Game Id;PlayerId;TeamId;Game Rating;SA;GA;SV;SV%;TOI;PIM
1914;171838;31;80;49;4;45;.918;3600000;0
1914;166646;16;39;33;6;27;.818;3334000;0
1914;170977;31;0;0;0;0;.00nan;0;0
1914;50065;16;48;0;0;0;.00nan;234000;0
1915;676;34;0;0;0;0;.00nan;0;0
1915;170314;25;0;0;0;0;.00nan;0;0
1915;78806;34;57;37;5;32;.865;3600000;0
1915;148958;25;28;32;6;26;.813;3600000;0
1916;15;30;0;0;0;0;.00nan;0;0
1916;167642;18;0;0;0;0;.00nan;0;0
1916;17043;30;69;25;2;23;.920;3600000;0
1916;173727;18;55;31;3;28;.903;3563000;0
1917;166591;20;0;0;0;0;.00nan;0;0
1917;779;5;78;32;2;30;.938;3866000;0
1917;166751;5;0;0;0;0;.00nan;0;0
1917;86697;20;68;29;3;26;.897;3866000;0
1918;163695;9;0;0;0;0;.00nan;0;0
1918;178413;17;0;0;0;0;.00nan;0;0
1918;175092;9;80;29;1;28;.966;3600000;0
1918;146862;17;59;28;3;25;.893;3600000;0
1919;170314;25;45;20;3;17;.850;3600000;0
1919;77955;28;0;0;0;0;.00nan;0;0
1919;85437;28;25;26;6;20;.769;3600000;0
1919;148958;25;0;0;0;0;.00nan;0;0
1920;166381;27;0;0;0;0;.00nan;0;0
1920;175660;27;78;22;1;21;.955;3600000;0
1920;57338;35;90;46;2;44;.957;3579000;0
1920;141998;35;0;0;0;0;.00nan;0;0
1921;2059;23;55;41;5;36;.878;3600000;0
1921;13714;8;59;25;2;23;.920;3600000;0
1921;18213;8;0;0;0;0;.00nan;0;0
1921;78573;23;0;0;0;0;.00nan;0;0
1922;67;11;72;30;2;28;.933;4149000;0
1922;179950;4838;0;0;0;0;.00nan;0;0
1922;46468;11;0;0;0;0;.00nan;0;0
1922;143749;4838;100;45;1;44;.978;4149000;0
1923;163195;0;0;0;0;0;.00nan;0;0
1923;168712;14;87;38;2;36;.947;3600000;0
1923;175912;14;0;0;0;0;.00nan;0;0
1923;139409;0;86;20;1;19;.950;3600000;0
1924;59540;15;53;34;5;29;.853;3837000;0
1924;71565;15;0;0;0;0;.00nan;0;0
1924;90164;10;0;0;0;0;.00nan;0;0
1924;152717;10;39;29;6;23;.793;3837000;0
1925;556;3;25;24;6;18;.750;2856000;0
1925;179344;3;58;12;1;11;.917;744000;0
1925;184770;22;0;0;0;0;.00nan;0;0
1925;143473;22;38;18;4;14;.778;3600000;0
1926;163423;26;0;0;0;0;.00nan;0;0
1926;13337;32;0;0;0;0;.00nan;0;0
1926;20432;32;97;27;0;27;1.000;3600000;0
1926;179154;26;63;38;4;34;.895;3600000;0
1927;183844;29;0;0;0;0;.00nan;0;0
1927;190465;33;100;33;0;33;1.000;3600000;0
1927;37818;29;88;31;1;30;.968;3545000;0
1927;86192;33;0;0;0;0;.00nan;0;0
1928;166646;16;0;0;0;0;.00nan;0;0
1928;167642;18;0;0;0;0;.00nan;0;0
1928;173727;18;65;46;7;39;.848;3600000;0
1928;50065;16;51;27;4;23;.852;3600000;0
1929;15;30;0;0;0;0;.00nan;0;0
1929;187537;19;69;35;3;32;.914;3600000;0
1929;163565;19;0;0;0;0;.00nan;0;0
1929;17043;30;47;26;4;22;.846;3546000;0
1930;3928;12;0;0;0;0;.00nan;0;0
1930;184770;22;0;0;0;0;.00nan;0;0
1930;91178;12;55;29;4;25;.862;3600000;0
1930;143473;22;58;18;2;16;.889;3600000;0
1931;676;34;75;30;1;29;.967;4200000;0
1931;78806;34;0;0;0;0;.00nan;0;0
1931;143156;21;96;34;1;33;.971;4200000;0
1931;157189;21;0;0;0;0;.00nan;0;0
1932;779;5;0;0;0;0;.00nan;0;0
1932;166751;5;89;32;2;30;.938;3600000;0
1932;90164;10;0;0;0;0;.00nan;0;0
1932;152717;10;65;32;4;28;.875;3560000;0
1933;183844;29;69;27;2;25;.926;3600000;0
1933;37818;29;0;0;0;0;.00nan;0;0
1933;57338;35;50;35;5;30;.857;3600000;0
1933;141998;35;0;0;0;0;.00nan;0;0
1934;166646;16;0;0;0;0;.00nan;0;0
1934;50065;16;73;31;2;29;.935;3600000;0
1934;77955;28;65;32;3;29;.906;3600000;0
1934;85437;28;0;0;0;0;.00nan;0;0
1935;168712;14;100;49;0;49;1.000;3600000;0
1935;175912;14;0;0;0;0;.00nan;0;0
1935;59540;15;70;19;1;18;.947;3600000;0
1935;71565;15;0;0;0;0;.00nan;0;0
1936;556;3;87;28;1;27;.964;3600000;0
1936;171838;31;79;35;2;33;.943;3548000;0
1936;170977;31;0;0;0;0;.00nan;0;0
1936;179344;3;0;0;0;0;.00nan;0;0
1937;178413;17;0;0;0;0;.00nan;0;0
1937;170314;25;79;12;0;12;1.000;3600000;0
1937;146862;17;73;35;3;32;.914;3600000;0
1937;148958;25;0;0;0;0;.00nan;0;0
1938;676;34;89;38;2;36;.947;3600000;0
1938;166381;27;49;23;3;20;.870;3545000;0
1938;175660;27;0;0;0;0;.00nan;0;0
1938;78806;34;0;0;0;0;.00nan;0;0
1939;163695;9;0;0;0;0;.00nan;0;0
1939;175092;9;94;46;2;44;.957;3600000;0
1939;190465;33;0;0;0;0;.00nan;0;0
1939;86192;33;58;30;4;26;.867;3514000;0
1940;163195;0;0;0;0;0;.00nan;0;0
1940;165582;24;0;0;0;0;.00nan;0;0
1940;85727;24;71;20;1;19;.950;3600000;0
1940;139409;0;63;45;5;40;.889;3600000;0
1941;167642;18;0;0;0;0;.00nan;0;0
1941;13337;32;0;0;0;0;.00nan;0;0
1941;20432;32;93;31;1;30;.968;3600000;0
1941;173727;18;82;33;2;31;.939;3600000;0
1942;67;11;0;0;0;0;.00nan;0;0
1942;179950;4838;0;0;0;0;.00nan;0;0
1942;46468;11;64;23;2;21;.913;3600000;0
1942;143749;4838;59;25;3;22;.880;3571000;0
1943;187537;19;100;29;0;29;1.000;3600000;0
1943;163565;19;0;0;0;0;.00nan;0;0
1943;13714;8;59;31;4;27;.871;3600000;0
1943;18213;8;0;0;0;0;.00nan;0;0
1944;15;30;0;0;0;0;.00nan;0;0
1944;17043;30;71;38;4;34;.895;4200000;0
1944;169868;4182;0;0;0;0;.00nan;0;0
1944;147945;4182;49;30;4;26;.867;4200000;0
1945;166591;20;0;0;0;0;.00nan;0;0
1945;2059;23;54;3;0;3;1.000;406000;0
1945;78573;23;32;34;6;28;.824;3139000;0
1945;86697;20;59;38;5;33;.868;3600000;0
1946;779;5;0;0;0;0;.00nan;0;0
1946;171838;31;0;0;0;0;.00nan;0;0
1946;166751;5;72;30;2;28;.933;4200000;0
1946;170977;31;88;39;2;37;.949;4200000;0
1947;166591;20;68;41;4;37;.902;3600000;0
1947;169868;4182;0;0;0;0;.00nan;0;0
1947;86697;20;0;0;0;0;.00nan;0;0
1947;147945;4182;64;19;1;18;.947;3600000;0
1948;556;3;41;32;5;27;.844;3586000;0
1948;179344;3;0;0;0;0;.00nan;0;0
1948;59540;15;58;32;4;28;.875;3600000;0
1948;71565;15;0;0;0;0;.00nan;0;0
1949;183844;29;0;0;0;0;.00nan;0;0
1949;184770;22;0;0;0;0;.00nan;0;0
1949;37818;29;68;42;4;38;.905;3600000;0
1949;143473;22;56;17;2;15;.882;3600000;0
1950;3928;12;0;0;0;0;.00nan;0;0
1950;168712;14;75;33;2;31;.939;3545000;0
1950;175912;14;0;0;0;0;.00nan;0;0
1950;91178;12;84;28;1;27;.964;3600000;0
1951;163695;9;97;52;3;49;.942;3600000;0
1951;170314;25;63;15;1;14;.933;3600000;0
1951;175092;9;0;0;0;0;.00nan;0;0
1951;148958;25;0;0;0;0;.00nan;0;0
1952;166381;27;92;37;2;35;.946;3585000;0
1952;175660;27;0;0;0;0;.00nan;0;0
1952;143156;21;89;22;1;21;.955;3600000;0
1952;157189;21;0;0;0;0;.00nan;0;0
1953;171838;31;61;31;4;27;.871;3600000;0
1953;163195;0;0;0;0;0;.00nan;0;0
1953;170977;31;0;0;0;0;.00nan;0;0
1953;139409;0;93;25;1;24;.960;3600000;0
1954;178413;17;0;0;0;0;.00nan;0;0
1954;190465;33;56;12;1;11;.917;1463000;0
1954;86192;33;45;27;4;23;.852;2137000;0
1954;146862;17;62;24;2;22;.917;3600000;0
1955;179950;4838;0;0;0;0;.00nan;0;0
1955;90164;10;86;49;4;45;.918;3698000;0
1955;143749;4838;72;36;3;33;.917;3698000;0
1955;152717;10;0;0;0;0;.00nan;0;0
1956;3928;12;18;24;6;18;.750;3600000;0
1956;165582;24;0;0;0;0;.00nan;0;0
1956;85727;24;100;44;1;43;.977;3600000;0
1956;91178;12;0;0;0;0;.00nan;0;0
1957;67;11;0;0;0;0;.00nan;0;0
1957;166646;16;0;0;0;0;.00nan;0;0
1957;46468;11;87;49;4;45;.918;3600000;0
1957;50065;16;51;30;5;25;.833;3555000;0
1958;2059;23;0;0;0;0;.00nan;0;0
1958;57338;35;83;32;2;30;.938;3600000;0
1958;78573;23;84;44;3;41;.932;3600000;0
1958;141998;35;0;0;0;0;.00nan;0;0
1959;167642;18;0;0;0;0;.00nan;0;0
1959;13714;8;45;21;3;18;.857;3567000;0
1959;18213;8;0;0;0;0;.00nan;0;0
1959;173727;18;77;28;2;26;.929;3600000;0
1960;166591;20;0;0;0;0;.00nan;0;0
1960;187537;19;54;20;2;18;.900;3828000;0
1960;163565;19;0;0;0;0;.00nan;0;0
1960;86697;20;84;29;1;28;.966;3828000;0
1961;15;30;0;0;0;0;.00nan;0;0
1961;163423;26;0;0;0;0;.00nan;0;0
1961;17043;30;64;32;5;27;.844;3600000;0
1961;179154;26;93;36;1;35;.972;3600000;0
1962;779;5;0;0;0;0;.00nan;0;0
1962;166751;5;100;44;3;41;.932;4200000;0
1962;143156;21;43;20;3;17;.850;4200000;0
1962;157189;21;0;0;0;0;.00nan;0;0
1963;556;3;100;42;1;41;.976;4200000;0
1963;676;34;78;18;1;17;.944;4200000;0
1963;179344;3;0;0;0;0;.00nan;0;0
1963;78806;34;0;0;0;0;.00nan;0;0
1964;163195;0;0;0;0;0;.00nan;0;0
1964;166381;27;0;0;0;0;.00nan;0;0
1964;175660;27;33;25;5;20;.800;3600000;0
1964;139409;0;61;48;6;42;.875;3599000;0
1965;163695;9;0;0;0;0;.00nan;0;0
1965;183844;29;63;27;3;24;.889;3600000;0
1965;175092;9;66;38;4;34;.895;3545000;0
1965;37818;29;0;0;0;0;.00nan;0;0
1966;166646;16;0;0;0;0;.00nan;0;0
1966;168712;14;0;0;0;0;.00nan;0;0
1966;175912;14;76;23;2;21;.913;3600000;0
1966;50065;16;52;24;3;21;.875;3550000;0
1967;67;11;0;0;0;0;.00nan;0;0
1967;46468;11;100;23;0;23;1.000;3600000;0
1967;90164;10;0;0;0;0;.00nan;0;0
1967;152717;10;80;41;3;38;.927;3600000;0
1968;171838;31;81;22;1;21;.955;3600000;0
1968;170977;31;0;0;0;0;.00nan;0;0
1968;179950;4838;0;0;0;0;.00nan;0;0
1968;143749;4838;72;34;3;31;.912;3600000;0
1969;2059;23;0;0;0;0;.00nan;0;0
1969;190465;33;0;0;0;0;.00nan;0;0
1969;78573;23;59;33;3;30;.909;3549000;0
1969;86192;33;67;24;2;22;.917;3600000;0
1970;3928;12;90;19;0;19;1.000;3600000;0
1970;13337;32;0;0;0;0;.00nan;0;0
1970;20432;32;91;34;1;33;.971;3549000;0
1970;91178;12;0;0;0;0;.00nan;0;0
1971;15;30;0;0;0;0;.00nan;0;0
1971;17043;30;76;27;2;25;.926;3600000;0
1971;57338;35;0;0;0;0;.00nan;0;0
1971;141998;35;71;39;4;35;.897;3600000;0
1972;163423;26;0;0;0;0;.00nan;0;0
1972;169868;4182;0;0;0;0;.00nan;0;0
1972;179154;26;71;41;5;36;.878;3869000;0
1972;147945;4182;40;23;4;19;.826;3869000;0
1973;166591;20;0;0;0;0;.00nan;0;0
1973;167642;18;0;0;0;0;.00nan;0;0
1973;173727;18;46;28;4;24;.857;4180000;0
1973;86697;20;70;48;5;43;.896;4180000;0
1974;13714;8;0;0;0;0;.00nan;0;0
1974;18213;8;100;31;0;31;1.000;3600000;0
1974;170314;25;48;35;5;30;.857;3600000;0
1974;148958;25;0;0;0;0;.00nan;0;0
1975;187537;19;59;28;3;25;.893;3545000;0
1975;163565;19;0;0;0;0;.00nan;0;0
1975;77955;28;86;35;2;33;.943;3600000;0
1975;85437;28;0;0;0;0;.00nan;0;0
1976;166381;27;60;27;2;25;.926;4083000;0
1976;175660;27;0;0;0;0;.00nan;0;0
1976;59540;15;70;26;3;23;.885;4083000;0
1976;71565;15;0;0;0;0;.00nan;0;0
1977;165582;24;0;0;0;0;.00nan;0;0
1977;184770;22;0;0;0;0;.00nan;0;0
1977;85727;24;87;54;5;49;.907;3600000;0
1977;143473;22;82;13;0;13;1.000;3600000;0
1978;556;3;32;16;4;12;.750;3545000;0
1978;779;5;79;39;3;36;.923;3600000;0
1978;166751;5;0;0;0;0;.00nan;0;0
1978;179344;3;0;0;0;0;.00nan;0;0
1979;3928;12;63;34;3;31;.912;4200000;0
1979;169868;4182;0;0;0;0;.00nan;0;0
1979;91178;12;0;0;0;0;.00nan;0;0
1979;147945;4182;85;45;3;42;.933;4200000;0
1980;163195;0;0;0;0;0;.00nan;0;0
1980;165582;24;86;31;1;30;.968;3600000;0
1980;85727;24;0;0;0;0;.00nan;0;0
1980;139409;0;68;27;2;25;.926;3600000;0
1981;183844;29;97;36;2;34;.944;3600000;0
1981;179950;4838;0;0;0;0;.00nan;0;0
1981;37818;29;0;0;0;0;.00nan;0;0
1981;143749;4838;91;31;1;30;.968;3600000;0
1982;178413;17;0;0;0;0;.00nan;0;0
1982;143156;21;99;24;0;24;1.000;3600000;0
1982;146862;17;71;24;2;22;.917;3576000;0
1982;157189;21;0;0;0;0;.00nan;0;0
1983;171838;31;0;0;0;0;.00nan;0;0
1983;163695;9;0;0;0;0;.00nan;0;0
1983;170977;31;100;34;0;34;1.000;3600000;0
1983;175092;9;57;16;2;14;.875;3542000;0
1984;15;30;0;0;0;0;.00nan;0;0
1984;17043;30;46;31;5;26;.839;3600000;0
1984;170314;25;0;0;0;0;.00nan;0;0
1984;148958;25;100;30;0;30;1.000;3600000;0
1985;163423;26;0;0;0;0;.00nan;0;0
1985;179154;26;78;29;2;27;.931;3600000;0
1985;90164;10;0;0;0;0;.00nan;0;0
1985;152717;10;69;37;4;33;.892;3522000;0
1986;190465;33;79;36;2;34;.944;3988000;0
1986;59540;15;0;0;0;0;.00nan;0;0
1986;71565;15;49;18;3;15;.833;3988000;0
1986;86192;33;0;0;0;0;.00nan;0;0
1987;187537;19;91;55;4;51;.927;3600000;0
1987;166646;16;76;24;1;23;.958;3600000;0
1987;163565;19;0;0;0;0;.00nan;0;0
1987;50065;16;0;0;0;0;.00nan;0;0
1988;676;34;0;0;0;0;.00nan;0;0
1988;13337;32;0;0;0;0;.00nan;0;0
1988;20432;32;68;24;2;22;.917;3600000;0
1988;78806;34;44;33;5;28;.848;3600000;0
1989;166591;20;0;0;0;0;.00nan;0;0
1989;13714;8;0;0;0;0;.00nan;0;0
1989;18213;8;69;21;2;19;.905;3600000;0
1989;86697;20;89;56;4;52;.929;3592000;0
1990;67;11;49;2;0;2;1.000;471000;0
1990;46468;11;28;32;6;26;.813;3129000;0
1990;57338;35;75;32;2;30;.938;3600000;0
1990;141998;35;0;0;0;0;.00nan;0;0
1991;167642;18;69;30;2;28;.933;4200000;0
1991;168712;14;78;25;2;23;.920;4200000;0
1991;173727;18;0;0;0;0;.00nan;0;0
1991;175912;14;0;0;0;0;.00nan;0;0
1992;2059;23;88;42;3;39;.929;3541000;0
1992;77955;28;80;22;1;21;.955;3600000;0
1992;78573;23;0;0;0;0;.00nan;0;0
1992;85437;28;0;0;0;0;.00nan;0;0
1993;556;3;30;21;5;16;.762;2599000;0
1993;166381;27;0;0;0;0;.00nan;0;0
1993;179344;3;36;19;4;15;.789;1001000;0
1993;175660;27;52;29;4;25;.862;3600000;0
1994;169868;4182;87;32;2;30;.938;3600000;0
1994;77955;28;0;0;0;0;.00nan;0;0
1994;85437;28;75;35;3;32;.914;3558000;0
1994;147945;4182;0;0;0;0;.00nan;0;0
1995;163195;0;71;27;2;25;.926;3600000;0
1995;178413;17;0;0;0;0;.00nan;0;0
1995;139409;0;0;0;0;0;.00nan;0;0
1995;146862;17;93;47;3;44;.936;3546000;0
1996;163695;9;0;0;0;0;.00nan;0;0
1996;175092;9;80;35;3;32;.914;3600000;0
1996;143156;21;100;31;0;31;1.000;3600000;0
1996;157189;21;0;0;0;0;.00nan;0;0
1997;169868;4182;0;0;0;0;.00nan;0;0
1997;59540;15;69;19;2;17;.895;3600000;0
1997;71565;15;0;0;0;0;.00nan;0;0
1997;147945;4182;79;33;3;30;.909;3588000;0
1998;779;5;0;0;0;0;.00nan;0;0
1998;166751;5;93;49;2;47;.959;4200000;0
1998;163195;0;0;0;0;0;.00nan;0;0
1998;139409;0;68;25;2;23;.920;4200000;0
1999;166591;20;0;0;0;0;.00nan;0;0
1999;171838;31;0;0;0;0;.00nan;0;0
1999;170977;31;73;37;4;33;.892;3563000;0
1999;86697;20;100;47;3;44;.936;3600000;0
2000;178413;17;28;14;4;10;.714;619000;0
2000;184770;22;0;0;0;0;.00nan;0;0
2000;143473;22;61;20;3;17;.850;3600000;0
2000;146862;17;46;31;5;26;.839;2981000;0
2001;676;34;91;45;3;42;.933;3600000;0
2001;163423;26;0;0;0;0;.00nan;0;0
2001;179154;26;39;38;7;31;.816;3600000;0
2001;78806;34;0;0;0;0;.00nan;0;0
2002;187537;19;71;15;1;14;.933;3600000;0
2002;163565;19;0;0;0;0;.00nan;0;0
2002;183844;29;78;31;2;29;.935;3546000;0
2002;37818;29;0;0;0;0;.00nan;0;0
2003;13714;8;49;33;6;27;.818;3600000;0
2003;165582;24;0;0;0;0;.00nan;0;0
2003;18213;8;0;0;0;0;.00nan;0;0
2003;85727;24;80;27;1;26;.963;3600000;0
2004;556;3;27;7;3;4;.571;575000;0
2004;167642;18;0;0;0;0;.00nan;0;0
2004;173727;18;76;38;3;35;.921;3600000;0
2004;179344;3;77;30;2;28;.933;3025000;0
2005;170314;25;0;0;0;0;.00nan;0;0
2005;77955;28;42;38;6;32;.842;3600000;0
2005;85437;28;0;0;0;0;.00nan;0;0
2005;148958;25;65;24;2;22;.917;3600000;0
2006;13337;32;56;21;2;19;.905;2387000;0
2006;20432;32;18;8;4;4;.500;1127000;0
2006;57338;35;54;27;4;23;.852;3600000;0
2006;141998;35;0;0;0;0;.00nan;0;0
2007;67;11;71;34;3;31;.912;3832000;0
2007;190465;33;0;0;0;0;.00nan;0;0
2007;46468;11;0;0;0;0;.00nan;0;0
2007;86192;33;64;28;2;26;.929;3832000;0
2008;166646;16;0;0;0;0;.00nan;0;0
2008;179950;4838;0;0;0;0;.00nan;0;0
2008;50065;16;100;34;0;34;1.000;3750000;0
2008;143749;4838;81;28;1;27;.964;3750000;0
2009;166381;27;0;0;0;0;.00nan;0;0
2009;168712;14;81;43;3;40;.930;4200000;0
2009;175660;27;70;30;3;27;.900;4200000;0
2009;175912;14;0;0;0;0;.00nan;0;0
2010;2059;23;53;3;0;3;1.000;650000;0
2010;3928;12;76;30;2;28;.933;3600000;0
2010;78573;23;24;29;7;22;.759;2950000;0
2010;91178;12;0;0;0;0;.00nan;0;0
2011;15;30;0;0;0;0;.00nan;0;0
2011;17043;30;80;37;2;35;.946;3600000;0
2011;90164;10;0;0;0;0;.00nan;0;0
2011;152717;10;51;28;4;24;.857;3528000;0
2012;184770;22;100;28;0;28;1.000;3600000;0
2012;143156;21;69;24;2;22;.917;3522000;0
2012;143473;22;0;0;0;0;.00nan;0;0
2012;157189;21;0;0;0;0;.00nan;0;0
2013;169868;4182;0;0;0;0;.00nan;0;0
2013;77955;28;77;25;1;24;.960;3958000;0
2013;85437;28;0;0;0;0;.00nan;0;0
2013;147945;4182;92;46;2;44;.957;3958000;0
2014;166591;20;0;0;0;0;.00nan;0;0
2014;167642;18;0;0;0;0;.00nan;0;0
2014;173727;18;44;18;3;15;.833;3571000;0
2014;86697;20;90;30;1;29;.967;3600000;0
2015;556;3;96;34;1;33;.971;3600000;0
2015;179344;3;0;0;0;0;.00nan;0;0
2015;57338;35;20;39;8;31;.795;3600000;0
2015;141998;35;0;0;0;0;.00nan;0;0
2016;178413;17;0;0;0;0;.00nan;0;0
2016;59540;15;0;0;0;0;.00nan;0;0
2016;71565;15;100;37;2;35;.946;3600000;0
2016;146862;17;71;32;3;29;.906;3560000;0
2017;190465;33;84;37;3;34;.919;3626000;0
2017;86192;33;0;0;0;0;.00nan;0;0
2017;90164;10;59;20;2;18;.900;3676000;0
2017;152717;10;0;0;0;0;.00nan;0;0
2018;676;34;72;37;4;33;.892;3600000;0
2018;13714;8;0;0;0;0;.00nan;0;0
2018;18213;8;32;24;5;19;.792;3551000;0
2018;78806;34;0;0;0;0;.00nan;0;0
2019;171838;31;100;33;1;32;.970;4200000;0
2019;187537;19;69;27;1;26;.963;4200000;0
2019;163565;19;0;0;0;0;.00nan;0;0
2019;170977;31;0;0;0;0;.00nan;0;0
2020;779;5;38;34;6;28;.824;3600000;0
2020;166751;5;0;0;0;0;.00nan;0;0
2020;165582;24;0;0;0;0;.00nan;0;0
2020;85727;24;70;34;3;31;.912;3600000;0
2021;163423;26;0;0;0;0;.00nan;0;0
2021;163695;9;0;0;0;0;.00nan;0;0
2021;179154;26;73;23;2;21;.913;3600000;0
2021;175092;9;90;46;4;42;.913;3600000;0
2022;13337;32;0;0;0;0;.00nan;0;0
2022;166381;27;78;27;2;25;.926;3600000;0
2022;20432;32;78;46;3;43;.935;3565000;0
2022;175660;27;0;0;0;0;.00nan;0;0
2023;67;11;25;32;6;26;.813;3600000;0
2023;168712;14;63;20;2;18;.900;3600000;0
2023;175912;14;0;0;0;0;.00nan;0;0
2023;46468;11;0;0;0;0;.00nan;0;0
2024;15;30;0;0;0;0;.00nan;0;0
2024;17043;30;34;32;6;26;.813;3600000;0
2024;170314;25;76;25;1;24;.960;3600000;0
2024;148958;25;0;0;0;0;.00nan;0;0
2025;166591;20;47;46;7;39;.848;3544000;0
2025;187537;19;0;0;0;0;.00nan;0;0
2025;163565;19;61;36;5;31;.861;3600000;0
2025;86697;20;0;0;0;0;.00nan;0;0
2026;163195;0;0;0;0;0;.00nan;0;0
2026;184770;22;0;0;0;0;.00nan;0;0
2026;139409;0;87;49;5;44;.898;3600000;0
2026;143473;22;75;25;2;23;.920;3600000;0
2027;190465;33;0;0;0;0;.00nan;0;0
2027;86192;33;56;39;6;33;.846;3600000;0
2027;143156;21;0;0;0;0;.00nan;0;0
2027;157189;21;43;28;5;23;.821;3600000;0
2028;2059;23;5;13;6;7;.538;2064000;0
2028;3928;12;50;18;3;15;.833;3600000;0
2028;78573;23;56;12;1;11;.917;1536000;0
2028;91178;12;0;0;0;0;.00nan;0;0
2029;13337;32;85;52;5;47;.904;3600000;0
2029;20432;32;0;0;0;0;.00nan;0;0
2029;179950;4838;0;0;0;0;.00nan;0;0
2029;143749;4838;58;25;3;22;.880;3600000;0
2030;169868;4182;0;0;0;0;.00nan;0;0
2030;90164;10;0;0;0;0;.00nan;0;0
2030;147945;4182;85;30;1;29;.967;3600000;0
2030;152717;10;37;37;7;30;.811;3600000;0
2031;167642;18;0;0;0;0;.00nan;0;0
2031;183844;29;72;21;2;19;.905;3600000;0
2031;173727;18;52;24;3;21;.875;3561000;0
2031;37818;29;0;0;0;0;.00nan;0;0
2032;556;3;89;33;2;31;.939;3600000;0
2032;179344;3;0;0;0;0;.00nan;0;0
2032;77955;28;63;30;3;27;.900;3572000;0
2032;85437;28;0;0;0;0;.00nan;0;0
2033;165582;24;0;0;0;0;.00nan;0;0
2033;59540;15;0;0;0;0;.00nan;0;0
2033;71565;15;91;40;2;38;.950;3600000;0
2033;85727;24;49;29;4;25;.862;3594000;0
2034;178413;17;0;0;0;0;.00nan;0;0
2034;57338;35;79;40;3;37;.925;3600000;0
2034;141998;35;0;0;0;0;.00nan;0;0
2034;146862;17;85;27;1;26;.963;3600000;0
2035;166646;16;0;0;0;0;.00nan;0;0
2035;163695;9;93;45;3;42;.933;4005000;0
2035;175092;9;0;0;0;0;.00nan;0;0
2035;50065;16;62;23;2;21;.913;4005000;0
2036;676;34;0;0;0;0;.00nan;0;0
2036;779;5;0;0;0;0;.00nan;0;0
2036;166751;5;90;50;3;47;.940;4200000;0
2036;78806;34;61;18;3;15;.833;4200000;0
2037;168712;14;53;37;5;32;.865;3595000;0
2037;175912;14;0;0;0;0;.00nan;0;0
2037;179950;4838;68;32;4;28;.875;3600000;0
2037;143749;4838;0;0;0;0;.00nan;0;0
2038;15;30;0;0;0;0;.00nan;0;0
2038;2059;23;39;8;2;6;.750;651000;0
2038;17043;30;78;29;2;27;.931;3600000;0
2038;78573;23;44;42;6;36;.857;2949000;0
2039;163195;0;56;5;0;5;1.000;424000;0
2039;13714;8;87;30;1;29;.967;3600000;0
2039;18213;8;0;0;0;0;.00nan;0;0
2039;139409;0;38;34;6;28;.824;3176000;0
2040;184770;22;0;0;0;0;.00nan;0;0
2040;190465;33;89;41;3;38;.927;3547000;0
2040;86192;33;0;0;0;0;.00nan;0;0
2040;143473;22;57;12;1;11;.917;3600000;0
2041;187537;19;48;28;4;24;.857;3531000;0
2041;163565;19;0;0;0;0;.00nan;0;0
2041;143156;21;79;39;2;37;.949;3600000;0
2041;157189;21;0;0;0;0;.00nan;0;0
2042;67;11;53;38;5;33;.868;2682000;0
2042;166381;27;0;0;0;0;.00nan;0;0
2042;175660;27;71;23;2;21;.913;3600000;0
2042;46468;11;34;17;4;13;.765;918000;0
2043;183844;29;29;28;6;22;.786;3793000;0
2043;37818;29;0;0;0;0;.00nan;0;0
2043;77955;28;69;41;5;36;.878;3793000;0
2043;85437;28;0;0;0;0;.00nan;0;0
2044;166591;20;0;0;0;0;.00nan;0;0
2044;86697;20;41;31;5;26;.839;3556000;0
2044;90164;10;0;0;0;0;.00nan;0;0
2044;152717;10;62;31;4;27;.871;3600000;0
2045;676;34;84;35;3;32;.914;3523000;0
2045;169868;4182;0;0;0;0;.00nan;0;0
2045;78806;34;0;0;0;0;.00nan;0;0
2045;147945;4182;79;25;2;23;.920;3600000;0
2046;171838;31;52;28;4;24;.857;3538000;0
2046;167642;18;0;0;0;0;.00nan;0;0
2046;173727;18;88;36;2;34;.944;3600000;0
2046;170977;31;0;0;0;0;.00nan;0;0
2047;556;3;100;42;1;41;.976;4200000;0
2047;165582;24;0;0;0;0;.00nan;0;0
2047;179344;3;0;0;0;0;.00nan;0;0
2047;85727;24;85;21;1;20;.952;4200000;0
2048;168712;14;84;24;1;23;.958;3600000;0
2048;175912;14;0;0;0;0;.00nan;0;0
2048;57338;35;59;23;2;21;.913;3545000;0
2048;141998;35;0;0;0;0;.00nan;0;0
2049;163423;26;0;0;0;0;.00nan;0;0
2049;179154;26;72;52;5;47;.904;3600000;0
2049;59540;15;0;0;0;0;.00nan;0;0
2049;71565;15;72;24;2;22;.917;3600000;0
2050;3928;12;97;23;0;23;1.000;3600000;0
2050;170314;25;49;34;5;29;.853;3600000;0
2050;91178;12;0;0;0;0;.00nan;0;0
2050;148958;25;0;0;0;0;.00nan;0;0
2051;15;30;0;0;0;0;.00nan;0;0
2051;178413;17;0;0;0;0;.00nan;0;0
2051;17043;30;71;24;2;22;.917;3600000;0
2051;146862;17;78;36;3;33;.917;3541000;0
2052;2059;23;0;0;0;0;.00nan;0;0
2052;163695;9;0;0;0;0;.00nan;0;0
2052;175092;9;38;22;5;17;.773;3600000;0
2052;78573;23;50;43;6;37;.860;3551000;0
2053;166646;16;0;0;0;0;.00nan;0;0
2053;179950;4838;0;0;0;0;.00nan;0;0
2053;50065;16;69;44;4;40;.909;3555000;0
2053;143749;4838;86;40;3;37;.925;3600000;0
2054;163195;0;0;0;0;0;.00nan;0;0
2054;90164;10;67;35;4;31;.886;3255000;0
2054;139409;0;69;18;1;17;.944;3600000;0
2054;152717;10;49;1;0;1;1.000;345000;0
2055;163423;26;0;0;0;0;.00nan;0;0
2055;166381;27;0;0;0;0;.00nan;0;0
2055;179154;26;67;45;5;40;.889;3552000;0
2055;175660;27;54;23;3;20;.870;3600000;0
2056;13337;32;0;0;0;0;.00nan;0;0
2056;13714;8;46;20;4;16;.800;3600000;0
2056;18213;8;0;0;0;0;.00nan;0;0
2056;20432;32;52;35;5;30;.857;3550000;0
2057;3928;12;42;20;4;16;.800;3512000;0
2057;169868;4182;0;0;0;0;.00nan;0;0
2057;91178;12;0;0;0;0;.00nan;0;0
2057;147945;4182;85;36;2;34;.944;3600000;0
2058;163695;9;0;0;0;0;.00nan;0;0
2058;175092;9;100;29;0;29;1.000;3600000;0
2058;77955;28;0;0;0;0;.00nan;0;0
2058;85437;28;67;28;3;25;.893;3600000;0
2059;171838;31;79;48;4;44;.917;3600000;0
2059;170977;31;0;0;0;0;.00nan;0;0
2059;59540;15;62;20;2;18;.900;3600000;0
2059;71565;15;0;0;0;0;.00nan;0;0
2060;556;3;76;20;1;19;.950;3600000;0
2060;183844;29;67;33;4;29;.879;3600000;0
2060;179344;3;0;0;0;0;.00nan;0;0
2060;37818;29;0;0;0;0;.00nan;0;0
2061;166591;20;0;0;0;0;.00nan;0;0
2061;168712;14;0;0;0;0;.00nan;0;0
2061;175912;14;54;21;2;19;.905;3600000;0
2061;86697;20;80;34;3;31;.912;3541000;0
2062;779;5;52;26;3;23;.885;3590000;0
2062;166751;5;0;0;0;0;.00nan;0;0
2062;2059;23;0;0;0;0;.00nan;0;0
2062;78573;23;71;22;1;21;.955;3600000;0
2063;165582;24;54;4;0;4;1.000;680000;0
2063;85727;24;17;26;6;20;.769;2920000;0
2063;143156;21;89;41;2;39;.951;3600000;0
2063;157189;21;0;0;0;0;.00nan;0;0
2064;184770;22;0;0;0;0;.00nan;0;0
2064;190465;33;0;0;0;0;.00nan;0;0
2064;86192;33;55;32;4;28;.875;3692000;0
2064;143473;22;56;21;3;18;.857;3692000;0
2065;67;11;43;25;4;21;.840;3600000;0
2065;163423;26;82;26;1;25;.962;3600000;0
2065;179154;26;0;0;0;0;.00nan;0;0
2065;46468;11;0;0;0;0;.00nan;0;0
2066;3928;12;0;0;0;0;.00nan;0;0
2066;178413;17;57;7;0;7;1.000;630000;0
2066;91178;12;99;26;0;26;1.000;3600000;0
2066;146862;17;46;32;6;26;.813;2970000;0
2067;166646;16;0;0;0;0;.00nan;0;0
2067;167642;18;0;0;0;0;.00nan;0;0
2067;173727;18;64;30;3;27;.900;3656000;0
2067;50065;16;45;25;4;21;.840;3656000;0
2068;15;30;0;0;0;0;.00nan;0;0
2068;17043;30;100;29;0;29;1.000;3600000;0
2068;57338;35;0;0;0;0;.00nan;0;0
2068;141998;35;71;28;2;26;.929;3533000;0
2069;187537;19;0;0;0;0;.00nan;0;0
2069;163565;19;83;30;2;28;.933;3578000;0
2069;179950;4838;0;0;0;0;.00nan;0;0
2069;143749;4838;90;26;1;25;.962;3600000;0
2070;163195;0;0;0;0;0;.00nan;0;0
2070;90164;10;99;45;1;44;.978;3600000;0
2070;139409;0;56;18;3;15;.833;3513000;0
2070;152717;10;0;0;0;0;.00nan;0;0
2071;13337;32;0;0;0;0;.00nan;0;0
2071;20432;32;100;38;1;37;.974;3600000;0
2071;184770;22;24;8;4;4;.500;1112000;0
2071;143473;22;63;11;0;11;1.000;2488000;0
2072;67;11;0;0;0;0;.00nan;0;0
2072;166646;16;53;23;3;20;.870;3600000;0
2072;46468;11;69;44;4;40;.909;3600000;0
2072;50065;16;0;0;0;0;.00nan;0;0
2073;3928;12;0;0;0;0;.00nan;0;0
2073;57338;35;100;43;1;42;.977;3600000;0
2073;91178;12;48;22;3;19;.864;3514000;0
2073;141998;35;0;0;0;0;.00nan;0;0
2074;556;3;59;36;5;31;.861;3574000;0
2074;179344;3;0;0;0;0;.00nan;0;0
2074;77955;28;24;5;3;2;.400;262000;0
2074;85437;28;82;27;1;26;.963;3338000;0
2075;779;5;0;0;0;0;.00nan;0;0
2075;171838;31;78;26;1;25;.962;3600000;0
2075;166751;5;65;35;3;32;.914;3600000;0
2075;170977;31;0;0;0;0;.00nan;0;0
2076;2059;23;0;0;0;0;.00nan;0;0
2076;78573;23;55;28;3;25;.893;3572000;0
2076;90164;10;0;0;0;0;.00nan;0;0
2076;152717;10;80;31;2;29;.935;3600000;0
2077;13337;32;52;38;5;33;.868;3600000;0
2077;178413;17;0;0;0;0;.00nan;0;0
2077;20432;32;0;0;0;0;.00nan;0;0
2077;146862;17;90;31;1;30;.968;3600000;0
2078;163195;0;0;0;0;0;.00nan;0;0
2078;163695;9;0;0;0;0;.00nan;0;0
2078;175092;9;63;26;2;24;.923;3561000;0
2078;139409;0;88;31;1;30;.968;3600000;0
2079;59540;15;0;0;0;0;.00nan;0;0
2079;71565;15;62;35;5;30;.857;3600000;0
2079;143156;21;21;29;7;22;.759;3575000;0
2079;157189;21;0;0;0;0;.00nan;0;0
2080;166591;20;0;0;0;0;.00nan;0;0
2080;165582;24;96;20;0;20;1.000;3600000;0
2080;85727;24;0;0;0;0;.00nan;0;0
2080;86697;20;82;26;1;25;.962;3553000;0
2081;183844;29;68;51;6;45;.882;3562000;0
2081;170314;25;0;0;0;0;.00nan;0;0
2081;37818;29;0;0;0;0;.00nan;0;0
2081;148958;25;47;22;4;18;.818;3600000;0
2082;168712;14;65;26;2;24;.923;3590000;0
2082;175912;14;0;0;0;0;.00nan;0;0
2082;190465;33;78;23;1;22;.957;3600000;0
2082;86192;33;0;0;0;0;.00nan;0;0
2083;167642;18;87;34;2;32;.941;3599000;0
2083;166381;27;0;0;0;0;.00nan;0;0
2083;173727;18;0;0;0;0;.00nan;0;0
2083;175660;27;80;22;1;21;.955;3600000;0
2084;676;34;77;23;1;22;.957;3600000;0
2084;187537;19;0;0;0;0;.00nan;0;0
2084;163565;19;72;35;3;32;.914;3600000;0
2084;78806;34;0;0;0;0;.00nan;0;0
2085;163423;26;0;0;0;0;.00nan;0;0
2085;179154;26;50;35;5;30;.857;3600000;0
2085;179950;4838;0;0;0;0;.00nan;0;0
2085;143749;4838;72;34;3;31;.912;3600000;0
2086;15;30;0;0;0;0;.00nan;0;0
2086;13714;8;81;40;3;37;.925;4054000;0
2086;17043;30;69;38;4;34;.895;4054000;0
2086;18213;8;0;0;0;0;.00nan;0;0
2087;170314;25;66;30;3;27;.900;3580000;0
2087;184770;22;0;0;0;0;.00nan;0;0
2087;143473;22;62;11;1;10;.909;3600000;0
2087;148958;25;0;0;0;0;.00nan;0;0
2088;15;30;0;0;0;0;.00nan;0;0
2088;17043;30;93;35;1;34;.971;3600000;0
2088;169868;4182;0;0;0;0;.00nan;0;0
2088;147945;4182;57;27;3;24;.889;3542000;0
2089;183844;29;97;44;2;42;.955;4200000;0
2089;37818;29;0;0;0;0;.00nan;0;0
2089;59540;15;63;17;2;15;.882;4200000;0
2089;71565;15;0;0;0;0;.00nan;0;0
2090;171838;31;71;46;5;41;.891;4200000;0
2090;163695;9;41;32;5;27;.844;4200000;0
2090;170977;31;0;0;0;0;.00nan;0;0
2090;175092;9;0;0;0;0;.00nan;0;0
2091;163423;26;0;0;0;0;.00nan;0;0
2091;179154;26;82;26;1;25;.962;3600000;0
2091;77955;28;76;33;2;31;.939;3567000;0
2091;85437;28;0;0;0;0;.00nan;0;0
2092;67;11;37;37;6;31;.838;3600000;0
2092;179950;4838;0;0;0;0;.00nan;0;0
2092;46468;11;0;0;0;0;.00nan;0;0
2092;143749;4838;61;24;2;22;.917;3600000;0
2093;166591;20;0;0;0;0;.00nan;0;0
2093;163195;0;0;0;0;0;.00nan;0;0
2093;86697;20;70;32;3;29;.906;3558000;0
2093;139409;0;75;25;2;23;.920;3600000;0
2094;171838;31;93;29;1;28;.966;3970000;0
2094;178413;17;0;0;0;0;.00nan;0;0
2094;170977;31;0;0;0;0;.00nan;0;0
2094;146862;17;99;25;0;25;1.000;3970000;0
2095;165582;24;80;32;1;31;.969;3600000;0
2095;190465;33;0;0;0;0;.00nan;0;0
2095;85727;24;0;0;0;0;.00nan;0;0
2095;86192;33;49;33;5;28;.848;3600000;0
2096;556;3;97;50;1;49;.980;3550000;0
2096;168712;14;96;23;0;23;1.000;3600000;0
2096;179344;3;0;0;0;0;.00nan;0;0
2096;175912;14;0;0;0;0;.00nan;0;0
2097;13337;32;0;0;0;0;.00nan;0;0
2097;20432;32;100;26;0;26;1.000;3600000;0
2097;57338;35;64;29;3;26;.897;3600000;0
2097;141998;35;0;0;0;0;.00nan;0;0
2098;3928;12;53;29;4;25;.862;3600000;0
2098;167642;18;0;0;0;0;.00nan;0;0
2098;173727;18;95;23;0;23;1.000;3600000;0
2098;91178;12;0;0;0;0;.00nan;0;0
2099;166646;16;60;42;6;36;.857;3600000;0
2099;166381;27;0;0;0;0;.00nan;0;0
2099;175660;27;90;34;2;32;.941;3600000;0
2099;50065;16;0;0;0;0;.00nan;0;0
2100;676;34;47;30;4;26;.867;3514000;0
2100;169868;4182;0;0;0;0;.00nan;0;0
2100;78806;34;0;0;0;0;.00nan;0;0
2100;147945;4182;63;22;3;19;.864;3600000;0
2101;13714;8;0;0;0;0;.00nan;0;0
2101;18213;8;73;33;3;30;.909;3600000;0
2101;184770;22;0;0;0;0;.00nan;0;0
2101;143473;22;40;21;4;17;.810;3600000;0
2102;187537;19;0;0;0;0;.00nan;0;0
2102;163565;19;89;31;2;29;.935;3600000;0
2102;90164;10;46;25;4;21;.840;3556000;0
2102;152717;10;0;0;0;0;.00nan;0;0
2103;779;5;89;33;2;31;.939;3600000;0
2103;166751;5;0;0;0;0;.00nan;0;0
2103;163695;9;53;2;0;2;1.000;296000;0
2103;175092;9;55;42;6;36;.857;3304000;0
2104;183844;29;0;0;0;0;.00nan;0;0
2104;37818;29;92;52;2;50;.962;3600000;0
2104;143156;21;54;23;3;20;.870;3523000;0
2104;157189;21;0;0;0;0;.00nan;0;0
2105;15;30;0;0;0;0;.00nan;0;0
2105;2059;23;0;0;0;0;.00nan;0;0
2105;17043;30;58;19;3;16;.842;3592000;0
2105;78573;23;89;36;2;34;.944;3600000;0
2106;165582;24;67;14;1;13;.929;3600000;0
2106;77955;28;0;0;0;0;.00nan;0;0
2106;85437;28;71;37;3;34;.919;3567000;0
2106;85727;24;0;0;0;0;.00nan;0;0
2107;163423;26;0;0;0;0;.00nan;0;0
2107;179154;26;70;26;2;24;.923;3703000;0
2107;59540;15;0;0;0;0;.00nan;0;0
2107;71565;15;76;20;1;19;.950;3703000;0
2108;556;3;66;45;5;40;.889;3527000;0
2108;178413;17;0;0;0;0;.00nan;0;0
2108;179344;3;0;0;0;0;.00nan;0;0
2108;146862;17;53;21;3;18;.857;3600000;0
2109;168712;14;56;28;4;24;.857;3600000;0
2109;175912;14;0;0;0;0;.00nan;0;0
2109;190465;33;0;0;0;0;.00nan;0;0
2109;86192;33;77;36;5;31;.861;3578000;0
2110;779;5;0;0;0;0;.00nan;0;0
2110;166751;5;56;45;5;40;.889;3600000;0
2110;179950;4838;0;0;0;0;.00nan;0;0
2110;143749;4838;100;26;0;26;1.000;3600000;0
2111;171838;31;100;40;2;38;.950;3615000;0
2111;170314;25;0;0;0;0;.00nan;0;0
2111;170977;31;0;0;0;0;.00nan;0;0
2111;148958;25;58;21;3;18;.857;3615000;0
2112;3928;12;0;0;0;0;.00nan;0;0
2112;13337;32;0;0;0;0;.00nan;0;0
2112;20432;32;77;24;1;23;.958;3600000;0
2112;91178;12;88;38;2;36;.947;3586000;0
2113;166646;16;0;0;0;0;.00nan;0;0
2113;50065;16;73;29;2;27;.931;4200000;0
2113;57338;35;73;33;2;31;.939;4200000;0
2113;141998;35;0;0;0;0;.00nan;0;0
2114;167642;18;0;0;0;0;.00nan;0;0
2114;13714;8;0;0;0;0;.00nan;0;0
2114;18213;8;98;31;1;30;.968;3600000;0
2114;173727;18;47;22;3;19;.864;3540000;0
2115;676;34;88;27;1;26;.963;3600000;0
2115;2059;23;76;37;3;34;.919;3583000;0
2115;78573;23;0;0;0;0;.00nan;0;0
2115;78806;34;0;0;0;0;.00nan;0;0
2116;67;11;0;0;0;0;.00nan;0;0
2116;187537;19;0;0;0;0;.00nan;0;0
2116;163565;19;65;17;1;16;.941;3600000;0
2116;46468;11;29;35;6;29;.829;3600000;0
2117;163195;0;60;26;3;23;.885;3600000;0
2117;190465;33;44;32;5;27;.844;3073000;0
2117;86192;33;53;9;1;8;.889;527000;0
2117;139409;0;0;0;0;0;.00nan;0;0
2118;166591;20;0;0;0;0;.00nan;0;0
2118;183844;29;46;24;4;20;.833;3548000;0
2118;37818;29;0;0;0;0;.00nan;0;0
2118;86697;20;87;43;3;40;.930;3600000;0
2119;184770;22;0;0;0;0;.00nan;0;0
2119;143156;21;98;53;3;50;.943;3576000;0
2119;143473;22;74;19;1;18;.947;3600000;0
2119;157189;21;0;0;0;0;.00nan;0;0
2120;163695;9;0;0;0;0;.00nan;0;0
2120;166381;27;0;0;0;0;.00nan;0;0
2120;175092;9;89;51;3;48;.941;3600000;0
2120;175660;27;52;29;4;25;.862;3596000;0
2121;169868;4182;0;0;0;0;.00nan;0;0
2121;90164;10;0;0;0;0;.00nan;0;0
2121;147945;4182;98;30;1;29;.967;3600000;0
2121;152717;10;87;42;2;40;.952;3558000;0
2122;15;30;0;0;0;0;.00nan;0;0
2122;187537;19;80;27;2;25;.926;3600000;0
2122;163565;19;0;0;0;0;.00nan;0;0
2122;17043;30;70;27;3;24;.889;3600000;0
2123;556;3;55;40;5;35;.875;3600000;0
2123;179344;3;0;0;0;0;.00nan;0;0
2123;59540;15;83;27;1;26;.963;3600000;0
2123;71565;15;0;0;0;0;.00nan;0;0
2124;163423;26;0;0;0;0;.00nan;0;0
2124;179154;26;78;27;1;26;.963;3600000;0
2124;57338;35;29;28;5;23;.821;3600000;0
2124;141998;35;0;0;0;0;.00nan;0;0
2125;178413;17;0;0;0;0;.00nan;0;0
2125;77955;28;0;0;0;0;.00nan;0;0
2125;85437;28;69;39;4;35;.897;3513000;0
2125;146862;17;71;30;2;28;.933;3600000;0
2126;779;5;69;46;4;42;.913;3522000;0
2126;166751;5;0;0;0;0;.00nan;0;0
2126;166381;27;59;16;2;14;.875;3600000;0
2126;175660;27;0;0;0;0;.00nan;0;0
2127;166591;20;55;28;4;24;.857;3972000;0
2127;171838;31;0;0;0;0;.00nan;0;0
2127;170977;31;84;49;3;46;.939;3941000;0
2127;86697;20;0;0;0;0;.00nan;0;0
2128;163695;9;67;50;6;44;.880;3600000;0
2128;175092;9;0;0;0;0;.00nan;0;0
2128;179950;4838;0;0;0;0;.00nan;0;0
2128;143749;4838;78;22;1;21;.955;3600000;0
2129;165582;24;80;37;3;34;.919;3600000;0
2129;85727;24;0;0;0;0;.00nan;0;0
2129;143156;21;0;0;0;0;.00nan;0;0
2129;157189;21;100;26;0;26;1.000;3600000;0
2130;676;34;0;0;0;0;.00nan;0;0
2130;163195;0;0;0;0;0;.00nan;0;0
2130;78806;34;88;33;1;32;.970;3600000;0
2130;139409;0;91;39;3;36;.923;3590000;0
2131;166646;16;67;23;2;21;.913;3567000;0
2131;3928;12;80;21;1;20;.952;3600000;0
2131;50065;16;0;0;0;0;.00nan;0;0
2131;91178;12;0;0;0;0;.00nan;0;0
2132;13337;32;56;5;0;5;1.000;547000;0
2132;13714;8;49;35;5;30;.857;3600000;0
2132;18213;8;0;0;0;0;.00nan;0;0
2132;20432;32;31;29;6;23;.793;2996000;0
2133;67;11;57;29;4;25;.862;4200000;0
2133;167642;18;0;0;0;0;.00nan;0;0
2133;173727;18;53;36;4;32;.889;4200000;0
2133;46468;11;0;0;0;0;.00nan;0;0
2134;2059;23;82;29;2;27;.931;3600000;0
2134;78573;23;0;0;0;0;.00nan;0;0
2134;90164;10;79;44;3;41;.932;3567000;0
2134;152717;10;0;0;0;0;.00nan;0;0
2135;183844;29;92;24;1;23;.958;3600000;0
2135;170314;25;52;20;3;17;.850;3517000;0
2135;37818;29;0;0;0;0;.00nan;0;0
2135;148958;25;0;0;0;0;.00nan;0;0
2136;163423;26;42;34;6;28;.824;2547000;0
2136;179154;26;36;12;3;9;.750;1053000;0
2136;190465;33;0;0;0;0;.00nan;0;0
2136;86192;33;69;27;2;25;.926;3600000;0
2137;178413;17;43;26;4;22;.846;4190000;0
2137;179950;4838;0;0;0;0;.00nan;0;0
2137;143749;4838;70;48;5;43;.896;4190000;0
2137;146862;17;0;0;0;0;.00nan;0;0
2138;168712;14;20;9;4;5;.556;773000;0
2138;175912;14;98;32;0;32;1.000;2796000;0
2138;59540;15;0;0;0;0;.00nan;0;0
2138;71565;15;81;30;2;28;.933;3600000;0
2139;187537;19;69;36;3;33;.917;3123000;0
2139;163565;19;31;9;3;6;.667;477000;0
2139;169868;4182;72;24;2;22;.917;3600000;0
2139;147945;4182;0;0;0;0;.00nan;0;0
2140;67;11;51;2;0;2;1.000;329000;0
2140;165582;24;0;0;0;0;.00nan;0;0
2140;46468;11;47;29;5;24;.828;3185000;0
2140;85727;24;69;28;3;25;.893;3600000;0
2141;167642;18;94;40;1;39;.975;3600000;0
2141;13714;8;81;29;2;27;.931;3600000;0
2141;18213;8;0;0;0;0;.00nan;0;0
2141;173727;18;0;0;0;0;.00nan;0;0
2142;163195;0;0;0;0;0;.00nan;0;0
2142;77955;28;41;2;1;1;.500;822000;0
2142;85437;28;39;37;7;30;.811;2778000;0
2142;139409;0;92;22;0;22;1.000;3600000;0
2143;676;34;66;8;0;8;1.000;993000;0
2143;59540;15;90;28;1;27;.964;3600000;0
2143;71565;15;0;0;0;0;.00nan;0;0
2143;78806;34;37;27;6;21;.778;2607000;0
2144;166381;27;0;0;0;0;.00nan;0;0
2144;178413;17;0;0;0;0;.00nan;0;0
2144;175660;27;65;23;2;21;.913;3600000;0
2144;146862;17;78;36;3;33;.917;3550000;0
2145;15;30;0;0;0;0;.00nan;0;0
2145;17043;30;69;38;4;34;.895;3600000;0
2145;143156;21;0;0;0;0;.00nan;0;0
2145;157189;21;83;27;1;26;.963;3600000;0
2146;3928;12;0;0;0;0;.00nan;0;0
2146;163423;26;0;0;0;0;.00nan;0;0
2146;179154;26;78;24;1;23;.958;3545000;0
2146;91178;12;100;34;0;34;1.000;3600000;0
2147;166646;16;0;0;0;0;.00nan;0;0
2147;169868;4182;0;0;0;0;.00nan;0;0
2147;50065;16;56;44;5;39;.886;4200000;0
2147;147945;4182;53;38;5;33;.868;4200000;0
2148;171838;31;71;40;4;36;.900;3558000;0
2148;13337;32;76;32;2;30;.938;3600000;0
2148;20432;32;0;0;0;0;.00nan;0;0
2148;170977;31;0;0;0;0;.00nan;0;0
2149;184770;22;0;0;0;0;.00nan;0;0
2149;57338;35;97;50;2;48;.960;4200000;0
2149;141998;35;0;0;0;0;.00nan;0;0
2149;143473;22;60;18;2;16;.889;4200000;0
2150;187537;19;0;0;0;0;.00nan;0;0
2150;163565;19;90;40;2;38;.950;3571000;0
2150;183844;29;0;0;0;0;.00nan;0;0
2150;37818;29;100;38;1;37;.974;3600000;0
2151;166591;20;0;0;0;0;.00nan;0;0
2151;86697;20;100;36;0;36;1.000;3600000;0
2151;90164;10;0;0;0;0;.00nan;0;0
2151;152717;10;77;24;1;23;.958;3589000;0
2152;67;11;77;26;2;24;.923;3645000;0
2152;167642;18;0;0;0;0;.00nan;0;0
2152;173727;18;81;27;1;26;.963;3645000;0
2152;46468;11;0;0;0;0;.00nan;0;0
2153;13714;8;0;0;0;0;.00nan;0;0
2153;18213;8;79;27;2;25;.926;3600000;0
2153;169868;4182;64;38;4;34;.895;3600000;0
2153;147945;4182;0;0;0;0;.00nan;0;0
2154;165582;24;0;0;0;0;.00nan;0;0
2154;179950;4838;0;0;0;0;.00nan;0;0
2154;85727;24;66;39;4;35;.897;4200000;0
2154;143749;4838;68;35;4;31;.886;4200000;0
2155;556;3;65;29;4;25;.862;3600000;0
2155;779;5;0;0;0;0;.00nan;0;0
2155;166751;5;43;33;5;28;.848;3541000;0
2155;179344;3;0;0;0;0;.00nan;0;0
2156;3928;12;0;0;0;0;.00nan;0;0
2156;59540;15;0;0;0;0;.00nan;0;0
2156;71565;15;92;38;2;36;.947;3600000;0
2156;91178;12;41;30;6;24;.800;3600000;0
2157;15;30;0;0;0;0;.00nan;0;0
2157;178413;17;0;0;0;0;.00nan;0;0
2157;17043;30;72;25;1;24;.960;4200000;0
2157;146862;17;97;64;1;63;.984;4200000;0
2158;676;34;93;28;1;27;.964;3600000;0
2158;184770;22;0;0;0;0;.00nan;0;0
2158;78806;34;0;0;0;0;.00nan;0;0
2158;143473;22;69;28;3;25;.893;3514000;0
2159;171838;31;62;51;6;45;.882;3600000;0
2159;170314;25;0;0;0;0;.00nan;0;0
2159;170977;31;0;0;0;0;.00nan;0;0
2159;148958;25;60;15;1;14;.933;3600000;0
2160;166381;27;0;0;0;0;.00nan;0;0
2160;175660;27;54;18;2;16;.889;3600000;0
2160;179950;4838;0;0;0;0;.00nan;0;0
2160;143749;4838;60;57;8;49;.860;3600000;0
2161;167642;18;83;33;2;31;.939;3600000;0
2161;165582;24;58;31;4;27;.871;3532000;0
2161;173727;18;0;0;0;0;.00nan;0;0
2161;85727;24;0;0;0;0;.00nan;0;0
2162;2059;23;0;0;0;0;.00nan;0;0
2162;183844;29;0;0;0;0;.00nan;0;0
2162;37818;29;60;21;2;19;.905;3773000;0
2162;78573;23;68;28;3;25;.893;3773000;0
2163;187537;19;75;22;1;21;.955;3600000;0
2163;163565;19;0;0;0;0;.00nan;0;0
2163;13337;32;0;0;0;0;.00nan;0;0
2163;20432;32;83;44;3;41;.932;3551000;0
2164;556;3;0;0;0;0;.00nan;0;0
2164;163695;9;0;0;0;0;.00nan;0;0
2164;179344;3;62;37;5;32;.865;3585000;0
2164;175092;9;85;41;3;38;.927;3600000;0
2165;163195;0;0;0;0;0;.00nan;0;0
2165;57338;35;54;30;4;26;.867;3600000;0
2165;139409;0;87;26;1;25;.962;3600000;0
2165;141998;35;0;0;0;0;.00nan;0;0
2166;183844;29;26;23;5;18;.783;2011000;0
2166;169868;4182;0;0;0;0;.00nan;0;0
2166;37818;29;61;18;2;16;.889;1589000;0
2166;147945;4182;56;29;4;25;.862;3600000;0
2167;779;5;91;40;2;38;.950;3600000;0
2167;166751;5;0;0;0;0;.00nan;0;0
2167;190465;33;62;34;3;31;.912;3543000;0
2167;86192;33;0;0;0;0;.00nan;0;0
2168;15;30;0;0;0;0;.00nan;0;0
2168;17043;30;90;28;1;27;.964;3600000;0
2168;90164;10;55;47;6;41;.872;3600000;0
2168;152717;10;0;0;0;0;.00nan;0;0
2169;166646;16;0;0;0;0;.00nan;0;0
2169;170314;25;54;28;4;24;.857;3551000;0
2169;50065;16;81;27;2;25;.926;3600000;0
2169;148958;25;0;0;0;0;.00nan;0;0
2170;67;11;0;0;0;0;.00nan;0;0
2170;171838;31;84;32;1;31;.969;4200000;0
2170;170977;31;0;0;0;0;.00nan;0;0
2170;46468;11;96;53;1;52;.981;4200000;0
2171;178413;17;77;25;1;24;.960;2422000;0
2171;77955;28;56;31;4;27;.871;3600000;0
2171;85437;28;0;0;0;0;.00nan;0;0
2171;146862;17;31;14;4;10;.714;1120000;0
2172;676;34;0;0;0;0;.00nan;0;0
2172;166591;20;0;0;0;0;.00nan;0;0
2172;78806;34;74;20;1;19;.950;3600000;0
2172;86697;20;63;30;2;28;.933;3543000;0
2173;165582;24;0;0;0;0;.00nan;0;0
2173;166381;27;100;23;0;23;1.000;3600000;0
2173;175660;27;0;0;0;0;.00nan;0;0
2173;85727;24;70;44;4;40;.909;3600000;0
2174;168712;14;82;48;5;43;.896;3600000;0
2174;184770;22;0;0;0;0;.00nan;0;0
2174;175912;14;0;0;0;0;.00nan;0;0
2174;143473;22;63;13;1;12;.923;3600000;0
2175;3928;12;0;0;0;0;.00nan;0;0
2175;57338;35;52;4;0;4;1.000;658000;0
2175;91178;12;72;24;2;22;.917;3600000;0
2175;141998;35;51;30;6;24;.800;2942000;0
2176;59540;15;81;21;1;20;.952;3600000;0
2176;71565;15;0;0;0;0;.00nan;0;0
2176;143156;21;76;43;5;38;.884;3600000;0
2176;157189;21;0;0;0;0;.00nan;0;0
2177;163423;26;0;0;0;0;.00nan;0;0
2177;13714;8;48;23;3;20;.870;3586000;0
2177;18213;8;0;0;0;0;.00nan;0;0
2177;179154;26;84;29;2;27;.931;3600000;0
2178;167642;18;0;0;0;0;.00nan;0;0
2178;173727;18;47;39;6;33;.846;3600000;0
2178;179950;4838;0;0;0;0;.00nan;0;0
2178;143749;4838;71;19;1;18;.947;3600000;0
2179;2059;23;0;0;0;0;.00nan;0;0
2179;13337;32;0;0;0;0;.00nan;0;0
2179;20432;32;57;33;5;28;.848;3600000;0
2179;78573;23;32;34;7;27;.794;3527000;0
2180;163695;9;77;36;4;32;.889;3600000;0
2180;175092;9;0;0;0;0;.00nan;0;0
2180;190465;33;0;0;0;0;.00nan;0;0
2180;86192;33;81;20;1;19;.950;3600000;0
2181;59540;15;0;0;0;0;.00nan;0;0
2181;71565;15;18;24;6;18;.750;3600000;0
2181;90164;10;0;0;0;0;.00nan;0;0
2181;152717;10;71;36;3;33;.917;3600000;0
2182;15;30;0;0;0;0;.00nan;0;0
2182;676;34;86;37;2;35;.946;3600000;0
2182;17043;30;69;32;3;29;.906;3550000;0
2182;78806;34;0;0;0;0;.00nan;0;0
2183;163195;0;0;0;0;0;.00nan;0;0
2183;170314;25;0;0;0;0;.00nan;0;0
2183;139409;0;71;27;2;25;.926;3550000;0
2183;148958;25;86;32;1;31;.969;3600000;0
2184;13337;32;0;0;0;0;.00nan;0;0
2184;20432;32;72;40;4;36;.900;3576000;0
2184;169868;4182;0;0;0;0;.00nan;0;0
2184;147945;4182;66;25;2;23;.920;3600000;0
2185;67;11;83;24;1;23;.958;3600000;0
2185;183844;29;0;0;0;0;.00nan;0;0
2185;37818;29;81;33;3;30;.909;3548000;0
2185;46468;11;0;0;0;0;.00nan;0;0
2186;171838;31;100;35;1;34;.971;3600000;0
2186;170977;31;0;0;0;0;.00nan;0;0
2186;77955;28;74;27;2;25;.926;3596000;0
2186;85437;28;0;0;0;0;.00nan;0;0
2187;163423;26;0;0;0;0;.00nan;0;0
2187;168712;14;57;24;3;21;.875;3544000;0
2187;179154;26;66;28;2;26;.929;3600000;0
2187;175912;14;0;0;0;0;.00nan;0;0
2188;166646;16;91;33;1;32;.970;3567000;0
2188;13714;8;100;27;0;27;1.000;3600000;0
2188;18213;8;0;0;0;0;.00nan;0;0
2188;50065;16;0;0;0;0;.00nan;0;0
2189;2059;23;100;50;1;49;.980;3600000;0
2189;3928;12;54;18;2;16;.889;3550000;0
2189;78573;23;0;0;0;0;.00nan;0;0
2189;91178;12;0;0;0;0;.00nan;0;0
2190;167642;18;0;0;0;0;.00nan;0;0
2190;166381;27;62;27;3;24;.889;3600000;0
2190;173727;18;88;37;2;35;.946;3600000;0
2190;175660;27;0;0;0;0;.00nan;0;0
2191;187537;19;62;28;3;25;.893;3766000;0
2191;163565;19;0;0;0;0;.00nan;0;0
2191;179950;4838;0;0;0;0;.00nan;0;0
2191;143749;4838;58;32;4;28;.875;3766000;0
2192;67;11;0;0;0;0;.00nan;0;0
2192;166591;20;0;0;0;0;.00nan;0;0
2192;46468;11;84;33;2;31;.939;3750000;0
2192;86697;20;81;36;3;33;.917;3750000;0
2193;170314;25;92;44;2;42;.955;3738000;0
2193;59540;15;74;20;1;19;.950;3738000;0
2193;71565;15;0;0;0;0;.00nan;0;0
2193;148958;25;0;0;0;0;.00nan;0;0
2194;556;3;63;45;6;39;.867;3224000;0
2194;179344;3;50;6;1;5;.833;376000;0
2194;184770;22;0;0;0;0;.00nan;0;0
2194;143473;22;50;19;3;16;.842;3600000;0
2195;183844;29;0;0;0;0;.00nan;0;0
2195;37818;29;65;27;3;24;.889;3600000;0
2195;77955;28;61;38;5;33;.868;3515000;0
2195;85437;28;0;0;0;0;.00nan;0;0
2196;676;34;71;26;2;24;.923;4200000;0
2196;168712;14;75;28;2;26;.929;4200000;0
2196;175912;14;0;0;0;0;.00nan;0;0
2196;78806;34;0;0;0;0;.00nan;0;0
2197;171838;31;94;45;2;43;.956;3600000;0
2197;170977;31;0;0;0;0;.00nan;0;0
2197;57338;35;66;36;3;33;.917;3555000;0
2197;141998;35;0;0;0;0;.00nan;0;0
2198;163195;0;0;0;0;0;.00nan;0;0
2198;139409;0;57;40;5;35;.875;3565000;0
2198;143156;21;60;36;4;32;.889;3600000;0
2198;157189;21;0;0;0;0;.00nan;0;0
2199;165582;24;0;0;0;0;.00nan;0;0
2199;85727;24;52;28;4;24;.857;3600000;0
2199;90164;10;70;40;5;35;.875;3596000;0
2199;152717;10;0;0;0;0;.00nan;0;0
2200;3928;12;75;30;2;28;.933;3600000;0
2200;13337;32;0;0;0;0;.00nan;0;0
2200;20432;32;51;28;4;24;.857;3513000;0
2200;91178;12;0;0;0;0;.00nan;0;0
2201;166646;16;0;0;0;0;.00nan;0;0
2201;166381;27;0;0;0;0;.00nan;0;0
2201;175660;27;60;28;3;25;.893;3600000;0
2201;50065;16;58;33;4;29;.879;3555000;0
2202;15;30;0;0;0;0;.00nan;0;0
2202;163423;26;0;0;0;0;.00nan;0;0
2202;17043;30;78;31;3;28;.903;4200000;0
2202;179154;26;96;50;3;47;.940;4200000;0
2203;178413;17;0;0;0;0;.00nan;0;0
2203;169868;4182;0;0;0;0;.00nan;0;0
2203;146862;17;74;29;3;26;.897;3580000;0
2203;147945;4182;86;41;2;39;.951;3600000;0
2204;13714;8;71;18;1;17;.944;3600000;0
2204;18213;8;0;0;0;0;.00nan;0;0
2204;179950;4838;0;0;0;0;.00nan;0;0
2204;143749;4838;55;28;4;24;.857;3600000;0
2205;187537;19;59;21;2;19;.905;3600000;0
2205;163565;19;0;0;0;0;.00nan;0;0
2205;167642;18;22;10;4;6;.600;942000;0
2205;173727;18;98;39;1;38;.974;2658000;0
2206;556;3;65;34;4;30;.882;3600000;0
2206;179344;3;0;0;0;0;.00nan;0;0
2206;77955;28;0;0;0;0;.00nan;0;0
2206;85437;28;60;24;3;21;.875;3600000;0
2207;168712;14;74;36;3;33;.917;3543000;0
2207;175912;14;0;0;0;0;.00nan;0;0
2207;90164;10;0;0;0;0;.00nan;0;0
2207;152717;10;64;25;2;23;.920;3600000;0
2208;163695;9;0;0;0;0;.00nan;0;0
2208;170314;25;0;0;0;0;.00nan;0;0
2208;175092;9;56;41;6;35;.854;3600000;0
2208;148958;25;78;25;1;24;.960;3600000;0
2209;184770;22;74;28;2;26;.929;3600000;0
2209;59540;15;71;41;5;36;.878;3600000;0
2209;71565;15;0;0;0;0;.00nan;0;0
2209;143473;22;0;0;0;0;.00nan;0;0
2210;166646;16;0;0;0;0;.00nan;0;0
2210;13337;32;0;0;0;0;.00nan;0;0
2210;20432;32;42;35;6;29;.829;3600000;0
2210;50065;16;50;18;3;15;.833;3600000;0
2211;67;11;85;49;4;45;.918;4200000;0
2211;46468;11;0;0;0;0;.00nan;0;0
2211;143156;21;66;34;4;30;.882;4200000;0
2211;157189;21;0;0;0;0;.00nan;0;0
2212;2059;23;56;43;6;37;.860;3600000;0
2212;169868;4182;0;0;0;0;.00nan;0;0
2212;78573;23;0;0;0;0;.00nan;0;0
2212;147945;4182;75;28;2;26;.929;3600000;0
2213;187537;19;61;18;1;17;.944;2465000;0
2213;163565;19;40;22;4;18;.818;1062000;0
2213;178413;17;0;0;0;0;.00nan;0;0
2213;146862;17;55;28;4;24;.857;3600000;0
2214;676;34;76;27;1;26;.963;3600000;0
2214;163195;0;32;30;6;24;.800;3600000;0
2214;78806;34;0;0;0;0;.00nan;0;0
2214;139409;0;0;0;0;0;.00nan;0;0
2215;779;5;0;0;0;0;.00nan;0;0
2215;166751;5;76;44;3;41;.932;3600000;0
2215;165582;24;0;0;0;0;.00nan;0;0
2215;85727;24;91;17;0;17;1.000;3600000;0
2216;166591;20;0;0;0;0;.00nan;0;0
2216;171838;31;71;27;2;25;.926;3531000;0
2216;170977;31;0;0;0;0;.00nan;0;0
2216;86697;20;93;31;1;30;.968;3600000;0
2217;183844;29;0;0;0;0;.00nan;0;0
2217;37818;29;83;36;2;34;.944;3600000;0
2217;57338;35;97;44;3;41;.932;3547000;0
2217;141998;35;0;0;0;0;.00nan;0;0
2218;163423;26;68;12;0;12;1.000;1258000;0
2218;166381;27;62;14;1;13;.929;3600000;0
2218;179154;26;45;26;4;22;.846;2342000;0
2218;175660;27;0;0;0;0;.00nan;0;0
2219;13714;8;82;23;1;22;.957;3600000;0
2219;18213;8;0;0;0;0;.00nan;0;0
2219;190465;33;0;0;0;0;.00nan;0;0
2219;86192;33;72;24;2;22;.917;3558000;0
2220;167642;18;0;0;0;0;.00nan;0;0
2220;173727;18;64;25;2;23;.920;3600000;0
2220;179950;4838;0;0;0;0;.00nan;0;0
2220;143749;4838;24;18;5;13;.722;3600000;0
2221;168712;14;0;0;0;0;.00nan;0;0
2221;175912;14;49;19;3;16;.842;3600000;0
2221;77955;28;49;35;5;30;.857;3513000;0
2221;85437;28;0;0;0;0;.00nan;0;0
2222;2059;23;0;0;0;0;.00nan;0;0
2222;178413;17;0;0;0;0;.00nan;0;0
2222;78573;23;81;46;4;42;.913;3600000;0
2222;146862;17;77;27;1;26;.963;3600000;0
2223;163195;0;80;47;3;44;.936;3188000;0
2223;184770;22;0;0;0;0;.00nan;0;0
2223;139409;0;28;7;3;4;.571;412000;0
2223;143473;22;56;18;2;16;.889;3600000;0
2224;676;34;0;0;0;0;.00nan;0;0
2224;163695;9;33;18;4;14;.778;731000;0
2224;175092;9;47;27;4;23;.852;2869000;0
2224;78806;34;50;26;4;22;.846;3600000;0
2225;165582;24;0;0;0;0;.00nan;0;0
2225;85727;24;78;25;2;23;.920;3600000;0
2225;90164;10;61;46;5;41;.891;3600000;0
2225;152717;10;0;0;0;0;.00nan;0;0
2226;13714;8;0;0;0;0;.00nan;0;0
2226;166381;27;0;0;0;0;.00nan;0;0
2226;18213;8;74;36;3;33;.917;3586000;0
2226;175660;27;83;32;2;30;.938;3600000;0
2227;187537;19;0;0;0;0;.00nan;0;0
2227;163565;19;61;33;4;29;.879;3600000;0
2227;179950;4838;0;0;0;0;.00nan;0;0
2227;143749;4838;99;50;3;47;.940;3600000;0
2228;15;30;72;36;3;33;.917;4200000;0
2228;3928;12;67;36;3;33;.917;4200000;0
2228;17043;30;0;0;0;0;.00nan;0;0
2228;91178;12;0;0;0;0;.00nan;0;0
2229;556;3;78;35;2;33;.943;3600000;0
2229;179344;3;0;0;0;0;.00nan;0;0
2229;190465;33;0;0;0;0;.00nan;0;0
2229;86192;33;58;31;4;27;.871;3554000;0
2230;13337;32;58;6;0;6;1.000;264000;0
2230;20432;32;58;42;6;36;.857;3336000;0
2230;170314;25;62;25;3;22;.880;3600000;0
2230;148958;25;0;0;0;0;.00nan;0;0
2231;166591;20;0;0;0;0;.00nan;0;0
2231;59540;15;53;14;2;12;.857;3600000;0
2231;71565;15;0;0;0;0;.00nan;0;0
2231;86697;20;71;40;3;37;.925;3585000;0
2232;166646;16;68;21;2;19;.905;3600000;0
2232;50065;16;0;0;0;0;.00nan;0;0
2232;57338;35;55;32;4;28;.875;3573000;0
2232;141998;35;0;0;0;0;.00nan;0;0
2233;67;11;0;0;0;0;.00nan;0;0
2233;169868;4182;0;0;0;0;.00nan;0;0
2233;46468;11;73;33;3;30;.909;3600000;0
2233;147945;4182;53;36;5;31;.861;3515000;0
2234;59540;15;0;0;0;0;.00nan;0;0
2234;71565;15;66;29;4;25;.862;3600000;0
2234;77955;28;50;47;7;40;.851;3600000;0
2234;85437;28;0;0;0;0;.00nan;0;0
2235;163195;0;0;0;0;0;.00nan;0;0
2235;168712;14;97;22;0;22;1.000;3600000;0
2235;175912;14;0;0;0;0;.00nan;0;0
2235;139409;0;97;37;2;35;.946;3562000;0
2236;779;5;0;0;0;0;.00nan;0;0
2236;166751;5;80;38;3;35;.921;3573000;0
2236;183844;29;0;0;0;0;.00nan;0;0
2236;37818;29;76;23;1;22;.957;3600000;0
2237;171838;31;95;45;3;42;.933;3600000;0
2237;13714;8;38;27;5;22;.815;3554000;0
2237;18213;8;0;0;0;0;.00nan;0;0
2237;170977;31;0;0;0;0;.00nan;0;0
2238;15;30;0;0;0;0;.00nan;0;0
2238;166381;27;86;37;2;35;.946;3600000;0
2238;17043;30;92;45;3;42;.933;3588000;0
2238;175660;27;0;0;0;0;.00nan;0;0
2239;187537;19;79;24;1;23;.958;3600000;0
2239;3284;21;55;26;3;23;.885;3530000;0
2239;163565;19;0;0;0;0;.00nan;0;0
2239;143156;21;0;0;0;0;.00nan;0;0
2240;165582;24;0;0;0;0;.00nan;0;0
2240;184770;22;0;0;0;0;.00nan;0;0
2240;85727;24;99;47;2;45;.957;3600000;0
2240;143473;22;25;21;5;16;.762;3600000;0
2241;166591;20;0;0;0;0;.00nan;0;0
2241;86697;20;90;41;2;39;.951;3600000;0
2241;90164;10;61;25;3;22;.880;3598000;0
2241;152717;10;0;0;0;0;.00nan;0;0
2242;163695;9;0;0;0;0;.00nan;0;0
2242;183844;29;77;30;2;28;.933;3529000;0
2242;175092;9;100;35;0;35;1.000;3600000;0
2242;37818;29;0;0;0;0;.00nan;0;0
2243;13337;32;0;0;0;0;.00nan;0;0
2243;20432;32;48;26;4;22;.846;3600000;0
2243;190465;33;100;25;0;25;1.000;3600000;0
2243;86192;33;0;0;0;0;.00nan;0;0
2244;676;34;0;0;0;0;.00nan;0;0
2244;166646;16;0;0;0;0;.00nan;0;0
2244;50065;16;86;42;3;39;.929;3659000;0
2244;78806;34;60;20;2;18;.900;3659000;0
2245;163423;26;0;0;0;0;.00nan;0;0
2245;179154;26;92;36;2;34;.944;3717000;0
2245;57338;35;67;35;3;32;.914;3717000;0
2245;141998;35;0;0;0;0;.00nan;0;0
2246;167642;18;0;0;0;0;.00nan;0;0
2246;173727;18;90;43;3;40;.930;3527000;0
2246;170314;25;75;21;1;20;.952;3600000;0
2246;148958;25;0;0;0;0;.00nan;0;0
2247;171838;31;85;40;3;37;.925;3579000;0
2247;3928;12;57;16;2;14;.875;3600000;0
2247;170977;31;0;0;0;0;.00nan;0;0
2247;91178;12;0;0;0;0;.00nan;0;0
2248;15;30;0;0;0;0;.00nan;0;0
2248;67;11;0;0;0;0;.00nan;0;0
2248;17043;30;90;17;0;17;1.000;3600000;0
2248;46468;11;52;40;5;35;.875;3600000;0
2249;169868;4182;59;6;0;6;1.000;269000;0
2249;179950;4838;0;0;0;0;.00nan;0;0
2249;143749;4838;64;29;3;26;.897;3600000;0
2249;147945;4182;47;36;6;30;.833;3331000;0
2250;178413;17;0;0;0;0;.00nan;0;0
2250;59540;15;0;0;0;0;.00nan;0;0
2250;71565;15;70;18;1;17;.944;3600000;0
2250;146862;17;68;39;4;35;.897;3600000;0
2251;556;3;72;29;2;27;.931;3572000;0
2251;168712;14;98;37;1;36;.973;3600000;0
2251;179344;3;0;0;0;0;.00nan;0;0
2251;175912;14;0;0;0;0;.00nan;0;0
2252;2059;23;0;0;0;0;.00nan;0;0
2252;3284;21;71;25;2;23;.920;4200000;0
2252;78573;23;97;54;2;52;.963;4200000;0
2252;143156;21;0;0;0;0;.00nan;0;0
2253;187537;19;74;35;2;33;.943;4200000;0
2253;163565;19;0;0;0;0;.00nan;0;0
2253;77955;28;92;33;2;31;.939;4200000;0
2253;85437;28;0;0;0;0;.00nan;0;0
2254;166591;20;60;13;1;12;.923;1496000;0
2254;165582;24;0;0;0;0;.00nan;0;0
2254;85727;24;91;20;0;20;1.000;3600000;0
2254;86697;20;29;29;6;23;.793;2104000;0
2255;556;3;0;0;0;0;.00nan;0;0
2255;170314;25;100;35;0;35;1.000;3600000;0
2255;179344;3;37;27;5;22;.815;3600000;0
2255;148958;25;0;0;0;0;.00nan;0;0
2256;183844;29;0;0;0;0;.00nan;0;0
2256;178413;17;82;35;2;33;.943;3600000;0
2256;37818;29;69;40;4;36;.900;3600000;0
2256;146862;17;0;0;0;0;.00nan;0;0
2257;184770;22;0;0;0;0;.00nan;0;0
2257;90164;10;0;0;0;0;.00nan;0;0
2257;143473;22;43;20;3;17;.850;3600000;0
2257;152717;10;63;38;4;34;.895;3574000;0
2258;676;34;0;0;0;0;.00nan;0;0
2258;171838;31;22;10;4;6;.600;928000;0
2258;170977;31;72;21;1;20;.952;2672000;0
2258;78806;34;48;28;4;24;.857;3600000;0
2259;163695;9;60;10;0;10;1.000;364000;0
2259;167642;18;0;0;0;0;.00nan;0;0
2259;173727;18;83;40;3;37;.925;3600000;0
2259;175092;9;33;33;6;27;.818;3236000;0
2260;166646;16;0;0;0;0;.00nan;0;0
2260;190465;33;72;37;4;33;.892;3122000;0
2260;50065;16;34;21;5;16;.762;3621000;0
2260;86192;33;54;3;0;3;1.000;499000;0
2261;163195;0;0;0;0;0;.00nan;0;0
2261;13337;32;0;0;0;0;.00nan;0;0
2261;20432;32;50;41;5;36;.878;3580000;0
2261;139409;0;60;28;3;25;.893;3600000;0
2262;67;11;35;39;7;32;.821;3600000;0
2262;46468;11;0;0;0;0;.00nan;0;0
2262;57338;35;80;24;1;23;.958;3600000;0
2262;141998;35;0;0;0;0;.00nan;0;0
2263;3928;12;78;25;2;23;.920;3600000;0
2263;13714;8;64;26;3;23;.885;3600000;0
2263;18213;8;0;0;0;0;.00nan;0;0
2263;91178;12;0;0;0;0;.00nan;0;0
2264;163423;26;0;0;0;0;.00nan;0;0
2264;166381;27;90;30;1;29;.967;3600000;0
2264;179154;26;84;44;3;41;.932;3515000;0
2264;175660;27;0;0;0;0;.00nan;0;0
2265;3284;21;0;0;0;0;.00nan;0;0
2265;169868;4182;0;0;0;0;.00nan;0;0
2265;143156;21;76;29;2;27;.931;3600000;0
2265;147945;4182;75;42;4;38;.905;3588000;0
2266;15;30;0;0;0;0;.00nan;0;0
2266;17043;30;63;32;4;28;.875;3600000;0
2266;179950;4838;0;0;0;0;.00nan;0;0
2266;143749;4838;100;41;0;41;1.000;3600000;0
2267;779;5;0;0;0;0;.00nan;0;0
2267;166751;5;88;43;4;39;.907;3600000;0
2267;59540;15;73;21;1;20;.952;3600000;0
2267;71565;15;0;0;0;0;.00nan;0;0
2268;187537;19;0;0;0;0;.00nan;0;0
2268;163565;19;59;35;5;30;.857;3600000;0
2268;184770;22;68;20;1;19;.950;3600000;0
2268;143473;22;0;0;0;0;.00nan;0;0
2269;171838;31;17;14;5;9;.643;1057000;0
2269;163423;26;0;0;0;0;.00nan;0;0
2269;170977;31;78;22;0;22;1.000;2543000;0
2269;179154;26;76;19;1;18;.947;3600000;0
2270;170314;25;100;38;1;37;.974;3717000;0
2270;57338;35;70;31;2;29;.935;3717000;0
2270;141998;35;0;0;0;0;.00nan;0;0
2270;148958;25;0;0;0;0;.00nan;0;0
2271;166646;16;48;23;4;19;.826;3635000;0
2271;168712;14;58;28;3;25;.893;3635000;0
2271;175912;14;0;0;0;0;.00nan;0;0
2271;50065;16;0;0;0;0;.00nan;0;0
2272;165582;24;0;0;0;0;.00nan;0;0
2272;183844;29;0;0;0;0;.00nan;0;0
2272;37818;29;91;39;2;37;.949;3552000;0
2272;85727;24;93;20;0;20;1.000;3600000;0
2273;166591;20;26;33;6;27;.818;3600000;0
2273;163195;0;0;0;0;0;.00nan;0;0
2273;86697;20;0;0;0;0;.00nan;0;0
2273;139409;0;85;38;2;36;.947;3600000;0
2274;556;3;78;33;2;31;.939;3600000;0
2274;178413;17;0;0;0;0;.00nan;0;0
2274;179344;3;0;0;0;0;.00nan;0;0
2274;146862;17;100;39;0;39;1.000;3600000;0
2275;779;5;85;46;3;43;.935;3600000;0
2275;166751;5;0;0;0;0;.00nan;0;0
2275;167642;18;0;0;0;0;.00nan;0;0
2275;173727;18;47;26;4;22;.846;3546000;0
2276;676;34;0;0;0;0;.00nan;0;0
2276;78806;34;70;14;1;13;.929;3600000;0
2276;90164;10;78;50;4;46;.920;3600000;0
2276;152717;10;0;0;0;0;.00nan;0;0
2277;163695;9;66;27;3;24;.889;3600000;0
2277;175092;9;0;0;0;0;.00nan;0;0
2277;77955;28;81;29;2;27;.931;3600000;0
2277;85437;28;0;0;0;0;.00nan;0;0
2278;3928;12;0;0;0;0;.00nan;0;0
2278;13337;32;0;0;0;0;.00nan;0;0
2278;20432;32;83;25;1;24;.960;3600000;0
2278;91178;12;78;23;2;21;.913;3565000;0
2279;13714;8;31;32;6;26;.813;3184000;0
2279;18213;8;59;7;0;7;1.000;342000;0
2279;169868;4182;0;0;0;0;.00nan;0;0
2279;147945;4182;51;29;4;25;.862;3600000;0
2280;166381;27;82;15;0;15;1.000;3600000;0
2280;175660;27;0;0;0;0;.00nan;0;0
2280;179950;4838;0;0;0;0;.00nan;0;0
2280;143749;4838;85;52;3;49;.942;3600000;0
2281;15;30;0;0;0;0;.00nan;0;0
2281;3284;21;40;35;6;29;.829;2836000;0
2281;17043;30;100;50;2;48;.960;3600000;0
2281;143156;21;49;2;0;2;1.000;764000;0
2282;170314;25;50;22;3;19;.864;3742000;0
2282;190465;33;0;0;0;0;.00nan;0;0
2282;86192;33;59;26;4;22;.846;3742000;0
2282;148958;25;0;0;0;0;.00nan;0;0
2283;187537;19;63;16;1;15;.938;3600000;0
2283;163565;19;0;0;0;0;.00nan;0;0
2283;168712;14;0;0;0;0;.00nan;0;0
2283;175912;14;94;42;2;40;.952;3546000;0
2284;59540;15;0;0;0;0;.00nan;0;0
2284;71565;15;65;21;2;19;.905;3600000;0
2284;77955;28;0;0;0;0;.00nan;0;0
2284;85437;28;55;37;5;32;.865;3561000;0
2285;166646;16;0;0;0;0;.00nan;0;0
2285;163195;0;0;0;0;0;.00nan;0;0
2285;50065;16;71;26;2;24;.923;3600000;0
2285;139409;0;86;44;3;41;.932;3558000;0
2286;2059;23;0;0;0;0;.00nan;0;0
2286;13714;8;0;0;0;0;.00nan;0;0
2286;18213;8;50;26;4;22;.846;3551000;0
2286;78573;23;66;34;3;31;.912;3600000;0
2287;676;34;0;0;0;0;.00nan;0;0
2287;78806;34;73;23;1;22;.957;3600000;0
2287;90164;10;0;0;0;0;.00nan;0;0
2287;152717;10;75;34;3;31;.912;3567000;0
2288;171838;31;0;0;0;0;.00nan;0;0
2288;163423;26;0;0;0;0;.00nan;0;0
2288;170977;31;55;37;4;33;.892;3600000;0
2288;179154;26;84;32;1;31;.969;3600000;0
2289;167642;18;0;0;0;0;.00nan;0;0
2289;178413;17;0;0;0;0;.00nan;0;0
2289;173727;18;74;31;3;28;.903;3560000;0
2289;146862;17;66;21;2;19;.905;3600000;0
2290;166591;20;0;0;0;0;.00nan;0;0
2290;57338;35;67;29;3;26;.897;3544000;0
2290;86697;20;99;45;1;44;.978;3600000;0
2290;141998;35;0;0;0;0;.00nan;0;0
2291;3284;21;54;31;5;26;.839;3600000;0
2291;3928;12;87;30;2;28;.933;3600000;0
2291;91178;12;0;0;0;0;.00nan;0;0
2291;143156;21;0;0;0;0;.00nan;0;0
2292;15;30;0;0;0;0;.00nan;0;0
2292;13337;32;0;0;0;0;.00nan;0;0
2292;17043;30;54;26;4;22;.846;4200000;0
2292;20432;32;75;53;4;49;.925;4200000;0
2293;556;3;77;24;2;22;.917;3600000;0
2293;163195;0;74;34;3;31;.912;3592000;0
2293;179344;3;0;0;0;0;.00nan;0;0
2293;139409;0;0;0;0;0;.00nan;0;0
2294;2059;23;0;0;0;0;.00nan;0;0
2294;59540;15;63;14;1;13;.929;3600000;0
2294;71565;15;0;0;0;0;.00nan;0;0
2294;78573;23;81;39;4;35;.897;3600000;0
2295;779;5;92;39;2;37;.949;3600000;0
2295;166751;5;0;0;0;0;.00nan;0;0
2295;168712;14;71;19;1;18;.947;3600000;0
2295;175912;14;0;0;0;0;.00nan;0;0
2296;187537;19;81;47;4;43;.915;4200000;0
2296;163565;19;0;0;0;0;.00nan;0;0
2296;165582;24;0;0;0;0;.00nan;0;0
2296;85727;24;40;27;4;23;.852;4200000;0
2297;166646;16;0;0;0;0;.00nan;0;0
2297;170314;25;74;26;2;24;.923;3600000;0
2297;50065;16;56;33;4;29;.879;3595000;0
2297;148958;25;0;0;0;0;.00nan;0;0
2298;166381;27;56;32;4;28;.875;3600000;0
2298;175660;27;0;0;0;0;.00nan;0;0
2298;190465;33;76;37;3;34;.919;3600000;0
2298;86192;33;0;0;0;0;.00nan;0;0
2299;13714;8;76;31;2;29;.935;3528000;0
2299;18213;8;0;0;0;0;.00nan;0;0
2299;169868;4182;0;0;0;0;.00nan;0;0
2299;147945;4182;100;23;0;23;1.000;3600000;0
2300;184770;22;0;0;0;0;.00nan;0;0
2300;179950;4838;0;0;0;0;.00nan;0;0
2300;143473;22;76;30;2;28;.933;4200000;0
2300;143749;4838;100;47;2;45;.957;4200000;0
2301;163423;26;0;0;0;0;.00nan;0;0
2301;183844;29;0;0;0;0;.00nan;0;0
2301;179154;26;66;31;3;28;.903;3596000;0
2301;37818;29;95;36;2;34;.944;3600000;0
2302;676;34;81;38;3;35;.921;3560000;0
2302;171838;31;89;33;2;31;.939;3600000;0
2302;170977;31;0;0;0;0;.00nan;0;0
2302;78806;34;0;0;0;0;.00nan;0;0
2303;15;30;0;0;0;0;.00nan;0;0
2303;13337;32;0;0;0;0;.00nan;0;0
2303;17043;30;55;28;4;24;.857;3600000;0
2303;20432;32;85;24;1;23;.958;3600000;0
2304;67;11;0;0;0;0;.00nan;0;0
2304;166591;20;0;0;0;0;.00nan;0;0
2304;46468;11;93;24;0;24;1.000;3600000;0
2304;86697;20;33;29;6;23;.793;3600000;0
2305;163195;0;0;0;0;0;.00nan;0;0
2305;77955;28;76;30;3;27;.900;3600000;0
2305;85437;28;0;0;0;0;.00nan;0;0
2305;139409;0;82;14;0;14;1.000;3600000;0
2306;556;3;62;30;4;26;.867;3539000;0
2306;187537;19;64;24;2;22;.917;3600000;0
2306;163565;19;0;0;0;0;.00nan;0;0
2306;179344;3;0;0;0;0;.00nan;0;0
2307;2059;23;52;10;1;9;.900;1028000;0
2307;178413;17;0;0;0;0;.00nan;0;0
2307;78573;23;37;36;6;30;.833;2572000;0
2307;146862;17;74;24;2;22;.917;3600000;0
2308;779;5;0;0;0;0;.00nan;0;0
2308;166751;5;80;34;2;32;.941;3600000;0
2308;163695;9;0;0;0;0;.00nan;0;0
2308;175092;9;47;35;6;29;.829;3600000;0
2309;3284;21;51;35;4;31;.886;3973000;0
2309;163423;26;53;27;3;24;.889;3973000;0
2309;179154;26;0;0;0;0;.00nan;0;0
2309;143156;21;0;0;0;0;.00nan;0;0
2310;165582;24;91;39;2;37;.949;3600000;0
2310;59540;15;0;0;0;0;.00nan;0;0
2310;71565;15;34;24;5;19;.792;3600000;0
2310;85727;24;0;0;0;0;.00nan;0;0
2311;171838;31;47;8;1;7;.875;359000;0
2311;166646;16;100;26;0;26;1.000;3600000;0
2311;170977;31;34;39;6;33;.846;3241000;0
2311;50065;16;0;0;0;0;.00nan;0;0
2312;169868;4182;0;0;0;0;.00nan;0;0
2312;170314;25;37;33;6;27;.818;3600000;0
2312;147945;4182;75;36;3;33;.917;3600000;0
2312;148958;25;0;0;0;0;.00nan;0;0
2313;3928;12;92;29;1;28;.966;3600000;0
2313;90164;10;53;31;5;26;.839;3600000;0
2313;91178;12;0;0;0;0;.00nan;0;0
2313;152717;10;0;0;0;0;.00nan;0;0
2314;166591;20;82;42;4;38;.905;3749000;0
2314;166381;27;48;26;5;21;.808;3749000;0
2314;175660;27;0;0;0;0;.00nan;0;0
2314;86697;20;0;0;0;0;.00nan;0;0
2315;13714;8;0;0;0;0;.00nan;0;0
2315;18213;8;70;26;2;24;.923;3581000;0
2315;57338;35;84;34;1;33;.971;3600000;0
2315;141998;35;0;0;0;0;.00nan;0;0
2316;167642;18;64;40;4;36;.900;3975000;0
2316;173727;18;0;0;0;0;.00nan;0;0
2316;184770;22;0;0;0;0;.00nan;0;0
2316;143473;22;37;18;5;13;.722;3975000;0
2317;179950;4838;0;0;0;0;.00nan;0;0
2317;190465;33;64;31;3;28;.903;4200000;0
2317;86192;33;0;0;0;0;.00nan;0;0
2317;143749;4838;45;16;3;13;.813;4200000;0
2318;13337;32;0;0;0;0;.00nan;0;0
2318;20432;32;80;35;3;32;.914;3600000;0
2318;59540;15;21;21;6;15;.714;3600000;0
2318;71565;15;0;0;0;0;.00nan;0;0
2319;676;34;0;0;0;0;.00nan;0;0
2319;183844;29;0;0;0;0;.00nan;0;0
2319;37818;29;90;40;4;36;.900;3564000;0
2319;78806;34;68;24;2;22;.917;3600000;0
2320;67;11;44;11;2;9;.818;2573000;0
2320;190465;33;0;0;0;0;.00nan;0;0
2320;46468;11;31;16;4;12;.750;960000;0
2320;86192;33;71;36;4;32;.889;3600000;0
2321;3928;12;56;19;2;17;.895;3600000;0
2321;77955;28;21;16;5;11;.688;991000;0
2321;85437;28;71;29;2;27;.931;2609000;0
2321;91178;12;0;0;0;0;.00nan;0;0
2322;166381;27;0;0;0;0;.00nan;0;0
2322;175660;27;60;38;4;34;.895;3959000;0
2322;184770;22;0;0;0;0;.00nan;0;0
2322;143473;22;86;37;3;34;.919;3959000;0
2323;15;30;0;0;0;0;.00nan;0;0
2323;163423;26;0;0;0;0;.00nan;0;0
2323;17043;30;65;23;2;21;.913;3542000;0
2323;179154;26;98;22;0;22;1.000;3600000;0
2324;163195;0;0;0;0;0;.00nan;0;0
2324;178413;17;0;0;0;0;.00nan;0;0
2324;139409;0;54;30;4;26;.867;3514000;0
2324;146862;17;93;37;2;35;.946;3600000;0
2325;556;3;48;19;3;16;.842;3515000;0
2325;779;5;100;41;1;40;.976;3600000;0
2325;166751;5;0;0;0;0;.00nan;0;0
2325;179344;3;0;0;0;0;.00nan;0;0
2326;166646;16;56;20;2;18;.900;3600000;0
2326;163695;9;52;44;6;38;.864;3600000;0
2326;175092;9;0;0;0;0;.00nan;0;0
2326;50065;16;0;0;0;0;.00nan;0;0
2327;3284;21;100;21;0;21;1.000;3600000;0
2327;168712;14;98;41;1;40;.976;3550000;0
2327;175912;14;0;0;0;0;.00nan;0;0
2327;143156;21;0;0;0;0;.00nan;0;0
2328;2059;23;0;0;0;0;.00nan;0;0
2328;165582;24;0;0;0;0;.00nan;0;0
2328;78573;23;80;46;3;43;.935;3526000;0
2328;85727;24;94;31;1;30;.968;3600000;0
2329;13337;32;100;34;0;34;1.000;3600000;0
2329;20432;32;0;0;0;0;.00nan;0;0
2329;170314;25;59;14;1;13;.929;3551000;0
2329;148958;25;0;0;0;0;.00nan;0;0
2330;13714;8;0;0;0;0;.00nan;0;0
2330;18213;8;91;15;0;15;1.000;3600000;0
2330;90164;10;0;0;0;0;.00nan;0;0
2330;152717;10;97;61;1;60;.984;3600000;0
2331;171838;31;49;33;5;28;.848;3600000;0
2331;167642;18;0;0;0;0;.00nan;0;0
2331;173727;18;78;33;2;31;.939;3600000;0
2331;170977;31;0;0;0;0;.00nan;0;0
2332;166591;20;0;0;0;0;.00nan;0;0
2332;179950;4838;0;0;0;0;.00nan;0;0
2332;86697;20;61;41;5;36;.878;3600000;0
2332;143749;4838;100;36;2;34;.944;3600000;0
2333;183844;29;0;0;0;0;.00nan;0;0
2333;37818;29;86;41;3;38;.927;3600000;0
2333;59540;15;87;31;1;30;.968;3600000;0
2333;71565;15;0;0;0;0;.00nan;0;0
2334;67;11;76;37;3;34;.919;3600000;0
2334;184770;22;58;22;2;20;.909;3600000;0
2334;46468;11;0;0;0;0;.00nan;0;0
2334;143473;22;0;0;0;0;.00nan;0;0
2335;3284;21;77;28;2;26;.929;3786000;0
2335;170314;25;68;28;3;25;.893;3786000;0
2335;143156;21;0;0;0;0;.00nan;0;0
2335;148958;25;0;0;0;0;.00nan;0;0
2336;166646;16;0;0;0;0;.00nan;0;0
2336;178413;17;0;0;0;0;.00nan;0;0
2336;50065;16;53;26;4;22;.846;3512000;0
2336;146862;17;89;36;2;34;.944;3600000;0
2337;2059;23;19;25;7;18;.720;2727000;0
2337;168712;14;0;0;0;0;.00nan;0;0
2337;175912;14;33;16;4;12;.750;3600000;0
2337;78573;23;56;11;1;10;.909;873000;0
2338;169868;4182;0;0;0;0;.00nan;0;0
2338;57338;35;100;53;2;51;.962;3600000;0
2338;141998;35;0;0;0;0;.00nan;0;0
2338;147945;4182;39;25;4;21;.840;3531000;0
2339;167642;18;35;35;6;29;.829;3095000;0
2339;173727;18;56;5;0;5;1.000;505000;0
2339;190465;33;24;17;5;12;.706;3600000;0
2339;86192;33;0;0;0;0;.00nan;0;0
2340;15;30;0;0;0;0;.00nan;0;0
2340;187537;19;57;26;4;22;.846;3521000;0
2340;163565;19;0;0;0;0;.00nan;0;0
2340;17043;30;94;40;2;38;.950;3600000;0
2341;3928;12;82;49;5;44;.898;3600000;0
2341;163195;0;0;0;0;0;.00nan;0;0
2341;91178;12;0;0;0;0;.00nan;0;0
2341;139409;0;62;13;1;12;.923;3600000;0
2342;163695;9;0;0;0;0;.00nan;0;0
2342;165582;24;0;0;0;0;.00nan;0;0
2342;175092;9;80;37;3;34;.919;3600000;0
2342;85727;24;100;24;0;24;1.000;3600000;0
2343;556;3;71;31;2;29;.935;4117000;0
2343;163423;26;0;0;0;0;.00nan;0;0
2343;179154;26;86;28;1;27;.964;4117000;0
2343;179344;3;0;0;0;0;.00nan;0;0
2344;13714;8;0;0;0;0;.00nan;0;0
2344;166381;27;87;42;3;39;.929;3622000;0
2344;18213;8;69;27;2;25;.926;3622000;0
2344;175660;27;0;0;0;0;.00nan;0;0
2345;163695;9;37;30;5;25;.833;3566000;0
2345;168712;14;89;40;3;37;.925;3600000;0
2345;175092;9;0;0;0;0;.00nan;0;0
2345;175912;14;0;0;0;0;.00nan;0;0
2346;166591;20;0;0;0;0;.00nan;0;0
2346;779;5;0;0;0;0;.00nan;0;0
2346;166751;5;56;39;5;34;.872;3548000;0
2346;86697;20;69;34;4;30;.882;3600000;0
2347;676;34;100;28;0;28;1.000;3600000;0
2347;3928;12;0;0;0;0;.00nan;0;0
2347;78806;34;0;0;0;0;.00nan;0;0
2347;91178;12;51;28;5;23;.821;3600000;0
2348;166646;16;43;32;6;26;.813;3174000;0
2348;50065;16;53;4;0;4;1.000;395000;0
2348;90164;10;0;0;0;0;.00nan;0;0
2348;152717;10;70;45;5;40;.889;3600000;0
2349;556;3;70;23;2;21;.913;3556000;0
2349;13337;32;0;0;0;0;.00nan;0;0
2349;20432;32;86;32;1;31;.969;3600000;0
2349;179344;3;0;0;0;0;.00nan;0;0
2350;67;11;40;34;7;27;.794;3600000;0
2350;170314;25;87;31;2;29;.935;3600000;0
2350;46468;11;0;0;0;0;.00nan;0;0
2350;148958;25;0;0;0;0;.00nan;0;0
2351;167642;18;0;0;0;0;.00nan;0;0
2351;183844;29;0;0;0;0;.00nan;0;0
2351;173727;18;79;45;4;41;.911;3576000;0
2351;37818;29;68;27;3;24;.889;3600000;0
2352;171838;31;73;45;4;41;.911;3569000;0
2352;170977;31;0;0;0;0;.00nan;0;0
2352;179950;4838;0;0;0;0;.00nan;0;0
2352;143749;4838;60;20;3;17;.850;3600000;0
2353;15;30;0;0;0;0;.00nan;0;0
2353;166381;27;0;0;0;0;.00nan;0;0
2353;17043;30;73;36;3;33;.917;3600000;0
2353;175660;27;100;26;0;26;1.000;3600000;0
2354;187537;19;0;0;0;0;.00nan;0;0
2354;163565;19;32;22;5;17;.773;3600000;0
2354;57338;35;72;33;3;30;.909;3600000;0
2354;141998;35;0;0;0;0;.00nan;0;0
2355;676;34;98;32;1;31;.969;3600000;0
2355;178413;17;0;0;0;0;.00nan;0;0
2355;78806;34;0;0;0;0;.00nan;0;0
2355;146862;17;85;41;3;38;.927;3590000;0
2356;184770;22;0;0;0;0;.00nan;0;0
2356;77955;28;0;0;0;0;.00nan;0;0
2356;85437;28;81;47;4;43;.915;3600000;0
2356;143473;22;84;15;0;15;1.000;3600000;0
2357;165582;24;0;0;0;0;.00nan;0;0
2357;169868;4182;0;0;0;0;.00nan;0;0
2357;85727;24;81;35;3;32;.914;3547000;0
2357;147945;4182;80;33;2;31;.939;3600000;0
2358;163195;0;0;0;0;0;.00nan;0;0
2358;13714;8;0;0;0;0;.00nan;0;0
2358;18213;8;75;24;1;23;.958;3600000;0
2358;139409;0;89;41;2;39;.951;3542000;0
2359;2059;23;0;0;0;0;.00nan;0;0
2359;57338;35;64;23;3;20;.870;3548000;0
2359;78573;23;99;31;1;30;.968;3600000;0
2359;141998;35;0;0;0;0;.00nan;0;0
2360;556;3;95;33;2;31;.939;3562000;0
2360;166591;20;0;0;0;0;.00nan;0;0
2360;179344;3;0;0;0;0;.00nan;0;0
2360;86697;20;100;30;0;30;1.000;3600000;0
2361;3284;21;87;30;1;29;.967;3600000;0
2361;90164;10;80;36;3;33;.917;3546000;0
2361;143156;21;0;0;0;0;.00nan;0;0
2361;152717;10;0;0;0;0;.00nan;0;0
2362;163695;9;0;0;0;0;.00nan;0;0
2362;175092;9;61;45;5;40;.889;3600000;0
2362;59540;15;83;15;0;15;1.000;3600000;0
2362;71565;15;0;0;0;0;.00nan;0;0
2363;166381;27;0;0;0;0;.00nan;0;0
2363;175660;27;67;33;4;29;.879;3728000;0
2363;190465;33;0;0;0;0;.00nan;0;0
2363;86192;33;92;50;3;47;.940;3728000;0
2364;779;5;74;31;2;29;.935;4200000;0
2364;166751;5;0;0;0;0;.00nan;0;0
2364;13337;32;0;0;0;0;.00nan;0;0
2364;20432;32;87;34;2;32;.941;4200000;0
2365;67;11;0;0;0;0;.00nan;0;0
2365;171838;31;81;26;2;24;.923;3600000;0
2365;170977;31;0;0;0;0;.00nan;0;0
2365;46468;11;63;28;3;25;.893;3581000;0
2366;167642;18;0;0;0;0;.00nan;0;0
2366;173727;18;52;38;5;33;.868;3556000;0
2366;170314;25;61;28;4;24;.857;3600000;0
2366;148958;25;0;0;0;0;.00nan;0;0
2367;183844;29;0;0;0;0;.00nan;0;0
2367;179950;4838;0;0;0;0;.00nan;0;0
2367;37818;29;92;31;1;30;.968;3586000;0
2367;143749;4838;100;38;0;38;1.000;3600000;0
2368;166591;20;0;0;0;0;.00nan;0;0
2368;166646;16;0;0;0;0;.00nan;0;0
2368;50065;16;53;24;3;21;.875;3513000;0
2368;86697;20;99;49;1;48;.980;3600000;0
2369;168712;14;93;29;1;28;.966;3600000;0
2369;169868;4182;0;0;0;0;.00nan;0;0
2369;175912;14;0;0;0;0;.00nan;0;0
2369;147945;4182;68;26;2;24;.923;3556000;0
2370;165582;24;0;0;0;0;.00nan;0;0
2370;77955;28;0;0;0;0;.00nan;0;0
2370;85437;28;39;33;6;27;.818;3600000;0
2370;85727;24;59;16;2;14;.875;3600000;0
2371;779;5;0;0;0;0;.00nan;0;0
2371;166751;5;69;21;1;20;.952;3543000;0
2371;163423;26;0;0;0;0;.00nan;0;0
2371;179154;26;98;20;0;20;1.000;3600000;0
2372;187537;19;88;25;1;24;.960;3600000;0
2372;3928;12;32;32;6;26;.813;3271000;0
2372;163565;19;0;0;0;0;.00nan;0;0
2372;91178;12;52;3;0;3;1.000;329000;0
2373;15;30;0;0;0;0;.00nan;0;0
2373;163195;0;0;0;0;0;.00nan;0;0
2373;17043;30;92;36;1;35;.972;3600000;0
2373;139409;0;65;38;5;33;.868;3600000;0
2374;179950;4838;0;0;0;0;.00nan;0;0
2374;190465;33;74;27;2;25;.926;4095000;0
2374;86192;33;0;0;0;0;.00nan;0;0
2374;143749;4838;66;26;3;23;.885;4095000;0
2375;168712;14;67;22;2;20;.909;3600000;0
2375;175912;14;0;0;0;0;.00nan;0;0
2375;77955;28;41;29;5;24;.828;3600000;0
2375;85437;28;0;0;0;0;.00nan;0;0
2376;184770;22;0;0;0;0;.00nan;0;0
2376;59540;15;91;37;3;34;.919;3579000;0
2376;71565;15;0;0;0;0;.00nan;0;0
2376;143473;22;78;28;2;26;.929;3600000;0
2377;165582;24;0;0;0;0;.00nan;0;0
2377;178413;17;0;0;0;0;.00nan;0;0
2377;85727;24;94;41;2;39;.951;4056000;0
2377;146862;17;83;35;3;32;.914;4056000;0
2378;556;3;86;34;2;32;.941;3600000;0
2378;179344;3;0;0;0;0;.00nan;0;0
2378;90164;10;0;0;0;0;.00nan;0;0
2378;152717;10;74;36;3;33;.917;3577000;0
2379;676;34;0;0;0;0;.00nan;0;0
2379;163695;9;0;0;0;0;.00nan;0;0
2379;175092;9;82;31;1;30;.968;3570000;0
2379;78806;34;89;17;0;17;1.000;3600000;0
2380;13714;8;94;31;1;30;.968;3600000;0
2380;18213;8;0;0;0;0;.00nan;0;0
2380;57338;35;66;34;4;30;.882;3600000;0
2380;141998;35;0;0;0;0;.00nan;0;0
2381;166646;16;62;30;3;27;.900;3600000;0
2381;3284;21;68;44;5;39;.886;3552000;0
2381;50065;16;0;0;0;0;.00nan;0;0
2381;143156;21;0;0;0;0;.00nan;0;0
2382;163423;26;0;0;0;0;.00nan;0;0
2382;13337;32;0;0;0;0;.00nan;0;0
2382;20432;32;64;37;5;32;.865;3844000;0
2382;179154;26;45;27;4;23;.852;3844000;0
2383;3928;12;0;0;0;0;.00nan;0;0
2383;163195;0;0;0;0;0;.00nan;0;0
2383;91178;12;82;31;2;29;.935;3600000;0
2383;139409;0;59;34;3;31;.912;3564000;0
2384;171838;31;0;0;0;0;.00nan;0;0
2384;166381;27;64;22;2;20;.909;3600000;0
2384;170977;31;72;31;3;28;.903;3589000;0
2384;175660;27;0;0;0;0;.00nan;0;0
2385;67;11;89;33;1;32;.970;3600000;0
2385;183844;29;0;0;0;0;.00nan;0;0
2385;37818;29;55;24;4;20;.833;3600000;0
2385;46468;11;0;0;0;0;.00nan;0;0
2386;2059;23;0;0;0;0;.00nan;0;0
2386;167642;18;0;0;0;0;.00nan;0;0
2386;173727;18;53;31;5;26;.839;3658000;0
2386;78573;23;75;35;4;31;.886;3658000;0
2387;170314;25;74;26;2;24;.923;3519000;0
2387;179950;4838;0;0;0;0;.00nan;0;0
2387;143749;4838;100;38;0;38;1.000;3600000;0
2387;148958;25;0;0;0;0;.00nan;0;0
2388;166591;20;0;0;0;0;.00nan;0;0
2388;3284;21;0;0;0;0;.00nan;0;0
2388;86697;20;65;39;5;34;.872;3600000;0
2388;143156;21;78;30;2;28;.933;3600000;0
2389;169868;4182;0;0;0;0;.00nan;0;0
2389;184770;22;47;29;5;24;.828;3792000;0
2389;143473;22;0;0;0;0;.00nan;0;0
2389;147945;4182;79;41;4;37;.902;3792000;0
2390;187537;19;66;36;3;33;.917;4200000;0
2390;163565;19;0;0;0;0;.00nan;0;0
2390;13714;8;0;0;0;0;.00nan;0;0
2390;18213;8;79;36;3;33;.917;4200000;0
2391;15;30;0;0;0;0;.00nan;0;0
2391;779;5;0;0;0;0;.00nan;0;0
2391;166751;5;93;48;3;45;.938;3591000;0
2391;17043;30;72;26;2;24;.923;3600000;0
2392;556;3;57;32;5;27;.844;3961000;0
2392;169868;4182;41;22;4;18;.818;3940000;0
2392;179344;3;0;0;0;0;.00nan;0;0
2392;147945;4182;0;0;0;0;.00nan;0;0
2393;676;34;0;0;0;0;.00nan;0;0
2393;190465;33;0;0;0;0;.00nan;0;0
2393;78806;34;85;35;2;33;.943;3755000;0
2393;86192;33;83;40;3;37;.925;3755000;0
2394;178413;17;0;0;0;0;.00nan;0;0
2394;57338;35;59;23;2;21;.913;3600000;0
2394;141998;35;0;0;0;0;.00nan;0;0
2394;146862;17;62;31;3;28;.903;3600000;0
2395;163423;26;0;0;0;0;.00nan;0;0
2395;167642;18;64;10;0;10;1.000;1146000;0
2395;173727;18;18;29;8;21;.724;2454000;0
2395;179154;26;68;25;3;22;.880;3600000;0
2396;166381;27;84;32;2;30;.938;3600000;0
2396;183844;29;0;0;0;0;.00nan;0;0
2396;175660;27;0;0;0;0;.00nan;0;0
2396;37818;29;46;38;6;32;.842;3600000;0
2397;190465;33;60;35;5;30;.857;3600000;0
2397;77955;28;48;0;0;0;.00nan;626000;0
2397;85437;28;18;22;6;16;.727;2964000;0
2397;86192;33;0;0;0;0;.00nan;0;0
2398;163195;0;72;31;3;28;.903;3835000;0
2398;59540;15;63;22;2;20;.909;3830000;0
2398;71565;15;0;0;0;0;.00nan;0;0
2398;139409;0;0;0;0;0;.00nan;0;0
2399;15;30;0;0;0;0;.00nan;0;0
2399;166591;20;0;0;0;0;.00nan;0;0
2399;17043;30;71;23;2;21;.913;3566000;0
2399;86697;20;93;31;1;30;.968;3600000;0
2400;184770;22;0;0;0;0;.00nan;0;0
2400;90164;10;0;0;0;0;.00nan;0;0
2400;143473;22;67;16;1;15;.938;3600000;0
2400;152717;10;97;56;3;53;.946;3573000;0
2401;171838;31;68;21;2;19;.905;3600000;0
2401;13337;32;52;4;0;4;1.000;705000;0
2401;20432;32;17;18;6;12;.667;2895000;0
2401;170977;31;0;0;0;0;.00nan;0;0
2402;163695;9;53;30;4;26;.867;2480000;0
2402;168712;14;58;21;3;18;.857;3600000;0
2402;175092;9;29;15;4;11;.733;1120000;0
2402;175912;14;0;0;0;0;.00nan;0;0
2403;67;11;0;0;0;0;.00nan;0;0
2403;165582;24;0;0;0;0;.00nan;0;0
2403;46468;11;56;38;5;33;.868;3600000;0
2403;85727;24;83;27;1;26;.963;3600000;0
2404;166646;16;77;40;4;36;.900;3600000;0
2404;179950;4838;0;0;0;0;.00nan;0;0
2404;50065;16;0;0;0;0;.00nan;0;0
2404;143749;4838;100;27;0;27;1.000;3600000;0
2405;13714;8;53;35;5;30;.857;3600000;0
2405;18213;8;0;0;0;0;.00nan;0;0
2405;170314;25;80;33;2;31;.939;3600000;0
2405;148958;25;0;0;0;0;.00nan;0;0
2406;779;5;0;0;0;0;.00nan;0;0
2406;166751;5;88;48;3;45;.938;3568000;0
2406;3928;12;64;25;2;23;.920;3600000;0
2406;91178;12;0;0;0;0;.00nan;0;0
2407;187537;19;0;0;0;0;.00nan;0;0
2407;2059;23;0;0;0;0;.00nan;0;0
2407;163565;19;79;30;3;27;.900;3993000;0
2407;78573;23;73;39;4;35;.897;3993000;0
2408;556;3;49;27;4;23;.852;3600000;0
2408;179344;3;0;0;0;0;.00nan;0;0
2408;57338;35;61;30;3;27;.900;3600000;0
2408;141998;35;0;0;0;0;.00nan;0;0
2409;3284;21;62;31;3;28;.903;4200000;0
2409;165582;24;0;0;0;0;.00nan;0;0
2409;85727;24;73;42;3;39;.929;4200000;0
2409;143156;21;0;0;0;0;.00nan;0;0
2410;2059;23;77;31;2;29;.935;3556000;0
2410;167642;18;0;0;0;0;.00nan;0;0
2410;173727;18;99;36;1;35;.972;3600000;0
2410;78573;23;0;0;0;0;.00nan;0;0
2411;163195;0;0;0;0;0;.00nan;0;0
2411;163695;9;0;0;0;0;.00nan;0;0
2411;175092;9;64;31;4;27;.871;3572000;0
2411;139409;0;83;33;3;30;.909;3600000;0
2412;3284;21;0;0;0;0;.00nan;0;0
2412;59540;15;0;0;0;0;.00nan;0;0
2412;71565;15;65;27;3;24;.889;3553000;0
2412;143156;21;85;30;1;29;.967;3600000;0
2413;13337;32;0;0;0;0;.00nan;0;0
2413;183844;29;0;0;0;0;.00nan;0;0
2413;20432;32;65;27;3;24;.889;3600000;0
2413;37818;29;44;23;4;19;.826;3600000;0
2414;67;11;80;50;3;47;.940;3584000;0
2414;184770;22;0;0;0;0;.00nan;0;0
2414;46468;11;0;0;0;0;.00nan;0;0
2414;143473;22;68;13;1;12;.923;3600000;0
2415;166646;16;0;0;0;0;.00nan;0;0
2415;50065;16;46;27;4;23;.852;3551000;0
2415;90164;10;64;34;3;31;.912;3600000;0
2415;152717;10;0;0;0;0;.00nan;0;0
2416;676;34;74;21;1;20;.952;3600000;0
2416;166591;20;0;0;0;0;.00nan;0;0
2416;78806;34;0;0;0;0;.00nan;0;0
2416;86697;20;61;27;3;24;.889;3568000;0
2417;15;30;0;0;0;0;.00nan;0;0
2417;171838;31;97;43;3;40;.930;3545000;0
2417;17043;30;79;30;2;28;.933;3600000;0
2417;170977;31;0;0;0;0;.00nan;0;0
2418;163423;26;0;0;0;0;.00nan;0;0
2418;179154;26;52;22;3;19;.864;3529000;0
2418;179950;4838;0;0;0;0;.00nan;0;0
2418;143749;4838;82;32;2;30;.938;3600000;0
2419;178413;17;0;0;0;0;.00nan;0;0
2419;190465;33;0;0;0;0;.00nan;0;0
2419;86192;33;92;45;2;43;.956;3869000;0
2419;146862;17;91;37;1;36;.973;3869000;0
2420;779;5;45;39;6;33;.846;3536000;0
2420;166751;5;0;0;0;0;.00nan;0;0
2420;13714;8;0;0;0;0;.00nan;0;0
2420;18213;8;61;30;4;26;.867;3600000;0
2421;166381;27;0;0;0;0;.00nan;0;0
2421;169868;4182;0;0;0;0;.00nan;0;0
2421;175660;27;45;23;4;19;.826;3588000;0
2421;147945;4182;81;35;3;32;.914;3600000;0
2422;187537;19;91;36;1;35;.972;3600000;0
2422;3928;12;46;19;3;16;.842;3566000;0
2422;163565;19;0;0;0;0;.00nan;0;0
2422;91178;12;0;0;0;0;.00nan;0;0
2423;556;3;90;42;2;40;.952;3600000;0
2423;179344;3;0;0;0;0;.00nan;0;0
2423;90164;10;0;0;0;0;.00nan;0;0
2423;152717;10;69;37;3;34;.919;3600000;0
2424;67;11;0;0;0;0;.00nan;0;0
2424;168712;14;42;14;3;11;.786;3600000;0
2424;175912;14;0;0;0;0;.00nan;0;0
2424;46468;11;73;42;4;38;.905;3600000;0
2425;57338;35;81;33;3;30;.909;3736000;0
2425;77955;28;0;0;0;0;.00nan;0;0
2425;85437;28;81;49;4;45;.918;3736000;0
2425;141998;35;0;0;0;0;.00nan;0;0
2426;178413;17;0;0;0;0;.00nan;0;0
2426;170314;25;81;35;3;32;.914;3548000;0
2426;146862;17;94;39;2;37;.949;3600000;0
2426;148958;25;0;0;0;0;.00nan;0;0
2427;15;30;0;0;0;0;.00nan;0;0
2427;183844;29;0;0;0;0;.00nan;0;0
2427;17043;30;81;37;3;34;.919;3600000;0
2427;37818;29;52;31;4;27;.871;3586000;0
2428;166646;16;0;0;0;0;.00nan;0;0
2428;163423;26;0;0;0;0;.00nan;0;0
2428;179154;26;79;29;2;27;.931;3600000;0
2428;50065;16;36;29;6;23;.793;3600000;0
2429;166591;20;0;0;0;0;.00nan;0;0
2429;165582;24;0;0;0;0;.00nan;0;0
2429;85727;24;76;22;1;21;.955;3600000;0
2429;86697;20;98;47;3;44;.936;3523000;0
2430;163695;9;84;21;0;21;1.000;1576000;0
2430;175092;9;49;40;6;34;.850;2024000;0
2430;59540;15;72;20;1;19;.950;3600000;0
2430;71565;15;0;0;0;0;.00nan;0;0
2431;190465;33;0;0;0;0;.00nan;0;0
2431;77955;28;24;24;6;18;.750;3227000;0
2431;85437;28;34;5;2;3;.600;373000;0
2431;86192;33;90;35;2;33;.943;3600000;0
2432;556;3;77;44;4;40;.909;3577000;0
2432;179344;3;0;0;0;0;.00nan;0;0
2432;184770;22;0;0;0;0;.00nan;0;0
2432;143473;22;57;23;3;20;.870;3600000;0
2433;676;34;61;30;3;27;.900;3494000;0
2433;779;5;0;0;0;0;.00nan;0;0
2433;166751;5;74;26;1;25;.962;3600000;0
2433;78806;34;0;0;0;0;.00nan;0;0
2434;171838;31;44;53;9;44;.830;3600000;0
2434;3284;21;44;28;5;23;.821;3600000;0
2434;170977;31;0;0;0;0;.00nan;0;0
2434;143156;21;0;0;0;0;.00nan;0;0
2435;163195;0;0;0;0;0;.00nan;0;0
2435;168712;14;0;0;0;0;.00nan;0;0
2435;175912;14;91;28;1;27;.964;3600000;0
2435;139409;0;98;44;2;42;.955;3580000;0
2436;167642;18;0;0;0;0;.00nan;0;0
2436;173727;18;85;28;1;27;.964;3600000;0
2436;169868;4182;0;0;0;0;.00nan;0;0
2436;147945;4182;68;34;3;31;.912;3586000;0
2437;13337;32;0;0;0;0;.00nan;0;0
2437;20432;32;75;36;3;33;.917;3600000;0
2437;170314;25;54;30;4;26;.867;3557000;0
2437;148958;25;0;0;0;0;.00nan;0;0
2438;3928;12;91;36;1;35;.972;3600000;0
2438;13714;8;0;0;0;0;.00nan;0;0
2438;18213;8;72;25;2;23;.920;3525000;0
2438;91178;12;0;0;0;0;.00nan;0;0
2439;2059;23;70;23;2;21;.913;3114000;0
2439;166381;27;0;0;0;0;.00nan;0;0
2439;175660;27;63;20;2;18;.900;3600000;0
2439;78573;23;24;5;3;2;.400;486000;0
2440;187537;19;76;23;1;22;.957;3600000;0
2440;163565;19;0;0;0;0;.00nan;0;0
2440;179950;4838;0;0;0;0;.00nan;0;0
2440;143749;4838;93;32;2;30;.938;3542000;0
2441;184770;22;0;0;0;0;.00nan;0;0
2441;59540;15;64;32;4;28;.875;3600000;0
2441;71565;15;0;0;0;0;.00nan;0;0
2441;143473;22;85;23;1;22;.957;3600000;0
2442;3284;21;71;38;4;34;.895;3600000;0
2442;168712;14;59;41;6;35;.854;3544000;0
2442;175912;14;0;0;0;0;.00nan;0;0
2442;143156;21;0;0;0;0;.00nan;0;0
2443;171838;31;59;26;3;23;.885;3600000;0
2443;183844;29;0;0;0;0;.00nan;0;0
2443;170977;31;0;0;0;0;.00nan;0;0
2443;37818;29;61;41;5;36;.878;3545000;0
2444;779;5;0;0;0;0;.00nan;0;0
2444;166751;5;38;30;6;24;.800;3600000;0
2444;163695;9;82;32;2;30;.938;3600000;0
2444;175092;9;0;0;0;0;.00nan;0;0
2445;163195;0;0;0;0;0;.00nan;0;0
2445;77955;28;0;0;0;0;.00nan;0;0
2445;85437;28;40;34;6;28;.824;3600000;0
2445;139409;0;60;20;2;18;.900;3600000;0
2446;676;34;96;36;1;35;.972;3600000;0
2446;165582;24;66;23;3;20;.870;3566000;0
2446;78806;34;0;0;0;0;.00nan;0;0
2446;85727;24;0;0;0;0;.00nan;0;0
2447;556;3;60;24;3;21;.875;3600000;0
2447;179344;3;0;0;0;0;.00nan;0;0
2447;190465;33;0;0;0;0;.00nan;0;0
2447;86192;33;33;27;6;21;.778;3600000;0
2448;166591;20;0;0;0;0;.00nan;0;0
2448;166646;16;100;37;0;37;1.000;4200000;0
2448;50065;16;0;0;0;0;.00nan;0;0
2448;86697;20;98;34;0;34;1.000;4200000;0
2449;163423;26;0;0;0;0;.00nan;0;0
2449;13337;32;0;0;0;0;.00nan;0;0
2449;20432;32;84;43;3;40;.930;3759000;0
2449;179154;26;72;30;2;28;.933;3759000;0
2450;3928;12;59;35;5;30;.857;3600000;0
2450;13714;8;0;0;0;0;.00nan;0;0
2450;18213;8;85;33;2;31;.939;3600000;0
2450;91178;12;0;0;0;0;.00nan;0;0
2451;170314;25;65;23;2;21;.913;3600000;0
2451;57338;35;84;29;1;28;.966;3600000;0
2451;141998;35;0;0;0;0;.00nan;0;0
2451;148958;25;0;0;0;0;.00nan;0;0
2452;167642;18;0;0;0;0;.00nan;0;0
2452;166381;27;92;19;0;19;1.000;3600000;0
2452;173727;18;85;38;2;36;.947;3515000;0
2452;175660;27;0;0;0;0;.00nan;0;0
2453;15;30;0;0;0;0;.00nan;0;0
2453;17043;30;66;39;3;36;.923;4200000;0
2453;169868;4182;0;0;0;0;.00nan;0;0
2453;147945;4182;83;35;3;32;.914;4200000;0
2454;187537;19;52;34;4;30;.882;3600000;0
2454;2059;23;0;0;0;0;.00nan;0;0
2454;163565;19;0;0;0;0;.00nan;0;0
2454;78573;23;87;28;1;27;.964;3600000;0
2455;166591;20;0;0;0;0;.00nan;0;0
2455;178413;17;0;0;0;0;.00nan;0;0
2455;86697;20;77;40;3;37;.925;3600000;0
2455;146862;17;61;30;4;26;.867;3552000;0
2456;179950;4838;0;0;0;0;.00nan;0;0
2456;90164;10;60;39;4;35;.897;3512000;0
2456;143749;4838;83;28;2;26;.929;3600000;0
2456;152717;10;0;0;0;0;.00nan;0;0
2457;15;30;69;38;4;34;.895;4039000;0
2457;2059;23;44;33;5;28;.848;4039000;0
2457;17043;30;0;0;0;0;.00nan;0;0
2457;78573;23;0;0;0;0;.00nan;0;0
2458;67;11;89;38;2;36;.947;3600000;0
2458;187537;19;0;0;0;0;.00nan;0;0
2458;163565;19;46;23;4;19;.826;3577000;0
2458;46468;11;0;0;0;0;.00nan;0;0
2459;163695;9;0;0;0;0;.00nan;0;0
2459;175092;9;73;39;4;35;.897;3560000;0
2459;59540;15;0;0;0;0;.00nan;0;0
2459;71565;15;76;29;2;27;.931;3600000;0
2460;556;3;85;29;1;28;.966;3600000;0
2460;166646;16;62;17;2;15;.882;3577000;0
2460;179344;3;0;0;0;0;.00nan;0;0
2460;50065;16;0;0;0;0;.00nan;0;0
2461;183844;29;0;0;0;0;.00nan;0;0
2461;168712;14;51;43;6;37;.860;3899000;0
2461;175912;14;0;0;0;0;.00nan;0;0
2461;37818;29;26;33;7;26;.788;3890000;0
2462;779;5;39;30;5;25;.833;3600000;0
2462;166751;5;0;0;0;0;.00nan;0;0
2462;184770;22;0;0;0;0;.00nan;0;0
2462;143473;22;100;23;0;23;1.000;3600000;0
2463;3284;21;78;37;4;33;.892;3600000;0
2463;165582;24;0;0;0;0;.00nan;0;0
2463;85727;24;100;25;0;25;1.000;3600000;0
2463;143156;21;0;0;0;0;.00nan;0;0
2464;163423;26;0;0;0;0;.00nan;0;0
2464;170314;25;79;32;2;30;.938;4161000;0
2464;179154;26;99;38;1;37;.974;4161000;0
2464;148958;25;0;0;0;0;.00nan;0;0
2465;13337;32;0;0;0;0;.00nan;0;0
2465;13714;8;0;0;0;0;.00nan;0;0
2465;18213;8;77;27;3;24;.889;3655000;0
2465;20432;32;61;20;2;18;.900;3655000;0
2466;3928;12;47;29;4;25;.862;3909000;0
2466;169868;4182;0;0;0;0;.00nan;0;0
2466;91178;12;0;0;0;0;.00nan;0;0
2466;147945;4182;56;28;3;25;.893;3909000;0
2467;167642;18;95;34;1;33;.971;3600000;0
2467;173727;18;0;0;0;0;.00nan;0;0
2467;90164;10;0;0;0;0;.00nan;0;0
2467;152717;10;77;35;3;32;.914;3511000;0
2468;190465;33;0;0;0;0;.00nan;0;0
2468;57338;35;54;26;3;23;.885;3563000;0
2468;86192;33;88;31;2;29;.935;3600000;0
2468;141998;35;0;0;0;0;.00nan;0;0
2469;163195;0;0;0;0;0;.00nan;0;0
2469;59540;15;42;32;5;27;.844;3590000;0
2469;71565;15;0;0;0;0;.00nan;0;0
2469;139409;0;63;31;3;28;.903;3600000;0
2470;184770;22;37;17;4;13;.765;3600000;0
2470;77955;28;55;10;1;9;.900;1070000;0
2470;85437;28;36;42;7;35;.833;2530000;0
2470;143473;22;0;0;0;0;.00nan;0;0
2471;183844;29;80;34;3;31;.912;3600000;0
2471;178413;17;0;0;0;0;.00nan;0;0
2471;37818;29;0;0;0;0;.00nan;0;0
2471;146862;17;54;27;4;23;.852;3600000;0
2472;676;34;0;0;0;0;.00nan;0;0
2472;13337;32;0;0;0;0;.00nan;0;0
2472;20432;32;66;41;4;37;.902;3600000;0
2472;78806;34;64;23;2;21;.913;3600000;0
2473;171838;31;0;0;0;0;.00nan;0;0
2473;168712;14;50;1;0;1;1.000;228000;0
2473;170977;31;70;38;4;34;.895;3600000;0
2473;175912;14;42;34;6;28;.824;3323000;0
2474;166591;20;0;0;0;0;.00nan;0;0
2474;163695;9;75;39;3;36;.923;3600000;0
2474;175092;9;0;0;0;0;.00nan;0;0
2474;86697;20;70;22;2;20;.909;3600000;0
2475;166646;16;0;0;0;0;.00nan;0;0
2475;3284;21;0;0;0;0;.00nan;0;0
2475;50065;16;77;29;2;27;.931;3600000;0
2475;143156;21;64;40;5;35;.875;3600000;0
2476;67;11;0;0;0;0;.00nan;0;0
2476;2059;23;0;0;0;0;.00nan;0;0
2476;46468;11;85;50;4;46;.920;3774000;0
2476;78573;23;61;25;3;22;.880;3774000;0
2477;190465;33;78;42;5;37;.881;3600000;0
2477;57338;35;0;0;0;0;.00nan;0;0
2477;86192;33;0;0;0;0;.00nan;0;0
2477;141998;35;87;37;2;35;.946;3600000;0
2478;556;3;73;28;2;26;.929;3600000;0
2478;179344;3;0;0;0;0;.00nan;0;0
2478;77955;28;38;43;7;36;.837;3600000;0
2478;85437;28;0;0;0;0;.00nan;0;0
2479;779;5;0;0;0;0;.00nan;0;0
2479;166751;5;84;44;4;40;.909;3599000;0
2479;163195;0;0;0;0;0;.00nan;0;0
2479;139409;0;56;24;3;21;.875;3644000;0
2480;676;34;94;33;1;32;.970;3600000;0
2480;165582;24;0;0;0;0;.00nan;0;0
2480;78806;34;0;0;0;0;.00nan;0;0
2480;85727;24;49;28;4;24;.857;3600000;0
2481;171838;31;61;46;6;40;.870;3600000;0
2481;178413;17;0;0;0;0;.00nan;0;0
2481;170977;31;0;0;0;0;.00nan;0;0
2481;146862;17;63;24;3;21;.875;3600000;0
2482;67;11;79;44;3;41;.932;3574000;0
2482;169868;4182;0;0;0;0;.00nan;0;0
2482;46468;11;0;0;0;0;.00nan;0;0
2482;147945;4182;71;25;2;23;.920;3600000;0
2483;166381;27;76;26;1;25;.962;3600000;0
2483;175660;27;0;0;0;0;.00nan;0;0
2483;90164;10;0;0;0;0;.00nan;0;0
2483;152717;10;64;40;5;35;.875;3600000;0
2484;187537;19;70;42;4;38;.905;3538000;0
2484;163565;19;0;0;0;0;.00nan;0;0
2484;13714;8;83;39;3;36;.923;3600000;0
2484;18213;8;0;0;0;0;.00nan;0;0
2485;163423;26;0;0;0;0;.00nan;0;0
2485;170314;25;45;36;5;31;.861;3583000;0
2485;179154;26;51;21;3;18;.857;3600000;0
2485;148958;25;0;0;0;0;.00nan;0;0
2486;15;30;0;0;0;0;.00nan;0;0
2486;167642;18;0;0;0;0;.00nan;0;0
2486;17043;30;88;30;1;29;.967;3600000;0
2486;173727;18;87;51;4;47;.922;3600000;0
2487;59540;15;32;17;4;13;.765;3600000;0
2487;71565;15;0;0;0;0;.00nan;0;0
2487;77955;28;0;0;0;0;.00nan;0;0
2487;85437;28;80;58;5;53;.914;3562000;0
2488;166591;20;0;0;0;0;.00nan;0;0
2488;168712;14;65;15;1;14;.933;3600000;0
2488;175912;14;0;0;0;0;.00nan;0;0
2488;86697;20;62;46;6;40;.870;3600000;0
2489;676;34;0;0;0;0;.00nan;0;0
2489;3284;21;69;18;1;17;.944;3600000;0
2489;78806;34;87;37;2;35;.946;3514000;0
2489;143156;21;0;0;0;0;.00nan;0;0
2490;163423;26;0;0;0;0;.00nan;0;0
2490;178413;17;0;0;0;0;.00nan;0;0
2490;179154;26;45;27;4;23;.852;3563000;0
2490;146862;17;88;34;2;32;.941;3600000;0
2491;166381;27;50;7;1;6;.857;3600000;0
2491;175660;27;0;0;0;0;.00nan;0;0
2491;190465;33;0;0;0;0;.00nan;0;0
2491;86192;33;96;55;4;51;.927;3600000;0
2492;166646;16;82;22;1;21;.955;3600000;0
2492;170314;25;70;26;2;24;.923;3545000;0
2492;50065;16;0;0;0;0;.00nan;0;0
2492;148958;25;0;0;0;0;.00nan;0;0
2493;171838;31;85;51;5;46;.902;3600000;0
2493;170977;31;0;0;0;0;.00nan;0;0
2493;57338;35;75;31;2;29;.935;3600000;0
2493;141998;35;0;0;0;0;.00nan;0;0
2494;3928;12;85;32;1;31;.969;3600000;0
2494;183844;29;0;0;0;0;.00nan;0;0
2494;37818;29;77;26;2;24;.923;3554000;0
2494;91178;12;0;0;0;0;.00nan;0;0
2495;13714;8;0;0;0;0;.00nan;0;0
2495;165582;24;0;0;0;0;.00nan;0;0
2495;18213;8;65;29;3;26;.897;3600000;0
2495;85727;24;49;29;4;25;.862;3551000;0
2496;67;11;0;0;0;0;.00nan;0;0
2496;46468;11;61;34;3;31;.912;3561000;0
2496;90164;10;0;0;0;0;.00nan;0;0
2496;152717;10;85;34;2;32;.941;3600000;0
2497;779;5;0;0;0;0;.00nan;0;0
2497;166751;5;63;34;3;31;.912;3584000;0
2497;179950;4838;0;0;0;0;.00nan;0;0
2497;143749;4838;86;28;1;27;.964;3600000;0
2498;2059;23;0;0;0;0;.00nan;0;0
2498;163695;9;0;0;0;0;.00nan;0;0
2498;175092;9;77;31;2;29;.935;4200000;0
2498;78573;23;79;32;2;30;.938;4200000;0
2499;556;3;12;27;7;20;.741;2882000;0
2499;187537;19;56;24;4;20;.833;3600000;0
2499;163565;19;0;0;0;0;.00nan;0;0
2499;179344;3;36;6;2;4;.667;718000;0
2500;3284;21;0;0;0;0;.00nan;0;0
2500;184770;22;0;0;0;0;.00nan;0;0
2500;143156;21;78;51;5;46;.902;3600000;0
2500;143473;22;70;17;1;16;.941;3600000;0
2501;163695;9;77;37;3;34;.919;3600000;0
2501;169868;4182;0;0;0;0;.00nan;0;0
2501;175092;9;0;0;0;0;.00nan;0;0
2501;147945;4182;92;39;2;37;.949;3600000;0
2502;676;34;73;15;1;14;.933;3600000;0
2502;77955;28;0;0;0;0;.00nan;0;0
2502;78806;34;0;0;0;0;.00nan;0;0
2502;85437;28;82;41;3;38;.927;3600000;0
2503;163195;0;0;0;0;0;.00nan;0;0
2503;178413;17;0;0;0;0;.00nan;0;0
2503;139409;0;69;38;4;34;.895;3600000;0
2503;146862;17;89;34;1;33;.971;3600000;0
2504;168712;14;60;12;1;11;.917;3600000;0
2504;170314;25;67;45;5;40;.889;3600000;0
2504;175912;14;0;0;0;0;.00nan;0;0
2504;148958;25;0;0;0;0;.00nan;0;0
2505;59540;15;78;12;0;12;1.000;3600000;0
2505;71565;15;0;0;0;0;.00nan;0;0
2505;90164;10;88;45;2;43;.956;3530000;0
2505;152717;10;0;0;0;0;.00nan;0;0
2506;163423;26;0;0;0;0;.00nan;0;0
2506;13714;8;96;40;1;39;.975;3600000;0
2506;18213;8;0;0;0;0;.00nan;0;0
2506;179154;26;66;23;2;21;.913;3599000;0
2507;171838;31;42;44;7;37;.841;3600000;0
2507;170977;31;0;0;0;0;.00nan;0;0
2507;190465;33;0;0;0;0;.00nan;0;0
2507;86192;33;72;30;2;28;.933;3600000;0
2508;166646;16;61;33;4;29;.879;3553000;0
2508;166381;27;67;34;3;31;.912;3600000;0
2508;175660;27;0;0;0;0;.00nan;0;0
2508;50065;16;0;0;0;0;.00nan;0;0
2509;13337;32;65;45;6;39;.867;3582000;0
2509;20432;32;0;0;0;0;.00nan;0;0
2509;179950;4838;0;0;0;0;.00nan;0;0
2509;143749;4838;76;41;5;36;.878;3600000;0
2510;3928;12;81;36;3;33;.917;3549000;0
2510;165582;24;0;0;0;0;.00nan;0;0
2510;85727;24;88;35;2;33;.943;3600000;0
2510;91178;12;0;0;0;0;.00nan;0;0
2511;779;5;0;0;0;0;.00nan;0;0
2511;166751;5;79;22;1;21;.955;3600000;0
2511;167642;18;0;0;0;0;.00nan;0;0
2511;173727;18;84;48;4;44;.917;3600000;0
2512;15;30;0;0;0;0;.00nan;0;0
2512;183844;29;0;0;0;0;.00nan;0;0
2512;17043;30;80;22;1;21;.955;3600000;0
2512;37818;29;70;32;3;29;.906;3555000;0
2513;556;3;64;19;2;17;.895;4200000;0
2513;2059;23;0;0;0;0;.00nan;0;0
2513;179344;3;0;0;0;0;.00nan;0;0
2513;78573;23;80;37;2;35;.946;4200000;0
2514;187537;19;65;30;3;27;.900;4200000;0
2514;163565;19;0;0;0;0;.00nan;0;0
2514;57338;35;70;33;3;30;.909;4200000;0
2514;141998;35;0;0;0;0;.00nan;0;0
2515;170314;25;70;36;3;33;.917;3544000;0
2515;184770;22;0;0;0;0;.00nan;0;0
2515;143473;22;91;30;1;29;.967;3600000;0
2515;148958;25;0;0;0;0;.00nan;0;0
2516;166591;20;48;0;0;0;.00nan;262000;0
2516;3284;21;86;29;2;27;.931;3600000;0
2516;86697;20;34;34;6;28;.824;3338000;0
2516;143156;21;0;0;0;0;.00nan;0;0
2517;169868;4182;0;0;0;0;.00nan;0;0
2517;57338;35;0;0;0;0;.00nan;0;0
2517;141998;35;75;39;3;36;.923;3600000;0
2517;147945;4182;51;26;4;22;.846;3587000;0
2518;166381;27;72;27;2;25;.926;3600000;0
2518;175660;27;0;0;0;0;.00nan;0;0
2518;90164;10;0;0;0;0;.00nan;0;0
2518;152717;10;100;39;0;39;1.000;3600000;0
2519;13714;8;86;16;0;16;1.000;3600000;0
2519;183844;29;0;0;0;0;.00nan;0;0
2519;18213;8;0;0;0;0;.00nan;0;0
2519;37818;29;66;40;5;35;.875;3600000;0
2520;171838;31;95;39;2;37;.949;3600000;0
2520;170977;31;0;0;0;0;.00nan;0;0
2520;77955;28;0;0;0;0;.00nan;0;0
2520;85437;28;60;28;3;25;.893;3600000;0
2521;166591;20;71;31;2;29;.935;4200000;0
2521;13337;32;0;0;0;0;.00nan;0;0
2521;20432;32;81;34;2;32;.941;4200000;0
2521;86697;20;0;0;0;0;.00nan;0;0
2522;190465;33;52;2;0;2;1.000;690000;0
2522;59540;15;88;14;0;14;1.000;3600000;0
2522;71565;15;0;0;0;0;.00nan;0;0
2522;86192;33;24;48;9;39;.813;2910000;0
2523;178413;17;0;0;0;0;.00nan;0;0
2523;168712;14;63;34;3;31;.912;3555000;0
2523;175912;14;0;0;0;0;.00nan;0;0
2523;146862;17;73;32;2;30;.938;3600000;0
2524;184770;22;78;11;0;11;1.000;3600000;0
2524;179950;4838;0;0;0;0;.00nan;0;0
2524;143473;22;0;0;0;0;.00nan;0;0
2524;143749;4838;97;49;1;48;.980;3600000;0
2525;676;34;0;0;0;0;.00nan;0;0
2525;163195;0;47;17;3;14;.824;1737000;0
2525;78806;34;64;22;2;20;.909;3600000;0
2525;139409;0;33;30;6;24;.800;1863000;0
2526;187537;19;0;0;0;0;.00nan;0;0
2526;163565;19;75;28;2;26;.929;4136000;0
2526;163695;9;0;0;0;0;.00nan;0;0
2526;175092;9;69;33;3;30;.909;4136000;0
2527;166646;16;71;34;3;31;.912;3795000;0
2527;163423;26;0;0;0;0;.00nan;0;0
2527;179154;26;83;33;2;31;.939;3795000;0
2527;50065;16;0;0;0;0;.00nan;0;0
2528;67;11;87;31;1;30;.968;3600000;0
2528;779;5;58;14;1;13;.929;1487000;0
2528;166751;5;24;27;6;21;.778;2113000;0
2528;46468;11;0;0;0;0;.00nan;0;0
2529;15;30;0;0;0;0;.00nan;0;0
2529;165582;24;67;9;0;9;1.000;1350000;0
2529;17043;30;29;35;7;28;.800;3600000;0
2529;85727;24;49;26;4;22;.846;2250000;0
2530;166381;27;0;0;0;0;.00nan;0;0
2530;170314;25;23;33;7;26;.788;3600000;0
2530;175660;27;94;35;1;34;.971;3600000;0
2530;148958;25;0;0;0;0;.00nan;0;0
2531;2059;23;0;0;0;0;.00nan;0;0
2531;3284;21;57;36;4;32;.889;4160000;0
2531;78573;23;62;38;5;33;.868;4140000;0
2531;143156;21;0;0;0;0;.00nan;0;0
2532;3928;12;79;22;2;20;.909;3600000;0
2532;57338;35;63;40;5;35;.875;3600000;0
2532;91178;12;0;0;0;0;.00nan;0;0
2532;141998;35;0;0;0;0;.00nan;0;0
2533;556;3;100;38;0;38;1.000;3600000;0
2533;169868;4182;0;0;0;0;.00nan;0;0
2533;179344;3;0;0;0;0;.00nan;0;0
2533;147945;4182;85;34;1;33;.971;3567000;0
2534;168712;14;100;33;0;33;1.000;3600000;0
2534;175912;14;0;0;0;0;.00nan;0;0
2534;179950;4838;0;0;0;0;.00nan;0;0
2534;143749;4838;95;37;2;35;.946;3559000;0
2535;676;34;32;28;6;22;.786;3600000;0
2535;78806;34;0;0;0;0;.00nan;0;0
2535;90164;10;0;0;0;0;.00nan;0;0
2535;152717;10;77;37;3;34;.919;3600000;0
2536;163423;26;0;0;0;0;.00nan;0;0
2536;179154;26;87;27;1;26;.963;4200000;0
2536;190465;33;0;0;0;0;.00nan;0;0
2536;86192;33;100;43;1;42;.977;4200000;0
2537;13714;8;84;21;1;20;.952;3600000;0
2537;18213;8;0;0;0;0;.00nan;0;0
2537;77955;28;0;0;0;0;.00nan;0;0
2537;85437;28;82;46;3;43;.935;3559000;0
2538;163195;0;57;37;4;33;.892;3600000;0
2538;167642;18;0;0;0;0;.00nan;0;0
2538;173727;18;57;23;2;21;.913;3600000;0
2538;139409;0;0;0;0;0;.00nan;0;0
2539;171838;31;87;30;2;28;.933;3600000;0
2539;2059;23;0;0;0;0;.00nan;0;0
2539;170977;31;0;0;0;0;.00nan;0;0
2539;78573;23;44;38;6;32;.842;3600000;0
2540;187537;19;80;30;2;28;.933;3600000;0
2540;163565;19;0;0;0;0;.00nan;0;0
2540;163695;9;72;42;4;38;.905;3536000;0
2540;175092;9;0;0;0;0;.00nan;0;0
2541;165582;24;0;0;0;0;.00nan;0;0
2541;179950;4838;0;0;0;0;.00nan;0;0
2541;85727;24;99;38;1;37;.974;3600000;0
2541;143749;4838;98;36;2;34;.944;3562000;0
2542;166646;16;63;24;3;21;.875;3600000;0
2542;169868;4182;0;0;0;0;.00nan;0;0
2542;50065;16;0;0;0;0;.00nan;0;0
2542;147945;4182;64;49;5;44;.898;3535000;0
2543;13337;32;0;0;0;0;.00nan;0;0
2543;183844;29;0;0;0;0;.00nan;0;0
2543;20432;32;54;28;4;24;.857;3535000;0
2543;37818;29;74;24;2;22;.917;3600000;0
2544;57338;35;28;33;7;26;.788;3106000;0
2544;59540;15;100;32;0;32;1.000;3600000;0
2544;71565;15;0;0;0;0;.00nan;0;0
2544;141998;35;51;2;0;2;1.000;494000;0
2545;67;11;0;0;0;0;.00nan;0;0
2545;170314;25;27;30;6;24;.800;3600000;0
2545;46468;11;66;40;5;35;.875;3600000;0
2545;148958;25;0;0;0;0;.00nan;0;0
2546;3928;12;100;23;0;23;1.000;3600000;0
2546;77955;28;70;37;3;34;.919;3600000;0
2546;85437;28;0;0;0;0;.00nan;0;0
2546;91178;12;0;0;0;0;.00nan;0;0
2547;779;5;0;0;0;0;.00nan;0;0
2547;166751;5;74;29;2;27;.931;3600000;0
2547;166381;27;16;26;7;19;.731;3026000;0
2547;175660;27;50;7;1;6;.857;574000;0
2548;178413;17;0;0;0;0;.00nan;0;0
2548;90164;10;86;46;3;43;.935;3544000;0
2548;146862;17;72;23;2;21;.913;3600000;0
2548;152717;10;0;0;0;0;.00nan;0;0
2549;163423;26;0;0;0;0;.00nan;0;0
2549;179154;26;99;22;0;22;1.000;3600000;0
2549;190465;33;51;32;4;28;.875;3286000;0
2549;86192;33;28;8;3;5;.625;314000;0
2550;15;30;0;0;0;0;.00nan;0;0
2550;13714;8;49;17;3;14;.824;3600000;0
2550;17043;30;71;48;5;43;.896;3555000;0
2550;18213;8;0;0;0;0;.00nan;0;0
2551;779;5;0;0;0;0;.00nan;0;0
2551;166751;5;86;40;3;37;.925;3600000;0
2551;163195;0;0;0;0;0;.00nan;0;0
2551;139409;0;48;30;4;26;.867;3553000;0
2552;166591;20;0;0;0;0;.00nan;0;0
2552;169868;4182;0;0;0;0;.00nan;0;0
2552;86697;20;100;37;0;37;1.000;3600000;0
2552;147945;4182;60;32;3;29;.906;3600000;0
2553;67;11;83;39;3;36;.923;3537000;0
2553;556;3;68;20;1;19;.950;3600000;0
2553;179344;3;0;0;0;0;.00nan;0;0
2553;46468;11;0;0;0;0;.00nan;0;0
2554;2059;23;55;18;2;16;.889;3600000;0
2554;183844;29;0;0;0;0;.00nan;0;0
2554;37818;29;72;35;3;32;.914;3553000;0
2554;78573;23;0;0;0;0;.00nan;0;0
2555;187537;19;76;31;2;29;.935;3600000;0
2555;163565;19;0;0;0;0;.00nan;0;0
2555;178413;17;48;23;4;19;.826;2333000;0
2555;146862;17;45;16;3;13;.813;1267000;0
2556;676;34;0;0;0;0;.00nan;0;0
2556;179950;4838;0;0;0;0;.00nan;0;0
2556;78806;34;54;21;3;18;.857;4200000;0
2556;143749;4838;81;40;3;37;.925;4200000;0
2557;171838;31;95;37;1;36;.973;3600000;0
2557;170977;31;0;0;0;0;.00nan;0;0
2557;184770;22;0;0;0;0;.00nan;0;0
2557;143473;22;93;20;0;20;1.000;3600000;0
2558;3284;21;84;27;2;25;.926;3600000;0
2558;167642;18;0;0;0;0;.00nan;0;0
2558;173727;18;74;36;3;33;.917;3574000;0
2558;143156;21;0;0;0;0;.00nan;0;0
2559;163695;9;43;5;1;4;.800;719000;0
2559;165582;24;97;42;3;39;.929;3600000;0
2559;175092;9;49;42;6;36;.857;2881000;0
2559;85727;24;0;0;0;0;.00nan;0;0
2560;13337;32;0;0;0;0;.00nan;0;0
2560;168712;14;54;17;2;15;.882;3600000;0
2560;20432;32;81;46;5;41;.891;3600000;0
2560;175912;14;0;0;0;0;.00nan;0;0
2561;170314;25;64;26;3;23;.885;4081000;0
2561;57338;35;77;37;4;33;.892;4081000;0
2561;141998;35;0;0;0;0;.00nan;0;0
2561;148958;25;0;0;0;0;.00nan;0;0
2562;3928;12;99;40;2;38;.950;3600000;0
2562;166381;27;79;39;3;36;.923;3547000;0
2562;175660;27;0;0;0;0;.00nan;0;0
2562;91178;12;0;0;0;0;.00nan;0;0
2563;15;30;0;0;0;0;.00nan;0;0
2563;17043;30;57;15;2;13;.867;3600000;0
2563;77955;28;0;0;0;0;.00nan;0;0
2563;85437;28;50;54;9;45;.833;3600000;0
2564;166646;16;0;0;0;0;.00nan;0;0
2564;163423;26;0;0;0;0;.00nan;0;0
2564;179154;26;65;28;2;26;.929;3553000;0
2564;50065;16;93;31;1;30;.968;3600000;0
2565;190465;33;0;0;0;0;.00nan;0;0
2565;86192;33;47;33;5;28;.848;3546000;0
2565;90164;10;0;0;0;0;.00nan;0;0
2565;152717;10;63;35;4;31;.886;3600000;0
2566;3284;21;88;16;0;16;1.000;3600000;0
2566;168712;14;68;43;4;39;.907;3600000;0
2566;175912;14;0;0;0;0;.00nan;0;0
2566;143156;21;0;0;0;0;.00nan;0;0
2567;163195;0;0;0;0;0;.00nan;0;0
2567;179950;4838;0;0;0;0;.00nan;0;0
2567;139409;0;83;37;2;35;.946;4185000;0
2567;143749;4838;82;40;2;38;.950;4200000;0
2568;779;5;81;42;4;38;.905;4200000;0
2568;187537;19;61;36;4;32;.889;4164000;0
2568;166751;5;0;0;0;0;.00nan;0;0
2568;163565;19;0;0;0;0;.00nan;0;0
2569;183844;29;0;0;0;0;.00nan;0;0
2569;184770;22;0;0;0;0;.00nan;0;0
2569;37818;29;51;31;4;27;.871;3600000;0
2569;143473;22;90;18;0;18;1.000;3600000;0
2570;676;34;0;0;0;0;.00nan;0;0
2570;166591;20;0;0;0;0;.00nan;0;0
2570;78806;34;77;30;2;28;.933;3600000;0
2570;86697;20;79;51;4;47;.922;3554000;0
2571;167642;18;0;0;0;0;.00nan;0;0
2571;173727;18;92;44;2;42;.955;3600000;0
2571;59540;15;91;22;0;22;1.000;3600000;0
2571;71565;15;0;0;0;0;.00nan;0;0
2572;556;3;0;0;0;0;.00nan;0;0
2572;2059;23;94;48;3;45;.938;4174000;0
2572;179344;3;68;28;2;26;.929;4174000;0
2572;78573;23;0;0;0;0;.00nan;0;0
2573;67;11;0;0;0;0;.00nan;0;0
2573;178413;17;0;0;0;0;.00nan;0;0
2573;46468;11;81;34;2;32;.941;3595000;0
2573;146862;17;82;26;1;25;.962;3600000;0
2574;171838;31;55;34;4;30;.882;3600000;0
2574;169868;4182;0;0;0;0;.00nan;0;0
2574;170977;31;0;0;0;0;.00nan;0;0
2574;147945;4182;64;25;3;22;.880;3600000;0
2575;163695;9;59;33;4;29;.879;3600000;0
2575;13714;8;64;25;3;22;.880;3600000;0
2575;18213;8;0;0;0;0;.00nan;0;0
2575;175092;9;0;0;0;0;.00nan;0;0
2576;57338;35;63;24;2;22;.917;3600000;0
2576;90164;10;28;14;4;10;.714;1080000;0
2576;141998;35;0;0;0;0;.00nan;0;0
2576;152717;10;81;27;1;26;.963;2520000;0
2577;163423;26;0;0;0;0;.00nan;0;0
2577;170314;25;78;30;2;28;.933;3600000;0
2577;179154;26;35;24;5;19;.792;3600000;0
2577;148958;25;0;0;0;0;.00nan;0;0
2578;3928;12;48;20;3;17;.850;3600000;0
2578;190465;33;60;40;4;36;.900;3548000;0
2578;86192;33;0;0;0;0;.00nan;0;0
2578;91178;12;0;0;0;0;.00nan;0;0
2579;166646;16;82;35;3;32;.914;3539000;0
2579;165582;24;0;0;0;0;.00nan;0;0
2579;50065;16;0;0;0;0;.00nan;0;0
2579;85727;24;93;35;1;34;.971;3600000;0
2580;13337;32;0;0;0;0;.00nan;0;0
2580;20432;32;74;19;1;18;.947;3600000;0
2580;77955;28;49;31;4;27;.871;3600000;0
2580;85437;28;0;0;0;0;.00nan;0;0
2581;15;30;0;0;0;0;.00nan;0;0
2581;166381;27;24;27;6;21;.778;3600000;0
2581;17043;30;79;28;1;27;.964;3600000;0
2581;175660;27;0;0;0;0;.00nan;0;0
2582;3284;21;56;21;3;18;.857;3600000;0
2582;168712;14;58;12;1;11;.917;689000;0
2582;175912;14;19;22;6;16;.727;2911000;0
2582;143156;21;0;0;0;0;.00nan;0;0
2583;556;3;51;28;5;23;.821;3716000;0
2583;163695;9;0;0;0;0;.00nan;0;0
2583;179344;3;0;0;0;0;.00nan;0;0
2583;175092;9;92;54;4;50;.926;3716000;0
2584;184770;22;0;0;0;0;.00nan;0;0
2584;77955;28;97;36;0;36;1.000;2668000;0
2584;85437;28;37;20;4;16;.800;932000;0
2584;143473;22;94;19;0;19;1.000;3600000;0
2585;187537;19;0;0;0;0;.00nan;0;0
2585;163195;0;0;0;0;0;.00nan;0;0
2585;163565;19;87;44;3;41;.932;3523000;0
2585;139409;0;69;19;1;18;.947;3600000;0
2586;179950;4838;0;0;0;0;.00nan;0;0
2586;59540;15;54;22;3;19;.864;3537000;0
2586;71565;15;0;0;0;0;.00nan;0;0
2586;143749;4838;92;30;1;29;.967;3600000;0
2587;183844;29;69;23;2;21;.913;3600000;0
2587;169868;4182;0;0;0;0;.00nan;0;0
2587;37818;29;0;0;0;0;.00nan;0;0
2587;147945;4182;50;31;4;27;.871;3557000;0
2588;166591;20;0;0;0;0;.00nan;0;0
2588;2059;23;69;38;4;34;.895;3579000;0
2588;78573;23;0;0;0;0;.00nan;0;0
2588;86697;20;89;38;2;36;.947;3600000;0
2589;165582;24;0;0;0;0;.00nan;0;0
2589;190465;33;0;0;0;0;.00nan;0;0
2589;85727;24;83;41;4;37;.902;4159000;0
2589;86192;33;30;31;5;26;.839;4159000;0
2590;676;34;57;30;4;26;.867;3600000;0
2590;167642;18;0;0;0;0;.00nan;0;0
2590;173727;18;89;36;1;35;.972;3600000;0
2590;78806;34;0;0;0;0;.00nan;0;0
2591;13714;8;63;42;6;36;.857;3093000;0
2591;178413;17;0;0;0;0;.00nan;0;0
2591;18213;8;51;2;0;2;1.000;507000;0
2591;146862;17;89;28;1;27;.964;3600000;0
2592;13337;32;0;0;0;0;.00nan;0;0
2592;20432;32;68;26;2;24;.923;3542000;0
2592;90164;10;0;0;0;0;.00nan;0;0
2592;152717;10;88;28;1;27;.964;3600000;0
2593;15;30;0;0;0;0;.00nan;0;0
2593;166646;16;0;0;0;0;.00nan;0;0
2593;17043;30;53;41;6;35;.854;3570000;0
2593;50065;16;44;27;5;22;.815;3600000;0
2594;167642;18;54;46;6;40;.870;3349000;0
2594;168712;14;85;26;2;24;.923;3600000;0
2594;173727;18;48;0;0;0;.00nan;251000;0
2594;175912;14;0;0;0;0;.00nan;0;0
2595;779;5;0;0;0;0;.00nan;0;0
2595;166751;5;82;35;2;33;.943;3600000;0
2595;13714;8;0;0;0;0;.00nan;0;0
2595;18213;8;53;24;3;21;.875;3571000;0
2596;3284;21;48;33;5;28;.848;3600000;0
2596;169868;4182;100;33;0;33;1.000;3600000;0
2596;143156;21;0;0;0;0;.00nan;0;0
2596;147945;4182;0;0;0;0;.00nan;0;0
2597;2059;23;0;0;0;0;.00nan;0;0
2597;163423;26;0;0;0;0;.00nan;0;0
2597;179154;26;57;18;3;15;.833;4200000;0
2597;78573;23;86;39;3;36;.923;4200000;0
2598;165582;24;70;32;3;29;.906;4200000;0
2598;57338;35;80;35;3;32;.914;4200000;0
2598;85727;24;0;0;0;0;.00nan;0;0
2598;141998;35;0;0;0;0;.00nan;0;0
2599;187537;19;91;41;3;38;.927;3600000;0
2599;163565;19;0;0;0;0;.00nan;0;0
2599;170314;25;39;28;5;23;.821;3532000;0
2599;148958;25;0;0;0;0;.00nan;0;0
2600;3928;12;96;42;2;40;.952;3548000;0
2600;166381;27;0;0;0;0;.00nan;0;0
2600;175660;27;87;30;1;29;.967;3600000;0
2600;91178;12;0;0;0;0;.00nan;0;0
2601;67;11;0;0;0;0;.00nan;0;0
2601;163695;9;68;27;2;25;.926;3565000;0
2601;175092;9;0;0;0;0;.00nan;0;0
2601;46468;11;95;35;1;34;.971;3600000;0
2602;556;3;22;5;3;2;.400;368000;0
2602;183844;29;0;0;0;0;.00nan;0;0
2602;179344;3;56;31;3;28;.903;3154000;0
2602;37818;29;53;34;4;30;.882;3600000;0
2603;178413;17;47;29;4;25;.862;2883000;0
2603;184770;22;0;0;0;0;.00nan;0;0
2603;143473;22;72;17;1;16;.941;3600000;0
2603;146862;17;20;9;4;5;.556;717000;0
2604;163195;0;78;31;2;29;.935;3600000;0
2604;170314;25;0;0;0;0;.00nan;0;0
2604;139409;0;0;0;0;0;.00nan;0;0
2604;148958;25;84;39;3;36;.923;3573000;0
2605;13714;8;32;9;3;6;.667;386000;0
2605;18213;8;76;17;0;17;1.000;3214000;0
2605;77955;28;64;40;4;36;.900;3587000;0
2605;85437;28;0;0;0;0;.00nan;0;0
2606;779;5;0;0;0;0;.00nan;0;0
2606;166751;5;91;42;2;40;.952;3600000;0
2606;178413;17;0;0;0;0;.00nan;0;0
2606;146862;17;59;33;4;29;.879;3598000;0
2607;163423;26;0;0;0;0;.00nan;0;0
2607;179154;26;100;17;0;17;1.000;3600000;0
2607;90164;10;77;25;2;23;.920;3517000;0
2607;152717;10;0;0;0;0;.00nan;0;0
2608;171838;31;73;40;4;36;.900;3600000;0
2608;170977;31;0;0;0;0;.00nan;0;0
2608;190465;33;0;0;0;0;.00nan;0;0
2608;86192;33;81;15;0;15;1.000;3600000;0
2609;3284;21;78;29;2;27;.931;3862000;0
2609;13337;32;0;0;0;0;.00nan;0;0
2609;20432;32;99;41;1;40;.976;3862000;0
2609;143156;21;0;0;0;0;.00nan;0;0
2610;163695;9;0;0;0;0;.00nan;0;0
2610;166381;27;61;18;2;16;.889;3600000;0
2610;175092;9;77;49;4;45;.918;3574000;0
2610;175660;27;0;0;0;0;.00nan;0;0
2611;67;11;54;27;4;23;.852;3600000;0
2611;167642;18;0;0;0;0;.00nan;0;0
2611;173727;18;49;32;5;27;.844;3549000;0
2611;46468;11;0;0;0;0;.00nan;0;0
2612;166646;16;0;0;0;0;.00nan;0;0
2612;2059;23;0;0;0;0;.00nan;0;0
2612;50065;16;84;27;1;26;.963;3912000;0
2612;78573;23;93;39;2;37;.949;3912000;0
2613;3928;12;82;33;3;30;.909;3600000;0
2613;179950;4838;72;49;5;44;.898;3600000;0
2613;91178;12;0;0;0;0;.00nan;0;0
2613;143749;4838;0;0;0;0;.00nan;0;0
2614;15;30;0;0;0;0;.00nan;0;0
2614;17043;30;56;34;5;29;.853;3591000;0
2614;168712;14;32;17;4;13;.765;2003000;0
2614;175912;14;70;13;0;13;1.000;1597000;0
2615;556;3;100;39;1;38;.974;3600000;0
2615;166591;20;0;0;0;0;.00nan;0;0
2615;179344;3;0;0;0;0;.00nan;0;0
2615;86697;20;80;42;4;38;.905;3600000;0
2616;184770;22;0;0;0;0;.00nan;0;0
2616;59540;15;58;27;4;23;.852;3659000;0
2616;71565;15;0;0;0;0;.00nan;0;0
2616;143473;22;73;30;3;27;.900;3659000;0
2617;183844;29;0;0;0;0;.00nan;0;0
2617;190465;33;0;0;0;0;.00nan;0;0
2617;37818;29;54;34;4;30;.882;3600000;0
2617;86192;33;60;28;3;25;.893;3600000;0
2618;165582;24;0;0;0;0;.00nan;0;0
2618;170314;25;99;34;1;33;.971;3600000;0
2618;85727;24;84;31;2;29;.935;3559000;0
2618;148958;25;0;0;0;0;.00nan;0;0
2619;171838;31;81;43;4;39;.907;3581000;0
2619;163195;0;0;0;0;0;.00nan;0;0
2619;170977;31;0;0;0;0;.00nan;0;0
2619;139409;0;67;17;2;15;.882;3600000;0
2620;13714;8;75;19;1;18;.947;3600000;0
2620;18213;8;0;0;0;0;.00nan;0;0
2620;90164;10;75;38;3;35;.921;2593000;0
2620;152717;10;32;13;4;9;.692;1007000;0
2621;166646;16;89;33;1;32;.970;3600000;0
2621;3928;12;79;36;3;33;.917;3559000;0
2621;50065;16;0;0;0;0;.00nan;0;0
2621;91178;12;0;0;0;0;.00nan;0;0
2622;779;5;0;0;0;0;.00nan;0;0
2622;166751;5;41;48;7;41;.854;3600000;0
2622;57338;35;82;30;2;28;.933;3600000;0
2622;141998;35;0;0;0;0;.00nan;0;0
2623;178413;17;0;0;0;0;.00nan;0;0
2623;77955;28;97;41;1;40;.976;4200000;0
2623;85437;28;0;0;0;0;.00nan;0;0
2623;146862;17;79;14;1;13;.929;4200000;0
2624;163423;26;0;0;0;0;.00nan;0;0
2624;179154;26;98;40;2;38;.950;3600000;0
2624;184770;22;94;18;0;18;1.000;3600000;0
2624;143473;22;0;0;0;0;.00nan;0;0
2625;163695;9;85;44;3;41;.932;3600000;0
2625;175092;9;0;0;0;0;.00nan;0;0
2625;179950;4838;0;0;0;0;.00nan;0;0
2625;143749;4838;57;27;4;23;.852;3581000;0
2626;3284;21;88;19;0;19;1.000;3600000;0
2626;13337;32;67;46;6;40;.870;3298000;0
2626;20432;32;49;1;0;1;1.000;302000;0
2626;143156;21;0;0;0;0;.00nan;0;0
2627;67;11;0;0;0;0;.00nan;0;0
2627;166381;27;66;24;2;22;.917;3600000;0
2627;175660;27;0;0;0;0;.00nan;0;0
2627;46468;11;87;43;3;40;.930;3580000;0
2628;187537;19;0;0;0;0;.00nan;0;0
2628;163565;19;93;31;2;29;.935;3600000;0
2628;169868;4182;62;30;3;27;.900;3571000;0
2628;147945;4182;0;0;0;0;.00nan;0;0
2629;15;30;0;0;0;0;.00nan;0;0
2629;676;34;0;0;0;0;.00nan;0;0
2629;17043;30;62;39;5;34;.872;3874000;0
2629;78806;34;49;24;4;20;.833;3874000;0
2630;2059;23;0;0;0;0;.00nan;0;0
2630;168712;14;59;26;3;23;.885;3600000;0
2630;175912;14;0;0;0;0;.00nan;0;0
2630;78573;23;55;37;4;33;.892;3559000;0
2631;779;5;48;40;6;34;.850;3600000;0
2631;166751;5;0;0;0;0;.00nan;0;0
2631;90164;10;0;0;0;0;.00nan;0;0
2631;152717;10;100;38;1;37;.974;3600000;0
2632;166591;20;0;0;0;0;.00nan;0;0
2632;190465;33;0;0;0;0;.00nan;0;0
2632;86192;33;92;42;2;40;.952;3543000;0
2632;86697;20;93;41;1;40;.976;3600000;0
2633;556;3;100;19;0;19;1.000;3600000;0
2633;171838;31;86;37;3;34;.919;3600000;0
2633;170977;31;0;0;0;0;.00nan;0;0
2633;179344;3;0;0;0;0;.00nan;0;0
2634;163423;26;65;53;6;47;.887;3600000;0
2634;165582;24;0;0;0;0;.00nan;0;0
2634;179154;26;0;0;0;0;.00nan;0;0
2634;85727;24;95;30;1;29;.967;3600000;0
2635;168712;14;99;37;1;36;.973;4200000;0
2635;169868;4182;0;0;0;0;.00nan;0;0
2635;175912;14;0;0;0;0;.00nan;0;0
2635;147945;4182;97;42;1;41;.976;4200000;0
2636;163695;9;0;0;0;0;.00nan;0;0
2636;167642;18;0;0;0;0;.00nan;0;0
2636;173727;18;84;40;3;37;.925;3600000;0
2636;175092;9;52;30;5;25;.833;3550000;0
2637;57338;35;68;26;2;24;.923;3600000;0
2637;77955;28;0;0;0;0;.00nan;0;0
2637;85437;28;68;40;3;37;.925;3584000;0
2637;141998;35;0;0;0;0;.00nan;0;0
2638;15;30;0;0;0;0;.00nan;0;0
2638;17043;30;71;37;4;33;.892;3600000;0
2638;184770;22;0;0;0;0;.00nan;0;0
2638;143473;22;64;17;1;16;.941;3600000;0
2639;166646;16;0;0;0;0;.00nan;0;0
2639;183844;29;62;17;1;16;.941;1820000;0
2639;37818;29;28;21;5;16;.762;1758000;0
2639;50065;16;47;21;4;17;.810;3600000;0
2640;676;34;65;30;3;27;.900;4200000;0
2640;3928;12;81;42;3;39;.929;4200000;0
2640;78806;34;0;0;0;0;.00nan;0;0
2640;91178;12;0;0;0;0;.00nan;0;0
2641;174718;25;92;48;3;45;.938;4159000;0
2641;179950;4838;0;0;0;0;.00nan;0;0
2641;143749;4838;75;30;2;28;.933;4159000;0
2641;148958;25;0;0;0;0;.00nan;0;0
2642;187537;19;0;0;0;0;.00nan;0;0
2642;2059;23;58;39;5;34;.872;3516000;0
2642;163565;19;49;22;3;19;.864;3600000;0
2642;78573;23;0;0;0;0;.00nan;0;0
2643;556;3;46;22;3;19;.864;3600000;0
2643;163423;26;0;0;0;0;.00nan;0;0
2643;179154;26;76;22;1;21;.955;3600000;0
2643;179344;3;0;0;0;0;.00nan;0;0
2644;779;5;0;0;0;0;.00nan;0;0
2644;166751;5;51;50;8;42;.840;3600000;0
2644;178413;17;0;0;0;0;.00nan;0;0
2644;146862;17;98;33;1;32;.970;3600000;0
2645;171838;31;59;25;3;22;.880;4185000;0
2645;170977;31;0;0;0;0;.00nan;0;0
2645;90164;10;0;0;0;0;.00nan;0;0
2645;152717;10;75;32;2;30;.938;4185000;0
2646;15;30;36;5;2;3;.600;275000;0
2646;165582;24;0;0;0;0;.00nan;0;0
2646;17043;30;59;39;6;33;.846;3325000;0
2646;85727;24;100;22;0;22;1.000;3600000;0
2647;3284;21;74;24;2;22;.917;3600000;0
2647;190465;33;0;0;0;0;.00nan;0;0
2647;86192;33;82;40;3;37;.925;3545000;0
2647;143156;21;0;0;0;0;.00nan;0;0
2648;13337;32;0;0;0;0;.00nan;0;0
2648;166381;27;52;26;4;22;.846;3552000;0
2648;20432;32;92;46;3;43;.935;3600000;0
2648;175660;27;0;0;0;0;.00nan;0;0
2649;67;11;35;34;6;28;.824;3600000;0
2649;46468;11;0;0;0;0;.00nan;0;0
2649;59540;15;76;21;1;20;.952;3600000;0
2649;71565;15;0;0;0;0;.00nan;0;0
2650;163195;0;0;0;0;0;.00nan;0;0
2650;169868;4182;0;0;0;0;.00nan;0;0
2650;139409;0;99;42;1;41;.976;3600000;0
2650;147945;4182;61;19;2;17;.895;3559000;0
2651;187537;19;100;22;0;22;1.000;3600000;0
2651;163565;19;0;0;0;0;.00nan;0;0
2651;168712;14;63;32;3;29;.906;3600000;0
2651;175912;14;0;0;0;0;.00nan;0;0
2652;3928;12;78;28;2;26;.929;3600000;0
2652;183844;29;93;48;3;45;.938;3558000;0
2652;37818;29;0;0;0;0;.00nan;0;0
2652;91178;12;0;0;0;0;.00nan;0;0
2653;163695;9;0;0;0;0;.00nan;0;0
2653;175092;9;73;29;2;27;.931;3600000;0
2653;57338;35;84;42;4;38;.905;3564000;0
2653;141998;35;0;0;0;0;.00nan;0;0
2654;166591;20;0;0;0;0;.00nan;0;0
2654;77955;28;0;0;0;0;.00nan;0;0
2654;85437;28;100;38;1;37;.974;4200000;0
2654;86697;20;80;29;1;28;.966;4200000;0
2655;3284;21;0;0;0;0;.00nan;0;0
2655;13714;8;81;36;3;33;.917;3548000;0
2655;18213;8;0;0;0;0;.00nan;0;0
2655;143156;21;75;26;2;24;.923;3600000;0
2656;167642;18;0;0;0;0;.00nan;0;0
2656;173727;18;60;36;4;32;.889;3583000;0
2656;174718;25;75;33;3;30;.909;3600000;0
2656;148958;25;0;0;0;0;.00nan;0;0
2657;13337;32;0;0;0;0;.00nan;0;0
2657;20432;32;81;35;3;32;.914;3978000;0
2657;179950;4838;0;0;0;0;.00nan;0;0
2657;143749;4838;75;30;2;28;.933;3978000;0
2658;2059;23;0;0;0;0;.00nan;0;0
2658;163195;0;90;23;0;23;1.000;3600000;0
2658;78573;23;56;43;6;37;.860;3600000;0
2658;139409;0;0;0;0;0;.00nan;0;0
2659;166591;20;67;41;5;36;.878;3596000;0
2659;184770;22;0;0;0;0;.00nan;0;0
2659;86697;20;0;0;0;0;.00nan;0;0
2659;143473;22;53;21;3;18;.857;3600000;0
2660;556;3;66;24;3;21;.875;3600000;0
2660;179344;3;0;0;0;0;.00nan;0;0
2660;90164;10;0;0;0;0;.00nan;0;0
2660;152717;10;100;38;0;38;1.000;3600000;0
2661;165582;24;0;0;0;0;.00nan;0;0
2661;178413;17;0;0;0;0;.00nan;0;0
2661;85727;24;84;28;2;26;.929;3600000;0
2661;146862;17;63;27;3;24;.889;3598000;0
2662;779;5;0;0;0;0;.00nan;0;0
2662;166751;5;69;32;4;28;.875;3600000;0
2662;77955;28;82;26;1;25;.962;3600000;0
2662;85437;28;0;0;0;0;.00nan;0;0
2663;171838;31;91;30;1;29;.967;3600000;0
2663;3928;12;88;40;2;38;.950;3557000;0
2663;170977;31;0;0;0;0;.00nan;0;0
2663;91178;12;0;0;0;0;.00nan;0;0
2664;163423;26;0;0;0;0;.00nan;0;0
2664;169868;4182;0;0;0;0;.00nan;0;0
2664;179154;26;97;35;2;33;.943;3558000;0
2664;147945;4182;96;22;0;22;1.000;3600000;0
2665;166646;16;0;0;0;0;.00nan;0;0
2665;190465;33;0;0;0;0;.00nan;0;0
2665;50065;16;60;25;3;22;.880;3600000;0
2665;86192;33;44;26;4;22;.846;3562000;0
2666;166381;27;70;31;3;28;.903;4200000;0
2666;175660;27;0;0;0;0;.00nan;0;0
2666;59540;15;90;36;3;33;.917;4200000;0
2666;71565;15;0;0;0;0;.00nan;0;0
2667;67;11;0;0;0;0;.00nan;0;0
2667;174718;25;0;0;0;0;.00nan;0;0
2667;46468;11;43;33;5;28;.848;3600000;0
2667;148958;25;61;29;4;25;.862;3600000;0
2668;15;30;0;0;0;0;.00nan;0;0
2668;17043;30;71;36;3;33;.917;4200000;0
2668;168712;14;94;48;3;45;.938;4200000;0
2668;175912;14;0;0;0;0;.00nan;0;0
2669;676;34;0;0;0;0;.00nan;0;0
2669;183844;29;58;41;6;35;.854;3539000;0
2669;37818;29;0;0;0;0;.00nan;0;0
2669;78806;34;61;27;3;24;.889;3600000;0
2670;2059;23;0;0;0;0;.00nan;0;0
2670;13714;8;0;0;0;0;.00nan;0;0
2670;18213;8;58;22;2;20;.909;3600000;0
2670;78573;23;93;32;1;31;.969;3600000;0
2671;167642;18;0;0;0;0;.00nan;0;0
2671;13337;32;0;0;0;0;.00nan;0;0
2671;20432;32;70;35;4;31;.886;3587000;0
2671;173727;18;65;30;3;27;.900;3600000;0
2672;77955;28;43;7;2;5;.714;322000;0
2672;85437;28;58;42;6;36;.857;3278000;0
2672;90164;10;0;0;0;0;.00nan;0;0
2672;152717;10;67;31;3;28;.903;3600000;0
2673;3284;21;81;27;1;26;.963;3600000;0
2673;163423;26;0;0;0;0;.00nan;0;0
2673;179154;26;52;40;6;34;.850;3600000;0
2673;143156;21;0;0;0;0;.00nan;0;0
2674;67;11;51;41;5;36;.878;3600000;0
2674;166646;16;0;0;0;0;.00nan;0;0
2674;46468;11;0;0;0;0;.00nan;0;0
2674;50065;16;68;29;2;27;.931;3600000;0
2675;187537;19;87;33;2;31;.939;3641000;0
2675;163195;0;63;28;3;25;.893;3641000;0
2675;163565;19;0;0;0;0;.00nan;0;0
2675;139409;0;0;0;0;0;.00nan;0;0
2676;166591;20;0;0;0;0;.00nan;0;0
2676;3928;12;81;12;0;12;1.000;3600000;0
2676;86697;20;98;68;5;63;.926;3600000;0
2676;91178;12;0;0;0;0;.00nan;0;0
2677;15;30;0;0;0;0;.00nan;0;0
2677;556;3;28;29;6;23;.793;3571000;0
2677;17043;30;84;42;4;38;.905;3600000;0
2677;179344;3;0;0;0;0;.00nan;0;0
2678;779;5;0;0;0;0;.00nan;0;0
2678;166751;5;73;30;2;28;.933;3558000;0
2678;168712;14;90;30;1;29;.967;3600000;0
2678;175912;14;0;0;0;0;.00nan;0;0
2679;676;34;99;40;1;39;.975;3600000;0
2679;178413;17;0;0;0;0;.00nan;0;0
2679;78806;34;0;0;0;0;.00nan;0;0
2679;146862;17;22;25;6;19;.760;3600000;0
2680;171838;31;32;29;6;23;.793;2615000;0
2680;170977;31;35;13;3;10;.769;985000;0
2680;184770;22;0;0;0;0;.00nan;0;0
2680;143473;22;75;26;2;24;.923;3600000;0
2681;163695;9;0;0;0;0;.00nan;0;0
2681;175092;9;71;40;4;36;.900;3600000;0
2681;57338;35;99;20;0;20;1.000;3600000;0
2681;141998;35;0;0;0;0;.00nan;0;0
2682;165582;24;0;0;0;0;.00nan;0;0
2682;183844;29;50;6;1;5;.833;498000;0
2682;37818;29;46;48;7;41;.854;3102000;0
2682;85727;24;93;22;0;22;1.000;3600000;0
2683;169868;4182;64;19;1;18;.947;2470000;0
2683;190465;33;0;0;0;0;.00nan;0;0
2683;86192;33;66;31;3;28;.903;3600000;0
2683;147945;4182;45;17;4;13;.765;1094000;0
2684;166381;27;67;28;2;26;.929;3600000;0
2684;174718;25;81;47;5;42;.894;3600000;0
2684;175660;27;0;0;0;0;.00nan;0;0
2684;148958;25;0;0;0;0;.00nan;0;0
2685;179950;4838;0;0;0;0;.00nan;0;0
2685;59540;15;74;25;2;23;.920;4200000;0
2685;71565;15;0;0;0;0;.00nan;0;0
2685;143749;4838;93;48;2;46;.958;4200000;0
2686;2059;23;0;0;0;0;.00nan;0;0
2686;13337;32;0;0;0;0;.00nan;0;0
2686;20432;32;73;23;2;21;.913;3600000;0
2686;78573;23;55;28;4;24;.857;3548000;0
2687;167642;18;58;37;4;33;.892;3856000;0
2687;173727;18;0;0;0;0;.00nan;0;0
2687;59540;15;60;25;3;22;.880;3856000;0
2687;71565;15;0;0;0;0;.00nan;0;0
2688;779;5;72;37;4;33;.892;3594000;0
2688;166646;16;0;0;0;0;.00nan;0;0
2688;166751;5;0;0;0;0;.00nan;0;0
2688;50065;16;70;27;2;25;.926;3600000;0
2689;13337;32;0;0;0;0;.00nan;0;0
2689;20432;32;83;35;4;31;.886;3600000;0
2689;59540;15;27;25;6;19;.760;3513000;0
2689;71565;15;0;0;0;0;.00nan;0;0
2690;187537;19;0;0;0;0;.00nan;0;0
2690;163565;19;83;26;1;25;.962;3600000;0
2690;167642;18;0;0;0;0;.00nan;0;0
2690;173727;18;60;37;4;33;.892;3600000;0
2691;556;3;0;0;0;0;.00nan;0;0
2691;779;5;0;0;0;0;.00nan;0;0
2691;166751;5;74;39;3;36;.923;4040000;0
2691;179344;3;59;21;2;19;.905;4040000;0
2692;166646;16;76;23;1;22;.957;3600000;0
2692;2059;23;0;0;0;0;.00nan;0;0
2692;50065;16;0;0;0;0;.00nan;0;0
2692;78573;23;70;32;3;29;.906;3558000;0
2693;187537;19;58;20;2;18;.900;3600000;0
2693;163565;19;0;0;0;0;.00nan;0;0
2693;169868;4182;0;0;0;0;.00nan;0;0
2693;147945;4182;40;27;5;22;.815;3600000;0
2694;13714;8;73;31;3;28;.903;3570000;0
2694;18213;8;0;0;0;0;.00nan;0;0
2694;168712;14;85;36;2;34;.944;3600000;0
2694;175912;14;0;0;0;0;.00nan;0;0
2695;163695;9;70;31;3;28;.903;3564000;0
2695;165582;24;0;0;0;0;.00nan;0;0
2695;175092;9;0;0;0;0;.00nan;0;0
2695;85727;24;89;28;1;27;.964;3600000;0
2696;166381;27;0;0;0;0;.00nan;0;0
2696;175660;27;64;24;2;22;.917;3526000;0
2696;77955;28;100;40;0;40;1.000;3600000;0
2696;85437;28;0;0;0;0;.00nan;0;0
2697;163195;0;0;0;0;0;.00nan;0;0
2697;163423;26;0;0;0;0;.00nan;0;0
2697;179154;26;47;33;5;28;.848;3591000;0
2697;139409;0;70;32;3;29;.906;3600000;0
2698;166591;20;0;0;0;0;.00nan;0;0
2698;179950;4838;0;0;0;0;.00nan;0;0
2698;86697;20;81;30;2;28;.933;3600000;0
2698;143749;4838;68;34;3;31;.912;3557000;0
2699;183844;29;100;43;1;42;.977;4200000;0
2699;37818;29;0;0;0;0;.00nan;0;0
2699;90164;10;0;0;0;0;.00nan;0;0
2699;152717;10;93;38;1;37;.974;4200000;0
2700;13714;8;0;0;0;0;.00nan;0;0
2700;18213;8;100;39;1;38;.974;4200000;0
2700;184770;22;0;0;0;0;.00nan;0;0
2700;143473;22;73;23;1;22;.957;4200000;0
2701;676;34;0;0;0;0;.00nan;0;0
2701;57338;35;67;43;5;38;.884;3600000;0
2701;78806;34;83;23;1;22;.957;3600000;0
2701;141998;35;0;0;0;0;.00nan;0;0
2702;3284;21;85;32;2;30;.938;4073000;0
2702;178413;17;0;0;0;0;.00nan;0;0
2702;143156;21;0;0;0;0;.00nan;0;0
2702;146862;17;79;44;3;41;.932;4073000;0
2703;15;30;0;0;0;0;.00nan;0;0
2703;67;11;0;0;0;0;.00nan;0;0
2703;17043;30;81;25;1;24;.960;3600000;0
2703;46468;11;64;32;3;29;.906;3521000;0
2704;171838;31;89;30;1;29;.967;3600000;0
2704;168712;14;63;32;4;28;.875;3600000;0
2704;170977;31;0;0;0;0;.00nan;0;0
2704;175912;14;0;0;0;0;.00nan;0;0
2705;163423;26;61;29;3;26;.897;3783000;0
2705;163695;9;0;0;0;0;.00nan;0;0
2705;179154;26;0;0;0;0;.00nan;0;0
2705;175092;9;57;31;4;27;.871;3783000;0
2706;174718;25;62;28;3;25;.893;4200000;0
2706;190465;33;0;0;0;0;.00nan;0;0
2706;86192;33;68;39;3;36;.923;4200000;0
2706;148958;25;0;0;0;0;.00nan;0;0
2707;179950;4838;0;0;0;0;.00nan;0;0
2707;77955;28;83;34;2;32;.941;3578000;0
2707;85437;28;0;0;0;0;.00nan;0;0
2707;143749;4838;85;23;1;22;.957;3600000;0
2708;3284;21;93;31;1;30;.968;3600000;0
2708;183844;29;0;0;0;0;.00nan;0;0
2708;37818;29;72;28;2;26;.929;3562000;0
2708;143156;21;0;0;0;0;.00nan;0;0
2709;166381;27;86;44;2;42;.955;4200000;0
2709;175660;27;0;0;0;0;.00nan;0;0
2709;184770;22;72;23;2;21;.913;4200000;0
2709;143473;22;0;0;0;0;.00nan;0;0
2710;57338;35;69;25;2;23;.920;3600000;0
2710;90164;10;59;41;4;37;.902;3561000;0
2710;141998;35;0;0;0;0;.00nan;0;0
2710;152717;10;0;0;0;0;.00nan;0;0
2711;171838;31;0;0;0;0;.00nan;0;0
2711;165582;24;0;0;0;0;.00nan;0;0
2711;170977;31;50;37;5;32;.865;3577000;0
2711;85727;24;54;26;4;22;.846;3600000;0
2712;166591;20;0;0;0;0;.00nan;0;0
2712;13714;8;65;24;3;21;.875;3551000;0
2712;18213;8;0;0;0;0;.00nan;0;0
2712;86697;20;94;40;2;38;.950;3600000;0
2713;15;30;0;0;0;0;.00nan;0;0
2713;3928;12;74;31;2;29;.935;3600000;0
2713;17043;30;56;26;3;23;.885;3551000;0
2713;91178;12;0;0;0;0;.00nan;0;0
2714;676;34;59;35;5;30;.857;3600000;0
2714;190465;33;0;0;0;0;.00nan;0;0
2714;78806;34;0;0;0;0;.00nan;0;0
2714;86192;33;80;40;3;37;.925;3600000;0
2715;168712;14;97;48;2;46;.958;4200000;0
2715;174718;25;85;28;2;26;.929;4200000;0
2715;175912;14;0;0;0;0;.00nan;0;0
2715;148958;25;0;0;0;0;.00nan;0;0
2716;67;11;82;56;4;52;.929;3558000;0
2716;169868;4182;0;0;0;0;.00nan;0;0
2716;46468;11;0;0;0;0;.00nan;0;0
2716;147945;4182;61;24;2;22;.917;3600000;0
2717;163195;0;0;0;0;0;.00nan;0;0
2717;13337;32;0;0;0;0;.00nan;0;0
2717;20432;32;65;45;5;40;.889;3600000;0
2717;139409;0;61;18;2;16;.889;3600000;0
2718;556;3;100;47;1;46;.979;3600000;0
2718;179344;3;0;0;0;0;.00nan;0;0
2718;179950;4838;0;0;0;0;.00nan;0;0
2718;143749;4838;58;28;4;24;.857;3600000;0
2719;163423;26;0;0;0;0;.00nan;0;0
2719;178413;17;0;0;0;0;.00nan;0;0
2719;179154;26;60;26;2;24;.923;3597000;0
2719;146862;17;83;24;1;23;.958;3600000;0
2720;165582;24;0;0;0;0;.00nan;0;0
2720;166381;27;78;29;2;27;.931;3600000;0
2720;175660;27;0;0;0;0;.00nan;0;0
2720;85727;24;88;51;5;46;.902;3600000;0
2721;3284;21;80;24;1;23;.958;3600000;0
2721;77955;28;0;0;0;0;.00nan;0;0
2721;85437;28;51;40;6;34;.850;3600000;0
2721;143156;21;0;0;0;0;.00nan;0;0
2722;13714;8;87;31;1;30;.968;3600000;0
2722;183844;29;0;0;0;0;.00nan;0;0
2722;18213;8;0;0;0;0;.00nan;0;0
2722;37818;29;65;23;2;21;.913;3580000;0
2723;166591;20;0;0;0;0;.00nan;0;0
2723;184770;22;0;0;0;0;.00nan;0;0
2723;86697;20;81;35;3;32;.914;3527000;0
2723;143473;22;62;15;1;14;.933;3600000;0
2724;171838;31;39;36;6;30;.833;3600000;0
2724;170977;31;0;0;0;0;.00nan;0;0
2724;59540;15;53;22;3;19;.864;3600000;0
2724;71565;15;0;0;0;0;.00nan;0;0
2725;779;5;0;0;0;0;.00nan;0;0
2725;166751;5;100;49;1;48;.980;4200000;0
2725;163695;9;0;0;0;0;.00nan;0;0
2725;175092;9;95;40;1;39;.975;4200000;0
2726;167642;18;0;0;0;0;.00nan;0;0
2726;173727;18;54;41;5;36;.878;3600000;0
2726;90164;10;0;0;0;0;.00nan;0;0
2726;152717;10;54;38;6;32;.842;3512000;0
2727;676;34;0;0;0;0;.00nan;0;0
2727;57338;35;48;32;5;27;.844;3854000;0
2727;78806;34;59;31;4;27;.871;3854000;0
2727;141998;35;0;0;0;0;.00nan;0;0
2728;166646;16;0;0;0;0;.00nan;0;0
2728;3928;12;81;35;2;33;.943;3551000;0
2728;50065;16;99;36;1;35;.972;3600000;0
2728;91178;12;0;0;0;0;.00nan;0;0
2729;67;11;0;0;0;0;.00nan;0;0
2729;2059;23;0;0;0;0;.00nan;0;0
2729;46468;11;53;34;5;29;.853;3575000;0
2729;78573;23;58;29;4;25;.862;3600000;0
2730;13337;32;0;0;0;0;.00nan;0;0
2730;178413;17;44;31;5;26;.839;3552000;0
2730;20432;32;56;30;4;26;.867;3600000;0
2730;146862;17;0;0;0;0;.00nan;0;0
2731;3284;21;0;0;0;0;.00nan;0;0
2731;179950;4838;98;47;2;45;.957;3600000;0
2731;143156;21;81;12;0;12;1.000;3600000;0
2731;143749;4838;0;0;0;0;.00nan;0;0
2732;167642;18;0;0;0;0;.00nan;0;0
2732;173727;18;59;26;3;23;.885;3600000;0
2732;184770;22;0;0;0;0;.00nan;0;0
2732;143473;22;31;26;5;21;.808;3581000;0
2733;166381;27;82;31;2;29;.935;3600000;0
2733;168712;14;0;0;0;0;.00nan;0;0
2733;175660;27;0;0;0;0;.00nan;0;0
2733;175912;14;61;32;3;29;.906;3547000;0
2734;3928;12;62;26;3;23;.885;3595000;0
2734;90164;10;0;0;0;0;.00nan;0;0
2734;91178;12;0;0;0;0;.00nan;0;0
2734;152717;10;100;40;2;38;.950;3600000;0
2735;15;30;0;0;0;0;.00nan;0;0
2735;17043;30;66;16;1;15;.938;3600000;0
2735;190465;33;0;0;0;0;.00nan;0;0
2735;86192;33;79;39;4;35;.897;3600000;0
2736;171838;31;31;8;3;5;.625;544000;0
2736;170977;31;50;21;3;18;.857;3056000;0
2736;77955;28;86;27;1;26;.963;3600000;0
2736;85437;28;0;0;0;0;.00nan;0;0
2737;2059;23;0;0;0;0;.00nan;0;0
2737;163195;0;0;0;0;0;.00nan;0;0
2737;78573;23;89;31;1;30;.968;3600000;0
2737;139409;0;58;20;2;18;.900;3541000;0
2738;178413;17;0;0;0;0;.00nan;0;0
2738;169868;4182;0;0;0;0;.00nan;0;0
2738;146862;17;94;48;3;45;.938;4155000;0
2738;147945;4182;75;24;2;22;.917;4163000;0
2739;779;5;85;27;1;26;.963;4108000;0
2739;166751;5;0;0;0;0;.00nan;0;0
2739;59540;15;79;32;2;30;.938;4108000;0
2739;71565;15;0;0;0;0;.00nan;0;0
2740;163695;9;0;0;0;0;.00nan;0;0
2740;13337;32;0;0;0;0;.00nan;0;0
2740;20432;32;74;32;3;29;.906;3531000;0
2740;175092;9;93;33;1;32;.970;3600000;0
2741;3284;21;0;0;0;0;.00nan;0;0
2741;13714;8;48;24;4;20;.833;3600000;0
2741;18213;8;0;0;0;0;.00nan;0;0
2741;143156;21;53;38;5;33;.868;3600000;0
2742;167642;18;39;28;6;22;.786;2155000;0
2742;165582;24;20;8;4;4;.500;487000;0
2742;173727;18;70;15;0;15;1.000;1438000;0
2742;85727;24;79;25;1;24;.960;3113000;0
2743;166591;20;0;0;0;0;.00nan;0;0
2743;163423;26;0;0;0;0;.00nan;0;0
2743;179154;26;64;32;4;28;.875;4200000;0
2743;86697;20;60;36;4;32;.889;4200000;0
2744;166646;16;0;0;0;0;.00nan;0;0
2744;184770;22;68;34;3;31;.912;3600000;0
2744;50065;16;76;24;2;22;.917;3600000;0
2744;143473;22;0;0;0;0;.00nan;0;0
2745;174718;25;62;22;2;20;.909;3600000;0
2745;179950;4838;0;0;0;0;.00nan;0;0
2745;143749;4838;51;35;5;30;.857;3600000;0
2745;148958;25;0;0;0;0;.00nan;0;0
2746;67;11;97;54;1;53;.981;4200000;0
2746;556;3;82;22;1;21;.955;4200000;0
2746;179344;3;0;0;0;0;.00nan;0;0
2746;46468;11;0;0;0;0;.00nan;0;0
2747;676;34;69;28;2;26;.929;3600000;0
2747;183844;29;24;35;7;28;.800;3600000;0
2747;37818;29;0;0;0;0;.00nan;0;0
2747;78806;34;0;0;0;0;.00nan;0;0
2748;187537;19;56;33;5;28;.848;3600000;0
2748;163565;19;0;0;0;0;.00nan;0;0
2748;57338;35;61;20;2;18;.900;3600000;0
2748;141998;35;0;0;0;0;.00nan;0;0
2749;3928;12;60;26;3;23;.885;3524000;0
2749;190465;33;0;0;0;0;.00nan;0;0
2749;86192;33;94;32;1;31;.969;3600000;0
2749;91178;12;0;0;0;0;.00nan;0;0
2750;167642;18;0;0;0;0;.00nan;0;0
2750;173727;18;64;32;4;28;.875;3555000;0
2750;77955;28;0;0;0;0;.00nan;0;0
2750;85437;28;63;28;3;25;.893;3600000;0
2751;163195;0;64;31;3;28;.903;3599000;0
2751;183844;29;0;0;0;0;.00nan;0;0
2751;37818;29;83;37;2;35;.946;3600000;0
2751;139409;0;0;0;0;0;.00nan;0;0
2752;2059;23;0;0;0;0;.00nan;0;0
2752;184770;22;0;0;0;0;.00nan;0;0
2752;78573;23;84;33;2;31;.939;3587000;0
2752;143473;22;100;22;0;22;1.000;3600000;0
2753;178413;17;0;0;0;0;.00nan;0;0
2753;168712;14;88;33;2;31;.939;3600000;0
2753;175912;14;0;0;0;0;.00nan;0;0
2753;146862;17;34;36;8;28;.778;3600000;0
2754;779;5;0;0;0;0;.00nan;0;0
2754;166751;5;70;32;4;28;.875;3552000;0
2754;169868;4182;0;0;0;0;.00nan;0;0
2754;147945;4182;69;27;2;25;.926;3600000;0
2755;171838;31;79;35;3;32;.914;3600000;0
2755;13714;8;21;30;7;23;.767;3600000;0
2755;18213;8;0;0;0;0;.00nan;0;0
2755;170977;31;0;0;0;0;.00nan;0;0
2756;163695;9;55;32;4;28;.875;3600000;0
2756;175092;9;0;0;0;0;.00nan;0;0
2756;90164;10;0;0;0;0;.00nan;0;0
2756;152717;10;99;41;1;40;.976;3600000;0
2757;67;11;0;0;0;0;.00nan;0;0
2757;13337;32;0;0;0;0;.00nan;0;0
2757;20432;32;94;30;1;29;.967;3600000;0
2757;46468;11;58;29;4;25;.862;3600000;0
2758;676;34;0;0;0;0;.00nan;0;0
2758;174718;25;67;31;3;28;.903;3600000;0
2758;78806;34;60;35;4;31;.886;3600000;0
2758;148958;25;0;0;0;0;.00nan;0;0
2759;187537;19;0;0;0;0;.00nan;0;0
2759;163565;19;65;44;6;38;.864;3600000;0
2759;166381;27;41;16;3;13;.813;3600000;0
2759;175660;27;0;0;0;0;.00nan;0;0
2760;166646;16;0;0;0;0;.00nan;0;0
2760;163423;26;0;0;0;0;.00nan;0;0
2760;179154;26;87;52;3;49;.942;3790000;0
2760;50065;16;36;20;4;16;.800;3799000;0
2761;556;3;67;46;5;41;.891;3600000;0
2761;179344;3;0;0;0;0;.00nan;0;0
2761;179950;4838;0;0;0;0;.00nan;0;0
2761;143749;4838;100;24;0;24;1.000;3600000;0
2762;166591;20;0;0;0;0;.00nan;0;0
2762;3928;12;96;18;0;18;1.000;3600000;0
2762;86697;20;72;33;3;30;.909;3600000;0
2762;91178;12;0;0;0;0;.00nan;0;0
2763;67;11;88;40;3;37;.925;3600000;0
2763;163423;26;0;0;0;0;.00nan;0;0
2763;179154;26;75;29;2;27;.931;3600000;0
2763;46468;11;0;0;0;0;.00nan;0;0
2764;779;5;0;0;0;0;.00nan;0;0
2764;166751;5;67;37;4;33;.892;3600000;0
2764;174718;25;93;30;1;29;.967;3600000;0
2764;148958;25;0;0;0;0;.00nan;0;0
2765;556;3;63;24;3;21;.875;3552000;0
2765;166381;27;93;35;2;33;.943;3600000;0
2765;179344;3;0;0;0;0;.00nan;0;0
2765;175660;27;0;0;0;0;.00nan;0;0
2766;2059;23;0;0;0;0;.00nan;0;0
2766;77955;28;0;0;0;0;.00nan;0;0
2766;78573;23;68;22;2;20;.909;3596000;0
2766;85437;28;93;22;0;22;1.000;3600000;0
2767;163195;0;0;0;0;0;.00nan;0;0
2767;190465;33;0;0;0;0;.00nan;0;0
2767;86192;33;73;39;3;36;.923;3548000;0
2767;139409;0;79;32;2;30;.938;3600000;0
2768;166646;16;0;0;0;0;.00nan;0;0
2768;13337;32;39;1;1;0;.000;255000;0
2768;20432;32;79;42;3;39;.929;3345000;0
2768;50065;16;59;16;2;14;.875;3600000;0
2769;171838;31;99;41;1;40;.976;3600000;0
2769;183844;29;0;0;0;0;.00nan;0;0
2769;170977;31;0;0;0;0;.00nan;0;0
2769;37818;29;79;54;5;49;.907;3600000;0
2770;3284;21;66;39;5;34;.872;3600000;0
2770;178413;17;0;0;0;0;.00nan;0;0
2770;143156;21;0;0;0;0;.00nan;0;0
2770;146862;17;100;37;1;36;.973;3600000;0
2771;163695;9;0;0;0;0;.00nan;0;0
2771;169868;4182;0;0;0;0;.00nan;0;0
2771;175092;9;70;36;4;32;.889;3563000;0
2771;147945;4182;80;29;2;27;.931;3600000;0
2772;184770;22;0;0;0;0;.00nan;0;0
2772;90164;10;0;0;0;0;.00nan;0;0
2772;143473;22;63;19;1;18;.947;3600000;0
2772;152717;10;73;36;3;33;.917;3538000;0
2773;179950;4838;0;0;0;0;.00nan;0;0
2773;57338;35;71;42;3;39;.929;4200000;0
2773;141998;35;0;0;0;0;.00nan;0;0
2773;143749;4838;77;35;3;32;.914;4175000;0
2774;187537;19;80;33;2;31;.939;3600000;0
2774;163565;19;0;0;0;0;.00nan;0;0
2774;59540;15;36;23;5;18;.783;3600000;0
2774;71565;15;0;0;0;0;.00nan;0;0
2775;15;30;88;33;2;31;.939;3600000;0
2775;166591;20;0;0;0;0;.00nan;0;0
2775;17043;30;0;0;0;0;.00nan;0;0
2775;86697;20;72;40;4;36;.900;3567000;0
2776;165582;24;0;0;0;0;.00nan;0;0
2776;168712;14;70;42;5;37;.881;3573000;0
2776;175912;14;0;0;0;0;.00nan;0;0
2776;85727;24;68;27;3;24;.889;3600000;0
2777;3928;12;44;40;6;34;.850;3600000;0
2777;13714;8;0;0;0;0;.00nan;0;0
2777;18213;8;87;33;1;32;.970;3600000;0
2777;91178;12;0;0;0;0;.00nan;0;0
2778;676;34;60;22;3;19;.864;3600000;0
2778;2059;23;51;34;5;29;.853;3566000;0
2778;78573;23;0;0;0;0;.00nan;0;0
2778;78806;34;0;0;0;0;.00nan;0;0
2779;163195;0;0;0;0;0;.00nan;0;0
2779;169868;4182;0;0;0;0;.00nan;0;0
2779;139409;0;67;15;1;14;.933;3600000;0
2779;147945;4182;92;47;3;44;.936;3579000;0
2780;163423;26;0;0;0;0;.00nan;0;0
2780;179154;26;65;29;3;26;.897;3544000;0
2780;77955;28;0;0;0;0;.00nan;0;0
2780;85437;28;81;31;2;29;.935;3600000;0
2781;163695;9;0;0;0;0;.00nan;0;0
2781;13337;32;74;29;2;27;.931;3878000;0
2781;20432;32;0;0;0;0;.00nan;0;0
2781;175092;9;50;23;3;20;.870;3878000;0
2782;179950;4838;0;0;0;0;.00nan;0;0
2782;190465;33;0;0;0;0;.00nan;0;0
2782;86192;33;100;30;0;30;1.000;3600000;0
2782;143749;4838;61;38;4;34;.895;3600000;0
2783;556;3;55;35;4;31;.886;3600000;0
2783;167642;18;0;0;0;0;.00nan;0;0
2783;173727;18;60;28;3;25;.893;3600000;0
2783;179344;3;0;0;0;0;.00nan;0;0
2784;67;11;0;0;0;0;.00nan;0;0
2784;3928;12;0;0;0;0;.00nan;0;0
2784;46468;11;67;34;3;31;.912;3574000;0
2784;91178;12;77;35;2;33;.943;3600000;0
2785;166381;27;50;24;3;21;.875;3883000;0
2785;175660;27;0;0;0;0;.00nan;0;0
2785;57338;35;97;40;2;38;.950;3883000;0
2785;141998;35;0;0;0;0;.00nan;0;0
2786;15;30;0;0;0;0;.00nan;0;0
2786;187537;19;0;0;0;0;.00nan;0;0
2786;163565;19;84;28;1;27;.964;3600000;0
2786;17043;30;75;26;2;24;.923;3561000;0
2787;166591;20;85;38;3;35;.921;3517000;0
2787;174718;25;75;21;1;20;.952;3600000;0
2787;86697;20;0;0;0;0;.00nan;0;0
2787;148958;25;0;0;0;0;.00nan;0;0
2788;779;5;0;0;0;0;.00nan;0;0
2788;171838;31;65;27;2;25;.926;3600000;0
2788;166751;5;63;38;4;34;.895;3600000;0
2788;170977;31;0;0;0;0;.00nan;0;0
2789;779;5;86;43;2;41;.953;3600000;0
2789;166751;5;0;0;0;0;.00nan;0;0
2789;183844;29;0;0;0;0;.00nan;0;0
2789;37818;29;38;14;3;11;.786;3573000;0
2790;163423;26;67;37;3;34;.919;3563000;0
2790;168712;14;75;24;2;22;.917;3600000;0
2790;179154;26;0;0;0;0;.00nan;0;0
2790;175912;14;0;0;0;0;.00nan;0;0
2791;676;34;67;40;3;37;.925;3600000;0
2791;165582;24;0;0;0;0;.00nan;0;0
2791;78806;34;0;0;0;0;.00nan;0;0
2791;85727;24;38;27;5;22;.815;3555000;0
2792;3284;21;84;51;4;47;.922;3731000;0
2792;184770;22;0;0;0;0;.00nan;0;0
2792;143156;21;0;0;0;0;.00nan;0;0
2792;143473;22;67;25;3;22;.880;3731000;0
2793;190465;33;0;0;0;0;.00nan;0;0
2793;57338;35;0;0;0;0;.00nan;0;0
2793;86192;33;100;23;0;23;1.000;3600000;0
2793;141998;35;95;39;1;38;.974;3600000;0
2794;13714;8;59;30;3;27;.900;3600000;0
2794;18213;8;0;0;0;0;.00nan;0;0
2794;179950;4838;0;0;0;0;.00nan;0;0
2794;143749;4838;67;20;2;18;.900;3600000;0
2795;15;30;0;0;0;0;.00nan;0;0
2795;166646;16;0;0;0;0;.00nan;0;0
2795;17043;30;87;42;2;40;.952;3600000;0
2795;50065;16;56;26;3;23;.885;3566000;0
2796;2059;23;0;0;0;0;.00nan;0;0
2796;59540;15;56;14;2;12;.857;3600000;0
2796;71565;15;0;0;0;0;.00nan;0;0
2796;78573;23;59;38;5;33;.868;3600000;0
2797;163195;0;0;0;0;0;.00nan;0;0
2797;178413;17;0;0;0;0;.00nan;0;0
2797;139409;0;86;40;3;37;.925;4200000;0
2797;146862;17;90;46;3;43;.935;4200000;0
2798;174718;25;80;38;3;35;.921;3600000;0
2798;90164;10;0;0;0;0;.00nan;0;0
2798;148958;25;0;0;0;0;.00nan;0;0
2798;152717;10;100;30;0;30;1.000;3600000;0
2799;169868;4182;0;0;0;0;.00nan;0;0
2799;59540;15;92;28;1;27;.964;3600000;0
2799;71565;15;0;0;0;0;.00nan;0;0
2799;147945;4182;60;24;3;21;.875;3544000;0
2800;3928;12;42;30;5;25;.833;3583000;0
2800;163695;9;0;0;0;0;.00nan;0;0
2800;175092;9;70;42;4;38;.905;3600000;0
2800;91178;12;0;0;0;0;.00nan;0;0
2801;67;11;66;45;5;40;.889;3581000;0
2801;46468;11;0;0;0;0;.00nan;0;0
2801;77955;28;63;24;3;21;.875;3600000;0
2801;85437;28;0;0;0;0;.00nan;0;0
2802;166591;20;0;0;0;0;.00nan;0;0
2802;183844;29;46;6;1;5;.833;632000;0
2802;37818;29;22;22;6;16;.727;2968000;0
2802;86697;20;66;32;3;29;.906;3600000;0
2803;556;3;51;40;5;35;.875;3566000;0
2803;13714;8;43;17;3;14;.824;3600000;0
2803;18213;8;0;0;0;0;.00nan;0;0
2803;179344;3;0;0;0;0;.00nan;0;0
2804;168712;14;68;32;3;29;.906;3533000;0
2804;184770;22;0;0;0;0;.00nan;0;0
2804;175912;14;0;0;0;0;.00nan;0;0
2804;143473;22;84;26;1;25;.962;3600000;0
2805;779;5;0;0;0;0;.00nan;0;0
2805;166751;5;41;43;7;36;.837;3600000;0
2805;163423;26;0;0;0;0;.00nan;0;0
2805;179154;26;30;16;4;12;.750;3600000;0
2806;676;34;0;0;0;0;.00nan;0;0
2806;178413;17;0;0;0;0;.00nan;0;0
2806;78806;34;91;17;0;17;1.000;3600000;0
2806;146862;17;94;38;1;37;.974;3570000;0
2807;171838;31;0;0;0;0;.00nan;0;0
2807;3284;21;91;27;1;26;.963;3600000;0
2807;170977;31;44;22;4;18;.818;3600000;0
2807;143156;21;0;0;0;0;.00nan;0;0
2808;13337;32;0;0;0;0;.00nan;0;0
2808;165582;24;0;0;0;0;.00nan;0;0
2808;20432;32;56;42;5;37;.881;3543000;0
2808;85727;24;30;17;4;13;.765;3600000;0
2809;166381;27;46;27;5;22;.815;3516000;0
2809;175660;27;0;0;0;0;.00nan;0;0
2809;77955;28;91;45;3;42;.933;3600000;0
2809;85437;28;0;0;0;0;.00nan;0;0
2810;167642;18;0;0;0;0;.00nan;0;0
2810;173727;18;70;46;5;41;.891;3583000;0
2810;179950;4838;0;0;0;0;.00nan;0;0
2810;143749;4838;65;28;3;25;.893;3600000;0
2811;15;30;0;0;0;0;.00nan;0;0
2811;163695;9;51;44;6;38;.864;3600000;0
2811;17043;30;68;16;1;15;.938;3600000;0
2811;175092;9;0;0;0;0;.00nan;0;0
2812;166646;16;0;0;0;0;.00nan;0;0
2812;2059;23;80;39;3;36;.923;3588000;0
2812;50065;16;80;24;1;23;.958;3600000;0
2812;78573;23;0;0;0;0;.00nan;0;0
2813;163195;0;0;0;0;0;.00nan;0;0
2813;59540;15;0;0;0;0;.00nan;0;0
2813;71565;15;69;27;2;25;.926;3600000;0
2813;139409;0;64;41;5;36;.878;3600000;0
2814;174718;25;91;35;2;33;.943;3600000;0
2814;57338;35;46;31;5;26;.839;3600000;0
2814;141998;35;0;0;0;0;.00nan;0;0
2814;148958;25;0;0;0;0;.00nan;0;0
2815;67;11;0;0;0;0;.00nan;0;0
2815;190465;33;0;0;0;0;.00nan;0;0
2815;46468;11;54;27;3;24;.889;3540000;0
2815;86192;33;76;24;1;23;.958;3600000;0
2816;178413;17;0;0;0;0;.00nan;0;0
2816;184770;22;0;0;0;0;.00nan;0;0
2816;143473;22;81;8;0;8;1.000;3600000;0
2816;146862;17;72;52;5;47;.904;3600000;0
2817;171838;31;6;28;8;20;.714;2101000;0
2817;165582;24;0;0;0;0;.00nan;0;0
2817;170977;31;63;22;2;20;.909;1499000;0
2817;85727;24;65;37;4;33;.892;3600000;0
2818;168712;14;82;25;1;24;.960;3600000;0
2818;175912;14;0;0;0;0;.00nan;0;0
2818;90164;10;32;31;6;25;.806;2525000;0
2818;152717;10;68;14;0;14;1.000;1075000;0
2819;3284;21;73;21;1;20;.952;3836000;0
2819;183844;29;94;36;2;34;.944;3836000;0
2819;37818;29;0;0;0;0;.00nan;0;0
2819;143156;21;0;0;0;0;.00nan;0;0
2820;166591;20;0;0;0;0;.00nan;0;0
2820;163423;26;0;0;0;0;.00nan;0;0
2820;179154;26;65;22;2;20;.909;3600000;0
2820;86697;20;81;42;3;39;.929;3600000;0
2821;163695;9;0;0;0;0;.00nan;0;0
2821;13714;8;97;24;0;24;1.000;3600000;0
2821;18213;8;0;0;0;0;.00nan;0;0
2821;175092;9;94;60;4;56;.933;3600000;0
2822;556;3;49;37;5;32;.865;3551000;0
2822;13337;32;0;0;0;0;.00nan;0;0
2822;20432;32;65;33;4;29;.879;3600000;0
2822;179344;3;0;0;0;0;.00nan;0;0
2823;15;30;0;0;0;0;.00nan;0;0
2823;779;5;75;17;0;17;1.000;1151000;0
2823;166751;5;39;34;6;28;.824;2440000;0
2823;17043;30;69;32;4;28;.875;3600000;0
2824;179950;4838;0;0;0;0;.00nan;0;0
2824;77955;28;67;41;4;37;.902;3697000;0
2824;85437;28;0;0;0;0;.00nan;0;0
2824;143749;4838;75;31;3;28;.903;3705000;0
2825;67;11;63;55;6;49;.891;3078000;0
2825;166381;27;62;16;1;15;.938;3600000;0
2825;175660;27;0;0;0;0;.00nan;0;0
2825;46468;11;55;8;0;8;1.000;522000;0
2826;167642;18;0;0;0;0;.00nan;0;0
2826;173727;18;48;31;5;26;.839;3600000;0
2826;190465;33;71;35;4;31;.886;3598000;0
2826;86192;33;0;0;0;0;.00nan;0;0
2827;187537;19;85;51;4;47;.922;3687000;0
2827;166646;16;0;0;0;0;.00nan;0;0
2827;163565;19;0;0;0;0;.00nan;0;0
2827;50065;16;54;19;3;16;.842;3687000;0
2828;2059;23;89;49;2;47;.959;3545000;0
2828;169868;4182;0;0;0;0;.00nan;0;0
2828;78573;23;0;0;0;0;.00nan;0;0
2828;147945;4182;100;30;0;30;1.000;3600000;0
2829;171838;31;91;41;1;40;.976;3600000;0
2829;170977;31;0;0;0;0;.00nan;0;0
2829;184770;22;42;11;2;9;.818;3557000;0
2829;143473;22;0;0;0;0;.00nan;0;0
2830;676;34;0;0;0;0;.00nan;0;0
2830;78806;34;70;24;1;23;.958;3744000;0
2830;90164;10;0;0;0;0;.00nan;0;0
2830;152717;10;92;36;2;34;.944;3744000;0
2831;166591;20;0;0;0;0;.00nan;0;0
2831;163195;0;75;23;1;22;.957;3600000;0
2831;86697;20;80;28;2;26;.929;3550000;0
2831;139409;0;0;0;0;0;.00nan;0;0
2832;168712;14;0;0;0;0;.00nan;0;0
2832;175912;14;46;33;5;28;.848;3584000;0
2832;59540;15;64;31;4;27;.871;3600000;0
2832;71565;15;0;0;0;0;.00nan;0;0
2833;556;3;65;34;4;30;.882;3680000;0
2833;179344;3;0;0;0;0;.00nan;0;0
2833;174718;25;54;31;5;26;.839;3662000;0
2833;148958;25;0;0;0;0;.00nan;0;0
2834;3928;12;79;39;3;36;.923;3600000;0
2834;57338;35;30;24;6;18;.750;3351000;0
2834;91178;12;0;0;0;0;.00nan;0;0
2834;141998;35;50;1;0;1;1.000;249000;0
2835;166646;16;56;30;4;26;.867;3682000;0
2835;169868;4182;0;0;0;0;.00nan;0;0
2835;50065;16;0;0;0;0;.00nan;0;0
2835;147945;4182;81;32;3;29;.906;3682000;0
2836;779;5;0;0;0;0;.00nan;0;0
2836;166751;5;88;45;2;43;.956;3815000;0
2836;3284;21;65;27;3;24;.889;3772000;0
2836;143156;21;0;0;0;0;.00nan;0;0
2837;163423;26;0;0;0;0;.00nan;0;0
2837;165582;24;0;0;0;0;.00nan;0;0
2837;179154;26;63;35;4;31;.886;3513000;0
2837;85727;24;82;33;2;31;.939;3600000;0
2838;67;11;49;7;1;6;.857;819000;0
2838;2059;23;73;32;2;30;.938;3600000;0
2838;46468;11;17;22;6;16;.727;2781000;0
2838;78573;23;0;0;0;0;.00nan;0;0
2839;167642;18;0;0;0;0;.00nan;0;0
2839;173727;18;61;31;3;28;.903;3600000;0
2839;77955;28;0;0;0;0;.00nan;0;0
2839;85437;28;77;39;4;35;.897;3572000;0
2840;556;3;56;34;4;30;.882;3541000;0
2840;3284;21;0;0;0;0;.00nan;0;0
2840;179344;3;0;0;0;0;.00nan;0;0
2840;143156;21;66;27;3;24;.889;3600000;0
2841;163195;0;0;0;0;0;.00nan;0;0
2841;183844;29;0;0;0;0;.00nan;0;0
2841;37818;29;90;61;4;57;.934;3581000;0
2841;139409;0;61;21;2;19;.905;3600000;0
2842;3928;12;66;24;2;22;.917;3600000;0
2842;178413;17;0;0;0;0;.00nan;0;0
2842;91178;12;0;0;0;0;.00nan;0;0
2842;146862;17;78;37;3;34;.919;3547000;0
2843;171838;31;67;39;4;35;.897;3583000;0
2843;170977;31;0;0;0;0;.00nan;0;0
2843;90164;10;0;0;0;0;.00nan;0;0
2843;152717;10;64;24;2;22;.917;3600000;0
2844;15;30;0;0;0;0;.00nan;0;0
2844;163695;9;90;35;2;33;.943;3600000;0
2844;17043;30;52;26;3;23;.885;3583000;0
2844;175092;9;0;0;0;0;.00nan;0;0
2845;166591;20;0;0;0;0;.00nan;0;0
2845;190465;33;0;0;0;0;.00nan;0;0
2845;86192;33;73;27;2;25;.926;3600000;0
2845;86697;20;53;34;4;30;.882;3589000;0
2846;779;5;91;32;1;31;.969;3600000;0
2846;166646;16;0;0;0;0;.00nan;0;0
2846;166751;5;0;0;0;0;.00nan;0;0
2846;50065;16;59;20;2;18;.900;3564000;0
2847;13337;32;0;0;0;0;.00nan;0;0
2847;20432;32;73;30;3;27;.900;3600000;0
2847;57338;35;67;36;5;31;.861;3529000;0
2847;141998;35;0;0;0;0;.00nan;0;0
2848;2059;23;0;0;0;0;.00nan;0;0
2848;166381;27;49;5;1;4;.800;3600000;0
2848;175660;27;0;0;0;0;.00nan;0;0
2848;78573;23;90;53;4;49;.925;3600000;0
2849;163423;26;45;32;5;27;.844;3550000;0
2849;13714;8;80;30;3;27;.900;3600000;0
2849;18213;8;0;0;0;0;.00nan;0;0
2849;179154;26;0;0;0;0;.00nan;0;0
2850;676;34;50;27;4;23;.852;3547000;0
2850;179950;4838;0;0;0;0;.00nan;0;0
2850;78806;34;0;0;0;0;.00nan;0;0
2850;143749;4838;58;22;3;19;.864;3600000;0
2851;187537;19;93;41;3;38;.927;3785000;0
2851;163565;19;0;0;0;0;.00nan;0;0
2851;184770;22;0;0;0;0;.00nan;0;0
2851;143473;22;62;30;4;26;.867;3785000;0
2852;168712;14;100;46;2;44;.957;3625000;0
2852;175912;14;0;0;0;0;.00nan;0;0
2852;59540;15;69;25;3;22;.880;3625000;0
2852;71565;15;0;0;0;0;.00nan;0;0
2853;67;11;59;35;4;31;.886;3600000;0
2853;13337;32;37;6;2;4;.667;538000;0
2853;20432;32;34;37;6;31;.838;3062000;0
2853;46468;11;0;0;0;0;.00nan;0;0
2854;15;30;0;0;0;0;.00nan;0;0
2854;17043;30;68;31;3;28;.903;4053000;0
2854;77955;28;55;31;4;27;.871;4053000;0
2854;85437;28;0;0;0;0;.00nan;0;0
2855;166591;20;0;0;0;0;.00nan;0;0
2855;59540;15;0;0;0;0;.00nan;0;0
2855;71565;15;94;36;2;34;.944;3600000;0
2855;86697;20;38;21;4;17;.810;3564000;0
2856;556;3;90;49;4;45;.918;3600000;0
2856;165582;24;0;0;0;0;.00nan;0;0
2856;179344;3;0;0;0;0;.00nan;0;0
2856;85727;24;50;35;5;30;.857;3581000;0
2857;183844;29;75;31;2;29;.935;3600000;0
2857;178413;17;0;0;0;0;.00nan;0;0
2857;37818;29;0;0;0;0;.00nan;0;0
2857;146862;17;64;31;3;28;.903;3572000;0
2858;171838;31;0;0;0;0;.00nan;0;0
2858;163195;0;0;0;0;0;.00nan;0;0
2858;170977;31;96;44;2;42;.955;3600000;0
2858;139409;0;65;26;3;23;.885;3544000;0
2859;3928;12;72;27;3;24;.889;3600000;0
2859;163695;9;79;32;2;30;.938;2790000;0
2859;175092;9;19;10;4;6;.600;810000;0
2859;91178;12;0;0;0;0;.00nan;0;0
2860;163423;26;0;0;0;0;.00nan;0;0
2860;179154;26;64;39;4;35;.897;3600000;0
2860;57338;35;88;45;3;42;.933;3600000;0
2860;141998;35;0;0;0;0;.00nan;0;0
2861;166646;16;0;0;0;0;.00nan;0;0
2861;190465;33;0;0;0;0;.00nan;0;0
2861;50065;16;52;20;3;17;.850;3600000;0
2861;86192;33;86;31;1;30;.968;3600000;0
2862;13714;8;74;31;2;29;.935;3894000;0
2862;18213;8;0;0;0;0;.00nan;0;0
2862;174718;25;56;21;3;18;.857;3894000;0
2862;148958;25;0;0;0;0;.00nan;0;0
2863;676;34;0;0;0;0;.00nan;0;0
2863;167642;18;0;0;0;0;.00nan;0;0
2863;173727;18;80;33;2;31;.939;4104000;0
2863;78806;34;65;26;3;23;.885;4104000;0
2864;2059;23;80;27;1;26;.963;4200000;0
2864;179950;4838;0;0;0;0;.00nan;0;0
2864;78573;23;0;0;0;0;.00nan;0;0
2864;143749;4838;72;21;1;20;.952;4200000;0
2865;187537;19;79;40;3;37;.925;3568000;0
2865;163565;19;0;0;0;0;.00nan;0;0
2865;169868;4182;0;0;0;0;.00nan;0;0
2865;147945;4182;93;37;2;35;.946;3600000;0
2866;779;5;0;0;0;0;.00nan;0;0
2866;166751;5;85;28;1;27;.964;3600000;0
2866;3928;12;0;0;0;0;.00nan;0;0
2866;91178;12;55;23;3;20;.870;3573000;0
2867;3284;21;52;24;3;21;.875;3600000;0
2867;90164;10;0;0;0;0;.00nan;0;0
2867;143156;21;0;0;0;0;.00nan;0;0
2867;152717;10;72;44;4;40;.909;3560000;0
2868;169868;4182;70;35;3;32;.914;3513000;0
2868;184770;22;0;0;0;0;.00nan;0;0
2868;143473;22;78;24;1;23;.958;3600000;0
2868;147945;4182;0;0;0;0;.00nan;0;0
2869;166591;20;100;40;1;39;.975;3600000;0
2869;57338;35;51;25;3;22;.880;3600000;0
2869;86697;20;0;0;0;0;.00nan;0;0
2869;141998;35;0;0;0;0;.00nan;0;0
2870;165582;24;0;0;0;0;.00nan;0;0
2870;77955;28;0;0;0;0;.00nan;0;0
2870;85437;28;77;50;4;46;.920;3600000;0
2870;85727;24;61;21;2;19;.905;3600000;0
2871;67;11;0;0;0;0;.00nan;0;0
2871;167642;18;47;28;4;24;.857;3694000;0
2871;173727;18;0;0;0;0;.00nan;0;0
2871;46468;11;63;37;5;32;.865;3694000;0
2872;166646;16;0;0;0;0;.00nan;0;0
2872;13714;8;54;24;3;21;.875;3600000;0
2872;18213;8;0;0;0;0;.00nan;0;0
2872;50065;16;100;31;0;31;1.000;3600000;0
2873;15;30;0;0;0;0;.00nan;0;0
2873;163195;0;100;36;0;36;1.000;3600000;0
2873;17043;30;45;22;4;18;.818;3600000;0
2873;139409;0;0;0;0;0;.00nan;0;0
2874;556;3;36;26;5;21;.808;3600000;0
2874;183844;29;47;21;4;17;.810;1189000;0
2874;179344;3;0;0;0;0;.00nan;0;0
2874;37818;29;44;17;3;14;.824;2356000;0
2875;779;5;27;26;6;20;.769;2226000;0
2875;166751;5;68;13;0;13;1.000;1374000;0
2875;90164;10;73;29;3;26;.897;3600000;0
2875;152717;10;0;0;0;0;.00nan;0;0
2876;171838;31;0;0;0;0;.00nan;0;0
2876;178413;17;0;0;0;0;.00nan;0;0
2876;170977;31;44;27;4;23;.852;3600000;0
2876;146862;17;49;34;5;29;.853;3600000;0
2877;163695;9;0;0;0;0;.00nan;0;0
2877;168712;14;67;20;2;18;.900;3600000;0
2877;175092;9;57;35;4;31;.886;3579000;0
2877;175912;14;0;0;0;0;.00nan;0;0
2878;174718;25;66;28;2;26;.929;3555000;0
2878;59540;15;91;27;1;26;.963;3600000;0
2878;71565;15;0;0;0;0;.00nan;0;0
2878;148958;25;0;0;0;0;.00nan;0;0
2879;187537;19;90;40;2;38;.950;3600000;0
2879;163423;26;0;0;0;0;.00nan;0;0
2879;163565;19;0;0;0;0;.00nan;0;0
2879;179154;26;49;35;5;30;.857;3600000;0
2880;13337;32;0;0;0;0;.00nan;0;0
2880;20432;32;70;32;3;29;.906;3600000;0
2880;190465;33;0;0;0;0;.00nan;0;0
2880;86192;33;69;37;4;33;.892;3558000;0
2881;676;34;90;44;3;41;.932;3600000;0
2881;166381;27;90;15;0;15;1.000;3600000;0
2881;175660;27;0;0;0;0;.00nan;0;0
2881;78806;34;0;0;0;0;.00nan;0;0
2882;3284;21;86;30;2;28;.933;3780000;0
2882;3928;12;86;42;3;39;.929;3780000;0
2882;91178;12;0;0;0;0;.00nan;0;0
2882;143156;21;0;0;0;0;.00nan;0;0
2883;2059;23;79;38;3;35;.921;3600000;0
2883;184770;22;0;0;0;0;.00nan;0;0
2883;78573;23;0;0;0;0;.00nan;0;0
2883;143473;22;86;15;0;15;1.000;3600000;0
2884;163195;0;41;27;5;22;.815;4138000;0
2884;57338;35;88;39;3;36;.923;3708000;0
2884;139409;0;0;0;0;0;.00nan;0;0
2884;141998;35;34;13;3;10;.769;430000;0
2885;187537;19;0;0;0;0;.00nan;0;0
2885;163565;19;45;23;4;19;.826;3600000;0
2885;190465;33;45;35;6;29;.829;3520000;0
2885;86192;33;0;0;0;0;.00nan;0;0
2886;169868;4182;56;5;0;5;1.000;596000;0
2886;179950;4838;0;0;0;0;.00nan;0;0
2886;143749;4838;78;25;1;24;.960;3600000;0
2886;147945;4182;12;21;6;15;.714;3004000;0
2887;67;11;0;0;0;0;.00nan;0;0
2887;676;34;65;23;2;21;.913;3600000;0
2887;46468;11;90;39;3;36;.923;3541000;0
2887;78806;34;0;0;0;0;.00nan;0;0
2888;15;30;0;0;0;0;.00nan;0;0
2888;17043;30;53;43;6;37;.860;3600000;0
2888;59540;15;0;0;0;0;.00nan;0;0
2888;86697;15;46;18;3;15;.833;3600000;0
2889;183844;29;81;29;1;28;.966;3600000;0
2889;168712;14;44;25;4;21;.840;3600000;0
2889;175912;14;0;0;0;0;.00nan;0;0
2889;37818;29;0;0;0;0;.00nan;0;0
2890;187578;10;65;33;3;30;.909;3600000;0
2890;13337;32;0;0;0;0;.00nan;0;0
2890;20432;32;69;27;2;25;.926;3600000;0
2890;90164;10;0;0;0;0;.00nan;0;0
2891;163695;9;40;26;4;22;.846;3536000;0
2891;175092;9;0;0;0;0;.00nan;0;0
2891;77955;28;83;34;2;32;.941;3600000;0
2891;85437;28;0;0;0;0;.00nan;0;0
2892;13714;8;86;31;2;29;.935;4200000;0
2892;18213;8;0;0;0;0;.00nan;0;0
2892;174718;25;75;35;2;33;.943;4200000;0
2892;148958;25;0;0;0;0;.00nan;0;0
2893;167642;18;0;0;0;0;.00nan;0;0
2893;166381;27;73;24;2;22;.917;3600000;0
2893;173727;18;41;50;8;42;.840;3600000;0
2893;175660;27;0;0;0;0;.00nan;0;0
2894;67;11;57;28;4;24;.857;3600000;0
2894;46468;11;0;0;0;0;.00nan;0;0
2894;77955;28;89;24;0;24;1.000;2767000;0
2894;85437;28;7;8;5;3;.375;812000;0
2895;183844;29;0;0;0;0;.00nan;0;0
2895;184770;22;76;32;1;31;.969;4200000;0
2895;37818;29;99;51;1;50;.980;4200000;0
2895;143473;22;0;0;0;0;.00nan;0;0
2896;676;34;0;0;0;0;.00nan;0;0
2896;59540;15;0;0;0;0;.00nan;0;0
2896;78806;34;66;22;1;21;.955;3600000;0
2896;86697;15;47;25;4;21;.840;3600000;0
2897;13337;32;81;42;4;38;.905;3578000;0
2897;165582;24;0;0;0;0;.00nan;0;0
2897;20432;32;0;0;0;0;.00nan;0;0
2897;85727;24;69;31;3;28;.903;3600000;0
2898;166646;16;0;0;0;0;.00nan;0;0
2898;178413;17;0;0;0;0;.00nan;0;0
2898;50065;16;66;21;2;19;.905;3600000;0
2898;146862;17;65;47;5;42;.894;3600000;0
2899;167642;18;76;34;3;31;.912;4082000;0
2899;173727;18;0;0;0;0;.00nan;0;0
2899;57338;35;70;31;2;29;.935;4082000;0
2899;141998;35;0;0;0;0;.00nan;0;0
2900;3928;12;60;18;2;16;.889;3600000;0
2900;174718;25;79;35;3;32;.914;3572000;0
2900;91178;12;0;0;0;0;.00nan;0;0
2900;148958;25;0;0;0;0;.00nan;0;0
2901;2059;23;75;32;2;30;.938;3600000;0
2901;179950;4838;0;0;0;0;.00nan;0;0
2901;78573;23;0;0;0;0;.00nan;0;0
2901;143749;4838;79;32;3;29;.906;3545000;0
2902;187537;19;83;33;2;31;.939;3536000;0
2902;163423;26;0;0;0;0;.00nan;0;0
2902;163565;19;0;0;0;0;.00nan;0;0
2902;179154;26;91;22;0;22;1.000;3600000;0
2903;163195;0;0;0;0;0;.00nan;0;0
2903;163695;9;54;38;5;33;.868;3600000;0
2903;175092;9;0;0;0;0;.00nan;0;0
2903;139409;0;54;22;3;19;.864;3600000;0
2904;556;3;48;28;4;24;.857;4200000;0
2904;13714;8;0;0;0;0;.00nan;0;0
2904;18213;8;78;37;4;33;.892;4200000;0
2904;179344;3;0;0;0;0;.00nan;0;0
2905;779;5;0;0;0;0;.00nan;0;0
2905;166751;5;78;45;4;41;.911;3600000;0
2905;169868;4182;0;0;0;0;.00nan;0;0
2905;147945;4182;85;22;1;21;.955;3600000;0
2906;163695;9;0;0;0;0;.00nan;0;0
2906;175092;9;62;36;4;32;.889;4053000;0
2906;77955;28;75;34;3;31;.912;4053000;0
2906;85437;28;0;0;0;0;.00nan;0;0
2907;166591;20;43;11;2;9;.818;832000;0
2907;178413;17;0;0;0;0;.00nan;0;0
2907;71565;20;39;29;5;24;.828;2768000;0
2907;146862;17;72;26;2;24;.923;3600000;0
2908;67;11;0;0;0;0;.00nan;0;0
2908;46468;11;24;34;7;27;.794;3600000;0
2908;59540;15;0;0;0;0;.00nan;0;0
2908;86697;15;85;23;1;22;.957;3600000;0
2909;187578;10;0;0;0;0;.00nan;0;0
2909;183844;29;100;42;1;41;.976;3600000;0
2909;37818;29;0;0;0;0;.00nan;0;0
2909;90164;10;63;28;3;25;.893;3558000;0
2910;13337;32;0;0;0;0;.00nan;0;0
2910;20432;32;83;41;3;38;.927;3555000;0
2910;184770;22;0;0;0;0;.00nan;0;0
2910;143473;22;58;13;1;12;.923;3600000;0
2911;676;34;68;33;3;30;.909;3600000;0
2911;3284;21;44;37;6;31;.838;3188000;0
2911;78806;34;0;0;0;0;.00nan;0;0
2911;143156;21;44;4;1;3;.750;412000;0
2912;171838;31;0;0;0;0;.00nan;0;0
2912;166381;27;78;21;1;20;.952;3600000;0
2912;175660;27;0;0;0;0;.00nan;0;0
2912;152717;31;89;53;2;51;.962;3600000;0
2913;166646;16;0;0;0;0;.00nan;0;0
2913;163195;0;71;55;6;49;.891;3578000;0
2913;50065;16;50;22;4;18;.818;3600000;0
2913;139409;0;0;0;0;0;.00nan;0;0
2914;3928;12;50;19;3;16;.842;4200000;0
2914;190465;33;0;0;0;0;.00nan;0;0
2914;86192;33;100;61;3;58;.951;4200000;0
2914;91178;12;0;0;0;0;.00nan;0;0
2915;15;30;0;0;0;0;.00nan;0;0
2915;17043;30;83;34;1;33;.971;3600000;0
2915;179950;4838;49;1;0;1;1.000;254000;0
2915;143749;4838;25;23;6;17;.739;3346000;0
2916;779;5;60;15;1;14;.933;3600000;0
2916;166751;5;0;0;0;0;.00nan;0;0
2916;2059;23;74;35;3;32;.914;3543000;0
2916;78573;23;0;0;0;0;.00nan;0;0
2917;187537;19;85;38;2;36;.947;3600000;0
2917;163565;19;0;0;0;0;.00nan;0;0
2917;165582;24;0;0;0;0;.00nan;0;0
2917;85727;24;57;29;3;26;.897;3599000;0
2918;556;3;49;23;4;19;.826;3722000;0
2918;3928;12;0;0;0;0;.00nan;0;0
2918;179344;3;0;0;0;0;.00nan;0;0
2918;91178;12;68;29;3;26;.897;3722000;0
2919;13714;8;63;20;2;18;.900;3600000;0
2919;18213;8;0;0;0;0;.00nan;0;0
2919;190465;33;28;28;6;22;.786;2197000;0
2919;86192;33;54;4;0;4;1.000;1403000;0
2920;163423;26;0;0;0;0;.00nan;0;0
2920;169868;4182;0;0;0;0;.00nan;0;0
2920;179154;26;92;45;4;41;.911;4101000;0
2920;147945;4182;81;38;3;35;.921;4101000;0
2921;167642;18;0;0;0;0;.00nan;0;0
2921;173727;18;45;34;5;29;.853;3555000;0
2921;57338;35;62;29;3;26;.897;3600000;0
2921;141998;35;0;0;0;0;.00nan;0;0
2922;67;11;65;37;4;33;.892;3875000;0
2922;163195;0;0;0;0;0;.00nan;0;0
2922;46468;11;0;0;0;0;.00nan;0;0
2922;139409;0;57;27;3;24;.889;3875000;0
2923;166646;16;0;0;0;0;.00nan;0;0
2923;50065;16;80;21;1;20;.952;3630000;0
2923;59540;15;71;22;2;20;.909;3630000;0
2923;86697;15;0;0;0;0;.00nan;0;0
2924;166591;20;0;0;0;0;.00nan;0;0
2924;184770;22;0;0;0;0;.00nan;0;0
2924;71565;20;100;45;2;43;.956;3600000;0
2924;143473;22;56;24;3;21;.875;3600000;0
2925;676;34;0;0;0;0;.00nan;0;0
2925;77955;28;0;0;0;0;.00nan;0;0
2925;78806;34;55;15;2;13;.867;3600000;0
2925;85437;28;56;45;5;40;.889;3600000;0
2926;166381;27;89;30;1;29;.967;3600000;0
2926;183844;29;0;0;0;0;.00nan;0;0
2926;175660;27;0;0;0;0;.00nan;0;0
2926;37818;29;97;45;3;42;.933;3600000;0
2927;163695;9;0;0;0;0;.00nan;0;0
2927;178413;17;0;0;0;0;.00nan;0;0
2927;175092;9;71;37;3;34;.919;3574000;0
2927;146862;17;77;26;1;25;.962;3600000;0
2928;779;5;0;0;0;0;.00nan;0;0
2928;187537;19;54;21;2;19;.905;4200000;0
2928;166751;5;87;44;2;42;.955;4200000;0
2928;163565;19;0;0;0;0;.00nan;0;0
2929;171838;31;0;0;0;0;.00nan;0;0
2929;187578;10;0;0;0;0;.00nan;0;0
2929;90164;10;87;31;1;30;.968;3600000;0
2929;152717;31;77;35;3;32;.914;3559000;0
2930;3284;21;100;33;0;33;1.000;3600000;0
2930;174718;25;57;39;5;34;.872;3600000;0
2930;143156;21;0;0;0;0;.00nan;0;0
2930;148958;25;0;0;0;0;.00nan;0;0
2931;13337;32;0;0;0;0;.00nan;0;0
2931;168712;14;81;14;0;14;1.000;3600000;0
2931;20432;32;94;48;4;44;.917;3600000;0
2931;175912;14;0;0;0;0;.00nan;0;0
2932;179950;4838;0;0;0;0;.00nan;0;0
2932;57338;35;0;0;0;0;.00nan;0;0
2932;141998;35;84;32;2;30;.938;3600000;0
2932;143749;4838;60;35;3;32;.914;3583000;0
2933;15;30;0;0;0;0;.00nan;0;0
2933;556;3;63;33;3;30;.909;3598000;0
2933;17043;30;90;40;2;38;.950;3600000;0
2933;179344;3;0;0;0;0;.00nan;0;0
2934;2059;23;89;44;3;41;.932;3600000;0
2934;163423;26;43;28;5;23;.821;3546000;0
2934;179154;26;0;0;0;0;.00nan;0;0
2934;78573;23;0;0;0;0;.00nan;0;0
2935;67;11;0;0;0;0;.00nan;0;0
2935;676;34;64;25;2;23;.920;3600000;0
2935;46468;11;85;51;4;47;.922;3600000;0
2935;78806;34;0;0;0;0;.00nan;0;0
2936;166646;16;70;29;3;26;.897;3600000;0
2936;190465;33;0;0;0;0;.00nan;0;0
2936;50065;16;0;0;0;0;.00nan;0;0
2936;86192;33;59;31;4;27;.871;3572000;0
2937;166591;20;0;0;0;0;.00nan;0;0
2937;166381;27;0;0;0;0;.00nan;0;0
2937;175660;27;80;26;1;25;.962;3600000;0
2937;71565;20;42;49;9;40;.816;3600000;0
2938;3928;12;67;33;3;30;.909;3562000;0
2938;174718;25;64;23;2;21;.913;3600000;0
2938;91178;12;0;0;0;0;.00nan;0;0
2938;148958;25;0;0;0;0;.00nan;0;0
2939;165582;24;0;0;0;0;.00nan;0;0
2939;169868;4182;0;0;0;0;.00nan;0;0
2939;85727;24;47;35;5;30;.857;3541000;0
2939;147945;4182;72;35;3;32;.914;3600000;0
2940;13337;32;0;0;0;0;.00nan;0;0
2940;20432;32;89;25;1;24;.960;3600000;0
2940;77955;28;64;23;2;21;.913;3554000;0
2940;85437;28;0;0;0;0;.00nan;0;0
2941;168712;14;74;31;2;29;.935;3600000;0
2941;184770;22;0;0;0;0;.00nan;0;0
2941;175912;14;0;0;0;0;.00nan;0;0
2941;143473;22;74;19;1;18;.947;3600000;0
2942;3284;21;60;32;4;28;.875;3600000;0
2942;57338;35;47;36;6;30;.833;3573000;0
2942;141998;35;0;0;0;0;.00nan;0;0
2942;143156;21;0;0;0;0;.00nan;0;0
2943;2059;23;30;36;6;30;.833;3565000;0
2943;165582;24;0;0;0;0;.00nan;0;0
2943;78573;23;0;0;0;0;.00nan;0;0
2943;85727;24;42;32;5;27;.844;3600000;0
2944;556;3;81;29;2;27;.931;3600000;0
2944;163195;0;0;0;0;0;.00nan;0;0
2944;179344;3;0;0;0;0;.00nan;0;0
2944;139409;0;43;29;5;24;.828;3600000;0
2945;166591;20;0;0;0;0;.00nan;0;0
2945;168712;14;76;33;3;30;.909;3600000;0
2945;175912;14;0;0;0;0;.00nan;0;0
2945;71565;20;56;38;5;33;.868;3600000;0
2946;178413;17;0;0;0;0;.00nan;0;0
2946;59540;15;0;0;0;0;.00nan;0;0
2946;86697;15;81;31;2;29;.935;3600000;0
2946;146862;17;33;30;6;24;.800;3600000;0
2947;676;34;0;0;0;0;.00nan;0;0
2947;779;5;0;0;0;0;.00nan;0;0
2947;166751;5;79;37;3;34;.919;3600000;0
2947;78806;34;57;10;1;9;.900;3600000;0
2948;187537;19;86;29;1;28;.966;3600000;0
2948;187578;10;85;37;2;35;.946;3579000;0
2948;163565;19;0;0;0;0;.00nan;0;0
2948;90164;10;0;0;0;0;.00nan;0;0
2949;163423;26;0;0;0;0;.00nan;0;0
2949;183844;29;40;42;7;35;.833;4091000;0
2949;179154;26;41;41;6;35;.854;4050000;0
2949;37818;29;0;0;0;0;.00nan;0;0
2950;3928;12;58;13;1;12;.923;3600000;0
2950;190465;33;0;0;0;0;.00nan;0;0
2950;86192;33;82;32;2;30;.938;3600000;0
2950;91178;12;0;0;0;0;.00nan;0;0
2951;169868;4182;0;0;0;0;.00nan;0;0
2951;174718;25;0;0;0;0;.00nan;0;0
2951;147945;4182;91;28;1;27;.964;3600000;0
2951;148958;25;66;40;4;36;.900;3600000;0
2952;13714;8;0;0;0;0;.00nan;0;0
2952;166381;27;82;32;1;31;.969;3567000;0
2952;18213;8;100;24;0;24;1.000;3600000;0
2952;175660;27;0;0;0;0;.00nan;0;0
2953;15;30;0;0;0;0;.00nan;0;0
2953;167642;18;0;0;0;0;.00nan;0;0
2953;17043;30;62;31;3;28;.903;3600000;0
2953;173727;18;87;34;2;32;.941;3600000;0
2954;2059;23;56;28;4;24;.857;3897000;0
2954;13337;32;0;0;0;0;.00nan;0;0
2954;20432;32;93;50;5;45;.900;3897000;0
2954;78573;23;0;0;0;0;.00nan;0;0
2955;166646;16;0;0;0;0;.00nan;0;0
2955;50065;16;69;35;3;32;.914;3572000;0
2955;57338;35;93;32;1;31;.969;3600000;0
2955;141998;35;0;0;0;0;.00nan;0;0
2956;67;11;73;40;4;36;.900;3600000;0
2956;3284;21;75;21;1;20;.952;3600000;0
2956;46468;11;0;0;0;0;.00nan;0;0
2956;143156;21;0;0;0;0;.00nan;0;0
2957;13714;8;0;0;0;0;.00nan;0;0
2957;18213;8;69;31;3;28;.903;3553000;0
2957;179950;4838;0;0;0;0;.00nan;0;0
2957;143749;4838;73;29;2;27;.931;3600000;0
2958;163195;0;52;27;3;24;.889;3565000;0
2958;165582;24;0;0;0;0;.00nan;0;0
2958;85727;24;99;34;1;33;.971;3600000;0
2958;139409;0;0;0;0;0;.00nan;0;0
2959;166591;20;0;0;0;0;.00nan;0;0
2959;183844;29;0;0;0;0;.00nan;0;0
2959;37818;29;70;25;2;23;.920;3600000;0
2959;71565;20;65;38;4;34;.895;3521000;0
2960;779;5;0;0;0;0;.00nan;0;0
2960;166751;5;58;33;4;29;.879;3600000;0
2960;59540;15;72;18;1;17;.944;3600000;0
2960;86697;15;0;0;0;0;.00nan;0;0
2961;556;3;97;33;1;32;.970;4200000;0
2961;3928;12;100;35;1;34;.971;4200000;0
2961;179344;3;0;0;0;0;.00nan;0;0
2961;91178;12;0;0;0;0;.00nan;0;0
2962;178413;17;15;22;6;16;.727;2192000;0
2962;77955;28;0;0;0;0;.00nan;0;0
2962;85437;28;85;41;2;39;.951;3600000;0
2962;146862;17;75;12;0;12;1.000;1408000;0
2963;187578;10;87;45;3;42;.933;3539000;0
2963;163695;9;0;0;0;0;.00nan;0;0
2963;175092;9;60;16;1;15;.938;3600000;0
2963;90164;10;0;0;0;0;.00nan;0;0
2964;676;34;67;21;2;19;.905;3600000;0
2964;187537;19;58;30;4;26;.867;3526000;0
2964;163565;19;0;0;0;0;.00nan;0;0
2964;78806;34;0;0;0;0;.00nan;0;0
2965;171838;31;0;0;0;0;.00nan;0;0
2965;168712;14;68;40;4;36;.900;3600000;0
2965;175912;14;0;0;0;0;.00nan;0;0
2965;152717;31;71;22;1;21;.955;3600000;0
2966;163423;26;0;0;0;0;.00nan;0;0
2966;179154;26;82;34;3;31;.912;3600000;0
2966;184770;22;0;0;0;0;.00nan;0;0
2966;143473;22;72;16;1;15;.938;3600000;0
2967;169868;4182;0;0;0;0;.00nan;0;0
2967;190465;33;0;0;0;0;.00nan;0;0
2967;86192;33;68;44;5;39;.886;3600000;0
2967;147945;4182;92;35;1;34;.971;3600000;0
2968;15;30;0;0;0;0;.00nan;0;0
2968;166381;27;53;21;3;18;.857;3600000;0
2968;17043;30;73;45;4;41;.911;3572000;0
2968;175660;27;0;0;0;0;.00nan;0;0
2969;3284;21;0;0;0;0;.00nan;0;0
2969;167642;18;0;0;0;0;.00nan;0;0
2969;173727;18;42;31;5;26;.839;3600000;0
2969;143156;21;91;43;2;41;.953;3600000;0
2970;169868;4182;98;28;0;28;1.000;3600000;0
2970;57338;35;84;41;2;39;.951;3560000;0
2970;141998;35;0;0;0;0;.00nan;0;0
2970;147945;4182;0;0;0;0;.00nan;0;0
2971;2059;23;16;22;6;16;.727;2321000;0
2971;174718;25;100;22;0;22;1.000;3600000;0
2971;78573;23;38;14;3;11;.786;1279000;0
2971;148958;25;0;0;0;0;.00nan;0;0
2972;556;3;100;40;2;38;.950;3600000;0
2972;163195;0;0;0;0;0;.00nan;0;0
2972;179344;3;0;0;0;0;.00nan;0;0
2972;139409;0;64;35;4;31;.886;3553000;0
2973;779;5;53;10;1;9;.900;818000;0
2973;166751;5;48;40;6;34;.850;2782000;0
2973;165582;24;61;15;2;13;.867;3600000;0
2973;85727;24;0;0;0;0;.00nan;0;0
2974;676;34;0;0;0;0;.00nan;0;0
2974;168712;14;97;32;1;31;.969;3600000;0
2974;175912;14;0;0;0;0;.00nan;0;0
2974;78806;34;57;32;4;28;.875;3600000;0
2975;3928;12;26;26;6;20;.769;2709000;0
2975;184770;22;0;0;0;0;.00nan;0;0
2975;91178;12;54;16;2;14;.875;891000;0
2975;143473;22;48;17;3;14;.824;3600000;0
2976;171838;31;0;0;0;0;.00nan;0;0
2976;183844;29;58;22;3;19;.864;3600000;0
2976;37818;29;0;0;0;0;.00nan;0;0
2976;152717;31;100;25;0;25;1.000;3600000;0
2977;187578;10;0;0;0;0;.00nan;0;0
2977;77955;28;75;44;3;41;.932;3589000;0
2977;85437;28;0;0;0;0;.00nan;0;0
2977;90164;10;84;34;2;32;.941;3600000;0
2978;187537;19;77;34;2;32;.941;3570000;0
2978;163565;19;0;0;0;0;.00nan;0;0
2978;59540;15;0;0;0;0;.00nan;0;0
2978;86697;15;86;26;1;25;.962;3600000;0
2979;166381;27;51;23;4;19;.826;3600000;0
2979;178413;17;0;0;0;0;.00nan;0;0
2979;175660;27;0;0;0;0;.00nan;0;0
2979;146862;17;70;49;6;43;.878;3600000;0
2980;166591;20;0;0;0;0;.00nan;0;0
2980;163695;9;50;36;6;30;.833;3600000;0
2980;175092;9;0;0;0;0;.00nan;0;0
2980;71565;20;47;38;7;31;.816;3546000;0
2981;2059;23;0;0;0;0;.00nan;0;0
2981;163423;26;0;0;0;0;.00nan;0;0
2981;179154;26;56;12;1;11;.917;3600000;0
2981;78573;23;73;40;4;36;.900;3600000;0
2982;13337;32;0;0;0;0;.00nan;0;0
2982;20432;32;96;42;2;40;.952;3600000;0
2982;190465;33;0;0;0;0;.00nan;0;0
2982;86192;33;43;23;4;19;.826;3561000;0
2983;67;11;71;13;0;13;1.000;1366000;0
2983;13714;8;65;24;3;21;.875;3600000;0
2983;18213;8;0;0;0;0;.00nan;0;0
2983;46468;11;12;24;7;17;.708;2234000;0
2984;166646;16;0;0;0;0;.00nan;0;0
2984;167642;18;0;0;0;0;.00nan;0;0
2984;173727;18;57;33;4;29;.879;3600000;0
2984;50065;16;74;27;2;25;.926;3600000;0
2985;3284;21;42;18;3;15;.833;3913000;0
2985;179950;4838;0;0;0;0;.00nan;0;0
2985;143156;21;0;0;0;0;.00nan;0;0
2985;143749;4838;76;34;2;32;.941;3913000;0
2986;165582;24;0;0;0;0;.00nan;0;0
2986;168712;14;0;0;0;0;.00nan;0;0
2986;175912;14;74;31;2;29;.935;3773000;0
2986;85727;24;92;36;1;35;.972;3773000;0
2987;15;30;0;0;0;0;.00nan;0;0
2987;17043;30;99;44;1;43;.977;3600000;0
2987;184770;22;53;18;2;16;.889;3550000;0
2987;143473;22;0;0;0;0;.00nan;0;0
2988;57338;35;74;34;3;31;.912;3592000;0
2988;59540;15;0;0;0;0;.00nan;0;0
2988;86697;15;82;26;1;25;.962;3600000;0
2988;141998;35;0;0;0;0;.00nan;0;0
2989;187537;19;0;0;0;0;.00nan;0;0
2989;163565;19;66;45;6;39;.867;3600000;0
2989;174718;25;62;21;2;19;.905;3600000;0
2989;148958;25;0;0;0;0;.00nan;0;0
2990;166591;20;0;0;0;0;.00nan;0;0
2990;779;5;57;27;3;24;.889;3600000;0
2990;166751;5;0;0;0;0;.00nan;0;0
2990;71565;20;56;34;5;29;.853;3539000;0
2991;556;3;91;34;2;32;.941;3600000;0
2991;676;34;14;26;7;19;.731;3600000;0
2991;179344;3;0;0;0;0;.00nan;0;0
2991;78806;34;0;0;0;0;.00nan;0;0
2992;13337;32;81;42;3;39;.929;3600000;0
2992;20432;32;0;0;0;0;.00nan;0;0
2992;169868;4182;57;34;4;30;.882;3600000;0
2992;147945;4182;0;0;0;0;.00nan;0;0
2993;3284;21;96;39;2;37;.949;3600000;0
2993;166381;27;40;21;4;17;.810;3567000;0
2993;175660;27;0;0;0;0;.00nan;0;0
2993;143156;21;0;0;0;0;.00nan;0;0
2994;163195;0;0;0;0;0;.00nan;0;0
2994;167642;18;100;27;0;27;1.000;3600000;0
2994;173727;18;0;0;0;0;.00nan;0;0
2994;139409;0;40;32;5;27;.844;3600000;0
2995;779;5;0;0;0;0;.00nan;0;0
2995;166751;5;61;20;2;18;.900;3600000;0
2995;77955;28;0;0;0;0;.00nan;0;0
2995;85437;28;66;36;4;32;.889;3568000;0
2996;556;3;0;0;0;0;.00nan;0;0
2996;179344;3;85;36;2;34;.944;3600000;0
2996;59540;15;0;0;0;0;.00nan;0;0
2996;86697;15;60;35;4;31;.886;3553000;0
2997;676;34;0;0;0;0;.00nan;0;0
2997;184770;22;0;0;0;0;.00nan;0;0
2997;78806;34;98;41;1;40;.976;3578000;0
2997;143473;22;89;18;0;18;1.000;3600000;0
2998;168712;14;63;24;2;22;.917;4200000;0
2998;175912;14;0;0;0;0;.00nan;0;0
2998;57338;35;100;49;2;47;.959;4199000;0
2998;141998;35;0;0;0;0;.00nan;0;0
2999;187578;10;87;45;4;41;.911;3544000;0
2999;163695;9;35;13;3;10;.769;3600000;0
2999;175092;9;0;0;0;0;.00nan;0;0
2999;90164;10;0;0;0;0;.00nan;0;0
3000;166591;20;73;17;0;17;1.000;1220000;0
3000;165582;24;0;0;0;0;.00nan;0;0
3000;71565;20;47;34;5;29;.853;2380000;0
3000;85727;24;85;27;1;26;.963;3600000;0
3001;187537;19;44;32;5;27;.844;3600000;0
3001;166646;16;0;0;0;0;.00nan;0;0
3001;163565;19;0;0;0;0;.00nan;0;0
3001;50065;16;91;30;2;28;.933;3600000;0
3002;13337;32;0;0;0;0;.00nan;0;0
3002;13714;8;0;0;0;0;.00nan;0;0
3002;18213;8;86;30;1;29;.967;3600000;0
3002;20432;32;97;42;2;40;.952;3544000;0
3003;67;11;76;36;3;33;.917;3543000;0
3003;178413;17;0;0;0;0;.00nan;0;0
3003;46468;11;0;0;0;0;.00nan;0;0
3003;146862;17;85;32;2;30;.938;3600000;0
3004;169868;4182;0;0;0;0;.00nan;0;0
3004;190465;33;0;0;0;0;.00nan;0;0
3004;86192;33;75;22;1;21;.955;3600000;0
3004;147945;4182;62;22;2;20;.909;3576000;0
3005;2059;23;64;34;4;30;.882;3544000;0
3005;174718;25;64;26;3;23;.885;3600000;0
3005;78573;23;0;0;0;0;.00nan;0;0
3005;148958;25;0;0;0;0;.00nan;0;0
3006;163195;0;0;0;0;0;.00nan;0;0
3006;179950;4838;0;0;0;0;.00nan;0;0
3006;139409;0;50;24;3;21;.875;3517000;0
3006;143749;4838;90;34;1;33;.971;3600000;0
3007;15;30;0;0;0;0;.00nan;0;0
3007;171838;31;0;0;0;0;.00nan;0;0
3007;17043;30;100;28;0;28;1.000;3600000;0
3007;152717;31;78;39;3;36;.923;3600000;0
3008;3284;21;100;32;0;32;1.000;3600000;0
3008;163695;9;0;0;0;0;.00nan;0;0
3008;175092;9;90;40;2;38;.950;3514000;0
3008;143156;21;0;0;0;0;.00nan;0;0
3009;3928;12;89;22;0;22;1.000;3600000;0
3009;163423;26;0;0;0;0;.00nan;0;0
3009;179154;26;66;32;3;29;.906;3600000;0
3009;91178;12;0;0;0;0;.00nan;0;0
3010;2059;23;0;0;0;0;.00nan;0;0
3010;190465;33;100;43;1;42;.977;3600000;0
3010;78573;23;80;30;2;28;.933;3584000;0
3010;86192;33;0;0;0;0;.00nan;0;0
3011;168712;14;97;34;1;33;.971;3600000;0
3011;175912;14;0;0;0;0;.00nan;0;0
3011;77955;28;37;31;6;25;.806;3329000;0
3011;85437;28;48;0;0;0;.00nan;271000;0
3012;166591;20;0;0;0;0;.00nan;0;0
3012;187578;10;53;21;3;18;.857;3600000;0
3012;71565;20;100;36;1;35;.972;3600000;0
3012;90164;10;0;0;0;0;.00nan;0;0
3013;556;3;72;37;4;33;.892;3600000;0
3013;165582;24;0;0;0;0;.00nan;0;0
3013;179344;3;0;0;0;0;.00nan;0;0
3013;85727;24;50;31;5;26;.839;3600000;0
3014;166646;16;0;0;0;0;.00nan;0;0
3014;183844;29;46;37;6;31;.838;3600000;0
3014;37818;29;0;0;0;0;.00nan;0;0
3014;50065;16;39;23;5;18;.783;3600000;0
3015;184770;22;0;0;0;0;.00nan;0;0
3015;57338;35;32;16;4;12;.750;1093000;0
3015;141998;35;40;24;5;19;.792;2507000;0
3015;143473;22;78;11;0;11;1.000;3600000;0
3016;779;5;0;0;0;0;.00nan;0;0
3016;166751;5;39;27;5;22;.815;3600000;0
3016;13337;32;0;0;0;0;.00nan;0;0
3016;20432;32;92;28;1;27;.964;3600000;0
3017;67;11;0;0;0;0;.00nan;0;0
3017;163195;0;0;0;0;0;.00nan;0;0
3017;46468;11;93;48;2;46;.958;3600000;0
3017;139409;0;80;15;0;15;1.000;3600000;0
3018;169868;4182;0;0;0;0;.00nan;0;0
3018;174718;25;67;31;2;29;.935;3600000;0
3018;147945;4182;79;37;3;34;.919;3554000;0
3018;148958;25;0;0;0;0;.00nan;0;0
3019;178413;17;0;0;0;0;.00nan;0;0
3019;179950;4838;0;0;0;0;.00nan;0;0
3019;143749;4838;73;39;4;35;.897;3600000;0
3019;146862;17;72;28;2;26;.929;3600000;0
3020;15;30;0;0;0;0;.00nan;0;0
3020;167642;18;79;38;3;35;.921;3600000;0
3020;17043;30;67;31;4;27;.871;3570000;0
3020;173727;18;0;0;0;0;.00nan;0;0
3021;171838;31;0;0;0;0;.00nan;0;0
3021;187537;19;73;35;3;32;.914;4029000;0
3021;163565;19;0;0;0;0;.00nan;0;0
3021;152717;31;87;32;2;30;.938;4029000;0
3022;166591;20;0;0;0;0;.00nan;0;0
3022;3284;21;59;21;3;18;.857;3600000;0
3022;71565;20;73;49;5;44;.898;3600000;0
3022;143156;21;0;0;0;0;.00nan;0;0
3023;676;34;39;26;5;21;.808;3539000;0
3023;163423;26;0;0;0;0;.00nan;0;0
3023;179154;26;80;40;4;36;.900;3600000;0
3023;78806;34;0;0;0;0;.00nan;0;0
3024;13714;8;81;26;2;24;.923;3600000;0
3024;18213;8;0;0;0;0;.00nan;0;0
3024;59540;15;0;0;0;0;.00nan;0;0
3024;86697;15;72;33;3;30;.909;3578000;0
3025;3928;12;70;26;3;23;.885;3552000;0
3025;167642;18;0;0;0;0;.00nan;0;0
3025;173727;18;92;44;2;42;.955;3600000;0
3025;91178;12;0;0;0;0;.00nan;0;0
3026;165582;24;0;0;0;0;.00nan;0;0
3026;57338;35;81;43;3;40;.930;3566000;0
3026;85727;24;76;29;2;27;.931;3600000;0
3026;141998;35;0;0;0;0;.00nan;0;0
3027;187578;10;40;22;4;18;.818;3600000;0
3027;77955;28;0;0;0;0;.00nan;0;0
3027;85437;28;82;35;3;32;.914;3600000;0
3027;90164;10;0;0;0;0;.00nan;0;0
3028;13337;32;0;0;0;0;.00nan;0;0
3028;20432;32;76;42;4;38;.905;3543000;0
3028;190465;33;0;0;0;0;.00nan;0;0
3028;86192;33;60;20;2;18;.900;3600000;0
3029;556;3;56;44;6;38;.864;3090000;0
3029;166646;16;76;26;2;24;.923;3600000;0
3029;179344;3;32;4;2;2;.500;510000;0
3029;50065;16;0;0;0;0;.00nan;0;0
3030;779;5;63;42;5;37;.881;3600000;0
3030;166751;5;0;0;0;0;.00nan;0;0
3030;184770;22;0;0;0;0;.00nan;0;0
3030;143473;22;91;33;2;31;.939;3600000;0
3031;67;11;60;31;3;28;.903;3725000;0
3031;163695;9;0;0;0;0;.00nan;0;0
3031;175092;9;79;35;2;33;.943;3710000;0
3031;46468;11;0;0;0;0;.00nan;0;0
3032;183844;29;78;32;2;30;.938;4200000;0
3032;168712;14;73;28;2;26;.929;4200000;0
3032;175912;14;0;0;0;0;.00nan;0;0
3032;37818;29;0;0;0;0;.00nan;0;0
3033;166381;27;87;31;1;30;.968;3588000;0
3033;175660;27;0;0;0;0;.00nan;0;0
3033;179950;4838;0;0;0;0;.00nan;0;0
3033;143749;4838;100;21;0;21;1.000;3600000;0
3034;171838;31;0;0;0;0;.00nan;0;0
3034;2059;23;0;0;0;0;.00nan;0;0
3034;78573;23;65;17;1;16;.941;3600000;0
3034;152717;31;87;53;5;48;.906;3600000;0
3035;187537;19;62;39;4;35;.897;3600000;0
3035;163565;19;0;0;0;0;.00nan;0;0
3035;174718;25;71;18;1;17;.944;3600000;0
3035;148958;25;0;0;0;0;.00nan;0;0
3036;15;30;0;0;0;0;.00nan;0;0
3036;17043;30;95;41;2;39;.951;3600000;0
3036;59540;15;0;0;0;0;.00nan;0;0
3036;86697;15;100;31;0;31;1.000;3600000;0
3037;3284;21;83;28;1;27;.964;3600000;0
3037;57338;35;0;0;0;0;.00nan;0;0
3037;141998;35;63;46;5;41;.891;3600000;0
3037;143156;21;0;0;0;0;.00nan;0;0
3038;676;34;100;34;0;34;1.000;3600000;0
3038;13714;8;0;0;0;0;.00nan;0;0
3038;18213;8;50;25;4;21;.840;3600000;0
3038;78806;34;0;0;0;0;.00nan;0;0
3039;165582;24;37;28;6;22;.786;2140000;0
3039;184770;22;57;25;3;22;.880;3600000;0
3039;85727;24;30;17;4;13;.765;1460000;0
3039;143473;22;0;0;0;0;.00nan;0;0
3040;166591;20;0;0;0;0;.00nan;0;0
3040;163695;9;56;32;4;28;.875;4064000;0
3040;175092;9;0;0;0;0;.00nan;0;0
3040;71565;20;93;45;3;42;.933;4052000;0
3041;67;11;0;0;0;0;.00nan;0;0
3041;779;5;0;0;0;0;.00nan;0;0
3041;166751;5;86;28;1;27;.964;3600000;0
3041;46468;11;75;37;3;34;.919;3512000;0
3042;187578;10;0;0;0;0;.00nan;0;0
3042;183844;29;0;0;0;0;.00nan;0;0
3042;37818;29;82;33;2;31;.939;3600000;0
3042;90164;10;70;37;4;33;.892;3581000;0
3043;3928;12;63;21;2;19;.905;3829000;0
3043;163423;26;0;0;0;0;.00nan;0;0
3043;179154;26;89;27;1;26;.963;3829000;0
3043;91178;12;0;0;0;0;.00nan;0;0
3044;171838;31;0;0;0;0;.00nan;0;0
3044;169868;4182;0;0;0;0;.00nan;0;0
3044;147945;4182;90;16;0;16;1.000;3600000;0
3044;152717;31;98;43;2;41;.953;3600000;0
3045;163195;0;0;0;0;0;.00nan;0;0
3045;166381;27;0;0;0;0;.00nan;0;0
3045;175660;27;100;26;0;26;1.000;3600000;0
3045;139409;0;78;38;3;35;.921;3600000;0
3046;167642;18;0;0;0;0;.00nan;0;0
3046;178413;17;0;0;0;0;.00nan;0;0
3046;173727;18;88;44;3;41;.932;3553000;0
3046;146862;17;77;23;1;22;.957;3600000;0
3047;15;30;0;0;0;0;.00nan;0;0
3047;13337;32;0;0;0;0;.00nan;0;0
3047;17043;30;65;25;2;23;.920;3600000;0
3047;20432;32;80;36;3;33;.917;3587000;0
3048;2059;23;78;32;2;30;.938;3600000;0
3048;179950;4838;0;0;0;0;.00nan;0;0
3048;78573;23;0;0;0;0;.00nan;0;0
3048;143749;4838;65;28;3;25;.893;3579000;0
3049;183844;29;0;0;0;0;.00nan;0;0
3049;37818;29;75;30;2;28;.933;3600000;0
3049;77955;28;62;36;4;32;.889;3513000;0
3049;85437;28;0;0;0;0;.00nan;0;0
3050;187578;10;0;0;0;0;.00nan;0;0
3050;168712;14;78;25;1;24;.960;3600000;0
3050;175912;14;0;0;0;0;.00nan;0;0
3050;90164;10;62;43;5;38;.884;3600000;0
3051;676;34;47;16;3;13;.813;3520000;0
3051;166591;20;0;0;0;0;.00nan;0;0
3051;71565;20;92;37;2;35;.946;3600000;0
3051;78806;34;0;0;0;0;.00nan;0;0
3052;163695;9;0;0;0;0;.00nan;0;0
3052;175092;9;72;39;3;36;.923;3555000;0
3052;184770;22;0;0;0;0;.00nan;0;0
3052;143473;22;62;18;2;16;.889;3600000;0
3053;556;3;97;46;3;43;.935;3570000;0
3053;3284;21;73;28;2;26;.929;3600000;0
3053;179344;3;0;0;0;0;.00nan;0;0
3053;143156;21;0;0;0;0;.00nan;0;0
3054;15;30;0;0;0;0;.00nan;0;0
3054;166646;16;0;0;0;0;.00nan;0;0
3054;17043;30;44;28;4;24;.857;3545000;0
3054;50065;16;53;27;3;24;.889;3600000;0
3055;67;11;13;25;7;18;.720;3114000;0
3055;46468;11;46;7;1;6;.857;486000;0
3055;57338;35;77;28;1;27;.964;3600000;0
3055;141998;35;0;0;0;0;.00nan;0;0
3056;166381;27;0;0;0;0;.00nan;0;0
3056;174718;25;97;38;2;36;.947;3557000;0
3056;175660;27;74;24;1;23;.958;3600000;0
3056;148958;25;0;0;0;0;.00nan;0;0
3057;13714;8;95;45;2;43;.956;4200000;0
3057;178413;17;0;0;0;0;.00nan;0;0
3057;18213;8;0;0;0;0;.00nan;0;0
3057;146862;17;100;51;2;49;.961;4200000;0
3058;3928;12;58;36;5;31;.861;3600000;0
3058;59540;15;0;0;0;0;.00nan;0;0
3058;86697;15;85;28;1;27;.964;3600000;0
3058;91178;12;0;0;0;0;.00nan;0;0
3059;167642;18;0;0;0;0;.00nan;0;0
3059;173727;18;85;30;1;29;.967;3600000;0
3059;169868;4182;0;0;0;0;.00nan;0;0
3059;147945;4182;51;13;2;11;.846;3570000;0
3060;187537;19;37;13;3;10;.769;3600000;0
3060;163423;26;0;0;0;0;.00nan;0;0
3060;163565;19;0;0;0;0;.00nan;0;0
3060;179154;26;57;37;6;31;.838;3600000;0
3061;779;5;57;13;1;12;.923;1671000;0
3061;166751;5;16;30;7;23;.767;1929000;0
3061;163195;0;0;0;0;0;.00nan;0;0
3061;139409;0;79;23;1;22;.957;3600000;0
3062;171838;31;0;0;0;0;.00nan;0;0
3062;77955;28;41;10;2;8;.800;643000;0
3062;85437;28;26;27;6;21;.778;2957000;0
3062;152717;31;64;24;2;22;.917;3600000;0
3063;556;3;56;22;3;19;.864;3572000;0
3063;166591;20;91;31;1;30;.968;3600000;0
3063;179344;3;0;0;0;0;.00nan;0;0
3063;71565;20;0;0;0;0;.00nan;0;0
3064;165582;24;0;0;0;0;.00nan;0;0
3064;183844;29;74;38;3;35;.921;3711000;0
3064;37818;29;0;0;0;0;.00nan;0;0
3064;85727;24;48;23;4;19;.826;3711000;0
3065;187578;10;0;0;0;0;.00nan;0;0
3065;178413;17;0;0;0;0;.00nan;0;0
3065;90164;10;90;48;4;44;.917;3600000;0
3065;146862;17;57;27;3;24;.889;3600000;0
3066;779;5;91;41;2;39;.951;3441000;0
3066;166751;5;29;8;3;5;.625;439000;0
3066;174718;25;51;29;4;25;.862;3880000;0
3066;148958;25;0;0;0;0;.00nan;0;0
3067;676;34;0;0;0;0;.00nan;0;0
3067;59540;15;0;0;0;0;.00nan;0;0
3067;78806;34;72;27;2;25;.926;3545000;0
3067;86697;15;91;32;1;31;.969;3600000;0
3068;3284;21;56;23;3;20;.870;3586000;0
3068;163695;9;99;36;1;35;.972;3600000;0
3068;175092;9;0;0;0;0;.00nan;0;0
3068;143156;21;0;0;0;0;.00nan;0;0
3069;187537;19;100;49;2;47;.959;4200000;0
3069;163565;19;0;0;0;0;.00nan;0;0
3069;190465;33;0;0;0;0;.00nan;0;0
3069;86192;33;81;35;2;33;.943;4200000;0
3070;13337;32;68;13;0;13;1.000;1068000;0
3070;166381;27;0;0;0;0;.00nan;0;0
3070;20432;32;57;45;6;39;.867;2532000;0
3070;175660;27;55;19;3;16;.842;3600000;0
3071;15;30;0;0;0;0;.00nan;0;0
3071;17043;30;96;21;0;21;1.000;3600000;0
3071;57338;35;97;35;1;34;.971;3553000;0
3071;141998;35;0;0;0;0;.00nan;0;0
3072;13714;8;56;12;1;11;.917;3600000;0
3072;18213;8;0;0;0;0;.00nan;0;0
3072;168712;14;94;43;3;40;.930;3600000;0
3072;175912;14;0;0;0;0;.00nan;0;0
3073;67;11;0;0;0;0;.00nan;0;0
3073;2059;23;46;23;4;19;.826;3600000;0
3073;46468;11;100;26;0;26;1.000;3600000;0
3073;78573;23;0;0;0;0;.00nan;0;0
3074;166646;16;0;0;0;0;.00nan;0;0
3074;3928;12;54;32;4;28;.875;3591000;0
3074;50065;16;79;28;2;26;.929;3600000;0
3074;91178;12;0;0;0;0;.00nan;0;0
3075;167642;18;0;0;0;0;.00nan;0;0
3075;173727;18;86;44;3;41;.932;3627000;0
3075;169868;4182;0;0;0;0;.00nan;0;0
3075;147945;4182;64;32;4;28;.875;3597000;0
3076;163423;26;0;0;0;0;.00nan;0;0
3076;179154;26;23;24;6;18;.750;3600000;0
3076;179950;4838;0;0;0;0;.00nan;0;0
3076;143749;4838;87;36;3;33;.917;3600000;0
3077;163195;0;81;52;5;47;.904;3600000;0
3077;184770;22;0;0;0;0;.00nan;0;0
3077;139409;0;0;0;0;0;.00nan;0;0
3077;143473;22;80;23;1;22;.957;3600000;0
3078;556;3;76;38;3;35;.921;3596000;0
3078;183844;29;0;0;0;0;.00nan;0;0
3078;179344;3;0;0;0;0;.00nan;0;0
3078;37818;29;100;45;1;44;.978;3600000;0
3079;15;30;0;0;0;0;.00nan;0;0
3079;17043;30;100;28;0;28;1.000;3600000;0
3079;190465;33;0;0;0;0;.00nan;0;0
3079;86192;33;57;31;4;27;.871;3600000;0
3080;67;11;0;0;0;0;.00nan;0;0
3080;169868;4182;0;0;0;0;.00nan;0;0
3080;46468;11;82;47;4;43;.915;3600000;0
3080;147945;4182;75;23;1;22;.957;3600000;0
3081;3928;12;50;22;3;19;.864;4200000;0
3081;168712;14;83;44;3;41;.932;4200000;0
3081;175912;14;0;0;0;0;.00nan;0;0
3081;91178;12;0;0;0;0;.00nan;0;0
3082;166646;16;0;0;0;0;.00nan;0;0
3082;13714;8;81;27;1;26;.963;3600000;0
3082;18213;8;0;0;0;0;.00nan;0;0
3082;50065;16;62;37;4;33;.892;3600000;0
3083;163195;0;0;0;0;0;.00nan;0;0
3083;163695;9;0;0;0;0;.00nan;0;0
3083;175092;9;70;38;4;34;.895;3600000;0
3083;139409;0;89;25;1;24;.960;3600000;0
3084;676;34;50;41;6;35;.854;3977000;0
3084;59540;15;29;25;5;20;.800;3977000;0
3084;78806;34;0;0;0;0;.00nan;0;0
3084;86697;15;0;0;0;0;.00nan;0;0
3085;166591;20;0;0;0;0;.00nan;0;0
3085;178413;17;0;0;0;0;.00nan;0;0
3085;71565;20;74;54;6;48;.889;3600000;0
3085;146862;17;66;25;2;23;.920;3600000;0
3086;187578;10;49;40;6;34;.850;3600000;0
3086;174718;25;64;31;3;28;.903;3600000;0
3086;90164;10;0;0;0;0;.00nan;0;0
3086;148958;25;0;0;0;0;.00nan;0;0
3087;171838;31;0;0;0;0;.00nan;0;0
3087;165582;24;0;0;0;0;.00nan;0;0
3087;85727;24;82;32;2;30;.938;3600000;0
3087;152717;31;70;39;4;35;.897;3560000;0
3088;779;5;0;0;0;0;.00nan;0;0
3088;166751;5;75;41;4;37;.902;4081000;0
3088;57338;35;78;38;3;35;.921;4081000;0
3088;141998;35;0;0;0;0;.00nan;0;0
3089;3284;21;67;21;2;19;.905;3600000;0
3089;77955;28;55;30;4;26;.867;3536000;0
3089;85437;28;0;0;0;0;.00nan;0;0
3089;143156;21;0;0;0;0;.00nan;0;0
3090;187537;19;45;22;4;18;.818;3600000;0
3090;163565;19;0;0;0;0;.00nan;0;0
3090;13337;32;0;0;0;0;.00nan;0;0
3090;20432;32;91;33;1;32;.970;3600000;0
3091;2059;23;47;40;6;34;.850;2806000;0
3091;166381;27;55;12;1;11;.917;3600000;0
3091;175660;27;0;0;0;0;.00nan;0;0
3091;78573;23;60;14;1;13;.929;794000;0
3092;163423;26;0;0;0;0;.00nan;0;0
3092;167642;18;0;0;0;0;.00nan;0;0
3092;173727;18;66;33;3;30;.909;3600000;0
3092;179154;26;62;35;4;31;.886;3552000;0
3093;169868;4182;65;16;2;14;.875;3600000;0
3093;179950;4838;0;0;0;0;.00nan;0;0
3093;143749;4838;79;39;3;36;.923;3552000;0
3093;147945;4182;0;0;0;0;.00nan;0;0
3094;13714;8;76;34;3;31;.912;3591000;0
3094;18213;8;0;0;0;0;.00nan;0;0
3094;59540;15;0;0;0;0;.00nan;0;0
3094;86697;15;100;37;1;36;.973;3600000;0
3095;676;34;0;0;0;0;.00nan;0;0
3095;168712;14;0;0;0;0;.00nan;0;0
3095;175912;14;99;38;1;37;.974;3600000;0
3095;78806;34;40;31;5;26;.839;3600000;0
3096;187578;10;88;39;2;37;.949;3600000;0
3096;165582;24;0;0;0;0;.00nan;0;0
3096;85727;24;40;21;4;17;.810;3557000;0
3096;90164;10;0;0;0;0;.00nan;0;0
3097;556;3;57;18;2;16;.889;3600000;0
3097;171838;31;0;0;0;0;.00nan;0;0
3097;179344;3;0;0;0;0;.00nan;0;0
3097;152717;31;88;45;3;42;.933;3574000;0
3098;163695;9;82;37;3;34;.919;3600000;0
3098;183844;29;54;18;2;16;.889;1628000;0
3098;175092;9;0;0;0;0;.00nan;0;0
3098;37818;29;7;18;6;12;.667;1972000;0
3099;67;11;20;28;7;21;.750;3600000;0
3099;13337;32;0;0;0;0;.00nan;0;0
3099;20432;32;66;20;2;18;.900;3600000;0
3099;46468;11;0;0;0;0;.00nan;0;0
3100;2059;23;0;0;0;0;.00nan;0;0
3100;57338;35;79;39;3;36;.923;3600000;0
3100;78573;23;87;35;2;33;.943;3600000;0
3100;141998;35;0;0;0;0;.00nan;0;0
3101;187537;19;0;0;0;0;.00nan;0;0
3101;163565;19;45;20;3;17;.850;3513000;0
3101;167642;18;100;48;1;47;.979;3600000;0
3101;173727;18;0;0;0;0;.00nan;0;0
3102;3284;21;78;31;2;29;.935;3600000;0
3102;163195;0;0;0;0;0;.00nan;0;0
3102;139409;0;100;42;1;41;.976;3600000;0
3102;143156;21;0;0;0;0;.00nan;0;0
3103;183844;29;59;34;4;30;.882;3838000;0
3103;178413;17;0;0;0;0;.00nan;0;0
3103;37818;29;0;0;0;0;.00nan;0;0
3103;146862;17;68;34;3;31;.912;3838000;0
3104;676;34;59;33;3;30;.909;3544000;0
3104;184770;22;0;0;0;0;.00nan;0;0
3104;78806;34;0;0;0;0;.00nan;0;0
3104;143473;22;65;16;2;14;.875;3600000;0
3105;165582;24;77;26;2;24;.923;3600000;0
3105;174718;25;100;30;1;29;.967;3600000;0
3105;85727;24;0;0;0;0;.00nan;0;0
3105;148958;25;0;0;0;0;.00nan;0;0
3106;779;5;0;0;0;0;.00nan;0;0
3106;166751;5;53;41;6;35;.854;3543000;0
3106;190465;33;0;0;0;0;.00nan;0;0
3106;86192;33;41;30;5;25;.833;3600000;0
3107;166646;16;0;0;0;0;.00nan;0;0
3107;50065;16;78;12;0;12;1.000;3600000;0
3107;77955;28;0;0;0;0;.00nan;0;0
3107;85437;28;60;25;3;22;.880;3600000;0
3108;166381;27;0;0;0;0;.00nan;0;0
3108;169868;4182;0;0;0;0;.00nan;0;0
3108;175660;27;60;16;1;15;.938;3600000;0
3108;147945;4182;88;56;5;51;.911;3600000;0
3109;15;30;0;0;0;0;.00nan;0;0
3109;17043;30;74;31;2;29;.935;4045000;0
3109;179950;4838;0;0;0;0;.00nan;0;0
3109;143749;4838;92;31;1;30;.968;4045000;0
3110;171838;31;0;0;0;0;.00nan;0;0
3110;163695;9;0;0;0;0;.00nan;0;0
3110;175092;9;65;38;4;34;.895;3542000;0
3110;152717;31;74;25;2;23;.920;3600000;0
3111;168712;14;100;44;2;42;.955;3600000;0
3111;184770;22;58;23;3;20;.870;3547000;0
3111;175912;14;0;0;0;0;.00nan;0;0
3111;143473;22;0;0;0;0;.00nan;0;0
3112;67;11;85;45;2;43;.956;3568000;0
3112;163423;26;0;0;0;0;.00nan;0;0
3112;179154;26;76;23;1;22;.957;3600000;0
3112;46468;11;0;0;0;0;.00nan;0;0
3113;3928;12;46;32;5;27;.844;3600000;0
3113;179950;4838;0;0;0;0;.00nan;0;0
3113;91178;12;0;0;0;0;.00nan;0;0
3113;143749;4838;100;39;1;38;.974;3600000;0
3114;2059;23;0;0;0;0;.00nan;0;0
3114;167642;18;0;0;0;0;.00nan;0;0
3114;173727;18;71;19;1;18;.947;3600000;0
3114;78573;23;64;28;3;25;.893;3522000;0
3115;166591;20;56;38;5;33;.868;3514000;0
3115;71565;20;0;0;0;0;.00nan;0;0
3115;77955;28;75;35;3;32;.914;3600000;0
3115;85437;28;0;0;0;0;.00nan;0;0
3116;165582;24;0;0;0;0;.00nan;0;0
3116;59540;15;0;0;0;0;.00nan;0;0
3116;85727;24;94;40;1;39;.975;3600000;0
3116;86697;15;59;27;3;24;.889;3515000;0
3117;171838;31;0;0;0;0;.00nan;0;0
3117;178413;17;0;0;0;0;.00nan;0;0
3117;146862;17;61;29;3;26;.897;3536000;0
3117;152717;31;100;41;1;40;.976;3600000;0
3118;779;5;78;24;1;23;.958;3600000;0
3118;166751;5;0;0;0;0;.00nan;0;0
3118;183844;29;67;27;2;25;.926;3544000;0
3118;37818;29;0;0;0;0;.00nan;0;0
3119;676;34;65;32;3;29;.906;3566000;0
3119;3284;21;85;35;2;33;.943;3600000;0
3119;78806;34;0;0;0;0;.00nan;0;0
3119;143156;21;0;0;0;0;.00nan;0;0
3120;13714;8;69;19;2;17;.895;3600000;0
3120;18213;8;0;0;0;0;.00nan;0;0
3120;190465;33;0;0;0;0;.00nan;0;0
3120;86192;33;66;51;6;45;.882;3600000;0
3121;166646;16;0;0;0;0;.00nan;0;0
3121;13337;32;0;0;0;0;.00nan;0;0
3121;20432;32;84;38;3;35;.921;3544000;0
3121;50065;16;55;20;2;18;.900;3600000;0
3122;166381;27;0;0;0;0;.00nan;0;0
3122;175660;27;74;26;2;24;.923;3600000;0
3122;57338;35;88;52;5;47;.904;3600000;0
3122;141998;35;0;0;0;0;.00nan;0;0
3123;187537;19;72;30;3;27;.900;3557000;0
3123;2059;23;92;46;2;44;.957;3600000;0
3123;163565;19;0;0;0;0;.00nan;0;0
3123;78573;23;0;0;0;0;.00nan;0;0
3124;187578;10;0;0;0;0;.00nan;0;0
3124;163195;0;0;0;0;0;.00nan;0;0
3124;90164;10;64;36;5;31;.861;3600000;0
3124;139409;0;92;30;1;29;.967;3600000;0
3125;166591;20;0;0;0;0;.00nan;0;0
3125;3284;21;0;0;0;0;.00nan;0;0
3125;71565;20;72;44;3;41;.932;4200000;0
3125;143156;21;71;30;3;27;.900;4200000;0
3126;556;3;63;31;3;28;.903;3600000;0
3126;168712;14;100;33;0;33;1.000;3600000;0
3126;179344;3;0;0;0;0;.00nan;0;0
3126;175912;14;0;0;0;0;.00nan;0;0
3127;67;11;0;0;0;0;.00nan;0;0
3127;13714;8;0;0;0;0;.00nan;0;0
3127;18213;8;76;11;0;11;1.000;3600000;0
3127;46468;11;81;48;5;43;.896;3600000;0
3128;167642;18;0;0;0;0;.00nan;0;0
3128;173727;18;52;27;4;23;.852;3600000;0
3128;169868;4182;0;0;0;0;.00nan;0;0
3128;147945;4182;56;27;3;24;.889;3600000;0
3129;15;30;0;0;0;0;.00nan;0;0
3129;3928;12;77;40;4;36;.900;3547000;0
3129;17043;30;72;34;3;31;.912;3600000;0
3129;91178;12;0;0;0;0;.00nan;0;0
3130;676;34;0;0;0;0;.00nan;0;0
3130;171838;31;0;0;0;0;.00nan;0;0
3130;78806;34;49;23;4;19;.826;3485000;0
3130;152717;31;100;44;2;42;.955;3600000;0
3131;183844;29;81;35;2;33;.943;3600000;0
3131;37818;29;0;0;0;0;.00nan;0;0
3131;77955;28;79;43;4;39;.907;3581000;0
3131;85437;28;0;0;0;0;.00nan;0;0
3132;190465;33;0;0;0;0;.00nan;0;0
3132;57338;35;100;38;0;38;1.000;3600000;0
3132;86192;33;84;24;1;23;.958;3596000;0
3132;141998;35;0;0;0;0;.00nan;0;0
3133;163423;26;0;0;0;0;.00nan;0;0
3133;179154;26;69;39;4;35;.897;3620000;0
3133;174718;25;47;30;5;25;.833;3620000;0
3133;148958;25;0;0;0;0;.00nan;0;0
3134;187537;19;88;18;0;18;1.000;3600000;0
3134;163565;19;0;0;0;0;.00nan;0;0
3134;13337;32;0;0;0;0;.00nan;0;0
3134;20432;32;84;32;2;30;.938;3520000;0
3135;187578;10;17;7;4;3;.429;783000;0
3135;59540;15;77;30;2;28;.933;3600000;0
3135;86697;15;0;0;0;0;.00nan;0;0
3135;90164;10;78;24;1;23;.958;2817000;0
3136;163695;9;0;0;0;0;.00nan;0;0
3136;178413;17;0;0;0;0;.00nan;0;0
3136;175092;9;69;36;4;32;.889;4200000;0
3136;146862;17;67;37;4;33;.892;4200000;0
3137;779;5;0;0;0;0;.00nan;0;0
3137;166751;5;100;52;3;49;.942;3600000;0
3137;184770;22;0;0;0;0;.00nan;0;0
3137;143473;22;39;22;4;18;.818;3568000;0
3138;166646;16;0;0;0;0;.00nan;0;0
3138;165582;24;0;0;0;0;.00nan;0;0
3138;50065;16;75;36;4;32;.889;4073000;0
3138;85727;24;64;33;3;30;.909;4073000;0
3139;67;11;21;18;5;13;.722;899000;0
3139;166381;27;66;17;1;16;.941;3600000;0
3139;175660;27;0;0;0;0;.00nan;0;0
3139;46468;11;65;38;4;34;.895;2701000;0
3140;2059;23;0;0;0;0;.00nan;0;0
3140;179950;4838;0;0;0;0;.00nan;0;0
3140;78573;23;94;50;3;47;.940;3904000;0
3140;143749;4838;78;28;2;26;.929;3904000;0
3141;556;3;67;24;2;22;.917;3600000;0
3141;163195;0;0;0;0;0;.00nan;0;0
3141;179344;3;0;0;0;0;.00nan;0;0
3141;139409;0;65;25;3;22;.880;3554000;0
3142;174718;25;78;31;1;30;.968;3600000;0
3142;190465;33;53;24;3;21;.875;3520000;0
3142;86192;33;0;0;0;0;.00nan;0;0
3142;148958;25;0;0;0;0;.00nan;0;0
3143;166591;20;83;44;3;41;.932;3600000;0
3143;59540;15;66;26;4;22;.846;3543000;0
3143;71565;20;0;0;0;0;.00nan;0;0
3143;86697;15;0;0;0;0;.00nan;0;0
3144;187537;19;63;46;5;41;.891;3600000;0
3144;3928;12;59;31;4;27;.871;3600000;0
3144;163565;19;0;0;0;0;.00nan;0;0
3144;91178;12;0;0;0;0;.00nan;0;0
3145;779;5;45;39;6;33;.846;2379000;0
3145;166751;5;38;15;3;12;.800;1221000;0
3145;3284;21;98;37;2;35;.946;3600000;0
3145;143156;21;0;0;0;0;.00nan;0;0
3146;166646;16;83;29;1;28;.966;3600000;0
3146;184770;22;40;15;3;12;.800;3558000;0
3146;50065;16;0;0;0;0;.00nan;0;0
3146;143473;22;0;0;0;0;.00nan;0;0
3147;178413;17;87;30;1;29;.967;3600000;0
3147;168712;14;65;32;3;29;.906;3514000;0
3147;175912;14;0;0;0;0;.00nan;0;0
3147;146862;17;0;0;0;0;.00nan;0;0
3148;13337;32;74;24;1;23;.958;3570000;0
3148;20432;32;0;0;0;0;.00nan;0;0
3148;169868;4182;0;0;0;0;.00nan;0;0
3148;147945;4182;100;31;0;31;1.000;3600000;0
3149;163423;26;81;35;2;33;.943;3600000;0
3149;13714;8;0;0;0;0;.00nan;0;0
3149;18213;8;47;29;4;25;.862;3550000;0
3149;179154;26;0;0;0;0;.00nan;0;0
3150;676;34;68;27;2;25;.926;3600000;0
3150;163695;9;63;33;3;30;.909;3600000;0
3150;175092;9;0;0;0;0;.00nan;0;0
3150;78806;34;0;0;0;0;.00nan;0;0
3151;15;30;0;0;0;0;.00nan;0;0
3151;17043;30;59;26;3;23;.885;3600000;0
3151;179950;4838;0;0;0;0;.00nan;0;0
3151;143749;4838;62;34;4;30;.882;3541000;0
3152;166591;20;0;0;0;0;.00nan;0;0
3152;71565;20;70;23;2;21;.913;3600000;0
3152;77955;28;93;38;1;37;.974;1550000;0
3152;85437;28;40;27;5;22;.815;2050000;0
3153;556;3;33;40;7;33;.825;3600000;0
3153;3284;21;86;35;2;33;.943;3600000;0
3153;179344;3;0;0;0;0;.00nan;0;0
3153;143156;21;0;0;0;0;.00nan;0;0
3154;779;5;0;0;0;0;.00nan;0;0
3154;166751;5;91;39;3;36;.923;3600000;0
3154;183844;29;86;15;0;15;1.000;3600000;0
3154;37818;29;0;0;0;0;.00nan;0;0
3155;187578;10;74;43;4;39;.907;3546000;0
3155;178413;17;0;0;0;0;.00nan;0;0
3155;90164;10;0;0;0;0;.00nan;0;0
3155;146862;17;60;23;2;21;.913;3600000;0
3156;163695;9;0;0;0;0;.00nan;0;0
3156;175092;9;85;40;3;37;.925;3599000;0
3156;184770;22;0;0;0;0;.00nan;0;0
3156;143473;22;66;23;2;21;.913;3600000;0
3157;165582;24;0;0;0;0;.00nan;0;0
3157;168712;14;78;34;3;31;.912;3583000;0
3157;175912;14;0;0;0;0;.00nan;0;0
3157;85727;24;71;23;2;21;.913;3600000;0
3158;171838;31;0;0;0;0;.00nan;0;0
3158;59540;15;0;0;0;0;.00nan;0;0
3158;86697;15;51;20;3;17;.850;3600000;0
3158;152717;31;73;42;5;37;.881;3544000;0
3159;163195;0;0;0;0;0;.00nan;0;0
3159;163423;26;0;0;0;0;.00nan;0;0
3159;179154;26;74;20;1;19;.950;3600000;0
3159;139409;0;33;30;6;24;.800;3600000;0
3160;166646;16;0;0;0;0;.00nan;0;0
3160;50065;16;82;15;0;15;1.000;3600000;0
3160;57338;35;97;54;3;51;.944;3600000;0
3160;141998;35;0;0;0;0;.00nan;0;0
3161;13714;8;80;27;2;25;.926;3600000;0
3161;18213;8;0;0;0;0;.00nan;0;0
3161;190465;33;0;0;0;0;.00nan;0;0
3161;86192;33;72;34;3;31;.912;3595000;0
3162;2059;23;57;32;5;27;.844;3600000;0
3162;169868;4182;0;0;0;0;.00nan;0;0
3162;78573;23;0;0;0;0;.00nan;0;0
3162;147945;4182;76;19;1;18;.947;3600000;0
3163;3928;12;50;47;7;40;.851;2712000;0
3163;167642;18;0;0;0;0;.00nan;0;0
3163;173727;18;74;38;3;35;.921;3600000;0
3163;91178;12;54;7;1;6;.857;888000;0
3164;187537;19;0;0;0;0;.00nan;0;0
3164;163565;19;75;42;4;38;.905;3594000;0
3164;166381;27;0;0;0;0;.00nan;0;0
3164;175660;27;66;23;2;21;.913;3600000;0
3165;13337;32;62;18;1;17;.944;1261000;0
3165;20432;32;36;21;4;17;.810;2339000;0
3165;174718;25;84;26;1;25;.962;3600000;0
3165;148958;25;0;0;0;0;.00nan;0;0
3166;15;30;0;0;0;0;.00nan;0;0
3166;67;11;0;0;0;0;.00nan;0;0
3166;17043;30;70;35;4;31;.886;3600000;0
3166;46468;11;51;32;5;27;.844;3563000;0
3167;3928;12;74;8;0;8;1.000;707000;0
3167;179950;4838;0;0;0;0;.00nan;0;0
3167;91178;12;24;25;6;19;.760;2893000;0
3167;143749;4838;98;29;1;28;.966;3600000;0
3168;3284;21;56;29;5;24;.828;3701000;0
3168;163195;0;85;50;4;46;.920;3701000;0
3168;139409;0;0;0;0;0;.00nan;0;0
3168;143156;21;0;0;0;0;.00nan;0;0
3169;183844;29;78;34;3;31;.912;4200000;0
3169;37818;29;0;0;0;0;.00nan;0;0
3169;59540;15;0;0;0;0;.00nan;0;0
3169;86697;15;55;28;3;25;.893;4200000;0
3170;187578;10;0;0;0;0;.00nan;0;0
3170;168712;14;83;39;4;35;.897;3517000;0
3170;175912;14;0;0;0;0;.00nan;0;0
3170;90164;10;84;38;2;36;.947;3600000;0
3171;556;3;45;29;4;25;.862;3600000;0
3171;676;34;93;27;1;26;.963;3600000;0
3171;179344;3;0;0;0;0;.00nan;0;0
3171;78806;34;0;0;0;0;.00nan;0;0
3172;779;5;0;0;0;0;.00nan;0;0
3172;171838;31;0;0;0;0;.00nan;0;0
3172;166751;5;79;36;3;33;.917;3600000;0
3172;152717;31;16;22;6;16;.727;3600000;0
3173;163695;9;32;37;7;30;.811;2673000;0
3173;175092;9;64;9;0;9;1.000;927000;0
3173;184770;22;0;0;0;0;.00nan;0;0
3173;143473;22;75;20;1;19;.950;3600000;0
3174;165582;24;0;0;0;0;.00nan;0;0
3174;178413;17;0;0;0;0;.00nan;0;0
3174;85727;24;69;29;2;27;.931;3993000;0
3174;146862;17;83;40;3;37;.925;3993000;0
3175;163423;26;0;0;0;0;.00nan;0;0
3175;179154;26;70;24;2;22;.917;3600000;0
3175;57338;35;61;32;3;29;.906;3599000;0
3175;141998;35;0;0;0;0;.00nan;0;0
3176;187537;19;65;34;4;30;.882;3986000;0
3176;163565;19;0;0;0;0;.00nan;0;0
3176;167642;18;0;0;0;0;.00nan;0;0
3176;173727;18;70;38;3;35;.921;4027000;0
3177;2059;23;0;0;0;0;.00nan;0;0
3177;166381;27;0;0;0;0;.00nan;0;0
3177;175660;27;65;33;3;30;.909;3600000;0
3177;78573;23;43;28;5;23;.821;3517000;0
3178;166591;20;0;0;0;0;.00nan;0;0
3178;13337;32;0;0;0;0;.00nan;0;0
3178;20432;32;85;33;2;31;.939;3600000;0
3178;71565;20;77;36;3;33;.917;3545000;0
3179;166646;16;0;0;0;0;.00nan;0;0
3179;174718;25;100;40;1;39;.975;3600000;0
3179;50065;16;44;24;4;20;.833;3600000;0
3179;148958;25;0;0;0;0;.00nan;0;0
3180;67;11;65;20;1;19;.950;1523000;0
3180;3928;12;80;24;1;23;.958;3600000;0
3180;46468;11;20;23;6;17;.739;2077000;0
3180;91178;12;0;0;0;0;.00nan;0;0
3181;166381;27;61;31;3;28;.903;4050000;0
3181;169868;4182;0;0;0;0;.00nan;0;0
3181;175660;27;0;0;0;0;.00nan;0;0
3181;147945;4182;98;42;2;40;.952;4050000;0
3182;15;30;46;28;4;24;.857;3600000;0
3182;17043;30;0;0;0;0;.00nan;0;0
3182;190465;33;0;0;0;0;.00nan;0;0
3182;86192;33;76;35;3;32;.914;3600000;0
3183;165582;24;0;0;0;0;.00nan;0;0
3183;168712;14;72;27;2;25;.926;3600000;0
3183;175912;14;0;0;0;0;.00nan;0;0
3183;85727;24;62;28;3;25;.893;3581000;0
3184;163423;26;0;0;0;0;.00nan;0;0
3184;167642;18;0;0;0;0;.00nan;0;0
3184;173727;18;39;31;6;25;.806;3600000;0
3184;179154;26;74;26;2;24;.923;3600000;0
3185;13714;8;78;25;2;23;.920;3600000;0
3185;18213;8;0;0;0;0;.00nan;0;0
3185;57338;35;80;41;3;38;.927;3600000;0
3185;141998;35;0;0;0;0;.00nan;0;0
3186;163195;0;0;0;0;0;.00nan;0;0
3186;183844;29;0;0;0;0;.00nan;0;0
3186;37818;29;100;38;0;38;1.000;3600000;0
3186;139409;0;87;29;1;28;.966;3566000;0
3187;187578;10;100;46;1;45;.978;3600000;0
3187;184770;22;0;0;0;0;.00nan;0;0
3187;90164;10;0;0;0;0;.00nan;0;0
3187;143473;22;38;14;3;11;.786;3540000;0
3188;171838;31;0;0;0;0;.00nan;0;0
3188;3284;21;59;23;3;20;.870;3551000;0
3188;143156;21;0;0;0;0;.00nan;0;0
3188;152717;31;92;48;2;46;.958;3600000;0
3189;779;5;0;0;0;0;.00nan;0;0
3189;166751;5;99;38;1;37;.974;3600000;0
3189;178413;17;0;0;0;0;.00nan;0;0
3189;146862;17;37;21;4;17;.810;3600000;0
3190;556;3;79;24;1;23;.958;3600000;0
3190;163695;9;0;0;0;0;.00nan;0;0
3190;179344;3;0;0;0;0;.00nan;0;0
3190;175092;9;70;35;3;32;.914;3552000;0
3191;166646;16;54;38;5;33;.868;3867000;0
3191;50065;16;0;0;0;0;.00nan;0;0
3191;59540;15;0;0;0;0;.00nan;0;0
3191;86697;15;51;29;4;25;.862;3867000;0
3192;676;34;75;32;2;30;.938;4127000;0
3192;77955;28;92;57;3;54;.947;4127000;0
3192;78806;34;0;0;0;0;.00nan;0;0
3192;85437;28;0;0;0;0;.00nan;0;0
3193;67;11;79;37;2;35;.946;3600000;0
3193;179950;4838;0;0;0;0;.00nan;0;0
3193;46468;11;0;0;0;0;.00nan;0;0
3193;143749;4838;67;31;3;28;.903;3570000;0
3194;2059;23;0;0;0;0;.00nan;0;0
3194;169868;4182;37;28;6;22;.786;3600000;0
3194;78573;23;17;31;7;24;.774;3600000;0
3194;147945;4182;0;0;0;0;.00nan;0;0
3195;187537;19;49;32;5;27;.844;3547000;0
3195;163565;19;0;0;0;0;.00nan;0;0
3195;190465;33;59;25;3;22;.880;3600000;0
3195;86192;33;0;0;0;0;.00nan;0;0
3196;167642;18;78;35;2;33;.943;3572000;0
3196;13337;32;0;0;0;0;.00nan;0;0
3196;20432;32;88;30;1;29;.967;3600000;0
3196;173727;18;0;0;0;0;.00nan;0;0
3197;15;30;0;0;0;0;.00nan;0;0
3197;13714;8;0;0;0;0;.00nan;0;0
3197;17043;30;44;42;6;36;.857;3600000;0
3197;18213;8;67;22;2;20;.909;3600000;0
3198;166591;20;0;0;0;0;.00nan;0;0
3198;174718;25;62;12;1;11;.917;3600000;0
3198;71565;20;84;63;5;58;.921;3600000;0
3198;148958;25;0;0;0;0;.00nan;0;0
3199;3928;12;94;43;2;41;.953;3600000;0
3199;166381;27;58;29;4;25;.862;3530000;0
3199;175660;27;0;0;0;0;.00nan;0;0
3199;91178;12;0;0;0;0;.00nan;0;0
3200;556;3;66;42;4;38;.905;3560000;0
3200;178413;17;0;0;0;0;.00nan;0;0
3200;179344;3;0;0;0;0;.00nan;0;0
3200;146862;17;66;18;2;16;.889;3600000;0
3201;165582;24;0;0;0;0;.00nan;0;0
3201;184770;22;0;0;0;0;.00nan;0;0
3201;85727;24;99;49;1;48;.980;3600000;0
3201;143473;22;48;20;3;17;.850;3543000;0
3202;676;34;0;0;0;0;.00nan;0;0
3202;166646;16;0;0;0;0;.00nan;0;0
3202;50065;16;80;31;2;29;.935;3600000;0
3202;78806;34;57;33;4;29;.879;3545000;0
3203;171838;31;0;0;0;0;.00nan;0;0
3203;163195;0;0;0;0;0;.00nan;0;0
3203;139409;0;80;37;3;34;.919;3600000;0
3203;152717;31;49;30;5;25;.833;3580000;0
3204;3284;21;84;42;3;39;.929;3568000;0
3204;77955;28;67;24;2;22;.917;3600000;0
3204;85437;28;0;0;0;0;.00nan;0;0
3204;143156;21;0;0;0;0;.00nan;0;0
3205;779;5;0;0;0;0;.00nan;0;0
3205;166751;5;89;53;2;51;.962;3590000;0
3205;168712;14;75;10;0;10;1.000;3600000;0
3205;175912;14;0;0;0;0;.00nan;0;0
3206;67;11;0;0;0;0;.00nan;0;0
3206;187537;19;88;31;2;29;.935;3600000;0
3206;163565;19;0;0;0;0;.00nan;0;0
3206;46468;11;36;30;5;25;.833;3600000;0
3207;2059;23;24;9;4;5;.556;862000;0
3207;190465;33;0;0;0;0;.00nan;0;0
3207;78573;23;71;14;1;13;.929;3306000;0
3207;86192;33;65;48;6;42;.875;4168000;0
3208;779;5;42;35;6;29;.829;3600000;0
3208;166751;5;0;0;0;0;.00nan;0;0
3208;77955;28;0;0;0;0;.00nan;0;0
3208;85437;28;80;21;1;20;.952;3600000;0
3209;166591;20;0;0;0;0;.00nan;0;0
3209;59540;15;0;0;0;0;.00nan;0;0
3209;71565;20;48;23;3;20;.870;3532000;0
3209;86697;15;82;30;1;29;.967;3600000;0
3210;163695;9;31;30;6;24;.800;3571000;0
3210;183844;29;0;0;0;0;.00nan;0;0
3210;175092;9;0;0;0;0;.00nan;0;0
3210;37818;29;72;39;4;35;.897;3600000;0
3211;556;3;0;0;0;0;.00nan;0;0
3211;178413;17;0;0;0;0;.00nan;0;0
3211;179344;3;72;21;1;20;.952;3600000;0
3211;146862;17;56;42;6;36;.857;3600000;0
3212;187578;10;88;45;4;41;.911;3927000;0
3212;3284;21;0;0;0;0;.00nan;0;0
3212;90164;10;0;0;0;0;.00nan;0;0
3212;143156;21;52;25;3;22;.880;3927000;0
3213;167642;18;51;2;0;2;1.000;203000;0
3213;173727;18;33;31;6;25;.806;3340000;0
3213;57338;35;47;35;5;30;.857;3600000;0
3213;141998;35;0;0;0;0;.00nan;0;0
3214;15;30;0;0;0;0;.00nan;0;0
3214;17043;30;67;57;7;50;.877;3600000;0
3214;174718;25;62;11;1;10;.909;3600000;0
3214;148958;25;0;0;0;0;.00nan;0;0
3215;166381;27;0;0;0;0;.00nan;0;0
3215;175660;27;25;24;6;18;.750;3600000;0
3215;179950;4838;0;0;0;0;.00nan;0;0
3215;143749;4838;90;44;2;42;.955;3600000;0
3216;676;34;89;25;1;24;.960;3600000;0
3216;165582;24;0;0;0;0;.00nan;0;0
3216;78806;34;0;0;0;0;.00nan;0;0
3216;85727;24;67;48;5;43;.896;3600000;0
3217;171838;31;0;0;0;0;.00nan;0;0
3217;163695;9;0;0;0;0;.00nan;0;0
3217;175092;9;86;39;2;37;.949;3600000;0
3217;152717;31;96;32;1;31;.969;3600000;0
3218;163423;26;0;0;0;0;.00nan;0;0
3218;13337;32;0;0;0;0;.00nan;0;0
3218;20432;32;80;37;3;34;.919;3600000;0
3218;179154;26;88;25;1;24;.960;3600000;0
3219;67;11;70;36;3;33;.917;3600000;0
3219;3928;12;25;25;6;19;.760;2586000;0
3219;46468;11;0;0;0;0;.00nan;0;0
3219;91178;12;48;7;1;6;.857;1014000;0
3220;167642;18;0;0;0;0;.00nan;0;0
3220;173727;18;100;42;1;41;.976;3600000;0
3220;190465;33;0;0;0;0;.00nan;0;0
3220;86192;33;64;24;2;22;.917;3563000;0
3221;179950;4838;0;0;0;0;.00nan;0;0
3221;57338;35;51;31;5;26;.839;3600000;0
3221;141998;35;0;0;0;0;.00nan;0;0
3221;143749;4838;85;29;2;27;.931;3600000;0
3222;187537;19;54;18;2;16;.889;3600000;0
3222;163565;19;0;0;0;0;.00nan;0;0
3222;166381;27;70;29;3;26;.897;3554000;0
3222;175660;27;0;0;0;0;.00nan;0;0
3223;67;11;0;0;0;0;.00nan;0;0
3223;13714;8;75;15;1;14;.933;3600000;0
3223;18213;8;0;0;0;0;.00nan;0;0
3223;46468;11;60;30;3;27;.900;3522000;0
3224;15;30;0;0;0;0;.00nan;0;0
3224;17043;30;100;37;0;37;1.000;3914000;0
3224;169868;4182;0;0;0;0;.00nan;0;0
3224;147945;4182;86;26;1;25;.962;3914000;0
3225;2059;23;0;0;0;0;.00nan;0;0
3225;174718;25;70;18;1;17;.944;3600000;0
3225;78573;23;90;45;2;43;.956;3568000;0
3225;148958;25;0;0;0;0;.00nan;0;0
3227;175660;21;57;28;4;24;.857;3600000;0
3227;85798;12;62;44;5;39;.886;3586000;0
3227;91178;12;0;0;0;0;.00nan;0;0
3227;143156;21;0;0;0;0;.00nan;0;0
3229;166646;16;60;38;4;34;.895;3587000;0
3229;50065;16;0;0;0;0;.00nan;0;0
3229;59540;15;85;40;3;37;.925;3600000;0
3229;71565;15;0;0;0;0;.00nan;0;0
3231;556;3;42;28;4;24;.857;3540000;0
3231;179344;3;0;0;0;0;.00nan;0;0
3231;77955;28;95;48;2;46;.958;3600000;0
3231;85437;28;0;0;0;0;.00nan;0;0
3233;67;11;0;0;0;0;.00nan;0;0
3233;166381;27;0;0;0;0;.00nan;0;0
3233;170294;27;78;25;1;24;.960;3600000;0
3233;46468;11;59;46;6;40;.870;3600000;0
3235;163695;9;51;8;1;7;.875;1242000;0
3235;178413;17;0;0;0;0;.00nan;0;0
3235;175092;9;4;29;8;21;.724;2358000;0
3235;146862;17;63;27;4;23;.852;3600000;0
3237;676;34;0;0;0;0;.00nan;0;0
3237;167642;18;0;0;0;0;.00nan;0;0
3237;173727;18;95;34;1;33;.971;3600000;0
3237;78806;34;60;36;5;31;.861;3600000;0
3239;165582;24;0;0;0;0;.00nan;0;0
3239;168872;24;20;19;6;13;.684;3600000;0
3239;190465;33;0;0;0;0;.00nan;0;0
3239;86192;33;84;26;1;25;.962;3600000;0
3241;13714;8;0;0;0;0;.00nan;0;0
3241;18213;8;78;29;1;28;.966;3600000;0
3241;168712;14;80;27;2;25;.926;3543000;0
3241;175912;14;0;0;0;0;.00nan;0;0
3243;2059;23;76;47;4;43;.915;3597000;0
3243;183844;29;64;18;2;16;.889;3600000;0
3243;37818;29;0;0;0;0;.00nan;0;0
3243;78573;23;0;0;0;0;.00nan;0;0
3245;15;30;0;0;0;0;.00nan;0;0
3245;187578;10;0;0;0;0;.00nan;0;0
3245;17043;30;46;23;4;19;.826;3600000;0
3245;152717;10;97;36;1;35;.972;3600000;0
3247;163195;0;0;0;0;0;.00nan;0;0
3247;13337;32;0;0;0;0;.00nan;0;0
3247;20432;32;84;27;1;26;.963;3600000;0
3247;139409;0;46;21;3;18;.857;3557000;0
3249;171838;31;98;43;1;42;.977;3600000;0
3249;170977;31;0;0;0;0;.00nan;0;0
3249;175084;22;0;0;0;0;.00nan;0;0
3249;143473;22;71;30;3;27;.900;3562000;0
3251;187537;19;0;0;0;0;.00nan;0;0
3251;163565;19;100;42;2;40;.952;3600000;0
3251;172499;35;0;0;0;0;.00nan;0;0
3251;141998;35;45;33;5;28;.848;3600000;0
3253;163423;26;0;0;0;0;.00nan;0;0
3253;170314;25;86;36;2;34;.944;3600000;0
3253;179154;26;68;45;6;39;.867;3600000;0
3253;148958;25;0;0;0;0;.00nan;0;0
3255;166591;20;0;0;0;0;.00nan;0;0
3255;779;5;100;27;0;27;1.000;3600000;0
3255;166751;5;0;0;0;0;.00nan;0;0
3255;86697;20;97;41;1;40;.976;3600000;0
3257;1593;4838;0;0;0;0;.00nan;0;0
3257;169868;4182;0;0;0;0;.00nan;0;0
3257;143749;4838;84;31;2;29;.935;3553000;0
3257;147945;4182;88;24;1;23;.958;3600000;0
3259;676;34;60;27;3;24;.889;3600000;0
3259;2059;23;100;38;0;38;1.000;3600000;0
3259;78573;23;0;0;0;0;.00nan;0;0
3259;78806;34;0;0;0;0;.00nan;0;0
3261;15;30;0;0;0;0;.00nan;0;0
3261;17043;30;61;20;3;17;.850;3880000;0
3261;168712;14;75;39;4;35;.897;3880000;0
3261;175912;14;0;0;0;0;.00nan;0;0
3263;77955;28;0;0;0;0;.00nan;0;0
3263;85437;28;58;41;5;36;.878;3600000;0
3263;85798;12;0;0;0;0;.00nan;0;0
3263;91178;12;60;28;3;25;.893;3600000;0
3265;1593;4838;0;0;0;0;.00nan;0;0
3265;170314;25;74;26;2;24;.923;3600000;0
3265;143749;4838;76;45;4;41;.911;3571000;0
3265;148958;25;0;0;0;0;.00nan;0;0
3267;13337;32;0;0;0;0;.00nan;0;0
3267;20432;32;100;26;0;26;1.000;3600000;0
3267;59540;15;41;22;4;18;.818;3600000;0
3267;71565;15;0;0;0;0;.00nan;0;0
3269;556;3;68;37;3;34;.919;4200000;0
3269;172499;35;0;0;0;0;.00nan;0;0
3269;179344;3;0;0;0;0;.00nan;0;0
3269;141998;35;59;23;3;20;.870;4200000;0
3271;187578;10;0;0;0;0;.00nan;0;0
3271;165582;24;0;0;0;0;.00nan;0;0
3271;168872;24;100;27;0;27;1.000;3600000;0
3271;152717;10;84;36;2;34;.944;3556000;0
3273;163195;0;0;0;0;0;.00nan;0;0
3273;163423;26;0;0;0;0;.00nan;0;0
3273;179154;26;42;35;7;28;.800;3600000;0
3273;139409;0;86;27;1;26;.963;3600000;0
3275;171838;31;0;0;0;0;.00nan;0;0
3275;166646;16;0;0;0;0;.00nan;0;0
3275;170977;31;74;47;4;43;.915;4200000;0
3275;50065;16;56;29;4;25;.862;4200000;0
3277;167642;18;0;0;0;0;.00nan;0;0
3277;173727;18;40;32;5;27;.844;3600000;0
3277;190465;33;0;0;0;0;.00nan;0;0
3277;86192;33;100;34;0;34;1.000;3600000;0
3279;779;5;76;27;1;26;.963;3600000;0
3279;166751;5;0;0;0;0;.00nan;0;0
3279;13714;8;0;0;0;0;.00nan;0;0
3279;18213;8;54;23;3;20;.870;3558000;0
3281;166381;27;25;24;6;18;.750;2878000;0
3281;178413;17;0;0;0;0;.00nan;0;0
3281;170294;27;50;11;1;10;.909;709000;0
3281;146862;17;89;54;5;49;.907;3600000;0
3283;187537;19;0;0;0;0;.00nan;0;0
3283;163565;19;76;26;2;24;.923;3600000;0
3283;183844;29;0;0;0;0;.00nan;0;0
3283;37818;29;67;37;4;33;.892;3551000;0
3285;166591;20;0;0;0;0;.00nan;0;0
3285;175084;22;0;0;0;0;.00nan;0;0
3285;86697;20;58;39;5;34;.872;3600000;0
3285;143473;22;66;25;2;23;.920;3600000;0
3287;169868;4182;0;0;0;0;.00nan;0;0
3287;175660;21;66;15;1;14;.933;3600000;0
3287;143156;21;0;0;0;0;.00nan;0;0
3287;147945;4182;58;39;5;34;.872;3600000;0
3289;67;11;55;39;5;34;.872;3600000;0
3289;163695;9;0;0;0;0;.00nan;0;0
3289;175092;9;84;29;2;27;.931;3600000;0
3289;46468;11;0;0;0;0;.00nan;0;0
3291;187578;10;71;24;2;22;.917;3570000;0
3291;13714;8;94;30;1;29;.967;3600000;0
3291;18213;8;0;0;0;0;.00nan;0;0
3291;152717;10;0;0;0;0;.00nan;0;0
3293;167642;18;95;43;2;41;.953;3600000;0
3293;168712;14;62;10;0;10;1.000;1720000;0
3293;173727;18;0;0;0;0;.00nan;0;0
3293;175912;14;28;16;5;11;.688;1880000;0
3295;187537;19;17;17;5;12;.706;1100000;0
3295;3928;12;0;0;0;0;.00nan;0;0
3295;163565;19;56;24;3;21;.875;2478000;0
3295;85798;12;41;34;6;28;.824;3600000;0
3297;171838;31;80;33;2;31;.939;3600000;0
3297;183844;29;47;17;3;14;.824;3545000;0
3297;170977;31;0;0;0;0;.00nan;0;0
3297;37818;29;0;0;0;0;.00nan;0;0
3299;166646;16;100;28;0;28;1.000;3600000;0
3299;166381;27;0;0;0;0;.00nan;0;0
3299;170294;27;73;36;3;33;.917;3600000;0
3299;50065;16;0;0;0;0;.00nan;0;0
3301;67;11;0;0;0;0;.00nan;0;0
3301;46468;11;53;28;3;25;.893;4200000;0
3301;77955;28;85;38;3;35;.921;4200000;0
3301;85437;28;0;0;0;0;.00nan;0;0
3303;2059;23;61;22;2;20;.909;3600000;0
3303;175660;21;53;25;4;21;.840;2603000;0
3303;78573;23;0;0;0;0;.00nan;0;0
3303;143156;21;10;9;5;4;.444;997000;0
3305;163695;9;59;42;5;37;.881;3600000;0
3305;175084;22;51;14;2;12;.857;3600000;0
3305;175092;9;0;0;0;0;.00nan;0;0
3305;143473;22;0;0;0;0;.00nan;0;0
3307;1593;4838;0;0;0;0;.00nan;0;0
3307;170314;25;0;0;0;0;.00nan;0;0
3307;143749;4838;59;42;5;37;.881;3600000;0
3307;148958;25;73;31;2;29;.935;3600000;0
3309;556;3;0;0;0;0;.00nan;0;0
3309;163423;26;58;34;4;30;.882;3549000;0
3309;179154;26;0;0;0;0;.00nan;0;0
3309;179344;3;77;37;3;34;.919;3600000;0
3311;172499;35;52;30;4;26;.867;3669000;0
3311;169868;4182;63;28;3;25;.893;3669000;0
3311;141998;35;0;0;0;0;.00nan;0;0
3311;147945;4182;0;0;0;0;.00nan;0;0
3313;165582;24;0;0;0;0;.00nan;0;0
3313;178413;17;60;41;5;36;.878;3600000;0
3313;168872;24;62;19;1;18;.947;3600000;0
3313;146862;17;0;0;0;0;.00nan;0;0
3315;779;5;0;0;0;0;.00nan;0;0
3315;166751;5;72;34;3;31;.912;3600000;0
3315;163195;0;39;25;4;21;.840;3572000;0
3315;139409;0;0;0;0;0;.00nan;0;0
3317;676;34;0;0;0;0;.00nan;0;0
3317;190465;33;0;0;0;0;.00nan;0;0
3317;78806;34;100;26;0;26;1.000;3600000;0
3317;86192;33;80;40;3;37;.925;3600000;0
3319;13337;32;0;0;0;0;.00nan;0;0
3319;20432;32;73;50;5;45;.900;3600000;0
3319;59540;15;81;21;1;20;.952;3600000;0
3319;71565;15;0;0;0;0;.00nan;0;0
3321;15;30;0;0;0;0;.00nan;0;0
3321;166591;20;69;42;3;39;.929;3554000;0
3321;17043;30;75;34;2;32;.941;3600000;0
3321;86697;20;0;0;0;0;.00nan;0;0
3323;15;30;0;0;0;0;.00nan;0;0
3323;17043;30;50;28;4;24;.857;3600000;0
3323;175084;22;0;0;0;0;.00nan;0;0
3323;143473;22;72;27;2;25;.926;3600000;0
3325;166591;20;0;0;0;0;.00nan;0;0
3325;172499;35;0;0;0;0;.00nan;0;0
3325;86697;20;86;39;2;37;.949;3549000;0
3325;141998;35;100;22;0;22;1.000;3600000;0
3327;187578;10;0;0;0;0;.00nan;0;0
3327;166381;27;73;26;2;24;.923;3600000;0
3327;170294;27;0;0;0;0;.00nan;0;0
3327;152717;10;70;49;6;43;.878;3600000;0
3329;168712;14;99;35;1;34;.971;3600000;0
3329;175912;14;0;0;0;0;.00nan;0;0
3329;59540;15;78;34;2;32;.941;3571000;0
3329;71565;15;0;0;0;0;.00nan;0;0
3331;169868;4182;0;0;0;0;.00nan;0;0
3331;175660;21;82;35;2;33;.943;4200000;0
3331;143156;21;0;0;0;0;.00nan;0;0
3331;147945;4182;69;27;2;25;.926;4200000;0
3333;187537;19;70;29;3;26;.897;4200000;0
3333;2059;23;64;29;3;26;.897;4200000;0
3333;163565;19;0;0;0;0;.00nan;0;0
3333;78573;23;0;0;0;0;.00nan;0;0
3335;13714;8;0;0;0;0;.00nan;0;0
3335;18213;8;64;21;2;19;.905;3600000;0
3335;77955;28;98;50;3;47;.940;3592000;0
3335;85437;28;0;0;0;0;.00nan;0;0
3337;779;5;66;24;2;22;.917;3600000;0
3337;166751;5;0;0;0;0;.00nan;0;0
3337;13337;32;0;0;0;0;.00nan;0;0
3337;20432;32;62;29;3;26;.897;3600000;0
3339;676;34;0;0;0;0;.00nan;0;0
3339;163695;9;0;0;0;0;.00nan;0;0
3339;175092;9;30;40;7;33;.825;3600000;0
3339;78806;34;85;23;1;22;.957;3600000;0
3341;178413;17;0;0;0;0;.00nan;0;0
3341;170314;25;66;33;3;30;.909;4049000;0
3341;146862;17;79;42;4;38;.905;4049000;0
3341;148958;25;0;0;0;0;.00nan;0;0
3343;163195;0;0;0;0;0;.00nan;0;0
3343;165582;24;0;0;0;0;.00nan;0;0
3343;168872;24;47;40;6;34;.850;3600000;0
3343;139409;0;67;28;2;26;.929;3600000;0
3345;556;3;52;21;3;18;.857;3570000;0
3345;167642;18;0;0;0;0;.00nan;0;0
3345;173727;18;71;21;1;20;.952;3600000;0
3345;179344;3;0;0;0;0;.00nan;0;0
3347;1593;4838;0;0;0;0;.00nan;0;0
3347;3928;12;56;22;3;19;.864;3600000;0
3347;85798;12;0;0;0;0;.00nan;0;0
3347;143749;4838;72;39;4;35;.897;3598000;0
3349;67;11;29;10;3;7;.700;465000;0
3349;163423;26;0;0;0;0;.00nan;0;0
3349;179154;26;78;15;0;15;1.000;3600000;0
3349;46468;11;50;37;5;32;.865;3135000;0
3351;183844;29;0;0;0;0;.00nan;0;0
3351;190465;33;0;0;0;0;.00nan;0;0
3351;37818;29;95;22;0;22;1.000;3600000;0
3351;86192;33;40;39;7;32;.821;3600000;0
3353;171838;31;0;0;0;0;.00nan;0;0
3353;166646;16;76;34;3;31;.912;3600000;0
3353;170977;31;50;30;4;26;.867;3557000;0
3353;50065;16;0;0;0;0;.00nan;0;0
3355;556;3;0;0;0;0;.00nan;0;0
3355;170314;25;0;0;0;0;.00nan;0;0
3355;179344;3;71;29;2;27;.931;3531000;0
3355;148958;25;94;20;0;20;1.000;3600000;0
3357;187537;19;0;0;0;0;.00nan;0;0
3357;163565;19;70;23;2;21;.913;3600000;0
3357;13337;32;83;40;3;37;.925;3600000;0
3357;20432;32;0;0;0;0;.00nan;0;0
3359;166646;16;0;0;0;0;.00nan;0;0
3359;183844;29;0;0;0;0;.00nan;0;0
3359;37818;29;50;27;5;22;.815;3600000;0
3359;50065;16;100;35;0;35;1.000;3600000;0
3361;15;30;0;0;0;0;.00nan;0;0
3361;166591;20;30;30;6;24;.800;2591000;0
3361;17043;30;58;25;2;23;.920;3600000;0
3361;86697;20;52;8;1;7;.875;1009000;0
3363;779;5;0;0;0;0;.00nan;0;0
3363;166751;5;75;42;4;38;.905;3600000;0
3363;168712;14;0;0;0;0;.00nan;0;0
3363;175912;14;65;18;1;17;.944;3600000;0
3365;163695;9;51;31;5;26;.839;3571000;0
3365;13714;8;60;32;4;28;.875;3600000;0
3365;18213;8;0;0;0;0;.00nan;0;0
3365;175092;9;0;0;0;0;.00nan;0;0
3367;1593;4838;89;44;3;41;.932;3600000;0
3367;175084;22;35;18;4;14;.778;3579000;0
3367;143473;22;0;0;0;0;.00nan;0;0
3367;143749;4838;0;0;0;0;.00nan;0;0
3369;163195;0;42;30;5;25;.833;3578000;0
3369;165582;24;73;33;3;30;.909;3600000;0
3369;168872;24;0;0;0;0;.00nan;0;0
3369;139409;0;0;0;0;0;.00nan;0;0
3371;169868;4182;61;31;3;28;.903;3600000;0
3371;77955;28;66;11;0;11;1.000;1719000;0
3371;85437;28;22;20;6;14;.700;1881000;0
3371;147945;4182;0;0;0;0;.00nan;0;0
3373;175660;21;0;0;0;0;.00nan;0;0
3373;59540;15;0;0;0;0;.00nan;0;0
3373;71565;15;98;42;1;41;.976;3600000;0
3373;143156;21;100;25;0;25;1.000;3600000;0
3375;163423;26;0;0;0;0;.00nan;0;0
3375;166381;27;0;0;0;0;.00nan;0;0
3375;170294;27;78;30;2;28;.933;3600000;0
3375;179154;26;81;45;4;41;.911;3593000;0
3377;187578;10;15;24;7;17;.708;2699000;0
3377;3928;12;0;0;0;0;.00nan;0;0
3377;85798;12;82;49;5;44;.898;3600000;0
3377;152717;10;54;6;0;6;1.000;858000;0
3379;2059;23;0;0;0;0;.00nan;0;0
3379;178413;17;81;28;2;26;.929;3600000;0
3379;78573;23;49;31;5;26;.839;3600000;0
3379;146862;17;0;0;0;0;.00nan;0;0
3381;676;34;66;42;5;37;.881;3579000;0
3381;172499;35;0;0;0;0;.00nan;0;0
3381;78806;34;0;0;0;0;.00nan;0;0
3381;141998;35;64;28;3;25;.893;3600000;0
3383;67;11;80;42;3;39;.929;3566000;0
3383;190465;33;67;24;2;22;.917;3600000;0
3383;46468;11;0;0;0;0;.00nan;0;0
3383;86192;33;0;0;0;0;.00nan;0;0
3385;171838;31;70;25;2;23;.920;3600000;0
3385;167642;18;68;34;3;31;.912;3576000;0
3385;173727;18;0;0;0;0;.00nan;0;0
3385;170977;31;0;0;0;0;.00nan;0;0
3387;67;11;52;40;5;35;.875;3600000;0
3387;175084;22;0;0;0;0;.00nan;0;0
3387;46468;11;0;0;0;0;.00nan;0;0
3387;143473;22;85;17;0;17;1.000;3600000;0
3389;171838;31;26;39;7;32;.821;3572000;0
3389;163195;0;0;0;0;0;.00nan;0;0
3389;170977;31;0;0;0;0;.00nan;0;0
3389;139409;0;65;42;5;37;.881;3600000;0
3391;556;3;48;25;4;21;.840;3580000;0
3391;183844;29;0;0;0;0;.00nan;0;0
3391;179344;3;0;0;0;0;.00nan;0;0
3391;37818;29;77;30;2;28;.933;3600000;0
3393;166646;16;0;0;0;0;.00nan;0;0
3393;170314;25;0;0;0;0;.00nan;0;0
3393;50065;16;60;24;2;22;.917;3566000;0
3393;148958;25;94;35;1;34;.971;3600000;0
3395;676;34;0;0;0;0;.00nan;0;0
3395;3928;12;0;0;0;0;.00nan;0;0
3395;78806;34;68;34;3;31;.912;3544000;0
3395;85798;12;66;24;2;22;.917;3600000;0
3397;166591;20;0;0;0;0;.00nan;0;0
3397;175660;21;0;0;0;0;.00nan;0;0
3397;86697;20;63;40;4;36;.900;3546000;0
3397;143156;21;68;29;2;27;.931;3600000;0
3399;187578;10;65;43;5;38;.884;3600000;0
3399;163423;26;0;0;0;0;.00nan;0;0
3399;179154;26;57;23;3;20;.870;3600000;0
3399;152717;10;0;0;0;0;.00nan;0;0
3401;163695;9;0;0;0;0;.00nan;0;0
3401;172499;35;0;0;0;0;.00nan;0;0
3401;175092;9;42;26;4;22;.846;3600000;0
3401;141998;35;100;26;0;26;1.000;3600000;0
3403;13337;32;0;0;0;0;.00nan;0;0
3403;166381;27;96;30;1;29;.967;3600000;0
3403;20432;32;71;46;5;41;.891;3600000;0
3403;170294;27;0;0;0;0;.00nan;0;0
3405;187537;19;79;29;2;27;.931;3600000;0
3405;163565;19;0;0;0;0;.00nan;0;0
3405;178413;17;0;0;0;0;.00nan;0;0
3405;146862;17;71;35;3;32;.914;3557000;0
3407;779;5;55;33;5;28;.848;3600000;0
3407;166751;5;0;0;0;0;.00nan;0;0
3407;2059;23;72;17;1;16;.941;3600000;0
3407;78573;23;0;0;0;0;.00nan;0;0
3409;13714;8;0;0;0;0;.00nan;0;0
3409;18213;8;59;18;2;16;.889;3600000;0
3409;169868;4182;0;0;0;0;.00nan;0;0
3409;147945;4182;66;37;4;33;.892;3527000;0
3411;190465;33;0;0;0;0;.00nan;0;0
3411;77955;28;74;28;2;26;.929;3588000;0
3411;85437;28;0;0;0;0;.00nan;0;0
3411;86192;33;88;29;1;28;.966;3600000;0
3413;167642;18;0;0;0;0;.00nan;0;0
3413;173727;18;79;30;2;28;.933;3600000;0
3413;59540;15;43;20;4;16;.800;3513000;0
3413;71565;15;0;0;0;0;.00nan;0;0
3415;15;30;0;0;0;0;.00nan;0;0
3415;17043;30;68;29;3;26;.897;3600000;0
3415;168712;14;100;35;0;35;1.000;3600000;0
3415;175912;14;0;0;0;0;.00nan;0;0
3417;1593;4838;0;0;0;0;.00nan;0;0
3417;165582;24;0;0;0;0;.00nan;0;0
3417;168872;24;54;32;4;28;.875;3600000;0
3417;143749;4838;50;40;5;35;.875;3546000;0
3419;163695;9;83;26;2;24;.923;3600000;0
3419;183844;29;39;24;4;20;.833;3589000;0
3419;175092;9;0;0;0;0;.00nan;0;0
3419;37818;29;0;0;0;0;.00nan;0;0
3421;13714;8;41;29;5;24;.828;3600000;0
3421;178413;17;99;46;2;44;.957;3600000;0
3421;18213;8;0;0;0;0;.00nan;0;0
3421;146862;17;0;0;0;0;.00nan;0;0
3423;13337;32;71;37;3;34;.919;3600000;0
3423;20432;32;0;0;0;0;.00nan;0;0
3423;169868;4182;52;33;4;29;.879;3600000;0
3423;147945;4182;0;0;0;0;.00nan;0;0
3425;163195;0;55;36;4;32;.889;3600000;0
3425;170314;25;76;29;3;26;.897;3600000;0
3425;139409;0;0;0;0;0;.00nan;0;0
3425;148958;25;0;0;0;0;.00nan;0;0
3427;15;30;0;0;0;0;.00nan;0;0
3427;17043;30;85;36;2;34;.944;3600000;0
3427;175084;22;23;10;4;6;.600;1016000;0
3427;143473;22;52;21;2;19;.905;2584000;0
3429;67;11;0;0;0;0;.00nan;0;0
3429;190465;33;87;19;0;19;1.000;3600000;0
3429;46468;11;80;31;2;29;.935;3583000;0
3429;86192;33;0;0;0;0;.00nan;0;0
3431;187537;19;55;8;1;7;.875;363000;0
3431;163565;19;27;29;6;23;.793;3237000;0
3431;175660;21;61;16;2;14;.875;3600000;0
3431;143156;21;0;0;0;0;.00nan;0;0
3433;2059;23;0;0;0;0;.00nan;0;0
3433;163423;26;100;36;1;35;.972;3600000;0
3433;179154;26;0;0;0;0;.00nan;0;0
3433;78573;23;72;29;2;27;.931;3552000;0
3435;676;34;60;28;3;25;.893;3520000;0
3435;168712;14;77;25;1;24;.960;3600000;0
3435;175912;14;0;0;0;0;.00nan;0;0
3435;78806;34;0;0;0;0;.00nan;0;0
3437;779;5;0;0;0;0;.00nan;0;0
3437;166751;5;89;32;1;31;.969;3600000;0
3437;165582;24;57;20;2;18;.900;3544000;0
3437;168872;24;0;0;0;0;.00nan;0;0
3439;166591;20;70;26;2;24;.923;3540000;0
3439;77955;28;0;0;0;0;.00nan;0;0
3439;85437;28;100;40;0;40;1.000;3600000;0
3439;86697;20;0;0;0;0;.00nan;0;0
3441;172499;35;0;0;0;0;.00nan;0;0
3441;166381;27;0;0;0;0;.00nan;0;0
3441;170294;27;63;30;2;28;.933;3600000;0
3441;141998;35;91;28;1;27;.964;3600000;0
3443;1593;4838;0;0;0;0;.00nan;0;0
3443;187578;10;0;0;0;0;.00nan;0;0
3443;143749;4838;66;26;3;23;.885;3600000;0
3443;152717;10;72;32;4;28;.875;3543000;0
3445;556;3;0;0;0;0;.00nan;0;0
3445;167642;18;66;27;2;25;.926;3600000;0
3445;173727;18;0;0;0;0;.00nan;0;0
3445;179344;3;66;29;3;26;.897;3600000;0
3447;171838;31;0;0;0;0;.00nan;0;0
3447;170977;31;89;45;3;42;.933;3600000;0
3447;59540;15;46;23;4;19;.826;3600000;0
3447;71565;15;0;0;0;0;.00nan;0;0
3449;166646;16;67;27;3;24;.889;3525000;0
3449;3928;12;88;27;1;26;.963;3600000;0
3449;50065;16;0;0;0;0;.00nan;0;0
3449;85798;12;0;0;0;0;.00nan;0;0
3450;38124;58;80;18;1;17;.944;3600000;0
3450;75362;57;20;36;8;28;.778;3124000;0
3450;86862;57;71;12;0;12;1.000;476000;0
3450;149450;58;0;0;0;0;.00nan;0;0
3451;1593;4837;0;0;0;0;.00nan;0;0
3451;60773;47;0;0;0;0;.00nan;0;0
3451;79141;47;94;32;1;31;.969;3600000;0
3451;85546;4837;76;46;4;42;.913;3600000;0
3452;190106;46;91;28;1;27;.964;3900000;0
3452;176938;62;0;0;0;0;.00nan;0;0
3452;79280;46;0;0;0;0;.00nan;0;0
3452;152418;62;84;31;1;30;.968;3900000;0
3453;43731;37;0;0;0;0;.00nan;0;0
3453;79132;49;57;34;4;30;.882;3600000;0
3453;85453;37;54;19;2;17;.895;3600000;0
3453;91225;49;0;0;0;0;.00nan;0;0
3454;173699;36;96;42;3;39;.929;3900000;0
3454;176860;44;0;0;0;0;.00nan;0;0
3454;57434;36;0;0;0;0;.00nan;0;0
3454;86180;44;52;19;3;16;.842;3900000;0
3455;182780;60;0;0;0;0;.00nan;0;0
3455;172499;50;0;0;0;0;.00nan;0;0
3455;170294;60;56;28;4;24;.857;3600000;0
3455;76574;50;92;36;1;35;.972;3600000;0
3456;172340;48;90;37;2;35;.946;3600000;0
3456;174718;4619;43;27;5;22;.815;3600000;0
3456;191813;4619;0;0;0;0;.00nan;0;0
3456;142492;48;0;0;0;0;.00nan;0;0
3457;183783;52;85;42;4;38;.905;3900000;0
3457;175084;65;73;43;4;39;.907;3900000;0
3457;180316;52;0;0;0;0;.00nan;0;0
3457;38276;65;0;0;0;0;.00nan;0;0
3458;187578;53;76;26;1;25;.962;3600000;0
3458;163471;63;41;22;4;18;.818;3600000;0
3458;169323;53;0;0;0;0;.00nan;0;0
3458;192457;63;0;0;0;0;.00nan;0;0
3459;178384;40;72;35;3;32;.914;3600000;0
3459;176915;54;81;32;2;30;.938;3600000;0
3459;85636;40;0;0;0;0;.00nan;0;0
3459;94615;54;0;0;0;0;.00nan;0;0
3460;168872;64;0;0;0;0;.00nan;0;0
3460;179306;61;0;0;0;0;.00nan;0;0
3460;78581;61;52;23;3;20;.870;3600000;0
3460;141978;64;60;34;4;30;.882;3600000;0
3461;163462;55;70;19;1;18;.947;3600000;0
3461;188888;51;0;0;0;0;.00nan;0;0
3461;169154;51;70;37;3;34;.919;3600000;0
3461;170728;55;0;0;0;0;.00nan;0;0
3462;38124;58;0;0;0;0;.00nan;0;0
3462;75362;57;67;16;1;15;.938;3600000;0
3462;86862;57;0;0;0;0;.00nan;0;0
3462;149450;58;79;42;4;38;.905;3600000;0
3463;189644;42;25;21;5;16;.762;3600000;0
3463;171608;45;0;0;0;0;.00nan;0;0
3463;57695;42;0;0;0;0;.00nan;0;0
3463;85798;45;100;30;0;30;1.000;3600000;0
3464;190106;46;68;29;3;26;.897;3600000;0
3464;176938;62;0;0;0;0;.00nan;0;0
3464;79280;46;0;0;0;0;.00nan;0;0
3464;152418;62;59;33;4;29;.879;3545000;0
3465;4622;38;0;0;0;0;.00nan;0;0
3465;183904;43;52;24;3;21;.875;3600000;0
3465;178612;43;0;0;0;0;.00nan;0;0
3465;64722;38;63;40;4;36;.900;3572000;0
3466;43731;37;0;0;0;0;.00nan;0;0
3466;79132;49;83;34;2;32;.941;3600000;0
3466;85453;37;38;23;4;19;.826;3560000;0
3466;91225;49;0;0;0;0;.00nan;0;0
3467;173699;36;78;34;3;31;.912;3600000;0
3467;176860;44;0;0;0;0;.00nan;0;0
3467;57434;36;0;0;0;0;.00nan;0;0
3467;86180;44;68;39;4;35;.897;3560000;0
3468;187699;41;32;35;7;28;.800;3600000;0
3468;-1;41;0;0;0;0;.00nan;0;0
3468;58100;56;63;23;2;21;.913;3600000;0
3468;85468;56;0;0;0;0;.00nan;0;0
3469;178384;40;75;33;3;30;.909;3600000;0
3469;176915;54;48;42;6;36;.857;3600000;0
3469;85636;40;0;0;0;0;.00nan;0;0
3469;94615;54;0;0;0;0;.00nan;0;0
3470;3284;59;0;0;0;0;.00nan;0;0
3470;183783;52;47;30;5;25;.833;3579000;0
3470;176921;59;70;41;3;38;.927;3600000;0
3470;180316;52;0;0;0;0;.00nan;0;0
3471;187578;53;62;13;1;12;.923;3600000;0
3471;188888;51;0;0;0;0;.00nan;0;0
3471;169154;51;63;32;3;29;.906;3600000;0
3471;169323;53;0;0;0;0;.00nan;0;0
3472;168872;64;0;0;0;0;.00nan;0;0
3472;179306;61;0;0;0;0;.00nan;0;0
3472;78581;61;52;31;5;26;.839;3600000;0
3472;141978;64;56;31;4;27;.871;3600000;0
3473;163471;63;68;25;2;23;.920;3600000;0
3473;43928;39;0;0;0;0;.00nan;0;0
3473;192457;63;0;0;0;0;.00nan;0;0
3473;143301;39;55;41;5;36;.878;3600000;0
3474;4622;38;40;28;5;23;.821;3591000;0
3474;58100;56;67;37;4;33;.892;3600000;0
3474;64722;38;0;0;0;0;.00nan;0;0
3474;85468;56;0;0;0;0;.00nan;0;0
3475;187699;41;91;50;3;47;.940;3530000;0
3475;183904;43;61;13;1;12;.923;3600000;0
3475;178612;43;0;0;0;0;.00nan;0;0
3475;-1;41;0;0;0;0;.00nan;0;0
3476;182780;60;0;0;0;0;.00nan;0;0
3476;172499;50;0;0;0;0;.00nan;0;0
3476;170294;60;48;24;3;21;.875;3600000;0
3476;76574;50;43;27;4;23;.852;3588000;0
3477;172340;48;71;33;3;30;.909;3900000;0
3477;174718;4619;69;25;3;22;.880;3900000;0
3477;191813;4619;0;0;0;0;.00nan;0;0
3477;142492;48;0;0;0;0;.00nan;0;0
3478;3284;59;0;0;0;0;.00nan;0;0
3478;175084;65;46;35;6;29;.829;3600000;0
3478;176921;59;83;32;2;30;.938;3600000;0
3478;38276;65;0;0;0;0;.00nan;0;0
3479;163462;55;76;24;2;22;.917;3600000;0
3479;170728;55;0;0;0;0;.00nan;0;0
3479;43928;39;0;0;0;0;.00nan;0;0
3479;143301;39;57;33;4;29;.879;3576000;0
3480;168872;64;0;0;0;0;.00nan;0;0
3480;171608;45;0;0;0;0;.00nan;0;0
3480;85798;45;77;21;1;20;.952;3600000;0
3480;141978;64;45;34;6;28;.824;3600000;0
3481;163471;63;50;15;2;13;.867;3600000;0
3481;173699;36;28;8;3;5;.625;561000;0
3481;192457;63;0;0;0;0;.00nan;0;0
3481;57434;36;97;30;0;30;1.000;3039000;0
3482;187578;53;59;19;2;17;.895;3900000;0
3482;169323;53;0;0;0;0;.00nan;0;0
3482;175084;65;78;34;2;32;.941;3877000;0
3482;38276;65;0;0;0;0;.00nan;0;0
3483;182780;60;0;0;0;0;.00nan;0;0
3483;170294;60;42;39;6;33;.846;3600000;0
3483;176860;44;69;24;2;22;.917;3600000;0
3483;86180;44;0;0;0;0;.00nan;0;0
3484;188888;51;0;0;0;0;.00nan;0;0
3484;169154;51;84;39;3;36;.923;3600000;0
3484;58100;56;89;17;0;17;1.000;3600000;0
3484;85468;56;0;0;0;0;.00nan;0;0
3485;190106;46;79;38;3;35;.921;3651000;0
3485;176938;62;67;23;2;21;.913;3651000;0
3485;79280;46;0;0;0;0;.00nan;0;0
3485;152418;62;0;0;0;0;.00nan;0;0
3486;183783;52;67;38;4;34;.895;3600000;0
3486;180316;52;0;0;0;0;.00nan;0;0
3486;38124;58;0;0;0;0;.00nan;0;0
3486;149450;58;100;30;0;30;1.000;3600000;0
3487;178384;40;47;13;2;11;.846;3600000;0
3487;79132;49;0;0;0;0;.00nan;0;0
3487;85636;40;0;0;0;0;.00nan;0;0
3487;91225;49;67;34;3;31;.912;3600000;0
3488;163471;63;55;30;4;26;.867;3600000;0
3488;173699;36;100;26;0;26;1.000;3600000;0
3488;192457;63;0;0;0;0;.00nan;0;0
3488;57434;36;0;0;0;0;.00nan;0;0
3489;172499;50;0;0;0;0;.00nan;0;0
3489;43731;37;0;0;0;0;.00nan;0;0
3489;76574;50;100;47;2;45;.957;3600000;0
3489;85453;37;40;20;4;16;.800;3568000;0
3490;4622;38;83;39;2;37;.949;3600000;0
3490;175084;65;0;0;0;0;.00nan;0;0
3490;38276;65;67;28;3;25;.893;3543000;0
3490;64722;38;0;0;0;0;.00nan;0;0
3491;172340;48;57;26;3;23;.885;3579000;0
3491;174718;4619;100;27;0;27;1.000;3600000;0
3491;191813;4619;0;0;0;0;.00nan;0;0
3491;142492;48;0;0;0;0;.00nan;0;0
3492;187699;41;84;42;2;40;.952;3600000;0
3492;3284;59;28;22;6;16;.727;3600000;0
3492;-1;41;0;0;0;0;.00nan;0;0
3492;176921;59;0;0;0;0;.00nan;0;0
3493;182780;60;80;57;3;54;.947;3600000;0
3493;170294;60;0;0;0;0;.00nan;0;0
3493;176860;44;0;0;0;0;.00nan;0;0
3493;86180;44;56;14;2;12;.857;3600000;0
3494;1593;4837;0;0;0;0;.00nan;0;0
3494;172340;48;0;0;0;0;.00nan;0;0
3494;85546;4837;64;22;2;20;.909;3600000;0
3494;142492;48;43;21;3;18;.857;3600000;0
3495;183904;43;92;27;1;26;.963;3900000;0
3495;178612;43;0;0;0;0;.00nan;0;0
3495;173699;36;0;0;0;0;.00nan;0;0
3495;57434;36;96;38;1;37;.974;3900000;0
3496;187578;53;0;0;0;0;.00nan;0;0
3496;163462;55;78;32;2;30;.938;3570000;0
3496;169323;53;82;26;1;25;.962;3600000;0
3496;170728;55;0;0;0;0;.00nan;0;0
3497;188888;51;68;29;3;26;.897;3900000;0
3497;169154;51;0;0;0;0;.00nan;0;0
3497;58100;56;90;44;3;41;.932;3900000;0
3497;85468;56;0;0;0;0;.00nan;0;0
3498;190106;46;0;0;0;0;.00nan;0;0
3498;176938;62;0;0;0;0;.00nan;0;0
3498;79280;46;65;21;2;19;.905;3900000;0
3498;152418;62;100;44;2;42;.955;3900000;0
3499;187699;41;0;0;0;0;.00nan;0;0
3499;183783;52;0;0;0;0;.00nan;0;0
3499;-1;41;88;47;4;43;.915;3598000;0
3499;180316;52;45;20;3;17;.850;3600000;0
3500;178384;40;0;0;0;0;.00nan;0;0
3500;79132;49;73;42;3;39;.929;3600000;0
3500;85636;40;63;20;2;18;.900;3600000;0
3500;91225;49;0;0;0;0;.00nan;0;0
3501;172499;50;0;0;0;0;.00nan;0;0
3501;43731;37;85;38;2;36;.947;3600000;0
3501;76574;50;65;37;4;33;.892;3548000;0
3501;85453;37;0;0;0;0;.00nan;0;0
3502;168872;64;42;23;4;19;.826;952000;0
3502;189644;42;58;30;4;26;.867;3600000;0
3502;57695;42;0;0;0;0;.00nan;0;0
3502;141978;64;51;41;6;35;.854;2648000;0
3503;4622;38;45;32;4;28;.875;3589000;0
3503;175084;65;53;17;2;15;.882;3600000;0
3503;38276;65;0;0;0;0;.00nan;0;0
3503;64722;38;0;0;0;0;.00nan;0;0
3504;171608;45;0;0;0;0;.00nan;0;0
3504;176915;54;91;29;1;28;.966;2687000;0
3504;85798;45;77;19;1;18;.947;3600000;0
3504;94615;54;20;10;4;6;.600;913000;0
3505;43928;39;0;0;0;0;.00nan;0;0
3505;75362;57;100;52;0;52;1.000;3600000;0
3505;86862;57;0;0;0;0;.00nan;0;0
3505;143301;39;85;31;2;29;.935;3594000;0
3506;179306;61;0;0;0;0;.00nan;0;0
3506;78479;47;52;23;3;20;.870;3578000;0
3506;78581;61;87;31;1;30;.968;3600000;0
3506;79141;47;0;0;0;0;.00nan;0;0
3507;3284;59;0;0;0;0;.00nan;0;0
3507;176921;59;40;22;4;18;.818;3600000;0
3507;38124;58;0;0;0;0;.00nan;0;0
3507;149450;58;60;49;6;43;.878;3586000;0
3508;187578;53;61;28;3;25;.893;3600000;0
3508;4622;38;0;0;0;0;.00nan;0;0
3508;169323;53;0;0;0;0;.00nan;0;0
3508;64722;38;79;45;4;41;.911;3569000;0
3509;168872;64;83;34;2;32;.941;3591000;0
3509;171608;45;93;31;1;30;.968;3600000;0
3509;85798;45;0;0;0;0;.00nan;0;0
3509;141978;64;0;0;0;0;.00nan;0;0
3510;187699;41;88;47;4;43;.915;3595000;0
3510;3284;59;57;16;2;14;.875;3600000;0
3510;-1;41;0;0;0;0;.00nan;0;0
3510;176921;59;0;0;0;0;.00nan;0;0
3511;43928;39;70;32;3;29;.906;3600000;0
3511;75362;57;64;33;4;29;.879;3600000;0
3511;86862;57;0;0;0;0;.00nan;0;0
3511;143301;39;0;0;0;0;.00nan;0;0
3512;176860;44;0;0;0;0;.00nan;0;0
3512;176938;62;78;27;2;25;.926;3900000;0
3512;86180;44;60;25;2;23;.920;3900000;0
3512;152418;62;0;0;0;0;.00nan;0;0
3513;1593;4837;0;0;0;0;.00nan;0;0
3513;79132;49;77;39;3;36;.923;3600000;0
3513;85546;4837;98;22;0;22;1.000;3600000;0
3513;91225;49;0;0;0;0;.00nan;0;0
3514;189644;42;99;45;1;44;.978;3793000;0
3514;43928;39;0;0;0;0;.00nan;0;0
3514;57695;42;0;0;0;0;.00nan;0;0
3514;143301;39;75;30;2;28;.933;3793000;0
3515;179306;61;0;0;0;0;.00nan;0;0
3515;174718;4619;83;35;2;33;.943;3600000;0
3515;191813;4619;0;0;0;0;.00nan;0;0
3515;78581;61;75;33;3;30;.909;3555000;0
3516;176860;44;91;30;2;28;.933;3900000;0
3516;176938;62;0;0;0;0;.00nan;0;0
3516;86180;44;0;0;0;0;.00nan;0;0
3516;152418;62;65;24;2;22;.917;3900000;0
3517;183904;43;61;23;2;21;.913;3690000;0
3517;178612;43;0;0;0;0;.00nan;0;0
3517;189644;42;86;42;3;39;.929;3690000;0
3517;57695;42;0;0;0;0;.00nan;0;0
3518;172340;48;99;40;2;38;.950;3600000;0
3518;78479;47;45;28;4;24;.857;3587000;0
3518;79141;47;0;0;0;0;.00nan;0;0
3518;142492;48;0;0;0;0;.00nan;0;0
3519;171608;45;0;0;0;0;.00nan;0;0
3519;43731;37;0;0;0;0;.00nan;0;0
3519;85453;37;67;25;2;23;.920;3858000;0
3519;85798;45;96;42;1;41;.976;3858000;0
3520;163471;63;58;28;3;25;.893;3825000;0
3520;192457;63;0;0;0;0;.00nan;0;0
3520;75362;57;67;40;4;36;.900;3825000;0
3520;86862;57;0;0;0;0;.00nan;0;0
3521;178384;40;100;35;0;35;1.000;3600000;0
3521;79132;49;0;0;0;0;.00nan;0;0
3521;85636;40;0;0;0;0;.00nan;0;0
3521;91225;49;64;40;5;35;.875;3600000;0
3522;4622;38;73;16;1;15;.938;3600000;0
3522;38124;58;76;44;4;40;.909;3600000;0
3522;64722;38;0;0;0;0;.00nan;0;0
3522;149450;58;0;0;0;0;.00nan;0;0
3523;183904;43;100;27;0;27;1.000;3600000;0
3523;178612;43;0;0;0;0;.00nan;0;0
3523;43928;39;0;0;0;0;.00nan;0;0
3523;143301;39;52;17;2;15;.882;3578000;0
3524;187578;53;77;34;2;32;.941;3600000;0
3524;169323;53;0;0;0;0;.00nan;0;0
3524;75362;57;0;0;0;0;.00nan;0;0
3524;86862;57;42;23;4;19;.826;3600000;0
3525;190106;46;73;19;1;18;.947;3600000;0
3525;58100;56;89;36;3;33;.917;3576000;0
3525;79280;46;0;0;0;0;.00nan;0;0
3525;85468;56;0;0;0;0;.00nan;0;0
3526;3284;59;0;0;0;0;.00nan;0;0
3526;183783;52;67;42;5;37;.881;3600000;0
3526;176921;59;87;29;1;28;.966;3600000;0
3526;180316;52;0;0;0;0;.00nan;0;0
3527;172340;48;100;25;0;25;1.000;3900000;0
3527;79132;49;97;38;0;38;1.000;3900000;0
3527;91225;49;0;0;0;0;.00nan;0;0
3527;142492;48;0;0;0;0;.00nan;0;0
3528;163471;63;22;10;4;6;.600;1198000;0
3528;173699;36;86;37;3;34;.919;3600000;0
3528;192457;63;51;9;1;8;.889;2362000;0
3528;57434;36;0;0;0;0;.00nan;0;0
3529;176915;54;100;42;0;42;1.000;3600000;0
3529;43731;37;0;0;0;0;.00nan;0;0
3529;85453;37;59;32;4;28;.875;3600000;0
3529;94615;54;0;0;0;0;.00nan;0;0
3530;174718;4619;100;37;1;36;.973;3600000;0
3530;176860;44;0;0;0;0;.00nan;0;0
3530;191813;4619;0;0;0;0;.00nan;0;0
3530;86180;44;61;31;4;27;.871;3600000;0
3531;163462;55;45;17;3;14;.824;3600000;0
3531;188888;51;0;0;0;0;.00nan;0;0
3531;169154;51;71;38;4;34;.895;3565000;0
3531;170728;55;0;0;0;0;.00nan;0;0
3532;172499;50;0;0;0;0;.00nan;0;0
3532;168872;64;100;25;0;25;1.000;3600000;0
3532;76574;50;67;29;2;27;.931;3521000;0
3532;141978;64;0;0;0;0;.00nan;0;0
3533;1593;4837;0;0;0;0;.00nan;0;0
3533;179306;61;0;0;0;0;.00nan;0;0
3533;78581;61;64;24;2;22;.917;3600000;0
3533;85546;4837;76;42;4;38;.905;3600000;0
3534;183904;43;71;26;2;24;.923;3600000;0
3534;178612;43;0;0;0;0;.00nan;0;0
3534;43928;39;0;0;0;0;.00nan;0;0
3534;143301;39;81;42;4;38;.905;3600000;0
3535;182780;60;0;0;0;0;.00nan;0;0
3535;170294;60;100;36;0;36;1.000;3600000;0
3535;176938;62;73;25;2;23;.920;3531000;0
3535;152418;62;0;0;0;0;.00nan;0;0
3536;187578;53;74;28;2;26;.929;3570000;0
3536;169323;53;0;0;0;0;.00nan;0;0
3536;75362;57;100;38;1;37;.974;3600000;0
3536;86862;57;0;0;0;0;.00nan;0;0
3537;171608;45;0;0;0;0;.00nan;0;0
3537;58100;56;67;40;4;36;.900;3590000;0
3537;85468;56;0;0;0;0;.00nan;0;0
3537;85798;45;83;41;3;38;.927;3600000;0
3538;187699;41;66;26;2;24;.923;3600000;0
3538;4622;38;0;0;0;0;.00nan;0;0
3538;-1;41;0;0;0;0;.00nan;0;0
3538;64722;38;57;27;3;24;.889;3563000;0
3539;189644;42;0;0;0;0;.00nan;0;0
3539;43731;37;78;35;3;32;.914;3600000;0
3539;57695;42;63;20;2;18;.900;3600000;0
3539;85453;37;0;0;0;0;.00nan;0;0
3540;190106;46;78;30;2;28;.933;3600000;0
3540;176915;54;69;48;5;43;.896;3600000;0
3540;79280;46;0;0;0;0;.00nan;0;0
3540;94615;54;0;0;0;0;.00nan;0;0
3541;178384;40;97;42;2;40;.952;3900000;0
3541;78479;47;81;27;2;25;.926;3900000;0
3541;79141;47;0;0;0;0;.00nan;0;0
3541;85636;40;0;0;0;0;.00nan;0;0
3542;3284;59;100;31;0;31;1.000;3600000;0
3542;175084;65;0;0;0;0;.00nan;0;0
3542;176921;59;0;0;0;0;.00nan;0;0
3542;77084;65;57;36;4;32;.889;3600000;0
3543;188888;51;71;35;3;32;.914;3598000;0
3543;169154;51;0;0;0;0;.00nan;0;0
3543;173699;36;0;0;0;0;.00nan;0;0
3543;57434;36;74;23;1;22;.957;3600000;0
3544;172499;50;0;0;0;0;.00nan;0;0
3544;168872;64;69;27;2;25;.926;3600000;0
3544;76574;50;62;38;5;33;.868;3600000;0
3544;141978;64;0;0;0;0;.00nan;0;0
3545;1593;4837;0;0;0;0;.00nan;0;0
3545;179306;61;59;30;3;27;.900;3522000;0
3545;78581;61;0;0;0;0;.00nan;0;0
3545;85546;4837;94;26;1;25;.962;3600000;0
3546;163462;55;0;0;0;0;.00nan;0;0
3546;163471;63;58;29;4;25;.862;3600000;0
3546;170728;55;47;36;5;31;.861;3549000;0
3546;192457;63;0;0;0;0;.00nan;0;0
3547;183783;52;0;0;0;0;.00nan;0;0
3547;180316;52;99;40;1;39;.975;3857000;0
3547;38124;58;0;0;0;0;.00nan;0;0
3547;149450;58;94;41;2;39;.951;3857000;0
3548;182780;60;0;0;0;0;.00nan;0;0
3548;170294;60;69;27;2;25;.926;3545000;0
3548;176938;62;0;0;0;0;.00nan;0;0
3548;152418;62;100;24;0;24;1.000;3600000;0
3549;174718;4619;38;16;3;13;.813;3519000;0
3549;191813;4619;0;0;0;0;.00nan;0;0
3549;79132;49;99;46;1;45;.978;3600000;0
3549;91225;49;0;0;0;0;.00nan;0;0
3550;4622;38;92;22;1;21;.955;3600000;0
3550;38124;58;77;35;2;33;.943;3600000;0
3550;64722;38;0;0;0;0;.00nan;0;0
3550;149450;58;0;0;0;0;.00nan;0;0
3551;187699;41;0;0;0;0;.00nan;0;0
3551;183783;52;0;0;0;0;.00nan;0;0
3551;-1;41;97;41;1;40;.976;3900000;0
3551;180316;52;74;19;1;18;.947;3900000;0
3552;172340;48;74;34;3;31;.912;3600000;0
3552;176860;44;0;0;0;0;.00nan;0;0
3552;86180;44;93;43;2;41;.953;3600000;0
3552;142492;48;0;0;0;0;.00nan;0;0
3553;3284;59;0;0;0;0;.00nan;0;0
3553;175084;65;0;0;0;0;.00nan;0;0
3553;176921;59;69;32;3;29;.906;3900000;0
3553;77084;65;99;47;3;44;.936;3900000;0
3554;178384;40;0;0;0;0;.00nan;0;0
3554;78479;47;0;0;0;0;.00nan;0;0
3554;79141;47;82;26;1;25;.962;3600000;0
3554;85636;40;61;37;4;33;.892;3600000;0
3555;176860;44;60;41;5;36;.878;3580000;0
3555;78479;47;74;29;3;26;.897;3600000;0
3555;79141;47;0;0;0;0;.00nan;0;0
3555;86180;44;0;0;0;0;.00nan;0;0
3556;190106;46;70;16;1;15;.938;3600000;0
3556;58100;56;0;0;0;0;.00nan;0;0
3556;79280;46;0;0;0;0;.00nan;0;0
3556;85468;56;67;46;4;42;.913;3600000;0
3557;163462;55;55;27;4;23;.852;3625000;0
3557;173699;36;66;42;5;37;.881;3625000;0
3557;170728;55;0;0;0;0;.00nan;0;0
3557;57434;36;0;0;0;0;.00nan;0;0
3558;163471;63;66;13;1;12;.923;3600000;0
3558;188888;51;0;0;0;0;.00nan;0;0
3558;169154;51;90;47;3;44;.936;3590000;0
3558;192457;63;0;0;0;0;.00nan;0;0
3559;175084;65;0;0;0;0;.00nan;0;0
3559;38124;58;0;0;0;0;.00nan;0;0
3559;77084;65;50;18;3;15;.833;3600000;0
3559;149450;58;100;60;2;58;.967;3600000;0
3560;189644;42;50;19;3;16;.842;3543000;0
3560;43731;37;0;0;0;0;.00nan;0;0
3560;57695;42;0;0;0;0;.00nan;0;0
3560;85453;37;79;26;1;25;.962;3600000;0
3561;176860;44;0;0;0;0;.00nan;0;0
3561;79132;49;36;31;6;25;.806;3600000;0
3561;86180;44;62;25;2;23;.920;3600000;0
3561;91225;49;0;0;0;0;.00nan;0;0
3562;182780;60;0;0;0;0;.00nan;0;0
3562;178384;40;71;35;4;31;.886;3600000;0
3562;170294;60;50;42;6;36;.857;3538000;0
3562;85636;40;0;0;0;0;.00nan;0;0
3563;174718;4619;43;49;7;42;.857;3600000;0
3563;191813;4619;0;0;0;0;.00nan;0;0
3563;75362;57;86;31;1;30;.968;3600000;0
3563;86862;57;0;0;0;0;.00nan;0;0
3564;175084;65;0;0;0;0;.00nan;0;0
3564;58100;56;79;38;3;35;.921;3600000;0
3564;77084;65;72;20;1;19;.950;3600000;0
3564;85468;56;0;0;0;0;.00nan;0;0
3565;172340;48;66;35;3;32;.914;3589000;0
3565;176938;62;0;0;0;0;.00nan;0;0
3565;142492;48;0;0;0;0;.00nan;0;0
3565;152418;62;54;19;2;17;.895;3600000;0
3566;173699;36;92;36;2;34;.944;3600000;0
3566;43928;39;0;0;0;0;.00nan;0;0
3566;57434;36;0;0;0;0;.00nan;0;0
3566;143301;39;78;41;3;38;.927;3543000;0
3567;187699;41;91;41;2;39;.951;3597000;0
3567;183783;52;73;20;1;19;.950;3600000;0
3567;-1;41;0;0;0;0;.00nan;0;0
3567;180316;52;0;0;0;0;.00nan;0;0
3568;163462;55;60;23;2;21;.913;3600000;0
3568;163471;63;66;37;4;33;.892;3515000;0
3568;170728;55;0;0;0;0;.00nan;0;0
3568;192457;63;0;0;0;0;.00nan;0;0
3569;3284;59;67;33;3;30;.909;3600000;0
3569;183904;43;23;26;6;20;.769;2207000;0
3569;178612;43;67;10;0;10;1.000;1393000;0
3569;176921;59;0;0;0;0;.00nan;0;0
3570;171608;45;0;0;0;0;.00nan;0;0
3570;179306;61;0;0;0;0;.00nan;0;0
3570;78581;61;68;24;2;22;.917;3900000;0
3570;85798;45;92;45;2;43;.956;3900000;0
3571;4622;38;79;39;2;37;.949;3600000;0
3571;38124;58;99;25;0;25;1.000;3600000;0
3571;64722;38;0;0;0;0;.00nan;0;0
3571;149450;58;0;0;0;0;.00nan;0;0
3572;176860;44;74;17;1;16;.941;3600000;0
3572;79132;49;0;0;0;0;.00nan;0;0
3572;86180;44;0;0;0;0;.00nan;0;0
3572;91225;49;66;43;5;38;.884;3600000;0
3573;1593;4837;0;0;0;0;.00nan;0;0
3573;78479;47;55;29;4;25;.862;3600000;0
3573;79141;47;0;0;0;0;.00nan;0;0
3573;85546;4837;100;32;0;32;1.000;3600000;0
3574;174718;4619;50;1;0;1;1.000;381000;0
3574;191813;4619;26;22;6;16;.727;3219000;0
3574;75362;57;0;0;0;0;.00nan;0;0
3574;86862;57;95;39;3;36;.923;3600000;0
3575;175084;65;0;0;0;0;.00nan;0;0
3575;58100;56;0;0;0;0;.00nan;0;0
3575;77084;65;46;33;5;28;.848;3600000;0
3575;85468;56;52;23;3;20;.870;3600000;0
3576;172340;48;0;0;0;0;.00nan;0;0
3576;176938;62;73;26;1;25;.962;3600000;0
3576;142492;48;48;35;6;29;.829;3600000;0
3576;152418;62;0;0;0;0;.00nan;0;0
3577;187578;53;95;27;0;27;1.000;3600000;0
3577;4622;38;0;0;0;0;.00nan;0;0
3577;169323;53;0;0;0;0;.00nan;0;0
3577;64722;38;40;28;5;23;.821;3600000;0
3578;168872;64;0;0;0;0;.00nan;0;0
3578;43731;37;99;30;1;29;.967;3600000;0
3578;85453;37;0;0;0;0;.00nan;0;0
3578;141978;64;89;48;2;46;.958;3571000;0
3579;173699;36;99;38;1;37;.974;3600000;0
3579;43928;39;0;0;0;0;.00nan;0;0
3579;57434;36;0;0;0;0;.00nan;0;0
3579;143301;39;42;22;4;18;.818;3600000;0
3580;172499;50;0;0;0;0;.00nan;0;0
3580;176915;54;67;30;3;27;.900;3600000;0
3580;76574;50;38;35;6;29;.829;3556000;0
3580;94615;54;0;0;0;0;.00nan;0;0
3581;189644;42;89;33;3;30;.909;3600000;0
3581;190106;46;81;28;1;27;.964;3600000;0
3581;57695;42;0;0;0;0;.00nan;0;0
3581;79280;46;0;0;0;0;.00nan;0;0
3582;187699;41;0;0;0;0;.00nan;0;0
3582;3284;59;0;0;0;0;.00nan;0;0
3582;-1;41;75;50;5;45;.900;3600000;0
3582;176921;59;62;10;1;9;.900;3600000;0
3583;163471;63;73;21;2;19;.905;3600000;0
3583;188888;51;0;0;0;0;.00nan;0;0
3583;169154;51;83;46;3;43;.935;3600000;0
3583;192457;63;0;0;0;0;.00nan;0;0
3584;171608;45;0;0;0;0;.00nan;0;0
3584;179306;61;81;27;1;26;.963;3600000;0
3584;78581;61;0;0;0;0;.00nan;0;0
3584;85798;45;70;34;3;31;.912;3519000;0
3585;163462;55;0;0;0;0;.00nan;0;0
3585;183783;52;0;0;0;0;.00nan;0;0
3585;170728;55;94;31;1;30;.968;3600000;0
3585;180316;52;79;33;2;31;.939;3568000;0
3586;183904;43;56;18;2;16;.889;3552000;0
3586;178612;43;0;0;0;0;.00nan;0;0
3586;38124;58;100;46;1;45;.978;3600000;0
3586;149450;58;0;0;0;0;.00nan;0;0
3587;187578;53;100;23;0;23;1.000;3600000;0
3587;3284;59;79;43;4;39;.907;3600000;0
3587;169323;53;0;0;0;0;.00nan;0;0
3587;176921;59;0;0;0;0;.00nan;0;0
3588;182780;60;0;0;0;0;.00nan;0;0
3588;178384;40;76;39;4;35;.897;3900000;0
3588;170294;60;48;30;4;26;.867;3900000;0
3588;85636;40;0;0;0;0;.00nan;0;0
3589;168872;64;53;42;5;37;.881;3600000;0
3589;43731;37;0;0;0;0;.00nan;0;0
3589;85453;37;65;15;1;14;.933;3600000;0
3589;141978;64;0;0;0;0;.00nan;0;0
3590;172499;50;20;29;7;22;.759;3025000;0
3590;176915;54;0;0;0;0;.00nan;0;0
3590;76574;50;55;8;1;7;.875;575000;0
3590;94615;54;62;47;6;41;.872;3600000;0
3591;176938;62;0;0;0;0;.00nan;0;0
3591;79132;49;47;44;7;37;.841;3600000;0
3591;91225;49;0;0;0;0;.00nan;0;0
3591;152418;62;54;11;1;10;.909;3600000;0
3592;188888;51;0;0;0;0;.00nan;0;0
3592;183904;43;0;0;0;0;.00nan;0;0
3592;178612;43;26;16;4;12;.750;3721000;0
3592;169154;51;88;54;5;49;.907;3721000;0
3593;174718;4619;98;53;3;50;.943;3563000;0
3593;191813;4619;0;0;0;0;.00nan;0;0
3593;78479;47;86;27;2;25;.926;3600000;0
3593;79141;47;0;0;0;0;.00nan;0;0
3594;176938;62;52;13;2;11;.846;3600000;0
3594;79132;49;38;15;3;12;.800;1223000;0
3594;91225;49;31;41;7;34;.829;2377000;0
3594;152418;62;0;0;0;0;.00nan;0;0
3595;189644;42;70;26;3;23;.885;3568000;0
3595;43928;39;0;0;0;0;.00nan;0;0
3595;57695;42;0;0;0;0;.00nan;0;0
3595;143301;39;91;39;2;37;.949;3600000;0
3596;172340;48;88;31;1;30;.968;3600000;0
3596;179306;61;0;0;0;0;.00nan;0;0
3596;78581;61;73;27;2;25;.926;3565000;0
3596;142492;48;0;0;0;0;.00nan;0;0
3597;168872;64;0;0;0;0;.00nan;0;0
3597;176915;54;79;34;3;31;.912;3600000;0
3597;94615;54;0;0;0;0;.00nan;0;0
3597;141978;64;57;33;4;29;.879;3600000;0
3598;187699;41;69;51;6;45;.882;3600000;0
3598;3284;59;0;0;0;0;.00nan;0;0
3598;-1;41;0;0;0;0;.00nan;0;0
3598;176921;59;73;19;1;18;.947;3600000;0
3599;1593;4837;0;0;0;0;.00nan;0;0
3599;176860;44;0;0;0;0;.00nan;0;0
3599;85546;4837;53;28;5;23;.821;3600000;0
3599;86180;44;77;30;2;28;.933;3600000;0
3600;183904;43;66;22;2;20;.909;3600000;0
3600;178612;43;0;0;0;0;.00nan;0;0
3600;58100;56;89;47;3;44;.936;3550000;0
3600;85468;56;0;0;0;0;.00nan;0;0
3601;187578;53;88;32;2;30;.938;3600000;0
3601;183783;52;46;23;3;20;.870;3543000;0
3601;169323;53;0;0;0;0;.00nan;0;0
3601;180316;52;0;0;0;0;.00nan;0;0
3602;190106;46;30;16;4;12;.750;2268000;0
3602;43928;39;43;4;1;3;.750;627000;0
3602;79280;46;52;8;1;7;.875;1332000;0
3602;143301;39;37;34;6;28;.824;2906000;0
3603;172340;48;75;32;2;30;.938;3600000;0
3603;179306;61;0;0;0;0;.00nan;0;0
3603;78581;61;52;26;3;23;.885;3555000;0
3603;142492;48;0;0;0;0;.00nan;0;0
3604;3284;59;0;0;0;0;.00nan;0;0
3604;175084;65;0;0;0;0;.00nan;0;0
3604;176921;59;51;20;3;17;.850;3600000;0
3604;77084;65;67;38;4;34;.895;3600000;0
3605;163462;55;80;31;2;29;.935;3600000;0
3605;163471;63;0;0;0;0;.00nan;0;0
3605;170728;55;0;0;0;0;.00nan;0;0
3605;192457;63;68;36;4;32;.889;3594000;0
3606;176915;54;99;49;2;47;.959;3600000;0
3606;43731;37;34;22;5;17;.773;3600000;0
3606;85453;37;0;0;0;0;.00nan;0;0
3606;94615;54;0;0;0;0;.00nan;0;0
3607;182780;60;0;0;0;0;.00nan;0;0
3607;170294;60;62;38;5;33;.868;3681000;0
3607;174718;4619;56;31;4;27;.871;3681000;0
3607;191813;4619;0;0;0;0;.00nan;0;0
3608;178384;40;100;31;0;31;1.000;3600000;0
3608;75362;57;65;30;3;27;.900;3600000;0
3608;85636;40;0;0;0;0;.00nan;0;0
3608;86862;57;0;0;0;0;.00nan;0;0
3609;188888;51;65;39;5;34;.872;3600000;0
3609;169154;51;0;0;0;0;.00nan;0;0
3609;38124;58;40;19;4;15;.789;3600000;0
3609;149450;58;0;0;0;0;.00nan;0;0
3610;168872;64;100;31;0;31;1.000;3600000;0
3610;189644;42;59;23;2;21;.913;3540000;0
3610;57695;42;0;0;0;0;.00nan;0;0
3610;141978;64;0;0;0;0;.00nan;0;0
3611;1593;4837;0;0;0;0;.00nan;0;0
3611;176860;44;77;49;5;44;.898;3542000;0
3611;85546;4837;59;25;3;22;.880;3600000;0
3611;86180;44;0;0;0;0;.00nan;0;0
3612;187578;53;0;0;0;0;.00nan;0;0
3612;3284;59;90;36;2;34;.944;3600000;0
3612;169323;53;57;30;3;27;.900;3546000;0
3612;176921;59;0;0;0;0;.00nan;0;0
3613;171608;45;0;0;0;0;.00nan;0;0
3613;43731;37;0;0;0;0;.00nan;0;0
3613;85453;37;64;19;1;18;.947;3600000;0
3613;85798;45;62;35;4;31;.886;3600000;0
3614;182780;60;0;0;0;0;.00nan;0;0
3614;170294;60;62;39;5;34;.872;3600000;0
3614;78479;47;0;0;0;0;.00nan;0;0
3614;79141;47;45;12;2;10;.833;3600000;0
3615;190106;46;82;27;1;26;.963;3600000;0
3615;43928;39;0;0;0;0;.00nan;0;0
3615;79280;46;0;0;0;0;.00nan;0;0
3615;143301;39;74;33;2;31;.939;3581000;0
3616;183783;52;46;14;2;12;.857;1649000;0
3616;175084;65;87;32;2;30;.938;3600000;0
3616;180316;52;16;21;6;15;.714;1951000;0
3616;77084;65;0;0;0;0;.00nan;0;0
3617;187699;41;98;44;2;42;.955;3565000;0
3617;4622;38;90;31;1;30;.968;3600000;0
3617;-1;41;0;0;0;0;.00nan;0;0
3617;64722;38;0;0;0;0;.00nan;0;0
3618;174718;4619;0;0;0;0;.00nan;0;0
3618;176938;62;0;0;0;0;.00nan;0;0
3618;191813;4619;83;30;1;29;.967;3866000;0
3618;152418;62;87;30;2;28;.933;3866000;0
3619;168872;64;0;0;0;0;.00nan;0;0
3619;189644;42;0;0;0;0;.00nan;0;0
3619;57695;42;75;23;1;22;.957;3600000;0
3619;141978;64;65;59;7;52;.881;3600000;0
3620;163462;55;0;0;0;0;.00nan;0;0
3620;163471;63;40;29;5;24;.828;3544000;0
3620;170728;55;96;52;3;49;.942;3600000;0
3620;192457;63;0;0;0;0;.00nan;0;0
3621;188888;51;0;0;0;0;.00nan;0;0
3621;169154;51;86;33;1;32;.970;3600000;0
3621;38124;58;0;0;0;0;.00nan;0;0
3621;149450;58;32;29;6;23;.793;3600000;0
3622;183904;43;76;23;1;22;.957;3600000;0
3622;178612;43;0;0;0;0;.00nan;0;0
3622;58100;56;19;8;4;4;.500;772000;0
3622;85468;56;84;32;1;31;.969;2828000;0
3623;171608;45;0;0;0;0;.00nan;0;0
3623;176915;54;90;30;1;29;.967;3600000;0
3623;85798;45;48;35;5;30;.857;3600000;0
3623;94615;54;0;0;0;0;.00nan;0;0
3624;179306;61;0;0;0;0;.00nan;0;0
3624;78479;47;72;25;2;23;.920;3600000;0
3624;78581;61;69;28;3;25;.893;3600000;0
3624;79141;47;0;0;0;0;.00nan;0;0
3625;187699;41;44;27;4;23;.852;2446000;0
3625;4622;38;0;0;0;0;.00nan;0;0
3625;-1;41;20;9;4;5;.556;1154000;0
3625;64722;38;84;21;1;20;.952;3600000;0
3626;172499;50;0;0;0;0;.00nan;0;0
3626;173699;36;47;25;4;21;.840;3888000;0
3626;57434;36;0;0;0;0;.00nan;0;0
3626;76574;50;57;39;5;34;.872;3888000;0
3627;172340;48;0;0;0;0;.00nan;0;0
3627;176938;62;74;23;2;21;.913;3600000;0
3627;142492;48;49;29;4;25;.862;3567000;0
3627;152418;62;0;0;0;0;.00nan;0;0
3628;183783;52;30;21;5;16;.762;1569000;0
3628;175084;65;0;0;0;0;.00nan;0;0
3628;180316;52;58;28;3;25;.893;2031000;0
3628;77084;65;75;19;1;18;.947;3600000;0
3629;178384;40;79;30;2;28;.933;3567000;0
3629;75362;57;0;0;0;0;.00nan;0;0
3629;85636;40;0;0;0;0;.00nan;0;0
3629;86862;57;97;33;1;32;.970;3600000;0
3630;172499;50;0;0;0;0;.00nan;0;0
3630;173699;36;58;27;3;24;.889;3600000;0
3630;57434;36;0;0;0;0;.00nan;0;0
3630;76574;50;42;42;6;36;.857;3600000;0
3631;187578;53;63;24;3;21;.875;3600000;0
3631;188888;51;0;0;0;0;.00nan;0;0
3631;169154;51;67;42;4;38;.905;3600000;0
3631;169323;53;0;0;0;0;.00nan;0;0
3632;1593;4837;0;0;0;0;.00nan;0;0
3632;182780;60;88;34;1;33;.971;3900000;0
3632;170294;60;0;0;0;0;.00nan;0;0
3632;85546;4837;90;34;1;33;.971;3900000;0
3633;1593;4837;0;0;0;0;.00nan;0;0
3633;182780;60;0;0;0;0;.00nan;0;0
3633;170294;60;61;32;3;29;.906;3543000;0
3633;85546;4837;59;22;2;20;.909;3600000;0
3634;171608;45;0;0;0;0;.00nan;0;0
3634;190106;46;0;0;0;0;.00nan;0;0
3634;79280;46;60;18;3;15;.833;3900000;0
3634;85798;45;97;48;3;45;.938;3900000;0
3635;3284;59;93;37;2;35;.946;3600000;0
3635;183783;52;86;42;3;39;.929;3571000;0
3635;176921;59;0;0;0;0;.00nan;0;0
3635;180316;52;0;0;0;0;.00nan;0;0
3636;78479;47;76;32;3;29;.906;3900000;0
3636;79132;49;98;56;3;53;.946;3900000;0
3636;79141;47;0;0;0;0;.00nan;0;0
3636;91225;49;0;0;0;0;.00nan;0;0
3637;183904;43;78;32;2;30;.938;3600000;0
3637;178612;43;0;0;0;0;.00nan;0;0
3637;173699;36;31;38;7;31;.816;3600000;0
3637;57434;36;0;0;0;0;.00nan;0;0
3638;174718;4619;61;27;4;23;.852;3543000;0
3638;191813;4619;0;0;0;0;.00nan;0;0
3638;75362;57;0;0;0;0;.00nan;0;0
3638;86862;57;70;33;3;30;.909;3600000;0
3639;4622;38;76;20;1;19;.950;3600000;0
3639;38124;58;58;22;3;19;.864;3566000;0
3639;64722;38;0;0;0;0;.00nan;0;0
3639;149450;58;0;0;0;0;.00nan;0;0
3640;163471;63;72;28;2;26;.929;3600000;0
3640;192457;63;0;0;0;0;.00nan;0;0
3640;58100;56;73;46;5;41;.891;3600000;0
3640;85468;56;0;0;0;0;.00nan;0;0
3641;172499;50;63;15;1;14;.933;1053000;0
3641;183904;43;91;19;0;19;1.000;3600000;0
3641;178612;43;0;0;0;0;.00nan;0;0
3641;76574;50;47;44;6;38;.864;2547000;0
3642;176860;44;47;12;2;10;.833;3600000;0
3642;79132;49;53;30;4;26;.867;3600000;0
3642;86180;44;0;0;0;0;.00nan;0;0
3642;91225;49;0;0;0;0;.00nan;0;0
3643;187578;53;56;22;3;19;.864;3600000;0
3643;4622;38;0;0;0;0;.00nan;0;0
3643;169323;53;0;0;0;0;.00nan;0;0
3643;64722;38;64;37;4;33;.892;3559000;0
3644;187699;41;90;55;3;52;.945;3579000;0
3644;173699;36;65;17;1;16;.941;3600000;0
3644;-1;41;0;0;0;0;.00nan;0;0
3644;57434;36;0;0;0;0;.00nan;0;0
3645;182780;60;35;31;5;26;.839;3600000;0
3645;172340;48;67;31;3;28;.903;3600000;0
3645;170294;60;0;0;0;0;.00nan;0;0
3645;142492;48;0;0;0;0;.00nan;0;0
3646;175084;65;44;12;2;10;.833;3531000;0
3646;38124;58;0;0;0;0;.00nan;0;0
3646;77084;65;0;0;0;0;.00nan;0;0
3646;149450;58;100;38;0;38;1.000;3600000;0
3647;189644;42;56;20;3;17;.850;3900000;0
3647;176915;54;72;37;3;34;.919;3900000;0
3647;57695;42;0;0;0;0;.00nan;0;0
3647;94615;54;0;0;0;0;.00nan;0;0
3648;174718;4619;100;23;0;23;1.000;3600000;0
3648;191813;4619;0;0;0;0;.00nan;0;0
3648;75362;57;65;38;3;35;.921;3600000;0
3648;86862;57;0;0;0;0;.00nan;0;0
3649;178384;40;90;33;2;31;.939;3600000;0
3649;176938;62;92;22;0;22;1.000;3600000;0
3649;38276;62;0;0;0;0;.00nan;0;0
3649;85636;40;0;0;0;0;.00nan;0;0
3650;3284;59;0;0;0;0;.00nan;0;0
3650;163462;55;90;46;4;42;.913;3594000;0
3650;170728;55;0;0;0;0;.00nan;0;0
3650;176921;59;62;22;2;20;.909;3600000;0
3651;188888;51;0;0;0;0;.00nan;0;0
3651;183783;52;0;0;0;0;.00nan;0;0
3651;169154;51;66;42;5;37;.881;3600000;0
3651;180316;52;48;27;4;23;.852;3600000;0
3652;168872;64;80;37;2;35;.946;3569000;0
3652;190106;46;94;22;0;22;1.000;3600000;0
3652;79280;46;0;0;0;0;.00nan;0;0
3652;141978;64;0;0;0;0;.00nan;0;0
3653;179306;61;0;0;0;0;.00nan;0;0
3653;78479;47;17;27;6;21;.778;3144000;0
3653;78581;61;80;34;2;32;.941;3600000;0
3653;79141;47;39;1;1;0;.000;456000;0
3654;187699;41;0;0;0;0;.00nan;0;0
3654;183904;43;63;16;1;15;.938;3600000;0
3654;178612;43;0;0;0;0;.00nan;0;0
3654;-1;41;98;54;4;50;.926;3600000;0
3655;187578;53;0;0;0;0;.00nan;0;0
3655;4622;38;81;33;2;31;.939;3572000;0
3655;169323;53;85;18;0;18;1.000;3600000;0
3655;64722;38;0;0;0;0;.00nan;0;0
3656;163471;63;59;27;3;24;.889;3755000;0
3656;192457;63;0;0;0;0;.00nan;0;0
3656;58100;56;57;29;4;25;.862;3755000;0
3656;85468;56;0;0;0;0;.00nan;0;0
3657;188888;51;73;48;5;43;.896;3600000;0
3657;183783;52;57;26;3;23;.885;3600000;0
3657;169154;51;0;0;0;0;.00nan;0;0
3657;180316;52;0;0;0;0;.00nan;0;0
3658;176860;44;0;0;0;0;.00nan;0;0
3658;79132;49;0;0;0;0;.00nan;0;0
3658;86180;44;75;22;1;21;.955;3600000;0
3658;91225;49;82;38;3;35;.921;3539000;0
3659;176915;54;0;0;0;0;.00nan;0;0
3659;43731;37;61;16;1;15;.938;3600000;0
3659;85453;37;0;0;0;0;.00nan;0;0
3659;94615;54;71;45;4;41;.911;3600000;0
3660;189644;42;0;0;0;0;.00nan;0;0
3660;171608;45;0;0;0;0;.00nan;0;0
3660;57695;42;71;30;3;27;.900;3900000;0
3660;85798;45;79;41;3;38;.927;3900000;0
3661;175084;65;0;0;0;0;.00nan;0;0
3661;38124;58;0;0;0;0;.00nan;0;0
3661;77084;65;98;36;1;35;.972;3600000;0
3661;149450;58;98;49;2;47;.959;3575000;0
3662;178384;40;0;0;0;0;.00nan;0;0
3662;176938;62;53;24;3;21;.875;3600000;0
3662;38276;62;0;0;0;0;.00nan;0;0
3662;85636;40;70;53;5;48;.906;3577000;0
3663;168872;64;0;0;0;0;.00nan;0;0
3663;190106;46;60;28;3;25;.893;3600000;0
3663;79280;46;0;0;0;0;.00nan;0;0
3663;141978;64;61;38;4;34;.895;3600000;0
3664;172499;50;0;0;0;0;.00nan;0;0
3664;43928;39;78;22;1;21;.955;3600000;0
3664;76574;50;55;36;4;32;.889;3600000;0
3664;143301;39;0;0;0;0;.00nan;0;0
3665;179306;61;63;29;3;26;.897;3839000;0
3665;78479;47;0;0;0;0;.00nan;0;0
3665;78581;61;0;0;0;0;.00nan;0;0
3665;79141;47;47;25;4;21;.840;3839000;0
3666;163462;55;0;0;0;0;.00nan;0;0
3666;173699;36;99;42;3;39;.929;3900000;0
3666;170728;55;71;27;3;24;.889;3900000;0
3666;57434;36;0;0;0;0;.00nan;0;0
3667;187578;53;66;29;3;26;.897;3564000;0
3667;169323;53;0;0;0;0;.00nan;0;0
3667;175084;65;95;33;1;32;.970;3600000;0
3667;77084;65;0;0;0;0;.00nan;0;0
3668;189644;42;46;25;4;21;.840;3554000;0
3668;171608;45;0;0;0;0;.00nan;0;0
3668;57695;42;0;0;0;0;.00nan;0;0
3668;85798;45;100;46;2;44;.957;3600000;0
3669;176915;54;87;28;1;27;.964;3600000;0
3669;43731;37;0;0;0;0;.00nan;0;0
3669;85453;37;40;14;3;11;.786;3574000;0
3669;94615;54;0;0;0;0;.00nan;0;0
3670;182780;60;53;3;0;3;1.000;324000;0
3670;172340;48;76;32;3;29;.906;3600000;0
3670;170294;60;26;30;6;24;.800;3276000;0
3670;142492;48;0;0;0;0;.00nan;0;0
3671;172499;50;0;0;0;0;.00nan;0;0
3671;43928;39;0;0;0;0;.00nan;0;0
3671;76574;50;67;31;3;28;.903;3538000;0
3671;143301;39;75;20;1;19;.950;3600000;0
3672;58100;56;92;53;3;50;.943;3600000;0
3672;75362;57;70;25;2;23;.920;3600000;0
3672;85468;56;0;0;0;0;.00nan;0;0
3672;86862;57;0;0;0;0;.00nan;0;0
3673;1593;4837;0;0;0;0;.00nan;0;0
3673;79132;49;43;36;5;31;.861;3600000;0
3673;85546;4837;73;18;1;17;.944;3600000;0
3673;91225;49;0;0;0;0;.00nan;0;0
3674;182780;60;0;0;0;0;.00nan;0;0
3674;170294;60;100;43;1;42;.977;3600000;0
3674;179306;61;0;0;0;0;.00nan;0;0
3674;78581;61;83;28;2;26;.929;3591000;0
3675;172340;48;0;0;0;0;.00nan;0;0
3675;78479;47;69;31;2;29;.935;3900000;0
3675;79141;47;0;0;0;0;.00nan;0;0
3675;142492;48;98;38;2;36;.947;3900000;0
3676;178384;40;94;50;6;44;.880;3600000;0
3676;174718;4619;24;5;3;2;.400;584000;0
3676;191813;4619;47;38;6;32;.842;3016000;0
3676;85636;40;0;0;0;0;.00nan;0;0
3677;187699;41;33;19;4;15;.789;830000;0
3677;-1;41;82;44;3;41;.932;2770000;0
3677;43928;39;0;0;0;0;.00nan;0;0
3677;143301;39;44;18;3;15;.833;3600000;0
3678;182780;60;18;8;4;4;.500;499000;0
3678;170294;60;100;39;0;39;1.000;3401000;0
3678;179306;61;46;29;4;25;.862;3900000;0
3678;78581;61;0;0;0;0;.00nan;0;0
3679;58100;56;84;27;1;26;.963;3600000;0
3679;75362;57;0;0;0;0;.00nan;0;0
3679;85468;56;0;0;0;0;.00nan;0;0
3679;86862;57;46;20;3;17;.850;3588000;0
3680;183783;52;0;0;0;0;.00nan;0;0
3680;175084;65;0;0;0;0;.00nan;0;0
3680;180316;52;33;34;6;28;.824;3600000;0
3680;77084;65;76;25;1;24;.960;3600000;0
3681;4622;38;56;6;0;6;1.000;549000;0
3681;38124;58;0;0;0;0;.00nan;0;0
3681;64722;38;20;27;7;20;.741;3051000;0
3681;149450;58;66;40;4;36;.900;3600000;0
3682;189644;42;62;26;3;23;.885;3600000;0
3682;43731;37;0;0;0;0;.00nan;0;0
3682;57695;42;0;0;0;0;.00nan;0;0
3682;85453;37;73;38;4;34;.895;3545000;0
3683;163471;63;62;26;4;22;.846;3575000;0
3683;173699;36;73;28;2;26;.929;3600000;0
3683;192457;63;0;0;0;0;.00nan;0;0
3683;57434;36;0;0;0;0;.00nan;0;0
3684;172499;50;0;0;0;0;.00nan;0;0
3684;176915;54;38;35;6;29;.829;3600000;0
3684;76574;50;68;26;2;24;.923;3600000;0
3684;94615;54;0;0;0;0;.00nan;0;0
3685;187578;53;40;30;5;25;.833;3327000;0
3685;3284;59;76;30;2;28;.933;3600000;0
3685;169323;53;53;4;0;4;1.000;273000;0
3685;176921;59;0;0;0;0;.00nan;0;0
3686;163462;55;48;16;3;13;.813;3600000;0
3686;188888;51;60;22;2;20;.909;1463000;0
3686;169154;51;38;26;5;21;.808;2137000;0
3686;170728;55;0;0;0;0;.00nan;0;0
3687;38124;58;0;0;0;0;.00nan;0;0
3687;75362;57;56;28;4;24;.857;3900000;0
3687;86862;57;0;0;0;0;.00nan;0;0
3687;149450;58;47;27;4;23;.852;3900000;0
3688;43928;39;0;0;0;0;.00nan;0;0
3688;58100;56;0;0;0;0;.00nan;0;0
3688;85468;56;71;42;4;38;.905;3577000;0
3688;143301;39;58;24;3;21;.875;3600000;0
3689;168872;64;64;49;5;44;.898;3569000;0
3689;176938;62;51;28;4;24;.857;3600000;0
3689;38276;62;0;0;0;0;.00nan;0;0
3689;141978;64;0;0;0;0;.00nan;0;0
3690;172499;50;0;0;0;0;.00nan;0;0
3690;190106;46;74;26;2;24;.923;3600000;0
3690;76574;50;53;39;5;34;.872;3600000;0
3690;79280;46;0;0;0;0;.00nan;0;0
3691;187699;41;0;0;0;0;.00nan;0;0
3691;-1;41;66;52;5;47;.904;3600000;0
3691;175084;65;0;0;0;0;.00nan;0;0
3691;77084;65;77;24;2;22;.917;3600000;0
3692;163471;63;95;19;0;19;1.000;3600000;0
3692;173699;36;82;43;4;39;.907;3600000;0
3692;192457;63;0;0;0;0;.00nan;0;0
3692;57434;36;0;0;0;0;.00nan;0;0
3693;189644;42;77;23;1;22;.957;3600000;0
3693;176915;54;84;38;3;35;.921;3573000;0
3693;57695;42;0;0;0;0;.00nan;0;0
3693;94615;54;0;0;0;0;.00nan;0;0
3694;171608;45;0;0;0;0;.00nan;0;0
3694;174718;4619;79;26;1;25;.962;3600000;0
3694;191813;4619;0;0;0;0;.00nan;0;0
3694;85798;45;61;32;4;28;.875;3600000;0
3695;172340;48;70;26;3;23;.885;3600000;0
3695;178384;40;81;44;4;40;.909;3587000;0
3695;85636;40;0;0;0;0;.00nan;0;0
3695;142492;48;0;0;0;0;.00nan;0;0
3696;3284;59;80;28;1;27;.964;3600000;0
3696;183783;52;69;39;4;35;.897;3600000;0
3696;176921;59;0;0;0;0;.00nan;0;0
3696;180316;52;0;0;0;0;.00nan;0;0
3697;163462;55;75;22;1;21;.955;3600000;0
3697;188888;51;0;0;0;0;.00nan;0;0
3697;169154;51;58;30;3;27;.900;3520000;0
3697;170728;55;0;0;0;0;.00nan;0;0
3698;1593;4837;0;0;0;0;.00nan;0;0
3698;78479;47;95;23;0;23;1.000;3600000;0
3698;79141;47;0;0;0;0;.00nan;0;0
3698;85546;4837;76;35;3;32;.914;3600000;0
3699;187578;53;54;35;5;30;.857;3600000;0
3699;169323;53;0;0;0;0;.00nan;0;0
3699;175084;65;29;35;7;28;.800;3569000;0
3699;77084;65;0;0;0;0;.00nan;0;0
3700;182780;60;0;0;0;0;.00nan;0;0
3700;170294;60;80;36;2;34;.944;3578000;0
3700;176860;44;100;25;0;25;1.000;3600000;0
3700;86180;44;0;0;0;0;.00nan;0;0
3701;38124;58;45;44;6;38;.864;3600000;0
3701;75362;57;0;0;0;0;.00nan;0;0
3701;86862;57;81;25;1;24;.960;3600000;0
3701;149450;58;0;0;0;0;.00nan;0;0
3702;168872;64;0;0;0;0;.00nan;0;0
3702;176938;62;0;0;0;0;.00nan;0;0
3702;38276;62;88;29;1;28;.966;3600000;0
3702;141978;64;85;41;2;39;.951;3600000;0
3703;183783;52;0;0;0;0;.00nan;0;0
3703;183904;43;81;32;3;29;.906;3900000;0
3703;178612;43;0;0;0;0;.00nan;0;0
3703;180316;52;83;45;3;42;.933;3900000;0
3704;179306;61;0;0;0;0;.00nan;0;0
3704;78581;61;70;30;3;27;.900;3600000;0
3704;79132;49;70;37;4;33;.892;3554000;0
3704;91225;49;0;0;0;0;.00nan;0;0
3705;4622;38;76;39;3;36;.923;3600000;0
3705;43731;37;0;0;0;0;.00nan;0;0
3705;64722;38;0;0;0;0;.00nan;0;0
3705;85453;37;69;37;4;33;.892;3600000;0
3706;187699;41;83;36;2;34;.944;3600000;0
3706;163471;63;72;20;1;19;.950;3600000;0
3706;-1;41;0;0;0;0;.00nan;0;0
3706;192457;63;0;0;0;0;.00nan;0;0
3707;189644;42;0;0;0;0;.00nan;0;0
3707;176915;54;0;0;0;0;.00nan;0;0
3707;57695;42;74;21;1;20;.952;3600000;0
3707;94615;54;50;33;5;28;.848;3600000;0
3708;171608;45;0;0;0;0;.00nan;0;0
3708;174718;4619;0;0;0;0;.00nan;0;0
3708;191813;4619;54;24;4;20;.833;3600000;0
3708;85798;45;48;29;5;24;.828;3573000;0
3709;172340;48;0;0;0;0;.00nan;0;0
3709;178384;40;84;43;3;40;.930;3600000;0
3709;85636;40;0;0;0;0;.00nan;0;0
3709;142492;48;44;24;4;20;.833;3578000;0
3710;3284;59;89;31;1;30;.968;3600000;0
3710;163462;55;0;0;0;0;.00nan;0;0
3710;170728;55;49;49;7;42;.857;3600000;0
3710;176921;59;0;0;0;0;.00nan;0;0
3711;188888;51;54;37;4;33;.892;3600000;0
3711;169154;51;0;0;0;0;.00nan;0;0
3711;173699;36;91;31;1;30;.968;3600000;0
3711;57434;36;0;0;0;0;.00nan;0;0
3712;187578;53;0;0;0;0;.00nan;0;0
3712;183904;43;27;28;6;22;.786;2964000;0
3712;178612;43;63;7;0;7;1.000;636000;0
3712;169323;53;90;36;2;34;.944;3600000;0
3713;182780;60;56;29;3;26;.897;3529000;0
3713;170294;60;0;0;0;0;.00nan;0;0
3713;176860;44;92;37;1;36;.973;3600000;0
3713;86180;44;0;0;0;0;.00nan;0;0
3714;172499;50;0;0;0;0;.00nan;0;0
3714;190106;46;65;23;2;21;.913;3568000;0
3714;76574;50;100;41;1;40;.976;3600000;0
3714;79280;46;0;0;0;0;.00nan;0;0
3715;179306;61;45;12;2;10;.833;3600000;0
3715;78581;61;0;0;0;0;.00nan;0;0
3715;79132;49;0;0;0;0;.00nan;0;0
3715;91225;49;80;46;3;43;.935;3600000;0
3716;4622;38;0;0;0;0;.00nan;0;0
3716;43731;37;58;36;5;31;.861;3600000;0
3716;64722;38;66;20;1;19;.950;3600000;0
3716;85453;37;0;0;0;0;.00nan;0;0
3717;43928;39;0;0;0;0;.00nan;0;0
3717;58100;56;98;45;2;43;.956;3516000;0
3717;85468;56;0;0;0;0;.00nan;0;0
3717;143301;39;88;17;0;17;1.000;3600000;0
3718;172340;48;54;29;4;25;.862;3600000;0
3718;179306;61;0;0;0;0;.00nan;0;0
3718;78581;61;14;27;8;19;.704;3600000;0
3718;142492;48;0;0;0;0;.00nan;0;0
3719;178384;40;96;44;2;42;.955;3521000;0
3719;78479;47;89;18;0;18;1.000;3600000;0
3719;79141;47;0;0;0;0;.00nan;0;0
3719;85636;40;0;0;0;0;.00nan;0;0
3720;171608;45;0;0;0;0;.00nan;0;0
3720;190106;46;70;29;2;27;.931;3600000;0
3720;79280;46;0;0;0;0;.00nan;0;0
3720;85798;45;38;36;7;29;.806;3600000;0
3721;1593;4837;0;0;0;0;.00nan;0;0
3721;79132;49;78;32;2;30;.938;3583000;0
3721;85546;4837;65;16;1;15;.938;3600000;0
3721;91225;49;0;0;0;0;.00nan;0;0
3722;168872;64;0;0;0;0;.00nan;0;0
3722;174718;4619;71;24;2;22;.917;3600000;0
3722;191813;4619;0;0;0;0;.00nan;0;0
3722;141978;64;64;41;5;36;.878;3600000;0
3723;163462;55;37;21;5;16;.762;3600000;0
3723;183904;43;42;42;6;36;.857;3600000;0
3723;178612;43;0;0;0;0;.00nan;0;0
3723;170728;55;0;0;0;0;.00nan;0;0
3724;4622;38;51;30;4;26;.867;3600000;0
3724;38124;58;97;37;1;36;.973;3600000;0
3724;64722;38;0;0;0;0;.00nan;0;0
3724;149450;58;0;0;0;0;.00nan;0;0
3725;173699;36;56;32;4;28;.875;3600000;0
3725;176860;44;80;27;1;26;.963;3600000;0
3725;57434;36;0;0;0;0;.00nan;0;0
3725;86180;44;0;0;0;0;.00nan;0;0
3726;1593;4837;0;0;0;0;.00nan;0;0
3726;168872;64;31;29;7;22;.759;2860000;0
3726;85546;4837;66;23;2;21;.913;3600000;0
3726;141978;64;66;10;0;10;1.000;740000;0
3727;163471;63;54;35;4;31;.886;3600000;0
3727;183904;43;74;30;3;27;.900;3600000;0
3727;178612;43;0;0;0;0;.00nan;0;0
3727;192457;63;0;0;0;0;.00nan;0;0
3728;4622;38;47;35;6;29;.829;2567000;0
3728;64722;38;49;1;0;1;1.000;980000;0
3728;75362;57;75;47;5;42;.894;3600000;0
3728;86862;57;0;0;0;0;.00nan;0;0
3729;176938;62;63;20;2;18;.900;3547000;0
3729;38276;62;0;0;0;0;.00nan;0;0
3729;43731;37;0;0;0;0;.00nan;0;0
3729;85453;37;97;40;1;39;.975;3600000;0
3730;189644;42;52;39;5;34;.872;3600000;0
3730;190106;46;78;31;1;30;.968;3600000;0
3730;57695;42;0;0;0;0;.00nan;0;0
3730;79280;46;0;0;0;0;.00nan;0;0
3731;187699;41;0;0;0;0;.00nan;0;0
3731;183783;52;53;12;2;10;.833;3600000;0
3731;-1;41;70;46;5;41;.891;3600000;0
3731;180316;52;0;0;0;0;.00nan;0;0
3732;182780;60;0;0;0;0;.00nan;0;0
3732;170294;60;71;22;2;20;.909;3600000;0
3732;79132;49;48;33;5;28;.848;3600000;0
3732;91225;49;0;0;0;0;.00nan;0;0
3733;172499;50;0;0;0;0;.00nan;0;0
3733;176915;54;70;24;2;22;.917;3565000;0
3733;76574;50;74;17;1;16;.941;3600000;0
3733;94615;54;0;0;0;0;.00nan;0;0
3734;172340;48;71;28;2;26;.929;3600000;0
3734;78479;47;78;33;3;30;.909;3593000;0
3734;79141;47;0;0;0;0;.00nan;0;0
3734;142492;48;0;0;0;0;.00nan;0;0
3735;187578;53;98;44;2;42;.955;3669000;0
3735;169323;53;0;0;0;0;.00nan;0;0
3735;175084;65;57;30;3;27;.900;3669000;0
3735;77084;65;0;0;0;0;.00nan;0;0
3736;38124;58;54;11;1;10;.909;554000;0
3736;191218;59;0;0;0;0;.00nan;0;0
3736;58054;59;96;20;0;20;1.000;3600000;0
3736;149450;58;46;35;5;30;.857;3046000;0
3737;188888;51;0;0;0;0;.00nan;0;0
3737;169154;51;72;50;5;45;.900;3600000;0
3737;43928;39;0;0;0;0;.00nan;0;0
3737;143301;39;59;12;1;11;.917;3600000;0
3738;178384;40;100;44;2;42;.955;3600000;0
3738;179306;61;0;0;0;0;.00nan;0;0
3738;78581;61;50;25;4;21;.840;3560000;0
3738;85636;40;0;0;0;0;.00nan;0;0
3739;173699;36;63;35;4;31;.886;3613000;0
3739;176860;44;0;0;0;0;.00nan;0;0
3739;57434;36;0;0;0;0;.00nan;0;0
3739;86180;44;66;24;3;21;.875;3613000;0
3740;1593;4837;51;18;2;16;.889;3894000;0
3740;168872;64;0;0;0;0;.00nan;0;0
3740;85546;4837;0;0;0;0;.00nan;0;0
3740;141978;64;88;44;3;41;.932;3894000;0
3741;163471;63;0;0;0;0;.00nan;0;0
3741;183904;43;0;0;0;0;.00nan;0;0
3741;178612;43;43;33;5;28;.848;3561000;0
3741;192457;63;68;36;4;32;.889;3600000;0
3742;187578;53;0;0;0;0;.00nan;0;0
3742;169323;53;44;23;4;19;.826;3900000;0
3742;175084;65;0;0;0;0;.00nan;0;0
3742;77084;65;87;54;4;50;.926;3900000;0
3743;4622;38;0;0;0;0;.00nan;0;0
3743;64722;38;83;33;3;30;.909;3900000;0
3743;75362;57;79;34;3;31;.912;3900000;0
3743;86862;57;0;0;0;0;.00nan;0;0
3744;171608;45;63;33;3;30;.909;3514000;0
3744;174718;4619;99;39;1;38;.974;3600000;0
3744;191813;4619;0;0;0;0;.00nan;0;0
3744;85798;45;0;0;0;0;.00nan;0;0
3745;163462;55;68;17;1;16;.941;3600000;0
3745;170728;55;0;0;0;0;.00nan;0;0
3745;58100;56;52;43;5;38;.884;3600000;0
3745;85468;56;0;0;0;0;.00nan;0;0
3746;172340;48;0;0;0;0;.00nan;0;0
3746;78479;47;0;0;0;0;.00nan;0;0
3746;79141;47;28;28;6;22;.786;3600000;0
3746;142492;48;65;39;5;34;.872;3600000;0
3747;176938;62;0;0;0;0;.00nan;0;0
3747;38276;62;51;33;4;29;.879;3553000;0
3747;43731;37;75;37;2;35;.946;3600000;0
3747;85453;37;0;0;0;0;.00nan;0;0
3748;187699;41;34;26;5;21;.808;2299000;0
3748;183783;52;0;0;0;0;.00nan;0;0
3748;-1;41;64;25;2;23;.920;1301000;0
3748;180316;52;49;15;2;13;.867;3600000;0
3749;189644;42;0;0;0;0;.00nan;0;0
3749;190106;46;0;0;0;0;.00nan;0;0
3749;57695;42;73;27;2;25;.926;3573000;0
3749;79280;46;100;36;0;36;1.000;3600000;0
3750;188888;51;78;46;3;43;.935;3900000;0
3750;169154;51;0;0;0;0;.00nan;0;0
3750;43928;39;0;0;0;0;.00nan;0;0
3750;143301;39;73;28;3;25;.893;3883000;0
3751;178384;40;0;0;0;0;.00nan;0;0
3751;179306;61;73;21;1;20;.952;3600000;0
3751;78581;61;0;0;0;0;.00nan;0;0
3751;85636;40;98;46;2;44;.957;3568000;0
3752;38124;58;0;0;0;0;.00nan;0;0
3752;191218;59;0;0;0;0;.00nan;0;0
3752;58054;59;62;20;2;18;.900;3560000;0
3752;149450;58;94;31;1;30;.968;3600000;0
3753;171608;45;54;2;0;2;1.000;660000;0
3753;174718;4619;59;12;1;11;.917;1192000;0
3753;191813;4619;27;25;6;19;.760;2361000;0
3753;85798;45;42;34;6;28;.824;2940000;0
3754;163462;55;0;0;0;0;.00nan;0;0
3754;170728;55;19;26;6;20;.769;3600000;0
3754;58100;56;98;58;3;55;.948;3600000;0
3754;85468;56;0;0;0;0;.00nan;0;0
3755;182780;60;0;0;0;0;.00nan;0;0
3755;170294;60;69;33;3;30;.909;3900000;0
3755;79132;49;60;27;3;24;.889;3900000;0
3755;91225;49;0;0;0;0;.00nan;0;0
3756;172499;50;0;0;0;0;.00nan;0;0
3756;176915;54;46;22;3;19;.864;3547000;0
3756;76574;50;90;32;1;31;.969;3600000;0
3756;94615;54;0;0;0;0;.00nan;0;0
3757;187699;41;66;33;4;29;.879;3584000;0
3757;-1;41;0;0;0;0;.00nan;0;0
3757;175084;65;0;0;0;0;.00nan;0;0
3757;77084;65;82;31;2;29;.935;3600000;0
3758;176915;54;57;29;3;26;.897;3900000;0
3758;43731;37;0;0;0;0;.00nan;0;0
3758;85453;37;74;29;3;26;.897;3900000;0
3758;94615;54;0;0;0;0;.00nan;0;0
3759;190106;46;0;0;0;0;.00nan;0;0
3759;43928;39;0;0;0;0;.00nan;0;0
3759;79280;46;39;35;6;29;.829;3600000;0
3759;143301;39;79;28;1;27;.964;3600000;0
3760;183783;52;68;23;1;22;.957;3600000;0
3760;180316;52;0;0;0;0;.00nan;0;0
3760;58100;56;34;31;6;25;.806;2142000;0
3760;85468;56;50;13;2;11;.846;1458000;0
3761;183904;43;43;28;4;24;.857;3816000;0
3761;178612;43;0;0;0;0;.00nan;0;0
3761;173699;36;68;37;5;32;.865;3816000;0
3761;57434;36;0;0;0;0;.00nan;0;0
3762;189644;42;60;28;2;26;.929;3548000;0
3762;174718;4619;96;35;1;34;.971;3600000;0
3762;191813;4619;0;0;0;0;.00nan;0;0
3762;57695;42;0;0;0;0;.00nan;0;0
3763;172340;48;0;0;0;0;.00nan;0;0
3763;79132;49;69;33;3;30;.909;3600000;0
3763;91225;49;0;0;0;0;.00nan;0;0
3763;142492;48;96;20;0;20;1.000;3600000;0
3764;176860;44;80;30;2;28;.933;3600000;0
3764;78479;47;63;32;3;29;.906;3591000;0
3764;79141;47;0;0;0;0;.00nan;0;0
3764;139467;44;0;0;0;0;.00nan;0;0
3765;183904;43;100;40;0;40;1.000;3600000;0
3765;178612;43;0;0;0;0;.00nan;0;0
3765;190106;46;65;42;4;38;.905;3600000;0
3765;79280;46;0;0;0;0;.00nan;0;0
3766;182780;60;0;0;0;0;.00nan;0;0
3766;172499;50;0;0;0;0;.00nan;0;0
3766;170294;60;75;28;2;26;.929;3588000;0
3766;76574;50;71;22;1;21;.955;3600000;0
3767;179306;61;40;9;2;7;.778;336000;0
3767;176938;62;88;27;1;26;.963;3600000;0
3767;38276;62;0;0;0;0;.00nan;0;0
3767;78581;61;43;38;6;32;.842;3264000;0
3768;189644;42;47;22;3;19;.864;3870000;0
3768;43731;37;72;29;2;27;.931;3870000;0
3768;57695;42;0;0;0;0;.00nan;0;0
3768;85453;37;0;0;0;0;.00nan;0;0
3769;183783;52;0;0;0;0;.00nan;0;0
3769;173699;36;63;42;5;37;.881;3590000;0
3769;180316;52;84;32;3;29;.906;3600000;0
3769;57434;36;0;0;0;0;.00nan;0;0
3770;187699;41;70;47;5;42;.894;2744000;0
3770;-1;41;15;12;5;7;.583;856000;0
3770;175084;65;62;24;3;21;.875;3600000;0
3770;77084;65;0;0;0;0;.00nan;0;0
3771;1593;4837;0;0;0;0;.00nan;0;0
3771;172340;48;0;0;0;0;.00nan;0;0
3771;85546;4837;83;20;1;19;.950;3600000;0
3771;142492;48;71;42;5;37;.881;3600000;0
3772;163471;63;86;32;1;31;.969;3600000;0
3772;192457;63;0;0;0;0;.00nan;0;0
3772;75362;57;62;41;4;37;.902;3600000;0
3772;86862;57;0;0;0;0;.00nan;0;0
3773;174718;4619;68;23;3;20;.870;3600000;0
3773;176915;54;93;61;4;57;.934;3595000;0
3773;191813;4619;0;0;0;0;.00nan;0;0
3773;94615;54;0;0;0;0;.00nan;0;0
3774;178384;40;91;30;2;28;.933;3788000;0
3774;79132;49;73;33;3;30;.909;3788000;0
3774;85636;40;0;0;0;0;.00nan;0;0
3774;91225;49;0;0;0;0;.00nan;0;0
3775;4622;38;70;18;1;17;.944;3600000;0
3775;188888;51;0;0;0;0;.00nan;0;0
3775;169154;51;88;46;4;42;.913;3600000;0
3775;64722;38;0;0;0;0;.00nan;0;0
3776;168872;64;100;29;0;29;1.000;3600000;0
3776;171608;45;0;0;0;0;.00nan;0;0
3776;85798;45;58;22;3;19;.864;3600000;0
3776;141978;64;0;0;0;0;.00nan;0;0
3777;187578;53;97;43;3;40;.930;3900000;0
3777;163462;55;52;26;3;23;.885;3900000;0
3777;169323;53;0;0;0;0;.00nan;0;0
3777;86180;55;0;0;0;0;.00nan;0;0
3778;38124;58;0;0;0;0;.00nan;0;0
3778;58100;56;100;36;0;36;1.000;3760000;0
3778;85468;56;0;0;0;0;.00nan;0;0
3778;149450;58;94;25;1;24;.960;3760000;0
3779;176860;44;0;0;0;0;.00nan;0;0
3779;78479;47;0;0;0;0;.00nan;0;0
3779;79141;47;58;24;2;22;.917;3600000;0
3779;139467;44;92;44;3;41;.932;3551000;0
3780;1593;4837;0;0;0;0;.00nan;0;0
3780;172340;48;55;33;5;28;.848;3600000;0
3780;85546;4837;90;19;0;19;1.000;3600000;0
3780;142492;48;0;0;0;0;.00nan;0;0
3781;183904;43;42;32;5;27;.844;3900000;0
3781;178612;43;0;0;0;0;.00nan;0;0
3781;190106;46;0;0;0;0;.00nan;0;0
3781;79280;46;59;43;5;38;.884;3900000;0
3782;179306;61;0;0;0;0;.00nan;0;0
3782;176938;62;0;0;0;0;.00nan;0;0
3782;38276;62;100;42;2;40;.952;3900000;0
3782;78581;61;64;24;2;22;.917;3900000;0
3783;4622;38;0;0;0;0;.00nan;0;0
3783;58100;56;97;52;3;49;.942;3529000;0
3783;64722;38;67;16;1;15;.938;3600000;0
3783;85468;56;0;0;0;0;.00nan;0;0
3784;189644;42;0;0;0;0;.00nan;0;0
3784;43731;37;0;0;0;0;.00nan;0;0
3784;57695;42;98;36;1;35;.972;3600000;0
3784;85453;37;51;39;5;34;.872;3600000;0
3785;183783;52;87;30;1;29;.967;3600000;0
3785;173699;36;80;15;0;15;1.000;2409000;0
3785;180316;52;0;0;0;0;.00nan;0;0
3785;57434;36;22;19;5;14;.737;1191000;0
3786;187699;41;0;0;0;0;.00nan;0;0
3786;-1;41;79;39;2;37;.949;3571000;0
3786;75362;57;0;0;0;0;.00nan;0;0
3786;86862;57;76;24;1;23;.958;3600000;0
3787;174718;4619;0;0;0;0;.00nan;0;0
3787;176915;54;0;0;0;0;.00nan;0;0
3787;191813;4619;66;23;2;21;.913;3600000;0
3787;94615;54;78;41;4;37;.902;3600000;0
3788;178384;40;0;0;0;0;.00nan;0;0
3788;79132;49;0;0;0;0;.00nan;0;0
3788;85636;40;79;22;1;21;.955;3600000;0
3788;91225;49;73;34;2;32;.941;3588000;0
3789;187578;53;0;0;0;0;.00nan;0;0
3789;169323;53;90;31;1;30;.968;3600000;0
3789;191218;59;0;0;0;0;.00nan;0;0
3789;58054;59;86;36;2;34;.944;3600000;0
3790;163462;55;0;0;0;0;.00nan;0;0
3790;188888;51;80;41;3;38;.927;3581000;0
3790;169154;51;0;0;0;0;.00nan;0;0
3790;86180;55;54;15;2;13;.867;3600000;0
3791;168872;64;68;30;2;28;.933;3600000;0
3791;171608;45;68;32;3;29;.906;3558000;0
3791;85798;45;0;0;0;0;.00nan;0;0
3791;141978;64;0;0;0;0;.00nan;0;0
3792;175084;65;0;0;0;0;.00nan;0;0
3792;38124;58;0;0;0;0;.00nan;0;0
3792;77084;65;47;19;3;16;.842;3511000;0
3792;149450;58;99;37;1;36;.973;3600000;0
3793;182780;60;41;25;4;21;.840;3600000;0
3793;172499;50;0;0;0;0;.00nan;0;0
3793;170294;60;0;0;0;0;.00nan;0;0
3793;76574;50;99;39;1;38;.974;3600000;0
3794;4622;38;45;21;3;18;.857;3586000;0
3794;64722;38;0;0;0;0;.00nan;0;0
3794;75362;57;85;32;2;30;.938;3600000;0
3794;86862;57;0;0;0;0;.00nan;0;0
3795;190106;46;66;37;4;33;.892;3571000;0
3795;43928;39;0;0;0;0;.00nan;0;0
3795;79280;46;0;0;0;0;.00nan;0;0
3795;143301;39;70;28;2;26;.929;3600000;0
3796;163462;55;0;0;0;0;.00nan;0;0
3796;188888;51;0;0;0;0;.00nan;0;0
3796;169154;51;94;55;2;53;.964;3836000;0
3796;86180;55;76;23;1;22;.957;3836000;0
3797;1593;4837;0;0;0;0;.00nan;0;0
3797;176938;62;54;30;4;26;.867;3538000;0
3797;38276;62;0;0;0;0;.00nan;0;0
3797;85546;4837;69;24;2;22;.917;3600000;0
3798;171608;45;0;0;0;0;.00nan;0;0
3798;43731;37;85;27;1;26;.963;3600000;0
3798;85453;37;0;0;0;0;.00nan;0;0
3798;85798;45;93;38;2;36;.947;3600000;0
3799;176860;44;18;8;4;4;.500;362000;0
3799;78479;47;94;19;0;19;1.000;3600000;0
3799;79141;47;0;0;0;0;.00nan;0;0
3799;139467;44;97;26;0;26;1.000;3238000;0
3800;168872;64;0;0;0;0;.00nan;0;0
3800;190106;46;88;28;2;26;.929;3900000;0
3800;79280;46;0;0;0;0;.00nan;0;0
3800;141978;64;97;42;2;40;.952;3900000;0
3801;4622;38;68;39;4;35;.897;3554000;0
3801;175084;65;0;0;0;0;.00nan;0;0
3801;64722;38;0;0;0;0;.00nan;0;0
3801;77084;65;83;31;2;29;.935;3600000;0
3802;187699;41;77;31;3;28;.903;3600000;0
3802;-1;41;0;0;0;0;.00nan;0;0
3802;75362;57;52;33;5;28;.848;3575000;0
3802;86862;57;0;0;0;0;.00nan;0;0
3803;172340;48;0;0;0;0;.00nan;0;0
3803;79132;49;99;25;0;25;1.000;3600000;0
3803;91225;49;0;0;0;0;.00nan;0;0
3803;142492;48;44;23;4;19;.826;3600000;0
3804;163471;63;53;31;4;27;.871;3544000;0
3804;191218;59;0;0;0;0;.00nan;0;0
3804;192457;63;0;0;0;0;.00nan;0;0
3804;58054;59;67;23;2;21;.913;3600000;0
3805;188888;51;0;0;0;0;.00nan;0;0
3805;169154;51;74;41;4;37;.902;3600000;0
3805;38124;58;0;0;0;0;.00nan;0;0
3805;149450;58;89;19;0;19;1.000;3600000;0
3806;183904;43;58;23;3;20;.870;3900000;0
3806;178612;43;0;0;0;0;.00nan;0;0
3806;58100;56;88;42;3;39;.929;3900000;0
3806;85468;56;0;0;0;0;.00nan;0;0
3807;187578;53;24;21;5;16;.762;3600000;0
3807;169323;53;0;0;0;0;.00nan;0;0
3807;75362;57;99;42;2;40;.952;3600000;0
3807;86862;57;0;0;0;0;.00nan;0;0
3808;183904;43;0;0;0;0;.00nan;0;0
3808;178612;43;74;21;1;20;.952;3600000;0
3808;58100;56;72;28;2;26;.929;3562000;0
3808;85468;56;0;0;0;0;.00nan;0;0
3809;168872;64;41;28;5;23;.821;2523000;0
3809;190106;46;77;24;1;23;.958;3600000;0
3809;79280;46;0;0;0;0;.00nan;0;0
3809;141978;64;25;11;4;7;.636;1077000;0
3810;163471;63;59;33;4;29;.879;3600000;0
3810;183783;52;39;31;6;25;.806;3600000;0
3810;180316;52;0;0;0;0;.00nan;0;0
3810;192457;63;0;0;0;0;.00nan;0;0
3811;187699;41;43;42;6;36;.857;3600000;0
3811;173699;36;65;27;4;23;.852;3600000;0
3811;-1;41;0;0;0;0;.00nan;0;0
3811;57434;36;0;0;0;0;.00nan;0;0
3812;172499;50;50;7;1;6;.857;815000;0
3812;189644;42;60;20;3;17;.850;3600000;0
3812;57695;42;0;0;0;0;.00nan;0;0
3812;76574;50;45;39;6;33;.846;2785000;0
3813;175084;65;0;0;0;0;.00nan;0;0
3813;43928;39;0;0;0;0;.00nan;0;0
3813;77084;65;73;30;3;27;.900;3600000;0
3813;143301;39;77;32;2;30;.938;3600000;0
3814;176915;54;73;35;3;32;.914;3878000;0
3814;43731;37;0;0;0;0;.00nan;0;0
3814;85453;37;62;25;3;22;.880;3900000;0
3814;94615;54;0;0;0;0;.00nan;0;0
3815;182780;60;68;14;1;13;.929;3600000;0
3815;178384;40;78;36;2;34;.944;3565000;0
3815;170294;60;0;0;0;0;.00nan;0;0
3815;85636;40;0;0;0;0;.00nan;0;0
3816;179306;61;0;0;0;0;.00nan;0;0
3816;176860;44;75;30;2;28;.933;3600000;0
3816;78581;61;58;23;3;20;.870;3586000;0
3816;139467;44;0;0;0;0;.00nan;0;0
3817;163462;55;0;0;0;0;.00nan;0;0
3817;38124;58;0;0;0;0;.00nan;0;0
3817;86180;55;100;30;0;30;1.000;3600000;0
3817;149450;58;62;36;4;32;.889;3600000;0
3818;187578;53;0;0;0;0;.00nan;0;0
3818;169323;53;66;19;2;17;.895;3900000;0
3818;75362;57;0;0;0;0;.00nan;0;0
3818;86862;57;97;49;2;47;.959;3900000;0
3819;168872;64;0;0;0;0;.00nan;0;0
3819;171608;45;0;0;0;0;.00nan;0;0
3819;85798;45;83;31;1;30;.968;3600000;0
3819;141978;64;84;37;3;34;.919;3600000;0
3820;1593;4837;0;0;0;0;.00nan;0;0
3820;78479;47;66;33;3;30;.909;3550000;0
3820;79141;47;0;0;0;0;.00nan;0;0
3820;85546;4837;89;29;1;28;.966;3600000;0
3821;4622;38;97;19;0;19;1.000;3600000;0
3821;173699;36;97;42;2;40;.952;3545000;0
3821;57434;36;0;0;0;0;.00nan;0;0
3821;64722;38;0;0;0;0;.00nan;0;0
3822;187699;41;0;0;0;0;.00nan;0;0
3822;-1;41;44;39;6;33;.846;3600000;0
3822;191218;59;0;0;0;0;.00nan;0;0
3822;58054;59;92;15;0;15;1.000;3600000;0
3823;172340;48;0;0;0;0;.00nan;0;0
3823;176938;62;81;25;1;24;.960;3600000;0
3823;38276;62;0;0;0;0;.00nan;0;0
3823;142492;48;95;47;2;45;.957;3544000;0
3824;176915;54;48;9;2;7;.778;926000;0
3824;43731;37;73;20;1;19;.950;3600000;0
3824;85453;37;0;0;0;0;.00nan;0;0
3824;94615;54;40;43;6;37;.860;2674000;0
3825;174718;4619;65;18;1;17;.944;3600000;0
3825;191813;4619;0;0;0;0;.00nan;0;0
3825;79132;49;68;44;5;39;.886;3600000;0
3825;91225;49;0;0;0;0;.00nan;0;0
3826;182780;60;0;0;0;0;.00nan;0;0
3826;178384;40;0;0;0;0;.00nan;0;0
3826;170294;60;100;48;0;48;1.000;3600000;0
3826;85636;40;69;30;3;27;.900;3600000;0
3827;179306;61;33;24;5;19;.792;3600000;0
3827;176860;44;0;0;0;0;.00nan;0;0
3827;78581;61;0;0;0;0;.00nan;0;0
3827;139467;44;76;32;3;29;.906;3600000;0
3828;163462;55;0;0;0;0;.00nan;0;0
3828;188888;51;0;0;0;0;.00nan;0;0
3828;169154;51;94;44;3;41;.932;3600000;0
3828;86180;55;96;25;0;25;1.000;3600000;0
3829;163471;63;0;0;0;0;.00nan;0;0
3829;38124;58;48;36;6;30;.833;3600000;0
3829;192457;63;35;18;4;14;.778;3600000;0
3829;149450;58;0;0;0;0;.00nan;0;0
3830;171608;45;0;0;0;0;.00nan;0;0
3830;176915;54;54;41;6;35;.854;3600000;0
3830;85798;45;66;24;2;22;.917;3600000;0
3830;94615;54;0;0;0;0;.00nan;0;0
3831;176938;62;0;0;0;0;.00nan;0;0
3831;38276;62;100;31;0;31;1.000;3600000;0
3831;78479;47;0;0;0;0;.00nan;0;0
3831;79141;47;60;22;2;20;.909;3519000;0
3832;183783;52;0;0;0;0;.00nan;0;0
3832;180316;52;54;33;4;29;.879;3600000;0
3832;43928;39;0;0;0;0;.00nan;0;0
3832;143301;39;45;30;5;25;.833;3574000;0
3833;4622;38;81;29;2;27;.931;3600000;0
3833;191218;59;47;31;5;26;.839;3600000;0
3833;64722;38;0;0;0;0;.00nan;0;0
3833;64911;59;0;0;0;0;.00nan;0;0
3834;172499;50;77;45;3;42;.933;3717000;0
3834;189644;42;0;0;0;0;.00nan;0;0
3834;57695;42;69;19;2;17;.895;3717000;0
3834;76574;50;0;0;0;0;.00nan;0;0
3835;188888;51;34;34;6;28;.824;2711000;0
3835;169154;51;60;7;0;7;1.000;802000;0
3835;175084;65;46;22;4;18;.818;3600000;0
3835;77084;65;0;0;0;0;.00nan;0;0
3836;172499;50;0;0;0;0;.00nan;0;0
3836;171608;45;0;0;0;0;.00nan;0;0
3836;76574;50;57;31;4;27;.871;3600000;0
3836;85798;45;74;22;1;21;.955;3600000;0
3837;168872;64;77;37;3;34;.919;3556000;0
3837;190106;46;81;28;2;26;.929;3600000;0
3837;79280;46;0;0;0;0;.00nan;0;0
3837;141978;64;0;0;0;0;.00nan;0;0
3838;172340;48;0;0;0;0;.00nan;0;0
3838;176860;44;80;28;2;26;.929;3694000;0
3838;139467;44;0;0;0;0;.00nan;0;0
3838;142492;48;65;28;3;25;.893;3694000;0
3839;1593;4837;0;0;0;0;.00nan;0;0
3839;182780;60;0;0;0;0;.00nan;0;0
3839;170294;60;77;31;2;29;.935;3543000;0
3839;85546;4837;79;20;1;19;.950;3600000;0
3840;78479;47;65;21;2;19;.905;3600000;0
3840;79132;49;72;41;4;37;.902;3532000;0
3840;79141;47;0;0;0;0;.00nan;0;0
3840;91225;49;0;0;0;0;.00nan;0;0
3841;189644;42;0;0;0;0;.00nan;0;0
3841;57695;42;69;24;2;22;.917;3600000;0
3841;58054;37;97;44;3;41;.932;3586000;0
3841;85453;37;0;0;0;0;.00nan;0;0
3842;163471;63;73;25;2;23;.920;3600000;0
3842;192457;63;0;0;0;0;.00nan;0;0
3842;58100;56;68;37;5;32;.865;3600000;0
3842;85468;56;0;0;0;0;.00nan;0;0
3843;174718;4619;61;38;5;33;.868;3543000;0
3843;176915;54;28;6;3;3;.500;285000;0
3843;191813;4619;0;0;0;0;.00nan;0;0
3843;94615;54;94;39;1;38;.974;3315000;0
3844;178384;40;81;25;1;24;.960;3600000;0
3844;179306;61;0;0;0;0;.00nan;0;0
3844;78581;61;92;34;2;32;.941;3576000;0
3844;85636;40;0;0;0;0;.00nan;0;0
3845;188888;51;0;0;0;0;.00nan;0;0
3845;169154;51;100;25;0;25;1.000;3600000;0
3845;173699;36;47;35;6;29;.829;3600000;0
3845;57434;36;0;0;0;0;.00nan;0;0
3846;168872;64;0;0;0;0;.00nan;0;0
3846;190106;46;66;34;3;31;.912;3591000;0
3846;79280;46;0;0;0;0;.00nan;0;0
3846;141978;64;81;28;2;26;.929;3600000;0
3847;175084;65;67;29;3;26;.897;3741000;0
3847;43928;39;0;0;0;0;.00nan;0;0
3847;77084;65;0;0;0;0;.00nan;0;0
3847;143301;39;73;30;2;28;.933;3741000;0
3848;172340;48;92;35;2;33;.943;3900000;0
3848;176860;44;0;0;0;0;.00nan;0;0
3848;139467;44;66;22;2;20;.909;3900000;0
3848;142492;48;0;0;0;0;.00nan;0;0
3849;183904;43;70;25;3;22;.880;3600000;0
3849;178612;43;0;0;0;0;.00nan;0;0
3849;38124;58;0;0;0;0;.00nan;0;0
3849;149450;58;57;34;4;30;.882;3542000;0
3850;187699;41;45;36;6;30;.833;3561000;0
3850;-1;41;0;0;0;0;.00nan;0;0
3850;75362;57;30;24;5;19;.792;3600000;0
3850;86862;57;0;0;0;0;.00nan;0;0
3851;1593;4837;0;0;0;0;.00nan;0;0
3851;179306;61;0;0;0;0;.00nan;0;0
3851;78581;61;69;31;3;28;.903;3900000;0
3851;85546;4837;63;35;3;32;.914;3900000;0
3852;183904;43;0;0;0;0;.00nan;0;0
3852;178612;43;100;38;1;37;.974;3600000;0
3852;43928;39;0;0;0;0;.00nan;0;0
3852;143301;39;71;30;3;27;.900;3518000;0
3853;187699;41;0;0;0;0;.00nan;0;0
3853;-1;41;98;60;4;56;.933;3600000;0
3853;75362;57;0;0;0;0;.00nan;0;0
3853;86862;57;75;23;1;22;.957;3600000;0
3854;182780;60;56;25;3;22;.880;3565000;0
3854;170294;60;0;0;0;0;.00nan;0;0
3854;176938;62;0;0;0;0;.00nan;0;0
3854;38276;62;96;33;1;32;.970;3600000;0
3855;187578;53;67;26;3;23;.885;3900000;0
3855;183783;52;86;43;3;40;.930;3900000;0
3855;169323;53;0;0;0;0;.00nan;0;0
3855;180316;52;0;0;0;0;.00nan;0;0
3856;178384;40;62;20;2;18;.900;3900000;0
3856;79132;49;0;0;0;0;.00nan;0;0
3856;85636;40;0;0;0;0;.00nan;0;0
3856;91225;49;69;24;2;22;.917;3900000;0
3857;172499;50;0;0;0;0;.00nan;0;0
3857;58054;37;62;20;2;18;.900;3600000;0
3857;76574;50;75;45;4;41;.911;3564000;0
3857;85453;37;0;0;0;0;.00nan;0;0
3858;173699;36;55;30;4;26;.867;3600000;0
3858;38124;58;51;43;6;37;.860;3567000;0
3858;57434;36;0;0;0;0;.00nan;0;0
3858;149450;58;0;0;0;0;.00nan;0;0
3859;189644;42;0;0;0;0;.00nan;0;0
3859;171608;45;0;0;0;0;.00nan;0;0
3859;57695;42;43;17;3;14;.824;3755000;0
3859;85798;45;100;53;2;51;.962;3755000;0
3860;163471;63;73;33;3;30;.909;3600000;0
3860;175084;65;0;0;0;0;.00nan;0;0
3860;192457;63;0;0;0;0;.00nan;0;0
3860;77084;65;67;35;4;31;.886;3556000;0
3861;174718;4619;68;17;1;16;.941;3600000;0
3861;176915;54;94;50;2;48;.960;3584000;0
3861;191813;4619;0;0;0;0;.00nan;0;0
3861;94615;54;0;0;0;0;.00nan;0;0
3862;4622;38;66;56;6;50;.893;3600000;0
3862;191218;59;0;0;0;0;.00nan;0;0
3862;64722;38;0;0;0;0;.00nan;0;0
3862;64911;59;53;22;3;19;.864;3600000;0
3863;188888;51;0;0;0;0;.00nan;0;0
3863;169154;51;80;29;2;27;.931;3863000;0
3863;58100;56;76;19;1;18;.947;3863000;0
3863;85468;56;0;0;0;0;.00nan;0;0
3864;189644;42;62;20;2;18;.900;3561000;0
3864;171608;45;90;33;1;32;.970;3600000;0
3864;57695;42;0;0;0;0;.00nan;0;0
3864;85798;45;0;0;0;0;.00nan;0;0
3865;1593;4837;0;0;0;0;.00nan;0;0
3865;78479;47;72;24;1;23;.958;3600000;0
3865;79141;47;0;0;0;0;.00nan;0;0
3865;85546;4837;91;39;2;37;.949;3600000;0
3866;182780;60;0;0;0;0;.00nan;0;0
3866;170294;60;76;43;4;39;.907;3825000;0
3866;176938;62;56;22;3;19;.864;3825000;0
3866;38276;62;0;0;0;0;.00nan;0;0
3867;178384;40;0;0;0;0;.00nan;0;0
3867;79132;49;67;25;2;23;.920;3600000;0
3867;85636;40;70;32;3;29;.906;3567000;0
3867;91225;49;0;0;0;0;.00nan;0;0
3868;4622;38;0;0;0;0;.00nan;0;0
3868;175084;65;66;29;2;27;.931;3900000;0
3868;64722;38;99;44;2;42;.955;3900000;0
3868;77084;65;0;0;0;0;.00nan;0;0
3869;172499;50;80;28;1;27;.964;3600000;0
3869;58054;37;81;25;2;23;.920;3600000;0
3869;76574;50;0;0;0;0;.00nan;0;0
3869;85453;37;0;0;0;0;.00nan;0;0
3870;179306;61;0;0;0;0;.00nan;0;0
3870;174718;4619;0;0;0;0;.00nan;0;0
3870;191813;4619;41;31;5;26;.839;3600000;0
3870;78581;61;95;34;1;33;.971;3600000;0
3871;187578;53;0;0;0;0;.00nan;0;0
3871;169323;53;84;36;2;34;.944;3566000;0
3871;191218;59;0;0;0;0;.00nan;0;0
3871;64911;59;87;25;1;24;.960;3600000;0
3872;163471;63;0;0;0;0;.00nan;0;0
3872;188888;51;66;49;6;43;.878;3600000;0
3872;169154;51;0;0;0;0;.00nan;0;0
3872;192457;63;62;26;3;23;.885;3600000;0
3873;163462;55;0;0;0;0;.00nan;0;0
3873;58100;56;61;44;5;39;.886;3600000;0
3873;85468;56;0;0;0;0;.00nan;0;0
3873;86180;55;35;14;4;10;.714;3600000;0
3874;183904;43;33;26;5;21;.808;3600000;0
3874;178612;43;0;0;0;0;.00nan;0;0
3874;43928;39;0;0;0;0;.00nan;0;0
3874;143301;39;25;26;6;20;.769;3571000;0
3875;1593;4837;0;0;0;0;.00nan;0;0
3875;79132;49;31;8;3;5;.625;505000;0
3875;85546;4837;83;27;2;25;.926;3600000;0
3875;91225;49;85;30;2;28;.933;3095000;0
3876;187578;53;51;18;2;16;.889;3548000;0
3876;169323;53;0;0;0;0;.00nan;0;0
3876;175084;65;0;0;0;0;.00nan;0;0
3876;77084;65;87;29;1;28;.966;3600000;0
3877;43928;39;0;0;0;0;.00nan;0;0
3877;58100;56;34;31;6;25;.806;3600000;0
3877;85468;56;0;0;0;0;.00nan;0;0
3877;143301;39;92;31;1;30;.968;3600000;0
3878;174718;4619;43;45;7;38;.844;3600000;0
3878;191813;4619;0;0;0;0;.00nan;0;0
3878;78479;47;80;28;2;26;.929;3600000;0
3878;79141;47;0;0;0;0;.00nan;0;0
3879;4622;38;63;38;5;33;.868;3600000;0
3879;38124;58;0;0;0;0;.00nan;0;0
3879;64722;38;0;0;0;0;.00nan;0;0
3879;149450;58;85;25;1;24;.960;3600000;0
3880;187699;41;0;0;0;0;.00nan;0;0
3880;163462;55;0;0;0;0;.00nan;0;0
3880;-1;41;96;56;4;52;.929;3600000;0
3880;86180;55;76;10;0;10;1.000;3600000;0
3881;189644;42;0;0;0;0;.00nan;0;0
3881;171608;45;0;0;0;0;.00nan;0;0
3881;57695;42;89;26;2;24;.923;3735000;0
3881;85798;45;86;37;3;34;.919;3735000;0
3882;163471;63;45;13;3;10;.769;3600000;0
3882;188888;51;88;26;1;25;.962;2614000;0
3882;169154;51;36;18;4;14;.778;966000;0
3882;192457;63;0;0;0;0;.00nan;0;0
3883;190106;46;54;27;3;24;.889;3600000;0
3883;176915;54;90;48;4;44;.917;3581000;0
3883;79280;46;0;0;0;0;.00nan;0;0
3883;94615;54;0;0;0;0;.00nan;0;0
3884;183783;52;59;42;5;37;.881;3600000;0
3884;180316;52;0;0;0;0;.00nan;0;0
3884;191218;59;0;0;0;0;.00nan;0;0
3884;64911;59;77;20;1;19;.950;3600000;0
3885;183904;43;64;28;3;25;.893;3600000;0
3885;178612;43;0;0;0;0;.00nan;0;0
3885;173699;36;79;44;4;40;.909;3560000;0
3885;57434;36;0;0;0;0;.00nan;0;0
3886;182780;60;0;0;0;0;.00nan;0;0
3886;170294;60;57;24;3;21;.875;3555000;0
3886;176860;44;88;33;2;31;.939;3600000;0
3886;139467;44;0;0;0;0;.00nan;0;0
3887;176938;62;68;22;1;21;.955;2419000;0
3887;38276;62;19;8;4;4;.500;1181000;0
3887;58054;37;86;34;2;32;.941;3600000;0
3887;85453;37;0;0;0;0;.00nan;0;0
3888;172340;48;0;0;0;0;.00nan;0;0
3888;174718;4619;0;0;0;0;.00nan;0;0
3888;191813;4619;82;36;2;34;.944;3600000;0
3888;142492;48;98;56;3;53;.946;3600000;0
3889;1593;4837;0;0;0;0;.00nan;0;0
3889;178384;40;68;43;5;38;.884;3600000;0
3889;85546;4837;42;23;4;19;.826;3600000;0
3889;85636;40;0;0;0;0;.00nan;0;0
3890;182780;60;55;35;5;30;.857;3600000;0
3890;170294;60;0;0;0;0;.00nan;0;0
3890;176860;44;0;0;0;0;.00nan;0;0
3890;139467;44;84;35;2;33;.943;3600000;0
3891;171608;45;0;0;0;0;.00nan;0;0
3891;190106;46;54;15;2;13;.867;3600000;0
3891;79280;46;0;0;0;0;.00nan;0;0
3891;85798;45;64;30;3;27;.900;3598000;0
3892;188888;51;0;0;0;0;.00nan;0;0
3892;169154;51;49;36;5;31;.861;3600000;0
3892;173699;36;90;30;1;29;.967;3600000;0
3892;57434;36;0;0;0;0;.00nan;0;0
3893;172499;50;0;0;0;0;.00nan;0;0
3893;168872;64;76;44;4;40;.909;3578000;0
3893;76574;50;57;18;2;16;.889;3600000;0
3893;141978;64;0;0;0;0;.00nan;0;0
3894;4622;38;54;34;5;29;.853;3900000;0
3894;163471;63;56;34;5;29;.853;3900000;0
3894;192457;63;0;0;0;0;.00nan;0;0
3894;64722;38;0;0;0;0;.00nan;0;0
3895;187578;53;74;28;3;25;.893;3900000;0
3895;169323;53;0;0;0;0;.00nan;0;0
3895;191218;59;77;36;3;33;.917;3900000;0
3895;64911;59;0;0;0;0;.00nan;0;0
3896;179306;61;0;0;0;0;.00nan;0;0
3896;78479;47;99;45;2;43;.956;3600000;0
3896;78581;61;61;30;3;27;.900;3547000;0
3896;79141;47;0;0;0;0;.00nan;0;0
3897;163462;55;0;0;0;0;.00nan;0;0
3897;175084;65;0;0;0;0;.00nan;0;0
3897;77084;65;53;33;4;29;.879;3600000;0
3897;86180;55;100;26;0;26;1.000;3600000;0
3898;38124;58;0;0;0;0;.00nan;0;0
3898;75362;57;72;26;2;24;.923;3521000;0
3898;86862;57;0;0;0;0;.00nan;0;0
3898;149450;58;100;32;0;32;1.000;3600000;0
3899;171608;45;67;22;2;20;.909;3600000;0
3899;58100;56;84;46;3;43;.935;3550000;0
3899;85468;56;0;0;0;0;.00nan;0;0
3899;85798;45;0;0;0;0;.00nan;0;0
3900;187578;53;59;7;0;7;1.000;1361000;0
3900;183783;52;0;0;0;0;.00nan;0;0
3900;169323;53;11;19;6;13;.684;2198000;0
3900;180316;52;74;41;5;36;.878;3600000;0
3901;172340;48;0;0;0;0;.00nan;0;0
3901;79132;49;78;26;2;24;.923;3600000;0
3901;91225;49;0;0;0;0;.00nan;0;0
3901;142492;48;56;26;4;22;.846;3579000;0
3902;176938;62;67;36;3;33;.917;3600000;0
3902;38276;62;0;0;0;0;.00nan;0;0
3902;58054;37;73;37;4;33;.892;3544000;0
3902;85453;37;0;0;0;0;.00nan;0;0
3903;188888;51;0;0;0;0;.00nan;0;0
3903;169154;51;72;40;4;36;.900;3593000;0
3903;173699;36;0;0;0;0;.00nan;0;0
3903;57434;36;61;29;3;26;.897;3600000;0
3904;187699;41;0;0;0;0;.00nan;0;0
3904;4622;38;0;0;0;0;.00nan;0;0
3904;-1;41;92;65;4;61;.938;3600000;0
3904;64722;38;97;31;1;30;.968;3600000;0
3905;189644;42;65;22;2;20;.909;3600000;0
3905;176915;54;51;35;5;30;.857;3600000;0
3905;57695;42;0;0;0;0;.00nan;0;0
3905;94615;54;0;0;0;0;.00nan;0;0
3906;1593;4837;0;0;0;0;.00nan;0;0
3906;178384;40;0;0;0;0;.00nan;0;0
3906;85546;4837;58;26;3;23;.885;3558000;0
3906;85636;40;97;30;1;29;.967;3600000;0
3907;175084;65;0;0;0;0;.00nan;0;0
3907;191218;59;0;0;0;0;.00nan;0;0
3907;64911;59;40;28;5;23;.821;3600000;0
3907;77084;65;91;32;1;31;.969;3600000;0
3908;183904;43;66;25;3;22;.880;3766000;0
3908;178612;43;0;0;0;0;.00nan;0;0
3908;43928;39;0;0;0;0;.00nan;0;0
3908;143301;39;100;47;2;45;.957;3766000;0
3909;179306;61;68;29;2;27;.931;3561000;0
3909;174718;4619;100;31;0;31;1.000;3600000;0
3909;191813;4619;0;0;0;0;.00nan;0;0
3909;78581;61;0;0;0;0;.00nan;0;0
3910;163462;55;0;0;0;0;.00nan;0;0
3910;163471;63;0;0;0;0;.00nan;0;0
3910;192457;63;69;27;2;25;.926;3600000;0
3910;86180;55;69;31;4;27;.871;3581000;0
3911;38124;58;0;0;0;0;.00nan;0;0
3911;75362;57;0;0;0;0;.00nan;0;0
3911;86862;57;54;34;5;29;.853;3600000;0
3911;149450;58;80;31;2;29;.935;3600000;0
3912;190106;46;55;15;2;13;.867;3600000;0
3912;58100;56;94;49;4;45;.918;3560000;0
3912;79280;46;0;0;0;0;.00nan;0;0
3912;85468;56;0;0;0;0;.00nan;0;0
3913;187699;41;66;26;2;24;.923;3600000;0
3913;-1;41;0;0;0;0;.00nan;0;0
3913;75362;57;93;42;4;38;.905;3521000;0
3913;86862;57;0;0;0;0;.00nan;0;0
3914;172499;50;0;0;0;0;.00nan;0;0
3914;168872;64;68;31;2;29;.935;3600000;0
3914;76574;50;85;46;4;42;.913;3544000;0
3914;141978;64;0;0;0;0;.00nan;0;0
3915;172340;48;65;31;3;28;.903;3600000;0
3915;79132;49;81;26;1;25;.962;2879000;0
3915;91225;49;24;15;4;11;.733;638000;0
3915;142492;48;0;0;0;0;.00nan;0;0
3916;189644;42;0;0;0;0;.00nan;0;0
3916;176915;54;0;0;0;0;.00nan;0;0
3916;57695;42;61;19;2;17;.895;3600000;0
3916;94615;54;50;54;8;46;.852;3600000;0
3917;182780;60;0;0;0;0;.00nan;0;0
3917;170294;60;87;39;3;36;.923;3600000;0
3917;78479;47;77;21;1;20;.952;3600000;0
3917;79141;47;0;0;0;0;.00nan;0;0
3918;182780;60;72;48;5;43;.896;3600000;0
3918;170294;60;0;0;0;0;.00nan;0;0
3918;78479;47;60;14;1;13;.929;3600000;0
3918;79141;47;0;0;0;0;.00nan;0;0
3919;168872;64;0;0;0;0;.00nan;0;0
3919;171608;45;0;0;0;0;.00nan;0;0
3919;85798;45;56;25;3;22;.880;3600000;0
3919;141978;64;37;31;6;25;.806;3600000;0
3920;1593;4837;0;0;0;0;.00nan;0;0
3920;176860;44;0;0;0;0;.00nan;0;0
3920;85546;4837;100;35;1;34;.971;3600000;0
3920;139467;44;68;26;2;24;.923;3561000;0
3921;174718;4619;68;29;2;27;.931;3600000;0
3921;191813;4619;0;0;0;0;.00nan;0;0
3921;79132;49;0;0;0;0;.00nan;0;0
3921;91225;49;56;31;4;27;.871;3600000;0
3922;4622;38;100;39;1;38;.974;3600000;0
3922;64722;38;0;0;0;0;.00nan;0;0
3922;75362;57;53;32;4;28;.875;3600000;0
3922;86862;57;0;0;0;0;.00nan;0;0
3923;178384;40;93;38;2;36;.947;3600000;0
3923;179306;61;0;0;0;0;.00nan;0;0
3923;78581;61;48;22;3;19;.864;3521000;0
3923;85636;40;0;0;0;0;.00nan;0;0
3924;43928;39;42;19;4;15;.789;3518000;0
3924;58100;56;100;36;2;34;.944;3600000;0
3924;85468;56;0;0;0;0;.00nan;0;0
3924;143301;39;0;0;0;0;.00nan;0;0
3925;187578;53;54;18;2;16;.889;3600000;0
3925;183783;52;0;0;0;0;.00nan;0;0
3925;169323;53;0;0;0;0;.00nan;0;0
3925;180316;52;66;48;5;43;.896;3600000;0
3926;182780;60;0;0;0;0;.00nan;0;0
3926;170294;60;77;29;2;27;.931;3600000;0
3926;79132;49;74;38;4;34;.895;3521000;0
3926;91225;49;0;0;0;0;.00nan;0;0
3927;171608;45;0;0;0;0;.00nan;0;0
3927;179306;61;0;0;0;0;.00nan;0;0
3927;78581;61;93;26;1;25;.962;3600000;0
3927;85798;45;76;37;4;33;.892;3600000;0
3928;190106;46;67;16;1;15;.938;3543000;0
3928;58054;37;100;36;0;36;1.000;3600000;0
3928;79280;46;0;0;0;0;.00nan;0;0
3928;85453;37;0;0;0;0;.00nan;0;0
3929;189644;42;95;20;0;20;1.000;3600000;0
3929;176938;62;69;40;4;36;.900;3600000;0
3929;38276;62;0;0;0;0;.00nan;0;0
3929;57695;42;0;0;0;0;.00nan;0;0
3930;172340;48;69;27;2;25;.926;3600000;0
3930;178384;40;74;46;4;42;.913;3536000;0
3930;85636;40;0;0;0;0;.00nan;0;0
3930;142492;48;0;0;0;0;.00nan;0;0
3931;163471;63;64;20;1;19;.950;3600000;0
3931;192457;63;0;0;0;0;.00nan;0;0
3931;58100;56;89;44;2;42;.955;3600000;0
3931;85468;56;0;0;0;0;.00nan;0;0
3932;1593;4837;0;0;0;0;.00nan;0;0
3932;174718;4619;99;37;2;35;.946;3600000;0
3932;191813;4619;0;0;0;0;.00nan;0;0
3932;85546;4837;80;43;4;39;.907;3523000;0
3933;38124;58;59;7;0;7;1.000;396000;0
3933;191218;59;75;21;1;20;.952;3600000;0
3933;64911;59;0;0;0;0;.00nan;0;0
3933;149450;58;36;35;6;29;.829;3204000;0
3934;168872;64;0;0;0;0;.00nan;0;0
3934;176915;54;62;30;3;27;.900;3600000;0
3934;94615;54;0;0;0;0;.00nan;0;0
3934;141978;64;41;24;5;19;.792;3591000;0
3935;163462;55;0;0;0;0;.00nan;0;0
3935;173699;36;83;45;4;41;.911;3600000;0
3935;57434;36;0;0;0;0;.00nan;0;0
3935;86180;55;96;31;1;30;.968;3600000;0
3936;187578;53;74;9;0;9;1.000;3600000;0
3936;169323;53;0;0;0;0;.00nan;0;0
3936;75362;57;0;0;0;0;.00nan;0;0
3936;86862;57;53;53;7;46;.868;3600000;0
3937;182780;60;57;20;3;17;.850;3600000;0
3937;170294;60;0;0;0;0;.00nan;0;0
3937;79132;49;0;0;0;0;.00nan;0;0
3937;91225;49;43;32;5;27;.844;3515000;0
3938;171608;45;0;0;0;0;.00nan;0;0
3938;179306;61;62;25;2;23;.920;3600000;0
3938;78581;61;0;0;0;0;.00nan;0;0
3938;85798;45;85;40;3;37;.925;3554000;0
3939;163471;63;58;18;2;16;.889;3600000;0
3939;192457;63;0;0;0;0;.00nan;0;0
3939;58100;56;0;0;0;0;.00nan;0;0
3939;85468;56;58;39;5;34;.872;3600000;0
3940;176860;44;44;38;6;32;.842;3515000;0
3940;78479;47;58;33;4;29;.879;3600000;0
3940;79141;47;0;0;0;0;.00nan;0;0
3940;139467;44;0;0;0;0;.00nan;0;0
3941;4622;38;72;36;3;33;.917;3561000;0
3941;183783;52;0;0;0;0;.00nan;0;0
3941;180316;52;66;20;2;18;.900;3600000;0
3941;64722;38;0;0;0;0;.00nan;0;0
3942;190106;46;0;0;0;0;.00nan;0;0
3942;58054;37;79;41;4;37;.902;3544000;0
3942;79280;46;70;34;3;31;.912;3600000;0
3942;85453;37;0;0;0;0;.00nan;0;0
3943;172499;50;0;0;0;0;.00nan;0;0
3943;183904;43;100;25;0;25;1.000;3600000;0
3943;178612;43;0;0;0;0;.00nan;0;0
3943;76574;50;83;55;5;50;.909;3600000;0
3944;189644;42;0;0;0;0;.00nan;0;0
3944;176938;62;0;0;0;0;.00nan;0;0
3944;38276;62;69;30;2;28;.933;3900000;0
3944;57695;42;80;32;2;30;.938;3900000;0
3945;172340;48;0;0;0;0;.00nan;0;0
3945;178384;40;67;41;5;36;.878;3600000;0
3945;85636;40;0;0;0;0;.00nan;0;0
3945;142492;48;91;35;1;34;.971;3600000;0
3946;1593;4837;0;0;0;0;.00nan;0;0
3946;174718;4619;0;0;0;0;.00nan;0;0
3946;191813;4619;63;25;3;22;.880;3559000;0
3946;85546;4837;99;49;2;47;.959;3600000;0
3947;175084;65;31;10;3;7;.700;460000;0
3947;191218;59;0;0;0;0;.00nan;0;0
3947;64911;59;60;24;3;21;.875;3600000;0
3947;77084;65;51;18;3;15;.833;3140000;0
3948;168872;64;99;37;1;36;.973;3600000;0
3948;176915;54;0;0;0;0;.00nan;0;0
3948;94615;54;71;29;2;27;.931;3584000;0
3948;141978;64;0;0;0;0;.00nan;0;0
3949;188888;51;0;0;0;0;.00nan;0;0
3949;169154;51;88;37;2;35;.946;3555000;0
3949;43928;39;0;0;0;0;.00nan;0;0
3949;143301;39;89;15;0;15;1.000;3600000;0
3950;187699;41;0;0;0;0;.00nan;0;0
3950;-1;41;65;44;5;39;.886;3600000;0
3950;38124;58;70;18;1;17;.944;3600000;0
3950;149450;58;0;0;0;0;.00nan;0;0
3951;187578;53;59;19;2;17;.895;3600000;0
3951;169323;53;0;0;0;0;.00nan;0;0
3951;75362;57;50;34;5;29;.853;3600000;0
3951;86862;57;0;0;0;0;.00nan;0;0
3952;176860;44;53;3;0;3;1.000;499000;0
3952;78479;47;0;0;0;0;.00nan;0;0
3952;79141;47;70;22;2;20;.909;3600000;0
3952;139467;44;39;35;6;29;.829;3101000;0
3953;187699;41;79;40;4;36;.900;3600000;0
3953;4622;38;0;0;0;0;.00nan;0;0
3953;-1;41;0;0;0;0;.00nan;0;0
3953;64722;38;57;18;2;16;.889;3600000;0
3954;172499;50;71;39;4;35;.897;3600000;0
3954;183904;43;31;27;5;22;.815;3553000;0
3954;178612;43;0;0;0;0;.00nan;0;0
3954;76574;50;0;0;0;0;.00nan;0;0
3955;175084;65;74;33;4;29;.879;3900000;0
3955;191218;59;53;21;3;18;.857;3900000;0
3955;64911;59;0;0;0;0;.00nan;0;0
3955;77084;65;0;0;0;0;.00nan;0;0
3956;188888;51;75;33;2;31;.939;3600000;0
3956;169154;51;0;0;0;0;.00nan;0;0
3956;43928;39;0;0;0;0;.00nan;0;0
3956;143301;39;72;19;1;18;.947;3600000;0
3957;163462;55;0;0;0;0;.00nan;0;0
3957;173699;36;94;37;3;34;.919;3600000;0
3957;57434;36;0;0;0;0;.00nan;0;0
3957;86180;55;61;18;2;16;.889;3600000;0
3958;183783;52;84;34;3;31;.912;3675000;0
3958;180316;52;0;0;0;0;.00nan;0;0
3958;38124;58;0;0;0;0;.00nan;0;0
3958;149450;58;51;28;4;24;.857;3675000;0
3959;172340;48;72;46;5;41;.891;3546000;0
3959;178384;40;50;22;4;18;.818;3600000;0
3959;85636;40;0;0;0;0;.00nan;0;0
3959;142492;48;0;0;0;0;.00nan;0;0
3960;172499;50;0;0;0;0;.00nan;0;0
3960;183904;43;68;22;2;20;.909;3600000;0
3960;178612;43;0;0;0;0;.00nan;0;0
3960;76574;50;85;48;4;44;.917;3600000;0
3961;187578;53;32;35;7;28;.800;3600000;0
3961;169323;53;0;0;0;0;.00nan;0;0
3961;191218;59;0;0;0;0;.00nan;0;0
3961;64911;59;29;19;5;14;.737;3600000;0
3962;189644;42;0;0;0;0;.00nan;0;0
3962;190106;46;64;32;3;29;.906;3600000;0
3962;57695;42;100;33;0;33;1.000;3600000;0
3962;79280;46;0;0;0;0;.00nan;0;0
3963;163462;55;0;0;0;0;.00nan;0;0
3963;173699;36;99;42;2;40;.952;3900000;0
3963;57434;36;0;0;0;0;.00nan;0;0
3963;86180;55;97;43;2;41;.953;3900000;0
3964;174718;4619;87;39;2;37;.949;3600000;0
3964;191813;4619;0;0;0;0;.00nan;0;0
3964;78479;47;32;30;6;24;.800;2912000;0
3964;79141;47;60;5;0;5;1.000;688000;0
3965;182780;60;81;23;0;23;1.000;3019000;0
3965;172340;48;53;30;4;26;.867;3546000;0
3965;170294;60;38;12;3;9;.750;581000;0
3965;142492;48;0;0;0;0;.00nan;0;0
3966;179306;61;0;0;0;0;.00nan;0;0
3966;176860;44;100;37;0;37;1.000;3600000;0
3966;78581;61;76;30;2;28;.933;3514000;0
3966;139467;44;0;0;0;0;.00nan;0;0
3967;182780;60;0;0;0;0;.00nan;0;0
3967;172340;48;0;0;0;0;.00nan;0;0
3967;170294;60;65;35;4;31;.886;3566000;0
3967;142492;48;62;28;3;25;.893;3600000;0
3968;163471;63;74;38;3;35;.921;3600000;0
3968;192457;63;0;0;0;0;.00nan;0;0
3968;75362;57;0;0;0;0;.00nan;0;0
3968;86862;57;63;34;4;30;.882;3564000;0
3969;176938;62;57;41;5;36;.878;3600000;0
3969;38276;62;0;0;0;0;.00nan;0;0
3969;78479;47;78;33;2;31;.939;3600000;0
3969;79141;47;0;0;0;0;.00nan;0;0
3970;190106;46;65;18;1;17;.944;3600000;0
3970;176915;54;39;35;6;29;.829;3287000;0
3970;79280;46;0;0;0;0;.00nan;0;0
3970;94615;54;41;2;1;1;.500;313000;0
3971;189644;42;70;14;1;13;.929;3600000;0
3971;57695;42;0;0;0;0;.00nan;0;0
3971;79132;49;66;46;5;41;.891;3600000;0
3971;91225;49;0;0;0;0;.00nan;0;0
3972;172499;50;0;0;0;0;.00nan;0;0
3972;173699;36;48;31;5;26;.839;3600000;0
3972;57434;36;0;0;0;0;.00nan;0;0
3972;76574;50;80;14;0;14;1.000;3600000;0
3973;187699;41;95;56;5;51;.911;3559000;0
3973;183783;52;41;17;3;14;.824;3600000;0
3973;-1;41;0;0;0;0;.00nan;0;0
3973;180316;52;0;0;0;0;.00nan;0;0
3974;175084;65;0;0;0;0;.00nan;0;0
3974;38124;58;0;0;0;0;.00nan;0;0
3974;77084;65;45;22;4;18;.818;3600000;0
3974;149450;58;63;19;2;17;.895;3600000;0
3975;174718;4619;67;27;3;24;.889;3541000;0
3975;191813;4619;0;0;0;0;.00nan;0;0
3975;58054;37;98;40;1;39;.975;3600000;0
3975;85453;37;0;0;0;0;.00nan;0;0
3976;1593;4837;0;0;0;0;.00nan;0;0
3976;178384;40;90;42;4;38;.905;3600000;0
3976;85546;4837;78;13;0;13;1.000;3600000;0
3976;85636;40;0;0;0;0;.00nan;0;0
3977;188888;51;0;0;0;0;.00nan;0;0
3977;169154;51;59;44;7;37;.841;3600000;0
3977;191218;59;0;0;0;0;.00nan;0;0
3977;64911;59;80;13;0;13;1.000;3600000;0
3978;183904;43;45;24;4;20;.833;3669000;0
3978;178612;43;0;0;0;0;.00nan;0;0
3978;43928;39;0;0;0;0;.00nan;0;0
3978;143301;39;58;39;5;34;.872;3669000;0
3979;163462;55;0;0;0;0;.00nan;0;0
3979;58100;56;81;33;2;31;.939;3600000;0
3979;85468;56;0;0;0;0;.00nan;0;0
3979;86180;55;50;27;4;23;.852;3513000;0
3980;179306;61;0;0;0;0;.00nan;0;0
3980;176860;44;69;31;3;28;.903;3600000;0
3980;78581;61;50;23;4;19;.826;3542000;0
3980;139467;44;0;0;0;0;.00nan;0;0
3981;1593;4837;0;0;0;0;.00nan;0;0
3981;178384;40;100;45;2;43;.956;3600000;0
3981;85546;4837;46;18;3;15;.833;3563000;0
3981;85636;40;0;0;0;0;.00nan;0;0
3982;187578;53;72;26;2;24;.923;3543000;0
3982;169323;53;0;0;0;0;.00nan;0;0
3982;38124;58;100;31;0;31;1.000;3600000;0
3982;149450;58;0;0;0;0;.00nan;0;0
3983;163471;63;74;41;4;37;.902;3900000;0
3983;192457;63;0;0;0;0;.00nan;0;0
3983;75362;57;68;34;4;30;.882;3900000;0
3983;86862;57;0;0;0;0;.00nan;0;0
3984;176938;62;0;0;0;0;.00nan;0;0
3984;38276;62;73;39;4;35;.897;3600000;0
3984;78479;47;0;0;0;0;.00nan;0;0
3984;79141;47;100;33;1;32;.970;3600000;0
3985;190106;46;0;0;0;0;.00nan;0;0
3985;176915;54;0;0;0;0;.00nan;0;0
3985;79280;46;77;31;3;28;.903;3600000;0
3985;94615;54;67;43;5;38;.884;3593000;0
3986;183783;52;0;0;0;0;.00nan;0;0
3986;175084;65;79;41;3;38;.927;3538000;0
3986;180316;52;77;23;1;22;.957;3600000;0
3986;77084;65;0;0;0;0;.00nan;0;0
3987;189644;42;0;0;0;0;.00nan;0;0
3987;57695;42;98;21;0;21;1.000;3600000;0
3987;79132;49;71;49;6;43;.878;3118000;0
3987;91225;49;28;8;3;5;.625;482000;0
3988;172499;50;51;29;5;24;.828;3600000;0
3988;173699;36;84;29;1;28;.966;3600000;0
3988;57434;36;0;0;0;0;.00nan;0;0
3988;76574;50;0;0;0;0;.00nan;0;0
3989;187699;41;0;0;0;0;.00nan;0;0
3989;4622;38;100;19;0;19;1.000;3600000;0
3989;-1;41;64;32;4;28;.875;3600000;0
3989;64722;38;0;0;0;0;.00nan;0;0
3990;174718;4619;70;28;2;26;.929;3797000;0
3990;191813;4619;0;0;0;0;.00nan;0;0
3990;58054;37;90;41;3;38;.927;3797000;0
3990;85453;37;0;0;0;0;.00nan;0;0
3991;188888;51;62;33;4;29;.879;3600000;0
3991;169154;51;0;0;0;0;.00nan;0;0
3991;58100;56;95;24;0;24;1.000;3600000;0
3991;85468;56;0;0;0;0;.00nan;0;0
3992;168872;64;0;0;0;0;.00nan;0;0
3992;171608;45;39;14;3;11;.786;1261000;0
3992;85798;45;54;37;5;32;.865;2339000;0
3992;141978;64;62;27;4;23;.852;3600000;0
3993;163462;55;0;0;0;0;.00nan;0;0
3993;191218;59;0;0;0;0;.00nan;0;0
3993;64911;59;52;39;5;34;.872;3900000;0
3993;86180;55;72;49;5;44;.898;3900000;0
3994;183904;43;77;29;1;28;.966;3600000;0
3994;178612;43;0;0;0;0;.00nan;0;0
3994;43928;39;0;0;0;0;.00nan;0;0
3994;143301;39;65;30;3;27;.900;3522000;0
3995;187578;53;78;23;2;21;.913;3600000;0
3995;169323;53;0;0;0;0;.00nan;0;0
3995;175084;65;68;26;2;24;.923;2458000;0
3995;77084;65;26;13;4;9;.692;1142000;0
3996;168872;64;59;36;4;32;.889;3562000;0
3996;171608;45;0;0;0;0;.00nan;0;0
3996;85798;45;47;23;3;20;.870;3600000;0
3996;141978;64;0;0;0;0;.00nan;0;0
3997;187578;53;0;0;0;0;.00nan;0;0
3997;4622;38;53;43;5;38;.884;3600000;0
3997;169323;53;76;21;1;20;.952;3600000;0
3997;64722;38;0;0;0;0;.00nan;0;0
3998;78479;47;57;15;2;13;.867;3900000;0
3998;79132;49;100;50;2;48;.960;3900000;0
3998;79141;47;0;0;0;0;.00nan;0;0
3998;91225;49;0;0;0;0;.00nan;0;0
3999;38124;58;71;18;1;17;.944;3600000;0
3999;191218;59;44;21;3;18;.857;3522000;0
3999;64911;59;0;0;0;0;.00nan;0;0
3999;149450;58;0;0;0;0;.00nan;0;0
4000;163462;55;0;0;0;0;.00nan;0;0
4000;188888;51;0;0;0;0;.00nan;0;0
4000;169154;51;69;41;3;38;.927;3900000;0
4000;86180;55;84;33;3;30;.909;3900000;0
4001;179306;61;0;0;0;0;.00nan;0;0
4001;58054;37;73;38;3;35;.921;3600000;0
4001;78581;61;60;32;4;28;.875;3598000;0
4001;85453;37;0;0;0;0;.00nan;0;0
4002;172340;48;70;35;4;31;.886;3600000;0
4002;176860;44;78;22;1;21;.955;3600000;0
4002;139467;44;0;0;0;0;.00nan;0;0
4002;142492;48;0;0;0;0;.00nan;0;0
4003;178384;40;43;20;4;16;.800;3578000;0
4003;75362;57;0;0;0;0;.00nan;0;0
4003;85636;40;0;0;0;0;.00nan;0;0
4003;86862;57;84;31;2;29;.935;3600000;0
4004;1593;4837;0;0;0;0;.00nan;0;0
4004;176938;62;87;36;2;34;.944;3600000;0
4004;38276;62;0;0;0;0;.00nan;0;0
4004;85546;4837;53;23;3;20;.870;3546000;0
4005;172340;48;0;0;0;0;.00nan;0;0
4005;176860;44;49;33;5;28;.848;3600000;0
4005;139467;44;0;0;0;0;.00nan;0;0
4005;142492;48;88;31;2;29;.935;3600000;0
4006;178384;40;78;32;2;30;.938;3600000;0
4006;75362;57;35;19;4;15;.789;1139000;0
4006;85636;40;0;0;0;0;.00nan;0;0
4006;86862;57;75;19;1;18;.947;2461000;0
4007;78479;47;54;12;1;11;.917;3544000;0
4007;79132;49;100;66;0;66;1.000;3600000;0
4007;79141;47;0;0;0;0;.00nan;0;0
4007;91225;49;0;0;0;0;.00nan;0;0
4008;1593;4837;0;0;0;0;.00nan;0;0
4008;176938;62;0;0;0;0;.00nan;0;0
4008;38276;62;56;22;3;19;.864;3600000;0
4008;85546;4837;46;33;5;28;.848;3541000;0
4009;187699;41;62;25;2;23;.920;1309000;0
4009;163471;63;62;14;1;13;.929;3600000;0
4009;-1;41;35;26;5;21;.808;2291000;0
4009;192457;63;0;0;0;0;.00nan;0;0
4010;179306;61;0;0;0;0;.00nan;0;0
4010;58054;37;100;34;1;33;.971;3600000;0
4010;78581;61;64;30;3;27;.900;3528000;0
4010;85453;37;0;0;0;0;.00nan;0;0
4011;163462;55;0;0;0;0;.00nan;0;0
4011;183904;43;99;24;0;24;1.000;3600000;0
4011;178612;43;0;0;0;0;.00nan;0;0
4011;86180;55;54;35;4;31;.886;3600000;0
4012;175084;65;0;0;0;0;.00nan;0;0
4012;38124;58;0;0;0;0;.00nan;0;0
4012;77084;65;86;16;0;16;1.000;3600000;0
4012;149450;58;91;45;2;43;.956;3569000;0
4013;187699;41;46;44;6;38;.864;2952000;0
4013;-1;41;54;4;0;4;1.000;648000;0
4013;58100;56;73;9;0;9;1.000;3600000;0
4013;85468;56;0;0;0;0;.00nan;0;0
4014;182780;60;0;0;0;0;.00nan;0;0
4014;170294;60;65;35;4;31;.886;3600000;0
4014;78479;47;72;19;1;18;.947;3600000;0
4014;79141;47;0;0;0;0;.00nan;0;0
4015;4622;38;55;39;5;34;.872;3600000;0
4015;183783;52;0;0;0;0;.00nan;0;0
4015;180316;52;89;26;1;25;.962;3600000;0
4015;64722;38;0;0;0;0;.00nan;0;0
4016;183904;43;41;22;4;18;.818;3566000;0
4016;178612;43;0;0;0;0;.00nan;0;0
4016;173699;36;90;36;2;34;.944;3600000;0
4016;57434;36;0;0;0;0;.00nan;0;0
4017;172499;50;0;0;0;0;.00nan;0;0
4017;190106;46;60;22;2;20;.909;3553000;0
4017;76574;50;97;33;1;32;.970;3600000;0
4017;79280;46;0;0;0;0;.00nan;0;0
4018;168872;64;68;37;3;34;.919;3532000;0
4018;189644;42;77;25;1;24;.960;3600000;0
4018;57695;42;0;0;0;0;.00nan;0;0
4018;141978;64;0;0;0;0;.00nan;0;0
4019;171608;45;0;0;0;0;.00nan;0;0
4019;176915;54;64;35;3;32;.914;3900000;0
4019;85798;45;75;39;3;36;.923;3893000;0
4019;94615;54;0;0;0;0;.00nan;0;0
4020;188888;51;0;0;0;0;.00nan;0;0
4020;169154;51;89;69;6;63;.913;3600000;0
4020;175084;65;0;0;0;0;.00nan;0;0
4020;77084;65;91;19;0;19;1.000;3600000;0
4021;179306;61;75;23;1;22;.957;3600000;0
4021;78581;61;0;0;0;0;.00nan;0;0
4021;79132;49;92;53;4;49;.925;3600000;0
4021;91225;49;0;0;0;0;.00nan;0;0
4022;163462;55;0;0;0;0;.00nan;0;0
4022;163471;63;67;30;3;27;.900;3600000;0
4022;192457;63;0;0;0;0;.00nan;0;0
4022;86180;55;76;29;2;27;.931;3600000;0
4023;174718;4619;85;37;2;35;.946;3600000;0
4023;176860;44;62;27;3;24;.889;3571000;0
4023;191813;4619;0;0;0;0;.00nan;0;0
4023;139467;44;0;0;0;0;.00nan;0;0
4024;1593;4837;61;22;2;20;.909;3600000;0
4024;182780;60;93;44;3;41;.932;3600000;0
4024;170294;60;0;0;0;0;.00nan;0;0
4024;85546;4837;0;0;0;0;.00nan;0;0
4025;183904;43;0;0;0;0;.00nan;0;0
4025;178612;43;83;25;1;24;.960;3900000;0
4025;173699;36;100;35;1;34;.971;3900000;0
4025;57434;36;0;0;0;0;.00nan;0;0
4026;187578;53;41;16;3;13;.813;3589000;0
4026;183783;52;95;38;2;36;.947;3600000;0
4026;169323;53;0;0;0;0;.00nan;0;0
4026;180316;52;0;0;0;0;.00nan;0;0
4027;43928;39;0;0;0;0;.00nan;0;0
4027;75362;57;0;0;0;0;.00nan;0;0
4027;86862;57;62;33;4;29;.879;3600000;0
4027;143301;39;79;27;1;26;.963;3600000;0
4028;187699;41;0;0;0;0;.00nan;0;0
4028;-1;41;72;41;3;38;.927;3678000;0
4028;58100;56;63;18;2;16;.889;3678000;0
4028;85468;56;0;0;0;0;.00nan;0;0
4029;178384;40;66;45;5;40;.889;3550000;0
4029;176938;62;0;0;0;0;.00nan;0;0
4029;38276;62;46;23;4;19;.826;3600000;0
4029;85636;40;0;0;0;0;.00nan;0;0
4030;4622;38;0;0;0;0;.00nan;0;0
4030;38124;58;0;0;0;0;.00nan;0;0
4030;64722;38;69;36;3;33;.917;3600000;0
4030;149450;58;45;26;4;22;.846;3600000;0
4031;172499;50;39;37;6;31;.838;3600000;0
4031;190106;46;0;0;0;0;.00nan;0;0
4031;76574;50;0;0;0;0;.00nan;0;0
4031;79280;46;61;17;1;16;.941;3600000;0
4032;168872;64;0;0;0;0;.00nan;0;0
4032;189644;42;0;0;0;0;.00nan;0;0
4032;57695;42;69;22;2;20;.909;3600000;0
4032;141978;64;68;45;5;40;.889;3600000;0
4033;172340;48;54;39;5;34;.872;3579000;0
4033;78479;47;0;0;0;0;.00nan;0;0
4033;79141;47;78;40;4;36;.900;3600000;0
4033;142492;48;0;0;0;0;.00nan;0;0
4034;163471;63;0;0;0;0;.00nan;0;0
4034;191218;59;0;0;0;0;.00nan;0;0
4034;192457;63;78;48;4;44;.917;3545000;0
4034;64911;59;36;13;3;10;.769;3600000;0
4035;176915;54;0;0;0;0;.00nan;0;0
4035;58054;37;77;24;1;23;.958;3600000;0
4035;85453;37;0;0;0;0;.00nan;0;0
4035;94615;54;68;44;4;40;.909;3600000;0
4036;163462;55;0;0;0;0;.00nan;0;0
4036;188888;51;97;45;2;43;.956;3569000;0
4036;169154;51;0;0;0;0;.00nan;0;0
4036;86180;55;83;30;1;29;.967;3600000;0
4037;179306;61;0;0;0;0;.00nan;0;0
4037;78581;61;61;24;3;21;.875;3600000;0
4037;79132;49;30;33;6;27;.818;2925000;0
4037;91225;49;54;10;1;9;.900;675000;0
4038;174718;4619;76;26;1;25;.962;3600000;0
4038;176860;44;0;0;0;0;.00nan;0;0
4038;191813;4619;0;0;0;0;.00nan;0;0
4038;139467;44;66;30;3;27;.900;3600000;0
4039;43928;39;100;21;0;21;1.000;3600000;0
4039;75362;57;98;51;3;48;.941;3600000;0
4039;86862;57;0;0;0;0;.00nan;0;0
4039;143301;39;0;0;0;0;.00nan;0;0
4040;178384;40;95;47;3;44;.936;3514000;0
4040;176938;62;77;22;1;21;.955;3600000;0
4040;38276;62;0;0;0;0;.00nan;0;0
4040;85636;40;0;0;0;0;.00nan;0;0
4041;1593;4837;0;0;0;0;.00nan;0;0
4041;172340;48;0;0;0;0;.00nan;0;0
4041;85546;4837;44;32;5;27;.844;3513000;0
4041;142492;48;95;43;3;40;.930;3600000;0
4042;187578;53;98;41;2;39;.951;3900000;0
4042;169323;53;0;0;0;0;.00nan;0;0
4042;175084;65;0;0;0;0;.00nan;0;0
4042;77084;65;68;28;2;26;.929;3900000;0
4043;38124;58;67;32;3;29;.906;3538000;0
4043;191218;59;88;28;1;27;.964;3600000;0
4043;64911;59;0;0;0;0;.00nan;0;0
4043;149450;58;0;0;0;0;.00nan;0;0
4044;168872;64;0;0;0;0;.00nan;0;0
4044;58054;37;74;19;1;18;.947;3600000;0
4044;85453;37;0;0;0;0;.00nan;0;0
4044;141978;64;80;34;2;32;.941;3594000;0
4045;172499;50;0;0;0;0;.00nan;0;0
4045;171608;45;62;13;1;12;.923;1513000;0
4045;76574;50;91;24;1;23;.958;3600000;0
4045;85798;45;41;28;5;23;.821;2087000;0
4046;170314;4619;0;0;0;0;.00nan;0;0
4046;176860;44;93;37;2;35;.946;3600000;0
4046;191813;4619;50;30;4;26;.867;3569000;0
4046;139467;44;0;0;0;0;.00nan;0;0
4047;43928;39;81;15;0;15;1.000;3600000;0
4047;58100;56;64;37;4;33;.892;3600000;0
4047;85468;56;0;0;0;0;.00nan;0;0
4047;143301;39;0;0;0;0;.00nan;0;0
4048;190106;46;67;21;1;20;.952;3600000;0
4048;176915;54;0;0;0;0;.00nan;0;0
4048;79280;46;0;0;0;0;.00nan;0;0
4048;94615;54;91;40;2;38;.950;3582000;0
4049;78479;47;90;18;0;18;1.000;3600000;0
4049;79132;49;68;28;2;26;.929;3600000;0
4049;79141;47;0;0;0;0;.00nan;0;0
4049;91225;49;0;0;0;0;.00nan;0;0
4050;4622;38;80;34;2;32;.941;3600000;0
4050;191218;59;0;0;0;0;.00nan;0;0
4050;64722;38;0;0;0;0;.00nan;0;0
4050;64911;59;70;30;3;27;.900;3600000;0
4051;168872;64;60;39;6;33;.846;2797000;0
4051;58054;37;65;18;2;16;.889;3600000;0
4051;85453;37;0;0;0;0;.00nan;0;0
4051;141978;64;57;5;0;5;1.000;803000;0
4052;163462;55;0;0;0;0;.00nan;0;0
4052;173699;36;72;31;2;29;.935;3600000;0
4052;57434;36;0;0;0;0;.00nan;0;0
4052;86180;55;68;36;4;32;.889;3572000;0
4053;172499;50;59;30;3;27;.900;3578000;0
4053;171608;45;0;0;0;0;.00nan;0;0
4053;76574;50;0;0;0;0;.00nan;0;0
4053;85798;45;82;23;1;22;.957;3600000;0
4054;183904;43;88;34;1;33;.971;3600000;0
4054;178612;43;0;0;0;0;.00nan;0;0
4054;189644;42;43;30;5;25;.833;3600000;0
4054;57695;42;0;0;0;0;.00nan;0;0
4055;1593;4837;0;0;0;0;.00nan;0;0
4055;178384;40;94;43;2;41;.953;3600000;0
4055;85546;4837;40;34;6;28;.824;3600000;0
4055;85636;40;0;0;0;0;.00nan;0;0
4056;183783;52;0;0;0;0;.00nan;0;0
4056;180316;52;100;29;0;29;1.000;3600000;0
4056;38124;58;0;0;0;0;.00nan;0;0
4056;149450;58;60;33;4;29;.879;3600000;0
4057;1593;4837;0;0;0;0;.00nan;0;0
4057;176860;44;59;30;3;27;.900;3549000;0
4057;85546;4837;86;35;2;33;.943;3600000;0
4057;139467;44;0;0;0;0;.00nan;0;0
4058;183783;52;82;27;1;26;.963;3600000;0
4058;180316;52;0;0;0;0;.00nan;0;0
4058;58100;56;94;34;2;32;.941;3543000;0
4058;85468;56;0;0;0;0;.00nan;0;0
4059;183904;43;76;30;2;28;.933;3600000;0
4059;178612;43;0;0;0;0;.00nan;0;0
4059;190106;46;54;30;4;26;.867;3537000;0
4059;79280;46;0;0;0;0;.00nan;0;0
4060;176938;62;92;19;0;19;1.000;3600000;0
4060;38276;62;0;0;0;0;.00nan;0;0
4060;79132;49;87;58;4;54;.931;3600000;0
4060;91225;49;0;0;0;0;.00nan;0;0
4061;170314;4619;28;35;7;28;.800;3600000;0
4061;191813;4619;0;0;0;0;.00nan;0;0
4061;58054;37;94;30;1;29;.967;3600000;0
4061;85453;37;0;0;0;0;.00nan;0;0
4062;187699;41;75;33;2;31;.939;3547000;0
4062;-1;41;0;0;0;0;.00nan;0;0
4062;38124;58;0;0;0;0;.00nan;0;0
4062;149450;58;79;24;1;23;.958;3600000;0
4063;189644;42;54;19;3;16;.842;3600000;0
4063;176915;54;65;51;5;46;.902;3567000;0
4063;57695;42;0;0;0;0;.00nan;0;0
4063;94615;54;0;0;0;0;.00nan;0;0
4064;187578;53;44;28;5;23;.821;3600000;0
4064;169323;53;0;0;0;0;.00nan;0;0
4064;175084;65;52;27;4;23;.852;2388000;0
4064;77084;65;45;8;2;6;.750;1212000;0
4065;163462;55;0;0;0;0;.00nan;0;0
4065;163471;63;90;41;2;39;.951;3600000;0
4065;192457;63;0;0;0;0;.00nan;0;0
4065;86180;55;58;26;3;23;.885;3596000;0
4066;182780;60;0;0;0;0;.00nan;0;0
4066;178384;40;90;33;2;31;.939;3900000;0
4066;170294;60;62;23;2;21;.913;3900000;0
4066;85636;40;0;0;0;0;.00nan;0;0
4067;191218;59;0;0;0;0;.00nan;0;0
4067;64911;59;61;20;3;17;.850;3613000;0
4067;75362;57;79;41;4;37;.902;3613000;0
4067;86862;57;0;0;0;0;.00nan;0;0
4068;188888;51;0;0;0;0;.00nan;0;0
4068;169154;51;70;32;3;29;.906;3600000;0
4068;173699;36;100;36;0;36;1.000;3600000;0
4068;57434;36;0;0;0;0;.00nan;0;0
4069;168872;64;0;0;0;0;.00nan;0;0
4069;78479;47;16;17;6;11;.647;2292000;0
4069;79141;47;47;12;2;10;.833;1308000;0
4069;141978;64;64;31;4;27;.871;3600000;0
4070;172340;48;31;10;3;7;.700;376000;0
4070;179306;61;0;0;0;0;.00nan;0;0
4070;78581;61;56;27;3;24;.889;3600000;0
4070;142492;48;83;30;2;28;.933;3155000;0
4071;1593;4837;51;42;5;37;.881;3600000;0
4071;176860;44;79;25;2;23;.920;3600000;0
4071;85546;4837;0;0;0;0;.00nan;0;0
4071;139467;44;0;0;0;0;.00nan;0;0
4072;187578;53;0;0;0;0;.00nan;0;0
4072;169323;53;84;40;3;37;.925;3555000;0
4072;175084;65;0;0;0;0;.00nan;0;0
4072;77084;65;67;15;1;14;.933;3600000;0
4073;189644;42;0;0;0;0;.00nan;0;0
4073;171608;45;0;0;0;0;.00nan;0;0
4073;57695;42;55;21;3;18;.857;3634000;0
4073;85798;45;100;48;2;46;.958;3634000;0
4074;183783;52;0;0;0;0;.00nan;0;0
4074;180316;52;57;19;2;17;.895;3600000;0
4074;58100;56;27;40;8;32;.800;3600000;0
4074;85468;56;0;0;0;0;.00nan;0;0
4075;183904;43;50;39;6;33;.846;3181000;0
4075;178612;43;56;4;0;4;1.000;419000;0
4075;190106;46;0;0;0;0;.00nan;0;0
4075;79280;46;55;15;2;13;.867;3600000;0
4076;176938;62;66;17;1;16;.941;3600000;0
4076;38276;62;0;0;0;0;.00nan;0;0
4076;79132;49;96;44;2;42;.955;3577000;0
4076;91225;49;0;0;0;0;.00nan;0;0
4077;170314;4619;65;46;5;41;.891;3600000;0
4077;191813;4619;0;0;0;0;.00nan;0;0
4077;58054;37;70;27;2;25;.926;3600000;0
4077;85453;37;0;0;0;0;.00nan;0;0
4078;187699;41;0;0;0;0;.00nan;0;0
4078;-1;41;53;47;6;41;.872;3600000;0
4078;43928;39;82;26;1;25;.962;3600000;0
4078;143301;39;0;0;0;0;.00nan;0;0
4079;163471;63;0;0;0;0;.00nan;0;0
4079;173699;36;50;34;5;29;.853;3102000;0
4079;192457;63;68;31;3;28;.903;3600000;0
4079;57434;36;58;5;0;5;1.000;498000;0
4080;172499;50;0;0;0;0;.00nan;0;0
4080;176915;54;0;0;0;0;.00nan;0;0
4080;76574;50;71;27;3;24;.889;3562000;0
4080;94615;54;75;30;2;28;.933;3600000;0
4081;182780;60;85;24;1;23;.958;3600000;0
4081;178384;40;0;0;0;0;.00nan;0;0
4081;170294;60;0;0;0;0;.00nan;0;0
4081;85636;40;68;37;4;33;.892;3600000;0
4082;191218;59;84;27;1;26;.963;3600000;0
4082;64911;59;0;0;0;0;.00nan;0;0
4082;75362;57;0;0;0;0;.00nan;0;0
4082;86862;57;81;47;4;43;.915;3600000;0
4083;168872;64;41;29;5;24;.828;3600000;0
4083;78479;47;76;25;1;24;.960;3600000;0
4083;79141;47;0;0;0;0;.00nan;0;0
4083;141978;64;0;0;0;0;.00nan;0;0
4084;172340;48;87;40;3;37;.925;3745000;0
4084;179306;61;56;27;4;23;.852;3745000;0
4084;78581;61;0;0;0;0;.00nan;0;0
4084;142492;48;0;0;0;0;.00nan;0;0
4085;163462;55;44;11;2;9;.818;3600000;0
4085;188888;51;66;31;3;28;.903;3600000;0
4085;169154;51;0;0;0;0;.00nan;0;0
4085;86180;55;0;0;0;0;.00nan;0;0
4086;4622;38;100;35;0;35;1.000;3600000;0
4086;38124;58;63;36;4;32;.889;3600000;0
4086;64722;38;0;0;0;0;.00nan;0;0
4086;149450;58;0;0;0;0;.00nan;0;0
4087;172499;50;56;26;3;23;.885;3600000;0
4087;171608;45;54;34;4;30;.882;3600000;0
4087;76574;50;0;0;0;0;.00nan;0;0
4087;85798;45;0;0;0;0;.00nan;0;0
4088;4622;38;83;36;2;34;.944;3600000;0
4088;43928;39;0;0;0;0;.00nan;0;0
4088;64722;38;0;0;0;0;.00nan;0;0
4088;143301;39;67;34;4;30;.882;3533000;0
4089;175084;65;61;35;4;31;.886;3600000;0
4089;75362;57;50;33;5;28;.848;3544000;0
4089;77084;65;0;0;0;0;.00nan;0;0
4089;86862;57;0;0;0;0;.00nan;0;0
4090;170314;4619;30;30;6;24;.800;2389000;0
4090;189644;42;45;24;4;20;.833;3600000;0
4090;191813;4619;56;12;1;11;.917;1211000;0
4090;57695;42;0;0;0;0;.00nan;0;0
4091;172340;48;0;0;0;0;.00nan;0;0
4091;176938;62;65;23;1;22;.957;3900000;0
4091;38276;62;0;0;0;0;.00nan;0;0
4091;142492;48;99;39;1;38;.974;3900000;0
4092;172499;50;0;0;0;0;.00nan;0;0
4092;176915;54;0;0;0;0;.00nan;0;0
4092;76574;50;58;30;4;26;.867;3900000;0
4092;94615;54;81;37;3;34;.919;3900000;0
4093;1593;4837;0;0;0;0;.00nan;0;0
4093;179306;61;0;0;0;0;.00nan;0;0
4093;78581;61;54;30;5;25;.833;3523000;0
4093;85546;4837;73;36;3;33;.917;3600000;0
4094;187578;53;88;23;1;22;.957;3600000;0
4094;169323;53;0;0;0;0;.00nan;0;0
4094;191218;59;0;0;0;0;.00nan;0;0
4094;64911;59;71;26;3;23;.885;3517000;0
4095;182780;60;50;25;4;21;.840;2687000;0
4095;170294;60;14;13;5;8;.615;913000;0
4095;78479;47;74;23;1;22;.957;3600000;0
4095;79141;47;0;0;0;0;.00nan;0;0
4096;183783;52;67;25;2;23;.920;3600000;0
4096;180316;52;0;0;0;0;.00nan;0;0
4096;75362;57;79;35;3;32;.914;3544000;0
4096;86862;57;0;0;0;0;.00nan;0;0
4097;163462;55;0;0;0;0;.00nan;0;0
4097;173699;36;59;40;6;34;.850;3123000;0
4097;57434;36;67;10;0;10;1.000;477000;0
4097;86180;55;43;26;4;22;.846;3600000;0
4098;187699;41;82;49;3;46;.939;3600000;0
4098;4622;38;65;26;2;24;.923;3600000;0
4098;-1;41;0;0;0;0;.00nan;0;0
4098;64722;38;0;0;0;0;.00nan;0;0
4099;163471;63;64;23;2;21;.913;3600000;0
4099;188888;51;0;0;0;0;.00nan;0;0
4099;169154;51;61;52;6;46;.885;3600000;0
4099;192457;63;0;0;0;0;.00nan;0;0
4100;38124;58;0;0;0;0;.00nan;0;0
4100;43928;39;0;0;0;0;.00nan;0;0
4100;143301;39;68;27;3;24;.889;3577000;0
4100;149450;58;100;33;1;32;.970;3600000;0
4101;171608;45;0;0;0;0;.00nan;0;0
4101;58100;56;65;16;1;15;.938;3559000;0
4101;85468;56;0;0;0;0;.00nan;0;0
4101;85798;45;88;22;0;22;1.000;3600000;0
4102;178384;40;89;39;3;36;.923;3900000;0
4102;176860;44;73;31;3;28;.903;3900000;0
4102;85636;40;0;0;0;0;.00nan;0;0
4102;139467;44;0;0;0;0;.00nan;0;0
4103;187578;53;67;25;2;23;.920;3600000;0
4103;169323;53;0;0;0;0;.00nan;0;0
4103;191218;59;0;0;0;0;.00nan;0;0
4103;64911;59;56;26;3;23;.885;3572000;0
4104;175084;65;0;0;0;0;.00nan;0;0
4104;75362;57;0;0;0;0;.00nan;0;0
4104;77084;65;80;13;0;13;1.000;3600000;0
4104;86862;57;81;37;3;34;.919;3600000;0
4105;182780;60;0;0;0;0;.00nan;0;0
4105;170294;60;53;34;5;29;.853;3600000;0
4105;78479;47;0;0;0;0;.00nan;0;0
4105;79141;47;100;38;0;38;1.000;3600000;0
4106;183783;52;47;19;3;16;.842;3600000;0
4106;180316;52;0;0;0;0;.00nan;0;0
4106;38124;58;0;0;0;0;.00nan;0;0
4106;149450;58;43;36;6;30;.833;3600000;0
4107;58054;37;73;23;1;22;.957;3600000;0
4107;79132;49;98;46;2;44;.957;3595000;0
4107;85453;37;0;0;0;0;.00nan;0;0
4107;91225;49;0;0;0;0;.00nan;0;0
4108;163471;63;67;29;3;26;.897;3559000;0
4108;173699;36;99;34;1;33;.971;3600000;0
4108;192457;63;0;0;0;0;.00nan;0;0
4108;57434;36;0;0;0;0;.00nan;0;0
4109;187699;41;85;52;4;48;.923;3566000;0
4109;4622;38;51;21;3;18;.857;3600000;0
4109;-1;41;0;0;0;0;.00nan;0;0
4109;64722;38;0;0;0;0;.00nan;0;0
4110;172499;50;0;0;0;0;.00nan;0;0
4110;189644;42;58;17;3;14;.824;3600000;0
4110;57695;42;0;0;0;0;.00nan;0;0
4110;76574;50;85;49;4;45;.918;3600000;0
4111;172340;48;66;30;3;27;.900;3595000;0
4111;176938;62;81;22;1;21;.955;3600000;0
4111;38276;62;0;0;0;0;.00nan;0;0
4111;142492;48;0;0;0;0;.00nan;0;0
4112;190106;46;80;14;0;14;1.000;3600000;0
4112;176915;54;0;0;0;0;.00nan;0;0
4112;79280;46;0;0;0;0;.00nan;0;0
4112;94615;54;46;38;5;33;.868;3600000;0
4113;170314;4619;100;38;1;37;.974;3600000;0
4113;179306;61;0;0;0;0;.00nan;0;0
4113;191813;4619;0;0;0;0;.00nan;0;0
4113;78581;61;42;25;4;21;.840;3600000;0
4114;188888;51;0;0;0;0;.00nan;0;0
4114;183904;43;82;29;2;27;.931;3600000;0
4114;178612;43;0;0;0;0;.00nan;0;0
4114;169154;51;91;44;3;41;.932;3547000;0
4115;1593;4837;0;0;0;0;.00nan;0;0
4115;168872;64;50;15;2;13;.867;2502000;0
4115;85546;4837;70;36;3;33;.917;3600000;0
4115;141978;64;38;23;4;19;.826;1098000;0
4116;163462;55;0;0;0;0;.00nan;0;0
4116;43928;39;0;0;0;0;.00nan;0;0
4116;86180;55;81;33;2;31;.939;3600000;0
4116;143301;39;58;28;3;25;.893;3582000;0
4117;178384;40;0;0;0;0;.00nan;0;0
4117;176860;44;77;22;1;21;.955;3600000;0
4117;85636;40;67;38;4;34;.895;3600000;0
4117;139467;44;0;0;0;0;.00nan;0;0
4118;175084;65;0;0;0;0;.00nan;0;0
4118;75362;57;100;49;1;48;.980;3600000;0
4118;77084;65;70;23;2;21;.913;3544000;0
4118;86862;57;0;0;0;0;.00nan;0;0
4119;171608;45;0;0;0;0;.00nan;0;0
4119;58100;56;98;34;1;33;.971;3600000;0
4119;85468;56;0;0;0;0;.00nan;0;0
4119;85798;45;83;30;2;28;.933;3557000;0
4120;179306;61;70;31;2;29;.935;3600000;0
4120;78479;47;0;0;0;0;.00nan;0;0
4120;78581;61;0;0;0;0;.00nan;0;0
4120;79141;47;68;30;3;27;.900;3576000;0
4121;183783;52;0;0;0;0;.00nan;0;0
4121;180316;52;71;39;4;35;.897;3600000;0
4121;191218;59;0;0;0;0;.00nan;0;0
4121;64911;59;44;32;6;26;.813;3537000;0
4122;58054;37;92;27;1;26;.963;3900000;0
4122;79132;49;0;0;0;0;.00nan;0;0
4122;85453;37;0;0;0;0;.00nan;0;0
4122;91225;49;89;30;1;29;.967;3900000;0
4123;187578;53;45;13;2;11;.846;3543000;0
4123;4622;38;0;0;0;0;.00nan;0;0
4123;169323;53;0;0;0;0;.00nan;0;0
4123;64722;38;84;30;1;29;.967;3600000;0
4124;163471;63;48;32;5;27;.844;3600000;0
4124;173699;36;0;0;0;0;.00nan;0;0
4124;192457;63;0;0;0;0;.00nan;0;0
4124;57434;36;95;35;1;34;.971;3600000;0
4125;187699;41;0;0;0;0;.00nan;0;0
4125;-1;41;68;37;3;34;.919;3600000;0
4125;38124;58;73;8;0;8;1.000;3600000;0
4125;149450;58;0;0;0;0;.00nan;0;0
4126;182780;60;100;43;2;41;.953;3900000;0
4126;172340;48;0;0;0;0;.00nan;0;0
4126;170294;60;0;0;0;0;.00nan;0;0
4126;142492;48;77;29;2;27;.931;3900000;0
4127;172499;50;0;0;0;0;.00nan;0;0
4127;176915;54;73;25;1;24;.960;3900000;0
4127;76574;50;99;36;1;35;.972;3900000;0
4127;94615;54;0;0;0;0;.00nan;0;0
4128;170314;4619;91;35;1;34;.971;3600000;0
4128;176938;62;66;30;3;27;.900;3524000;0
4128;38276;62;0;0;0;0;.00nan;0;0
4128;191813;4619;0;0;0;0;.00nan;0;0
4129;188888;51;70;26;2;24;.923;3600000;0
4129;183904;43;0;0;0;0;.00nan;0;0
4129;178612;43;71;21;1;20;.952;3600000;0
4129;169154;51;0;0;0;0;.00nan;0;0
4130;1593;4837;0;0;0;0;.00nan;0;0
4130;168872;64;0;0;0;0;.00nan;0;0
4130;85546;4837;70;31;3;28;.903;3600000;0
4130;141978;64;54;48;7;41;.854;3600000;0
4131;163462;55;79;40;4;36;.900;3900000;0
4131;43928;39;60;37;4;33;.892;3900000;0
4131;86180;55;0;0;0;0;.00nan;0;0
4131;143301;39;0;0;0;0;.00nan;0;0
4132;1593;4837;0;0;0;0;.00nan;0;0
4132;178384;40;91;47;4;43;.915;3528000;0
4132;85546;4837;62;18;2;16;.889;3600000;0
4132;85636;40;0;0;0;0;.00nan;0;0
4133;163462;55;0;0;0;0;.00nan;0;0
4133;183904;43;58;38;5;33;.868;3541000;0
4133;178612;43;0;0;0;0;.00nan;0;0
4133;86180;55;85;44;3;41;.932;3600000;0
4134;182780;60;74;43;4;39;.907;3600000;0
4134;170294;60;0;0;0;0;.00nan;0;0
4134;170314;4619;77;25;1;24;.960;3600000;0
4134;191813;4619;0;0;0;0;.00nan;0;0
4135;58100;56;28;26;5;21;.808;2304000;0
4135;75362;57;0;0;0;0;.00nan;0;0
4135;85468;56;59;7;0;7;1.000;1296000;0
4135;86862;57;55;14;2;12;.857;3600000;0
4136;176860;44;89;38;2;36;.947;3600000;0
4136;176938;62;0;0;0;0;.00nan;0;0
4136;38276;62;59;36;5;31;.861;3587000;0
4136;139467;44;0;0;0;0;.00nan;0;0
4137;172499;50;0;0;0;0;.00nan;0;0
4137;190106;46;58;17;1;16;.941;3600000;0
4137;76574;50;78;30;2;28;.933;3600000;0
4137;79280;46;0;0;0;0;.00nan;0;0
4138;187578;53;78;29;2;27;.931;3653000;0
4138;183783;52;71;23;1;22;.957;3653000;0
4138;169323;53;0;0;0;0;.00nan;0;0
4138;180316;52;0;0;0;0;.00nan;0;0
4139;179306;61;0;0;0;0;.00nan;0;0
4139;58054;37;0;0;0;0;.00nan;0;0
4139;78581;61;69;21;2;19;.905;3600000;0
4139;85453;37;44;32;6;26;.813;3600000;0
4140;187699;41;87;49;3;46;.939;3566000;0
4140;-1;41;0;0;0;0;.00nan;0;0
4140;38124;58;81;24;1;23;.958;3600000;0
4140;149450;58;0;0;0;0;.00nan;0;0
4141;172340;48;53;15;2;13;.867;3600000;0
4141;79132;49;59;34;4;30;.882;3559000;0
4141;91225;49;0;0;0;0;.00nan;0;0
4141;142492;48;0;0;0;0;.00nan;0;0
4142;4622;38;86;37;2;35;.946;3600000;0
4142;175084;65;0;0;0;0;.00nan;0;0
4142;64722;38;0;0;0;0;.00nan;0;0
4142;77084;65;50;34;5;29;.853;3600000;0
4143;163471;63;71;28;2;26;.929;3600000;0
4143;188888;51;0;0;0;0;.00nan;0;0
4143;169154;51;92;44;3;41;.932;3582000;0
4143;192457;63;0;0;0;0;.00nan;0;0
4144;168872;64;0;0;0;0;.00nan;0;0
4144;176915;54;0;0;0;0;.00nan;0;0
4144;94615;54;70;31;3;28;.903;3516000;0
4144;141978;64;95;33;1;32;.970;3600000;0
4145;173699;36;54;31;4;27;.871;3573000;0
4145;43928;39;0;0;0;0;.00nan;0;0
4145;57434;36;0;0;0;0;.00nan;0;0
4145;143301;39;65;24;2;22;.917;3600000;0
4146;163462;55;52;37;6;31;.838;3600000;0
4146;183904;43;0;0;0;0;.00nan;0;0
4146;178612;43;57;17;2;15;.882;3600000;0
4146;86180;55;0;0;0;0;.00nan;0;0
4147;187578;53;0;0;0;0;.00nan;0;0
4147;187699;41;0;0;0;0;.00nan;0;0
4147;169323;53;80;14;0;14;1.000;3600000;0
4147;-1;41;74;42;3;39;.929;3600000;0
4148;182780;60;0;0;0;0;.00nan;0;0
4148;170294;60;68;39;4;35;.897;3900000;0
4148;170314;4619;66;31;4;27;.871;3900000;0
4148;191813;4619;0;0;0;0;.00nan;0;0
4149;78479;47;60;18;2;16;.889;3600000;0
4149;79132;49;76;41;4;37;.902;3600000;0
4149;79141;47;0;0;0;0;.00nan;0;0
4149;91225;49;0;0;0;0;.00nan;0;0
4150;176860;44;87;41;3;38;.927;3875000;0
4150;176938;62;92;38;2;36;.947;3875000;0
4150;38276;62;0;0;0;0;.00nan;0;0
4150;139467;44;0;0;0;0;.00nan;0;0
4151;172499;50;0;0;0;0;.00nan;0;0
4151;190106;46;0;0;0;0;.00nan;0;0
4151;76574;50;87;44;3;41;.932;3900000;0
4151;79280;46;46;16;3;13;.813;3900000;0
4152;183783;52;0;0;0;0;.00nan;0;0
4152;175084;65;44;25;4;21;.840;3050000;0
4152;180316;52;91;32;1;31;.969;3600000;0
4152;77084;65;50;3;0;3;1.000;550000;0
4153;179306;61;90;22;0;22;1.000;3600000;0
4153;58054;37;97;36;1;35;.972;3573000;0
4153;78581;61;0;0;0;0;.00nan;0;0
4153;85453;37;0;0;0;0;.00nan;0;0
4154;168872;64;44;32;5;27;.844;3600000;0
4154;189644;42;0;0;0;0;.00nan;0;0
4154;57695;42;27;27;6;21;.778;3588000;0
4154;141978;64;0;0;0;0;.00nan;0;0
4155;171608;45;0;0;0;0;.00nan;0;0
4155;176915;54;60;23;3;20;.870;3569000;0
4155;85798;45;86;30;2;28;.933;3600000;0
4155;94615;54;0;0;0;0;.00nan;0;0
4156;1593;4837;0;0;0;0;.00nan;0;0
4156;178384;40;0;0;0;0;.00nan;0;0
4156;85546;4837;90;31;2;29;.935;3585000;0
4156;85636;40;81;25;1;24;.960;3600000;0
4157;4622;38;0;0;0;0;.00nan;0;0
4157;191218;59;0;0;0;0;.00nan;0;0
4157;64722;38;69;47;5;42;.894;3568000;0
4157;64911;59;38;15;3;12;.800;3600000;0
4158;163471;63;66;24;2;22;.917;3600000;0
4158;188888;51;100;50;1;49;.980;3600000;0
4158;169154;51;0;0;0;0;.00nan;0;0
4158;192457;63;0;0;0;0;.00nan;0;0
4159;173699;36;92;66;3;63;.955;3728000;0
4159;43928;39;75;31;2;29;.935;3728000;0
4159;57434;36;0;0;0;0;.00nan;0;0
4159;143301;39;0;0;0;0;.00nan;0;0
4160;58100;56;82;23;1;22;.957;3600000;0
4160;75362;57;0;0;0;0;.00nan;0;0
4160;85468;56;0;0;0;0;.00nan;0;0
4160;86862;57;36;27;5;22;.815;3600000;0
4161;182780;60;69;23;2;21;.913;3600000;0
4161;172499;50;0;0;0;0;.00nan;0;0
4161;170294;60;0;0;0;0;.00nan;0;0
4161;76574;50;86;40;3;37;.925;3551000;0
4162;190106;46;41;24;4;20;.833;3600000;0
4162;58100;56;96;46;3;43;.935;3600000;0
4162;79280;46;0;0;0;0;.00nan;0;0
4162;85468;56;0;0;0;0;.00nan;0;0
4163;1593;4837;0;0;0;0;.00nan;0;0
4163;176938;62;88;34;4;30;.882;3600000;0
4163;38276;62;0;0;0;0;.00nan;0;0
4163;85546;4837;39;25;5;20;.800;3582000;0
4164;189644;42;37;21;4;17;.810;3555000;0
4164;171608;45;0;0;0;0;.00nan;0;0
4164;57695;42;0;0;0;0;.00nan;0;0
4164;85798;45;72;30;3;27;.900;3600000;0
4165;168872;64;0;0;0;0;.00nan;0;0
4165;176915;54;0;0;0;0;.00nan;0;0
4165;94615;54;47;26;4;22;.846;3600000;0
4165;141978;64;84;34;2;32;.941;3600000;0
4166;188888;51;0;0;0;0;.00nan;0;0
4166;183904;43;92;22;0;22;1.000;3600000;0
4166;178612;43;0;0;0;0;.00nan;0;0
4166;169154;51;98;55;2;53;.964;3525000;0
4167;182780;60;0;0;0;0;.00nan;0;0
4167;172499;50;0;0;0;0;.00nan;0;0
4167;170294;60;38;28;5;23;.821;3600000;0
4167;76574;50;64;17;1;16;.941;3600000;0
4168;1593;4837;0;0;0;0;.00nan;0;0
4168;176938;62;0;0;0;0;.00nan;0;0
4168;38276;62;97;37;1;36;.973;3600000;0
4168;85546;4837;50;28;4;24;.857;3600000;0
4169;187699;41;0;0;0;0;.00nan;0;0
4169;4622;38;92;15;0;15;1.000;3600000;0
4169;-1;41;98;48;2;46;.958;3600000;0
4169;64722;38;0;0;0;0;.00nan;0;0
4170;178384;40;86;52;5;47;.904;3600000;0
4170;170314;4619;74;26;1;25;.962;3600000;0
4170;191813;4619;0;0;0;0;.00nan;0;0
4170;85636;40;0;0;0;0;.00nan;0;0
4171;38124;58;0;0;0;0;.00nan;0;0
4171;43928;39;0;0;0;0;.00nan;0;0
4171;143301;39;77;40;4;36;.900;3600000;0
4171;149450;58;38;30;6;24;.800;3562000;0
4172;163462;55;0;0;0;0;.00nan;0;0
4172;163471;63;55;32;4;28;.875;3557000;0
4172;192457;63;0;0;0;0;.00nan;0;0
4172;86180;55;87;35;2;33;.943;3600000;0
4173;178384;40;0;0;0;0;.00nan;0;0
4173;78479;47;78;22;1;21;.955;3600000;0
4173;79141;47;0;0;0;0;.00nan;0;0
4173;85636;40;94;39;3;36;.923;3569000;0
4174;183904;43;63;29;3;26;.897;3549000;0
4174;178612;43;0;0;0;0;.00nan;0;0
4174;43928;39;0;0;0;0;.00nan;0;0
4174;143301;39;83;33;2;31;.939;3600000;0
4175;190106;46;43;21;4;17;.810;3564000;0
4175;58100;56;93;45;3;42;.933;3600000;0
4175;79280;46;0;0;0;0;.00nan;0;0
4175;85468;56;0;0;0;0;.00nan;0;0
4176;183783;52;67;34;3;31;.912;3900000;0
4176;173699;36;69;32;3;29;.906;3900000;0
4176;180316;52;0;0;0;0;.00nan;0;0
4176;57434;36;0;0;0;0;.00nan;0;0
4177;187578;53;0;0;0;0;.00nan;0;0
4177;169323;53;99;35;1;34;.971;3600000;0
4177;175084;65;0;0;0;0;.00nan;0;0
4177;77084;65;49;24;4;20;.833;3600000;0
4178;163471;63;69;27;2;25;.926;3900000;0
4178;38124;58;0;0;0;0;.00nan;0;0
4178;192457;63;0;0;0;0;.00nan;0;0
4178;149450;58;88;35;2;33;.943;3900000;0
4179;171608;45;36;8;2;6;.750;1503000;0
4179;176915;54;55;32;5;27;.844;3600000;0
4179;85798;45;1;17;7;10;.588;2097000;0
4179;94615;54;0;0;0;0;.00nan;0;0
4180;168872;64;0;0;0;0;.00nan;0;0
4180;58054;37;73;27;2;25;.926;3600000;0
4180;85453;37;0;0;0;0;.00nan;0;0
4180;141978;64;97;50;3;47;.940;3549000;0
4181;172340;48;65;40;5;35;.875;3617000;0
4181;179306;61;21;21;6;15;.714;3622000;0
4181;78581;61;0;0;0;0;.00nan;0;0
4181;142492;48;0;0;0;0;.00nan;0;0
4182;182780;60;93;41;2;39;.951;3600000;0
4182;170294;60;0;0;0;0;.00nan;0;0
4182;176860;44;27;21;5;16;.762;3600000;0
4182;139467;44;0;0;0;0;.00nan;0;0
4183;1593;4837;0;0;0;0;.00nan;0;0
4183;178384;40;62;51;6;45;.882;3286000;0
4183;85546;4837;50;27;5;22;.815;3600000;0
4183;85636;40;52;3;0;3;1.000;314000;0
4184;187578;53;73;27;2;25;.926;3629000;0
4184;183783;52;0;0;0;0;.00nan;0;0
4184;169323;53;0;0;0;0;.00nan;0;0
4184;180316;52;78;40;3;37;.925;3629000;0
4185;191218;59;0;0;0;0;.00nan;0;0
4185;64911;59;67;24;3;21;.875;3677000;0
4185;75362;57;100;56;2;54;.964;3677000;0
4185;86862;57;0;0;0;0;.00nan;0;0
4186;171608;45;0;0;0;0;.00nan;0;0
4186;58100;56;57;16;2;14;.875;3600000;0
4186;85468;56;0;0;0;0;.00nan;0;0
4186;85798;45;48;31;4;27;.871;3540000;0
4187;176938;62;63;29;3;26;.897;3855000;0
4187;38276;62;0;0;0;0;.00nan;0;0
4187;78479;47;85;34;2;32;.941;3855000;0
4187;79141;47;0;0;0;0;.00nan;0;0
4188;187699;41;66;34;4;30;.882;3600000;0
4188;188888;51;0;0;0;0;.00nan;0;0
4188;169154;51;46;19;3;16;.842;3600000;0
4188;-1;41;0;0;0;0;.00nan;0;0
4189;172499;50;0;0;0;0;.00nan;0;0
4189;189644;42;59;24;2;22;.917;3814000;0
4189;57695;42;0;0;0;0;.00nan;0;0
4189;76574;50;77;39;3;36;.923;3814000;0
4190;190106;46;0;0;0;0;.00nan;0;0
4190;176915;54;0;0;0;0;.00nan;0;0
4190;79280;46;67;22;2;20;.909;3600000;0
4190;94615;54;82;63;5;58;.921;3600000;0
4191;170314;4619;46;25;4;21;.840;3600000;0
4191;191813;4619;0;0;0;0;.00nan;0;0
4191;79132;49;71;30;3;27;.900;3600000;0
4191;91225;49;0;0;0;0;.00nan;0;0
4192;168872;64;73;31;2;29;.935;3600000;0
4192;58054;37;0;0;0;0;.00nan;0;0
4192;85453;37;52;34;5;29;.853;3600000;0
4192;141978;64;0;0;0;0;.00nan;0;0
4193;4622;38;78;37;3;34;.919;3513000;0
4193;43928;39;86;25;1;24;.960;3600000;0
4193;64722;38;0;0;0;0;.00nan;0;0
4193;143301;39;0;0;0;0;.00nan;0;0
4194;172340;48;0;0;0;0;.00nan;0;0
4194;179306;61;52;20;3;17;.850;2664000;0
4194;78581;61;9;9;5;4;.444;936000;0
4194;142492;48;78;42;4;38;.905;3600000;0
4195;163462;55;0;0;0;0;.00nan;0;0
4195;183904;43;57;11;1;10;.909;661000;0
4195;178612;43;32;38;6;32;.842;2939000;0
4195;86180;55;100;30;0;30;1.000;3600000;0
4196;173699;36;84;45;3;42;.933;3900000;0
4196;38124;58;60;27;3;24;.889;3900000;0
4196;57434;36;0;0;0;0;.00nan;0;0
4196;149450;58;0;0;0;0;.00nan;0;0
4197;1593;4837;40;23;4;19;.826;2044000;0
4197;176938;62;0;0;0;0;.00nan;0;0
4197;38276;62;72;31;3;28;.903;3600000;0
4197;85546;4837;49;16;2;14;.875;1556000;0
4198;187578;53;0;0;0;0;.00nan;0;0
4198;169323;53;91;19;0;19;1.000;3600000;0
4198;173699;36;60;38;5;33;.868;3600000;0
4198;57434;36;0;0;0;0;.00nan;0;0
4199;191218;59;48;19;3;16;.842;3600000;0
4199;64911;59;0;0;0;0;.00nan;0;0
4199;75362;57;0;0;0;0;.00nan;0;0
4199;86862;57;46;51;8;43;.843;3600000;0
4200;171608;45;0;0;0;0;.00nan;0;0
4200;58100;56;71;16;1;15;.938;3600000;0
4200;85468;56;0;0;0;0;.00nan;0;0
4200;85798;45;59;37;5;32;.865;3600000;0
4201;78479;47;0;0;0;0;.00nan;0;0
4201;79132;49;60;38;4;34;.895;3593000;0
4201;79141;47;65;25;3;22;.880;3600000;0
4201;91225;49;0;0;0;0;.00nan;0;0
4202;183783;52;44;32;5;27;.844;3749000;0
4202;175084;65;72;37;4;33;.892;3749000;0
4202;180316;52;0;0;0;0;.00nan;0;0
4202;77084;65;0;0;0;0;.00nan;0;0
4203;163462;55;0;0;0;0;.00nan;0;0
4203;163471;63;0;0;0;0;.00nan;0;0
4203;192457;63;89;34;2;32;.941;3600000;0
4203;86180;55;64;27;3;24;.889;3600000;0
4204;182780;60;0;0;0;0;.00nan;0;0
4204;170294;60;47;34;6;28;.824;3600000;0
4204;176860;44;49;19;3;16;.842;3600000;0
4204;139467;44;0;0;0;0;.00nan;0;0
4205;4622;38;99;39;1;38;.974;3763000;0
4205;183904;43;64;23;2;21;.913;3763000;0
4205;178612;43;0;0;0;0;.00nan;0;0
4205;64722;38;0;0;0;0;.00nan;0;0
4206;176915;54;0;0;0;0;.00nan;0;0
4206;58054;37;33;26;5;21;.808;3600000;0
4206;85453;37;0;0;0;0;.00nan;0;0
4206;94615;54;100;38;1;37;.974;3600000;0
4207;172499;50;0;0;0;0;.00nan;0;0
4207;189644;42;57;15;2;13;.867;3600000;0
4207;57695;42;0;0;0;0;.00nan;0;0
4207;76574;50;98;63;5;58;.921;3600000;0
4208;163471;63;95;37;2;35;.946;3663000;0
4208;43928;39;0;0;0;0;.00nan;0;0
4208;192457;63;0;0;0;0;.00nan;0;0
4208;143301;39;65;30;3;27;.900;3663000;0
4209;1593;4837;0;0;0;0;.00nan;0;0
4209;170314;4619;81;44;3;41;.932;3600000;0
4209;191813;4619;0;0;0;0;.00nan;0;0
4209;85546;4837;69;24;2;22;.917;3600000;0
4210;168872;64;0;0;0;0;.00nan;0;0
4210;190106;46;95;33;2;31;.939;3600000;0
4210;79280;46;0;0;0;0;.00nan;0;0
4210;141978;64;49;30;4;26;.867;3562000;0
4211;187578;53;0;0;0;0;.00nan;0;0
4211;183783;52;0;0;0;0;.00nan;0;0
4211;169323;53;69;31;3;28;.903;3600000;0
4211;180316;52;100;43;2;41;.953;3600000;0
4212;176915;54;0;0;0;0;.00nan;0;0
4212;58054;37;62;12;1;11;.917;3600000;0
4212;85453;37;0;0;0;0;.00nan;0;0
4212;94615;54;68;50;5;45;.900;3600000;0
4213;4622;38;77;52;6;46;.885;3600000;0
4213;173699;36;71;31;3;28;.903;3600000;0
4213;57434;36;0;0;0;0;.00nan;0;0
4213;64722;38;0;0;0;0;.00nan;0;0
4214;172340;48;88;41;3;38;.927;3600000;0
4214;176860;44;100;33;0;33;1.000;3600000;0
4214;139467;44;0;0;0;0;.00nan;0;0
4214;142492;48;0;0;0;0;.00nan;0;0
4215;163471;63;76;28;2;26;.929;3600000;0
4215;183904;43;68;35;3;32;.914;3600000;0
4215;178612;43;0;0;0;0;.00nan;0;0
4215;192457;63;0;0;0;0;.00nan;0;0
4216;178384;40;98;39;2;37;.949;3600000;0
4216;78479;47;59;29;3;26;.897;3585000;0
4216;79141;47;0;0;0;0;.00nan;0;0
4216;85636;40;0;0;0;0;.00nan;0;0
4217;187699;41;82;43;3;40;.930;3578000;0
4217;-1;41;0;0;0;0;.00nan;0;0
4217;38124;58;0;0;0;0;.00nan;0;0
4217;149450;58;53;15;2;13;.867;3600000;0
4218;189644;42;71;23;2;21;.913;3900000;0
4218;171608;45;0;0;0;0;.00nan;0;0
4218;57695;42;0;0;0;0;.00nan;0;0
4218;85798;45;97;43;2;41;.953;3900000;0
4219;176938;62;39;16;4;12;.750;3600000;0
4219;38276;62;0;0;0;0;.00nan;0;0
4219;79132;49;56;44;5;39;.886;3600000;0
4219;91225;49;0;0;0;0;.00nan;0;0
4220;4622;38;41;29;5;24;.828;3600000;0
4220;38124;58;0;0;0;0;.00nan;0;0
4220;64722;38;0;0;0;0;.00nan;0;0
4220;149450;58;69;28;2;26;.929;3600000;0
4221;173699;36;49;29;5;24;.828;3600000;0
4221;43928;39;0;0;0;0;.00nan;0;0
4221;57434;36;0;0;0;0;.00nan;0;0
4221;143301;39;87;27;1;26;.963;3600000;0
4222;182780;60;74;31;3;28;.903;3600000;0
4222;172499;50;0;0;0;0;.00nan;0;0
4222;170294;60;0;0;0;0;.00nan;0;0
4222;76574;50;50;33;5;28;.848;3553000;0
4223;172340;48;0;0;0;0;.00nan;0;0
4223;78479;47;68;25;2;23;.920;3900000;0
4223;79141;47;0;0;0;0;.00nan;0;0
4223;142492;48;94;36;2;34;.944;3900000;0
4224;175084;65;50;30;4;26;.867;3570000;0
4224;58100;56;100;39;2;37;.949;3600000;0
4224;77084;65;0;0;0;0;.00nan;0;0
4224;85468;56;0;0;0;0;.00nan;0;0
4225;163471;63;84;31;2;29;.935;3600000;0
4225;183904;43;70;41;4;37;.902;3522000;0
4225;178612;43;0;0;0;0;.00nan;0;0
4225;192457;63;0;0;0;0;.00nan;0;0
4226;168872;64;0;0;0;0;.00nan;0;0
4226;176915;54;0;0;0;0;.00nan;0;0
4226;94615;54;82;58;6;52;.897;3600000;0
4226;141978;64;71;28;3;25;.893;3600000;0
4227;178384;40;98;42;3;39;.929;3600000;0
4227;78773;44;0;0;0;0;.00nan;0;0
4227;85636;40;0;0;0;0;.00nan;0;0
4227;139467;44;44;28;5;23;.821;3573000;0
4228;183783;52;43;46;8;38;.826;3077000;0
4228;180316;52;42;3;1;2;.667;523000;0
4228;191218;59;0;0;0;0;.00nan;0;0
4228;64911;59;49;16;3;13;.813;3600000;0
4229;1593;4837;0;0;0;0;.00nan;0;0
4229;179306;61;0;0;0;0;.00nan;0;0
4229;78581;61;65;28;3;25;.893;3557000;0
4229;85546;4837;89;38;2;36;.947;3600000;0
4230;188888;51;0;0;0;0;.00nan;0;0
4230;169154;51;100;33;0;33;1.000;3714000;0
4230;176860;55;0;0;0;0;.00nan;0;0
4230;86180;55;80;28;1;27;.964;3714000;0
4231;187699;41;42;3;1;2;.667;361000;0
4231;-1;41;51;44;6;38;.864;3239000;0
4231;75362;57;93;29;1;28;.966;3600000;0
4231;86862;57;0;0;0;0;.00nan;0;0
4232;176938;62;0;0;0;0;.00nan;0;0
4232;38276;62;88;24;0;24;1.000;3600000;0
4232;79132;49;31;29;6;23;.793;3202000;0
4232;91225;49;54;3;0;3;1.000;398000;0
4233;168872;64;82;40;3;37;.925;3600000;0
4233;190106;46;54;31;5;26;.839;3559000;0
4233;79280;46;0;0;0;0;.00nan;0;0
4233;141978;64;0;0;0;0;.00nan;0;0
4234;183783;52;0;0;0;0;.00nan;0;0
4234;180316;52;62;20;2;18;.900;3600000;0
4234;58100;56;50;34;5;29;.853;3600000;0
4234;85468;56;0;0;0;0;.00nan;0;0
4235;4622;38;0;0;0;0;.00nan;0;0
4235;163471;63;60;15;1;14;.933;3600000;0
4235;192457;63;0;0;0;0;.00nan;0;0
4235;64722;38;55;32;4;28;.875;3600000;0
4236;173699;36;0;0;0;0;.00nan;0;0
4236;43928;39;50;23;4;19;.826;3600000;0
4236;57434;36;36;38;6;32;.842;3558000;0
4236;143301;39;0;0;0;0;.00nan;0;0
4237;182780;60;0;0;0;0;.00nan;0;0
4237;172499;50;0;0;0;0;.00nan;0;0
4237;170294;60;69;33;3;30;.909;3600000;0
4237;76574;50;53;32;4;28;.875;3600000;0
4238;189644;42;0;0;0;0;.00nan;0;0
4238;171608;45;0;0;0;0;.00nan;0;0
4238;57695;42;54;19;2;17;.895;3531000;0
4238;85798;45;100;30;0;30;1.000;3600000;0
4239;176915;54;94;43;2;41;.953;3547000;0
4239;58054;37;68;18;1;17;.944;3600000;0
4239;85453;37;0;0;0;0;.00nan;0;0
4239;94615;54;0;0;0;0;.00nan;0;0
4240;172340;48;62;35;4;31;.886;3549000;0
4240;170314;4619;76;33;2;31;.939;3600000;0
4240;191813;4619;0;0;0;0;.00nan;0;0
4240;142492;48;0;0;0;0;.00nan;0;0
4241;178384;40;69;17;1;16;.941;1568000;0
4241;78773;44;66;27;2;25;.926;3600000;0
4241;85636;40;17;21;6;15;.714;2032000;0
4241;139467;44;0;0;0;0;.00nan;0;0
4242;175084;65;0;0;0;0;.00nan;0;0
4242;191218;59;78;30;2;28;.933;3600000;0
4242;64911;59;0;0;0;0;.00nan;0;0
4242;77084;65;57;26;3;23;.885;3553000;0
4243;188888;51;0;0;0;0;.00nan;0;0
4243;183904;43;0;0;0;0;.00nan;0;0
4243;178612;43;41;18;3;15;.833;3545000;0
4243;169154;51;88;37;2;35;.946;3600000;0
4244;1593;4837;0;0;0;0;.00nan;0;0
4244;179306;61;79;30;1;29;.967;3582000;0
4244;78581;61;0;0;0;0;.00nan;0;0
4244;85546;4837;98;22;0;22;1.000;3600000;0
4245;187578;53;0;0;0;0;.00nan;0;0
4245;169323;53;49;23;3;20;.870;3577000;0
4245;38124;58;78;24;2;22;.917;3600000;0
4245;149450;58;0;0;0;0;.00nan;0;0
4246;187578;53;24;6;3;3;.500;468000;0
4246;169323;53;79;23;1;22;.957;3132000;0
4246;191218;59;0;0;0;0;.00nan;0;0
4246;64911;59;89;34;1;33;.971;3600000;0
4247;187699;41;100;30;0;30;1.000;3600000;0
4247;-1;41;0;0;0;0;.00nan;0;0
4247;75362;57;0;0;0;0;.00nan;0;0
4247;86862;57;73;18;1;17;.944;3576000;0
4248;171608;45;0;0;0;0;.00nan;0;0
4248;58054;37;0;0;0;0;.00nan;0;0
4248;85453;37;67;27;3;24;.889;3576000;0
4248;85798;45;88;34;2;32;.941;3600000;0
4249;189644;42;88;33;2;31;.939;3600000;0
4249;190106;46;0;0;0;0;.00nan;0;0
4249;57695;42;0;0;0;0;.00nan;0;0
4249;79280;46;46;20;3;17;.850;3546000;0
4250;175084;65;74;21;1;20;.952;3600000;0
4250;58100;56;74;34;2;32;.941;3596000;0
4250;77084;65;0;0;0;0;.00nan;0;0
4250;85468;56;0;0;0;0;.00nan;0;0
4251;188888;51;77;37;3;34;.919;3600000;0
4251;169154;51;0;0;0;0;.00nan;0;0
4251;176860;55;0;0;0;0;.00nan;0;0
4251;86180;55;100;24;0;24;1.000;3600000;0
4252;176938;62;0;0;0;0;.00nan;0;0
4252;38276;62;100;38;0;38;1.000;3600000;0
4252;78773;44;0;0;0;0;.00nan;0;0
4252;139467;44;80;45;3;42;.933;3600000;0
4253;172340;48;0;0;0;0;.00nan;0;0
4253;178384;40;27;7;3;4;.571;522000;0
4253;85636;40;81;31;2;29;.935;3078000;0
4253;142492;48;80;24;1;23;.958;3600000;0
4254;168872;64;0;0;0;0;.00nan;0;0
4254;170314;4619;76;26;2;24;.923;3544000;0
4254;191813;4619;0;0;0;0;.00nan;0;0
4254;141978;64;100;51;1;50;.980;3600000;0
4255;176938;62;0;0;0;0;.00nan;0;0
4255;38276;62;97;33;1;32;.970;3600000;0
4255;78773;44;49;23;3;20;.870;3593000;0
4255;139467;44;0;0;0;0;.00nan;0;0
4256;1593;4837;0;0;0;0;.00nan;0;0
4256;179306;61;0;0;0;0;.00nan;0;0
4256;78581;61;49;30;5;25;.833;3549000;0
4256;85546;4837;81;43;4;39;.907;3600000;0
4257;183904;43;69;34;3;31;.912;3568000;0
4257;178612;43;0;0;0;0;.00nan;0;0
4257;176860;55;0;0;0;0;.00nan;0;0
4257;86180;55;100;37;1;36;.973;3600000;0
4258;187578;53;0;0;0;0;.00nan;0;0
4258;169323;53;92;29;2;27;.931;3900000;0
4258;173699;36;89;31;1;30;.968;3900000;0
4258;57434;36;0;0;0;0;.00nan;0;0
4259;43928;39;0;0;0;0;.00nan;0;0
4259;58100;56;0;0;0;0;.00nan;0;0
4259;85468;56;66;35;4;31;.886;3600000;0
4259;143301;39;67;16;1;15;.938;3600000;0
4260;178384;40;99;63;1;62;.984;3900000;0
4260;60773;47;0;0;0;0;.00nan;0;0
4260;78479;47;82;29;1;28;.966;3900000;0
4260;85636;40;0;0;0;0;.00nan;0;0
4261;190106;46;100;29;0;29;1.000;3600000;0
4261;58054;37;95;34;1;33;.971;3550000;0
4261;79280;46;0;0;0;0;.00nan;0;0
4261;85453;37;0;0;0;0;.00nan;0;0
4262;183783;52;55;27;3;24;.889;3600000;0
4262;180316;52;0;0;0;0;.00nan;0;0
4262;75362;57;24;28;6;22;.786;2400000;0
4262;86862;57;37;7;2;5;.714;1200000;0
4263;163471;63;67;24;2;22;.917;3600000;0
4263;188888;51;98;37;0;37;1.000;2958000;0
4263;169154;51;35;15;3;12;.800;597000;0
4263;192457;63;0;0;0;0;.00nan;0;0
4264;168872;64;100;44;2;42;.955;3900000;0
4264;170314;4619;62;26;2;24;.923;3900000;0
4264;191813;4619;0;0;0;0;.00nan;0;0
4264;141978;64;0;0;0;0;.00nan;0;0
4265;1593;4837;62;7;0;7;1.000;1753000;0
4265;60773;47;0;0;0;0;.00nan;0;0
4265;78479;47;67;31;3;28;.903;3600000;0
4265;85546;4837;39;20;4;16;.800;1847000;0
4266;163471;63;85;28;1;27;.964;3600000;0
4266;183904;43;66;28;2;26;.929;3557000;0
4266;178612;43;0;0;0;0;.00nan;0;0
4266;192457;63;0;0;0;0;.00nan;0;0
4267;182780;60;48;33;6;27;.818;3205000;0
4267;170294;60;54;3;0;3;1.000;395000;0
4267;176938;62;65;29;3;26;.897;3600000;0
4267;38276;62;0;0;0;0;.00nan;0;0
4268;171608;45;0;0;0;0;.00nan;0;0
4268;58100;56;83;39;3;36;.923;3565000;0
4268;85468;56;0;0;0;0;.00nan;0;0
4268;85798;45;94;27;1;26;.963;3600000;0
4269;190106;46;36;27;5;22;.815;3600000;0
4269;58054;37;84;36;2;34;.944;3600000;0
4269;79280;46;0;0;0;0;.00nan;0;0
4269;85453;37;0;0;0;0;.00nan;0;0
4270;183783;52;0;0;0;0;.00nan;0;0
4270;173699;36;97;58;3;55;.948;3600000;0
4270;180316;52;58;17;2;15;.882;3600000;0
4270;57434;36;0;0;0;0;.00nan;0;0
4271;179306;61;0;0;0;0;.00nan;0;0
4271;78581;61;56;24;3;21;.875;3600000;0
4271;79132;49;57;37;5;32;.865;3548000;0
4271;91225;49;0;0;0;0;.00nan;0;0
4272;189644;42;0;0;0;0;.00nan;0;0
4272;176915;54;0;0;0;0;.00nan;0;0
4272;79141;42;55;14;2;12;.857;3600000;0
4272;94615;54;52;51;7;44;.863;3600000;0
4273;172340;48;0;0;0;0;.00nan;0;0
4273;170314;4619;96;43;3;40;.930;3600000;0
4273;191813;4619;0;0;0;0;.00nan;0;0
4273;142492;48;60;32;4;28;.875;3596000;0
4274;175084;65;76;36;3;33;.917;3600000;0
4274;191218;59;62;21;2;19;.905;3600000;0
4274;64911;59;0;0;0;0;.00nan;0;0
4274;77084;65;0;0;0;0;.00nan;0;0
4275;188888;51;0;0;0;0;.00nan;0;0
4275;169154;51;97;49;2;47;.959;3600000;0
4275;43928;39;0;0;0;0;.00nan;0;0
4275;143301;39;59;25;3;22;.880;3600000;0
4276;187699;41;59;40;5;35;.875;3600000;0
4276;-1;41;0;0;0;0;.00nan;0;0
4276;176860;55;80;11;0;11;1.000;3600000;0
4276;86180;55;0;0;0;0;.00nan;0;0
4277;38124;58;0;0;0;0;.00nan;0;0
4277;75362;57;43;30;6;24;.800;3580000;0
4277;86862;57;0;0;0;0;.00nan;0;0
4277;149450;58;46;32;5;27;.844;3600000;0
4278;1593;4837;0;0;0;0;.00nan;0;0
4278;78773;44;0;0;0;0;.00nan;0;0
4278;85546;4837;84;35;1;34;.971;3600000;0
4278;139467;44;51;24;3;21;.875;3514000;0
4279;163471;63;34;35;6;29;.829;3900000;0
4279;183904;43;70;12;0;12;1.000;1909000;0
4279;178612;43;16;17;6;11;.647;1991000;0
4279;192457;63;0;0;0;0;.00nan;0;0
4280;171608;45;0;0;0;0;.00nan;0;0
4280;58100;56;76;33;3;30;.909;3527000;0
4280;85468;56;0;0;0;0;.00nan;0;0
4280;85798;45;80;26;1;25;.962;3600000;0
4281;190106;46;55;17;2;15;.882;3335000;0
4281;176915;54;85;50;4;46;.920;3600000;0
4281;79280;46;31;6;3;3;.500;247000;0
4281;94615;54;0;0;0;0;.00nan;0;0
4282;179306;61;55;15;2;13;.867;3600000;0
4282;78581;61;0;0;0;0;.00nan;0;0
4282;79132;49;53;4;0;4;1.000;307000;0
4282;91225;49;48;43;6;37;.860;3293000;0
4283;4622;38;89;36;2;34;.944;3582000;0
4283;176860;55;82;21;1;20;.952;3600000;0
4283;64722;38;0;0;0;0;.00nan;0;0
4283;86180;55;0;0;0;0;.00nan;0;0
4284;187578;53;63;18;1;17;.944;3600000;0
4284;187699;41;0;0;0;0;.00nan;0;0
4284;169323;53;0;0;0;0;.00nan;0;0
4284;-1;41;79;49;4;45;.918;3600000;0
4285;172499;50;0;0;0;0;.00nan;0;0
4285;168872;64;0;0;0;0;.00nan;0;0
4285;76574;50;90;31;2;29;.935;3900000;0
4285;141978;64;70;26;2;24;.923;3900000;0
4286;178384;40;93;43;3;40;.930;3622000;0
4286;60773;47;0;0;0;0;.00nan;0;0
4286;78479;47;67;22;2;20;.909;3622000;0
4286;85636;40;0;0;0;0;.00nan;0;0
4287;173699;36;86;51;5;46;.902;3600000;0
4287;191218;59;0;0;0;0;.00nan;0;0
4287;57434;36;0;0;0;0;.00nan;0;0
4287;64911;59;50;16;2;14;.875;3600000;0
4288;188888;51;36;42;7;35;.833;2886000;0
4288;169154;51;62;8;0;8;1.000;658000;0
4288;43928;39;31;22;5;17;.773;3600000;0
4288;143301;39;0;0;0;0;.00nan;0;0
4289;38124;58;80;33;2;31;.939;3900000;0
4289;75362;57;0;0;0;0;.00nan;0;0
4289;86862;57;100;41;2;39;.951;3900000;0
4289;149450;58;0;0;0;0;.00nan;0;0
4290;182780;60;0;0;0;0;.00nan;0;0
4290;170294;60;100;28;0;28;1.000;3600000;0
4290;176938;62;59;22;2;20;.909;3559000;0
4290;38276;62;0;0;0;0;.00nan;0;0
4291;187699;41;57;43;5;38;.884;3600000;0
4291;4622;38;63;21;2;19;.905;3600000;0
4291;-1;41;0;0;0;0;.00nan;0;0
4291;64722;38;0;0;0;0;.00nan;0;0
4292;172499;50;0;0;0;0;.00nan;0;0
4292;168872;64;55;44;5;39;.886;3600000;0
4292;76574;50;100;25;0;25;1.000;3600000;0
4292;141978;64;0;0;0;0;.00nan;0;0
4293;189644;42;86;15;0;15;1.000;3600000;0
4293;58054;37;54;28;4;24;.857;3600000;0
4293;79141;42;0;0;0;0;.00nan;0;0
4293;85453;37;0;0;0;0;.00nan;0;0
4294;172340;48;75;34;3;31;.912;3567000;0
4294;78773;44;0;0;0;0;.00nan;0;0
4294;139467;44;65;15;1;14;.933;3600000;0
4294;142492;48;0;0;0;0;.00nan;0;0
4295;183783;52;88;40;2;38;.950;3600000;0
4295;175084;65;40;35;6;29;.829;3600000;0
4295;180316;52;0;0;0;0;.00nan;0;0
4295;77084;65;0;0;0;0;.00nan;0;0
4296;187578;53;0;0;0;0;.00nan;0;0
4296;169323;53;35;35;6;29;.829;3600000;0
4296;191218;59;100;29;0;29;1.000;3600000;0
4296;64911;59;0;0;0;0;.00nan;0;0
4297;190106;46;49;19;3;16;.842;3889000;0
4297;58100;56;71;34;4;30;.882;3889000;0
4297;79280;46;0;0;0;0;.00nan;0;0
4297;85468;56;0;0;0;0;.00nan;0;0
4298;182780;60;84;23;0;23;1.000;3042000;0
4298;170294;60;21;3;3;0;.000;513000;0
4298;179306;61;0;0;0;0;.00nan;0;0
4298;78581;61;84;27;1;26;.963;3600000;0
4299;1593;4837;0;0;0;0;.00nan;0;0
4299;79132;49;71;48;4;44;.917;3600000;0
4299;85546;4837;76;23;1;22;.957;3600000;0
4299;91225;49;0;0;0;0;.00nan;0;0
4300;188888;51;0;0;0;0;.00nan;0;0
4300;169154;51;91;43;3;40;.930;3591000;0
4300;173699;36;80;29;2;27;.931;3600000;0
4300;57434;36;0;0;0;0;.00nan;0;0
4301;172499;50;0;0;0;0;.00nan;0;0
4301;189644;42;54;24;3;21;.875;3600000;0
4301;76574;50;92;41;2;39;.951;3600000;0
4301;79141;42;0;0;0;0;.00nan;0;0
4302;172340;48;0;0;0;0;.00nan;0;0
4302;78773;44;0;0;0;0;.00nan;0;0
4302;139467;44;64;24;3;21;.875;3600000;0
4302;142492;48;61;34;4;30;.882;3564000;0
4303;170314;4619;0;0;0;0;.00nan;0;0
4303;191813;4619;29;33;6;27;.818;3600000;0
4303;60773;47;0;0;0;0;.00nan;0;0
4303;78479;47;77;33;3;30;.909;3600000;0
4304;183904;43;43;28;5;23;.821;3600000;0
4304;178612;43;0;0;0;0;.00nan;0;0
4304;43928;39;0;0;0;0;.00nan;0;0
4304;143301;39;99;48;2;46;.958;3600000;0
4305;182780;60;0;0;0;0;.00nan;0;0
4305;170294;60;99;55;3;52;.945;3600000;0
4305;179306;61;26;6;3;3;.500;257000;0
4305;78581;61;70;18;1;17;.944;3298000;0
4306;1593;4837;0;0;0;0;.00nan;0;0
4306;176921;62;63;10;0;10;1.000;723000;0
4306;176938;62;22;23;6;17;.739;2877000;0
4306;85546;4837;75;23;1;22;.957;3600000;0
4307;4622;38;100;27;0;27;1.000;3600000;0
4307;64722;38;0;0;0;0;.00nan;0;0
4307;75362;57;66;22;2;20;.909;3563000;0
4307;86862;57;0;0;0;0;.00nan;0;0
4308;171608;45;0;0;0;0;.00nan;0;0
4308;190106;46;74;18;1;17;.944;3600000;0
4308;79280;46;0;0;0;0;.00nan;0;0
4308;85798;45;70;48;5;43;.896;3600000;0
4309;183783;52;0;0;0;0;.00nan;0;0
4309;175084;65;60;29;3;26;.897;3851000;0
4309;180316;52;95;47;3;44;.936;3900000;0
4309;77084;65;0;0;0;0;.00nan;0;0
4310;78773;44;0;0;0;0;.00nan;0;0
4310;79132;49;80;45;4;41;.911;3600000;0
4310;91225;49;0;0;0;0;.00nan;0;0
4310;139467;44;93;26;1;25;.962;3600000;0
4311;173699;36;58;17;2;15;.882;3561000;0
4311;57434;36;0;0;0;0;.00nan;0;0
4311;58100;56;99;32;1;31;.969;3600000;0
4311;85468;56;0;0;0;0;.00nan;0;0
4312;187699;41;90;33;1;32;.970;3600000;0
4312;170977;41;0;0;0;0;.00nan;0;0
4312;38124;58;0;0;0;0;.00nan;0;0
4312;149450;58;61;27;2;25;.926;3600000;0
4313;163471;63;80;34;2;32;.941;3600000;0
4313;188888;51;0;0;0;0;.00nan;0;0
4313;169154;51;70;36;4;32;.889;3573000;0
4313;192457;63;0;0;0;0;.00nan;0;0
4314;170314;4619;90;45;4;41;.911;3572000;0
4314;191813;4619;0;0;0;0;.00nan;0;0
4314;60773;47;0;0;0;0;.00nan;0;0
4314;78479;47;38;13;3;10;.769;3600000;0
4315;165744;53;0;0;0;0;.00nan;0;0
4315;169323;53;48;20;3;17;.850;3600000;0
4315;191218;59;92;38;2;36;.947;3600000;0
4315;64911;59;0;0;0;0;.00nan;0;0
4316;178384;40;91;30;2;28;.933;3600000;0
4316;168872;64;49;9;1;8;.889;1205000;0
4316;85636;40;0;0;0;0;.00nan;0;0
4316;141978;64;50;23;4;19;.826;2395000;0
4317;43928;39;0;0;0;0;.00nan;0;0
4317;86180;55;45;22;4;18;.818;3600000;0
4317;143301;39;40;31;5;26;.839;3600000;0
4317;157189;55;0;0;0;0;.00nan;0;0
4318;1593;4837;66;34;3;31;.912;3600000;0
4318;176921;62;67;37;4;33;.892;3600000;0
4318;176938;62;0;0;0;0;.00nan;0;0
4318;85546;4837;0;0;0;0;.00nan;0;0
4319;165744;53;82;37;3;34;.919;3600000;0
4319;183783;52;77;27;2;25;.926;3600000;0
4319;169323;53;0;0;0;0;.00nan;0;0
4319;180316;52;0;0;0;0;.00nan;0;0
4320;182780;60;0;0;0;0;.00nan;0;0
4320;172340;48;83;26;2;24;.923;3175000;0
4320;170294;60;65;25;3;22;.880;3600000;0
4320;142492;48;31;6;3;3;.500;401000;0
4321;4622;38;99;37;2;35;.946;3600000;0
4321;64722;38;0;0;0;0;.00nan;0;0
4321;75362;57;0;0;0;0;.00nan;0;0
4321;86862;57;67;34;3;31;.912;3600000;0
4322;171608;45;71;28;2;26;.929;3600000;0
4322;176915;54;97;34;1;33;.971;3600000;0
4322;85798;45;0;0;0;0;.00nan;0;0
4322;94615;54;0;0;0;0;.00nan;0;0
4323;179306;61;0;0;0;0;.00nan;0;0
4323;60773;47;100;25;0;25;1.000;3600000;0
4323;78479;47;0;0;0;0;.00nan;0;0
4323;78581;61;68;28;2;26;.929;3521000;0
4324;78773;44;0;0;0;0;.00nan;0;0
4324;79132;49;59;43;5;38;.884;3535000;0
4324;91225;49;0;0;0;0;.00nan;0;0
4324;139467;44;46;15;3;12;.800;3600000;0
4325;172499;50;0;0;0;0;.00nan;0;0
4325;58054;37;76;22;1;21;.955;3600000;0
4325;76574;50;50;34;5;29;.853;3600000;0
4325;85453;37;0;0;0;0;.00nan;0;0
4326;173699;36;66;31;3;28;.903;3900000;0
4326;57434;36;0;0;0;0;.00nan;0;0
4326;58100;56;0;0;0;0;.00nan;0;0
4326;85468;56;74;31;3;28;.903;3900000;0
4327;189644;42;0;0;0;0;.00nan;0;0
4327;190106;46;0;0;0;0;.00nan;0;0
4327;79141;42;47;34;5;29;.853;3600000;0
4327;79280;46;74;25;1;24;.960;3600000;0
4328;191218;59;0;0;0;0;.00nan;0;0
4328;43928;39;82;34;2;32;.941;3600000;0
4328;64911;59;61;31;3;28;.903;3553000;0
4328;143301;39;0;0;0;0;.00nan;0;0
4329;163471;63;51;27;4;23;.852;3567000;0
4329;188888;51;91;41;2;39;.951;3600000;0
4329;169154;51;0;0;0;0;.00nan;0;0
4329;192457;63;0;0;0;0;.00nan;0;0
4330;178384;40;43;30;5;25;.833;3600000;0
4330;168872;64;82;24;1;23;.958;3600000;0
4330;85636;40;0;0;0;0;.00nan;0;0
4330;141978;64;0;0;0;0;.00nan;0;0
4331;183904;43;40;33;6;27;.818;3600000;0
4331;178612;43;0;0;0;0;.00nan;0;0
4331;86180;55;93;32;2;30;.938;3600000;0
4331;157189;55;0;0;0;0;.00nan;0;0
4332;187699;41;80;32;2;30;.938;3580000;0
4332;170977;41;0;0;0;0;.00nan;0;0
4332;38124;58;92;21;0;21;1.000;3600000;0
4332;149450;58;0;0;0;0;.00nan;0;0
4333;187699;41;81;54;5;49;.907;3600000;0
4333;165744;53;0;0;0;0;.00nan;0;0
4333;169323;53;77;23;1;22;.957;3600000;0
4333;170977;41;0;0;0;0;.00nan;0;0
4334;182780;60;65;29;3;26;.897;3600000;0
4334;172340;48;0;0;0;0;.00nan;0;0
4334;170294;60;0;0;0;0;.00nan;0;0
4334;142492;48;59;38;4;34;.895;3577000;0
4335;189644;42;73;30;2;28;.933;3600000;0
4335;171608;45;0;0;0;0;.00nan;0;0
4335;79141;42;0;0;0;0;.00nan;0;0
4335;85798;45;74;44;5;39;.886;3600000;0
4336;172499;50;0;0;0;0;.00nan;0;0
4336;58054;37;0;0;0;0;.00nan;0;0
4336;76574;50;57;45;6;39;.867;3600000;0
4336;85453;37;80;29;2;27;.931;3600000;0
4337;175084;65;0;0;0;0;.00nan;0;0
4337;191218;59;62;43;6;37;.860;3600000;0
4337;64911;59;0;0;0;0;.00nan;0;0
4337;77084;65;60;28;3;25;.893;3600000;0
4338;163471;63;0;0;0;0;.00nan;0;0
4338;192457;63;70;30;2;28;.933;3900000;0
4338;86180;55;100;52;2;50;.962;3900000;0
4338;157189;55;0;0;0;0;.00nan;0;0
4339;78773;44;0;0;0;0;.00nan;0;0
4339;85546;4837;0;0;0;0;.00nan;0;0
4339;86875;4837;67;36;3;33;.917;3600000;0
4339;139467;44;35;30;5;25;.833;3524000;0
4340;183783;52;0;0;0;0;.00nan;0;0
4340;180316;52;62;27;3;24;.889;3600000;0
4340;75362;57;0;0;0;0;.00nan;0;0
4340;86862;57;100;36;0;36;1.000;3600000;0
4341;4622;64;66;13;1;12;.923;3600000;0
4341;168872;64;0;0;0;0;.00nan;0;0
4341;176915;54;89;41;2;39;.951;3587000;0
4341;94615;54;0;0;0;0;.00nan;0;0
4342;179306;61;0;0;0;0;.00nan;0;0
4342;64722;49;0;0;0;0;.00nan;0;0
4342;78581;61;64;28;3;25;.893;3546000;0
4342;79132;49;75;32;2;30;.938;3600000;0
4343;78773;44;38;33;6;27;.818;2507000;0
4343;85546;4837;55;3;0;3;1.000;1107000;0
4343;86875;4837;25;31;7;24;.774;2493000;0
4343;139467;44;47;13;2;11;.846;1093000;0
4344;183904;43;83;28;1;27;.964;3600000;0
4344;178612;43;0;0;0;0;.00nan;0;0
4344;86180;55;64;23;2;21;.913;3600000;0
4344;157189;55;0;0;0;0;.00nan;0;0
4345;183783;52;61;34;4;30;.882;3900000;0
4345;180316;52;0;0;0;0;.00nan;0;0
4345;75362;57;0;0;0;0;.00nan;0;0
4345;86862;57;65;41;4;37;.902;3900000;0
4346;190106;46;42;12;3;9;.750;3600000;0
4346;58100;56;20;18;5;13;.722;921000;0
4346;79280;46;0;0;0;0;.00nan;0;0
4346;85468;56;79;34;2;32;.941;2679000;0
4347;165744;53;0;0;0;0;.00nan;0;0
4347;169323;53;62;33;4;29;.879;3600000;0
4347;173699;36;71;34;3;31;.912;3600000;0
4347;57434;36;0;0;0;0;.00nan;0;0
4348;173918;50;0;0;0;0;.00nan;0;0
4348;189644;42;83;12;0;12;1.000;3600000;0
4348;76574;50;90;59;5;54;.915;3600000;0
4348;79141;42;0;0;0;0;.00nan;0;0
4349;172340;48;0;0;0;0;.00nan;0;0
4349;170314;4619;100;26;0;26;1.000;3600000;0
4349;191813;4619;0;0;0;0;.00nan;0;0
4349;142492;48;64;27;3;24;.889;3600000;0
4350;163471;63;69;26;3;23;.885;3639000;0
4350;188888;51;0;0;0;0;.00nan;0;0
4350;169154;51;91;49;4;45;.918;3639000;0
4350;192457;63;0;0;0;0;.00nan;0;0
4351;4622;64;79;24;1;23;.958;3818000;0
4351;168872;64;0;0;0;0;.00nan;0;0
4351;176915;54;0;0;0;0;.00nan;0;0
4351;94615;54;87;33;2;31;.939;3818000;0
4352;179306;61;52;22;3;19;.864;3600000;0
4352;64722;49;64;14;0;14;1.000;1351000;0
4352;78581;61;0;0;0;0;.00nan;0;0
4352;79132;49;34;32;6;26;.813;2249000;0
4353;187699;41;89;47;3;44;.936;3600000;0
4353;170977;41;0;0;0;0;.00nan;0;0
4353;38124;58;60;13;1;12;.923;3600000;0
4353;149450;58;0;0;0;0;.00nan;0;0
4354;173918;50;0;0;0;0;.00nan;0;0
4354;171608;45;0;0;0;0;.00nan;0;0
4354;76574;50;76;38;3;35;.921;3520000;0
4354;85798;45;91;37;1;36;.973;3600000;0
4355;38124;58;100;30;0;30;1.000;3600000;0
4355;58100;56;58;45;6;39;.867;3296000;0
4355;85468;56;52;3;0;3;1.000;304000;0
4355;149450;58;0;0;0;0;.00nan;0;0
4356;182780;60;0;0;0;0;.00nan;0;0
4356;170294;60;54;28;3;25;.893;3520000;0
4356;176921;62;0;0;0;0;.00nan;0;0
4356;176938;62;95;33;1;32;.970;3600000;0
4357;190106;46;92;24;1;23;.958;3900000;0
4357;58054;37;95;34;1;33;.971;3900000;0
4357;79280;46;0;0;0;0;.00nan;0;0
4357;85453;37;0;0;0;0;.00nan;0;0
4358;165744;53;68;28;4;24;.857;3600000;0
4358;169323;53;0;0;0;0;.00nan;0;0
4358;173699;36;97;59;5;54;.915;3552000;0
4358;57434;36;0;0;0;0;.00nan;0;0
4359;172340;48;92;23;0;23;1.000;3600000;0
4359;60773;47;62;26;2;24;.923;3546000;0
4359;78479;47;0;0;0;0;.00nan;0;0
4359;142492;48;0;0;0;0;.00nan;0;0
4360;187699;41;90;46;3;43;.935;3600000;0
4360;170977;41;0;0;0;0;.00nan;0;0
4360;175084;65;0;0;0;0;.00nan;0;0
4360;77084;65;81;14;0;14;1.000;3600000;0
4361;163471;63;98;26;0;26;1.000;3600000;0
4361;43928;39;0;0;0;0;.00nan;0;0
4361;192457;63;0;0;0;0;.00nan;0;0
4361;143301;39;80;27;1;26;.963;3558000;0
4362;170314;4619;94;40;3;37;.925;3586000;0
4362;189644;42;69;26;2;24;.923;3600000;0
4362;191813;4619;0;0;0;0;.00nan;0;0
4362;79141;42;0;0;0;0;.00nan;0;0
4363;188888;51;0;0;0;0;.00nan;0;0
4363;183904;43;95;26;1;25;.962;3900000;0
4363;178612;43;0;0;0;0;.00nan;0;0
4363;169154;51;96;41;1;40;.976;3900000;0
4364;78977;38;0;0;0;0;.00nan;0;0
4364;86180;55;80;27;2;25;.926;3600000;0
4364;141978;38;57;41;6;35;.854;3600000;0
4364;157189;55;0;0;0;0;.00nan;0;0
4365;64722;49;0;0;0;0;.00nan;0;0
4365;78773;44;0;0;0;0;.00nan;0;0
4365;79132;49;83;27;2;25;.926;3555000;0
4365;139467;44;86;26;1;25;.962;3600000;0
4366;172340;48;90;38;3;35;.921;3600000;0
4366;85546;4837;0;0;0;0;.00nan;0;0
4366;86875;4837;92;22;0;22;1.000;3600000;0
4366;142492;48;0;0;0;0;.00nan;0;0
4367;165744;53;0;0;0;0;.00nan;0;0
4367;183904;43;0;0;0;0;.00nan;0;0
4367;178612;43;71;33;3;30;.909;3600000;0
4367;169323;53;53;36;5;31;.861;3600000;0
4368;191218;59;64;14;1;13;.929;3600000;0
4368;64911;59;0;0;0;0;.00nan;0;0
4368;75362;57;0;0;0;0;.00nan;0;0
4368;86862;57;47;36;5;31;.861;3600000;0
4369;173918;50;0;0;0;0;.00nan;0;0
4369;171608;45;0;0;0;0;.00nan;0;0
4369;76574;50;75;39;4;35;.897;3900000;0
4369;85798;45;69;32;4;28;.875;3900000;0
4370;38124;58;100;25;0;25;1.000;3600000;0
4370;58100;56;0;0;0;0;.00nan;0;0
4370;85468;56;67;26;2;24;.923;3512000;0
4370;149450;58;0;0;0;0;.00nan;0;0
4371;182780;60;75;43;3;40;.930;3600000;0
4371;170294;60;0;0;0;0;.00nan;0;0
4371;176921;62;79;14;0;14;1.000;3600000;0
4371;176938;62;0;0;0;0;.00nan;0;0
4372;190106;46;0;0;0;0;.00nan;0;0
4372;58054;37;0;0;0;0;.00nan;0;0
4372;79280;46;100;42;2;40;.952;3600000;0
4372;85453;37;57;26;3;23;.885;3544000;0
4373;183783;52;86;33;2;31;.939;3600000;0
4373;180316;52;0;0;0;0;.00nan;0;0
4373;86180;55;62;32;3;29;.906;3570000;0
4373;157189;55;0;0;0;0;.00nan;0;0
4374;188888;51;70;43;4;39;.907;3600000;0
4374;169154;51;0;0;0;0;.00nan;0;0
4374;78977;38;0;0;0;0;.00nan;0;0
4374;141978;38;37;26;5;21;.808;3592000;0
4375;187699;41;91;58;4;54;.931;3600000;0
4375;170977;41;0;0;0;0;.00nan;0;0
4375;175084;65;0;0;0;0;.00nan;0;0
4375;77084;65;88;17;0;17;1.000;3600000;0
4376;178384;40;77;27;2;25;.926;3600000;0
4376;176915;54;0;0;0;0;.00nan;0;0
4376;85636;40;0;0;0;0;.00nan;0;0
4376;94615;54;68;28;3;25;.893;3583000;0
4377;170314;4619;0;0;0;0;.00nan;0;0
4377;189644;42;0;0;0;0;.00nan;0;0
4377;191813;4619;84;30;2;28;.933;3900000;0
4377;79141;42;84;29;2;27;.931;3900000;0
4378;163471;63;87;34;2;32;.941;3600000;0
4378;43928;39;69;26;3;23;.885;3592000;0
4378;192457;63;0;0;0;0;.00nan;0;0
4378;143301;39;0;0;0;0;.00nan;0;0
4379;4622;64;95;49;2;47;.959;3572000;0
4379;168872;64;0;0;0;0;.00nan;0;0
4379;179306;61;0;0;0;0;.00nan;0;0
4379;78581;61;73;20;1;19;.950;3600000;0
4380;64722;49;0;0;0;0;.00nan;0;0
4380;78773;44;34;19;4;15;.789;3831000;0
4380;79132;49;89;56;5;51;.911;3831000;0
4380;139467;44;0;0;0;0;.00nan;0;0
4381;191218;59;0;0;0;0;.00nan;0;0
4381;64911;59;71;24;2;22;.917;3600000;0
4381;75362;57;39;27;6;21;.778;2345000;0
4381;86862;57;70;21;1;20;.952;1255000;0
4382;171608;45;70;44;5;39;.886;3600000;0
4382;58054;37;67;24;2;22;.917;3600000;0
4382;85453;37;0;0;0;0;.00nan;0;0
4382;85798;45;0;0;0;0;.00nan;0;0
4383;183783;52;0;0;0;0;.00nan;0;0
4383;180316;52;49;14;2;12;.857;3600000;0
4383;78977;38;83;65;6;59;.908;3600000;0
4383;141978;38;0;0;0;0;.00nan;0;0
4384;178384;40;0;0;0;0;.00nan;0;0
4384;176915;54;59;34;4;30;.882;3600000;0
4384;85636;40;83;28;1;27;.964;3600000;0
4384;94615;54;0;0;0;0;.00nan;0;0
4385;173699;36;74;48;5;43;.896;3567000;0
4385;43928;39;0;0;0;0;.00nan;0;0
4385;57434;36;0;0;0;0;.00nan;0;0
4385;143301;39;100;50;2;48;.960;3600000;0
4386;4622;64;67;30;2;28;.933;3528000;0
4386;168872;64;0;0;0;0;.00nan;0;0
4386;179306;61;0;0;0;0;.00nan;0;0
4386;78581;61;80;14;0;14;1.000;3600000;0
4387;182780;60;0;0;0;0;.00nan;0;0
4387;170294;60;44;30;5;25;.833;3600000;0
4387;85546;4837;0;0;0;0;.00nan;0;0
4387;86875;4837;81;22;1;21;.955;3600000;0
4388;189644;42;55;20;2;18;.900;3900000;0
4388;176921;62;82;30;2;28;.933;3900000;0
4388;176938;62;0;0;0;0;.00nan;0;0
4388;79141;42;0;0;0;0;.00nan;0;0
4389;173918;50;0;0;0;0;.00nan;0;0
4389;190106;46;49;21;3;18;.857;3900000;0
4389;76574;50;100;45;3;42;.933;3900000;0
4389;79280;46;0;0;0;0;.00nan;0;0
4390;1593;4837;0;0;0;0;.00nan;0;0
4390;182780;60;74;31;3;28;.903;3900000;0
4390;170294;60;0;0;0;0;.00nan;0;0
4390;86875;4837;83;33;3;30;.909;3877000;0
4391;4622;64;55;44;6;38;.864;2464000;0
4391;168872;64;57;17;2;15;.882;1136000;0
4391;78479;47;0;0;0;0;.00nan;0;0
4391;86151;47;49;20;3;17;.850;3600000;0
4392;189644;42;0;0;0;0;.00nan;0;0
4392;176921;62;0;0;0;0;.00nan;0;0
4392;176938;62;39;29;5;24;.828;3512000;0
4392;79141;42;69;25;3;22;.880;3600000;0
4393;187699;41;0;0;0;0;.00nan;0;0
4393;170977;41;95;45;2;43;.956;3900000;0
4393;191218;59;63;19;2;17;.895;3900000;0
4393;64911;59;0;0;0;0;.00nan;0;0
4394;172499;50;0;0;0;0;.00nan;0;0
4394;190106;46;0;0;0;0;.00nan;0;0
4394;76574;50;90;44;4;40;.909;3600000;0
4394;79280;46;69;20;1;19;.950;3600000;0
4395;172340;48;0;0;0;0;.00nan;0;0
4395;179306;61;0;0;0;0;.00nan;0;0
4395;78581;61;80;28;2;26;.929;3600000;0
4395;142492;48;100;50;0;50;1.000;3600000;0
4396;163471;63;90;40;2;38;.950;3600000;0
4396;183783;52;89;49;3;46;.939;3544000;0
4396;180316;52;0;0;0;0;.00nan;0;0
4396;192457;63;0;0;0;0;.00nan;0;0
4397;171608;45;0;0;0;0;.00nan;0;0
4397;176915;54;0;0;0;0;.00nan;0;0
4397;85798;45;100;34;1;33;.971;3600000;0
4397;94615;54;69;33;4;29;.879;3600000;0
4398;178384;40;57;40;5;35;.875;3600000;0
4398;170314;4619;62;26;2;24;.923;3600000;0
4398;191813;4619;0;0;0;0;.00nan;0;0
4398;85636;40;0;0;0;0;.00nan;0;0
4399;58100;56;57;34;4;30;.882;3600000;0
4399;78977;38;0;0;0;0;.00nan;0;0
4399;85468;56;0;0;0;0;.00nan;0;0
4399;141978;38;49;30;5;25;.833;3554000;0
4400;1593;4837;0;0;0;0;.00nan;0;0
4400;78479;47;0;0;0;0;.00nan;0;0
4400;86151;47;64;40;4;36;.900;3900000;0
4400;86875;4837;64;30;4;26;.867;3900000;0
4401;183904;43;84;17;0;17;1.000;3600000;0
4401;178612;43;0;0;0;0;.00nan;0;0
4401;173699;36;59;35;4;31;.886;3600000;0
4401;57434;36;0;0;0;0;.00nan;0;0
4402;171608;45;0;0;0;0;.00nan;0;0
4402;58054;37;72;24;3;21;.875;3900000;0
4402;85453;37;0;0;0;0;.00nan;0;0
4402;85798;45;91;49;3;46;.939;3900000;0
4403;182780;60;0;0;0;0;.00nan;0;0
4403;172340;48;68;27;2;25;.926;3900000;0
4403;170294;60;85;35;2;33;.943;3900000;0
4403;142492;48;0;0;0;0;.00nan;0;0
4404;163471;63;76;37;3;34;.919;3600000;0
4404;43928;39;0;0;0;0;.00nan;0;0
4404;192457;63;0;0;0;0;.00nan;0;0
4404;143301;39;61;19;2;17;.895;3600000;0
4405;4622;64;87;28;1;27;.964;3600000;0
4405;168872;64;0;0;0;0;.00nan;0;0
4405;170314;4619;64;33;3;30;.909;3557000;0
4405;191813;4619;0;0;0;0;.00nan;0;0
4406;191218;59;71;28;2;26;.929;3600000;0
4406;64911;59;0;0;0;0;.00nan;0;0
4406;75362;57;0;0;0;0;.00nan;0;0
4406;86862;57;70;35;4;31;.886;3557000;0
4407;188888;51;39;8;2;6;.750;1645000;0
4407;169154;51;27;25;6;19;.760;1955000;0
4407;38124;58;29;24;5;19;.792;3600000;0
4407;149450;58;0;0;0;0;.00nan;0;0
4408;165744;53;0;0;0;0;.00nan;0;0
4408;169323;53;16;34;8;26;.765;3600000;0
4408;86180;55;83;34;2;32;.941;3600000;0
4408;157189;55;0;0;0;0;.00nan;0;0
4409;183904;43;95;23;0;23;1.000;3600000;0
4409;178612;43;0;0;0;0;.00nan;0;0
4409;173699;36;22;11;4;7;.636;1044000;0
4409;57434;36;64;26;2;24;.923;2556000;0
4410;58100;56;47;24;4;20;.833;3686000;0
4410;78977;38;0;0;0;0;.00nan;0;0
4410;85468;56;0;0;0;0;.00nan;0;0
4410;141978;38;47;32;5;27;.844;3686000;0
4411;4622;64;97;52;2;50;.962;3596000;0
4411;168872;64;0;0;0;0;.00nan;0;0
4411;78479;47;0;0;0;0;.00nan;0;0
4411;86151;47;60;18;1;17;.944;3600000;0
4412;171608;45;0;0;0;0;.00nan;0;0
4412;58054;37;0;0;0;0;.00nan;0;0
4412;85453;37;71;23;2;21;.913;3900000;0
4412;85798;45;100;56;2;54;.964;3900000;0
4413;187699;41;67;36;4;32;.889;3566000;0
4413;165744;53;55;18;3;15;.833;3600000;0
4413;169323;53;0;0;0;0;.00nan;0;0
4413;170977;41;0;0;0;0;.00nan;0;0
4414;172499;50;40;14;3;11;.786;489000;0
4414;76574;50;32;34;6;28;.824;3111000;0
4414;78773;44;0;0;0;0;.00nan;0;0
4414;139467;44;78;39;3;36;.923;3600000;0
4415;189644;42;57;10;1;9;.900;3600000;0
4415;64722;49;0;0;0;0;.00nan;0;0
4415;79132;49;81;52;5;47;.904;3600000;0
4415;79141;42;0;0;0;0;.00nan;0;0
4416;175084;65;0;0;0;0;.00nan;0;0
4416;75362;57;86;50;4;46;.920;3600000;0
4416;77084;65;86;21;0;21;1.000;3600000;0
4416;86862;57;0;0;0;0;.00nan;0;0
4417;190106;46;69;16;1;15;.938;3900000;0
4417;176915;54;80;30;1;29;.967;3900000;0
4417;79280;46;0;0;0;0;.00nan;0;0
4417;94615;54;0;0;0;0;.00nan;0;0
4418;178384;40;75;42;4;38;.905;3629000;0
4418;179306;61;0;0;0;0;.00nan;0;0
4418;78581;61;38;23;5;18;.783;3629000;0
4418;85636;40;0;0;0;0;.00nan;0;0
4419;188888;51;76;18;0;18;1.000;1409000;0
4419;169154;51;23;25;6;19;.760;2191000;0
4419;191218;59;0;0;0;0;.00nan;0;0
4419;64911;59;70;24;2;22;.917;3600000;0
4420;183783;52;0;0;0;0;.00nan;0;0
4420;180316;52;78;40;2;38;.950;3900000;0
4420;43928;39;84;39;2;37;.949;3900000;0
4420;143301;39;0;0;0;0;.00nan;0;0
4421;38124;58;0;0;0;0;.00nan;0;0
4421;86180;55;89;30;1;29;.967;3600000;0
4421;149450;58;63;33;4;29;.879;3600000;0
4421;157189;55;0;0;0;0;.00nan;0;0
4422;183783;52;61;28;3;25;.893;3759000;0
4422;183904;43;55;29;4;25;.862;3759000;0
4422;178612;43;0;0;0;0;.00nan;0;0
4422;180316;52;0;0;0;0;.00nan;0;0
4423;187699;41;100;30;0;30;1.000;3600000;0
4423;170977;41;0;0;0;0;.00nan;0;0
4423;38124;58;70;23;1;22;.957;3572000;0
4423;149450;58;0;0;0;0;.00nan;0;0
4424;172499;50;0;0;0;0;.00nan;0;0
4424;76574;50;98;58;2;56;.966;3600000;0
4424;78773;44;88;20;0;20;1.000;3600000;0
4424;139467;44;0;0;0;0;.00nan;0;0
4425;189644;42;0;0;0;0;.00nan;0;0
4425;64722;49;0;0;0;0;.00nan;0;0
4425;79132;49;85;46;5;41;.891;3600000;0
4425;79141;42;71;21;1;20;.952;3600000;0
4426;1593;4837;0;0;0;0;.00nan;0;0
4426;172340;48;0;0;0;0;.00nan;0;0
4426;86875;4837;61;37;4;33;.892;3600000;0
4426;142492;48;100;42;0;42;1.000;3600000;0
4427;188888;51;0;0;0;0;.00nan;0;0
4427;169154;51;82;49;4;45;.918;3600000;0
4427;175084;65;0;0;0;0;.00nan;0;0
4427;77084;65;69;23;1;22;.957;3600000;0
4428;163471;63;47;18;3;15;.833;3689000;0
4428;192457;63;0;0;0;0;.00nan;0;0
4428;86180;55;67;37;4;33;.892;3689000;0
4428;157189;55;0;0;0;0;.00nan;0;0
4429;182780;60;0;0;0;0;.00nan;0;0
4429;170294;60;48;26;4;22;.846;3557000;0
4429;170314;4619;78;29;2;27;.931;3600000;0
4429;191813;4619;0;0;0;0;.00nan;0;0
4430;178384;40;0;0;0;0;.00nan;0;0
4430;179306;61;0;0;0;0;.00nan;0;0
4430;78581;61;48;26;4;22;.846;3829000;0
4430;85636;40;54;35;5;30;.857;3829000;0
4431;173699;36;26;20;5;15;.750;1581000;0
4431;43928;39;0;0;0;0;.00nan;0;0
4431;57434;36;99;29;0;29;1.000;2278000;0
4431;143301;39;21;21;6;15;.714;3859000;0
4432;182780;60;91;44;3;41;.932;3600000;0
4432;170294;60;0;0;0;0;.00nan;0;0
4432;78479;47;0;0;0;0;.00nan;0;0
4432;86151;47;57;30;4;26;.867;3554000;0
4433;175084;65;0;0;0;0;.00nan;0;0
4433;77084;65;85;22;1;21;.955;3600000;0
4433;78977;38;0;0;0;0;.00nan;0;0
4433;141978;38;70;38;4;34;.895;3600000;0
4434;189644;42;0;0;0;0;.00nan;0;0
4434;58054;37;96;41;2;39;.951;3900000;0
4434;79141;42;66;20;2;18;.900;3900000;0
4434;85453;37;0;0;0;0;.00nan;0;0
4435;182780;60;0;0;0;0;.00nan;0;0
4435;170294;60;65;28;3;25;.893;3600000;0
4435;78479;47;0;0;0;0;.00nan;0;0
4435;86151;47;56;37;5;32;.865;3512000;0
4436;171608;45;0;0;0;0;.00nan;0;0
4436;176915;54;56;29;3;26;.897;3597000;0
4436;85798;45;81;30;2;28;.933;3600000;0
4436;94615;54;0;0;0;0;.00nan;0;0
4437;190106;46;22;27;7;20;.741;3600000;0
4437;58100;56;82;37;3;34;.919;3600000;0
4437;79280;46;0;0;0;0;.00nan;0;0
4437;85468;56;0;0;0;0;.00nan;0;0
4438;183783;52;0;0;0;0;.00nan;0;0
4438;180316;52;89;34;2;32;.941;3900000;0
4438;75362;57;0;0;0;0;.00nan;0;0
4438;86862;57;92;41;2;39;.951;3900000;0
4439;172499;50;0;0;0;0;.00nan;0;0
4439;43928;39;79;27;1;26;.963;3600000;0
4439;76574;50;70;47;5;42;.894;3600000;0
4439;143301;39;0;0;0;0;.00nan;0;0
4440;172340;48;45;24;4;20;.833;3694000;0
4440;178384;40;81;39;3;36;.923;3698000;0
4440;85636;40;0;0;0;0;.00nan;0;0
4440;142492;48;0;0;0;0;.00nan;0;0
4441;163471;63;56;25;3;22;.880;3541000;0
4441;188888;51;0;0;0;0;.00nan;0;0
4441;169154;51;86;36;2;34;.944;3600000;0
4441;192457;63;0;0;0;0;.00nan;0;0
4442;173699;36;83;39;3;36;.923;3600000;0
4442;57434;36;0;0;0;0;.00nan;0;0
4442;86180;55;0;0;0;0;.00nan;0;0
4442;157189;55;25;29;6;23;.793;3600000;0
4443;165744;53;82;31;2;29;.935;3600000;0
4443;169323;53;0;0;0;0;.00nan;0;0
4443;75362;57;58;43;6;37;.860;3323000;0
4443;86862;57;53;2;0;2;1.000;277000;0
4444;182780;60;92;20;0;20;1.000;3600000;0
4444;178384;40;59;34;4;30;.882;3600000;0
4444;170294;60;0;0;0;0;.00nan;0;0
4444;85636;40;0;0;0;0;.00nan;0;0
4445;171608;45;0;0;0;0;.00nan;0;0
4445;190106;46;80;27;2;25;.926;3900000;0
4445;79280;46;0;0;0;0;.00nan;0;0
4445;85798;45;82;32;2;30;.938;3900000;0
4446;176921;62;44;22;4;18;.818;3600000;0
4446;176938;62;0;0;0;0;.00nan;0;0
4446;78773;44;44;32;6;26;.813;3570000;0
4446;139467;44;0;0;0;0;.00nan;0;0
4447;183783;52;67;45;4;41;.911;3537000;0
4447;180316;52;0;0;0;0;.00nan;0;0
4447;191218;59;51;23;3;20;.870;3600000;0
4447;64911;59;0;0;0;0;.00nan;0;0
4448;1593;4837;0;0;0;0;.00nan;0;0
4448;64722;49;90;60;3;57;.950;3600000;0
4448;79132;49;0;0;0;0;.00nan;0;0
4448;86875;4837;87;19;0;19;1.000;3600000;0
4449;183904;43;77;32;3;29;.906;3569000;0
4449;178612;43;0;0;0;0;.00nan;0;0
4449;173699;36;0;0;0;0;.00nan;0;0
4449;57434;36;75;36;2;34;.944;3600000;0
4450;172499;50;0;0;0;0;.00nan;0;0
4450;43928;39;0;0;0;0;.00nan;0;0
4450;76574;50;87;37;3;34;.919;3900000;0
4450;143301;39;73;34;3;31;.912;3900000;0
4451;189644;42;80;30;2;28;.933;3600000;0
4451;176915;54;44;40;6;34;.850;3201000;0
4451;79141;42;0;0;0;0;.00nan;0;0
4451;94615;54;55;5;0;5;1.000;399000;0
4452;187699;41;67;39;4;35;.897;3791000;0
4452;188888;51;0;0;0;0;.00nan;0;0
4452;169154;51;76;35;3;32;.914;3791000;0
4452;170977;41;0;0;0;0;.00nan;0;0
4453;4622;64;71;36;3;33;.917;3900000;0
4453;168872;64;0;0;0;0;.00nan;0;0
4453;58054;37;62;27;3;24;.889;3900000;0
4453;85453;37;0;0;0;0;.00nan;0;0
4454;170314;4619;56;35;4;31;.886;3563000;0
4454;179306;61;0;0;0;0;.00nan;0;0
4454;191813;4619;0;0;0;0;.00nan;0;0
4454;78581;61;66;34;3;31;.912;3600000;0
4455;175084;65;0;0;0;0;.00nan;0;0
4455;77084;65;75;24;1;23;.958;3600000;0
4455;86180;55;78;28;2;26;.929;3543000;0
4455;157189;55;0;0;0;0;.00nan;0;0
4456;165744;53;0;0;0;0;.00nan;0;0
4456;169323;53;63;28;3;25;.893;3900000;0
4456;75362;57;0;0;0;0;.00nan;0;0
4456;86862;57;70;36;3;33;.917;3900000;0
4457;171608;45;71;21;1;20;.952;3600000;0
4457;176915;54;0;0;0;0;.00nan;0;0
4457;85798;45;0;0;0;0;.00nan;0;0
4457;94615;54;69;39;4;35;.897;3600000;0
4458;163471;63;88;22;1;21;.955;3900000;0
4458;192457;63;0;0;0;0;.00nan;0;0
4458;58100;56;97;49;1;48;.980;3900000;0
4458;85468;56;0;0;0;0;.00nan;0;0
4459;176921;62;57;35;5;30;.857;3518000;0
4459;176938;62;0;0;0;0;.00nan;0;0
4459;78773;44;0;0;0;0;.00nan;0;0
4459;139467;44;72;26;3;23;.885;3600000;0
4460;183783;52;0;0;0;0;.00nan;0;0
4460;180316;52;53;37;5;32;.865;3836000;0
4460;78977;38;0;0;0;0;.00nan;0;0
4460;141978;38;49;38;6;32;.842;3836000;0
4461;64722;49;0;0;0;0;.00nan;0;0
4461;78479;47;0;0;0;0;.00nan;0;0
4461;79132;49;84;32;1;31;.969;3567000;0
4461;86151;47;89;16;0;16;1.000;3600000;0
4462;183904;43;50;23;3;20;.870;3600000;0
4462;178612;43;0;0;0;0;.00nan;0;0
4462;173699;36;100;43;2;41;.953;3600000;0
4462;57434;36;0;0;0;0;.00nan;0;0
4463;189644;42;0;0;0;0;.00nan;0;0
4463;190106;46;0;0;0;0;.00nan;0;0
4463;79141;42;57;31;4;27;.871;3600000;0
4463;79280;46;80;24;1;23;.958;3600000;0
4464;1593;4837;0;0;0;0;.00nan;0;0
4464;172340;48;0;0;0;0;.00nan;0;0
4464;86875;4837;100;41;1;40;.976;3814000;0
4464;142492;48;80;27;2;25;.926;3814000;0
4465;188888;51;95;59;4;55;.932;3600000;0
4465;169154;51;0;0;0;0;.00nan;0;0
4465;175084;65;0;0;0;0;.00nan;0;0
4465;77084;65;83;9;0;9;1.000;3600000;0
4466;4622;64;99;38;1;37;.974;3600000;0
4466;168872;64;0;0;0;0;.00nan;0;0
4466;58054;37;0;0;0;0;.00nan;0;0
4466;85453;37;52;24;4;20;.833;3600000;0
4467;170314;4619;62;30;3;27;.900;3635000;0
4467;179306;61;70;26;2;24;.923;3635000;0
4467;191813;4619;0;0;0;0;.00nan;0;0
4467;78581;61;0;0;0;0;.00nan;0;0
4468;191218;59;0;0;0;0;.00nan;0;0
4468;64911;59;48;19;3;16;.842;3561000;0
4468;86180;55;83;33;2;31;.939;3600000;0
4468;157189;55;0;0;0;0;.00nan;0;0
4469;187699;41;51;34;5;29;.853;3600000;0
4469;170977;41;0;0;0;0;.00nan;0;0
4469;38124;58;87;22;1;21;.955;3600000;0
4469;149450;58;0;0;0;0;.00nan;0;0
4470;182780;60;100;47;2;45;.957;3900000;0
4470;178384;40;68;30;2;28;.933;3900000;0
4470;170294;60;0;0;0;0;.00nan;0;0
4470;85636;40;0;0;0;0;.00nan;0;0
4471;172499;50;0;0;0;0;.00nan;0;0
4471;76574;50;100;43;2;41;.953;3900000;0
4471;78773;44;0;0;0;0;.00nan;0;0
4471;139467;44;59;24;2;22;.917;3900000;0
4472;165744;53;71;32;3;29;.906;3747000;0
4472;169323;53;0;0;0;0;.00nan;0;0
4472;86180;55;80;31;2;29;.935;3740000;0
4472;157189;55;0;0;0;0;.00nan;0;0
4473;187699;41;99;39;1;38;.974;3600000;0
4473;170977;41;0;0;0;0;.00nan;0;0
4473;78977;38;53;26;3;23;.885;3522000;0
4473;141978;38;0;0;0;0;.00nan;0;0
4474;189644;42;55;24;3;21;.875;3600000;0
4474;176915;54;88;45;4;41;.911;3578000;0
4474;79141;42;0;0;0;0;.00nan;0;0
4474;94615;54;0;0;0;0;.00nan;0;0
4475;4622;64;100;26;0;26;1.000;3600000;0
4475;168872;64;0;0;0;0;.00nan;0;0
4475;176921;62;37;29;6;23;.793;3308000;0
4475;176938;62;53;3;0;3;1.000;292000;0
4476;172499;50;82;28;2;26;.929;3600000;0
4476;76574;50;0;0;0;0;.00nan;0;0
4476;78773;44;43;25;4;21;.840;3544000;0
4476;139467;44;0;0;0;0;.00nan;0;0
4477;1593;4837;0;0;0;0;.00nan;0;0
4477;179306;61;0;0;0;0;.00nan;0;0
4477;78581;61;63;30;3;27;.900;3600000;0
4477;86875;4837;100;28;0;28;1.000;3600000;0
4478;171608;45;0;0;0;0;.00nan;0;0
4478;190106;46;73;19;1;18;.947;3900000;0
4478;79280;46;0;0;0;0;.00nan;0;0
4478;85798;45;97;38;1;37;.974;3900000;0
4479;165744;53;0;0;0;0;.00nan;0;0
4479;183783;52;27;5;3;2;.400;393000;0
4479;169323;53;82;56;6;50;.893;3565000;0
4479;180316;52;70;28;2;26;.929;3207000;0
4480;172340;48;80;15;0;15;1.000;3600000;0
4480;64722;49;0;0;0;0;.00nan;0;0
4480;79132;49;97;61;3;58;.951;3600000;0
4480;142492;48;0;0;0;0;.00nan;0;0
4481;163471;63;92;28;1;27;.964;3600000;0
4481;192457;63;0;0;0;0;.00nan;0;0
4481;58100;56;72;34;3;31;.912;3517000;0
4481;85468;56;0;0;0;0;.00nan;0;0
4482;178384;40;69;28;3;25;.893;3600000;0
4482;170314;4619;51;26;4;22;.846;3544000;0
4482;191813;4619;0;0;0;0;.00nan;0;0
4482;85636;40;0;0;0;0;.00nan;0;0
4483;4622;64;73;38;3;35;.921;3600000;0
4483;168872;64;0;0;0;0;.00nan;0;0
4483;176921;62;51;27;4;23;.852;3543000;0
4483;176938;62;0;0;0;0;.00nan;0;0
4484;191218;59;0;0;0;0;.00nan;0;0
4484;43928;39;79;39;3;36;.923;3600000;0
4484;64911;59;50;34;5;29;.853;3528000;0
4484;143301;39;0;0;0;0;.00nan;0;0
4485;178384;40;0;0;0;0;.00nan;0;0
4485;78479;47;0;0;0;0;.00nan;0;0
4485;85636;40;97;49;1;48;.980;3579000;0
4485;86151;47;85;17;0;17;1.000;3600000;0
4486;1593;4837;0;0;0;0;.00nan;0;0
4486;182780;60;100;40;1;39;.975;3600000;0
4486;170294;60;0;0;0;0;.00nan;0;0
4486;86875;4837;55;18;2;16;.889;3554000;0
4487;183904;43;0;0;0;0;.00nan;0;0
4487;178612;43;47;30;4;26;.867;3600000;0
4487;191218;59;0;0;0;0;.00nan;0;0
4487;64911;59;81;26;1;25;.962;3600000;0
4488;190106;46;74;20;1;19;.950;3600000;0
4488;176915;54;98;55;2;53;.964;3559000;0
4488;79280;46;0;0;0;0;.00nan;0;0
4488;94615;54;0;0;0;0;.00nan;0;0
4489;58054;37;42;28;5;23;.821;3522000;0
4489;78977;38;0;0;0;0;.00nan;0;0
4489;85453;37;0;0;0;0;.00nan;0;0
4489;141978;38;90;43;3;40;.930;3600000;0
4490;188888;51;0;0;0;0;.00nan;0;0
4490;169154;51;98;36;1;35;.972;3600000;0
4490;173699;36;53;28;4;24;.857;3600000;0
4490;57434;36;0;0;0;0;.00nan;0;0
4491;187699;41;87;61;5;56;.918;3600000;0
4491;170977;41;0;0;0;0;.00nan;0;0
4491;175084;65;0;0;0;0;.00nan;0;0
4491;77084;65;66;15;1;14;.933;3600000;0
4492;38124;58;0;0;0;0;.00nan;0;0
4492;58100;56;100;25;0;25;1.000;3600000;0
4492;85468;56;0;0;0;0;.00nan;0;0
4492;149450;58;45;31;5;26;.839;3600000;0
4493;78479;47;0;0;0;0;.00nan;0;0
4493;78773;44;0;0;0;0;.00nan;0;0
4493;86151;47;58;39;5;34;.872;3900000;0
4493;139467;44;45;33;5;28;.848;3900000;0
4494;1593;4837;100;32;0;32;1.000;3600000;0
4494;182780;60;0;0;0;0;.00nan;0;0
4494;170294;60;25;25;6;19;.760;3600000;0
4494;86875;4837;0;0;0;0;.00nan;0;0
4495;188888;51;22;24;6;18;.750;2309000;0
4495;183904;43;91;27;1;26;.963;3600000;0
4495;178612;43;0;0;0;0;.00nan;0;0
4495;169154;51;55;11;1;10;.909;1291000;0
4496;165744;53;71;23;2;21;.913;3600000;0
4496;169323;53;0;0;0;0;.00nan;0;0
4496;38124;58;71;35;3;32;.914;3600000;0
4496;149450;58;0;0;0;0;.00nan;0;0
4497;183783;52;0;0;0;0;.00nan;0;0
4497;180316;52;86;33;2;31;.939;3600000;0
4497;75362;57;0;0;0;0;.00nan;0;0
4497;86862;57;91;49;3;46;.939;3599000;0
4498;176921;62;78;26;2;24;.923;3600000;0
4498;176938;62;0;0;0;0;.00nan;0;0
4498;64722;49;0;0;0;0;.00nan;0;0
4498;79132;49;73;41;5;36;.878;3600000;0
4499;58054;37;0;0;0;0;.00nan;0;0
4499;78977;38;62;37;4;33;.892;3535000;0
4499;85453;37;67;22;2;20;.909;3600000;0
4499;141978;38;0;0;0;0;.00nan;0;0
4500;173699;36;82;53;5;48;.906;3600000;0
4500;191218;59;71;27;2;25;.926;3600000;0
4500;57434;36;0;0;0;0;.00nan;0;0
4500;64911;59;0;0;0;0;.00nan;0;0
4501;187699;41;0;0;0;0;.00nan;0;0
4501;170977;41;70;28;3;25;.893;3600000;0
4501;58100;56;76;18;1;17;.944;3087000;0
4501;85468;56;28;9;3;6;.667;503000;0
4502;172499;50;0;0;0;0;.00nan;0;0
4502;171608;45;0;0;0;0;.00nan;0;0
4502;76574;50;68;22;2;20;.909;3550000;0
4502;85798;45;86;28;1;27;.964;3600000;0
4503;172340;48;56;35;3;32;.914;3600000;0
4503;178384;40;99;35;1;34;.971;3600000;0
4503;85636;40;0;0;0;0;.00nan;0;0
4503;142492;48;0;0;0;0;.00nan;0;0
4504;163471;63;100;38;1;37;.974;3600000;0
4504;175084;65;71;28;2;26;.929;3578000;0
4504;192457;63;0;0;0;0;.00nan;0;0
4504;77084;65;0;0;0;0;.00nan;0;0
4505;190106;46;61;14;1;13;.929;3259000;0
4505;176915;54;91;48;3;45;.938;3600000;0
4505;79280;46;27;7;3;4;.571;307000;0
4505;94615;54;0;0;0;0;.00nan;0;0
4506;170314;4619;100;41;1;40;.976;3900000;0
4506;179306;61;0;0;0;0;.00nan;0;0
4506;191813;4619;0;0;0;0;.00nan;0;0
4506;78581;61;86;26;1;25;.962;3900000;0
4507;4622;64;56;31;4;27;.871;3600000;0
4507;168872;64;0;0;0;0;.00nan;0;0
4507;189644;42;81;25;1;24;.960;3600000;0
4507;79141;42;0;0;0;0;.00nan;0;0
4508;43928;39;0;0;0;0;.00nan;0;0
4508;86180;55;81;44;4;40;.909;3900000;0
4508;143301;39;83;42;4;38;.905;3900000;0
4508;157189;55;0;0;0;0;.00nan;0;0
4509;78479;47;0;0;0;0;.00nan;0;0
4509;78773;44;69;30;3;27;.900;3900000;0
4509;86151;47;83;40;3;37;.925;3900000;0
4509;139467;44;0;0;0;0;.00nan;0;0
4510;163471;63;0;0;0;0;.00nan;0;0
4510;165744;53;0;0;0;0;.00nan;0;0
4510;169323;53;76;31;2;29;.935;3755000;0
4510;192457;63;70;36;3;33;.917;3755000;0
4511;183783;52;67;16;1;15;.938;3600000;0
4511;180316;52;0;0;0;0;.00nan;0;0
4511;75362;57;24;16;4;12;.750;1880000;0
4511;86862;57;74;22;2;20;.909;1720000;0
4512;176921;62;66;19;1;18;.947;3600000;0
4512;176938;62;0;0;0;0;.00nan;0;0
4512;64722;49;79;48;4;44;.917;3600000;0
4512;79132;49;0;0;0;0;.00nan;0;0
4513;172499;50;88;34;1;33;.971;3600000;0
4513;171608;45;0;0;0;0;.00nan;0;0
4513;76574;50;0;0;0;0;.00nan;0;0
4513;85798;45;84;29;2;27;.931;3545000;0
4514;170314;4619;0;0;0;0;.00nan;0;0
4514;179306;61;65;37;4;33;.892;3900000;0
4514;191813;4619;65;43;4;39;.907;3900000;0
4514;78581;61;0;0;0;0;.00nan;0;0
4515;4622;64;98;49;3;46;.939;3600000;0
4515;168872;64;0;0;0;0;.00nan;0;0
4515;189644;42;0;0;0;0;.00nan;0;0
4515;79141;42;18;27;7;20;.741;3600000;0
4516;43928;39;75;28;2;26;.929;3588000;0
4516;86180;55;84;32;1;31;.969;3600000;0
4516;143301;39;0;0;0;0;.00nan;0;0
4516;157189;55;0;0;0;0;.00nan;0;0
4517;187699;41;31;31;6;25;.806;3600000;0
4517;170977;41;0;0;0;0;.00nan;0;0
4517;38124;58;0;0;0;0;.00nan;0;0
4517;149450;58;66;15;1;14;.933;3600000;0
4518;176915;54;81;53;4;49;.925;3672000;0
4518;58054;37;45;17;3;14;.824;3647000;0
4518;85453;37;0;0;0;0;.00nan;0;0
4518;94615;54;0;0;0;0;.00nan;0;0
4519;1593;4837;0;0;0;0;.00nan;0;0
4519;170314;4619;90;29;2;27;.931;3567000;0
4519;191813;4619;0;0;0;0;.00nan;0;0
4519;86875;4837;87;31;1;30;.968;3600000;0
4520;172340;48;74;30;2;28;.933;3600000;0
4520;78479;47;0;0;0;0;.00nan;0;0
4520;86151;47;76;33;3;30;.909;3595000;0
4520;142492;48;0;0;0;0;.00nan;0;0
4521;178384;40;88;29;1;28;.966;3600000;0
4521;64722;49;0;0;0;0;.00nan;0;0
4521;79132;49;76;41;3;38;.927;3561000;0
4521;85636;40;0;0;0;0;.00nan;0;0
4522;183904;43;88;30;2;28;.933;3600000;0
4522;178612;43;0;0;0;0;.00nan;0;0
4522;43928;39;0;0;0;0;.00nan;0;0
4522;143301;39;51;29;4;25;.862;3570000;0
4523;182780;60;69;26;2;24;.923;3586000;0
4523;170294;60;0;0;0;0;.00nan;0;0
4523;78773;44;0;0;0;0;.00nan;0;0
4523;139467;44;100;29;0;29;1.000;3600000;0
4524;173699;36;84;35;2;33;.943;3600000;0
4524;57434;36;0;0;0;0;.00nan;0;0
4524;58100;56;77;41;4;37;.902;3517000;0
4524;85468;56;0;0;0;0;.00nan;0;0
4525;182780;60;0;0;0;0;.00nan;0;0
4525;170294;60;66;42;4;38;.905;3600000;0
4525;78773;44;0;0;0;0;.00nan;0;0
4525;139467;44;70;18;1;17;.944;3600000;0
4526;1593;4837;0;0;0;0;.00nan;0;0
4526;78479;47;0;0;0;0;.00nan;0;0
4526;86151;47;77;40;4;36;.900;3600000;0
4526;86875;4837;99;38;1;37;.974;3600000;0
4527;190106;46;51;14;2;12;.857;3600000;0
4527;176915;54;89;52;3;49;.942;3600000;0
4527;79280;46;0;0;0;0;.00nan;0;0
4527;94615;54;0;0;0;0;.00nan;0;0
4528;183783;52;0;0;0;0;.00nan;0;0
4528;180316;52;97;52;2;50;.962;3900000;0
4528;191218;59;64;23;2;21;.913;3900000;0
4528;64911;59;0;0;0;0;.00nan;0;0
4529;187699;41;63;35;4;31;.886;3600000;0
4529;170977;41;0;0;0;0;.00nan;0;0
4529;78977;38;0;0;0;0;.00nan;0;0
4529;141978;38;79;22;1;21;.955;3600000;0
4530;189644;42;71;24;2;22;.917;3600000;0
4530;171608;45;0;0;0;0;.00nan;0;0
4530;79141;42;0;0;0;0;.00nan;0;0
4530;85798;45;74;35;3;32;.914;3600000;0
4531;172340;48;39;30;5;25;.833;3600000;0
4531;170314;4619;37;34;6;28;.824;2687000;0
4531;191813;4619;53;11;1;10;.909;913000;0
4531;142492;48;0;0;0;0;.00nan;0;0
4532;175084;65;0;0;0;0;.00nan;0;0
4532;77084;65;100;33;0;33;1.000;3600000;0
4532;86180;55;82;40;3;37;.925;3600000;0
4532;157189;55;0;0;0;0;.00nan;0;0
4533;163471;63;88;34;2;32;.941;3543000;0
4533;183904;43;83;24;1;23;.958;3600000;0
4533;178612;43;0;0;0;0;.00nan;0;0
4533;192457;63;0;0;0;0;.00nan;0;0
4534;4622;64;94;43;3;40;.930;3900000;0
4534;178384;40;72;31;3;28;.903;3900000;0
4534;168872;64;0;0;0;0;.00nan;0;0
4534;85636;40;0;0;0;0;.00nan;0;0
4535;188888;51;0;0;0;0;.00nan;0;0
4535;169154;51;61;42;5;37;.881;3600000;0
4535;43928;39;0;0;0;0;.00nan;0;0
4535;143301;39;58;20;2;18;.900;3600000;0
4536;179306;61;0;0;0;0;.00nan;0;0
4536;176921;62;38;16;3;13;.813;3514000;0
4536;176938;62;0;0;0;0;.00nan;0;0
4536;78581;61;99;45;1;44;.978;3600000;0
4537;165744;53;61;31;4;27;.871;3600000;0
4537;169323;53;0;0;0;0;.00nan;0;0
4537;38124;58;62;23;2;21;.913;3600000;0
4537;149450;58;0;0;0;0;.00nan;0;0
4538;171608;45;80;43;4;39;.907;3600000;0
4538;190106;46;0;0;0;0;.00nan;0;0
4538;79280;46;57;13;1;12;.923;3600000;0
4538;85798;45;0;0;0;0;.00nan;0;0
4539;173699;36;33;32;6;26;.813;2619000;0
4539;57434;36;43;5;1;4;.800;981000;0
4539;58100;56;91;29;1;28;.966;3600000;0
4539;85468;56;0;0;0;0;.00nan;0;0
4540;172340;48;0;0;0;0;.00nan;0;0
4540;64722;49;0;0;0;0;.00nan;0;0
4540;79132;49;74;29;2;27;.931;3600000;0
4540;142492;48;65;39;4;35;.897;3511000;0
4541;187699;41;0;0;0;0;.00nan;0;0
4541;165744;53;65;31;3;28;.903;3100000;0
4541;169323;53;22;4;3;1;.250;500000;0
4541;170977;41;69;31;3;28;.903;3600000;0
4542;172499;50;0;0;0;0;.00nan;0;0
4542;58054;37;91;32;1;31;.969;3701000;0
4542;76574;50;93;37;2;35;.946;3701000;0
4542;85453;37;0;0;0;0;.00nan;0;0
4543;175084;65;0;0;0;0;.00nan;0;0
4543;77084;65;100;26;0;26;1.000;3600000;0
4543;86180;55;67;37;4;33;.892;3600000;0
4543;157189;55;0;0;0;0;.00nan;0;0
4544;163471;63;96;47;2;45;.957;3514000;0
4544;183904;43;0;0;0;0;.00nan;0;0
4544;178612;43;95;22;0;22;1.000;3600000;0
4544;192457;63;0;0;0;0;.00nan;0;0
4545;189644;42;0;0;0;0;.00nan;0;0
4545;176915;54;0;0;0;0;.00nan;0;0
4545;79141;42;61;17;2;15;.882;3541000;0
4545;94615;54;100;32;0;32;1.000;3600000;0
4546;4622;64;40;32;6;26;.813;3148000;0
4546;178384;40;0;0;0;0;.00nan;0;0
4546;168872;64;46;7;1;6;.857;452000;0
4546;85636;40;81;33;3;30;.909;3600000;0
4547;191218;59;0;0;0;0;.00nan;0;0
4547;64911;59;77;9;0;9;1.000;3600000;0
4547;75362;57;0;0;0;0;.00nan;0;0
4547;86862;57;97;52;3;49;.942;3600000;0
4548;188888;51;52;43;6;37;.860;3600000;0
4548;169154;51;0;0;0;0;.00nan;0;0
4548;43928;39;41;15;3;12;.800;3600000;0
4548;143301;39;0;0;0;0;.00nan;0;0
4549;179306;61;64;20;2;18;.900;3600000;0
4549;176921;62;61;46;5;41;.891;3600000;0
4549;176938;62;0;0;0;0;.00nan;0;0
4549;78581;61;0;0;0;0;.00nan;0;0
4550;38124;58;0;0;0;0;.00nan;0;0
4550;78977;38;91;31;1;30;.968;3600000;0
4550;141978;38;0;0;0;0;.00nan;0;0
4550;149450;58;58;29;3;26;.897;3516000;0
4551;171608;45;0;0;0;0;.00nan;0;0
4551;190106;46;71;25;3;22;.880;3900000;0
4551;79280;46;0;0;0;0;.00nan;0;0
4551;85798;45;97;54;3;51;.944;3900000;0
4552;170314;4619;58;33;5;28;.848;2927000;0
4552;191813;4619;57;3;0;3;1.000;673000;0
4552;78479;47;54;13;2;11;.846;1732000;0
4552;86151;47;26;19;5;14;.737;1841000;0
4553;183783;52;75;22;1;21;.955;3600000;0
4553;180316;52;0;0;0;0;.00nan;0;0
4553;75362;57;62;43;5;38;.884;3600000;0
4553;86862;57;0;0;0;0;.00nan;0;0
4554;38124;58;59;27;4;23;.852;3722000;0
4554;78977;38;0;0;0;0;.00nan;0;0
4554;141978;38;70;25;3;22;.880;3722000;0
4554;149450;58;0;0;0;0;.00nan;0;0
4555;172499;50;75;37;3;34;.919;3600000;0
4555;58054;37;0;0;0;0;.00nan;0;0
4555;76574;50;0;0;0;0;.00nan;0;0
4555;85453;37;68;24;2;22;.917;3600000;0
4556;189644;42;82;15;0;15;1.000;3600000;0
4556;176915;54;0;0;0;0;.00nan;0;0
4556;79141;42;0;0;0;0;.00nan;0;0
4556;94615;54;84;45;3;42;.933;3600000;0
4557;175084;65;0;0;0;0;.00nan;0;0
4557;191218;59;82;28;1;27;.964;3600000;0
4557;64911;59;0;0;0;0;.00nan;0;0
4557;77084;65;50;33;4;29;.879;3600000;0
4558;170314;4619;70;49;5;44;.898;3600000;0
4558;176921;62;67;26;2;24;.923;3600000;0
4558;176938;62;0;0;0;0;.00nan;0;0
4558;191813;4619;0;0;0;0;.00nan;0;0
4559;1593;4837;0;0;0;0;.00nan;0;0
4559;172340;48;73;29;2;27;.931;3583000;0
4559;86875;4837;79;26;1;25;.962;3600000;0
4559;142492;48;0;0;0;0;.00nan;0;0
4560;188888;51;0;0;0;0;.00nan;0;0
4560;183904;43;0;0;0;0;.00nan;0;0
4560;178612;43;81;35;2;33;.943;3600000;0
4560;169154;51;72;43;4;39;.907;3539000;0
4561;179306;61;0;0;0;0;.00nan;0;0
4561;78479;47;0;0;0;0;.00nan;0;0
4561;78581;61;35;21;5;16;.762;3600000;0
4561;86151;47;67;34;4;30;.882;3600000;0
4562;170314;4619;0;0;0;0;.00nan;0;0
4562;176921;62;48;18;3;15;.833;3531000;0
4562;176938;62;0;0;0;0;.00nan;0;0
4562;191813;4619;91;28;1;27;.964;3600000;0
4563;75362;57;60;34;3;31;.912;3598000;0
4563;78977;38;0;0;0;0;.00nan;0;0
4563;86862;57;0;0;0;0;.00nan;0;0
4563;141978;38;77;27;2;25;.926;3600000;0
4564;190106;46;19;24;6;18;.750;3193000;0
4564;58054;37;57;29;3;26;.897;3600000;0
4564;79280;46;47;5;1;4;.800;407000;0
4564;85453;37;0;0;0;0;.00nan;0;0
4565;172499;50;0;0;0;0;.00nan;0;0
4565;189644;42;70;19;1;18;.947;3600000;0
4565;76574;50;97;44;2;42;.955;3600000;0
4565;79141;42;0;0;0;0;.00nan;0;0
4566;163471;63;26;6;3;3;.500;580000;0
4566;43928;39;0;0;0;0;.00nan;0;0
4566;192457;63;79;26;1;25;.962;2977000;0
4566;143301;39;52;21;3;18;.857;3600000;0
4567;182780;60;76;51;5;46;.902;3600000;0
4567;170294;60;0;0;0;0;.00nan;0;0
4567;78773;44;0;0;0;0;.00nan;0;0
4567;139467;44;73;22;2;20;.909;3600000;0
4568;183904;43;88;31;1;30;.968;3600000;0
4568;178612;43;0;0;0;0;.00nan;0;0
4568;173699;36;91;38;2;36;.947;3600000;0
4568;57434;36;0;0;0;0;.00nan;0;0
4569;187699;41;79;42;3;39;.929;3600000;0
4569;165744;53;70;5;0;5;1.000;3600000;0
4569;169323;53;0;0;0;0;.00nan;0;0
4569;170977;41;0;0;0;0;.00nan;0;0
4570;183783;52;0;0;0;0;.00nan;0;0
4570;180316;52;100;34;1;33;.971;3900000;0
4570;38124;58;0;0;0;0;.00nan;0;0
4570;149450;58;98;45;1;44;.978;3900000;0
4571;1593;4837;0;0;0;0;.00nan;0;0
4571;64722;49;0;0;0;0;.00nan;0;0
4571;79132;49;78;42;3;39;.929;3600000;0
4571;86875;4837;31;24;5;19;.792;3515000;0
4572;190106;46;64;23;2;21;.913;3600000;0
4572;58054;37;44;31;5;26;.839;3600000;0
4572;79280;46;0;0;0;0;.00nan;0;0
4572;85453;37;0;0;0;0;.00nan;0;0
4573;175084;65;0;0;0;0;.00nan;0;0
4573;191218;59;0;0;0;0;.00nan;0;0
4573;64911;59;71;34;3;31;.912;3900000;0
4573;77084;65;61;29;3;26;.897;3900000;0
4574;163471;63;53;38;5;33;.868;3521000;0
4574;192457;63;0;0;0;0;.00nan;0;0
4574;58100;56;74;37;4;33;.892;3600000;0
4574;85468;56;0;0;0;0;.00nan;0;0
4575;171608;45;0;0;0;0;.00nan;0;0
4575;176915;54;75;23;1;22;.957;3600000;0
4575;85798;45;93;44;4;40;.909;3600000;0
4575;94615;54;0;0;0;0;.00nan;0;0
4576;4622;64;19;9;4;5;.556;1065000;0
4576;172499;50;0;0;0;0;.00nan;0;0
4576;168872;64;85;16;0;16;1.000;2835000;0
4576;76574;50;100;54;4;50;.926;3900000;0
4577;178384;40;63;39;4;35;.897;3589000;0
4577;179306;61;0;0;0;0;.00nan;0;0
4577;78581;61;52;18;3;15;.833;3600000;0
4577;85636;40;0;0;0;0;.00nan;0;0
4578;188888;51;0;0;0;0;.00nan;0;0
4578;169154;51;64;40;5;35;.875;3600000;0
4578;86180;55;64;20;2;18;.900;3600000;0
4578;157189;55;0;0;0;0;.00nan;0;0
4579;182780;60;0;0;0;0;.00nan;0;0
4579;170294;60;51;28;4;24;.857;3600000;0
4579;78773;44;69;30;3;27;.900;3600000;0
4579;139467;44;0;0;0;0;.00nan;0;0
4580;1593;4837;0;0;0;0;.00nan;0;0
4580;64722;49;98;64;4;60;.938;3552000;0
4580;79132;49;0;0;0;0;.00nan;0;0
4580;86875;4837;43;9;2;7;.778;3600000;0
4581;165744;53;92;42;2;40;.952;3600000;0
4581;169323;53;0;0;0;0;.00nan;0;0
4581;175084;65;65;34;3;31;.912;3583000;0
4581;77084;65;0;0;0;0;.00nan;0;0
4582;171608;45;63;29;3;26;.897;3600000;0
4582;58054;37;0;0;0;0;.00nan;0;0
4582;85453;37;78;28;1;27;.964;3600000;0
4582;85798;45;0;0;0;0;.00nan;0;0
4583;172340;48;0;0;0;0;.00nan;0;0
4583;176921;62;58;22;2;20;.909;3900000;0
4583;176938;62;0;0;0;0;.00nan;0;0
4583;142492;48;94;46;2;44;.957;3900000;0
4584;75362;57;0;0;0;0;.00nan;0;0
4584;78977;38;0;0;0;0;.00nan;0;0
4584;86862;57;76;34;3;31;.912;3600000;0
4584;141978;38;53;30;4;26;.867;3569000;0
4585;183904;43;0;0;0;0;.00nan;0;0
4585;178612;43;44;19;3;16;.842;3831000;0
4585;173699;36;0;0;0;0;.00nan;0;0
4585;57434;36;81;43;4;39;.907;3831000;0
4586;187699;41;0;0;0;0;.00nan;0;0
4586;170977;41;55;32;4;28;.875;3532000;0
4586;38124;58;80;28;2;26;.929;3600000;0
4586;149450;58;0;0;0;0;.00nan;0;0
4587;189644;42;66;18;1;17;.944;3652000;0
4587;176915;54;94;57;2;55;.965;3652000;0
4587;79141;42;0;0;0;0;.00nan;0;0
4587;94615;54;0;0;0;0;.00nan;0;0
4588;170314;4619;83;29;1;28;.966;3600000;0
4588;191813;4619;0;0;0;0;.00nan;0;0
4588;78479;47;0;0;0;0;.00nan;0;0
4588;86151;47;77;42;3;39;.929;3537000;0
4589;183783;52;75;37;3;34;.919;3588000;0
4589;180316;52;0;0;0;0;.00nan;0;0
4589;191218;59;74;31;1;30;.968;3600000;0
4589;64911;59;0;0;0;0;.00nan;0;0
4590;188888;51;69;39;4;35;.897;3600000;0
4590;169154;51;0;0;0;0;.00nan;0;0
4590;86180;55;56;11;1;10;.909;3600000;0
4590;157189;55;0;0;0;0;.00nan;0;0
4591;4622;64;61;20;2;18;.900;3600000;0
4591;172499;50;54;35;4;31;.886;3587000;0
4591;168872;64;0;0;0;0;.00nan;0;0
4591;76574;50;0;0;0;0;.00nan;0;0
4592;43928;39;0;0;0;0;.00nan;0;0
4592;58100;56;0;0;0;0;.00nan;0;0
4592;85468;56;61;41;5;36;.878;3665000;0
4592;143301;39;33;18;4;14;.778;3665000;0
4593;178384;40;0;0;0;0;.00nan;0;0
4593;179306;61;62;21;2;19;.905;3600000;0
4593;78581;61;0;0;0;0;.00nan;0;0
4593;85636;40;47;51;7;44;.863;3600000;0
4594;171608;45;0;0;0;0;.00nan;0;0
4594;176915;54;57;33;4;29;.879;3600000;0
4594;85798;45;77;25;1;24;.960;3600000;0
4594;94615;54;0;0;0;0;.00nan;0;0
4595;170314;4619;42;33;6;27;.818;3600000;0
4595;191813;4619;0;0;0;0;.00nan;0;0
4595;78479;47;0;0;0;0;.00nan;0;0
4595;86151;47;58;22;3;19;.864;3600000;0
4596;172340;48;100;46;1;45;.978;3600000;0
4596;176921;62;47;21;3;18;.857;3514000;0
4596;176938;62;0;0;0;0;.00nan;0;0
4596;142492;48;0;0;0;0;.00nan;0;0
4597;189644;42;0;0;0;0;.00nan;0;0
4597;190106;46;69;40;6;34;.850;3600000;0
4597;79141;42;81;26;1;25;.962;3600000;0
4597;79280;46;0;0;0;0;.00nan;0;0
4598;187699;41;59;35;3;32;.914;3585000;0
4598;170977;41;0;0;0;0;.00nan;0;0
4598;75362;57;71;25;2;23;.920;3600000;0
4598;86862;57;0;0;0;0;.00nan;0;0
4599;183783;52;0;0;0;0;.00nan;0;0
4599;175084;65;0;0;0;0;.00nan;0;0
4599;180316;52;78;51;4;47;.922;3547000;0
4599;77084;65;55;22;3;19;.864;3600000;0
4600;43928;39;100;27;1;26;.963;3600000;0
4600;58100;56;40;41;7;34;.829;3600000;0
4600;85468;56;0;0;0;0;.00nan;0;0
4600;143301;39;0;0;0;0;.00nan;0;0
4601;163471;63;95;33;2;31;.939;3600000;0
4601;192457;63;0;0;0;0;.00nan;0;0
4601;86180;55;68;39;4;35;.897;3584000;0
4601;157189;55;0;0;0;0;.00nan;0;0
4603;170294;60;0;0;0;0;.00nan;0;0
4603;190106;46;41;28;5;23;.821;3600000;0
4603;79280;46;0;0;0;0;.00nan;0;0
4603;91398;60;100;30;0;30;1.000;3600000;0
4605;4622;38;91;24;1;23;.958;3600000;0
4605;175084;65;0;0;0;0;.00nan;0;0
4605;38276;65;44;34;5;29;.853;3600000;0
4605;64722;38;0;0;0;0;.00nan;0;0
4607;179306;61;0;0;0;0;.00nan;0;0
4607;38124;58;52;37;5;32;.865;3600000;0
4607;78581;61;71;21;2;19;.905;3600000;0
4607;149450;58;0;0;0;0;.00nan;0;0
4609;183904;43;57;36;5;31;.861;3546000;0
4609;178612;43;0;0;0;0;.00nan;0;0
4609;60773;47;0;0;0;0;.00nan;0;0
4609;79141;47;64;35;4;31;.886;3600000;0
4611;187578;53;98;37;1;36;.973;3600000;0
4611;169323;53;0;0;0;0;.00nan;0;0
4611;189644;42;49;24;4;20;.833;3600000;0
4611;57695;42;0;0;0;0;.00nan;0;0
4613;168872;64;80;30;1;29;.967;3600000;0
4613;85546;4837;69;27;2;25;.926;3588000;0
4613;86875;4837;0;0;0;0;.00nan;0;0
4613;141850;64;0;0;0;0;.00nan;0;0
4615;188888;51;70;19;1;18;.947;3600000;0
4615;169154;51;0;0;0;0;.00nan;0;0
4615;75362;57;0;0;0;0;.00nan;0;0
4615;86862;57;67;46;5;41;.891;3600000;0
4617;171608;45;0;0;0;0;.00nan;0;0
4617;58100;56;73;28;2;26;.929;3600000;0
4617;85468;56;0;0;0;0;.00nan;0;0
4617;85798;45;40;36;5;31;.861;3600000;0
4619;173699;36;63;41;5;36;.878;3600000;0
4619;176860;44;0;0;0;0;.00nan;0;0
4619;57434;36;0;0;0;0;.00nan;0;0
4619;86180;44;90;26;1;25;.962;3600000;0
4621;163471;63;50;26;4;22;.846;3600000;0
4621;176915;54;62;11;0;11;1.000;603000;0
4621;181123;63;0;0;0;0;.00nan;0;0
4621;94615;54;32;40;7;33;.825;2997000;0
4623;183783;52;100;28;0;28;1.000;3600000;0
4623;180316;52;0;0;0;0;.00nan;0;0
4623;43928;39;0;0;0;0;.00nan;0;0
4623;143301;39;74;29;2;27;.931;3593000;0
4625;174718;4619;67;29;3;26;.897;3720000;0
4625;191813;4619;0;0;0;0;.00nan;0;0
4625;79132;49;70;26;2;24;.923;3720000;0
4625;91225;49;0;0;0;0;.00nan;0;0
4627;172340;48;65;24;2;22;.917;3595000;0
4627;176938;62;0;0;0;0;.00nan;0;0
4627;142492;48;0;0;0;0;.00nan;0;0
4627;152418;62;87;27;1;26;.963;3600000;0
4629;187699;41;77;41;3;38;.927;3600000;0
4629;163462;55;0;0;0;0;.00nan;0;0
4629;170728;55;40;24;4;20;.833;3524000;0
4629;-1;41;0;0;0;0;.00nan;0;0
4631;172499;50;74;29;2;27;.931;1231000;0
4631;43731;37;0;0;0;0;.00nan;0;0
4631;76574;50;67;31;4;27;.871;2369000;0
4631;85453;37;84;10;0;10;1.000;3600000;0
4633;3284;59;0;0;0;0;.00nan;0;0
4633;178384;40;76;55;5;50;.909;3560000;0
4633;176921;59;63;24;3;21;.875;3600000;0
4633;85636;40;0;0;0;0;.00nan;0;0
4634;175764;729;0;0;0;0;.00nan;0;0
4634;-1;745;0;0;0;0;.00nan;0;0
4634;75268;745;38;33;6;27;.818;3600000;0
4634;88646;729;90;36;2;34;.944;3600000;0
4635;195867;2168;0;0;0;0;.00nan;0;0
4635;-1;751;0;0;0;0;.00nan;0;0
4635;49935;2168;67;42;4;38;.905;3600000;0
4635;148788;751;55;26;3;23;.885;3600000;0
4636;3756;752;83;41;3;38;.927;3546000;0
4636;61272;752;0;0;0;0;.00nan;0;0
4636;66245;748;0;0;0;0;.00nan;0;0
4636;67362;748;77;25;2;23;.920;3600000;0
4637;1957;733;49;47;7;40;.851;3600000;0
4637;178098;738;68;26;2;24;.923;3600000;0
4637;185442;738;0;0;0;0;.00nan;0;0
4637;67287;733;0;0;0;0;.00nan;0;0
4638;201075;736;72;41;4;37;.902;3600000;0
4638;196715;736;0;0;0;0;.00nan;0;0
4638;44526;734;74;19;1;18;.947;3600000;0
4638;192386;734;0;0;0;0;.00nan;0;0
4639;2643;742;51;24;3;21;.875;3560000;0
4639;196698;741;0;0;0;0;.00nan;0;0
4639;46792;741;100;44;1;43;.977;3600000;0
4639;-1;742;0;0;0;0;.00nan;0;0
4640;848;743;35;18;4;14;.778;3565000;0
4640;187925;3789;76;33;2;31;.939;3600000;0
4640;190589;743;0;0;0;0;.00nan;0;0
4640;-1;3789;0;0;0;0;.00nan;0;0
4641;83;737;59;27;3;24;.889;3600000;0
4641;199033;737;0;0;0;0;.00nan;0;0
4641;190570;1880;87;37;2;35;.946;3600000;0
4641;-1;1880;0;0;0;0;.00nan;0;0
4642;8505;732;81;40;3;37;.925;3600000;0
4642;56565;732;0;0;0;0;.00nan;0;0
4642;63932;749;0;0;0;0;.00nan;0;0
4642;85281;749;34;27;6;21;.778;3600000;0
4643;195887;764;0;0;0;0;.00nan;0;0
4643;-1;764;55;38;5;33;.868;3579000;0
4643;49900;744;45;26;4;22;.846;3600000;0
4643;52204;744;0;0;0;0;.00nan;0;0
4644;175764;729;0;0;0;0;.00nan;0;0
4644;57107;747;0;0;0;0;.00nan;0;0
4644;76405;747;74;40;4;36;.900;3545000;0
4644;88646;729;60;23;3;20;.870;3600000;0
4645;504;740;0;0;0;0;.00nan;0;0
4645;595;740;95;41;2;39;.951;3600000;0
4645;188561;739;0;0;0;0;.00nan;0;0
4645;33044;739;52;29;3;26;.897;3600000;0
4646;2643;742;82;29;1;28;.966;3600000;0
4646;-1;742;0;0;0;0;.00nan;0;0
4646;-1;745;0;0;0;0;.00nan;0;0
4646;75268;745;63;32;3;29;.906;3571000;0
4647;-1;751;0;0;0;0;.00nan;0;0
4647;66245;748;83;25;1;24;.960;3600000;0
4647;67362;748;0;0;0;0;.00nan;0;0
4647;148788;751;94;32;2;30;.938;3592000;0
4648;44526;734;43;27;6;21;.778;3052000;0
4648;192386;734;60;5;0;5;1.000;548000;0
4648;63932;749;0;0;0;0;.00nan;0;0
4648;85281;749;67;29;3;26;.897;3600000;0
4649;83;737;75;11;0;11;1.000;3600000;0
4649;1957;733;70;43;5;38;.884;3600000;0
4649;199033;737;0;0;0;0;.00nan;0;0
4649;67287;733;0;0;0;0;.00nan;0;0
4650;201075;736;95;35;1;34;.971;3600000;0
4650;196698;741;0;0;0;0;.00nan;0;0
4650;196715;736;0;0;0;0;.00nan;0;0
4650;46792;741;64;27;3;24;.889;3573000;0
4651;178098;738;85;27;1;26;.963;3600000;0
4651;190570;1880;60;27;3;24;.889;3526000;0
4651;185442;738;0;0;0;0;.00nan;0;0
4651;-1;1880;0;0;0;0;.00nan;0;0
4652;187925;3789;0;0;0;0;.00nan;0;0
4652;8505;732;0;0;0;0;.00nan;0;0
4652;-1;3789;70;32;2;30;.938;3567000;0
4652;56565;732;77;19;1;18;.947;3600000;0
4653;3756;752;73;47;5;42;.894;3593000;0
4653;195887;764;0;0;0;0;.00nan;0;0
4653;-1;764;43;18;3;15;.833;3600000;0
4653;61272;752;0;0;0;0;.00nan;0;0
4654;175764;729;0;0;0;0;.00nan;0;0
4654;49900;744;57;21;2;19;.905;3600000;0
4654;52204;744;0;0;0;0;.00nan;0;0
4654;88646;729;66;33;4;29;.879;3514000;0
4655;1957;733;70;47;5;42;.894;3600000;0
4655;-1;745;86;19;0;19;1.000;3600000;0
4655;67287;733;0;0;0;0;.00nan;0;0
4655;75268;745;0;0;0;0;.00nan;0;0
4656;83;737;76;27;1;26;.963;3600000;0
4656;187925;3789;0;0;0;0;.00nan;0;0
4656;199033;737;0;0;0;0;.00nan;0;0
4656;-1;3789;75;36;3;33;.917;3600000;0
4657;3756;752;98;35;1;34;.971;3900000;0
4657;196698;741;0;0;0;0;.00nan;0;0
4657;46792;741;71;26;1;25;.962;3900000;0
4657;61272;752;0;0;0;0;.00nan;0;0
4658;2643;742;52;27;4;23;.852;3900000;0
4658;188561;739;0;0;0;0;.00nan;0;0
4658;33044;739;72;39;4;35;.897;3900000;0
4658;-1;742;0;0;0;0;.00nan;0;0
4659;504;740;0;0;0;0;.00nan;0;0
4659;595;740;84;36;2;34;.944;3525000;0
4659;201075;736;85;15;0;15;1.000;3600000;0
4659;196715;736;0;0;0;0;.00nan;0;0
4660;848;743;99;45;2;43;.956;3600000;0
4660;178098;738;0;0;0;0;.00nan;0;0
4660;190589;743;0;0;0;0;.00nan;0;0
4660;185442;738;45;19;3;16;.842;3563000;0
4661;190570;1880;56;25;3;22;.880;3568000;0
4661;-1;1880;0;0;0;0;.00nan;0;0
4661;63932;749;0;0;0;0;.00nan;0;0
4661;85281;749;89;39;2;37;.949;3600000;0
4662;8505;732;0;0;0;0;.00nan;0;0
4662;56565;732;71;34;4;30;.882;3600000;0
4662;57107;747;52;3;0;3;1.000;434000;0
4662;76405;747;29;27;6;21;.778;3123000;0
4663;195867;2168;0;0;0;0;.00nan;0;0
4663;195887;764;0;0;0;0;.00nan;0;0
4663;-1;764;75;52;5;47;.904;3600000;0
4663;49935;2168;94;25;0;25;1.000;3600000;0
4664;44526;734;83;31;1;30;.968;3600000;0
4664;192386;734;0;0;0;0;.00nan;0;0
4664;49900;744;0;0;0;0;.00nan;0;0
4664;52204;744;49;23;4;19;.826;3600000;0
4665;-1;751;0;0;0;0;.00nan;0;0
4665;66245;748;89;31;1;30;.968;3900000;0
4665;67362;748;0;0;0;0;.00nan;0;0
4665;148788;751;86;33;1;32;.970;3900000;0
4666;83;737;43;27;4;23;.852;3593000;0
4666;199033;737;0;0;0;0;.00nan;0;0
4666;-1;745;0;0;0;0;.00nan;0;0
4666;75268;745;50;16;3;13;.813;3600000;0
4667;188561;739;0;0;0;0;.00nan;0;0
4667;201075;736;76;33;2;31;.939;3600000;0
4667;33044;739;57;36;4;32;.889;3524000;0
4667;196715;736;0;0;0;0;.00nan;0;0
4668;504;740;62;9;0;9;1.000;1610000;0
4668;595;740;15;21;6;15;.714;1990000;0
4668;187925;3789;0;0;0;0;.00nan;0;0
4668;-1;3789;91;35;2;33;.943;3600000;0
4669;848;743;97;51;2;49;.961;3900000;0
4669;175764;729;0;0;0;0;.00nan;0;0
4669;190589;743;0;0;0;0;.00nan;0;0
4669;88646;729;76;24;2;22;.917;3900000;0
4670;190570;1880;56;38;5;33;.868;3600000;0
4670;-1;1880;0;0;0;0;.00nan;0;0
4670;57107;747;0;0;0;0;.00nan;0;0
4670;76405;747;73;22;1;21;.955;3600000;0
4671;2643;742;90;19;0;19;1.000;3600000;0
4671;8505;732;0;0;0;0;.00nan;0;0
4671;-1;742;0;0;0;0;.00nan;0;0
4671;56565;732;85;45;2;43;.956;3547000;0
4672;195867;2168;0;0;0;0;.00nan;0;0
4672;49935;2168;74;29;2;27;.931;3900000;0
4672;66245;748;87;38;2;36;.947;3900000;0
4672;67362;748;0;0;0;0;.00nan;0;0
4673;1957;733;74;39;5;34;.872;3600000;0
4673;44526;734;63;26;2;24;.923;3600000;0
4673;192386;734;0;0;0;0;.00nan;0;0
4673;67287;733;0;0;0;0;.00nan;0;0
4674;196698;741;0;0;0;0;.00nan;0;0
4674;46792;741;80;34;2;32;.941;3600000;0
4674;63932;749;0;0;0;0;.00nan;0;0
4674;85281;749;76;34;3;31;.912;3570000;0
4675;195887;764;0;0;0;0;.00nan;0;0
4675;-1;751;0;0;0;0;.00nan;0;0
4675;-1;764;82;30;2;28;.933;3600000;0
4675;148788;751;53;32;4;28;.875;3513000;0
4676;8505;732;61;31;4;27;.871;3558000;0
4676;49900;744;64;25;2;23;.920;3600000;0
4676;52204;744;0;0;0;0;.00nan;0;0
4676;56565;732;0;0;0;0;.00nan;0;0
4677;83;737;38;32;6;26;.813;3515000;0
4677;199033;737;0;0;0;0;.00nan;0;0
4677;175764;729;0;0;0;0;.00nan;0;0
4677;88646;729;99;58;4;54;.931;3600000;0
4678;195867;2168;0;0;0;0;.00nan;0;0
4678;49935;2168;89;46;4;42;.913;3765000;0
4678;63932;749;0;0;0;0;.00nan;0;0
4678;85281;749;67;29;3;26;.897;3765000;0
4679;44526;734;67;28;3;25;.893;3563000;0
4679;192386;734;0;0;0;0;.00nan;0;0
4679;66245;748;97;46;2;44;.957;3600000;0
4679;67362;748;0;0;0;0;.00nan;0;0
4680;1957;733;94;51;1;50;.980;3900000;0
4680;188561;739;0;0;0;0;.00nan;0;0
4680;33044;739;99;38;1;37;.974;3900000;0
4680;67287;733;0;0;0;0;.00nan;0;0
4681;848;743;78;42;4;38;.905;3600000;0
4681;195887;764;0;0;0;0;.00nan;0;0
4681;190589;743;0;0;0;0;.00nan;0;0
4681;-1;764;96;56;5;51;.911;3556000;0
4682;3756;752;40;26;4;22;.846;3600000;0
4682;49900;744;76;26;1;25;.962;3600000;0
4682;52204;744;0;0;0;0;.00nan;0;0
4682;61272;752;0;0;0;0;.00nan;0;0
4683;187925;3789;53;10;1;9;.900;384000;0
4683;-1;3789;52;36;5;31;.861;3141000;0
4683;-1;745;0;0;0;0;.00nan;0;0
4683;75268;745;59;32;4;28;.875;3600000;0
4684;83;737;81;24;1;23;.958;3600000;0
4684;199033;737;0;0;0;0;.00nan;0;0
4684;188561;739;64;29;3;26;.897;3597000;0
4684;33044;739;0;0;0;0;.00nan;0;0
4685;504;740;99;41;1;40;.976;3600000;0
4685;595;740;0;0;0;0;.00nan;0;0
4685;57107;747;0;0;0;0;.00nan;0;0
4685;76405;747;64;18;2;16;.889;3554000;0
4686;201075;736;79;36;3;33;.917;3600000;0
4686;190570;1880;45;28;4;24;.857;3537000;0
4686;196715;736;0;0;0;0;.00nan;0;0
4686;-1;1880;0;0;0;0;.00nan;0;0
4687;2643;742;98;29;1;28;.966;3600000;0
4687;196698;741;0;0;0;0;.00nan;0;0
4687;46792;741;58;28;3;25;.893;3581000;0
4687;-1;742;0;0;0;0;.00nan;0;0
4688;1957;733;0;0;0;0;.00nan;0;0
4688;178098;738;90;29;1;28;.966;3600000;0
4688;185442;738;0;0;0;0;.00nan;0;0
4688;67287;733;69;31;3;28;.903;3514000;0
4689;175764;729;0;0;0;0;.00nan;0;0
4689;44526;734;56;23;3;20;.870;3556000;0
4689;192386;734;0;0;0;0;.00nan;0;0
4689;88646;729;75;25;2;23;.920;3600000;0
4690;-1;751;0;0;0;0;.00nan;0;0
4690;63932;749;60;21;3;18;.857;3430000;0
4690;85281;749;22;4;3;1;.250;142000;0
4690;148788;751;61;32;4;28;.875;3600000;0
4691;195867;2168;0;0;0;0;.00nan;0;0
4691;49935;2168;72;39;4;35;.897;3900000;0
4691;57107;747;61;30;4;26;.867;3900000;0
4691;76405;747;0;0;0;0;.00nan;0;0
4692;196698;741;0;0;0;0;.00nan;0;0
4692;46792;741;40;30;5;25;.833;3600000;0
4692;49900;744;0;0;0;0;.00nan;0;0
4692;52204;744;77;42;3;39;.929;3600000;0
4693;83;737;85;22;1;21;.955;3600000;0
4693;504;740;0;0;0;0;.00nan;0;0
4693;595;740;73;43;4;39;.907;3600000;0
4693;199033;737;0;0;0;0;.00nan;0;0
4694;3756;752;0;0;0;0;.00nan;0;0
4694;-1;745;0;0;0;0;.00nan;0;0
4694;61272;752;89;41;3;38;.927;3643000;0
4694;75268;745;88;35;2;33;.943;3643000;0
4695;2643;742;96;38;2;36;.947;3600000;0
4695;187925;3789;0;0;0;0;.00nan;0;0
4695;-1;3789;63;32;3;29;.906;3600000;0
4695;-1;742;0;0;0;0;.00nan;0;0
4696;8505;732;0;0;0;0;.00nan;0;0
4696;190570;1880;76;24;2;22;.917;3544000;0
4696;-1;1880;0;0;0;0;.00nan;0;0
4696;56565;732;91;36;1;35;.972;3600000;0
4697;848;743;40;36;6;30;.833;3600000;0
4697;195887;764;0;0;0;0;.00nan;0;0
4697;190589;743;0;0;0;0;.00nan;0;0
4697;-1;764;100;35;0;35;1.000;3600000;0
4698;201075;736;91;36;3;33;.917;3900000;0
4698;196715;736;0;0;0;0;.00nan;0;0
4698;44526;734;84;44;3;41;.932;3900000;0
4698;192386;734;0;0;0;0;.00nan;0;0
4699;1957;733;0;0;0;0;.00nan;0;0
4699;-1;751;0;0;0;0;.00nan;0;0
4699;67287;733;85;53;4;49;.925;3572000;0
4699;148788;751;48;15;2;13;.867;3600000;0
4700;848;743;79;40;3;37;.925;3600000;0
4700;195867;2168;0;0;0;0;.00nan;0;0
4700;190589;743;0;0;0;0;.00nan;0;0
4700;49935;2168;100;37;0;37;1.000;3600000;0
4701;504;740;74;35;2;33;.943;3548000;0
4701;595;740;0;0;0;0;.00nan;0;0
4701;-1;745;0;0;0;0;.00nan;0;0
4701;75268;745;67;15;1;14;.933;3600000;0
4702;57107;747;82;30;1;29;.967;3900000;0
4702;66245;748;0;0;0;0;.00nan;0;0
4702;67362;748;98;54;1;53;.981;3900000;0
4702;76405;747;0;0;0;0;.00nan;0;0
4703;175764;729;0;0;0;0;.00nan;0;0
4703;190570;1880;95;40;3;37;.925;3900000;0
4703;-1;1880;0;0;0;0;.00nan;0;0
4703;88646;729;69;34;3;31;.912;3900000;0
4704;83;737;91;32;1;31;.969;3600000;0
4704;199033;737;0;0;0;0;.00nan;0;0
4704;188561;739;0;0;0;0;.00nan;0;0
4704;33044;739;79;28;2;26;.929;3544000;0
4705;196698;741;0;0;0;0;.00nan;0;0
4705;46792;741;52;37;5;32;.865;3600000;0
4705;49900;744;100;28;0;28;1.000;3600000;0
4705;52204;744;0;0;0;0;.00nan;0;0
4706;2643;742;0;0;0;0;.00nan;0;0
4706;195887;764;0;0;0;0;.00nan;0;0
4706;-1;764;68;46;5;41;.891;3600000;0
4706;-1;742;43;23;4;19;.826;3600000;0
4707;8505;732;0;0;0;0;.00nan;0;0
4707;178098;738;0;0;0;0;.00nan;0;0
4707;185442;738;78;33;2;31;.939;3547000;0
4707;56565;732;100;36;1;35;.972;3600000;0
4708;11716;751;78;36;3;33;.917;3600000;0
4708;201075;736;0;0;0;0;.00nan;0;0
4708;196715;736;68;38;4;34;.895;3573000;0
4708;148788;751;0;0;0;0;.00nan;0;0
4709;8505;732;0;0;0;0;.00nan;0;0
4709;-1;745;0;0;0;0;.00nan;0;0
4709;56565;732;100;47;2;45;.957;3900000;0
4709;75268;745;59;22;2;20;.909;3900000;0
4710;848;743;68;28;3;25;.893;3600000;0
4710;66245;748;0;0;0;0;.00nan;0;0
4710;67362;748;84;38;4;34;.895;3589000;0
4710;91742;743;0;0;0;0;.00nan;0;0
4711;175764;729;0;0;0;0;.00nan;0;0
4711;33044;739;0;0;0;0;.00nan;0;0
4711;74734;739;96;36;1;35;.972;3600000;0
4711;88646;729;86;40;2;38;.950;3544000;0
4712;190570;1880;65;30;3;27;.900;3576000;0
4712;44526;734;69;27;2;25;.926;3600000;0
4712;192386;734;0;0;0;0;.00nan;0;0
4712;-1;1880;0;0;0;0;.00nan;0;0
4713;195887;764;0;0;0;0;.00nan;0;0
4713;-1;764;71;27;2;25;.926;3551000;0
4713;49900;744;78;21;1;20;.952;3600000;0
4713;52204;744;0;0;0;0;.00nan;0;0
4714;504;740;55;27;3;24;.889;3600000;0
4714;595;740;0;0;0;0;.00nan;0;0
4714;3756;752;97;21;0;21;1.000;3600000;0
4714;61272;752;0;0;0;0;.00nan;0;0
4715;1957;733;0;0;0;0;.00nan;0;0
4715;178098;738;82;15;0;15;1.000;3600000;0
4715;185442;738;0;0;0;0;.00nan;0;0
4715;67287;733;98;44;2;42;.955;3528000;0
4716;2643;742;90;30;1;29;.967;3900000;0
4716;196698;741;0;0;0;0;.00nan;0;0
4716;46792;741;96;33;1;32;.970;3900000;0
4716;-1;742;0;0;0;0;.00nan;0;0
4717;83;737;84;38;4;34;.895;3573000;0
4717;199033;737;0;0;0;0;.00nan;0;0
4717;85281;749;75;27;2;25;.926;3600000;0
4717;85661;749;0;0;0;0;.00nan;0;0
4718;33044;739;0;0;0;0;.00nan;0;0
4718;-1;3789;64;16;1;15;.938;1311000;0
4718;58037;3789;20;12;5;7;.583;2289000;0
4718;74734;739;55;35;5;30;.857;3600000;0
4719;195887;764;0;0;0;0;.00nan;0;0
4719;-1;764;92;38;2;36;.947;3600000;0
4719;49900;744;57;23;3;20;.870;3550000;0
4719;52204;744;0;0;0;0;.00nan;0;0
4720;504;740;0;0;0;0;.00nan;0;0
4720;595;740;62;22;2;20;.909;3600000;0
4720;8505;732;66;7;0;7;1.000;1101000;0
4720;56565;732;48;44;6;38;.864;2499000;0
4721;848;743;82;26;1;25;.962;3600000;0
4721;3756;752;67;34;3;31;.912;3600000;0
4721;61272;752;0;0;0;0;.00nan;0;0
4721;91742;743;0;0;0;0;.00nan;0;0
4722;178098;738;96;23;0;23;1.000;3600000;0
4722;201075;736;35;32;6;26;.813;2957000;0
4722;185442;738;0;0;0;0;.00nan;0;0
4722;196715;736;53;2;0;2;1.000;643000;0
4723;44526;734;81;40;3;37;.925;3569000;0
4723;192386;734;0;0;0;0;.00nan;0;0
4723;85281;749;0;0;0;0;.00nan;0;0
4723;85661;749;81;37;2;35;.946;3600000;0
4724;175764;729;0;0;0;0;.00nan;0;0
4724;196698;741;0;0;0;0;.00nan;0;0
4724;46792;741;64;33;4;29;.879;3891000;0
4724;88646;729;62;32;3;29;.906;3891000;0
4725;11716;751;57;23;3;20;.870;3894000;0
4725;195867;2168;0;0;0;0;.00nan;0;0
4725;49935;2168;97;43;2;41;.953;3894000;0
4725;148788;751;0;0;0;0;.00nan;0;0
4726;1957;733;0;0;0;0;.00nan;0;0
4726;2643;742;79;35;3;32;.914;3600000;0
4726;-1;742;0;0;0;0;.00nan;0;0
4726;67287;733;52;41;7;34;.829;3600000;0
4727;190570;1880;0;0;0;0;.00nan;0;0
4727;-1;1880;54;20;2;18;.900;3600000;0
4727;66245;748;91;57;4;53;.930;3554000;0
4727;67362;748;0;0;0;0;.00nan;0;0
4728;83;737;79;27;1;26;.963;3600000;0
4728;199033;737;0;0;0;0;.00nan;0;0
4728;57107;747;73;33;2;31;.939;3550000;0
4728;76405;747;0;0;0;0;.00nan;0;0
4729;8505;732;0;0;0;0;.00nan;0;0
4729;-1;3789;0;0;0;0;.00nan;0;0
4729;56565;732;90;33;2;31;.939;3615000;0
4729;58037;3789;70;17;1;16;.941;3615000;0
4730;195887;764;0;0;0;0;.00nan;0;0
4730;-1;764;55;24;3;21;.875;3586000;0
4730;52204;752;0;0;0;0;.00nan;0;0
4730;61272;752;97;45;1;44;.978;3600000;0
4731;3756;744;99;37;1;36;.973;3600000;0
4731;178098;738;72;35;3;32;.914;3512000;0
4731;185442;738;0;0;0;0;.00nan;0;0
4731;49900;744;0;0;0;0;.00nan;0;0
4732;201075;736;82;41;3;38;.927;3581000;0
4732;196715;736;0;0;0;0;.00nan;0;0
4732;85281;749;0;0;0;0;.00nan;0;0
4732;85661;749;62;20;2;18;.900;3600000;0
4733;83;737;76;27;2;25;.926;3791000;0
4733;199033;737;0;0;0;0;.00nan;0;0
4733;196698;741;0;0;0;0;.00nan;0;0
4733;46792;741;54;20;3;17;.850;3791000;0
4734;175764;729;0;0;0;0;.00nan;0;0
4734;33044;739;0;0;0;0;.00nan;0;0
4734;74734;739;95;34;1;33;.971;3552000;0
4734;88646;729;100;28;0;28;1.000;3600000;0
4735;848;743;99;48;2;46;.958;3600000;0
4735;195867;2168;0;0;0;0;.00nan;0;0
4735;49935;2168;72;35;3;32;.914;3555000;0
4735;91742;743;0;0;0;0;.00nan;0;0
4736;11716;751;47;28;4;24;.857;3561000;0
4736;66245;748;0;0;0;0;.00nan;0;0
4736;67362;748;54;21;3;18;.857;3600000;0
4736;148788;751;0;0;0;0;.00nan;0;0
4737;2643;742;44;30;5;25;.833;3514000;0
4737;190570;1880;79;37;3;34;.919;3600000;0
4737;-1;1880;0;0;0;0;.00nan;0;0
4737;-1;742;0;0;0;0;.00nan;0;0
4738;44526;734;63;33;4;29;.879;3600000;0
4738;192386;734;0;0;0;0;.00nan;0;0
4738;57107;747;0;0;0;0;.00nan;0;0
4738;76405;747;74;33;3;30;.909;3600000;0
4739;-1;745;0;0;0;0;.00nan;0;0
4739;52204;752;63;36;3;33;.917;3548000;0
4739;61272;752;0;0;0;0;.00nan;0;0
4739;75268;745;62;19;2;17;.895;3600000;0
4740;504;740;86;40;3;37;.925;3900000;0
4740;595;740;0;0;0;0;.00nan;0;0
4740;-1;3789;0;0;0;0;.00nan;0;0
4740;58037;3789;72;28;3;25;.893;3900000;0
4741;2643;742;100;23;0;23;1.000;3600000;0
4741;196698;741;0;0;0;0;.00nan;0;0
4741;46792;741;55;44;6;38;.864;3600000;0
4741;-1;742;0;0;0;0;.00nan;0;0
4742;3756;744;54;15;2;13;.867;3600000;0
4742;33044;739;0;0;0;0;.00nan;0;0
4742;49900;744;0;0;0;0;.00nan;0;0
4742;74734;739;89;46;4;42;.913;3511000;0
4743;848;743;61;31;4;27;.871;3590000;0
4743;66245;748;86;36;2;34;.944;3600000;0
4743;67362;748;0;0;0;0;.00nan;0;0
4743;91742;743;0;0;0;0;.00nan;0;0
4744;11716;751;52;32;5;27;.844;3600000;0
4744;44526;734;92;36;2;34;.944;3600000;0
4744;192386;734;0;0;0;0;.00nan;0;0
4744;148788;751;0;0;0;0;.00nan;0;0
4745;201075;736;47;42;6;36;.857;3600000;0
4745;196715;736;0;0;0;0;.00nan;0;0
4745;57107;747;0;0;0;0;.00nan;0;0
4745;76405;747;70;32;3;29;.906;3600000;0
4746;195867;2168;0;0;0;0;.00nan;0;0
4746;195887;764;0;0;0;0;.00nan;0;0
4746;-1;764;63;25;3;22;.880;3515000;0
4746;49935;2168;89;38;1;37;.974;3600000;0
4747;178098;738;51;28;4;24;.857;3514000;0
4747;175764;729;0;0;0;0;.00nan;0;0
4747;185442;738;0;0;0;0;.00nan;0;0
4747;88646;729;100;50;2;48;.960;3600000;0
4748;-1;3789;0;0;0;0;.00nan;0;0
4748;-1;745;0;0;0;0;.00nan;0;0
4748;58037;3789;75;25;1;24;.960;3600000;0
4748;75268;745;79;45;3;42;.933;3554000;0
4749;1957;733;100;35;1;34;.971;3900000;0
4749;190570;1880;0;0;0;0;.00nan;0;0
4749;-1;1880;79;27;1;26;.963;3900000;0
4749;67287;733;0;0;0;0;.00nan;0;0
4750;504;740;0;0;0;0;.00nan;0;0
4750;595;740;82;39;3;36;.923;3600000;0
4750;8505;732;0;0;0;0;.00nan;0;0
4750;56565;732;59;35;4;31;.886;3546000;0
4751;83;737;82;34;2;32;.941;3600000;0
4751;3756;744;39;25;4;21;.840;3520000;0
4751;199033;737;0;0;0;0;.00nan;0;0
4751;49900;744;0;0;0;0;.00nan;0;0
4752;195887;764;0;0;0;0;.00nan;0;0
4752;33044;739;0;0;0;0;.00nan;0;0
4752;-1;764;65;42;5;37;.881;3600000;0
4752;74734;739;79;24;2;22;.917;3600000;0
4753;848;743;68;41;4;37;.902;3600000;0
4753;85281;749;91;18;0;18;1.000;3600000;0
4753;85661;749;0;0;0;0;.00nan;0;0
4753;91742;743;0;0;0;0;.00nan;0;0
4754;11716;751;0;0;0;0;.00nan;0;0
4754;201075;736;59;50;6;44;.880;3600000;0
4754;196715;736;0;0;0;0;.00nan;0;0
4754;148788;751;71;21;1;20;.952;3600000;0
4755;2643;742;46;17;3;14;.824;3600000;0
4755;-1;742;0;0;0;0;.00nan;0;0
4755;52204;752;74;53;4;49;.925;3600000;0
4755;61272;752;0;0;0;0;.00nan;0;0
4756;57107;747;0;0;0;0;.00nan;0;0
4756;66245;748;0;0;0;0;.00nan;0;0
4756;67362;748;72;33;3;30;.909;3649000;0
4756;76405;747;72;24;2;22;.917;3649000;0
4757;178098;738;0;0;0;0;.00nan;0;0
4757;190570;1880;74;40;4;36;.900;3900000;0
4757;185442;738;41;29;4;25;.862;3849000;0
4757;-1;1880;0;0;0;0;.00nan;0;0
4758;1957;733;52;40;6;34;.850;3600000;0
4758;175764;729;0;0;0;0;.00nan;0;0
4758;67287;733;0;0;0;0;.00nan;0;0
4758;88646;729;74;30;2;28;.933;3600000;0
4759;504;740;59;38;5;33;.868;3600000;0
4759;595;740;0;0;0;0;.00nan;0;0
4759;-1;745;0;0;0;0;.00nan;0;0
4759;75268;745;98;21;0;21;1.000;3600000;0
4760;8505;732;0;0;0;0;.00nan;0;0
4760;196698;741;0;0;0;0;.00nan;0;0
4760;46792;741;75;29;2;27;.931;3600000;0
4760;56565;732;78;39;3;36;.923;3569000;0
4761;195867;2168;0;0;0;0;.00nan;0;0
4761;44526;734;65;33;3;30;.909;3600000;0
4761;192386;734;0;0;0;0;.00nan;0;0
4761;49935;2168;53;29;4;25;.862;3550000;0
4762;83;737;68;45;5;40;.889;3600000;0
4762;199033;737;0;0;0;0;.00nan;0;0
4762;85281;749;94;32;1;31;.969;3600000;0
4762;85661;749;0;0;0;0;.00nan;0;0
4763;3756;744;49;21;3;18;.857;3600000;0
4763;49900;744;0;0;0;0;.00nan;0;0
4763;52204;752;44;24;4;20;.833;3562000;0
4763;61272;752;0;0;0;0;.00nan;0;0
4764;11716;751;0;0;0;0;.00nan;0;0
4764;66245;748;100;39;1;38;.974;3600000;0
4764;67362;748;0;0;0;0;.00nan;0;0
4764;148788;751;58;29;3;26;.897;3515000;0
4765;178098;738;43;30;5;25;.833;3600000;0
4765;33044;739;0;0;0;0;.00nan;0;0
4765;185442;738;0;0;0;0;.00nan;0;0
4765;74734;739;100;48;1;47;.979;3600000;0
4766;196698;741;0;0;0;0;.00nan;0;0
4766;-1;3789;0;0;0;0;.00nan;0;0
4766;46792;741;72;37;3;34;.919;3729000;0
4766;58037;3789;82;42;2;40;.952;3729000;0
4767;504;740;0;0;0;0;.00nan;0;0
4767;595;740;40;23;4;19;.826;3900000;0
4767;1957;733;0;0;0;0;.00nan;0;0
4767;67287;733;83;48;4;44;.917;3900000;0
4768;848;743;100;37;2;35;.946;3900000;0
4768;2643;742;92;31;2;29;.935;3900000;0
4768;-1;742;0;0;0;0;.00nan;0;0
4768;91742;743;0;0;0;0;.00nan;0;0
4769;195887;764;65;26;2;24;.923;3513000;0
4769;-1;764;0;0;0;0;.00nan;0;0
4769;57107;747;0;0;0;0;.00nan;0;0
4769;76405;747;100;38;0;38;1.000;3600000;0
4770;-1;745;0;0;0;0;.00nan;0;0
4770;75268;745;61;40;5;35;.875;3600000;0
4770;85281;749;89;36;1;35;.972;3600000;0
4770;85661;749;0;0;0;0;.00nan;0;0
4771;83;737;55;26;3;23;.885;3547000;0
4771;199033;737;0;0;0;0;.00nan;0;0
4771;195867;2168;0;0;0;0;.00nan;0;0
4771;49935;2168;99;60;2;58;.967;3600000;0
4772;8505;732;0;0;0;0;.00nan;0;0
4772;175764;729;0;0;0;0;.00nan;0;0
4772;56565;732;75;58;6;52;.897;3600000;0
4772;88646;729;95;20;0;20;1.000;3600000;0
4773;-1;3789;0;0;0;0;.00nan;0;0
4773;58037;3789;85;33;2;31;.939;3900000;0
4773;66245;748;0;0;0;0;.00nan;0;0
4773;67362;748;83;35;2;33;.943;3900000;0
4774;83;737;68;31;3;28;.903;3558000;0
4774;199033;737;0;0;0;0;.00nan;0;0
4774;44526;734;95;48;2;46;.958;3600000;0
4774;192386;734;0;0;0;0;.00nan;0;0
4775;196698;741;0;0;0;0;.00nan;0;0
4775;46792;741;63;29;3;26;.897;3545000;0
4775;52204;752;77;25;1;24;.960;3600000;0
4775;61272;752;0;0;0;0;.00nan;0;0
4776;848;743;66;36;4;32;.889;3900000;0
4776;3756;744;67;37;4;33;.892;3900000;0
4776;49900;744;0;0;0;0;.00nan;0;0
4776;91742;743;0;0;0;0;.00nan;0;0
4777;1957;733;0;0;0;0;.00nan;0;0
4777;201075;736;52;23;4;19;.826;3573000;0
4777;196715;736;0;0;0;0;.00nan;0;0
4777;67287;733;76;33;3;30;.909;3600000;0
4778;33044;739;0;0;0;0;.00nan;0;0
4778;190570;1880;81;30;1;29;.967;3600000;0
4778;-1;1880;0;0;0;0;.00nan;0;0
4778;74734;739;51;36;5;31;.861;3600000;0
4779;2643;742;0;0;0;0;.00nan;0;0
4779;11716;751;0;0;0;0;.00nan;0;0
4779;-1;742;91;39;2;37;.949;3600000;0
4779;148788;751;88;41;3;38;.927;3600000;0
4780;178098;738;64;32;4;28;.875;3710000;0
4780;185442;738;0;0;0;0;.00nan;0;0
4780;-1;745;0;0;0;0;.00nan;0;0
4780;75268;745;73;34;3;31;.912;3710000;0
4781;504;740;0;0;0;0;.00nan;0;0
4781;595;740;77;41;4;37;.902;3600000;0
4781;195867;2168;0;0;0;0;.00nan;0;0
4781;49935;2168;60;25;3;22;.880;3600000;0
4782;195887;764;0;0;0;0;.00nan;0;0
4782;-1;764;90;46;3;43;.935;3600000;0
4782;85281;749;0;0;0;0;.00nan;0;0
4782;85661;749;83;16;0;16;1.000;3600000;0
4783;175764;729;0;0;0;0;.00nan;0;0
4783;66245;748;64;27;3;24;.889;3515000;0
4783;67362;748;0;0;0;0;.00nan;0;0
4783;88646;729;83;32;1;31;.969;3600000;0
4784;201075;736;0;0;0;0;.00nan;0;0
4784;196715;736;84;44;3;41;.932;3569000;0
4784;-1;3789;0;0;0;0;.00nan;0;0
4784;58037;3789;78;25;1;24;.960;3600000;0
4785;33044;739;0;0;0;0;.00nan;0;0
4785;44526;734;0;0;0;0;.00nan;0;0
4785;192386;734;78;34;2;32;.941;3600000;0
4785;74734;739;37;29;6;23;.793;3600000;0
4786;848;743;51;44;6;38;.864;3600000;0
4786;3756;744;56;19;2;17;.895;3600000;0
4786;49900;744;0;0;0;0;.00nan;0;0
4786;91742;743;0;0;0;0;.00nan;0;0
4787;11716;751;0;0;0;0;.00nan;0;0
4787;190570;1880;0;0;0;0;.00nan;0;0
4787;-1;1880;59;28;3;25;.893;3600000;0
4787;148788;751;76;32;2;30;.938;3600000;0
4788;2643;742;86;22;1;21;.955;3600000;0
4788;-1;742;0;0;0;0;.00nan;0;0
4788;52204;752;98;50;2;48;.960;3600000;0
4788;61272;752;0;0;0;0;.00nan;0;0
4789;83;737;61;19;2;17;.895;3600000;0
4789;199033;737;0;0;0;0;.00nan;0;0
4789;8505;732;0;0;0;0;.00nan;0;0
4789;56565;732;82;46;3;43;.935;3582000;0
4790;195867;2168;0;0;0;0;.00nan;0;0
4790;-1;745;0;0;0;0;.00nan;0;0
4790;49935;2168;56;26;3;23;.885;3598000;0
4790;75268;745;85;33;2;31;.939;3600000;0
4791;83;737;70;23;2;21;.913;3600000;0
4791;504;740;0;0;0;0;.00nan;0;0
4791;595;740;59;28;3;25;.893;3555000;0
4791;199033;737;0;0;0;0;.00nan;0;0
4792;1957;733;88;53;4;49;.925;3600000;0
4792;178098;738;95;23;0;23;1.000;3600000;0
4792;185442;738;0;0;0;0;.00nan;0;0
4792;67287;733;0;0;0;0;.00nan;0;0
4793;196698;741;0;0;0;0;.00nan;0;0
4793;46792;741;65;40;4;36;.900;3600000;0
4793;57107;747;0;0;0;0;.00nan;0;0
4793;76405;747;84;29;2;27;.931;3600000;0
4794;201075;736;0;0;0;0;.00nan;0;0
4794;175764;729;94;19;0;19;1.000;3600000;0
4794;196715;736;98;50;1;49;.980;3588000;0
4794;88646;729;0;0;0;0;.00nan;0;0
4795;33044;739;0;0;0;0;.00nan;0;0
4795;-1;3789;0;0;0;0;.00nan;0;0
4795;58037;3789;85;32;2;30;.938;3600000;0
4795;74734;739;46;38;6;32;.842;3600000;0
4796;3756;744;91;32;1;31;.969;3600000;0
4796;49900;744;0;0;0;0;.00nan;0;0
4796;52204;752;35;34;6;28;.824;2919000;0
4796;61272;752;44;5;1;4;.800;681000;0
4797;11716;751;89;21;0;21;1.000;3600000;0
4797;195887;764;56;13;1;12;.923;1193000;0
4797;-1;764;34;28;6;22;.786;2407000;0
4797;148788;751;0;0;0;0;.00nan;0;0
4798;8505;732;0;0;0;0;.00nan;0;0
4798;56565;732;60;38;4;34;.895;3600000;0
4798;66245;748;48;0;0;0;.00nan;417000;0
4798;67362;748;27;25;6;19;.760;3127000;0
4799;196698;741;24;27;6;21;.778;3600000;0
4799;46792;741;0;0;0;0;.00nan;0;0
4799;57107;747;68;18;1;17;.944;3600000;0
4799;76405;747;0;0;0;0;.00nan;0;0
4800;2643;742;48;32;4;28;.875;3600000;0
4800;195867;2168;0;0;0;0;.00nan;0;0
4800;-1;742;0;0;0;0;.00nan;0;0
4800;49935;2168;100;37;1;36;.973;3600000;0
4801;504;740;0;0;0;0;.00nan;0;0
4801;595;740;62;37;4;33;.892;3593000;0
4801;44526;734;55;23;3;20;.870;3600000;0
4801;192386;734;0;0;0;0;.00nan;0;0
4802;83;737;93;26;0;26;1.000;3600000;0
4802;199033;737;0;0;0;0;.00nan;0;0
4802;190570;1880;0;0;0;0;.00nan;0;0
4802;-1;1880;42;26;4;22;.846;3600000;0
4803;1957;733;0;0;0;0;.00nan;0;0
4803;178098;738;64;24;2;22;.917;3600000;0
4803;185442;738;0;0;0;0;.00nan;0;0
4803;67287;733;85;31;1;30;.968;3600000;0
4804;196698;741;57;5;0;5;1.000;305000;0
4804;46792;741;41;47;7;40;.851;3295000;0
4804;85281;749;0;0;0;0;.00nan;0;0
4804;85661;749;56;15;2;13;.867;3600000;0
4805;3756;744;65;22;2;20;.909;3600000;0
4805;49900;744;0;0;0;0;.00nan;0;0
4805;52204;752;68;51;6;45;.882;3600000;0
4805;61272;752;0;0;0;0;.00nan;0;0
4806;848;743;0;0;0;0;.00nan;0;0
4806;195887;764;69;28;2;26;.929;3600000;0
4806;-1;764;0;0;0;0;.00nan;0;0
4806;91742;743;80;39;4;35;.897;3533000;0
4807;-1;745;0;0;0;0;.00nan;0;0
4807;57107;747;0;0;0;0;.00nan;0;0
4807;75268;745;29;29;6;23;.793;3600000;0
4807;76405;747;68;31;3;28;.903;3600000;0
4808;2643;742;95;24;0;24;1.000;3600000;0
4808;-1;742;0;0;0;0;.00nan;0;0
4808;66245;748;88;36;1;35;.972;3585000;0
4808;67362;748;0;0;0;0;.00nan;0;0
4809;178098;738;64;19;2;17;.895;3600000;0
4809;185442;738;0;0;0;0;.00nan;0;0
4809;44526;734;53;30;4;26;.867;3543000;0
4809;192386;734;0;0;0;0;.00nan;0;0
4810;504;740;0;0;0;0;.00nan;0;0
4810;595;740;81;37;3;34;.919;3600000;0
4810;33044;739;68;21;1;20;.952;3600000;0
4810;74734;739;0;0;0;0;.00nan;0;0
4811;83;737;79;25;1;24;.960;3600000;0
4811;199033;737;0;0;0;0;.00nan;0;0
4811;201075;736;97;43;2;41;.953;3563000;0
4811;196715;736;0;0;0;0;.00nan;0;0
4812;1957;733;59;34;5;29;.853;3600000;0
4812;175764;729;84;32;2;30;.938;3600000;0
4812;67287;733;0;0;0;0;.00nan;0;0
4812;88646;729;0;0;0;0;.00nan;0;0
4813;8505;732;0;0;0;0;.00nan;0;0
4813;190570;1880;68;32;3;29;.906;3574000;0
4813;-1;1880;0;0;0;0;.00nan;0;0
4813;56565;732;87;35;2;33;.943;3600000;0
4814;196698;741;0;0;0;0;.00nan;0;0
4814;46792;741;93;28;1;27;.964;3600000;0
4814;85281;749;73;30;2;28;.933;3552000;0
4814;85661;749;0;0;0;0;.00nan;0;0
4815;195887;764;0;0;0;0;.00nan;0;0
4815;-1;764;66;26;2;24;.923;3600000;0
4815;52204;752;86;46;4;42;.913;3548000;0
4815;61272;752;0;0;0;0;.00nan;0;0
4816;-1;745;0;0;0;0;.00nan;0;0
4816;57107;747;0;0;0;0;.00nan;0;0
4816;75268;745;68;33;3;30;.909;3558000;0
4816;76405;747;86;35;2;33;.943;3600000;0
4817;3756;744;83;27;2;25;.926;3614000;0
4817;195867;2168;0;0;0;0;.00nan;0;0
4817;49900;744;0;0;0;0;.00nan;0;0
4817;49935;2168;80;20;1;19;.950;3614000;0
4818;44526;734;71;31;3;28;.903;3600000;0
4818;192386;734;0;0;0;0;.00nan;0;0
4818;66245;748;62;30;4;26;.867;3556000;0
4818;67362;748;0;0;0;0;.00nan;0;0
4819;504;740;0;0;0;0;.00nan;0;0
4819;595;740;48;25;4;21;.840;3600000;0
4819;178098;738;88;38;2;36;.947;3600000;0
4819;185442;738;0;0;0;0;.00nan;0;0
4820;83;737;95;23;1;22;.957;3600000;0
4820;199033;737;0;0;0;0;.00nan;0;0
4820;58037;3789;45;43;6;37;.860;3600000;0
4820;224115;3789;0;0;0;0;.00nan;0;0
4821;848;743;57;35;5;30;.857;3600000;0
4821;8505;732;0;0;0;0;.00nan;0;0
4821;56565;732;39;38;7;31;.816;3572000;0
4821;91742;743;0;0;0;0;.00nan;0;0
4822;2643;742;25;27;6;21;.778;3600000;0
4822;11716;751;93;32;1;31;.969;3600000;0
4822;-1;742;0;0;0;0;.00nan;0;0
4822;148788;751;0;0;0;0;.00nan;0;0
4823;201075;736;0;0;0;0;.00nan;0;0
4823;33044;739;0;0;0;0;.00nan;0;0
4823;196715;736;90;45;2;43;.956;3600000;0
4823;74734;739;48;18;3;15;.833;3573000;0
4824;175764;729;0;0;0;0;.00nan;0;0
4824;190570;1880;57;31;3;28;.903;3600000;0
4824;-1;1880;0;0;0;0;.00nan;0;0
4824;88646;729;100;32;0;32;1.000;3600000;0
4825;-1;745;67;27;2;25;.926;2980000;0
4825;75268;745;26;10;4;6;.600;620000;0
4825;85281;749;0;0;0;0;.00nan;0;0
4825;85661;749;100;34;0;34;1.000;3600000;0
4826;848;743;0;0;0;0;.00nan;0;0
4826;1957;733;77;31;3;28;.903;3900000;0
4826;67287;733;0;0;0;0;.00nan;0;0
4826;91742;743;68;32;3;29;.906;3900000;0
4827;195867;2168;0;0;0;0;.00nan;0;0
4827;44526;734;74;39;3;36;.923;3600000;0
4827;192386;734;0;0;0;0;.00nan;0;0
4827;49935;2168;91;20;0;20;1.000;3600000;0
4828;33044;739;95;33;1;32;.970;3900000;0
4828;66245;748;0;0;0;0;.00nan;0;0
4828;67362;748;86;23;1;22;.957;3900000;0
4828;74734;739;0;0;0;0;.00nan;0;0
4829;3756;744;53;32;4;28;.875;3900000;0
4829;11716;751;0;0;0;0;.00nan;0;0
4829;49900;744;0;0;0;0;.00nan;0;0
4829;148788;751;73;40;4;36;.900;3878000;0
4830;8505;732;0;0;0;0;.00nan;0;0
4830;52204;752;71;38;4;34;.895;3900000;0
4830;56565;732;79;47;4;43;.915;3900000;0
4830;61272;752;0;0;0;0;.00nan;0;0
4831;201075;736;92;36;1;35;.972;3600000;0
4831;196715;736;0;0;0;0;.00nan;0;0
4831;58037;3789;79;35;3;32;.914;3597000;0
4831;224115;3789;0;0;0;0;.00nan;0;0
4832;2643;742;100;40;1;39;.975;3600000;0
4832;195887;764;98;45;2;43;.956;3588000;0
4832;-1;764;0;0;0;0;.00nan;0;0
4832;-1;742;0;0;0;0;.00nan;0;0
4833;1957;733;0;0;0;0;.00nan;0;0
4833;175764;729;0;0;0;0;.00nan;0;0
4833;67287;733;79;43;4;39;.907;3600000;0
4833;88646;729;97;21;0;21;1.000;3600000;0
4834;-1;745;0;0;0;0;.00nan;0;0
4834;75268;745;66;33;3;30;.909;3600000;0
4834;85281;749;0;0;0;0;.00nan;0;0
4834;85661;749;75;24;1;23;.958;3600000;0
4835;83;737;61;21;2;19;.905;3600000;0
4835;848;743;32;25;5;20;.800;3600000;0
4835;199033;737;0;0;0;0;.00nan;0;0
4835;91742;743;0;0;0;0;.00nan;0;0
4836;196698;741;0;0;0;0;.00nan;0;0
4836;46792;741;74;45;4;41;.911;3600000;0
4836;57107;747;0;0;0;0;.00nan;0;0
4836;76405;747;91;30;1;29;.967;3600000;0
4837;504;740;58;43;5;38;.884;3600000;0
4837;595;740;0;0;0;0;.00nan;0;0
4837;190570;1880;63;24;2;22;.917;3600000;0
4837;-1;1880;0;0;0;0;.00nan;0;0
4838;195867;2168;0;0;0;0;.00nan;0;0
4838;33044;739;0;0;0;0;.00nan;0;0
4838;49935;2168;64;37;4;33;.892;3568000;0
4838;74734;739;70;33;3;30;.909;3600000;0
4839;2195;748;56;7;1;6;.857;1239000;0
4839;3756;744;59;28;4;24;.857;3600000;0
4839;49900;744;0;0;0;0;.00nan;0;0
4839;66245;748;45;23;4;19;.826;2311000;0
4840;52204;752;90;19;0;19;1.000;3600000;0
4840;58037;3789;84;32;2;30;.938;3573000;0
4840;61272;752;0;0;0;0;.00nan;0;0
4840;224115;3789;0;0;0;0;.00nan;0;0
4841;8505;732;0;0;0;0;.00nan;0;0
4841;195887;764;0;0;0;0;.00nan;0;0
4841;-1;764;77;35;2;33;.943;3558000;0
4841;56565;732;96;35;1;34;.971;3600000;0
4842;83;737;69;30;3;27;.900;3900000;0
4842;199033;737;0;0;0;0;.00nan;0;0
4842;175764;729;0;0;0;0;.00nan;0;0
4842;88646;729;79;38;3;35;.921;3900000;0
4843;11716;751;0;0;0;0;.00nan;0;0
4843;44526;734;57;34;4;30;.882;3600000;0
4843;192386;734;0;0;0;0;.00nan;0;0
4843;148788;751;50;36;5;31;.861;3600000;0
4844;848;743;58;24;3;21;.875;3600000;0
4844;196698;741;0;0;0;0;.00nan;0;0
4844;46792;741;65;40;5;35;.875;3547000;0
4844;91742;743;0;0;0;0;.00nan;0;0
4845;504;740;0;0;0;0;.00nan;0;0
4845;595;740;71;32;3;29;.906;3600000;0
4845;178098;738;76;34;2;32;.941;3600000;0
4845;185442;738;0;0;0;0;.00nan;0;0
4846;201075;736;0;0;0;0;.00nan;0;0
4846;196715;736;78;49;4;45;.918;3900000;0
4846;57107;747;0;0;0;0;.00nan;0;0
4846;76405;747;61;28;4;24;.857;3900000;0
4847;1957;733;65;36;3;33;.917;3600000;0
4847;190570;1880;70;28;2;26;.929;3600000;0
4847;-1;1880;0;0;0;0;.00nan;0;0
4847;67287;733;0;0;0;0;.00nan;0;0
4848;2643;742;97;50;0;50;1.000;3900000;0
4848;-1;742;0;0;0;0;.00nan;0;0
4848;85281;749;0;0;0;0;.00nan;0;0
4848;85661;749;96;19;0;19;1.000;3900000;0
4849;3756;744;76;28;2;26;.929;3900000;0
4849;195887;764;0;0;0;0;.00nan;0;0
4849;-1;764;95;45;2;43;.956;3900000;0
4849;49900;744;0;0;0;0;.00nan;0;0
4850;178098;738;48;33;5;28;.848;3613000;0
4850;185442;738;0;0;0;0;.00nan;0;0
4850;44526;734;49;25;4;21;.840;3613000;0
4850;67362;734;0;0;0;0;.00nan;0;0
4851;2195;748;62;22;2;20;.909;3600000;0
4851;196698;741;0;0;0;0;.00nan;0;0
4851;46792;741;72;29;3;26;.897;3600000;0
4851;66245;748;0;0;0;0;.00nan;0;0
4852;504;740;92;39;1;38;.974;3845000;0
4852;595;740;0;0;0;0;.00nan;0;0
4852;11716;751;0;0;0;0;.00nan;0;0
4852;148788;751;90;18;0;18;1.000;3845000;0
4853;848;743;93;24;0;24;1.000;1376000;0
4853;57107;747;0;0;0;0;.00nan;0;0
4853;76405;747;82;31;2;29;.935;3600000;0
4853;91742;743;46;26;4;22;.846;2224000;0
4854;1957;733;0;0;0;0;.00nan;0;0
4854;190570;1880;63;23;2;21;.913;3600000;0
4854;-1;1880;0;0;0;0;.00nan;0;0
4854;67287;733;62;36;4;32;.889;3582000;0
4855;8505;732;76;27;2;25;.926;3600000;0
4855;195867;2168;0;0;0;0;.00nan;0;0
4855;49935;2168;87;49;4;45;.918;3558000;0
4855;56565;732;0;0;0;0;.00nan;0;0
4856;175764;729;0;0;0;0;.00nan;0;0
4856;33044;739;0;0;0;0;.00nan;0;0
4856;74734;739;73;37;3;34;.919;3600000;0
4856;88646;729;78;31;2;29;.935;3600000;0
4857;83;737;71;28;2;26;.929;3600000;0
4857;199033;737;0;0;0;0;.00nan;0;0
4857;58037;3789;0;0;0;0;.00nan;0;0
4857;85797;3789;61;33;3;30;.909;3585000;0
4858;2643;742;75;26;2;24;.923;3600000;0
4858;3756;744;77;31;3;28;.903;3600000;0
4858;-1;742;0;0;0;0;.00nan;0;0
4858;49900;744;0;0;0;0;.00nan;0;0
4859;195887;764;51;53;7;46;.868;3558000;0
4859;-1;764;0;0;0;0;.00nan;0;0
4859;85281;749;0;0;0;0;.00nan;0;0
4859;85661;749;49;32;5;27;.844;3600000;0
4860;11716;751;0;0;0;0;.00nan;0;0
4860;-1;745;0;0;0;0;.00nan;0;0
4860;75268;745;53;38;5;33;.868;3600000;0
4860;148788;751;81;25;1;24;.960;3600000;0
4861;178098;738;85;27;1;26;.963;3900000;0
4861;185442;738;0;0;0;0;.00nan;0;0
4861;52204;752;96;40;1;39;.975;3900000;0
4861;61272;752;0;0;0;0;.00nan;0;0
4862;195867;2168;0;0;0;0;.00nan;0;0
4862;196698;741;0;0;0;0;.00nan;0;0
4862;46792;741;79;43;4;39;.907;3900000;0
4862;49935;2168;94;49;4;45;.918;3900000;0
4863;1957;733;77;46;4;42;.913;3569000;0
4863;2195;748;51;17;2;15;.882;3600000;0
4863;66245;748;0;0;0;0;.00nan;0;0
4863;67287;733;0;0;0;0;.00nan;0;0
4864;504;740;90;42;3;39;.929;3600000;0
4864;595;740;0;0;0;0;.00nan;0;0
4864;85281;749;0;0;0;0;.00nan;0;0
4864;85661;749;89;20;0;20;1.000;3600000;0
4865;848;743;0;0;0;0;.00nan;0;0
4865;201075;736;50;28;4;24;.857;3587000;0
4865;196715;736;0;0;0;0;.00nan;0;0
4865;91742;743;77;33;2;31;.939;3600000;0
4866;8505;732;0;0;0;0;.00nan;0;0
4866;33044;739;0;0;0;0;.00nan;0;0
4866;56565;732;40;34;5;29;.853;3600000;0
4866;74734;739;100;33;1;32;.970;3600000;0
4867;175764;729;0;0;0;0;.00nan;0;0
4867;-1;745;0;0;0;0;.00nan;0;0
4867;75268;745;68;32;3;29;.906;3546000;0
4867;88646;729;91;36;2;34;.944;3600000;0
4868;52204;752;73;38;3;35;.921;3600000;0
4868;58037;3789;0;0;0;0;.00nan;0;0
4868;61272;752;0;0;0;0;.00nan;0;0
4868;85797;3789;43;30;5;25;.833;3554000;0
4869;196698;741;0;0;0;0;.00nan;0;0
4869;44526;734;0;0;0;0;.00nan;0;0
4869;46792;741;64;38;5;33;.868;3600000;0
4869;67362;734;93;29;1;28;.966;3600000;0
4870;83;737;64;30;3;27;.900;3600000;0
4870;2195;748;0;0;0;0;.00nan;0;0
4870;199033;737;0;0;0;0;.00nan;0;0
4870;66245;748;84;34;2;32;.941;3600000;0
4871;3756;744;0;0;0;0;.00nan;0;0
4871;195867;2168;0;0;0;0;.00nan;0;0
4871;49900;744;81;27;2;25;.926;3600000;0
4871;49935;2168;69;34;3;31;.912;3555000;0
4872;190570;1880;53;35;5;30;.857;3600000;0
4872;-1;1880;0;0;0;0;.00nan;0;0
4872;57107;747;0;0;0;0;.00nan;0;0
4872;76405;747;70;37;4;33;.892;3600000;0
4873;11716;751;80;46;4;42;.913;3600000;0
4873;195887;764;0;0;0;0;.00nan;0;0
4873;-1;764;67;40;5;35;.875;3600000;0
4873;148788;751;0;0;0;0;.00nan;0;0
4874;201075;736;100;54;2;52;.963;3600000;0
4874;33044;739;51;32;4;28;.875;3536000;0
4874;196715;736;0;0;0;0;.00nan;0;0
4874;74734;739;0;0;0;0;.00nan;0;0
4875;848;743;91;41;3;38;.927;3600000;0
4875;2643;742;49;39;5;34;.872;3576000;0
4875;-1;742;0;0;0;0;.00nan;0;0
4875;91742;743;0;0;0;0;.00nan;0;0
4876;195867;2168;0;0;0;0;.00nan;0;0
4876;-1;745;49;2;0;2;1.000;510000;0
4876;49935;2168;81;34;2;32;.941;3600000;0
4876;75268;745;19;27;6;21;.778;3090000;0
4877;178098;738;57;29;4;25;.862;3544000;0
4877;185442;738;0;0;0;0;.00nan;0;0
4877;196698;741;0;0;0;0;.00nan;0;0
4877;46792;741;66;34;3;31;.912;3600000;0
4878;190570;1880;0;0;0;0;.00nan;0;0
4878;-1;1880;68;39;4;35;.897;3900000;0
4878;85281;749;0;0;0;0;.00nan;0;0
4878;85661;749;83;44;4;40;.909;3900000;0
4879;504;740;65;10;0;10;1.000;1229000;0
4879;595;740;29;36;7;29;.806;2371000;0
4879;52204;752;84;40;3;37;.925;3600000;0
4879;61272;752;0;0;0;0;.00nan;0;0
4880;8505;732;0;0;0;0;.00nan;0;0
4880;44526;734;77;38;3;35;.921;3900000;0
4880;56565;732;89;34;3;31;.912;3900000;0
4880;67362;734;0;0;0;0;.00nan;0;0
4881;175764;729;0;0;0;0;.00nan;0;0
4881;57107;747;68;25;2;23;.920;3600000;0
4881;76405;747;0;0;0;0;.00nan;0;0
4881;88646;729;46;35;5;30;.857;3600000;0
4882;2195;748;78;24;1;23;.958;3600000;0
4882;195887;764;66;35;3;32;.914;3556000;0
4882;-1;764;0;0;0;0;.00nan;0;0
4882;66245;748;0;0;0;0;.00nan;0;0
4883;83;737;52;24;3;21;.875;3561000;0
4883;199033;737;0;0;0;0;.00nan;0;0
4883;201075;736;0;0;0;0;.00nan;0;0
4883;196715;736;78;30;2;28;.933;3600000;0
4884;2643;742;81;25;1;24;.960;3600000;0
4884;3756;744;55;21;2;19;.905;3545000;0
4884;-1;742;0;0;0;0;.00nan;0;0
4884;49900;744;0;0;0;0;.00nan;0;0
4885;195867;2168;0;0;0;0;.00nan;0;0
4885;49935;2168;54;19;2;17;.895;3600000;0
4885;52204;752;84;49;4;45;.918;3586000;0
4885;61272;752;0;0;0;0;.00nan;0;0
4886;175764;729;0;0;0;0;.00nan;0;0
4886;85281;749;0;0;0;0;.00nan;0;0
4886;85661;749;70;26;2;24;.923;3860000;0
4886;88646;729;100;39;1;38;.974;3860000;0
4887;11716;751;0;0;0;0;.00nan;0;0
4887;190570;1880;63;29;3;26;.897;3900000;0
4887;-1;1880;0;0;0;0;.00nan;0;0
4887;148788;751;85;29;3;26;.897;3900000;0
4888;8505;732;0;0;0;0;.00nan;0;0
4888;56565;732;85;39;2;37;.949;3600000;0
4888;57107;747;0;0;0;0;.00nan;0;0
4888;76405;747;64;28;3;25;.893;3574000;0
4889;2195;748;0;0;0;0;.00nan;0;0
4889;58037;3789;0;0;0;0;.00nan;0;0
4889;66245;748;98;25;0;25;1.000;3600000;0
4889;85797;3789;64;35;4;31;.886;3600000;0
4890;196698;741;0;0;0;0;.00nan;0;0
4890;46792;741;100;35;0;35;1.000;3900000;0
4890;-1;745;0;0;0;0;.00nan;0;0
4890;75268;745;97;26;0;26;1.000;3900000;0
4891;178098;738;85;26;1;25;.962;3600000;0
4891;33044;739;51;25;3;22;.880;3110000;0
4891;185442;738;0;0;0;0;.00nan;0;0
4891;74734;739;31;10;3;7;.700;490000;0
4892;504;740;95;46;3;43;.935;3900000;0
4892;595;740;0;0;0;0;.00nan;0;0
4892;195887;764;0;0;0;0;.00nan;0;0
4892;-1;764;76;39;3;36;.923;3900000;0
4893;83;737;92;22;0;22;1.000;3600000;0
4893;848;743;97;40;1;39;.975;3600000;0
4893;199033;737;0;0;0;0;.00nan;0;0
4893;91742;743;0;0;0;0;.00nan;0;0
4894;1957;733;0;0;0;0;.00nan;0;0
4894;201075;736;56;17;2;15;.882;3583000;0
4894;196715;736;0;0;0;0;.00nan;0;0
4894;67287;733;100;39;0;39;1.000;3600000;0
4895;2643;742;67;30;4;26;.867;3582000;0
4895;3756;744;98;47;2;45;.957;3600000;0
4895;-1;742;0;0;0;0;.00nan;0;0
4895;49900;744;0;0;0;0;.00nan;0;0
4896;8505;732;0;0;0;0;.00nan;0;0
4896;56565;732;76;36;3;33;.917;3590000;0
4896;85281;749;0;0;0;0;.00nan;0;0
4896;85661;749;62;21;2;19;.905;3600000;0
4897;11716;751;0;0;0;0;.00nan;0;0
4897;175764;729;0;0;0;0;.00nan;0;0
4897;88646;729;87;24;1;23;.958;3900000;0
4897;148788;751;97;37;1;36;.973;3900000;0
4898;44526;734;0;0;0;0;.00nan;0;0
4898;52204;752;83;26;1;25;.962;3600000;0
4898;61272;752;0;0;0;0;.00nan;0;0
4898;67362;734;89;37;2;35;.946;3552000;0
4899;195867;2168;0;0;0;0;.00nan;0;0
4899;49935;2168;94;36;1;35;.972;3600000;0
4899;58037;3789;0;0;0;0;.00nan;0;0
4899;85797;3789;73;23;2;21;.913;3600000;0
4900;504;740;74;40;4;36;.900;3600000;0
4900;595;740;0;0;0;0;.00nan;0;0
4900;2195;748;0;0;0;0;.00nan;0;0
4900;66245;748;65;23;2;21;.913;3600000;0
4901;178098;738;99;42;2;40;.952;3600000;0
4901;195887;764;0;0;0;0;.00nan;0;0
4901;185442;738;0;0;0;0;.00nan;0;0
4901;-1;764;72;42;4;38;.905;3600000;0
4902;3756;744;63;29;4;25;.862;3600000;0
4902;196698;741;0;0;0;0;.00nan;0;0
4902;46792;741;90;42;3;39;.929;3600000;0
4902;49900;744;0;0;0;0;.00nan;0;0
4903;848;743;0;0;0;0;.00nan;0;0
4903;-1;745;0;0;0;0;.00nan;0;0
4903;75268;745;63;19;1;18;.947;3585000;0
4903;91742;743;100;26;0;26;1.000;3600000;0
4904;83;737;57;24;3;21;.875;3560000;0
4904;2643;742;72;29;2;27;.931;3600000;0
4904;199033;737;0;0;0;0;.00nan;0;0
4904;-1;742;0;0;0;0;.00nan;0;0
4905;196698;741;72;22;1;21;.955;3900000;0
4905;46792;741;0;0;0;0;.00nan;0;0
4905;57107;747;0;0;0;0;.00nan;0;0
4905;76405;747;95;39;1;38;.974;3900000;0
4906;8505;732;0;0;0;0;.00nan;0;0
4906;11716;751;91;38;2;36;.947;3600000;0
4906;56565;732;77;38;3;35;.921;3600000;0
4906;148788;751;0;0;0;0;.00nan;0;0
4907;1957;733;0;0;0;0;.00nan;0;0
4907;44526;734;40;26;4;22;.846;3600000;0
4907;67287;733;95;41;1;40;.976;3600000;0
4907;67362;734;0;0;0;0;.00nan;0;0
4908;504;740;0;0;0;0;.00nan;0;0
4908;595;740;68;32;3;29;.906;3595000;0
4908;195867;2168;71;31;2;29;.935;3600000;0
4908;49935;2168;0;0;0;0;.00nan;0;0
4909;178098;738;67;34;3;31;.912;3596000;0
4909;185442;738;0;0;0;0;.00nan;0;0
4909;58037;3789;0;0;0;0;.00nan;0;0
4909;85797;3789;71;28;2;26;.929;3600000;0
4910;2195;748;0;0;0;0;.00nan;0;0
4910;3756;744;62;33;4;29;.879;3547000;0
4910;49900;744;0;0;0;0;.00nan;0;0
4910;66245;748;74;37;3;34;.919;3600000;0
4911;52204;752;71;44;5;39;.886;3600000;0
4911;61272;752;0;0;0;0;.00nan;0;0
4911;85281;749;0;0;0;0;.00nan;0;0
4911;85661;749;87;27;1;26;.963;3600000;0
4912;201075;736;64;42;4;38;.905;3600000;0
4912;196715;736;0;0;0;0;.00nan;0;0
4912;-1;745;0;0;0;0;.00nan;0;0
4912;75268;745;76;21;1;20;.952;3600000;0
4913;1957;733;0;0;0;0;.00nan;0;0
4913;44526;734;0;0;0;0;.00nan;0;0
4913;67287;733;92;35;2;33;.943;3571000;0
4913;67362;734;100;23;0;23;1.000;3600000;0
4914;848;743;0;0;0;0;.00nan;0;0
4914;190570;1880;0;0;0;0;.00nan;0;0
4914;-1;1880;68;32;3;29;.906;3600000;0
4914;91742;743;64;43;5;38;.884;3550000;0
4915;83;737;92;31;1;30;.968;3600000;0
4915;199033;737;0;0;0;0;.00nan;0;0
4915;195887;764;0;0;0;0;.00nan;0;0
4915;-1;764;82;39;2;37;.949;3600000;0
4916;2643;742;98;32;1;31;.969;3802000;0
4916;-1;742;0;0;0;0;.00nan;0;0
4916;57107;747;0;0;0;0;.00nan;0;0
4916;76405;747;86;33;2;31;.939;3802000;0
4917;83;737;47;20;3;17;.850;3583000;0
4917;504;740;77;31;2;29;.935;3600000;0
4917;595;740;0;0;0;0;.00nan;0;0
4917;199033;737;0;0;0;0;.00nan;0;0
4918;178098;738;56;22;3;19;.864;3519000;0
4918;185442;738;0;0;0;0;.00nan;0;0
4918;196698;741;0;0;0;0;.00nan;0;0
4918;46792;741;92;49;1;48;.980;3600000;0
4919;33044;739;0;0;0;0;.00nan;0;0
4919;58037;3789;0;0;0;0;.00nan;0;0
4919;74734;739;88;29;1;28;.966;3547000;0
4919;85797;3789;99;26;0;26;1.000;3600000;0
4920;848;743;0;0;0;0;.00nan;0;0
4920;11716;751;0;0;0;0;.00nan;0;0
4920;91742;743;66;23;2;21;.913;3600000;0
4920;148788;751;38;29;5;24;.828;3600000;0
4921;-1;745;0;0;0;0;.00nan;0;0
4921;52204;752;58;32;4;28;.875;3549000;0
4921;61272;752;0;0;0;0;.00nan;0;0
4921;75268;745;90;33;2;31;.939;3600000;0
4922;201075;736;0;0;0;0;.00nan;0;0
4922;195867;2168;0;0;0;0;.00nan;0;0
4922;196715;736;100;37;1;36;.973;3900000;0
4922;49935;2168;98;34;1;33;.971;3900000;0
4923;1957;733;54;12;1;11;.917;499000;0
4923;67287;733;42;36;6;30;.833;3101000;0
4923;85281;749;0;0;0;0;.00nan;0;0
4923;85661;749;56;18;2;16;.889;3600000;0
4924;175764;729;0;0;0;0;.00nan;0;0
4924;190570;1880;94;48;3;45;.938;3900000;0
4924;-1;1880;0;0;0;0;.00nan;0;0
4924;88646;729;90;48;3;45;.938;3900000;0
4925;2195;748;0;0;0;0;.00nan;0;0
4925;195887;764;82;37;3;34;.919;3575000;0
4925;-1;764;0;0;0;0;.00nan;0;0
4925;66245;748;82;36;2;34;.944;3600000;0
4926;2643;742;100;45;2;43;.956;3600000;0
4926;-1;742;0;0;0;0;.00nan;0;0
4926;57107;747;0;0;0;0;.00nan;0;0
4926;76405;747;56;23;3;20;.870;3558000;0
4927;2195;748;0;0;0;0;.00nan;0;0
4927;-1;745;46;24;4;20;.833;3554000;0
4927;66245;748;64;28;3;25;.893;3600000;0
4927;75268;745;0;0;0;0;.00nan;0;0
4928;33044;739;0;0;0;0;.00nan;0;0
4928;44526;734;0;0;0;0;.00nan;0;0
4928;67362;734;73;22;1;21;.955;3600000;0
4928;74734;739;90;53;5;48;.906;3600000;0
4929;3756;744;0;0;0;0;.00nan;0;0
4929;49900;744;93;22;0;22;1.000;3600000;0
4929;58037;3789;0;0;0;0;.00nan;0;0
4929;85797;3789;70;41;4;37;.902;3600000;0
4930;11716;751;0;0;0;0;.00nan;0;0
4930;52204;752;75;47;5;42;.894;3600000;0
4930;61272;752;0;0;0;0;.00nan;0;0
4930;148788;751;67;21;2;19;.905;3600000;0
4931;1957;733;0;0;0;0;.00nan;0;0
4931;195867;2168;0;0;0;0;.00nan;0;0
4931;49935;2168;58;31;4;27;.871;3543000;0
4931;67287;733;72;35;3;32;.914;3600000;0
4932;504;740;79;33;2;31;.939;3641000;0
4932;595;740;0;0;0;0;.00nan;0;0
4932;190570;1880;76;27;3;24;.889;3641000;0
4932;-1;1880;0;0;0;0;.00nan;0;0
4933;8505;732;0;0;0;0;.00nan;0;0
4933;201075;736;90;48;4;44;.917;3545000;0
4933;196715;736;0;0;0;0;.00nan;0;0
4933;56565;732;78;37;3;34;.919;3600000;0
4934;848;743;0;0;0;0;.00nan;0;0
4934;195887;764;0;0;0;0;.00nan;0;0
4934;-1;764;34;30;6;24;.800;3600000;0
4934;91742;743;96;46;3;43;.935;3600000;0
4935;175764;729;0;0;0;0;.00nan;0;0
4935;196698;741;0;0;0;0;.00nan;0;0
4935;46792;741;55;27;4;23;.852;3546000;0
4935;88646;729;85;36;2;34;.944;3600000;0
4936;83;737;0;0;0;0;.00nan;0;0
4936;199033;737;45;26;4;22;.846;3600000;0
4936;178098;738;55;3;0;3;1.000;398000;0
4936;185442;738;21;23;6;17;.739;3148000;0
4937;195867;2168;0;0;0;0;.00nan;0;0
4937;49935;2168;84;32;2;30;.938;3600000;0
4937;58037;3789;0;0;0;0;.00nan;0;0
4937;85797;3789;57;27;5;22;.815;3600000;0
4938;33044;739;0;0;0;0;.00nan;0;0
4938;74734;739;58;40;5;35;.875;3586000;0
4938;85281;749;0;0;0;0;.00nan;0;0
4938;85661;749;84;38;3;35;.921;3600000;0
4939;83;737;75;29;1;28;.966;3600000;0
4939;199033;737;0;0;0;0;.00nan;0;0
4939;178098;738;61;30;3;27;.900;3585000;0
4939;185442;738;0;0;0;0;.00nan;0;0
4940;848;743;0;0;0;0;.00nan;0;0
4940;52204;752;69;36;3;33;.917;3814000;0
4940;61272;752;0;0;0;0;.00nan;0;0
4940;91742;743;60;29;4;25;.862;3814000;0
4941;201075;736;83;35;2;33;.943;2514000;0
4941;190570;1880;0;0;0;0;.00nan;0;0
4941;196715;736;40;20;4;16;.800;1086000;0
4941;-1;1880;85;26;1;25;.962;3600000;0
4942;8505;732;0;0;0;0;.00nan;0;0
4942;44526;734;0;0;0;0;.00nan;0;0
4942;56565;732;70;32;3;29;.906;3564000;0
4942;67362;734;99;37;1;36;.973;3600000;0
4943;11716;751;0;0;0;0;.00nan;0;0
4943;195887;764;0;0;0;0;.00nan;0;0
4943;-1;764;95;54;2;52;.963;3900000;0
4943;148788;751;93;25;2;23;.920;3900000;0
4944;2195;748;100;27;0;27;1.000;3600000;0
4944;-1;745;0;0;0;0;.00nan;0;0
4944;66245;748;0;0;0;0;.00nan;0;0
4944;75268;745;87;29;1;28;.966;3575000;0
4945;2643;742;50;29;5;24;.828;3600000;0
4945;175764;729;0;0;0;0;.00nan;0;0
4945;-1;742;0;0;0;0;.00nan;0;0
4945;88646;729;100;32;0;32;1.000;3600000;0
4946;1957;733;0;0;0;0;.00nan;0;0
4946;52204;752;0;0;0;0;.00nan;0;0
4946;61272;752;74;39;3;36;.923;3900000;0
4946;67287;733;92;47;3;44;.936;3900000;0
4947;83;737;71;30;2;28;.933;3517000;0
4947;199033;737;0;0;0;0;.00nan;0;0
4947;44526;734;100;39;0;39;1.000;3600000;0
4947;67362;734;0;0;0;0;.00nan;0;0
4948;3756;744;0;0;0;0;.00nan;0;0
4948;11716;751;56;34;4;30;.882;3600000;0
4948;49900;744;86;29;1;28;.966;3600000;0
4948;148788;751;0;0;0;0;.00nan;0;0
4949;504;740;53;29;4;25;.862;3600000;0
4949;595;740;0;0;0;0;.00nan;0;0
4949;8505;732;0;0;0;0;.00nan;0;0
4949;56565;732;95;24;0;24;1.000;3600000;0
4950;33044;739;0;0;0;0;.00nan;0;0
4950;57107;747;0;0;0;0;.00nan;0;0
4950;74734;739;98;37;2;35;.946;3600000;0
4950;76405;747;61;27;3;24;.889;3591000;0
4951;175764;729;0;0;0;0;.00nan;0;0
4951;195867;2168;0;0;0;0;.00nan;0;0
4951;49935;2168;51;35;5;30;.857;3594000;0
4951;88646;729;61;27;4;23;.852;3600000;0
4952;1957;733;54;3;0;3;1.000;427000;0
4952;58037;3789;0;0;0;0;.00nan;0;0
4952;67287;733;42;38;7;31;.816;3173000;0
4952;85797;3789;67;18;1;17;.944;3600000;0
4953;195887;764;0;0;0;0;.00nan;0;0
4953;-1;764;84;40;2;38;.950;3600000;0
4953;85281;749;0;0;0;0;.00nan;0;0
4953;85661;749;59;13;1;12;.923;3600000;0
4954;196698;741;0;0;0;0;.00nan;0;0
4954;46792;741;85;29;1;28;.966;3600000;0
4954;-1;745;0;0;0;0;.00nan;0;0
4954;75268;745;57;32;4;28;.875;3600000;0
4955;848;743;0;0;0;0;.00nan;0;0
4955;190570;1880;52;33;4;29;.879;3514000;0
4955;-1;1880;0;0;0;0;.00nan;0;0
4955;91742;743;83;35;2;33;.943;3600000;0
4956;2643;742;51;24;4;20;.833;3574000;0
4956;201075;736;96;51;3;48;.941;3600000;0
4956;196715;736;0;0;0;0;.00nan;0;0
4956;-1;742;0;0;0;0;.00nan;0;0
4957;83;737;73;30;2;28;.933;3560000;0
4957;2195;748;0;0;0;0;.00nan;0;0
4957;199033;737;0;0;0;0;.00nan;0;0
4957;66245;748;93;30;1;29;.967;3600000;0
4958;1957;733;0;0;0;0;.00nan;0;0
4958;58037;3789;0;0;0;0;.00nan;0;0
4958;67287;733;100;40;1;39;.975;3600000;0
4958;85797;3789;36;14;3;11;.786;3514000;0
4959;195887;764;0;0;0;0;.00nan;0;0
4959;-1;764;92;39;2;37;.949;3577000;0
4959;85281;749;100;32;0;32;1.000;3600000;0
4959;85661;749;0;0;0;0;.00nan;0;0
4960;11716;751;0;0;0;0;.00nan;0;0
4960;33044;739;0;0;0;0;.00nan;0;0
4960;74734;739;72;25;2;23;.920;3600000;0
4960;148788;751;88;46;3;43;.935;3552000;0
4961;8505;732;0;0;0;0;.00nan;0;0
4961;178098;738;0;0;0;0;.00nan;0;0
4961;185442;738;60;36;5;31;.861;3600000;0
4961;56565;732;95;38;2;36;.947;3600000;0
4962;504;740;0;0;0;0;.00nan;0;0
4962;595;740;86;42;3;39;.929;3569000;0
4962;57107;747;0;0;0;0;.00nan;0;0
4962;76405;747;73;19;1;18;.947;3600000;0
4963;190570;1880;94;40;4;36;.900;3777000;0
4963;196698;741;0;0;0;0;.00nan;0;0
4963;46792;741;84;37;3;34;.919;3777000;0
4963;-1;1880;0;0;0;0;.00nan;0;0
4964;3756;744;92;25;0;25;1.000;3600000;0
4964;-1;745;0;0;0;0;.00nan;0;0
4964;49900;744;0;0;0;0;.00nan;0;0
4964;75268;745;89;43;2;41;.953;3517000;0
4965;848;743;0;0;0;0;.00nan;0;0
4965;201075;736;0;0;0;0;.00nan;0;0
4965;196715;736;91;41;2;39;.951;3596000;0
4965;91742;743;82;29;1;28;.966;3600000;0
4966;83;737;84;22;1;21;.955;3600000;0
4966;199033;737;0;0;0;0;.00nan;0;0
4966;195867;2168;0;0;0;0;.00nan;0;0
4966;49935;2168;77;33;2;31;.939;3569000;0
4967;2195;748;100;58;1;57;.983;3600000;0
4967;178098;738;0;0;0;0;.00nan;0;0
4967;185442;738;39;25;5;20;.800;3600000;0
4967;66245;748;0;0;0;0;.00nan;0;0
4968;44526;734;78;37;3;34;.919;3555000;0
4968;58037;3789;0;0;0;0;.00nan;0;0
4968;67362;734;0;0;0;0;.00nan;0;0
4968;85797;3789;70;26;2;24;.923;3600000;0
4969;504;740;71;45;5;40;.889;3600000;0
4969;595;740;0;0;0;0;.00nan;0;0
4969;85281;749;59;19;2;17;.895;3600000;0
4969;85661;749;0;0;0;0;.00nan;0;0
4970;33044;739;0;0;0;0;.00nan;0;0
4970;52204;752;83;30;1;29;.967;3600000;0
4970;61272;752;0;0;0;0;.00nan;0;0
4970;74734;739;78;38;4;34;.895;3600000;0
4971;195887;764;0;0;0;0;.00nan;0;0
4971;-1;764;100;41;1;40;.976;3600000;0
4971;57107;747;68;35;4;31;.886;3600000;0
4971;76405;747;0;0;0;0;.00nan;0;0
4972;848;743;0;0;0;0;.00nan;0;0
4972;175764;729;0;0;0;0;.00nan;0;0
4972;88646;729;76;34;2;32;.941;3569000;0
4972;91742;743;71;21;1;20;.952;3600000;0
4973;1957;733;62;37;4;33;.892;3600000;0
4973;8505;732;0;0;0;0;.00nan;0;0
4973;56565;732;91;44;2;42;.955;3600000;0
4973;67287;733;0;0;0;0;.00nan;0;0
4974;178098;738;73;34;3;31;.912;3900000;0
4974;195867;2168;0;0;0;0;.00nan;0;0
4974;185442;738;0;0;0;0;.00nan;0;0
4974;49935;2168;97;37;3;34;.919;3900000;0
4975;201075;736;70;38;4;34;.895;3600000;0
4975;196715;736;0;0;0;0;.00nan;0;0
4975;-1;745;0;0;0;0;.00nan;0;0
4975;75268;745;86;30;1;29;.967;3600000;0
4976;3756;744;67;27;3;24;.889;3514000;0
4976;49900;744;0;0;0;0;.00nan;0;0
4976;58037;3789;0;0;0;0;.00nan;0;0
4976;85797;3789;78;23;1;22;.957;3600000;0
4977;504;740;0;0;0;0;.00nan;0;0
4977;595;740;76;34;3;31;.912;3546000;0
4977;11716;751;0;0;0;0;.00nan;0;0
4977;148788;751;68;19;1;18;.947;3600000;0
4978;1957;733;0;0;0;0;.00nan;0;0
4978;8505;732;0;0;0;0;.00nan;0;0
4978;56565;732;59;33;4;29;.879;3600000;0
4978;67287;733;99;38;1;37;.974;3600000;0
4979;190570;1880;100;26;0;26;1.000;3600000;0
4979;44526;734;82;46;3;43;.935;3600000;0
4979;-1;1880;0;0;0;0;.00nan;0;0
4979;67362;734;0;0;0;0;.00nan;0;0
4980;2643;742;54;27;4;23;.852;3600000;0
4980;-1;742;0;0;0;0;.00nan;0;0
4980;52204;752;91;28;1;27;.964;3600000;0
4980;61272;752;0;0;0;0;.00nan;0;0
4981;195887;764;46;13;2;11;.846;914000;0
4981;-1;764;62;47;6;41;.872;2686000;0
4981;57107;747;0;0;0;0;.00nan;0;0
4981;76405;747;83;11;0;11;1.000;3600000;0
4982;175764;729;0;0;0;0;.00nan;0;0
4982;85281;749;0;0;0;0;.00nan;0;0
4982;85661;749;81;37;4;33;.892;3744000;0
4982;88646;729;69;30;3;27;.900;3744000;0
4983;44526;734;48;32;5;27;.844;3600000;0
4983;-1;745;0;0;0;0;.00nan;0;0
4983;67362;734;0;0;0;0;.00nan;0;0
4983;75268;745;97;35;2;33;.943;3600000;0
4984;178098;738;0;0;0;0;.00nan;0;0
4984;201075;736;0;0;0;0;.00nan;0;0
4984;185442;738;65;23;2;21;.913;3900000;0
4984;196715;736;95;45;2;43;.956;3900000;0
4985;8505;732;0;0;0;0;.00nan;0;0
4985;56565;732;52;36;5;31;.861;3600000;0
4985;58037;3789;0;0;0;0;.00nan;0;0
4985;85797;3789;88;44;2;42;.955;3600000;0
4986;83;737;75;27;2;25;.926;3600000;0
4986;199033;737;0;0;0;0;.00nan;0;0
4986;33044;739;59;42;5;37;.881;3600000;0
4986;74734;739;0;0;0;0;.00nan;0;0
4987;3756;744;82;36;3;33;.917;3546000;0
4987;11716;751;0;0;0;0;.00nan;0;0
4987;49900;744;0;0;0;0;.00nan;0;0
4987;148788;751;93;39;2;37;.949;3600000;0
4988;1957;733;0;0;0;0;.00nan;0;0
4988;196698;741;0;0;0;0;.00nan;0;0
4988;46792;741;53;15;2;13;.867;3577000;0
4988;67287;733;99;41;1;40;.976;3600000;0
4989;190570;1880;78;26;2;24;.923;3900000;0
4989;-1;1880;0;0;0;0;.00nan;0;0
4989;52204;752;83;34;2;32;.941;3900000;0
4989;61272;752;0;0;0;0;.00nan;0;0
4990;2195;748;38;38;6;32;.842;3813000;0
4990;2643;742;60;42;5;37;.881;3813000;0
4990;-1;742;0;0;0;0;.00nan;0;0
4990;66245;748;0;0;0;0;.00nan;0;0
4991;195867;2168;0;0;0;0;.00nan;0;0
4991;49935;2168;81;33;2;31;.939;3600000;0
4991;57107;747;0;0;0;0;.00nan;0;0
4991;76405;747;67;35;4;31;.886;3598000;0
4992;848;743;0;0;0;0;.00nan;0;0
4992;85281;749;0;0;0;0;.00nan;0;0
4992;85661;749;83;25;1;24;.960;3600000;0
4992;91742;743;53;42;5;37;.881;3600000;0
4993;-1;745;0;0;0;0;.00nan;0;0
4993;52204;752;72;52;5;47;.904;3600000;0
4993;61272;752;0;0;0;0;.00nan;0;0
4993;75268;745;71;29;3;26;.897;3600000;0
4994;8505;732;0;0;0;0;.00nan;0;0
4994;178098;738;69;27;2;25;.926;3600000;0
4994;185442;738;0;0;0;0;.00nan;0;0
4994;56565;732;89;42;4;38;.905;3513000;0
4995;83;737;91;40;2;38;.950;3900000;0
4995;199033;737;0;0;0;0;.00nan;0;0
4995;11716;751;0;0;0;0;.00nan;0;0
4995;148788;751;78;30;2;28;.933;3900000;0
4996;201075;736;46;7;1;6;.857;328000;0
4996;33044;739;0;0;0;0;.00nan;0;0
4996;196715;736;47;53;8;45;.849;3272000;0
4996;74734;739;47;25;4;21;.840;3600000;0
4997;2195;748;0;0;0;0;.00nan;0;0
4997;3756;744;0;0;0;0;.00nan;0;0
4997;49900;744;69;23;1;22;.957;3600000;0
4997;66245;748;58;29;3;26;.897;3537000;0
4998;504;740;96;43;3;40;.930;3538000;0
4998;595;740;0;0;0;0;.00nan;0;0
4998;44526;734;82;22;1;21;.955;3600000;0
4998;67362;734;0;0;0;0;.00nan;0;0
4999;1957;733;0;0;0;0;.00nan;0;0
4999;175764;729;0;0;0;0;.00nan;0;0
4999;67287;733;78;36;2;34;.944;3600000;0
4999;88646;729;82;26;1;25;.962;3600000;0
5000;190570;1880;0;0;0;0;.00nan;0;0
5000;196698;741;0;0;0;0;.00nan;0;0
5000;46792;741;99;37;1;36;.973;3600000;0
5000;-1;1880;43;22;4;18;.818;3600000;0
5001;2643;742;70;27;2;25;.926;3600000;0
5001;195887;764;0;0;0;0;.00nan;0;0
5001;-1;764;57;35;5;30;.857;3600000;0
5001;-1;742;0;0;0;0;.00nan;0;0
5002;8505;732;0;0;0;0;.00nan;0;0
5002;178098;738;0;0;0;0;.00nan;0;0
5002;185442;738;72;26;2;24;.923;3600000;0
5002;56565;732;62;38;5;33;.868;3600000;0
5003;57107;747;0;0;0;0;.00nan;0;0
5003;76405;747;90;37;2;35;.946;3743000;0
5003;85281;749;0;0;0;0;.00nan;0;0
5003;85661;749;84;43;3;40;.930;3743000;0
5004;848;743;0;0;0;0;.00nan;0;0
5004;195867;2168;0;0;0;0;.00nan;0;0
5004;49935;2168;99;39;2;37;.949;3900000;0
5004;91742;743;69;29;2;27;.931;3900000;0
5005;196698;741;0;0;0;0;.00nan;0;0
5005;46792;741;61;35;4;31;.886;3900000;0
5005;58037;3789;0;0;0;0;.00nan;0;0
5005;85797;3789;69;38;4;34;.895;3900000;0
5006;3756;744;71;34;3;31;.912;3600000;0
5006;11716;751;0;0;0;0;.00nan;0;0
5006;49900;744;0;0;0;0;.00nan;0;0
5006;148788;751;92;24;0;24;1.000;3600000;0
5007;504;740;0;0;0;0;.00nan;0;0
5007;595;740;100;49;1;48;.980;3600000;0
5007;2195;748;0;0;0;0;.00nan;0;0
5007;66245;748;55;20;2;18;.900;3551000;0
5008;201075;736;39;24;5;19;.792;2259000;0
5008;175764;729;0;0;0;0;.00nan;0;0
5008;196715;736;64;20;1;19;.950;1341000;0
5008;88646;729;57;21;3;18;.857;3600000;0
5009;44526;734;86;47;4;43;.915;3600000;0
5009;-1;745;0;0;0;0;.00nan;0;0
5009;67362;734;0;0;0;0;.00nan;0;0
5009;75268;745;82;26;1;25;.962;3600000;0
5010;57107;747;0;0;0;0;.00nan;0;0
5010;76405;747;100;24;0;24;1.000;3600000;0
5010;85281;749;0;0;0;0;.00nan;0;0
5010;85661;749;76;27;1;26;.963;3565000;0
5011;33044;739;0;0;0;0;.00nan;0;0
5011;190570;1880;84;46;4;42;.913;3553000;0
5011;-1;1880;0;0;0;0;.00nan;0;0
5011;74734;739;63;25;3;22;.880;3600000;0
5012;848;743;0;0;0;0;.00nan;0;0
5012;52204;752;93;36;1;35;.972;3600000;0
5012;61272;752;0;0;0;0;.00nan;0;0
5012;91742;743;57;25;3;22;.880;3538000;0
5013;2643;742;70;21;1;20;.952;3564000;0
5013;195867;2168;0;0;0;0;.00nan;0;0
5013;-1;742;0;0;0;0;.00nan;0;0
5013;49935;2168;100;29;0;29;1.000;3600000;0
5014;178098;738;0;0;0;0;.00nan;0;0
5014;175764;729;0;0;0;0;.00nan;0;0
5014;185442;738;72;28;2;26;.929;3600000;0
5014;88646;729;55;39;5;34;.872;3600000;0
5015;1957;733;0;0;0;0;.00nan;0;0
5015;11716;751;0;0;0;0;.00nan;0;0
5015;67287;733;80;47;3;44;.936;3581000;0
5015;148788;751;85;36;2;34;.944;3600000;0
5016;195887;764;67;29;3;26;.897;3547000;0
5016;-1;764;0;0;0;0;.00nan;0;0
5016;58037;3789;0;0;0;0;.00nan;0;0
5016;85797;3789;82;26;1;25;.962;3600000;0
5017;848;743;0;0;0;0;.00nan;0;0
5017;2195;748;72;22;1;21;.955;3591000;0
5017;66245;748;0;0;0;0;.00nan;0;0
5017;91742;743;100;37;0;37;1.000;3600000;0
5018;504;740;62;24;3;21;.875;3600000;0
5018;595;740;0;0;0;0;.00nan;0;0
5018;44526;734;100;32;0;32;1.000;3600000;0
5018;67362;734;0;0;0;0;.00nan;0;0
5019;83;737;89;28;1;27;.964;3600000;0
5019;199033;737;0;0;0;0;.00nan;0;0
5019;-1;745;0;0;0;0;.00nan;0;0
5019;75268;745;52;36;5;31;.861;3600000;0
5020;33044;739;0;0;0;0;.00nan;0;0
5020;196698;741;0;0;0;0;.00nan;0;0
5020;46792;741;87;43;3;40;.930;3555000;0
5020;74734;739;58;23;2;21;.913;3600000;0
5021;2643;742;79;33;2;31;.939;3600000;0
5021;3756;744;58;21;3;18;.857;3545000;0
5021;193790;744;0;0;0;0;.00nan;0;0
5021;-1;742;0;0;0;0;.00nan;0;0
5022;195867;2168;0;0;0;0;.00nan;0;0
5022;49935;2168;57;23;3;20;.870;3626000;0
5022;52204;752;92;37;2;35;.946;3626000;0
5022;61272;752;0;0;0;0;.00nan;0;0
5023;201075;736;0;0;0;0;.00nan;0;0
5023;190570;1880;73;24;2;22;.917;3871000;0
5023;-1;1880;0;0;0;0;.00nan;0;0
5023;49900;736;99;34;1;33;.971;3871000;0
5024;175764;729;0;0;0;0;.00nan;0;0
5024;58037;3789;88;35;2;33;.943;3600000;0
5024;85797;3789;0;0;0;0;.00nan;0;0
5024;88646;729;54;30;4;26;.867;3515000;0
5025;178098;738;82;34;2;32;.941;3600000;0
5025;185442;738;0;0;0;0;.00nan;0;0
5025;85281;749;0;0;0;0;.00nan;0;0
5025;85661;749;69;26;3;23;.885;3552000;0
5026;1957;733;0;0;0;0;.00nan;0;0
5026;57107;747;0;0;0;0;.00nan;0;0
5026;67287;733;95;47;2;45;.957;3900000;0
5026;76405;747;97;26;2;24;.923;3900000;0
5027;3756;744;62;22;2;20;.909;3523000;0
5027;193790;744;0;0;0;0;.00nan;0;0
5027;190570;1880;98;23;0;23;1.000;3600000;0
5027;-1;1880;0;0;0;0;.00nan;0;0
5028;848;743;0;0;0;0;.00nan;0;0
5028;11716;751;0;0;0;0;.00nan;0;0
5028;91742;743;80;38;3;35;.921;3558000;0
5028;148788;751;53;15;2;13;.867;3600000;0
5029;2643;742;58;38;5;33;.868;3600000;0
5029;-1;742;0;0;0;0;.00nan;0;0
5029;52204;752;100;48;3;45;.938;3600000;0
5029;61272;752;0;0;0;0;.00nan;0;0
5030;504;740;0;0;0;0;.00nan;0;0
5030;595;740;73;29;2;27;.931;3600000;0
5030;201075;736;0;0;0;0;.00nan;0;0
5030;49900;736;53;29;4;25;.862;3565000;0
5031;8505;732;55;36;5;31;.861;3600000;0
5031;-1;745;0;0;0;0;.00nan;0;0
5031;56565;732;0;0;0;0;.00nan;0;0
5031;75268;745;70;32;3;29;.906;3600000;0
5032;195887;764;0;0;0;0;.00nan;0;0
5032;196698;741;0;0;0;0;.00nan;0;0
5032;46792;741;86;28;1;27;.964;3600000;0
5032;-1;764;97;22;0;22;1.000;3600000;0
5033;44526;734;65;31;3;28;.903;3600000;0
5033;58037;3789;0;0;0;0;.00nan;0;0
5033;67362;734;0;0;0;0;.00nan;0;0
5033;85797;3789;65;22;2;20;.909;3600000;0
5034;1957;733;0;0;0;0;.00nan;0;0
5034;67287;733;91;56;5;51;.911;3575000;0
5034;85281;749;0;0;0;0;.00nan;0;0
5034;85661;749;46;23;4;19;.826;3600000;0
5035;178098;738;0;0;0;0;.00nan;0;0
5035;185442;738;85;32;1;31;.969;3600000;0
5035;57107;747;0;0;0;0;.00nan;0;0
5035;76405;747;55;39;6;33;.846;3600000;0
5036;2195;748;100;37;0;37;1.000;3600000;0
5036;8505;732;0;0;0;0;.00nan;0;0
5036;56565;732;65;39;5;34;.872;3600000;0
5036;66245;748;0;0;0;0;.00nan;0;0
5037;175764;729;0;0;0;0;.00nan;0;0
5037;33044;739;0;0;0;0;.00nan;0;0
5037;74734;739;92;27;1;26;.963;3600000;0
5037;88646;729;69;27;2;25;.926;3583000;0
5038;83;737;17;21;6;15;.714;3600000;0
5038;199033;737;0;0;0;0;.00nan;0;0
5038;11716;751;0;0;0;0;.00nan;0;0
5038;148788;751;72;29;2;27;.931;3600000;0
5039;504;740;69;40;4;36;.900;3564000;0
5039;595;740;0;0;0;0;.00nan;0;0
5039;2643;742;55;21;3;18;.857;3600000;0
5039;-1;742;0;0;0;0;.00nan;0;0
5040;195887;764;0;0;0;0;.00nan;0;0
5040;190570;1880;57;33;4;29;.879;3600000;0
5040;-1;1880;0;0;0;0;.00nan;0;0
5040;-1;764;73;29;2;27;.931;3600000;0
5041;196698;741;0;0;0;0;.00nan;0;0
5041;46792;741;68;32;4;28;.875;3600000;0
5041;-1;745;0;0;0;0;.00nan;0;0
5041;75268;745;100;41;1;40;.976;3600000;0
5042;57107;747;0;0;0;0;.00nan;0;0
5042;76405;747;28;48;9;39;.813;3600000;0
5042;85281;749;0;0;0;0;.00nan;0;0
5042;85661;749;64;32;4;28;.875;3600000;0
5043;848;743;87;42;3;39;.929;3600000;0
5043;3756;744;18;12;5;7;.583;2050000;0
5043;193790;744;49;8;1;7;.875;1550000;0
5043;91742;743;0;0;0;0;.00nan;0;0
5044;11716;751;66;33;3;30;.909;3543000;0
5044;178098;738;89;23;1;22;.957;3600000;0
5044;185442;738;0;0;0;0;.00nan;0;0
5044;148788;751;0;0;0;0;.00nan;0;0
5045;201075;736;0;0;0;0;.00nan;0;0
5045;44526;734;68;20;2;18;.900;3600000;0
5045;49900;736;97;54;3;51;.944;3600000;0
5045;67362;734;0;0;0;0;.00nan;0;0
5046;8505;732;0;0;0;0;.00nan;0;0
5046;195867;2168;0;0;0;0;.00nan;0;0
5046;49935;2168;83;35;2;33;.943;3549000;0
5046;56565;732;100;42;1;41;.976;3600000;0
5047;175764;729;0;0;0;0;.00nan;0;0
5047;58037;3789;0;0;0;0;.00nan;0;0
5047;85797;3789;99;29;1;28;.966;3600000;0
5047;88646;729;80;28;3;25;.893;3566000;0
5048;504;740;0;0;0;0;.00nan;0;0
5048;595;740;63;47;6;41;.872;3600000;0
5048;33044;739;0;0;0;0;.00nan;0;0
5048;74734;739;96;42;2;40;.952;3600000;0
5049;195887;764;0;0;0;0;.00nan;0;0
5049;-1;764;66;42;5;37;.881;3600000;0
5049;-1;745;0;0;0;0;.00nan;0;0
5049;75268;745;74;33;2;31;.939;3600000;0
5050;2195;748;75;32;2;30;.938;3600000;0
5050;3756;744;73;24;1;23;.958;3600000;0
5050;193790;744;0;0;0;0;.00nan;0;0
5050;66245;748;0;0;0;0;.00nan;0;0
5051;83;737;57;20;2;18;.900;3600000;0
5051;199033;737;0;0;0;0;.00nan;0;0
5051;190570;1880;59;38;5;33;.868;3600000;0
5051;-1;1880;0;0;0;0;.00nan;0;0
5052;11716;751;0;0;0;0;.00nan;0;0
5052;57107;747;0;0;0;0;.00nan;0;0
5052;76405;747;67;30;3;27;.900;3561000;0
5052;148788;751;76;26;1;25;.962;3600000;0
5053;196698;741;0;0;0;0;.00nan;0;0
5053;46792;741;65;18;2;16;.889;3514000;0
5053;52204;752;100;32;0;32;1.000;3600000;0
5053;61272;752;0;0;0;0;.00nan;0;0
5054;848;743;0;0;0;0;.00nan;0;0
5054;195867;2168;0;0;0;0;.00nan;0;0
5054;49935;2168;100;40;0;40;1.000;3600000;0
5054;91742;743;53;25;4;21;.840;3600000;0
5055;58037;3789;0;0;0;0;.00nan;0;0
5055;85281;749;0;0;0;0;.00nan;0;0
5055;85661;749;85;29;2;27;.931;3900000;0
5055;85797;3789;74;25;2;23;.920;3900000;0
5056;8505;732;0;0;0;0;.00nan;0;0
5056;201075;736;0;0;0;0;.00nan;0;0
5056;49900;736;88;37;2;35;.946;3600000;0
5056;56565;732;88;28;1;27;.964;3600000;0
5057;1957;733;0;0;0;0;.00nan;0;0
5057;33044;739;0;0;0;0;.00nan;0;0
5057;67287;733;85;33;2;31;.939;3600000;0
5057;74734;739;65;29;3;26;.897;3553000;0
5058;2643;742;68;37;4;33;.892;3585000;0
5058;44526;734;72;30;3;27;.900;3600000;0
5058;-1;742;0;0;0;0;.00nan;0;0
5058;67362;734;0;0;0;0;.00nan;0;0
5059;83;737;54;25;3;22;.880;3600000;0
5059;199033;737;0;0;0;0;.00nan;0;0
5059;195887;764;0;0;0;0;.00nan;0;0
5059;-1;764;88;50;4;46;.920;3522000;0
5060;11716;751;0;0;0;0;.00nan;0;0
5060;196698;741;0;0;0;0;.00nan;0;0
5060;46792;741;83;31;2;29;.935;3557000;0
5060;148788;751;100;41;0;41;1.000;3600000;0
5061;190570;1880;66;24;2;22;.917;3600000;0
5061;-1;1880;0;0;0;0;.00nan;0;0
5061;52204;752;59;32;4;28;.875;3586000;0
5061;61272;752;0;0;0;0;.00nan;0;0
5062;848;743;92;48;3;45;.938;3600000;0
5062;-1;745;0;0;0;0;.00nan;0;0
5062;75268;745;57;35;4;31;.886;3550000;0
5062;91742;743;0;0;0;0;.00nan;0;0
5063;2195;748;34;27;5;22;.815;3600000;0
5063;178098;738;74;33;2;31;.939;3600000;0
5063;185442;738;0;0;0;0;.00nan;0;0
5063;66245;748;0;0;0;0;.00nan;0;0
5064;3756;744;69;25;2;23;.920;3600000;0
5064;193790;744;0;0;0;0;.00nan;0;0
5064;201075;736;0;0;0;0;.00nan;0;0
5064;49900;736;72;47;5;42;.894;3600000;0
5065;504;740;76;23;1;22;.957;2802000;0
5065;595;740;24;11;4;7;.636;1082000;0
5065;44526;734;63;34;4;30;.882;3884000;0
5065;67362;734;0;0;0;0;.00nan;0;0
5066;1957;733;81;16;0;16;1.000;1327000;0
5066;33044;739;0;0;0;0;.00nan;0;0
5066;67287;733;49;43;6;37;.860;2273000;0
5066;74734;739;54;23;3;20;.870;3600000;0
5067;2643;742;100;32;0;32;1.000;3600000;0
5067;175764;729;0;0;0;0;.00nan;0;0
5067;-1;742;0;0;0;0;.00nan;0;0
5067;88646;729;90;53;5;48;.906;3600000;0
5068;57107;747;81;34;2;32;.941;3642000;0
5068;58037;3789;0;0;0;0;.00nan;0;0
5068;76405;747;0;0;0;0;.00nan;0;0
5068;85797;3789;66;30;3;27;.900;3642000;0
5069;195867;2168;0;0;0;0;.00nan;0;0
5069;49935;2168;100;31;0;31;1.000;3600000;0
5069;85281;749;0;0;0;0;.00nan;0;0
5069;85661;749;90;38;2;36;.947;3567000;0
5070;2195;748;24;27;6;21;.778;1299000;0
5070;195867;2168;0;0;0;0;.00nan;0;0
5070;49935;2168;87;30;1;29;.967;3600000;0
5070;66245;748;69;22;2;20;.909;2301000;0
5071;178098;738;0;0;0;0;.00nan;0;0
5071;185442;738;47;28;4;24;.857;3600000;0
5071;-1;745;0;0;0;0;.00nan;0;0
5071;75268;745;64;37;5;32;.865;3545000;0
5072;83;737;53;20;2;18;.900;3600000;0
5072;1957;733;0;0;0;0;.00nan;0;0
5072;199033;737;0;0;0;0;.00nan;0;0
5072;67287;733;91;46;3;43;.935;3589000;0
5073;504;740;0;0;0;0;.00nan;0;0
5073;595;740;55;39;5;34;.872;3600000;0
5073;196698;741;67;29;2;27;.931;3600000;0
5073;46792;741;0;0;0;0;.00nan;0;0
5074;3756;744;67;26;2;24;.923;3600000;0
5074;193790;744;0;0;0;0;.00nan;0;0
5074;175764;729;0;0;0;0;.00nan;0;0
5074;88646;729;68;33;3;30;.909;3600000;0
5075;11716;751;0;0;0;0;.00nan;0;0
5075;58037;3789;0;0;0;0;.00nan;0;0
5075;85797;3789;69;29;3;26;.897;3900000;0
5075;148788;751;69;32;3;29;.906;3900000;0
5076;190570;1880;0;0;0;0;.00nan;0;0
5076;44526;734;44;30;5;25;.833;3900000;0
5076;-1;1880;74;43;5;38;.884;3900000;0
5076;67362;734;0;0;0;0;.00nan;0;0
5077;8505;732;0;0;0;0;.00nan;0;0
5077;52204;752;97;53;0;53;1.000;3900000;0
5077;56565;732;96;21;0;21;1.000;3900000;0
5077;61272;752;0;0;0;0;.00nan;0;0
5078;201075;736;0;0;0;0;.00nan;0;0
5078;195887;764;0;0;0;0;.00nan;0;0
5078;-1;764;97;47;1;46;.979;3900000;0
5078;49900;736;87;29;1;28;.966;3900000;0
5079;57107;747;0;0;0;0;.00nan;0;0
5079;76405;747;55;32;5;27;.844;3744000;0
5079;85281;749;0;0;0;0;.00nan;0;0
5079;85661;749;68;37;4;33;.892;3744000;0
5080;178098;738;91;33;1;32;.970;3600000;0
5080;185442;738;0;0;0;0;.00nan;0;0
5080;44526;734;82;31;3;28;.903;3563000;0
5080;67362;734;0;0;0;0;.00nan;0;0
5081;848;743;100;29;0;29;1.000;3600000;0
5081;196698;741;0;0;0;0;.00nan;0;0
5081;46792;741;71;40;4;36;.900;3600000;0
5081;91742;743;0;0;0;0;.00nan;0;0
5082;33044;739;0;0;0;0;.00nan;0;0
5082;-1;745;0;0;0;0;.00nan;0;0
5082;74734;739;100;27;0;27;1.000;3600000;0
5082;75268;745;58;34;5;29;.853;3600000;0
5083;504;740;0;0;0;0;.00nan;0;0
5083;595;740;89;45;4;41;.911;3600000;0
5083;3756;744;83;13;0;13;1.000;3600000;0
5083;193790;744;0;0;0;0;.00nan;0;0
5084;2195;748;100;36;0;36;1.000;3600000;0
5084;11716;751;0;0;0;0;.00nan;0;0
5084;66245;748;0;0;0;0;.00nan;0;0
5084;148788;751;61;42;5;37;.881;3600000;0
5085;1957;733;0;0;0;0;.00nan;0;0
5085;190570;1880;71;29;2;27;.931;3600000;0
5085;-1;1880;0;0;0;0;.00nan;0;0
5085;67287;733;75;39;4;35;.897;3570000;0
5086;2643;742;100;27;0;27;1.000;3600000;0
5086;201075;736;0;0;0;0;.00nan;0;0
5086;-1;742;0;0;0;0;.00nan;0;0
5086;49900;736;68;37;4;33;.892;3600000;0
5087;8505;732;0;0;0;0;.00nan;0;0
5087;175764;729;72;34;2;32;.941;2933000;0
5087;56565;732;49;19;3;16;.842;3600000;0
5087;88646;729;27;8;3;5;.625;583000;0
5088;-1;747;21;31;7;24;.774;3198000;0
5088;76405;747;62;6;0;6;1.000;402000;0
5088;85281;749;87;28;1;27;.964;3600000;0
5088;85661;749;0;0;0;0;.00nan;0;0
5089;195887;764;90;43;2;41;.953;3600000;0
5089;-1;764;0;0;0;0;.00nan;0;0
5089;52204;752;61;30;4;26;.867;3600000;0
5089;61272;752;0;0;0;0;.00nan;0;0
5090;195867;2168;0;0;0;0;.00nan;0;0
5090;-1;745;0;0;0;0;.00nan;0;0
5090;49935;2168;73;19;1;18;.947;3600000;0
5090;75268;745;76;47;4;43;.915;3600000;0
5091;8505;732;0;0;0;0;.00nan;0;0
5091;56565;732;75;26;3;23;.885;3584000;0
5091;58037;3789;77;26;2;24;.923;3600000;0
5091;85797;3789;0;0;0;0;.00nan;0;0
5092;175764;729;0;0;0;0;.00nan;0;0
5092;44526;734;56;27;3;24;.889;3600000;0
5092;67362;734;0;0;0;0;.00nan;0;0
5092;88646;729;72;37;4;33;.892;3596000;0
5093;11716;751;0;0;0;0;.00nan;0;0
5093;196698;741;0;0;0;0;.00nan;0;0
5093;46792;741;78;42;4;38;.905;3856000;0
5093;148788;751;75;33;3;30;.909;3856000;0
5094;178098;738;58;33;5;28;.848;3600000;0
5094;33044;739;0;0;0;0;.00nan;0;0
5094;74734;739;89;30;1;29;.967;3600000;0
5094;93324;738;0;0;0;0;.00nan;0;0
5095;504;740;0;0;0;0;.00nan;0;0
5095;595;740;71;37;3;34;.919;3815000;0
5095;190570;1880;63;25;2;23;.920;3815000;0
5095;-1;1880;0;0;0;0;.00nan;0;0
5096;2195;748;59;24;3;21;.875;3600000;0
5096;52204;752;0;0;0;0;.00nan;0;0
5096;61272;752;88;30;1;29;.967;3600000;0
5096;66245;748;0;0;0;0;.00nan;0;0
5097;1957;733;82;20;0;20;1.000;2141000;0
5097;201075;736;44;6;1;5;.833;1534000;0
5097;49900;736;34;22;6;16;.727;2022000;0
5097;67287;733;14;17;6;11;.647;1459000;0
5098;2643;742;60;32;4;28;.875;3600000;0
5098;195887;764;0;0;0;0;.00nan;0;0
5098;-1;764;94;44;3;41;.932;3600000;0
5098;-1;742;0;0;0;0;.00nan;0;0
5099;-1;747;0;0;0;0;.00nan;0;0
5099;76405;747;100;31;0;31;1.000;3600000;0
5099;85281;749;0;0;0;0;.00nan;0;0
5099;85661;749;39;23;4;19;.826;3600000;0
5100;1957;733;68;42;5;37;.881;3600000;0
5100;195867;2168;82;28;2;26;.929;3600000;0
5100;49935;2168;0;0;0;0;.00nan;0;0
5100;67122;733;0;0;0;0;.00nan;0;0
5101;504;740;0;0;0;0;.00nan;0;0
5101;595;740;76;36;3;33;.917;3609000;0
5101;178098;738;72;29;2;27;.931;3609000;0
5101;93324;738;0;0;0;0;.00nan;0;0
5102;2643;742;86;35;2;33;.943;3600000;0
5102;44526;734;76;22;1;21;.955;3600000;0
5102;-1;742;0;0;0;0;.00nan;0;0
5102;67362;734;0;0;0;0;.00nan;0;0
5103;11716;751;0;0;0;0;.00nan;0;0
5103;196698;741;48;0;0;0;.00nan;273000;0
5103;46792;741;60;34;6;28;.824;3327000;0
5103;148788;751;100;36;1;35;.972;3600000;0
5104;8505;732;0;0;0;0;.00nan;0;0
5104;33044;739;0;0;0;0;.00nan;0;0
5104;56565;732;70;31;3;28;.903;3600000;0
5104;74734;739;52;32;4;28;.875;3590000;0
5105;848;743;56;26;3;23;.885;3600000;0
5105;2195;748;54;32;4;28;.875;3552000;0
5105;66245;748;0;0;0;0;.00nan;0;0
5105;91742;743;0;0;0;0;.00nan;0;0
5106;201075;736;57;6;0;6;1.000;544000;0
5106;175764;729;0;0;0;0;.00nan;0;0
5106;49900;736;54;41;6;35;.854;3056000;0
5106;88646;729;89;35;2;33;.943;3600000;0
5107;195887;764;0;0;0;0;.00nan;0;0
5107;-1;764;70;30;2;28;.933;3600000;0
5107;-1;745;0;0;0;0;.00nan;0;0
5107;75268;745;70;32;3;29;.906;3558000;0
5108;83;737;74;22;1;21;.955;3600000;0
5108;2643;742;80;30;2;28;.933;3600000;0
5108;199033;737;0;0;0;0;.00nan;0;0
5108;-1;742;0;0;0;0;.00nan;0;0
5109;3756;744;82;36;3;33;.917;3554000;0
5109;193790;744;0;0;0;0;.00nan;0;0
5109;85281;749;0;0;0;0;.00nan;0;0
5109;85661;749;59;21;2;19;.905;3600000;0
5110;-1;747;0;0;0;0;.00nan;0;0
5110;52204;752;100;34;0;34;1.000;3600000;0
5110;61272;752;0;0;0;0;.00nan;0;0
5110;76405;747;38;42;7;35;.833;3600000;0
5111;190570;1880;0;0;0;0;.00nan;0;0
5111;-1;1880;96;20;0;20;1.000;3600000;0
5111;58037;3789;0;0;0;0;.00nan;0;0
5111;85797;3789;64;19;1;18;.947;3543000;0
5112;1957;733;75;27;2;25;.926;3553000;0
5112;2195;748;88;19;0;19;1.000;3600000;0
5112;66245;748;0;0;0;0;.00nan;0;0
5112;67122;733;0;0;0;0;.00nan;0;0
5113;175764;729;0;0;0;0;.00nan;0;0
5113;33044;739;0;0;0;0;.00nan;0;0
5113;74734;739;48;23;4;19;.826;3525000;0
5113;88646;729;87;45;2;43;.956;3600000;0
5114;504;740;60;26;3;23;.885;3600000;0
5114;595;740;0;0;0;0;.00nan;0;0
5114;201075;736;0;0;0;0;.00nan;0;0
5114;49900;736;74;38;4;34;.895;3586000;0
5115;848;743;0;0;0;0;.00nan;0;0
5115;44526;734;50;27;4;23;.852;3546000;0
5115;67362;734;0;0;0;0;.00nan;0;0
5115;91742;743;73;32;3;29;.906;3600000;0
5116;11716;751;0;0;0;0;.00nan;0;0
5116;-1;745;0;0;0;0;.00nan;0;0
5116;75268;745;43;35;5;30;.857;3581000;0
5116;148788;751;53;30;4;26;.867;3600000;0
5117;3756;744;89;31;1;30;.968;3600000;0
5117;193790;744;0;0;0;0;.00nan;0;0
5117;-1;2168;0;0;0;0;.00nan;0;0
5117;49935;2168;64;24;2;22;.917;3600000;0
5118;178098;738;75;24;2;22;.917;3596000;0
5118;-1;747;0;0;0;0;.00nan;0;0
5118;76405;747;91;29;1;28;.966;3600000;0
5118;93324;738;0;0;0;0;.00nan;0;0
5119;195887;764;0;0;0;0;.00nan;0;0
5119;196698;741;0;0;0;0;.00nan;0;0
5119;46792;741;56;25;4;21;.840;3600000;0
5119;-1;764;96;43;2;41;.953;3600000;0
5120;83;737;69;31;3;28;.903;3536000;0
5120;199033;737;0;0;0;0;.00nan;0;0
5120;190570;1880;0;0;0;0;.00nan;0;0
5120;-1;1880;92;30;1;29;.967;3600000;0
5121;8505;732;0;0;0;0;.00nan;0;0
5121;56565;732;100;28;0;28;1.000;3600000;0
5121;58037;3789;0;0;0;0;.00nan;0;0
5121;85797;3789;87;40;2;38;.950;3563000;0
5122;175764;729;72;22;1;21;.955;3600000;0
5122;52204;752;97;66;3;63;.955;3600000;0
5122;61272;752;0;0;0;0;.00nan;0;0
5122;88646;729;0;0;0;0;.00nan;0;0
5123;201075;736;0;0;0;0;.00nan;0;0
5123;44526;734;51;23;4;19;.826;3600000;0
5123;49900;736;61;48;6;42;.875;3600000;0
5123;67362;734;0;0;0;0;.00nan;0;0
5124;848;743;0;0;0;0;.00nan;0;0
5124;85281;749;0;0;0;0;.00nan;0;0
5124;85661;749;58;26;3;23;.885;3600000;0
5124;91742;743;94;35;1;34;.971;3600000;0
5125;2643;742;92;40;1;39;.975;3900000;0
5125;178098;738;0;0;0;0;.00nan;0;0
5125;-1;742;0;0;0;0;.00nan;0;0
5125;93324;738;96;32;1;31;.969;3900000;0
5126;195887;764;100;43;1;42;.977;3600000;0
5126;-1;764;0;0;0;0;.00nan;0;0
5126;58037;3789;80;26;2;24;.923;3544000;0
5126;85797;3789;0;0;0;0;.00nan;0;0
5127;83;737;78;22;2;20;.909;3600000;0
5127;199033;737;0;0;0;0;.00nan;0;0
5127;33044;739;0;0;0;0;.00nan;0;0
5127;74734;739;47;30;4;26;.867;3556000;0
5128;3756;744;61;29;3;26;.897;3578000;0
5128;193790;744;0;0;0;0;.00nan;0;0
5128;196698;741;0;0;0;0;.00nan;0;0
5128;46792;741;83;30;2;28;.933;3600000;0
5129;504;740;0;0;0;0;.00nan;0;0
5129;595;740;85;30;1;29;.967;3600000;0
5129;190570;1880;64;29;3;26;.897;3568000;0
5129;-1;1880;0;0;0;0;.00nan;0;0
5130;11716;751;0;0;0;0;.00nan;0;0
5130;-1;2168;0;0;0;0;.00nan;0;0
5130;49935;2168;64;32;3;29;.906;3600000;0
5130;148788;751;68;39;4;35;.897;3574000;0
5131;1957;733;91;33;1;32;.970;3600000;0
5131;-1;747;0;0;0;0;.00nan;0;0
5131;67122;733;0;0;0;0;.00nan;0;0
5131;76405;747;41;22;4;18;.818;3600000;0
5132;201075;736;0;0;0;0;.00nan;0;0
5132;175764;729;0;0;0;0;.00nan;0;0
5132;49900;736;81;48;4;44;.917;3600000;0
5132;88646;729;100;28;0;28;1.000;3600000;0
5133;848;743;95;43;3;40;.930;3555000;0
5133;85281;749;0;0;0;0;.00nan;0;0
5133;85661;749;62;21;2;19;.905;3600000;0
5133;91742;743;0;0;0;0;.00nan;0;0
5134;3756;744;88;28;1;27;.964;3900000;0
5134;193790;744;0;0;0;0;.00nan;0;0
5134;-1;745;0;0;0;0;.00nan;0;0
5134;75268;745;93;35;1;34;.971;3900000;0
5135;2195;748;47;15;2;13;.867;3600000;0
5135;-1;2168;0;0;0;0;.00nan;0;0
5135;49935;2168;78;51;4;47;.922;3551000;0
5135;66245;748;0;0;0;0;.00nan;0;0
5136;83;737;68;26;2;24;.923;3600000;0
5136;199033;737;0;0;0;0;.00nan;0;0
5136;178098;738;70;31;3;28;.903;3586000;0
5136;93324;738;0;0;0;0;.00nan;0;0
5137;190570;1880;77;27;2;25;.926;3685000;0
5137;-1;1880;0;0;0;0;.00nan;0;0
5137;58037;3789;0;0;0;0;.00nan;0;0
5137;85797;3789;89;43;3;40;.930;3685000;0
5138;196698;741;0;0;0;0;.00nan;0;0
5138;44526;734;94;36;1;35;.972;3600000;0
5138;46792;741;85;44;3;41;.932;3515000;0
5138;67362;734;0;0;0;0;.00nan;0;0
5139;504;740;0;0;0;0;.00nan;0;0
5139;595;740;61;44;6;38;.864;3600000;0
5139;33044;739;0;0;0;0;.00nan;0;0
5139;74734;739;100;34;1;33;.971;3600000;0
5140;2643;742;87;43;2;41;.953;3900000;0
5140;11716;751;62;23;2;21;.913;3900000;0
5140;-1;742;0;0;0;0;.00nan;0;0
5140;148788;751;0;0;0;0;.00nan;0;0
5141;1957;733;85;34;2;32;.941;3900000;0
5141;52204;752;79;34;2;32;.941;3900000;0
5141;61272;752;0;0;0;0;.00nan;0;0
5141;67122;733;0;0;0;0;.00nan;0;0
5142;8505;732;0;0;0;0;.00nan;0;0
5142;195887;764;0;0;0;0;.00nan;0;0
5142;-1;764;98;45;2;43;.956;3570000;0
5142;56565;732;100;23;0;23;1.000;3600000;0
5143;848;743;86;26;1;25;.962;3600000;0
5143;-1;747;42;26;4;22;.846;3600000;0
5143;76405;747;0;0;0;0;.00nan;0;0
5143;91742;743;0;0;0;0;.00nan;0;0
5144;52204;752;34;34;6;28;.824;3189000;0
5144;56565;745;100;23;0;23;1.000;3600000;0
5144;61272;752;70;10;0;10;1.000;411000;0
5144;75268;745;0;0;0;0;.00nan;0;0
5145;2195;748;95;37;2;35;.946;3600000;0
5145;2643;742;67;29;3;26;.897;3559000;0
5145;-1;742;0;0;0;0;.00nan;0;0
5145;66245;748;0;0;0;0;.00nan;0;0
5146;178098;738;74;42;4;38;.905;3539000;0
5146;175764;729;0;0;0;0;.00nan;0;0
5146;88646;729;80;36;2;34;.944;3600000;0
5146;93324;738;0;0;0;0;.00nan;0;0
5147;196698;741;0;0;0;0;.00nan;0;0
5147;46792;741;70;48;5;43;.896;3535000;0
5147;-1;2168;0;0;0;0;.00nan;0;0
5147;49935;2168;68;32;3;29;.906;3600000;0
5148;1957;734;54;30;5;25;.833;3900000;0
5148;33044;739;0;0;0;0;.00nan;0;0
5148;44526;734;0;0;0;0;.00nan;0;0
5148;74734;739;77;55;5;50;.909;3900000;0
5149;83;737;44;22;4;18;.818;3543000;0
5149;3756;744;93;35;2;33;.943;3600000;0
5149;199033;737;0;0;0;0;.00nan;0;0
5149;193790;744;0;0;0;0;.00nan;0;0
5150;841;764;74;26;2;24;.923;3600000;0
5150;196715;736;0;0;0;0;.00nan;0;0
5150;-1;764;0;0;0;0;.00nan;0;0
5150;49900;736;54;26;3;23;.885;3550000;0
5151;58037;3789;0;0;0;0;.00nan;0;0
5151;67122;733;0;0;0;0;.00nan;0;0
5151;67362;733;93;50;3;47;.940;3600000;0
5151;85797;3789;73;19;1;18;.947;3600000;0
5152;8505;732;65;27;3;24;.889;3622000;0
5152;195867;732;0;0;0;0;.00nan;0;0
5152;180110;1880;73;39;4;35;.897;3640000;0
5152;49815;1880;0;0;0;0;.00nan;0;0
5153;848;743;0;0;0;0;.00nan;0;0
5153;-1;747;0;0;0;0;.00nan;0;0
5153;76405;747;92;30;1;29;.967;3600000;0
5153;91742;743;64;22;2;20;.909;3552000;0
5154;-1;2168;0;0;0;0;.00nan;0;0
5154;49935;2168;77;35;3;32;.914;3600000;0
5154;52204;752;45;26;4;22;.846;3576000;0
5154;61272;752;0;0;0;0;.00nan;0;0
5155;178098;738;70;34;4;30;.882;3576000;0
5155;85281;749;0;0;0;0;.00nan;0;0
5155;85661;749;61;31;3;28;.903;3600000;0
5155;93324;738;0;0;0;0;.00nan;0;0
5156;2195;748;60;42;5;37;.881;3600000;0
5156;33044;739;0;0;0;0;.00nan;0;0
5156;66245;748;0;0;0;0;.00nan;0;0
5156;74734;739;78;28;2;26;.929;3600000;0
5157;11716;751;0;0;0;0;.00nan;0;0
5157;-1;747;0;0;0;0;.00nan;0;0
5157;76405;747;88;18;0;18;1.000;3600000;0
5157;148788;751;98;48;2;46;.958;3600000;0
5158;8505;732;58;33;4;29;.879;3600000;0
5158;195867;732;0;0;0;0;.00nan;0;0
5158;196715;736;0;0;0;0;.00nan;0;0
5158;49900;736;51;39;6;33;.846;3557000;0
5159;3756;744;88;19;0;19;1.000;3600000;0
5159;193790;744;0;0;0;0;.00nan;0;0
5159;67122;733;0;0;0;0;.00nan;0;0
5159;67362;733;96;44;2;42;.955;3592000;0
5160;841;764;81;45;3;42;.933;3553000;0
5160;2643;742;74;27;2;25;.926;3600000;0
5160;-1;764;0;0;0;0;.00nan;0;0
5160;-1;742;0;0;0;0;.00nan;0;0
5161;83;737;94;19;0;19;1.000;3600000;0
5161;504;740;0;0;0;0;.00nan;0;0
5161;595;740;84;41;2;39;.951;3600000;0
5161;199033;737;0;0;0;0;.00nan;0;0
5162;848;743;62;35;4;31;.886;3600000;0
5162;196698;741;0;0;0;0;.00nan;0;0
5162;46792;741;51;30;5;25;.833;3555000;0
5162;91742;743;0;0;0;0;.00nan;0;0
5163;-1;747;0;0;0;0;.00nan;0;0
5163;56565;745;88;38;2;36;.947;3588000;0
5163;75268;745;0;0;0;0;.00nan;0;0
5163;76405;747;66;17;1;16;.941;3600000;0
5164;8505;732;65;28;3;25;.893;3900000;0
5164;178098;738;58;27;3;24;.889;3900000;0
5164;195867;732;0;0;0;0;.00nan;0;0
5164;93324;738;0;0;0;0;.00nan;0;0
5165;175764;729;0;0;0;0;.00nan;0;0
5165;180110;1880;62;26;3;23;.885;3517000;0
5165;49815;1880;0;0;0;0;.00nan;0;0
5165;88646;729;98;33;1;32;.970;3600000;0
5166;58037;3789;61;29;3;26;.897;3600000;0
5166;85281;749;0;0;0;0;.00nan;0;0
5166;85661;749;45;36;5;31;.861;3600000;0
5166;85797;3789;0;0;0;0;.00nan;0;0
5167;848;743;0;0;0;0;.00nan;0;0
5167;3756;744;81;35;3;32;.914;3600000;0
5167;193790;744;0;0;0;0;.00nan;0;0
5167;91742;743;38;33;6;27;.818;3600000;0
5168;11716;751;0;0;0;0;.00nan;0;0
5168;52204;752;72;31;3;28;.903;3600000;0
5168;61272;752;0;0;0;0;.00nan;0;0
5168;148788;751;74;29;2;27;.931;3600000;0
5169;33044;739;0;0;0;0;.00nan;0;0
5169;196715;736;0;0;0;0;.00nan;0;0
5169;49900;736;98;39;2;37;.949;3600000;0
5169;74734;739;100;40;1;39;.975;3600000;0
5170;841;764;65;29;3;26;.897;3600000;0
5170;-1;764;0;0;0;0;.00nan;0;0
5170;67122;733;21;17;5;12;.706;1780000;0
5170;67362;733;88;23;0;23;1.000;1820000;0
5171;2195;748;64;32;3;29;.906;3600000;0
5171;2643;742;0;0;0;0;.00nan;0;0
5171;-1;742;57;26;3;23;.885;3556000;0
5171;66245;748;0;0;0;0;.00nan;0;0
5172;196698;741;0;0;0;0;.00nan;0;0
5172;46792;741;53;32;4;28;.875;3600000;0
5172;-1;2168;0;0;0;0;.00nan;0;0
5172;49935;2168;70;28;2;26;.929;3600000;0
5173;83;737;52;26;4;22;.846;3783000;0
5173;1957;734;0;0;0;0;.00nan;0;0
5173;199033;737;0;0;0;0;.00nan;0;0
5173;44526;734;86;34;3;31;.912;3783000;0
5174;841;764;77;43;4;39;.907;3600000;0
5174;-1;764;0;0;0;0;.00nan;0;0
5174;56565;745;63;31;3;28;.903;3600000;0
5174;75268;745;0;0;0;0;.00nan;0;0
5175;178098;738;53;28;4;24;.857;3516000;0
5175;67122;733;0;0;0;0;.00nan;0;0
5175;67362;733;85;32;2;30;.938;3600000;0
5175;93324;738;0;0;0;0;.00nan;0;0
5176;83;737;60;34;5;29;.853;3545000;0
5176;199033;737;0;0;0;0;.00nan;0;0
5176;175764;729;64;39;4;35;.897;3600000;0
5176;88646;729;0;0;0;0;.00nan;0;0
5177;1957;734;100;24;0;24;1.000;3600000;0
5177;180110;1880;0;0;0;0;.00nan;0;0
5177;44526;734;0;0;0;0;.00nan;0;0
5177;49815;1880;70;28;2;26;.929;3529000;0
5178;504;740;0;0;0;0;.00nan;0;0
5178;595;740;56;29;4;25;.862;3600000;0
5178;58037;3789;0;0;0;0;.00nan;0;0
5178;85797;3789;80;33;1;32;.970;3600000;0
5179;2195;748;91;32;1;31;.969;3600000;0
5179;52204;752;0;0;0;0;.00nan;0;0
5179;61272;752;64;30;3;27;.900;3600000;0
5179;66245;748;0;0;0;0;.00nan;0;0
5180;3756;744;95;20;0;20;1.000;3600000;0
5180;193790;744;0;0;0;0;.00nan;0;0
5180;196715;736;54;4;0;4;1.000;247000;0
5180;49900;736;57;29;4;25;.862;3353000;0
5181;2643;742;80;31;1;30;.968;3600000;0
5181;33044;739;0;0;0;0;.00nan;0;0
5181;-1;742;0;0;0;0;.00nan;0;0
5181;74734;739;65;25;2;23;.920;3590000;0
5182;848;743;89;52;4;48;.923;3600000;0
5182;8505;732;68;19;1;18;.947;3600000;0
5182;195867;732;0;0;0;0;.00nan;0;0
5182;91742;743;0;0;0;0;.00nan;0;0
5183;11716;751;0;0;0;0;.00nan;0;0
5183;85281;749;77;20;1;19;.950;3600000;0
5183;85661;749;0;0;0;0;.00nan;0;0
5183;148788;751;89;38;3;35;.921;3524000;0
5184;-1;747;0;0;0;0;.00nan;0;0
5184;-1;2168;59;5;0;5;1.000;595000;0
5184;49935;2168;41;38;6;32;.842;2969000;0
5184;76405;747;64;38;5;33;.868;3600000;0
5185;2195;748;87;36;2;34;.944;3808000;0
5185;56565;745;52;21;3;18;.857;3808000;0
5185;66245;748;0;0;0;0;.00nan;0;0
5185;75268;745;0;0;0;0;.00nan;0;0
5186;504;740;0;0;0;0;.00nan;0;0
5186;595;740;90;45;3;42;.933;3538000;0
5186;175764;729;0;0;0;0;.00nan;0;0
5186;88646;729;74;17;1;16;.941;3600000;0
5187;180110;1880;44;16;3;13;.813;3600000;0
5187;49815;1880;0;0;0;0;.00nan;0;0
5187;58037;3789;100;29;0;29;1.000;3600000;0
5187;85797;3789;0;0;0;0;.00nan;0;0
5188;1957;734;82;12;0;12;1.000;3600000;0
5188;44526;734;0;0;0;0;.00nan;0;0
5188;67122;733;0;0;0;0;.00nan;0;0
5188;67362;733;85;51;4;47;.922;3600000;0
5189;841;764;26;30;6;24;.800;3576000;0
5189;196698;741;0;0;0;0;.00nan;0;0
5189;46792;741;61;33;5;28;.848;3600000;0
5189;-1;764;0;0;0;0;.00nan;0;0
5190;3756;744;75;31;3;28;.903;3600000;0
5190;193790;744;0;0;0;0;.00nan;0;0
5190;33044;739;0;0;0;0;.00nan;0;0
5190;74734;739;34;35;6;29;.829;3600000;0
5191;83;737;93;42;2;40;.952;3600000;0
5191;199033;737;0;0;0;0;.00nan;0;0
5191;52204;752;89;46;3;43;.935;3571000;0
5191;61272;752;0;0;0;0;.00nan;0;0
5192;848;743;73;41;4;37;.902;3600000;0
5192;2643;742;46;19;3;16;.842;3600000;0
5192;-1;742;0;0;0;0;.00nan;0;0
5192;91742;743;0;0;0;0;.00nan;0;0
5193;11716;751;0;0;0;0;.00nan;0;0
5193;85281;749;0;0;0;0;.00nan;0;0
5193;85661;749;47;22;4;18;.818;3560000;0
5193;148788;751;64;29;3;26;.897;3600000;0
5194;8505;732;68;27;2;25;.926;3600000;0
5194;195867;732;0;0;0;0;.00nan;0;0
5194;196715;736;0;0;0;0;.00nan;0;0
5194;49900;736;74;49;4;45;.918;3516000;0
5195;-1;747;0;0;0;0;.00nan;0;0
5195;-1;2168;0;0;0;0;.00nan;0;0
5195;49935;2168;58;27;3;24;.889;3600000;0
5195;76405;747;100;39;0;39;1.000;3600000;0
5196;1957;734;86;42;3;39;.929;3561000;0
5196;175764;729;0;0;0;0;.00nan;0;0
5196;44526;734;0;0;0;0;.00nan;0;0
5196;88646;729;80;30;2;28;.933;3600000;0
5197;504;740;0;0;0;0;.00nan;0;0
5197;595;740;95;51;4;47;.922;3600000;0
5197;58037;3789;85;30;1;29;.967;3600000;0
5197;85797;3789;0;0;0;0;.00nan;0;0
5198;33044;739;0;0;0;0;.00nan;0;0
5198;196698;741;0;0;0;0;.00nan;0;0
5198;46792;741;72;26;2;24;.923;3600000;0
5198;74734;739;46;34;5;29;.853;3600000;0
5199;3756;744;54;23;3;20;.870;3600000;0
5199;193790;744;0;0;0;0;.00nan;0;0
5199;67122;733;0;0;0;0;.00nan;0;0
5199;67362;733;80;45;4;41;.911;3559000;0
5200;83;737;90;42;3;39;.929;3600000;0
5200;199033;737;0;0;0;0;.00nan;0;0
5200;178098;738;49;29;5;24;.828;3514000;0
5200;93324;738;0;0;0;0;.00nan;0;0
5201;-1;2168;0;0;0;0;.00nan;0;0
5201;49935;2168;83;49;4;45;.918;3600000;0
5201;85281;749;66;22;1;21;.955;3600000;0
5201;85661;749;0;0;0;0;.00nan;0;0
5202;848;743;67;33;3;30;.909;3600000;0
5202;52204;752;45;24;4;20;.833;3600000;0
5202;61272;752;0;0;0;0;.00nan;0;0
5202;91742;743;0;0;0;0;.00nan;0;0
5203;201075;736;0;0;0;0;.00nan;0;0
5203;180110;1880;0;0;0;0;.00nan;0;0
5203;49815;1880;73;19;1;18;.947;3900000;0
5203;49900;736;97;51;1;50;.980;3900000;0
5204;2643;742;67;16;2;14;.875;3600000;0
5204;-1;742;0;0;0;0;.00nan;0;0
5204;56565;745;84;49;4;45;.918;3521000;0
5204;75268;745;0;0;0;0;.00nan;0;0
5205;11716;751;0;0;0;0;.00nan;0;0
5205;-1;747;0;0;0;0;.00nan;0;0
5205;76405;747;51;19;2;17;.895;3600000;0
5205;148788;751;85;43;3;40;.930;3574000;0
5206;504;740;0;0;0;0;.00nan;0;0
5206;595;740;83;38;3;35;.921;3572000;0
5206;1957;734;0;0;0;0;.00nan;0;0
5206;44526;734;91;28;1;27;.964;3600000;0
5207;-1;2168;0;0;0;0;.00nan;0;0
5207;49935;2168;73;27;2;25;.926;3600000;0
5207;85281;749;0;0;0;0;.00nan;0;0
5207;85661;749;88;46;3;43;.935;3552000;0
5208;841;764;69;47;5;42;.894;3600000;0
5208;196698;741;0;0;0;0;.00nan;0;0
5208;46792;741;92;28;1;27;.964;3600000;0
5208;-1;764;0;0;0;0;.00nan;0;0
5209;178098;738;84;38;3;35;.921;3600000;0
5209;201075;736;0;0;0;0;.00nan;0;0
5209;49900;736;71;43;4;39;.907;3546000;0
5209;93324;738;0;0;0;0;.00nan;0;0
5210;2643;742;75;28;2;26;.929;3600000;0
5210;-1;742;0;0;0;0;.00nan;0;0
5210;58037;3789;0;0;0;0;.00nan;0;0
5210;85797;3789;56;32;4;28;.875;3583000;0
5211;83;737;53;27;4;23;.852;3600000;0
5211;199033;737;0;0;0;0;.00nan;0;0
5211;52204;752;63;42;5;37;.881;3576000;0
5211;61272;752;0;0;0;0;.00nan;0;0
5212;8505;732;58;17;2;15;.882;3600000;0
5212;195867;732;0;0;0;0;.00nan;0;0
5212;33044;739;18;24;6;18;.750;2157000;0
5212;74734;739;61;20;2;18;.900;1443000;0
5213;848;743;77;33;2;31;.939;3600000;0
5213;56565;745;24;27;6;21;.778;3107000;0
5213;75268;745;35;4;2;2;.500;493000;0
5213;91742;743;0;0;0;0;.00nan;0;0
5214;3756;744;78;33;2;31;.939;3600000;0
5214;193790;744;0;0;0;0;.00nan;0;0
5214;180110;1880;57;37;4;33;.892;3540000;0
5214;49815;1880;0;0;0;0;.00nan;0;0
5215;11716;751;0;0;0;0;.00nan;0;0
5215;-1;747;0;0;0;0;.00nan;0;0
5215;76405;747;91;33;1;32;.970;3900000;0
5215;148788;751;88;25;1;24;.960;3900000;0
5216;2195;748;40;29;5;24;.828;3600000;0
5216;196698;741;0;0;0;0;.00nan;0;0
5216;46792;741;85;26;1;25;.962;3600000;0
5216;66245;748;0;0;0;0;.00nan;0;0
5217;841;764;68;36;3;33;.917;3600000;0
5217;175764;729;0;0;0;0;.00nan;0;0
5217;-1;764;0;0;0;0;.00nan;0;0
5217;88646;729;75;26;2;24;.923;3600000;0
5218;2195;748;64;17;1;16;.941;3600000;0
5218;52204;752;46;35;5;30;.857;3600000;0
5218;61272;752;0;0;0;0;.00nan;0;0
5218;66245;748;0;0;0;0;.00nan;0;0
5219;83;737;59;29;4;25;.862;3600000;0
5219;199033;737;0;0;0;0;.00nan;0;0
5219;58037;3789;43;33;5;28;.848;3561000;0
5219;85797;3789;0;0;0;0;.00nan;0;0
5220;848;743;66;37;5;32;.865;3567000;0
5220;33044;739;0;0;0;0;.00nan;0;0
5220;74734;739;64;31;3;28;.903;3600000;0
5220;91742;743;0;0;0;0;.00nan;0;0
5221;504;740;80;38;2;36;.947;3600000;0
5221;595;740;0;0;0;0;.00nan;0;0
5221;3756;744;75;18;1;17;.944;3600000;0
5221;193790;744;0;0;0;0;.00nan;0;0
5222;56565;745;52;18;2;16;.889;3600000;0
5222;67122;733;0;0;0;0;.00nan;0;0
5222;67362;733;62;40;5;35;.875;3600000;0
5222;75268;745;0;0;0;0;.00nan;0;0
5223;8505;732;99;41;2;39;.951;3600000;0
5223;195867;732;0;0;0;0;.00nan;0;0
5223;180110;1880;0;0;0;0;.00nan;0;0
5223;49815;1880;82;37;3;34;.919;3600000;0
5224;175764;729;0;0;0;0;.00nan;0;0
5224;-1;2168;0;0;0;0;.00nan;0;0
5224;49935;2168;93;38;2;36;.947;3900000;0
5224;88646;729;92;45;2;43;.956;3900000;0
5225;83;737;72;40;4;36;.900;3600000;0
5225;199033;737;0;0;0;0;.00nan;0;0
5225;58037;3789;0;0;0;0;.00nan;0;0
5225;85797;3789;73;13;0;13;1.000;3600000;0
5226;201075;736;0;0;0;0;.00nan;0;0
5226;49900;736;76;45;5;40;.889;3584000;0
5226;85281;749;0;0;0;0;.00nan;0;0
5226;85661;749;59;26;3;23;.885;3600000;0
5227;2643;742;80;15;0;15;1.000;3600000;0
5227;178098;738;85;43;3;40;.930;3600000;0
5227;-1;742;0;0;0;0;.00nan;0;0
5227;93324;738;0;0;0;0;.00nan;0;0
5228;841;764;83;44;3;41;.932;3885000;0
5228;-1;747;0;0;0;0;.00nan;0;0
5228;-1;764;0;0;0;0;.00nan;0;0
5228;76405;747;85;33;2;31;.939;3885000;0
5229;196698;741;0;0;0;0;.00nan;0;0
5229;46792;741;94;38;2;36;.947;3600000;0
5229;56565;745;52;22;3;19;.864;3570000;0
5229;75268;745;0;0;0;0;.00nan;0;0
5230;848;743;77;43;5;38;.884;3558000;0
5230;1957;734;56;23;3;20;.870;3600000;0
5230;44526;734;0;0;0;0;.00nan;0;0
5230;91742;743;0;0;0;0;.00nan;0;0
5231;504;740;0;0;0;0;.00nan;0;0
5231;595;740;69;32;3;29;.906;3600000;0
5231;8505;732;63;37;4;33;.892;3547000;0
5231;195867;732;0;0;0;0;.00nan;0;0
5232;11716;751;0;0;0;0;.00nan;0;0
5232;52204;752;48;41;7;34;.829;3600000;0
5232;61272;752;0;0;0;0;.00nan;0;0
5232;148788;751;99;35;1;34;.971;3600000;0
5233;2195;748;58;34;4;30;.882;3600000;0
5233;175764;729;0;0;0;0;.00nan;0;0
5233;66245;748;0;0;0;0;.00nan;0;0
5233;88646;729;78;28;2;26;.929;3600000;0
5234;33044;739;0;0;0;0;.00nan;0;0
5234;74734;739;72;31;3;28;.903;3900000;0
5234;85281;749;0;0;0;0;.00nan;0;0
5234;85661;749;78;35;3;32;.914;3900000;0
5235;3756;744;76;27;2;25;.926;3600000;0
5235;193790;744;0;0;0;0;.00nan;0;0
5235;-1;747;0;0;0;0;.00nan;0;0
5235;76405;747;63;40;5;35;.875;3600000;0
5236;83;737;39;27;5;22;.815;3516000;0
5236;199033;737;0;0;0;0;.00nan;0;0
5236;201075;736;0;0;0;0;.00nan;0;0
5236;49900;736;80;41;3;38;.927;3600000;0
5237;2643;742;94;26;0;26;1.000;3600000;0
5237;180110;1880;91;36;2;34;.944;3561000;0
5237;-1;742;0;0;0;0;.00nan;0;0
5237;49815;1880;0;0;0;0;.00nan;0;0
5238;841;764;64;47;5;42;.894;3588000;0
5238;178098;738;55;23;3;20;.870;3600000;0
5238;-1;764;0;0;0;0;.00nan;0;0
5238;93324;738;0;0;0;0;.00nan;0;0
5239;1957;734;0;0;0;0;.00nan;0;0
5239;44526;734;100;32;0;32;1.000;3600000;0
5239;58037;3789;0;0;0;0;.00nan;0;0
5239;85797;3789;95;37;1;36;.973;3570000;0
5240;8505;732;31;9;3;6;.667;412000;0
5240;195867;732;80;29;1;28;.966;3188000;0
5240;196698;741;62;16;1;15;.938;3600000;0
5240;46792;741;0;0;0;0;.00nan;0;0
5241;180110;1880;0;0;0;0;.00nan;0;0
5241;49815;1880;85;42;3;39;.929;3600000;0
5241;56565;745;100;19;0;19;1.000;3600000;0
5241;75268;745;0;0;0;0;.00nan;0;0
5242;33044;739;0;0;0;0;.00nan;0;0
5242;-1;2168;55;16;2;14;.875;1923000;0
5242;49935;2168;18;20;6;14;.700;1677000;0
5242;74734;739;74;28;2;26;.929;3600000;0
5243;3756;744;46;21;4;17;.810;3534000;0
5243;193790;744;0;0;0;0;.00nan;0;0
5243;178098;738;94;43;2;41;.953;3600000;0
5243;93324;738;0;0;0;0;.00nan;0;0
5244;504;740;0;0;0;0;.00nan;0;0
5244;595;740;67;36;3;33;.917;3515000;0
5244;175764;729;0;0;0;0;.00nan;0;0
5244;88646;729;80;24;1;23;.958;3600000;0
5245;848;743;91;31;1;30;.968;3600000;0
5245;-1;747;0;0;0;0;.00nan;0;0
5245;76405;747;67;25;3;22;.880;3588000;0
5245;91742;743;0;0;0;0;.00nan;0;0
5246;52204;752;85;22;1;21;.955;3600000;0
5246;61272;752;0;0;0;0;.00nan;0;0
5246;85281;749;0;0;0;0;.00nan;0;0
5246;85661;749;73;33;3;30;.909;3578000;0
5247;841;764;100;30;0;30;1.000;3600000;0
5247;2195;748;0;0;0;0;.00nan;0;0
5247;-1;764;0;0;0;0;.00nan;0;0
5247;66245;748;91;51;4;47;.922;3600000;0
5248;196698;741;0;0;0;0;.00nan;0;0
5248;46792;741;82;27;1;26;.963;3600000;0
5248;67122;733;0;0;0;0;.00nan;0;0
5248;67362;733;70;38;3;35;.921;3538000;0
5249;201075;736;0;0;0;0;.00nan;0;0
5249;49900;736;66;32;3;29;.906;3582000;0
5249;58037;3789;0;0;0;0;.00nan;0;0
5249;85797;3789;67;27;2;25;.926;3600000;0
5250;2643;742;71;40;4;36;.900;3565000;0
5250;11716;751;0;0;0;0;.00nan;0;0
5250;-1;742;0;0;0;0;.00nan;0;0
5250;148788;751;63;26;3;23;.885;3600000;0
5251;178098;738;0;0;0;0;.00nan;0;0
5251;-1;2168;0;0;0;0;.00nan;0;0
5251;49935;2168;78;40;3;37;.925;3600000;0
5251;93324;738;72;26;2;24;.923;3600000;0
5252;1957;734;0;0;0;0;.00nan;0;0
5252;180110;1880;63;31;4;27;.871;3900000;0
5252;44526;734;55;29;4;25;.862;3900000;0
5252;49815;1880;0;0;0;0;.00nan;0;0
5253;175764;729;53;23;3;20;.870;3600000;0
5253;58037;3789;0;0;0;0;.00nan;0;0
5253;85797;3789;65;41;4;37;.902;3580000;0
5253;88646;729;0;0;0;0;.00nan;0;0
5254;52204;752;66;37;4;33;.892;3552000;0
5254;61272;752;0;0;0;0;.00nan;0;0
5254;85281;749;63;30;3;27;.900;3600000;0
5254;85661;749;0;0;0;0;.00nan;0;0
5255;33044;739;0;0;0;0;.00nan;0;0
5255;67122;733;0;0;0;0;.00nan;0;0
5255;67362;733;67;41;5;36;.878;3559000;0
5255;74734;739;61;34;4;30;.882;3600000;0
5256;504;740;0;0;0;0;.00nan;0;0
5256;595;740;66;44;5;39;.886;3600000;0
5256;848;743;76;22;1;21;.955;3600000;0
5256;91742;743;0;0;0;0;.00nan;0;0
5257;2195;748;65;25;3;22;.880;3546000;0
5257;201075;736;0;0;0;0;.00nan;0;0
5257;49900;736;80;25;1;24;.960;3600000;0
5257;66245;748;0;0;0;0;.00nan;0;0
5258;8505;732;65;22;2;20;.909;3600000;0
5258;11716;751;0;0;0;0;.00nan;0;0
5258;195867;732;0;0;0;0;.00nan;0;0
5258;148788;751;80;44;4;40;.909;3563000;0
5259;3756;744;60;31;3;28;.903;3552000;0
5259;193790;744;0;0;0;0;.00nan;0;0
5259;-1;747;66;27;2;25;.926;3600000;0
5259;76405;747;0;0;0;0;.00nan;0;0
5260;841;764;87;33;1;32;.970;3600000;0
5260;-1;764;0;0;0;0;.00nan;0;0
5260;56565;745;87;43;3;40;.930;3560000;0
5260;75268;745;0;0;0;0;.00nan;0;0
5261;83;737;80;32;2;30;.938;3567000;0
5261;1957;734;0;0;0;0;.00nan;0;0
5261;199033;737;0;0;0;0;.00nan;0;0
5261;44526;734;98;31;1;30;.968;3600000;0
5262;-1;2168;0;0;0;0;.00nan;0;0
5262;49935;2168;85;28;1;27;.964;3600000;0
5262;56565;745;81;32;2;30;.938;3556000;0
5262;75268;745;0;0;0;0;.00nan;0;0
5263;11716;751;0;0;0;0;.00nan;0;0
5263;178098;738;90;33;1;32;.970;3600000;0
5263;93324;738;0;0;0;0;.00nan;0;0
5263;148788;751;87;39;3;36;.923;3600000;0
5264;52204;752;100;27;0;27;1.000;3600000;0
5264;61272;752;0;0;0;0;.00nan;0;0
5264;85281;749;46;33;5;28;.848;3600000;0
5264;85661;749;0;0;0;0;.00nan;0;0
5265;2195;748;57;35;5;30;.857;3514000;0
5265;196698;741;0;0;0;0;.00nan;0;0
5265;46792;741;52;25;3;22;.880;3600000;0
5265;66245;748;0;0;0;0;.00nan;0;0
5266;33044;739;0;0;0;0;.00nan;0;0
5266;58037;3789;0;0;0;0;.00nan;0;0
5266;74734;739;61;26;2;24;.923;3600000;0
5266;85797;3789;89;32;1;31;.969;3600000;0
5267;848;743;86;31;1;30;.968;3600000;0
5267;2643;742;88;17;0;17;1.000;3600000;0
5267;-1;742;0;0;0;0;.00nan;0;0
5267;91742;743;0;0;0;0;.00nan;0;0
5268;201075;736;46;7;1;6;.857;573000;0
5268;175764;729;0;0;0;0;.00nan;0;0
5268;49900;736;32;29;6;23;.793;3027000;0
5268;88646;729;43;24;4;20;.833;3600000;0
5269;8505;732;59;18;2;16;.889;3600000;0
5269;195867;732;0;0;0;0;.00nan;0;0
5269;67122;733;0;0;0;0;.00nan;0;0
5269;67362;733;72;55;7;48;.873;3600000;0
5270;3756;744;25;22;6;16;.727;3137000;0
5270;193790;744;46;5;1;4;.800;463000;0
5270;-1;747;0;0;0;0;.00nan;0;0
5270;76405;747;100;31;0;31;1.000;3600000;0
5271;504;740;0;0;0;0;.00nan;0;0
5271;595;740;97;44;1;43;.977;3900000;0
5271;841;764;87;31;1;30;.968;3900000;0
5271;-1;764;0;0;0;0;.00nan;0;0
5272;1957;734;0;0;0;0;.00nan;0;0
5272;180110;1880;0;0;0;0;.00nan;0;0
5272;44526;734;100;41;1;40;.976;3600000;0
5272;49815;1880;50;23;3;20;.870;3540000;0
5273;2643;742;57;21;2;19;.905;3600000;0
5273;-1;742;0;0;0;0;.00nan;0;0
5273;-1;2168;0;0;0;0;.00nan;0;0
5273;49935;2168;60;27;3;24;.889;3568000;0
5274;2195;748;0;0;0;0;.00nan;0;0
5274;56565;745;77;25;1;24;.960;3600000;0
5274;66245;748;70;25;2;23;.920;3541000;0
5274;75268;745;0;0;0;0;.00nan;0;0
5275;178098;738;90;23;1;22;.957;3600000;0
5275;175764;729;0;0;0;0;.00nan;0;0
5275;88646;729;55;37;5;32;.865;3600000;0
5275;93324;738;0;0;0;0;.00nan;0;0
5276;11716;751;0;0;0;0;.00nan;0;0
5276;58037;3789;90;34;1;33;.971;3600000;0
5276;85797;3789;0;0;0;0;.00nan;0;0
5276;148788;751;63;23;2;21;.913;3600000;0
5277;3756;744;67;24;2;22;.917;3600000;0
5277;193790;744;0;0;0;0;.00nan;0;0
5277;85281;749;90;29;1;28;.966;3600000;0
5277;85661;749;0;0;0;0;.00nan;0;0
5278;848;743;64;39;4;35;.897;3900000;0
5278;196698;741;0;0;0;0;.00nan;0;0
5278;46792;741;68;37;4;33;.892;3900000;0
5278;91742;743;0;0;0;0;.00nan;0;0
5279;83;737;98;25;0;25;1.000;3600000;0
5279;199033;737;0;0;0;0;.00nan;0;0
5279;67122;733;34;34;6;28;.824;2949000;0
5279;67362;733;58;8;0;8;1.000;651000;0
5280;-1;747;0;0;0;0;.00nan;0;0
5280;52204;752;96;40;1;39;.975;3900000;0
5280;61272;752;0;0;0;0;.00nan;0;0
5280;76405;747;100;34;1;33;.971;3900000;0
5281;1957;734;89;39;3;36;.923;3600000;0
5281;8505;732;93;31;2;29;.935;3600000;0
5281;195867;732;0;0;0;0;.00nan;0;0
5281;44526;734;0;0;0;0;.00nan;0;0
5282;3756;744;100;22;0;22;1.000;3600000;0
5282;193790;744;0;0;0;0;.00nan;0;0
5282;85281;749;75;29;2;27;.931;3582000;0
5282;85661;749;0;0;0;0;.00nan;0;0
5283;201075;736;0;0;0;0;.00nan;0;0
5283;33044;739;0;0;0;0;.00nan;0;0
5283;49900;736;92;23;0;23;1.000;3600000;0
5283;74734;739;56;31;4;27;.871;3600000;0
5284;83;737;94;24;0;24;1.000;3600000;0
5284;199033;737;0;0;0;0;.00nan;0;0
5284;67122;733;58;8;0;8;1.000;452000;0
5284;67362;733;43;39;6;33;.846;3148000;0
5285;504;740;0;0;0;0;.00nan;0;0
5285;595;740;82;44;4;40;.909;3600000;0
5285;180110;1880;84;17;0;17;1.000;3600000;0
5285;49815;1880;0;0;0;0;.00nan;0;0
5286;-1;747;70;40;4;36;.900;3900000;0
5286;52204;752;0;0;0;0;.00nan;0;0
5286;61272;752;76;43;4;39;.907;3900000;0
5286;76405;747;0;0;0;0;.00nan;0;0
5287;848;743;95;40;2;38;.950;3600000;0
5287;196698;741;0;0;0;0;.00nan;0;0
5287;46792;741;54;22;3;19;.864;3588000;0
5287;91742;743;0;0;0;0;.00nan;0;0
5288;11716;751;44;25;4;21;.840;3600000;0
5288;56565;745;100;29;0;29;1.000;3600000;0
5288;75268;745;0;0;0;0;.00nan;0;0
5288;148788;751;0;0;0;0;.00nan;0;0
5289;2195;748;0;0;0;0;.00nan;0;0
5289;-1;2168;0;0;0;0;.00nan;0;0
5289;49935;2168;97;45;3;42;.933;3900000;0
5289;66245;748;61;27;3;24;.889;3900000;0
5290;504;740;0;0;0;0;.00nan;0;0
5290;595;740;89;61;4;57;.934;3600000;0
5290;175764;729;0;0;0;0;.00nan;0;0
5290;88646;729;67;17;1;16;.941;3600000;0
5291;83;737;26;13;4;9;.692;1000000;0
5291;199033;737;58;19;2;17;.895;2600000;0
5291;8505;732;64;21;2;19;.905;3600000;0
5291;195867;732;0;0;0;0;.00nan;0;0
5292;58037;3789;0;0;0;0;.00nan;0;0
5292;67122;733;0;0;0;0;.00nan;0;0
5292;67362;733;96;32;1;31;.969;3900000;0
5292;85797;3789;80;26;1;25;.962;3900000;0
5293;33044;739;0;0;0;0;.00nan;0;0
5293;180110;1880;28;13;4;9;.692;1154000;0
5293;49815;1880;54;21;2;19;.905;2419000;0
5293;74734;739;62;40;5;35;.875;3600000;0
5294;841;764;100;45;1;44;.978;3600000;0
5294;2643;742;73;26;2;24;.923;3556000;0
5294;-1;764;0;0;0;0;.00nan;0;0
5294;-1;742;0;0;0;0;.00nan;0;0
5295;196698;741;0;0;0;0;.00nan;0;0
5295;46792;741;55;32;4;28;.875;3600000;0
5295;52204;752;77;28;1;27;.964;3600000;0
5295;61272;752;0;0;0;0;.00nan;0;0
5296;178098;738;58;22;3;19;.864;3554000;0
5296;58037;3789;0;0;0;0;.00nan;0;0
5296;85797;3789;88;32;1;31;.969;3600000;0
5296;93324;738;0;0;0;0;.00nan;0;0
5297;201075;736;0;0;0;0;.00nan;0;0
5297;175764;729;0;0;0;0;.00nan;0;0
5297;49900;736;64;35;4;31;.886;3578000;0
5297;88646;729;54;20;2;18;.900;3600000;0
5298;83;737;67;31;3;28;.903;3900000;0
5298;199033;737;0;0;0;0;.00nan;0;0
5298;-1;747;0;0;0;0;.00nan;0;0
5298;76405;747;75;34;3;31;.912;3900000;0
5299;3756;744;60;29;3;26;.897;3592000;0
5299;193790;744;0;0;0;0;.00nan;0;0
5299;-1;2168;0;0;0;0;.00nan;0;0
5299;49935;2168;67;17;1;16;.941;3600000;0
5300;504;740;62;32;4;28;.875;3600000;0
5300;595;740;0;0;0;0;.00nan;0;0
5300;1957;734;0;0;0;0;.00nan;0;0
5300;44526;734;89;29;1;28;.966;3600000;0
5301;11716;751;0;0;0;0;.00nan;0;0
5301;85281;749;0;0;0;0;.00nan;0;0
5301;85661;749;93;32;1;31;.969;3600000;0
5301;148788;751;87;35;2;33;.943;3600000;0
5302;841;764;56;42;5;37;.881;3600000;0
5302;180110;1880;0;0;0;0;.00nan;0;0
5302;-1;764;0;0;0;0;.00nan;0;0
5302;49815;1880;78;23;1;22;.957;3600000;0
5303;8505;732;70;34;3;31;.912;3900000;0
5303;195867;732;0;0;0;0;.00nan;0;0
5303;33044;739;93;55;3;52;.945;3900000;0
5303;74734;739;0;0;0;0;.00nan;0;0
5304;2643;742;74;26;2;24;.923;3900000;0
5304;-1;742;0;0;0;0;.00nan;0;0
5304;56565;745;92;36;2;34;.944;3900000;0
5304;75268;745;0;0;0;0;.00nan;0;0
5305;2195;748;100;39;1;38;.974;3600000;0
5305;66245;748;0;0;0;0;.00nan;0;0
5305;85281;749;0;0;0;0;.00nan;0;0
5305;85661;749;55;33;4;29;.879;3600000;0
5306;841;764;59;31;4;27;.871;3774000;0
5306;175764;729;0;0;0;0;.00nan;0;0
5306;-1;764;0;0;0;0;.00nan;0;0
5306;88646;729;77;35;3;32;.914;3774000;0
5307;-1;747;0;0;0;0;.00nan;0;0
5307;58037;3789;0;0;0;0;.00nan;0;0
5307;76405;747;58;29;3;26;.897;3600000;0
5307;85797;3789;100;30;0;30;1.000;3600000;0
5308;1957;734;0;0;0;0;.00nan;0;0
5308;33044;739;40;27;5;22;.815;3600000;0
5308;44526;734;86;26;1;25;.962;3600000;0
5308;74734;739;0;0;0;0;.00nan;0;0
5309;504;740;0;0;0;0;.00nan;0;0
5309;595;740;90;29;2;27;.931;3600000;0
5309;178098;738;0;0;0;0;.00nan;0;0
5309;93324;738;63;31;3;28;.903;3567000;0
5310;201075;736;0;0;0;0;.00nan;0;0
5310;49900;736;67;25;2;23;.920;3600000;0
5310;52204;752;27;32;6;26;.813;3600000;0
5310;61272;752;0;0;0;0;.00nan;0;0
5311;180110;1880;67;34;3;31;.912;3576000;0
5311;-1;2168;0;0;0;0;.00nan;0;0
5311;49815;1880;0;0;0;0;.00nan;0;0
5311;49935;2168;84;32;2;30;.938;3600000;0
5312;83;737;76;24;1;23;.958;3600000;0
5312;199033;737;0;0;0;0;.00nan;0;0
5312;8505;732;0;0;0;0;.00nan;0;0
5312;195867;732;62;26;2;24;.923;3600000;0
5313;11716;751;0;0;0;0;.00nan;0;0
5313;56565;745;68;32;3;29;.906;3538000;0
5313;75268;745;0;0;0;0;.00nan;0;0
5313;148788;751;91;24;1;23;.958;3600000;0
5314;848;743;86;36;2;34;.944;3900000;0
5314;196698;741;0;0;0;0;.00nan;0;0
5314;46792;741;80;33;2;31;.939;3900000;0
5314;91742;743;0;0;0;0;.00nan;0;0
5315;504;740;90;38;2;36;.947;3600000;0
5315;595;740;0;0;0;0;.00nan;0;0
5315;2643;742;53;24;3;21;.875;3545000;0
5315;-1;742;0;0;0;0;.00nan;0;0
5316;8505;732;76;31;2;29;.935;3551000;0
5316;195867;732;0;0;0;0;.00nan;0;0
5316;67122;733;0;0;0;0;.00nan;0;0
5316;67362;733;96;33;1;32;.970;3600000;0
5317;201075;736;0;0;0;0;.00nan;0;0
5317;-1;2168;0;0;0;0;.00nan;0;0
5317;49900;736;51;35;5;30;.857;3600000;0
5317;49935;2168;99;21;0;21;1.000;3600000;0
5318;2195;748;0;0;0;0;.00nan;0;0
5318;66245;748;98;38;1;37;.974;3600000;0
5318;85281;749;0;0;0;0;.00nan;0;0
5318;85661;749;80;32;2;30;.938;3570000;0
5319;178098;738;0;0;0;0;.00nan;0;0
5319;58037;3789;0;0;0;0;.00nan;0;0
5319;85797;3789;72;39;4;35;.897;3895000;0
5319;93324;738;69;30;3;27;.900;3895000;0
5320;841;764;53;38;5;33;.868;3600000;0
5320;1957;734;0;0;0;0;.00nan;0;0
5320;44526;734;77;25;1;24;.960;3600000;0
5320;-1;764;0;0;0;0;.00nan;0;0
5321;3756;744;0;0;0;0;.00nan;0;0
5321;193790;744;85;39;3;36;.923;3600000;0
5321;-1;747;0;0;0;0;.00nan;0;0
5321;76405;747;100;18;0;18;1.000;3600000;0
5322;175764;729;0;0;0;0;.00nan;0;0
5322;52204;752;83;28;1;27;.964;3600000;0
5322;61272;752;0;0;0;0;.00nan;0;0
5322;88646;729;81;31;2;29;.935;3580000;0
5323;11716;751;0;0;0;0;.00nan;0;0
5323;33044;739;0;0;0;0;.00nan;0;0
5323;74734;739;62;28;3;25;.893;3600000;0
5323;148788;751;100;53;2;51;.962;3600000;0
5324;2643;742;88;19;0;19;1.000;3600000;0
5324;-1;742;0;0;0;0;.00nan;0;0
5324;67122;733;0;0;0;0;.00nan;0;0
5324;67362;733;97;46;2;44;.957;3600000;0
5325;180110;1880;63;37;4;33;.892;3900000;0
5325;-1;2168;0;0;0;0;.00nan;0;0
5325;49815;1880;0;0;0;0;.00nan;0;0
5325;49935;2168;69;36;4;32;.889;3900000;0
5326;2195;748;79;27;1;26;.963;3900000;0
5326;201075;736;0;0;0;0;.00nan;0;0
5326;49900;736;97;44;1;43;.977;3900000;0
5326;66245;748;0;0;0;0;.00nan;0;0
5327;175764;729;0;0;0;0;.00nan;0;0
5327;58037;3789;0;0;0;0;.00nan;0;0
5327;85797;3789;69;34;3;31;.912;3600000;0
5327;88646;729;52;34;4;30;.882;3600000;0
5328;196698;741;0;0;0;0;.00nan;0;0
5328;46792;741;91;39;2;37;.949;3600000;0
5328;85281;749;78;46;5;41;.891;3600000;0
5328;85661;749;0;0;0;0;.00nan;0;0
5329;-1;747;0;0;0;0;.00nan;0;0
5329;33044;739;0;0;0;0;.00nan;0;0
5329;74734;739;59;27;3;24;.889;3600000;0
5329;76405;747;54;35;4;31;.886;3565000;0
5330;2643;742;52;29;4;25;.862;3600000;0
5330;-1;742;0;0;0;0;.00nan;0;0
5330;56565;745;100;45;2;43;.956;3600000;0
5330;75268;745;0;0;0;0;.00nan;0;0
5331;8505;732;73;27;2;25;.926;3900000;0
5331;178098;738;78;35;2;33;.943;3900000;0
5331;195867;732;0;0;0;0;.00nan;0;0
5331;93324;738;0;0;0;0;.00nan;0;0
5332;504;740;0;0;0;0;.00nan;0;0
5332;595;740;96;51;2;49;.961;3900000;0
5332;67122;733;0;0;0;0;.00nan;0;0
5332;67362;733;99;40;2;38;.950;3900000;0
5333;848;743;41;35;6;29;.829;3600000;0
5333;11716;751;0;0;0;0;.00nan;0;0
5333;91742;743;0;0;0;0;.00nan;0;0
5333;148788;751;44;27;5;22;.815;3600000;0
5334;2195;748;0;0;0;0;.00nan;0;0
5334;180110;1880;94;31;1;30;.968;3600000;0
5334;49815;1880;0;0;0;0;.00nan;0;0
5334;66245;748;60;25;3;22;.880;3514000;0
5335;178098;738;0;0;0;0;.00nan;0;0
5335;33044;739;0;0;0;0;.00nan;0;0
5335;74734;739;100;24;0;24;1.000;3600000;0
5335;93324;738;94;43;2;41;.953;3577000;0
5336;52204;752;62;29;3;26;.897;3592000;0
5336;56565;745;57;23;2;21;.913;3600000;0
5336;61272;752;0;0;0;0;.00nan;0;0
5336;75268;745;0;0;0;0;.00nan;0;0
5337;11716;751;0;0;0;0;.00nan;0;0
5337;-1;2168;0;0;0;0;.00nan;0;0
5337;49935;2168;66;17;1;16;.941;3600000;0
5337;148788;751;61;47;5;42;.894;3600000;0
5338;178098;738;100;34;0;34;1.000;3600000;0
5338;58037;3789;0;0;0;0;.00nan;0;0
5338;85797;3789;84;34;2;32;.941;3548000;0
5338;93324;738;0;0;0;0;.00nan;0;0
5339;1957;734;0;0;0;0;.00nan;0;0
5339;3756;744;59;40;5;35;.875;3600000;0
5339;193790;744;0;0;0;0;.00nan;0;0
5339;44526;734;100;42;0;42;1.000;3600000;0
5340;504;740;0;0;0;0;.00nan;0;0
5340;595;740;73;31;3;28;.903;3600000;0
5340;848;743;100;23;0;23;1.000;3600000;0
5340;91742;743;0;0;0;0;.00nan;0;0
5341;201075;736;69;27;2;25;.926;3600000;0
5341;49900;736;0;0;0;0;.00nan;0;0
5341;67122;733;51;17;2;15;.882;1519000;0
5341;67362;733;39;30;6;24;.800;2081000;0
5342;8505;732;79;30;2;28;.933;3600000;0
5342;175764;729;0;0;0;0;.00nan;0;0
5342;195867;732;0;0;0;0;.00nan;0;0
5342;88646;729;71;43;4;39;.907;3600000;0
5343;33044;739;0;0;0;0;.00nan;0;0
5343;180110;1880;70;33;3;30;.909;3600000;0
5343;49815;1880;0;0;0;0;.00nan;0;0
5343;74734;739;54;40;6;34;.850;3600000;0
5344;848;743;91;43;4;39;.907;3600000;0
5344;56565;745;37;29;5;24;.828;3563000;0
5344;75268;745;0;0;0;0;.00nan;0;0
5344;91742;743;0;0;0;0;.00nan;0;0
5345;2643;742;57;24;3;21;.875;3600000;0
5345;-1;742;0;0;0;0;.00nan;0;0
5345;85281;749;0;0;0;0;.00nan;0;0
5345;85661;749;97;48;4;44;.917;3546000;0
5346;83;737;0;0;0;0;.00nan;0;0
5346;199033;737;62;22;2;20;.909;3600000;0
5346;175764;729;0;0;0;0;.00nan;0;0
5346;88646;729;66;25;3;22;.880;3555000;0
5347;-1;2168;0;0;0;0;.00nan;0;0
5347;49935;2168;40;37;6;31;.838;3600000;0
5347;52204;752;69;33;3;30;.909;3600000;0
5347;61272;752;0;0;0;0;.00nan;0;0
5348;201075;736;0;0;0;0;.00nan;0;0
5348;196698;741;0;0;0;0;.00nan;0;0
5348;46792;741;100;29;0;29;1.000;3600000;0
5348;49900;736;69;30;3;27;.900;3600000;0
5349;8505;732;63;23;3;20;.870;3600000;0
5349;195867;732;0;0;0;0;.00nan;0;0
5349;58037;3789;0;0;0;0;.00nan;0;0
5349;85797;3789;31;41;8;33;.805;3600000;0
5350;2195;748;84;52;5;47;.904;3600000;0
5350;-1;747;0;0;0;0;.00nan;0;0
5350;66245;748;0;0;0;0;.00nan;0;0
5350;76405;747;58;20;3;17;.850;3600000;0
5351;841;764;86;36;2;34;.944;3600000;0
5351;1957;734;87;25;1;24;.960;2867000;0
5351;44526;734;16;6;4;2;.333;733000;0
5351;-1;764;0;0;0;0;.00nan;0;0
5352;178098;738;42;31;5;26;.839;3600000;0
5352;180110;1880;100;40;1;39;.975;3600000;0
5352;49815;1880;0;0;0;0;.00nan;0;0
5352;93324;738;0;0;0;0;.00nan;0;0
5353;2643;742;77;33;3;30;.909;3600000;0
5353;-1;742;0;0;0;0;.00nan;0;0
5353;85281;749;69;44;4;40;.909;3561000;0
5353;85661;749;0;0;0;0;.00nan;0;0
5354;504;740;0;0;0;0;.00nan;0;0
5354;595;740;93;31;2;29;.935;3600000;0
5354;67122;733;0;0;0;0;.00nan;0;0
5354;67362;733;73;30;3;27;.900;3560000;0
5355;2195;748;0;0;0;0;.00nan;0;0
5355;-1;747;72;35;3;32;.914;3543000;0
5355;66245;748;95;39;1;38;.974;3600000;0
5355;76405;747;0;0;0;0;.00nan;0;0
5356;3756;744;44;19;3;16;.842;3513000;0
5356;193790;744;0;0;0;0;.00nan;0;0
5356;56565;745;98;39;1;38;.974;3600000;0
5356;75268;745;0;0;0;0;.00nan;0;0
5357;1957;734;43;26;4;22;.846;3550000;0
5357;44526;734;0;0;0;0;.00nan;0;0
5357;58037;3789;0;0;0;0;.00nan;0;0
5357;85797;3789;69;31;3;28;.903;3600000;0
5358;83;737;82;27;1;26;.963;3600000;0
5358;199033;737;0;0;0;0;.00nan;0;0
5358;196698;741;0;0;0;0;.00nan;0;0
5358;46792;741;70;27;2;25;.926;3585000;0
5359;175764;729;0;0;0;0;.00nan;0;0
5359;33044;739;0;0;0;0;.00nan;0;0
5359;74734;739;60;34;4;30;.882;3584000;0
5359;88646;729;66;34;3;31;.912;3600000;0
5360;848;743;58;22;2;20;.909;3600000;0
5360;11716;751;0;0;0;0;.00nan;0;0
5360;91742;743;0;0;0;0;.00nan;0;0
5360;148788;751;55;28;3;25;.893;3576000;0
5361;201075;736;0;0;0;0;.00nan;0;0
5361;49900;736;92;27;1;26;.963;3600000;0
5361;52204;752;82;31;2;29;.935;3571000;0
5361;61272;752;0;0;0;0;.00nan;0;0
5362;841;764;95;35;1;34;.971;3600000;0
5362;-1;764;0;0;0;0;.00nan;0;0
5362;-1;2168;0;0;0;0;.00nan;0;0
5362;49935;2168;50;27;4;23;.852;3600000;0
5363;2195;748;64;30;3;27;.900;3900000;0
5363;66245;748;0;0;0;0;.00nan;0;0
5363;85281;749;0;0;0;0;.00nan;0;0
5363;85661;749;75;31;3;28;.903;3900000;0
5364;504;740;0;0;0;0;.00nan;0;0
5364;595;740;85;32;2;30;.938;3600000;0
5364;67122;733;0;0;0;0;.00nan;0;0
5364;67362;733;47;29;5;24;.828;3600000;0
5365;2643;742;57;36;5;31;.861;3900000;0
5365;-1;747;0;0;0;0;.00nan;0;0
5365;-1;742;0;0;0;0;.00nan;0;0
5365;76405;747;64;46;5;41;.891;3900000;0
5366;3756;744;79;32;2;30;.938;3579000;0
5366;193790;744;0;0;0;0;.00nan;0;0
5366;-1;2168;0;0;0;0;.00nan;0;0
5366;49935;2168;78;28;1;27;.964;3600000;0
5367;1957;734;0;0;0;0;.00nan;0;0
5367;8505;732;88;20;0;20;1.000;3600000;0
5367;195867;732;0;0;0;0;.00nan;0;0
5367;44526;734;48;29;4;25;.862;3600000;0
5368;83;737;75;33;2;31;.939;3900000;0
5368;199033;737;0;0;0;0;.00nan;0;0
5368;58037;3789;0;0;0;0;.00nan;0;0
5368;85797;3789;95;37;2;35;.946;3900000;0
5369;33044;739;0;0;0;0;.00nan;0;0
5369;52204;752;89;41;3;38;.927;3600000;0
5369;61272;752;0;0;0;0;.00nan;0;0
5369;74734;739;100;32;0;32;1.000;3600000;0
5370;180110;1880;0;0;0;0;.00nan;0;0
5370;49815;1880;60;20;2;18;.900;3600000;0
5370;56565;745;97;54;3;51;.944;3600000;0
5370;75268;745;0;0;0;0;.00nan;0;0
5371;848;743;94;46;2;44;.957;3589000;0
5371;178098;738;91;37;1;36;.973;3600000;0
5371;91742;743;0;0;0;0;.00nan;0;0
5371;93324;738;0;0;0;0;.00nan;0;0
5372;2195;748;0;0;0;0;.00nan;0;0
5372;66245;748;60;33;4;29;.879;3568000;0
5372;85281;749;0;0;0;0;.00nan;0;0
5372;85661;749;61;25;3;22;.880;3600000;0
5373;504;740;0;0;0;0;.00nan;0;0
5373;595;740;90;40;2;38;.950;3653000;0
5373;201075;736;0;0;0;0;.00nan;0;0
5373;49900;736;67;29;3;26;.897;3653000;0
5374;2643;742;70;40;4;36;.900;3555000;0
5374;-1;747;0;0;0;0;.00nan;0;0
5374;-1;742;0;0;0;0;.00nan;0;0
5374;76405;747;63;25;3;22;.880;3600000;0
5375;841;764;79;35;2;33;.943;3561000;0
5375;-1;764;0;0;0;0;.00nan;0;0
5375;67122;733;0;0;0;0;.00nan;0;0
5375;67362;733;82;29;1;28;.966;3600000;0
5376;8505;732;64;45;5;40;.889;3570000;0
5376;175764;729;0;0;0;0;.00nan;0;0
5376;195867;732;0;0;0;0;.00nan;0;0
5376;88646;729;62;33;4;29;.879;3600000;0
5377;1957;734;0;0;0;0;.00nan;0;0
5377;44526;734;94;29;2;27;.931;3600000;0
5377;52204;752;29;32;6;26;.813;3600000;0
5377;61272;752;0;0;0;0;.00nan;0;0
5378;3756;744;77;20;1;19;.950;3900000;0
5378;193790;744;0;0;0;0;.00nan;0;0
5378;56565;745;95;44;1;43;.977;3900000;0
5378;75268;745;0;0;0;0;.00nan;0;0
5379;841;764;84;32;1;31;.969;3900000;0
5379;-1;764;0;0;0;0;.00nan;0;0
5379;-1;2168;0;0;0;0;.00nan;0;0
5379;49935;2168;87;33;1;32;.970;3900000;0
5380;848;743;70;30;3;27;.900;3600000;0
5380;58037;3789;0;0;0;0;.00nan;0;0
5380;85797;3789;48;29;4;25;.862;3598000;0
5380;91742;743;0;0;0;0;.00nan;0;0
5381;83;737;18;11;4;7;.636;833000;0
5381;199033;737;75;30;2;28;.933;2767000;0
5381;67122;733;0;0;0;0;.00nan;0;0
5381;67362;733;92;49;3;46;.939;3600000;0
5382;11716;751;0;0;0;0;.00nan;0;0
5382;196698;741;0;0;0;0;.00nan;0;0
5382;46792;741;77;25;2;23;.920;3515000;0
5382;148788;751;98;23;0;23;1.000;3600000;0
5383;178098;738;79;26;1;25;.962;3600000;0
5383;201075;736;0;0;0;0;.00nan;0;0
5383;49900;736;74;35;3;32;.914;3596000;0
5383;93324;738;0;0;0;0;.00nan;0;0
5384;504;740;0;0;0;0;.00nan;0;0
5384;595;740;76;43;5;38;.884;3600000;0
5384;180110;1880;77;19;1;18;.947;3600000;0
5384;49815;1880;0;0;0;0;.00nan;0;0
5385;33044;739;28;30;6;24;.800;3510000;0
5385;56565;745;53;31;5;26;.839;3600000;0
5385;74734;739;22;4;3;1;.250;90000;0
5385;75268;745;0;0;0;0;.00nan;0;0
5386;-1;747;0;0;0;0;.00nan;0;0
5386;52204;752;95;45;2;43;.956;3900000;0
5386;61272;752;0;0;0;0;.00nan;0;0
5386;76405;747;78;26;2;24;.923;3900000;0
5387;196698;741;0;0;0;0;.00nan;0;0
5387;46792;741;83;38;3;35;.921;3600000;0
5387;-1;2168;0;0;0;0;.00nan;0;0
5387;49935;2168;46;31;5;26;.839;3579000;0
5388;841;764;49;36;5;31;.861;3600000;0
5388;2195;748;84;41;3;38;.927;3600000;0
5388;-1;764;0;0;0;0;.00nan;0;0
5388;66245;748;0;0;0;0;.00nan;0;0
5389;11716;751;0;0;0;0;.00nan;0;0
5389;175764;729;0;0;0;0;.00nan;0;0
5389;88646;729;91;29;1;28;.966;3900000;0
5389;148788;751;100;40;1;39;.975;3900000;0
5390;1957;734;65;29;3;26;.897;3600000;0
5390;178098;738;0;0;0;0;.00nan;0;0
5390;44526;734;0;0;0;0;.00nan;0;0
5390;93324;738;100;37;0;37;1.000;3600000;0
5391;3756;744;98;37;1;36;.973;3600000;0
5391;193790;744;0;0;0;0;.00nan;0;0
5391;85281;749;0;0;0;0;.00nan;0;0
5391;85661;749;45;11;2;9;.818;3565000;0
5392;2643;742;59;29;4;25;.862;3600000;0
5392;8505;732;37;32;6;26;.813;3593000;0
5392;195867;732;0;0;0;0;.00nan;0;0
5392;-1;742;0;0;0;0;.00nan;0;0
5393;201075;736;0;0;0;0;.00nan;0;0
5393;49900;736;97;39;1;38;.974;3600000;0
5393;58037;3789;57;6;0;6;1.000;1230000;0
5393;85797;3789;24;14;4;10;.714;2370000;0
5394;848;743;0;0;0;0;.00nan;0;0
5394;33044;739;0;0;0;0;.00nan;0;0
5394;74734;739;97;40;2;38;.950;3555000;0
5394;91742;743;100;32;0;32;1.000;3600000;0
5395;83;737;67;32;3;29;.906;3600000;0
5395;199033;737;0;0;0;0;.00nan;0;0
5395;67122;733;0;0;0;0;.00nan;0;0
5395;67362;733;50;37;4;33;.892;3555000;0
5396;56565;745;100;42;1;41;.976;3900000;0
5396;75268;745;0;0;0;0;.00nan;0;0
5396;85281;749;0;0;0;0;.00nan;0;0
5396;85661;749;72;18;1;17;.944;3900000;0
5397;2195;748;86;41;3;38;.927;3600000;0
5397;196698;741;0;0;0;0;.00nan;0;0
5397;46792;741;44;28;5;23;.821;3546000;0
5397;66245;748;0;0;0;0;.00nan;0;0
5398;1957;734;76;36;3;33;.917;3621000;0
5398;-1;747;0;0;0;0;.00nan;0;0
5398;44526;734;0;0;0;0;.00nan;0;0
5398;76405;747;82;29;2;27;.931;3621000;0
5399;3756;744;95;41;2;39;.951;3596000;0
5399;8505;732;100;31;0;31;1.000;3600000;0
5399;193790;744;0;0;0;0;.00nan;0;0
5399;195867;732;0;0;0;0;.00nan;0;0
5400;504;740;62;42;5;37;.881;3517000;0
5400;595;740;0;0;0;0;.00nan;0;0
5400;175764;729;0;0;0;0;.00nan;0;0
5400;88646;729;65;25;3;22;.880;3600000;0
5401;11716;751;0;0;0;0;.00nan;0;0
5401;52204;752;100;31;0;31;1.000;3600000;0
5401;61272;752;0;0;0;0;.00nan;0;0
5401;148788;751;55;35;5;30;.857;3600000;0
5402;178098;738;0;0;0;0;.00nan;0;0
5402;180110;1880;73;28;2;26;.929;3600000;0
5402;49815;1880;0;0;0;0;.00nan;0;0
5402;93324;738;64;29;3;26;.897;3600000;0
5403;2643;742;100;50;3;47;.940;3600000;0
5403;-1;742;0;0;0;0;.00nan;0;0
5403;-1;2168;55;5;0;5;1.000;261000;0
5403;49935;2168;38;43;6;37;.860;3339000;0
5404;83;737;48;27;4;23;.852;3583000;0
5404;199033;737;0;0;0;0;.00nan;0;0
5404;201075;736;0;0;0;0;.00nan;0;0
5404;49900;736;67;32;3;29;.906;3600000;0
5405;848;743;0;0;0;0;.00nan;0;0
5405;67122;733;0;0;0;0;.00nan;0;0
5405;67362;733;88;38;2;36;.947;3580000;0
5405;91742;743;87;37;1;36;.973;3600000;0
5406;841;764;80;30;2;28;.933;3580000;0
5406;33044;739;0;0;0;0;.00nan;0;0
5406;-1;764;0;0;0;0;.00nan;0;0
5406;74734;739;83;26;1;25;.962;3600000;0
5407;-1;747;0;0;0;0;.00nan;0;0
5407;56565;745;98;41;1;40;.976;3550000;0
5407;75268;745;0;0;0;0;.00nan;0;0
5407;76405;747;100;24;0;24;1.000;3600000;0
5408;2195;748;52;22;3;19;.864;2932000;0
5408;11716;751;67;32;3;29;.906;3304000;0
5408;66245;748;20;10;4;6;.600;923000;0
5408;148788;751;34;12;3;9;.750;551000;0
5409;1957;734;89;42;3;39;.929;3900000;0
5409;175764;729;0;0;0;0;.00nan;0;0
5409;44526;734;0;0;0;0;.00nan;0;0
5409;88646;729;89;40;3;37;.925;3900000;0
5410;83;737;77;26;1;25;.962;3600000;0
5410;199033;737;0;0;0;0;.00nan;0;0
5410;8505;732;55;25;3;22;.880;3525000;0
5410;195867;732;0;0;0;0;.00nan;0;0
5411;3756;744;53;19;2;17;.895;3558000;0
5411;193790;744;0;0;0;0;.00nan;0;0
5411;-1;2168;0;0;0;0;.00nan;0;0
5411;49935;2168;100;44;1;43;.977;3600000;0
5412;504;740;0;0;0;0;.00nan;0;0
5412;595;740;74;29;2;27;.931;3900000;0
5412;196698;741;0;0;0;0;.00nan;0;0
5412;46792;741;80;35;2;33;.943;3900000;0
5413;178098;738;83;28;1;27;.964;3600000;0
5413;52204;752;79;38;3;35;.921;3600000;0
5413;61272;752;0;0;0;0;.00nan;0;0
5413;93324;738;0;0;0;0;.00nan;0;0
5414;180110;1880;64;32;4;28;.875;3600000;0
5414;49815;1880;0;0;0;0;.00nan;0;0
5414;58037;3789;0;0;0;0;.00nan;0;0
5414;85797;3789;47;43;6;37;.860;3563000;0
5415;2643;742;72;29;3;26;.897;3600000;0
5415;-1;742;0;0;0;0;.00nan;0;0
5415;85281;749;0;0;0;0;.00nan;0;0
5415;85661;749;52;32;4;28;.875;3518000;0
5417;187925;3789;98;45;1;44;.978;3107000;0
5417;-1;3789;25;7;3;4;.571;493000;0
5417;57107;747;0;0;0;0;.00nan;0;0
5417;76405;747;43;13;3;10;.769;3600000;0
5419;3756;752;70;26;2;24;.923;3711000;0
5419;178098;738;92;44;3;41;.932;3711000;0
5419;185442;738;0;0;0;0;.00nan;0;0
5419;61272;752;0;0;0;0;.00nan;0;0
5421;196698;741;0;0;0;0;.00nan;0;0
5421;46792;741;90;37;2;35;.946;3600000;0
5421;66245;748;68;32;3;29;.906;3564000;0
5421;67362;748;0;0;0;0;.00nan;0;0
5423;190570;1880;0;0;0;0;.00nan;0;0
5423;-1;751;0;0;0;0;.00nan;0;0
5423;-1;1880;61;17;2;15;.882;3900000;0
5423;148788;751;80;33;2;31;.939;3900000;0
5425;195867;2168;0;0;0;0;.00nan;0;0
5425;195887;764;60;41;5;36;.878;3600000;0
5425;-1;764;0;0;0;0;.00nan;0;0
5425;49935;2168;84;30;1;29;.967;3600000;0
5427;201075;736;77;37;3;34;.919;3547000;0
5427;196715;736;0;0;0;0;.00nan;0;0
5427;49900;744;93;31;1;30;.968;3600000;0
5427;52204;744;0;0;0;0;.00nan;0;0
5429;83;737;62;21;2;19;.905;3600000;0
5429;199033;737;0;0;0;0;.00nan;0;0
5429;175764;729;0;0;0;0;.00nan;0;0
5429;88646;729;96;25;0;25;1.000;3600000;0
5431;1957;733;67;36;3;33;.917;3600000;0
5431;188561;739;0;0;0;0;.00nan;0;0
5431;33044;739;74;28;2;26;.929;3600000;0
5431;67287;733;0;0;0;0;.00nan;0;0
5433;504;740;0;0;0;0;.00nan;0;0
5433;595;740;98;63;3;60;.952;3566000;0
5433;-1;745;0;0;0;0;.00nan;0;0
5433;75268;745;58;25;2;23;.920;3600000;0
5435;2643;742;100;21;0;21;1.000;3600000;0
5435;8505;732;0;0;0;0;.00nan;0;0
5435;-1;742;0;0;0;0;.00nan;0;0
5435;56565;732;67;47;5;42;.894;3600000;0
5437;44526;734;100;30;0;30;1.000;3600000;0
5437;192386;734;0;0;0;0;.00nan;0;0
5437;63932;749;0;0;0;0;.00nan;0;0
5437;85281;749;64;24;2;22;.917;3587000;0
5439;848;743;22;33;7;26;.788;2558000;0
5439;190589;743;55;7;1;6;.857;1042000;0
5439;63932;749;0;0;0;0;.00nan;0;0
5439;85281;749;73;26;2;24;.923;3600000;0
5441;175764;729;0;0;0;0;.00nan;0;0
5441;66245;748;75;34;3;31;.912;3600000;0
5441;67362;748;0;0;0;0;.00nan;0;0
5441;88646;729;73;20;1;19;.950;3600000;0
5443;83;737;26;25;6;19;.760;3176000;0
5443;1957;733;0;0;0;0;.00nan;0;0
5443;199033;737;44;4;1;3;.750;408000;0
5443;67287;733;56;41;6;35;.854;3600000;0
5445;8505;732;0;0;0;0;.00nan;0;0
5445;201075;736;0;0;0;0;.00nan;0;0
5445;196715;736;71;54;5;49;.907;3600000;0
5445;56565;732;55;18;2;16;.889;3600000;0
5447;187925;3789;44;36;5;31;.861;3555000;0
5447;195867;2168;0;0;0;0;.00nan;0;0
5447;-1;3789;0;0;0;0;.00nan;0;0
5447;49935;2168;51;29;4;25;.862;3600000;0
5449;2643;742;100;37;1;36;.973;3600000;0
5449;188561;739;0;0;0;0;.00nan;0;0
5449;33044;739;32;35;6;29;.829;3600000;0
5449;-1;742;0;0;0;0;.00nan;0;0
5451;-1;745;0;0;0;0;.00nan;0;0
5451;57107;747;0;0;0;0;.00nan;0;0
5451;75268;745;84;19;0;19;1.000;3600000;0
5451;76405;747;48;36;6;30;.833;3600000;0
5453;44526;734;92;33;2;31;.939;3600000;0
5453;192386;734;0;0;0;0;.00nan;0;0
5453;49900;744;56;21;3;18;.857;3581000;0
5453;52204;744;0;0;0;0;.00nan;0;0
5455;195887;764;0;0;0;0;.00nan;0;0
5455;196698;741;0;0;0;0;.00nan;0;0
5455;46792;741;51;26;3;23;.885;3546000;0
5455;-1;764;82;34;2;32;.941;3600000;0
5457;178098;738;49;35;6;29;.829;3600000;0
5457;185442;738;0;0;0;0;.00nan;0;0
5457;-1;751;0;0;0;0;.00nan;0;0
5457;148788;751;71;33;3;30;.909;3600000;0
5459;504;740;0;0;0;0;.00nan;0;0
5459;595;740;94;40;2;38;.950;3600000;0
5459;3756;752;61;31;3;28;.903;3582000;0
5459;61272;752;0;0;0;0;.00nan;0;0
5461;187925;3789;0;0;0;0;.00nan;0;0
5461;-1;3789;86;50;4;46;.920;3600000;0
5461;57107;747;70;19;1;18;.947;3600000;0
5461;76405;747;0;0;0;0;.00nan;0;0
5463;201075;736;37;32;6;26;.813;2398000;0
5463;195867;2168;68;18;1;17;.944;3600000;0
5463;196715;736;68;8;0;8;1.000;1202000;0
5463;49935;2168;0;0;0;0;.00nan;0;0
5465;-1;751;0;0;0;0;.00nan;0;0
5465;66245;748;0;0;0;0;.00nan;0;0
5465;67362;748;95;41;2;39;.951;3549000;0
5465;148788;751;87;24;1;23;.958;3600000;0
5467;848;743;0;0;0;0;.00nan;0;0
5467;8505;732;91;39;2;37;.949;3600000;0
5467;190589;743;56;33;4;29;.879;3531000;0
5467;56565;732;0;0;0;0;.00nan;0;0
5469;44526;734;0;0;0;0;.00nan;0;0
5469;192386;734;34;17;4;13;.765;3544000;0
5469;-1;745;0;0;0;0;.00nan;0;0
5469;75268;745;47;20;3;17;.850;3600000;0
5471;178098;738;0;0;0;0;.00nan;0;0
5471;185442;738;51;27;4;23;.852;3600000;0
5471;196698;741;75;25;1;24;.960;3600000;0
5471;46792;741;0;0;0;0;.00nan;0;0
5473;2643;742;0;0;0;0;.00nan;0;0
5473;-1;742;71;9;0;9;1.000;3600000;0
5473;63932;749;0;0;0;0;.00nan;0;0
5473;85281;749;59;31;3;28;.903;3600000;0
5475;1957;733;79;26;1;25;.962;3600000;0
5475;188561;739;58;37;4;33;.892;3600000;0
5475;33044;739;0;0;0;0;.00nan;0;0
5475;67287;733;0;0;0;0;.00nan;0;0
5477;175764;729;85;36;2;34;.944;3600000;0
5477;195887;764;68;41;5;36;.878;3600000;0
5477;-1;764;0;0;0;0;.00nan;0;0
5477;88646;729;0;0;0;0;.00nan;0;0
5479;504;740;45;31;5;26;.839;3600000;0
5479;595;740;0;0;0;0;.00nan;0;0
5479;190570;1880;78;24;1;23;.958;3600000;0
5479;-1;1880;0;0;0;0;.00nan;0;0
5481;3756;752;0;0;0;0;.00nan;0;0
5481;49900;744;0;0;0;0;.00nan;0;0
5481;52204;744;85;35;2;33;.943;3600000;0
5481;61272;752;65;38;4;34;.895;3531000;0
5483;2643;742;79;25;1;24;.960;3600000;0
5483;3756;752;75;37;3;34;.919;3598000;0
5483;-1;742;0;0;0;0;.00nan;0;0
5483;61272;752;0;0;0;0;.00nan;0;0
5485;201075;736;90;42;3;39;.929;3600000;0
5485;196715;736;0;0;0;0;.00nan;0;0
5485;57107;747;0;0;0;0;.00nan;0;0
5485;76405;747;69;17;1;16;.941;3600000;0
5487;8505;732;0;0;0;0;.00nan;0;0
5487;190570;1880;0;0;0;0;.00nan;0;0
5487;-1;1880;87;34;1;33;.971;3600000;0
5487;56565;732;96;36;2;34;.944;3600000;0
5489;188561;739;0;0;0;0;.00nan;0;0
5489;195887;764;68;28;2;26;.929;3600000;0
5489;33044;739;37;27;5;22;.815;3600000;0
5489;-1;764;0;0;0;0;.00nan;0;0
5491;-1;751;0;0;0;0;.00nan;0;0
5491;44526;734;76;42;4;38;.905;3600000;0
5491;192386;734;0;0;0;0;.00nan;0;0
5491;148788;751;68;31;3;28;.903;3600000;0
5493;1957;733;0;0;0;0;.00nan;0;0
5493;196698;741;0;0;0;0;.00nan;0;0
5493;46792;741;65;14;1;13;.929;3600000;0
5493;67287;733;91;45;3;42;.933;3524000;0
5495;83;737;76;39;4;35;.897;3543000;0
5495;199033;737;0;0;0;0;.00nan;0;0
5495;49900;744;0;0;0;0;.00nan;0;0
5495;52204;744;59;25;3;22;.880;3600000;0
5497;187925;3789;82;33;2;31;.939;3600000;0
5497;-1;3789;0;0;0;0;.00nan;0;0
5497;63932;749;0;0;0;0;.00nan;0;0
5497;85281;749;51;24;3;21;.875;3563000;0
5499;-1;745;0;0;0;0;.00nan;0;0
5499;66245;748;49;26;4;22;.846;3600000;0
5499;67362;748;0;0;0;0;.00nan;0;0
5499;75268;745;54;36;5;31;.861;3563000;0
5501;178098;738;76;34;2;32;.941;3546000;0
5501;175764;729;0;0;0;0;.00nan;0;0
5501;185442;738;0;0;0;0;.00nan;0;0
5501;88646;729;68;20;1;19;.950;3600000;0
5503;504;740;0;0;0;0;.00nan;0;0
5503;595;740;76;43;4;39;.907;3600000;0
5503;848;743;75;24;1;23;.958;3600000;0
5503;190589;743;0;0;0;0;.00nan;0;0
5505;195887;764;0;0;0;0;.00nan;0;0
5505;196698;741;0;0;0;0;.00nan;0;0
5505;46792;741;59;29;4;25;.862;3600000;0
5505;-1;764;100;37;0;37;1.000;3600000;0
5507;848;743;0;0;0;0;.00nan;0;0
5507;190589;743;91;35;1;34;.971;3600000;0
5507;57107;747;58;27;2;25;.926;3549000;0
5507;76405;747;0;0;0;0;.00nan;0;0
5509;187925;3789;0;0;0;0;.00nan;0;0
5509;-1;751;0;0;0;0;.00nan;0;0
5509;-1;3789;71;38;4;34;.895;3600000;0
5509;148788;751;55;21;3;18;.857;3600000;0
5511;188561;739;42;23;4;19;.826;3583000;0
5511;178098;738;0;0;0;0;.00nan;0;0
5511;33044;739;0;0;0;0;.00nan;0;0
5511;185442;738;77;40;3;37;.925;3600000;0
5513;504;740;65;54;6;48;.889;2617000;0
5513;595;740;29;9;3;6;.667;983000;0
5513;2643;742;0;0;0;0;.00nan;0;0
5513;-1;742;77;14;0;14;1.000;3600000;0
5515;3756;752;0;0;0;0;.00nan;0;0
5515;61272;752;94;54;5;49;.907;3600000;0
5515;66245;748;0;0;0;0;.00nan;0;0
5515;67362;748;89;19;0;19;1.000;3600000;0
5517;8505;732;64;21;2;19;.905;3600000;0
5517;201075;736;0;0;0;0;.00nan;0;0
5517;196715;736;58;36;4;32;.889;3549000;0
5517;56565;732;0;0;0;0;.00nan;0;0
5519;190570;1880;72;28;2;26;.929;3600000;0
5519;-1;1880;0;0;0;0;.00nan;0;0
5519;49900;744;72;29;3;26;.897;3544000;0
5519;52204;744;0;0;0;0;.00nan;0;0
5521;175764;729;87;31;2;29;.935;3900000;0
5521;63932;749;84;37;2;35;.946;3900000;0
5521;85281;749;0;0;0;0;.00nan;0;0
5521;88646;729;0;0;0;0;.00nan;0;0
5523;195867;2168;0;0;0;0;.00nan;0;0
5523;-1;745;0;0;0;0;.00nan;0;0
5523;49935;2168;31;25;5;20;.800;3600000;0
5523;75268;745;55;32;4;28;.875;3600000;0
5525;83;737;0;0;0;0;.00nan;0;0
5525;1957;733;72;36;3;33;.917;3578000;0
5525;199033;737;55;21;2;19;.905;3600000;0
5525;67287;733;0;0;0;0;.00nan;0;0
5527;3756;752;59;33;4;29;.879;3542000;0
5527;61272;752;0;0;0;0;.00nan;0;0
5527;63932;749;0;0;0;0;.00nan;0;0
5527;85281;749;88;45;3;42;.933;3600000;0
5529;187925;3789;55;40;5;35;.875;3600000;0
5529;195887;764;0;0;0;0;.00nan;0;0
5529;-1;3789;0;0;0;0;.00nan;0;0
5529;-1;764;57;19;2;17;.895;3600000;0
5531;188561;739;0;0;0;0;.00nan;0;0
5531;33044;739;56;23;3;20;.870;3587000;0
5531;44526;734;88;30;1;29;.967;3600000;0
5531;192386;734;0;0;0;0;.00nan;0;0
5533;178098;738;68;26;2;24;.923;3579000;0
5533;201075;736;0;0;0;0;.00nan;0;0
5533;185442;738;0;0;0;0;.00nan;0;0
5533;196715;736;99;42;1;41;.976;3600000;0
5535;83;737;40;34;6;28;.824;3600000;0
5535;199033;737;0;0;0;0;.00nan;0;0
5535;195867;2168;0;0;0;0;.00nan;0;0
5535;49935;2168;100;38;0;38;1.000;3600000;0
5537;196698;741;0;0;0;0;.00nan;0;0
5537;46792;741;48;34;5;29;.853;3600000;0
5537;66245;748;0;0;0;0;.00nan;0;0
5537;67362;748;85;27;2;25;.926;3600000;0
5539;175764;729;0;0;0;0;.00nan;0;0
5539;-1;745;0;0;0;0;.00nan;0;0
5539;75268;745;71;37;3;34;.919;3544000;0
5539;88646;729;81;38;2;36;.947;3600000;0
5541;8505;732;43;31;5;26;.839;2470000;0
5541;56565;732;47;23;4;19;.826;1130000;0
5541;57107;747;0;0;0;0;.00nan;0;0
5541;76405;747;79;25;1;24;.960;3600000;0
5543;504;740;0;0;0;0;.00nan;0;0
5543;595;740;78;32;2;30;.938;3600000;0
5543;190570;1880;53;24;3;21;.875;3573000;0
5543;-1;1880;0;0;0;0;.00nan;0;0
5545;1957;733;51;30;4;26;.867;3600000;0
5545;49900;744;0;0;0;0;.00nan;0;0
5545;52204;744;81;25;1;24;.960;3600000;0
5545;67287;733;0;0;0;0;.00nan;0;0
5547;848;743;28;26;6;20;.769;2498000;0
5547;190589;743;60;17;2;15;.882;1102000;0
5547;-1;751;0;0;0;0;.00nan;0;0
5547;148788;751;61;21;2;19;.905;3600000;0
5549;83;737;0;0;0;0;.00nan;0;0
5549;1957;733;53;4;0;4;1.000;287000;0
5549;199033;737;69;23;2;21;.913;3600000;0
5549;67287;733;79;45;4;41;.911;3313000;0
5551;178098;738;0;0;0;0;.00nan;0;0
5551;185442;738;89;36;2;34;.944;3600000;0
5551;-1;745;0;0;0;0;.00nan;0;0
5551;75268;745;45;18;3;15;.833;3600000;0
5553;2643;742;77;27;1;26;.963;3600000;0
5553;195887;764;68;39;5;34;.872;3600000;0
5553;-1;764;0;0;0;0;.00nan;0;0
5553;-1;742;0;0;0;0;.00nan;0;0
5555;49900;744;82;30;2;28;.933;3900000;0
5555;52204;744;0;0;0;0;.00nan;0;0
5555;66245;748;76;29;2;27;.931;3900000;0
5555;67362;748;0;0;0;0;.00nan;0;0
5557;190570;1880;0;0;0;0;.00nan;0;0
5557;196698;741;68;31;3;28;.903;3618000;0
5557;46792;741;0;0;0;0;.00nan;0;0
5557;-1;1880;54;22;4;18;.818;3618000;0
5559;848;743;0;0;0;0;.00nan;0;0
5559;190589;743;75;30;2;28;.933;3600000;0
5559;-1;751;0;0;0;0;.00nan;0;0
5559;148788;751;40;29;5;24;.828;3600000;0
5561;3756;752;0;0;0;0;.00nan;0;0
5561;57107;747;97;37;1;36;.973;3600000;0
5561;61272;752;97;42;2;40;.952;3600000;0
5561;76405;747;0;0;0;0;.00nan;0;0
5563;44526;734;69;28;2;26;.929;3600000;0
5563;192386;734;0;0;0;0;.00nan;0;0
5563;63932;749;0;0;0;0;.00nan;0;0
5563;85281;749;31;34;7;27;.794;3600000;0
5565;187925;3789;0;0;0;0;.00nan;0;0
5565;188561;739;71;30;2;28;.933;3600000;0
5565;33044;739;0;0;0;0;.00nan;0;0
5565;-1;3789;65;40;4;36;.900;3553000;0
5567;504;740;71;36;3;33;.917;3570000;0
5567;595;740;0;0;0;0;.00nan;0;0
5567;8505;732;0;0;0;0;.00nan;0;0
5567;56565;732;77;30;2;28;.933;3600000;0
5569;201075;736;75;49;6;43;.878;3600000;0
5569;195867;2168;0;0;0;0;.00nan;0;0
5569;196715;736;0;0;0;0;.00nan;0;0
5569;49935;2168;74;21;1;20;.952;3600000;0
572;175764;729;0;0;0;0;.00nan;0;0
572;33044;739;0;0;0;0;.00nan;0;0
572;74734;739;65;38;4;34;.895;3513000;0
572;88646;729;61;23;2;21;.913;3600000;0
573;8505;732;100;37;0;37;1.000;3600000;0
573;195867;732;0;0;0;0;.00nan;0;0
573;180110;1880;63;21;2;19;.905;3566000;0
573;49815;1880;0;0;0;0;.00nan;0;0
574;1957;734;71;26;2;24;.923;3600000;0
574;44526;734;0;0;0;0;.00nan;0;0
574;58037;3789;0;0;0;0;.00nan;0;0
574;85797;3789;62;36;5;31;.861;3600000;0
575;83;737;86;44;3;41;.932;3560000;0
575;199033;737;0;0;0;0;.00nan;0;0
575;178098;738;85;27;1;26;.963;3600000;0
575;93324;738;0;0;0;0;.00nan;0;0
576;2195;748;88;42;2;40;.952;4569000;0
576;2643;742;78;29;1;28;.966;4569000;0
576;-1;742;0;0;0;0;.00nan;0;0
576;66245;748;0;0;0;0;.00nan;0;0
577;848;743;46;38;6;32;.842;3600000;0
577;85281;749;50;22;3;19;.864;3600000;0
577;85661;749;0;0;0;0;.00nan;0;0
577;91742;743;0;0;0;0;.00nan;0;0
578;3756;744;41;26;4;22;.846;3598000;0
578;193790;744;0;0;0;0;.00nan;0;0
578;-1;747;0;0;0;0;.00nan;0;0
578;76405;747;80;37;3;34;.919;3600000;0
579;11716;751;0;0;0;0;.00nan;0;0
579;-1;2168;0;0;0;0;.00nan;0;0
579;49935;2168;82;34;2;32;.941;3600000;0
579;148788;751;46;28;5;23;.821;3600000;0
580;175764;729;0;0;0;0;.00nan;0;0
580;33044;739;0;0;0;0;.00nan;0;0
580;74734;739;100;33;0;33;1.000;3600000;0
580;88646;729;63;27;2;25;.926;3514000;0
581;8505;732;54;23;3;20;.870;3546000;0
581;195867;732;0;0;0;0;.00nan;0;0
581;180110;1880;93;31;1;30;.968;3600000;0
581;49815;1880;0;0;0;0;.00nan;0;0
582;1957;734;53;24;4;20;.833;3698000;0
582;44526;734;0;0;0;0;.00nan;0;0
582;58037;3789;0;0;0;0;.00nan;0;0
582;85797;3789;81;39;3;36;.923;3698000;0
583;83;737;68;20;2;18;.900;3600000;0
583;199033;737;0;0;0;0;.00nan;0;0
583;178098;738;67;36;4;32;.889;3600000;0
583;93324;738;0;0;0;0;.00nan;0;0
584;2195;748;49;39;6;33;.846;3600000;0
584;2643;742;66;22;1;21;.955;3600000;0
584;-1;742;0;0;0;0;.00nan;0;0
584;66245;748;0;0;0;0;.00nan;0;0
585;848;743;59;27;3;24;.889;3785000;0
585;85281;749;0;0;0;0;.00nan;0;0
585;85661;749;59;34;4;30;.882;3785000;0
585;91742;743;0;0;0;0;.00nan;0;0
586;3756;744;84;37;2;35;.946;3545000;0
586;193790;744;0;0;0;0;.00nan;0;0
586;-1;747;0;0;0;0;.00nan;0;0
586;76405;747;67;16;1;15;.938;3600000;0
587;11716;751;0;0;0;0;.00nan;0;0
587;-1;2168;0;0;0;0;.00nan;0;0
587;49935;2168;88;33;1;32;.970;3600000;0
587;148788;751;69;28;2;26;.929;3556000;0
588;175764;729;0;0;0;0;.00nan;0;0
588;33044;739;0;0;0;0;.00nan;0;0
588;74734;739;62;24;2;22;.917;3600000;0
588;88646;729;58;29;4;25;.862;3600000;0
589;8505;732;73;23;2;21;.913;3840000;0
589;195867;732;0;0;0;0;.00nan;0;0
589;180110;1880;92;44;3;41;.932;3840000;0
589;49815;1880;0;0;0;0;.00nan;0;0
590;1957;734;59;40;5;35;.875;3600000;0
590;44526;734;0;0;0;0;.00nan;0;0
590;58037;3789;0;0;0;0;.00nan;0;0
590;85797;3789;73;29;2;27;.931;3600000;0
591;83;737;71;37;4;33;.892;3635000;0
591;199033;737;0;0;0;0;.00nan;0;0
591;178098;738;59;25;3;22;.880;3635000;0
591;93324;738;0;0;0;0;.00nan;0;0
592;2195;748;100;38;0;38;1.000;3600000;0
592;2643;742;53;32;4;28;.875;3600000;0
592;-1;742;0;0;0;0;.00nan;0;0
592;66245;748;0;0;0;0;.00nan;0;0
593;848;743;75;34;3;31;.912;3565000;0
593;85281;749;0;0;0;0;.00nan;0;0
593;85661;749;75;24;2;22;.917;3600000;0
593;91742;743;0;0;0;0;.00nan;0;0
594;3756;744;90;30;1;29;.967;3600000;0
594;193790;744;0;0;0;0;.00nan;0;0
594;-1;747;0;0;0;0;.00nan;0;0
594;76405;747;88;40;3;37;.925;3553000;0
595;11716;751;0;0;0;0;.00nan;0;0
595;-1;2168;0;0;0;0;.00nan;0;0
595;49935;2168;92;42;2;40;.952;4471000;0
595;148788;751;95;28;1;27;.964;4471000;0
596;175764;729;0;0;0;0;.00nan;0;0
596;33044;739;0;0;0;0;.00nan;0;0
596;74734;739;95;34;1;33;.971;3600000;0
596;88646;729;70;28;2;26;.929;3573000;0
597;8505;732;67;33;3;30;.909;3600000;0
597;195867;732;0;0;0;0;.00nan;0;0
597;180110;1880;73;34;4;30;.882;3543000;0
597;49815;1880;0;0;0;0;.00nan;0;0
598;1957;734;78;36;3;33;.917;4046000;0
598;44526;734;0;0;0;0;.00nan;0;0
598;58037;3789;0;0;0;0;.00nan;0;0
598;85797;3789;100;42;2;40;.952;4046000;0
599;83;737;97;29;1;28;.966;3580000;0
599;199033;737;0;0;0;0;.00nan;0;0
599;178098;738;100;31;0;31;1.000;3600000;0
599;93324;738;0;0;0;0;.00nan;0;0
600;2195;748;94;42;1;41;.976;4935000;0
600;2643;742;87;35;2;33;.943;4935000;0
600;-1;742;0;0;0;0;.00nan;0;0
600;66245;748;0;0;0;0;.00nan;0;0
601;848;743;46;34;5;29;.853;3600000;0
601;85281;749;0;0;0;0;.00nan;0;0
601;85661;749;84;27;1;26;.963;3600000;0
601;91742;743;0;0;0;0;.00nan;0;0
602;3756;744;69;31;3;28;.903;3600000;0
602;193790;744;0;0;0;0;.00nan;0;0
602;-1;747;0;0;0;0;.00nan;0;0
602;76405;747;55;30;4;26;.867;3600000;0
603;11716;751;0;0;0;0;.00nan;0;0
603;-1;2168;0;0;0;0;.00nan;0;0
603;49935;2168;54;44;6;38;.864;3600000;0
603;148788;751;67;29;4;25;.862;3600000;0
892;175764;729;0;0;0;0;.00nan;0;0
892;33044;739;0;0;0;0;.00nan;0;0
892;74734;739;64;33;4;29;.879;3537000;0
892;88646;729;79;28;2;26;.929;3600000;0
893;8505;732;58;14;1;13;.929;3600000;0
893;195867;732;0;0;0;0;.00nan;0;0
893;180110;1880;83;44;3;41;.932;3600000;0
893;49815;1880;0;0;0;0;.00nan;0;0
894;1957;734;43;22;4;18;.818;2384000;0
894;44526;734;51;9;1;8;.889;1216000;0
894;58037;3789;0;0;0;0;.00nan;0;0
894;85797;3789;90;30;2;28;.933;3600000;0
895;83;737;57;26;3;23;.885;3557000;0
895;199033;737;0;0;0;0;.00nan;0;0
895;178098;738;100;41;1;40;.976;3600000;0
895;93324;738;0;0;0;0;.00nan;0;0
896;2195;748;63;28;3;25;.893;3565000;0
896;2643;742;84;31;1;30;.968;3600000;0
896;-1;742;0;0;0;0;.00nan;0;0
896;66245;748;0;0;0;0;.00nan;0;0
897;848;743;65;32;3;29;.906;3581000;0
897;85281;749;0;0;0;0;.00nan;0;0
897;85661;749;88;33;2;31;.939;3600000;0
897;91742;743;0;0;0;0;.00nan;0;0
898;3756;744;100;42;1;41;.976;3600000;0
898;193790;744;0;0;0;0;.00nan;0;0
898;-1;747;0;0;0;0;.00nan;0;0
898;76405;747;84;34;2;32;.941;3562000;0
899;11716;751;0;0;0;0;.00nan;0;0
899;-1;2168;0;0;0;0;.00nan;0;0
899;49935;2168;59;23;2;21;.913;4065000;0
899;148788;751;92;50;3;47;.940;4065000;0
985;175764;729;0;0;0;0;.00nan;0;0
985;33044;739;0;0;0;0;.00nan;0;0
985;74734;739;80;31;2;29;.935;3600000;0
985;88646;729;59;28;3;25;.893;3600000;0
986;2195;748;71;39;4;35;.897;3531000;0
986;2643;742;64;19;2;17;.895;3600000;0
986;-1;742;0;0;0;0;.00nan;0;0
986;66245;748;0;0;0;0;.00nan;0;0
987;3756;744;77;28;2;26;.929;3600000;0
987;193790;744;0;0;0;0;.00nan;0;0
987;-1;747;0;0;0;0;.00nan;0;0
987;76405;747;58;30;4;26;.867;3549000;0
988;11716;751;0;0;0;0;.00nan;0;0
988;-1;2168;0;0;0;0;.00nan;0;0
988;49935;2168;77;30;2;28;.933;3600000;0
988;148788;751;69;29;3;26;.897;3600000;0
1073;8505;732;76;30;2;28;.933;3600000;0
1073;195867;732;0;0;0;0;.00nan;0;0
1073;33044;739;0;0;0;0;.00nan;0;0
1073;74734;739;61;38;4;34;.895;3521000;0
1074;178098;738;76;35;3;32;.914;4203000;0
1074;58037;3789;0;0;0;0;.00nan;0;0
1074;85797;3789;70;38;4;34;.895;4203000;0
1074;93324;738;0;0;0;0;.00nan;0;0
1075;2643;742;91;34;2;32;.941;3600000;0
1075;3756;744;74;44;3;41;.932;3548000;0
1075;193790;744;0;0;0;0;.00nan;0;0
1075;-1;742;0;0;0;0;.00nan;0;0
1076;-1;2168;0;0;0;0;.00nan;0;0
1076;49935;2168;42;38;6;32;.842;3600000;0
1076;85281;749;0;0;0;0;.00nan;0;0
1076;85661;749;81;26;1;25;.962;3600000;0
1077;8505;732;57;30;4;26;.867;3581000;0
1077;195867;732;0;0;0;0;.00nan;0;0
1077;33044;739;0;0;0;0;.00nan;0;0
1077;74734;739;66;25;2;23;.920;3600000;0
1078;178098;738;70;36;4;32;.889;3600000;0
1078;58037;3789;0;0;0;0;.00nan;0;0
1078;85797;3789;81;24;1;23;.958;3600000;0
1078;93324;738;0;0;0;0;.00nan;0;0
1079;2643;742;51;30;5;25;.833;3600000;0
1079;3756;744;90;34;1;33;.971;3600000;0
1079;193790;744;0;0;0;0;.00nan;0;0
1079;-1;742;0;0;0;0;.00nan;0;0
1080;-1;2168;0;0;0;0;.00nan;0;0
1080;49935;2168;100;42;0;42;1.000;3600000;0
1080;85281;749;0;0;0;0;.00nan;0;0
1080;85661;749;62;35;4;31;.886;3600000;0
1081;8505;732;100;39;0;39;1.000;3600000;0
1081;195867;732;0;0;0;0;.00nan;0;0
1081;33044;739;0;0;0;0;.00nan;0;0
1081;74734;739;36;32;6;26;.813;3600000;0
1082;178098;738;100;24;0;24;1.000;3600000;0
1082;58037;3789;0;0;0;0;.00nan;0;0
1082;85797;3789;90;30;1;29;.967;3596000;0
1082;93324;738;0;0;0;0;.00nan;0;0
1083;2643;742;54;34;4;30;.882;3596000;0
1083;3756;744;62;22;2;20;.909;3600000;0
1083;193790;744;0;0;0;0;.00nan;0;0
1083;-1;742;0;0;0;0;.00nan;0;0
1084;-1;2168;0;0;0;0;.00nan;0;0
1084;49935;2168;81;35;1;34;.971;3600000;0
1084;85281;749;0;0;0;0;.00nan;0;0
1084;85661;749;89;44;3;41;.932;3557000;0
1085;8505;732;47;21;3;18;.857;3560000;0
1085;195867;732;0;0;0;0;.00nan;0;0
1085;33044;739;0;0;0;0;.00nan;0;0
1085;74734;739;87;28;1;27;.964;3600000;0
1086;178098;738;82;23;1;22;.957;3600000;0
1086;58037;3789;0;0;0;0;.00nan;0;0
1086;85797;3789;53;31;4;27;.871;3600000;0
1086;93324;738;0;0;0;0;.00nan;0;0
1087;2643;742;71;27;2;25;.926;3600000;0
1087;3756;744;91;32;1;31;.969;3600000;0
1087;193790;744;0;0;0;0;.00nan;0;0
1087;-1;742;0;0;0;0;.00nan;0;0
1088;-1;2168;0;0;0;0;.00nan;0;0
1088;49935;2168;65;33;3;30;.909;3600000;0
1088;85281;749;0;0;0;0;.00nan;0;0
1088;85661;749;65;27;2;25;.926;3600000;0
1263;8505;732;73;21;1;20;.952;3600000;0
1263;195867;732;0;0;0;0;.00nan;0;0
1263;33044;739;0;0;0;0;.00nan;0;0
1263;74734;739;63;39;5;34;.872;3600000;0
1264;178098;738;100;29;0;29;1.000;3600000;0
1264;58037;3789;0;0;0;0;.00nan;0;0
1264;85797;3789;82;37;2;35;.946;3569000;0
1264;93324;738;0;0;0;0;.00nan;0;0
1265;2643;742;88;34;2;32;.941;3600000;0
1265;3756;744;57;31;4;27;.871;3600000;0
1265;193790;744;0;0;0;0;.00nan;0;0
1265;-1;742;0;0;0;0;.00nan;0;0
1266;-1;2168;0;0;0;0;.00nan;0;0
1266;49935;2168;76;29;2;27;.931;3543000;0
1266;85281;749;0;0;0;0;.00nan;0;0
1266;85661;749;60;17;1;16;.941;3600000;0
1350;8505;732;58;24;3;21;.875;3600000;0
1350;195867;732;0;0;0;0;.00nan;0;0
1350;33044;739;71;20;1;19;.950;3107000;0
1350;74734;739;26;6;3;3;.500;493000;0
1351;2643;742;59;36;5;31;.861;3588000;0
1351;3756;744;71;36;4;32;.889;3600000;0
1351;193790;744;0;0;0;0;.00nan;0;0
1351;-1;742;0;0;0;0;.00nan;0;0
1352;-1;2168;0;0;0;0;.00nan;0;0
1352;49935;2168;94;31;1;30;.968;3600000;0
1352;85281;749;0;0;0;0;.00nan;0;0
1352;85661;749;44;33;5;28;.848;3600000;0
1466;-1;2168;0;0;0;0;.00nan;0;0
1466;49935;2168;51;23;3;20;.870;3546000;0
1466;85281;749;0;0;0;0;.00nan;0;0
1466;85661;749;64;22;2;20;.909;3600000;0
1493;8505;732;45;23;4;19;.826;3600000;0
1493;178098;738;100;33;1;32;.970;3600000;0
1493;195867;732;0;0;0;0;.00nan;0;0
1493;93324;738;0;0;0;0;.00nan;0;0
1494;3756;744;66;38;4;34;.895;3600000;0
1494;193790;744;0;0;0;0;.00nan;0;0
1494;85281;749;0;0;0;0;.00nan;0;0
1494;85661;749;83;27;1;26;.963;3600000;0
1495;8505;732;100;30;0;30;1.000;3600000;0
1495;178098;738;85;47;4;43;.915;3600000;0
1495;195867;732;0;0;0;0;.00nan;0;0
1495;93324;738;0;0;0;0;.00nan;0;0
1496;3756;744;62;29;2;27;.931;3526000;0
1496;193790;744;0;0;0;0;.00nan;0;0
1496;85281;749;0;0;0;0;.00nan;0;0
1496;85661;749;89;17;0;17;1.000;3600000;0
1497;8505;732;73;35;3;32;.914;3793000;0
1497;178098;738;90;37;2;35;.946;3793000;0
1497;195867;732;0;0;0;0;.00nan;0;0
1497;93324;738;0;0;0;0;.00nan;0;0
1498;3756;744;96;29;1;28;.966;3599000;0
1498;193790;744;0;0;0;0;.00nan;0;0
1498;85281;749;0;0;0;0;.00nan;0;0
1498;85661;749;100;34;0;34;1.000;3600000;0
1499;8505;732;80;26;1;25;.962;3600000;0
1499;178098;738;98;45;2;43;.956;3600000;0
1499;195867;732;0;0;0;0;.00nan;0;0
1499;93324;738;0;0;0;0;.00nan;0;0
1500;3756;744;100;25;0;25;1.000;3600000;0
1500;193790;744;0;0;0;0;.00nan;0;0
1500;85281;749;0;0;0;0;.00nan;0;0
1500;85661;749;81;26;1;25;.962;3565000;0
1651;8505;732;75;38;2;36;.947;4424000;0
1651;178098;738;89;45;3;42;.933;4424000;0
1651;195867;732;0;0;0;0;.00nan;0;0
1651;93324;738;0;0;0;0;.00nan;0;0
1652;3756;744;69;28;2;26;.929;3600000;0
1652;193790;744;0;0;0;0;.00nan;0;0
1652;85281;749;0;0;0;0;.00nan;0;0
1652;85661;749;57;26;4;22;.846;3550000;0
1685;8505;732;74;19;1;18;.947;3600000;0
1685;178098;738;70;47;6;41;.872;3600000;0
1685;195867;732;0;0;0;0;.00nan;0;0
1685;93324;738;0;0;0;0;.00nan;0;0
1686;3756;744;34;10;3;7;.700;455000;0
1686;193790;744;81;28;1;27;.964;3071000;0
1686;85281;749;0;0;0;0;.00nan;0;0
1686;85661;749;96;38;2;36;.947;3600000;0
1753;8505;732;64;38;4;34;.895;4063000;0
1753;195867;732;0;0;0;0;.00nan;0;0
1753;85281;749;0;0;0;0;.00nan;0;0
1753;85661;749;78;42;3;39;.929;4063000;0
1754;8505;732;57;25;3;22;.880;3600000;0
1754;195867;732;0;0;0;0;.00nan;0;0
1754;85281;749;0;0;0;0;.00nan;0;0
1754;85661;749;60;33;4;29;.879;3544000;0
1755;8505;732;63;24;2;22;.917;4230000;0
1755;195867;732;0;0;0;0;.00nan;0;0
1755;85281;749;0;0;0;0;.00nan;0;0
1755;85661;749;94;48;3;45;.938;4230000;0
1756;8505;732;100;43;1;42;.977;3600000;0
1756;195867;732;0;0;0;0;.00nan;0;0
1756;85281;749;0;0;0;0;.00nan;0;0
1756;85661;749;72;33;3;30;.909;3515000;0
5570;14259;572;0;0;0;0;.00nan;0;0
5570;35520;578;0;0;0;0;.00nan;0;0
5570;53861;578;64;14;1;13;.929;3600000;0
5570;68167;572;60;21;2;19;.905;3600000;0
5571;5559;576;52;23;3;20;.870;3531000;0
5571;78251;569;80;32;1;31;.969;3600000;0
5571;91202;576;0;0;0;0;.00nan;0;0
5571;141419;569;0;0;0;0;.00nan;0;0
5572;185232;568;0;0;0;0;.00nan;0;0
5572;44405;566;0;0;0;0;.00nan;0;0
5572;64923;568;57;23;3;20;.870;3600000;0
5572;67614;566;86;48;4;44;.917;3575000;0
5573;65014;570;80;40;3;37;.925;3539000;0
5573;67626;570;0;0;0;0;.00nan;0;0
5573;91403;577;0;0;0;0;.00nan;0;0
5573;143829;577;76;27;1;26;.963;3600000;0
5574;320;562;81;26;2;24;.923;3600000;0
5574;169493;562;0;0;0;0;.00nan;0;0
5574;174407;571;59;31;4;27;.871;3568000;0
5574;179602;571;0;0;0;0;.00nan;0;0
5575;12859;565;76;26;2;24;.923;3600000;0
5575;195646;574;56;35;4;31;.886;3518000;0
5575;84430;565;0;0;0;0;.00nan;0;0
5575;155943;574;0;0;0;0;.00nan;0;0
5576;56126;575;0;0;0;0;.00nan;0;0
5576;78815;564;0;0;0;0;.00nan;0;0
5576;86347;575;66;24;2;22;.917;3600000;0
5576;90734;564;74;41;4;37;.902;3566000;0
5577;5559;576;80;25;1;24;.960;3600000;0
5577;14259;572;0;0;0;0;.00nan;0;0
5577;68167;572;64;34;4;30;.882;3600000;0
5577;91202;576;0;0;0;0;.00nan;0;0
5578;35520;578;0;0;0;0;.00nan;0;0
5578;53861;578;64;26;2;24;.923;3600000;0
5578;65014;570;81;35;3;32;.914;3560000;0
5578;67626;570;0;0;0;0;.00nan;0;0
5579;174407;571;13;20;6;14;.700;2041000;0
5579;179602;571;16;6;4;2;.333;1559000;0
5579;44405;566;60;44;5;39;.886;3600000;0
5579;67614;566;0;0;0;0;.00nan;0;0
5580;1601;573;0;0;0;0;.00nan;0;0
5580;78815;564;0;0;0;0;.00nan;0;0
5580;84945;573;50;37;5;32;.865;3565000;0
5580;90734;564;57;27;3;24;.889;3600000;0
5581;12859;565;0;0;0;0;.00nan;0;0
5581;78251;569;78;43;3;40;.930;3535000;0
5581;84430;565;75;20;1;19;.950;3600000;0
5581;141419;569;0;0;0;0;.00nan;0;0
5582;320;562;100;35;1;34;.971;3600000;0
5582;169493;562;0;0;0;0;.00nan;0;0
5582;78251;569;0;0;0;0;.00nan;0;0
5582;141419;569;26;19;5;14;.737;3600000;0
5583;5559;576;0;0;0;0;.00nan;0;0
5583;35520;578;59;31;4;27;.871;3527000;0
5583;53861;578;0;0;0;0;.00nan;0;0
5583;91202;576;71;25;2;23;.920;3600000;0
5584;185232;568;0;0;0;0;.00nan;0;0
5584;64923;568;54;36;5;31;.861;3547000;0
5584;91403;577;65;33;4;29;.879;3600000;0
5584;143829;577;0;0;0;0;.00nan;0;0
5585;174407;571;70;27;2;25;.926;3600000;0
5585;179602;571;0;0;0;0;.00nan;0;0
5585;44405;566;87;43;3;40;.930;3569000;0
5585;67614;566;0;0;0;0;.00nan;0;0
5586;1601;573;0;0;0;0;.00nan;0;0
5586;14259;572;0;0;0;0;.00nan;0;0
5586;68167;572;67;39;4;35;.897;3600000;0
5586;84945;573;93;36;1;35;.972;3600000;0
5587;195646;574;74;33;2;31;.939;3600000;0
5587;56126;575;0;0;0;0;.00nan;0;0
5587;86347;575;52;25;4;21;.840;3514000;0
5587;155943;574;0;0;0;0;.00nan;0;0
5588;12859;565;0;0;0;0;.00nan;0;0
5588;65014;570;0;0;0;0;.00nan;0;0
5588;67626;570;43;33;5;28;.848;3600000;0
5588;84430;565;72;35;3;32;.914;3600000;0
5589;35520;578;0;0;0;0;.00nan;0;0
5589;53861;578;74;36;3;33;.917;3577000;0
5589;64800;568;64;19;2;17;.895;3600000;0
5589;64923;568;0;0;0;0;.00nan;0;0
5590;1601;573;0;0;0;0;.00nan;0;0
5590;13325;566;0;0;0;0;.00nan;0;0
5590;44405;566;49;38;6;32;.842;3600000;0
5590;84945;573;90;30;1;29;.967;3600000;0
5591;78815;564;0;0;0;0;.00nan;0;0
5591;90734;564;85;30;1;29;.967;3600000;0
5591;91403;577;46;18;3;15;.833;3537000;0
5591;143829;577;0;0;0;0;.00nan;0;0
5592;320;562;73;34;3;31;.912;3600000;0
5592;169493;562;0;0;0;0;.00nan;0;0
5592;56126;575;0;0;0;0;.00nan;0;0
5592;86347;575;90;19;0;19;1.000;3600000;0
5593;195646;574;99;22;0;22;1.000;3600000;0
5593;65014;570;88;31;1;30;.968;3546000;0
5593;67626;570;0;0;0;0;.00nan;0;0
5593;155943;574;0;0;0;0;.00nan;0;0
5594;5559;576;97;24;0;24;1.000;3600000;0
5594;14259;572;0;0;0;0;.00nan;0;0
5594;68167;572;66;23;3;20;.870;3600000;0
5594;91202;576;0;0;0;0;.00nan;0;0
5595;174407;571;0;0;0;0;.00nan;0;0
5595;179602;571;69;18;1;17;.944;3600000;0
5595;78251;569;81;37;3;34;.919;3600000;0
5595;141419;569;0;0;0;0;.00nan;0;0
5596;64800;568;57;25;3;22;.880;3600000;0
5596;64923;568;0;0;0;0;.00nan;0;0
5596;78251;569;0;0;0;0;.00nan;0;0
5596;141419;569;59;32;4;28;.875;3550000;0
5597;1601;573;0;0;0;0;.00nan;0;0
5597;35520;578;0;0;0;0;.00nan;0;0
5597;53861;578;95;41;2;39;.951;3900000;0
5597;84945;573;96;48;2;46;.958;3900000;0
5598;5559;576;50;33;5;28;.848;3581000;0
5598;56126;575;0;0;0;0;.00nan;0;0
5598;86347;575;57;21;3;18;.857;3600000;0
5598;91202;576;0;0;0;0;.00nan;0;0
5599;320;562;0;0;0;0;.00nan;0;0
5599;14259;572;0;0;0;0;.00nan;0;0
5599;169493;562;63;30;3;27;.900;3513000;0
5599;68167;572;80;24;1;23;.958;3600000;0
5600;12859;565;0;0;0;0;.00nan;0;0
5600;13325;566;0;0;0;0;.00nan;0;0
5600;44405;566;76;30;2;28;.933;3600000;0
5600;84430;565;41;28;5;23;.821;3600000;0
5601;35520;578;82;33;3;30;.909;3772000;0
5601;53861;578;0;0;0;0;.00nan;0;0
5601;78251;569;83;41;2;39;.951;3772000;0
5601;141419;569;0;0;0;0;.00nan;0;0
5602;13325;566;87;27;1;26;.963;3600000;0
5602;44405;566;0;0;0;0;.00nan;0;0
5602;91403;577;23;23;6;17;.739;3600000;0
5602;143829;577;0;0;0;0;.00nan;0;0
5603;14259;572;0;0;0;0;.00nan;0;0
5603;195646;574;100;30;0;30;1.000;3600000;0
5603;68167;572;82;43;3;40;.930;3600000;0
5603;155943;574;0;0;0;0;.00nan;0;0
5604;56126;575;92;18;0;18;1.000;3600000;0
5604;64800;568;70;28;2;26;.929;3600000;0
5604;64923;568;0;0;0;0;.00nan;0;0
5604;86347;575;0;0;0;0;.00nan;0;0
5605;12859;565;61;28;3;25;.893;3600000;0
5605;174407;571;71;23;1;22;.957;3600000;0
5605;179602;571;0;0;0;0;.00nan;0;0
5605;84430;565;0;0;0;0;.00nan;0;0
5606;320;562;59;36;5;31;.861;3544000;0
5606;169493;562;0;0;0;0;.00nan;0;0
5606;78815;564;0;0;0;0;.00nan;0;0
5606;90734;564;48;26;4;22;.846;3600000;0
5607;5559;576;0;0;0;0;.00nan;0;0
5607;65014;570;100;26;1;25;.962;3600000;0
5607;67626;570;0;0;0;0;.00nan;0;0
5607;91202;576;66;33;3;30;.909;3553000;0
5608;320;562;0;0;0;0;.00nan;0;0
5608;5559;576;69;22;2;20;.909;3600000;0
5608;169493;562;29;31;6;25;.806;3600000;0
5608;91202;576;0;0;0;0;.00nan;0;0
5609;35520;578;46;5;1;4;.800;603000;0
5609;53861;578;49;42;6;36;.857;2997000;0
5609;91403;577;67;19;1;18;.947;3600000;0
5609;143829;577;0;0;0;0;.00nan;0;0
5610;1601;573;0;0;0;0;.00nan;0;0
5610;64800;568;76;30;2;28;.933;3600000;0
5610;64923;568;0;0;0;0;.00nan;0;0
5610;84945;573;69;45;5;40;.889;3600000;0
5611;13325;566;0;0;0;0;.00nan;0;0
5611;44405;566;64;46;5;41;.891;3600000;0
5611;78815;564;0;0;0;0;.00nan;0;0
5611;90734;564;75;26;2;24;.923;3600000;0
5612;14259;572;81;33;2;31;.939;3572000;0
5612;56126;575;79;24;1;23;.958;3600000;0
5612;68167;572;0;0;0;0;.00nan;0;0
5612;86347;575;0;0;0;0;.00nan;0;0
5613;12859;565;0;0;0;0;.00nan;0;0
5613;195646;574;96;38;1;37;.974;3900000;0
5613;84430;565;90;32;1;31;.969;3900000;0
5613;155943;574;0;0;0;0;.00nan;0;0
5614;5559;576;78;31;2;29;.935;3600000;0
5614;78815;564;78;29;3;26;.897;3600000;0
5614;90734;564;0;0;0;0;.00nan;0;0
5614;91202;576;0;0;0;0;.00nan;0;0
5615;1601;573;0;0;0;0;.00nan;0;0
5615;5559;576;0;0;0;0;.00nan;0;0
5615;84945;573;80;39;3;36;.923;3552000;0
5615;91202;576;82;27;2;25;.926;3600000;0
5616;320;562;0;0;0;0;.00nan;0;0
5616;169493;562;91;53;4;49;.925;3570000;0
5616;91403;577;59;17;2;15;.882;3600000;0
5616;143829;577;0;0;0;0;.00nan;0;0
5617;174407;571;71;24;1;23;.958;3600000;0
5617;195646;574;0;0;0;0;.00nan;0;0
5617;179602;571;0;0;0;0;.00nan;0;0
5617;155943;574;90;35;2;33;.943;3569000;0
5618;13325;566;0;0;0;0;.00nan;0;0
5618;14259;572;0;0;0;0;.00nan;0;0
5618;44405;566;65;27;3;24;.889;3575000;0
5618;68167;572;93;35;1;34;.971;3600000;0
5619;12859;565;0;0;0;0;.00nan;0;0
5619;56126;575;0;0;0;0;.00nan;0;0
5619;84430;565;75;35;3;32;.914;3600000;0
5619;86347;575;67;25;2;23;.920;3600000;0
5620;65014;570;83;27;1;26;.963;3600000;0
5620;67626;570;0;0;0;0;.00nan;0;0
5620;78251;569;66;26;2;24;.923;3580000;0
5620;141419;569;0;0;0;0;.00nan;0;0
5621;65014;570;95;45;2;43;.956;3600000;0
5621;67626;570;0;0;0;0;.00nan;0;0
5621;78251;569;0;0;0;0;.00nan;0;0
5621;141419;569;49;28;4;24;.857;3579000;0
5622;1601;573;84;37;2;35;.946;3600000;0
5622;56126;575;53;30;4;26;.867;3548000;0
5622;84945;573;0;0;0;0;.00nan;0;0
5622;86347;575;0;0;0;0;.00nan;0;0
5623;174407;571;0;0;0;0;.00nan;0;0
5623;179602;571;77;21;1;20;.952;3600000;0
5623;91403;577;0;0;0;0;.00nan;0;0
5623;143829;577;92;40;2;38;.950;3572000;0
5624;35520;578;0;0;0;0;.00nan;0;0
5624;53861;578;98;40;1;39;.975;3575000;0
5624;78815;564;0;0;0;0;.00nan;0;0
5624;90734;564;94;17;0;17;1.000;3600000;0
5625;12859;565;91;34;1;33;.971;3600000;0
5625;64800;568;100;25;0;25;1.000;3600000;0
5625;64923;568;0;0;0;0;.00nan;0;0
5625;84430;565;0;0;0;0;.00nan;0;0
5626;320;562;61;25;3;22;.880;3600000;0
5626;14259;572;0;0;0;0;.00nan;0;0
5626;169493;562;0;0;0;0;.00nan;0;0
5626;68167;572;98;26;0;26;1.000;3600000;0
5627;14259;572;0;0;0;0;.00nan;0;0
5627;68167;572;51;29;4;25;.862;3623000;0
5627;78815;564;0;0;0;0;.00nan;0;0
5627;90734;564;69;29;3;26;.897;3623000;0
5628;78251;569;95;45;2;43;.956;3574000;0
5628;91403;577;0;0;0;0;.00nan;0;0
5628;141419;569;0;0;0;0;.00nan;0;0
5628;143829;577;80;13;0;13;1.000;3600000;0
5629;13325;566;0;0;0;0;.00nan;0;0
5629;44405;566;98;47;2;45;.957;3600000;0
5629;56126;575;0;0;0;0;.00nan;0;0
5629;86347;575;70;20;1;19;.950;3600000;0
5630;35520;578;0;0;0;0;.00nan;0;0
5630;53861;578;78;48;5;43;.896;3600000;0
5630;65014;570;50;20;3;17;.850;3600000;0
5630;67626;570;0;0;0;0;.00nan;0;0
5631;1601;573;0;0;0;0;.00nan;0;0
5631;12859;565;62;31;3;28;.903;3600000;0
5631;84430;565;0;0;0;0;.00nan;0;0
5631;84945;573;100;38;0;38;1.000;3600000;0
5632;5559;576;77;33;2;31;.939;3577000;0
5632;195646;574;74;23;1;22;.957;3600000;0
5632;91202;576;0;0;0;0;.00nan;0;0
5632;155943;574;0;0;0;0;.00nan;0;0
5633;14259;572;0;0;0;0;.00nan;0;0
5633;174407;571;0;0;0;0;.00nan;0;0
5633;179602;571;91;31;2;29;.935;3684000;0
5633;68167;572;85;26;1;25;.962;3684000;0
5634;320;562;55;19;2;17;.895;1183000;0
5634;12859;565;0;0;0;0;.00nan;0;0
5634;169493;562;28;12;4;8;.667;2384000;0
5634;84430;565;40;26;5;21;.808;3600000;0
5635;13325;566;69;50;6;44;.880;3641000;0
5635;35520;578;0;0;0;0;.00nan;0;0
5635;44405;566;0;0;0;0;.00nan;0;0
5635;53861;578;56;35;5;30;.857;3641000;0
5636;64800;568;66;19;2;17;.895;3532000;0
5636;64923;568;0;0;0;0;.00nan;0;0
5636;78815;564;0;0;0;0;.00nan;0;0
5636;90734;564;100;38;0;38;1.000;3600000;0
5637;56126;575;0;0;0;0;.00nan;0;0
5637;65014;570;0;0;0;0;.00nan;0;0
5637;67626;570;92;35;1;34;.971;3575000;0
5637;86347;575;94;23;0;23;1.000;3600000;0
5638;1601;573;0;0;0;0;.00nan;0;0
5638;78251;569;82;45;3;42;.933;3900000;0
5638;84945;573;60;34;3;31;.912;3900000;0
5638;141419;569;0;0;0;0;.00nan;0;0
5639;174407;571;76;21;1;20;.952;3600000;0
5639;179602;571;0;0;0;0;.00nan;0;0
5639;35520;578;62;35;3;32;.914;3550000;0
5639;53861;578;0;0;0;0;.00nan;0;0
5640;5559;576;57;32;4;28;.875;3544000;0
5640;13325;566;0;0;0;0;.00nan;0;0
5640;44405;566;64;28;3;25;.893;3600000;0
5640;91202;576;0;0;0;0;.00nan;0;0
5641;12859;565;63;34;4;30;.882;3600000;0
5641;64800;568;0;0;0;0;.00nan;0;0
5641;64923;568;73;23;1;22;.957;3600000;0
5641;84430;565;0;0;0;0;.00nan;0;0
5642;195646;574;100;24;0;24;1.000;3600000;0
5642;91403;577;0;0;0;0;.00nan;0;0
5642;143829;577;63;28;3;25;.893;3600000;0
5642;155943;574;0;0;0;0;.00nan;0;0
5643;14259;572;0;0;0;0;.00nan;0;0
5643;65014;570;100;23;0;23;1.000;3600000;0
5643;67626;570;0;0;0;0;.00nan;0;0
5643;68167;572;91;31;1;30;.968;3600000;0
5644;56126;575;0;0;0;0;.00nan;0;0
5644;78815;564;0;0;0;0;.00nan;0;0
5644;86347;575;78;30;2;28;.933;3600000;0
5644;90734;564;72;32;3;29;.906;3529000;0
5645;13325;566;0;0;0;0;.00nan;0;0
5645;44405;566;63;19;2;17;.895;3666000;0
5645;78251;569;91;42;3;39;.929;3666000;0
5645;141419;569;0;0;0;0;.00nan;0;0
5646;1601;573;0;0;0;0;.00nan;0;0
5646;35520;578;0;0;0;0;.00nan;0;0
5646;53861;578;16;21;6;15;.714;3592000;0
5646;84945;573;53;33;4;29;.879;3600000;0
5647;174407;571;88;41;3;38;.927;3700000;0
5647;195646;574;0;0;0;0;.00nan;0;0
5647;179602;571;0;0;0;0;.00nan;0;0
5647;155943;574;73;36;4;32;.889;3700000;0
5648;320;562;0;0;0;0;.00nan;0;0
5648;169493;562;100;24;0;24;1.000;3600000;0
5648;65014;570;87;34;1;33;.971;3592000;0
5648;67626;570;0;0;0;0;.00nan;0;0
5649;1601;573;94;45;2;43;.956;3600000;0
5649;195646;574;52;26;3;23;.885;3556000;0
5649;84945;573;0;0;0;0;.00nan;0;0
5649;155943;574;0;0;0;0;.00nan;0;0
5650;5559;576;0;0;0;0;.00nan;0;0
5650;78251;569;71;28;2;26;.929;3900000;0
5650;91202;576;78;34;2;32;.941;3900000;0
5650;141419;569;0;0;0;0;.00nan;0;0
5651;35520;578;0;0;0;0;.00nan;0;0
5651;53861;578;98;51;1;50;.980;3584000;0
5651;64800;568;96;23;0;23;1.000;3600000;0
5651;64923;568;0;0;0;0;.00nan;0;0
5652;13325;566;0;0;0;0;.00nan;0;0
5652;44405;566;87;28;1;27;.964;3600000;0
5652;65014;570;83;32;2;30;.938;3545000;0
5652;67626;570;0;0;0;0;.00nan;0;0
5653;14259;572;0;0;0;0;.00nan;0;0
5653;68167;572;67;42;4;38;.905;3600000;0
5653;91403;577;100;24;0;24;1.000;3600000;0
5653;143829;577;0;0;0;0;.00nan;0;0
5654;12859;565;0;0;0;0;.00nan;0;0
5654;78815;564;0;0;0;0;.00nan;0;0
5654;84430;565;59;31;4;27;.871;3547000;0
5654;90734;564;65;30;3;27;.900;3600000;0
5655;35520;578;77;23;1;22;.957;3600000;0
5655;53861;578;0;0;0;0;.00nan;0;0
5655;78251;569;62;36;4;32;.889;3600000;0
5655;141419;569;0;0;0;0;.00nan;0;0
5656;320;562;48;32;4;28;.875;3594000;0
5656;1601;573;0;0;0;0;.00nan;0;0
5656;169493;562;0;0;0;0;.00nan;0;0
5656;84945;573;88;35;2;33;.943;3600000;0
5657;195646;574;87;46;2;44;.957;3696000;0
5657;56126;575;0;0;0;0;.00nan;0;0
5657;86347;575;74;23;1;22;.957;3696000;0
5657;155943;574;0;0;0;0;.00nan;0;0
5658;5559;576;82;38;2;36;.947;3600000;0
5658;174407;571;0;0;0;0;.00nan;0;0
5658;179602;571;67;21;1;20;.952;3600000;0
5658;91202;576;0;0;0;0;.00nan;0;0
5659;13325;566;75;34;3;31;.912;3600000;0
5659;44405;566;0;0;0;0;.00nan;0;0
5659;78815;564;0;0;0;0;.00nan;0;0
5659;90734;564;91;39;2;37;.949;3600000;0
5660;14259;572;0;0;0;0;.00nan;0;0
5660;65014;570;93;17;0;17;1.000;3600000;0
5660;67626;570;0;0;0;0;.00nan;0;0
5660;68167;572;67;21;1;20;.952;3600000;0
5661;64800;568;100;28;0;28;1.000;3600000;0
5661;64923;568;0;0;0;0;.00nan;0;0
5661;91403;577;65;35;3;32;.914;3600000;0
5661;143829;577;0;0;0;0;.00nan;0;0
5662;320;562;45;36;6;30;.833;3083000;0
5662;13325;566;0;0;0;0;.00nan;0;0
5662;169493;562;52;9;1;8;.889;517000;0
5662;44405;566;84;13;0;13;1.000;3600000;0
5663;1601;573;0;0;0;0;.00nan;0;0
5663;78251;569;0;0;0;0;.00nan;0;0
5663;84945;573;53;29;4;25;.862;3900000;0
5663;141419;569;63;36;4;32;.889;3900000;0
5664;64800;568;80;37;4;33;.892;3824000;0
5664;64923;568;0;0;0;0;.00nan;0;0
5664;85428;574;64;39;5;34;.872;3824000;0
5664;155943;574;0;0;0;0;.00nan;0;0
5665;320;562;96;24;0;24;1.000;3600000;0
5665;169493;562;0;0;0;0;.00nan;0;0
5665;35520;578;0;0;0;0;.00nan;0;0
5665;53861;578;61;24;2;22;.917;3571000;0
5666;13325;566;0;0;0;0;.00nan;0;0
5666;44405;566;39;29;5;24;.828;3597000;0
5666;91403;577;0;0;0;0;.00nan;0;0
5666;143829;577;68;36;4;32;.889;3600000;0
5667;14259;572;0;0;0;0;.00nan;0;0
5667;56126;575;0;0;0;0;.00nan;0;0
5667;68167;572;100;45;1;44;.978;3795000;0
5667;86347;575;61;22;2;20;.909;3795000;0
5668;174407;571;60;23;3;20;.870;3600000;0
5668;179602;571;0;0;0;0;.00nan;0;0
5668;78815;564;0;0;0;0;.00nan;0;0
5668;90734;564;55;32;5;27;.844;3523000;0
5669;1601;573;77;34;3;31;.912;3600000;0
5669;65014;570;57;35;5;30;.857;3600000;0
5669;67626;570;0;0;0;0;.00nan;0;0
5669;84945;573;0;0;0;0;.00nan;0;0
5670;35520;578;85;37;2;35;.946;3600000;0
5670;53861;578;0;0;0;0;.00nan;0;0
5670;56126;575;71;28;3;25;.893;3539000;0
5670;86347;575;0;0;0;0;.00nan;0;0
5671;5559;576;71;37;4;33;.892;3600000;0
5671;91202;576;0;0;0;0;.00nan;0;0
5671;91403;577;90;22;0;22;1.000;3600000;0
5671;143829;577;0;0;0;0;.00nan;0;0
5672;78815;564;0;0;0;0;.00nan;0;0
5672;85428;574;76;31;2;29;.935;3600000;0
5672;90734;564;56;37;6;31;.838;3600000;0
5672;155943;574;0;0;0;0;.00nan;0;0
5673;14259;572;0;0;0;0;.00nan;0;0
5673;64800;568;56;23;3;20;.870;3549000;0
5673;64923;568;0;0;0;0;.00nan;0;0
5673;68167;572;76;27;2;25;.926;3600000;0
5674;174407;571;0;0;0;0;.00nan;0;0
5674;179602;571;73;30;3;27;.900;3900000;0
5674;65014;570;66;34;3;31;.912;3900000;0
5674;67626;570;0;0;0;0;.00nan;0;0
5675;320;562;85;31;1;30;.968;3600000;0
5675;12859;565;0;0;0;0;.00nan;0;0
5675;169493;562;0;0;0;0;.00nan;0;0
5675;84430;565;74;36;3;33;.917;3513000;0
5676;5559;576;0;0;0;0;.00nan;0;0
5676;12859;565;92;47;3;44;.936;3894000;0
5676;84430;565;0;0;0;0;.00nan;0;0
5676;91202;576;61;25;3;22;.880;3900000;0
5677;56126;575;0;0;0;0;.00nan;0;0
5677;64800;568;78;27;2;25;.926;3600000;0
5677;64923;568;0;0;0;0;.00nan;0;0
5677;86347;575;71;36;3;33;.917;3590000;0
5678;1601;573;0;0;0;0;.00nan;0;0
5678;174407;571;34;22;4;18;.818;3600000;0
5678;179602;571;0;0;0;0;.00nan;0;0
5678;84945;573;99;40;1;39;.975;3600000;0
5679;5559;576;0;0;0;0;.00nan;0;0
5679;13325;566;0;0;0;0;.00nan;0;0
5679;44405;566;91;47;3;44;.936;3600000;0
5679;91202;576;36;29;5;24;.828;3513000;0
5680;78251;569;41;50;7;43;.860;3173000;0
5680;78815;564;90;32;2;30;.938;3600000;0
5680;90734;564;0;0;0;0;.00nan;0;0
5680;141419;569;56;5;0;5;1.000;427000;0
5681;65014;570;83;35;3;32;.914;3600000;0
5681;67626;570;0;0;0;0;.00nan;0;0
5681;85428;574;75;41;4;37;.902;3600000;0
5681;155943;574;0;0;0;0;.00nan;0;0
5682;12859;565;0;0;0;0;.00nan;0;0
5682;14259;572;0;0;0;0;.00nan;0;0
5682;68167;572;61;38;5;33;.868;3600000;0
5682;84430;565;62;23;2;21;.913;3600000;0
5683;56126;575;0;0;0;0;.00nan;0;0
5683;65014;570;86;49;4;45;.918;3563000;0
5683;67626;570;0;0;0;0;.00nan;0;0
5683;86347;575;74;20;2;18;.900;3600000;0
5684;14259;572;0;0;0;0;.00nan;0;0
5684;68167;572;64;27;4;23;.852;3600000;0
5684;78251;569;42;29;6;23;.793;2504000;0
5684;141419;569;58;15;1;14;.933;1096000;0
5685;5559;576;0;0;0;0;.00nan;0;0
5685;78815;564;0;0;0;0;.00nan;0;0
5685;90734;564;81;26;1;25;.962;3600000;0
5685;91202;576;78;36;2;34;.944;3585000;0
5686;320;562;91;39;2;37;.949;3600000;0
5686;169493;562;0;0;0;0;.00nan;0;0
5686;64800;568;42;24;4;20;.833;3562000;0
5686;64923;568;0;0;0;0;.00nan;0;0
5687;1601;573;0;0;0;0;.00nan;0;0
5687;84945;573;78;34;3;31;.912;3900000;0
5687;91403;577;70;22;3;19;.864;3900000;0
5687;143829;577;0;0;0;0;.00nan;0;0
5688;35520;578;0;0;0;0;.00nan;0;0
5688;53861;578;98;25;0;25;1.000;3600000;0
5688;85428;574;96;40;2;38;.950;3544000;0
5688;155943;574;0;0;0;0;.00nan;0;0
5689;1601;573;71;26;2;24;.923;3600000;0
5689;5559;576;0;0;0;0;.00nan;0;0
5689;84945;573;0;0;0;0;.00nan;0;0
5689;91202;576;43;28;5;23;.821;3600000;0
5690;35520;578;0;0;0;0;.00nan;0;0
5690;53861;578;72;24;2;22;.917;3900000;0
5690;85428;574;0;0;0;0;.00nan;0;0
5690;155943;574;81;35;2;33;.943;3900000;0
5691;14259;572;0;0;0;0;.00nan;0;0
5691;68167;572;49;30;4;26;.867;3591000;0
5691;78251;569;0;0;0;0;.00nan;0;0
5691;141419;569;82;38;3;35;.921;3600000;0
5692;13325;566;0;0;0;0;.00nan;0;0
5692;174407;571;62;22;1;21;.955;3600000;0
5692;179602;571;0;0;0;0;.00nan;0;0
5692;44405;566;79;31;3;28;.903;3588000;0
5693;78815;564;0;0;0;0;.00nan;0;0
5693;90734;564;69;32;3;29;.906;3600000;0
5693;91403;577;0;0;0;0;.00nan;0;0
5693;143829;577;100;29;0;29;1.000;3600000;0
5694;12859;565;80;51;4;47;.922;3600000;0
5694;56126;575;0;0;0;0;.00nan;0;0
5694;84430;565;0;0;0;0;.00nan;0;0
5694;86347;575;100;25;0;25;1.000;3600000;0
5695;320;562;0;0;0;0;.00nan;0;0
5695;169493;562;93;40;3;37;.925;3600000;0
5695;64800;568;0;0;0;0;.00nan;0;0
5695;64923;568;61;33;4;29;.879;3578000;0
5696;320;562;73;30;2;28;.933;3625000;0
5696;169493;562;0;0;0;0;.00nan;0;0
5696;56126;575;0;0;0;0;.00nan;0;0
5696;86347;575;86;35;3;32;.914;3625000;0
5697;174407;571;69;24;2;22;.917;3600000;0
5697;179602;571;0;0;0;0;.00nan;0;0
5697;91403;577;0;0;0;0;.00nan;0;0
5697;143829;577;81;50;4;46;.920;3551000;0
5698;35520;578;0;0;0;0;.00nan;0;0
5698;53861;578;65;27;3;24;.889;3552000;0
5698;85428;574;56;19;2;17;.895;3600000;0
5698;155943;574;0;0;0;0;.00nan;0;0
5699;64800;568;51;18;3;15;.833;3600000;0
5699;64923;568;0;0;0;0;.00nan;0;0
5699;65014;570;95;58;4;54;.931;3586000;0
5699;67626;570;0;0;0;0;.00nan;0;0
5700;320;562;0;0;0;0;.00nan;0;0
5700;5559;576;0;0;0;0;.00nan;0;0
5700;169493;562;92;31;1;30;.968;3600000;0
5700;91202;576;61;26;2;24;.923;3600000;0
5701;14259;572;0;0;0;0;.00nan;0;0
5701;68167;572;98;58;4;54;.931;3563000;0
5701;78815;564;0;0;0;0;.00nan;0;0
5701;90734;564;62;25;3;22;.880;3600000;0
5702;13325;566;0;0;0;0;.00nan;0;0
5702;44405;566;52;27;4;23;.852;3540000;0
5702;78251;569;77;34;2;32;.941;3600000;0
5702;141419;569;0;0;0;0;.00nan;0;0
5703;1601;573;0;0;0;0;.00nan;0;0
5703;35520;578;48;32;5;27;.844;3600000;0
5703;53861;578;0;0;0;0;.00nan;0;0
5703;84945;573;100;24;0;24;1.000;3600000;0
5704;5559;576;0;0;0;0;.00nan;0;0
5704;85428;574;0;0;0;0;.00nan;0;0
5704;91202;576;45;40;6;34;.850;3600000;0
5704;155943;574;68;35;3;32;.914;3600000;0
5705;12859;565;59;47;5;42;.894;3600000;0
5705;84430;565;0;0;0;0;.00nan;0;0
5705;91403;577;82;15;0;15;1.000;3600000;0
5705;143829;577;0;0;0;0;.00nan;0;0
5706;13325;566;84;30;1;29;.967;3600000;0
5706;14259;572;0;0;0;0;.00nan;0;0
5706;44405;566;0;0;0;0;.00nan;0;0
5706;68167;572;46;26;4;22;.846;3600000;0
5707;174407;571;0;0;0;0;.00nan;0;0
5707;179602;571;73;25;2;23;.920;3900000;0
5707;56126;575;63;21;2;19;.905;3900000;0
5707;86347;575;0;0;0;0;.00nan;0;0
5708;65014;570;69;33;4;29;.879;3544000;0
5708;67626;570;0;0;0;0;.00nan;0;0
5708;78815;564;0;0;0;0;.00nan;0;0
5708;90734;564;78;30;2;28;.933;3600000;0
5709;14259;572;0;0;0;0;.00nan;0;0
5709;35520;578;0;0;0;0;.00nan;0;0
5709;53861;578;49;19;3;16;.842;3600000;0
5709;68167;572;78;42;4;38;.905;3544000;0
5710;64800;568;47;31;5;26;.839;3543000;0
5710;64923;568;0;0;0;0;.00nan;0;0
5710;85428;574;69;34;4;30;.882;3600000;0
5710;155943;574;0;0;0;0;.00nan;0;0
5711;56126;575;0;0;0;0;.00nan;0;0
5711;86347;575;57;26;3;23;.885;3534000;0
5711;91403;577;66;20;1;19;.950;3600000;0
5711;143829;577;0;0;0;0;.00nan;0;0
5712;320;562;100;42;0;42;1.000;3600000;0
5712;169493;562;0;0;0;0;.00nan;0;0
5712;78251;569;58;25;3;22;.880;3600000;0
5712;141419;569;0;0;0;0;.00nan;0;0
5713;1601;573;0;0;0;0;.00nan;0;0
5713;13325;566;0;0;0;0;.00nan;0;0
5713;44405;566;59;26;3;23;.885;3632000;0
5713;84945;573;61;30;4;26;.867;3632000;0
5714;174407;571;98;26;0;26;1.000;3600000;0
5714;179602;571;0;0;0;0;.00nan;0;0
5714;78815;564;0;0;0;0;.00nan;0;0
5714;90734;564;76;30;3;27;.900;3600000;0
5715;5559;576;0;0;0;0;.00nan;0;0
5715;12859;565;0;0;0;0;.00nan;0;0
5715;84430;565;63;16;1;15;.938;3600000;0
5715;91202;576;67;33;3;30;.909;3548000;0
5716;12859;565;0;0;0;0;.00nan;0;0
5716;78251;569;71;31;2;29;.935;3600000;0
5716;84430;565;91;29;1;28;.966;3600000;0
5716;141419;569;0;0;0;0;.00nan;0;0
5717;320;562;39;23;4;19;.826;3540000;0
5717;169493;562;0;0;0;0;.00nan;0;0
5717;35520;578;0;0;0;0;.00nan;0;0
5717;53861;578;70;29;2;27;.931;3600000;0
5718;1601;573;0;0;0;0;.00nan;0;0
5718;84945;573;58;28;3;25;.893;3588000;0
5718;91403;577;76;20;1;19;.950;3600000;0
5718;143829;577;0;0;0;0;.00nan;0;0
5719;13325;566;0;0;0;0;.00nan;0;0
5719;44405;566;49;20;3;17;.850;3600000;0
5719;85428;574;100;26;0;26;1.000;3600000;0
5719;155943;574;0;0;0;0;.00nan;0;0
5720;174407;571;100;25;0;25;1.000;3600000;0
5720;179602;571;0;0;0;0;.00nan;0;0
5720;65014;570;70;43;3;40;.930;3600000;0
5720;67626;570;0;0;0;0;.00nan;0;0
5721;64800;568;91;17;0;17;1.000;3600000;0
5721;64923;568;0;0;0;0;.00nan;0;0
5721;91403;577;91;35;1;34;.971;3600000;0
5721;143829;577;0;0;0;0;.00nan;0;0
5722;320;562;99;42;1;41;.976;3600000;0
5722;169493;562;0;0;0;0;.00nan;0;0
5722;85428;574;63;19;2;17;.895;3571000;0
5722;155943;574;0;0;0;0;.00nan;0;0
5723;56126;575;0;0;0;0;.00nan;0;0
5723;78251;569;71;40;4;36;.900;3600000;0
5723;86347;575;85;27;1;26;.963;3600000;0
5723;141419;569;0;0;0;0;.00nan;0;0
5724;1601;573;0;0;0;0;.00nan;0;0
5724;174407;571;67;28;2;26;.929;3900000;0
5724;179602;571;0;0;0;0;.00nan;0;0
5724;84945;573;93;38;2;36;.947;3900000;0
5725;5559;576;0;0;0;0;.00nan;0;0
5725;78815;564;0;0;0;0;.00nan;0;0
5725;90734;564;100;23;0;23;1.000;3600000;0
5725;91202;576;55;53;6;47;.887;3600000;0
5726;12859;565;64;31;3;28;.903;3600000;0
5726;65014;570;53;45;8;37;.822;3600000;0
5726;67626;570;0;0;0;0;.00nan;0;0
5726;84430;565;0;0;0;0;.00nan;0;0
5727;65014;570;66;39;5;34;.872;3600000;0
5727;67626;570;0;0;0;0;.00nan;0;0
5727;78251;569;0;0;0;0;.00nan;0;0
5727;141419;569;79;27;2;25;.926;3600000;0
5728;12859;565;0;0;0;0;.00nan;0;0
5728;35520;578;0;0;0;0;.00nan;0;0
5728;53861;578;84;25;1;24;.960;3600000;0
5728;84430;565;80;30;2;28;.933;3583000;0
5729;1601;573;63;30;3;27;.900;3600000;0
5729;78815;564;0;0;0;0;.00nan;0;0
5729;84945;573;0;0;0;0;.00nan;0;0
5729;90734;564;30;20;5;15;.750;3583000;0
5730;5559;576;0;0;0;0;.00nan;0;0
5730;174407;571;0;0;0;0;.00nan;0;0
5730;179602;571;69;30;3;27;.900;3546000;0
5730;91202;576;80;31;2;29;.935;3600000;0
5731;14259;572;0;0;0;0;.00nan;0;0
5731;64800;568;42;25;5;20;.800;3600000;0
5731;64923;568;0;0;0;0;.00nan;0;0
5731;68167;572;85;32;1;31;.969;3600000;0
5732;320;562;98;38;3;35;.921;3600000;0
5732;169493;562;0;0;0;0;.00nan;0;0
5732;85428;574;0;0;0;0;.00nan;0;0
5732;155943;574;83;16;0;16;1.000;3600000;0
5733;13325;566;0;0;0;0;.00nan;0;0
5733;44405;566;73;22;1;21;.955;3600000;0
5733;56126;575;71;25;2;23;.920;3543000;0
5733;86347;575;0;0;0;0;.00nan;0;0
5734;64800;568;48;25;4;21;.840;3544000;0
5734;64923;568;0;0;0;0;.00nan;0;0
5734;65014;570;98;37;2;35;.946;3600000;0
5734;67626;570;0;0;0;0;.00nan;0;0
5735;12859;565;0;0;0;0;.00nan;0;0
5735;13325;566;0;0;0;0;.00nan;0;0
5735;44405;566;100;33;0;33;1.000;3600000;0
5735;84430;565;55;24;3;21;.875;3600000;0
5736;5559;576;100;33;1;32;.970;3600000;0
5736;64800;568;0;0;0;0;.00nan;0;0
5736;64923;568;49;24;3;21;.875;3568000;0
5736;91202;576;0;0;0;0;.00nan;0;0
5737;320;562;79;50;4;46;.920;3600000;0
5737;169493;562;0;0;0;0;.00nan;0;0
5737;91403;577;61;17;1;16;.941;3600000;0
5737;143829;577;0;0;0;0;.00nan;0;0
5738;78251;569;58;30;3;27;.900;3900000;0
5738;85428;574;0;0;0;0;.00nan;0;0
5738;141419;569;0;0;0;0;.00nan;0;0
5738;155943;574;68;36;3;33;.917;3900000;0
5739;35520;578;0;0;0;0;.00nan;0;0
5739;53861;578;69;25;2;23;.920;3600000;0
5739;56126;575;0;0;0;0;.00nan;0;0
5739;86347;575;67;33;3;30;.909;3576000;0
5740;1601;573;0;0;0;0;.00nan;0;0
5740;65014;570;53;23;3;20;.870;3539000;0
5740;67626;570;0;0;0;0;.00nan;0;0
5740;84945;573;89;34;1;33;.971;3600000;0
5741;320;562;65;42;5;37;.881;3600000;0
5741;169493;562;0;0;0;0;.00nan;0;0
5741;91403;577;0;0;0;0;.00nan;0;0
5741;143829;577;87;31;1;30;.968;3600000;0
5742;14259;572;0;0;0;0;.00nan;0;0
5742;174407;571;61;28;3;25;.893;3588000;0
5742;179602;571;0;0;0;0;.00nan;0;0
5742;68167;572;97;44;2;42;.955;3600000;0
5743;12859;565;0;0;0;0;.00nan;0;0
5743;78815;564;0;0;0;0;.00nan;0;0
5743;84430;565;75;37;3;34;.919;3551000;0
5743;90734;564;65;14;1;13;.929;3600000;0
5744;1601;573;61;46;5;41;.891;3572000;0
5744;56126;575;0;0;0;0;.00nan;0;0
5744;84945;573;0;0;0;0;.00nan;0;0
5744;86347;575;47;27;4;23;.852;3600000;0
5745;13325;566;0;0;0;0;.00nan;0;0
5745;35520;578;0;0;0;0;.00nan;0;0
5745;44405;566;82;27;1;26;.963;3600000;0
5745;53861;578;78;31;2;29;.935;3582000;0
5746;5559;576;0;0;0;0;.00nan;0;0
5746;64800;568;85;24;1;23;.958;3900000;0
5746;64923;568;0;0;0;0;.00nan;0;0
5746;91202;576;88;32;1;31;.969;3900000;0
5747;12859;565;98;48;2;46;.958;3600000;0
5747;84430;565;0;0;0;0;.00nan;0;0
5747;85428;574;75;19;1;18;.947;3600000;0
5747;155943;574;0;0;0;0;.00nan;0;0
5748;65014;570;61;31;4;27;.871;3600000;0
5748;67626;570;0;0;0;0;.00nan;0;0
5748;78815;564;0;0;0;0;.00nan;0;0
5748;90734;564;2;20;7;13;.650;3600000;0
5749;5559;576;74;48;5;43;.896;3600000;0
5749;91202;576;0;0;0;0;.00nan;0;0
5749;91403;577;0;0;0;0;.00nan;0;0
5749;143829;577;100;31;0;31;1.000;3600000;0
5750;174407;571;83;30;2;28;.933;3584000;0
5750;179602;571;0;0;0;0;.00nan;0;0
5750;56126;575;0;0;0;0;.00nan;0;0
5750;86347;575;100;33;0;33;1.000;3600000;0
5751;35520;578;0;0;0;0;.00nan;0;0
5751;53861;578;88;31;1;30;.968;3900000;0
5751;65014;570;100;45;1;44;.978;3900000;0
5751;67626;570;0;0;0;0;.00nan;0;0
5752;1601;573;0;0;0;0;.00nan;0;0
5752;64800;568;60;20;3;17;.850;3600000;0
5752;64923;568;0;0;0;0;.00nan;0;0
5752;84945;573;87;60;4;56;.933;3600000;0
5753;320;562;0;0;0;0;.00nan;0;0
5753;169493;562;98;46;2;44;.957;3600000;0
5753;56126;575;0;0;0;0;.00nan;0;0
5753;86347;575;62;26;3;23;.885;3600000;0
5754;13325;566;0;0;0;0;.00nan;0;0
5754;44405;566;70;25;2;23;.920;3558000;0
5754;78251;569;86;32;1;31;.969;3600000;0
5754;141419;569;0;0;0;0;.00nan;0;0
5755;12859;565;53;23;3;20;.870;3600000;0
5755;14259;572;0;0;0;0;.00nan;0;0
5755;68167;572;100;35;0;35;1.000;3600000;0
5755;84430;565;0;0;0;0;.00nan;0;0
5756;78815;564;0;0;0;0;.00nan;0;0
5756;85428;574;70;34;3;31;.912;3585000;0
5756;90734;564;78;25;2;23;.920;3600000;0
5756;155943;574;0;0;0;0;.00nan;0;0
5757;5559;576;57;4;0;4;1.000;524000;0
5757;35520;578;0;0;0;0;.00nan;0;0
5757;53861;578;82;37;3;34;.919;3600000;0
5757;91202;576;34;29;6;23;.793;3076000;0
5758;14259;572;0;0;0;0;.00nan;0;0
5758;68167;572;83;31;2;29;.935;3900000;0
5758;78251;569;69;25;2;23;.920;3900000;0
5758;141419;569;0;0;0;0;.00nan;0;0
5759;1601;573;0;0;0;0;.00nan;0;0
5759;84945;573;73;22;2;20;.909;3600000;0
5759;85428;574;46;27;4;23;.852;3554000;0
5759;155943;574;0;0;0;0;.00nan;0;0
5760;5559;576;85;39;3;36;.923;3568000;0
5760;65014;570;96;46;2;44;.957;3600000;0
5760;67626;570;0;0;0;0;.00nan;0;0
5760;91202;576;0;0;0;0;.00nan;0;0
5761;320;562;99;42;2;40;.952;3600000;0
5761;169493;562;0;0;0;0;.00nan;0;0
5761;78815;564;0;0;0;0;.00nan;0;0
5761;90734;564;84;41;3;38;.927;3600000;0
5762;13325;566;0;0;0;0;.00nan;0;0
5762;44405;566;95;24;0;24;1.000;3600000;0
5762;64800;568;70;23;2;21;.913;3556000;0
5762;64923;568;0;0;0;0;.00nan;0;0
5763;12859;565;81;33;2;31;.939;3554000;0
5763;174407;571;100;26;0;26;1.000;3600000;0
5763;179602;571;0;0;0;0;.00nan;0;0
5763;84430;565;0;0;0;0;.00nan;0;0
5764;174407;571;100;35;0;35;1.000;3600000;0
5764;179602;571;0;0;0;0;.00nan;0;0
5764;78251;569;0;0;0;0;.00nan;0;0
5764;141419;569;82;26;1;25;.962;3553000;0
5765;320;562;64;44;5;39;.886;3553000;0
5765;169493;562;0;0;0;0;.00nan;0;0
5765;64800;568;0;0;0;0;.00nan;0;0
5765;64923;568;47;19;3;16;.842;3600000;0
5766;1601;573;31;28;6;22;.786;2476000;0
5766;84945;573;51;2;0;2;1.000;1124000;0
5766;85428;574;0;0;0;0;.00nan;0;0
5766;155943;574;75;32;2;30;.938;3600000;0
5767;14259;572;93;46;3;43;.935;3600000;0
5767;65014;570;53;23;4;19;.826;3586000;0
5767;67626;570;0;0;0;0;.00nan;0;0
5767;68167;572;0;0;0;0;.00nan;0;0
5768;56126;575;84;27;1;26;.963;3600000;0
5768;86347;575;0;0;0;0;.00nan;0;0
5768;91403;577;0;0;0;0;.00nan;0;0
5768;143829;577;81;33;2;31;.939;3548000;0
5769;12859;565;0;0;0;0;.00nan;0;0
5769;78815;564;0;0;0;0;.00nan;0;0
5769;84430;565;81;30;2;28;.933;3562000;0
5769;90734;564;79;22;1;21;.955;3600000;0
5770;78251;569;79;45;3;42;.933;3550000;0
5770;85428;574;63;16;1;15;.938;3600000;0
5770;141419;569;0;0;0;0;.00nan;0;0
5770;155943;574;0;0;0;0;.00nan;0;0
5771;320;562;94;27;1;26;.963;3600000;0
5771;1601;573;0;0;0;0;.00nan;0;0
5771;169493;562;0;0;0;0;.00nan;0;0
5771;84945;573;52;33;5;28;.848;3600000;0
5772;5559;576;0;0;0;0;.00nan;0;0
5772;78815;564;0;0;0;0;.00nan;0;0
5772;90734;564;96;23;0;23;1.000;3600000;0
5772;91202;576;80;36;3;33;.917;3600000;0
5773;174407;571;79;31;2;29;.935;3566000;0
5773;179602;571;0;0;0;0;.00nan;0;0
5773;64800;568;70;25;1;24;.960;3600000;0
5773;64923;568;0;0;0;0;.00nan;0;0
5774;35520;578;0;0;0;0;.00nan;0;0
5774;53861;578;97;47;2;45;.957;3542000;0
5774;91403;577;88;31;1;30;.968;3600000;0
5774;143829;577;0;0;0;0;.00nan;0;0
5775;13325;566;0;0;0;0;.00nan;0;0
5775;44405;566;70;38;4;34;.895;3525000;0
5775;56126;575;0;0;0;0;.00nan;0;0
5775;86347;575;57;16;2;14;.875;3600000;0
5776;14259;572;0;0;0;0;.00nan;0;0
5776;65014;570;0;0;0;0;.00nan;0;0
5776;67626;570;74;21;1;20;.952;3600000;0
5776;68167;572;69;31;3;28;.903;3566000;0
5777;35520;578;100;43;2;41;.953;3600000;0
5777;53861;578;0;0;0;0;.00nan;0;0
5777;78815;564;0;0;0;0;.00nan;0;0
5777;90734;564;59;28;3;25;.893;3592000;0
5778;14259;572;0;0;0;0;.00nan;0;0
5778;68167;572;49;28;4;24;.857;3600000;0
5778;85428;574;0;0;0;0;.00nan;0;0
5778;155943;574;53;22;3;19;.864;3600000;0
5779;5559;576;69;44;6;38;.864;3600000;0
5779;56126;575;78;25;2;23;.920;3600000;0
5779;86347;575;0;0;0;0;.00nan;0;0
5779;91202;576;0;0;0;0;.00nan;0;0
5780;174407;571;0;0;0;0;.00nan;0;0
5780;179602;571;100;35;0;35;1.000;3600000;0
5780;64800;568;43;29;5;24;.828;3600000;0
5780;64923;568;0;0;0;0;.00nan;0;0
5781;65014;570;55;26;3;23;.885;3600000;0
5781;67626;570;0;0;0;0;.00nan;0;0
5781;78251;569;0;0;0;0;.00nan;0;0
5781;141419;569;57;37;5;32;.865;3541000;0
5782;12859;565;82;24;1;23;.958;3613000;0
5782;84430;565;0;0;0;0;.00nan;0;0
5782;91403;577;100;23;0;23;1.000;3613000;0
5782;143829;577;0;0;0;0;.00nan;0;0
5783;320;562;0;0;0;0;.00nan;0;0
5783;13325;566;59;27;3;24;.889;3543000;0
5783;169493;562;72;21;1;20;.952;3600000;0
5783;44405;566;0;0;0;0;.00nan;0;0
5784;78251;569;0;0;0;0;.00nan;0;0
5784;91403;577;57;29;3;26;.897;3566000;0
5784;141419;569;100;42;2;40;.952;3600000;0
5784;143829;577;0;0;0;0;.00nan;0;0
5785;1601;573;0;0;0;0;.00nan;0;0
5785;12859;565;0;0;0;0;.00nan;0;0
5785;84430;565;60;25;3;22;.880;3634000;0
5785;84945;573;93;47;4;43;.915;3634000;0
5786;56126;575;0;0;0;0;.00nan;0;0
5786;78251;569;85;27;1;26;.963;3600000;0
5786;86347;575;100;34;0;34;1.000;3600000;0
5786;141419;569;0;0;0;0;.00nan;0;0
5787;5559;576;0;0;0;0;.00nan;0;0
5787;12859;565;51;32;4;28;.875;3600000;0
5787;84430;565;0;0;0;0;.00nan;0;0
5787;91202;576;84;29;1;28;.966;3600000;0
5788;64800;568;85;26;1;25;.962;3600000;0
5788;64923;568;0;0;0;0;.00nan;0;0
5788;78815;564;0;0;0;0;.00nan;0;0
5788;90734;564;83;43;4;39;.907;3600000;0
5789;320;562;0;0;0;0;.00nan;0;0
5789;169493;562;71;30;2;28;.933;3600000;0
5789;65014;570;45;33;5;28;.848;3600000;0
5789;67626;570;0;0;0;0;.00nan;0;0
5790;13325;566;0;0;0;0;.00nan;0;0
5790;44405;566;66;38;4;34;.895;3578000;0
5790;85428;574;71;29;2;27;.931;3600000;0
5790;155943;574;0;0;0;0;.00nan;0;0
5791;14259;572;0;0;0;0;.00nan;0;0
5791;68167;572;100;34;1;33;.971;3600000;0
5791;91403;577;60;20;2;18;.900;3547000;0
5791;143829;577;0;0;0;0;.00nan;0;0
5792;174407;571;0;0;0;0;.00nan;0;0
5792;179602;571;66;25;2;23;.920;3600000;0
5792;35520;578;0;0;0;0;.00nan;0;0
5792;53861;578;53;22;3;19;.864;3555000;0
5793;35520;578;0;0;0;0;.00nan;0;0
5793;53861;578;54;31;3;28;.903;3593000;0
5793;64800;568;68;18;1;17;.944;3600000;0
5793;64923;568;0;0;0;0;.00nan;0;0
5794;78251;569;87;65;5;60;.923;3600000;0
5794;91403;577;62;24;2;22;.917;3600000;0
5794;141419;569;0;0;0;0;.00nan;0;0
5794;143829;577;0;0;0;0;.00nan;0;0
5795;5559;576;74;25;1;24;.960;3600000;0
5795;14259;572;0;0;0;0;.00nan;0;0
5795;68167;572;65;23;2;21;.913;3572000;0
5795;91202;576;0;0;0;0;.00nan;0;0
5796;1601;573;0;0;0;0;.00nan;0;0
5796;56126;575;0;0;0;0;.00nan;0;0
5796;84945;573;76;31;2;29;.935;3600000;0
5796;86347;575;53;43;6;37;.860;3600000;0
5797;13325;566;0;0;0;0;.00nan;0;0
5797;44405;566;84;50;5;45;.900;3600000;0
5797;78815;564;0;0;0;0;.00nan;0;0
5797;90734;564;68;26;2;24;.923;3600000;0
5798;320;562;74;42;4;38;.905;3600000;0
5798;169493;562;0;0;0;0;.00nan;0;0
5798;65014;570;32;31;6;25;.806;3515000;0
5798;67626;570;0;0;0;0;.00nan;0;0
5799;12859;565;0;0;0;0;.00nan;0;0
5799;84430;565;74;41;4;37;.902;3600000;0
5799;85428;574;70;24;2;22;.917;3600000;0
5799;155943;574;0;0;0;0;.00nan;0;0
5800;1601;573;55;21;3;18;.857;3600000;0
5800;14259;572;0;0;0;0;.00nan;0;0
5800;68167;572;56;43;6;37;.860;3600000;0
5800;84945;573;0;0;0;0;.00nan;0;0
5801;5559;576;0;0;0;0;.00nan;0;0
5801;78251;569;57;35;4;31;.886;3534000;0
5801;91202;576;73;23;2;21;.913;3600000;0
5801;141419;569;0;0;0;0;.00nan;0;0
5802;64800;568;95;35;2;33;.943;3600000;0
5802;64923;568;0;0;0;0;.00nan;0;0
5802;91403;577;55;23;3;20;.870;3588000;0
5802;143829;577;0;0;0;0;.00nan;0;0
5803;56126;575;0;0;0;0;.00nan;0;0
5803;85428;574;0;0;0;0;.00nan;0;0
5803;86347;575;37;32;5;27;.844;3600000;0
5803;155943;574;95;32;1;31;.969;3600000;0
5804;320;562;93;47;3;44;.936;3600000;0
5804;169493;562;0;0;0;0;.00nan;0;0
5804;174407;571;0;0;0;0;.00nan;0;0
5804;179602;571;100;29;0;29;1.000;3600000;0
5805;13325;566;0;0;0;0;.00nan;0;0
5805;44405;566;49;27;4;23;.852;3600000;0
5805;65014;570;89;34;1;33;.971;3600000;0
5805;67626;570;0;0;0;0;.00nan;0;0
5806;12859;565;96;41;2;39;.951;3600000;0
5806;35520;578;0;0;0;0;.00nan;0;0
5806;53861;578;54;27;3;24;.889;3600000;0
5806;84430;565;0;0;0;0;.00nan;0;0
5807;78251;569;54;37;5;32;.865;2225000;0
5807;78815;564;0;0;0;0;.00nan;0;0
5807;90734;564;47;21;4;17;.810;3600000;0
5807;141419;569;54;15;2;13;.867;1375000;0
5808;1601;573;0;0;0;0;.00nan;0;0
5808;35520;578;0;0;0;0;.00nan;0;0
5808;53861;578;85;27;1;26;.963;3600000;0
5808;84945;573;54;34;4;30;.882;3600000;0
5809;5559;576;88;28;1;27;.964;3600000;0
5809;65014;570;58;27;3;24;.889;3529000;0
5809;67626;570;0;0;0;0;.00nan;0;0
5809;91202;576;0;0;0;0;.00nan;0;0
5810;56126;575;0;0;0;0;.00nan;0;0
5810;64800;568;48;27;5;22;.815;3900000;0
5810;64923;568;0;0;0;0;.00nan;0;0
5810;86347;575;50;36;5;31;.861;3900000;0
5811;85428;574;94;41;2;39;.951;3600000;0
5811;91403;577;37;18;4;14;.778;3547000;0
5811;143829;577;0;0;0;0;.00nan;0;0
5811;155943;574;0;0;0;0;.00nan;0;0
5812;13325;566;0;0;0;0;.00nan;0;0
5812;174407;571;0;0;0;0;.00nan;0;0
5812;179602;571;96;22;0;22;1.000;3600000;0
5812;44405;566;79;27;1;26;.963;3581000;0
5813;12859;565;0;0;0;0;.00nan;0;0
5813;14259;572;0;0;0;0;.00nan;0;0
5813;68167;572;50;26;4;22;.846;3541000;0
5813;84430;565;74;25;2;23;.920;3600000;0
5814;13325;566;0;0;0;0;.00nan;0;0
5814;44405;566;98;40;0;40;1.000;3900000;0
5814;64800;568;87;16;0;16;1.000;3900000;0
5814;64923;568;0;0;0;0;.00nan;0;0
5815;35520;578;0;0;0;0;.00nan;0;0
5815;53861;578;98;41;1;40;.976;3600000;0
5815;91403;577;72;27;2;25;.926;3600000;0
5815;143829;577;0;0;0;0;.00nan;0;0
5816;1601;573;0;0;0;0;.00nan;0;0
5816;14259;572;0;0;0;0;.00nan;0;0
5816;68167;572;99;45;1;44;.978;3600000;0
5816;84945;573;67;23;2;21;.913;3550000;0
5817;56126;575;0;0;0;0;.00nan;0;0
5817;78251;569;0;0;0;0;.00nan;0;0
5817;86347;575;54;17;2;15;.882;3600000;0
5817;141419;569;54;31;4;27;.871;3600000;0
5818;5559;576;0;0;0;0;.00nan;0;0
5818;174407;571;0;0;0;0;.00nan;0;0
5818;179602;571;51;19;3;16;.842;3779000;0
5818;91202;576;87;33;2;31;.939;3779000;0
5819;12859;565;57;30;4;26;.867;3600000;0
5819;78815;564;0;0;0;0;.00nan;0;0
5819;84430;565;0;0;0;0;.00nan;0;0
5819;90734;564;79;30;1;29;.967;3600000;0
5820;65014;570;86;43;2;41;.953;3900000;0
5820;67626;570;0;0;0;0;.00nan;0;0
5820;85428;574;82;25;2;23;.920;3900000;0
5820;155943;574;0;0;0;0;.00nan;0;0
5821;78815;564;61;20;2;18;.900;1154000;0
5821;85428;574;0;0;0;0;.00nan;0;0
5821;90734;564;16;22;6;16;.727;2446000;0
5821;155943;574;66;29;2;27;.931;3600000;0
5822;64800;568;78;25;1;24;.960;3600000;0
5822;64923;568;0;0;0;0;.00nan;0;0
5822;78251;569;0;0;0;0;.00nan;0;0
5822;141419;569;75;42;4;38;.905;3600000;0
5823;174407;571;0;0;0;0;.00nan;0;0
5823;179602;571;100;25;0;25;1.000;3600000;0
5823;35520;578;35;30;5;25;.833;3600000;0
5823;53861;578;0;0;0;0;.00nan;0;0
5824;1601;573;0;0;0;0;.00nan;0;0
5824;12859;565;0;0;0;0;.00nan;0;0
5824;84430;565;73;35;3;32;.914;3600000;0
5824;84945;573;50;29;5;24;.828;3600000;0
5825;5559;576;29;28;6;22;.786;3331000;0
5825;13325;566;0;0;0;0;.00nan;0;0
5825;44405;566;47;29;5;24;.828;3600000;0
5825;91202;576;51;3;0;3;1.000;269000;0
5826;14259;572;0;0;0;0;.00nan;0;0
5826;56126;575;0;0;0;0;.00nan;0;0
5826;68167;572;100;50;3;47;.940;3693000;0
5826;86347;575;39;17;4;13;.765;3693000;0
5827;65014;570;0;0;0;0;.00nan;0;0
5827;67626;570;71;43;4;39;.907;3600000;0
5827;91403;577;93;28;1;27;.964;3600000;0
5827;143829;577;0;0;0;0;.00nan;0;0
5828;5559;576;0;0;0;0;.00nan;0;0
5828;35520;578;0;0;0;0;.00nan;0;0
5828;53861;578;70;32;3;29;.906;3561000;0
5828;91202;576;86;28;2;26;.929;3600000;0
5829;64800;568;78;11;0;11;1.000;3600000;0
5829;64923;568;0;0;0;0;.00nan;0;0
5829;65014;570;75;35;3;32;.914;3600000;0
5829;67626;570;0;0;0;0;.00nan;0;0
5830;85428;574;52;26;4;22;.846;3600000;0
5830;91403;577;92;32;1;31;.969;3600000;0
5830;143829;577;0;0;0;0;.00nan;0;0
5830;155943;574;0;0;0;0;.00nan;0;0
5831;13325;566;0;0;0;0;.00nan;0;0
5831;14259;572;0;0;0;0;.00nan;0;0
5831;44405;566;45;22;4;18;.818;3521000;0
5831;68167;572;86;33;2;31;.939;3600000;0
5832;1601;573;0;0;0;0;.00nan;0;0
5832;174407;571;0;0;0;0;.00nan;0;0
5832;179602;571;67;21;2;19;.905;3600000;0
5832;84945;573;45;19;3;16;.842;3555000;0
5833;35520;578;0;0;0;0;.00nan;0;0
5833;53861;578;96;37;1;36;.973;3600000;0
5833;78251;569;46;24;4;20;.833;3600000;0
5833;141419;569;0;0;0;0;.00nan;0;0
5834;78251;569;93;46;2;44;.957;2600000;0
5834;85428;574;50;21;3;18;.857;3600000;0
5834;141419;569;31;20;4;16;.800;1000000;0
5834;155943;574;0;0;0;0;.00nan;0;0
5835;5559;576;90;50;5;45;.900;3600000;0
5835;64800;568;57;16;2;14;.875;3600000;0
5835;64923;568;0;0;0;0;.00nan;0;0
5835;91202;576;0;0;0;0;.00nan;0;0
5836;320;562;0;0;0;0;.00nan;0;0
5836;169493;562;88;39;3;36;.923;3600000;0
5836;91403;577;0;0;0;0;.00nan;0;0
5836;143829;577;65;32;4;28;.875;3541000;0
5837;1601;573;0;0;0;0;.00nan;0;0
5837;13325;566;67;31;3;28;.903;3600000;0
5837;44405;566;0;0;0;0;.00nan;0;0
5837;84945;573;35;25;5;20;.800;3584000;0
5838;12859;565;55;33;5;28;.848;3600000;0
5838;78815;564;0;0;0;0;.00nan;0;0
5838;84430;565;0;0;0;0;.00nan;0;0
5838;90734;564;84;30;1;29;.967;3600000;0
5839;174407;571;0;0;0;0;.00nan;0;0
5839;179602;571;79;30;2;28;.933;3565000;0
5839;65014;570;63;14;1;13;.929;3600000;0
5839;67626;570;0;0;0;0;.00nan;0;0
5840;1601;573;78;43;3;40;.930;3600000;0
5840;64800;568;66;18;1;17;.944;3600000;0
5840;64923;568;0;0;0;0;.00nan;0;0
5840;84945;573;0;0;0;0;.00nan;0;0
5841;5559;576;0;0;0;0;.00nan;0;0
5841;91202;576;69;34;3;31;.912;3578000;0
5841;91403;577;69;18;2;16;.889;3600000;0
5841;143829;577;0;0;0;0;.00nan;0;0
5842;320;562;95;28;0;28;1.000;3600000;0
5842;169493;562;0;0;0;0;.00nan;0;0
5842;35520;578;0;0;0;0;.00nan;0;0
5842;53861;578;89;31;1;30;.968;3586000;0
5843;14259;572;0;0;0;0;.00nan;0;0
5843;68167;572;100;45;0;45;1.000;3600000;0
5843;85428;574;0;0;0;0;.00nan;0;0
5843;155943;574;69;26;2;24;.923;3513000;0
5844;13325;566;0;0;0;0;.00nan;0;0
5844;44405;566;97;44;3;41;.932;3600000;0
5844;56126;575;100;18;0;18;1.000;3600000;0
5844;86347;575;0;0;0;0;.00nan;0;0
5845;12859;565;0;0;0;0;.00nan;0;0
5845;65014;570;62;25;2;23;.920;3600000;0
5845;67626;570;0;0;0;0;.00nan;0;0
5845;84430;565;72;36;3;33;.917;3553000;0
5846;1601;573;0;0;0;0;.00nan;0;0
5846;78251;569;53;25;3;22;.880;3549000;0
5846;84945;573;99;45;1;44;.978;3600000;0
5846;141419;569;0;0;0;0;.00nan;0;0
5847;5559;576;0;0;0;0;.00nan;0;0
5847;14259;572;0;0;0;0;.00nan;0;0
5847;68167;572;83;38;3;35;.921;3600000;0
5847;91202;576;84;18;0;18;1.000;3600000;0
5848;64800;568;81;29;1;28;.966;3547000;0
5848;64923;568;0;0;0;0;.00nan;0;0
5848;85428;574;100;27;0;27;1.000;3600000;0
5848;155943;574;0;0;0;0;.00nan;0;0
5849;174407;571;0;0;0;0;.00nan;0;0
5849;179602;571;51;35;5;30;.857;3600000;0
5849;56126;575;76;30;2;28;.933;3600000;0
5849;86347;575;0;0;0;0;.00nan;0;0
5850;320;562;33;32;6;26;.813;3235000;0
5850;12859;565;0;0;0;0;.00nan;0;0
5850;169493;562;51;2;0;2;1.000;365000;0
5850;84430;565;96;33;2;31;.939;3600000;0
5851;13325;566;0;0;0;0;.00nan;0;0
5851;44405;566;65;30;3;27;.900;3552000;0
5851;65014;570;100;46;2;44;.957;3600000;0
5851;67626;570;0;0;0;0;.00nan;0;0
5852;12859;565;0;0;0;0;.00nan;0;0
5852;35520;578;0;0;0;0;.00nan;0;0
5852;53861;578;60;26;3;23;.885;3600000;0
5852;84430;565;51;31;5;26;.839;3595000;0
5853;5559;576;0;0;0;0;.00nan;0;0
5853;56126;575;0;0;0;0;.00nan;0;0
5853;86347;575;71;25;2;23;.920;3543000;0
5853;91202;576;84;27;1;26;.963;3600000;0
5854;1601;573;0;0;0;0;.00nan;0;0
5854;84945;573;100;48;2;46;.958;3889000;0
5854;91403;577;61;27;2;25;.926;3900000;0
5854;143829;577;0;0;0;0;.00nan;0;0
5855;320;562;0;0;0;0;.00nan;0;0
5855;169493;562;77;41;3;38;.927;3600000;0
5855;174407;571;0;0;0;0;.00nan;0;0
5855;179602;571;100;31;0;31;1.000;3600000;0
5856;14259;572;0;0;0;0;.00nan;0;0
5856;68167;572;93;48;4;44;.917;3600000;0
5856;78815;564;0;0;0;0;.00nan;0;0
5856;90734;564;77;20;1;19;.950;3600000;0
5857;64800;568;100;25;0;25;1.000;3600000;0
5857;64923;568;0;0;0;0;.00nan;0;0
5857;91403;577;0;0;0;0;.00nan;0;0
5857;143829;577;76;37;3;34;.919;3600000;0
5858;1601;573;24;26;6;20;.769;2693000;0
5858;84945;573;64;16;1;15;.938;907000;0
5858;85428;574;58;18;2;16;.889;3600000;0
5858;155943;574;0;0;0;0;.00nan;0;0
5859;13325;566;0;0;0;0;.00nan;0;0
5859;35520;578;0;0;0;0;.00nan;0;0
5859;44405;566;93;38;2;36;.947;3600000;0
5859;53861;578;85;48;4;44;.917;3560000;0
5860;174407;571;88;31;2;29;.935;3600000;0
5860;179602;571;0;0;0;0;.00nan;0;0
5860;56126;575;56;28;3;25;.893;3544000;0
5860;86347;575;0;0;0;0;.00nan;0;0
5861;320;562;97;33;1;32;.970;3600000;0
5861;169493;562;0;0;0;0;.00nan;0;0
5861;78815;564;63;24;2;22;.917;3598000;0
5861;90734;564;0;0;0;0;.00nan;0;0
5862;5559;576;88;36;3;33;.917;3793000;0
5862;12859;565;74;26;2;24;.923;3793000;0
5862;84430;565;0;0;0;0;.00nan;0;0
5862;91202;576;0;0;0;0;.00nan;0;0
5863;65014;570;88;29;2;27;.931;3859000;0
5863;67626;570;0;0;0;0;.00nan;0;0
5863;78251;569;86;41;3;38;.927;3859000;0
5863;141419;569;0;0;0;0;.00nan;0;0
5864;12859;565;36;21;4;17;.810;3069000;0
5864;78251;569;100;28;0;28;1.000;3600000;0
5864;84430;565;39;14;3;11;.786;531000;0
5864;141419;569;0;0;0;0;.00nan;0;0
5865;14259;572;0;0;0;0;.00nan;0;0
5865;35520;578;0;0;0;0;.00nan;0;0
5865;53861;578;77;25;1;24;.960;3600000;0
5865;68167;572;95;39;2;37;.949;3600000;0
5866;1601;573;0;0;0;0;.00nan;0;0
5866;174407;571;0;0;0;0;.00nan;0;0
5866;179602;571;73;12;0;12;1.000;3600000;0
5866;84945;573;78;31;2;29;.935;3511000;0
5867;56126;575;0;0;0;0;.00nan;0;0
5867;65014;570;95;36;1;35;.972;3600000;0
5867;67626;570;0;0;0;0;.00nan;0;0
5867;86347;575;47;21;3;18;.857;3541000;0
5868;78815;564;0;0;0;0;.00nan;0;0
5868;90734;564;55;34;5;29;.853;3600000;0
5868;91403;577;100;34;0;34;1.000;3600000;0
5868;143829;577;0;0;0;0;.00nan;0;0
5869;13325;566;0;0;0;0;.00nan;0;0
5869;44405;566;82;42;3;39;.929;3600000;0
5869;91403;577;83;25;2;23;.920;3600000;0
5869;143829;577;0;0;0;0;.00nan;0;0
5870;14259;572;50;50;8;42;.840;3600000;0
5870;64800;568;63;23;3;20;.870;3600000;0
5870;64923;568;0;0;0;0;.00nan;0;0
5870;68167;572;0;0;0;0;.00nan;0;0
5871;35520;578;0;0;0;0;.00nan;0;0
5871;53861;578;70;41;4;37;.902;3587000;0
5871;85428;574;47;15;2;13;.867;3600000;0
5871;155943;574;0;0;0;0;.00nan;0;0
5872;1601;573;50;1;0;1;1.000;1361000;0
5872;78251;569;75;39;3;36;.923;3600000;0
5872;84945;573;29;15;4;11;.733;2188000;0
5872;141419;569;0;0;0;0;.00nan;0;0
5873;320;562;0;0;0;0;.00nan;0;0
5873;169493;562;50;19;3;16;.842;3570000;0
5873;78815;564;0;0;0;0;.00nan;0;0
5873;90734;564;75;19;1;18;.947;3600000;0
5874;12859;565;60;30;4;26;.867;3600000;0
5874;174407;571;9;19;6;13;.684;3069000;0
5874;179602;571;62;5;0;5;1.000;517000;0
5874;84430;565;0;0;0;0;.00nan;0;0
5875;14259;572;0;0;0;0;.00nan;0;0
5875;65014;570;0;0;0;0;.00nan;0;0
5875;67626;570;72;40;4;36;.900;3600000;0
5875;68167;572;87;29;1;28;.966;3600000;0
5876;35520;578;86;43;3;40;.930;3562000;0
5876;53861;578;0;0;0;0;.00nan;0;0
5876;85428;574;0;0;0;0;.00nan;0;0
5876;155943;574;66;15;1;14;.933;3600000;0
5877;1601;573;0;0;0;0;.00nan;0;0
5877;5559;576;99;26;0;26;1.000;3600000;0
5877;84945;573;98;47;3;44;.936;3600000;0
5877;91202;576;0;0;0;0;.00nan;0;0
5878;12859;565;0;0;0;0;.00nan;0;0
5878;64800;568;80;22;1;21;.955;3871000;0
5878;64923;568;0;0;0;0;.00nan;0;0
5878;84430;565;87;43;2;41;.953;3871000;0
5879;320;562;86;33;1;32;.970;3793000;0
5879;13325;566;0;0;0;0;.00nan;0;0
5879;169493;562;0;0;0;0;.00nan;0;0
5879;44405;566;94;43;2;41;.953;3793000;0
5880;56126;575;81;24;3;21;.875;3900000;0
5880;78815;564;0;0;0;0;.00nan;0;0
5880;86347;575;0;0;0;0;.00nan;0;0
5880;90734;564;64;26;3;23;.885;3900000;0
5881;174407;571;42;23;4;19;.826;3600000;0
5881;179602;571;0;0;0;0;.00nan;0;0
5881;91403;577;89;18;0;18;1.000;3600000;0
5881;143829;577;0;0;0;0;.00nan;0;0
5882;64800;568;73;19;1;18;.947;3600000;0
5882;64923;568;0;0;0;0;.00nan;0;0
5882;78815;564;0;0;0;0;.00nan;0;0
5882;90734;564;57;32;4;28;.875;3600000;0
5883;56126;575;0;0;0;0;.00nan;0;0
5883;78251;569;98;48;3;45;.938;3544000;0
5883;86347;575;91;35;2;33;.943;3600000;0
5883;141419;569;0;0;0;0;.00nan;0;0
5884;1601;573;0;0;0;0;.00nan;0;0
5884;14259;572;0;0;0;0;.00nan;0;0
5884;68167;572;84;35;3;32;.914;3882000;0
5884;84945;573;61;28;3;25;.893;3900000;0
5885;13325;566;0;0;0;0;.00nan;0;0
5885;44405;566;94;46;2;44;.957;3822000;0
5885;91403;577;73;19;1;18;.947;3822000;0
5885;143829;577;0;0;0;0;.00nan;0;0
5886;320;562;100;27;0;27;1.000;3600000;0
5886;5559;576;0;0;0;0;.00nan;0;0
5886;169493;562;0;0;0;0;.00nan;0;0
5886;91202;576;71;29;2;27;.931;3570000;0
5887;174407;571;0;0;0;0;.00nan;0;0
5887;179602;571;69;23;2;21;.913;3600000;0
5887;85428;574;63;42;5;37;.881;3600000;0
5887;155943;574;0;0;0;0;.00nan;0;0
5888;1601;573;85;46;3;43;.935;3600000;0
5888;65014;570;81;31;2;29;.935;3600000;0
5888;67626;570;0;0;0;0;.00nan;0;0
5888;84945;573;0;0;0;0;.00nan;0;0
5889;320;562;91;46;1;45;.978;3608000;0
5889;169493;562;0;0;0;0;.00nan;0;0
5889;64800;568;58;15;2;13;.867;3592000;0
5889;64923;568;0;0;0;0;.00nan;0;0
5890;13325;566;0;0;0;0;.00nan;0;0
5890;174407;571;0;0;0;0;.00nan;0;0
5890;179602;571;77;28;2;26;.929;3600000;0
5890;44405;566;64;31;3;28;.903;3600000;0
5891;14259;572;0;0;0;0;.00nan;0;0
5891;68167;572;99;40;2;38;.950;3600000;0
5891;78251;569;71;29;3;26;.897;3544000;0
5891;141419;569;0;0;0;0;.00nan;0;0
5892;185232;575;0;0;0;0;.00nan;0;0
5892;35520;578;0;0;0;0;.00nan;0;0
5892;53861;578;71;39;4;35;.897;3600000;0
5892;86347;575;71;29;3;26;.897;3600000;0
5893;5559;576;27;22;5;17;.773;2307000;0
5893;78815;564;0;0;0;0;.00nan;0;0
5893;90734;564;85;27;1;26;.963;3600000;0
5893;91202;576;59;13;2;11;.846;1293000;0
5894;12859;565;69;28;3;25;.893;3569000;0
5894;84430;565;0;0;0;0;.00nan;0;0
5894;91403;577;63;20;2;18;.900;3600000;0
5894;143829;577;0;0;0;0;.00nan;0;0
5895;1601;573;0;0;0;0;.00nan;0;0
5895;78815;564;42;30;5;25;.833;3600000;0
5895;84945;573;75;32;2;30;.938;3600000;0
5895;90734;564;0;0;0;0;.00nan;0;0
5896;14259;572;0;0;0;0;.00nan;0;0
5896;68167;572;74;30;2;28;.933;3594000;0
5896;78251;569;0;0;0;0;.00nan;0;0
5896;141419;569;88;26;1;25;.962;3600000;0
5897;5559;576;0;0;0;0;.00nan;0;0
5897;12859;565;0;0;0;0;.00nan;0;0
5897;84430;565;99;38;1;37;.974;3600000;0
5897;91202;576;70;34;3;31;.912;3515000;0
5898;320;562;0;0;0;0;.00nan;0;0
5898;169493;562;100;50;0;50;1.000;3600000;0
5898;64800;568;0;0;0;0;.00nan;0;0
5898;64923;568;70;22;1;21;.955;3564000;0
5899;56126;574;0;0;0;0;.00nan;0;0
5899;65014;570;100;40;1;39;.975;3600000;0
5899;67626;570;0;0;0;0;.00nan;0;0
5899;85428;574;50;23;3;20;.870;3514000;0
5900;13325;566;0;0;0;0;.00nan;0;0
5900;174407;571;0;0;0;0;.00nan;0;0
5900;179602;571;73;29;2;27;.931;3600000;0
5900;44405;566;79;40;3;37;.925;3599000;0
5901;185232;575;100;51;0;51;1.000;3600000;0
5901;86347;575;0;0;0;0;.00nan;0;0
5901;91403;577;0;0;0;0;.00nan;0;0
5901;143829;577;80;26;1;25;.962;3553000;0
5902;64800;568;81;14;0;14;1.000;3600000;0
5902;64923;568;0;0;0;0;.00nan;0;0
5902;78251;569;0;0;0;0;.00nan;0;0
5902;141419;569;74;39;3;36;.923;3600000;0
5903;5559;576;77;26;2;24;.923;3600000;0
5903;35520;578;0;0;0;0;.00nan;0;0
5903;53861;578;60;28;3;25;.893;3581000;0
5903;91202;576;0;0;0;0;.00nan;0;0
5904;14259;572;0;0;0;0;.00nan;0;0
5904;56126;574;0;0;0;0;.00nan;0;0
5904;68167;572;86;43;2;41;.953;3600000;0
5904;85428;574;64;22;2;20;.909;3574000;0
5905;174407;571;0;0;0;0;.00nan;0;0
5905;179602;571;90;31;1;30;.968;3600000;0
5905;185232;575;57;30;3;27;.900;3524000;0
5905;86347;575;0;0;0;0;.00nan;0;0
5906;320;562;0;0;0;0;.00nan;0;0
5906;169493;562;62;40;4;36;.900;3600000;0
5906;91403;577;95;20;0;20;1.000;3600000;0
5906;143829;577;0;0;0;0;.00nan;0;0
5907;5559;576;0;0;0;0;.00nan;0;0
5907;13325;566;0;0;0;0;.00nan;0;0
5907;44405;566;64;28;2;26;.929;3600000;0
5907;91202;576;93;33;1;32;.970;3600000;0
5908;65014;570;79;26;1;25;.962;3600000;0
5908;67626;570;0;0;0;0;.00nan;0;0
5908;78815;564;0;0;0;0;.00nan;0;0
5908;90734;564;77;32;2;30;.938;3600000;0
5909;35520;578;0;0;0;0;.00nan;0;0
5909;53861;578;82;52;4;48;.923;3600000;0
5909;64800;568;100;32;0;32;1.000;3600000;0
5909;64923;568;0;0;0;0;.00nan;0;0
5910;13325;566;0;0;0;0;.00nan;0;0
5910;185232;575;0;0;0;0;.00nan;0;0
5910;44405;566;72;41;5;36;.878;3600000;0
5910;86347;575;75;23;1;22;.957;3600000;0
5911;12859;565;0;0;0;0;.00nan;0;0
5911;65014;570;0;0;0;0;.00nan;0;0
5911;67626;570;81;32;2;30;.938;3600000;0
5911;84430;565;52;27;4;23;.852;3557000;0
5912;78251;569;92;40;2;38;.950;3600000;0
5912;78815;564;0;0;0;0;.00nan;0;0
5912;90734;564;37;32;5;27;.844;3600000;0
5912;141419;569;0;0;0;0;.00nan;0;0
5913;5559;576;90;38;2;36;.947;3556000;0
5913;56126;574;0;0;0;0;.00nan;0;0
5913;85428;574;75;21;1;20;.952;3600000;0
5913;91202;576;0;0;0;0;.00nan;0;0
5914;320;562;0;0;0;0;.00nan;0;0
5914;169493;562;83;43;3;40;.930;3600000;0
5914;174407;571;0;0;0;0;.00nan;0;0
5914;179602;571;65;15;1;14;.933;3600000;0
5915;35520;578;0;0;0;0;.00nan;0;0
5915;53861;578;94;39;2;37;.949;3582000;0
5915;78815;564;0;0;0;0;.00nan;0;0
5915;90734;564;99;34;1;33;.971;3600000;0
5916;65014;570;78;37;3;34;.919;3600000;0
5916;67626;570;0;0;0;0;.00nan;0;0
5916;91403;577;100;24;0;24;1.000;3600000;0
5916;143829;577;0;0;0;0;.00nan;0;0
5917;320;562;54;27;4;23;.852;3600000;0
5917;1601;573;0;0;0;0;.00nan;0;0
5917;169493;562;0;0;0;0;.00nan;0;0
5917;84945;573;57;16;1;15;.938;3600000;0
5918;5559;576;0;0;0;0;.00nan;0;0
5918;56126;574;92;51;4;47;.922;3516000;0
5918;85428;574;0;0;0;0;.00nan;0;0
5918;91202;576;81;30;2;28;.933;3600000;0
5919;13325;566;85;32;2;30;.938;3556000;0
5919;44405;566;0;0;0;0;.00nan;0;0
5919;64800;568;84;19;1;18;.947;3600000;0
5919;64923;568;0;0;0;0;.00nan;0;0
5920;14259;572;0;0;0;0;.00nan;0;0
5920;174407;571;0;0;0;0;.00nan;0;0
5920;179602;571;61;30;4;26;.867;3571000;0
5920;68167;572;57;19;2;17;.895;3600000;0
5921;12859;565;78;34;2;32;.941;3900000;0
5921;185232;575;0;0;0;0;.00nan;0;0
5921;84430;565;0;0;0;0;.00nan;0;0
5921;86347;575;65;22;2;20;.909;3882000;0
5922;35520;578;0;0;0;0;.00nan;0;0
5922;53861;578;91;34;1;33;.971;3900000;0
5922;65014;570;99;35;1;34;.971;3900000;0
5922;67626;570;0;0;0;0;.00nan;0;0
5923;1601;573;0;0;0;0;.00nan;0;0
5923;84945;573;100;47;1;46;.979;3600000;0
5923;91403;577;47;25;4;21;.840;3600000;0
5923;143829;577;0;0;0;0;.00nan;0;0
5924;64800;568;41;14;3;11;.786;3720000;0
5924;64923;568;0;0;0;0;.00nan;0;0
5924;78815;564;0;0;0;0;.00nan;0;0
5924;90734;564;98;44;2;42;.955;3720000;0
5925;56126;574;0;0;0;0;.00nan;0;0
5925;78251;569;98;51;3;48;.941;3900000;0
5925;85428;574;68;28;3;25;.893;3900000;0
5925;141419;569;0;0;0;0;.00nan;0;0
5926;13325;566;0;0;0;0;.00nan;0;0
5926;14259;572;0;0;0;0;.00nan;0;0
5926;44405;566;77;29;1;28;.966;3900000;0
5926;68167;572;98;36;1;35;.972;3900000;0
5927;320;562;93;40;2;38;.950;3855000;0
5927;169493;562;0;0;0;0;.00nan;0;0
5927;185232;575;0;0;0;0;.00nan;0;0
5927;86347;575;53;30;3;27;.900;3855000;0
5928;12859;565;0;0;0;0;.00nan;0;0
5928;174407;571;0;0;0;0;.00nan;0;0
5928;179602;571;65;15;1;14;.933;3600000;0
5928;84430;565;76;47;5;42;.894;3600000;0
5929;1601;573;0;0;0;0;.00nan;0;0
5929;35520;578;0;0;0;0;.00nan;0;0
5929;53861;578;84;31;2;29;.935;3600000;0
5929;84945;573;43;21;4;17;.810;3538000;0
5930;56126;574;0;0;0;0;.00nan;0;0
5930;85428;574;66;31;3;28;.903;3600000;0
5930;91403;577;85;12;0;12;1.000;3600000;0
5930;143829;577;0;0;0;0;.00nan;0;0
5931;320;562;0;0;0;0;.00nan;0;0
5931;169493;562;90;18;0;18;1.000;3600000;0
5931;78251;569;89;39;2;37;.949;3565000;0
5931;141419;569;0;0;0;0;.00nan;0;0
5932;12859;565;0;0;0;0;.00nan;0;0
5932;13325;566;0;0;0;0;.00nan;0;0
5932;44405;566;53;22;2;20;.909;3900000;0
5932;84430;565;79;27;2;25;.926;3900000;0
5933;5559;576;85;41;3;38;.927;3600000;0
5933;185232;575;0;0;0;0;.00nan;0;0
5933;86347;575;64;16;2;14;.875;3600000;0
5933;91202;576;0;0;0;0;.00nan;0;0
5934;174407;571;0;0;0;0;.00nan;0;0
5934;179602;571;100;36;1;35;.972;3600000;0
5934;78815;564;0;0;0;0;.00nan;0;0
5934;90734;564;76;39;4;35;.897;3600000;0
5935;64800;568;84;22;1;21;.955;3600000;0
5935;64923;568;0;0;0;0;.00nan;0;0
5935;65014;570;68;41;5;36;.878;3600000;0
5935;67626;570;0;0;0;0;.00nan;0;0
5936;174407;571;0;0;0;0;.00nan;0;0
5936;78251;569;0;0;0;0;.00nan;0;0
5936;90734;571;74;22;1;21;.955;3600000;0
5936;141419;569;87;44;3;41;.932;3531000;0
5937;5559;576;0;0;0;0;.00nan;0;0
5937;64800;568;87;31;2;29;.935;3900000;0
5937;64923;568;0;0;0;0;.00nan;0;0
5937;91202;576;96;31;2;29;.935;3900000;0
5938;14259;572;0;0;0;0;.00nan;0;0
5938;68167;572;70;34;3;31;.912;3600000;0
5938;91403;577;63;34;4;30;.882;3586000;0
5938;143829;577;0;0;0;0;.00nan;0;0
5939;1601;573;0;0;0;0;.00nan;0;0
5939;5559;576;66;23;2;21;.913;3600000;0
5939;84945;573;84;50;4;46;.920;3597000;0
5939;91202;576;0;0;0;0;.00nan;0;0
5940;320;562;0;0;0;0;.00nan;0;0
5940;14259;572;0;0;0;0;.00nan;0;0
5940;169493;562;80;23;1;22;.957;3600000;0
5940;68167;572;61;28;3;25;.893;3600000;0
5941;174407;571;0;0;0;0;.00nan;0;0
5941;179602;564;78;41;5;36;.878;3543000;0
5941;78815;564;0;0;0;0;.00nan;0;0
5941;90734;571;58;37;4;33;.892;3600000;0
5942;12859;565;0;0;0;0;.00nan;0;0
5942;64800;568;0;0;0;0;.00nan;0;0
5942;64923;568;57;23;3;20;.870;3900000;0
5942;84430;565;61;30;3;27;.900;3900000;0
5943;35520;578;0;0;0;0;.00nan;0;0
5943;53861;578;51;19;3;16;.842;3600000;0
5943;78251;569;55;35;4;31;.886;3579000;0
5943;141419;569;0;0;0;0;.00nan;0;0
5944;13325;566;0;0;0;0;.00nan;0;0
5944;44405;566;51;33;4;29;.879;3900000;0
5944;65014;570;52;26;4;22;.846;3900000;0
5944;67626;570;0;0;0;0;.00nan;0;0
5945;1601;573;0;0;0;0;.00nan;0;0
5945;64800;568;63;28;3;25;.893;3900000;0
5945;64923;568;0;0;0;0;.00nan;0;0
5945;84945;573;100;50;3;47;.940;3900000;0
5946;179602;564;93;46;2;44;.957;3600000;0
5946;78815;564;0;0;0;0;.00nan;0;0
5946;91403;577;68;19;1;18;.947;3600000;0
5946;143829;577;0;0;0;0;.00nan;0;0
5947;320;562;0;0;0;0;.00nan;0;0
5947;169493;562;76;45;4;41;.911;3600000;0
5947;56126;574;0;0;0;0;.00nan;0;0
5947;85428;574;86;15;0;15;1.000;3600000;0
5948;12859;565;50;28;4;24;.857;3555000;0
5948;185232;575;0;0;0;0;.00nan;0;0
5948;84430;565;0;0;0;0;.00nan;0;0
5948;86347;575;74;24;2;22;.917;3600000;0
5949;13325;566;0;0;0;0;.00nan;0;0
5949;35520;578;62;22;2;20;.909;3556000;0
5949;44405;566;83;27;1;26;.963;3600000;0
5949;53861;578;0;0;0;0;.00nan;0;0
5950;320;562;99;49;1;48;.980;3600000;0
5950;169493;562;0;0;0;0;.00nan;0;0
5950;56126;574;0;0;0;0;.00nan;0;0
5950;85428;574;82;27;2;25;.926;3565000;0
5951;14259;572;0;0;0;0;.00nan;0;0
5951;68167;572;91;46;1;45;.978;3900000;0
5951;78251;569;69;18;1;17;.944;3900000;0
5951;141419;569;0;0;0;0;.00nan;0;0
5952;174407;571;0;0;0;0;.00nan;0;0
5952;90734;571;83;38;2;36;.947;3600000;0
5952;91403;577;0;0;0;0;.00nan;0;0
5952;143829;577;90;31;1;30;.968;3600000;0
5953;1601;573;69;28;2;26;.929;3549000;0
5953;179602;564;78;20;1;19;.950;3600000;0
5953;78815;564;0;0;0;0;.00nan;0;0
5953;84945;573;0;0;0;0;.00nan;0;0
5954;185232;575;0;0;0;0;.00nan;0;0
5954;65014;570;66;37;4;33;.892;3600000;0
5954;67626;570;0;0;0;0;.00nan;0;0
5954;86347;575;72;18;1;17;.944;3600000;0
5955;5559;576;0;0;0;0;.00nan;0;0
5955;12859;565;0;0;0;0;.00nan;0;0
5955;84430;565;63;22;2;20;.909;3514000;0
5955;91202;576;95;21;0;21;1.000;3600000;0
5956;320;562;91;38;2;36;.947;3586000;0
5956;169493;562;0;0;0;0;.00nan;0;0
5956;91403;577;91;21;0;21;1.000;3600000;0
5956;143829;577;0;0;0;0;.00nan;0;0
5957;35520;578;0;0;0;0;.00nan;0;0
5957;53861;578;82;50;4;46;.920;3900000;0
5957;56126;574;0;0;0;0;.00nan;0;0
5957;85428;574;61;31;4;27;.871;3899000;0
5958;185232;575;0;0;0;0;.00nan;0;0
5958;64800;568;79;29;2;27;.931;3900000;0
5958;64923;568;0;0;0;0;.00nan;0;0
5958;86347;575;73;28;2;26;.929;3900000;0
5959;174407;571;0;0;0;0;.00nan;0;0
5959;65014;570;48;26;4;22;.846;3580000;0
5959;67626;570;0;0;0;0;.00nan;0;0
5959;90734;571;73;23;2;21;.913;3600000;0
5960;12859;565;0;0;0;0;.00nan;0;0
5960;13325;566;0;0;0;0;.00nan;0;0
5960;44405;566;66;31;3;28;.903;3600000;0
5960;84430;565;73;23;1;22;.957;3600000;0
5961;320;562;0;0;0;0;.00nan;0;0
5961;169493;562;43;43;7;36;.837;3600000;0
5961;78251;569;57;24;3;21;.875;3600000;0
5961;141419;569;0;0;0;0;.00nan;0;0
5962;1601;573;0;0;0;0;.00nan;0;0
5962;13325;566;0;0;0;0;.00nan;0;0
5962;44405;566;92;37;1;36;.973;3600000;0
5962;84945;573;66;31;3;28;.903;3549000;0
5963;5559;576;0;0;0;0;.00nan;0;0
5963;174407;571;0;0;0;0;.00nan;0;0
5963;90734;571;62;18;2;16;.889;3600000;0
5963;91202;576;100;38;1;37;.974;3600000;0
5964;14259;572;0;0;0;0;.00nan;0;0
5964;64800;568;81;15;0;15;1.000;3600000;0
5964;64923;568;0;0;0;0;.00nan;0;0
5964;68167;572;51;30;4;26;.867;3600000;0
5965;185232;575;92;35;1;34;.971;3900000;0
5965;56126;574;0;0;0;0;.00nan;0;0
5965;85428;574;75;22;1;21;.955;3900000;0
5965;86347;575;0;0;0;0;.00nan;0;0
5966;65014;570;86;41;2;39;.951;3900000;0
5966;67626;570;0;0;0;0;.00nan;0;0
5966;91403;577;67;23;2;21;.913;3900000;0
5966;143829;577;0;0;0;0;.00nan;0;0
5967;12859;565;77;40;3;37;.925;3529000;0
5967;179602;564;85;26;1;25;.962;3600000;0
5967;78815;564;0;0;0;0;.00nan;0;0
5967;84430;565;0;0;0;0;.00nan;0;0
5968;185232;575;0;0;0;0;.00nan;0;0
5968;35520;578;0;0;0;0;.00nan;0;0
5968;53861;578;78;21;1;20;.952;3600000;0
5968;86347;575;78;31;2;29;.935;3600000;0
5969;320;562;70;34;4;30;.882;3545000;0
5969;12859;565;0;0;0;0;.00nan;0;0
5969;169493;562;0;0;0;0;.00nan;0;0
5969;84430;565;75;36;3;33;.917;3600000;0
5970;13325;566;77;35;2;33;.943;3600000;0
5970;44405;566;0;0;0;0;.00nan;0;0
5970;56126;574;43;31;5;26;.839;3600000;0
5970;85428;574;0;0;0;0;.00nan;0;0
5971;14259;572;0;0;0;0;.00nan;0;0
5971;174407;571;0;0;0;0;.00nan;0;0
5971;68167;572;100;35;0;35;1.000;3600000;0
5971;90734;571;69;21;1;20;.952;3543000;0
5972;179602;564;62;19;1;18;.947;3600000;0
5972;78251;569;100;43;0;43;1.000;3600000;0
5972;78815;564;0;0;0;0;.00nan;0;0
5972;141419;569;0;0;0;0;.00nan;0;0
5973;64800;568;34;24;5;19;.792;3600000;0
5973;64923;568;0;0;0;0;.00nan;0;0
5973;91403;577;0;0;0;0;.00nan;0;0
5973;143829;577;67;39;4;35;.897;3600000;0
5974;65014;570;91;33;1;32;.970;3600000;0
5974;67626;570;0;0;0;0;.00nan;0;0
5974;78251;569;69;39;4;35;.897;3600000;0
5974;141419;569;0;0;0;0;.00nan;0;0
5975;5559;576;77;23;1;22;.957;3600000;0
5975;78251;569;75;30;2;28;.933;3581000;0
5975;91202;576;0;0;0;0;.00nan;0;0
5975;141419;569;0;0;0;0;.00nan;0;0
5976;1601;573;0;0;0;0;.00nan;0;0
5976;185232;575;0;0;0;0;.00nan;0;0
5976;84945;573;60;45;6;39;.867;3600000;0
5976;86347;575;79;26;1;25;.962;3600000;0
5977;320;562;83;27;1;26;.963;3900000;0
5977;169493;562;0;0;0;0;.00nan;0;0
5977;65014;570;87;31;1;30;.968;3900000;0
5977;67626;570;0;0;0;0;.00nan;0;0
5978;174407;571;0;0;0;0;.00nan;0;0
5978;56126;574;0;0;0;0;.00nan;0;0
5978;85428;574;76;23;1;22;.957;3600000;0
5978;90734;571;47;26;4;22;.846;3600000;0
5979;13325;566;0;0;0;0;.00nan;0;0
5979;179602;564;61;34;4;30;.882;3600000;0
5979;44405;566;90;29;1;28;.966;3600000;0
5979;78815;564;0;0;0;0;.00nan;0;0
5980;14259;572;0;0;0;0;.00nan;0;0
5980;35520;578;0;0;0;0;.00nan;0;0
5980;53861;578;73;35;3;32;.914;3600000;0
5980;68167;572;100;32;0;32;1.000;3600000;0
5981;179602;564;0;0;0;0;.00nan;0;0
5981;185232;575;76;41;4;37;.902;3600000;0
5981;78815;564;66;16;1;15;.938;3600000;0
5981;86347;575;0;0;0;0;.00nan;0;0
5982;1601;573;0;0;0;0;.00nan;0;0
5982;56126;574;0;0;0;0;.00nan;0;0
5982;84945;573;60;34;3;31;.912;3600000;0
5982;85428;574;44;27;4;23;.852;3590000;0
5983;5559;576;0;0;0;0;.00nan;0;0
5983;91202;576;77;19;1;18;.947;3600000;0
5983;91403;577;58;28;2;26;.929;3600000;0
5983;143829;577;0;0;0;0;.00nan;0;0
5984;320;562;0;0;0;0;.00nan;0;0
5984;14259;572;0;0;0;0;.00nan;0;0
5984;169493;562;67;21;2;19;.905;3900000;0
5984;68167;572;100;44;2;42;.955;3900000;0
5985;174407;571;0;0;0;0;.00nan;0;0
5985;64800;568;68;23;2;21;.913;3600000;0
5985;64923;568;0;0;0;0;.00nan;0;0
5985;90734;571;57;39;5;34;.872;3600000;0
5986;12859;565;78;18;1;17;.944;3600000;0
5986;35520;578;0;0;0;0;.00nan;0;0
5986;53861;578;56;25;3;22;.880;3522000;0
5986;84430;565;0;0;0;0;.00nan;0;0
5987;179602;564;56;28;4;24;.857;3633000;0
5987;65014;570;86;39;3;36;.923;3633000;0
5987;67626;570;0;0;0;0;.00nan;0;0
5987;78815;564;0;0;0;0;.00nan;0;0
5988;35520;578;71;49;4;45;.918;3600000;0
5988;53861;578;0;0;0;0;.00nan;0;0
5988;91403;577;0;0;0;0;.00nan;0;0
5988;143829;577;71;20;1;19;.950;3600000;0
5989;320;562;71;35;3;32;.914;3554000;0
5989;5559;576;65;12;1;11;.917;3600000;0
5989;169493;562;0;0;0;0;.00nan;0;0
5989;91202;576;0;0;0;0;.00nan;0;0
5990;174407;571;0;0;0;0;.00nan;0;0
5990;64800;568;0;0;0;0;.00nan;0;0
5990;64923;568;61;16;1;15;.938;3600000;0
5990;90734;571;65;41;4;37;.902;3600000;0
5991;1601;573;75;51;4;47;.922;3600000;0
5991;56126;574;92;33;1;32;.970;3600000;0
5991;84945;573;0;0;0;0;.00nan;0;0
5991;85428;574;0;0;0;0;.00nan;0;0
5992;13325;566;0;0;0;0;.00nan;0;0
5992;44405;566;97;46;1;45;.978;3600000;0
5992;78251;569;71;38;4;34;.895;3600000;0
5992;141419;569;0;0;0;0;.00nan;0;0
5993;14259;572;0;0;0;0;.00nan;0;0
5993;185232;575;0;0;0;0;.00nan;0;0
5993;68167;572;77;37;3;34;.919;3544000;0
5993;86347;575;91;32;1;31;.969;3600000;0
5994;12859;565;0;0;0;0;.00nan;0;0
5994;84430;565;79;37;3;34;.919;3600000;0
5994;91403;577;80;16;0;16;1.000;3600000;0
5994;143829;577;0;0;0;0;.00nan;0;0
5995;174407;571;0;0;0;0;.00nan;0;0
5995;78251;569;0;0;0;0;.00nan;0;0
5995;90734;571;62;19;1;18;.947;3600000;0
5995;141419;569;60;44;5;39;.886;3600000;0
5996;14259;572;0;0;0;0;.00nan;0;0
5996;179602;564;81;29;1;28;.966;3600000;0
5996;68167;572;80;38;2;36;.947;3600000;0
5996;78815;564;0;0;0;0;.00nan;0;0
5997;1601;573;0;0;0;0;.00nan;0;0
5997;35520;578;0;0;0;0;.00nan;0;0
5997;53861;578;71;30;3;27;.900;3900000;0
5997;84945;573;69;32;3;29;.906;3900000;0
5998;64800;568;69;16;1;15;.938;3600000;0
5998;64923;568;0;0;0;0;.00nan;0;0
5998;78251;569;58;43;6;37;.860;2884000;0
5998;141419;569;59;12;1;11;.917;716000;0
5999;320;562;0;0;0;0;.00nan;0;0
5999;13325;566;0;0;0;0;.00nan;0;0
5999;169493;562;65;23;2;21;.913;3582000;0
5999;44405;566;81;25;1;24;.960;3600000;0
6000;13325;566;16;19;6;13;.684;2056000;0
6000;44405;566;71;12;0;12;1.000;1544000;0
6000;56126;574;0;0;0;0;.00nan;0;0
6000;85428;574;91;21;0;21;1.000;3600000;0
6001;12859;565;0;0;0;0;.00nan;0;0
6001;14259;572;94;44;2;42;.955;3900000;0
6001;68167;572;0;0;0;0;.00nan;0;0
6001;84430;565;60;20;2;18;.900;3900000;0
6002;320;562;68;25;2;23;.920;3600000;0
6002;169493;562;0;0;0;0;.00nan;0;0
6002;35520;578;0;0;0;0;.00nan;0;0
6002;53861;578;55;28;3;25;.893;3600000;0
6003;1601;573;0;0;0;0;.00nan;0;0
6003;65014;570;94;37;3;34;.919;3900000;0
6003;67626;570;0;0;0;0;.00nan;0;0
6003;84945;573;62;30;3;27;.900;3900000;0
6004;5559;576;0;0;0;0;.00nan;0;0
6004;179602;564;68;46;6;40;.870;3600000;0
6004;78815;564;0;0;0;0;.00nan;0;0
6004;91202;576;65;31;3;28;.903;3600000;0
6005;185232;575;62;28;3;25;.893;3600000;0
6005;86347;575;0;0;0;0;.00nan;0;0
6005;91403;577;70;34;4;30;.882;3571000;0
6005;143829;577;0;0;0;0;.00nan;0;0
6006;179602;564;39;16;3;13;.813;2167000;0
6006;56126;574;0;0;0;0;.00nan;0;0
6006;78815;564;33;25;6;19;.760;1433000;0
6006;85428;574;74;37;3;34;.919;3600000;0
6007;78251;569;0;0;0;0;.00nan;0;0
6007;91403;577;0;0;0;0;.00nan;0;0
6007;141419;569;97;40;1;39;.975;3900000;0
6007;143829;577;78;16;1;15;.938;3900000;0
6008;320;562;0;0;0;0;.00nan;0;0
6008;169493;562;91;52;3;49;.942;3600000;0
6008;64800;568;74;21;2;19;.905;3600000;0
6008;64923;568;0;0;0;0;.00nan;0;0
6009;13325;566;0;0;0;0;.00nan;0;0
6009;185232;575;0;0;0;0;.00nan;0;0
6009;44405;566;85;39;2;37;.949;3600000;0
6009;86347;575;50;19;3;16;.842;3543000;0
6010;14259;572;0;0;0;0;.00nan;0;0
6010;65014;570;41;31;5;26;.839;3600000;0
6010;67626;570;0;0;0;0;.00nan;0;0
6010;68167;572;100;35;0;35;1.000;3600000;0
6011;174407;571;0;0;0;0;.00nan;0;0
6011;35520;578;84;51;5;46;.902;3864000;0
6011;53861;578;0;0;0;0;.00nan;0;0
6011;90734;571;30;31;6;25;.806;3864000;0
6012;1601;573;58;35;4;31;.886;3555000;0
6012;12859;565;0;0;0;0;.00nan;0;0
6012;84430;565;60;24;3;21;.875;3600000;0
6012;84945;573;0;0;0;0;.00nan;0;0
6013;320;562;0;0;0;0;.00nan;0;0
6013;1601;573;0;0;0;0;.00nan;0;0
6013;169493;562;90;29;2;27;.931;3600000;0
6013;84945;573;44;37;6;31;.838;3600000;0
6014;56126;574;0;0;0;0;.00nan;0;0
6014;64800;568;74;27;2;25;.926;3893000;0
6014;64923;568;0;0;0;0;.00nan;0;0
6014;85428;574;76;38;3;35;.921;3893000;0
6015;14259;572;0;0;0;0;.00nan;0;0
6015;68167;572;69;36;3;33;.917;3520000;0
6015;91403;577;59;13;1;12;.923;3600000;0
6015;143829;577;0;0;0;0;.00nan;0;0
6016;174407;571;0;0;0;0;.00nan;0;0
6016;185232;575;75;25;1;24;.960;3600000;0
6016;86347;575;0;0;0;0;.00nan;0;0
6016;90734;571;41;33;5;28;.848;3600000;0
6017;179602;564;67;20;1;19;.950;3600000;0
6017;35520;578;0;0;0;0;.00nan;0;0
6017;53861;578;51;33;5;28;.848;3600000;0
6017;78815;564;0;0;0;0;.00nan;0;0
6018;5559;576;0;0;0;0;.00nan;0;0
6018;65014;570;0;0;0;0;.00nan;0;0
6018;67626;570;16;20;6;14;.700;3600000;0
6018;91202;576;100;28;0;28;1.000;3600000;0
6019;12859;565;81;23;1;22;.957;3600000;0
6019;78251;569;67;43;4;39;.907;3600000;0
6019;84430;565;0;0;0;0;.00nan;0;0
6019;141419;569;0;0;0;0;.00nan;0;0
6021;174407;571;57;28;3;25;.893;3900000;0
6021;179602;571;0;0;0;0;.00nan;0;0
6021;65014;570;76;46;3;43;.935;3900000;0
6021;67626;570;0;0;0;0;.00nan;0;0
6023;320;562;100;27;0;27;1.000;3600000;0
6023;5559;576;0;0;0;0;.00nan;0;0
6023;169493;562;0;0;0;0;.00nan;0;0
6023;91202;576;69;30;2;28;.933;3548000;0
6025;7063;566;0;0;0;0;.00nan;0;0
6025;56126;575;0;0;0;0;.00nan;0;0
6025;67614;566;86;31;1;30;.968;3600000;0
6025;86347;575;70;22;2;20;.909;3564000;0
6027;12859;565;0;0;0;0;.00nan;0;0
6027;35520;578;0;0;0;0;.00nan;0;0
6027;53861;578;52;29;3;26;.897;3900000;0
6027;84430;565;68;31;3;28;.903;3900000;0
6029;1601;573;0;0;0;0;.00nan;0;0
6029;4484;572;0;0;0;0;.00nan;0;0
6029;14259;572;70;24;1;23;.958;3900000;0
6029;84945;573;100;33;1;32;.970;3900000;0
6031;195646;574;58;21;2;19;.905;3534000;0
6031;185232;568;0;0;0;0;.00nan;0;0
6031;64923;568;100;30;0;30;1.000;3600000;0
6031;155943;574;0;0;0;0;.00nan;0;0
6033;13041;564;0;0;0;0;.00nan;0;0
6033;78251;569;0;0;0;0;.00nan;0;0
6033;90734;564;60;17;2;15;.882;3568000;0
6033;141419;569;99;38;1;37;.974;3600000;0
6037;320;562;60;29;3;26;.897;3569000;0
6037;169493;562;0;0;0;0;.00nan;0;0
6037;78251;569;95;32;1;31;.969;3600000;0
6037;141419;569;0;0;0;0;.00nan;0;0
6041;4484;572;0;0;0;0;.00nan;0;0
6041;14259;572;52;37;5;32;.865;3600000;0
6041;35520;578;0;0;0;0;.00nan;0;0
6041;53861;578;73;32;3;29;.906;3600000;0
6045;12859;565;0;0;0;0;.00nan;0;0
6045;185232;568;0;0;0;0;.00nan;0;0
6045;64923;568;93;21;0;21;1.000;3600000;0
6045;84430;565;63;29;3;26;.897;3600000;0
6047;195646;574;60;16;2;14;.875;3600000;0
6047;56126;575;0;0;0;0;.00nan;0;0
6047;86347;575;82;42;3;39;.929;3553000;0
6047;155943;574;0;0;0;0;.00nan;0;0
6049;185232;568;0;0;0;0;.00nan;0;0
6049;35520;578;87;49;3;46;.939;3557000;0
6049;53861;578;0;0;0;0;.00nan;0;0
6049;64923;568;75;25;1;24;.960;3600000;0
6051;320;562;0;0;0;0;.00nan;0;0
6051;7063;566;0;0;0;0;.00nan;0;0
6051;169493;562;85;32;1;31;.969;3600000;0
6051;67614;566;96;21;0;21;1.000;3600000;0
6059;56126;575;48;17;3;14;.824;3575000;0
6059;78251;569;0;0;0;0;.00nan;0;0
6059;86347;575;0;0;0;0;.00nan;0;0
6059;141419;569;98;27;1;26;.963;3600000;0
6061;1601;573;0;0;0;0;.00nan;0;0
6061;12859;565;49;26;3;23;.885;3551000;0
6061;84430;565;0;0;0;0;.00nan;0;0
6061;84945;573;79;38;2;36;.947;3600000;0
6063;185232;568;0;0;0;0;.00nan;0;0
6063;35520;578;0;0;0;0;.00nan;0;0
6063;53861;578;86;53;5;48;.906;3600000;0
6063;64923;568;83;22;1;21;.955;3600000;0
6065;320;562;63;46;6;40;.870;3600000;0
6065;7063;566;0;0;0;0;.00nan;0;0
6065;169493;562;0;0;0;0;.00nan;0;0
6065;67614;566;72;21;1;20;.952;3600000;0
6073;195646;574;46;25;3;22;.880;3588000;0
6073;56126;575;0;0;0;0;.00nan;0;0
6073;86347;575;87;34;2;32;.941;3600000;0
6073;155943;574;0;0;0;0;.00nan;0;0
6075;1601;573;0;0;0;0;.00nan;0;0
6075;12859;565;0;0;0;0;.00nan;0;0
6075;84430;565;70;34;4;30;.882;3600000;0
6075;84945;573;78;31;3;28;.903;3600000;0
6077;5559;576;68;28;2;26;.929;3538000;0
6077;12859;565;100;25;0;25;1.000;3600000;0
6077;84430;565;0;0;0;0;.00nan;0;0
6077;91202;576;0;0;0;0;.00nan;0;0
6079;44405;566;85;28;1;27;.964;3549000;0
6079;67614;566;0;0;0;0;.00nan;0;0
6079;78251;569;0;0;0;0;.00nan;0;0
6079;141419;569;94;22;0;22;1.000;3600000;0
6087;1601;573;56;37;5;32;.865;3600000;0
6087;185232;568;71;22;1;21;.955;3600000;0
6087;64923;568;0;0;0;0;.00nan;0;0
6087;84945;573;0;0;0;0;.00nan;0;0
6089;195646;574;0;0;0;0;.00nan;0;0
6089;35520;578;59;36;5;31;.861;3600000;0
6089;53861;578;0;0;0;0;.00nan;0;0
6089;155943;574;100;25;0;25;1.000;3600000;0
6091;5559;576;0;0;0;0;.00nan;0;0
6091;195646;574;0;0;0;0;.00nan;0;0
6091;91202;576;61;27;3;24;.889;3600000;0
6091;155943;574;84;29;1;28;.966;3600000;0
6093;35520;578;0;0;0;0;.00nan;0;0
6093;53861;578;51;31;4;27;.871;3600000;0
6093;78815;564;0;0;0;0;.00nan;0;0
6093;90734;564;100;33;1;32;.970;3600000;0
6095;14259;572;0;0;0;0;.00nan;0;0
6095;56126;575;0;0;0;0;.00nan;0;0
6095;68167;572;97;42;1;41;.976;3900000;0
6095;86347;575;87;25;1;24;.960;3900000;0
6097;12859;565;100;37;0;37;1.000;3600000;0
6097;185232;568;0;0;0;0;.00nan;0;0
6097;64923;568;77;26;1;25;.962;3547000;0
6097;84430;565;0;0;0;0;.00nan;0;0
6099;1601;573;0;0;0;0;.00nan;0;0
6099;78251;569;0;0;0;0;.00nan;0;0
6099;84945;573;99;38;1;37;.974;3600000;0
6099;141419;569;57;29;4;25;.862;3600000;0
6101;174407;571;51;23;3;20;.870;3600000;0
6101;179602;571;0;0;0;0;.00nan;0;0
6101;91403;577;100;35;0;35;1.000;3600000;0
6101;143829;577;0;0;0;0;.00nan;0;0
6103;44405;566;71;31;3;28;.903;3516000;0
6103;65014;570;92;31;1;30;.968;3600000;0
6103;67614;566;0;0;0;0;.00nan;0;0
6103;67626;570;0;0;0;0;.00nan;0;0
6109;14259;572;96;46;1;45;.978;3599000;0
6109;44405;566;0;0;0;0;.00nan;0;0
6109;67614;566;94;22;0;22;1.000;3600000;0
6109;68167;572;0;0;0;0;.00nan;0;0
6113;5559;576;55;26;4;22;.846;3517000;0
6113;35520;578;86;36;2;34;.944;3600000;0
6113;53861;578;0;0;0;0;.00nan;0;0
6113;91202;576;0;0;0;0;.00nan;0;0
6115;12859;565;60;30;3;27;.900;3563000;0
6115;195646;574;75;22;1;21;.955;3600000;0
6115;84430;565;0;0;0;0;.00nan;0;0
6115;155943;574;0;0;0;0;.00nan;0;0
989;5559;576;0;0;0;0;.00nan;0;0
989;14259;572;0;0;0;0;.00nan;0;0
989;68167;572;21;27;7;20;.741;3600000;0
989;91202;576;94;23;0;23;1.000;3600000;0
990;320;562;77;20;1;19;.950;3600000;0
990;169493;562;0;0;0;0;.00nan;0;0
990;65014;570;83;32;2;30;.938;3545000;0
990;67626;570;0;0;0;0;.00nan;0;0
991;5559;576;0;0;0;0;.00nan;0;0
991;14259;572;0;0;0;0;.00nan;0;0
991;68167;572;48;18;3;15;.833;3600000;0
991;91202;576;98;25;0;25;1.000;3600000;0
992;320;562;77;35;3;32;.914;3513000;0
992;169493;562;0;0;0;0;.00nan;0;0
992;65014;570;80;26;1;25;.962;3600000;0
992;67626;570;0;0;0;0;.00nan;0;0
1127;320;562;74;27;2;25;.926;3589000;0
1127;169493;562;0;0;0;0;.00nan;0;0
1127;65014;570;86;31;1;30;.968;3600000;0
1127;67626;570;0;0;0;0;.00nan;0;0
1173;64800;568;98;22;0;22;1.000;3600000;0
1173;64923;568;0;0;0;0;.00nan;0;0
1173;65014;570;77;43;4;39;.907;3600000;0
1173;67626;570;0;0;0;0;.00nan;0;0
1174;5559;576;0;0;0;0;.00nan;0;0
1174;91202;576;86;42;3;39;.929;3600000;0
1174;91403;577;87;15;0;15;1.000;3600000;0
1174;143829;577;0;0;0;0;.00nan;0;0
1175;174407;571;0;0;0;0;.00nan;0;0
1175;179602;564;53;27;4;23;.852;3804000;0
1175;78815;564;0;0;0;0;.00nan;0;0
1175;90734;571;93;49;3;46;.939;3804000;0
1176;185232;575;0;0;0;0;.00nan;0;0
1176;56126;574;0;0;0;0;.00nan;0;0
1176;85428;574;53;21;3;18;.857;3600000;0
1176;86347;575;34;27;6;21;.778;3600000;0
1177;64800;568;60;12;1;11;.917;3600000;0
1177;64923;568;0;0;0;0;.00nan;0;0
1177;65014;570;85;47;3;44;.936;3581000;0
1177;67626;570;0;0;0;0;.00nan;0;0
1178;5559;576;50;1;0;1;1.000;279000;0
1178;91202;576;36;27;5;22;.815;3321000;0
1178;91403;577;88;20;0;20;1.000;3600000;0
1178;143829;577;0;0;0;0;.00nan;0;0
1179;174407;571;0;0;0;0;.00nan;0;0
1179;179602;564;100;22;0;22;1.000;3600000;0
1179;78815;564;0;0;0;0;.00nan;0;0
1179;90734;571;88;46;3;43;.935;3600000;0
1180;185232;575;0;0;0;0;.00nan;0;0
1180;56126;574;0;0;0;0;.00nan;0;0
1180;85428;574;100;53;1;52;.981;5235000;0
1180;86347;575;70;32;2;30;.938;5235000;0
1181;64800;568;68;26;2;24;.923;3600000;0
1181;64923;568;0;0;0;0;.00nan;0;0
1181;65014;570;67;33;3;30;.909;3600000;0
1181;67626;570;0;0;0;0;.00nan;0;0
1182;5559;576;59;23;2;21;.913;3173000;0
1182;91202;576;28;7;3;4;.571;412000;0
1182;91403;577;48;20;3;17;.850;3600000;0
1182;143829;577;0;0;0;0;.00nan;0;0
1183;174407;571;0;0;0;0;.00nan;0;0
1183;179602;564;65;17;1;16;.941;3600000;0
1183;78815;564;0;0;0;0;.00nan;0;0
1183;90734;571;82;50;4;46;.920;3600000;0
1184;185232;575;0;0;0;0;.00nan;0;0
1184;56126;574;0;0;0;0;.00nan;0;0
1184;85428;574;64;23;2;21;.913;3600000;0
1184;86347;575;72;46;5;41;.891;3600000;0
1185;64800;568;62;16;1;15;.938;3600000;0
1185;64923;568;0;0;0;0;.00nan;0;0
1185;65014;570;79;42;3;39;.929;3600000;0
1185;67626;570;0;0;0;0;.00nan;0;0
1186;5559;576;0;0;0;0;.00nan;0;0
1186;91202;576;93;36;1;35;.972;3600000;0
1186;91403;577;50;18;2;16;.889;3600000;0
1186;143829;577;0;0;0;0;.00nan;0;0
1187;174407;571;0;0;0;0;.00nan;0;0
1187;179602;564;77;32;2;30;.938;3600000;0
1187;78815;564;0;0;0;0;.00nan;0;0
1187;90734;571;50;37;5;32;.865;3600000;0
1188;185232;575;0;0;0;0;.00nan;0;0
1188;56126;574;0;0;0;0;.00nan;0;0
1188;85428;574;68;28;2;26;.929;3600000;0
1188;86347;575;78;39;3;36;.923;3600000;0
1501;5559;576;0;0;0;0;.00nan;0;0
1501;91202;576;94;44;3;41;.932;3559000;0
1501;91403;577;56;21;2;19;.905;3600000;0
1501;143829;577;0;0;0;0;.00nan;0;0
1502;174407;571;0;0;0;0;.00nan;0;0
1502;179602;564;54;30;4;26;.867;3559000;0
1502;78815;564;0;0;0;0;.00nan;0;0
1502;90734;571;81;38;3;35;.921;3600000;0
1516;174407;571;0;0;0;0;.00nan;0;0
1516;179602;564;90;31;1;30;.968;3600000;0
1516;78815;564;0;0;0;0;.00nan;0;0
1516;90734;571;26;34;6;28;.824;3600000;0
1557;179602;564;74;50;5;45;.900;3520000;0
1557;64800;568;69;29;3;26;.897;3600000;0
1557;64923;568;0;0;0;0;.00nan;0;0
1557;78815;564;0;0;0;0;.00nan;0;0
1558;56126;574;0;0;0;0;.00nan;0;0
1558;85428;574;80;42;4;38;.905;3600000;0
1558;91403;577;67;16;1;15;.938;3600000;0
1558;143829;577;0;0;0;0;.00nan;0;0
1559;179602;564;94;36;1;35;.972;3600000;0
1559;64800;568;33;21;4;17;.810;3600000;0
1559;64923;568;0;0;0;0;.00nan;0;0
1559;78815;564;0;0;0;0;.00nan;0;0
1560;56126;574;0;0;0;0;.00nan;0;0
1560;85428;574;71;38;3;35;.921;3549000;0
1560;91403;577;75;19;1;18;.947;3600000;0
1560;143829;577;0;0;0;0;.00nan;0;0
1561;179602;564;75;21;1;20;.952;3689000;0
1561;64800;568;92;34;2;32;.941;3689000;0
1561;64923;568;0;0;0;0;.00nan;0;0
1561;78815;564;0;0;0;0;.00nan;0;0
1562;56126;574;0;0;0;0;.00nan;0;0
1562;85428;574;100;40;1;39;.975;3600000;0
1562;91403;577;74;23;2;21;.913;3600000;0
1562;143829;577;0;0;0;0;.00nan;0;0
1563;179602;564;100;52;3;49;.942;5021000;0
1563;64800;568;94;49;4;45;.918;5021000;0
1563;64923;568;0;0;0;0;.00nan;0;0
1563;78815;564;0;0;0;0;.00nan;0;0
1564;56126;574;0;0;0;0;.00nan;0;0
1564;85428;574;77;38;3;35;.921;3600000;0
1564;91403;577;46;22;4;18;.818;3585000;0
1564;143829;577;0;0;0;0;.00nan;0;0
1774;179602;564;99;35;1;34;.971;3600000;0
1774;64800;568;58;23;3;20;.870;3514000;0
1774;64923;568;0;0;0;0;.00nan;0;0
1774;78815;564;0;0;0;0;.00nan;0;0
1775;56126;574;0;0;0;0;.00nan;0;0
1775;85428;574;83;38;3;35;.921;3600000;0
1775;91403;577;92;20;0;20;1.000;3600000;0
1775;143829;577;0;0;0;0;.00nan;0;0
1826;56126;574;0;0;0;0;.00nan;0;0
1826;85428;574;64;30;3;27;.900;3538000;0
1826;91403;577;92;34;1;33;.971;3600000;0
1826;143829;577;0;0;0;0;.00nan;0;0
1898;56126;574;0;0;0;0;.00nan;0;0
1898;64800;568;67;25;2;23;.920;4261000;0
1898;64923;568;0;0;0;0;.00nan;0;0
1898;85428;574;91;50;3;47;.940;4261000;0
1899;179602;564;100;31;0;31;1.000;3600000;0
1899;78815;564;0;0;0;0;.00nan;0;0
1899;91403;577;57;29;4;25;.862;3600000;0
1899;143829;577;0;0;0;0;.00nan;0;0
6118;1712;893;0;0;0;0;.00nan;0;0
6118;7624;872;0;0;0;0;.00nan;0;0
6118;164715;872;72;35;3;32;.914;3600000;0
6118;70879;893;91;36;2;34;.944;3600000;0
6119;28831;881;0;0;0;0;.00nan;0;0
6119;57859;883;0;0;0;0;.00nan;0;0
6119;66993;881;44;37;7;30;.811;3600000;0
6119;142911;883;75;38;4;34;.895;3600000;0
6120;28701;882;54;27;3;24;.889;3600000;0
6120;196005;882;0;0;0;0;.00nan;0;0
6120;78596;873;99;23;0;23;1.000;3600000;0
6120;146386;873;0;0;0;0;.00nan;0;0
6121;3077;875;56;25;3;22;.880;3600000;0
6121;63551;892;0;0;0;0;.00nan;0;0
6121;146684;892;96;37;1;36;.973;3600000;0
6121;147567;875;0;0;0;0;.00nan;0;0
6122;3359;878;62;34;4;30;.882;3600000;0
6122;176963;878;0;0;0;0;.00nan;0;0
6122;80834;887;73;24;2;22;.917;3600000;0
6122;159705;887;0;0;0;0;.00nan;0;0
6123;987;886;100;31;0;31;1.000;3600000;0
6123;5354;886;0;0;0;0;.00nan;0;0
6123;20645;885;87;25;1;24;.960;3573000;0
6123;71075;885;0;0;0;0;.00nan;0;0
6124;7037;876;0;0;0;0;.00nan;0;0
6124;11670;876;100;48;2;46;.958;3900000;0
6124;85749;877;0;0;0;0;.00nan;0;0
6124;149858;877;83;30;2;28;.933;3900000;0
6125;987;886;34;24;5;19;.792;3549000;0
6125;1712;893;0;0;0;0;.00nan;0;0
6125;5354;886;0;0;0;0;.00nan;0;0
6125;70879;893;78;40;4;36;.900;3600000;0
6126;7037;876;0;0;0;0;.00nan;0;0
6126;11670;876;63;28;3;25;.893;3600000;0
6126;28701;882;69;46;5;41;.891;3572000;0
6126;196005;882;0;0;0;0;.00nan;0;0
6127;28831;881;0;0;0;0;.00nan;0;0
6127;63551;892;21;23;6;17;.739;2434000;0
6127;66993;881;98;24;0;24;1.000;3600000;0
6127;146684;892;63;11;0;11;1.000;1166000;0
6128;3077;875;0;0;0;0;.00nan;0;0
6128;85749;877;79;22;1;21;.955;3600000;0
6128;147567;875;75;43;4;39;.907;3600000;0
6128;149858;877;0;0;0;0;.00nan;0;0
6129;78596;873;61;29;3;26;.897;3900000;0
6129;80834;887;85;39;3;36;.923;3900000;0
6129;146386;873;0;0;0;0;.00nan;0;0
6129;159705;887;0;0;0;0;.00nan;0;0
6130;3359;878;63;33;4;29;.879;3600000;0
6130;7624;872;0;0;0;0;.00nan;0;0
6130;164715;872;61;43;5;38;.884;3546000;0
6130;176963;878;0;0;0;0;.00nan;0;0
6131;2195;893;0;0;0;0;.00nan;0;0
6131;57859;883;0;0;0;0;.00nan;0;0
6131;70879;893;57;33;4;29;.879;3527000;0
6131;142911;883;96;46;2;44;.957;3600000;0
6132;28701;882;0;0;0;0;.00nan;0;0
6132;36755;882;99;41;2;39;.951;3600000;0
6132;55802;887;37;34;6;28;.824;3600000;0
6132;80834;887;0;0;0;0;.00nan;0;0
6133;3077;875;0;0;0;0;.00nan;0;0
6133;59025;875;58;24;3;21;.875;3600000;0
6133;78596;873;59;41;5;36;.878;3600000;0
6133;146386;873;0;0;0;0;.00nan;0;0
6134;3359;878;0;0;0;0;.00nan;0;0
6134;11670;876;55;37;5;32;.865;3600000;0
6134;176963;878;100;29;0;29;1.000;3600000;0
6134;65762;876;0;0;0;0;.00nan;0;0
6135;20645;885;0;0;0;0;.00nan;0;0
6135;28831;881;0;0;0;0;.00nan;0;0
6135;66993;881;92;42;3;39;.929;3600000;0
6135;85670;885;91;17;0;17;1.000;3600000;0
6136;164715;872;100;34;0;34;1.000;3600000;0
6136;63551;892;62;23;3;20;.870;3600000;0
6136;87798;872;0;0;0;0;.00nan;0;0
6136;146684;892;0;0;0;0;.00nan;0;0
6137;987;886;97;48;3;45;.938;3900000;0
6137;85749;877;79;33;3;30;.909;3900000;0
6137;85797;886;0;0;0;0;.00nan;0;0
6137;149858;877;0;0;0;0;.00nan;0;0
6138;3077;875;0;0;0;0;.00nan;0;0
6138;11670;876;0;0;0;0;.00nan;0;0
6138;59025;875;76;30;2;28;.933;3549000;0
6138;65762;876;86;30;1;29;.967;3600000;0
6139;57859;883;0;0;0;0;.00nan;0;0
6139;63551;892;72;19;1;18;.947;3900000;0
6139;142911;883;95;48;1;47;.979;3900000;0
6139;146684;892;0;0;0;0;.00nan;0;0
6140;28701;882;0;0;0;0;.00nan;0;0
6140;28831;881;50;17;2;15;.882;3600000;0
6140;36755;882;76;36;3;33;.917;3523000;0
6140;66993;881;0;0;0;0;.00nan;0;0
6141;2195;893;0;0;0;0;.00nan;0;0
6141;3359;878;65;33;3;30;.909;3532000;0
6141;176963;878;0;0;0;0;.00nan;0;0
6141;70879;893;87;29;1;28;.966;3600000;0
6142;164715;872;0;0;0;0;.00nan;0;0
6142;55802;887;85;20;0;20;1.000;3900000;0
6142;80834;887;0;0;0;0;.00nan;0;0
6142;87798;872;95;37;0;37;1.000;3900000;0
6143;987;886;79;35;3;32;.914;3684000;0
6143;78596;873;61;26;4;22;.846;3684000;0
6143;85797;886;0;0;0;0;.00nan;0;0
6143;146386;873;0;0;0;0;.00nan;0;0
6144;20645;885;0;0;0;0;.00nan;0;0
6144;85670;885;58;25;3;22;.880;3551000;0
6144;85749;877;75;29;2;27;.931;3600000;0
6144;149858;877;0;0;0;0;.00nan;0;0
6145;11670;876;0;0;0;0;.00nan;0;0
6145;28831;881;0;0;0;0;.00nan;0;0
6145;65762;876;49;9;2;7;.778;3600000;0
6145;66993;881;72;45;5;40;.889;3600000;0
6146;20645;885;0;0;0;0;.00nan;0;0
6146;57859;883;0;0;0;0;.00nan;0;0
6146;85670;885;100;32;1;31;.969;3600000;0
6146;142911;883;64;31;3;28;.903;3600000;0
6147;2195;893;57;29;4;25;.862;3600000;0
6147;28831;881;0;0;0;0;.00nan;0;0
6147;66993;881;74;24;1;23;.958;3600000;0
6147;70879;893;0;0;0;0;.00nan;0;0
6148;987;886;15;18;6;12;.667;1897000;0
6148;28701;882;0;0;0;0;.00nan;0;0
6148;36755;882;100;28;0;28;1.000;3600000;0
6148;85797;886;71;13;0;13;1.000;1703000;0
6149;3077;875;49;37;5;32;.865;3123000;0
6149;57859;883;0;0;0;0;.00nan;0;0
6149;59025;875;17;8;4;4;.500;477000;0
6149;142911;883;58;28;3;25;.893;3600000;0
6150;20645;885;0;0;0;0;.00nan;0;0
6150;55802;887;64;31;4;27;.871;3600000;0
6150;80834;887;0;0;0;0;.00nan;0;0
6150;85670;885;52;39;5;34;.872;3568000;0
6151;3359;878;0;0;0;0;.00nan;0;0
6151;176963;878;50;26;3;23;.885;3557000;0
6151;78596;873;0;0;0;0;.00nan;0;0
6151;146386;873;70;23;2;21;.913;3600000;0
6152;63551;892;0;0;0;0;.00nan;0;0
6152;85749;877;60;37;4;33;.892;3600000;0
6152;146684;892;76;24;1;23;.958;3600000;0
6152;149858;877;0;0;0;0;.00nan;0;0
6153;164715;872;0;0;0;0;.00nan;0;0
6153;11670;876;0;0;0;0;.00nan;0;0
6153;65762;876;86;17;0;17;1.000;3600000;0
6153;87798;872;90;41;2;39;.951;3549000;0
6154;2195;893;64;30;3;27;.900;3600000;0
6154;28701;882;0;0;0;0;.00nan;0;0
6154;36755;882;65;23;2;21;.913;3600000;0
6154;70879;893;0;0;0;0;.00nan;0;0
6155;11670;876;0;0;0;0;.00nan;0;0
6155;55802;887;48;26;4;22;.846;3600000;0
6155;65762;876;100;51;0;51;1.000;3600000;0
6155;80834;887;0;0;0;0;.00nan;0;0
6156;3077;875;0;0;0;0;.00nan;0;0
6156;28831;881;0;0;0;0;.00nan;0;0
6156;59025;875;69;37;3;34;.919;3600000;0
6156;66993;881;39;33;5;28;.848;3569000;0
6157;3359;878;55;30;3;27;.900;3600000;0
6157;20645;885;0;0;0;0;.00nan;0;0
6157;176963;878;0;0;0;0;.00nan;0;0
6157;85670;885;52;30;4;26;.867;3574000;0
6158;63551;892;51;28;4;24;.857;3869000;0
6158;78596;873;58;27;3;24;.889;3869000;0
6158;146386;873;0;0;0;0;.00nan;0;0
6158;146684;892;0;0;0;0;.00nan;0;0
6159;987;886;0;0;0;0;.00nan;0;0
6159;57859;883;0;0;0;0;.00nan;0;0
6159;85797;886;74;32;2;30;.938;3543000;0
6159;142911;883;100;39;1;38;.974;3600000;0
6160;164715;872;0;0;0;0;.00nan;0;0
6160;85749;877;0;0;0;0;.00nan;0;0
6160;87798;872;100;42;2;40;.952;3600000;0
6160;149858;877;62;26;3;23;.885;3543000;0
6161;20645;885;0;0;0;0;.00nan;0;0
6161;28701;882;0;0;0;0;.00nan;0;0
6161;36755;882;92;32;2;30;.938;3600000;0
6161;85670;885;47;19;3;16;.842;3600000;0
6162;11670;876;0;0;0;0;.00nan;0;0
6162;65762;876;79;41;3;38;.927;3600000;0
6162;78596;873;80;35;2;33;.943;3600000;0
6162;146386;873;0;0;0;0;.00nan;0;0
6163;164715;872;0;0;0;0;.00nan;0;0
6163;57859;883;52;29;4;25;.862;3582000;0
6163;87798;872;76;34;2;32;.941;3600000;0
6163;142911;883;0;0;0;0;.00nan;0;0
6164;3359;878;85;29;1;28;.966;3600000;0
6164;28831;881;27;28;6;22;.786;3600000;0
6164;176963;878;0;0;0;0;.00nan;0;0
6164;66993;881;0;0;0;0;.00nan;0;0
6165;987;886;71;25;2;23;.920;3600000;0
6165;63551;892;70;38;3;35;.921;3542000;0
6165;85797;886;0;0;0;0;.00nan;0;0
6165;146684;892;0;0;0;0;.00nan;0;0
6166;3077;875;0;0;0;0;.00nan;0;0
6166;55802;887;0;0;0;0;.00nan;0;0
6166;59025;875;51;29;4;25;.862;3599000;0
6166;80834;887;55;24;3;21;.875;3600000;0
6167;2195;893;45;4;1;3;.750;518000;0
6167;70879;893;32;38;7;31;.816;3082000;0
6167;85749;877;75;25;1;24;.960;3600000;0
6167;149858;877;0;0;0;0;.00nan;0;0
6168;28701;882;0;0;0;0;.00nan;0;0
6168;36755;882;52;40;5;35;.875;3593000;0
6168;57859;883;44;21;4;17;.810;3600000;0
6168;142911;883;0;0;0;0;.00nan;0;0
6169;3077;875;0;0;0;0;.00nan;0;0
6169;3359;878;0;0;0;0;.00nan;0;0
6169;176963;878;68;26;3;23;.885;3900000;0
6169;59025;875;88;43;3;40;.930;3900000;0
6170;11670;876;70;38;4;34;.895;3600000;0
6170;20645;885;0;0;0;0;.00nan;0;0
6170;65762;876;0;0;0;0;.00nan;0;0
6170;85670;885;90;31;1;30;.968;3600000;0
6171;2195;893;0;0;0;0;.00nan;0;0
6171;70879;893;59;19;2;17;.895;3600000;0
6171;78596;873;47;32;5;27;.844;3600000;0
6171;146386;873;0;0;0;0;.00nan;0;0
6172;55802;887;75;30;2;28;.933;3600000;0
6172;63551;892;0;0;0;0;.00nan;0;0
6172;80834;887;0;0;0;0;.00nan;0;0
6172;146684;892;54;22;3;19;.864;3573000;0
6173;28831;881;0;0;0;0;.00nan;0;0
6173;66993;881;79;43;4;39;.907;3600000;0
6173;85749;877;0;0;0;0;.00nan;0;0
6173;149858;877;73;19;1;18;.947;3600000;0
6174;987;886;65;25;2;23;.920;3600000;0
6174;164715;872;0;0;0;0;.00nan;0;0
6174;85797;886;0;0;0;0;.00nan;0;0
6174;87798;872;89;51;4;47;.922;3514000;0
6175;5354;893;0;0;0;0;.00nan;0;0
6175;63551;892;100;31;0;31;1.000;3600000;0
6175;70879;893;48;43;6;37;.860;3600000;0
6175;146684;892;0;0;0;0;.00nan;0;0
6176;55802;887;73;31;3;28;.903;3596000;0
6176;57859;883;0;0;0;0;.00nan;0;0
6176;80834;887;0;0;0;0;.00nan;0;0
6176;142911;883;79;33;2;31;.939;3600000;0
6177;164715;872;100;43;1;42;.977;3600000;0
6177;28831;881;0;0;0;0;.00nan;0;0
6177;66993;881;48;27;4;23;.852;3600000;0
6177;87798;872;0;0;0;0;.00nan;0;0
6178;3077;875;89;34;2;32;.941;3600000;0
6178;20645;885;0;0;0;0;.00nan;0;0
6178;59025;875;0;0;0;0;.00nan;0;0
6178;85670;885;29;20;5;15;.750;3600000;0
6179;3359;878;100;24;0;24;1.000;3600000;0
6179;28701;882;0;0;0;0;.00nan;0;0
6179;176963;878;0;0;0;0;.00nan;0;0
6179;36755;882;70;26;2;24;.923;3600000;0
6180;78596;873;86;31;1;30;.968;3600000;0
6180;85749;877;51;13;2;11;.846;3538000;0
6180;146386;873;0;0;0;0;.00nan;0;0
6180;149858;877;0;0;0;0;.00nan;0;0
6181;987;886;0;0;0;0;.00nan;0;0
6181;11670;876;100;39;0;39;1.000;3600000;0
6181;65762;876;0;0;0;0;.00nan;0;0
6181;69536;886;52;15;2;13;.867;3580000;0
6182;2195;893;0;0;0;0;.00nan;0;0
6182;55802;887;83;33;2;31;.939;3600000;0
6182;70879;893;62;41;6;35;.854;3600000;0
6182;80834;887;0;0;0;0;.00nan;0;0
6183;11670;876;0;0;0;0;.00nan;0;0
6183;57859;883;0;0;0;0;.00nan;0;0
6183;65762;876;58;19;2;17;.895;3577000;0
6183;142911;883;100;41;1;40;.976;3600000;0
6184;20645;885;67;41;4;37;.902;3564000;0
6184;78596;873;93;33;2;31;.939;3600000;0
6184;85670;885;0;0;0;0;.00nan;0;0
6184;146386;873;0;0;0;0;.00nan;0;0
6185;3359;878;62;24;2;22;.917;3600000;0
6185;176963;878;0;0;0;0;.00nan;0;0
6185;63551;892;70;20;1;19;.950;3600000;0
6185;146684;892;0;0;0;0;.00nan;0;0
6186;987;886;0;0;0;0;.00nan;0;0
6186;28831;881;0;0;0;0;.00nan;0;0
6186;66993;881;64;28;3;25;.893;3584000;0
6186;69536;886;62;22;2;20;.909;3600000;0
6187;28701;882;0;0;0;0;.00nan;0;0
6187;36755;882;97;38;1;37;.974;3600000;0
6187;85749;877;55;28;3;25;.893;3571000;0
6187;149858;877;0;0;0;0;.00nan;0;0
6188;3077;875;62;16;1;15;.938;2725000;0
6188;164715;872;0;0;0;0;.00nan;0;0
6188;59025;875;23;10;4;6;.600;808000;0
6188;87798;872;61;30;3;27;.900;3600000;0
6189;28701;882;0;0;0;0;.00nan;0;0
6189;36755;882;88;38;3;35;.921;3900000;0
6189;63551;892;61;31;3;28;.903;3900000;0
6189;146684;892;0;0;0;0;.00nan;0;0
6190;11670;876;0;0;0;0;.00nan;0;0
6190;28831;881;0;0;0;0;.00nan;0;0
6190;65762;876;57;28;3;25;.893;3581000;0
6190;66993;881;87;28;1;27;.964;3600000;0
6191;3077;875;0;0;0;0;.00nan;0;0
6191;8424;893;0;0;0;0;.00nan;0;0
6191;59025;875;41;24;4;20;.833;3600000;0
6191;70879;893;100;51;0;51;1.000;3600000;0
6192;3359;878;84;43;3;40;.930;3600000;0
6192;176963;878;0;0;0;0;.00nan;0;0
6192;85749;877;0;0;0;0;.00nan;0;0
6192;149858;877;37;26;5;21;.808;3520000;0
6193;57859;883;92;34;1;33;.971;3600000;0
6193;78596;873;0;0;0;0;.00nan;0;0
6193;142911;883;0;0;0;0;.00nan;0;0
6193;146386;873;66;31;3;28;.903;3534000;0
6194;987;886;0;0;0;0;.00nan;0;0
6194;55802;887;81;32;2;30;.938;3600000;0
6194;69536;886;60;35;5;30;.857;3600000;0
6194;70213;887;0;0;0;0;.00nan;0;0
6195;164715;872;77;35;3;32;.914;3600000;0
6195;75313;885;0;0;0;0;.00nan;0;0
6195;85670;885;54;18;2;16;.889;3600000;0
6195;87798;872;0;0;0;0;.00nan;0;0
6196;8424;893;74;29;2;27;.931;3559000;0
6196;11670;876;0;0;0;0;.00nan;0;0
6196;65762;876;99;37;1;36;.973;3600000;0
6196;70879;893;0;0;0;0;.00nan;0;0
6197;3359;878;85;30;1;29;.967;3600000;0
6197;176963;878;0;0;0;0;.00nan;0;0
6197;57859;883;0;0;0;0;.00nan;0;0
6197;142911;883;73;40;4;36;.900;3600000;0
6198;164715;872;51;15;2;13;.867;1564000;0
6198;28701;882;0;0;0;0;.00nan;0;0
6198;36755;882;100;27;0;27;1.000;3600000;0
6198;87798;872;18;18;5;13;.722;2036000;0
6199;28831;881;0;0;0;0;.00nan;0;0
6199;66993;881;100;38;0;38;1.000;3900000;0
6199;78596;873;96;29;0;29;1.000;3900000;0
6199;146386;873;0;0;0;0;.00nan;0;0
6200;63551;892;73;27;2;25;.926;3600000;0
6200;75313;885;0;0;0;0;.00nan;0;0
6200;85670;885;73;37;4;33;.892;3545000;0
6200;146684;892;0;0;0;0;.00nan;0;0
6201;55802;887;91;33;1;32;.970;3600000;0
6201;70213;887;0;0;0;0;.00nan;0;0
6201;85749;877;51;28;3;25;.893;3599000;0
6201;149858;877;0;0;0;0;.00nan;0;0
6202;987;886;0;0;0;0;.00nan;0;0
6202;3077;875;0;0;0;0;.00nan;0;0
6202;59025;875;80;37;3;34;.919;3600000;0
6202;69536;886;75;28;2;26;.929;3600000;0
6203;28831;881;80;42;3;39;.929;3557000;0
6203;55802;887;79;24;1;23;.958;3600000;0
6203;66993;881;0;0;0;0;.00nan;0;0
6203;70213;887;0;0;0;0;.00nan;0;0
6204;164715;872;38;30;6;24;.800;2359000;0
6204;11670;876;0;0;0;0;.00nan;0;0
6204;65762;876;62;19;2;17;.895;3600000;0
6204;87798;872;57;10;1;9;.900;1241000;0
6205;11670;876;75;27;2;25;.926;3600000;0
6205;63551;892;53;19;3;16;.842;3564000;0
6205;65762;876;0;0;0;0;.00nan;0;0
6205;146684;892;0;0;0;0;.00nan;0;0
6206;3077;875;0;0;0;0;.00nan;0;0
6206;28701;882;0;0;0;0;.00nan;0;0
6206;36755;882;94;40;2;38;.950;3574000;0
6206;59025;875;92;29;1;28;.966;3600000;0
6207;987;886;0;0;0;0;.00nan;0;0
6207;3359;878;0;0;0;0;.00nan;0;0
6207;176963;878;82;49;4;45;.918;3540000;0
6207;69536;886;71;27;2;25;.926;3600000;0
6208;8424;893;94;34;2;32;.941;3713000;0
6208;70879;893;0;0;0;0;.00nan;0;0
6208;75313;885;0;0;0;0;.00nan;0;0
6208;85670;885;86;33;1;32;.970;3713000;0
6209;57859;883;0;0;0;0;.00nan;0;0
6209;85749;877;0;0;0;0;.00nan;0;0
6209;142911;883;64;37;4;33;.892;3573000;0
6209;149858;877;65;22;2;20;.909;3600000;0
6210;164715;872;0;0;0;0;.00nan;0;0
6210;78596;873;96;14;0;14;1.000;3600000;0
6210;87798;872;69;30;3;27;.900;3600000;0
6210;146386;873;0;0;0;0;.00nan;0;0
6211;28831;881;0;0;0;0;.00nan;0;0
6211;66993;881;69;46;5;41;.891;3595000;0
6211;85749;877;0;0;0;0;.00nan;0;0
6211;149858;877;51;19;3;16;.842;3600000;0
6212;3359;878;75;29;2;27;.931;3600000;0
6212;164715;872;77;31;3;28;.903;3600000;0
6212;176963;878;0;0;0;0;.00nan;0;0
6212;87798;872;0;0;0;0;.00nan;0;0
6213;3077;875;0;0;0;0;.00nan;0;0
6213;59025;875;76;34;3;31;.912;3545000;0
6213;75313;885;0;0;0;0;.00nan;0;0
6213;85670;885;85;17;1;16;.941;3600000;0
6214;11670;876;0;0;0;0;.00nan;0;0
6214;65762;876;63;33;4;29;.879;3588000;0
6214;78596;873;50;23;3;20;.870;3600000;0
6214;146386;873;0;0;0;0;.00nan;0;0
6215;57859;883;0;0;0;0;.00nan;0;0
6215;63551;892;0;0;0;0;.00nan;0;0
6215;142911;883;72;23;1;22;.957;3600000;0
6215;146684;892;70;24;2;22;.917;3552000;0
6216;8424;893;43;44;7;37;.841;3594000;0
6216;55802;887;55;35;5;30;.857;3600000;0
6216;70213;887;0;0;0;0;.00nan;0;0
6216;70879;893;0;0;0;0;.00nan;0;0
6217;987;886;0;0;0;0;.00nan;0;0
6217;28701;882;39;22;4;18;.818;2610000;0
6217;36755;882;22;15;5;10;.667;990000;0
6217;69536;886;79;25;1;24;.960;3600000;0
6218;28701;882;0;0;0;0;.00nan;0;0
6218;36755;882;81;49;4;45;.918;3573000;0
6218;85749;877;0;0;0;0;.00nan;0;0
6218;149858;877;70;23;2;21;.913;3600000;0
6219;3077;875;0;0;0;0;.00nan;0;0
6219;8424;893;78;25;1;24;.960;3600000;0
6219;59025;875;43;33;5;28;.848;3600000;0
6219;70879;893;0;0;0;0;.00nan;0;0
6220;11670;876;0;0;0;0;.00nan;0;0
6220;65762;876;65;39;5;34;.872;3600000;0
6220;75313;885;0;0;0;0;.00nan;0;0
6220;85670;885;90;29;1;28;.966;3600000;0
6221;987;886;0;0;0;0;.00nan;0;0
6221;57859;883;70;40;4;36;.900;3600000;0
6221;69536;886;68;17;1;16;.941;3600000;0
6221;142911;883;0;0;0;0;.00nan;0;0
6222;3359;878;61;21;3;18;.857;3600000;0
6222;28701;882;0;0;0;0;.00nan;0;0
6222;176963;878;0;0;0;0;.00nan;0;0
6222;36755;882;35;27;5;22;.815;3517000;0
6223;28831;881;0;0;0;0;.00nan;0;0
6223;63551;892;65;25;3;22;.880;3645000;0
6223;66993;881;79;42;4;38;.905;3645000;0
6223;146684;892;0;0;0;0;.00nan;0;0
6224;55802;887;0;0;0;0;.00nan;0;0
6224;70213;887;86;29;1;28;.966;3600000;0
6224;78596;873;80;37;3;34;.919;3580000;0
6224;146386;873;0;0;0;0;.00nan;0;0
6225;164715;872;0;0;0;0;.00nan;0;0
6225;85749;877;0;0;0;0;.00nan;0;0
6225;87798;872;85;28;2;26;.929;3513000;0
6225;149858;877;100;29;0;29;1.000;3600000;0
6226;8424;893;97;42;2;40;.952;3600000;0
6226;11670;876;79;35;3;32;.914;3570000;0
6226;65762;876;0;0;0;0;.00nan;0;0
6226;70879;893;0;0;0;0;.00nan;0;0
6227;57859;883;0;0;0;0;.00nan;0;0
6227;75313;885;0;0;0;0;.00nan;0;0
6227;85670;885;71;31;3;28;.903;3550000;0
6227;142911;883;88;34;1;33;.971;3600000;0
6228;987;886;0;0;0;0;.00nan;0;0
6228;28831;881;0;0;0;0;.00nan;0;0
6228;66993;881;76;21;1;20;.952;3900000;0
6228;69536;886;81;31;1;30;.968;3900000;0
6229;3077;875;0;0;0;0;.00nan;0;0
6229;55802;887;66;27;3;24;.889;3715000;0
6229;59025;875;99;48;2;46;.958;3715000;0
6229;70213;887;0;0;0;0;.00nan;0;0
6230;3359;878;53;24;3;21;.875;3600000;0
6230;176963;878;0;0;0;0;.00nan;0;0
6230;78596;873;94;20;0;20;1.000;3600000;0
6230;146386;873;0;0;0;0;.00nan;0;0
6231;164715;872;76;22;1;21;.955;3600000;0
6231;63551;892;80;34;2;32;.941;3541000;0
6231;87798;872;0;0;0;0;.00nan;0;0
6231;146684;892;0;0;0;0;.00nan;0;0
6232;3359;878;0;0;0;0;.00nan;0;0
6232;11670;876;100;28;0;28;1.000;3600000;0
6232;176963;878;59;25;3;22;.880;3600000;0
6232;65762;876;0;0;0;0;.00nan;0;0
6233;8424;893;74;24;1;23;.958;3693000;0
6233;28831;881;0;0;0;0;.00nan;0;0
6233;66993;881;79;30;2;28;.933;3693000;0
6233;70879;893;0;0;0;0;.00nan;0;0
6234;63551;892;67;29;2;27;.931;3600000;0
6234;75313;885;16;21;6;15;.714;2038000;0
6234;85670;885;60;12;1;11;.917;1562000;0
6234;146684;892;0;0;0;0;.00nan;0;0
6235;28701;882;0;0;0;0;.00nan;0;0
6235;36755;882;73;34;3;31;.912;3600000;0
6235;78596;873;100;37;0;37;1.000;3600000;0
6235;146386;873;0;0;0;0;.00nan;0;0
6236;55802;887;91;32;2;30;.938;3600000;0
6236;57859;883;0;0;0;0;.00nan;0;0
6236;70213;887;0;0;0;0;.00nan;0;0
6236;142911;883;57;26;3;23;.885;3600000;0
6237;987;886;0;0;0;0;.00nan;0;0
6237;164715;872;0;0;0;0;.00nan;0;0
6237;69536;886;56;15;2;13;.867;3600000;0
6237;87798;872;83;39;3;36;.923;3551000;0
6238;14266;875;79;28;1;27;.964;3780000;0
6238;59025;875;0;0;0;0;.00nan;0;0
6238;85749;877;0;0;0;0;.00nan;0;0
6238;149858;877;51;18;2;16;.889;3780000;0
6239;8424;893;62;42;5;37;.881;3586000;0
6239;70879;893;0;0;0;0;.00nan;0;0
6239;78596;873;58;32;4;28;.875;3600000;0
6239;146386;873;0;0;0;0;.00nan;0;0
6240;28701;882;0;0;0;0;.00nan;0;0
6240;36755;882;97;40;1;39;.975;3541000;0
6240;57859;883;96;20;0;20;1.000;3600000;0
6240;142911;883;0;0;0;0;.00nan;0;0
6241;11670;876;0;0;0;0;.00nan;0;0
6241;14266;875;52;32;4;28;.875;3600000;0
6241;59025;875;0;0;0;0;.00nan;0;0
6241;65762;876;50;32;5;27;.844;3600000;0
6242;3359;878;0;0;0;0;.00nan;0;0
6242;176963;878;100;33;0;33;1.000;3600000;0
6242;75313;885;0;0;0;0;.00nan;0;0
6242;85670;885;79;23;1;22;.957;3578000;0
6243;55802;887;65;31;3;28;.903;3600000;0
6243;63551;892;49;31;5;26;.839;3562000;0
6243;70213;887;0;0;0;0;.00nan;0;0
6243;146684;892;0;0;0;0;.00nan;0;0
6244;987;886;100;54;1;53;.981;3900000;0
6244;69536;886;0;0;0;0;.00nan;0;0
6244;85749;877;0;0;0;0;.00nan;0;0
6244;149858;877;90;29;1;28;.966;3900000;0
6245;164715;872;96;50;3;47;.940;3900000;0
6245;28831;881;0;0;0;0;.00nan;0;0
6245;66993;881;71;29;3;26;.897;3900000;0
6245;87798;872;0;0;0;0;.00nan;0;0
6246;3359;878;0;0;0;0;.00nan;0;0
6246;8424;893;67;27;3;24;.889;3600000;0
6246;176963;878;55;32;4;28;.875;3600000;0
6246;70879;893;0;0;0;0;.00nan;0;0
6247;164715;872;0;0;0;0;.00nan;0;0
6247;11670;876;100;32;0;32;1.000;3600000;0
6247;65762;876;0;0;0;0;.00nan;0;0
6247;87798;872;78;29;2;27;.931;3600000;0
6248;57859;883;0;0;0;0;.00nan;0;0
6248;85749;877;0;0;0;0;.00nan;0;0
6248;142911;883;89;34;1;33;.971;3600000;0
6248;149858;877;48;21;3;18;.857;3536000;0
6249;14266;875;74;30;3;27;.900;3600000;0
6249;28701;882;0;0;0;0;.00nan;0;0
6249;36755;882;66;34;4;30;.882;3562000;0
6249;59025;875;0;0;0;0;.00nan;0;0
6250;75313;885;0;0;0;0;.00nan;0;0
6250;78596;873;100;29;0;29;1.000;3600000;0
6250;85670;885;71;37;3;34;.919;3600000;0
6250;146386;873;0;0;0;0;.00nan;0;0
6251;28831;881;0;0;0;0;.00nan;0;0
6251;55802;887;55;27;3;24;.889;3600000;0
6251;66993;881;65;38;6;32;.842;3600000;0
6251;70213;887;0;0;0;0;.00nan;0;0
6252;987;886;0;0;0;0;.00nan;0;0
6252;63551;892;74;36;3;33;.917;3546000;0
6252;69536;886;69;26;2;24;.923;3600000;0
6252;146684;892;0;0;0;0;.00nan;0;0
6253;11670;876;71;40;4;36;.900;3540000;0
6253;65762;876;0;0;0;0;.00nan;0;0
6253;85749;877;80;31;2;29;.935;3600000;0
6253;149858;877;0;0;0;0;.00nan;0;0
6254;8424;893;85;37;3;34;.919;3900000;0
6254;28701;882;0;0;0;0;.00nan;0;0
6254;36755;882;81;36;3;33;.917;3900000;0
6254;70879;893;0;0;0;0;.00nan;0;0
6255;28831;881;67;22;2;20;.909;3569000;0
6255;66993;881;0;0;0;0;.00nan;0;0
6255;78596;873;100;29;0;29;1.000;3600000;0
6255;146386;873;0;0;0;0;.00nan;0;0
6256;14266;875;77;42;3;39;.929;3900000;0
6256;59025;875;0;0;0;0;.00nan;0;0
6256;63551;892;57;31;3;28;.903;3900000;0
6256;146684;892;0;0;0;0;.00nan;0;0
6257;987;886;0;0;0;0;.00nan;0;0
6257;69536;886;70;27;3;24;.889;3784000;0
6257;75313;885;0;0;0;0;.00nan;0;0
6257;85670;885;73;23;2;21;.913;3784000;0
6258;164715;872;0;0;0;0;.00nan;0;0
6258;57859;883;83;24;1;23;.958;3600000;0
6258;87798;872;68;29;3;26;.897;3517000;0
6258;142911;883;0;0;0;0;.00nan;0;0
6259;3359;878;66;26;2;24;.923;3125000;0
6259;176963;878;28;15;4;11;.733;475000;0
6259;55802;887;72;30;3;27;.900;3600000;0
6259;70213;887;0;0;0;0;.00nan;0;0
6260;11670;876;67;27;3;24;.889;3563000;0
6260;28831;881;0;0;0;0;.00nan;0;0
6260;65762;876;0;0;0;0;.00nan;0;0
6260;66993;881;94;35;1;34;.971;3600000;0
6261;164715;872;0;0;0;0;.00nan;0;0
6261;75313;885;0;0;0;0;.00nan;0;0
6261;85670;885;60;33;4;29;.879;3600000;0
6261;87798;872;93;31;1;30;.968;3600000;0
6262;14266;875;82;25;1;24;.960;3600000;0
6262;59025;875;0;0;0;0;.00nan;0;0
6262;78596;873;48;25;4;21;.840;3600000;0
6262;146386;873;0;0;0;0;.00nan;0;0
6263;28701;882;0;0;0;0;.00nan;0;0
6263;36755;882;97;42;3;39;.929;3600000;0
6263;63551;892;0;0;0;0;.00nan;0;0
6263;146684;892;72;22;1;21;.955;3600000;0
6264;987;886;0;0;0;0;.00nan;0;0
6264;8424;893;79;32;3;29;.906;3769000;0
6264;69536;886;76;28;2;26;.929;3769000;0
6264;70879;893;0;0;0;0;.00nan;0;0
6265;55802;887;46;27;4;23;.852;3600000;0
6265;70213;887;0;0;0;0;.00nan;0;0
6265;85749;877;0;0;0;0;.00nan;0;0
6265;149858;877;62;15;1;14;.933;3600000;0
6266;8424;893;72;31;4;27;.871;3600000;0
6266;70879;893;0;0;0;0;.00nan;0;0
6266;85749;877;0;0;0;0;.00nan;0;0
6266;149858;877;64;25;2;23;.920;3600000;0
6267;57859;883;0;0;0;0;.00nan;0;0
6267;78596;873;61;38;4;34;.895;3900000;0
6267;142911;883;60;31;4;27;.871;3900000;0
6267;146386;873;0;0;0;0;.00nan;0;0
6268;28831;881;0;0;0;0;.00nan;0;0
6268;66993;881;6;24;8;16;.667;3600000;0
6268;75313;885;0;0;0;0;.00nan;0;0
6268;85670;885;73;31;2;29;.935;3600000;0
6269;987;886;0;0;0;0;.00nan;0;0
6269;14266;875;52;29;4;25;.862;3637000;0
6269;59025;875;0;0;0;0;.00nan;0;0
6269;69536;886;60;35;5;30;.857;3637000;0
6270;3359;878;87;47;4;43;.915;3600000;0
6270;176963;878;0;0;0;0;.00nan;0;0
6270;63551;892;91;27;1;26;.963;3600000;0
6270;146684;892;0;0;0;0;.00nan;0;0
6271;11670;876;78;39;4;35;.897;3600000;0
6271;55802;887;54;33;5;28;.848;3569000;0
6271;65762;876;0;0;0;0;.00nan;0;0
6271;70213;887;0;0;0;0;.00nan;0;0
6272;164715;872;0;0;0;0;.00nan;0;0
6272;28701;882;0;0;0;0;.00nan;0;0
6272;36755;882;92;32;2;30;.938;3600000;0
6272;87798;872;45;26;4;22;.846;3541000;0
6273;8424;893;73;32;3;29;.906;3545000;0
6273;57859;883;0;0;0;0;.00nan;0;0
6273;70879;893;0;0;0;0;.00nan;0;0
6273;142911;883;91;34;1;33;.971;3600000;0
6274;28701;882;0;0;0;0;.00nan;0;0
6274;28831;881;0;0;0;0;.00nan;0;0
6274;36755;882;100;30;0;30;1.000;3600000;0
6274;66993;881;81;41;5;36;.878;3600000;0
6275;164715;872;0;0;0;0;.00nan;0;0
6275;14266;875;53;41;5;36;.878;3600000;0
6275;59025;875;0;0;0;0;.00nan;0;0
6275;87798;872;100;25;0;25;1.000;3600000;0
6276;987;886;0;0;0;0;.00nan;0;0
6276;69536;886;61;22;2;20;.909;3600000;0
6276;78596;873;0;0;0;0;.00nan;0;0
6276;146386;873;56;29;4;25;.862;3574000;0
6277;11670;876;85;38;2;36;.947;3549000;0
6277;63551;892;0;0;0;0;.00nan;0;0
6277;65762;876;0;0;0;0;.00nan;0;0
6277;146684;892;80;19;1;18;.947;3600000;0
6278;55802;887;0;0;0;0;.00nan;0;0
6278;70213;887;64;14;1;13;.929;3620000;0
6278;75313;885;0;0;0;0;.00nan;0;0
6278;85670;885;93;34;2;32;.941;3620000;0
6279;3359;878;81;54;6;48;.889;3600000;0
6279;176963;878;0;0;0;0;.00nan;0;0
6279;85749;877;82;25;1;24;.960;3600000;0
6279;149858;877;0;0;0;0;.00nan;0;0
6280;14266;875;55;30;4;26;.867;3600000;0
6280;57859;883;0;0;0;0;.00nan;0;0
6280;59025;875;0;0;0;0;.00nan;0;0
6280;142911;883;100;38;1;37;.974;3600000;0
6281;11670;876;88;28;1;27;.964;3600000;0
6281;28701;882;74;38;4;34;.895;3600000;0
6281;36755;882;0;0;0;0;.00nan;0;0
6281;65762;876;0;0;0;0;.00nan;0;0
6282;3359;878;0;0;0;0;.00nan;0;0
6282;28831;881;0;0;0;0;.00nan;0;0
6282;176963;878;93;30;1;29;.967;3600000;0
6282;66993;881;84;35;2;33;.943;3545000;0
6283;75313;885;90;48;2;46;.958;3600000;0
6283;85670;885;0;0;0;0;.00nan;0;0
6283;85749;877;0;0;0;0;.00nan;0;0
6283;149858;877;38;33;6;27;.818;3600000;0
6284;63551;892;0;0;0;0;.00nan;0;0
6284;78596;873;85;47;4;43;.915;3600000;0
6284;146386;873;0;0;0;0;.00nan;0;0
6284;146684;892;74;25;1;24;.960;3600000;0
6285;987;886;0;0;0;0;.00nan;0;0
6285;55802;887;75;29;3;26;.897;3600000;0
6285;69536;886;67;34;4;30;.882;3600000;0
6285;70213;887;0;0;0;0;.00nan;0;0
6286;8424;893;69;19;1;18;.947;3600000;0
6286;164715;872;0;0;0;0;.00nan;0;0
6286;70879;893;0;0;0;0;.00nan;0;0
6286;87798;872;72;33;3;30;.909;3600000;0
6287;8424;893;68;26;2;24;.923;3600000;0
6287;70879;893;0;0;0;0;.00nan;0;0
6287;75313;885;0;0;0;0;.00nan;0;0
6287;85670;885;45;27;4;23;.852;3580000;0
6288;11670;876;30;33;7;26;.788;3116000;0
6288;57859;883;82;27;1;26;.963;3600000;0
6288;65762;876;57;6;0;6;1.000;484000;0
6288;142911;883;0;0;0;0;.00nan;0;0
6289;14266;875;62;28;3;25;.893;3562000;0
6289;28831;881;74;28;2;26;.929;3600000;0
6289;59025;875;0;0;0;0;.00nan;0;0
6289;66993;881;0;0;0;0;.00nan;0;0
6290;164715;872;0;0;0;0;.00nan;0;0
6290;78596;873;59;12;1;11;.917;3600000;0
6290;87798;872;79;41;3;38;.927;3580000;0
6290;146386;873;0;0;0;0;.00nan;0;0
6291;28701;882;0;0;0;0;.00nan;0;0
6291;36755;882;82;41;3;38;.927;3600000;0
6291;55802;887;37;27;5;22;.815;3540000;0
6291;70213;887;0;0;0;0;.00nan;0;0
6292;987;886;42;25;4;21;.840;3900000;0
6292;3359;878;58;27;4;23;.852;3900000;0
6292;176963;878;0;0;0;0;.00nan;0;0
6292;69536;886;0;0;0;0;.00nan;0;0
6293;63551;892;77;30;2;28;.933;3554000;0
6293;85749;877;0;0;0;0;.00nan;0;0
6293;146684;892;0;0;0;0;.00nan;0;0
6293;149858;877;100;35;0;35;1.000;3600000;0
6294;8424;893;41;23;4;19;.826;3535000;0
6294;70879;893;0;0;0;0;.00nan;0;0
6294;75313;885;0;0;0;0;.00nan;0;0
6294;85670;885;90;38;2;36;.947;3600000;0
6295;987;886;0;0;0;0;.00nan;0;0
6295;11670;876;100;35;1;34;.971;3600000;0
6295;65762;876;0;0;0;0;.00nan;0;0
6295;69536;886;57;18;2;16;.889;3560000;0
6296;28701;882;0;0;0;0;.00nan;0;0
6296;28831;881;0;0;0;0;.00nan;0;0
6296;36755;882;60;29;4;25;.862;3575000;0
6296;66993;881;75;36;2;34;.944;3600000;0
6297;57859;883;0;0;0;0;.00nan;0;0
6297;63551;892;71;26;2;24;.923;3600000;0
6297;142911;883;53;30;4;26;.867;3591000;0
6297;146684;892;0;0;0;0;.00nan;0;0
6298;164715;872;60;28;3;25;.893;3546000;0
6298;55802;887;67;29;2;27;.931;3600000;0
6298;70213;887;0;0;0;0;.00nan;0;0
6298;87798;872;0;0;0;0;.00nan;0;0
6299;28701;882;0;0;0;0;.00nan;0;0
6299;36755;882;67;45;5;40;.889;3600000;0
6299;75313;885;0;0;0;0;.00nan;0;0
6299;85670;885;77;24;1;23;.958;3600000;0
6300;28831;881;0;0;0;0;.00nan;0;0
6300;57859;883;50;28;4;24;.857;3585000;0
6300;66993;881;79;34;3;31;.912;3600000;0
6300;142911;883;0;0;0;0;.00nan;0;0
6301;3359;878;91;30;1;29;.967;3600000;0
6301;14266;875;87;31;2;29;.935;3585000;0
6301;176963;878;0;0;0;0;.00nan;0;0
6301;59025;875;0;0;0;0;.00nan;0;0
6302;8424;893;39;33;6;27;.818;3600000;0
6302;63551;892;100;45;3;42;.933;3600000;0
6302;70879;893;0;0;0;0;.00nan;0;0
6302;146684;892;0;0;0;0;.00nan;0;0
6303;78596;873;95;36;2;34;.944;3590000;0
6303;85749;877;0;0;0;0;.00nan;0;0
6303;146386;873;0;0;0;0;.00nan;0;0
6303;149858;877;81;24;1;23;.958;3600000;0
6304;164715;872;0;0;0;0;.00nan;0;0
6304;55802;887;100;35;0;35;1.000;3600000;0
6304;70213;887;0;0;0;0;.00nan;0;0
6304;87798;872;82;32;2;30;.938;3562000;0
6305;8424;893;70;28;2;26;.929;3600000;0
6305;14266;875;67;33;4;29;.879;3517000;0
6305;59025;875;0;0;0;0;.00nan;0;0
6305;70879;893;0;0;0;0;.00nan;0;0
6306;3359;878;49;46;7;39;.848;3600000;0
6306;28701;882;0;0;0;0;.00nan;0;0
6306;176963;878;0;0;0;0;.00nan;0;0
6306;36755;882;87;31;1;30;.968;3600000;0
6307;57859;883;0;0;0;0;.00nan;0;0
6307;75313;885;0;0;0;0;.00nan;0;0
6307;85670;885;83;31;2;29;.935;3600000;0
6307;142911;883;46;29;4;25;.862;3561000;0
6308;28831;881;0;0;0;0;.00nan;0;0
6308;66993;881;97;39;3;36;.923;3900000;0
6308;78596;873;75;28;3;25;.893;3885000;0
6308;146386;873;0;0;0;0;.00nan;0;0
6309;55802;887;73;38;4;34;.895;3592000;0
6309;63551;892;65;28;3;25;.893;3600000;0
6309;70213;887;0;0;0;0;.00nan;0;0
6309;146684;892;0;0;0;0;.00nan;0;0
6310;987;886;100;34;1;33;.971;3600000;0
6310;69536;886;0;0;0;0;.00nan;0;0
6310;85749;877;0;0;0;0;.00nan;0;0
6310;149858;877;56;31;4;27;.871;3600000;0
6311;8424;893;0;0;0;0;.00nan;0;0
6311;63551;892;60;25;3;22;.880;3600000;0
6311;70879;893;28;25;5;20;.800;3600000;0
6311;146684;892;0;0;0;0;.00nan;0;0
6312;164715;872;0;0;0;0;.00nan;0;0
6312;57859;883;0;0;0;0;.00nan;0;0
6312;87798;872;91;29;1;28;.966;3600000;0
6312;142911;883;49;25;4;21;.840;3600000;0
6313;75313;885;0;0;0;0;.00nan;0;0
6313;78596;873;100;32;0;32;1.000;3600000;0
6313;85670;885;44;25;4;21;.840;3600000;0
6313;146386;873;0;0;0;0;.00nan;0;0
6314;3359;878;89;55;5;50;.909;3900000;0
6314;176963;878;0;0;0;0;.00nan;0;0
6314;55802;887;84;21;0;21;1.000;2000000;0
6314;70213;887;21;15;5;10;.667;1900000;0
6315;987;886;85;26;1;25;.962;3600000;0
6315;14266;875;74;34;3;31;.912;3550000;0
6315;59025;875;0;0;0;0;.00nan;0;0
6315;69536;886;0;0;0;0;.00nan;0;0
6316;28701;882;0;0;0;0;.00nan;0;0
6316;36755;882;74;47;5;42;.894;3524000;0
6316;85749;877;0;0;0;0;.00nan;0;0
6316;149858;877;59;28;3;25;.893;3600000;0
6317;987;886;0;0;0;0;.00nan;0;0
6317;3359;878;95;37;2;35;.946;3900000;0
6317;176963;878;0;0;0;0;.00nan;0;0
6317;69536;886;79;27;2;25;.926;3900000;0
6318;8424;893;78;30;2;28;.933;3740000;0
6318;11670;876;86;23;1;22;.957;3740000;0
6318;65762;876;0;0;0;0;.00nan;0;0
6318;70879;893;0;0;0;0;.00nan;0;0
6319;28701;882;0;0;0;0;.00nan;0;0
6319;36755;882;81;46;4;42;.913;3600000;0
6319;55802;887;35;26;5;21;.808;3572000;0
6319;70213;887;0;0;0;0;.00nan;0;0
6320;14266;875;82;31;1;30;.968;3629000;0
6320;59025;875;0;0;0;0;.00nan;0;0
6320;75313;885;0;0;0;0;.00nan;0;0
6320;85670;885;93;31;2;29;.935;3629000;0
6321;57859;883;59;30;3;27;.900;3545000;0
6321;78596;873;65;23;2;21;.913;3600000;0
6321;142911;883;0;0;0;0;.00nan;0;0
6321;146386;873;0;0;0;0;.00nan;0;0
6322;987;886;0;0;0;0;.00nan;0;0
6322;63551;892;0;0;0;0;.00nan;0;0
6322;69536;886;87;27;1;26;.963;3900000;0
6322;146684;892;78;29;1;28;.966;3900000;0
6323;28831;881;0;0;0;0;.00nan;0;0
6323;66993;881;90;35;2;33;.943;3600000;0
6323;85749;877;74;21;1;20;.952;3600000;0
6323;149858;877;0;0;0;0;.00nan;0;0
6324;3359;878;54;26;4;22;.846;3600000;0
6324;164715;872;0;0;0;0;.00nan;0;0
6324;176963;878;0;0;0;0;.00nan;0;0
6324;87798;872;61;21;2;19;.905;3600000;0
6325;28831;881;0;0;0;0;.00nan;0;0
6325;57859;883;64;32;3;29;.906;3573000;0
6325;66993;881;71;26;2;24;.923;3600000;0
6325;142911;883;0;0;0;0;.00nan;0;0
6326;28701;882;0;0;0;0;.00nan;0;0
6326;36755;882;88;33;2;31;.939;3574000;0
6326;63551;892;81;26;1;25;.962;3600000;0
6326;146684;892;0;0;0;0;.00nan;0;0
6327;14266;875;79;34;2;32;.941;3600000;0
6327;59025;875;0;0;0;0;.00nan;0;0
6327;85749;877;0;0;0;0;.00nan;0;0
6327;149858;877;40;27;5;22;.815;3600000;0
6328;3359;878;0;0;0;0;.00nan;0;0
6328;11670;876;66;28;3;25;.893;3600000;0
6328;176963;878;100;30;0;30;1.000;3600000;0
6328;65762;876;0;0;0;0;.00nan;0;0
6329;55802;887;64;20;2;18;.900;3600000;0
6329;70213;887;0;0;0;0;.00nan;0;0
6329;75313;885;0;0;0;0;.00nan;0;0
6329;85670;885;66;44;5;39;.886;3600000;0
6330;8424;893;100;31;0;31;1.000;3600000;0
6330;70879;893;0;0;0;0;.00nan;0;0
6330;78596;873;81;30;2;28;.933;3569000;0
6330;146386;873;0;0;0;0;.00nan;0;0
6331;987;886;0;0;0;0;.00nan;0;0
6331;164715;872;93;39;2;37;.949;3567000;0
6331;69536;886;75;19;1;18;.947;3600000;0
6331;87798;872;0;0;0;0;.00nan;0;0
6332;55802;887;58;27;3;24;.889;3600000;0
6332;70213;887;0;0;0;0;.00nan;0;0
6332;85749;877;0;0;0;0;.00nan;0;0
6332;149858;877;78;32;2;30;.938;3600000;0
6333;8424;893;84;42;4;38;.905;3874000;0
6333;164715;872;0;0;0;0;.00nan;0;0
6333;70879;893;0;0;0;0;.00nan;0;0
6333;87798;872;71;41;4;37;.902;3900000;0
6334;11670;876;70;21;1;20;.952;845000;0
6334;65762;876;32;34;6;28;.824;3001000;0
6334;78596;873;37;30;6;24;.800;3846000;0
6334;146386;873;0;0;0;0;.00nan;0;0
6335;3359;878;0;0;0;0;.00nan;0;0
6335;28831;881;0;0;0;0;.00nan;0;0
6335;176963;878;78;23;1;22;.957;3600000;0
6335;66993;881;98;56;4;52;.929;3600000;0
6336;28701;882;0;0;0;0;.00nan;0;0
6336;36755;882;90;51;3;48;.941;3900000;0
6336;75313;885;72;33;3;30;.909;3900000;0
6336;85670;885;0;0;0;0;.00nan;0;0
6337;14266;875;100;39;2;37;.949;3900000;0
6337;59025;875;0;0;0;0;.00nan;0;0
6337;63551;892;0;0;0;0;.00nan;0;0
6337;146684;892;67;30;2;28;.933;3900000;0
6338;55802;887;84;38;3;35;.921;3600000;0
6338;70213;887;0;0;0;0;.00nan;0;0
6338;85749;877;0;0;0;0;.00nan;0;0
6338;149858;877;70;23;3;20;.870;3547000;0
6339;987;886;99;25;0;25;1.000;3600000;0
6339;57859;883;0;0;0;0;.00nan;0;0
6339;69536;886;0;0;0;0;.00nan;0;0
6339;142911;883;82;46;3;43;.935;3600000;0
6340;11670;876;62;37;4;33;.892;3600000;0
6340;55802;887;13;25;7;18;.720;1924000;0
6340;65762;876;0;0;0;0;.00nan;0;0
6340;70213;887;43;22;4;18;.818;1676000;0
6341;14266;875;57;21;2;19;.905;3600000;0
6341;57859;883;0;0;0;0;.00nan;0;0
6341;59025;875;0;0;0;0;.00nan;0;0
6341;142911;883;70;33;3;30;.909;3580000;0
6342;3359;878;46;32;5;27;.844;3600000;0
6342;176963;878;0;0;0;0;.00nan;0;0
6342;78596;873;0;0;0;0;.00nan;0;0
6342;146386;873;98;20;0;20;1.000;3600000;0
6343;63551;892;0;0;0;0;.00nan;0;0
6343;75313;885;0;0;0;0;.00nan;0;0
6343;85670;885;57;35;4;31;.886;3600000;0
6343;146684;892;100;30;0;30;1.000;3600000;0
6344;987;886;61;21;3;18;.857;3600000;0
6344;28831;881;0;0;0;0;.00nan;0;0
6344;66993;881;100;41;0;41;1.000;3600000;0
6344;69536;886;0;0;0;0;.00nan;0;0
6345;8424;893;82;35;3;32;.914;3600000;0
6345;70879;893;0;0;0;0;.00nan;0;0
6345;85749;877;0;0;0;0;.00nan;0;0
6345;149858;877;60;35;4;31;.886;3546000;0
6346;164715;872;0;0;0;0;.00nan;0;0
6346;28701;882;0;0;0;0;.00nan;0;0
6346;36755;882;100;35;0;35;1.000;3600000;0
6346;87798;872;42;37;6;31;.838;3600000;0
6347;3359;878;0;0;0;0;.00nan;0;0
6347;176963;878;44;19;3;16;.842;3600000;0
6347;57859;883;0;0;0;0;.00nan;0;0
6347;142911;883;64;38;4;34;.895;3597000;0
6348;987;886;0;0;0;0;.00nan;0;0
6348;8424;893;0;0;0;0;.00nan;0;0
6348;69536;886;81;13;0;13;1.000;3600000;0
6348;70879;893;61;45;5;40;.889;3600000;0
6349;3359;878;0;0;0;0;.00nan;0;0
6349;176963;878;48;32;5;27;.844;3600000;0
6349;57859;883;79;33;2;31;.939;3600000;0
6349;142911;883;0;0;0;0;.00nan;0;0
6350;28701;882;0;0;0;0;.00nan;0;0
6350;28831;881;0;0;0;0;.00nan;0;0
6350;36755;882;85;37;3;34;.919;3550000;0
6350;66993;881;73;26;2;24;.923;3600000;0
6351;63551;892;100;30;0;30;1.000;3600000;0
6351;78596;873;0;0;0;0;.00nan;0;0
6351;146386;873;47;30;4;26;.867;3600000;0
6351;146684;892;0;0;0;0;.00nan;0;0
6352;14266;875;44;26;5;21;.808;3546000;0
6352;55802;887;77;32;4;28;.875;3600000;0
6352;59025;875;0;0;0;0;.00nan;0;0
6352;70213;887;0;0;0;0;.00nan;0;0
6353;11670;876;96;37;1;36;.973;3900000;0
6353;65762;876;0;0;0;0;.00nan;0;0
6353;85749;877;0;0;0;0;.00nan;0;0
6353;149858;877;68;21;1;20;.952;3900000;0
6354;164715;872;0;0;0;0;.00nan;0;0
6354;75313;885;0;0;0;0;.00nan;0;0
6354;85670;885;62;25;2;23;.920;3595000;0
6354;87798;872;90;31;1;30;.968;3600000;0
6355;8424;893;83;23;1;22;.957;3600000;0
6355;55802;887;49;36;6;30;.833;3600000;0
6355;70213;887;0;0;0;0;.00nan;0;0
6355;70879;893;0;0;0;0;.00nan;0;0
6356;28701;882;0;0;0;0;.00nan;0;0
6356;36755;882;75;34;3;31;.912;3600000;0
6356;57859;883;0;0;0;0;.00nan;0;0
6356;142911;883;46;27;4;23;.852;3600000;0
6357;3359;878;100;38;1;37;.974;3830000;0
6357;14266;875;0;0;0;0;.00nan;0;0
6357;176963;878;0;0;0;0;.00nan;0;0
6357;59025;875;79;32;2;30;.938;3830000;0
6358;28831;881;0;0;0;0;.00nan;0;0
6358;66993;881;87;29;2;27;.931;3660000;0
6358;75313;885;0;0;0;0;.00nan;0;0
6358;85670;885;86;24;1;23;.958;3660000;0
6359;63551;892;100;21;0;21;1.000;3600000;0
6359;85749;877;0;0;0;0;.00nan;0;0
6359;146684;892;0;0;0;0;.00nan;0;0
6359;149858;877;75;40;4;36;.900;3600000;0
6360;987;886;0;0;0;0;.00nan;0;0
6360;11670;876;63;36;3;33;.917;3900000;0
6360;65762;876;0;0;0;0;.00nan;0;0
6360;69536;886;71;32;3;29;.906;3900000;0
6361;164715;872;0;0;0;0;.00nan;0;0
6361;78596;873;0;0;0;0;.00nan;0;0
6361;87798;872;77;32;2;30;.938;3600000;0
6361;146386;873;45;25;4;21;.840;3539000;0
6362;8424;893;0;0;0;0;.00nan;0;0
6362;70879;893;37;35;6;29;.829;3600000;0
6362;85749;877;0;0;0;0;.00nan;0;0
6362;149858;877;100;35;0;35;1.000;3600000;0
6363;164715;872;0;0;0;0;.00nan;0;0
6363;14266;875;69;28;2;26;.929;3600000;0
6363;59025;875;0;0;0;0;.00nan;0;0
6363;87798;872;74;32;3;29;.906;3599000;0
6364;11670;876;0;0;0;0;.00nan;0;0
6364;65762;876;67;32;3;29;.906;3592000;0
6364;78596;873;91;33;2;31;.939;3600000;0
6364;146386;873;0;0;0;0;.00nan;0;0
6365;11670;876;0;0;0;0;.00nan;0;0
6365;63551;892;93;19;0;19;1.000;3600000;0
6365;65762;876;82;46;3;43;.935;3600000;0
6365;146684;892;0;0;0;0;.00nan;0;0
6366;55802;887;94;30;1;29;.967;3600000;0
6366;57859;883;0;0;0;0;.00nan;0;0
6366;70213;887;0;0;0;0;.00nan;0;0
6366;142911;883;58;29;3;26;.897;3525000;0
6367;164715;872;0;0;0;0;.00nan;0;0
6367;28831;881;0;0;0;0;.00nan;0;0
6367;66993;881;92;30;1;29;.967;3900000;0
6367;87798;872;97;41;1;40;.976;3900000;0
6368;14266;875;35;26;6;20;.769;2958000;0
6368;28701;882;0;0;0;0;.00nan;0;0
6368;36755;882;52;26;3;23;.885;3600000;0
6368;59025;875;53;3;0;3;1.000;642000;0
6369;3359;878;55;35;5;30;.857;3600000;0
6369;8424;893;28;29;6;23;.793;2984000;0
6369;176963;878;0;0;0;0;.00nan;0;0
6369;70879;893;52;4;0;4;1.000;586000;0
6370;987;886;65;27;2;25;.926;3600000;0
6370;69536;886;0;0;0;0;.00nan;0;0
6370;78596;873;34;26;5;21;.808;2247000;0
6370;146386;873;59;6;0;6;1.000;1353000;0
6371;75313;885;0;0;0;0;.00nan;0;0
6371;85670;885;94;35;3;32;.914;3600000;0
6371;85749;877;0;0;0;0;.00nan;0;0
6371;149858;877;45;22;4;18;.818;3549000;0
6372;8424;893;27;22;5;17;.773;1730000;0
6372;28701;882;83;30;1;29;.967;3056000;0
6372;36755;882;36;11;3;8;.727;544000;0
6372;70879;893;56;14;2;12;.857;1870000;0
6373;11670;876;0;0;0;0;.00nan;0;0
6373;57859;883;0;0;0;0;.00nan;0;0
6373;65762;876;62;29;3;26;.897;3900000;0
6373;142911;883;66;36;3;33;.917;3900000;0
6374;14266;875;82;29;2;27;.931;3900000;0
6374;28831;881;0;0;0;0;.00nan;0;0
6374;59025;875;0;0;0;0;.00nan;0;0
6374;66993;881;97;43;2;41;.953;3900000;0
6375;3359;878;68;26;1;25;.962;3900000;0
6375;176963;878;0;0;0;0;.00nan;0;0
6375;75313;885;0;0;0;0;.00nan;0;0
6375;85670;885;91;31;1;30;.968;3900000;0
6376;78596;873;64;19;2;17;.895;3600000;0
6376;85749;877;0;0;0;0;.00nan;0;0
6376;146386;873;0;0;0;0;.00nan;0;0
6376;149858;877;82;41;4;37;.902;3512000;0
6377;164715;872;0;0;0;0;.00nan;0;0
6377;63551;892;100;29;0;29;1.000;3600000;0
6377;87798;872;68;40;3;37;.925;3600000;0
6377;146684;892;0;0;0;0;.00nan;0;0
6378;987;886;79;33;2;31;.939;3658000;0
6378;55802;887;0;0;0;0;.00nan;0;0
6378;69536;886;0;0;0;0;.00nan;0;0
6378;70213;887;65;32;3;29;.906;3658000;0
6379;8424;893;52;27;3;24;.889;3600000;0
6379;57859;883;0;0;0;0;.00nan;0;0
6379;70879;893;0;0;0;0;.00nan;0;0
6379;142911;883;67;31;4;27;.871;3550000;0
6380;987;886;0;0;0;0;.00nan;0;0
6380;28701;882;0;0;0;0;.00nan;0;0
6380;36755;882;89;36;3;33;.917;3600000;0
6380;69536;886;100;26;0;26;1.000;3600000;0
6381;28831;881;69;40;4;36;.900;3600000;0
6381;63551;892;26;14;4;10;.714;2170000;0
6381;66993;881;0;0;0;0;.00nan;0;0
6381;146684;892;46;13;2;11;.846;1430000;0
6382;3359;878;74;47;5;42;.894;3600000;0
6382;176963;878;0;0;0;0;.00nan;0;0
6382;85749;877;0;0;0;0;.00nan;0;0
6382;149858;877;80;29;2;27;.931;3600000;0
6383;11670;876;0;0;0;0;.00nan;0;0
6383;65762;876;83;31;2;29;.935;3600000;0
6383;75313;885;58;26;3;23;.885;3563000;0
6383;85670;885;0;0;0;0;.00nan;0;0
6384;55802;887;77;22;1;21;.955;3600000;0
6384;70213;887;0;0;0;0;.00nan;0;0
6384;78596;873;31;30;6;24;.800;2563000;0
6384;146386;873;54;5;0;5;1.000;1037000;0
6385;164715;872;0;0;0;0;.00nan;0;0
6385;14266;875;43;15;3;12;.800;3568000;0
6385;59025;875;0;0;0;0;.00nan;0;0
6385;87798;872;83;30;1;29;.967;3600000;0
6386;8424;893;0;0;0;0;.00nan;0;0
6386;28831;881;0;0;0;0;.00nan;0;0
6386;66993;881;51;29;4;25;.862;3600000;0
6386;70879;893;35;30;5;25;.833;3566000;0
6387;11670;876;0;0;0;0;.00nan;0;0
6387;28701;882;0;0;0;0;.00nan;0;0
6387;36755;882;100;57;2;55;.965;3900000;0
6387;65762;876;83;42;2;40;.952;3900000;0
6388;14266;875;68;38;4;34;.895;3600000;0
6388;59025;875;0;0;0;0;.00nan;0;0
6388;78596;873;63;24;2;22;.917;3600000;0
6388;146386;873;0;0;0;0;.00nan;0;0
6389;3359;878;56;39;5;34;.872;3240000;0
6389;176963;878;54;6;0;6;1.000;360000;0
6389;63551;892;0;0;0;0;.00nan;0;0
6389;146684;892;63;18;1;17;.944;3600000;0
6390;164715;872;0;0;0;0;.00nan;0;0
6390;55802;887;100;24;0;24;1.000;3600000;0
6390;70213;887;0;0;0;0;.00nan;0;0
6390;87798;872;65;41;4;37;.902;3600000;0
6391;987;886;0;0;0;0;.00nan;0;0
6391;69536;886;63;32;4;28;.875;3600000;0
6391;75313;885;0;0;0;0;.00nan;0;0
6391;85670;885;65;25;2;23;.920;3600000;0
6392;57859;883;0;0;0;0;.00nan;0;0
6392;85749;877;98;23;0;23;1.000;3600000;0
6392;142911;883;88;35;2;33;.943;3511000;0
6392;149858;877;0;0;0;0;.00nan;0;0
6393;11670;876;61;30;4;26;.867;3573000;0
6393;14266;875;76;28;2;26;.929;3600000;0
6393;59025;875;0;0;0;0;.00nan;0;0
6393;65762;876;0;0;0;0;.00nan;0;0
6394;57859;883;0;0;0;0;.00nan;0;0
6394;63551;892;76;18;1;17;.944;3600000;0
6394;142911;883;79;37;2;35;.946;3588000;0
6394;146684;892;0;0;0;0;.00nan;0;0
6395;28701;882;87;32;1;31;.969;3600000;0
6395;36755;882;0;0;0;0;.00nan;0;0
6395;78596;873;28;15;4;11;.733;1033000;0
6395;146386;873;46;12;2;10;.833;2567000;0
6396;28831;881;0;0;0;0;.00nan;0;0
6396;55802;887;58;25;3;22;.880;3900000;0
6396;66993;881;78;40;3;37;.925;3900000;0
6396;70213;887;0;0;0;0;.00nan;0;0
6397;987;886;0;0;0;0;.00nan;0;0
6397;3359;878;92;45;2;43;.956;3900000;0
6397;176963;878;0;0;0;0;.00nan;0;0
6397;69536;886;67;23;2;21;.913;3900000;0
6398;8424;893;78;23;1;22;.957;3600000;0
6398;70879;893;0;0;0;0;.00nan;0;0
6398;75313;885;0;0;0;0;.00nan;0;0
6398;85670;885;61;33;3;30;.909;3547000;0
6399;164715;872;0;0;0;0;.00nan;0;0
6399;85749;877;0;0;0;0;.00nan;0;0
6399;87798;872;100;35;0;35;1.000;3900000;0
6399;149858;877;86;23;0;23;1.000;3900000;0
6400;1712;893;62;25;3;22;.880;3600000;0
6400;3077;883;0;0;0;0;.00nan;0;0
6400;57859;883;49;40;6;34;.850;3600000;0
6400;71075;893;0;0;0;0;.00nan;0;0
6401;65762;876;60;32;4;28;.875;3575000;0
6401;70879;877;0;0;0;0;.00nan;0;0
6401;141484;876;0;0;0;0;.00nan;0;0
6401;149858;877;96;43;2;41;.953;3600000;0
6402;3359;878;64;21;2;19;.905;3900000;0
6402;176963;878;0;0;0;0;.00nan;0;0
6402;59025;875;88;41;2;39;.951;3900000;0
6402;147567;875;0;0;0;0;.00nan;0;0
6403;75313;885;0;0;0;0;.00nan;0;0
6403;78596;873;78;46;4;42;.913;3574000;0
6403;85670;885;76;27;2;25;.926;3600000;0
6403;146386;873;0;0;0;0;.00nan;0;0
6404;28831;881;0;0;0;0;.00nan;0;0
6404;55802;892;0;0;0;0;.00nan;0;0
6404;63551;892;68;20;2;18;.900;3777000;0
6404;66993;881;92;54;3;51;.944;3777000;0
6405;987;886;100;24;0;24;1.000;3600000;0
6405;7624;886;0;0;0;0;.00nan;0;0
6405;28701;882;0;0;0;0;.00nan;0;0
6405;36755;882;68;30;3;27;.900;3600000;0
6406;164715;872;0;0;0;0;.00nan;0;0
6406;65762;876;100;24;0;24;1.000;3600000;0
6406;87798;872;63;26;2;24;.923;3520000;0
6406;141484;876;0;0;0;0;.00nan;0;0
6407;14266;875;65;33;3;30;.909;3557000;0
6407;57859;883;0;0;0;0;.00nan;0;0
6407;59025;875;0;0;0;0;.00nan;0;0
6407;142911;883;85;35;2;33;.943;3600000;0
6408;8424;893;100;35;1;34;.971;3900000;0
6408;28701;882;0;0;0;0;.00nan;0;0
6408;36755;882;93;39;1;38;.974;3897000;0
6408;71075;893;0;0;0;0;.00nan;0;0
6409;987;886;55;24;3;21;.875;3600000;0
6409;28831;881;0;0;0;0;.00nan;0;0
6409;66993;881;97;17;0;17;1.000;3600000;0
6409;69536;886;0;0;0;0;.00nan;0;0
6410;55802;892;84;34;2;32;.941;3566000;0
6410;63551;892;0;0;0;0;.00nan;0;0
6410;75313;885;74;23;1;22;.957;3600000;0
6410;85670;885;0;0;0;0;.00nan;0;0
6411;70213;887;54;35;5;30;.857;3600000;0
6411;78596;873;94;21;0;21;1.000;3600000;0
6411;80834;887;0;0;0;0;.00nan;0;0
6411;146386;873;0;0;0;0;.00nan;0;0
6412;3359;878;46;44;6;38;.864;3600000;0
6412;176963;878;0;0;0;0;.00nan;0;0
6412;70879;877;62;25;3;22;.880;3600000;0
6412;149858;877;0;0;0;0;.00nan;0;0
6413;987;886;0;0;0;0;.00nan;0;0
6413;57859;883;0;0;0;0;.00nan;0;0
6413;69536;886;92;25;1;24;.960;3900000;0
6413;142911;883;100;48;1;47;.979;3900000;0
6414;164715;872;0;0;0;0;.00nan;0;0
6414;28701;882;0;0;0;0;.00nan;0;0
6414;36755;882;82;34;2;32;.941;3600000;0
6414;87798;872;80;37;3;34;.919;3600000;0
6415;14266;875;70;39;4;35;.897;3543000;0
6415;28831;881;0;0;0;0;.00nan;0;0
6415;59025;875;0;0;0;0;.00nan;0;0
6415;66993;881;90;32;2;30;.938;3600000;0
6416;3359;878;96;35;1;34;.971;3600000;0
6416;176963;878;0;0;0;0;.00nan;0;0
6416;78596;873;89;37;2;35;.946;3547000;0
6416;146386;873;0;0;0;0;.00nan;0;0
6417;70879;877;99;43;1;42;.977;3706000;0
6417;75313;885;0;0;0;0;.00nan;0;0
6417;85670;885;64;24;2;22;.917;3706000;0
6417;149858;877;0;0;0;0;.00nan;0;0
6418;11670;876;71;40;5;35;.875;3600000;0
6418;55802;892;96;34;1;33;.971;3600000;0
6418;63551;892;0;0;0;0;.00nan;0;0
6418;65762;876;0;0;0;0;.00nan;0;0
6419;8424;893;60;27;3;24;.889;3600000;0
6419;70213;887;0;0;0;0;.00nan;0;0
6419;71075;893;0;0;0;0;.00nan;0;0
6419;80834;887;77;24;1;23;.958;3600000;0
6420;57859;883;84;37;3;34;.919;3555000;0
6420;70879;877;78;32;2;30;.938;3600000;0
6420;142911;883;0;0;0;0;.00nan;0;0
6420;149858;877;0;0;0;0;.00nan;0;0
6421;14266;875;0;0;0;0;.00nan;0;0
6421;55802;892;43;26;4;22;.846;3551000;0
6421;59025;875;56;29;3;26;.897;3600000;0
6421;63551;892;0;0;0;0;.00nan;0;0
6422;3359;878;70;25;2;23;.920;3554000;0
6422;28831;881;0;0;0;0;.00nan;0;0
6422;176963;878;0;0;0;0;.00nan;0;0
6422;66993;881;80;27;1;26;.963;3600000;0
6423;987;886;0;0;0;0;.00nan;0;0
6423;69536;886;55;29;4;25;.862;3548000;0
6423;75313;885;0;0;0;0;.00nan;0;0
6423;85670;885;69;22;3;19;.864;3600000;0
6424;28701;882;0;0;0;0;.00nan;0;0
6424;36755;882;68;49;6;43;.878;3900000;0
6424;78596;873;43;34;6;28;.824;3900000;0
6424;146386;873;0;0;0;0;.00nan;0;0
6425;11670;876;0;0;0;0;.00nan;0;0
6425;65762;876;63;31;4;27;.871;3600000;0
6425;70213;887;55;32;5;27;.844;3600000;0
6425;80834;887;0;0;0;0;.00nan;0;0
6426;8424;893;90;32;2;30;.938;3600000;0
6426;164715;872;54;16;2;14;.875;1190000;0
6426;71075;893;0;0;0;0;.00nan;0;0
6426;87798;872;18;21;6;15;.714;2410000;0
6427;8424;893;60;35;4;31;.886;3818000;0
6427;71075;893;0;0;0;0;.00nan;0;0
6427;78596;873;50;28;5;23;.821;3818000;0
6427;146386;873;0;0;0;0;.00nan;0;0
6428;11670;876;0;0;0;0;.00nan;0;0
6428;57859;883;0;0;0;0;.00nan;0;0
6428;65762;876;39;23;4;19;.826;3900000;0
6428;142911;883;77;40;4;36;.900;3900000;0
6429;14266;875;96;24;0;24;1.000;3600000;0
6429;28701;882;0;0;0;0;.00nan;0;0
6429;36755;882;98;37;1;36;.973;3543000;0
6429;59025;875;0;0;0;0;.00nan;0;0
6430;28831;881;0;0;0;0;.00nan;0;0
6430;66993;881;69;26;2;24;.923;3578000;0
6430;75313;885;0;0;0;0;.00nan;0;0
6430;85670;885;100;22;0;22;1.000;3600000;0
6431;3359;878;61;24;3;21;.875;3600000;0
6431;176963;878;0;0;0;0;.00nan;0;0
6431;70213;887;46;29;4;25;.862;3550000;0
6431;80834;887;0;0;0;0;.00nan;0;0
6432;987;886;56;30;4;26;.867;3574000;0
6432;55802;892;73;29;2;27;.931;3600000;0
6432;63551;892;0;0;0;0;.00nan;0;0
6432;69536;886;0;0;0;0;.00nan;0;0
6433;164715;872;0;0;0;0;.00nan;0;0
6433;70879;877;35;28;6;22;.786;3900000;0
6433;87798;872;35;37;6;31;.838;3895000;0
6433;149858;877;0;0;0;0;.00nan;0;0
6434;3359;878;42;25;4;21;.840;3600000;0
6434;11670;876;0;0;0;0;.00nan;0;0
6434;176963;878;0;0;0;0;.00nan;0;0
6434;65762;876;91;30;1;29;.967;3600000;0
6435;8424;893;67;21;1;20;.952;3600000;0
6435;28831;881;60;51;5;46;.902;3600000;0
6435;66993;881;0;0;0;0;.00nan;0;0
6435;71075;893;0;0;0;0;.00nan;0;0
6436;987;886;0;0;0;0;.00nan;0;0
6436;14266;875;52;30;4;26;.867;3525000;0
6436;59025;875;0;0;0;0;.00nan;0;0
6436;69536;886;75;26;2;24;.923;3600000;0
6437;164715;872;0;0;0;0;.00nan;0;0
6437;75313;885;0;0;0;0;.00nan;0;0
6437;85670;885;94;31;1;30;.968;3600000;0
6437;87798;872;58;32;4;28;.875;3600000;0
6438;28701;882;0;0;0;0;.00nan;0;0
6438;36755;882;91;56;4;52;.929;3567000;0
6438;55802;892;72;19;2;17;.895;3600000;0
6438;63551;892;0;0;0;0;.00nan;0;0
6439;57859;883;0;0;0;0;.00nan;0;0
6439;70213;887;0;0;0;0;.00nan;0;0
6439;80834;887;78;22;1;21;.955;3600000;0
6439;142911;883;52;31;4;27;.871;3600000;0
6440;70879;877;64;27;3;24;.889;3517000;0
6440;78596;873;82;24;1;23;.958;3600000;0
6440;146386;873;0;0;0;0;.00nan;0;0
6440;149858;877;0;0;0;0;.00nan;0;0
6441;57859;883;0;0;0;0;.00nan;0;0
6441;75313;885;0;0;0;0;.00nan;0;0
6441;85670;885;80;33;2;31;.939;3549000;0
6441;142911;883;86;27;1;26;.963;3600000;0
6442;11670;876;0;0;0;0;.00nan;0;0
6442;28701;882;0;0;0;0;.00nan;0;0
6442;36755;882;61;32;3;29;.906;3565000;0
6442;65762;876;73;25;2;23;.920;3600000;0
6443;3359;878;0;0;0;0;.00nan;0;0
6443;176963;878;45;32;5;27;.844;3600000;0
6443;55802;892;100;36;1;35;.972;3600000;0
6443;63551;892;0;0;0;0;.00nan;0;0
6444;14266;875;42;19;4;15;.789;3607000;0
6444;59025;875;0;0;0;0;.00nan;0;0
6444;78596;873;0;0;0;0;.00nan;0;0
6444;146386;873;79;34;3;31;.912;3607000;0
6445;987;886;0;0;0;0;.00nan;0;0
6445;69536;886;91;32;1;31;.969;3600000;0
6445;70213;887;51;29;4;25;.862;3600000;0
6445;80834;887;0;0;0;0;.00nan;0;0
6446;164715;872;56;36;4;32;.889;3553000;0
6446;28831;881;0;0;0;0;.00nan;0;0
6446;66993;881;89;31;2;29;.935;3600000;0
6446;87798;872;0;0;0;0;.00nan;0;0
6447;11670;876;0;0;0;0;.00nan;0;0
6447;65762;876;72;34;3;31;.912;3540000;0
6447;75313;885;0;0;0;0;.00nan;0;0
6447;85670;885;83;27;1;26;.963;3600000;0
6448;3359;878;56;29;4;25;.862;3569000;0
6448;28701;882;0;0;0;0;.00nan;0;0
6448;176963;878;0;0;0;0;.00nan;0;0
6448;36755;882;71;28;3;25;.893;3600000;0
6449;28831;881;0;0;0;0;.00nan;0;0
6449;57859;883;0;0;0;0;.00nan;0;0
6449;66993;881;89;32;1;31;.969;3600000;0
6449;142911;883;83;33;2;31;.939;3600000;0
6450;14266;875;54;25;4;21;.840;3600000;0
6450;59025;875;0;0;0;0;.00nan;0;0
6450;70213;887;7;23;7;16;.696;3292000;0
6450;80834;887;54;4;0;4;1.000;308000;0
6451;164715;872;0;0;0;0;.00nan;0;0
6451;78596;873;25;15;4;11;.733;828000;0
6451;87798;872;85;35;2;33;.943;3600000;0
6451;146386;873;35;21;4;17;.810;2772000;0
6452;8424;893;97;51;2;49;.961;3900000;0
6452;55802;892;83;31;2;29;.935;3900000;0
6452;63551;892;0;0;0;0;.00nan;0;0
6452;71075;893;0;0;0;0;.00nan;0;0
6453;987;886;0;0;0;0;.00nan;0;0
6453;69536;886;70;23;2;21;.913;3600000;0
6453;70879;877;62;30;3;27;.900;3548000;0
6453;149858;877;0;0;0;0;.00nan;0;0
6454;11670;876;0;0;0;0;.00nan;0;0
6454;28831;881;0;0;0;0;.00nan;0;0
6454;65762;876;58;34;4;30;.882;3554000;0
6454;66993;881;76;39;3;36;.923;3600000;0
6455;57859;883;0;0;0;0;.00nan;0;0
6455;78596;873;51;28;4;24;.857;3661000;0
6455;142911;883;83;36;3;33;.917;3661000;0
6455;146386;873;0;0;0;0;.00nan;0;0
6456;3359;878;57;28;3;25;.893;3900000;0
6456;164715;872;0;0;0;0;.00nan;0;0
6456;176963;878;0;0;0;0;.00nan;0;0
6456;87798;872;69;37;3;34;.919;3900000;0
6457;14266;875;50;38;5;33;.868;3600000;0
6457;59025;875;0;0;0;0;.00nan;0;0
6457;75313;885;0;0;0;0;.00nan;0;0
6457;85670;885;95;21;0;21;1.000;3600000;0
6458;28701;882;0;0;0;0;.00nan;0;0
6458;36755;882;100;39;1;38;.974;3900000;0
6458;70213;887;97;40;1;39;.975;3900000;0
6458;80834;887;0;0;0;0;.00nan;0;0
6459;987;886;0;0;0;0;.00nan;0;0
6459;8424;893;86;37;2;35;.946;3533000;0
6459;69536;886;93;18;0;18;1.000;3600000;0
6459;71075;893;0;0;0;0;.00nan;0;0
6460;55802;892;81;27;1;26;.963;3600000;0
6460;63551;892;0;0;0;0;.00nan;0;0
6460;70879;877;68;48;5;43;.896;3600000;0
6460;149858;877;0;0;0;0;.00nan;0;0
6461;3359;878;77;26;2;24;.923;3600000;0
6461;8424;893;58;26;3;23;.885;3575000;0
6461;176963;878;0;0;0;0;.00nan;0;0
6461;71075;893;0;0;0;0;.00nan;0;0
6462;28701;882;0;0;0;0;.00nan;0;0
6462;36755;882;17;39;9;30;.769;3600000;0
6462;75313;885;0;0;0;0;.00nan;0;0
6462;85670;885;64;26;3;23;.885;3600000;0
6463;28831;881;0;0;0;0;.00nan;0;0
6463;66993;881;80;48;5;43;.896;3597000;0
6463;70879;877;62;32;3;29;.906;3600000;0
6463;149858;877;0;0;0;0;.00nan;0;0
6464;11670;876;0;0;0;0;.00nan;0;0
6464;14266;875;0;0;0;0;.00nan;0;0
6464;59025;875;100;40;1;39;.975;3600000;0
6464;65762;876;71;30;2;28;.933;3557000;0
6465;987;886;0;0;0;0;.00nan;0;0
6465;69536;886;100;40;1;39;.975;3900000;0
6465;78596;873;79;27;1;26;.963;3900000;0
6465;146386;873;0;0;0;0;.00nan;0;0
6466;55802;892;100;29;0;29;1.000;3600000;0
6466;63551;892;0;0;0;0;.00nan;0;0
6466;70213;887;97;43;2;41;.953;3591000;0
6466;80834;887;0;0;0;0;.00nan;0;0
6467;164715;872;0;0;0;0;.00nan;0;0
6467;57859;883;0;0;0;0;.00nan;0;0
6467;87798;872;84;29;1;28;.966;3600000;0
6467;142911;883;75;32;3;29;.906;3600000;0
6468;8424;893;62;27;3;24;.889;3900000;0
6468;11670;876;90;44;3;41;.932;3900000;0
6468;65762;876;0;0;0;0;.00nan;0;0
6468;71075;893;0;0;0;0;.00nan;0;0
6469;28701;882;0;0;0;0;.00nan;0;0
6469;36755;882;50;29;4;25;.862;3579000;0
6469;57859;883;0;0;0;0;.00nan;0;0
6469;142911;883;61;31;3;28;.903;3600000;0
6470;3359;878;85;44;3;41;.932;3600000;0
6470;176963;878;0;0;0;0;.00nan;0;0
6470;75313;885;76;27;2;25;.926;3600000;0
6470;85670;885;0;0;0;0;.00nan;0;0
6471;55802;892;79;25;1;24;.960;3600000;0
6471;63551;892;0;0;0;0;.00nan;0;0
6471;78596;873;78;32;2;30;.938;3600000;0
6471;146386;873;0;0;0;0;.00nan;0;0
6472;28831;881;0;0;0;0;.00nan;0;0
6472;66993;881;100;40;1;39;.975;3600000;0
6472;70213;887;0;0;0;0;.00nan;0;0
6472;80834;887;55;23;3;20;.870;3576000;0
6473;987;886;0;0;0;0;.00nan;0;0
6473;164715;872;0;0;0;0;.00nan;0;0
6473;69536;886;74;20;1;19;.950;3900000;0
6473;87798;872;97;46;1;45;.978;3900000;0
6474;14266;875;86;34;2;32;.941;3600000;0
6474;59025;875;0;0;0;0;.00nan;0;0
6474;70879;877;49;20;3;17;.850;3591000;0
6474;149858;877;0;0;0;0;.00nan;0;0
6475;8424;893;0;0;0;0;.00nan;0;0
6475;14266;875;67;29;3;26;.897;3586000;0
6475;59025;875;0;0;0;0;.00nan;0;0
6475;71075;893;81;24;1;23;.958;3600000;0
6476;987;886;0;0;0;0;.00nan;0;0
6476;11670;876;0;0;0;0;.00nan;0;0
6476;65762;876;100;45;2;43;.956;3900000;0
6476;69536;886;94;39;2;37;.949;3900000;0
6477;28701;882;0;0;0;0;.00nan;0;0
6477;36755;882;88;38;3;35;.921;3600000;0
6477;70879;877;36;27;5;22;.815;3515000;0
6477;149858;877;0;0;0;0;.00nan;0;0
6478;28831;881;99;44;1;43;.977;3600000;0
6478;66993;881;0;0;0;0;.00nan;0;0
6478;78596;873;59;34;4;30;.882;3600000;0
6478;146386;873;0;0;0;0;.00nan;0;0
6479;3359;878;42;35;6;29;.829;3600000;0
6479;176963;878;0;0;0;0;.00nan;0;0
6479;57859;883;0;0;0;0;.00nan;0;0
6479;142911;883;72;23;2;21;.913;3600000;0
6480;70213;887;28;27;6;21;.778;3253000;0
6480;75313;885;0;0;0;0;.00nan;0;0
6480;80834;887;58;7;0;7;1.000;629000;0
6480;85670;885;43;41;6;35;.854;3900000;0
6481;164715;872;0;0;0;0;.00nan;0;0
6481;55802;892;79;21;1;20;.952;3600000;0
6481;63551;892;0;0;0;0;.00nan;0;0
6481;87798;872;97;41;2;39;.951;3600000;0
6483;20645;885;66;22;2;20;.909;3600000;0
6483;28831;881;0;0;0;0;.00nan;0;0
6483;66993;881;76;49;5;44;.898;3600000;0
6483;71075;885;0;0;0;0;.00nan;0;0
6487;3359;878;0;0;0;0;.00nan;0;0
6487;176963;878;76;48;5;43;.896;3600000;0
6487;78596;873;94;33;1;32;.970;3600000;0
6487;146386;873;0;0;0;0;.00nan;0;0
6491;987;886;63;23;2;21;.913;3516000;0
6491;5354;886;0;0;0;0;.00nan;0;0
6491;57859;883;0;0;0;0;.00nan;0;0
6491;142911;883;100;30;0;30;1.000;3600000;0
6493;1712;893;0;0;0;0;.00nan;0;0
6493;28701;882;82;38;3;35;.921;3900000;0
6493;196005;882;0;0;0;0;.00nan;0;0
6493;70879;893;58;18;3;15;.833;3900000;0
6495;3077;875;0;0;0;0;.00nan;0;0
6495;80834;887;0;0;0;0;.00nan;0;0
6495;147567;875;61;47;6;41;.872;3600000;0
6495;159705;887;84;34;2;32;.941;3600000;0
6497;1712;893;21;9;4;5;.556;3600000;0
6497;7624;872;70;21;1;20;.952;1316000;0
6497;164715;872;53;30;5;25;.833;2202000;0
6497;70879;893;0;0;0;0;.00nan;0;0
6499;28701;882;52;3;0;3;1.000;911000;0
6499;196005;882;28;30;6;24;.800;2689000;0
6499;57859;883;0;0;0;0;.00nan;0;0
6499;142911;883;79;39;3;36;.923;3600000;0
6505;20645;885;0;0;0;0;.00nan;0;0
6505;71075;885;53;21;2;19;.905;3580000;0
6505;78596;873;0;0;0;0;.00nan;0;0
6505;146386;873;100;37;1;36;.973;3600000;0
6507;3077;875;71;27;2;25;.926;3600000;0
6507;3359;878;73;33;3;30;.909;3559000;0
6507;176963;878;0;0;0;0;.00nan;0;0
6507;147567;875;0;0;0;0;.00nan;0;0
6509;987;886;0;0;0;0;.00nan;0;0
6509;5354;886;74;22;1;21;.955;3600000;0
6509;28831;881;98;41;2;39;.951;3559000;0
6509;66993;881;0;0;0;0;.00nan;0;0
6511;3077;875;78;42;3;39;.929;3600000;0
6511;20645;885;47;34;5;29;.853;3582000;0
6511;71075;885;0;0;0;0;.00nan;0;0
6511;147567;875;0;0;0;0;.00nan;0;0
6517;3359;878;0;0;0;0;.00nan;0;0
6517;176963;878;52;32;4;28;.875;3608000;0
6517;78596;873;87;37;3;34;.919;3596000;0
6517;146386;873;0;0;0;0;.00nan;0;0
6519;987;886;100;30;0;30;1.000;3600000;0
6519;5354;886;0;0;0;0;.00nan;0;0
6519;28701;882;34;30;6;24;.800;3600000;0
6519;196005;882;0;0;0;0;.00nan;0;0
6523;1712;893;0;0;0;0;.00nan;0;0
6523;7624;872;0;0;0;0;.00nan;0;0
6523;164715;872;46;18;3;15;.833;3600000;0
6523;70879;893;22;27;6;21;.778;3600000;0
6525;1712;893;73;30;3;27;.900;3900000;0
6525;28831;881;0;0;0;0;.00nan;0;0
6525;66993;881;93;48;3;45;.938;3900000;0
6525;70879;893;0;0;0;0;.00nan;0;0
6529;20645;885;0;0;0;0;.00nan;0;0
6529;57859;883;0;0;0;0;.00nan;0;0
6529;71075;885;83;42;3;39;.929;3600000;0
6529;142911;883;67;38;4;34;.895;3544000;0
6533;28701;882;0;0;0;0;.00nan;0;0
6533;196005;882;48;28;4;24;.857;3568000;0
6533;80834;887;77;34;3;31;.912;3600000;0
6533;159705;887;0;0;0;0;.00nan;0;0
6537;3359;878;41;23;4;19;.826;3576000;0
6537;7624;872;77;28;2;26;.929;3600000;0
6537;164715;872;0;0;0;0;.00nan;0;0
6537;176963;878;0;0;0;0;.00nan;0;0
6539;7037;876;0;0;0;0;.00nan;0;0
6539;11670;876;78;27;1;26;.963;3577000;0
6539;63551;892;100;26;0;26;1.000;3600000;0
6539;146684;892;0;0;0;0;.00nan;0;0
6541;3077;875;0;0;0;0;.00nan;0;0
6541;7624;872;0;0;0;0;.00nan;0;0
6541;164715;872;79;34;1;33;.971;3900000;0
6541;147567;875;91;28;1;27;.964;3900000;0
6543;78596;873;96;34;2;32;.941;3600000;0
6543;80834;887;76;33;3;30;.909;3593000;0
6543;146386;873;0;0;0;0;.00nan;0;0
6543;159705;887;0;0;0;0;.00nan;0;0
6545;987;886;72;42;4;38;.905;3600000;0
6545;5354;886;0;0;0;0;.00nan;0;0
6545;85749;877;82;24;1;23;.958;3600000;0
6545;149858;877;0;0;0;0;.00nan;0;0
6547;3359;878;90;36;2;34;.944;3600000;0
6547;28831;881;51;29;4;25;.862;3600000;0
6547;176963;878;0;0;0;0;.00nan;0;0
6547;66993;881;0;0;0;0;.00nan;0;0
6549;1712;893;0;0;0;0;.00nan;0;0
6549;20645;885;86;27;1;26;.963;3600000;0
6549;70879;893;93;46;3;43;.935;3536000;0
6549;71075;885;0;0;0;0;.00nan;0;0
6551;28701;882;100;34;0;34;1.000;3600000;0
6551;196005;882;0;0;0;0;.00nan;0;0
6551;57859;883;0;0;0;0;.00nan;0;0
6551;142911;883;66;38;5;33;.868;3600000;0
6555;987;886;0;0;0;0;.00nan;0;0
6555;5354;886;57;25;3;22;.880;3900000;0
6555;28831;881;0;0;0;0;.00nan;0;0
6555;66993;881;69;37;3;34;.919;3900000;0
6557;1712;893;71;28;3;25;.893;3600000;0
6557;28701;882;85;35;2;33;.943;3600000;0
6557;196005;882;0;0;0;0;.00nan;0;0
6557;70879;893;0;0;0;0;.00nan;0;0
6561;78596;873;46;7;1;6;.857;865000;0
6561;80834;887;0;0;0;0;.00nan;0;0
6561;146386;873;21;25;6;19;.760;2735000;0
6561;159705;887;83;48;3;45;.938;3600000;0
6563;20645;885;0;0;0;0;.00nan;0;0
6563;57859;883;64;28;3;25;.893;3600000;0
6563;71075;885;87;21;0;21;1.000;3600000;0
6563;142911;883;0;0;0;0;.00nan;0;0
6565;3077;875;50;37;5;32;.865;3900000;0
6565;7624;872;67;41;5;36;.878;3900000;0
6565;164715;872;0;0;0;0;.00nan;0;0
6565;147567;875;0;0;0;0;.00nan;0;0
6567;3077;875;0;0;0;0;.00nan;0;0
6567;78596;873;68;28;2;26;.929;3600000;0
6567;146386;873;0;0;0;0;.00nan;0;0
6567;147567;875;32;24;5;19;.792;3600000;0
6569;987;886;71;30;4;26;.867;3581000;0
6569;3359;878;79;28;2;26;.929;3600000;0
6569;5354;886;0;0;0;0;.00nan;0;0
6569;176963;878;0;0;0;0;.00nan;0;0
6575;20645;885;0;0;0;0;.00nan;0;0
6575;28701;882;66;36;5;31;.861;3600000;0
6575;196005;882;0;0;0;0;.00nan;0;0
6575;71075;885;65;23;2;21;.913;3600000;0
6579;1712;893;0;0;0;0;.00nan;0;0
6579;7624;872;0;0;0;0;.00nan;0;0
6579;164715;872;75;41;4;37;.902;3600000;0
6579;70879;893;61;29;3;26;.897;3600000;0
1089;28831;881;0;0;0;0;.00nan;0;0
1089;57859;883;0;0;0;0;.00nan;0;0
1089;66993;881;100;24;0;24;1.000;3600000;0
1089;142911;883;66;29;3;26;.897;3600000;0
1090;8424;893;0;0;0;0;.00nan;0;0
1090;11670;876;0;0;0;0;.00nan;0;0
1090;65762;876;32;24;5;19;.792;3600000;0
1090;67287;893;67;16;1;15;.938;3600000;0
1091;28831;881;0;0;0;0;.00nan;0;0
1091;57859;883;0;0;0;0;.00nan;0;0
1091;66993;881;56;26;3;23;.885;3584000;0
1091;142911;883;63;25;2;23;.920;3600000;0
1092;8424;893;38;41;6;35;.854;3600000;0
1092;11670;876;0;0;0;0;.00nan;0;0
1092;65762;876;100;26;0;26;1.000;3600000;0
1092;67287;893;0;0;0;0;.00nan;0;0
1161;28831;881;0;0;0;0;.00nan;0;0
1161;57859;883;0;0;0;0;.00nan;0;0
1161;66993;881;22;20;5;15;.750;3536000;0
1161;142911;883;95;44;3;41;.932;3600000;0
1162;8424;893;96;36;1;35;.972;3995000;0
1162;11670;876;0;0;0;0;.00nan;0;0
1162;65762;876;79;28;2;26;.929;3995000;0
1162;67287;893;0;0;0;0;.00nan;0;0
1204;55802;892;82;33;2;31;.939;4799000;0
1204;57859;883;0;0;0;0;.00nan;0;0
1204;63551;892;0;0;0;0;.00nan;0;0
1204;142911;883;86;52;3;49;.942;4799000;0
1205;987;886;0;0;0;0;.00nan;0;0
1205;8424;893;91;42;3;39;.929;3600000;0
1205;67287;893;0;0;0;0;.00nan;0;0
1205;69536;886;80;28;2;26;.929;3600000;0
1206;70213;887;100;38;0;38;1.000;3600000;0
1206;78596;873;84;35;3;32;.914;3600000;0
1206;80834;887;0;0;0;0;.00nan;0;0
1206;146386;873;0;0;0;0;.00nan;0;0
1207;70879;877;0;0;0;0;.00nan;0;0
1207;75313;885;0;0;0;0;.00nan;0;0
1207;85670;885;67;30;3;27;.900;3600000;0
1207;149858;877;65;27;2;25;.926;3600000;0
1208;55802;892;77;30;3;27;.900;3600000;0
1208;57859;883;59;13;1;12;.923;1012000;0
1208;63551;892;0;0;0;0;.00nan;0;0
1208;142911;883;28;24;6;18;.750;2588000;0
1209;987;886;0;0;0;0;.00nan;0;0
1209;8424;893;78;41;4;37;.902;3600000;0
1209;67287;893;0;0;0;0;.00nan;0;0
1209;69536;886;81;14;0;14;1.000;3600000;0
1210;70213;887;54;34;5;29;.853;3521000;0
1210;78596;873;68;27;3;24;.889;3600000;0
1210;80834;887;0;0;0;0;.00nan;0;0
1210;146386;873;0;0;0;0;.00nan;0;0
1211;70879;877;52;23;3;20;.870;3639000;0
1211;75313;885;0;0;0;0;.00nan;0;0
1211;85670;885;78;46;4;42;.913;3639000;0
1211;149858;877;0;0;0;0;.00nan;0;0
1212;55802;892;45;18;3;15;.833;3516000;0
1212;57859;883;0;0;0;0;.00nan;0;0
1212;63551;892;0;0;0;0;.00nan;0;0
1212;142911;883;92;38;1;37;.974;3600000;0
1213;987;886;0;0;0;0;.00nan;0;0
1213;8424;893;66;21;2;19;.905;3536000;0
1213;67287;893;0;0;0;0;.00nan;0;0
1213;69536;886;91;23;0;23;1.000;3600000;0
1214;70213;887;68;33;2;31;.939;4153000;0
1214;78596;873;93;47;3;44;.936;4153000;0
1214;80834;887;0;0;0;0;.00nan;0;0
1214;146386;873;0;0;0;0;.00nan;0;0
1215;70879;877;63;27;3;24;.889;3586000;0
1215;75313;885;0;0;0;0;.00nan;0;0
1215;85670;885;90;41;2;39;.951;3600000;0
1215;149858;877;0;0;0;0;.00nan;0;0
1216;55802;892;84;15;0;15;1.000;3600000;0
1216;57859;883;0;0;0;0;.00nan;0;0
1216;63551;892;0;0;0;0;.00nan;0;0
1216;142911;883;80;25;2;23;.920;3582000;0
1217;987;886;0;0;0;0;.00nan;0;0
1217;8424;893;74;34;3;31;.912;3655000;0
1217;67287;893;0;0;0;0;.00nan;0;0
1217;69536;886;36;20;4;16;.800;3655000;0
1218;70213;887;61;34;4;30;.882;3600000;0
1218;78596;873;89;28;1;27;.964;3600000;0
1218;80834;887;0;0;0;0;.00nan;0;0
1218;146386;873;0;0;0;0;.00nan;0;0
1219;70879;877;93;19;0;19;1.000;3600000;0
1219;75313;885;0;0;0;0;.00nan;0;0
1219;85670;885;77;38;3;35;.921;3600000;0
1219;149858;877;0;0;0;0;.00nan;0;0
1503;55802;892;74;23;2;21;.913;3600000;0
1503;57859;883;0;0;0;0;.00nan;0;0
1503;63551;892;0;0;0;0;.00nan;0;0
1503;142911;883;62;33;4;29;.879;3552000;0
1504;987;886;0;0;0;0;.00nan;0;0
1504;8424;893;91;33;1;32;.970;3550000;0
1504;67287;893;0;0;0;0;.00nan;0;0
1504;69536;886;100;27;0;27;1.000;3600000;0
1505;70213;887;71;24;2;22;.917;3600000;0
1505;78596;873;72;40;4;36;.900;3565000;0
1505;80834;887;0;0;0;0;.00nan;0;0
1505;146386;873;0;0;0;0;.00nan;0;0
1506;70879;877;51;34;5;29;.853;3600000;0
1506;75313;885;0;0;0;0;.00nan;0;0
1506;85670;885;98;23;0;23;1.000;3600000;0
1506;149858;877;0;0;0;0;.00nan;0;0
1517;70213;887;84;35;2;33;.943;3600000;0
1517;78596;873;59;32;4;28;.875;3559000;0
1517;80834;887;0;0;0;0;.00nan;0;0
1517;146386;873;0;0;0;0;.00nan;0;0
1518;70879;877;100;29;0;29;1.000;3600000;0
1518;75313;885;0;0;0;0;.00nan;0;0
1518;85670;885;54;32;4;28;.875;3600000;0
1518;149858;877;0;0;0;0;.00nan;0;0
1565;55802;892;92;45;2;43;.956;3600000;0
1565;63551;892;0;0;0;0;.00nan;0;0
1565;70879;877;48;18;3;15;.833;3546000;0
1565;149858;877;0;0;0;0;.00nan;0;0
1566;987;886;0;0;0;0;.00nan;0;0
1566;69536;886;41;28;5;23;.821;3591000;0
1566;70213;887;49;23;4;19;.826;3600000;0
1566;80834;887;0;0;0;0;.00nan;0;0
1567;55802;892;99;36;1;35;.972;3600000;0
1567;63551;892;0;0;0;0;.00nan;0;0
1567;70879;877;56;34;4;30;.882;3600000;0
1567;149858;877;0;0;0;0;.00nan;0;0
1568;987;886;0;0;0;0;.00nan;0;0
1568;69536;886;97;30;2;28;.933;3600000;0
1568;70213;887;58;36;5;31;.861;3600000;0
1568;80834;887;0;0;0;0;.00nan;0;0
1569;55802;892;72;37;3;34;.919;4125000;0
1569;63551;892;0;0;0;0;.00nan;0;0
1569;70879;877;79;32;2;30;.938;4110000;0
1569;149858;877;0;0;0;0;.00nan;0;0
1570;987;886;0;0;0;0;.00nan;0;0
1570;69536;886;100;29;0;29;1.000;3600000;0
1570;70213;887;75;28;1;27;.964;3547000;0
1570;80834;887;0;0;0;0;.00nan;0;0
1571;55802;892;76;33;3;30;.909;3600000;0
1571;63551;892;0;0;0;0;.00nan;0;0
1571;70879;877;100;30;0;30;1.000;3600000;0
1571;149858;877;0;0;0;0;.00nan;0;0
1572;987;886;0;0;0;0;.00nan;0;0
1572;69536;886;55;24;4;20;.833;3858000;0
1572;70213;887;78;38;3;35;.921;3858000;0
1572;80834;887;0;0;0;0;.00nan;0;0
1769;55802;892;13;13;5;8;.615;858000;0
1769;63551;892;71;23;1;22;.957;2742000;0
1769;70879;877;91;32;1;31;.969;3600000;0
1769;149858;877;0;0;0;0;.00nan;0;0
1770;987;886;0;0;0;0;.00nan;0;0
1770;69536;886;100;34;0;34;1.000;3600000;0
1770;70213;887;68;29;3;26;.897;3600000;0
1770;80834;887;0;0;0;0;.00nan;0;0
1795;55802;892;100;22;0;22;1.000;3600000;0
1795;63551;892;0;0;0;0;.00nan;0;0
1795;70879;877;90;36;1;35;.972;3571000;0
1795;149858;877;0;0;0;0;.00nan;0;0
1796;987;886;0;0;0;0;.00nan;0;0
1796;69536;886;100;21;0;21;1.000;3600000;0
1796;70213;887;87;31;2;29;.935;3537000;0
1796;80834;887;0;0;0;0;.00nan;0;0
1846;55802;892;93;35;2;33;.943;3600000;0
1846;63551;892;0;0;0;0;.00nan;0;0
1846;70879;877;49;36;5;31;.861;3600000;0
1846;149858;877;0;0;0;0;.00nan;0;0
1903;987;886;0;0;0;0;.00nan;0;0
1903;55802;892;76;28;2;26;.929;3971000;0
1903;63551;892;0;0;0;0;.00nan;0;0
1903;69536;886;89;38;3;35;.921;3971000;0
6580;6948;519;100;46;2;44;.957;3600000;0
6580;7332;512;0;0;0;0;.00nan;0;0
6580;143083;519;0;0;0;0;.00nan;0;0
6580;152201;512;50;22;3;19;.864;3563000;0
6581;14047;517;73;30;3;27;.900;3545000;0
6581;174581;518;0;0;0;0;.00nan;0;0
6581;86099;517;0;0;0;0;.00nan;0;0
6581;143523;518;88;38;2;36;.947;3600000;0
6582;6944;520;0;0;0;0;.00nan;0;0
6582;143256;520;83;27;1;26;.963;3600000;0
6582;143307;1876;0;0;0;0;.00nan;0;0
6582;155529;1876;62;34;3;31;.912;3600000;0
6583;1072;511;0;0;0;0;.00nan;0;0
6583;67764;516;0;0;0;0;.00nan;0;0
6583;143191;516;70;22;1;21;.955;3600000;0
6583;155474;511;66;49;5;44;.898;3600000;0
6584;16587;513;29;30;6;24;.800;3600000;0
6584;89998;515;0;0;0;0;.00nan;0;0
6584;143330;515;100;30;0;30;1.000;3600000;0
6584;152494;513;0;0;0;0;.00nan;0;0
6585;8035;524;71;12;0;12;1.000;1363000;0
6585;142929;1872;0;0;0;0;.00nan;0;0
6585;152464;524;26;30;6;24;.800;2237000;0
6585;152478;1872;77;21;1;20;.952;3600000;0
6586;6947;1472;100;37;0;37;1.000;3600000;0
6586;7487;1472;0;0;0;0;.00nan;0;0
6586;80859;514;67;25;3;22;.880;3600000;0
6586;159851;514;0;0;0;0;.00nan;0;0
6587;141496;1876;54;25;3;22;.880;3531000;0
6587;142929;1872;0;0;0;0;.00nan;0;0
6587;143307;1876;0;0;0;0;.00nan;0;0
6587;152478;1872;68;21;1;20;.952;3600000;0
6588;6947;1472;48;28;4;24;.857;3600000;0
6588;57390;1472;0;0;0;0;.00nan;0;0
6588;86360;519;89;33;1;32;.970;3600000;0
6588;143083;519;0;0;0;0;.00nan;0;0
6589;6944;520;0;0;0;0;.00nan;0;0
6589;43896;516;76;32;2;30;.938;3578000;0
6589;143191;516;0;0;0;0;.00nan;0;0
6589;143256;520;93;32;1;31;.969;3600000;0
6590;1072;511;72;21;1;20;.952;3600000;0
6590;16587;513;0;0;0;0;.00nan;0;0
6590;37077;513;60;39;5;34;.872;3600000;0
6590;155474;511;0;0;0;0;.00nan;0;0
6591;14047;517;82;31;3;28;.903;3540000;0
6591;59614;514;76;21;1;20;.952;3600000;0
6591;80859;514;0;0;0;0;.00nan;0;0
6591;86099;517;0;0;0;0;.00nan;0;0
6592;7332;512;0;0;0;0;.00nan;0;0
6592;174581;518;0;0;0;0;.00nan;0;0
6592;143523;518;91;36;2;34;.944;3600000;0
6592;152201;512;26;21;5;16;.762;3600000;0
6593;8035;524;0;0;0;0;.00nan;0;0
6593;86228;515;0;0;0;0;.00nan;0;0
6593;143330;515;87;24;1;23;.958;3600000;0
6593;152464;524;26;36;8;28;.778;3600000;0
6594;8035;524;94;54;3;51;.944;3824000;0
6594;43896;516;64;22;2;20;.909;3824000;0
6594;143191;516;0;0;0;0;.00nan;0;0
6594;152464;524;0;0;0;0;.00nan;0;0
6595;1072;511;85;37;2;35;.946;3558000;0
6595;86360;519;69;19;1;18;.947;3600000;0
6595;143083;519;0;0;0;0;.00nan;0;0
6595;155474;511;0;0;0;0;.00nan;0;0
6596;174581;518;59;43;6;37;.860;2756000;0
6596;86228;515;0;0;0;0;.00nan;0;0
6596;143330;515;48;16;3;13;.813;3600000;0
6596;143523;518;49;8;1;7;.875;844000;0
6597;7332;512;87;45;3;42;.933;3735000;0
6597;14047;517;75;37;4;33;.892;3735000;0
6597;86099;517;0;0;0;0;.00nan;0;0
6597;152201;512;0;0;0;0;.00nan;0;0
6598;6947;1472;0;0;0;0;.00nan;0;0
6598;57390;1472;76;28;2;26;.929;3600000;0
6598;141496;1876;70;31;3;28;.903;3567000;0
6598;143307;1876;0;0;0;0;.00nan;0;0
6599;16587;513;0;0;0;0;.00nan;0;0
6599;37077;513;72;21;1;20;.952;3900000;0
6599;142929;1872;0;0;0;0;.00nan;0;0
6599;152478;1872;79;27;1;26;.963;3900000;0
6600;6944;520;0;0;0;0;.00nan;0;0
6600;59614;514;60;25;3;22;.880;3600000;0
6600;80859;514;0;0;0;0;.00nan;0;0
6600;143256;520;56;40;6;34;.850;3600000;0
6601;7332;512;0;0;0;0;.00nan;0;0
6601;142929;1872;0;0;0;0;.00nan;0;0
6601;152201;512;50;33;5;28;.848;3600000;0
6601;152478;1872;66;30;3;27;.900;3600000;0
6602;6947;1472;0;0;0;0;.00nan;0;0
6602;16587;513;0;0;0;0;.00nan;0;0
6602;37077;513;42;25;4;21;.840;3589000;0
6602;57390;1472;69;35;3;32;.914;3600000;0
6603;6944;520;90;26;1;25;.962;3900000;0
6603;8035;524;0;0;0;0;.00nan;0;0
6603;143256;520;0;0;0;0;.00nan;0;0
6603;152464;524;97;38;1;37;.974;3900000;0
6604;1072;511;62;23;2;21;.913;3600000;0
6604;174581;518;0;0;0;0;.00nan;0;0
6604;143523;518;77;41;4;37;.902;3600000;0
6604;155474;511;0;0;0;0;.00nan;0;0
6605;14047;517;100;37;0;37;1.000;3600000;0
6605;86099;517;0;0;0;0;.00nan;0;0
6605;86360;519;74;26;2;24;.923;3572000;0
6605;143083;519;0;0;0;0;.00nan;0;0
6606;43896;516;72;21;1;20;.952;3600000;0
6606;141496;1876;80;36;2;34;.944;3572000;0
6606;143191;516;0;0;0;0;.00nan;0;0
6606;143307;1876;0;0;0;0;.00nan;0;0
6607;59614;514;81;17;0;17;1.000;3600000;0
6607;80859;514;0;0;0;0;.00nan;0;0
6607;86228;515;0;0;0;0;.00nan;0;0
6607;143330;515;89;38;1;37;.974;3600000;0
6608;86360;519;77;31;2;29;.935;3600000;0
6608;142929;1872;0;0;0;0;.00nan;0;0
6608;143083;519;0;0;0;0;.00nan;0;0
6608;152478;1872;91;30;1;29;.967;3600000;0
6609;6944;520;0;0;0;0;.00nan;0;0
6609;174581;518;58;16;1;15;.938;1135000;0
6609;143256;520;69;21;1;20;.952;3600000;0
6609;143523;518;33;28;6;22;.786;2465000;0
6610;6947;1472;0;0;0;0;.00nan;0;0
6610;14047;517;56;25;3;22;.880;3700000;0
6610;57390;1472;75;41;4;37;.902;3700000;0
6610;86099;517;0;0;0;0;.00nan;0;0
6611;1072;511;0;0;0;0;.00nan;0;0
6611;7332;512;49;35;5;30;.857;3547000;0
6611;152201;512;0;0;0;0;.00nan;0;0
6611;155474;511;28;18;4;14;.778;3600000;0
6612;86228;515;0;0;0;0;.00nan;0;0
6612;141496;1876;61;51;7;44;.863;3600000;0
6612;143307;1876;0;0;0;0;.00nan;0;0
6612;143330;515;56;21;2;19;.905;3600000;0
6613;8035;524;81;32;2;30;.938;3900000;0
6613;16587;513;0;0;0;0;.00nan;0;0
6613;37077;513;62;20;2;18;.900;3900000;0
6613;152464;524;0;0;0;0;.00nan;0;0
6614;43896;516;96;33;2;31;.939;3600000;0
6614;59614;514;27;19;5;14;.737;3600000;0
6614;80859;514;0;0;0;0;.00nan;0;0
6614;143191;516;0;0;0;0;.00nan;0;0
6615;59614;514;0;0;0;0;.00nan;0;0
6615;80859;514;92;21;0;21;1.000;3600000;0
6615;142929;1872;0;0;0;0;.00nan;0;0
6615;152478;1872;52;24;3;21;.875;3600000;0
6616;6947;1472;0;0;0;0;.00nan;0;0
6616;174581;518;0;0;0;0;.00nan;0;0
6616;57390;1472;73;17;1;16;.941;3600000;0
6616;143523;518;71;28;2;26;.929;3555000;0
6617;6944;520;64;22;2;20;.909;3600000;0
6617;86360;519;85;46;3;43;.935;3543000;0
6617;143083;519;0;0;0;0;.00nan;0;0
6617;143256;520;0;0;0;0;.00nan;0;0
6618;1072;511;51;25;3;22;.880;3592000;0
6618;14047;517;92;30;1;29;.967;3600000;0
6618;86099;517;0;0;0;0;.00nan;0;0
6618;155474;511;0;0;0;0;.00nan;0;0
6619;16587;513;0;0;0;0;.00nan;0;0
6619;37077;513;41;27;5;22;.815;3600000;0
6619;43896;516;0;0;0;0;.00nan;0;0
6619;143191;516;87;30;1;29;.967;3600000;0
6620;8035;524;0;0;0;0;.00nan;0;0
6620;141496;1876;73;41;3;38;.927;3600000;0
6620;143307;1876;0;0;0;0;.00nan;0;0
6620;152464;524;42;24;4;20;.833;3553000;0
6621;7332;512;0;0;0;0;.00nan;0;0
6621;86228;515;54;19;2;17;.895;3600000;0
6621;143330;515;0;0;0;0;.00nan;0;0
6621;152201;512;91;41;3;38;.927;3577000;0
6622;174581;518;59;33;4;29;.879;3576000;0
6622;43896;516;0;0;0;0;.00nan;0;0
6622;143191;516;52;20;2;18;.900;3600000;0
6622;143523;518;0;0;0;0;.00nan;0;0
6623;1072;511;0;0;0;0;.00nan;0;0
6623;86228;515;0;0;0;0;.00nan;0;0
6623;143330;515;66;35;4;31;.886;3581000;0
6623;155474;511;64;24;2;22;.917;3600000;0
6624;14047;517;86;33;2;31;.939;3576000;0
6624;86099;517;0;0;0;0;.00nan;0;0
6624;142929;1872;0;0;0;0;.00nan;0;0
6624;152478;1872;68;19;1;18;.947;3600000;0
6625;6947;1472;0;0;0;0;.00nan;0;0
6625;7332;512;98;36;1;35;.972;3900000;0
6625;57390;1472;81;23;1;22;.957;3900000;0
6625;152201;512;0;0;0;0;.00nan;0;0
6626;6944;520;0;0;0;0;.00nan;0;0
6626;16587;513;0;0;0;0;.00nan;0;0
6626;37077;513;62;31;3;28;.903;3600000;0
6626;143256;520;44;28;4;24;.857;3561000;0
6627;8035;524;89;44;3;41;.932;3600000;0
6627;86360;519;90;22;0;22;1.000;3600000;0
6627;143083;519;0;0;0;0;.00nan;0;0
6627;152464;524;0;0;0;0;.00nan;0;0
6628;59614;514;0;0;0;0;.00nan;0;0
6628;80859;514;54;9;1;8;.889;3600000;0
6628;141496;1876;87;42;3;39;.929;3568000;0
6628;143307;1876;0;0;0;0;.00nan;0;0
6629;174581;518;0;0;0;0;.00nan;0;0
6629;142929;1872;87;34;2;32;.941;3600000;0
6629;143523;518;44;34;5;29;.853;3600000;0
6629;152478;1872;0;0;0;0;.00nan;0;0
6630;1072;511;99;27;0;27;1.000;3600000;0
6630;6947;1472;53;37;5;32;.865;3600000;0
6630;57390;1472;0;0;0;0;.00nan;0;0
6630;155474;511;0;0;0;0;.00nan;0;0
6631;6944;520;100;25;0;25;1.000;3600000;0
6631;7332;512;0;0;0;0;.00nan;0;0
6631;143256;520;0;0;0;0;.00nan;0;0
6631;152201;512;65;29;3;26;.897;3600000;0
6632;16587;513;0;0;0;0;.00nan;0;0
6632;37077;513;27;20;5;15;.750;3600000;0
6632;141496;1876;75;41;4;37;.902;3600000;0
6632;143307;1876;0;0;0;0;.00nan;0;0
6633;43896;516;47;19;3;16;.842;3600000;0
6633;86360;519;92;39;2;37;.949;3600000;0
6633;143083;519;0;0;0;0;.00nan;0;0
6633;143191;516;0;0;0;0;.00nan;0;0
6634;8035;524;0;0;0;0;.00nan;0;0
6634;59614;514;38;19;4;15;.789;3600000;0
6634;80859;514;0;0;0;0;.00nan;0;0
6634;152464;524;81;53;5;48;.906;3580000;0
6635;14047;517;49;39;6;33;.846;3600000;0
6635;86099;517;0;0;0;0;.00nan;0;0
6635;86228;515;0;0;0;0;.00nan;0;0
6635;143330;515;100;25;0;25;1.000;3600000;0
6636;86360;519;74;25;2;23;.920;3678000;0
6636;141496;1876;78;23;1;22;.957;3678000;0
6636;143083;519;0;0;0;0;.00nan;0;0
6636;143307;1876;0;0;0;0;.00nan;0;0
6637;8035;524;74;27;2;25;.926;3600000;0
6637;174581;518;0;0;0;0;.00nan;0;0
6637;143523;518;77;36;3;33;.917;3560000;0
6637;152464;524;0;0;0;0;.00nan;0;0
6638;1072;511;42;30;5;25;.833;3600000;0
6638;142929;1872;0;0;0;0;.00nan;0;0
6638;152478;1872;100;27;0;27;1.000;3600000;0
6638;155474;511;0;0;0;0;.00nan;0;0
6639;6944;520;79;33;2;31;.939;3575000;0
6639;14047;517;86;31;1;30;.968;3600000;0
6639;86099;517;0;0;0;0;.00nan;0;0
6639;143256;520;0;0;0;0;.00nan;0;0
6640;7332;512;95;31;1;30;.968;3600000;0
6640;43896;516;19;25;6;19;.760;2899000;0
6640;143191;516;52;3;0;3;1.000;701000;0
6640;152201;512;0;0;0;0;.00nan;0;0
6641;16587;513;0;0;0;0;.00nan;0;0
6641;37077;513;100;52;3;49;.942;3600000;0
6641;59614;514;0;0;0;0;.00nan;0;0
6641;80859;514;44;33;5;28;.848;3569000;0
6642;6947;1472;0;0;0;0;.00nan;0;0
6642;57390;1472;52;38;5;33;.868;3600000;0
6642;86228;515;0;0;0;0;.00nan;0;0
6642;143330;515;90;19;0;19;1.000;3600000;0
6643;6947;1472;0;0;0;0;.00nan;0;0
6643;57390;1472;82;32;1;31;.969;3545000;0
6643;142929;1872;0;0;0;0;.00nan;0;0
6643;152478;1872;98;21;0;21;1.000;3600000;0
6644;6944;520;0;0;0;0;.00nan;0;0
6644;86228;515;0;0;0;0;.00nan;0;0
6644;143256;520;36;26;5;21;.808;3599000;0
6644;143330;515;83;38;3;35;.921;3600000;0
6645;1072;511;84;33;2;31;.939;3600000;0
6645;8035;524;0;0;0;0;.00nan;0;0
6645;152464;524;63;35;4;31;.886;3562000;0
6645;155474;511;0;0;0;0;.00nan;0;0
6646;7332;512;0;0;0;0;.00nan;0;0
6646;141496;1876;36;19;4;15;.789;3562000;0
6646;143307;1876;0;0;0;0;.00nan;0;0
6646;152201;512;73;37;3;34;.919;3600000;0
6647;14047;517;65;22;2;20;.909;3600000;0
6647;43896;516;66;27;3;24;.889;3560000;0
6647;86099;517;0;0;0;0;.00nan;0;0
6647;143191;516;0;0;0;0;.00nan;0;0
6648;16587;513;0;0;0;0;.00nan;0;0
6648;37077;513;76;27;1;26;.963;3600000;0
6648;86360;519;77;32;2;30;.938;3543000;0
6648;143083;519;0;0;0;0;.00nan;0;0
6649;174581;518;0;0;0;0;.00nan;0;0
6649;59614;514;68;13;1;12;.923;3600000;0
6649;80859;514;0;0;0;0;.00nan;0;0
6649;143523;518;71;45;5;40;.889;3600000;0
6650;6947;1472;0;0;0;0;.00nan;0;0
6650;43896;516;0;0;0;0;.00nan;0;0
6650;57390;1472;65;34;3;31;.912;3580000;0
6650;143191;516;75;27;2;25;.926;3600000;0
6651;59614;514;42;25;4;21;.840;3600000;0
6651;80859;514;0;0;0;0;.00nan;0;0
6651;86360;519;83;39;3;36;.923;3600000;0
6651;143083;519;0;0;0;0;.00nan;0;0
6652;174581;518;68;26;3;23;.885;3600000;0
6652;141496;1876;25;32;6;26;.813;3600000;0
6652;143307;1876;0;0;0;0;.00nan;0;0
6652;143523;518;0;0;0;0;.00nan;0;0
6653;1072;511;0;0;0;0;.00nan;0;0
6653;6944;520;0;0;0;0;.00nan;0;0
6653;143256;520;71;31;2;29;.935;3600000;0
6653;155474;511;47;19;3;16;.842;3579000;0
6654;14047;517;60;29;4;25;.862;3600000;0
6654;16587;513;0;0;0;0;.00nan;0;0
6654;37077;513;57;19;2;17;.895;3600000;0
6654;86099;517;0;0;0;0;.00nan;0;0
6655;7332;512;95;16;0;16;1.000;3600000;0
6655;8035;524;90;41;2;39;.951;3524000;0
6655;152201;512;0;0;0;0;.00nan;0;0
6655;152464;524;0;0;0;0;.00nan;0;0
6656;86228;515;0;0;0;0;.00nan;0;0
6656;142929;1872;0;0;0;0;.00nan;0;0
6656;143330;515;90;31;1;30;.968;3600000;0
6656;152478;1872;78;44;4;40;.909;3600000;0
6657;6944;520;52;18;2;16;.889;3600000;0
6657;142929;1872;0;0;0;0;.00nan;0;0
6657;143256;520;0;0;0;0;.00nan;0;0
6657;152478;1872;97;31;1;30;.968;3600000;0
6658;174581;518;0;0;0;0;.00nan;0;0
6658;44141;519;0;0;0;0;.00nan;0;0
6658;86360;519;42;39;6;33;.846;3600000;0
6658;143523;518;82;32;2;30;.938;3600000;0
6659;14047;517;70;25;2;23;.920;3600000;0
6659;86099;517;0;0;0;0;.00nan;0;0
6659;91414;1876;56;6;0;6;1.000;706000;0
6659;141496;1876;42;39;6;33;.846;2894000;0
6660;43896;516;58;40;5;35;.875;3600000;0
6660;86228;515;0;0;0;0;.00nan;0;0
6660;143191;516;0;0;0;0;.00nan;0;0
6660;143330;515;92;33;1;32;.970;3600000;0
6661;7332;512;0;0;0;0;.00nan;0;0
6661;37077;513;79;29;2;27;.931;3900000;0
6661;86579;513;0;0;0;0;.00nan;0;0
6661;152201;512;65;27;2;25;.926;3900000;0
6662;6947;1472;0;0;0;0;.00nan;0;0
6662;8035;524;0;0;0;0;.00nan;0;0
6662;57390;1472;67;30;3;27;.900;3557000;0
6662;152464;524;75;31;2;29;.935;3600000;0
6663;1072;511;51;33;4;29;.879;3600000;0
6663;59614;514;0;0;0;0;.00nan;0;0
6663;80859;514;65;20;1;19;.950;3600000;0
6663;155474;511;0;0;0;0;.00nan;0;0
6664;43896;516;0;0;0;0;.00nan;0;0
6664;142929;1872;0;0;0;0;.00nan;0;0
6664;143191;516;43;25;4;21;.840;3900000;0
6664;152478;1872;40;20;4;16;.800;3900000;0
6665;6944;520;53;36;5;31;.861;3600000;0
6665;6947;1472;100;52;3;49;.942;3600000;0
6665;57390;1472;0;0;0;0;.00nan;0;0
6665;143256;520;0;0;0;0;.00nan;0;0
6666;174581;518;0;0;0;0;.00nan;0;0
6666;37077;513;0;0;0;0;.00nan;0;0
6666;86579;513;77;31;2;29;.935;3600000;0
6666;143523;518;44;25;3;22;.880;3589000;0
6667;1072;511;0;0;0;0;.00nan;0;0
6667;91414;1876;0;0;0;0;.00nan;0;0
6667;141496;1876;71;42;4;38;.905;3600000;0
6667;155474;511;84;16;0;16;1.000;3600000;0
6668;7332;512;53;33;6;27;.818;3600000;0
6668;59614;514;90;40;3;37;.925;3600000;0
6668;80859;514;0;0;0;0;.00nan;0;0
6668;152201;512;0;0;0;0;.00nan;0;0
6669;8035;524;45;28;5;23;.821;3600000;0
6669;14047;517;70;26;2;24;.923;3600000;0
6669;86099;517;0;0;0;0;.00nan;0;0
6669;152464;524;0;0;0;0;.00nan;0;0
6670;44141;519;0;0;0;0;.00nan;0;0
6670;86228;515;0;0;0;0;.00nan;0;0
6670;86360;519;97;39;1;38;.974;3600000;0
6670;143330;515;80;39;3;36;.923;3600000;0
6671;8035;524;81;35;2;33;.943;3600000;0
6671;142929;1872;0;0;0;0;.00nan;0;0
6671;152464;524;0;0;0;0;.00nan;0;0
6671;152478;1872;61;32;4;28;.875;3537000;0
6672;6947;1472;0;0;0;0;.00nan;0;0
6672;57390;1472;73;28;3;25;.893;3600000;0
6672;59614;514;99;24;0;24;1.000;3600000;0
6672;80859;514;0;0;0;0;.00nan;0;0
6673;6944;520;64;24;2;22;.917;3900000;0
6673;91414;1876;0;0;0;0;.00nan;0;0
6673;141496;1876;93;37;2;35;.946;3900000;0
6673;143256;520;0;0;0;0;.00nan;0;0
6674;1072;511;0;0;0;0;.00nan;0;0
6674;43896;516;0;0;0;0;.00nan;0;0
6674;143191;516;77;30;2;28;.933;3544000;0
6674;155474;511;89;25;1;24;.960;3600000;0
6675;14047;517;0;0;0;0;.00nan;0;0
6675;174581;518;0;0;0;0;.00nan;0;0
6675;86099;517;64;31;3;28;.903;3600000;0
6675;143523;518;55;36;6;30;.833;3600000;0
6676;7332;512;51;29;4;25;.862;3600000;0
6676;44141;519;0;0;0;0;.00nan;0;0
6676;86360;519;90;33;1;32;.970;3600000;0
6676;152201;512;0;0;0;0;.00nan;0;0
6677;37077;513;45;29;4;25;.862;3585000;0
6677;86228;515;0;0;0;0;.00nan;0;0
6677;86579;513;0;0;0;0;.00nan;0;0
6677;143330;515;83;27;2;25;.926;3600000;0
6678;6947;1472;43;22;4;18;.818;1632000;0
6678;44141;519;0;0;0;0;.00nan;0;0
6678;57390;1472;39;18;4;14;.778;1968000;0
6678;86360;519;66;37;3;34;.919;3600000;0
6679;7332;512;74;25;1;24;.960;3600000;0
6679;174581;518;0;0;0;0;.00nan;0;0
6679;143523;518;85;59;6;53;.898;3600000;0
6679;152201;512;0;0;0;0;.00nan;0;0
6680;91414;1876;0;0;0;0;.00nan;0;0
6680;141496;1876;97;38;1;37;.974;3600000;0
6680;142929;1872;0;0;0;0;.00nan;0;0
6680;152478;1872;76;39;3;36;.923;3554000;0
6681;6944;520;65;32;3;29;.906;3528000;0
6681;43896;516;0;0;0;0;.00nan;0;0
6681;143191;516;85;30;1;29;.967;3600000;0
6681;143256;520;0;0;0;0;.00nan;0;0
6682;1072;511;41;28;5;23;.821;3600000;0
6682;37077;513;55;27;3;24;.889;3600000;0
6682;86579;513;0;0;0;0;.00nan;0;0
6682;155474;511;0;0;0;0;.00nan;0;0
6683;8035;524;64;45;5;40;.889;3551000;0
6683;86228;515;0;0;0;0;.00nan;0;0
6683;143330;515;46;22;4;18;.818;3600000;0
6683;152464;524;0;0;0;0;.00nan;0;0
6684;14047;517;90;43;2;41;.953;3600000;0
6684;59614;514;89;14;0;14;1.000;3600000;0
6684;80859;514;0;0;0;0;.00nan;0;0
6684;86099;517;0;0;0;0;.00nan;0;0
6685;37077;513;29;33;6;27;.818;3080000;0
6685;86579;513;44;5;1;4;.800;520000;0
6685;142929;1872;84;27;1;26;.963;3600000;0
6685;152478;1872;0;0;0;0;.00nan;0;0
6686;6944;520;100;40;0;40;1.000;3600000;0
6686;59614;514;76;25;1;24;.960;3571000;0
6686;80859;514;0;0;0;0;.00nan;0;0
6686;143256;520;0;0;0;0;.00nan;0;0
6687;1072;511;0;0;0;0;.00nan;0;0
6687;44141;519;0;0;0;0;.00nan;0;0
6687;86360;519;70;37;4;33;.892;3600000;0
6687;155474;511;61;17;1;16;.941;3600000;0
6688;7332;512;56;26;3;23;.885;3600000;0
6688;14047;517;66;37;4;33;.892;3600000;0
6688;86099;517;0;0;0;0;.00nan;0;0
6688;152201;512;0;0;0;0;.00nan;0;0
6689;8035;524;71;33;4;29;.879;3556000;0
6689;43896;516;0;0;0;0;.00nan;0;0
6689;143191;516;71;25;2;23;.920;3600000;0
6689;152464;524;0;0;0;0;.00nan;0;0
6690;174581;518;0;0;0;0;.00nan;0;0
6690;86228;515;0;0;0;0;.00nan;0;0
6690;143330;515;59;20;2;18;.900;3600000;0
6690;143523;518;46;34;5;29;.853;3600000;0
6691;6947;1472;51;25;4;21;.840;3600000;0
6691;57390;1472;0;0;0;0;.00nan;0;0
6691;91414;1876;0;0;0;0;.00nan;0;0
6691;141496;1876;75;46;5;41;.891;3585000;0
6692;14047;517;80;27;1;26;.963;3900000;0
6692;44141;519;0;0;0;0;.00nan;0;0
6692;86099;517;0;0;0;0;.00nan;0;0
6692;86360;519;100;43;1;42;.977;3900000;0
6693;1072;511;0;0;0;0;.00nan;0;0
6693;174581;518;94;44;3;41;.932;3900000;0
6693;143523;518;0;0;0;0;.00nan;0;0
6693;155474;511;56;20;3;17;.850;3900000;0
6694;7332;512;65;23;4;19;.826;3900000;0
6694;142929;1872;0;0;0;0;.00nan;0;0
6694;152201;512;0;0;0;0;.00nan;0;0
6694;152478;1872;80;44;4;40;.909;3900000;0
6695;43896;516;0;0;0;0;.00nan;0;0
6695;91414;1876;57;29;3;26;.897;3900000;0
6695;141496;1876;0;0;0;0;.00nan;0;0
6695;143191;516;60;31;3;28;.903;3900000;0
6696;6947;1472;65;43;5;38;.884;3561000;0
6696;37077;513;0;0;0;0;.00nan;0;0
6696;57390;1472;0;0;0;0;.00nan;0;0
6696;86579;513;61;20;3;17;.850;3600000;0
6697;6944;520;30;19;5;14;.737;3543000;0
6697;8035;524;84;37;4;33;.892;3600000;0
6697;143256;520;0;0;0;0;.00nan;0;0
6697;152464;524;0;0;0;0;.00nan;0;0
6698;59614;514;29;20;5;15;.750;3526000;0
6698;80859;514;0;0;0;0;.00nan;0;0
6698;86228;515;0;0;0;0;.00nan;0;0
6698;143330;515;71;31;3;28;.903;3600000;0
6699;44141;519;0;0;0;0;.00nan;0;0
6699;86360;519;63;40;5;35;.875;3600000;0
6699;142929;1872;0;0;0;0;.00nan;0;0
6699;152478;1872;84;15;0;15;1.000;3600000;0
6700;6947;1472;68;27;2;25;.926;3600000;0
6700;14047;517;66;32;3;29;.906;3583000;0
6700;57390;1472;0;0;0;0;.00nan;0;0
6700;86099;517;0;0;0;0;.00nan;0;0
6701;6944;520;0;0;0;0;.00nan;0;0
6701;174581;518;0;0;0;0;.00nan;0;0
6701;143256;520;69;30;3;27;.900;3600000;0
6701;143523;518;61;37;4;33;.892;3569000;0
6702;1072;511;82;33;3;30;.909;3621000;0
6702;7332;512;63;29;4;25;.862;3621000;0
6702;152201;512;0;0;0;0;.00nan;0;0
6702;155474;511;0;0;0;0;.00nan;0;0
6703;43896;516;0;0;0;0;.00nan;0;0
6703;59614;514;60;24;3;21;.875;3900000;0
6703;80859;514;0;0;0;0;.00nan;0;0
6703;143191;516;95;52;3;49;.942;3900000;0
6704;8035;524;78;35;2;33;.943;3555000;0
6704;37077;513;71;22;1;21;.955;3600000;0
6704;86579;513;0;0;0;0;.00nan;0;0
6704;152464;524;0;0;0;0;.00nan;0;0
6705;86228;515;60;18;2;16;.889;3600000;0
6705;91414;1876;0;0;0;0;.00nan;0;0
6705;141496;1876;96;34;1;33;.971;3600000;0
6705;143330;515;0;0;0;0;.00nan;0;0
6706;6944;520;79;31;2;29;.935;3600000;0
6706;44141;519;0;0;0;0;.00nan;0;0
6706;86360;519;58;45;6;39;.867;3600000;0
6706;143256;520;0;0;0;0;.00nan;0;0
6707;6947;1472;82;25;1;24;.960;3600000;0
6707;174581;518;0;0;0;0;.00nan;0;0
6707;57390;1472;0;0;0;0;.00nan;0;0
6707;143523;518;75;31;2;29;.935;3600000;0
6708;1072;511;0;0;0;0;.00nan;0;0
6708;14047;517;65;32;4;28;.875;3600000;0
6708;86099;517;0;0;0;0;.00nan;0;0
6708;155474;511;72;23;2;21;.913;3600000;0
6709;7332;512;0;0;0;0;.00nan;0;0
6709;86228;515;0;0;0;0;.00nan;0;0
6709;143330;515;91;40;2;38;.950;3600000;0
6709;152201;512;71;34;3;31;.912;3563000;0
6710;8035;524;51;31;5;26;.839;3595000;0
6710;91414;1876;0;0;0;0;.00nan;0;0
6710;141496;1876;65;30;3;27;.900;3600000;0
6710;152464;524;0;0;0;0;.00nan;0;0
6711;37077;513;53;20;2;18;.900;3579000;0
6711;43896;516;0;0;0;0;.00nan;0;0
6711;86579;513;0;0;0;0;.00nan;0;0
6711;143191;516;83;31;1;30;.968;3600000;0
6712;59614;514;88;19;0;19;1.000;3600000;0
6712;80859;514;0;0;0;0;.00nan;0;0
6712;142929;1872;0;0;0;0;.00nan;0;0
6712;152478;1872;98;42;2;40;.952;3591000;0
6713;14047;517;57;40;5;35;.875;3600000;0
6713;86099;517;0;0;0;0;.00nan;0;0
6713;142929;1872;0;0;0;0;.00nan;0;0
6713;152478;1872;80;32;2;30;.938;3600000;0
6714;6947;1472;84;37;3;34;.919;3568000;0
6714;7332;512;74;24;2;22;.917;3600000;0
6714;57390;1472;0;0;0;0;.00nan;0;0
6714;152201;512;0;0;0;0;.00nan;0;0
6715;6944;520;0;0;0;0;.00nan;0;0
6715;37077;513;39;21;4;17;.810;3600000;0
6715;86579;513;0;0;0;0;.00nan;0;0
6715;143256;520;99;53;2;51;.962;3600000;0
6716;8035;524;81;27;2;25;.926;3515000;0
6716;44141;519;0;0;0;0;.00nan;0;0
6716;86360;519;94;21;0;21;1.000;3600000;0
6716;152464;524;0;0;0;0;.00nan;0;0
6717;59614;514;86;19;0;19;1.000;3600000;0
6717;80859;514;0;0;0;0;.00nan;0;0
6717;91414;1876;0;0;0;0;.00nan;0;0
6717;141496;1876;86;41;3;38;.927;3600000;0
6718;174581;518;0;0;0;0;.00nan;0;0
6718;43896;516;51;22;3;19;.864;3593000;0
6718;143191;516;0;0;0;0;.00nan;0;0
6718;143523;518;88;40;2;38;.950;3600000;0
6719;1072;511;54;27;3;24;.889;3570000;0
6719;86228;515;0;0;0;0;.00nan;0;0
6719;143330;515;82;35;2;33;.943;3600000;0
6719;155474;511;0;0;0;0;.00nan;0;0
6720;43896;516;0;0;0;0;.00nan;0;0
6720;44141;519;0;0;0;0;.00nan;0;0
6720;86360;519;69;31;3;28;.903;3564000;0
6720;143191;516;67;23;2;21;.913;3600000;0
6721;174581;518;0;0;0;0;.00nan;0;0
6721;142929;1872;0;0;0;0;.00nan;0;0
6721;143523;518;42;28;5;23;.821;3627000;0
6721;152478;1872;67;34;4;30;.882;3627000;0
6722;1072;511;77;27;2;25;.926;3600000;0
6722;6947;1472;0;0;0;0;.00nan;0;0
6722;57390;1472;40;31;6;25;.806;3600000;0
6722;155474;511;0;0;0;0;.00nan;0;0
6723;14047;517;0;0;0;0;.00nan;0;0
6723;86099;517;83;38;4;34;.895;3600000;0
6723;86228;515;69;25;2;23;.920;3355000;0
6723;143330;515;21;3;3;0;.000;219000;0
6724;6944;520;0;0;0;0;.00nan;0;0
6724;7332;512;0;0;0;0;.00nan;0;0
6724;143256;520;71;32;3;29;.906;3600000;0
6724;152201;512;52;30;4;26;.867;3541000;0
6725;37077;513;0;0;0;0;.00nan;0;0
6725;86579;513;91;21;0;21;1.000;3600000;0
6725;91414;1876;84;37;2;35;.946;3600000;0
6725;141496;1876;0;0;0;0;.00nan;0;0
6726;8035;524;97;49;3;46;.939;3565000;0
6726;59614;514;81;24;2;22;.917;3600000;0
6726;80859;514;0;0;0;0;.00nan;0;0
6726;152464;524;0;0;0;0;.00nan;0;0
6727;1072;511;0;0;0;0;.00nan;0;0
6727;142929;1872;0;0;0;0;.00nan;0;0
6727;152478;1872;88;30;1;29;.967;3600000;0
6727;155474;511;57;18;2;16;.889;3559000;0
6728;6947;1472;100;43;1;42;.977;3600000;0
6728;57390;1472;0;0;0;0;.00nan;0;0
6728;86228;515;0;0;0;0;.00nan;0;0
6728;143330;515;56;24;3;21;.875;3531000;0
6729;6944;520;0;0;0;0;.00nan;0;0
6729;14047;517;57;17;2;15;.882;3600000;0
6729;86099;517;0;0;0;0;.00nan;0;0
6729;143256;520;51;43;7;36;.837;3600000;0
6730;44141;519;0;0;0;0;.00nan;0;0
6730;86360;519;72;10;0;10;1.000;3600000;0
6730;91414;1876;97;43;2;41;.953;3534000;0
6730;141496;1876;0;0;0;0;.00nan;0;0
6731;7332;512;0;0;0;0;.00nan;0;0
6731;43896;516;0;0;0;0;.00nan;0;0
6731;143191;516;77;27;2;25;.926;3600000;0
6731;152201;512;57;28;3;25;.893;3594000;0
6732;8035;524;0;0;0;0;.00nan;0;0
6732;174581;518;0;0;0;0;.00nan;0;0
6732;143523;518;55;46;6;40;.870;3600000;0
6732;152464;524;70;22;2;20;.909;3600000;0
6733;37077;513;0;0;0;0;.00nan;0;0
6733;59614;514;0;0;0;0;.00nan;0;0
6733;80859;514;90;36;2;34;.944;3600000;0
6733;86579;513;50;37;5;32;.865;3600000;0
6734;6947;1472;0;0;0;0;.00nan;0;0
6734;57390;1472;48;22;3;19;.864;3555000;0
6734;142929;1872;0;0;0;0;.00nan;0;0
6734;152478;1872;51;16;2;14;.875;3600000;0
6735;37077;513;48;17;2;15;.882;2405000;0
6735;44141;519;0;0;0;0;.00nan;0;0
6735;86360;519;100;41;2;39;.951;3600000;0
6735;86579;513;29;15;4;11;.733;1195000;0
6736;174581;518;21;23;6;17;.739;2283000;0
6736;59614;514;80;36;2;34;.944;3600000;0
6736;80859;514;0;0;0;0;.00nan;0;0
6736;143523;518;60;19;2;17;.895;1317000;0
6737;14047;517;100;45;1;44;.978;3600000;0
6737;43896;516;0;0;0;0;.00nan;0;0
6737;86099;517;0;0;0;0;.00nan;0;0
6737;143191;516;58;21;2;19;.905;3543000;0
6738;7332;512;0;0;0;0;.00nan;0;0
6738;91414;1876;78;35;3;32;.914;3590000;0
6738;141496;1876;0;0;0;0;.00nan;0;0
6738;152201;512;58;22;2;20;.909;3600000;0
6739;1072;511;41;29;5;24;.828;3575000;0
6739;8035;524;76;34;3;31;.912;3600000;0
6739;152464;524;0;0;0;0;.00nan;0;0
6739;155474;511;0;0;0;0;.00nan;0;0
6740;6944;520;0;0;0;0;.00nan;0;0
6740;86228;515;0;0;0;0;.00nan;0;0
6740;143256;520;91;36;2;34;.944;3600000;0
6740;143330;515;65;31;3;28;.903;3567000;0
6741;86228;515;0;0;0;0;.00nan;0;0
6741;142929;1872;0;0;0;0;.00nan;0;0
6741;143330;515;78;28;2;26;.929;3600000;0
6741;152478;1872;78;46;5;41;.891;3600000;0
6742;1072;511;0;0;0;0;.00nan;0;0
6742;6944;520;71;23;1;22;.957;3160000;0
6742;143256;520;25;6;3;3;.500;358000;0
6742;155474;511;66;26;2;24;.923;3600000;0
6743;174581;518;0;0;0;0;.00nan;0;0
6743;91414;1876;70;23;1;22;.957;3900000;0
6743;141496;1876;0;0;0;0;.00nan;0;0
6743;143523;518;94;32;1;31;.969;3900000;0
6744;6947;1472;67;38;4;34;.895;3600000;0
6744;43896;516;72;22;1;21;.955;3600000;0
6744;57390;1472;0;0;0;0;.00nan;0;0
6744;143191;516;0;0;0;0;.00nan;0;0
6745;14047;517;95;38;1;37;.974;3600000;0
6745;37077;513;79;30;2;28;.933;3543000;0
6745;86099;517;0;0;0;0;.00nan;0;0
6745;86579;513;0;0;0;0;.00nan;0;0
6746;7332;512;0;0;0;0;.00nan;0;0
6746;8035;524;94;50;2;48;.960;3900000;0
6746;152201;512;65;21;2;19;.905;3900000;0
6746;152464;524;0;0;0;0;.00nan;0;0
6747;44141;519;0;0;0;0;.00nan;0;0
6747;59614;514;61;14;1;13;.929;3600000;0
6747;80859;514;0;0;0;0;.00nan;0;0
6747;86360;519;64;28;3;25;.893;3519000;0
6748;6944;520;0;0;0;0;.00nan;0;0
6748;142929;1872;0;0;0;0;.00nan;0;0
6748;143256;520;73;21;1;20;.952;3600000;0
6748;152478;1872;89;32;2;30;.938;3548000;0
6749;6947;1472;0;0;0;0;.00nan;0;0
6749;8035;524;0;0;0;0;.00nan;0;0
6749;57390;1472;67;24;2;22;.917;3600000;0
6749;152464;524;78;47;3;44;.936;3556000;0
6750;174581;518;0;0;0;0;.00nan;0;0
6750;44141;519;0;0;0;0;.00nan;0;0
6750;86360;519;90;37;1;36;.973;3600000;0
6750;143523;518;61;28;3;25;.893;3600000;0
6751;1072;511;65;23;2;21;.913;3600000;0
6751;59614;514;61;33;4;29;.879;3538000;0
6751;80859;514;0;0;0;0;.00nan;0;0
6751;155474;511;0;0;0;0;.00nan;0;0
6752;14047;517;99;31;1;30;.968;3600000;0
6752;86099;517;0;0;0;0;.00nan;0;0
6752;91414;1876;0;0;0;0;.00nan;0;0
6752;141496;1876;57;44;6;38;.864;3600000;0
6753;7332;512;0;0;0;0;.00nan;0;0
6753;37077;513;89;50;4;46;.920;3591000;0
6753;86579;513;0;0;0;0;.00nan;0;0
6753;152201;512;79;25;2;23;.920;3600000;0
6754;43896;516;0;0;0;0;.00nan;0;0
6754;86228;515;0;0;0;0;.00nan;0;0
6754;143191;516;65;21;2;19;.905;3595000;0
6754;143330;515;85;24;1;23;.958;3600000;0
6755;6944;520;44;25;4;21;.840;3600000;0
6755;6947;1472;86;35;2;33;.943;3600000;0
6755;57390;1472;0;0;0;0;.00nan;0;0
6755;143256;520;0;0;0;0;.00nan;0;0
6756;44141;519;100;47;1;46;.979;3600000;0
6756;86228;515;0;0;0;0;.00nan;0;0
6756;86360;519;0;0;0;0;.00nan;0;0
6756;143330;515;59;30;4;26;.867;3600000;0
6757;8035;524;0;0;0;0;.00nan;0;0
6757;14047;517;33;16;4;12;.750;3180000;0
6757;86099;517;49;1;0;1;1.000;395000;0
6757;152464;524;69;30;2;28;.933;3600000;0
6758;1072;511;0;0;0;0;.00nan;0;0
6758;91414;1876;0;0;0;0;.00nan;0;0
6758;141496;1876;100;46;2;44;.957;3900000;0
6758;155474;511;79;38;2;36;.947;3900000;0
6759;43896;516;54;24;3;21;.875;3600000;0
6759;142929;1872;0;0;0;0;.00nan;0;0
6759;143191;516;0;0;0;0;.00nan;0;0
6759;152478;1872;58;39;5;34;.872;3550000;0
6760;174581;518;0;0;0;0;.00nan;0;0
6760;37077;513;60;19;2;17;.895;3600000;0
6760;86579;513;0;0;0;0;.00nan;0;0
6760;143523;518;76;39;3;36;.923;3600000;0
6761;7332;512;0;0;0;0;.00nan;0;0
6761;59614;514;54;17;2;15;.882;3655000;0
6761;80859;514;0;0;0;0;.00nan;0;0
6761;152201;512;74;34;3;31;.912;3655000;0
6762;7332;512;0;0;0;0;.00nan;0;0
6762;44141;519;0;0;0;0;.00nan;0;0
6762;86360;519;54;47;6;41;.872;3548000;0
6762;152201;512;50;28;4;24;.857;3600000;0
6763;14047;517;64;28;3;25;.893;3600000;0
6763;174581;518;0;0;0;0;.00nan;0;0
6763;86099;517;0;0;0;0;.00nan;0;0
6763;143523;518;49;37;6;31;.838;3600000;0
6764;6944;520;0;0;0;0;.00nan;0;0
6764;91414;1876;0;0;0;0;.00nan;0;0
6764;141496;1876;67;44;5;39;.886;3600000;0
6764;143256;520;81;26;1;25;.962;3600000;0
6765;1072;511;81;31;2;29;.935;3600000;0
6765;43896;516;0;0;0;0;.00nan;0;0
6765;143191;516;75;28;3;25;.893;3595000;0
6765;155474;511;0;0;0;0;.00nan;0;0
6766;37077;513;0;0;0;0;.00nan;0;0
6766;86228;515;0;0;0;0;.00nan;0;0
6766;86579;513;67;24;2;22;.917;3600000;0
6766;143330;515;57;22;3;19;.864;3600000;0
6767;8035;524;0;0;0;0;.00nan;0;0
6767;142929;1872;0;0;0;0;.00nan;0;0
6767;152464;524;83;18;0;18;1.000;3600000;0
6767;152478;1872;49;36;5;31;.861;3600000;0
6768;6947;1472;0;0;0;0;.00nan;0;0
6768;57390;1472;98;43;1;42;.977;3600000;0
6768;59614;514;100;29;0;29;1.000;3600000;0
6768;80859;514;0;0;0;0;.00nan;0;0
6769;43896;516;77;24;1;23;.958;3600000;0
6769;91414;1876;71;15;0;15;1.000;732000;0
6769;141496;1876;35;34;6;28;.824;2868000;0
6769;143191;516;0;0;0;0;.00nan;0;0
6770;91414;1876;0;0;0;0;.00nan;0;0
6770;141496;1876;47;24;4;20;.833;3570000;0
6770;142929;1872;84;34;2;32;.941;3600000;0
6770;152478;1872;0;0;0;0;.00nan;0;0
6771;6947;1472;87;35;2;33;.943;3600000;0
6771;44141;519;0;0;0;0;.00nan;0;0
6771;57390;1472;0;0;0;0;.00nan;0;0
6771;86360;519;75;36;3;33;.917;3600000;0
6772;6944;520;0;0;0;0;.00nan;0;0
6772;43896;516;63;16;1;15;.938;3600000;0
6772;143191;516;0;0;0;0;.00nan;0;0
6772;143256;520;57;37;5;32;.865;3600000;0
6773;1072;511;0;0;0;0;.00nan;0;0
6773;37077;513;76;33;2;31;.939;3600000;0
6773;86579;513;0;0;0;0;.00nan;0;0
6773;155474;511;81;38;3;35;.921;3568000;0
6774;14047;517;0;0;0;0;.00nan;0;0
6774;59614;514;68;19;1;18;.947;3600000;0
6774;80859;514;0;0;0;0;.00nan;0;0
6774;86099;517;100;36;0;36;1.000;3600000;0
6775;7332;512;56;17;2;15;.882;3600000;0
6775;174581;518;0;0;0;0;.00nan;0;0
6775;143523;518;83;42;3;39;.929;3600000;0
6775;152201;512;0;0;0;0;.00nan;0;0
6776;8035;524;0;0;0;0;.00nan;0;0
6776;86228;515;0;0;0;0;.00nan;0;0
6776;143330;515;56;23;3;20;.870;3600000;0
6776;152464;524;54;42;6;36;.857;3600000;0
6777;1072;511;46;23;4;19;.826;3900000;0
6777;44141;519;0;0;0;0;.00nan;0;0
6777;86360;519;87;47;4;43;.915;3900000;0
6777;155474;511;0;0;0;0;.00nan;0;0
6778;174581;518;0;0;0;0;.00nan;0;0
6778;86228;515;0;0;0;0;.00nan;0;0
6778;143330;515;66;23;3;20;.870;3600000;0
6778;143523;518;74;44;5;39;.886;3564000;0
6779;7332;512;0;0;0;0;.00nan;0;0
6779;14047;517;0;0;0;0;.00nan;0;0
6779;86099;517;91;39;3;36;.923;3900000;0
6779;152201;512;59;27;3;24;.889;3900000;0
6780;6947;1472;0;0;0;0;.00nan;0;0
6780;57390;1472;83;36;2;34;.944;3600000;0
6780;91414;1876;37;10;3;7;.700;563000;0
6780;141496;1876;44;19;3;16;.842;3037000;0
6781;37077;513;57;27;3;24;.889;3600000;0
6781;86579;513;0;0;0;0;.00nan;0;0
6781;142929;1872;0;0;0;0;.00nan;0;0
6781;152478;1872;52;36;5;31;.861;3589000;0
6782;8035;524;100;36;1;35;.972;3600000;0
6782;43896;516;66;26;3;23;.885;3580000;0
6782;143191;516;0;0;0;0;.00nan;0;0
6782;152464;524;0;0;0;0;.00nan;0;0
6783;6944;520;0;0;0;0;.00nan;0;0
6783;59614;514;70;21;1;20;.952;3600000;0
6783;80859;514;0;0;0;0;.00nan;0;0
6783;143256;520;72;44;4;40;.909;3600000;0
6784;7332;512;63;14;1;13;.929;3600000;0
6784;142929;1872;0;0;0;0;.00nan;0;0
6784;152201;512;0;0;0;0;.00nan;0;0
6784;152478;1872;79;47;3;44;.936;3600000;0
6785;6947;1472;84;40;3;37;.925;3600000;0
6785;37077;513;63;28;4;24;.857;3546000;0
6785;57390;1472;0;0;0;0;.00nan;0;0
6785;86579;513;0;0;0;0;.00nan;0;0
6786;6944;520;0;0;0;0;.00nan;0;0
6786;8035;524;44;31;5;26;.839;3600000;0
6786;143256;520;55;20;2;18;.900;3600000;0
6786;152464;524;0;0;0;0;.00nan;0;0
6787;1072;511;0;0;0;0;.00nan;0;0
6787;174581;518;0;0;0;0;.00nan;0;0
6787;143523;518;51;29;4;25;.862;3592000;0
6787;155474;511;49;16;3;13;.813;3600000;0
6788;14047;517;85;25;1;24;.960;3900000;0
6788;44141;519;0;0;0;0;.00nan;0;0
6788;86099;517;0;0;0;0;.00nan;0;0
6788;86360;519;96;39;1;38;.974;3900000;0
6789;59614;514;69;26;2;24;.923;3900000;0
6789;80859;514;0;0;0;0;.00nan;0;0
6789;86228;515;74;26;2;24;.923;3900000;0
6789;143330;515;0;0;0;0;.00nan;0;0
6790;44141;519;0;0;0;0;.00nan;0;0
6790;86360;519;81;27;1;26;.963;3600000;0
6790;142929;1872;0;0;0;0;.00nan;0;0
6790;152478;1872;88;37;2;35;.946;3600000;0
6791;6944;520;0;0;0;0;.00nan;0;0
6791;174581;518;69;33;3;30;.909;3600000;0
6791;143256;520;100;39;0;39;1.000;3600000;0
6791;143523;518;0;0;0;0;.00nan;0;0
6792;6947;1472;0;0;0;0;.00nan;0;0
6792;14047;517;0;0;0;0;.00nan;0;0
6792;57390;1472;64;22;2;20;.909;3900000;0
6792;86099;517;85;35;2;33;.943;3900000;0
6793;1072;511;54;29;4;25;.862;3600000;0
6793;7332;512;0;0;0;0;.00nan;0;0
6793;152201;512;43;30;5;25;.833;3545000;0
6793;155474;511;0;0;0;0;.00nan;0;0
6794;86228;515;0;0;0;0;.00nan;0;0
6794;91414;1876;0;0;0;0;.00nan;0;0
6794;141496;1876;88;48;3;45;.938;3600000;0
6794;143330;515;92;14;0;14;1.000;3600000;0
6795;8035;524;12;22;7;15;.682;1661000;0
6795;37077;513;0;0;0;0;.00nan;0;0
6795;86579;513;80;28;2;26;.929;3600000;0
6795;152464;524;56;15;1;14;.933;1939000;0
6796;43896;516;0;0;0;0;.00nan;0;0
6796;59614;514;93;39;2;37;.949;3581000;0
6796;80859;514;0;0;0;0;.00nan;0;0
6796;143191;516;70;20;1;19;.950;3600000;0
6797;59614;514;74;33;3;30;.909;3600000;0
6797;80859;514;0;0;0;0;.00nan;0;0
6797;142929;1872;0;0;0;0;.00nan;0;0
6797;152478;1872;74;25;1;24;.960;3600000;0
6798;6947;1472;56;19;3;16;.842;3600000;0
6798;174581;518;0;0;0;0;.00nan;0;0
6798;57390;1472;0;0;0;0;.00nan;0;0
6798;143523;518;58;35;4;31;.886;3600000;0
6799;6944;520;0;0;0;0;.00nan;0;0
6799;44141;519;0;0;0;0;.00nan;0;0
6799;86360;519;25;28;6;22;.786;3600000;0
6799;143256;520;100;26;0;26;1.000;3600000;0
6800;1072;511;0;0;0;0;.00nan;0;0
6800;14047;517;0;0;0;0;.00nan;0;0
6800;86099;517;65;17;1;16;.941;3600000;0
6800;155474;511;65;23;2;21;.913;3588000;0
6801;37077;513;54;37;5;32;.865;3600000;0
6801;43896;516;86;29;1;28;.966;3600000;0
6801;86579;513;0;0;0;0;.00nan;0;0
6801;143191;516;0;0;0;0;.00nan;0;0
6802;8035;524;0;0;0;0;.00nan;0;0
6802;91414;1876;96;36;1;35;.972;3600000;0
6802;141496;1876;0;0;0;0;.00nan;0;0
6802;152464;524;76;33;2;31;.939;3552000;0
6803;7332;512;77;31;2;29;.935;3600000;0
6803;86228;515;0;0;0;0;.00nan;0;0
6803;143330;515;46;24;4;20;.833;3600000;0
6803;152201;512;0;0;0;0;.00nan;0;0
6804;43896;516;0;0;0;0;.00nan;0;0
6804;44141;519;97;44;1;43;.977;3900000;0
6804;86360;519;0;0;0;0;.00nan;0;0
6804;143191;516;78;27;1;26;.963;3900000;0
6805;174581;518;0;0;0;0;.00nan;0;0
6805;142929;1872;0;0;0;0;.00nan;0;0
6805;143523;518;100;24;0;24;1.000;3600000;0
6805;152478;1872;52;26;3;23;.885;3600000;0
6806;1072;511;55;27;3;24;.889;3600000;0
6806;6947;1472;0;0;0;0;.00nan;0;0
6806;57390;1472;57;36;4;32;.889;3556000;0
6806;155474;511;0;0;0;0;.00nan;0;0
6807;14047;517;0;0;0;0;.00nan;0;0
6807;86099;517;89;51;5;46;.902;3600000;0
6807;86228;515;0;0;0;0;.00nan;0;0
6807;143330;515;88;27;1;26;.963;3600000;0
6808;6944;520;0;0;0;0;.00nan;0;0
6808;7332;512;0;0;0;0;.00nan;0;0
6808;143256;520;89;42;3;39;.929;3568000;0
6808;152201;512;60;21;2;19;.905;3600000;0
6809;37077;513;67;31;2;29;.935;3544000;0
6809;86579;513;0;0;0;0;.00nan;0;0
6809;91414;1876;100;36;1;35;.972;3600000;0
6809;141496;1876;0;0;0;0;.00nan;0;0
6810;8035;524;74;50;5;45;.900;3600000;0
6810;59614;514;95;20;0;20;1.000;3600000;0
6810;80859;514;0;0;0;0;.00nan;0;0
6810;152464;524;0;0;0;0;.00nan;0;0
6811;8035;524;71;21;2;19;.905;3545000;0
6811;44141;519;0;0;0;0;.00nan;0;0
6811;86360;519;97;36;1;35;.972;3600000;0
6811;152464;524;0;0;0;0;.00nan;0;0
6812;174581;518;0;0;0;0;.00nan;0;0
6812;43896;516;65;22;2;20;.909;3600000;0
6812;143191;516;0;0;0;0;.00nan;0;0
6812;143523;518;41;44;7;37;.841;3600000;0
6813;1072;511;0;0;0;0;.00nan;0;0
6813;86228;515;0;0;0;0;.00nan;0;0
6813;143330;515;52;15;2;13;.867;3600000;0
6813;155474;511;91;41;3;38;.927;3600000;0
6814;14047;517;0;0;0;0;.00nan;0;0
6814;86099;517;84;32;2;30;.938;3600000;0
6814;142929;1872;0;0;0;0;.00nan;0;0
6814;152478;1872;52;29;4;25;.862;3550000;0
6815;6947;1472;87;36;3;33;.917;3900000;0
6815;7332;512;56;17;3;14;.824;3900000;0
6815;57390;1472;0;0;0;0;.00nan;0;0
6815;152201;512;0;0;0;0;.00nan;0;0
6816;6944;520;0;0;0;0;.00nan;0;0
6816;37077;513;0;0;0;0;.00nan;0;0
6816;86579;513;75;27;1;26;.963;3900000;0
6816;143256;520;88;30;1;29;.967;3900000;0
6817;59614;514;0;0;0;0;.00nan;0;0
6817;80859;514;74;21;1;20;.952;3600000;0
6817;91414;1876;18;10;4;6;.600;1148000;0
6817;141496;1876;86;31;1;30;.968;2452000;0
6818;174581;518;0;0;0;0;.00nan;0;0
6818;142929;1872;0;0;0;0;.00nan;0;0
6818;143523;518;100;38;1;37;.974;3600000;0
6818;152478;1872;71;25;2;23;.920;3561000;0
6819;1072;511;63;20;2;18;.900;3600000;0
6819;6947;1472;0;0;0;0;.00nan;0;0
6819;57390;1472;98;55;4;51;.927;3533000;0
6819;155474;511;0;0;0;0;.00nan;0;0
6820;6944;520;62;40;5;35;.875;3600000;0
6820;7332;512;0;0;0;0;.00nan;0;0
6820;143256;520;0;0;0;0;.00nan;0;0
6820;152201;512;72;29;2;27;.931;3600000;0
6821;37077;513;74;30;2;28;.933;3600000;0
6821;86579;513;0;0;0;0;.00nan;0;0
6821;91414;1876;29;36;7;29;.806;3600000;0
6821;141496;1876;0;0;0;0;.00nan;0;0
6822;43896;516;0;0;0;0;.00nan;0;0
6822;44141;519;0;0;0;0;.00nan;0;0
6822;86360;519;93;40;2;38;.950;3900000;0
6822;143191;516;87;32;2;30;.938;3885000;0
6823;14047;517;0;0;0;0;.00nan;0;0
6823;86099;517;86;42;3;39;.929;3671000;0
6823;86228;515;0;0;0;0;.00nan;0;0
6823;143330;515;77;26;2;24;.923;3671000;0
6824;8035;524;94;44;2;42;.955;3600000;0
6824;59614;514;76;20;1;19;.950;3600000;0
6824;80859;514;0;0;0;0;.00nan;0;0
6824;152464;524;0;0;0;0;.00nan;0;0
6825;44141;519;0;0;0;0;.00nan;0;0
6825;86360;519;61;27;3;24;.889;3563000;0
6825;91414;1876;0;0;0;0;.00nan;0;0
6825;141496;1876;93;34;1;33;.971;3600000;0
6826;8035;524;34;32;6;26;.813;3516000;0
6826;174581;518;0;0;0;0;.00nan;0;0
6826;143523;518;82;47;4;43;.915;3600000;0
6826;152464;524;0;0;0;0;.00nan;0;0
6827;1072;511;0;0;0;0;.00nan;0;0
6827;142929;1872;0;0;0;0;.00nan;0;0
6827;152478;1872;92;43;4;39;.907;3600000;0
6827;155474;511;100;35;0;35;1.000;3600000;0
6828;6944;520;0;0;0;0;.00nan;0;0
6828;14047;517;0;0;0;0;.00nan;0;0
6828;86099;517;55;21;3;18;.857;3900000;0
6828;143256;520;90;41;3;38;.927;3900000;0
6829;7332;512;100;44;2;42;.955;3857000;0
6829;43896;516;70;36;3;33;.917;3857000;0
6829;143191;516;0;0;0;0;.00nan;0;0
6829;152201;512;0;0;0;0;.00nan;0;0
6830;37077;513;94;40;2;38;.950;3900000;0
6830;59614;514;96;48;2;46;.958;3900000;0
6830;80859;514;0;0;0;0;.00nan;0;0
6830;86579;513;0;0;0;0;.00nan;0;0
6831;6947;1472;90;49;3;46;.939;3600000;0
6831;57390;1472;0;0;0;0;.00nan;0;0
6831;86228;515;0;0;0;0;.00nan;0;0
6831;143330;515;44;24;4;20;.833;3545000;0
6832;6947;1472;0;0;0;0;.00nan;0;0
6832;57390;1472;41;29;5;24;.828;3600000;0
6832;142929;1872;0;0;0;0;.00nan;0;0
6832;152478;1872;87;36;2;34;.944;3600000;0
6833;6944;520;64;33;4;29;.879;3600000;0
6833;86228;515;0;0;0;0;.00nan;0;0
6833;143256;520;0;0;0;0;.00nan;0;0
6833;143330;515;74;26;2;24;.923;3600000;0
6834;7332;512;0;0;0;0;.00nan;0;0
6834;91414;1876;60;25;3;22;.880;3600000;0
6834;141496;1876;0;0;0;0;.00nan;0;0
6834;152201;512;31;26;6;20;.769;3600000;0
6835;14047;517;0;0;0;0;.00nan;0;0
6835;43896;516;0;0;0;0;.00nan;0;0
6835;86099;517;48;33;5;28;.848;3600000;0
6835;143191;516;60;35;4;31;.886;3600000;0
6836;37077;513;40;23;4;19;.826;3592000;0
6836;44141;519;0;0;0;0;.00nan;0;0
6836;86360;519;79;32;2;30;.938;3600000;0
6836;86579;513;0;0;0;0;.00nan;0;0
6837;1072;511;74;22;1;21;.955;3600000;0
6837;8035;524;0;0;0;0;.00nan;0;0
6837;152464;524;82;51;4;47;.922;3600000;0
6837;155474;511;0;0;0;0;.00nan;0;0
6838;174581;518;0;0;0;0;.00nan;0;0
6838;59614;514;78;23;1;22;.957;3600000;0
6838;80859;514;0;0;0;0;.00nan;0;0
6838;143523;518;34;28;6;22;.786;3600000;0
6839;43896;516;88;26;1;25;.962;3600000;0
6839;57390;1472;86;32;2;30;.938;3574000;0
6839;80859;1472;0;0;0;0;.00nan;0;0
6839;143191;516;0;0;0;0;.00nan;0;0
6840;6947;514;0;0;0;0;.00nan;0;0
6840;44141;519;0;0;0;0;.00nan;0;0
6840;59614;514;62;38;4;34;.895;3600000;0
6840;86360;519;93;39;1;38;.974;3600000;0
6841;174581;518;0;0;0;0;.00nan;0;0
6841;91414;1876;0;0;0;0;.00nan;0;0
6841;141496;1876;65;35;3;32;.914;3543000;0
6841;143523;518;100;42;1;41;.976;3600000;0
6842;1072;511;0;0;0;0;.00nan;0;0
6842;6944;520;58;6;0;6;1.000;258000;0
6842;143256;520;70;55;6;49;.891;3342000;0
6842;155474;511;98;19;0;19;1.000;3600000;0
6843;14047;517;0;0;0;0;.00nan;0;0
6843;37077;513;100;32;0;32;1.000;3600000;0
6843;86099;517;75;31;2;29;.935;3580000;0
6843;86579;513;0;0;0;0;.00nan;0;0
6844;7332;512;59;23;3;20;.870;3600000;0
6844;8035;524;66;56;6;50;.893;3600000;0
6844;152201;512;0;0;0;0;.00nan;0;0
6844;152464;524;0;0;0;0;.00nan;0;0
6845;86228;515;0;0;0;0;.00nan;0;0
6845;142929;1872;60;6;0;6;1.000;437000;0
6845;143330;515;81;24;1;23;.958;3600000;0
6845;152478;1872;67;46;5;41;.891;3163000;0
6846;6944;520;0;0;0;0;.00nan;0;0
6846;142929;1872;0;0;0;0;.00nan;0;0
6846;143256;520;84;27;1;26;.963;3900000;0
6846;152478;1872;84;28;1;27;.964;3900000;0
6847;174581;518;0;0;0;0;.00nan;0;0
6847;44141;519;83;32;2;30;.938;3600000;0
6847;86360;519;0;0;0;0;.00nan;0;0
6847;143523;518;83;44;3;41;.932;3543000;0
6848;14047;517;0;0;0;0;.00nan;0;0
6848;86099;517;48;16;2;14;.875;3900000;0
6848;91414;1876;0;0;0;0;.00nan;0;0
6848;141496;1876;85;32;2;30;.938;3900000;0
6849;43896;516;0;0;0;0;.00nan;0;0
6849;86228;515;0;0;0;0;.00nan;0;0
6849;143191;516;85;34;3;31;.912;3600000;0
6849;143330;515;71;39;4;35;.897;3594000;0
6850;7332;512;0;0;0;0;.00nan;0;0
6850;37077;513;37;33;5;28;.848;3600000;0
6850;86579;513;0;0;0;0;.00nan;0;0
6850;152201;512;80;14;0;14;1.000;3600000;0
6851;8035;524;90;31;1;30;.968;3600000;0
6851;57390;1472;78;26;2;24;.923;3600000;0
6851;80859;1472;0;0;0;0;.00nan;0;0
6851;152464;524;0;0;0;0;.00nan;0;0
6852;1072;511;93;42;1;41;.976;3600000;0
6852;6947;514;69;23;2;21;.913;3551000;0
6852;59614;514;0;0;0;0;.00nan;0;0
6852;155474;511;0;0;0;0;.00nan;0;0
6853;43896;516;0;0;0;0;.00nan;0;0
6853;142929;1872;0;0;0;0;.00nan;0;0
6853;143191;516;33;18;4;14;.778;3561000;0
6853;152478;1872;84;33;3;30;.909;3600000;0
6854;6944;520;0;0;0;0;.00nan;0;0
6854;57390;1472;57;27;3;24;.889;3514000;0
6854;80859;1472;0;0;0;0;.00nan;0;0
6854;143256;520;82;25;1;24;.960;3600000;0
6855;174581;518;0;0;0;0;.00nan;0;0
6855;37077;513;65;21;2;19;.905;3600000;0
6855;86579;513;0;0;0;0;.00nan;0;0
6855;143523;518;81;41;3;38;.927;3551000;0
6856;1072;511;0;0;0;0;.00nan;0;0
6856;91414;1876;0;0;0;0;.00nan;0;0
6856;141496;1876;69;45;4;41;.911;3597000;0
6856;155474;511;45;18;3;15;.833;3600000;0
6857;8035;524;0;0;0;0;.00nan;0;0
6857;14047;517;0;0;0;0;.00nan;0;0
6857;86099;517;58;20;2;18;.900;3600000;0
6857;152464;524;95;46;3;43;.935;3599000;0
6858;6947;514;0;0;0;0;.00nan;0;0
6858;7332;512;0;0;0;0;.00nan;0;0
6858;59614;514;87;35;2;33;.943;3600000;0
6858;152201;512;68;32;3;29;.906;3600000;0
6859;44141;519;58;17;1;16;.941;1323000;0
6859;86228;515;0;0;0;0;.00nan;0;0
6859;86360;519;20;15;5;10;.667;2277000;0
6859;143330;515;72;29;2;27;.931;3600000;0
6860;8035;524;0;0;0;0;.00nan;0;0
6860;142929;1872;0;0;0;0;.00nan;0;0
6860;152464;524;40;33;6;27;.818;3600000;0
6860;152478;1872;85;24;1;23;.958;3600000;0
6861;6947;514;0;0;0;0;.00nan;0;0
6861;57390;1472;64;33;3;30;.909;3600000;0
6861;59614;514;64;29;4;25;.862;3545000;0
6861;80859;1472;0;0;0;0;.00nan;0;0
6862;6944;520;75;24;1;23;.958;3600000;0
6862;91414;1876;0;0;0;0;.00nan;0;0
6862;141496;1876;75;38;3;35;.921;3597000;0
6862;143256;520;0;0;0;0;.00nan;0;0
6863;1072;511;0;0;0;0;.00nan;0;0
6863;43896;516;81;36;2;34;.944;3845000;0
6863;143191;516;0;0;0;0;.00nan;0;0
6863;155474;511;77;31;1;30;.968;3845000;0
6864;14047;517;0;0;0;0;.00nan;0;0
6864;174581;518;0;0;0;0;.00nan;0;0
6864;86099;517;73;24;1;23;.958;3600000;0
6864;143523;518;50;43;6;37;.860;3600000;0
6865;7332;512;80;34;2;32;.941;3900000;0
6865;44141;519;0;0;0;0;.00nan;0;0
6865;86360;519;74;30;2;28;.933;3898000;0
6865;152201;512;0;0;0;0;.00nan;0;0
6866;37077;513;50;29;4;25;.862;3577000;0
6866;86228;515;0;0;0;0;.00nan;0;0
6866;86579;513;0;0;0;0;.00nan;0;0
6866;143330;515;84;29;2;27;.931;3600000;0
6867;44141;519;0;0;0;0;.00nan;0;0
6867;57390;1472;82;29;1;28;.966;3600000;0
6867;80859;1472;0;0;0;0;.00nan;0;0
6867;86360;519;64;34;4;30;.882;3600000;0
6868;7332;512;0;0;0;0;.00nan;0;0
6868;174581;518;74;16;0;16;1.000;1253000;0
6868;143523;518;53;44;6;38;.864;2347000;0
6868;152201;512;57;20;2;18;.900;3600000;0
6869;91414;1876;86;33;2;31;.939;3600000;0
6869;141496;1876;0;0;0;0;.00nan;0;0
6869;142929;1872;0;0;0;0;.00nan;0;0
6869;152478;1872;77;25;3;22;.880;3600000;0
6870;6944;520;0;0;0;0;.00nan;0;0
6870;43896;516;0;0;0;0;.00nan;0;0
6870;143191;516;60;21;2;19;.905;3600000;0
6870;143256;520;44;28;4;24;.857;3534000;0
6871;1072;511;0;0;0;0;.00nan;0;0
6871;37077;513;0;0;0;0;.00nan;0;0
6871;86579;513;90;31;1;30;.968;3600000;0
6871;155474;511;59;28;3;25;.893;3600000;0
6872;8035;524;0;0;0;0;.00nan;0;0
6872;86228;515;0;0;0;0;.00nan;0;0
6872;143330;515;93;37;2;35;.946;3594000;0
6872;152464;524;100;36;0;36;1.000;3600000;0
6873;6947;514;86;15;0;15;1.000;3600000;0
6873;14047;517;0;0;0;0;.00nan;0;0
6873;59614;514;0;0;0;0;.00nan;0;0
6873;86099;517;98;44;1;43;.977;3600000;0
6874;37077;513;53;24;3;21;.875;3600000;0
6874;86579;513;0;0;0;0;.00nan;0;0
6874;142929;1872;0;0;0;0;.00nan;0;0
6874;152478;1872;100;22;0;22;1.000;3600000;0
6875;57390;1472;69;31;3;28;.903;3772000;0
6875;80859;1472;0;0;0;0;.00nan;0;0
6875;91414;1876;0;0;0;0;.00nan;0;0
6875;141496;1876;59;35;4;31;.886;3772000;0
6876;6944;520;0;0;0;0;.00nan;0;0
6876;6947;514;62;31;3;28;.903;3600000;0
6876;59614;514;0;0;0;0;.00nan;0;0
6876;143256;520;69;28;2;26;.929;3600000;0
6877;14047;511;69;36;3;33;.917;3600000;0
6877;44141;519;59;16;2;14;.875;1511000;0
6877;86360;519;16;17;6;11;.647;2089000;0
6877;155474;511;0;0;0;0;.00nan;0;0
6878;7332;512;100;32;0;32;1.000;3900000;0
6878;62287;517;0;0;0;0;.00nan;0;0
6878;86099;517;98;42;0;42;1.000;3900000;0
6878;152201;512;0;0;0;0;.00nan;0;0
6879;8035;524;0;0;0;0;.00nan;0;0
6879;43896;516;51;25;4;21;.840;3752000;0
6879;143191;516;0;0;0;0;.00nan;0;0
6879;152464;524;90;46;3;43;.935;3752000;0
6880;174581;518;0;0;0;0;.00nan;0;0
6880;86228;515;0;0;0;0;.00nan;0;0
6880;143330;515;100;24;0;24;1.000;3600000;0
6880;143523;518;84;35;2;33;.943;3600000;0
6881;44141;519;0;0;0;0;.00nan;0;0
6881;62287;517;0;0;0;0;.00nan;0;0
6881;86099;517;51;19;3;16;.842;3557000;0
6881;86360;519;79;33;2;31;.939;3600000;0
6882;14047;511;86;27;1;26;.963;3600000;0
6882;174581;518;0;0;0;0;.00nan;0;0
6882;143523;518;77;36;2;34;.944;3567000;0
6882;155474;511;0;0;0;0;.00nan;0;0
6883;7332;512;0;0;0;0;.00nan;0;0
6883;142929;1872;0;0;0;0;.00nan;0;0
6883;152201;512;65;18;1;17;.944;3600000;0
6883;152478;1872;65;35;3;32;.914;3600000;0
6884;43896;516;0;0;0;0;.00nan;0;0
6884;91414;1876;80;42;4;38;.905;3561000;0
6884;141496;1876;0;0;0;0;.00nan;0;0
6884;143191;516;49;17;3;14;.824;3600000;0
6885;37077;513;100;20;0;20;1.000;3600000;0
6885;57390;1472;62;33;3;30;.909;3600000;0
6885;80859;1472;0;0;0;0;.00nan;0;0
6885;86579;513;0;0;0;0;.00nan;0;0
6886;6944;520;0;0;0;0;.00nan;0;0
6886;8035;524;0;0;0;0;.00nan;0;0
6886;143256;520;59;37;5;32;.865;3600000;0
6886;152464;524;83;25;1;24;.960;3600000;0
6887;6947;514;0;0;0;0;.00nan;0;0
6887;59614;514;91;40;2;38;.950;3600000;0
6887;86228;515;0;0;0;0;.00nan;0;0
6887;143330;515;91;44;4;40;.909;3550000;0
6888;44141;519;0;0;0;0;.00nan;0;0
6888;86360;519;57;31;4;27;.871;3554000;0
6888;142929;1872;0;0;0;0;.00nan;0;0
6888;152478;1872;75;28;2;26;.929;3600000;0
6889;57390;1472;51;2;0;2;1.000;282000;0
6889;62287;517;0;0;0;0;.00nan;0;0
6889;80859;1472;21;22;6;16;.727;3318000;0
6889;86099;517;60;32;4;28;.875;3600000;0
6890;6944;520;0;0;0;0;.00nan;0;0
6890;174581;518;0;0;0;0;.00nan;0;0
6890;143256;520;65;27;3;24;.889;3600000;0
6890;143523;518;55;35;4;31;.886;3544000;0
6891;7332;512;54;21;2;19;.905;3600000;0
6891;14047;511;69;53;6;47;.887;3600000;0
6891;152201;512;0;0;0;0;.00nan;0;0
6891;155474;511;0;0;0;0;.00nan;0;0
6892;6947;514;0;0;0;0;.00nan;0;0
6892;43896;516;70;34;3;31;.912;3539000;0
6892;59614;514;81;23;1;22;.957;3600000;0
6892;143191;516;0;0;0;0;.00nan;0;0
6893;8035;524;0;0;0;0;.00nan;0;0
6893;37077;513;52;29;4;25;.862;3569000;0
6893;86579;513;0;0;0;0;.00nan;0;0
6893;152464;524;100;58;2;56;.966;3600000;0
6894;86228;515;55;20;2;18;.900;3900000;0
6894;91414;1876;0;0;0;0;.00nan;0;0
6894;141496;1876;100;42;2;40;.952;3900000;0
6894;143330;515;0;0;0;0;.00nan;0;0
6895;6944;520;0;0;0;0;.00nan;0;0
6895;44141;519;0;0;0;0;.00nan;0;0
6895;86360;519;61;16;1;15;.938;3600000;0
6895;143256;520;72;40;3;37;.925;3567000;0
6896;174581;518;0;0;0;0;.00nan;0;0
6896;57390;1472;80;30;2;28;.933;3707000;0
6896;80859;1472;0;0;0;0;.00nan;0;0
6896;143523;518;92;46;3;43;.935;3707000;0
6897;14047;511;75;22;1;21;.955;3600000;0
6897;62287;517;0;0;0;0;.00nan;0;0
6897;86099;517;86;42;3;39;.929;3600000;0
6897;155474;511;0;0;0;0;.00nan;0;0
6898;7332;512;0;0;0;0;.00nan;0;0
6898;86228;515;0;0;0;0;.00nan;0;0
6898;143330;515;73;44;5;39;.886;3600000;0
6898;152201;512;73;26;2;24;.923;3600000;0
6899;8035;524;0;0;0;0;.00nan;0;0
6899;91414;1876;52;25;3;22;.880;3536000;0
6899;141496;1876;0;0;0;0;.00nan;0;0
6899;152464;524;98;37;1;36;.973;3600000;0
6900;37077;513;0;0;0;0;.00nan;0;0
6900;43896;516;0;0;0;0;.00nan;0;0
6900;86579;513;63;33;4;29;.879;3575000;0
6900;143191;516;70;26;2;24;.923;3600000;0
6901;6947;514;87;17;0;17;1.000;3600000;0
6901;59614;514;0;0;0;0;.00nan;0;0
6901;142929;1872;0;0;0;0;.00nan;0;0
6901;152478;1872;63;31;3;28;.903;3600000;0
6902;62287;517;0;0;0;0;.00nan;0;0
6902;86099;517;100;25;0;25;1.000;3600000;0
6902;142929;1872;64;18;2;16;.889;2085000;0
6902;152478;1872;26;26;6;20;.769;1515000;0
6903;7332;512;43;27;4;23;.852;3600000;0
6903;57390;1472;41;39;6;33;.846;3553000;0
6903;80859;1472;0;0;0;0;.00nan;0;0
6903;152201;512;0;0;0;0;.00nan;0;0
6904;6944;520;0;0;0;0;.00nan;0;0
6904;37077;513;80;27;2;25;.926;3900000;0
6904;86579;513;0;0;0;0;.00nan;0;0
6904;143256;520;90;38;2;36;.947;3900000;0
6905;6947;514;92;31;1;30;.968;3900000;0
6905;59614;514;0;0;0;0;.00nan;0;0
6905;91414;1876;0;0;0;0;.00nan;0;0
6905;141496;1876;94;49;1;48;.980;3900000;0
6906;174581;518;0;0;0;0;.00nan;0;0
6906;43896;516;40;23;4;19;.826;3600000;0
6906;143191;516;0;0;0;0;.00nan;0;0
6906;143523;518;46;34;5;29;.853;3547000;0
6907;8035;524;0;0;0;0;.00nan;0;0
6907;44141;519;0;0;0;0;.00nan;0;0
6907;86360;519;91;32;2;30;.938;3600000;0
6907;152464;524;45;40;6;34;.850;3600000;0
6908;14047;511;54;39;6;33;.846;3600000;0
6908;86228;515;0;0;0;0;.00nan;0;0
6908;143330;515;92;35;2;33;.943;3600000;0
6908;155474;511;0;0;0;0;.00nan;0;0
6909;14047;511;78;30;2;28;.933;3600000;0
6909;142929;1872;0;0;0;0;.00nan;0;0
6909;152478;1872;51;34;5;29;.853;3600000;0
6909;155474;511;0;0;0;0;.00nan;0;0
6910;57390;1472;0;0;0;0;.00nan;0;0
6910;80859;1472;99;63;4;59;.937;3900000;0
6910;86228;515;69;20;0;20;1.000;1855000;0
6910;143330;515;26;13;4;9;.692;2045000;0
6911;6944;520;37;33;6;27;.818;3600000;0
6911;62287;517;0;0;0;0;.00nan;0;0
6911;86099;517;100;24;0;24;1.000;3600000;0
6911;143256;520;0;0;0;0;.00nan;0;0
6912;44141;519;0;0;0;0;.00nan;0;0
6912;86360;519;55;32;4;28;.875;3517000;0
6912;91414;1876;0;0;0;0;.00nan;0;0
6912;141496;1876;79;32;2;30;.938;3600000;0
6913;7332;512;0;0;0;0;.00nan;0;0
6913;43896;516;51;25;4;21;.840;3600000;0
6913;143191;516;0;0;0;0;.00nan;0;0
6913;152201;512;99;24;0;24;1.000;3600000;0
6914;8035;524;0;0;0;0;.00nan;0;0
6914;174581;518;0;0;0;0;.00nan;0;0
6914;143523;518;63;20;2;18;.900;3802000;0
6914;152464;524;87;44;3;41;.932;3802000;0
6915;6947;514;56;18;2;16;.889;3759000;0
6915;37077;513;83;37;3;34;.919;3789000;0
6915;59614;514;0;0;0;0;.00nan;0;0
6915;86579;513;0;0;0;0;.00nan;0;0
6916;57390;1472;93;31;1;30;.968;3600000;0
6916;80859;1472;0;0;0;0;.00nan;0;0
6916;142929;1872;0;0;0;0;.00nan;0;0
6916;152478;1872;59;34;4;30;.882;3600000;0
6917;37077;513;100;24;0;24;1.000;3600000;0
6917;44141;519;0;0;0;0;.00nan;0;0
6917;86360;519;62;29;3;26;.897;3600000;0
6917;86579;513;0;0;0;0;.00nan;0;0
6918;6947;514;0;0;0;0;.00nan;0;0
6918;174581;518;0;0;0;0;.00nan;0;0
6918;59614;514;82;22;1;21;.955;3900000;0
6918;143523;518;100;30;1;29;.967;3900000;0
6919;8035;524;0;0;0;0;.00nan;0;0
6919;14047;511;78;21;1;20;.952;3600000;0
6919;152464;524;68;40;3;37;.925;3600000;0
6919;155474;511;0;0;0;0;.00nan;0;0
6920;43896;516;75;30;2;28;.933;3900000;0
6920;62287;517;0;0;0;0;.00nan;0;0
6920;86099;517;88;38;2;36;.947;3896000;0
6920;143191;516;0;0;0;0;.00nan;0;0
6921;7332;512;0;0;0;0;.00nan;0;0
6921;91414;1876;64;46;5;41;.891;3600000;0
6921;141496;1876;0;0;0;0;.00nan;0;0
6921;152201;512;67;19;1;18;.947;3600000;0
6922;6944;520;66;11;0;11;1.000;1781000;0
6922;86228;515;0;0;0;0;.00nan;0;0
6922;143256;520;52;29;5;24;.828;1819000;0
6922;143330;515;86;33;2;31;.939;3600000;0
6923;86228;515;0;0;0;0;.00nan;0;0
6923;142929;1872;0;0;0;0;.00nan;0;0
6923;143330;515;93;36;2;34;.944;3600000;0
6923;152478;1872;57;23;3;20;.870;3574000;0
6924;6944;520;56;6;0;6;1.000;695000;0
6924;14047;511;73;28;2;26;.929;3600000;0
6924;143256;520;1;17;7;10;.588;2905000;0
6924;155474;511;0;0;0;0;.00nan;0;0
6925;174581;518;0;0;0;0;.00nan;0;0
6925;91414;1876;0;0;0;0;.00nan;0;0
6925;141496;1876;66;26;2;24;.923;3600000;0
6925;143523;518;61;35;4;31;.886;3573000;0
6926;43896;516;97;19;0;19;1.000;3600000;0
6926;57390;1472;98;42;2;40;.952;3600000;0
6926;80859;1472;0;0;0;0;.00nan;0;0
6926;143191;516;0;0;0;0;.00nan;0;0
6927;37077;513;38;24;4;20;.833;3600000;0
6927;62287;517;0;0;0;0;.00nan;0;0
6927;86099;517;100;31;0;31;1.000;3600000;0
6927;86579;513;0;0;0;0;.00nan;0;0
6928;7332;512;54;26;3;23;.885;3574000;0
6928;8035;524;0;0;0;0;.00nan;0;0
6928;152201;512;0;0;0;0;.00nan;0;0
6928;152464;524;97;45;2;43;.956;3600000;0
6929;6947;514;85;27;1;26;.963;3600000;0
6929;44141;519;0;0;0;0;.00nan;0;0
6929;59614;514;0;0;0;0;.00nan;0;0
6929;86360;519;56;42;4;38;.905;3600000;0
6930;6944;520;0;0;0;0;.00nan;0;0
6930;142929;1872;66;18;1;17;.944;3600000;0
6930;143256;520;45;29;5;24;.828;3600000;0
6930;152478;1872;0;0;0;0;.00nan;0;0
6931;8035;524;0;0;0;0;.00nan;0;0
6931;57390;1472;0;0;0;0;.00nan;0;0
6931;80859;1472;53;36;5;31;.861;3555000;0
6931;152464;524;86;49;4;45;.918;3600000;0
6932;174581;518;0;0;0;0;.00nan;0;0
6932;44141;519;0;0;0;0;.00nan;0;0
6932;86360;519;67;32;4;28;.875;3600000;0
6932;143523;518;79;34;3;31;.912;3600000;0
6933;6947;514;46;15;3;12;.800;3548000;0
6933;14047;511;91;39;2;37;.949;3600000;0
6933;59614;514;0;0;0;0;.00nan;0;0
6933;155474;511;0;0;0;0;.00nan;0;0
6934;62287;517;0;0;0;0;.00nan;0;0
6934;86099;517;64;20;2;18;.900;3600000;0
6934;91414;1876;0;0;0;0;.00nan;0;0
6934;141496;1876;90;47;3;44;.936;3561000;0
6935;7332;512;60;24;2;22;.917;3600000;0
6935;37077;513;48;35;5;30;.857;3600000;0
6935;86579;513;0;0;0;0;.00nan;0;0
6935;152201;512;0;0;0;0;.00nan;0;0
6936;43896;516;92;26;1;25;.962;3600000;0
6936;86228;515;0;0;0;0;.00nan;0;0
6936;143191;516;0;0;0;0;.00nan;0;0
6936;143330;515;67;30;3;27;.900;3588000;0
6937;6944;520;88;43;2;41;.953;3900000;0
6937;57390;1472;74;24;2;22;.917;3900000;0
6937;80859;1472;0;0;0;0;.00nan;0;0
6937;143256;520;0;0;0;0;.00nan;0;0
6938;44141;519;0;0;0;0;.00nan;0;0
6938;86228;515;0;0;0;0;.00nan;0;0
6938;86360;519;72;44;3;41;.932;3600000;0
6938;143330;515;92;36;2;34;.944;3600000;0
6939;14047;511;71;23;1;22;.957;3600000;0
6939;91414;1876;0;0;0;0;.00nan;0;0
6939;141496;1876;82;36;2;34;.944;3561000;0
6939;155474;511;0;0;0;0;.00nan;0;0
6940;43896;516;46;21;3;18;.857;3564000;0
6940;142929;1872;0;0;0;0;.00nan;0;0
6940;143191;516;0;0;0;0;.00nan;0;0
6940;152478;1872;90;32;1;31;.969;3600000;0
6941;174581;518;0;0;0;0;.00nan;0;0
6941;37077;513;68;24;2;22;.917;3704000;0
6941;86579;513;0;0;0;0;.00nan;0;0
6941;143523;518;70;29;3;26;.897;3704000;0
6942;8035;524;53;32;4;28;.875;2536000;0
6942;62287;517;0;0;0;0;.00nan;0;0
6942;86099;517;76;20;1;19;.950;3600000;0
6942;152464;524;19;14;5;9;.643;1064000;0
6943;6947;514;0;0;0;0;.00nan;0;0
6943;7332;512;0;0;0;0;.00nan;0;0
6943;59614;514;73;29;3;26;.897;3538000;0
6943;152201;512;94;37;1;36;.973;3600000;0
6945;14047;517;61;20;2;18;.900;2747000;0
6945;86099;517;20;9;4;5;.556;853000;0
6945;89998;515;0;0;0;0;.00nan;0;0
6945;143330;515;77;21;1;20;.952;3600000;0
6949;6948;519;0;0;0;0;.00nan;0;0
6949;174581;518;0;0;0;0;.00nan;0;0
6949;143083;519;78;23;1;22;.957;3600000;0
6949;143523;518;80;29;2;27;.931;3544000;0
6953;6947;1472;73;21;1;20;.952;3600000;0
6953;7487;1472;0;0;0;0;.00nan;0;0
6953;142929;1872;0;0;0;0;.00nan;0;0
6953;152478;1872;43;33;6;27;.818;3600000;0
6955;6944;520;0;0;0;0;.00nan;0;0
6955;67764;516;0;0;0;0;.00nan;0;0
6955;143191;516;73;26;2;24;.923;3600000;0
6955;143256;520;77;51;5;46;.902;3600000;0
6957;8035;524;0;0;0;0;.00nan;0;0
6957;143307;1876;0;0;0;0;.00nan;0;0
6957;152464;524;61;25;2;23;.920;3900000;0
6957;155529;1876;100;43;2;41;.953;3900000;0
6959;6948;519;0;0;0;0;.00nan;0;0
6959;143083;519;79;23;1;22;.957;3600000;0
6959;143307;1876;0;0;0;0;.00nan;0;0
6959;155529;1876;70;24;2;22;.917;3552000;0
6961;6944;520;89;18;0;18;1.000;3600000;0
6961;14047;517;32;28;6;22;.786;3600000;0
6961;86099;517;0;0;0;0;.00nan;0;0
6961;143256;520;0;0;0;0;.00nan;0;0
6963;6947;1472;58;31;3;28;.903;3600000;0
6963;7487;1472;0;0;0;0;.00nan;0;0
6963;16587;513;0;0;0;0;.00nan;0;0
6963;152494;513;100;27;0;27;1.000;3600000;0
6967;8035;524;0;0;0;0;.00nan;0;0
6967;89998;515;0;0;0;0;.00nan;0;0
6967;143330;515;91;31;1;30;.968;3600000;0
6967;152464;524;96;43;2;41;.953;3600000;0
6969;174581;518;0;0;0;0;.00nan;0;0
6969;67764;516;0;0;0;0;.00nan;0;0
6969;143191;516;81;29;1;28;.966;3600000;0
6969;143523;518;78;33;2;31;.939;3558000;0
6973;16587;513;0;0;0;0;.00nan;0;0
6973;89998;515;46;29;5;24;.828;3543000;0
6973;143330;515;0;0;0;0;.00nan;0;0
6973;152494;513;81;47;4;43;.915;3600000;0
6975;6944;520;87;33;3;30;.909;3600000;0
6975;6947;1472;0;0;0;0;.00nan;0;0
6975;7487;1472;76;25;2;23;.920;3600000;0
6975;143256;520;0;0;0;0;.00nan;0;0
6979;67764;516;63;31;4;27;.871;3600000;0
6979;143191;516;0;0;0;0;.00nan;0;0
6979;143307;1876;45;36;5;31;.861;3564000;0
6979;155529;1876;0;0;0;0;.00nan;0;0
6981;6948;519;69;31;3;28;.903;3600000;0
6981;174581;518;42;35;6;29;.829;3600000;0
6981;143083;519;0;0;0;0;.00nan;0;0
6981;143523;518;0;0;0;0;.00nan;0;0
6985;8035;524;76;45;4;41;.911;3600000;0
6985;14047;517;0;0;0;0;.00nan;0;0
6985;86099;517;80;26;1;25;.962;3600000;0
6985;152464;524;0;0;0;0;.00nan;0;0
6987;6944;520;0;0;0;0;.00nan;0;0
6987;16587;513;74;27;3;24;.889;3808000;0
6987;143256;520;65;32;4;28;.875;3808000;0
6987;152494;513;0;0;0;0;.00nan;0;0
6989;14047;517;0;0;0;0;.00nan;0;0
6989;86099;517;57;11;1;10;.909;3600000;0
6989;143307;1876;0;0;0;0;.00nan;0;0
6989;155529;1876;70;34;3;31;.912;3517000;0
6991;67764;516;0;0;0;0;.00nan;0;0
6991;142929;1872;0;0;0;0;.00nan;0;0
6991;143191;516;69;27;2;25;.926;3600000;0
6991;152478;1872;70;30;3;27;.900;3600000;0
6993;6947;1472;59;32;4;28;.875;3566000;0
6993;7487;1472;0;0;0;0;.00nan;0;0
6993;174581;518;0;0;0;0;.00nan;0;0
6993;143523;518;89;41;2;39;.951;3600000;0
6995;1072;511;0;0;0;0;.00nan;0;0
6995;6948;519;88;45;2;43;.956;3600000;0
6995;143083;519;0;0;0;0;.00nan;0;0
6995;155474;511;77;25;1;24;.960;3600000;0
6997;7332;512;91;43;3;40;.930;3600000;0
6997;89998;515;0;0;0;0;.00nan;0;0
6997;143330;515;42;24;4;20;.833;3560000;0
6997;152201;512;0;0;0;0;.00nan;0;0
6999;8035;524;0;0;0;0;.00nan;0;0
6999;80859;514;63;19;2;17;.895;3600000;0
6999;152464;524;75;34;3;31;.912;3596000;0
6999;159851;514;0;0;0;0;.00nan;0;0
7001;14047;517;98;33;2;31;.939;3600000;0
7001;86099;517;0;0;0;0;.00nan;0;0
7001;142929;1872;23;23;6;17;.739;2661000;0
7001;152478;1872;47;11;2;9;.818;939000;0
7003;6947;1472;0;0;0;0;.00nan;0;0
7003;7487;1472;55;33;4;29;.879;3600000;0
7003;174581;518;84;30;1;29;.967;3600000;0
7003;143523;518;0;0;0;0;.00nan;0;0
7011;6948;519;0;0;0;0;.00nan;0;0
7011;16587;513;0;0;0;0;.00nan;0;0
7011;143083;519;74;40;3;37;.925;3544000;0
7011;152494;513;72;29;2;27;.931;3600000;0
7013;6944;520;41;16;3;13;.813;3566000;0
7013;143256;520;0;0;0;0;.00nan;0;0
7013;143307;1876;87;27;1;26;.963;3600000;0
7013;155529;1876;0;0;0;0;.00nan;0;0
7017;6948;519;58;29;3;26;.897;3691000;0
7017;8035;524;60;33;4;29;.879;3691000;0
7017;143083;519;0;0;0;0;.00nan;0;0
7017;152464;524;0;0;0;0;.00nan;0;0
7019;6947;1472;98;28;0;28;1.000;3600000;0
7019;7487;1472;0;0;0;0;.00nan;0;0
7019;174581;518;0;0;0;0;.00nan;0;0
7019;143523;518;79;37;2;35;.946;3532000;0
7023;14047;517;31;24;5;19;.792;3574000;0
7023;86099;517;0;0;0;0;.00nan;0;0
7023;142929;1872;0;0;0;0;.00nan;0;0
7023;152478;1872;41;20;4;16;.800;3600000;0
7025;16587;513;0;0;0;0;.00nan;0;0
7025;143307;1876;0;0;0;0;.00nan;0;0
7025;152494;513;84;26;1;25;.962;3900000;0
7025;155529;1876;100;35;1;34;.971;3900000;0
7031;6948;519;0;0;0;0;.00nan;0;0
7031;16587;513;68;18;1;17;.944;3600000;0
7031;143083;519;83;48;4;44;.917;3600000;0
7031;152494;513;0;0;0;0;.00nan;0;0
7035;6944;520;0;0;0;0;.00nan;0;0
7035;67764;516;0;0;0;0;.00nan;0;0
7035;143191;516;83;27;1;26;.963;3600000;0
7035;143256;520;78;31;2;29;.935;3567000;0
7039;8035;524;0;0;0;0;.00nan;0;0
7039;142929;1872;59;34;4;30;.882;3900000;0
7039;152464;524;54;40;4;36;.900;3900000;0
7039;152478;1872;0;0;0;0;.00nan;0;0
7041;14047;517;0;0;0;0;.00nan;0;0
7041;86099;517;46;19;4;15;.789;3600000;0
7041;143307;1876;74;32;3;29;.906;3600000;0
7041;155529;1876;0;0;0;0;.00nan;0;0
650;7332;512;0;0;0;0;.00nan;0;0
650;8035;524;0;0;0;0;.00nan;0;0
650;152201;512;49;28;4;24;.857;3591000;0
650;152464;524;91;55;3;52;.945;3600000;0
651;57390;1472;0;0;0;0;.00nan;0;0
651;62287;517;0;0;0;0;.00nan;0;0
651;80859;1472;74;23;1;22;.957;3600000;0
651;86099;517;58;24;2;22;.917;3571000;0
652;37077;513;87;29;1;28;.966;3600000;0
652;86579;513;0;0;0;0;.00nan;0;0
652;142929;1872;0;0;0;0;.00nan;0;0
652;152478;1872;74;28;2;26;.929;3547000;0
653;6944;520;0;0;0;0;.00nan;0;0
653;44141;519;0;0;0;0;.00nan;0;0
653;86360;519;71;29;3;26;.897;3600000;0
653;143256;520;74;27;2;25;.926;3600000;0
654;7332;512;0;0;0;0;.00nan;0;0
654;8035;524;0;0;0;0;.00nan;0;0
654;152201;512;72;19;1;18;.947;3600000;0
654;152464;524;94;43;2;41;.953;3556000;0
655;57390;1472;95;22;0;22;1.000;3600000;0
655;62287;517;0;0;0;0;.00nan;0;0
655;80859;1472;0;0;0;0;.00nan;0;0
655;86099;517;80;37;2;35;.946;3538000;0
656;37077;513;85;30;1;29;.967;3600000;0
656;86579;513;0;0;0;0;.00nan;0;0
656;142929;1872;0;0;0;0;.00nan;0;0
656;152478;1872;65;30;2;28;.933;3596000;0
657;6944;520;0;0;0;0;.00nan;0;0
657;44141;519;0;0;0;0;.00nan;0;0
657;86360;519;57;24;3;21;.875;3562000;0
657;143256;520;73;20;1;19;.950;3600000;0
658;7332;512;0;0;0;0;.00nan;0;0
658;8035;524;0;0;0;0;.00nan;0;0
658;152201;512;32;16;4;12;.750;3569000;0
658;152464;524;100;55;2;53;.964;3600000;0
659;57390;1472;71;31;3;28;.903;3515000;0
659;62287;517;0;0;0;0;.00nan;0;0
659;80859;1472;0;0;0;0;.00nan;0;0
659;86099;517;87;26;1;25;.962;3600000;0
660;37077;513;72;18;1;17;.944;3570000;0
660;86579;513;0;0;0;0;.00nan;0;0
660;142929;1872;0;0;0;0;.00nan;0;0
660;152478;1872;100;30;0;30;1.000;3600000;0
661;6944;520;0;0;0;0;.00nan;0;0
661;44141;519;0;0;0;0;.00nan;0;0
661;86360;519;84;42;3;39;.929;3556000;0
661;143256;520;64;21;2;19;.905;3600000;0
774;7332;512;0;0;0;0;.00nan;0;0
774;8035;524;0;0;0;0;.00nan;0;0
774;152201;512;67;29;3;26;.897;3600000;0
774;152464;524;33;34;6;28;.824;3600000;0
775;57390;1472;94;28;2;26;.929;3956000;0
775;62287;517;0;0;0;0;.00nan;0;0
775;80859;1472;0;0;0;0;.00nan;0;0
775;86099;517;99;45;1;44;.978;3956000;0
776;37077;513;84;33;2;31;.939;3600000;0
776;86579;513;0;0;0;0;.00nan;0;0
776;142929;1872;0;0;0;0;.00nan;0;0
776;152478;1872;65;32;3;29;.906;3549000;0
900;7332;512;0;0;0;0;.00nan;0;0
900;8035;524;0;0;0;0;.00nan;0;0
900;152201;512;92;20;0;20;1.000;3600000;0
900;152464;524;67;34;4;30;.882;3600000;0
901;57390;1472;67;40;4;36;.900;3600000;0
901;62287;517;0;0;0;0;.00nan;0;0
901;80859;1472;0;0;0;0;.00nan;0;0
901;86099;517;63;32;3;29;.906;3600000;0
993;37077;513;49;42;6;36;.857;3069000;0
993;86228;515;0;0;0;0;.00nan;0;0
993;86579;513;56;6;0;6;1.000;531000;0
993;143330;515;63;28;3;25;.893;3600000;0
994;6947;514;0;0;0;0;.00nan;0;0
994;59614;514;98;38;1;37;.974;3543000;0
994;62287;517;0;0;0;0;.00nan;0;0
994;86099;517;100;37;0;37;1.000;3600000;0
995;7332;512;0;0;0;0;.00nan;0;0
995;43896;516;87;42;3;39;.929;3561000;0
995;143191;516;0;0;0;0;.00nan;0;0
995;152201;512;64;20;1;19;.950;3600000;0
996;6944;520;0;0;0;0;.00nan;0;0
996;14047;511;61;20;2;18;.900;3600000;0
996;143256;520;49;42;6;36;.857;3600000;0
996;155474;511;0;0;0;0;.00nan;0;0
997;37077;513;47;31;4;27;.871;3579000;0
997;86228;515;0;0;0;0;.00nan;0;0
997;86579;513;0;0;0;0;.00nan;0;0
997;143330;515;81;36;3;33;.917;3600000;0
998;6947;514;0;0;0;0;.00nan;0;0
998;59614;514;82;27;1;26;.963;3600000;0
998;62287;517;49;1;0;1;1.000;241000;0
998;86099;517;52;41;6;35;.854;3359000;0
999;7332;512;0;0;0;0;.00nan;0;0
999;43896;516;71;29;2;27;.931;3552000;0
999;143191;516;0;0;0;0;.00nan;0;0
999;152201;512;81;25;1;24;.960;3600000;0
1000;6944;520;0;0;0;0;.00nan;0;0
1000;14047;511;84;29;2;27;.931;3600000;0
1000;143256;520;67;38;4;34;.895;3569000;0
1000;155474;511;0;0;0;0;.00nan;0;0
1001;37077;513;89;37;2;35;.946;3600000;0
1001;86228;515;0;0;0;0;.00nan;0;0
1001;86579;513;0;0;0;0;.00nan;0;0
1001;143330;515;72;34;4;30;.882;3600000;0
1002;6947;514;0;0;0;0;.00nan;0;0
1002;59614;514;90;30;2;28;.933;3600000;0
1002;62287;517;0;0;0;0;.00nan;0;0
1002;86099;517;68;28;3;25;.893;3556000;0
1003;7332;512;0;0;0;0;.00nan;0;0
1003;43896;516;33;21;5;16;.762;2177000;0
1003;143191;516;82;15;0;15;1.000;1376000;0
1003;152201;512;51;36;4;32;.889;3600000;0
1004;6944;520;0;0;0;0;.00nan;0;0
1004;14047;511;75;42;4;38;.905;3600000;0
1004;143256;520;52;39;5;34;.872;3566000;0
1004;155474;511;0;0;0;0;.00nan;0;0
1005;37077;513;90;40;2;38;.950;3576000;0
1005;86228;515;0;0;0;0;.00nan;0;0
1005;86579;513;0;0;0;0;.00nan;0;0
1005;143330;515;85;29;1;28;.966;3600000;0
1006;6947;514;0;0;0;0;.00nan;0;0
1006;59614;514;81;13;0;13;1.000;3600000;0
1006;62287;517;0;0;0;0;.00nan;0;0
1006;86099;517;54;22;3;19;.864;3600000;0
1007;7332;512;0;0;0;0;.00nan;0;0
1007;43896;516;92;30;1;29;.967;3600000;0
1007;143191;516;0;0;0;0;.00nan;0;0
1007;152201;512;81;25;2;23;.920;3600000;0
1008;6944;520;0;0;0;0;.00nan;0;0
1008;14047;511;83;37;3;34;.919;3984000;0
1008;143256;520;84;36;2;34;.944;3984000;0
1008;155474;511;0;0;0;0;.00nan;0;0
1267;37077;513;93;47;2;45;.957;3600000;0
1267;86228;515;0;0;0;0;.00nan;0;0
1267;86579;513;0;0;0;0;.00nan;0;0
1267;143330;515;34;32;6;26;.813;3600000;0
1268;6947;514;0;0;0;0;.00nan;0;0
1268;59614;514;100;29;0;29;1.000;3600000;0
1268;62287;517;0;0;0;0;.00nan;0;0
1268;86099;517;65;31;3;28;.903;3600000;0
1269;7332;512;0;0;0;0;.00nan;0;0
1269;43896;516;53;33;5;28;.848;3547000;0
1269;143191;516;0;0;0;0;.00nan;0;0
1269;152201;512;49;23;3;20;.870;3600000;0
1270;6944;520;0;0;0;0;.00nan;0;0
1270;14047;511;73;19;1;18;.947;3600000;0
1270;143256;520;78;32;2;30;.938;3563000;0
1270;155474;511;0;0;0;0;.00nan;0;0
1353;37077;513;100;29;0;29;1.000;3600000;0
1353;86228;515;0;0;0;0;.00nan;0;0
1353;86579;513;0;0;0;0;.00nan;0;0
1353;143330;515;69;21;1;20;.952;3554000;0
1447;37077;513;85;45;3;42;.933;4454000;0
1447;86228;515;0;0;0;0;.00nan;0;0
1447;86579;513;0;0;0;0;.00nan;0;0
1447;143330;515;89;42;2;40;.952;4454000;0
1482;7332;512;0;0;0;0;.00nan;0;0
1482;86228;515;0;0;0;0;.00nan;0;0
1482;143330;515;93;30;1;29;.967;3600000;0
1482;152201;512;85;30;2;28;.933;3568000;0
1483;6947;514;0;0;0;0;.00nan;0;0
1483;14047;511;66;34;3;31;.912;3600000;0
1483;59614;514;100;32;0;32;1.000;3600000;0
1483;155474;511;0;0;0;0;.00nan;0;0
1484;7332;512;0;0;0;0;.00nan;0;0
1484;86228;515;0;0;0;0;.00nan;0;0
1484;143330;515;69;51;6;45;.882;3600000;0
1484;152201;512;62;21;2;19;.905;3600000;0
1485;6947;514;0;0;0;0;.00nan;0;0
1485;14047;511;45;25;4;21;.840;3600000;0
1485;59614;514;43;32;5;27;.844;3547000;0
1485;155474;511;0;0;0;0;.00nan;0;0
1486;7332;512;0;0;0;0;.00nan;0;0
1486;86228;515;0;0;0;0;.00nan;0;0
1486;143330;515;79;49;5;44;.898;3526000;0
1486;152201;512;69;30;3;27;.900;3600000;0
1487;6947;514;0;0;0;0;.00nan;0;0
1487;14047;511;98;35;1;34;.971;4074000;0
1487;59614;514;92;45;2;43;.956;4074000;0
1487;155474;511;0;0;0;0;.00nan;0;0
1488;7332;512;0;0;0;0;.00nan;0;0
1488;86228;515;0;0;0;0;.00nan;0;0
1488;143330;515;75;42;4;38;.905;3890000;0
1488;152201;512;57;23;3;20;.870;3890000;0
1489;6947;514;0;0;0;0;.00nan;0;0
1489;14047;511;73;29;2;27;.931;3600000;0
1489;59614;514;40;27;5;22;.815;3600000;0
1489;155474;511;0;0;0;0;.00nan;0;0
1663;7332;512;0;0;0;0;.00nan;0;0
1663;86228;515;0;0;0;0;.00nan;0;0
1663;143330;515;67;36;4;32;.889;3952000;0
1663;152201;512;35;14;3;11;.786;3984000;0
1664;6947;514;0;0;0;0;.00nan;0;0
1664;14047;511;50;25;3;22;.880;3600000;0
1664;59614;514;79;37;4;33;.892;3550000;0
1664;155474;511;0;0;0;0;.00nan;0;0
1705;7332;512;0;0;0;0;.00nan;0;0
1705;14047;511;76;49;4;45;.918;5315000;0
1705;152201;512;70;42;3;39;.929;5315000;0
1705;155474;511;0;0;0;0;.00nan;0;0
1706;7332;512;0;0;0;0;.00nan;0;0
1706;14047;511;91;42;4;38;.905;4424000;0
1706;152201;512;71;34;3;31;.912;4424000;0
1706;155474;511;0;0;0;0;.00nan;0;0
1707;7332;512;0;0;0;0;.00nan;0;0
1707;14047;511;76;41;5;36;.878;3579000;0
1707;152201;512;61;27;3;24;.889;3600000;0
1707;155474;511;0;0;0;0;.00nan;0;0
1708;7332;512;0;0;0;0;.00nan;0;0
1708;14047;511;63;31;4;27;.871;3561000;0
1708;152201;512;81;40;3;37;.925;3600000;0
1708;155474;511;0;0;0;0;.00nan;0;0
7042;24593;642;78;21;1;20;.952;3600000;0
7042;174334;1813;84;41;2;39;.951;3544000;0
7042;-1;642;0;0;0;0;.00nan;0;0
7042;-1;1813;0;0;0;0;.00nan;0;0
7043;162945;631;0;0;0;0;.00nan;0;0
7043;73274;647;71;38;4;34;.895;3600000;0
7043;80222;647;0;0;0;0;.00nan;0;0
7043;144705;631;22;15;5;10;.667;3582000;0
7044;177631;637;0;0;0;0;.00nan;0;0
7044;17625;651;0;0;0;0;.00nan;0;0
7044;170144;637;63;26;2;24;.923;3600000;0
7044;149584;651;66;34;3;31;.912;3560000;0
7045;-1;628;0;0;0;0;.00nan;0;0
7045;-1;639;0;0;0;0;.00nan;0;0
7045;149969;639;88;14;0;14;1.000;3600000;0
7045;161336;628;72;27;2;25;.926;3544000;0
7046;165867;627;0;0;0;0;.00nan;0;0
7046;43064;627;61;27;3;24;.889;3600000;0
7046;62279;1814;0;0;0;0;.00nan;0;0
7046;85787;1814;54;29;4;25;.862;3572000;0
7047;11068;641;0;0;0;0;.00nan;0;0
7047;195761;632;73;28;2;26;.929;3545000;0
7047;151728;632;0;0;0;0;.00nan;0;0
7047;160577;641;82;30;1;29;.967;3600000;0
7048;11851;625;22;22;6;16;.727;3600000;0
7048;18965;636;71;31;3;28;.903;3600000;0
7048;-1;625;0;0;0;0;.00nan;0;0
7048;87603;636;0;0;0;0;.00nan;0;0
7049;22684;632;96;33;1;32;.970;3600000;0
7049;174334;1813;49;32;5;27;.844;3600000;0
7049;-1;1813;0;0;0;0;.00nan;0;0
7049;151728;632;0;0;0;0;.00nan;0;0
7050;177631;637;0;0;0;0;.00nan;0;0
7050;170144;637;64;40;5;35;.875;3600000;0
7050;-1;639;0;0;0;0;.00nan;0;0
7050;149969;639;66;35;4;31;.886;3600000;0
7051;18965;636;84;15;0;15;1.000;3600000;0
7051;-1;628;0;0;0;0;.00nan;0;0
7051;87603;636;0;0;0;0;.00nan;0;0
7051;161336;628;68;29;3;26;.897;3600000;0
7052;162945;631;77;26;2;24;.923;3600000;0
7052;24593;642;38;30;5;25;.833;3600000;0
7052;-1;642;0;0;0;0;.00nan;0;0
7052;144705;631;0;0;0;0;.00nan;0;0
7053;11068;641;48;7;1;6;.857;443000;0
7053;168651;651;72;26;2;24;.923;3600000;0
7053;149584;651;0;0;0;0;.00nan;0;0
7053;160577;641;37;37;7;30;.811;3157000;0
7054;62279;1814;0;0;0;0;.00nan;0;0
7054;73274;647;0;0;0;0;.00nan;0;0
7054;80222;647;83;39;3;36;.923;3600000;0
7054;85787;1814;100;29;0;29;1.000;3600000;0
7055;11851;625;27;16;4;12;.750;3571000;0
7055;-1;625;0;0;0;0;.00nan;0;0
7055;43064;627;75;31;3;28;.903;3600000;0
7055;65823;627;0;0;0;0;.00nan;0;0
7056;177631;637;0;0;0;0;.00nan;0;0
7056;18965;636;85;27;2;25;.926;3600000;0
7056;170144;637;65;38;4;34;.895;3522000;0
7056;87603;636;0;0;0;0;.00nan;0;0
7057;168651;651;0;0;0;0;.00nan;0;0
7057;22684;632;59;31;4;27;.871;3900000;0
7057;149584;651;60;33;4;29;.879;3900000;0
7057;151728;632;0;0;0;0;.00nan;0;0
7058;162945;631;48;34;5;29;.853;3600000;0
7058;-1;639;0;0;0;0;.00nan;0;0
7058;144705;631;0;0;0;0;.00nan;0;0
7058;149969;639;69;29;2;27;.931;3600000;0
7059;11068;641;58;7;0;7;1.000;1270000;0
7059;73274;647;0;0;0;0;.00nan;0;0
7059;80222;647;88;27;1;26;.963;3600000;0
7059;160577;641;32;17;4;13;.765;2330000;0
7060;11851;625;88;34;2;32;.941;3900000;0
7060;-1;625;0;0;0;0;.00nan;0;0
7060;-1;628;0;0;0;0;.00nan;0;0
7060;161336;628;96;40;2;38;.950;3900000;0
7061;174334;1813;38;17;4;13;.765;3600000;0
7061;-1;1813;0;0;0;0;.00nan;0;0
7061;62279;1814;0;0;0;0;.00nan;0;0
7061;85787;1814;100;30;0;30;1.000;3600000;0
7062;24593;642;81;44;4;40;.909;3900000;0
7062;-1;642;0;0;0;0;.00nan;0;0
7062;43064;627;38;19;4;15;.789;3900000;0
7062;65823;627;0;0;0;0;.00nan;0;0
7063;162945;631;65;18;2;16;.889;3600000;0
7063;22684;632;56;35;5;30;.857;3600000;0
7063;144705;631;0;0;0;0;.00nan;0;0
7063;151728;632;0;0;0;0;.00nan;0;0
7064;-1;639;0;0;0;0;.00nan;0;0
7064;43064;627;88;28;2;26;.929;3600000;0
7064;65823;627;0;0;0;0;.00nan;0;0
7064;149969;639;64;32;3;29;.906;3541000;0
7065;18965;636;0;0;0;0;.00nan;0;0
7065;174334;1813;24;30;6;24;.800;2957000;0
7065;-1;1813;62;9;0;9;1.000;643000;0
7065;87603;636;100;38;0;38;1.000;3600000;0
7066;168651;651;0;0;0;0;.00nan;0;0
7066;73274;647;0;0;0;0;.00nan;0;0
7066;80222;647;68;51;5;46;.902;3600000;0
7066;149584;651;87;24;1;23;.958;3600000;0
7067;24593;642;83;26;1;25;.962;3600000;0
7067;-1;642;0;0;0;0;.00nan;0;0
7067;62279;1814;0;0;0;0;.00nan;0;0
7067;85787;1814;49;25;4;21;.840;3600000;0
7068;11068;641;0;0;0;0;.00nan;0;0
7068;-1;628;64;32;4;28;.875;3857000;0
7068;160577;641;83;56;5;51;.911;3857000;0
7068;161336;628;0;0;0;0;.00nan;0;0
7069;177631;637;44;26;4;22;.846;2476000;0
7069;11851;625;79;36;3;33;.917;3600000;0
7069;170144;637;26;14;4;10;.714;1124000;0
7069;-1;625;0;0;0;0;.00nan;0;0
7070;177631;637;73;31;2;29;.935;3900000;0
7070;170144;637;0;0;0;0;.00nan;0;0
7070;22684;632;100;57;2;55;.965;3900000;0
7070;151728;632;0;0;0;0;.00nan;0;0
7071;168651;651;49;14;2;12;.857;3600000;0
7071;62279;1814;0;0;0;0;.00nan;0;0
7071;85787;1814;89;47;3;44;.936;3542000;0
7071;149584;651;0;0;0;0;.00nan;0;0
7072;24593;642;64;32;3;29;.906;3600000;0
7072;-1;639;0;0;0;0;.00nan;0;0
7072;-1;642;0;0;0;0;.00nan;0;0
7072;149969;639;70;23;2;21;.913;3600000;0
7073;-1;628;37;24;5;19;.792;3676000;0
7073;73274;647;76;45;4;41;.911;3676000;0
7073;80222;647;0;0;0;0;.00nan;0;0
7073;161336;628;0;0;0;0;.00nan;0;0
7074;18965;636;0;0;0;0;.00nan;0;0
7074;43064;627;100;39;0;39;1.000;3600000;0
7074;65823;627;0;0;0;0;.00nan;0;0
7074;87603;636;46;18;3;15;.833;3600000;0
7075;162945;631;0;0;0;0;.00nan;0;0
7075;11068;641;74;15;0;15;1.000;773000;0
7075;144705;631;73;26;2;24;.923;3600000;0
7075;160577;641;24;24;6;18;.750;2827000;0
7076;11851;625;0;0;0;0;.00nan;0;0
7076;-1;625;37;22;4;18;.818;3871000;0
7076;174334;1813;69;42;5;37;.881;3871000;0
7076;-1;1813;0;0;0;0;.00nan;0;0
7077;22684;632;47;28;5;23;.821;3600000;0
7077;62279;1814;100;28;0;28;1.000;3600000;0
7077;85787;1814;0;0;0;0;.00nan;0;0
7077;151728;632;0;0;0;0;.00nan;0;0
7078;11851;625;63;21;2;19;.905;3900000;0
7078;-1;625;0;0;0;0;.00nan;0;0
7078;-1;639;0;0;0;0;.00nan;0;0
7078;149969;639;82;30;2;28;.933;3900000;0
7079;11068;641;0;0;0;0;.00nan;0;0
7079;18965;636;81;29;2;27;.931;3600000;0
7079;87603;636;0;0;0;0;.00nan;0;0
7079;160577;641;70;31;3;28;.903;3545000;0
7080;162945;631;59;28;4;24;.857;3899000;0
7080;43064;627;65;31;3;28;.903;3899000;0
7080;65823;627;0;0;0;0;.00nan;0;0
7080;144705;631;0;0;0;0;.00nan;0;0
7081;24593;642;45;15;3;12;.800;3900000;0
7081;-1;642;0;0;0;0;.00nan;0;0
7081;73274;647;0;0;0;0;.00nan;0;0
7081;80222;647;97;50;3;47;.940;3900000;0
7082;168651;651;0;0;0;0;.00nan;0;0
7082;-1;628;0;0;0;0;.00nan;0;0
7082;149584;651;76;28;1;27;.964;3600000;0
7082;161336;628;23;23;6;17;.739;3600000;0
7083;177631;637;0;0;0;0;.00nan;0;0
7083;170144;637;36;33;6;27;.818;3900000;0
7083;174334;1813;72;49;6;43;.878;3898000;0
7083;-1;1813;0;0;0;0;.00nan;0;0
7084;11851;625;29;24;6;18;.750;1866000;0
7084;22684;632;87;39;2;37;.949;3600000;0
7084;-1;625;55;19;2;17;.895;1734000;0
7084;151728;632;0;0;0;0;.00nan;0;0
7085;18965;636;52;17;2;15;.882;3600000;0
7085;73274;647;0;0;0;0;.00nan;0;0
7085;80222;647;92;47;3;44;.936;3600000;0
7085;87603;636;0;0;0;0;.00nan;0;0
7086;24593;642;91;41;2;39;.951;3600000;0
7086;-1;628;0;0;0;0;.00nan;0;0
7086;-1;642;0;0;0;0;.00nan;0;0
7086;161336;628;86;14;0;14;1.000;3600000;0
7087;177631;637;0;0;0;0;.00nan;0;0
7087;11068;641;96;37;2;35;.946;3600000;0
7087;170144;637;41;26;4;22;.846;3579000;0
7087;160577;641;0;0;0;0;.00nan;0;0
7088;162945;631;0;0;0;0;.00nan;0;0
7088;168651;651;33;16;4;12;.750;1850000;0
7088;144705;631;61;23;2;21;.913;3600000;0
7088;149584;651;64;17;1;16;.941;1750000;0
7089;-1;639;0;0;0;0;.00nan;0;0
7089;62279;1814;0;0;0;0;.00nan;0;0
7089;85787;1814;71;28;2;26;.929;3600000;0
7089;149969;639;55;29;3;26;.897;3542000;0
7090;174334;1813;62;32;4;28;.875;3900000;0
7090;-1;1813;0;0;0;0;.00nan;0;0
7090;43064;627;67;38;4;34;.895;3900000;0
7090;65823;627;0;0;0;0;.00nan;0;0
7091;168651;651;0;0;0;0;.00nan;0;0
7091;174334;1813;87;29;1;28;.966;3548000;0
7091;-1;1813;0;0;0;0;.00nan;0;0
7091;149584;651;82;15;0;15;1.000;3600000;0
7092;18965;636;68;20;1;19;.950;3600000;0
7092;-1;639;0;0;0;0;.00nan;0;0
7092;87603;636;0;0;0;0;.00nan;0;0
7092;149969;639;79;38;3;35;.921;3520000;0
7093;177631;637;0;0;0;0;.00nan;0;0
7093;170144;637;74;37;4;33;.892;3536000;0
7093;24593;642;80;35;2;33;.943;3600000;0
7093;-1;642;0;0;0;0;.00nan;0;0
7094;22684;632;100;28;0;28;1.000;3600000;0
7094;-1;628;0;0;0;0;.00nan;0;0
7094;151728;632;0;0;0;0;.00nan;0;0
7094;161336;628;69;25;2;23;.920;3525000;0
7095;162945;631;23;25;6;19;.760;3600000;0
7095;62279;1814;0;0;0;0;.00nan;0;0
7095;85787;1814;84;39;3;36;.923;3600000;0
7095;144705;631;0;0;0;0;.00nan;0;0
7096;11068;641;0;0;0;0;.00nan;0;0
7096;43064;627;86;39;3;36;.923;3600000;0
7096;152851;627;0;0;0;0;.00nan;0;0
7096;160577;641;77;31;2;29;.935;3600000;0
7097;11851;625;39;17;3;14;.824;3900000;0
7097;-1;625;0;0;0;0;.00nan;0;0
7097;73274;647;0;0;0;0;.00nan;0;0
7097;80222;647;82;45;3;42;.933;3900000;0
7098;22684;632;82;32;1;31;.969;3900000;0
7098;-1;639;0;0;0;0;.00nan;0;0
7098;149969;639;80;27;1;26;.963;3900000;0
7098;151728;632;0;0;0;0;.00nan;0;0
7099;18965;636;63;21;2;19;.905;3600000;0
7099;62279;1814;0;0;0;0;.00nan;0;0
7099;85787;1814;70;37;4;33;.892;3574000;0
7099;87603;636;0;0;0;0;.00nan;0;0
7100;174334;1813;59;29;4;25;.862;3600000;0
7100;-1;1813;0;0;0;0;.00nan;0;0
7100;73274;647;77;51;5;46;.902;3590000;0
7100;80222;647;0;0;0;0;.00nan;0;0
7101;177631;637;0;0;0;0;.00nan;0;0
7101;170144;637;50;24;3;21;.875;3569000;0
7101;43064;627;80;25;1;24;.960;3600000;0
7101;152851;627;0;0;0;0;.00nan;0;0
7102;162945;631;0;0;0;0;.00nan;0;0
7102;-1;628;19;37;8;29;.784;3600000;0
7102;144705;631;50;21;3;18;.857;3600000;0
7102;161336;628;0;0;0;0;.00nan;0;0
7103;168651;651;0;0;0;0;.00nan;0;0
7103;24593;642;30;30;6;24;.800;2117000;0
7103;-1;642;45;13;2;11;.846;1483000;0
7103;149584;651;72;23;2;21;.913;3600000;0
7104;11068;641;0;0;0;0;.00nan;0;0
7104;11851;625;87;32;2;30;.938;3900000;0
7104;-1;625;0;0;0;0;.00nan;0;0
7104;160577;641;77;31;2;29;.935;3900000;0
7105;18965;636;0;0;0;0;.00nan;0;0
7105;22684;632;87;35;2;33;.943;3558000;0
7105;87603;636;100;35;0;35;1.000;3600000;0
7105;151728;632;0;0;0;0;.00nan;0;0
7106;162945;631;57;27;3;24;.889;3600000;0
7106;11851;625;70;22;2;20;.909;3600000;0
7106;-1;625;0;0;0;0;.00nan;0;0
7106;144705;631;0;0;0;0;.00nan;0;0
7107;43064;627;97;36;1;35;.972;3900000;0
7107;73274;647;0;0;0;0;.00nan;0;0
7107;80222;647;99;43;1;42;.977;3900000;0
7107;152851;627;0;0;0;0;.00nan;0;0
7108;177631;637;0;0;0;0;.00nan;0;0
7108;170144;637;100;30;0;30;1.000;3600000;0
7108;62279;1814;0;0;0;0;.00nan;0;0
7108;85787;1814;87;34;2;32;.941;3600000;0
7109;168651;651;0;0;0;0;.00nan;0;0
7109;-1;639;0;0;0;0;.00nan;0;0
7109;149584;651;83;22;1;21;.955;3600000;0
7109;149969;639;98;45;2;43;.956;3548000;0
7110;174334;1813;27;26;6;20;.769;3600000;0
7110;-1;628;47;30;5;25;.833;3600000;0
7110;-1;1813;0;0;0;0;.00nan;0;0
7110;161336;628;0;0;0;0;.00nan;0;0
7111;11068;641;68;42;5;37;.881;3600000;0
7111;24593;642;86;15;0;15;1.000;3600000;0
7111;-1;642;0;0;0;0;.00nan;0;0
7111;160577;641;0;0;0;0;.00nan;0;0
7112;22684;632;100;26;0;26;1.000;3600000;0
7112;73274;647;0;0;0;0;.00nan;0;0
7112;80222;647;54;31;4;27;.871;3600000;0
7112;151728;632;0;0;0;0;.00nan;0;0
7113;11068;641;66;36;4;32;.889;3600000;0
7113;-1;639;26;27;6;21;.778;3525000;0
7113;149969;639;0;0;0;0;.00nan;0;0
7113;160577;641;0;0;0;0;.00nan;0;0
7114;18965;636;0;0;0;0;.00nan;0;0
7114;24593;642;86;42;3;39;.929;3566000;0
7114;-1;642;0;0;0;0;.00nan;0;0
7114;87603;636;53;16;2;14;.875;3600000;0
7115;162945;631;0;0;0;0;.00nan;0;0
7115;174334;1813;91;29;1;28;.966;3600000;0
7115;-1;1813;0;0;0;0;.00nan;0;0
7115;144705;631;75;35;4;31;.886;3600000;0
7116;177631;637;0;0;0;0;.00nan;0;0
7116;170144;637;83;31;1;30;.968;3900000;0
7116;-1;628;0;0;0;0;.00nan;0;0
7116;161336;628;89;32;1;31;.969;3900000;0
7117;168651;651;0;0;0;0;.00nan;0;0
7117;43064;627;100;36;1;35;.972;3600000;0
7117;149584;651;64;30;3;27;.900;3562000;0
7117;152851;627;0;0;0;0;.00nan;0;0
7118;11851;625;0;0;0;0;.00nan;0;0
7118;-1;625;100;27;0;27;1.000;3600000;0
7118;62279;1814;0;0;0;0;.00nan;0;0
7118;85787;1814;85;34;2;32;.941;3600000;0
7119;168651;651;0;0;0;0;.00nan;0;0
7119;18965;636;79;43;4;39;.907;3900000;0
7119;87603;636;0;0;0;0;.00nan;0;0
7119;149584;651;78;42;4;38;.905;3849000;0
7120;22684;632;76;36;3;33;.917;3600000;0
7120;43064;627;0;0;0;0;.00nan;0;0
7120;44134;632;0;0;0;0;.00nan;0;0
7120;152851;627;53;31;5;26;.839;3580000;0
7121;-1;639;0;0;0;0;.00nan;0;0
7121;73274;647;0;0;0;0;.00nan;0;0
7121;80222;647;92;54;4;50;.926;3676000;0
7121;149969;639;74;36;3;33;.917;3676000;0
7122;162945;631;77;36;3;33;.917;3801000;0
7122;177631;637;0;0;0;0;.00nan;0;0
7122;170144;637;55;34;4;30;.882;3801000;0
7122;144705;631;0;0;0;0;.00nan;0;0
7123;-1;628;59;22;2;20;.909;3600000;0
7123;62279;1814;97;45;3;42;.933;3542000;0
7123;85787;1814;0;0;0;0;.00nan;0;0
7123;161336;628;0;0;0;0;.00nan;0;0
7124;11068;641;0;0;0;0;.00nan;0;0
7124;174334;1813;81;24;1;23;.958;3600000;0
7124;-1;1813;0;0;0;0;.00nan;0;0
7124;160577;641;66;29;2;27;.931;3549000;0
7125;11851;625;68;22;1;21;.955;3600000;0
7125;24593;642;63;44;5;39;.886;3600000;0
7125;-1;642;0;0;0;0;.00nan;0;0
7125;85354;625;0;0;0;0;.00nan;0;0
7126;22684;632;77;30;2;28;.933;3600000;0
7126;24593;642;65;35;4;31;.886;3577000;0
7126;-1;642;0;0;0;0;.00nan;0;0
7126;44134;632;0;0;0;0;.00nan;0;0
7127;162945;631;0;0;0;0;.00nan;0;0
7127;18965;636;42;22;4;18;.818;3583000;0
7127;87603;636;0;0;0;0;.00nan;0;0
7127;144705;631;66;32;3;29;.906;3600000;0
7128;177631;637;0;0;0;0;.00nan;0;0
7128;170144;637;78;31;3;28;.903;3900000;0
7128;73274;647;0;0;0;0;.00nan;0;0
7128;80222;647;66;30;3;27;.900;3900000;0
7129;11851;625;80;37;3;34;.919;3572000;0
7129;168651;651;0;0;0;0;.00nan;0;0
7129;85354;625;0;0;0;0;.00nan;0;0
7129;149584;651;97;30;1;29;.967;3600000;0
7130;174334;1813;0;0;0;0;.00nan;0;0
7130;-1;639;0;0;0;0;.00nan;0;0
7130;-1;1813;79;36;3;33;.917;3600000;0
7130;149969;639;69;31;4;27;.871;3575000;0
7131;-1;628;0;0;0;0;.00nan;0;0
7131;43064;627;27;11;4;7;.636;1154000;0
7131;152851;627;48;20;3;17;.850;2446000;0
7131;161336;628;29;24;5;19;.792;3600000;0
7132;11068;641;0;0;0;0;.00nan;0;0
7132;62279;1814;78;40;3;37;.925;3600000;0
7132;85787;1814;0;0;0;0;.00nan;0;0
7132;160577;641;63;37;4;33;.892;3569000;0
7133;177631;637;0;0;0;0;.00nan;0;0
7133;170144;637;67;19;1;18;.947;3600000;0
7133;-1;639;0;0;0;0;.00nan;0;0
7133;149969;639;73;31;2;29;.935;3550000;0
7134;168651;651;55;23;3;20;.870;3518000;0
7134;22684;632;94;28;1;27;.964;3600000;0
7134;44134;632;0;0;0;0;.00nan;0;0
7134;149584;651;0;0;0;0;.00nan;0;0
7135;24593;642;78;34;2;32;.941;3600000;0
7135;-1;628;0;0;0;0;.00nan;0;0
7135;-1;642;0;0;0;0;.00nan;0;0
7135;161336;628;79;21;1;20;.952;3600000;0
7136;162945;631;61;19;3;16;.842;3900000;0
7136;11068;641;0;0;0;0;.00nan;0;0
7136;144705;631;0;0;0;0;.00nan;0;0
7136;160577;641;76;37;3;34;.919;3900000;0
7137;18965;636;26;22;5;17;.773;3757000;0
7137;73274;647;85;53;4;49;.925;3757000;0
7137;80222;647;0;0;0;0;.00nan;0;0
7137;87603;636;0;0;0;0;.00nan;0;0
7138;174334;1813;69;20;1;19;.950;3600000;0
7138;-1;1813;0;0;0;0;.00nan;0;0
7138;62279;1814;56;23;3;20;.870;3567000;0
7138;85787;1814;0;0;0;0;.00nan;0;0
7139;11851;625;63;35;4;31;.886;3900000;0
7139;43064;627;68;36;4;32;.889;3900000;0
7139;85354;625;0;0;0;0;.00nan;0;0
7139;152851;627;0;0;0;0;.00nan;0;0
7140;22684;632;72;27;2;25;.926;3600000;0
7140;-1;639;0;0;0;0;.00nan;0;0
7140;44134;632;0;0;0;0;.00nan;0;0
7140;149969;639;41;37;6;31;.838;3600000;0
7141;18965;636;68;28;2;26;.929;3900000;0
7141;24593;642;98;44;2;42;.955;3900000;0
7141;-1;642;0;0;0;0;.00nan;0;0
7141;87603;636;0;0;0;0;.00nan;0;0
7142;162945;631;0;0;0;0;.00nan;0;0
7142;11851;625;40;26;4;22;.846;3542000;0
7142;85354;625;0;0;0;0;.00nan;0;0
7142;144705;631;71;31;3;28;.903;3600000;0
7143;177631;637;0;0;0;0;.00nan;0;0
7143;170144;637;85;32;2;30;.938;3600000;0
7143;62279;1814;0;0;0;0;.00nan;0;0
7143;85787;1814;68;41;4;37;.902;3600000;0
7144;168651;651;0;0;0;0;.00nan;0;0
7144;-1;628;77;20;1;19;.950;3600000;0
7144;149584;651;63;23;3;20;.870;3586000;0
7144;161336;628;0;0;0;0;.00nan;0;0
7145;174334;1813;84;29;1;28;.966;3600000;0
7145;-1;1813;0;0;0;0;.00nan;0;0
7145;43064;627;60;28;3;25;.893;3571000;0
7145;152851;627;0;0;0;0;.00nan;0;0
7146;11068;641;91;35;1;34;.971;3600000;0
7146;73274;647;0;0;0;0;.00nan;0;0
7146;80222;647;69;35;4;31;.886;3600000;0
7146;160577;641;0;0;0;0;.00nan;0;0
7147;177631;637;0;0;0;0;.00nan;0;0
7147;170144;637;66;25;3;22;.880;3559000;0
7147;22684;632;80;27;1;26;.963;3600000;0
7147;44134;632;0;0;0;0;.00nan;0;0
7148;24593;642;65;26;3;23;.885;3600000;0
7148;-1;639;0;0;0;0;.00nan;0;0
7148;-1;642;0;0;0;0;.00nan;0;0
7148;149969;639;51;35;5;30;.857;3569000;0
7149;168651;651;100;22;0;22;1.000;3600000;0
7149;174334;1813;67;45;5;40;.889;3600000;0
7149;-1;1813;0;0;0;0;.00nan;0;0
7149;149584;651;0;0;0;0;.00nan;0;0
7150;162945;631;37;29;5;24;.828;3600000;0
7150;43064;627;96;32;1;31;.969;3600000;0
7150;144705;631;0;0;0;0;.00nan;0;0
7150;152851;627;0;0;0;0;.00nan;0;0
7151;11068;641;0;0;0;0;.00nan;0;0
7151;11851;625;91;22;0;22;1.000;3600000;0
7151;85354;625;0;0;0;0;.00nan;0;0
7151;160577;641;88;39;3;36;.923;3600000;0
7152;-1;628;0;0;0;0;.00nan;0;0
7152;73274;647;70;33;3;30;.909;3595000;0
7152;80222;647;0;0;0;0;.00nan;0;0
7152;161336;628;87;33;2;31;.939;3600000;0
7153;18965;636;43;27;4;23;.852;3600000;0
7153;62279;1814;15;31;7;24;.774;2095000;0
7153;85787;1814;61;15;2;13;.867;1505000;0
7153;87603;636;0;0;0;0;.00nan;0;0
7154;18965;636;71;20;1;19;.950;3900000;0
7154;-1;639;0;0;0;0;.00nan;0;0
7154;87603;636;0;0;0;0;.00nan;0;0
7154;149969;639;85;25;1;24;.960;3900000;0
7155;22684;632;99;30;1;29;.967;3600000;0
7155;24593;642;75;16;0;16;1.000;3084000;0
7155;-1;642;35;11;3;8;.727;460000;0
7155;44134;632;0;0;0;0;.00nan;0;0
7156;162945;631;0;0;0;0;.00nan;0;0
7156;62279;1814;89;26;1;25;.962;3600000;0
7156;85787;1814;0;0;0;0;.00nan;0;0
7156;144705;631;63;22;2;20;.909;3544000;0
7157;177631;637;0;0;0;0;.00nan;0;0
7157;170144;637;70;17;1;16;.941;3600000;0
7157;73274;647;60;7;0;7;1.000;681000;0
7157;80222;647;51;36;6;30;.833;2919000;0
7158;-1;628;0;0;0;0;.00nan;0;0
7158;43064;627;92;49;3;46;.939;3659000;0
7158;152851;627;0;0;0;0;.00nan;0;0
7158;161336;628;69;30;2;28;.933;3707000;0
7159;11068;641;26;27;6;21;.778;2720000;0
7159;168651;651;63;31;4;27;.871;3600000;0
7159;149584;651;0;0;0;0;.00nan;0;0
7159;160577;641;48;9;1;8;.889;880000;0
7160;11851;625;55;17;2;15;.882;3600000;0
7160;174334;1813;73;41;4;37;.902;3600000;0
7160;-1;1813;0;0;0;0;.00nan;0;0
7160;85354;625;0;0;0;0;.00nan;0;0
7161;11851;625;87;31;1;30;.968;3900000;0
7161;22684;632;67;21;1;20;.952;3900000;0
7161;44134;632;0;0;0;0;.00nan;0;0
7161;85354;625;0;0;0;0;.00nan;0;0
7162;-1;639;78;24;1;23;.958;3600000;0
7162;43064;627;30;24;5;19;.792;3600000;0
7162;149969;639;0;0;0;0;.00nan;0;0
7162;152851;627;0;0;0;0;.00nan;0;0
7163;162945;631;91;27;1;26;.963;3600000;0
7163;73274;647;0;0;0;0;.00nan;0;0
7163;80222;647;69;31;3;28;.903;3586000;0
7163;144705;631;0;0;0;0;.00nan;0;0
7164;177631;637;0;0;0;0;.00nan;0;0
7164;170144;637;62;20;2;18;.900;3600000;0
7164;-1;628;57;44;6;38;.864;3600000;0
7164;161336;628;0;0;0;0;.00nan;0;0
7165;168651;651;41;38;6;32;.842;3600000;0
7165;18965;636;79;36;3;33;.917;3600000;0
7165;87603;636;0;0;0;0;.00nan;0;0
7165;149584;651;0;0;0;0;.00nan;0;0
7166;24593;642;86;34;1;33;.971;3600000;0
7166;174334;1813;72;23;2;21;.913;3569000;0
7166;-1;642;0;0;0;0;.00nan;0;0
7166;-1;1813;0;0;0;0;.00nan;0;0
7167;11068;641;63;22;2;20;.909;3600000;0
7167;62279;1814;0;0;0;0;.00nan;0;0
7167;85787;1814;79;46;5;41;.891;3600000;0
7167;160577;641;0;0;0;0;.00nan;0;0
7168;162945;631;0;0;0;0;.00nan;0;0
7168;-1;639;0;0;0;0;.00nan;0;0
7168;144705;631;32;25;5;20;.800;3600000;0
7168;149969;639;93;18;0;18;1.000;3600000;0
7169;11068;641;90;38;2;36;.947;3600000;0
7169;-1;628;0;0;0;0;.00nan;0;0
7169;160577;641;0;0;0;0;.00nan;0;0
7169;161336;628;38;25;5;20;.800;3600000;0
7170;18965;636;89;29;1;28;.966;3552000;0
7170;22684;632;100;32;0;32;1.000;3600000;0
7170;44134;632;0;0;0;0;.00nan;0;0
7170;87603;636;0;0;0;0;.00nan;0;0
7171;168651;651;0;0;0;0;.00nan;0;0
7171;24593;642;64;30;3;27;.900;3900000;0
7171;-1;642;0;0;0;0;.00nan;0;0
7171;149584;651;50;24;3;21;.875;3858000;0
7172;177631;637;0;0;0;0;.00nan;0;0
7172;11851;625;64;20;2;18;.900;3600000;0
7172;170144;637;71;38;4;34;.895;3562000;0
7172;85354;625;0;0;0;0;.00nan;0;0
7173;174334;1813;67;19;1;18;.947;3600000;0
7173;-1;1813;0;0;0;0;.00nan;0;0
7173;73274;647;0;0;0;0;.00nan;0;0
7173;80222;647;85;41;3;38;.927;3533000;0
7174;165867;627;0;0;0;0;.00nan;0;0
7174;43064;627;77;25;2;23;.920;3600000;0
7174;62279;1814;0;0;0;0;.00nan;0;0
7174;85787;1814;45;33;5;28;.848;3600000;0
7175;162945;631;59;20;2;18;.900;3600000;0
7175;-1;628;0;0;0;0;.00nan;0;0
7175;144705;631;0;0;0;0;.00nan;0;0
7175;161336;628;88;42;3;39;.929;3560000;0
7176;177631;637;0;0;0;0;.00nan;0;0
7176;18965;636;74;23;1;22;.957;3600000;0
7176;170144;637;84;56;5;51;.911;3600000;0
7176;87603;636;0;0;0;0;.00nan;0;0
7177;22684;632;52;17;2;15;.882;3600000;0
7177;44134;632;0;0;0;0;.00nan;0;0
7177;73274;647;59;4;0;4;1.000;492000;0
7177;80222;647;39;28;6;22;.786;3108000;0
7178;165867;627;0;0;0;0;.00nan;0;0
7178;168651;651;0;0;0;0;.00nan;0;0
7178;43064;627;95;34;2;32;.941;3600000;0
7178;149584;651;47;24;3;21;.875;3600000;0
7179;-1;639;0;0;0;0;.00nan;0;0
7179;62279;1814;37;30;6;24;.800;3600000;0
7179;85787;1814;0;0;0;0;.00nan;0;0
7179;149969;639;97;39;2;37;.949;3600000;0
7180;11068;641;78;24;1;23;.958;3600000;0
7180;174334;1813;55;19;2;17;.895;3600000;0
7180;-1;1813;0;0;0;0;.00nan;0;0
7180;160577;641;0;0;0;0;.00nan;0;0
7181;11851;625;76;28;2;26;.929;3600000;0
7181;24593;642;73;38;4;34;.895;3524000;0
7181;-1;642;0;0;0;0;.00nan;0;0
7181;85354;625;0;0;0;0;.00nan;0;0
7182;168651;651;0;0;0;0;.00nan;0;0
7182;73274;647;88;49;4;45;.918;3600000;0
7182;80222;647;0;0;0;0;.00nan;0;0
7182;149584;651;77;22;1;21;.955;3600000;0
7183;22684;632;67;32;3;29;.906;3638000;0
7183;-1;628;0;0;0;0;.00nan;0;0
7183;44134;632;0;0;0;0;.00nan;0;0
7183;161336;628;54;14;2;12;.857;3638000;0
7184;174334;1813;32;41;7;34;.829;3600000;0
7184;-1;639;0;0;0;0;.00nan;0;0
7184;-1;1813;0;0;0;0;.00nan;0;0
7184;149969;639;100;29;0;29;1.000;3600000;0
7185;165867;627;0;0;0;0;.00nan;0;0
7185;18965;636;0;0;0;0;.00nan;0;0
7185;43064;627;90;45;3;42;.933;3900000;0
7185;87603;636;58;23;3;20;.870;3900000;0
7186;162945;631;71;19;1;18;.947;3600000;0
7186;24593;642;71;48;5;43;.896;3600000;0
7186;-1;642;0;0;0;0;.00nan;0;0
7186;144705;631;0;0;0;0;.00nan;0;0
7187;177631;637;0;0;0;0;.00nan;0;0
7187;11068;641;71;14;0;14;1.000;1243000;0
7187;170144;637;59;26;3;23;.885;3600000;0
7187;160577;641;36;38;7;31;.816;2357000;0
7188;11851;625;53;29;4;25;.862;3600000;0
7188;62279;1814;0;0;0;0;.00nan;0;0
7188;85354;625;0;0;0;0;.00nan;0;0
7188;85787;1814;99;35;1;34;.971;3600000;0
7189;24593;642;70;24;2;22;.917;3600000;0
7189;-1;642;0;0;0;0;.00nan;0;0
7189;73274;647;0;0;0;0;.00nan;0;0
7189;80222;647;62;43;6;37;.860;3600000;0
7190;162945;631;0;0;0;0;.00nan;0;0
7190;168651;651;0;0;0;0;.00nan;0;0
7190;144705;631;87;34;2;32;.941;3793000;0
7190;149584;651;80;39;3;36;.923;3793000;0
7191;22684;632;76;30;1;29;.967;3600000;0
7191;174334;1813;81;40;4;36;.900;3600000;0
7191;-1;1813;0;0;0;0;.00nan;0;0
7191;44134;632;0;0;0;0;.00nan;0;0
7192;177631;637;0;0;0;0;.00nan;0;0
7192;165867;627;0;0;0;0;.00nan;0;0
7192;170144;637;53;26;4;22;.846;3600000;0
7192;43064;627;35;33;6;27;.818;3600000;0
7193;11068;641;0;0;0;0;.00nan;0;0
7193;-1;639;0;0;0;0;.00nan;0;0
7193;149969;639;88;34;2;32;.941;3574000;0
7193;160577;641;78;23;1;22;.957;3600000;0
7194;11851;625;70;27;2;25;.926;3600000;0
7194;18965;636;19;20;5;15;.750;1877000;0
7194;85354;625;0;0;0;0;.00nan;0;0
7194;87603;636;70;13;0;13;1.000;1723000;0
7195;-1;628;0;0;0;0;.00nan;0;0
7195;62279;1814;0;0;0;0;.00nan;0;0
7195;85787;1814;71;39;5;34;.872;3600000;0
7195;161336;628;28;26;7;19;.731;3600000;0
7196;11068;641;68;33;4;29;.879;3538000;0
7196;22684;632;63;20;2;18;.900;3600000;0
7196;44134;632;0;0;0;0;.00nan;0;0
7196;160577;641;0;0;0;0;.00nan;0;0
7197;165867;627;0;0;0;0;.00nan;0;0
7197;24593;642;80;39;3;36;.923;3734000;0
7197;-1;642;0;0;0;0;.00nan;0;0
7197;43064;627;88;31;2;29;.935;3734000;0
7198;162945;631;74;19;1;18;.947;3600000;0
7198;177631;637;0;0;0;0;.00nan;0;0
7198;170144;637;55;37;4;33;.892;3600000;0
7198;144705;631;0;0;0;0;.00nan;0;0
7199;11851;625;71;19;1;18;.947;3600000;0
7199;73274;647;98;57;2;55;.965;3564000;0
7199;80222;647;0;0;0;0;.00nan;0;0
7199;85354;625;0;0;0;0;.00nan;0;0
7200;-1;628;61;35;4;31;.886;3598000;0
7200;-1;639;0;0;0;0;.00nan;0;0
7200;149969;639;93;38;2;36;.947;3600000;0
7200;161336;628;0;0;0;0;.00nan;0;0
7201;168651;651;71;20;1;19;.950;3600000;0
7201;62279;1814;0;0;0;0;.00nan;0;0
7201;85787;1814;91;48;3;45;.938;3583000;0
7201;149584;651;0;0;0;0;.00nan;0;0
7202;18965;636;73;42;3;39;.929;3807000;0
7202;174334;1813;56;35;4;31;.886;3807000;0
7202;-1;1813;0;0;0;0;.00nan;0;0
7202;87603;636;0;0;0;0;.00nan;0;0
7203;162945;631;0;0;0;0;.00nan;0;0
7203;22684;632;67;33;4;29;.879;3600000;0
7203;44134;632;0;0;0;0;.00nan;0;0
7203;144705;631;90;32;1;31;.969;3600000;0
7204;168651;651;0;0;0;0;.00nan;0;0
7204;-1;639;62;26;2;24;.923;3031000;0
7204;149584;651;58;20;2;18;.900;3600000;0
7204;149969;639;31;8;3;5;.625;569000;0
7205;11068;641;99;50;1;49;.980;3600000;0
7205;18965;636;44;16;3;13;.813;3550000;0
7205;87603;636;0;0;0;0;.00nan;0;0
7205;160577;641;0;0;0;0;.00nan;0;0
7206;24593;642;85;27;1;26;.963;3550000;0
7206;-1;642;0;0;0;0;.00nan;0;0
7206;62279;1814;0;0;0;0;.00nan;0;0
7206;85787;1814;100;37;0;37;1.000;3600000;0
7207;177631;637;0;0;0;0;.00nan;0;0
7207;170144;637;76;21;1;20;.952;3600000;0
7207;174334;1813;71;38;3;35;.921;3584000;0
7207;-1;1813;0;0;0;0;.00nan;0;0
7208;165867;627;57;8;0;8;1.000;613000;0
7208;43064;627;17;20;6;14;.700;2987000;0
7208;73274;647;0;0;0;0;.00nan;0;0
7208;80222;647;56;26;3;23;.885;3600000;0
7209;11851;625;54;35;5;30;.857;3530000;0
7209;-1;628;0;0;0;0;.00nan;0;0
7209;85354;625;0;0;0;0;.00nan;0;0
7209;161336;628;65;30;3;27;.900;3600000;0
7210;62279;1814;0;0;0;0;.00nan;0;0
7210;73274;647;54;29;4;25;.862;3600000;0
7210;80222;647;0;0;0;0;.00nan;0;0
7210;85787;1814;56;36;5;31;.861;3600000;0
7211;11851;625;80;25;1;24;.960;3600000;0
7211;-1;639;0;0;0;0;.00nan;0;0
7211;85354;625;0;0;0;0;.00nan;0;0
7211;149969;639;80;46;4;42;.913;3600000;0
7212;162945;631;91;46;2;44;.957;3890000;0
7212;18965;636;92;34;1;33;.971;3890000;0
7212;87603;636;0;0;0;0;.00nan;0;0
7212;144705;631;0;0;0;0;.00nan;0;0
7213;11068;641;78;27;1;26;.963;3600000;0
7213;24593;642;97;24;0;24;1.000;3600000;0
7213;-1;642;0;0;0;0;.00nan;0;0
7213;160577;641;0;0;0;0;.00nan;0;0
7214;177631;637;0;0;0;0;.00nan;0;0
7214;168651;651;0;0;0;0;.00nan;0;0
7214;170144;637;64;40;4;36;.900;3560000;0
7214;149584;651;68;38;3;35;.921;3600000;0
7215;174334;1813;77;31;3;28;.903;3600000;0
7215;-1;628;0;0;0;0;.00nan;0;0
7215;-1;1813;0;0;0;0;.00nan;0;0
7215;161336;628;100;30;0;30;1.000;3600000;0
7216;165867;627;0;0;0;0;.00nan;0;0
7216;22684;632;100;42;0;42;1.000;3900000;0
7216;43064;627;72;18;0;18;1.000;3900000;0
7216;44134;632;0;0;0;0;.00nan;0;0
7217;22684;632;44;16;3;13;.813;3546000;0
7217;44134;632;0;0;0;0;.00nan;0;0
7217;62279;1814;0;0;0;0;.00nan;0;0
7217;85787;1814;82;28;2;26;.929;3600000;0
7218;162945;631;0;0;0;0;.00nan;0;0
7218;174334;1813;94;23;0;23;1.000;3600000;0
7218;-1;1813;0;0;0;0;.00nan;0;0
7218;144705;631;57;38;4;34;.895;3600000;0
7219;-1;639;0;0;0;0;.00nan;0;0
7219;73274;647;89;36;2;34;.944;3553000;0
7219;80222;647;0;0;0;0;.00nan;0;0
7219;149969;639;79;26;1;25;.962;3600000;0
7220;177631;637;0;0;0;0;.00nan;0;0
7220;170144;637;55;29;4;25;.862;3565000;0
7220;24593;642;74;30;2;28;.933;3600000;0
7220;-1;642;0;0;0;0;.00nan;0;0
7221;18965;636;43;27;5;22;.815;3600000;0
7221;-1;628;0;0;0;0;.00nan;0;0
7221;87603;636;0;0;0;0;.00nan;0;0
7221;161336;628;74;27;2;25;.926;3600000;0
7222;11068;641;58;42;6;36;.857;3600000;0
7222;165867;627;0;0;0;0;.00nan;0;0
7222;43064;627;100;27;0;27;1.000;3600000;0
7222;160577;641;0;0;0;0;.00nan;0;0
7223;11851;625;0;0;0;0;.00nan;0;0
7223;168651;651;0;0;0;0;.00nan;0;0
7223;85354;625;100;31;1;30;.968;3600000;0
7223;149584;651;65;23;2;21;.913;3558000;0
7224;174334;1813;99;22;0;22;1.000;3600000;0
7224;-1;1813;0;0;0;0;.00nan;0;0
7224;73274;647;90;33;2;31;.939;3552000;0
7224;80222;647;0;0;0;0;.00nan;0;0
7225;22684;632;83;34;2;32;.941;3600000;0
7225;24593;642;10;16;6;10;.625;3059000;0
7225;-1;642;63;13;1;12;.923;541000;0
7225;44134;632;0;0;0;0;.00nan;0;0
7226;18965;636;90;29;1;28;.966;3600000;0
7226;-1;639;0;0;0;0;.00nan;0;0
7226;87603;636;0;0;0;0;.00nan;0;0
7226;149969;639;68;31;3;28;.903;3600000;0
7227;165867;627;0;0;0;0;.00nan;0;0
7227;-1;628;80;43;3;40;.930;3600000;0
7227;43064;627;50;25;4;21;.840;3582000;0
7227;161336;628;0;0;0;0;.00nan;0;0
7228;162945;631;65;42;5;37;.881;3600000;0
7228;168651;651;0;0;0;0;.00nan;0;0
7228;144705;631;0;0;0;0;.00nan;0;0
7228;149584;651;64;19;1;18;.947;3600000;0
7229;11851;625;54;13;3;10;.769;3879000;0
7229;62279;1814;0;0;0;0;.00nan;0;0
7229;85354;625;0;0;0;0;.00nan;0;0
7229;85787;1814;92;49;3;46;.939;3900000;0
7230;177631;637;0;0;0;0;.00nan;0;0
7230;11068;641;0;0;0;0;.00nan;0;0
7230;170144;637;100;28;0;28;1.000;3600000;0
7230;160577;641;73;38;3;35;.921;3600000;0
7231;11851;625;75;25;2;23;.920;3562000;0
7231;18965;636;83;27;1;26;.963;3600000;0
7231;85354;625;0;0;0;0;.00nan;0;0
7231;87603;636;0;0;0;0;.00nan;0;0
7232;168651;651;0;0;0;0;.00nan;0;0
7232;24593;642;73;34;3;31;.912;3600000;0
7232;-1;642;0;0;0;0;.00nan;0;0
7232;149584;651;49;25;4;21;.840;3581000;0
7233;162945;631;0;0;0;0;.00nan;0;0
7233;22684;632;59;28;3;25;.893;3519000;0
7233;44134;632;0;0;0;0;.00nan;0;0
7233;144705;631;76;27;1;26;.963;3600000;0
7234;177631;637;0;0;0;0;.00nan;0;0
7234;170144;637;100;29;0;29;1.000;3600000;0
7234;-1;639;0;0;0;0;.00nan;0;0
7234;149969;639;41;24;5;19;.792;3600000;0
7235;-1;628;0;0;0;0;.00nan;0;0
7235;73274;647;100;51;3;48;.941;3886000;0
7235;80222;647;0;0;0;0;.00nan;0;0
7235;161336;628;59;35;4;31;.886;3886000;0
7236;165867;627;0;0;0;0;.00nan;0;0
7236;43064;627;66;27;3;24;.889;3900000;0
7236;62279;1814;0;0;0;0;.00nan;0;0
7236;85787;1814;82;37;3;34;.919;3888000;0
7237;11068;641;36;38;6;32;.842;2933000;0
7237;174334;1813;88;35;2;33;.943;3600000;0
7237;-1;1813;0;0;0;0;.00nan;0;0
7237;160577;641;51;3;0;3;1.000;667000;0
7238;177631;637;0;0;0;0;.00nan;0;0
7238;170144;637;74;22;2;20;.909;3900000;0
7238;22684;632;90;38;2;36;.947;3900000;0
7238;44134;632;0;0;0;0;.00nan;0;0
7239;18965;636;78;24;1;23;.958;3600000;0
7239;174334;1813;70;30;2;28;.933;3600000;0
7239;-1;1813;0;0;0;0;.00nan;0;0
7239;87603;636;0;0;0;0;.00nan;0;0
7240;24593;642;86;36;2;34;.944;3572000;0
7240;-1;642;0;0;0;0;.00nan;0;0
7240;73274;647;82;19;1;18;.947;3600000;0
7240;80222;647;0;0;0;0;.00nan;0;0
7241;162945;631;47;22;4;18;.818;3537000;0
7241;-1;639;0;0;0;0;.00nan;0;0
7241;144705;631;0;0;0;0;.00nan;0;0
7241;149969;639;100;47;2;45;.957;3600000;0
7242;-1;628;0;0;0;0;.00nan;0;0
7242;62279;1814;0;0;0;0;.00nan;0;0
7242;85787;1814;70;21;1;20;.952;3600000;0
7242;161336;628;66;26;2;24;.923;3583000;0
7243;165867;627;0;0;0;0;.00nan;0;0
7243;168651;651;0;0;0;0;.00nan;0;0
7243;43064;627;98;49;2;47;.959;3558000;0
7243;149584;651;93;21;0;21;1.000;3600000;0
7244;11068;641;85;29;1;28;.966;2685000;0
7244;11851;625;52;23;3;20;.870;3600000;0
7244;85354;625;0;0;0;0;.00nan;0;0
7244;160577;641;36;17;4;13;.765;907000;0
7245;-1;639;0;0;0;0;.00nan;0;0
7245;62279;1814;0;0;0;0;.00nan;0;0
7245;85787;1814;39;31;5;26;.839;3600000;0
7245;149969;639;67;28;2;26;.929;3600000;0
7246;162945;631;0;0;0;0;.00nan;0;0
7246;165867;627;0;0;0;0;.00nan;0;0
7246;43064;627;56;44;6;38;.864;3600000;0
7246;144705;631;54;18;2;16;.889;3600000;0
7247;11851;625;89;19;0;19;1.000;3600000;0
7247;73274;647;29;27;6;21;.778;3168000;0
7247;80222;647;57;4;0;4;1.000;432000;0
7247;85354;625;0;0;0;0;.00nan;0;0
7248;177631;637;54;18;2;16;.889;3600000;0
7248;170144;637;0;0;0;0;.00nan;0;0
7248;24593;642;89;43;3;40;.930;3586000;0
7248;-1;642;0;0;0;0;.00nan;0;0
7249;22684;632;70;25;2;23;.920;3600000;0
7249;-1;628;0;0;0;0;.00nan;0;0
7249;44134;632;0;0;0;0;.00nan;0;0
7249;161336;628;72;40;3;37;.925;3600000;0
7250;168651;651;0;0;0;0;.00nan;0;0
7250;174334;1813;0;0;0;0;.00nan;0;0
7250;-1;1813;53;24;3;21;.875;3900000;0
7250;149584;651;50;22;3;19;.864;3900000;0
7251;11068;641;28;27;6;21;.778;3094000;0
7251;18965;636;71;31;3;28;.903;3600000;0
7251;87603;636;0;0;0;0;.00nan;0;0
7251;160577;641;48;6;1;5;.833;506000;0
7252;11068;641;0;0;0;0;.00nan;0;0
7252;22684;632;0;0;0;0;.00nan;0;0
7252;44134;632;42;23;4;19;.826;3600000;0
7252;160577;641;82;28;1;27;.964;3600000;0
7253;24593;642;87;31;2;29;.935;3600000;0
7253;-1;639;0;0;0;0;.00nan;0;0
7253;-1;642;0;0;0;0;.00nan;0;0
7253;149969;639;51;21;3;18;.857;3578000;0
7254;162945;631;86;24;1;23;.958;3600000;0
7254;-1;628;0;0;0;0;.00nan;0;0
7254;144705;631;0;0;0;0;.00nan;0;0
7254;161336;628;70;39;4;35;.897;3600000;0
7255;168651;651;84;40;3;37;.925;3521000;0
7255;18965;636;75;21;1;20;.952;3600000;0
7255;87603;636;0;0;0;0;.00nan;0;0
7255;149584;651;0;0;0;0;.00nan;0;0
7256;177631;637;0;0;0;0;.00nan;0;0
7256;170144;637;64;21;2;19;.905;3600000;0
7256;62279;1814;0;0;0;0;.00nan;0;0
7256;85787;1814;73;33;3;30;.909;3543000;0
7257;11851;625;59;25;3;22;.880;3515000;0
7257;174334;1813;94;31;1;30;.968;3600000;0
7257;-1;1813;0;0;0;0;.00nan;0;0
7257;85354;625;0;0;0;0;.00nan;0;0
7258;165867;627;0;0;0;0;.00nan;0;0
7258;43064;627;44;23;5;18;.783;3600000;0
7258;73274;647;57;32;4;28;.875;3600000;0
7258;80222;647;0;0;0;0;.00nan;0;0
7259;18965;636;0;0;0;0;.00nan;0;0
7259;73274;647;90;39;2;37;.949;3569000;0
7259;80222;647;0;0;0;0;.00nan;0;0
7259;87603;636;69;18;1;17;.944;3600000;0
7260;162945;631;0;0;0;0;.00nan;0;0
7260;177631;637;0;0;0;0;.00nan;0;0
7260;170144;637;83;44;4;40;.909;3600000;0
7260;144705;631;77;24;1;23;.958;3600000;0
7261;174334;1813;66;29;3;26;.897;3600000;0
7261;-1;628;42;28;5;23;.821;3518000;0
7261;-1;1813;0;0;0;0;.00nan;0;0
7261;161336;628;0;0;0;0;.00nan;0;0
7262;24593;642;72;18;1;17;.944;3600000;0
7262;-1;642;0;0;0;0;.00nan;0;0
7262;62279;1814;0;0;0;0;.00nan;0;0
7262;85787;1814;89;37;2;35;.946;3589000;0
7263;165867;627;0;0;0;0;.00nan;0;0
7263;-1;639;0;0;0;0;.00nan;0;0
7263;43064;627;69;39;4;35;.897;3900000;0
7263;149969;639;52;32;4;28;.875;3900000;0
7264;11068;641;27;12;4;8;.667;1429000;0
7264;168651;651;0;0;0;0;.00nan;0;0
7264;149584;651;76;23;1;22;.957;3600000;0
7264;160577;641;9;22;6;16;.727;2171000;0
7265;11851;625;99;31;1;30;.968;3600000;0
7265;22684;632;90;38;2;36;.947;3600000;0
7265;44134;632;0;0;0;0;.00nan;0;0
7265;85354;625;0;0;0;0;.00nan;0;0
7266;22684;632;57;18;2;16;.889;3600000;0
7266;44134;632;0;0;0;0;.00nan;0;0
7266;62279;1814;0;0;0;0;.00nan;0;0
7266;85787;1814;98;48;3;45;.938;3575000;0
7267;11068;641;51;36;5;31;.861;3600000;0
7267;-1;639;0;0;0;0;.00nan;0;0
7267;149969;639;62;27;3;24;.889;3600000;0
7267;160577;641;0;0;0;0;.00nan;0;0
7268;18965;636;36;24;6;18;.750;2349000;0
7268;-1;628;0;0;0;0;.00nan;0;0
7268;87603;636;64;11;0;11;1.000;1251000;0
7268;161336;628;95;36;1;35;.972;3600000;0
7269;24593;642;59;30;5;25;.833;3600000;0
7269;174334;1813;81;22;1;21;.955;3600000;0
7269;-1;642;0;0;0;0;.00nan;0;0
7269;-1;1813;0;0;0;0;.00nan;0;0
7270;162945;631;74;12;0;12;1.000;3600000;0
7270;73274;647;0;0;0;0;.00nan;0;0
7270;80222;647;59;42;6;36;.857;3600000;0
7270;144705;631;0;0;0;0;.00nan;0;0
7271;177631;637;0;0;0;0;.00nan;0;0
7271;168651;651;0;0;0;0;.00nan;0;0
7271;170144;637;85;45;4;41;.911;3828000;0
7271;149584;651;41;25;5;20;.800;3828000;0
7272;11851;625;85;23;1;22;.957;3600000;0
7272;165867;627;0;0;0;0;.00nan;0;0
7272;43064;627;97;45;3;42;.933;3600000;0
7272;85354;625;0;0;0;0;.00nan;0;0
7273;162945;631;41;13;3;10;.769;3600000;0
7273;24593;642;62;38;4;34;.895;3544000;0
7273;-1;642;0;0;0;0;.00nan;0;0
7273;144705;631;0;0;0;0;.00nan;0;0
7274;168651;651;0;0;0;0;.00nan;0;0
7274;62279;1814;93;27;1;26;.963;3900000;0
7274;85787;1814;0;0;0;0;.00nan;0;0
7274;149584;651;67;17;1;16;.941;3900000;0
7275;22684;632;100;34;0;34;1.000;3600000;0
7275;174334;1813;45;25;4;21;.840;3600000;0
7275;-1;1813;0;0;0;0;.00nan;0;0
7275;44134;632;0;0;0;0;.00nan;0;0
7276;165867;627;0;0;0;0;.00nan;0;0
7276;18965;636;86;17;0;17;1.000;3600000;0
7276;43064;627;74;35;3;32;.914;3600000;0
7276;87603;636;0;0;0;0;.00nan;0;0
7277;11068;641;97;32;2;30;.938;3600000;0
7277;73274;647;61;41;5;36;.878;3600000;0
7277;80222;647;0;0;0;0;.00nan;0;0
7277;160577;641;0;0;0;0;.00nan;0;0
7278;177631;637;0;0;0;0;.00nan;0;0
7278;170144;637;100;24;0;24;1.000;3600000;0
7278;-1;628;0;0;0;0;.00nan;0;0
7278;161336;628;42;27;5;22;.815;3600000;0
7279;11851;625;0;0;0;0;.00nan;0;0
7279;-1;639;0;0;0;0;.00nan;0;0
7279;85354;625;77;23;1;22;.957;3600000;0
7279;149969;639;93;54;5;49;.907;3600000;0
7280;162945;631;0;0;0;0;.00nan;0;0
7280;11068;641;0;0;0;0;.00nan;0;0
7280;144705;631;57;25;3;22;.880;3725000;0
7280;160577;641;59;35;4;31;.886;3725000;0
7281;11851;625;100;30;0;30;1.000;3600000;0
7281;24593;642;60;28;3;25;.893;3600000;0
7281;-1;642;0;0;0;0;.00nan;0;0
7281;85354;625;0;0;0;0;.00nan;0;0
7282;-1;639;0;0;0;0;.00nan;0;0
7282;73274;647;0;0;0;0;.00nan;0;0
7282;80222;647;53;44;6;38;.864;3600000;0
7282;149969;639;84;26;1;25;.962;3600000;0
7283;177631;637;50;32;4;28;.875;2929000;0
7283;18965;636;48;29;5;24;.828;3600000;0
7283;170144;637;37;14;3;11;.786;594000;0
7283;87603;636;0;0;0;0;.00nan;0;0
7284;168651;651;0;0;0;0;.00nan;0;0
7284;-1;628;34;6;2;4;.667;802000;0
7284;149584;651;67;21;2;19;.905;3600000;0
7284;161336;628;39;38;6;32;.842;2798000;0
7285;174334;1813;77;35;2;33;.943;3600000;0
7285;-1;1813;0;0;0;0;.00nan;0;0
7285;62279;1814;0;0;0;0;.00nan;0;0
7285;85787;1814;41;30;5;25;.833;3600000;0
7286;165867;627;70;34;3;31;.912;3600000;0
7286;22684;632;75;25;2;23;.920;3600000;0
7286;43064;627;0;0;0;0;.00nan;0;0
7286;44134;632;0;0;0;0;.00nan;0;0
7287;22684;632;70;26;2;24;.923;3600000;0
7287;-1;639;58;32;4;28;.875;3525000;0
7287;44134;632;0;0;0;0;.00nan;0;0
7287;149969;639;0;0;0;0;.00nan;0;0
7288;162945;631;0;0;0;0;.00nan;0;0
7288;18965;636;49;23;4;19;.826;3659000;0
7288;87603;636;0;0;0;0;.00nan;0;0
7288;144705;631;89;41;3;38;.927;3659000;0
7289;62279;1814;0;0;0;0;.00nan;0;0
7289;73274;647;69;38;4;34;.895;3540000;0
7289;80222;647;0;0;0;0;.00nan;0;0
7289;85787;1814;61;21;2;19;.905;3600000;0
7290;24593;642;70;37;3;34;.919;3600000;0
7290;-1;628;99;27;0;27;1.000;3600000;0
7290;-1;642;0;0;0;0;.00nan;0;0
7290;161336;628;0;0;0;0;.00nan;0;0
7291;177631;637;0;0;0;0;.00nan;0;0
7291;170144;637;46;27;4;23;.852;3546000;0
7291;174334;1813;96;42;2;40;.952;3600000;0
7291;-1;1813;0;0;0;0;.00nan;0;0
7292;11068;641;72;27;2;25;.926;3778000;0
7292;165867;627;0;0;0;0;.00nan;0;0
7292;43064;627;63;20;3;17;.850;3778000;0
7292;160577;641;0;0;0;0;.00nan;0;0
7293;11851;625;37;25;5;20;.800;3554000;0
7293;168651;651;0;0;0;0;.00nan;0;0
7293;85354;625;0;0;0;0;.00nan;0;0
7293;149584;651;61;31;4;27;.871;3600000;0
7294;177631;637;0;0;0;0;.00nan;0;0
7294;170144;637;63;17;2;15;.882;3600000;0
7294;73274;647;55;13;2;11;.846;674000;0
7294;80222;647;31;33;6;27;.818;2926000;0
7295;-1;628;69;24;1;23;.958;3900000;0
7295;-1;639;0;0;0;0;.00nan;0;0
7295;149969;639;79;26;1;25;.962;3900000;0
7295;161336;628;0;0;0;0;.00nan;0;0
7296;18965;636;75;29;2;27;.931;3589000;0
7296;62279;1814;0;0;0;0;.00nan;0;0
7296;85787;1814;100;24;0;24;1.000;3600000;0
7296;87603;636;0;0;0;0;.00nan;0;0
7297;168651;651;0;0;0;0;.00nan;0;0
7297;22684;632;79;35;3;32;.914;3600000;0
7297;44134;632;0;0;0;0;.00nan;0;0
7297;149584;651;100;28;0;28;1.000;3600000;0
7298;165867;627;0;0;0;0;.00nan;0;0
7298;174334;1813;77;32;2;30;.938;3600000;0
7298;-1;1813;0;0;0;0;.00nan;0;0
7298;43064;627;42;26;4;22;.846;3515000;0
7299;11068;641;0;0;0;0;.00nan;0;0
7299;24593;642;82;25;1;24;.960;3600000;0
7299;-1;642;0;0;0;0;.00nan;0;0
7299;160577;641;50;35;5;30;.857;3600000;0
7300;162945;631;61;31;3;28;.903;3600000;0
7300;11851;625;100;28;0;28;1.000;3600000;0
7300;85354;625;0;0;0;0;.00nan;0;0
7300;144705;631;0;0;0;0;.00nan;0;0
7301;18965;636;100;24;0;24;1.000;3600000;0
7301;24593;642;0;0;0;0;.00nan;0;0
7301;-1;642;82;42;4;38;.905;3600000;0
7301;87603;636;0;0;0;0;.00nan;0;0
7302;22684;632;46;18;3;15;.833;3521000;0
7302;44134;632;0;0;0;0;.00nan;0;0
7302;73274;647;100;35;1;34;.971;3600000;0
7302;80222;647;0;0;0;0;.00nan;0;0
7303;11851;625;62;24;3;21;.875;3546000;0
7303;-1;628;0;0;0;0;.00nan;0;0
7303;85354;625;0;0;0;0;.00nan;0;0
7303;161336;628;74;29;2;27;.931;3600000;0
7304;168651;651;0;0;0;0;.00nan;0;0
7304;-1;639;0;0;0;0;.00nan;0;0
7304;149584;651;88;23;1;22;.957;3600000;0
7304;149969;639;79;33;2;31;.939;3572000;0
7305;11068;641;74;33;3;30;.909;3592000;0
7305;62279;1814;0;0;0;0;.00nan;0;0
7305;85787;1814;76;27;2;25;.926;3600000;0
7305;160577;641;0;0;0;0;.00nan;0;0
7306;162945;631;0;0;0;0;.00nan;0;0
7306;174334;1813;0;0;0;0;.00nan;0;0
7306;-1;1813;66;38;3;35;.921;3900000;0
7306;144705;631;75;33;3;30;.909;3900000;0
7307;177631;637;0;0;0;0;.00nan;0;0
7307;165867;627;0;0;0;0;.00nan;0;0
7307;170144;637;79;36;4;32;.889;3551000;0
7307;43064;627;69;33;3;30;.909;3600000;0
7308;174334;1813;81;47;3;44;.936;3532000;0
7308;-1;639;0;0;0;0;.00nan;0;0
7308;-1;1813;0;0;0;0;.00nan;0;0
7308;149969;639;69;18;1;17;.944;3600000;0
7309;18965;636;39;20;4;16;.800;3809000;0
7309;22684;632;70;34;3;31;.912;3809000;0
7309;44134;632;0;0;0;0;.00nan;0;0
7309;87603;636;0;0;0;0;.00nan;0;0
7310;165867;627;0;0;0;0;.00nan;0;0
7310;24593;642;71;30;3;27;.900;3900000;0
7310;-1;642;0;0;0;0;.00nan;0;0
7310;43064;627;84;33;3;30;.909;3900000;0
7311;162945;631;71;22;2;20;.909;3543000;0
7311;62279;1814;0;0;0;0;.00nan;0;0
7311;85787;1814;94;39;1;38;.974;3600000;0
7311;144705;631;0;0;0;0;.00nan;0;0
7312;168651;651;0;0;0;0;.00nan;0;0
7312;73274;647;0;0;0;0;.00nan;0;0
7312;80222;647;51;37;4;33;.892;3600000;0
7312;149584;651;70;22;1;21;.955;3600000;0
7313;177631;637;99;41;1;40;.976;3600000;0
7313;11851;625;75;32;2;30;.938;3548000;0
7313;170144;637;0;0;0;0;.00nan;0;0
7313;85354;625;0;0;0;0;.00nan;0;0
7314;11068;641;0;0;0;0;.00nan;0;0
7314;-1;628;0;0;0;0;.00nan;0;0
7314;160577;641;95;49;3;46;.939;3900000;0
7314;161336;628;60;30;3;27;.900;3900000;0
7315;22684;632;92;21;0;21;1.000;3600000;0
7315;24593;642;69;32;3;29;.906;3600000;0
7315;-1;642;0;0;0;0;.00nan;0;0
7315;44134;632;0;0;0;0;.00nan;0;0
7316;162945;631;86;42;4;38;.905;3600000;0
7316;177631;637;0;0;0;0;.00nan;0;0
7316;170144;637;92;31;1;30;.968;3600000;0
7316;144705;631;0;0;0;0;.00nan;0;0
7317;11068;641;0;0;0;0;.00nan;0;0
7317;73274;647;0;0;0;0;.00nan;0;0
7317;80222;647;67;41;5;36;.878;3600000;0
7317;160577;641;59;25;2;23;.920;3600000;0
7318;168651;651;73;26;2;24;.923;3900000;0
7318;-1;628;0;0;0;0;.00nan;0;0
7318;149584;651;0;0;0;0;.00nan;0;0
7318;161336;628;73;31;2;29;.935;3900000;0
7319;18965;636;62;19;2;17;.895;3600000;0
7319;174334;1813;69;36;3;33;.917;3583000;0
7319;-1;1813;0;0;0;0;.00nan;0;0
7319;87603;636;0;0;0;0;.00nan;0;0
7320;165867;627;0;0;0;0;.00nan;0;0
7320;43064;627;86;30;2;28;.933;3600000;0
7320;62279;1814;0;0;0;0;.00nan;0;0
7320;85787;1814;78;49;5;44;.898;3600000;0
7321;11851;625;0;0;0;0;.00nan;0;0
7321;-1;639;0;0;0;0;.00nan;0;0
7321;85354;625;49;19;3;16;.842;3574000;0
7321;149969;639;100;43;2;41;.953;3600000;0
7322;11851;625;89;22;0;22;1.000;3600000;0
7322;24593;642;76;50;5;45;.900;3600000;0
7322;-1;642;0;0;0;0;.00nan;0;0
7322;85354;625;0;0;0;0;.00nan;0;0
7323;168651;651;0;0;0;0;.00nan;0;0
7323;22684;632;15;24;7;17;.708;3181000;0
7323;44134;632;53;4;0;4;1.000;419000;0
7323;149584;651;72;31;2;29;.935;3600000;0
7324;-1;639;0;0;0;0;.00nan;0;0
7324;73274;647;100;45;2;43;.956;3775000;0
7324;80222;647;0;0;0;0;.00nan;0;0
7324;149969;639;74;31;3;28;.903;3775000;0
7325;165867;627;0;0;0;0;.00nan;0;0
7325;18965;636;0;0;0;0;.00nan;0;0
7325;43064;627;87;32;2;30;.938;3568000;0
7325;87603;636;80;23;1;22;.957;3600000;0
7326;162945;631;0;0;0;0;.00nan;0;0
7326;-1;628;58;31;4;27;.871;2942000;0
7326;144705;631;50;21;3;18;.857;3600000;0
7326;161336;628;58;5;0;5;1.000;658000;0
7327;174334;1813;39;17;4;13;.765;3600000;0
7327;-1;1813;0;0;0;0;.00nan;0;0
7327;62279;1814;0;0;0;0;.00nan;0;0
7327;85787;1814;49;43;6;37;.860;3574000;0
7328;177631;637;0;0;0;0;.00nan;0;0
7328;11068;641;0;0;0;0;.00nan;0;0
7328;170144;637;64;21;2;19;.905;3543000;0
7328;160577;641;91;36;1;35;.972;3600000;0
7329;22684;632;67;35;4;31;.886;3579000;0
7329;174334;1813;68;24;2;22;.917;3600000;0
7329;-1;1813;0;0;0;0;.00nan;0;0
7329;44134;632;0;0;0;0;.00nan;0;0
7330;177631;637;0;0;0;0;.00nan;0;0
7330;170144;637;79;26;2;24;.923;3738000;0
7330;-1;628;0;0;0;0;.00nan;0;0
7330;161336;628;64;22;1;21;.955;3738000;0
7331;168651;651;0;0;0;0;.00nan;0;0
7331;24593;642;62;34;3;31;.912;3600000;0
7331;-1;642;0;0;0;0;.00nan;0;0
7331;149584;651;36;17;4;13;.765;3600000;0
7332;162945;631;75;30;3;27;.900;3544000;0
7332;165867;627;0;0;0;0;.00nan;0;0
7332;43064;627;97;38;2;36;.947;3600000;0
7332;144705;631;0;0;0;0;.00nan;0;0
7333;11068;641;90;28;1;27;.964;3600000;0
7333;-1;639;0;0;0;0;.00nan;0;0
7333;149969;639;83;33;2;31;.939;3546000;0
7333;160577;641;0;0;0;0;.00nan;0;0
7334;11851;625;86;14;0;14;1.000;3600000;0
7334;73274;647;71;28;2;26;.929;1579000;0
7334;80222;647;50;34;6;28;.824;2021000;0
7334;85354;625;0;0;0;0;.00nan;0;0
7335;162945;631;0;0;0;0;.00nan;0;0
7335;24593;642;65;34;4;30;.882;3600000;0
7335;-1;642;0;0;0;0;.00nan;0;0
7335;144705;631;100;28;0;28;1.000;3600000;0
7336;18965;636;63;18;2;16;.889;3600000;0
7336;62279;1814;63;43;5;38;.884;3600000;0
7336;85787;1814;0;0;0;0;.00nan;0;0
7336;87603;636;0;0;0;0;.00nan;0;0
7337;11851;625;47;19;3;16;.842;3900000;0
7337;174334;1813;82;38;3;35;.921;3900000;0
7337;-1;1813;0;0;0;0;.00nan;0;0
7337;85354;625;0;0;0;0;.00nan;0;0
7338;-1;639;0;0;0;0;.00nan;0;0
7338;62279;1814;0;0;0;0;.00nan;0;0
7338;85787;1814;60;41;5;36;.878;3600000;0
7338;149969;639;83;29;2;27;.931;3600000;0
7339;168651;651;0;0;0;0;.00nan;0;0
7339;18965;636;51;41;6;35;.854;3600000;0
7339;87603;636;0;0;0;0;.00nan;0;0
7339;149584;651;98;41;1;40;.976;3600000;0
7340;11068;641;0;0;0;0;.00nan;0;0
7340;24593;642;65;18;1;17;.944;3600000;0
7340;-1;642;0;0;0;0;.00nan;0;0
7340;160577;641;70;47;4;43;.915;3600000;0
7341;162945;631;59;24;2;22;.917;3600000;0
7341;22684;632;52;36;4;32;.889;3590000;0
7341;44134;632;0;0;0;0;.00nan;0;0
7341;144705;631;0;0;0;0;.00nan;0;0
7342;177631;637;0;0;0;0;.00nan;0;0
7342;165867;627;0;0;0;0;.00nan;0;0
7342;170144;637;65;25;3;22;.880;3578000;0
7342;43064;627;75;33;2;31;.939;3600000;0
7343;-1;628;0;0;0;0;.00nan;0;0
7343;73274;647;91;55;4;51;.927;3600000;0
7343;80222;647;0;0;0;0;.00nan;0;0
7343;161336;628;16;22;6;16;.727;3520000;0
7344;177631;637;0;0;0;0;.00nan;0;0
7344;18965;636;54;18;2;16;.889;3600000;0
7344;170144;637;74;43;4;39;.907;3600000;0
7344;87603;636;0;0;0;0;.00nan;0;0
7345;174334;1813;100;50;3;47;.940;3900000;0
7345;-1;628;0;0;0;0;.00nan;0;0
7345;-1;1813;0;0;0;0;.00nan;0;0
7345;161336;628;61;30;3;27;.900;3900000;0
7346;168651;651;0;0;0;0;.00nan;0;0
7346;73274;647;0;0;0;0;.00nan;0;0
7346;80222;647;71;42;5;37;.881;3516000;0
7346;149584;651;64;22;3;19;.864;3600000;0
7347;165867;627;0;0;0;0;.00nan;0;0
7347;-1;639;0;0;0;0;.00nan;0;0
7347;43064;627;97;33;0;33;1.000;3900000;0
7347;149969;639;100;37;0;37;1.000;3900000;0
7348;11068;641;0;0;0;0;.00nan;0;0
7348;62279;1814;0;0;0;0;.00nan;0;0
7348;85787;1814;79;20;1;19;.950;3600000;0
7348;160577;641;74;42;3;39;.929;3572000;0
7349;11851;625;57;26;3;23;.885;3600000;0
7349;22684;632;65;21;2;19;.905;3600000;0
7349;44134;632;0;0;0;0;.00nan;0;0
7349;85354;625;0;0;0;0;.00nan;0;0
7350;168651;651;0;0;0;0;.00nan;0;0
7350;62279;1814;0;0;0;0;.00nan;0;0
7350;85787;1814;69;36;4;32;.889;3540000;0
7350;149584;651;60;19;2;17;.895;3600000;0
7351;11851;625;100;24;0;24;1.000;3600000;0
7351;165867;627;0;0;0;0;.00nan;0;0
7351;43064;627;76;35;3;32;.914;3600000;0
7351;85354;625;0;0;0;0;.00nan;0;0
7352;162945;631;0;0;0;0;.00nan;0;0
7352;11068;641;84;34;2;32;.941;3682000;0
7352;144705;631;76;30;3;27;.900;3682000;0
7352;160577;641;0;0;0;0;.00nan;0;0
7353;22684;632;41;23;4;19;.826;3600000;0
7353;-1;628;0;0;0;0;.00nan;0;0
7353;44134;632;0;0;0;0;.00nan;0;0
7353;161336;628;63;28;3;25;.893;3600000;0
7354;24593;642;51;20;3;17;.850;3600000;0
7354;-1;642;0;0;0;0;.00nan;0;0
7354;73274;647;66;48;5;43;.896;3533000;0
7354;80222;647;0;0;0;0;.00nan;0;0
7355;11068;641;0;0;0;0;.00nan;0;0
7355;174334;1813;59;25;3;22;.880;3600000;0
7355;-1;1813;0;0;0;0;.00nan;0;0
7355;160577;641;96;23;0;23;1.000;3600000;0
7356;11851;625;42;30;5;25;.833;3600000;0
7356;18965;636;76;25;2;23;.920;3600000;0
7356;85354;625;0;0;0;0;.00nan;0;0
7356;87603;636;0;0;0;0;.00nan;0;0
7357;162945;631;67;29;2;27;.931;3600000;0
7357;-1;639;55;4;0;4;1.000;701000;0
7357;144705;631;0;0;0;0;.00nan;0;0
7357;149969;639;26;28;7;21;.750;2899000;0
7358;165867;627;0;0;0;0;.00nan;0;0
7358;168651;651;0;0;0;0;.00nan;0;0
7358;43064;627;72;34;4;30;.882;3600000;0
7358;149584;651;57;23;3;20;.870;3600000;0
7359;177631;637;0;0;0;0;.00nan;0;0
7359;170144;637;91;37;2;35;.946;3552000;0
7359;62279;1814;0;0;0;0;.00nan;0;0
7359;85787;1814;90;27;1;26;.963;3600000;0
7360;24593;642;63;27;3;24;.889;3600000;0
7360;174334;1813;77;41;4;37;.902;3600000;0
7360;-1;642;0;0;0;0;.00nan;0;0
7360;-1;1813;0;0;0;0;.00nan;0;0
7361;168651;651;0;0;0;0;.00nan;0;0
7361;-1;639;70;32;3;29;.906;3575000;0
7361;149584;651;88;29;1;28;.966;3600000;0
7361;149969;639;0;0;0;0;.00nan;0;0
7362;162945;631;0;0;0;0;.00nan;0;0
7362;73274;647;0;0;0;0;.00nan;0;0
7362;80222;647;87;44;4;40;.909;3600000;0
7362;144705;631;55;14;2;12;.857;3600000;0
7363;177631;637;0;0;0;0;.00nan;0;0
7363;170144;637;85;32;1;31;.969;3900000;0
7363;22684;632;98;35;1;34;.971;3900000;0
7363;44134;632;0;0;0;0;.00nan;0;0
7364;18965;636;55;22;3;19;.864;3600000;0
7364;-1;628;0;0;0;0;.00nan;0;0
7364;87603;636;0;0;0;0;.00nan;0;0
7364;161336;628;72;42;4;38;.905;3543000;0
7365;11068;641;0;0;0;0;.00nan;0;0
7365;165867;627;0;0;0;0;.00nan;0;0
7365;43064;627;95;22;0;22;1.000;3600000;0
7365;160577;641;71;33;3;30;.909;3600000;0
7366;11851;625;53;27;4;23;.852;3648000;0
7366;62279;1814;0;0;0;0;.00nan;0;0
7366;85354;625;0;0;0;0;.00nan;0;0
7366;85787;1814;64;39;5;34;.872;3648000;0
7367;24593;642;80;30;2;28;.933;3600000;0
7367;-1;628;0;0;0;0;.00nan;0;0
7367;-1;642;0;0;0;0;.00nan;0;0
7367;161336;628;61;29;3;26;.897;3572000;0
7368;162945;631;90;26;1;25;.962;3600000;0
7368;62279;1814;55;4;0;4;1.000;734000;0
7368;85787;1814;33;32;6;26;.813;2866000;0
7368;144705;631;0;0;0;0;.00nan;0;0
7369;11851;625;73;29;2;27;.931;3600000;0
7369;168651;651;0;0;0;0;.00nan;0;0
7369;85354;625;0;0;0;0;.00nan;0;0
7369;149584;651;77;33;3;30;.909;3600000;0
7370;165867;627;0;0;0;0;.00nan;0;0
7370;22684;632;87;32;2;30;.938;3527000;0
7370;43064;627;98;26;0;26;1.000;3600000;0
7370;44134;632;0;0;0;0;.00nan;0;0
7371;18965;636;64;20;2;18;.900;3600000;0
7371;24593;642;81;62;6;56;.903;3600000;0
7371;-1;642;0;0;0;0;.00nan;0;0
7371;87603;636;0;0;0;0;.00nan;0;0
7372;177631;637;0;0;0;0;.00nan;0;0
7372;170144;637;64;23;2;21;.913;3553000;0
7372;-1;639;0;0;0;0;.00nan;0;0
7372;149969;639;85;27;1;26;.963;3600000;0
7373;174334;1813;69;20;1;19;.950;3600000;0
7373;-1;1813;0;0;0;0;.00nan;0;0
7373;73274;647;98;43;2;41;.953;3551000;0
7373;80222;647;0;0;0;0;.00nan;0;0
7374;11068;641;75;35;2;33;.943;3600000;0
7374;-1;628;0;0;0;0;.00nan;0;0
7374;160577;641;0;0;0;0;.00nan;0;0
7374;161336;628;67;18;1;17;.944;3600000;0
7375;22684;632;49;21;3;18;.857;3571000;0
7375;44134;632;0;0;0;0;.00nan;0;0
7375;73274;647;0;0;0;0;.00nan;0;0
7375;80222;647;77;28;2;26;.929;3600000;0
7376;-1;628;0;0;0;0;.00nan;0;0
7376;-1;639;0;0;0;0;.00nan;0;0
7376;149969;639;92;47;2;45;.957;3854000;0
7376;161336;628;72;17;1;16;.941;3854000;0
7377;24593;642;58;28;3;25;.893;3900000;0
7377;-1;642;0;0;0;0;.00nan;0;0
7377;62279;1814;0;0;0;0;.00nan;0;0
7377;85787;1814;96;42;3;39;.929;3900000;0
7378;162945;631;0;0;0;0;.00nan;0;0
7378;168651;651;0;0;0;0;.00nan;0;0
7378;144705;631;60;32;4;28;.875;3900000;0
7378;149584;651;70;37;4;33;.892;3900000;0
7379;165867;627;0;0;0;0;.00nan;0;0
7379;174334;1813;77;33;3;30;.909;3537000;0
7379;-1;1813;0;0;0;0;.00nan;0;0
7379;43064;627;87;25;1;24;.960;3600000;0
7380;11068;641;0;0;0;0;.00nan;0;0
7380;18965;636;88;22;1;21;.955;3600000;0
7380;87603;636;0;0;0;0;.00nan;0;0
7380;160577;641;62;38;4;34;.895;3600000;0
7381;177631;637;0;0;0;0;.00nan;0;0
7381;11851;625;55;35;5;30;.857;3900000;0
7381;170144;637;57;30;5;25;.833;3900000;0
7381;85354;625;0;0;0;0;.00nan;0;0
7382;18965;636;52;23;3;20;.870;3597000;0
7382;73274;647;95;38;2;36;.947;3600000;0
7382;80222;647;0;0;0;0;.00nan;0;0
7382;87603;636;0;0;0;0;.00nan;0;0
7383;177631;637;0;0;0;0;.00nan;0;0
7383;170144;637;66;25;2;23;.920;3600000;0
7383;174334;1813;77;57;6;51;.895;3266000;0
7383;-1;1813;53;3;0;3;1.000;334000;0
7384;22684;632;77;32;2;30;.938;3900000;0
7384;-1;639;0;0;0;0;.00nan;0;0
7384;44134;632;0;0;0;0;.00nan;0;0
7384;149969;639;76;34;2;32;.941;3900000;0
7385;11068;641;0;0;0;0;.00nan;0;0
7385;22684;632;62;27;3;24;.889;3557000;0
7385;44134;632;0;0;0;0;.00nan;0;0
7385;160577;641;56;20;2;18;.900;3600000;0
7386;18965;636;98;34;1;33;.971;3600000;0
7386;-1;639;0;0;0;0;.00nan;0;0
7386;87603;636;0;0;0;0;.00nan;0;0
7386;149969;639;73;36;3;33;.917;3584000;0
7387;177631;637;0;0;0;0;.00nan;0;0
7387;170144;637;74;22;2;20;.909;3600000;0
7387;73274;647;0;0;0;0;.00nan;0;0
7387;80222;647;77;36;3;33;.917;3548000;0
7388;-1;628;36;18;4;14;.778;3600000;0
7388;62279;1814;0;0;0;0;.00nan;0;0
7388;85787;1814;82;27;1;26;.963;3600000;0
7388;161336;628;0;0;0;0;.00nan;0;0
7389;168651;651;0;0;0;0;.00nan;0;0
7389;174334;1813;79;37;2;35;.946;3548000;0
7389;-1;1813;0;0;0;0;.00nan;0;0
7389;149584;651;87;27;1;26;.963;3600000;0
7390;165867;627;0;0;0;0;.00nan;0;0
7390;24593;642;34;33;6;27;.818;2314000;0
7390;-1;642;71;16;0;16;1.000;1286000;0
7390;43064;627;86;18;0;18;1.000;3600000;0
7391;162945;631;100;36;0;36;1.000;3600000;0
7391;11851;625;55;35;5;30;.857;3600000;0
7391;85354;625;0;0;0;0;.00nan;0;0
7391;144705;631;0;0;0;0;.00nan;0;0
7392;24593;642;39;30;5;25;.833;3600000;0
7392;-1;639;0;0;0;0;.00nan;0;0
7392;-1;642;0;0;0;0;.00nan;0;0
7392;149969;639;62;22;2;20;.909;3600000;0
7393;18965;636;63;17;2;15;.882;3617000;0
7393;22684;632;94;49;3;46;.939;3617000;0
7393;44134;632;0;0;0;0;.00nan;0;0
7393;87603;636;0;0;0;0;.00nan;0;0
7394;62279;1814;0;0;0;0;.00nan;0;0
7394;73274;647;87;26;1;25;.962;3600000;0
7394;80222;647;0;0;0;0;.00nan;0;0
7394;85787;1814;68;26;2;24;.923;3574000;0
7395;177631;637;82;35;2;33;.943;3600000;0
7395;168651;651;0;0;0;0;.00nan;0;0
7395;170144;637;0;0;0;0;.00nan;0;0
7395;149584;651;32;31;6;25;.806;3600000;0
7396;165867;627;0;0;0;0;.00nan;0;0
7396;-1;628;55;3;0;3;1.000;481000;0
7396;43064;627;64;22;2;20;.909;3600000;0
7396;161336;628;54;31;5;26;.839;3119000;0
7397;162945;631;80;33;2;31;.939;3600000;0
7397;174334;1813;47;33;6;27;.818;3259000;0
7397;-1;1813;50;1;0;1;1.000;341000;0
7397;144705;631;0;0;0;0;.00nan;0;0
7398;11068;641;69;37;4;33;.892;3551000;0
7398;11851;625;47;20;3;17;.850;3600000;0
7398;85354;625;0;0;0;0;.00nan;0;0
7398;160577;641;0;0;0;0;.00nan;0;0
7399;177631;637;0;0;0;0;.00nan;0;0
7399;170144;637;63;23;2;21;.913;3684000;0
7399;24593;642;0;0;0;0;.00nan;0;0
7399;-1;642;67;18;1;17;.944;3684000;0
7400;162945;631;0;0;0;0;.00nan;0;0
7400;18965;636;74;32;2;30;.938;3582000;0
7400;87603;636;0;0;0;0;.00nan;0;0
7400;144705;631;90;26;1;25;.962;3600000;0
7401;165867;627;0;0;0;0;.00nan;0;0
7401;43064;627;62;35;4;31;.886;3516000;0
7401;73274;647;0;0;0;0;.00nan;0;0
7401;80222;647;94;39;2;37;.949;3600000;0
7402;11068;641;0;0;0;0;.00nan;0;0
7402;168651;651;71;23;1;22;.957;3600000;0
7402;149584;651;0;0;0;0;.00nan;0;0
7402;160577;641;100;37;0;37;1.000;3600000;0
7403;22684;632;26;24;5;19;.792;3600000;0
7403;44134;632;0;0;0;0;.00nan;0;0
7403;62279;1814;100;37;2;35;.946;3600000;0
7403;85787;1814;0;0;0;0;.00nan;0;0
7404;174334;1813;64;36;4;32;.889;3574000;0
7404;-1;639;0;0;0;0;.00nan;0;0
7404;-1;1813;0;0;0;0;.00nan;0;0
7404;149969;639;80;33;2;31;.939;3600000;0
7405;11851;625;68;28;3;25;.893;3568000;0
7405;-1;628;0;0;0;0;.00nan;0;0
7405;85354;625;0;0;0;0;.00nan;0;0
7405;161336;628;88;34;2;32;.941;3600000;0
7409;11068;641;0;0;0;0;.00nan;0;0
7409;195761;632;0;0;0;0;.00nan;0;0
7409;151728;632;47;21;3;18;.857;3689000;0
7409;160577;641;66;38;4;34;.895;3689000;0
7411;162945;631;54;26;4;22;.846;3600000;0
7411;62279;1814;0;0;0;0;.00nan;0;0
7411;85787;1814;73;30;2;28;.933;3600000;0
7411;144705;631;0;0;0;0;.00nan;0;0
7415;11851;625;68;15;1;14;.933;3600000;0
7415;-1;625;0;0;0;0;.00nan;0;0
7415;73274;647;74;46;5;41;.891;3600000;0
7415;80222;647;0;0;0;0;.00nan;0;0
7417;165867;627;96;47;1;46;.979;3900000;0
7417;24593;642;97;33;1;32;.970;3900000;0
7417;-1;642;0;0;0;0;.00nan;0;0
7417;43064;627;0;0;0;0;.00nan;0;0
7419;174334;1813;96;39;1;38;.974;3600000;0
7419;-1;639;0;0;0;0;.00nan;0;0
7419;-1;1813;0;0;0;0;.00nan;0;0
7419;149969;639;98;20;0;20;1.000;3600000;0
7421;11068;641;55;32;4;28;.875;3587000;0
7421;17625;651;0;0;0;0;.00nan;0;0
7421;149584;651;74;23;2;21;.913;3600000;0
7421;160577;641;0;0;0;0;.00nan;0;0
7423;165867;627;0;0;0;0;.00nan;0;0
7423;174334;1813;0;0;0;0;.00nan;0;0
7423;-1;1813;72;41;4;37;.902;3701000;0
7423;43064;627;91;41;3;38;.927;3701000;0
7427;11851;625;0;0;0;0;.00nan;0;0
7427;-1;625;74;31;2;29;.935;3600000;0
7427;-1;639;0;0;0;0;.00nan;0;0
7427;149969;639;59;28;3;25;.893;3561000;0
7429;162945;631;0;0;0;0;.00nan;0;0
7429;24593;642;0;0;0;0;.00nan;0;0
7429;-1;642;61;34;4;30;.882;3600000;0
7429;144705;631;32;21;5;16;.762;3551000;0
7437;11851;625;76;23;1;22;.957;3600000;0
7437;-1;625;0;0;0;0;.00nan;0;0
7437;-1;639;87;38;2;36;.947;3580000;0
7437;149969;639;0;0;0;0;.00nan;0;0
7441;165867;627;64;23;2;21;.913;3629000;0
7441;174334;1813;83;25;1;24;.960;3629000;0
7441;-1;1813;0;0;0;0;.00nan;0;0
7441;43064;627;0;0;0;0;.00nan;0;0
7443;11068;641;0;0;0;0;.00nan;0;0
7443;17625;651;0;0;0;0;.00nan;0;0
7443;149584;651;79;13;0;13;1.000;3600000;0
7443;160577;641;78;50;4;46;.920;3600000;0
7445;162945;631;88;32;1;31;.969;3600000;0
7445;73274;647;0;0;0;0;.00nan;0;0
7445;80222;647;65;31;3;28;.903;3574000;0
7445;144705;631;0;0;0;0;.00nan;0;0
7449;174334;1813;66;31;3;28;.903;3600000;0
7449;-1;1813;0;0;0;0;.00nan;0;0
7449;62279;1814;0;0;0;0;.00nan;0;0
7449;85787;1814;70;39;4;35;.897;3595000;0
7453;165867;627;0;0;0;0;.00nan;0;0
7453;-1;639;0;0;0;0;.00nan;0;0
7453;43064;627;63;24;3;21;.875;3600000;0
7453;149969;639;82;33;2;31;.939;3600000;0
7455;11068;641;84;43;3;40;.930;3600000;0
7455;195761;632;74;27;2;25;.926;3600000;0
7455;151728;632;0;0;0;0;.00nan;0;0
7455;160577;641;0;0;0;0;.00nan;0;0
7457;17625;651;0;0;0;0;.00nan;0;0
7457;73274;647;34;32;6;26;.813;2743000;0
7457;80222;647;49;6;1;5;.833;857000;0
7457;149584;651;58;25;3;22;.880;3600000;0
7461;162945;631;0;0;0;0;.00nan;0;0
7461;11851;625;0;0;0;0;.00nan;0;0
7461;-1;625;65;44;4;40;.909;3600000;0
7461;144705;631;97;38;1;37;.974;3600000;0
7463;11851;625;73;23;1;22;.957;3600000;0
7463;-1;625;0;0;0;0;.00nan;0;0
7463;195761;632;0;0;0;0;.00nan;0;0
7463;151728;632;58;32;3;29;.906;3584000;0
7465;177631;637;0;0;0;0;.00nan;0;0
7465;170144;637;74;21;1;20;.952;3600000;0
7465;62279;1814;0;0;0;0;.00nan;0;0
7465;85787;1814;94;35;2;33;.943;3585000;0
7467;165867;627;0;0;0;0;.00nan;0;0
7467;-1;628;0;0;0;0;.00nan;0;0
7467;43064;627;66;35;5;30;.857;3557000;0
7467;161336;628;48;25;4;21;.840;3600000;0
7469;11068;641;92;48;3;45;.938;3600000;0
7469;17625;651;0;0;0;0;.00nan;0;0
7469;149584;651;51;16;2;14;.875;3600000;0
7469;160577;641;0;0;0;0;.00nan;0;0
7471;162945;631;76;42;4;38;.905;3900000;0
7471;24593;642;72;34;4;30;.882;3900000;0
7471;-1;642;0;0;0;0;.00nan;0;0
7471;144705;631;0;0;0;0;.00nan;0;0
7473;-1;639;0;0;0;0;.00nan;0;0
7473;73274;647;0;0;0;0;.00nan;0;0
7473;80222;647;65;38;4;34;.895;3600000;0
7473;149969;639;61;21;2;19;.905;3600000;0
7475;18965;636;66;26;3;23;.885;3600000;0
7475;174334;1813;95;60;4;56;.933;3600000;0
7475;-1;1813;0;0;0;0;.00nan;0;0
7475;87603;636;0;0;0;0;.00nan;0;0
7477;17625;651;0;0;0;0;.00nan;0;0
7477;62279;1814;100;38;0;38;1.000;3600000;0
7477;85787;1814;0;0;0;0;.00nan;0;0
7477;149584;651;55;15;1;14;.933;3561000;0
7479;11851;625;0;0;0;0;.00nan;0;0
7479;-1;625;97;29;0;29;1.000;3600000;0
7479;-1;639;91;34;2;32;.941;3547000;0
7479;149969;639;0;0;0;0;.00nan;0;0
7487;165867;627;51;23;3;20;.870;3538000;0
7487;195761;632;94;29;1;28;.966;3600000;0
7487;43064;627;0;0;0;0;.00nan;0;0
7487;151728;632;0;0;0;0;.00nan;0;0
7489;162945;631;0;0;0;0;.00nan;0;0
7489;24593;642;0;0;0;0;.00nan;0;0
7489;-1;642;64;32;3;29;.906;3600000;0
7489;144705;631;91;19;0;19;1.000;3600000;0
7493;174334;1813;66;26;2;24;.923;3900000;0
7493;-1;1813;0;0;0;0;.00nan;0;0
7493;62279;1814;84;36;2;34;.944;3900000;0
7493;85787;1814;0;0;0;0;.00nan;0;0
7495;165867;627;0;0;0;0;.00nan;0;0
7495;17625;651;0;0;0;0;.00nan;0;0
7495;43064;627;70;41;4;37;.902;3600000;0
7495;149584;651;90;34;1;33;.971;3600000;0
7501;162945;631;0;0;0;0;.00nan;0;0
7501;11851;625;70;25;2;23;.920;3900000;0
7501;-1;625;0;0;0;0;.00nan;0;0
7501;144705;631;82;27;2;25;.926;3900000;0
7503;11068;641;78;38;3;35;.921;3600000;0
7503;195761;632;0;0;0;0;.00nan;0;0
7503;151728;632;69;16;1;15;.938;3600000;0
7503;160577;641;0;0;0;0;.00nan;0;0
777;-1;639;0;0;0;0;.00nan;0;0
777;62279;1814;0;0;0;0;.00nan;0;0
777;85787;1814;100;27;0;27;1.000;3600000;0
777;149969;639;69;40;4;36;.900;3600000;0
778;165867;627;0;0;0;0;.00nan;0;0
778;-1;628;0;0;0;0;.00nan;0;0
778;43064;627;100;26;0;26;1.000;3600000;0
778;161336;628;77;33;3;30;.909;3600000;0
779;-1;639;0;0;0;0;.00nan;0;0
779;62279;1814;0;0;0;0;.00nan;0;0
779;85787;1814;66;21;1;20;.952;3600000;0
779;149969;639;79;38;3;35;.921;3560000;0
780;165867;627;0;0;0;0;.00nan;0;0
780;-1;628;0;0;0;0;.00nan;0;0
780;43064;627;61;24;3;21;.875;3600000;0
780;161336;628;65;34;4;30;.882;3570000;0
947;18965;636;62;28;3;25;.893;3600000;0
947;62279;1814;0;0;0;0;.00nan;0;0
947;85787;1814;69;41;4;37;.902;3600000;0
947;87603;636;0;0;0;0;.00nan;0;0
948;162945;631;0;0;0;0;.00nan;0;0
948;177631;637;0;0;0;0;.00nan;0;0
948;170144;637;73;28;2;26;.929;3600000;0
948;144705;631;67;36;4;32;.889;3562000;0
949;11851;625;93;27;1;26;.963;3600000;0
949;22684;632;63;32;4;28;.875;3600000;0
949;44134;632;0;0;0;0;.00nan;0;0
949;85354;625;0;0;0;0;.00nan;0;0
950;165867;627;0;0;0;0;.00nan;0;0
950;168651;651;0;0;0;0;.00nan;0;0
950;43064;627;93;45;2;43;.956;3600000;0
950;149584;651;74;34;3;31;.912;3596000;0
951;18965;636;61;30;3;27;.900;3600000;0
951;62279;1814;0;0;0;0;.00nan;0;0
951;85787;1814;66;48;5;43;.896;3530000;0
951;87603;636;0;0;0;0;.00nan;0;0
952;162945;631;84;37;2;35;.946;4392000;0
952;177631;637;0;0;0;0;.00nan;0;0
952;170144;637;70;32;3;29;.906;4392000;0
952;144705;631;0;0;0;0;.00nan;0;0
953;11851;625;70;24;2;22;.917;3721000;0
953;22684;632;99;41;1;40;.976;3721000;0
953;44134;632;0;0;0;0;.00nan;0;0
953;85354;625;0;0;0;0;.00nan;0;0
954;165867;627;0;0;0;0;.00nan;0;0
954;168651;651;0;0;0;0;.00nan;0;0
954;43064;627;75;25;1;24;.960;3600000;0
954;149584;651;70;28;2;26;.929;3583000;0
955;18965;636;78;23;1;22;.957;3600000;0
955;62279;1814;0;0;0;0;.00nan;0;0
955;85787;1814;75;57;7;50;.877;3600000;0
955;87603;636;0;0;0;0;.00nan;0;0
956;162945;631;82;27;1;26;.963;3600000;0
956;177631;637;0;0;0;0;.00nan;0;0
956;170144;637;77;38;3;35;.921;3533000;0
956;144705;631;0;0;0;0;.00nan;0;0
957;11851;625;67;24;2;22;.917;3600000;0
957;22684;632;69;42;4;38;.905;3600000;0
957;44134;632;0;0;0;0;.00nan;0;0
957;85354;625;0;0;0;0;.00nan;0;0
958;165867;627;0;0;0;0;.00nan;0;0
958;168651;651;0;0;0;0;.00nan;0;0
958;43064;627;73;32;3;29;.906;3814000;0
958;149584;651;72;26;2;24;.923;3814000;0
959;18965;636;61;20;2;18;.900;3600000;0
959;62279;1814;0;0;0;0;.00nan;0;0
959;85787;1814;80;51;4;47;.922;3600000;0
959;87603;636;0;0;0;0;.00nan;0;0
960;162945;631;46;30;5;25;.833;3600000;0
960;177631;637;0;0;0;0;.00nan;0;0
960;170144;637;61;20;2;18;.900;3600000;0
960;144705;631;0;0;0;0;.00nan;0;0
961;11851;625;96;25;0;25;1.000;3600000;0
961;22684;632;58;23;3;20;.870;3600000;0
961;44134;632;0;0;0;0;.00nan;0;0
961;85354;625;0;0;0;0;.00nan;0;0
962;165867;627;0;0;0;0;.00nan;0;0
962;168651;651;0;0;0;0;.00nan;0;0
962;43064;627;84;27;1;26;.963;3600000;0
962;149584;651;58;19;2;17;.895;3547000;0
1253;162945;631;80;35;3;32;.914;3595000;0
1253;177631;637;0;0;0;0;.00nan;0;0
1253;170144;637;85;23;1;22;.957;3600000;0
1253;144705;631;0;0;0;0;.00nan;0;0
1254;11851;625;65;22;2;20;.909;3600000;0
1254;22684;632;77;46;4;42;.913;3590000;0
1254;44134;632;0;0;0;0;.00nan;0;0
1254;85354;625;0;0;0;0;.00nan;0;0
1255;165867;627;0;0;0;0;.00nan;0;0
1255;168651;651;54;9;1;8;.889;760000;0
1255;43064;627;73;37;4;33;.892;3600000;0
1255;149584;651;22;28;6;22;.786;2840000;0
1304;162945;631;62;24;2;22;.917;3543000;0
1304;177631;637;0;0;0;0;.00nan;0;0
1304;170144;637;90;31;1;30;.968;3600000;0
1304;144705;631;0;0;0;0;.00nan;0;0
1448;165867;627;0;0;0;0;.00nan;0;0
1448;18965;636;58;22;3;19;.864;3569000;0
1448;43064;627;82;33;2;31;.939;3600000;0
1448;87603;636;0;0;0;0;.00nan;0;0
1449;177631;637;0;0;0;0;.00nan;0;0
1449;11851;625;59;35;5;30;.857;3600000;0
1449;170144;637;66;23;1;22;.957;3600000;0
1449;85354;625;0;0;0;0;.00nan;0;0
1450;165867;627;0;0;0;0;.00nan;0;0
1450;18965;636;70;26;2;24;.923;3575000;0
1450;43064;627;99;38;1;37;.974;3600000;0
1450;87603;636;0;0;0;0;.00nan;0;0
1451;177631;637;0;0;0;0;.00nan;0;0
1451;11851;625;75;43;4;39;.907;3576000;0
1451;170144;637;65;23;2;21;.913;3600000;0
1451;85354;625;0;0;0;0;.00nan;0;0
1452;165867;627;0;0;0;0;.00nan;0;0
1452;18965;636;56;22;3;19;.864;3554000;0
1452;43064;627;84;36;2;34;.944;3600000;0
1452;87603;636;0;0;0;0;.00nan;0;0
1453;177631;637;0;0;0;0;.00nan;0;0
1453;11851;625;88;21;0;21;1.000;3600000;0
1453;170144;637;64;32;3;29;.906;3600000;0
1453;85354;625;0;0;0;0;.00nan;0;0
1454;165867;627;0;0;0;0;.00nan;0;0
1454;18965;636;71;24;2;22;.917;3600000;0
1454;43064;627;73;47;5;42;.894;3600000;0
1454;87603;636;0;0;0;0;.00nan;0;0
1455;177631;637;0;0;0;0;.00nan;0;0
1455;11851;625;59;26;2;24;.923;3600000;0
1455;170144;637;37;22;4;18;.818;3600000;0
1455;85354;625;0;0;0;0;.00nan;0;0
1633;165867;627;0;0;0;0;.00nan;0;0
1633;18965;636;80;22;1;21;.955;3600000;0
1633;43064;627;90;42;3;39;.929;3576000;0
1633;87603;636;0;0;0;0;.00nan;0;0
1634;177631;637;0;0;0;0;.00nan;0;0
1634;11851;625;32;27;5;22;.815;3600000;0
1634;170144;637;67;40;4;36;.900;3600000;0
1634;85354;625;0;0;0;0;.00nan;0;0
1665;165867;627;0;0;0;0;.00nan;0;0
1665;18965;636;84;26;2;24;.923;3600000;0
1665;43064;627;91;42;3;39;.929;3595000;0
1665;87603;636;0;0;0;0;.00nan;0;0
1666;177631;637;0;0;0;0;.00nan;0;0
1666;11851;625;70;26;2;24;.923;3573000;0
1666;170144;637;100;30;0;30;1.000;3600000;0
1666;85354;625;0;0;0;0;.00nan;0;0
1709;165867;627;0;0;0;0;.00nan;0;0
1709;18965;636;96;34;2;32;.941;3600000;0
1709;43064;627;76;35;3;32;.914;3566000;0
1709;87603;636;0;0;0;0;.00nan;0;0
1757;177631;637;0;0;0;0;.00nan;0;0
1757;18965;636;79;49;3;46;.939;5569000;0
1757;170144;637;99;55;2;53;.964;5569000;0
1757;87603;636;0;0;0;0;.00nan;0;0
1758;177631;637;0;0;0;0;.00nan;0;0
1758;18965;636;58;25;4;21;.840;3600000;0
1758;170144;637;62;42;5;37;.881;3533000;0
1758;87603;636;0;0;0;0;.00nan;0;0
1759;177631;637;0;0;0;0;.00nan;0;0
1759;18965;636;57;32;4;28;.875;4031000;0
1759;170144;637;69;39;3;36;.923;4031000;0
1759;87603;636;0;0;0;0;.00nan;0;0
1760;177631;637;0;0;0;0;.00nan;0;0
1760;18965;636;66;29;3;26;.897;3600000;0
1760;170144;637;35;27;5;22;.815;3534000;0
1760;87603;636;0;0;0;0;.00nan;0;0
7504;167824;828;96;37;2;35;.946;3876000;0
7504;165723;837;87;37;2;35;.946;3900000;0
7504;89190;837;0;0;0;0;.00nan;0;0
7504;148041;828;0;0;0;0;.00nan;0;0
7505;183545;842;59;41;5;36;.878;3600000;0
7505;19322;848;74;26;2;24;.923;3600000;0
7505;23433;842;0;0;0;0;.00nan;0;0
7505;47736;848;0;0;0;0;.00nan;0;0
7506;165723;837;100;24;0;24;1.000;3600000;0
7506;180287;847;89;37;3;34;.919;3600000;0
7506;54017;847;0;0;0;0;.00nan;0;0
7506;89190;837;0;0;0;0;.00nan;0;0
7507;167824;828;61;24;2;22;.917;3600000;0
7507;16588;836;0;0;0;0;.00nan;0;0
7507;182116;836;65;35;4;31;.886;3559000;0
7507;148041;828;0;0;0;0;.00nan;0;0
7508;26336;829;49;8;1;7;.875;1121000;0
7508;62975;834;0;0;0;0;.00nan;0;0
7508;89874;829;33;24;6;18;.750;2479000;0
7508;147901;834;68;28;2;26;.929;3600000;0
7509;30431;839;0;0;0;0;.00nan;0;0
7509;-1;833;0;0;0;0;.00nan;0;0
7509;53867;833;45;35;5;30;.857;3600000;0
7509;78223;839;88;33;2;31;.939;3600000;0
7510;8501;832;0;0;0;0;.00nan;0;0
7510;16838;830;0;0;0;0;.00nan;0;0
7510;46492;832;52;37;5;32;.865;3557000;0
7510;47791;830;39;19;4;15;.789;3600000;0
7511;2410;838;60;48;6;42;.875;3556000;0
7511;5663;831;0;0;0;0;.00nan;0;0
7511;57657;838;0;0;0;0;.00nan;0;0
7511;78094;831;74;39;4;35;.897;3600000;0
7512;2410;838;60;17;2;15;.882;3600000;0
7512;16588;836;0;0;0;0;.00nan;0;0
7512;182116;836;71;39;4;35;.897;3600000;0
7512;57657;838;0;0;0;0;.00nan;0;0
7513;16838;830;70;28;3;25;.893;3513000;0
7513;-1;833;0;0;0;0;.00nan;0;0
7513;47791;830;0;0;0;0;.00nan;0;0
7513;53867;833;95;32;1;31;.969;3600000;0
7514;8501;832;0;0;0;0;.00nan;0;0
7514;183545;842;0;0;0;0;.00nan;0;0
7514;23433;842;71;42;4;38;.905;3556000;0
7514;46492;832;64;27;3;24;.889;3600000;0
7515;167824;828;0;0;0;0;.00nan;0;0
7515;30431;839;65;26;3;23;.885;3600000;0
7515;78223;839;0;0;0;0;.00nan;0;0
7515;148041;828;65;42;4;38;.905;3600000;0
7516;165723;837;30;24;5;19;.792;3546000;0
7516;62975;834;47;28;4;24;.857;1956000;0
7516;89190;837;0;0;0;0;.00nan;0;0
7516;147901;834;81;16;0;16;1.000;1644000;0
7517;5663;831;72;29;3;26;.897;3600000;0
7517;26336;829;56;43;5;38;.884;3163000;0
7517;78094;831;0;0;0;0;.00nan;0;0
7517;89874;829;51;2;0;2;1.000;354000;0
7518;19322;848;68;21;1;20;.952;3600000;0
7518;180287;847;84;49;4;45;.918;3600000;0
7518;47736;848;0;0;0;0;.00nan;0;0
7518;54017;847;0;0;0;0;.00nan;0;0
7519;167824;828;72;20;1;19;.950;3600000;0
7519;183545;842;0;0;0;0;.00nan;0;0
7519;23433;842;86;35;2;33;.943;3547000;0
7519;148041;828;0;0;0;0;.00nan;0;0
7520;8501;832;0;0;0;0;.00nan;0;0
7520;180287;847;61;29;3;26;.897;3600000;0
7520;46492;832;71;37;4;33;.892;3551000;0
7520;54017;847;0;0;0;0;.00nan;0;0
7521;16588;836;55;13;1;12;.923;2440000;0
7521;182116;836;23;12;4;8;.667;1160000;0
7521;62975;834;71;33;2;31;.939;3600000;0
7521;147901;834;0;0;0;0;.00nan;0;0
7522;165723;837;100;42;0;42;1.000;3600000;0
7522;26336;829;43;16;3;13;.813;3600000;0
7522;89190;837;0;0;0;0;.00nan;0;0
7522;89874;829;0;0;0;0;.00nan;0;0
7523;2410;838;0;0;0;0;.00nan;0;0
7523;30431;839;71;21;2;19;.905;3900000;0
7523;57657;838;97;45;2;43;.956;3900000;0
7523;78223;839;0;0;0;0;.00nan;0;0
7524;16838;830;49;27;4;23;.852;3900000;0
7524;19322;848;60;39;4;35;.897;3900000;0
7524;47736;848;0;0;0;0;.00nan;0;0
7524;47791;830;0;0;0;0;.00nan;0;0
7525;5663;831;64;15;1;14;.933;3800000;0
7525;-1;833;0;0;0;0;.00nan;0;0
7525;53867;833;94;42;2;40;.952;3800000;0
7525;78094;831;0;0;0;0;.00nan;0;0
7526;2410;838;64;29;3;26;.897;3600000;0
7526;-1;833;0;0;0;0;.00nan;0;0
7526;53867;833;40;32;6;26;.813;3600000;0
7526;57657;838;0;0;0;0;.00nan;0;0
7527;183545;842;0;0;0;0;.00nan;0;0
7527;16838;830;36;29;5;24;.828;3570000;0
7527;23433;842;62;35;4;31;.886;3600000;0
7527;47791;830;0;0;0;0;.00nan;0;0
7528;180287;847;100;43;1;42;.977;3600000;0
7528;54017;847;0;0;0;0;.00nan;0;0
7528;62975;834;68;24;2;22;.917;3563000;0
7528;147901;834;0;0;0;0;.00nan;0;0
7529;16588;836;0;0;0;0;.00nan;0;0
7529;19322;848;44;30;5;25;.833;3600000;0
7529;182116;836;65;19;1;18;.947;3600000;0
7529;47736;848;0;0;0;0;.00nan;0;0
7530;8501;832;72;34;3;31;.912;3524000;0
7530;165723;837;79;22;1;21;.955;3600000;0
7530;46492;832;0;0;0;0;.00nan;0;0
7530;89190;837;0;0;0;0;.00nan;0;0
7531;167824;828;0;0;0;0;.00nan;0;0
7531;26336;829;61;20;1;19;.950;3600000;0
7531;89874;829;0;0;0;0;.00nan;0;0
7531;148041;828;53;23;3;20;.870;3510000;0
7532;16588;836;74;34;3;31;.912;3565000;0
7532;-1;833;85;33;2;31;.939;3600000;0
7532;182116;836;0;0;0;0;.00nan;0;0
7532;53867;833;0;0;0;0;.00nan;0;0
7533;183545;842;61;23;2;21;.913;3620000;0
7533;23433;842;0;0;0;0;.00nan;0;0
7533;62975;834;0;0;0;0;.00nan;0;0
7533;147901;834;69;29;3;26;.897;3620000;0
7534;165723;837;87;16;0;16;1.000;3600000;0
7534;30431;839;68;32;3;29;.906;3600000;0
7534;78223;839;0;0;0;0;.00nan;0;0
7534;89190;837;0;0;0;0;.00nan;0;0
7535;8501;832;0;0;0;0;.00nan;0;0
7535;19322;848;0;0;0;0;.00nan;0;0
7535;46492;832;100;36;1;35;.972;3600000;0
7535;47736;848;74;25;2;23;.920;3543000;0
7536;2410;838;0;0;0;0;.00nan;0;0
7536;26336;829;0;0;0;0;.00nan;0;0
7536;57657;838;91;33;2;31;.939;3600000;0
7536;89874;829;53;28;4;24;.857;3529000;0
7537;16838;830;0;0;0;0;.00nan;0;0
7537;180287;847;69;15;0;15;1.000;1307000;0
7537;47791;830;67;28;2;26;.929;3600000;0
7537;54017;847;35;35;6;29;.829;2293000;0
7538;5663;831;62;22;2;20;.909;3600000;0
7538;167824;828;56;39;6;33;.846;3600000;0
7538;78094;831;0;0;0;0;.00nan;0;0
7538;148041;828;0;0;0;0;.00nan;0;0
7539;5663;831;0;0;0;0;.00nan;0;0
7539;30431;839;0;0;0;0;.00nan;0;0
7539;78094;831;62;31;4;27;.871;3600000;0
7539;78223;839;99;44;1;43;.977;3600000;0
7540;183545;842;0;0;0;0;.00nan;0;0
7540;165723;837;80;33;3;30;.909;3900000;0
7540;23433;842;75;38;3;35;.921;3900000;0
7540;89190;837;0;0;0;0;.00nan;0;0
7541;5663;831;59;20;2;18;.900;3600000;0
7541;180287;847;15;30;7;23;.767;2410000;0
7541;54017;847;67;11;0;11;1.000;1190000;0
7541;78094;831;0;0;0;0;.00nan;0;0
7542;16588;836;0;0;0;0;.00nan;0;0
7542;26336;829;62;29;4;25;.862;3900000;0
7542;182116;836;82;41;4;37;.902;3900000;0
7542;89874;829;0;0;0;0;.00nan;0;0
7543;2410;838;69;40;5;35;.875;3600000;0
7543;8501;832;54;19;2;17;.895;1155000;0
7543;46492;832;18;22;6;16;.727;2445000;0
7543;57657;838;0;0;0;0;.00nan;0;0
7544;167824;828;35;29;6;23;.793;3600000;0
7544;-1;833;0;0;0;0;.00nan;0;0
7544;53867;833;98;39;1;38;.974;3600000;0
7544;148041;828;0;0;0;0;.00nan;0;0
7545;19322;848;84;18;0;18;1.000;3600000;0
7545;47736;848;0;0;0;0;.00nan;0;0
7545;62975;834;48;31;5;26;.839;3600000;0
7545;147901;834;0;0;0;0;.00nan;0;0
7546;16838;830;69;31;3;28;.903;3600000;0
7546;30431;839;55;38;5;33;.868;3600000;0
7546;47791;830;0;0;0;0;.00nan;0;0
7546;78223;839;0;0;0;0;.00nan;0;0
7547;5663;831;0;0;0;0;.00nan;0;0
7547;165723;837;67;26;2;24;.923;3600000;0
7547;78094;831;70;32;3;29;.906;3579000;0
7547;89190;837;0;0;0;0;.00nan;0;0
7548;2410;838;62;20;2;18;.900;3600000;0
7548;180287;847;70;38;3;35;.921;3600000;0
7548;54017;847;0;0;0;0;.00nan;0;0
7548;57657;838;0;0;0;0;.00nan;0;0
7549;-1;833;0;0;0;0;.00nan;0;0
7549;53867;833;40;25;4;21;.840;3600000;0
7549;62975;834;82;38;3;35;.921;3600000;0
7549;147901;834;0;0;0;0;.00nan;0;0
7550;167824;828;0;0;0;0;.00nan;0;0
7550;16838;830;0;0;0;0;.00nan;0;0
7550;47791;830;35;26;5;21;.808;3597000;0
7550;148041;828;58;29;4;25;.862;3600000;0
7551;183545;842;0;0;0;0;.00nan;0;0
7551;23433;842;82;34;2;32;.941;3600000;0
7551;30431;839;0;0;0;0;.00nan;0;0
7551;78223;839;35;16;4;12;.750;3542000;0
7552;19322;848;69;20;1;19;.950;3600000;0
7552;26336;829;80;32;3;29;.906;3541000;0
7552;47736;848;0;0;0;0;.00nan;0;0
7552;89874;829;0;0;0;0;.00nan;0;0
7553;5663;831;78;15;0;15;1.000;3600000;0
7553;8501;832;34;17;4;13;.765;1410000;0
7553;46492;832;40;27;6;21;.778;2190000;0
7553;78094;831;0;0;0;0;.00nan;0;0
7554;183545;842;25;32;6;26;.813;2400000;0
7554;16588;836;0;0;0;0;.00nan;0;0
7554;23433;842;56;12;1;11;.917;1200000;0
7554;182116;836;99;41;2;39;.951;3600000;0
7555;-1;833;0;0;0;0;.00nan;0;0
7555;180287;847;0;0;0;0;.00nan;0;0
7555;53867;833;57;35;4;31;.886;3600000;0
7555;54017;847;78;22;2;20;.909;3600000;0
7556;8501;832;85;36;3;33;.917;3538000;0
7556;30431;839;75;23;1;22;.957;3600000;0
7556;46492;832;0;0;0;0;.00nan;0;0
7556;78223;839;0;0;0;0;.00nan;0;0
7557;167824;828;58;29;2;27;.931;3900000;0
7557;62975;834;0;0;0;0;.00nan;0;0
7557;147901;834;100;44;2;42;.955;3900000;0
7557;148041;828;0;0;0;0;.00nan;0;0
7558;2410;838;0;0;0;0;.00nan;0;0
7558;19322;848;0;0;0;0;.00nan;0;0
7558;47736;848;69;23;2;21;.913;3600000;0
7558;57657;838;65;28;3;25;.893;3575000;0
7559;165723;837;76;27;2;25;.926;3600000;0
7559;16588;836;84;43;3;40;.930;3549000;0
7559;182116;836;0;0;0;0;.00nan;0;0
7559;89190;837;0;0;0;0;.00nan;0;0
7560;16838;830;48;21;3;18;.857;3554000;0
7560;26336;829;68;28;2;26;.929;3600000;0
7560;47791;830;0;0;0;0;.00nan;0;0
7560;89874;829;0;0;0;0;.00nan;0;0
7561;2410;838;52;32;5;27;.844;3576000;0
7561;57657;838;0;0;0;0;.00nan;0;0
7561;62975;834;65;33;4;29;.879;3600000;0
7561;147901;834;0;0;0;0;.00nan;0;0
7562;183545;842;0;0;0;0;.00nan;0;0
7562;23433;842;44;22;4;18;.818;3900000;0
7562;-1;833;0;0;0;0;.00nan;0;0
7562;53867;833;72;32;4;28;.875;3900000;0
7563;16588;836;0;0;0;0;.00nan;0;0
7563;180287;847;93;23;0;23;1.000;3600000;0
7563;182116;836;74;26;1;25;.962;3547000;0
7563;54017;847;0;0;0;0;.00nan;0;0
7564;167824;828;56;30;4;26;.867;3600000;0
7564;165723;837;100;36;0;36;1.000;3600000;0
7564;89190;837;0;0;0;0;.00nan;0;0
7564;148041;828;0;0;0;0;.00nan;0;0
7565;19322;848;64;28;3;25;.893;3900000;0
7565;30431;839;62;27;3;24;.889;3900000;0
7565;47736;848;0;0;0;0;.00nan;0;0
7565;78223;839;0;0;0;0;.00nan;0;0
7566;8501;832;0;0;0;0;.00nan;0;0
7566;26336;829;86;33;2;31;.939;3600000;0
7566;46492;832;58;37;5;32;.865;3600000;0
7566;89874;829;0;0;0;0;.00nan;0;0
7567;5663;831;93;36;1;35;.972;3600000;0
7567;16838;830;51;33;5;28;.848;3600000;0
7567;47791;830;0;0;0;0;.00nan;0;0
7567;78094;831;0;0;0;0;.00nan;0;0
7568;2410;838;64;24;2;22;.917;3600000;0
7568;167824;828;0;0;0;0;.00nan;0;0
7568;57657;838;0;0;0;0;.00nan;0;0
7568;148041;828;65;32;4;28;.875;3600000;0
7569;183545;842;0;0;0;0;.00nan;0;0
7569;23433;842;61;32;4;28;.875;3600000;0
7569;180287;847;80;23;1;22;.957;3600000;0
7569;54017;847;0;0;0;0;.00nan;0;0
7570;8501;832;0;0;0;0;.00nan;0;0
7570;-1;833;0;0;0;0;.00nan;0;0
7570;46492;832;60;14;2;12;.857;3900000;0
7570;53867;833;97;31;2;29;.935;3900000;0
7571;16838;830;0;0;0;0;.00nan;0;0
7571;47791;830;77;32;3;29;.906;3562000;0
7571;62975;834;84;33;2;31;.939;3600000;0
7571;147901;834;0;0;0;0;.00nan;0;0
7572;165723;837;80;35;3;32;.914;3600000;0
7572;19322;848;83;28;2;26;.929;3600000;0
7572;47736;848;0;0;0;0;.00nan;0;0
7572;89190;837;0;0;0;0;.00nan;0;0
7573;26336;829;64;41;5;36;.878;3554000;0
7573;30431;839;67;35;4;31;.886;3600000;0
7573;78223;839;0;0;0;0;.00nan;0;0
7573;89874;829;0;0;0;0;.00nan;0;0
7574;16588;836;0;0;0;0;.00nan;0;0
7574;30431;839;0;0;0;0;.00nan;0;0
7574;182116;836;77;38;3;35;.921;3570000;0
7574;78223;839;90;34;1;33;.971;3600000;0
7575;8501;832;77;59;4;55;.932;3600000;0
7575;46492;832;0;0;0;0;.00nan;0;0
7575;62975;834;0;0;0;0;.00nan;0;0
7575;147901;834;100;23;0;23;1.000;3600000;0
7576;167824;828;86;28;1;27;.964;3600000;0
7576;180287;847;51;37;5;32;.865;3600000;0
7576;54017;847;0;0;0;0;.00nan;0;0
7576;148041;828;0;0;0;0;.00nan;0;0
7577;5663;831;58;20;2;18;.900;3830000;0
7577;19322;848;0;0;0;0;.00nan;0;0
7577;47736;848;72;35;3;32;.914;3830000;0
7577;78094;831;0;0;0;0;.00nan;0;0
7578;26336;829;0;0;0;0;.00nan;0;0
7578;-1;833;24;6;3;3;.500;286000;0
7578;53867;833;75;36;4;32;.889;3314000;0
7578;89874;829;45;30;4;26;.867;3600000;0
7579;165723;837;76;24;2;22;.917;3645000;0
7579;16838;830;79;27;3;24;.889;3645000;0
7579;47791;830;0;0;0;0;.00nan;0;0
7579;89190;837;0;0;0;0;.00nan;0;0
7580;5663;831;0;0;0;0;.00nan;0;0
7580;16588;836;49;15;2;13;.867;1103000;0
7580;182116;836;41;38;6;32;.842;2497000;0
7580;78094;831;50;25;4;21;.840;3600000;0
7581;2410;838;51;38;5;33;.868;3600000;0
7581;165723;837;31;26;6;20;.769;3544000;0
7581;57657;838;0;0;0;0;.00nan;0;0
7581;89190;837;0;0;0;0;.00nan;0;0
7582;19322;848;74;22;1;21;.955;3600000;0
7582;-1;833;0;0;0;0;.00nan;0;0
7582;47736;848;0;0;0;0;.00nan;0;0
7582;53867;833;73;33;3;30;.909;3600000;0
7583;8501;832;0;0;0;0;.00nan;0;0
7583;167824;828;0;0;0;0;.00nan;0;0
7583;46492;832;75;32;3;29;.906;3600000;0
7583;148041;828;75;32;4;28;.875;3549000;0
7584;30431;839;61;28;4;24;.857;3531000;0
7584;180287;847;74;32;2;30;.938;3600000;0
7584;54017;847;0;0;0;0;.00nan;0;0
7584;78223;839;0;0;0;0;.00nan;0;0
7585;5663;831;67;27;2;25;.926;3600000;0
7585;62975;834;0;0;0;0;.00nan;0;0
7585;78094;831;0;0;0;0;.00nan;0;0
7585;147901;834;81;43;4;39;.907;3600000;0
7586;5663;831;0;0;0;0;.00nan;0;0
7586;183545;842;0;0;0;0;.00nan;0;0
7586;23433;842;89;35;1;34;.971;3600000;0
7586;78094;831;50;20;3;17;.850;3559000;0
7587;26336;829;74;28;2;26;.929;3600000;0
7587;180287;847;68;31;3;28;.903;3543000;0
7587;54017;847;0;0;0;0;.00nan;0;0
7587;89874;829;0;0;0;0;.00nan;0;0
7588;8501;832;98;36;1;35;.972;3569000;0
7588;16588;836;0;0;0;0;.00nan;0;0
7588;182116;836;100;31;0;31;1.000;3600000;0
7588;46492;832;0;0;0;0;.00nan;0;0
7589;30431;839;0;0;0;0;.00nan;0;0
7589;62975;834;77;32;3;29;.906;3900000;0
7589;78223;839;54;24;3;21;.875;3900000;0
7589;147901;834;0;0;0;0;.00nan;0;0
7590;167824;828;78;28;2;26;.929;3600000;0
7590;19322;848;0;0;0;0;.00nan;0;0
7590;47736;848;66;31;3;28;.903;3600000;0
7590;148041;828;0;0;0;0;.00nan;0;0
7591;2410;838;22;33;7;26;.788;3600000;0
7591;16838;830;0;0;0;0;.00nan;0;0
7591;47791;830;68;19;1;18;.947;3600000;0
7591;57657;838;0;0;0;0;.00nan;0;0
7592;16588;836;0;0;0;0;.00nan;0;0
7592;16838;830;82;36;3;33;.917;3600000;0
7592;182116;836;100;31;0;31;1.000;3600000;0
7592;47791;830;0;0;0;0;.00nan;0;0
7593;183545;842;88;32;2;30;.938;3600000;0
7593;23433;842;0;0;0;0;.00nan;0;0
7593;26336;829;58;23;3;20;.870;3554000;0
7593;89874;829;0;0;0;0;.00nan;0;0
7594;180287;847;51;32;4;28;.875;3581000;0
7594;54017;847;0;0;0;0;.00nan;0;0
7594;62975;834;78;27;2;25;.926;3600000;0
7594;147901;834;0;0;0;0;.00nan;0;0
7595;2410;838;0;0;0;0;.00nan;0;0
7595;5663;831;49;24;4;20;.833;3563000;0
7595;57657;838;97;42;3;39;.929;3600000;0
7595;78094;831;0;0;0;0;.00nan;0;0
7596;30431;839;71;29;2;27;.931;3600000;0
7596;-1;833;0;0;0;0;.00nan;0;0
7596;53867;833;67;29;3;26;.897;3581000;0
7596;78223;839;0;0;0;0;.00nan;0;0
7597;8501;832;0;0;0;0;.00nan;0;0
7597;16838;830;40;26;5;21;.808;3600000;0
7597;46492;832;99;43;1;42;.977;3600000;0
7597;47791;830;0;0;0;0;.00nan;0;0
7598;167824;828;0;0;0;0;.00nan;0;0
7598;16588;836;0;0;0;0;.00nan;0;0
7598;182116;836;97;40;2;38;.950;3600000;0
7598;148041;828;60;31;4;27;.871;3600000;0
7599;183545;842;0;0;0;0;.00nan;0;0
7599;19322;848;83;29;2;27;.931;3600000;0
7599;23433;842;56;30;3;27;.900;3592000;0
7599;47736;848;0;0;0;0;.00nan;0;0
7600;26336;829;69;26;2;24;.923;3600000;0
7600;62975;834;0;0;0;0;.00nan;0;0
7600;89874;829;0;0;0;0;.00nan;0;0
7600;147901;834;43;26;5;21;.808;3600000;0
7601;8501;832;41;40;6;34;.850;3600000;0
7601;183545;842;99;32;1;31;.969;3600000;0
7601;23433;842;0;0;0;0;.00nan;0;0
7601;46492;832;0;0;0;0;.00nan;0;0
7602;19322;848;0;0;0;0;.00nan;0;0
7602;180287;847;84;25;1;24;.960;3900000;0
7602;47736;848;90;24;1;23;.958;3900000;0
7602;54017;847;0;0;0;0;.00nan;0;0
7603;2410;838;75;44;4;40;.909;3600000;0
7603;16588;836;0;0;0;0;.00nan;0;0
7603;182116;836;75;34;3;31;.912;3600000;0
7603;57657;838;0;0;0;0;.00nan;0;0
7604;165723;837;96;31;1;30;.968;3600000;0
7604;62975;834;72;40;3;37;.925;3513000;0
7604;89190;837;0;0;0;0;.00nan;0;0
7604;147901;834;0;0;0;0;.00nan;0;0
7605;16838;830;0;0;0;0;.00nan;0;0
7605;-1;833;37;27;5;22;.815;3600000;0
7605;47791;830;59;34;4;30;.882;3600000;0
7605;53867;833;0;0;0;0;.00nan;0;0
7606;165723;837;0;0;0;0;.00nan;0;0
7606;180287;847;79;46;5;41;.891;3712000;0
7606;54017;847;0;0;0;0;.00nan;0;0
7606;89190;837;60;30;4;26;.867;3712000;0
7607;167824;828;99;36;1;35;.972;3600000;0
7607;30431;839;0;0;0;0;.00nan;0;0
7607;78223;839;58;23;2;21;.913;3568000;0
7607;148041;828;0;0;0;0;.00nan;0;0
7608;5663;831;42;20;4;16;.800;3656000;0
7608;26336;829;72;33;3;30;.909;3656000;0
7608;78094;831;0;0;0;0;.00nan;0;0
7608;89874;829;0;0;0;0;.00nan;0;0
7609;2410;838;0;0;0;0;.00nan;0;0
7609;30431;839;0;0;0;0;.00nan;0;0
7609;57657;838;68;27;3;24;.889;3665000;0
7609;78223;839;59;25;2;23;.920;3665000;0
7610;5663;831;78;17;1;16;.941;3600000;0
7610;-1;833;0;0;0;0;.00nan;0;0
7610;53867;833;69;30;2;28;.933;3574000;0
7610;78094;831;0;0;0;0;.00nan;0;0
7611;16588;836;0;0;0;0;.00nan;0;0
7611;182116;836;100;39;2;37;.949;3600000;0
7611;62975;834;0;0;0;0;.00nan;0;0
7611;147901;834;49;22;3;19;.864;3544000;0
7612;8501;832;0;0;0;0;.00nan;0;0
7612;180287;847;68;21;2;19;.905;3600000;0
7612;46492;832;43;22;4;18;.818;3524000;0
7612;54017;847;0;0;0;0;.00nan;0;0
7613;167824;828;0;0;0;0;.00nan;0;0
7613;183545;842;0;0;0;0;.00nan;0;0
7613;23433;842;63;38;4;34;.895;3600000;0
7613;148041;828;48;35;5;30;.857;3582000;0
7614;16838;830;48;21;4;17;.810;3600000;0
7614;19322;848;49;38;5;33;.868;3580000;0
7614;47736;848;0;0;0;0;.00nan;0;0
7614;47791;830;0;0;0;0;.00nan;0;0
7615;165723;837;79;38;3;35;.921;3599000;0
7615;26336;829;77;24;1;23;.958;3600000;0
7615;89190;837;0;0;0;0;.00nan;0;0
7615;89874;829;0;0;0;0;.00nan;0;0
7616;2410;838;0;0;0;0;.00nan;0;0
7616;-1;833;0;0;0;0;.00nan;0;0
7616;53867;833;97;38;1;37;.974;3600000;0
7616;57657;838;55;31;4;27;.871;3600000;0
7617;8501;832;0;0;0;0;.00nan;0;0
7617;165723;837;57;22;2;20;.909;3600000;0
7617;46492;832;72;47;5;42;.894;3600000;0
7617;89190;837;0;0;0;0;.00nan;0;0
7618;16588;836;0;0;0;0;.00nan;0;0
7618;19322;848;78;28;1;27;.964;3600000;0
7618;182116;836;89;41;3;38;.927;3529000;0
7618;47736;848;0;0;0;0;.00nan;0;0
7619;167824;828;0;0;0;0;.00nan;0;0
7619;26336;829;88;37;2;35;.946;3573000;0
7619;89874;829;0;0;0;0;.00nan;0;0
7619;148041;828;80;28;1;27;.964;3600000;0
7620;183545;842;0;0;0;0;.00nan;0;0
7620;16838;830;59;14;1;13;.929;3600000;0
7620;23433;842;79;43;4;39;.907;3600000;0
7620;47791;830;0;0;0;0;.00nan;0;0
7621;5663;831;0;0;0;0;.00nan;0;0
7621;30431;839;0;0;0;0;.00nan;0;0
7621;78094;831;65;18;1;17;.944;3600000;0
7621;78223;839;92;41;3;38;.927;3513000;0
7622;183545;842;80;25;1;24;.960;3600000;0
7622;23433;842;0;0;0;0;.00nan;0;0
7622;62975;834;81;31;2;29;.935;3547000;0
7622;147901;834;0;0;0;0;.00nan;0;0
7623;16838;830;0;0;0;0;.00nan;0;0
7623;180287;847;83;32;2;30;.938;3600000;0
7623;47791;830;82;40;3;37;.925;3600000;0
7623;54017;847;0;0;0;0;.00nan;0;0
7624;16588;836;0;0;0;0;.00nan;0;0
7624;-1;833;74;35;3;32;.914;3546000;0
7624;182116;836;79;28;2;26;.929;3600000;0
7624;53867;833;0;0;0;0;.00nan;0;0
7625;8501;832;87;52;3;49;.942;3900000;0
7625;19322;848;0;0;0;0;.00nan;0;0
7625;46492;832;0;0;0;0;.00nan;0;0
7625;47736;848;46;20;3;17;.850;3893000;0
7626;5663;831;61;21;2;19;.905;3658000;0
7626;167824;828;79;39;3;36;.923;3658000;0
7626;78094;831;0;0;0;0;.00nan;0;0
7626;148041;828;0;0;0;0;.00nan;0;0
7627;165723;837;67;25;2;23;.920;3600000;0
7627;30431;839;70;25;2;23;.920;2499000;0
7627;78223;839;33;19;4;15;.789;1101000;0
7627;89190;837;0;0;0;0;.00nan;0;0
7628;2410;838;54;35;5;30;.857;3600000;0
7628;8501;832;0;0;0;0;.00nan;0;0
7628;46492;832;100;53;2;51;.962;3600000;0
7628;57657;838;0;0;0;0;.00nan;0;0
7629;167824;828;81;26;2;24;.923;3600000;0
7629;-1;833;0;0;0;0;.00nan;0;0
7629;53867;833;61;29;3;26;.897;3556000;0
7629;148041;828;0;0;0;0;.00nan;0;0
7630;19322;848;78;12;0;12;1.000;3600000;0
7630;47736;848;0;0;0;0;.00nan;0;0
7630;62975;834;0;0;0;0;.00nan;0;0
7630;147901;834;72;34;2;32;.941;3567000;0
7631;183545;842;0;0;0;0;.00nan;0;0
7631;165723;837;77;24;1;23;.958;3600000;0
7631;23433;842;67;57;7;50;.877;3600000;0
7631;89190;837;0;0;0;0;.00nan;0;0
7632;16838;830;57;35;4;31;.886;3900000;0
7632;30431;839;0;0;0;0;.00nan;0;0
7632;47791;830;0;0;0;0;.00nan;0;0
7632;78223;839;45;33;5;28;.848;3900000;0
7633;5663;831;79;13;0;13;1.000;3600000;0
7633;180287;847;41;32;6;26;.813;3152000;0
7633;54017;847;61;8;0;8;1.000;448000;0
7633;78094;831;0;0;0;0;.00nan;0;0
7634;16588;836;49;12;2;10;.833;1008000;0
7634;26336;829;56;20;2;18;.900;3600000;0
7634;182116;836;50;39;6;33;.846;2592000;0
7634;89874;829;0;0;0;0;.00nan;0;0
7635;165723;837;79;31;2;29;.935;3600000;0
7635;16588;836;0;0;0;0;.00nan;0;0
7635;182116;836;63;31;4;27;.871;3522000;0
7635;89190;837;0;0;0;0;.00nan;0;0
7636;183545;842;0;0;0;0;.00nan;0;0
7636;23433;842;79;29;1;28;.966;3600000;0
7636;30431;839;0;0;0;0;.00nan;0;0
7636;78223;839;46;21;3;18;.857;3553000;0
7637;2410;838;0;0;0;0;.00nan;0;0
7637;180287;847;0;0;0;0;.00nan;0;0
7637;54017;847;51;21;3;18;.857;3513000;0
7637;57657;838;87;31;1;30;.968;3600000;0
7638;5663;831;54;21;4;17;.810;3551000;0
7638;8501;832;0;0;0;0;.00nan;0;0
7638;46492;832;83;45;3;42;.933;3600000;0
7638;78094;831;0;0;0;0;.00nan;0;0
7639;-1;833;0;0;0;0;.00nan;0;0
7639;53867;833;53;35;4;31;.886;3900000;0
7639;62975;834;0;0;0;0;.00nan;0;0
7639;147901;834;60;31;4;27;.871;3900000;0
7640;19322;848;73;38;4;34;.895;3600000;0
7640;26336;829;73;26;1;25;.962;3600000;0
7640;47736;848;0;0;0;0;.00nan;0;0
7640;89874;829;0;0;0;0;.00nan;0;0
7641;2410;838;80;31;2;29;.935;3664000;0
7641;19322;848;0;0;0;0;.00nan;0;0
7641;47736;848;95;39;1;38;.974;3664000;0
7641;57657;838;0;0;0;0;.00nan;0;0
7642;-1;833;84;28;1;27;.964;3561000;0
7642;180287;847;100;38;0;38;1.000;3600000;0
7642;53867;833;0;0;0;0;.00nan;0;0
7642;54017;847;0;0;0;0;.00nan;0;0
7643;183545;842;9;28;7;21;.750;3320000;0
7643;16588;836;0;0;0;0;.00nan;0;0
7643;23433;842;49;2;0;2;1.000;280000;0
7643;182116;836;95;34;1;33;.971;3600000;0
7644;167824;828;0;0;0;0;.00nan;0;0
7644;62975;834;82;47;5;42;.894;3600000;0
7644;147901;834;0;0;0;0;.00nan;0;0
7644;148041;828;71;21;2;19;.905;3600000;0
7645;8501;832;88;40;3;37;.925;3600000;0
7645;30431;839;0;0;0;0;.00nan;0;0
7645;46492;832;0;0;0;0;.00nan;0;0
7645;78223;839;51;13;2;11;.846;3600000;0
7646;16838;830;82;38;3;35;.921;3600000;0
7646;26336;829;0;0;0;0;.00nan;0;0
7646;47791;830;0;0;0;0;.00nan;0;0
7646;89874;829;91;21;0;21;1.000;3600000;0
7647;5663;831;0;0;0;0;.00nan;0;0
7647;165723;837;42;38;6;32;.842;3600000;0
7647;78094;831;46;30;5;25;.833;3600000;0
7647;89190;837;0;0;0;0;.00nan;0;0
7648;167824;828;0;0;0;0;.00nan;0;0
7648;16838;830;76;35;3;32;.914;3557000;0
7648;47791;830;0;0;0;0;.00nan;0;0
7648;148041;828;84;32;2;30;.938;3600000;0
7649;183545;842;0;0;0;0;.00nan;0;0
7649;23433;842;69;38;4;34;.895;3582000;0
7649;180287;847;96;41;3;38;.927;3600000;0
7649;54017;847;0;0;0;0;.00nan;0;0
7650;8501;832;0;0;0;0;.00nan;0;0
7650;-1;833;0;0;0;0;.00nan;0;0
7650;46492;832;50;32;5;27;.844;3600000;0
7650;53867;833;83;25;1;24;.960;3600000;0
7651;2410;838;0;0;0;0;.00nan;0;0
7651;167824;828;80;42;3;39;.929;3861000;0
7651;57657;838;71;37;4;33;.892;3861000;0
7651;148041;828;0;0;0;0;.00nan;0;0
7652;165723;837;91;30;1;29;.967;3600000;0
7652;19322;848;81;33;2;31;.939;3555000;0
7652;47736;848;0;0;0;0;.00nan;0;0
7652;89190;837;0;0;0;0;.00nan;0;0
7653;26336;829;0;0;0;0;.00nan;0;0
7653;30431;839;0;0;0;0;.00nan;0;0
7653;78223;839;91;43;2;41;.953;3557000;0
7653;89874;829;88;34;1;33;.971;3600000;0
7654;16838;830;59;21;2;19;.905;3600000;0
7654;47791;830;0;0;0;0;.00nan;0;0
7654;62975;834;76;43;4;39;.907;3600000;0
7654;147901;834;0;0;0;0;.00nan;0;0
7655;2410;838;89;40;3;37;.925;3900000;0
7655;183545;842;59;29;3;26;.897;3900000;0
7655;23433;842;0;0;0;0;.00nan;0;0
7655;57657;838;0;0;0;0;.00nan;0;0
7656;26336;829;42;22;4;18;.818;3600000;0
7656;-1;833;81;29;1;28;.966;3600000;0
7656;53867;833;0;0;0;0;.00nan;0;0
7656;89874;829;0;0;0;0;.00nan;0;0
7657;8501;832;59;13;1;12;.923;1499000;0
7657;46492;832;30;29;6;23;.793;2087000;0
7657;62975;834;0;0;0;0;.00nan;0;0
7657;147901;834;35;26;5;21;.808;3600000;0
7658;165723;837;82;21;1;20;.952;3600000;0
7658;16838;830;0;0;0;0;.00nan;0;0
7658;47791;830;53;31;5;26;.839;3600000;0
7658;89190;837;0;0;0;0;.00nan;0;0
7659;16588;836;0;0;0;0;.00nan;0;0
7659;30431;839;65;23;2;21;.913;3600000;0
7659;182116;836;92;46;4;42;.913;3518000;0
7659;78223;839;0;0;0;0;.00nan;0;0
7660;5663;831;85;14;0;14;1.000;3600000;0
7660;19322;848;0;0;0;0;.00nan;0;0
7660;47736;848;50;34;5;29;.853;3600000;0
7660;78094;831;0;0;0;0;.00nan;0;0
7661;167824;828;0;0;0;0;.00nan;0;0
7661;180287;847;93;32;2;30;.938;3600000;0
7661;54017;847;0;0;0;0;.00nan;0;0
7661;148041;828;83;42;3;39;.929;3542000;0
7662;5663;831;69;19;1;18;.947;3600000;0
7662;16588;836;83;50;5;45;.900;3600000;0
7662;182116;836;0;0;0;0;.00nan;0;0
7662;78094;831;0;0;0;0;.00nan;0;0
7663;167824;828;75;32;3;29;.906;3566000;0
7663;165723;837;96;30;1;29;.967;3600000;0
7663;89190;837;0;0;0;0;.00nan;0;0
7663;148041;828;0;0;0;0;.00nan;0;0
7664;30431;839;60;35;4;31;.886;3600000;0
7664;62975;834;48;18;3;15;.833;3600000;0
7664;78223;839;0;0;0;0;.00nan;0;0
7664;147901;834;0;0;0;0;.00nan;0;0
7665;183545;842;67;23;2;21;.913;3007000;0
7665;23433;842;40;15;3;12;.800;593000;0
7665;26336;829;81;25;1;24;.960;3600000;0
7665;89874;829;0;0;0;0;.00nan;0;0
7666;30431;839;46;30;4;26;.867;3600000;0
7666;180287;847;67;27;3;24;.889;3600000;0
7666;54017;847;0;0;0;0;.00nan;0;0
7666;78223;839;0;0;0;0;.00nan;0;0
7667;8501;832;0;0;0;0;.00nan;0;0
7667;167824;828;0;0;0;0;.00nan;0;0
7667;46492;832;100;45;1;44;.978;3600000;0
7667;148041;828;21;33;7;26;.788;3600000;0
7668;5663;831;73;18;1;17;.944;3900000;0
7668;62975;834;0;0;0;0;.00nan;0;0
7668;78094;831;0;0;0;0;.00nan;0;0
7668;147901;834;100;37;1;36;.973;3900000;0
7669;19322;848;53;41;5;36;.878;3600000;0
7669;-1;833;0;0;0;0;.00nan;0;0
7669;47736;848;0;0;0;0;.00nan;0;0
7669;53867;833;85;32;2;30;.938;3600000;0
7670;16588;836;0;0;0;0;.00nan;0;0
7670;16838;830;76;28;2;26;.929;3579000;0
7670;182116;836;100;48;1;47;.979;3600000;0
7670;47791;830;0;0;0;0;.00nan;0;0
7671;2410;838;0;0;0;0;.00nan;0;0
7671;16838;830;0;0;0;0;.00nan;0;0
7671;47791;830;77;25;1;24;.960;3600000;0
7671;57657;838;68;30;2;28;.933;3571000;0
7672;165723;837;55;18;2;16;.889;3600000;0
7672;-1;833;85;41;3;38;.927;3551000;0
7672;53867;833;0;0;0;0;.00nan;0;0
7672;89190;837;0;0;0;0;.00nan;0;0
7673;8501;832;61;33;4;29;.879;3572000;0
7673;16588;836;0;0;0;0;.00nan;0;0
7673;182116;836;63;23;2;21;.913;3600000;0
7673;46492;832;0;0;0;0;.00nan;0;0
7674;167824;828;63;25;3;22;.880;3545000;0
7674;19322;848;0;0;0;0;.00nan;0;0
7674;47736;848;100;45;2;43;.956;3600000;0
7674;148041;828;0;0;0;0;.00nan;0;0
7675;26336;829;0;0;0;0;.00nan;0;0
7675;180287;847;100;32;0;32;1.000;3600000;0
7675;54017;847;0;0;0;0;.00nan;0;0
7675;89874;829;88;43;3;40;.930;3600000;0
7676;5663;831;67;24;2;22;.917;3600000;0
7676;183545;842;95;34;1;33;.971;2630000;0
7676;23433;842;31;16;4;12;.750;970000;0
7676;78094;831;0;0;0;0;.00nan;0;0
7677;2410;838;87;38;2;36;.947;3760000;0
7677;165723;837;66;27;3;24;.889;3760000;0
7677;57657;838;0;0;0;0;.00nan;0;0
7677;89190;837;0;0;0;0;.00nan;0;0
7678;183545;842;63;43;5;38;.884;3560000;0
7678;23433;842;0;0;0;0;.00nan;0;0
7678;-1;833;0;0;0;0;.00nan;0;0
7678;53867;833;70;37;4;33;.892;3600000;0
7679;16588;836;0;0;0;0;.00nan;0;0
7679;180287;847;84;29;2;27;.931;3600000;0
7679;182116;836;80;46;5;41;.891;3600000;0
7679;54017;847;0;0;0;0;.00nan;0;0
7680;8501;832;0;0;0;0;.00nan;0;0
7680;26336;829;77;20;1;19;.950;3600000;0
7680;46492;832;92;43;3;40;.930;3600000;0
7680;89874;829;0;0;0;0;.00nan;0;0
7681;165723;837;100;27;0;27;1.000;3600000;0
7681;62975;834;48;48;7;41;.854;3314000;0
7681;89190;837;0;0;0;0;.00nan;0;0
7681;147901;834;55;5;0;5;1.000;286000;0
7682;19322;848;51;33;5;28;.848;3600000;0
7682;30431;839;81;33;1;32;.970;3600000;0
7682;47736;848;0;0;0;0;.00nan;0;0
7682;78223;839;0;0;0;0;.00nan;0;0
7683;5663;831;79;40;4;36;.900;3553000;0
7683;16838;830;58;22;3;19;.864;3600000;0
7683;47791;830;0;0;0;0;.00nan;0;0
7683;78094;831;0;0;0;0;.00nan;0;0
7684;2410;838;92;39;2;37;.949;3600000;0
7684;165723;837;84;41;3;38;.927;3600000;0
7684;57657;838;0;0;0;0;.00nan;0;0
7684;89190;837;0;0;0;0;.00nan;0;0
7685;5663;831;84;24;1;23;.958;3900000;0
7685;-1;833;0;0;0;0;.00nan;0;0
7685;53867;833;96;40;1;39;.975;3900000;0
7685;78094;831;0;0;0;0;.00nan;0;0
7686;16588;836;0;0;0;0;.00nan;0;0
7686;180287;847;30;27;5;22;.815;3900000;0
7686;182116;836;71;47;5;42;.894;3900000;0
7686;54017;847;0;0;0;0;.00nan;0;0
7687;183545;842;0;0;0;0;.00nan;0;0
7687;23433;842;70;31;2;29;.935;3900000;0
7687;30431;839;89;29;2;27;.931;3900000;0
7687;78223;839;0;0;0;0;.00nan;0;0
7688;167824;828;0;0;0;0;.00nan;0;0
7688;19322;848;73;31;2;29;.935;3600000;0
7688;47736;848;0;0;0;0;.00nan;0;0
7688;148041;828;63;30;3;27;.900;3560000;0
7689;26336;829;64;27;3;24;.889;3523000;0
7689;62975;834;82;25;1;24;.960;3600000;0
7689;89874;829;0;0;0;0;.00nan;0;0
7689;147901;834;0;0;0;0;.00nan;0;0
7690;8501;832;0;0;0;0;.00nan;0;0
7690;16838;830;50;19;3;16;.842;3590000;0
7690;46492;832;89;37;2;35;.946;3600000;0
7690;47791;830;0;0;0;0;.00nan;0;0
7691;183545;842;51;41;6;35;.854;3100000;0
7691;16838;830;0;0;0;0;.00nan;0;0
7691;23433;842;57;6;0;6;1.000;500000;0
7691;47791;830;76;15;0;15;1.000;3600000;0
7692;19322;848;0;0;0;0;.00nan;0;0
7692;180287;847;0;0;0;0;.00nan;0;0
7692;47736;848;86;19;0;19;1.000;3600000;0
7692;54017;847;53;26;4;22;.846;3600000;0
7693;2410;838;0;0;0;0;.00nan;0;0
7693;8501;832;0;0;0;0;.00nan;0;0
7693;46492;832;69;27;3;24;.889;3781000;0
7693;57657;838;76;34;2;32;.941;3781000;0
7694;-1;833;56;39;6;33;.846;3600000;0
7694;53867;833;0;0;0;0;.00nan;0;0
7694;62975;834;0;0;0;0;.00nan;0;0
7694;147901;834;53;27;3;24;.889;3600000;0
7695;165723;837;47;33;5;28;.848;3600000;0
7695;30431;839;76;39;4;35;.897;3600000;0
7695;78223;839;0;0;0;0;.00nan;0;0
7695;89190;837;0;0;0;0;.00nan;0;0
7696;5663;831;78;27;2;25;.926;3900000;0
7696;26336;829;0;0;0;0;.00nan;0;0
7696;78094;831;0;0;0;0;.00nan;0;0
7696;89874;829;66;27;2;25;.926;3900000;0
7697;167824;828;46;30;5;25;.833;3600000;0
7697;16588;836;0;0;0;0;.00nan;0;0
7697;182116;836;64;50;6;44;.880;3573000;0
7697;148041;828;0;0;0;0;.00nan;0;0
7698;2410;838;48;25;5;20;.800;3900000;0
7698;183545;842;0;0;0;0;.00nan;0;0
7698;23433;842;43;30;5;25;.833;3900000;0
7698;57657;838;0;0;0;0;.00nan;0;0
7699;-1;833;0;0;0;0;.00nan;0;0
7699;180287;847;57;29;4;25;.862;3600000;0
7699;53867;833;37;31;5;26;.839;3574000;0
7699;54017;847;0;0;0;0;.00nan;0;0
7700;165723;837;0;0;0;0;.00nan;0;0
7700;19322;848;0;0;0;0;.00nan;0;0
7700;47736;848;68;45;5;40;.889;3562000;0
7700;89190;837;60;27;3;24;.889;3600000;0
7701;5663;831;57;25;3;22;.880;3900000;0
7701;30431;839;88;42;3;39;.929;3900000;0
7701;78094;831;0;0;0;0;.00nan;0;0
7701;78223;839;0;0;0;0;.00nan;0;0
7702;8501;832;0;0;0;0;.00nan;0;0
7702;26336;829;51;22;3;19;.864;3571000;0
7702;46492;832;95;34;1;33;.971;3600000;0
7702;89874;829;0;0;0;0;.00nan;0;0
7703;183545;842;81;41;3;38;.927;3600000;0
7703;165723;837;57;25;4;21;.840;3559000;0
7703;23433;842;0;0;0;0;.00nan;0;0
7703;89190;837;0;0;0;0;.00nan;0;0
7704;16838;830;59;5;0;5;1.000;754000;0
7704;180287;847;75;36;3;33;.917;3600000;0
7704;47791;830;30;29;6;23;.793;2846000;0
7704;54017;847;0;0;0;0;.00nan;0;0
7705;8501;832;90;40;3;37;.925;3587000;0
7705;16588;836;0;0;0;0;.00nan;0;0
7705;182116;836;91;29;1;28;.966;3600000;0
7705;46492;832;0;0;0;0;.00nan;0;0
7706;167824;828;0;0;0;0;.00nan;0;0
7706;-1;833;74;17;0;17;1.000;1846000;0
7706;53867;833;30;27;5;22;.815;1754000;0
7706;148041;828;92;30;1;29;.967;3600000;0
7707;30431;839;0;0;0;0;.00nan;0;0
7707;62975;834;72;22;1;21;.955;3545000;0
7707;78223;839;100;47;0;47;1.000;3600000;0
7707;147901;834;0;0;0;0;.00nan;0;0
7708;19322;848;57;38;5;33;.868;3600000;0
7708;26336;829;0;0;0;0;.00nan;0;0
7708;47736;848;0;0;0;0;.00nan;0;0
7708;89874;829;89;27;1;26;.963;3600000;0
7709;2410;838;0;0;0;0;.00nan;0;0
7709;5663;831;70;19;1;18;.947;3600000;0
7709;57657;838;37;34;6;28;.824;3600000;0
7709;78094;831;0;0;0;0;.00nan;0;0
7710;16588;836;0;0;0;0;.00nan;0;0
7710;182116;836;99;42;2;40;.952;3600000;0
7710;62975;834;60;12;1;11;.917;973000;0
7710;147901;834;31;27;6;21;.778;2627000;0
7711;2410;838;54;26;3;23;.885;3600000;0
7711;167824;828;46;24;4;20;.833;3544000;0
7711;57657;838;0;0;0;0;.00nan;0;0
7711;148041;828;0;0;0;0;.00nan;0;0
7712;19322;848;69;28;2;26;.929;3591000;0
7712;-1;833;0;0;0;0;.00nan;0;0
7712;47736;848;0;0;0;0;.00nan;0;0
7712;53867;833;99;41;1;40;.976;3600000;0
7713;183545;842;73;29;2;27;.931;3600000;0
7713;16588;836;51;2;0;2;1.000;264000;0
7713;23433;842;0;0;0;0;.00nan;0;0
7713;182116;836;40;42;7;35;.833;3336000;0
7714;5663;831;100;32;0;32;1.000;3600000;0
7714;165723;837;38;37;7;30;.811;3600000;0
7714;78094;831;0;0;0;0;.00nan;0;0
7714;89190;837;0;0;0;0;.00nan;0;0
7715;8501;832;0;0;0;0;.00nan;0;0
7715;30431;839;66;27;3;24;.889;3600000;0
7715;46492;832;58;34;5;29;.853;3569000;0
7715;78223;839;0;0;0;0;.00nan;0;0
7716;26336;829;34;9;3;6;.667;3600000;0
7716;180287;847;90;50;4;46;.920;3600000;0
7716;54017;847;0;0;0;0;.00nan;0;0
7716;89874;829;0;0;0;0;.00nan;0;0
7717;16838;830;64;36;5;31;.861;3513000;0
7717;47791;830;0;0;0;0;.00nan;0;0
7717;62975;834;79;34;3;31;.912;3600000;0
7717;147901;834;0;0;0;0;.00nan;0;0
7718;183545;842;0;0;0;0;.00nan;0;0
7718;23433;842;73;35;3;32;.914;3600000;0
7718;26336;829;37;26;5;21;.808;3515000;0
7718;89874;829;0;0;0;0;.00nan;0;0
7719;2410;838;68;17;1;16;.941;3600000;0
7719;180287;847;44;51;7;44;.863;3600000;0
7719;54017;847;0;0;0;0;.00nan;0;0
7719;57657;838;0;0;0;0;.00nan;0;0
7720;16588;836;0;0;0;0;.00nan;0;0
7720;-1;833;0;0;0;0;.00nan;0;0
7720;182116;836;82;36;3;33;.917;3588000;0
7720;53867;833;84;29;1;28;.966;3600000;0
7721;167824;828;0;0;0;0;.00nan;0;0
7721;30431;839;64;21;2;19;.905;3137000;0
7721;78223;839;25;7;3;4;.571;463000;0
7721;148041;828;96;33;1;32;.970;3600000;0
7722;165723;837;46;21;3;18;.857;3900000;0
7722;62975;834;93;45;3;42;.933;3900000;0
7722;89190;837;0;0;0;0;.00nan;0;0
7722;147901;834;0;0;0;0;.00nan;0;0
7723;8501;832;0;0;0;0;.00nan;0;0
7723;19322;848;0;0;0;0;.00nan;0;0
7723;46492;832;55;32;4;28;.875;3593000;0
7723;47736;848;77;34;3;31;.912;3600000;0
7724;5663;831;66;36;4;32;.889;3900000;0
7724;16838;830;42;25;4;21;.840;3900000;0
7724;47791;830;0;0;0;0;.00nan;0;0
7724;78094;831;0;0;0;0;.00nan;0;0
7725;16838;830;42;22;4;18;.818;3549000;0
7725;-1;833;0;0;0;0;.00nan;0;0
7725;47791;830;0;0;0;0;.00nan;0;0
7725;53867;833;100;43;2;41;.953;3600000;0
7726;8501;832;0;0;0;0;.00nan;0;0
7726;180287;847;69;33;3;30;.909;3600000;0
7726;46492;832;71;34;4;30;.882;3600000;0
7726;54017;847;0;0;0;0;.00nan;0;0
7727;183545;842;0;0;0;0;.00nan;0;0
7727;23433;842;57;30;4;26;.867;3519000;0
7727;62975;834;57;17;2;15;.882;3600000;0
7727;147901;834;0;0;0;0;.00nan;0;0
7728;2410;838;94;34;1;33;.971;3579000;0
7728;30431;839;100;34;0;34;1.000;3600000;0
7728;57657;838;0;0;0;0;.00nan;0;0
7728;78223;839;0;0;0;0;.00nan;0;0
7729;16588;836;0;0;0;0;.00nan;0;0
7729;19322;848;0;0;0;0;.00nan;0;0
7729;182116;836;57;37;4;33;.892;3582000;0
7729;47736;848;80;35;3;32;.914;3600000;0
7730;165723;837;100;31;0;31;1.000;3600000;0
7730;26336;829;52;31;5;26;.839;3600000;0
7730;89190;837;0;0;0;0;.00nan;0;0
7730;89874;829;0;0;0;0;.00nan;0;0
7731;5663;831;68;23;2;21;.913;3554000;0
7731;167824;828;0;0;0;0;.00nan;0;0
7731;78094;831;0;0;0;0;.00nan;0;0
7731;148041;828;100;31;0;31;1.000;3600000;0
7732;2410;838;72;28;2;26;.929;3600000;0
7732;26336;829;63;29;3;26;.897;3600000;0
7732;57657;838;0;0;0;0;.00nan;0;0
7732;89874;829;0;0;0;0;.00nan;0;0
7733;5663;831;60;22;2;20;.909;3572000;0
7733;183545;842;100;42;1;41;.976;3600000;0
7733;23433;842;0;0;0;0;.00nan;0;0
7733;78094;831;0;0;0;0;.00nan;0;0
7734;180287;847;58;34;4;30;.882;3514000;0
7734;54017;847;0;0;0;0;.00nan;0;0
7734;62975;834;58;21;2;19;.905;3600000;0
7734;147901;834;0;0;0;0;.00nan;0;0
7735;16588;836;0;0;0;0;.00nan;0;0
7735;30431;839;28;34;6;28;.824;3600000;0
7735;182116;836;87;31;1;30;.968;3600000;0
7735;78223;839;0;0;0;0;.00nan;0;0
7736;8501;832;0;0;0;0;.00nan;0;0
7736;167824;828;71;26;2;24;.923;3600000;0
7736;46492;832;90;42;3;39;.929;3592000;0
7736;148041;828;0;0;0;0;.00nan;0;0
7737;165723;837;78;30;2;28;.933;3600000;0
7737;-1;833;0;0;0;0;.00nan;0;0
7737;53867;833;64;42;4;38;.905;3555000;0
7737;89190;837;0;0;0;0;.00nan;0;0
7738;16838;830;63;35;4;31;.886;3736000;0
7738;19322;848;0;0;0;0;.00nan;0;0
7738;47736;848;70;28;3;25;.893;3736000;0
7738;47791;830;0;0;0;0;.00nan;0;0
7739;26336;829;0;0;0;0;.00nan;0;0
7739;30431;839;48;26;4;22;.846;3548000;0
7739;78223;839;0;0;0;0;.00nan;0;0
7739;89874;829;69;28;2;26;.929;3600000;0
7740;16588;836;0;0;0;0;.00nan;0;0
7740;16838;830;97;20;0;20;1.000;3600000;0
7740;182116;836;67;47;5;42;.894;3600000;0
7740;47791;830;0;0;0;0;.00nan;0;0
7741;2410;838;0;0;0;0;.00nan;0;0
7741;57657;838;48;33;5;28;.848;3600000;0
7741;62975;834;94;40;2;38;.950;3600000;0
7741;147901;834;0;0;0;0;.00nan;0;0
7742;5663;831;48;25;4;21;.840;2078000;0
7742;180287;847;52;25;4;21;.840;1892000;0
7742;54017;847;89;23;0;23;1.000;1708000;0
7742;78094;831;41;9;2;7;.778;1466000;0
7743;8501;832;86;32;2;30;.938;3558000;0
7743;-1;833;0;0;0;0;.00nan;0;0
7743;46492;832;0;0;0;0;.00nan;0;0
7743;53867;833;64;11;1;10;.909;3600000;0
7744;167824;828;0;0;0;0;.00nan;0;0
7744;165723;837;98;29;0;29;1.000;3600000;0
7744;89190;837;0;0;0;0;.00nan;0;0
7744;148041;828;81;34;2;32;.941;3522000;0
7745;183545;842;96;51;3;48;.941;3900000;0
7745;19322;848;0;0;0;0;.00nan;0;0
7745;23433;842;0;0;0;0;.00nan;0;0
7745;47736;848;59;23;3;20;.870;3900000;0
7746;2410;838;60;21;3;18;.857;3610000;0
7746;-1;833;73;39;4;35;.897;3610000;0
7746;53867;833;0;0;0;0;.00nan;0;0
7746;57657;838;0;0;0;0;.00nan;0;0
7747;16588;836;0;0;0;0;.00nan;0;0
7747;26336;829;45;24;4;20;.833;3559000;0
7747;182116;836;73;30;3;27;.900;3600000;0
7747;89874;829;0;0;0;0;.00nan;0;0
7748;167824;828;100;28;0;28;1.000;3600000;0
7748;62975;834;0;0;0;0;.00nan;0;0
7748;147901;834;81;25;1;24;.960;3557000;0
7748;148041;828;0;0;0;0;.00nan;0;0
7749;183545;842;91;48;3;45;.938;3558000;0
7749;23433;842;0;0;0;0;.00nan;0;0
7749;180287;847;58;20;2;18;.900;3600000;0
7749;54017;847;0;0;0;0;.00nan;0;0
7750;8501;832;0;0;0;0;.00nan;0;0
7750;165723;837;100;22;0;22;1.000;3600000;0
7750;46492;832;72;22;1;21;.955;3544000;0
7750;89190;837;0;0;0;0;.00nan;0;0
7751;16838;830;93;31;2;29;.935;3600000;0
7751;30431;839;0;0;0;0;.00nan;0;0
7751;47791;830;0;0;0;0;.00nan;0;0
7751;78223;839;48;26;4;22;.846;3600000;0
7752;5663;831;0;0;0;0;.00nan;0;0
7752;19322;848;0;0;0;0;.00nan;0;0
7752;47736;848;69;26;2;24;.923;3600000;0
7752;78094;831;59;24;3;21;.875;3564000;0
7753;2410;838;0;0;0;0;.00nan;0;0
7753;19322;848;0;0;0;0;.00nan;0;0
7753;47736;848;31;24;5;19;.792;3579000;0
7753;57657;838;78;40;3;37;.925;3600000;0
7754;8501;832;0;0;0;0;.00nan;0;0
7754;46492;832;100;46;1;45;.978;3600000;0
7754;62975;834;71;29;2;27;.931;3584000;0
7754;147901;834;0;0;0;0;.00nan;0;0
7755;167824;828;44;28;4;24;.857;3584000;0
7755;183545;842;81;33;2;31;.939;3600000;0
7755;23433;842;0;0;0;0;.00nan;0;0
7755;148041;828;0;0;0;0;.00nan;0;0
7756;165723;837;75;16;1;15;.938;3600000;0
7756;180287;847;67;33;3;30;.909;3529000;0
7756;54017;847;0;0;0;0;.00nan;0;0
7756;89190;837;0;0;0;0;.00nan;0;0
7757;30431;839;68;21;2;19;.905;3600000;0
7757;-1;833;42;12;3;9;.750;1275000;0
7757;53867;833;29;30;6;24;.800;2325000;0
7757;78223;839;0;0;0;0;.00nan;0;0
7758;16838;830;70;18;1;17;.944;3600000;0
7758;26336;829;82;37;2;35;.946;3556000;0
7758;47791;830;0;0;0;0;.00nan;0;0
7758;89874;829;0;0;0;0;.00nan;0;0
7759;5663;831;67;27;2;25;.926;3900000;0
7759;16588;836;0;0;0;0;.00nan;0;0
7759;182116;836;100;44;2;42;.955;3900000;0
7759;78094;831;0;0;0;0;.00nan;0;0
7760;8501;832;59;38;4;34;.895;3524000;0
7760;183545;842;0;0;0;0;.00nan;0;0
7760;23433;842;64;23;2;21;.913;3600000;0
7760;46492;832;0;0;0;0;.00nan;0;0
7761;167824;828;0;0;0;0;.00nan;0;0
7761;180287;847;78;30;2;28;.933;3587000;0
7761;54017;847;0;0;0;0;.00nan;0;0
7761;148041;828;80;15;0;15;1.000;3600000;0
7762;26336;829;64;25;2;23;.920;3600000;0
7762;-1;833;0;0;0;0;.00nan;0;0
7762;53867;833;60;29;3;26;.897;3546000;0
7762;89874;829;0;0;0;0;.00nan;0;0
7763;5663;831;0;0;0;0;.00nan;0;0
7763;62975;834;60;22;2;20;.909;3600000;0
7763;78094;831;57;36;5;31;.861;3600000;0
7763;147901;834;0;0;0;0;.00nan;0;0
7764;19322;848;62;30;3;27;.900;3600000;0
7764;30431;839;0;0;0;0;.00nan;0;0
7764;47736;848;0;0;0;0;.00nan;0;0
7764;78223;839;40;33;6;27;.818;3600000;0
7765;165723;837;70;31;3;28;.903;3548000;0
7765;16838;830;88;32;2;30;.938;3600000;0
7765;47791;830;0;0;0;0;.00nan;0;0
7765;89190;837;0;0;0;0;.00nan;0;0
7766;183545;842;45;32;5;27;.844;3212000;0
7766;23433;842;54;4;0;4;1.000;388000;0
7766;-1;833;0;0;0;0;.00nan;0;0
7766;53867;833;36;43;7;36;.837;3554000;0
7767;30431;839;68;26;2;24;.923;3600000;0
7767;180287;847;56;31;5;26;.839;3600000;0
7767;54017;847;0;0;0;0;.00nan;0;0
7767;78223;839;0;0;0;0;.00nan;0;0
7768;167824;828;0;0;0;0;.00nan;0;0
7768;26336;829;78;33;2;31;.939;3600000;0
7768;89874;829;0;0;0;0;.00nan;0;0
7768;148041;828;43;21;4;17;.810;3553000;0
7769;19322;848;0;0;0;0;.00nan;0;0
7769;47736;848;77;31;2;29;.935;3573000;0
7769;62975;834;77;24;1;23;.958;3600000;0
7769;147901;834;0;0;0;0;.00nan;0;0
7770;2410;838;65;29;3;26;.897;3520000;0
7770;16838;830;0;0;0;0;.00nan;0;0
7770;47791;830;92;31;1;30;.968;3600000;0
7770;57657;838;0;0;0;0;.00nan;0;0
7771;2410;838;0;0;0;0;.00nan;0;0
7771;16838;830;98;32;1;31;.969;3600000;0
7771;47791;830;0;0;0;0;.00nan;0;0
7771;57657;838;81;29;2;27;.931;3550000;0
7772;183545;842;0;0;0;0;.00nan;0;0
7772;23433;842;61;29;3;26;.897;3534000;0
7772;-1;833;100;43;1;42;.977;3600000;0
7772;53867;833;0;0;0;0;.00nan;0;0
7773;30431;839;0;0;0;0;.00nan;0;0
7773;180287;847;51;17;2;15;.882;3600000;0
7773;54017;847;0;0;0;0;.00nan;0;0
7773;78223;839;66;35;3;32;.914;3600000;0
7774;167824;828;80;26;1;25;.962;3600000;0
7774;26336;829;0;0;0;0;.00nan;0;0
7774;89874;829;72;35;3;32;.914;3548000;0
7774;148041;828;0;0;0;0;.00nan;0;0
7775;5663;831;69;26;2;24;.923;3600000;0
7775;8501;832;0;0;0;0;.00nan;0;0
7775;46492;832;98;53;3;50;.943;3578000;0
7775;78094;831;0;0;0;0;.00nan;0;0
7776;5663;831;66;25;3;22;.880;3567000;0
7776;8501;832;87;35;1;34;.971;3600000;0
7776;46492;832;0;0;0;0;.00nan;0;0
7776;78094;831;0;0;0;0;.00nan;0;0
7777;19322;848;74;21;1;20;.952;3732000;0
7777;47736;848;0;0;0;0;.00nan;0;0
7777;62975;834;88;36;2;34;.944;3732000;0
7777;147901;834;0;0;0;0;.00nan;0;0
7778;2410;838;98;25;0;25;1.000;3600000;0
7778;57657;838;0;0;0;0;.00nan;0;0
7778;62975;834;81;28;2;26;.929;3527000;0
7778;147901;834;0;0;0;0;.00nan;0;0
7779;165723;837;58;16;2;14;.875;3600000;0
7779;16588;836;60;6;0;6;1.000;367000;0
7779;182116;836;61;51;7;44;.863;3233000;0
7779;89190;837;0;0;0;0;.00nan;0;0
7780;26336;829;89;38;3;35;.921;3899000;0
7780;30431;839;0;0;0;0;.00nan;0;0
7780;78223;839;97;44;2;42;.955;3899000;0
7780;89874;829;0;0;0;0;.00nan;0;0
7781;183545;842;66;27;3;24;.889;3600000;0
7781;23433;842;0;0;0;0;.00nan;0;0
7781;30431;839;100;31;0;31;1.000;3600000;0
7781;78223;839;0;0;0;0;.00nan;0;0
7782;16588;836;0;0;0;0;.00nan;0;0
7782;180287;847;66;20;2;18;.900;3877000;0
7782;182116;836;90;31;1;30;.968;3877000;0
7782;54017;847;0;0;0;0;.00nan;0;0
7783;8501;832;45;10;2;8;.800;1343000;0
7783;16838;830;49;30;5;25;.833;3600000;0
7783;46492;832;28;24;5;19;.792;2243000;0
7783;47791;830;0;0;0;0;.00nan;0;0
7784;167824;828;100;29;0;29;1.000;3600000;0
7784;19322;848;0;0;0;0;.00nan;0;0
7784;47736;848;70;30;2;28;.933;3552000;0
7784;148041;828;0;0;0;0;.00nan;0;0
7785;26336;829;100;24;0;24;1.000;3600000;0
7785;62975;834;63;44;5;39;.886;3600000;0
7785;89874;829;0;0;0;0;.00nan;0;0
7785;147901;834;0;0;0;0;.00nan;0;0
7786;2410;838;40;35;6;29;.829;2780000;0
7786;165723;837;65;44;6;38;.864;3600000;0
7786;57657;838;45;10;2;8;.800;820000;0
7786;89190;837;0;0;0;0;.00nan;0;0
7787;5663;831;84;15;0;15;1.000;3600000;0
7787;-1;833;0;0;0;0;.00nan;0;0
7787;53867;833;90;56;4;52;.929;3600000;0
7787;78094;831;0;0;0;0;.00nan;0;0
7788;2410;838;0;0;0;0;.00nan;0;0
7788;8501;832;0;0;0;0;.00nan;0;0
7788;46492;832;55;38;5;33;.868;3600000;0
7788;57657;838;97;24;0;24;1.000;3600000;0
7789;167824;828;65;18;2;16;.889;3827000;0
7789;16588;836;0;0;0;0;.00nan;0;0
7789;182116;836;81;40;3;37;.925;3827000;0
7789;148041;828;0;0;0;0;.00nan;0;0
7790;165723;837;100;28;0;28;1.000;3600000;0
7790;30431;839;35;23;4;19;.826;3600000;0
7790;78223;839;0;0;0;0;.00nan;0;0
7790;89190;837;0;0;0;0;.00nan;0;0
7791;19322;848;100;36;1;35;.972;3900000;0
7791;180287;847;96;36;1;35;.972;3900000;0
7791;47736;848;0;0;0;0;.00nan;0;0
7791;54017;847;0;0;0;0;.00nan;0;0
7792;5663;831;50;19;3;16;.842;3600000;0
7792;26336;829;82;48;4;44;.917;3545000;0
7792;78094;831;0;0;0;0;.00nan;0;0
7792;89874;829;0;0;0;0;.00nan;0;0
7793;183545;842;0;0;0;0;.00nan;0;0
7793;16838;830;93;21;0;21;1.000;3600000;0
7793;23433;842;61;30;3;27;.900;3600000;0
7793;47791;830;0;0;0;0;.00nan;0;0
7794;-1;833;0;0;0;0;.00nan;0;0
7794;53867;833;75;45;4;41;.911;3562000;0
7794;62975;834;62;29;3;26;.897;3600000;0
7794;147901;834;0;0;0;0;.00nan;0;0
7795;2410;838;0;0;0;0;.00nan;0;0
7795;183545;842;55;26;3;23;.885;3600000;0
7795;23433;842;0;0;0;0;.00nan;0;0
7795;57657;838;59;36;5;31;.861;3515000;0
7796;-1;833;0;0;0;0;.00nan;0;0
7796;180287;847;76;22;1;21;.955;3600000;0
7796;53867;833;54;28;3;25;.893;3531000;0
7796;54017;847;0;0;0;0;.00nan;0;0
7797;8501;832;0;0;0;0;.00nan;0;0
7797;26336;829;70;23;1;22;.957;3665000;0
7797;46492;832;72;23;2;21;.913;3665000;0
7797;89874;829;0;0;0;0;.00nan;0;0
7798;167824;828;0;0;0;0;.00nan;0;0
7798;16838;830;67;44;5;39;.886;3600000;0
7798;47791;830;0;0;0;0;.00nan;0;0
7798;148041;828;67;29;3;26;.897;3600000;0
7799;16588;836;0;0;0;0;.00nan;0;0
7799;182116;836;53;33;5;28;.848;3600000;0
7799;62975;834;66;26;3;23;.885;3600000;0
7799;147901;834;0;0;0;0;.00nan;0;0
7800;165723;837;46;24;4;20;.833;3600000;0
7800;19322;848;40;36;6;30;.833;3581000;0
7800;47736;848;0;0;0;0;.00nan;0;0
7800;89190;837;0;0;0;0;.00nan;0;0
7801;5663;831;66;18;2;16;.889;3600000;0
7801;30431;839;50;19;2;17;.895;2869000;0
7801;78094;831;0;0;0;0;.00nan;0;0
7801;78223;839;30;16;4;12;.750;731000;0
7802;183545;842;79;26;2;24;.923;3600000;0
7802;23433;842;0;0;0;0;.00nan;0;0
7802;62975;834;72;47;5;42;.894;3600000;0
7802;147901;834;0;0;0;0;.00nan;0;0
7803;8501;832;0;0;0;0;.00nan;0;0
7803;180287;847;82;35;2;33;.943;3900000;0
7803;46492;832;84;33;2;31;.939;3900000;0
7803;54017;847;0;0;0;0;.00nan;0;0
7804;5663;831;57;10;1;9;.900;3600000;0
7804;167824;828;25;6;3;3;.500;343000;0
7804;78094;831;0;0;0;0;.00nan;0;0
7804;148041;828;93;42;2;40;.952;3257000;0
7805;16838;830;57;25;3;22;.880;3600000;0
7805;-1;833;0;0;0;0;.00nan;0;0
7805;47791;830;0;0;0;0;.00nan;0;0
7805;53867;833;68;39;5;34;.872;3571000;0
7806;165723;837;65;33;3;30;.909;3597000;0
7806;-1;833;91;36;2;34;.944;3600000;0
7806;53867;833;0;0;0;0;.00nan;0;0
7806;89190;837;0;0;0;0;.00nan;0;0
7807;8501;832;84;37;1;36;.973;3900000;0
7807;167824;828;68;17;1;16;.941;3900000;0
7807;46492;832;0;0;0;0;.00nan;0;0
7807;148041;828;0;0;0;0;.00nan;0;0
7808;180287;847;52;19;2;17;.895;1706000;0
7808;54017;847;7;15;6;9;.600;1894000;0
7808;62975;834;0;0;0;0;.00nan;0;0
7808;147901;834;75;31;2;29;.935;3600000;0
7809;16588;836;0;0;0;0;.00nan;0;0
7809;30431;839;91;26;1;25;.962;3600000;0
7809;182116;836;32;30;6;24;.800;3600000;0
7809;78223;839;0;0;0;0;.00nan;0;0
7810;13715;848;0;0;0;0;.00nan;0;0
7810;16838;830;53;33;4;29;.879;3556000;0
7810;47736;848;63;18;2;16;.889;3600000;0
7810;47791;830;0;0;0;0;.00nan;0;0
7811;2410;838;48;39;6;33;.846;3355000;0
7811;26336;829;90;29;1;28;.966;3600000;0
7811;57657;838;39;1;1;0;.000;245000;0
7811;89874;829;0;0;0;0;.00nan;0;0
7812;2410;838;0;0;0;0;.00nan;0;0
7812;30431;839;58;27;4;23;.852;3900000;0
7812;57657;838;46;31;4;27;.871;3900000;0
7812;78223;839;0;0;0;0;.00nan;0;0
7813;13715;848;52;38;5;33;.868;3600000;0
7813;16588;836;64;15;1;14;.933;3600000;0
7813;182116;836;0;0;0;0;.00nan;0;0
7813;47736;848;0;0;0;0;.00nan;0;0
7814;5663;831;50;24;4;20;.833;3513000;0
7814;183545;842;0;0;0;0;.00nan;0;0
7814;23433;842;100;46;2;44;.957;3600000;0
7814;78094;831;0;0;0;0;.00nan;0;0
7815;2410;838;84;37;2;35;.946;3900000;0
7815;26336;829;93;42;2;40;.952;3900000;0
7815;57657;838;0;0;0;0;.00nan;0;0
7815;89874;829;0;0;0;0;.00nan;0;0
7816;16588;836;50;13;2;11;.846;1528000;0
7816;-1;830;0;0;0;0;.00nan;0;0
7816;182116;836;22;22;6;16;.727;2072000;0
7816;47791;830;53;26;4;22;.846;3600000;0
7817;165723;837;68;19;2;17;.895;3600000;0
7817;-1;833;0;0;0;0;.00nan;0;0
7817;53867;833;50;29;4;25;.862;3560000;0
7817;89190;837;0;0;0;0;.00nan;0;0
7818;16588;836;0;0;0;0;.00nan;0;0
7818;26336;829;100;34;1;33;.971;3900000;0
7818;182116;836;93;39;1;38;.974;3900000;0
7818;89874;829;0;0;0;0;.00nan;0;0
7819;167824;828;0;0;0;0;.00nan;0;0
7819;-1;830;0;0;0;0;.00nan;0;0
7819;47791;830;67;15;1;14;.933;3600000;0
7819;148041;828;81;32;2;30;.938;3552000;0
7820;183545;842;64;34;4;30;.882;3600000;0
7820;13715;848;0;0;0;0;.00nan;0;0
7820;23433;842;0;0;0;0;.00nan;0;0
7820;47736;848;94;31;1;30;.968;3600000;0
7821;8501;832;0;0;0;0;.00nan;0;0
7821;-1;833;0;0;0;0;.00nan;0;0
7821;46492;832;86;26;2;24;.923;3900000;0
7821;53867;833;93;41;2;39;.951;3900000;0
7822;2410;838;100;29;0;29;1.000;3600000;0
7822;57657;838;0;0;0;0;.00nan;0;0
7822;62975;834;47;29;5;24;.828;3600000;0
7822;147901;834;0;0;0;0;.00nan;0;0
7823;180287;847;82;36;3;33;.917;3585000;0
7823;48141;831;0;0;0;0;.00nan;0;0
7823;78094;831;51;14;2;12;.857;3600000;0
7823;147977;847;0;0;0;0;.00nan;0;0
7824;2410;838;67;22;2;20;.909;3600000;0
7824;-1;833;46;35;5;30;.857;3600000;0
7824;53867;833;0;0;0;0;.00nan;0;0
7824;57657;838;0;0;0;0;.00nan;0;0
7825;183545;842;0;0;0;0;.00nan;0;0
7825;23433;842;64;27;2;25;.926;3600000;0
7825;180287;847;52;34;4;30;.882;3527000;0
7825;54017;847;0;0;0;0;.00nan;0;0
7826;8501;832;0;0;0;0;.00nan;0;0
7826;165723;837;59;19;2;17;.895;3600000;0
7826;46492;832;35;47;8;39;.830;3600000;0
7826;89190;837;0;0;0;0;.00nan;0;0
7827;167824;828;74;30;2;28;.933;3600000;0
7827;62975;834;44;18;3;15;.833;3600000;0
7827;147901;834;0;0;0;0;.00nan;0;0
7827;148041;828;0;0;0;0;.00nan;0;0
7828;5663;831;62;29;3;26;.897;3600000;0
7828;13715;848;24;26;6;20;.769;2704000;0
7828;47736;848;45;6;1;5;.833;896000;0
7828;78094;831;0;0;0;0;.00nan;0;0
7829;16838;830;73;18;1;17;.944;3600000;0
7829;30431;839;95;40;2;38;.950;3581000;0
7829;47791;830;0;0;0;0;.00nan;0;0
7829;78223;839;0;0;0;0;.00nan;0;0
7830;165723;837;60;22;2;20;.909;3600000;0
7830;16588;836;0;0;0;0;.00nan;0;0
7830;182116;836;69;41;5;36;.878;3600000;0
7830;89190;837;0;0;0;0;.00nan;0;0
7831;2410;838;75;21;1;20;.952;3600000;0
7831;183545;842;0;0;0;0;.00nan;0;0
7831;23433;842;59;26;2;24;.923;3600000;0
7831;57657;838;0;0;0;0;.00nan;0;0
7832;2410;838;65;24;2;22;.917;3557000;0
7832;5663;831;100;34;1;33;.971;3600000;0
7832;57657;838;0;0;0;0;.00nan;0;0
7832;78094;831;0;0;0;0;.00nan;0;0
7833;167824;828;0;0;0;0;.00nan;0;0
7833;-1;833;0;0;0;0;.00nan;0;0
7833;53867;833;84;24;0;24;1.000;3900000;0
7833;148041;828;100;30;0;30;1.000;3900000;0
7834;8501;832;0;0;0;0;.00nan;0;0
7834;16588;836;0;0;0;0;.00nan;0;0
7834;182116;836;68;25;2;23;.920;3900000;0
7834;46492;832;97;42;2;40;.952;3900000;0
7835;183545;842;53;44;6;38;.864;3247000;0
7835;165723;837;82;41;4;37;.902;3600000;0
7835;23433;842;47;5;1;4;.800;353000;0
7835;89190;837;0;0;0;0;.00nan;0;0
7836;30431;839;13;15;5;10;.667;2243000;0
7836;62975;834;98;22;0;22;1.000;3600000;0
7836;78223;839;71;12;0;12;1.000;1357000;0
7836;147901;834;0;0;0;0;.00nan;0;0
7837;16838;830;53;17;2;15;.882;3600000;0
7837;180287;847;38;35;6;29;.829;3119000;0
7837;47791;830;0;0;0;0;.00nan;0;0
7837;54017;847;53;2;0;2;1.000;481000;0
7838;183545;842;0;0;0;0;.00nan;0;0
7838;16588;836;0;0;0;0;.00nan;0;0
7838;23433;842;31;25;5;20;.800;3824000;0
7838;182116;836;21;21;6;15;.714;3824000;0
7839;26336;829;87;38;2;36;.947;3600000;0
7839;180287;847;0;0;0;0;.00nan;0;0
7839;54017;847;73;24;1;23;.958;3600000;0
7839;89874;829;0;0;0;0;.00nan;0;0
7840;8501;832;0;0;0;0;.00nan;0;0
7840;30431;839;74;36;3;33;.917;3548000;0
7840;46492;832;86;31;2;29;.935;3600000;0
7840;78223;839;0;0;0;0;.00nan;0;0
7841;2410;838;85;25;1;24;.960;3900000;0
7841;167824;828;0;0;0;0;.00nan;0;0
7841;57657;838;0;0;0;0;.00nan;0;0
7841;148041;828;100;56;1;55;.982;3900000;0
7842;13715;848;0;0;0;0;.00nan;0;0
7842;-1;833;0;0;0;0;.00nan;0;0
7842;47736;848;45;21;4;17;.810;3640000;0
7842;53867;833;74;29;3;26;.897;3629000;0
7843;5663;831;0;0;0;0;.00nan;0;0
7843;165723;837;77;35;3;32;.914;3600000;0
7843;78094;831;54;29;5;24;.828;3513000;0
7843;89190;837;0;0;0;0;.00nan;0;0
7844;16838;830;53;36;5;31;.861;3600000;0
7844;47791;830;0;0;0;0;.00nan;0;0
7844;62975;834;81;32;2;30;.938;3600000;0
7844;147901;834;0;0;0;0;.00nan;0;0
7845;13715;848;23;15;4;11;.733;1083000;0
7845;26336;829;0;0;0;0;.00nan;0;0
7845;47736;848;81;24;1;23;.958;2517000;0
7845;89874;829;77;27;1;26;.963;3600000;0
7846;2410;838;90;35;2;33;.943;3570000;0
7846;16588;836;0;0;0;0;.00nan;0;0
7846;182116;836;94;28;1;27;.964;3600000;0
7846;57657;838;0;0;0;0;.00nan;0;0
7847;165723;837;48;32;4;28;.875;3557000;0
7847;26336;829;57;27;3;24;.889;3600000;0
7847;89190;837;0;0;0;0;.00nan;0;0
7847;89874;829;0;0;0;0;.00nan;0;0
7848;2410;838;100;36;1;35;.972;3600000;0
7848;180287;847;67;32;3;29;.906;3546000;0
7848;54017;847;0;0;0;0;.00nan;0;0
7848;57657;838;0;0;0;0;.00nan;0;0
7849;16588;836;0;0;0;0;.00nan;0;0
7849;-1;833;0;0;0;0;.00nan;0;0
7849;182116;836;100;42;1;41;.976;3600000;0
7849;53867;833;60;18;2;16;.889;3544000;0
7850;8501;832;0;0;0;0;.00nan;0;0
7850;13715;848;0;0;0;0;.00nan;0;0
7850;46492;832;53;31;4;27;.871;3584000;0
7850;47736;848;65;22;2;20;.909;3600000;0
7851;167824;828;81;42;3;39;.929;3900000;0
7851;30431;839;54;18;3;15;.833;3900000;0
7851;78223;839;0;0;0;0;.00nan;0;0
7851;148041;828;0;0;0;0;.00nan;0;0
7852;183545;842;74;30;2;28;.933;3699000;0
7852;23433;842;0;0;0;0;.00nan;0;0
7852;26336;829;88;36;3;33;.917;3699000;0
7852;89874;829;0;0;0;0;.00nan;0;0
7853;5663;831;82;28;3;25;.893;3667000;0
7853;16838;830;78;40;4;36;.900;3667000;0
7853;47791;830;0;0;0;0;.00nan;0;0
7853;78094;831;0;0;0;0;.00nan;0;0
7854;167824;828;53;5;0;5;1.000;640000;0
7854;183545;842;60;31;4;27;.871;3600000;0
7854;23433;842;0;0;0;0;.00nan;0;0
7854;148041;828;30;32;7;25;.781;2960000;0
7855;165723;837;46;18;3;15;.833;3561000;0
7855;180287;847;75;32;2;30;.938;3600000;0
7855;54017;847;0;0;0;0;.00nan;0;0
7855;89190;837;0;0;0;0;.00nan;0;0
7856;30431;839;73;24;1;23;.958;3600000;0
7856;-1;833;87;31;2;29;.935;3600000;0
7856;53867;833;0;0;0;0;.00nan;0;0
7856;78223;839;0;0;0;0;.00nan;0;0
7857;5663;831;66;29;3;26;.897;3600000;0
7857;16588;836;45;7;1;6;.857;675000;0
7857;182116;836;44;41;7;34;.829;2925000;0
7857;78094;831;0;0;0;0;.00nan;0;0
7858;8501;832;0;0;0;0;.00nan;0;0
7858;46492;832;79;33;2;31;.939;3900000;0
7858;62975;834;78;27;2;25;.926;3900000;0
7858;147901;834;0;0;0;0;.00nan;0;0
7859;2410;838;0;0;0;0;.00nan;0;0
7859;13715;848;0;0;0;0;.00nan;0;0
7859;47736;848;51;26;4;22;.846;3600000;0
7859;57657;838;60;48;5;43;.896;3564000;0
7860;16838;830;86;31;2;29;.935;3600000;0
7860;26336;829;85;42;4;38;.905;3588000;0
7860;47791;830;0;0;0;0;.00nan;0;0
7860;89874;829;0;0;0;0;.00nan;0;0
7861;2410;838;29;7;3;4;.571;521000;0
7861;16588;836;53;10;1;9;.900;820000;0
7861;182116;836;46;39;6;33;.846;2694000;0
7861;57657;838;50;18;2;16;.889;3079000;0
7862;8501;832;0;0;0;0;.00nan;0;0
7862;183545;842;0;0;0;0;.00nan;0;0
7862;23433;842;72;37;3;34;.919;3600000;0
7862;46492;832;59;35;4;31;.886;3581000;0
7863;167824;828;82;19;0;19;1.000;3600000;0
7863;180287;847;90;35;2;33;.943;3534000;0
7863;54017;847;0;0;0;0;.00nan;0;0
7863;148041;828;0;0;0;0;.00nan;0;0
7864;165723;837;76;29;2;27;.931;3900000;0
7864;16838;830;77;33;2;31;.939;3900000;0
7864;47791;830;0;0;0;0;.00nan;0;0
7864;89190;837;0;0;0;0;.00nan;0;0
7865;13715;848;0;0;0;0;.00nan;0;0
7865;30431;839;0;0;0;0;.00nan;0;0
7865;47736;848;45;25;4;21;.840;3890000;0
7865;78223;839;59;28;3;25;.893;3890000;0
7866;26336;829;63;21;2;19;.905;3600000;0
7866;-1;833;0;0;0;0;.00nan;0;0
7866;53867;833;54;30;3;27;.900;3567000;0
7866;89874;829;0;0;0;0;.00nan;0;0
7867;5663;831;91;32;1;31;.969;3600000;0
7867;62975;834;65;50;6;44;.880;3356000;0
7867;78094;831;0;0;0;0;.00nan;0;0
7867;147901;834;51;2;0;2;1.000;244000;0
7869;26336;829;71;29;3;26;.897;3554000;0
7869;30431;839;0;0;0;0;.00nan;0;0
7869;78223;839;86;30;1;29;.967;3600000;0
7869;89874;829;0;0;0;0;.00nan;0;0
7871;165723;837;49;30;4;26;.867;3900000;0
7871;180287;847;78;36;4;32;.889;3900000;0
7871;54017;847;0;0;0;0;.00nan;0;0
7871;89190;837;0;0;0;0;.00nan;0;0
7873;8501;832;0;0;0;0;.00nan;0;0
7873;183545;842;0;0;0;0;.00nan;0;0
7873;23433;842;82;27;1;26;.963;3600000;0
7873;46492;832;77;27;2;25;.926;3549000;0
7875;16838;830;72;36;3;33;.917;3600000;0
7875;47791;830;0;0;0;0;.00nan;0;0
7875;62975;834;78;29;2;27;.931;3600000;0
7875;147901;834;0;0;0;0;.00nan;0;0
7877;2410;838;33;28;5;23;.821;3600000;0
7877;16588;836;0;0;0;0;.00nan;0;0
7877;182116;836;85;36;2;34;.944;3600000;0
7877;57657;838;0;0;0;0;.00nan;0;0
7879;5663;831;72;26;2;24;.923;3600000;0
7879;167824;828;73;34;3;31;.912;3576000;0
7879;78094;831;0;0;0;0;.00nan;0;0
7879;148041;828;0;0;0;0;.00nan;0;0
7881;19322;848;71;26;2;24;.923;3600000;0
7881;-1;833;0;0;0;0;.00nan;0;0
7881;47736;848;0;0;0;0;.00nan;0;0
7881;53867;833;74;41;4;37;.902;3585000;0
7885;2410;838;0;0;0;0;.00nan;0;0
7885;5663;831;0;0;0;0;.00nan;0;0
7885;57657;838;100;27;0;27;1.000;3600000;0
7885;78094;831;66;17;1;16;.941;3543000;0
7889;16588;836;78;38;3;35;.921;3600000;0
7889;30431;839;81;25;1;24;.960;3600000;0
7889;182116;836;0;0;0;0;.00nan;0;0
7889;78223;839;0;0;0;0;.00nan;0;0
7893;19322;848;0;0;0;0;.00nan;0;0
7893;26336;829;0;0;0;0;.00nan;0;0
7893;47736;848;82;44;3;41;.932;3900000;0
7893;89874;829;73;35;3;32;.914;3900000;0
7895;167824;828;0;0;0;0;.00nan;0;0
7895;-1;833;73;30;3;27;.900;3545000;0
7895;53867;833;0;0;0;0;.00nan;0;0
7895;148041;828;70;28;2;26;.929;3600000;0
7897;167824;828;41;24;4;20;.833;3573000;0
7897;-1;833;0;0;0;0;.00nan;0;0
7897;53867;833;81;39;3;36;.923;3600000;0
7897;148041;828;0;0;0;0;.00nan;0;0
7899;5663;831;0;0;0;0;.00nan;0;0
7899;183545;842;0;0;0;0;.00nan;0;0
7899;23433;842;88;39;1;38;.974;3600000;0
7899;78094;831;100;22;0;22;1.000;3600000;0
7901;19322;848;70;26;2;24;.923;3900000;0
7901;26336;829;0;0;0;0;.00nan;0;0
7901;47736;848;0;0;0;0;.00nan;0;0
7901;89874;829;89;35;2;33;.943;3900000;0
7905;30431;839;0;0;0;0;.00nan;0;0
7905;180287;847;53;32;6;26;.813;3037000;0
7905;54017;847;59;7;0;7;1.000;563000;0
7905;78223;839;47;21;3;18;.857;3600000;0
7909;2410;838;0;0;0;0;.00nan;0;0
7909;8501;832;0;0;0;0;.00nan;0;0
7909;46492;832;72;28;2;26;.929;3545000;0
7909;57657;838;100;40;1;39;.975;3600000;0
7913;8501;832;83;36;3;33;.917;3589000;0
7913;16588;836;0;0;0;0;.00nan;0;0
7913;182116;836;82;36;2;34;.944;3600000;0
7913;46492;832;0;0;0;0;.00nan;0;0
7917;5663;831;0;0;0;0;.00nan;0;0
7917;183545;842;78;49;5;44;.898;3600000;0
7917;23433;842;0;0;0;0;.00nan;0;0
7917;78094;831;53;19;2;17;.895;3600000;0
7921;167824;828;0;0;0;0;.00nan;0;0
7921;19322;848;0;0;0;0;.00nan;0;0
7921;47736;848;83;40;2;38;.950;3900000;0
7921;148041;828;59;22;2;20;.909;3900000;0
7923;26336;829;74;21;1;20;.952;3900000;0
7923;180287;847;0;0;0;0;.00nan;0;0
7923;54017;847;89;31;1;30;.968;3900000;0
7923;89874;829;0;0;0;0;.00nan;0;0
7927;8501;832;67;19;1;18;.947;2639000;0
7927;19322;848;78;33;2;31;.939;3600000;0
7927;46492;832;33;16;4;12;.750;961000;0
7927;47736;848;0;0;0;0;.00nan;0;0
7929;16588;836;0;0;0;0;.00nan;0;0
7929;26336;829;0;0;0;0;.00nan;0;0
7929;182116;836;52;45;6;39;.867;3600000;0
7929;89874;829;77;23;1;22;.957;3600000;0
7931;2410;838;97;48;2;46;.958;3600000;0
7931;5663;831;25;28;6;22;.786;3600000;0
7931;57657;838;0;0;0;0;.00nan;0;0
7931;78094;831;0;0;0;0;.00nan;0;0
7935;167824;828;0;0;0;0;.00nan;0;0
7935;-1;833;0;0;0;0;.00nan;0;0
7935;53867;833;60;32;4;28;.875;3600000;0
7935;148041;828;75;27;1;26;.963;3600000;0
7941;5663;831;0;0;0;0;.00nan;0;0
7941;167824;828;0;0;0;0;.00nan;0;0
7941;78094;831;67;13;1;12;.923;3600000;0
7941;148041;828;55;35;4;31;.886;3600000;0
7943;183545;842;0;0;0;0;.00nan;0;0
7943;16588;836;0;0;0;0;.00nan;0;0
7943;23433;842;85;38;2;36;.947;3574000;0
7943;182116;836;82;25;1;24;.960;3600000;0
7947;26336;829;0;0;0;0;.00nan;0;0
7947;-1;833;0;0;0;0;.00nan;0;0
7947;53867;833;97;40;0;40;1.000;3900000;0
7947;89874;829;96;22;0;22;1.000;3900000;0
7951;8501;832;0;0;0;0;.00nan;0;0
7951;19322;848;57;38;5;33;.868;3713000;0
7951;46492;832;62;41;6;35;.854;3713000;0
7951;47736;848;0;0;0;0;.00nan;0;0
7957;2410;838;100;24;0;24;1.000;3600000;0
7957;8501;832;76;47;4;43;.915;3600000;0
7957;46492;832;0;0;0;0;.00nan;0;0
7957;57657;838;0;0;0;0;.00nan;0;0
7961;183545;842;68;39;4;35;.897;3600000;0
7961;23433;842;0;0;0;0;.00nan;0;0
7961;30431;839;51;35;5;30;.857;3600000;0
7961;78223;839;0;0;0;0;.00nan;0;0
7963;16588;836;66;23;2;21;.913;3600000;0
7963;19322;848;0;0;0;0;.00nan;0;0
7963;182116;836;0;0;0;0;.00nan;0;0
7963;47736;848;49;29;5;24;.828;3600000;0
7965;5663;831;63;33;4;29;.879;3570000;0
7965;-1;833;0;0;0;0;.00nan;0;0
7965;53867;833;90;36;2;34;.944;3600000;0
7965;78094;831;0;0;0;0;.00nan;0;0
713;2410;838;70;20;1;19;.950;3600000;0
713;13715;848;0;0;0;0;.00nan;0;0
713;47736;848;45;35;5;30;.857;3600000;0
713;57657;838;0;0;0;0;.00nan;0;0
714;30431;839;64;28;3;25;.893;3600000;0
714;180287;847;100;30;0;30;1.000;3600000;0
714;54017;847;0;0;0;0;.00nan;0;0
714;78223;839;0;0;0;0;.00nan;0;0
715;2410;838;90;40;4;36;.900;4202000;0
715;13715;848;0;0;0;0;.00nan;0;0
715;47736;848;52;26;3;23;.885;4202000;0
715;57657;838;0;0;0;0;.00nan;0;0
716;30431;839;81;38;3;35;.921;3568000;0
716;180287;847;88;32;2;30;.938;3600000;0
716;54017;847;0;0;0;0;.00nan;0;0
716;78223;839;0;0;0;0;.00nan;0;0
746;2410;838;84;35;3;32;.914;3600000;0
746;13715;848;0;0;0;0;.00nan;0;0
746;47736;848;41;31;5;26;.839;3583000;0
746;57657;838;0;0;0;0;.00nan;0;0
812;13715;848;0;0;0;0;.00nan;0;0
812;180287;847;81;26;1;25;.962;3600000;0
812;47736;848;97;40;2;38;.950;3573000;0
812;54017;847;0;0;0;0;.00nan;0;0
813;13715;848;0;0;0;0;.00nan;0;0
813;180287;847;73;45;5;40;.889;3874000;0
813;47736;848;60;32;4;28;.875;3859000;0
813;54017;847;0;0;0;0;.00nan;0;0
1009;13715;848;0;0;0;0;.00nan;0;0
1009;180287;847;73;37;3;34;.919;4091000;0
1009;47736;848;74;30;2;28;.933;4091000;0
1009;54017;847;0;0;0;0;.00nan;0;0
1093;13715;848;0;0;0;0;.00nan;0;0
1093;165723;837;72;19;1;18;.947;3600000;0
1093;47736;848;83;35;2;33;.943;3552000;0
1093;89190;837;0;0;0;0;.00nan;0;0
1094;167824;828;0;0;0;0;.00nan;0;0
1094;16838;830;39;31;5;26;.839;3532000;0
1094;47791;830;0;0;0;0;.00nan;0;0
1094;148041;828;76;29;3;26;.897;3600000;0
1095;26336;829;67;27;2;25;.926;3600000;0
1095;62975;834;18;17;5;12;.706;1949000;0
1095;89874;829;0;0;0;0;.00nan;0;0
1095;147901;834;80;21;0;21;1.000;1651000;0
1096;2410;838;98;44;1;43;.977;3562000;0
1096;5663;831;100;23;0;23;1.000;3600000;0
1096;57657;838;0;0;0;0;.00nan;0;0
1096;78094;831;0;0;0;0;.00nan;0;0
1097;13715;848;0;0;0;0;.00nan;0;0
1097;165723;837;84;23;1;22;.957;3600000;0
1097;47736;848;79;33;2;31;.939;3598000;0
1097;89190;837;0;0;0;0;.00nan;0;0
1098;167824;828;67;41;4;37;.902;3562000;0
1098;16838;830;56;22;3;19;.864;3600000;0
1098;47791;830;0;0;0;0;.00nan;0;0
1098;148041;828;0;0;0;0;.00nan;0;0
1099;26336;829;97;33;1;32;.970;3600000;0
1099;62975;834;42;27;4;23;.852;3600000;0
1099;89874;829;0;0;0;0;.00nan;0;0
1099;147901;834;0;0;0;0;.00nan;0;0
1100;2410;838;76;41;4;37;.902;3600000;0
1100;5663;831;74;21;2;19;.905;3600000;0
1100;57657;838;0;0;0;0;.00nan;0;0
1100;78094;831;0;0;0;0;.00nan;0;0
1101;13715;848;0;0;0;0;.00nan;0;0
1101;165723;837;100;20;0;20;1.000;3600000;0
1101;47736;848;72;39;4;35;.897;3600000;0
1101;89190;837;0;0;0;0;.00nan;0;0
1102;167824;828;76;21;1;20;.952;3600000;0
1102;16838;830;76;34;3;31;.912;3521000;0
1102;47791;830;0;0;0;0;.00nan;0;0
1102;148041;828;0;0;0;0;.00nan;0;0
1103;26336;829;66;25;3;22;.880;3600000;0
1103;62975;834;51;30;4;26;.867;3600000;0
1103;89874;829;0;0;0;0;.00nan;0;0
1103;147901;834;0;0;0;0;.00nan;0;0
1104;2410;838;91;30;1;29;.967;3600000;0
1104;5663;831;43;26;5;21;.808;3600000;0
1104;57657;838;0;0;0;0;.00nan;0;0
1104;78094;831;0;0;0;0;.00nan;0;0
1105;13715;848;0;0;0;0;.00nan;0;0
1105;165723;837;100;28;0;28;1.000;3600000;0
1105;47736;848;71;45;5;40;.889;3600000;0
1105;89190;837;0;0;0;0;.00nan;0;0
1106;167824;828;59;33;4;29;.879;3573000;0
1106;16838;830;57;18;2;16;.889;3600000;0
1106;47791;830;0;0;0;0;.00nan;0;0
1106;148041;828;0;0;0;0;.00nan;0;0
1107;26336;829;51;17;2;15;.882;3546000;0
1107;62975;834;100;50;0;50;1.000;3600000;0
1107;89874;829;0;0;0;0;.00nan;0;0
1107;147901;834;0;0;0;0;.00nan;0;0
1108;2410;838;63;23;3;20;.870;3600000;0
1108;5663;831;48;38;6;32;.842;3037000;0
1108;57657;838;0;0;0;0;.00nan;0;0
1108;78094;831;46;4;1;3;.750;563000;0
1354;167824;828;55;38;4;34;.895;3579000;0
1354;16838;830;74;33;2;31;.939;3600000;0
1354;47791;830;0;0;0;0;.00nan;0;0
1354;148041;828;0;0;0;0;.00nan;0;0
1355;26336;829;72;24;2;22;.917;3600000;0
1355;62975;834;98;53;3;50;.943;3542000;0
1355;89874;829;0;0;0;0;.00nan;0;0
1355;147901;834;0;0;0;0;.00nan;0;0
1356;2410;838;100;25;0;25;1.000;3600000;0
1356;5663;831;56;16;2;14;.875;3547000;0
1356;57657;838;0;0;0;0;.00nan;0;0
1356;78094;831;0;0;0;0;.00nan;0;0
1467;167824;828;82;31;1;30;.968;3600000;0
1467;16838;830;73;37;4;33;.892;3600000;0
1467;47791;830;0;0;0;0;.00nan;0;0
1467;148041;828;0;0;0;0;.00nan;0;0
1468;2410;838;100;34;0;34;1.000;3600000;0
1468;5663;831;74;27;1;26;.963;3600000;0
1468;57657;838;0;0;0;0;.00nan;0;0
1468;78094;831;0;0;0;0;.00nan;0;0
1507;167824;828;67;29;3;26;.897;3600000;0
1507;16838;830;29;7;3;4;.571;502000;0
1507;47791;830;72;24;2;22;.917;3098000;0
1507;148041;828;0;0;0;0;.00nan;0;0
1519;2410;838;37;35;6;29;.829;3600000;0
1519;165723;837;100;32;0;32;1.000;3600000;0
1519;57657;838;0;0;0;0;.00nan;0;0
1519;89190;837;0;0;0;0;.00nan;0;0
1520;167824;828;97;53;5;48;.906;3600000;0
1520;26336;829;68;13;1;12;.923;3600000;0
1520;89874;829;0;0;0;0;.00nan;0;0
1520;148041;828;0;0;0;0;.00nan;0;0
1521;2410;838;72;31;2;29;.935;3600000;0
1521;165723;837;66;30;3;27;.900;3550000;0
1521;57657;838;0;0;0;0;.00nan;0;0
1521;89190;837;0;0;0;0;.00nan;0;0
1522;167824;828;95;26;0;26;1.000;3600000;0
1522;26336;829;77;35;3;32;.914;3600000;0
1522;89874;829;0;0;0;0;.00nan;0;0
1522;148041;828;0;0;0;0;.00nan;0;0
1523;2410;838;33;37;7;30;.811;3600000;0
1523;165723;837;100;23;0;23;1.000;3600000;0
1523;57657;838;0;0;0;0;.00nan;0;0
1523;89190;837;0;0;0;0;.00nan;0;0
1524;167824;828;28;14;4;10;.714;1177000;0
1524;26336;829;57;26;3;23;.885;3600000;0
1524;89874;829;0;0;0;0;.00nan;0;0
1524;148041;828;91;29;1;28;.966;2391000;0
1525;2410;838;61;28;2;26;.929;3600000;0
1525;165723;837;89;26;1;25;.962;3600000;0
1525;57657;838;0;0;0;0;.00nan;0;0
1525;89190;837;0;0;0;0;.00nan;0;0
1526;167824;828;0;0;0;0;.00nan;0;0
1526;26336;829;94;38;1;37;.974;3600000;0
1526;89874;829;0;0;0;0;.00nan;0;0
1526;148041;828;79;38;2;36;.947;3600000;0
1761;2410;838;32;10;3;7;.700;361000;0
1761;165723;837;88;34;2;32;.941;3600000;0
1761;57657;838;72;21;1;20;.952;3186000;0
1761;89190;837;0;0;0;0;.00nan;0;0
1762;167824;828;0;0;0;0;.00nan;0;0
1762;26336;829;75;24;2;22;.917;3545000;0
1762;89874;829;0;0;0;0;.00nan;0;0
1762;148041;828;99;46;1;45;.978;3600000;0
1776;167824;828;0;0;0;0;.00nan;0;0
1776;26336;829;66;35;4;31;.886;3672000;0
1776;89874;829;0;0;0;0;.00nan;0;0
1776;148041;828;62;39;5;34;.872;3672000;0
1827;165723;837;100;57;2;55;.965;4560000;0
1827;26336;829;71;30;3;27;.900;4560000;0
1827;89190;837;0;0;0;0;.00nan;0;0
1827;89874;829;0;0;0;0;.00nan;0;0
1828;165723;837;76;23;2;21;.913;3600000;0
1828;26336;829;73;37;3;34;.919;3543000;0
1828;89190;837;0;0;0;0;.00nan;0;0
1828;89874;829;0;0;0;0;.00nan;0;0
7966;190702;3737;100;34;0;34;1.000;3600000;0
7966;192030;3737;0;0;0;0;.00nan;0;0
7966;192036;796;0;0;0;0;.00nan;0;0
7966;149847;796;51;19;3;16;.842;3600000;0
7967;8487;783;57;22;2;20;.909;3900000;0
7967;11490;798;87;35;2;33;.943;3900000;0
7967;201174;798;0;0;0;0;.00nan;0;0
7967;195942;783;0;0;0;0;.00nan;0;0
7968;193854;777;39;20;4;16;.800;3600000;0
7968;-1;776;0;0;0;0;.00nan;0;0
7968;66924;777;0;0;0;0;.00nan;0;0
7968;95405;776;62;40;5;35;.875;3600000;0
7969;8107;780;83;27;1;26;.963;3900000;0
7969;46334;794;0;0;0;0;.00nan;0;0
7969;-1;780;0;0;0;0;.00nan;0;0
7969;62060;794;97;44;1;43;.977;3900000;0
7970;183377;904;27;31;6;25;.806;3134000;0
7970;202497;2182;0;0;0;0;.00nan;0;0
7970;-1;904;49;2;0;2;1.000;466000;0
7970;82273;2182;65;31;3;28;.903;3600000;0
7971;-1;778;0;0;0;0;.00nan;0;0
7971;-1;784;92;36;1;35;.972;3600000;0
7971;-1;784;0;0;0;0;.00nan;0;0
7971;146184;778;73;25;2;23;.920;3580000;0
7972;8487;783;39;23;4;19;.826;3791000;0
7972;195942;783;0;0;0;0;.00nan;0;0
7972;46334;794;0;0;0;0;.00nan;0;0
7972;62060;794;82;45;3;42;.933;3791000;0
7973;202497;2182;0;0;0;0;.00nan;0;0
7973;-1;776;0;0;0;0;.00nan;0;0
7973;82273;2182;78;26;1;25;.962;3600000;0
7973;95405;776;47;22;3;19;.864;3600000;0
7974;192036;796;0;0;0;0;.00nan;0;0
7974;-1;784;70;24;2;22;.917;3600000;0
7974;-1;784;0;0;0;0;.00nan;0;0
7974;149847;796;47;47;6;41;.872;3600000;0
7975;11490;798;56;19;2;17;.895;3560000;0
7975;201174;798;0;0;0;0;.00nan;0;0
7975;190702;3737;68;15;1;14;.933;3600000;0
7975;192030;3737;0;0;0;0;.00nan;0;0
7976;183377;904;99;42;1;41;.976;3600000;0
7976;171673;778;0;0;0;0;.00nan;0;0
7976;-1;904;0;0;0;0;.00nan;0;0
7976;146184;778;28;26;6;20;.769;3600000;0
7977;8107;780;27;28;6;22;.786;2795000;0
7977;193854;777;77;36;4;32;.889;3600000;0
7977;-1;780;63;8;0;8;1.000;773000;0
7977;66924;777;0;0;0;0;.00nan;0;0
7978;183377;904;63;30;3;27;.900;3600000;0
7978;-1;784;79;38;4;34;.895;3586000;0
7978;-1;784;0;0;0;0;.00nan;0;0
7978;-1;904;0;0;0;0;.00nan;0;0
7979;190702;3737;70;21;2;19;.905;3600000;0
7979;192030;3737;0;0;0;0;.00nan;0;0
7979;46334;794;0;0;0;0;.00nan;0;0
7979;62060;794;71;31;3;28;.903;3557000;0
7980;11490;798;58;25;3;22;.880;3600000;0
7980;201174;798;0;0;0;0;.00nan;0;0
7980;192036;796;0;0;0;0;.00nan;0;0
7980;149847;796;97;43;1;42;.977;3600000;0
7981;8487;783;71;35;3;32;.914;3600000;0
7981;193854;777;38;24;5;19;.792;3544000;0
7981;195942;783;0;0;0;0;.00nan;0;0
7981;66924;777;0;0;0;0;.00nan;0;0
7982;8107;780;64;14;1;13;.929;3662000;0
7982;202497;2182;0;0;0;0;.00nan;0;0
7982;-1;780;0;0;0;0;.00nan;0;0
7982;82273;2182;100;33;0;33;1.000;3662000;0
7983;171673;778;57;16;2;14;.875;3600000;0
7983;-1;776;52;17;3;14;.824;2859000;0
7983;95405;776;32;19;4;15;.789;741000;0
7983;146184;778;0;0;0;0;.00nan;0;0
7984;8487;783;64;22;2;20;.909;3600000;0
7984;195942;783;0;0;0;0;.00nan;0;0
7984;202497;2182;0;0;0;0;.00nan;0;0
7984;82273;2182;50;34;4;30;.882;3589000;0
7985;-1;776;70;32;3;29;.906;3900000;0
7985;-1;784;0;0;0;0;.00nan;0;0
7985;-1;784;72;32;3;29;.906;3900000;0
7985;95405;776;0;0;0;0;.00nan;0;0
7986;183377;904;55;26;3;23;.885;3512000;0
7986;192036;796;0;0;0;0;.00nan;0;0
7986;-1;904;0;0;0;0;.00nan;0;0
7986;149847;796;87;32;1;31;.969;3600000;0
7987;193854;777;22;22;6;16;.727;3360000;0
7987;190702;3737;39;42;6;36;.857;3900000;0
7987;192030;3737;0;0;0;0;.00nan;0;0
7987;66924;777;53;1;0;1;1.000;540000;0
7988;8107;780;69;24;2;22;.917;3600000;0
7988;171673;778;64;40;4;36;.900;3517000;0
7988;-1;780;0;0;0;0;.00nan;0;0
7988;146184;778;0;0;0;0;.00nan;0;0
7989;11490;798;74;25;1;24;.960;3600000;0
7989;201174;798;0;0;0;0;.00nan;0;0
7989;46334;794;0;0;0;0;.00nan;0;0
7989;62060;794;27;20;5;15;.750;3600000;0
7990;183377;904;66;28;3;25;.893;3552000;0
7990;-1;776;0;0;0;0;.00nan;0;0
7990;-1;904;0;0;0;0;.00nan;0;0
7990;95405;776;90;38;2;36;.947;3600000;0
7991;193854;777;0;0;0;0;.00nan;0;0
7991;11490;798;69;35;4;31;.886;3573000;0
7991;201174;798;0;0;0;0;.00nan;0;0
7991;66924;777;89;30;2;28;.933;3600000;0
7992;8107;780;87;28;2;26;.929;3600000;0
7992;-1;784;49;33;5;28;.848;3600000;0
7992;-1;784;0;0;0;0;.00nan;0;0
7992;-1;780;0;0;0;0;.00nan;0;0
7993;190702;3737;83;30;2;28;.933;3741000;0
7993;202497;2182;0;0;0;0;.00nan;0;0
7993;192030;3737;0;0;0;0;.00nan;0;0
7993;82273;2182;85;28;1;27;.964;3741000;0
7994;192036;796;0;0;0;0;.00nan;0;0
7994;46334;794;100;29;0;29;1.000;3600000;0
7994;62060;794;0;0;0;0;.00nan;0;0
7994;149847;796;43;29;5;24;.828;3600000;0
7995;8487;783;59;32;4;28;.875;3600000;0
7995;171673;778;53;20;3;17;.850;3600000;0
7995;195942;783;0;0;0;0;.00nan;0;0
7995;146184;778;0;0;0;0;.00nan;0;0
7996;8487;783;42;31;5;26;.839;3600000;0
7996;195942;783;0;0;0;0;.00nan;0;0
7996;-1;784;28;29;6;23;.793;3598000;0
7996;-1;784;0;0;0;0;.00nan;0;0
7997;11490;798;0;0;0;0;.00nan;0;0
7997;201174;798;60;36;5;31;.861;3585000;0
7997;202497;2182;0;0;0;0;.00nan;0;0
7997;82273;2182;58;21;3;18;.857;3600000;0
7998;192036;796;0;0;0;0;.00nan;0;0
7998;-1;776;67;30;3;27;.900;3514000;0
7998;95405;776;0;0;0;0;.00nan;0;0
7998;149847;796;99;44;1;43;.977;3600000;0
7999;171673;778;94;19;0;19;1.000;3600000;0
7999;190702;3737;0;0;0;0;.00nan;0;0
7999;192030;3737;60;36;4;32;.889;3600000;0
7999;146184;778;0;0;0;0;.00nan;0;0
8000;8107;780;0;0;0;0;.00nan;0;0
8000;183377;904;57;42;7;35;.833;3600000;0
8000;-1;780;79;25;2;23;.920;3600000;0
8000;-1;904;0;0;0;0;.00nan;0;0
8001;193854;777;72;24;1;23;.958;3600000;0
8001;46334;794;52;34;5;29;.853;3600000;0
8001;62060;794;0;0;0;0;.00nan;0;0
8001;66924;777;0;0;0;0;.00nan;0;0
8002;8487;783;84;13;0;13;1.000;3600000;0
8002;183377;904;55;49;6;43;.878;3033000;0
8002;195942;783;0;0;0;0;.00nan;0;0
8002;-1;904;49;2;0;2;1.000;567000;0
8003;190702;3737;99;42;1;41;.976;3600000;0
8003;192030;3737;0;0;0;0;.00nan;0;0
8003;-1;784;54;32;4;28;.875;3600000;0
8003;-1;784;0;0;0;0;.00nan;0;0
8004;11490;798;56;36;5;31;.861;3555000;0
8004;171673;778;50;26;4;22;.846;3600000;0
8004;201174;798;0;0;0;0;.00nan;0;0
8004;146184;778;0;0;0;0;.00nan;0;0
8005;193854;777;67;30;3;27;.900;3600000;0
8005;192036;796;58;13;1;12;.923;1599000;0
8005;66924;777;0;0;0;0;.00nan;0;0
8005;149847;796;37;28;5;23;.821;2001000;0
8006;8107;780;79;22;2;20;.909;3900000;0
8006;-1;776;0;0;0;0;.00nan;0;0
8006;-1;780;0;0;0;0;.00nan;0;0
8006;95405;776;92;44;2;42;.955;3900000;0
8007;202497;2182;0;0;0;0;.00nan;0;0
8007;46334;794;0;0;0;0;.00nan;0;0
8007;62060;794;54;26;3;23;.885;3600000;0
8007;82273;2182;46;33;5;28;.848;3576000;0
8008;11490;798;73;29;2;27;.931;3600000;0
8008;201174;798;0;0;0;0;.00nan;0;0
8008;-1;784;56;29;4;25;.862;3540000;0
8008;-1;784;0;0;0;0;.00nan;0;0
8009;193854;777;53;14;2;12;.857;3600000;0
8009;202497;2182;0;0;0;0;.00nan;0;0
8009;66924;777;0;0;0;0;.00nan;0;0
8009;82273;2182;90;34;1;33;.971;3600000;0
8010;8487;783;77;27;2;25;.926;3513000;0
8010;195942;783;0;0;0;0;.00nan;0;0
8010;-1;776;85;19;0;19;1.000;3600000;0
8010;95405;776;0;0;0;0;.00nan;0;0
8011;8107;780;76;23;1;22;.957;3600000;0
8011;192036;796;56;30;4;26;.867;3600000;0
8011;-1;780;0;0;0;0;.00nan;0;0
8011;149847;796;0;0;0;0;.00nan;0;0
8012;183377;904;21;23;6;17;.739;2963000;0
8012;190702;3737;18;7;4;3;.429;890000;0
8012;192030;3737;66;17;1;16;.941;2710000;0
8012;-1;904;37;8;2;6;.750;637000;0
8013;171673;778;71;19;1;18;.947;3689000;0
8013;46334;794;0;0;0;0;.00nan;0;0
8013;62060;794;92;42;2;40;.952;3689000;0
8013;146184;778;0;0;0;0;.00nan;0;0
8014;183377;904;55;4;0;4;1.000;571000;0
8014;11490;798;0;0;0;0;.00nan;0;0
8014;201174;798;56;30;3;27;.900;3600000;0
8014;-1;904;34;32;6;26;.813;3029000;0
8015;8107;780;65;33;4;29;.879;3694000;0
8015;8487;783;69;37;5;32;.865;3694000;0
8015;195942;783;0;0;0;0;.00nan;0;0
8015;-1;780;0;0;0;0;.00nan;0;0
8016;190702;3737;66;25;2;23;.920;3600000;0
8016;192030;3737;0;0;0;0;.00nan;0;0
8016;-1;776;65;36;4;32;.889;3551000;0
8016;95405;776;0;0;0;0;.00nan;0;0
8017;202497;2182;0;0;0;0;.00nan;0;0
8017;192036;796;0;0;0;0;.00nan;0;0
8017;82273;2182;64;17;1;16;.941;3600000;0
8017;149847;796;81;41;3;38;.927;3600000;0
8018;46334;794;0;0;0;0;.00nan;0;0
8018;-1;784;36;29;5;24;.828;3600000;0
8018;-1;784;0;0;0;0;.00nan;0;0
8018;62060;794;66;17;2;15;.882;3600000;0
8019;193854;777;42;34;6;28;.824;3600000;0
8019;171673;778;97;36;1;35;.972;3600000;0
8019;66924;777;0;0;0;0;.00nan;0;0
8019;146184;778;0;0;0;0;.00nan;0;0
8020;11490;798;56;37;4;33;.892;3576000;0
8020;201174;798;0;0;0;0;.00nan;0;0
8020;-1;776;0;0;0;0;.00nan;0;0
8020;95405;776;67;25;2;23;.920;3600000;0
8021;193854;777;99;34;1;33;.971;3600000;0
8021;-1;784;0;0;0;0;.00nan;0;0
8021;-1;784;65;44;5;39;.886;3600000;0
8021;66924;777;0;0;0;0;.00nan;0;0
8022;8487;783;92;38;3;35;.921;3790000;0
8022;195942;783;0;0;0;0;.00nan;0;0
8022;192036;796;0;0;0;0;.00nan;0;0
8022;149847;796;71;29;2;27;.931;3790000;0
8023;8107;780;79;23;1;22;.957;3600000;0
8023;190702;3737;0;0;0;0;.00nan;0;0
8023;192030;3737;66;37;4;33;.892;3600000;0
8023;-1;780;0;0;0;0;.00nan;0;0
8024;171673;778;44;24;4;20;.833;3545000;0
8024;202497;2182;0;0;0;0;.00nan;0;0
8024;82273;2182;61;23;3;20;.870;3600000;0
8024;146184;778;0;0;0;0;.00nan;0;0
8025;183377;904;50;28;4;24;.857;3590000;0
8025;46334;794;77;31;2;29;.935;3600000;0
8025;-1;904;0;0;0;0;.00nan;0;0
8025;62060;794;0;0;0;0;.00nan;0;0
8026;8487;783;29;7;3;4;.571;604000;0
8026;195942;783;69;19;1;18;.947;2996000;0
8026;190702;3737;100;45;1;44;.978;3600000;0
8026;192030;3737;0;0;0;0;.00nan;0;0
8027;193854;777;85;19;0;19;1.000;3600000;0
8027;183377;904;65;37;4;33;.892;3600000;0
8027;-1;904;0;0;0;0;.00nan;0;0
8027;66924;777;0;0;0;0;.00nan;0;0
8028;171673;778;82;26;1;25;.962;3600000;0
8028;192036;796;0;0;0;0;.00nan;0;0
8028;146184;778;0;0;0;0;.00nan;0;0
8028;149847;796;59;21;2;19;.905;3561000;0
8029;-1;776;0;0;0;0;.00nan;0;0
8029;46334;794;0;0;0;0;.00nan;0;0
8029;62060;794;53;48;6;42;.875;3600000;0
8029;95405;776;65;26;3;23;.885;3600000;0
8030;8107;780;85;31;3;28;.903;3600000;0
8030;11490;798;0;0;0;0;.00nan;0;0
8030;201174;798;47;25;4;21;.840;3600000;0
8030;-1;780;0;0;0;0;.00nan;0;0
8031;202497;2182;0;0;0;0;.00nan;0;0
8031;-1;784;19;7;4;3;.429;809000;0
8031;-1;784;80;30;2;28;.933;2791000;0
8031;82273;2182;91;33;1;32;.970;3600000;0
8032;8487;783;79;30;2;28;.933;3600000;0
8032;11490;798;53;32;4;28;.875;3574000;0
8032;201174;798;0;0;0;0;.00nan;0;0
8032;195942;783;0;0;0;0;.00nan;0;0
8033;193854;777;82;24;1;23;.958;3600000;0
8033;-1;776;0;0;0;0;.00nan;0;0
8033;66924;777;0;0;0;0;.00nan;0;0
8033;95405;776;92;58;5;53;.914;3600000;0
8034;190702;3737;42;32;5;27;.844;3593000;0
8034;192030;3737;0;0;0;0;.00nan;0;0
8034;192036;796;0;0;0;0;.00nan;0;0
8034;149847;796;59;27;3;24;.889;3600000;0
8035;183377;904;87;47;4;43;.915;3600000;0
8035;202497;2182;0;0;0;0;.00nan;0;0
8035;-1;904;0;0;0;0;.00nan;0;0
8035;82273;2182;83;23;1;22;.957;3600000;0
8036;8107;780;52;24;4;20;.833;3600000;0
8036;46334;794;0;0;0;0;.00nan;0;0
8036;-1;780;0;0;0;0;.00nan;0;0
8036;62060;794;48;34;5;29;.853;3600000;0
8037;171673;778;0;0;0;0;.00nan;0;0
8037;-1;784;77;30;2;28;.933;3600000;0
8037;-1;784;0;0;0;0;.00nan;0;0
8037;146184;778;51;25;4;21;.840;3557000;0
8038;8487;783;0;0;0;0;.00nan;0;0
8038;195942;783;67;23;2;21;.913;3600000;0
8038;46334;794;0;0;0;0;.00nan;0;0
8038;62060;794;92;46;3;43;.935;3585000;0
8039;11490;798;82;34;2;32;.941;3545000;0
8039;201174;798;0;0;0;0;.00nan;0;0
8039;190702;3737;80;27;1;26;.963;3600000;0
8039;192030;3737;0;0;0;0;.00nan;0;0
8040;192036;796;0;0;0;0;.00nan;0;0
8040;-1;784;0;0;0;0;.00nan;0;0
8040;-1;784;69;31;2;29;.935;3600000;0
8040;149847;796;28;26;5;21;.808;3600000;0
8041;8107;780;60;37;4;33;.892;3573000;0
8041;193854;777;66;27;3;24;.889;3600000;0
8041;-1;780;0;0;0;0;.00nan;0;0
8041;66924;777;0;0;0;0;.00nan;0;0
8042;202497;2182;0;0;0;0;.00nan;0;0
8042;-1;776;0;0;0;0;.00nan;0;0
8042;82273;2182;82;21;1;20;.952;3600000;0
8042;95405;776;34;21;4;17;.810;3600000;0
8043;183377;904;67;29;3;26;.897;3835000;0
8043;171673;778;74;22;2;20;.909;3835000;0
8043;-1;904;0;0;0;0;.00nan;0;0
8043;146184;778;0;0;0;0;.00nan;0;0
8044;8487;783;82;37;3;34;.919;3675000;0
8044;193854;777;49;23;4;19;.826;3675000;0
8044;195942;783;0;0;0;0;.00nan;0;0
8044;66924;777;0;0;0;0;.00nan;0;0
8045;171673;778;69;18;1;17;.944;3600000;0
8045;-1;776;57;27;4;23;.852;3600000;0
8045;95405;776;0;0;0;0;.00nan;0;0
8045;146184;778;0;0;0;0;.00nan;0;0
8046;11490;798;89;19;0;19;1.000;3600000;0
8046;201174;798;0;0;0;0;.00nan;0;0
8046;192036;796;73;31;2;29;.935;3521000;0
8046;149847;796;0;0;0;0;.00nan;0;0
8047;190702;3737;68;25;2;23;.920;3600000;0
8047;192030;3737;0;0;0;0;.00nan;0;0
8047;46334;794;0;0;0;0;.00nan;0;0
8047;62060;794;87;39;3;36;.923;3600000;0
8048;183377;904;69;27;2;25;.926;3600000;0
8048;-1;784;56;28;3;25;.893;3581000;0
8048;-1;784;0;0;0;0;.00nan;0;0
8048;-1;904;0;0;0;0;.00nan;0;0
8049;8107;780;76;23;1;22;.957;3600000;0
8049;202497;2182;0;0;0;0;.00nan;0;0
8049;-1;780;0;0;0;0;.00nan;0;0
8049;82273;2182;63;35;3;32;.914;3522000;0
8050;183377;904;0;0;0;0;.00nan;0;0
8050;192036;796;0;0;0;0;.00nan;0;0
8050;-1;904;59;31;3;28;.903;3581000;0
8050;149847;796;74;30;2;28;.933;3600000;0
8051;11490;798;68;26;3;23;.885;3600000;0
8051;201174;798;0;0;0;0;.00nan;0;0
8051;46334;794;39;1;1;0;.000;392000;0
8051;62060;794;37;46;7;39;.848;3208000;0
8052;193854;777;75;20;1;19;.950;3600000;0
8052;190702;3737;58;52;6;46;.885;3600000;0
8052;192030;3737;0;0;0;0;.00nan;0;0
8052;66924;777;0;0;0;0;.00nan;0;0
8053;-1;776;0;0;0;0;.00nan;0;0
8053;-1;784;82;40;2;38;.950;3600000;0
8053;-1;784;0;0;0;0;.00nan;0;0
8053;95405;776;76;25;1;24;.960;3600000;0
8054;8487;783;77;32;2;30;.938;3600000;0
8054;195942;783;0;0;0;0;.00nan;0;0
8054;202497;2182;0;0;0;0;.00nan;0;0
8054;82273;2182;75;35;3;32;.914;3563000;0
8055;8107;780;98;35;1;34;.971;3579000;0
8055;171673;778;100;47;0;47;1.000;3600000;0
8055;-1;780;0;0;0;0;.00nan;0;0
8055;146184;778;0;0;0;0;.00nan;0;0
8056;8487;783;66;12;1;11;.917;3600000;0
8056;171673;778;61;25;3;22;.880;3516000;0
8056;195942;783;0;0;0;0;.00nan;0;0
8056;146184;778;0;0;0;0;.00nan;0;0
8057;193854;777;66;28;3;25;.893;3600000;0
8057;11490;798;0;0;0;0;.00nan;0;0
8057;201174;798;28;30;6;24;.800;3600000;0
8057;66924;777;0;0;0;0;.00nan;0;0
8058;183377;904;17;21;6;15;.714;2687000;0
8058;-1;776;0;0;0;0;.00nan;0;0
8058;-1;904;64;10;0;10;1.000;913000;0
8058;95405;776;83;17;0;17;1.000;3600000;0
8059;192036;796;0;0;0;0;.00nan;0;0
8059;46334;794;0;0;0;0;.00nan;0;0
8059;62060;794;100;31;0;31;1.000;3600000;0
8059;149847;796;64;31;3;28;.903;3600000;0
8060;8107;780;95;26;1;25;.962;3600000;0
8060;-1;784;83;35;3;32;.914;3511000;0
8060;-1;784;0;0;0;0;.00nan;0;0
8060;-1;780;0;0;0;0;.00nan;0;0
8061;190702;3737;64;42;5;37;.881;3600000;0
8061;202497;2182;0;0;0;0;.00nan;0;0
8061;192030;3737;0;0;0;0;.00nan;0;0
8061;82273;2182;86;16;0;16;1.000;3600000;0
8062;8107;780;97;20;0;20;1.000;3600000;0
8062;183377;904;35;31;6;25;.806;3600000;0
8062;-1;780;0;0;0;0;.00nan;0;0
8062;-1;904;0;0;0;0;.00nan;0;0
8063;8487;783;66;27;2;25;.926;3600000;0
8063;195942;783;0;0;0;0;.00nan;0;0
8063;-1;784;54;24;3;21;.875;3545000;0
8063;-1;784;0;0;0;0;.00nan;0;0
8064;193854;777;100;23;0;23;1.000;3600000;0
8064;46334;794;0;0;0;0;.00nan;0;0
8064;62060;794;93;38;2;36;.947;3534000;0
8064;66924;777;0;0;0;0;.00nan;0;0
8065;192036;796;0;0;0;0;.00nan;0;0
8065;-1;776;0;0;0;0;.00nan;0;0
8065;95405;776;100;40;0;40;1.000;3600000;0
8065;149847;796;81;22;1;21;.955;3544000;0
8066;11490;798;100;44;3;41;.932;3900000;0
8066;201174;798;0;0;0;0;.00nan;0;0
8066;202497;2182;0;0;0;0;.00nan;0;0
8066;82273;2182;47;21;3;18;.857;3900000;0
8067;171673;778;0;0;0;0;.00nan;0;0
8067;190702;3737;72;21;1;20;.952;3600000;0
8067;192030;3737;0;0;0;0;.00nan;0;0
8067;146184;778;93;23;0;23;1.000;3600000;0
8068;8487;783;88;28;1;27;.964;3600000;0
8068;183377;904;75;39;4;35;.897;3600000;0
8068;195942;783;0;0;0;0;.00nan;0;0
8068;-1;904;0;0;0;0;.00nan;0;0
8069;11490;798;72;21;1;20;.952;3600000;0
8069;171673;778;0;0;0;0;.00nan;0;0
8069;201174;798;0;0;0;0;.00nan;0;0
8069;146184;778;62;30;3;27;.900;3572000;0
8070;190702;3737;0;0;0;0;.00nan;0;0
8070;192030;3737;72;18;1;17;.944;3600000;0
8070;-1;784;66;40;4;36;.900;3600000;0
8070;-1;784;0;0;0;0;.00nan;0;0
8071;8107;780;84;25;1;24;.960;3600000;0
8071;-1;776;0;0;0;0;.00nan;0;0
8071;-1;780;0;0;0;0;.00nan;0;0
8071;95405;776;78;38;3;35;.921;3544000;0
8072;202497;2182;0;0;0;0;.00nan;0;0
8072;46334;794;0;0;0;0;.00nan;0;0
8072;62060;794;84;42;3;39;.929;3593000;0
8072;82273;2182;45;10;2;8;.800;3600000;0
8073;193854;777;55;27;3;24;.889;3599000;0
8073;192036;796;0;0;0;0;.00nan;0;0
8073;66924;777;0;0;0;0;.00nan;0;0
8073;149847;796;96;36;1;35;.972;3600000;0
8074;11490;798;78;28;2;26;.929;3600000;0
8074;201174;798;0;0;0;0;.00nan;0;0
8074;-1;784;50;21;3;18;.857;3600000;0
8074;-1;784;0;0;0;0;.00nan;0;0
8075;8487;783;64;17;2;15;.882;3600000;0
8075;195942;783;0;0;0;0;.00nan;0;0
8075;-1;776;0;0;0;0;.00nan;0;0
8075;95405;776;67;30;3;27;.900;3552000;0
8076;183377;904;99;47;2;45;.957;3600000;0
8076;190702;3737;59;29;3;26;.897;3581000;0
8076;192030;3737;0;0;0;0;.00nan;0;0
8076;-1;904;0;0;0;0;.00nan;0;0
8077;8107;780;73;45;5;40;.889;3521000;0
8077;192036;796;0;0;0;0;.00nan;0;0
8077;-1;780;0;0;0;0;.00nan;0;0
8077;149847;796;66;32;3;29;.906;3600000;0
8078;193854;777;31;20;5;15;.750;3600000;0
8078;202497;2182;0;0;0;0;.00nan;0;0
8078;66924;777;0;0;0;0;.00nan;0;0
8078;82273;2182;85;34;2;32;.941;3600000;0
8079;171673;778;65;27;3;24;.889;3549000;0
8079;46334;794;0;0;0;0;.00nan;0;0
8079;62060;794;74;28;2;26;.929;3600000;0
8079;146184;778;0;0;0;0;.00nan;0;0
8080;183377;904;100;40;1;39;.975;3600000;0
8080;11490;798;52;23;3;20;.870;3562000;0
8080;201174;798;0;0;0;0;.00nan;0;0
8080;-1;904;0;0;0;0;.00nan;0;0
8081;190702;3737;87;34;1;33;.971;3900000;0
8081;192030;3737;0;0;0;0;.00nan;0;0
8081;-1;776;0;0;0;0;.00nan;0;0
8081;95405;776;91;30;1;29;.967;3900000;0
8082;8107;780;60;33;4;29;.879;3514000;0
8082;8487;783;91;41;2;39;.951;3600000;0
8082;195942;783;0;0;0;0;.00nan;0;0
8082;-1;780;0;0;0;0;.00nan;0;0
8083;202497;2182;0;0;0;0;.00nan;0;0
8083;192036;796;0;0;0;0;.00nan;0;0
8083;82273;2182;90;21;0;21;1.000;3900000;0
8083;149847;796;100;50;0;50;1.000;3900000;0
8084;193854;777;0;0;0;0;.00nan;0;0
8084;171673;778;69;35;4;31;.886;3600000;0
8084;66924;777;7;24;8;16;.667;3600000;0
8084;146184;778;0;0;0;0;.00nan;0;0
8085;46334;794;0;0;0;0;.00nan;0;0
8085;-1;784;91;34;2;32;.941;3600000;0
8085;-1;784;0;0;0;0;.00nan;0;0
8085;62060;794;64;31;3;28;.903;3586000;0
8086;8487;783;67;33;4;29;.879;3550000;0
8086;195942;783;0;0;0;0;.00nan;0;0
8086;192036;796;0;0;0;0;.00nan;0;0
8086;149847;796;72;29;2;27;.931;3600000;0
8087;193854;777;55;18;2;16;.889;3600000;0
8087;-1;784;59;15;1;14;.933;2522000;0
8087;-1;784;20;18;5;13;.722;1078000;0
8087;66924;777;0;0;0;0;.00nan;0;0
8088;11490;798;43;23;4;19;.826;3595000;0
8088;201174;798;0;0;0;0;.00nan;0;0
8088;-1;776;0;0;0;0;.00nan;0;0
8088;95405;776;74;29;2;27;.931;3600000;0
8089;183377;904;100;20;0;20;1.000;3600000;0
8089;46334;794;0;0;0;0;.00nan;0;0
8089;-1;904;0;0;0;0;.00nan;0;0
8089;62060;794;84;34;3;31;.912;3600000;0
8090;8107;780;64;27;3;24;.889;3893000;0
8090;190702;3737;82;41;4;37;.902;3894000;0
8090;192030;3737;0;0;0;0;.00nan;0;0
8090;-1;780;0;0;0;0;.00nan;0;0
8091;171673;778;66;30;3;27;.900;3885000;0
8091;202497;2182;0;0;0;0;.00nan;0;0
8091;82273;2182;57;30;4;26;.867;3885000;0
8091;146184;778;0;0;0;0;.00nan;0;0
8092;8487;783;68;20;1;19;.950;3600000;0
8092;195942;783;0;0;0;0;.00nan;0;0
8092;190702;3737;53;36;4;32;.889;3600000;0
8092;192030;3737;0;0;0;0;.00nan;0;0
8093;8107;780;89;30;1;29;.967;3600000;0
8093;11490;798;65;22;2;20;.909;3041000;0
8093;201174;798;34;12;3;9;.750;559000;0
8093;-1;780;0;0;0;0;.00nan;0;0
8094;193854;777;83;28;2;26;.929;3600000;0
8094;183377;904;73;45;5;40;.889;3600000;0
8094;-1;904;0;0;0;0;.00nan;0;0
8094;66924;777;0;0;0;0;.00nan;0;0
8095;202497;2182;0;0;0;0;.00nan;0;0
8095;-1;784;52;28;4;24;.857;3600000;0
8095;-1;784;0;0;0;0;.00nan;0;0
8095;82273;2182;93;17;0;17;1.000;3600000;0
8096;-1;776;0;0;0;0;.00nan;0;0
8096;46334;794;0;0;0;0;.00nan;0;0
8096;62060;794;84;36;2;34;.944;3900000;0
8096;95405;776;95;34;2;32;.941;3900000;0
8097;171673;778;0;0;0;0;.00nan;0;0
8097;192036;796;0;0;0;0;.00nan;0;0
8097;146184;778;71;28;2;26;.929;3600000;0
8097;149847;796;53;28;4;24;.857;3554000;0
8098;8487;783;0;0;0;0;.00nan;0;0
8098;11490;798;88;28;1;27;.964;3600000;0
8098;201174;798;0;0;0;0;.00nan;0;0
8098;195942;783;64;26;2;24;.923;3558000;0
8099;193854;777;99;22;0;22;1.000;3600000;0
8099;-1;776;0;0;0;0;.00nan;0;0
8099;66924;777;0;0;0;0;.00nan;0;0
8099;95405;776;85;37;2;35;.946;3549000;0
8100;190702;3737;63;30;3;27;.900;3900000;0
8100;192030;3737;0;0;0;0;.00nan;0;0
8100;192036;796;0;0;0;0;.00nan;0;0
8100;149847;796;92;47;3;44;.936;3900000;0
8101;171673;778;71;33;3;30;.909;3591000;0
8101;-1;784;0;0;0;0;.00nan;0;0
8101;-1;784;64;20;2;18;.900;3600000;0
8101;146184;778;0;0;0;0;.00nan;0;0
8102;8107;780;0;0;0;0;.00nan;0;0
8102;46334;794;0;0;0;0;.00nan;0;0
8102;-1;780;56;15;2;13;.867;3600000;0
8102;62060;794;55;38;5;33;.868;3600000;0
8103;183377;904;37;22;4;18;.818;3600000;0
8103;202497;2182;0;0;0;0;.00nan;0;0
8103;-1;904;0;0;0;0;.00nan;0;0
8103;82273;2182;72;21;1;20;.952;3600000;0
8104;183377;904;33;11;3;8;.727;575000;0
8104;171673;778;100;26;0;26;1.000;3600000;0
8104;-1;904;63;30;3;27;.900;3025000;0
8104;146184;778;0;0;0;0;.00nan;0;0
8105;11490;798;99;24;0;24;1.000;3600000;0
8105;201174;798;0;0;0;0;.00nan;0;0
8105;190702;3737;44;24;4;20;.833;1119000;0
8105;192030;3737;70;31;2;29;.935;2481000;0
8106;192036;796;0;0;0;0;.00nan;0;0
8106;-1;784;0;0;0;0;.00nan;0;0
8106;-1;784;42;24;5;19;.792;3545000;0
8106;149847;796;73;42;4;38;.905;3600000;0
8107;202497;2182;0;0;0;0;.00nan;0;0
8107;-1;776;32;35;7;28;.800;3600000;0
8107;82273;2182;65;23;2;21;.913;3600000;0
8107;95405;776;0;0;0;0;.00nan;0;0
8108;8107;780;100;24;0;24;1.000;3600000;0
8108;193854;777;97;42;1;41;.976;3600000;0
8108;-1;780;0;0;0;0;.00nan;0;0
8108;66924;777;0;0;0;0;.00nan;0;0
8109;8487;783;66;28;4;24;.857;3600000;0
8109;195942;783;0;0;0;0;.00nan;0;0
8109;46334;794;56;44;6;38;.864;3522000;0
8109;62060;794;0;0;0;0;.00nan;0;0
8110;11490;798;79;25;1;24;.960;3600000;0
8110;201174;798;0;0;0;0;.00nan;0;0
8110;192036;796;0;0;0;0;.00nan;0;0
8110;149847;796;69;35;3;32;.914;3546000;0
8111;8487;783;64;30;3;27;.900;3600000;0
8111;193854;777;42;28;5;23;.821;3537000;0
8111;195942;783;0;0;0;0;.00nan;0;0
8111;66924;777;0;0;0;0;.00nan;0;0
8112;183377;904;68;49;5;44;.898;3600000;0
8112;-1;784;70;15;1;14;.933;3600000;0
8112;-1;784;0;0;0;0;.00nan;0;0
8112;-1;904;0;0;0;0;.00nan;0;0
8113;8107;780;40;24;5;19;.792;3566000;0
8113;202497;2182;0;0;0;0;.00nan;0;0
8113;-1;780;0;0;0;0;.00nan;0;0
8113;82273;2182;66;30;3;27;.900;3600000;0
8114;190702;3737;67;24;2;22;.917;3600000;0
8114;192030;3737;0;0;0;0;.00nan;0;0
8114;46334;794;65;28;3;25;.893;2418000;0
8114;62060;794;32;21;4;17;.810;1182000;0
8115;171673;778;41;30;6;24;.800;2383000;0
8115;-1;776;0;0;0;0;.00nan;0;0
8115;95405;776;92;47;3;44;.936;3600000;0
8115;146184;778;60;6;0;6;1.000;1217000;0
8116;11490;798;82;32;2;30;.938;3858000;0
8116;201174;798;0;0;0;0;.00nan;0;0
8116;202497;2182;0;0;0;0;.00nan;0;0
8116;82273;2182;87;29;1;28;.966;3858000;0
8117;8487;783;62;24;3;21;.875;3600000;0
8117;195942;783;0;0;0;0;.00nan;0;0
8117;192036;796;0;0;0;0;.00nan;0;0
8117;149847;796;73;46;4;42;.913;3599000;0
8118;193854;777;61;18;2;16;.889;3600000;0
8118;-1;784;86;48;4;44;.917;3574000;0
8118;-1;784;0;0;0;0;.00nan;0;0
8118;66924;777;0;0;0;0;.00nan;0;0
8119;8107;780;93;20;0;20;1.000;3600000;0
8119;190702;3737;60;27;3;24;.889;3600000;0
8119;192030;3737;0;0;0;0;.00nan;0;0
8119;-1;780;0;0;0;0;.00nan;0;0
8120;-1;776;0;0;0;0;.00nan;0;0
8120;46334;794;0;0;0;0;.00nan;0;0
8120;62060;794;52;23;3;20;.870;3600000;0
8120;95405;776;82;33;2;31;.939;3600000;0
8121;183377;904;67;35;3;32;.914;3600000;0
8121;171673;778;60;21;2;19;.905;3600000;0
8121;-1;904;0;0;0;0;.00nan;0;0
8121;146184;778;0;0;0;0;.00nan;0;0
8122;183377;904;76;23;1;22;.957;3900000;0
8122;190702;3737;84;28;1;27;.964;3900000;0
8122;192030;3737;0;0;0;0;.00nan;0;0
8122;-1;904;0;0;0;0;.00nan;0;0
8123;8487;783;73;35;3;32;.914;3586000;0
8123;195942;783;0;0;0;0;.00nan;0;0
8123;202497;2182;0;0;0;0;.00nan;0;0
8123;82273;2182;78;21;2;19;.905;3600000;0
8124;11490;798;80;33;3;30;.909;3600000;0
8124;201174;798;0;0;0;0;.00nan;0;0
8124;192036;796;0;0;0;0;.00nan;0;0
8124;149847;796;38;30;5;25;.833;3595000;0
8125;-1;776;0;0;0;0;.00nan;0;0
8125;-1;784;46;26;4;22;.846;3900000;0
8125;-1;784;0;0;0;0;.00nan;0;0
8125;95405;776;61;35;4;31;.886;3900000;0
8126;8107;780;75;23;2;21;.913;3900000;0
8126;171673;778;88;39;2;37;.949;3900000;0
8126;-1;780;0;0;0;0;.00nan;0;0
8126;146184;778;0;0;0;0;.00nan;0;0
8127;193854;777;56;24;3;21;.875;3600000;0
8127;46334;794;0;0;0;0;.00nan;0;0
8127;62060;794;47;43;6;37;.860;3600000;0
8127;66924;777;0;0;0;0;.00nan;0;0
8128;8487;783;63;15;1;14;.933;3600000;0
8128;11490;798;52;32;4;28;.875;3600000;0
8128;201174;798;0;0;0;0;.00nan;0;0
8128;195942;783;0;0;0;0;.00nan;0;0
8129;193854;777;77;23;1;22;.957;3600000;0
8129;-1;776;0;0;0;0;.00nan;0;0
8129;66924;777;0;0;0;0;.00nan;0;0
8129;95405;776;53;36;5;31;.861;3600000;0
8130;46334;794;0;0;0;0;.00nan;0;0
8130;-1;784;0;0;0;0;.00nan;0;0
8130;-1;784;58;40;4;36;.900;3600000;0
8130;62060;794;67;43;5;38;.884;3600000;0
8131;8107;780;31;28;6;22;.786;3699000;0
8131;183377;904;0;0;0;0;.00nan;0;0
8131;-1;780;0;0;0;0;.00nan;0;0
8131;-1;904;54;38;5;33;.868;3699000;0
8132;202497;2182;0;0;0;0;.00nan;0;0
8132;192036;796;0;0;0;0;.00nan;0;0
8132;82273;2182;72;29;2;27;.931;3600000;0
8132;149847;796;88;39;3;36;.923;3581000;0
8133;171673;778;0;0;0;0;.00nan;0;0
8133;190702;3737;58;24;2;22;.917;3600000;0
8133;192030;3737;0;0;0;0;.00nan;0;0
8133;146184;778;58;28;3;25;.893;3545000;0
8134;183377;904;48;42;7;35;.833;3600000;0
8134;171673;778;72;18;1;17;.944;3600000;0
8134;-1;904;0;0;0;0;.00nan;0;0
8134;146184;778;0;0;0;0;.00nan;0;0
8135;8107;780;25;21;5;16;.762;2115000;0
8135;190702;3737;0;0;0;0;.00nan;0;0
8135;192030;3737;76;25;1;24;.960;3600000;0
8135;-1;780;56;6;0;6;1.000;1485000;0
8136;8487;783;76;26;1;25;.962;3600000;0
8136;192036;796;0;0;0;0;.00nan;0;0
8136;-1;783;0;0;0;0;.00nan;0;0
8136;149847;796;65;25;3;22;.880;3517000;0
8137;207726;777;0;0;0;0;.00nan;0;0
8137;-1;784;78;36;3;33;.917;3598000;0
8137;-1;784;0;0;0;0;.00nan;0;0
8137;66924;777;86;32;1;31;.969;3600000;0
8138;-1;776;72;23;1;22;.957;3900000;0
8138;46334;794;0;0;0;0;.00nan;0;0
8138;62060;794;91;27;1;26;.963;3900000;0
8138;95405;776;0;0;0;0;.00nan;0;0
8139;11490;798;68;24;2;22;.917;3600000;0
8139;202497;2182;0;0;0;0;.00nan;0;0
8139;82273;2182;50;26;3;23;.885;3600000;0
8139;83199;798;0;0;0;0;.00nan;0;0
8140;183377;904;76;31;2;29;.935;3573000;0
8140;190702;3737;85;28;1;27;.964;3600000;0
8140;192030;3737;0;0;0;0;.00nan;0;0
8140;-1;904;0;0;0;0;.00nan;0;0
8141;11490;798;61;25;3;22;.880;3600000;0
8141;192036;796;0;0;0;0;.00nan;0;0
8141;83199;798;0;0;0;0;.00nan;0;0
8141;149847;796;44;33;6;27;.818;3600000;0
8142;-1;776;0;0;0;0;.00nan;0;0
8142;-1;784;48;27;4;23;.852;3855000;0
8142;-1;784;0;0;0;0;.00nan;0;0
8142;95405;776;57;40;5;35;.875;3855000;0
8143;207726;777;0;0;0;0;.00nan;0;0
8143;46334;794;0;0;0;0;.00nan;0;0
8143;62060;794;94;50;3;47;.940;3900000;0
8143;66924;777;46;15;3;12;.800;3900000;0
8144;8487;783;80;33;2;31;.939;3600000;0
8144;202497;2182;0;0;0;0;.00nan;0;0
8144;-1;783;0;0;0;0;.00nan;0;0
8144;82273;2182;70;42;5;37;.881;3600000;0
8145;8107;780;82;22;1;21;.955;3600000;0
8145;171673;778;0;0;0;0;.00nan;0;0
8145;-1;780;0;0;0;0;.00nan;0;0
8145;146184;778;76;38;4;34;.895;3600000;0
8146;171673;778;0;0;0;0;.00nan;0;0
8146;190702;3737;89;41;2;39;.951;3600000;0
8146;192030;3737;0;0;0;0;.00nan;0;0
8146;146184;778;51;20;3;17;.850;3555000;0
8147;8487;783;63;42;5;37;.881;3600000;0
8147;11490;798;72;42;4;38;.905;3600000;0
8147;-1;783;0;0;0;0;.00nan;0;0
8147;83199;798;0;0;0;0;.00nan;0;0
8148;202497;2182;0;0;0;0;.00nan;0;0
8148;192036;796;0;0;0;0;.00nan;0;0
8148;82273;2182;46;26;5;21;.808;3600000;0
8148;149847;796;92;36;2;34;.944;3600000;0
8149;207726;777;0;0;0;0;.00nan;0;0
8149;-1;776;0;0;0;0;.00nan;0;0
8149;66924;777;81;21;1;20;.952;3600000;0
8149;95405;776;87;37;2;35;.946;3577000;0
8150;8107;780;69;16;1;15;.938;3600000;0
8150;183377;904;73;39;3;36;.923;3578000;0
8150;-1;780;0;0;0;0;.00nan;0;0
8150;-1;904;0;0;0;0;.00nan;0;0
8151;46334;794;90;34;2;32;.941;3900000;0
8151;-1;784;77;24;2;22;.917;3900000;0
8151;-1;784;0;0;0;0;.00nan;0;0
8151;62060;794;0;0;0;0;.00nan;0;0
8152;8487;783;62;25;2;23;.920;3900000;0
8152;202497;2182;0;0;0;0;.00nan;0;0
8152;-1;783;0;0;0;0;.00nan;0;0
8152;82273;2182;93;39;2;37;.949;3900000;0
8153;11490;798;0;0;0;0;.00nan;0;0
8153;46334;794;0;0;0;0;.00nan;0;0
8153;62060;794;100;41;1;40;.976;3600000;0
8153;83199;798;57;26;4;22;.846;3600000;0
8154;190702;3737;76;31;3;28;.903;3600000;0
8154;207726;777;0;0;0;0;.00nan;0;0
8154;192030;3737;0;0;0;0;.00nan;0;0
8154;66924;777;49;23;4;19;.826;3543000;0
8155;-1;776;0;0;0;0;.00nan;0;0
8155;-1;784;0;0;0;0;.00nan;0;0
8155;-1;784;28;26;5;21;.808;3600000;0
8155;95405;776;81;29;1;28;.966;3600000;0
8156;8107;780;72;25;2;23;.920;3600000;0
8156;171673;778;69;34;3;31;.912;3552000;0
8156;-1;780;0;0;0;0;.00nan;0;0
8156;146184;778;0;0;0;0;.00nan;0;0
8157;183377;904;87;36;2;34;.944;3547000;0
8157;192036;796;0;0;0;0;.00nan;0;0
8157;-1;904;0;0;0;0;.00nan;0;0
8157;149847;796;62;16;1;15;.938;3600000;0
8158;193854;777;80;31;2;29;.935;3600000;0
8158;11490;798;64;42;5;37;.881;3600000;0
8158;66924;777;0;0;0;0;.00nan;0;0
8158;83199;798;0;0;0;0;.00nan;0;0
8159;190702;3737;0;0;0;0;.00nan;0;0
8159;202497;2182;0;0;0;0;.00nan;0;0
8159;192030;3737;64;36;3;33;.917;3549000;0
8159;82273;2182;75;24;2;22;.917;3600000;0
8160;8107;780;84;24;1;23;.958;3900000;0
8160;-1;784;96;35;1;34;.971;3900000;0
8160;-1;784;0;0;0;0;.00nan;0;0
8160;-1;780;0;0;0;0;.00nan;0;0
8161;183377;904;75;33;3;30;.909;3600000;0
8161;-1;776;0;0;0;0;.00nan;0;0
8161;-1;904;0;0;0;0;.00nan;0;0
8161;95405;776;52;30;4;26;.867;3568000;0
8162;192036;796;0;0;0;0;.00nan;0;0
8162;46334;794;0;0;0;0;.00nan;0;0
8162;62060;794;100;25;0;25;1.000;3600000;0
8162;149847;796;83;32;2;30;.938;3600000;0
8163;8487;783;72;26;2;24;.923;3881000;0
8163;171673;778;0;0;0;0;.00nan;0;0
8163;195942;783;0;0;0;0;.00nan;0;0
8163;146184;778;80;33;2;31;.939;3900000;0
8164;171673;778;89;32;1;31;.969;3600000;0
8164;190702;3737;82;31;2;29;.935;3592000;0
8164;192030;3737;0;0;0;0;.00nan;0;0
8164;146184;778;0;0;0;0;.00nan;0;0
8165;11490;798;45;33;6;27;.818;3159000;0
8165;202497;2182;0;0;0;0;.00nan;0;0
8165;82273;2182;39;25;5;20;.800;3600000;0
8165;83199;798;63;8;0;8;1.000;419000;0
8166;192036;796;0;0;0;0;.00nan;0;0
8166;-1;776;0;0;0;0;.00nan;0;0
8166;95405;776;55;29;3;26;.897;3600000;0
8166;149847;796;80;36;4;32;.889;3579000;0
8167;8487;783;59;23;2;21;.913;3600000;0
8167;195942;783;0;0;0;0;.00nan;0;0
8167;-1;784;0;0;0;0;.00nan;0;0
8167;-1;784;60;29;3;26;.897;3543000;0
8168;8107;780;83;16;0;16;1.000;3600000;0
8168;183377;904;81;51;4;47;.922;3600000;0
8168;-1;780;0;0;0;0;.00nan;0;0
8168;-1;904;0;0;0;0;.00nan;0;0
8169;193854;777;47;19;3;16;.842;3600000;0
8169;46334;794;64;9;0;9;1.000;449000;0
8169;62060;794;29;37;7;30;.811;3151000;0
8169;66924;777;0;0;0;0;.00nan;0;0
8170;193854;777;66;25;2;23;.920;3600000;0
8170;192036;796;53;3;0;3;1.000;363000;0
8170;66924;777;0;0;0;0;.00nan;0;0
8170;149847;796;33;31;6;25;.806;3237000;0
8171;8107;780;89;32;1;31;.969;3600000;0
8171;-1;776;0;0;0;0;.00nan;0;0
8171;-1;780;0;0;0;0;.00nan;0;0
8171;95405;776;70;40;4;36;.900;3600000;0
8172;190702;3737;46;30;4;26;.867;3579000;0
8172;192030;3737;0;0;0;0;.00nan;0;0
8172;-1;784;63;33;3;30;.909;3600000;0
8172;-1;784;0;0;0;0;.00nan;0;0
8173;8487;783;64;28;3;25;.893;3600000;0
8173;183377;904;76;31;3;28;.903;3577000;0
8173;195942;783;0;0;0;0;.00nan;0;0
8173;-1;904;0;0;0;0;.00nan;0;0
8174;202497;2182;73;18;1;17;.944;3600000;0
8174;46334;794;0;0;0;0;.00nan;0;0
8174;62060;794;25;30;6;24;.800;3600000;0
8174;82273;2182;0;0;0;0;.00nan;0;0
8175;11490;798;64;31;3;28;.903;3900000;0
8175;171673;778;36;15;3;12;.800;3900000;0
8175;64066;778;0;0;0;0;.00nan;0;0
8175;83199;798;0;0;0;0;.00nan;0;0
8176;183377;904;44;26;4;22;.846;3545000;0
8176;190702;3737;0;0;0;0;.00nan;0;0
8176;192030;3737;69;27;3;24;.889;3600000;0
8176;-1;904;0;0;0;0;.00nan;0;0
8177;8487;783;58;22;3;19;.864;3553000;0
8177;195942;783;0;0;0;0;.00nan;0;0
8177;-1;776;0;0;0;0;.00nan;0;0
8177;95405;776;90;39;2;37;.949;3600000;0
8178;8107;780;79;37;3;34;.919;3900000;0
8178;192036;796;60;32;3;29;.906;3900000;0
8178;-1;780;0;0;0;0;.00nan;0;0
8178;149847;796;0;0;0;0;.00nan;0;0
8179;11490;798;83;34;2;32;.941;3600000;0
8179;-1;784;55;25;3;22;.880;3551000;0
8179;-1;784;0;0;0;0;.00nan;0;0
8179;83199;798;0;0;0;0;.00nan;0;0
8180;193854;777;81;31;3;28;.903;3600000;0
8180;202497;2182;72;28;2;26;.929;2621000;0
8180;66924;777;0;0;0;0;.00nan;0;0
8180;82273;2182;27;12;4;8;.667;979000;0
8181;171673;778;59;10;1;9;.900;3600000;0
8181;46334;794;0;0;0;0;.00nan;0;0
8181;62060;794;69;43;4;39;.907;3600000;0
8181;64066;778;0;0;0;0;.00nan;0;0
8182;183377;904;57;38;4;34;.895;3900000;0
8182;11490;798;61;33;4;29;.879;3900000;0
8182;-1;904;0;0;0;0;.00nan;0;0
8182;83199;798;0;0;0;0;.00nan;0;0
8183;46334;794;0;0;0;0;.00nan;0;0
8183;-1;784;58;36;4;32;.889;3600000;0
8183;-1;784;0;0;0;0;.00nan;0;0
8183;62060;794;55;30;5;25;.833;3550000;0
8184;190702;3737;51;25;3;22;.880;3600000;0
8184;192030;3737;0;0;0;0;.00nan;0;0
8184;-1;776;56;33;4;29;.879;3600000;0
8184;95405;776;0;0;0;0;.00nan;0;0
8185;8107;780;84;48;3;45;.938;3900000;0
8185;8487;783;53;21;3;18;.857;3900000;0
8185;195942;783;0;0;0;0;.00nan;0;0
8185;-1;780;0;0;0;0;.00nan;0;0
8186;202497;2182;0;0;0;0;.00nan;0;0
8186;192036;796;0;0;0;0;.00nan;0;0
8186;82273;2182;85;26;1;25;.962;3600000;0
8186;149847;796;46;22;4;18;.818;3600000;0
8187;193854;777;38;24;4;20;.833;3600000;0
8187;171673;778;100;45;2;43;.956;3600000;0
8187;64066;778;0;0;0;0;.00nan;0;0
8187;66924;777;0;0;0;0;.00nan;0;0
8188;11490;798;0;0;0;0;.00nan;0;0
8188;-1;776;55;3;0;3;1.000;285000;0
8188;83199;798;81;27;1;26;.963;3600000;0
8188;95405;776;31;30;6;24;.800;3315000;0
8189;8487;783;28;29;6;23;.793;3273000;0
8189;195942;783;52;3;0;3;1.000;327000;0
8189;192036;796;0;0;0;0;.00nan;0;0
8189;149847;796;56;34;5;29;.853;3600000;0
8190;8107;780;56;21;2;19;.905;3600000;0
8190;190702;3737;63;43;6;37;.860;3600000;0
8190;192030;3737;0;0;0;0;.00nan;0;0
8190;-1;780;0;0;0;0;.00nan;0;0
8191;193854;777;73;19;1;18;.947;3600000;0
8191;-1;784;0;0;0;0;.00nan;0;0
8191;-1;784;50;42;5;37;.881;3600000;0
8191;66924;777;0;0;0;0;.00nan;0;0
8192;171673;778;71;31;2;29;.935;3600000;0
8192;202497;2182;50;1;0;1;1.000;260000;0
8192;64066;778;0;0;0;0;.00nan;0;0
8192;82273;2182;36;30;6;24;.800;3340000;0
8193;183377;904;77;37;4;33;.892;3900000;0
8193;46334;794;60;30;4;26;.867;3900000;0
8193;-1;904;0;0;0;0;.00nan;0;0
8193;62060;794;0;0;0;0;.00nan;0;0
8194;193854;777;83;25;1;24;.960;3600000;0
8194;183377;904;75;48;4;44;.917;3600000;0
8194;-1;904;0;0;0;0;.00nan;0;0
8194;66924;777;0;0;0;0;.00nan;0;0
8195;8487;783;93;20;0;20;1.000;3600000;0
8195;195942;783;0;0;0;0;.00nan;0;0
8195;190702;3737;90;34;2;32;.941;3600000;0
8195;192030;3737;0;0;0;0;.00nan;0;0
8196;202497;2182;0;0;0;0;.00nan;0;0
8196;-1;784;53;23;3;20;.870;3539000;0
8196;-1;784;0;0;0;0;.00nan;0;0
8196;82273;2182;86;23;1;22;.957;3600000;0
8197;-1;776;0;0;0;0;.00nan;0;0
8197;46334;794;0;0;0;0;.00nan;0;0
8197;62060;794;64;33;3;30;.909;3600000;0
8197;95405;776;100;25;0;25;1.000;3600000;0
8198;8107;780;55;16;2;14;.875;3783000;0
8198;11490;798;76;35;3;32;.914;3783000;0
8198;-1;780;0;0;0;0;.00nan;0;0
8198;83199;798;0;0;0;0;.00nan;0;0
8199;171673;778;57;18;2;16;.889;3600000;0
8199;192036;796;0;0;0;0;.00nan;0;0
8199;64066;778;0;0;0;0;.00nan;0;0
8199;149847;796;58;35;4;31;.886;3591000;0
8200;8487;783;91;29;1;28;.966;3600000;0
8200;11490;798;97;47;2;45;.957;3581000;0
8200;195942;783;0;0;0;0;.00nan;0;0
8200;83199;798;0;0;0;0;.00nan;0;0
8201;193854;777;95;46;3;43;.935;3600000;0
8201;-1;776;0;0;0;0;.00nan;0;0
8201;66924;777;0;0;0;0;.00nan;0;0
8201;95405;776;63;43;5;38;.884;3577000;0
8202;190702;3737;82;27;1;26;.963;3600000;0
8202;192030;3737;0;0;0;0;.00nan;0;0
8202;192036;796;0;0;0;0;.00nan;0;0
8202;149847;796;77;44;4;40;.909;3600000;0
8203;171673;778;49;23;3;20;.870;3600000;0
8203;-1;784;0;0;0;0;.00nan;0;0
8203;-1;784;58;36;4;32;.889;3555000;0
8203;64066;778;0;0;0;0;.00nan;0;0
8204;183377;904;70;35;3;32;.914;3599000;0
8204;202497;2182;0;0;0;0;.00nan;0;0
8204;-1;904;0;0;0;0;.00nan;0;0
8204;82273;2182;84;30;1;29;.967;3600000;0
8205;8107;780;46;26;4;22;.846;3600000;0
8205;46334;794;0;0;0;0;.00nan;0;0
8205;-1;780;0;0;0;0;.00nan;0;0
8205;62060;794;81;36;3;33;.917;3600000;0
8206;11490;798;22;25;6;19;.760;1883000;0
8206;190702;3737;40;28;6;22;.786;3600000;0
8206;192030;3737;0;0;0;0;.00nan;0;0
8206;83199;798;53;17;2;15;.882;1701000;0
8207;192036;796;0;0;0;0;.00nan;0;0
8207;-1;784;83;37;3;34;.919;3600000;0
8207;-1;784;0;0;0;0;.00nan;0;0
8207;149847;796;62;24;2;22;.917;3600000;0
8208;8107;780;95;33;1;32;.970;3600000;0
8208;193854;777;0;0;0;0;.00nan;0;0
8208;-1;780;0;0;0;0;.00nan;0;0
8208;66924;777;59;21;2;19;.905;3556000;0
8209;202497;2182;0;0;0;0;.00nan;0;0
8209;-1;776;0;0;0;0;.00nan;0;0
8209;82273;2182;86;30;1;29;.967;3600000;0
8209;95405;776;48;35;5;30;.857;3600000;0
8210;8487;783;90;19;0;19;1.000;3600000;0
8210;195942;783;0;0;0;0;.00nan;0;0
8210;46334;794;0;0;0;0;.00nan;0;0
8210;62060;794;52;31;4;27;.871;3600000;0
8211;183377;904;60;27;2;25;.926;3565000;0
8211;171673;778;0;0;0;0;.00nan;0;0
8211;-1;904;0;0;0;0;.00nan;0;0
8211;64066;778;90;18;0;18;1.000;3600000;0
8212;8487;783;60;28;3;25;.893;3600000;0
8212;193854;777;21;25;6;19;.760;3137000;0
8212;195942;783;0;0;0;0;.00nan;0;0
8212;66924;777;49;1;0;1;1.000;463000;0
8213;171673;778;0;0;0;0;.00nan;0;0
8213;-1;776;0;0;0;0;.00nan;0;0
8213;64066;778;93;20;0;20;1.000;3600000;0
8213;95405;776;88;44;3;41;.932;3600000;0
8214;11490;798;72;29;2;27;.931;3568000;0
8214;192036;796;0;0;0;0;.00nan;0;0
8214;83199;798;0;0;0;0;.00nan;0;0
8214;149847;796;99;38;1;37;.974;3600000;0
8215;183377;904;69;35;3;32;.914;3600000;0
8215;-1;784;86;20;0;20;1.000;3600000;0
8215;-1;784;0;0;0;0;.00nan;0;0
8215;-1;904;0;0;0;0;.00nan;0;0
8216;8107;780;0;0;0;0;.00nan;0;0
8216;202497;2182;0;0;0;0;.00nan;0;0
8216;-1;780;47;28;4;24;.857;3538000;0
8216;82273;2182;70;20;2;18;.900;3600000;0
8217;190702;3737;34;26;5;21;.808;3553000;0
8217;192030;3737;0;0;0;0;.00nan;0;0
8217;46334;794;0;0;0;0;.00nan;0;0
8217;62060;794;89;44;3;41;.932;3600000;0
8218;183377;904;0;0;0;0;.00nan;0;0
8218;192036;796;0;0;0;0;.00nan;0;0
8218;-1;904;64;31;3;28;.903;3600000;0
8218;149847;796;87;33;2;31;.939;3600000;0
8219;-1;776;0;0;0;0;.00nan;0;0
8219;-1;784;71;35;3;32;.914;3900000;0
8219;-1;784;0;0;0;0;.00nan;0;0
8219;95405;776;84;36;3;33;.917;3900000;0
8220;193854;777;45;23;4;19;.826;3543000;0
8220;190702;3737;79;39;3;36;.923;3600000;0
8220;192030;3737;0;0;0;0;.00nan;0;0
8220;66924;777;0;0;0;0;.00nan;0;0
8221;8487;783;84;28;1;27;.964;3565000;0
8221;195942;783;0;0;0;0;.00nan;0;0
8221;202497;2182;0;0;0;0;.00nan;0;0
8221;82273;2182;100;33;0;33;1.000;3600000;0
8222;11490;798;90;22;0;22;1.000;3600000;0
8222;46334;794;64;32;4;28;.875;3600000;0
8222;62060;794;0;0;0;0;.00nan;0;0
8222;83199;798;0;0;0;0;.00nan;0;0
8223;8107;780;78;26;1;25;.962;3600000;0
8223;171673;778;0;0;0;0;.00nan;0;0
8223;-1;780;0;0;0;0;.00nan;0;0
8223;64066;778;60;39;5;34;.872;3600000;0
8224;190702;3737;56;22;3;19;.864;3547000;0
8224;202497;2182;0;0;0;0;.00nan;0;0
8224;192030;3737;0;0;0;0;.00nan;0;0
8224;82273;2182;82;27;1;26;.963;3600000;0
8225;8487;783;58;29;4;25;.862;3600000;0
8225;171673;778;71;29;2;27;.931;3600000;0
8225;195942;783;0;0;0;0;.00nan;0;0
8225;64066;778;0;0;0;0;.00nan;0;0
8226;193854;777;89;35;2;33;.943;3600000;0
8226;11490;798;56;25;3;22;.880;3586000;0
8226;66924;777;0;0;0;0;.00nan;0;0
8226;83199;798;0;0;0;0;.00nan;0;0
8227;192036;796;0;0;0;0;.00nan;0;0
8227;46334;794;0;0;0;0;.00nan;0;0
8227;62060;794;76;20;1;19;.950;3600000;0
8227;149847;796;67;23;2;21;.913;3565000;0
8228;8107;780;85;22;1;21;.955;3600000;0
8228;-1;784;0;0;0;0;.00nan;0;0
8228;-1;784;65;35;3;32;.914;3546000;0
8228;-1;780;0;0;0;0;.00nan;0;0
8229;183377;904;84;29;2;27;.931;3600000;0
8229;-1;776;0;0;0;0;.00nan;0;0
8229;-1;904;0;0;0;0;.00nan;0;0
8229;95405;776;42;31;6;25;.806;3600000;0
8230;193854;777;68;19;2;17;.895;3600000;0
8230;46334;794;0;0;0;0;.00nan;0;0
8230;62060;794;81;50;5;45;.900;3600000;0
8230;66924;777;0;0;0;0;.00nan;0;0
8231;192036;796;0;0;0;0;.00nan;0;0
8231;-1;776;57;33;4;29;.879;3899000;0
8231;95405;776;0;0;0;0;.00nan;0;0
8231;149847;796;57;33;4;29;.879;3900000;0
8232;8487;783;83;35;2;33;.943;3581000;0
8232;195942;783;0;0;0;0;.00nan;0;0
8232;-1;784;75;21;1;20;.952;3600000;0
8232;-1;784;0;0;0;0;.00nan;0;0
8233;8107;780;70;22;2;20;.909;3600000;0
8233;183377;904;82;42;3;39;.929;3596000;0
8233;-1;780;0;0;0;0;.00nan;0;0
8233;-1;904;0;0;0;0;.00nan;0;0
8234;11490;798;96;34;2;32;.941;3572000;0
8234;202497;2182;0;0;0;0;.00nan;0;0
8234;82273;2182;100;29;0;29;1.000;3600000;0
8234;83199;798;0;0;0;0;.00nan;0;0
8235;171673;778;36;22;4;18;.818;3600000;0
8235;190702;3737;75;34;3;31;.912;3600000;0
8235;192030;3737;0;0;0;0;.00nan;0;0
8235;64066;778;0;0;0;0;.00nan;0;0
8236;8487;783;0;0;0;0;.00nan;0;0
8236;183377;904;81;33;2;31;.939;3900000;0
8236;195942;783;64;22;2;20;.909;3900000;0
8236;-1;904;0;0;0;0;.00nan;0;0
8237;193854;777;70;29;2;27;.931;3900000;0
8237;192036;796;0;0;0;0;.00nan;0;0
8237;66924;777;0;0;0;0;.00nan;0;0
8237;149847;796;90;39;2;37;.949;3900000;0
8238;190702;3737;58;27;3;24;.889;3542000;0
8238;192030;3737;0;0;0;0;.00nan;0;0
8238;-1;784;75;27;2;25;.926;3600000;0
8238;-1;784;0;0;0;0;.00nan;0;0
8239;8107;780;67;16;1;15;.938;3600000;0
8239;-1;776;0;0;0;0;.00nan;0;0
8239;-1;780;0;0;0;0;.00nan;0;0
8239;95405;776;97;44;2;42;.955;3590000;0
8240;202497;2182;0;0;0;0;.00nan;0;0
8240;46334;794;0;0;0;0;.00nan;0;0
8240;62060;794;78;44;3;41;.932;3600000;0
8240;82273;2182;50;38;6;32;.842;3600000;0
8241;11490;798;97;23;0;23;1.000;3600000;0
8241;171673;778;77;41;3;38;.927;3600000;0
8241;64066;778;0;0;0;0;.00nan;0;0
8241;83199;798;0;0;0;0;.00nan;0;0
8242;183377;904;64;32;3;29;.906;3900000;0
8242;190702;3737;61;30;3;27;.900;3900000;0
8242;192030;3737;0;0;0;0;.00nan;0;0
8242;-1;904;0;0;0;0;.00nan;0;0
8243;8487;783;48;25;4;21;.840;3600000;0
8243;195942;783;0;0;0;0;.00nan;0;0
8243;-1;776;0;0;0;0;.00nan;0;0
8243;95405;776;91;28;1;27;.964;3600000;0
8244;11490;798;72;28;3;25;.893;3600000;0
8244;-1;784;0;0;0;0;.00nan;0;0
8244;-1;784;54;29;4;25;.862;3600000;0
8244;83199;798;0;0;0;0;.00nan;0;0
8245;8107;780;63;22;2;20;.909;3600000;0
8245;192036;796;0;0;0;0;.00nan;0;0
8245;-1;780;0;0;0;0;.00nan;0;0
8245;149847;796;75;50;5;45;.900;3600000;0
8246;193854;777;58;25;2;23;.920;3900000;0
8246;202497;2182;0;0;0;0;.00nan;0;0
8246;66924;777;0;0;0;0;.00nan;0;0
8246;82273;2182;78;32;2;30;.938;3866000;0
8247;171673;778;71;22;2;20;.909;3600000;0
8247;46334;794;0;0;0;0;.00nan;0;0
8247;62060;794;67;30;3;27;.900;3564000;0
8247;64066;778;0;0;0;0;.00nan;0;0
8248;183377;904;65;35;4;31;.886;3554000;0
8248;11490;798;62;22;2;20;.909;3600000;0
8248;-1;904;0;0;0;0;.00nan;0;0
8248;83199;798;0;0;0;0;.00nan;0;0
8249;193854;777;0;0;0;0;.00nan;0;0
8249;171673;778;45;47;7;40;.851;3600000;0
8249;64066;778;0;0;0;0;.00nan;0;0
8249;66924;777;78;20;1;19;.950;3600000;0
8250;202497;2182;0;0;0;0;.00nan;0;0
8250;192036;796;0;0;0;0;.00nan;0;0
8250;82273;2182;69;24;2;22;.917;3600000;0
8250;149847;796;94;46;3;43;.935;3560000;0
8251;190702;3737;0;0;0;0;.00nan;0;0
8251;192030;3737;79;14;0;14;1.000;3600000;0
8251;-1;776;0;0;0;0;.00nan;0;0
8251;95405;776;89;36;2;34;.944;3571000;0
8252;46334;794;0;0;0;0;.00nan;0;0
8252;-1;784;86;26;1;25;.962;3600000;0
8252;-1;784;0;0;0;0;.00nan;0;0
8252;62060;794;70;40;4;36;.900;3600000;0
8253;8107;780;67;34;3;31;.912;3561000;0
8253;8487;783;96;32;1;31;.969;3600000;0
8253;195942;783;0;0;0;0;.00nan;0;0
8253;-1;780;0;0;0;0;.00nan;0;0
8254;193854;777;52;25;4;21;.840;3565000;0
8254;-1;784;73;39;3;36;.923;3600000;0
8254;-1;784;0;0;0;0;.00nan;0;0
8254;66924;777;0;0;0;0;.00nan;0;0
8255;8487;783;80;34;2;32;.941;3900000;0
8255;195942;783;0;0;0;0;.00nan;0;0
8255;192036;796;0;0;0;0;.00nan;0;0
8255;149847;796;70;27;2;25;.926;3900000;0
8256;183377;904;0;0;0;0;.00nan;0;0
8256;46334;794;0;0;0;0;.00nan;0;0
8256;-1;904;87;30;2;28;.933;3600000;0
8256;62060;794;66;39;4;35;.897;3598000;0
8257;11490;798;98;21;0;21;1.000;3900000;0
8257;-1;776;0;0;0;0;.00nan;0;0
8257;83199;798;0;0;0;0;.00nan;0;0
8257;95405;776;95;36;0;36;1.000;3900000;0
8258;8107;780;51;22;2;20;.909;3900000;0
8258;190702;3737;0;0;0;0;.00nan;0;0
8258;192030;3737;82;34;2;32;.941;3900000;0
8258;-1;780;0;0;0;0;.00nan;0;0
8259;171673;778;100;32;0;32;1.000;3600000;0
8259;202497;2182;35;5;2;3;.600;907000;0
8259;64066;778;0;0;0;0;.00nan;0;0
8259;82273;2182;39;29;6;23;.793;2693000;0
8260;8487;783;100;25;0;25;1.000;3600000;0
8260;195942;783;0;0;0;0;.00nan;0;0
8260;190702;3737;46;22;3;19;.864;3600000;0
8260;192030;3737;0;0;0;0;.00nan;0;0
8261;202497;2182;0;0;0;0;.00nan;0;0
8261;-1;784;35;27;5;22;.815;3600000;0
8261;-1;784;0;0;0;0;.00nan;0;0
8261;82273;2182;86;20;0;20;1.000;3600000;0
8262;8107;780;99;40;1;39;.975;3600000;0
8262;11490;798;29;27;6;21;.778;3302000;0
8262;-1;780;0;0;0;0;.00nan;0;0
8262;83199;798;58;9;0;9;1.000;298000;0
8263;193854;777;61;21;3;18;.857;3900000;0
8263;183377;904;75;40;3;37;.925;3900000;0
8263;-1;904;0;0;0;0;.00nan;0;0
8263;66924;777;0;0;0;0;.00nan;0;0
8264;-1;776;0;0;0;0;.00nan;0;0
8264;46334;794;0;0;0;0;.00nan;0;0
8264;62060;794;75;34;3;31;.912;3900000;0
8264;95405;776;92;39;3;36;.923;3900000;0
8265;171673;778;79;31;3;28;.903;3571000;0
8265;192036;796;58;20;2;18;.900;3600000;0
8265;64066;778;0;0;0;0;.00nan;0;0
8265;149847;796;0;0;0;0;.00nan;0;0
8267;202497;2182;0;0;0;0;.00nan;0;0
8267;-1;784;0;0;0;0;.00nan;0;0
8267;-1;784;88;36;2;34;.944;3583000;0
8267;82273;2182;85;25;1;24;.960;3600000;0
8269;8487;783;54;26;3;23;.885;3600000;0
8269;201174;798;78;29;2;27;.931;3600000;0
8269;195942;783;0;0;0;0;.00nan;0;0
8269;-1;798;0;0;0;0;.00nan;0;0
8271;-1;778;0;0;0;0;.00nan;0;0
8271;192036;796;0;0;0;0;.00nan;0;0
8271;146184;778;80;25;2;23;.920;3900000;0
8271;149847;796;59;25;2;23;.920;3900000;0
8275;193854;777;80;26;1;25;.962;3600000;0
8275;46334;794;0;0;0;0;.00nan;0;0
8275;62060;794;75;50;4;46;.920;3600000;0
8275;66924;777;0;0;0;0;.00nan;0;0
8277;8107;780;57;13;1;12;.923;3600000;0
8277;183377;904;92;40;2;38;.950;3579000;0
8277;-1;780;0;0;0;0;.00nan;0;0
8277;-1;904;0;0;0;0;.00nan;0;0
8279;8107;780;91;31;1;30;.968;3600000;0
8279;192036;796;0;0;0;0;.00nan;0;0
8279;-1;780;0;0;0;0;.00nan;0;0
8279;149847;796;81;55;5;50;.909;3600000;0
8281;8487;783;68;16;1;15;.938;3600000;0
8281;11490;798;62;35;4;31;.886;3600000;0
8281;201174;798;0;0;0;0;.00nan;0;0
8281;195942;783;0;0;0;0;.00nan;0;0
8283;190702;3737;36;31;5;26;.839;3581000;0
8283;192030;3737;0;0;0;0;.00nan;0;0
8283;46334;794;0;0;0;0;.00nan;0;0
8283;62060;794;60;29;3;26;.897;3600000;0
8285;193854;777;44;19;4;15;.789;3537000;0
8285;-1;784;0;0;0;0;.00nan;0;0
8285;-1;784;86;36;2;34;.944;3600000;0
8285;66924;777;0;0;0;0;.00nan;0;0
8289;183377;904;36;35;6;29;.829;3216000;0
8289;-1;778;0;0;0;0;.00nan;0;0
8289;-1;904;41;2;1;1;.500;384000;0
8289;146184;778;92;25;0;25;1.000;3600000;0
8291;8107;780;0;0;0;0;.00nan;0;0
8291;-1;784;68;23;2;21;.913;3600000;0
8291;-1;784;0;0;0;0;.00nan;0;0
8291;-1;780;64;28;4;24;.857;3555000;0
8293;193854;777;0;0;0;0;.00nan;0;0
8293;-1;778;0;0;0;0;.00nan;0;0
8293;66924;777;71;25;2;23;.920;3600000;0
8293;146184;778;73;41;3;38;.927;3562000;0
8295;190702;3737;0;0;0;0;.00nan;0;0
8295;192030;3737;66;25;2;23;.920;3600000;0
8295;192036;796;51;29;4;25;.862;3519000;0
8295;149847;796;0;0;0;0;.00nan;0;0
8297;8487;783;0;0;0;0;.00nan;0;0
8297;195942;783;81;28;1;27;.964;3900000;0
8297;202497;2182;0;0;0;0;.00nan;0;0
8297;82273;2182;76;18;1;17;.944;3900000;0
8301;11490;798;0;0;0;0;.00nan;0;0
8301;201174;798;100;34;0;34;1.000;3600000;0
8301;46334;794;52;26;3;23;.885;3600000;0
8301;62060;794;0;0;0;0;.00nan;0;0
8303;193854;777;89;50;4;46;.920;3545000;0
8303;11490;798;0;0;0;0;.00nan;0;0
8303;201174;798;50;23;3;20;.870;3600000;0
8303;66924;777;0;0;0;0;.00nan;0;0
8305;190702;3737;69;34;3;31;.912;3557000;0
8305;192030;3737;0;0;0;0;.00nan;0;0
8305;-1;784;0;0;0;0;.00nan;0;0
8305;-1;784;53;18;2;16;.889;3600000;0
8307;8107;780;70;19;1;18;.947;3600000;0
8307;-1;776;0;0;0;0;.00nan;0;0
8307;-1;780;0;0;0;0;.00nan;0;0
8307;95405;776;49;29;4;25;.862;3600000;0
8309;202497;2182;0;0;0;0;.00nan;0;0
8309;46334;794;0;0;0;0;.00nan;0;0
8309;62060;794;54;44;6;38;.864;3600000;0
8309;82273;2182;70;21;1;20;.952;3600000;0
8311;183377;904;76;30;2;28;.933;3600000;0
8311;-1;778;0;0;0;0;.00nan;0;0
8311;-1;904;0;0;0;0;.00nan;0;0
8311;146184;778;50;35;5;30;.857;3600000;0
8313;8487;783;70;37;4;33;.892;3900000;0
8313;195942;783;0;0;0;0;.00nan;0;0
8313;192036;796;0;0;0;0;.00nan;0;0
8313;149847;796;68;37;4;33;.892;3900000;0
8315;11490;798;76;22;1;21;.955;3600000;0
8315;201174;798;0;0;0;0;.00nan;0;0
8315;202497;2182;0;0;0;0;.00nan;0;0
8315;82273;2182;48;27;4;23;.852;3600000;0
8319;8107;780;0;0;0;0;.00nan;0;0
8319;192036;796;68;55;6;49;.891;3304000;0
8319;-1;780;40;15;3;12;.800;3600000;0
8319;149847;796;50;1;0;1;1.000;296000;0
8321;8487;783;0;0;0;0;.00nan;0;0
8321;195942;783;53;23;3;20;.870;3600000;0
8321;190702;3737;0;0;0;0;.00nan;0;0
8321;192030;3737;35;18;4;14;.778;3587000;0
8323;183377;904;57;6;0;6;1.000;349000;0
8323;-1;784;56;19;2;17;.895;3600000;0
8323;-1;784;0;0;0;0;.00nan;0;0
8323;-1;904;56;46;6;40;.870;3251000;0
8325;-1;778;70;28;3;25;.893;3600000;0
8325;46334;794;57;34;4;30;.882;3543000;0
8325;62060;794;0;0;0;0;.00nan;0;0
8325;146184;778;0;0;0;0;.00nan;0;0
8327;8107;780;75;25;1;24;.960;3600000;0
8327;190702;3737;82;43;3;40;.930;3590000;0
8327;192030;3737;0;0;0;0;.00nan;0;0
8327;-1;780;0;0;0;0;.00nan;0;0
8329;202497;2182;0;0;0;0;.00nan;0;0
8329;46334;794;0;0;0;0;.00nan;0;0
8329;62060;794;100;46;1;45;.978;3900000;0
8329;82273;2182;76;15;1;14;.933;3900000;0
8331;183377;904;56;24;3;21;.875;3543000;0
8331;192036;796;0;0;0;0;.00nan;0;0
8331;-1;904;0;0;0;0;.00nan;0;0
8331;149847;796;95;43;2;41;.953;3600000;0
8333;8487;783;54;39;6;33;.846;3122000;0
8333;193854;777;52;29;4;25;.862;3600000;0
8333;195942;783;54;4;0;4;1.000;478000;0
8333;66924;777;0;0;0;0;.00nan;0;0
8335;-1;778;0;0;0;0;.00nan;0;0
8335;-1;784;0;0;0;0;.00nan;0;0
8335;-1;784;86;27;1;26;.963;3600000;0
8335;146184;778;77;42;3;39;.929;3586000;0
8339;190702;3737;0;0;0;0;.00nan;0;0
8339;192030;3737;46;22;3;19;.864;3600000;0
8339;46334;794;66;34;4;30;.882;3544000;0
8339;62060;794;0;0;0;0;.00nan;0;0
8341;183377;904;0;0;0;0;.00nan;0;0
8341;202497;2182;31;17;4;13;.765;3600000;0
8341;-1;904;43;37;6;31;.838;3560000;0
8341;82273;2182;0;0;0;0;.00nan;0;0
8343;8487;783;0;0;0;0;.00nan;0;0
8343;193854;777;0;0;0;0;.00nan;0;0
8343;195942;783;78;44;4;40;.909;3600000;0
8343;66924;777;72;23;1;22;.957;3600000;0
8347;11490;798;0;0;0;0;.00nan;0;0
8347;201174;798;42;28;5;23;.821;3600000;0
8347;-1;778;81;31;2;29;.935;3600000;0
8347;146184;778;0;0;0;0;.00nan;0;0
8349;192036;796;78;31;2;29;.935;3553000;0
8349;-1;784;79;24;1;23;.958;3600000;0
8349;-1;784;0;0;0;0;.00nan;0;0
8349;149847;796;0;0;0;0;.00nan;0;0
662;11490;798;77;35;3;32;.914;4107000;0
662;-1;784;93;38;2;36;.947;4107000;0
662;-1;784;0;0;0;0;.00nan;0;0
662;83199;798;0;0;0;0;.00nan;0;0
663;192036;796;0;0;0;0;.00nan;0;0
663;-1;776;0;0;0;0;.00nan;0;0
663;95405;776;96;23;0;23;1.000;3600000;0
663;149847;796;81;30;1;29;.967;3566000;0
664;11490;798;100;29;0;29;1.000;3600000;0
664;-1;784;77;31;2;29;.935;3591000;0
664;-1;784;0;0;0;0;.00nan;0;0
664;83199;798;0;0;0;0;.00nan;0;0
665;192036;796;0;0;0;0;.00nan;0;0
665;-1;776;0;0;0;0;.00nan;0;0
665;95405;776;86;29;2;27;.931;3600000;0
665;149847;796;54;33;5;28;.848;3600000;0
747;11490;798;41;18;4;14;.778;3775000;0
747;-1;784;67;41;5;36;.878;3775000;0
747;-1;784;0;0;0;0;.00nan;0;0
747;83199;798;0;0;0;0;.00nan;0;0
814;202497;2182;0;0;0;0;.00nan;0;0
814;-1;776;0;0;0;0;.00nan;0;0
814;82273;2182;43;16;3;13;.813;3600000;0
814;95405;776;48;24;4;20;.833;3563000;0
815;193854;777;64;25;3;22;.880;3545000;0
815;190702;3737;100;50;2;48;.960;3600000;0
815;192030;3737;0;0;0;0;.00nan;0;0
815;66924;777;0;0;0;0;.00nan;0;0
816;8487;783;59;27;3;24;.889;3600000;0
816;171673;778;58;34;5;29;.853;3523000;0
816;195942;783;0;0;0;0;.00nan;0;0
816;64066;778;0;0;0;0;.00nan;0;0
817;8107;780;43;27;4;23;.852;4200000;0
817;11490;798;63;37;4;33;.892;4200000;0
817;-1;780;0;0;0;0;.00nan;0;0
817;83199;798;0;0;0;0;.00nan;0;0
818;202497;2182;0;0;0;0;.00nan;0;0
818;-1;776;0;0;0;0;.00nan;0;0
818;82273;2182;79;23;1;22;.957;3600000;0
818;95405;776;71;41;4;37;.902;3600000;0
819;193854;777;93;20;0;20;1.000;3600000;0
819;190702;3737;46;24;4;20;.833;2238000;0
819;192030;3737;67;16;1;15;.938;1362000;0
819;66924;777;0;0;0;0;.00nan;0;0
820;8487;783;79;43;3;40;.930;3600000;0
820;171673;778;76;37;4;33;.892;3561000;0
820;195942;783;0;0;0;0;.00nan;0;0
820;64066;778;0;0;0;0;.00nan;0;0
821;8107;780;96;30;1;29;.967;3600000;0
821;11490;798;47;32;5;27;.844;3600000;0
821;-1;780;0;0;0;0;.00nan;0;0
821;83199;798;0;0;0;0;.00nan;0;0
822;202497;2182;0;0;0;0;.00nan;0;0
822;-1;776;52;6;1;5;.833;1666000;0
822;82273;2182;100;23;0;23;1.000;3600000;0
822;95405;776;54;27;4;23;.852;1934000;0
823;193854;777;30;18;4;14;.778;3560000;0
823;190702;3737;78;33;2;31;.939;3600000;0
823;192030;3737;0;0;0;0;.00nan;0;0
823;66924;777;0;0;0;0;.00nan;0;0
824;8487;783;80;25;1;24;.960;3600000;0
824;171673;778;61;38;5;33;.868;3600000;0
824;195942;783;0;0;0;0;.00nan;0;0
824;64066;778;0;0;0;0;.00nan;0;0
825;8107;780;85;32;1;31;.969;3600000;0
825;11490;798;32;24;5;19;.792;3600000;0
825;-1;780;0;0;0;0;.00nan;0;0
825;83199;798;0;0;0;0;.00nan;0;0
826;202497;2182;0;0;0;0;.00nan;0;0
826;-1;776;0;0;0;0;.00nan;0;0
826;82273;2182;63;27;3;24;.889;3600000;0
826;95405;776;64;36;4;32;.889;3582000;0
827;193854;777;78;38;3;35;.921;3600000;0
827;190702;3737;79;41;4;37;.902;3600000;0
827;192030;3737;0;0;0;0;.00nan;0;0
827;66924;777;0;0;0;0;.00nan;0;0
828;8487;783;56;32;5;27;.844;3600000;0
828;171673;778;66;25;3;22;.880;3600000;0
828;195942;783;0;0;0;0;.00nan;0;0
828;64066;778;0;0;0;0;.00nan;0;0
829;8107;780;58;16;2;14;.875;3544000;0
829;11490;798;79;26;1;25;.962;3600000;0
829;-1;780;0;0;0;0;.00nan;0;0
829;83199;798;0;0;0;0;.00nan;0;0
1189;193854;777;82;26;1;25;.962;3600000;0
1189;190702;3737;7;29;8;21;.724;2461000;0
1189;192030;3737;54;5;0;5;1.000;1139000;0
1189;66924;777;0;0;0;0;.00nan;0;0
1190;8487;783;51;29;5;24;.828;3600000;0
1190;171673;778;100;32;0;32;1.000;3600000;0
1190;195942;783;0;0;0;0;.00nan;0;0
1190;64066;778;0;0;0;0;.00nan;0;0
1191;8107;780;84;32;2;30;.938;3600000;0
1191;11490;798;70;34;3;31;.912;3583000;0
1191;-1;780;0;0;0;0;.00nan;0;0
1191;83199;798;0;0;0;0;.00nan;0;0
1244;193854;777;76;33;3;30;.909;3600000;0
1244;190702;3737;53;30;4;26;.867;3545000;0
1244;192030;3737;0;0;0;0;.00nan;0;0
1244;66924;777;0;0;0;0;.00nan;0;0
1245;8487;783;71;24;2;22;.917;3600000;0
1245;171673;778;34;32;6;26;.813;3600000;0
1245;195942;783;0;0;0;0;.00nan;0;0
1245;64066;778;0;0;0;0;.00nan;0;0
1271;8487;783;49;31;5;26;.839;3569000;0
1271;195942;783;0;0;0;0;.00nan;0;0
1271;202497;2182;0;0;0;0;.00nan;0;0
1271;82273;2182;54;25;3;22;.880;3600000;0
1272;8107;780;64;22;3;19;.864;3600000;0
1272;193854;777;77;25;2;23;.920;3600000;0
1272;-1;780;0;0;0;0;.00nan;0;0
1272;66924;777;0;0;0;0;.00nan;0;0
1273;8487;783;76;28;2;26;.929;3879000;0
1273;195942;783;0;0;0;0;.00nan;0;0
1273;202497;2182;0;0;0;0;.00nan;0;0
1273;82273;2182;76;24;1;23;.958;3879000;0
1274;8107;780;61;20;2;18;.900;3600000;0
1274;193854;777;70;31;4;27;.871;3600000;0
1274;-1;780;0;0;0;0;.00nan;0;0
1274;66924;777;0;0;0;0;.00nan;0;0
1275;8487;783;57;44;5;39;.886;3522000;0
1275;195942;783;0;0;0;0;.00nan;0;0
1275;202497;2182;0;0;0;0;.00nan;0;0
1275;82273;2182;68;31;4;27;.871;3600000;0
1276;8107;780;100;46;2;44;.957;3600000;0
1276;193854;777;62;27;3;24;.889;3544000;0
1276;-1;780;0;0;0;0;.00nan;0;0
1276;66924;777;0;0;0;0;.00nan;0;0
1277;8487;783;66;24;2;22;.917;4200000;0
1277;195942;783;0;0;0;0;.00nan;0;0
1277;202497;2182;0;0;0;0;.00nan;0;0
1277;82273;2182;55;23;2;21;.913;4200000;0
1278;8107;780;83;29;2;27;.931;4200000;0
1278;193854;777;82;31;2;29;.935;4200000;0
1278;-1;780;0;0;0;0;.00nan;0;0
1278;66924;777;0;0;0;0;.00nan;0;0
1543;8487;783;100;57;2;55;.965;4200000;0
1543;195942;783;0;0;0;0;.00nan;0;0
1543;202497;2182;0;0;0;0;.00nan;0;0
1543;82273;2182;97;41;2;39;.951;4200000;0
1544;8107;780;49;31;5;26;.839;2274000;0
1544;193854;777;68;21;2;19;.905;3600000;0
1544;-1;780;52;8;1;7;.875;1326000;0
1544;66924;777;0;0;0;0;.00nan;0;0
1596;8487;783;67;29;2;27;.931;3600000;0
1596;195942;783;0;0;0;0;.00nan;0;0
1596;202497;2182;0;0;0;0;.00nan;0;0
1596;82273;2182;97;33;1;32;.970;3600000;0
1597;8107;780;76;31;2;29;.935;3558000;0
1597;193854;777;86;29;1;28;.966;3600000;0
1597;-1;780;0;0;0;0;.00nan;0;0
1597;66924;777;0;0;0;0;.00nan;0;0
1635;193854;777;68;22;2;20;.909;4135000;0
1635;202497;2182;0;0;0;0;.00nan;0;0
1635;66924;777;0;0;0;0;.00nan;0;0
1635;82273;2182;83;38;3;35;.921;4135000;0
1636;193854;777;100;33;1;32;.970;3600000;0
1636;202497;2182;0;0;0;0;.00nan;0;0
1636;66924;777;0;0;0;0;.00nan;0;0
1636;82273;2182;76;28;2;26;.929;3586000;0
1637;193854;777;88;34;2;32;.941;3600000;0
1637;202497;2182;0;0;0;0;.00nan;0;0
1637;66924;777;0;0;0;0;.00nan;0;0
1637;82273;2182;68;39;4;35;.897;3538000;0
1638;193854;777;86;37;3;34;.919;3600000;0
1638;202497;2182;0;0;0;0;.00nan;0;0
1638;66924;777;0;0;0;0;.00nan;0;0
1638;82273;2182;49;27;4;23;.852;3557000;0
8350;10112;1423;0;0;0;0;.00nan;0;0
8350;27517;1423;90;49;2;47;.959;3600000;0
8350;-1;560;0;0;0;0;.00nan;0;0
8350;54860;560;68;29;3;26;.897;3600000;0
8351;180738;555;52;56;8;48;.857;3600000;0
8351;36115;555;0;0;0;0;.00nan;0;0
8351;-1;560;0;0;0;0;.00nan;0;0
8351;54860;560;69;24;2;22;.917;3600000;0
8352;4379;2626;79;37;2;35;.946;3600000;0
8352;28989;2626;0;0;0;0;.00nan;0;0
8352;-1;561;0;0;0;0;.00nan;0;0
8352;65324;561;34;36;7;29;.806;3600000;0
8353;75764;558;0;0;0;0;.00nan;0;0
8353;85395;558;69;42;4;38;.905;3600000;0
8353;86422;552;52;20;3;17;.850;3600000;0
8353;88692;552;0;0;0;0;.00nan;0;0
8354;4379;2626;90;34;1;33;.971;3600000;0
8354;28989;2626;0;0;0;0;.00nan;0;0
8354;80596;556;0;0;0;0;.00nan;0;0
8354;85349;556;53;30;4;26;.867;3600000;0
8355;2140;553;49;24;3;21;.875;3559000;0
8355;10112;1423;91;58;2;56;.966;3600000;0
8355;27517;1423;0;0;0;0;.00nan;0;0
8355;83252;553;0;0;0;0;.00nan;0;0
8356;4379;2626;0;0;0;0;.00nan;0;0
8356;28989;2626;85;47;3;44;.936;3600000;0
8356;80596;556;0;0;0;0;.00nan;0;0
8356;85349;556;59;27;4;23;.852;3571000;0
8357;180738;555;88;53;3;50;.943;3597000;0
8357;36115;555;0;0;0;0;.00nan;0;0
8357;-1;561;0;0;0;0;.00nan;0;0
8357;65324;561;74;23;2;21;.913;3600000;0
8358;-1;560;29;19;4;15;.789;1069000;0
8358;54860;560;98;35;0;35;1.000;2531000;0
8358;86422;552;100;26;0;26;1.000;3600000;0
8358;88692;552;0;0;0;0;.00nan;0;0
8359;4379;2626;72;34;3;31;.912;3600000;0
8359;28989;2626;0;0;0;0;.00nan;0;0
8359;180738;555;57;13;1;12;.923;882000;0
8359;36115;555;53;41;7;34;.829;2718000;0
8360;10112;1423;37;37;6;31;.838;3315000;0
8360;27517;1423;41;2;1;1;.500;285000;0
8360;75764;558;0;0;0;0;.00nan;0;0
8360;85395;558;98;25;0;25;1.000;3600000;0
8361;178789;554;0;0;0;0;.00nan;0;0
8361;-1;554;79;12;0;12;1.000;3600000;0
8361;180738;555;98;54;2;52;.963;3600000;0
8361;36115;555;0;0;0;0;.00nan;0;0
8362;-1;561;89;56;5;51;.911;3677000;0
8362;65324;561;0;0;0;0;.00nan;0;0
8362;86422;552;48;21;4;17;.810;3677000;0
8362;88692;552;0;0;0;0;.00nan;0;0
8363;178789;554;0;0;0;0;.00nan;0;0
8363;-1;554;58;34;3;31;.912;3900000;0
8363;86422;552;80;32;3;29;.906;3900000;0
8363;88692;552;0;0;0;0;.00nan;0;0
8364;10112;1423;68;47;5;42;.894;3600000;0
8364;27517;1423;0;0;0;0;.00nan;0;0
8364;-1;560;0;0;0;0;.00nan;0;0
8364;54860;560;86;17;0;17;1.000;3600000;0
8365;2140;553;66;41;5;36;.878;3600000;0
8365;178789;554;0;0;0;0;.00nan;0;0
8365;-1;554;83;15;0;15;1.000;3600000;0
8365;83252;553;0;0;0;0;.00nan;0;0
8366;-1;561;49;2;0;2;1.000;297000;0
8366;65324;561;39;43;7;36;.837;3303000;0
8366;80596;556;0;0;0;0;.00nan;0;0
8366;85349;556;68;24;2;22;.917;3600000;0
8367;-1;561;71;32;2;30;.938;3600000;0
8367;65324;561;0;0;0;0;.00nan;0;0
8367;75764;558;68;34;3;31;.912;3595000;0
8367;85395;558;0;0;0;0;.00nan;0;0
8368;-1;560;0;0;0;0;.00nan;0;0
8368;54860;560;100;34;0;34;1.000;3600000;0
8368;80596;556;51;29;4;25;.862;3600000;0
8368;85349;556;0;0;0;0;.00nan;0;0
8369;80596;556;0;0;0;0;.00nan;0;0
8369;85349;556;86;39;2;37;.949;3577000;0
8369;86422;552;100;40;0;40;1.000;3600000;0
8369;88692;552;0;0;0;0;.00nan;0;0
8370;-1;560;0;0;0;0;.00nan;0;0
8370;54860;560;73;28;2;26;.929;3600000;0
8370;75764;558;56;5;0;5;1.000;563000;0
8370;85395;558;30;34;6;28;.824;3037000;0
8371;4379;2626;83;49;3;46;.939;3597000;0
8371;163784;2626;0;0;0;0;.00nan;0;0
8371;86422;552;78;25;2;23;.920;3600000;0
8371;88692;552;0;0;0;0;.00nan;0;0
8372;10112;1423;0;0;0;0;.00nan;0;0
8372;183905;1423;68;39;4;35;.897;3900000;0
8372;178789;554;0;0;0;0;.00nan;0;0
8372;-1;554;50;20;4;16;.800;3900000;0
8373;2140;553;88;25;1;24;.960;3600000;0
8373;180738;555;89;45;4;41;.911;3600000;0
8373;36115;555;0;0;0;0;.00nan;0;0
8373;83252;553;0;0;0;0;.00nan;0;0
8374;-1;561;0;0;0;0;.00nan;0;0
8374;65324;561;71;45;4;41;.911;3587000;0
8374;80596;556;0;0;0;0;.00nan;0;0
8374;85349;556;87;39;3;36;.923;3600000;0
8375;4379;2626;0;0;0;0;.00nan;0;0
8375;163784;2626;92;38;1;37;.974;3600000;0
8375;86422;552;63;26;2;24;.923;3585000;0
8375;88692;552;0;0;0;0;.00nan;0;0
8376;2140;553;73;18;1;17;.944;2471000;0
8376;-1;560;0;0;0;0;.00nan;0;0
8376;54860;560;72;25;2;23;.920;3600000;0
8376;83252;553;22;10;4;6;.600;1129000;0
8377;2140;553;0;0;0;0;.00nan;0;0
8377;-1;561;0;0;0;0;.00nan;0;0
8377;65324;561;51;24;3;21;.875;3546000;0
8377;83252;553;80;32;2;30;.938;3600000;0
8378;2140;553;94;18;0;18;1.000;3600000;0
8378;4379;2626;41;35;6;29;.829;3339000;0
8378;163784;2626;48;0;0;0;.00nan;261000;0
8378;83252;553;0;0;0;0;.00nan;0;0
8379;178789;554;0;0;0;0;.00nan;0;0
8379;-1;554;67;26;3;23;.885;3586000;0
8379;80596;556;0;0;0;0;.00nan;0;0
8379;85349;556;81;32;2;30;.938;3600000;0
8380;180738;555;96;43;2;41;.953;3527000;0
8380;36115;555;0;0;0;0;.00nan;0;0
8380;75764;558;100;31;0;31;1.000;3600000;0
8380;85395;558;0;0;0;0;.00nan;0;0
8381;178789;554;0;0;0;0;.00nan;0;0
8381;-1;554;57;36;4;32;.889;3846000;0
8381;80596;556;64;36;3;33;.917;3846000;0
8381;85349;556;0;0;0;0;.00nan;0;0
8382;2140;553;92;32;1;31;.969;3600000;0
8382;-1;560;0;0;0;0;.00nan;0;0
8382;54860;560;52;47;6;41;.872;3600000;0
8382;83252;553;0;0;0;0;.00nan;0;0
8383;180738;555;0;0;0;0;.00nan;0;0
8383;36115;555;88;29;1;28;.966;3600000;0
8383;75764;558;0;0;0;0;.00nan;0;0
8383;85395;558;61;19;2;17;.895;3595000;0
8384;-1;561;0;0;0;0;.00nan;0;0
8384;65324;561;63;26;2;24;.923;3572000;0
8384;75764;558;99;25;0;25;1.000;3600000;0
8384;85395;558;0;0;0;0;.00nan;0;0
8385;80596;556;0;0;0;0;.00nan;0;0
8385;85349;556;78;22;1;21;.955;3900000;0
8385;86422;552;0;0;0;0;.00nan;0;0
8385;88692;552;100;36;1;35;.972;3900000;0
8386;4379;2626;0;0;0;0;.00nan;0;0
8386;163784;2626;59;15;2;13;.867;3600000;0
8386;10112;1423;0;0;0;0;.00nan;0;0
8386;183905;1423;64;45;5;40;.889;3600000;0
8387;178789;554;0;0;0;0;.00nan;0;0
8387;-1;554;38;27;5;22;.815;3600000;0
8387;180738;555;57;45;6;39;.867;3577000;0
8387;36115;555;0;0;0;0;.00nan;0;0
8388;10112;1423;0;0;0;0;.00nan;0;0
8388;183905;1423;80;65;6;59;.908;3600000;0
8388;80596;556;0;0;0;0;.00nan;0;0
8388;85349;556;58;18;2;16;.889;3600000;0
8389;2140;553;99;26;0;26;1.000;3600000;0
8389;75764;558;0;0;0;0;.00nan;0;0
8389;83252;553;0;0;0;0;.00nan;0;0
8389;85395;558;16;27;7;20;.741;3600000;0
8390;-1;561;0;0;0;0;.00nan;0;0
8390;65324;561;51;23;3;20;.870;3600000;0
8390;86422;552;80;25;1;24;.960;3600000;0
8390;88692;552;0;0;0;0;.00nan;0;0
8391;-1;560;0;0;0;0;.00nan;0;0
8391;54860;560;88;38;2;36;.947;3571000;0
8391;86422;552;70;21;1;20;.952;3600000;0
8391;88692;552;0;0;0;0;.00nan;0;0
8392;10112;1423;0;0;0;0;.00nan;0;0
8392;183905;1423;72;39;4;35;.897;3600000;0
8392;80596;556;73;17;1;16;.941;3600000;0
8392;85349;556;0;0;0;0;.00nan;0;0
8393;-1;561;58;33;4;29;.879;3513000;0
8393;65324;561;0;0;0;0;.00nan;0;0
8393;75764;558;83;30;2;28;.933;3600000;0
8393;85395;558;0;0;0;0;.00nan;0;0
8394;2140;553;87;21;1;20;.952;3900000;0
8394;180738;555;0;0;0;0;.00nan;0;0
8394;36115;555;97;37;1;36;.973;3900000;0
8394;83252;553;0;0;0;0;.00nan;0;0
8395;4379;2626;0;0;0;0;.00nan;0;0
8395;163784;2626;44;38;5;33;.868;3600000;0
8395;178789;554;0;0;0;0;.00nan;0;0
8395;-1;554;79;22;1;21;.955;3600000;0
8396;4379;2626;0;0;0;0;.00nan;0;0
8396;163784;2626;70;46;4;42;.913;3554000;0
8396;86422;552;69;24;2;22;.917;3600000;0
8396;88692;552;0;0;0;0;.00nan;0;0
8397;178789;554;0;0;0;0;.00nan;0;0
8397;-1;554;69;21;1;20;.952;3600000;0
8397;86422;552;68;34;4;30;.882;3600000;0
8397;88692;552;0;0;0;0;.00nan;0;0
8398;-1;561;0;0;0;0;.00nan;0;0
8398;65324;561;58;36;5;31;.861;3600000;0
8398;80596;556;0;0;0;0;.00nan;0;0
8398;85349;556;48;18;2;16;.889;3600000;0
8399;2140;553;87;37;2;35;.946;3600000;0
8399;75764;558;0;0;0;0;.00nan;0;0
8399;83252;553;0;0;0;0;.00nan;0;0
8399;85395;558;52;35;4;31;.886;3580000;0
8400;2140;553;0;0;0;0;.00nan;0;0
8400;-1;561;67;39;5;34;.872;3600000;0
8400;65324;561;0;0;0;0;.00nan;0;0
8400;83252;553;90;25;1;24;.960;3600000;0
8401;178789;554;0;0;0;0;.00nan;0;0
8401;-1;554;54;21;2;19;.905;3600000;0
8401;180738;555;33;31;6;25;.806;1744000;0
8401;36115;555;62;26;3;23;.885;1856000;0
8402;10112;1423;0;0;0;0;.00nan;0;0
8402;183905;1423;92;42;2;40;.952;3600000;0
8402;-1;560;85;25;1;24;.960;3600000;0
8402;54860;560;0;0;0;0;.00nan;0;0
8403;180738;555;81;36;3;33;.917;3568000;0
8403;36115;555;0;0;0;0;.00nan;0;0
8403;75764;558;74;28;2;26;.929;3600000;0
8403;85395;558;0;0;0;0;.00nan;0;0
8404;2140;553;96;20;0;20;1.000;3600000;0
8404;10112;1423;0;0;0;0;.00nan;0;0
8404;183905;1423;52;40;6;34;.850;3600000;0
8404;83252;553;0;0;0;0;.00nan;0;0
8405;180738;555;0;0;0;0;.00nan;0;0
8405;36115;555;90;37;1;36;.973;3600000;0
8405;80596;556;0;0;0;0;.00nan;0;0
8405;85349;556;50;24;3;21;.875;3585000;0
8406;178789;554;0;0;0;0;.00nan;0;0
8406;-1;554;45;19;3;16;.842;3733000;0
8406;-1;560;0;0;0;0;.00nan;0;0
8406;54860;560;92;57;4;53;.930;3733000;0
8407;2140;553;29;27;6;21;.778;3131000;0
8407;10112;1423;56;47;6;41;.872;3600000;0
8407;183905;1423;0;0;0;0;.00nan;0;0
8407;83252;553;41;3;1;2;.667;400000;0
8408;180738;555;98;62;2;60;.968;3600000;0
8408;36115;555;0;0;0;0;.00nan;0;0
8408;80596;556;69;22;1;21;.955;3600000;0
8408;85349;556;0;0;0;0;.00nan;0;0
8409;4379;2626;70;43;4;39;.907;3600000;0
8409;163784;2626;0;0;0;0;.00nan;0;0
8409;178789;554;0;0;0;0;.00nan;0;0
8409;-1;554;100;26;0;26;1.000;3600000;0
8410;-1;560;84;38;2;36;.947;3600000;0
8410;54860;560;0;0;0;0;.00nan;0;0
8410;75764;558;0;0;0;0;.00nan;0;0
8410;85395;558;81;28;1;27;.964;3600000;0
8411;10112;1423;0;0;0;0;.00nan;0;0
8411;183905;1423;46;37;6;31;.838;3900000;0
8411;180738;555;63;27;2;25;.926;2733000;0
8411;36115;555;41;22;4;18;.818;1167000;0
8412;4379;2626;0;0;0;0;.00nan;0;0
8412;163784;2626;48;39;5;34;.872;3516000;0
8412;80596;556;0;0;0;0;.00nan;0;0
8412;85349;556;60;28;3;25;.893;3600000;0
8413;178789;554;0;0;0;0;.00nan;0;0
8413;-1;554;50;30;5;25;.833;3600000;0
8413;75764;558;27;14;4;10;.714;927000;0
8413;85395;558;81;39;3;36;.923;2662000;0
8414;10112;1423;37;8;2;6;.750;957000;0
8414;183905;1423;37;34;6;28;.824;2643000;0
8414;80596;556;60;27;3;24;.889;3600000;0
8414;85349;556;0;0;0;0;.00nan;0;0
8415;2140;553;78;26;2;24;.923;3600000;0
8415;4379;2626;0;0;0;0;.00nan;0;0
8415;163784;2626;45;32;5;27;.844;3600000;0
8415;83252;553;0;0;0;0;.00nan;0;0
8416;2140;553;66;43;5;38;.884;3900000;0
8416;83252;553;0;0;0;0;.00nan;0;0
8416;86422;552;49;27;5;22;.815;3171000;0
8416;88692;552;56;2;0;2;1.000;729000;0
8417;4379;2626;0;0;0;0;.00nan;0;0
8417;163784;2626;70;40;4;36;.900;3600000;0
8417;75764;558;93;37;2;35;.946;3600000;0
8417;85395;558;0;0;0;0;.00nan;0;0
8418;180738;555;68;52;6;46;.885;3704000;0
8418;36115;555;0;0;0;0;.00nan;0;0
8418;-1;560;0;0;0;0;.00nan;0;0
8418;54860;560;20;17;5;12;.706;3704000;0
8419;178789;554;0;0;0;0;.00nan;0;0
8419;-1;554;81;29;1;28;.966;3600000;0
8419;-1;561;0;0;0;0;.00nan;0;0
8419;65324;561;88;38;2;36;.947;3553000;0
8420;178789;554;0;0;0;0;.00nan;0;0
8420;-1;554;63;25;3;22;.880;3600000;0
8420;75764;558;63;37;4;33;.892;3600000;0
8420;85395;558;0;0;0;0;.00nan;0;0
8421;-1;561;0;0;0;0;.00nan;0;0
8421;65324;561;83;37;2;35;.946;3600000;0
8421;86422;552;61;12;1;11;.917;3600000;0
8421;88692;552;0;0;0;0;.00nan;0;0
8422;-1;560;0;0;0;0;.00nan;0;0
8422;54860;560;71;28;3;25;.893;3600000;0
8422;80596;556;0;0;0;0;.00nan;0;0
8422;85349;556;44;21;4;17;.810;3547000;0
8423;2140;553;100;20;0;20;1.000;3600000;0
8423;10112;1423;0;0;0;0;.00nan;0;0
8423;183905;1423;67;52;5;47;.904;3600000;0
8423;83252;553;0;0;0;0;.00nan;0;0
8424;4379;2626;0;0;0;0;.00nan;0;0
8424;163784;2626;52;18;3;15;.833;3600000;0
8424;75764;558;38;18;4;14;.778;985000;0
8424;85395;558;47;23;3;20;.870;2615000;0
8425;178789;554;98;22;0;22;1.000;3600000;0
8425;-1;554;0;0;0;0;.00nan;0;0
8425;-1;560;0;0;0;0;.00nan;0;0
8425;54860;560;68;39;4;35;.897;3600000;0
8426;10112;1423;0;0;0;0;.00nan;0;0
8426;183905;1423;88;45;3;42;.933;3600000;0
8426;86422;552;0;0;0;0;.00nan;0;0
8426;88692;552;72;21;1;20;.952;3600000;0
8427;2140;553;93;33;1;32;.970;3600000;0
8427;180738;555;41;37;6;31;.838;3600000;0
8427;36115;555;0;0;0;0;.00nan;0;0
8427;83252;553;0;0;0;0;.00nan;0;0
8428;-1;561;85;39;2;37;.949;3600000;0
8428;65324;561;0;0;0;0;.00nan;0;0
8428;80596;556;80;37;3;34;.919;3544000;0
8428;85349;556;0;0;0;0;.00nan;0;0
8429;178789;554;78;26;1;25;.962;3600000;0
8429;-1;554;0;0;0;0;.00nan;0;0
8429;-1;561;0;0;0;0;.00nan;0;0
8429;65324;561;80;38;3;35;.921;3518000;0
8430;10112;1423;0;0;0;0;.00nan;0;0
8430;183905;1423;100;51;0;51;1.000;3600000;0
8430;178789;554;0;0;0;0;.00nan;0;0
8430;-1;554;55;10;1;9;.900;3580000;0
8431;80596;556;0;0;0;0;.00nan;0;0
8431;85349;556;73;23;1;22;.957;3600000;0
8431;86422;552;61;38;5;33;.868;3600000;0
8431;88692;552;0;0;0;0;.00nan;0;0
8432;2140;553;91;43;3;40;.930;3614000;0
8432;4379;2626;69;25;2;23;.920;3614000;0
8432;163784;2626;0;0;0;0;.00nan;0;0
8432;83252;553;0;0;0;0;.00nan;0;0
8433;180738;555;64;26;3;23;.885;3600000;0
8433;36115;555;0;0;0;0;.00nan;0;0
8433;-1;560;0;0;0;0;.00nan;0;0
8433;54860;560;94;35;2;33;.943;3600000;0
8434;10112;1423;0;0;0;0;.00nan;0;0
8434;183905;1423;77;39;3;36;.923;3822000;0
8434;-1;561;0;0;0;0;.00nan;0;0
8434;65324;561;64;35;4;31;.886;3822000;0
8435;2140;553;0;0;0;0;.00nan;0;0
8435;-1;560;0;0;0;0;.00nan;0;0
8435;54860;560;97;33;1;32;.970;3600000;0
8435;83252;553;58;21;2;19;.905;3545000;0
8436;75764;558;56;39;5;34;.872;2961000;0
8436;85395;558;19;9;4;5;.556;639000;0
8436;86422;552;0;0;0;0;.00nan;0;0
8436;88692;552;64;25;3;22;.880;3600000;0
8437;4379;2626;47;5;1;4;.800;744000;0
8437;163784;2626;21;30;7;23;.767;2856000;0
8437;178789;554;0;0;0;0;.00nan;0;0
8437;-1;554;75;25;1;24;.960;3600000;0
8438;4379;2626;50;36;5;31;.861;3600000;0
8438;163784;2626;0;0;0;0;.00nan;0;0
8438;178789;554;60;26;3;23;.885;3600000;0
8438;-1;554;0;0;0;0;.00nan;0;0
8439;80596;556;0;0;0;0;.00nan;0;0
8439;85349;556;53;36;4;32;.889;3600000;0
8439;86422;552;100;36;0;36;1.000;3600000;0
8439;88692;552;0;0;0;0;.00nan;0;0
8440;10112;1423;0;0;0;0;.00nan;0;0
8440;183905;1423;97;45;2;43;.956;3593000;0
8440;75764;558;94;34;1;33;.971;3600000;0
8440;85395;558;0;0;0;0;.00nan;0;0
8441;180738;555;65;43;5;38;.884;3545000;0
8441;36115;555;0;0;0;0;.00nan;0;0
8441;-1;561;0;0;0;0;.00nan;0;0
8441;65324;561;47;22;4;18;.818;3600000;0
8442;2037;560;0;0;0;0;.00nan;0;0
8442;2140;553;91;31;1;30;.968;3600000;0
8442;54860;560;87;30;2;28;.933;3582000;0
8442;83252;553;0;0;0;0;.00nan;0;0
8443;10112;1423;0;0;0;0;.00nan;0;0
8443;183905;1423;89;41;2;39;.951;3559000;0
8443;75764;558;0;0;0;0;.00nan;0;0
8443;85395;558;99;29;0;29;1.000;3600000;0
8444;2037;560;0;0;0;0;.00nan;0;0
8444;54860;560;87;45;4;41;.911;3577000;0
8444;80596;556;64;20;2;18;.900;3600000;0
8444;85349;556;0;0;0;0;.00nan;0;0
8445;2140;553;0;0;0;0;.00nan;0;0
8445;83252;553;64;50;6;44;.880;3600000;0
8445;86422;552;61;26;3;23;.885;3600000;0
8445;88692;552;0;0;0;0;.00nan;0;0
8446;180738;555;0;0;0;0;.00nan;0;0
8446;36115;555;86;38;1;37;.974;3900000;0
8446;-1;561;82;28;1;27;.964;3900000;0
8446;65324;561;0;0;0;0;.00nan;0;0
8447;2140;553;40;27;5;22;.815;2114000;0
8447;178789;554;0;0;0;0;.00nan;0;0
8447;-1;554;100;33;0;33;1.000;3600000;0
8447;83252;553;48;10;2;8;.800;1486000;0
8448;75764;558;68;17;1;16;.941;1123000;0
8448;85395;558;42;36;6;30;.833;2477000;0
8448;86422;552;96;22;0;22;1.000;3600000;0
8448;88692;552;0;0;0;0;.00nan;0;0
8449;10112;1423;0;0;0;0;.00nan;0;0
8449;183905;1423;73;30;2;28;.933;3600000;0
8449;180738;555;90;35;1;34;.971;3600000;0
8449;36115;555;0;0;0;0;.00nan;0;0
8450;4379;2626;0;0;0;0;.00nan;0;0
8450;163784;2626;62;34;4;30;.882;3900000;0
8450;-1;561;0;0;0;0;.00nan;0;0
8450;65324;561;67;36;4;32;.889;3900000;0
8451;2140;553;96;46;3;43;.935;3600000;0
8451;178789;554;0;0;0;0;.00nan;0;0
8451;-1;554;94;19;0;19;1.000;3600000;0
8451;83252;553;0;0;0;0;.00nan;0;0
8452;75764;558;69;30;3;27;.900;2836000;0
8452;80596;556;0;0;0;0;.00nan;0;0
8452;85349;556;60;32;4;28;.875;3600000;0
8452;85395;558;29;12;4;8;.667;764000;0
8453;10112;1423;0;0;0;0;.00nan;0;0
8453;183905;1423;85;43;4;39;.907;3600000;0
8453;180738;555;97;45;3;42;.933;3600000;0
8453;36115;555;0;0;0;0;.00nan;0;0
8454;4379;2626;45;36;5;31;.861;3531000;0
8454;163784;2626;0;0;0;0;.00nan;0;0
8454;-1;561;0;0;0;0;.00nan;0;0
8454;65324;561;54;25;3;22;.880;3600000;0
8455;-1;560;0;0;0;0;.00nan;0;0
8455;54860;560;66;48;5;43;.896;3557000;0
8455;86422;552;50;20;3;17;.850;3600000;0
8455;88692;552;0;0;0;0;.00nan;0;0
8456;10112;1423;0;0;0;0;.00nan;0;0
8456;183905;1423;79;52;5;47;.904;3600000;0
8456;86422;552;66;17;1;16;.941;3600000;0
8456;88692;552;0;0;0;0;.00nan;0;0
8457;2140;553;94;39;3;36;.923;3600000;0
8457;80596;556;0;0;0;0;.00nan;0;0
8457;83252;553;0;0;0;0;.00nan;0;0
8457;85349;556;14;18;6;12;.667;3600000;0
8458;178789;554;0;0;0;0;.00nan;0;0
8458;-1;554;73;26;2;24;.923;3600000;0
8458;75764;558;0;0;0;0;.00nan;0;0
8458;85395;558;46;25;4;21;.840;3513000;0
8459;4379;2626;0;0;0;0;.00nan;0;0
8459;163784;2626;66;24;2;22;.917;3600000;0
8459;180738;555;82;47;5;42;.894;3600000;0
8459;36115;555;0;0;0;0;.00nan;0;0
8460;-1;561;0;0;0;0;.00nan;0;0
8460;-1;560;44;4;1;3;.750;325000;0
8460;54860;560;47;36;6;30;.833;3275000;0
8460;65324;561;93;25;1;24;.960;3600000;0
8461;10112;1423;0;0;0;0;.00nan;0;0
8461;183905;1423;98;53;3;50;.943;3575000;0
8461;86422;552;82;25;1;24;.960;3600000;0
8461;88692;552;0;0;0;0;.00nan;0;0
8462;2140;553;0;0;0;0;.00nan;0;0
8462;80596;556;65;32;3;29;.906;3551000;0
8462;83252;553;82;40;2;38;.950;3600000;0
8462;85349;556;0;0;0;0;.00nan;0;0
8463;4379;2626;0;0;0;0;.00nan;0;0
8463;163784;2626;93;27;1;26;.963;3900000;0
8463;180738;555;0;0;0;0;.00nan;0;0
8463;36115;555;96;52;1;51;.981;3900000;0
8464;-1;561;64;22;2;20;.909;3600000;0
8464;-1;560;0;0;0;0;.00nan;0;0
8464;54860;560;53;25;3;22;.880;3560000;0
8464;65324;561;0;0;0;0;.00nan;0;0
8465;178789;554;75;30;2;28;.933;3600000;0
8465;-1;554;0;0;0;0;.00nan;0;0
8465;75764;558;0;0;0;0;.00nan;0;0
8465;85395;558;94;43;3;40;.930;3565000;0
8466;178789;554;0;0;0;0;.00nan;0;0
8466;-1;554;80;26;2;24;.923;3600000;0
8466;80596;556;0;0;0;0;.00nan;0;0
8466;85349;556;64;41;5;36;.878;3600000;0
8467;10112;1423;49;2;0;2;1.000;404000;0
8467;183905;1423;3;27;8;19;.704;3196000;0
8467;-1;561;0;0;0;0;.00nan;0;0
8467;65324;561;70;20;1;19;.950;3600000;0
8468;2140;553;73;20;1;19;.950;3600000;0
8468;75764;558;69;37;3;34;.919;3548000;0
8468;83252;553;0;0;0;0;.00nan;0;0
8468;85395;558;0;0;0;0;.00nan;0;0
8469;180738;555;63;48;6;42;.875;2842000;0
8469;36115;555;47;7;1;6;.857;758000;0
8469;86422;552;69;6;0;6;1.000;3600000;0
8469;88692;552;0;0;0;0;.00nan;0;0
8470;4379;2626;0;0;0;0;.00nan;0;0
8470;163784;2626;45;33;5;28;.848;3540000;0
8470;-1;560;0;0;0;0;.00nan;0;0
8470;54860;560;77;31;3;28;.903;3600000;0
8471;180738;555;45;15;3;12;.800;600000;0
8471;36115;555;98;51;2;49;.961;3000000;0
8471;86422;552;66;5;0;5;1.000;3600000;0
8471;88692;552;0;0;0;0;.00nan;0;0
8472;178789;554;100;27;0;27;1.000;3600000;0
8472;-1;554;0;0;0;0;.00nan;0;0
8472;80596;556;81;28;1;27;.964;3568000;0
8472;85349;556;0;0;0;0;.00nan;0;0
8473;2140;553;0;0;0;0;.00nan;0;0
8473;75764;558;0;0;0;0;.00nan;0;0
8473;83252;553;49;30;4;26;.867;3577000;0
8473;85395;558;87;42;2;40;.952;3600000;0
8474;10112;1423;0;0;0;0;.00nan;0;0
8474;183905;1423;82;67;6;61;.910;3600000;0
8474;-1;561;0;0;0;0;.00nan;0;0
8474;65324;561;81;15;0;15;1.000;3600000;0
8475;4379;2626;96;18;0;18;1.000;3600000;0
8475;163784;2626;0;0;0;0;.00nan;0;0
8475;-1;560;0;0;0;0;.00nan;0;0
8475;54860;560;65;33;3;30;.909;3600000;0
8476;75764;558;0;0;0;0;.00nan;0;0
8476;80596;556;0;0;0;0;.00nan;0;0
8476;85349;556;89;18;0;18;1.000;3600000;0
8476;85395;558;35;40;7;33;.825;3600000;0
8477;-1;560;65;29;3;26;.897;3141000;0
8477;54860;560;31;10;3;7;.700;459000;0
8477;75764;558;0;0;0;0;.00nan;0;0
8477;85395;558;57;19;3;16;.842;3600000;0
8478;2140;553;71;37;4;33;.892;3565000;0
8478;178789;554;76;31;2;29;.935;3600000;0
8478;-1;554;0;0;0;0;.00nan;0;0
8478;83252;553;0;0;0;0;.00nan;0;0
8479;10112;1423;0;0;0;0;.00nan;0;0
8479;183905;1423;54;44;6;38;.864;3600000;0
8479;80596;556;0;0;0;0;.00nan;0;0
8479;85349;556;51;14;2;12;.857;3600000;0
8480;4379;2626;45;40;6;34;.850;3600000;0
8480;163784;2626;0;0;0;0;.00nan;0;0
8480;86422;552;63;23;2;21;.913;3600000;0
8480;88692;552;0;0;0;0;.00nan;0;0
8481;180738;555;94;53;3;50;.943;3600000;0
8481;36115;555;0;0;0;0;.00nan;0;0
8481;-1;561;0;0;0;0;.00nan;0;0
8481;65324;561;57;18;2;16;.889;3600000;0
8482;-1;560;0;0;0;0;.00nan;0;0
8482;54860;560;100;40;0;40;1.000;3600000;0
8482;75764;558;0;0;0;0;.00nan;0;0
8482;85395;558;45;21;3;18;.857;3600000;0
8483;178789;554;0;0;0;0;.00nan;0;0
8483;-1;554;62;39;5;34;.872;3525000;0
8483;86422;552;59;24;3;21;.875;3600000;0
8483;88692;552;0;0;0;0;.00nan;0;0
8484;4379;2626;0;0;0;0;.00nan;0;0
8484;163784;2626;59;21;3;18;.857;3600000;0
8484;10112;1423;79;43;4;39;.907;3574000;0
8484;183905;1423;0;0;0;0;.00nan;0;0
8485;2140;553;69;31;3;28;.903;3600000;0
8485;-1;561;76;30;2;28;.933;3600000;0
8485;65324;561;0;0;0;0;.00nan;0;0
8485;83252;553;0;0;0;0;.00nan;0;0
8486;180738;555;0;0;0;0;.00nan;0;0
8486;36115;555;80;48;5;43;.896;3600000;0
8486;80596;556;0;0;0;0;.00nan;0;0
8486;85349;556;55;17;2;15;.882;3600000;0
8487;178789;554;0;0;0;0;.00nan;0;0
8487;-1;554;99;35;1;34;.971;3900000;0
8487;-1;561;0;0;0;0;.00nan;0;0
8487;65324;561;97;43;1;42;.977;3900000;0
8488;178789;554;59;22;2;20;.909;3600000;0
8488;-1;554;0;0;0;0;.00nan;0;0
8488;-1;561;77;32;3;29;.906;3600000;0
8488;65324;561;0;0;0;0;.00nan;0;0
8489;75764;558;0;0;0;0;.00nan;0;0
8489;80596;556;0;0;0;0;.00nan;0;0
8489;85349;556;42;23;4;19;.826;3558000;0
8489;85395;558;91;37;2;35;.946;3600000;0
8490;2140;553;74;9;0;9;1.000;3600000;0
8490;180738;555;74;46;4;42;.913;3600000;0
8490;36115;555;0;0;0;0;.00nan;0;0
8490;83252;553;0;0;0;0;.00nan;0;0
8491;4379;2626;0;0;0;0;.00nan;0;0
8491;163784;2626;89;31;1;30;.968;3900000;0
8491;-1;560;0;0;0;0;.00nan;0;0
8491;54860;560;94;27;1;26;.963;3900000;0
8492;2140;553;99;32;1;31;.969;3600000;0
8492;10112;1423;0;0;0;0;.00nan;0;0
8492;183905;1423;67;36;4;32;.889;3600000;0
8492;83252;553;0;0;0;0;.00nan;0;0
8493;4379;2626;73;12;0;12;1.000;3600000;0
8493;163784;2626;0;0;0;0;.00nan;0;0
8493;180738;555;0;0;0;0;.00nan;0;0
8493;36115;555;84;49;5;44;.898;3600000;0
8494;-1;560;100;42;1;41;.976;3900000;0
8494;54860;560;0;0;0;0;.00nan;0;0
8494;80596;556;0;0;0;0;.00nan;0;0
8494;85349;556;60;14;1;13;.929;3900000;0
8495;80596;556;0;0;0;0;.00nan;0;0
8495;85349;556;65;40;5;35;.875;3600000;0
8495;86422;552;76;22;1;21;.955;3600000;0
8495;88692;552;0;0;0;0;.00nan;0;0
8496;2140;553;61;40;5;35;.875;3600000;0
8496;-1;560;0;0;0;0;.00nan;0;0
8496;54860;560;100;32;0;32;1.000;3600000;0
8496;83252;553;0;0;0;0;.00nan;0;0
8497;180738;555;100;33;0;33;1.000;3600000;0
8497;36115;555;0;0;0;0;.00nan;0;0
8497;75764;558;0;0;0;0;.00nan;0;0
8497;85395;558;60;16;1;15;.938;3557000;0
8498;4379;2626;64;20;2;18;.900;3600000;0
8498;163784;2626;0;0;0;0;.00nan;0;0
8498;10112;1423;0;0;0;0;.00nan;0;0
8498;183905;1423;93;48;3;45;.938;3549000;0
8499;178789;554;0;0;0;0;.00nan;0;0
8499;-1;554;86;29;1;28;.966;3600000;0
8499;-1;561;100;28;0;28;1.000;3600000;0
8499;65324;561;0;0;0;0;.00nan;0;0
8500;10112;1423;100;54;1;53;.981;3675000;0
8500;183905;1423;0;0;0;0;.00nan;0;0
8500;178789;554;47;11;2;9;.818;3675000;0
8500;-1;554;0;0;0;0;.00nan;0;0
8501;-1;561;37;27;5;22;.815;3600000;0
8501;65324;561;0;0;0;0;.00nan;0;0
8501;80596;556;46;24;4;20;.833;3600000;0
8501;85349;556;0;0;0;0;.00nan;0;0
8502;180738;555;72;46;5;41;.891;3600000;0
8502;36115;555;0;0;0;0;.00nan;0;0
8502;86422;552;89;20;0;20;1.000;3600000;0
8502;88692;552;0;0;0;0;.00nan;0;0
8503;4379;2626;0;0;0;0;.00nan;0;0
8503;163784;2626;69;31;3;28;.903;3600000;0
8503;75764;558;0;0;0;0;.00nan;0;0
8503;85395;558;100;32;0;32;1.000;3600000;0
8504;2140;553;69;21;1;20;.952;3600000;0
8504;-1;560;0;0;0;0;.00nan;0;0
8504;54860;560;62;40;5;35;.875;3600000;0
8504;83252;553;0;0;0;0;.00nan;0;0
8505;10112;1423;0;0;0;0;.00nan;0;0
8505;183905;1423;98;57;3;54;.947;3600000;0
8505;178789;554;0;0;0;0;.00nan;0;0
8505;-1;554;50;9;1;8;.889;3600000;0
8506;180738;555;97;57;1;56;.982;3900000;0
8506;36115;555;0;0;0;0;.00nan;0;0
8506;86422;552;72;20;1;19;.950;3900000;0
8506;88692;552;0;0;0;0;.00nan;0;0
8507;2140;553;75;31;3;28;.903;3600000;0
8507;80596;556;0;0;0;0;.00nan;0;0
8507;83252;553;0;0;0;0;.00nan;0;0
8507;85349;556;45;26;4;22;.846;3577000;0
8508;4379;2626;72;22;1;21;.955;3600000;0
8508;163784;2626;0;0;0;0;.00nan;0;0
8508;75764;558;0;0;0;0;.00nan;0;0
8508;85395;558;74;33;3;30;.909;3560000;0
8509;-1;561;70;25;1;24;.960;3600000;0
8509;-1;560;0;0;0;0;.00nan;0;0
8509;54860;560;75;39;3;36;.923;3548000;0
8509;65324;561;0;0;0;0;.00nan;0;0
8510;10112;1423;62;49;6;43;.878;3600000;0
8510;183905;1423;0;0;0;0;.00nan;0;0
8510;75764;558;0;0;0;0;.00nan;0;0
8510;85395;558;84;23;1;22;.957;3600000;0
8511;2140;553;0;0;0;0;.00nan;0;0
8511;83252;553;74;31;3;28;.903;3600000;0
8511;86422;552;100;27;1;26;.963;3600000;0
8511;88692;552;0;0;0;0;.00nan;0;0
8512;178789;554;80;11;0;11;1.000;3600000;0
8512;-1;554;0;0;0;0;.00nan;0;0
8512;180738;555;0;0;0;0;.00nan;0;0
8512;36115;555;97;59;4;55;.932;3600000;0
8513;4379;2626;0;0;0;0;.00nan;0;0
8513;163784;2626;64;33;3;30;.909;3900000;0
8513;-1;561;88;33;3;30;.909;3900000;0
8513;65324;561;0;0;0;0;.00nan;0;0
8514;-1;560;75;41;3;38;.927;3600000;0
8514;54860;560;0;0;0;0;.00nan;0;0
8514;80596;556;100;24;0;24;1.000;3600000;0
8514;85349;556;0;0;0;0;.00nan;0;0
8515;-1;560;0;0;0;0;.00nan;0;0
8515;54860;560;53;31;5;26;.839;3600000;0
8515;75764;558;0;0;0;0;.00nan;0;0
8515;85395;558;82;14;0;14;1.000;3600000;0
8516;178789;554;75;28;2;26;.929;3600000;0
8516;-1;554;0;0;0;0;.00nan;0;0
8516;86422;552;85;41;4;37;.902;3566000;0
8516;88692;552;0;0;0;0;.00nan;0;0
8517;180738;555;30;9;3;6;.667;459000;0
8517;36115;555;88;42;2;40;.952;3141000;0
8517;80596;556;54;15;2;13;.867;3600000;0
8517;85349;556;0;0;0;0;.00nan;0;0
8518;2140;553;64;27;2;25;.926;3600000;0
8518;4379;2626;0;0;0;0;.00nan;0;0
8518;163784;2626;60;26;3;23;.885;3566000;0
8518;83252;553;0;0;0;0;.00nan;0;0
8519;10112;1423;0;0;0;0;.00nan;0;0
8519;183905;1423;82;36;2;34;.944;3600000;0
8519;-1;561;51;25;4;21;.840;3596000;0
8519;65324;561;0;0;0;0;.00nan;0;0
8520;-1;560;0;0;0;0;.00nan;0;0
8520;54860;560;70;37;4;33;.892;3600000;0
8520;75764;558;0;0;0;0;.00nan;0;0
8520;85395;558;43;32;5;27;.844;3543000;0
8521;178789;554;100;24;0;24;1.000;3600000;0
8521;-1;554;0;0;0;0;.00nan;0;0
8521;86422;552;69;38;4;34;.895;3600000;0
8521;88692;552;0;0;0;0;.00nan;0;0
8522;10112;1423;0;0;0;0;.00nan;0;0
8522;183905;1423;97;45;1;44;.978;3595000;0
8522;-1;561;100;33;0;33;1.000;3600000;0
8522;65324;561;0;0;0;0;.00nan;0;0
8523;2140;553;0;0;0;0;.00nan;0;0
8523;4379;2626;95;38;1;37;.974;3600000;0
8523;163784;2626;0;0;0;0;.00nan;0;0
8523;83252;553;29;26;5;21;.808;3600000;0
8524;10112;1423;98;26;0;26;1.000;1367000;0
8524;183905;1423;43;40;6;34;.850;2233000;0
8524;86422;552;88;18;0;18;1.000;3600000;0
8524;88692;552;0;0;0;0;.00nan;0;0
8525;2140;553;80;34;2;32;.941;3900000;0
8525;-1;561;61;27;2;25;.926;3900000;0
8525;65324;561;0;0;0;0;.00nan;0;0
8525;83252;553;0;0;0;0;.00nan;0;0
8526;178789;554;50;15;2;13;.867;3600000;0
8526;-1;554;0;0;0;0;.00nan;0;0
8526;75764;558;30;29;6;23;.793;1836000;0
8526;85395;558;62;18;2;16;.889;1764000;0
8527;180738;555;63;50;6;44;.880;2977000;0
8527;36115;555;59;9;0;9;1.000;623000;0
8527;80596;556;0;0;0;0;.00nan;0;0
8527;85349;556;70;20;1;19;.950;3600000;0
8528;4379;2626;37;28;6;22;.786;3575000;0
8528;163784;2626;0;0;0;0;.00nan;0;0
8528;-1;560;0;0;0;0;.00nan;0;0
8528;54860;560;68;42;5;37;.881;3600000;0
8529;10112;1423;0;0;0;0;.00nan;0;0
8529;183905;1423;71;30;2;28;.933;3600000;0
8529;-1;560;0;0;0;0;.00nan;0;0
8529;54860;560;68;34;3;31;.912;3600000;0
8530;178789;554;94;31;1;30;.968;3600000;0
8530;-1;554;0;0;0;0;.00nan;0;0
8530;80596;556;0;0;0;0;.00nan;0;0
8530;85349;556;80;40;2;38;.950;3593000;0
8531;2140;553;72;35;3;32;.914;3600000;0
8531;180738;555;0;0;0;0;.00nan;0;0
8531;36115;555;99;44;1;43;.977;3600000;0
8531;83252;553;0;0;0;0;.00nan;0;0
8532;4379;2626;0;0;0;0;.00nan;0;0
8532;163784;2626;58;29;4;25;.862;3600000;0
8532;86422;552;60;14;1;13;.929;3600000;0
8532;88692;552;0;0;0;0;.00nan;0;0
8533;-1;561;93;34;1;33;.971;3600000;0
8533;65324;561;0;0;0;0;.00nan;0;0
8533;75764;558;0;0;0;0;.00nan;0;0
8533;85395;558;49;28;4;24;.857;3600000;0
8534;2140;553;74;37;3;34;.919;3900000;0
8534;83252;553;0;0;0;0;.00nan;0;0
8534;86422;552;61;29;3;26;.897;3900000;0
8534;88692;552;0;0;0;0;.00nan;0;0
8535;10112;1423;0;0;0;0;.00nan;0;0
8535;183905;1423;61;44;5;39;.886;3600000;0
8535;75764;558;0;0;0;0;.00nan;0;0
8535;85395;558;34;23;6;17;.739;3592000;0
8536;-1;561;90;37;2;35;.946;3600000;0
8536;-1;561;0;0;0;0;.00nan;0;0
8536;80596;556;0;0;0;0;.00nan;0;0
8536;85349;556;54;31;4;27;.871;3600000;0
8537;180738;555;67;37;4;33;.892;3600000;0
8537;-1;560;0;0;0;0;.00nan;0;0
8537;54860;560;84;23;1;22;.957;3600000;0
8537;157845;555;0;0;0;0;.00nan;0;0
8538;10112;1423;73;40;4;36;.900;3587000;0
8538;183905;1423;0;0;0;0;.00nan;0;0
8538;75764;558;0;0;0;0;.00nan;0;0
8538;85395;558;63;18;2;16;.889;3600000;0
8539;10112;1423;0;0;0;0;.00nan;0;0
8539;183905;1423;78;29;2;27;.931;3600000;0
8539;180738;555;12;21;7;14;.667;2137000;0
8539;36115;555;51;2;0;2;1.000;1463000;0
8540;2140;553;87;41;3;38;.927;3548000;0
8540;83252;553;0;0;0;0;.00nan;0;0
8540;86422;552;67;20;1;19;.950;3600000;0
8540;88692;552;0;0;0;0;.00nan;0;0
8541;4379;2626;100;34;1;33;.971;3900000;0
8541;163784;2626;0;0;0;0;.00nan;0;0
8541;80596;556;0;0;0;0;.00nan;0;0
8541;85349;556;84;29;1;28;.966;3900000;0
8542;-1;561;62;29;3;26;.897;3600000;0
8542;-1;560;62;32;3;29;.906;3144000;0
8542;54860;560;34;12;3;9;.750;456000;0
8542;65324;561;0;0;0;0;.00nan;0;0
8543;4379;2626;0;0;0;0;.00nan;0;0
8543;163784;2626;59;40;4;36;.900;3600000;0
8543;178789;554;88;25;0;25;1.000;3600000;0
8543;-1;554;0;0;0;0;.00nan;0;0
8544;80596;556;83;36;2;34;.944;3563000;0
8544;85349;556;0;0;0;0;.00nan;0;0
8544;86422;552;100;24;0;24;1.000;3600000;0
8544;88692;552;0;0;0;0;.00nan;0;0
8545;180738;555;92;35;2;33;.943;3600000;0
8545;36115;555;0;0;0;0;.00nan;0;0
8545;-1;560;0;0;0;0;.00nan;0;0
8545;54860;560;69;33;4;29;.879;3542000;0
8546;2140;553;74;34;2;32;.941;3900000;0
8546;-1;561;69;30;2;28;.933;3900000;0
8546;65324;561;0;0;0;0;.00nan;0;0
8546;83252;553;0;0;0;0;.00nan;0;0
8547;2140;553;93;25;1;24;.960;3600000;0
8547;4379;2626;44;29;5;24;.828;3600000;0
8547;163784;2626;0;0;0;0;.00nan;0;0
8547;83252;553;0;0;0;0;.00nan;0;0
8548;2140;553;67;31;3;28;.903;3547000;0
8548;178789;554;58;14;2;12;.857;3600000;0
8548;-1;554;0;0;0;0;.00nan;0;0
8548;83252;553;0;0;0;0;.00nan;0;0
8549;-1;560;0;0;0;0;.00nan;0;0
8549;54860;560;60;34;4;30;.882;3561000;0
8549;86422;552;50;23;3;20;.870;3600000;0
8549;88692;552;0;0;0;0;.00nan;0;0
8550;10112;1423;0;0;0;0;.00nan;0;0
8550;183905;1423;97;42;2;40;.952;3560000;0
8550;80596;556;0;0;0;0;.00nan;0;0
8550;85349;556;73;19;1;18;.947;3600000;0
8551;-1;561;62;22;2;20;.909;3540000;0
8551;65324;561;0;0;0;0;.00nan;0;0
8551;75764;558;0;0;0;0;.00nan;0;0
8551;85395;558;100;32;0;32;1.000;3600000;0
8552;4379;2626;0;0;0;0;.00nan;0;0
8552;163784;2626;100;29;0;29;1.000;3600000;0
8552;180738;555;89;37;2;35;.946;3528000;0
8552;36115;555;0;0;0;0;.00nan;0;0
8553;75764;558;0;0;0;0;.00nan;0;0
8553;80596;556;54;21;3;18;.857;3600000;0
8553;85349;556;0;0;0;0;.00nan;0;0
8553;85395;558;70;41;4;37;.902;3562000;0
8554;180738;555;55;42;6;36;.857;3207000;0
8554;36115;555;58;6;0;6;1.000;393000;0
8554;86422;552;89;24;1;23;.958;3600000;0
8554;88692;552;0;0;0;0;.00nan;0;0
8555;178789;554;50;17;2;15;.882;3600000;0
8555;-1;554;0;0;0;0;.00nan;0;0
8555;-1;561;98;37;1;36;.973;3600000;0
8555;65324;561;0;0;0;0;.00nan;0;0
8556;10112;1423;0;0;0;0;.00nan;0;0
8556;183905;1423;62;37;4;33;.892;3600000;0
8556;-1;560;66;16;1;15;.938;3600000;0
8556;54860;560;0;0;0;0;.00nan;0;0
8557;10112;1423;0;0;0;0;.00nan;0;0
8557;183905;1423;81;67;5;62;.925;3600000;0
8557;178789;554;56;27;4;23;.852;3600000;0
8557;-1;554;0;0;0;0;.00nan;0;0
8558;180738;555;97;56;4;52;.929;3600000;0
8558;36115;555;0;0;0;0;.00nan;0;0
8558;86422;552;61;12;1;11;.917;3600000;0
8558;88692;552;0;0;0;0;.00nan;0;0
8559;2140;553;47;18;3;15;.833;3600000;0
8559;75764;558;0;0;0;0;.00nan;0;0
8559;83252;553;0;0;0;0;.00nan;0;0
8559;85395;558;68;46;5;41;.891;3538000;0
8560;4379;2626;0;0;0;0;.00nan;0;0
8560;163784;2626;48;34;5;29;.853;3600000;0
8560;80596;556;0;0;0;0;.00nan;0;0
8560;85349;556;94;31;1;30;.968;3600000;0
8561;10112;1423;55;53;6;47;.887;3261000;0
8561;183905;1423;58;9;1;8;.889;339000;0
8561;178789;554;92;27;1;26;.963;3600000;0
8561;-1;554;0;0;0;0;.00nan;0;0
8562;2140;553;0;0;0;0;.00nan;0;0
8562;75764;558;0;0;0;0;.00nan;0;0
8562;83252;553;59;23;2;21;.913;3600000;0
8562;85395;558;54;31;4;27;.871;3600000;0
8563;-1;561;52;21;3;18;.857;3600000;0
8563;65324;561;0;0;0;0;.00nan;0;0
8563;86422;552;50;37;5;32;.865;3540000;0
8563;88692;552;0;0;0;0;.00nan;0;0
8564;4379;2626;47;31;5;26;.839;3600000;0
8564;163784;2626;0;0;0;0;.00nan;0;0
8564;-1;560;0;0;0;0;.00nan;0;0
8564;54860;560;77;29;2;27;.931;3600000;0
8565;-1;560;73;46;5;41;.891;3600000;0
8565;54860;560;0;0;0;0;.00nan;0;0
8565;80596;556;0;0;0;0;.00nan;0;0
8565;85349;556;63;15;1;14;.933;3600000;0
8566;-1;561;56;21;2;19;.905;3600000;0
8566;180738;555;0;0;0;0;.00nan;0;0
8566;36115;555;83;44;3;41;.932;3557000;0
8566;65324;561;0;0;0;0;.00nan;0;0
8567;10112;1423;0;0;0;0;.00nan;0;0
8567;183905;1423;94;46;3;43;.935;3556000;0
8567;86422;552;61;13;1;12;.923;3600000;0
8567;88692;552;0;0;0;0;.00nan;0;0
8568;-1;561;69;16;1;15;.938;3600000;0
8568;180738;555;69;50;6;44;.880;3600000;0
8568;36115;555;0;0;0;0;.00nan;0;0
8568;65324;561;0;0;0;0;.00nan;0;0
8569;-1;561;81;31;3;28;.903;3900000;0
8569;65324;561;0;0;0;0;.00nan;0;0
8569;86422;552;0;0;0;0;.00nan;0;0
8569;88692;552;76;36;3;33;.917;3900000;0
8570;2140;553;61;15;2;13;.867;3659000;0
8570;10112;1423;0;0;0;0;.00nan;0;0
8570;183905;1423;92;45;3;42;.933;3659000;0
8570;83252;553;0;0;0;0;.00nan;0;0
8571;4379;2626;0;0;0;0;.00nan;0;0
8571;163784;2626;56;19;2;17;.895;3600000;0
8571;75764;558;0;0;0;0;.00nan;0;0
8571;85395;558;78;40;4;36;.900;3600000;0
8572;178789;554;68;20;1;19;.950;3600000;0
8572;-1;554;0;0;0;0;.00nan;0;0
8572;-1;560;0;0;0;0;.00nan;0;0
8572;54860;560;79;40;3;37;.925;3542000;0
8573;10112;1423;0;0;0;0;.00nan;0;0
8573;183905;1423;90;60;2;58;.967;3600000;0
8573;80596;556;0;0;0;0;.00nan;0;0
8573;85349;556;57;23;3;20;.870;3568000;0
8574;75764;558;86;36;2;34;.944;3573000;0
8574;85395;558;0;0;0;0;.00nan;0;0
8574;86422;552;82;26;1;25;.962;3600000;0
8574;88692;552;0;0;0;0;.00nan;0;0
8575;4379;2626;75;24;1;23;.958;3600000;0
8575;163784;2626;0;0;0;0;.00nan;0;0
8575;180738;555;94;44;3;41;.932;3524000;0
8575;36115;555;0;0;0;0;.00nan;0;0
8576;178789;554;63;12;1;11;.917;3600000;0
8576;-1;554;0;0;0;0;.00nan;0;0
8576;-1;560;49;50;7;43;.860;3600000;0
8576;54860;560;0;0;0;0;.00nan;0;0
8577;2140;553;73;34;3;31;.912;3585000;0
8577;-1;561;68;18;1;17;.944;3600000;0
8577;65324;561;0;0;0;0;.00nan;0;0
8577;83252;553;0;0;0;0;.00nan;0;0
8578;178789;554;67;20;1;19;.950;3600000;0
8578;-1;554;0;0;0;0;.00nan;0;0
8578;180738;555;92;50;4;46;.920;3600000;0
8578;36115;555;0;0;0;0;.00nan;0;0
8579;2140;553;97;36;1;35;.972;3900000;0
8579;80596;556;0;0;0;0;.00nan;0;0
8579;83252;553;0;0;0;0;.00nan;0;0
8579;85349;556;85;27;1;26;.963;3900000;0
8580;4379;2626;0;0;0;0;.00nan;0;0
8580;163784;2626;53;24;3;21;.875;3600000;0
8580;10112;1423;0;0;0;0;.00nan;0;0
8580;183905;1423;100;30;0;30;1.000;3600000;0
8581;178789;554;66;18;1;17;.944;3600000;0
8581;-1;554;0;0;0;0;.00nan;0;0
8581;180738;555;0;0;0;0;.00nan;0;0
8581;36115;555;85;63;6;57;.905;3600000;0
8582;2140;553;0;0;0;0;.00nan;0;0
8582;83252;553;78;34;3;31;.912;3600000;0
8582;86422;552;39;21;4;17;.810;3566000;0
8582;88692;552;0;0;0;0;.00nan;0;0
8583;4379;2626;70;25;2;23;.920;3600000;0
8583;163784;2626;0;0;0;0;.00nan;0;0
8583;75764;558;73;36;3;33;.917;3564000;0
8583;85395;558;0;0;0;0;.00nan;0;0
8584;-1;561;99;31;1;30;.968;3600000;0
8584;-1;560;0;0;0;0;.00nan;0;0
8584;54860;560;89;48;4;44;.917;3600000;0
8584;65324;561;0;0;0;0;.00nan;0;0
8585;75764;558;0;0;0;0;.00nan;0;0
8585;85395;558;79;53;5;48;.906;3600000;0
8585;86422;552;0;0;0;0;.00nan;0;0
8585;88692;552;73;28;2;26;.929;3600000;0
8586;10112;1423;0;0;0;0;.00nan;0;0
8586;183905;1423;98;44;2;42;.955;3567000;0
8586;-1;560;92;16;0;16;1.000;3600000;0
8586;54860;560;0;0;0;0;.00nan;0;0
8587;-1;560;71;34;3;31;.912;3537000;0
8587;54860;560;0;0;0;0;.00nan;0;0
8587;86422;552;68;17;1;16;.941;3600000;0
8587;88692;552;0;0;0;0;.00nan;0;0
8588;180738;555;60;52;6;46;.885;3352000;0
8588;36115;555;56;5;0;5;1.000;248000;0
8588;80596;556;79;13;0;13;1.000;3600000;0
8588;85349;556;0;0;0;0;.00nan;0;0
8589;75764;558;0;0;0;0;.00nan;0;0
8589;80596;556;44;27;4;23;.852;3600000;0
8589;85349;556;0;0;0;0;.00nan;0;0
8589;85395;558;92;33;1;32;.970;3600000;0
8590;178789;554;85;28;1;27;.964;3600000;0
8590;-1;554;0;0;0;0;.00nan;0;0
8590;80596;556;0;0;0;0;.00nan;0;0
8590;85349;556;70;35;3;32;.914;3523000;0
8591;180738;555;75;31;2;29;.935;3900000;0
8591;36115;555;0;0;0;0;.00nan;0;0
8591;75764;558;74;32;2;30;.938;3900000;0
8591;85395;558;0;0;0;0;.00nan;0;0
8592;4379;2626;0;0;0;0;.00nan;0;0
8592;163784;2626;52;22;4;18;.818;3900000;0
8592;10112;1423;0;0;0;0;.00nan;0;0
8592;183905;1423;97;51;4;47;.922;3900000;0
8593;-1;561;72;26;3;23;.885;3600000;0
8593;-1;560;0;0;0;0;.00nan;0;0
8593;54860;560;100;42;0;42;1.000;3600000;0
8593;65324;561;0;0;0;0;.00nan;0;0
8594;-1;561;92;35;1;34;.971;3600000;0
8594;65324;561;0;0;0;0;.00nan;0;0
8594;86422;552;59;23;2;21;.913;3600000;0
8594;88692;552;0;0;0;0;.00nan;0;0
8595;4379;2626;59;38;6;32;.842;3266000;0
8595;163784;2626;57;8;0;8;1.000;334000;0
8595;10112;1423;0;0;0;0;.00nan;0;0
8595;183905;1423;97;46;2;44;.957;3600000;0
8596;2140;553;92;38;2;36;.947;3859000;0
8596;178789;554;60;25;2;23;.920;3900000;0
8596;-1;554;0;0;0;0;.00nan;0;0
8596;83252;553;0;0;0;0;.00nan;0;0
8597;180738;555;63;9;0;9;1.000;614000;0
8597;36115;555;21;26;6;20;.769;2986000;0
8597;-1;560;0;0;0;0;.00nan;0;0
8597;54860;560;64;21;2;19;.905;3600000;0
8598;75764;558;0;0;0;0;.00nan;0;0
8598;80596;556;0;0;0;0;.00nan;0;0
8598;85349;556;58;21;2;19;.905;3600000;0
8598;85395;558;71;40;4;36;.900;3600000;0
8599;178789;554;77;28;2;26;.929;3900000;0
8599;-1;554;0;0;0;0;.00nan;0;0
8599;75764;558;100;71;2;69;.972;3900000;0
8599;85395;558;0;0;0;0;.00nan;0;0
8600;4379;2626;55;7;1;6;.857;993000;0
8600;163784;2626;11;26;7;19;.731;2607000;0
8600;80596;556;63;29;3;26;.897;3600000;0
8600;85349;556;0;0;0;0;.00nan;0;0
8601;2140;553;67;15;1;14;.933;3600000;0
8601;180738;555;59;42;5;37;.881;3600000;0
8601;36115;555;0;0;0;0;.00nan;0;0
8601;83252;553;0;0;0;0;.00nan;0;0
8602;10112;1423;0;0;0;0;.00nan;0;0
8602;183905;1423;98;64;4;60;.938;3600000;0
8602;-1;561;65;17;1;16;.941;3600000;0
8602;65324;561;0;0;0;0;.00nan;0;0
8603;-1;560;0;0;0;0;.00nan;0;0
8603;54860;560;99;48;1;47;.979;3600000;0
8603;86422;552;68;27;2;25;.926;3549000;0
8603;88692;552;0;0;0;0;.00nan;0;0
8604;178789;554;66;47;5;42;.894;3555000;0
8604;-1;554;0;0;0;0;.00nan;0;0
8604;86422;552;0;0;0;0;.00nan;0;0
8604;88692;552;52;29;4;25;.862;3600000;0
8605;10112;1423;0;0;0;0;.00nan;0;0
8605;183905;1423;46;30;4;26;.867;3600000;0
8605;180738;555;0;0;0;0;.00nan;0;0
8605;36115;555;55;27;3;24;.889;3600000;0
8606;4379;2626;68;21;1;20;.952;3600000;0
8606;163784;2626;0;0;0;0;.00nan;0;0
8606;-1;560;55;44;6;38;.864;3600000;0
8606;54860;560;0;0;0;0;.00nan;0;0
8607;-1;561;62;14;1;13;.929;3600000;0
8607;65324;561;0;0;0;0;.00nan;0;0
8607;75764;558;0;0;0;0;.00nan;0;0
8607;85395;558;51;31;5;26;.839;3600000;0
8608;4379;2626;0;0;0;0;.00nan;0;0
8608;163784;2626;56;33;4;29;.879;3600000;0
8608;86422;552;100;27;0;27;1.000;3600000;0
8608;88692;552;0;0;0;0;.00nan;0;0
8609;178789;554;84;15;0;15;1.000;3600000;0
8609;-1;554;0;0;0;0;.00nan;0;0
8609;-1;560;84;23;0;23;1.000;1368000;0
8609;54860;560;68;39;4;35;.897;2232000;0
8610;178789;554;65;23;2;21;.913;3900000;0
8610;-1;554;0;0;0;0;.00nan;0;0
8610;-1;560;0;0;0;0;.00nan;0;0
8610;54860;560;93;37;2;35;.946;3900000;0
8611;10112;1423;65;23;2;21;.913;1207000;0
8611;183905;1423;32;32;6;26;.813;2393000;0
8611;86422;552;58;11;1;10;.909;3600000;0
8611;88692;552;0;0;0;0;.00nan;0;0
8612;2140;553;61;29;3;26;.897;3900000;0
8612;80596;556;0;0;0;0;.00nan;0;0
8612;83252;553;0;0;0;0;.00nan;0;0
8612;85349;556;85;39;3;36;.923;3900000;0
8613;180738;555;62;42;5;37;.881;3590000;0
8613;36115;555;0;0;0;0;.00nan;0;0
8613;75764;558;0;0;0;0;.00nan;0;0
8613;85395;558;49;20;3;17;.850;3600000;0
8614;4379;2626;0;0;0;0;.00nan;0;0
8614;163784;2626;88;30;1;29;.967;3600000;0
8614;-1;561;68;22;2;20;.909;3561000;0
8614;65324;561;0;0;0;0;.00nan;0;0
8615;10112;1423;0;0;0;0;.00nan;0;0
8615;183905;1423;37;30;5;25;.833;3600000;0
8615;180738;555;0;0;0;0;.00nan;0;0
8615;36115;555;84;35;2;33;.943;3600000;0
8616;2140;553;52;27;4;23;.852;3900000;0
8616;80596;556;45;27;4;23;.852;3900000;0
8616;83252;553;0;0;0;0;.00nan;0;0
8616;85349;556;0;0;0;0;.00nan;0;0
8617;75764;558;30;32;6;26;.813;2738000;0
8617;85395;558;56;6;0;6;1.000;862000;0
8617;86422;552;0;0;0;0;.00nan;0;0
8617;88692;552;44;20;3;17;.850;3600000;0
8618;4379;2626;73;27;2;25;.926;3549000;0
8618;163784;2626;0;0;0;0;.00nan;0;0
8618;-1;561;0;0;0;0;.00nan;0;0
8618;65324;561;88;30;1;29;.967;3600000;0
8619;4379;2626;0;0;0;0;.00nan;0;0
8619;163784;2626;61;40;4;36;.900;3600000;0
8619;178789;554;87;31;1;30;.968;3600000;0
8619;-1;554;0;0;0;0;.00nan;0;0
8621;4379;2626;79;16;1;15;.938;3600000;0
8621;10112;1423;33;36;7;29;.806;2895000;0
8621;27517;1423;56;4;0;4;1.000;705000;0
8621;28989;2626;0;0;0;0;.00nan;0;0
8623;180738;555;62;49;6;43;.878;3029000;0
8623;36115;555;53;4;0;4;1.000;571000;0
8623;80596;556;0;0;0;0;.00nan;0;0
8623;85349;556;39;26;5;21;.808;3600000;0
8627;2140;553;74;42;4;38;.905;3595000;0
8627;83252;553;0;0;0;0;.00nan;0;0
8627;86422;552;77;25;2;23;.920;3600000;0
8627;88692;552;0;0;0;0;.00nan;0;0
8629;-1;560;0;0;0;0;.00nan;0;0
8629;54860;560;68;46;5;41;.891;3575000;0
8629;75764;558;79;39;3;36;.923;3600000;0
8629;85395;558;0;0;0;0;.00nan;0;0
8631;-1;561;0;0;0;0;.00nan;0;0
8631;65324;561;98;53;3;50;.943;3900000;0
8631;86422;552;0;0;0;0;.00nan;0;0
8631;88692;552;69;28;3;25;.893;3900000;0
8635;180738;555;53;12;1;11;.917;662000;0
8635;36115;555;42;47;7;40;.851;2938000;0
8635;-1;560;64;23;2;21;.913;3600000;0
8635;54860;560;0;0;0;0;.00nan;0;0
8637;75764;558;0;0;0;0;.00nan;0;0
8637;80596;556;22;4;3;1;.250;322000;0
8637;85349;556;71;20;1;19;.950;3278000;0
8637;85395;558;100;36;0;36;1.000;3600000;0
8639;4379;2626;0;0;0;0;.00nan;0;0
8639;10112;1423;63;17;2;15;.882;1723000;0
8639;27517;1423;23;21;6;15;.714;1877000;0
8639;28989;2626;67;22;1;21;.955;3600000;0
8661;4379;2626;56;28;3;25;.893;3600000;0
8661;28989;2626;0;0;0;0;.00nan;0;0
8661;180738;555;0;0;0;0;.00nan;0;0
8661;36115;555;24;44;8;36;.818;3600000;0
8663;178789;554;37;24;5;19;.792;3562000;0
8663;-1;554;0;0;0;0;.00nan;0;0
8663;75764;558;0;0;0;0;.00nan;0;0
8663;85395;558;91;47;3;44;.936;3600000;0
8665;10112;1423;0;0;0;0;.00nan;0;0
8665;27517;1423;96;51;3;48;.941;3600000;0
8665;-1;561;0;0;0;0;.00nan;0;0
8665;65324;561;71;28;2;26;.929;3600000;0
8667;2140;553;75;43;4;39;.907;3556000;0
8667;80596;556;49;19;3;16;.842;3600000;0
8667;83252;553;0;0;0;0;.00nan;0;0
8667;85349;556;0;0;0;0;.00nan;0;0
8669;-1;560;0;0;0;0;.00nan;0;0
8669;54860;560;85;61;6;55;.902;3542000;0
8669;86422;552;54;18;3;15;.833;3600000;0
8669;88692;552;0;0;0;0;.00nan;0;0
8671;-1;560;58;19;2;17;.895;905000;0
8671;54860;560;48;37;6;31;.838;2695000;0
8671;86422;552;48;16;3;13;.813;3600000;0
8671;88692;552;0;0;0;0;.00nan;0;0
8673;4379;2626;100;45;1;44;.978;3600000;0
8673;28989;2626;0;0;0;0;.00nan;0;0
8673;80596;556;0;0;0;0;.00nan;0;0
8673;85349;556;66;31;3;28;.903;3555000;0
8675;180738;555;47;36;5;31;.861;3585000;0
8675;36115;555;0;0;0;0;.00nan;0;0
8675;75764;558;54;23;3;20;.870;3600000;0
8675;85395;558;0;0;0;0;.00nan;0;0
8677;178789;554;0;0;0;0;.00nan;0;0
8677;-1;554;51;23;3;20;.870;3600000;0
8677;-1;561;82;39;4;35;.897;3579000;0
8677;65324;561;0;0;0;0;.00nan;0;0
8679;2140;553;0;0;0;0;.00nan;0;0
8679;10112;1423;59;38;4;34;.895;3900000;0
8679;27517;1423;0;0;0;0;.00nan;0;0
8679;83252;553;66;34;4;30;.882;3900000;0
1710;178789;554;80;30;2;28;.933;3542000;0
1710;-1;554;0;0;0;0;.00nan;0;0
1710;75764;558;0;0;0;0;.00nan;0;0
1710;85395;558;99;45;1;44;.978;3600000;0
1711;4379;2626;0;0;0;0;.00nan;0;0
1711;163784;2626;60;14;2;12;.857;3600000;0
1711;86422;552;54;23;3;20;.870;3600000;0
1711;88692;552;0;0;0;0;.00nan;0;0
1712;-1;561;63;19;2;17;.895;3600000;0
1712;-1;560;0;0;0;0;.00nan;0;0
1712;54860;560;44;24;4;20;.833;3539000;0
1712;65324;561;0;0;0;0;.00nan;0;0
1713;2140;553;97;53;4;49;.925;3600000;0
1713;80596;556;0;0;0;0;.00nan;0;0
1713;83252;553;0;0;0;0;.00nan;0;0
1713;85349;556;47;15;3;12;.800;3600000;0
1714;178789;554;72;20;1;19;.950;3600000;0
1714;-1;554;0;0;0;0;.00nan;0;0
1714;75764;558;0;0;0;0;.00nan;0;0
1714;85395;558;90;54;4;50;.926;3600000;0
1715;4379;2626;0;0;0;0;.00nan;0;0
1715;163784;2626;99;47;2;45;.957;3600000;0
1715;86422;552;66;26;2;24;.923;3600000;0
1715;88692;552;0;0;0;0;.00nan;0;0
1716;2037;560;0;0;0;0;.00nan;0;0
1716;-1;561;76;27;2;25;.926;3600000;0
1716;54860;560;72;33;3;30;.909;3600000;0
1716;65324;561;0;0;0;0;.00nan;0;0
1717;2140;553;81;38;3;35;.921;3600000;0
1717;80596;556;0;0;0;0;.00nan;0;0
1717;83252;553;0;0;0;0;.00nan;0;0
1717;85349;556;52;35;5;30;.857;3582000;0
1831;4379;2626;57;13;1;12;.923;1122000;0
1831;163784;2626;36;31;6;25;.806;2478000;0
1831;178789;554;80;23;1;22;.957;3600000;0
1831;-1;554;0;0;0;0;.00nan;0;0
1832;2140;553;68;26;2;24;.923;3633000;0
1832;-1;561;73;31;3;28;.903;3666000;0
1832;65324;561;0;0;0;0;.00nan;0;0
1832;83252;553;0;0;0;0;.00nan;0;0
1909;2140;553;63;29;3;26;.897;3600000;0
1909;178789;554;36;28;5;23;.821;3579000;0
1909;-1;554;0;0;0;0;.00nan;0;0
1909;83252;553;0;0;0;0;.00nan;0;0
1910;4379;2626;0;0;0;0;.00nan;0;0
1910;163784;2626;68;36;4;32;.889;3697000;0
1910;-1;561;93;51;3;48;.941;3697000;0
1910;65324;561;0;0;0;0;.00nan;0;0
8690;171970;82;85;29;1;28;.966;3600000;0
8690;-1;82;0;0;0;0;.00nan;0;0
8690;173856;75;0;0;0;0;.00nan;0;0
8690;171615;75;49;16;2;14;.875;3600000;0
8691;165611;81;29;15;4;11;.733;689000;0
8691;176770;81;83;21;1;20;.952;2911000;0
8691;38209;149;84;19;1;18;.947;3600000;0
8691;86875;149;0;0;0;0;.00nan;0;0
8692;163989;72;71;35;3;32;.914;3600000;0
8692;169166;1095;17;19;6;13;.684;2754000;0
8692;60773;1095;62;15;1;14;.933;846000;0
8692;64811;72;0;0;0;0;.00nan;0;0
8693;173874;158;0;0;0;0;.00nan;0;0
8693;58054;69;61;20;2;18;.900;3600000;0
8693;91398;158;92;49;3;46;.939;3542000;0
8693;161047;69;0;0;0;0;.00nan;0;0
8694;164987;85;96;25;0;25;1.000;3600000;0
8694;37857;4245;41;33;5;28;.848;3600000;0
8694;186520;4245;0;0;0;0;.00nan;0;0
8694;57998;85;0;0;0;0;.00nan;0;0
8695;184049;1097;38;29;5;24;.828;3600000;0
8695;170612;74;0;0;0;0;.00nan;0;0
8695;171730;1097;0;0;0;0;.00nan;0;0
8695;57215;74;81;31;2;29;.935;3600000;0
8696;4487;4920;49;16;3;13;.813;3540000;0
8696;183859;4920;0;0;0;0;.00nan;0;0
8696;184398;78;0;0;0;0;.00nan;0;0
8696;179406;78;99;43;1;42;.977;3600000;0
8697;178911;152;0;0;0;0;.00nan;0;0
8697;179411;151;0;0;0;0;.00nan;0;0
8697;176060;151;68;32;3;29;.906;3516000;0
8697;85935;152;79;24;1;23;.958;3600000;0
8698;184049;1097;68;20;2;18;.900;3600000;0
8698;171730;1097;0;0;0;0;.00nan;0;0
8698;175423;77;71;37;3;34;.919;3571000;0
8698;180873;77;0;0;0;0;.00nan;0;0
8699;173823;73;0;0;0;0;.00nan;0;0
8699;173918;4921;57;35;4;31;.886;3600000;0
8699;170963;73;88;31;1;30;.968;3600000;0
8699;182049;4921;0;0;0;0;.00nan;0;0
8700;163989;72;0;0;0;0;.00nan;0;0
8700;169166;1095;99;48;1;47;.979;3900000;0
8700;60773;1095;0;0;0;0;.00nan;0;0
8700;64811;72;76;25;1;24;.960;3900000;0
8701;166545;1096;0;0;0;0;.00nan;0;0
8701;183775;1096;95;37;2;35;.946;3538000;0
8701;170612;74;0;0;0;0;.00nan;0;0
8701;57215;74;100;36;0;36;1.000;3600000;0
8702;165611;81;97;56;3;53;.946;3900000;0
8702;176770;81;0;0;0;0;.00nan;0;0
8702;38209;149;61;25;3;22;.880;3900000;0
8702;86875;149;0;0;0;0;.00nan;0;0
8703;173874;158;0;0;0;0;.00nan;0;0
8703;58054;69;63;25;3;22;.880;3600000;0
8703;91398;158;68;37;4;33;.892;3571000;0
8703;161047;69;0;0;0;0;.00nan;0;0
8704;171970;82;53;17;2;15;.882;3600000;0
8704;-1;82;0;0;0;0;.00nan;0;0
8704;170598;4922;76;42;4;38;.905;3519000;0
8704;161046;4922;0;0;0;0;.00nan;0;0
8705;2495;2564;72;20;2;18;.900;3600000;0
8705;46790;71;0;0;0;0;.00nan;0;0
8705;78775;71;83;39;3;36;.923;3600000;0
8705;85633;2564;0;0;0;0;.00nan;0;0
8706;178911;152;91;36;2;34;.944;3007000;0
8706;179411;151;54;4;0;4;1.000;448000;0
8706;176060;151;35;34;6;28;.824;3139000;0
8706;85935;152;32;7;3;4;.571;593000;0
8707;4487;4920;0;0;0;0;.00nan;0;0
8707;183859;4920;100;34;1;33;.971;3600000;0
8707;184398;78;47;29;4;25;.862;2268000;0
8707;179406;78;32;15;4;11;.733;1332000;0
8708;164987;85;0;0;0;0;.00nan;0;0
8708;37857;4245;100;31;1;30;.968;3900000;0
8708;186520;4245;0;0;0;0;.00nan;0;0
8708;57998;85;93;33;1;32;.970;3900000;0
8709;173856;75;55;23;3;20;.870;3600000;0
8709;171615;75;0;0;0;0;.00nan;0;0
8709;176136;76;0;0;0;0;.00nan;0;0
8709;57207;76;100;31;0;31;1.000;3600000;0
8710;-1;157;31;17;4;13;.765;3600000;0
8710;85009;80;96;33;1;32;.970;3600000;0
8710;85555;157;0;0;0;0;.00nan;0;0
8710;92313;80;0;0;0;0;.00nan;0;0
8711;-1;67;0;0;0;0;.00nan;0;0
8711;169096;67;46;23;4;19;.826;3707000;0
8711;184158;4620;0;0;0;0;.00nan;0;0
8711;181341;4620;76;43;5;38;.884;3691000;0
8712;164987;85;0;0;0;0;.00nan;0;0
8712;37857;4245;0;0;0;0;.00nan;0;0
8712;186520;4245;67;25;2;23;.920;3600000;0
8712;57998;85;59;30;3;27;.900;3544000;0
8713;-1;157;49;23;4;19;.826;3545000;0
8713;85009;80;72;36;3;33;.917;3600000;0
8713;85555;157;0;0;0;0;.00nan;0;0
8713;92313;80;0;0;0;0;.00nan;0;0
8714;-1;67;0;0;0;0;.00nan;0;0
8714;169096;67;41;32;6;26;.813;3600000;0
8714;184398;78;0;0;0;0;.00nan;0;0
8714;179406;78;94;32;1;31;.969;3600000;0
8715;178911;152;0;0;0;0;.00nan;0;0
8715;179411;151;0;0;0;0;.00nan;0;0
8715;176060;151;84;44;3;41;.932;3600000;0
8715;85935;152;47;26;4;22;.846;3550000;0
8716;2495;2564;0;0;0;0;.00nan;0;0
8716;163989;72;100;31;0;31;1.000;3600000;0
8716;64811;72;0;0;0;0;.00nan;0;0
8716;85633;2564;46;27;4;23;.852;3600000;0
8717;-1;67;0;0;0;0;.00nan;0;0
8717;169096;67;87;37;2;35;.946;3900000;0
8717;170612;74;0;0;0;0;.00nan;0;0
8717;57215;74;87;31;2;29;.935;3900000;0
8718;164987;85;0;0;0;0;.00nan;0;0
8718;176136;76;0;0;0;0;.00nan;0;0
8718;57207;76;68;51;6;45;.882;3577000;0
8718;57998;85;32;23;5;18;.783;3600000;0
8719;169166;1095;70;26;2;24;.923;3544000;0
8719;46790;71;0;0;0;0;.00nan;0;0
8719;60773;1095;0;0;0;0;.00nan;0;0
8719;78775;71;83;30;1;29;.967;3600000;0
8720;166545;1096;97;39;2;37;.949;3566000;0
8720;183775;1096;0;0;0;0;.00nan;0;0
8720;184049;1097;84;26;1;25;.962;3600000;0
8720;171730;1097;0;0;0;0;.00nan;0;0
8721;2495;2564;0;0;0;0;.00nan;0;0
8721;173918;4921;0;0;0;0;.00nan;0;0
8721;182049;4921;53;35;5;30;.857;3541000;0
8721;85633;2564;93;40;3;37;.925;3600000;0
8722;4487;4920;0;0;0;0;.00nan;0;0
8722;183859;4920;97;24;0;24;1.000;3600000;0
8722;184158;4620;0;0;0;0;.00nan;0;0
8722;181341;4620;63;33;3;30;.909;3600000;0
8723;-1;67;0;0;0;0;.00nan;0;0
8723;169096;67;80;27;1;26;.963;3554000;0
8723;170612;74;0;0;0;0;.00nan;0;0
8723;57215;74;100;32;0;32;1.000;3600000;0
8724;173874;158;0;0;0;0;.00nan;0;0
8724;178911;152;0;0;0;0;.00nan;0;0
8724;57207;152;76;27;2;25;.926;3600000;0
8724;91398;158;75;52;5;47;.904;3600000;0
8725;165611;81;75;33;3;30;.909;3608000;0
8725;176770;81;0;0;0;0;.00nan;0;0
8725;85009;80;0;0;0;0;.00nan;0;0
8725;92313;80;71;23;2;21;.913;3608000;0
8726;173823;73;0;0;0;0;.00nan;0;0
8726;170963;73;73;21;1;20;.952;3600000;0
8726;179411;151;56;38;5;33;.868;3600000;0
8726;176060;151;0;0;0;0;.00nan;0;0
8727;4487;4920;0;0;0;0;.00nan;0;0
8727;183859;4920;100;25;0;25;1.000;3600000;0
8727;184158;4620;98;41;1;40;.976;3568000;0
8727;181341;4620;0;0;0;0;.00nan;0;0
8728;175423;77;0;0;0;0;.00nan;0;0
8728;180873;77;20;28;7;21;.750;3600000;0
8728;38209;149;0;0;0;0;.00nan;0;0
8728;86875;149;69;18;1;17;.944;3600000;0
8729;171970;82;69;23;1;22;.957;3600000;0
8729;-1;82;0;0;0;0;.00nan;0;0
8729;170598;4922;78;41;4;37;.902;3600000;0
8729;161046;4922;0;0;0;0;.00nan;0;0
8730;169166;1095;0;0;0;0;.00nan;0;0
8730;173918;4921;0;0;0;0;.00nan;0;0
8730;182049;4921;74;33;3;30;.909;3598000;0
8730;60773;1095;85;36;2;34;.944;3600000;0
8731;2495;2564;0;0;0;0;.00nan;0;0
8731;163989;72;91;31;1;30;.968;3600000;0
8731;64811;72;0;0;0;0;.00nan;0;0
8731;85633;2564;33;27;5;22;.815;3600000;0
8732;164987;85;50;10;1;9;.900;3600000;0
8732;176136;76;0;0;0;0;.00nan;0;0
8732;57998;85;0;0;0;0;.00nan;0;0
8732;78864;76;78;44;4;40;.909;3600000;0
8733;173874;158;84;37;2;35;.946;3600000;0
8733;178911;152;0;0;0;0;.00nan;0;0
8733;57207;152;27;29;7;22;.759;3600000;0
8733;91398;158;0;0;0;0;.00nan;0;0
8734;184398;78;66;22;2;20;.909;3696000;0
8734;179406;78;0;0;0;0;.00nan;0;0
8734;37857;4245;78;21;1;20;.952;3696000;0
8734;186520;4245;0;0;0;0;.00nan;0;0
8735;173823;73;60;9;0;9;1.000;896000;0
8735;170963;73;17;21;6;15;.714;2704000;0
8735;-1;157;67;22;3;19;.864;3600000;0
8735;38276;157;0;0;0;0;.00nan;0;0
8736;165611;81;0;0;0;0;.00nan;0;0
8736;176770;81;28;26;6;20;.769;3600000;0
8736;85009;80;65;28;3;25;.893;3600000;0
8736;92313;80;0;0;0;0;.00nan;0;0
8737;179411;151;0;0;0;0;.00nan;0;0
8737;176060;151;59;49;6;43;.878;3600000;0
8737;58054;69;86;15;0;15;1.000;3600000;0
8737;161047;69;0;0;0;0;.00nan;0;0
8738;175423;77;0;0;0;0;.00nan;0;0
8738;180873;77;95;35;1;34;.971;3594000;0
8738;38209;149;99;20;0;20;1.000;3600000;0
8738;86875;149;0;0;0;0;.00nan;0;0
8739;164987;85;0;0;0;0;.00nan;0;0
8739;176136;76;0;0;0;0;.00nan;0;0
8739;57998;85;41;22;4;18;.818;3600000;0
8739;78864;76;50;41;6;35;.854;3600000;0
8740;-1;67;0;0;0;0;.00nan;0;0
8740;169096;67;65;23;3;20;.870;3600000;0
8740;170612;74;0;0;0;0;.00nan;0;0
8740;57215;74;77;41;4;37;.902;3589000;0
8741;173856;75;42;22;4;18;.818;3600000;0
8741;170598;4922;52;8;1;7;.875;1232000;0
8741;171615;75;0;0;0;0;.00nan;0;0
8741;161046;4922;57;31;4;27;.871;2363000;0
8742;184398;78;75;30;3;27;.900;3811000;0
8742;179406;78;0;0;0;0;.00nan;0;0
8742;37857;4245;0;0;0;0;.00nan;0;0
8742;186520;4245;73;29;2;27;.931;3811000;0
8743;173823;73;0;0;0;0;.00nan;0;0
8743;170963;73;70;36;4;32;.889;3584000;0
8743;-1;157;0;0;0;0;.00nan;0;0
8743;38276;157;79;30;2;28;.933;3600000;0
8744;179411;151;48;45;7;38;.844;2633000;0
8744;176060;151;36;18;4;14;.778;967000;0
8744;58054;69;38;7;2;5;.714;3600000;0
8744;161047;69;0;0;0;0;.00nan;0;0
8745;173874;158;0;0;0;0;.00nan;0;0
8745;178911;152;0;0;0;0;.00nan;0;0
8745;57207;152;75;33;3;30;.909;3557000;0
8745;91398;158;74;22;1;21;.955;3600000;0
8746;166545;1096;65;37;5;32;.865;3830000;0
8746;183775;1096;0;0;0;0;.00nan;0;0
8746;175423;77;0;0;0;0;.00nan;0;0
8746;180873;77;56;33;4;29;.879;3830000;0
8747;171970;82;0;0;0;0;.00nan;0;0
8747;-1;82;66;30;3;27;.900;3876000;0
8747;173856;75;83;36;3;33;.917;3900000;0
8747;171615;75;0;0;0;0;.00nan;0;0
8748;165611;81;76;36;3;33;.917;3600000;0
8748;179411;151;0;0;0;0;.00nan;0;0
8748;176060;151;52;39;5;34;.872;3575000;0
8748;176770;81;0;0;0;0;.00nan;0;0
8749;170598;4922;80;16;0;16;1.000;3600000;0
8749;176136;76;0;0;0;0;.00nan;0;0
8749;78864;76;31;40;8;32;.800;3600000;0
8749;161046;4922;0;0;0;0;.00nan;0;0
8750;-1;157;72;28;2;26;.929;3900000;0
8750;38209;149;94;42;2;40;.952;3900000;0
8750;38276;157;0;0;0;0;.00nan;0;0
8750;86875;149;0;0;0;0;.00nan;0;0
8751;170598;4922;68;26;2;24;.923;3600000;0
8751;175423;77;83;37;3;34;.919;3600000;0
8751;180873;77;0;0;0;0;.00nan;0;0
8751;161046;4922;0;0;0;0;.00nan;0;0
8752;173823;73;0;0;0;0;.00nan;0;0
8752;170963;73;69;36;3;33;.917;3542000;0
8752;58054;69;69;27;2;25;.926;3600000;0
8752;161047;69;0;0;0;0;.00nan;0;0
8753;171970;82;81;49;4;45;.918;3878000;0
8753;-1;82;0;0;0;0;.00nan;0;0
8753;173856;75;82;45;3;42;.933;3878000;0
8753;171615;75;0;0;0;0;.00nan;0;0
8754;166545;1096;69;33;4;29;.879;3544000;0
8754;183775;1096;0;0;0;0;.00nan;0;0
8754;184049;1097;64;32;3;29;.906;3600000;0
8754;171730;1097;0;0;0;0;.00nan;0;0
8755;165611;81;0;0;0;0;.00nan;0;0
8755;179411;151;61;33;4;29;.879;3615000;0
8755;176060;151;0;0;0;0;.00nan;0;0
8755;176770;81;58;38;5;33;.868;3611000;0
8756;2495;2564;37;27;5;22;.815;3600000;0
8756;163989;72;62;25;3;22;.880;3600000;0
8756;64811;72;0;0;0;0;.00nan;0;0
8756;85633;2564;0;0;0;0;.00nan;0;0
8757;173874;158;0;0;0;0;.00nan;0;0
8757;178911;152;58;24;3;21;.875;3668000;0
8757;57207;152;0;0;0;0;.00nan;0;0
8757;91398;158;99;46;2;44;.957;3668000;0
8758;4487;4920;0;0;0;0;.00nan;0;0
8758;183859;4920;44;27;5;22;.815;3544000;0
8758;170612;74;0;0;0;0;.00nan;0;0
8758;57215;74;77;38;4;34;.895;3600000;0
8759;37857;4245;94;36;2;34;.944;3550000;0
8759;186520;4245;0;0;0;0;.00nan;0;0
8759;46790;71;0;0;0;0;.00nan;0;0
8759;78775;71;88;26;1;25;.962;3600000;0
8760;164987;85;68;30;3;27;.900;3600000;0
8760;184398;78;46;23;4;19;.826;3548000;0
8760;179406;78;0;0;0;0;.00nan;0;0
8760;57998;85;0;0;0;0;.00nan;0;0
8761;-1;157;0;0;0;0;.00nan;0;0
8761;38209;149;0;0;0;0;.00nan;0;0
8761;38276;157;65;28;2;26;.929;3600000;0
8761;86875;149;98;42;1;41;.976;3600000;0
8762;-1;67;75;38;4;34;.895;3594000;0
8762;169096;67;0;0;0;0;.00nan;0;0
8762;184158;4620;0;0;0;0;.00nan;0;0
8762;181341;4620;80;32;3;29;.906;3600000;0
8763;173823;73;0;0;0;0;.00nan;0;0
8763;170963;73;92;45;2;43;.956;3600000;0
8763;58054;69;0;0;0;0;.00nan;0;0
8763;161047;69;42;23;3;20;.870;3567000;0
8764;171970;82;0;0;0;0;.00nan;0;0
8764;-1;82;86;41;3;38;.927;3817000;0
8764;173856;75;0;0;0;0;.00nan;0;0
8764;171615;75;59;22;2;20;.909;3817000;0
8765;166545;1096;0;0;0;0;.00nan;0;0
8765;183775;1096;51;22;3;19;.864;3600000;0
8765;170598;4922;0;0;0;0;.00nan;0;0
8765;161046;4922;99;38;1;37;.974;3600000;0
8766;165611;81;0;0;0;0;.00nan;0;0
8766;179411;151;0;0;0;0;.00nan;0;0
8766;176060;151;78;29;3;26;.897;3600000;0
8766;176770;81;49;33;4;29;.879;3566000;0
8767;2495;2564;0;0;0;0;.00nan;0;0
8767;169166;1095;68;34;4;30;.882;3568000;0
8767;60773;1095;0;0;0;0;.00nan;0;0
8767;85633;2564;89;37;3;34;.919;3600000;0
8768;173874;158;53;32;5;27;.844;3578000;0
8768;178911;152;0;0;0;0;.00nan;0;0
8768;57207;152;53;27;4;23;.852;3600000;0
8768;91398;158;0;0;0;0;.00nan;0;0
8769;4487;4920;83;29;1;28;.966;3600000;0
8769;183859;4920;0;0;0;0;.00nan;0;0
8769;170612;74;40;3;1;2;.667;341000;0
8769;57215;74;54;35;5;30;.857;3259000;0
8770;184049;1097;0;0;0;0;.00nan;0;0
8770;171730;1097;60;24;3;21;.875;3600000;0
8770;176136;76;36;28;5;23;.821;3600000;0
8770;78864;76;0;0;0;0;.00nan;0;0
8771;163989;72;0;0;0;0;.00nan;0;0
8771;46790;71;66;42;5;37;.881;3600000;0
8771;64811;72;89;25;1;24;.960;3600000;0
8771;78775;71;0;0;0;0;.00nan;0;0
8772;164987;85;0;0;0;0;.00nan;0;0
8772;184398;78;0;0;0;0;.00nan;0;0
8772;179406;78;54;39;5;34;.872;3600000;0
8772;57998;85;78;24;1;23;.958;3600000;0
8773;173918;4921;0;0;0;0;.00nan;0;0
8773;37857;4245;0;0;0;0;.00nan;0;0
8773;182049;4921;91;32;2;30;.938;3600000;0
8773;186520;4245;63;31;3;28;.903;3576000;0
8774;-1;67;0;0;0;0;.00nan;0;0
8774;169096;67;51;32;4;28;.875;3515000;0
8774;184158;4620;0;0;0;0;.00nan;0;0
8774;181341;4620;95;38;2;36;.947;3600000;0
8775;175423;77;0;0;0;0;.00nan;0;0
8775;176136;76;0;0;0;0;.00nan;0;0
8775;180873;77;51;15;2;13;.867;3600000;0
8775;78864;76;75;38;3;35;.921;3566000;0
8776;4487;4920;0;0;0;0;.00nan;0;0
8776;183859;4920;44;32;6;26;.813;3600000;0
8776;170612;74;0;0;0;0;.00nan;0;0
8776;57215;74;84;26;1;25;.962;3600000;0
8777;166545;1096;77;31;2;29;.935;3600000;0
8777;183775;1096;0;0;0;0;.00nan;0;0
8777;184049;1097;60;28;3;25;.893;3568000;0
8777;171730;1097;0;0;0;0;.00nan;0;0
8778;164987;85;95;41;1;40;.976;3900000;0
8778;184398;78;88;26;1;25;.962;3900000;0
8778;179406;78;0;0;0;0;.00nan;0;0
8778;57998;85;0;0;0;0;.00nan;0;0
8779;173874;158;0;0;0;0;.00nan;0;0
8779;-1;157;63;26;3;23;.885;3900000;0
8779;38276;157;0;0;0;0;.00nan;0;0
8779;91398;158;88;46;3;43;.935;3900000;0
8780;173918;4921;87;38;2;36;.947;3900000;0
8780;37857;4245;87;34;2;32;.941;3900000;0
8780;182049;4921;0;0;0;0;.00nan;0;0
8780;186520;4245;0;0;0;0;.00nan;0;0
8781;178911;152;0;0;0;0;.00nan;0;0
8781;38209;149;0;0;0;0;.00nan;0;0
8781;57207;152;91;33;1;32;.970;3549000;0
8781;86875;149;100;28;0;28;1.000;3600000;0
8782;173856;75;87;34;1;33;.971;3900000;0
8782;171615;75;0;0;0;0;.00nan;0;0
8782;176136;76;0;0;0;0;.00nan;0;0
8782;78864;76;99;36;1;35;.972;3900000;0
8783;-1;67;0;0;0;0;.00nan;0;0
8783;169096;67;71;25;2;23;.920;3600000;0
8783;184158;4620;66;37;4;33;.892;3519000;0
8783;181341;4620;0;0;0;0;.00nan;0;0
8784;2495;2564;0;0;0;0;.00nan;0;0
8784;58054;69;79;31;3;28;.903;3576000;0
8784;85633;2564;77;25;2;23;.920;3600000;0
8784;161047;69;0;0;0;0;.00nan;0;0
8785;170612;74;0;0;0;0;.00nan;0;0
8785;37857;4245;0;0;0;0;.00nan;0;0
8785;186520;4245;96;31;1;30;.968;3600000;0
8785;57215;74;87;32;2;30;.938;3600000;0
8786;179411;151;0;0;0;0;.00nan;0;0
8786;176060;151;70;35;3;32;.914;3600000;0
8786;85009;80;94;21;0;21;1.000;3600000;0
8786;92313;80;0;0;0;0;.00nan;0;0
8787;2495;2564;90;32;1;31;.969;3600000;0
8787;58054;69;0;0;0;0;.00nan;0;0
8787;85633;2564;0;0;0;0;.00nan;0;0
8787;161047;69;63;24;2;22;.917;3593000;0
8788;164987;85;0;0;0;0;.00nan;0;0
8788;-1;67;0;0;0;0;.00nan;0;0
8788;169096;67;69;29;3;26;.897;3865000;0
8788;57998;85;94;48;4;44;.917;3865000;0
8789;173874;158;0;0;0;0;.00nan;0;0
8789;-1;157;77;18;1;17;.944;3600000;0
8789;38276;157;0;0;0;0;.00nan;0;0
8789;91398;158;71;52;5;47;.904;3600000;0
8790;184158;4620;100;29;0;29;1.000;3600000;0
8790;170612;74;0;0;0;0;.00nan;0;0
8790;181341;4620;0;0;0;0;.00nan;0;0
8790;57215;74;92;41;2;39;.951;3567000;0
8791;178911;152;0;0;0;0;.00nan;0;0
8791;38209;149;78;30;2;28;.933;3727000;0
8791;57207;152;60;28;3;25;.893;3696000;0
8791;86875;149;0;0;0;0;.00nan;0;0
8792;169166;1095;83;34;2;32;.941;3600000;0
8792;46790;71;0;0;0;0;.00nan;0;0
8792;60773;1095;0;0;0;0;.00nan;0;0
8792;78775;71;61;29;4;25;.862;3566000;0
8793;166545;1096;0;0;0;0;.00nan;0;0
8793;171970;82;88;25;1;24;.960;3600000;0
8793;183775;1096;90;36;2;34;.944;3591000;0
8793;-1;82;0;0;0;0;.00nan;0;0
8794;163989;72;93;34;1;33;.971;3600000;0
8794;173823;73;0;0;0;0;.00nan;0;0
8794;170963;73;77;34;3;31;.912;3542000;0
8794;64811;72;0;0;0;0;.00nan;0;0
8795;4487;4920;0;0;0;0;.00nan;0;0
8795;183859;4920;63;14;1;13;.929;3600000;0
8795;184398;78;78;48;4;44;.917;3600000;0
8795;179406;78;0;0;0;0;.00nan;0;0
8796;164987;85;52;51;6;45;.882;3600000;0
8796;-1;67;53;35;4;31;.886;3600000;0
8796;169096;67;0;0;0;0;.00nan;0;0
8796;57998;85;0;0;0;0;.00nan;0;0
8797;173874;158;63;36;4;32;.889;3600000;0
8797;-1;157;0;0;0;0;.00nan;0;0
8797;38276;157;50;21;3;18;.857;3600000;0
8797;91398;158;0;0;0;0;.00nan;0;0
8798;184049;1097;61;30;4;26;.867;3900000;0
8798;173856;75;88;62;4;58;.935;3900000;0
8798;171615;75;0;0;0;0;.00nan;0;0
8798;171730;1097;0;0;0;0;.00nan;0;0
8799;175423;77;51;33;5;28;.848;3600000;0
8799;176136;76;0;0;0;0;.00nan;0;0
8799;180873;77;0;0;0;0;.00nan;0;0
8799;78864;76;67;36;4;32;.889;3600000;0
8800;179411;151;56;8;1;7;.875;900000;0
8800;176060;151;35;28;6;22;.786;2711000;0
8800;85009;80;51;39;6;33;.846;3611000;0
8800;92313;80;0;0;0;0;.00nan;0;0
8801;165611;81;0;0;0;0;.00nan;0;0
8801;173918;4921;0;0;0;0;.00nan;0;0
8801;176770;81;63;29;3;26;.897;3900000;0
8801;182049;4921;76;32;3;29;.906;3900000;0
8802;178911;152;62;33;4;29;.879;3600000;0
8802;38209;149;0;0;0;0;.00nan;0;0
8802;57207;152;0;0;0;0;.00nan;0;0
8802;86875;149;70;21;1;20;.952;3600000;0
8803;171970;82;0;0;0;0;.00nan;0;0
8803;-1;82;32;27;5;22;.815;3600000;0
8803;175423;77;0;0;0;0;.00nan;0;0
8803;180873;77;74;28;2;26;.929;3600000;0
8804;163989;72;0;0;0;0;.00nan;0;0
8804;173823;73;82;26;1;25;.962;3600000;0
8804;170963;73;0;0;0;0;.00nan;0;0
8804;64811;72;81;34;2;32;.941;3581000;0
8805;166545;1096;52;29;4;25;.862;3600000;0
8805;183775;1096;0;0;0;0;.00nan;0;0
8805;170598;4922;35;27;6;21;.778;3101000;0
8805;161046;4922;47;5;1;4;.800;499000;0
8806;2495;2564;0;0;0;0;.00nan;0;0
8806;58054;69;100;37;1;36;.973;3600000;0
8806;85633;2564;85;32;2;30;.938;3600000;0
8806;161047;69;0;0;0;0;.00nan;0;0
8807;4487;4920;64;28;3;25;.893;3600000;0
8807;183859;4920;0;0;0;0;.00nan;0;0
8807;184158;4620;38;37;6;31;.838;3600000;0
8807;181341;4620;0;0;0;0;.00nan;0;0
8808;184049;1097;0;0;0;0;.00nan;0;0
8808;173856;75;67;9;0;9;1.000;435000;0
8808;171615;75;23;35;7;28;.800;3165000;0
8808;171730;1097;60;30;3;27;.900;3600000;0
8809;173874;158;0;0;0;0;.00nan;0;0
8809;-1;157;57;19;2;17;.895;3551000;0
8809;38276;157;0;0;0;0;.00nan;0;0
8809;91398;158;100;32;0;32;1.000;3600000;0
8810;170612;74;0;0;0;0;.00nan;0;0
8810;37857;4245;65;22;2;20;.909;3600000;0
8810;186520;4245;0;0;0;0;.00nan;0;0
8810;57215;74;32;22;4;18;.818;3515000;0
8811;169166;1095;0;0;0;0;.00nan;0;0
8811;46790;71;73;31;2;29;.935;3545000;0
8811;60773;1095;88;27;1;26;.963;3600000;0
8811;78775;71;0;0;0;0;.00nan;0;0
8812;179411;151;76;44;3;41;.932;3900000;0
8812;176060;151;0;0;0;0;.00nan;0;0
8812;85009;80;0;0;0;0;.00nan;0;0
8812;92313;80;65;25;3;22;.880;3900000;0
8813;165611;81;0;0;0;0;.00nan;0;0
8813;173918;4921;98;36;1;35;.972;3600000;0
8813;176770;81;75;36;3;33;.917;3555000;0
8813;182049;4921;0;0;0;0;.00nan;0;0
8814;184158;4620;97;47;2;45;.957;3600000;0
8814;184398;78;51;25;4;21;.840;3564000;0
8814;179406;78;0;0;0;0;.00nan;0;0
8814;181341;4620;0;0;0;0;.00nan;0;0
8815;178911;152;0;0;0;0;.00nan;0;0
8815;38209;149;40;32;5;27;.844;3555000;0
8815;57207;152;58;25;3;22;.880;3600000;0
8815;86875;149;0;0;0;0;.00nan;0;0
8816;171970;82;50;29;4;25;.862;3900000;0
8816;-1;82;0;0;0;0;.00nan;0;0
8816;175423;77;57;33;4;29;.879;3900000;0
8816;180873;77;0;0;0;0;.00nan;0;0
8817;166545;1096;0;0;0;0;.00nan;0;0
8817;183775;1096;81;39;3;36;.923;3600000;0
8817;170598;4922;0;0;0;0;.00nan;0;0
8817;161046;4922;76;40;4;36;.900;3586000;0
8818;164987;85;0;0;0;0;.00nan;0;0
8818;-1;67;53;18;3;15;.833;3600000;0
8818;169096;67;0;0;0;0;.00nan;0;0
8818;57998;85;49;38;6;32;.842;3600000;0
8819;169166;1095;67;48;5;43;.896;3570000;0
8819;46790;71;0;0;0;0;.00nan;0;0
8819;60773;1095;0;0;0;0;.00nan;0;0
8819;78775;71;44;23;4;19;.826;3600000;0
8820;165611;81;0;0;0;0;.00nan;0;0
8820;173918;4921;0;0;0;0;.00nan;0;0
8820;176770;81;77;25;1;24;.960;3600000;0
8820;182049;4921;81;43;4;39;.907;3600000;0
8821;166545;1096;79;30;2;28;.933;3600000;0
8821;183775;1096;0;0;0;0;.00nan;0;0
8821;175423;77;0;0;0;0;.00nan;0;0
8821;180873;77;65;38;4;34;.895;3595000;0
8822;169166;1095;72;45;4;41;.911;3600000;0
8822;173823;73;0;0;0;0;.00nan;0;0
8822;170963;73;52;21;3;18;.857;3600000;0
8822;60773;1095;0;0;0;0;.00nan;0;0
8823;171970;82;87;41;2;39;.951;3600000;0
8823;-1;82;0;0;0;0;.00nan;0;0
8823;173856;75;45;32;5;27;.844;3600000;0
8823;171615;75;0;0;0;0;.00nan;0;0
8824;165611;81;0;0;0;0;.00nan;0;0
8824;176770;81;67;45;4;41;.911;3600000;0
8824;38209;149;0;0;0;0;.00nan;0;0
8824;86875;149;90;23;1;22;.957;3600000;0
8825;58054;69;91;35;2;33;.943;3600000;0
8825;85009;80;80;37;3;34;.919;3600000;0
8825;92313;80;0;0;0;0;.00nan;0;0
8825;161047;69;0;0;0;0;.00nan;0;0
8826;170598;4922;72;25;2;23;.920;3900000;0
8826;176136;76;0;0;0;0;.00nan;0;0
8826;78864;76;84;41;2;39;.951;3900000;0
8826;161046;4922;0;0;0;0;.00nan;0;0
8827;173918;4921;65;42;5;37;.881;3600000;0
8827;182049;4921;0;0;0;0;.00nan;0;0
8827;46790;71;0;0;0;0;.00nan;0;0
8827;78775;71;92;33;2;31;.939;3600000;0
8828;166545;1096;36;28;5;23;.821;3600000;0
8828;183775;1096;0;0;0;0;.00nan;0;0
8828;184049;1097;0;0;0;0;.00nan;0;0
8828;171730;1097;99;40;2;38;.950;3600000;0
8829;171970;82;0;0;0;0;.00nan;0;0
8829;-1;82;64;23;2;21;.913;3543000;0
8829;175423;77;91;34;1;33;.971;3600000;0
8829;180873;77;0;0;0;0;.00nan;0;0
8830;165611;81;89;41;2;39;.951;3600000;0
8830;176770;81;0;0;0;0;.00nan;0;0
8830;38209;149;69;19;1;18;.947;3600000;0
8830;86875;149;0;0;0;0;.00nan;0;0
8831;163989;72;86;16;0;16;1.000;3600000;0
8831;173918;4921;62;9;0;9;1.000;1115000;0
8831;182049;4921;27;37;8;29;.784;2485000;0
8831;64811;72;0;0;0;0;.00nan;0;0
8832;58054;69;60;31;3;28;.903;3600000;0
8832;85009;80;40;22;4;18;.818;3562000;0
8832;92313;80;0;0;0;0;.00nan;0;0
8832;161047;69;0;0;0;0;.00nan;0;0
8833;166545;1096;0;0;0;0;.00nan;0;0
8833;183775;1096;100;50;1;49;.980;3600000;0
8833;170598;4922;71;27;2;25;.926;3553000;0
8833;161046;4922;0;0;0;0;.00nan;0;0
8834;184158;4620;65;32;4;28;.875;3541000;0
8834;170612;74;0;0;0;0;.00nan;0;0
8834;181341;4620;0;0;0;0;.00nan;0;0
8834;57215;74;64;26;2;24;.923;3600000;0
8835;164987;85;69;24;2;22;.917;3600000;0
8835;37857;4245;50;33;5;28;.848;3600000;0
8835;186520;4245;0;0;0;0;.00nan;0;0
8835;57998;85;0;0;0;0;.00nan;0;0
8836;184049;1097;87;34;2;32;.941;3600000;0
8836;171730;1097;0;0;0;0;.00nan;0;0
8836;176136;76;37;6;2;4;.667;342000;0
8836;78864;76;65;44;6;38;.864;3258000;0
8837;46790;71;82;30;2;28;.933;3600000;0
8837;78775;71;0;0;0;0;.00nan;0;0
8837;85633;2564;0;0;0;0;.00nan;0;0
8837;86151;2564;83;41;3;38;.927;3570000;0
8838;4487;4920;0;0;0;0;.00nan;0;0
8838;183859;4920;61;19;2;17;.895;3600000;0
8838;184398;78;64;32;3;29;.906;3600000;0
8838;179406;78;0;0;0;0;.00nan;0;0
8839;178911;152;0;0;0;0;.00nan;0;0
8839;-1;157;0;0;0;0;.00nan;0;0
8839;57207;152;87;32;1;31;.969;3600000;0
8839;85555;157;79;41;4;37;.902;3600000;0
8840;173874;158;0;0;0;0;.00nan;0;0
8840;179411;151;0;0;0;0;.00nan;0;0
8840;176060;151;78;34;3;31;.912;3600000;0
8840;91398;158;70;33;4;29;.879;3600000;0
8841;-1;67;0;0;0;0;.00nan;0;0
8841;169096;67;71;30;3;27;.900;3608000;0
8841;173823;73;0;0;0;0;.00nan;0;0
8841;170963;73;57;21;2;19;.905;3608000;0
8842;171970;82;78;32;2;30;.938;3900000;0
8842;-1;82;0;0;0;0;.00nan;0;0
8842;175423;77;0;0;0;0;.00nan;0;0
8842;180873;77;86;40;2;38;.950;3900000;0
8843;169166;1095;64;34;3;31;.912;3600000;0
8843;46790;71;52;17;2;15;.882;2536000;0
8843;60773;1095;0;0;0;0;.00nan;0;0
8843;78775;71;8;13;6;7;.538;1064000;0
8844;165611;81;0;0;0;0;.00nan;0;0
8844;176770;81;86;35;2;33;.943;3553000;0
8844;38209;149;0;0;0;0;.00nan;0;0
8844;86875;149;83;24;1;23;.958;3600000;0
8845;163989;72;46;39;6;33;.846;3600000;0
8845;64811;72;0;0;0;0;.00nan;0;0
8845;85633;2564;0;0;0;0;.00nan;0;0
8845;86151;2564;91;52;3;49;.942;3600000;0
8846;58054;69;0;0;0;0;.00nan;0;0
8846;85009;80;0;0;0;0;.00nan;0;0
8846;92313;80;75;29;3;26;.897;3600000;0
8846;161047;69;39;24;4;20;.833;3600000;0
8847;166545;1096;64;45;5;40;.889;3600000;0
8847;183775;1096;0;0;0;0;.00nan;0;0
8847;170598;4922;0;0;0;0;.00nan;0;0
8847;161046;4922;58;14;2;12;.857;3600000;0
8848;164987;85;0;0;0;0;.00nan;0;0
8848;37857;4245;0;0;0;0;.00nan;0;0
8848;186520;4245;61;30;3;27;.900;3600000;0
8848;57998;85;46;31;5;26;.839;3586000;0
8849;184049;1097;44;4;1;3;.750;258000;0
8849;173856;75;56;19;2;17;.895;3600000;0
8849;171615;75;0;0;0;0;.00nan;0;0
8849;171730;1097;34;33;6;27;.818;3342000;0
8850;4487;4920;0;0;0;0;.00nan;0;0
8850;183859;4920;36;21;5;16;.762;3600000;0
8850;184398;78;56;5;0;5;1.000;573000;0
8850;179406;78;50;40;6;34;.850;3023000;0
8851;178911;152;57;27;3;24;.889;3560000;0
8851;-1;157;85;33;2;31;.939;3600000;0
8851;57207;152;0;0;0;0;.00nan;0;0
8851;85555;157;0;0;0;0;.00nan;0;0
8852;173874;158;83;32;3;29;.906;3600000;0
8852;179411;151;20;26;6;20;.769;3220000;0
8852;176060;151;49;1;0;1;1.000;380000;0
8852;91398;158;0;0;0;0;.00nan;0;0
8853;-1;67;58;32;4;28;.875;3556000;0
8853;169096;67;0;0;0;0;.00nan;0;0
8853;173823;73;0;0;0;0;.00nan;0;0
8853;170963;73;80;30;2;28;.933;3600000;0
8854;169166;1095;0;0;0;0;.00nan;0;0
8854;173918;4921;0;0;0;0;.00nan;0;0
8854;182049;4921;76;27;1;26;.963;3600000;0
8854;60773;1095;53;27;4;23;.852;3600000;0
8855;163989;72;0;0;0;0;.00nan;0;0
8855;46790;71;0;0;0;0;.00nan;0;0
8855;64811;72;64;18;1;17;.944;3600000;0
8855;78775;71;78;53;5;48;.906;3600000;0
8856;184158;4620;99;39;1;38;.974;3600000;0
8856;170612;74;0;0;0;0;.00nan;0;0
8856;181341;4620;0;0;0;0;.00nan;0;0
8856;57215;74;63;39;5;34;.872;3600000;0
8857;173856;75;0;0;0;0;.00nan;0;0
8857;171615;75;69;24;2;22;.917;3600000;0
8857;176136;76;60;27;3;24;.889;3596000;0
8857;78864;76;0;0;0;0;.00nan;0;0
8858;173874;158;0;0;0;0;.00nan;0;0
8858;179411;151;0;0;0;0;.00nan;0;0
8858;176060;151;72;37;4;33;.892;3586000;0
8858;91398;158;79;29;3;26;.897;3600000;0
8859;4487;4920;66;8;0;8;1.000;687000;0
8859;183859;4920;29;25;6;19;.760;2910000;0
8859;-1;67;38;7;2;5;.714;1369000;0
8859;169096;67;38;24;5;19;.792;2231000;0
8860;184158;4620;0;0;0;0;.00nan;0;0
8860;181341;4620;25;27;6;21;.778;3600000;0
8860;37857;4245;0;0;0;0;.00nan;0;0
8860;186520;4245;34;20;5;15;.750;3600000;0
8861;166545;1096;0;0;0;0;.00nan;0;0
8861;183775;1096;64;28;3;25;.893;3569000;0
8861;175423;77;79;31;2;29;.935;3600000;0
8861;180873;77;0;0;0;0;.00nan;0;0
8862;163989;72;82;16;0;16;1.000;3600000;0
8862;173823;73;0;0;0;0;.00nan;0;0
8862;170963;73;83;39;2;37;.949;3584000;0
8862;64811;72;0;0;0;0;.00nan;0;0
8863;170598;4922;66;21;2;19;.905;3558000;0
8863;176136;76;0;0;0;0;.00nan;0;0
8863;78864;76;99;40;1;39;.975;3600000;0
8863;161046;4922;0;0;0;0;.00nan;0;0
8864;58054;69;82;27;1;26;.963;3900000;0
8864;85633;2564;0;0;0;0;.00nan;0;0
8864;86151;2564;95;33;1;32;.970;3900000;0
8864;161047;69;0;0;0;0;.00nan;0;0
8865;170612;74;0;0;0;0;.00nan;0;0
8865;184398;78;59;29;3;26;.897;3571000;0
8865;179406;78;0;0;0;0;.00nan;0;0
8865;57215;74;86;26;1;25;.962;3600000;0
8866;184049;1097;25;16;5;11;.688;2336000;0
8866;173856;75;82;29;1;28;.966;3600000;0
8866;171615;75;0;0;0;0;.00nan;0;0
8866;171730;1097;65;17;1;16;.941;1264000;0
8867;165611;81;59;33;4;29;.879;3600000;0
8867;173874;158;0;0;0;0;.00nan;0;0
8867;176770;81;0;0;0;0;.00nan;0;0
8867;91398;158;74;23;1;22;.957;3600000;0
8868;178911;152;0;0;0;0;.00nan;0;0
8868;-1;157;0;0;0;0;.00nan;0;0
8868;57207;152;79;31;3;28;.903;3584000;0
8868;85555;157;71;24;2;22;.917;3600000;0
8869;164987;85;69;29;2;27;.931;3540000;0
8869;57998;85;0;0;0;0;.00nan;0;0
8869;85009;80;89;18;0;18;1.000;3600000;0
8869;92313;80;0;0;0;0;.00nan;0;0
8870;173918;4921;0;0;0;0;.00nan;0;0
8870;182049;4921;82;40;4;36;.900;3600000;0
8870;46790;71;0;0;0;0;.00nan;0;0
8870;78775;71;96;33;1;32;.970;3600000;0
8871;179411;151;0;0;0;0;.00nan;0;0
8871;176060;151;34;31;6;25;.806;3582000;0
8871;38209;149;0;0;0;0;.00nan;0;0
8871;86875;149;43;20;4;16;.800;3600000;0
8872;169166;1095;55;30;4;26;.867;3900000;0
8872;58054;69;62;28;4;24;.857;3900000;0
8872;60773;1095;0;0;0;0;.00nan;0;0
8872;161047;69;0;0;0;0;.00nan;0;0
8873;-1;67;48;35;6;29;.829;3600000;0
8873;169096;67;0;0;0;0;.00nan;0;0
8873;184158;4620;95;38;2;36;.947;3600000;0
8873;181341;4620;0;0;0;0;.00nan;0;0
8874;184049;1097;61;26;2;24;.923;3600000;0
8874;171730;1097;0;0;0;0;.00nan;0;0
8874;175423;77;0;0;0;0;.00nan;0;0
8874;180873;77;67;45;4;41;.911;3574000;0
8875;173823;73;0;0;0;0;.00nan;0;0
8875;173918;4921;0;0;0;0;.00nan;0;0
8875;170963;73;81;28;1;27;.964;3600000;0
8875;182049;4921;49;40;6;34;.850;3600000;0
8876;163989;72;82;28;1;27;.964;3600000;0
8876;169166;1095;0;0;0;0;.00nan;0;0
8876;60773;1095;67;38;3;35;.921;3546000;0
8876;64811;72;0;0;0;0;.00nan;0;0
8877;171970;82;51;21;3;18;.857;3600000;0
8877;-1;82;0;0;0;0;.00nan;0;0
8877;170598;4922;57;33;4;29;.879;3555000;0
8877;161046;4922;0;0;0;0;.00nan;0;0
8878;178911;152;0;0;0;0;.00nan;0;0
8878;179411;151;0;0;0;0;.00nan;0;0
8878;176060;151;77;43;4;39;.907;3600000;0
8878;57207;152;91;16;0;16;1.000;3600000;0
8879;4487;4920;0;0;0;0;.00nan;0;0
8879;183859;4920;70;32;3;29;.906;3600000;0
8879;37857;4245;68;33;4;29;.879;3549000;0
8879;186520;4245;0;0;0;0;.00nan;0;0
8880;170612;74;0;0;0;0;.00nan;0;0
8880;184398;78;85;35;3;32;.914;3556000;0
8880;179406;78;0;0;0;0;.00nan;0;0
8880;57215;74;77;32;2;30;.938;3600000;0
8881;165611;81;100;35;1;34;.971;3600000;0
8881;173874;158;0;0;0;0;.00nan;0;0
8881;176770;81;0;0;0;0;.00nan;0;0
8881;91398;158;58;37;5;32;.865;3600000;0
8882;166545;1096;0;0;0;0;.00nan;0;0
8882;183775;1096;63;32;3;29;.906;3513000;0
8882;176136;76;0;0;0;0;.00nan;0;0
8882;78864;76;81;23;1;22;.957;3600000;0
8883;46790;71;81;25;1;24;.960;3614000;0
8883;78775;71;0;0;0;0;.00nan;0;0
8883;85633;2564;0;0;0;0;.00nan;0;0
8883;86151;2564;70;25;2;23;.920;3614000;0
8884;-1;157;0;0;0;0;.00nan;0;0
8884;38209;149;0;0;0;0;.00nan;0;0
8884;85555;157;97;24;0;24;1.000;3600000;0
8884;86875;149;71;34;4;30;.882;3600000;0
8885;164987;85;60;36;4;32;.889;3576000;0
8885;57998;85;0;0;0;0;.00nan;0;0
8885;85009;80;78;26;2;24;.923;3600000;0
8885;92313;80;0;0;0;0;.00nan;0;0
8886;-1;67;0;0;0;0;.00nan;0;0
8886;169096;67;14;33;8;25;.758;3600000;0
8886;184158;4620;58;25;3;22;.880;3600000;0
8886;181341;4620;0;0;0;0;.00nan;0;0
8887;166545;1096;0;0;0;0;.00nan;0;0
8887;183775;1096;82;24;1;23;.958;3600000;0
8887;175423;77;57;31;4;27;.871;3600000;0
8887;180873;77;0;0;0;0;.00nan;0;0
8888;169166;1095;72;38;4;34;.895;3600000;0
8888;46790;71;0;0;0;0;.00nan;0;0
8888;60773;1095;0;0;0;0;.00nan;0;0
8888;78775;71;77;32;2;30;.938;3600000;0
8889;184049;1097;84;26;1;25;.962;2745000;0
8889;170598;4922;0;0;0;0;.00nan;0;0
8889;171730;1097;35;18;4;14;.778;1097000;0
8889;161046;4922;53;30;4;26;.867;3842000;0
8890;173823;73;0;0;0;0;.00nan;0;0
8890;170963;73;73;35;3;32;.914;3542000;0
8890;85633;2564;0;0;0;0;.00nan;0;0
8890;86151;2564;77;26;1;25;.962;3600000;0
8891;178911;152;0;0;0;0;.00nan;0;0
8891;179411;151;14;5;4;1;.200;698000;0
8891;176060;151;89;31;1;30;.968;2902000;0
8891;57207;152;100;26;0;26;1.000;3600000;0
8892;4487;4920;80;23;1;22;.957;3600000;0
8892;183859;4920;0;0;0;0;.00nan;0;0
8892;37857;4245;0;0;0;0;.00nan;0;0
8892;186520;4245;59;35;5;30;.857;3600000;0
8893;170612;74;68;20;1;19;.950;3900000;0
8893;184398;78;90;35;1;34;.971;3900000;0
8893;179406;78;0;0;0;0;.00nan;0;0
8893;57215;74;0;0;0;0;.00nan;0;0
8894;171970;82;0;0;0;0;.00nan;0;0
8894;-1;82;73;39;4;35;.897;3900000;0
8894;173856;75;73;39;4;35;.897;3900000;0
8894;171615;75;0;0;0;0;.00nan;0;0
8895;165611;81;61;25;3;22;.880;3600000;0
8895;173874;158;46;36;6;30;.833;3600000;0
8895;176770;81;0;0;0;0;.00nan;0;0
8895;91398;158;0;0;0;0;.00nan;0;0
8896;-1;157;0;0;0;0;.00nan;0;0
8896;38209;149;0;0;0;0;.00nan;0;0
8896;85555;157;22;23;6;17;.739;3600000;0
8896;86875;149;56;27;3;24;.889;3600000;0
8897;164987;85;0;0;0;0;.00nan;0;0
8897;57998;85;88;36;1;35;.972;3600000;0
8897;85009;80;0;0;0;0;.00nan;0;0
8897;92313;80;69;23;2;21;.913;3585000;0
8898;173918;4921;98;49;3;46;.939;3600000;0
8898;182049;4921;0;0;0;0;.00nan;0;0
8898;58054;69;77;27;2;25;.926;3600000;0
8898;161047;69;0;0;0;0;.00nan;0;0
8899;163989;72;29;18;4;14;.778;990000;0
8899;64811;72;62;15;1;14;.933;2610000;0
8899;85633;2564;0;0;0;0;.00nan;0;0
8899;86151;2564;81;34;2;32;.941;3600000;0
8900;184049;1097;0;0;0;0;.00nan;0;0
8900;173856;75;0;0;0;0;.00nan;0;0
8900;171615;75;78;44;4;40;.909;3753000;0
8900;171730;1097;53;36;5;31;.861;3753000;0
8901;-1;157;0;0;0;0;.00nan;0;0
8901;179411;151;58;47;6;41;.872;3323000;0
8901;176060;151;39;1;1;0;.000;277000;0
8901;85555;157;87;16;0;16;1.000;3600000;0
8902;173918;4921;0;0;0;0;.00nan;0;0
8902;182049;4921;99;45;2;43;.956;3900000;0
8902;58054;69;0;0;0;0;.00nan;0;0
8902;161047;69;56;23;2;21;.913;3900000;0
8903;171970;82;54;30;3;27;.900;3562000;0
8903;-1;82;0;0;0;0;.00nan;0;0
8903;184158;4620;71;27;2;25;.926;3600000;0
8903;181341;4620;0;0;0;0;.00nan;0;0
8904;164987;85;66;29;3;26;.897;3570000;0
8904;165611;81;81;33;2;31;.939;3600000;0
8904;176770;81;0;0;0;0;.00nan;0;0
8904;57998;85;0;0;0;0;.00nan;0;0
8905;163989;72;0;0;0;0;.00nan;0;0
8905;173918;4921;62;10;0;10;1.000;311000;0
8905;182049;4921;54;51;7;44;.863;3289000;0
8905;64811;72;57;19;2;17;.895;3600000;0
8906;173856;75;0;0;0;0;.00nan;0;0
8906;170598;4922;99;24;0;24;1.000;3600000;0
8906;171615;75;45;24;4;20;.833;3600000;0
8906;161046;4922;0;0;0;0;.00nan;0;0
8907;184398;78;0;0;0;0;.00nan;0;0
8907;179406;78;64;14;1;13;.929;3600000;0
8907;176136;76;0;0;0;0;.00nan;0;0
8907;78864;76;86;53;5;48;.906;3600000;0
8908;-1;157;0;0;0;0;.00nan;0;0
8908;179411;151;100;41;1;40;.976;3600000;0
8908;176060;151;0;0;0;0;.00nan;0;0
8908;85555;157;43;14;2;12;.857;3590000;0
8909;-1;67;89;42;3;39;.929;3900000;0
8909;169096;67;0;0;0;0;.00nan;0;0
8909;178911;152;0;0;0;0;.00nan;0;0
8909;57207;152;45;18;3;15;.833;3900000;0
8910;184049;1097;38;24;5;19;.792;3529000;0
8910;184398;78;59;27;3;24;.889;3600000;0
8910;171730;1097;0;0;0;0;.00nan;0;0
8910;179406;78;0;0;0;0;.00nan;0;0
8911;171970;82;32;38;7;31;.816;3600000;0
8911;-1;82;0;0;0;0;.00nan;0;0
8911;184158;4620;100;39;1;38;.974;3600000;0
8911;181341;4620;0;0;0;0;.00nan;0;0
8912;38209;149;0;0;0;0;.00nan;0;0
8912;85009;80;45;39;6;33;.846;3600000;0
8912;86875;149;68;25;2;23;.920;3600000;0
8912;92313;80;0;0;0;0;.00nan;0;0
8913;183755;69;77;29;2;27;.931;3600000;0
8913;173823;73;0;0;0;0;.00nan;0;0
8913;170963;73;71;38;3;35;.921;3600000;0
8913;161047;69;0;0;0;0;.00nan;0;0
8914;163989;72;77;31;3;28;.903;3648000;0
8914;169166;1095;58;32;4;28;.875;3648000;0
8914;60773;1095;0;0;0;0;.00nan;0;0
8914;64811;72;0;0;0;0;.00nan;0;0
8915;166545;1096;0;0;0;0;.00nan;0;0
8915;183775;1096;55;38;4;34;.895;3600000;0
8915;175423;77;0;0;0;0;.00nan;0;0
8915;180873;77;87;32;1;31;.969;3600000;0
8916;164987;85;0;0;0;0;.00nan;0;0
8916;165611;81;55;37;5;32;.865;3544000;0
8916;176770;81;0;0;0;0;.00nan;0;0
8916;57998;85;63;34;4;30;.882;3600000;0
8917;4487;4920;0;0;0;0;.00nan;0;0
8917;183859;4920;94;37;3;34;.919;3600000;0
8917;178911;152;0;0;0;0;.00nan;0;0
8917;57207;152;66;37;4;33;.892;3552000;0
8918;173856;75;66;23;2;21;.913;3600000;0
8918;170598;4922;70;36;3;33;.917;3568000;0
8918;171615;75;0;0;0;0;.00nan;0;0
8918;161046;4922;0;0;0;0;.00nan;0;0
8919;37857;4245;100;29;0;29;1.000;3600000;0
8919;186520;4245;0;0;0;0;.00nan;0;0
8919;85633;2564;0;0;0;0;.00nan;0;0
8919;86151;2564;77;26;1;25;.962;3563000;0
8920;184049;1097;0;0;0;0;.00nan;0;0
8920;171730;1097;73;25;2;23;.920;3600000;0
8920;176136;76;0;0;0;0;.00nan;0;0
8920;78864;76;95;43;3;40;.930;3591000;0
8921;173918;4921;0;0;0;0;.00nan;0;0
8921;182049;4921;63;46;5;41;.891;3600000;0
8921;46790;71;0;0;0;0;.00nan;0;0
8921;78775;71;72;27;2;25;.926;3600000;0
8922;-1;67;92;30;1;29;.967;3600000;0
8922;169096;67;0;0;0;0;.00nan;0;0
8922;170612;74;0;0;0;0;.00nan;0;0
8922;57215;74;100;28;0;28;1.000;3600000;0
8923;171970;82;0;0;0;0;.00nan;0;0
8923;-1;82;12;28;8;20;.714;3600000;0
8923;184158;4620;47;30;4;26;.867;3600000;0
8923;181341;4620;0;0;0;0;.00nan;0;0
8924;179411;151;0;0;0;0;.00nan;0;0
8924;176060;151;81;27;1;26;.963;3546000;0
8924;38209;149;94;22;0;22;1.000;3600000;0
8924;86875;149;0;0;0;0;.00nan;0;0
8925;184049;1097;58;25;3;22;.880;3600000;0
8925;171730;1097;0;0;0;0;.00nan;0;0
8925;175423;77;42;30;5;25;.833;3574000;0
8925;180873;77;0;0;0;0;.00nan;0;0
8926;169166;1095;0;0;0;0;.00nan;0;0
8926;173823;73;0;0;0;0;.00nan;0;0
8926;170963;73;74;29;2;27;.931;3600000;0
8926;60773;1095;57;23;3;20;.870;3560000;0
8927;166545;1096;0;0;0;0;.00nan;0;0
8927;183775;1096;75;26;1;25;.962;3600000;0
8927;176136;76;62;22;2;20;.909;3543000;0
8927;78864;76;0;0;0;0;.00nan;0;0
8928;164987;85;100;37;1;36;.973;3600000;0
8928;165611;81;0;0;0;0;.00nan;0;0
8928;176770;81;80;33;2;31;.939;3548000;0
8928;57998;85;0;0;0;0;.00nan;0;0
8929;163989;72;0;0;0;0;.00nan;0;0
8929;173918;4921;83;36;2;34;.944;3600000;0
8929;182049;4921;0;0;0;0;.00nan;0;0
8929;64811;72;65;27;3;24;.889;3543000;0
8930;170598;4922;0;0;0;0;.00nan;0;0
8930;184398;78;44;31;5;26;.839;3600000;0
8930;179406;78;0;0;0;0;.00nan;0;0
8930;161046;4922;75;29;2;27;.931;3600000;0
8931;4487;4920;66;27;3;24;.889;3600000;0
8931;183859;4920;0;0;0;0;.00nan;0;0
8931;178911;152;57;31;4;27;.871;3600000;0
8931;57207;152;0;0;0;0;.00nan;0;0
8932;37857;4245;70;31;3;28;.903;3600000;0
8932;186520;4245;0;0;0;0;.00nan;0;0
8932;85633;2564;0;0;0;0;.00nan;0;0
8932;86151;2564;100;29;0;29;1.000;3600000;0
8933;183755;69;75;33;2;31;.939;3600000;0
8933;46790;71;53;35;5;30;.857;3600000;0
8933;78775;71;0;0;0;0;.00nan;0;0
8933;161047;69;0;0;0;0;.00nan;0;0
8934;-1;157;0;0;0;0;.00nan;0;0
8934;85009;80;0;0;0;0;.00nan;0;0
8934;85555;157;52;17;2;15;.882;3600000;0
8934;92313;80;59;38;5;33;.868;3600000;0
8935;-1;67;0;0;0;0;.00nan;0;0
8935;169096;67;51;42;6;36;.857;3600000;0
8935;170612;74;0;0;0;0;.00nan;0;0
8935;57215;74;93;33;1;32;.970;3600000;0
8936;173856;75;43;30;5;25;.833;3600000;0
8936;171615;75;0;0;0;0;.00nan;0;0
8936;175423;77;0;0;0;0;.00nan;0;0
8936;180873;77;55;22;3;19;.864;3600000;0
8937;163989;72;100;27;0;27;1.000;3600000;0
8937;169166;1095;52;32;4;28;.875;3600000;0
8937;60773;1095;0;0;0;0;.00nan;0;0
8937;64811;72;0;0;0;0;.00nan;0;0
8938;184398;78;0;0;0;0;.00nan;0;0
8938;179406;78;59;27;3;24;.889;3600000;0
8938;176136;76;65;10;0;10;1.000;632000;0
8938;78864;76;24;25;6;19;.760;2968000;0
8939;183755;69;61;34;4;30;.882;3600000;0
8939;46790;71;0;0;0;0;.00nan;0;0
8939;78775;71;57;46;7;39;.848;3600000;0
8939;161047;69;0;0;0;0;.00nan;0;0
8940;-1;157;0;0;0;0;.00nan;0;0
8940;85009;80;73;34;3;31;.912;3600000;0
8940;85555;157;61;20;2;18;.900;3600000;0
8940;92313;80;0;0;0;0;.00nan;0;0
8941;173918;4921;49;2;0;2;1.000;517000;0
8941;182049;4921;34;28;6;22;.786;3083000;0
8941;85633;2564;0;0;0;0;.00nan;0;0
8941;86151;2564;60;24;3;21;.875;3600000;0
8942;173874;158;0;0;0;0;.00nan;0;0
8942;179411;151;68;26;3;23;.885;3641000;0
8942;176060;151;0;0;0;0;.00nan;0;0
8942;91398;158;94;37;2;35;.946;3641000;0
8943;184049;1097;71;34;3;31;.912;3900000;0
8943;170598;4922;68;34;3;31;.912;3900000;0
8943;171730;1097;0;0;0;0;.00nan;0;0
8943;161046;4922;0;0;0;0;.00nan;0;0
8944;184158;4620;51;19;3;16;.842;3600000;0
8944;181341;4620;0;0;0;0;.00nan;0;0
8944;37857;4245;49;43;6;37;.860;3324000;0
8944;186520;4245;35;5;2;3;.600;276000;0
8945;171970;82;50;24;4;20;.833;3600000;0
8945;-1;82;0;0;0;0;.00nan;0;0
8945;176136;76;56;12;1;11;.917;1189000;0
8945;78864;76;32;24;5;19;.792;2380000;0
8946;166545;1096;0;0;0;0;.00nan;0;0
8946;183775;1096;43;41;6;35;.854;3600000;0
8946;173823;73;0;0;0;0;.00nan;0;0
8946;170963;73;83;28;1;27;.964;3600000;0
8947;165611;81;61;30;3;27;.900;3533000;0
8947;178911;152;0;0;0;0;.00nan;0;0
8947;176770;81;0;0;0;0;.00nan;0;0
8947;57207;152;90;29;1;28;.966;3600000;0
8948;46790;71;92;32;1;31;.969;2962000;0
8948;78775;71;30;9;3;6;.667;588000;0
8948;85633;2564;0;0;0;0;.00nan;0;0
8948;86151;2564;65;28;3;25;.893;3600000;0
8949;4487;4920;0;0;0;0;.00nan;0;0
8949;183859;4920;70;21;2;19;.905;3600000;0
8949;184398;78;77;39;3;36;.923;3600000;0
8949;179406;78;0;0;0;0;.00nan;0;0
8950;38209;149;75;32;2;30;.938;3568000;0
8950;85009;80;61;15;1;14;.933;3600000;0
8950;86875;149;0;0;0;0;.00nan;0;0
8950;92313;80;0;0;0;0;.00nan;0;0
8951;173874;158;0;0;0;0;.00nan;0;0
8951;179411;151;0;0;0;0;.00nan;0;0
8951;176060;151;68;31;3;28;.903;3600000;0
8951;91398;158;100;36;0;36;1.000;3600000;0
8952;171970;82;83;14;0;14;1.000;3600000;0
8952;-1;82;0;0;0;0;.00nan;0;0
8952;176136;76;51;47;6;41;.872;3600000;0
8952;78864;76;0;0;0;0;.00nan;0;0
8953;169166;1095;56;35;4;31;.886;3562000;0
8953;-1;157;0;0;0;0;.00nan;0;0
8953;60773;1095;0;0;0;0;.00nan;0;0
8953;85555;157;62;25;3;22;.880;3600000;0
8954;163989;72;38;25;5;20;.800;3600000;0
8954;173918;4921;0;0;0;0;.00nan;0;0
8954;182049;4921;75;29;2;27;.931;3600000;0
8954;64811;72;0;0;0;0;.00nan;0;0
8955;183755;69;100;24;0;24;1.000;3600000;0
8955;85633;2564;0;0;0;0;.00nan;0;0
8955;86151;2564;74;39;3;36;.923;3600000;0
8955;161047;69;0;0;0;0;.00nan;0;0
8956;165611;81;67;32;2;30;.938;3600000;0
8956;178911;152;0;0;0;0;.00nan;0;0
8956;176770;81;0;0;0;0;.00nan;0;0
8956;57207;152;69;16;1;15;.938;3600000;0
8957;4487;4920;0;0;0;0;.00nan;0;0
8957;183859;4920;86;26;1;25;.962;3600000;0
8957;170728;85;0;0;0;0;.00nan;0;0
8957;57998;85;67;37;4;33;.892;3600000;0
8958;170598;4922;29;37;7;30;.811;3600000;0
8958;170612;74;0;0;0;0;.00nan;0;0
8958;57215;74;73;25;1;24;.960;3600000;0
8958;161046;4922;0;0;0;0;.00nan;0;0
8959;166545;1096;57;21;2;19;.905;2507000;0
8959;183775;1096;22;11;4;7;.636;1093000;0
8959;173856;75;0;0;0;0;.00nan;0;0
8959;171615;75;77;26;1;25;.962;3600000;0
8960;173874;158;0;0;0;0;.00nan;0;0
8960;179411;151;61;31;3;28;.903;3600000;0
8960;176060;151;0;0;0;0;.00nan;0;0
8960;91398;158;100;41;1;40;.976;3600000;0
8961;184398;78;0;0;0;0;.00nan;0;0
8961;179406;78;59;25;3;22;.880;3600000;0
8961;37857;4245;0;0;0;0;.00nan;0;0
8961;186520;4245;62;28;2;26;.929;3600000;0
8962;184049;1097;50;25;3;22;.880;3600000;0
8962;171730;1097;0;0;0;0;.00nan;0;0
8962;175423;77;88;38;2;36;.947;3600000;0
8962;180873;77;0;0;0;0;.00nan;0;0
8963;173823;73;0;0;0;0;.00nan;0;0
8963;170963;73;51;31;4;27;.871;3525000;0
8963;46790;71;91;30;2;28;.933;3600000;0
8963;78775;71;0;0;0;0;.00nan;0;0
8964;38209;149;0;0;0;0;.00nan;0;0
8964;85009;80;85;31;2;29;.935;3600000;0
8964;86875;149;70;33;3;30;.909;3600000;0
8964;92313;80;0;0;0;0;.00nan;0;0
8965;-1;67;76;31;2;29;.935;3595000;0
8965;169096;67;0;0;0;0;.00nan;0;0
8965;184158;4620;93;31;1;30;.968;3600000;0
8965;181341;4620;0;0;0;0;.00nan;0;0
8966;173823;73;0;0;0;0;.00nan;0;0
8966;170963;73;72;28;2;26;.929;3600000;0
8966;46790;71;0;0;0;0;.00nan;0;0
8966;78775;71;54;28;4;24;.857;3600000;0
8967;171970;82;67;16;1;15;.938;3600000;0
8967;-1;82;0;0;0;0;.00nan;0;0
8967;176136;76;0;0;0;0;.00nan;0;0
8967;78864;76;87;47;4;43;.915;3600000;0
8968;163989;72;0;0;0;0;.00nan;0;0
8968;169166;1095;0;0;0;0;.00nan;0;0
8968;60773;1095;87;53;5;48;.906;3574000;0
8968;64811;72;43;23;4;19;.826;3600000;0
8969;183755;69;45;21;4;17;.810;3731000;0
8969;85633;2564;89;45;3;42;.933;3731000;0
8969;86151;2564;0;0;0;0;.00nan;0;0
8969;161047;69;0;0;0;0;.00nan;0;0
8970;165611;81;0;0;0;0;.00nan;0;0
8970;178911;152;67;23;2;21;.913;3600000;0
8970;176770;81;57;35;4;31;.886;3551000;0
8970;57207;152;0;0;0;0;.00nan;0;0
8971;4487;4920;92;22;0;22;1.000;3600000;0
8971;183859;4920;0;0;0;0;.00nan;0;0
8971;170728;85;98;40;1;39;.975;3600000;0
8971;57998;85;0;0;0;0;.00nan;0;0
8972;170598;4922;0;0;0;0;.00nan;0;0
8972;170612;74;0;0;0;0;.00nan;0;0
8972;57215;74;63;27;3;24;.889;3600000;0
8972;161046;4922;88;49;4;45;.918;3569000;0
8973;173856;75;65;39;4;35;.897;3591000;0
8973;171615;75;0;0;0;0;.00nan;0;0
8973;175423;77;0;0;0;0;.00nan;0;0
8973;180873;77;60;30;3;27;.900;3600000;0
8974;173874;158;76;38;3;35;.921;3900000;0
8974;179411;151;0;0;0;0;.00nan;0;0
8974;176060;151;54;24;3;21;.875;3900000;0
8974;91398;158;0;0;0;0;.00nan;0;0
8975;184398;78;29;30;6;24;.800;3099000;0
8975;179406;78;49;7;1;6;.857;501000;0
8975;37857;4245;48;23;4;19;.826;3600000;0
8975;186520;4245;0;0;0;0;.00nan;0;0
8976;166545;1096;0;0;0;0;.00nan;0;0
8976;183775;1096;56;34;4;30;.882;3600000;0
8976;184049;1097;0;0;0;0;.00nan;0;0
8976;171730;1097;45;28;5;23;.821;3600000;0
8977;38209;149;56;7;0;7;1.000;1426000;0
8977;85009;80;0;0;0;0;.00nan;0;0
8977;86875;149;25;11;4;7;.636;2174000;0
8977;92313;80;96;31;1;30;.968;3600000;0
8978;173918;4921;75;43;4;39;.907;3600000;0
8978;-1;157;0;0;0;0;.00nan;0;0
8978;182049;4921;0;0;0;0;.00nan;0;0
8978;85555;157;82;29;1;28;.966;3600000;0
8979;-1;67;0;0;0;0;.00nan;0;0
8979;169096;67;71;34;3;31;.912;3595000;0
8979;184158;4620;85;30;1;29;.967;3600000;0
8979;181341;4620;0;0;0;0;.00nan;0;0
8980;183755;69;82;37;3;34;.919;3600000;0
8980;169166;1095;60;33;4;29;.879;3600000;0
8980;60773;1095;0;0;0;0;.00nan;0;0
8980;161047;69;0;0;0;0;.00nan;0;0
8981;166545;1096;32;23;5;18;.783;2337000;0
8981;183775;1096;54;20;2;18;.900;1263000;0
8981;184049;1097;71;38;4;34;.895;3600000;0
8981;171730;1097;0;0;0;0;.00nan;0;0
8982;173823;73;0;0;0;0;.00nan;0;0
8982;170963;73;55;27;4;23;.852;3545000;0
8982;85633;2564;0;0;0;0;.00nan;0;0
8982;86151;2564;83;38;3;35;.921;3600000;0
8983;4487;4920;74;22;2;20;.909;3559000;0
8983;183859;4920;0;0;0;0;.00nan;0;0
8983;170728;85;0;0;0;0;.00nan;0;0
8983;57998;85;100;33;0;33;1.000;3600000;0
8984;173856;75;0;0;0;0;.00nan;0;0
8984;171615;75;26;27;6;21;.778;3892000;0
8984;175423;77;0;0;0;0;.00nan;0;0
8984;180873;77;28;26;6;20;.769;3900000;0
8985;173918;4921;0;0;0;0;.00nan;0;0
8985;-1;157;73;20;1;19;.950;3600000;0
8985;182049;4921;66;41;5;36;.878;3600000;0
8985;85555;157;0;0;0;0;.00nan;0;0
8986;184158;4620;56;21;2;19;.905;3559000;0
8986;170728;85;0;0;0;0;.00nan;0;0
8986;181341;4620;0;0;0;0;.00nan;0;0
8986;57998;85;100;37;1;36;.973;3600000;0
8987;173823;73;0;0;0;0;.00nan;0;0
8987;170963;73;82;30;1;29;.967;3600000;0
8987;85009;80;59;29;3;26;.897;3572000;0
8987;92313;80;0;0;0;0;.00nan;0;0
8988;166545;1096;0;0;0;0;.00nan;0;0
8988;183775;1096;76;32;2;30;.938;3600000;0
8988;175423;77;70;34;3;31;.912;3560000;0
8988;180873;77;0;0;0;0;.00nan;0;0
8989;165611;81;71;23;1;22;.957;3600000;0
8989;173874;158;41;3;1;2;.667;1000000;0
8989;176770;81;0;0;0;0;.00nan;0;0
8989;91398;158;17;20;6;14;.700;2600000;0
8990;178911;152;0;0;0;0;.00nan;0;0
8990;38209;149;91;29;2;27;.931;3600000;0
8990;57207;152;48;33;5;28;.848;3600000;0
8990;86875;149;0;0;0;0;.00nan;0;0
8991;170612;74;0;0;0;0;.00nan;0;0
8991;184398;78;40;41;6;35;.854;3132000;0
8991;179406;78;28;8;3;5;.625;468000;0
8991;57215;74;81;37;3;34;.919;3600000;0
8992;184049;1097;83;34;2;32;.941;3600000;0
8992;170598;4922;53;37;5;32;.865;3600000;0
8992;171730;1097;0;0;0;0;.00nan;0;0
8992;161046;4922;0;0;0;0;.00nan;0;0
8993;184158;4620;84;21;1;20;.952;3600000;0
8993;170728;85;0;0;0;0;.00nan;0;0
8993;181341;4620;0;0;0;0;.00nan;0;0
8993;57998;85;76;45;5;40;.889;3600000;0
8994;170598;4922;0;0;0;0;.00nan;0;0
8994;175423;77;0;0;0;0;.00nan;0;0
8994;180873;77;66;27;3;24;.889;3600000;0
8994;161046;4922;68;40;4;36;.900;3597000;0
8995;173823;73;0;0;0;0;.00nan;0;0
8995;170963;73;69;31;2;29;.935;3600000;0
8995;85633;2564;0;0;0;0;.00nan;0;0
8995;86151;2564;44;32;5;27;.844;3600000;0
8996;169166;1095;15;27;7;20;.741;2388000;0
8996;60773;1095;53;8;1;7;.875;1212000;0
8996;85009;80;88;32;1;31;.969;3600000;0
8996;92313;80;0;0;0;0;.00nan;0;0
8997;165611;81;0;0;0;0;.00nan;0;0
8997;173874;158;0;0;0;0;.00nan;0;0
8997;176770;81;76;34;3;31;.912;3900000;0
8997;91398;158;71;38;3;35;.921;3900000;0
8998;183755;69;0;0;0;0;.00nan;0;0
8998;46790;71;0;0;0;0;.00nan;0;0
8998;78775;71;69;35;3;32;.914;3600000;0
8998;161047;69;100;25;0;25;1.000;3600000;0
8999;178911;152;0;0;0;0;.00nan;0;0
8999;38209;149;0;0;0;0;.00nan;0;0
8999;57207;152;80;27;2;25;.926;3879000;0
8999;86875;149;78;35;3;32;.914;3879000;0
9000;171970;82;33;31;6;25;.806;3600000;0
9000;-1;82;0;0;0;0;.00nan;0;0
9000;173856;75;0;0;0;0;.00nan;0;0
9000;171615;75;88;28;1;27;.964;3600000;0
9001;-1;67;0;0;0;0;.00nan;0;0
9001;169096;67;37;40;7;33;.825;3600000;0
9001;37857;4245;83;32;1;31;.969;3600000;0
9001;186520;4245;0;0;0;0;.00nan;0;0
9002;166545;1096;0;0;0;0;.00nan;0;0
9002;183775;1096;68;33;3;30;.909;3900000;0
9002;176136;76;76;35;3;32;.914;3900000;0
9002;78864;76;0;0;0;0;.00nan;0;0
9003;170612;74;0;0;0;0;.00nan;0;0
9003;184398;78;0;0;0;0;.00nan;0;0
9003;179406;78;72;30;2;28;.933;3600000;0
9003;57215;74;57;37;6;31;.838;3600000;0
9004;163989;72;52;26;4;22;.846;3900000;0
9004;173918;4921;79;41;4;37;.902;3900000;0
9004;182049;4921;0;0;0;0;.00nan;0;0
9004;64811;72;0;0;0;0;.00nan;0;0
9005;-1;67;50;25;4;21;.840;3600000;0
9005;169096;67;0;0;0;0;.00nan;0;0
9005;184158;4620;0;0;0;0;.00nan;0;0
9005;181341;4620;45;33;5;28;.848;3573000;0
9006;166545;1096;71;37;3;34;.919;3544000;0
9006;183775;1096;0;0;0;0;.00nan;0;0
9006;175423;77;61;20;2;18;.900;3600000;0
9006;180873;77;0;0;0;0;.00nan;0;0
9007;171970;82;0;0;0;0;.00nan;0;0
9007;-1;82;100;29;0;29;1.000;3600000;0
9007;173856;75;79;41;3;38;.927;3600000;0
9007;171615;75;0;0;0;0;.00nan;0;0
9008;169166;1095;23;26;6;20;.769;3126000;0
9008;60773;1095;41;2;1;1;.500;474000;0
9008;85009;80;0;0;0;0;.00nan;0;0
9008;92313;80;54;24;3;21;.875;3600000;0
9009;165611;81;51;37;5;32;.865;3600000;0
9009;173874;158;0;0;0;0;.00nan;0;0
9009;176770;81;0;0;0;0;.00nan;0;0
9009;91398;158;69;23;2;21;.913;3600000;0
9010;163989;72;0;0;0;0;.00nan;0;0
9010;64811;72;98;33;1;32;.970;3600000;0
9010;85633;2564;81;34;2;32;.941;3555000;0
9010;86151;2564;0;0;0;0;.00nan;0;0
9011;183755;69;96;34;1;33;.971;3600000;0
9011;46790;71;53;41;6;35;.854;3600000;0
9011;78775;71;0;0;0;0;.00nan;0;0
9011;161047;69;0;0;0;0;.00nan;0;0
9012;184049;1097;60;28;3;25;.893;3830000;0
9012;170598;4922;94;44;2;42;.955;3830000;0
9012;171730;1097;0;0;0;0;.00nan;0;0
9012;161046;4922;0;0;0;0;.00nan;0;0
9013;178911;152;66;37;4;33;.892;3600000;0
9013;38209;149;57;41;5;36;.878;3597000;0
9013;57207;152;0;0;0;0;.00nan;0;0
9013;86875;149;0;0;0;0;.00nan;0;0
9014;4487;4920;0;0;0;0;.00nan;0;0
9014;183859;4920;39;19;4;15;.789;3900000;0
9014;170728;85;0;0;0;0;.00nan;0;0
9014;57998;85;83;45;4;41;.911;3900000;0
9015;170612;74;0;0;0;0;.00nan;0;0
9015;184398;78;84;35;2;33;.943;3600000;0
9015;179406;78;0;0;0;0;.00nan;0;0
9015;57215;74;48;28;4;24;.857;3593000;0
9016;173823;73;0;0;0;0;.00nan;0;0
9016;173918;4921;0;0;0;0;.00nan;0;0
9016;170963;73;97;50;3;47;.940;3900000;0
9016;182049;4921;69;34;3;31;.912;3900000;0
9017;169166;1095;0;0;0;0;.00nan;0;0
9017;60773;1095;79;44;4;40;.909;3537000;0
9017;85009;80;67;24;2;22;.917;3600000;0
9017;92313;80;0;0;0;0;.00nan;0;0
9018;183755;69;0;0;0;0;.00nan;0;0
9018;46790;71;0;0;0;0;.00nan;0;0
9018;78775;71;58;40;6;34;.850;3600000;0
9018;161047;69;82;18;0;18;1.000;3600000;0
9019;4487;4920;93;22;0;22;1.000;3600000;0
9019;183859;4920;0;0;0;0;.00nan;0;0
9019;184158;4620;88;29;1;28;.966;3600000;0
9019;181341;4620;0;0;0;0;.00nan;0;0
9020;166545;1096;0;0;0;0;.00nan;0;0
9020;183775;1096;73;22;1;21;.955;3600000;0
9020;184049;1097;0;0;0;0;.00nan;0;0
9020;171730;1097;55;21;2;19;.905;3600000;0
9021;-1;157;0;0;0;0;.00nan;0;0
9021;179411;151;0;0;0;0;.00nan;0;0
9021;176060;151;87;41;2;39;.951;3900000;0
9021;85555;157;81;23;2;21;.913;3900000;0
9022;173874;158;0;0;0;0;.00nan;0;0
9022;38209;149;0;0;0;0;.00nan;0;0
9022;86875;149;55;20;2;18;.900;3600000;0
9022;91398;158;54;43;6;37;.860;3600000;0
9023;166545;1096;0;0;0;0;.00nan;0;0
9023;183775;1096;76;34;3;31;.912;3600000;0
9023;175423;77;0;0;0;0;.00nan;0;0
9023;180873;77;40;20;4;16;.800;3562000;0
9024;171970;82;0;0;0;0;.00nan;0;0
9024;-1;82;72;24;1;23;.958;3600000;0
9024;170598;4922;52;24;3;21;.875;3567000;0
9024;161046;4922;0;0;0;0;.00nan;0;0
9025;178911;152;0;0;0;0;.00nan;0;0
9025;-1;157;0;0;0;0;.00nan;0;0
9025;57207;152;73;29;3;26;.897;3552000;0
9025;85555;157;54;19;2;17;.895;3600000;0
9026;170612;74;0;0;0;0;.00nan;0;0
9026;37857;4245;37;36;6;30;.833;3600000;0
9026;186520;4245;0;0;0;0;.00nan;0;0
9026;57215;74;66;17;1;16;.941;3600000;0
9027;184158;4620;53;38;6;32;.842;3600000;0
9027;184398;78;0;0;0;0;.00nan;0;0
9027;179406;78;90;35;2;33;.943;3600000;0
9027;181341;4620;0;0;0;0;.00nan;0;0
9028;183755;69;82;33;2;31;.939;3900000;0
9028;169166;1095;77;26;2;24;.923;3900000;0
9028;60773;1095;0;0;0;0;.00nan;0;0
9028;161047;69;0;0;0;0;.00nan;0;0
9029;184049;1097;70;38;3;35;.921;3546000;0
9029;173856;75;0;0;0;0;.00nan;0;0
9029;171615;75;65;24;2;22;.917;3600000;0
9029;171730;1097;0;0;0;0;.00nan;0;0
9030;4487;4920;77;24;1;23;.958;3900000;0
9030;183859;4920;0;0;0;0;.00nan;0;0
9030;184158;4620;100;43;1;42;.977;3900000;0
9030;181341;4620;0;0;0;0;.00nan;0;0
9031;173874;158;0;0;0;0;.00nan;0;0
9031;38209;149;0;0;0;0;.00nan;0;0
9031;86875;149;39;18;4;14;.778;3600000;0
9031;91398;158;68;38;5;33;.868;3549000;0
9032;173823;73;0;0;0;0;.00nan;0;0
9032;173918;4921;0;0;0;0;.00nan;0;0
9032;170963;73;81;28;1;27;.964;3900000;0
9032;182049;4921;98;43;1;42;.977;3900000;0
9033;166545;1096;0;0;0;0;.00nan;0;0
9033;183775;1096;58;28;3;25;.893;3549000;0
9033;173856;75;78;23;1;22;.957;3600000;0
9033;171615;75;0;0;0;0;.00nan;0;0
9034;165611;81;61;27;3;24;.889;3579000;0
9034;176770;81;0;0;0;0;.00nan;0;0
9034;85009;80;68;25;2;23;.920;3600000;0
9034;92313;80;0;0;0;0;.00nan;0;0
9035;183755;69;0;0;0;0;.00nan;0;0
9035;169166;1095;0;0;0;0;.00nan;0;0
9035;60773;1095;66;49;5;44;.898;3600000;0
9035;161047;69;46;18;3;15;.833;3600000;0
9036;170598;4922;0;0;0;0;.00nan;0;0
9036;176136;76;69;34;3;31;.912;3600000;0
9036;78864;76;0;0;0;0;.00nan;0;0
9036;161046;4922;47;25;4;21;.840;3566000;0
9037;163989;72;61;32;4;28;.875;3549000;0
9037;64811;72;0;0;0;0;.00nan;0;0
9037;85633;2564;0;0;0;0;.00nan;0;0
9037;86151;2564;84;32;3;29;.906;3600000;0
9038;170612;74;0;0;0;0;.00nan;0;0
9038;37857;4245;0;0;0;0;.00nan;0;0
9038;186520;4245;85;36;2;34;.944;3600000;0
9038;57215;74;56;26;3;23;.885;3566000;0
9039;171970;82;58;17;2;15;.882;3600000;0
9039;-1;82;0;0;0;0;.00nan;0;0
9039;184049;1097;43;11;2;9;.818;1146000;0
9039;171730;1097;33;34;6;28;.824;2454000;0
9040;178911;152;0;0;0;0;.00nan;0;0
9040;-1;157;0;0;0;0;.00nan;0;0
9040;57207;152;79;21;1;20;.952;3600000;0
9040;85555;157;89;39;2;37;.949;3583000;0
9041;-1;67;0;0;0;0;.00nan;0;0
9041;169096;67;87;29;1;28;.966;3600000;0
9041;184398;78;100;29;0;29;1.000;3600000;0
9041;179406;78;0;0;0;0;.00nan;0;0
9042;184158;4620;78;45;4;41;.911;3548000;0
9042;184398;78;75;27;2;25;.926;3600000;0
9042;179406;78;0;0;0;0;.00nan;0;0
9042;181341;4620;0;0;0;0;.00nan;0;0
9043;173874;158;51;42;6;36;.857;3600000;0
9043;38209;149;50;15;2;13;.867;3600000;0
9043;86875;149;0;0;0;0;.00nan;0;0
9043;91398;158;0;0;0;0;.00nan;0;0
9044;173856;75;0;0;0;0;.00nan;0;0
9044;171615;75;39;31;6;25;.806;3600000;0
9044;175423;77;100;26;0;26;1.000;3600000;0
9044;180873;77;0;0;0;0;.00nan;0;0
9045;166545;1096;73;23;2;21;.913;3772000;0
9045;183775;1096;0;0;0;0;.00nan;0;0
9045;184049;1097;73;29;3;26;.897;3772000;0
9045;171730;1097;0;0;0;0;.00nan;0;0
9046;183755;69;80;22;1;21;.955;3600000;0
9046;169166;1095;80;40;2;38;.950;3583000;0
9046;60773;1095;0;0;0;0;.00nan;0;0
9046;161047;69;0;0;0;0;.00nan;0;0
9047;163989;72;0;0;0;0;.00nan;0;0
9047;64811;72;75;20;1;19;.950;3600000;0
9047;85633;2564;93;42;2;40;.952;3545000;0
9047;86151;2564;0;0;0;0;.00nan;0;0
9048;170612;74;28;28;6;22;.786;3600000;0
9048;37857;4245;41;30;6;24;.800;2511000;0
9048;186520;4245;47;8;1;7;.875;1089000;0
9048;57215;74;0;0;0;0;.00nan;0;0
9049;171970;82;0;0;0;0;.00nan;0;0
9049;-1;82;45;28;5;23;.821;3835000;0
9049;176136;76;0;0;0;0;.00nan;0;0
9049;78864;76;80;41;4;37;.902;3822000;0
9050;173823;73;0;0;0;0;.00nan;0;0
9050;170963;73;99;37;3;34;.919;3900000;0
9050;46790;71;0;0;0;0;.00nan;0;0
9050;78775;71;76;33;3;30;.909;3900000;0
9051;165611;81;38;41;7;34;.829;3600000;0
9051;176770;81;0;0;0;0;.00nan;0;0
9051;85009;80;0;0;0;0;.00nan;0;0
9051;92313;80;78;28;2;26;.929;3600000;0
9052;-1;157;73;21;1;20;.952;3600000;0
9052;179411;151;58;34;4;30;.882;3600000;0
9052;176060;151;0;0;0;0;.00nan;0;0
9052;85555;157;0;0;0;0;.00nan;0;0
9053;4487;4920;0;0;0;0;.00nan;0;0
9053;183859;4920;100;27;0;27;1.000;3600000;0
9053;-1;67;78;43;3;40;.930;3600000;0
9053;169096;67;0;0;0;0;.00nan;0;0
9054;163989;72;49;13;3;10;.769;3600000;0
9054;173918;4921;44;4;1;3;.750;1103000;0
9054;182049;4921;19;32;7;25;.781;2497000;0
9054;64811;72;0;0;0;0;.00nan;0;0
9055;169166;1095;0;0;0;0;.00nan;0;0
9055;60773;1095;52;37;5;32;.865;3600000;0
9055;85633;2564;0;0;0;0;.00nan;0;0
9055;86151;2564;98;42;2;40;.952;3600000;0
9056;173823;73;0;0;0;0;.00nan;0;0
9056;170963;73;80;39;3;36;.923;3600000;0
9056;46790;71;21;9;4;5;.556;1073000;0
9056;78775;71;98;30;0;30;1.000;2527000;0
9057;170728;85;0;0;0;0;.00nan;0;0
9057;184398;78;85;27;1;26;.963;3021000;0
9057;179406;78;30;9;3;6;.667;579000;0
9057;57998;85;95;41;3;38;.927;3600000;0
9058;4487;4920;0;0;0;0;.00nan;0;0
9058;183859;4920;100;35;1;34;.971;3600000;0
9058;-1;67;0;0;0;0;.00nan;0;0
9058;169096;67;64;36;3;33;.917;3516000;0
9059;173823;73;75;24;1;23;.958;3600000;0
9059;170598;4922;57;28;4;24;.857;3600000;0
9059;170963;73;0;0;0;0;.00nan;0;0
9059;161046;4922;0;0;0;0;.00nan;0;0
9060;166545;1096;0;0;0;0;.00nan;0;0
9060;171970;82;57;22;3;19;.864;3545000;0
9060;183775;1096;76;37;2;35;.946;3600000;0
9060;-1;82;0;0;0;0;.00nan;0;0
9061;173856;75;77;12;0;12;1.000;3600000;0
9061;171615;75;0;0;0;0;.00nan;0;0
9061;176136;76;0;0;0;0;.00nan;0;0
9061;78864;76;38;42;7;35;.833;3600000;0
9062;165611;81;71;36;2;34;.944;3900000;0
9062;176770;81;0;0;0;0;.00nan;0;0
9062;38209;149;0;0;0;0;.00nan;0;0
9062;86875;149;77;30;2;28;.933;3900000;0
9063;184049;1097;84;27;1;26;.963;3600000;0
9063;171730;1097;0;0;0;0;.00nan;0;0
9063;175423;77;0;0;0;0;.00nan;0;0
9063;180873;77;37;28;5;23;.821;3600000;0
9064;166545;1096;41;23;5;18;.783;2767000;0
9064;171970;82;0;0;0;0;.00nan;0;0
9064;183775;1096;56;13;1;12;.923;805000;0
9064;-1;82;45;27;5;22;.815;3600000;0
9065;169166;1095;46;26;4;22;.846;3600000;0
9065;170612;74;0;0;0;0;.00nan;0;0
9065;57215;74;38;27;6;21;.778;3579000;0
9065;60773;1095;0;0;0;0;.00nan;0;0
9066;163989;72;66;18;1;17;.944;3600000;0
9066;170598;4922;44;45;7;38;.844;3037000;0
9066;64811;72;0;0;0;0;.00nan;0;0
9066;161046;4922;42;13;3;10;.769;563000;0
9067;46790;71;0;0;0;0;.00nan;0;0
9067;78775;71;94;38;1;37;.974;3600000;0
9067;85633;2564;0;0;0;0;.00nan;0;0
9067;86151;2564;90;41;2;39;.951;3578000;0
9068;4487;4920;0;0;0;0;.00nan;0;0
9068;183859;4920;63;18;2;16;.889;3630000;0
9068;184158;4620;86;41;3;38;.927;3630000;0
9068;181341;4620;0;0;0;0;.00nan;0;0
9069;173856;75;51;23;3;20;.870;3600000;0
9069;171615;75;0;0;0;0;.00nan;0;0
9069;176136;76;86;38;2;36;.947;3600000;0
9069;78864;76;0;0;0;0;.00nan;0;0
9070;183755;69;65;24;2;22;.917;3600000;0
9070;173874;158;0;0;0;0;.00nan;0;0
9070;91398;158;76;36;3;33;.917;3600000;0
9070;161047;69;0;0;0;0;.00nan;0;0
9071;-1;67;64;35;4;31;.886;3600000;0
9071;169096;67;0;0;0;0;.00nan;0;0
9071;37857;4245;0;0;0;0;.00nan;0;0
9071;186520;4245;95;36;1;35;.972;3600000;0
9072;170728;85;0;0;0;0;.00nan;0;0
9072;184398;78;0;0;0;0;.00nan;0;0
9072;179406;78;73;30;2;28;.933;3600000;0
9072;57998;85;58;31;4;27;.871;3585000;0
9073;2495;80;0;0;0;0;.00nan;0;0
9073;-1;157;0;0;0;0;.00nan;0;0
9073;85009;80;80;32;2;30;.938;3542000;0
9073;85555;157;98;33;1;32;.970;3600000;0
9074;178911;152;56;21;2;19;.905;3900000;0
9074;179411;151;0;0;0;0;.00nan;0;0
9074;176060;151;93;37;2;35;.946;3900000;0
9074;57207;152;0;0;0;0;.00nan;0;0
9075;184158;4620;0;0;0;0;.00nan;0;0
9075;170728;85;0;0;0;0;.00nan;0;0
9075;181341;4620;17;18;6;12;.667;3600000;0
9075;57998;85;60;28;3;25;.893;3600000;0
9076;165611;81;90;47;4;43;.915;3600000;0
9076;176770;81;0;0;0;0;.00nan;0;0
9076;38209;149;48;20;3;17;.850;3600000;0
9076;86875;149;0;0;0;0;.00nan;0;0
9077;184049;1097;0;0;0;0;.00nan;0;0
9077;171730;1097;63;22;2;20;.909;3600000;0
9077;175423;77;46;27;4;23;.852;3573000;0
9077;180873;77;0;0;0;0;.00nan;0;0
9078;163989;72;0;0;0;0;.00nan;0;0
9078;169166;1095;0;0;0;0;.00nan;0;0
9078;60773;1095;50;27;4;23;.852;3600000;0
9078;64811;72;69;21;1;20;.952;3600000;0
9079;4487;4920;62;24;2;22;.917;3900000;0
9079;183859;4920;0;0;0;0;.00nan;0;0
9079;184398;78;69;22;2;20;.909;3900000;0
9079;179406;78;0;0;0;0;.00nan;0;0
9080;183755;69;0;0;0;0;.00nan;0;0
9080;173874;158;81;35;2;33;.943;3600000;0
9080;91398;158;0;0;0;0;.00nan;0;0
9080;161047;69;58;30;4;26;.867;3583000;0
9081;-1;67;0;0;0;0;.00nan;0;0
9081;169096;67;74;42;4;38;.905;3722000;0
9081;37857;4245;62;28;3;25;.893;3722000;0
9081;186520;4245;0;0;0;0;.00nan;0;0
9082;173856;75;0;0;0;0;.00nan;0;0
9082;171615;75;61;25;3;22;.880;3600000;0
9082;176136;76;58;22;2;20;.909;2424000;0
9082;78864;76;28;13;4;9;.692;1176000;0
9083;173823;73;0;0;0;0;.00nan;0;0
9083;170963;73;68;38;4;34;.895;3600000;0
9083;46790;71;73;22;1;21;.955;3600000;0
9083;78775;71;0;0;0;0;.00nan;0;0
9084;2495;80;65;36;4;32;.889;3600000;0
9084;-1;157;94;33;1;32;.970;3600000;0
9084;85009;80;0;0;0;0;.00nan;0;0
9084;85555;157;0;0;0;0;.00nan;0;0
9085;173918;4921;0;0;0;0;.00nan;0;0
9085;170612;74;0;0;0;0;.00nan;0;0
9085;182049;4921;96;49;3;46;.939;3524000;0
9085;57215;74;68;17;1;16;.941;3600000;0
9086;178911;152;0;0;0;0;.00nan;0;0
9086;179411;151;97;43;1;42;.977;3600000;0
9086;176060;151;0;0;0;0;.00nan;0;0
9086;57207;152;81;14;0;14;1.000;3600000;0
9087;184158;4620;81;30;2;28;.933;3900000;0
9087;170728;85;0;0;0;0;.00nan;0;0
9087;181341;4620;0;0;0;0;.00nan;0;0
9087;57998;85;79;30;2;28;.933;3900000;0
9088;165611;81;0;0;0;0;.00nan;0;0
9088;176770;81;88;44;3;41;.932;3600000;0
9088;38209;149;0;0;0;0;.00nan;0;0
9088;86875;149;50;28;4;24;.857;3542000;0
9089;173823;73;0;0;0;0;.00nan;0;0
9089;170598;4922;57;31;4;27;.871;3600000;0
9089;170963;73;72;22;2;20;.909;3600000;0
9089;161046;4922;0;0;0;0;.00nan;0;0
9090;169166;1095;86;25;1;24;.960;3600000;0
9090;46790;71;0;0;0;0;.00nan;0;0
9090;60773;1095;0;0;0;0;.00nan;0;0
9090;78775;71;61;24;3;21;.875;3516000;0
9091;166545;1096;0;0;0;0;.00nan;0;0
9091;171970;82;35;20;4;16;.800;3550000;0
9091;183775;1096;94;46;3;43;.935;3600000;0
9091;-1;82;0;0;0;0;.00nan;0;0
9092;163989;72;66;22;2;20;.909;3900000;0
9092;64811;72;0;0;0;0;.00nan;0;0
9092;85633;2564;0;0;0;0;.00nan;0;0
9092;86151;2564;89;39;2;37;.949;3900000;0
9093;178911;152;0;0;0;0;.00nan;0;0
9093;179411;151;0;0;0;0;.00nan;0;0
9093;176060;151;90;47;2;45;.957;3583000;0
9093;57207;152;69;17;1;16;.941;3600000;0
9094;183755;69;44;20;3;17;.850;3600000;0
9094;173874;158;0;0;0;0;.00nan;0;0
9094;91398;158;92;53;4;49;.925;3600000;0
9094;161047;69;0;0;0;0;.00nan;0;0
9095;-1;67;47;32;5;27;.844;3600000;0
9095;169096;67;0;0;0;0;.00nan;0;0
9095;37857;4245;0;0;0;0;.00nan;0;0
9095;186520;4245;100;21;0;21;1.000;3600000;0
9096;184049;1097;52;24;3;21;.875;3600000;0
9096;171730;1097;0;0;0;0;.00nan;0;0
9096;175423;77;0;0;0;0;.00nan;0;0
9096;180873;77;62;36;4;32;.889;3600000;0
9097;2495;80;0;0;0;0;.00nan;0;0
9097;-1;157;0;0;0;0;.00nan;0;0
9097;85009;80;66;30;3;27;.900;3576000;0
9097;85555;157;88;29;2;27;.931;3600000;0
9098;173918;4921;81;28;2;26;.929;3600000;0
9098;170612;74;0;0;0;0;.00nan;0;0
9098;182049;4921;0;0;0;0;.00nan;0;0
9098;57215;74;66;41;4;37;.902;3600000;0
9099;184081;157;79;26;2;24;.923;3557000;0
9099;-1;157;0;0;0;0;.00nan;0;0
9099;38209;149;93;32;1;31;.969;3600000;0
9099;86875;149;0;0;0;0;.00nan;0;0
9100;171970;82;76;21;1;20;.952;3600000;0
9100;-1;82;0;0;0;0;.00nan;0;0
9100;175423;77;80;40;3;37;.925;3512000;0
9100;180873;77;0;0;0;0;.00nan;0;0
9101;165611;81;48;33;5;28;.848;3553000;0
9101;176770;81;0;0;0;0;.00nan;0;0
9101;37857;4245;0;0;0;0;.00nan;0;0
9101;186520;4245;78;36;3;33;.917;3600000;0
9102;173856;75;20;16;5;11;.688;2000000;0
9102;170598;4922;80;41;4;37;.902;3600000;0
9102;171615;75;56;13;1;12;.923;1600000;0
9102;161046;4922;0;0;0;0;.00nan;0;0
9103;169166;1095;60;39;5;34;.872;3600000;0
9103;60773;1095;0;0;0;0;.00nan;0;0
9103;85633;2564;0;0;0;0;.00nan;0;0
9103;86151;2564;66;26;2;24;.923;3600000;0
9104;184158;4620;55;32;4;28;.875;3565000;0
9104;184398;78;74;40;3;37;.925;3600000;0
9104;179406;78;0;0;0;0;.00nan;0;0
9104;181341;4620;0;0;0;0;.00nan;0;0
9105;4487;4920;0;0;0;0;.00nan;0;0
9105;183859;4920;96;22;0;22;1.000;3600000;0
9105;184158;4620;97;49;2;47;.959;3539000;0
9105;181341;4620;0;0;0;0;.00nan;0;0
9106;171970;82;58;41;5;36;.878;3743000;0
9106;-1;82;0;0;0;0;.00nan;0;0
9106;175423;77;0;0;0;0;.00nan;0;0
9106;180873;77;38;35;6;29;.829;3771000;0
9107;166545;1096;56;4;0;4;1.000;552000;0
9107;183775;1096;28;27;6;21;.778;3048000;0
9107;176136;76;88;31;2;29;.935;3600000;0
9107;78864;76;0;0;0;0;.00nan;0;0
9108;165611;81;53;29;4;25;.862;3600000;0
9108;176770;81;0;0;0;0;.00nan;0;0
9108;37857;4245;0;0;0;0;.00nan;0;0
9108;186520;4245;61;44;6;38;.864;3600000;0
9109;184049;1097;55;25;3;22;.880;3531000;0
9109;170598;4922;100;48;1;47;.979;3600000;0
9109;171730;1097;0;0;0;0;.00nan;0;0
9109;161046;4922;0;0;0;0;.00nan;0;0
9110;173823;73;0;0;0;0;.00nan;0;0
9110;170963;73;58;24;3;21;.875;3560000;0
9110;85633;2564;0;0;0;0;.00nan;0;0
9110;86151;2564;93;40;2;38;.950;3600000;0
9111;2495;80;0;0;0;0;.00nan;0;0
9111;170728;85;0;0;0;0;.00nan;0;0
9111;57998;85;100;35;0;35;1.000;3600000;0
9111;85009;80;55;16;1;15;.938;3600000;0
9112;163989;72;82;34;2;32;.941;3600000;0
9112;170612;74;0;0;0;0;.00nan;0;0
9112;57215;74;93;32;1;31;.969;3600000;0
9112;64811;72;0;0;0;0;.00nan;0;0
9113;173856;75;0;0;0;0;.00nan;0;0
9113;173918;4921;0;0;0;0;.00nan;0;0
9113;171615;75;87;40;3;37;.925;3600000;0
9113;182049;4921;70;36;4;32;.889;3544000;0
9114;169166;1095;52;38;5;33;.868;3859000;0
9114;46790;71;0;0;0;0;.00nan;0;0
9114;60773;1095;0;0;0;0;.00nan;0;0
9114;78775;71;33;29;6;23;.793;3859000;0
9115;184081;157;38;21;4;17;.810;3600000;0
9115;173874;158;0;0;0;0;.00nan;0;0
9115;-1;157;0;0;0;0;.00nan;0;0
9115;91398;158;99;50;3;47;.940;3600000;0
9116;179411;151;0;0;0;0;.00nan;0;0
9116;176060;151;85;33;2;31;.939;3600000;0
9116;38209;149;58;43;5;38;.884;3600000;0
9116;86875;149;0;0;0;0;.00nan;0;0
9117;-1;67;0;0;0;0;.00nan;0;0
9117;169096;67;85;25;1;24;.960;3600000;0
9117;184398;78;62;40;4;36;.900;3600000;0
9117;179406;78;0;0;0;0;.00nan;0;0
9118;173823;73;40;34;6;28;.824;3565000;0
9118;170963;73;0;0;0;0;.00nan;0;0
9118;46790;71;55;35;4;31;.886;3600000;0
9118;78775;71;0;0;0;0;.00nan;0;0
9119;183755;69;72;19;1;18;.947;3600000;0
9119;169166;1095;0;0;0;0;.00nan;0;0
9119;60773;1095;72;44;4;40;.909;3600000;0
9119;161047;69;0;0;0;0;.00nan;0;0
9120;166545;1096;73;43;4;39;.907;3595000;0
9120;171970;82;0;0;0;0;.00nan;0;0
9120;183775;1096;0;0;0;0;.00nan;0;0
9120;-1;82;68;24;2;22;.917;3600000;0
9121;165611;81;0;0;0;0;.00nan;0;0
9121;176770;81;87;49;3;46;.939;3900000;0
9121;37857;4245;69;28;3;25;.893;3900000;0
9121;186520;4245;0;0;0;0;.00nan;0;0
9122;4487;4920;0;0;0;0;.00nan;0;0
9122;183859;4920;59;28;4;24;.857;3559000;0
9122;184158;4620;97;50;3;47;.940;3600000;0
9122;181341;4620;0;0;0;0;.00nan;0;0
9123;2495;80;70;25;2;23;.920;3600000;0
9123;170728;85;0;0;0;0;.00nan;0;0
9123;57998;85;59;29;4;25;.862;3528000;0
9123;85009;80;0;0;0;0;.00nan;0;0
9124;163989;72;0;0;0;0;.00nan;0;0
9124;170612;74;0;0;0;0;.00nan;0;0
9124;57215;74;91;35;2;33;.943;3600000;0
9124;64811;72;71;30;3;27;.900;3557000;0
9125;173856;75;51;19;4;15;.789;3900000;0
9125;173918;4921;79;47;4;43;.915;3900000;0
9125;171615;75;0;0;0;0;.00nan;0;0
9125;182049;4921;0;0;0;0;.00nan;0;0
9126;184049;1097;89;31;1;30;.968;3600000;0
9126;170598;4922;0;0;0;0;.00nan;0;0
9126;171730;1097;0;0;0;0;.00nan;0;0
9126;161046;4922;65;41;5;36;.878;3600000;0
9127;175423;77;62;30;4;26;.867;3600000;0
9127;176136;76;0;0;0;0;.00nan;0;0
9127;180873;77;0;0;0;0;.00nan;0;0
9127;78864;76;42;36;6;30;.833;3515000;0
9128;184081;157;0;0;0;0;.00nan;0;0
9128;173874;158;0;0;0;0;.00nan;0;0
9128;-1;157;71;20;2;18;.900;3600000;0
9128;91398;158;61;46;7;39;.848;3600000;0
9129;179411;151;26;6;3;3;.500;567000;0
9129;176060;151;58;23;2;21;.913;3033000;0
9129;38209;149;0;0;0;0;.00nan;0;0
9129;86875;149;97;41;2;39;.951;3600000;0
9130;-1;67;99;37;1;36;.973;3600000;0
9130;169096;67;0;0;0;0;.00nan;0;0
9130;184398;78;0;0;0;0;.00nan;0;0
9130;179406;78;46;25;4;21;.840;3600000;0
9131;184158;4620;0;0;0;0;.00nan;0;0
9131;184398;78;62;39;5;34;.872;3600000;0
9131;179406;78;0;0;0;0;.00nan;0;0
9131;181341;4620;65;21;2;19;.905;3600000;0
9132;170598;4922;77;33;2;31;.939;3600000;0
9132;175423;77;59;7;0;7;1.000;522000;0
9132;180873;77;40;35;6;29;.829;3078000;0
9132;161046;4922;0;0;0;0;.00nan;0;0
9133;183755;69;0;0;0;0;.00nan;0;0
9133;169166;1095;65;23;2;21;.913;3600000;0
9133;60773;1095;0;0;0;0;.00nan;0;0
9133;161047;69;71;35;3;32;.914;3600000;0
9134;4487;4920;99;49;3;46;.939;3600000;0
9134;183859;4920;0;0;0;0;.00nan;0;0
9134;-1;67;0;0;0;0;.00nan;0;0
9134;169096;67;61;43;5;38;.884;3522000;0
9135;2495;80;0;0;0;0;.00nan;0;0
9135;170728;85;81;36;3;33;.917;3706000;0
9135;57998;85;0;0;0;0;.00nan;0;0
9135;85009;80;53;25;4;21;.840;3706000;0
9136;163989;72;45;33;6;27;.818;3600000;0
9136;170612;74;66;39;5;34;.872;3600000;0
9136;57215;74;0;0;0;0;.00nan;0;0
9136;64811;72;0;0;0;0;.00nan;0;0
9137;173856;75;0;0;0;0;.00nan;0;0
9137;173918;4921;0;0;0;0;.00nan;0;0
9137;171615;75;62;27;3;24;.889;3600000;0
9137;182049;4921;45;30;6;24;.800;3592000;0
9138;166545;1096;0;0;0;0;.00nan;0;0
9138;183775;1096;47;24;4;20;.833;3816000;0
9138;176136;76;88;36;3;33;.917;3816000;0
9138;78864;76;0;0;0;0;.00nan;0;0
9139;173823;73;0;0;0;0;.00nan;0;0
9139;170963;73;99;33;2;31;.939;3600000;0
9139;46790;71;0;0;0;0;.00nan;0;0
9139;78775;71;57;24;3;21;.875;3600000;0
9140;184081;157;61;33;4;29;.879;3600000;0
9140;173874;158;50;2;0;2;1.000;721000;0
9140;-1;157;0;0;0;0;.00nan;0;0
9140;91398;158;36;39;7;32;.821;2879000;0
9141;179411;151;96;37;1;36;.973;3600000;0
9141;176060;151;0;0;0;0;.00nan;0;0
9141;38209;149;50;21;3;18;.857;3552000;0
9141;86875;149;0;0;0;0;.00nan;0;0
9142;2495;80;50;21;3;18;.857;3900000;0
9142;38209;149;0;0;0;0;.00nan;0;0
9142;85009;80;0;0;0;0;.00nan;0;0
9142;86875;149;91;38;3;35;.921;3900000;0
9143;171970;82;68;31;3;28;.903;3537000;0
9143;-1;82;0;0;0;0;.00nan;0;0
9143;184049;1097;74;20;1;19;.950;3600000;0
9143;171730;1097;0;0;0;0;.00nan;0;0
9144;166545;1096;0;0;0;0;.00nan;0;0
9144;183775;1096;96;35;1;34;.971;3600000;0
9144;173856;75;68;29;2;27;.931;3558000;0
9144;171615;75;0;0;0;0;.00nan;0;0
9145;165611;81;0;0;0;0;.00nan;0;0
9145;178911;152;0;0;0;0;.00nan;0;0
9145;176770;81;75;44;4;40;.909;3554000;0
9145;57207;152;66;21;2;19;.905;3600000;0
9146;163989;72;75;36;3;33;.917;3600000;0
9146;46790;71;68;13;0;13;1.000;1513000;0
9146;64811;72;0;0;0;0;.00nan;0;0
9146;78775;71;24;23;6;17;.739;2087000;0
9147;4487;4920;0;0;0;0;.00nan;0;0
9147;183859;4920;76;20;1;19;.950;3600000;0
9147;184398;78;79;49;5;44;.898;3600000;0
9147;179406;78;0;0;0;0;.00nan;0;0
9148;169166;1095;66;34;4;30;.882;3551000;0
9148;173874;158;0;0;0;0;.00nan;0;0
9148;60773;1095;0;0;0;0;.00nan;0;0
9148;91398;158;67;27;3;24;.889;3600000;0
9149;184158;4620;100;38;1;37;.974;3600000;0
9149;170728;85;43;4;1;3;.750;513000;0
9149;181341;4620;0;0;0;0;.00nan;0;0
9149;57998;85;20;22;6;16;.727;3087000;0
9150;2495;80;0;0;0;0;.00nan;0;0
9150;38209;149;0;0;0;0;.00nan;0;0
9150;85009;80;83;33;1;32;.970;3600000;0
9150;86875;149;81;34;2;32;.941;3587000;0
9151;171970;82;0;0;0;0;.00nan;0;0
9151;-1;82;60;15;2;13;.867;3600000;0
9151;184049;1097;73;39;4;35;.897;3589000;0
9151;171730;1097;0;0;0;0;.00nan;0;0
9152;166545;1096;46;37;5;32;.865;3600000;0
9152;183775;1096;0;0;0;0;.00nan;0;0
9152;173856;75;73;26;2;24;.923;3600000;0
9152;171615;75;0;0;0;0;.00nan;0;0
9153;165611;81;0;0;0;0;.00nan;0;0
9153;178911;152;0;0;0;0;.00nan;0;0
9153;176770;81;73;44;5;39;.886;3591000;0
9153;57207;152;74;31;3;28;.903;3600000;0
9154;170598;4922;100;31;0;31;1.000;3600000;0
9154;176136;76;83;42;3;39;.929;3600000;0
9154;78864;76;0;0;0;0;.00nan;0;0
9154;161046;4922;0;0;0;0;.00nan;0;0
9155;46790;71;92;37;2;35;.946;3600000;0
9155;78775;71;0;0;0;0;.00nan;0;0
9155;85633;2564;0;0;0;0;.00nan;0;0
9155;86151;2564;31;22;5;17;.773;3600000;0
9156;169166;1095;96;62;4;58;.935;3900000;0
9156;173874;158;0;0;0;0;.00nan;0;0
9156;60773;1095;0;0;0;0;.00nan;0;0
9156;91398;158;55;28;4;24;.857;3900000;0
9157;4487;4920;0;0;0;0;.00nan;0;0
9157;183859;4920;65;15;1;14;.933;3600000;0
9157;37857;4245;0;0;0;0;.00nan;0;0
9157;186520;4245;98;48;3;45;.938;3515000;0
9158;184398;78;0;0;0;0;.00nan;0;0
9158;179406;78;80;32;1;31;.969;3900000;0
9158;175423;77;98;32;1;31;.969;3900000;0
9158;180873;77;0;0;0;0;.00nan;0;0
9159;183755;69;63;34;4;30;.882;3600000;0
9159;184081;157;0;0;0;0;.00nan;0;0
9159;-1;157;100;41;1;40;.976;3600000;0
9159;161047;69;0;0;0;0;.00nan;0;0
9160;163989;72;65;24;2;22;.917;3725000;0
9160;173918;4921;0;0;0;0;.00nan;0;0
9160;182049;4921;92;45;3;42;.933;3725000;0
9160;64811;72;0;0;0;0;.00nan;0;0
9161;173823;73;0;0;0;0;.00nan;0;0
9161;170963;73;90;29;2;27;.931;3600000;0
9161;179411;151;0;0;0;0;.00nan;0;0
9161;176060;151;94;50;4;46;.920;3524000;0
9162;-1;67;28;24;6;18;.750;2960000;0
9162;169096;67;48;7;1;6;.857;640000;0
9162;170612;74;0;0;0;0;.00nan;0;0
9162;57215;74;63;31;3;28;.903;3600000;0
9163;2495;80;32;9;3;6;.667;573000;0
9163;38209;149;39;34;6;28;.824;3900000;0
9163;85009;80;38;17;3;14;.824;3327000;0
9163;86875;149;0;0;0;0;.00nan;0;0
9164;171970;82;61;41;4;37;.902;3600000;0
9164;-1;82;0;0;0;0;.00nan;0;0
9164;184049;1097;89;31;1;30;.968;3600000;0
9164;171730;1097;0;0;0;0;.00nan;0;0
9165;165611;81;39;36;6;30;.833;3542000;0
9165;178911;152;51;28;4;24;.857;3600000;0
9165;176770;81;0;0;0;0;.00nan;0;0
9165;57207;152;0;0;0;0;.00nan;0;0
9166;166545;1096;81;31;2;29;.935;3065000;0
9166;183775;1096;27;7;3;4;.571;535000;0
9166;170598;4922;48;38;6;32;.842;3542000;0
9166;161046;4922;0;0;0;0;.00nan;0;0
9167;184158;4620;54;19;2;17;.895;3600000;0
9167;170728;85;57;30;4;26;.867;2688000;0
9167;181341;4620;0;0;0;0;.00nan;0;0
9167;57998;85;22;11;4;7;.636;912000;0
9168;169166;1095;0;0;0;0;.00nan;0;0
9168;173874;158;39;23;4;19;.826;1117000;0
9168;60773;1095;84;32;2;30;.938;3600000;0
9168;91398;158;56;16;2;14;.875;2483000;0
9169;4487;4920;20;25;6;19;.760;3600000;0
9169;183859;4920;0;0;0;0;.00nan;0;0
9169;37857;4245;95;41;2;39;.951;3600000;0
9169;186520;4245;0;0;0;0;.00nan;0;0
9170;173856;75;0;0;0;0;.00nan;0;0
9170;171615;75;72;17;1;16;.941;3600000;0
9170;176136;76;0;0;0;0;.00nan;0;0
9170;78864;76;75;33;2;31;.939;3578000;0
9171;46790;71;0;0;0;0;.00nan;0;0
9171;78775;71;97;40;2;38;.950;3900000;0
9171;85633;2564;87;32;2;30;.938;3900000;0
9171;86151;2564;0;0;0;0;.00nan;0;0
9172;184398;78;52;24;3;21;.875;3600000;0
9172;179406;78;0;0;0;0;.00nan;0;0
9172;175423;77;0;0;0;0;.00nan;0;0
9172;180873;77;67;42;4;38;.905;3568000;0
9173;183755;69;0;0;0;0;.00nan;0;0
9173;184081;157;53;30;4;26;.867;3612000;0
9173;-1;157;0;0;0;0;.00nan;0;0
9173;161047;69;84;30;3;27;.900;3612000;0
9174;163989;72;0;0;0;0;.00nan;0;0
9174;173918;4921;65;53;7;46;.868;3600000;0
9174;182049;4921;0;0;0;0;.00nan;0;0
9174;64811;72;66;18;1;17;.944;3600000;0
9175;173823;73;86;34;3;31;.912;3600000;0
9175;170963;73;0;0;0;0;.00nan;0;0
9175;179411;151;39;38;6;32;.842;3331000;0
9175;176060;151;50;1;0;1;1.000;269000;0
9176;-1;67;0;0;0;0;.00nan;0;0
9176;169096;67;75;36;3;33;.917;3600000;0
9176;170612;74;0;0;0;0;.00nan;0;0
9176;57215;74;46;25;4;21;.840;3552000;0
9177;184158;4620;80;39;3;36;.923;3900000;0
9177;170728;85;0;0;0;0;.00nan;0;0
9177;181341;4620;0;0;0;0;.00nan;0;0
9177;57998;85;76;34;3;31;.912;3900000;0
9178;170598;4922;0;0;0;0;.00nan;0;0
9178;176136;76;66;25;2;23;.920;3900000;0
9178;78864;76;0;0;0;0;.00nan;0;0
9178;161046;4922;80;30;2;28;.933;3900000;0
9179;163989;72;47;29;5;24;.828;3600000;0
9179;46790;71;34;13;4;9;.692;944000;0
9179;64811;72;0;0;0;0;.00nan;0;0
9179;78775;71;52;23;3;20;.870;2615000;0
9180;173918;4921;0;0;0;0;.00nan;0;0
9180;182049;4921;71;40;3;37;.925;3554000;0
9180;85633;2564;0;0;0;0;.00nan;0;0
9180;86151;2564;63;23;2;21;.913;3600000;0
9181;2495;80;68;26;2;24;.923;3900000;0
9181;179411;151;0;0;0;0;.00nan;0;0
9181;176060;151;98;44;2;42;.955;3900000;0
9181;85009;80;0;0;0;0;.00nan;0;0
9182;-1;67;100;52;2;50;.962;3900000;0
9182;169096;67;0;0;0;0;.00nan;0;0
9182;170612;74;0;0;0;0;.00nan;0;0
9182;57215;74;87;42;2;40;.952;3900000;0
9183;184081;157;98;25;0;25;1.000;3600000;0
9183;-1;157;0;0;0;0;.00nan;0;0
9183;38209;149;0;0;0;0;.00nan;0;0
9183;86875;149;80;44;4;40;.909;3600000;0
9184;183755;69;70;31;2;29;.935;3600000;0
9184;173823;73;0;0;0;0;.00nan;0;0
9184;170963;73;77;36;3;33;.917;3594000;0
9184;161047;69;0;0;0;0;.00nan;0;0
9185;4487;4920;0;0;0;0;.00nan;0;0
9185;183859;4920;67;20;1;19;.950;3600000;0
9185;37857;4245;0;0;0;0;.00nan;0;0
9185;186520;4245;77;36;3;33;.917;3546000;0
9186;170598;4922;0;0;0;0;.00nan;0;0
9186;175423;77;61;30;4;26;.867;3746000;0
9186;180873;77;0;0;0;0;.00nan;0;0
9186;161046;4922;71;35;3;32;.914;3746000;0
9187;173823;73;0;0;0;0;.00nan;0;0
9187;170963;73;70;30;3;27;.900;3532000;0
9187;46790;71;0;0;0;0;.00nan;0;0
9187;78775;71;100;34;1;33;.971;3600000;0
9188;-1;67;91;28;1;27;.964;3600000;0
9188;169096;67;0;0;0;0;.00nan;0;0
9188;169166;1095;47;29;5;24;.828;2861000;0
9188;60773;1095;39;9;2;7;.778;739000;0
9189;163989;72;77;26;1;25;.962;3600000;0
9189;64811;72;0;0;0;0;.00nan;0;0
9189;85633;2564;0;0;0;0;.00nan;0;0
9189;86151;2564;77;36;3;33;.917;3570000;0
9190;183755;69;99;20;0;20;1.000;3600000;0
9190;173918;4921;0;0;0;0;.00nan;0;0
9190;182049;4921;94;44;3;41;.932;3600000;0
9190;161047;69;0;0;0;0;.00nan;0;0
9191;178911;152;0;0;0;0;.00nan;0;0
9191;57207;152;72;30;3;27;.900;3515000;0
9191;59592;80;0;0;0;0;.00nan;0;0
9191;85009;80;80;28;1;27;.964;3600000;0
9192;4487;4920;0;0;0;0;.00nan;0;0
9192;183859;4920;78;27;2;25;.926;3900000;0
9192;37857;4245;0;0;0;0;.00nan;0;0
9192;186520;4245;97;47;2;45;.957;3900000;0
9193;170612;74;0;0;0;0;.00nan;0;0
9193;170728;85;0;0;0;0;.00nan;0;0
9193;57215;74;41;16;3;13;.813;3600000;0
9193;57998;85;58;47;6;41;.872;3600000;0
9194;171970;82;64;24;2;22;.917;3514000;0
9194;-1;82;0;0;0;0;.00nan;0;0
9194;173856;75;100;46;0;46;1.000;3600000;0
9194;171615;75;0;0;0;0;.00nan;0;0
9195;165611;81;70;50;6;44;.880;3321000;0
9195;173874;158;0;0;0;0;.00nan;0;0
9195;176770;81;53;3;0;3;1.000;279000;0
9195;91398;158;84;30;2;28;.933;3600000;0
9196;166545;1096;0;0;0;0;.00nan;0;0
9196;183775;1096;100;21;0;21;1.000;3600000;0
9196;176136;76;0;0;0;0;.00nan;0;0
9196;78864;76;97;52;1;51;.981;3600000;0
9197;184158;4620;67;29;3;26;.897;3600000;0
9197;184398;78;58;37;4;33;.892;3600000;0
9197;179406;78;0;0;0;0;.00nan;0;0
9197;181341;4620;0;0;0;0;.00nan;0;0
9198;184081;157;32;31;6;25;.806;3600000;0
9198;-1;157;0;0;0;0;.00nan;0;0
9198;179411;151;0;0;0;0;.00nan;0;0
9198;176060;151;96;43;2;41;.953;3600000;0
9199;175423;77;0;0;0;0;.00nan;0;0
9199;176136;76;56;29;4;25;.862;3585000;0
9199;180873;77;68;30;3;27;.900;3600000;0
9199;78864;76;0;0;0;0;.00nan;0;0
9200;-1;67;0;0;0;0;.00nan;0;0
9200;169096;67;74;27;2;25;.926;3600000;0
9200;169166;1095;0;0;0;0;.00nan;0;0
9200;60773;1095;62;39;4;35;.897;3576000;0
9201;166545;1096;0;0;0;0;.00nan;0;0
9201;183775;1096;60;32;4;28;.875;3900000;0
9201;170598;4922;73;38;4;34;.895;3900000;0
9201;161046;4922;0;0;0;0;.00nan;0;0
9202;163989;72;0;0;0;0;.00nan;0;0
9202;46790;71;69;41;5;36;.878;3900000;0
9202;64811;72;53;32;5;27;.844;3900000;0
9202;78775;71;0;0;0;0;.00nan;0;0
9203;183755;69;86;34;2;32;.941;3600000;0
9203;173918;4921;0;0;0;0;.00nan;0;0
9203;182049;4921;91;42;3;39;.929;3543000;0
9203;161047;69;0;0;0;0;.00nan;0;0
9204;173823;73;71;28;2;26;.929;3600000;0
9204;170963;73;0;0;0;0;.00nan;0;0
9204;85633;2564;97;55;3;52;.945;3600000;0
9204;86151;2564;0;0;0;0;.00nan;0;0
9205;178911;152;73;21;1;20;.952;3600000;0
9205;57207;152;0;0;0;0;.00nan;0;0
9205;59592;80;98;43;2;41;.953;3554000;0
9205;85009;80;0;0;0;0;.00nan;0;0
9206;4487;4920;79;29;2;27;.931;3600000;0
9206;183859;4920;0;0;0;0;.00nan;0;0
9206;37857;4245;49;33;6;27;.818;2687000;0
9206;186520;4245;53;6;0;6;1.000;913000;0
9207;170612;74;0;0;0;0;.00nan;0;0
9207;170728;85;0;0;0;0;.00nan;0;0
9207;57215;74;77;25;2;23;.920;3756000;0
9207;57998;85;85;33;3;30;.909;3756000;0
9208;165611;81;0;0;0;0;.00nan;0;0
9208;173874;158;0;0;0;0;.00nan;0;0
9208;176770;81;72;33;2;31;.939;3600000;0
9208;91398;158;65;26;3;23;.885;3600000;0
9209;171970;82;0;0;0;0;.00nan;0;0
9209;-1;82;62;31;3;28;.903;3600000;0
9209;184049;1097;0;0;0;0;.00nan;0;0
9209;171730;1097;81;35;2;33;.943;3600000;0
9210;184158;4620;0;0;0;0;.00nan;0;0
9210;184398;78;0;0;0;0;.00nan;0;0
9210;179406;78;72;39;4;35;.897;3555000;0
9210;181341;4620;70;34;3;31;.912;3600000;0
9211;-1;67;72;37;3;34;.919;3600000;0
9211;169096;67;0;0;0;0;.00nan;0;0
9211;169166;1095;54;30;4;26;.867;3600000;0
9211;60773;1095;0;0;0;0;.00nan;0;0
9212;166545;1096;100;29;0;29;1.000;3600000;0
9212;183775;1096;0;0;0;0;.00nan;0;0
9212;170598;4922;0;0;0;0;.00nan;0;0
9212;161046;4922;50;29;4;25;.862;3600000;0
9213;4487;4920;0;0;0;0;.00nan;0;0
9213;183859;4920;68;29;3;26;.897;3669000;0
9213;37857;4245;0;0;0;0;.00nan;0;0
9213;186520;4245;79;42;4;38;.905;3669000;0
9214;170612;74;67;12;0;12;1.000;1451000;0
9214;170728;85;0;0;0;0;.00nan;0;0
9214;57215;74;31;16;4;12;.750;2146000;0
9214;57998;85;66;33;3;30;.909;3600000;0
9215;171970;82;21;24;6;18;.750;2000000;0
9215;-1;82;39;21;4;17;.810;1600000;0
9215;184049;1097;79;25;1;24;.960;3600000;0
9215;171730;1097;0;0;0;0;.00nan;0;0
9216;173856;75;56;24;3;21;.875;3781000;0
9216;171615;75;0;0;0;0;.00nan;0;0
9216;176136;76;0;0;0;0;.00nan;0;0
9216;78864;76;89;47;4;43;.915;3781000;0
9217;183755;69;51;29;4;25;.862;3600000;0
9217;173823;73;0;0;0;0;.00nan;0;0
9217;170963;73;73;23;1;22;.957;3600000;0
9217;161047;69;0;0;0;0;.00nan;0;0
9218;171970;82;0;0;0;0;.00nan;0;0
9218;-1;82;73;31;3;28;.903;3600000;0
9218;175423;77;0;0;0;0;.00nan;0;0
9218;180873;77;22;29;6;23;.793;3600000;0
9219;178911;152;0;0;0;0;.00nan;0;0
9219;38209;149;0;0;0;0;.00nan;0;0
9219;57207;152;56;39;5;34;.872;3600000;0
9219;86875;149;96;25;1;24;.960;3600000;0
9220;170612;74;0;0;0;0;.00nan;0;0
9220;170728;85;0;0;0;0;.00nan;0;0
9220;57215;74;85;31;2;29;.935;3556000;0
9220;57998;85;66;17;1;16;.941;3600000;0
9221;173918;4921;0;0;0;0;.00nan;0;0
9221;37857;4245;57;17;2;15;.882;3600000;0
9221;182049;4921;86;55;4;51;.927;3584000;0
9221;186520;4245;0;0;0;0;.00nan;0;0
9222;173874;158;0;0;0;0;.00nan;0;0
9222;59592;80;91;37;2;35;.946;3600000;0
9222;85009;80;0;0;0;0;.00nan;0;0
9222;91398;158;53;39;5;34;.872;3600000;0
9223;184049;1097;70;44;5;39;.886;3600000;0
9223;173856;75;49;28;4;24;.857;3600000;0
9223;171615;75;0;0;0;0;.00nan;0;0
9223;171730;1097;0;0;0;0;.00nan;0;0
9224;184158;4620;100;22;0;22;1.000;3600000;0
9224;170728;85;0;0;0;0;.00nan;0;0
9224;181341;4620;0;0;0;0;.00nan;0;0
9224;57998;85;81;52;5;47;.904;3600000;0
9225;173823;73;0;0;0;0;.00nan;0;0
9225;170963;73;42;26;5;21;.808;3600000;0
9225;46790;71;0;0;0;0;.00nan;0;0
9225;78775;71;79;30;3;27;.900;3600000;0
9226;166545;1096;68;31;3;28;.903;3628000;0
9226;171970;82;0;0;0;0;.00nan;0;0
9226;183775;1096;0;0;0;0;.00nan;0;0
9226;-1;82;75;36;4;32;.889;3628000;0
9227;163989;72;85;39;3;36;.923;3707000;0
9227;183755;69;60;35;4;31;.886;3707000;0
9227;64811;72;0;0;0;0;.00nan;0;0
9227;161047;69;0;0;0;0;.00nan;0;0
9228;169166;1095;29;32;6;26;.813;1996000;0
9228;60773;1095;69;11;0;11;1.000;1904000;0
9228;85633;2564;70;11;0;11;1.000;1338000;0
9228;86151;2564;29;28;6;22;.786;2562000;0
9229;178911;152;89;38;2;36;.947;3600000;0
9229;38209;149;0;0;0;0;.00nan;0;0
9229;57207;152;0;0;0;0;.00nan;0;0
9229;86875;149;76;31;3;28;.903;3600000;0
9230;173856;75;0;0;0;0;.00nan;0;0
9230;171615;75;77;37;3;34;.919;3600000;0
9230;175423;77;100;29;0;29;1.000;3600000;0
9230;180873;77;0;0;0;0;.00nan;0;0
9231;173918;4921;0;0;0;0;.00nan;0;0
9231;37857;4245;0;0;0;0;.00nan;0;0
9231;182049;4921;93;35;1;34;.971;3697000;0
9231;186520;4245;92;43;2;41;.953;3697000;0
9232;184049;1097;0;0;0;0;.00nan;0;0
9232;170598;4922;0;0;0;0;.00nan;0;0
9232;171730;1097;74;33;2;31;.939;3587000;0
9232;161046;4922;88;34;1;33;.971;3600000;0
9233;179411;151;0;0;0;0;.00nan;0;0
9233;176060;151;67;22;2;20;.909;3900000;0
9233;176136;76;86;38;2;36;.947;3900000;0
9233;78864;76;0;0;0;0;.00nan;0;0
9234;4487;4920;0;0;0;0;.00nan;0;0
9234;183859;4920;74;26;2;24;.923;3871000;0
9234;184398;78;94;36;2;34;.944;3900000;0
9234;179406;78;0;0;0;0;.00nan;0;0
9235;165611;81;0;0;0;0;.00nan;0;0
9235;184081;157;74;25;2;23;.920;3600000;0
9235;-1;157;0;0;0;0;.00nan;0;0
9235;176770;81;70;39;4;35;.897;3565000;0
9236;173874;158;0;0;0;0;.00nan;0;0
9236;59592;80;60;22;2;20;.909;3600000;0
9236;85009;80;0;0;0;0;.00nan;0;0
9236;91398;158;51;31;5;26;.839;3600000;0
9237;-1;67;47;34;5;29;.853;3563000;0
9237;169096;67;0;0;0;0;.00nan;0;0
9237;170612;74;0;0;0;0;.00nan;0;0
9237;57215;74;53;26;4;22;.846;3600000;0
9238;184158;4620;68;26;2;24;.923;3559000;0
9238;184398;78;0;0;0;0;.00nan;0;0
9238;179406;78;98;23;0;23;1.000;3600000;0
9238;181341;4620;0;0;0;0;.00nan;0;0
9239;169166;1095;75;32;2;30;.938;3581000;0
9239;173823;73;63;17;1;16;.941;3600000;0
9239;170963;73;0;0;0;0;.00nan;0;0
9239;60773;1095;0;0;0;0;.00nan;0;0
9240;166545;1096;0;0;0;0;.00nan;0;0
9240;171970;82;76;25;1;24;.960;3600000;0
9240;183775;1096;81;47;4;43;.915;3600000;0
9240;-1;82;0;0;0;0;.00nan;0;0
9241;163989;72;0;0;0;0;.00nan;0;0
9241;183755;69;0;0;0;0;.00nan;0;0
9241;64811;72;59;28;4;24;.857;3572000;0
9241;161047;69;64;27;3;24;.889;3600000;0
9242;178911;152;0;0;0;0;.00nan;0;0
9242;38209;149;43;18;3;15;.833;3600000;0
9242;57207;152;59;31;4;27;.871;3565000;0
9242;86875;149;0;0;0;0;.00nan;0;0
9243;4487;4920;58;21;3;18;.857;3600000;0
9243;183859;4920;0;0;0;0;.00nan;0;0
9243;170728;85;0;0;0;0;.00nan;0;0
9243;57998;85;84;46;4;42;.913;3575000;0
9244;173856;75;61;19;2;17;.895;3600000;0
9244;171615;75;0;0;0;0;.00nan;0;0
9244;175423;77;69;14;0;14;1.000;1181000;0
9244;180873;77;34;34;6;28;.824;2419000;0
9245;173918;4921;0;0;0;0;.00nan;0;0
9245;37857;4245;79;25;1;24;.960;3600000;0
9245;182049;4921;56;30;3;27;.900;3574000;0
9245;186520;4245;0;0;0;0;.00nan;0;0
9246;184049;1097;78;32;3;29;.906;3600000;0
9246;170598;4922;46;34;5;29;.853;3222000;0
9246;171730;1097;0;0;0;0;.00nan;0;0
9246;161046;4922;54;3;0;3;1.000;307000;0
9247;179411;151;69;39;5;34;.872;3600000;0
9247;176060;151;0;0;0;0;.00nan;0;0
9247;176136;76;0;0;0;0;.00nan;0;0
9247;78864;76;86;32;2;30;.938;3600000;0
9248;46790;71;68;30;3;27;.900;3600000;0
9248;78775;71;0;0;0;0;.00nan;0;0
9248;85633;2564;0;0;0;0;.00nan;0;0
9248;86151;2564;79;46;5;41;.891;3573000;0
9249;165611;81;96;42;1;41;.976;3900000;0
9249;184081;157;72;21;1;20;.952;3900000;0
9249;-1;157;0;0;0;0;.00nan;0;0
9249;176770;81;0;0;0;0;.00nan;0;0
9250;173874;158;0;0;0;0;.00nan;0;0
9250;59592;80;45;25;4;21;.840;3600000;0
9250;85009;80;0;0;0;0;.00nan;0;0
9250;91398;158;100;30;0;30;1.000;3600000;0
9251;-1;67;0;0;0;0;.00nan;0;0
9251;169096;67;88;38;2;36;.947;3573000;0
9251;170612;74;0;0;0;0;.00nan;0;0
9251;57215;74;99;40;1;39;.975;3600000;0
9252;184158;4620;0;0;0;0;.00nan;0;0
9252;170612;74;0;0;0;0;.00nan;0;0
9252;181341;4620;37;24;4;20;.833;3600000;0
9252;57215;74;67;30;3;27;.900;3600000;0
9253;163989;72;64;24;2;22;.917;3600000;0
9253;64811;72;0;0;0;0;.00nan;0;0
9253;85633;2564;27;35;7;28;.800;2968000;0
9253;86151;2564;61;8;0;8;1.000;632000;0
9254;4487;4920;0;0;0;0;.00nan;0;0
9254;183859;4920;56;26;4;22;.846;3600000;0
9254;170728;85;0;0;0;0;.00nan;0;0
9254;57998;85;95;58;5;53;.914;3596000;0
9255;179411;151;0;0;0;0;.00nan;0;0
9255;176060;151;78;35;3;32;.914;3732000;0
9255;176136;76;52;15;2;13;.867;3732000;0
9255;78864;76;0;0;0;0;.00nan;0;0
9256;173823;73;0;0;0;0;.00nan;0;0
9256;170963;73;58;38;5;33;.868;3573000;0
9256;46790;71;0;0;0;0;.00nan;0;0
9256;78775;71;54;21;3;18;.857;3600000;0
9257;165611;81;0;0;0;0;.00nan;0;0
9257;184081;157;81;33;2;31;.939;3600000;0
9257;-1;157;0;0;0;0;.00nan;0;0
9257;176770;81;81;51;4;47;.922;3574000;0
9258;-1;67;67;43;5;38;.884;3600000;0
9258;169096;67;0;0;0;0;.00nan;0;0
9258;184398;78;0;0;0;0;.00nan;0;0
9258;179406;78;81;36;2;34;.944;3600000;0
9259;178911;152;80;27;1;26;.963;3600000;0
9259;57207;152;0;0;0;0;.00nan;0;0
9259;59592;80;68;34;4;30;.882;3600000;0
9259;85009;80;0;0;0;0;.00nan;0;0
9260;173823;73;0;0;0;0;.00nan;0;0
9260;173918;4921;0;0;0;0;.00nan;0;0
9260;170963;73;55;22;3;19;.864;3575000;0
9260;182049;4921;93;54;2;52;.963;3600000;0
9261;165611;81;86;37;2;35;.946;3600000;0
9261;176770;81;0;0;0;0;.00nan;0;0
9261;38209;149;0;0;0;0;.00nan;0;0
9261;86875;149;44;25;4;21;.840;3600000;0
9262;171970;82;38;4;2;2;.500;705000;0
9262;-1;82;31;29;6;23;.793;2918000;0
9262;170598;4922;44;3;1;2;.667;425000;0
9262;161046;4922;21;24;6;18;.750;3213000;0
9263;184158;4620;77;25;1;24;.960;3600000;0
9263;181341;4620;0;0;0;0;.00nan;0;0
9263;37857;4245;97;41;2;39;.951;3580000;0
9263;186520;4245;0;0;0;0;.00nan;0;0
9264;169166;1095;66;39;4;35;.897;3600000;0
9264;173823;73;0;0;0;0;.00nan;0;0
9264;170963;73;78;26;1;25;.962;3600000;0
9264;60773;1095;0;0;0;0;.00nan;0;0
9265;166545;1096;0;0;0;0;.00nan;0;0
9265;183775;1096;63;30;3;27;.900;3546000;0
9265;176136;76;84;30;1;29;.967;3600000;0
9265;78864;76;0;0;0;0;.00nan;0;0
9266;165611;81;33;15;4;11;.733;992000;0
9266;176770;81;41;18;3;15;.833;2608000;0
9266;38209;149;0;0;0;0;.00nan;0;0
9266;86875;149;77;42;3;39;.929;3600000;0
9267;170598;4922;66;29;3;26;.897;3688000;0
9267;175423;77;55;32;4;28;.875;3688000;0
9267;180873;77;0;0;0;0;.00nan;0;0
9267;161046;4922;0;0;0;0;.00nan;0;0
9268;183755;69;94;35;1;34;.971;3600000;0
9268;85633;2564;0;0;0;0;.00nan;0;0
9268;86151;2564;54;33;5;28;.848;3600000;0
9268;161047;69;0;0;0;0;.00nan;0;0
9269;4487;4920;0;0;0;0;.00nan;0;0
9269;183859;4920;91;18;0;18;1.000;3600000;0
9269;173874;158;0;0;0;0;.00nan;0;0
9269;91398;158;77;37;3;34;.919;3600000;0
9270;163989;72;55;21;3;18;.857;3593000;0
9270;170728;85;0;0;0;0;.00nan;0;0
9270;57998;85;96;36;2;34;.944;3600000;0
9270;64811;72;0;0;0;0;.00nan;0;0
9271;171970;82;77;25;1;24;.960;3900000;0
9271;-1;82;0;0;0;0;.00nan;0;0
9271;184049;1097;74;23;1;22;.957;3900000;0
9271;171730;1097;0;0;0;0;.00nan;0;0
9272;170612;74;0;0;0;0;.00nan;0;0
9272;46790;71;0;0;0;0;.00nan;0;0
9272;57215;74;49;22;4;18;.818;3589000;0
9272;78775;71;60;25;3;22;.880;3600000;0
9273;-1;67;0;0;0;0;.00nan;0;0
9273;169096;67;91;31;1;30;.968;3600000;0
9273;184398;78;63;29;3;26;.897;3555000;0
9273;179406;78;0;0;0;0;.00nan;0;0
9274;184081;157;54;19;3;16;.842;3600000;0
9274;-1;157;0;0;0;0;.00nan;0;0
9274;59592;80;66;43;5;38;.884;3573000;0
9274;85009;80;0;0;0;0;.00nan;0;0
9275;173856;75;88;25;1;24;.960;3600000;0
9275;173918;4921;40;35;6;29;.829;2640000;0
9275;171615;75;0;0;0;0;.00nan;0;0
9275;182049;4921;54;13;2;11;.846;960000;0
9276;178911;152;49;32;5;27;.844;3600000;0
9276;179411;151;0;0;0;0;.00nan;0;0
9276;176060;151;57;46;6;40;.870;3559000;0
9276;57207;152;0;0;0;0;.00nan;0;0
9277;175423;77;0;0;0;0;.00nan;0;0
9277;176136;76;0;0;0;0;.00nan;0;0
9277;180873;77;49;36;5;31;.861;3591000;0
9277;78864;76;66;26;3;23;.885;3600000;0
9278;169166;1095;0;0;0;0;.00nan;0;0
9278;173823;73;66;35;4;31;.886;3600000;0
9278;170963;73;0;0;0;0;.00nan;0;0
9278;60773;1095;60;42;5;37;.881;3567000;0
9279;166545;1096;42;22;4;18;.818;3593000;0
9279;183775;1096;0;0;0;0;.00nan;0;0
9279;170598;4922;0;0;0;0;.00nan;0;0
9279;161046;4922;90;53;3;50;.943;3600000;0
9280;165611;81;90;42;3;39;.929;3556000;0
9280;176770;81;0;0;0;0;.00nan;0;0
9280;38209;149;65;17;1;16;.941;3600000;0
9280;86875;149;0;0;0;0;.00nan;0;0
9281;183755;69;0;0;0;0;.00nan;0;0
9281;85633;2564;83;24;1;23;.958;3600000;0
9281;86151;2564;0;0;0;0;.00nan;0;0
9281;161047;69;69;28;2;26;.929;3564000;0
9282;178911;152;0;0;0;0;.00nan;0;0
9282;179411;151;0;0;0;0;.00nan;0;0
9282;176060;151;87;29;1;28;.966;3600000;0
9282;57207;152;61;22;2;20;.909;3595000;0
9283;4487;4920;0;0;0;0;.00nan;0;0
9283;183859;4920;61;19;3;16;.842;3852000;0
9283;173874;158;99;55;2;53;.964;3852000;0
9283;91398;158;0;0;0;0;.00nan;0;0
9284;163989;72;0;0;0;0;.00nan;0;0
9284;170728;85;0;0;0;0;.00nan;0;0
9284;57998;85;97;47;2;45;.957;3571000;0
9284;64811;72;65;20;1;19;.950;3600000;0
9285;184158;4620;81;39;3;36;.923;3600000;0
9285;181341;4620;0;0;0;0;.00nan;0;0
9285;37857;4245;0;0;0;0;.00nan;0;0
9285;186520;4245;40;29;5;24;.828;3570000;0
9286;171970;82;0;0;0;0;.00nan;0;0
9286;-1;82;99;37;2;35;.946;3600000;0
9286;184049;1097;0;0;0;0;.00nan;0;0
9286;171730;1097;56;32;4;28;.875;3578000;0
9287;170612;74;72;44;5;39;.886;3842000;0
9287;46790;71;58;27;4;23;.852;3842000;0
9287;57215;74;0;0;0;0;.00nan;0;0
9287;78775;71;0;0;0;0;.00nan;0;0
9288;-1;67;46;26;4;22;.846;3900000;0
9288;169096;67;0;0;0;0;.00nan;0;0
9288;184398;78;0;0;0;0;.00nan;0;0
9288;179406;78;76;45;4;41;.911;3900000;0
9289;184081;157;75;31;3;28;.903;3695000;0
9289;-1;157;0;0;0;0;.00nan;0;0
9289;59592;80;78;27;2;25;.926;3695000;0
9289;85009;80;0;0;0;0;.00nan;0;0
9290;173856;75;69;26;2;24;.923;3900000;0
9290;173918;4921;0;0;0;0;.00nan;0;0
9290;171615;75;0;0;0;0;.00nan;0;0
9290;182049;4921;87;34;2;32;.941;3900000;0
9291;175423;77;72;24;1;23;.958;3600000;0
9291;176136;76;79;45;3;42;.933;3592000;0
9291;180873;77;0;0;0;0;.00nan;0;0
9291;78864;76;0;0;0;0;.00nan;0;0
9292;169166;1095;63;27;2;25;.926;3600000;0
9292;60773;1095;0;0;0;0;.00nan;0;0
9292;85633;2564;0;0;0;0;.00nan;0;0
9292;86151;2564;58;37;4;33;.892;3525000;0
9293;166545;1096;0;0;0;0;.00nan;0;0
9293;183775;1096;55;38;5;33;.868;3600000;0
9293;184049;1097;75;33;2;31;.939;3600000;0
9293;171730;1097;0;0;0;0;.00nan;0;0
9294;4487;4920;95;19;0;19;1.000;3600000;0
9294;183859;4920;0;0;0;0;.00nan;0;0
9294;173874;158;70;21;1;20;.952;1386000;0
9294;91398;158;44;27;5;22;.815;2214000;0
9295;163989;72;74;27;2;25;.926;3600000;0
9295;170728;85;21;26;6;20;.769;2146000;0
9295;57998;85;55;17;2;15;.882;1454000;0
9295;64811;72;0;0;0;0;.00nan;0;0
9296;184158;4620;0;0;0;0;.00nan;0;0
9296;181341;4620;26;39;8;31;.795;3600000;0
9296;37857;4245;53;26;4;22;.846;3600000;0
9296;186520;4245;0;0;0;0;.00nan;0;0
9297;170612;74;0;0;0;0;.00nan;0;0
9297;46790;71;0;0;0;0;.00nan;0;0
9297;57215;74;67;37;4;33;.892;3600000;0
9297;78775;71;80;30;1;29;.967;3600000;0
9298;184081;157;70;26;2;24;.923;3832000;0
9298;-1;157;0;0;0;0;.00nan;0;0
9298;59592;80;82;42;3;39;.929;3832000;0
9298;85009;80;0;0;0;0;.00nan;0;0
9299;173856;75;62;30;3;27;.900;3600000;0
9299;173918;4921;60;36;5;31;.861;3569000;0
9299;171615;75;0;0;0;0;.00nan;0;0
9299;182049;4921;0;0;0;0;.00nan;0;0
9300;178911;152;99;31;1;30;.968;3600000;0
9300;179411;151;75;33;2;31;.939;3553000;0
9300;176060;151;0;0;0;0;.00nan;0;0
9300;57207;152;0;0;0;0;.00nan;0;0
9301;173918;4921;58;49;6;43;.878;3600000;0
9301;37857;4245;0;0;0;0;.00nan;0;0
9301;182049;4921;0;0;0;0;.00nan;0;0
9301;186520;4245;94;20;0;20;1.000;3600000;0
9302;184081;157;63;36;4;32;.889;3600000;0
9302;-1;157;0;0;0;0;.00nan;0;0
9302;38209;149;0;0;0;0;.00nan;0;0
9302;86875;149;96;39;1;38;.974;3600000;0
9303;171970;82;42;44;6;38;.864;3536000;0
9303;-1;82;0;0;0;0;.00nan;0;0
9303;184158;4620;62;38;4;34;.895;3600000;0
9303;181341;4620;0;0;0;0;.00nan;0;0
9304;183755;69;68;25;2;23;.920;3600000;0
9304;85633;2564;54;11;1;10;.909;785000;0
9304;86151;2564;36;36;6;30;.833;2815000;0
9304;161047;69;0;0;0;0;.00nan;0;0
9305;173856;75;99;52;2;50;.962;3600000;0
9305;170598;4922;32;13;3;10;.769;494000;0
9305;171615;75;0;0;0;0;.00nan;0;0
9305;161046;4922;71;26;2;24;.923;3106000;0
9306;169166;1095;95;43;3;40;.930;3561000;0
9306;178911;152;62;25;2;23;.920;3600000;0
9306;57207;152;0;0;0;0;.00nan;0;0
9306;60773;1095;0;0;0;0;.00nan;0;0
9307;163989;72;52;26;3;23;.885;3544000;0
9307;175423;77;0;0;0;0;.00nan;0;0
9307;180873;77;63;22;2;20;.909;3600000;0
9307;64811;72;0;0;0;0;.00nan;0;0
9308;166545;1096;66;44;6;38;.864;3581000;0
9308;183775;1096;0;0;0;0;.00nan;0;0
9308;170728;85;0;0;0;0;.00nan;0;0
9308;57998;85;66;39;4;35;.897;3600000;0
9309;184049;1097;70;23;2;21;.913;3900000;0
9309;171730;1097;0;0;0;0;.00nan;0;0
9309;176136;76;96;44;2;42;.955;3900000;0
9309;78864;76;0;0;0;0;.00nan;0;0
9310;169166;1095;0;0;0;0;.00nan;0;0
9310;179411;151;0;0;0;0;.00nan;0;0
9310;176060;151;53;32;4;28;.875;3900000;0
9310;60773;1095;88;49;4;45;.918;3900000;0
9311;184081;157;50;26;4;22;.846;3600000;0
9311;-1;157;0;0;0;0;.00nan;0;0
9311;38209;149;79;33;1;32;.970;3600000;0
9311;86875;149;0;0;0;0;.00nan;0;0
9312;171970;82;0;0;0;0;.00nan;0;0
9312;-1;82;88;27;2;25;.926;3600000;0
9312;184158;4620;77;50;5;45;.900;3600000;0
9312;181341;4620;0;0;0;0;.00nan;0;0
9313;163989;72;0;0;0;0;.00nan;0;0
9313;175423;77;100;33;1;32;.970;3600000;0
9313;180873;77;0;0;0;0;.00nan;0;0
9313;64811;72;38;17;3;14;.824;3538000;0
9314;183755;69;85;30;2;28;.933;3900000;0
9314;173823;73;0;0;0;0;.00nan;0;0
9314;170963;73;96;50;2;48;.960;3900000;0
9314;161047;69;0;0;0;0;.00nan;0;0
9315;166545;1096;0;0;0;0;.00nan;0;0
9315;183775;1096;72;38;3;35;.921;3600000;0
9315;170728;85;0;0;0;0;.00nan;0;0
9315;57998;85;72;26;2;24;.923;3600000;0
9316;170612;74;0;0;0;0;.00nan;0;0
9316;184398;78;100;42;0;42;1.000;3600000;0
9316;179406;78;0;0;0;0;.00nan;0;0
9316;57215;74;57;28;3;25;.893;3600000;0
9317;173856;75;0;0;0;0;.00nan;0;0
9317;170598;4922;81;30;1;29;.967;3600000;0
9317;171615;75;69;36;4;32;.889;3600000;0
9317;161046;4922;0;0;0;0;.00nan;0;0
9318;173874;158;0;0;0;0;.00nan;0;0
9318;178911;152;0;0;0;0;.00nan;0;0
9318;57207;152;50;25;3;22;.880;3587000;0
9318;91398;158;90;34;2;32;.941;3600000;0
9319;184049;1097;0;0;0;0;.00nan;0;0
9319;171730;1097;51;31;5;26;.839;3600000;0
9319;176136;76;99;34;0;34;1.000;2649000;0
9319;78864;76;28;13;4;9;.692;951000;0
9320;46790;71;71;25;2;23;.920;3600000;0
9320;78775;71;0;0;0;0;.00nan;0;0
9320;85633;2564;39;10;2;8;.800;1257000;0
9320;86151;2564;51;33;6;27;.818;2343000;0
9321;165611;81;93;33;2;31;.939;3600000;0
9321;176770;81;0;0;0;0;.00nan;0;0
9321;59592;80;33;27;5;22;.815;3600000;0
9321;85009;80;0;0;0;0;.00nan;0;0
9322;173918;4921;69;27;2;25;.926;3600000;0
9322;37857;4245;69;40;4;36;.900;3523000;0
9322;182049;4921;0;0;0;0;.00nan;0;0
9322;186520;4245;0;0;0;0;.00nan;0;0
9323;4487;4920;58;30;4;26;.867;3900000;0
9323;183859;4920;0;0;0;0;.00nan;0;0
9323;-1;67;0;0;0;0;.00nan;0;0
9323;169096;67;76;44;4;40;.909;3900000;0
9324;184081;157;60;24;3;21;.875;3600000;0
9324;-1;157;0;0;0;0;.00nan;0;0
9324;38209;149;0;0;0;0;.00nan;0;0
9324;86875;149;71;42;4;38;.905;3600000;0
9325;171970;82;93;35;1;34;.971;3600000;0
9325;-1;82;0;0;0;0;.00nan;0;0
9325;184158;4620;0;0;0;0;.00nan;0;0
9325;181341;4620;70;35;3;32;.914;3591000;0
9326;165611;81;0;0;0;0;.00nan;0;0
9326;176770;81;97;39;2;37;.949;3600000;0
9326;59592;80;33;25;6;19;.760;3328000;0
9326;85009;80;49;4;1;3;.750;272000;0
9327;163989;72;77;28;2;26;.929;3600000;0
9327;175423;77;0;0;0;0;.00nan;0;0
9327;180873;77;45;42;6;36;.857;3600000;0
9327;64811;72;0;0;0;0;.00nan;0;0
9328;183755;69;0;0;0;0;.00nan;0;0
9328;173823;73;97;49;3;46;.939;3600000;0
9328;170963;73;0;0;0;0;.00nan;0;0
9328;161047;69;51;25;4;21;.840;3544000;0
9329;173856;75;64;25;3;22;.880;3900000;0
9329;170598;4922;0;0;0;0;.00nan;0;0
9329;171615;75;0;0;0;0;.00nan;0;0
9329;161046;4922;76;44;3;41;.932;3900000;0
9330;46790;71;0;0;0;0;.00nan;0;0
9330;78775;71;68;32;3;29;.906;3900000;0
9330;85633;2564;0;0;0;0;.00nan;0;0
9330;86151;2564;76;33;3;30;.909;3900000;0
9331;166545;1096;89;43;3;40;.930;3900000;0
9331;183775;1096;0;0;0;0;.00nan;0;0
9331;170728;85;0;0;0;0;.00nan;0;0
9331;57998;85;94;37;3;34;.919;3900000;0
9332;170612;74;69;42;4;38;.905;3650000;0
9332;184398;78;76;38;3;35;.921;3650000;0
9332;179406;78;0;0;0;0;.00nan;0;0
9332;57215;74;0;0;0;0;.00nan;0;0
9333;173874;158;72;46;5;41;.891;3600000;0
9333;178911;152;27;28;6;22;.786;3543000;0
9333;57207;152;0;0;0;0;.00nan;0;0
9333;91398;158;0;0;0;0;.00nan;0;0
9334;184049;1097;48;34;5;29;.853;3578000;0
9334;171730;1097;0;0;0;0;.00nan;0;0
9334;176136;76;0;0;0;0;.00nan;0;0
9334;78864;76;50;32;4;28;.875;3600000;0
9335;173918;4921;0;0;0;0;.00nan;0;0
9335;37857;4245;0;0;0;0;.00nan;0;0
9335;182049;4921;98;30;1;29;.967;3600000;0
9335;186520;4245;57;15;2;13;.867;3562000;0
9336;169166;1095;19;23;6;17;.739;1700000;0
9336;179411;151;0;0;0;0;.00nan;0;0
9336;176060;151;52;26;4;22;.846;3600000;0
9336;60773;1095;57;24;3;21;.875;1900000;0
9337;4487;4920;0;0;0;0;.00nan;0;0
9337;183859;4920;57;18;2;16;.889;3600000;0
9337;-1;67;24;28;6;22;.786;2732000;0
9337;169096;67;68;10;0;10;1.000;868000;0
9338;175423;77;73;37;3;34;.919;3600000;0
9338;176136;76;83;25;1;24;.960;3600000;0
9338;180873;77;0;0;0;0;.00nan;0;0
9338;78864;76;0;0;0;0;.00nan;0;0
9339;179411;151;0;0;0;0;.00nan;0;0
9339;176060;151;75;39;4;35;.897;3600000;0
9339;38209;149;41;25;5;20;.800;3587000;0
9339;86875;149;0;0;0;0;.00nan;0;0
9340;163989;72;0;0;0;0;.00nan;0;0
9340;183755;69;65;36;4;32;.889;3525000;0
9340;64811;72;84;30;2;28;.933;3600000;0
9340;161047;69;0;0;0;0;.00nan;0;0
9341;165611;81;78;35;3;32;.914;3566000;0
9341;173874;158;0;0;0;0;.00nan;0;0
9341;176770;81;0;0;0;0;.00nan;0;0
9341;91398;158;70;22;1;21;.955;3600000;0
9342;184081;157;71;39;4;35;.897;3794000;0
9342;178911;152;49;38;5;33;.868;3794000;0
9342;-1;157;0;0;0;0;.00nan;0;0
9342;57207;152;0;0;0;0;.00nan;0;0
9343;184158;4620;90;42;3;39;.929;3600000;0
9343;181341;4620;0;0;0;0;.00nan;0;0
9343;37857;4245;33;25;5;20;.800;3600000;0
9343;186520;4245;0;0;0;0;.00nan;0;0
9344;184049;1097;34;30;6;24;.800;3338000;0
9344;171730;1097;48;0;0;0;.00nan;262000;0
9344;175423;77;0;0;0;0;.00nan;0;0
9344;180873;77;89;40;3;37;.925;3600000;0
9345;173823;73;0;0;0;0;.00nan;0;0
9345;170963;73;57;27;3;24;.889;3579000;0
9345;46790;71;0;0;0;0;.00nan;0;0
9345;78775;71;99;49;2;47;.959;3600000;0
9346;166545;1096;86;32;1;31;.969;3600000;0
9346;183775;1096;0;0;0;0;.00nan;0;0
9346;176136;76;18;8;4;4;.500;1133000;0
9346;78864;76;61;37;5;32;.865;2467000;0
9347;163989;72;0;0;0;0;.00nan;0;0
9347;183755;69;66;29;3;26;.897;3600000;0
9347;64811;72;40;28;5;23;.821;3557000;0
9347;161047;69;0;0;0;0;.00nan;0;0
9348;171970;82;32;21;5;16;.762;3624000;0
9348;-1;82;0;0;0;0;.00nan;0;0
9348;170598;4922;70;41;4;37;.902;3624000;0
9348;161046;4922;0;0;0;0;.00nan;0;0
9349;169166;1095;100;55;3;52;.945;3900000;0
9349;60773;1095;0;0;0;0;.00nan;0;0
9349;85633;2564;0;0;0;0;.00nan;0;0
9349;86151;2564;73;33;3;30;.909;3900000;0
9350;4487;4920;0;0;0;0;.00nan;0;0
9350;183859;4920;79;23;1;22;.957;3600000;0
9350;170612;74;0;0;0;0;.00nan;0;0
9350;57215;74;80;46;4;42;.913;3600000;0
9351;-1;67;0;0;0;0;.00nan;0;0
9351;169096;67;73;29;1;28;.966;3600000;0
9351;173856;75;36;28;6;22;.786;3323000;0
9351;171615;75;55;5;0;5;1.000;277000;0
9352;165611;81;53;24;4;20;.833;3900000;0
9352;173874;158;0;0;0;0;.00nan;0;0
9352;176770;81;0;0;0;0;.00nan;0;0
9352;91398;158;83;52;4;48;.923;3883000;0
9353;184081;157;0;0;0;0;.00nan;0;0
9353;-1;157;100;48;2;46;.958;3600000;0
9353;38209;149;0;0;0;0;.00nan;0;0
9353;86875;149;64;35;5;30;.857;3600000;0
9354;173918;4921;0;0;0;0;.00nan;0;0
9354;182049;4921;76;36;3;33;.917;3554000;0
9354;59592;80;84;25;1;24;.960;3600000;0
9354;85009;80;0;0;0;0;.00nan;0;0
9355;178911;152;0;0;0;0;.00nan;0;0
9355;179411;151;0;0;0;0;.00nan;0;0
9355;176060;151;60;39;5;34;.872;3572000;0
9355;57207;152;59;23;3;20;.870;3600000;0
9356;184158;4620;99;29;0;29;1.000;3600000;0
9356;184398;78;98;44;2;42;.955;3600000;0
9356;179406;78;0;0;0;0;.00nan;0;0
9356;181341;4620;0;0;0;0;.00nan;0;0
9357;184081;157;78;24;1;23;.958;3600000;0
9357;-1;157;0;0;0;0;.00nan;0;0
9357;38209;149;39;25;4;21;.840;3600000;0
9357;86875;149;0;0;0;0;.00nan;0;0
9358;169166;1095;0;0;0;0;.00nan;0;0
9358;173823;73;30;19;4;15;.789;1897000;0
9358;170963;73;62;15;1;14;.933;1703000;0
9358;60773;1095;97;37;1;36;.973;3600000;0
9359;166545;1096;0;0;0;0;.00nan;0;0
9359;183775;1096;64;23;2;21;.913;3600000;0
9359;175423;77;32;17;4;13;.765;1072000;0
9359;180873;77;67;33;3;30;.909;2528000;0
9360;163989;72;71;37;3;34;.919;3600000;0
9360;183755;69;85;30;2;28;.933;3235000;0
9360;64811;72;0;0;0;0;.00nan;0;0
9360;161047;69;28;7;3;4;.571;343000;0
9361;184049;1097;0;0;0;0;.00nan;0;0
9361;170598;4922;0;0;0;0;.00nan;0;0
9361;171730;1097;70;28;2;26;.929;3552000;0
9361;161046;4922;80;23;1;22;.957;3600000;0
9362;46790;71;60;27;3;24;.889;3600000;0
9362;78775;71;0;0;0;0;.00nan;0;0
9362;85633;2564;34;23;5;18;.783;3584000;0
9362;86151;2564;0;0;0;0;.00nan;0;0
9363;178911;152;96;37;2;35;.946;3586000;0
9363;179411;151;0;0;0;0;.00nan;0;0
9363;176060;151;99;28;1;27;.964;3600000;0
9363;57207;152;0;0;0;0;.00nan;0;0
9364;4487;4920;68;23;2;21;.913;3600000;0
9364;183859;4920;0;0;0;0;.00nan;0;0
9364;170612;74;51;37;5;32;.865;3600000;0
9364;57215;74;0;0;0;0;.00nan;0;0
9365;-1;67;55;21;3;18;.857;3600000;0
9365;169096;67;0;0;0;0;.00nan;0;0
9365;173856;75;0;0;0;0;.00nan;0;0
9365;171615;75;52;30;5;25;.833;3560000;0
9366;165611;81;0;0;0;0;.00nan;0;0
9366;173874;158;71;45;4;41;.911;3572000;0
9366;176770;81;79;33;3;30;.909;3600000;0
9366;91398;158;0;0;0;0;.00nan;0;0
9367;170728;85;52;3;0;3;1.000;387000;0
9367;37857;4245;0;0;0;0;.00nan;0;0
9367;186520;4245;100;23;0;23;1.000;3600000;0
9367;57998;85;45;39;6;33;.846;3213000;0
9368;171970;82;0;0;0;0;.00nan;0;0
9368;-1;82;70;37;4;33;.892;3770000;0
9368;176136;76;64;43;5;38;.884;3770000;0
9368;78864;76;0;0;0;0;.00nan;0;0
9369;173918;4921;67;31;3;28;.903;3517000;0
9369;182049;4921;0;0;0;0;.00nan;0;0
9369;59592;80;87;28;1;27;.964;3600000;0
9369;85009;80;0;0;0;0;.00nan;0;0
9370;166545;1096;47;31;5;26;.839;3551000;0
9370;183775;1096;0;0;0;0;.00nan;0;0
9370;175423;77;0;0;0;0;.00nan;0;0
9370;180873;77;76;39;4;35;.897;3600000;0
9371;169166;1095;63;28;3;25;.893;3600000;0
9371;173823;73;0;0;0;0;.00nan;0;0
9371;170963;73;45;23;4;19;.826;3595000;0
9371;60773;1095;0;0;0;0;.00nan;0;0
9372;184049;1097;74;36;3;33;.917;3583000;0
9372;170598;4922;100;41;1;40;.976;3600000;0
9372;171730;1097;0;0;0;0;.00nan;0;0
9372;161046;4922;0;0;0;0;.00nan;0;0
9373;4487;4920;0;0;0;0;.00nan;0;0
9373;183859;4920;91;31;1;30;.968;3600000;0
9373;170612;74;0;0;0;0;.00nan;0;0
9373;57215;74;76;50;6;44;.880;3600000;0
9374;-1;67;0;0;0;0;.00nan;0;0
9374;169096;67;53;29;4;25;.862;3600000;0
9374;173856;75;24;13;4;9;.692;1031000;0
9374;171615;75;80;27;1;26;.963;2547000;0
9375;171970;82;74;26;2;24;.923;3600000;0
9375;-1;82;0;0;0;0;.00nan;0;0
9375;176136;76;0;0;0;0;.00nan;0;0
9375;78864;76;75;38;4;34;.895;3512000;0
9376;184081;157;0;0;0;0;.00nan;0;0
9376;-1;157;69;27;3;24;.889;3600000;0
9376;179411;151;25;33;7;26;.788;3600000;0
9376;176060;151;0;0;0;0;.00nan;0;0
9377;170728;85;0;0;0;0;.00nan;0;0
9377;37857;4245;69;20;1;19;.950;3806000;0
9377;186520;4245;0;0;0;0;.00nan;0;0
9377;57998;85;92;58;2;56;.966;3806000;0
9378;173918;4921;88;27;1;26;.963;3598000;0
9378;182049;4921;0;0;0;0;.00nan;0;0
9378;59592;80;90;21;0;21;1.000;3600000;0
9378;85009;80;0;0;0;0;.00nan;0;0
9379;171970;82;67;27;2;25;.926;3600000;0
9379;-1;67;0;0;0;0;.00nan;0;0
9379;-1;82;0;0;0;0;.00nan;0;0
9379;169096;67;58;41;5;36;.878;3600000;0
9380;183755;69;49;31;4;27;.871;3545000;0
9380;179411;151;0;0;0;0;.00nan;0;0
9380;176060;151;100;46;3;43;.935;3600000;0
9380;161047;69;0;0;0;0;.00nan;0;0
9381;4487;4920;0;0;0;0;.00nan;0;0
9381;183859;4920;70;21;1;20;.952;3600000;0
9381;85633;2564;52;10;1;9;.900;681000;0
9381;86151;2564;42;49;7;42;.857;2919000;0
9382;170728;85;0;0;0;0;.00nan;0;0
9382;37857;4245;0;0;0;0;.00nan;0;0
9382;186520;4245;100;34;0;34;1.000;3600000;0
9382;57998;85;94;43;2;41;.953;3558000;0
9383;175423;77;64;23;2;21;.913;3600000;0
9383;176136;76;90;49;3;46;.939;3562000;0
9383;180873;77;0;0;0;0;.00nan;0;0
9383;78864;76;0;0;0;0;.00nan;0;0
9384;166545;1096;48;28;4;24;.857;3077000;0
9384;183775;1096;23;4;3;1;.250;523000;0
9384;173874;158;0;0;0;0;.00nan;0;0
9384;91398;158;85;28;1;27;.964;3600000;0
9385;184158;4620;81;35;2;33;.943;3900000;0
9385;181341;4620;0;0;0;0;.00nan;0;0
9385;37857;4245;86;36;2;34;.944;3900000;0
9385;186520;4245;0;0;0;0;.00nan;0;0
9386;183755;69;72;31;3;28;.903;3600000;0
9386;173823;73;0;0;0;0;.00nan;0;0
9386;170963;73;67;41;4;37;.902;3579000;0
9386;161047;69;0;0;0;0;.00nan;0;0
9387;171970;82;0;0;0;0;.00nan;0;0
9387;-1;67;99;33;1;32;.970;3600000;0
9387;-1;82;84;33;2;31;.939;3565000;0
9387;169096;67;0;0;0;0;.00nan;0;0
9388;163989;72;62;22;3;19;.864;3600000;0
9388;179411;151;0;0;0;0;.00nan;0;0
9388;176060;151;74;54;6;48;.889;3600000;0
9388;64811;72;0;0;0;0;.00nan;0;0
9389;178911;152;0;0;0;0;.00nan;0;0
9389;57207;152;94;30;1;29;.967;3600000;0
9389;59592;80;62;36;4;32;.889;3600000;0
9389;85009;80;0;0;0;0;.00nan;0;0
9390;170612;74;0;0;0;0;.00nan;0;0
9390;176136;76;76;43;4;39;.907;3544000;0
9390;57215;74;52;19;2;17;.895;3600000;0
9390;78864;76;0;0;0;0;.00nan;0;0
9391;173856;75;59;42;6;36;.857;3786000;0
9391;170598;4922;56;36;5;31;.861;3786000;0
9391;171615;75;0;0;0;0;.00nan;0;0
9391;161046;4922;0;0;0;0;.00nan;0;0
9392;184049;1097;41;27;5;22;.815;3900000;0
9392;171730;1097;0;0;0;0;.00nan;0;0
9392;175423;77;0;0;0;0;.00nan;0;0
9392;180873;77;70;47;5;42;.894;3900000;0
9393;4487;4920;0;0;0;0;.00nan;0;0
9393;183859;4920;77;18;1;17;.944;3900000;0
9393;46790;71;0;0;0;0;.00nan;0;0
9393;78775;71;97;57;1;56;.982;3900000;0
9394;163462;85;89;40;3;37;.925;3586000;0
9394;170728;85;0;0;0;0;.00nan;0;0
9394;184398;78;89;25;1;24;.960;3600000;0
9394;179406;78;0;0;0;0;.00nan;0;0
9395;165611;81;0;0;0;0;.00nan;0;0
9395;184081;157;69;19;1;18;.947;3600000;0
9395;-1;157;0;0;0;0;.00nan;0;0
9395;176770;81;63;49;5;44;.898;3600000;0
9396;169166;1095;23;24;6;18;.750;3600000;0
9396;173918;4921;0;0;0;0;.00nan;0;0
9396;182049;4921;83;52;5;47;.904;3600000;0
9396;60773;1095;0;0;0;0;.00nan;0;0
9397;184158;4620;0;0;0;0;.00nan;0;0
9397;181341;4620;53;30;4;26;.867;3600000;0
9397;37857;4245;0;0;0;0;.00nan;0;0
9397;186520;4245;85;45;3;42;.933;3600000;0
9398;183755;69;0;0;0;0;.00nan;0;0
9398;173823;73;97;63;4;59;.937;3900000;0
9398;170963;73;0;0;0;0;.00nan;0;0
9398;161047;69;72;35;4;31;.886;3900000;0
9399;171970;82;61;28;3;25;.893;3550000;0
9399;-1;67;0;0;0;0;.00nan;0;0
9399;-1;82;0;0;0;0;.00nan;0;0
9399;169096;67;84;35;2;33;.943;3600000;0
9400;166545;1096;59;33;3;30;.909;3567000;0
9400;183775;1096;0;0;0;0;.00nan;0;0
9400;173874;158;0;0;0;0;.00nan;0;0
9400;91398;158;85;27;1;26;.963;3600000;0
9401;163989;72;0;0;0;0;.00nan;0;0
9401;179411;151;71;57;6;51;.895;2769000;0
9401;176060;151;25;19;5;14;.737;831000;0
9401;64811;72;62;25;3;22;.880;3600000;0
9402;178911;152;81;30;2;28;.933;3600000;0
9402;57207;152;0;0;0;0;.00nan;0;0
9402;59592;80;75;46;5;41;.891;3600000;0
9402;85009;80;0;0;0;0;.00nan;0;0
9403;170612;74;82;15;0;15;1.000;3600000;0
9403;176136;76;0;0;0;0;.00nan;0;0
9403;57215;74;0;0;0;0;.00nan;0;0
9403;78864;76;87;44;3;41;.932;3600000;0
9404;173856;75;0;0;0;0;.00nan;0;0
9404;171615;75;31;16;4;12;.750;3600000;0
9404;175423;77;91;46;3;43;.935;3600000;0
9404;180873;77;0;0;0;0;.00nan;0;0
9405;184049;1097;0;0;0;0;.00nan;0;0
9405;170598;4922;0;0;0;0;.00nan;0;0
9405;171730;1097;76;21;1;20;.952;3600000;0
9405;161046;4922;66;46;6;40;.870;3600000;0
9406;4487;4920;95;32;2;30;.938;3555000;0
9406;183859;4920;0;0;0;0;.00nan;0;0
9406;46790;71;76;24;1;23;.958;3600000;0
9406;78775;71;0;0;0;0;.00nan;0;0
9407;163462;85;19;20;6;14;.700;3020000;0
9407;170728;85;53;4;0;4;1.000;558000;0
9407;184398;78;0;0;0;0;.00nan;0;0
9407;179406;78;35;23;5;18;.783;3600000;0
9408;165611;81;69;16;1;15;.938;1541000;0
9408;184081;157;0;0;0;0;.00nan;0;0
9408;-1;157;51;36;5;31;.861;3600000;0
9408;176770;81;36;24;5;19;.792;2003000;0
9409;173918;4921;93;26;1;25;.962;3900000;0
9409;182049;4921;0;0;0;0;.00nan;0;0
9409;85633;2564;0;0;0;0;.00nan;0;0
9409;86151;2564;94;27;1;26;.963;3900000;0
9410;4487;4920;0;0;0;0;.00nan;0;0
9410;183859;4920;56;17;2;15;.882;3600000;0
9410;173823;73;0;0;0;0;.00nan;0;0
9410;170963;73;97;62;3;59;.952;3550000;0
9411;166545;1096;0;0;0;0;.00nan;0;0
9411;183775;1096;82;30;2;28;.933;3600000;0
9411;173874;158;60;34;4;30;.882;3550000;0
9411;91398;158;0;0;0;0;.00nan;0;0
9412;178911;152;0;0;0;0;.00nan;0;0
9412;57207;152;100;43;0;43;1.000;3600000;0
9412;59592;80;74;45;5;40;.889;3600000;0
9412;85009;80;0;0;0;0;.00nan;0;0
9413;173856;75;76;25;1;24;.960;3600000;0
9413;171615;75;0;0;0;0;.00nan;0;0
9413;175423;77;0;0;0;0;.00nan;0;0
9413;180873;77;78;37;2;35;.946;3551000;0
9414;169166;1095;37;37;7;30;.811;3755000;0
9414;46790;71;0;0;0;0;.00nan;0;0
9414;60773;1095;0;0;0;0;.00nan;0;0
9414;78775;71;32;30;6;24;.800;3771000;0
9415;165611;81;0;0;0;0;.00nan;0;0
9415;184081;157;65;30;4;26;.867;3600000;0
9415;-1;157;0;0;0;0;.00nan;0;0
9415;176770;81;60;42;5;37;.881;3600000;0
9416;173918;4921;42;9;2;7;.778;379000;0
9416;182049;4921;48;40;6;34;.850;3221000;0
9416;85633;2564;93;28;1;27;.964;3600000;0
9416;86151;2564;0;0;0;0;.00nan;0;0
9417;170598;4922;83;30;1;29;.967;3600000;0
9417;175423;77;0;0;0;0;.00nan;0;0
9417;180873;77;68;33;3;30;.909;3582000;0
9417;161046;4922;0;0;0;0;.00nan;0;0
9418;163989;72;70;30;3;27;.900;3900000;0
9418;173823;73;0;0;0;0;.00nan;0;0
9418;170963;73;82;41;3;38;.927;3900000;0
9418;64811;72;0;0;0;0;.00nan;0;0
9419;165611;81;0;0;0;0;.00nan;0;0
9419;176770;81;83;34;2;32;.941;3600000;0
9419;59592;80;85;36;3;33;.917;3600000;0
9419;85009;80;0;0;0;0;.00nan;0;0
9420;184158;4620;74;29;3;26;.897;3550000;0
9420;170612;74;89;26;1;25;.962;3600000;0
9420;181341;4620;0;0;0;0;.00nan;0;0
9420;57215;74;0;0;0;0;.00nan;0;0
9421;184049;1097;29;21;5;16;.762;3582000;0
9421;173874;158;0;0;0;0;.00nan;0;0
9421;171730;1097;0;0;0;0;.00nan;0;0
9421;91398;158;73;32;3;29;.906;3600000;0
9422;163989;4245;73;25;2;23;.920;3600000;0
9422;173918;4921;0;0;0;0;.00nan;0;0
9422;37857;4245;0;0;0;0;.00nan;0;0
9422;182049;4921;91;49;3;46;.939;3553000;0
9423;184081;157;55;32;4;28;.875;3581000;0
9423;-1;157;0;0;0;0;.00nan;0;0
9423;38209;149;89;35;2;33;.943;3600000;0
9423;86875;149;0;0;0;0;.00nan;0;0
9424;173823;73;0;0;0;0;.00nan;0;0
9424;173918;4921;74;38;3;35;.921;3547000;0
9424;170963;73;62;18;2;16;.889;3600000;0
9424;182049;4921;0;0;0;0;.00nan;0;0
9425;165611;81;0;0;0;0;.00nan;0;0
9425;176770;81;52;30;4;26;.867;3600000;0
9425;59592;80;43;33;5;28;.848;3600000;0
9425;85009;80;0;0;0;0;.00nan;0;0
9426;183755;69;80;43;4;39;.907;3705000;0
9426;57953;72;0;0;0;0;.00nan;0;0
9426;64811;72;62;29;3;26;.897;3705000;0
9426;161047;69;0;0;0;0;.00nan;0;0
9427;178911;152;0;0;0;0;.00nan;0;0
9427;179411;151;0;0;0;0;.00nan;0;0
9427;176060;151;88;40;3;37;.925;3600000;0
9427;57207;152;44;25;4;21;.840;3558000;0
9428;163462;85;90;48;2;46;.958;3600000;0
9428;170728;85;0;0;0;0;.00nan;0;0
9428;57695;2564;0;0;0;0;.00nan;0;0
9428;86151;2564;68;16;1;15;.938;3600000;0
9429;4487;4920;0;0;0;0;.00nan;0;0
9429;183859;4920;86;30;1;29;.967;3600000;0
9429;170612;74;0;0;0;0;.00nan;0;0
9429;57215;74;51;35;5;30;.857;3600000;0
9430;171970;82;61;41;5;36;.878;3600000;0
9430;173856;75;72;30;2;28;.933;3600000;0
9430;171615;75;0;0;0;0;.00nan;0;0
9430;85050;82;0;0;0;0;.00nan;0;0
9431;184049;1097;78;43;4;39;.907;3549000;0
9431;173874;158;0;0;0;0;.00nan;0;0
9431;171730;1097;0;0;0;0;.00nan;0;0
9431;91398;158;70;36;3;33;.917;3600000;0
9432;163989;4245;79;36;2;34;.944;3600000;0
9432;184158;4620;58;38;5;33;.868;3600000;0
9432;181341;4620;0;0;0;0;.00nan;0;0
9432;37857;4245;0;0;0;0;.00nan;0;0
9433;170598;4922;94;34;1;33;.971;3600000;0
9433;176136;76;56;26;3;23;.885;3557000;0
9433;78864;76;0;0;0;0;.00nan;0;0
9433;161046;4922;0;0;0;0;.00nan;0;0
9434;169166;1095;96;47;3;44;.936;3537000;0
9434;176200;1095;0;0;0;0;.00nan;0;0
9434;46790;71;0;0;0;0;.00nan;0;0
9434;78775;71;73;21;1;20;.952;3600000;0
9435;166545;1096;0;0;0;0;.00nan;0;0
9435;183775;1096;57;27;3;24;.889;3554000;0
9435;175423;77;0;0;0;0;.00nan;0;0
9435;180873;77;93;36;1;35;.972;3600000;0
9436;173823;73;57;45;5;40;.889;3600000;0
9436;170963;73;0;0;0;0;.00nan;0;0
9436;57953;72;100;31;0;31;1.000;3600000;0
9436;64811;72;0;0;0;0;.00nan;0;0
9437;169166;1095;0;0;0;0;.00nan;0;0
9437;173918;4921;0;0;0;0;.00nan;0;0
9437;176200;1095;72;36;3;33;.917;3600000;0
9437;182049;4921;60;35;4;31;.886;3580000;0
9438;165611;81;65;41;5;36;.878;3600000;0
9438;176770;81;0;0;0;0;.00nan;0;0
9438;59592;80;68;18;1;17;.944;3600000;0
9438;85009;80;0;0;0;0;.00nan;0;0
9439;173856;75;0;0;0;0;.00nan;0;0
9439;170598;4922;0;0;0;0;.00nan;0;0
9439;171615;75;37;22;4;18;.818;3579000;0
9439;161046;4922;77;33;2;31;.939;3600000;0
9440;163462;85;83;25;1;24;.960;3600000;0
9440;170728;85;0;0;0;0;.00nan;0;0
9440;57695;2564;0;0;0;0;.00nan;0;0
9440;86151;2564;56;31;4;27;.871;3600000;0
9441;4487;4920;78;24;1;23;.958;3600000;0
9441;183859;4920;0;0;0;0;.00nan;0;0
9441;170612;74;51;33;4;29;.879;3600000;0
9441;57215;74;0;0;0;0;.00nan;0;0
9442;184049;1097;0;0;0;0;.00nan;0;0
9442;173874;158;87;34;2;32;.941;3600000;0
9442;171730;1097;35;28;5;23;.821;3600000;0
9442;91398;158;0;0;0;0;.00nan;0;0
9443;163989;4245;74;50;5;45;.900;3688000;0
9443;184158;4620;35;26;6;20;.769;3688000;0
9443;181341;4620;0;0;0;0;.00nan;0;0
9443;37857;4245;0;0;0;0;.00nan;0;0
9444;171970;82;0;0;0;0;.00nan;0;0
9444;176136;76;0;0;0;0;.00nan;0;0
9444;78864;76;71;33;3;30;.909;3564000;0
9444;85050;82;71;26;2;24;.923;3600000;0
9445;183755;69;70;46;4;42;.913;3728000;0
9445;46790;71;70;47;5;42;.894;3728000;0
9445;78775;71;0;0;0;0;.00nan;0;0
9445;161047;69;0;0;0;0;.00nan;0;0
9446;184081;157;0;0;0;0;.00nan;0;0
9446;178911;152;100;54;1;53;.981;3600000;0
9446;-1;157;50;17;2;15;.882;3556000;0
9446;57207;152;0;0;0;0;.00nan;0;0
9447;179411;151;0;0;0;0;.00nan;0;0
9447;176060;151;45;28;4;24;.857;3600000;0
9447;38209;149;0;0;0;0;.00nan;0;0
9447;86875;149;85;29;1;28;.966;3600000;0
9448;-1;67;45;41;6;35;.854;3600000;0
9448;169096;67;0;0;0;0;.00nan;0;0
9448;184398;78;98;21;0;21;1.000;3600000;0
9448;179406;78;0;0;0;0;.00nan;0;0
9449;179411;151;85;32;2;30;.938;3900000;0
9449;176060;151;0;0;0;0;.00nan;0;0
9449;38209;149;83;30;2;28;.933;3900000;0
9449;86875;149;0;0;0;0;.00nan;0;0
9450;166545;1096;53;36;5;31;.861;3559000;0
9450;183775;1096;0;0;0;0;.00nan;0;0
9450;175423;77;57;35;4;31;.886;3600000;0
9450;180873;77;0;0;0;0;.00nan;0;0
9451;169166;1095;0;0;0;0;.00nan;0;0
9451;176200;1095;81;30;1;29;.967;3600000;0
9451;57953;72;58;22;2;20;.909;3600000;0
9451;64811;72;0;0;0;0;.00nan;0;0
9452;173856;75;68;22;1;21;.955;3600000;0
9452;170598;4922;37;27;5;22;.815;3600000;0
9452;171615;75;0;0;0;0;.00nan;0;0
9452;161046;4922;0;0;0;0;.00nan;0;0
9453;163462;85;84;28;2;26;.929;3900000;0
9453;170728;85;0;0;0;0;.00nan;0;0
9453;57695;2564;97;46;2;44;.957;3900000;0
9453;86151;2564;0;0;0;0;.00nan;0;0
9454;171970;82;86;35;2;33;.943;3600000;0
9454;176136;76;48;22;3;19;.864;3547000;0
9454;78864;76;0;0;0;0;.00nan;0;0
9454;85050;82;0;0;0;0;.00nan;0;0
9455;183755;69;0;0;0;0;.00nan;0;0
9455;46790;71;0;0;0;0;.00nan;0;0
9455;78775;71;93;42;2;40;.952;3600000;0
9455;161047;69;55;29;4;25;.862;3549000;0
9456;184081;157;91;32;1;31;.969;3600000;0
9456;178911;152;54;6;1;5;.833;307000;0
9456;-1;157;0;0;0;0;.00nan;0;0
9456;57207;152;43;21;4;17;.810;3293000;0
9457;173823;73;0;0;0;0;.00nan;0;0
9457;173918;4921;95;31;1;30;.968;3600000;0
9457;170963;73;61;32;4;28;.875;3600000;0
9457;182049;4921;0;0;0;0;.00nan;0;0
9458;-1;67;0;0;0;0;.00nan;0;0
9458;169096;67;91;30;1;29;.967;3549000;0
9458;184398;78;98;25;0;25;1.000;3600000;0
9458;179406;78;0;0;0;0;.00nan;0;0
9459;4487;4920;0;0;0;0;.00nan;0;0
9459;183859;4920;69;17;1;16;.941;3600000;0
9459;-1;67;65;49;6;43;.878;3600000;0
9459;169096;67;0;0;0;0;.00nan;0;0
9460;171970;82;0;0;0;0;.00nan;0;0
9460;170598;4922;0;0;0;0;.00nan;0;0
9460;85050;82;63;17;1;16;.941;3600000;0
9460;161046;4922;73;32;2;30;.938;3558000;0
9461;163989;4245;56;24;3;21;.875;3550000;0
9461;-1;74;0;0;0;0;.00nan;0;0
9461;37857;4245;0;0;0;0;.00nan;0;0
9461;57215;74;71;25;2;23;.920;3600000;0
9462;184158;4620;67;20;1;19;.950;3600000;0
9462;184398;78;73;34;3;31;.912;3527000;0
9462;179406;78;0;0;0;0;.00nan;0;0
9462;181341;4620;0;0;0;0;.00nan;0;0
9463;184081;157;0;0;0;0;.00nan;0;0
9463;179411;151;0;0;0;0;.00nan;0;0
9463;176060;151;82;44;4;40;.909;3900000;0
9463;38276;157;84;42;4;38;.905;3900000;0
9464;178911;152;76;33;3;30;.909;3600000;0
9464;38209;149;0;0;0;0;.00nan;0;0
9464;57207;152;0;0;0;0;.00nan;0;0
9464;86875;149;70;50;5;45;.900;3595000;0
9465;171970;82;53;26;3;23;.885;3575000;0
9465;173856;75;68;24;2;22;.917;3600000;0
9465;171615;75;0;0;0;0;.00nan;0;0
9465;85050;82;0;0;0;0;.00nan;0;0
9466;169166;1095;0;0;0;0;.00nan;0;0
9466;173918;4921;0;0;0;0;.00nan;0;0
9466;176200;1095;57;26;3;23;.885;3600000;0
9466;182049;4921;90;44;4;40;.909;3557000;0
9467;57695;2564;0;0;0;0;.00nan;0;0
9467;57953;72;0;0;0;0;.00nan;0;0
9467;64811;72;45;29;5;24;.828;3600000;0
9467;86151;2564;99;39;1;38;.974;3600000;0
9468;4487;4920;0;0;0;0;.00nan;0;0
9468;183859;4920;99;28;1;27;.964;3600000;0
9468;184158;4620;75;49;5;44;.898;3600000;0
9468;181341;4620;0;0;0;0;.00nan;0;0
9469;163462;85;0;0;0;0;.00nan;0;0
9469;165611;81;0;0;0;0;.00nan;0;0
9469;176770;81;71;29;3;26;.897;3600000;0
9469;176860;85;100;38;0;38;1.000;3600000;0
9470;163989;4245;78;30;3;27;.900;3900000;0
9470;-1;74;0;0;0;0;.00nan;0;0
9470;37857;4245;0;0;0;0;.00nan;0;0
9470;57215;74;82;39;3;36;.923;3900000;0
9471;166545;1096;0;0;0;0;.00nan;0;0
9471;183775;1096;66;26;3;23;.885;3900000;0
9471;184049;1097;56;26;3;23;.885;3900000;0
9471;171730;1097;0;0;0;0;.00nan;0;0
9472;175423;77;0;0;0;0;.00nan;0;0
9472;176136;76;63;30;3;27;.900;3545000;0
9472;180873;77;95;37;1;36;.973;3600000;0
9472;78864;76;0;0;0;0;.00nan;0;0
9473;173823;73;0;0;0;0;.00nan;0;0
9473;170963;73;76;30;2;28;.933;3548000;0
9473;46790;71;0;0;0;0;.00nan;0;0
9473;78775;71;99;35;1;34;.971;3600000;0
9474;-1;67;0;0;0;0;.00nan;0;0
9474;169096;67;58;27;3;24;.889;3597000;0
9474;184398;78;94;45;2;43;.956;3600000;0
9474;179406;78;0;0;0;0;.00nan;0;0
9475;173874;158;0;0;0;0;.00nan;0;0
9475;59592;80;66;27;3;24;.889;3600000;0
9475;85009;80;0;0;0;0;.00nan;0;0
9475;91398;158;32;34;6;28;.824;3600000;0
9476;183755;69;71;26;2;24;.923;3600000;0
9476;179411;151;0;0;0;0;.00nan;0;0
9476;176060;151;67;35;4;31;.886;3594000;0
9476;161047;69;0;0;0;0;.00nan;0;0
9477;4487;4920;0;0;0;0;.00nan;0;0
9477;183859;4920;54;37;5;32;.865;3600000;0
9477;184158;4620;0;0;0;0;.00nan;0;0
9477;181341;4620;86;35;2;33;.943;3600000;0
9478;178911;152;0;0;0;0;.00nan;0;0
9478;38209;149;71;49;4;45;.918;3826000;0
9478;57207;152;62;35;5;30;.857;3826000;0
9478;86875;149;0;0;0;0;.00nan;0;0
9479;171970;82;16;20;6;14;.700;2502000;0
9479;173856;75;0;0;0;0;.00nan;0;0
9479;171615;75;48;27;4;23;.852;3600000;0
9479;85050;82;39;23;4;19;.826;1098000;0
9480;169166;1095;0;0;0;0;.00nan;0;0
9480;173918;4921;69;26;2;24;.923;3900000;0
9480;176200;1095;64;25;2;23;.920;3900000;0
9480;78864;4921;0;0;0;0;.00nan;0;0
9481;163462;85;0;0;0;0;.00nan;0;0
9481;165611;81;39;38;7;31;.816;3600000;0
9481;176770;81;0;0;0;0;.00nan;0;0
9481;176860;85;81;30;2;28;.933;3600000;0
9482;163989;4245;67;21;1;20;.952;3600000;0
9482;-1;74;0;0;0;0;.00nan;0;0
9482;37857;4245;0;0;0;0;.00nan;0;0
9482;57215;74;64;44;5;39;.886;3600000;0
9483;184049;1097;0;0;0;0;.00nan;0;0
9483;189581;76;0;0;0;0;.00nan;0;0
9483;171730;1097;41;36;6;30;.833;3600000;0
9483;176136;76;84;34;2;32;.941;3600000;0
9484;57695;2564;61;36;4;32;.889;3900000;0
9484;75051;71;0;0;0;0;.00nan;0;0
9484;78775;71;82;36;4;32;.889;3900000;0
9484;86151;2564;0;0;0;0;.00nan;0;0
9485;169096;67;46;20;3;17;.850;3600000;0
9485;179406;78;48;35;5;30;.857;3560000;0
9485;182049;67;0;0;0;0;.00nan;0;0
9485;46790;78;0;0;0;0;.00nan;0;0
9486;173874;158;47;36;5;31;.861;3580000;0
9486;59592;80;67;29;3;26;.897;3600000;0
9486;85009;80;0;0;0;0;.00nan;0;0
9486;91398;158;0;0;0;0;.00nan;0;0
9487;183755;69;69;33;3;30;.909;3600000;0
9487;179411;151;32;32;6;26;.813;2793000;0
9487;176060;151;63;8;0;8;1.000;807000;0
9487;161047;69;0;0;0;0;.00nan;0;0
9488;184081;157;0;0;0;0;.00nan;0;0
9488;38209;149;0;0;0;0;.00nan;0;0
9488;38276;157;20;23;6;17;.739;3547000;0
9488;86875;149;77;44;5;39;.886;3600000;0
9489;189581;76;0;0;0;0;.00nan;0;0
9489;175423;77;0;0;0;0;.00nan;0;0
9489;176136;76;70;29;2;27;.931;3545000;0
9489;180873;77;97;40;1;39;.975;3600000;0
9490;169166;1095;46;24;4;20;.833;2449000;0
9490;176200;1095;26;16;4;12;.750;1151000;0
9490;57953;72;0;0;0;0;.00nan;0;0
9490;64811;72;86;35;2;33;.943;3600000;0
9491;57695;2564;0;0;0;0;.00nan;0;0
9491;75051;71;93;47;3;44;.936;3600000;0
9491;78775;71;0;0;0;0;.00nan;0;0
9491;86151;2564;83;29;2;27;.931;3600000;0
9492;163462;85;0;0;0;0;.00nan;0;0
9492;165611;81;0;0;0;0;.00nan;0;0
9492;176770;81;76;38;3;35;.921;3900000;0
9492;176860;85;61;26;3;23;.885;3900000;0
9493;173856;75;72;30;3;27;.900;3569000;0
9493;170598;4922;0;0;0;0;.00nan;0;0
9493;171615;75;0;0;0;0;.00nan;0;0
9493;161046;4922;99;30;1;29;.967;3600000;0
9494;178911;152;70;40;4;36;.900;3600000;0
9494;179411;151;74;28;3;25;.893;3016000;0
9494;176060;151;32;10;3;7;.700;501000;0
9494;57207;152;0;0;0;0;.00nan;0;0
9495;173874;158;0;0;0;0;.00nan;0;0
9495;59592;80;76;30;2;28;.933;3900000;0
9495;85009;80;0;0;0;0;.00nan;0;0
9495;91398;158;92;38;2;36;.947;3900000;0
9496;183755;69;77;17;1;16;.941;3600000;0
9496;184398;4921;36;54;9;45;.833;3600000;0
9496;78864;4921;0;0;0;0;.00nan;0;0
9496;161047;69;0;0;0;0;.00nan;0;0
9497;189581;76;42;3;1;2;.667;350000;0
9497;176136;76;45;38;6;32;.842;3250000;0
9497;75051;71;0;0;0;0;.00nan;0;0
9497;78775;71;71;36;4;32;.889;3600000;0
9498;165611;81;0;0;0;0;.00nan;0;0
9498;179406;78;0;0;0;0;.00nan;0;0
9498;176770;81;83;32;2;30;.938;3805000;0
9498;46790;78;75;33;3;30;.909;3805000;0
9499;184081;157;0;0;0;0;.00nan;0;0
9499;179411;151;0;0;0;0;.00nan;0;0
9499;176060;151;98;45;3;42;.933;3600000;0
9499;38276;157;73;23;2;21;.913;3600000;0
9500;163989;4245;78;24;1;23;.958;3600000;0
9500;169096;67;0;0;0;0;.00nan;0;0
9500;37857;4245;0;0;0;0;.00nan;0;0
9500;182049;67;77;30;2;28;.933;3560000;0
9501;169166;1095;0;0;0;0;.00nan;0;0
9501;173823;73;0;0;0;0;.00nan;0;0
9501;170963;73;67;32;3;29;.906;3600000;0
9501;176200;1095;30;32;6;26;.813;3600000;0
9502;166545;1096;0;0;0;0;.00nan;0;0
9502;183775;1096;59;24;3;21;.875;3600000;0
9502;75051;71;0;0;0;0;.00nan;0;0
9502;78775;71;91;33;1;32;.970;3600000;0
9503;184081;157;74;25;2;23;.920;3900000;0
9503;38276;157;0;0;0;0;.00nan;0;0
9503;57953;72;0;0;0;0;.00nan;0;0
9503;64811;72;93;39;2;37;.949;3900000;0
9504;183755;69;55;26;4;22;.846;3600000;0
9504;184398;4921;22;11;4;7;.636;730000;0
9504;78864;4921;67;32;4;28;.875;2870000;0
9504;161047;69;0;0;0;0;.00nan;0;0
9505;171970;82;53;25;3;22;.880;3535000;0
9505;170598;4922;100;43;1;42;.977;3600000;0
9505;85050;82;0;0;0;0;.00nan;0;0
9505;161046;4922;0;0;0;0;.00nan;0;0
9506;189628;149;0;0;0;0;.00nan;0;0
9506;38209;149;74;33;3;30;.909;3594000;0
9506;57695;2564;0;0;0;0;.00nan;0;0
9506;86151;2564;95;39;2;37;.949;3600000;0
9507;173874;158;0;0;0;0;.00nan;0;0
9507;178911;152;64;43;4;39;.907;3600000;0
9507;57207;152;0;0;0;0;.00nan;0;0
9507;91398;158;57;16;2;14;.875;3600000;0
9508;4487;4920;0;0;0;0;.00nan;0;0
9508;183859;4920;98;31;1;30;.968;3600000;0
9508;184158;4620;45;28;4;24;.857;3600000;0
9508;181341;4620;0;0;0;0;.00nan;0;0
9509;184049;1097;96;32;1;31;.969;3600000;0
9509;171730;1097;0;0;0;0;.00nan;0;0
9509;175423;77;0;0;0;0;.00nan;0;0
9509;180873;77;66;28;2;26;.929;3541000;0
9510;189581;76;93;51;3;48;.941;3900000;0
9510;173856;75;79;39;3;36;.923;3900000;0
9510;176136;76;0;0;0;0;.00nan;0;0
9510;91225;75;0;0;0;0;.00nan;0;0
9511;165611;81;0;0;0;0;.00nan;0;0
9511;179406;78;0;0;0;0;.00nan;0;0
9511;176770;81;57;37;5;32;.865;3589000;0
9511;46790;78;60;28;3;25;.893;3600000;0
9512;-1;74;0;0;0;0;.00nan;0;0
9512;57215;74;80;33;3;30;.909;3600000;0
9512;59592;80;74;30;2;28;.933;3600000;0
9512;85009;80;0;0;0;0;.00nan;0;0
9513;163989;4245;64;29;3;26;.897;3900000;0
9513;169096;67;0;0;0;0;.00nan;0;0
9513;37857;4245;0;0;0;0;.00nan;0;0
9513;182049;67;70;36;3;33;.917;3900000;0
9514;169166;1095;0;0;0;0;.00nan;0;0
9514;173823;73;74;42;4;38;.905;3573000;0
9514;170963;73;0;0;0;0;.00nan;0;0
9514;176200;1095;73;25;2;23;.920;3600000;0
9515;166545;1096;70;34;3;31;.912;3600000;0
9515;183775;1096;0;0;0;0;.00nan;0;0
9515;75051;71;54;33;5;28;.848;3537000;0
9515;78775;71;0;0;0;0;.00nan;0;0
9516;184081;157;0;0;0;0;.00nan;0;0
9516;38276;157;77;31;3;28;.903;3900000;0
9516;57953;72;88;35;3;32;.914;3900000;0
9516;64811;72;0;0;0;0;.00nan;0;0
9517;183755;69;0;0;0;0;.00nan;0;0
9517;184398;4921;75;32;2;30;.938;3600000;0
9517;78864;4921;0;0;0;0;.00nan;0;0
9517;161047;69;68;33;3;30;.909;3570000;0
9518;189581;76;0;0;0;0;.00nan;0;0
9518;170598;4922;0;0;0;0;.00nan;0;0
9518;176136;76;72;44;4;40;.909;3542000;0
9518;161046;4922;99;39;2;37;.949;3600000;0
9519;189628;149;63;27;3;24;.889;3900000;0
9519;38209;149;0;0;0;0;.00nan;0;0
9519;57695;2564;64;28;3;25;.893;3900000;0
9519;86151;2564;0;0;0;0;.00nan;0;0
9520;173874;158;40;30;5;25;.833;3600000;0
9520;178911;152;0;0;0;0;.00nan;0;0
9520;57207;152;90;35;1;34;.971;3600000;0
9520;91398;158;0;0;0;0;.00nan;0;0
9521;4487;4920;0;0;0;0;.00nan;0;0
9521;163989;4245;93;32;2;30;.938;3600000;0
9521;183859;4920;50;32;5;27;.844;3600000;0
9521;37857;4245;0;0;0;0;.00nan;0;0
9522;171970;82;0;0;0;0;.00nan;0;0
9522;173856;75;0;0;0;0;.00nan;0;0
9522;85050;82;100;52;2;50;.962;3900000;0
9522;91225;75;60;21;2;19;.905;3900000;0
9523;184049;1097;0;0;0;0;.00nan;0;0
9523;171730;1097;68;38;3;35;.921;3558000;0
9523;175423;77;86;38;2;36;.947;3600000;0
9523;180873;77;0;0;0;0;.00nan;0;0
9524;165611;81;62;26;2;24;.923;3546000;0
9524;179406;78;0;0;0;0;.00nan;0;0
9524;176770;81;0;0;0;0;.00nan;0;0
9524;46790;78;88;33;1;32;.970;3600000;0
9525;-1;74;0;0;0;0;.00nan;0;0
9525;57215;74;100;25;0;25;1.000;3600000;0
9525;59592;80;78;20;1;19;.950;3558000;0
9525;85009;80;0;0;0;0;.00nan;0;0
9526;169096;67;0;0;0;0;.00nan;0;0
9526;184158;4620;84;24;1;23;.958;3900000;0
9526;181341;4620;0;0;0;0;.00nan;0;0
9526;182049;67;96;38;1;37;.974;3900000;0
9527;175423;77;0;0;0;0;.00nan;0;0
9527;180873;77;68;42;4;38;.905;3600000;0
9527;75051;71;0;0;0;0;.00nan;0;0
9527;78775;71;59;11;1;10;.909;3600000;0
9528;173823;73;53;5;0;5;1.000;680000;0
9528;170963;73;30;29;6;23;.793;2897000;0
9528;57953;72;0;0;0;0;.00nan;0;0
9528;64811;72;56;36;5;31;.861;3600000;0
9529;166545;1096;57;23;2;21;.913;2457000;0
9529;183775;1096;37;18;4;14;.778;1087000;0
9529;170598;4922;49;30;5;25;.833;3600000;0
9529;161046;4922;0;0;0;0;.00nan;0;0
9530;189628;149;55;5;0;5;1.000;387000;0
9530;38209;149;34;36;6;30;.833;3213000;0
9530;57695;2564;0;0;0;0;.00nan;0;0
9530;85633;2564;88;36;2;34;.944;3600000;0
9531;4487;4920;0;0;0;0;.00nan;0;0
9531;163989;4245;73;29;1;28;.966;3600000;0
9531;183859;4920;62;36;4;32;.889;3600000;0
9531;37857;4245;0;0;0;0;.00nan;0;0
9532;171970;82;99;39;1;38;.974;3600000;0
9532;173856;75;55;30;3;27;.900;3538000;0
9532;85050;82;0;0;0;0;.00nan;0;0
9532;91225;75;0;0;0;0;.00nan;0;0
9533;184049;1097;100;39;2;37;.949;3600000;0
9533;189581;76;0;0;0;0;.00nan;0;0
9533;171730;1097;0;0;0;0;.00nan;0;0
9533;176136;76;72;38;3;35;.921;3551000;0
9534;-1;74;0;0;0;0;.00nan;0;0
9534;57215;74;68;21;3;18;.857;3600000;0
9534;59592;80;53;26;4;22;.846;3548000;0
9534;85009;80;0;0;0;0;.00nan;0;0
9535;184398;4921;28;16;4;12;.750;1128000;0
9535;57953;72;0;0;0;0;.00nan;0;0
9535;64811;72;74;21;2;19;.905;3600000;0
9535;78864;4921;50;28;3;25;.893;2472000;0
9536;169096;67;0;0;0;0;.00nan;0;0
9536;184158;4620;68;43;5;38;.884;3600000;0
9536;181341;4620;0;0;0;0;.00nan;0;0
9536;182049;67;57;18;2;16;.889;3600000;0
9537;178911;152;81;30;3;27;.900;3900000;0
9537;38209;149;0;0;0;0;.00nan;0;0
9537;57207;152;0;0;0;0;.00nan;0;0
9537;85546;149;89;48;3;45;.938;3900000;0
9538;173823;73;0;0;0;0;.00nan;0;0
9538;170963;73;77;41;4;37;.902;3537000;0
9538;75051;71;0;0;0;0;.00nan;0;0
9538;78775;71;61;25;3;22;.880;3600000;0
9539;171970;82;0;0;0;0;.00nan;0;0
9539;184049;1097;77;39;3;36;.923;3600000;0
9539;171730;1097;0;0;0;0;.00nan;0;0
9539;85050;82;40;27;5;22;.815;3575000;0
9540;176200;1095;79;21;1;20;.952;3600000;0
9540;57695;2564;0;0;0;0;.00nan;0;0
9540;60773;1095;0;0;0;0;.00nan;0;0
9540;85633;2564;68;30;3;27;.900;3552000;0
9541;165611;81;86;50;4;46;.920;3545000;0
9541;184081;157;0;0;0;0;.00nan;0;0
9541;176770;81;0;0;0;0;.00nan;0;0
9541;38276;157;46;16;3;13;.813;3600000;0
9542;170598;4922;66;32;4;28;.875;3638000;0
9542;179406;78;0;0;0;0;.00nan;0;0
9542;46790;78;78;38;3;35;.921;3638000;0
9542;161046;4922;0;0;0;0;.00nan;0;0
9543;184158;4620;79;40;3;37;.925;3600000;0
9543;-1;74;0;0;0;0;.00nan;0;0
9543;181341;4620;0;0;0;0;.00nan;0;0
9543;57215;74;66;33;4;29;.879;3565000;0
9544;178911;152;0;0;0;0;.00nan;0;0
9544;38209;149;0;0;0;0;.00nan;0;0
9544;57207;152;100;41;1;40;.976;3600000;0
9544;85546;149;86;31;2;29;.935;3545000;0
9545;179406;78;0;0;0;0;.00nan;0;0
9545;175423;77;0;0;0;0;.00nan;0;0
9545;180873;77;86;26;1;25;.962;3900000;0
9545;46790;78;96;38;1;37;.974;3900000;0
9546;171970;82;19;21;6;15;.714;2182000;0
9546;184049;1097;84;42;4;38;.905;3600000;0
9546;171730;1097;0;0;0;0;.00nan;0;0
9546;85050;82;59;18;2;16;.889;1418000;0
9547;165611;81;82;48;3;45;.938;3600000;0
9547;184081;157;0;0;0;0;.00nan;0;0
9547;176770;81;0;0;0;0;.00nan;0;0
9547;38276;157;63;33;4;29;.879;3573000;0
9548;173823;73;0;0;0;0;.00nan;0;0
9548;170963;73;98;50;3;47;.940;3565000;0
9548;57953;72;0;0;0;0;.00nan;0;0
9548;64811;72;68;24;2;22;.917;3600000;0
9549;183755;69;70;29;3;26;.897;3900000;0
9549;179411;151;0;0;0;0;.00nan;0;0
9549;176060;151;83;41;3;38;.927;3900000;0
9549;161047;69;0;0;0;0;.00nan;0;0
9550;166545;1096;0;0;0;0;.00nan;0;0
9550;183775;1096;78;25;1;24;.960;3600000;0
9550;170598;4922;50;44;5;39;.886;3600000;0
9550;161046;4922;0;0;0;0;.00nan;0;0
9551;4487;4920;0;0;0;0;.00nan;0;0
9551;163462;85;0;0;0;0;.00nan;0;0
9551;183859;4920;75;22;1;21;.955;3600000;0
9551;176860;85;84;43;4;39;.907;3600000;0
9552;173874;158;0;0;0;0;.00nan;0;0
9552;59592;80;82;36;2;34;.944;3543000;0
9552;85009;80;0;0;0;0;.00nan;0;0
9552;91398;158;78;23;1;22;.957;3600000;0
9553;163989;4245;45;32;6;26;.813;3074000;0
9553;169096;67;0;0;0;0;.00nan;0;0
9553;37857;4245;58;5;0;5;1.000;526000;0
9553;182049;67;75;31;2;29;.935;3600000;0
9554;189581;76;0;0;0;0;.00nan;0;0
9554;173856;75;0;0;0;0;.00nan;0;0
9554;176136;76;96;37;2;35;.946;3900000;0
9554;91225;75;78;27;2;25;.926;3900000;0
9555;176200;1095;71;20;1;19;.950;3600000;0
9555;60773;1095;0;0;0;0;.00nan;0;0
9555;75051;71;0;0;0;0;.00nan;0;0
9555;78775;71;100;38;0;38;1.000;3600000;0
9556;173918;4921;0;0;0;0;.00nan;0;0
9556;57695;2564;0;0;0;0;.00nan;0;0
9556;78864;4921;31;26;5;21;.808;3579000;0
9556;85633;2564;71;31;3;28;.903;3600000;0
9557;184158;4620;76;20;1;19;.950;3600000;0
9557;-1;74;0;0;0;0;.00nan;0;0
9557;181341;4620;0;0;0;0;.00nan;0;0
9557;57215;74;69;30;3;27;.900;3536000;0
9558;178911;152;40;26;5;21;.808;3600000;0
9558;38209;149;0;0;0;0;.00nan;0;0
9558;57207;152;0;0;0;0;.00nan;0;0
9558;85546;149;37;43;8;35;.814;3600000;0
9559;173856;75;49;31;4;27;.871;3600000;0
9559;175423;77;96;28;1;27;.964;3600000;0
9559;180873;77;0;0;0;0;.00nan;0;0
9559;91225;75;0;0;0;0;.00nan;0;0
9560;173823;73;80;28;2;26;.929;3600000;0
9560;170963;73;0;0;0;0;.00nan;0;0
9560;57695;2564;67;35;3;32;.914;3545000;0
9560;85633;2564;0;0;0;0;.00nan;0;0
9561;171970;82;0;0;0;0;.00nan;0;0
9561;184049;1097;70;16;0;16;1.000;2734000;0
9561;171730;1097;27;13;4;9;.692;866000;0
9561;85050;82;93;33;1;32;.970;3600000;0
9562;165611;81;0;0;0;0;.00nan;0;0
9562;184081;157;91;28;1;27;.964;3600000;0
9562;176770;81;98;46;2;44;.957;3574000;0
9562;38276;157;0;0;0;0;.00nan;0;0
9563;57953;72;50;36;5;31;.861;3600000;0
9563;64811;72;0;0;0;0;.00nan;0;0
9563;75051;71;0;0;0;0;.00nan;0;0
9563;78775;71;79;29;2;27;.931;3600000;0
9564;183755;69;0;0;0;0;.00nan;0;0
9564;179411;151;59;35;4;31;.886;3544000;0
9564;176060;151;0;0;0;0;.00nan;0;0
9564;161047;69;59;24;3;21;.875;3600000;0
9565;166545;1096;68;23;2;21;.913;3900000;0
9565;183775;1096;0;0;0;0;.00nan;0;0
9565;170598;4922;0;0;0;0;.00nan;0;0
9565;161046;4922;71;29;2;27;.931;3900000;0
9566;4487;4920;0;0;0;0;.00nan;0;0
9566;163462;85;0;0;0;0;.00nan;0;0
9566;183859;4920;84;18;1;17;.944;3600000;0
9566;176860;85;90;36;2;34;.944;3564000;0
9567;173874;158;91;36;2;34;.944;3900000;0
9567;59592;80;67;25;2;23;.920;3873000;0
9567;85009;80;0;0;0;0;.00nan;0;0
9567;91398;158;0;0;0;0;.00nan;0;0
9568;163989;4245;45;23;4;19;.826;3600000;0
9568;169096;67;0;0;0;0;.00nan;0;0
9568;37857;4245;0;0;0;0;.00nan;0;0
9568;182049;67;70;39;5;34;.872;3600000;0
9569;189581;76;25;6;3;3;.500;293000;0
9569;179406;78;0;0;0;0;.00nan;0;0
9569;176136;76;69;23;2;21;.913;3307000;0
9569;46790;78;100;24;0;24;1.000;3600000;0
9570;173918;4921;0;0;0;0;.00nan;0;0
9570;176200;1095;75;30;2;28;.933;3600000;0
9570;60773;1095;0;0;0;0;.00nan;0;0
9570;78864;4921;69;36;3;33;.917;3600000;0
9571;184158;4620;0;0;0;0;.00nan;0;0
9571;-1;74;0;0;0;0;.00nan;0;0
9571;181341;4620;100;26;0;26;1.000;3600000;0
9571;57215;74;46;45;6;39;.867;3600000;0
9572;57695;2564;97;28;0;28;1.000;1962000;0
9572;57953;72;0;0;0;0;.00nan;0;0
9572;64811;72;53;18;3;15;.833;3600000;0
9572;85633;2564;25;19;5;14;.737;1638000;0
9573;183755;69;54;22;3;19;.864;3600000;0
9573;179411;151;0;0;0;0;.00nan;0;0
9573;176060;151;84;47;4;43;.915;3574000;0
9573;161047;69;0;0;0;0;.00nan;0;0
9574;4487;4920;0;0;0;0;.00nan;0;0
9574;163462;85;0;0;0;0;.00nan;0;0
9574;183859;4920;60;25;3;22;.880;3654000;0
9574;176860;85;92;45;4;41;.911;3654000;0
9575;173874;158;0;0;0;0;.00nan;0;0
9575;59592;80;0;0;0;0;.00nan;0;0
9575;85009;80;92;37;2;35;.946;3600000;0
9575;91398;158;70;35;3;32;.914;3551000;0
9576;163989;4245;30;26;6;20;.769;3600000;0
9576;169096;67;0;0;0;0;.00nan;0;0
9576;37857;4245;0;0;0;0;.00nan;0;0
9576;182049;67;47;40;7;33;.825;3600000;0
9577;189581;76;47;7;1;6;.857;1188000;0
9577;179406;78;0;0;0;0;.00nan;0;0
9577;176136;76;38;33;6;27;.818;2412000;0
9577;46790;78;88;40;3;37;.925;3600000;0
9578;173823;73;0;0;0;0;.00nan;0;0
9578;173918;4921;54;6;0;6;1.000;587000;0
9578;170963;73;81;13;0;13;1.000;3600000;0
9578;78864;4921;55;44;6;38;.864;3013000;0
9579;57953;72;0;0;0;0;.00nan;0;0
9579;64811;72;63;22;2;20;.909;3900000;0
9579;75051;71;0;0;0;0;.00nan;0;0
9579;78775;71;97;49;2;47;.959;3900000;0
9580;183755;69;91;34;1;33;.971;3600000;0
9580;178911;152;72;31;2;29;.935;3545000;0
9580;57207;152;0;0;0;0;.00nan;0;0
9580;161047;69;0;0;0;0;.00nan;0;0
9581;173874;158;0;0;0;0;.00nan;0;0
9581;38209;149;0;0;0;0;.00nan;0;0
9581;85546;149;56;20;3;17;.850;3548000;0
9581;91398;158;96;38;2;36;.947;3600000;0
9582;163989;4245;60;26;3;23;.885;3600000;0
9582;179406;78;51;2;0;2;1.000;504000;0
9582;37857;4245;0;0;0;0;.00nan;0;0
9582;46790;78;65;53;6;47;.887;3096000;0
9583;165611;81;0;0;0;0;.00nan;0;0
9583;176770;81;54;51;7;44;.863;3600000;0
9583;59592;80;59;32;3;29;.906;3600000;0
9583;85009;80;0;0;0;0;.00nan;0;0
9584;163462;85;0;0;0;0;.00nan;0;0
9584;169096;67;0;0;0;0;.00nan;0;0
9584;176860;85;89;45;3;42;.933;3900000;0
9584;182049;67;56;22;3;19;.864;3900000;0
9585;166545;1096;0;0;0;0;.00nan;0;0
9585;183775;1096;91;33;1;32;.970;3600000;0
9585;184049;1097;59;29;4;25;.862;3600000;0
9585;171730;1097;0;0;0;0;.00nan;0;0
9586;173856;75;86;28;1;27;.964;3600000;0
9586;170598;4922;77;45;4;41;.911;3600000;0
9586;91225;75;0;0;0;0;.00nan;0;0
9586;161046;4922;0;0;0;0;.00nan;0;0
9587;163989;4245;34;23;5;18;.783;3600000;0
9587;184158;4620;0;0;0;0;.00nan;0;0
9587;181341;4620;73;35;4;31;.886;3600000;0
9587;37857;4245;0;0;0;0;.00nan;0;0
9588;171970;82;0;0;0;0;.00nan;0;0
9588;170598;4922;0;0;0;0;.00nan;0;0
9588;85050;82;100;24;0;24;1.000;3600000;0
9588;161046;4922;92;34;1;33;.971;3563000;0
9589;176200;1095;82;42;4;38;.905;3600000;0
9589;57953;72;61;7;0;7;1.000;1015000;0
9589;60773;1095;0;0;0;0;.00nan;0;0
9589;64811;72;21;27;7;20;.741;2585000;0
9590;166545;1096;45;32;5;27;.844;3600000;0
9590;183775;1096;0;0;0;0;.00nan;0;0
9590;189581;76;0;0;0;0;.00nan;0;0
9590;176136;76;62;29;3;26;.897;3600000;0
9591;173823;73;0;0;0;0;.00nan;0;0
9591;170963;73;60;28;3;25;.893;3591000;0
9591;57695;2564;0;0;0;0;.00nan;0;0
9591;85633;2564;73;28;2;26;.929;3600000;0
9592;183755;69;100;52;3;49;.942;3900000;0
9592;178911;152;0;0;0;0;.00nan;0;0
9592;57207;152;97;36;3;33;.917;3900000;0
9592;161047;69;0;0;0;0;.00nan;0;0
9593;-1;74;0;0;0;0;.00nan;0;0
9593;175423;77;0;0;0;0;.00nan;0;0
9593;180873;77;57;30;4;26;.867;3600000;0
9593;57215;74;100;26;0;26;1.000;3600000;0
9594;173874;158;0;0;0;0;.00nan;0;0
9594;38209;149;0;0;0;0;.00nan;0;0
9594;85546;149;80;35;3;32;.914;3553000;0
9594;91398;158;72;27;2;25;.926;3600000;0
9595;184049;1097;60;15;1;14;.933;478000;0
9595;173856;75;0;0;0;0;.00nan;0;0
9595;171730;1097;40;40;6;34;.850;3122000;0
9595;91225;75;89;33;1;32;.970;3600000;0
9596;173918;4921;0;0;0;0;.00nan;0;0
9596;75051;71;0;0;0;0;.00nan;0;0
9596;78775;71;77;31;2;29;.935;3600000;0
9596;78864;4921;66;31;3;28;.903;3560000;0
9597;4487;4920;0;0;0;0;.00nan;0;0
9597;183859;4920;63;15;1;14;.933;3600000;0
9597;179406;78;0;0;0;0;.00nan;0;0
9597;46790;78;68;45;6;39;.867;3600000;0
9598;184081;157;52;13;2;11;.846;3600000;0
9598;179411;151;59;7;0;7;1.000;572000;0
9598;176060;151;49;38;6;32;.842;3028000;0
9598;38276;157;0;0;0;0;.00nan;0;0
9599;165611;81;100;53;2;51;.962;3600000;0
9599;176770;81;0;0;0;0;.00nan;0;0
9599;59592;80;60;31;3;28;.903;3543000;0
9599;85009;80;0;0;0;0;.00nan;0;0
9600;163462;85;0;0;0;0;.00nan;0;0
9600;169096;67;0;0;0;0;.00nan;0;0
9600;176860;85;62;37;4;33;.892;3600000;0
9600;182049;67;68;17;1;16;.941;3600000;0
9601;163989;4245;96;40;2;38;.950;3900000;0
9601;184158;4620;83;36;2;34;.944;3900000;0
9601;181341;4620;0;0;0;0;.00nan;0;0
9601;37857;4245;0;0;0;0;.00nan;0;0
9602;173823;73;72;25;2;23;.920;3600000;0
9602;173918;4921;0;0;0;0;.00nan;0;0
9602;170963;73;0;0;0;0;.00nan;0;0
9602;78864;4921;91;44;3;41;.932;3600000;0
9603;171970;82;76;21;1;20;.952;3600000;0
9603;170598;4922;85;40;3;37;.925;3572000;0
9603;85050;82;0;0;0;0;.00nan;0;0
9603;161046;4922;0;0;0;0;.00nan;0;0
9604;176200;1095;100;44;1;43;.977;3600000;0
9604;57695;2564;65;25;3;22;.880;3568000;0
9604;60773;1095;0;0;0;0;.00nan;0;0
9604;85633;2564;0;0;0;0;.00nan;0;0
9605;183755;69;0;0;0;0;.00nan;0;0
9605;178911;152;100;35;1;34;.971;3600000;0
9605;57207;152;0;0;0;0;.00nan;0;0
9605;161047;69;65;30;3;27;.900;3587000;0
9606;-1;74;0;0;0;0;.00nan;0;0
9606;175423;77;31;29;6;23;.793;2775000;0
9606;180873;77;59;9;0;9;1.000;825000;0
9606;57215;74;90;16;0;16;1.000;3600000;0
9607;184049;1097;90;35;2;33;.943;3600000;0
9607;173856;75;53;25;3;22;.880;3567000;0
9607;171730;1097;0;0;0;0;.00nan;0;0
9607;91225;75;0;0;0;0;.00nan;0;0
9608;173874;158;68;27;2;25;.926;3600000;0
9608;38209;149;0;0;0;0;.00nan;0;0
9608;85546;149;48;33;5;28;.848;3600000;0
9608;91398;158;0;0;0;0;.00nan;0;0
9609;166545;1096;0;0;0;0;.00nan;0;0
9609;183775;1096;89;45;3;42;.933;3742000;0
9609;189581;76;91;35;2;33;.943;3742000;0
9609;176136;76;0;0;0;0;.00nan;0;0
9610;57953;72;66;35;5;30;.857;3806000;0
9610;64811;72;0;0;0;0;.00nan;0;0
9610;75051;71;92;49;4;45;.918;3806000;0
9610;78775;71;0;0;0;0;.00nan;0;0
9611;4487;4920;0;0;0;0;.00nan;0;0
9611;183859;4920;43;21;3;18;.857;3522000;0
9611;179406;78;0;0;0;0;.00nan;0;0
9611;46790;78;95;38;1;37;.974;3600000;0
9612;165611;81;0;0;0;0;.00nan;0;0
9612;176770;81;39;26;4;22;.846;3579000;0
9612;59592;80;0;0;0;0;.00nan;0;0
9612;85009;80;75;27;2;25;.926;3600000;0
9613;184081;157;0;0;0;0;.00nan;0;0
9613;179411;151;99;55;3;52;.945;3600000;0
9613;176060;151;0;0;0;0;.00nan;0;0
9613;38276;157;65;41;5;36;.878;3600000;0
9614;163462;85;0;0;0;0;.00nan;0;0
9614;169096;67;0;0;0;0;.00nan;0;0
9614;176860;85;74;35;3;32;.914;3597000;0
9614;182049;67;95;36;1;35;.972;3600000;0
9615;173823;73;0;0;0;0;.00nan;0;0
9615;170963;73;62;26;3;23;.885;3600000;0
9615;57695;2564;0;0;0;0;.00nan;0;0
9615;85633;2564;58;40;5;35;.875;3566000;0
9616;165611;81;100;35;1;34;.971;3900000;0
9616;173874;158;0;0;0;0;.00nan;0;0
9616;176770;81;0;0;0;0;.00nan;0;0
9616;91398;158;97;48;1;47;.979;3900000;0
9617;173918;4921;42;3;1;2;.667;414000;0
9617;57953;72;0;0;0;0;.00nan;0;0
9617;64811;72;70;23;1;22;.957;3600000;0
9617;78864;4921;34;46;8;38;.826;3186000;0
9618;183755;69;48;25;4;21;.840;3548000;0
9618;75051;71;0;0;0;0;.00nan;0;0
9618;78775;71;85;47;3;44;.936;3600000;0
9618;161047;69;0;0;0;0;.00nan;0;0
9619;163989;4245;43;20;4;16;.800;3513000;0
9619;-1;74;0;0;0;0;.00nan;0;0
9619;37857;4245;0;0;0;0;.00nan;0;0
9619;57215;74;96;38;2;36;.947;3600000;0
9620;4487;4920;0;0;0;0;.00nan;0;0
9620;183859;4920;45;22;4;18;.818;3900000;0
9620;179406;78;85;57;4;53;.930;3900000;0
9620;46790;78;0;0;0;0;.00nan;0;0
9621;178911;152;0;0;0;0;.00nan;0;0
9621;57207;152;71;30;3;27;.900;3600000;0
9621;59592;80;80;46;4;42;.913;3594000;0
9621;85009;80;0;0;0;0;.00nan;0;0
9622;179411;151;0;0;0;0;.00nan;0;0
9622;176060;151;61;41;5;36;.878;3547000;0
9622;38209;149;0;0;0;0;.00nan;0;0
9622;85546;149;66;32;4;28;.875;3600000;0
9623;171970;82;0;0;0;0;.00nan;0;0
9623;175423;77;0;0;0;0;.00nan;0;0
9623;180873;77;98;48;1;47;.979;3900000;0
9623;85050;82;87;30;1;29;.967;3900000;0
9624;184049;1097;79;55;4;51;.927;3600000;0
9624;189581;76;0;0;0;0;.00nan;0;0
9624;171730;1097;0;0;0;0;.00nan;0;0
9624;176136;76;81;23;1;22;.957;3600000;0
9625;184158;4620;80;21;1;20;.952;3652000;0
9625;181341;4620;0;0;0;0;.00nan;0;0
9625;38209;149;0;0;0;0;.00nan;0;0
9625;85546;149;91;35;2;33;.943;3652000;0
9626;171970;82;54;23;3;20;.870;3600000;0
9626;175423;77;41;34;6;28;.824;2601000;0
9626;180873;77;40;13;3;10;.769;999000;0
9626;85050;82;0;0;0;0;.00nan;0;0
9627;173823;73;0;0;0;0;.00nan;0;0
9627;170963;73;80;28;2;26;.929;3600000;0
9627;57695;2564;54;18;2;16;.889;1267000;0
9627;85633;2564;30;28;6;22;.786;2333000;0
9628;165611;81;38;33;6;27;.818;3600000;0
9628;173874;158;0;0;0;0;.00nan;0;0
9628;176770;81;0;0;0;0;.00nan;0;0
9628;91398;158;70;29;3;26;.897;3600000;0
9629;183755;69;52;26;3;23;.885;3836000;0
9629;75051;71;0;0;0;0;.00nan;0;0
9629;78775;71;79;40;4;36;.900;3836000;0
9629;161047;69;0;0;0;0;.00nan;0;0
9630;4487;4920;0;0;0;0;.00nan;0;0
9630;183859;4920;65;25;3;22;.880;3600000;0
9630;169096;67;0;0;0;0;.00nan;0;0
9630;182049;67;98;55;4;51;.927;3581000;0
9631;163462;85;0;0;0;0;.00nan;0;0
9631;179406;78;72;29;2;27;.931;3600000;0
9631;176860;85;65;34;4;30;.882;3587000;0
9631;46790;78;0;0;0;0;.00nan;0;0
9632;163989;4245;48;17;3;14;.824;3600000;0
9632;-1;74;0;0;0;0;.00nan;0;0
9632;37857;4245;0;0;0;0;.00nan;0;0
9632;57215;74;64;49;6;43;.878;3600000;0
9633;166545;1096;56;49;6;43;.878;3600000;0
9633;183775;1096;0;0;0;0;.00nan;0;0
9633;173856;75;49;26;4;22;.846;3600000;0
9633;91225;75;0;0;0;0;.00nan;0;0
9634;184049;1097;0;0;0;0;.00nan;0;0
9634;189581;76;89;34;2;32;.941;3600000;0
9634;171730;1097;32;14;3;11;.786;3600000;0
9634;176136;76;0;0;0;0;.00nan;0;0
9635;184081;157;0;0;0;0;.00nan;0;0
9635;179411;151;0;0;0;0;.00nan;0;0
9635;176060;151;69;61;7;54;.885;3600000;0
9635;38276;157;91;28;1;27;.964;3600000;0
9636;178911;152;0;0;0;0;.00nan;0;0
9636;57207;152;93;30;1;29;.967;3900000;0
9636;59592;80;97;45;1;44;.978;3900000;0
9636;85009;80;0;0;0;0;.00nan;0;0
9637;173918;4921;0;0;0;0;.00nan;0;0
9637;176200;1095;48;14;2;12;.857;3555000;0
9637;60773;1095;0;0;0;0;.00nan;0;0
9637;78864;4921;97;38;1;37;.974;3600000;0
9638;184158;4620;0;0;0;0;.00nan;0;0
9638;181341;4620;97;34;1;33;.971;3600000;0
9638;38209;149;0;0;0;0;.00nan;0;0
9638;85546;149;61;25;3;22;.880;3555000;0
9639;176200;1095;94;35;1;34;.971;3600000;0
9639;57953;72;0;0;0;0;.00nan;0;0
9639;60773;1095;0;0;0;0;.00nan;0;0
9639;64811;72;41;26;4;22;.846;3600000;0
9640;165611;81;0;0;0;0;.00nan;0;0
9640;173874;158;71;47;5;42;.894;3600000;0
9640;176770;81;75;24;2;22;.917;3600000;0
9640;91398;158;0;0;0;0;.00nan;0;0
9641;183755;69;50;33;6;27;.818;2848000;0
9641;75051;71;0;0;0;0;.00nan;0;0
9641;78775;71;78;35;3;32;.914;3600000;0
9641;161047;69;53;10;1;9;.900;752000;0
9642;173823;73;65;32;3;29;.906;3600000;0
9642;170963;73;0;0;0;0;.00nan;0;0
9642;57695;2564;0;0;0;0;.00nan;0;0
9642;85633;2564;41;21;4;17;.810;3593000;0
9643;163462;85;100;23;0;23;1.000;3600000;0
9643;179406;78;0;0;0;0;.00nan;0;0
9643;176860;85;0;0;0;0;.00nan;0;0
9643;46790;78;78;20;1;19;.950;3567000;0
9644;163989;4245;91;28;1;27;.964;3876000;0
9644;-1;74;76;32;2;30;.938;3876000;0
9644;37857;4245;0;0;0;0;.00nan;0;0
9644;57215;74;0;0;0;0;.00nan;0;0
9645;166545;1096;19;21;6;15;.714;2390000;0
9645;183775;1096;50;19;3;16;.842;1210000;0
9645;173856;75;0;0;0;0;.00nan;0;0
9645;91225;75;82;25;1;24;.960;3600000;0
9646;171970;82;0;0;0;0;.00nan;0;0
9646;184049;1097;95;36;1;35;.972;3600000;0
9646;171730;1097;0;0;0;0;.00nan;0;0
9646;85050;82;54;28;4;24;.857;3600000;0
9647;189581;76;69;13;0;13;1.000;1237000;0
9647;170598;4922;66;25;3;22;.880;3600000;0
9647;176136;76;37;38;6;32;.842;2363000;0
9647;161046;4922;0;0;0;0;.00nan;0;0
9648;178911;152;100;25;0;25;1.000;3600000;0
9648;57207;152;0;0;0;0;.00nan;0;0
9648;59592;80;0;0;0;0;.00nan;0;0
9648;85009;80;70;37;4;33;.892;3600000;0
9649;184081;157;62;28;3;25;.893;3600000;0
9649;179411;151;29;26;6;20;.769;2225000;0
9649;176060;151;58;13;1;12;.923;1375000;0
9649;38276;157;0;0;0;0;.00nan;0;0
9650;4487;4920;0;0;0;0;.00nan;0;0
9650;183859;4920;65;39;4;35;.897;3577000;0
9650;169096;67;0;0;0;0;.00nan;0;0
9650;182049;67;97;35;2;33;.943;3600000;0
9651;184158;4620;82;33;2;31;.939;3600000;0
9651;181341;4620;0;0;0;0;.00nan;0;0
9651;38209;149;44;13;2;11;.846;1029000;0
9651;85546;149;20;28;6;22;.786;2571000;0
9652;170598;4922;79;34;2;32;.941;3600000;0
9652;175423;77;0;0;0;0;.00nan;0;0
9652;180873;77;50;27;4;23;.852;3600000;0
9652;161046;4922;0;0;0;0;.00nan;0;0
9653;176200;1095;72;34;3;31;.912;3600000;0
9653;57695;2564;0;0;0;0;.00nan;0;0
9653;60773;1095;0;0;0;0;.00nan;0;0
9653;85633;2564;43;20;4;16;.800;3565000;0
9654;163462;85;71;30;2;28;.933;3554000;0
9654;179406;78;100;31;0;31;1.000;3600000;0
9654;176860;85;0;0;0;0;.00nan;0;0
9654;46790;78;0;0;0;0;.00nan;0;0
9655;166545;1096;43;28;5;23;.821;2335000;0
9655;183775;1096;57;10;1;9;.900;1219000;0
9655;173856;75;28;5;3;2;.400;482000;0
9655;91225;75;78;30;2;28;.933;3118000;0
9656;173918;4921;0;0;0;0;.00nan;0;0
9656;57953;72;85;38;2;36;.947;3556000;0
9656;64811;72;0;0;0;0;.00nan;0;0
9656;78864;4921;83;33;1;32;.970;3600000;0
9657;184081;157;0;0;0;0;.00nan;0;0
9657;179411;151;0;0;0;0;.00nan;0;0
9657;176060;151;97;58;3;55;.948;3600000;0
9657;38276;157;55;15;2;13;.867;3600000;0
9658;4487;4920;45;17;3;14;.824;3600000;0
9658;183859;4920;0;0;0;0;.00nan;0;0
9658;169096;67;0;0;0;0;.00nan;0;0
9658;182049;67;90;47;4;43;.915;3584000;0
9659;173823;73;0;0;0;0;.00nan;0;0
9659;178911;152;100;45;2;43;.956;3600000;0
9659;170963;73;55;30;4;26;.867;3540000;0
9659;57207;152;0;0;0;0;.00nan;0;0
9660;171970;82;0;0;0;0;.00nan;0;0
9660;170598;4922;70;32;3;29;.906;3600000;0
9660;85050;82;45;29;4;25;.862;3567000;0
9660;161046;4922;0;0;0;0;.00nan;0;0
9661;183755;69;53;31;5;26;.839;3551000;0
9661;57695;2564;0;0;0;0;.00nan;0;0
9661;85633;2564;61;27;3;24;.889;3600000;0
9661;161047;69;0;0;0;0;.00nan;0;0
9662;173823;73;81;33;2;31;.939;3600000;0
9662;178911;152;0;0;0;0;.00nan;0;0
9662;170963;73;0;0;0;0;.00nan;0;0
9662;57207;152;99;23;0;23;1.000;3600000;0
9663;163462;85;0;0;0;0;.00nan;0;0
9663;-1;74;0;0;0;0;.00nan;0;0
9663;176860;85;60;38;5;33;.868;3576000;0
9663;57215;74;73;31;3;28;.903;3600000;0
9664;173874;158;0;0;0;0;.00nan;0;0
9664;179411;151;0;0;0;0;.00nan;0;0
9664;176060;151;52;48;6;42;.875;3600000;0
9664;91398;158;47;19;3;16;.842;3600000;0
9665;171970;82;58;21;2;19;.905;3600000;0
9665;189581;76;41;2;1;1;.500;306000;0
9665;176136;76;35;36;6;30;.833;3294000;0
9665;85050;82;0;0;0;0;.00nan;0;0
9666;176200;1095;40;35;6;29;.829;2350000;0
9666;57953;72;0;0;0;0;.00nan;0;0
9666;60773;1095;68;16;0;16;1.000;1250000;0
9666;64811;72;63;16;2;14;.875;3600000;0
9667;166545;1096;88;28;1;27;.964;3600000;0
9667;183775;1096;0;0;0;0;.00nan;0;0
9667;175423;77;0;0;0;0;.00nan;0;0
9667;180873;77;90;39;2;37;.949;3568000;0
9668;165611;81;100;25;0;25;1.000;3600000;0
9668;176770;81;0;0;0;0;.00nan;0;0
9668;59592;80;67;34;3;31;.912;3600000;0
9668;85009;80;0;0;0;0;.00nan;0;0
9669;183755;69;58;29;3;26;.897;3551000;0
9669;57695;2564;0;0;0;0;.00nan;0;0
9669;85633;2564;100;40;1;39;.975;3600000;0
9669;161047;69;0;0;0;0;.00nan;0;0
9670;184049;1097;56;30;4;26;.867;3560000;0
9670;170598;4922;73;33;3;30;.909;3600000;0
9670;171730;1097;0;0;0;0;.00nan;0;0
9670;161046;4922;0;0;0;0;.00nan;0;0
9671;4487;4920;0;0;0;0;.00nan;0;0
9671;183859;4920;52;15;2;13;.867;3600000;0
9671;184158;4620;61;43;5;38;.884;3600000;0
9671;181341;4620;0;0;0;0;.00nan;0;0
9672;173874;158;60;30;4;26;.867;3556000;0
9672;179411;151;60;29;3;26;.897;3600000;0
9672;176060;151;0;0;0;0;.00nan;0;0
9672;91398;158;0;0;0;0;.00nan;0;0
9673;163989;4245;95;42;2;40;.952;3900000;0
9673;173856;75;93;36;2;34;.944;3900000;0
9673;37857;4245;0;0;0;0;.00nan;0;0
9673;91225;75;0;0;0;0;.00nan;0;0
9674;169096;67;0;0;0;0;.00nan;0;0
9674;179406;78;39;28;5;23;.821;3600000;0
9674;182049;67;100;30;0;30;1.000;3600000;0
9674;46790;78;0;0;0;0;.00nan;0;0
9675;184081;157;0;0;0;0;.00nan;0;0
9675;38209;149;0;0;0;0;.00nan;0;0
9675;38276;157;57;35;3;32;.914;3900000;0
9675;85546;149;79;45;3;42;.933;3900000;0
9676;173918;4921;59;14;1;13;.929;1190000;0
9676;75051;71;0;0;0;0;.00nan;0;0
9676;78775;71;64;41;4;37;.902;3600000;0
9676;78864;4921;17;16;5;11;.688;2395000;0
9677;4487;4920;51;21;3;18;.857;3600000;0
9677;183859;4920;0;0;0;0;.00nan;0;0
9677;184158;4620;0;0;0;0;.00nan;0;0
9677;181341;4620;61;37;4;33;.892;3565000;0
9678;184081;157;24;18;5;13;.722;3530000;0
9678;38209;149;0;0;0;0;.00nan;0;0
9678;38276;157;0;0;0;0;.00nan;0;0
9678;85546;149;73;37;3;34;.919;3600000;0
9679;171970;82;0;0;0;0;.00nan;0;0
9679;189581;76;88;29;1;28;.966;3576000;0
9679;176136;76;0;0;0;0;.00nan;0;0
9679;85050;82;89;22;0;22;1.000;3600000;0
9680;165611;81;100;33;1;32;.970;3600000;0
9680;176770;81;0;0;0;0;.00nan;0;0
9680;59592;80;0;0;0;0;.00nan;0;0
9680;85009;80;73;39;3;36;.923;3514000;0
9681;57695;2564;0;0;0;0;.00nan;0;0
9681;57953;72;94;20;0;20;1.000;3600000;0
9681;64811;72;0;0;0;0;.00nan;0;0
9681;85633;2564;64;28;3;25;.893;3600000;0
9682;183755;69;0;0;0;0;.00nan;0;0
9682;178911;152;0;0;0;0;.00nan;0;0
9682;57207;152;56;41;6;35;.854;3730000;0
9682;161047;69;38;30;5;25;.833;3730000;0
9683;170598;4922;57;19;2;17;.895;3600000;0
9683;175423;77;52;36;5;31;.861;3600000;0
9683;180873;77;0;0;0;0;.00nan;0;0
9683;161046;4922;0;0;0;0;.00nan;0;0
9684;163462;85;0;0;0;0;.00nan;0;0
9684;-1;74;0;0;0;0;.00nan;0;0
9684;176860;85;100;27;1;26;.963;3600000;0
9684;57215;74;52;27;4;23;.852;3600000;0
9685;173874;158;0;0;0;0;.00nan;0;0
9685;179411;151;0;0;0;0;.00nan;0;0
9685;176060;151;49;33;5;28;.848;3577000;0
9685;91398;158;55;23;3;20;.870;3600000;0
9686;163989;4245;84;32;2;30;.938;3682000;0
9686;173856;75;0;0;0;0;.00nan;0;0
9686;37857;4245;0;0;0;0;.00nan;0;0
9686;91225;75;77;29;3;26;.897;3682000;0
9687;166545;1096;31;36;6;30;.833;3050000;0
9687;183775;1096;46;4;1;3;.750;550000;0
9687;184049;1097;0;0;0;0;.00nan;0;0
9687;171730;1097;60;21;2;19;.905;3600000;0
9688;176200;1095;52;43;6;37;.860;3900000;0
9688;60773;1095;0;0;0;0;.00nan;0;0
9688;75051;71;65;14;0;14;1.000;1860000;0
9688;78775;71;29;28;6;22;.786;2040000;0
9689;169096;67;0;0;0;0;.00nan;0;0
9689;179406;78;0;0;0;0;.00nan;0;0
9689;182049;67;79;25;1;24;.960;3564000;0
9689;46790;78;100;31;0;31;1.000;3600000;0
9690;173823;73;0;0;0;0;.00nan;0;0
9690;173918;4921;0;0;0;0;.00nan;0;0
9690;170963;73;85;33;1;32;.970;3600000;0
9690;78864;4921;48;19;3;16;.842;3539000;0
9691;4487;4920;49;14;2;12;.857;2005000;0
9691;183859;4920;32;18;4;14;.778;1595000;0
9691;184158;4620;91;33;1;32;.970;3600000;0
9691;181341;4620;0;0;0;0;.00nan;0;0
9692;184081;157;0;0;0;0;.00nan;0;0
9692;38209;149;0;0;0;0;.00nan;0;0
9692;38276;157;94;32;1;31;.969;3600000;0
9692;85546;149;76;39;3;36;.923;3514000;0
9693;176200;1095;43;30;5;25;.833;3572000;0
9693;60773;1095;0;0;0;0;.00nan;0;0
9693;75051;71;0;0;0;0;.00nan;0;0
9693;78775;71;63;29;3;26;.897;3600000;0
9694;166545;1096;0;0;0;0;.00nan;0;0
9694;183775;1096;74;25;1;24;.960;3600000;0
9694;184049;1097;44;33;5;28;.848;3600000;0
9694;171730;1097;0;0;0;0;.00nan;0;0
9695;170598;4922;53;24;3;21;.875;3563000;0
9695;175423;77;0;0;0;0;.00nan;0;0
9695;180873;77;85;29;2;27;.931;3600000;0
9695;161046;4922;0;0;0;0;.00nan;0;0
9696;163462;85;82;28;2;26;.929;3900000;0
9696;-1;74;0;0;0;0;.00nan;0;0
9696;176860;85;0;0;0;0;.00nan;0;0
9696;57215;74;92;39;2;37;.949;3900000;0
9697;169096;67;58;19;2;17;.895;3049000;0
9697;179406;78;0;0;0;0;.00nan;0;0
9697;182049;67;30;8;3;5;.625;551000;0
9697;46790;78;100;17;0;17;1.000;3600000;0
9699;164987;85;43;32;5;27;.844;3600000;0
9699;-1;157;0;0;0;0;.00nan;0;0
9699;57998;85;0;0;0;0;.00nan;0;0
9699;85555;157;79;31;2;29;.935;3600000;0
9701;184049;1097;71;37;4;33;.892;3574000;0
9701;169166;1095;68;26;2;24;.923;3600000;0
9701;171730;1097;0;0;0;0;.00nan;0;0
9701;176200;1095;0;0;0;0;.00nan;0;0
9703;173874;158;0;0;0;0;.00nan;0;0
9703;179411;151;0;0;0;0;.00nan;0;0
9703;176060;151;41;33;5;28;.848;3558000;0
9703;91398;158;49;23;4;19;.826;3600000;0
9705;171970;82;74;34;2;32;.941;3543000;0
9705;-1;82;0;0;0;0;.00nan;0;0
9705;180873;77;0;0;0;0;.00nan;0;0
9705;64961;77;85;28;1;27;.964;3600000;0
9707;165611;81;32;19;5;14;.737;2310000;0
9707;184398;78;0;0;0;0;.00nan;0;0
9707;179406;78;30;31;6;25;.806;3900000;0
9707;176770;81;59;14;1;13;.929;1590000;0
9709;2495;2564;0;0;0;0;.00nan;0;0
9709;4487;4920;71;24;2;22;.917;3600000;0
9709;183859;4920;0;0;0;0;.00nan;0;0
9709;85633;2564;78;48;5;43;.896;3600000;0
9711;163989;72;74;41;3;38;.927;3568000;0
9711;38209;149;0;0;0;0;.00nan;0;0
9711;64811;72;0;0;0;0;.00nan;0;0
9711;86875;149;68;16;1;15;.938;3600000;0
9713;173918;4921;0;0;0;0;.00nan;0;0
9713;182049;4921;80;32;2;30;.938;3600000;0
9713;46790;71;0;0;0;0;.00nan;0;0
9713;78775;71;77;39;4;35;.897;3589000;0
9715;178911;152;77;36;3;33;.917;3600000;0
9715;58054;69;73;25;2;23;.920;3600000;0
9715;85935;152;0;0;0;0;.00nan;0;0
9715;161047;69;0;0;0;0;.00nan;0;0
9717;170598;4922;100;42;0;42;1.000;3600000;0
9717;37857;4245;72;24;2;22;.917;3526000;0
9717;186520;4245;0;0;0;0;.00nan;0;0
9717;161046;4922;0;0;0;0;.00nan;0;0
9719;166545;1096;0;0;0;0;.00nan;0;0
9719;183775;1096;73;28;3;25;.893;3732000;0
9719;173823;73;0;0;0;0;.00nan;0;0
9719;170963;73;67;26;2;24;.923;3732000;0
9721;173856;75;76;24;1;23;.958;3600000;0
9721;171615;75;0;0;0;0;.00nan;0;0
9721;85009;80;26;22;5;17;.773;3600000;0
9721;92313;80;0;0;0;0;.00nan;0;0
9723;170612;74;0;0;0;0;.00nan;0;0
9723;176136;76;0;0;0;0;.00nan;0;0
9723;57207;76;100;51;0;51;1.000;3900000;0
9723;57215;74;97;28;0;28;1.000;3900000;0
9725;-1;67;85;29;1;28;.966;3600000;0
9725;169096;67;0;0;0;0;.00nan;0;0
9725;184158;4620;0;0;0;0;.00nan;0;0
9725;181341;4620;71;35;3;32;.914;3600000;0
1847;4487;4920;0;0;0;0;.00nan;0;0
1847;183859;4920;47;23;4;19;.826;3600000;0
1847;179406;78;68;25;2;23;.920;1438000;0
1847;46790;78;38;24;5;19;.792;2162000;0
1848;163989;4245;63;27;3;24;.889;3532000;0
1848;184158;4620;92;36;1;35;.972;3600000;0
1848;181341;4620;0;0;0;0;.00nan;0;0
1848;37857;4245;0;0;0;0;.00nan;0;0
1849;173856;75;67;32;3;29;.906;3600000;0
1849;170598;4922;50;28;4;24;.857;2400000;0
1849;91225;75;0;0;0;0;.00nan;0;0
1849;161046;4922;38;24;4;20;.833;1200000;0
1850;171970;82;0;0;0;0;.00nan;0;0
1850;-1;74;0;0;0;0;.00nan;0;0
1850;57215;74;72;35;4;31;.886;3600000;0
1850;85050;82;73;23;2;21;.913;3600000;0
1851;173823;73;0;0;0;0;.00nan;0;0
1851;170963;73;74;49;6;43;.878;3600000;0
1851;57953;72;87;17;0;17;1.000;3600000;0
1851;64811;72;0;0;0;0;.00nan;0;0
1852;183755;69;57;42;6;36;.857;3600000;0
1852;75051;71;0;0;0;0;.00nan;0;0
1852;78775;71;100;46;2;44;.957;3600000;0
1852;161047;69;0;0;0;0;.00nan;0;0
1853;184081;157;88;28;1;27;.964;3600000;0
1853;173874;158;94;23;0;23;1.000;1142000;0
1853;38276;157;0;0;0;0;.00nan;0;0
1853;91398;158;33;33;6;27;.818;2458000;0
1854;178911;152;0;0;0;0;.00nan;0;0
1854;38209;149;0;0;0;0;.00nan;0;0
1854;57207;152;62;33;4;29;.879;3562000;0
1854;85546;149;62;27;3;24;.889;3600000;0
1855;4487;4920;53;10;1;9;.900;2674000;0
1855;183859;4920;14;5;4;1;.200;926000;0
1855;179406;78;0;0;0;0;.00nan;0;0
1855;46790;78;99;41;2;39;.951;3600000;0
1857;173856;75;31;30;6;24;.800;2664000;0
1857;170598;4922;67;30;4;26;.867;3600000;0
1857;91225;75;57;5;0;5;1.000;889000;0
1857;161046;4922;0;0;0;0;.00nan;0;0
1859;173823;73;0;0;0;0;.00nan;0;0
1859;170963;73;78;32;2;30;.938;3600000;0
1859;57953;72;0;0;0;0;.00nan;0;0
1859;64811;72;54;30;4;26;.867;3513000;0
1861;184081;157;45;21;3;18;.857;3600000;0
1861;173874;158;0;0;0;0;.00nan;0;0
1861;38276;157;0;0;0;0;.00nan;0;0
1861;91398;158;96;62;5;57;.919;3540000;0
9726;197999;116;0;0;0;0;.00nan;0;0
9726;203412;117;51;2;0;2;1.000;461000;0
9726;197768;117;27;32;7;25;.781;3139000;0
9726;-1;116;73;27;1;26;.963;3600000;0
9727;192948;111;52;11;1;10;.909;1668000;0
9727;200233;108;0;0;0;0;.00nan;0;0
9727;196372;108;72;24;1;23;.958;3600000;0
9727;197912;111;18;23;6;17;.739;1932000;0
9728;192948;111;0;0;0;0;.00nan;0;0
9728;196324;110;0;0;0;0;.00nan;0;0
9728;197010;110;67;22;2;20;.909;3600000;0
9728;197912;111;52;42;6;36;.857;3600000;0
9729;204630;109;65;34;3;31;.912;3547000;0
9729;200233;108;0;0;0;0;.00nan;0;0
9729;196372;108;83;27;2;25;.926;3600000;0
9729;197038;109;0;0;0;0;.00nan;0;0
9730;199481;122;51;37;5;32;.865;3528000;0
9730;205469;122;0;0;0;0;.00nan;0;0
9730;202161;115;0;0;0;0;.00nan;0;0
9730;207439;115;60;28;3;25;.893;3600000;0
9731;197999;116;0;0;0;0;.00nan;0;0
9731;203412;117;33;37;7;30;.811;3600000;0
9731;197768;117;0;0;0;0;.00nan;0;0
9731;-1;116;37;25;5;20;.800;3600000;0
9732;193687;120;30;23;5;18;.783;3600000;0
9732;200353;123;57;8;0;8;1.000;524000;0
9732;200390;120;0;0;0;0;.00nan;0;0
9732;-1;123;37;34;6;28;.824;3076000;0
9733;192776;119;57;28;4;24;.857;3600000;0
9733;192900;114;30;16;4;12;.750;1763000;0
9733;195017;119;0;0;0;0;.00nan;0;0
9733;197047;114;30;14;4;10;.714;1837000;0
9734;202246;112;52;30;4;26;.867;3600000;0
9734;-1;112;0;0;0;0;.00nan;0;0
9734;197059;113;31;4;2;2;.500;788000;0
9734;-1;113;32;33;6;27;.818;2812000;0
9735;195111;125;63;30;2;28;.933;3600000;0
9735;195392;125;0;0;0;0;.00nan;0;0
9735;206864;127;45;35;5;30;.857;3600000;0
9735;202314;127;0;0;0;0;.00nan;0;0
9736;195001;126;0;0;0;0;.00nan;0;0
9736;195089;124;0;0;0;0;.00nan;0;0
9736;206731;124;60;34;4;30;.882;3600000;0
9736;212039;126;92;33;1;32;.970;3600000;0
9737;192780;118;0;0;0;0;.00nan;0;0
9737;196414;118;74;47;5;42;.894;3600000;0
9737;207493;121;0;0;0;0;.00nan;0;0
9737;202279;121;95;32;1;31;.969;3600000;0
9738;192776;119;59;38;4;34;.895;3600000;0
9738;192900;114;0;0;0;0;.00nan;0;0
9738;195017;119;0;0;0;0;.00nan;0;0
9738;197047;114;69;30;2;28;.933;3600000;0
9739;193687;120;0;0;0;0;.00nan;0;0
9739;200390;120;50;24;3;21;.875;3900000;0
9739;195089;124;70;30;3;27;.900;3900000;0
9739;206731;124;0;0;0;0;.00nan;0;0
9740;199481;122;0;0;0;0;.00nan;0;0
9740;205469;122;92;39;2;37;.949;3600000;0
9740;202161;115;34;22;4;18;.818;3514000;0
9740;207439;115;0;0;0;0;.00nan;0;0
9741;192780;118;0;0;0;0;.00nan;0;0
9741;203412;117;78;28;1;27;.964;3600000;0
9741;196414;118;74;41;3;38;.927;3553000;0
9741;197768;117;0;0;0;0;.00nan;0;0
9742;195111;125;78;26;1;25;.962;3600000;0
9742;195392;125;0;0;0;0;.00nan;0;0
9742;207493;121;1;20;8;12;.600;2292000;0
9742;202279;121;35;12;3;9;.750;1308000;0
9743;200353;123;0;0;0;0;.00nan;0;0
9743;206864;127;0;0;0;0;.00nan;0;0
9743;202314;127;80;36;3;33;.917;3600000;0
9743;-1;123;57;38;4;34;.895;3580000;0
9744;195001;126;67;19;2;17;.895;3600000;0
9744;212039;126;0;0;0;0;.00nan;0;0
9744;202246;112;43;30;5;25;.833;2382000;0
9744;-1;112;58;13;1;12;.923;1218000;0
9745;197999;116;0;0;0;0;.00nan;0;0
9745;197059;113;0;0;0;0;.00nan;0;0
9745;-1;113;85;37;1;36;.973;3600000;0
9745;-1;116;68;22;2;20;.909;3542000;0
9746;192948;111;0;0;0;0;.00nan;0;0
9746;196324;110;0;0;0;0;.00nan;0;0
9746;197010;110;72;19;1;18;.947;3600000;0
9746;197912;111;53;50;6;44;.880;3600000;0
9747;193687;120;0;0;0;0;.00nan;0;0
9747;200390;120;69;27;3;24;.889;3543000;0
9747;206864;127;0;0;0;0;.00nan;0;0
9747;202314;127;87;36;2;34;.944;3600000;0
9748;192776;119;80;38;4;34;.895;3900000;0
9748;195001;126;0;0;0;0;.00nan;0;0
9748;195017;119;0;0;0;0;.00nan;0;0
9748;212039;126;42;24;4;20;.833;3900000;0
9749;192900;114;43;25;4;21;.840;3600000;0
9749;202161;115;82;27;1;26;.963;3600000;0
9749;207439;115;0;0;0;0;.00nan;0;0
9749;197047;114;0;0;0;0;.00nan;0;0
9750;200233;108;69;18;1;17;.944;3600000;0
9750;196372;108;0;0;0;0;.00nan;0;0
9750;197059;113;0;0;0;0;.00nan;0;0
9750;-1;113;76;38;3;35;.921;3559000;0
9751;197999;116;0;0;0;0;.00nan;0;0
9751;195111;125;0;0;0;0;.00nan;0;0
9751;195392;125;57;35;5;30;.857;3600000;0
9751;-1;116;82;31;2;29;.935;3600000;0
9752;192948;111;0;0;0;0;.00nan;0;0
9752;197059;113;60;29;3;26;.897;3900000;0
9752;-1;113;0;0;0;0;.00nan;0;0
9752;197912;111;86;44;3;41;.932;3900000;0
9753;192780;118;0;0;0;0;.00nan;0;0
9753;193687;120;68;37;4;33;.892;3600000;0
9753;200390;120;0;0;0;0;.00nan;0;0
9753;196414;118;18;23;6;17;.739;3562000;0
9754;197999;116;24;28;6;22;.786;3084000;0
9754;192776;119;31;30;6;24;.800;3600000;0
9754;195017;119;0;0;0;0;.00nan;0;0
9754;-1;116;43;4;1;3;.750;516000;0
9755;195001;126;44;29;5;24;.828;3600000;0
9755;212039;126;0;0;0;0;.00nan;0;0
9755;206864;127;0;0;0;0;.00nan;0;0
9755;202314;127;74;41;4;37;.902;3600000;0
9756;199481;122;0;0;0;0;.00nan;0;0
9756;205469;122;60;37;5;32;.865;3600000;0
9756;207493;121;1;11;6;5;.455;1061000;0
9756;202279;121;58;31;3;28;.903;2539000;0
9757;196324;110;76;27;2;25;.926;3600000;0
9757;202161;115;33;27;5;22;.815;2189000;0
9757;207439;115;40;11;2;9;.818;1411000;0
9757;197010;110;0;0;0;0;.00nan;0;0
9758;204630;109;52;35;5;30;.857;3856000;0
9758;197038;109;0;0;0;0;.00nan;0;0
9758;197059;113;0;0;0;0;.00nan;0;0
9758;-1;113;22;17;6;11;.647;3868000;0
9759;195111;125;72;30;2;28;.933;3900000;0
9759;195392;125;0;0;0;0;.00nan;0;0
9759;206864;127;92;35;2;33;.943;3900000;0
9759;202314;127;0;0;0;0;.00nan;0;0
9760;196324;110;0;0;0;0;.00nan;0;0
9760;202246;112;28;32;7;25;.781;2671000;0
9760;197010;110;80;22;1;21;.955;3600000;0
9760;-1;112;45;15;2;13;.867;929000;0
9761;195001;126;0;0;0;0;.00nan;0;0
9761;195089;124;31;28;5;23;.821;2082000;0
9761;206731;124;70;19;1;18;.947;1518000;0
9761;212039;126;63;28;2;26;.929;3600000;0
9762;192780;118;0;0;0;0;.00nan;0;0
9762;199481;122;0;0;0;0;.00nan;0;0
9762;205469;122;46;31;5;26;.839;3600000;0
9762;196414;118;76;22;2;20;.909;3600000;0
9763;192776;119;0;0;0;0;.00nan;0;0
9763;195017;119;96;26;0;26;1.000;3600000;0
9763;207493;121;17;24;6;18;.750;2749000;0
9763;202279;121;58;8;0;8;1.000;851000;0
9764;193687;120;0;0;0;0;.00nan;0;0
9764;200353;123;55;40;6;34;.850;3319000;0
9764;200390;120;62;27;3;24;.889;3600000;0
9764;-1;123;47;5;1;4;.800;281000;0
9765;192900;114;0;0;0;0;.00nan;0;0
9765;203412;117;63;26;3;23;.885;3900000;0
9765;197047;114;67;33;3;30;.909;3900000;0
9765;197768;117;0;0;0;0;.00nan;0;0
9766;192948;111;0;0;0;0;.00nan;0;0
9766;204630;109;0;0;0;0;.00nan;0;0
9766;197038;109;100;45;2;43;.956;3900000;0
9766;197912;111;64;27;2;25;.926;3900000;0
9767;202161;115;0;0;0;0;.00nan;0;0
9767;207439;115;42;26;4;22;.846;3643000;0
9767;202246;112;0;0;0;0;.00nan;0;0
9767;-1;112;52;35;5;30;.857;3643000;0
9768;197999;116;0;0;0;0;.00nan;0;0
9768;192780;118;0;0;0;0;.00nan;0;0
9768;196414;118;65;43;5;38;.884;3581000;0
9768;-1;116;42;17;3;14;.824;3600000;0
9769;195001;126;0;0;0;0;.00nan;0;0
9769;195111;125;50;18;2;16;.889;1068000;0
9769;195392;125;27;33;7;26;.788;2532000;0
9769;212039;126;96;19;0;19;1.000;3600000;0
9770;200353;123;0;0;0;0;.00nan;0;0
9770;195089;124;59;37;4;33;.892;3553000;0
9770;206731;124;0;0;0;0;.00nan;0;0
9770;-1;123;57;29;3;26;.897;3600000;0
9771;197999;116;0;0;0;0;.00nan;0;0
9771;204630;109;74;46;5;41;.891;3600000;0
9771;197038;109;0;0;0;0;.00nan;0;0
9771;-1;116;69;23;2;21;.913;3600000;0
9772;192900;114;81;25;1;24;.960;3600000;0
9772;199481;122;0;0;0;0;.00nan;0;0
9772;205469;122;86;34;3;31;.912;3531000;0
9772;197047;114;0;0;0;0;.00nan;0;0
9773;192776;119;0;0;0;0;.00nan;0;0
9773;200233;108;0;0;0;0;.00nan;0;0
9773;195017;119;60;35;5;30;.857;3678000;0
9773;196372;108;40;25;4;21;.840;3678000;0
9774;192948;111;0;0;0;0;.00nan;0;0
9774;195111;125;34;34;6;28;.824;3250000;0
9774;195392;125;52;4;0;4;1.000;350000;0
9774;197912;111;67;23;2;21;.913;3600000;0
9775;200233;108;53;19;3;16;.842;3600000;0
9775;196372;108;0;0;0;0;.00nan;0;0
9775;202246;112;59;47;6;41;.872;3600000;0
9775;-1;112;0;0;0;0;.00nan;0;0
9776;203412;117;75;28;2;26;.929;3600000;0
9776;193687;120;43;43;7;36;.837;2373000;0
9776;200390;120;67;22;1;21;.955;1227000;0
9776;197768;117;0;0;0;0;.00nan;0;0
9777;192776;119;90;36;2;34;.944;3600000;0
9777;192948;111;20;28;6;22;.786;3600000;0
9777;195017;119;0;0;0;0;.00nan;0;0
9777;197912;111;0;0;0;0;.00nan;0;0
9778;192780;118;0;0;0;0;.00nan;0;0
9778;196414;118;88;38;2;36;.947;3600000;0
9778;197059;113;0;0;0;0;.00nan;0;0
9778;-1;113;56;28;3;25;.893;3542000;0
9779;195089;124;77;25;1;24;.960;3600000;0
9779;206731;124;0;0;0;0;.00nan;0;0
9779;206864;127;0;0;0;0;.00nan;0;0
9779;202314;127;64;34;4;30;.882;3600000;0
9780;204630;109;0;0;0;0;.00nan;0;0
9780;195001;126;0;0;0;0;.00nan;0;0
9780;212039;126;84;31;1;30;.968;3600000;0
9780;197038;109;35;35;6;29;.829;3600000;0
9781;202161;115;90;36;2;34;.944;3600000;0
9781;207439;115;0;0;0;0;.00nan;0;0
9781;207493;121;0;0;0;0;.00nan;0;0
9781;202279;121;73;31;3;28;.903;3589000;0
9782;200353;123;45;6;1;5;.833;558000;0
9782;196324;110;0;0;0;0;.00nan;0;0
9782;197010;110;42;26;5;21;.808;3600000;0
9782;-1;123;30;36;7;29;.806;3042000;0
9783;200353;123;81;40;4;36;.900;3600000;0
9783;202161;115;0;0;0;0;.00nan;0;0
9783;207439;115;65;19;1;18;.947;3600000;0
9783;-1;123;0;0;0;0;.00nan;0;0
9784;192900;114;0;0;0;0;.00nan;0;0
9784;192948;111;0;0;0;0;.00nan;0;0
9784;197047;114;61;20;2;18;.900;3600000;0
9784;197912;111;73;37;3;34;.919;3590000;0
9785;195089;124;56;4;0;4;1.000;1004000;0
9785;206731;124;39;33;6;27;.818;2560000;0
9785;207493;121;58;39;5;34;.872;3600000;0
9785;202279;121;0;0;0;0;.00nan;0;0
9786;199481;122;0;0;0;0;.00nan;0;0
9786;205469;122;100;30;0;30;1.000;3600000;0
9786;195111;125;0;0;0;0;.00nan;0;0
9786;195392;125;74;39;4;35;.897;3600000;0
9787;200233;108;0;0;0;0;.00nan;0;0
9787;196372;108;66;35;3;32;.914;3600000;0
9787;202246;112;0;0;0;0;.00nan;0;0
9787;-1;112;64;37;4;33;.892;3569000;0
9788;192776;119;0;0;0;0;.00nan;0;0
9788;195017;119;63;21;2;19;.905;3600000;0
9788;206864;127;61;41;5;36;.878;3600000;0
9788;202314;127;0;0;0;0;.00nan;0;0
9789;192780;118;56;20;2;18;.900;1168000;0
9789;195001;126;54;19;3;16;.842;3600000;0
9789;212039;126;0;0;0;0;.00nan;0;0
9789;196414;118;47;36;6;30;.833;2432000;0
9790;203412;117;0;0;0;0;.00nan;0;0
9790;196324;110;73;53;6;47;.887;3600000;0
9790;197010;110;0;0;0;0;.00nan;0;0
9790;197768;117;88;30;1;29;.967;3600000;0
9791;193687;120;54;19;2;17;.895;3218000;0
9791;200390;120;32;9;3;6;.667;550000;0
9791;195111;125;53;43;6;37;.860;3790000;0
9791;195392;125;0;0;0;0;.00nan;0;0
9792;204630;109;36;37;7;30;.811;2704000;0
9792;197038;109;64;8;0;8;1.000;896000;0
9792;197059;113;67;26;3;23;.885;3600000;0
9792;-1;113;0;0;0;0;.00nan;0;0
9793;199481;122;0;0;0;0;.00nan;0;0
9793;205469;122;99;42;1;41;.976;3600000;0
9793;202161;115;45;22;4;18;.818;3600000;0
9793;207439;115;0;0;0;0;.00nan;0;0
9794;197999;116;0;0;0;0;.00nan;0;0
9794;196324;110;0;0;0;0;.00nan;0;0
9794;197010;110;74;29;2;27;.931;3600000;0
9794;-1;116;32;20;4;16;.800;3578000;0
9795;192776;119;75;25;1;24;.960;3600000;0
9795;195017;119;0;0;0;0;.00nan;0;0
9795;202246;112;72;26;3;23;.885;3600000;0
9795;-1;112;0;0;0;0;.00nan;0;0
9796;192900;114;0;0;0;0;.00nan;0;0
9796;193687;120;48;28;4;24;.857;3543000;0
9796;200390;120;0;0;0;0;.00nan;0;0
9796;197047;114;56;28;3;25;.893;3600000;0
9797;202161;115;57;19;2;17;.895;3600000;0
9797;207439;115;0;0;0;0;.00nan;0;0
9797;197059;113;0;0;0;0;.00nan;0;0
9797;-1;113;75;38;3;35;.921;3545000;0
9798;200233;108;0;0;0;0;.00nan;0;0
9798;195001;126;0;0;0;0;.00nan;0;0
9798;212039;126;58;34;4;30;.882;3600000;0
9798;196372;108;38;25;5;20;.800;3568000;0
9799;203412;117;78;36;3;33;.917;3711000;0
9799;195089;124;86;46;4;42;.913;3711000;0
9799;206731;124;0;0;0;0;.00nan;0;0
9799;197768;117;0;0;0;0;.00nan;0;0
9800;197999;116;27;7;3;4;.571;450000;0
9800;202161;115;0;0;0;0;.00nan;0;0
9800;207439;115;55;33;4;29;.879;3661000;0
9800;-1;116;92;26;0;26;1.000;3211000;0
9801;192948;111;0;0;0;0;.00nan;0;0
9801;195001;126;85;35;3;32;.914;3900000;0
9801;212039;126;0;0;0;0;.00nan;0;0
9801;197912;111;67;34;3;31;.912;3900000;0
9802;204630;109;98;48;2;46;.958;3555000;0
9802;200233;108;98;21;0;21;1.000;3600000;0
9802;196372;108;0;0;0;0;.00nan;0;0
9802;197038;109;0;0;0;0;.00nan;0;0
9803;192900;114;93;26;1;25;.962;3600000;0
9803;206864;127;0;0;0;0;.00nan;0;0
9803;202314;127;93;46;2;44;.957;3553000;0
9803;197047;114;0;0;0;0;.00nan;0;0
9804;192780;118;0;0;0;0;.00nan;0;0
9804;193687;120;66;32;3;29;.906;3568000;0
9804;200390;120;0;0;0;0;.00nan;0;0
9804;196414;118;98;30;1;29;.967;3600000;0
9805;192776;119;0;0;0;0;.00nan;0;0
9805;199481;122;53;4;0;4;1.000;544000;0
9805;205469;122;35;34;6;28;.824;3001000;0
9805;195017;119;43;23;4;19;.826;3600000;0
9806;195089;124;0;0;0;0;.00nan;0;0
9806;206731;124;55;36;5;31;.861;3600000;0
9806;197059;113;35;12;3;9;.750;590000;0
9806;-1;113;45;24;4;20;.833;2979000;0
9807;203412;117;0;0;0;0;.00nan;0;0
9807;207493;121;53;41;5;36;.878;3556000;0
9807;202279;121;0;0;0;0;.00nan;0;0
9807;197768;117;45;25;4;21;.840;3600000;0
9808;196324;110;38;22;5;17;.773;3888000;0
9808;202246;112;50;36;5;31;.861;3900000;0
9808;197010;110;0;0;0;0;.00nan;0;0
9808;-1;112;0;0;0;0;.00nan;0;0
9809;193687;120;0;0;0;0;.00nan;0;0
9809;200390;120;59;27;3;24;.889;3900000;0
9809;202161;115;54;20;3;17;.850;3900000;0
9809;207439;115;0;0;0;0;.00nan;0;0
9810;199481;122;0;0;0;0;.00nan;0;0
9810;205469;122;62;27;3;24;.889;3600000;0
9810;206864;127;32;43;7;36;.837;3600000;0
9810;202314;127;0;0;0;0;.00nan;0;0
9811;192948;111;46;22;3;19;.864;3522000;0
9811;207493;121;0;0;0;0;.00nan;0;0
9811;202279;121;74;22;1;21;.955;3600000;0
9811;197912;111;0;0;0;0;.00nan;0;0
9812;192780;118;53;22;3;19;.864;3550000;0
9812;196414;118;0;0;0;0;.00nan;0;0
9812;202246;112;0;0;0;0;.00nan;0;0
9812;-1;112;87;36;2;34;.944;3600000;0
9813;200233;108;60;22;2;20;.909;3600000;0
9813;196324;110;0;0;0;0;.00nan;0;0
9813;196372;108;0;0;0;0;.00nan;0;0
9813;197010;110;35;37;7;30;.811;3600000;0
9814;200353;123;0;0;0;0;.00nan;0;0
9814;195111;125;70;31;3;28;.903;3600000;0
9814;195392;125;0;0;0;0;.00nan;0;0
9814;-1;123;22;38;8;30;.789;3600000;0
9815;203412;117;32;31;6;25;.806;2419000;0
9815;197059;113;94;36;1;35;.972;3600000;0
9815;-1;113;0;0;0;0;.00nan;0;0
9815;197768;117;43;15;2;13;.867;1181000;0
9816;204630;109;0;0;0;0;.00nan;0;0
9816;195001;126;0;0;0;0;.00nan;0;0
9816;212039;126;69;22;2;20;.909;3600000;0
9816;197038;109;81;43;4;39;.907;3550000;0
9817;197999;116;0;0;0;0;.00nan;0;0
9817;195089;124;81;39;3;36;.923;3600000;0
9817;206731;124;0;0;0;0;.00nan;0;0
9817;-1;116;46;31;5;26;.839;3584000;0
9818;192780;118;0;0;0;0;.00nan;0;0
9818;192948;111;0;0;0;0;.00nan;0;0
9818;196414;118;49;33;5;28;.848;3600000;0
9818;197912;111;53;30;4;26;.867;3600000;0
9819;192900;114;0;0;0;0;.00nan;0;0
9819;199481;122;63;33;3;30;.909;3600000;0
9819;205469;122;0;0;0;0;.00nan;0;0
9819;197047;114;91;20;0;20;1.000;3600000;0
9820;192776;119;86;22;1;21;.955;3600000;0
9820;200353;123;33;29;6;23;.793;3600000;0
9820;195017;119;0;0;0;0;.00nan;0;0
9820;-1;123;0;0;0;0;.00nan;0;0
9821;196324;110;54;17;2;15;.882;3600000;0
9821;207493;121;0;0;0;0;.00nan;0;0
9821;202279;121;86;42;3;39;.929;3600000;0
9821;197010;110;0;0;0;0;.00nan;0;0
9822;193687;120;91;41;2;39;.951;3600000;0
9822;200390;120;0;0;0;0;.00nan;0;0
9822;206864;127;0;0;0;0;.00nan;0;0
9822;202314;127;41;25;4;21;.840;3594000;0
9823;195001;126;0;0;0;0;.00nan;0;0
9823;195089;124;91;48;2;46;.958;3900000;0
9823;206731;124;0;0;0;0;.00nan;0;0
9823;212039;126;69;28;2;26;.929;3900000;0
9824;203412;117;78;25;1;24;.960;3600000;0
9824;199481;122;0;0;0;0;.00nan;0;0
9824;205469;122;60;37;5;32;.865;3600000;0
9824;197768;117;0;0;0;0;.00nan;0;0
9825;197999;116;66;24;2;22;.917;3552000;0
9825;207493;121;0;0;0;0;.00nan;0;0
9825;202279;121;95;33;1;32;.970;3600000;0
9825;-1;116;0;0;0;0;.00nan;0;0
9826;204630;109;0;0;0;0;.00nan;0;0
9826;195111;125;45;30;4;26;.867;3565000;0
9826;195392;125;0;0;0;0;.00nan;0;0
9826;197038;109;66;31;3;28;.903;3600000;0
9827;197999;116;0;0;0;0;.00nan;0;0
9827;202246;112;97;32;1;31;.969;3900000;0
9827;-1;112;0;0;0;0;.00nan;0;0
9827;-1;116;61;18;1;17;.944;3900000;0
9828;192948;111;0;0;0;0;.00nan;0;0
9828;196324;110;31;35;6;29;.829;3600000;0
9828;197010;110;0;0;0;0;.00nan;0;0
9828;197912;111;51;18;3;15;.833;3600000;0
9829;203412;117;0;0;0;0;.00nan;0;0
9829;202161;115;54;23;3;20;.870;3600000;0
9829;207439;115;0;0;0;0;.00nan;0;0
9829;197768;117;51;42;5;37;.881;3532000;0
9830;192900;114;0;0;0;0;.00nan;0;0
9830;200233;108;0;0;0;0;.00nan;0;0
9830;196372;108;100;33;0;33;1.000;3600000;0
9830;197047;114;82;29;1;28;.966;3567000;0
9831;193687;120;0;0;0;0;.00nan;0;0
9831;199481;122;0;0;0;0;.00nan;0;0
9831;200390;120;48;29;4;25;.862;3654000;0
9831;205469;122;63;41;5;36;.878;3654000;0
9832;192776;119;59;24;4;20;.833;3615000;0
9832;204630;109;0;0;0;0;.00nan;0;0
9832;195017;119;0;0;0;0;.00nan;0;0
9832;197038;109;80;34;3;31;.912;3615000;0
9833;207493;121;0;0;0;0;.00nan;0;0
9833;202279;121;68;35;4;31;.886;3526000;0
9833;197059;113;0;0;0;0;.00nan;0;0
9833;-1;113;60;21;3;18;.857;3600000;0
9834;195111;125;0;0;0;0;.00nan;0;0
9834;195392;125;92;32;1;31;.969;3600000;0
9834;206864;127;90;41;3;38;.927;3542000;0
9834;202314;127;0;0;0;0;.00nan;0;0
9835;200353;123;87;33;1;32;.970;3028000;0
9835;195001;126;0;0;0;0;.00nan;0;0
9835;212039;126;79;23;1;22;.957;3600000;0
9835;-1;123;38;14;3;11;.786;572000;0
9836;192948;111;35;37;6;31;.838;3528000;0
9836;202161;115;0;0;0;0;.00nan;0;0
9836;207439;115;47;31;4;27;.871;3600000;0
9836;197912;111;0;0;0;0;.00nan;0;0
9837;192780;118;0;0;0;0;.00nan;0;0
9837;193687;120;46;34;5;29;.853;3598000;0
9837;200390;120;0;0;0;0;.00nan;0;0
9837;196414;118;66;29;3;26;.897;3600000;0
9838;195001;126;61;43;5;38;.884;3600000;0
9838;195089;124;63;20;2;18;.900;3600000;0
9838;206731;124;0;0;0;0;.00nan;0;0
9838;212039;126;0;0;0;0;.00nan;0;0
9839;199481;122;86;43;3;40;.930;3579000;0
9839;200233;108;0;0;0;0;.00nan;0;0
9839;205469;122;0;0;0;0;.00nan;0;0
9839;196372;108;72;20;1;19;.950;3600000;0
9840;192900;114;26;6;3;3;.500;513000;0
9840;195111;125;76;26;1;25;.962;3600000;0
9840;195392;125;0;0;0;0;.00nan;0;0
9840;197047;114;47;17;3;14;.824;3087000;0
9841;200353;123;0;0;0;0;.00nan;0;0
9841;206864;127;0;0;0;0;.00nan;0;0
9841;202314;127;45;21;4;17;.810;3600000;0
9841;-1;123;40;29;5;24;.828;3600000;0
9842;203412;117;3;13;6;7;.538;1621000;0
9842;202246;112;0;0;0;0;.00nan;0;0
9842;-1;112;47;34;5;29;.853;3600000;0
9842;197768;117;71;16;0;16;1.000;1979000;0
9843;197999;116;0;0;0;0;.00nan;0;0
9843;197059;113;49;31;4;27;.871;3600000;0
9843;-1;113;0;0;0;0;.00nan;0;0
9843;-1;116;70;38;3;35;.921;3600000;0
9844;204630;109;0;0;0;0;.00nan;0;0
9844;207493;121;0;0;0;0;.00nan;0;0
9844;202279;121;45;18;3;15;.833;3900000;0
9844;197038;109;74;37;3;34;.919;3900000;0
9845;192900;114;77;40;3;37;.925;3668000;0
9845;206864;127;58;24;2;22;.917;3668000;0
9845;202314;127;0;0;0;0;.00nan;0;0
9845;197047;114;0;0;0;0;.00nan;0;0
9846;200353;123;100;34;0;34;1.000;3600000;0
9846;195089;124;0;0;0;0;.00nan;0;0
9846;206731;124;58;33;4;29;.879;3600000;0
9846;-1;123;0;0;0;0;.00nan;0;0
9847;192780;118;33;11;3;8;.727;495000;0
9847;196324;110;0;0;0;0;.00nan;0;0
9847;196414;118;34;36;7;29;.806;3105000;0
9847;197010;110;52;21;3;18;.857;3600000;0
9848;207493;121;72;38;3;35;.921;3600000;0
9848;202246;112;34;22;5;17;.773;3579000;0
9848;202279;121;0;0;0;0;.00nan;0;0
9848;-1;112;0;0;0;0;.00nan;0;0
9849;192780;118;0;0;0;0;.00nan;0;0
9849;195089;124;57;31;4;27;.871;3531000;0
9849;206731;124;0;0;0;0;.00nan;0;0
9849;196414;118;72;28;2;26;.929;3600000;0
9850;197999;116;0;0;0;0;.00nan;0;0
9850;197059;113;58;6;0;6;1.000;379000;0
9850;-1;113;31;31;6;25;.806;3221000;0
9850;-1;116;82;31;2;29;.935;3600000;0
9851;200233;108;0;0;0;0;.00nan;0;0
9851;196324;110;51;28;4;24;.857;3600000;0
9851;196372;108;59;39;5;34;.872;3600000;0
9851;197010;110;0;0;0;0;.00nan;0;0
9852;193687;120;41;24;4;20;.833;3600000;0
9852;200390;120;0;0;0;0;.00nan;0;0
9852;195111;125;19;11;5;6;.545;1146000;0
9852;195392;125;65;18;2;16;.889;2454000;0
9853;199481;122;0;0;0;0;.00nan;0;0
9853;200353;123;65;23;2;21;.913;3600000;0
9853;205469;122;46;36;5;31;.861;3600000;0
9853;-1;123;0;0;0;0;.00nan;0;0
9854;203412;117;68;31;3;28;.903;3891000;0
9854;192948;111;0;0;0;0;.00nan;0;0
9854;197768;117;0;0;0;0;.00nan;0;0
9854;197912;111;73;36;3;33;.917;3900000;0
9855;204630;109;0;0;0;0;.00nan;0;0
9855;207493;121;0;0;0;0;.00nan;0;0
9855;202279;121;60;31;4;27;.871;3600000;0
9855;197038;109;48;33;5;28;.848;3546000;0
9856;199481;122;33;24;5;19;.792;2293000;0
9856;205469;122;52;10;1;9;.900;1307000;0
9856;195089;124;68;21;1;20;.952;3600000;0
9856;206731;124;0;0;0;0;.00nan;0;0
9857;197999;116;66;26;2;24;.923;3600000;0
9857;193687;120;0;0;0;0;.00nan;0;0
9857;200390;120;46;27;4;23;.852;3593000;0
9857;-1;116;0;0;0;0;.00nan;0;0
9858;192776;119;0;0;0;0;.00nan;0;0
9858;195017;119;83;24;1;23;.958;3600000;0
9858;202246;112;0;0;0;0;.00nan;0;0
9858;-1;112;67;51;6;45;.882;3600000;0
9859;192900;114;0;0;0;0;.00nan;0;0
9859;197047;114;62;20;2;18;.900;3600000;0
9859;197059;113;0;0;0;0;.00nan;0;0
9859;-1;113;68;35;3;32;.914;3549000;0
9860;192780;118;0;0;0;0;.00nan;0;0
9860;206864;127;0;0;0;0;.00nan;0;0
9860;196414;118;47;25;4;21;.840;3527000;0
9860;202314;127;54;18;2;16;.889;3600000;0
9861;200353;123;0;0;0;0;.00nan;0;0
9861;202161;115;33;4;2;2;.500;718000;0
9861;207439;115;37;32;6;26;.813;2882000;0
9861;-1;123;81;32;2;30;.938;3600000;0
9862;200233;108;53;26;4;22;.846;3600000;0
9862;196324;110;52;31;4;27;.871;3067000;0
9862;196372;108;0;0;0;0;.00nan;0;0
9862;197010;110;23;4;3;1;.250;533000;0
9863;192948;111;44;23;4;19;.826;3600000;0
9863;207493;121;52;45;6;39;.867;2886000;0
9863;202279;121;43;4;1;3;.750;714000;0
9863;197912;111;0;0;0;0;.00nan;0;0
9864;197999;116;0;0;0;0;.00nan;0;0
9864;192900;114;78;35;2;33;.943;3575000;0
9864;197047;114;0;0;0;0;.00nan;0;0
9864;-1;116;70;21;1;20;.952;3600000;0
9865;195089;124;0;0;0;0;.00nan;0;0
9865;206731;124;42;30;5;25;.833;3600000;0
9865;202161;115;32;33;7;26;.788;2892000;0
9865;207439;115;42;3;1;2;.667;708000;0
9866;192776;119;23;32;7;25;.781;3001000;0
9866;192780;118;36;29;6;23;.793;3600000;0
9866;195017;119;49;6;1;5;.833;587000;0
9866;196414;118;0;0;0;0;.00nan;0;0
9867;195001;126;0;0;0;0;.00nan;0;0
9867;195111;125;0;0;0;0;.00nan;0;0
9867;195392;125;61;58;7;51;.879;3600000;0
9867;212039;126;51;21;3;18;.857;3600000;0
9868;203412;117;65;33;3;30;.909;3600000;0
9868;204630;109;74;45;4;41;.911;3551000;0
9868;197038;109;0;0;0;0;.00nan;0;0
9868;197768;117;0;0;0;0;.00nan;0;0
9869;199481;122;69;34;3;31;.912;3600000;0
9869;205469;122;0;0;0;0;.00nan;0;0
9869;206864;127;0;0;0;0;.00nan;0;0
9869;202314;127;93;32;1;31;.969;3600000;0
9870;195001;126;84;22;1;21;.955;3600000;0
9870;195111;125;46;46;7;39;.848;3600000;0
9870;195392;125;0;0;0;0;.00nan;0;0
9870;212039;126;0;0;0;0;.00nan;0;0
9871;192776;119;42;24;4;20;.833;3724000;0
9871;193687;120;58;32;5;27;.844;3724000;0
9871;200390;120;0;0;0;0;.00nan;0;0
9871;195017;119;0;0;0;0;.00nan;0;0
9872;196324;110;0;0;0;0;.00nan;0;0
9872;202246;112;53;30;4;26;.867;3600000;0
9872;197010;110;54;34;5;29;.853;3550000;0
9872;-1;112;0;0;0;0;.00nan;0;0
9873;200353;123;0;0;0;0;.00nan;0;0
9873;206864;127;31;19;5;14;.737;3562000;0
9873;202314;127;0;0;0;0;.00nan;0;0
9873;-1;123;70;30;3;27;.900;3600000;0
9874;192780;118;0;0;0;0;.00nan;0;0
9874;193687;120;59;29;4;25;.862;3900000;0
9874;200390;120;0;0;0;0;.00nan;0;0
9874;196414;118;90;55;4;51;.927;3900000;0
9875;200353;123;23;34;7;27;.794;2940000;0
9875;195089;124;46;30;5;25;.833;3600000;0
9875;206731;124;0;0;0;0;.00nan;0;0
9875;-1;123;68;9;0;9;1.000;660000;0
9876;203412;117;79;32;2;30;.938;3600000;0
9876;192948;111;36;13;3;10;.769;1461000;0
9876;197768;117;0;0;0;0;.00nan;0;0
9876;197912;111;23;28;6;22;.786;2139000;0
9877;197999;116;78;23;1;22;.957;3550000;0
9877;195001;126;0;0;0;0;.00nan;0;0
9877;212039;126;47;29;4;25;.862;3900000;0
9877;-1;116;30;7;3;4;.571;350000;0
9878;192900;114;0;0;0;0;.00nan;0;0
9878;197047;114;86;35;2;33;.943;3553000;0
9878;197059;113;0;0;0;0;.00nan;0;0
9878;-1;113;99;40;1;39;.975;3600000;0
9879;200233;108;0;0;0;0;.00nan;0;0
9879;206864;127;0;0;0;0;.00nan;0;0
9879;196372;108;48;22;4;18;.818;3600000;0
9879;202314;127;76;49;5;44;.898;3600000;0
9880;192776;119;55;37;6;31;.838;3900000;0
9880;195017;119;0;0;0;0;.00nan;0;0
9880;195111;125;57;16;1;15;.938;1807000;0
9880;195392;125;49;32;5;27;.844;2093000;0
9881;192900;114;42;30;5;25;.833;3600000;0
9881;202246;112;0;0;0;0;.00nan;0;0
9881;-1;112;92;34;1;33;.971;3600000;0
9881;197047;114;0;0;0;0;.00nan;0;0
9882;192948;111;0;0;0;0;.00nan;0;0
9882;206864;127;57;36;4;32;.889;3571000;0
9882;202314;127;0;0;0;0;.00nan;0;0
9882;197912;111;70;29;2;27;.931;3600000;0
9883;204630;109;0;0;0;0;.00nan;0;0
9883;196324;110;73;25;3;22;.880;3543000;0
9883;197010;110;0;0;0;0;.00nan;0;0
9883;197038;109;94;36;2;34;.944;3600000;0
9884;203412;117;32;18;4;14;.778;1729000;0
9884;202161;115;0;0;0;0;.00nan;0;0
9884;207439;115;32;23;5;18;.783;3600000;0
9884;197768;117;38;27;6;21;.778;1871000;0
9885;199481;122;0;0;0;0;.00nan;0;0
9885;205469;122;60;30;3;27;.900;3600000;0
9885;197059;113;39;34;6;28;.824;3068000;0
9885;-1;113;48;0;0;0;.00nan;532000;0
9886;193687;120;0;0;0;0;.00nan;0;0
9886;200233;108;63;44;5;39;.886;3900000;0
9886;200390;120;72;46;5;41;.891;3900000;0
9886;196372;108;0;0;0;0;.00nan;0;0
9887;192776;119;0;0;0;0;.00nan;0;0
9887;192780;118;0;0;0;0;.00nan;0;0
9887;195017;119;71;26;2;24;.923;3600000;0
9887;196414;118;64;36;4;32;.889;3544000;0
9888;195089;124;59;18;3;15;.833;3900000;0
9888;206731;124;0;0;0;0;.00nan;0;0
9888;207493;121;0;0;0;0;.00nan;0;0
9888;202279;121;58;30;3;27;.900;3900000;0
9889;202246;112;82;28;2;26;.929;3651000;0
9889;-1;112;0;0;0;0;.00nan;0;0
9889;197059;113;0;0;0;0;.00nan;0;0
9889;-1;113;64;32;3;29;.906;3651000;0
9890;192900;114;0;0;0;0;.00nan;0;0
9890;195001;126;0;0;0;0;.00nan;0;0
9890;212039;126;51;25;4;21;.840;3900000;0
9890;197047;114;92;48;4;44;.917;3854000;0
9891;199481;122;81;33;2;31;.939;3600000;0
9891;205469;122;0;0;0;0;.00nan;0;0
9891;195089;124;0;0;0;0;.00nan;0;0
9891;206731;124;44;31;5;26;.839;3600000;0
9892;192780;118;0;0;0;0;.00nan;0;0
9892;196414;118;70;34;3;31;.912;3900000;0
9892;202161;115;88;40;3;37;.925;3900000;0
9892;207439;115;0;0;0;0;.00nan;0;0
9893;192776;119;0;0;0;0;.00nan;0;0
9893;195017;119;65;21;2;19;.905;3600000;0
9893;207493;121;48;29;5;24;.828;3600000;0
9893;202279;121;0;0;0;0;.00nan;0;0
9894;204630;109;86;58;4;54;.931;3600000;0
9894;196324;110;0;0;0;0;.00nan;0;0
9894;197010;110;56;8;1;7;.875;3600000;0
9894;197038;109;0;0;0;0;.00nan;0;0
9895;200353;123;0;0;0;0;.00nan;0;0
9895;195111;125;86;29;1;28;.966;3600000;0
9895;195392;125;0;0;0;0;.00nan;0;0
9895;-1;123;51;34;5;29;.853;3600000;0
9896;197999;116;0;0;0;0;.00nan;0;0
9896;203412;117;48;34;5;29;.853;3538000;0
9896;197768;117;0;0;0;0;.00nan;0;0
9896;-1;116;58;25;3;22;.880;3600000;0
9897;204630;109;0;0;0;0;.00nan;0;0
9897;206864;127;0;0;0;0;.00nan;0;0
9897;202314;127;31;19;4;15;.789;3524000;0
9897;197038;109;86;34;2;32;.941;3600000;0
9898;193687;120;59;36;5;31;.861;3600000;0
9898;200390;120;0;0;0;0;.00nan;0;0
9898;195001;126;63;23;2;21;.913;3600000;0
9898;212039;126;0;0;0;0;.00nan;0;0
9899;200233;108;0;0;0;0;.00nan;0;0
9899;196372;108;59;40;4;36;.900;3900000;0
9899;202246;112;0;0;0;0;.00nan;0;0
9899;-1;112;79;45;4;41;.911;3900000;0
9900;200353;123;0;0;0;0;.00nan;0;0
9900;195111;125;0;0;0;0;.00nan;0;0
9900;195392;125;80;37;3;34;.919;3588000;0
9900;-1;123;76;33;2;31;.939;3600000;0
9901;192948;111;0;0;0;0;.00nan;0;0
9901;196324;110;60;14;1;13;.929;3600000;0
9901;197010;110;0;0;0;0;.00nan;0;0
9901;197912;111;84;32;2;30;.938;3600000;0
9902;192948;111;0;0;0;0;.00nan;0;0
9902;204630;109;96;32;1;31;.969;3600000;0
9902;197038;109;0;0;0;0;.00nan;0;0
9902;197912;111;45;14;2;12;.857;3571000;0
9903;192776;119;61;27;3;24;.889;3530000;0
9903;195017;119;0;0;0;0;.00nan;0;0
9903;207493;121;0;0;0;0;.00nan;0;0
9903;202279;121;98;35;1;34;.971;3600000;0
9904;206864;127;0;0;0;0;.00nan;0;0
9904;202246;112;0;0;0;0;.00nan;0;0
9904;202314;127;63;34;3;31;.912;3580000;0
9904;-1;112;59;15;1;14;.933;3600000;0
9905;195001;126;0;0;0;0;.00nan;0;0
9905;212039;126;77;21;1;20;.952;3600000;0
9905;197059;113;57;48;6;42;.875;2816000;0
9905;-1;113;20;10;4;6;.600;784000;0
9906;197999;116;47;23;4;19;.826;3600000;0
9906;200233;108;62;30;3;27;.900;3600000;0
9906;196372;108;0;0;0;0;.00nan;0;0
9906;-1;116;0;0;0;0;.00nan;0;0
9907;192900;114;0;0;0;0;.00nan;0;0
9907;203412;117;63;46;6;40;.870;3565000;0
9907;197047;114;55;33;4;29;.879;3600000;0
9907;197768;117;0;0;0;0;.00nan;0;0
9908;192780;118;0;0;0;0;.00nan;0;0
9908;195111;125;28;22;5;17;.773;2131000;0
9908;195392;125;61;15;1;14;.933;1469000;0
9908;196414;118;39;28;5;23;.821;3600000;0
9909;192948;111;0;0;0;0;.00nan;0;0
9909;202161;115;48;38;5;33;.868;3579000;0
9909;207439;115;0;0;0;0;.00nan;0;0
9909;197912;111;58;34;4;30;.882;3600000;0
9910;204630;109;58;5;0;5;1.000;331000;0
9910;202246;112;33;28;5;23;.821;3600000;0
9910;-1;112;0;0;0;0;.00nan;0;0
9910;197038;109;42;38;7;31;.816;3192000;0
9911;199481;122;0;0;0;0;.00nan;0;0
9911;200353;123;0;0;0;0;.00nan;0;0
9911;205469;122;64;21;2;19;.905;3600000;0
9911;-1;123;70;36;3;33;.917;3600000;0
9912;193687;120;0;0;0;0;.00nan;0;0
9912;200390;120;50;30;4;26;.867;3542000;0
9912;195111;125;100;57;3;54;.947;3600000;0
9912;195392;125;0;0;0;0;.00nan;0;0
9913;192776;119;17;28;7;21;.750;3261000;0
9913;195017;119;53;2;0;2;1.000;339000;0
9913;195089;124;15;28;7;21;.750;3199000;0
9913;206731;124;45;4;1;3;.750;349000;0
9914;200233;108;0;0;0;0;.00nan;0;0
9914;196372;108;91;32;1;31;.969;3600000;0
9914;197059;113;0;0;0;0;.00nan;0;0
9914;-1;113;51;30;4;26;.867;3600000;0
9915;192780;118;0;0;0;0;.00nan;0;0
9915;206864;127;43;31;5;26;.839;3553000;0
9915;196414;118;64;32;4;28;.875;3600000;0
9915;202314;127;0;0;0;0;.00nan;0;0
9916;197999;116;0;0;0;0;.00nan;0;0
9916;195001;126;0;0;0;0;.00nan;0;0
9916;212039;126;70;29;2;27;.931;3600000;0
9916;-1;116;64;27;3;24;.889;3549000;0
9917;192900;114;0;0;0;0;.00nan;0;0
9917;207493;121;38;31;6;25;.806;3154000;0
9917;202279;121;52;2;0;2;1.000;446000;0
9917;197047;114;65;17;1;16;.941;3600000;0
9918;204630;109;69;32;3;29;.906;3600000;0
9918;202161;115;0;0;0;0;.00nan;0;0
9918;207439;115;50;29;4;25;.862;3570000;0
9918;197038;109;0;0;0;0;.00nan;0;0
9919;192948;111;62;31;4;27;.871;3600000;0
9919;202246;112;0;0;0;0;.00nan;0;0
9919;-1;112;55;29;5;24;.828;3551000;0
9919;197912;111;0;0;0;0;.00nan;0;0
9920;192900;114;74;21;1;20;.952;3600000;0
9920;200353;123;67;27;3;24;.889;3600000;0
9920;197047;114;0;0;0;0;.00nan;0;0
9920;-1;123;0;0;0;0;.00nan;0;0
9921;192780;118;0;0;0;0;.00nan;0;0
9921;195089;124;0;0;0;0;.00nan;0;0
9921;206731;124;58;20;2;18;.900;3600000;0
9921;196414;118;73;31;3;28;.903;3545000;0
9922;192776;119;0;0;0;0;.00nan;0;0
9922;199481;122;82;28;2;26;.929;3600000;0
9922;205469;122;0;0;0;0;.00nan;0;0
9922;195017;119;58;33;4;29;.879;3515000;0
9923;193687;120;29;20;5;15;.750;3514000;0
9923;200390;120;0;0;0;0;.00nan;0;0
9923;195111;125;0;0;0;0;.00nan;0;0
9923;195392;125;76;37;3;34;.919;3600000;0
9924;203412;117;48;27;4;23;.852;3557000;0
9924;207493;121;0;0;0;0;.00nan;0;0
9924;202279;121;59;26;3;23;.885;3600000;0
9924;197768;117;0;0;0;0;.00nan;0;0
9925;197999;116;0;0;0;0;.00nan;0;0
9925;197059;113;70;38;3;35;.921;3542000;0
9925;-1;113;0;0;0;0;.00nan;0;0
9925;-1;116;52;15;2;13;.867;3600000;0
9926;200233;108;50;3;0;3;1.000;758000;0
9926;196324;110;82;34;2;32;.941;3600000;0
9926;196372;108;46;41;6;35;.854;2842000;0
9926;197010;110;0;0;0;0;.00nan;0;0
9927;195089;124;86;41;2;39;.951;3600000;0
9927;206731;124;0;0;0;0;.00nan;0;0
9927;206864;127;0;0;0;0;.00nan;0;0
9927;202314;127;57;42;5;37;.881;3600000;0
9928;193687;120;0;0;0;0;.00nan;0;0
9928;199481;122;62;7;0;7;1.000;646000;0
9928;200390;120;84;42;3;39;.929;3600000;0
9928;205469;122;40;31;6;25;.806;2954000;0
9929;200353;123;0;0;0;0;.00nan;0;0
9929;195089;124;59;32;4;28;.875;3600000;0
9929;206731;124;0;0;0;0;.00nan;0;0
9929;-1;123;46;33;5;28;.848;3553000;0
9930;192780;118;0;0;0;0;.00nan;0;0
9930;203412;117;41;17;3;14;.824;3600000;0
9930;196414;118;46;40;6;34;.850;3600000;0
9930;197768;117;0;0;0;0;.00nan;0;0
9931;197999;116;0;0;0;0;.00nan;0;0
9931;192776;119;41;34;6;28;.824;3029000;0
9931;195017;119;56;5;0;5;1.000;571000;0
9931;-1;116;54;20;3;17;.850;3600000;0
9932;192900;114;0;0;0;0;.00nan;0;0
9932;202246;112;56;47;6;41;.872;3057000;0
9932;-1;112;54;3;0;3;1.000;543000;0
9932;197047;114;43;20;5;15;.750;3600000;0
9933;199481;122;48;26;4;22;.846;3600000;0
9933;205469;122;0;0;0;0;.00nan;0;0
9933;195001;126;0;0;0;0;.00nan;0;0
9933;212039;126;71;19;1;18;.947;3600000;0
9934;200233;108;46;16;3;13;.813;3600000;0
9934;195111;125;62;39;5;34;.872;3540000;0
9934;195392;125;0;0;0;0;.00nan;0;0
9934;196372;108;0;0;0;0;.00nan;0;0
9935;195001;126;58;24;3;21;.875;3578000;0
9935;212039;126;0;0;0;0;.00nan;0;0
9935;202246;112;0;0;0;0;.00nan;0;0
9935;-1;112;86;32;1;31;.969;3600000;0
9936;192948;111;0;0;0;0;.00nan;0;0
9936;195111;125;0;0;0;0;.00nan;0;0
9936;195392;125;100;39;1;38;.974;3600000;0
9936;197912;111;67;25;2;23;.920;3600000;0
9937;200233;108;61;25;3;22;.880;2794000;0
9937;196372;108;29;15;4;11;.733;1061000;0
9937;202161;115;0;0;0;0;.00nan;0;0
9937;207439;115;16;32;7;25;.781;3900000;0
9938;192780;118;79;32;2;30;.938;1813000;0
9938;193687;120;0;0;0;0;.00nan;0;0
9938;200390;120;40;19;4;15;.789;3600000;0
9938;196414;118;29;23;6;17;.739;1787000;0
9939;192776;119;0;0;0;0;.00nan;0;0
9939;195017;119;81;41;3;38;.927;3600000;0
9939;197059;113;0;0;0;0;.00nan;0;0
9939;-1;113;72;30;2;28;.933;3600000;0
9940;197999;116;78;15;0;15;1.000;3600000;0
9940;207493;121;0;0;0;0;.00nan;0;0
9940;202279;121;65;45;5;40;.889;3600000;0
9940;-1;116;0;0;0;0;.00nan;0;0
9941;204630;109;0;0;0;0;.00nan;0;0
9941;196324;110;0;0;0;0;.00nan;0;0
9941;197010;110;76;34;3;31;.912;3900000;0
9941;197038;109;69;33;3;30;.909;3900000;0
9942;204630;109;0;0;0;0;.00nan;0;0
9942;196324;110;0;0;0;0;.00nan;0;0
9942;197010;110;71;24;1;23;.958;3600000;0
9942;197038;109;98;48;2;46;.958;3600000;0
9943;193687;120;91;22;0;22;1.000;3600000;0
9943;200390;120;0;0;0;0;.00nan;0;0
9943;207493;121;95;30;1;29;.967;3564000;0
9943;202279;121;0;0;0;0;.00nan;0;0
9944;192900;114;0;0;0;0;.00nan;0;0
9944;195089;124;66;26;2;24;.923;3600000;0
9944;206731;124;0;0;0;0;.00nan;0;0
9944;197047;114;49;38;6;32;.842;3600000;0
9945;199481;122;74;23;2;21;.913;3900000;0
9945;205469;122;0;0;0;0;.00nan;0;0
9945;202161;115;70;28;2;26;.929;3900000;0
9945;207439;115;0;0;0;0;.00nan;0;0
9946;197999;116;0;0;0;0;.00nan;0;0
9946;192780;118;64;34;3;31;.912;3716000;0
9946;196414;118;0;0;0;0;.00nan;0;0
9946;-1;116;73;31;2;29;.935;3716000;0
9947;200353;123;34;31;6;25;.806;3600000;0
9947;206864;127;70;26;2;24;.923;3600000;0
9947;202314;127;0;0;0;0;.00nan;0;0
9947;-1;123;0;0;0;0;.00nan;0;0
9948;192776;119;0;0;0;0;.00nan;0;0
9948;203412;117;45;28;4;24;.857;3600000;0
9948;195017;119;60;41;5;36;.878;3536000;0
9948;197768;117;0;0;0;0;.00nan;0;0
9949;192948;111;0;0;0;0;.00nan;0;0
9949;202246;112;80;25;1;24;.960;3552000;0
9949;-1;112;0;0;0;0;.00nan;0;0
9949;197912;111;100;30;0;30;1.000;3600000;0
9950;204630;109;79;53;5;48;.906;3580000;0
9950;195111;125;0;0;0;0;.00nan;0;0
9950;195392;125;48;19;3;16;.842;3600000;0
9950;197038;109;0;0;0;0;.00nan;0;0
9951;206864;127;0;0;0;0;.00nan;0;0
9951;207493;121;0;0;0;0;.00nan;0;0
9951;202279;121;48;34;5;29;.853;3600000;0
9951;202314;127;62;29;3;26;.897;3600000;0
9952;195001;126;0;0;0;0;.00nan;0;0
9952;212039;126;60;14;1;13;.929;3600000;0
9952;202161;115;0;0;0;0;.00nan;0;0
9952;207439;115;40;38;6;32;.842;3600000;0
9953;193687;120;100;26;0;26;1.000;3600000;0
9953;200390;120;0;0;0;0;.00nan;0;0
9953;195089;124;0;0;0;0;.00nan;0;0
9953;206731;124;43;29;4;25;.862;3600000;0
9954;192900;114;0;0;0;0;.00nan;0;0
9954;200353;123;0;0;0;0;.00nan;0;0
9954;197047;114;59;28;4;24;.857;3600000;0
9954;-1;123;47;34;5;29;.853;3588000;0
9955;196324;110;72;24;2;22;.917;3600000;0
9955;197010;110;0;0;0;0;.00nan;0;0
9955;197059;113;16;17;5;12;.706;1129000;0
9955;-1;113;54;38;5;33;.868;2471000;0
9956;200233;108;40;26;4;22;.846;3600000;0
9956;196372;108;0;0;0;0;.00nan;0;0
9956;197059;113;1;25;9;16;.640;2348000;0
9956;-1;113;60;17;1;16;.941;1252000;0
9957;192948;111;0;0;0;0;.00nan;0;0
9957;204630;109;0;0;0;0;.00nan;0;0
9957;197038;109;46;33;5;28;.848;3600000;0
9957;197912;111;83;19;0;19;1.000;3600000;0
9958;202161;115;86;34;1;33;.971;3600000;0
9958;207439;115;0;0;0;0;.00nan;0;0
9958;207493;121;0;0;0;0;.00nan;0;0
9958;202279;121;72;27;2;25;.926;3546000;0
9959;192900;114;0;0;0;0;.00nan;0;0
9959;202246;112;54;29;4;25;.862;3752000;0
9959;-1;112;0;0;0;0;.00nan;0;0
9959;197047;114;48;29;5;24;.828;3752000;0
9960;193687;120;57;31;4;27;.871;3600000;0
9960;199481;122;68;27;2;25;.926;3600000;0
9960;200390;120;0;0;0;0;.00nan;0;0
9960;205469;122;0;0;0;0;.00nan;0;0
9961;200353;123;61;42;5;37;.881;3521000;0
9961;195001;126;0;0;0;0;.00nan;0;0
9961;212039;126;54;25;3;22;.880;3600000;0
9961;-1;123;0;0;0;0;.00nan;0;0
9962;203412;117;100;29;1;28;.966;3600000;0
9962;195111;125;55;42;6;36;.857;2842000;0
9962;195392;125;47;9;2;7;.778;758000;0
9962;197768;117;0;0;0;0;.00nan;0;0
9963;200233;108;60;28;4;24;.857;3600000;0
9963;195089;124;2;17;7;10;.588;1793000;0
9963;206731;124;47;13;2;11;.846;1807000;0
9963;196372;108;0;0;0;0;.00nan;0;0
9964;197999;116;0;0;0;0;.00nan;0;0
9964;192948;111;0;0;0;0;.00nan;0;0
9964;197912;111;37;28;6;22;.786;3600000;0
9964;-1;116;77;36;3;33;.917;3600000;0
9965;192900;114;0;0;0;0;.00nan;0;0
9965;193687;120;0;0;0;0;.00nan;0;0
9965;200390;120;59;27;3;24;.889;3600000;0
9965;197047;114;65;51;6;45;.882;3600000;0
9966;192776;119;33;31;6;25;.806;3551000;0
9966;195017;119;0;0;0;0;.00nan;0;0
9966;202161;115;74;47;5;42;.894;3600000;0
9966;207439;115;0;0;0;0;.00nan;0;0
9967;203412;117;0;0;0;0;.00nan;0;0
9967;197059;113;0;0;0;0;.00nan;0;0
9967;-1;113;79;49;4;45;.918;3600000;0
9967;197768;117;55;26;3;23;.885;3600000;0
9968;206864;127;0;0;0;0;.00nan;0;0
9968;202246;112;0;0;0;0;.00nan;0;0
9968;202314;127;50;23;3;20;.870;3546000;0
9968;-1;112;91;30;2;28;.933;3600000;0
9969;200353;123;0;0;0;0;.00nan;0;0
9969;195001;126;0;0;0;0;.00nan;0;0
9969;212039;126;48;21;4;17;.810;3571000;0
9969;-1;123;94;40;2;38;.950;3600000;0
9970;195111;125;0;0;0;0;.00nan;0;0
9970;195392;125;56;30;4;26;.867;3600000;0
9970;207493;121;97;24;0;24;1.000;3600000;0
9970;202279;121;0;0;0;0;.00nan;0;0
9971;204630;109;27;20;5;15;.750;2077000;0
9971;195089;124;40;23;4;19;.826;3600000;0
9971;206731;124;0;0;0;0;.00nan;0;0
9971;197038;109;61;19;3;16;.842;1523000;0
9972;196324;110;0;0;0;0;.00nan;0;0
9972;202246;112;81;29;1;28;.966;3600000;0
9972;197010;110;74;34;2;32;.941;3568000;0
9972;-1;112;0;0;0;0;.00nan;0;0
9973;192780;118;0;0;0;0;.00nan;0;0
9973;199481;122;82;36;3;33;.917;3600000;0
9973;205469;122;0;0;0;0;.00nan;0;0
9973;196414;118;56;32;5;27;.844;3531000;0
9974;197999;116;64;25;2;23;.920;3600000;0
9974;200233;108;77;38;3;35;.921;3586000;0
9974;196372;108;0;0;0;0;.00nan;0;0
9974;-1;116;0;0;0;0;.00nan;0;0
9975;192776;119;0;0;0;0;.00nan;0;0
9975;200353;123;84;32;1;31;.969;3900000;0
9975;195017;119;69;22;1;21;.955;3900000;0
9975;-1;123;0;0;0;0;.00nan;0;0
9976;203412;117;16;38;8;30;.789;3600000;0
9976;195001;126;79;26;1;25;.962;3600000;0
9976;212039;126;0;0;0;0;.00nan;0;0
9976;197768;117;0;0;0;0;.00nan;0;0
9977;192948;111;0;0;0;0;.00nan;0;0
9977;195089;124;0;0;0;0;.00nan;0;0
9977;206731;124;37;34;6;28;.824;3760000;0
9977;197912;111;53;31;5;26;.839;3760000;0
9978;197999;116;0;0;0;0;.00nan;0;0
9978;204630;109;0;0;0;0;.00nan;0;0
9978;197038;109;68;38;4;34;.895;3535000;0
9978;-1;116;73;25;2;23;.920;3600000;0
9979;202161;115;0;0;0;0;.00nan;0;0
9979;207439;115;54;38;5;33;.868;3600000;0
9979;197059;113;65;50;6;44;.880;3566000;0
9979;-1;113;0;0;0;0;.00nan;0;0
9980;192900;114;68;25;2;23;.920;3574000;0
9980;200233;108;0;0;0;0;.00nan;0;0
9980;196372;108;78;23;1;22;.957;3600000;0
9980;197047;114;0;0;0;0;.00nan;0;0
9981;196324;110;49;24;5;19;.792;2385000;0
9981;207493;121;47;46;7;39;.848;3722000;0
9981;202279;121;0;0;0;0;.00nan;0;0
9981;197010;110;69;16;1;15;.938;1337000;0
9982;192780;118;94;38;1;37;.974;3600000;0
9982;199481;122;0;0;0;0;.00nan;0;0
9982;205469;122;68;26;2;24;.923;3543000;0
9982;196414;118;0;0;0;0;.00nan;0;0
9983;193687;120;58;20;2;18;.900;3600000;0
9983;200390;120;0;0;0;0;.00nan;0;0
9983;206864;127;67;35;3;32;.914;3547000;0
9983;202314;127;0;0;0;0;.00nan;0;0
9984;193687;120;0;0;0;0;.00nan;0;0
9984;200390;120;59;18;2;16;.889;3600000;0
9984;207493;121;59;14;1;13;.929;770000;0
9984;202279;121;50;39;6;33;.846;2830000;0
9985;192776;119;29;13;4;9;.692;976000;0
9985;195017;119;57;18;2;16;.889;2624000;0
9985;206864;127;0;0;0;0;.00nan;0;0
9985;202314;127;76;35;3;32;.914;3600000;0
9986;204630;109;0;0;0;0;.00nan;0;0
9986;196324;110;0;0;0;0;.00nan;0;0
9986;197010;110;74;23;1;22;.957;3600000;0
9986;197038;109;73;40;4;36;.900;3600000;0
9987;195001;126;0;0;0;0;.00nan;0;0
9987;212039;126;52;23;3;20;.870;3600000;0
9987;197059;113;0;0;0;0;.00nan;0;0
9987;-1;113;72;47;5;42;.894;3559000;0
9988;203412;117;60;25;3;22;.880;3600000;0
9988;206864;127;31;30;7;23;.767;2683000;0
9988;202314;127;48;5;1;4;.800;917000;0
9988;197768;117;0;0;0;0;.00nan;0;0
9989;197999;116;0;0;0;0;.00nan;0;0
9989;192948;111;0;0;0;0;.00nan;0;0
9989;197912;111;58;40;5;35;.875;3792000;0
9989;-1;116;45;26;4;22;.846;3792000;0
9990;192900;114;0;0;0;0;.00nan;0;0
9990;199481;122;71;43;4;39;.907;3578000;0
9990;205469;122;0;0;0;0;.00nan;0;0
9990;197047;114;75;26;2;24;.923;3600000;0
9991;200233;108;77;23;1;22;.957;3739000;0
9991;196372;108;0;0;0;0;.00nan;0;0
9991;202246;112;0;0;0;0;.00nan;0;0
9991;-1;112;92;41;2;39;.951;3739000;0
9992;203412;117;0;0;0;0;.00nan;0;0
9992;195111;125;0;0;0;0;.00nan;0;0
9992;195392;125;70;28;3;25;.893;3600000;0
9992;197768;117;85;35;2;33;.943;3600000;0
9993;204630;109;0;0;0;0;.00nan;0;0
9993;200233;108;0;0;0;0;.00nan;0;0
9993;196372;108;82;32;1;31;.969;3600000;0
9993;197038;109;89;43;4;39;.907;3600000;0
9994;197999;116;0;0;0;0;.00nan;0;0
9994;202161;115;0;0;0;0;.00nan;0;0
9994;207439;115;78;36;2;34;.944;3600000;0
9994;-1;116;29;23;5;18;.783;3600000;0
9995;193687;120;74;23;1;22;.957;3600000;0
9995;200390;120;0;0;0;0;.00nan;0;0
9995;202246;112;40;41;6;35;.854;3600000;0
9995;-1;112;0;0;0;0;.00nan;0;0
9996;192776;119;81;27;1;26;.963;3900000;0
9996;200353;123;76;34;1;33;.971;3900000;0
9996;195017;119;0;0;0;0;.00nan;0;0
9996;-1;123;0;0;0;0;.00nan;0;0
9997;192900;114;0;0;0;0;.00nan;0;0
9997;197047;114;40;18;4;14;.778;3600000;0
9997;197059;113;50;36;5;31;.861;3600000;0
9997;-1;113;0;0;0;0;.00nan;0;0
9998;192948;111;82;47;3;44;.936;3600000;0
9998;195001;126;0;0;0;0;.00nan;0;0
9998;212039;126;63;15;1;14;.933;3600000;0
9998;197912;111;0;0;0;0;.00nan;0;0
9999;192780;118;0;0;0;0;.00nan;0;0
9999;196414;118;35;28;5;23;.821;3569000;0
9999;207493;121;79;36;3;33;.917;3600000;0
9999;202279;121;0;0;0;0;.00nan;0;0
10000;193687;120;0;0;0;0;.00nan;0;0
10000;200390;120;70;25;3;22;.880;3600000;0
10000;202246;112;73;21;1;20;.952;2450000;0
10000;-1;112;29;15;4;11;.733;1146000;0
10001;200353;123;65;13;0;13;1.000;978000;0
10001;195089;124;64;32;3;29;.906;3600000;0
10001;206731;124;0;0;0;0;.00nan;0;0
10001;-1;123;28;26;6;20;.769;2622000;0
10002;199481;122;0;0;0;0;.00nan;0;0
10002;205469;122;72;36;3;33;.917;3600000;0
10002;207493;121;0;0;0;0;.00nan;0;0
10002;202279;121;45;33;5;28;.848;3593000;0
10003;192780;118;64;34;4;30;.882;3584000;0
10003;206864;127;0;0;0;0;.00nan;0;0
10003;196414;118;0;0;0;0;.00nan;0;0
10003;202314;127;65;38;3;35;.921;3600000;0
10004;195111;125;0;0;0;0;.00nan;0;0
10004;195392;125;38;34;6;28;.824;3519000;0
10004;196324;110;0;0;0;0;.00nan;0;0
10004;197010;110;49;23;4;19;.826;3600000;0
10005;203412;117;27;35;7;28;.800;3869000;0
10005;202161;115;42;32;6;26;.813;3097000;0
10005;207439;115;67;13;0;13;1.000;772000;0
10005;197768;117;0;0;0;0;.00nan;0;0
10006;204630;109;69;21;1;20;.952;1521000;0
10006;200233;108;55;13;2;11;.846;3600000;0
10006;196372;108;0;0;0;0;.00nan;0;0
10006;197038;109;32;32;6;26;.813;2079000;0
10007;192948;111;0;0;0;0;.00nan;0;0
10007;197059;113;0;0;0;0;.00nan;0;0
10007;-1;113;83;31;1;30;.968;3600000;0
10007;197912;111;40;28;5;23;.821;3600000;0
10008;206864;127;27;42;8;34;.810;3600000;0
10008;196324;110;41;16;3;13;.813;3600000;0
10008;202314;127;0;0;0;0;.00nan;0;0
10008;197010;110;0;0;0;0;.00nan;0;0
10009;192776;119;0;0;0;0;.00nan;0;0
10009;195001;126;0;0;0;0;.00nan;0;0
10009;195017;119;59;27;4;23;.852;3701000;0
10009;212039;126;79;37;3;34;.919;3701000;0
10010;192900;114;0;0;0;0;.00nan;0;0
10010;202161;115;0;0;0;0;.00nan;0;0
10010;207439;115;65;38;4;34;.895;3556000;0
10010;197047;114;64;21;2;19;.905;3600000;0
10011;193687;120;34;28;5;23;.821;3554000;0
10011;200390;120;0;0;0;0;.00nan;0;0
10011;207493;121;87;57;4;53;.930;3600000;0
10011;202279;121;0;0;0;0;.00nan;0;0
10012;195089;124;0;0;0;0;.00nan;0;0
10012;195111;125;63;34;4;30;.882;3600000;0
10012;195392;125;0;0;0;0;.00nan;0;0
10012;206731;124;46;39;5;34;.872;3569000;0
10013;197999;116;0;0;0;0;.00nan;0;0
10013;195001;126;0;0;0;0;.00nan;0;0
10013;212039;126;44;35;5;30;.857;3600000;0
10013;-1;116;70;22;2;20;.909;3600000;0
10014;192780;118;0;0;0;0;.00nan;0;0
10014;196414;118;96;24;0;24;1.000;3600000;0
10014;207493;121;0;0;0;0;.00nan;0;0
10014;202279;121;65;22;2;20;.909;3570000;0
10015;196324;110;0;0;0;0;.00nan;0;0
10015;202161;115;62;27;3;24;.889;3600000;0
10015;207439;115;0;0;0;0;.00nan;0;0
10015;197010;110;53;23;4;19;.826;3541000;0
10016;192900;114;0;0;0;0;.00nan;0;0
10016;204630;109;0;0;0;0;.00nan;0;0
10016;197038;109;25;43;9;34;.791;3600000;0
10016;197047;114;80;24;1;23;.958;3600000;0
10017;192948;111;50;3;0;3;1.000;321000;0
10017;200233;108;0;0;0;0;.00nan;0;0
10017;196372;108;80;35;2;33;.943;3600000;0
10017;197912;111;32;41;7;34;.829;3279000;0
10018;192776;119;0;0;0;0;.00nan;0;0
10018;195017;119;69;26;2;24;.923;3600000;0
10018;195111;125;0;0;0;0;.00nan;0;0
10018;195392;125;64;29;4;25;.862;3600000;0
10019;200353;123;0;0;0;0;.00nan;0;0
10019;195089;124;72;35;3;32;.914;3579000;0
10019;206731;124;0;0;0;0;.00nan;0;0
10019;-1;123;66;26;2;24;.923;3600000;0
10020;203412;117;80;25;1;24;.960;3600000;0
10020;202246;112;79;38;4;34;.895;3600000;0
10020;-1;112;0;0;0;0;.00nan;0;0
10020;197768;117;0;0;0;0;.00nan;0;0
10021;192900;114;32;26;6;20;.769;3600000;0
10021;192948;111;67;35;3;32;.914;3600000;0
10021;197047;114;0;0;0;0;.00nan;0;0
10021;197912;111;0;0;0;0;.00nan;0;0
10022;196324;110;64;19;1;18;.947;3600000;0
10022;202161;115;0;0;0;0;.00nan;0;0
10022;207439;115;31;38;7;31;.816;3600000;0
10022;197010;110;0;0;0;0;.00nan;0;0
10023;195089;124;0;0;0;0;.00nan;0;0
10023;206731;124;68;33;3;30;.909;3600000;0
10023;197059;113;0;0;0;0;.00nan;0;0
10023;-1;113;100;31;0;31;1.000;3600000;0
10024;197999;116;0;0;0;0;.00nan;0;0
10024;199481;122;71;40;4;36;.900;3900000;0
10024;205469;122;0;0;0;0;.00nan;0;0
10024;-1;116;43;24;4;20;.833;3900000;0
10025;200390;120;61;23;2;21;.913;3580000;0
10025;195001;126;0;0;0;0;.00nan;0;0
10025;212039;126;100;36;0;36;1.000;3600000;0
10025;207600;120;0;0;0;0;.00nan;0;0
10026;192776;119;64;23;3;20;.870;3531000;0
10026;192780;118;0;0;0;0;.00nan;0;0
10026;195017;119;0;0;0;0;.00nan;0;0
10026;196414;118;83;30;1;29;.967;3600000;0
10027;200353;123;88;48;3;45;.938;3600000;0
10027;206864;127;0;0;0;0;.00nan;0;0
10027;202314;127;82;15;0;15;1.000;3600000;0
10027;-1;123;0;0;0;0;.00nan;0;0
10028;200233;108;72;18;1;17;.944;3600000;0
10028;196372;108;0;0;0;0;.00nan;0;0
10028;207493;121;72;40;4;36;.900;3600000;0
10028;202279;121;0;0;0;0;.00nan;0;0
10029;195001;126;53;2;0;2;1.000;280000;0
10029;212039;126;30;26;6;20;.769;3320000;0
10029;207493;121;52;20;3;17;.850;1603000;0
10029;202279;121;50;31;5;26;.839;1913000;0
10030;197999;116;0;0;0;0;.00nan;0;0
10030;192900;114;0;0;0;0;.00nan;0;0
10030;197047;114;52;28;4;24;.857;3600000;0
10030;-1;116;98;28;0;28;1.000;3600000;0
10031;195089;124;44;33;5;28;.848;3562000;0
10031;206731;124;0;0;0;0;.00nan;0;0
10031;206864;127;0;0;0;0;.00nan;0;0
10031;202314;127;53;24;3;21;.875;3600000;0
10032;199481;122;0;0;0;0;.00nan;0;0
10032;204630;109;0;0;0;0;.00nan;0;0
10032;205469;122;74;22;1;21;.955;3600000;0
10032;197038;109;85;43;2;41;.953;3600000;0
10033;192780;118;79;24;1;23;.958;3600000;0
10033;195111;125;53;33;4;29;.879;3600000;0
10033;195392;125;0;0;0;0;.00nan;0;0
10033;196414;118;0;0;0;0;.00nan;0;0
10034;200353;123;0;0;0;0;.00nan;0;0
10034;197059;113;0;0;0;0;.00nan;0;0
10034;-1;113;97;43;2;41;.953;3599000;0
10034;-1;123;85;37;1;36;.973;3600000;0
10035;203412;117;0;0;0;0;.00nan;0;0
10035;200390;120;62;21;2;19;.905;3568000;0
10035;207600;120;29;7;3;4;.571;332000;0
10035;197768;117;63;43;5;38;.884;3900000;0
10036;192948;111;0;0;0;0;.00nan;0;0
10036;202246;112;0;0;0;0;.00nan;0;0
10036;-1;112;80;32;2;30;.938;3600000;0
10036;197912;111;30;25;5;20;.800;3600000;0
10037;204630;109;64;39;5;34;.872;3775000;0
10037;202161;115;39;20;4;16;.800;3738000;0
10037;207439;115;0;0;0;0;.00nan;0;0
10037;197038;109;0;0;0;0;.00nan;0;0
10038;192776;119;0;0;0;0;.00nan;0;0
10038;195017;119;26;32;7;25;.781;3600000;0
10038;197059;113;100;47;2;45;.957;3600000;0
10038;-1;113;0;0;0;0;.00nan;0;0
10039;200233;108;0;0;0;0;.00nan;0;0
10039;196324;110;0;0;0;0;.00nan;0;0
10039;196372;108;33;28;5;23;.821;3600000;0
10039;197010;110;84;40;2;38;.950;3600000;0
10040;192948;111;0;0;0;0;.00nan;0;0
10040;200233;108;81;24;1;23;.958;3600000;0
10040;196372;108;0;0;0;0;.00nan;0;0
10040;197912;111;51;25;3;22;.880;3600000;0
10041;203412;117;68;26;2;24;.923;3600000;0
10041;197059;113;0;0;0;0;.00nan;0;0
10041;-1;113;42;27;4;23;.852;3548000;0
10041;197768;117;0;0;0;0;.00nan;0;0
10042;195111;125;55;37;5;32;.865;3600000;0
10042;195392;125;0;0;0;0;.00nan;0;0
10042;202161;115;0;0;0;0;.00nan;0;0
10042;207439;115;75;21;1;20;.952;3600000;0
10043;197999;116;0;0;0;0;.00nan;0;0
10043;204630;109;0;0;0;0;.00nan;0;0
10043;197038;109;80;42;3;39;.929;3541000;0
10043;-1;116;59;11;1;10;.909;3600000;0
10044;199481;122;76;32;3;29;.906;3600000;0
10044;205469;122;0;0;0;0;.00nan;0;0
10044;207493;121;23;24;6;18;.750;3130000;0
10044;202279;121;66;6;0;6;1.000;470000;0
10045;192780;118;0;0;0;0;.00nan;0;0
10045;192900;114;29;8;3;5;.625;1127000;0
10045;196414;118;73;36;4;32;.889;3600000;0
10045;197047;114;25;24;6;18;.750;2473000;0
10046;196324;110;71;27;2;25;.926;3600000;0
10046;202246;112;56;51;6;45;.882;2935000;0
10046;197010;110;0;0;0;0;.00nan;0;0
10046;-1;112;63;3;0;3;1.000;665000;0
10047;192776;119;0;0;0;0;.00nan;0;0
10047;195017;119;68;23;2;21;.913;3600000;0
10047;206864;127;0;0;0;0;.00nan;0;0
10047;202314;127;81;44;4;40;.909;3600000;0
10048;200353;123;49;30;4;26;.867;3558000;0
10048;195001;126;0;0;0;0;.00nan;0;0
10048;212039;126;64;21;2;19;.905;3600000;0
10048;-1;123;0;0;0;0;.00nan;0;0
10049;200233;108;0;0;0;0;.00nan;0;0
10049;196372;108;64;26;2;24;.923;3600000;0
10049;202161;115;15;30;7;23;.767;3600000;0
10049;207439;115;0;0;0;0;.00nan;0;0
10050;193687;120;72;19;1;18;.947;3600000;0
10050;200390;120;0;0;0;0;.00nan;0;0
10050;195089;124;71;51;5;46;.902;3600000;0
10050;206731;124;0;0;0;0;.00nan;0;0
10051;192776;119;70;28;2;26;.929;3600000;0
10051;195017;119;0;0;0;0;.00nan;0;0
10051;206864;127;13;21;6;15;.714;3600000;0
10051;202314;127;0;0;0;0;.00nan;0;0
10052;197999;116;47;16;2;14;.875;3600000;0
10052;197059;113;53;36;5;31;.861;3600000;0
10052;-1;113;0;0;0;0;.00nan;0;0
10052;-1;116;0;0;0;0;.00nan;0;0
10053;192948;111;0;0;0;0;.00nan;0;0
10053;204630;109;59;38;5;33;.868;3846000;0
10053;197038;109;0;0;0;0;.00nan;0;0
10053;197912;111;45;30;4;26;.867;3845000;0
10054;203412;117;0;0;0;0;.00nan;0;0
10054;202246;112;0;0;0;0;.00nan;0;0
10054;-1;112;96;33;1;32;.970;3600000;0
10054;197768;117;42;27;5;22;.815;3600000;0
10055;195089;124;50;5;1;4;.800;430000;0
10055;206731;124;34;31;6;25;.806;3170000;0
10055;207493;121;82;27;2;25;.926;3600000;0
10055;202279;121;0;0;0;0;.00nan;0;0
10056;192900;114;0;0;0;0;.00nan;0;0
10056;199481;122;84;33;3;30;.909;3900000;0
10056;205469;122;0;0;0;0;.00nan;0;0
10056;197047;114;78;33;3;30;.909;3900000;0
10057;192780;118;71;21;1;20;.952;1357000;0
10057;193687;120;0;0;0;0;.00nan;0;0
10057;200390;120;57;24;3;21;.875;3600000;0
10057;196414;118;32;30;6;24;.800;2243000;0
10058;200353;123;41;23;4;19;.826;3600000;0
10058;195111;125;53;17;2;15;.882;2423000;0
10058;195392;125;33;17;4;13;.765;1102000;0
10058;-1;123;0;0;0;0;.00nan;0;0
10059;195001;126;0;0;0;0;.00nan;0;0
10059;212039;126;100;25;0;25;1.000;3600000;0
10059;197059;113;28;23;5;18;.783;2418000;0
10059;-1;113;46;22;4;18;.818;1182000;0
10060;197999;116;0;0;0;0;.00nan;0;0
10060;196324;110;80;30;2;28;.933;3600000;0
10060;197010;110;0;0;0;0;.00nan;0;0
10060;-1;116;47;53;7;46;.868;3600000;0
10061;200233;108;21;25;6;19;.760;3539000;0
10061;196372;108;0;0;0;0;.00nan;0;0
10061;202161;115;0;0;0;0;.00nan;0;0
10061;207439;115;87;51;4;47;.922;3600000;0
10062;195111;125;35;5;2;3;.600;523000;0
10062;195392;125;46;38;6;32;.842;3077000;0
10062;206864;127;0;0;0;0;.00nan;0;0
10062;202314;127;55;18;2;16;.889;3600000;0
10063;200353;123;0;0;0;0;.00nan;0;0
10063;195001;126;0;0;0;0;.00nan;0;0
10063;212039;126;100;23;0;23;1.000;3600000;0
10063;-1;123;79;40;3;37;.925;3600000;0
10064;199481;122;49;19;3;16;.842;3600000;0
10064;205469;122;0;0;0;0;.00nan;0;0
10064;202246;112;25;21;5;16;.762;1804000;0
10064;-1;112;55;15;2;13;.867;1796000;0
10065;192776;119;87;37;3;34;.919;3581000;0
10065;195017;119;0;0;0;0;.00nan;0;0
10065;195089;124;79;25;1;24;.960;3600000;0
10065;206731;124;0;0;0;0;.00nan;0;0
10066;192900;114;76;28;2;26;.929;3600000;0
10066;207493;121;16;22;6;16;.727;1772000;0
10066;202279;121;50;8;1;7;.875;1828000;0
10066;197047;114;0;0;0;0;.00nan;0;0
10067;192780;118;0;0;0;0;.00nan;0;0
10067;203412;117;44;18;3;15;.833;3600000;0
10067;196414;118;72;50;6;44;.880;3600000;0
10067;197768;117;0;0;0;0;.00nan;0;0
10068;193687;120;30;26;6;20;.769;2936000;0
10068;200390;120;40;2;1;1;.500;664000;0
10068;196324;110;0;0;0;0;.00nan;0;0
10068;197010;110;74;26;1;25;.962;3600000;0
10069;192948;111;62;18;2;16;.889;3600000;0
10069;204630;109;72;45;4;41;.911;3588000;0
10069;197038;109;0;0;0;0;.00nan;0;0
10069;197912;111;0;0;0;0;.00nan;0;0
10070;192776;119;0;0;0;0;.00nan;0;0
10070;199481;122;60;15;1;14;.933;3600000;0
10070;205469;122;0;0;0;0;.00nan;0;0
10070;195017;119;55;37;5;32;.865;3600000;0
10071;195001;126;0;0;0;0;.00nan;0;0
10071;212039;126;84;40;3;37;.925;3600000;0
10071;196324;110;34;27;6;21;.778;3600000;0
10071;197010;110;0;0;0;0;.00nan;0;0
10072;200233;108;0;0;0;0;.00nan;0;0
10072;206864;127;0;0;0;0;.00nan;0;0
10072;196372;108;58;18;2;16;.889;3600000;0
10072;202314;127;52;30;4;26;.867;3520000;0
10073;195089;124;40;24;4;20;.833;3801000;0
10073;195111;125;66;43;5;38;.884;3801000;0
10073;195392;125;0;0;0;0;.00nan;0;0
10073;206731;124;0;0;0;0;.00nan;0;0
10074;203412;117;63;25;2;23;.920;3600000;0
10074;206864;127;71;32;3;29;.906;3562000;0
10074;202314;127;0;0;0;0;.00nan;0;0
10074;197768;117;0;0;0;0;.00nan;0;0
10075;197999;116;59;11;1;10;.909;2797000;0
10075;202246;112;50;29;4;25;.862;3600000;0
10075;-1;112;0;0;0;0;.00nan;0;0
10075;-1;116;27;15;4;11;.733;752000;0
10076;192780;118;0;0;0;0;.00nan;0;0
10076;199481;122;65;38;5;33;.868;3584000;0
10076;205469;122;0;0;0;0;.00nan;0;0
10076;196414;118;71;38;4;34;.895;3600000;0
10077;193687;120;0;0;0;0;.00nan;0;0
10077;200353;123;48;22;4;18;.818;2292000;0
10077;200390;120;53;14;2;12;.857;3600000;0
10077;-1;123;52;15;2;13;.867;1308000;0
10078;192948;111;0;0;0;0;.00nan;0;0
10078;202161;115;86;20;0;20;1.000;3600000;0
10078;207439;115;0;0;0;0;.00nan;0;0
10078;197912;111;93;38;2;36;.947;3515000;0
10079;197999;116;0;0;0;0;.00nan;0;0
10079;204630;109;73;31;2;29;.935;3600000;0
10079;197038;109;0;0;0;0;.00nan;0;0
10079;-1;116;66;29;3;26;.897;3600000;0
10080;192780;118;78;43;4;39;.907;3900000;0
10080;192900;114;0;0;0;0;.00nan;0;0
10080;196414;118;0;0;0;0;.00nan;0;0
10080;197047;114;32;17;4;13;.765;3900000;0
10081;200233;108;0;0;0;0;.00nan;0;0
10081;195089;124;72;39;4;35;.897;3900000;0
10081;206731;124;0;0;0;0;.00nan;0;0
10081;196372;108;42;24;4;20;.833;3900000;0
10082;192776;119;31;18;4;14;.778;3600000;0
10082;203412;117;38;7;2;5;.714;733000;0
10082;195017;119;0;0;0;0;.00nan;0;0
10082;197768;117;39;41;7;34;.829;2867000;0
10083;202246;112;0;0;0;0;.00nan;0;0
10083;-1;112;59;33;4;29;.879;3591000;0
10083;197059;113;58;26;3;23;.885;3600000;0
10083;-1;113;0;0;0;0;.00nan;0;0
10084;195001;126;53;17;2;15;.882;2810000;0
10084;212039;126;19;9;4;5;.556;790000;0
10084;207493;121;79;34;2;32;.941;3600000;0
10084;202279;121;0;0;0;0;.00nan;0;0
10085;192948;111;11;21;6;15;.714;3600000;0
10085;204630;109;0;0;0;0;.00nan;0;0
10085;197038;109;100;44;2;42;.955;3600000;0
10085;197912;111;0;0;0;0;.00nan;0;0
10086;192776;119;0;0;0;0;.00nan;0;0
10086;195017;119;78;26;2;24;.923;3600000;0
10086;202161;115;59;29;3;26;.897;3557000;0
10086;207439;115;0;0;0;0;.00nan;0;0
10087;195089;124;0;0;0;0;.00nan;0;0
10087;206731;124;63;26;2;24;.923;3600000;0
10087;196324;110;0;0;0;0;.00nan;0;0
10087;197010;110;32;19;4;15;.789;3558000;0
10088;199481;122;45;19;4;15;.789;3600000;0
10088;205469;122;0;0;0;0;.00nan;0;0
10088;195111;125;81;50;4;46;.920;3567000;0
10088;195392;125;0;0;0;0;.00nan;0;0
10089;192780;118;50;1;0;1;1.000;330000;0
10089;196414;118;47;42;6;36;.857;3270000;0
10089;207493;121;87;26;1;25;.962;3600000;0
10089;202279;121;0;0;0;0;.00nan;0;0
10090;193687;120;45;20;3;17;.850;3600000;0
10090;200390;120;0;0;0;0;.00nan;0;0
10090;197059;113;68;23;1;22;.957;1286000;0
10090;-1;113;14;19;6;13;.684;2314000;0
10091;200233;108;34;17;4;13;.765;3600000;0
10091;200353;123;0;0;0;0;.00nan;0;0
10091;196372;108;0;0;0;0;.00nan;0;0
10091;-1;123;52;46;6;40;.870;3585000;0
10092;203412;117;94;43;2;41;.953;3900000;0
10092;195001;126;0;0;0;0;.00nan;0;0
10092;212039;126;78;31;2;29;.935;3900000;0
10092;197768;117;0;0;0;0;.00nan;0;0
10093;202161;115;0;0;0;0;.00nan;0;0
10093;207439;115;70;35;4;31;.886;3600000;0
10093;202246;112;24;20;6;14;.700;2426000;0
10093;-1;112;43;4;1;3;.750;1174000;0
10094;197999;116;93;32;1;31;.969;3600000;0
10094;193687;120;0;0;0;0;.00nan;0;0
10094;200390;120;73;29;2;27;.931;3566000;0
10094;-1;116;0;0;0;0;.00nan;0;0
10095;192900;114;0;0;0;0;.00nan;0;0
10095;195111;125;0;0;0;0;.00nan;0;0
10095;195392;125;81;45;4;41;.911;3600000;0
10095;197047;114;94;26;0;26;1.000;3600000;0
10096;206864;127;0;0;0;0;.00nan;0;0
10096;207493;121;77;36;3;33;.917;3600000;0
10096;202279;121;0;0;0;0;.00nan;0;0
10096;202314;127;32;25;5;20;.800;3517000;0
10097;200353;123;79;45;4;41;.911;3900000;0
10097;196324;110;42;28;4;24;.857;3888000;0
10097;197010;110;0;0;0;0;.00nan;0;0
10097;-1;123;0;0;0;0;.00nan;0;0
10098;192780;118;0;0;0;0;.00nan;0;0
10098;195089;124;77;31;2;29;.935;3600000;0
10098;206731;124;0;0;0;0;.00nan;0;0
10098;196414;118;63;30;3;27;.900;3546000;0
10099;203412;117;35;19;4;15;.789;2291000;0
10099;199481;122;93;23;0;23;1.000;3600000;0
10099;205469;122;0;0;0;0;.00nan;0;0
10099;197768;117;67;11;0;11;1.000;1309000;0
10100;202161;115;0;0;0;0;.00nan;0;0
10100;207439;115;76;41;4;37;.902;3600000;0
10100;197059;113;12;22;7;15;.682;3600000;0
10100;-1;113;0;0;0;0;.00nan;0;0
10101;192776;119;0;0;0;0;.00nan;0;0
10101;195017;119;33;26;6;20;.769;3600000;0
10101;206864;127;67;30;3;27;.900;3600000;0
10101;202314;127;0;0;0;0;.00nan;0;0
10102;200353;123;0;0;0;0;.00nan;0;0
10102;195111;125;38;23;4;19;.826;3290000;0
10102;195392;125;48;0;0;0;.00nan;310000;0
10102;-1;123;62;23;2;21;.913;3600000;0
10103;197999;116;0;0;0;0;.00nan;0;0
10103;202161;115;72;54;5;49;.907;3600000;0
10103;207439;115;0;0;0;0;.00nan;0;0
10103;-1;116;79;26;1;25;.962;3600000;0
10104;192900;114;0;0;0;0;.00nan;0;0
10104;203412;117;53;43;6;37;.860;3600000;0
10104;197047;114;71;18;1;17;.944;3600000;0
10104;197768;117;0;0;0;0;.00nan;0;0
10105;192948;111;0;0;0;0;.00nan;0;0
10105;200233;108;0;0;0;0;.00nan;0;0
10105;196372;108;75;31;2;29;.935;3600000;0
10105;197912;111;64;42;5;37;.881;3600000;0
10106;204630;109;56;40;5;35;.875;3600000;0
10106;202246;112;77;28;2;26;.929;3600000;0
10106;-1;112;0;0;0;0;.00nan;0;0
10106;197038;109;0;0;0;0;.00nan;0;0
10107;192948;111;26;12;4;8;.667;1124000;0
10107;196324;110;0;0;0;0;.00nan;0;0
10107;197010;110;70;26;3;23;.885;3600000;0
10107;197912;111;71;32;3;29;.906;2476000;0
10108;192900;114;36;31;6;25;.806;3600000;0
10108;195089;124;73;28;2;26;.929;3600000;0
10108;206731;124;0;0;0;0;.00nan;0;0
10108;197047;114;0;0;0;0;.00nan;0;0
10109;193687;120;100;31;0;31;1.000;3600000;0
10109;199481;122;59;29;3;26;.897;3600000;0
10109;200390;120;0;0;0;0;.00nan;0;0
10109;205469;122;0;0;0;0;.00nan;0;0
10110;192776;119;85;36;2;34;.944;3600000;0
10110;200353;123;60;36;4;32;.889;3578000;0
10110;195017;119;0;0;0;0;.00nan;0;0
10110;-1;123;0;0;0;0;.00nan;0;0
10111;206864;127;0;0;0;0;.00nan;0;0
10111;202314;127;60;26;3;23;.885;3600000;0
10111;197059;113;62;8;0;8;1.000;841000;0
10111;-1;113;14;23;7;16;.696;2759000;0
10112;195001;126;0;0;0;0;.00nan;0;0
10112;212039;126;69;30;3;27;.900;3600000;0
10112;207493;121;37;36;6;30;.833;3600000;0
10112;202279;121;0;0;0;0;.00nan;0;0
10113;192780;118;0;0;0;0;.00nan;0;0
10113;204630;109;0;0;0;0;.00nan;0;0
10113;196414;118;39;11;3;8;.727;3600000;0
10113;197038;109;66;45;5;40;.889;3600000;0
10114;199481;122;0;0;0;0;.00nan;0;0
10114;205469;122;93;51;3;48;.941;3900000;0
10114;195089;124;0;0;0;0;.00nan;0;0
10114;206731;124;62;27;3;24;.889;3900000;0
10115;200233;108;0;0;0;0;.00nan;0;0
10115;196324;110;87;24;1;23;.958;3600000;0
10115;196372;108;43;37;5;32;.865;3600000;0
10115;197010;110;0;0;0;0;.00nan;0;0
10116;195111;125;49;35;5;30;.857;3900000;0
10116;195392;125;0;0;0;0;.00nan;0;0
10116;197059;113;44;28;5;23;.821;3900000;0
10116;-1;113;0;0;0;0;.00nan;0;0
10117;200353;123;0;0;0;0;.00nan;0;0
10117;207493;121;0;0;0;0;.00nan;0;0
10117;202279;121;65;28;3;25;.893;3577000;0
10117;-1;123;99;43;2;41;.953;3600000;0
10118;197999;116;0;0;0;0;.00nan;0;0
10118;195001;126;64;27;2;25;.926;3600000;0
10118;212039;126;0;0;0;0;.00nan;0;0
10118;-1;116;58;24;3;21;.875;3580000;0
10119;203412;117;41;29;5;24;.828;3580000;0
10119;202246;112;0;0;0;0;.00nan;0;0
10119;-1;112;69;37;4;33;.892;3600000;0
10119;213504;117;0;0;0;0;.00nan;0;0
10120;206864;127;0;0;0;0;.00nan;0;0
10120;202161;115;45;32;5;27;.844;3600000;0
10120;207439;115;0;0;0;0;.00nan;0;0
10120;202314;127;57;22;2;20;.909;3600000;0
10121;193687;120;66;16;2;14;.875;3600000;0
10121;204630;109;64;51;6;45;.882;3186000;0
10121;200390;120;0;0;0;0;.00nan;0;0
10121;197038;109;54;5;0;5;1.000;414000;0
10122;192776;119;0;0;0;0;.00nan;0;0
10122;192780;118;51;36;5;31;.861;3864000;0
10122;195017;119;72;35;4;31;.886;3864000;0
10122;196414;118;0;0;0;0;.00nan;0;0
10123;192948;111;58;38;5;33;.868;3585000;0
10123;196324;110;0;0;0;0;.00nan;0;0
10123;197010;110;65;28;3;25;.893;3600000;0
10123;197912;111;0;0;0;0;.00nan;0;0
10124;199481;122;58;32;4;28;.875;3525000;0
10124;205469;122;0;0;0;0;.00nan;0;0
10124;206864;127;68;24;2;22;.917;3600000;0
10124;202314;127;0;0;0;0;.00nan;0;0
10125;193687;120;0;0;0;0;.00nan;0;0
10125;200390;120;44;31;4;27;.871;3898000;0
10125;207493;121;79;36;3;33;.917;3898000;0
10125;202279;121;0;0;0;0;.00nan;0;0
10126;196324;110;0;0;0;0;.00nan;0;0
10126;202246;112;0;0;0;0;.00nan;0;0
10126;197010;110;73;34;2;32;.941;3900000;0
10126;-1;112;78;29;2;27;.931;3900000;0
10127;203412;117;62;24;3;21;.875;3600000;0
10127;197059;113;34;11;3;8;.727;337000;0
10127;-1;113;55;42;6;36;.857;3263000;0
10127;213504;117;0;0;0;0;.00nan;0;0
10128;197999;116;0;0;0;0;.00nan;0;0
10128;199481;122;80;31;2;29;.935;3600000;0
10128;205469;122;0;0;0;0;.00nan;0;0
10128;-1;116;62;32;4;28;.875;3526000;0
10129;192900;114;0;0;0;0;.00nan;0;0
10129;202161;115;0;0;0;0;.00nan;0;0
10129;207439;115;64;27;2;25;.926;3900000;0
10129;197047;114;70;25;2;23;.920;3900000;0
10130;192780;118;0;0;0;0;.00nan;0;0
10130;200233;108;0;0;0;0;.00nan;0;0
10130;196372;108;100;27;0;27;1.000;3600000;0
10130;196414;118;57;40;5;35;.875;3600000;0
10131;195001;126;0;0;0;0;.00nan;0;0
10131;195111;125;82;57;5;52;.912;3600000;0
10131;195392;125;0;0;0;0;.00nan;0;0
10131;212039;126;47;13;2;11;.846;3600000;0
10132;192780;118;91;42;3;39;.929;3600000;0
10132;192948;111;0;0;0;0;.00nan;0;0
10132;196414;118;0;0;0;0;.00nan;0;0
10132;197912;111;75;37;4;33;.892;3590000;0
10133;204630;109;10;26;7;19;.731;2226000;0
10133;200353;123;0;0;0;0;.00nan;0;0
10133;197038;109;66;13;0;13;1.000;1374000;0
10133;-1;123;58;12;1;11;.917;3600000;0
10134;197999;116;67;18;1;17;.944;3600000;0
10134;202161;115;59;31;3;28;.903;3578000;0
10134;207439;115;0;0;0;0;.00nan;0;0
10134;-1;116;0;0;0;0;.00nan;0;0
10135;192776;119;32;30;6;24;.800;3600000;0
10135;193687;120;59;14;1;13;.929;3600000;0
10135;200390;120;0;0;0;0;.00nan;0;0
10135;195017;119;0;0;0;0;.00nan;0;0
10136;199481;122;0;0;0;0;.00nan;0;0
10136;205469;122;50;20;3;17;.850;3550000;0
10136;197059;113;82;40;2;38;.950;3600000;0
10136;-1;113;0;0;0;0;.00nan;0;0
10137;195001;126;19;27;6;21;.778;3600000;0
10137;212039;126;0;0;0;0;.00nan;0;0
10137;206864;127;0;0;0;0;.00nan;0;0
10137;202314;127;58;28;3;25;.893;3600000;0
10138;195089;124;47;12;2;10;.833;3600000;0
10138;206731;124;0;0;0;0;.00nan;0;0
10138;207493;121;76;28;1;27;.964;3600000;0
10138;202279;121;0;0;0;0;.00nan;0;0
10139;200233;108;23;26;6;20;.769;3006000;0
10139;196324;110;65;33;4;29;.879;3600000;0
10139;196372;108;48;0;0;0;.00nan;567000;0
10139;197010;110;0;0;0;0;.00nan;0;0
10140;195111;125;51;33;4;29;.879;3600000;0
10140;195392;125;0;0;0;0;.00nan;0;0
10140;202246;112;0;0;0;0;.00nan;0;0
10140;-1;112;66;27;3;24;.889;3600000;0
10141;192776;119;0;0;0;0;.00nan;0;0
10141;193687;120;33;11;3;8;.727;1390000;0
10141;200390;120;31;22;5;17;.773;2210000;0
10141;195017;119;69;31;3;28;.903;3600000;0
10142;195089;124;0;0;0;0;.00nan;0;0
10142;206731;124;56;40;5;35;.875;3557000;0
10142;206864;127;71;30;3;27;.900;3600000;0
10142;202314;127;0;0;0;0;.00nan;0;0
10143;200233;108;0;0;0;0;.00nan;0;0
10143;200353;123;62;33;3;30;.909;3600000;0
10143;196372;108;46;21;4;17;.810;3555000;0
10143;-1;123;0;0;0;0;.00nan;0;0
10144;192900;114;0;0;0;0;.00nan;0;0
10144;203412;117;59;36;4;32;.889;3900000;0
10144;197047;114;68;39;4;35;.897;3900000;0
10144;213504;117;0;0;0;0;.00nan;0;0
10145;192948;111;50;35;4;31;.886;3600000;0
10145;200353;123;0;0;0;0;.00nan;0;0
10145;197912;111;0;0;0;0;.00nan;0;0
10145;-1;123;65;43;5;38;.884;3577000;0
10146;192780;118;0;0;0;0;.00nan;0;0
10146;204630;109;32;16;4;12;.750;1810000;0
10146;196414;118;82;34;2;32;.941;3600000;0
10146;197038;109;43;15;2;13;.867;1790000;0
10147;202161;115;0;0;0;0;.00nan;0;0
10147;207439;115;83;26;3;23;.885;3600000;0
10147;202246;112;49;35;5;30;.857;3551000;0
10147;-1;112;0;0;0;0;.00nan;0;0
10148;197999;116;0;0;0;0;.00nan;0;0
10148;192900;114;56;40;5;35;.875;3582000;0
10148;197047;114;0;0;0;0;.00nan;0;0
10148;-1;116;56;22;3;19;.864;3600000;0
10149;203412;117;0;0;0;0;.00nan;0;0
10149;197059;113;0;0;0;0;.00nan;0;0
10149;-1;113;29;32;6;26;.813;3600000;0
10149;213504;117;59;26;3;23;.885;3600000;0
10150;199481;122;79;62;6;56;.903;3278000;0
10150;205469;122;50;2;0;2;1.000;267000;0
10150;195001;126;0;0;0;0;.00nan;0;0
10150;212039;126;57;26;4;22;.846;3600000;0
10151;195111;125;0;0;0;0;.00nan;0;0
10151;195392;125;81;26;1;25;.962;3600000;0
10151;196324;110;0;0;0;0;.00nan;0;0
10151;197010;110;84;35;2;33;.943;3549000;0
10152;192780;118;0;0;0;0;.00nan;0;0
10152;203412;117;52;33;5;28;.848;3883000;0
10152;196414;118;76;37;4;33;.892;3856000;0
10152;213504;117;0;0;0;0;.00nan;0;0
10153;197999;116;50;15;2;13;.867;2712000;0
10153;197059;113;38;8;2;6;.750;642000;0
10153;-1;113;38;36;6;30;.833;2917000;0
10153;-1;116;16;5;4;1;.200;888000;0
10154;192900;114;0;0;0;0;.00nan;0;0
10154;202246;112;65;27;2;25;.926;3568000;0
10154;-1;112;0;0;0;0;.00nan;0;0
10154;197047;114;66;19;1;18;.947;3600000;0
10155;204630;109;0;0;0;0;.00nan;0;0
10155;200233;108;0;0;0;0;.00nan;0;0
10155;196372;108;81;32;1;31;.969;3600000;0
10155;197038;109;45;29;5;24;.828;3600000;0
10156;200353;123;0;0;0;0;.00nan;0;0
10156;195111;125;74;29;2;27;.931;3829000;0
10156;195392;125;0;0;0;0;.00nan;0;0
10156;-1;123;90;35;1;34;.971;3829000;0
10157;192900;114;17;18;6;12;.667;2595000;0
10157;192948;111;0;0;0;0;.00nan;0;0
10157;197047;114;47;6;1;5;.833;1005000;0
10157;197912;111;80;35;2;33;.943;3600000;0
10158;195089;124;56;34;5;29;.853;3600000;0
10158;206731;124;0;0;0;0;.00nan;0;0
10158;202161;115;20;25;7;18;.720;3574000;0
10158;207439;115;0;0;0;0;.00nan;0;0
10159;192776;119;78;26;1;25;.962;3600000;0
10159;200233;108;76;41;3;38;.927;3562000;0
10159;195017;119;0;0;0;0;.00nan;0;0
10159;196372;108;0;0;0;0;.00nan;0;0
10160;197999;116;0;0;0;0;.00nan;0;0
10160;197059;113;99;53;1;52;.981;3600000;0
10160;-1;113;0;0;0;0;.00nan;0;0
10160;-1;116;28;25;5;20;.800;3600000;0
10161;193687;120;61;39;4;35;.897;3549000;0
10161;200390;120;0;0;0;0;.00nan;0;0
10161;195001;126;0;0;0;0;.00nan;0;0
10161;212039;126;82;40;3;37;.925;3600000;0
10162;206864;127;0;0;0;0;.00nan;0;0
10162;207493;121;62;36;4;32;.889;3600000;0
10162;202279;121;0;0;0;0;.00nan;0;0
10162;202314;127;69;15;1;14;.933;3600000;0
10163;199481;122;75;37;4;33;.892;3600000;0
10163;205469;122;0;0;0;0;.00nan;0;0
10163;196324;110;0;0;0;0;.00nan;0;0
10163;197010;110;37;30;5;25;.833;3568000;0
10164;192900;114;0;0;0;0;.00nan;0;0
10164;204630;109;49;35;5;30;.857;3576000;0
10164;197038;109;0;0;0;0;.00nan;0;0
10164;197047;114;69;32;3;29;.906;3600000;0
10165;192948;111;88;29;1;28;.966;3900000;0
10165;202246;112;0;0;0;0;.00nan;0;0
10165;-1;112;91;34;1;33;.971;3900000;0
10165;197912;111;0;0;0;0;.00nan;0;0
10166;192776;119;0;0;0;0;.00nan;0;0
10166;199481;122;0;0;0;0;.00nan;0;0
10166;205469;122;88;42;3;39;.929;3557000;0
10166;195017;119;61;22;2;20;.909;3600000;0
10167;192780;118;0;0;0;0;.00nan;0;0
10167;195089;124;0;0;0;0;.00nan;0;0
10167;206731;124;70;33;4;29;.879;3600000;0
10167;196414;118;77;23;1;22;.957;3600000;0
10168;200233;108;0;0;0;0;.00nan;0;0
10168;195111;125;44;35;6;29;.829;3600000;0
10168;195392;125;0;0;0;0;.00nan;0;0
10168;196372;108;53;26;3;23;.885;3600000;0
10169;193687;120;0;0;0;0;.00nan;0;0
10169;200353;123;74;33;3;30;.909;3600000;0
10169;200390;120;52;31;4;27;.871;3600000;0
10169;-1;123;0;0;0;0;.00nan;0;0
10170;203412;117;0;0;0;0;.00nan;0;0
10170;196324;110;40;28;5;23;.821;3589000;0
10170;197010;110;0;0;0;0;.00nan;0;0
10170;213504;117;69;32;3;29;.906;3600000;0
10171;202161;115;0;0;0;0;.00nan;0;0
10171;207439;115;76;27;2;25;.926;3600000;0
10171;202246;112;68;41;4;37;.902;3513000;0
10171;-1;112;0;0;0;0;.00nan;0;0
10172;197999;116;0;0;0;0;.00nan;0;0
10172;203412;117;67;43;4;39;.907;3900000;0
10172;-1;116;42;21;4;17;.810;3900000;0
10172;213504;117;0;0;0;0;.00nan;0;0
10173;192780;118;66;28;3;25;.893;3600000;0
10173;196414;118;0;0;0;0;.00nan;0;0
10173;207493;121;60;31;4;27;.871;3577000;0
10173;202279;121;0;0;0;0;.00nan;0;0
10174;195001;126;44;4;1;3;.750;393000;0
10174;212039;126;22;23;6;17;.739;3152000;0
10174;206864;127;0;0;0;0;.00nan;0;0
10174;202314;127;41;33;6;27;.818;3600000;0
10175;200353;123;0;0;0;0;.00nan;0;0
10175;195111;125;0;0;0;0;.00nan;0;0
10175;195392;125;32;23;5;18;.783;3549000;0
10175;-1;123;90;44;3;41;.932;3600000;0
10176;204630;109;0;0;0;0;.00nan;0;0
10176;196324;110;0;0;0;0;.00nan;0;0
10176;197010;110;47;12;2;10;.833;3600000;0
10176;197038;109;59;49;7;42;.857;3600000;0
10177;192776;119;85;25;1;24;.960;3600000;0
10177;193687;120;71;27;2;25;.926;3545000;0
10177;200390;120;0;0;0;0;.00nan;0;0
10177;195017;119;0;0;0;0;.00nan;0;0
10178;192780;118;0;0;0;0;.00nan;0;0
10178;203412;117;64;33;3;30;.909;3588000;0
10178;196414;118;78;28;2;26;.929;3600000;0
10178;213504;117;0;0;0;0;.00nan;0;0
10179;200353;123;0;0;0;0;.00nan;0;0
10179;195001;126;0;0;0;0;.00nan;0;0
10179;212039;126;70;25;2;23;.920;3600000;0
10179;-1;123;12;41;9;32;.780;3600000;0
10180;199481;122;63;26;3;23;.885;3600000;0
10180;205469;122;0;0;0;0;.00nan;0;0
10180;207493;121;44;29;4;25;.862;3554000;0
10180;202279;121;0;0;0;0;.00nan;0;0
10181;197999;116;80;18;0;18;1.000;3600000;0
10181;202161;115;72;49;5;44;.898;3600000;0
10181;207439;115;0;0;0;0;.00nan;0;0
10181;-1;116;0;0;0;0;.00nan;0;0
10182;192900;114;0;0;0;0;.00nan;0;0
10182;197047;114;53;35;5;30;.857;3538000;0
10182;197059;113;0;0;0;0;.00nan;0;0
10182;-1;113;61;31;3;28;.903;3600000;0
10183;200233;108;0;0;0;0;.00nan;0;0
10183;196324;110;46;39;5;34;.872;3600000;0
10183;196372;108;78;28;2;26;.929;3600000;0
10183;197010;110;0;0;0;0;.00nan;0;0
10184;195111;125;74;41;4;37;.902;3600000;0
10184;195392;125;0;0;0;0;.00nan;0;0
10184;206864;127;0;0;0;0;.00nan;0;0
10184;202314;127;53;21;3;18;.857;3600000;0
10185;202246;112;82;40;3;37;.925;3600000;0
10185;-1;112;0;0;0;0;.00nan;0;0
10185;197059;113;55;41;6;35;.854;3600000;0
10185;-1;113;0;0;0;0;.00nan;0;0
10186;192948;111;0;0;0;0;.00nan;0;0
10186;196324;110;0;0;0;0;.00nan;0;0
10186;197010;110;37;24;4;20;.833;3550000;0
10186;197912;111;70;31;2;29;.935;3600000;0
10187;203412;117;63;33;3;30;.909;3585000;0
10187;195089;124;75;31;2;29;.935;3600000;0
10187;206731;124;0;0;0;0;.00nan;0;0
10187;213504;117;0;0;0;0;.00nan;0;0
10188;193687;120;67;21;2;19;.905;3600000;0
10188;200390;120;0;0;0;0;.00nan;0;0
10188;207493;121;51;35;5;30;.857;2412000;0
10188;202279;121;27;14;4;10;.714;1188000;0
10189;192776;119;0;0;0;0;.00nan;0;0
10189;199481;122;0;0;0;0;.00nan;0;0
10189;205469;122;87;36;2;34;.944;3581000;0
10189;195017;119;100;22;0;22;1.000;3600000;0
10190;204630;109;88;40;3;37;.925;3543000;0
10190;206864;127;59;21;2;19;.905;3600000;0
10190;202314;127;0;0;0;0;.00nan;0;0
10190;197038;109;0;0;0;0;.00nan;0;0
10191;195001;126;0;0;0;0;.00nan;0;0
10191;212039;126;26;14;4;10;.714;3515000;0
10191;202161;115;0;0;0;0;.00nan;0;0
10191;207439;115;79;34;2;32;.941;3600000;0
10192;197999;116;63;23;2;21;.913;3900000;0
10192;202246;112;0;0;0;0;.00nan;0;0
10192;-1;112;91;45;2;43;.956;3900000;0
10192;-1;116;0;0;0;0;.00nan;0;0
10193;204630;109;0;0;0;0;.00nan;0;0
10193;195089;124;0;0;0;0;.00nan;0;0
10193;206731;124;68;20;1;19;.950;3600000;0
10193;197038;109;89;49;4;45;.918;3600000;0
10194;193687;120;50;1;0;1;1.000;321000;0
10194;199481;122;87;53;4;49;.925;3600000;0
10194;200390;120;25;24;6;18;.750;3232000;0
10194;205469;122;0;0;0;0;.00nan;0;0
10195;192776;119;88;23;1;22;.957;3900000;0
10195;192780;118;0;0;0;0;.00nan;0;0
10195;195017;119;0;0;0;0;.00nan;0;0
10195;196414;118;97;44;1;43;.977;3900000;0
10196;192900;114;0;0;0;0;.00nan;0;0
10196;200233;108;0;0;0;0;.00nan;0;0
10196;196372;108;34;29;6;23;.793;3600000;0
10196;197047;114;71;33;3;30;.909;3600000;0
10197;203412;117;0;0;0;0;.00nan;0;0
10197;200353;123;73;31;3;28;.903;3513000;0
10197;-1;123;0;0;0;0;.00nan;0;0
10197;213504;117;74;24;1;23;.958;3600000;0
10198;192948;111;0;0;0;0;.00nan;0;0
10198;200233;108;0;0;0;0;.00nan;0;0
10198;196372;108;83;37;2;35;.946;3546000;0
10198;197912;111;93;34;1;33;.971;3600000;0
10199;202161;115;76;23;1;22;.957;3900000;0
10199;207439;115;0;0;0;0;.00nan;0;0
10199;197059;113;0;0;0;0;.00nan;0;0
10199;-1;113;97;38;1;37;.974;3900000;0
10200;197999;116;0;0;0;0;.00nan;0;0
10200;192900;114;52;33;4;29;.879;3884000;0
10200;197047;114;0;0;0;0;.00nan;0;0
10200;-1;116;65;33;3;30;.909;3884000;0
10201;192776;119;0;0;0;0;.00nan;0;0
10201;195017;119;48;27;4;23;.852;3745000;0
10201;207493;121;91;43;3;40;.930;3745000;0
10201;202279;121;0;0;0;0;.00nan;0;0
10202;204630;109;45;34;5;29;.853;3600000;0
10202;200353;123;0;0;0;0;.00nan;0;0
10202;197038;109;0;0;0;0;.00nan;0;0
10202;-1;123;69;19;1;18;.947;3600000;0
10203;196324;110;41;29;5;24;.828;3599000;0
10203;202246;112;84;47;4;43;.915;3600000;0
10203;197010;110;0;0;0;0;.00nan;0;0
10203;-1;112;0;0;0;0;.00nan;0;0
10204;195111;125;28;28;6;22;.786;1345000;0
10204;195392;125;41;36;6;30;.833;2255000;0
10204;206864;127;0;0;0;0;.00nan;0;0
10204;202314;127;49;14;2;12;.857;3600000;0
10205;192948;111;0;0;0;0;.00nan;0;0
10205;196324;110;0;0;0;0;.00nan;0;0
10205;197010;110;39;27;5;22;.815;3542000;0
10205;197912;111;71;34;3;31;.912;3600000;0
10206;192776;119;86;39;2;37;.949;3900000;0
10206;195017;119;0;0;0;0;.00nan;0;0
10206;195089;124;57;24;2;22;.917;3900000;0
10206;206731;124;0;0;0;0;.00nan;0;0
10207;192780;118;0;0;0;0;.00nan;0;0
10207;206864;127;0;0;0;0;.00nan;0;0
10207;196414;118;68;22;2;20;.909;3600000;0
10207;202314;127;71;37;3;34;.919;3557000;0
10208;195001;126;0;0;0;0;.00nan;0;0
10208;212039;126;71;29;2;27;.931;3600000;0
10208;197059;113;90;48;3;45;.938;3547000;0
10208;-1;113;0;0;0;0;.00nan;0;0
10209;197999;116;0;0;0;0;.00nan;0;0
10209;192900;114;0;0;0;0;.00nan;0;0
10209;197047;114;39;30;5;25;.833;3600000;0
10209;-1;116;61;17;2;15;.882;3600000;0
10210;200233;108;0;0;0;0;.00nan;0;0
10210;196372;108;69;26;1;25;.962;3600000;0
10210;202161;115;86;53;4;49;.925;3600000;0
10210;207439;115;0;0;0;0;.00nan;0;0
10211;199481;122;39;26;5;21;.808;3900000;0
10211;205469;122;0;0;0;0;.00nan;0;0
10211;195111;125;73;52;5;47;.904;3900000;0
10211;195392;125;0;0;0;0;.00nan;0;0
10212;192948;111;0;0;0;0;.00nan;0;0
10212;193687;120;41;21;4;17;.810;2226000;0
10212;200390;120;56;4;0;4;1.000;1674000;0
10212;197912;111;67;44;4;40;.909;3900000;0
10213;204630;109;57;21;2;19;.905;1780000;0
10213;200233;108;0;0;0;0;.00nan;0;0
10213;196372;108;66;19;2;17;.895;3600000;0
10213;197038;109;27;29;6;23;.793;1820000;0
10214;203412;117;0;0;0;0;.00nan;0;0
10214;202161;115;0;0;0;0;.00nan;0;0
10214;207439;115;78;24;1;23;.958;3600000;0
10214;213504;117;51;31;4;27;.871;3600000;0
10215;192776;119;0;0;0;0;.00nan;0;0
10215;195017;119;82;24;1;23;.958;3600000;0
10215;195111;125;0;0;0;0;.00nan;0;0
10215;195392;125;97;46;2;44;.957;3555000;0
10216;192900;114;37;34;6;28;.824;3351000;0
10216;197047;114;54;3;0;3;1.000;249000;0
10216;197059;113;36;20;4;16;.800;2802000;0
10216;-1;113;18;9;4;5;.556;717000;0
10217;199481;122;0;0;0;0;.00nan;0;0
10217;205469;122;84;41;3;38;.927;3595000;0
10217;206864;127;75;24;1;23;.958;3600000;0
10217;202314;127;0;0;0;0;.00nan;0;0
10218;192780;118;0;0;0;0;.00nan;0;0
10218;200353;123;73;25;2;23;.920;3669000;0
10218;196414;118;83;39;3;36;.923;3669000;0
10218;-1;123;0;0;0;0;.00nan;0;0
10219;207493;121;88;31;1;30;.968;3600000;0
10219;202246;112;32;20;4;16;.800;3600000;0
10219;202279;121;0;0;0;0;.00nan;0;0
10219;-1;112;0;0;0;0;.00nan;0;0
10220;195089;124;97;45;2;43;.956;3600000;0
10220;206731;124;0;0;0;0;.00nan;0;0
10220;196324;110;45;30;5;25;.833;3600000;0
10220;197010;110;0;0;0;0;.00nan;0;0
10221;193687;120;76;19;1;18;.947;3900000;0
10221;204630;109;96;39;1;38;.974;3900000;0
10221;200390;120;0;0;0;0;.00nan;0;0
10221;197038;109;0;0;0;0;.00nan;0;0
10222;195089;124;0;0;0;0;.00nan;0;0
10222;206731;124;42;34;5;29;.853;3600000;0
10222;202246;112;0;0;0;0;.00nan;0;0
10222;-1;112;59;22;2;20;.909;3600000;0
10223;206864;127;52;4;0;4;1.000;559000;0
10223;207493;121;49;29;4;25;.862;3600000;0
10223;202279;121;0;0;0;0;.00nan;0;0
10223;202314;127;30;29;6;23;.793;2997000;0
10224;192780;118;0;0;0;0;.00nan;0;0
10224;195111;125;88;57;4;53;.930;3600000;0
10224;195392;125;0;0;0;0;.00nan;0;0
10224;196414;118;31;19;5;14;.737;3584000;0
10225;199481;122;68;27;3;24;.889;3600000;0
10225;200353;123;0;0;0;0;.00nan;0;0
10225;205469;122;0;0;0;0;.00nan;0;0
10225;-1;123;56;29;4;25;.862;3571000;0
10226;192900;114;0;0;0;0;.00nan;0;0
10226;195001;126;0;0;0;0;.00nan;0;0
10226;212039;126;67;18;1;17;.944;3600000;0
10226;197047;114;40;38;6;32;.842;3600000;0
10227;203412;117;52;37;5;32;.865;3600000;0
10227;192948;111;0;0;0;0;.00nan;0;0
10227;197912;111;46;39;6;33;.846;3539000;0
10227;213504;117;0;0;0;0;.00nan;0;0
10228;200233;108;0;0;0;0;.00nan;0;0
10228;196372;108;71;23;1;22;.957;3600000;0
10228;202246;112;80;33;2;31;.939;3543000;0
10228;-1;112;0;0;0;0;.00nan;0;0
10229;202161;115;64;35;4;31;.886;3737000;0
10229;207439;115;0;0;0;0;.00nan;0;0
10229;197059;113;0;0;0;0;.00nan;0;0
10229;-1;113;58;39;5;34;.872;3737000;0
10230;192776;119;74;42;4;38;.905;3600000;0
10230;195017;119;0;0;0;0;.00nan;0;0
10230;196324;110;0;0;0;0;.00nan;0;0
10230;197010;110;76;23;1;22;.957;3600000;0
10231;200353;123;30;39;7;32;.821;3600000;0
10231;195001;126;0;0;0;0;.00nan;0;0
10231;212039;126;55;25;3;22;.880;3600000;0
10231;-1;123;0;0;0;0;.00nan;0;0
10232;197999;116;0;0;0;0;.00nan;0;0
10232;192948;111;26;15;4;11;.733;1088000;0
10232;197912;111;50;23;4;19;.826;2512000;0
10232;-1;116;77;29;2;27;.931;3600000;0
10233;193687;120;53;23;3;20;.870;3900000;0
10233;200390;120;0;0;0;0;.00nan;0;0
10233;207493;121;90;43;3;40;.930;3900000;0
10233;202279;121;0;0;0;0;.00nan;0;0
10234;192780;118;0;0;0;0;.00nan;0;0
10234;196324;110;57;18;2;16;.889;3600000;0
10234;196414;118;71;35;3;32;.914;3555000;0
10234;197010;110;0;0;0;0;.00nan;0;0
10235;192948;111;0;0;0;0;.00nan;0;0
10235;204630;109;0;0;0;0;.00nan;0;0
10235;197038;109;100;46;2;44;.957;3600000;0
10235;197912;111;68;32;3;29;.906;3544000;0
10236;195089;124;62;26;3;23;.885;3600000;0
10236;206731;124;0;0;0;0;.00nan;0;0
10236;206864;127;0;0;0;0;.00nan;0;0
10236;202314;127;25;33;7;26;.788;3600000;0
10237;192900;114;0;0;0;0;.00nan;0;0
10237;199481;122;79;29;2;27;.931;3565000;0
10237;205469;122;0;0;0;0;.00nan;0;0
10237;197047;114;88;35;1;34;.971;3600000;0
10238;195111;125;26;20;5;15;.750;1910000;0
10238;195392;125;52;9;1;8;.889;1690000;0
10238;202246;112;41;4;1;3;.750;528000;0
10238;-1;112;49;38;6;32;.842;3034000;0
10239;195001;126;0;0;0;0;.00nan;0;0
10239;212039;126;81;14;0;14;1.000;3600000;0
10239;197059;113;30;33;6;27;.818;3031000;0
10239;-1;113;21;10;4;6;.600;569000;0
10240;203412;117;63;24;2;22;.917;3600000;0
10240;200353;123;0;0;0;0;.00nan;0;0
10240;-1;123;45;36;5;31;.861;3600000;0
10240;213504;117;0;0;0;0;.00nan;0;0
10241;200233;108;70;19;1;18;.947;3014000;0
10241;196372;108;24;4;3;1;.250;586000;0
10241;207493;121;50;38;5;33;.868;3600000;0
10241;202279;121;0;0;0;0;.00nan;0;0
10242;192780;118;51;2;0;2;1.000;855000;0
10242;196414;118;33;30;6;24;.800;2996000;0
10242;202246;112;24;33;7;26;.788;3851000;0
10242;-1;112;0;0;0;0;.00nan;0;0
10243;192948;111;0;0;0;0;.00nan;0;0
10243;200233;108;66;33;4;29;.879;2771000;0
10243;196372;108;34;11;4;7;.636;829000;0
10243;197912;111;59;26;3;23;.885;3600000;0
10244;197999;116;0;0;0;0;.00nan;0;0
10244;204630;109;60;32;4;28;.875;3600000;0
10244;197038;109;0;0;0;0;.00nan;0;0
10244;-1;116;55;25;3;22;.880;3600000;0
10245;192900;114;91;33;2;31;.939;3600000;0
10245;196324;110;0;0;0;0;.00nan;0;0
10245;197010;110;68;45;5;40;.889;3600000;0
10245;197047;114;0;0;0;0;.00nan;0;0
10246;193687;120;86;28;1;27;.964;3600000;0
10246;200390;120;0;0;0;0;.00nan;0;0
10246;202161;115;67;37;3;34;.919;3600000;0
10246;207439;115;0;0;0;0;.00nan;0;0
10247;192776;119;0;0;0;0;.00nan;0;0
10247;195001;126;0;0;0;0;.00nan;0;0
10247;195017;119;60;44;5;39;.886;3574000;0
10247;212039;126;65;29;3;26;.897;3600000;0
10248;200353;123;79;35;3;32;.914;3600000;0
10248;197059;113;40;27;4;23;.852;3544000;0
10248;-1;113;0;0;0;0;.00nan;0;0
10248;-1;123;0;0;0;0;.00nan;0;0
10249;195089;124;41;28;5;23;.821;3562000;0
10249;206731;124;0;0;0;0;.00nan;0;0
10249;206864;127;70;40;4;36;.900;3600000;0
10249;202314;127;0;0;0;0;.00nan;0;0
10250;199481;122;78;37;3;34;.919;3900000;0
10250;205469;122;0;0;0;0;.00nan;0;0
10250;207493;121;0;0;0;0;.00nan;0;0
10250;202279;121;76;36;3;33;.917;3865000;0
10251;192948;111;87;28;1;27;.964;3600000;0
10251;202161;115;0;0;0;0;.00nan;0;0
10251;207439;115;35;31;5;26;.839;3600000;0
10251;197912;111;0;0;0;0;.00nan;0;0
10252;195089;124;0;0;0;0;.00nan;0;0
10252;195111;125;37;35;6;29;.829;3600000;0
10252;195392;125;0;0;0;0;.00nan;0;0
10252;206731;124;62;31;3;28;.903;3600000;0
10253;199481;122;0;0;0;0;.00nan;0;0
10253;205469;122;52;31;5;26;.839;3585000;0
10253;196324;110;53;32;4;28;.875;3600000;0
10253;197010;110;0;0;0;0;.00nan;0;0
10254;192776;119;72;42;2;40;.952;3900000;0
10254;192780;118;0;0;0;0;.00nan;0;0
10254;195017;119;0;0;0;0;.00nan;0;0
10254;196414;118;78;27;2;25;.926;3900000;0
10255;203412;117;0;0;0;0;.00nan;0;0
10255;204630;109;100;49;2;47;.959;3600000;0
10255;197038;109;0;0;0;0;.00nan;0;0
10255;213504;117;29;23;5;18;.783;3600000;0
10256;197999;116;89;18;0;18;1.000;3600000;0
10256;200353;123;0;0;0;0;.00nan;0;0
10256;-1;116;0;0;0;0;.00nan;0;0
10256;-1;123;83;28;1;27;.964;3562000;0
10257;192900;114;63;27;2;25;.926;3182000;0
10257;202246;112;0;0;0;0;.00nan;0;0
10257;-1;112;85;35;2;33;.943;3600000;0
10257;197047;114;37;13;3;10;.769;418000;0
10258;193687;120;51;21;3;18;.857;3699000;0
10258;200390;120;0;0;0;0;.00nan;0;0
10258;197059;113;0;0;0;0;.00nan;0;0
10258;-1;113;52;24;4;20;.833;3699000;0
10259;195001;126;0;0;0;0;.00nan;0;0
10259;195111;125;0;0;0;0;.00nan;0;0
10259;195392;125;60;39;5;34;.872;3554000;0
10259;212039;126;70;36;4;32;.889;3600000;0
10260;199481;122;70;21;1;20;.952;3600000;0
10260;205469;122;0;0;0;0;.00nan;0;0
10260;202246;112;36;23;4;19;.826;3600000;0
10260;-1;112;0;0;0;0;.00nan;0;0
10261;203412;117;51;38;5;33;.868;3517000;0
10261;192948;111;0;0;0;0;.00nan;0;0
10261;197912;111;55;26;3;23;.885;3600000;0
10261;213504;117;0;0;0;0;.00nan;0;0
10262;197999;116;0;0;0;0;.00nan;0;0
10262;204630;109;80;44;5;39;.886;3585000;0
10262;197038;109;0;0;0;0;.00nan;0;0
10262;-1;116;40;18;4;14;.778;3600000;0
10263;192780;118;0;0;0;0;.00nan;0;0
10263;196414;118;82;42;4;38;.905;3881000;0
10263;202161;115;83;42;3;39;.929;3881000;0
10263;207439;115;0;0;0;0;.00nan;0;0
10264;207493;121;55;24;3;21;.875;3600000;0
10264;202279;121;0;0;0;0;.00nan;0;0
10264;197059;113;53;31;4;27;.871;3594000;0
10264;-1;113;0;0;0;0;.00nan;0;0
10265;192776;119;0;0;0;0;.00nan;0;0
10265;195017;119;100;23;0;23;1.000;3600000;0
10265;195111;125;43;38;6;32;.842;3600000;0
10265;195392;125;0;0;0;0;.00nan;0;0
10266;192900;114;0;0;0;0;.00nan;0;0
10266;196324;110;0;0;0;0;.00nan;0;0
10266;197010;110;17;25;6;19;.760;3600000;0
10266;197047;114;77;37;3;34;.919;3600000;0
10267;193687;120;0;0;0;0;.00nan;0;0
10267;200233;108;67;33;3;30;.909;3900000;0
10267;200390;120;83;41;3;38;.927;3900000;0
10267;196372;108;0;0;0;0;.00nan;0;0
10268;195001;126;60;28;3;25;.893;3589000;0
10268;212039;126;0;0;0;0;.00nan;0;0
10268;206864;127;0;0;0;0;.00nan;0;0
10268;202314;127;96;38;2;36;.947;3600000;0
10269;192780;118;69;23;2;21;.913;2678000;0
10269;203412;117;21;28;7;21;.750;3660000;0
10269;196414;118;17;8;4;4;.500;982000;0
10269;213504;117;0;0;0;0;.00nan;0;0
10270;200353;123;0;0;0;0;.00nan;0;0
10270;195089;124;77;36;3;33;.917;3538000;0
10270;206731;124;0;0;0;0;.00nan;0;0
10270;-1;123;81;26;1;25;.962;3600000;0
10271;192776;119;31;28;6;22;.786;2210000;0
10271;192948;111;0;0;0;0;.00nan;0;0
10271;195017;119;46;7;1;6;.857;1311000;0
10271;197912;111;43;26;5;21;.808;3600000;0
10272;204630;109;73;43;4;39;.907;3600000;0
10272;196324;110;71;20;1;19;.950;3600000;0
10272;197010;110;0;0;0;0;.00nan;0;0
10272;197038;109;0;0;0;0;.00nan;0;0
10273;192900;114;0;0;0;0;.00nan;0;0
10273;202161;115;0;0;0;0;.00nan;0;0
10273;207439;115;94;36;2;34;.944;3600000;0
10273;197047;114;51;31;5;26;.839;3600000;0
10274;195089;124;70;30;3;27;.900;3600000;0
10274;206731;124;0;0;0;0;.00nan;0;0
10274;202246;112;64;36;4;32;.889;3567000;0
10274;-1;112;0;0;0;0;.00nan;0;0
10275;193687;120;100;35;0;35;1.000;3600000;0
10275;200390;120;0;0;0;0;.00nan;0;0
10275;206864;127;0;0;0;0;.00nan;0;0
10275;202314;127;62;23;2;21;.913;3520000;0
10276;200233;108;0;0;0;0;.00nan;0;0
10276;196372;108;39;32;5;27;.844;3600000;0
10276;197059;113;0;0;0;0;.00nan;0;0
10276;-1;113;74;28;2;26;.929;3600000;0
10277;197999;116;0;0;0;0;.00nan;0;0
10277;200353;123;0;0;0;0;.00nan;0;0
10277;-1;116;49;19;3;16;.842;3577000;0
10277;-1;123;70;30;2;28;.933;3600000;0
10278;195111;125;80;54;4;50;.926;3600000;0
10278;195392;125;0;0;0;0;.00nan;0;0
10278;207493;121;91;20;0;20;1.000;3600000;0
10278;202279;121;0;0;0;0;.00nan;0;0
10279;192776;119;0;0;0;0;.00nan;0;0
10279;204630;109;31;3;2;1;.333;432000;0
10279;195017;119;75;33;2;31;.939;3600000;0
10279;197038;109;37;28;5;23;.821;3168000;0
10280;192900;114;52;25;3;22;.880;3585000;0
10280;192948;111;85;33;1;32;.970;3600000;0
10280;197047;114;0;0;0;0;.00nan;0;0
10280;197912;111;0;0;0;0;.00nan;0;0
10281;197999;116;49;23;3;20;.870;3585000;0
10281;195089;124;0;0;0;0;.00nan;0;0
10281;206731;124;69;26;2;24;.923;3600000;0
10281;-1;116;0;0;0;0;.00nan;0;0
10282;199481;122;62;31;3;28;.903;3600000;0
10282;205469;122;0;0;0;0;.00nan;0;0
10282;207493;121;84;45;4;41;.911;3592000;0
10282;202279;121;0;0;0;0;.00nan;0;0
10283;192780;118;0;0;0;0;.00nan;0;0
10283;195111;125;0;0;0;0;.00nan;0;0
10283;195392;125;95;44;1;43;.977;3600000;0
10283;196414;118;61;22;2;20;.909;3551000;0
10284;200353;123;65;26;3;23;.885;3754000;0
10284;202246;112;0;0;0;0;.00nan;0;0
10284;-1;112;67;26;2;24;.923;3754000;0
10284;-1;123;0;0;0;0;.00nan;0;0
10285;200233;108;0;0;0;0;.00nan;0;0
10285;195001;126;0;0;0;0;.00nan;0;0
10285;212039;126;81;25;1;24;.960;3600000;0
10285;196372;108;43;38;6;32;.842;3600000;0
10286;203412;117;23;4;3;1;.250;575000;0
10286;202161;115;85;35;3;32;.914;3600000;0
10286;207439;115;0;0;0;0;.00nan;0;0
10286;213504;117;36;26;5;21;.808;3025000;0
10287;197999;116;0;0;0;0;.00nan;0;0
10287;206864;127;36;28;6;22;.786;3600000;0
10287;202314;127;0;0;0;0;.00nan;0;0
10287;-1;116;100;35;1;34;.971;3600000;0
10288;193687;120;65;37;5;32;.865;3600000;0
10288;200390;120;0;0;0;0;.00nan;0;0
10288;195001;126;45;36;6;30;.833;3571000;0
10288;212039;126;0;0;0;0;.00nan;0;0
10289;202161;115;0;0;0;0;.00nan;0;0
10289;207439;115;72;41;3;38;.927;3552000;0
10289;197059;113;70;30;2;28;.933;3600000;0
10289;-1;113;0;0;0;0;.00nan;0;0
10290;192948;111;26;23;5;18;.783;1818000;0
10290;199481;122;0;0;0;0;.00nan;0;0
10290;205469;122;48;22;4;18;.818;3600000;0
10290;197912;111;50;26;4;22;.846;1782000;0
10291;203412;117;58;40;5;35;.875;3900000;0
10291;196324;110;0;0;0;0;.00nan;0;0
10291;197010;110;84;49;5;44;.898;3900000;0
10291;213504;117;0;0;0;0;.00nan;0;0
10292;192776;119;53;43;6;37;.860;3600000;0
10292;195017;119;0;0;0;0;.00nan;0;0
10292;196324;110;50;26;3;23;.885;3600000;0
10292;197010;110;0;0;0;0;.00nan;0;0
10293;203412;117;47;21;3;18;.857;3600000;0
10293;197059;113;0;0;0;0;.00nan;0;0
10293;-1;113;57;37;5;32;.865;3600000;0
10293;213504;117;0;0;0;0;.00nan;0;0
10294;197999;116;0;0;0;0;.00nan;0;0
10294;206864;127;0;0;0;0;.00nan;0;0
10294;202314;127;70;39;3;36;.923;3588000;0
10294;-1;116;65;16;1;15;.938;3600000;0
10295;192900;114;0;0;0;0;.00nan;0;0
10295;204630;109;6;20;7;13;.650;1928000;0
10295;197038;109;57;11;1;10;.909;1672000;0
10295;197047;114;46;25;5;20;.800;3600000;0
10296;199481;122;56;37;5;32;.865;3513000;0
10296;200233;108;68;27;3;24;.889;3600000;0
10296;205469;122;0;0;0;0;.00nan;0;0
10296;196372;108;0;0;0;0;.00nan;0;0
10297;195089;124;54;21;3;18;.857;3900000;0
10297;195111;125;62;34;3;31;.912;3900000;0
10297;195392;125;0;0;0;0;.00nan;0;0
10297;206731;124;0;0;0;0;.00nan;0;0
10298;200353;123;0;0;0;0;.00nan;0;0
10298;202246;112;64;23;2;21;.913;3585000;0
10298;-1;112;0;0;0;0;.00nan;0;0
10298;-1;123;81;26;1;25;.962;3600000;0
10299;192948;111;0;0;0;0;.00nan;0;0
10299;199481;122;0;0;0;0;.00nan;0;0
10299;205469;122;82;33;2;31;.939;3557000;0
10299;197912;111;91;25;1;24;.960;3600000;0
10300;204630;109;79;37;3;34;.919;3600000;0
10300;202161;115;61;21;2;19;.905;3600000;0
10300;207439;115;0;0;0;0;.00nan;0;0
10300;197038;109;0;0;0;0;.00nan;0;0
10301;195089;124;0;0;0;0;.00nan;0;0
10301;195111;125;0;0;0;0;.00nan;0;0
10301;195392;125;68;26;2;24;.923;3600000;0
10301;206731;124;36;28;5;23;.821;3600000;0
10302;192776;119;17;20;6;14;.700;2109000;0
10302;193687;120;84;26;1;25;.962;3600000;0
10302;200390;120;0;0;0;0;.00nan;0;0
10302;195017;119;73;16;0;16;1.000;1491000;0
10303;206864;127;68;45;5;40;.889;3638000;0
10303;202314;127;0;0;0;0;.00nan;0;0
10303;197059;113;67;36;4;32;.889;3638000;0
10303;-1;113;0;0;0;0;.00nan;0;0
10304;195001;126;0;0;0;0;.00nan;0;0
10304;212039;126;61;28;4;24;.857;3900000;0
10304;196324;110;0;0;0;0;.00nan;0;0
10304;197010;110;47;28;4;24;.857;3900000;0
10305;192780;118;0;0;0;0;.00nan;0;0
10305;196414;118;89;43;3;40;.930;3544000;0
10305;207493;121;67;26;2;24;.923;3600000;0
10305;202279;121;0;0;0;0;.00nan;0;0
10306;192948;111;56;25;3;22;.880;3338000;0
10306;202246;112;0;0;0;0;.00nan;0;0
10306;-1;112;76;27;2;25;.926;3600000;0
10306;197912;111;25;6;3;3;.500;262000;0
10307;192776;119;0;0;0;0;.00nan;0;0
10307;195017;119;69;31;2;29;.935;3556000;0
10307;195089;124;100;30;0;30;1.000;3600000;0
10307;206731;124;0;0;0;0;.00nan;0;0
10308;192780;118;56;27;3;24;.889;3535000;0
10308;200353;123;73;23;1;22;.957;3600000;0
10308;196414;118;0;0;0;0;.00nan;0;0
10308;-1;123;0;0;0;0;.00nan;0;0
10309;196324;110;45;21;4;17;.810;3600000;0
10309;197010;110;0;0;0;0;.00nan;0;0
10309;197059;113;0;0;0;0;.00nan;0;0
10309;-1;113;74;38;3;35;.921;3600000;0
10310;192900;114;0;0;0;0;.00nan;0;0
10310;203412;117;81;28;1;27;.964;3600000;0
10310;197047;114;57;26;3;23;.885;3522000;0
10310;213504;117;0;0;0;0;.00nan;0;0
10311;199481;122;63;19;1;18;.947;3600000;0
10311;204630;109;66;35;4;31;.886;3600000;0
10311;205469;122;0;0;0;0;.00nan;0;0
10311;197038;109;0;0;0;0;.00nan;0;0
10312;197999;116;0;0;0;0;.00nan;0;0
10312;192900;114;62;41;5;36;.878;3560000;0
10312;197047;114;0;0;0;0;.00nan;0;0
10312;-1;116;71;34;3;31;.912;3600000;0
10313;200353;123;0;0;0;0;.00nan;0;0
10313;207493;121;77;22;1;21;.955;3600000;0
10313;202279;121;0;0;0;0;.00nan;0;0
10313;-1;123;42;34;6;28;.824;3600000;0
10314;192948;111;45;4;1;3;.750;505000;0
10314;193687;120;73;32;2;30;.938;3600000;0
10314;200390;120;0;0;0;0;.00nan;0;0
10314;197912;111;46;39;6;33;.846;3095000;0
10315;195001;126;63;17;1;16;.941;3600000;0
10315;212039;126;0;0;0;0;.00nan;0;0
10315;206864;127;0;0;0;0;.00nan;0;0
10315;202314;127;61;35;4;31;.886;3600000;0
10316;195111;125;31;40;7;33;.825;3025000;0
10316;195392;125;61;8;0;8;1.000;575000;0
10316;202161;115;73;29;4;25;.862;3600000;0
10316;207439;115;0;0;0;0;.00nan;0;0
10317;192780;118;61;13;1;12;.923;1429000;0
10317;200233;108;36;5;2;3;.600;858000;0
10317;196372;108;23;22;6;16;.727;2689000;0
10317;196414;118;25;23;6;17;.739;2171000;0
10318;204630;109;78;34;2;32;.941;3600000;0
10318;196324;110;0;0;0;0;.00nan;0;0
10318;197010;110;50;21;3;18;.857;3543000;0
10318;197038;109;0;0;0;0;.00nan;0;0
10319;203412;117;90;38;1;37;.974;3600000;0
10319;200233;108;0;0;0;0;.00nan;0;0
10319;196372;108;90;47;2;45;.957;3545000;0
10319;213504;117;0;0;0;0;.00nan;0;0
10320;202161;115;10;16;6;10;.625;3014000;0
10320;207439;115;59;1;0;1;1.000;886000;0
10320;202246;112;68;50;6;44;.880;3900000;0
10320;-1;112;0;0;0;0;.00nan;0;0
10321;192776;119;75;32;2;30;.938;3600000;0
10321;195017;119;0;0;0;0;.00nan;0;0
10321;207493;121;0;0;0;0;.00nan;0;0
10321;202279;121;58;43;5;38;.884;3600000;0
10322;200353;123;0;0;0;0;.00nan;0;0
10322;195089;124;57;40;5;35;.875;3746000;0
10322;206731;124;0;0;0;0;.00nan;0;0
10322;-1;123;36;29;6;23;.793;3746000;0
10323;192780;118;0;0;0;0;.00nan;0;0
10323;193687;120;52;36;4;32;.889;3559000;0
10323;200390;120;0;0;0;0;.00nan;0;0
10323;196414;118;66;24;2;22;.917;3600000;0
10324;195001;126;0;0;0;0;.00nan;0;0
10324;212039;126;56;23;3;20;.870;3600000;0
10324;197059;113;44;4;1;3;.750;627000;0
10324;-1;113;47;47;7;40;.851;2973000;0
10325;203412;117;0;0;0;0;.00nan;0;0
10325;202161;115;0;0;0;0;.00nan;0;0
10325;207439;115;55;36;5;31;.861;3900000;0
10325;213504;117;39;28;5;23;.821;3851000;0
10326;197999;116;0;0;0;0;.00nan;0;0
10326;195111;125;48;51;8;43;.843;3003000;0
10326;195392;125;53;5;0;5;1.000;597000;0
10326;-1;116;64;24;2;22;.917;3600000;0
10327;204630;109;60;47;6;41;.872;3541000;0
10327;200233;108;63;32;4;28;.875;3600000;0
10327;196372;108;0;0;0;0;.00nan;0;0
10327;197038;109;0;0;0;0;.00nan;0;0
10328;196324;110;0;0;0;0;.00nan;0;0
10328;202246;112;0;0;0;0;.00nan;0;0
10328;197010;110;74;24;2;22;.917;3600000;0
10328;-1;112;67;34;3;31;.912;3541000;0
10329;192900;114;0;0;0;0;.00nan;0;0
10329;204630;109;0;0;0;0;.00nan;0;0
10329;197038;109;100;44;1;43;.977;3600000;0
10329;197047;114;65;26;2;24;.923;3590000;0
10330;193687;120;83;39;3;36;.923;3798000;0
10330;200390;120;0;0;0;0;.00nan;0;0
10330;195089;124;64;33;4;29;.879;3798000;0
10330;206731;124;0;0;0;0;.00nan;0;0
10331;192776;119;0;0;0;0;.00nan;0;0
10331;195017;119;52;37;5;32;.865;3864000;0
10331;206864;127;0;0;0;0;.00nan;0;0
10331;202314;127;59;36;4;32;.889;3864000;0
10332;195111;125;0;0;0;0;.00nan;0;0
10332;195392;125;72;41;5;36;.878;3600000;0
10332;197059;113;0;0;0;0;.00nan;0;0
10332;-1;113;60;26;3;23;.885;3600000;0
10333;192948;111;0;0;0;0;.00nan;0;0
10333;200353;123;90;34;1;33;.971;3600000;0
10333;197912;111;74;28;2;26;.929;3600000;0
10333;-1;123;0;0;0;0;.00nan;0;0
10334;195001;126;0;0;0;0;.00nan;0;0
10334;212039;126;75;26;2;24;.923;3600000;0
10334;207493;121;45;32;5;27;.844;3600000;0
10334;202279;121;0;0;0;0;.00nan;0;0
10335;192776;119;85;36;3;33;.917;3655000;0
10335;193687;120;0;0;0;0;.00nan;0;0
10335;200390;120;51;28;4;24;.857;3655000;0
10335;195017;119;0;0;0;0;.00nan;0;0
10336;192948;111;54;33;5;28;.848;3613000;0
10336;195089;124;0;0;0;0;.00nan;0;0
10336;206731;124;56;33;4;29;.879;3613000;0
10336;197912;111;0;0;0;0;.00nan;0;0
10337;192780;118;0;0;0;0;.00nan;0;0
10337;199481;122;0;0;0;0;.00nan;0;0
10337;205469;122;61;18;2;16;.889;3600000;0
10337;196414;118;64;27;3;24;.889;3565000;0
10338;192900;114;91;40;2;38;.950;3900000;0
10338;200233;108;0;0;0;0;.00nan;0;0
10338;196372;108;74;27;2;25;.926;3900000;0
10338;197047;114;0;0;0;0;.00nan;0;0
10339;200353;123;0;0;0;0;.00nan;0;0
10339;207493;121;65;31;3;28;.903;3600000;0
10339;202279;121;0;0;0;0;.00nan;0;0
10339;-1;123;79;28;1;27;.964;3600000;0
10340;195001;126;76;25;1;24;.960;3600000;0
10340;195111;125;86;61;5;56;.918;3600000;0
10340;195392;125;0;0;0;0;.00nan;0;0
10340;212039;126;0;0;0;0;.00nan;0;0
10341;197999;116;64;37;4;33;.892;3600000;0
10341;203412;117;48;33;5;28;.848;3554000;0
10341;-1;116;0;0;0;0;.00nan;0;0
10341;213504;117;0;0;0;0;.00nan;0;0
10342;204630;109;85;41;3;38;.927;3600000;0
10342;202161;115;36;17;4;13;.765;3543000;0
10342;207439;115;0;0;0;0;.00nan;0;0
10342;197038;109;0;0;0;0;.00nan;0;0
10343;197999;116;0;0;0;0;.00nan;0;0
10343;197059;113;71;41;4;37;.902;3600000;0
10343;-1;113;0;0;0;0;.00nan;0;0
10343;-1;116;58;25;3;22;.880;3600000;0
10344;192948;111;0;0;0;0;.00nan;0;0
10344;206864;127;38;21;4;17;.810;3600000;0
10344;202314;127;0;0;0;0;.00nan;0;0
10344;197912;111;43;34;5;29;.853;3559000;0
10345;200233;108;33;34;6;28;.824;3536000;0
10345;196372;108;0;0;0;0;.00nan;0;0
10345;202246;112;50;28;4;24;.857;3600000;0
10345;-1;112;0;0;0;0;.00nan;0;0
10346;192780;118;54;27;3;24;.889;3600000;0
10346;199481;122;100;37;0;37;1.000;3600000;0
10346;205469;122;0;0;0;0;.00nan;0;0
10346;196414;118;0;0;0;0;.00nan;0;0
10347;203412;117;0;0;0;0;.00nan;0;0
10347;196324;110;75;26;1;25;.962;3600000;0
10347;197010;110;0;0;0;0;.00nan;0;0
10347;213504;117;44;39;5;34;.872;3600000;0
10348;203412;117;79;25;1;24;.960;3600000;0
10348;204630;109;97;39;2;37;.949;3566000;0
10348;197038;109;0;0;0;0;.00nan;0;0
10348;213504;117;0;0;0;0;.00nan;0;0
10349;196324;110;0;0;0;0;.00nan;0;0
10349;202161;115;0;0;0;0;.00nan;0;0
10349;207439;115;50;29;4;25;.862;3557000;0
10349;197010;110;54;20;3;17;.850;3600000;0
10350;195001;126;0;0;0;0;.00nan;0;0
10350;195089;124;31;28;6;22;.786;3600000;0
10350;206731;124;0;0;0;0;.00nan;0;0
10350;212039;126;69;17;2;15;.882;3600000;0
10351;192776;119;0;0;0;0;.00nan;0;0
10351;199481;122;83;41;3;38;.927;3552000;0
10351;205469;122;0;0;0;0;.00nan;0;0
10351;195017;119;73;31;2;29;.935;3600000;0
10352;192948;111;0;0;0;0;.00nan;0;0
10352;200233;108;0;0;0;0;.00nan;0;0
10352;196372;108;74;36;3;33;.917;3600000;0
10352;197912;111;59;31;4;27;.871;3548000;0
10353;206864;127;0;0;0;0;.00nan;0;0
10353;202161;115;61;22;2;20;.909;3600000;0
10353;207439;115;0;0;0;0;.00nan;0;0
10353;202314;127;60;29;3;26;.897;3570000;0
10354;203412;117;63;24;3;21;.875;3600000;0
10354;204630;109;90;55;5;50;.909;3600000;0
10354;197038;109;0;0;0;0;.00nan;0;0
10354;213504;117;0;0;0;0;.00nan;0;0
10355;197999;116;0;0;0;0;.00nan;0;0
10355;202246;112;84;34;2;32;.941;3600000;0
10355;-1;112;0;0;0;0;.00nan;0;0
10355;-1;116;79;31;3;28;.903;3562000;0
10356;192900;114;0;0;0;0;.00nan;0;0
10356;199481;122;51;4;0;4;1.000;634000;0
10356;205469;122;34;36;6;30;.833;2966000;0
10356;197047;114;65;31;3;28;.903;3600000;0
10357;195111;125;0;0;0;0;.00nan;0;0
10357;195392;125;87;43;3;40;.930;3600000;0
10357;207493;121;22;24;6;18;.750;3600000;0
10357;202279;121;0;0;0;0;.00nan;0;0
10358;192948;111;0;0;0;0;.00nan;0;0
10358;200233;108;0;0;0;0;.00nan;0;0
10358;196372;108;62;27;3;24;.889;3600000;0
10358;197912;111;66;48;5;43;.896;3591000;0
10359;192900;114;59;30;4;26;.867;3600000;0
10359;202161;115;0;0;0;0;.00nan;0;0
10359;207439;115;55;38;5;33;.868;3600000;0
10359;197047;114;0;0;0;0;.00nan;0;0
10360;192780;118;0;0;0;0;.00nan;0;0
10360;193687;120;77;22;2;20;.909;3563000;0
10360;200390;120;0;0;0;0;.00nan;0;0
10360;196414;118;96;33;1;32;.970;3600000;0
10361;192776;119;74;32;3;29;.906;3600000;0
10361;195001;126;0;0;0;0;.00nan;0;0
10361;195017;119;0;0;0;0;.00nan;0;0
10361;212039;126;50;28;4;24;.857;3567000;0
10362;196324;110;0;0;0;0;.00nan;0;0
10362;197010;110;77;12;0;12;1.000;3600000;0
10362;197059;113;0;0;0;0;.00nan;0;0
10362;-1;113;54;40;5;35;.875;3600000;0
10363;195089;124;64;45;5;40;.889;3544000;0
10363;206731;124;0;0;0;0;.00nan;0;0
10363;206864;127;0;0;0;0;.00nan;0;0
10363;202314;127;43;14;3;11;.786;3600000;0
10364;200353;123;0;0;0;0;.00nan;0;0
10364;207493;121;0;0;0;0;.00nan;0;0
10364;202279;121;79;33;2;31;.939;3600000;0
10364;-1;123;70;36;4;32;.889;3563000;0
10365;204630;109;100;40;2;38;.950;3600000;0
10365;202246;112;0;0;0;0;.00nan;0;0
10365;-1;112;45;29;4;25;.862;3515000;0
10365;197038;109;0;0;0;0;.00nan;0;0
10366;195089;124;0;0;0;0;.00nan;0;0
10366;195111;125;72;23;1;22;.957;3555000;0
10366;195392;125;24;5;3;2;.400;345000;0
10366;206731;124;60;36;4;32;.889;3900000;0
10367;199481;122;0;0;0;0;.00nan;0;0
10367;200353;123;48;29;5;24;.828;3544000;0
10367;205469;122;59;25;3;22;.880;3600000;0
10367;-1;123;0;0;0;0;.00nan;0;0
10368;192780;118;64;44;5;39;.886;3600000;0
10368;195001;126;98;35;1;34;.971;3600000;0
10368;212039;126;0;0;0;0;.00nan;0;0
10368;196414;118;0;0;0;0;.00nan;0;0
10369;197999;116;54;32;4;28;.875;3560000;0
10369;200233;108;62;31;3;28;.903;3600000;0
10369;196372;108;0;0;0;0;.00nan;0;0
10369;-1;116;0;0;0;0;.00nan;0;0
10370;203412;117;59;29;3;26;.897;3600000;0
10370;197059;113;39;34;6;28;.824;3326000;0
10370;-1;113;55;4;0;4;1.000;274000;0
10370;213504;117;0;0;0;0;.00nan;0;0
10371;202161;115;60;19;2;17;.895;3600000;0
10371;207439;115;0;0;0;0;.00nan;0;0
10371;202246;112;71;43;5;38;.884;3600000;0
10371;-1;112;0;0;0;0;.00nan;0;0
10372;197999;116;59;7;0;7;1.000;771000;0
10372;192948;111;76;33;3;30;.909;3600000;0
10372;197912;111;0;0;0;0;.00nan;0;0
10372;-1;116;40;33;6;27;.818;2829000;0
10373;192900;114;0;0;0;0;.00nan;0;0
10373;203412;117;0;0;0;0;.00nan;0;0
10373;197047;114;51;39;5;34;.872;3600000;0
10373;213504;117;70;35;3;32;.914;3600000;0
10374;193687;120;54;33;5;28;.848;3600000;0
10374;200390;120;0;0;0;0;.00nan;0;0
10374;207493;121;37;34;6;28;.824;3585000;0
10374;202279;121;0;0;0;0;.00nan;0;0
10375;192780;118;0;0;0;0;.00nan;0;0
10375;196414;118;100;28;0;28;1.000;3600000;0
10375;197059;113;51;15;2;13;.867;1491000;0
10375;-1;113;18;27;7;20;.741;2109000;0
10376;192776;119;0;0;0;0;.00nan;0;0
10376;195017;119;70;18;1;17;.944;3600000;0
10376;195111;125;57;12;1;11;.917;1337000;0
10376;195392;125;28;28;6;22;.786;2263000;0
10377;206864;127;61;27;3;24;.889;3600000;0
10377;196324;110;0;0;0;0;.00nan;0;0
10377;202314;127;0;0;0;0;.00nan;0;0
10377;197010;110;66;40;4;36;.900;3550000;0
10378;193687;120;66;18;1;17;.944;3646000;0
10378;200390;120;0;0;0;0;.00nan;0;0
10378;207493;121;80;32;2;30;.938;3646000;0
10378;202279;121;0;0;0;0;.00nan;0;0
10379;192900;114;0;0;0;0;.00nan;0;0
10379;202246;112;65;33;3;30;.909;3600000;0
10379;-1;112;0;0;0;0;.00nan;0;0
10379;197047;114;69;25;2;23;.920;3600000;0
10380;197999;116;0;0;0;0;.00nan;0;0
10380;203412;117;41;18;3;15;.833;3572000;0
10380;-1;116;81;32;2;30;.938;3600000;0
10380;213504;117;0;0;0;0;.00nan;0;0
10381;199481;122;73;29;4;25;.862;3900000;0
10381;205469;122;0;0;0;0;.00nan;0;0
10381;195089;124;56;40;4;36;.900;3900000;0
10381;206731;124;0;0;0;0;.00nan;0;0
10382;195001;126;0;0;0;0;.00nan;0;0
10382;212039;126;85;36;2;34;.944;3600000;0
10382;206864;127;0;0;0;0;.00nan;0;0
10382;202314;127;38;28;5;23;.821;3600000;0
10383;192900;114;47;34;5;29;.853;3324000;0
10383;202161;115;77;30;2;28;.933;3600000;0
10383;207439;115;0;0;0;0;.00nan;0;0
10383;197047;114;41;2;1;1;.500;276000;0
10384;192780;118;0;0;0;0;.00nan;0;0
10384;196414;118;47;29;5;24;.828;3900000;0
10384;207493;121;51;37;5;32;.865;3900000;0
10384;202279;121;0;0;0;0;.00nan;0;0
10385;204630;109;70;60;7;53;.883;3600000;0
10385;200233;108;0;0;0;0;.00nan;0;0
10385;196372;108;65;28;3;25;.893;3600000;0
10385;197038;109;0;0;0;0;.00nan;0;0
10386;199481;122;49;24;3;21;.875;2673000;0
10386;205469;122;7;8;5;3;.375;927000;0
10386;195111;125;93;22;0;22;1.000;3600000;0
10386;195392;125;0;0;0;0;.00nan;0;0
10387;192948;111;0;0;0;0;.00nan;0;0
10387;204630;109;37;7;2;5;.714;640000;0
10387;197038;109;33;36;6;30;.833;2960000;0
10387;197912;111;67;24;3;21;.875;3600000;0
10388;197999;116;34;22;6;16;.727;2894000;0
10388;202161;115;0;0;0;0;.00nan;0;0
10388;207439;115;44;35;6;29;.829;3900000;0
10388;-1;116;70;11;0;11;1.000;1006000;0
10389;193687;120;62;30;3;27;.900;3600000;0
10389;200390;120;0;0;0;0;.00nan;0;0
10389;196324;110;0;0;0;0;.00nan;0;0
10389;197010;110;52;27;4;23;.852;3558000;0
10390;192776;119;37;20;4;16;.800;3600000;0
10390;195017;119;0;0;0;0;.00nan;0;0
10390;195111;125;69;50;5;45;.900;3556000;0
10390;195392;125;0;0;0;0;.00nan;0;0
10391;203412;117;0;0;0;0;.00nan;0;0
10391;197059;113;0;0;0;0;.00nan;0;0
10391;-1;113;52;38;5;33;.868;3900000;0
10391;213504;117;45;28;5;23;.821;3900000;0
10392;200353;123;45;41;6;35;.854;2499000;0
10392;206864;127;0;0;0;0;.00nan;0;0
10392;202314;127;90;36;3;33;.917;3600000;0
10392;-1;123;41;7;2;5;.714;1101000;0
10393;195001;126;72;29;4;25;.862;3600000;0
10393;195089;124;34;31;6;25;.806;1957000;0
10393;206731;124;49;21;3;18;.857;1643000;0
10393;212039;126;0;0;0;0;.00nan;0;0
10394;192780;118;0;0;0;0;.00nan;0;0
10394;196414;118;41;26;5;21;.808;3763000;0
10394;207493;121;70;53;6;47;.887;3763000;0
10394;202279;121;0;0;0;0;.00nan;0;0
10395;192948;111;62;38;4;34;.895;3900000;0
10395;202246;112;51;27;4;23;.852;3900000;0
10395;-1;112;0;0;0;0;.00nan;0;0
10395;197912;111;0;0;0;0;.00nan;0;0
10396;192900;114;0;0;0;0;.00nan;0;0
10396;197047;114;61;30;4;26;.867;3691000;0
10396;197059;113;46;33;5;28;.848;3691000;0
10396;-1;113;0;0;0;0;.00nan;0;0
10397;195089;124;83;33;2;31;.939;3600000;0
10397;206731;124;0;0;0;0;.00nan;0;0
10397;206864;127;0;0;0;0;.00nan;0;0
10397;202314;127;51;31;4;27;.871;3525000;0
10398;193687;120;0;0;0;0;.00nan;0;0
10398;199481;122;0;0;0;0;.00nan;0;0
10398;200390;120;65;36;4;32;.889;3600000;0
10398;205469;122;89;36;1;35;.972;3600000;0
10399;200353;123;68;12;0;12;1.000;1344000;0
10399;195111;125;0;0;0;0;.00nan;0;0
10399;195392;125;86;43;3;40;.930;3600000;0
10399;-1;123;20;17;5;12;.706;2252000;0
10400;203412;117;98;54;3;51;.944;3600000;0
10400;200233;108;0;0;0;0;.00nan;0;0
10400;196372;108;62;13;1;12;.923;3600000;0
10400;213504;117;0;0;0;0;.00nan;0;0
10401;204630;109;48;42;6;36;.857;2673000;0
10401;202246;112;0;0;0;0;.00nan;0;0
10401;-1;112;83;27;1;26;.963;3600000;0
10401;197038;109;47;6;1;5;.833;927000;0
10402;197999;116;0;0;0;0;.00nan;0;0
10402;200233;108;77;29;2;27;.931;3600000;0
10402;196372;108;0;0;0;0;.00nan;0;0
10402;-1;116;69;36;4;32;.889;3516000;0
10403;200353;123;14;22;6;16;.727;1810000;0
10403;195001;126;0;0;0;0;.00nan;0;0
10403;212039;126;56;23;3;20;.870;3600000;0
10403;-1;123;48;14;2;12;.857;1790000;0
10404;192776;119;0;0;0;0;.00nan;0;0
10404;195017;119;55;22;3;19;.864;3600000;0
10404;207493;121;0;0;0;0;.00nan;0;0
10404;202279;121;63;39;5;34;.872;3553000;0
10405;196324;110;64;34;4;30;.882;3900000;0
10405;197010;110;0;0;0;0;.00nan;0;0
10405;197059;113;0;0;0;0;.00nan;0;0
10405;-1;113;55;45;4;41;.911;3900000;0
10407;195089;124;33;26;5;21;.808;3600000;0
10407;206731;124;0;0;0;0;.00nan;0;0
10407;196324;110;0;0;0;0;.00nan;0;0
10407;197010;110;64;23;2;21;.913;3600000;0
10409;197999;116;0;0;0;0;.00nan;0;0
10409;193687;120;21;24;6;18;.750;3600000;0
10409;200390;120;0;0;0;0;.00nan;0;0
10409;-1;116;53;21;3;18;.857;3600000;0
10411;195001;126;0;0;0;0;.00nan;0;0
10411;212039;126;62;13;1;12;.923;3600000;0
10411;202161;115;61;11;0;11;1.000;796000;0
10411;207439;115;25;27;6;21;.778;2804000;0
10413;192900;114;35;24;5;19;.792;3900000;0
10413;192948;111;0;0;0;0;.00nan;0;0
10413;197047;114;0;0;0;0;.00nan;0;0
10413;197912;111;87;52;5;47;.904;3900000;0
10415;195111;125;37;26;4;22;.846;3600000;0
10415;195392;125;0;0;0;0;.00nan;0;0
10415;197059;113;0;0;0;0;.00nan;0;0
10415;-1;113;80;25;1;24;.960;3600000;0
10417;192776;119;86;31;2;29;.935;3600000;0
10417;204630;109;34;27;6;21;.778;2776000;0
10417;195017;119;0;0;0;0;.00nan;0;0
10417;197038;109;55;4;0;4;1.000;824000;0
10419;200233;108;0;0;0;0;.00nan;0;0
10419;206864;127;0;0;0;0;.00nan;0;0
10419;196372;108;73;28;2;26;.929;3900000;0
10419;202314;127;69;27;2;25;.926;3900000;0
10421;192780;118;0;0;0;0;.00nan;0;0
10421;200353;123;72;29;2;27;.931;3898000;0
10421;196414;118;59;29;3;26;.897;3898000;0
10421;-1;123;0;0;0;0;.00nan;0;0
10423;203412;117;69;29;2;27;.931;3600000;0
10423;207493;121;18;27;6;21;.778;2743000;0
10423;202279;121;41;2;1;1;.500;857000;0
10423;197768;117;0;0;0;0;.00nan;0;0
10425;199481;122;0;0;0;0;.00nan;0;0
10425;205469;122;27;22;5;17;.773;3549000;0
10425;202246;112;72;36;4;32;.889;3600000;0
10425;-1;112;0;0;0;0;.00nan;0;0
10427;192948;111;82;32;2;30;.938;3900000;0
10427;195001;126;56;17;2;15;.882;3900000;0
10427;212039;126;0;0;0;0;.00nan;0;0
10427;197912;111;0;0;0;0;.00nan;0;0
10429;196324;110;35;28;5;23;.821;3572000;0
10429;202161;115;80;47;4;43;.915;3600000;0
10429;207439;115;0;0;0;0;.00nan;0;0
10429;197010;110;0;0;0;0;.00nan;0;0
10431;200353;123;0;0;0;0;.00nan;0;0
10431;195089;124;0;0;0;0;.00nan;0;0
10431;206731;124;33;40;7;33;.825;3600000;0
10431;-1;123;51;21;3;18;.857;3600000;0
10433;203412;117;70;27;1;26;.963;3600000;0
10433;197059;113;16;8;4;4;.500;1064000;0
10433;-1;113;51;29;4;25;.862;2536000;0
10433;197768;117;0;0;0;0;.00nan;0;0
10435;204630;109;0;0;0;0;.00nan;0;0
10435;200233;108;50;18;2;16;.889;3600000;0
10435;196372;108;0;0;0;0;.00nan;0;0
10435;197038;109;74;56;6;50;.893;3600000;0
10437;192776;119;0;0;0;0;.00nan;0;0
10437;192900;114;0;0;0;0;.00nan;0;0
10437;195017;119;61;22;2;20;.909;3900000;0
10437;197047;114;87;33;2;31;.939;3900000;0
10439;197999;116;54;19;3;16;.842;3780000;0
10439;192780;118;65;37;4;33;.892;3780000;0
10439;196414;118;0;0;0;0;.00nan;0;0
10439;-1;116;0;0;0;0;.00nan;0;0
10441;207493;121;0;0;0;0;.00nan;0;0
10441;202246;112;0;0;0;0;.00nan;0;0
10441;202279;121;19;27;6;21;.778;3600000;0
10441;-1;112;62;15;1;14;.933;3600000;0
10443;193687;120;0;0;0;0;.00nan;0;0
10443;200390;120;98;27;0;27;1.000;3600000;0
10443;195111;125;0;0;0;0;.00nan;0;0
10443;195392;125;78;41;3;38;.927;3600000;0
10445;199481;122;62;29;3;26;.897;3600000;0
10445;205469;122;0;0;0;0;.00nan;0;0
10445;206864;127;64;42;5;37;.881;3513000;0
10445;202314;127;0;0;0;0;.00nan;0;0
10447;197999;116;0;0;0;0;.00nan;0;0
10447;204630;109;65;39;4;35;.897;3533000;0
10447;197038;109;0;0;0;0;.00nan;0;0
10447;-1;116;67;27;2;25;.926;3600000;0
10449;203412;117;83;39;3;36;.923;3770000;0
10449;195001;126;0;0;0;0;.00nan;0;0
10449;212039;126;71;28;2;26;.929;3770000;0
10449;197768;117;0;0;0;0;.00nan;0;0
10451;199481;122;0;0;0;0;.00nan;0;0
10451;200353;123;37;20;4;16;.800;2095000;0
10451;205469;122;63;31;4;27;.871;3624000;0
10451;-1;123;57;8;1;7;.875;1529000;0
10453;196324;110;0;0;0;0;.00nan;0;0
10453;197010;110;54;27;4;23;.852;3600000;0
10453;197059;113;55;25;3;22;.880;1554000;0
10453;-1;113;35;33;6;27;.818;2046000;0
10455;206864;127;0;0;0;0;.00nan;0;0
10455;202246;112;91;37;1;36;.973;3600000;0
10455;202314;127;25;18;5;13;.722;3600000;0
10455;-1;112;0;0;0;0;.00nan;0;0
10457;195089;124;37;20;4;16;.800;3600000;0
10457;206731;124;0;0;0;0;.00nan;0;0
10457;202161;115;37;28;5;23;.821;3564000;0
10457;207439;115;0;0;0;0;.00nan;0;0
10459;200233;108;0;0;0;0;.00nan;0;0
10459;196372;108;68;29;3;26;.897;3600000;0
10459;207493;121;65;41;4;37;.902;3533000;0
10459;202279;121;0;0;0;0;.00nan;0;0
10461;192780;118;0;0;0;0;.00nan;0;0
10461;192900;114;78;32;3;29;.906;3579000;0
10461;196414;118;73;26;2;24;.923;3600000;0
10461;197047;114;0;0;0;0;.00nan;0;0
10463;193687;120;0;0;0;0;.00nan;0;0
10463;200390;120;50;32;4;28;.875;3548000;0
10463;195111;125;73;29;2;27;.931;3600000;0
10463;195392;125;0;0;0;0;.00nan;0;0
10465;192776;119;72;25;2;23;.920;3548000;0
10465;192948;111;0;0;0;0;.00nan;0;0
10465;195017;119;0;0;0;0;.00nan;0;0
10465;197912;111;92;21;0;21;1.000;3600000;0
10467;192780;118;88;47;3;44;.936;3886000;0
10467;203412;117;43;19;4;15;.789;3886000;0
10467;196414;118;0;0;0;0;.00nan;0;0
10467;197768;117;0;0;0;0;.00nan;0;0
10469;199481;122;64;32;3;29;.906;3600000;0
10469;205469;122;0;0;0;0;.00nan;0;0
10469;207493;121;0;0;0;0;.00nan;0;0
10469;202279;121;65;24;2;22;.917;3600000;0
10471;192948;111;0;0;0;0;.00nan;0;0
10471;204630;109;40;8;2;6;.750;735000;0
10471;197038;109;32;40;7;33;.825;2865000;0
10471;197912;111;49;24;3;21;.875;3600000;0
10473;192776;119;0;0;0;0;.00nan;0;0
10473;195017;119;25;25;5;20;.800;3567000;0
10473;202161;115;0;0;0;0;.00nan;0;0
10473;207439;115;58;26;3;23;.885;3600000;0
10475;192900;114;0;0;0;0;.00nan;0;0
10475;206864;127;14;21;6;15;.714;2857000;0
10475;202314;127;39;8;2;6;.750;743000;0
10475;197047;114;80;37;3;34;.919;3600000;0
10477;195111;125;0;0;0;0;.00nan;0;0
10477;195392;125;55;43;6;37;.860;3600000;0
10477;196324;110;83;25;1;24;.960;3600000;0
10477;197010;110;0;0;0;0;.00nan;0;0
10479;200233;108;61;28;3;25;.893;3600000;0
10479;196372;108;0;0;0;0;.00nan;0;0
10479;197059;113;20;17;5;12;.706;1493000;0
10479;-1;113;24;22;6;16;.727;2107000;0
10481;197999;116;65;28;2;26;.929;3600000;0
10481;202246;112;54;24;3;21;.875;1756000;0
10481;-1;112;17;20;6;14;.700;1844000;0
10481;-1;116;0;0;0;0;.00nan;0;0
10483;193687;120;70;33;3;30;.909;3774000;0
10483;200390;120;0;0;0;0;.00nan;0;0
10483;195001;126;69;37;4;33;.892;3774000;0
10483;212039;126;0;0;0;0;.00nan;0;0
10485;200353;123;55;32;4;28;.875;3600000;0
10485;195089;124;0;0;0;0;.00nan;0;0
10485;206731;124;79;37;3;34;.919;3600000;0
10485;-1;123;0;0;0;0;.00nan;0;0
10487;192780;118;0;0;0;0;.00nan;0;0
10487;192948;111;61;31;4;27;.871;3579000;0
10487;196414;118;86;35;3;32;.914;3600000;0
10487;197912;111;0;0;0;0;.00nan;0;0
10489;195111;125;35;30;5;25;.833;2740000;0
10489;195392;125;29;13;4;9;.692;860000;0
10489;196324;110;0;0;0;0;.00nan;0;0
10489;197010;110;82;25;1;24;.960;3600000;0
10491;195089;124;0;0;0;0;.00nan;0;0
10491;206731;124;26;29;6;23;.793;3574000;0
10491;206864;127;0;0;0;0;.00nan;0;0
10491;202314;127;54;34;4;30;.882;3600000;0
10493;207493;121;40;27;5;22;.815;3541000;0
10493;202246;112;67;33;3;30;.909;3600000;0
10493;202279;121;0;0;0;0;.00nan;0;0
10493;-1;112;0;0;0;0;.00nan;0;0
10495;192776;119;60;22;2;20;.909;3588000;0
10495;193687;120;99;41;1;40;.976;3600000;0
10495;200390;120;0;0;0;0;.00nan;0;0
10495;195017;119;0;0;0;0;.00nan;0;0
10497;204630;109;92;43;2;41;.953;3900000;0
10497;197038;109;0;0;0;0;.00nan;0;0
10497;197059;113;72;28;2;26;.929;3900000;0
10497;-1;113;0;0;0;0;.00nan;0;0
10499;195001;126;0;0;0;0;.00nan;0;0
10499;212039;126;52;22;3;19;.864;3600000;0
10499;202161;115;50;1;0;1;1.000;238000;0
10499;207439;115;45;42;6;36;.857;3362000;0
10501;203412;117;81;53;5;48;.906;3575000;0
10501;200233;108;0;0;0;0;.00nan;0;0
10501;196372;108;50;25;4;21;.840;3600000;0
10501;197768;117;0;0;0;0;.00nan;0;0
10503;197999;116;44;12;2;10;.833;536000;0
10503;200353;123;0;0;0;0;.00nan;0;0
10503;-1;116;34;31;6;25;.806;3064000;0
10503;-1;123;37;20;4;16;.800;3600000;0
10505;192900;114;0;0;0;0;.00nan;0;0
10505;199481;122;0;0;0;0;.00nan;0;0
10505;205469;122;85;41;2;39;.951;3600000;0
10505;197047;114;58;32;3;29;.906;3574000;0
10507;200353;123;21;12;4;8;.667;1078000;0
10507;207493;121;0;0;0;0;.00nan;0;0
10507;202279;121;55;34;4;30;.882;3600000;0
10507;-1;123;50;24;3;21;.875;2522000;0
10509;203412;117;66;30;3;27;.900;3600000;0
10509;204630;109;55;3;0;3;1.000;359000;0
10509;197038;109;71;54;6;48;.889;3241000;0
10509;197768;117;0;0;0;0;.00nan;0;0
10511;200233;108;65;31;3;28;.903;3570000;0
10511;196324;110;64;22;2;20;.909;3600000;0
10511;196372;108;0;0;0;0;.00nan;0;0
10511;197010;110;0;0;0;0;.00nan;0;0
10513;206864;127;64;28;2;26;.929;3600000;0
10513;202314;127;0;0;0;0;.00nan;0;0
10513;197059;113;0;0;0;0;.00nan;0;0
10513;-1;113;85;37;3;34;.919;3600000;0
10515;192900;114;58;31;3;28;.903;3548000;0
10515;195111;125;0;0;0;0;.00nan;0;0
10515;195392;125;75;24;2;22;.917;3600000;0
10515;197047;114;0;0;0;0;.00nan;0;0
10517;192780;118;79;30;2;28;.933;3623000;0
10517;199481;122;78;29;1;28;.966;3623000;0
10517;205469;122;0;0;0;0;.00nan;0;0
10517;196414;118;0;0;0;0;.00nan;0;0
10519;197999;116;41;17;3;14;.824;3600000;0
10519;192948;111;0;0;0;0;.00nan;0;0
10519;197912;111;19;23;6;17;.739;3600000;0
10519;-1;116;0;0;0;0;.00nan;0;0
10521;193687;120;79;23;0;23;1.000;2402000;0
10521;200390;120;37;21;4;17;.810;1168000;0
10521;202161;115;76;30;2;28;.933;3600000;0
10521;207439;115;0;0;0;0;.00nan;0;0
10523;192776;119;36;12;3;9;.750;1267000;0
10523;195001;126;51;22;3;19;.864;3600000;0
10523;195017;119;26;20;5;15;.750;2333000;0
10523;212039;126;0;0;0;0;.00nan;0;0
10525;195089;124;49;20;3;17;.850;3900000;0
10525;206731;124;0;0;0;0;.00nan;0;0
10525;202246;112;0;0;0;0;.00nan;0;0
10525;-1;112;76;36;3;33;.917;3900000;0
10527;206864;127;0;0;0;0;.00nan;0;0
10527;196324;110;0;0;0;0;.00nan;0;0
10527;202314;127;46;36;6;30;.833;3600000;0
10527;197010;110;51;20;3;17;.850;3600000;0
10529;192776;119;67;34;3;31;.912;3600000;0
10529;195017;119;0;0;0;0;.00nan;0;0
10529;195111;125;51;37;5;32;.865;3600000;0
10529;195392;125;0;0;0;0;.00nan;0;0
10531;202161;115;0;0;0;0;.00nan;0;0
10531;207439;115;85;36;3;33;.917;3750000;0
10531;202246;112;55;21;2;19;.905;3750000;0
10531;-1;112;0;0;0;0;.00nan;0;0
10533;193687;120;0;0;0;0;.00nan;0;0
10533;200353;123;59;25;3;22;.880;3590000;0
10533;200390;120;80;35;2;33;.943;3600000;0
10533;-1;123;0;0;0;0;.00nan;0;0
10535;195089;124;0;0;0;0;.00nan;0;0
10535;206731;124;76;24;1;23;.958;3600000;0
10535;197059;113;40;29;5;24;.828;3600000;0
10535;-1;113;0;0;0;0;.00nan;0;0
10537;197999;116;0;0;0;0;.00nan;0;0
10537;203412;117;59;39;4;35;.897;3900000;0
10537;197768;117;0;0;0;0;.00nan;0;0
10537;-1;116;59;29;4;25;.862;3900000;0
10539;192780;118;0;0;0;0;.00nan;0;0
10539;200233;108;0;0;0;0;.00nan;0;0
10539;196372;108;50;14;2;12;.857;3552000;0
10539;196414;118;83;29;1;28;.966;3600000;0
10541;199481;122;0;0;0;0;.00nan;0;0
10541;205469;122;55;33;4;29;.879;3577000;0
10541;195001;126;0;0;0;0;.00nan;0;0
10541;212039;126;63;25;3;22;.880;3600000;0
10543;192900;114;0;0;0;0;.00nan;0;0
10543;204630;109;98;56;5;51;.911;3600000;0
10543;197038;109;0;0;0;0;.00nan;0;0
10543;197047;114;89;17;0;17;1.000;3600000;0
10545;192948;111;0;0;0;0;.00nan;0;0
10545;207493;121;74;24;1;23;.958;3600000;0
10545;202279;121;0;0;0;0;.00nan;0;0
10545;197912;111;43;25;4;21;.840;3600000;0
1361;192948;111;0;0;0;0;.00nan;0;0
1361;200233;108;0;0;0;0;.00nan;0;0
1361;196372;108;56;21;2;19;.905;3600000;0
1361;197912;111;23;33;7;26;.788;3600000;0
1362;197999;116;0;0;0;0;.00nan;0;0
1362;202246;112;57;27;3;24;.889;3862000;0
1362;-1;112;0;0;0;0;.00nan;0;0
1362;-1;116;56;28;4;24;.857;3862000;0
1363;192900;114;0;0;0;0;.00nan;0;0
1363;196324;110;0;0;0;0;.00nan;0;0
1363;197010;110;63;29;3;26;.897;3600000;0
1363;197047;114;40;23;4;19;.826;3600000;0
1364;203412;117;70;26;2;24;.923;3600000;0
1364;202161;115;18;29;7;22;.759;3600000;0
1364;207439;115;0;0;0;0;.00nan;0;0
1364;213504;117;0;0;0;0;.00nan;0;0
1365;200353;123;83;48;3;45;.938;4191000;0
1365;195001;126;46;22;4;18;.818;4207000;0
1365;212039;126;0;0;0;0;.00nan;0;0
1365;-1;123;0;0;0;0;.00nan;0;0
1366;192776;119;65;43;6;37;.860;3975000;0
1366;195017;119;0;0;0;0;.00nan;0;0
1366;206864;127;0;0;0;0;.00nan;0;0
1366;202314;127;46;48;7;41;.854;4011000;0
1367;192780;118;0;0;0;0;.00nan;0;0
1367;193687;120;69;26;2;24;.923;3600000;0
1367;200390;120;0;0;0;0;.00nan;0;0
1367;196414;118;76;41;3;38;.927;3586000;0
1368;199481;122;81;38;2;36;.947;3552000;0
1368;205469;122;0;0;0;0;.00nan;0;0
1368;195089;124;74;21;1;20;.952;3600000;0
1368;206731;124;0;0;0;0;.00nan;0;0
1369;192948;111;65;23;2;21;.913;2502000;0
1369;200233;108;0;0;0;0;.00nan;0;0
1369;196372;108;100;28;0;28;1.000;3600000;0
1369;197912;111;30;13;4;9;.692;1098000;0
1370;197999;116;0;0;0;0;.00nan;0;0
1370;202246;112;41;21;4;17;.810;3546000;0
1370;-1;112;0;0;0;0;.00nan;0;0
1370;-1;116;53;30;3;27;.900;3600000;0
1371;192900;114;0;0;0;0;.00nan;0;0
1371;196324;110;0;0;0;0;.00nan;0;0
1371;197010;110;70;21;1;20;.952;3600000;0
1371;197047;114;59;26;3;23;.885;3543000;0
1372;203412;117;70;31;2;29;.935;3549000;0
1372;202161;115;90;41;1;40;.976;3600000;0
1372;207439;115;0;0;0;0;.00nan;0;0
1372;213504;117;0;0;0;0;.00nan;0;0
1373;200353;123;58;52;6;46;.885;3336000;0
1373;195001;126;60;20;2;18;.900;3600000;0
1373;212039;126;0;0;0;0;.00nan;0;0
1373;-1;123;51;3;0;3;1.000;264000;0
1374;192776;119;43;39;6;33;.846;4040000;0
1374;195017;119;0;0;0;0;.00nan;0;0
1374;206864;127;0;0;0;0;.00nan;0;0
1374;202314;127;27;25;5;20;.800;4040000;0
1375;192780;118;0;0;0;0;.00nan;0;0
1375;193687;120;80;19;1;18;.947;3600000;0
1375;200390;120;0;0;0;0;.00nan;0;0
1375;196414;118;84;32;2;30;.938;3544000;0
1376;199481;122;45;29;5;24;.828;3600000;0
1376;205469;122;0;0;0;0;.00nan;0;0
1376;195089;124;37;34;6;28;.824;3021000;0
1376;206731;124;43;5;1;4;.800;579000;0
1377;192948;111;0;0;0;0;.00nan;0;0
1377;200233;108;58;14;1;13;.929;2699000;0
1377;196372;108;19;8;4;4;.500;901000;0
1377;197912;111;81;34;2;32;.941;3600000;0
1378;197999;116;0;0;0;0;.00nan;0;0
1378;202246;112;69;29;3;26;.897;3600000;0
1378;-1;112;0;0;0;0;.00nan;0;0
1378;-1;116;39;25;5;20;.800;3535000;0
1379;192900;114;0;0;0;0;.00nan;0;0
1379;196324;110;0;0;0;0;.00nan;0;0
1379;197010;110;74;21;2;19;.905;3600000;0
1379;197047;114;65;33;3;30;.909;3600000;0
1380;203412;117;93;39;2;37;.949;3772000;0
1380;202161;115;96;40;1;39;.975;3772000;0
1380;207439;115;0;0;0;0;.00nan;0;0
1380;213504;117;0;0;0;0;.00nan;0;0
1381;200353;123;89;39;2;37;.949;3600000;0
1381;195001;126;54;21;3;18;.857;3580000;0
1381;212039;126;0;0;0;0;.00nan;0;0
1381;-1;123;0;0;0;0;.00nan;0;0
1382;192776;119;65;38;4;34;.895;4659000;0
1382;195017;119;0;0;0;0;.00nan;0;0
1382;206864;127;0;0;0;0;.00nan;0;0
1382;202314;127;74;50;3;47;.940;4659000;0
1383;192780;118;0;0;0;0;.00nan;0;0
1383;193687;120;66;41;3;38;.927;3876000;0
1383;200390;120;0;0;0;0;.00nan;0;0
1383;196414;118;65;31;4;27;.871;3876000;0
1384;199481;122;50;15;2;13;.867;3600000;0
1384;205469;122;0;0;0;0;.00nan;0;0
1384;195089;124;74;36;3;33;.917;3550000;0
1384;206731;124;0;0;0;0;.00nan;0;0
1385;192948;111;0;0;0;0;.00nan;0;0
1385;200233;108;0;0;0;0;.00nan;0;0
1385;196372;108;78;29;2;27;.931;4098000;0
1385;197912;111;71;33;3;30;.909;4098000;0
1386;197999;116;0;0;0;0;.00nan;0;0
1386;202246;112;55;32;4;28;.875;3560000;0
1386;-1;112;0;0;0;0;.00nan;0;0
1386;-1;116;65;29;3;26;.897;3600000;0
1387;192900;114;0;0;0;0;.00nan;0;0
1387;196324;110;0;0;0;0;.00nan;0;0
1387;197010;110;61;40;5;35;.875;3927000;0
1387;197047;114;56;31;4;27;.871;3927000;0
1388;203412;117;98;23;0;23;1.000;3600000;0
1388;202161;115;55;38;5;33;.868;3600000;0
1388;207439;115;0;0;0;0;.00nan;0;0
1388;213504;117;0;0;0;0;.00nan;0;0
1389;200353;123;80;58;6;52;.897;3600000;0
1389;195001;126;72;18;1;17;.944;3600000;0
1389;212039;126;0;0;0;0;.00nan;0;0
1389;-1;123;0;0;0;0;.00nan;0;0
1390;192776;119;33;32;6;26;.813;3202000;0
1390;195017;119;69;5;0;5;1.000;398000;0
1390;206864;127;0;0;0;0;.00nan;0;0
1390;202314;127;99;31;1;30;.968;3600000;0
1391;192780;118;0;0;0;0;.00nan;0;0
1391;193687;120;25;23;5;18;.783;1869000;0
1391;200390;120;61;14;1;13;.929;1731000;0
1391;196414;118;66;31;3;28;.903;3600000;0
1392;199481;122;50;30;4;26;.867;3600000;0
1392;205469;122;0;0;0;0;.00nan;0;0
1392;195089;124;38;32;5;27;.844;3557000;0
1392;206731;124;0;0;0;0;.00nan;0;0
1598;192948;111;31;3;2;1;.333;349000;0
1598;200233;108;0;0;0;0;.00nan;0;0
1598;196372;108;54;31;4;27;.871;3600000;0
1598;197912;111;19;27;6;21;.778;3251000;0
1599;197999;116;0;0;0;0;.00nan;0;0
1599;202246;112;48;19;3;16;.842;3600000;0
1599;-1;112;0;0;0;0;.00nan;0;0
1599;-1;116;34;17;4;13;.765;3568000;0
1600;192900;114;0;0;0;0;.00nan;0;0
1600;196324;110;0;0;0;0;.00nan;0;0
1600;197010;110;53;25;4;21;.840;3540000;0
1600;197047;114;73;33;2;31;.939;3600000;0
1601;203412;117;61;24;2;22;.917;3600000;0
1601;202161;115;68;31;3;28;.903;3600000;0
1601;207439;115;0;0;0;0;.00nan;0;0
1601;213504;117;0;0;0;0;.00nan;0;0
1602;200353;123;64;51;6;45;.882;3018000;0
1602;195001;126;56;11;1;10;.909;3600000;0
1602;212039;126;0;0;0;0;.00nan;0;0
1602;-1;123;35;6;2;4;.667;582000;0
1603;192776;119;87;37;3;34;.919;4080000;0
1603;195017;119;0;0;0;0;.00nan;0;0
1603;206864;127;0;0;0;0;.00nan;0;0
1603;202314;127;70;44;4;40;.909;4064000;0
1604;192780;118;58;7;0;7;1.000;700000;0
1604;193687;120;62;30;3;27;.900;3600000;0
1604;200390;120;0;0;0;0;.00nan;0;0
1604;196414;118;20;26;7;19;.731;2900000;0
1605;199481;122;65;23;2;21;.913;3600000;0
1605;205469;122;0;0;0;0;.00nan;0;0
1605;195089;124;80;48;4;44;.917;3583000;0
1605;206731;124;0;0;0;0;.00nan;0;0
1639;197999;116;61;14;1;13;.929;1488000;0
1639;202246;112;24;12;4;8;.667;637000;0
1639;-1;112;69;29;2;27;.931;2907000;0
1639;-1;116;36;20;4;16;.800;2112000;0
1640;192900;114;47;36;6;30;.833;3111000;0
1640;196324;110;48;27;4;23;.852;2405000;0
1640;197010;110;26;12;4;8;.667;1195000;0
1640;197047;114;30;8;3;5;.625;440000;0
1641;203412;117;96;19;0;19;1.000;3600000;0
1641;202161;115;47;25;4;21;.840;3600000;0
1641;207439;115;0;0;0;0;.00nan;0;0
1641;213504;117;0;0;0;0;.00nan;0;0
1642;200353;123;72;44;5;39;.886;3600000;0
1642;195001;126;51;17;2;15;.882;3600000;0
1642;212039;126;0;0;0;0;.00nan;0;0
1642;-1;123;0;0;0;0;.00nan;0;0
1643;192776;119;56;25;3;22;.880;3600000;0
1643;195017;119;0;0;0;0;.00nan;0;0
1643;206864;127;0;0;0;0;.00nan;0;0
1643;202314;127;51;37;5;32;.865;3558000;0
1667;197999;116;0;0;0;0;.00nan;0;0
1667;202246;112;69;20;1;19;.950;3600000;0
1667;-1;112;0;0;0;0;.00nan;0;0
1667;-1;116;54;21;2;19;.905;3564000;0
1668;192776;119;71;22;1;21;.955;3600000;0
1668;195017;119;0;0;0;0;.00nan;0;0
1668;206864;127;0;0;0;0;.00nan;0;0
1668;202314;127;76;47;4;43;.915;3600000;0
1718;200233;108;0;0;0;0;.00nan;0;0
1718;196372;108;54;22;3;19;.864;3771000;0
1718;202246;112;83;30;4;26;.867;3771000;0
1718;-1;112;0;0;0;0;.00nan;0;0
1719;203412;117;94;39;2;37;.949;3600000;0
1719;196324;110;0;0;0;0;.00nan;0;0
1719;197010;110;49;29;4;25;.862;3600000;0
1719;213504;117;0;0;0;0;.00nan;0;0
1720;199481;122;50;37;5;32;.865;3600000;0
1720;205469;122;0;0;0;0;.00nan;0;0
1720;195001;126;71;23;1;22;.957;3600000;0
1720;212039;126;0;0;0;0;.00nan;0;0
1721;192776;119;36;32;6;26;.813;3657000;0
1721;193687;120;42;28;5;23;.821;3657000;0
1721;200390;120;0;0;0;0;.00nan;0;0
1721;195017;119;0;0;0;0;.00nan;0;0
1722;200233;108;53;2;0;2;1.000;324000;0
1722;196372;108;28;27;6;21;.778;3201000;0
1722;202246;112;60;37;4;33;.892;3600000;0
1722;-1;112;0;0;0;0;.00nan;0;0
1723;203412;117;66;45;6;39;.867;3179000;0
1723;196324;110;0;0;0;0;.00nan;0;0
1723;197010;110;56;30;4;26;.867;3600000;0
1723;213504;117;52;2;0;2;1.000;403000;0
1724;199481;122;57;36;4;32;.889;3922000;0
1724;205469;122;0;0;0;0;.00nan;0;0
1724;195001;126;64;26;3;23;.885;3922000;0
1724;212039;126;0;0;0;0;.00nan;0;0
1725;192776;119;87;34;2;32;.941;3600000;0
1725;193687;120;73;34;3;31;.912;3599000;0
1725;200390;120;0;0;0;0;.00nan;0;0
1725;195017;119;0;0;0;0;.00nan;0;0
1726;200233;108;0;0;0;0;.00nan;0;0
1726;196372;108;96;21;0;21;1.000;3600000;0
1726;202246;112;69;42;4;38;.905;3600000;0
1726;-1;112;0;0;0;0;.00nan;0;0
1727;203412;117;79;29;1;28;.966;3600000;0
1727;196324;110;0;0;0;0;.00nan;0;0
1727;197010;110;68;28;2;26;.929;3550000;0
1727;213504;117;0;0;0;0;.00nan;0;0
1728;199481;122;98;47;3;44;.936;3600000;0
1728;205469;122;0;0;0;0;.00nan;0;0
1728;195001;126;74;28;2;26;.929;3600000;0
1728;212039;126;0;0;0;0;.00nan;0;0
1729;192776;119;20;40;9;31;.775;3581000;0
1729;193687;120;26;33;7;26;.788;3600000;0
1729;200390;120;0;0;0;0;.00nan;0;0
1729;195017;119;0;0;0;0;.00nan;0;0
1730;200233;108;0;0;0;0;.00nan;0;0
1730;196372;108;59;32;4;28;.875;3911000;0
1730;202246;112;82;45;3;42;.933;3911000;0
1730;-1;112;0;0;0;0;.00nan;0;0
1731;203412;117;79;24;1;23;.958;3600000;0
1731;196324;110;0;0;0;0;.00nan;0;0
1731;197010;110;66;35;4;31;.886;3600000;0
1731;213504;117;0;0;0;0;.00nan;0;0
1732;199481;122;79;26;1;25;.962;3600000;0
1732;205469;122;0;0;0;0;.00nan;0;0
1732;195001;126;34;26;5;21;.808;3600000;0
1732;212039;126;0;0;0;0;.00nan;0;0
1733;192776;119;72;38;3;35;.921;3600000;0
1733;193687;120;26;36;7;29;.806;3600000;0
1733;200390;120;0;0;0;0;.00nan;0;0
1733;195017;119;0;0;0;0;.00nan;0;0
1921;200233;108;0;0;0;0;.00nan;0;0
1921;196372;108;61;37;4;33;.892;3600000;0
1921;202246;112;49;31;5;26;.839;3582000;0
1921;-1;112;0;0;0;0;.00nan;0;0
1923;199481;122;88;30;1;29;.967;3600000;0
1923;205469;122;0;0;0;0;.00nan;0;0
1923;195001;126;72;31;3;28;.903;3522000;0
1923;212039;126;0;0;0;0;.00nan;0;0
10546;195330;89;52;27;3;24;.889;2672000;0
10546;201792;89;24;12;4;8;.667;928000;0
10546;196495;87;71;32;4;28;.875;3600000;0
10546;-1;87;0;0;0;0;.00nan;0;0
10547;192739;92;81;41;3;38;.927;3553000;0
10547;212343;96;68;26;2;24;.923;3600000;0
10547;196532;92;0;0;0;0;.00nan;0;0
10547;-1;96;0;0;0;0;.00nan;0;0
10548;209784;91;98;38;1;37;.974;3600000;0
10548;200572;95;0;0;0;0;.00nan;0;0
10548;195346;95;74;31;2;29;.935;3559000;0
10548;-1;91;0;0;0;0;.00nan;0;0
10549;194502;86;73;33;2;31;.939;3547000;0
10549;205799;86;0;0;0;0;.00nan;0;0
10549;201888;90;0;0;0;0;.00nan;0;0
10549;-1;90;91;32;1;31;.969;3600000;0
10550;200065;93;35;25;5;20;.800;3600000;0
10550;205318;97;50;25;4;21;.840;1163000;0
10550;205824;97;46;32;6;26;.813;2437000;0
10550;197675;93;0;0;0;0;.00nan;0;0
10551;192718;103;68;44;4;40;.909;3514000;0
10551;194632;102;66;24;2;22;.917;3600000;0
10551;210428;103;0;0;0;0;.00nan;0;0
10551;200549;102;0;0;0;0;.00nan;0;0
10552;197940;100;43;30;5;25;.833;3549000;0
10552;210603;104;68;39;4;35;.897;3600000;0
10552;212368;100;0;0;0;0;.00nan;0;0
10552;208300;104;0;0;0;0;.00nan;0;0
10553;209796;107;0;0;0;0;.00nan;0;0
10553;205112;105;0;0;0;0;.00nan;0;0
10553;-1;105;51;34;5;29;.853;3600000;0
10553;-1;107;79;42;4;38;.905;3600000;0
10554;192733;99;77;36;3;33;.917;3600000;0
10554;194531;99;0;0;0;0;.00nan;0;0
10554;-1;98;49;35;5;30;.857;3600000;0
10554;-1;98;0;0;0;0;.00nan;0;0
10555;192739;92;54;28;4;24;.857;3900000;0
10555;212343;96;52;30;4;26;.867;3900000;0
10555;196532;92;0;0;0;0;.00nan;0;0
10555;-1;96;0;0;0;0;.00nan;0;0
10556;194502;86;65;34;3;31;.912;3900000;0
10556;205799;86;0;0;0;0;.00nan;0;0
10556;196495;87;74;38;3;35;.921;3900000;0
10556;-1;87;0;0;0;0;.00nan;0;0
10557;197940;100;59;27;3;24;.889;3600000;0
10557;210603;104;0;0;0;0;.00nan;0;0
10557;212368;100;0;0;0;0;.00nan;0;0
10557;208300;104;60;34;4;30;.882;3579000;0
10558;194542;88;64;36;5;31;.861;3561000;0
10558;210480;88;0;0;0;0;.00nan;0;0
10558;195330;89;0;0;0;0;.00nan;0;0
10558;201792;89;57;32;4;28;.875;3600000;0
10559;209784;91;55;5;0;5;1.000;839000;0
10559;200572;95;57;19;2;17;.895;3600000;0
10559;195346;95;0;0;0;0;.00nan;0;0
10559;-1;91;48;44;6;38;.864;2761000;0
10560;205112;105;0;0;0;0;.00nan;0;0
10560;196525;94;38;34;6;28;.824;3600000;0
10560;-1;94;0;0;0;0;.00nan;0;0
10560;-1;105;70;32;2;30;.938;3600000;0
10561;200065;93;85;31;2;29;.935;3600000;0
10561;205318;97;26;30;6;24;.800;2726000;0
10561;205824;97;61;16;1;15;.938;874000;0
10561;197675;93;0;0;0;0;.00nan;0;0
10562;196055;106;0;0;0;0;.00nan;0;0
10562;-1;98;77;44;4;40;.909;3583000;0
10562;-1;106;51;22;3;19;.864;3600000;0
10562;-1;98;0;0;0;0;.00nan;0;0
10563;209796;107;0;0;0;0;.00nan;0;0
10563;194899;101;0;0;0;0;.00nan;0;0
10563;201739;101;88;39;2;37;.949;3600000;0
10563;-1;107;49;28;4;24;.857;3575000;0
10564;194542;88;29;28;5;23;.821;3557000;0
10564;210480;88;0;0;0;0;.00nan;0;0
10564;201888;90;0;0;0;0;.00nan;0;0
10564;-1;90;71;40;4;36;.900;3600000;0
10565;192718;103;75;23;1;22;.957;3600000;0
10565;210428;103;0;0;0;0;.00nan;0;0
10565;196055;106;21;22;6;16;.727;2057000;0
10565;-1;106;59;16;1;15;.938;1543000;0
10566;201888;90;0;0;0;0;.00nan;0;0
10566;196495;87;54;45;6;39;.867;3556000;0
10566;-1;90;34;24;5;19;.792;3600000;0
10566;-1;87;0;0;0;0;.00nan;0;0
10567;194502;86;73;30;3;27;.900;3600000;0
10567;205799;86;0;0;0;0;.00nan;0;0
10567;195330;89;78;42;4;38;.905;3569000;0
10567;201792;89;0;0;0;0;.00nan;0;0
10568;194502;86;0;0;0;0;.00nan;0;0
10568;205799;86;98;38;1;37;.974;3795000;0
10568;196495;87;67;24;2;22;.917;3795000;0
10568;-1;87;0;0;0;0;.00nan;0;0
10569;195330;89;39;9;2;7;.778;1198000;0
10569;201792;89;41;25;4;21;.840;2371000;0
10569;201888;90;79;39;3;36;.923;3600000;0
10569;-1;90;0;0;0;0;.00nan;0;0
10570;192739;92;33;37;7;30;.811;3195000;0
10570;200065;93;0;0;0;0;.00nan;0;0
10570;196532;92;52;3;0;3;1.000;347000;0
10570;197675;93;41;29;5;24;.828;3600000;0
10571;200572;95;0;0;0;0;.00nan;0;0
10571;195346;95;69;21;1;20;.952;3600000;0
10571;212343;96;60;36;4;32;.889;3061000;0
10571;-1;96;18;9;4;5;.556;539000;0
10572;209784;91;0;0;0;0;.00nan;0;0
10572;205318;97;59;34;4;30;.882;3543000;0
10572;205824;97;0;0;0;0;.00nan;0;0
10572;-1;91;79;38;3;35;.921;3600000;0
10573;192733;99;77;42;3;39;.929;3515000;0
10573;194531;99;0;0;0;0;.00nan;0;0
10573;194632;102;76;18;1;17;.944;3600000;0
10573;200549;102;0;0;0;0;.00nan;0;0
10574;205112;105;0;0;0;0;.00nan;0;0
10574;196055;106;0;0;0;0;.00nan;0;0
10574;-1;106;55;23;3;20;.870;3585000;0
10574;-1;105;99;38;1;37;.974;3600000;0
10575;197940;100;80;36;2;34;.944;3600000;0
10575;212368;100;0;0;0;0;.00nan;0;0
10575;-1;98;31;24;5;19;.792;3600000;0
10575;-1;98;0;0;0;0;.00nan;0;0
10576;200572;95;62;30;3;27;.900;3587000;0
10576;195346;95;0;0;0;0;.00nan;0;0
10576;196495;87;0;0;0;0;.00nan;0;0
10576;-1;87;99;40;1;39;.975;3600000;0
10577;192739;92;0;0;0;0;.00nan;0;0
10577;194542;88;41;23;4;19;.826;3730000;0
10577;210480;88;0;0;0;0;.00nan;0;0
10577;196532;92;68;48;5;43;.896;3730000;0
10578;194502;86;89;36;1;35;.972;3600000;0
10578;205799;86;0;0;0;0;.00nan;0;0
10578;195330;89;52;33;5;28;.848;3600000;0
10578;201792;89;0;0;0;0;.00nan;0;0
10579;209796;107;0;0;0;0;.00nan;0;0
10579;196525;94;66;37;4;33;.892;3640000;0
10579;-1;94;0;0;0;0;.00nan;0;0
10579;-1;107;29;18;5;13;.722;3640000;0
10580;192718;103;0;0;0;0;.00nan;0;0
10580;210428;103;29;28;6;22;.786;3600000;0
10580;210603;104;64;26;2;24;.923;3600000;0
10580;208300;104;0;0;0;0;.00nan;0;0
10581;194632;102;0;0;0;0;.00nan;0;0
10581;200549;102;43;20;3;17;.850;3573000;0
10581;196055;106;96;31;1;30;.968;3600000;0
10581;-1;106;0;0;0;0;.00nan;0;0
10582;197940;100;0;0;0;0;.00nan;0;0
10582;212368;100;69;33;3;30;.909;3600000;0
10582;-1;98;0;0;0;0;.00nan;0;0
10582;-1;98;38;25;5;20;.800;3581000;0
10583;205112;105;27;19;5;14;.737;3600000;0
10583;194899;101;70;40;4;36;.900;3600000;0
10583;201739;101;0;0;0;0;.00nan;0;0
10583;-1;105;0;0;0;0;.00nan;0;0
10584;194542;88;0;0;0;0;.00nan;0;0
10584;210480;88;63;30;2;28;.933;3900000;0
10584;212343;96;76;27;2;25;.926;3900000;0
10584;-1;96;0;0;0;0;.00nan;0;0
10585;209784;91;0;0;0;0;.00nan;0;0
10585;205318;97;49;35;5;30;.857;3600000;0
10585;205824;97;0;0;0;0;.00nan;0;0
10585;-1;91;49;28;4;24;.857;3600000;0
10586;192733;99;74;27;2;25;.926;3579000;0
10586;194531;99;0;0;0;0;.00nan;0;0
10586;205112;105;0;0;0;0;.00nan;0;0
10586;-1;105;87;33;1;32;.970;3600000;0
10587;205318;97;0;0;0;0;.00nan;0;0
10587;205824;97;76;40;3;37;.925;3600000;0
10587;201888;90;0;0;0;0;.00nan;0;0
10587;-1;90;57;25;4;21;.840;3521000;0
10588;197940;100;68;24;3;21;.875;3900000;0
10588;194899;101;93;41;3;38;.927;3900000;0
10588;201739;101;0;0;0;0;.00nan;0;0
10588;212368;100;0;0;0;0;.00nan;0;0
10589;200572;95;0;0;0;0;.00nan;0;0
10589;195346;95;50;24;3;21;.875;3600000;0
10589;196495;87;94;50;4;46;.920;3600000;0
10589;-1;87;0;0;0;0;.00nan;0;0
10590;192739;92;88;34;1;33;.971;3773000;0
10590;195330;89;67;24;2;22;.917;3773000;0
10590;201792;89;0;0;0;0;.00nan;0;0
10590;196532;92;0;0;0;0;.00nan;0;0
10591;194542;88;52;18;3;15;.833;1991000;0
10591;205318;97;55;43;6;37;.860;3345000;0
10591;210480;88;42;29;5;24;.828;1909000;0
10591;205824;97;32;10;2;8;.800;555000;0
10592;197940;100;0;0;0;0;.00nan;0;0
10592;194899;101;66;34;3;31;.912;3573000;0
10592;201739;101;0;0;0;0;.00nan;0;0
10592;212368;100;77;31;2;29;.935;3600000;0
10593;209784;91;60;30;4;26;.867;3597000;0
10593;194502;86;73;36;3;33;.917;3600000;0
10593;205799;86;0;0;0;0;.00nan;0;0
10593;-1;91;0;0;0;0;.00nan;0;0
10594;200065;93;56;26;3;23;.885;3600000;0
10594;201888;90;0;0;0;0;.00nan;0;0
10594;-1;90;59;53;7;46;.868;3600000;0
10594;197675;93;0;0;0;0;.00nan;0;0
10595;192739;92;61;33;4;29;.879;3570000;0
10595;200572;95;57;22;3;19;.864;3600000;0
10595;195346;95;0;0;0;0;.00nan;0;0
10595;196532;92;0;0;0;0;.00nan;0;0
10596;194632;102;39;20;4;16;.800;3600000;0
10596;200549;102;0;0;0;0;.00nan;0;0
10596;-1;98;50;35;5;30;.857;3600000;0
10596;-1;98;0;0;0;0;.00nan;0;0
10597;209796;107;0;0;0;0;.00nan;0;0
10597;196055;106;0;0;0;0;.00nan;0;0
10597;-1;106;68;25;2;23;.920;3586000;0
10597;-1;107;82;28;1;27;.964;3600000;0
10598;197940;100;96;29;1;28;.966;3600000;0
10598;205112;105;0;0;0;0;.00nan;0;0
10598;212368;100;0;0;0;0;.00nan;0;0
10598;-1;105;70;33;2;31;.939;3600000;0
10599;192718;103;84;17;0;17;1.000;3600000;0
10599;210428;103;0;0;0;0;.00nan;0;0
10599;196525;94;35;32;5;27;.844;3600000;0
10599;-1;94;0;0;0;0;.00nan;0;0
10600;212343;96;0;0;0;0;.00nan;0;0
10600;196495;87;76;27;1;26;.963;3600000;0
10600;-1;87;0;0;0;0;.00nan;0;0
10600;-1;96;89;47;3;44;.936;3567000;0
10601;192739;92;0;0;0;0;.00nan;0;0
10601;194502;86;54;17;2;15;.882;894000;0
10601;205799;86;36;34;6;28;.824;2706000;0
10601;196532;92;72;26;1;25;.962;3600000;0
10602;192733;99;83;43;3;40;.930;3600000;0
10602;209796;107;44;21;4;17;.810;3541000;0
10602;194531;99;0;0;0;0;.00nan;0;0
10602;-1;107;0;0;0;0;.00nan;0;0
10603;197940;100;0;0;0;0;.00nan;0;0
10603;205112;105;33;26;5;21;.808;3515000;0
10603;212368;100;58;27;3;24;.889;3600000;0
10603;-1;105;0;0;0;0;.00nan;0;0
10604;209784;91;0;0;0;0;.00nan;0;0
10604;200065;93;0;0;0;0;.00nan;0;0
10604;-1;91;57;27;3;24;.889;3551000;0
10604;197675;93;52;20;2;18;.900;3600000;0
10605;194542;88;58;34;4;30;.882;3578000;0
10605;210480;88;0;0;0;0;.00nan;0;0
10605;195330;89;0;0;0;0;.00nan;0;0
10605;201792;89;74;33;2;31;.939;3600000;0
10606;205318;97;0;0;0;0;.00nan;0;0
10606;205824;97;83;31;1;30;.968;3900000;0
10606;201888;90;70;16;1;15;.938;3900000;0
10606;-1;90;0;0;0;0;.00nan;0;0
10607;210603;104;77;21;1;20;.952;3900000;0
10607;196055;106;90;36;1;35;.972;3900000;0
10607;-1;106;0;0;0;0;.00nan;0;0
10607;208300;104;0;0;0;0;.00nan;0;0
10608;192718;103;78;25;2;23;.920;3600000;0
10608;210428;103;0;0;0;0;.00nan;0;0
10608;194899;101;0;0;0;0;.00nan;0;0
10608;201739;101;77;27;1;26;.963;3600000;0
10609;205112;105;0;0;0;0;.00nan;0;0
10609;194632;102;83;26;1;25;.962;3600000;0
10609;200549;102;0;0;0;0;.00nan;0;0
10609;-1;105;93;44;3;41;.932;3576000;0
10610;194899;101;72;48;5;43;.896;3600000;0
10610;201739;101;0;0;0;0;.00nan;0;0
10610;-1;98;55;20;2;18;.900;3600000;0
10610;-1;98;0;0;0;0;.00nan;0;0
10611;209784;91;31;8;3;5;.625;1849000;0
10611;205318;97;74;30;2;28;.933;3600000;0
10611;205824;97;0;0;0;0;.00nan;0;0
10611;-1;91;22;22;6;16;.727;1751000;0
10612;194502;86;39;35;6;29;.829;3600000;0
10612;205799;86;0;0;0;0;.00nan;0;0
10612;212343;96;55;41;6;35;.854;2960000;0
10612;-1;96;60;11;1;10;.909;640000;0
10613;209784;91;0;0;0;0;.00nan;0;0
10613;196495;87;60;24;3;21;.875;3900000;0
10613;-1;91;66;32;3;29;.906;3900000;0
10613;-1;87;0;0;0;0;.00nan;0;0
10614;195330;89;0;0;0;0;.00nan;0;0
10614;201792;89;44;42;7;35;.833;3600000;0
10614;212343;96;0;0;0;0;.00nan;0;0
10614;-1;96;68;37;4;33;.892;3600000;0
10615;197940;100;47;39;6;33;.846;3237000;0
10615;200572;95;0;0;0;0;.00nan;0;0
10615;195346;95;79;37;3;34;.919;3600000;0
10615;212368;100;40;2;1;1;.500;363000;0
10616;192718;103;65;28;3;25;.893;3600000;0
10616;194632;102;28;29;6;23;.793;2524000;0
10616;210428;103;0;0;0;0;.00nan;0;0
10616;200549;102;55;13;1;12;.923;1076000;0
10617;209784;91;0;0;0;0;.00nan;0;0
10617;194502;86;45;34;6;28;.824;3600000;0
10617;205799;86;0;0;0;0;.00nan;0;0
10617;-1;91;44;16;3;13;.813;3600000;0
10618;212343;96;57;44;5;39;.886;3600000;0
10618;201888;90;0;0;0;0;.00nan;0;0
10618;-1;90;79;28;1;27;.964;3600000;0
10618;-1;96;0;0;0;0;.00nan;0;0
10619;200065;93;100;25;0;25;1.000;3600000;0
10619;195330;89;84;33;2;31;.939;3570000;0
10619;201792;89;0;0;0;0;.00nan;0;0
10619;197675;93;0;0;0;0;.00nan;0;0
10620;209796;107;0;0;0;0;.00nan;0;0
10620;194632;102;80;29;2;27;.931;3600000;0
10620;200549;102;0;0;0;0;.00nan;0;0
10620;-1;107;64;42;5;37;.881;3600000;0
10621;192733;99;0;0;0;0;.00nan;0;0
10621;194531;99;99;58;2;56;.966;3600000;0
10621;200572;95;0;0;0;0;.00nan;0;0
10621;195346;95;45;15;3;12;.800;3547000;0
10622;197940;100;48;35;5;30;.857;3546000;0
10622;194899;101;0;0;0;0;.00nan;0;0
10622;201739;101;69;47;4;43;.915;3600000;0
10622;212368;100;0;0;0;0;.00nan;0;0
10623;205112;105;0;0;0;0;.00nan;0;0
10623;196525;94;46;26;4;22;.846;3600000;0
10623;-1;94;0;0;0;0;.00nan;0;0
10623;-1;105;78;26;1;25;.962;3600000;0
10624;210603;104;51;26;3;23;.885;3900000;0
10624;196495;87;60;29;3;26;.897;3900000;0
10624;-1;87;0;0;0;0;.00nan;0;0
10624;208300;104;0;0;0;0;.00nan;0;0
10625;196055;106;0;0;0;0;.00nan;0;0
10625;-1;98;80;38;3;35;.921;3542000;0
10625;-1;106;84;35;2;33;.943;3600000;0
10625;-1;98;0;0;0;0;.00nan;0;0
10626;194502;86;0;0;0;0;.00nan;0;0
10626;205799;86;58;38;5;33;.868;3600000;0
10626;201888;90;64;20;2;18;.900;3600000;0
10626;-1;90;0;0;0;0;.00nan;0;0
10627;209784;91;60;31;3;28;.903;3600000;0
10627;195330;89;63;22;2;20;.909;3280000;0
10627;201792;89;23;4;3;1;.250;320000;0
10627;-1;91;0;0;0;0;.00nan;0;0
10628;194542;88;52;22;4;18;.818;3600000;0
10628;210480;88;0;0;0;0;.00nan;0;0
10628;212343;96;0;0;0;0;.00nan;0;0
10628;-1;96;36;29;5;24;.828;3596000;0
10629;192718;103;42;48;7;41;.854;3600000;0
10629;210428;103;0;0;0;0;.00nan;0;0
10629;196495;87;0;0;0;0;.00nan;0;0
10629;-1;87;71;24;3;21;.875;3600000;0
10630;194632;102;0;0;0;0;.00nan;0;0
10630;200549;102;63;36;4;32;.889;3600000;0
10630;210603;104;0;0;0;0;.00nan;0;0
10630;208300;104;49;31;5;26;.839;3600000;0
10631;200572;95;31;16;4;12;.750;3529000;0
10631;195346;95;0;0;0;0;.00nan;0;0
10631;-1;98;0;0;0;0;.00nan;0;0
10631;-1;98;100;46;2;44;.957;3600000;0
10632;192739;92;52;25;4;21;.840;3600000;0
10632;194899;101;37;21;4;17;.810;1067000;0
10632;201739;101;47;32;4;28;.875;2533000;0
10632;196532;92;0;0;0;0;.00nan;0;0
10633;200065;93;48;47;7;40;.851;3600000;0
10633;205318;97;0;0;0;0;.00nan;0;0
10633;205824;97;54;24;3;21;.875;3600000;0
10633;197675;93;0;0;0;0;.00nan;0;0
10634;209796;107;0;0;0;0;.00nan;0;0
10634;210603;104;78;33;2;31;.939;3600000;0
10634;-1;107;48;22;3;19;.864;3575000;0
10634;208300;104;0;0;0;0;.00nan;0;0
10635;194542;88;0;0;0;0;.00nan;0;0
10635;210480;88;35;34;6;28;.824;3600000;0
10635;201888;90;0;0;0;0;.00nan;0;0
10635;-1;90;54;41;5;36;.878;3600000;0
10636;194502;86;74;36;3;33;.917;3632000;0
10636;205799;86;0;0;0;0;.00nan;0;0
10636;195330;89;0;0;0;0;.00nan;0;0
10636;201792;89;57;29;4;25;.862;3632000;0
10637;200065;93;90;41;2;39;.951;3600000;0
10637;205318;97;63;38;3;35;.921;3553000;0
10637;205824;97;0;0;0;0;.00nan;0;0
10637;197675;93;0;0;0;0;.00nan;0;0
10638;194632;102;76;31;3;28;.903;3554000;0
10638;200549;102;0;0;0;0;.00nan;0;0
10638;200572;95;67;27;2;25;.926;3600000;0
10638;195346;95;0;0;0;0;.00nan;0;0
10639;196495;87;64;25;2;23;.920;3600000;0
10639;196525;94;91;35;1;34;.971;3600000;0
10639;-1;94;0;0;0;0;.00nan;0;0
10639;-1;87;0;0;0;0;.00nan;0;0
10640;192739;92;31;16;4;12;.750;1077000;0
10640;196532;92;67;28;2;26;.929;2523000;0
10640;-1;98;81;31;2;29;.935;3600000;0
10640;-1;98;0;0;0;0;.00nan;0;0
10641;209784;91;44;30;5;25;.833;3600000;0
10641;212343;96;72;28;2;26;.929;3600000;0
10641;-1;91;0;0;0;0;.00nan;0;0
10641;-1;96;0;0;0;0;.00nan;0;0
10642;209796;107;80;28;1;27;.964;3600000;0
10642;196495;87;21;34;7;27;.794;3600000;0
10642;-1;107;0;0;0;0;.00nan;0;0
10642;-1;87;0;0;0;0;.00nan;0;0
10643;192733;99;81;27;2;25;.926;3600000;0
10643;192739;92;45;19;3;16;.842;3583000;0
10643;194531;99;0;0;0;0;.00nan;0;0
10643;196532;92;0;0;0;0;.00nan;0;0
10644;200572;95;0;0;0;0;.00nan;0;0
10644;194899;101;0;0;0;0;.00nan;0;0
10644;195346;95;87;30;1;29;.967;3600000;0
10644;201739;101;75;35;3;32;.914;3565000;0
10645;205112;105;0;0;0;0;.00nan;0;0
10645;210603;104;0;0;0;0;.00nan;0;0
10645;-1;105;98;50;3;47;.940;3524000;0
10645;208300;104;88;29;1;28;.966;3600000;0
10646;194542;88;29;27;6;21;.778;3113000;0
10646;205318;97;0;0;0;0;.00nan;0;0
10646;210480;88;29;9;3;6;.667;487000;0
10646;205824;97;73;39;4;35;.897;3600000;0
10647;212343;96;0;0;0;0;.00nan;0;0
10647;196525;94;70;45;5;40;.889;3600000;0
10647;-1;94;0;0;0;0;.00nan;0;0
10647;-1;96;91;27;1;26;.963;3600000;0
10648;209784;91;51;5;1;4;.800;424000;0
10648;200065;93;28;22;6;16;.727;2755000;0
10648;-1;91;28;29;6;23;.793;3200000;0
10648;197675;93;53;4;0;4;1.000;869000;0
10649;195330;89;80;41;3;38;.927;3600000;0
10649;201792;89;0;0;0;0;.00nan;0;0
10649;201888;90;0;0;0;0;.00nan;0;0
10649;-1;90;30;46;8;38;.826;3600000;0
10650;192739;92;56;31;4;27;.871;3571000;0
10650;194632;102;75;31;2;29;.935;3600000;0
10650;200549;102;0;0;0;0;.00nan;0;0
10650;196532;92;0;0;0;0;.00nan;0;0
10651;192733;99;47;34;5;29;.853;3600000;0
10651;194531;99;0;0;0;0;.00nan;0;0
10651;205112;105;0;0;0;0;.00nan;0;0
10651;-1;105;63;18;2;16;.889;3600000;0
10652;210603;104;45;26;5;21;.808;3600000;0
10652;194899;101;64;50;6;44;.880;3572000;0
10652;201739;101;0;0;0;0;.00nan;0;0
10652;208300;104;0;0;0;0;.00nan;0;0
10653;196055;106;89;33;2;31;.939;3600000;0
10653;196495;87;71;39;4;35;.897;3599000;0
10653;-1;106;0;0;0;0;.00nan;0;0
10653;-1;87;0;0;0;0;.00nan;0;0
10654;192718;103;44;22;4;18;.818;3600000;0
10654;210428;103;0;0;0;0;.00nan;0;0
10654;-1;98;25;12;4;8;.667;1146000;0
10654;-1;98;47;16;2;14;.875;2370000;0
10655;194502;86;72;20;1;19;.950;3600000;0
10655;205799;86;0;0;0;0;.00nan;0;0
10655;201888;90;69;30;2;28;.933;3565000;0
10655;-1;90;0;0;0;0;.00nan;0;0
10656;197940;100;69;35;3;32;.914;3600000;0
10656;194632;102;0;0;0;0;.00nan;0;0
10656;200549;102;78;44;4;40;.909;3571000;0
10656;212368;100;0;0;0;0;.00nan;0;0
10657;200065;93;93;37;2;35;.946;3321000;0
10657;194542;88;75;33;3;30;.909;3600000;0
10657;210480;88;0;0;0;0;.00nan;0;0
10657;197675;93;33;9;3;6;.667;265000;0
10658;205112;105;30;43;8;35;.814;3600000;0
10658;196495;87;90;27;1;26;.963;3600000;0
10658;-1;105;0;0;0;0;.00nan;0;0
10658;-1;87;0;0;0;0;.00nan;0;0
10659;209796;107;0;0;0;0;.00nan;0;0
10659;196055;106;0;0;0;0;.00nan;0;0
10659;-1;106;86;27;1;26;.963;3600000;0
10659;-1;107;49;29;5;24;.828;3600000;0
10660;192718;103;0;0;0;0;.00nan;0;0
10660;210428;103;72;36;3;33;.917;3600000;0
10660;-1;98;57;30;4;26;.867;3576000;0
10660;-1;98;0;0;0;0;.00nan;0;0
10661;192733;99;0;0;0;0;.00nan;0;0
10661;194531;99;52;25;3;22;.880;3550000;0
10661;194899;101;0;0;0;0;.00nan;0;0
10661;201739;101;71;28;2;26;.929;3600000;0
10662;209784;91;0;0;0;0;.00nan;0;0
10662;212343;96;65;29;2;27;.931;3900000;0
10662;-1;91;87;36;2;34;.944;3882000;0
10662;-1;96;0;0;0;0;.00nan;0;0
10663;200572;95;0;0;0;0;.00nan;0;0
10663;195330;89;87;48;4;44;.917;3553000;0
10663;195346;95;85;28;2;26;.929;3600000;0
10663;201792;89;0;0;0;0;.00nan;0;0
10664;205318;97;69;30;3;27;.900;3600000;0
10664;205824;97;0;0;0;0;.00nan;0;0
10664;196525;94;44;35;6;29;.829;3600000;0
10664;-1;94;0;0;0;0;.00nan;0;0
10665;192718;103;47;17;2;15;.882;3900000;0
10665;192733;99;100;46;2;44;.957;3900000;0
10665;194531;99;0;0;0;0;.00nan;0;0
10665;210428;103;0;0;0;0;.00nan;0;0
10666;210603;104;49;24;3;21;.875;3552000;0
10666;196055;106;91;40;2;38;.950;3600000;0
10666;-1;106;0;0;0;0;.00nan;0;0
10666;208300;104;0;0;0;0;.00nan;0;0
10667;197940;100;0;0;0;0;.00nan;0;0
10667;192739;92;77;29;2;27;.931;3600000;0
10667;212368;100;46;37;5;32;.865;3600000;0
10667;196532;92;0;0;0;0;.00nan;0;0
10668;200065;93;82;26;1;25;.962;3600000;0
10668;196525;94;51;34;4;30;.882;3600000;0
10668;-1;94;0;0;0;0;.00nan;0;0
10668;197675;93;0;0;0;0;.00nan;0;0
10669;194502;86;80;41;4;37;.902;3556000;0
10669;194542;88;66;23;2;21;.913;3600000;0
10669;210480;88;0;0;0;0;.00nan;0;0
10669;205799;86;0;0;0;0;.00nan;0;0
10670;205112;105;0;0;0;0;.00nan;0;0
10670;194632;102;32;29;6;23;.793;3600000;0
10670;200549;102;0;0;0;0;.00nan;0;0
10670;-1;105;74;22;1;21;.955;3600000;0
10671;209784;91;50;24;3;21;.875;3900000;0
10671;196525;94;0;0;0;0;.00nan;0;0
10671;-1;94;84;36;3;33;.917;3900000;0
10671;-1;91;0;0;0;0;.00nan;0;0
10672;200572;95;34;27;5;22;.815;3658000;0
10672;195346;95;0;0;0;0;.00nan;0;0
10672;201888;90;0;0;0;0;.00nan;0;0
10672;-1;90;58;38;6;32;.842;3658000;0
10673;194899;101;78;28;2;26;.929;3600000;0
10673;201739;101;0;0;0;0;.00nan;0;0
10673;-1;98;78;34;3;31;.912;3545000;0
10673;-1;98;0;0;0;0;.00nan;0;0
10674;210603;104;0;0;0;0;.00nan;0;0
10674;196055;106;0;0;0;0;.00nan;0;0
10674;-1;106;58;42;5;37;.881;3584000;0
10674;208300;104;56;27;3;24;.889;3600000;0
10675;194502;86;72;40;5;35;.875;3521000;0
10675;205799;86;0;0;0;0;.00nan;0;0
10675;196495;87;55;22;3;19;.864;3600000;0
10675;-1;87;0;0;0;0;.00nan;0;0
10676;209784;91;36;12;3;9;.750;1564000;0
10676;212343;96;31;8;3;5;.625;506000;0
10676;-1;91;20;20;5;15;.750;2036000;0
10676;-1;96;74;30;2;28;.933;3094000;0
10677;192739;92;45;21;3;18;.857;3600000;0
10677;205318;97;56;37;4;33;.892;3557000;0
10677;205824;97;0;0;0;0;.00nan;0;0
10677;196532;92;0;0;0;0;.00nan;0;0
10678;209796;107;0;0;0;0;.00nan;0;0
10678;200065;93;55;43;6;37;.860;3552000;0
10678;-1;107;62;41;5;36;.878;3600000;0
10678;197675;93;0;0;0;0;.00nan;0;0
10679;194542;88;52;36;5;31;.861;3600000;0
10679;210480;88;0;0;0;0;.00nan;0;0
10679;195330;89;86;31;2;29;.935;3600000;0
10679;201792;89;0;0;0;0;.00nan;0;0
10680;200572;95;0;0;0;0;.00nan;0;0
10680;195346;95;53;25;3;22;.880;3600000;0
10680;196525;94;90;63;5;58;.921;3578000;0
10680;-1;94;0;0;0;0;.00nan;0;0
10681;194632;102;69;37;3;34;.919;3542000;0
10681;200549;102;0;0;0;0;.00nan;0;0
10681;210603;104;80;31;1;30;.968;3600000;0
10681;208300;104;0;0;0;0;.00nan;0;0
10682;192733;99;65;32;3;29;.906;3600000;0
10682;194531;99;0;0;0;0;.00nan;0;0
10682;-1;98;93;24;0;24;1.000;3600000;0
10682;-1;98;0;0;0;0;.00nan;0;0
10683;192718;103;0;0;0;0;.00nan;0;0
10683;210428;103;68;13;1;12;.923;3600000;0
10683;194899;101;0;0;0;0;.00nan;0;0
10683;201739;101;90;53;4;49;.925;3600000;0
10684;205112;105;0;0;0;0;.00nan;0;0
10684;196055;106;0;0;0;0;.00nan;0;0
10684;-1;106;52;31;4;27;.871;3900000;0
10684;-1;105;57;32;4;28;.875;3900000;0
10685;194542;88;0;0;0;0;.00nan;0;0
10685;210480;88;93;35;1;34;.971;3868000;0
10685;196495;87;90;29;2;27;.931;3868000;0
10685;-1;87;0;0;0;0;.00nan;0;0
10686;200065;93;0;0;0;0;.00nan;0;0
10686;212343;96;55;27;3;24;.889;3517000;0
10686;197675;93;81;33;1;32;.970;3600000;0
10686;-1;96;0;0;0;0;.00nan;0;0
10687;194632;102;0;0;0;0;.00nan;0;0
10687;200549;102;73;41;4;37;.902;3600000;0
10687;210603;104;0;0;0;0;.00nan;0;0
10687;208300;104;18;16;5;11;.688;3561000;0
10688;192739;92;53;2;0;2;1.000;478000;0
10688;196525;94;0;0;0;0;.00nan;0;0
10688;196532;92;49;31;4;27;.871;3122000;0
10688;-1;94;32;33;6;27;.818;3600000;0
10689;197940;100;43;22;4;18;.818;3514000;0
10689;194502;86;85;36;2;34;.944;3600000;0
10689;205799;86;0;0;0;0;.00nan;0;0
10689;212368;100;0;0;0;0;.00nan;0;0
10690;200572;95;37;25;5;20;.800;3600000;0
10690;195346;95;0;0;0;0;.00nan;0;0
10690;201888;90;0;0;0;0;.00nan;0;0
10690;-1;90;83;31;2;29;.935;3600000;0
10691;205112;105;0;0;0;0;.00nan;0;0
10691;194899;101;31;23;5;18;.783;3589000;0
10691;201739;101;0;0;0;0;.00nan;0;0
10691;-1;105;89;46;3;43;.935;3600000;0
10692;209796;107;66;39;5;34;.872;3545000;0
10692;205318;97;0;0;0;0;.00nan;0;0
10692;205824;97;52;21;3;18;.857;3600000;0
10692;-1;107;0;0;0;0;.00nan;0;0
10693;192718;103;75;34;2;32;.941;3600000;0
10693;210428;103;0;0;0;0;.00nan;0;0
10693;196055;106;71;49;4;45;.918;3580000;0
10693;-1;106;0;0;0;0;.00nan;0;0
10694;192733;99;0;0;0;0;.00nan;0;0
10694;194531;99;80;44;4;40;.909;3600000;0
10694;-1;98;81;28;1;27;.964;3600000;0
10694;-1;98;0;0;0;0;.00nan;0;0
10695;194502;86;0;0;0;0;.00nan;0;0
10695;205799;86;68;31;2;29;.935;3600000;0
10695;201888;90;0;0;0;0;.00nan;0;0
10695;-1;90;58;27;4;23;.852;3600000;0
10696;197940;100;68;27;2;25;.926;3600000;0
10696;195330;89;54;25;3;22;.880;3549000;0
10696;201792;89;0;0;0;0;.00nan;0;0
10696;212368;100;0;0;0;0;.00nan;0;0
10697;192733;99;28;37;6;31;.838;3600000;0
10697;194531;99;0;0;0;0;.00nan;0;0
10697;194632;102;85;34;2;32;.941;3600000;0
10697;200549;102;0;0;0;0;.00nan;0;0
10698;209796;107;0;0;0;0;.00nan;0;0
10698;212343;96;0;0;0;0;.00nan;0;0
10698;-1;107;53;27;4;23;.852;3600000;0
10698;-1;96;71;43;5;38;.884;3575000;0
10699;197940;100;91;38;2;36;.947;3652000;0
10699;212368;100;0;0;0;0;.00nan;0;0
10699;196495;87;0;0;0;0;.00nan;0;0
10699;-1;87;59;18;1;17;.944;3652000;0
10700;209784;91;0;0;0;0;.00nan;0;0
10700;196055;106;0;0;0;0;.00nan;0;0
10700;-1;106;62;31;3;28;.903;3521000;0
10700;-1;91;78;28;1;27;.964;3600000;0
10701;192739;92;72;22;1;21;.955;3600000;0
10701;209796;107;0;0;0;0;.00nan;0;0
10701;196532;92;0;0;0;0;.00nan;0;0
10701;-1;107;98;44;2;42;.955;3545000;0
10702;195330;89;69;41;4;37;.902;3600000;0
10702;201792;89;0;0;0;0;.00nan;0;0
10702;201888;90;0;0;0;0;.00nan;0;0
10702;-1;90;56;25;3;22;.880;3600000;0
10703;192733;99;98;62;3;59;.952;3581000;0
10703;194531;99;0;0;0;0;.00nan;0;0
10703;210603;104;0;0;0;0;.00nan;0;0
10703;208300;104;64;19;2;17;.895;3600000;0
10704;194542;88;48;28;4;24;.857;3600000;0
10704;210480;88;0;0;0;0;.00nan;0;0
10704;201888;90;0;0;0;0;.00nan;0;0
10704;-1;90;100;43;0;43;1.000;3600000;0
10705;196055;106;0;0;0;0;.00nan;0;0
10705;212343;96;64;28;3;25;.893;3600000;0
10705;-1;106;64;38;4;34;.895;3600000;0
10705;-1;96;0;0;0;0;.00nan;0;0
10706;192739;92;0;0;0;0;.00nan;0;0
10706;209784;91;0;0;0;0;.00nan;0;0
10706;196532;92;74;34;2;32;.941;3600000;0
10706;-1;91;60;42;4;38;.905;3539000;0
10707;195330;89;0;0;0;0;.00nan;0;0
10707;201792;89;76;27;1;26;.963;3600000;0
10707;196495;87;48;43;6;37;.860;3600000;0
10707;-1;87;0;0;0;0;.00nan;0;0
10708;197940;100;50;32;5;27;.844;3547000;0
10708;194542;88;52;33;4;29;.879;3600000;0
10708;210480;88;0;0;0;0;.00nan;0;0
10708;212368;100;0;0;0;0;.00nan;0;0
10709;209796;107;17;9;4;5;.556;629000;0
10709;200572;95;0;0;0;0;.00nan;0;0
10709;195346;95;93;21;0;21;1.000;3600000;0
10709;-1;107;38;25;4;21;.840;2971000;0
10710;194502;86;93;36;2;34;.944;3564000;0
10710;205318;97;79;25;1;24;.960;3600000;0
10710;205799;86;0;0;0;0;.00nan;0;0
10710;205824;97;0;0;0;0;.00nan;0;0
10711;200065;93;61;50;7;43;.860;3600000;0
10711;194632;102;0;0;0;0;.00nan;0;0
10711;200549;102;88;27;1;26;.963;3600000;0
10711;197675;93;0;0;0;0;.00nan;0;0
10712;192733;99;80;45;4;41;.911;3565000;0
10712;194531;99;0;0;0;0;.00nan;0;0
10712;205112;105;0;0;0;0;.00nan;0;0
10712;-1;105;66;32;3;29;.906;3600000;0
10713;194899;101;78;39;2;37;.949;2700000;0
10713;201739;101;19;8;4;4;.500;900000;0
10713;-1;98;70;26;2;24;.923;3600000;0
10713;-1;98;0;0;0;0;.00nan;0;0
10714;192718;103;0;0;0;0;.00nan;0;0
10714;210428;103;21;27;6;21;.778;3600000;0
10714;196525;94;62;27;3;24;.889;3600000;0
10714;-1;94;0;0;0;0;.00nan;0;0
10715;209784;91;69;29;2;27;.931;3600000;0
10715;209796;107;51;30;3;27;.900;3597000;0
10715;-1;91;0;0;0;0;.00nan;0;0
10715;-1;107;0;0;0;0;.00nan;0;0
10716;192739;92;91;25;0;25;1.000;3600000;0
10716;196055;106;54;34;5;29;.853;3600000;0
10716;196532;92;0;0;0;0;.00nan;0;0
10716;-1;106;0;0;0;0;.00nan;0;0
10717;197940;100;84;38;3;35;.921;3600000;0
10717;212368;100;0;0;0;0;.00nan;0;0
10717;201888;90;0;0;0;0;.00nan;0;0
10717;-1;90;40;30;4;26;.867;3549000;0
10718;205112;105;0;0;0;0;.00nan;0;0
10718;-1;98;0;0;0;0;.00nan;0;0
10718;-1;105;75;37;4;33;.892;3600000;0
10718;-1;98;63;42;5;37;.881;3600000;0
10719;192718;103;82;39;3;36;.923;3655000;0
10719;210428;103;0;0;0;0;.00nan;0;0
10719;210603;104;65;22;2;20;.909;3655000;0
10719;208300;104;0;0;0;0;.00nan;0;0
10720;192733;99;80;41;3;38;.927;3900000;0
10720;194531;99;0;0;0;0;.00nan;0;0
10720;194632;102;65;28;3;25;.893;3900000;0
10720;200549;102;0;0;0;0;.00nan;0;0
10721;200065;93;0;0;0;0;.00nan;0;0
10721;194899;101;58;30;4;26;.867;3565000;0
10721;201739;101;0;0;0;0;.00nan;0;0
10721;197675;93;57;27;3;24;.889;3600000;0
10722;194542;88;61;41;5;36;.878;3882000;0
10722;210480;88;0;0;0;0;.00nan;0;0
10722;195330;89;38;37;6;31;.838;3882000;0
10722;201792;89;0;0;0;0;.00nan;0;0
10723;200572;95;0;0;0;0;.00nan;0;0
10723;195346;95;68;15;1;14;.933;3600000;0
10723;196055;106;0;0;0;0;.00nan;0;0
10723;-1;106;98;50;2;48;.960;3590000;0
10724;194502;86;71;40;3;37;.925;3600000;0
10724;205799;86;0;0;0;0;.00nan;0;0
10724;212343;96;0;0;0;0;.00nan;0;0
10724;-1;96;47;30;5;25;.833;3518000;0
10725;192739;92;49;24;4;20;.833;3900000;0
10725;205318;97;93;50;4;46;.920;3900000;0
10725;205824;97;0;0;0;0;.00nan;0;0
10725;196532;92;0;0;0;0;.00nan;0;0
10726;210603;104;55;17;2;15;.882;3600000;0
10726;194899;101;0;0;0;0;.00nan;0;0
10726;201739;101;48;38;6;32;.842;3600000;0
10726;208300;104;0;0;0;0;.00nan;0;0
10727;200065;93;84;31;1;30;.968;3600000;0
10727;-1;98;51;36;5;31;.861;3600000;0
10727;-1;98;0;0;0;0;.00nan;0;0
10727;197675;93;0;0;0;0;.00nan;0;0
10728;194542;88;62;30;3;27;.900;3600000;0
10728;210480;88;0;0;0;0;.00nan;0;0
10728;195330;89;43;11;2;9;.818;606000;0
10728;201792;89;41;36;6;30;.833;2994000;0
10729;205112;105;39;10;2;8;.800;677000;0
10729;200572;95;0;0;0;0;.00nan;0;0
10729;195346;95;77;27;1;26;.963;3600000;0
10729;-1;105;13;25;7;18;.720;2923000;0
10730;209784;91;0;0;0;0;.00nan;0;0
10730;201888;90;0;0;0;0;.00nan;0;0
10730;-1;91;55;31;4;27;.871;3600000;0
10730;-1;90;84;28;2;26;.929;3600000;0
10731;209796;107;0;0;0;0;.00nan;0;0
10731;194632;102;0;0;0;0;.00nan;0;0
10731;200549;102;68;32;3;29;.906;3600000;0
10731;-1;107;73;47;5;42;.894;3531000;0
10732;192733;99;80;35;3;32;.914;3564000;0
10732;200065;93;0;0;0;0;.00nan;0;0
10732;194531;99;0;0;0;0;.00nan;0;0
10732;197675;93;76;31;2;29;.935;3600000;0
10733;194502;86;72;25;2;23;.920;3600000;0
10733;205799;86;0;0;0;0;.00nan;0;0
10733;196495;87;22;22;6;16;.727;3272000;0
10733;-1;87;50;1;0;1;1.000;328000;0
10734;192739;92;38;19;4;15;.789;3600000;0
10734;194502;86;0;0;0;0;.00nan;0;0
10734;205799;86;59;47;6;41;.872;3550000;0
10734;196532;92;0;0;0;0;.00nan;0;0
10735;194542;88;86;61;6;55;.902;3691000;0
10735;210480;88;0;0;0;0;.00nan;0;0
10735;200572;95;25;18;5;13;.722;3691000;0
10735;195346;95;0;0;0;0;.00nan;0;0
10736;205318;97;19;10;4;6;.600;987000;0
10736;205824;97;68;16;0;16;1.000;2560000;0
10736;212343;96;81;43;3;40;.930;3600000;0
10736;-1;96;0;0;0;0;.00nan;0;0
10737;209784;91;0;0;0;0;.00nan;0;0
10737;205112;105;0;0;0;0;.00nan;0;0
10737;-1;105;64;33;3;30;.909;3600000;0
10737;-1;91;96;23;0;23;1.000;3600000;0
10738;197940;100;72;31;2;29;.935;3552000;0
10738;200065;93;99;39;1;38;.974;3600000;0
10738;212368;100;0;0;0;0;.00nan;0;0
10738;197675;93;0;0;0;0;.00nan;0;0
10739;192733;99;0;0;0;0;.00nan;0;0
10739;209796;107;0;0;0;0;.00nan;0;0
10739;194531;99;50;45;6;39;.867;3600000;0
10739;-1;107;93;32;1;31;.969;3600000;0
10740;192718;103;0;0;0;0;.00nan;0;0
10740;210428;103;35;34;6;28;.824;3572000;0
10740;201888;90;47;5;1;4;.800;396000;0
10740;-1;90;62;39;4;35;.897;3204000;0
10741;194632;102;62;29;3;26;.897;3600000;0
10741;200549;102;0;0;0;0;.00nan;0;0
10741;210603;104;61;41;5;36;.878;3295000;0
10741;208300;104;39;1;1;0;.000;305000;0
10742;194899;101;82;38;3;35;.921;3549000;0
10742;196055;106;0;0;0;0;.00nan;0;0
10742;201739;101;0;0;0;0;.00nan;0;0
10742;-1;106;58;21;2;19;.905;3600000;0
10743;196525;94;91;46;3;43;.935;3529000;0
10743;-1;98;86;29;1;28;.966;3600000;0
10743;-1;94;0;0;0;0;.00nan;0;0
10743;-1;98;0;0;0;0;.00nan;0;0
10744;195330;89;31;26;6;20;.769;3707000;0
10744;201792;89;0;0;0;0;.00nan;0;0
10744;196495;87;71;46;5;41;.891;3701000;0
10744;-1;87;0;0;0;0;.00nan;0;0
10745;192739;92;0;0;0;0;.00nan;0;0
10745;205112;105;0;0;0;0;.00nan;0;0
10745;196532;92;84;17;0;17;1.000;3600000;0
10745;-1;105;54;36;5;31;.861;3600000;0
10746;205318;97;71;21;1;20;.952;3600000;0
10746;205824;97;0;0;0;0;.00nan;0;0
10746;212343;96;0;0;0;0;.00nan;0;0
10746;-1;96;62;35;4;31;.886;3600000;0
10747;196525;94;0;0;0;0;.00nan;0;0
10747;-1;98;0;0;0;0;.00nan;0;0
10747;-1;94;62;31;3;28;.903;3536000;0
10747;-1;98;90;31;1;30;.968;3600000;0
10748;192718;103;57;44;4;40;.909;3900000;0
10748;194632;102;0;0;0;0;.00nan;0;0
10748;210428;103;0;0;0;0;.00nan;0;0
10748;200549;102;78;45;4;41;.911;3900000;0
10749;210603;104;0;0;0;0;.00nan;0;0
10749;201888;90;77;35;2;33;.943;3600000;0
10749;-1;90;0;0;0;0;.00nan;0;0
10749;208300;104;37;31;6;25;.806;3600000;0
10750;192733;99;58;37;5;32;.865;3524000;0
10750;194531;99;0;0;0;0;.00nan;0;0
10750;196055;106;58;28;3;25;.893;3600000;0
10750;-1;106;0;0;0;0;.00nan;0;0
10751;195330;89;30;28;6;22;.786;2279000;0
10751;201792;89;60;16;1;15;.938;1321000;0
10751;196495;87;0;0;0;0;.00nan;0;0
10751;-1;87;59;22;3;19;.864;3600000;0
10752;194899;101;0;0;0;0;.00nan;0;0
10752;201739;101;90;33;1;32;.970;3600000;0
10752;-1;98;37;33;6;27;.818;3600000;0
10752;-1;98;0;0;0;0;.00nan;0;0
10753;194502;86;0;0;0;0;.00nan;0;0
10753;194542;88;52;30;4;26;.867;3537000;0
10753;210480;88;0;0;0;0;.00nan;0;0
10753;205799;86;98;37;2;35;.946;3600000;0
10754;192739;92;0;0;0;0;.00nan;0;0
10754;200572;95;0;0;0;0;.00nan;0;0
10754;195346;95;56;30;4;26;.867;3567000;0
10754;196532;92;91;46;3;43;.935;3600000;0
10755;197940;100;71;23;2;21;.913;3600000;0
10755;192733;99;21;24;6;18;.750;2245000;0
10755;194531;99;50;17;2;15;.882;1355000;0
10755;212368;100;0;0;0;0;.00nan;0;0
10756;201888;90;0;0;0;0;.00nan;0;0
10756;196525;94;35;32;6;26;.813;2858000;0
10756;-1;94;40;8;2;6;.750;742000;0
10756;-1;90;83;24;1;23;.958;3600000;0
10757;194899;101;52;36;5;31;.861;3600000;0
10757;201739;101;0;0;0;0;.00nan;0;0
10757;-1;98;0;0;0;0;.00nan;0;0
10757;-1;98;39;37;6;31;.838;3600000;0
10758;205318;97;36;34;6;28;.824;2980000;0
10758;205824;97;49;1;0;1;1.000;573000;0
10758;195330;89;0;0;0;0;.00nan;0;0
10758;201792;89;30;28;5;23;.821;3600000;0
10759;205112;105;0;0;0;0;.00nan;0;0
10759;210603;104;0;0;0;0;.00nan;0;0
10759;-1;105;88;30;2;28;.933;3881000;0
10759;208300;104;80;43;2;41;.953;3900000;0
10760;197940;100;0;0;0;0;.00nan;0;0
10760;192733;99;48;0;0;0;.00nan;297000;0
10760;194531;99;64;43;6;37;.860;3303000;0
10760;212368;100;66;24;2;22;.917;3600000;0
10761;196055;106;0;0;0;0;.00nan;0;0
10761;201888;90;60;20;2;18;.900;3600000;0
10761;-1;106;45;34;5;29;.853;3600000;0
10761;-1;90;0;0;0;0;.00nan;0;0
10762;205318;97;57;5;0;5;1.000;743000;0
10762;205824;97;29;28;6;22;.786;2857000;0
10762;196495;87;65;25;2;23;.920;3600000;0
10762;-1;87;0;0;0;0;.00nan;0;0
10763;194502;86;0;0;0;0;.00nan;0;0
10763;194542;88;0;0;0;0;.00nan;0;0
10763;210480;88;87;18;0;18;1.000;3600000;0
10763;205799;86;94;37;2;35;.946;3575000;0
10764;200572;95;54;19;2;17;.895;3600000;0
10764;195330;89;60;42;6;36;.857;3600000;0
10764;195346;95;0;0;0;0;.00nan;0;0
10764;201792;89;0;0;0;0;.00nan;0;0
10765;200065;93;61;33;4;29;.879;3600000;0
10765;212343;96;69;42;5;37;.881;3590000;0
10765;197675;93;0;0;0;0;.00nan;0;0
10765;-1;96;0;0;0;0;.00nan;0;0
10766;209796;107;0;0;0;0;.00nan;0;0
10766;201888;90;40;8;2;6;.750;494000;0
10766;-1;107;53;26;4;22;.846;3600000;0
10766;-1;90;43;42;7;35;.833;3106000;0
10767;197940;100;10;10;5;5;.500;2151000;0
10767;192733;99;79;30;1;29;.967;3600000;0
10767;194531;99;0;0;0;0;.00nan;0;0
10767;212368;100;27;13;4;9;.692;1449000;0
10768;205112;105;0;0;0;0;.00nan;0;0
10768;210603;104;100;26;0;26;1.000;3600000;0
10768;-1;105;70;23;1;22;.957;3557000;0
10768;208300;104;0;0;0;0;.00nan;0;0
10769;196055;106;0;0;0;0;.00nan;0;0
10769;196525;94;49;34;5;29;.853;3522000;0
10769;-1;94;0;0;0;0;.00nan;0;0
10769;-1;106;75;33;3;30;.909;3600000;0
10770;209784;91;55;4;0;4;1.000;757000;0
10770;-1;98;99;34;1;33;.971;3600000;0
10770;-1;91;6;20;7;13;.650;2843000;0
10770;-1;98;0;0;0;0;.00nan;0;0
10771;192739;92;0;0;0;0;.00nan;0;0
10771;196495;87;0;0;0;0;.00nan;0;0
10771;196532;92;38;27;5;22;.815;3583000;0
10771;-1;87;55;31;4;27;.871;3600000;0
10772;194542;88;0;0;0;0;.00nan;0;0
10772;210480;88;79;32;2;30;.938;3797000;0
10772;200572;95;0;0;0;0;.00nan;0;0
10772;195346;95;50;19;3;16;.842;3797000;0
10773;200065;93;0;0;0;0;.00nan;0;0
10773;212343;96;0;0;0;0;.00nan;0;0
10773;197675;93;56;29;4;25;.862;3600000;0
10773;-1;96;95;24;0;24;1.000;3600000;0
10774;196055;106;100;45;2;43;.956;3900000;0
10774;196525;94;0;0;0;0;.00nan;0;0
10774;-1;94;69;31;2;29;.935;3900000;0
10774;-1;106;0;0;0;0;.00nan;0;0
10775;192718;103;0;0;0;0;.00nan;0;0
10775;205112;105;0;0;0;0;.00nan;0;0
10775;210428;103;52;26;3;23;.885;3600000;0
10775;-1;105;89;42;2;40;.952;3600000;0
10776;194502;86;75;38;3;35;.921;3600000;0
10776;205318;97;36;31;6;25;.806;3600000;0
10776;205799;86;0;0;0;0;.00nan;0;0
10776;205824;97;0;0;0;0;.00nan;0;0
10777;192733;99;0;0;0;0;.00nan;0;0
10777;209784;91;69;18;1;17;.944;3600000;0
10777;194531;99;81;38;3;35;.921;3582000;0
10777;-1;91;0;0;0;0;.00nan;0;0
10778;197940;100;8;16;6;10;.625;2225000;0
10778;194899;101;91;51;3;48;.941;3600000;0
10778;201739;101;0;0;0;0;.00nan;0;0
10778;212368;100;51;3;0;3;1.000;1375000;0
10779;205112;105;37;33;6;27;.818;3331000;0
10779;201888;90;0;0;0;0;.00nan;0;0
10779;-1;105;45;7;1;6;.857;269000;0
10779;-1;90;51;17;3;14;.824;3600000;0
10780;209796;107;0;0;0;0;.00nan;0;0
10780;196055;106;0;0;0;0;.00nan;0;0
10780;-1;106;62;29;3;26;.897;3567000;0
10780;-1;107;99;34;1;33;.971;3600000;0
10781;192718;103;100;36;0;36;1.000;3600000;0
10781;194632;102;43;17;3;14;.824;3600000;0
10781;210428;103;0;0;0;0;.00nan;0;0
10781;200549;102;0;0;0;0;.00nan;0;0
10782;194542;88;45;44;6;38;.864;3615000;0
10782;205112;105;61;13;1;12;.923;966000;0
10782;210480;88;0;0;0;0;.00nan;0;0
10782;-1;105;37;25;6;19;.760;2649000;0
10783;209784;91;0;0;0;0;.00nan;0;0
10783;194899;101;0;0;0;0;.00nan;0;0
10783;201739;101;82;28;1;27;.964;3600000;0
10783;-1;91;65;29;3;26;.897;3571000;0
10784;210603;104;71;31;2;29;.935;3600000;0
10784;196525;94;61;33;4;29;.879;3538000;0
10784;-1;94;0;0;0;0;.00nan;0;0
10784;208300;104;0;0;0;0;.00nan;0;0
10785;194542;88;27;27;6;21;.778;2270000;0
10785;210480;88;39;12;3;9;.750;1330000;0
10785;196055;106;0;0;0;0;.00nan;0;0
10785;-1;106;43;32;5;27;.844;3600000;0
10786;192739;92;50;24;4;20;.833;3600000;0
10786;195330;89;52;3;0;3;1.000;341000;0
10786;201792;89;39;36;6;30;.833;3231000;0
10786;196532;92;0;0;0;0;.00nan;0;0
10787;205318;97;45;6;1;5;.833;476000;0
10787;205824;97;35;31;6;25;.806;3124000;0
10787;196495;87;70;30;3;27;.900;3600000;0
10787;-1;87;0;0;0;0;.00nan;0;0
10788;209784;91;54;39;5;34;.872;3600000;0
10788;194632;102;0;0;0;0;.00nan;0;0
10788;200549;102;84;27;1;26;.963;3600000;0
10788;-1;91;0;0;0;0;.00nan;0;0
10789;209796;107;0;0;0;0;.00nan;0;0
10789;-1;98;76;39;4;35;.897;3600000;0
10789;-1;107;86;32;1;31;.969;3600000;0
10789;-1;98;0;0;0;0;.00nan;0;0
10790;194899;101;45;23;4;19;.826;3558000;0
10790;201739;101;0;0;0;0;.00nan;0;0
10790;196525;94;0;0;0;0;.00nan;0;0
10790;-1;94;100;46;2;44;.957;3600000;0
10791;192718;103;64;17;2;15;.882;3600000;0
10791;192733;99;56;42;5;37;.881;3600000;0
10791;194531;99;0;0;0;0;.00nan;0;0
10791;210428;103;0;0;0;0;.00nan;0;0
10792;194502;86;0;0;0;0;.00nan;0;0
10792;200572;95;70;27;2;25;.926;3600000;0
10792;205799;86;66;40;5;35;.875;3600000;0
10792;195346;95;0;0;0;0;.00nan;0;0
10793;200065;93;53;24;3;21;.875;3514000;0
10793;196495;87;81;28;1;27;.964;3600000;0
10793;-1;87;0;0;0;0;.00nan;0;0
10793;197675;93;0;0;0;0;.00nan;0;0
10794;205318;97;0;0;0;0;.00nan;0;0
10794;205824;97;97;41;2;39;.951;3600000;0
10794;195330;89;0;0;0;0;.00nan;0;0
10794;201792;89;53;18;3;15;.833;3543000;0
10795;192733;99;93;32;1;31;.969;3600000;0
10795;194531;99;0;0;0;0;.00nan;0;0
10795;194632;102;46;24;4;20;.833;3600000;0
10795;200549;102;0;0;0;0;.00nan;0;0
10796;197940;100;65;25;2;23;.920;3600000;0
10796;209784;91;0;0;0;0;.00nan;0;0
10796;212368;100;0;0;0;0;.00nan;0;0
10796;-1;91;59;32;4;28;.875;3581000;0
10797;192718;103;83;41;4;37;.902;3600000;0
10797;205112;105;50;1;0;1;1.000;208000;0
10797;210428;103;0;0;0;0;.00nan;0;0
10797;-1;105;31;28;6;22;.786;3334000;0
10798;194542;88;100;39;1;38;.974;3676000;0
10798;210480;88;0;0;0;0;.00nan;0;0
10798;196525;94;82;31;2;29;.935;3676000;0
10798;-1;94;0;0;0;0;.00nan;0;0
10799;210603;104;63;36;4;32;.889;3552000;0
10799;-1;98;85;35;2;33;.943;3600000;0
10799;-1;98;0;0;0;0;.00nan;0;0
10799;208300;104;0;0;0;0;.00nan;0;0
10800;209796;107;0;0;0;0;.00nan;0;0
10800;196055;106;0;0;0;0;.00nan;0;0
10800;-1;106;55;30;4;26;.867;3600000;0
10800;-1;107;86;28;1;27;.964;3600000;0
10801;194502;86;75;27;2;25;.926;3900000;0
10801;205799;86;0;0;0;0;.00nan;0;0
10801;201888;90;78;29;2;27;.931;3900000;0
10801;-1;90;0;0;0;0;.00nan;0;0
10802;205318;97;63;31;3;28;.903;3600000;0
10802;205824;97;0;0;0;0;.00nan;0;0
10802;212343;96;0;0;0;0;.00nan;0;0
10802;-1;96;31;25;5;20;.800;3540000;0
10803;194632;102;0;0;0;0;.00nan;0;0
10803;200549;102;43;26;5;21;.808;3584000;0
10803;196055;106;67;39;4;35;.897;3600000;0
10803;-1;106;0;0;0;0;.00nan;0;0
10804;192739;92;0;0;0;0;.00nan;0;0
10804;196495;87;0;0;0;0;.00nan;0;0
10804;196532;92;71;26;2;24;.923;3600000;0
10804;-1;87;79;44;4;40;.909;3600000;0
10805;209796;107;97;20;0;20;1.000;3600000;0
10805;194542;88;34;17;4;13;.765;1066000;0
10805;210480;88;82;26;1;25;.962;2534000;0
10805;-1;107;0;0;0;0;.00nan;0;0
10806;200065;93;0;0;0;0;.00nan;0;0
10806;195330;89;26;12;4;8;.667;1055000;0
10806;201792;89;82;40;2;38;.950;2545000;0
10806;197675;93;77;25;1;24;.960;3600000;0
10807;192718;103;0;0;0;0;.00nan;0;0
10807;210428;103;61;20;2;18;.900;3600000;0
10807;-1;98;0;0;0;0;.00nan;0;0
10807;-1;98;66;43;4;39;.907;3522000;0
10808;192733;99;96;41;2;39;.951;3600000;0
10808;194531;99;0;0;0;0;.00nan;0;0
10808;210603;104;0;0;0;0;.00nan;0;0
10808;208300;104;81;35;3;32;.914;3600000;0
10809;194899;101;0;0;0;0;.00nan;0;0
10809;201739;101;43;21;4;17;.810;3600000;0
10809;196525;94;0;0;0;0;.00nan;0;0
10809;-1;94;64;49;6;43;.878;3513000;0
10810;201888;90;0;0;0;0;.00nan;0;0
10810;196495;87;62;33;3;30;.909;3900000;0
10810;-1;90;58;36;3;33;.917;3900000;0
10810;-1;87;0;0;0;0;.00nan;0;0
10811;192718;103;70;40;4;36;.900;3585000;0
10811;209796;107;48;21;3;18;.857;3600000;0
10811;210428;103;0;0;0;0;.00nan;0;0
10811;-1;107;0;0;0;0;.00nan;0;0
10812;197940;100;0;0;0;0;.00nan;0;0
10812;196055;106;0;0;0;0;.00nan;0;0
10812;212368;100;70;22;1;21;.955;3600000;0
10812;-1;106;80;45;3;42;.933;3556000;0
10813;194502;86;58;5;0;5;1.000;683000;0
10813;200572;95;49;22;3;19;.864;3600000;0
10813;205799;86;44;34;6;28;.824;2917000;0
10813;195346;95;0;0;0;0;.00nan;0;0
10814;200065;93;100;41;0;41;1.000;3600000;0
10814;212343;96;27;28;6;22;.786;2448000;0
10814;197675;93;0;0;0;0;.00nan;0;0
10814;-1;96;45;8;1;7;.875;1152000;0
10815;197940;100;70;33;3;30;.909;3717000;0
10815;196055;106;75;44;4;40;.909;3717000;0
10815;212368;100;0;0;0;0;.00nan;0;0
10815;-1;106;0;0;0;0;.00nan;0;0
10816;194542;88;87;37;2;35;.946;3806000;0
10816;210480;88;0;0;0;0;.00nan;0;0
10816;210603;104;52;24;3;21;.875;3806000;0
10816;208300;104;0;0;0;0;.00nan;0;0
10817;194632;102;0;0;0;0;.00nan;0;0
10817;200549;102;42;24;4;20;.833;3600000;0
10817;-1;98;40;41;7;34;.829;3600000;0
10817;-1;98;0;0;0;0;.00nan;0;0
10818;192739;92;63;33;3;30;.909;3565000;0
10818;200572;95;0;0;0;0;.00nan;0;0
10818;195346;95;65;23;2;21;.913;3600000;0
10818;196532;92;0;0;0;0;.00nan;0;0
10819;209784;91;0;0;0;0;.00nan;0;0
10819;212343;96;0;0;0;0;.00nan;0;0
10819;-1;91;74;36;3;33;.917;3591000;0
10819;-1;96;100;43;1;42;.977;3600000;0
10820;205112;105;0;0;0;0;.00nan;0;0
10820;194899;101;44;26;4;22;.846;3900000;0
10820;201739;101;0;0;0;0;.00nan;0;0
10820;-1;105;59;29;4;25;.862;3900000;0
10821;192718;103;64;40;4;36;.900;3548000;0
10821;194542;88;94;37;2;35;.946;3600000;0
10821;210428;103;0;0;0;0;.00nan;0;0
10821;210480;88;0;0;0;0;.00nan;0;0
10822;194632;102;67;27;3;24;.889;3600000;0
10822;200549;102;0;0;0;0;.00nan;0;0
10822;-1;98;0;0;0;0;.00nan;0;0
10822;-1;98;60;36;4;32;.889;3559000;0
10823;195330;89;0;0;0;0;.00nan;0;0
10823;201792;89;90;37;3;34;.919;3900000;0
10823;196495;87;67;30;3;27;.900;3900000;0
10823;-1;87;0;0;0;0;.00nan;0;0
10824;200572;95;69;32;3;29;.906;3556000;0
10824;195346;95;0;0;0;0;.00nan;0;0
10824;201888;90;0;0;0;0;.00nan;0;0
10824;-1;90;93;40;2;38;.950;3600000;0
10825;209784;91;48;28;4;24;.857;3900000;0
10825;194542;88;75;37;4;33;.892;3900000;0
10825;210480;88;0;0;0;0;.00nan;0;0
10825;-1;91;0;0;0;0;.00nan;0;0
10826;192739;92;0;0;0;0;.00nan;0;0
10826;212343;96;43;35;6;29;.829;3600000;0
10826;196532;92;76;34;2;32;.941;3600000;0
10826;-1;96;0;0;0;0;.00nan;0;0
10827;200065;93;76;26;2;24;.923;3600000;0
10827;194502;86;0;0;0;0;.00nan;0;0
10827;205799;86;63;33;4;29;.879;3600000;0
10827;197675;93;0;0;0;0;.00nan;0;0
10828;205318;97;68;27;2;25;.926;3564000;0
10828;205824;97;0;0;0;0;.00nan;0;0
10828;196055;106;0;0;0;0;.00nan;0;0
10828;-1;106;100;38;0;38;1.000;3600000;0
10829;194632;102;0;0;0;0;.00nan;0;0
10829;200549;102;65;24;2;22;.917;3600000;0
10829;-1;98;83;41;3;38;.927;3571000;0
10829;-1;98;0;0;0;0;.00nan;0;0
10830;209796;107;0;0;0;0;.00nan;0;0
10830;205112;105;0;0;0;0;.00nan;0;0
10830;-1;105;60;24;2;22;.917;3900000;0
10830;-1;107;72;33;2;31;.939;3900000;0
10831;192733;99;70;25;2;23;.920;3600000;0
10831;194531;99;0;0;0;0;.00nan;0;0
10831;194899;101;0;0;0;0;.00nan;0;0
10831;201739;101;60;36;4;32;.889;3520000;0
10832;197940;100;99;44;2;42;.955;3600000;0
10832;210603;104;0;0;0;0;.00nan;0;0
10832;212368;100;0;0;0;0;.00nan;0;0
10832;208300;104;40;17;3;14;.824;3592000;0
10833;200572;95;0;0;0;0;.00nan;0;0
10833;195330;89;56;46;6;40;.870;3303000;0
10833;195346;95;69;42;4;38;.905;3600000;0
10833;201792;89;54;5;0;5;1.000;233000;0
10834;192739;92;70;16;1;15;.938;3600000;0
10834;201888;90;72;41;3;38;.927;3576000;0
10834;196532;92;0;0;0;0;.00nan;0;0
10834;-1;90;0;0;0;0;.00nan;0;0
10835;209796;107;76;29;2;27;.931;3600000;0
10835;205112;105;0;0;0;0;.00nan;0;0
10835;-1;105;61;28;3;25;.893;3545000;0
10835;-1;107;0;0;0;0;.00nan;0;0
10836;200065;93;93;21;0;21;1.000;3600000;0
10836;196055;106;0;0;0;0;.00nan;0;0
10836;-1;106;76;43;3;40;.930;3600000;0
10836;197675;93;0;0;0;0;.00nan;0;0
10837;194899;101;68;27;2;25;.926;3600000;0
10837;201739;101;0;0;0;0;.00nan;0;0
10837;196525;94;64;26;3;23;.885;3553000;0
10837;-1;94;0;0;0;0;.00nan;0;0
10838;197940;100;0;0;0;0;.00nan;0;0
10838;192718;103;64;11;1;10;.909;3600000;0
10838;210428;103;0;0;0;0;.00nan;0;0
10838;212368;100;53;40;5;35;.875;3600000;0
10839;192733;99;64;34;4;30;.882;3576000;0
10839;194531;99;0;0;0;0;.00nan;0;0
10839;210603;104;67;27;2;25;.926;3600000;0
10839;208300;104;0;0;0;0;.00nan;0;0
10840;194632;102;90;19;0;19;1.000;3600000;0
10840;200549;102;0;0;0;0;.00nan;0;0
10840;-1;98;30;49;8;41;.837;3219000;0
10840;-1;98;50;3;0;3;1.000;381000;0
10841;212343;96;68;31;3;28;.903;3558000;0
10841;201888;90;0;0;0;0;.00nan;0;0
10841;-1;90;81;34;2;32;.941;3600000;0
10841;-1;96;0;0;0;0;.00nan;0;0
10842;194502;86;0;0;0;0;.00nan;0;0
10842;205318;97;50;10;1;9;.900;1897000;0
10842;205799;86;68;30;3;27;.900;3600000;0
10842;205824;97;16;21;6;15;.714;1703000;0
10843;205112;105;43;32;5;27;.844;3558000;0
10843;210603;104;0;0;0;0;.00nan;0;0
10843;-1;105;0;0;0;0;.00nan;0;0
10843;208300;104;40;24;4;20;.833;3600000;0
10844;197940;100;70;31;2;29;.935;3900000;0
10844;209796;107;0;0;0;0;.00nan;0;0
10844;212368;100;0;0;0;0;.00nan;0;0
10844;-1;107;96;38;2;36;.947;3900000;0
10845;192718;103;0;0;0;0;.00nan;0;0
10845;192733;99;0;0;0;0;.00nan;0;0
10845;194531;99;46;26;4;22;.846;3600000;0
10845;210428;103;28;20;5;15;.750;3580000;0
10846;200065;93;62;29;3;26;.897;3600000;0
10846;196495;87;0;0;0;0;.00nan;0;0
10846;-1;87;35;28;5;23;.821;3515000;0
10846;197675;93;0;0;0;0;.00nan;0;0
10847;196525;94;0;0;0;0;.00nan;0;0
10847;-1;98;91;48;2;46;.958;3600000;0
10847;-1;94;50;22;3;19;.864;3590000;0
10847;-1;98;0;0;0;0;.00nan;0;0
10848;200065;93;50;18;3;15;.833;3643000;0
10848;194502;86;0;0;0;0;.00nan;0;0
10848;205799;86;77;44;4;40;.909;3643000;0
10848;197675;93;0;0;0;0;.00nan;0;0
10849;200572;95;0;0;0;0;.00nan;0;0
10849;195346;95;68;20;1;19;.950;3600000;0
10849;212343;96;50;33;4;29;.879;3600000;0
10849;-1;96;0;0;0;0;.00nan;0;0
10850;194502;86;0;0;0;0;.00nan;0;0
10850;205799;86;93;37;2;35;.946;3600000;0
10850;196495;87;80;28;1;27;.964;3600000;0
10850;-1;87;0;0;0;0;.00nan;0;0
10851;212343;96;43;4;1;3;.750;820000;0
10851;201888;90;0;0;0;0;.00nan;0;0
10851;-1;90;59;25;3;22;.880;3600000;0
10851;-1;96;52;41;6;35;.854;2780000;0
10852;194632;102;45;30;5;25;.833;3566000;0
10852;200549;102;0;0;0;0;.00nan;0;0
10852;195330;89;80;17;0;17;1.000;1808000;0
10852;201792;89;37;18;4;14;.778;1792000;0
10853;200065;93;46;33;6;27;.818;3646000;0
10853;194542;88;49;33;5;28;.848;3655000;0
10853;210480;88;0;0;0;0;.00nan;0;0
10853;197675;93;0;0;0;0;.00nan;0;0
10854;209784;91;0;0;0;0;.00nan;0;0
10854;200572;95;39;1;1;0;.000;309000;0
10854;195346;95;16;18;6;12;.667;3291000;0
10854;-1;91;60;31;3;28;.903;3600000;0
10855;192739;92;76;30;3;27;.900;3900000;0
10855;205318;97;72;38;3;35;.921;3900000;0
10855;205824;97;0;0;0;0;.00nan;0;0
10855;196532;92;0;0;0;0;.00nan;0;0
10856;192718;103;85;28;1;27;.964;3600000;0
10856;209796;107;0;0;0;0;.00nan;0;0
10856;210428;103;0;0;0;0;.00nan;0;0
10856;-1;107;65;40;4;36;.900;3600000;0
10857;197940;100;36;22;5;17;.773;3542000;0
10857;212368;100;0;0;0;0;.00nan;0;0
10857;-1;98;0;0;0;0;.00nan;0;0
10857;-1;98;55;29;4;25;.862;3600000;0
10858;210603;104;69;27;2;25;.926;3600000;0
10858;196525;94;97;41;3;38;.927;3600000;0
10858;-1;94;0;0;0;0;.00nan;0;0
10858;208300;104;0;0;0;0;.00nan;0;0
10859;192733;99;28;24;5;19;.792;1944000;0
10859;194531;99;52;16;2;14;.875;1656000;0
10859;196055;106;0;0;0;0;.00nan;0;0
10859;-1;106;90;33;2;31;.939;3600000;0
10860;194632;102;0;0;0;0;.00nan;0;0
10860;200549;102;88;31;1;30;.968;3600000;0
10860;196495;87;0;0;0;0;.00nan;0;0
10860;-1;87;57;37;4;33;.892;3600000;0
10861;194502;86;78;32;2;30;.938;3600000;0
10861;194542;88;56;35;5;30;.857;3600000;0
10861;210480;88;0;0;0;0;.00nan;0;0
10861;205799;86;0;0;0;0;.00nan;0;0
10862;200065;93;45;36;5;31;.861;3600000;0
10862;201888;90;0;0;0;0;.00nan;0;0
10862;-1;90;95;28;1;27;.964;3600000;0
10862;197675;93;0;0;0;0;.00nan;0;0
10863;194899;101;0;0;0;0;.00nan;0;0
10863;195330;89;65;23;1;22;.957;3600000;0
10863;201739;101;96;33;2;31;.939;3590000;0
10863;201792;89;0;0;0;0;.00nan;0;0
10864;209784;91;92;52;3;49;.942;3900000;0
10864;200572;95;37;12;3;9;.750;3900000;0
10864;195346;95;0;0;0;0;.00nan;0;0
10864;-1;91;0;0;0;0;.00nan;0;0
10865;209796;107;37;21;4;17;.810;3600000;0
10865;196525;94;0;0;0;0;.00nan;0;0
10865;-1;94;53;38;5;33;.868;3570000;0
10865;-1;107;0;0;0;0;.00nan;0;0
10866;197940;100;0;0;0;0;.00nan;0;0
10866;212368;100;42;21;4;17;.810;3900000;0
10866;-1;98;94;49;4;45;.918;3900000;0
10866;-1;98;0;0;0;0;.00nan;0;0
10867;192739;92;0;0;0;0;.00nan;0;0
10867;205318;97;0;0;0;0;.00nan;0;0
10867;205824;97;41;32;5;27;.844;3600000;0
10867;196532;92;66;27;2;25;.926;3600000;0
10868;205112;105;0;0;0;0;.00nan;0;0
10868;210603;104;0;0;0;0;.00nan;0;0
10868;-1;105;54;25;3;22;.880;3551000;0
10868;208300;104;82;32;2;30;.938;3600000;0
10869;192733;99;70;42;4;38;.905;3861000;0
10869;194531;99;0;0;0;0;.00nan;0;0
10869;196055;106;49;23;4;19;.826;3900000;0
10869;-1;106;0;0;0;0;.00nan;0;0
10870;194542;88;0;0;0;0;.00nan;0;0
10870;210480;88;48;36;5;31;.861;3600000;0
10870;212343;96;0;0;0;0;.00nan;0;0
10870;-1;96;74;26;2;24;.923;3600000;0
10871;209796;107;61;21;1;20;.952;2550000;0
10871;196055;106;0;0;0;0;.00nan;0;0
10871;-1;106;62;26;2;24;.923;3600000;0
10871;-1;107;35;17;4;13;.765;1050000;0
10872;192718;103;81;30;2;28;.933;3600000;0
10872;205112;105;54;31;4;27;.871;3536000;0
10872;210428;103;0;0;0;0;.00nan;0;0
10872;-1;105;0;0;0;0;.00nan;0;0
10873;194502;86;0;0;0;0;.00nan;0;0
10873;194899;101;46;42;6;36;.857;3600000;0
10873;205799;86;63;27;3;24;.889;3600000;0
10873;201739;101;0;0;0;0;.00nan;0;0
10874;194632;102;83;34;3;31;.912;3600000;0
10874;200549;102;0;0;0;0;.00nan;0;0
10874;201888;90;0;0;0;0;.00nan;0;0
10874;-1;90;72;28;2;26;.929;3600000;0
10875;194899;101;61;9;0;9;1.000;728000;0
10875;201739;101;21;29;7;22;.759;2872000;0
10875;196495;87;78;25;1;24;.960;3600000;0
10875;-1;87;0;0;0;0;.00nan;0;0
10876;194542;88;84;35;3;32;.914;3600000;0
10876;194632;102;44;3;1;2;.667;489000;0
10876;210480;88;0;0;0;0;.00nan;0;0
10876;200549;102;16;25;6;19;.760;3111000;0
10877;200065;93;69;32;3;29;.906;3710000;0
10877;212343;96;63;38;4;34;.895;3710000;0
10877;197675;93;0;0;0;0;.00nan;0;0
10877;-1;96;0;0;0;0;.00nan;0;0
10878;192739;92;0;0;0;0;.00nan;0;0
10878;209784;91;0;0;0;0;.00nan;0;0
10878;196532;92;83;34;2;32;.941;3600000;0
10878;-1;91;69;32;3;29;.906;3577000;0
10879;209796;107;0;0;0;0;.00nan;0;0
10879;205112;105;0;0;0;0;.00nan;0;0
10879;-1;105;71;31;3;28;.903;3554000;0
10879;-1;107;79;26;2;24;.923;3600000;0
10880;192718;103;72;25;1;24;.960;3600000;0
10880;210428;103;0;0;0;0;.00nan;0;0
10880;196525;94;91;34;2;32;.941;3600000;0
10880;-1;94;0;0;0;0;.00nan;0;0
10881;197940;100;33;21;4;17;.810;3513000;0
10881;196055;106;0;0;0;0;.00nan;0;0
10881;212368;100;0;0;0;0;.00nan;0;0
10881;-1;106;68;27;2;25;.926;3600000;0
10882;200065;93;0;0;0;0;.00nan;0;0
10882;200572;95;58;27;3;24;.889;3600000;0
10882;195346;95;0;0;0;0;.00nan;0;0
10882;197675;93;65;44;5;39;.886;3515000;0
10883;194502;86;33;40;7;33;.825;3225000;0
10883;194632;102;58;27;3;24;.889;3600000;0
10883;200549;102;0;0;0;0;.00nan;0;0
10883;205799;86;28;6;3;3;.500;375000;0
10884;194899;101;61;65;7;58;.892;3318000;0
10884;201739;101;52;2;0;2;1.000;282000;0
10884;201888;90;0;0;0;0;.00nan;0;0
10884;-1;90;83;12;0;12;1.000;3600000;0
10885;192739;92;27;18;5;13;.722;3600000;0
10885;212343;96;65;32;3;29;.906;2599000;0
10885;196532;92;0;0;0;0;.00nan;0;0
10885;-1;96;28;13;4;9;.692;973000;0
10886;209784;91;0;0;0;0;.00nan;0;0
10886;195330;89;0;0;0;0;.00nan;0;0
10886;201792;89;45;29;5;24;.828;3900000;0
10886;-1;91;62;44;5;39;.886;3900000;0
10887;205318;97;59;28;4;24;.857;3900000;0
10887;200572;95;0;0;0;0;.00nan;0;0
10887;205824;97;0;0;0;0;.00nan;0;0
10887;195346;95;61;41;4;37;.902;3900000;0
10888;197940;100;46;35;6;29;.829;3600000;0
10888;205112;105;0;0;0;0;.00nan;0;0
10888;212368;100;0;0;0;0;.00nan;0;0
10888;-1;105;57;25;3;22;.880;3600000;0
10889;192733;99;56;31;5;26;.839;3600000;0
10889;194531;99;0;0;0;0;.00nan;0;0
10889;196525;94;69;25;2;23;.920;3600000;0
10889;-1;94;0;0;0;0;.00nan;0;0
10890;192718;103;71;32;3;29;.906;3600000;0
10890;209796;107;26;14;4;10;.714;2501000;0
10890;210428;103;0;0;0;0;.00nan;0;0
10890;-1;107;7;9;5;4;.444;1099000;0
10891;210603;104;57;28;3;25;.893;3600000;0
10891;-1;98;100;40;1;39;.975;3600000;0
10891;-1;98;0;0;0;0;.00nan;0;0
10891;208300;104;0;0;0;0;.00nan;0;0
10892;194502;86;0;0;0;0;.00nan;0;0
10892;205799;86;58;34;4;30;.882;3541000;0
10892;196495;87;49;15;2;13;.867;3600000;0
10892;-1;87;0;0;0;0;.00nan;0;0
10893;194542;88;33;21;4;17;.810;3533000;0
10893;210480;88;0;0;0;0;.00nan;0;0
10893;194899;101;0;0;0;0;.00nan;0;0
10893;201739;101;91;47;2;45;.957;3600000;0
10894;192739;92;0;0;0;0;.00nan;0;0
10894;209784;91;62;44;5;39;.886;3600000;0
10894;196532;92;71;26;2;24;.923;3600000;0
10894;-1;91;0;0;0;0;.00nan;0;0
10895;192718;103;0;0;0;0;.00nan;0;0
10895;209796;107;0;0;0;0;.00nan;0;0
10895;210428;103;57;46;6;40;.870;3600000;0
10895;-1;107;65;22;2;20;.909;3600000;0
10896;200065;93;100;24;0;24;1.000;3600000;0
10896;195330;89;20;29;7;22;.759;2187000;0
10896;201792;89;50;9;1;8;.889;1413000;0
10896;197675;93;0;0;0;0;.00nan;0;0
10897;196055;106;0;0;0;0;.00nan;0;0
10897;196525;94;0;0;0;0;.00nan;0;0
10897;-1;94;65;22;2;20;.909;3600000;0
10897;-1;106;32;46;8;38;.826;3600000;0
10898;210603;104;0;0;0;0;.00nan;0;0
10898;-1;98;0;0;0;0;.00nan;0;0
10898;-1;98;75;46;3;43;.935;3900000;0
10898;208300;104;88;37;3;34;.919;3900000;0
10899;197940;100;0;0;0;0;.00nan;0;0
10899;192733;99;46;6;1;5;.833;490000;0
10899;194531;99;18;29;7;22;.759;3110000;0
10899;212368;100;77;28;2;26;.929;3600000;0
10900;200572;95;0;0;0;0;.00nan;0;0
10900;195346;95;48;23;4;19;.826;3600000;0
10900;212343;96;42;3;1;2;.667;1077000;0
10900;-1;96;24;35;7;28;.800;2523000;0
10901;205318;97;0;0;0;0;.00nan;0;0
10901;205824;97;88;37;2;35;.946;3593000;0
10901;195330;89;0;0;0;0;.00nan;0;0
10901;201792;89;81;28;1;27;.964;3600000;0
10902;205112;105;88;26;1;25;.962;3600000;0
10902;196055;106;76;37;2;35;.946;3578000;0
10902;-1;106;0;0;0;0;.00nan;0;0
10902;-1;105;0;0;0;0;.00nan;0;0
10903;192733;99;84;33;1;32;.970;3600000;0
10903;194531;99;0;0;0;0;.00nan;0;0
10903;196525;94;68;30;3;27;.900;3579000;0
10903;-1;94;0;0;0;0;.00nan;0;0
10904;195330;89;0;0;0;0;.00nan;0;0
10904;201792;89;51;36;5;31;.861;3589000;0
10904;196495;87;58;36;4;32;.889;3600000;0
10904;-1;87;0;0;0;0;.00nan;0;0
10905;194542;88;68;34;3;31;.912;3894000;0
10905;210480;88;0;0;0;0;.00nan;0;0
10905;201888;90;0;0;0;0;.00nan;0;0
10905;-1;90;55;30;4;26;.867;3899000;0
10906;209784;91;0;0;0;0;.00nan;0;0
10906;200572;95;56;26;3;23;.885;3600000;0
10906;196473;95;0;0;0;0;.00nan;0;0
10906;-1;91;45;29;5;24;.828;3538000;0
10907;192739;92;0;0;0;0;.00nan;0;0
10907;200065;93;68;36;3;33;.917;3554000;0
10907;196532;92;73;33;2;31;.939;3600000;0
10907;197675;93;0;0;0;0;.00nan;0;0
10908;194632;102;93;23;1;22;.957;3600000;0
10908;200549;102;0;0;0;0;.00nan;0;0
10908;194899;101;66;61;6;55;.902;3600000;0
10908;201739;101;0;0;0;0;.00nan;0;0
10909;197940;100;32;25;5;20;.800;3543000;0
10909;205318;97;53;28;4;24;.857;3600000;0
10909;205824;97;0;0;0;0;.00nan;0;0
10909;212368;100;0;0;0;0;.00nan;0;0
10910;194531;99;46;35;5;30;.857;3528000;0
10910;-1;98;51;24;3;21;.875;3600000;0
10910;-1;99;0;0;0;0;.00nan;0;0
10910;-1;98;0;0;0;0;.00nan;0;0
10911;192718;103;69;42;4;38;.905;3900000;0
10911;205112;105;0;0;0;0;.00nan;0;0
10911;210428;103;0;0;0;0;.00nan;0;0
10911;-1;105;49;22;4;18;.818;3895000;0
10912;209796;107;47;14;2;12;.857;3542000;0
10912;210603;104;80;33;1;32;.970;3600000;0
10912;-1;107;0;0;0;0;.00nan;0;0
10912;208300;104;0;0;0;0;.00nan;0;0
10913;205112;105;73;38;2;36;.947;3900000;0
10913;-1;98;0;0;0;0;.00nan;0;0
10913;-1;105;0;0;0;0;.00nan;0;0
10913;-1;98;70;23;2;21;.913;3900000;0
10914;209796;107;0;0;0;0;.00nan;0;0
10914;196525;94;61;39;5;34;.872;3566000;0
10914;-1;107;55;24;3;21;.875;3600000;0
10914;-1;94;0;0;0;0;.00nan;0;0
10915;197940;100;0;0;0;0;.00nan;0;0
10915;212343;96;84;34;2;32;.941;3600000;0
10915;212368;100;50;19;3;16;.842;3576000;0
10915;-1;96;0;0;0;0;.00nan;0;0
10916;194542;88;55;31;5;26;.839;3600000;0
10916;210480;88;0;0;0;0;.00nan;0;0
10916;196495;87;22;8;4;4;.500;859000;0
10916;-1;87;75;16;0;16;1.000;2741000;0
10917;205799;86;39;31;5;26;.839;3600000;0
10917;195330;89;0;0;0;0;.00nan;0;0
10917;201792;89;74;22;1;21;.955;3600000;0
10917;201876;86;0;0;0;0;.00nan;0;0
10918;209784;91;53;20;3;17;.850;3819000;0
10918;200065;93;88;40;2;38;.950;3819000;0
10918;-1;91;0;0;0;0;.00nan;0;0
10918;197675;93;0;0;0;0;.00nan;0;0
10919;192739;92;90;40;2;38;.950;3600000;0
10919;200572;95;51;22;3;19;.864;3548000;0
10919;196473;95;0;0;0;0;.00nan;0;0
10919;196532;92;0;0;0;0;.00nan;0;0
10920;194531;99;80;42;4;38;.905;3675000;0
10920;205318;97;56;25;3;22;.880;3675000;0
10920;205824;97;0;0;0;0;.00nan;0;0
10920;-1;99;0;0;0;0;.00nan;0;0
10921;194632;102;79;31;2;29;.935;3600000;0
10921;200549;102;0;0;0;0;.00nan;0;0
10921;194899;101;68;38;4;34;.895;3600000;0
10921;201739;101;0;0;0;0;.00nan;0;0
10922;205799;86;0;0;0;0;.00nan;0;0
10922;201876;86;45;29;5;24;.828;3600000;0
10922;201888;90;68;31;3;28;.903;3600000;0
10922;-1;90;0;0;0;0;.00nan;0;0
10923;195330;89;82;29;2;27;.931;3600000;0
10923;201792;89;0;0;0;0;.00nan;0;0
10923;196495;87;72;38;3;35;.921;3565000;0
10923;-1;87;0;0;0;0;.00nan;0;0
10924;200065;93;46;54;9;45;.833;3600000;0
10924;200572;95;0;0;0;0;.00nan;0;0
10924;196473;95;63;21;2;19;.905;3600000;0
10924;197675;93;0;0;0;0;.00nan;0;0
10925;197940;100;41;38;6;32;.842;3162000;0
10925;194632;102;0;0;0;0;.00nan;0;0
10925;200549;102;100;25;0;25;1.000;3600000;0
10925;212368;100;58;7;0;7;1.000;438000;0
10926;192739;92;0;0;0;0;.00nan;0;0
10926;209784;91;0;0;0;0;.00nan;0;0
10926;196532;92;63;20;2;18;.900;3600000;0
10926;-1;91;83;45;4;41;.911;3585000;0
10927;196055;106;68;26;2;24;.923;3600000;0
10927;196525;94;44;39;6;33;.846;3600000;0
10927;-1;106;0;0;0;0;.00nan;0;0
10927;-1;94;0;0;0;0;.00nan;0;0
10928;192718;103;20;28;6;22;.786;2962000;0
10928;210428;103;45;4;1;3;.750;638000;0
10928;210603;104;92;20;0;20;1.000;3600000;0
10928;208300;104;0;0;0;0;.00nan;0;0
10929;205318;97;0;0;0;0;.00nan;0;0
10929;205824;97;59;24;3;21;.875;3900000;0
10929;-1;98;83;46;3;43;.935;3900000;0
10929;-1;98;0;0;0;0;.00nan;0;0
10930;194899;101;62;20;1;19;.950;2543000;0
10930;201739;101;19;8;4;4;.500;1057000;0
10930;212343;96;0;0;0;0;.00nan;0;0
10930;-1;96;99;37;2;35;.946;3600000;0
10931;205112;105;0;0;0;0;.00nan;0;0
10931;196525;94;38;37;6;31;.838;3243000;0
10931;-1;105;81;24;1;23;.958;3600000;0
10931;-1;94;49;2;0;2;1.000;357000;0
10932;209796;107;64;25;2;23;.920;3729000;0
10932;194531;99;90;40;3;37;.925;3729000;0
10932;-1;99;0;0;0;0;.00nan;0;0
10932;-1;107;0;0;0;0;.00nan;0;0
10933;192718;103;0;0;0;0;.00nan;0;0
10933;210428;103;61;43;5;38;.884;3900000;0
10933;210603;104;39;33;5;28;.848;3900000;0
10933;208300;104;0;0;0;0;.00nan;0;0
10934;205799;86;87;49;3;46;.939;3546000;0
10934;195330;89;0;0;0;0;.00nan;0;0
10934;201792;89;72;27;2;25;.926;3600000;0
10934;201876;86;0;0;0;0;.00nan;0;0
10935;194542;88;59;24;3;21;.875;3514000;0
10935;210480;88;0;0;0;0;.00nan;0;0
10935;196495;87;100;41;1;40;.976;3600000;0
10935;-1;87;0;0;0;0;.00nan;0;0
10936;212343;96;95;37;2;35;.946;3600000;0
10936;-1;98;36;27;5;22;.815;3600000;0
10936;-1;98;0;0;0;0;.00nan;0;0
10936;-1;96;0;0;0;0;.00nan;0;0
10937;205318;97;0;0;0;0;.00nan;0;0
10937;205824;97;71;25;2;23;.920;3600000;0
10937;196055;106;0;0;0;0;.00nan;0;0
10937;-1;106;66;33;4;29;.879;3558000;0
10938;192739;92;0;0;0;0;.00nan;0;0
10938;200065;93;71;32;3;29;.906;3625000;0
10938;196532;92;55;25;4;21;.840;3625000;0
10938;197675;93;0;0;0;0;.00nan;0;0
10939;209784;91;39;33;6;27;.818;3678000;0
10939;200572;95;27;14;4;10;.714;1145000;0
10939;196473;95;61;16;1;15;.938;2533000;0
10939;-1;91;0;0;0;0;.00nan;0;0
10940;197940;100;93;29;1;28;.966;3600000;0
10940;205112;105;0;0;0;0;.00nan;0;0
10940;212368;100;0;0;0;0;.00nan;0;0
10940;-1;105;91;35;3;32;.914;3574000;0
10941;194632;102;0;0;0;0;.00nan;0;0
10941;205318;97;33;36;7;29;.806;3600000;0
10941;200549;102;65;18;1;17;.944;3600000;0
10941;205824;97;0;0;0;0;.00nan;0;0
10942;194531;99;38;38;7;31;.816;3547000;0
10942;212343;96;0;0;0;0;.00nan;0;0
10942;-1;99;0;0;0;0;.00nan;0;0
10942;-1;96;57;39;5;34;.872;3600000;0
10943;205799;86;53;33;4;29;.879;3600000;0
10943;201876;86;0;0;0;0;.00nan;0;0
10943;201888;90;0;0;0;0;.00nan;0;0
10943;-1;90;84;29;1;28;.966;3600000;0
10944;194542;88;71;37;3;34;.919;3600000;0
10944;210480;88;0;0;0;0;.00nan;0;0
10944;195330;89;0;0;0;0;.00nan;0;0
10944;201792;89;45;27;4;23;.852;3541000;0
10945;192718;103;0;0;0;0;.00nan;0;0
10945;210428;103;71;44;4;40;.909;3600000;0
10945;200572;95;81;16;0;16;1.000;3600000;0
10945;196473;95;0;0;0;0;.00nan;0;0
10946;209784;91;0;0;0;0;.00nan;0;0
10946;210603;104;89;42;2;40;.952;3600000;0
10946;-1;91;75;24;1;23;.958;3600000;0
10946;208300;104;0;0;0;0;.00nan;0;0
10947;192739;92;51;2;0;2;1.000;422000;0
10947;200065;93;0;0;0;0;.00nan;0;0
10947;196532;92;27;26;6;20;.769;3125000;0
10947;197675;93;67;36;4;32;.889;3600000;0
10948;194632;102;79;45;4;41;.911;3546000;0
10948;200549;102;0;0;0;0;.00nan;0;0
10948;212343;96;77;31;2;29;.935;3600000;0
10948;-1;96;0;0;0;0;.00nan;0;0
10949;209796;107;66;26;2;24;.923;3561000;0
10949;196055;106;99;29;0;29;1.000;3600000;0
10949;-1;106;0;0;0;0;.00nan;0;0
10949;-1;107;0;0;0;0;.00nan;0;0
10950;205318;97;0;0;0;0;.00nan;0;0
10950;194899;101;62;42;5;37;.881;3541000;0
10950;205824;97;67;29;3;26;.897;3600000;0
10950;201739;101;0;0;0;0;.00nan;0;0
10951;197940;100;44;18;3;15;.833;3558000;0
10951;212368;100;0;0;0;0;.00nan;0;0
10951;196525;94;93;34;1;33;.971;3600000;0
10951;-1;94;0;0;0;0;.00nan;0;0
10952;194531;99;92;40;2;38;.950;3600000;0
10952;196495;87;0;0;0;0;.00nan;0;0
10952;-1;99;0;0;0;0;.00nan;0;0
10952;-1;87;48;19;3;16;.842;3557000;0
10953;194542;88;0;0;0;0;.00nan;0;0
10953;210480;88;50;27;4;23;.852;3566000;0
10953;201888;90;63;31;3;28;.903;3600000;0
10953;-1;90;0;0;0;0;.00nan;0;0
10954;195330;89;79;24;1;23;.958;3600000;0
10954;201792;89;0;0;0;0;.00nan;0;0
10954;-1;98;92;41;3;38;.927;3541000;0
10954;-1;98;0;0;0;0;.00nan;0;0
10955;200572;95;0;0;0;0;.00nan;0;0
10955;205799;86;62;35;4;31;.886;3571000;0
10955;201876;86;0;0;0;0;.00nan;0;0
10955;196473;95;54;25;3;22;.880;3600000;0
10956;192739;92;49;21;3;18;.857;3600000;0
10956;210603;104;0;0;0;0;.00nan;0;0
10956;196532;92;0;0;0;0;.00nan;0;0
10956;208300;104;81;57;5;52;.912;3600000;0
10957;197940;100;0;0;0;0;.00nan;0;0
10957;209796;107;0;0;0;0;.00nan;0;0
10957;212368;100;82;26;1;25;.962;3600000;0
10957;-1;107;58;31;4;27;.871;3600000;0
10958;205112;105;0;0;0;0;.00nan;0;0
10958;194899;101;0;0;0;0;.00nan;0;0
10958;201739;101;72;36;3;33;.917;3600000;0
10958;-1;105;48;25;4;21;.840;3600000;0
10959;196055;106;53;34;5;29;.853;3600000;0
10959;196525;94;86;27;1;26;.963;3600000;0
10959;-1;106;0;0;0;0;.00nan;0;0
10959;-1;94;0;0;0;0;.00nan;0;0
10960;205318;97;0;0;0;0;.00nan;0;0
10960;205824;97;41;23;4;19;.826;3600000;0
10960;212343;96;0;0;0;0;.00nan;0;0
10960;-1;96;69;35;3;32;.914;3600000;0
10961;192718;103;0;0;0;0;.00nan;0;0
10961;192739;92;0;0;0;0;.00nan;0;0
10961;210428;103;78;33;2;31;.939;3600000;0
10961;196532;92;52;18;3;15;.833;3583000;0
10962;197940;100;37;36;7;29;.806;3600000;0
10962;196055;106;0;0;0;0;.00nan;0;0
10962;212368;100;0;0;0;0;.00nan;0;0
10962;-1;106;72;23;1;22;.957;3600000;0
10963;196495;87;35;21;4;17;.810;2242000;0
10963;-1;98;84;37;3;34;.919;3600000;0
10963;-1;98;0;0;0;0;.00nan;0;0
10963;-1;87;46;9;2;7;.778;1358000;0
10964;194531;99;72;40;3;37;.925;3567000;0
10964;201888;90;0;0;0;0;.00nan;0;0
10964;-1;99;0;0;0;0;.00nan;0;0
10964;-1;90;76;22;1;21;.955;3600000;0
10965;192718;103;0;0;0;0;.00nan;0;0
10965;209784;91;0;0;0;0;.00nan;0;0
10965;210428;103;87;39;3;36;.923;3558000;0
10965;-1;91;86;33;1;32;.970;3600000;0
10966;200572;95;69;26;2;24;.923;3600000;0
10966;210603;104;63;38;5;33;.868;3600000;0
10966;196473;95;0;0;0;0;.00nan;0;0
10966;208300;104;0;0;0;0;.00nan;0;0
10967;205799;86;20;33;7;26;.788;2331000;0
10967;201876;86;45;4;1;3;.750;1269000;0
10967;-1;98;63;33;3;30;.909;3600000;0
10967;-1;98;0;0;0;0;.00nan;0;0
10968;194531;99;0;0;0;0;.00nan;0;0
10968;194542;88;59;31;4;27;.871;3600000;0
10968;210480;88;0;0;0;0;.00nan;0;0
10968;-1;99;39;39;7;32;.821;3600000;0
10969;192718;103;52;32;5;27;.844;3600000;0
10969;200065;93;52;20;3;17;.850;3600000;0
10969;210428;103;0;0;0;0;.00nan;0;0
10969;197675;93;0;0;0;0;.00nan;0;0
10970;194899;101;0;0;0;0;.00nan;0;0
10970;201739;101;90;28;0;28;1.000;3900000;0
10970;196525;94;100;36;0;36;1.000;3900000;0
10970;-1;94;0;0;0;0;.00nan;0;0
10971;205318;97;62;36;4;32;.889;3600000;0
10971;210603;104;0;0;0;0;.00nan;0;0
10971;205824;97;0;0;0;0;.00nan;0;0
10971;208300;104;100;23;0;23;1.000;3600000;0
10972;192718;103;0;0;0;0;.00nan;0;0
10972;210428;103;79;29;1;28;.966;3600000;0
10972;212343;96;56;42;5;37;.881;3600000;0
10972;-1;96;0;0;0;0;.00nan;0;0
10973;200572;95;0;0;0;0;.00nan;0;0
10973;195346;95;47;33;5;28;.848;3600000;0
10973;196495;87;58;32;4;28;.875;3600000;0
10973;-1;87;0;0;0;0;.00nan;0;0
10974;201888;90;0;0;0;0;.00nan;0;0
10974;-1;98;82;41;4;37;.902;3582000;0
10974;-1;90;62;27;3;24;.889;3600000;0
10974;-1;98;0;0;0;0;.00nan;0;0
10975;192733;99;43;4;1;3;.750;1030000;0
10975;194531;99;33;34;6;28;.824;2570000;0
10975;195330;89;0;0;0;0;.00nan;0;0
10975;201792;89;63;13;1;12;.923;3600000;0
10976;192739;92;63;30;3;27;.900;3900000;0
10976;209784;91;0;0;0;0;.00nan;0;0
10976;196532;92;0;0;0;0;.00nan;0;0
10976;-1;91;70;36;3;33;.917;3900000;0
10977;200065;93;62;24;2;22;.917;3600000;0
10977;210603;104;0;0;0;0;.00nan;0;0
10977;197675;93;0;0;0;0;.00nan;0;0
10977;208300;104;87;35;3;32;.914;3574000;0
10978;194632;102;0;0;0;0;.00nan;0;0
10978;200549;102;57;28;4;24;.857;3600000;0
10978;196055;106;17;30;8;22;.733;3600000;0
10978;-1;106;0;0;0;0;.00nan;0;0
10979;197940;100;95;21;0;21;1.000;3600000;0
10979;194899;101;75;47;4;43;.915;3600000;0
10979;201739;101;0;0;0;0;.00nan;0;0
10979;212368;100;0;0;0;0;.00nan;0;0
10980;209796;107;40;28;6;22;.786;3642000;0
10980;196525;94;61;39;5;34;.872;3642000;0
10980;-1;94;0;0;0;0;.00nan;0;0
10980;-1;107;0;0;0;0;.00nan;0;0
10981;192733;99;65;29;3;26;.897;3666000;0
10981;194502;86;0;0;0;0;.00nan;0;0
10981;194531;99;0;0;0;0;.00nan;0;0
10981;201876;86;56;24;4;20;.833;3666000;0
10982;195330;89;67;31;3;28;.903;3600000;0
10982;201792;89;0;0;0;0;.00nan;0;0
10982;201888;90;64;41;4;37;.902;3600000;0
10982;-1;90;0;0;0;0;.00nan;0;0
10983;194542;88;76;22;1;21;.955;3600000;0
10983;210480;88;0;0;0;0;.00nan;0;0
10983;-1;98;53;3;0;3;1.000;382000;0
10983;-1;98;23;35;7;28;.800;3218000;0
10984;192739;92;0;0;0;0;.00nan;0;0
10984;209784;91;69;40;4;36;.900;3536000;0
10984;196532;92;76;29;2;27;.931;3600000;0
10984;-1;91;0;0;0;0;.00nan;0;0
10985;209796;107;0;0;0;0;.00nan;0;0
10985;196525;94;0;0;0;0;.00nan;0;0
10985;-1;94;94;48;3;45;.938;3554000;0
10985;-1;107;91;39;2;37;.949;3600000;0
10986;197940;100;70;20;1;19;.950;3600000;0
10986;194899;101;14;23;7;16;.696;2220000;0
10986;201739;101;41;18;3;15;.833;1380000;0
10986;212368;100;0;0;0;0;.00nan;0;0
10987;200065;93;0;0;0;0;.00nan;0;0
10987;205318;97;0;0;0;0;.00nan;0;0
10987;205824;97;90;37;3;34;.919;3900000;0
10987;197675;93;73;32;3;29;.906;3900000;0
10988;194632;102;64;22;2;20;.909;3600000;0
10988;200549;102;0;0;0;0;.00nan;0;0
10988;196055;106;0;0;0;0;.00nan;0;0
10988;-1;106;63;34;4;30;.882;3565000;0
10989;201888;90;0;0;0;0;.00nan;0;0
10989;196495;87;61;31;4;27;.871;3600000;0
10989;-1;90;41;38;6;32;.842;3597000;0
10989;-1;87;0;0;0;0;.00nan;0;0
10990;210603;104;70;27;2;25;.926;3600000;0
10990;212343;96;77;34;3;31;.912;3557000;0
10990;-1;96;0;0;0;0;.00nan;0;0
10990;208300;104;0;0;0;0;.00nan;0;0
10991;194542;88;0;0;0;0;.00nan;0;0
10991;210480;88;47;27;4;23;.852;3548000;0
10991;195330;89;0;0;0;0;.00nan;0;0
10991;201792;89;83;37;3;34;.919;3600000;0
10992;192718;103;82;38;2;36;.947;3131000;0
10992;210428;103;24;5;3;2;.400;469000;0
10992;205318;97;69;27;2;25;.926;3600000;0
10992;205824;97;0;0;0;0;.00nan;0;0
10993;205112;105;82;50;3;47;.940;3900000;0
10993;196055;106;60;26;3;23;.885;3900000;0
10993;-1;106;0;0;0;0;.00nan;0;0
10993;-1;105;0;0;0;0;.00nan;0;0
10994;209796;107;0;0;0;0;.00nan;0;0
10994;194632;102;62;35;4;31;.886;3900000;0
10994;200549;102;0;0;0;0;.00nan;0;0
10994;-1;107;61;43;4;39;.907;3900000;0
10995;192739;92;100;32;1;31;.969;3600000;0
10995;200572;95;0;0;0;0;.00nan;0;0
10995;195346;95;21;30;6;24;.800;3600000;0
10995;196532;92;0;0;0;0;.00nan;0;0
10996;205112;105;0;0;0;0;.00nan;0;0
10996;194632;102;0;0;0;0;.00nan;0;0
10996;200549;102;100;27;0;27;1.000;3600000;0
10996;-1;105;32;26;5;21;.808;3600000;0
10997;209784;91;72;46;4;42;.913;3571000;0
10997;194502;86;79;32;2;30;.938;3600000;0
10997;201876;86;0;0;0;0;.00nan;0;0
10997;-1;91;0;0;0;0;.00nan;0;0
10998;200065;93;71;45;4;41;.911;3577000;0
10998;194542;88;73;31;3;28;.903;3600000;0
10998;210480;88;0;0;0;0;.00nan;0;0
10998;197675;93;0;0;0;0;.00nan;0;0
10999;209796;107;47;13;2;11;.846;1263000;0
10999;194899;101;0;0;0;0;.00nan;0;0
10999;201739;101;57;26;3;23;.885;3600000;0
10999;-1;107;8;16;6;10;.625;2337000;0
11000;209784;91;0;0;0;0;.00nan;0;0
11000;195330;89;0;0;0;0;.00nan;0;0
11000;201792;89;73;40;4;36;.900;3559000;0
11000;-1;91;71;29;2;27;.931;3600000;0
11001;194502;86;56;50;6;44;.880;3600000;0
11001;200572;95;0;0;0;0;.00nan;0;0
11001;195346;95;47;12;2;10;.833;3600000;0
11001;201876;86;0;0;0;0;.00nan;0;0
11002;194542;88;67;21;1;20;.952;3900000;0
11002;210480;88;0;0;0;0;.00nan;0;0
11002;212343;96;0;0;0;0;.00nan;0;0
11002;-1;96;77;28;1;27;.964;3900000;0
11003;192739;92;49;22;3;19;.864;3600000;0
11003;200065;93;63;37;4;33;.892;3549000;0
11003;196532;92;0;0;0;0;.00nan;0;0
11003;197675;93;0;0;0;0;.00nan;0;0
11004;197940;100;72;29;2;27;.931;3900000;0
11004;209796;107;100;51;2;49;.961;3886000;0
11004;212368;100;0;0;0;0;.00nan;0;0
11004;-1;107;0;0;0;0;.00nan;0;0
11005;205318;97;79;26;1;25;.962;3600000;0
11005;205824;97;0;0;0;0;.00nan;0;0
11005;201888;90;0;0;0;0;.00nan;0;0
11005;-1;90;97;48;2;46;.958;3549000;0
11006;192733;99;91;35;1;34;.971;3600000;0
11006;194531;99;0;0;0;0;.00nan;0;0
11006;194899;101;96;41;2;39;.951;3588000;0
11006;201739;101;0;0;0;0;.00nan;0;0
11007;192718;103;0;0;0;0;.00nan;0;0
11007;210428;103;60;30;3;27;.900;3600000;0
11007;196055;106;44;25;5;20;.800;2057000;0
11007;-1;106;28;16;4;12;.750;1543000;0
11008;210603;104;87;32;2;30;.938;3600000;0
11008;196525;94;58;29;3;26;.897;3600000;0
11008;-1;94;0;0;0;0;.00nan;0;0
11008;208300;104;0;0;0;0;.00nan;0;0
11009;194632;102;0;0;0;0;.00nan;0;0
11009;200549;102;73;27;1;26;.963;3600000;0
11009;-1;98;86;32;2;30;.938;3600000;0
11009;-1;98;0;0;0;0;.00nan;0;0
11010;209784;91;31;13;4;9;.692;1187000;0
11010;196495;87;69;24;2;22;.917;3600000;0
11010;-1;91;54;37;4;33;.892;2413000;0
11010;-1;87;0;0;0;0;.00nan;0;0
11011;194502;86;0;0;0;0;.00nan;0;0
11011;200572;95;37;10;2;8;.800;1341000;0
11011;195346;95;31;16;4;12;.750;2259000;0
11011;201876;86;84;29;1;28;.966;3600000;0
11012;192739;92;0;0;0;0;.00nan;0;0
11012;195330;89;31;31;6;25;.806;2305000;0
11012;201792;89;69;14;0;14;1.000;1295000;0
11012;196532;92;54;27;3;24;.889;3600000;0
11013;197940;100;0;0;0;0;.00nan;0;0
11013;209796;107;0;0;0;0;.00nan;0;0
11013;212368;100;42;19;4;15;.789;3600000;0
11013;-1;107;44;31;5;26;.839;3600000;0
11014;200065;93;0;0;0;0;.00nan;0;0
11014;201888;90;70;28;2;26;.929;3600000;0
11014;-1;90;0;0;0;0;.00nan;0;0
11014;197675;93;36;21;4;17;.810;3515000;0
11015;192718;103;42;34;5;29;.853;3600000;0
11015;205112;105;0;0;0;0;.00nan;0;0
11015;210428;103;0;0;0;0;.00nan;0;0
11015;-1;105;93;40;2;38;.950;3600000;0
11016;210603;104;0;0;0;0;.00nan;0;0
11016;196525;94;0;0;0;0;.00nan;0;0
11016;-1;94;76;31;2;29;.935;3600000;0
11016;208300;104;57;28;3;25;.893;3542000;0
11017;192733;99;0;0;0;0;.00nan;0;0
11017;194531;99;65;42;5;37;.881;3600000;0
11017;194899;101;0;0;0;0;.00nan;0;0
11017;201739;101;42;37;6;31;.838;3599000;0
11018;192739;92;82;33;2;31;.939;3900000;0
11018;196495;87;0;0;0;0;.00nan;0;0
11018;196532;92;0;0;0;0;.00nan;0;0
11018;-1;87;100;40;2;38;.950;3900000;0
11019;212343;96;36;30;5;25;.833;3595000;0
11019;201888;90;0;0;0;0;.00nan;0;0
11019;-1;90;66;28;3;25;.893;3600000;0
11019;-1;96;0;0;0;0;.00nan;0;0
11020;194542;88;61;31;5;26;.839;3600000;0
11020;205318;97;0;0;0;0;.00nan;0;0
11020;210480;88;0;0;0;0;.00nan;0;0
11020;205824;97;65;23;2;21;.913;3600000;0
11021;194632;102;57;38;5;33;.868;3600000;0
11021;200549;102;0;0;0;0;.00nan;0;0
11021;-1;98;90;36;2;34;.944;3600000;0
11021;-1;98;0;0;0;0;.00nan;0;0
11022;210603;104;47;19;3;16;.842;3600000;0
11022;196055;106;55;35;5;30;.857;3561000;0
11022;-1;106;0;0;0;0;.00nan;0;0
11022;208300;104;0;0;0;0;.00nan;0;0
11023;205112;105;0;0;0;0;.00nan;0;0
11023;196525;94;73;44;4;40;.909;3600000;0
11023;-1;94;0;0;0;0;.00nan;0;0
11023;-1;105;33;24;5;19;.792;3600000;0
11024;205112;105;91;39;2;37;.949;3600000;0
11024;210603;104;39;1;1;0;.000;416000;0
11024;-1;105;0;0;0;0;.00nan;0;0
11024;208300;104;21;21;6;15;.714;3184000;0
11025;194899;101;83;42;3;39;.929;3600000;0
11025;196055;106;82;25;1;24;.960;3600000;0
11025;201739;101;0;0;0;0;.00nan;0;0
11025;-1;106;0;0;0;0;.00nan;0;0
11026;192739;92;75;31;2;29;.935;3900000;0
11026;194502;86;100;48;2;46;.958;3900000;0
11026;201876;86;0;0;0;0;.00nan;0;0
11026;196532;92;0;0;0;0;.00nan;0;0
11027;194542;88;86;37;2;35;.946;3600000;0
11027;210480;88;0;0;0;0;.00nan;0;0
11027;201888;90;0;0;0;0;.00nan;0;0
11027;-1;90;56;29;4;25;.862;3568000;0
11028;212343;96;66;40;4;36;.900;3600000;0
11028;196495;87;98;27;0;27;1.000;3600000;0
11028;-1;87;0;0;0;0;.00nan;0;0
11028;-1;96;0;0;0;0;.00nan;0;0
11029;209784;91;0;0;0;0;.00nan;0;0
11029;195330;89;0;0;0;0;.00nan;0;0
11029;201792;89;64;37;4;33;.892;3551000;0
11029;-1;91;69;29;3;26;.897;3600000;0
11030;200065;93;75;26;1;25;.962;3600000;0
11030;205318;97;73;44;4;40;.909;3600000;0
11030;205824;97;0;0;0;0;.00nan;0;0
11030;197675;93;0;0;0;0;.00nan;0;0
11031;205112;105;63;25;2;23;.920;3600000;0
11031;196525;94;22;32;8;24;.750;3211000;0
11031;-1;94;51;2;0;2;1.000;389000;0
11031;-1;105;0;0;0;0;.00nan;0;0
11032;192733;99;0;0;0;0;.00nan;0;0
11032;194531;99;68;37;5;32;.865;3600000;0
11032;-1;98;66;20;1;19;.950;3600000;0
11032;-1;98;0;0;0;0;.00nan;0;0
11033;194632;102;0;0;0;0;.00nan;0;0
11033;200549;102;73;30;2;28;.933;3900000;0
11033;194899;101;0;0;0;0;.00nan;0;0
11033;201739;101;80;35;2;33;.943;3900000;0
11034;197940;100;71;43;4;39;.907;3900000;0
11034;192718;103;0;0;0;0;.00nan;0;0
11034;210428;103;53;31;4;27;.871;3900000;0
11034;212368;100;0;0;0;0;.00nan;0;0
11035;209796;107;63;38;4;34;.895;3600000;0
11035;210603;104;27;31;6;25;.806;3524000;0
11035;-1;107;0;0;0;0;.00nan;0;0
11035;208300;104;0;0;0;0;.00nan;0;0
11036;194542;88;0;0;0;0;.00nan;0;0
11036;210480;88;67;17;1;16;.941;3600000;0
11036;201888;90;57;33;4;29;.879;3600000;0
11036;-1;90;0;0;0;0;.00nan;0;0
11037;194632;102;51;15;2;13;.867;3558000;0
11037;200549;102;0;0;0;0;.00nan;0;0
11037;194899;101;100;48;1;47;.979;3600000;0
11037;201739;101;0;0;0;0;.00nan;0;0
11038;192739;92;0;0;0;0;.00nan;0;0
11038;194502;86;74;29;2;27;.931;3600000;0
11038;201876;86;0;0;0;0;.00nan;0;0
11038;196532;92;57;26;3;23;.885;3600000;0
11039;200065;93;0;0;0;0;.00nan;0;0
11039;196495;87;67;26;3;23;.885;3900000;0
11039;-1;87;0;0;0;0;.00nan;0;0
11039;197675;93;60;36;3;33;.917;3900000;0
11040;196055;106;0;0;0;0;.00nan;0;0
11040;196525;94;0;0;0;0;.00nan;0;0
11040;-1;94;82;32;2;30;.938;3600000;0
11040;-1;106;33;27;5;22;.815;3600000;0
11041;192718;103;53;28;3;25;.893;3900000;0
11041;209796;107;0;0;0;0;.00nan;0;0
11041;210428;103;0;0;0;0;.00nan;0;0
11041;-1;107;71;38;3;35;.921;3900000;0
11042;197940;100;57;4;0;4;1.000;1102000;0
11042;210603;104;0;0;0;0;.00nan;0;0
11042;212368;100;35;30;6;24;.800;2798000;0
11042;208300;104;45;39;6;33;.846;3900000;0
11043;192733;99;66;35;3;32;.914;3600000;0
11043;194531;99;0;0;0;0;.00nan;0;0
11043;-1;98;0;0;0;0;.00nan;0;0
11043;-1;98;82;28;2;26;.929;3600000;0
11044;195330;89;0;0;0;0;.00nan;0;0
11044;201792;89;97;44;3;41;.932;3600000;0
11044;212343;96;0;0;0;0;.00nan;0;0
11044;-1;96;33;19;4;15;.789;3551000;0
11045;194542;88;78;48;5;43;.896;3600000;0
11045;210480;88;0;0;0;0;.00nan;0;0
11045;200572;95;73;25;1;24;.960;3600000;0
11045;195346;95;0;0;0;0;.00nan;0;0
11046;205318;97;81;26;2;24;.923;3600000;0
11046;205824;97;0;0;0;0;.00nan;0;0
11046;196495;87;0;0;0;0;.00nan;0;0
11046;-1;87;52;26;4;22;.846;3588000;0
11047;192733;99;0;0;0;0;.00nan;0;0
11047;194531;99;93;45;2;43;.956;3565000;0
11047;-1;98;76;22;1;21;.955;3600000;0
11047;-1;98;0;0;0;0;.00nan;0;0
11048;197940;100;61;35;4;31;.886;3528000;0
11048;205112;105;0;0;0;0;.00nan;0;0
11048;212368;100;0;0;0;0;.00nan;0;0
11048;-1;105;71;23;2;21;.913;3600000;0
11049;209784;91;0;0;0;0;.00nan;0;0
11049;205318;97;0;0;0;0;.00nan;0;0
11049;205824;97;97;25;0;25;1.000;3600000;0
11049;-1;91;85;36;3;33;.917;3600000;0
11050;197940;100;53;35;5;30;.857;3578000;0
11050;212368;100;0;0;0;0;.00nan;0;0
11050;196525;94;55;28;4;24;.857;3600000;0
11050;-1;94;0;0;0;0;.00nan;0;0
11051;192718;103;0;0;0;0;.00nan;0;0
11051;210428;103;36;30;5;25;.833;3515000;0
11051;196055;106;64;29;3;26;.897;3600000;0
11051;-1;106;0;0;0;0;.00nan;0;0
11052;200065;93;62;32;4;28;.875;3874000;0
11052;201888;90;0;0;0;0;.00nan;0;0
11052;-1;90;75;32;3;29;.906;3874000;0
11052;197675;93;0;0;0;0;.00nan;0;0
11053;194542;88;50;27;4;23;.852;3538000;0
11053;210480;88;0;0;0;0;.00nan;0;0
11053;195330;89;0;0;0;0;.00nan;0;0
11053;201792;89;87;33;2;31;.939;3600000;0
11054;209784;91;22;10;4;6;.600;831000;0
11054;200572;95;45;23;4;19;.826;3600000;0
11054;195346;95;0;0;0;0;.00nan;0;0
11054;-1;91;79;26;1;25;.962;2756000;0
11055;210603;104;57;27;3;24;.889;3600000;0
11055;196055;106;55;19;2;17;.895;1029000;0
11055;-1;106;32;30;6;24;.800;2571000;0
11055;208300;104;0;0;0;0;.00nan;0;0
11056;209796;107;49;25;3;22;.880;3600000;0
11056;194899;101;38;34;6;28;.824;2202000;0
11056;201739;101;34;16;4;12;.750;1398000;0
11056;-1;107;0;0;0;0;.00nan;0;0
11057;200065;93;23;22;6;16;.727;3046000;0
11057;196495;87;86;27;2;25;.926;3600000;0
11057;-1;87;0;0;0;0;.00nan;0;0
11057;197675;93;55;4;0;4;1.000;554000;0
11058;194502;86;80;39;3;36;.923;3551000;0
11058;201876;86;0;0;0;0;.00nan;0;0
11058;201888;90;0;0;0;0;.00nan;0;0
11058;-1;90;72;26;2;24;.923;3600000;0
11059;200572;95;0;0;0;0;.00nan;0;0
11059;195330;89;0;0;0;0;.00nan;0;0
11059;195346;95;65;16;1;15;.938;3600000;0
11059;201792;89;65;37;4;33;.892;3600000;0
11060;192739;92;55;22;3;19;.864;3600000;0
11060;194542;88;55;34;4;30;.882;3569000;0
11060;210480;88;0;0;0;0;.00nan;0;0
11060;196532;92;0;0;0;0;.00nan;0;0
11061;205318;97;0;0;0;0;.00nan;0;0
11061;205824;97;73;25;2;23;.920;3600000;0
11061;212343;96;41;37;6;31;.838;3600000;0
11061;-1;96;0;0;0;0;.00nan;0;0
11062;205112;105;0;0;0;0;.00nan;0;0
11062;194632;102;70;22;1;21;.955;3600000;0
11062;200549;102;0;0;0;0;.00nan;0;0
11062;-1;105;82;36;3;33;.917;3522000;0
11063;209796;107;0;0;0;0;.00nan;0;0
11063;194899;101;39;31;6;25;.806;3193000;0
11063;201739;101;48;8;1;7;.875;407000;0
11063;-1;107;57;26;3;23;.885;3600000;0
11064;197940;100;100;30;0;30;1.000;3600000;0
11064;192733;99;69;29;2;27;.931;3578000;0
11064;194531;99;0;0;0;0;.00nan;0;0
11064;212368;100;0;0;0;0;.00nan;0;0
11065;192718;103;0;0;0;0;.00nan;0;0
11065;210428;103;77;10;0;10;1.000;3600000;0
11065;196055;106;94;46;3;43;.935;3600000;0
11065;-1;106;0;0;0;0;.00nan;0;0
11066;196525;94;41;39;7;32;.821;3600000;0
11066;-1;98;72;31;2;29;.935;3600000;0
11066;-1;94;0;0;0;0;.00nan;0;0
11066;-1;98;0;0;0;0;.00nan;0;0
11067;209784;91;0;0;0;0;.00nan;0;0
11067;212343;96;0;0;0;0;.00nan;0;0
11067;-1;91;78;18;1;17;.944;3600000;0
11067;-1;96;66;35;4;31;.886;3600000;0
11068;200065;93;63;44;5;39;.886;3591000;0
11068;194502;86;0;0;0;0;.00nan;0;0
11068;201876;86;79;35;2;33;.943;3600000;0
11068;197675;93;0;0;0;0;.00nan;0;0
11069;192739;92;0;0;0;0;.00nan;0;0
11069;201888;90;45;40;6;34;.850;3600000;0
11069;196532;92;37;29;5;24;.828;3600000;0
11069;-1;90;0;0;0;0;.00nan;0;0
11070;200572;95;81;24;1;23;.958;3600000;0
11070;195346;95;0;0;0;0;.00nan;0;0
11070;196495;87;56;20;2;18;.900;2544000;0
11070;-1;87;21;16;5;11;.688;1056000;0
11071;209796;107;72;21;1;20;.952;3600000;0
11071;196525;94;0;0;0;0;.00nan;0;0
11071;-1;94;90;40;2;38;.950;3559000;0
11071;-1;107;0;0;0;0;.00nan;0;0
11072;192718;103;0;0;0;0;.00nan;0;0
11072;210428;103;77;48;6;42;.875;3600000;0
11072;210603;104;0;0;0;0;.00nan;0;0
11072;208300;104;84;40;2;38;.950;3600000;0
11073;192733;99;0;0;0;0;.00nan;0;0
11073;194531;99;81;38;3;35;.921;3600000;0
11073;196055;106;96;23;0;23;1.000;3600000;0
11073;-1;106;0;0;0;0;.00nan;0;0
11074;197940;100;72;35;3;32;.914;3600000;0
11074;194632;102;31;15;4;11;.733;3542000;0
11074;200549;102;0;0;0;0;.00nan;0;0
11074;212368;100;0;0;0;0;.00nan;0;0
11075;200065;93;57;27;3;24;.889;3600000;0
11075;195330;89;0;0;0;0;.00nan;0;0
11075;201792;89;62;34;4;30;.882;3549000;0
11075;197675;93;0;0;0;0;.00nan;0;0
11076;194542;88;65;45;4;41;.911;3746000;0
11076;210480;88;0;0;0;0;.00nan;0;0
11076;196495;87;73;44;5;39;.886;3745000;0
11076;-1;87;0;0;0;0;.00nan;0;0
11077;205318;97;0;0;0;0;.00nan;0;0
11077;205824;97;63;26;2;24;.923;3600000;0
11077;212343;96;55;37;5;32;.865;3600000;0
11077;-1;96;0;0;0;0;.00nan;0;0
11078;205112;105;55;35;4;31;.886;3600000;0
11078;196055;106;92;30;1;29;.967;3600000;0
11078;-1;106;0;0;0;0;.00nan;0;0
11078;-1;105;0;0;0;0;.00nan;0;0
11079;209796;107;0;0;0;0;.00nan;0;0
11079;210603;104;55;19;2;17;.895;3600000;0
11079;-1;107;76;41;4;37;.902;3583000;0
11079;208300;104;0;0;0;0;.00nan;0;0
11080;196525;94;96;58;1;57;.983;3900000;0
11080;-1;98;75;20;1;19;.950;3900000;0
11080;-1;94;0;0;0;0;.00nan;0;0
11080;-1;98;0;0;0;0;.00nan;0;0
11081;192718;103;61;22;2;20;.909;3600000;0
11081;210428;103;0;0;0;0;.00nan;0;0
11081;194899;101;32;12;3;9;.750;1666000;0
11081;201739;101;26;27;6;21;.778;1934000;0
11082;194502;86;57;31;4;27;.871;3600000;0
11082;205318;97;0;0;0;0;.00nan;0;0
11082;205824;97;34;29;6;23;.793;3562000;0
11082;201876;86;0;0;0;0;.00nan;0;0
11083;209784;91;0;0;0;0;.00nan;0;0
11083;194542;88;45;19;3;16;.842;3577000;0
11083;210480;88;0;0;0;0;.00nan;0;0
11083;-1;91;79;34;2;32;.941;3600000;0
11084;200065;93;95;45;3;42;.933;3900000;0
11084;200572;95;59;25;3;22;.880;3900000;0
11084;195346;95;0;0;0;0;.00nan;0;0
11084;197675;93;0;0;0;0;.00nan;0;0
11085;192739;92;95;34;1;33;.971;3600000;0
11085;195330;89;0;0;0;0;.00nan;0;0
11085;201792;89;49;33;5;28;.848;3600000;0
11085;196532;92;0;0;0;0;.00nan;0;0
11086;205318;97;99;43;1;42;.977;3600000;0
11086;205824;97;0;0;0;0;.00nan;0;0
11086;196495;87;0;0;0;0;.00nan;0;0
11086;-1;87;71;25;2;23;.920;3544000;0
11087;195330;89;53;24;3;21;.875;3600000;0
11087;201792;89;0;0;0;0;.00nan;0;0
11087;212343;96;0;0;0;0;.00nan;0;0
11087;-1;96;98;22;0;22;1.000;3600000;0
11088;205112;105;75;39;3;36;.923;3600000;0
11088;210603;104;16;19;5;14;.737;2205000;0
11088;-1;105;0;0;0;0;.00nan;0;0
11088;208300;104;41;18;3;15;.833;1395000;0
11089;194632;102;0;0;0;0;.00nan;0;0
11089;200549;102;79;27;1;26;.963;3600000;0
11089;196525;94;52;39;5;34;.872;3600000;0
11089;-1;94;0;0;0;0;.00nan;0;0
11090;209784;91;97;22;0;22;1.000;3600000;0
11090;201888;90;62;21;2;19;.905;3164000;0
11090;-1;91;0;0;0;0;.00nan;0;0
11090;-1;90;29;7;3;4;.571;436000;0
11091;194899;101;92;53;4;49;.925;3712000;0
11091;201739;101;0;0;0;0;.00nan;0;0
11091;-1;98;49;26;3;23;.885;3712000;0
11091;-1;98;0;0;0;0;.00nan;0;0
11092;209784;91;63;31;4;27;.871;3557000;0
11092;196495;87;60;26;3;23;.885;3600000;0
11092;-1;91;0;0;0;0;.00nan;0;0
11092;-1;87;0;0;0;0;.00nan;0;0
11093;194542;88;60;25;3;22;.880;3600000;0
11093;210480;88;0;0;0;0;.00nan;0;0
11093;201888;90;0;0;0;0;.00nan;0;0
11093;-1;90;58;37;5;32;.865;3546000;0
11094;205318;97;0;0;0;0;.00nan;0;0
11094;200572;95;77;23;1;22;.957;3600000;0
11094;205824;97;72;42;4;38;.905;3600000;0
11094;195346;95;0;0;0;0;.00nan;0;0
11095;192739;92;31;21;6;15;.714;3600000;0
11095;212343;96;0;0;0;0;.00nan;0;0
11095;196532;92;0;0;0;0;.00nan;0;0
11095;-1;96;90;42;2;40;.952;3600000;0
11096;200065;93;83;22;1;21;.955;3600000;0
11096;194502;86;42;28;5;23;.821;3600000;0
11096;201876;86;0;0;0;0;.00nan;0;0
11096;197675;93;0;0;0;0;.00nan;0;0
11097;194632;102;36;22;5;17;.773;3600000;0
11097;200549;102;0;0;0;0;.00nan;0;0
11097;194899;101;0;0;0;0;.00nan;0;0
11097;201739;101;48;46;7;39;.848;3600000;0
11098;197940;100;58;34;4;30;.882;3560000;0
11098;212368;100;0;0;0;0;.00nan;0;0
11098;-1;98;71;33;3;30;.909;3600000;0
11098;-1;98;0;0;0;0;.00nan;0;0
11099;205112;105;55;26;3;23;.885;3600000;0
11099;196055;106;55;35;5;30;.857;3600000;0
11099;-1;106;0;0;0;0;.00nan;0;0
11099;-1;105;0;0;0;0;.00nan;0;0
11100;192733;99;98;29;1;28;.966;3600000;0
11100;194531;99;0;0;0;0;.00nan;0;0
11100;196525;94;59;26;2;24;.923;3600000;0
11100;-1;94;0;0;0;0;.00nan;0;0
11101;192718;103;0;0;0;0;.00nan;0;0
11101;210428;103;64;26;2;24;.923;3900000;0
11101;210603;104;97;41;2;39;.951;3900000;0
11101;208300;104;0;0;0;0;.00nan;0;0
11102;194502;86;0;0;0;0;.00nan;0;0
11102;201876;86;65;24;2;22;.917;3600000;0
11102;212343;96;47;29;5;24;.828;3600000;0
11102;-1;96;0;0;0;0;.00nan;0;0
11103;201888;90;51;43;5;38;.884;3582000;0
11103;196495;87;0;0;0;0;.00nan;0;0
11103;-1;90;0;0;0;0;.00nan;0;0
11103;-1;87;64;30;4;26;.867;3600000;0
11104;205318;97;81;37;3;34;.919;3900000;0
11104;205824;97;0;0;0;0;.00nan;0;0
11104;195330;89;0;0;0;0;.00nan;0;0
11104;201792;89;46;18;3;15;.833;3900000;0
11105;194542;88;0;0;0;0;.00nan;0;0
11105;210480;88;77;46;5;41;.891;3549000;0
11105;200572;95;0;0;0;0;.00nan;0;0
11105;195346;95;40;16;3;13;.813;3600000;0
11106;192739;92;0;0;0;0;.00nan;0;0
11106;200065;93;73;42;4;38;.905;3514000;0
11106;196532;92;51;15;2;13;.867;3600000;0
11106;197675;93;0;0;0;0;.00nan;0;0
11107;209796;107;60;20;2;18;.900;3900000;0
11107;196525;94;0;0;0;0;.00nan;0;0
11107;-1;94;92;39;2;37;.949;3900000;0
11107;-1;107;0;0;0;0;.00nan;0;0
11108;197940;100;0;0;0;0;.00nan;0;0
11108;212368;100;100;36;1;35;.972;3600000;0
11108;-1;98;39;32;5;27;.844;3600000;0
11108;-1;98;0;0;0;0;.00nan;0;0
11109;192718;103;68;21;2;19;.905;3600000;0
11109;210428;103;0;0;0;0;.00nan;0;0
11109;196055;106;28;12;4;8;.667;967000;0
11109;-1;106;23;32;7;25;.781;2633000;0
11110;192733;99;0;0;0;0;.00nan;0;0
11110;194531;99;63;31;4;27;.871;3665000;0
11110;205112;105;0;0;0;0;.00nan;0;0
11110;-1;105;57;28;3;25;.893;3665000;0
11111;194632;102;0;0;0;0;.00nan;0;0
11111;200549;102;55;24;3;21;.875;3577000;0
11111;194899;101;94;42;2;40;.952;3600000;0
11111;201739;101;0;0;0;0;.00nan;0;0
11112;192739;92;40;21;4;17;.810;3555000;0
11112;195330;89;0;0;0;0;.00nan;0;0
11112;201792;89;88;49;3;46;.939;3600000;0
11112;196532;92;0;0;0;0;.00nan;0;0
11113;200065;93;0;0;0;0;.00nan;0;0
11113;212343;96;0;0;0;0;.00nan;0;0
11113;197675;93;83;31;1;30;.968;3600000;0
11113;-1;96;43;33;5;28;.848;3600000;0
11114;209796;107;0;0;0;0;.00nan;0;0
11114;196055;106;76;36;3;33;.917;3559000;0
11114;-1;106;0;0;0;0;.00nan;0;0
11114;-1;107;80;34;2;32;.941;3600000;0
11115;192718;103;72;25;2;23;.920;3600000;0
11115;210428;103;0;0;0;0;.00nan;0;0
11115;194899;101;0;0;0;0;.00nan;0;0
11115;201739;101;88;59;3;56;.949;3545000;0
11116;210603;104;75;31;2;29;.935;3600000;0
11116;196525;94;75;47;3;44;.936;3600000;0
11116;-1;94;0;0;0;0;.00nan;0;0
11116;208300;104;0;0;0;0;.00nan;0;0
11117;209784;91;0;0;0;0;.00nan;0;0
11117;200572;95;67;18;1;17;.944;3600000;0
11117;195346;95;0;0;0;0;.00nan;0;0
11117;-1;91;60;43;6;37;.860;3600000;0
11118;205112;105;56;23;3;20;.870;3900000;0
11118;196525;94;0;0;0;0;.00nan;0;0
11118;-1;94;52;21;3;18;.857;3900000;0
11118;-1;105;0;0;0;0;.00nan;0;0
11119;192733;99;59;37;5;32;.865;3600000;0
11119;194531;99;0;0;0;0;.00nan;0;0
11119;-1;98;100;45;0;45;1.000;3600000;0
11119;-1;98;0;0;0;0;.00nan;0;0
11120;194502;86;85;47;4;43;.915;3545000;0
11120;201876;86;0;0;0;0;.00nan;0;0
11120;196495;87;51;16;2;14;.875;3600000;0
11120;-1;87;0;0;0;0;.00nan;0;0
11121;212343;96;100;33;0;33;1.000;3600000;0
11121;196495;87;0;0;0;0;.00nan;0;0
11121;-1;87;71;26;1;25;.962;3562000;0
11121;-1;96;0;0;0;0;.00nan;0;0
11122;200572;95;57;27;3;24;.889;3583000;0
11122;195330;89;0;0;0;0;.00nan;0;0
11122;195346;95;0;0;0;0;.00nan;0;0
11122;201792;89;77;34;2;32;.941;3600000;0
11123;209784;91;0;0;0;0;.00nan;0;0
11123;194542;88;30;35;8;27;.771;3600000;0
11123;210480;88;0;0;0;0;.00nan;0;0
11123;-1;91;90;36;1;35;.972;3600000;0
11124;192739;92;71;24;2;22;.917;3600000;0
11124;201888;90;0;0;0;0;.00nan;0;0
11124;196532;92;0;0;0;0;.00nan;0;0
11124;-1;90;61;34;4;30;.882;3577000;0
11125;200065;93;94;43;2;41;.953;3600000;0
11125;205318;97;71;42;4;38;.905;3568000;0
11125;205824;97;0;0;0;0;.00nan;0;0
11125;197675;93;0;0;0;0;.00nan;0;0
11126;197940;100;79;31;2;29;.935;3600000;0
11126;194632;102;26;8;3;5;.625;428000;0
11126;200549;102;62;23;2;21;.913;3172000;0
11126;212368;100;0;0;0;0;.00nan;0;0
11127;205112;105;69;48;5;43;.896;3600000;0
11127;196055;106;75;31;2;29;.935;3600000;0
11127;-1;106;0;0;0;0;.00nan;0;0
11127;-1;105;0;0;0;0;.00nan;0;0
11128;192733;99;93;35;1;34;.971;3600000;0
11128;209796;107;73;29;2;27;.931;3573000;0
11128;194531;99;0;0;0;0;.00nan;0;0
11128;-1;107;0;0;0;0;.00nan;0;0
11129;192718;103;73;26;2;24;.923;3608000;0
11129;210428;103;0;0;0;0;.00nan;0;0
11129;210603;104;0;0;0;0;.00nan;0;0
11129;208300;104;55;20;3;17;.850;3608000;0
11130;194899;101;77;37;3;34;.919;3566000;0
11130;201739;101;0;0;0;0;.00nan;0;0
11130;-1;98;85;27;1;26;.963;3600000;0
11130;-1;98;0;0;0;0;.00nan;0;0
11131;209784;91;46;41;6;35;.854;3600000;0
11131;201888;90;41;28;5;23;.821;3600000;0
11131;-1;91;0;0;0;0;.00nan;0;0
11131;-1;90;0;0;0;0;.00nan;0;0
11132;194502;86;65;21;1;20;.952;3600000;0
11132;201876;86;0;0;0;0;.00nan;0;0
11132;212343;96;67;38;3;35;.921;3514000;0
11132;-1;96;0;0;0;0;.00nan;0;0
11133;200572;95;0;0;0;0;.00nan;0;0
11133;195330;89;76;36;3;33;.917;3889000;0
11133;195346;95;54;17;2;15;.882;3889000;0
11133;201792;89;0;0;0;0;.00nan;0;0
11134;197940;100;0;0;0;0;.00nan;0;0
11134;194632;102;65;22;2;20;.909;3600000;0
11134;200549;102;0;0;0;0;.00nan;0;0
11134;212368;100;81;47;4;43;.915;3562000;0
11135;192739;92;0;0;0;0;.00nan;0;0
11135;194542;88;100;37;0;37;1.000;3600000;0
11135;210480;88;0;0;0;0;.00nan;0;0
11135;196532;92;53;24;4;20;.833;3600000;0
11136;192733;99;57;8;0;8;1.000;274000;0
11136;209796;107;0;0;0;0;.00nan;0;0
11136;194531;99;38;28;5;23;.821;3326000;0
11136;-1;107;97;37;2;35;.946;3600000;0
11137;200065;93;88;31;1;30;.968;3600000;0
11137;205318;97;0;0;0;0;.00nan;0;0
11137;205824;97;57;30;3;27;.900;3568000;0
11137;197675;93;0;0;0;0;.00nan;0;0
11138;192718;103;0;0;0;0;.00nan;0;0
11138;210428;103;63;30;4;26;.867;3900000;0
11138;210603;104;64;38;4;34;.895;3900000;0
11138;208300;104;0;0;0;0;.00nan;0;0
11139;196055;106;58;29;4;25;.862;3572000;0
11139;196525;94;80;33;3;30;.909;3600000;0
11139;-1;94;0;0;0;0;.00nan;0;0
11139;-1;106;0;0;0;0;.00nan;0;0
11140;194899;101;0;0;0;0;.00nan;0;0
11140;201739;101;100;42;1;41;.976;3600000;0
11140;-1;98;0;0;0;0;.00nan;0;0
11140;-1;98;53;17;2;15;.882;3600000;0
11141;209796;107;54;30;3;27;.900;3900000;0
11141;196055;106;75;35;3;32;.914;3900000;0
11141;-1;106;0;0;0;0;.00nan;0;0
11141;-1;107;0;0;0;0;.00nan;0;0
11142;194542;88;2;30;8;22;.733;2442000;0
11142;210480;88;35;7;2;5;.714;1158000;0
11142;196495;87;97;17;0;17;1.000;3600000;0
11142;-1;87;0;0;0;0;.00nan;0;0
11143;195330;89;0;0;0;0;.00nan;0;0
11143;201792;89;41;34;5;29;.853;3587000;0
11143;212343;96;0;0;0;0;.00nan;0;0
11143;-1;96;92;44;3;41;.932;3600000;0
11144;209784;91;0;0;0;0;.00nan;0;0
11144;200065;93;100;27;0;27;1.000;3600000;0
11144;-1;91;61;38;5;33;.868;3600000;0
11144;197675;93;0;0;0;0;.00nan;0;0
11145;192739;92;67;28;2;26;.929;3600000;0
11145;205318;97;88;19;0;19;1.000;3600000;0
11145;205824;97;0;0;0;0;.00nan;0;0
11145;196532;92;0;0;0;0;.00nan;0;0
11146;194632;102;0;0;0;0;.00nan;0;0
11146;200549;102;91;33;1;32;.970;3600000;0
11146;-1;98;48;37;5;32;.865;3600000;0
11146;-1;98;0;0;0;0;.00nan;0;0
11147;192718;103;75;29;2;27;.931;3600000;0
11147;192733;99;68;36;4;32;.889;3515000;0
11147;194531;99;0;0;0;0;.00nan;0;0
11147;210428;103;0;0;0;0;.00nan;0;0
11148;210603;104;36;28;5;23;.821;3548000;0
11148;194899;101;80;38;4;34;.895;3600000;0
11148;201739;101;0;0;0;0;.00nan;0;0
11148;208300;104;0;0;0;0;.00nan;0;0
11149;197940;100;49;24;4;20;.833;3571000;0
11149;212368;100;0;0;0;0;.00nan;0;0
11149;196525;94;77;35;3;32;.914;3600000;0
11149;-1;94;0;0;0;0;.00nan;0;0
11150;194502;86;65;45;5;40;.889;3545000;0
11150;200572;95;0;0;0;0;.00nan;0;0
11150;195346;95;50;25;4;21;.840;3600000;0
11150;201876;86;0;0;0;0;.00nan;0;0
11151;192718;103;0;0;0;0;.00nan;0;0
11151;205112;105;73;41;4;37;.902;3600000;0
11151;210428;103;60;31;3;28;.903;3600000;0
11151;-1;105;0;0;0;0;.00nan;0;0
11152;197940;100;0;0;0;0;.00nan;0;0
11152;212368;100;69;20;1;19;.950;3600000;0
11152;196525;94;0;0;0;0;.00nan;0;0
11152;-1;94;95;45;3;42;.933;3531000;0
11153;205318;97;80;35;2;33;.943;3600000;0
11153;205824;97;0;0;0;0;.00nan;0;0
11153;212343;96;49;8;1;7;.875;1738000;0
11153;-1;96;12;20;6;14;.700;1862000;0
11154;209784;91;0;0;0;0;.00nan;0;0
11154;194502;86;64;30;4;26;.867;3545000;0
11154;201876;86;0;0;0;0;.00nan;0;0
11154;-1;91;69;33;3;30;.909;3600000;0
11155;201888;90;0;0;0;0;.00nan;0;0
11155;196495;87;91;38;2;36;.947;3900000;0
11155;-1;90;70;31;2;29;.935;3900000;0
11155;-1;87;0;0;0;0;.00nan;0;0
11156;194542;88;68;32;3;29;.906;3600000;0
11156;210480;88;0;0;0;0;.00nan;0;0
11156;196495;87;79;41;4;37;.902;3593000;0
11156;-1;87;0;0;0;0;.00nan;0;0
11157;192739;92;81;32;2;30;.938;3600000;0
11157;200572;95;54;35;5;30;.857;3600000;0
11157;195346;95;0;0;0;0;.00nan;0;0
11157;196532;92;0;0;0;0;.00nan;0;0
11158;205112;105;61;34;4;30;.882;3600000;0
11158;212343;96;50;34;6;28;.824;3595000;0
11158;-1;105;0;0;0;0;.00nan;0;0
11158;-1;96;0;0;0;0;.00nan;0;0
11159;209784;91;0;0;0;0;.00nan;0;0
11159;205318;97;0;0;0;0;.00nan;0;0
11159;205824;97;75;35;3;32;.914;3640000;0
11159;-1;91;65;23;2;21;.913;3640000;0
11160;197940;100;92;45;2;43;.956;3600000;0
11160;194632;102;94;16;0;16;1.000;3600000;0
11160;200549;102;0;0;0;0;.00nan;0;0
11160;212368;100;0;0;0;0;.00nan;0;0
11161;192733;99;63;32;4;28;.875;3900000;0
11161;194531;99;0;0;0;0;.00nan;0;0
11161;194899;101;0;0;0;0;.00nan;0;0
11161;201739;101;67;42;4;38;.905;3900000;0
11162;192718;103;86;27;1;26;.963;3900000;0
11162;210428;103;0;0;0;0;.00nan;0;0
11162;195330;89;0;0;0;0;.00nan;0;0
11162;201792;89;97;31;1;30;.968;3900000;0
11163;194502;86;90;41;2;39;.951;3600000;0
11163;210603;104;21;10;4;6;.600;1039000;0
11163;201876;86;0;0;0;0;.00nan;0;0
11163;208300;104;69;14;0;14;1.000;2490000;0
11164;209796;107;0;0;0;0;.00nan;0;0
11164;-1;98;54;34;4;30;.882;3590000;0
11164;-1;107;96;38;2;36;.947;3600000;0
11164;-1;98;0;0;0;0;.00nan;0;0
11165;201888;90;0;0;0;0;.00nan;0;0
11165;196495;87;0;0;0;0;.00nan;0;0
11165;-1;90;31;26;5;21;.808;3553000;0
11165;-1;87;72;33;3;30;.909;3600000;0
11166;192739;92;0;0;0;0;.00nan;0;0
11166;200572;95;0;0;0;0;.00nan;0;0
11166;195346;95;60;28;3;25;.893;3562000;0
11166;196532;92;81;35;2;33;.943;3600000;0
11167;200065;93;73;33;3;30;.909;3600000;0
11167;205112;105;0;0;0;0;.00nan;0;0
11167;-1;105;61;30;4;26;.867;3543000;0
11167;197675;93;0;0;0;0;.00nan;0;0
11168;196055;106;62;29;4;25;.862;3900000;0
11168;196525;94;43;28;4;24;.857;3900000;0
11168;-1;94;0;0;0;0;.00nan;0;0
11168;-1;106;0;0;0;0;.00nan;0;0
11169;192718;103;0;0;0;0;.00nan;0;0
11169;194502;86;0;0;0;0;.00nan;0;0
11169;210428;103;85;33;1;32;.970;3600000;0
11169;201876;86;56;37;5;32;.865;3600000;0
11170;210603;104;72;33;3;30;.909;3544000;0
11170;195330;89;71;29;2;27;.931;3600000;0
11170;201792;89;0;0;0;0;.00nan;0;0
11170;208300;104;0;0;0;0;.00nan;0;0
11171;209796;107;43;28;5;23;.821;3541000;0
11171;-1;98;96;43;3;40;.930;3600000;0
11171;-1;107;0;0;0;0;.00nan;0;0
11171;-1;98;0;0;0;0;.00nan;0;0
11172;192733;99;0;0;0;0;.00nan;0;0
11172;194531;99;61;34;4;30;.882;3600000;0
11172;194632;102;53;24;3;21;.875;3600000;0
11172;200549;102;0;0;0;0;.00nan;0;0
11173;197940;100;0;0;0;0;.00nan;0;0
11173;194899;101;95;31;1;30;.968;3600000;0
11173;201739;101;0;0;0;0;.00nan;0;0
11173;212368;100;47;35;5;30;.857;3600000;0
11174;209784;91;0;0;0;0;.00nan;0;0
11174;212343;96;0;0;0;0;.00nan;0;0
11174;-1;91;67;25;2;23;.920;3900000;0
11174;-1;96;71;33;2;31;.939;3900000;0
11175;205112;105;65;45;6;39;.867;3600000;0
11175;205318;97;55;23;3;20;.870;3600000;0
11175;205824;97;0;0;0;0;.00nan;0;0
11175;-1;105;0;0;0;0;.00nan;0;0
11176;194632;102;0;0;0;0;.00nan;0;0
11176;200549;102;51;19;3;16;.842;3600000;0
11176;196525;94;0;0;0;0;.00nan;0;0
11176;-1;94;62;40;4;36;.900;3592000;0
11177;200065;93;50;28;4;24;.857;3600000;0
11177;194542;88;21;10;4;6;.600;954000;0
11177;210480;88;68;23;2;21;.913;2589000;0
11177;197675;93;0;0;0;0;.00nan;0;0
11178;195330;89;0;0;0;0;.00nan;0;0
11178;201792;89;50;13;2;11;.846;3600000;0
11178;196525;94;59;23;3;20;.870;3600000;0
11178;-1;94;0;0;0;0;.00nan;0;0
11179;205318;97;80;36;3;33;.917;3600000;0
11179;205824;97;0;0;0;0;.00nan;0;0
11179;212343;96;55;38;5;33;.868;3600000;0
11179;-1;96;0;0;0;0;.00nan;0;0
11180;200065;93;69;31;3;28;.903;3600000;0
11180;201888;90;0;0;0;0;.00nan;0;0
11180;-1;90;93;32;1;31;.969;3600000;0
11180;197675;93;0;0;0;0;.00nan;0;0
11181;205112;105;23;29;6;23;.793;2474000;0
11181;195330;89;83;15;0;15;1.000;3600000;0
11181;201792;89;0;0;0;0;.00nan;0;0
11181;-1;105;69;12;0;12;1.000;1126000;0
11182;192718;103;47;32;5;27;.844;3600000;0
11182;194632;102;75;23;1;22;.957;3600000;0
11182;210428;103;0;0;0;0;.00nan;0;0
11182;200549;102;0;0;0;0;.00nan;0;0
11183;209796;107;0;0;0;0;.00nan;0;0
11183;194502;86;100;38;0;38;1.000;3600000;0
11183;201876;86;0;0;0;0;.00nan;0;0
11183;-1;107;54;27;4;23;.852;3600000;0
11184;201888;90;0;0;0;0;.00nan;0;0
11184;196495;87;58;24;3;21;.875;3546000;0
11184;-1;90;73;33;2;31;.939;3600000;0
11184;-1;87;0;0;0;0;.00nan;0;0
11185;209784;91;0;0;0;0;.00nan;0;0
11185;194542;88;96;30;1;29;.967;3600000;0
11185;210480;88;0;0;0;0;.00nan;0;0
11185;-1;91;56;20;2;18;.900;3600000;0
11186;192739;92;56;20;3;17;.850;3600000;0
11186;205318;97;0;0;0;0;.00nan;0;0
11186;205824;97;58;43;5;38;.884;3600000;0
11186;196532;92;0;0;0;0;.00nan;0;0
11187;200065;93;0;0;0;0;.00nan;0;0
11187;200572;95;0;0;0;0;.00nan;0;0
11187;195346;95;50;20;3;17;.850;3600000;0
11187;197675;93;50;33;4;29;.879;3600000;0
11188;194632;102;45;30;5;25;.833;3600000;0
11188;200549;102;0;0;0;0;.00nan;0;0
11188;196525;94;26;28;6;22;.786;2527000;0
11188;-1;94;33;4;2;2;.500;1073000;0
11189;209796;107;89;39;3;36;.923;3600000;0
11189;195330;89;57;41;5;36;.878;3555000;0
11189;201792;89;0;0;0;0;.00nan;0;0
11189;-1;107;0;0;0;0;.00nan;0;0
11190;197940;100;100;27;0;27;1.000;3600000;0
11190;192718;103;79;43;3;40;.930;3600000;0
11190;210428;103;0;0;0;0;.00nan;0;0
11190;212368;100;0;0;0;0;.00nan;0;0
11191;192733;99;80;41;3;38;.927;3550000;0
11191;194531;99;0;0;0;0;.00nan;0;0
11191;194899;101;84;35;2;33;.943;3600000;0
11191;201739;101;0;0;0;0;.00nan;0;0
11192;210603;104;60;22;2;20;.909;3600000;0
11192;-1;98;39;38;6;32;.842;3164000;0
11192;-1;98;61;4;0;4;1.000;436000;0
11192;208300;104;0;0;0;0;.00nan;0;0
11193;194502;86;44;24;4;20;.833;3600000;0
11193;196055;106;91;38;1;37;.974;3600000;0
11193;201876;86;0;0;0;0;.00nan;0;0
11193;-1;106;0;0;0;0;.00nan;0;0
11194;194542;88;0;0;0;0;.00nan;0;0
11194;210480;88;86;43;3;40;.930;3671000;0
11194;196495;87;0;0;0;0;.00nan;0;0
11194;-1;87;69;26;2;24;.923;3671000;0
11195;209784;91;66;39;4;35;.897;3576000;0
11195;201888;90;69;25;2;23;.920;3600000;0
11195;-1;91;0;0;0;0;.00nan;0;0
11195;-1;90;0;0;0;0;.00nan;0;0
11196;192733;99;0;0;0;0;.00nan;0;0
11196;194531;99;79;53;4;49;.925;3600000;0
11196;194632;102;0;0;0;0;.00nan;0;0
11196;200549;102;48;17;3;14;.824;3600000;0
11197;209796;107;0;0;0;0;.00nan;0;0
11197;-1;98;74;45;4;41;.911;3600000;0
11197;-1;107;71;35;3;32;.914;3600000;0
11197;-1;98;0;0;0;0;.00nan;0;0
11198;197940;100;32;32;6;26;.813;3298000;0
11198;192718;103;0;0;0;0;.00nan;0;0
11198;210428;103;58;35;4;31;.886;3600000;0
11198;212368;100;48;0;0;0;.00nan;239000;0
11199;200065;93;61;18;2;16;.889;3899000;0
11199;212343;96;98;42;2;40;.952;3900000;0
11199;197675;93;0;0;0;0;.00nan;0;0
11199;-1;96;0;0;0;0;.00nan;0;0
11200;205318;97;6;20;7;13;.650;2672000;0
11200;200572;95;66;29;3;26;.897;3600000;0
11200;205824;97;49;19;3;16;.842;928000;0
11200;195346;95;0;0;0;0;.00nan;0;0
11201;194502;86;0;0;0;0;.00nan;0;0
11201;201876;86;42;28;5;23;.821;3582000;0
11201;196525;94;0;0;0;0;.00nan;0;0
11201;-1;94;62;36;4;32;.889;3600000;0
11202;210603;104;0;0;0;0;.00nan;0;0
11202;194899;101;71;15;0;15;1.000;1138000;0
11202;201739;101;40;34;6;28;.824;2462000;0
11202;208300;104;68;29;3;26;.897;3600000;0
11203;195330;89;0;0;0;0;.00nan;0;0
11203;196055;106;0;0;0;0;.00nan;0;0
11203;201792;89;51;36;5;31;.861;3600000;0
11203;-1;106;81;31;2;29;.935;3600000;0
11204;192739;92;52;27;4;23;.852;3600000;0
11204;212343;96;67;51;5;46;.902;3600000;0
11204;196532;92;0;0;0;0;.00nan;0;0
11204;-1;96;0;0;0;0;.00nan;0;0
11205;194502;86;43;37;6;31;.838;3600000;0
11205;205112;105;78;22;1;21;.955;3600000;0
11205;201876;86;0;0;0;0;.00nan;0;0
11205;-1;105;0;0;0;0;.00nan;0;0
11206;192733;99;59;32;4;28;.875;3532000;0
11206;194531;99;0;0;0;0;.00nan;0;0
11206;196525;94;99;45;2;43;.956;3600000;0
11206;-1;94;0;0;0;0;.00nan;0;0
11207;192739;92;65;38;4;34;.895;3600000;0
11207;196495;87;69;31;3;28;.903;3600000;0
11207;196532;92;0;0;0;0;.00nan;0;0
11207;-1;87;0;0;0;0;.00nan;0;0
11208;192718;103;59;25;3;22;.880;3525000;0
11208;210428;103;0;0;0;0;.00nan;0;0
11208;-1;98;95;36;1;35;.972;3600000;0
11208;-1;98;0;0;0;0;.00nan;0;0
11209;205318;97;0;0;0;0;.00nan;0;0
11209;200572;95;0;0;0;0;.00nan;0;0
11209;205824;97;51;29;4;25;.862;3600000;0
11209;195346;95;73;23;1;22;.957;3600000;0
11210;212343;96;57;34;5;29;.853;3600000;0
11210;196495;87;0;0;0;0;.00nan;0;0
11210;-1;87;75;27;2;25;.926;3600000;0
11210;-1;96;0;0;0;0;.00nan;0;0
11211;192739;92;0;0;0;0;.00nan;0;0
11211;209784;91;0;0;0;0;.00nan;0;0
11211;196532;92;54;20;2;18;.900;3900000;0
11211;-1;91;100;39;2;37;.949;3900000;0
11212;209796;107;0;0;0;0;.00nan;0;0
11212;194632;102;36;43;7;36;.837;3600000;0
11212;200549;102;0;0;0;0;.00nan;0;0
11212;-1;107;57;29;4;25;.862;3600000;0
11213;210603;104;93;32;1;31;.969;3600000;0
11213;194899;101;63;24;3;21;.875;3600000;0
11213;201739;101;0;0;0;0;.00nan;0;0
11213;208300;104;0;0;0;0;.00nan;0;0
11214;194502;86;33;9;3;6;.667;480000;0
11214;195330;89;0;0;0;0;.00nan;0;0
11214;201792;89;38;24;5;19;.792;3600000;0
11214;201876;86;69;29;3;26;.897;3067000;0
11215;205318;97;60;30;3;27;.900;3600000;0
11215;205824;97;0;0;0;0;.00nan;0;0
11215;201888;90;0;0;0;0;.00nan;0;0
11215;-1;90;52;28;4;24;.857;3600000;0
11216;192739;92;53;30;4;26;.867;3746000;0
11216;194542;88;67;48;5;43;.896;3746000;0
11216;210480;88;0;0;0;0;.00nan;0;0
11216;196532;92;0;0;0;0;.00nan;0;0
11217;200065;93;17;19;6;13;.684;1863000;0
11217;212343;96;57;19;2;17;.895;2432000;0
11217;197675;93;57;7;0;7;1.000;1737000;0
11217;-1;96;36;24;5;19;.792;1168000;0
11218;209784;91;0;0;0;0;.00nan;0;0
11218;196495;87;67;23;1;22;.957;3600000;0
11218;-1;91;41;26;4;22;.846;3600000;0
11218;-1;87;0;0;0;0;.00nan;0;0
11219;197940;100;72;26;2;24;.923;3600000;0
11219;192733;99;52;31;5;26;.839;3600000;0
11219;194531;99;0;0;0;0;.00nan;0;0
11219;212368;100;0;0;0;0;.00nan;0;0
11220;194632;102;0;0;0;0;.00nan;0;0
11220;200549;102;66;28;3;25;.893;3543000;0
11220;194899;101;0;0;0;0;.00nan;0;0
11220;201739;101;100;58;2;56;.966;3600000;0
11221;192718;103;80;23;1;22;.957;3600000;0
11221;210428;103;0;0;0;0;.00nan;0;0
11221;196525;94;52;3;0;3;1.000;340000;0
11221;-1;94;47;38;7;31;.816;3260000;0
11222;205112;105;73;38;4;34;.895;3600000;0
11222;210603;104;67;38;5;33;.868;3600000;0
11222;-1;105;0;0;0;0;.00nan;0;0
11222;208300;104;0;0;0;0;.00nan;0;0
11223;196055;106;81;30;2;28;.933;3600000;0
11223;-1;98;49;36;5;31;.861;3600000;0
11223;-1;106;0;0;0;0;.00nan;0;0
11223;-1;98;0;0;0;0;.00nan;0;0
11224;209784;91;0;0;0;0;.00nan;0;0
11224;194502;86;33;25;5;20;.800;3600000;0
11224;201876;86;0;0;0;0;.00nan;0;0
11224;-1;91;75;22;1;21;.955;3600000;0
11225;192739;92;0;0;0;0;.00nan;0;0
11225;201888;90;51;41;5;36;.878;3600000;0
11225;196532;92;57;25;3;22;.880;3600000;0
11225;-1;90;0;0;0;0;.00nan;0;0
11226;194542;88;47;29;5;24;.828;3600000;0
11226;205318;97;0;0;0;0;.00nan;0;0
11226;210480;88;0;0;0;0;.00nan;0;0
11226;205824;97;71;24;1;23;.958;3600000;0
11227;200572;95;64;20;2;18;.900;3600000;0
11227;195346;95;0;0;0;0;.00nan;0;0
11227;196495;87;0;0;0;0;.00nan;0;0
11227;-1;87;76;39;3;36;.923;3600000;0
11228;194632;102;56;30;5;25;.833;3717000;0
11228;200549;102;0;0;0;0;.00nan;0;0
11228;194899;101;26;12;4;8;.667;1039000;0
11228;201739;101;67;22;2;20;.909;2678000;0
11229;209796;107;52;20;3;17;.850;3600000;0
11229;205112;105;47;13;2;11;.846;833000;0
11229;-1;105;33;27;6;21;.778;2767000;0
11229;-1;107;0;0;0;0;.00nan;0;0
11230;197940;100;0;0;0;0;.00nan;0;0
11230;192733;99;0;0;0;0;.00nan;0;0
11230;194531;99;80;44;4;40;.909;3600000;0
11230;212368;100;81;35;3;32;.914;3600000;0
11231;200065;93;85;37;3;34;.919;3600000;0
11231;212343;96;83;32;2;30;.938;3600000;0
11231;197675;93;0;0;0;0;.00nan;0;0
11231;-1;96;0;0;0;0;.00nan;0;0
11232;192718;103;0;0;0;0;.00nan;0;0
11232;210428;103;62;30;3;27;.900;3600000;0
11232;196525;94;100;38;0;38;1.000;3600000;0
11232;-1;94;0;0;0;0;.00nan;0;0
11233;196055;106;0;0;0;0;.00nan;0;0
11233;-1;98;0;0;0;0;.00nan;0;0
11233;-1;106;71;44;4;40;.909;3593000;0
11233;-1;98;76;29;2;27;.931;3600000;0
11234;210603;104;0;0;0;0;.00nan;0;0
11234;196525;94;55;42;6;36;.857;3600000;0
11234;-1;94;0;0;0;0;.00nan;0;0
11234;208300;104;68;22;2;20;.909;3600000;0
11235;200572;95;0;0;0;0;.00nan;0;0
11235;195346;95;42;24;4;20;.833;3877000;0
11235;201888;90;0;0;0;0;.00nan;0;0
11235;-1;90;61;40;5;35;.875;3877000;0
11236;194542;88;74;43;4;39;.907;3600000;0
11236;210480;88;0;0;0;0;.00nan;0;0
11236;196495;87;64;22;2;20;.909;3600000;0
11236;-1;87;0;0;0;0;.00nan;0;0
11237;192733;99;81;33;2;31;.939;3600000;0
11237;194531;99;0;0;0;0;.00nan;0;0
11237;210603;104;67;38;5;33;.868;3600000;0
11237;208300;104;0;0;0;0;.00nan;0;0
11238;192718;103;58;20;2;18;.900;3600000;0
11238;209796;107;0;0;0;0;.00nan;0;0
11238;210428;103;0;0;0;0;.00nan;0;0
11238;-1;107;72;33;3;30;.909;3586000;0
11239;209784;91;81;37;3;34;.919;3900000;0
11239;205318;97;77;34;3;31;.912;3900000;0
11239;205824;97;0;0;0;0;.00nan;0;0
11239;-1;91;0;0;0;0;.00nan;0;0
11240;197940;100;66;22;2;20;.909;3600000;0
11240;194899;101;0;0;0;0;.00nan;0;0
11240;201739;101;78;48;3;45;.938;3587000;0
11240;212368;100;0;0;0;0;.00nan;0;0
11241;209784;91;0;0;0;0;.00nan;0;0
11241;200065;93;55;30;4;26;.867;3581000;0
11241;-1;91;68;26;2;24;.923;3600000;0
11241;197675;93;0;0;0;0;.00nan;0;0
11242;195330;89;37;21;4;17;.810;3272000;0
11242;201792;89;30;10;3;7;.700;304000;0
11242;201888;90;0;0;0;0;.00nan;0;0
11242;-1;90;57;36;5;31;.861;3600000;0
11243;194502;86;47;45;6;39;.867;3140000;0
11243;194542;88;41;26;5;21;.808;3600000;0
11243;210480;88;0;0;0;0;.00nan;0;0
11243;201876;86;57;4;0;4;1.000;403000;0
11244;192739;92;35;32;6;26;.813;3243000;0
11244;200572;95;59;17;2;15;.882;3600000;0
11244;195346;95;0;0;0;0;.00nan;0;0
11244;196532;92;45;7;1;6;.857;357000;0
11245;205318;97;64;21;2;19;.905;3024000;0
11245;205824;97;30;9;3;6;.667;576000;0
11245;212343;96;91;33;1;32;.970;3600000;0
11245;-1;96;0;0;0;0;.00nan;0;0
11246;209796;107;100;33;0;33;1.000;3600000;0
11246;210603;104;71;43;4;39;.907;3600000;0
11246;-1;107;0;0;0;0;.00nan;0;0
11246;208300;104;0;0;0;0;.00nan;0;0
11247;192718;103;15;25;7;18;.720;3068000;0
11247;205112;105;99;46;2;44;.957;3600000;0
11247;210428;103;52;3;0;3;1.000;532000;0
11247;-1;105;0;0;0;0;.00nan;0;0
11248;192733;99;82;33;3;30;.909;3600000;0
11248;194531;99;0;0;0;0;.00nan;0;0
11248;194632;102;37;29;5;24;.828;3558000;0
11248;200549;102;0;0;0;0;.00nan;0;0
11249;194899;101;69;38;4;34;.895;3900000;0
11249;196055;106;69;31;4;27;.871;3900000;0
11249;201739;101;0;0;0;0;.00nan;0;0
11249;-1;106;0;0;0;0;.00nan;0;0
11250;197940;100;17;14;5;9;.643;2011000;0
11250;212368;100;58;13;1;12;.923;1589000;0
11250;-1;98;87;29;1;28;.966;3600000;0
11250;-1;98;0;0;0;0;.00nan;0;0
11251;201888;90;64;33;3;30;.909;3600000;0
11251;196495;87;49;40;6;34;.850;3124000;0
11251;-1;90;0;0;0;0;.00nan;0;0
11251;-1;87;54;1;0;1;1.000;476000;0
11252;192733;99;0;0;0;0;.00nan;0;0
11252;194531;99;76;49;4;45;.918;3600000;0
11252;194632;102;0;0;0;0;.00nan;0;0
11252;200549;102;66;22;2;20;.909;3600000;0
11253;192739;92;0;0;0;0;.00nan;0;0
11253;200572;95;0;0;0;0;.00nan;0;0
11253;195346;95;41;28;5;23;.821;3558000;0
11253;196532;92;58;31;4;27;.871;3600000;0
11254;194502;86;0;0;0;0;.00nan;0;0
11254;194542;88;62;29;3;26;.897;3600000;0
11254;210480;88;0;0;0;0;.00nan;0;0
11254;201876;86;100;33;0;33;1.000;3600000;0
11255;209784;91;0;0;0;0;.00nan;0;0
11255;200065;93;0;0;0;0;.00nan;0;0
11255;-1;91;96;23;0;23;1.000;3600000;0
11255;197675;93;63;37;4;33;.892;3600000;0
11256;209796;107;0;0;0;0;.00nan;0;0
11256;205112;105;0;0;0;0;.00nan;0;0
11256;-1;105;82;46;3;43;.935;3559000;0
11256;-1;107;74;20;1;19;.950;3600000;0
11257;192718;103;0;0;0;0;.00nan;0;0
11257;210428;103;82;36;3;33;.917;3591000;0
11257;210603;104;0;0;0;0;.00nan;0;0
11257;208300;104;61;36;4;32;.889;3600000;0
11258;197940;100;46;30;5;25;.833;3646000;0
11258;212368;100;0;0;0;0;.00nan;0;0
11258;-1;98;0;0;0;0;.00nan;0;0
11258;-1;98;62;38;4;34;.895;3646000;0
11259;194899;101;46;5;1;4;.800;962000;0
11259;196055;106;0;0;0;0;.00nan;0;0
11259;201739;101;52;41;6;35;.854;2558000;0
11259;-1;106;59;36;5;31;.861;3600000;0
11260;209784;91;0;0;0;0;.00nan;0;0
11260;212343;96;66;30;3;27;.900;3567000;0
11260;-1;91;57;23;2;21;.913;3600000;0
11260;-1;96;0;0;0;0;.00nan;0;0
11261;194502;86;39;32;6;26;.813;2152000;0
11261;195330;89;0;0;0;0;.00nan;0;0
11261;201792;89;84;37;3;34;.919;3600000;0
11261;201876;86;53;12;1;11;.917;1448000;0
11262;197940;100;0;0;0;0;.00nan;0;0
11262;192733;99;57;35;5;30;.857;3536000;0
11262;194531;99;0;0;0;0;.00nan;0;0
11262;212368;100;52;24;3;21;.875;3600000;0
11263;205318;97;90;33;2;31;.939;3600000;0
11263;200572;95;43;27;4;23;.852;3544000;0
11263;205824;97;0;0;0;0;.00nan;0;0
11263;195346;95;0;0;0;0;.00nan;0;0
11264;209796;107;55;26;3;23;.885;3600000;0
11264;196525;94;0;0;0;0;.00nan;0;0
11264;-1;94;74;44;4;40;.909;3559000;0
11264;-1;107;0;0;0;0;.00nan;0;0
11265;192718;103;78;36;2;34;.944;3600000;0
11265;205112;105;57;33;5;28;.848;3600000;0
11265;210428;103;0;0;0;0;.00nan;0;0
11265;-1;105;0;0;0;0;.00nan;0;0
11266;194632;102;44;24;4;20;.833;3600000;0
11266;200549;102;0;0;0;0;.00nan;0;0
11266;196525;94;41;40;7;33;.825;3600000;0
11266;-1;94;0;0;0;0;.00nan;0;0
11267;195330;89;0;0;0;0;.00nan;0;0
11267;201792;89;86;41;3;38;.927;3600000;0
11267;201888;90;0;0;0;0;.00nan;0;0
11267;-1;90;69;32;4;28;.875;3588000;0
11268;194542;88;59;34;4;30;.882;3900000;0
11268;210480;88;0;0;0;0;.00nan;0;0
11268;212343;96;53;36;4;32;.889;3900000;0
11268;-1;96;0;0;0;0;.00nan;0;0
11269;200065;93;72;43;4;39;.907;3600000;0
11269;200572;95;0;0;0;0;.00nan;0;0
11269;195346;95;65;16;1;15;.938;3600000;0
11269;197675;93;0;0;0;0;.00nan;0;0
11270;205112;105;91;33;1;32;.970;3600000;0
11270;-1;98;50;21;3;18;.857;3568000;0
11270;-1;105;0;0;0;0;.00nan;0;0
11270;-1;98;0;0;0;0;.00nan;0;0
11271;194502;86;86;37;2;35;.946;3590000;0
11271;201876;86;0;0;0;0;.00nan;0;0
11271;196495;87;71;21;1;20;.952;3600000;0
11271;-1;87;0;0;0;0;.00nan;0;0
11272;192739;92;62;12;1;11;.917;3600000;0
11272;209784;91;18;23;6;17;.739;1722000;0
11272;196532;92;0;0;0;0;.00nan;0;0
11272;-1;91;56;28;4;24;.857;1878000;0
11273;194542;88;67;29;3;26;.897;3551000;0
11273;210480;88;0;0;0;0;.00nan;0;0
11273;201888;90;68;26;2;24;.923;3600000;0
11273;-1;90;0;0;0;0;.00nan;0;0
11274;195330;89;0;0;0;0;.00nan;0;0
11274;201792;89;80;45;4;41;.911;3725000;0
11274;196495;87;0;0;0;0;.00nan;0;0
11274;-1;87;59;36;5;31;.861;3725000;0
11275;200572;95;84;27;1;26;.963;3600000;0
11275;195346;95;0;0;0;0;.00nan;0;0
11275;212343;96;33;45;7;38;.844;3600000;0
11275;-1;96;0;0;0;0;.00nan;0;0
11276;197940;100;64;35;4;31;.886;3600000;0
11276;194632;102;54;22;3;19;.864;3600000;0
11276;200549;102;0;0;0;0;.00nan;0;0
11276;212368;100;0;0;0;0;.00nan;0;0
11277;192733;99;84;27;1;26;.963;3600000;0
11277;194531;99;0;0;0;0;.00nan;0;0
11277;194899;101;88;39;3;36;.923;3572000;0
11277;201739;101;0;0;0;0;.00nan;0;0
11278;192718;103;69;27;2;25;.926;3600000;0
11278;210428;103;0;0;0;0;.00nan;0;0
11278;196525;94;73;48;5;43;.896;3600000;0
11278;-1;94;0;0;0;0;.00nan;0;0
11279;209796;107;0;0;0;0;.00nan;0;0
11279;210603;104;100;32;0;32;1.000;3600000;0
11279;-1;107;63;32;3;29;.906;3600000;0
11279;208300;104;0;0;0;0;.00nan;0;0
11280;205112;105;84;43;2;41;.953;3600000;0
11280;-1;98;54;32;4;28;.875;3578000;0
11280;-1;105;0;0;0;0;.00nan;0;0
11280;-1;98;0;0;0;0;.00nan;0;0
11281;192739;92;0;0;0;0;.00nan;0;0
11281;209784;91;53;3;0;3;1.000;888000;0
11281;196532;92;69;24;2;22;.917;3600000;0
11281;-1;91;37;33;6;27;.818;2712000;0
11282;194502;86;0;0;0;0;.00nan;0;0
11282;195330;89;27;26;6;20;.769;3553000;0
11282;201792;89;0;0;0;0;.00nan;0;0
11282;201876;86;55;33;5;28;.848;3600000;0
11283;209796;107;57;28;4;24;.857;3600000;0
11283;196525;94;0;0;0;0;.00nan;0;0
11283;-1;94;57;43;6;37;.860;3587000;0
11283;-1;107;0;0;0;0;.00nan;0;0
11284;197940;100;62;29;3;26;.897;3600000;0
11284;194632;102;0;0;0;0;.00nan;0;0
11284;200549;102;69;45;4;41;.911;3600000;0
11284;212368;100;0;0;0;0;.00nan;0;0
11285;200065;93;0;0;0;0;.00nan;0;0
11285;205318;97;69;23;2;21;.913;3600000;0
11285;205824;97;0;0;0;0;.00nan;0;0
11285;197675;93;70;43;4;39;.907;3586000;0
11286;194542;88;0;0;0;0;.00nan;0;0
11286;210480;88;77;36;3;33;.917;3600000;0
11286;201888;90;0;0;0;0;.00nan;0;0
11286;-1;90;53;28;4;24;.857;3555000;0
11287;192718;103;0;0;0;0;.00nan;0;0
11287;210428;103;35;32;6;26;.813;3600000;0
11287;210603;104;35;29;6;23;.793;3327000;0
11287;208300;104;40;2;1;1;.500;258000;0
11288;205112;105;0;0;0;0;.00nan;0;0
11288;196055;106;89;41;3;38;.927;3600000;0
11288;-1;106;0;0;0;0;.00nan;0;0
11288;-1;105;32;31;6;25;.806;3600000;0
11289;192733;99;0;0;0;0;.00nan;0;0
11289;194531;99;39;28;5;23;.821;3600000;0
11289;194899;101;43;4;1;3;.750;346000;0
11289;201739;101;6;23;7;16;.696;3254000;0
11290;200572;95;0;0;0;0;.00nan;0;0
11290;195346;95;65;23;2;21;.913;3600000;0
11290;212343;96;69;15;0;15;1.000;1355000;0
11290;-1;96;47;42;6;36;.857;2245000;0
11291;200065;93;44;35;6;29;.829;3600000;0
11291;205318;97;0;0;0;0;.00nan;0;0
11291;205824;97;55;28;3;25;.893;3600000;0
11291;197675;93;0;0;0;0;.00nan;0;0
11292;210603;104;0;0;0;0;.00nan;0;0
11292;196055;106;0;0;0;0;.00nan;0;0
11292;-1;106;77;39;3;36;.923;3600000;0
11292;208300;104;53;31;4;27;.871;3577000;0
11293;209796;107;0;0;0;0;.00nan;0;0
11293;196525;94;85;40;3;37;.925;3600000;0
11293;-1;94;0;0;0;0;.00nan;0;0
11293;-1;107;58;34;4;30;.882;3598000;0
11295;195330;89;60;8;0;8;1.000;1003000;0
11295;201792;89;35;33;6;27;.818;2597000;0
11295;212343;96;59;21;2;19;.905;3600000;0
11295;-1;96;0;0;0;0;.00nan;0;0
11297;194899;101;0;0;0;0;.00nan;0;0
11297;201739;101;61;22;3;19;.864;3600000;0
11297;196525;94;50;29;4;25;.862;3588000;0
11297;-1;94;0;0;0;0;.00nan;0;0
11299;200572;95;91;24;0;24;1.000;3600000;0
11299;195346;95;0;0;0;0;.00nan;0;0
11299;196495;87;97;42;1;41;.976;3600000;0
11299;-1;87;0;0;0;0;.00nan;0;0
11301;210603;104;37;30;5;25;.833;3600000;0
11301;196055;106;88;30;1;29;.967;3600000;0
11301;-1;106;0;0;0;0;.00nan;0;0
11301;208300;104;0;0;0;0;.00nan;0;0
11303;192739;92;92;36;1;35;.972;3600000;0
11303;194542;88;0;0;0;0;.00nan;0;0
11303;210480;88;42;34;5;29;.853;3600000;0
11303;196532;92;0;0;0;0;.00nan;0;0
11305;200065;93;61;27;3;24;.889;3600000;0
11305;205318;97;61;30;3;27;.900;2875000;0
11305;205824;97;17;7;4;3;.429;725000;0
11305;197675;93;0;0;0;0;.00nan;0;0
11307;209784;91;0;0;0;0;.00nan;0;0
11307;194502;86;98;49;2;47;.959;3900000;0
11307;205799;86;0;0;0;0;.00nan;0;0
11307;-1;91;79;28;2;26;.929;3900000;0
11309;194632;102;21;31;7;24;.774;3600000;0
11309;200549;102;0;0;0;0;.00nan;0;0
11309;-1;98;50;21;3;18;.857;3600000;0
11309;-1;98;0;0;0;0;.00nan;0;0
11311;197940;100;0;0;0;0;.00nan;0;0
11311;205112;105;0;0;0;0;.00nan;0;0
11311;212368;100;61;30;3;27;.900;3600000;0
11311;-1;105;54;35;4;31;.886;3600000;0
11313;192718;103;0;0;0;0;.00nan;0;0
11313;210428;103;38;28;4;24;.857;3541000;0
11313;201888;90;0;0;0;0;.00nan;0;0
11313;-1;90;60;21;2;19;.905;3600000;0
11315;192733;99;72;34;3;31;.912;3562000;0
11315;209796;107;76;21;1;20;.952;3600000;0
11315;194531;99;0;0;0;0;.00nan;0;0
11315;-1;107;0;0;0;0;.00nan;0;0
11317;197940;100;95;39;2;37;.949;3600000;0
11317;205112;105;59;31;3;28;.903;3566000;0
11317;212368;100;0;0;0;0;.00nan;0;0
11317;-1;105;0;0;0;0;.00nan;0;0
11319;192718;103;0;0;0;0;.00nan;0;0
11319;210428;103;40;30;5;25;.833;3600000;0
11319;210603;104;79;31;2;29;.935;3600000;0
11319;208300;104;0;0;0;0;.00nan;0;0
11321;209784;91;0;0;0;0;.00nan;0;0
11321;196525;94;0;0;0;0;.00nan;0;0
11321;-1;94;56;25;3;22;.880;3600000;0
11321;-1;91;58;37;4;33;.892;3600000;0
11323;194632;102;62;22;3;19;.864;3214000;0
11323;200549;102;46;3;1;2;.667;386000;0
11323;194899;101;49;45;7;38;.844;3600000;0
11323;201739;101;0;0;0;0;.00nan;0;0
11325;205318;97;36;25;5;20;.800;3658000;0
11325;205824;97;0;0;0;0;.00nan;0;0
11325;-1;98;81;43;4;39;.907;3658000;0
11325;-1;98;0;0;0;0;.00nan;0;0
11327;200572;95;68;18;2;16;.889;3600000;0
11327;195346;95;0;0;0;0;.00nan;0;0
11327;196495;87;83;46;3;43;.935;3559000;0
11327;-1;87;0;0;0;0;.00nan;0;0
11329;194542;88;74;39;3;36;.923;3600000;0
11329;210480;88;0;0;0;0;.00nan;0;0
11329;195330;89;0;0;0;0;.00nan;0;0
11329;201792;89;51;35;4;31;.886;3567000;0
11331;192739;92;66;40;4;36;.900;3600000;0
11331;200065;93;95;33;1;32;.970;3600000;0
11331;196532;92;0;0;0;0;.00nan;0;0
11331;197675;93;0;0;0;0;.00nan;0;0
11333;192733;99;31;29;6;23;.793;2876000;0
11333;194531;99;14;7;4;3;.429;724000;0
11333;196055;106;0;0;0;0;.00nan;0;0
11333;-1;106;76;30;2;28;.933;3600000;0
11335;209796;107;0;0;0;0;.00nan;0;0
11335;212343;96;87;36;2;34;.944;3600000;0
11335;-1;107;63;35;4;31;.886;3578000;0
11335;-1;96;0;0;0;0;.00nan;0;0
11337;194502;86;27;28;6;22;.786;2883000;0
11337;205799;86;60;11;1;10;.909;717000;0
11337;201888;90;0;0;0;0;.00nan;0;0
11337;-1;90;65;29;3;26;.897;3600000;0
11339;200572;95;0;0;0;0;.00nan;0;0
11339;195346;95;65;29;2;27;.931;3600000;0
11339;201888;90;36;20;4;16;.800;3566000;0
11339;-1;90;0;0;0;0;.00nan;0;0
11341;192733;99;0;0;0;0;.00nan;0;0
11341;194531;99;65;46;4;42;.913;3900000;0
11341;194542;88;0;0;0;0;.00nan;0;0
11341;210480;88;64;38;4;34;.895;3900000;0
11343;197940;100;0;0;0;0;.00nan;0;0
11343;205112;105;0;0;0;0;.00nan;0;0
11343;212368;100;42;21;4;17;.810;3546000;0
11343;-1;105;77;32;3;29;.906;3600000;0
11345;192718;103;28;18;4;14;.778;3600000;0
11345;194632;102;0;0;0;0;.00nan;0;0
11345;210428;103;0;0;0;0;.00nan;0;0
11345;200549;102;48;32;6;26;.813;3565000;0
11347;209784;91;72;30;2;28;.933;3600000;0
11347;196055;106;60;25;3;22;.880;3549000;0
11347;-1;106;0;0;0;0;.00nan;0;0
11347;-1;91;0;0;0;0;.00nan;0;0
11349;205318;97;0;0;0;0;.00nan;0;0
11349;205824;97;54;37;5;32;.865;3600000;0
11349;196525;94;51;24;3;21;.875;3600000;0
11349;-1;94;0;0;0;0;.00nan;0;0
11351;194899;101;0;0;0;0;.00nan;0;0
11351;201739;101;85;32;2;30;.938;3600000;0
11351;212343;96;0;0;0;0;.00nan;0;0
11351;-1;96;59;28;3;25;.893;3550000;0
11353;200065;93;0;0;0;0;.00nan;0;0
11353;195330;89;22;43;8;35;.814;3600000;0
11353;201792;89;0;0;0;0;.00nan;0;0
11353;197675;93;100;37;0;37;1.000;3600000;0
11355;209796;107;79;39;3;36;.923;3600000;0
11355;-1;98;0;0;0;0;.00nan;0;0
11355;-1;107;0;0;0;0;.00nan;0;0
11355;-1;98;57;37;6;31;.838;3600000;0
11357;192739;92;0;0;0;0;.00nan;0;0
11357;210603;104;0;0;0;0;.00nan;0;0
11357;196532;92;81;37;2;35;.946;3600000;0
11357;208300;104;38;27;5;22;.815;3600000;0
11359;194502;86;0;0;0;0;.00nan;0;0
11359;205799;86;75;39;3;36;.923;3600000;0
11359;196495;87;0;0;0;0;.00nan;0;0
11359;-1;87;56;41;5;36;.878;3534000;0
11361;194899;101;73;33;3;30;.909;3579000;0
11361;201739;101;0;0;0;0;.00nan;0;0
11361;-1;98;84;34;2;32;.941;3600000;0
11361;-1;98;0;0;0;0;.00nan;0;0
11363;192739;92;40;31;5;26;.839;3600000;0
11363;194502;86;94;40;1;39;.975;3600000;0
11363;205799;86;0;0;0;0;.00nan;0;0
11363;196532;92;0;0;0;0;.00nan;0;0
11365;200065;93;64;37;4;33;.892;3600000;0
11365;196055;106;0;0;0;0;.00nan;0;0
11365;-1;106;97;33;1;32;.970;3600000;0
11365;197675;93;0;0;0;0;.00nan;0;0
11367;205318;97;52;4;0;4;1.000;260000;0
11367;205824;97;39;28;5;23;.821;3340000;0
11367;196495;87;45;24;4;20;.833;3600000;0
11367;-1;87;0;0;0;0;.00nan;0;0
11369;209796;107;0;0;0;0;.00nan;0;0
11369;200572;95;52;31;5;26;.839;3600000;0
11369;195346;95;0;0;0;0;.00nan;0;0
11369;-1;107;39;38;6;32;.842;3562000;0
11371;210603;104;50;37;5;32;.865;3548000;0
11371;212343;96;0;0;0;0;.00nan;0;0
11371;-1;96;69;31;3;28;.903;3600000;0
11371;208300;104;0;0;0;0;.00nan;0;0
11373;192733;99;75;24;1;23;.958;3600000;0
11373;194531;99;0;0;0;0;.00nan;0;0
11373;196525;94;57;29;4;25;.862;3600000;0
11373;-1;94;0;0;0;0;.00nan;0;0
11375;209784;91;0;0;0;0;.00nan;0;0
11375;201888;90;0;0;0;0;.00nan;0;0
11375;-1;91;65;33;3;30;.909;3546000;0
11375;-1;90;69;22;2;20;.909;3600000;0
11377;194632;102;55;34;5;29;.853;3648000;0
11377;200549;102;0;0;0;0;.00nan;0;0
11377;195330;89;0;0;0;0;.00nan;0;0
11377;201792;89;54;32;4;28;.875;3648000;0
11379;197940;100;88;34;2;32;.941;3600000;0
11379;194542;88;53;32;4;28;.875;3534000;0
11379;210480;88;0;0;0;0;.00nan;0;0
11379;212368;100;0;0;0;0;.00nan;0;0
11381;192718;103;0;0;0;0;.00nan;0;0
11381;205112;105;25;30;6;24;.800;3344000;0
11381;210428;103;85;31;1;30;.968;3600000;0
11381;-1;105;50;1;0;1;1.000;256000;0
11383;192718;103;75;30;2;28;.933;3600000;0
11383;210428;103;0;0;0;0;.00nan;0;0
11383;200572;95;0;0;0;0;.00nan;0;0
11383;195346;95;53;27;4;23;.852;3540000;0
11385;200065;93;0;0;0;0;.00nan;0;0
11385;196495;87;0;0;0;0;.00nan;0;0
11385;-1;87;73;32;2;30;.938;3600000;0
11385;197675;93;51;25;3;22;.880;3600000;0
11387;194632;102;0;0;0;0;.00nan;0;0
11387;205318;97;63;46;5;41;.891;3600000;0
11387;200549;102;96;23;0;23;1.000;3600000;0
11387;205824;97;0;0;0;0;.00nan;0;0
11389;192739;92;0;0;0;0;.00nan;0;0
11389;212343;96;87;31;1;30;.968;3600000;0
11389;196532;92;46;24;3;21;.875;3521000;0
11389;-1;96;0;0;0;0;.00nan;0;0
11391;205112;105;0;0;0;0;.00nan;0;0
11391;-1;98;0;0;0;0;.00nan;0;0
11391;-1;105;62;24;2;22;.917;3600000;0
11391;-1;98;64;35;3;32;.914;3600000;0
11393;194502;86;0;0;0;0;.00nan;0;0
11393;194542;88;65;19;2;17;.895;3600000;0
11393;210480;88;0;0;0;0;.00nan;0;0
11393;205799;86;68;35;3;32;.914;3567000;0
11395;197940;100;0;0;0;0;.00nan;0;0
11395;209796;107;78;31;2;29;.935;3600000;0
11395;212368;100;76;41;3;38;.927;3588000;0
11395;-1;107;0;0;0;0;.00nan;0;0
11397;209784;91;59;31;3;28;.903;3600000;0
11397;201888;90;38;38;6;32;.842;3600000;0
11397;-1;91;0;0;0;0;.00nan;0;0
11397;-1;90;0;0;0;0;.00nan;0;0
11399;192733;99;0;0;0;0;.00nan;0;0
11399;194531;99;45;18;3;15;.833;3600000;0
11399;194899;101;0;0;0;0;.00nan;0;0
11399;201739;101;64;43;4;39;.907;3561000;0
11401;196055;106;83;31;1;30;.968;3600000;0
11401;196525;94;0;0;0;0;.00nan;0;0
11401;-1;94;76;29;2;27;.931;3553000;0
11401;-1;106;0;0;0;0;.00nan;0;0
11403;210603;104;0;0;0;0;.00nan;0;0
11403;195330;89;50;36;5;31;.861;3581000;0
11403;201792;89;0;0;0;0;.00nan;0;0
11403;208300;104;59;23;3;20;.870;3600000;0
11405;209784;91;0;0;0;0;.00nan;0;0
11405;-1;98;85;38;2;36;.947;3600000;0
11405;-1;91;38;22;4;18;.818;3548000;0
11405;-1;98;0;0;0;0;.00nan;0;0
11407;205318;97;63;44;5;39;.886;3600000;0
11407;205824;97;0;0;0;0;.00nan;0;0
11407;212343;96;0;0;0;0;.00nan;0;0
11407;-1;96;78;26;1;25;.962;3600000;0
11409;192733;99;60;26;3;23;.885;3600000;0
11409;194531;99;0;0;0;0;.00nan;0;0
11409;194542;88;64;34;4;30;.882;3600000;0
11409;210480;88;0;0;0;0;.00nan;0;0
11411;192718;103;0;0;0;0;.00nan;0;0
11411;210428;103;80;27;1;26;.963;3600000;0
11411;196525;94;54;20;2;18;.900;3577000;0
11411;-1;94;0;0;0;0;.00nan;0;0
11413;195330;89;39;18;3;15;.833;1423000;0
11413;201792;89;40;30;5;25;.833;2177000;0
11413;201888;90;0;0;0;0;.00nan;0;0
11413;-1;90;64;10;1;9;.900;3600000;0
11415;209796;107;0;0;0;0;.00nan;0;0
11415;196495;87;9;22;7;15;.682;2525000;0
11415;-1;107;38;17;3;14;.824;3600000;0
11415;-1;87;63;17;1;16;.941;1075000;0
11417;192739;92;69;23;2;21;.913;3530000;0
11417;194899;101;100;32;0;32;1.000;3600000;0
11417;201739;101;0;0;0;0;.00nan;0;0
11417;196532;92;0;0;0;0;.00nan;0;0
11419;197940;100;57;39;5;34;.872;3600000;0
11419;200572;95;0;0;0;0;.00nan;0;0
11419;195346;95;76;21;1;20;.952;3600000;0
11419;212368;100;0;0;0;0;.00nan;0;0
11421;200065;93;63;24;3;21;.875;3600000;0
11421;194632;102;0;0;0;0;.00nan;0;0
11421;200549;102;48;29;4;25;.862;3600000;0
11421;197675;93;0;0;0;0;.00nan;0;0
11423;194502;86;79;33;3;30;.909;3600000;0
11423;205112;105;76;17;1;16;.941;3600000;0
11423;205799;86;0;0;0;0;.00nan;0;0
11423;-1;105;0;0;0;0;.00nan;0;0
11425;210603;104;23;24;5;19;.792;3900000;0
11425;196055;106;0;0;0;0;.00nan;0;0
11425;-1;106;61;41;5;36;.878;3900000;0
11425;208300;104;0;0;0;0;.00nan;0;0
11427;209796;107;29;28;6;22;.786;2101000;0
11427;210603;104;0;0;0;0;.00nan;0;0
11427;-1;107;16;14;5;9;.643;1499000;0
11427;208300;104;33;27;5;22;.815;3600000;0
11429;201888;90;80;29;2;27;.931;3600000;0
11429;196525;94;0;0;0;0;.00nan;0;0
11429;-1;94;60;26;3;23;.885;3562000;0
11429;-1;90;0;0;0;0;.00nan;0;0
11431;192718;103;90;26;1;25;.962;3600000;0
11431;192733;99;0;0;0;0;.00nan;0;0
11431;194531;99;56;32;4;28;.875;3600000;0
11431;210428;103;0;0;0;0;.00nan;0;0
11433;205112;105;0;0;0;0;.00nan;0;0
11433;-1;98;0;0;0;0;.00nan;0;0
11433;-1;105;66;37;3;34;.919;3600000;0
11433;-1;98;58;36;4;32;.889;3600000;0
11435;209784;91;65;28;3;25;.893;3900000;0
11435;196495;87;0;0;0;0;.00nan;0;0
11435;-1;91;0;0;0;0;.00nan;0;0
11435;-1;87;53;23;3;20;.870;3900000;0
11437;192739;92;0;0;0;0;.00nan;0;0
11437;194899;101;48;27;4;23;.852;3527000;0
11437;201739;101;0;0;0;0;.00nan;0;0
11437;196532;92;53;17;2;15;.882;3600000;0
11439;195330;89;73;32;4;28;.875;3548000;0
11439;201792;89;0;0;0;0;.00nan;0;0
11439;212343;96;75;37;3;34;.919;3600000;0
11439;-1;96;0;0;0;0;.00nan;0;0
11441;197940;100;0;0;0;0;.00nan;0;0
11441;200065;93;0;0;0;0;.00nan;0;0
11441;212368;100;54;27;3;24;.889;3574000;0
11441;197675;93;85;27;2;25;.926;3600000;0
11443;194502;86;0;0;0;0;.00nan;0;0
11443;205799;86;51;26;4;22;.846;3516000;0
11443;196055;106;98;41;2;39;.951;3600000;0
11443;-1;106;0;0;0;0;.00nan;0;0
11445;194542;88;87;35;1;34;.971;3600000;0
11445;194632;102;29;16;4;12;.750;3600000;0
11445;210480;88;0;0;0;0;.00nan;0;0
11445;200549;102;0;0;0;0;.00nan;0;0
11447;205318;97;0;0;0;0;.00nan;0;0
11447;200572;95;33;19;4;15;.789;3544000;0
11447;205824;97;80;40;3;37;.925;3600000;0
11447;195346;95;0;0;0;0;.00nan;0;0
1393;200572;95;70;20;1;19;.950;3600000;0
1393;195330;89;0;0;0;0;.00nan;0;0
1393;195346;95;0;0;0;0;.00nan;0;0
1393;201792;89;67;25;2;23;.920;3544000;0
1394;192739;92;43;24;4;20;.833;3600000;0
1394;200065;93;97;35;1;34;.971;3600000;0
1394;196532;92;0;0;0;0;.00nan;0;0
1394;197675;93;0;0;0;0;.00nan;0;0
1395;205318;97;93;38;2;36;.947;3600000;0
1395;205824;97;0;0;0;0;.00nan;0;0
1395;196495;87;13;19;6;13;.684;3122000;0
1395;-1;87;54;4;0;4;1.000;478000;0
1396;194542;88;60;29;3;26;.897;3581000;0
1396;210480;88;0;0;0;0;.00nan;0;0
1396;201888;90;0;0;0;0;.00nan;0;0
1396;-1;90;81;32;2;30;.938;3600000;0
1397;205112;105;0;0;0;0;.00nan;0;0
1397;194632;102;48;32;5;27;.844;3543000;0
1397;200549;102;0;0;0;0;.00nan;0;0
1397;-1;105;72;33;4;29;.879;3600000;0
1398;197940;100;85;18;0;18;1.000;3600000;0
1398;212368;100;0;0;0;0;.00nan;0;0
1398;-1;98;79;36;3;33;.917;3600000;0
1398;-1;98;0;0;0;0;.00nan;0;0
1399;209796;107;0;0;0;0;.00nan;0;0
1399;196055;106;89;39;2;37;.949;3600000;0
1399;-1;106;0;0;0;0;.00nan;0;0
1399;-1;107;100;29;0;29;1.000;3600000;0
1400;192718;103;0;0;0;0;.00nan;0;0
1400;210428;103;79;28;1;27;.964;3565000;0
1400;210603;104;0;0;0;0;.00nan;0;0
1400;208300;104;100;21;0;21;1.000;3600000;0
1401;200572;95;73;18;1;17;.944;3600000;0
1401;195330;89;0;0;0;0;.00nan;0;0
1401;195346;95;0;0;0;0;.00nan;0;0
1401;201792;89;74;51;5;46;.902;3600000;0
1402;192739;92;52;28;4;24;.857;3600000;0
1402;200065;93;86;44;3;41;.932;3600000;0
1402;196532;92;0;0;0;0;.00nan;0;0
1402;197675;93;0;0;0;0;.00nan;0;0
1403;205318;97;62;49;4;45;.918;3589000;0
1403;205824;97;0;0;0;0;.00nan;0;0
1403;196495;87;76;30;2;28;.933;3600000;0
1403;-1;87;0;0;0;0;.00nan;0;0
1404;194542;88;43;24;4;20;.833;2252000;0
1404;210480;88;66;17;1;16;.941;1348000;0
1404;201888;90;54;4;0;4;1.000;617000;0
1404;-1;90;34;34;6;28;.824;2983000;0
1405;205112;105;0;0;0;0;.00nan;0;0
1405;194632;102;73;26;2;24;.923;3591000;0
1405;200549;102;0;0;0;0;.00nan;0;0
1405;-1;105;90;29;1;28;.966;3600000;0
1406;197940;100;58;14;2;12;.857;3600000;0
1406;212368;100;0;0;0;0;.00nan;0;0
1406;-1;98;26;33;7;26;.788;3242000;0
1406;-1;98;49;2;0;2;1.000;358000;0
1407;209796;107;0;0;0;0;.00nan;0;0
1407;196055;106;28;23;6;17;.739;3347000;0
1407;-1;106;58;5;0;5;1.000;253000;0
1407;-1;107;65;29;3;26;.897;3600000;0
1408;192718;103;0;0;0;0;.00nan;0;0
1408;210428;103;59;42;5;37;.881;3600000;0
1408;210603;104;0;0;0;0;.00nan;0;0
1408;208300;104;59;22;2;20;.909;3600000;0
1409;200572;95;66;24;2;22;.917;3600000;0
1409;195330;89;94;43;3;40;.930;2701000;0
1409;195346;95;0;0;0;0;.00nan;0;0
1409;201792;89;29;13;4;9;.692;899000;0
1410;192739;92;62;32;4;28;.875;3600000;0
1410;200065;93;22;28;7;21;.750;3600000;0
1410;196532;92;0;0;0;0;.00nan;0;0
1410;197675;93;0;0;0;0;.00nan;0;0
1411;205318;97;51;37;5;32;.865;3600000;0
1411;205824;97;0;0;0;0;.00nan;0;0
1411;196495;87;80;23;1;22;.957;3600000;0
1411;-1;87;0;0;0;0;.00nan;0;0
1412;194542;88;49;17;2;15;.882;3545000;0
1412;210480;88;0;0;0;0;.00nan;0;0
1412;201888;90;0;0;0;0;.00nan;0;0
1412;-1;90;81;32;1;31;.969;3600000;0
1413;205112;105;0;0;0;0;.00nan;0;0
1413;194632;102;46;27;4;23;.852;3600000;0
1413;200549;102;0;0;0;0;.00nan;0;0
1413;-1;105;48;42;6;36;.857;3594000;0
1414;197940;100;64;32;3;29;.906;3616000;0
1414;212368;100;0;0;0;0;.00nan;0;0
1414;-1;98;69;35;4;31;.886;3616000;0
1414;-1;98;0;0;0;0;.00nan;0;0
1415;209796;107;0;0;0;0;.00nan;0;0
1415;196055;106;52;34;5;29;.853;3600000;0
1415;-1;106;0;0;0;0;.00nan;0;0
1415;-1;107;21;36;8;28;.778;3588000;0
1416;192718;103;0;0;0;0;.00nan;0;0
1416;210428;103;66;39;3;36;.923;3600000;0
1416;210603;104;0;0;0;0;.00nan;0;0
1416;208300;104;48;29;4;25;.862;3544000;0
1417;200572;95;71;35;4;31;.886;3600000;0
1417;195330;89;0;0;0;0;.00nan;0;0
1417;195346;95;0;0;0;0;.00nan;0;0
1417;201792;89;47;34;5;29;.853;3586000;0
1418;192739;92;53;29;4;25;.862;3600000;0
1418;200065;93;67;49;5;44;.898;3578000;0
1418;196532;92;0;0;0;0;.00nan;0;0
1418;197675;93;0;0;0;0;.00nan;0;0
1419;205318;97;60;27;3;24;.889;3597000;0
1419;205824;97;0;0;0;0;.00nan;0;0
1419;196495;87;71;26;2;24;.923;3600000;0
1419;-1;87;0;0;0;0;.00nan;0;0
1420;194542;88;76;46;3;43;.935;4889000;0
1420;210480;88;0;0;0;0;.00nan;0;0
1420;201888;90;0;0;0;0;.00nan;0;0
1420;-1;90;73;38;2;36;.947;4889000;0
1421;205112;105;0;0;0;0;.00nan;0;0
1421;194632;102;56;34;6;28;.824;3953000;0
1421;200549;102;0;0;0;0;.00nan;0;0
1421;-1;105;84;51;5;46;.902;3953000;0
1422;197940;100;44;18;4;14;.778;3572000;0
1422;212368;100;0;0;0;0;.00nan;0;0
1422;-1;98;62;29;3;26;.897;3600000;0
1422;-1;98;0;0;0;0;.00nan;0;0
1423;209796;107;0;0;0;0;.00nan;0;0
1423;196055;106;43;52;7;45;.865;3964000;0
1423;-1;106;0;0;0;0;.00nan;0;0
1423;-1;107;29;25;6;19;.760;3939000;0
1424;192718;103;0;0;0;0;.00nan;0;0
1424;210428;103;53;39;5;34;.872;3600000;0
1424;210603;104;0;0;0;0;.00nan;0;0
1424;208300;104;46;26;4;22;.846;3600000;0
1606;192739;92;49;25;4;21;.840;3600000;0
1606;200065;93;75;54;5;49;.907;3573000;0
1606;196532;92;0;0;0;0;.00nan;0;0
1606;197675;93;0;0;0;0;.00nan;0;0
1607;205318;97;76;24;1;23;.958;3551000;0
1607;205824;97;0;0;0;0;.00nan;0;0
1607;196495;87;100;33;0;33;1.000;3600000;0
1607;-1;87;0;0;0;0;.00nan;0;0
1608;194542;88;79;25;2;23;.920;3544000;0
1608;210480;88;0;0;0;0;.00nan;0;0
1608;201888;90;0;0;0;0;.00nan;0;0
1608;-1;90;82;31;1;30;.968;3600000;0
1609;205112;105;0;0;0;0;.00nan;0;0
1609;194632;102;50;22;3;19;.864;3724000;0
1609;200549;102;0;0;0;0;.00nan;0;0
1609;-1;105;60;35;4;31;.886;3724000;0
1610;197940;100;100;22;0;22;1.000;3600000;0
1610;212368;100;0;0;0;0;.00nan;0;0
1610;-1;98;69;36;4;32;.889;3600000;0
1610;-1;98;0;0;0;0;.00nan;0;0
1611;209796;107;0;0;0;0;.00nan;0;0
1611;196055;106;82;34;3;31;.912;3925000;0
1611;-1;106;0;0;0;0;.00nan;0;0
1611;-1;107;68;25;2;23;.920;3925000;0
1612;192718;103;0;0;0;0;.00nan;0;0
1612;210428;103;93;39;2;37;.949;3600000;0
1612;210603;104;0;0;0;0;.00nan;0;0
1612;208300;104;47;15;3;12;.800;3600000;0
1644;192739;92;53;36;5;31;.861;3558000;0
1644;200065;93;65;30;3;27;.900;3600000;0
1644;196532;92;0;0;0;0;.00nan;0;0
1644;197675;93;0;0;0;0;.00nan;0;0
1645;205112;105;0;0;0;0;.00nan;0;0
1645;194632;102;73;22;1;21;.955;3600000;0
1645;200549;102;0;0;0;0;.00nan;0;0
1645;-1;105;56;38;5;33;.868;3600000;0
1646;192718;103;0;0;0;0;.00nan;0;0
1646;210428;103;83;39;3;36;.923;3567000;0
1646;210603;104;0;0;0;0;.00nan;0;0
1646;208300;104;89;39;2;37;.949;3600000;0
1669;192739;92;28;30;6;24;.800;3545000;0
1669;200065;93;63;40;5;35;.875;3600000;0
1669;196532;92;0;0;0;0;.00nan;0;0
1669;197675;93;0;0;0;0;.00nan;0;0
1670;205112;105;0;0;0;0;.00nan;0;0
1670;194632;102;24;15;4;11;.733;3514000;0
1670;200549;102;0;0;0;0;.00nan;0;0
1670;-1;105;99;44;2;42;.955;3600000;0
1734;200065;93;88;60;5;55;.917;3600000;0
1734;200572;95;96;19;0;19;1.000;3600000;0
1734;195346;95;0;0;0;0;.00nan;0;0
1734;197675;93;0;0;0;0;.00nan;0;0
1735;201888;90;0;0;0;0;.00nan;0;0
1735;196495;87;64;23;2;21;.913;3558000;0
1735;-1;90;100;33;1;32;.970;3600000;0
1735;-1;87;0;0;0;0;.00nan;0;0
1736;197940;100;88;25;1;24;.960;3600000;0
1736;205112;105;0;0;0;0;.00nan;0;0
1736;212368;100;0;0;0;0;.00nan;0;0
1736;-1;105;65;33;3;30;.909;3573000;0
1737;209796;107;62;34;2;32;.941;3321000;0
1737;210603;104;0;0;0;0;.00nan;0;0
1737;-1;107;27;28;6;22;.786;2440000;0
1737;208300;104;42;57;7;50;.877;5761000;0
1738;200065;93;90;50;4;46;.920;3600000;0
1738;200572;95;59;12;1;11;.917;3600000;0
1738;195346;95;0;0;0;0;.00nan;0;0
1738;197675;93;0;0;0;0;.00nan;0;0
1739;201888;90;0;0;0;0;.00nan;0;0
1739;196495;87;57;28;3;25;.893;3600000;0
1739;-1;90;67;34;4;30;.882;3544000;0
1739;-1;87;0;0;0;0;.00nan;0;0
1740;197940;100;69;16;1;15;.938;3600000;0
1740;205112;105;0;0;0;0;.00nan;0;0
1740;212368;100;0;0;0;0;.00nan;0;0
1740;-1;105;57;31;3;28;.903;3516000;0
1741;209796;107;0;0;0;0;.00nan;0;0
1741;210603;104;0;0;0;0;.00nan;0;0
1741;-1;107;65;40;4;36;.900;3600000;0
1741;208300;104;86;29;1;28;.966;3600000;0
1742;200065;93;46;34;5;29;.853;3600000;0
1742;200572;95;68;17;1;16;.941;3600000;0
1742;195346;95;0;0;0;0;.00nan;0;0
1742;197675;93;0;0;0;0;.00nan;0;0
1743;201888;90;0;0;0;0;.00nan;0;0
1743;196495;87;79;33;2;31;.939;3600000;0
1743;-1;90;74;38;4;34;.895;3600000;0
1743;-1;87;0;0;0;0;.00nan;0;0
1744;197940;100;55;20;3;17;.850;3600000;0
1744;205112;105;0;0;0;0;.00nan;0;0
1744;212368;100;0;0;0;0;.00nan;0;0
1744;-1;105;57;41;6;35;.854;3600000;0
1745;209796;107;0;0;0;0;.00nan;0;0
1745;210603;104;0;0;0;0;.00nan;0;0
1745;-1;107;12;33;8;25;.758;3600000;0
1745;208300;104;70;27;2;25;.926;3600000;0
1746;200065;93;56;27;4;23;.852;2326000;0
1746;200572;95;34;18;4;14;.778;3600000;0
1746;195346;95;0;0;0;0;.00nan;0;0
1746;197675;93;47;6;1;5;.833;1263000;0
1747;201888;90;0;0;0;0;.00nan;0;0
1747;196495;87;32;26;5;21;.808;3524000;0
1747;-1;90;67;37;3;34;.919;3600000;0
1747;-1;87;0;0;0;0;.00nan;0;0
1748;197940;100;75;25;2;23;.920;3600000;0
1748;205112;105;0;0;0;0;.00nan;0;0
1748;212368;100;0;0;0;0;.00nan;0;0
1748;-1;105;45;36;6;30;.833;3600000;0
1749;209796;107;0;0;0;0;.00nan;0;0
1749;210603;104;0;0;0;0;.00nan;0;0
1749;-1;107;77;30;2;28;.933;3600000;0
1749;208300;104;34;29;5;24;.828;3600000;0
11448;208575;142;82;22;0;22;1.000;1848000;0
11448;201673;141;48;22;3;19;.864;3600000;0
11448;196456;142;51;28;5;23;.821;1752000;0
11448;197756;141;0;0;0;0;.00nan;0;0
11449;203276;139;59;43;6;37;.860;3600000;0
11449;192889;139;0;0;0;0;.00nan;0;0
11449;192895;143;74;20;1;19;.950;3600000;0
11449;194456;143;0;0;0;0;.00nan;0;0
11450;192847;144;0;0;0;0;.00nan;0;0
11450;189944;144;88;33;1;32;.970;3600000;0
11450;196445;140;0;0;0;0;.00nan;0;0
11450;196812;140;56;36;4;32;.889;3600000;0
11451;198081;133;0;0;0;0;.00nan;0;0
11451;199701;138;43;5;1;4;.800;263000;0
11451;202059;133;47;19;3;16;.842;3600000;0
11451;-1;138;51;32;4;28;.875;3302000;0
11452;194393;1340;0;0;0;0;.00nan;0;0
11452;195169;129;42;44;6;38;.864;3600000;0
11452;201666;1340;30;22;5;17;.773;3600000;0
11452;-1;129;0;0;0;0;.00nan;0;0
11453;196012;128;76;30;2;28;.933;3600000;0
11453;196287;132;56;28;3;25;.893;3592000;0
11453;196809;132;0;0;0;0;.00nan;0;0
11453;-1;128;0;0;0;0;.00nan;0;0
11454;203288;135;59;36;4;32;.889;3600000;0
11454;198091;136;96;21;0;21;1.000;3600000;0
11454;194197;135;0;0;0;0;.00nan;0;0
11454;201530;136;0;0;0;0;.00nan;0;0
11455;198091;136;0;0;0;0;.00nan;0;0
11455;199437;134;64;15;1;14;.933;3600000;0
11455;201530;136;88;44;3;41;.932;3564000;0
11455;-1;134;0;0;0;0;.00nan;0;0
11456;-1;130;79;35;2;33;.943;3600000;0
11456;-1;131;0;0;0;0;.00nan;0;0
11456;197759;130;0;0;0;0;.00nan;0;0
11456;-1;131;39;24;4;20;.833;3589000;0
11457;194264;137;65;30;3;27;.900;3600000;0
11457;196287;132;0;0;0;0;.00nan;0;0
11457;196809;132;49;38;5;33;.868;3600000;0
11457;-1;137;0;0;0;0;.00nan;0;0
11458;203276;139;57;35;4;31;.886;3600000;0
11458;192889;139;0;0;0;0;.00nan;0;0
11458;192895;143;52;23;3;20;.870;3600000;0
11458;194456;143;0;0;0;0;.00nan;0;0
11459;192847;144;0;0;0;0;.00nan;0;0
11459;189944;144;87;36;2;34;.944;3600000;0
11459;196445;140;81;40;3;37;.925;3568000;0
11459;196812;140;0;0;0;0;.00nan;0;0
11460;208575;142;0;0;0;0;.00nan;0;0
11460;201673;141;50;30;4;26;.867;3570000;0
11460;196456;142;58;18;2;16;.889;3600000;0
11460;197756;141;0;0;0;0;.00nan;0;0
11461;198081;133;0;0;0;0;.00nan;0;0
11461;199437;134;59;26;3;23;.885;3565000;0
11461;202059;133;87;28;1;27;.964;3600000;0
11461;-1;134;0;0;0;0;.00nan;0;0
11462;194264;137;65;30;4;26;.867;3600000;0
11462;196012;128;49;38;6;32;.842;3541000;0
11462;-1;137;0;0;0;0;.00nan;0;0
11462;-1;128;0;0;0;0;.00nan;0;0
11463;-1;130;0;0;0;0;.00nan;0;0
11463;-1;131;0;0;0;0;.00nan;0;0
11463;197759;130;73;55;5;50;.909;3533000;0
11463;-1;131;49;22;3;19;.864;3600000;0
11464;203288;135;89;33;1;32;.970;3545000;0
11464;194197;135;0;0;0;0;.00nan;0;0
11464;194393;1340;100;39;0;39;1.000;3600000;0
11464;201666;1340;0;0;0;0;.00nan;0;0
11465;199701;138;0;0;0;0;.00nan;0;0
11465;195169;129;42;30;5;25;.833;3528000;0
11465;-1;129;0;0;0;0;.00nan;0;0
11465;-1;138;71;39;4;35;.897;3600000;0
11466;192895;143;41;21;4;17;.810;3600000;0
11466;194456;143;0;0;0;0;.00nan;0;0
11466;201673;141;0;0;0;0;.00nan;0;0
11466;197756;141;53;40;6;34;.850;3560000;0
11467;203276;139;27;27;6;21;.778;3052000;0
11467;192889;139;44;4;1;3;.750;498000;0
11467;196445;140;64;26;3;23;.885;3195000;0
11467;196812;140;27;7;3;4;.571;405000;0
11468;198081;133;0;0;0;0;.00nan;0;0
11468;198091;136;0;0;0;0;.00nan;0;0
11468;201530;136;83;28;2;26;.929;3600000;0
11468;202059;133;39;32;5;27;.844;3600000;0
11469;194393;1340;49;19;3;16;.842;3600000;0
11469;201666;1340;0;0;0;0;.00nan;0;0
11469;-1;131;83;29;1;28;.966;3600000;0
11469;-1;131;0;0;0;0;.00nan;0;0
11470;194264;137;64;21;2;19;.905;3600000;0
11470;-1;130;61;29;3;26;.897;2477000;0
11470;-1;137;0;0;0;0;.00nan;0;0
11470;197759;130;34;21;4;17;.810;1123000;0
11471;203288;135;51;20;3;17;.850;3600000;0
11471;199701;138;0;0;0;0;.00nan;0;0
11471;194197;135;0;0;0;0;.00nan;0;0
11471;-1;138;71;43;4;39;.907;3551000;0
11472;195169;129;21;32;7;25;.781;3176000;0
11472;196287;132;0;0;0;0;.00nan;0;0
11472;196809;132;32;26;5;21;.808;3600000;0
11472;-1;129;53;3;0;3;1.000;408000;0
11473;199437;134;63;32;3;29;.906;3589000;0
11473;196012;128;0;0;0;0;.00nan;0;0
11473;-1;134;0;0;0;0;.00nan;0;0
11473;-1;128;84;32;2;30;.938;3600000;0
11474;198081;133;56;33;4;29;.879;3818000;0
11474;198091;136;0;0;0;0;.00nan;0;0
11474;201530;136;45;31;5;26;.839;3818000;0
11474;202059;133;0;0;0;0;.00nan;0;0
11475;194393;1340;77;14;0;14;1.000;3600000;0
11475;201666;1340;0;0;0;0;.00nan;0;0
11475;-1;130;89;47;2;45;.957;2753000;0
11475;197759;130;37;17;4;13;.765;847000;0
11476;203276;139;0;0;0;0;.00nan;0;0
11476;192847;144;0;0;0;0;.00nan;0;0
11476;192889;139;66;36;4;32;.889;3579000;0
11476;189944;144;67;28;3;25;.893;3600000;0
11477;208575;142;0;0;0;0;.00nan;0;0
11477;196445;140;0;0;0;0;.00nan;0;0
11477;196456;142;80;29;1;28;.966;3600000;0
11477;196812;140;48;25;4;21;.840;3600000;0
11478;192895;143;0;0;0;0;.00nan;0;0
11478;194456;143;31;12;3;9;.750;3553000;0
11478;201673;141;76;29;2;27;.931;3600000;0
11478;197756;141;0;0;0;0;.00nan;0;0
11479;194264;137;0;0;0;0;.00nan;0;0
11479;-1;137;85;26;1;25;.962;3600000;0
11479;-1;131;0;0;0;0;.00nan;0;0
11479;-1;131;63;28;3;25;.893;3596000;0
11480;192847;144;0;0;0;0;.00nan;0;0
11480;208575;142;94;43;2;41;.953;3600000;0
11480;189944;144;83;41;3;38;.927;3600000;0
11480;196456;142;0;0;0;0;.00nan;0;0
11481;195169;129;57;15;2;13;.867;3600000;0
11481;196287;132;55;36;5;31;.861;1984000;0
11481;196809;132;34;26;5;21;.808;1616000;0
11481;-1;129;0;0;0;0;.00nan;0;0
11482;203288;135;83;38;2;36;.947;3555000;0
11482;199437;134;84;30;1;29;.967;3600000;0
11482;194197;135;0;0;0;0;.00nan;0;0
11482;-1;134;0;0;0;0;.00nan;0;0
11483;199701;138;88;36;2;34;.944;3033000;0
11483;196012;128;59;22;2;20;.909;3600000;0
11483;-1;138;26;8;3;5;.625;567000;0
11483;-1;128;0;0;0;0;.00nan;0;0
11484;208575;142;0;0;0;0;.00nan;0;0
11484;196445;140;0;0;0;0;.00nan;0;0
11484;196456;142;69;23;1;22;.957;3600000;0
11484;196812;140;49;37;5;32;.865;3600000;0
11485;192847;144;0;0;0;0;.00nan;0;0
11485;192895;143;71;28;2;26;.929;3600000;0
11485;194456;143;0;0;0;0;.00nan;0;0
11485;189944;144;86;39;3;36;.923;3600000;0
11486;198081;133;46;27;4;23;.852;3600000;0
11486;196012;128;32;29;6;23;.793;3600000;0
11486;202059;133;0;0;0;0;.00nan;0;0
11486;-1;128;0;0;0;0;.00nan;0;0
11487;195169;129;0;0;0;0;.00nan;0;0
11487;-1;131;0;0;0;0;.00nan;0;0
11487;-1;129;43;25;4;21;.840;3600000;0
11487;-1;131;40;28;5;23;.821;3600000;0
11488;203288;135;0;0;0;0;.00nan;0;0
11488;198091;136;12;18;6;12;.667;2384000;0
11488;194197;135;60;23;2;21;.913;3600000;0
11488;201530;136;55;12;1;11;.917;1216000;0
11489;203276;139;63;38;4;34;.895;3900000;0
11489;192889;139;0;0;0;0;.00nan;0;0
11489;199701;138;0;0;0;0;.00nan;0;0
11489;-1;138;46;24;4;20;.833;3900000;0
11490;194393;1340;36;24;5;19;.792;3600000;0
11490;201666;1340;0;0;0;0;.00nan;0;0
11490;-1;131;45;38;6;32;.842;3551000;0
11490;-1;131;0;0;0;0;.00nan;0;0
11491;208575;142;74;35;2;33;.943;3569000;0
11491;201673;141;92;32;1;31;.969;3600000;0
11491;196456;142;0;0;0;0;.00nan;0;0
11491;197756;141;0;0;0;0;.00nan;0;0
11492;192895;143;66;30;3;27;.900;3600000;0
11492;194456;143;0;0;0;0;.00nan;0;0
11492;196012;128;46;37;5;32;.865;3514000;0
11492;-1;128;0;0;0;0;.00nan;0;0
11493;192847;144;0;0;0;0;.00nan;0;0
11493;199701;138;58;32;3;29;.906;3534000;0
11493;189944;144;79;26;1;25;.962;3600000;0
11493;-1;138;0;0;0;0;.00nan;0;0
11494;199437;134;0;0;0;0;.00nan;0;0
11494;-1;130;39;35;6;29;.829;3573000;0
11494;197759;130;0;0;0;0;.00nan;0;0
11494;-1;134;37;16;4;12;.750;3600000;0
11495;198091;136;0;0;0;0;.00nan;0;0
11495;201530;136;89;34;1;33;.971;3600000;0
11495;196445;140;0;0;0;0;.00nan;0;0
11495;196812;140;58;30;3;27;.900;3542000;0
11496;198081;133;0;0;0;0;.00nan;0;0
11496;196287;132;0;0;0;0;.00nan;0;0
11496;202059;133;46;25;4;21;.840;3600000;0
11496;196809;132;38;27;5;22;.815;3600000;0
11497;203288;135;73;27;2;25;.926;3600000;0
11497;194197;135;0;0;0;0;.00nan;0;0
11497;194264;137;17;21;6;15;.714;2950000;0
11497;-1;137;54;4;0;4;1.000;650000;0
11498;194393;1340;0;0;0;0;.00nan;0;0
11498;195169;129;46;34;5;29;.853;3600000;0
11498;201666;1340;78;23;1;22;.957;3600000;0
11498;-1;129;0;0;0;0;.00nan;0;0
11499;199437;134;99;26;0;26;1.000;3600000;0
11499;-1;130;0;0;0;0;.00nan;0;0
11499;197759;130;33;35;5;30;.857;3600000;0
11499;-1;134;0;0;0;0;.00nan;0;0
11500;203288;135;0;0;0;0;.00nan;0;0
11500;194197;135;50;27;3;24;.889;3600000;0
11500;196445;140;61;37;4;33;.892;3562000;0
11500;196812;140;0;0;0;0;.00nan;0;0
11501;194264;137;0;0;0;0;.00nan;0;0
11501;-1;137;54;25;4;21;.840;3600000;0
11501;-1;131;49;17;2;15;.882;1200000;0
11501;-1;131;38;35;6;29;.829;2400000;0
11502;192847;144;65;49;5;44;.898;3516000;0
11502;189944;144;0;0;0;0;.00nan;0;0
11502;196012;128;0;0;0;0;.00nan;0;0
11502;-1;128;67;26;3;23;.885;3600000;0
11503;203276;139;57;33;4;29;.879;3600000;0
11503;192889;139;0;0;0;0;.00nan;0;0
11503;201673;141;0;0;0;0;.00nan;0;0
11503;197756;141;58;11;1;10;.909;3600000;0
11504;198081;133;37;25;5;20;.800;3600000;0
11504;208575;142;0;0;0;0;.00nan;0;0
11504;196456;142;28;28;6;22;.786;3600000;0
11504;202059;133;0;0;0;0;.00nan;0;0
11505;192895;143;0;0;0;0;.00nan;0;0
11505;199701;138;0;0;0;0;.00nan;0;0
11505;194456;143;56;25;3;22;.880;3900000;0
11505;-1;138;78;45;3;42;.933;3900000;0
11506;198091;136;20;21;6;15;.714;2867000;0
11506;195169;129;47;25;4;21;.840;3600000;0
11506;201530;136;27;8;3;5;.625;733000;0
11506;-1;129;0;0;0;0;.00nan;0;0
11507;194393;1340;47;24;4;20;.833;3567000;0
11507;201666;1340;0;0;0;0;.00nan;0;0
11507;196287;132;81;28;1;27;.964;3600000;0
11507;196809;132;0;0;0;0;.00nan;0;0
11508;203276;139;0;0;0;0;.00nan;0;0
11508;192889;139;72;32;3;29;.906;3562000;0
11508;196012;128;52;20;2;18;.900;3600000;0
11508;-1;128;0;0;0;0;.00nan;0;0
11509;198081;133;0;0;0;0;.00nan;0;0
11509;196445;140;0;0;0;0;.00nan;0;0
11509;202059;133;62;22;3;19;.864;3600000;0
11509;196812;140;45;43;6;37;.860;3600000;0
11510;198091;136;0;0;0;0;.00nan;0;0
11510;195169;129;0;0;0;0;.00nan;0;0
11510;201530;136;100;47;1;46;.979;3600000;0
11510;-1;129;64;22;2;20;.909;3548000;0
11511;-1;130;75;27;2;25;.926;3600000;0
11511;-1;131;78;46;3;43;.935;3545000;0
11511;197759;130;0;0;0;0;.00nan;0;0
11511;-1;131;0;0;0;0;.00nan;0;0
11512;194264;137;69;36;3;33;.917;3588000;0
11512;196287;132;0;0;0;0;.00nan;0;0
11512;196809;132;92;35;1;34;.971;3600000;0
11512;-1;137;0;0;0;0;.00nan;0;0
11513;203276;139;81;51;4;47;.922;3900000;0
11513;192889;139;0;0;0;0;.00nan;0;0
11513;194393;1340;39;24;4;20;.833;3900000;0
11513;201666;1340;0;0;0;0;.00nan;0;0
11514;198091;136;59;26;3;23;.885;3564000;0
11514;192847;144;0;0;0;0;.00nan;0;0
11514;189944;144;99;34;1;33;.971;3600000;0
11514;201530;136;0;0;0;0;.00nan;0;0
11515;192895;143;49;35;5;30;.857;3600000;0
11515;194456;143;0;0;0;0;.00nan;0;0
11515;195169;129;72;24;1;23;.958;3600000;0
11515;-1;129;0;0;0;0;.00nan;0;0
11516;201673;141;77;23;2;21;.913;3900000;0
11516;196012;128;77;33;2;31;.939;3900000;0
11516;197756;141;0;0;0;0;.00nan;0;0
11516;-1;128;0;0;0;0;.00nan;0;0
11517;199437;134;51;29;4;25;.862;3596000;0
11517;196287;132;0;0;0;0;.00nan;0;0
11517;196809;132;64;20;2;18;.900;3600000;0
11517;-1;134;0;0;0;0;.00nan;0;0
11518;194393;1340;45;11;2;9;.818;3600000;0
11518;201666;1340;0;0;0;0;.00nan;0;0
11518;196445;140;0;0;0;0;.00nan;0;0
11518;196812;140;98;51;3;48;.941;3600000;0
11519;198081;133;68;27;2;25;.926;3600000;0
11519;208575;142;0;0;0;0;.00nan;0;0
11519;196456;142;67;30;4;26;.867;3573000;0
11519;202059;133;0;0;0;0;.00nan;0;0
11520;199437;134;66;46;4;42;.913;3600000;0
11520;194264;137;82;28;2;26;.929;3600000;0
11520;-1;137;0;0;0;0;.00nan;0;0
11520;-1;134;0;0;0;0;.00nan;0;0
11521;199701;138;0;0;0;0;.00nan;0;0
11521;195169;129;0;0;0;0;.00nan;0;0
11521;-1;129;51;30;4;26;.867;3559000;0
11521;-1;138;72;30;2;28;.933;3600000;0
11522;203288;135;59;26;3;23;.885;3551000;0
11522;192847;144;0;0;0;0;.00nan;0;0
11522;194197;135;0;0;0;0;.00nan;0;0
11522;189944;144;94;44;2;42;.955;3600000;0
11523;208575;142;36;36;6;30;.833;2988000;0
11523;194393;1340;24;8;4;4;.500;1018000;0
11523;201666;1340;64;7;0;7;1.000;2582000;0
11523;196456;142;57;6;0;6;1.000;566000;0
11524;201673;141;57;39;5;34;.872;3600000;0
11524;-1;130;0;0;0;0;.00nan;0;0
11524;197756;141;0;0;0;0;.00nan;0;0
11524;197759;130;88;34;2;32;.941;3600000;0
11525;198091;136;0;0;0;0;.00nan;0;0
11525;201530;136;92;41;2;39;.951;3551000;0
11525;196287;132;69;27;1;26;.963;3600000;0
11525;196809;132;0;0;0;0;.00nan;0;0
11526;203276;139;50;36;6;30;.833;2070000;0
11526;192889;139;67;15;1;14;.933;1530000;0
11526;196445;140;74;27;2;25;.926;3600000;0
11526;196812;140;0;0;0;0;.00nan;0;0
11527;192895;143;43;22;3;19;.864;3900000;0
11527;194456;143;0;0;0;0;.00nan;0;0
11527;-1;131;84;45;3;42;.933;3900000;0
11527;-1;131;0;0;0;0;.00nan;0;0
11528;203288;135;80;24;1;23;.958;3600000;0
11528;199437;134;95;44;2;42;.955;3600000;0
11528;194197;135;0;0;0;0;.00nan;0;0
11528;-1;134;0;0;0;0;.00nan;0;0
11529;198081;133;0;0;0;0;.00nan;0;0
11529;192847;144;0;0;0;0;.00nan;0;0
11529;189944;144;83;45;4;41;.911;3600000;0
11529;202059;133;88;14;0;14;1.000;3600000;0
11530;192895;143;0;0;0;0;.00nan;0;0
11530;194456;143;65;13;1;12;.923;3600000;0
11530;-1;130;97;57;3;54;.947;3566000;0
11530;197759;130;0;0;0;0;.00nan;0;0
11531;195169;129;55;34;4;30;.882;3569000;0
11531;196012;128;0;0;0;0;.00nan;0;0
11531;-1;129;0;0;0;0;.00nan;0;0
11531;-1;128;60;18;2;16;.889;3600000;0
11532;194264;137;77;21;1;20;.952;3600000;0
11532;196287;132;0;0;0;0;.00nan;0;0
11532;196809;132;59;32;4;28;.875;3600000;0
11532;-1;137;0;0;0;0;.00nan;0;0
11533;203276;139;77;30;1;29;.967;3600000;0
11533;208575;142;0;0;0;0;.00nan;0;0
11533;192889;139;0;0;0;0;.00nan;0;0
11533;196456;142;74;32;3;29;.906;3559000;0
11534;201673;141;0;0;0;0;.00nan;0;0
11534;-1;131;0;0;0;0;.00nan;0;0
11534;197756;141;74;23;2;21;.913;3600000;0
11534;-1;131;86;29;1;28;.966;3600000;0
11535;198091;136;49;26;4;22;.846;3532000;0
11535;199701;138;0;0;0;0;.00nan;0;0
11535;201530;136;0;0;0;0;.00nan;0;0
11535;-1;138;67;24;2;22;.917;3600000;0
11536;199437;134;54;34;4;30;.882;3600000;0
11536;196012;128;75;23;1;22;.957;3600000;0
11536;-1;134;0;0;0;0;.00nan;0;0
11536;-1;128;0;0;0;0;.00nan;0;0
11537;194264;137;70;12;0;12;1.000;1350000;0
11537;195169;129;80;37;3;34;.919;3600000;0
11537;-1;137;19;19;6;13;.684;2250000;0
11537;-1;129;0;0;0;0;.00nan;0;0
11538;208575;142;0;0;0;0;.00nan;0;0
11538;192895;143;65;25;2;23;.920;3552000;0
11538;194456;143;0;0;0;0;.00nan;0;0
11538;196456;142;74;26;1;25;.962;3600000;0
11539;196445;140;0;0;0;0;.00nan;0;0
11539;196812;140;54;31;4;27;.871;3580000;0
11539;-1;131;66;32;3;29;.906;3600000;0
11539;-1;131;0;0;0;0;.00nan;0;0
11540;199701;138;0;0;0;0;.00nan;0;0
11540;194393;1340;0;0;0;0;.00nan;0;0
11540;201666;1340;66;14;1;13;.929;3600000;0
11540;-1;138;83;46;3;43;.935;3542000;0
11541;203288;135;67;20;2;18;.900;3570000;0
11541;198081;133;0;0;0;0;.00nan;0;0
11541;194197;135;0;0;0;0;.00nan;0;0
11541;202059;133;94;35;1;34;.971;3600000;0
11542;192895;143;0;0;0;0;.00nan;0;0
11542;194456;143;47;12;2;10;.833;3900000;0
11542;-1;130;0;0;0;0;.00nan;0;0
11542;197759;130;78;42;2;40;.952;3900000;0
11543;192847;144;0;0;0;0;.00nan;0;0
11543;189944;144;77;25;2;23;.920;3600000;0
11543;-1;131;0;0;0;0;.00nan;0;0
11543;-1;131;73;42;4;38;.905;3515000;0
11544;198081;133;88;33;2;31;.939;3600000;0
11544;199437;134;59;23;3;20;.870;3600000;0
11544;202059;133;0;0;0;0;.00nan;0;0
11544;-1;134;0;0;0;0;.00nan;0;0
11545;198091;136;0;0;0;0;.00nan;0;0
11545;194264;137;79;40;4;36;.900;3900000;0
11545;201530;136;50;32;4;28;.875;3900000;0
11545;-1;137;0;0;0;0;.00nan;0;0
11546;195169;129;0;0;0;0;.00nan;0;0
11546;196287;132;0;0;0;0;.00nan;0;0
11546;196809;132;68;32;3;29;.906;3600000;0
11546;-1;129;39;22;4;18;.818;3554000;0
11547;194393;1340;78;28;1;27;.964;3600000;0
11547;201666;1340;0;0;0;0;.00nan;0;0
11547;196012;128;80;36;3;33;.917;3527000;0
11547;-1;128;0;0;0;0;.00nan;0;0
11548;208575;142;70;30;2;28;.933;3544000;0
11548;196445;140;0;0;0;0;.00nan;0;0
11548;196456;142;0;0;0;0;.00nan;0;0
11548;196812;140;90;28;1;27;.964;3600000;0
11549;199437;134;33;12;3;9;.750;870000;0
11549;199701;138;0;0;0;0;.00nan;0;0
11549;-1;134;10;19;6;13;.684;2730000;0
11549;-1;138;75;31;3;28;.903;3600000;0
11550;203288;135;0;0;0;0;.00nan;0;0
11550;194197;135;42;37;6;31;.838;3658000;0
11550;194264;137;0;0;0;0;.00nan;0;0
11550;-1;137;38;28;5;23;.821;3657000;0
11551;192847;144;58;19;2;17;.895;3600000;0
11551;189944;144;0;0;0;0;.00nan;0;0
11551;-1;130;78;47;3;44;.936;3546000;0
11551;197759;130;0;0;0;0;.00nan;0;0
11552;203276;139;82;34;2;32;.941;3552000;0
11552;192889;139;0;0;0;0;.00nan;0;0
11552;201673;141;75;20;1;19;.950;3600000;0
11552;197756;141;0;0;0;0;.00nan;0;0
11553;192895;143;55;26;4;22;.846;3600000;0
11553;194456;143;0;0;0;0;.00nan;0;0
11553;-1;131;91;30;1;29;.967;3600000;0
11553;-1;131;0;0;0;0;.00nan;0;0
11554;208575;142;0;0;0;0;.00nan;0;0
11554;201673;141;0;0;0;0;.00nan;0;0
11554;196456;142;56;34;4;30;.882;3745000;0
11554;197756;141;62;39;5;34;.872;3745000;0
11555;195169;129;80;28;1;27;.964;3600000;0
11555;196012;128;77;31;2;29;.935;3571000;0
11555;-1;129;0;0;0;0;.00nan;0;0
11555;-1;128;0;0;0;0;.00nan;0;0
11556;203276;139;0;0;0;0;.00nan;0;0
11556;192889;139;38;29;5;24;.828;3873000;0
11556;-1;130;59;10;0;10;1.000;638000;0
11556;197759;130;54;31;4;27;.871;3235000;0
11557;203288;135;71;42;4;38;.905;3900000;0
11557;198091;136;54;30;4;26;.867;3872000;0
11557;194197;135;0;0;0;0;.00nan;0;0
11557;201530;136;0;0;0;0;.00nan;0;0
11558;194393;1340;54;13;2;11;.846;3600000;0
11558;201666;1340;0;0;0;0;.00nan;0;0
11558;196287;132;43;30;5;25;.833;3600000;0
11558;196809;132;0;0;0;0;.00nan;0;0
11559;198081;133;47;19;3;16;.842;3600000;0
11559;199701;138;62;40;5;35;.875;3536000;0
11559;202059;133;0;0;0;0;.00nan;0;0
11559;-1;138;0;0;0;0;.00nan;0;0
11560;203276;139;63;46;5;41;.891;3564000;0
11560;192847;144;0;0;0;0;.00nan;0;0
11560;192889;139;0;0;0;0;.00nan;0;0
11560;189944;144;59;26;3;23;.885;3600000;0
11561;198091;136;0;0;0;0;.00nan;0;0
11561;199701;138;0;0;0;0;.00nan;0;0
11561;201530;136;68;30;2;28;.933;3600000;0
11561;-1;138;79;40;3;37;.925;3545000;0
11562;203288;135;67;32;3;29;.906;3870000;0
11562;198081;133;0;0;0;0;.00nan;0;0
11562;194197;135;0;0;0;0;.00nan;0;0
11562;202059;133;61;24;2;22;.917;3870000;0
11563;201673;141;47;27;5;22;.815;3600000;0
11563;196445;140;0;0;0;0;.00nan;0;0
11563;196812;140;95;40;2;38;.950;3600000;0
11563;197756;141;0;0;0;0;.00nan;0;0
11564;192895;143;53;29;4;25;.862;3600000;0
11564;194393;1340;57;24;3;21;.875;3600000;0
11564;194456;143;0;0;0;0;.00nan;0;0
11564;201666;1340;0;0;0;0;.00nan;0;0
11565;203276;139;40;30;5;25;.833;3600000;0
11565;192889;139;0;0;0;0;.00nan;0;0
11565;201673;141;0;0;0;0;.00nan;0;0
11565;197756;141;98;20;0;20;1.000;3600000;0
11566;208575;142;0;0;0;0;.00nan;0;0
11566;199437;134;91;44;3;41;.932;3600000;0
11566;196456;142;48;27;4;23;.852;3600000;0
11566;-1;134;0;0;0;0;.00nan;0;0
11567;192847;144;0;0;0;0;.00nan;0;0
11567;189944;144;89;38;2;36;.947;3600000;0
11567;196445;140;36;8;3;5;.625;263000;0
11567;196812;140;81;34;3;31;.912;3337000;0
11568;198081;133;84;35;2;33;.943;3548000;0
11568;198091;136;81;26;1;25;.962;3600000;0
11568;201530;136;0;0;0;0;.00nan;0;0
11568;202059;133;0;0;0;0;.00nan;0;0
11569;195169;129;82;31;1;30;.968;3600000;0
11569;-1;131;0;0;0;0;.00nan;0;0
11569;-1;129;0;0;0;0;.00nan;0;0
11569;-1;131;18;37;8;29;.784;3600000;0
11570;199701;138;0;0;0;0;.00nan;0;0
11570;194264;137;81;37;2;35;.946;3600000;0
11570;-1;137;0;0;0;0;.00nan;0;0
11570;-1;138;86;26;1;25;.962;3600000;0
11571;192895;143;0;0;0;0;.00nan;0;0
11571;194456;143;66;15;1;14;.933;3600000;0
11571;196287;132;39;10;2;8;.800;1249000;0
11571;196809;132;28;32;6;26;.813;2351000;0
11572;203288;135;70;43;4;39;.907;3600000;0
11572;194197;135;0;0;0;0;.00nan;0;0
11572;196012;128;94;23;0;23;1.000;3600000;0
11572;-1;128;0;0;0;0;.00nan;0;0
11573;192847;144;0;0;0;0;.00nan;0;0
11573;208575;142;90;31;1;30;.968;3600000;0
11573;189944;144;73;39;4;35;.897;3600000;0
11573;196456;142;0;0;0;0;.00nan;0;0
11574;198081;133;0;0;0;0;.00nan;0;0
11574;198091;136;0;0;0;0;.00nan;0;0
11574;201530;136;46;36;5;31;.861;3792000;0
11574;202059;133;67;35;4;31;.886;3816000;0
11575;195169;129;0;0;0;0;.00nan;0;0
11575;-1;130;34;35;6;29;.829;2148000;0
11575;197759;130;63;21;2;19;.905;1452000;0
11575;-1;129;66;19;2;17;.895;3600000;0
11576;192895;143;53;22;3;19;.864;3600000;0
11576;194456;143;0;0;0;0;.00nan;0;0
11576;196012;128;50;38;6;32;.842;2675000;0
11576;-1;128;37;9;2;7;.778;925000;0
11577;199701;138;0;0;0;0;.00nan;0;0
11577;194264;137;0;0;0;0;.00nan;0;0
11577;-1;137;65;15;1;14;.933;3600000;0
11577;-1;138;67;51;5;46;.902;3600000;0
11578;203288;135;0;0;0;0;.00nan;0;0
11578;194197;135;41;25;4;21;.840;3600000;0
11578;196287;132;87;29;1;28;.966;3600000;0
11578;196809;132;0;0;0;0;.00nan;0;0
11579;203276;139;0;0;0;0;.00nan;0;0
11579;192889;139;49;41;5;36;.878;3898000;0
11579;199437;134;64;35;4;31;.886;3898000;0
11579;-1;134;0;0;0;0;.00nan;0;0
11580;194393;1340;69;35;2;33;.943;3900000;0
11580;201666;1340;0;0;0;0;.00nan;0;0
11580;-1;131;67;25;2;23;.920;3900000;0
11580;-1;131;0;0;0;0;.00nan;0;0
11581;199437;134;78;43;4;39;.907;3600000;0
11581;201673;141;0;0;0;0;.00nan;0;0
11581;197756;141;34;30;5;25;.833;3567000;0
11581;-1;134;0;0;0;0;.00nan;0;0
11582;194393;1340;0;0;0;0;.00nan;0;0
11582;201666;1340;62;13;1;12;.923;3600000;0
11582;-1;130;0;0;0;0;.00nan;0;0
11582;197759;130;58;55;6;49;.891;3600000;0
11583;192847;144;0;0;0;0;.00nan;0;0
11583;208575;142;0;0;0;0;.00nan;0;0
11583;189944;144;76;27;2;25;.926;3600000;0
11583;196456;142;65;38;4;34;.895;3518000;0
11584;195169;129;96;20;0;20;1.000;3600000;0
11584;196445;140;0;0;0;0;.00nan;0;0
11584;196812;140;86;48;5;43;.896;3600000;0
11584;-1;129;0;0;0;0;.00nan;0;0
11585;203276;139;92;45;3;42;.933;3627000;0
11585;192889;139;0;0;0;0;.00nan;0;0
11585;-1;130;85;33;2;31;.939;3627000;0
11585;197759;130;0;0;0;0;.00nan;0;0
11586;198091;136;63;35;4;31;.886;3557000;0
11586;194264;137;45;11;2;9;.818;3600000;0
11586;201530;136;0;0;0;0;.00nan;0;0
11586;-1;137;0;0;0;0;.00nan;0;0
11587;203288;135;62;36;4;32;.889;3538000;0
11587;194197;135;0;0;0;0;.00nan;0;0
11587;196012;128;68;32;3;29;.906;3600000;0
11587;-1;128;0;0;0;0;.00nan;0;0
11588;192895;143;64;26;3;23;.885;3900000;0
11588;194456;143;0;0;0;0;.00nan;0;0
11588;196287;132;0;0;0;0;.00nan;0;0
11588;196809;132;91;51;3;48;.941;3900000;0
11589;203276;139;31;6;3;3;.500;1549000;0
11589;192889;139;25;25;6;19;.760;2051000;0
11589;-1;131;0;0;0;0;.00nan;0;0
11589;-1;131;85;29;1;28;.966;3600000;0
11590;198081;133;0;0;0;0;.00nan;0;0
11590;192847;144;33;28;5;23;.821;3600000;0
11590;189944;144;0;0;0;0;.00nan;0;0
11590;202059;133;67;30;2;28;.933;3600000;0
11591;208575;142;43;5;1;4;.800;722000;0
11591;201673;141;0;0;0;0;.00nan;0;0
11591;196456;142;3;26;8;18;.692;2878000;0
11591;197756;141;62;27;3;24;.889;3600000;0
11592;199437;134;77;35;3;32;.914;3600000;0
11592;194264;137;86;30;2;28;.933;3600000;0
11592;-1;137;0;0;0;0;.00nan;0;0
11592;-1;134;0;0;0;0;.00nan;0;0
11593;196445;140;0;0;0;0;.00nan;0;0
11593;196812;140;59;36;4;32;.889;3600000;0
11593;-1;131;54;23;3;20;.870;3600000;0
11593;-1;131;0;0;0;0;.00nan;0;0
11594;199701;138;38;14;3;11;.786;480000;0
11594;194393;1340;40;22;4;18;.818;3600000;0
11594;201666;1340;0;0;0;0;.00nan;0;0
11594;-1;138;38;43;7;36;.837;3120000;0
11595;198091;136;0;0;0;0;.00nan;0;0
11595;201530;136;52;31;4;27;.871;3550000;0
11595;196012;128;0;0;0;0;.00nan;0;0
11595;-1;128;67;33;3;30;.909;3600000;0
11596;208575;142;61;14;1;13;.929;3600000;0
11596;201673;141;68;25;2;23;.920;3581000;0
11596;196456;142;0;0;0;0;.00nan;0;0
11596;197756;141;0;0;0;0;.00nan;0;0
11597;203288;135;51;30;4;26;.867;3600000;0
11597;199701;138;66;43;5;38;.884;3598000;0
11597;194197;135;0;0;0;0;.00nan;0;0
11597;-1;138;0;0;0;0;.00nan;0;0
11598;203276;139;91;49;3;46;.939;3577000;0
11598;192889;139;0;0;0;0;.00nan;0;0
11598;195169;129;60;12;1;11;.917;3600000;0
11598;-1;129;0;0;0;0;.00nan;0;0
11599;196445;140;75;31;2;29;.935;3600000;0
11599;196812;140;0;0;0;0;.00nan;0;0
11599;-1;130;46;11;2;9;.818;2629000;0
11599;197759;130;12;11;5;6;.545;971000;0
11600;198091;136;79;36;3;33;.917;3600000;0
11600;201530;136;0;0;0;0;.00nan;0;0
11600;196012;128;27;14;4;10;.714;2114000;0
11600;-1;128;65;28;2;26;.929;1486000;0
11601;194264;137;0;0;0;0;.00nan;0;0
11601;194393;1340;0;0;0;0;.00nan;0;0
11601;201666;1340;54;19;3;16;.842;3600000;0
11601;-1;137;100;23;0;23;1.000;3600000;0
11602;192847;144;0;0;0;0;.00nan;0;0
11602;189944;144;90;35;3;32;.914;3600000;0
11602;196287;132;37;23;4;19;.826;3554000;0
11602;196809;132;0;0;0;0;.00nan;0;0
11603;198081;133;68;43;4;39;.907;3559000;0
11603;192895;143;0;0;0;0;.00nan;0;0
11603;194456;143;69;23;2;21;.913;3600000;0
11603;202059;133;0;0;0;0;.00nan;0;0
11604;201673;141;0;0;0;0;.00nan;0;0
11604;196287;132;0;0;0;0;.00nan;0;0
11604;196809;132;69;36;3;33;.917;3600000;0
11604;197756;141;49;29;5;24;.828;3600000;0
11605;203288;135;54;24;3;21;.875;3600000;0
11605;199437;134;81;34;2;32;.941;3600000;0
11605;194197;135;0;0;0;0;.00nan;0;0
11605;-1;134;0;0;0;0;.00nan;0;0
11606;199437;134;72;33;3;30;.909;3600000;0
11606;-1;131;0;0;0;0;.00nan;0;0
11606;-1;131;53;42;5;37;.881;3600000;0
11606;-1;134;0;0;0;0;.00nan;0;0
11607;203288;135;65;30;3;27;.900;3543000;0
11607;198091;136;0;0;0;0;.00nan;0;0
11607;194197;135;0;0;0;0;.00nan;0;0
11607;201530;136;70;28;2;26;.929;3600000;0
11608;198081;133;84;24;1;23;.958;3600000;0
11608;194393;1340;0;0;0;0;.00nan;0;0
11608;201666;1340;89;45;4;41;.911;3600000;0
11608;202059;133;0;0;0;0;.00nan;0;0
11609;203276;139;41;31;5;26;.839;3562000;0
11609;192889;139;0;0;0;0;.00nan;0;0
11609;196445;140;0;0;0;0;.00nan;0;0
11609;196812;140;52;31;4;27;.871;3600000;0
11610;192895;143;37;21;4;17;.810;3723000;0
11610;194264;137;0;0;0;0;.00nan;0;0
11610;194456;143;0;0;0;0;.00nan;0;0
11610;-1;137;67;34;3;31;.912;3723000;0
11611;192847;144;0;0;0;0;.00nan;0;0
11611;189944;144;39;36;7;29;.806;3600000;0
11611;201673;141;86;32;2;30;.938;3600000;0
11611;197756;141;0;0;0;0;.00nan;0;0
11612;198081;133;83;20;0;20;1.000;2434000;0
11612;202059;133;22;9;4;5;.556;1166000;0
11612;-1;131;23;24;6;18;.750;2547000;0
11612;-1;131;54;12;1;11;.917;1053000;0
11613;199437;134;77;34;2;32;.941;3600000;0
11613;195169;129;69;39;4;35;.897;3588000;0
11613;-1;129;0;0;0;0;.00nan;0;0
11613;-1;134;0;0;0;0;.00nan;0;0
11614;198091;136;0;0;0;0;.00nan;0;0
11614;194393;1340;63;45;5;40;.889;3600000;0
11614;201530;136;70;27;2;25;.926;3600000;0
11614;201666;1340;0;0;0;0;.00nan;0;0
11615;199701;138;42;19;3;16;.842;2602000;0
11615;196287;132;0;0;0;0;.00nan;0;0
11615;196809;132;57;42;5;37;.881;3600000;0
11615;-1;138;23;12;4;8;.667;994000;0
11616;203288;135;70;20;1;19;.950;3600000;0
11616;194197;135;0;0;0;0;.00nan;0;0
11616;-1;130;0;0;0;0;.00nan;0;0
11616;197759;130;47;35;5;30;.857;3600000;0
11617;208575;142;46;6;1;5;.833;516000;0
11617;196012;128;0;0;0;0;.00nan;0;0
11617;196456;142;35;29;6;23;.793;3084000;0
11617;-1;128;54;21;3;18;.857;3600000;0
11618;203288;135;0;0;0;0;.00nan;0;0
11618;194197;135;65;30;3;27;.900;3544000;0
11618;-1;130;74;34;2;32;.941;3600000;0
11618;197759;130;0;0;0;0;.00nan;0;0
11619;198081;133;0;0;0;0;.00nan;0;0
11619;202059;133;72;24;1;23;.958;3600000;0
11619;-1;131;0;0;0;0;.00nan;0;0
11619;-1;131;76;32;2;30;.938;3584000;0
11620;199437;134;96;38;1;37;.974;3600000;0
11620;195169;129;0;0;0;0;.00nan;0;0
11620;-1;129;43;24;4;20;.833;3600000;0
11620;-1;134;0;0;0;0;.00nan;0;0
11621;208575;142;28;29;6;23;.793;3178000;0
11621;199701;138;54;10;0;10;1.000;1031000;0
11621;196456;142;61;3;0;3;1.000;722000;0
11621;-1;138;39;30;6;24;.800;2869000;0
11622;194393;1340;0;0;0;0;.00nan;0;0
11622;201666;1340;93;19;0;19;1.000;3600000;0
11622;196012;128;74;39;4;35;.897;3600000;0
11622;-1;128;0;0;0;0;.00nan;0;0
11623;192847;144;0;0;0;0;.00nan;0;0
11623;194264;137;64;22;3;19;.864;3600000;0
11623;189944;144;98;41;2;39;.951;3600000;0
11623;-1;137;0;0;0;0;.00nan;0;0
11624;192847;144;68;39;3;36;.923;3600000;0
11624;192895;143;95;23;0;23;1.000;3600000;0
11624;194456;143;0;0;0;0;.00nan;0;0
11624;189944;144;0;0;0;0;.00nan;0;0
11625;201673;141;0;0;0;0;.00nan;0;0
11625;196445;140;0;0;0;0;.00nan;0;0
11625;196812;140;74;35;3;32;.914;3600000;0
11625;197756;141;30;15;4;11;.733;3588000;0
11626;195169;129;27;27;6;21;.778;3600000;0
11626;196012;128;0;0;0;0;.00nan;0;0
11626;-1;129;0;0;0;0;.00nan;0;0
11626;-1;128;75;23;1;22;.957;3600000;0
11627;208575;142;0;0;0;0;.00nan;0;0
11627;196287;132;0;0;0;0;.00nan;0;0
11627;196456;142;64;29;4;25;.862;3564000;0
11627;196809;132;67;23;2;21;.913;3600000;0
11628;203276;139;21;23;6;17;.739;2463000;0
11628;192889;139;64;10;0;10;1.000;1137000;0
11628;194264;137;0;0;0;0;.00nan;0;0
11628;-1;137;49;30;5;25;.833;3600000;0
11629;198091;136;44;16;3;13;.813;3600000;0
11629;201530;136;0;0;0;0;.00nan;0;0
11629;-1;130;0;0;0;0;.00nan;0;0
11629;197759;130;67;45;5;40;.889;3566000;0
11630;192895;143;61;24;3;21;.875;3560000;0
11630;194456;143;0;0;0;0;.00nan;0;0
11630;201673;141;87;29;1;28;.966;3600000;0
11630;197756;141;0;0;0;0;.00nan;0;0
11631;192895;143;0;0;0;0;.00nan;0;0
11631;194456;143;85;19;0;19;1.000;3600000;0
11631;196445;140;0;0;0;0;.00nan;0;0
11631;196812;140;75;41;4;37;.902;3600000;0
11632;203276;139;60;29;3;26;.897;3587000;0
11632;208575;142;0;0;0;0;.00nan;0;0
11632;192889;139;0;0;0;0;.00nan;0;0
11632;196456;142;82;24;1;23;.958;3600000;0
11633;198091;136;0;0;0;0;.00nan;0;0
11633;201530;136;71;33;4;29;.879;3600000;0
11633;201673;141;26;33;7;26;.788;2828000;0
11633;197756;141;60;8;0;8;1.000;772000;0
11634;198081;133;0;0;0;0;.00nan;0;0
11634;196287;132;0;0;0;0;.00nan;0;0
11634;202059;133;71;37;4;33;.892;3600000;0
11634;196809;132;74;28;1;27;.964;3600000;0
11635;203288;135;83;40;3;37;.925;3900000;0
11635;194197;135;0;0;0;0;.00nan;0;0
11635;195169;129;67;32;3;29;.906;3900000;0
11635;-1;129;0;0;0;0;.00nan;0;0
11636;192847;144;0;0;0;0;.00nan;0;0
11636;189944;144;70;27;3;24;.889;3600000;0
11636;196445;140;0;0;0;0;.00nan;0;0
11636;196812;140;48;29;5;24;.828;3593000;0
11637;199437;134;18;28;7;21;.750;2095000;0
11637;196287;132;65;18;1;17;.944;3600000;0
11637;196809;132;0;0;0;0;.00nan;0;0
11637;-1;134;41;16;3;13;.813;1505000;0
11638;194393;1340;0;0;0;0;.00nan;0;0
11638;201666;1340;72;19;1;18;.947;3600000;0
11638;-1;131;0;0;0;0;.00nan;0;0
11638;-1;131;59;24;3;21;.875;3540000;0
11639;196012;128;0;0;0;0;.00nan;0;0
11639;-1;130;0;0;0;0;.00nan;0;0
11639;197759;130;72;33;3;30;.909;3600000;0
11639;-1;128;65;38;4;34;.895;3571000;0
11640;199701;138;0;0;0;0;.00nan;0;0
11640;194264;137;44;25;4;21;.840;3583000;0
11640;-1;137;0;0;0;0;.00nan;0;0
11640;-1;138;75;29;2;27;.931;3600000;0
11641;203288;135;93;30;1;29;.967;3900000;0
11641;194197;135;0;0;0;0;.00nan;0;0
11641;201673;141;0;0;0;0;.00nan;0;0
11641;197756;141;85;32;1;31;.969;3900000;0
11642;198091;136;60;41;5;36;.878;3600000;0
11642;195169;129;75;30;2;28;.933;3600000;0
11642;201530;136;0;0;0;0;.00nan;0;0
11642;-1;129;0;0;0;0;.00nan;0;0
11643;194393;1340;72;25;2;23;.920;3900000;0
11643;201666;1340;0;0;0;0;.00nan;0;0
11643;-1;130;98;49;2;47;.959;3900000;0
11643;197759;130;0;0;0;0;.00nan;0;0
11644;199701;138;52;36;5;31;.861;3600000;0
11644;194264;137;0;0;0;0;.00nan;0;0
11644;-1;137;55;27;4;23;.852;3600000;0
11644;-1;138;0;0;0;0;.00nan;0;0
11645;199437;134;51;36;5;31;.861;3577000;0
11645;196287;132;0;0;0;0;.00nan;0;0
11645;196809;132;56;22;3;19;.864;3600000;0
11645;-1;134;0;0;0;0;.00nan;0;0
11646;192847;144;0;0;0;0;.00nan;0;0
11646;208575;142;0;0;0;0;.00nan;0;0
11646;189944;144;86;26;1;25;.962;3600000;0
11646;196456;142;75;29;2;27;.931;3550000;0
11647;203276;139;82;36;2;34;.944;3900000;0
11647;192889;139;0;0;0;0;.00nan;0;0
11647;192895;143;0;0;0;0;.00nan;0;0
11647;194456;143;71;22;2;20;.909;3900000;0
11648;192895;143;49;22;3;19;.864;3600000;0
11648;194456;143;0;0;0;0;.00nan;0;0
11648;196445;140;49;2;0;2;1.000;400000;0
11648;196812;140;50;35;5;30;.857;3178000;0
11649;198081;133;46;29;4;25;.862;3900000;0
11649;201673;141;51;25;4;21;.840;3900000;0
11649;202059;133;0;0;0;0;.00nan;0;0
11649;197756;141;0;0;0;0;.00nan;0;0
11650;198091;136;0;0;0;0;.00nan;0;0
11650;195169;129;0;0;0;0;.00nan;0;0
11650;201530;136;75;28;2;26;.929;3600000;0
11650;-1;129;37;28;5;23;.821;3600000;0
11651;196012;128;0;0;0;0;.00nan;0;0
11651;-1;131;83;31;1;30;.968;3600000;0
11651;-1;131;0;0;0;0;.00nan;0;0
11651;-1;128;64;26;2;24;.923;3589000;0
11652;199437;134;65;38;4;34;.895;3537000;0
11652;194393;1340;0;0;0;0;.00nan;0;0
11652;201666;1340;61;20;2;18;.900;3600000;0
11652;-1;134;0;0;0;0;.00nan;0;0
11653;198091;136;50;29;5;24;.828;3583000;0
11653;201530;136;0;0;0;0;.00nan;0;0
11653;196445;140;58;24;3;21;.875;3600000;0
11653;196812;140;0;0;0;0;.00nan;0;0
11654;198081;133;0;0;0;0;.00nan;0;0
11654;202059;133;64;37;4;33;.892;3600000;0
11654;-1;130;0;0;0;0;.00nan;0;0
11654;197759;130;56;55;7;48;.873;3600000;0
11655;203276;139;0;0;0;0;.00nan;0;0
11655;192889;139;67;28;3;25;.893;3628000;0
11655;196445;140;0;0;0;0;.00nan;0;0
11655;196812;140;77;32;2;30;.938;3628000;0
11656;198091;136;0;0;0;0;.00nan;0;0
11656;192847;144;0;0;0;0;.00nan;0;0
11656;189944;144;25;33;7;26;.788;3600000;0
11656;201530;136;43;25;5;20;.800;3600000;0
11657;203288;135;91;42;4;38;.905;3600000;0
11657;199437;134;27;40;8;32;.800;3600000;0
11657;194197;135;0;0;0;0;.00nan;0;0
11657;-1;134;0;0;0;0;.00nan;0;0
11658;195169;129;87;28;1;27;.964;3600000;0
11658;196287;132;0;0;0;0;.00nan;0;0
11658;196809;132;56;39;4;35;.897;3600000;0
11658;-1;129;0;0;0;0;.00nan;0;0
11659;194393;1340;0;0;0;0;.00nan;0;0
11659;201666;1340;38;29;5;24;.828;3600000;0
11659;196012;128;55;3;0;3;1.000;557000;0
11659;-1;128;47;33;6;27;.818;3043000;0
11660;203276;139;41;32;5;27;.844;3600000;0
11660;192889;139;0;0;0;0;.00nan;0;0
11660;-1;131;0;0;0;0;.00nan;0;0
11660;-1;131;61;34;4;30;.882;3600000;0
11661;208575;142;0;0;0;0;.00nan;0;0
11661;196456;142;48;20;3;17;.850;3600000;0
11661;-1;130;68;46;4;42;.913;3600000;0
11661;197759;130;0;0;0;0;.00nan;0;0
11662;192847;144;0;0;0;0;.00nan;0;0
11662;192895;143;0;0;0;0;.00nan;0;0
11662;194456;143;69;22;1;21;.955;3600000;0
11662;189944;144;82;36;3;33;.917;3571000;0
11663;199701;138;0;0;0;0;.00nan;0;0
11663;195169;129;0;0;0;0;.00nan;0;0
11663;-1;129;61;25;4;21;.840;3600000;0
11663;-1;138;82;55;5;50;.909;3572000;0
11664;198081;133;0;0;0;0;.00nan;0;0
11664;194264;137;26;35;7;28;.800;3600000;0
11664;202059;133;92;32;1;31;.969;3600000;0
11664;-1;137;0;0;0;0;.00nan;0;0
11665;203288;135;62;25;3;22;.880;3600000;0
11665;194197;135;0;0;0;0;.00nan;0;0
11665;196012;128;57;36;4;32;.889;3558000;0
11665;-1;128;0;0;0;0;.00nan;0;0
11666;199701;138;23;6;3;3;.500;372000;0
11666;196287;132;0;0;0;0;.00nan;0;0
11666;196809;132;54;29;4;25;.862;3600000;0
11666;-1;138;50;18;2;16;.889;3228000;0
11667;198091;136;84;47;3;44;.936;3574000;0
11667;192895;143;78;25;1;24;.960;3600000;0
11667;194456;143;0;0;0;0;.00nan;0;0
11667;201530;136;0;0;0;0;.00nan;0;0
11668;196445;140;0;0;0;0;.00nan;0;0
11668;196812;140;75;30;2;28;.933;3600000;0
11668;-1;130;0;0;0;0;.00nan;0;0
11668;197759;130;67;34;3;31;.912;3595000;0
11669;201673;141;57;33;5;28;.848;3300000;0
11669;-1;131;38;19;4;15;.789;3600000;0
11669;197756;141;50;1;0;1;1.000;300000;0
11669;-1;131;0;0;0;0;.00nan;0;0
11670;208575;142;0;0;0;0;.00nan;0;0
11670;196456;142;74;36;3;33;.917;3600000;0
11670;-1;131;0;0;0;0;.00nan;0;0
11670;-1;131;83;16;0;16;1.000;3600000;0
11671;201673;141;0;0;0;0;.00nan;0;0
11671;-1;130;51;49;7;42;.857;3600000;0
11671;197756;141;40;16;4;12;.750;3600000;0
11671;197759;130;0;0;0;0;.00nan;0;0
11672;196012;128;0;0;0;0;.00nan;0;0
11672;196287;132;0;0;0;0;.00nan;0;0
11672;196809;132;61;41;5;36;.878;3600000;0
11672;-1;128;41;23;4;19;.826;3600000;0
11673;203276;139;23;26;6;20;.769;1780000;0
11673;192847;144;0;0;0;0;.00nan;0;0
11673;192889;139;39;16;4;12;.750;1820000;0
11673;189944;144;92;36;2;34;.944;3600000;0
11674;203288;135;24;10;4;6;.600;981000;0
11674;198081;133;72;31;3;28;.903;3600000;0
11674;194197;135;28;22;5;17;.773;2619000;0
11674;202059;133;0;0;0;0;.00nan;0;0
11675;194264;137;0;0;0;0;.00nan;0;0
11675;194393;1340;0;0;0;0;.00nan;0;0
11675;201666;1340;43;20;4;16;.800;3557000;0
11675;-1;137;69;32;3;29;.906;3600000;0
11676;199437;134;85;27;1;26;.963;3600000;0
11676;199701;138;61;29;3;26;.897;3530000;0
11676;-1;134;0;0;0;0;.00nan;0;0
11676;-1;138;0;0;0;0;.00nan;0;0
11677;208575;142;64;25;2;23;.920;2453000;0
11677;192895;143;34;16;4;12;.750;3600000;0
11677;194456;143;0;0;0;0;.00nan;0;0
11677;196456;142;27;13;4;9;.692;1147000;0
11678;203288;135;1;18;8;10;.556;2220000;0
11678;198081;133;0;0;0;0;.00nan;0;0
11678;194197;135;41;26;4;22;.846;1380000;0
11678;202059;133;78;32;3;29;.906;3600000;0
11679;192847;144;0;0;0;0;.00nan;0;0
11679;189944;144;64;32;3;29;.906;3579000;0
11679;196012;128;0;0;0;0;.00nan;0;0
11679;-1;128;79;26;1;25;.962;3600000;0
11680;203276;139;0;0;0;0;.00nan;0;0
11680;192889;139;69;41;4;37;.902;3600000;0
11680;201673;141;77;33;2;31;.939;3600000;0
11680;197756;141;0;0;0;0;.00nan;0;0
11681;199701;138;0;0;0;0;.00nan;0;0
11681;194264;137;80;24;1;23;.958;3600000;0
11681;-1;137;0;0;0;0;.00nan;0;0
11681;-1;138;66;45;5;40;.889;3600000;0
11682;194393;1340;0;0;0;0;.00nan;0;0
11682;195169;129;54;38;5;33;.868;3543000;0
11682;201666;1340;52;29;4;25;.862;3600000;0
11682;-1;129;0;0;0;0;.00nan;0;0
11683;196287;132;0;0;0;0;.00nan;0;0
11683;196445;140;57;25;3;22;.880;3577000;0
11683;196809;132;65;23;2;21;.913;3600000;0
11683;196812;140;0;0;0;0;.00nan;0;0
11684;203288;135;52;30;4;26;.867;3600000;0
11684;208575;142;73;27;2;25;.926;3600000;0
11684;194197;135;0;0;0;0;.00nan;0;0
11684;196456;142;0;0;0;0;.00nan;0;0
11685;198091;136;0;0;0;0;.00nan;0;0
11685;201530;136;47;25;4;21;.840;3600000;0
11685;196012;128;40;9;2;7;.778;988000;0
11685;-1;128;18;22;6;16;.727;2612000;0
11686;198081;133;24;30;7;23;.767;3546000;0
11686;195169;129;0;0;0;0;.00nan;0;0
11686;202059;133;0;0;0;0;.00nan;0;0
11686;-1;129;46;36;6;30;.833;3600000;0
11687;192847;144;46;20;3;17;.850;3585000;0
11687;189944;144;0;0;0;0;.00nan;0;0
11687;-1;130;0;0;0;0;.00nan;0;0
11687;197759;130;68;17;1;16;.941;3600000;0
11688;194264;137;0;0;0;0;.00nan;0;0
11688;196445;140;0;0;0;0;.00nan;0;0
11688;196812;140;86;33;2;31;.939;3795000;0
11688;-1;137;73;20;1;19;.950;3795000;0
11689;194393;1340;48;34;5;29;.853;3559000;0
11689;201666;1340;0;0;0;0;.00nan;0;0
11689;196287;132;0;0;0;0;.00nan;0;0
11689;196809;132;77;36;4;32;.889;3600000;0
11690;199437;134;80;14;0;14;1.000;3600000;0
11690;196445;140;60;37;5;32;.865;3600000;0
11690;196812;140;0;0;0;0;.00nan;0;0
11690;-1;134;0;0;0;0;.00nan;0;0
11691;198091;136;97;25;0;25;1.000;3600000;0
11691;201530;136;0;0;0;0;.00nan;0;0
11691;196012;128;56;42;6;36;.857;3600000;0
11691;-1;128;0;0;0;0;.00nan;0;0
11692;198081;133;0;0;0;0;.00nan;0;0
11692;195169;129;65;26;2;24;.923;3600000;0
11692;202059;133;60;27;4;23;.852;3567000;0
11692;-1;129;0;0;0;0;.00nan;0;0
11693;199701;138;0;0;0;0;.00nan;0;0
11693;-1;130;28;35;7;28;.800;3600000;0
11693;197759;130;0;0;0;0;.00nan;0;0
11693;-1;138;81;34;3;31;.912;3600000;0
11694;194264;137;79;38;3;35;.921;3900000;0
11694;196287;132;81;41;3;38;.927;3900000;0
11694;196809;132;0;0;0;0;.00nan;0;0
11694;-1;137;0;0;0;0;.00nan;0;0
11695;203276;139;55;25;3;22;.880;3900000;0
11695;203288;135;86;46;3;43;.935;3900000;0
11695;192889;139;0;0;0;0;.00nan;0;0
11695;194197;135;0;0;0;0;.00nan;0;0
11696;192895;143;69;33;3;30;.909;3900000;0
11696;194456;143;0;0;0;0;.00nan;0;0
11696;201673;141;0;0;0;0;.00nan;0;0
11696;197756;141;76;30;3;27;.900;3900000;0
11697;192847;144;59;11;1;10;.909;1296000;0
11697;189944;144;7;16;6;10;.625;2304000;0
11697;-1;131;0;0;0;0;.00nan;0;0
11697;-1;131;64;17;1;16;.941;3600000;0
11698;208575;142;0;0;0;0;.00nan;0;0
11698;192895;143;0;0;0;0;.00nan;0;0
11698;194456;143;34;19;4;15;.789;3592000;0
11698;196456;142;83;39;3;36;.923;3600000;0
11699;203288;135;0;0;0;0;.00nan;0;0
11699;194197;135;62;38;4;34;.895;3600000;0
11699;201673;141;58;15;1;14;.933;3600000;0
11699;197756;141;0;0;0;0;.00nan;0;0
11700;199701;138;43;38;6;32;.842;3600000;0
11700;-1;131;77;28;2;26;.929;3600000;0
11700;-1;131;0;0;0;0;.00nan;0;0
11700;-1;138;0;0;0;0;.00nan;0;0
11701;199437;134;85;47;3;44;.936;3543000;0
11701;194393;1340;0;0;0;0;.00nan;0;0
11701;201666;1340;53;12;2;10;.833;3600000;0
11701;-1;134;0;0;0;0;.00nan;0;0
11702;192895;143;65;21;2;19;.905;3600000;0
11702;194456;143;0;0;0;0;.00nan;0;0
11702;196445;140;0;0;0;0;.00nan;0;0
11702;196812;140;66;34;4;30;.882;3528000;0
11703;194393;1340;0;0;0;0;.00nan;0;0
11703;201666;1340;53;23;3;20;.870;3900000;0
11703;201673;141;90;41;3;38;.927;3900000;0
11703;197756;141;0;0;0;0;.00nan;0;0
11704;208575;142;0;0;0;0;.00nan;0;0
11704;199437;134;0;0;0;0;.00nan;0;0
11704;196456;142;83;26;1;25;.962;3600000;0
11704;-1;134;58;39;5;34;.872;3600000;0
11705;199701;138;0;0;0;0;.00nan;0;0
11705;-1;130;0;0;0;0;.00nan;0;0
11705;197759;130;58;21;3;18;.857;3600000;0
11705;-1;138;55;33;4;29;.879;3600000;0
11706;192847;144;0;0;0;0;.00nan;0;0
11706;194393;1340;25;24;6;18;.750;3006000;0
11706;189944;144;54;31;5;26;.839;3600000;0
11706;201666;1340;44;5;1;4;.800;531000;0
11707;195169;129;60;25;3;22;.880;3600000;0
11707;196445;140;0;0;0;0;.00nan;0;0
11707;196812;140;48;44;6;38;.864;3600000;0
11707;-1;129;0;0;0;0;.00nan;0;0
11708;198081;133;71;18;1;17;.944;3600000;0
11708;194264;137;65;33;3;30;.909;3516000;0
11708;202059;133;0;0;0;0;.00nan;0;0
11708;-1;137;0;0;0;0;.00nan;0;0
11709;203276;139;60;35;4;31;.886;3600000;0
11709;192889;139;0;0;0;0;.00nan;0;0
11709;196287;132;0;0;0;0;.00nan;0;0
11709;196809;132;25;26;6;20;.769;3560000;0
11710;192847;144;100;34;0;34;1.000;3600000;0
11710;195169;129;0;0;0;0;.00nan;0;0
11710;189944;144;0;0;0;0;.00nan;0;0
11710;-1;129;75;25;1;24;.960;3553000;0
11711;201673;141;0;0;0;0;.00nan;0;0
11711;196445;140;23;36;7;29;.806;3334000;0
11711;196812;140;52;3;0;3;1.000;266000;0
11711;197756;141;18;26;6;20;.769;3600000;0
11712;203276;139;49;7;1;6;.857;919000;0
11712;192889;139;5;21;7;14;.667;2681000;0
11712;199437;134;53;23;3;20;.870;3600000;0
11712;-1;134;0;0;0;0;.00nan;0;0
11713;198091;136;0;0;0;0;.00nan;0;0
11713;208575;142;0;0;0;0;.00nan;0;0
11713;201530;136;49;17;3;14;.824;3544000;0
11713;196456;142;79;29;2;27;.931;3600000;0
11714;196287;132;69;14;1;13;.929;3600000;0
11714;196809;132;0;0;0;0;.00nan;0;0
11714;-1;130;0;0;0;0;.00nan;0;0
11714;197759;130;79;49;5;44;.898;3600000;0
11715;196012;128;65;32;3;29;.906;3900000;0
11715;-1;131;0;0;0;0;.00nan;0;0
11715;-1;131;72;30;3;27;.900;3900000;0
11715;-1;128;0;0;0;0;.00nan;0;0
11716;203288;135;65;36;3;33;.917;3574000;0
11716;208575;142;69;18;1;17;.944;3600000;0
11716;194197;135;0;0;0;0;.00nan;0;0
11716;196456;142;0;0;0;0;.00nan;0;0
11717;198081;133;0;0;0;0;.00nan;0;0
11717;199437;134;0;0;0;0;.00nan;0;0
11717;202059;133;31;35;7;28;.800;3744000;0
11717;-1;134;53;40;6;34;.850;3745000;0
11718;196012;128;0;0;0;0;.00nan;0;0
11718;-1;130;57;38;5;33;.868;3581000;0
11718;197759;130;0;0;0;0;.00nan;0;0
11718;-1;128;53;21;3;18;.857;3600000;0
11719;203276;139;46;39;5;34;.872;3600000;0
11719;192889;139;0;0;0;0;.00nan;0;0
11719;194264;137;45;22;4;18;.818;3600000;0
11719;-1;137;0;0;0;0;.00nan;0;0
11720;199701;138;0;0;0;0;.00nan;0;0
11720;-1;131;32;25;5;20;.800;3600000;0
11720;-1;131;0;0;0;0;.00nan;0;0
11720;-1;138;65;27;2;25;.926;3600000;0
11721;192895;143;56;28;3;25;.893;3535000;0
11721;194393;1340;0;0;0;0;.00nan;0;0
11721;194456;143;0;0;0;0;.00nan;0;0
11721;201666;1340;55;17;2;15;.882;3600000;0
11722;192847;144;41;39;5;34;.872;3600000;0
11722;189944;144;0;0;0;0;.00nan;0;0
11722;201673;141;88;18;0;18;1.000;3600000;0
11722;197756;141;0;0;0;0;.00nan;0;0
11723;192895;143;0;0;0;0;.00nan;0;0
11723;194456;143;48;27;4;23;.852;3600000;0
11723;195169;129;41;31;5;26;.839;3590000;0
11723;-1;129;0;0;0;0;.00nan;0;0
11724;199701;138;71;45;4;41;.911;3600000;0
11724;196287;132;0;0;0;0;.00nan;0;0
11724;196809;132;95;33;1;32;.970;3600000;0
11724;-1;138;0;0;0;0;.00nan;0;0
11725;203288;135;0;0;0;0;.00nan;0;0
11725;198091;136;0;0;0;0;.00nan;0;0
11725;194197;135;48;31;5;26;.839;3583000;0
11725;201530;136;47;26;4;22;.846;3600000;0
11726;194264;137;0;0;0;0;.00nan;0;0
11726;-1;137;76;10;0;10;1.000;3600000;0
11726;-1;131;0;0;0;0;.00nan;0;0
11726;-1;131;83;44;3;41;.932;3600000;0
11727;192847;144;0;0;0;0;.00nan;0;0
11727;208575;142;0;0;0;0;.00nan;0;0
11727;189944;144;67;23;3;20;.870;3600000;0
11727;196456;142;40;31;5;26;.839;3516000;0
11728;-1;130;52;24;3;21;.875;2739000;0
11728;-1;131;72;18;1;17;.944;3600000;0
11728;197759;130;15;7;4;3;.429;861000;0
11728;-1;131;0;0;0;0;.00nan;0;0
11729;198081;133;0;0;0;0;.00nan;0;0
11729;194264;137;0;0;0;0;.00nan;0;0
11729;202059;133;60;34;4;30;.882;3563000;0
11729;-1;137;87;39;3;36;.923;3600000;0
11730;203288;135;73;36;3;33;.917;3549000;0
11730;199437;134;54;17;2;15;.882;3600000;0
11730;194197;135;0;0;0;0;.00nan;0;0
11730;-1;134;0;0;0;0;.00nan;0;0
11731;203276;139;18;9;4;5;.556;795000;0
11731;208575;142;0;0;0;0;.00nan;0;0
11731;192889;139;81;32;2;30;.938;2805000;0
11731;196456;142;48;19;3;16;.842;3600000;0
11732;192847;144;0;0;0;0;.00nan;0;0
11732;189944;144;73;44;5;39;.886;3600000;0
11732;201673;141;54;20;3;17;.850;3600000;0
11732;197756;141;0;0;0;0;.00nan;0;0
11733;192895;143;0;0;0;0;.00nan;0;0
11733;194456;143;80;24;1;23;.958;3600000;0
11733;196445;140;0;0;0;0;.00nan;0;0
11733;196812;140;70;45;5;40;.889;3600000;0
11734;198091;136;66;31;3;28;.903;3530000;0
11734;199437;134;76;23;1;22;.957;3600000;0
11734;201530;136;0;0;0;0;.00nan;0;0
11734;-1;134;0;0;0;0;.00nan;0;0
11735;196287;132;0;0;0;0;.00nan;0;0
11735;196809;132;53;22;3;19;.864;3537000;0
11735;-1;131;0;0;0;0;.00nan;0;0
11735;-1;131;95;30;1;29;.967;3600000;0
11736;203288;135;55;35;5;30;.857;3600000;0
11736;194197;135;0;0;0;0;.00nan;0;0
11736;195169;129;63;23;2;21;.913;3600000;0
11736;-1;129;0;0;0;0;.00nan;0;0
11737;196012;128;61;23;4;19;.826;3600000;0
11737;-1;130;0;0;0;0;.00nan;0;0
11737;197759;130;65;48;6;42;.875;3558000;0
11737;-1;128;0;0;0;0;.00nan;0;0
11738;198081;133;71;54;7;47;.870;3600000;0
11738;194393;1340;74;29;2;27;.931;3600000;0
11738;201666;1340;0;0;0;0;.00nan;0;0
11738;202059;133;0;0;0;0;.00nan;0;0
11739;199701;138;0;0;0;0;.00nan;0;0
11739;194264;137;70;25;2;23;.920;3600000;0
11739;-1;137;0;0;0;0;.00nan;0;0
11739;-1;138;75;49;5;44;.898;3600000;0
11740;198091;136;0;0;0;0;.00nan;0;0
11740;199437;134;0;0;0;0;.00nan;0;0
11740;201530;136;63;21;2;19;.905;3600000;0
11740;-1;134;54;25;3;22;.880;3549000;0
11741;194264;137;0;0;0;0;.00nan;0;0
11741;195169;129;0;0;0;0;.00nan;0;0
11741;-1;137;76;27;2;25;.926;3600000;0
11741;-1;129;61;34;4;30;.882;3540000;0
11742;196287;132;62;43;5;38;.884;3520000;0
11742;196809;132;0;0;0;0;.00nan;0;0
11742;-1;130;61;34;3;31;.912;3600000;0
11742;197759;130;0;0;0;0;.00nan;0;0
11743;203288;135;0;0;0;0;.00nan;0;0
11743;194197;135;84;49;4;45;.918;3597000;0
11743;194393;1340;0;0;0;0;.00nan;0;0
11743;201666;1340;83;36;2;34;.944;3600000;0
11744;198081;133;0;0;0;0;.00nan;0;0
11744;199701;138;81;53;5;48;.906;3600000;0
11744;202059;133;68;18;1;17;.944;3600000;0
11744;-1;138;0;0;0;0;.00nan;0;0
11745;203276;139;23;11;4;7;.636;856000;0
11745;192889;139;54;27;3;24;.889;2744000;0
11745;192895;143;60;25;4;21;.840;3600000;0
11745;194456;143;0;0;0;0;.00nan;0;0
11746;208575;142;73;28;2;26;.929;3600000;0
11746;196445;140;42;19;4;15;.789;3591000;0
11746;196456;142;0;0;0;0;.00nan;0;0
11746;196812;140;0;0;0;0;.00nan;0;0
11747;192847;144;78;30;1;29;.967;3543000;0
11747;189944;144;0;0;0;0;.00nan;0;0
11747;201673;141;0;0;0;0;.00nan;0;0
11747;197756;141;89;21;0;21;1.000;3600000;0
11748;196012;128;0;0;0;0;.00nan;0;0
11748;-1;131;67;41;4;37;.902;3900000;0
11748;-1;131;0;0;0;0;.00nan;0;0
11748;-1;128;53;24;4;20;.833;3900000;0
11749;203276;139;82;37;2;35;.946;3900000;0
11749;208575;142;0;0;0;0;.00nan;0;0
11749;192889;139;0;0;0;0;.00nan;0;0
11749;196456;142;63;26;2;24;.923;3900000;0
11750;192895;143;86;39;3;36;.923;3600000;0
11750;194456;143;0;0;0;0;.00nan;0;0
11750;201673;141;55;14;1;13;.929;1599000;0
11750;197756;141;42;22;4;18;.818;1973000;0
11751;192847;144;0;0;0;0;.00nan;0;0
11751;189944;144;71;32;2;30;.938;3600000;0
11751;196445;140;0;0;0;0;.00nan;0;0
11751;196812;140;50;31;4;27;.871;3534000;0
11752;199437;134;50;34;5;29;.853;3600000;0
11752;196287;132;0;0;0;0;.00nan;0;0
11752;196809;132;80;25;1;24;.960;3600000;0
11752;-1;134;0;0;0;0;.00nan;0;0
11753;198081;133;0;0;0;0;.00nan;0;0
11753;199701;138;0;0;0;0;.00nan;0;0
11753;202059;133;65;20;2;18;.900;3600000;0
11753;-1;138;84;43;3;40;.930;3567000;0
11754;195169;129;81;26;1;25;.962;3600000;0
11754;-1;131;0;0;0;0;.00nan;0;0
11754;-1;129;0;0;0;0;.00nan;0;0
11754;-1;131;68;27;2;25;.926;3564000;0
11755;194264;137;95;19;0;19;1.000;3600000;0
11755;201530;136;38;35;7;28;.800;3600000;0
11755;-1;137;0;0;0;0;.00nan;0;0
11755;-1;136;0;0;0;0;.00nan;0;0
11756;203288;135;78;30;3;27;.900;3600000;0
11756;194197;135;0;0;0;0;.00nan;0;0
11756;194393;1340;25;6;3;3;.500;497000;0
11756;201666;1340;78;22;1;21;.955;3049000;0
11757;208575;142;100;33;0;33;1.000;3600000;0
11757;196445;140;55;25;3;22;.880;3600000;0
11757;196456;142;0;0;0;0;.00nan;0;0
11757;196812;140;0;0;0;0;.00nan;0;0
11758;194264;137;88;28;1;27;.964;3626000;0
11758;195169;129;72;29;2;27;.931;3626000;0
11758;-1;137;0;0;0;0;.00nan;0;0
11758;-1;129;0;0;0;0;.00nan;0;0
11759;192847;144;0;0;0;0;.00nan;0;0
11759;192895;143;0;0;0;0;.00nan;0;0
11759;194456;143;46;19;4;15;.789;3900000;0
11759;189944;144;90;45;4;41;.911;3900000;0
11760;203288;135;66;33;3;30;.909;3762000;0
11760;194197;135;0;0;0;0;.00nan;0;0
11760;201530;136;58;29;4;25;.862;3762000;0
11760;-1;136;0;0;0;0;.00nan;0;0
11761;198081;133;67;40;5;35;.875;3600000;0
11761;199437;134;23;22;6;16;.727;1956000;0
11761;202059;133;0;0;0;0;.00nan;0;0
11761;-1;134;71;17;0;17;1.000;1603000;0
11762;-1;130;0;0;0;0;.00nan;0;0
11762;-1;131;21;16;5;11;.688;2026000;0
11762;197759;130;65;31;3;28;.903;3600000;0
11762;-1;131;34;13;3;10;.769;1574000;0
11763;194393;1340;0;0;0;0;.00nan;0;0
11763;201666;1340;60;23;3;20;.870;3600000;0
11763;196012;128;55;17;2;15;.882;1387000;0
11763;-1;128;9;18;6;12;.667;2213000;0
11764;199701;138;0;0;0;0;.00nan;0;0
11764;196287;132;0;0;0;0;.00nan;0;0
11764;196809;132;85;33;2;31;.939;3600000;0
11764;-1;138;60;35;4;31;.886;3535000;0
11765;203276;139;0;0;0;0;.00nan;0;0
11765;192889;139;67;33;3;30;.909;3600000;0
11765;201673;141;58;15;2;13;.867;3600000;0
11765;197756;141;0;0;0;0;.00nan;0;0
11766;192847;144;38;39;6;33;.846;3600000;0
11766;192895;143;89;15;0;15;1.000;3600000;0
11766;194456;143;0;0;0;0;.00nan;0;0
11766;189944;144;0;0;0;0;.00nan;0;0
11767;208575;142;57;45;5;40;.889;3600000;0
11767;201673;141;0;0;0;0;.00nan;0;0
11767;196456;142;0;0;0;0;.00nan;0;0
11767;197756;141;70;22;1;21;.955;3600000;0
11768;198081;133;0;0;0;0;.00nan;0;0
11768;199437;134;63;34;4;30;.882;3600000;0
11768;202059;133;79;23;1;22;.957;3600000;0
11768;-1;134;0;0;0;0;.00nan;0;0
11769;203288;135;0;0;0;0;.00nan;0;0
11769;194197;135;55;26;3;23;.885;3600000;0
11769;201530;136;0;0;0;0;.00nan;0;0
11769;-1;136;21;32;6;26;.813;3600000;0
11770;-1;130;83;42;3;39;.929;3567000;0
11770;-1;131;0;0;0;0;.00nan;0;0
11770;197759;130;0;0;0;0;.00nan;0;0
11770;-1;131;91;28;1;27;.964;3600000;0
11771;194264;137;0;0;0;0;.00nan;0;0
11771;194393;1340;34;29;6;23;.793;3600000;0
11771;201666;1340;0;0;0;0;.00nan;0;0
11771;-1;137;70;19;1;18;.947;3600000;0
11772;199701;138;67;26;2;24;.923;3900000;0
11772;195169;129;87;33;2;31;.939;3900000;0
11772;-1;129;0;0;0;0;.00nan;0;0
11772;-1;138;0;0;0;0;.00nan;0;0
11773;196012;128;39;33;6;27;.818;3741000;0
11773;196287;132;20;27;7;20;.741;3741000;0
11773;196809;132;0;0;0;0;.00nan;0;0
11773;-1;128;0;0;0;0;.00nan;0;0
11774;203276;139;47;39;6;33;.846;3600000;0
11774;192889;139;0;0;0;0;.00nan;0;0
11774;196445;140;0;0;0;0;.00nan;0;0
11774;196812;140;62;18;1;17;.944;3600000;0
11775;192847;144;0;0;0;0;.00nan;0;0
11775;208575;142;26;26;6;20;.769;3571000;0
11775;189944;144;70;42;5;37;.881;3600000;0
11775;196456;142;0;0;0;0;.00nan;0;0
11776;199701;138;0;0;0;0;.00nan;0;0
11776;195169;129;53;21;3;18;.857;3600000;0
11776;-1;129;0;0;0;0;.00nan;0;0
11776;-1;138;51;37;5;32;.865;3544000;0
11777;196012;128;55;32;4;28;.875;3835000;0
11777;-1;130;0;0;0;0;.00nan;0;0
11777;197759;130;61;43;5;38;.884;3850000;0
11777;-1;128;0;0;0;0;.00nan;0;0
11778;199437;134;97;55;4;51;.927;3549000;0
11778;194393;1340;0;0;0;0;.00nan;0;0
11778;201666;1340;52;15;2;13;.867;3600000;0
11778;-1;134;0;0;0;0;.00nan;0;0
11779;203288;135;86;41;2;39;.951;3566000;0
11779;198081;133;0;0;0;0;.00nan;0;0
11779;208556;135;0;0;0;0;.00nan;0;0
11779;202059;133;79;26;1;25;.962;3600000;0
11780;201673;141;26;19;5;14;.737;3600000;0
11780;196445;140;65;15;1;14;.933;870000;0
11780;196812;140;25;23;6;17;.739;2675000;0
11780;197756;141;0;0;0;0;.00nan;0;0
11781;201530;136;75;26;1;25;.962;2522000;0
11781;196287;132;0;0;0;0;.00nan;0;0
11781;196809;132;78;25;1;24;.960;3600000;0
11781;-1;136;34;15;4;11;.733;1078000;0
11782;192895;143;36;26;5;21;.808;3900000;0
11782;194197;143;0;0;0;0;.00nan;0;0
11782;194264;137;28;7;3;4;.571;580000;0
11782;-1;137;68;32;2;30;.938;3320000;0
11783;201673;141;0;0;0;0;.00nan;0;0
11783;196445;140;98;42;1;41;.976;3600000;0
11783;196812;140;0;0;0;0;.00nan;0;0
11783;197756;141;97;25;0;25;1.000;3600000;0
11784;192895;143;0;0;0;0;.00nan;0;0
11784;199437;134;94;42;3;39;.929;3900000;0
11784;194197;143;71;29;3;26;.897;3900000;0
11784;-1;134;0;0;0;0;.00nan;0;0
11785;196012;128;0;0;0;0;.00nan;0;0
11785;-1;131;64;23;2;21;.913;3600000;0
11785;-1;131;0;0;0;0;.00nan;0;0
11785;-1;128;62;36;4;32;.889;3600000;0
11786;195169;129;59;22;3;19;.864;3556000;0
11786;-1;130;0;0;0;0;.00nan;0;0
11786;197759;130;94;42;2;40;.952;3600000;0
11786;-1;129;0;0;0;0;.00nan;0;0
11787;208575;142;0;0;0;0;.00nan;0;0
11787;194264;137;42;30;6;24;.800;3890000;0
11787;196456;142;52;36;5;31;.861;3890000;0
11787;-1;137;0;0;0;0;.00nan;0;0
11788;199701;138;0;0;0;0;.00nan;0;0
11788;194393;1340;0;0;0;0;.00nan;0;0
11788;201666;1340;55;17;2;15;.882;3600000;0
11788;-1;138;62;39;4;35;.897;3582000;0
11789;203288;135;65;43;5;38;.884;3657000;0
11789;208556;135;0;0;0;0;.00nan;0;0
11789;196287;132;0;0;0;0;.00nan;0;0
11789;196809;132;44;22;4;18;.818;3657000;0
11790;198081;133;47;25;4;21;.840;3529000;0
11790;201530;136;0;0;0;0;.00nan;0;0
11790;202059;133;0;0;0;0;.00nan;0;0
11790;-1;136;83;37;2;35;.946;3600000;0
11791;196012;128;67;25;2;23;.920;3600000;0
11791;-1;130;56;31;4;27;.871;3520000;0
11791;197759;130;0;0;0;0;.00nan;0;0
11791;-1;128;0;0;0;0;.00nan;0;0
11792;192895;143;60;31;4;27;.871;3776000;0
11792;199701;138;84;56;5;51;.911;3776000;0
11792;194197;143;0;0;0;0;.00nan;0;0
11792;-1;138;0;0;0;0;.00nan;0;0
11793;208575;142;44;47;7;40;.851;2790000;0
11793;194393;1340;49;29;4;25;.862;3600000;0
11793;201666;1340;0;0;0;0;.00nan;0;0
11793;196456;142;40;3;1;2;.667;810000;0
11794;203276;139;36;35;6;29;.829;3600000;0
11794;192847;144;0;0;0;0;.00nan;0;0
11794;192889;139;0;0;0;0;.00nan;0;0
11794;189944;144;76;32;2;30;.938;3600000;0
11795;195169;129;0;0;0;0;.00nan;0;0
11795;-1;131;0;0;0;0;.00nan;0;0
11795;-1;129;54;36;5;31;.861;3523000;0
11795;-1;131;67;28;3;25;.893;3600000;0
11796;192847;144;66;33;4;29;.879;3600000;0
11796;189944;144;0;0;0;0;.00nan;0;0
11796;196445;140;0;0;0;0;.00nan;0;0
11796;196812;140;26;18;5;13;.722;3552000;0
11797;203276;139;0;0;0;0;.00nan;0;0
11797;192889;139;76;54;6;48;.889;3600000;0
11797;201673;141;0;0;0;0;.00nan;0;0
11797;197756;141;65;14;1;13;.929;3600000;0
11798;199437;134;76;47;4;43;.915;3600000;0
11798;194264;137;59;25;3;22;.880;3600000;0
11798;-1;137;0;0;0;0;.00nan;0;0
11798;-1;134;0;0;0;0;.00nan;0;0
11799;198081;133;0;0;0;0;.00nan;0;0
11799;201530;136;68;40;5;35;.875;3592000;0
11799;202059;133;45;26;4;22;.846;3600000;0
11799;-1;136;0;0;0;0;.00nan;0;0
11800;203288;135;70;32;4;28;.875;3569000;0
11800;208556;135;0;0;0;0;.00nan;0;0
11800;196287;132;0;0;0;0;.00nan;0;0
11800;196809;132;61;21;3;18;.857;3600000;0
11801;-1;130;0;0;0;0;.00nan;0;0
11801;-1;131;0;0;0;0;.00nan;0;0
11801;197759;130;35;34;6;28;.824;3600000;0
11801;-1;131;76;20;1;19;.950;3600000;0
11802;203276;139;37;25;4;21;.840;3538000;0
11802;208575;142;0;0;0;0;.00nan;0;0
11802;192889;139;0;0;0;0;.00nan;0;0
11802;196456;142;64;24;2;22;.917;3600000;0
11803;195169;129;63;26;2;24;.923;3600000;0
11803;196012;128;59;44;6;38;.864;3600000;0
11803;-1;129;0;0;0;0;.00nan;0;0
11803;-1;128;0;0;0;0;.00nan;0;0
11804;192895;143;75;25;2;23;.920;3600000;0
11804;199437;134;47;39;6;33;.846;2753000;0
11804;194197;143;0;0;0;0;.00nan;0;0
11804;-1;134;37;8;2;6;.750;847000;0
11805;199701;138;0;0;0;0;.00nan;0;0
11805;196445;140;45;25;4;21;.840;3794000;0
11805;196812;140;0;0;0;0;.00nan;0;0
11805;-1;138;79;46;5;41;.891;3794000;0
11806;198081;133;60;36;4;32;.889;3600000;0
11806;201673;141;40;33;6;27;.818;3066000;0
11806;202059;133;0;0;0;0;.00nan;0;0
11806;197756;141;44;4;1;3;.750;534000;0
11807;208575;142;68;25;2;23;.920;3600000;0
11807;199701;138;85;43;3;40;.930;3557000;0
11807;196456;142;0;0;0;0;.00nan;0;0
11807;-1;138;0;0;0;0;.00nan;0;0
11808;198081;133;0;0;0;0;.00nan;0;0
11808;196445;140;0;0;0;0;.00nan;0;0
11808;202059;133;75;22;1;21;.955;3600000;0
11808;196812;140;77;34;2;32;.941;3566000;0
11809;195169;129;41;23;4;19;.826;3600000;0
11809;-1;130;0;0;0;0;.00nan;0;0
11809;197759;130;89;28;1;27;.964;3600000;0
11809;-1;129;0;0;0;0;.00nan;0;0
11810;194393;1340;67;19;1;18;.947;2457000;0
11810;201666;1340;24;15;4;11;.733;1101000;0
11810;196012;128;69;38;3;35;.921;3600000;0
11810;-1;128;0;0;0;0;.00nan;0;0
11811;194264;137;41;40;6;34;.850;3600000;0
11811;196287;132;0;0;0;0;.00nan;0;0
11811;196809;132;73;25;2;23;.920;3600000;0
11811;-1;137;0;0;0;0;.00nan;0;0
11812;203288;135;31;15;4;11;.733;1116000;0
11812;208556;135;77;21;0;21;1.000;2484000;0
11812;-1;131;0;0;0;0;.00nan;0;0
11812;-1;131;32;29;6;23;.793;3600000;0
11813;203288;135;49;36;6;30;.833;3529000;0
11813;208556;135;0;0;0;0;.00nan;0;0
11813;196012;128;0;0;0;0;.00nan;0;0
11813;-1;128;52;30;4;26;.867;3600000;0
11814;201530;136;0;0;0;0;.00nan;0;0
11814;-1;131;22;24;6;18;.750;3082000;0
11814;-1;131;56;5;0;5;1.000;482000;0
11814;-1;136;43;33;5;28;.848;3600000;0
11815;194393;1340;0;0;0;0;.00nan;0;0
11815;201666;1340;47;12;2;10;.833;3600000;0
11815;-1;130;0;0;0;0;.00nan;0;0
11815;197759;130;78;54;5;49;.907;3600000;0
11816;203276;139;53;32;5;27;.844;3546000;0
11816;198081;133;50;21;3;18;.857;3600000;0
11816;192889;139;0;0;0;0;.00nan;0;0
11816;202059;133;0;0;0;0;.00nan;0;0
11817;192847;144;0;0;0;0;.00nan;0;0
11817;199437;134;76;37;3;34;.919;3600000;0
11817;189944;144;58;28;4;24;.857;3600000;0
11817;-1;134;0;0;0;0;.00nan;0;0
11818;199701;138;57;10;1;9;.900;414000;0
11818;201673;141;0;0;0;0;.00nan;0;0
11818;197756;141;57;32;6;26;.813;3609000;0
11818;-1;138;45;37;6;31;.838;3195000;0
11819;208575;142;0;0;0;0;.00nan;0;0
11819;192895;143;67;23;1;22;.957;3600000;0
11819;194197;143;0;0;0;0;.00nan;0;0
11819;196456;142;60;33;5;28;.848;3600000;0
11820;199437;134;0;0;0;0;.00nan;0;0
11820;196445;140;73;34;3;31;.912;3577000;0
11820;196812;140;0;0;0;0;.00nan;0;0
11820;-1;134;76;17;1;16;.941;3600000;0
11821;194393;1340;54;26;4;22;.846;3600000;0
11821;201666;1340;0;0;0;0;.00nan;0;0
11821;196287;132;0;0;0;0;.00nan;0;0
11821;196809;132;28;35;7;28;.800;3600000;0
11822;203276;139;0;0;0;0;.00nan;0;0
11822;192847;144;0;0;0;0;.00nan;0;0
11822;192889;139;65;35;3;32;.914;3600000;0
11822;189944;144;55;35;5;30;.857;3549000;0
11823;201530;136;87;18;0;18;1.000;3600000;0
11823;-1;131;0;0;0;0;.00nan;0;0
11823;-1;131;59;49;5;44;.898;3600000;0
11823;-1;136;0;0;0;0;.00nan;0;0
11824;194264;137;0;0;0;0;.00nan;0;0
11824;195169;129;23;21;5;16;.762;3900000;0
11824;-1;137;36;23;5;18;.783;3900000;0
11824;-1;129;0;0;0;0;.00nan;0;0
11825;201673;141;34;19;4;15;.789;3600000;0
11825;196445;140;0;0;0;0;.00nan;0;0
11825;196812;140;57;42;5;37;.881;3570000;0
11825;197756;141;0;0;0;0;.00nan;0;0
11826;203276;139;69;37;3;34;.919;3900000;0
11826;192889;139;0;0;0;0;.00nan;0;0
11826;196012;128;54;25;3;22;.880;3900000;0
11826;-1;128;0;0;0;0;.00nan;0;0
11827;203288;135;41;35;6;29;.829;2533000;0
11827;208556;135;49;8;1;7;.875;1067000;0
11827;192895;143;56;13;1;12;.923;3600000;0
11827;194197;143;0;0;0;0;.00nan;0;0
11828;192847;144;54;4;0;4;1.000;343000;0
11828;208575;142;49;24;4;20;.833;3600000;0
11828;189944;144;37;32;6;26;.813;3209000;0
11828;196456;142;0;0;0;0;.00nan;0;0
11829;194264;137;74;39;4;35;.897;3590000;0
11829;201673;141;0;0;0;0;.00nan;0;0
11829;-1;137;0;0;0;0;.00nan;0;0
11829;197756;141;59;29;3;26;.897;3600000;0
11830;201530;136;93;42;2;40;.952;3552000;0
11830;-1;131;89;33;1;32;.970;3600000;0
11830;-1;131;0;0;0;0;.00nan;0;0
11830;-1;136;0;0;0;0;.00nan;0;0
11831;203276;139;0;0;0;0;.00nan;0;0
11831;192889;139;53;43;6;37;.860;3600000;0
11831;199701;138;0;0;0;0;.00nan;0;0
11831;-1;138;44;19;3;16;.842;3600000;0
11832;195169;129;77;27;2;25;.926;3600000;0
11832;196287;132;0;0;0;0;.00nan;0;0
11832;196809;132;49;30;4;26;.867;3562000;0
11832;-1;129;0;0;0;0;.00nan;0;0
11833;194264;137;0;0;0;0;.00nan;0;0
11833;196445;140;54;32;4;28;.875;3569000;0
11833;196812;140;0;0;0;0;.00nan;0;0
11833;-1;137;73;28;3;25;.893;3600000;0
11834;198081;133;0;0;0;0;.00nan;0;0
11834;194393;1340;0;0;0;0;.00nan;0;0
11834;201666;1340;73;34;4;30;.882;3900000;0
11834;202059;133;67;32;4;28;.875;3900000;0
11835;201530;136;0;0;0;0;.00nan;0;0
11835;-1;130;0;0;0;0;.00nan;0;0
11835;197759;130;61;35;4;31;.886;3600000;0
11835;-1;136;66;38;5;33;.868;3578000;0
11836;199437;134;80;50;5;45;.900;3545000;0
11836;196012;128;57;31;4;27;.871;3600000;0
11836;-1;134;0;0;0;0;.00nan;0;0
11836;-1;128;0;0;0;0;.00nan;0;0
11837;203276;139;71;32;3;29;.906;3569000;0
11837;198081;133;77;23;1;22;.957;3600000;0
11837;192889;139;0;0;0;0;.00nan;0;0
11837;202059;133;0;0;0;0;.00nan;0;0
11838;195169;129;90;20;0;20;1.000;3600000;0
11838;-1;131;0;0;0;0;.00nan;0;0
11838;-1;129;0;0;0;0;.00nan;0;0
11838;-1;131;55;32;4;28;.875;3600000;0
11839;201530;136;70;40;4;36;.900;3600000;0
11839;-1;130;45;30;5;25;.833;3551000;0
11839;197759;130;0;0;0;0;.00nan;0;0
11839;-1;136;0;0;0;0;.00nan;0;0
11840;199701;138;40;42;7;35;.833;3600000;0
11840;196287;132;0;0;0;0;.00nan;0;0
11840;196809;132;75;21;1;20;.952;3600000;0
11840;-1;138;0;0;0;0;.00nan;0;0
11841;208575;142;0;0;0;0;.00nan;0;0
11841;194264;137;77;38;3;35;.921;3520000;0
11841;196456;142;73;24;1;23;.958;3600000;0
11841;-1;137;0;0;0;0;.00nan;0;0
11842;192895;143;40;26;5;21;.808;3845000;0
11842;194197;143;0;0;0;0;.00nan;0;0
11842;201673;141;72;42;4;38;.905;3845000;0
11842;197756;141;0;0;0;0;.00nan;0;0
11843;203288;135;37;25;5;20;.800;1824000;0
11843;208556;135;58;8;0;8;1.000;1776000;0
11843;192847;144;0;0;0;0;.00nan;0;0
11843;189944;144;92;24;0;24;1.000;3600000;0
11844;192847;144;0;0;0;0;.00nan;0;0
11844;192895;143;0;0;0;0;.00nan;0;0
11844;194197;143;68;22;2;20;.909;3600000;0
11844;189944;144;88;43;3;40;.930;3581000;0
11845;203288;135;100;44;1;43;.977;3900000;0
11845;208556;135;0;0;0;0;.00nan;0;0
11845;196445;140;0;0;0;0;.00nan;0;0
11845;196812;140;80;23;1;22;.957;3900000;0
11846;199437;134;86;46;4;42;.913;3600000;0
11846;194393;1340;55;27;3;24;.889;3037000;0
11846;201666;1340;29;5;3;2;.400;547000;0
11846;-1;134;0;0;0;0;.00nan;0;0
11847;195169;129;52;42;6;36;.857;3356000;0
11847;196012;128;60;25;2;23;.920;2880000;0
11847;-1;129;56;0;0;0;.00nan;544000;0
11847;-1;128;28;14;4;10;.714;1020000;0
11848;196287;132;87;17;0;17;1.000;3600000;0
11848;196809;132;0;0;0;0;.00nan;0;0
11848;-1;131;57;33;4;29;.879;3600000;0
11848;-1;131;0;0;0;0;.00nan;0;0
11849;208575;142;67;32;3;29;.906;3600000;0
11849;196287;132;100;22;0;22;1.000;3600000;0
11849;196456;142;0;0;0;0;.00nan;0;0
11849;196809;132;0;0;0;0;.00nan;0;0
11850;203276;139;57;42;6;36;.857;3752000;0
11850;192889;139;0;0;0;0;.00nan;0;0
11850;192895;143;40;24;5;19;.792;3752000;0
11850;194197;143;0;0;0;0;.00nan;0;0
11851;192847;144;19;10;4;6;.600;1001000;0
11851;189944;144;64;22;1;21;.955;2599000;0
11851;196445;140;0;0;0;0;.00nan;0;0
11851;196812;140;79;27;2;25;.926;3600000;0
11852;203288;135;81;42;3;39;.929;3561000;0
11852;208556;135;0;0;0;0;.00nan;0;0
11852;201530;136;63;15;1;14;.933;3600000;0
11852;-1;136;0;0;0;0;.00nan;0;0
11853;194393;1340;0;0;0;0;.00nan;0;0
11853;195169;129;78;32;2;30;.938;3600000;0
11853;201666;1340;48;26;3;23;.885;3572000;0
11853;-1;129;0;0;0;0;.00nan;0;0
11854;198081;133;0;0;0;0;.00nan;0;0
11854;202059;133;54;29;4;25;.862;3900000;0
11854;-1;130;0;0;0;0;.00nan;0;0
11854;197759;130;76;42;4;38;.905;3900000;0
11855;194264;137;84;33;2;31;.939;3600000;0
11855;201673;141;0;0;0;0;.00nan;0;0
11855;-1;137;0;0;0;0;.00nan;0;0
11855;197756;141;79;49;4;45;.918;3549000;0
11856;199701;138;0;0;0;0;.00nan;0;0
11856;196012;128;61;20;1;19;.950;3600000;0
11856;-1;138;84;39;3;36;.923;3560000;0
11856;-1;128;0;0;0;0;.00nan;0;0
11857;199437;134;67;34;3;31;.912;3515000;0
11857;201530;136;0;0;0;0;.00nan;0;0
11857;-1;134;0;0;0;0;.00nan;0;0
11857;-1;136;97;36;1;35;.972;3600000;0
11858;194264;137;0;0;0;0;.00nan;0;0
11858;196012;128;0;0;0;0;.00nan;0;0
11858;-1;137;56;34;5;29;.853;3574000;0
11858;-1;128;51;27;4;23;.852;3600000;0
11859;199701;138;68;39;4;35;.897;3600000;0
11859;201673;141;60;40;5;35;.875;3595000;0
11859;197756;141;0;0;0;0;.00nan;0;0
11859;-1;138;0;0;0;0;.00nan;0;0
11860;196287;132;0;0;0;0;.00nan;0;0
11860;196445;140;63;27;2;25;.926;3900000;0
11860;196809;132;95;42;2;40;.952;3900000;0
11860;196812;140;0;0;0;0;.00nan;0;0
11861;198081;133;60;37;4;33;.892;3600000;0
11861;202059;133;0;0;0;0;.00nan;0;0
11861;-1;131;0;0;0;0;.00nan;0;0
11861;-1;131;87;29;1;28;.966;3600000;0
11862;208575;142;0;0;0;0;.00nan;0;0
11862;196445;140;45;28;4;24;.857;3140000;0
11862;196456;142;67;25;2;23;.920;3600000;0
11862;196812;140;21;8;4;4;.500;460000;0
11863;192847;144;0;0;0;0;.00nan;0;0
11863;192895;143;75;31;2;29;.935;3608000;0
11863;194197;143;0;0;0;0;.00nan;0;0
11863;189944;144;98;37;1;36;.973;3608000;0
11864;195169;129;0;0;0;0;.00nan;0;0
11864;201673;141;0;0;0;0;.00nan;0;0
11864;197756;141;57;17;2;15;.882;3600000;0
11864;-1;129;56;39;5;34;.872;3600000;0
11865;198081;133;0;0;0;0;.00nan;0;0
11865;202059;133;78;27;1;26;.963;3600000;0
11865;-1;130;0;0;0;0;.00nan;0;0
11865;197759;130;75;41;3;38;.927;3537000;0
11866;203276;139;54;23;3;20;.870;3600000;0
11866;192889;139;0;0;0;0;.00nan;0;0
11866;196287;132;75;41;4;37;.902;3600000;0
11866;196809;132;0;0;0;0;.00nan;0;0
11867;203288;135;0;0;0;0;.00nan;0;0
11867;208556;135;66;24;2;22;.917;3600000;0
11867;199437;134;68;28;4;24;.857;3576000;0
11867;-1;134;0;0;0;0;.00nan;0;0
11868;194264;137;75;28;3;25;.893;3600000;0
11868;-1;137;0;0;0;0;.00nan;0;0
11868;-1;131;53;2;0;2;1.000;422000;0
11868;-1;131;35;37;6;31;.838;3178000;0
11869;199437;134;81;29;2;27;.931;3600000;0
11869;195169;129;77;44;4;40;.909;3534000;0
11869;-1;129;0;0;0;0;.00nan;0;0
11869;-1;134;0;0;0;0;.00nan;0;0
11870;194264;137;0;0;0;0;.00nan;0;0
11870;-1;130;0;0;0;0;.00nan;0;0
11870;-1;137;62;22;2;20;.909;3600000;0
11870;197759;130;69;40;4;36;.900;3562000;0
11871;196012;128;91;35;1;34;.971;3600000;0
11871;-1;131;0;0;0;0;.00nan;0;0
11871;-1;131;64;29;3;26;.897;3516000;0
11871;-1;128;0;0;0;0;.00nan;0;0
11872;194393;1340;0;0;0;0;.00nan;0;0
11872;201530;136;39;28;5;23;.821;3586000;0
11872;201666;1340;75;31;3;28;.903;3600000;0
11872;-1;136;0;0;0;0;.00nan;0;0
11873;192847;144;0;0;0;0;.00nan;0;0
11873;199701;138;0;0;0;0;.00nan;0;0
11873;189944;144;67;25;2;23;.920;3588000;0
11873;-1;138;99;47;1;46;.979;3600000;0
11874;203288;135;57;41;6;35;.854;3600000;0
11874;208556;135;0;0;0;0;.00nan;0;0
11874;195169;129;0;0;0;0;.00nan;0;0
11874;-1;129;82;28;1;27;.964;3600000;0
11875;208575;142;0;0;0;0;.00nan;0;0
11875;201673;141;65;27;2;25;.926;3784000;0
11875;196456;142;61;30;3;27;.900;3784000;0
11875;197756;141;0;0;0;0;.00nan;0;0
11876;192895;143;93;29;1;28;.966;3600000;0
11876;194197;143;0;0;0;0;.00nan;0;0
11876;196445;140;0;0;0;0;.00nan;0;0
11876;196812;140;62;46;7;39;.848;3600000;0
11877;199437;134;86;37;2;35;.946;3600000;0
11877;201530;136;0;0;0;0;.00nan;0;0
11877;-1;134;0;0;0;0;.00nan;0;0
11877;-1;136;33;27;5;22;.815;3600000;0
11878;192847;144;92;42;3;39;.929;3900000;0
11878;194393;1340;58;30;3;27;.900;3866000;0
11878;189944;144;0;0;0;0;.00nan;0;0
11878;201666;1340;0;0;0;0;.00nan;0;0
11879;199701;138;74;34;3;31;.912;3900000;0
11879;-1;131;66;29;3;26;.897;3900000;0
11879;-1;131;0;0;0;0;.00nan;0;0
11879;-1;138;0;0;0;0;.00nan;0;0
11880;196287;132;0;0;0;0;.00nan;0;0
11880;196809;132;70;28;3;25;.893;3600000;0
11880;-1;130;0;0;0;0;.00nan;0;0
11880;197759;130;74;41;4;37;.902;3548000;0
11881;199437;134;0;0;0;0;.00nan;0;0
11881;201530;136;23;42;8;34;.810;3600000;0
11881;-1;134;50;22;3;19;.864;3600000;0
11881;-1;136;0;0;0;0;.00nan;0;0
11882;195169;129;48;28;4;24;.857;3579000;0
11882;-1;130;65;26;2;24;.923;3600000;0
11882;197759;130;0;0;0;0;.00nan;0;0
11882;-1;129;0;0;0;0;.00nan;0;0
11883;198081;133;0;0;0;0;.00nan;0;0
11883;196012;128;65;30;4;26;.867;3565000;0
11883;202059;133;60;29;3;26;.897;3600000;0
11883;-1;128;0;0;0;0;.00nan;0;0
11884;192847;144;0;0;0;0;.00nan;0;0
11884;194264;137;74;21;1;20;.952;3600000;0
11884;189944;144;76;31;3;28;.903;3582000;0
11884;-1;137;0;0;0;0;.00nan;0;0
11885;203276;139;0;0;0;0;.00nan;0;0
11885;208575;142;40;29;6;23;.793;3536000;0
11885;192889;139;68;40;4;36;.900;3600000;0
11885;196456;142;0;0;0;0;.00nan;0;0
11886;192895;143;0;0;0;0;.00nan;0;0
11886;194197;143;41;28;4;24;.857;3900000;0
11886;196445;140;88;47;4;43;.915;3900000;0
11886;196812;140;0;0;0;0;.00nan;0;0
11887;198081;133;100;42;0;42;1.000;3600000;0
11887;196012;128;0;0;0;0;.00nan;0;0
11887;202059;133;0;0;0;0;.00nan;0;0
11887;-1;128;64;36;4;32;.889;3600000;0
11888;196287;132;0;0;0;0;.00nan;0;0
11888;196809;132;83;35;2;33;.943;3600000;0
11888;-1;131;0;0;0;0;.00nan;0;0
11888;-1;131;48;30;4;26;.867;3569000;0
11889;203276;139;64;42;5;37;.881;3600000;0
11889;192889;139;0;0;0;0;.00nan;0;0
11889;201673;141;74;21;1;20;.952;3600000;0
11889;197756;141;0;0;0;0;.00nan;0;0
11890;203288;135;89;36;2;34;.944;3900000;0
11890;208556;135;0;0;0;0;.00nan;0;0
11890;194264;137;0;0;0;0;.00nan;0;0
11890;-1;137;76;30;2;28;.933;3900000;0
11891;199701;138;0;0;0;0;.00nan;0;0
11891;194393;1340;0;0;0;0;.00nan;0;0
11891;201666;1340;69;24;2;22;.917;3600000;0
11891;-1;138;64;26;3;23;.885;3560000;0
11892;208575;142;0;0;0;0;.00nan;0;0
11892;195169;129;71;25;2;23;.920;3600000;0
11892;196456;142;77;40;3;37;.925;3558000;0
11892;-1;129;0;0;0;0;.00nan;0;0
11893;203276;139;66;24;3;21;.875;3600000;0
11893;192889;139;0;0;0;0;.00nan;0;0
11893;201530;136;28;21;5;16;.762;2438000;0
11893;-1;136;22;12;4;8;.667;1162000;0
11894;198081;133;89;33;1;32;.970;3600000;0
11894;192895;143;60;20;2;18;.900;3546000;0
11894;194197;143;0;0;0;0;.00nan;0;0
11894;202059;133;0;0;0;0;.00nan;0;0
11895;192847;144;0;0;0;0;.00nan;0;0
11895;189944;144;59;23;3;20;.870;3871000;0
11895;201673;141;65;25;2;23;.920;3871000;0
11895;197756;141;0;0;0;0;.00nan;0;0
11896;208575;142;0;0;0;0;.00nan;0;0
11896;196456;142;88;48;3;45;.938;3900000;0
11896;-1;131;75;38;3;35;.921;3872000;0
11896;-1;131;0;0;0;0;.00nan;0;0
11897;199701;138;56;6;0;6;1.000;657000;0
11897;196012;128;65;22;2;20;.909;3600000;0
11897;-1;138;36;39;6;33;.846;2943000;0
11897;-1;128;0;0;0;0;.00nan;0;0
11898;201673;141;0;0;0;0;.00nan;0;0
11898;196445;140;0;0;0;0;.00nan;0;0
11898;196812;140;40;37;6;31;.838;3600000;0
11898;197756;141;76;26;1;25;.962;3600000;0
11899;192895;143;60;21;2;19;.905;3600000;0
11899;194197;143;0;0;0;0;.00nan;0;0
11899;201530;136;0;0;0;0;.00nan;0;0
11899;-1;136;69;38;4;34;.895;3564000;0
11900;198081;133;0;0;0;0;.00nan;0;0
11900;195169;129;56;23;3;20;.870;3600000;0
11900;202059;133;85;40;2;38;.950;3600000;0
11900;-1;129;0;0;0;0;.00nan;0;0
11901;208575;142;100;27;0;27;1.000;3600000;0
11901;196456;142;0;0;0;0;.00nan;0;0
11901;-1;130;0;0;0;0;.00nan;0;0
11901;197759;130;72;36;4;32;.889;3600000;0
11902;194264;137;58;36;5;31;.861;3600000;0
11902;194393;1340;0;0;0;0;.00nan;0;0
11902;201666;1340;94;29;1;28;.966;3600000;0
11902;-1;137;0;0;0;0;.00nan;0;0
11903;199437;134;49;39;6;33;.846;3600000;0
11903;196287;132;0;0;0;0;.00nan;0;0
11903;196809;132;84;34;3;31;.912;3600000;0
11903;-1;134;0;0;0;0;.00nan;0;0
11904;203276;139;81;28;1;27;.964;3600000;0
11904;203288;135;63;35;4;31;.886;3600000;0
11904;208556;135;0;0;0;0;.00nan;0;0
11904;192889;139;0;0;0;0;.00nan;0;0
11905;203288;135;0;0;0;0;.00nan;0;0
11905;208556;135;34;38;6;32;.842;3586000;0
11905;192895;143;0;0;0;0;.00nan;0;0
11905;194197;143;47;27;4;23;.852;3600000;0
11906;198081;133;85;36;2;34;.944;3600000;0
11906;195169;129;0;0;0;0;.00nan;0;0
11906;202059;133;0;0;0;0;.00nan;0;0
11906;-1;129;29;32;6;26;.813;3600000;0
11907;199701;138;0;0;0;0;.00nan;0;0
11907;-1;130;62;29;3;26;.897;3547000;0
11907;197759;130;0;0;0;0;.00nan;0;0
11907;-1;138;82;30;2;28;.933;3600000;0
11908;196012;128;0;0;0;0;.00nan;0;0
11908;196287;132;59;35;4;31;.886;3600000;0
11908;196809;132;0;0;0;0;.00nan;0;0
11908;-1;128;81;27;1;26;.963;3600000;0
11909;203276;139;0;0;0;0;.00nan;0;0
11909;192889;139;66;39;4;35;.897;3600000;0
11909;194393;1340;73;18;1;17;.944;3600000;0
11909;201666;1340;0;0;0;0;.00nan;0;0
11910;192847;144;0;0;0;0;.00nan;0;0
11910;189944;144;72;35;4;31;.886;3600000;0
11910;196445;140;97;35;1;34;.971;3600000;0
11910;196812;140;0;0;0;0;.00nan;0;0
11911;199437;134;76;43;3;40;.930;3600000;0
11911;194264;137;24;6;3;3;.500;483000;0
11911;-1;137;68;19;1;18;.947;3102000;0
11911;-1;134;0;0;0;0;.00nan;0;0
11912;199701;138;37;37;6;31;.838;3540000;0
11912;-1;131;0;0;0;0;.00nan;0;0
11912;-1;131;51;30;4;26;.867;3600000;0
11912;-1;138;0;0;0;0;.00nan;0;0
11913;203288;135;39;29;6;23;.793;3600000;0
11913;208556;135;0;0;0;0;.00nan;0;0
11913;199437;134;57;28;3;25;.893;3600000;0
11913;-1;134;0;0;0;0;.00nan;0;0
11914;203276;139;57;45;6;39;.867;3600000;0
11914;192889;139;0;0;0;0;.00nan;0;0
11914;192895;143;73;17;1;16;.941;3600000;0
11914;194197;143;0;0;0;0;.00nan;0;0
11915;201673;141;33;41;7;34;.829;3568000;0
11915;196012;128;49;42;6;36;.857;3600000;0
11915;197756;141;0;0;0;0;.00nan;0;0
11915;-1;128;0;0;0;0;.00nan;0;0
11916;194393;1340;0;0;0;0;.00nan;0;0
11916;201666;1340;100;22;0;22;1.000;3600000;0
11916;-1;130;0;0;0;0;.00nan;0;0
11916;197759;130;60;43;5;38;.884;3600000;0
11917;198081;133;0;0;0;0;.00nan;0;0
11917;196287;132;0;0;0;0;.00nan;0;0
11917;202059;133;73;33;3;30;.909;3545000;0
11917;196809;132;77;25;2;23;.920;3600000;0
11918;203288;135;81;39;3;36;.923;3600000;0
11918;208556;135;0;0;0;0;.00nan;0;0
11918;194264;137;36;31;6;25;.806;2812000;0
11918;-1;137;54;3;0;3;1.000;788000;0
11919;203276;139;49;21;3;18;.857;3600000;0
11919;192889;139;0;0;0;0;.00nan;0;0
11919;195169;129;81;38;4;34;.895;3548000;0
11919;-1;129;0;0;0;0;.00nan;0;0
11920;208575;142;100;38;2;36;.947;3820000;0
11920;196012;128;0;0;0;0;.00nan;0;0
11920;196456;142;0;0;0;0;.00nan;0;0
11920;-1;128;75;32;3;29;.906;3820000;0
11921;192847;144;0;0;0;0;.00nan;0;0
11921;192895;143;41;23;5;18;.783;3527000;0
11921;194197;143;0;0;0;0;.00nan;0;0
11921;189944;144;100;53;3;50;.943;3600000;0
11922;194264;137;0;0;0;0;.00nan;0;0
11922;201530;136;0;0;0;0;.00nan;0;0
11922;-1;137;67;23;2;21;.913;3600000;0
11922;-1;136;40;34;6;28;.824;3600000;0
11923;199437;134;58;31;4;27;.871;3600000;0
11923;-1;131;74;19;1;18;.947;3600000;0
11923;-1;131;0;0;0;0;.00nan;0;0
11923;-1;134;0;0;0;0;.00nan;0;0
11924;199701;138;0;0;0;0;.00nan;0;0
11924;-1;130;48;32;5;27;.844;3600000;0
11924;197759;130;0;0;0;0;.00nan;0;0
11924;-1;138;98;42;2;40;.952;3600000;0
11925;194393;1340;57;5;0;5;1.000;836000;0
11925;201666;1340;11;27;7;20;.741;2764000;0
11925;196287;132;71;32;3;29;.906;3600000;0
11925;196809;132;0;0;0;0;.00nan;0;0
11926;203288;135;80;43;3;40;.930;3696000;0
11926;198081;133;0;0;0;0;.00nan;0;0
11926;208556;135;0;0;0;0;.00nan;0;0
11926;202059;133;60;35;4;31;.886;3696000;0
11927;196012;128;74;31;2;29;.935;3600000;0
11927;196445;140;0;0;0;0;.00nan;0;0
11927;196812;140;51;25;4;21;.840;3600000;0
11927;-1;128;0;0;0;0;.00nan;0;0
11928;195169;129;0;0;0;0;.00nan;0;0
11928;201673;141;46;28;4;24;.857;3571000;0
11928;197756;141;0;0;0;0;.00nan;0;0
11928;-1;129;60;23;2;21;.913;3600000;0
11929;199437;134;0;0;0;0;.00nan;0;0
11929;-1;131;0;0;0;0;.00nan;0;0
11929;-1;131;90;32;1;31;.969;3600000;0
11929;-1;134;62;27;3;24;.889;3519000;0
11930;208575;142;0;0;0;0;.00nan;0;0
11930;195169;129;50;26;4;22;.846;3600000;0
11930;196456;142;97;41;1;40;.976;3600000;0
11930;-1;129;0;0;0;0;.00nan;0;0
11931;203276;139;100;42;1;41;.976;3600000;0
11931;192847;144;0;0;0;0;.00nan;0;0
11931;192889;139;0;0;0;0;.00nan;0;0
11931;189944;144;65;33;3;30;.909;3525000;0
11932;198081;133;79;13;0;13;1.000;3600000;0
11932;196287;132;52;11;1;10;.909;916000;0
11932;202059;133;0;0;0;0;.00nan;0;0
11932;196809;132;58;44;6;38;.864;2684000;0
11933;199437;134;55;28;4;24;.857;3556000;0
11933;-1;130;0;0;0;0;.00nan;0;0
11933;197759;130;77;32;2;30;.938;3600000;0
11933;-1;134;0;0;0;0;.00nan;0;0
11934;194264;137;74;35;3;32;.914;3600000;0
11934;194393;1340;49;29;4;25;.862;3591000;0
11934;201666;1340;0;0;0;0;.00nan;0;0
11934;-1;137;0;0;0;0;.00nan;0;0
11935;199701;138;0;0;0;0;.00nan;0;0
11935;201530;136;80;32;2;30;.938;3600000;0
11935;-1;138;61;26;3;23;.885;3556000;0
11935;-1;136;0;0;0;0;.00nan;0;0
11936;203276;139;0;0;0;0;.00nan;0;0
11936;192847;144;0;0;0;0;.00nan;0;0
11936;192889;139;63;33;4;29;.879;3600000;0
11936;189944;144;88;32;1;31;.969;3600000;0
11937;208575;142;46;22;4;18;.818;3693000;0
11937;196445;140;0;0;0;0;.00nan;0;0
11937;196456;142;0;0;0;0;.00nan;0;0
11937;196812;140;66;26;3;23;.885;3693000;0
11938;192895;143;53;34;5;29;.853;3543000;0
11938;194197;143;0;0;0;0;.00nan;0;0
11938;201673;141;0;0;0;0;.00nan;0;0
11938;197756;141;56;23;4;19;.826;3600000;0
11939;203276;139;69;32;4;28;.875;3651000;0
11939;208575;142;0;0;0;0;.00nan;0;0
11939;192889;139;0;0;0;0;.00nan;0;0
11939;196456;142;52;21;3;18;.857;3647000;0
11940;199701;138;0;0;0;0;.00nan;0;0
11940;201530;136;0;0;0;0;.00nan;0;0
11940;-1;138;50;23;4;19;.826;3900000;0
11940;-1;136;88;47;4;43;.915;3900000;0
11941;195169;129;81;36;2;34;.944;3600000;0
11941;196012;128;38;27;5;22;.815;3600000;0
11941;-1;129;0;0;0;0;.00nan;0;0
11941;-1;128;0;0;0;0;.00nan;0;0
11942;-1;130;0;0;0;0;.00nan;0;0
11942;-1;131;0;0;0;0;.00nan;0;0
11942;197759;130;79;32;2;30;.938;3541000;0
11942;-1;131;100;27;0;27;1.000;3600000;0
11943;192847;144;0;0;0;0;.00nan;0;0
11943;189944;144;72;34;4;30;.882;3545000;0
11943;196287;132;0;0;0;0;.00nan;0;0
11943;196809;132;65;30;3;27;.900;3600000;0
11944;203288;135;46;30;5;25;.833;3572000;0
11944;198081;133;51;24;4;20;.833;3600000;0
11944;208556;135;0;0;0;0;.00nan;0;0
11944;202059;133;0;0;0;0;.00nan;0;0
11945;199437;134;100;34;0;34;1.000;3600000;0
11945;201673;141;96;28;1;27;.964;3578000;0
11945;197756;141;0;0;0;0;.00nan;0;0
11945;-1;134;0;0;0;0;.00nan;0;0
11946;192847;144;0;0;0;0;.00nan;0;0
11946;195169;129;0;0;0;0;.00nan;0;0
11946;189944;144;43;31;6;25;.806;3600000;0
11946;-1;129;35;25;5;20;.800;3600000;0
11947;194264;137;0;0;0;0;.00nan;0;0
11947;194393;1340;0;0;0;0;.00nan;0;0
11947;201666;1340;100;26;0;26;1.000;3600000;0
11947;-1;137;68;44;5;39;.886;3600000;0
11948;203288;135;0;0;0;0;.00nan;0;0
11948;208556;135;62;22;2;20;.909;3600000;0
11948;199701;138;63;39;4;35;.897;3600000;0
11948;-1;138;0;0;0;0;.00nan;0;0
11949;198081;133;0;0;0;0;.00nan;0;0
11949;201530;136;0;0;0;0;.00nan;0;0
11949;202059;133;66;28;3;25;.893;3579000;0
11949;-1;136;100;35;1;34;.971;3600000;0
11950;196012;128;0;0;0;0;.00nan;0;0
11950;-1;131;0;0;0;0;.00nan;0;0
11950;-1;131;74;31;2;29;.935;3600000;0
11950;-1;128;55;28;4;24;.857;3530000;0
11951;194393;1340;0;0;0;0;.00nan;0;0
11951;201666;1340;100;35;0;35;1.000;3600000;0
11951;201673;141;0;0;0;0;.00nan;0;0
11951;197756;141;62;38;4;34;.895;3600000;0
11952;196287;132;67;25;2;23;.920;2885000;0
11952;196809;132;14;12;5;7;.583;715000;0
11952;-1;130;0;0;0;0;.00nan;0;0
11952;197759;130;83;25;1;24;.960;3600000;0
11953;203276;139;74;30;2;28;.933;3600000;0
11953;192889;139;0;0;0;0;.00nan;0;0
11953;196445;140;0;0;0;0;.00nan;0;0
11953;196812;140;51;31;5;26;.839;3600000;0
11954;208575;142;0;0;0;0;.00nan;0;0
11954;192895;143;67;14;1;13;.929;3600000;0
11954;194197;143;0;0;0;0;.00nan;0;0
11954;196456;142;69;40;5;35;.875;3600000;0
11955;208575;142;78;51;5;46;.902;3600000;0
11955;192895;143;0;0;0;0;.00nan;0;0
11955;194197;143;73;28;2;26;.929;3600000;0
11955;196456;142;0;0;0;0;.00nan;0;0
11956;203276;139;0;0;0;0;.00nan;0;0
11956;192889;139;64;22;2;20;.909;3600000;0
11956;196445;140;35;32;6;26;.813;3600000;0
11956;196812;140;0;0;0;0;.00nan;0;0
11957;192847;144;38;18;4;14;.778;2669000;0
11957;199437;134;39;25;5;20;.800;3600000;0
11957;189944;144;38;19;4;15;.789;931000;0
11957;-1;134;0;0;0;0;.00nan;0;0
11958;196012;128;59;28;3;25;.893;3600000;0
11958;-1;130;62;44;5;39;.886;3576000;0
11958;197759;130;0;0;0;0;.00nan;0;0
11958;-1;128;0;0;0;0;.00nan;0;0
11959;201673;141;100;28;0;28;1.000;3600000;0
11959;196287;132;0;0;0;0;.00nan;0;0
11959;196809;132;97;34;1;33;.971;3562000;0
11959;197756;141;0;0;0;0;.00nan;0;0
11960;198081;133;77;35;4;31;.886;3600000;0
11960;201530;136;56;33;5;28;.848;3574000;0
11960;202059;133;0;0;0;0;.00nan;0;0
11960;-1;136;0;0;0;0;.00nan;0;0
11961;199701;138;0;0;0;0;.00nan;0;0
11961;194264;137;48;16;2;14;.875;3570000;0
11961;-1;137;0;0;0;0;.00nan;0;0
11961;-1;138;99;45;1;44;.978;3600000;0
11962;194393;1340;41;26;5;21;.808;3600000;0
11962;201666;1340;0;0;0;0;.00nan;0;0
11962;-1;131;82;34;2;32;.941;3600000;0
11962;-1;131;0;0;0;0;.00nan;0;0
11963;192847;144;0;0;0;0;.00nan;0;0
11963;192895;143;64;21;2;19;.905;3600000;0
11963;194197;143;0;0;0;0;.00nan;0;0
11963;189944;144;60;36;4;32;.889;3535000;0
11964;203288;135;67;26;2;24;.923;3573000;0
11964;208556;135;0;0;0;0;.00nan;0;0
11964;195169;129;100;27;0;27;1.000;3600000;0
11964;-1;129;0;0;0;0;.00nan;0;0
11965;196012;128;0;0;0;0;.00nan;0;0
11965;196445;140;0;0;0;0;.00nan;0;0
11965;196812;140;59;32;4;28;.875;3562000;0
11965;-1;128;86;32;3;29;.906;3600000;0
11966;199437;134;69;46;5;41;.891;3600000;0
11966;199701;138;0;0;0;0;.00nan;0;0
11966;-1;134;0;0;0;0;.00nan;0;0
11966;-1;138;82;30;2;28;.933;3600000;0
11967;203276;139;75;31;3;28;.903;3900000;0
11967;192889;139;0;0;0;0;.00nan;0;0
11967;201530;136;0;0;0;0;.00nan;0;0
11967;-1;136;68;36;3;33;.917;3900000;0
11968;192847;144;3;21;7;14;.667;2220000;0
11968;208575;142;0;0;0;0;.00nan;0;0
11968;189944;144;54;11;1;10;.909;1380000;0
11968;196456;142;45;29;5;24;.828;3600000;0
11969;194264;137;96;35;1;34;.971;3600000;0
11969;-1;130;0;0;0;0;.00nan;0;0
11969;-1;137;0;0;0;0;.00nan;0;0
11969;197759;130;81;34;2;32;.941;3600000;0
11970;201530;136;60;41;5;36;.878;3538000;0
11970;201673;141;67;29;3;26;.897;3600000;0
11970;197756;141;0;0;0;0;.00nan;0;0
11970;-1;136;0;0;0;0;.00nan;0;0
11971;203288;135;52;32;5;27;.844;3600000;0
11971;208556;135;0;0;0;0;.00nan;0;0
11971;-1;131;0;0;0;0;.00nan;0;0
11971;-1;131;38;36;6;30;.833;3565000;0
11972;195169;129;51;34;4;30;.882;3600000;0
11972;-1;130;35;29;5;24;.828;2065000;0
11972;197759;130;19;15;5;10;.667;1535000;0
11972;-1;129;0;0;0;0;.00nan;0;0
11973;194264;137;0;0;0;0;.00nan;0;0
11973;196287;132;0;0;0;0;.00nan;0;0
11973;196809;132;36;28;5;23;.821;3544000;0
11973;-1;137;72;30;4;26;.867;3600000;0
11974;194393;1340;0;0;0;0;.00nan;0;0
11974;201666;1340;68;29;3;26;.897;3600000;0
11974;196445;140;54;31;4;27;.871;3600000;0
11974;196812;140;0;0;0;0;.00nan;0;0
11975;199701;138;0;0;0;0;.00nan;0;0
11975;196012;128;0;0;0;0;.00nan;0;0
11975;-1;138;95;40;3;37;.925;3900000;0
11975;-1;128;51;23;3;20;.870;3900000;0
11976;208575;142;0;0;0;0;.00nan;0;0
11976;201530;136;43;20;3;17;.850;2428000;0
11976;196456;142;84;26;1;25;.962;3600000;0
11976;-1;136;28;21;5;16;.762;1172000;0
11977;198081;133;0;0;0;0;.00nan;0;0
11977;199437;134;75;20;1;19;.950;3600000;0
11977;202059;133;71;40;4;36;.900;3600000;0
11977;-1;134;0;0;0;0;.00nan;0;0
11978;195169;129;0;0;0;0;.00nan;0;0
11978;196012;128;70;42;4;38;.905;3600000;0
11978;-1;129;44;33;6;27;.818;3533000;0
11978;-1;128;0;0;0;0;.00nan;0;0
11979;199701;138;81;35;3;32;.914;3600000;0
11979;196445;140;0;0;0;0;.00nan;0;0
11979;196812;140;35;25;5;20;.800;3535000;0
11979;-1;138;0;0;0;0;.00nan;0;0
11980;203276;139;95;44;2;42;.955;3565000;0
11980;192889;139;0;0;0;0;.00nan;0;0
11980;192895;143;85;14;0;14;1.000;3600000;0
11980;194197;143;0;0;0;0;.00nan;0;0
11981;192847;144;0;0;0;0;.00nan;0;0
11981;189944;144;67;34;4;30;.882;3526000;0
11981;201673;141;79;31;2;29;.935;3600000;0
11981;197756;141;0;0;0;0;.00nan;0;0
11982;203288;135;60;22;2;20;.909;2607000;0
11982;208556;135;26;12;4;8;.667;993000;0
11982;-1;131;84;26;1;25;.962;3600000;0
11982;-1;131;0;0;0;0;.00nan;0;0
11983;208575;142;34;15;4;11;.733;727000;0
11983;192895;143;41;14;4;10;.714;3900000;0
11983;194197;143;0;0;0;0;.00nan;0;0
11983;196456;142;96;46;0;46;1.000;3173000;0
11984;198081;133;68;24;2;22;.917;3582000;0
11984;194264;137;76;20;1;19;.950;3600000;0
11984;202059;133;0;0;0;0;.00nan;0;0
11984;-1;137;0;0;0;0;.00nan;0;0
11985;203288;135;0;0;0;0;.00nan;0;0
11985;208556;135;54;29;4;25;.862;3600000;0
11985;-1;130;38;15;3;12;.800;1311000;0
11985;197759;130;38;21;4;17;.810;2289000;0
11986;194393;1340;0;0;0;0;.00nan;0;0
11986;201666;1340;31;28;6;22;.786;3600000;0
11986;196287;132;0;0;0;0;.00nan;0;0
11986;196809;132;87;30;1;29;.967;3600000;0
11987;203276;139;0;0;0;0;.00nan;0;0
11987;192889;139;52;36;5;31;.861;3518000;0
11987;201673;141;42;16;3;13;.813;3600000;0
11987;197756;141;0;0;0;0;.00nan;0;0
11988;192895;143;78;29;2;27;.931;3600000;0
11988;194197;143;0;0;0;0;.00nan;0;0
11988;196445;140;69;24;1;23;.958;2479000;0
11988;196812;140;31;17;4;13;.765;1121000;0
11989;199437;134;40;36;6;30;.833;3585000;0
11989;199701;138;0;0;0;0;.00nan;0;0
11989;-1;134;0;0;0;0;.00nan;0;0
11989;-1;138;60;29;5;24;.828;3600000;0
11990;194393;1340;0;0;0;0;.00nan;0;0
11990;201530;136;0;0;0;0;.00nan;0;0
11990;201666;1340;51;23;4;19;.826;3600000;0
11990;-1;136;81;29;1;28;.966;3600000;0
11991;-1;130;40;9;2;7;.778;422000;0
11991;-1;131;0;0;0;0;.00nan;0;0
11991;197759;130;44;36;5;31;.861;3178000;0
11991;-1;131;72;26;2;24;.923;3600000;0
11992;196012;128;69;33;4;29;.879;3900000;0
11992;196287;132;0;0;0;0;.00nan;0;0
11992;196809;132;84;42;4;38;.905;3900000;0
11992;-1;128;0;0;0;0;.00nan;0;0
11993;192895;143;72;35;3;32;.914;3564000;0
11993;194197;143;0;0;0;0;.00nan;0;0
11993;201673;141;84;33;2;31;.939;3600000;0
11993;197756;141;0;0;0;0;.00nan;0;0
11994;192847;144;0;0;0;0;.00nan;0;0
11994;208575;142;0;0;0;0;.00nan;0;0
11994;189944;144;43;30;5;25;.833;3600000;0
11994;196456;142;92;37;1;36;.973;3600000;0
11995;199437;134;89;48;4;44;.917;3579000;0
11995;195169;129;52;15;3;12;.800;3600000;0
11995;-1;129;0;0;0;0;.00nan;0;0
11995;-1;134;0;0;0;0;.00nan;0;0
11996;198081;133;0;0;0;0;.00nan;0;0
11996;196012;128;67;25;2;23;.920;3600000;0
11996;202059;133;54;32;4;28;.875;3580000;0
11996;-1;128;0;0;0;0;.00nan;0;0
11997;196287;132;0;0;0;0;.00nan;0;0
11997;196809;132;61;25;2;23;.920;3600000;0
11997;-1;130;0;0;0;0;.00nan;0;0
11997;197759;130;75;42;4;38;.905;3576000;0
11998;199701;138;0;0;0;0;.00nan;0;0
11998;194393;1340;0;0;0;0;.00nan;0;0
11998;201666;1340;63;18;1;17;.944;3600000;0
11998;-1;138;80;26;2;24;.923;3563000;0
11999;199437;134;48;0;0;0;.00nan;245000;0
11999;195169;129;77;34;4;30;.882;3600000;0
11999;-1;129;0;0;0;0;.00nan;0;0
11999;-1;134;39;35;6;29;.829;3294000;0
12000;203288;135;58;32;4;28;.875;3600000;0
12000;208556;135;0;0;0;0;.00nan;0;0
12000;201530;136;0;0;0;0;.00nan;0;0
12000;-1;136;80;24;1;23;.958;3600000;0
12001;198081;133;26;13;4;9;.692;2063000;0
12001;196012;128;0;0;0;0;.00nan;0;0
12001;202059;133;32;15;4;11;.733;1537000;0
12001;-1;128;99;41;2;39;.951;3600000;0
12002;194264;137;37;25;5;20;.800;3628000;0
12002;-1;130;84;48;4;44;.917;3628000;0
12002;-1;137;0;0;0;0;.00nan;0;0
12002;197759;130;0;0;0;0;.00nan;0;0
12003;192895;143;0;0;0;0;.00nan;0;0
12003;194197;143;79;40;3;37;.925;3600000;0
12003;201673;141;0;0;0;0;.00nan;0;0
12003;197756;141;26;34;7;27;.794;3600000;0
12004;203276;139;53;30;4;26;.867;3600000;0
12004;192889;139;0;0;0;0;.00nan;0;0
12004;196445;140;68;40;5;35;.875;3563000;0
12004;196812;140;0;0;0;0;.00nan;0;0
12005;196287;132;70;37;3;34;.919;3858000;0
12005;196809;132;0;0;0;0;.00nan;0;0
12005;-1;131;62;31;4;27;.871;3858000;0
12005;-1;131;0;0;0;0;.00nan;0;0
12006;208575;142;0;0;0;0;.00nan;0;0
12006;196445;140;0;0;0;0;.00nan;0;0
12006;196456;142;54;26;4;22;.846;3767000;0
12006;196812;140;85;40;3;37;.925;3767000;0
12007;203276;139;0;0;0;0;.00nan;0;0
12007;192847;144;0;0;0;0;.00nan;0;0
12007;192889;139;35;23;4;19;.826;3539000;0
12007;189944;144;72;24;2;22;.917;3600000;0
12008;203288;135;0;0;0;0;.00nan;0;0
12008;208556;135;85;38;3;35;.921;3580000;0
12008;201530;136;61;21;2;19;.905;3600000;0
12008;-1;136;0;0;0;0;.00nan;0;0
12009;194264;137;0;0;0;0;.00nan;0;0
12009;-1;137;38;26;5;21;.808;3535000;0
12009;-1;131;0;0;0;0;.00nan;0;0
12009;-1;131;94;49;3;46;.939;3600000;0
12010;199701;138;0;0;0;0;.00nan;0;0
12010;194393;1340;54;24;3;21;.875;3542000;0
12010;201666;1340;0;0;0;0;.00nan;0;0
12010;-1;138;87;39;2;37;.949;3600000;0
12011;199437;134;66;37;5;32;.865;3529000;0
12011;201530;136;0;0;0;0;.00nan;0;0
12011;-1;134;0;0;0;0;.00nan;0;0
12011;-1;136;72;32;3;29;.906;3600000;0
12012;203288;135;71;47;4;43;.915;3600000;0
12012;198081;133;0;0;0;0;.00nan;0;0
12012;208556;135;0;0;0;0;.00nan;0;0
12012;202059;133;99;24;0;24;1.000;3600000;0
12013;194393;1340;0;0;0;0;.00nan;0;0
12013;201666;1340;53;18;3;15;.833;3900000;0
12013;-1;130;0;0;0;0;.00nan;0;0
12013;197759;130;95;58;3;55;.948;3900000;0
12014;199701;138;0;0;0;0;.00nan;0;0
12014;-1;131;0;0;0;0;.00nan;0;0
12014;-1;131;54;32;4;28;.875;3600000;0
12014;-1;138;26;28;6;22;.786;3586000;0
12015;203276;139;91;52;4;48;.923;3558000;0
12015;192889;139;0;0;0;0;.00nan;0;0
12015;192895;143;57;21;3;18;.857;3600000;0
12015;194197;143;0;0;0;0;.00nan;0;0
12016;192847;144;46;28;4;24;.857;3600000;0
12016;189944;144;0;0;0;0;.00nan;0;0
12016;196445;140;0;0;0;0;.00nan;0;0
12016;196812;140;51;46;7;39;.848;3600000;0
12017;208575;142;0;0;0;0;.00nan;0;0
12017;201673;141;35;7;3;4;.571;589000;0
12017;196456;142;50;34;5;29;.853;3552000;0
12017;197756;141;73;23;1;22;.957;3011000;0
12018;194264;137;57;16;2;14;.875;3600000;0
12018;-1;137;0;0;0;0;.00nan;0;0
12018;-1;131;61;36;5;31;.861;3600000;0
12018;-1;131;0;0;0;0;.00nan;0;0
12019;199701;138;53;22;3;19;.864;3600000;0
12019;196287;132;0;0;0;0;.00nan;0;0
12019;196809;132;71;37;4;33;.892;3582000;0
12019;-1;138;0;0;0;0;.00nan;0;0
12020;194264;137;0;0;0;0;.00nan;0;0
12020;-1;130;0;0;0;0;.00nan;0;0
12020;-1;137;64;20;2;18;.900;3600000;0
12020;197759;130;82;46;4;42;.913;3557000;0
12021;198081;133;0;0;0;0;.00nan;0;0
12021;196287;132;0;0;0;0;.00nan;0;0
12021;202059;133;51;33;4;29;.879;3569000;0
12021;196809;132;100;45;2;43;.956;3600000;0
12022;203288;135;0;0;0;0;.00nan;0;0
12022;208556;135;83;28;2;26;.929;3600000;0
12022;199437;134;71;32;4;28;.875;3528000;0
12022;-1;134;0;0;0;0;.00nan;0;0
12023;194393;1340;46;6;1;5;.833;953000;0
12023;201666;1340;23;24;6;18;.750;2617000;0
12023;196012;128;42;29;5;24;.828;3600000;0
12023;-1;128;0;0;0;0;.00nan;0;0
12024;208575;142;0;0;0;0;.00nan;0;0
12024;192895;143;78;32;3;29;.906;3600000;0
12024;194197;143;0;0;0;0;.00nan;0;0
12024;196456;142;34;30;6;24;.800;3600000;0
12025;199437;134;0;0;0;0;.00nan;0;0
12025;201530;136;0;0;0;0;.00nan;0;0
12025;-1;134;97;36;2;34;.944;3600000;0
12025;-1;136;62;37;4;33;.892;3582000;0
12026;195169;129;74;32;3;29;.906;3600000;0
12026;-1;131;81;40;3;37;.925;3323000;0
12026;-1;129;0;0;0;0;.00nan;0;0
12026;-1;131;23;4;3;1;.250;277000;0
12027;196012;128;0;0;0;0;.00nan;0;0
12027;-1;130;0;0;0;0;.00nan;0;0
12027;197759;130;88;43;3;40;.930;3575000;0
12027;-1;128;71;28;2;26;.929;3600000;0
12028;198081;133;31;8;3;5;.625;311000;0
12028;194393;1340;72;26;3;23;.885;3600000;0
12028;201666;1340;0;0;0;0;.00nan;0;0
12028;202059;133;45;34;5;29;.853;3289000;0
12029;203276;139;65;26;2;24;.923;3515000;0
12029;192847;144;0;0;0;0;.00nan;0;0
12029;192889;139;0;0;0;0;.00nan;0;0
12029;189944;144;100;26;0;26;1.000;3600000;0
12030;201673;141;73;47;4;43;.915;3600000;0
12030;196445;140;100;26;0;26;1.000;3600000;0
12030;196812;140;0;0;0;0;.00nan;0;0
12030;197756;141;0;0;0;0;.00nan;0;0
12031;201673;141;0;0;0;0;.00nan;0;0
12031;196445;140;30;30;6;24;.800;1660000;0
12031;196812;140;65;19;1;18;.947;1940000;0
12031;197756;141;59;12;1;11;.917;3600000;0
12032;194264;137;89;34;1;33;.971;3600000;0
12032;195169;129;0;0;0;0;.00nan;0;0
12032;-1;137;0;0;0;0;.00nan;0;0
12032;-1;129;67;30;3;27;.900;3557000;0
12033;201530;136;31;9;3;6;.667;455000;0
12033;196287;132;0;0;0;0;.00nan;0;0
12033;196809;132;97;39;1;38;.974;3600000;0
12033;-1;136;66;41;5;36;.878;3145000;0
12034;203276;139;0;0;0;0;.00nan;0;0
12034;192889;139;77;47;4;43;.915;3562000;0
12034;192895;143;0;0;0;0;.00nan;0;0
12034;194197;143;38;15;3;12;.800;3600000;0
12035;203288;135;88;37;1;36;.973;3600000;0
12035;208556;135;0;0;0;0;.00nan;0;0
12035;199701;138;65;17;1;16;.941;1804000;0
12035;-1;138;13;24;7;17;.708;1796000;0
12036;194393;1340;0;0;0;0;.00nan;0;0
12036;201666;1340;68;37;4;33;.892;3600000;0
12036;196287;132;0;0;0;0;.00nan;0;0
12036;196809;132;68;29;2;27;.931;3600000;0
12037;208575;142;0;0;0;0;.00nan;0;0
12037;196445;140;0;0;0;0;.00nan;0;0
12037;196456;142;70;33;3;30;.909;3900000;0
12037;196812;140;86;42;3;39;.929;3900000;0
12038;203276;139;52;31;4;27;.871;3600000;0
12038;192889;139;0;0;0;0;.00nan;0;0
12038;201673;141;93;22;0;22;1.000;3600000;0
12038;197756;141;0;0;0;0;.00nan;0;0
12039;199437;134;66;40;5;35;.875;3526000;0
12039;196012;128;83;36;3;33;.917;3600000;0
12039;-1;134;0;0;0;0;.00nan;0;0
12039;-1;128;0;0;0;0;.00nan;0;0
12040;-1;130;0;0;0;0;.00nan;0;0
12040;-1;131;0;0;0;0;.00nan;0;0
12040;197759;130;86;42;3;39;.929;3900000;0
12040;-1;131;64;32;3;29;.906;3900000;0
12041;199701;138;66;14;1;13;.929;2000000;0
12041;194264;137;67;33;4;29;.879;3600000;0
12041;-1;137;0;0;0;0;.00nan;0;0
12041;-1;138;21;27;6;21;.778;1600000;0
12042;194264;137;0;0;0;0;.00nan;0;0
12042;196012;128;0;0;0;0;.00nan;0;0
12042;-1;137;76;45;5;40;.889;3600000;0
12042;-1;128;91;32;1;31;.969;3600000;0
12043;203276;139;98;48;2;46;.958;3546000;0
12043;208575;142;0;0;0;0;.00nan;0;0
12043;192889;139;0;0;0;0;.00nan;0;0
12043;196456;142;71;23;1;22;.957;3600000;0
12044;192847;144;0;0;0;0;.00nan;0;0
12044;189944;144;62;46;6;40;.870;3600000;0
12044;201673;141;69;26;2;24;.923;3600000;0
12044;197756;141;0;0;0;0;.00nan;0;0
12045;192895;143;47;11;2;9;.818;3600000;0
12045;194197;143;0;0;0;0;.00nan;0;0
12045;196445;140;0;0;0;0;.00nan;0;0
12045;196812;140;52;34;5;29;.853;3600000;0
12046;201530;136;0;0;0;0;.00nan;0;0
12046;196287;132;0;0;0;0;.00nan;0;0
12046;196809;132;81;33;2;31;.939;3600000;0
12046;-1;136;64;26;3;23;.885;3552000;0
12047;198081;133;64;40;5;35;.875;3600000;0
12047;199437;134;92;39;2;37;.949;3600000;0
12047;202059;133;0;0;0;0;.00nan;0;0
12047;-1;134;0;0;0;0;.00nan;0;0
12048;199701;138;0;0;0;0;.00nan;0;0
12048;-1;131;78;33;2;31;.939;3600000;0
12048;-1;131;0;0;0;0;.00nan;0;0
12048;-1;138;42;35;6;29;.829;3600000;0
12049;195169;129;51;20;4;16;.800;3600000;0
12049;-1;130;54;18;2;16;.889;1372000;0
12049;197759;130;52;41;6;35;.854;2228000;0
12049;-1;129;0;0;0;0;.00nan;0;0
12050;203288;135;98;45;3;42;.933;3600000;0
12050;208556;135;0;0;0;0;.00nan;0;0
12050;194393;1340;0;0;0;0;.00nan;0;0
12050;201666;1340;85;21;1;20;.952;3600000;0
12051;203276;139;0;0;0;0;.00nan;0;0
12051;208575;142;57;37;4;33;.892;3900000;0
12051;192889;139;48;28;4;24;.857;3900000;0
12051;196456;142;0;0;0;0;.00nan;0;0
12052;192895;143;0;0;0;0;.00nan;0;0
12052;194197;143;26;23;6;17;.739;3600000;0
12052;196445;140;96;57;3;54;.947;3600000;0
12052;196812;140;0;0;0;0;.00nan;0;0
12053;192847;144;71;47;5;42;.894;3600000;0
12053;189944;144;0;0;0;0;.00nan;0;0
12053;201673;141;0;0;0;0;.00nan;0;0
12053;197756;141;96;23;0;23;1.000;3600000;0
12054;198081;133;0;0;0;0;.00nan;0;0
12054;199437;134;0;0;0;0;.00nan;0;0
12054;202059;133;65;21;2;19;.905;3600000;0
12054;-1;134;74;38;4;34;.895;3577000;0
12055;203288;135;0;0;0;0;.00nan;0;0
12055;208556;135;70;20;1;19;.950;3600000;0
12055;196287;132;55;47;6;41;.872;3600000;0
12055;196809;132;0;0;0;0;.00nan;0;0
12056;194393;1340;53;19;3;16;.842;3547000;0
12056;201530;136;100;52;2;50;.962;3600000;0
12056;201666;1340;0;0;0;0;.00nan;0;0
12056;-1;136;0;0;0;0;.00nan;0;0
12057;195169;129;72;24;1;23;.958;3600000;0
12057;-1;131;48;0;0;0;.00nan;586000;0
12057;-1;129;0;0;0;0;.00nan;0;0
12057;-1;131;34;34;6;28;.824;3014000;0
12058;199701;138;44;26;4;22;.846;3600000;0
12058;-1;130;76;32;2;30;.938;3600000;0
12058;197759;130;0;0;0;0;.00nan;0;0
12058;-1;138;0;0;0;0;.00nan;0;0
12059;194264;137;41;36;6;30;.833;3514000;0
12059;196012;128;84;46;4;42;.913;3600000;0
12059;-1;137;0;0;0;0;.00nan;0;0
12059;-1;128;0;0;0;0;.00nan;0;0
12061;195169;129;16;22;6;16;.727;2818000;0
12061;196287;132;0;0;0;0;.00nan;0;0
12061;196809;132;51;34;5;29;.853;3600000;0
12061;-1;129;40;13;3;10;.769;782000;0
12063;192895;143;84;14;0;14;1.000;3600000;0
12063;194456;143;0;0;0;0;.00nan;0;0
12063;-1;130;68;10;0;10;1.000;455000;0
12063;197759;130;43;37;6;31;.838;3145000;0
12065;199437;134;32;23;5;18;.783;2399000;0
12065;194393;1340;0;0;0;0;.00nan;0;0
12065;201666;1340;83;30;2;28;.933;3600000;0
12065;-1;134;64;17;1;16;.941;1201000;0
12067;203276;139;59;25;3;22;.880;3558000;0
12067;208575;142;0;0;0;0;.00nan;0;0
12067;192889;139;0;0;0;0;.00nan;0;0
12067;196456;142;65;26;2;24;.923;3600000;0
12069;194264;137;70;39;3;36;.923;3900000;0
12069;196012;128;55;27;3;24;.889;3900000;0
12069;-1;137;0;0;0;0;.00nan;0;0
12069;-1;128;0;0;0;0;.00nan;0;0
12071;203288;135;83;42;3;39;.929;3557000;0
12071;194197;135;0;0;0;0;.00nan;0;0
12071;-1;131;0;0;0;0;.00nan;0;0
12071;-1;131;66;16;1;15;.938;3600000;0
12073;198081;133;0;0;0;0;.00nan;0;0
12073;192847;144;46;15;2;13;.867;2005000;0
12073;189944;144;38;33;6;27;.818;1595000;0
12073;202059;133;58;16;2;14;.875;3600000;0
12075;199701;138;0;0;0;0;.00nan;0;0
12075;201673;141;66;22;2;20;.909;3600000;0
12075;197756;141;0;0;0;0;.00nan;0;0
12075;-1;138;69;48;5;43;.896;3600000;0
12077;198091;136;0;0;0;0;.00nan;0;0
12077;201530;136;66;25;2;23;.920;3600000;0
12077;196445;140;0;0;0;0;.00nan;0;0
12077;196812;140;69;46;5;41;.891;3600000;0
12079;198081;133;0;0;0;0;.00nan;0;0
12079;202059;133;91;19;0;19;1.000;3600000;0
12079;-1;130;61;6;0;6;1.000;260000;0
12079;197759;130;54;48;6;42;.875;3340000;0
12081;203288;135;63;40;4;36;.900;3600000;0
12081;194197;135;0;0;0;0;.00nan;0;0
12081;194393;1340;55;18;2;16;.889;3600000;0
12081;201666;1340;0;0;0;0;.00nan;0;0
12083;208575;142;0;0;0;0;.00nan;0;0
12083;201673;141;74;36;4;32;.889;3834000;0
12083;196456;142;93;49;5;44;.898;3834000;0
12083;197756;141;0;0;0;0;.00nan;0;0
12085;198091;136;0;0;0;0;.00nan;0;0
12085;201530;136;77;36;3;33;.917;3900000;0
12085;196445;140;0;0;0;0;.00nan;0;0
12085;196812;140;67;32;3;29;.906;3900000;0
12087;192847;144;0;0;0;0;.00nan;0;0
12087;192895;143;99;21;0;21;1.000;3600000;0
12087;194456;143;0;0;0;0;.00nan;0;0
12087;189944;144;77;41;3;38;.927;3600000;0
12089;199437;134;68;33;3;30;.909;3600000;0
12089;196012;128;0;0;0;0;.00nan;0;0
12089;-1;134;0;0;0;0;.00nan;0;0
12089;-1;128;38;40;6;34;.850;3600000;0
12091;195169;129;42;18;3;15;.833;3571000;0
12091;-1;131;72;32;2;30;.938;3600000;0
12091;-1;129;0;0;0;0;.00nan;0;0
12091;-1;131;0;0;0;0;.00nan;0;0
12093;199701;138;0;0;0;0;.00nan;0;0
12093;196287;132;0;0;0;0;.00nan;0;0
12093;196809;132;84;27;2;25;.926;3668000;0
12093;-1;138;59;25;3;22;.880;3668000;0
12095;203276;139;95;45;2;43;.956;3600000;0
12095;192889;139;0;0;0;0;.00nan;0;0
12095;194264;137;43;18;3;15;.833;3545000;0
12095;-1;137;0;0;0;0;.00nan;0;0
12097;198091;136;60;36;4;32;.889;3600000;0
12097;201530;136;0;0;0;0;.00nan;0;0
12097;201673;141;0;0;0;0;.00nan;0;0
12097;197756;141;77;31;3;28;.903;3600000;0
12099;199701;138;60;31;4;27;.871;3882000;0
12099;-1;130;58;32;3;29;.906;3882000;0
12099;197759;130;0;0;0;0;.00nan;0;0
12099;-1;138;0;0;0;0;.00nan;0;0
12101;194264;137;0;0;0;0;.00nan;0;0
12101;-1;137;61;32;4;28;.875;3593000;0
12101;-1;131;0;0;0;0;.00nan;0;0
12101;-1;131;65;23;2;21;.913;3600000;0
12103;203288;135;0;0;0;0;.00nan;0;0
12103;192847;144;58;47;6;41;.872;3528000;0
12103;194197;135;69;35;4;31;.886;3600000;0
12103;189944;144;0;0;0;0;.00nan;0;0
12105;208575;142;70;36;4;32;.889;3600000;0
12105;195169;129;0;0;0;0;.00nan;0;0
12105;196456;142;0;0;0;0;.00nan;0;0
12105;-1;129;100;26;0;26;1.000;3600000;0
12107;203276;139;0;0;0;0;.00nan;0;0
12107;192889;139;62;34;3;31;.912;3804000;0
12107;196445;140;58;31;4;27;.871;3804000;0
12107;196812;140;0;0;0;0;.00nan;0;0
12109;198081;133;75;36;2;34;.944;3900000;0
12109;199437;134;0;0;0;0;.00nan;0;0
12109;202059;133;0;0;0;0;.00nan;0;0
12109;-1;134;80;36;2;34;.944;3900000;0
12111;192895;143;15;19;6;13;.684;1786000;0
12111;194393;1340;0;0;0;0;.00nan;0;0
12111;194456;143;82;14;0;14;1.000;1778000;0
12111;201666;1340;60;35;5;30;.857;3600000;0
12113;196012;128;66;24;2;22;.917;3600000;0
12113;196287;132;18;8;4;4;.500;772000;0
12113;196809;132;97;35;2;33;.943;2828000;0
12113;-1;128;0;0;0;0;.00nan;0;0
12115;199437;134;59;37;4;33;.892;3600000;0
12115;196445;140;0;0;0;0;.00nan;0;0
12115;196812;140;38;30;5;25;.833;3545000;0
12115;-1;134;0;0;0;0;.00nan;0;0
12117;192895;143;65;28;2;26;.929;3600000;0
12117;194456;143;0;0;0;0;.00nan;0;0
12117;196287;132;0;0;0;0;.00nan;0;0
12117;196809;132;67;45;5;40;.889;3600000;0
12119;199701;138;0;0;0;0;.00nan;0;0
12119;-1;130;0;0;0;0;.00nan;0;0
12119;197759;130;75;29;2;27;.931;3600000;0
12119;-1;138;68;35;3;32;.914;3565000;0
12121;203288;135;99;53;2;51;.962;3600000;0
12121;194197;135;0;0;0;0;.00nan;0;0
12121;194393;1340;39;17;3;14;.824;3557000;0
12121;201666;1340;0;0;0;0;.00nan;0;0
12123;201673;141;100;27;0;27;1.000;3600000;0
12123;196012;128;0;0;0;0;.00nan;0;0
12123;197756;141;0;0;0;0;.00nan;0;0
12123;-1;128;79;34;2;32;.941;3600000;0
12125;198081;133;0;0;0;0;.00nan;0;0
12125;195169;129;0;0;0;0;.00nan;0;0
12125;202059;133;74;36;3;33;.917;3600000;0
12125;-1;129;64;22;2;20;.909;3600000;0
12127;208575;142;42;23;4;19;.826;2268000;0
12127;194264;137;10;21;7;14;.667;2813000;0
12127;196456;142;51;10;1;9;.900;1332000;0
12127;-1;137;55;5;0;5;1.000;758000;0
12129;198091;136;0;0;0;0;.00nan;0;0
12129;192847;144;0;0;0;0;.00nan;0;0
12129;189944;144;34;40;7;33;.825;3600000;0
12129;201530;136;49;28;4;24;.857;3600000;0
12131;203276;139;56;40;5;35;.875;3568000;0
12131;192889;139;0;0;0;0;.00nan;0;0
12131;-1;131;42;23;4;19;.826;3600000;0
12131;-1;131;0;0;0;0;.00nan;0;0
12133;192847;144;67;32;3;29;.906;3600000;0
12133;194264;137;0;0;0;0;.00nan;0;0
12133;189944;144;0;0;0;0;.00nan;0;0
12133;-1;137;61;32;4;28;.875;3560000;0
12135;208575;142;0;0;0;0;.00nan;0;0
12135;199437;134;0;0;0;0;.00nan;0;0
12135;196456;142;97;42;2;40;.952;3600000;0
12135;-1;134;57;25;3;22;.880;3572000;0
12137;196012;128;62;26;3;23;.885;3600000;0
12137;-1;130;66;42;5;37;.881;3518000;0
12137;197759;130;0;0;0;0;.00nan;0;0
12137;-1;128;0;0;0;0;.00nan;0;0
12139;192895;143;56;14;2;12;.857;2469000;0
12139;194456;143;32;14;4;10;.714;1125000;0
12139;196287;132;51;37;5;32;.865;3600000;0
12139;196809;132;0;0;0;0;.00nan;0;0
12141;203288;135;0;0;0;0;.00nan;0;0
12141;199701;138;66;44;5;39;.886;3600000;0
12141;194197;135;60;20;2;18;.900;3600000;0
12141;-1;138;0;0;0;0;.00nan;0;0
12143;194393;1340;0;0;0;0;.00nan;0;0
12143;195169;129;62;32;3;29;.906;3600000;0
12143;201666;1340;33;26;6;20;.769;3600000;0
12143;-1;129;0;0;0;0;.00nan;0;0
12145;198091;136;89;32;2;30;.938;3600000;0
12145;201530;136;0;0;0;0;.00nan;0;0
12145;196445;140;25;36;8;28;.778;3138000;0
12145;196812;140;46;2;1;1;.500;462000;0
12147;203276;139;0;0;0;0;.00nan;0;0
12147;198081;133;65;23;2;21;.913;3600000;0
12147;192889;139;73;33;3;30;.909;3600000;0
12147;202059;133;0;0;0;0;.00nan;0;0
12149;201673;141;53;25;3;22;.880;3545000;0
12149;-1;131;0;0;0;0;.00nan;0;0
12149;197756;141;0;0;0;0;.00nan;0;0
12149;-1;131;68;26;2;24;.923;3600000;0
12151;194264;137;71;19;1;18;.947;3600000;0
12151;-1;130;0;0;0;0;.00nan;0;0
12151;-1;137;0;0;0;0;.00nan;0;0
12151;197759;130;58;43;5;38;.884;3600000;0
12153;192847;144;0;0;0;0;.00nan;0;0
12153;192895;143;31;16;4;12;.750;3900000;0
12153;194456;143;0;0;0;0;.00nan;0;0
12153;189944;144;85;45;4;41;.911;3890000;0
12155;195169;129;0;0;0;0;.00nan;0;0
12155;196287;132;0;0;0;0;.00nan;0;0
12155;196809;132;46;34;5;29;.853;3600000;0
12155;-1;129;81;21;1;20;.952;3600000;0
12157;199701;138;0;0;0;0;.00nan;0;0
12157;194393;1340;56;25;3;22;.880;3585000;0
12157;201666;1340;0;0;0;0;.00nan;0;0
12157;-1;138;72;31;2;29;.935;3600000;0
12159;199437;134;55;32;5;27;.844;3600000;0
12159;196445;140;0;0;0;0;.00nan;0;0
12159;196812;140;42;37;6;31;.838;3564000;0
12159;-1;134;0;0;0;0;.00nan;0;0
12161;198091;136;0;0;0;0;.00nan;0;0
12161;201530;136;71;27;2;25;.926;3795000;0
12161;196012;128;0;0;0;0;.00nan;0;0
12161;-1;128;88;43;3;40;.930;3795000;0
12163;203276;139;67;40;4;36;.900;3613000;0
12163;203288;135;25;21;5;16;.762;3613000;0
12163;192889;139;0;0;0;0;.00nan;0;0
12163;194197;135;0;0;0;0;.00nan;0;0
12165;198081;133;0;0;0;0;.00nan;0;0
12165;208575;142;79;31;2;29;.935;3600000;0
12165;196456;142;0;0;0;0;.00nan;0;0
12165;202059;133;74;35;3;32;.914;3554000;0
12167;201673;141;74;29;2;27;.931;3600000;0
12167;-1;131;63;32;3;29;.906;3600000;0
12167;197756;141;0;0;0;0;.00nan;0;0
12167;-1;131;0;0;0;0;.00nan;0;0
12169;196012;128;84;44;2;42;.955;3600000;0
12169;196445;140;77;36;3;33;.917;3545000;0
12169;196812;140;0;0;0;0;.00nan;0;0
12169;-1;128;0;0;0;0;.00nan;0;0
12171;208575;142;0;0;0;0;.00nan;0;0
12171;194264;137;0;0;0;0;.00nan;0;0
12171;196456;142;70;35;3;32;.914;3600000;0
12171;-1;137;37;22;4;18;.818;3600000;0
12173;203288;135;58;5;0;5;1.000;682000;0
12173;198081;133;52;17;2;15;.882;3600000;0
12173;194197;135;43;37;6;31;.838;2918000;0
12173;202059;133;0;0;0;0;.00nan;0;0
12175;201673;141;0;0;0;0;.00nan;0;0
12175;-1;130;18;31;7;24;.774;3326000;0
12175;197756;141;70;29;2;27;.931;3600000;0
12175;197759;130;52;3;0;3;1.000;274000;0
12177;192847;144;76;44;5;39;.886;3600000;0
12177;192895;143;0;0;0;0;.00nan;0;0
12177;194456;143;63;20;2;18;.900;3600000;0
12177;189944;144;0;0;0;0;.00nan;0;0
12179;194393;1340;0;0;0;0;.00nan;0;0
12179;201666;1340;51;25;4;21;.840;3600000;0
12179;196287;132;3;17;7;10;.588;1675000;0
12179;196809;132;61;15;1;14;.933;1925000;0
12181;199437;134;0;0;0;0;.00nan;0;0
12181;199701;138;24;15;4;11;.733;711000;0
12181;-1;134;45;21;4;17;.810;3600000;0
12181;-1;138;65;30;3;27;.900;2889000;0
12183;203276;139;68;11;0;11;1.000;1114000;0
12183;192889;139;21;26;6;20;.769;2486000;0
12183;195169;129;48;18;3;15;.833;3600000;0
12183;-1;129;0;0;0;0;.00nan;0;0
12185;198091;136;35;28;6;22;.786;3600000;0
12185;201530;136;0;0;0;0;.00nan;0;0
12185;-1;131;0;0;0;0;.00nan;0;0
12185;-1;131;87;42;3;39;.929;3600000;0
1305;192895;143;85;33;2;31;.939;3930000;0
1305;194197;143;0;0;0;0;.00nan;0;0
1305;-1;130;0;0;0;0;.00nan;0;0
1305;197759;130;94;54;3;51;.944;3930000;0
1306;198081;133;0;0;0;0;.00nan;0;0
1306;199701;138;0;0;0;0;.00nan;0;0
1306;202059;133;75;22;1;21;.955;3600000;0
1306;-1;138;61;50;6;44;.880;3600000;0
1307;203288;135;87;44;3;41;.932;3600000;0
1307;208556;135;0;0;0;0;.00nan;0;0
1307;196012;128;91;23;0;23;1.000;3600000;0
1307;-1;128;0;0;0;0;.00nan;0;0
1308;199437;134;55;26;3;23;.885;3545000;0
1308;194264;137;85;31;2;29;.935;3600000;0
1308;-1;137;0;0;0;0;.00nan;0;0
1308;-1;134;0;0;0;0;.00nan;0;0
1309;192847;144;0;0;0;0;.00nan;0;0
1309;189944;144;59;34;5;29;.853;3562000;0
1309;201673;141;54;24;3;21;.875;3600000;0
1309;197756;141;0;0;0;0;.00nan;0;0
1310;194393;1340;0;0;0;0;.00nan;0;0
1310;201530;136;32;30;6;24;.800;3213000;0
1310;201666;1340;42;21;4;17;.810;3600000;0
1310;-1;136;35;5;2;3;.600;387000;0
1311;208575;142;62;10;0;10;1.000;1630000;0
1311;196287;132;0;0;0;0;.00nan;0;0
1311;196456;142;19;15;5;10;.667;1970000;0
1311;196809;132;99;20;0;20;1.000;3600000;0
1312;195169;129;50;26;4;22;.846;3583000;0
1312;-1;131;0;0;0;0;.00nan;0;0
1312;-1;129;0;0;0;0;.00nan;0;0
1312;-1;131;70;35;3;32;.914;3600000;0
1313;192895;143;47;24;3;21;.875;3600000;0
1313;194197;143;0;0;0;0;.00nan;0;0
1313;-1;130;0;0;0;0;.00nan;0;0
1313;197759;130;67;40;4;36;.900;3596000;0
1314;198081;133;0;0;0;0;.00nan;0;0
1314;199701;138;0;0;0;0;.00nan;0;0
1314;202059;133;67;21;1;20;.952;3600000;0
1314;-1;138;64;43;5;38;.884;3600000;0
1315;203288;135;36;18;4;14;.778;1188000;0
1315;208556;135;38;23;4;19;.826;2412000;0
1315;196012;128;73;20;1;19;.950;3600000;0
1315;-1;128;0;0;0;0;.00nan;0;0
1316;199437;134;98;35;1;34;.971;3600000;0
1316;194264;137;86;34;2;32;.941;3563000;0
1316;-1;137;0;0;0;0;.00nan;0;0
1316;-1;134;0;0;0;0;.00nan;0;0
1317;192847;144;0;0;0;0;.00nan;0;0
1317;189944;144;56;34;5;29;.853;3600000;0
1317;201673;141;59;17;2;15;.882;3600000;0
1317;197756;141;0;0;0;0;.00nan;0;0
1318;194393;1340;0;0;0;0;.00nan;0;0
1318;201530;136;46;31;5;26;.839;3600000;0
1318;201666;1340;84;26;1;25;.962;3600000;0
1318;-1;136;0;0;0;0;.00nan;0;0
1319;208575;142;0;0;0;0;.00nan;0;0
1319;196287;132;0;0;0;0;.00nan;0;0
1319;196456;142;77;40;3;37;.925;3600000;0
1319;196809;132;58;29;4;25;.862;3560000;0
1320;195169;129;70;29;3;26;.897;3592000;0
1320;-1;131;0;0;0;0;.00nan;0;0
1320;-1;129;0;0;0;0;.00nan;0;0
1320;-1;131;76;27;1;26;.963;3600000;0
1321;192895;143;66;19;2;17;.895;3600000;0
1321;194197;143;0;0;0;0;.00nan;0;0
1321;-1;130;0;0;0;0;.00nan;0;0
1321;197759;130;67;43;5;38;.884;3600000;0
1322;198081;133;0;0;0;0;.00nan;0;0
1322;199701;138;0;0;0;0;.00nan;0;0
1322;202059;133;76;27;1;26;.963;3600000;0
1322;-1;138;82;37;3;34;.919;3577000;0
1323;203288;135;34;36;7;29;.806;3600000;0
1323;208556;135;0;0;0;0;.00nan;0;0
1323;196012;128;60;23;2;21;.913;3600000;0
1323;-1;128;0;0;0;0;.00nan;0;0
1324;199437;134;30;30;6;24;.800;3191000;0
1324;194264;137;70;28;2;26;.929;3600000;0
1324;-1;137;0;0;0;0;.00nan;0;0
1324;-1;134;50;8;1;7;.875;409000;0
1325;192847;144;62;10;0;10;1.000;1520000;0
1325;189944;144;30;20;5;15;.750;2028000;0
1325;201673;141;61;32;4;28;.875;3600000;0
1325;197756;141;0;0;0;0;.00nan;0;0
1326;194393;1340;0;0;0;0;.00nan;0;0
1326;201530;136;76;39;3;36;.923;3600000;0
1326;201666;1340;62;32;4;28;.875;3544000;0
1326;-1;136;0;0;0;0;.00nan;0;0
1327;208575;142;0;0;0;0;.00nan;0;0
1327;196287;132;0;0;0;0;.00nan;0;0
1327;196456;142;100;29;0;29;1.000;4052000;0
1327;196809;132;92;26;1;25;.962;4052000;0
1328;195169;129;77;32;2;30;.938;3543000;0
1328;-1;131;0;0;0;0;.00nan;0;0
1328;-1;129;0;0;0;0;.00nan;0;0
1328;-1;131;97;34;1;33;.971;3600000;0
1329;192895;143;31;18;5;13;.722;3515000;0
1329;194197;143;0;0;0;0;.00nan;0;0
1329;-1;130;0;0;0;0;.00nan;0;0
1329;197759;130;94;47;3;44;.936;3600000;0
1330;198081;133;0;0;0;0;.00nan;0;0
1330;199701;138;0;0;0;0;.00nan;0;0
1330;202059;133;40;27;5;22;.815;3600000;0
1330;-1;138;73;37;4;33;.892;3600000;0
1331;203288;135;73;33;3;30;.909;3553000;0
1331;208556;135;0;0;0;0;.00nan;0;0
1331;196012;128;74;30;2;28;.933;3600000;0
1331;-1;128;0;0;0;0;.00nan;0;0
1332;199437;134;99;36;1;35;.972;3600000;0
1332;194264;137;71;33;3;30;.909;3600000;0
1332;-1;137;0;0;0;0;.00nan;0;0
1332;-1;134;0;0;0;0;.00nan;0;0
1333;192847;144;0;0;0;0;.00nan;0;0
1333;189944;144;100;48;0;48;1.000;3600000;0
1333;201673;141;53;40;6;34;.850;3600000;0
1333;197756;141;0;0;0;0;.00nan;0;0
1334;194393;1340;0;0;0;0;.00nan;0;0
1334;201530;136;91;49;3;46;.939;4319000;0
1334;201666;1340;63;33;4;29;.879;4319000;0
1334;-1;136;0;0;0;0;.00nan;0;0
1335;208575;142;0;0;0;0;.00nan;0;0
1335;196287;132;0;0;0;0;.00nan;0;0
1335;196456;142;46;29;5;24;.828;3600000;0
1335;196809;132;65;24;2;22;.917;3600000;0
1336;195169;129;42;20;4;16;.800;3570000;0
1336;-1;131;0;0;0;0;.00nan;0;0
1336;-1;129;0;0;0;0;.00nan;0;0
1336;-1;131;76;38;3;35;.921;3600000;0
1573;192895;143;49;31;4;27;.871;3600000;0
1573;194197;143;0;0;0;0;.00nan;0;0
1573;-1;130;0;0;0;0;.00nan;0;0
1573;197759;130;66;35;3;32;.914;3600000;0
1574;198081;133;0;0;0;0;.00nan;0;0
1574;199701;138;0;0;0;0;.00nan;0;0
1574;202059;133;78;21;1;20;.952;3600000;0
1574;-1;138;73;43;4;39;.907;3600000;0
1575;199437;134;76;35;4;31;.886;3600000;0
1575;194264;137;84;26;2;24;.923;3600000;0
1575;-1;137;0;0;0;0;.00nan;0;0
1575;-1;134;0;0;0;0;.00nan;0;0
1576;192847;144;0;0;0;0;.00nan;0;0
1576;189944;144;77;34;2;32;.941;3724000;0
1576;201673;141;72;24;1;23;.958;3724000;0
1576;197756;141;0;0;0;0;.00nan;0;0
1577;194393;1340;0;0;0;0;.00nan;0;0
1577;201530;136;89;43;3;40;.930;3572000;0
1577;201666;1340;71;22;2;20;.909;3600000;0
1577;-1;136;0;0;0;0;.00nan;0;0
1578;208575;142;0;0;0;0;.00nan;0;0
1578;196287;132;0;0;0;0;.00nan;0;0
1578;196456;142;42;21;4;17;.810;3600000;0
1578;196809;132;57;35;5;30;.857;3552000;0
1625;192895;143;79;26;2;24;.923;3600000;0
1625;194197;143;0;0;0;0;.00nan;0;0
1625;-1;130;48;31;5;26;.839;2628000;0
1625;197759;130;28;13;4;9;.692;972000;0
1626;199437;134;91;34;1;33;.971;3600000;0
1626;194264;137;60;34;4;30;.882;3600000;0
1626;-1;137;0;0;0;0;.00nan;0;0
1626;-1;134;0;0;0;0;.00nan;0;0
1627;194393;1340;0;0;0;0;.00nan;0;0
1627;201530;136;66;38;4;34;.895;3588000;0
1627;201666;1340;68;16;1;15;.938;3600000;0
1627;-1;136;0;0;0;0;.00nan;0;0
1628;208575;142;0;0;0;0;.00nan;0;0
1628;196287;132;0;0;0;0;.00nan;0;0
1628;196456;142;77;11;0;11;1.000;3600000;0
1628;196809;132;66;32;4;28;.875;3600000;0
1653;199437;134;86;31;1;30;.968;3600000;0
1653;194264;137;77;25;2;23;.920;3547000;0
1653;-1;137;0;0;0;0;.00nan;0;0
1653;-1;134;0;0;0;0;.00nan;0;0
1687;192895;143;81;24;1;23;.958;3600000;0
1687;199437;134;44;45;7;38;.844;2990000;0
1687;194197;143;0;0;0;0;.00nan;0;0
1687;-1;134;40;8;2;6;.750;610000;0
1688;196012;128;78;29;1;28;.966;3600000;0
1688;-1;131;0;0;0;0;.00nan;0;0
1688;-1;131;86;35;2;33;.943;3543000;0
1688;-1;128;0;0;0;0;.00nan;0;0
1689;194393;1340;0;0;0;0;.00nan;0;0
1689;201666;1340;71;30;2;28;.933;3565000;0
1689;201673;141;94;35;1;34;.971;3600000;0
1689;197756;141;0;0;0;0;.00nan;0;0
1690;198081;133;0;0;0;0;.00nan;0;0
1690;208575;142;0;0;0;0;.00nan;0;0
1690;196456;142;14;29;7;22;.759;3600000;0
1690;202059;133;76;22;1;21;.955;3600000;0
1691;192895;143;87;24;1;23;.958;3600000;0
1691;199437;134;49;35;4;31;.886;3600000;0
1691;194197;143;0;0;0;0;.00nan;0;0
1691;-1;134;0;0;0;0;.00nan;0;0
1692;196012;128;75;29;3;26;.897;3600000;0
1692;-1;131;0;0;0;0;.00nan;0;0
1692;-1;131;87;37;2;35;.946;3600000;0
1692;-1;128;0;0;0;0;.00nan;0;0
1693;194393;1340;0;0;0;0;.00nan;0;0
1693;201666;1340;60;40;4;36;.900;4256000;0
1693;201673;141;52;27;3;24;.889;4256000;0
1693;197756;141;0;0;0;0;.00nan;0;0
1694;198081;133;51;4;0;4;1.000;657000;0
1694;208575;142;0;0;0;0;.00nan;0;0
1694;196456;142;87;54;5;49;.907;3600000;0
1694;202059;133;26;26;6;20;.769;2941000;0
1695;192895;143;47;17;3;14;.824;3600000;0
1695;199437;134;71;42;4;38;.905;3600000;0
1695;194197;143;0;0;0;0;.00nan;0;0
1695;-1;134;0;0;0;0;.00nan;0;0
1696;196012;128;82;35;3;32;.914;3600000;0
1696;-1;131;0;0;0;0;.00nan;0;0
1696;-1;131;57;42;5;37;.881;3600000;0
1696;-1;128;0;0;0;0;.00nan;0;0
1697;194393;1340;40;3;1;2;.667;913000;0
1697;201666;1340;26;27;6;21;.778;2655000;0
1697;201673;141;47;34;5;29;.853;3600000;0
1697;197756;141;0;0;0;0;.00nan;0;0
1698;198081;133;0;0;0;0;.00nan;0;0
1698;208575;142;0;0;0;0;.00nan;0;0
1698;196456;142;65;47;6;41;.872;3638000;0
1698;202059;133;42;29;5;24;.828;3603000;0
1699;192895;143;60;27;3;24;.889;3580000;0
1699;199437;134;92;34;2;32;.941;3600000;0
1699;194197;143;0;0;0;0;.00nan;0;0
1699;-1;134;0;0;0;0;.00nan;0;0
1700;196012;128;58;22;3;19;.864;3600000;0
1700;-1;131;0;0;0;0;.00nan;0;0
1700;-1;131;65;41;5;36;.878;3548000;0
1700;-1;128;0;0;0;0;.00nan;0;0
1701;194393;1340;99;40;1;39;.975;3600000;0
1701;201666;1340;0;0;0;0;.00nan;0;0
1701;201673;141;64;21;2;19;.905;3548000;0
1701;197756;141;0;0;0;0;.00nan;0;0
1702;198081;133;0;0;0;0;.00nan;0;0
1702;208575;142;0;0;0;0;.00nan;0;0
1702;196456;142;66;53;5;48;.906;4144000;0
1702;202059;133;29;33;6;27;.818;4144000;0
1911;192895;143;41;24;4;20;.833;3599000;0
1911;199437;134;65;25;3;22;.880;3600000;0
1911;194197;143;0;0;0;0;.00nan;0;0
1911;-1;134;0;0;0;0;.00nan;0;0
1912;196012;128;37;13;3;10;.769;3600000;0
1912;-1;131;0;0;0;0;.00nan;0;0
1912;-1;131;11;37;9;28;.757;3600000;0
1912;-1;128;0;0;0;0;.00nan;0;0
1913;194393;1340;89;33;1;32;.970;3600000;0
1913;201666;1340;0;0;0;0;.00nan;0;0
1913;201673;141;81;42;3;39;.929;3600000;0
1913;197756;141;0;0;0;0;.00nan;0;0
1914;198081;133;0;0;0;0;.00nan;0;0
1914;208575;142;0;0;0;0;.00nan;0;0
1914;196456;142;70;31;3;28;.903;3567000;0
1914;202059;133;72;29;2;27;.931;3600000;0
12212;190034;217;0;0;0;0;.00nan;0;0
12212;190041;217;76;41;3;38;.927;3526000;0
12212;-1;180;65;17;1;16;.941;3600000;0
12212;197707;180;0;0;0;0;.00nan;0;0
12209;187628;227;0;0;0;0;.00nan;0;0
12209;183695;232;64;23;2;21;.913;3600000;0
12209;-1;227;59;32;3;29;.906;3596000;0
12209;179691;232;0;0;0;0;.00nan;0;0
12202;201560;202;81;26;1;25;.962;3600000;0
12202;196299;202;0;0;0;0;.00nan;0;0
12202;185743;201;60;40;4;36;.900;3600000;0
12202;-1;201;0;0;0;0;.00nan;0;0
12207;195238;200;0;0;0;0;.00nan;0;0
12207;175370;199;80;23;1;22;.957;3600000;0
12207;187295;200;72;43;5;38;.884;3600000;0
12207;161006;199;0;0;0;0;.00nan;0;0
12204;169226;186;66;45;5;40;.889;3600000;0
12204;182128;215;66;29;3;26;.897;3600000;0
12204;185778;186;0;0;0;0;.00nan;0;0
12204;-1;215;0;0;0;0;.00nan;0;0
12203;201495;213;95;28;1;27;.964;3582000;0
12203;192461;210;0;0;0;0;.00nan;0;0
12203;197672;210;86;16;0;16;1.000;3600000;0
12203;203029;213;0;0;0;0;.00nan;0;0
12205;170351;194;86;40;2;38;.950;3600000;0
12205;179647;195;14;6;4;2;.333;788000;0
12205;-1;194;0;0;0;0;.00nan;0;0
12205;191849;195;63;11;0;11;1.000;2741000;0
12213;184069;208;0;0;0;0;.00nan;0;0
12213;189902;204;74;31;3;28;.903;3600000;0
12213;184712;204;0;0;0;0;.00nan;0;0
12213;179702;208;86;27;1;26;.963;3600000;0
12355;182454;4864;60;28;3;25;.893;3576000;0
12355;183737;4864;0;0;0;0;.00nan;0;0
12355;184907;4959;0;0;0;0;.00nan;0;0
12355;-1;4959;94;29;1;28;.966;3600000;0
12371;-1;203;73;30;2;28;.933;3600000;0
12371;201524;205;72;23;2;21;.913;2746000;0
12371;-1;203;0;0;0;0;.00nan;0;0
12371;-1;205;31;11;4;7;.636;854000;0
12217;194893;191;76;21;1;20;.952;3600000;0
12217;201892;191;0;0;0;0;.00nan;0;0
12217;192547;190;0;0;0;0;.00nan;0;0
12217;197704;190;97;48;2;46;.958;3545000;0
12375;173770;193;0;0;0;0;.00nan;0;0
12375;-1;189;75;36;3;33;.917;3600000;0
12375;186451;193;77;25;1;24;.960;3600000;0
12375;-1;189;0;0;0;0;.00nan;0;0
12432;183678;1505;0;0;0;0;.00nan;0;0
12432;-1;216;0;0;0;0;.00nan;0;0
12432;186549;1505;71;15;1;14;.933;3600000;0
12432;187240;216;69;41;4;37;.902;3600000;0
12609;175354;228;58;22;2;20;.909;1575000;0
12609;180377;228;31;23;5;18;.783;2025000;0
12609;181338;230;0;0;0;0;.00nan;0;0
12609;186495;230;75;19;1;18;.947;3600000;0
12278;-1;181;58;23;3;20;.870;3600000;0
12278;-1;214;96;23;0;23;1.000;3600000;0
12278;191518;214;0;0;0;0;.00nan;0;0
12278;192552;181;0;0;0;0;.00nan;0;0
12243;-1;207;71;31;3;28;.903;3600000;0
12243;-1;206;15;28;7;21;.750;2231000;0
12243;-1;207;0;0;0;0;.00nan;0;0
12243;202998;206;58;6;0;6;1.000;1369000;0
12263;195251;4949;77;32;3;29;.906;3600000;0
12263;196571;177;87;32;2;30;.938;3600000;0
12263;197685;4949;0;0;0;0;.00nan;0;0
12263;-1;177;0;0;0;0;.00nan;0;0
12195;174325;197;0;0;0;0;.00nan;0;0
12195;184648;196;43;20;4;16;.800;3600000;0
12195;201585;197;51;38;5;33;.868;3557000;0
12195;191118;196;0;0;0;0;.00nan;0;0
12186;-1;1371;0;0;0;0;.00nan;0;0
12186;190125;184;85;24;1;23;.958;3600000;0
12186;179668;184;0;0;0;0;.00nan;0;0
12186;192688;1371;59;30;4;26;.867;3600000;0
12189;194219;4960;0;0;0;0;.00nan;0;0
12189;173219;4960;76;30;2;28;.933;3600000;0
12189;191120;223;42;28;4;24;.857;3600000;0
12189;187118;223;0;0;0;0;.00nan;0;0
12187;-1;183;96;22;0;22;1.000;3600000;0
12187;182089;183;0;0;0;0;.00nan;0;0
12187;-1;178;76;43;3;40;.930;3600000;0
12187;-1;178;0;0;0;0;.00nan;0;0
12193;189081;187;45;30;5;25;.833;3580000;0
12193;173900;192;0;0;0;0;.00nan;0;0
12193;-1;192;83;33;3;30;.909;3600000;0
12193;-1;187;0;0;0;0;.00nan;0;0
12191;200452;221;0;0;0;0;.00nan;0;0
12191;185800;229;39;24;5;19;.792;3543000;0
12191;185960;229;0;0;0;0;.00nan;0;0
12191;187362;221;73;33;3;30;.909;3600000;0
12190;189773;231;0;0;0;0;.00nan;0;0
12190;189885;225;57;50;6;44;.880;3145000;0
12190;185034;231;73;9;0;9;1.000;3600000;0
12190;-1;225;51;2;0;2;1.000;455000;0
12197;179169;209;0;0;0;0;.00nan;0;0
12197;176932;176;73;46;4;42;.913;3549000;0
12197;182006;176;0;0;0;0;.00nan;0;0
12197;186205;209;69;29;3;26;.897;3600000;0
12188;173549;219;55;23;2;21;.913;3564000;0
12188;179679;212;0;0;0;0;.00nan;0;0
12188;181102;219;0;0;0;0;.00nan;0;0
12188;186641;212;91;20;0;20;1.000;3600000;0
12192;192915;179;0;0;0;0;.00nan;0;0
12192;-1;183;0;0;0;0;.00nan;0;0
12192;182089;183;60;41;5;36;.878;3600000;0
12192;-1;179;64;20;2;18;.900;3600000;0
12546;189902;204;71;21;1;20;.952;3600000;0
12546;184712;204;0;0;0;0;.00nan;0;0
12546;175370;199;40;15;3;12;.800;2494000;0
12546;161006;199;25;15;4;11;.733;1106000;0
12229;184069;208;54;19;2;17;.895;3600000;0
12229;201524;205;0;0;0;0;.00nan;0;0
12229;179702;208;0;0;0;0;.00nan;0;0
12229;-1;205;100;31;0;31;1.000;3600000;0
12321;173549;219;47;11;2;9;.818;1268000;0
12321;169226;186;4;14;6;8;.571;1814000;0
12321;181102;219;15;20;6;14;.700;2632000;0
12321;185778;186;59;20;2;18;.900;2086000;0
12255;195238;200;0;0;0;0;.00nan;0;0
12255;179452;226;0;0;0;0;.00nan;0;0
12255;187295;200;86;40;3;37;.925;3600000;0
12255;192629;226;70;23;2;21;.913;3600000;0
12269;189081;187;84;22;1;21;.955;3600000;0
12269;-1;189;79;31;2;29;.935;3575000;0
12269;-1;187;0;0;0;0;.00nan;0;0
12269;-1;189;0;0;0;0;.00nan;0;0
12249;195164;218;95;37;2;35;.946;3600000;0
12249;190034;217;46;30;5;25;.833;3600000;0
12249;190041;217;0;0;0;0;.00nan;0;0
12249;190095;218;0;0;0;0;.00nan;0;0
12782;187628;227;0;0;0;0;.00nan;0;0
12782;-1;227;53;39;5;34;.872;3600000;0
12782;184610;222;77;33;2;31;.939;3600000;0
12782;185851;222;0;0;0;0;.00nan;0;0
12456;173770;193;61;43;4;39;.907;3600000;0
12456;184788;198;57;26;3;23;.885;3600000;0
12456;181431;198;0;0;0;0;.00nan;0;0
12456;186451;193;0;0;0;0;.00nan;0;0
12297;175354;228;0;0;0;0;.00nan;0;0
12297;180377;228;91;33;2;31;.939;3600000;0
12297;185800;229;0;0;0;0;.00nan;0;0
12297;185960;229;57;40;5;35;.875;3600000;0
12240;-1;1371;0;0;0;0;.00nan;0;0
12240;-1;220;0;0;0;0;.00nan;0;0
12240;187443;220;75;24;1;23;.958;3554000;0
12240;192688;1371;100;29;0;29;1.000;3600000;0
12327;183678;1505;0;0;0;0;.00nan;0;0
12327;201495;213;75;39;3;36;.923;3557000;0
12327;186549;1505;70;27;2;25;.926;3600000;0
12327;203029;213;0;0;0;0;.00nan;0;0
12201;178394;188;0;0;0;0;.00nan;0;0
12201;173900;192;0;0;0;0;.00nan;0;0
12201;184409;188;47;15;3;12;.800;3900000;0
12201;-1;192;74;35;3;32;.914;3900000;0
12218;174325;197;0;0;0;0;.00nan;0;0
12218;184648;196;57;20;2;18;.900;3600000;0
12218;201585;197;53;41;6;35;.854;3600000;0
12218;191118;196;0;0;0;0;.00nan;0;0
12210;192461;210;63;18;2;16;.889;3600000;0
12210;197672;210;0;0;0;0;.00nan;0;0
12210;-1;178;49;31;5;26;.839;3600000;0
12210;-1;178;0;0;0;0;.00nan;0;0
12198;200452;221;0;0;0;0;.00nan;0;0
12198;184175;224;96;36;1;35;.972;3600000;0
12198;185840;224;0;0;0;0;.00nan;0;0
12198;187362;221;62;21;2;19;.905;3596000;0
12216;189773;231;0;0;0;0;.00nan;0;0
12216;185034;231;92;20;0;20;1.000;3600000;0
12216;191120;223;98;48;3;45;.938;3600000;0
12216;187118;223;0;0;0;0;.00nan;0;0
12214;200306;182;92;36;2;34;.944;3600000;0
12214;179388;182;0;0;0;0;.00nan;0;0
12214;190125;184;76;42;4;38;.905;3556000;0
12214;179668;184;0;0;0;0;.00nan;0;0
12194;192915;179;0;0;0;0;.00nan;0;0
12194;-1;216;0;0;0;0;.00nan;0;0
12194;-1;179;99;50;3;47;.940;3600000;0
12194;187240;216;47;33;5;28;.848;3572000;0
12223;-1;207;73;27;2;25;.926;3529000;0
12223;185743;201;100;36;0;36;1.000;3600000;0
12223;-1;207;0;0;0;0;.00nan;0;0
12223;-1;201;0;0;0;0;.00nan;0;0
12215;178394;188;0;0;0;0;.00nan;0;0
12215;184409;188;66;26;2;24;.923;3600000;0
12215;179647;195;45;26;4;22;.846;3543000;0
12215;191849;195;0;0;0;0;.00nan;0;0
12199;194219;4960;86;18;0;18;1.000;3600000;0
12199;173219;4960;0;0;0;0;.00nan;0;0
12199;184175;224;78;25;1;24;.960;3565000;0
12199;185840;224;0;0;0;0;.00nan;0;0
12266;195164;218;61;27;3;24;.889;3594000;0
12266;190095;218;0;0;0;0;.00nan;0;0
12266;179679;212;0;0;0;0;.00nan;0;0
12266;186641;212;100;38;1;37;.974;3600000;0
12206;170351;194;100;31;0;31;1.000;3600000;0
12206;-1;194;0;0;0;0;.00nan;0;0
12206;192547;190;0;0;0;0;.00nan;0;0
12206;197704;190;64;38;4;34;.895;3600000;0
12279;195251;4949;38;38;6;32;.842;3102000;0
12279;196571;177;63;24;2;22;.917;3600000;0
12279;197685;4949;55;4;0;4;1.000;498000;0
12279;-1;177;0;0;0;0;.00nan;0;0
12251;182128;215;0;0;0;0;.00nan;0;0
12251;-1;180;72;21;1;20;.952;3600000;0
12251;197707;180;0;0;0;0;.00nan;0;0
12251;-1;215;76;30;2;28;.933;3541000;0
12196;183695;232;25;22;5;17;.773;3578000;0
12196;189885;225;65;41;4;37;.902;3600000;0
12196;179691;232;0;0;0;0;.00nan;0;0
12196;-1;225;0;0;0;0;.00nan;0;0
12208;176932;176;0;0;0;0;.00nan;0;0
12208;184907;4959;0;0;0;0;.00nan;0;0
12208;182006;176;88;33;1;32;.970;3600000;0
12208;-1;4959;83;30;2;28;.933;3545000;0
12225;200306;182;77;24;1;23;.958;3600000;0
12225;179388;182;0;0;0;0;.00nan;0;0
12225;-1;181;69;30;2;28;.933;3600000;0
12225;192552;181;0;0;0;0;.00nan;0;0
12259;-1;220;0;0;0;0;.00nan;0;0
12259;187443;220;99;34;1;33;.971;3600000;0
12259;-1;214;86;49;3;46;.939;3600000;0
12259;191518;214;0;0;0;0;.00nan;0;0
12235;201560;202;67;15;1;14;.933;3600000;0
12235;196299;202;0;0;0;0;.00nan;0;0
12235;-1;206;47;29;4;25;.862;3600000;0
12235;202998;206;0;0;0;0;.00nan;0;0
12226;182454;4864;54;5;0;5;1.000;333000;0
12226;183737;4864;47;35;6;29;.829;3267000;0
12226;179169;209;0;0;0;0;.00nan;0;0
12226;186205;209;66;18;1;17;.944;3600000;0
12420;194893;191;60;26;3;23;.885;3543000;0
12420;184788;198;0;0;0;0;.00nan;0;0
12420;201892;191;0;0;0;0;.00nan;0;0
12420;181431;198;87;36;2;34;.944;3600000;0
12356;179452;226;0;0;0;0;.00nan;0;0
12356;201560;202;0;0;0;0;.00nan;0;0
12356;196299;202;68;34;3;31;.912;3562000;0
12356;192629;226;63;25;2;23;.920;3600000;0
12990;195251;4949;0;0;0;0;.00nan;0;0
12990;196571;177;0;0;0;0;.00nan;0;0
12990;197685;4949;92;43;3;40;.930;3900000;0
12990;-1;177;67;27;3;24;.889;3900000;0
12390;179169;209;0;0;0;0;.00nan;0;0
12390;184907;4959;87;39;3;36;.923;3524000;0
12390;186205;209;84;32;1;31;.969;3600000;0
12390;-1;4959;0;0;0;0;.00nan;0;0
12328;-1;216;26;30;7;23;.767;3600000;0
12328;-1;183;0;0;0;0;.00nan;0;0
12328;182089;183;79;42;3;39;.929;3600000;0
12328;187240;216;0;0;0;0;.00nan;0;0
12333;182467;185;0;0;0;0;.00nan;0;0
12333;-1;181;0;0;0;0;.00nan;0;0
12333;-1;185;85;30;1;29;.967;3600000;0
12333;192552;181;63;41;5;36;.878;3600000;0
12336;173549;219;0;0;0;0;.00nan;0;0
12336;181102;219;86;18;0;18;1.000;3600000;0
12336;182128;215;0;0;0;0;.00nan;0;0
12336;-1;215;55;34;5;29;.853;3600000;0
12292;179679;212;100;41;1;40;.976;3900000;0
12292;186641;212;0;0;0;0;.00nan;0;0
12292;-1;180;0;0;0;0;.00nan;0;0
12292;197707;180;69;19;1;18;.947;3900000;0
12290;170351;194;75;25;2;23;.920;3900000;0
12290;184648;196;85;38;2;36;.947;3900000;0
12290;-1;194;0;0;0;0;.00nan;0;0
12290;191118;196;0;0;0;0;.00nan;0;0
12300;189902;204;85;41;3;38;.927;3600000;0
12300;184712;204;0;0;0;0;.00nan;0;0
12300;-1;206;0;0;0;0;.00nan;0;0
12300;202998;206;54;29;4;25;.862;3585000;0
12453;201495;213;0;0;0;0;.00nan;0;0
12453;-1;178;0;0;0;0;.00nan;0;0
12453;203029;213;53;24;3;21;.875;3600000;0
12453;-1;178;100;31;0;31;1.000;3600000;0
12416;194893;191;0;0;0;0;.00nan;0;0
12416;-1;189;96;64;3;61;.953;3600000;0
12416;201892;191;61;16;2;14;.875;3600000;0
12416;-1;189;0;0;0;0;.00nan;0;0
12412;194219;4960;33;36;7;29;.806;3259000;0
12412;173219;4960;49;1;0;1;1.000;341000;0
12412;181338;230;0;0;0;0;.00nan;0;0
12412;186495;230;100;23;0;23;1.000;3600000;0
12285;195238;200;0;0;0;0;.00nan;0;0
12285;-1;207;0;0;0;0;.00nan;0;0
12285;187295;200;67;34;3;31;.912;3600000;0
12285;-1;207;34;24;5;19;.792;3555000;0
12200;189773;231;0;0;0;0;.00nan;0;0
12200;189885;225;0;0;0;0;.00nan;0;0
12200;185034;231;93;31;1;30;.968;3600000;0
12200;-1;225;90;40;3;37;.925;3581000;0
12230;182454;4864;0;0;0;0;.00nan;0;0
12230;183737;4864;43;43;7;36;.837;3600000;0
12230;176932;176;0;0;0;0;.00nan;0;0
12230;182006;176;39;18;3;15;.833;3600000;0
12227;189081;187;85;34;2;32;.941;3600000;0
12227;179647;195;0;0;0;0;.00nan;0;0
12227;191849;195;55;35;4;31;.886;3570000;0
12227;-1;187;0;0;0;0;.00nan;0;0
12253;184069;208;100;24;0;24;1.000;3600000;0
12253;179702;208;0;0;0;0;.00nan;0;0
12253;185743;201;80;31;2;29;.935;3513000;0
12253;-1;201;0;0;0;0;.00nan;0;0
12228;200452;221;77;25;1;24;.960;3600000;0
12228;185800;229;0;0;0;0;.00nan;0;0
12228;185960;229;91;43;2;41;.953;3543000;0
12228;187362;221;0;0;0;0;.00nan;0;0
12220;173770;193;75;24;2;22;.917;3600000;0
12220;174325;197;69;20;1;19;.950;2631000;0
12220;201585;197;24;12;4;8;.667;969000;0
12220;186451;193;0;0;0;0;.00nan;0;0
12252;169226;186;51;31;4;27;.871;3555000;0
12252;190034;217;80;33;3;30;.909;3600000;0
12252;190041;217;0;0;0;0;.00nan;0;0
12252;185778;186;0;0;0;0;.00nan;0;0
12246;-1;1371;0;0;0;0;.00nan;0;0
12246;190125;184;47;34;5;29;.853;3562000;0
12246;179668;184;0;0;0;0;.00nan;0;0
12246;192688;1371;46;25;4;21;.840;3600000;0
12221;187628;227;25;17;5;12;.706;807000;0
12221;-1;227;66;32;3;29;.906;2793000;0
12221;184610;222;77;28;2;26;.929;3600000;0
12221;185851;222;0;0;0;0;.00nan;0;0
12245;183695;232;0;0;0;0;.00nan;0;0
12245;179691;232;52;28;4;24;.857;3600000;0
12245;191120;223;0;0;0;0;.00nan;0;0
12245;187118;223;100;34;1;33;.971;3600000;0
12599;-1;203;73;34;3;31;.912;3569000;0
12599;201524;205;0;0;0;0;.00nan;0;0
12599;-1;203;0;0;0;0;.00nan;0;0
12599;-1;205;75;25;1;24;.960;3600000;0
12238;183678;1505;61;34;4;30;.882;3600000;0
12238;186549;1505;0;0;0;0;.00nan;0;0
12238;192461;210;46;35;6;29;.829;3550000;0
12238;197672;210;0;0;0;0;.00nan;0;0
12224;184788;198;0;0;0;0;.00nan;0;0
12224;181431;198;69;19;1;18;.947;3600000;0
12224;192547;190;0;0;0;0;.00nan;0;0
12224;197704;190;66;49;6;43;.878;3600000;0
13499;200306;182;46;45;6;39;.867;3536000;0
13499;179388;182;0;0;0;0;.00nan;0;0
13499;-1;214;42;24;4;20;.833;3600000;0
13499;191518;214;0;0;0;0;.00nan;0;0
13568;-1;211;53;35;5;30;.857;3600000;0
13568;195164;218;19;14;5;9;.643;1160000;0
13568;190095;218;85;30;1;29;.967;2438000;0
13568;179646;211;0;0;0;0;.00nan;0;0
12318;184175;224;65;47;6;41;.872;3600000;0
12318;181338;230;0;0;0;0;.00nan;0;0
12318;185840;224;0;0;0;0;.00nan;0;0
12318;186495;230;68;22;2;20;.909;3600000;0
12381;185800;229;0;0;0;0;.00nan;0;0
12381;185960;229;75;30;2;28;.933;3589000;0
12381;191120;223;99;41;1;40;.976;3600000;0
12381;187118;223;0;0;0;0;.00nan;0;0
12231;189081;187;79;21;1;20;.952;3600000;0
12231;170351;194;79;39;5;34;.872;3579000;0
12231;-1;194;0;0;0;0;.00nan;0;0
12231;-1;187;0;0;0;0;.00nan;0;0
12288;201562;2620;0;0;0;0;.00nan;0;0
12288;176932;176;0;0;0;0;.00nan;0;0
12288;182006;176;49;48;7;41;.854;3600000;0
12288;-1;2620;97;28;0;28;1.000;3600000;0
12393;-1;203;0;0;0;0;.00nan;0;0
12393;-1;203;68;25;1;24;.960;3600000;0
12393;185743;201;88;37;2;35;.946;3600000;0
12393;-1;201;0;0;0;0;.00nan;0;0
12441;-1;207;75;33;3;30;.909;3600000;0
12441;-1;206;39;25;4;21;.840;3548000;0
12441;-1;207;0;0;0;0;.00nan;0;0
12441;202998;206;0;0;0;0;.00nan;0;0
12417;169226;186;50;28;4;24;.857;3600000;0
12417;179679;212;72;16;0;16;1.000;1664000;0
12417;185778;186;0;0;0;0;.00nan;0;0
12417;186641;212;23;32;7;25;.781;1936000;0
12241;200452;221;0;0;0;0;.00nan;0;0
12241;189773;231;0;0;0;0;.00nan;0;0
12241;185034;231;67;17;1;16;.941;3600000;0
12241;187362;221;71;43;4;39;.907;3600000;0
12367;182467;185;87;33;1;32;.970;3600000;0
12367;-1;185;0;0;0;0;.00nan;0;0
12367;-1;214;0;0;0;0;.00nan;0;0
12367;191518;214;100;36;0;36;1.000;3600000;0
12384;-1;189;65;34;3;31;.912;3593000;0
12384;179647;195;70;23;2;21;.913;3600000;0
12384;191849;195;0;0;0;0;.00nan;0;0
12384;-1;189;0;0;0;0;.00nan;0;0
12293;-1;211;71;34;3;31;.912;3569000;0
12293;195164;218;78;29;1;28;.966;3600000;0
12293;190095;218;0;0;0;0;.00nan;0;0
12293;179646;211;0;0;0;0;.00nan;0;0
12364;201524;205;0;0;0;0;.00nan;0;0
12364;201560;202;99;27;0;27;1.000;3600000;0
12364;196299;202;0;0;0;0;.00nan;0;0
12364;-1;205;87;42;2;40;.952;3540000;0
13588;184175;224;97;44;2;42;.955;3568000;0
13588;175354;228;0;0;0;0;.00nan;0;0
13588;180377;228;62;16;1;15;.938;3600000;0
13588;185840;224;0;0;0;0;.00nan;0;0
12233;-1;183;0;0;0;0;.00nan;0;0
12233;196571;177;71;31;4;27;.871;3585000;0
12233;182089;183;73;39;3;36;.923;3600000;0
12233;-1;177;0;0;0;0;.00nan;0;0
12287;184069;208;66;26;2;24;.923;3600000;0
12287;195238;200;0;0;0;0;.00nan;0;0
12287;179702;208;0;0;0;0;.00nan;0;0
12287;187295;200;93;45;3;42;.933;3600000;0
12272;173770;193;73;20;1;19;.950;3600000;0
12272;184648;196;0;0;0;0;.00nan;0;0
12272;186451;193;0;0;0;0;.00nan;0;0
12272;191118;196;88;36;2;34;.944;3580000;0
12495;179169;209;0;0;0;0;.00nan;0;0
12495;184907;4959;0;0;0;0;.00nan;0;0
12495;186205;209;68;23;2;21;.913;3585000;0
12495;-1;4959;74;24;1;23;.958;3600000;0
12271;187628;227;0;0;0;0;.00nan;0;0
12271;194219;4960;78;33;2;31;.939;3900000;0
12271;173219;4960;0;0;0;0;.00nan;0;0
12271;-1;227;72;32;2;30;.938;3900000;0
12270;184788;198;0;0;0;0;.00nan;0;0
12270;181431;198;58;13;1;12;.923;3600000;0
12270;192547;190;92;54;3;51;.944;3521000;0
12270;197704;190;0;0;0;0;.00nan;0;0
12265;200306;182;0;0;0;0;.00nan;0;0
12265;179388;182;49;32;5;27;.844;3600000;0
12265;-1;220;100;23;0;23;1.000;3600000;0
12265;187443;220;0;0;0;0;.00nan;0;0
12341;178394;188;0;0;0;0;.00nan;0;0
12341;194893;191;93;38;1;37;.974;3600000;0
12341;184409;188;49;30;4;26;.867;3600000;0
12341;201892;191;0;0;0;0;.00nan;0;0
12260;173549;219;0;0;0;0;.00nan;0;0
12260;190034;217;71;42;3;39;.929;3569000;0
12260;190041;217;0;0;0;0;.00nan;0;0
12260;181102;219;65;22;1;21;.955;3600000;0
12915;182128;215;0;0;0;0;.00nan;0;0
12915;-1;180;46;12;3;9;.750;3600000;0
12915;197707;180;0;0;0;0;.00nan;0;0
12915;-1;215;65;45;5;40;.889;3600000;0
12261;-1;1371;0;0;0;0;.00nan;0;0
12261;190125;184;86;38;3;35;.921;3524000;0
12261;179668;184;0;0;0;0;.00nan;0;0
12261;192688;1371;73;21;1;20;.952;3600000;0
12329;175370;199;0;0;0;0;.00nan;0;0
12329;179452;226;60;32;4;28;.875;3545000;0
12329;192629;226;0;0;0;0;.00nan;0;0
12329;161006;199;61;32;3;29;.906;3600000;0
12211;192915;179;0;0;0;0;.00nan;0;0
12211;-1;179;64;21;2;19;.905;3600000;0
12211;-1;178;3;22;7;15;.682;1984000;0
12211;-1;178;81;22;0;22;1.000;1616000;0
12332;183695;232;35;23;4;19;.826;3900000;0
12332;184610;222;0;0;0;0;.00nan;0;0
12332;179691;232;0;0;0;0;.00nan;0;0
12332;185851;222;75;44;4;40;.909;3897000;0
12330;183678;1505;0;0;0;0;.00nan;0;0
12330;195251;4949;23;25;6;19;.760;1932000;0
12330;186549;1505;100;27;0;27;1.000;3600000;0
12330;197685;4949;50;22;3;19;.864;1668000;0
12358;201495;213;81;31;1;30;.968;3600000;0
12358;192461;210;52;28;4;24;.857;3600000;0
12358;197672;210;0;0;0;0;.00nan;0;0
12358;203029;213;0;0;0;0;.00nan;0;0
12701;173900;192;0;0;0;0;.00nan;0;0
12701;174325;197;48;7;1;6;.857;607000;0
12701;201585;197;64;52;6;46;.885;2993000;0
12701;-1;192;54;11;1;10;.909;3600000;0
13582;183678;1505;0;0;0;0;.00nan;0;0
13582;195251;4949;91;29;1;28;.966;3600000;0
13582;186549;1505;41;22;4;18;.818;3600000;0
13582;197685;4949;0;0;0;0;.00nan;0;0
12234;189081;187;0;0;0;0;.00nan;0;0
12234;-1;189;0;0;0;0;.00nan;0;0
12234;-1;187;56;19;2;17;.895;3600000;0
12234;-1;189;77;35;3;32;.914;3556000;0
12334;-1;207;70;26;2;24;.923;3600000;0
12334;-1;206;0;0;0;0;.00nan;0;0
12334;-1;207;0;0;0;0;.00nan;0;0
12334;202998;206;48;27;4;23;.852;3555000;0
12436;-1;216;0;0;0;0;.00nan;0;0
12436;187240;216;62;14;1;13;.929;3600000;0
12436;192461;210;0;0;0;0;.00nan;0;0
12436;197672;210;78;37;3;34;.919;3578000;0
13461;-1;203;65;21;2;19;.905;3600000;0
13461;-1;203;0;0;0;0;.00nan;0;0
13461;185743;201;0;0;0;0;.00nan;0;0
13461;-1;201;77;43;3;40;.930;3571000;0
12294;195238;200;0;0;0;0;.00nan;0;0
12294;201524;205;79;17;0;17;1.000;3600000;0
12294;-1;205;0;0;0;0;.00nan;0;0
12294;187295;200;68;29;3;26;.897;3600000;0
12301;184069;208;0;0;0;0;.00nan;0;0
12301;175370;199;0;0;0;0;.00nan;0;0
12301;179702;208;68;31;3;28;.903;3900000;0
12301;161006;199;79;30;3;27;.900;3900000;0
12256;189773;231;0;0;0;0;.00nan;0;0
12256;185034;231;77;21;1;20;.952;3600000;0
12256;185800;229;59;43;5;38;.884;3600000;0
12256;185960;229;0;0;0;0;.00nan;0;0
12347;178394;188;64;17;1;16;.941;3600000;0
12347;170351;194;0;0;0;0;.00nan;0;0
12347;184409;188;0;0;0;0;.00nan;0;0
12347;-1;194;91;53;4;49;.925;3600000;0
12429;189885;225;66;24;2;22;.917;3592000;0
12429;-1;225;0;0;0;0;.00nan;0;0
12429;191120;223;0;0;0;0;.00nan;0;0
12429;187118;223;84;28;1;27;.964;3600000;0
12323;-1;216;78;32;2;30;.938;3600000;0
12323;196571;177;68;35;3;32;.914;3560000;0
12323;187240;216;0;0;0;0;.00nan;0;0
12323;-1;177;0;0;0;0;.00nan;0;0
12344;179452;226;0;0;0;0;.00nan;0;0
12344;201560;202;78;40;3;37;.925;3900000;0
12344;196299;202;0;0;0;0;.00nan;0;0
12344;192629;226;66;31;3;28;.903;3900000;0
12257;183695;232;0;0;0;0;.00nan;0;0
12257;200452;221;79;35;3;32;.914;3600000;0
12257;179691;232;64;22;2;20;.909;3600000;0
12257;187362;221;0;0;0;0;.00nan;0;0
12543;194219;4960;0;0;0;0;.00nan;0;0
12543;173219;4960;49;25;3;22;.880;3600000;0
12543;175354;228;0;0;0;0;.00nan;0;0
12543;180377;228;100;31;0;31;1.000;3600000;0
12284;173900;192;0;0;0;0;.00nan;0;0
12284;-1;192;86;27;1;26;.963;3552000;0
12284;192547;190;0;0;0;0;.00nan;0;0
12284;197704;190;100;40;0;40;1.000;3600000;0
12242;182454;4864;0;0;0;0;.00nan;0;0
12242;183737;4864;92;38;1;37;.974;3600000;0
12242;176932;176;81;28;2;26;.929;3591000;0
12242;182006;176;0;0;0;0;.00nan;0;0
12464;194893;191;62;32;4;28;.875;3600000;0
12464;179647;195;62;46;5;41;.891;3600000;0
12464;201892;191;0;0;0;0;.00nan;0;0
12464;191849;195;0;0;0;0;.00nan;0;0
12276;173770;193;42;22;4;18;.818;3592000;0
12276;184648;196;74;34;3;31;.912;3600000;0
12276;186451;193;0;0;0;0;.00nan;0;0
12276;191118;196;0;0;0;0;.00nan;0;0
12264;-1;211;54;29;3;26;.897;3600000;0
12264;190034;217;0;0;0;0;.00nan;0;0
12264;190041;217;100;32;0;32;1.000;3600000;0
12264;179646;211;0;0;0;0;.00nan;0;0
12274;173549;219;0;0;0;0;.00nan;0;0
12274;195164;218;0;0;0;0;.00nan;0;0
12274;190095;218;73;24;2;22;.917;3600000;0
12274;181102;219;59;29;3;26;.897;3590000;0
12254;200306;182;69;29;3;26;.897;3570000;0
12254;179388;182;0;0;0;0;.00nan;0;0
12254;-1;220;0;0;0;0;.00nan;0;0
12254;187443;220;81;29;1;28;.966;3600000;0
12286;190125;184;70;23;2;21;.913;3600000;0
12286;179668;184;0;0;0;0;.00nan;0;0
12286;-1;181;40;43;7;36;.837;3600000;0
12286;192552;181;0;0;0;0;.00nan;0;0
12236;192915;179;0;0;0;0;.00nan;0;0
12236;-1;183;62;36;4;32;.889;3600000;0
12236;182089;183;0;0;0;0;.00nan;0;0
12236;-1;179;84;31;1;30;.968;3600000;0
12426;169226;186;70;31;2;29;.935;3600000;0
12426;182128;215;61;43;5;38;.884;3600000;0
12426;185778;186;0;0;0;0;.00nan;0;0
12426;-1;215;0;0;0;0;.00nan;0;0
12306;174325;197;79;45;3;42;.933;2425000;0
12306;184788;198;67;12;1;11;.917;3600000;0
12306;201585;197;33;14;4;10;.714;1175000;0
12306;181431;198;0;0;0;0;.00nan;0;0
12524;181338;230;0;0;0;0;.00nan;0;0
12524;186495;230;85;17;0;17;1.000;3600000;0
12524;191120;223;51;41;6;35;.854;1498000;0
12524;187118;223;68;30;2;28;.933;2102000;0
12413;182467;185;47;31;5;26;.839;3767000;0
12413;-1;185;0;0;0;0;.00nan;0;0
12413;-1;214;0;0;0;0;.00nan;0;0
12413;191518;214;54;38;6;32;.842;3767000;0
12433;179679;212;0;0;0;0;.00nan;0;0
12433;186641;212;74;22;1;21;.955;3600000;0
12433;-1;180;0;0;0;0;.00nan;0;0
12433;197707;180;53;29;4;25;.862;3600000;0
12399;179169;209;0;0;0;0;.00nan;0;0
12399;201562;2620;0;0;0;0;.00nan;0;0
12399;-1;2620;85;16;0;16;1.000;3600000;0
12399;186205;209;65;34;3;31;.912;3600000;0
12581;194893;191;0;0;0;0;.00nan;0;0
12581;174325;197;0;0;0;0;.00nan;0;0
12581;201585;197;95;59;4;55;.932;3600000;0
12581;201892;191;60;11;1;10;.909;3600000;0
12478;195251;4949;85;25;2;23;.920;3900000;0
12478;201495;213;73;33;2;31;.939;3900000;0
12478;197685;4949;0;0;0;0;.00nan;0;0
12478;203029;213;0;0;0;0;.00nan;0;0
12741;175354;228;35;42;7;35;.833;3134000;0
12741;180377;228;59;8;0;8;1.000;466000;0
12741;181338;230;0;0;0;0;.00nan;0;0
12741;186495;230;66;17;1;16;.941;3600000;0
13555;178394;188;0;0;0;0;.00nan;0;0
13555;184409;188;81;36;3;33;.917;3694000;0
13555;184788;198;0;0;0;0;.00nan;0;0
13555;181431;198;70;30;2;28;.933;3663000;0
12369;201560;202;0;0;0;0;.00nan;0;0
12369;-1;207;31;34;6;28;.824;3316000;0
12369;196299;202;56;25;3;22;.880;3600000;0
12369;-1;207;58;6;0;6;1.000;284000;0
12700;187628;227;0;0;0;0;.00nan;0;0
12700;194219;4960;64;19;1;18;.947;3600000;0
12700;173219;4960;0;0;0;0;.00nan;0;0
12700;-1;227;60;25;3;22;.880;3581000;0
13520;175370;199;81;36;2;34;.944;3600000;0
13520;201524;205;45;27;4;23;.852;3556000;0
13520;-1;205;0;0;0;0;.00nan;0;0
13520;161006;199;0;0;0;0;.00nan;0;0
12476;-1;203;49;22;3;19;.864;3900000;0
12476;-1;203;0;0;0;0;.00nan;0;0
12476;-1;206;58;30;3;27;.900;3900000;0
12476;202998;206;0;0;0;0;.00nan;0;0
12405;173900;192;60;34;4;30;.882;3522000;0
12405;179647;195;0;0;0;0;.00nan;0;0
12405;-1;192;0;0;0;0;.00nan;0;0
12405;191849;195;96;37;2;35;.946;3600000;0
12382;-1;189;65;23;2;21;.913;3600000;0
12382;184648;196;0;0;0;0;.00nan;0;0
12382;191118;196;59;26;3;23;.885;3600000;0
12382;-1;189;0;0;0;0;.00nan;0;0
12262;173770;193;0;0;0;0;.00nan;0;0
12262;170351;194;72;38;3;35;.921;3900000;0
12262;-1;194;0;0;0;0;.00nan;0;0
12262;186451;193;63;22;3;19;.864;3900000;0
12304;-1;1371;0;0;0;0;.00nan;0;0
12304;-1;181;95;16;0;16;1.000;3600000;0
12304;192552;181;0;0;0;0;.00nan;0;0
12304;192688;1371;64;38;4;34;.895;3600000;0
12338;183678;1505;43;25;4;21;.840;3600000;0
12338;186549;1505;0;0;0;0;.00nan;0;0
12338;-1;178;49;2;0;2;1.000;1322000;0
12338;-1;178;23;17;5;12;.706;2240000;0
12222;184175;224;65;33;3;30;.909;3600000;0
12222;189885;225;0;0;0;0;.00nan;0;0
12222;-1;225;55;37;5;32;.865;3525000;0
12222;185840;224;0;0;0;0;.00nan;0;0
12296;195238;200;0;0;0;0;.00nan;0;0
12296;185743;201;80;31;2;29;.935;3600000;0
12296;187295;200;69;31;3;28;.903;3575000;0
12296;-1;201;0;0;0;0;.00nan;0;0
12310;184069;208;36;25;5;20;.800;3600000;0
12310;179452;226;25;12;4;8;.667;1143000;0
12310;179702;208;0;0;0;0;.00nan;0;0
12310;192629;226;45;16;3;13;.813;2419000;0
12277;200306;182;0;0;0;0;.00nan;0;0
12277;179388;182;75;34;3;31;.912;3575000;0
12277;-1;220;64;23;2;21;.913;3600000;0
12277;187443;220;0;0;0;0;.00nan;0;0
12313;195164;218;72;24;1;23;.958;3600000;0
12313;190095;218;0;0;0;0;.00nan;0;0
12313;182128;215;0;0;0;0;.00nan;0;0
12313;-1;215;42;34;6;28;.824;3600000;0
12267;189885;225;70;48;4;44;.917;3600000;0
12267;184610;222;88;17;0;17;1.000;3600000;0
12267;-1;225;0;0;0;0;.00nan;0;0
12267;185851;222;0;0;0;0;.00nan;0;0
12552;-1;203;0;0;0;0;.00nan;0;0
12552;189902;204;60;23;3;20;.870;3600000;0
12552;184712;204;0;0;0;0;.00nan;0;0
12552;-1;203;44;30;5;25;.833;3553000;0
12258;182467;185;77;42;3;39;.929;3600000;0
12258;-1;1371;66;32;4;28;.875;3559000;0
12258;-1;185;0;0;0;0;.00nan;0;0
12258;192688;1371;0;0;0;0;.00nan;0;0
12237;192915;179;0;0;0;0;.00nan;0;0
12237;-1;179;71;18;1;17;.944;3600000;0
12237;-1;178;66;43;4;39;.907;3600000;0
12237;-1;178;0;0;0;0;.00nan;0;0
12244;201495;213;0;0;0;0;.00nan;0;0
12244;-1;183;44;11;2;9;.818;1526000;0
12244;182089;183;7;15;6;9;.600;2074000;0
12244;203029;213;60;24;3;21;.875;3600000;0
12308;173549;219;0;0;0;0;.00nan;0;0
12308;181102;219;63;31;4;27;.871;3549000;0
12308;-1;180;60;18;2;16;.889;3600000;0
12308;197707;180;0;0;0;0;.00nan;0;0
12239;182454;4864;0;0;0;0;.00nan;0;0
12239;183737;4864;64;28;2;26;.929;3865000;0
12239;201562;2620;0;0;0;0;.00nan;0;0
12239;-1;2620;83;25;2;23;.920;3900000;0
13103;190034;217;62;40;4;36;.900;3522000;0
13103;190041;217;0;0;0;0;.00nan;0;0
13103;179679;212;0;0;0;0;.00nan;0;0
13103;186641;212;61;25;3;22;.880;3600000;0
13550;184069;208;0;0;0;0;.00nan;0;0
13550;195238;200;90;31;1;30;.968;3600000;0
13550;179702;208;44;23;4;19;.826;3600000;0
13550;187295;200;0;0;0;0;.00nan;0;0
12268;189081;187;76;29;1;28;.966;3543000;0
12268;178394;188;100;29;0;29;1.000;3600000;0
12268;184409;188;0;0;0;0;.00nan;0;0
12268;-1;187;0;0;0;0;.00nan;0;0
12475;195251;4949;0;0;0;0;.00nan;0;0
12475;-1;216;0;0;0;0;.00nan;0;0
12475;187240;216;54;19;2;17;.895;3600000;0
12475;197685;4949;69;34;3;31;.912;3568000;0
12418;179169;209;0;0;0;0;.00nan;0;0
12418;184907;4959;0;0;0;0;.00nan;0;0
12418;186205;209;53;39;5;34;.872;3600000;0
12418;-1;4959;76;24;1;23;.958;3600000;0
12219;200452;221;0;0;0;0;.00nan;0;0
12219;184175;224;89;29;1;28;.966;3900000;0
12219;185840;224;0;0;0;0;.00nan;0;0
12219;187362;221;85;26;1;25;.962;3900000;0
12335;175370;199;0;0;0;0;.00nan;0;0
12335;185743;201;0;0;0;0;.00nan;0;0
12335;-1;201;59;26;3;23;.885;3600000;0
12335;161006;199;89;32;1;31;.969;3600000;0
12354;183695;232;63;22;2;20;.909;3600000;0
12354;179691;232;0;0;0;0;.00nan;0;0
12354;185800;229;0;0;0;0;.00nan;0;0
12354;185960;229;27;28;6;22;.786;3600000;0
12762;187628;227;71;27;2;25;.926;3600000;0
12762;-1;227;0;0;0;0;.00nan;0;0
12762;175354;228;0;0;0;0;.00nan;0;0
12762;180377;228;64;31;3;28;.903;3600000;0
12305;-1;211;57;19;3;16;.842;3900000;0
12305;190034;217;0;0;0;0;.00nan;0;0
12305;190041;217;90;42;3;39;.929;3900000;0
12305;179646;211;0;0;0;0;.00nan;0;0
13533;184648;196;90;49;3;46;.939;3900000;0
13533;179647;195;48;18;3;15;.833;3900000;0
13533;191118;196;0;0;0;0;.00nan;0;0
13533;191849;195;0;0;0;0;.00nan;0;0
12315;190125;184;0;0;0;0;.00nan;0;0
12315;179668;184;45;28;5;23;.821;3600000;0
12315;-1;181;83;33;2;31;.939;3600000;0
12315;192552;181;0;0;0;0;.00nan;0;0
13447;179169;209;71;25;1;24;.960;3600000;0
13447;201562;2620;64;28;2;26;.929;3550000;0
13447;-1;2620;0;0;0;0;.00nan;0;0
13447;186205;209;0;0;0;0;.00nan;0;0
12319;182454;4864;44;34;5;29;.853;3600000;0
12319;183737;4864;0;0;0;0;.00nan;0;0
12319;176932;176;0;0;0;0;.00nan;0;0
12319;182006;176;82;28;2;26;.929;3600000;0
13403;189081;187;81;23;1;22;.957;3600000;0
13403;170351;194;76;31;2;29;.935;3544000;0
13403;-1;194;0;0;0;0;.00nan;0;0
13403;-1;187;0;0;0;0;.00nan;0;0
12721;189902;204;72;29;3;26;.897;3600000;0
12721;184712;204;0;0;0;0;.00nan;0;0
12721;201524;205;0;0;0;0;.00nan;0;0
12721;-1;205;38;26;5;21;.808;3525000;0
12324;189773;231;0;0;0;0;.00nan;0;0
12324;184610;222;34;11;3;8;.727;384000;0
12324;185034;231;50;8;1;7;.875;3600000;0
12324;185851;222;63;41;5;36;.878;3216000;0
13566;179452;226;0;0;0;0;.00nan;0;0
13566;-1;206;83;34;2;32;.941;2489000;0
13566;192629;226;80;23;1;22;.957;3600000;0
13566;202998;206;26;17;4;13;.765;1111000;0
12339;183678;1505;0;0;0;0;.00nan;0;0
12339;196571;177;74;26;2;24;.923;3554000;0
12339;186549;1505;77;20;1;19;.950;3600000;0
12339;-1;177;0;0;0;0;.00nan;0;0
12232;169226;186;75;21;1;20;.952;3600000;0
12232;179679;212;58;6;0;6;1.000;754000;0
12232;185778;186;0;0;0;0;.00nan;0;0
12232;186641;212;26;26;6;20;.769;2846000;0
12345;184069;208;76;37;3;34;.919;3600000;0
12345;-1;203;37;20;4;16;.800;3600000;0
12345;179702;208;0;0;0;0;.00nan;0;0
12345;-1;203;0;0;0;0;.00nan;0;0
12291;173770;193;0;0;0;0;.00nan;0;0
12291;179647;195;0;0;0;0;.00nan;0;0
12291;186451;193;65;26;3;23;.885;3709000;0
12291;191849;195;74;27;2;25;.926;3709000;0
12496;195164;218;37;25;5;20;.800;3600000;0
12496;190095;218;0;0;0;0;.00nan;0;0
12496;-1;180;78;28;2;26;.929;3600000;0
12496;197707;180;0;0;0;0;.00nan;0;0
12409;201560;202;63;23;3;20;.870;3600000;0
12409;196299;202;0;0;0;0;.00nan;0;0
12409;-1;206;65;41;4;37;.902;3600000;0
12409;202998;206;0;0;0;0;.00nan;0;0
12311;190125;184;89;44;2;42;.955;3900000;0
12311;179668;184;0;0;0;0;.00nan;0;0
12311;-1;220;0;0;0;0;.00nan;0;0
12311;187443;220;87;36;2;34;.944;3900000;0
13183;194893;191;29;14;4;10;.714;1098000;0
13183;184788;198;0;0;0;0;.00nan;0;0
13183;201892;191;45;25;4;21;.840;2502000;0
13183;181431;198;88;43;2;41;.953;3600000;0
12312;200306;182;60;31;4;27;.871;3600000;0
12312;-1;1371;57;26;2;24;.923;2986000;0
12312;179388;182;0;0;0;0;.00nan;0;0
12312;192688;1371;21;11;4;7;.636;614000;0
12483;182467;185;0;0;0;0;.00nan;0;0
12483;-1;185;46;27;4;23;.852;3561000;0
12483;-1;214;58;21;2;19;.905;3600000;0
12483;191518;214;0;0;0;0;.00nan;0;0
12403;-1;211;0;0;0;0;.00nan;0;0
12403;173549;219;71;31;2;29;.935;3814000;0
12403;179646;211;94;34;1;33;.971;3814000;0
12403;181102;219;0;0;0;0;.00nan;0;0
12370;189773;231;52;12;2;10;.833;2676000;0
12370;185034;231;7;8;5;3;.375;924000;0
12370;185800;229;100;50;3;47;.940;3600000;0
12370;185960;229;0;0;0;0;.00nan;0;0
12366;201495;213;28;23;5;18;.783;3598000;0
12366;-1;178;0;0;0;0;.00nan;0;0
12366;203029;213;0;0;0;0;.00nan;0;0
12366;-1;178;59;28;4;24;.857;3600000;0
12248;-1;216;80;33;2;31;.939;3900000;0
12248;-1;183;88;40;2;38;.950;3900000;0
12248;182089;183;0;0;0;0;.00nan;0;0
12248;187240;216;0;0;0;0;.00nan;0;0
12455;178394;188;71;31;2;29;.935;3600000;0
12455;173900;192;0;0;0;0;.00nan;0;0
12455;184409;188;0;0;0;0;.00nan;0;0
12455;-1;192;48;27;4;23;.852;3600000;0
12550;170351;194;0;0;0;0;.00nan;0;0
12550;174325;197;0;0;0;0;.00nan;0;0
12550;201585;197;58;19;2;17;.895;3600000;0
12550;-1;194;52;25;3;22;.880;3556000;0
12360;183695;232;0;0;0;0;.00nan;0;0
12360;184175;224;30;28;6;22;.786;1447000;0
12360;179691;232;84;26;1;25;.962;3600000;0
12360;185840;224;40;30;5;25;.833;2153000;0
12451;175370;199;47;33;5;28;.848;3600000;0
12451;185743;201;84;28;1;27;.964;3600000;0
12451;-1;201;0;0;0;0;.00nan;0;0
12451;161006;199;0;0;0;0;.00nan;0;0
12283;189081;187;60;30;3;27;.900;3600000;0
12283;173900;192;51;30;4;26;.867;3600000;0
12283;-1;192;0;0;0;0;.00nan;0;0
12283;-1;187;0;0;0;0;.00nan;0;0
12419;183695;232;81;31;2;29;.935;3600000;0
12419;175354;228;50;34;5;29;.853;3600000;0
12419;179691;232;0;0;0;0;.00nan;0;0
12419;180377;228;0;0;0;0;.00nan;0;0
12299;182467;185;90;28;1;27;.964;3600000;0
12299;-1;220;80;41;2;39;.951;3600000;0
12299;187443;220;0;0;0;0;.00nan;0;0
12299;-1;185;0;0;0;0;.00nan;0;0
12448;175370;199;0;0;0;0;.00nan;0;0
12448;179452;226;75;21;1;20;.952;3600000;0
12448;192629;226;0;0;0;0;.00nan;0;0
12448;161006;199;69;27;2;25;.926;3572000;0
12281;194219;4960;0;0;0;0;.00nan;0;0
12281;173219;4960;77;36;2;34;.944;3600000;0
12281;200452;221;61;27;3;24;.889;3553000;0
12281;187362;221;0;0;0;0;.00nan;0;0
12457;-1;1371;0;0;0;0;.00nan;0;0
12457;-1;181;68;32;2;30;.938;3900000;0
12457;192552;181;0;0;0;0;.00nan;0;0
12457;192688;1371;77;27;2;25;.926;3900000;0
12438;201562;2620;0;0;0;0;.00nan;0;0
12438;176932;176;95;37;2;35;.946;3600000;0
12438;182006;176;0;0;0;0;.00nan;0;0
12438;-1;2620;46;24;3;21;.875;3600000;0
12450;173770;193;89;28;1;27;.964;3600000;0
12450;-1;189;79;47;5;42;.894;3600000;0
12450;186451;193;0;0;0;0;.00nan;0;0
12450;-1;189;0;0;0;0;.00nan;0;0
12302;200306;182;0;0;0;0;.00nan;0;0
12302;179388;182;99;41;2;39;.951;3900000;0
12302;-1;214;0;0;0;0;.00nan;0;0
12302;191518;214;69;22;2;20;.909;3900000;0
12388;201524;205;66;22;2;20;.909;3600000;0
12388;-1;205;0;0;0;0;.00nan;0;0
12388;185743;201;0;0;0;0;.00nan;0;0
12388;-1;201;81;42;3;39;.929;3547000;0
12343;190034;217;31;32;6;26;.813;3600000;0
12343;190041;217;0;0;0;0;.00nan;0;0
12343;182128;215;98;37;2;35;.946;3600000;0
12343;-1;215;0;0;0;0;.00nan;0;0
12298;184648;196;100;28;0;28;1.000;3600000;0
12298;191118;196;0;0;0;0;.00nan;0;0
12298;192547;190;0;0;0;0;.00nan;0;0
12298;197704;190;75;52;5;47;.904;3600000;0
12564;181338;230;0;0;0;0;.00nan;0;0
12564;185800;229;0;0;0;0;.00nan;0;0
12564;185960;229;79;52;5;47;.904;3600000;0
12564;186495;230;62;14;1;13;.929;3600000;0
12350;184175;224;61;37;5;32;.865;3600000;0
12350;185840;224;0;0;0;0;.00nan;0;0
12350;191120;223;0;0;0;0;.00nan;0;0
12350;187118;223;72;16;1;15;.938;3600000;0
12325;187628;227;0;0;0;0;.00nan;0;0
12325;-1;227;90;39;2;37;.949;3600000;0
12325;189885;225;0;0;0;0;.00nan;0;0
12325;-1;225;54;40;4;36;.900;3600000;0
12346;195238;200;0;0;0;0;.00nan;0;0
12346;189902;204;65;29;3;26;.897;3600000;0
12346;184712;204;0;0;0;0;.00nan;0;0
12346;187295;200;76;41;4;37;.902;3600000;0
12331;184069;208;53;3;0;3;1.000;713000;0
12331;179702;208;27;31;6;25;.806;2887000;0
12331;-1;207;74;32;2;30;.938;3600000;0
12331;-1;207;0;0;0;0;.00nan;0;0
12353;183678;1505;0;0;0;0;.00nan;0;0
12353;186549;1505;42;18;3;15;.833;3582000;0
12353;-1;178;75;29;2;27;.931;3600000;0
12353;-1;178;0;0;0;0;.00nan;0;0
12620;194893;191;58;11;1;10;.909;3600000;0
12620;174325;197;48;46;7;39;.848;3242000;0
12620;201585;197;57;6;0;6;1.000;358000;0
12620;201892;191;0;0;0;0;.00nan;0;0
12485;195251;4949;53;23;3;20;.870;3600000;0
12485;196571;177;0;0;0;0;.00nan;0;0
12485;197685;4949;0;0;0;0;.00nan;0;0
12485;-1;177;58;33;4;29;.879;3578000;0
12340;169226;186;0;0;0;0;.00nan;0;0
12340;195164;218;0;0;0;0;.00nan;0;0
12340;190095;218;47;27;4;23;.852;3600000;0
12340;185778;186;70;20;1;19;.950;3600000;0
12273;192915;179;0;0;0;0;.00nan;0;0
12273;-1;179;76;28;2;26;.929;3600000;0
12273;192461;210;81;37;3;34;.919;3563000;0
12273;197672;210;0;0;0;0;.00nan;0;0
12395;182454;4864;0;0;0;0;.00nan;0;0
12395;183737;4864;95;33;1;32;.970;3900000;0
12395;184907;4959;0;0;0;0;.00nan;0;0
12395;-1;4959;79;25;1;24;.960;3900000;0
12365;173549;219;0;0;0;0;.00nan;0;0
12365;181102;219;99;42;1;41;.976;3600000;0
12365;-1;180;60;29;4;25;.862;3600000;0
12365;197707;180;0;0;0;0;.00nan;0;0
12440;-1;189;0;0;0;0;.00nan;0;0
12440;179647;195;39;25;4;21;.840;3545000;0
12440;191849;195;0;0;0;0;.00nan;0;0
12440;-1;189;74;29;3;26;.897;3600000;0
12757;179169;209;0;0;0;0;.00nan;0;0
12757;201562;2620;48;21;3;18;.857;3600000;0
12757;-1;2620;0;0;0;0;.00nan;0;0
12757;186205;209;76;52;5;47;.904;3539000;0
13518;189902;204;0;0;0;0;.00nan;0;0
13518;184712;204;100;44;0;44;1.000;3600000;0
13518;201560;202;48;24;3;21;.875;3600000;0
13518;196299;202;0;0;0;0;.00nan;0;0
12250;-1;183;0;0;0;0;.00nan;0;0
12250;182089;183;74;38;3;35;.921;3600000;0
12250;192461;210;0;0;0;0;.00nan;0;0
12250;197672;210;29;16;4;12;.750;3590000;0
12316;190034;217;0;0;0;0;.00nan;0;0
12316;190041;217;94;44;2;42;.955;3600000;0
12316;179679;212;0;0;0;0;.00nan;0;0
12316;186641;212;54;26;3;23;.885;3571000;0
12247;192915;179;100;30;1;29;.967;3600000;0
12247;-1;216;0;0;0;0;.00nan;0;0
12247;-1;179;0;0;0;0;.00nan;0;0
12247;187240;216;66;24;2;22;.917;3551000;0
12307;170351;194;70;46;4;42;.913;3600000;0
12307;184788;198;0;0;0;0;.00nan;0;0
12307;-1;194;0;0;0;0;.00nan;0;0
12307;181431;198;86;16;0;16;1.000;3600000;0
12439;173549;219;64;36;4;32;.889;3534000;0
12439;195164;218;68;22;2;20;.909;3600000;0
12439;190095;218;0;0;0;0;.00nan;0;0
12439;181102;219;0;0;0;0;.00nan;0;0
12275;189081;187;67;27;3;24;.889;3562000;0
12275;192547;190;0;0;0;0;.00nan;0;0
12275;-1;187;0;0;0;0;.00nan;0;0
12275;197704;190;79;28;2;26;.929;3600000;0
12282;187628;227;0;0;0;0;.00nan;0;0
12282;200452;221;0;0;0;0;.00nan;0;0
12282;-1;227;73;33;3;30;.909;3551000;0
12282;187362;221;86;39;2;37;.949;3600000;0
12519;196571;177;36;28;5;23;.821;3600000;0
12519;-1;178;0;0;0;0;.00nan;0;0
12519;-1;178;81;33;3;30;.909;3600000;0
12519;-1;177;0;0;0;0;.00nan;0;0
12604;175370;199;91;32;1;31;.969;3600000;0
12604;-1;206;65;37;4;33;.892;3210000;0
12604;202998;206;34;10;3;7;.700;390000;0
12604;161006;199;0;0;0;0;.00nan;0;0
12776;194893;191;66;15;1;14;.933;3600000;0
12776;174325;197;71;29;2;27;.931;1864000;0
12776;201585;197;73;44;4;40;.909;1736000;0
12776;201892;191;0;0;0;0;.00nan;0;0
12452;183695;232;0;0;0;0;.00nan;0;0
12452;175354;228;0;0;0;0;.00nan;0;0
12452;179691;232;18;23;6;17;.739;3562000;0
12452;180377;228;52;36;5;31;.861;3600000;0
12693;179679;212;100;30;0;30;1.000;3826000;0
12693;186641;212;0;0;0;0;.00nan;0;0
12693;-1;180;0;0;0;0;.00nan;0;0
12693;197707;180;89;33;1;32;.970;3826000;0
12723;195251;4949;57;37;5;32;.865;3236000;0
12723;-1;216;50;28;4;24;.857;3600000;0
12723;187240;216;0;0;0;0;.00nan;0;0
12723;197685;4949;71;8;0;8;1.000;310000;0
13506;184175;224;97;59;3;56;.949;3900000;0
13506;181338;230;0;0;0;0;.00nan;0;0
13506;185840;224;0;0;0;0;.00nan;0;0
13506;186495;230;50;17;3;14;.824;3900000;0
12342;-1;211;60;45;5;40;.889;3600000;0
12342;169226;186;83;36;2;34;.944;3600000;0
12342;179646;211;0;0;0;0;.00nan;0;0
12342;185778;186;0;0;0;0;.00nan;0;0
12376;182467;185;0;0;0;0;.00nan;0;0
12376;-1;181;86;33;1;32;.970;3600000;0
12376;-1;185;70;26;2;24;.923;3547000;0
12376;192552;181;0;0;0;0;.00nan;0;0
13589;173770;193;0;0;0;0;.00nan;0;0
13589;173900;192;0;0;0;0;.00nan;0;0
13589;-1;192;78;35;2;33;.943;3600000;0
13589;186451;193;56;27;3;24;.889;3578000;0
12359;189885;225;49;29;4;25;.862;3600000;0
12359;-1;225;0;0;0;0;.00nan;0;0
12359;191120;223;36;32;6;26;.813;3554000;0
12359;187118;223;0;0;0;0;.00nan;0;0
12349;195238;200;0;0;0;0;.00nan;0;0
12349;201524;205;0;0;0;0;.00nan;0;0
12349;-1;205;45;19;3;16;.842;3900000;0
12349;187295;200;87;47;3;44;.936;3900000;0
12373;178394;188;0;0;0;0;.00nan;0;0
12373;184409;188;97;25;0;25;1.000;3600000;0
12373;184648;196;71;42;4;38;.905;3600000;0
12373;191118;196;0;0;0;0;.00nan;0;0
12363;179452;226;0;0;0;0;.00nan;0;0
12363;-1;207;85;40;2;38;.950;3856000;0
12363;-1;207;0;0;0;0;.00nan;0;0
12363;192629;226;80;28;1;27;.964;3856000;0
12309;190125;184;90;31;2;29;.935;3893000;0
12309;179668;184;0;0;0;0;.00nan;0;0
12309;-1;220;0;0;0;0;.00nan;0;0
12309;187443;220;83;30;1;29;.967;3893000;0
12398;194219;4960;80;49;4;45;.918;3600000;0
12398;173219;4960;0;0;0;0;.00nan;0;0
12398;184610;222;75;23;1;22;.957;3600000;0
12398;185851;222;0;0;0;0;.00nan;0;0
12431;179169;209;73;45;4;41;.911;3600000;0
12431;176932;176;0;0;0;0;.00nan;0;0
12431;182006;176;100;23;0;23;1.000;3600000;0
12431;186205;209;0;0;0;0;.00nan;0;0
12387;182454;4864;0;0;0;0;.00nan;0;0
12387;183737;4864;28;25;5;20;.800;3527000;0
12387;184907;4959;0;0;0;0;.00nan;0;0
12387;-1;4959;65;25;3;22;.880;3600000;0
12362;195238;200;46;42;6;36;.857;2498000;0
12362;189902;204;0;0;0;0;.00nan;0;0
12362;184712;204;58;18;2;16;.889;3600000;0
12362;187295;200;64;16;1;15;.938;1102000;0
13428;182467;185;48;30;4;26;.867;3543000;0
13428;-1;1371;0;0;0;0;.00nan;0;0
13428;-1;185;0;0;0;0;.00nan;0;0
13428;192688;1371;61;31;3;28;.903;3600000;0
12404;179452;226;58;27;4;23;.852;3600000;0
12404;-1;207;0;0;0;0;.00nan;0;0
12404;-1;207;41;44;6;38;.864;3514000;0
12404;192629;226;0;0;0;0;.00nan;0;0
12392;178394;188;0;0;0;0;.00nan;0;0
12392;170351;194;68;52;5;47;.904;3600000;0
12392;184409;188;52;13;2;11;.846;3600000;0
12392;-1;194;0;0;0;0;.00nan;0;0
12406;201524;205;100;31;0;31;1.000;3600000;0
12406;201560;202;72;25;1;24;.960;3543000;0
12406;196299;202;0;0;0;0;.00nan;0;0
12406;-1;205;0;0;0;0;.00nan;0;0
12391;201495;213;66;24;2;22;.917;3900000;0
12391;-1;183;0;0;0;0;.00nan;0;0
12391;182089;183;88;37;2;35;.946;3900000;0
12391;203029;213;0;0;0;0;.00nan;0;0
12402;200306;182;86;22;0;22;1.000;3600000;0
12402;179388;182;0;0;0;0;.00nan;0;0
12402;-1;181;0;0;0;0;.00nan;0;0
12402;192552;181;72;42;5;37;.881;3600000;0
12352;-1;211;0;0;0;0;.00nan;0;0
12352;179646;211;74;39;3;36;.923;3593000;0
12352;182128;215;0;0;0;0;.00nan;0;0
12352;-1;215;94;39;2;37;.949;3600000;0
13556;-1;189;100;50;2;48;.960;3900000;0
13556;184788;198;0;0;0;0;.00nan;0;0
13556;181431;198;54;19;2;17;.895;3900000;0
13556;-1;189;0;0;0;0;.00nan;0;0
12317;190125;184;0;0;0;0;.00nan;0;0
12317;179668;184;84;33;2;31;.939;3600000;0
12317;-1;214;58;34;5;29;.853;3600000;0
12317;191518;214;0;0;0;0;.00nan;0;0
13542;175354;228;69;25;2;23;.920;3600000;0
13542;180377;228;0;0;0;0;.00nan;0;0
13542;191120;223;47;6;1;5;.833;881000;0
13542;187118;223;8;22;7;15;.682;2719000;0
12945;-1;203;42;21;4;17;.810;3576000;0
12945;-1;203;0;0;0;0;.00nan;0;0
12945;-1;206;82;30;2;28;.933;3600000;0
12945;202998;206;0;0;0;0;.00nan;0;0
12368;184175;224;96;40;2;38;.950;3577000;0
12368;189773;231;0;0;0;0;.00nan;0;0
12368;185034;231;80;21;1;20;.952;3600000;0
12368;185840;224;0;0;0;0;.00nan;0;0
12295;189081;187;0;0;0;0;.00nan;0;0
12295;184648;196;86;36;1;35;.972;3355000;0
12295;191118;196;27;6;3;3;.500;245000;0
12295;-1;187;83;18;0;18;1.000;3600000;0
13091;187628;227;74;47;4;43;.915;3600000;0
13091;-1;227;0;0;0;0;.00nan;0;0
13091;184610;222;33;29;6;23;.793;3515000;0
13091;185851;222;0;0;0;0;.00nan;0;0
12428;189902;204;61;35;4;31;.886;3561000;0
12428;184712;204;0;0;0;0;.00nan;0;0
12428;201560;202;0;0;0;0;.00nan;0;0
12428;196299;202;91;34;2;32;.941;3600000;0
12314;173770;193;40;20;4;16;.800;3600000;0
12314;186451;193;0;0;0;0;.00nan;0;0
12314;192547;190;0;0;0;0;.00nan;0;0
12314;197704;190;75;44;5;39;.886;3589000;0
12469;169226;186;71;24;2;22;.917;3600000;0
12469;182128;215;73;43;5;38;.884;3600000;0
12469;185778;186;0;0;0;0;.00nan;0;0
12469;-1;215;0;0;0;0;.00nan;0;0
12430;184069;208;56;16;2;14;.875;3900000;0
12430;179702;208;0;0;0;0;.00nan;0;0
12430;185743;201;96;39;2;37;.949;3900000;0
12430;-1;201;0;0;0;0;.00nan;0;0
13519;-1;220;57;32;4;28;.875;3582000;0
13519;187443;220;0;0;0;0;.00nan;0;0
13519;-1;214;0;0;0;0;.00nan;0;0
13519;191518;214;72;29;3;26;.897;3600000;0
12480;-1;189;0;0;0;0;.00nan;0;0
12480;179647;195;98;18;0;18;1.000;3600000;0
12480;191849;195;0;0;0;0;.00nan;0;0
12480;-1;189;98;42;1;41;.976;3563000;0
12614;182454;4864;0;0;0;0;.00nan;0;0
12614;183737;4864;69;32;3;29;.906;3566000;0
12614;179169;209;0;0;0;0;.00nan;0;0
12614;186205;209;64;15;1;14;.933;3600000;0
13458;-1;203;0;0;0;0;.00nan;0;0
13458;175370;199;0;0;0;0;.00nan;0;0
13458;-1;203;73;32;2;30;.938;3600000;0
13458;161006;199;58;29;4;25;.862;3542000;0
12357;183678;1505;0;0;0;0;.00nan;0;0
12357;196571;177;100;37;1;36;.973;3600000;0
12357;186549;1505;68;33;3;30;.909;3565000;0
12357;-1;177;0;0;0;0;.00nan;0;0
13437;-1;183;51;33;5;28;.848;3593000;0
13437;182089;183;0;0;0;0;.00nan;0;0
13437;-1;178;53;26;3;23;.885;3600000;0
13437;-1;178;0;0;0;0;.00nan;0;0
12444;176932;176;0;0;0;0;.00nan;0;0
12444;184907;4959;83;36;2;34;.944;3600000;0
12444;182006;176;82;45;4;41;.911;3600000;0
12444;-1;4959;0;0;0;0;.00nan;0;0
12446;189885;225;78;43;4;39;.907;3292000;0
12446;181338;230;0;0;0;0;.00nan;0;0
12446;-1;225;26;6;3;3;.500;308000;0
12446;186495;230;91;20;0;20;1.000;3600000;0
12726;190034;217;69;37;3;34;.919;3564000;0
12726;190041;217;0;0;0;0;.00nan;0;0
12726;179679;212;77;31;2;29;.935;3600000;0
12726;186641;212;0;0;0;0;.00nan;0;0
12755;173900;192;0;0;0;0;.00nan;0;0
12755;184788;198;0;0;0;0;.00nan;0;0
12755;-1;192;41;27;4;23;.852;3588000;0
12755;181431;198;82;35;2;33;.943;3600000;0
12383;183678;1505;69;32;2;30;.938;3600000;0
12383;186549;1505;0;0;0;0;.00nan;0;0
12383;192461;210;76;40;3;37;.925;3600000;0
12383;197672;210;0;0;0;0;.00nan;0;0
13471;195251;4949;70;31;3;28;.903;3600000;0
13471;196571;177;0;0;0;0;.00nan;0;0
13471;197685;4949;0;0;0;0;.00nan;0;0
13471;-1;177;45;32;5;27;.844;3594000;0
13456;-1;211;64;26;3;23;.885;3780000;0
13456;173549;219;0;0;0;0;.00nan;0;0
13456;179646;211;0;0;0;0;.00nan;0;0
13456;181102;219;82;33;2;31;.939;3780000;0
13004;184610;222;94;42;2;40;.952;3587000;0
13004;181338;230;0;0;0;0;.00nan;0;0
13004;185851;222;0;0;0;0;.00nan;0;0
13004;186495;230;67;17;1;16;.941;3600000;0
13495;179169;209;35;37;6;31;.838;2320000;0
13495;201562;2620;0;0;0;0;.00nan;0;0
13495;-1;2620;45;18;3;15;.833;3600000;0
13495;186205;209;65;20;1;19;.950;1280000;0
13528;170351;194;59;37;4;33;.892;3600000;0
13528;184648;196;0;0;0;0;.00nan;0;0
13528;-1;194;0;0;0;0;.00nan;0;0
13528;191118;196;74;27;2;25;.926;3600000;0
12408;175354;228;0;0;0;0;.00nan;0;0
12408;180377;228;60;15;1;14;.933;3600000;0
12408;191120;223;76;32;2;30;.938;3568000;0
12408;187118;223;0;0;0;0;.00nan;0;0
12563;194219;4960;0;0;0;0;.00nan;0;0
12563;173219;4960;90;32;1;31;.969;3600000;0
12563;185800;229;60;31;4;27;.871;3600000;0
12563;185960;229;0;0;0;0;.00nan;0;0
12337;200452;221;97;57;3;54;.947;3600000;0
12337;189773;231;0;0;0;0;.00nan;0;0
12337;185034;231;91;20;0;20;1.000;3600000;0
12337;187362;221;0;0;0;0;.00nan;0;0
12280;192915;179;0;0;0;0;.00nan;0;0
12280;201495;213;0;0;0;0;.00nan;0;0
12280;-1;179;90;19;0;19;1.000;3600000;0
12280;203029;213;53;31;4;27;.871;3600000;0
12836;187628;227;0;0;0;0;.00nan;0;0
12836;194219;4960;81;39;3;36;.923;3788000;0
12836;173219;4960;0;0;0;0;.00nan;0;0
12836;-1;227;76;29;2;27;.931;3788000;0
12684;-1;189;0;0;0;0;.00nan;0;0
12684;184788;198;47;15;2;13;.867;3900000;0
12684;181431;198;0;0;0;0;.00nan;0;0
12684;-1;189;90;33;2;31;.939;3900000;0
12498;194893;191;94;37;2;35;.946;3900000;0
12498;173900;192;0;0;0;0;.00nan;0;0
12498;-1;192;79;41;2;39;.951;3900000;0
12498;201892;191;0;0;0;0;.00nan;0;0
12386;190125;184;39;23;5;18;.783;3600000;0
12386;179668;184;0;0;0;0;.00nan;0;0
12386;-1;181;100;46;1;45;.978;3600000;0
12386;192552;181;0;0;0;0;.00nan;0;0
12415;183695;232;28;24;5;19;.792;3569000;0
12415;179691;232;0;0;0;0;.00nan;0;0
12415;191120;223;0;0;0;0;.00nan;0;0
12415;187118;223;59;32;3;29;.906;3600000;0
12289;-1;183;0;0;0;0;.00nan;0;0
12289;182089;183;48;33;5;28;.848;3547000;0
12289;192461;210;0;0;0;0;.00nan;0;0
12289;197672;210;61;35;4;31;.886;3600000;0
12547;182454;4864;0;0;0;0;.00nan;0;0
12547;183737;4864;79;37;4;33;.892;3900000;0
12547;176932;176;43;25;4;21;.840;3900000;0
12547;182006;176;0;0;0;0;.00nan;0;0
12512;189902;204;79;32;2;30;.938;3600000;0
12512;184712;204;0;0;0;0;.00nan;0;0
12512;201560;202;34;27;5;22;.815;3600000;0
12512;196299;202;0;0;0;0;.00nan;0;0
12422;178394;188;0;0;0;0;.00nan;0;0
12422;184409;188;74;28;2;26;.929;3600000;0
12422;184648;196;72;37;4;33;.892;3520000;0
12422;191118;196;0;0;0;0;.00nan;0;0
12575;169226;186;62;27;3;24;.889;3568000;0
12575;185778;186;0;0;0;0;.00nan;0;0
12575;-1;180;0;0;0;0;.00nan;0;0
12575;197707;180;79;39;2;37;.949;3600000;0
12536;195164;218;70;20;1;19;.950;3600000;0
12536;190095;218;0;0;0;0;.00nan;0;0
12536;179679;212;0;0;0;0;.00nan;0;0
12536;186641;212;65;38;4;34;.895;3600000;0
12654;-1;216;0;0;0;0;.00nan;0;0
12654;187240;216;36;23;4;19;.826;3900000;0
12654;-1;178;0;0;0;0;.00nan;0;0
12654;-1;178;41;28;4;24;.857;3900000;0
12591;190034;217;0;0;0;0;.00nan;0;0
12591;190041;217;85;38;2;36;.947;3600000;0
12591;182128;215;0;0;0;0;.00nan;0;0
12591;-1;215;54;30;4;26;.867;3525000;0
12320;182467;185;0;0;0;0;.00nan;0;0
12320;-1;220;0;0;0;0;.00nan;0;0
12320;187443;220;93;29;1;28;.966;3600000;0
12320;-1;185;60;33;4;29;.879;3600000;0
12493;175354;228;78;32;2;30;.938;3600000;0
12493;180377;228;0;0;0;0;.00nan;0;0
12493;185800;229;59;9;0;9;1.000;1305000;0
12493;185960;229;9;26;7;19;.731;2295000;0
13462;175370;199;51;20;3;17;.850;3600000;0
13462;-1;207;82;33;1;32;.970;3600000;0
13462;-1;207;0;0;0;0;.00nan;0;0
13462;161006;199;0;0;0;0;.00nan;0;0
12380;189081;187;0;0;0;0;.00nan;0;0
12380;192547;190;67;45;5;40;.889;3668000;0
12380;-1;187;59;26;4;22;.846;3668000;0
12380;197704;190;0;0;0;0;.00nan;0;0
12378;195238;200;0;0;0;0;.00nan;0;0
12378;201524;205;79;20;1;19;.950;3600000;0
12378;-1;205;0;0;0;0;.00nan;0;0
12378;187295;200;100;40;0;40;1.000;3600000;0
13549;190034;217;84;41;3;38;.927;3600000;0
13549;190041;217;0;0;0;0;.00nan;0;0
13549;182128;215;100;23;0;23;1.000;3600000;0
13549;-1;215;0;0;0;0;.00nan;0;0
12526;183678;1505;0;0;0;0;.00nan;0;0
12526;196571;177;0;0;0;0;.00nan;0;0
12526;186549;1505;85;25;1;24;.960;3600000;0
12526;-1;177;53;26;3;23;.885;3572000;0
12702;-1;1371;0;0;0;0;.00nan;0;0
12702;-1;181;0;0;0;0;.00nan;0;0
12702;192552;181;75;34;2;32;.941;3600000;0
12702;192688;1371;55;27;3;24;.889;3587000;0
12447;173549;219;24;17;5;12;.706;3613000;0
12447;195164;218;0;0;0;0;.00nan;0;0
12447;190095;218;90;49;4;45;.918;3613000;0
12447;181102;219;0;0;0;0;.00nan;0;0
12864;179679;212;82;27;1;26;.963;3551000;0
12864;186641;212;0;0;0;0;.00nan;0;0
12864;-1;180;100;26;0;26;1.000;3600000;0
12864;197707;180;0;0;0;0;.00nan;0;0
12322;192915;179;0;0;0;0;.00nan;0;0
12322;195251;4949;31;28;6;22;.786;2587000;0
12322;-1;179;83;31;2;29;.935;3600000;0
12322;197685;4949;51;9;1;8;.889;1013000;0
12449;201495;213;51;18;3;15;.833;3600000;0
12449;-1;183;84;49;4;45;.918;3545000;0
12449;182089;183;0;0;0;0;.00nan;0;0
12449;203029;213;0;0;0;0;.00nan;0;0
12377;200452;221;0;0;0;0;.00nan;0;0
12377;189885;225;67;27;3;24;.889;3831000;0
12377;-1;225;0;0;0;0;.00nan;0;0
12377;187362;221;84;36;2;34;.944;3822000;0
12508;-1;203;67;23;2;21;.913;3600000;0
12508;-1;203;0;0;0;0;.00nan;0;0
12508;185743;201;96;38;1;37;.974;3600000;0
12508;-1;201;0;0;0;0;.00nan;0;0
12463;201560;202;0;0;0;0;.00nan;0;0
12463;-1;207;0;0;0;0;.00nan;0;0
12463;196299;202;77;29;2;27;.931;3600000;0
12463;-1;207;99;38;1;37;.974;3600000;0
12491;201562;2620;0;0;0;0;.00nan;0;0
12491;184907;4959;68;22;2;20;.909;3769000;0
12491;-1;2620;75;23;1;22;.957;3769000;0
12491;-1;4959;0;0;0;0;.00nan;0;0
12460;187628;227;85;33;2;31;.939;3600000;0
12460;184175;224;60;34;4;30;.882;3580000;0
12460;-1;227;0;0;0;0;.00nan;0;0
12460;185840;224;0;0;0;0;.00nan;0;0
12610;189081;187;29;9;3;6;.667;519000;0
12610;194893;191;0;0;0;0;.00nan;0;0
12610;201892;191;76;23;2;21;.913;3600000;0
12610;-1;187;83;48;4;44;.917;3081000;0
12472;-1;211;75;33;3;30;.909;3600000;0
12472;169226;186;0;0;0;0;.00nan;0;0
12472;179646;211;0;0;0;0;.00nan;0;0
12472;185778;186;42;27;4;23;.852;3574000;0
12629;173900;192;91;29;1;28;.966;3600000;0
12629;170351;194;61;31;4;27;.871;3600000;0
12629;-1;192;0;0;0;0;.00nan;0;0
12629;-1;194;0;0;0;0;.00nan;0;0
12397;200306;182;99;34;1;33;.971;3600000;0
12397;179388;182;0;0;0;0;.00nan;0;0
12397;190125;184;0;0;0;0;.00nan;0;0
12397;179668;184;81;36;4;32;.889;3600000;0
12474;178394;188;70;29;3;26;.897;3600000;0
12474;173770;193;0;0;0;0;.00nan;0;0
12474;184409;188;0;0;0;0;.00nan;0;0
12474;186451;193;44;35;6;29;.829;3600000;0
12465;184069;208;0;0;0;0;.00nan;0;0
12465;179702;208;67;36;3;33;.917;3600000;0
12465;-1;206;0;0;0;0;.00nan;0;0
12465;202998;206;34;32;5;27;.844;3600000;0
13579;184610;222;88;54;4;50;.926;3573000;0
13579;181338;230;0;0;0;0;.00nan;0;0
13579;185851;222;0;0;0;0;.00nan;0;0
13579;186495;230;52;24;3;21;.875;3600000;0
13389;182454;4864;11;18;6;12;.667;2346000;0
13389;183737;4864;62;4;0;4;1.000;1254000;0
13389;179169;209;0;0;0;0;.00nan;0;0
13389;186205;209;54;29;3;26;.897;3600000;0
12385;183695;232;71;27;2;25;.926;3151000;0
12385;189773;231;0;0;0;0;.00nan;0;0
12385;179691;232;35;9;3;6;.667;449000;0
12385;185034;231;96;23;0;23;1.000;3600000;0
12351;-1;220;69;33;3;30;.909;3900000;0
12351;187443;220;0;0;0;0;.00nan;0;0
12351;-1;214;76;39;3;36;.923;3900000;0
12351;191518;214;0;0;0;0;.00nan;0;0
12510;174325;197;51;2;0;2;1.000;251000;0
12510;201585;197;56;42;6;36;.857;3349000;0
12510;179647;195;64;24;2;22;.917;3600000;0
12510;191849;195;0;0;0;0;.00nan;0;0
12648;189902;204;0;0;0;0;.00nan;0;0
12648;184712;204;49;32;4;28;.875;3900000;0
12648;175370;199;0;0;0;0;.00nan;0;0
12648;161006;199;57;32;4;28;.875;3900000;0
12396;200452;221;57;21;2;19;.905;3600000;0
12396;189885;225;0;0;0;0;.00nan;0;0
12396;-1;225;49;31;4;27;.871;3584000;0
12396;187362;221;0;0;0;0;.00nan;0;0
12548;-1;203;0;0;0;0;.00nan;0;0
12548;179452;226;0;0;0;0;.00nan;0;0
12548;-1;203;87;38;2;36;.947;3600000;0
12548;192629;226;43;26;4;22;.846;3528000;0
12499;201562;2620;38;18;3;15;.833;3900000;0
12499;176932;176;62;31;3;28;.903;3900000;0
12499;182006;176;0;0;0;0;.00nan;0;0
12499;-1;2620;0;0;0;0;.00nan;0;0
12511;185800;229;0;0;0;0;.00nan;0;0
12511;185960;229;85;36;3;33;.917;3556000;0
12511;191120;223;88;35;2;33;.943;3600000;0
12511;187118;223;0;0;0;0;.00nan;0;0
12517;173770;193;45;10;2;8;.800;3600000;0
12517;174325;197;64;43;5;38;.884;3600000;0
12517;201585;197;0;0;0;0;.00nan;0;0
12517;186451;193;0;0;0;0;.00nan;0;0
12466;200306;182;0;0;0;0;.00nan;0;0
12466;-1;1371;92;52;4;48;.923;3552000;0
12466;179388;182;64;21;2;19;.905;3600000;0
12466;192688;1371;0;0;0;0;.00nan;0;0
12541;179452;226;63;23;2;21;.913;3600000;0
12541;-1;206;50;31;5;26;.839;2161000;0
12541;192629;226;0;0;0;0;.00nan;0;0
12541;202998;206;60;8;0;8;1.000;1439000;0
12571;196571;177;98;23;0;23;1.000;3600000;0
12571;-1;178;90;42;3;39;.929;3600000;0
12571;-1;178;0;0;0;0;.00nan;0;0
12571;-1;177;0;0;0;0;.00nan;0;0
12348;179647;195;78;26;1;25;.962;3600000;0
12348;191849;195;0;0;0;0;.00nan;0;0
12348;192547;190;0;0;0;0;.00nan;0;0
12348;197704;190;80;49;4;45;.918;3600000;0
12594;169226;186;100;22;0;22;1.000;3600000;0
12594;182128;215;36;38;6;32;.842;3089000;0
12594;185778;186;0;0;0;0;.00nan;0;0
12594;-1;215;53;2;0;2;1.000;511000;0
12592;183678;1505;0;0;0;0;.00nan;0;0
12592;195251;4949;0;0;0;0;.00nan;0;0
12592;186549;1505;57;29;3;26;.897;3545000;0
12592;197685;4949;79;26;2;24;.923;3600000;0
13217;194219;4960;0;0;0;0;.00nan;0;0
13217;173219;4960;86;43;3;40;.930;3597000;0
13217;181338;230;0;0;0;0;.00nan;0;0
13217;186495;230;68;15;1;14;.933;3600000;0
12435;182467;185;46;38;6;32;.842;2546000;0
12435;190125;184;100;28;1;27;.964;3600000;0
12435;179668;184;0;0;0;0;.00nan;0;0
12435;-1;185;42;7;2;5;.714;1054000;0
12470;184069;208;57;32;3;29;.906;3545000;0
12470;201560;202;84;30;1;29;.967;3600000;0
12470;179702;208;0;0;0;0;.00nan;0;0
12470;196299;202;0;0;0;0;.00nan;0;0
13101;170351;194;68;37;3;34;.919;3580000;0
13101;184788;198;0;0;0;0;.00nan;0;0
13101;-1;194;0;0;0;0;.00nan;0;0
13101;181431;198;75;20;1;19;.950;3600000;0
12497;-1;211;55;24;3;21;.875;3569000;0
12497;190034;217;0;0;0;0;.00nan;0;0
12497;190041;217;94;39;2;37;.949;3600000;0
12497;179646;211;0;0;0;0;.00nan;0;0
12481;201524;205;0;0;0;0;.00nan;0;0
12481;-1;207;37;34;6;28;.824;3168000;0
12481;-1;205;97;30;0;30;1.000;3600000;0
12481;-1;207;49;1;0;1;1.000;432000;0
12458;194893;191;100;33;1;32;.970;3600000;0
12458;184648;196;78;47;5;42;.894;3600000;0
12458;201892;191;0;0;0;0;.00nan;0;0
12458;191118;196;0;0;0;0;.00nan;0;0
12414;195238;200;55;37;5;32;.865;3325000;0
12414;185743;201;81;21;1;20;.952;3600000;0
12414;187295;200;29;9;3;6;.667;275000;0
12414;-1;201;0;0;0;0;.00nan;0;0
12454;173549;219;46;13;2;11;.846;1362000;0
12454;181102;219;26;25;6;19;.760;2238000;0
12454;-1;180;100;29;0;29;1.000;3600000;0
12454;197707;180;0;0;0;0;.00nan;0;0
12530;183695;232;73;43;5;38;.884;3519000;0
12530;179691;232;0;0;0;0;.00nan;0;0
12530;191120;223;0;0;0;0;.00nan;0;0
12530;187118;223;74;37;3;34;.919;3600000;0
12423;-1;216;0;0;0;0;.00nan;0;0
12423;-1;183;46;37;6;31;.838;3600000;0
12423;182089;183;0;0;0;0;.00nan;0;0
12423;187240;216;46;18;3;15;.833;3600000;0
12525;182454;4864;0;0;0;0;.00nan;0;0
12525;183737;4864;42;31;5;26;.839;3600000;0
12525;184907;4959;0;0;0;0;.00nan;0;0
12525;-1;4959;45;16;3;13;.813;3600000;0
12427;189773;231;0;0;0;0;.00nan;0;0
12427;184610;222;0;0;0;0;.00nan;0;0
12427;185034;231;56;21;2;19;.905;3600000;0
12427;185851;222;93;52;4;48;.923;3590000;0
13562;195164;218;53;29;4;25;.862;3585000;0
13562;190095;218;0;0;0;0;.00nan;0;0
13562;179679;212;0;0;0;0;.00nan;0;0
13562;186641;212;69;23;2;21;.913;3600000;0
12303;192915;179;0;0;0;0;.00nan;0;0
12303;201495;213;68;34;3;31;.912;3600000;0
12303;-1;179;78;26;1;25;.962;3600000;0
12303;203029;213;0;0;0;0;.00nan;0;0
12407;184175;224;42;31;6;25;.806;3569000;0
12407;189885;225;69;41;4;37;.902;3600000;0
12407;-1;225;0;0;0;0;.00nan;0;0
12407;185840;224;0;0;0;0;.00nan;0;0
12597;189081;187;43;27;4;23;.852;3555000;0
12597;173770;193;59;20;3;17;.850;3600000;0
12597;186451;193;0;0;0;0;.00nan;0;0
12597;-1;187;0;0;0;0;.00nan;0;0
12576;-1;203;87;41;2;39;.951;3600000;0
12576;189902;204;78;23;1;22;.957;3600000;0
12576;184712;204;0;0;0;0;.00nan;0;0
12576;-1;203;0;0;0;0;.00nan;0;0
12570;181338;230;41;15;3;12;.800;3600000;0
12570;185800;229;97;61;5;56;.918;3586000;0
12570;185960;229;0;0;0;0;.00nan;0;0
12570;186495;230;0;0;0;0;.00nan;0;0
12598;174325;197;0;0;0;0;.00nan;0;0
12598;-1;189;0;0;0;0;.00nan;0;0
12598;201585;197;97;52;4;48;.923;3782000;0
12598;-1;189;29;20;5;15;.750;3782000;0
12411;178394;188;0;0;0;0;.00nan;0;0
12411;184409;188;74;20;1;19;.950;3600000;0
12411;184648;196;0;0;0;0;.00nan;0;0
12411;191118;196;92;58;5;53;.914;3600000;0
12615;182467;185;0;0;0;0;.00nan;0;0
12615;-1;181;65;25;2;23;.920;3600000;0
12615;-1;185;47;33;5;28;.848;3600000;0
12615;192552;181;0;0;0;0;.00nan;0;0
12502;201495;213;0;0;0;0;.00nan;0;0
12502;192461;210;70;16;1;15;.938;3600000;0
12502;197672;210;0;0;0;0;.00nan;0;0
12502;203029;213;46;28;4;24;.857;3600000;0
12361;192915;179;0;0;0;0;.00nan;0;0
12361;196571;177;58;43;5;38;.884;3568000;0
12361;-1;179;56;24;3;21;.875;3600000;0
12361;-1;177;0;0;0;0;.00nan;0;0
13264;175370;199;61;14;1;13;.929;3600000;0
13264;185743;201;0;0;0;0;.00nan;0;0
13264;-1;201;89;37;2;35;.946;3568000;0
13264;161006;199;0;0;0;0;.00nan;0;0
12868;187628;227;0;0;0;0;.00nan;0;0
12868;-1;227;57;18;2;16;.889;3600000;0
12868;175354;228;26;27;6;21;.778;3600000;0
12868;180377;228;0;0;0;0;.00nan;0;0
12539;201562;2620;0;0;0;0;.00nan;0;0
12539;184907;4959;62;34;3;31;.912;3900000;0
12539;-1;2620;59;29;3;26;.897;3900000;0
12539;-1;4959;0;0;0;0;.00nan;0;0
12326;179647;195;0;0;0;0;.00nan;0;0
12326;191849;195;39;18;4;14;.778;3600000;0
12326;192547;190;60;42;5;37;.881;3600000;0
12326;197704;190;0;0;0;0;.00nan;0;0
12691;179679;212;0;0;0;0;.00nan;0;0
12691;182128;215;0;0;0;0;.00nan;0;0
12691;186641;212;81;40;4;36;.900;3758000;0
12691;-1;215;42;31;5;26;.839;3758000;0
12627;182454;4864;97;52;3;49;.942;3591000;0
12627;183737;4864;0;0;0;0;.00nan;0;0
12627;176932;176;0;0;0;0;.00nan;0;0
12627;182006;176;76;18;2;16;.889;3600000;0
13573;200306;182;97;24;0;24;1.000;3600000;0
13573;179388;182;0;0;0;0;.00nan;0;0
13573;190125;184;0;0;0;0;.00nan;0;0
13573;179668;184;71;43;4;39;.907;3600000;0
13502;169226;186;59;20;2;18;.900;3600000;0
13502;185778;186;0;0;0;0;.00nan;0;0
13502;-1;180;78;38;4;34;.895;3580000;0
13502;197707;180;0;0;0;0;.00nan;0;0
12372;-1;1371;0;0;0;0;.00nan;0;0
12372;-1;220;0;0;0;0;.00nan;0;0
12372;187443;220;67;20;1;19;.950;3900000;0
12372;192688;1371;100;38;1;37;.974;3900000;0
13560;-1;1371;77;27;2;25;.926;3600000;0
13560;-1;214;73;36;3;33;.917;3600000;0
13560;191518;214;0;0;0;0;.00nan;0;0
13560;192688;1371;0;0;0;0;.00nan;0;0
12830;184069;208;0;0;0;0;.00nan;0;0
12830;189902;204;60;18;2;16;.889;1582000;0
12830;184712;204;37;31;6;25;.806;2018000;0
12830;179702;208;69;29;3;26;.897;3600000;0
12578;179452;226;0;0;0;0;.00nan;0;0
12578;-1;206;25;31;7;24;.774;3600000;0
12578;192629;226;59;23;3;20;.870;3600000;0
12578;202998;206;0;0;0;0;.00nan;0;0
13587;179169;209;0;0;0;0;.00nan;0;0
13587;176932;176;74;35;3;32;.914;3633000;0
13587;182006;176;0;0;0;0;.00nan;0;0
13587;186205;209;67;30;2;28;.933;3633000;0
12603;195251;4949;90;33;1;32;.970;3600000;0
12603;197685;4949;0;0;0;0;.00nan;0;0
12603;-1;178;0;0;0;0;.00nan;0;0
12603;-1;178;51;31;4;27;.871;3600000;0
13496;187628;227;43;28;5;23;.821;3558000;0
13496;183695;232;0;0;0;0;.00nan;0;0
13496;-1;227;0;0;0;0;.00nan;0;0
13496;179691;232;45;30;4;26;.867;3600000;0
13523;-1;203;0;0;0;0;.00nan;0;0
13523;175370;199;0;0;0;0;.00nan;0;0
13523;-1;203;88;33;2;31;.939;3600000;0
13523;161006;199;45;19;3;16;.842;3548000;0
13507;178394;188;61;13;1;12;.923;3600000;0
13507;184409;188;0;0;0;0;.00nan;0;0
13507;174325;197;50;31;4;27;.871;2151000;0
13507;201585;197;65;18;1;17;.944;1449000;0
13593;189885;225;0;0;0;0;.00nan;0;0
13593;-1;225;15;19;6;13;.684;3600000;0
13593;191120;223;87;37;2;35;.946;3600000;0
13593;187118;223;0;0;0;0;.00nan;0;0
12522;173900;192;0;0;0;0;.00nan;0;0
12522;184788;198;0;0;0;0;.00nan;0;0
12522;-1;192;100;29;0;29;1.000;3600000;0
12522;181431;198;67;29;3;26;.897;3600000;0
12389;195238;200;0;0;0;0;.00nan;0;0
12389;201524;205;0;0;0;0;.00nan;0;0
12389;-1;205;78;24;2;22;.917;3600000;0
12389;187295;200;70;45;6;39;.867;3600000;0
12482;173549;219;0;0;0;0;.00nan;0;0
12482;195164;218;0;0;0;0;.00nan;0;0
12482;190095;218;67;27;2;25;.926;3600000;0
12482;181102;219;70;33;3;30;.909;3596000;0
12518;170351;194;99;36;1;35;.972;3600000;0
12518;-1;189;37;26;5;21;.808;3600000;0
12518;-1;194;0;0;0;0;.00nan;0;0
12518;-1;189;0;0;0;0;.00nan;0;0
12379;189773;231;50;9;1;8;.889;760000;0
12379;175354;228;56;4;0;4;1.000;689000;0
12379;185034;231;25;25;6;19;.760;2793000;0
12379;180377;228;38;36;6;30;.833;2911000;0
12551;-1;216;43;35;5;30;.857;3600000;0
12551;187240;216;0;0;0;0;.00nan;0;0
12551;192461;210;0;0;0;0;.00nan;0;0
12551;197672;210;61;23;2;21;.913;3600000;0
12442;200452;221;0;0;0;0;.00nan;0;0
12442;184610;222;47;34;5;29;.853;3600000;0
12442;185851;222;0;0;0;0;.00nan;0;0
12442;187362;221;99;41;2;39;.951;3600000;0
12765;182467;185;66;15;1;14;.933;3600000;0
12765;-1;181;17;21;6;15;.714;1810000;0
12765;-1;185;0;0;0;0;.00nan;0;0
12765;192552;181;69;23;1;22;.957;1790000;0
12486;-1;211;52;37;5;32;.865;3600000;0
12486;190034;217;90;34;1;33;.971;3600000;0
12486;190041;217;0;0;0;0;.00nan;0;0
12486;179646;211;0;0;0;0;.00nan;0;0
12528;184175;224;58;40;5;35;.875;3600000;0
12528;184610;222;67;22;2;20;.909;3600000;0
12528;185840;224;0;0;0;0;.00nan;0;0
12528;185851;222;0;0;0;0;.00nan;0;0
13485;201562;2620;0;0;0;0;.00nan;0;0
13485;184907;4959;0;0;0;0;.00nan;0;0
13485;-1;2620;64;21;2;19;.905;3600000;0
13485;-1;4959;47;24;3;21;.875;3587000;0
12477;184069;208;76;38;3;35;.921;3600000;0
12477;179702;208;0;0;0;0;.00nan;0;0
12477;-1;207;44;24;4;20;.833;2201000;0
12477;-1;207;49;16;3;13;.813;1399000;0
13277;194219;4960;100;43;1;42;.977;3600000;0
13277;173219;4960;0;0;0;0;.00nan;0;0
13277;181338;230;0;0;0;0;.00nan;0;0
13277;186495;230;48;23;3;20;.870;3516000;0
12445;200306;182;97;36;2;34;.944;3900000;0
12445;179388;182;0;0;0;0;.00nan;0;0
12445;-1;214;0;0;0;0;.00nan;0;0
12445;191518;214;74;30;2;28;.933;3900000;0
13505;-1;216;0;0;0;0;.00nan;0;0
13505;201495;213;70;30;3;27;.900;3800000;0
13505;187240;216;83;31;2;29;.935;3800000;0
13505;203029;213;0;0;0;0;.00nan;0;0
12616;201562;2620;72;24;1;23;.958;3582000;0
12616;176932;176;0;0;0;0;.00nan;0;0
12616;182006;176;100;29;0;29;1.000;3600000;0
12616;-1;2620;0;0;0;0;.00nan;0;0
12601;173770;193;57;21;1;20;.952;3900000;0
12601;174325;197;0;0;0;0;.00nan;0;0
12601;201585;197;100;48;1;47;.979;3900000;0
12601;186451;193;0;0;0;0;.00nan;0;0
12459;187628;227;0;0;0;0;.00nan;0;0
12459;189773;231;0;0;0;0;.00nan;0;0
12459;-1;227;77;41;3;38;.927;3584000;0
12459;185034;231;77;26;2;24;.923;3600000;0
12638;195164;218;88;36;2;34;.944;3900000;0
12638;190095;218;0;0;0;0;.00nan;0;0
12638;179679;212;0;0;0;0;.00nan;0;0
12638;186641;212;80;34;2;32;.941;3900000;0
12605;169226;186;57;14;1;13;.929;3600000;0
12605;190034;217;0;0;0;0;.00nan;0;0
12605;190041;217;35;23;4;19;.826;3600000;0
12605;185778;186;0;0;0;0;.00nan;0;0
12634;179452;226;72;28;3;25;.893;3900000;0
12634;185743;201;70;35;3;32;.914;3900000;0
12634;192629;226;0;0;0;0;.00nan;0;0
12634;-1;201;0;0;0;0;.00nan;0;0
12479;178394;188;0;0;0;0;.00nan;0;0
12479;184409;188;50;29;4;25;.862;3593000;0
12479;179647;195;83;45;3;42;.933;3600000;0
12479;191849;195;0;0;0;0;.00nan;0;0
12374;192915;179;0;0;0;0;.00nan;0;0
12374;195251;4949;91;32;1;31;.969;3600000;0
12374;-1;179;67;25;2;23;.920;3569000;0
12374;197685;4949;0;0;0;0;.00nan;0;0
13451;183678;1505;71;34;3;31;.912;3564000;0
13451;186549;1505;0;0;0;0;.00nan;0;0
13451;192461;210;78;33;2;31;.939;3600000;0
13451;197672;210;0;0;0;0;.00nan;0;0
12507;201524;205;0;0;0;0;.00nan;0;0
12507;-1;205;79;11;0;11;1.000;3600000;0
12507;-1;206;0;0;0;0;.00nan;0;0
12507;202998;206;88;49;1;48;.980;3600000;0
12513;173549;219;86;29;2;27;.931;3600000;0
12513;181102;219;0;0;0;0;.00nan;0;0
12513;-1;180;96;48;3;45;.938;3546000;0
12513;197707;180;0;0;0;0;.00nan;0;0
13526;-1;181;49;25;4;21;.840;3543000;0
13526;-1;220;0;0;0;0;.00nan;0;0
13526;187443;220;64;29;3;26;.897;3600000;0
13526;192552;181;0;0;0;0;.00nan;0;0
12400;170351;194;0;0;0;0;.00nan;0;0
12400;-1;194;77;14;0;14;1.000;3600000;0
12400;192547;190;0;0;0;0;.00nan;0;0
12400;197704;190;43;36;5;31;.861;3600000;0
12669;184648;196;100;34;0;34;1.000;3600000;0
12669;184788;198;0;0;0;0;.00nan;0;0
12669;181431;198;54;28;3;25;.893;3600000;0
12669;191118;196;0;0;0;0;.00nan;0;0
12489;178394;188;28;8;3;5;.625;517000;0
12489;184409;188;82;29;1;28;.966;3064000;0
12489;179647;195;0;0;0;0;.00nan;0;0
12489;191849;195;57;17;2;15;.882;3600000;0
12555;183678;1505;0;0;0;0;.00nan;0;0
12555;-1;183;0;0;0;0;.00nan;0;0
12555;182089;183;74;31;2;29;.935;3600000;0
12555;186549;1505;36;23;5;18;.783;3600000;0
12698;174325;197;88;41;2;39;.951;3756000;0
12698;184648;196;42;15;3;12;.800;3756000;0
12698;201585;197;0;0;0;0;.00nan;0;0
12698;191118;196;0;0;0;0;.00nan;0;0
12487;184069;208;0;0;0;0;.00nan;0;0
12487;179452;226;0;0;0;0;.00nan;0;0
12487;179702;208;68;43;5;38;.884;3600000;0
12487;192629;226;72;23;1;22;.957;3600000;0
12488;201560;202;65;19;2;17;.895;3600000;0
12488;-1;207;46;46;7;39;.848;3600000;0
12488;196299;202;0;0;0;0;.00nan;0;0
12488;-1;207;0;0;0;0;.00nan;0;0
12520;182467;185;55;26;3;23;.885;3600000;0
12520;200306;182;85;49;4;45;.918;3596000;0
12520;179388;182;0;0;0;0;.00nan;0;0
12520;-1;185;0;0;0;0;.00nan;0;0
12514;190125;184;63;20;2;18;.900;3600000;0
12514;179668;184;0;0;0;0;.00nan;0;0
12514;-1;214;53;27;4;23;.852;3531000;0
12514;191518;214;0;0;0;0;.00nan;0;0
12713;-1;216;69;37;4;33;.892;3600000;0
12713;201495;213;69;25;2;23;.920;2987000;0
12713;187240;216;0;0;0;0;.00nan;0;0
12713;203029;213;24;5;3;2;.400;590000;0
12897;169226;186;0;0;0;0;.00nan;0;0
12897;182128;215;0;0;0;0;.00nan;0;0
12897;185778;186;97;40;2;38;.950;3600000;0
12897;-1;215;40;30;5;25;.833;3600000;0
12467;194219;4960;0;0;0;0;.00nan;0;0
12467;173219;4960;87;16;0;16;1.000;3600000;0
12467;189885;225;96;31;1;30;.968;3544000;0
12467;-1;225;0;0;0;0;.00nan;0;0
12468;189081;187;48;26;4;22;.846;3600000;0
12468;192547;190;56;39;5;34;.872;3545000;0
12468;-1;187;0;0;0;0;.00nan;0;0
12468;197704;190;0;0;0;0;.00nan;0;0
12533;200452;221;0;0;0;0;.00nan;0;0
12533;191120;223;82;43;3;40;.930;3529000;0
12533;187118;223;0;0;0;0;.00nan;0;0
12533;187362;221;85;27;1;26;.963;3600000;0
12613;195251;4949;50;3;0;3;1.000;251000;0
12613;196571;177;64;28;3;25;.893;3600000;0
12613;197685;4949;40;31;6;25;.806;3349000;0
12613;-1;177;0;0;0;0;.00nan;0;0
12586;182454;4864;0;0;0;0;.00nan;0;0
12586;183737;4864;75;40;4;36;.900;3600000;0
12586;184907;4959;0;0;0;0;.00nan;0;0
12586;-1;4959;77;10;0;10;1.000;3600000;0
12580;181338;230;0;0;0;0;.00nan;0;0
12580;185800;229;78;56;6;50;.893;3600000;0
12580;185960;229;0;0;0;0;.00nan;0;0
12580;186495;230;73;19;1;18;.947;3600000;0
12421;195238;200;44;20;3;17;.850;1709000;0
12421;175370;199;0;0;0;0;.00nan;0;0
12421;187295;200;39;19;4;15;.789;1891000;0
12421;161006;199;94;20;0;20;1.000;3600000;0
13590;183695;232;60;32;5;27;.844;3871000;0
13590;189773;231;60;34;4;30;.882;3871000;0
13590;179691;232;0;0;0;0;.00nan;0;0
13590;185034;231;0;0;0;0;.00nan;0;0
12531;184175;224;86;36;2;34;.944;3600000;0
12531;184610;222;57;30;3;27;.900;3597000;0
12531;185840;224;0;0;0;0;.00nan;0;0
12531;185851;222;0;0;0;0;.00nan;0;0
12759;-1;203;52;36;5;31;.861;3576000;0
12759;189902;204;67;29;3;26;.897;3600000;0
12759;184712;204;0;0;0;0;.00nan;0;0
12759;-1;203;0;0;0;0;.00nan;0;0
12401;192915;179;76;40;4;36;.900;3584000;0
12401;-1;179;0;0;0;0;.00nan;0;0
12401;-1;178;66;31;3;28;.903;3600000;0
12401;-1;178;0;0;0;0;.00nan;0;0
12523;-1;211;71;33;3;30;.909;3558000;0
12523;179646;211;0;0;0;0;.00nan;0;0
12523;179679;212;0;0;0;0;.00nan;0;0
12523;186641;212;91;45;2;43;.956;3600000;0
12780;194893;191;50;12;2;10;.833;3600000;0
12780;170351;194;52;28;4;24;.857;2072000;0
12780;-1;194;58;26;3;23;.885;1528000;0
12780;201892;191;0;0;0;0;.00nan;0;0
12566;173770;193;0;0;0;0;.00nan;0;0
12566;173900;192;0;0;0;0;.00nan;0;0
12566;-1;192;76;21;1;20;.952;3600000;0
12566;186451;193;55;22;3;19;.864;3578000;0
12424;-1;1371;0;0;0;0;.00nan;0;0
12424;-1;220;80;45;3;42;.933;3600000;0
12424;187443;220;0;0;0;0;.00nan;0;0
12424;192688;1371;59;31;4;27;.871;3574000;0
12534;173549;219;72;20;1;19;.950;3600000;0
12534;195164;218;84;61;5;56;.918;3600000;0
12534;190095;218;0;0;0;0;.00nan;0;0
12534;181102;219;0;0;0;0;.00nan;0;0
12559;201560;202;0;0;0;0;.00nan;0;0
12559;196299;202;44;18;3;15;.833;3600000;0
12559;185743;201;57;41;5;36;.878;3565000;0
12559;-1;201;0;0;0;0;.00nan;0;0
12561;183695;232;0;0;0;0;.00nan;0;0
12561;184610;222;51;33;5;28;.848;3600000;0
12561;179691;232;75;37;3;34;.919;3600000;0
12561;185851;222;0;0;0;0;.00nan;0;0
12425;195238;200;0;0;0;0;.00nan;0;0
12425;175370;199;31;19;4;15;.789;3545000;0
12425;187295;200;86;44;3;41;.932;3600000;0
12425;161006;199;0;0;0;0;.00nan;0;0
12608;-1;183;100;48;1;47;.979;3600000;0
12608;182089;183;0;0;0;0;.00nan;0;0
12608;192461;210;51;15;2;13;.867;3589000;0
12608;197672;210;0;0;0;0;.00nan;0;0
12625;187628;227;0;0;0;0;.00nan;0;0
12625;-1;227;51;30;4;26;.867;3900000;0
12625;185800;229;0;0;0;0;.00nan;0;0
12625;185960;229;63;36;4;32;.889;3900000;0
12587;176932;176;0;0;0;0;.00nan;0;0
12587;184907;4959;0;0;0;0;.00nan;0;0
12587;182006;176;79;48;3;45;.938;3600000;0
12587;-1;4959;84;35;2;33;.943;3600000;0
12584;201495;213;73;25;2;23;.920;3600000;0
12584;-1;178;0;0;0;0;.00nan;0;0
12584;203029;213;0;0;0;0;.00nan;0;0
12584;-1;178;55;30;3;27;.900;3541000;0
12484;189885;225;68;43;5;38;.884;3600000;0
12484;175354;228;59;19;2;17;.895;3600000;0
12484;180377;228;0;0;0;0;.00nan;0;0
12484;-1;225;0;0;0;0;.00nan;0;0
13478;173900;192;0;0;0;0;.00nan;0;0
13478;184648;196;0;0;0;0;.00nan;0;0
13478;-1;192;50;19;3;16;.842;3544000;0
13478;191118;196;93;39;2;37;.949;3600000;0
12595;173549;219;0;0;0;0;.00nan;0;0
12595;179679;212;0;0;0;0;.00nan;0;0
12595;181102;219;64;33;4;29;.879;3620000;0
12595;186641;212;63;20;3;17;.850;3620000;0
12394;-1;1371;0;0;0;0;.00nan;0;0
12394;-1;220;56;36;5;31;.861;3600000;0
12394;187443;220;0;0;0;0;.00nan;0;0
12394;192688;1371;49;21;3;18;.857;3600000;0
12410;200452;221;88;33;1;32;.970;3600000;0
12410;191120;223;27;32;6;26;.813;2087000;0
12410;187118;223;69;14;0;14;1.000;1513000;0
12410;187362;221;0;0;0;0;.00nan;0;0
12560;200306;182;0;0;0;0;.00nan;0;0
12560;179388;182;67;22;1;21;.955;3600000;0
12560;-1;181;69;32;3;29;.906;3553000;0
12560;192552;181;0;0;0;0;.00nan;0;0
12788;169226;186;74;29;2;27;.931;3571000;0
12788;185778;186;0;0;0;0;.00nan;0;0
12788;-1;180;77;27;1;26;.963;3600000;0
12788;197707;180;0;0;0;0;.00nan;0;0
13404;194219;4960;85;50;4;46;.920;3600000;0
13404;173219;4960;0;0;0;0;.00nan;0;0
13404;181338;230;0;0;0;0;.00nan;0;0
13404;186495;230;84;30;1;29;.967;3600000;0
12686;189081;187;82;31;1;30;.968;3900000;0
12686;194893;191;69;17;1;16;.941;3900000;0
12686;201892;191;0;0;0;0;.00nan;0;0
12686;-1;187;0;0;0;0;.00nan;0;0
12506;189902;204;56;24;3;21;.875;3600000;0
12506;184712;204;0;0;0;0;.00nan;0;0
12506;-1;207;49;36;5;31;.861;3565000;0
12506;-1;207;0;0;0;0;.00nan;0;0
12434;192915;179;0;0;0;0;.00nan;0;0
12434;-1;179;71;35;4;31;.886;3554000;0
12434;192461;210;0;0;0;0;.00nan;0;0
12434;197672;210;73;26;2;24;.923;3600000;0
12535;184069;208;92;38;3;35;.921;3552000;0
12535;201524;205;0;0;0;0;.00nan;0;0
12535;179702;208;0;0;0;0;.00nan;0;0
12535;-1;205;72;26;2;24;.923;3600000;0
12545;-1;211;70;30;2;28;.933;3600000;0
12545;179646;211;0;0;0;0;.00nan;0;0
12545;182128;215;53;31;4;27;.871;3541000;0
12545;-1;215;0;0;0;0;.00nan;0;0
12642;182454;4864;0;0;0;0;.00nan;0;0
12642;183737;4864;71;33;3;30;.909;3600000;0
12642;179169;209;0;0;0;0;.00nan;0;0
12642;186205;209;64;19;1;18;.947;3600000;0
12542;178394;188;0;0;0;0;.00nan;0;0
12542;184409;188;99;36;1;35;.972;3600000;0
12542;184788;198;0;0;0;0;.00nan;0;0
12542;181431;198;37;24;5;19;.792;3600000;0
12500;-1;189;0;0;0;0;.00nan;0;0
12500;192547;190;49;36;5;31;.861;3600000;0
12500;197704;190;0;0;0;0;.00nan;0;0
12500;-1;189;78;42;4;38;.905;3600000;0
12877;-1;203;71;14;1;13;.929;3900000;0
12877;-1;203;0;0;0;0;.00nan;0;0
12877;185743;201;0;0;0;0;.00nan;0;0
12877;-1;201;81;24;1;23;.958;3900000;0
12808;183678;1505;0;0;0;0;.00nan;0;0
12808;-1;216;0;0;0;0;.00nan;0;0
12808;186549;1505;53;24;3;21;.875;3560000;0
12808;187240;216;83;34;2;32;.941;3600000;0
12501;190125;184;70;25;2;23;.920;3600000;0
12501;179668;184;0;0;0;0;.00nan;0;0
12501;-1;214;0;0;0;0;.00nan;0;0
12501;191518;214;90;45;3;42;.933;3599000;0
12666;173900;192;0;0;0;0;.00nan;0;0
12666;-1;189;26;13;4;9;.692;910000;0
12666;-1;192;84;31;2;29;.935;3600000;0
12666;-1;189;52;20;3;17;.850;2690000;0
12670;189902;204;51;37;5;32;.865;3559000;0
12670;184712;204;0;0;0;0;.00nan;0;0
12670;175370;199;0;0;0;0;.00nan;0;0
12670;161006;199;61;27;4;23;.852;3600000;0
12532;184175;224;74;40;4;36;.900;3600000;0
12532;175354;228;0;0;0;0;.00nan;0;0
12532;180377;228;55;44;6;38;.864;3600000;0
12532;185840;224;0;0;0;0;.00nan;0;0
12529;-1;207;0;0;0;0;.00nan;0;0
12529;-1;206;73;31;2;29;.935;3600000;0
12529;-1;207;20;28;7;21;.750;3600000;0
12529;202998;206;0;0;0;0;.00nan;0;0
12557;182467;185;87;35;2;33;.943;3900000;0
12557;200306;182;82;27;2;25;.926;3900000;0
12557;179388;182;0;0;0;0;.00nan;0;0
12557;-1;185;0;0;0;0;.00nan;0;0
12527;179452;226;81;34;2;32;.941;3591000;0
12527;201524;205;100;32;0;32;1.000;3600000;0
12527;-1;205;0;0;0;0;.00nan;0;0
12527;192629;226;0;0;0;0;.00nan;0;0
12437;-1;1371;92;33;1;32;.970;3845000;0
12437;-1;220;0;0;0;0;.00nan;0;0
12437;187443;220;94;39;2;37;.949;3845000;0
12437;192688;1371;0;0;0;0;.00nan;0;0
12462;190125;184;0;0;0;0;.00nan;0;0
12462;179668;184;88;38;3;35;.921;3600000;0
12462;-1;181;75;29;2;27;.931;3226000;0
12462;192552;181;28;7;3;4;.571;374000;0
12640;176932;176;74;38;4;34;.895;3900000;0
12640;184907;4959;62;34;4;30;.882;3900000;0
12640;182006;176;0;0;0;0;.00nan;0;0
12640;-1;4959;0;0;0;0;.00nan;0;0
13515;174325;197;0;0;0;0;.00nan;0;0
13515;201585;197;78;29;1;28;.966;3600000;0
13515;192547;190;0;0;0;0;.00nan;0;0
13515;197704;190;49;33;5;28;.848;3600000;0
13536;192915;179;68;31;2;29;.935;3600000;0
13536;-1;179;0;0;0;0;.00nan;0;0
13536;-1;178;57;32;4;28;.875;3542000;0
13536;-1;178;0;0;0;0;.00nan;0;0
12596;195164;218;75;28;1;27;.964;3600000;0
12596;190095;218;0;0;0;0;.00nan;0;0
12596;182128;215;0;0;0;0;.00nan;0;0
12596;-1;215;58;34;4;30;.882;3600000;0
12661;182454;4864;78;43;3;40;.930;3900000;0
12661;183737;4864;0;0;0;0;.00nan;0;0
12661;179169;209;58;26;3;23;.885;3900000;0
12661;186205;209;0;0;0;0;.00nan;0;0
12657;183695;232;62;28;4;24;.857;3582000;0
12657;184610;222;75;40;3;37;.925;3600000;0
12657;179691;232;0;0;0;0;.00nan;0;0
12657;185851;222;0;0;0;0;.00nan;0;0
12606;195251;4949;100;35;1;34;.971;3600000;0
12606;196571;177;19;19;6;13;.684;2968000;0
12606;197685;4949;0;0;0;0;.00nan;0;0
12606;-1;177;43;5;1;4;.800;632000;0
13220;194893;191;58;20;2;18;.900;3600000;0
13220;174325;197;0;0;0;0;.00nan;0;0
13220;201585;197;91;63;5;58;.921;3600000;0
13220;201892;191;0;0;0;0;.00nan;0;0
12537;194219;4960;0;0;0;0;.00nan;0;0
12537;173219;4960;75;44;4;40;.909;3600000;0
12537;189773;231;0;0;0;0;.00nan;0;0
12537;185034;231;74;23;1;22;.957;3600000;0
12505;189885;225;65;33;4;29;.879;3594000;0
12505;-1;225;0;0;0;0;.00nan;0;0
12505;185800;229;67;31;3;28;.903;3600000;0
12505;185960;229;0;0;0;0;.00nan;0;0
13538;175370;199;77;32;3;29;.906;3900000;0
13538;179452;226;0;0;0;0;.00nan;0;0
13538;192629;226;76;32;3;29;.906;3900000;0
13538;161006;199;0;0;0;0;.00nan;0;0
12503;201495;213;0;0;0;0;.00nan;0;0
12503;192461;210;71;20;2;18;.900;3600000;0
12503;197672;210;0;0;0;0;.00nan;0;0
12503;203029;213;70;39;3;36;.923;3567000;0
12866;183678;1505;0;0;0;0;.00nan;0;0
12866;-1;183;0;0;0;0;.00nan;0;0
12866;182089;183;48;34;5;29;.853;3600000;0
12866;186549;1505;68;18;1;17;.944;3600000;0
13019;169226;186;87;32;2;30;.938;3565000;0
13019;195164;218;0;0;0;0;.00nan;0;0
13019;190095;218;91;38;1;37;.974;3600000;0
13019;185778;186;0;0;0;0;.00nan;0;0
12600;-1;211;59;29;3;26;.897;3559000;0
12600;179646;211;0;0;0;0;.00nan;0;0
12600;-1;180;51;20;2;18;.900;3600000;0
12600;197707;180;0;0;0;0;.00nan;0;0
12704;182467;185;0;0;0;0;.00nan;0;0
12704;-1;185;56;16;2;14;.875;3773000;0
12704;-1;214;84;35;3;32;.914;3773000;0
12704;191518;214;0;0;0;0;.00nan;0;0
12516;173770;193;0;0;0;0;.00nan;0;0
12516;184648;196;94;56;5;51;.911;3600000;0
12516;186451;193;87;17;0;17;1.000;3600000;0
12516;191118;196;0;0;0;0;.00nan;0;0
12553;187628;227;0;0;0;0;.00nan;0;0
12553;-1;227;92;29;1;28;.966;3600000;0
12553;191120;223;49;37;5;32;.865;3600000;0
12553;187118;223;0;0;0;0;.00nan;0;0
12650;183695;232;42;21;3;18;.857;3013000;0
12650;200452;221;0;0;0;0;.00nan;0;0
12650;179691;232;26;6;3;3;.500;587000;0
12650;187362;221;88;38;2;36;.947;3600000;0
12663;189081;187;61;29;3;26;.897;3552000;0
12663;184788;198;0;0;0;0;.00nan;0;0
12663;181431;198;75;26;1;25;.962;3600000;0
12663;-1;187;0;0;0;0;.00nan;0;0
12544;184175;224;84;59;5;54;.915;3556000;0
12544;189773;231;0;0;0;0;.00nan;0;0
12544;185034;231;38;20;4;16;.800;3600000;0
12544;185840;224;0;0;0;0;.00nan;0;0
12703;179169;209;0;0;0;0;.00nan;0;0
12703;201562;2620;0;0;0;0;.00nan;0;0
12703;-1;2620;43;11;2;9;.818;3518000;0
12703;186205;209;100;34;0;34;1.000;3600000;0
12895;170351;194;28;26;5;21;.808;3600000;0
12895;-1;189;99;37;1;36;.973;3600000;0
12895;-1;194;0;0;0;0;.00nan;0;0
12895;-1;189;0;0;0;0;.00nan;0;0
12950;175354;228;68;38;4;34;.895;3600000;0
12950;180377;228;0;0;0;0;.00nan;0;0
12950;181338;230;0;0;0;0;.00nan;0;0
12950;186495;230;73;22;1;21;.955;3600000;0
13492;189902;204;41;30;5;25;.833;3600000;0
13492;184712;204;0;0;0;0;.00nan;0;0
13492;201524;205;66;21;2;19;.905;3600000;0
13492;-1;205;0;0;0;0;.00nan;0;0
13503;195251;4949;48;27;4;23;.852;3600000;0
13503;-1;183;30;16;4;12;.750;1063000;0
13503;182089;183;72;32;2;30;.938;2511000;0
13503;197685;4949;0;0;0;0;.00nan;0;0
12569;184069;208;87;38;3;35;.921;3900000;0
12569;201560;202;64;25;3;22;.880;3900000;0
12569;179702;208;0;0;0;0;.00nan;0;0
12569;196299;202;0;0;0;0;.00nan;0;0
12494;173900;192;0;0;0;0;.00nan;0;0
12494;179647;195;34;27;6;21;.778;3600000;0
12494;-1;192;78;30;2;28;.933;3600000;0
12494;191849;195;0;0;0;0;.00nan;0;0
12443;195238;200;0;0;0;0;.00nan;0;0
12443;-1;206;77;28;1;27;.964;3600000;0
12443;187295;200;60;42;4;38;.905;3600000;0
12443;202998;206;0;0;0;0;.00nan;0;0
12651;196571;177;61;21;3;18;.857;3513000;0
12651;-1;178;0;0;0;0;.00nan;0;0
12651;-1;178;95;38;1;37;.974;3600000;0
12651;-1;177;0;0;0;0;.00nan;0;0
13591;194219;4960;73;21;1;20;.952;3600000;0
13591;173219;4960;0;0;0;0;.00nan;0;0
13591;184610;222;58;32;4;28;.875;3600000;0
13591;185851;222;0;0;0;0;.00nan;0;0
12649;200306;182;85;28;1;27;.964;3600000;0
12649;179388;182;0;0;0;0;.00nan;0;0
12649;190125;184;74;29;2;27;.931;3545000;0
12649;179668;184;0;0;0;0;.00nan;0;0
12770;-1;181;98;28;0;28;1.000;3600000;0
12770;-1;214;81;31;2;29;.935;3585000;0
12770;191518;214;0;0;0;0;.00nan;0;0
12770;192552;181;0;0;0;0;.00nan;0;0
12643;173549;219;58;26;3;23;.885;3658000;0
12643;181102;219;0;0;0;0;.00nan;0;0
12643;182128;215;70;38;4;34;.895;3714000;0
12643;-1;215;0;0;0;0;.00nan;0;0
12720;-1;211;71;42;4;38;.905;3600000;0
12720;169226;186;67;25;3;22;.880;3600000;0
12720;179646;211;0;0;0;0;.00nan;0;0
12720;185778;186;0;0;0;0;.00nan;0;0
12607;189885;225;0;0;0;0;.00nan;0;0
12607;-1;225;75;26;2;24;.923;3600000;0
12607;191120;223;71;35;4;31;.886;3538000;0
12607;187118;223;0;0;0;0;.00nan;0;0
12521;195238;200;0;0;0;0;.00nan;0;0
12521;-1;207;71;44;4;40;.909;3600000;0
12521;187295;200;77;35;3;32;.914;3600000;0
12521;-1;207;0;0;0;0;.00nan;0;0
12706;189902;204;56;34;4;30;.882;3600000;0
12706;184712;204;0;0;0;0;.00nan;0;0
12706;-1;206;0;0;0;0;.00nan;0;0
12706;202998;206;81;19;1;18;.947;3600000;0
12558;192915;179;0;0;0;0;.00nan;0;0
12558;183678;1505;0;0;0;0;.00nan;0;0
12558;-1;179;78;30;2;28;.933;3600000;0
12558;186549;1505;72;35;3;32;.914;3550000;0
12538;194893;191;0;0;0;0;.00nan;0;0
12538;179647;195;0;0;0;0;.00nan;0;0
12538;201892;191;97;53;2;51;.962;3552000;0
12538;191849;195;86;35;1;34;.971;3600000;0
12573;178394;188;0;0;0;0;.00nan;0;0
12573;184409;188;56;34;5;29;.853;3595000;0
12573;-1;189;0;0;0;0;.00nan;0;0
12573;-1;189;83;40;2;38;.950;3600000;0
12585;175370;199;0;0;0;0;.00nan;0;0
12585;201560;202;0;0;0;0;.00nan;0;0
12585;196299;202;62;22;2;20;.909;3571000;0
12585;161006;199;77;27;1;26;.963;3600000;0
12504;174325;197;0;0;0;0;.00nan;0;0
12504;201585;197;95;34;1;33;.971;3600000;0
12504;192547;190;44;24;4;20;.833;3600000;0
12504;197704;190;0;0;0;0;.00nan;0;0
12674;187628;227;70;24;1;23;.958;3600000;0
12674;200452;221;0;0;0;0;.00nan;0;0
12674;-1;227;0;0;0;0;.00nan;0;0
12674;187362;221;86;49;4;45;.918;3600000;0
13072;-1;216;0;0;0;0;.00nan;0;0
13072;187240;216;46;36;5;31;.861;3600000;0
13072;192461;210;74;22;1;21;.955;3600000;0
13072;197672;210;0;0;0;0;.00nan;0;0
12473;182467;185;70;32;3;29;.906;3596000;0
12473;-1;220;0;0;0;0;.00nan;0;0
12473;187443;220;79;24;1;23;.958;3600000;0
12473;-1;185;0;0;0;0;.00nan;0;0
12593;184069;208;0;0;0;0;.00nan;0;0
12593;179452;226;66;23;1;22;.957;3600000;0
12593;179702;208;74;52;5;47;.904;3600000;0
12593;192629;226;0;0;0;0;.00nan;0;0
12582;187628;227;0;0;0;0;.00nan;0;0
12582;-1;227;56;31;3;28;.903;3866000;0
12582;189885;225;91;51;4;47;.922;3866000;0
12582;-1;225;0;0;0;0;.00nan;0;0
12848;182467;185;0;0;0;0;.00nan;0;0
12848;-1;185;78;41;3;38;.927;3804000;0
12848;-1;214;0;0;0;0;.00nan;0;0
12848;191518;214;48;26;4;22;.846;3804000;0
12768;200452;221;56;43;5;38;.884;3600000;0
12768;175354;228;0;0;0;0;.00nan;0;0
12768;180377;228;70;23;2;21;.913;3600000;0
12768;187362;221;0;0;0;0;.00nan;0;0
12835;195164;218;53;36;5;31;.861;3600000;0
12835;190095;218;0;0;0;0;.00nan;0;0
12835;-1;180;94;32;1;31;.969;3600000;0
12835;197707;180;0;0;0;0;.00nan;0;0
12568;173900;192;0;0;0;0;.00nan;0;0
12568;-1;192;68;22;2;20;.909;3600000;0
12568;192547;190;0;0;0;0;.00nan;0;0
12568;197704;190;82;45;4;41;.911;3515000;0
12766;179169;209;0;0;0;0;.00nan;0;0
12766;176932;176;0;0;0;0;.00nan;0;0
12766;182006;176;92;41;2;39;.951;3600000;0
12766;186205;209;79;37;3;34;.919;3544000;0
12736;173549;219;73;31;2;29;.935;2890000;0
12736;181102;219;26;15;4;11;.733;710000;0
12736;182128;215;0;0;0;0;.00nan;0;0
12736;-1;215;100;26;0;26;1.000;3600000;0
12556;178394;188;100;36;0;36;1.000;3600000;0
12556;184409;188;0;0;0;0;.00nan;0;0
12556;184788;198;72;21;1;20;.952;3577000;0
12556;181431;198;0;0;0;0;.00nan;0;0
12745;-1;211;0;0;0;0;.00nan;0;0
12745;179646;211;31;35;7;28;.800;3600000;0
12745;179679;212;0;0;0;0;.00nan;0;0
12745;186641;212;60;28;4;24;.857;3600000;0
12688;183695;232;92;38;1;37;.974;3600000;0
12688;179691;232;0;0;0;0;.00nan;0;0
12688;185800;229;0;0;0;0;.00nan;0;0
12688;185960;229;51;28;4;24;.857;3600000;0
12665;173770;193;0;0;0;0;.00nan;0;0
12665;174325;197;0;0;0;0;.00nan;0;0
12665;201585;197;62;39;4;35;.897;3600000;0
12665;186451;193;61;13;1;12;.923;3600000;0
12890;170351;194;82;33;1;32;.970;3600000;0
12890;184648;196;88;34;2;32;.941;3565000;0
12890;-1;194;0;0;0;0;.00nan;0;0
12890;191118;196;0;0;0;0;.00nan;0;0
12577;-1;207;0;0;0;0;.00nan;0;0
12577;185743;201;40;30;5;25;.833;3600000;0
12577;-1;207;74;28;1;27;.964;3600000;0
12577;-1;201;0;0;0;0;.00nan;0;0
12974;179452;226;0;0;0;0;.00nan;0;0
12974;201524;205;0;0;0;0;.00nan;0;0
12974;-1;205;68;41;4;37;.902;3600000;0
12974;192629;226;89;33;1;32;.970;3600000;0
12645;-1;183;0;0;0;0;.00nan;0;0
12645;182089;183;82;34;2;32;.941;3600000;0
12645;192461;210;0;0;0;0;.00nan;0;0
12645;197672;210;51;39;5;34;.872;3600000;0
12515;190125;184;78;31;2;29;.935;3600000;0
12515;179668;184;0;0;0;0;.00nan;0;0
12515;-1;181;62;37;4;33;.892;3594000;0
12515;192552;181;0;0;0;0;.00nan;0;0
12554;189773;231;0;0;0;0;.00nan;0;0
12554;185034;231;67;25;2;23;.920;3900000;0
12554;181338;230;0;0;0;0;.00nan;0;0
12554;186495;230;86;42;2;40;.952;3900000;0
12461;-1;1371;0;0;0;0;.00nan;0;0
12461;-1;220;75;31;2;29;.935;3546000;0
12461;187443;220;0;0;0;0;.00nan;0;0
12461;192688;1371;91;29;1;28;.966;3600000;0
12549;184175;224;0;0;0;0;.00nan;0;0
12549;185840;224;97;26;0;26;1.000;3600000;0
12549;191120;223;0;0;0;0;.00nan;0;0
12549;187118;223;50;27;4;23;.852;3600000;0
12679;182454;4864;70;26;2;24;.923;2837000;0
12679;183737;4864;29;13;4;9;.692;763000;0
12679;201562;2620;0;0;0;0;.00nan;0;0
12679;-1;2620;68;20;1;19;.950;3600000;0
12509;192915;179;71;27;2;25;.926;3600000;0
12509;-1;179;0;0;0;0;.00nan;0;0
12509;-1;178;40;38;6;32;.842;3600000;0
12509;-1;178;0;0;0;0;.00nan;0;0
12671;201495;213;55;29;4;25;.862;3600000;0
12671;196571;177;0;0;0;0;.00nan;0;0
12671;203029;213;0;0;0;0;.00nan;0;0
12671;-1;177;76;23;1;22;.957;3600000;0
12637;194219;4960;0;0;0;0;.00nan;0;0
12637;173219;4960;38;29;5;24;.828;3900000;0
12637;184610;222;0;0;0;0;.00nan;0;0
12637;185851;222;67;54;5;49;.907;3900000;0
12954;-1;203;50;27;3;24;.889;3900000;0
12954;201524;205;0;0;0;0;.00nan;0;0
12954;-1;203;0;0;0;0;.00nan;0;0
12954;-1;205;58;22;3;19;.864;3900000;0
12667;189081;187;57;31;3;28;.903;3533000;0
12667;184788;198;0;0;0;0;.00nan;0;0
12667;181431;198;94;36;1;35;.972;3600000;0
12667;-1;187;0;0;0;0;.00nan;0;0
12632;170351;194;0;0;0;0;.00nan;0;0
12632;179647;195;79;12;0;12;1.000;3600000;0
12632;-1;194;74;43;4;39;.907;3600000;0
12632;191849;195;0;0;0;0;.00nan;0;0
12612;184069;208;82;33;2;31;.939;3551000;0
12612;201560;202;71;22;1;21;.955;3600000;0
12612;179702;208;0;0;0;0;.00nan;0;0
12612;196299;202;0;0;0;0;.00nan;0;0
12851;169226;186;58;29;3;26;.897;3600000;0
12851;185778;186;0;0;0;0;.00nan;0;0
12851;-1;180;0;0;0;0;.00nan;0;0
12851;197707;180;78;48;4;44;.917;3580000;0
12914;179169;209;63;33;3;30;.909;3600000;0
12914;176932;176;94;35;1;34;.971;3600000;0
12914;182006;176;0;0;0;0;.00nan;0;0
12914;186205;209;0;0;0;0;.00nan;0;0
12787;194893;191;84;30;2;28;.933;3565000;0
12787;173900;192;0;0;0;0;.00nan;0;0
12787;-1;192;90;37;1;36;.973;3600000;0
12787;201892;191;0;0;0;0;.00nan;0;0
12639;189773;231;0;0;0;0;.00nan;0;0
12639;185034;231;56;32;4;28;.875;3600000;0
12639;181338;230;78;10;0;10;1.000;3600000;0
12639;186495;230;0;0;0;0;.00nan;0;0
12722;195251;4949;40;15;3;12;.800;3599000;0
12722;-1;183;99;56;2;54;.964;3600000;0
12722;182089;183;0;0;0;0;.00nan;0;0
12722;197685;4949;0;0;0;0;.00nan;0;0
13569;-1;181;80;40;4;36;.900;3600000;0
13569;-1;214;54;41;5;36;.878;3600000;0
13569;191518;214;0;0;0;0;.00nan;0;0
13569;192552;181;0;0;0;0;.00nan;0;0
12471;182467;185;0;0;0;0;.00nan;0;0
12471;-1;220;0;0;0;0;.00nan;0;0
12471;187443;220;81;32;3;29;.906;3600000;0
12471;-1;185;89;33;2;31;.939;3600000;0
12767;175370;199;53;22;3;19;.864;3576000;0
12767;-1;206;88;32;2;30;.938;3600000;0
12767;202998;206;0;0;0;0;.00nan;0;0
12767;161006;199;0;0;0;0;.00nan;0;0
13558;187628;227;58;41;5;36;.878;3600000;0
13558;-1;227;0;0;0;0;.00nan;0;0
13558;175354;228;81;19;1;18;.947;3600000;0
13558;180377;228;0;0;0;0;.00nan;0;0
12579;189885;225;55;19;2;17;.895;3600000;0
12579;184610;222;67;38;4;34;.895;3544000;0
12579;-1;225;0;0;0;0;.00nan;0;0
12579;185851;222;0;0;0;0;.00nan;0;0
12572;200306;182;78;32;3;29;.906;3896000;0
12572;-1;1371;0;0;0;0;.00nan;0;0
12572;179388;182;0;0;0;0;.00nan;0;0
12572;192688;1371;75;39;3;36;.923;3900000;0
12675;173549;219;55;28;3;25;.893;3600000;0
12675;169226;186;0;0;0;0;.00nan;0;0
12675;181102;219;0;0;0;0;.00nan;0;0
12675;185778;186;71;19;1;18;.947;3600000;0
12747;194219;4960;74;29;2;27;.931;3611000;0
12747;183695;232;87;38;3;35;.921;3611000;0
12747;173219;4960;0;0;0;0;.00nan;0;0
12747;179691;232;0;0;0;0;.00nan;0;0
12540;-1;189;72;22;1;21;.955;3600000;0
12540;192547;190;0;0;0;0;.00nan;0;0
12540;197704;190;88;39;2;37;.949;3544000;0
12540;-1;189;0;0;0;0;.00nan;0;0
12718;182454;4864;0;0;0;0;.00nan;0;0
12718;183737;4864;98;41;2;39;.951;3600000;0
12718;184907;4959;0;0;0;0;.00nan;0;0
12718;-1;4959;66;16;1;15;.938;3600000;0
12617;184648;196;97;47;1;46;.979;3900000;0
12617;179647;195;82;19;1;18;.947;3900000;0
12617;191118;196;0;0;0;0;.00nan;0;0
12617;191849;195;0;0;0;0;.00nan;0;0
12562;189902;204;67;26;3;23;.885;3600000;0
12562;184712;204;0;0;0;0;.00nan;0;0
12562;-1;207;31;29;6;23;.793;3600000;0
12562;-1;207;0;0;0;0;.00nan;0;0
12611;178394;188;79;10;0;10;1.000;3600000;0
12611;184409;188;0;0;0;0;.00nan;0;0
12611;174325;197;0;0;0;0;.00nan;0;0
12611;201585;197;98;50;2;48;.960;3600000;0
12630;195238;200;0;0;0;0;.00nan;0;0
12630;185743;201;70;45;5;40;.889;3600000;0
12630;187295;200;69;18;1;17;.944;3600000;0
12630;-1;201;0;0;0;0;.00nan;0;0
12588;200452;221;0;0;0;0;.00nan;0;0
12588;184175;224;0;0;0;0;.00nan;0;0
12588;185840;224;82;44;3;41;.932;3600000;0
12588;187362;221;88;42;2;40;.952;3600000;0
12687;195164;218;61;28;3;25;.893;3517000;0
12687;190095;218;0;0;0;0;.00nan;0;0
12687;182128;215;89;33;1;32;.970;3600000;0
12687;-1;215;0;0;0;0;.00nan;0;0
12682;201495;213;0;0;0;0;.00nan;0;0
12682;196571;177;93;32;1;31;.969;3600000;0
12682;203029;213;66;40;3;37;.925;3570000;0
12682;-1;177;0;0;0;0;.00nan;0;0
12662;195251;4949;89;34;2;32;.941;3900000;0
12662;197685;4949;0;0;0;0;.00nan;0;0
12662;-1;178;0;0;0;0;.00nan;0;0
12662;-1;178;74;34;2;32;.941;3900000;0
12589;-1;203;0;0;0;0;.00nan;0;0
12589;201560;202;0;0;0;0;.00nan;0;0
12589;-1;203;45;23;4;19;.826;3600000;0
12589;196299;202;100;33;0;33;1.000;3600000;0
13164;194893;191;0;0;0;0;.00nan;0;0
13164;170351;194;49;48;7;41;.854;3600000;0
13164;-1;194;0;0;0;0;.00nan;0;0
13164;201892;191;83;14;0;14;1.000;3600000;0
12737;183678;1505;0;0;0;0;.00nan;0;0
12737;201495;213;79;36;3;33;.917;3600000;0
12737;186549;1505;95;23;0;23;1.000;3600000;0
12737;203029;213;0;0;0;0;.00nan;0;0
13082;190034;217;74;41;4;37;.902;3600000;0
13082;190041;217;0;0;0;0;.00nan;0;0
13082;179679;212;0;0;0;0;.00nan;0;0
13082;186641;212;28;27;6;21;.778;3527000;0
12636;173770;193;51;17;2;15;.882;3600000;0
12636;184648;196;71;20;1;19;.950;1781000;0
12636;186451;193;0;0;0;0;.00nan;0;0
12636;191118;196;42;35;5;30;.857;1819000;0
12490;192915;179;0;0;0;0;.00nan;0;0
12490;196571;177;0;0;0;0;.00nan;0;0
12490;-1;179;92;35;1;34;.971;3600000;0
12490;-1;177;54;31;4;27;.871;3600000;0
12678;189081;187;0;0;0;0;.00nan;0;0
12678;184788;198;0;0;0;0;.00nan;0;0
12678;181431;198;41;33;5;28;.848;3600000;0
12678;-1;187;82;36;1;35;.972;3600000;0
12810;201562;2620;0;0;0;0;.00nan;0;0
12810;184907;4959;58;20;2;18;.900;3600000;0
12810;-1;2620;53;30;4;26;.867;3599000;0
12810;-1;4959;0;0;0;0;.00nan;0;0
12705;183695;232;0;0;0;0;.00nan;0;0
12705;179691;232;54;12;2;10;.833;3900000;0
12705;185800;229;98;44;2;42;.955;3900000;0
12705;185960;229;0;0;0;0;.00nan;0;0
12681;195238;200;100;42;2;40;.952;3900000;0
12681;179452;226;65;26;2;24;.923;3900000;0
12681;187295;200;0;0;0;0;.00nan;0;0
12681;192629;226;0;0;0;0;.00nan;0;0
12633;184175;224;72;43;4;39;.907;3584000;0
12633;181338;230;66;16;2;14;.875;3600000;0
12633;185840;224;0;0;0;0;.00nan;0;0
12633;186495;230;0;0;0;0;.00nan;0;0
12574;-1;1371;95;35;2;33;.943;3600000;0
12574;190125;184;37;21;4;17;.810;3528000;0
12574;179668;184;0;0;0;0;.00nan;0;0
12574;192688;1371;0;0;0;0;.00nan;0;0
12754;192461;210;71;20;1;19;.950;3600000;0
12754;197672;210;0;0;0;0;.00nan;0;0
12754;-1;178;39;41;6;35;.854;3600000;0
12754;-1;178;0;0;0;0;.00nan;0;0
12772;-1;211;73;31;2;29;.935;3600000;0
12772;179646;211;0;0;0;0;.00nan;0;0
12772;-1;180;64;25;3;22;.880;3545000;0
12772;197707;180;0;0;0;0;.00nan;0;0
12752;182454;4864;70;41;4;37;.902;3600000;0
12752;183737;4864;0;0;0;0;.00nan;0;0
12752;179169;209;0;0;0;0;.00nan;0;0
12752;186205;209;61;18;1;17;.944;3600000;0
13557;189885;225;0;0;0;0;.00nan;0;0
13557;181338;230;0;0;0;0;.00nan;0;0
13557;-1;225;73;37;4;33;.892;3600000;0
13557;186495;230;82;23;1;22;.957;3600000;0
13068;-1;203;57;32;4;28;.875;3592000;0
13068;-1;203;0;0;0;0;.00nan;0;0
13068;-1;206;0;0;0;0;.00nan;0;0
13068;202998;206;60;23;2;21;.913;3600000;0
13574;194893;191;0;0;0;0;.00nan;0;0
13574;170351;194;0;0;0;0;.00nan;0;0
13574;-1;194;82;50;4;46;.920;3600000;0
13574;201892;191;76;9;0;9;1.000;3600000;0
12699;173770;193;0;0;0;0;.00nan;0;0
12699;-1;189;72;47;5;42;.894;3600000;0
12699;186451;193;88;18;0;18;1.000;3600000;0
12699;-1;189;0;0;0;0;.00nan;0;0
12724;187628;227;68;31;2;29;.935;3900000;0
12724;-1;227;0;0;0;0;.00nan;0;0
12724;191120;223;84;35;2;33;.943;3900000;0
12724;187118;223;0;0;0;0;.00nan;0;0
13592;179647;195;65;23;3;20;.870;3600000;0
13592;191849;195;0;0;0;0;.00nan;0;0
13592;192547;190;48;23;4;19;.826;1180000;0
13592;197704;190;83;39;3;36;.923;2420000;0
13497;190034;217;0;0;0;0;.00nan;0;0
13497;190041;217;69;27;2;25;.926;3590000;0
13497;182128;215;0;0;0;0;.00nan;0;0
13497;-1;215;88;32;1;31;.969;3600000;0
12677;184610;222;58;23;3;20;.870;3667000;0
12677;185800;229;0;0;0;0;.00nan;0;0
12677;185851;222;0;0;0;0;.00nan;0;0
12677;185960;229;73;33;4;29;.879;3667000;0
12871;195164;218;0;0;0;0;.00nan;0;0
12871;190095;218;51;32;4;28;.875;3600000;0
12871;179679;212;0;0;0;0;.00nan;0;0
12871;186641;212;100;30;0;30;1.000;3600000;0
12710;183678;1505;0;0;0;0;.00nan;0;0
12710;195251;4949;70;33;4;29;.879;3600000;0
12710;186549;1505;71;19;1;18;.947;3600000;0
12710;197685;4949;0;0;0;0;.00nan;0;0
12716;189081;187;49;22;3;19;.864;3552000;0
12716;173900;192;0;0;0;0;.00nan;0;0
12716;-1;192;68;27;2;25;.926;3600000;0
12716;-1;187;0;0;0;0;.00nan;0;0
12644;200306;182;68;37;4;33;.892;3700000;0
12644;179388;182;0;0;0;0;.00nan;0;0
12644;-1;214;64;35;3;32;.914;3700000;0
12644;191518;214;0;0;0;0;.00nan;0;0
12647;189773;231;0;0;0;0;.00nan;0;0
12647;175354;228;0;0;0;0;.00nan;0;0
12647;185034;231;84;15;0;15;1.000;3600000;0
12647;180377;228;85;47;4;43;.915;3600000;0
12900;201562;2620;26;19;4;15;.789;3900000;0
12900;176932;176;0;0;0;0;.00nan;0;0
12900;182006;176;68;33;4;29;.879;3900000;0
12900;-1;2620;0;0;0;0;.00nan;0;0
12904;-1;216;60;16;1;15;.938;3600000;0
12904;-1;183;0;0;0;0;.00nan;0;0
12904;182089;183;60;30;4;26;.867;3600000;0
12904;187240;216;0;0;0;0;.00nan;0;0
12742;189902;204;37;37;7;30;.811;3181000;0
12742;184712;204;49;1;0;1;1.000;419000;0
12742;175370;199;0;0;0;0;.00nan;0;0
12742;161006;199;94;31;1;30;.968;3600000;0
13525;-1;216;0;0;0;0;.00nan;0;0
13525;196571;177;54;40;5;35;.875;3564000;0
13525;187240;216;66;24;3;21;.875;3600000;0
13525;-1;177;0;0;0;0;.00nan;0;0
12673;184069;208;68;23;2;21;.913;3600000;0
12673;179702;208;0;0;0;0;.00nan;0;0
12673;185743;201;69;29;3;26;.897;3564000;0
12673;-1;201;0;0;0;0;.00nan;0;0
12965;194219;4960;0;0;0;0;.00nan;0;0
12965;173219;4960;57;17;2;15;.882;3600000;0
12965;175354;228;78;40;3;37;.925;3600000;0
12965;180377;228;0;0;0;0;.00nan;0;0
13575;201495;213;39;13;3;10;.769;3600000;0
13575;-1;183;0;0;0;0;.00nan;0;0
13575;182089;183;58;49;6;43;.878;3600000;0
13575;203029;213;0;0;0;0;.00nan;0;0
13571;179169;209;0;0;0;0;.00nan;0;0
13571;184907;4959;0;0;0;0;.00nan;0;0
13571;186205;209;30;25;5;20;.800;3540000;0
13571;-1;4959;72;29;3;26;.897;3600000;0
12919;169226;186;82;31;2;29;.935;3560000;0
12919;195164;218;66;17;1;16;.941;3600000;0
12919;190095;218;0;0;0;0;.00nan;0;0
12919;185778;186;0;0;0;0;.00nan;0;0
12988;182467;185;0;0;0;0;.00nan;0;0
12988;-1;185;64;30;3;27;.900;3600000;0
12988;-1;214;68;46;4;42;.913;3600000;0
12988;191518;214;0;0;0;0;.00nan;0;0
12887;195251;4949;69;25;2;23;.920;3543000;0
12887;197685;4949;0;0;0;0;.00nan;0;0
12887;-1;178;92;32;1;31;.969;3600000;0
12887;-1;178;0;0;0;0;.00nan;0;0
12732;183695;232;60;23;3;20;.870;3600000;0
12732;184175;224;51;38;5;33;.868;3549000;0
12732;179691;232;0;0;0;0;.00nan;0;0
12732;185840;224;0;0;0;0;.00nan;0;0
12849;184069;208;0;0;0;0;.00nan;0;0
12849;179452;226;0;0;0;0;.00nan;0;0
12849;179702;208;97;46;3;43;.935;3544000;0
12849;192629;226;68;24;2;22;.917;3600000;0
12751;189081;187;72;17;1;16;.941;3600000;0
12751;184648;196;67;39;3;36;.923;3600000;0
12751;191118;196;0;0;0;0;.00nan;0;0
12751;-1;187;0;0;0;0;.00nan;0;0
12785;190034;217;89;28;1;27;.964;3600000;0
12785;190041;217;0;0;0;0;.00nan;0;0
12785;182128;215;0;0;0;0;.00nan;0;0
12785;-1;215;58;39;4;35;.897;3600000;0
12641;184788;198;0;0;0;0;.00nan;0;0
12641;181431;198;68;26;2;24;.923;3600000;0
12641;192547;190;44;19;3;16;.842;1708000;0
12641;197704;190;24;24;6;18;.750;1892000;0
12652;192915;179;0;0;0;0;.00nan;0;0
12652;-1;179;69;24;2;22;.917;3545000;0
12652;192461;210;92;20;0;20;1.000;3600000;0
12652;197672;210;0;0;0;0;.00nan;0;0
12624;-1;203;93;43;2;41;.953;3600000;0
12624;201560;202;0;0;0;0;.00nan;0;0
12624;-1;203;0;0;0;0;.00nan;0;0
12624;196299;202;49;29;4;25;.862;3522000;0
12771;173549;219;58;26;3;23;.885;3516000;0
12771;179679;212;0;0;0;0;.00nan;0;0
12771;181102;219;0;0;0;0;.00nan;0;0
12771;186641;212;95;32;1;31;.969;3600000;0
12760;182454;4864;0;0;0;0;.00nan;0;0
12760;183737;4864;85;35;2;33;.943;3701000;0
12760;201562;2620;0;0;0;0;.00nan;0;0
12760;-1;2620;65;28;3;25;.893;3722000;0
12619;194219;4960;86;34;2;32;.941;3533000;0
12619;173219;4960;0;0;0;0;.00nan;0;0
12619;189885;225;0;0;0;0;.00nan;0;0
12619;-1;225;100;34;0;34;1.000;3600000;0
13218;189902;204;0;0;0;0;.00nan;0;0
13218;184712;204;91;36;1;35;.972;3600000;0
13218;185743;201;67;36;3;33;.917;3600000;0
13218;-1;201;0;0;0;0;.00nan;0;0
12690;195238;200;0;0;0;0;.00nan;0;0
12690;-1;206;29;29;6;23;.793;2102000;0
12690;187295;200;97;27;0;27;1.000;3600000;0
12690;202998;206;71;18;0;18;1.000;1498000;0
12794;183678;1505;44;22;3;19;.864;3532000;0
12794;201495;213;0;0;0;0;.00nan;0;0
12794;186549;1505;0;0;0;0;.00nan;0;0
12794;203029;213;98;37;1;36;.973;3600000;0
12653;185800;229;29;31;6;25;.806;3600000;0
12653;185960;229;0;0;0;0;.00nan;0;0
12653;191120;223;54;25;3;22;.880;3600000;0
12653;187118;223;0;0;0;0;.00nan;0;0
12660;194893;191;0;0;0;0;.00nan;0;0
12660;179647;195;69;28;2;26;.929;3600000;0
12660;201892;191;45;23;4;19;.826;3546000;0
12660;191849;195;0;0;0;0;.00nan;0;0
12847;175370;199;71;26;2;24;.923;3600000;0
12847;201524;205;0;0;0;0;.00nan;0;0
12847;-1;205;50;19;3;16;.842;3545000;0
12847;161006;199;0;0;0;0;.00nan;0;0
12602;178394;188;89;17;0;17;1.000;3600000;0
12602;184409;188;0;0;0;0;.00nan;0;0
12602;192547;190;0;0;0;0;.00nan;0;0
12602;197704;190;93;61;5;56;.918;3600000;0
12590;201524;205;0;0;0;0;.00nan;0;0
12590;-1;207;61;40;5;35;.875;3600000;0
12590;-1;205;100;36;1;35;.972;3600000;0
12590;-1;207;0;0;0;0;.00nan;0;0
12719;183695;232;71;22;1;21;.955;2464000;0
12719;189773;231;0;0;0;0;.00nan;0;0
12719;179691;232;27;11;4;7;.636;1136000;0
12719;185034;231;87;17;0;17;1.000;3600000;0
12865;189885;225;0;0;0;0;.00nan;0;0
12865;175354;228;0;0;0;0;.00nan;0;0
12865;180377;228;77;27;2;25;.926;3625000;0
12865;-1;225;80;28;1;27;.964;3625000;0
12565;192915;179;0;0;0;0;.00nan;0;0
12565;183678;1505;0;0;0;0;.00nan;0;0
12565;-1;179;57;31;3;28;.903;3600000;0
12565;186549;1505;67;20;1;19;.950;3600000;0
12683;184610;222;56;26;3;23;.885;3600000;0
12683;185800;229;0;0;0;0;.00nan;0;0
12683;185851;222;0;0;0;0;.00nan;0;0
12683;185960;229;77;45;4;41;.911;3559000;0
12936;-1;183;94;39;2;37;.949;3600000;0
12936;182089;183;0;0;0;0;.00nan;0;0
12936;192461;210;64;15;1;14;.933;3600000;0
12936;197672;210;0;0;0;0;.00nan;0;0
12635;173900;192;0;0;0;0;.00nan;0;0
12635;179647;195;0;0;0;0;.00nan;0;0
12635;-1;192;76;29;2;27;.931;3517000;0
12635;191849;195;100;29;0;29;1.000;3600000;0
12711;-1;216;0;0;0;0;.00nan;0;0
12711;196571;177;62;30;4;26;.867;3527000;0
12711;187240;216;83;31;2;29;.935;3600000;0
12711;-1;177;0;0;0;0;.00nan;0;0
12905;174325;197;0;0;0;0;.00nan;0;0
12905;-1;189;74;19;1;18;.947;3600000;0
12905;201585;197;72;36;3;33;.917;3600000;0
12905;-1;189;0;0;0;0;.00nan;0;0
12492;-1;181;93;38;2;36;.947;3900000;0
12492;-1;220;0;0;0;0;.00nan;0;0
12492;187443;220;88;30;2;28;.933;3900000;0
12492;192552;181;0;0;0;0;.00nan;0;0
12680;182467;185;49;38;5;33;.868;3600000;0
12680;200306;182;69;19;1;18;.947;3600000;0
12680;179388;182;0;0;0;0;.00nan;0;0
12680;-1;185;0;0;0;0;.00nan;0;0
12628;-1;1371;0;0;0;0;.00nan;0;0
12628;190125;184;69;40;4;36;.900;3578000;0
12628;179668;184;0;0;0;0;.00nan;0;0
12628;192688;1371;71;34;3;31;.912;3600000;0
12750;201562;2620;83;41;2;39;.951;3807000;0
12750;184907;4959;0;0;0;0;.00nan;0;0
12750;-1;2620;0;0;0;0;.00nan;0;0
12750;-1;4959;90;38;3;35;.921;3807000;0
12791;-1;211;92;47;2;45;.957;3600000;0
12791;179646;211;0;0;0;0;.00nan;0;0
12791;179679;212;70;35;4;31;.886;3572000;0
12791;186641;212;0;0;0;0;.00nan;0;0
12746;190034;217;0;0;0;0;.00nan;0;0
12746;190041;217;85;41;3;38;.927;3580000;0
12746;182128;215;69;21;2;19;.905;3600000;0
12746;-1;215;0;0;0;0;.00nan;0;0
12790;187628;227;63;35;4;31;.886;3554000;0
12790;200452;221;0;0;0;0;.00nan;0;0
12790;-1;227;0;0;0;0;.00nan;0;0
12790;187362;221;49;22;3;19;.864;3600000;0
12773;194893;191;80;28;2;26;.929;3600000;0
12773;173770;193;93;30;1;29;.967;3600000;0
12773;201892;191;0;0;0;0;.00nan;0;0
12773;186451;193;0;0;0;0;.00nan;0;0
12738;184648;196;0;0;0;0;.00nan;0;0
12738;184788;198;0;0;0;0;.00nan;0;0
12738;181431;198;82;32;1;31;.969;3600000;0
12738;191118;196;76;36;3;33;.917;3600000;0
12735;195238;200;49;16;2;14;.875;1547000;0
12735;179452;226;0;0;0;0;.00nan;0;0
12735;187295;200;32;26;6;20;.769;2053000;0
12735;192629;226;67;26;2;24;.923;3600000;0
12753;182454;4864;63;47;5;42;.894;3543000;0
12753;183737;4864;0;0;0;0;.00nan;0;0
12753;176932;176;0;0;0;0;.00nan;0;0
12753;182006;176;61;29;4;25;.862;3600000;0
12832;173549;219;0;0;0;0;.00nan;0;0
12832;169226;186;0;0;0;0;.00nan;0;0
12832;181102;219;99;41;2;39;.951;3900000;0
12832;185778;186;87;37;2;35;.946;3900000;0
12758;189081;187;0;0;0;0;.00nan;0;0
12758;170351;194;100;42;2;40;.952;3600000;0
12758;-1;194;0;0;0;0;.00nan;0;0
12758;-1;187;52;23;3;20;.870;3543000;0
12631;-1;203;84;42;3;39;.929;3900000;0
12631;201560;202;87;44;3;41;.932;3876000;0
12631;-1;203;0;0;0;0;.00nan;0;0
12631;196299;202;0;0;0;0;.00nan;0;0
12804;-1;211;27;45;8;37;.822;3600000;0
12804;179646;211;0;0;0;0;.00nan;0;0
12804;-1;180;43;22;4;18;.818;3600000;0
12804;197707;180;0;0;0;0;.00nan;0;0
12883;187628;227;0;0;0;0;.00nan;0;0
12883;-1;227;41;27;4;23;.852;3811000;0
12883;191120;223;58;42;5;37;.881;3811000;0
12883;187118;223;0;0;0;0;.00nan;0;0
12783;179169;209;0;0;0;0;.00nan;0;0
12783;184907;4959;72;34;3;31;.912;3564000;0
12783;186205;209;100;40;1;39;.975;3600000;0
12783;-1;4959;0;0;0;0;.00nan;0;0
12775;184175;224;55;34;5;29;.853;3600000;0
12775;184610;222;57;19;2;17;.895;1885000;0
12775;185840;224;0;0;0;0;.00nan;0;0
12775;185851;222;12;18;6;12;.667;1715000;0
12819;-1;216;79;25;1;24;.960;3600000;0
12819;201495;213;0;0;0;0;.00nan;0;0
12819;187240;216;0;0;0;0;.00nan;0;0
12819;203029;213;59;23;2;21;.913;3568000;0
12685;-1;207;68;22;1;21;.955;3600000;0
12685;-1;206;0;0;0;0;.00nan;0;0
12685;-1;207;0;0;0;0;.00nan;0;0
12685;202998;206;30;30;6;24;.800;3600000;0
12621;190125;184;0;0;0;0;.00nan;0;0
12621;179668;184;70;29;3;26;.897;3546000;0
12621;-1;220;0;0;0;0;.00nan;0;0
12621;187443;220;82;37;2;35;.946;3600000;0
12816;-1;206;56;29;4;25;.862;3530000;0
12816;185743;201;80;32;2;30;.938;3600000;0
12816;-1;201;0;0;0;0;.00nan;0;0
12816;202998;206;0;0;0;0;.00nan;0;0
12622;178394;188;0;0;0;0;.00nan;0;0
12622;184409;188;19;22;6;16;.727;3600000;0
12622;174325;197;0;0;0;0;.00nan;0;0
12622;201585;197;80;40;3;37;.925;3600000;0
12928;183678;1505;0;0;0;0;.00nan;0;0
12928;-1;183;0;0;0;0;.00nan;0;0
12928;182089;183;43;40;6;34;.850;3600000;0
12928;186549;1505;99;22;0;22;1.000;3600000;0
12769;195251;4949;54;19;2;17;.895;3900000;0
12769;201495;213;59;21;2;19;.905;3900000;0
12769;197685;4949;0;0;0;0;.00nan;0;0
12769;203029;213;0;0;0;0;.00nan;0;0
12715;192915;179;0;0;0;0;.00nan;0;0
12715;196571;177;100;49;3;46;.939;3600000;0
12715;-1;179;30;23;5;18;.783;3560000;0
12715;-1;177;0;0;0;0;.00nan;0;0
12826;175370;199;0;0;0;0;.00nan;0;0
12826;179452;226;92;30;1;29;.967;3600000;0
12826;192629;226;0;0;0;0;.00nan;0;0
12826;161006;199;83;36;2;34;.944;3600000;0
13570;179169;209;63;35;4;31;.886;3584000;0
13570;201562;2620;0;0;0;0;.00nan;0;0
13570;-1;2620;68;29;3;26;.897;3600000;0
13570;186205;209;0;0;0;0;.00nan;0;0
12583;200306;182;0;0;0;0;.00nan;0;0
12583;-1;1371;0;0;0;0;.00nan;0;0
12583;179388;182;74;46;4;42;.913;3600000;0
12583;192688;1371;83;26;2;24;.923;3600000;0
12856;173549;219;65;44;4;40;.909;3900000;0
12856;169226;186;91;56;4;52;.929;3900000;0
12856;181102;219;0;0;0;0;.00nan;0;0
12856;185778;186;0;0;0;0;.00nan;0;0
12779;189081;187;47;21;3;18;.857;3555000;0
12779;184648;196;100;42;2;40;.952;3600000;0
12779;191118;196;0;0;0;0;.00nan;0;0
12779;-1;187;0;0;0;0;.00nan;0;0
12672;-1;203;90;43;3;40;.930;3600000;0
12672;201560;202;73;8;0;8;1.000;3600000;0
12672;-1;203;0;0;0;0;.00nan;0;0
12672;196299;202;0;0;0;0;.00nan;0;0
13380;195164;218;0;0;0;0;.00nan;0;0
13380;190095;218;70;42;4;38;.905;3533000;0
13380;179679;212;0;0;0;0;.00nan;0;0
13380;186641;212;80;26;2;24;.923;3600000;0
12676;184069;208;0;0;0;0;.00nan;0;0
12676;195238;200;0;0;0;0;.00nan;0;0
12676;179702;208;82;24;1;23;.958;3900000;0
12676;187295;200;96;40;1;39;.975;3900000;0
12655;183695;232;58;23;3;20;.870;3600000;0
12655;179691;232;0;0;0;0;.00nan;0;0
12655;191120;223;0;0;0;0;.00nan;0;0
12655;187118;223;59;35;4;31;.886;3578000;0
12879;184175;224;0;0;0;0;.00nan;0;0
12879;189885;225;92;32;2;30;.938;3867000;0
12879;-1;225;0;0;0;0;.00nan;0;0
12879;185840;224;74;29;1;28;.966;3867000;0
12756;194893;191;0;0;0;0;.00nan;0;0
12756;173770;193;51;38;6;32;.842;3540000;0
12756;201892;191;59;27;4;23;.852;3600000;0
12756;186451;193;0;0;0;0;.00nan;0;0
12815;182454;4864;0;0;0;0;.00nan;0;0
12815;183737;4864;69;26;2;24;.923;3600000;0
12815;176932;176;59;26;3;23;.885;3555000;0
12815;182006;176;0;0;0;0;.00nan;0;0
12777;189773;231;0;0;0;0;.00nan;0;0
12777;175354;228;0;0;0;0;.00nan;0;0
12777;185034;231;84;25;1;24;.960;3900000;0
12777;180377;228;95;29;1;28;.966;3900000;0
12948;178394;188;77;35;2;33;.943;3900000;0
12948;170351;194;81;38;2;36;.947;3900000;0
12948;184409;188;0;0;0;0;.00nan;0;0
12948;-1;194;0;0;0;0;.00nan;0;0
13133;187628;227;66;53;6;47;.887;2832000;0
13133;-1;227;56;13;1;12;.923;768000;0
13133;181338;230;0;0;0;0;.00nan;0;0
13133;186495;230;79;10;0;10;1.000;3600000;0
12668;184788;198;0;0;0;0;.00nan;0;0
12668;179647;195;60;9;0;9;1.000;1369000;0
12668;181431;198;77;34;3;31;.912;3600000;0
12668;191849;195;42;34;6;28;.824;2231000;0
12778;194219;4960;66;24;2;22;.917;3600000;0
12778;173219;4960;0;0;0;0;.00nan;0;0
12778;200452;221;0;0;0;0;.00nan;0;0
12778;187362;221;61;33;3;30;.909;3574000;0
12618;-1;189;42;30;5;25;.833;3600000;0
12618;192547;190;0;0;0;0;.00nan;0;0
12618;197704;190;26;26;6;20;.769;3546000;0
12618;-1;189;0;0;0;0;.00nan;0;0
12943;182467;185;79;23;2;21;.913;3600000;0
12943;-1;185;0;0;0;0;.00nan;0;0
12943;-1;214;31;32;6;26;.813;3600000;0
12943;191518;214;0;0;0;0;.00nan;0;0
12659;200306;182;59;35;4;31;.886;3546000;0
12659;179388;182;0;0;0;0;.00nan;0;0
12659;-1;181;83;34;2;32;.941;3600000;0
12659;192552;181;0;0;0;0;.00nan;0;0
12921;190034;217;87;36;2;34;.944;3600000;0
12921;190041;217;0;0;0;0;.00nan;0;0
12921;-1;180;36;30;5;25;.833;3600000;0
12921;197707;180;0;0;0;0;.00nan;0;0
12963;-1;183;63;31;3;28;.903;3600000;0
12963;182089;183;0;0;0;0;.00nan;0;0
12963;192461;210;84;16;0;16;1.000;3600000;0
12963;197672;210;0;0;0;0;.00nan;0;0
12727;195251;4949;0;0;0;0;.00nan;0;0
12727;197685;4949;90;16;0;16;1.000;3600000;0
12727;-1;178;0;0;0;0;.00nan;0;0
12727;-1;178;70;25;1;24;.960;3543000;0
12802;173900;192;0;0;0;0;.00nan;0;0
12802;-1;189;95;40;3;37;.925;3596000;0
12802;-1;192;72;25;2;23;.920;3600000;0
12802;-1;189;0;0;0;0;.00nan;0;0
13003;195164;218;72;46;5;41;.891;3600000;0
13003;190095;218;0;0;0;0;.00nan;0;0
13003;-1;180;0;0;0;0;.00nan;0;0
13003;197707;180;95;21;0;21;1.000;3600000;0
12725;196571;177;80;35;2;33;.943;3600000;0
12725;-1;178;48;20;3;17;.850;3570000;0
12725;-1;178;0;0;0;0;.00nan;0;0
12725;-1;177;0;0;0;0;.00nan;0;0
13477;-1;203;71;26;2;24;.923;3600000;0
13477;-1;203;0;0;0;0;.00nan;0;0
13477;-1;207;55;27;3;24;.889;3544000;0
13477;-1;207;0;0;0;0;.00nan;0;0
13580;183695;232;79;49;5;44;.898;3600000;0
13580;179691;232;0;0;0;0;.00nan;0;0
13580;181338;230;0;0;0;0;.00nan;0;0
13580;186495;230;75;17;1;16;.941;3600000;0
12730;-1;181;45;37;5;32;.865;3600000;0
12730;-1;220;95;20;0;20;1.000;3600000;0
12730;187443;220;0;0;0;0;.00nan;0;0
12730;192552;181;0;0;0;0;.00nan;0;0
12793;200452;221;63;29;3;26;.897;3600000;0
12793;175354;228;0;0;0;0;.00nan;0;0
12793;180377;228;35;24;5;19;.792;3523000;0
12793;187362;221;0;0;0;0;.00nan;0;0
12828;-1;211;57;28;4;24;.857;3600000;0
12828;179646;211;0;0;0;0;.00nan;0;0
12828;182128;215;69;27;2;25;.926;2434000;0
12828;-1;215;36;21;4;17;.810;1166000;0
13585;169226;186;97;36;1;35;.972;3900000;0
13585;190034;217;79;23;1;22;.957;3900000;0
13585;190041;217;0;0;0;0;.00nan;0;0
13585;185778;186;0;0;0;0;.00nan;0;0
12729;184610;222;90;28;1;27;.964;3600000;0
12729;185800;229;0;0;0;0;.00nan;0;0
12729;185851;222;0;0;0;0;.00nan;0;0
12729;185960;229;34;31;5;26;.839;3600000;0
12993;182454;4864;0;0;0;0;.00nan;0;0
12993;183737;4864;91;35;2;33;.943;3600000;0
12993;176932;176;0;0;0;0;.00nan;0;0
12993;182006;176;100;27;0;27;1.000;3600000;0
12820;189902;204;85;28;1;27;.964;3600000;0
12820;184712;204;0;0;0;0;.00nan;0;0
12820;201524;205;0;0;0;0;.00nan;0;0
12820;-1;205;59;30;3;27;.900;3600000;0
12656;-1;1371;0;0;0;0;.00nan;0;0
12656;190125;184;70;42;4;38;.905;3900000;0
12656;179668;184;0;0;0;0;.00nan;0;0
12656;192688;1371;64;34;4;30;.882;3883000;0
13029;170351;194;73;31;3;28;.903;3600000;0
13029;174325;197;0;0;0;0;.00nan;0;0
13029;201585;197;90;53;2;51;.962;3600000;0
13029;-1;194;0;0;0;0;.00nan;0;0
12807;194219;4960;0;0;0;0;.00nan;0;0
12807;173219;4960;58;37;4;33;.892;3600000;0
12807;189773;231;0;0;0;0;.00nan;0;0
12807;185034;231;76;13;0;13;1.000;3600000;0
12969;184069;208;71;26;2;24;.923;3600000;0
12969;189902;204;69;22;1;21;.955;3600000;0
12969;184712;204;0;0;0;0;.00nan;0;0
12969;179702;208;0;0;0;0;.00nan;0;0
12695;-1;207;86;37;2;35;.946;3592000;0
12695;185743;201;80;28;1;27;.964;3600000;0
12695;-1;207;0;0;0;0;.00nan;0;0
12695;-1;201;0;0;0;0;.00nan;0;0
12817;201562;2620;0;0;0;0;.00nan;0;0
12817;184907;4959;0;0;0;0;.00nan;0;0
12817;-1;2620;75;33;2;31;.939;3600000;0
12817;-1;4959;80;37;3;34;.919;3565000;0
12805;173770;193;0;0;0;0;.00nan;0;0
12805;173900;192;97;57;4;53;.930;3600000;0
12805;-1;192;0;0;0;0;.00nan;0;0
12805;186451;193;78;29;2;27;.931;3600000;0
12764;184648;196;51;40;6;34;.850;3017000;0
12764;179647;195;59;18;2;16;.889;3600000;0
12764;191118;196;32;4;2;2;.500;583000;0
12764;191849;195;0;0;0;0;.00nan;0;0
12955;190034;217;0;0;0;0;.00nan;0;0
12955;190041;217;43;23;4;19;.826;3551000;0
12955;-1;180;0;0;0;0;.00nan;0;0
12955;197707;180;53;16;2;14;.875;3600000;0
12774;183695;232;0;0;0;0;.00nan;0;0
12774;189773;231;0;0;0;0;.00nan;0;0
12774;179691;232;82;43;4;39;.907;3600000;0
12774;185034;231;100;32;0;32;1.000;3600000;0
13034;189885;225;0;0;0;0;.00nan;0;0
13034;175354;228;0;0;0;0;.00nan;0;0
13034;180377;228;85;18;0;18;1.000;3600000;0
13034;-1;225;97;38;2;36;.947;3524000;0
13339;-1;216;0;0;0;0;.00nan;0;0
13339;-1;183;0;0;0;0;.00nan;0;0
13339;182089;183;85;42;3;39;.929;3600000;0
13339;187240;216;67;23;2;21;.913;3600000;0
12911;179679;212;0;0;0;0;.00nan;0;0
12911;182128;215;65;44;5;39;.886;3600000;0
12911;186641;212;74;29;2;27;.931;3600000;0
12911;-1;215;0;0;0;0;.00nan;0;0
12623;178394;188;0;0;0;0;.00nan;0;0
12623;194893;191;0;0;0;0;.00nan;0;0
12623;184409;188;48;32;5;27;.844;3600000;0
12623;201892;191;85;23;1;22;.957;3600000;0
12739;192915;179;0;0;0;0;.00nan;0;0
12739;201495;213;85;37;3;34;.919;3900000;0
12739;-1;179;57;24;3;21;.875;3900000;0
12739;203029;213;0;0;0;0;.00nan;0;0
12734;183678;1505;0;0;0;0;.00nan;0;0
12734;196571;177;85;33;2;31;.939;3592000;0
12734;186549;1505;84;33;1;32;.970;3600000;0
12734;-1;177;0;0;0;0;.00nan;0;0
12664;182467;185;82;38;2;36;.947;3900000;0
12664;-1;1371;0;0;0;0;.00nan;0;0
12664;-1;185;0;0;0;0;.00nan;0;0
12664;192688;1371;71;24;2;22;.917;3900000;0
12567;190125;184;60;18;2;16;.889;3600000;0
12567;179668;184;0;0;0;0;.00nan;0;0
12567;-1;220;93;48;3;45;.938;3600000;0
12567;187443;220;0;0;0;0;.00nan;0;0
12784;-1;203;0;0;0;0;.00nan;0;0
12784;175370;199;0;0;0;0;.00nan;0;0
12784;-1;203;99;40;1;39;.975;3600000;0
12784;161006;199;55;27;4;23;.852;3600000;0
12997;195251;4949;0;0;0;0;.00nan;0;0
12997;192461;210;100;38;1;37;.974;3600000;0
12997;197672;210;0;0;0;0;.00nan;0;0
12997;197685;4949;40;16;3;13;.813;3518000;0
12841;192915;179;93;35;2;33;.943;3895000;0
12841;201495;213;0;0;0;0;.00nan;0;0
12841;-1;179;0;0;0;0;.00nan;0;0
12841;203029;213;77;36;3;33;.917;3895000;0
12992;-1;181;69;25;3;22;.880;3546000;0
12992;-1;214;67;25;2;23;.920;3600000;0
12992;191518;214;0;0;0;0;.00nan;0;0
12992;192552;181;0;0;0;0;.00nan;0;0
12646;173900;192;0;0;0;0;.00nan;0;0
12646;-1;192;38;22;4;18;.818;3591000;0
12646;192547;190;0;0;0;0;.00nan;0;0
12646;197704;190;100;50;2;48;.960;3600000;0
12929;169226;186;97;29;1;28;.966;3741000;0
12929;179679;212;0;0;0;0;.00nan;0;0
12929;185778;186;0;0;0;0;.00nan;0;0
12929;186641;212;94;42;2;40;.952;3741000;0
12733;195238;200;0;0;0;0;.00nan;0;0
12733;201560;202;78;24;2;22;.917;3600000;0
12733;196299;202;0;0;0;0;.00nan;0;0
12733;187295;200;36;34;6;28;.824;3600000;0
12740;183678;1505;74;21;1;20;.952;3600000;0
12740;186549;1505;0;0;0;0;.00nan;0;0
12740;-1;178;53;5;0;5;1.000;642000;0
12740;-1;178;24;24;6;18;.750;2958000;0
12862;201562;2620;0;0;0;0;.00nan;0;0
12862;184907;4959;0;0;0;0;.00nan;0;0
12862;-1;2620;58;31;3;28;.903;3600000;0
12862;-1;4959;99;38;2;36;.947;3600000;0
13007;189885;225;56;46;6;40;.870;3012000;0
13007;181338;230;0;0;0;0;.00nan;0;0
13007;-1;225;70;11;0;11;1.000;588000;0
13007;186495;230;56;21;3;18;.857;3600000;0
13017;195251;4949;48;25;4;21;.840;3600000;0
13017;-1;183;76;23;1;22;.957;3600000;0
13017;182089;183;0;0;0;0;.00nan;0;0
13017;197685;4949;0;0;0;0;.00nan;0;0
12812;189081;187;40;37;6;31;.838;3600000;0
12812;179647;195;0;0;0;0;.00nan;0;0
12812;191849;195;70;20;1;19;.950;3600000;0
12812;-1;187;0;0;0;0;.00nan;0;0
13050;175370;199;62;27;3;24;.889;3522000;0
13050;179452;226;0;0;0;0;.00nan;0;0
13050;192629;226;99;33;1;32;.970;3600000;0
13050;161006;199;0;0;0;0;.00nan;0;0
12840;-1;189;92;35;2;33;.943;3600000;0
12840;184648;196;0;0;0;0;.00nan;0;0
12840;191118;196;44;32;5;27;.844;3600000;0
12840;-1;189;0;0;0;0;.00nan;0;0
12800;184610;222;65;26;2;24;.923;3532000;0
12800;175354;228;0;0;0;0;.00nan;0;0
12800;180377;228;82;29;1;28;.966;3600000;0
12800;185851;222;0;0;0;0;.00nan;0;0
12626;178394;188;100;36;0;36;1.000;3600000;0
12626;173770;193;67;19;1;18;.947;3551000;0
12626;184409;188;0;0;0;0;.00nan;0;0
12626;186451;193;0;0;0;0;.00nan;0;0
12860;-1;206;61;26;2;24;.923;3600000;0
12860;185743;201;63;48;6;42;.875;3600000;0
12860;-1;201;0;0;0;0;.00nan;0;0
12860;202998;206;0;0;0;0;.00nan;0;0
12781;187628;227;74;27;2;25;.926;3565000;0
12781;183695;232;71;20;1;19;.950;3600000;0
12781;-1;227;0;0;0;0;.00nan;0;0
12781;179691;232;0;0;0;0;.00nan;0;0
12658;182467;185;0;0;0;0;.00nan;0;0
12658;190125;184;0;0;0;0;.00nan;0;0
12658;179668;184;44;25;4;21;.840;3514000;0
12658;-1;185;99;45;2;43;.956;3600000;0
12893;194219;4960;68;27;3;24;.889;3719000;0
12893;173219;4960;0;0;0;0;.00nan;0;0
12893;191120;223;72;42;4;38;.905;3719000;0
12893;187118;223;0;0;0;0;.00nan;0;0
12696;200306;182;90;33;2;31;.939;3600000;0
12696;179388;182;0;0;0;0;.00nan;0;0
12696;-1;220;0;0;0;0;.00nan;0;0
12696;187443;220;50;38;5;33;.868;3600000;0
12891;-1;211;98;47;2;45;.957;3582000;0
12891;173549;219;0;0;0;0;.00nan;0;0
12891;179646;211;0;0;0;0;.00nan;0;0
12891;181102;219;85;29;1;28;.966;3600000;0
12901;184175;224;83;39;3;36;.923;3670000;0
12901;185800;229;0;0;0;0;.00nan;0;0
12901;185840;224;0;0;0;0;.00nan;0;0
12901;185960;229;77;34;2;32;.941;3670000;0
13054;170351;194;52;21;3;18;.857;3600000;0
13054;174325;197;0;0;0;0;.00nan;0;0
13054;201585;197;82;30;2;28;.933;3600000;0
13054;-1;194;0;0;0;0;.00nan;0;0
12888;182454;4864;0;0;0;0;.00nan;0;0
12888;183737;4864;96;25;0;25;1.000;3600000;0
12888;176932;176;0;0;0;0;.00nan;0;0
12888;182006;176;79;27;2;25;.926;3568000;0
12689;-1;203;94;32;1;31;.969;3600000;0
12689;-1;203;0;0;0;0;.00nan;0;0
12689;-1;207;0;0;0;0;.00nan;0;0
12689;-1;207;74;24;2;22;.917;3568000;0
13240;195164;218;96;40;2;38;.950;3600000;0
13240;190095;218;0;0;0;0;.00nan;0;0
13240;182128;215;37;22;4;18;.818;2579000;0
13240;-1;215;11;10;5;5;.500;1021000;0
12749;189902;204;72;21;1;20;.952;3600000;0
12749;184712;204;0;0;0;0;.00nan;0;0
12749;201560;202;24;24;5;19;.792;2354000;0
12749;196299;202;52;4;0;4;1.000;1246000;0
12823;179169;209;0;0;0;0;.00nan;0;0
12823;184907;4959;94;34;1;33;.971;3600000;0
12823;186205;209;75;25;2;23;.920;3558000;0
12823;-1;4959;0;0;0;0;.00nan;0;0
13025;192461;210;76;33;3;30;.909;3574000;0
13025;197672;210;0;0;0;0;.00nan;0;0
13025;-1;178;82;36;2;34;.944;3600000;0
13025;-1;178;0;0;0;0;.00nan;0;0
13552;182454;4864;0;0;0;0;.00nan;0;0
13552;183737;4864;83;38;3;35;.921;3600000;0
13552;201562;2620;43;24;4;20;.833;3571000;0
13552;-1;2620;0;0;0;0;.00nan;0;0
12714;200306;182;0;0;0;0;.00nan;0;0
12714;-1;1371;0;0;0;0;.00nan;0;0
12714;179388;182;56;35;4;31;.886;3544000;0
12714;192688;1371;72;33;2;31;.939;3600000;0
13087;179452;226;62;21;2;19;.905;3600000;0
13087;185743;201;0;0;0;0;.00nan;0;0
13087;192629;226;0;0;0;0;.00nan;0;0
13087;-1;201;62;33;4;29;.879;3568000;0
12878;187628;227;0;0;0;0;.00nan;0;0
12878;194219;4960;0;0;0;0;.00nan;0;0
12878;173219;4960;98;41;2;39;.951;3600000;0
12878;-1;227;84;29;1;28;.966;3600000;0
13238;201524;205;74;20;1;19;.950;3600000;0
13238;-1;205;0;0;0;0;.00nan;0;0
13238;-1;206;0;0;0;0;.00nan;0;0
13238;202998;206;45;38;5;33;.868;3600000;0
12843;200452;221;61;7;0;7;1.000;1126000;0
12843;184610;222;0;0;0;0;.00nan;0;0
12843;185851;222;97;42;2;40;.952;3600000;0
12843;187362;221;18;21;6;15;.714;2474000;0
12743;196571;177;40;31;5;26;.839;3600000;0
12743;192461;210;93;36;2;34;.944;3600000;0
12743;197672;210;0;0;0;0;.00nan;0;0
12743;-1;177;0;0;0;0;.00nan;0;0
12970;169226;186;69;18;1;17;.944;3600000;0
12970;190034;217;89;47;2;45;.957;3600000;0
12970;190041;217;0;0;0;0;.00nan;0;0
12970;185778;186;0;0;0;0;.00nan;0;0
12697;182467;185;75;32;2;30;.938;3544000;0
12697;-1;1371;77;24;1;23;.958;3600000;0
12697;-1;185;0;0;0;0;.00nan;0;0
12697;192688;1371;0;0;0;0;.00nan;0;0
12874;200452;221;72;29;3;26;.897;3568000;0
12874;185800;229;86;29;1;28;.966;3600000;0
12874;185960;229;0;0;0;0;.00nan;0;0
12874;187362;221;0;0;0;0;.00nan;0;0
12999;179169;209;82;24;1;23;.958;3600000;0
12999;176932;176;0;0;0;0;.00nan;0;0
12999;182006;176;30;21;5;16;.762;3600000;0
12999;186205;209;0;0;0;0;.00nan;0;0
12813;189773;231;0;0;0;0;.00nan;0;0
12813;185034;231;61;17;2;15;.882;3600000;0
12813;191120;223;66;44;5;39;.886;3600000;0
12813;187118;223;0;0;0;0;.00nan;0;0
12831;173549;219;60;37;4;33;.892;3600000;0
12831;181102;219;0;0;0;0;.00nan;0;0
12831;182128;215;43;22;4;18;.818;2335000;0
12831;-1;215;52;17;2;15;.882;1264000;0
12884;184069;208;100;29;0;29;1.000;3600000;0
12884;-1;203;84;39;3;36;.923;3600000;0
12884;179702;208;0;0;0;0;.00nan;0;0
12884;-1;203;0;0;0;0;.00nan;0;0
12731;178394;188;0;0;0;0;.00nan;0;0
12731;184409;188;80;23;1;22;.957;3600000;0
12731;192547;190;95;47;2;45;.957;3600000;0
12731;197704;190;0;0;0;0;.00nan;0;0
12707;184788;198;57;30;3;27;.900;3571000;0
12707;179647;195;80;31;2;29;.935;3600000;0
12707;181431;198;0;0;0;0;.00nan;0;0
12707;191849;195;0;0;0;0;.00nan;0;0
13070;189885;225;85;38;2;36;.947;3571000;0
13070;175354;228;97;23;0;23;1.000;3600000;0
13070;180377;228;0;0;0;0;.00nan;0;0
13070;-1;225;0;0;0;0;.00nan;0;0
12837;-1;211;37;12;3;9;.750;392000;0
12837;195164;218;61;14;1;13;.929;3600000;0
12837;190095;218;0;0;0;0;.00nan;0;0
12837;179646;211;91;30;2;28;.933;3208000;0
13190;170351;194;0;0;0;0;.00nan;0;0
13190;174325;197;0;0;0;0;.00nan;0;0
13190;201585;197;85;42;2;40;.952;3555000;0
13190;-1;194;70;18;1;17;.944;3600000;0
13284;175370;199;0;0;0;0;.00nan;0;0
13284;201524;205;0;0;0;0;.00nan;0;0
13284;-1;205;84;32;2;30;.938;3600000;0
13284;161006;199;45;31;5;26;.839;3600000;0
13045;179679;212;0;0;0;0;.00nan;0;0
13045;186641;212;99;33;1;32;.970;3600000;0
13045;-1;180;66;29;3;26;.897;3561000;0
13045;197707;180;0;0;0;0;.00nan;0;0
12712;189902;204;0;0;0;0;.00nan;0;0
12712;184712;204;83;47;3;44;.936;3543000;0
12712;-1;207;80;29;2;27;.931;3600000;0
12712;-1;207;0;0;0;0;.00nan;0;0
12798;173770;193;0;0;0;0;.00nan;0;0
12798;-1;189;77;35;3;32;.914;3528000;0
12798;186451;193;60;19;1;18;.947;3600000;0
12798;-1;189;0;0;0;0;.00nan;0;0
12825;184610;222;56;25;3;22;.880;3600000;0
12825;185851;222;0;0;0;0;.00nan;0;0
12825;191120;223;0;0;0;0;.00nan;0;0
12825;187118;223;100;28;0;28;1.000;3600000;0
12920;189081;187;100;21;0;21;1.000;3600000;0
12920;192547;190;67;19;1;18;.947;1100000;0
12920;-1;187;0;0;0;0;.00nan;0;0
12920;197704;190;24;30;6;24;.800;2500000;0
12861;-1;216;0;0;0;0;.00nan;0;0
12861;201495;213;74;35;2;33;.943;3600000;0
12861;187240;216;77;27;1;26;.963;3600000;0
12861;203029;213;0;0;0;0;.00nan;0;0
12692;190125;184;60;30;3;27;.900;3549000;0
12692;179668;184;0;0;0;0;.00nan;0;0
12692;-1;214;87;41;2;39;.951;3600000;0
12692;191518;214;0;0;0;0;.00nan;0;0
12869;173900;192;0;0;0;0;.00nan;0;0
12869;-1;189;0;0;0;0;.00nan;0;0
12869;-1;192;88;34;2;32;.941;3900000;0
12869;-1;189;94;36;2;34;.944;3900000;0
12717;195238;200;0;0;0;0;.00nan;0;0
12717;-1;207;0;0;0;0;.00nan;0;0
12717;187295;200;65;17;2;15;.882;3600000;0
12717;-1;207;57;38;4;34;.895;3580000;0
12763;173770;193;73;28;2;26;.929;3600000;0
12763;184788;198;0;0;0;0;.00nan;0;0
12763;181431;198;77;34;3;31;.912;3559000;0
12763;186451;193;0;0;0;0;.00nan;0;0
12857;189773;231;0;0;0;0;.00nan;0;0
12857;185034;231;68;15;1;14;.933;3600000;0
12857;185800;229;19;8;4;4;.500;701000;0
12857;185960;229;21;40;8;32;.800;2899000;0
12799;184069;208;90;31;1;30;.968;3780000;0
12799;201560;202;0;0;0;0;.00nan;0;0
12799;179702;208;0;0;0;0;.00nan;0;0
12799;196299;202;88;33;2;31;.939;3780000;0
12961;187628;227;58;27;3;24;.889;3900000;0
12961;184175;224;73;42;3;39;.929;3900000;0
12961;-1;227;0;0;0;0;.00nan;0;0
12961;185840;224;0;0;0;0;.00nan;0;0
12844;194219;4960;59;27;3;24;.889;3555000;0
12844;183695;232;0;0;0;0;.00nan;0;0
12844;173219;4960;0;0;0;0;.00nan;0;0
12844;179691;232;79;27;1;26;.963;3600000;0
12903;201562;2620;0;0;0;0;.00nan;0;0
12903;184907;4959;0;0;0;0;.00nan;0;0
12903;-1;2620;76;21;1;20;.952;3600000;0
12903;-1;4959;66;45;5;40;.889;3600000;0
12827;192915;179;0;0;0;0;.00nan;0;0
12827;183678;1505;0;0;0;0;.00nan;0;0
12827;-1;179;78;30;3;27;.900;3900000;0
12827;186549;1505;64;31;3;28;.903;3900000;0
13043;200306;182;83;37;2;35;.946;3600000;0
13043;179388;182;0;0;0;0;.00nan;0;0
13043;-1;181;52;33;4;29;.879;3583000;0
13043;192552;181;0;0;0;0;.00nan;0;0
12966;173549;219;0;0;0;0;.00nan;0;0
12966;190034;217;0;0;0;0;.00nan;0;0
12966;190041;217;70;22;1;21;.955;3600000;0
12966;181102;219;39;29;5;24;.828;3600000;0
13132;179452;226;0;0;0;0;.00nan;0;0
13132;185743;201;49;28;4;24;.857;3527000;0
13132;192629;226;91;37;2;35;.946;3600000;0
13132;-1;201;0;0;0;0;.00nan;0;0
13509;182467;185;88;46;3;43;.935;3600000;0
13509;-1;1371;0;0;0;0;.00nan;0;0
13509;-1;185;0;0;0;0;.00nan;0;0
13509;192688;1371;72;30;2;28;.933;3600000;0
13583;192915;179;74;36;3;33;.917;3600000;0
13583;196571;177;56;34;5;29;.853;3568000;0
13583;-1;179;0;0;0;0;.00nan;0;0
13583;-1;177;0;0;0;0;.00nan;0;0
12818;200452;221;0;0;0;0;.00nan;0;0
12818;184175;224;0;0;0;0;.00nan;0;0
12818;185840;224;64;45;4;41;.911;3583000;0
12818;187362;221;90;31;2;29;.935;3600000;0
12811;195238;200;0;0;0;0;.00nan;0;0
12811;189902;204;100;27;0;27;1.000;3600000;0
12811;184712;204;0;0;0;0;.00nan;0;0
12811;187295;200;97;38;2;36;.947;3521000;0
12748;-1;220;64;34;4;30;.882;3566000;0
12748;187443;220;0;0;0;0;.00nan;0;0
12748;-1;214;0;0;0;0;.00nan;0;0
12748;191518;214;68;28;2;26;.929;3600000;0
12909;182454;4864;0;0;0;0;.00nan;0;0
12909;183737;4864;56;38;5;33;.868;3578000;0
12909;179169;209;0;0;0;0;.00nan;0;0
12909;186205;209;57;31;4;27;.871;3600000;0
12976;194893;191;69;24;2;22;.917;3600000;0
12976;184648;196;78;50;5;45;.900;3600000;0
12976;201892;191;0;0;0;0;.00nan;0;0
12976;191118;196;0;0;0;0;.00nan;0;0
13145;169226;186;57;28;3;25;.893;3599000;0
13145;195164;218;0;0;0;0;.00nan;0;0
13145;190095;218;99;51;2;49;.961;3600000;0
13145;185778;186;0;0;0;0;.00nan;0;0
12852;-1;211;83;44;2;42;.955;3597000;0
12852;179646;211;0;0;0;0;.00nan;0;0
12852;-1;180;51;7;1;6;.857;3600000;0
12852;197707;180;0;0;0;0;.00nan;0;0
13079;195251;4949;75;28;2;26;.929;3600000;0
13079;-1;216;63;36;4;32;.889;3535000;0
13079;187240;216;0;0;0;0;.00nan;0;0
13079;197685;4949;0;0;0;0;.00nan;0;0
13540;189902;204;89;46;3;43;.935;3600000;0
13540;184712;204;0;0;0;0;.00nan;0;0
13540;179452;226;83;28;1;27;.964;3600000;0
13540;192629;226;0;0;0;0;.00nan;0;0
12885;189081;187;56;14;1;13;.929;3600000;0
12885;174325;197;0;0;0;0;.00nan;0;0
12885;201585;197;79;50;4;46;.920;3600000;0
12885;-1;187;0;0;0;0;.00nan;0;0
12761;196571;177;0;0;0;0;.00nan;0;0
12761;-1;178;0;0;0;0;.00nan;0;0
12761;-1;178;85;51;4;47;.922;3600000;0
12761;-1;177;67;15;1;14;.933;3600000;0
12918;182454;4864;0;0;0;0;.00nan;0;0
12918;183737;4864;78;34;2;32;.941;3567000;0
12918;201562;2620;0;0;0;0;.00nan;0;0
12918;-1;2620;84;26;1;25;.962;3600000;0
12975;184069;208;0;0;0;0;.00nan;0;0
12975;179702;208;69;37;3;34;.919;3545000;0
12975;-1;206;75;30;2;28;.933;3600000;0
12975;202998;206;0;0;0;0;.00nan;0;0
12838;194893;191;0;0;0;0;.00nan;0;0
12838;173900;192;0;0;0;0;.00nan;0;0
12838;-1;192;92;47;2;45;.957;3600000;0
12838;201892;191;71;20;1;19;.950;3600000;0
13048;179679;212;0;0;0;0;.00nan;0;0
13048;182128;215;0;0;0;0;.00nan;0;0
13048;186641;212;66;26;2;24;.923;3600000;0
13048;-1;215;59;24;3;21;.875;3591000;0
13080;-1;183;0;0;0;0;.00nan;0;0
13080;182089;183;81;32;2;30;.938;3562000;0
13080;-1;178;73;25;1;24;.960;3600000;0
13080;-1;178;0;0;0;0;.00nan;0;0
12801;173770;193;0;0;0;0;.00nan;0;0
12801;184788;198;0;0;0;0;.00nan;0;0
12801;181431;198;77;33;3;30;.909;3900000;0
12801;186451;193;58;29;3;26;.897;3900000;0
12806;178394;188;0;0;0;0;.00nan;0;0
12806;173900;192;0;0;0;0;.00nan;0;0
12806;184409;188;76;36;2;34;.944;3543000;0
12806;-1;192;79;29;1;28;.966;3600000;0
13201;169226;186;51;30;4;26;.867;3581000;0
13201;195164;218;87;44;3;41;.932;3600000;0
13201;190095;218;0;0;0;0;.00nan;0;0
13201;185778;186;0;0;0;0;.00nan;0;0
13488;175370;199;53;34;4;30;.882;3600000;0
13488;201524;205;0;0;0;0;.00nan;0;0
13488;-1;205;96;33;1;32;.970;3600000;0
13488;161006;199;0;0;0;0;.00nan;0;0
12786;179452;226;0;0;0;0;.00nan;0;0
12786;-1;207;60;25;2;23;.920;3600000;0
12786;-1;207;0;0;0;0;.00nan;0;0
12786;192629;226;82;37;3;34;.919;3550000;0
12824;195238;200;0;0;0;0;.00nan;0;0
12824;-1;203;43;33;6;27;.818;2109000;0
12824;-1;203;64;13;0;13;1.000;1491000;0
12824;187295;200;62;27;3;24;.889;3600000;0
12984;184175;224;35;21;4;17;.810;3595000;0
12984;185800;229;65;29;3;26;.897;3600000;0
12984;185840;224;0;0;0;0;.00nan;0;0
12984;185960;229;0;0;0;0;.00nan;0;0
12886;189773;231;0;0;0;0;.00nan;0;0
12886;184610;222;24;13;4;9;.692;1187000;0
12886;185034;231;80;26;2;24;.923;3600000;0
12886;185851;222;48;25;3;22;.880;2413000;0
12850;192915;179;0;0;0;0;.00nan;0;0
12850;195251;4949;45;30;4;26;.867;3600000;0
12850;-1;179;95;23;0;23;1.000;3600000;0
12850;197685;4949;0;0;0;0;.00nan;0;0
12989;170351;194;55;20;2;18;.900;3600000;0
12989;184648;196;50;28;4;24;.857;3562000;0
12989;-1;194;0;0;0;0;.00nan;0;0
12989;191118;196;0;0;0;0;.00nan;0;0
12924;179169;209;0;0;0;0;.00nan;0;0
12924;184907;4959;0;0;0;0;.00nan;0;0
12924;186205;209;96;37;1;36;.973;3600000;0
12924;-1;4959;79;35;2;33;.943;3600000;0
12809;201560;202;65;25;3;22;.880;3600000;0
12809;196299;202;0;0;0;0;.00nan;0;0
12809;-1;206;0;0;0;0;.00nan;0;0
12809;202998;206;100;41;0;41;1.000;3600000;0
12870;194219;4960;0;0;0;0;.00nan;0;0
12870;183695;232;71;28;1;27;.964;3600000;0
12870;173219;4960;60;38;5;33;.868;3600000;0
12870;179691;232;0;0;0;0;.00nan;0;0
13023;189885;225;0;0;0;0;.00nan;0;0
13023;-1;225;69;28;2;26;.929;3600000;0
13023;185800;229;0;0;0;0;.00nan;0;0
13023;185960;229;36;30;5;25;.833;3600000;0
12858;184610;222;65;33;3;30;.909;3600000;0
12858;175354;228;99;20;0;20;1.000;3600000;0
12858;180377;228;0;0;0;0;.00nan;0;0
12858;185851;222;0;0;0;0;.00nan;0;0
13163;201524;205;0;0;0;0;.00nan;0;0
13163;-1;205;38;26;5;21;.808;3576000;0
13163;185743;201;67;34;3;31;.912;3600000;0
13163;-1;201;0;0;0;0;.00nan;0;0
12803;196571;177;89;47;3;44;.936;3859000;0
12803;192461;210;76;30;2;28;.933;3859000;0
12803;197672;210;0;0;0;0;.00nan;0;0
12803;-1;177;0;0;0;0;.00nan;0;0
12913;-1;203;71;37;4;33;.892;3600000;0
12913;189902;204;100;23;0;23;1.000;3600000;0
12913;184712;204;0;0;0;0;.00nan;0;0
12913;-1;203;0;0;0;0;.00nan;0;0
12902;200452;221;0;0;0;0;.00nan;0;0
12902;181338;230;0;0;0;0;.00nan;0;0
12902;186495;230;100;22;0;22;1.000;3600000;0
12902;187362;221;98;46;2;44;.957;3521000;0
12744;195238;200;67;24;2;22;.917;3543000;0
12744;-1;207;0;0;0;0;.00nan;0;0
12744;187295;200;0;0;0;0;.00nan;0;0
12744;-1;207;100;31;0;31;1.000;3600000;0
12908;192915;179;0;0;0;0;.00nan;0;0
12908;-1;216;0;0;0;0;.00nan;0;0
12908;-1;179;96;34;1;33;.971;3900000;0
12908;187240;216;89;29;1;28;.966;3900000;0
13370;194893;191;88;13;0;13;1.000;3600000;0
13370;170351;194;0;0;0;0;.00nan;0;0
13370;-1;194;65;50;6;44;.880;3600000;0
13370;201892;191;0;0;0;0;.00nan;0;0
12927;-1;211;72;33;3;30;.909;3568000;0
12927;179646;211;0;0;0;0;.00nan;0;0
12927;179679;212;0;0;0;0;.00nan;0;0
12927;186641;212;60;14;1;13;.929;3600000;0
12922;201562;2620;0;0;0;0;.00nan;0;0
12922;176932;176;0;0;0;0;.00nan;0;0
12922;182006;176;61;31;3;28;.903;3683000;0
12922;-1;2620;64;23;2;21;.913;3673000;0
12728;-1;1371;0;0;0;0;.00nan;0;0
12728;-1;214;97;39;1;38;.974;3900000;0
12728;191518;214;0;0;0;0;.00nan;0;0
12728;192688;1371;90;26;1;25;.962;3900000;0
13130;187628;227;0;0;0;0;.00nan;0;0
13130;184175;224;0;0;0;0;.00nan;0;0
13130;-1;227;47;24;4;20;.833;3636000;0
13130;185840;224;54;31;5;26;.839;3636000;0
12982;200306;182;73;25;1;24;.960;3600000;0
12982;179388;182;0;0;0;0;.00nan;0;0
12982;-1;220;0;0;0;0;.00nan;0;0
12982;187443;220;73;26;2;24;.923;3589000;0
12971;184648;196;0;0;0;0;.00nan;0;0
12971;191118;196;58;35;4;31;.886;3587000;0
12971;192547;190;0;0;0;0;.00nan;0;0
12971;197704;190;92;39;2;37;.949;3600000;0
13014;190034;217;98;54;1;53;.981;3599000;0
13014;190041;217;0;0;0;0;.00nan;0;0
13014;-1;180;0;0;0;0;.00nan;0;0
13014;197707;180;87;14;0;14;1.000;3600000;0
12876;183678;1505;0;0;0;0;.00nan;0;0
12876;195251;4949;92;40;2;38;.950;3900000;0
12876;186549;1505;93;38;2;36;.947;3900000;0
12876;197685;4949;0;0;0;0;.00nan;0;0
12853;189081;187;56;30;4;26;.867;3600000;0
12853;173770;193;100;33;0;33;1.000;3600000;0
12853;186451;193;0;0;0;0;.00nan;0;0
12853;-1;187;0;0;0;0;.00nan;0;0
12882;-1;189;61;33;4;29;.879;3600000;0
12882;184788;198;66;23;2;21;.913;3600000;0
12882;181431;198;0;0;0;0;.00nan;0;0
12882;-1;189;0;0;0;0;.00nan;0;0
12873;173900;192;0;0;0;0;.00nan;0;0
12873;-1;189;0;0;0;0;.00nan;0;0
12873;-1;192;70;32;3;29;.906;3570000;0
12873;-1;189;74;33;2;31;.939;3600000;0
13187;184069;208;0;0;0;0;.00nan;0;0
13187;179452;226;78;30;3;27;.900;3600000;0
13187;179702;208;98;39;2;37;.949;3600000;0
13187;192629;226;0;0;0;0;.00nan;0;0
13008;195164;218;76;35;4;31;.886;3600000;0
13008;190034;217;0;0;0;0;.00nan;0;0
13008;190041;217;99;36;1;35;.972;3600000;0
13008;190095;218;0;0;0;0;.00nan;0;0
12972;189773;231;0;0;0;0;.00nan;0;0
12972;185034;231;83;44;3;41;.932;3900000;0
12972;181338;230;0;0;0;0;.00nan;0;0
12972;186495;230;78;30;3;27;.900;3900000;0
12694;182467;185;0;0;0;0;.00nan;0;0
12694;190125;184;83;36;3;33;.917;3900000;0
12694;179668;184;0;0;0;0;.00nan;0;0
12694;-1;185;68;41;3;38;.927;3900000;0
12907;187628;227;52;29;4;25;.862;3578000;0
12907;183695;232;0;0;0;0;.00nan;0;0
12907;-1;227;0;0;0;0;.00nan;0;0
12907;179691;232;76;28;2;26;.929;3600000;0
12949;-1;211;0;0;0;0;.00nan;0;0
12949;173549;219;44;15;3;12;.800;3600000;0
12949;179646;211;71;35;4;31;.886;3572000;0
12949;181102;219;0;0;0;0;.00nan;0;0
12987;182454;4864;0;0;0;0;.00nan;0;0
12987;183737;4864;94;31;1;30;.968;3600000;0
12987;179169;209;45;25;4;21;.840;3600000;0
12987;186205;209;0;0;0;0;.00nan;0;0
13131;-1;183;73;34;2;32;.941;3830000;0
13131;182089;183;0;0;0;0;.00nan;0;0
13131;-1;178;0;0;0;0;.00nan;0;0
13131;-1;178;73;32;3;29;.906;3830000;0
12822;178394;188;0;0;0;0;.00nan;0;0
12822;184409;188;58;8;1;7;.875;3600000;0
12822;192547;190;97;59;3;56;.949;3600000;0
12822;197704;190;0;0;0;0;.00nan;0;0
12797;-1;216;52;22;3;19;.864;3643000;0
12797;196571;177;0;0;0;0;.00nan;0;0
12797;187240;216;0;0;0;0;.00nan;0;0
12797;-1;177;83;37;2;35;.946;3642000;0
13076;189081;187;61;16;1;15;.938;1182000;0
13076;194893;191;100;30;0;30;1.000;3600000;0
13076;201892;191;0;0;0;0;.00nan;0;0
13076;-1;187;33;32;6;26;.813;2418000;0
12796;200306;182;0;0;0;0;.00nan;0;0
12796;179388;182;66;22;2;20;.909;3600000;0
12796;-1;214;0;0;0;0;.00nan;0;0
12796;191518;214;66;45;5;40;.889;3600000;0
12925;175354;228;72;19;1;18;.947;3600000;0
12925;180377;228;0;0;0;0;.00nan;0;0
12925;191120;223;0;0;0;0;.00nan;0;0
12925;187118;223;56;28;3;25;.893;3554000;0
12934;-1;203;0;0;0;0;.00nan;0;0
12934;189902;204;57;39;5;34;.872;3600000;0
12934;184712;204;0;0;0;0;.00nan;0;0
12934;-1;203;76;19;1;18;.947;3600000;0
12867;173900;192;41;17;3;14;.824;1200000;0
12867;179647;195;97;33;1;32;.970;3600000;0
12867;-1;192;26;30;7;23;.767;2400000;0
12867;191849;195;0;0;0;0;.00nan;0;0
12789;184069;208;65;23;2;21;.913;3549000;0
12789;179702;208;0;0;0;0;.00nan;0;0
12789;-1;207;0;0;0;0;.00nan;0;0
12789;-1;207;87;32;1;31;.969;3600000;0
12933;200452;221;63;34;3;31;.912;3562000;0
12933;191120;223;73;33;2;31;.939;3600000;0
12933;187118;223;0;0;0;0;.00nan;0;0
12933;187362;221;0;0;0;0;.00nan;0;0
12708;-1;1371;0;0;0;0;.00nan;0;0
12708;190125;184;79;33;3;30;.909;3900000;0
12708;179668;184;0;0;0;0;.00nan;0;0
12708;192688;1371;65;31;3;28;.903;3893000;0
13031;182454;4864;89;48;3;45;.938;3590000;0
13031;183737;4864;0;0;0;0;.00nan;0;0
13031;201562;2620;0;0;0;0;.00nan;0;0
13031;-1;2620;69;14;1;13;.929;3600000;0
12899;192915;179;73;31;2;29;.935;3564000;0
12899;183678;1505;0;0;0;0;.00nan;0;0
12899;-1;179;0;0;0;0;.00nan;0;0
12899;186549;1505;79;26;1;25;.962;3600000;0
13020;201495;213;0;0;0;0;.00nan;0;0
13020;192461;210;69;18;1;17;.944;3600000;0
13020;197672;210;0;0;0;0;.00nan;0;0
13020;203029;213;98;52;2;50;.962;3568000;0
12892;178394;188;29;25;5;20;.800;1523000;0
12892;173770;193;77;23;2;21;.913;3600000;0
12892;184409;188;79;18;0;18;1.000;2077000;0
12892;186451;193;0;0;0;0;.00nan;0;0
12829;201560;202;69;28;2;26;.929;3581000;0
12829;196299;202;0;0;0;0;.00nan;0;0
12829;185743;201;79;28;1;27;.964;3600000;0
12829;-1;201;0;0;0;0;.00nan;0;0
12937;194219;4960;94;34;1;33;.971;3600000;0
12937;173219;4960;0;0;0;0;.00nan;0;0
12937;189773;231;43;22;4;18;.818;3600000;0
12937;185034;231;0;0;0;0;.00nan;0;0
12939;176932;176;0;0;0;0;.00nan;0;0
12939;184907;4959;0;0;0;0;.00nan;0;0
12939;182006;176;84;31;2;29;.935;3600000;0
12939;-1;4959;57;11;1;10;.909;3600000;0
12863;182467;185;72;37;3;34;.919;3589000;0
12863;-1;181;72;26;2;24;.923;3600000;0
12863;-1;185;0;0;0;0;.00nan;0;0
12863;192552;181;0;0;0;0;.00nan;0;0
13097;182128;215;40;35;6;29;.829;3600000;0
13097;-1;180;0;0;0;0;.00nan;0;0
13097;197707;180;70;22;1;21;.955;3600000;0
13097;-1;215;0;0;0;0;.00nan;0;0
13033;175370;199;0;0;0;0;.00nan;0;0
13033;-1;206;0;0;0;0;.00nan;0;0
13033;202998;206;69;33;3;30;.909;3624000;0
13033;161006;199;94;33;2;31;.939;3624000;0
13152;201495;213;69;31;3;28;.903;3600000;0
13152;-1;178;42;24;4;20;.833;3592000;0
13152;203029;213;0;0;0;0;.00nan;0;0
13152;-1;178;0;0;0;0;.00nan;0;0
12910;170351;194;91;30;1;29;.967;3600000;0
12910;-1;189;72;38;3;35;.921;3587000;0
12910;-1;194;0;0;0;0;.00nan;0;0
12910;-1;189;0;0;0;0;.00nan;0;0
13065;173549;219;0;0;0;0;.00nan;0;0
13065;190034;217;82;26;1;25;.962;3600000;0
13065;190041;217;0;0;0;0;.00nan;0;0
13065;181102;219;84;36;3;33;.917;3557000;0
12834;-1;183;0;0;0;0;.00nan;0;0
12834;196571;177;71;21;1;20;.952;3600000;0
12834;182089;183;49;34;5;29;.853;3600000;0
12834;-1;177;0;0;0;0;.00nan;0;0
12814;201560;202;0;0;0;0;.00nan;0;0
12814;196299;202;73;24;2;22;.917;3676000;0
12814;-1;206;73;35;3;32;.914;3676000;0
12814;202998;206;0;0;0;0;.00nan;0;0
12842;195238;200;0;0;0;0;.00nan;0;0
12842;185743;201;80;38;3;35;.921;3900000;0
12842;187295;200;65;26;3;23;.885;3900000;0
12842;-1;201;0;0;0;0;.00nan;0;0
13394;194219;4960;0;0;0;0;.00nan;0;0
13394;173219;4960;75;19;1;18;.947;3600000;0
13394;189885;225;90;41;2;39;.951;3552000;0
13394;-1;225;0;0;0;0;.00nan;0;0
13040;184175;224;79;28;2;26;.929;3600000;0
13040;185800;229;72;35;3;32;.914;3570000;0
13040;185840;224;0;0;0;0;.00nan;0;0
13040;185960;229;0;0;0;0;.00nan;0;0
12839;-1;220;0;0;0;0;.00nan;0;0
12839;187443;220;83;35;2;33;.943;3900000;0
12839;-1;214;0;0;0;0;.00nan;0;0
12839;191518;214;99;36;2;34;.944;3900000;0
13021;184788;198;0;0;0;0;.00nan;0;0
13021;179647;195;0;0;0;0;.00nan;0;0
13021;181431;198;89;39;2;37;.949;3549000;0
13021;191849;195;99;31;1;30;.968;3600000;0
12960;176932;176;88;43;3;40;.930;3600000;0
12960;184907;4959;100;31;0;31;1.000;3600000;0
12960;182006;176;0;0;0;0;.00nan;0;0
12960;-1;4959;0;0;0;0;.00nan;0;0
12795;-1;1371;71;23;2;21;.913;3662000;0
12795;-1;181;64;28;3;25;.893;3662000;0
12795;192552;181;0;0;0;0;.00nan;0;0
12795;192688;1371;0;0;0;0;.00nan;0;0
12957;-1;211;48;38;6;32;.842;3600000;0
12957;195164;218;82;17;0;17;1.000;3600000;0
12957;190095;218;0;0;0;0;.00nan;0;0
12957;179646;211;0;0;0;0;.00nan;0;0
13024;189902;204;51;37;5;32;.865;3530000;0
13024;184712;204;0;0;0;0;.00nan;0;0
13024;179452;226;0;0;0;0;.00nan;0;0
13024;192629;226;46;21;3;18;.857;3600000;0
13252;182128;215;0;0;0;0;.00nan;0;0
13252;-1;180;74;36;4;32;.889;3527000;0
13252;197707;180;0;0;0;0;.00nan;0;0
13252;-1;215;67;30;2;28;.933;3600000;0
13051;179169;209;0;0;0;0;.00nan;0;0
13051;201562;2620;73;26;2;24;.923;3600000;0
13051;-1;2620;0;0;0;0;.00nan;0;0
13051;186205;209;69;47;4;43;.915;3521000;0
13001;194893;191;26;17;5;12;.706;3600000;0
13001;184648;196;96;37;2;35;.946;3600000;0
13001;201892;191;0;0;0;0;.00nan;0;0
13001;191118;196;0;0;0;0;.00nan;0;0
12930;183678;1505;55;30;4;26;.867;3600000;0
12930;-1;216;0;0;0;0;.00nan;0;0
12930;186549;1505;0;0;0;0;.00nan;0;0
12930;187240;216;34;27;5;22;.815;3597000;0
12932;183695;232;35;35;7;28;.800;3600000;0
12932;175354;228;0;0;0;0;.00nan;0;0
12932;179691;232;0;0;0;0;.00nan;0;0
12932;180377;228;100;29;0;29;1.000;3600000;0
12912;182467;185;78;53;4;49;.925;3900000;0
12912;-1;220;68;37;4;33;.892;3900000;0
12912;187443;220;0;0;0;0;.00nan;0;0
12912;-1;185;0;0;0;0;.00nan;0;0
13056;195251;4949;92;46;3;43;.935;3712000;0
13056;192461;210;49;23;4;19;.826;3712000;0
13056;197672;210;0;0;0;0;.00nan;0;0
13056;197685;4949;0;0;0;0;.00nan;0;0
13116;174325;197;0;0;0;0;.00nan;0;0
13116;201585;197;92;45;4;41;.911;3900000;0
13116;192547;190;0;0;0;0;.00nan;0;0
13116;197704;190;51;31;4;27;.871;3900000;0
13584;189081;187;72;23;1;22;.957;3600000;0
13584;178394;188;70;21;2;19;.905;3600000;0
13584;184409;188;0;0;0;0;.00nan;0;0
13584;-1;187;0;0;0;0;.00nan;0;0
13015;184069;208;87;33;2;31;.939;3578000;0
13015;201524;205;0;0;0;0;.00nan;0;0
13015;179702;208;0;0;0;0;.00nan;0;0
13015;-1;205;85;29;1;28;.966;3600000;0
13553;-1;203;51;45;6;39;.867;3600000;0
13553;179452;226;54;25;3;22;.880;3600000;0
13553;-1;203;0;0;0;0;.00nan;0;0
13553;192629;226;0;0;0;0;.00nan;0;0
12953;184610;222;66;37;4;33;.892;3600000;0
12953;185851;222;0;0;0;0;.00nan;0;0
12953;191120;223;76;29;3;26;.897;3600000;0
12953;187118;223;0;0;0;0;.00nan;0;0
13150;187628;227;0;0;0;0;.00nan;0;0
13150;-1;227;65;29;3;26;.897;3900000;0
13150;189885;225;0;0;0;0;.00nan;0;0
13150;-1;225;91;50;3;47;.940;3900000;0
12709;190125;184;76;27;1;26;.963;3594000;0
12709;179668;184;0;0;0;0;.00nan;0;0
12709;-1;181;100;29;0;29;1.000;3600000;0
12709;192552;181;0;0;0;0;.00nan;0;0
12940;200452;221;0;0;0;0;.00nan;0;0
12940;181338;230;0;0;0;0;.00nan;0;0
12940;186495;230;100;31;0;31;1.000;3600000;0
12940;187362;221;97;36;1;35;.972;3600000;0
13572;182454;4864;0;0;0;0;.00nan;0;0
13572;183737;4864;100;35;0;35;1.000;3600000;0
13572;201562;2620;0;0;0;0;.00nan;0;0
13572;-1;2620;73;24;1;23;.958;3562000;0
13073;173549;219;73;31;2;29;.935;3600000;0
13073;179679;212;0;0;0;0;.00nan;0;0
13073;181102;219;0;0;0;0;.00nan;0;0
13073;186641;212;22;23;6;17;.739;3600000;0
13309;195251;4949;0;0;0;0;.00nan;0;0
13309;201495;213;61;32;4;28;.875;3600000;0
13309;197685;4949;86;29;1;28;.966;3600000;0
13309;203029;213;0;0;0;0;.00nan;0;0
13039;189081;187;0;0;0;0;.00nan;0;0
13039;179647;195;52;26;4;22;.846;3600000;0
13039;191849;195;0;0;0;0;.00nan;0;0
13039;-1;187;94;32;1;31;.969;3600000;0
13278;169226;186;99;23;0;23;1.000;3600000;0
13278;185778;186;0;0;0;0;.00nan;0;0
13278;-1;180;77;33;2;31;.939;3534000;0
13278;197707;180;0;0;0;0;.00nan;0;0
13114;195164;218;88;40;2;38;.950;3686000;0
13114;190034;217;0;0;0;0;.00nan;0;0
13114;190041;217;64;28;3;25;.893;3686000;0
13114;190095;218;0;0;0;0;.00nan;0;0
12792;182467;185;0;0;0;0;.00nan;0;0
12792;190125;184;70;30;3;27;.900;3600000;0
12792;179668;184;0;0;0;0;.00nan;0;0
12792;-1;185;53;40;5;35;.875;3551000;0
13136;179452;226;0;0;0;0;.00nan;0;0
13136;-1;206;0;0;0;0;.00nan;0;0
13136;192629;226;100;31;0;31;1.000;3600000;0
13136;202998;206;73;33;3;30;.909;3600000;0
13134;187628;227;57;32;4;28;.875;3600000;0
13134;-1;227;0;0;0;0;.00nan;0;0
13134;185800;229;0;0;0;0;.00nan;0;0
13134;185960;229;70;30;3;27;.900;3600000;0
12833;175370;199;62;34;4;30;.882;3663000;0
12833;201560;202;69;34;3;31;.912;3663000;0
12833;196299;202;0;0;0;0;.00nan;0;0
12833;161006;199;0;0;0;0;.00nan;0;0
12889;195238;200;0;0;0;0;.00nan;0;0
12889;189902;204;0;0;0;0;.00nan;0;0
12889;184712;204;63;20;2;18;.900;3600000;0
12889;187295;200;67;46;5;41;.891;3600000;0
12821;-1;1371;0;0;0;0;.00nan;0;0
12821;-1;181;0;0;0;0;.00nan;0;0
12821;192552;181;99;52;3;49;.942;3600000;0
12821;192688;1371;31;26;5;21;.808;3513000;0
12938;176932;176;0;0;0;0;.00nan;0;0
12938;184907;4959;75;28;1;27;.964;3600000;0
12938;182006;176;58;41;5;36;.878;3600000;0
12938;-1;4959;0;0;0;0;.00nan;0;0
12994;178394;188;84;36;3;33;.917;3555000;0
12994;170351;194;0;0;0;0;.00nan;0;0
12994;184409;188;0;0;0;0;.00nan;0;0
12994;-1;194;87;33;1;32;.970;3600000;0
12983;192915;179;0;0;0;0;.00nan;0;0
12983;-1;183;63;24;2;22;.917;3600000;0
12983;182089;183;0;0;0;0;.00nan;0;0
12983;-1;179;63;33;3;30;.909;3546000;0
12978;200452;221;26;6;3;3;.500;320000;0
12978;175354;228;0;0;0;0;.00nan;0;0
12978;180377;228;53;36;5;31;.861;3900000;0
12978;187362;221;84;41;2;39;.951;3580000;0
12917;194893;191;0;0;0;0;.00nan;0;0
12917;173770;193;0;0;0;0;.00nan;0;0
12917;201892;191;79;25;1;24;.960;3600000;0
12917;186451;193;21;32;7;25;.781;3600000;0
12959;189773;231;0;0;0;0;.00nan;0;0
12959;185034;231;72;26;2;24;.923;3762000;0
12959;181338;230;0;0;0;0;.00nan;0;0
12959;186495;230;91;43;3;40;.930;3762000;0
12968;-1;189;92;21;0;21;1.000;3600000;0
12968;192547;190;66;50;6;44;.880;3600000;0
12968;197704;190;0;0;0;0;.00nan;0;0
12968;-1;189;0;0;0;0;.00nan;0;0
12845;184069;208;0;0;0;0;.00nan;0;0
12845;179702;208;95;24;0;24;1.000;3600000;0
12845;-1;207;95;43;2;41;.953;3574000;0
12845;-1;207;0;0;0;0;.00nan;0;0
13011;184610;222;0;0;0;0;.00nan;0;0
13011;185851;222;43;23;5;18;.783;3570000;0
13011;191120;223;0;0;0;0;.00nan;0;0
13011;187118;223;64;38;4;34;.895;3600000;0
12923;194893;191;92;16;0;16;1.000;3600000;0
12923;-1;189;42;32;5;27;.844;2128000;0
12923;201892;191;0;0;0;0;.00nan;0;0
12923;-1;189;58;18;2;16;.889;1472000;0
12854;201524;205;100;28;0;28;1.000;3600000;0
12854;201560;202;0;0;0;0;.00nan;0;0
12854;196299;202;59;28;3;25;.893;3600000;0
12854;-1;205;0;0;0;0;.00nan;0;0
13122;184069;208;0;0;0;0;.00nan;0;0
13122;179702;208;77;47;4;43;.915;3561000;0
13122;-1;206;75;33;2;31;.939;3600000;0
13122;202998;206;0;0;0;0;.00nan;0;0
12875;196571;177;35;25;5;20;.800;3562000;0
12875;-1;178;0;0;0;0;.00nan;0;0
12875;-1;178;73;38;4;34;.895;3600000;0
12875;-1;177;0;0;0;0;.00nan;0;0
13172;173549;219;0;0;0;0;.00nan;0;0
13172;195164;218;0;0;0;0;.00nan;0;0
13172;190095;218;42;32;5;27;.844;3556000;0
13172;181102;219;72;41;4;37;.902;3600000;0
12942;173770;193;65;19;1;18;.947;3600000;0
12942;186451;193;0;0;0;0;.00nan;0;0
12942;192547;190;0;0;0;0;.00nan;0;0
12942;197704;190;35;48;7;41;.854;3600000;0
13173;179452;226;0;0;0;0;.00nan;0;0
13173;185743;201;68;36;3;33;.917;3542000;0
13173;192629;226;83;28;1;27;.964;3600000;0
13173;-1;201;0;0;0;0;.00nan;0;0
12894;173900;192;0;0;0;0;.00nan;0;0
12894;170351;194;85;50;4;46;.920;3600000;0
12894;-1;192;44;17;3;14;.824;3600000;0
12894;-1;194;0;0;0;0;.00nan;0;0
13066;184648;196;63;29;4;25;.862;3600000;0
13066;184788;198;0;0;0;0;.00nan;0;0
13066;181431;198;100;21;0;21;1.000;3600000;0
13066;191118;196;0;0;0;0;.00nan;0;0
12881;200306;182;59;19;2;17;.895;3600000;0
12881;179388;182;0;0;0;0;.00nan;0;0
12881;-1;214;94;33;1;32;.970;3600000;0
12881;191518;214;0;0;0;0;.00nan;0;0
12962;176932;176;34;16;4;12;.750;1182000;0
12962;184907;4959;0;0;0;0;.00nan;0;0
12962;182006;176;72;20;2;18;.900;2418000;0
12962;-1;4959;91;44;3;41;.932;3600000;0
12944;192915;179;56;28;4;24;.857;3565000;0
12944;-1;216;79;38;3;35;.921;3600000;0
12944;-1;179;0;0;0;0;.00nan;0;0
12944;187240;216;0;0;0;0;.00nan;0;0
13005;183678;1505;0;0;0;0;.00nan;0;0
13005;195251;4949;90;31;1;30;.968;3600000;0
13005;186549;1505;50;18;2;16;.889;3559000;0
13005;197685;4949;0;0;0;0;.00nan;0;0
12846;175370;199;0;0;0;0;.00nan;0;0
12846;-1;207;0;0;0;0;.00nan;0;0
12846;-1;207;98;23;0;23;1.000;3600000;0
12846;161006;199;58;35;5;30;.857;3600000;0
13012;183695;232;65;36;4;32;.889;3609000;0
13012;184610;222;59;34;5;29;.853;3609000;0
13012;179691;232;0;0;0;0;.00nan;0;0
13012;185851;222;0;0;0;0;.00nan;0;0
13018;187628;227;0;0;0;0;.00nan;0;0
13018;-1;227;75;26;1;25;.962;3600000;0
13018;191120;223;73;47;5;42;.894;3600000;0
13018;187118;223;0;0;0;0;.00nan;0;0
13092;169226;186;72;28;2;26;.929;3600000;0
13092;190034;217;52;33;5;28;.848;3600000;0
13092;190041;217;0;0;0;0;.00nan;0;0
13092;185778;186;0;0;0;0;.00nan;0;0
13282;182128;215;84;31;1;30;.968;3600000;0
13282;-1;180;0;0;0;0;.00nan;0;0
13282;197707;180;66;34;3;31;.912;3522000;0
13282;-1;215;0;0;0;0;.00nan;0;0
12946;189081;187;63;32;4;28;.875;3576000;0
12946;178394;188;0;0;0;0;.00nan;0;0
12946;184409;188;53;18;3;15;.833;3600000;0
12946;-1;187;0;0;0;0;.00nan;0;0
13268;174325;197;52;8;1;7;.875;444000;0
13268;201585;197;65;50;4;46;.920;3156000;0
13268;179647;195;57;19;2;17;.895;3600000;0
13268;191849;195;0;0;0;0;.00nan;0;0
13144;194219;4960;61;20;3;17;.850;3600000;0
13144;173219;4960;0;0;0;0;.00nan;0;0
13144;185800;229;60;28;4;24;.857;3600000;0
13144;185960;229;0;0;0;0;.00nan;0;0
13055;182454;4864;0;0;0;0;.00nan;0;0
13055;183737;4864;73;31;3;28;.903;3670000;0
13055;179169;209;0;0;0;0;.00nan;0;0
13055;186205;209;64;35;4;31;.886;3670000;0
13147;-1;183;0;0;0;0;.00nan;0;0
13147;196571;177;0;0;0;0;.00nan;0;0
13147;182089;183;60;44;5;39;.886;3600000;0
13147;-1;177;85;33;2;31;.939;3600000;0
13049;200452;221;0;0;0;0;.00nan;0;0
13049;189885;225;71;23;1;22;.957;3600000;0
13049;-1;225;0;0;0;0;.00nan;0;0
13049;187362;221;73;43;5;38;.884;3600000;0
12981;-1;211;71;29;2;27;.931;3900000;0
12981;179646;211;0;0;0;0;.00nan;0;0
12981;179679;212;0;0;0;0;.00nan;0;0
12981;186641;212;74;24;2;22;.917;3900000;0
12979;184175;224;65;44;5;39;.886;3600000;0
12979;189773;231;0;0;0;0;.00nan;0;0
12979;185034;231;90;18;0;18;1.000;3600000;0
12979;185840;224;0;0;0;0;.00nan;0;0
13094;-1;216;65;7;0;7;1.000;1620000;0
13094;201495;213;0;0;0;0;.00nan;0;0
13094;187240;216;14;19;6;13;.684;1980000;0
13094;203029;213;62;30;3;27;.900;3600000;0
13113;179169;209;11;18;6;12;.667;1939000;0
13113;201562;2620;0;0;0;0;.00nan;0;0
13113;-1;2620;80;29;1;28;.966;3600000;0
13113;186205;209;49;18;2;16;.889;1661000;0
13104;189885;225;0;0;0;0;.00nan;0;0
13104;184610;222;100;32;0;32;1.000;3600000;0
13104;-1;225;61;31;4;27;.871;3600000;0
13104;185851;222;0;0;0;0;.00nan;0;0
12952;189081;187;96;33;1;32;.970;3900000;0
12952;173770;193;59;23;1;22;.957;3900000;0
12952;186451;193;0;0;0;0;.00nan;0;0
12952;-1;187;0;0;0;0;.00nan;0;0
13175;170351;194;0;0;0;0;.00nan;0;0
13175;184788;198;0;0;0;0;.00nan;0;0
13175;-1;194;77;34;2;32;.941;3900000;0
13175;181431;198;76;31;2;29;.935;3900000;0
12985;201562;2620;78;23;1;22;.957;3600000;0
12985;176932;176;0;0;0;0;.00nan;0;0
12985;182006;176;67;29;3;26;.897;3552000;0
12985;-1;2620;0;0;0;0;.00nan;0;0
12855;200306;182;73;24;2;22;.917;3900000;0
12855;179388;182;0;0;0;0;.00nan;0;0
12855;190125;184;95;32;2;30;.938;3900000;0
12855;179668;184;0;0;0;0;.00nan;0;0
12926;195238;200;0;0;0;0;.00nan;0;0
12926;175370;199;71;21;1;20;.952;3600000;0
12926;187295;200;81;33;2;31;.939;3567000;0
12926;161006;199;0;0;0;0;.00nan;0;0
13198;173549;219;23;33;7;26;.788;3600000;0
13198;181102;219;0;0;0;0;.00nan;0;0
13198;182128;215;0;0;0;0;.00nan;0;0
13198;-1;215;61;26;3;23;.885;3600000;0
13059;192915;179;0;0;0;0;.00nan;0;0
13059;-1;183;89;52;4;48;.923;3888000;0
13059;182089;183;0;0;0;0;.00nan;0;0
13059;-1;179;26;18;5;13;.722;3888000;0
13153;201495;213;82;34;2;32;.941;3874000;0
13153;-1;178;87;33;1;32;.970;3874000;0
13153;203029;213;0;0;0;0;.00nan;0;0
13153;-1;178;0;0;0;0;.00nan;0;0
13057;183678;1505;0;0;0;0;.00nan;0;0
13057;186549;1505;65;24;2;22;.917;3900000;0
13057;192461;210;81;25;2;23;.920;3900000;0
13057;197672;210;0;0;0;0;.00nan;0;0
12859;-1;1371;0;0;0;0;.00nan;0;0
12859;-1;181;56;21;2;19;.905;3900000;0
12859;192552;181;0;0;0;0;.00nan;0;0
12859;192688;1371;96;44;2;42;.955;3900000;0
13016;-1;211;0;0;0;0;.00nan;0;0
13016;179646;211;58;53;7;46;.868;3600000;0
13016;179679;212;0;0;0;0;.00nan;0;0
13016;186641;212;64;22;2;20;.909;3600000;0
13078;-1;220;0;0;0;0;.00nan;0;0
13078;187443;220;54;24;3;21;.875;3562000;0
13078;-1;214;75;29;2;27;.931;3600000;0
13078;191518;214;0;0;0;0;.00nan;0;0
13030;182454;4864;0;0;0;0;.00nan;0;0
13030;183737;4864;78;41;3;38;.927;3541000;0
13030;184907;4959;0;0;0;0;.00nan;0;0
13030;-1;4959;57;20;2;18;.900;3600000;0
12896;201524;205;57;25;3;22;.880;3586000;0
12896;-1;207;0;0;0;0;.00nan;0;0
12896;-1;205;0;0;0;0;.00nan;0;0
12896;-1;207;64;24;2;22;.917;3600000;0
12967;200452;221;70;35;3;32;.914;3665000;0
12967;175354;228;65;22;2;20;.909;3665000;0
12967;180377;228;0;0;0;0;.00nan;0;0
12967;187362;221;0;0;0;0;.00nan;0;0
13052;183695;232;19;10;4;6;.600;1025000;0
13052;184175;224;0;0;0;0;.00nan;0;0
13052;179691;232;48;10;2;8;.800;2575000;0
13052;185840;224;71;30;3;27;.900;3600000;0
13137;179647;195;92;20;0;20;1.000;3600000;0
13137;191849;195;0;0;0;0;.00nan;0;0
13137;192547;190;0;0;0;0;.00nan;0;0
13137;197704;190;62;46;6;40;.870;3600000;0
12872;201560;202;54;22;3;19;.864;3589000;0
12872;196299;202;0;0;0;0;.00nan;0;0
12872;185743;201;97;35;1;34;.971;3600000;0
12872;-1;201;0;0;0;0;.00nan;0;0
13290;169226;186;43;18;3;15;.833;3584000;0
13290;185778;186;0;0;0;0;.00nan;0;0
13290;-1;180;100;42;1;41;.976;3600000;0
13290;197707;180;0;0;0;0;.00nan;0;0
12898;173900;192;29;20;6;14;.700;3900000;0
12898;184648;196;60;51;6;45;.882;3900000;0
12898;-1;192;0;0;0;0;.00nan;0;0
12898;191118;196;0;0;0;0;.00nan;0;0
13162;183695;232;44;34;5;29;.853;3600000;0
13162;179691;232;0;0;0;0;.00nan;0;0
13162;181338;230;0;0;0;0;.00nan;0;0
13162;186495;230;70;19;1;18;.947;3600000;0
12880;190125;184;100;21;0;21;1.000;3600000;0
12880;179668;184;0;0;0;0;.00nan;0;0
12880;-1;220;81;30;1;29;.967;3543000;0
12880;187443;220;0;0;0;0;.00nan;0;0
13010;178394;188;0;0;0;0;.00nan;0;0
13010;184409;188;81;25;1;24;.960;3600000;0
13010;-1;189;89;39;2;37;.949;3519000;0
13010;-1;189;0;0;0;0;.00nan;0;0
12991;194219;4960;0;0;0;0;.00nan;0;0
12991;173219;4960;81;39;4;35;.897;3900000;0
12991;191120;223;0;0;0;0;.00nan;0;0
12991;187118;223;65;41;4;37;.902;3900000;0
12935;201524;205;0;0;0;0;.00nan;0;0
12935;-1;207;46;44;6;38;.864;3600000;0
12935;-1;205;82;27;2;25;.926;3600000;0
12935;-1;207;0;0;0;0;.00nan;0;0
13000;195238;200;0;0;0;0;.00nan;0;0
13000;-1;203;51;18;2;16;.889;3561000;0
13000;-1;203;0;0;0;0;.00nan;0;0
13000;187295;200;83;23;1;22;.957;3600000;0
13140;-1;206;0;0;0;0;.00nan;0;0
13140;185743;201;56;36;4;32;.889;3600000;0
13140;-1;201;0;0;0;0;.00nan;0;0
13140;202998;206;98;26;0;26;1.000;3600000;0
12980;187628;227;81;43;3;40;.930;3546000;0
12980;189773;231;0;0;0;0;.00nan;0;0
12980;-1;227;0;0;0;0;.00nan;0;0
12980;185034;231;73;28;2;26;.929;3600000;0
13229;173549;219;0;0;0;0;.00nan;0;0
13229;181102;219;97;35;1;34;.971;3600000;0
13229;182128;215;42;29;5;24;.828;3600000;0
13229;-1;215;0;0;0;0;.00nan;0;0
13193;194893;191;90;23;1;22;.957;3600000;0
13193;179647;195;69;24;2;22;.917;3600000;0
13193;201892;191;0;0;0;0;.00nan;0;0
13193;191849;195;0;0;0;0;.00nan;0;0
12973;189081;187;0;0;0;0;.00nan;0;0
12973;173900;192;0;0;0;0;.00nan;0;0
12973;-1;192;75;25;1;24;.960;3578000;0
12973;-1;187;90;19;0;19;1.000;3600000;0
13032;184069;208;0;0;0;0;.00nan;0;0
13032;179452;226;0;0;0;0;.00nan;0;0
13032;179702;208;73;46;4;42;.913;3662000;0
13032;192629;226;47;31;5;26;.839;3662000;0
12947;183678;1505;60;39;5;34;.872;3600000;0
12947;-1;216;80;28;2;26;.929;3600000;0
12947;186549;1505;0;0;0;0;.00nan;0;0
12947;187240;216;0;0;0;0;.00nan;0;0
13006;175354;228;0;0;0;0;.00nan;0;0
13006;180377;228;97;40;2;38;.950;3600000;0
13006;185800;229;0;0;0;0;.00nan;0;0
13006;185960;229;65;25;3;22;.880;3555000;0
13292;174325;197;50;8;1;7;.875;610000;0
13292;184788;198;68;24;2;22;.917;3600000;0
13292;201585;197;58;42;6;36;.857;2990000;0
13292;181431;198;0;0;0;0;.00nan;0;0
13105;201495;213;0;0;0;0;.00nan;0;0
13105;192461;210;74;22;2;20;.909;3600000;0
13105;197672;210;0;0;0;0;.00nan;0;0
13105;203029;213;83;42;3;39;.929;3582000;0
13148;182454;4864;0;0;0;0;.00nan;0;0
13148;183737;4864;62;27;3;24;.889;3719000;0
13148;201562;2620;0;0;0;0;.00nan;0;0
13148;-1;2620;60;33;4;29;.879;3719000;0
13060;-1;203;0;0;0;0;.00nan;0;0
13060;189902;204;68;37;4;33;.892;3600000;0
13060;184712;204;0;0;0;0;.00nan;0;0
13060;-1;203;76;27;1;26;.963;3600000;0
12941;182467;185;97;39;1;38;.974;3600000;0
12941;200306;182;66;33;3;30;.909;3516000;0
12941;179388;182;0;0;0;0;.00nan;0;0
12941;-1;185;0;0;0;0;.00nan;0;0
13093;190034;217;0;0;0;0;.00nan;0;0
13093;190041;217;100;32;0;32;1.000;3600000;0
13093;179679;212;0;0;0;0;.00nan;0;0
13093;186641;212;60;28;3;25;.893;3600000;0
13276;194219;4960;13;19;6;13;.684;2223000;0
13276;173219;4960;53;13;1;12;.923;1377000;0
13276;184175;224;91;33;2;31;.939;3600000;0
13276;185840;224;0;0;0;0;.00nan;0;0
13074;174325;197;0;0;0;0;.00nan;0;0
13074;184648;196;68;17;1;16;.941;3600000;0
13074;201585;197;84;41;3;38;.927;3561000;0
13074;191118;196;0;0;0;0;.00nan;0;0
13047;-1;211;99;54;3;51;.944;3600000;0
13047;195164;218;33;15;4;11;.733;3548000;0
13047;190095;218;0;0;0;0;.00nan;0;0
13047;179646;211;0;0;0;0;.00nan;0;0
12995;-1;1371;0;0;0;0;.00nan;0;0
12995;-1;214;80;28;2;26;.929;3600000;0
12995;191518;214;0;0;0;0;.00nan;0;0
12995;192688;1371;56;29;4;25;.862;3600000;0
13321;189885;225;88;67;6;61;.910;3600000;0
13321;181338;230;0;0;0;0;.00nan;0;0
13321;-1;225;0;0;0;0;.00nan;0;0
13321;186495;230;52;12;2;10;.833;3600000;0
13063;192461;210;0;0;0;0;.00nan;0;0
13063;197672;210;61;18;2;16;.889;3590000;0
13063;-1;178;0;0;0;0;.00nan;0;0
13063;-1;178;94;38;1;37;.974;3600000;0
12956;182467;185;0;0;0;0;.00nan;0;0
12956;-1;181;81;36;2;34;.944;3635000;0
12956;-1;185;64;28;3;25;.893;3635000;0
12956;192552;181;0;0;0;0;.00nan;0;0
13231;173549;219;58;28;3;25;.893;3681000;0
13231;169226;186;70;23;2;21;.913;3681000;0
13231;181102;219;0;0;0;0;.00nan;0;0
13231;185778;186;0;0;0;0;.00nan;0;0
13098;189773;231;0;0;0;0;.00nan;0;0
13098;189885;225;74;50;5;45;.900;3600000;0
13098;185034;231;75;28;2;26;.929;3600000;0
13098;-1;225;0;0;0;0;.00nan;0;0
13096;190034;217;56;30;4;26;.867;3600000;0
13096;190041;217;0;0;0;0;.00nan;0;0
13096;179679;212;31;9;3;6;.667;554000;0
13096;186641;212;84;30;2;28;.933;2989000;0
13111;189081;187;0;0;0;0;.00nan;0;0
13111;174325;197;0;0;0;0;.00nan;0;0
13111;201585;197;61;41;6;35;.854;3553000;0
13111;-1;187;36;20;4;16;.800;3600000;0
13197;201524;205;0;0;0;0;.00nan;0;0
13197;-1;205;45;20;3;17;.850;3600000;0
13197;-1;206;0;0;0;0;.00nan;0;0
13197;202998;206;55;40;5;35;.875;3569000;0
13088;184175;224;56;43;5;38;.884;3600000;0
13088;175354;228;88;29;1;28;.966;3600000;0
13088;180377;228;0;0;0;0;.00nan;0;0
13088;185840;224;0;0;0;0;.00nan;0;0
13151;-1;211;88;49;4;45;.918;3818000;0
13151;179646;211;0;0;0;0;.00nan;0;0
13151;182128;215;0;0;0;0;.00nan;0;0
13151;-1;215;62;28;3;25;.893;3818000;0
13179;187628;227;0;0;0;0;.00nan;0;0
13179;-1;227;86;39;2;37;.949;3600000;0
13179;181338;230;0;0;0;0;.00nan;0;0
13179;186495;230;50;20;3;17;.850;3544000;0
12986;173770;193;53;31;4;27;.871;3579000;0
12986;179647;195;91;42;3;39;.929;3600000;0
12986;186451;193;0;0;0;0;.00nan;0;0
12986;191849;195;0;0;0;0;.00nan;0;0
13107;173900;192;0;0;0;0;.00nan;0;0
13107;184788;198;0;0;0;0;.00nan;0;0
13107;-1;192;77;25;1;24;.960;3600000;0
13107;181431;198;36;31;6;25;.806;3600000;0
13084;195238;200;0;0;0;0;.00nan;0;0
13084;185743;201;63;20;2;18;.900;3900000;0
13084;187295;200;71;28;2;26;.929;3897000;0
13084;-1;201;0;0;0;0;.00nan;0;0
13166;179169;209;0;0;0;0;.00nan;0;0
13166;184907;4959;0;0;0;0;.00nan;0;0
13166;186205;209;62;22;2;20;.909;3600000;0
13166;-1;4959;58;38;5;33;.868;3600000;0
13009;-1;203;66;21;2;19;.905;3568000;0
13009;-1;203;0;0;0;0;.00nan;0;0
13009;-1;207;98;45;1;44;.978;3600000;0
13009;-1;207;0;0;0;0;.00nan;0;0
13143;200306;182;0;0;0;0;.00nan;0;0
13143;-1;1371;0;0;0;0;.00nan;0;0
13143;179388;182;80;29;2;27;.931;3514000;0
13143;192688;1371;100;31;0;31;1.000;3600000;0
13109;184069;208;49;29;4;25;.862;3516000;0
13109;175370;199;0;0;0;0;.00nan;0;0
13109;179702;208;0;0;0;0;.00nan;0;0
13109;161006;199;67;26;2;24;.923;3600000;0
13142;170351;194;51;2;0;2;1.000;308000;0
13142;-1;194;35;37;6;31;.838;3210000;0
13142;192547;190;0;0;0;0;.00nan;0;0
13142;197704;190;58;31;4;27;.871;3600000;0
13067;192915;179;0;0;0;0;.00nan;0;0
13067;195251;4949;47;30;4;26;.867;3600000;0
13067;-1;179;55;19;3;16;.842;3600000;0
13067;197685;4949;0;0;0;0;.00nan;0;0
13002;201562;2620;0;0;0;0;.00nan;0;0
13002;176932;176;0;0;0;0;.00nan;0;0
13002;182006;176;89;41;3;38;.927;3552000;0
13002;-1;2620;59;20;2;18;.900;3600000;0
13139;183695;232;0;0;0;0;.00nan;0;0
13139;189885;225;0;0;0;0;.00nan;0;0
13139;179691;232;27;21;5;16;.762;3514000;0
13139;-1;225;100;43;3;40;.930;3600000;0
13086;-1;189;69;34;3;31;.912;3600000;0
13086;184788;198;33;40;7;33;.825;3600000;0
13086;181431;198;0;0;0;0;.00nan;0;0
13086;-1;189;0;0;0;0;.00nan;0;0
12998;189773;231;0;0;0;0;.00nan;0;0
12998;185034;231;37;12;3;9;.750;3600000;0
12998;191120;223;0;0;0;0;.00nan;0;0
12998;187118;223;66;35;4;31;.886;3551000;0
12931;189902;204;72;30;2;28;.933;3581000;0
12931;184712;204;0;0;0;0;.00nan;0;0
12931;-1;207;0;0;0;0;.00nan;0;0
12931;-1;207;85;31;1;30;.968;3600000;0
13222;187628;227;56;28;3;25;.893;3600000;0
13222;-1;227;0;0;0;0;.00nan;0;0
13222;185800;229;0;0;0;0;.00nan;0;0
13222;185960;229;100;36;0;36;1.000;3600000;0
13365;195164;218;82;41;3;38;.927;3900000;0
13365;190095;218;0;0;0;0;.00nan;0;0
13365;-1;180;73;31;3;28;.903;3900000;0
13365;197707;180;0;0;0;0;.00nan;0;0
13062;183678;1505;0;0;0;0;.00nan;0;0
13062;-1;183;0;0;0;0;.00nan;0;0
13062;182089;183;70;31;3;28;.903;3600000;0
13062;186549;1505;37;18;4;14;.778;3573000;0
13075;169226;186;0;0;0;0;.00nan;0;0
13075;179679;212;48;27;4;23;.852;3600000;0
13075;185778;186;95;24;0;24;1.000;3600000;0
13075;186641;212;0;0;0;0;.00nan;0;0
13115;190034;217;0;0;0;0;.00nan;0;0
13115;190041;217;78;29;1;28;.966;3900000;0
13115;182128;215;95;41;1;40;.976;3900000;0
13115;-1;215;0;0;0;0;.00nan;0;0
12951;195238;200;51;29;4;25;.862;3600000;0
12951;201560;202;86;36;1;35;.972;3600000;0
12951;196299;202;0;0;0;0;.00nan;0;0
12951;187295;200;0;0;0;0;.00nan;0;0
13138;192915;179;100;33;0;33;1.000;3600000;0
13138;-1;179;0;0;0;0;.00nan;0;0
13138;192461;210;42;28;5;23;.821;2377000;0
13138;197672;210;59;11;1;10;.909;1223000;0
13013;184175;224;0;0;0;0;.00nan;0;0
13013;175354;228;42;26;4;22;.846;3566000;0
13013;180377;228;0;0;0;0;.00nan;0;0
13013;185840;224;76;30;2;28;.933;3600000;0
13100;200452;221;0;0;0;0;.00nan;0;0
13100;184610;222;67;34;3;31;.912;3527000;0
13100;185851;222;0;0;0;0;.00nan;0;0
13100;187362;221;98;37;1;36;.973;3600000;0
13028;178394;188;87;45;4;41;.911;3900000;0
13028;173900;192;64;37;4;33;.892;3900000;0
13028;184409;188;0;0;0;0;.00nan;0;0
13028;-1;192;0;0;0;0;.00nan;0;0
13177;-1;1371;0;0;0;0;.00nan;0;0
13177;-1;214;83;30;1;29;.967;3600000;0
13177;191518;214;0;0;0;0;.00nan;0;0
13177;192688;1371;90;36;2;34;.944;3600000;0
13184;-1;211;52;41;5;36;.878;3515000;0
13184;173549;219;0;0;0;0;.00nan;0;0
13184;179646;211;0;0;0;0;.00nan;0;0
13184;181102;219;71;34;3;31;.912;3600000;0
13110;195251;4949;0;0;0;0;.00nan;0;0
13110;-1;216;100;39;0;39;1.000;3600000;0
13110;187240;216;0;0;0;0;.00nan;0;0
13110;197685;4949;48;33;4;29;.879;3600000;0
13185;184648;196;72;29;2;27;.931;3600000;0
13185;191118;196;0;0;0;0;.00nan;0;0
13185;192547;190;50;36;5;31;.861;3600000;0
13185;197704;190;0;0;0;0;.00nan;0;0
13191;194893;191;100;27;0;27;1.000;3600000;0
13191;173770;193;0;0;0;0;.00nan;0;0
13191;201892;191;0;0;0;0;.00nan;0;0
13191;186451;193;54;32;4;28;.875;3600000;0
13127;182454;4864;0;0;0;0;.00nan;0;0
13127;183737;4864;46;36;6;30;.833;3600000;0
13127;184907;4959;17;22;6;16;.727;2729000;0
13127;-1;4959;43;5;1;4;.800;857000;0
12964;182467;185;51;29;4;25;.862;2146000;0
12964;200306;182;100;30;0;30;1.000;3600000;0
12964;179388;182;0;0;0;0;.00nan;0;0
12964;-1;185;47;13;2;11;.846;1454000;0
13262;196571;177;73;27;2;25;.926;3600000;0
13262;-1;178;57;38;5;33;.868;3600000;0
13262;-1;178;0;0;0;0;.00nan;0;0
13262;-1;177;0;0;0;0;.00nan;0;0
12916;190125;184;47;27;4;23;.852;3547000;0
12916;179668;184;0;0;0;0;.00nan;0;0
12916;-1;220;0;0;0;0;.00nan;0;0
12916;187443;220;87;40;2;38;.950;3600000;0
13027;184069;208;0;0;0;0;.00nan;0;0
13027;175370;199;72;23;1;22;.957;3600000;0
13027;179702;208;47;26;4;22;.846;3600000;0
13027;161006;199;0;0;0;0;.00nan;0;0
13042;201562;2620;49;24;4;20;.833;3900000;0
13042;176932;176;66;40;4;36;.900;3900000;0
13042;182006;176;0;0;0;0;.00nan;0;0
13042;-1;2620;0;0;0;0;.00nan;0;0
13053;189081;187;62;31;3;28;.903;3600000;0
13053;178394;188;60;30;4;26;.867;2513000;0
13053;184409;188;22;9;4;5;.556;1087000;0
13053;-1;187;0;0;0;0;.00nan;0;0
13212;194219;4960;0;0;0;0;.00nan;0;0
13212;173219;4960;42;36;5;31;.861;3587000;0
13212;185800;229;42;23;4;19;.826;3600000;0
13212;185960;229;0;0;0;0;.00nan;0;0
13233;174325;197;45;31;5;26;.839;3563000;0
13233;-1;189;0;0;0;0;.00nan;0;0
13233;201585;197;0;0;0;0;.00nan;0;0
13233;-1;189;70;30;3;27;.900;3600000;0
13058;183678;1505;0;0;0;0;.00nan;0;0
13058;-1;216;54;18;2;16;.889;3600000;0
13058;186549;1505;36;28;5;23;.821;3600000;0
13058;187240;216;0;0;0;0;.00nan;0;0
13281;181338;230;0;0;0;0;.00nan;0;0
13281;186495;230;46;19;4;15;.789;3743000;0
13281;191120;223;0;0;0;0;.00nan;0;0
13281;187118;223;93;49;3;46;.939;3748000;0
13261;179679;212;0;0;0;0;.00nan;0;0
13261;182128;215;0;0;0;0;.00nan;0;0
13261;186641;212;59;21;2;19;.905;3600000;0
13261;-1;215;47;30;5;25;.833;3600000;0
12996;-1;1371;0;0;0;0;.00nan;0;0
12996;-1;220;0;0;0;0;.00nan;0;0
12996;187443;220;97;31;1;30;.968;3900000;0
12996;192688;1371;98;40;1;39;.975;3900000;0
12958;182467;185;74;38;4;34;.895;3600000;0
12958;190125;184;56;24;3;21;.875;3600000;0
12958;179668;184;0;0;0;0;.00nan;0;0
12958;-1;185;0;0;0;0;.00nan;0;0
13108;194893;191;66;23;2;21;.913;3600000;0
13108;173900;192;0;0;0;0;.00nan;0;0
13108;-1;192;97;64;3;61;.953;3600000;0
13108;201892;191;0;0;0;0;.00nan;0;0
13106;-1;183;57;32;4;28;.875;3600000;0
13106;182089;183;0;0;0;0;.00nan;0;0
13106;192461;210;80;26;1;25;.962;3600000;0
13106;197672;210;0;0;0;0;.00nan;0;0
13022;179452;226;0;0;0;0;.00nan;0;0
13022;201560;202;50;25;4;21;.840;3900000;0
13022;196299;202;0;0;0;0;.00nan;0;0
13022;192629;226;66;40;4;36;.900;3900000;0
13071;183695;232;19;10;4;6;.600;1104000;0
13071;175354;228;0;0;0;0;.00nan;0;0
13071;179691;232;48;14;2;12;.857;2496000;0
13071;180377;228;84;29;2;27;.931;3600000;0
13208;192915;179;73;24;1;23;.958;3600000;0
13208;196571;177;90;35;2;33;.943;3600000;0
13208;-1;179;0;0;0;0;.00nan;0;0
13208;-1;177;0;0;0;0;.00nan;0;0
13155;173549;219;34;28;5;23;.821;3519000;0
13155;190034;217;73;34;3;31;.912;3600000;0
13155;190041;217;0;0;0;0;.00nan;0;0
13155;181102;219;0;0;0;0;.00nan;0;0
13037;189902;204;52;29;4;25;.862;3600000;0
13037;184712;204;0;0;0;0;.00nan;0;0
13037;201524;205;45;23;3;20;.870;3277000;0
13037;-1;205;22;4;3;1;.250;238000;0
13035;195238;200;0;0;0;0;.00nan;0;0
13035;-1;203;63;43;6;37;.860;3312000;0
13035;-1;203;49;1;0;1;1.000;288000;0
13035;187295;200;89;29;1;28;.966;3600000;0
13077;200452;221;0;0;0;0;.00nan;0;0
13077;189773;231;0;0;0;0;.00nan;0;0
13077;185034;231;55;13;2;11;.846;3600000;0
13077;187362;221;77;47;5;42;.894;3600000;0
12906;-1;181;69;30;3;27;.900;3565000;0
12906;-1;214;0;0;0;0;.00nan;0;0
12906;191518;214;62;19;2;17;.895;3600000;0
12906;192552;181;0;0;0;0;.00nan;0;0
13186;187628;227;0;0;0;0;.00nan;0;0
13186;-1;227;43;33;5;28;.848;3900000;0
13186;184610;222;43;29;5;24;.828;3900000;0
13186;185851;222;0;0;0;0;.00nan;0;0
13205;-1;211;74;47;5;42;.894;3600000;0
13205;179646;211;0;0;0;0;.00nan;0;0
13205;-1;180;0;0;0;0;.00nan;0;0
13205;197707;180;60;20;2;18;.900;3600000;0
13327;174325;197;0;0;0;0;.00nan;0;0
13327;201585;197;83;50;4;46;.920;3600000;0
13327;179647;195;98;22;0;22;1.000;3600000;0
13327;191849;195;0;0;0;0;.00nan;0;0
13303;184648;196;62;21;2;19;.905;3600000;0
13303;191118;196;0;0;0;0;.00nan;0;0
13303;192547;190;36;24;5;19;.792;3004000;0
13303;197704;190;31;9;3;6;.667;596000;0
13041;182454;4864;0;0;0;0;.00nan;0;0
13041;183737;4864;84;41;3;38;.927;3900000;0
13041;176932;176;0;0;0;0;.00nan;0;0
13041;182006;176;74;31;3;28;.903;3900000;0
13081;182467;185;50;1;0;1;1.000;258000;0
13081;-1;220;92;20;0;20;1.000;3600000;0
13081;187443;220;0;0;0;0;.00nan;0;0
13081;-1;185;39;28;6;22;.786;3342000;0
13135;179169;209;0;0;0;0;.00nan;0;0
13135;184907;4959;0;0;0;0;.00nan;0;0
13135;186205;209;72;16;1;15;.938;3600000;0
13135;-1;4959;68;22;2;20;.909;3587000;0
13161;184069;208;77;37;3;34;.919;3564000;0
13161;-1;203;0;0;0;0;.00nan;0;0
13161;179702;208;0;0;0;0;.00nan;0;0
13161;-1;203;100;44;1;43;.977;3600000;0
13325;195238;200;0;0;0;0;.00nan;0;0
13325;175370;199;59;19;2;17;.895;3600000;0
13325;187295;200;83;57;6;51;.895;3600000;0
13325;161006;199;0;0;0;0;.00nan;0;0
13255;194219;4960;49;13;2;11;.846;3587000;0
13255;173219;4960;0;0;0;0;.00nan;0;0
13255;184610;222;0;0;0;0;.00nan;0;0
13255;185851;222;98;48;1;47;.979;3600000;0
13157;194893;191;54;17;2;15;.882;3600000;0
13157;-1;189;80;52;6;46;.885;3600000;0
13157;201892;191;0;0;0;0;.00nan;0;0
13157;-1;189;0;0;0;0;.00nan;0;0
13156;200452;221;38;22;4;18;.818;3600000;0
13156;189885;225;76;24;1;23;.958;3600000;0
13156;-1;225;0;0;0;0;.00nan;0;0
13156;187362;221;0;0;0;0;.00nan;0;0
13119;181338;230;67;21;2;19;.905;3600000;0
13119;186495;230;0;0;0;0;.00nan;0;0
13119;191120;223;87;48;4;44;.917;3521000;0
13119;187118;223;0;0;0;0;.00nan;0;0
13577;195164;218;79;35;3;32;.914;3600000;0
13577;190095;218;0;0;0;0;.00nan;0;0
13577;182128;215;20;24;6;18;.750;3006000;0
13577;-1;215;58;5;0;5;1.000;594000;0
13279;170351;194;46;39;6;33;.846;3600000;0
13279;179647;195;68;17;1;16;.941;3600000;0
13279;-1;194;0;0;0;0;.00nan;0;0
13279;191849;195;0;0;0;0;.00nan;0;0
13199;-1;183;52;2;0;2;1.000;431000;0
13199;196571;177;0;0;0;0;.00nan;0;0
13199;182089;183;24;38;8;30;.789;3169000;0
13199;-1;177;87;30;1;29;.967;3600000;0
12977;179452;226;67;19;1;18;.947;3600000;0
12977;-1;207;60;28;3;25;.893;3543000;0
12977;-1;207;0;0;0;0;.00nan;0;0
12977;192629;226;0;0;0;0;.00nan;0;0
13112;189081;187;73;26;2;24;.923;3900000;0
13112;184788;198;0;0;0;0;.00nan;0;0
13112;181431;198;89;43;2;41;.953;3900000;0
13112;-1;187;0;0;0;0;.00nan;0;0
13438;169226;186;0;0;0;0;.00nan;0;0
13438;185778;186;76;25;1;24;.960;3600000;0
13438;-1;180;58;36;4;32;.889;3600000;0
13438;197707;180;0;0;0;0;.00nan;0;0
13061;183678;1505;0;0;0;0;.00nan;0;0
13061;186549;1505;61;33;4;29;.879;3600000;0
13061;-1;178;0;0;0;0;.00nan;0;0
13061;-1;178;100;27;0;27;1.000;3600000;0
13564;-1;206;70;27;3;24;.889;3900000;0
13564;185743;201;78;29;3;26;.897;3900000;0
13564;-1;201;0;0;0;0;.00nan;0;0
13564;202998;206;0;0;0;0;.00nan;0;0
13089;189902;204;92;29;1;28;.966;3600000;0
13089;184712;204;0;0;0;0;.00nan;0;0
13089;201524;205;0;0;0;0;.00nan;0;0
13089;-1;205;61;27;3;24;.889;3519000;0
13207;-1;216;65;25;3;22;.880;3600000;0
13207;187240;216;0;0;0;0;.00nan;0;0
13207;-1;178;28;36;6;30;.833;3217000;0
13207;-1;178;49;2;0;2;1.000;383000;0
13085;182454;4864;72;33;4;29;.879;3600000;0
13085;183737;4864;0;0;0;0;.00nan;0;0
13085;201562;2620;0;0;0;0;.00nan;0;0
13085;-1;2620;90;30;1;29;.967;3600000;0
13123;195251;4949;83;28;2;26;.929;3600000;0
13123;192461;210;76;31;3;28;.903;3577000;0
13123;197672;210;0;0;0;0;.00nan;0;0
13123;197685;4949;0;0;0;0;.00nan;0;0
13195;-1;181;83;23;1;22;.957;3600000;0
13195;-1;214;44;32;5;27;.844;3600000;0
13195;191518;214;0;0;0;0;.00nan;0;0
13195;192552;181;0;0;0;0;.00nan;0;0
13181;201560;202;51;25;3;22;.880;3889000;0
13181;196299;202;0;0;0;0;.00nan;0;0
13181;185743;201;91;41;2;39;.951;3889000;0
13181;-1;201;0;0;0;0;.00nan;0;0
13414;194219;4960;0;0;0;0;.00nan;0;0
13414;173219;4960;100;31;0;31;1.000;3600000;0
13414;185800;229;0;0;0;0;.00nan;0;0
13414;185960;229;80;39;3;36;.923;3600000;0
13064;178394;188;63;29;3;26;.897;3600000;0
13064;173770;193;0;0;0;0;.00nan;0;0
13064;184409;188;0;0;0;0;.00nan;0;0
13064;186451;193;94;20;0;20;1.000;3600000;0
13202;175370;199;0;0;0;0;.00nan;0;0
13202;179452;226;0;0;0;0;.00nan;0;0
13202;192629;226;65;22;3;19;.864;3712000;0
13202;161006;199;91;40;2;38;.950;3712000;0
13026;190125;184;53;32;4;28;.875;3697000;0
13026;179668;184;0;0;0;0;.00nan;0;0
13026;-1;181;0;0;0;0;.00nan;0;0
13026;192552;181;73;31;3;28;.903;3697000;0
13379;169226;186;80;27;1;26;.963;3600000;0
13379;179679;212;0;0;0;0;.00nan;0;0
13379;185778;186;0;0;0;0;.00nan;0;0
13379;186641;212;86;35;2;33;.943;3586000;0
13311;184175;224;90;32;2;30;.938;3600000;0
13311;185840;224;0;0;0;0;.00nan;0;0
13311;191120;223;0;0;0;0;.00nan;0;0
13311;187118;223;71;29;3;26;.897;3566000;0
13463;182454;4864;0;0;0;0;.00nan;0;0
13463;183737;4864;80;44;3;41;.932;3600000;0
13463;184907;4959;0;0;0;0;.00nan;0;0
13463;-1;4959;72;19;1;18;.947;3600000;0
13384;173549;219;0;0;0;0;.00nan;0;0
13384;195164;218;0;0;0;0;.00nan;0;0
13384;190095;218;64;25;2;23;.920;3600000;0
13384;181102;219;72;38;4;34;.895;3578000;0
13046;190125;184;92;22;0;22;1.000;3600000;0
13046;179668;184;0;0;0;0;.00nan;0;0
13046;-1;214;0;0;0;0;.00nan;0;0
13046;191518;214;64;24;2;22;.917;3600000;0
13038;182467;185;83;32;1;31;.969;3600000;0
13038;-1;220;99;27;0;27;1.000;3600000;0
13038;187443;220;0;0;0;0;.00nan;0;0
13038;-1;185;0;0;0;0;.00nan;0;0
13083;179169;209;0;0;0;0;.00nan;0;0
13083;176932;176;0;0;0;0;.00nan;0;0
13083;182006;176;63;19;2;17;.895;3900000;0
13083;186205;209;78;37;2;35;.946;3900000;0
13120;200452;221;0;0;0;0;.00nan;0;0
13120;181338;230;0;0;0;0;.00nan;0;0
13120;186495;230;72;19;1;18;.947;3600000;0
13120;187362;221;86;51;4;47;.922;3600000;0
13203;-1;183;0;0;0;0;.00nan;0;0
13203;182089;183;88;47;2;45;.957;3541000;0
13203;-1;178;0;0;0;0;.00nan;0;0
13203;-1;178;76;26;1;25;.962;3600000;0
13215;-1;211;89;49;3;46;.939;3578000;0
13215;179646;211;0;0;0;0;.00nan;0;0
13215;182128;215;0;0;0;0;.00nan;0;0
13215;-1;215;70;24;2;22;.917;3600000;0
13194;189081;187;26;13;4;9;.692;3600000;0
13194;174325;197;0;0;0;0;.00nan;0;0
13194;201585;197;56;50;7;43;.860;3600000;0
13194;-1;187;0;0;0;0;.00nan;0;0
13169;201495;213;41;22;4;18;.818;2102000;0
13169;192461;210;75;19;1;18;.947;3600000;0
13169;197672;210;0;0;0;0;.00nan;0;0
13169;203029;213;61;18;1;17;.944;1498000;0
13154;183678;1505;0;0;0;0;.00nan;0;0
13154;196571;177;79;46;4;42;.913;3600000;0
13154;186549;1505;93;20;0;20;1.000;3600000;0
13154;-1;177;0;0;0;0;.00nan;0;0
13159;184069;208;52;35;5;30;.857;3600000;0
13159;179702;208;0;0;0;0;.00nan;0;0
13159;-1;207;94;36;1;35;.972;3600000;0
13159;-1;207;0;0;0;0;.00nan;0;0
13158;189902;204;44;28;5;23;.821;3900000;0
13158;184712;204;0;0;0;0;.00nan;0;0
13158;201524;205;47;29;5;24;.828;3900000;0
13158;-1;205;0;0;0;0;.00nan;0;0
13275;173770;193;0;0;0;0;.00nan;0;0
13275;170351;194;76;44;4;40;.909;3600000;0
13275;-1;194;0;0;0;0;.00nan;0;0
13275;186451;193;65;14;1;13;.929;3600000;0
13267;175370;199;92;35;2;33;.943;3900000;0
13267;201560;202;68;30;2;28;.933;3900000;0
13267;196299;202;0;0;0;0;.00nan;0;0
13267;161006;199;0;0;0;0;.00nan;0;0
13418;194219;4960;64;24;2;22;.917;3556000;0
13418;173219;4960;0;0;0;0;.00nan;0;0
13418;184175;224;90;28;1;27;.964;3600000;0
13418;185840;224;0;0;0;0;.00nan;0;0
13171;183695;232;53;33;4;29;.879;3900000;0
13171;200452;221;66;42;4;38;.905;3900000;0
13171;179691;232;0;0;0;0;.00nan;0;0
13171;187362;221;0;0;0;0;.00nan;0;0
13304;189081;187;0;0;0;0;.00nan;0;0
13304;170351;194;0;0;0;0;.00nan;0;0
13304;-1;194;77;50;4;46;.920;3533000;0
13304;-1;187;58;19;2;17;.895;3600000;0
13069;201562;2620;0;0;0;0;.00nan;0;0
13069;176932;176;74;41;3;38;.927;3900000;0
13069;182006;176;0;0;0;0;.00nan;0;0
13069;-1;2620;53;19;3;16;.842;3900000;0
13160;182454;4864;64;35;4;31;.886;3580000;0
13160;183737;4864;0;0;0;0;.00nan;0;0
13160;179169;209;0;0;0;0;.00nan;0;0
13160;186205;209;53;21;3;18;.857;3600000;0
13165;-1;203;100;41;1;40;.976;3900000;0
13165;179452;226;0;0;0;0;.00nan;0;0
13165;-1;203;0;0;0;0;.00nan;0;0
13165;192629;226;81;29;1;28;.966;3900000;0
13170;187628;227;0;0;0;0;.00nan;0;0
13170;-1;227;52;35;5;30;.857;3639000;0
13170;175354;228;56;31;4;27;.871;3640000;0
13170;180377;228;0;0;0;0;.00nan;0;0
13167;190034;217;22;4;3;1;.250;396000;0
13167;190041;217;53;32;5;27;.844;3204000;0
13167;-1;180;59;25;3;22;.880;3600000;0
13167;197707;180;0;0;0;0;.00nan;0;0
13386;173549;219;43;32;5;27;.844;3597000;0
13386;179679;212;53;29;4;25;.862;3600000;0
13386;181102;219;0;0;0;0;.00nan;0;0
13386;186641;212;0;0;0;0;.00nan;0;0
13259;192915;179;0;0;0;0;.00nan;0;0
13259;-1;179;64;18;1;17;.944;3600000;0
13259;-1;178;67;40;4;36;.900;3600000;0
13259;-1;178;0;0;0;0;.00nan;0;0
13036;-1;207;0;0;0;0;.00nan;0;0
13036;185743;201;52;23;3;20;.870;3900000;0
13036;-1;207;100;50;3;47;.940;3900000;0
13036;-1;201;0;0;0;0;.00nan;0;0
13090;200306;182;52;31;4;27;.871;3568000;0
13090;179388;182;0;0;0;0;.00nan;0;0
13090;-1;220;77;30;2;28;.933;3600000;0
13090;187443;220;0;0;0;0;.00nan;0;0
13117;173900;192;0;0;0;0;.00nan;0;0
13117;184648;196;0;0;0;0;.00nan;0;0
13117;-1;192;56;23;3;20;.870;3900000;0
13117;191118;196;88;47;3;44;.936;3896000;0
13124;178394;188;0;0;0;0;.00nan;0;0
13124;184409;188;51;28;4;24;.857;3527000;0
13124;179647;195;0;0;0;0;.00nan;0;0
13124;191849;195;80;32;2;30;.938;3600000;0
13223;189885;225;85;39;2;37;.949;3600000;0
13223;-1;225;0;0;0;0;.00nan;0;0
13223;185800;229;0;0;0;0;.00nan;0;0
13223;185960;229;51;32;4;28;.875;3522000;0
13227;195238;200;0;0;0;0;.00nan;0;0
13227;201560;202;0;0;0;0;.00nan;0;0
13227;196299;202;84;31;2;29;.935;3900000;0
13227;187295;200;88;33;2;31;.939;3900000;0
13225;194893;191;55;17;2;15;.882;3900000;0
13225;201892;191;0;0;0;0;.00nan;0;0
13225;192547;190;100;54;2;52;.963;3900000;0
13225;197704;190;0;0;0;0;.00nan;0;0
13295;195164;218;74;22;1;21;.955;3600000;0
13295;190095;218;0;0;0;0;.00nan;0;0
13295;182128;215;79;44;3;41;.932;3600000;0
13295;-1;215;0;0;0;0;.00nan;0;0
13285;174325;197;57;48;6;42;.875;3600000;0
13285;184788;198;0;0;0;0;.00nan;0;0
13285;201585;197;0;0;0;0;.00nan;0;0
13285;181431;198;31;15;4;11;.733;3600000;0
13149;196571;177;0;0;0;0;.00nan;0;0
13149;192461;210;43;27;4;23;.852;3600000;0
13149;197672;210;0;0;0;0;.00nan;0;0
13149;-1;177;92;34;1;33;.971;3600000;0
13121;195251;4949;88;28;1;27;.964;3600000;0
13121;-1;216;0;0;0;0;.00nan;0;0
13121;187240;216;58;42;5;37;.881;3600000;0
13121;197685;4949;0;0;0;0;.00nan;0;0
13188;183678;1505;0;0;0;0;.00nan;0;0
13188;201495;213;88;31;1;30;.968;3560000;0
13188;186549;1505;96;28;0;28;1.000;3600000;0
13188;203029;213;0;0;0;0;.00nan;0;0
13260;179452;226;52;31;5;26;.839;3600000;0
13260;201524;205;0;0;0;0;.00nan;0;0
13260;-1;205;85;35;2;33;.943;3600000;0
13260;192629;226;0;0;0;0;.00nan;0;0
13141;182467;185;83;33;1;32;.970;3600000;0
13141;-1;181;72;43;3;40;.930;3563000;0
13141;-1;185;0;0;0;0;.00nan;0;0
13141;192552;181;0;0;0;0;.00nan;0;0
13146;189902;204;0;0;0;0;.00nan;0;0
13146;184712;204;75;28;2;26;.929;3600000;0
13146;-1;206;0;0;0;0;.00nan;0;0
13146;202998;206;60;31;3;28;.903;3600000;0
13228;194893;191;0;0;0;0;.00nan;0;0
13228;201892;191;59;11;1;10;.909;3600000;0
13228;192547;190;0;0;0;0;.00nan;0;0
13228;197704;190;98;67;5;62;.925;3600000;0
13232;178394;188;77;24;1;23;.958;3600000;0
13232;184409;188;0;0;0;0;.00nan;0;0
13232;-1;189;66;27;2;25;.926;3567000;0
13232;-1;189;0;0;0;0;.00nan;0;0
13192;184610;222;82;31;1;30;.968;3600000;0
13192;175354;228;0;0;0;0;.00nan;0;0
13192;180377;228;55;23;2;21;.913;3590000;0
13192;185851;222;0;0;0;0;.00nan;0;0
13200;190034;217;91;46;3;43;.935;3573000;0
13200;190041;217;0;0;0;0;.00nan;0;0
13200;-1;180;0;0;0;0;.00nan;0;0
13200;197707;180;67;21;2;19;.905;3600000;0
13178;184069;208;0;0;0;0;.00nan;0;0
13178;-1;203;77;26;2;24;.923;1939000;0
13178;179702;208;56;33;4;29;.879;3600000;0
13178;-1;203;14;17;6;11;.647;1661000;0
13168;189773;231;0;0;0;0;.00nan;0;0
13168;185034;231;59;17;2;15;.882;3600000;0
13168;185800;229;97;56;3;53;.946;3600000;0
13168;185960;229;0;0;0;0;.00nan;0;0
13336;-1;189;0;0;0;0;.00nan;0;0
13336;184648;196;95;41;2;39;.951;3900000;0
13336;191118;196;0;0;0;0;.00nan;0;0
13336;-1;189;58;22;2;20;.909;3900000;0
13546;169226;186;71;26;1;25;.962;3600000;0
13546;195164;218;64;40;4;36;.900;3600000;0
13546;190095;218;0;0;0;0;.00nan;0;0
13546;185778;186;0;0;0;0;.00nan;0;0
13417;194219;4960;0;0;0;0;.00nan;0;0
13417;173219;4960;62;32;4;28;.875;3600000;0
13417;184175;224;91;36;1;35;.972;3600000;0
13417;185840;224;0;0;0;0;.00nan;0;0
13430;173770;193;0;0;0;0;.00nan;0;0
13430;179647;195;46;31;5;26;.839;3600000;0
13430;186451;193;63;27;3;24;.889;3600000;0
13430;191849;195;0;0;0;0;.00nan;0;0
13044;-1;207;40;16;3;13;.813;589000;0
13044;-1;206;51;19;3;16;.842;3600000;0
13044;-1;207;65;18;1;17;.944;3011000;0
13044;202998;206;0;0;0;0;.00nan;0;0
13095;195238;200;0;0;0;0;.00nan;0;0
13095;185743;201;65;21;2;19;.905;3600000;0
13095;187295;200;86;48;4;44;.917;3529000;0
13095;-1;201;0;0;0;0;.00nan;0;0
13129;173900;192;69;16;1;15;.938;3600000;0
13129;170351;194;71;33;3;30;.909;3518000;0
13129;-1;192;0;0;0;0;.00nan;0;0
13129;-1;194;0;0;0;0;.00nan;0;0
13128;200306;182;0;0;0;0;.00nan;0;0
13128;179388;182;51;29;4;25;.862;3900000;0
13128;190125;184;70;43;4;39;.907;3900000;0
13128;179668;184;0;0;0;0;.00nan;0;0
13216;189081;187;90;34;1;33;.971;3600000;0
13216;174325;197;0;0;0;0;.00nan;0;0
13216;201585;197;84;35;2;33;.943;3570000;0
13216;-1;187;0;0;0;0;.00nan;0;0
13300;179679;212;0;0;0;0;.00nan;0;0
13300;182128;215;0;0;0;0;.00nan;0;0
13300;186641;212;76;24;2;22;.917;3578000;0
13300;-1;215;99;41;1;40;.976;3600000;0
13189;183678;1505;0;0;0;0;.00nan;0;0
13189;186549;1505;34;31;5;26;.839;3600000;0
13189;192461;210;93;22;0;22;1.000;3600000;0
13189;197672;210;0;0;0;0;.00nan;0;0
13176;179169;209;0;0;0;0;.00nan;0;0
13176;201562;2620;0;0;0;0;.00nan;0;0
13176;-1;2620;70;36;4;32;.889;3600000;0
13176;186205;209;57;39;5;34;.872;3565000;0
13221;195251;4949;50;25;3;22;.880;3600000;0
13221;-1;183;0;0;0;0;.00nan;0;0
13221;182089;183;50;35;5;30;.857;3553000;0
13221;197685;4949;0;0;0;0;.00nan;0;0
13286;-1;216;43;23;4;19;.826;3545000;0
13286;187240;216;0;0;0;0;.00nan;0;0
13286;-1;178;0;0;0;0;.00nan;0;0
13286;-1;178;78;33;3;30;.909;3600000;0
13102;-1;181;0;0;0;0;.00nan;0;0
13102;-1;220;0;0;0;0;.00nan;0;0
13102;187443;220;77;24;2;22;.917;3900000;0
13102;192552;181;82;38;2;36;.947;3900000;0
13291;187628;227;0;0;0;0;.00nan;0;0
13291;-1;227;70;39;3;36;.923;3900000;0
13291;189885;225;91;39;3;36;.923;3900000;0
13291;-1;225;0;0;0;0;.00nan;0;0
13271;-1;1371;0;0;0;0;.00nan;0;0
13271;-1;214;92;43;2;41;.953;3900000;0
13271;191518;214;0;0;0;0;.00nan;0;0
13271;192688;1371;62;19;2;17;.895;3900000;0
13224;201495;213;68;23;2;21;.913;3600000;0
13224;-1;183;71;33;3;30;.909;3600000;0
13224;182089;183;0;0;0;0;.00nan;0;0
13224;203029;213;0;0;0;0;.00nan;0;0
13237;184788;198;0;0;0;0;.00nan;0;0
13237;181431;198;41;26;4;22;.846;3600000;0
13237;192547;190;52;42;5;37;.881;3579000;0
13237;197704;190;0;0;0;0;.00nan;0;0
13226;182467;185;0;0;0;0;.00nan;0;0
13226;200306;182;66;30;2;28;.933;3890000;0
13226;179388;182;0;0;0;0;.00nan;0;0
13226;-1;185;77;25;2;23;.920;3900000;0
13245;173549;219;0;0;0;0;.00nan;0;0
13245;181102;219;66;34;3;31;.912;3592000;0
13245;-1;180;77;35;2;33;.943;3600000;0
13245;197707;180;0;0;0;0;.00nan;0;0
13253;-1;203;46;34;5;29;.853;3543000;0
13253;179452;226;0;0;0;0;.00nan;0;0
13253;-1;203;0;0;0;0;.00nan;0;0
13253;192629;226;52;29;4;25;.862;3600000;0
13249;201524;205;0;0;0;0;.00nan;0;0
13249;-1;205;51;22;3;19;.864;3600000;0
13249;185743;201;54;34;5;29;.853;3555000;0
13249;-1;201;0;0;0;0;.00nan;0;0
13453;-1;216;0;0;0;0;.00nan;0;0
13453;196571;177;69;27;2;25;.926;3551000;0
13453;187240;216;73;25;1;24;.960;3600000;0
13453;-1;177;0;0;0;0;.00nan;0;0
13254;189885;225;0;0;0;0;.00nan;0;0
13254;184610;222;73;27;2;25;.926;3600000;0
13254;-1;225;67;39;4;35;.897;3576000;0
13254;185851;222;0;0;0;0;.00nan;0;0
13474;178394;188;88;14;0;14;1.000;3600000;0
13474;184409;188;0;0;0;0;.00nan;0;0
13474;184648;196;0;0;0;0;.00nan;0;0
13474;191118;196;71;44;4;40;.909;3600000;0
13317;190125;184;0;0;0;0;.00nan;0;0
13317;179668;184;77;19;1;18;.947;3600000;0
13317;-1;214;65;10;0;10;1.000;1069000;0
13317;191518;214;20;28;6;22;.786;2531000;0
13118;194219;4960;34;19;4;15;.789;892000;0
13118;173219;4960;100;33;0;33;1.000;2708000;0
13118;189773;231;68;9;0;9;1.000;1172000;0
13118;185034;231;26;19;5;14;.737;2386000;0
13174;195238;200;100;50;3;47;.940;3600000;0
13174;201560;202;58;33;4;29;.879;3588000;0
13174;196299;202;0;0;0;0;.00nan;0;0
13174;187295;200;0;0;0;0;.00nan;0;0
13099;176932;176;0;0;0;0;.00nan;0;0
13099;184907;4959;0;0;0;0;.00nan;0;0
13099;182006;176;67;31;4;27;.871;3600000;0
13099;-1;4959;100;28;0;28;1.000;3600000;0
13346;187628;227;77;47;4;43;.915;3549000;0
13346;-1;227;0;0;0;0;.00nan;0;0
13346;181338;230;0;0;0;0;.00nan;0;0
13346;186495;230;66;19;2;17;.895;3600000;0
13335;185800;229;76;32;2;30;.938;3778000;0
13335;185960;229;0;0;0;0;.00nan;0;0
13335;191120;223;0;0;0;0;.00nan;0;0
13335;187118;223;92;37;1;36;.973;3778000;0
13257;189902;204;63;22;2;20;.909;3600000;0
13257;184712;204;0;0;0;0;.00nan;0;0
13257;-1;206;0;0;0;0;.00nan;0;0
13257;202998;206;64;32;3;29;.906;3588000;0
13258;194893;191;65;26;2;24;.923;3600000;0
13258;184788;198;79;44;4;40;.909;3584000;0
13258;201892;191;0;0;0;0;.00nan;0;0
13258;181431;198;0;0;0;0;.00nan;0;0
13371;-1;1371;0;0;0;0;.00nan;0;0
13371;-1;181;71;41;4;37;.902;3554000;0
13371;192552;181;0;0;0;0;.00nan;0;0
13371;192688;1371;79;28;2;26;.929;3600000;0
13473;184069;208;0;0;0;0;.00nan;0;0
13473;175370;199;0;0;0;0;.00nan;0;0
13473;179702;208;59;33;4;29;.879;3583000;0
13473;161006;199;65;29;3;26;.897;3600000;0
13348;184610;222;0;0;0;0;.00nan;0;0
13348;181338;230;0;0;0;0;.00nan;0;0
13348;185851;222;93;43;2;41;.953;3600000;0
13348;186495;230;41;27;5;22;.815;3600000;0
13236;201562;2620;0;0;0;0;.00nan;0;0
13236;184907;4959;0;0;0;0;.00nan;0;0
13236;-1;2620;35;33;6;27;.818;3600000;0
13236;-1;4959;96;23;0;23;1.000;3600000;0
13296;192915;179;0;0;0;0;.00nan;0;0
13296;195251;4949;74;26;2;24;.923;3600000;0
13296;-1;179;43;26;4;22;.846;3566000;0
13296;197685;4949;0;0;0;0;.00nan;0;0
13206;200452;221;0;0;0;0;.00nan;0;0
13206;189773;231;0;0;0;0;.00nan;0;0
13206;185034;231;95;22;0;22;1.000;3600000;0
13206;187362;221;89;47;4;43;.915;3600000;0
13204;173770;193;62;21;2;19;.905;3600000;0
13204;173900;192;0;0;0;0;.00nan;0;0
13204;-1;192;82;37;3;34;.919;3554000;0
13204;186451;193;0;0;0;0;.00nan;0;0
13247;-1;211;69;34;3;31;.912;3600000;0
13247;190034;217;57;35;5;30;.857;3576000;0
13247;190041;217;0;0;0;0;.00nan;0;0
13247;179646;211;0;0;0;0;.00nan;0;0
13302;-1;211;52;2;0;2;1.000;403000;0
13302;169226;186;83;29;1;28;.966;3600000;0
13302;179646;211;66;51;6;45;.882;3197000;0
13302;185778;186;0;0;0;0;.00nan;0;0
13301;175354;228;0;0;0;0;.00nan;0;0
13301;180377;228;66;25;2;23;.920;3771000;0
13301;191120;223;82;35;1;34;.971;3771000;0
13301;187118;223;0;0;0;0;.00nan;0;0
13504;-1;189;91;43;3;40;.930;3600000;0
13504;179647;195;100;23;0;23;1.000;3600000;0
13504;191849;195;0;0;0;0;.00nan;0;0
13504;-1;189;0;0;0;0;.00nan;0;0
13454;183695;232;0;0;0;0;.00nan;0;0
13454;184175;224;95;43;3;40;.930;3542000;0
13454;179691;232;62;17;1;16;.941;3600000;0
13454;185840;224;0;0;0;0;.00nan;0;0
13407;182128;215;0;0;0;0;.00nan;0;0
13407;-1;180;72;36;3;33;.917;3600000;0
13407;197707;180;0;0;0;0;.00nan;0;0
13407;-1;215;51;36;5;31;.861;3600000;0
13308;189081;187;100;28;0;28;1.000;3600000;0
13308;179647;195;47;26;3;23;.885;3600000;0
13308;191849;195;0;0;0;0;.00nan;0;0
13308;-1;187;0;0;0;0;.00nan;0;0
13424;194219;4960;0;0;0;0;.00nan;0;0
13424;173219;4960;54;34;4;30;.882;3513000;0
13424;175354;228;63;20;2;18;.900;3600000;0
13424;180377;228;0;0;0;0;.00nan;0;0
13398;179169;209;0;0;0;0;.00nan;0;0
13398;201562;2620;0;0;0;0;.00nan;0;0
13398;-1;2620;67;31;3;28;.903;3600000;0
13398;186205;209;49;30;4;26;.867;3600000;0
13293;201524;205;0;0;0;0;.00nan;0;0
13293;-1;205;51;24;3;21;.875;3795000;0
13293;-1;206;75;33;2;31;.939;3769000;0
13293;202998;206;0;0;0;0;.00nan;0;0
13248;-1;210;0;0;0;0;.00nan;0;0
13248;-1;216;54;46;7;39;.848;3600000;0
13248;187240;216;0;0;0;0;.00nan;0;0
13248;192461;210;74;24;1;23;.958;3600000;0
13213;-1;1371;0;0;0;0;.00nan;0;0
13213;-1;220;0;0;0;0;.00nan;0;0
13213;187443;220;74;25;2;23;.920;3600000;0
13213;192688;1371;63;37;4;33;.892;3574000;0
13287;183678;1505;0;0;0;0;.00nan;0;0
13287;195251;4949;40;32;6;26;.813;3160000;0
13287;186549;1505;68;22;1;21;.955;3600000;0
13287;197685;4949;49;1;0;1;1.000;440000;0
13211;200452;221;0;0;0;0;.00nan;0;0
13211;191120;223;0;0;0;0;.00nan;0;0
13211;187118;223;94;44;2;42;.955;3600000;0
13211;187362;221;58;33;4;29;.879;3516000;0
13182;175370;199;67;26;2;24;.923;3600000;0
13182;-1;207;88;43;3;40;.930;3553000;0
13182;-1;207;0;0;0;0;.00nan;0;0
13182;161006;199;0;0;0;0;.00nan;0;0
13125;176932;176;0;0;0;0;.00nan;0;0
13125;184907;4959;0;0;0;0;.00nan;0;0
13125;182006;176;52;32;4;28;.875;3584000;0
13125;-1;4959;75;31;3;28;.903;3600000;0
13209;173900;192;0;0;0;0;.00nan;0;0
13209;170351;194;21;41;8;33;.805;3600000;0
13209;-1;192;71;26;2;24;.923;3600000;0
13209;-1;194;0;0;0;0;.00nan;0;0
13214;190125;184;98;23;0;23;1.000;3600000;0
13214;179668;184;0;0;0;0;.00nan;0;0
13214;-1;214;58;38;4;34;.895;3600000;0
13214;191518;214;0;0;0;0;.00nan;0;0
13283;195238;200;56;5;0;5;1.000;371000;0
13283;179452;226;0;0;0;0;.00nan;0;0
13283;187295;200;24;25;6;19;.760;3229000;0
13283;192629;226;56;17;2;15;.882;3600000;0
13270;189773;231;0;0;0;0;.00nan;0;0
13270;184610;222;22;27;6;21;.778;3292000;0
13270;185034;231;67;20;1;19;.950;3600000;0
13270;185851;222;46;4;1;3;.750;308000;0
13567;-1;189;64;26;2;24;.923;3600000;0
13567;184648;196;80;36;3;33;.917;3549000;0
13567;191118;196;0;0;0;0;.00nan;0;0
13567;-1;189;0;0;0;0;.00nan;0;0
13263;173770;193;0;0;0;0;.00nan;0;0
13263;184788;198;0;0;0;0;.00nan;0;0
13263;181431;198;34;25;5;20;.800;3600000;0
13263;186451;193;100;39;2;37;.949;3600000;0
13390;-1;203;55;37;4;33;.892;3548000;0
13390;201560;202;79;35;3;32;.914;3600000;0
13390;-1;203;0;0;0;0;.00nan;0;0
13390;196299;202;0;0;0;0;.00nan;0;0
13246;200306;182;87;38;2;36;.947;3600000;0
13246;179388;182;0;0;0;0;.00nan;0;0
13246;-1;181;61;30;3;27;.900;3584000;0
13246;192552;181;0;0;0;0;.00nan;0;0
13250;189902;204;88;34;2;32;.941;3600000;0
13250;184712;204;0;0;0;0;.00nan;0;0
13250;185743;201;83;37;3;34;.919;3589000;0
13250;-1;201;0;0;0;0;.00nan;0;0
13328;201495;213;74;33;2;31;.939;3516000;0
13328;196571;177;100;25;0;25;1.000;3600000;0
13328;203029;213;0;0;0;0;.00nan;0;0
13328;-1;177;0;0;0;0;.00nan;0;0
13383;169226;186;51;30;4;26;.867;3600000;0
13383;190034;217;100;34;0;34;1.000;3600000;0
13383;190041;217;0;0;0;0;.00nan;0;0
13383;185778;186;0;0;0;0;.00nan;0;0
13322;192915;179;85;25;1;24;.960;3600000;0
13322;-1;183;0;0;0;0;.00nan;0;0
13322;182089;183;52;28;4;24;.857;3600000;0
13322;-1;179;0;0;0;0;.00nan;0;0
13319;-1;211;55;38;5;33;.868;3600000;0
13319;179646;211;0;0;0;0;.00nan;0;0
13319;179679;212;0;0;0;0;.00nan;0;0
13319;186641;212;71;26;3;23;.885;3600000;0
13349;181338;230;0;0;0;0;.00nan;0;0
13349;185800;229;0;0;0;0;.00nan;0;0
13349;185960;229;98;35;1;34;.971;3600000;0
13349;186495;230;100;31;0;31;1.000;3600000;0
13334;194416;191;0;0;0;0;.00nan;0;0
13334;178394;188;0;0;0;0;.00nan;0;0
13334;184409;188;74;38;3;35;.921;3600000;0
13334;201892;191;48;32;5;27;.844;3550000;0
13340;174325;197;69;46;5;41;.891;3600000;0
13340;184677;197;0;0;0;0;.00nan;0;0
13340;192547;190;0;0;0;0;.00nan;0;0
13340;197704;190;47;19;3;16;.842;3600000;0
13310;184175;224;100;36;1;35;.972;3600000;0
13310;189885;225;50;27;4;23;.852;3600000;0
13310;-1;225;0;0;0;0;.00nan;0;0
13310;185840;224;0;0;0;0;.00nan;0;0
13412;173900;192;87;25;1;24;.960;3600000;0
13412;184648;196;0;0;0;0;.00nan;0;0
13412;-1;192;0;0;0;0;.00nan;0;0
13412;191118;196;89;32;2;30;.938;3577000;0
13288;184788;198;57;42;6;36;.857;3600000;0
13288;179647;195;0;0;0;0;.00nan;0;0
13288;181431;198;0;0;0;0;.00nan;0;0
13288;191849;195;46;15;2;13;.867;3600000;0
13343;182467;185;58;25;3;22;.880;3600000;0
13343;190125;184;18;9;4;5;.556;1082000;0
13343;179668;184;53;18;2;16;.889;2518000;0
13343;-1;185;0;0;0;0;.00nan;0;0
13356;183695;232;54;33;4;29;.879;2325000;0
13356;179691;232;61;13;1;12;.923;1275000;0
13356;181338;230;0;0;0;0;.00nan;0;0
13356;186495;230;64;22;2;20;.909;3600000;0
13449;173549;219;0;0;0;0;.00nan;0;0
13449;195164;218;68;27;2;25;.926;3600000;0
13449;190095;218;0;0;0;0;.00nan;0;0
13449;181102;219;64;30;3;27;.900;3554000;0
13244;182454;4864;0;0;0;0;.00nan;0;0
13244;183737;4864;78;32;2;30;.938;3524000;0
13244;201562;2620;84;17;0;17;1.000;3600000;0
13244;-1;2620;0;0;0;0;.00nan;0;0
13344;189773;231;0;0;0;0;.00nan;0;0
13344;185034;231;64;20;2;18;.900;3600000;0
13344;191120;223;60;36;5;31;.861;3600000;0
13344;187118;223;0;0;0;0;.00nan;0;0
13297;184069;208;98;43;2;41;.953;3900000;0
13297;179702;208;0;0;0;0;.00nan;0;0
13297;185743;201;82;39;2;37;.949;3900000;0
13297;-1;201;0;0;0;0;.00nan;0;0
13460;169226;186;0;0;0;0;.00nan;0;0
13460;182128;215;87;63;4;59;.937;3600000;0
13460;185778;186;90;21;0;21;1.000;3600000;0
13460;-1;215;0;0;0;0;.00nan;0;0
13266;-1;210;0;0;0;0;.00nan;0;0
13266;192461;210;55;25;3;22;.880;3600000;0
13266;-1;178;53;34;4;30;.882;3600000;0
13266;-1;178;0;0;0;0;.00nan;0;0
13294;194416;191;52;27;4;23;.852;3600000;0
13294;201892;191;0;0;0;0;.00nan;0;0
13294;192547;190;100;34;0;34;1.000;3600000;0
13294;197704;190;0;0;0;0;.00nan;0;0
13219;194219;4960;80;27;1;26;.963;3600000;0
13219;173219;4960;0;0;0;0;.00nan;0;0
13219;200452;221;82;38;2;36;.947;3600000;0
13219;187362;221;0;0;0;0;.00nan;0;0
13210;183678;1505;77;30;3;27;.900;3600000;0
13210;201495;213;0;0;0;0;.00nan;0;0
13210;186549;1505;0;0;0;0;.00nan;0;0
13210;203029;213;35;40;6;34;.850;3600000;0
13299;178394;188;0;0;0;0;.00nan;0;0
13299;184409;188;77;19;2;17;.895;3900000;0
13299;174325;197;0;0;0;0;.00nan;0;0
13299;184677;197;82;41;2;39;.951;3900000;0
13126;176932;176;81;33;2;31;.939;3592000;0
13126;184907;4959;85;28;1;27;.964;3600000;0
13126;182006;176;0;0;0;0;.00nan;0;0
13126;-1;4959;0;0;0;0;.00nan;0;0
13333;201524;205;57;17;2;15;.882;3600000;0
13333;-1;205;0;0;0;0;.00nan;0;0
13333;-1;206;0;0;0;0;.00nan;0;0
13333;202998;206;51;28;4;24;.857;3533000;0
13196;200306;182;56;5;0;5;1.000;626000;0
13196;179388;182;42;36;6;30;.833;2894000;0
13196;-1;220;39;17;4;13;.765;2065000;0
13196;187443;220;64;9;0;9;1.000;1535000;0
13581;192915;179;0;0;0;0;.00nan;0;0
13581;-1;216;0;0;0;0;.00nan;0;0
13581;-1;179;53;35;4;31;.886;3590000;0
13581;187240;216;58;19;2;17;.895;3600000;0
13323;184610;222;0;0;0;0;.00nan;0;0
13323;185800;229;65;28;3;25;.893;3577000;0
13323;185851;222;78;29;2;27;.931;3600000;0
13323;185960;229;0;0;0;0;.00nan;0;0
13273;-1;211;86;35;2;33;.943;3525000;0
13273;179646;211;0;0;0;0;.00nan;0;0
13273;179679;212;0;0;0;0;.00nan;0;0
13273;186641;212;88;16;0;16;1.000;3600000;0
13442;189081;187;73;17;1;16;.941;3600000;0
13442;-1;189;84;44;3;41;.932;3589000;0
13442;-1;187;0;0;0;0;.00nan;0;0
13442;-1;189;0;0;0;0;.00nan;0;0
13363;195164;218;0;0;0;0;.00nan;0;0
13363;190034;217;72;30;2;28;.933;3600000;0
13363;190041;217;0;0;0;0;.00nan;0;0
13363;190095;218;73;37;3;34;.919;3585000;0
13239;-1;181;71;23;2;21;.913;3600000;0
13239;-1;214;60;23;3;20;.870;3580000;0
13239;191518;214;0;0;0;0;.00nan;0;0
13239;192552;181;0;0;0;0;.00nan;0;0
13354;184069;208;42;26;4;22;.846;3569000;0
13354;195238;200;0;0;0;0;.00nan;0;0
13354;179702;208;0;0;0;0;.00nan;0;0
13354;187295;200;98;37;2;35;.946;3600000;0
13529;175370;199;0;0;0;0;.00nan;0;0
13529;201560;202;76;33;2;31;.939;3600000;0
13529;196299;202;0;0;0;0;.00nan;0;0
13529;161006;199;59;32;4;28;.875;3579000;0
13312;-1;203;69;18;1;17;.944;3600000;0
13312;-1;203;0;0;0;0;.00nan;0;0
13312;-1;207;84;45;3;42;.933;3521000;0
13312;-1;207;0;0;0;0;.00nan;0;0
13329;195251;4949;100;27;0;27;1.000;3600000;0
13329;-1;183;0;0;0;0;.00nan;0;0
13329;182089;183;68;31;3;28;.903;3600000;0
13329;197685;4949;0;0;0;0;.00nan;0;0
13307;182454;4864;67;24;2;22;.917;2659000;0
13307;183737;4864;19;9;4;5;.556;941000;0
13307;179169;209;0;0;0;0;.00nan;0;0
13307;186205;209;78;27;1;26;.963;3600000;0
13445;189902;204;60;30;3;27;.900;3542000;0
13445;184712;204;0;0;0;0;.00nan;0;0
13445;179452;226;0;0;0;0;.00nan;0;0
13445;192629;226;68;24;1;23;.958;3600000;0
13548;173549;219;86;51;4;47;.922;3615000;0
13548;181102;219;0;0;0;0;.00nan;0;0
13548;-1;180;65;24;3;21;.875;3615000;0
13548;197707;180;0;0;0;0;.00nan;0;0
13358;173770;193;86;25;1;24;.960;3600000;0
13358;170351;194;61;17;1;16;.941;1562000;0
13358;-1;194;34;26;5;21;.808;2038000;0
13358;186451;193;0;0;0;0;.00nan;0;0
13280;189773;231;0;0;0;0;.00nan;0;0
13280;189885;225;74;42;4;38;.905;3600000;0
13280;185034;231;59;12;1;11;.917;3600000;0
13280;-1;225;0;0;0;0;.00nan;0;0
13326;184610;222;27;29;6;23;.793;3600000;0
13326;175354;228;0;0;0;0;.00nan;0;0
13326;180377;228;83;28;1;27;.964;3600000;0
13326;185851;222;0;0;0;0;.00nan;0;0
13243;173770;193;63;15;1;14;.933;3600000;0
13243;186451;193;0;0;0;0;.00nan;0;0
13243;192547;190;59;63;8;55;.873;3352000;0
13243;197704;190;55;5;0;5;1.000;248000;0
13318;195251;4949;57;35;4;31;.886;3900000;0
13318;-1;210;0;0;0;0;.00nan;0;0
13318;192461;210;53;29;4;25;.862;3900000;0
13318;197685;4949;0;0;0;0;.00nan;0;0
13331;183695;232;74;32;2;30;.938;3532000;0
13331;200452;221;0;0;0;0;.00nan;0;0
13331;179691;232;0;0;0;0;.00nan;0;0
13331;187362;221;100;32;0;32;1.000;3600000;0
13274;201524;205;0;0;0;0;.00nan;0;0
13274;-1;205;59;20;2;18;.900;3600000;0
13274;-1;206;62;35;3;32;.914;3600000;0
13274;202998;206;0;0;0;0;.00nan;0;0
13527;184648;196;65;54;6;48;.889;3600000;0
13527;179647;195;76;10;0;10;1.000;3600000;0
13527;191118;196;0;0;0;0;.00nan;0;0
13527;191849;195;0;0;0;0;.00nan;0;0
13330;192915;179;75;13;0;13;1.000;3600000;0
13330;-1;183;88;53;4;49;.925;3600000;0
13330;182089;183;0;0;0;0;.00nan;0;0
13330;-1;179;0;0;0;0;.00nan;0;0
13265;-1;220;80;24;1;23;.958;3600000;0
13265;187443;220;0;0;0;0;.00nan;0;0
13265;-1;214;0;0;0;0;.00nan;0;0
13265;191518;214;43;23;3;20;.870;3583000;0
13470;184175;224;72;33;4;29;.879;3590000;0
13470;181338;230;0;0;0;0;.00nan;0;0
13470;185840;224;0;0;0;0;.00nan;0;0
13470;186495;230;61;19;2;17;.895;3600000;0
13368;174325;197;77;38;3;35;.921;3587000;0
13368;-1;189;0;0;0;0;.00nan;0;0
13368;184677;197;0;0;0;0;.00nan;0;0
13368;-1;189;59;14;1;13;.929;3600000;0
13374;200306;182;72;26;2;24;.923;3600000;0
13374;179388;182;0;0;0;0;.00nan;0;0
13374;-1;181;0;0;0;0;.00nan;0;0
13374;192552;181;39;23;4;19;.826;3550000;0
13180;179169;209;0;0;0;0;.00nan;0;0
13180;184907;4959;0;0;0;0;.00nan;0;0
13180;186205;209;58;35;4;31;.886;3600000;0
13180;-1;4959;36;29;5;24;.828;3592000;0
13342;183678;1505;0;0;0;0;.00nan;0;0
13342;186549;1505;53;33;5;28;.848;3600000;0
13342;-1;178;64;47;6;41;.872;3543000;0
13342;-1;178;0;0;0;0;.00nan;0;0
13320;194416;191;75;26;2;24;.923;3668000;0
13320;184788;198;0;0;0;0;.00nan;0;0
13320;201892;191;0;0;0;0;.00nan;0;0
13320;181431;198;94;35;1;34;.971;3668000;0
13360;-1;211;0;0;0;0;.00nan;0;0
13360;169226;186;0;0;0;0;.00nan;0;0
13360;179646;211;68;42;5;37;.881;3600000;0
13360;185778;186;76;31;2;29;.935;3600000;0
13464;201562;2620;89;19;0;19;1.000;3600000;0
13464;176932;176;0;0;0;0;.00nan;0;0
13464;182006;176;97;50;3;47;.940;3600000;0
13464;-1;2620;0;0;0;0;.00nan;0;0
13433;187628;227;0;0;0;0;.00nan;0;0
13433;-1;227;100;32;1;31;.969;3600000;0
13433;185800;229;0;0;0;0;.00nan;0;0
13433;185960;229;52;26;4;22;.846;3600000;0
13235;182467;185;100;40;0;40;1.000;3600000;0
13235;190125;184;65;23;2;21;.913;3521000;0
13235;179668;184;0;0;0;0;.00nan;0;0
13235;-1;185;0;0;0;0;.00nan;0;0
13234;-1;216;56;30;3;27;.900;3568000;0
13234;201495;213;79;27;2;25;.926;3600000;0
13234;187240;216;0;0;0;0;.00nan;0;0
13234;203029;213;0;0;0;0;.00nan;0;0
13483;173549;219;0;0;0;0;.00nan;0;0
13483;190034;217;80;44;4;40;.909;3900000;0
13483;190041;217;0;0;0;0;.00nan;0;0
13483;181102;219;45;31;4;27;.871;3900000;0
13486;179679;212;0;0;0;0;.00nan;0;0
13486;182128;215;0;0;0;0;.00nan;0;0
13486;186641;212;49;26;4;22;.846;3900000;0
13486;-1;215;73;40;4;36;.900;3900000;0
13498;195164;218;82;32;1;31;.969;3600000;0
13498;190095;218;0;0;0;0;.00nan;0;0
13498;-1;180;55;24;3;21;.875;3532000;0
13498;197707;180;0;0;0;0;.00nan;0;0
13376;184610;222;0;0;0;0;.00nan;0;0
13376;181338;230;0;0;0;0;.00nan;0;0
13376;185851;222;91;53;4;49;.925;3600000;0
13376;186495;230;50;15;2;13;.867;3600000;0
13361;189081;187;63;18;1;17;.944;3600000;0
13361;184648;196;0;0;0;0;.00nan;0;0
13361;191118;196;58;44;5;39;.886;3600000;0
13361;-1;187;0;0;0;0;.00nan;0;0
13315;170351;194;0;0;0;0;.00nan;0;0
13315;184788;198;59;31;4;27;.871;3900000;0
13315;-1;194;79;42;4;38;.905;3900000;0
13315;181431;198;0;0;0;0;.00nan;0;0
13242;182467;185;0;0;0;0;.00nan;0;0
13242;-1;1371;0;0;0;0;.00nan;0;0
13242;-1;185;49;34;5;29;.853;3521000;0
13242;192688;1371;74;32;3;29;.906;3600000;0
13406;189885;225;0;0;0;0;.00nan;0;0
13406;-1;225;75;36;3;33;.917;3886000;0
13406;185800;229;55;29;3;26;.897;3900000;0
13406;185960;229;0;0;0;0;.00nan;0;0
13431;179452;226;77;27;2;25;.926;3900000;0
13431;201524;205;0;0;0;0;.00nan;0;0
13431;-1;205;96;52;2;50;.962;3900000;0
13431;192629;226;0;0;0;0;.00nan;0;0
13324;175370;199;0;0;0;0;.00nan;0;0
13324;-1;207;47;31;5;26;.839;3551000;0
13324;-1;207;0;0;0;0;.00nan;0;0
13324;161006;199;84;33;3;30;.909;3600000;0
13409;-1;203;0;0;0;0;.00nan;0;0
13409;201560;202;72;29;2;27;.931;3600000;0
13409;-1;203;80;39;3;36;.923;3600000;0
13409;196299;202;0;0;0;0;.00nan;0;0
13400;173900;192;0;0;0;0;.00nan;0;0
13400;174325;197;0;0;0;0;.00nan;0;0
13400;184677;197;46;39;6;33;.846;3600000;0
13400;-1;192;61;26;3;23;.885;3600000;0
13450;189902;204;38;35;6;29;.829;3113000;0
13450;184712;204;53;4;0;4;1.000;419000;0
13450;185743;201;50;27;4;23;.852;3600000;0
13450;-1;201;0;0;0;0;.00nan;0;0
13341;-1;210;0;0;0;0;.00nan;0;0
13341;196571;177;81;46;3;43;.935;3900000;0
13341;192461;210;60;22;3;19;.864;3900000;0
13341;-1;177;0;0;0;0;.00nan;0;0
13415;173549;219;81;42;3;39;.929;3530000;0
13415;190034;217;0;0;0;0;.00nan;0;0
13415;190041;217;71;24;1;23;.958;3600000;0
13415;181102;219;0;0;0;0;.00nan;0;0
13269;-1;181;94;48;1;47;.979;3643000;0
13269;-1;220;0;0;0;0;.00nan;0;0
13269;187443;220;86;17;0;17;1.000;3643000;0
13269;192552;181;0;0;0;0;.00nan;0;0
13387;195238;200;51;2;0;2;1.000;336000;0
13387;175370;199;70;29;3;26;.897;3600000;0
13387;187295;200;33;36;6;30;.833;3264000;0
13387;161006;199;0;0;0;0;.00nan;0;0
13410;195251;4949;73;24;2;22;.917;3600000;0
13410;201495;213;35;33;6;27;.818;3282000;0
13410;197685;4949;0;0;0;0;.00nan;0;0
13410;203029;213;47;8;1;7;.875;318000;0
13401;201560;202;0;0;0;0;.00nan;0;0
13401;-1;207;0;0;0;0;.00nan;0;0
13401;196299;202;62;40;5;35;.875;3600000;0
13401;-1;207;66;21;1;20;.952;3600000;0
13362;187628;227;0;0;0;0;.00nan;0;0
13362;184175;224;47;19;3;16;.842;3600000;0
13362;-1;227;24;32;7;25;.781;3600000;0
13362;185840;224;0;0;0;0;.00nan;0;0
13313;192915;179;60;27;3;24;.889;3600000;0
13313;183678;1505;0;0;0;0;.00nan;0;0
13313;-1;179;0;0;0;0;.00nan;0;0
13313;186549;1505;45;30;5;25;.833;3600000;0
13419;-1;1371;0;0;0;0;.00nan;0;0
13419;-1;214;63;21;2;19;.905;3600000;0
13419;191518;214;0;0;0;0;.00nan;0;0
13419;192688;1371;82;43;3;40;.930;3581000;0
13381;-1;203;95;34;2;32;.941;3584000;0
13381;-1;203;0;0;0;0;.00nan;0;0
13381;-1;206;87;26;1;25;.962;3600000;0
13381;202998;206;0;0;0;0;.00nan;0;0
13432;194219;4960;70;26;2;24;.923;3555000;0
13432;173219;4960;0;0;0;0;.00nan;0;0
13432;200452;221;0;0;0;0;.00nan;0;0
13432;187362;221;98;38;1;37;.974;3600000;0
13241;179169;209;0;0;0;0;.00nan;0;0
13241;184907;4959;82;43;3;40;.930;3900000;0
13241;186205;209;69;32;3;29;.906;3900000;0
13241;-1;4959;0;0;0;0;.00nan;0;0
13446;169226;186;78;31;3;28;.903;3900000;0
13446;179679;212;90;52;3;49;.942;3900000;0
13446;185778;186;0;0;0;0;.00nan;0;0
13446;186641;212;0;0;0;0;.00nan;0;0
13305;170351;194;54;19;2;17;.895;3600000;0
13305;-1;194;0;0;0;0;.00nan;0;0
13305;192547;190;91;39;1;38;.974;3600000;0
13305;197704;190;0;0;0;0;.00nan;0;0
13543;178394;188;82;20;1;19;.950;3600000;0
13543;184409;188;0;0;0;0;.00nan;0;0
13543;-1;189;79;42;4;38;.905;3600000;0
13543;-1;189;0;0;0;0;.00nan;0;0
13251;182454;4864;0;0;0;0;.00nan;0;0
13251;183737;4864;39;23;4;19;.826;3545000;0
13251;176932;176;0;0;0;0;.00nan;0;0
13251;182006;176;68;24;2;22;.917;3600000;0
13357;-1;211;72;25;2;23;.920;3600000;0
13357;195164;218;0;0;0;0;.00nan;0;0
13357;190095;218;50;18;3;15;.833;3550000;0
13357;179646;211;0;0;0;0;.00nan;0;0
13369;187628;227;70;53;6;47;.887;3042000;0
13369;189773;231;0;0;0;0;.00nan;0;0
13369;-1;227;63;7;0;7;1.000;558000;0
13369;185034;231;63;14;1;13;.929;3600000;0
13531;194416;191;84;12;0;12;1.000;3600000;0
13531;184648;196;98;53;4;49;.925;3600000;0
13531;201892;191;0;0;0;0;.00nan;0;0
13531;191118;196;0;0;0;0;.00nan;0;0
13484;195251;4949;0;0;0;0;.00nan;0;0
13484;197685;4949;89;20;0;20;1.000;3600000;0
13484;-1;178;0;0;0;0;.00nan;0;0
13484;-1;178;78;39;4;35;.897;3600000;0
13289;173770;193;0;0;0;0;.00nan;0;0
13289;186451;193;91;18;0;18;1.000;3600000;0
13289;192547;190;0;0;0;0;.00nan;0;0
13289;197704;190;83;50;4;46;.920;3600000;0
13423;200306;182;66;16;1;15;.938;3600000;0
13423;179388;182;0;0;0;0;.00nan;0;0
13423;-1;214;0;0;0;0;.00nan;0;0
13423;191518;214;74;25;2;23;.920;3579000;0
13364;175354;228;99;35;1;34;.971;3600000;0
13364;180377;228;0;0;0;0;.00nan;0;0
13364;181338;230;0;0;0;0;.00nan;0;0
13364;186495;230;66;20;2;18;.900;3579000;0
13392;-1;210;0;0;0;0;.00nan;0;0
13392;-1;216;0;0;0;0;.00nan;0;0
13392;187240;216;54;18;2;16;.889;3524000;0
13392;192461;210;100;29;0;29;1.000;3600000;0
13230;-1;181;80;34;2;32;.941;3515000;0
13230;-1;220;0;0;0;0;.00nan;0;0
13230;187443;220;89;20;0;20;1.000;3600000;0
13230;192552;181;0;0;0;0;.00nan;0;0
13332;201495;213;0;0;0;0;.00nan;0;0
13332;196571;177;0;0;0;0;.00nan;0;0
13332;203029;213;65;40;5;35;.875;3570000;0
13332;-1;177;44;22;4;18;.818;3600000;0
13367;174325;197;61;41;4;37;.902;3600000;0
13367;184677;197;0;0;0;0;.00nan;0;0
13367;184788;198;0;0;0;0;.00nan;0;0
13367;181431;198;70;24;1;23;.958;3600000;0
13511;192915;179;96;37;1;36;.973;3600000;0
13511;-1;179;0;0;0;0;.00nan;0;0
13511;-1;178;54;46;7;39;.848;3600000;0
13511;-1;178;0;0;0;0;.00nan;0;0
13272;200306;182;0;0;0;0;.00nan;0;0
13272;179388;182;91;47;3;44;.936;3546000;0
13272;190125;184;53;15;2;13;.867;3600000;0
13272;179668;184;0;0;0;0;.00nan;0;0
13508;173549;219;0;0;0;0;.00nan;0;0
13508;169226;186;71;20;1;19;.950;3600000;0
13508;181102;219;55;52;7;45;.865;3600000;0
13508;185778;186;0;0;0;0;.00nan;0;0
13352;183678;1505;0;0;0;0;.00nan;0;0
13352;-1;183;35;7;2;5;.714;462000;0
13352;182089;183;30;36;7;29;.806;3138000;0
13352;186549;1505;45;17;3;14;.824;3600000;0
13359;-1;211;62;28;3;25;.893;3661000;0
13359;190034;217;86;32;2;30;.938;3661000;0
13359;190041;217;0;0;0;0;.00nan;0;0
13359;179646;211;0;0;0;0;.00nan;0;0
13353;200452;221;0;0;0;0;.00nan;0;0
13353;181338;230;0;0;0;0;.00nan;0;0
13353;186495;230;54;24;4;20;.833;3790000;0
13353;187362;221;72;44;5;39;.886;3790000;0
13388;184175;224;100;43;1;42;.977;3900000;0
13388;184610;222;79;26;1;25;.962;3900000;0
13388;185840;224;0;0;0;0;.00nan;0;0
13388;185851;222;0;0;0;0;.00nan;0;0
13413;183695;232;51;46;6;40;.870;3600000;0
13413;189885;225;78;43;4;39;.907;3600000;0
13413;179691;232;0;0;0;0;.00nan;0;0
13413;-1;225;0;0;0;0;.00nan;0;0
13373;173770;193;89;18;0;18;1.000;3600000;0
13373;170351;194;0;0;0;0;.00nan;0;0
13373;-1;194;97;55;2;53;.964;3594000;0
13373;186451;193;0;0;0;0;.00nan;0;0
13416;179679;212;0;0;0;0;.00nan;0;0
13416;186641;212;74;24;2;22;.917;3562000;0
13416;-1;180;0;0;0;0;.00nan;0;0
13416;197707;180;62;16;1;15;.938;3600000;0
13468;189081;187;83;28;1;27;.964;3600000;0
13468;-1;189;0;0;0;0;.00nan;0;0
13468;-1;187;0;0;0;0;.00nan;0;0
13468;-1;189;89;36;2;34;.944;3550000;0
13459;175354;228;0;0;0;0;.00nan;0;0
13459;180377;228;64;21;2;19;.905;3600000;0
13459;185800;229;88;42;3;39;.929;3549000;0
13459;185960;229;0;0;0;0;.00nan;0;0
13443;184069;208;94;41;3;38;.927;3223000;0
13443;189902;204;70;25;2;23;.920;3600000;0
13443;184712;204;0;0;0;0;.00nan;0;0
13443;179702;208;26;7;3;4;.571;377000;0
13298;201562;2620;70;31;3;28;.903;3600000;0
13298;184907;4959;0;0;0;0;.00nan;0;0
13298;-1;2620;0;0;0;0;.00nan;0;0
13298;-1;4959;98;21;0;21;1.000;3600000;0
13455;195238;200;0;0;0;0;.00nan;0;0
13455;-1;206;0;0;0;0;.00nan;0;0
13455;187295;200;76;32;3;29;.906;3600000;0
13455;202998;206;73;46;4;42;.913;3571000;0
13306;179169;209;0;0;0;0;.00nan;0;0
13306;176932;176;67;30;3;27;.900;3900000;0
13306;182006;176;0;0;0;0;.00nan;0;0
13306;186205;209;78;41;3;38;.927;3900000;0
13405;-1;203;57;22;2;20;.909;3547000;0
13405;201524;205;0;0;0;0;.00nan;0;0
13405;-1;203;0;0;0;0;.00nan;0;0
13405;-1;205;79;24;1;23;.958;3600000;0
13393;175370;199;0;0;0;0;.00nan;0;0
13393;185743;201;62;26;3;23;.885;3600000;0
13393;-1;201;0;0;0;0;.00nan;0;0
13393;161006;199;64;36;4;32;.889;3573000;0
13391;184648;196;80;38;3;35;.921;3594000;0
13391;184788;198;56;15;2;13;.867;3600000;0
13391;181431;198;0;0;0;0;.00nan;0;0
13391;191118;196;0;0;0;0;.00nan;0;0
13378;183678;1505;40;29;5;24;.828;3900000;0
13378;-1;216;56;7;0;7;1.000;1597000;0
13378;186549;1505;0;0;0;0;.00nan;0;0
13378;187240;216;18;16;5;11;.688;2303000;0
13516;200452;221;84;46;3;43;.935;3551000;0
13516;185800;229;0;0;0;0;.00nan;0;0
13516;185960;229;85;32;2;30;.938;3600000;0
13516;187362;221;0;0;0;0;.00nan;0;0
13436;192915;179;0;0;0;0;.00nan;0;0
13436;-1;183;84;34;2;32;.941;3600000;0
13436;182089;183;0;0;0;0;.00nan;0;0
13436;-1;179;36;28;6;22;.786;3600000;0
13256;179169;209;0;0;0;0;.00nan;0;0
13256;176932;176;0;0;0;0;.00nan;0;0
13256;182006;176;69;22;2;20;.909;3600000;0
13256;186205;209;72;37;3;34;.919;3564000;0
13554;194416;191;85;15;0;15;1.000;3600000;0
13554;-1;189;81;54;5;49;.907;3600000;0
13554;201892;191;0;0;0;0;.00nan;0;0
13554;-1;189;0;0;0;0;.00nan;0;0
13440;173900;192;0;0;0;0;.00nan;0;0
13440;174325;197;50;1;0;1;1.000;283000;0
13440;184677;197;45;47;7;40;.851;3279000;0
13440;-1;192;44;32;5;27;.844;3600000;0
13513;201524;205;81;32;3;29;.906;3543000;0
13513;201560;202;96;38;1;37;.974;3600000;0
13513;196299;202;0;0;0;0;.00nan;0;0
13513;-1;205;0;0;0;0;.00nan;0;0
13337;-1;181;25;19;5;14;.737;2052000;0
13337;-1;220;0;0;0;0;.00nan;0;0
13337;187443;220;76;33;2;31;.939;3600000;0
13337;192552;181;47;20;3;17;.850;1548000;0
13457;195164;218;58;23;3;20;.870;3600000;0
13457;190095;218;0;0;0;0;.00nan;0;0
13457;-1;180;68;44;5;39;.886;3513000;0
13457;197707;180;0;0;0;0;.00nan;0;0
13426;184610;222;0;0;0;0;.00nan;0;0
13426;185851;222;88;28;1;27;.964;3600000;0
13426;191120;223;0;0;0;0;.00nan;0;0
13426;187118;223;52;36;5;31;.861;3600000;0
13338;201562;2620;0;0;0;0;.00nan;0;0
13338;184907;4959;52;3;0;3;1.000;423000;0
13338;-1;2620;53;20;3;17;.850;3600000;0
13338;-1;4959;26;34;7;27;.794;3177000;0
13351;182467;185;57;44;6;38;.864;3555000;0
13351;190125;184;39;24;5;19;.792;3600000;0
13351;179668;184;0;0;0;0;.00nan;0;0
13351;-1;185;0;0;0;0;.00nan;0;0
13372;-1;211;48;38;5;33;.868;3600000;0
13372;169226;186;0;0;0;0;.00nan;0;0
13372;179646;211;0;0;0;0;.00nan;0;0
13372;185778;186;96;16;0;16;1.000;3600000;0
13472;194219;4960;0;0;0;0;.00nan;0;0
13472;183695;232;0;0;0;0;.00nan;0;0
13472;173219;4960;52;29;4;25;.862;3600000;0
13472;179691;232;62;44;5;39;.886;3544000;0
13465;200306;182;95;50;2;48;.960;3589000;0
13465;-1;1371;0;0;0;0;.00nan;0;0
13465;179388;182;0;0;0;0;.00nan;0;0
13465;192688;1371;100;25;0;25;1.000;3600000;0
13489;184175;224;60;23;3;20;.870;3600000;0
13489;185840;224;0;0;0;0;.00nan;0;0
13489;191120;223;63;43;4;39;.907;3544000;0
13489;187118;223;0;0;0;0;.00nan;0;0
13524;194219;4960;56;33;4;29;.879;3600000;0
13524;173219;4960;0;0;0;0;.00nan;0;0
13524;175354;228;76;18;1;17;.944;3600000;0
13524;180377;228;0;0;0;0;.00nan;0;0
13345;-1;210;0;0;0;0;.00nan;0;0
13345;196571;177;64;44;5;39;.886;3600000;0
13345;192461;210;65;23;2;21;.913;3600000;0
13345;-1;177;0;0;0;0;.00nan;0;0
13539;184069;208;81;37;3;34;.919;3600000;0
13539;179702;208;0;0;0;0;.00nan;0;0
13539;-1;207;20;21;5;16;.762;3512000;0
13539;-1;207;0;0;0;0;.00nan;0;0
13444;-1;216;64;29;3;26;.897;3600000;0
13444;201495;213;53;39;5;34;.872;3551000;0
13444;187240;216;0;0;0;0;.00nan;0;0
13444;203029;213;0;0;0;0;.00nan;0;0
13535;189081;187;27;29;6;23;.793;3600000;0
13535;173770;193;74;29;2;27;.931;3600000;0
13535;186451;193;0;0;0;0;.00nan;0;0
13535;-1;187;0;0;0;0;.00nan;0;0
13479;189902;204;49;29;5;24;.828;3600000;0
13479;184712;204;0;0;0;0;.00nan;0;0
13479;185743;201;96;34;1;33;.971;3600000;0
13479;-1;201;0;0;0;0;.00nan;0;0
13576;187628;227;64;27;2;25;.926;1500000;0
13576;189773;231;0;0;0;0;.00nan;0;0
13576;-1;227;34;23;5;18;.783;2100000;0
13576;185034;231;31;17;4;13;.765;3600000;0
13481;195238;200;0;0;0;0;.00nan;0;0
13481;-1;206;90;34;2;32;.941;3600000;0
13481;187295;200;59;34;5;29;.853;3600000;0
13481;202998;206;0;0;0;0;.00nan;0;0
13411;182467;185;0;0;0;0;.00nan;0;0
13411;-1;185;61;32;3;29;.906;3600000;0
13411;-1;214;100;29;0;29;1.000;3600000;0
13411;191518;214;0;0;0;0;.00nan;0;0
13522;182454;4864;0;0;0;0;.00nan;0;0
13522;183737;4864;74;36;3;33;.917;3691000;0
13522;201562;2620;0;0;0;0;.00nan;0;0
13522;-1;2620;43;20;4;16;.800;3691000;0
13487;183695;232;80;25;1;24;.960;3600000;0
13487;189885;225;100;30;0;30;1.000;3600000;0
13487;179691;232;0;0;0;0;.00nan;0;0
13487;-1;225;0;0;0;0;.00nan;0;0
13314;173900;192;0;0;0;0;.00nan;0;0
13314;-1;192;47;16;3;13;.813;3600000;0
13314;192547;190;0;0;0;0;.00nan;0;0
13314;197704;190;70;36;4;32;.889;3564000;0
13565;189081;187;33;33;7;26;.788;2778000;0
13565;194416;191;77;28;3;25;.893;3600000;0
13565;201892;191;0;0;0;0;.00nan;0;0
13565;-1;187;58;8;0;8;1.000;822000;0
13350;190125;184;42;17;3;14;.824;3600000;0
13350;179668;184;0;0;0;0;.00nan;0;0
13350;-1;220;0;0;0;0;.00nan;0;0
13350;187443;220;61;30;4;26;.867;3546000;0
13559;184175;224;77;45;4;41;.911;3684000;0
13559;185800;229;0;0;0;0;.00nan;0;0
13559;185840;224;0;0;0;0;.00nan;0;0
13559;185960;229;52;23;3;20;.870;3691000;0
13551;173770;193;0;0;0;0;.00nan;0;0
13551;179647;195;64;30;3;27;.900;3600000;0
13551;186451;193;72;38;4;34;.895;3587000;0
13551;191849;195;0;0;0;0;.00nan;0;0
13578;184069;208;0;0;0;0;.00nan;0;0
13578;201524;205;0;0;0;0;.00nan;0;0
13578;179702;208;62;26;2;24;.923;3896000;0
13578;-1;205;92;40;2;38;.950;3900000;0
13429;195251;4949;0;0;0;0;.00nan;0;0
13429;-1;210;0;0;0;0;.00nan;0;0
13429;192461;210;47;27;4;23;.852;3562000;0
13429;197685;4949;72;41;3;38;.927;3600000;0
13347;178394;188;0;0;0;0;.00nan;0;0
13347;184409;188;97;18;0;18;1.000;3600000;0
13347;192547;190;97;50;2;48;.960;3548000;0
13347;197704;190;0;0;0;0;.00nan;0;0
13377;-1;211;89;28;1;27;.964;3600000;0
13377;173549;219;83;33;2;31;.939;3563000;0
13377;179646;211;0;0;0;0;.00nan;0;0
13377;181102;219;0;0;0;0;.00nan;0;0
13399;192915;179;75;23;2;21;.913;3867000;0
13399;201495;213;0;0;0;0;.00nan;0;0
13399;-1;179;0;0;0;0;.00nan;0;0
13399;203029;213;88;31;1;30;.968;3867000;0
13421;182467;185;59;25;3;22;.880;3524000;0
13421;-1;1371;0;0;0;0;.00nan;0;0
13421;-1;185;0;0;0;0;.00nan;0;0
13421;192688;1371;79;26;1;25;.962;3600000;0
13475;181338;230;0;0;0;0;.00nan;0;0
13475;186495;230;68;17;1;16;.941;3600000;0
13475;191120;223;0;0;0;0;.00nan;0;0
13475;187118;223;78;52;5;47;.904;3600000;0
13469;200306;182;58;27;3;24;.889;3555000;0
13469;179388;182;0;0;0;0;.00nan;0;0
13469;-1;181;79;26;2;24;.923;3600000;0
13469;192552;181;0;0;0;0;.00nan;0;0
13512;194219;4960;0;0;0;0;.00nan;0;0
13512;173219;4960;82;14;0;14;1.000;3600000;0
13512;189885;225;74;47;4;43;.915;3600000;0
13512;-1;225;0;0;0;0;.00nan;0;0
13480;201560;202;69;21;1;20;.952;3600000;0
13480;196299;202;0;0;0;0;.00nan;0;0
13480;185743;201;72;48;5;43;.896;3600000;0
13480;-1;201;0;0;0;0;.00nan;0;0
13544;-1;216;0;0;0;0;.00nan;0;0
13544;187240;216;71;24;2;22;.917;3552000;0
13544;-1;178;0;0;0;0;.00nan;0;0
13544;-1;178;78;29;1;28;.966;3600000;0
13586;190034;217;62;24;2;22;.917;3600000;0
13586;190041;217;0;0;0;0;.00nan;0;0
13586;182128;215;0;0;0;0;.00nan;0;0
13586;-1;215;76;41;3;38;.927;3552000;0
13452;179169;209;0;0;0;0;.00nan;0;0
13452;201562;2620;54;36;5;31;.861;3600000;0
13452;-1;2620;0;0;0;0;.00nan;0;0
13452;186205;209;86;30;2;28;.933;3600000;0
13514;184069;208;66;31;4;27;.871;3547000;0
13514;179702;208;0;0;0;0;.00nan;0;0
13514;-1;206;0;0;0;0;.00nan;0;0
13514;202998;206;93;44;3;41;.932;3600000;0
13482;189902;204;47;31;4;27;.871;3600000;0
13482;184712;204;0;0;0;0;.00nan;0;0
13482;179452;226;0;0;0;0;.00nan;0;0
13482;192629;226;82;29;1;28;.966;3600000;0
13366;201495;213;83;47;3;44;.936;3600000;0
13366;196571;177;100;25;0;25;1.000;3600000;0
13366;203029;213;0;0;0;0;.00nan;0;0
13366;-1;177;0;0;0;0;.00nan;0;0
13395;178394;188;0;0;0;0;.00nan;0;0
13395;184409;188;52;29;4;25;.862;3900000;0
13395;184788;198;79;21;1;20;.952;3395000;0
13395;181431;198;27;7;3;4;.571;505000;0
13420;182467;185;0;0;0;0;.00nan;0;0
13420;200306;182;0;0;0;0;.00nan;0;0
13420;179388;182;86;38;2;36;.947;3600000;0
13420;-1;185;61;31;3;28;.903;3543000;0
13501;201524;205;0;0;0;0;.00nan;0;0
13501;-1;205;65;30;3;27;.900;3587000;0
13501;185743;201;0;0;0;0;.00nan;0;0
13501;-1;201;88;33;2;31;.939;3600000;0
13422;183678;1505;0;0;0;0;.00nan;0;0
13422;-1;216;98;43;1;42;.977;3551000;0
13422;186549;1505;100;28;0;28;1.000;3600000;0
13422;187240;216;0;0;0;0;.00nan;0;0
13517;195164;218;75;20;1;19;.950;3600000;0
13517;190034;217;0;0;0;0;.00nan;0;0
13517;190041;217;96;40;2;38;.950;3600000;0
13517;190095;218;0;0;0;0;.00nan;0;0
13547;187628;227;0;0;0;0;.00nan;0;0
13547;200452;221;0;0;0;0;.00nan;0;0
13547;-1;227;60;31;3;28;.903;3564000;0
13547;187362;221;77;30;2;28;.933;3600000;0
13402;183695;232;0;0;0;0;.00nan;0;0
13402;179691;232;50;32;5;27;.844;3545000;0
13402;181338;230;0;0;0;0;.00nan;0;0
13402;186495;230;33;19;4;15;.789;3600000;0
13534;169226;186;0;0;0;0;.00nan;0;0
13534;185778;186;74;37;3;34;.919;3900000;0
13534;-1;180;82;42;3;39;.929;3900000;0
13534;197707;180;0;0;0;0;.00nan;0;0
13537;189773;231;0;0;0;0;.00nan;0;0
13537;175354;228;0;0;0;0;.00nan;0;0
13537;185034;231;78;18;1;17;.944;3600000;0
13537;180377;228;83;34;2;32;.941;3555000;0
13355;182454;4864;0;0;0;0;.00nan;0;0
13355;183737;4864;77;29;2;27;.931;3900000;0
13355;184907;4959;0;0;0;0;.00nan;0;0
13355;-1;4959;69;20;2;18;.900;3900000;0
13545;173549;219;50;1;0;1;1.000;324000;0
13545;179679;212;0;0;0;0;.00nan;0;0
13545;181102;219;31;26;5;21;.808;3229000;0
13545;186641;212;58;28;4;24;.857;3600000;0
13385;170351;194;50;2;0;2;1.000;299000;0
13385;179647;195;0;0;0;0;.00nan;0;0
13385;-1;194;26;40;8;32;.800;3301000;0
13385;191849;195;75;29;2;27;.931;3600000;0
13408;-1;203;83;51;5;46;.902;3600000;0
13408;175370;199;0;0;0;0;.00nan;0;0
13408;-1;203;0;0;0;0;.00nan;0;0
13408;161006;199;60;19;2;17;.895;3600000;0
13532;192915;179;0;0;0;0;.00nan;0;0
13532;-1;210;0;0;0;0;.00nan;0;0
13532;-1;179;52;28;4;24;.857;3516000;0
13532;192461;210;87;26;2;24;.923;3600000;0
13316;179169;209;70;38;3;35;.921;3583000;0
13316;176932;176;0;0;0;0;.00nan;0;0
13316;182006;176;73;23;2;21;.913;3600000;0
13316;186205;209;0;0;0;0;.00nan;0;0
13435;-1;1371;0;0;0;0;.00nan;0;0
13435;-1;214;72;45;5;40;.889;3600000;0
13435;191518;214;0;0;0;0;.00nan;0;0
13435;192688;1371;62;23;2;21;.913;3600000;0
13467;173900;192;0;0;0;0;.00nan;0;0
13467;174325;197;92;49;2;47;.959;3876000;0
13467;184677;197;0;0;0;0;.00nan;0;0
13467;-1;192;65;20;1;19;.950;3876000;0
13396;175370;199;27;23;5;18;.783;3600000;0
13396;-1;206;91;35;1;34;.971;3600000;0
13396;202998;206;0;0;0;0;.00nan;0;0
13396;161006;199;0;0;0;0;.00nan;0;0
13493;200452;221;73;40;3;37;.925;3549000;0
13493;184610;222;73;25;2;23;.920;3600000;0
13493;185851;222;0;0;0;0;.00nan;0;0
13493;187362;221;0;0;0;0;.00nan;0;0
13500;-1;220;0;0;0;0;.00nan;0;0
13500;187443;220;77;26;1;25;.962;3900000;0
13500;-1;214;0;0;0;0;.00nan;0;0
13500;191518;214;90;41;1;40;.976;3900000;0
13382;-1;183;0;0;0;0;.00nan;0;0
13382;196571;177;56;26;3;23;.885;3576000;0
13382;182089;183;93;33;1;32;.970;3600000;0
13382;-1;177;0;0;0;0;.00nan;0;0
13425;-1;211;51;31;4;27;.871;3600000;0
13425;179646;211;0;0;0;0;.00nan;0;0
13425;182128;215;71;23;1;22;.957;3600000;0
13425;-1;215;0;0;0;0;.00nan;0;0
13397;170351;194;0;0;0;0;.00nan;0;0
13397;-1;189;48;24;4;20;.833;3900000;0
13397;-1;194;45;23;4;19;.826;3900000;0
13397;-1;189;0;0;0;0;.00nan;0;0
13521;195164;218;100;47;0;47;1.000;3600000;0
13521;190034;217;81;27;2;25;.926;3525000;0
13521;190041;217;0;0;0;0;.00nan;0;0
13521;190095;218;0;0;0;0;.00nan;0;0
13375;179169;209;0;0;0;0;.00nan;0;0
13375;176932;176;0;0;0;0;.00nan;0;0
13375;182006;176;56;33;4;29;.879;3600000;0
13375;186205;209;52;38;6;32;.842;3564000;0
13510;200306;182;52;35;4;31;.886;3600000;0
13510;179388;182;0;0;0;0;.00nan;0;0
13510;190125;184;79;27;1;26;.963;3600000;0
13510;179668;184;0;0;0;0;.00nan;0;0
13563;183695;232;77;25;1;24;.960;3600000;0
13563;179691;232;0;0;0;0;.00nan;0;0
13563;185800;229;0;0;0;0;.00nan;0;0
13563;185960;229;100;31;0;31;1.000;3600000;0
13491;-1;216;48;0;0;0;.00nan;627000;0
13491;187240;216;53;26;4;22;.846;3273000;0
13491;-1;178;50;26;4;22;.846;3900000;0
13491;-1;178;0;0;0;0;.00nan;0;0
13476;187628;227;0;0;0;0;.00nan;0;0
13476;-1;227;84;40;3;37;.925;3573000;0
13476;181338;230;0;0;0;0;.00nan;0;0
13476;186495;230;84;25;1;24;.960;3600000;0
13490;184175;224;62;32;4;28;.875;3600000;0
13490;189773;231;0;0;0;0;.00nan;0;0
13490;185034;231;83;25;2;23;.920;3600000;0
13490;185840;224;0;0;0;0;.00nan;0;0
13466;195251;4949;50;24;4;20;.833;3717000;0
13466;201495;213;0;0;0;0;.00nan;0;0
13466;197685;4949;0;0;0;0;.00nan;0;0
13466;203029;213;99;46;3;43;.935;3717000;0
13530;179452;226;70;18;1;17;.944;3600000;0
13530;201560;202;81;35;2;33;.943;3600000;0
13530;196299;202;0;0;0;0;.00nan;0;0
13530;192629;226;0;0;0;0;.00nan;0;0
13434;195238;200;0;0;0;0;.00nan;0;0
13434;-1;203;77;43;4;39;.907;3900000;0
13434;-1;203;0;0;0;0;.00nan;0;0
13434;187295;200;60;35;4;31;.886;3900000;0
13561;194416;191;58;13;1;12;.923;3600000;0
13561;178394;188;96;63;5;58;.921;3600000;0
13561;184409;188;0;0;0;0;.00nan;0;0
13561;201892;191;0;0;0;0;.00nan;0;0
13427;174325;197;74;49;6;43;.878;3600000;0
13427;184677;197;0;0;0;0;.00nan;0;0
13427;179647;195;81;12;0;12;1.000;3600000;0
13427;191849;195;0;0;0;0;.00nan;0;0
13439;182454;4864;0;0;0;0;.00nan;0;0
13439;183737;4864;85;43;2;41;.953;3900000;0
13439;184907;4959;0;0;0;0;.00nan;0;0
13439;-1;4959;67;22;2;20;.909;3900000;0
13441;173900;192;0;0;0;0;.00nan;0;0
13441;184788;198;0;0;0;0;.00nan;0;0
13441;-1;192;70;26;1;25;.962;3900000;0
13441;181431;198;65;14;1;13;.929;3900000;0
13541;194219;4960;93;42;2;40;.952;3600000;0
13541;173219;4960;0;0;0;0;.00nan;0;0
13541;191120;223;46;19;3;16;.842;3568000;0
13541;187118;223;0;0;0;0;.00nan;0;0
13494;-1;1371;0;0;0;0;.00nan;0;0
13494;-1;181;100;24;0;24;1.000;3600000;0
13494;192552;181;0;0;0;0;.00nan;0;0
13494;192688;1371;61;28;3;25;.893;3582000;0
13448;-1;211;0;0;0;0;.00nan;0;0
13448;179646;211;37;36;6;30;.833;3600000;0
13448;-1;180;68;17;1;16;.941;3600000;0
13448;197707;180;0;0;0;0;.00nan;0;0
13595;192915;179;77;28;1;27;.964;3600000;0
13595;175370;199;0;0;0;0;.00nan;0;0
13595;-1;179;0;0;0;0;.00nan;0;0
13595;161006;199;74;41;4;37;.902;3600000;0
13597;178394;188;0;0;0;0;.00nan;0;0
13597;184069;208;93;31;1;30;.968;3600000;0
13597;184409;188;66;25;2;23;.920;3549000;0
13597;179702;208;0;0;0;0;.00nan;0;0
13599;179679;212;0;0;0;0;.00nan;0;0
13599;-1;220;0;0;0;0;.00nan;0;0
13599;186641;212;83;27;1;26;.963;3600000;0
13599;187443;220;79;42;4;38;.905;3600000;0
13601;184610;222;89;24;0;24;1.000;3600000;0
13601;185851;222;0;0;0;0;.00nan;0;0
13601;191120;223;66;30;3;27;.900;3600000;0
13601;187118;223;0;0;0;0;.00nan;0;0
13603;-1;189;75;27;1;26;.963;3900000;0
13603;175354;228;80;28;1;27;.964;3900000;0
13603;180377;228;0;0;0;0;.00nan;0;0
13603;-1;189;0;0;0;0;.00nan;0;0
13605;200306;182;86;35;2;33;.943;3600000;0
13605;-1;211;65;31;3;28;.903;3549000;0
13605;179388;182;0;0;0;0;.00nan;0;0
13605;179646;211;0;0;0;0;.00nan;0;0
13607;173770;193;0;0;0;0;.00nan;0;0
13607;189902;204;24;14;4;10;.714;916000;0
13607;184712;204;85;27;1;26;.963;2684000;0
13607;186451;193;88;25;1;24;.960;3600000;0
13609;170351;194;48;33;4;29;.879;3600000;0
13609;-1;194;0;0;0;0;.00nan;0;0
13609;-1;181;32;21;5;16;.762;2306000;0
13609;192552;181;52;4;0;4;1.000;1250000;0
13611;179169;209;0;0;0;0;.00nan;0;0
13611;186205;209;69;38;4;34;.895;3865000;0
13611;192461;210;79;39;3;36;.923;3865000;0
13611;197672;210;0;0;0;0;.00nan;0;0
13613;190034;217;0;0;0;0;.00nan;0;0
13613;190041;217;62;35;4;31;.886;3577000;0
13613;176932;176;90;37;2;35;.946;3600000;0
13613;182006;176;0;0;0;0;.00nan;0;0
13615;189081;187;72;30;2;28;.933;3600000;0
13615;169226;186;99;42;1;41;.976;3600000;0
13615;185778;186;0;0;0;0;.00nan;0;0
13615;-1;187;0;0;0;0;.00nan;0;0
13617;183678;1505;0;0;0;0;.00nan;0;0
13617;-1;1371;49;1;0;1;1.000;456000;0
13617;186549;1505;46;26;4;22;.846;3600000;0
13617;192688;1371;48;37;5;32;.865;3134000;0
13619;187628;227;0;0;0;0;.00nan;0;0
13619;-1;227;68;32;3;29;.906;3600000;0
13619;190125;184;49;36;5;31;.861;3537000;0
13619;179668;184;0;0;0;0;.00nan;0;0
13621;-1;216;0;0;0;0;.00nan;0;0
13621;201524;205;0;0;0;0;.00nan;0;0
13621;-1;205;70;30;2;28;.933;3555000;0
13621;187240;216;93;36;1;35;.972;3600000;0
13623;184175;224;73;27;2;25;.926;3600000;0
13623;185840;224;0;0;0;0;.00nan;0;0
13623;-1;178;0;0;0;0;.00nan;0;0
13623;-1;178;65;29;3;26;.897;3555000;0
13625;173549;219;0;0;0;0;.00nan;0;0
13625;184648;196;76;25;1;24;.960;3600000;0
13625;181102;219;73;39;3;36;.923;3547000;0
13625;191118;196;0;0;0;0;.00nan;0;0
13627;184907;4959;0;0;0;0;.00nan;0;0
13627;196571;177;96;30;1;29;.967;3788000;0
13627;-1;4959;90;39;2;37;.949;3788000;0
13627;-1;177;0;0;0;0;.00nan;0;0
13629;200452;221;0;0;0;0;.00nan;0;0
13629;194893;191;80;17;0;17;1.000;3600000;0
13629;201892;191;0;0;0;0;.00nan;0;0
13629;187362;221;84;37;2;35;.946;3520000;0
13631;-1;203;91;45;3;42;.933;3746000;0
13631;179452;226;0;0;0;0;.00nan;0;0
13631;191078;203;0;0;0;0;.00nan;0;0
13631;192629;226;62;20;2;18;.900;3762000;0
13633;195164;218;81;26;1;25;.962;3600000;0
13633;174325;197;0;0;0;0;.00nan;0;0
13633;190095;218;0;0;0;0;.00nan;0;0
13633;201585;197;89;55;4;51;.927;3600000;0
13635;201562;2620;0;0;0;0;.00nan;0;0
13635;-1;206;45;33;5;28;.848;3600000;0
13635;-1;2620;76;22;1;21;.955;3600000;0
13635;202998;206;0;0;0;0;.00nan;0;0
13637;182324;4960;0;0;0;0;.00nan;0;0
13637;194219;4960;50;37;5;32;.865;3543000;0
13637;195251;4949;73;41;4;37;.902;3600000;0
13637;197685;4949;0;0;0;0;.00nan;0;0
13639;183695;232;84;21;1;20;.952;3600000;0
13639;179684;180;0;0;0;0;.00nan;0;0
13639;179691;232;0;0;0;0;.00nan;0;0
13639;-1;180;52;29;3;26;.897;3543000;0
13641;182467;185;78;49;5;44;.898;3600000;0
13641;189773;231;0;0;0;0;.00nan;0;0
13641;185034;231;55;19;2;17;.895;3600000;0
13641;-1;185;0;0;0;0;.00nan;0;0
13643;201560;202;49;33;5;28;.848;3600000;0
13643;-1;183;35;18;4;14;.778;1201000;0
13643;196299;202;0;0;0;0;.00nan;0;0
13643;182089;183;57;28;4;24;.857;2399000;0
13645;195238;200;0;0;0;0;.00nan;0;0
13645;181338;230;0;0;0;0;.00nan;0;0
13645;186495;230;59;16;2;14;.875;3590000;0
13645;187295;200;100;47;0;47;1.000;3600000;0
13647;173900;192;0;0;0;0;.00nan;0;0
13647;-1;192;63;11;1;10;.909;3600000;0
13647;185743;201;88;49;3;46;.939;3600000;0
13647;-1;201;0;0;0;0;.00nan;0;0
13649;189885;225;44;43;6;37;.860;2898000;0
13649;179647;195;73;18;1;17;.944;3600000;0
13649;-1;225;44;9;2;7;.778;702000;0
13649;191849;195;0;0;0;0;.00nan;0;0
13651;182454;4864;0;0;0;0;.00nan;0;0
13651;183737;4864;100;26;0;26;1.000;3600000;0
13651;192547;190;51;18;2;16;.889;2722000;0
13651;197704;190;28;18;4;14;.778;878000;0
13653;201495;213;100;35;0;35;1.000;3600000;0
13653;-1;214;57;6;0;6;1.000;512000;0
13653;191518;214;32;26;6;20;.769;3088000;0
13653;203029;213;0;0;0;0;.00nan;0;0
13655;-1;207;100;35;0;35;1.000;3600000;0
13655;185800;229;0;0;0;0;.00nan;0;0
13655;185960;229;63;19;1;18;.947;3550000;0
13655;-1;207;0;0;0;0;.00nan;0;0
13657;184788;198;0;0;0;0;.00nan;0;0
13657;181431;198;63;23;3;20;.870;3600000;0
13657;182128;215;72;46;5;41;.891;3591000;0
13657;-1;215;0;0;0;0;.00nan;0;0
13659;184175;224;0;0;0;0;.00nan;0;0
13659;201524;205;63;23;2;21;.913;3557000;0
13659;-1;205;0;0;0;0;.00nan;0;0
13659;185840;224;100;59;1;58;.983;3600000;0
13661;182467;185;0;0;0;0;.00nan;0;0
13661;179452;226;50;14;2;12;.857;3600000;0
13661;-1;185;63;34;3;31;.912;3600000;0
13661;192629;226;0;0;0;0;.00nan;0;0
13663;189081;187;0;0;0;0;.00nan;0;0
13663;-1;207;75;44;3;41;.932;3563000;0
13663;-1;207;0;0;0;0;.00nan;0;0
13663;-1;187;62;13;1;12;.923;3600000;0
13665;-1;206;0;0;0;0;.00nan;0;0
13665;-1;214;69;27;2;25;.926;3900000;0
13665;191518;214;0;0;0;0;.00nan;0;0
13665;202998;206;84;39;2;37;.949;3900000;0
13667;-1;189;0;0;0;0;.00nan;0;0
13667;184907;4959;59;31;3;28;.903;3600000;0
13667;-1;4959;0;0;0;0;.00nan;0;0
13667;-1;189;82;26;2;24;.923;3600000;0
13669;195238;200;57;30;4;26;.867;3600000;0
13669;191120;223;0;0;0;0;.00nan;0;0
13669;187118;223;100;45;1;44;.978;3600000;0
13669;187295;200;0;0;0;0;.00nan;0;0
13671;201560;202;0;0;0;0;.00nan;0;0
13671;-1;183;0;0;0;0;.00nan;0;0
13671;196299;202;81;32;3;29;.906;3600000;0
13671;182089;183;38;29;5;24;.828;3519000;0
13673;183695;232;0;0;0;0;.00nan;0;0
13673;176932;176;60;19;1;18;.947;1242000;0
13673;179691;232;67;18;1;17;.944;3600000;0
13673;182006;176;25;28;6;22;.786;2358000;0
13675;184610;222;0;0;0;0;.00nan;0;0
13675;201495;213;0;0;0;0;.00nan;0;0
13675;185851;222;90;36;2;34;.944;3562000;0
13675;203029;213;92;32;1;31;.969;3600000;0
13677;-1;203;0;0;0;0;.00nan;0;0
13677;179679;212;68;35;3;32;.914;3558000;0
13677;186641;212;0;0;0;0;.00nan;0;0
13677;191078;203;81;26;1;25;.962;3600000;0
13679;-1;216;98;44;2;42;.955;3800000;0
13679;181338;230;75;38;3;35;.921;3800000;0
13679;186495;230;0;0;0;0;.00nan;0;0
13679;187240;216;0;0;0;0;.00nan;0;0
13681;173900;192;87;46;3;43;.935;3600000;0
13681;184788;198;37;41;8;33;.805;3600000;0
13681;-1;192;0;0;0;0;.00nan;0;0
13681;181431;198;0;0;0;0;.00nan;0;0
13683;187628;227;59;26;3;23;.885;3900000;0
13683;170351;194;0;0;0;0;.00nan;0;0
13683;-1;227;0;0;0;0;.00nan;0;0
13683;-1;194;60;28;3;25;.893;3900000;0
13685;200306;182;38;10;2;8;.800;1152000;0
13685;179388;182;28;29;6;23;.793;2448000;0
13685;192461;210;0;0;0;0;.00nan;0;0
13685;197672;210;67;25;2;23;.920;3600000;0
13687;178394;188;69;28;3;25;.893;3600000;0
13687;184409;188;0;0;0;0;.00nan;0;0
13687;201562;2620;67;48;4;44;.917;3596000;0
13687;-1;2620;0;0;0;0;.00nan;0;0
13689;189773;231;0;0;0;0;.00nan;0;0
13689;174325;197;53;41;6;35;.854;3600000;0
13689;201585;197;0;0;0;0;.00nan;0;0
13689;185034;231;43;17;3;14;.824;3600000;0
13691;173549;219;83;38;2;36;.947;3567000;0
13691;184648;196;0;0;0;0;.00nan;0;0
13691;181102;219;0;0;0;0;.00nan;0;0
13691;191118;196;96;29;1;28;.966;3600000;0
13693;169226;186;0;0;0;0;.00nan;0;0
13693;175354;228;0;0;0;0;.00nan;0;0
13693;180377;228;80;28;1;27;.964;3600000;0
13693;185778;186;73;21;2;19;.905;3546000;0
13695;194893;191;84;16;0;16;1.000;3600000;0
13695;189902;204;70;46;4;42;.913;3600000;0
13695;184712;204;0;0;0;0;.00nan;0;0
13695;201892;191;0;0;0;0;.00nan;0;0
13697;-1;220;65;23;3;20;.870;3600000;0
13697;185800;229;71;42;4;38;.905;3600000;0
13697;185960;229;0;0;0;0;.00nan;0;0
13697;187443;220;0;0;0;0;.00nan;0;0
13699;195164;218;0;0;0;0;.00nan;0;0
13699;190095;218;82;28;1;27;.964;3900000;0
13699;190125;184;0;0;0;0;.00nan;0;0
13699;179668;184;100;53;1;52;.981;3900000;0
13701;200452;221;91;30;1;29;.967;3551000;0
13701;179169;209;100;28;0;28;1.000;3600000;0
13701;186205;209;0;0;0;0;.00nan;0;0
13701;187362;221;0;0;0;0;.00nan;0;0
13703;183678;1505;62;25;3;22;.880;3542000;0
13703;184069;208;0;0;0;0;.00nan;0;0
13703;179702;208;98;41;2;39;.951;3600000;0
13703;186549;1505;0;0;0;0;.00nan;0;0
13705;173770;193;61;16;1;15;.938;3600000;0
13705;185743;201;0;0;0;0;.00nan;0;0
13705;186451;193;0;0;0;0;.00nan;0;0
13705;-1;201;90;42;2;40;.952;3600000;0
13707;195251;4949;0;0;0;0;.00nan;0;0
13707;189885;225;0;0;0;0;.00nan;0;0
13707;-1;225;65;31;4;27;.871;3600000;0
13707;197685;4949;76;50;6;44;.880;3541000;0
13709;175370;199;35;9;3;6;.667;546000;0
13709;179647;195;0;0;0;0;.00nan;0;0
13709;191849;195;64;25;2;23;.920;3600000;0
13709;161006;199;72;32;3;29;.906;3054000;0
13711;192547;190;0;0;0;0;.00nan;0;0
13711;197704;190;80;40;3;37;.925;3600000;0
13711;-1;178;63;37;4;33;.892;3597000;0
13711;-1;178;0;0;0;0;.00nan;0;0
13713;182454;4864;0;0;0;0;.00nan;0;0
13713;183737;4864;71;26;2;24;.923;3600000;0
13713;-1;211;0;0;0;0;.00nan;0;0
13713;179646;211;75;39;3;36;.923;3579000;0
13715;196571;177;0;0;0;0;.00nan;0;0
13715;-1;181;88;57;3;54;.947;3600000;0
13715;192552;181;0;0;0;0;.00nan;0;0
13715;-1;177;76;32;2;30;.938;3600000;0
13717;192915;179;0;0;0;0;.00nan;0;0
13717;182128;215;0;0;0;0;.00nan;0;0
13717;-1;179;69;26;2;24;.923;3545000;0
13717;-1;215;88;33;1;32;.970;3600000;0
13719;182324;4960;43;25;3;22;.880;3600000;0
13719;194219;4960;0;0;0;0;.00nan;0;0
13719;190034;217;75;29;2;27;.931;3600000;0
13719;190041;217;0;0;0;0;.00nan;0;0
13721;-1;1371;65;26;2;24;.923;3600000;0
13721;179684;180;77;40;3;37;.925;3592000;0
13721;-1;180;0;0;0;0;.00nan;0;0
13721;192688;1371;0;0;0;0;.00nan;0;0
13723;184175;224;86;41;3;38;.927;3595000;0
13723;179452;226;0;0;0;0;.00nan;0;0
13723;185840;224;0;0;0;0;.00nan;0;0
13723;192629;226;74;23;1;22;.957;3600000;0
13725;-1;211;72;34;3;31;.912;3900000;0
13725;195164;218;76;39;3;36;.923;3900000;0
13725;190095;218;0;0;0;0;.00nan;0;0
13725;179646;211;0;0;0;0;.00nan;0;0
13727;175370;199;56;30;4;26;.867;3600000;0
13727;-1;214;93;42;3;39;.929;3600000;0
13727;191518;214;0;0;0;0;.00nan;0;0
13727;161006;199;0;0;0;0;.00nan;0;0
13729;200452;221;0;0;0;0;.00nan;0;0
13729;-1;207;97;25;0;25;1.000;3600000;0
13729;187362;221;30;21;5;16;.762;3600000;0
13729;-1;207;0;0;0;0;.00nan;0;0
13731;195238;200;0;0;0;0;.00nan;0;0
13731;182128;215;97;41;1;40;.976;3600000;0
13731;187295;200;65;34;4;30;.882;3600000;0
13731;-1;215;0;0;0;0;.00nan;0;0
13733;178394;188;0;0;0;0;.00nan;0;0
13733;184409;188;83;48;3;45;.938;3584000;0
13733;179647;195;60;19;2;17;.895;3600000;0
13733;191849;195;0;0;0;0;.00nan;0;0
13735;169226;186;51;41;5;36;.878;3590000;0
13735;185778;186;0;0;0;0;.00nan;0;0
13735;192461;210;73;34;3;31;.912;3600000;0
13735;197672;210;0;0;0;0;.00nan;0;0
13737;196571;177;58;27;3;24;.889;3600000;0
13737;191120;223;0;0;0;0;.00nan;0;0
13737;187118;223;71;38;4;34;.895;3588000;0
13737;-1;177;0;0;0;0;.00nan;0;0
13739;179169;209;65;27;2;25;.926;3900000;0
13739;190125;184;0;0;0;0;.00nan;0;0
13739;179668;184;77;33;2;31;.939;3900000;0
13739;186205;209;0;0;0;0;.00nan;0;0
13741;173900;192;0;0;0;0;.00nan;0;0
13741;174325;197;0;0;0;0;.00nan;0;0
13741;201585;197;80;43;4;39;.907;3600000;0
13741;-1;192;93;23;0;23;1.000;3600000;0
13743;182454;4864;0;0;0;0;.00nan;0;0
13743;183737;4864;56;34;4;30;.882;3600000;0
13743;189773;231;0;0;0;0;.00nan;0;0
13743;185034;231;87;15;0;15;1.000;3600000;0
13745;-1;189;58;17;2;15;.882;3600000;0
13745;-1;183;74;38;3;35;.921;3600000;0
13745;182089;183;0;0;0;0;.00nan;0;0
13745;-1;189;0;0;0;0;.00nan;0;0
13747;200306;182;67;35;3;32;.914;3515000;0
13747;179388;182;0;0;0;0;.00nan;0;0
13747;-1;178;85;28;1;27;.964;3600000;0
13747;-1;178;0;0;0;0;.00nan;0;0
13749;201560;202;77;13;0;13;1.000;3600000;0
13749;196299;202;0;0;0;0;.00nan;0;0
13749;-1;181;74;46;4;42;.913;3600000;0
13749;192552;181;0;0;0;0;.00nan;0;0
13751;-1;203;58;43;5;38;.884;3657000;0
13751;184610;222;62;36;4;32;.889;3657000;0
13751;185851;222;0;0;0;0;.00nan;0;0
13751;191078;203;0;0;0;0;.00nan;0;0
13753;179684;180;0;0;0;0;.00nan;0;0
13753;185800;229;0;0;0;0;.00nan;0;0
13753;185960;229;100;27;0;27;1.000;3600000;0
13753;-1;180;72;33;4;29;.879;3600000;0
13755;184069;208;95;28;0;28;1.000;924000;0
13755;173770;193;62;12;1;11;.917;3600000;0
13755;179702;208;58;42;6;36;.857;2676000;0
13755;186451;193;0;0;0;0;.00nan;0;0
13757;195251;4949;92;29;1;28;.966;3600000;0
13757;189885;225;0;0;0;0;.00nan;0;0
13757;-1;225;92;40;2;38;.950;3544000;0
13757;197685;4949;0;0;0;0;.00nan;0;0
13759;201495;213;64;31;3;28;.903;3564000;0
13759;-1;206;100;39;1;38;.974;3600000;0
13759;202998;206;0;0;0;0;.00nan;0;0
13759;203029;213;0;0;0;0;.00nan;0;0
13761;192915;179;0;0;0;0;.00nan;0;0
13761;-1;179;88;16;0;16;1.000;3600000;0
13761;185743;201;81;44;3;41;.932;3600000;0
13761;-1;201;0;0;0;0;.00nan;0;0
13763;182467;185;23;14;4;10;.714;1143000;0
13763;183678;1505;0;0;0;0;.00nan;0;0
13763;186549;1505;65;14;1;13;.929;3600000;0
13763;-1;185;67;31;3;28;.903;2457000;0
13765;184907;4959;75;38;3;35;.921;3600000;0
13765;181338;230;0;0;0;0;.00nan;0;0
13765;186495;230;60;19;2;17;.895;3600000;0
13765;-1;4959;0;0;0;0;.00nan;0;0
13767;176932;176;98;42;2;40;.952;3600000;0
13767;182006;176;0;0;0;0;.00nan;0;0
13767;-1;220;0;0;0;0;.00nan;0;0
13767;187443;220;90;33;1;32;.970;3600000;0
13769;187628;227;0;0;0;0;.00nan;0;0
13769;-1;227;84;43;3;40;.930;3600000;0
13769;189902;204;100;36;0;36;1.000;3600000;0
13769;184712;204;0;0;0;0;.00nan;0;0
13771;184788;198;0;0;0;0;.00nan;0;0
13771;179679;212;0;0;0;0;.00nan;0;0
13771;181431;198;74;25;2;23;.920;3900000;0
13771;186641;212;86;37;2;35;.946;3900000;0
13773;182324;4960;0;0;0;0;.00nan;0;0
13773;194219;4960;80;18;0;18;1.000;3600000;0
13773;183695;232;43;41;6;35;.854;3600000;0
13773;179691;232;0;0;0;0;.00nan;0;0
13775;173549;219;56;16;2;14;.875;3600000;0
13775;190034;217;0;0;0;0;.00nan;0;0
13775;190041;217;56;37;4;33;.892;3600000;0
13775;181102;219;0;0;0;0;.00nan;0;0
13777;189081;187;69;30;3;27;.900;3600000;0
13777;-1;1371;0;0;0;0;.00nan;0;0
13777;192688;1371;30;26;5;21;.808;3539000;0
13777;-1;187;0;0;0;0;.00nan;0;0
13779;170351;194;100;36;1;35;.972;3600000;0
13779;-1;216;76;28;2;26;.929;3542000;0
13779;-1;194;0;0;0;0;.00nan;0;0
13779;187240;216;0;0;0;0;.00nan;0;0
13781;194893;191;46;20;3;17;.850;3834000;0
13781;175354;228;0;0;0;0;.00nan;0;0
13781;201892;191;0;0;0;0;.00nan;0;0
13781;180377;228;91;52;4;48;.923;3834000;0
13783;201524;205;0;0;0;0;.00nan;0;0
13783;201562;2620;0;0;0;0;.00nan;0;0
13783;-1;205;55;38;5;33;.868;3563000;0
13783;-1;2620;45;25;4;21;.840;3600000;0
13785;184648;196;0;0;0;0;.00nan;0;0
13785;191118;196;83;25;1;24;.960;3600000;0
13785;192547;190;68;35;3;32;.914;3545000;0
13785;197704;190;0;0;0;0;.00nan;0;0
13787;189773;231;0;0;0;0;.00nan;0;0
13787;179647;195;0;0;0;0;.00nan;0;0
13787;185034;231;80;13;0;13;1.000;3600000;0
13787;191849;195;66;39;4;35;.897;3600000;0
13789;-1;216;0;0;0;0;.00nan;0;0
13789;175370;199;0;0;0;0;.00nan;0;0
13789;187240;216;48;27;4;23;.852;3600000;0
13789;161006;199;97;36;1;35;.972;3600000;0
13791;179169;209;0;0;0;0;.00nan;0;0
13791;196571;177;0;0;0;0;.00nan;0;0
13791;186205;209;60;30;3;27;.900;3588000;0
13791;-1;177;81;34;2;32;.941;3600000;0
13793;189902;204;38;31;5;26;.839;2381000;0
13793;184712;204;64;10;0;10;1.000;1219000;0
13793;184788;198;90;21;0;21;1.000;3600000;0
13793;181431;198;0;0;0;0;.00nan;0;0
13795;178394;188;53;41;5;36;.878;3600000;0
13795;194893;191;0;0;0;0;.00nan;0;0
13795;184409;188;0;0;0;0;.00nan;0;0
13795;201892;191;75;23;1;22;.957;3600000;0
13797;-1;189;0;0;0;0;.00nan;0;0
13797;-1;183;0;0;0;0;.00nan;0;0
13797;182089;183;89;33;1;32;.970;3600000;0
13797;-1;189;74;38;3;35;.921;3522000;0
13799;-1;211;0;0;0;0;.00nan;0;0
13799;179646;211;93;35;1;34;.971;3600000;0
13799;-1;220;51;21;3;18;.857;3518000;0
13799;187443;220;0;0;0;0;.00nan;0;0
13801;179684;180;52;34;4;30;.882;3600000;0
13801;-1;180;0;0;0;0;.00nan;0;0
13801;-1;178;0;0;0;0;.00nan;0;0
13801;-1;178;36;30;5;25;.833;3600000;0
13803;200452;221;100;34;1;33;.971;3600000;0
13803;191120;223;80;42;4;38;.905;3600000;0
13803;187118;223;0;0;0;0;.00nan;0;0
13803;187362;221;0;0;0;0;.00nan;0;0
13805;195251;4949;0;0;0;0;.00nan;0;0
13805;190125;184;43;28;5;23;.821;3682000;0
13805;179668;184;0;0;0;0;.00nan;0;0
13805;197685;4949;51;36;4;32;.889;3682000;0
13807;200306;182;0;0;0;0;.00nan;0;0
13807;179388;182;50;28;4;24;.857;3900000;0
13807;201562;2620;68;39;4;35;.897;3900000;0
13807;-1;2620;0;0;0;0;.00nan;0;0
13809;184175;224;0;0;0;0;.00nan;0;0
13809;184907;4959;40;2;1;1;.500;330000;0
13809;185840;224;93;41;2;39;.951;3600000;0
13809;-1;4959;30;29;6;23;.793;3270000;0
13811;192915;179;73;20;1;19;.950;3600000;0
13811;-1;179;0;0;0;0;.00nan;0;0
13811;185800;229;0;0;0;0;.00nan;0;0
13811;185960;229;83;45;3;42;.933;3514000;0
13813;173770;193;0;0;0;0;.00nan;0;0
13813;195164;218;0;0;0;0;.00nan;0;0
13813;190095;218;75;41;3;38;.927;3766000;0
13813;186451;193;43;20;4;16;.800;3766000;0
13815;189081;187;0;0;0;0;.00nan;0;0
13815;173900;192;0;0;0;0;.00nan;0;0
13815;-1;192;100;44;1;43;.977;3600000;0
13815;-1;187;73;27;2;25;.926;3600000;0
13817;183678;1505;71;22;1;21;.955;3600000;0
13817;190034;217;75;35;4;31;.886;3600000;0
13817;190041;217;0;0;0;0;.00nan;0;0
13817;186549;1505;0;0;0;0;.00nan;0;0
13819;182467;185;82;41;2;39;.951;3600000;0
13819;201524;205;70;23;1;22;.957;3600000;0
13819;-1;205;0;0;0;0;.00nan;0;0
13819;-1;185;0;0;0;0;.00nan;0;0
13821;201495;213;0;0;0;0;.00nan;0;0
13821;192461;210;0;0;0;0;.00nan;0;0
13821;197672;210;97;18;0;18;1.000;3600000;0
13821;203029;213;72;30;2;28;.933;3566000;0
13823;173549;219;0;0;0;0;.00nan;0;0
13823;181102;219;63;27;3;24;.889;3600000;0
13823;192547;190;0;0;0;0;.00nan;0;0
13823;197704;190;76;38;4;34;.895;3551000;0
13825;184069;208;50;20;3;17;.850;3545000;0
13825;179702;208;0;0;0;0;.00nan;0;0
13825;185743;201;0;0;0;0;.00nan;0;0
13825;-1;201;86;34;2;32;.941;3600000;0
13827;184610;222;61;28;4;24;.857;3547000;0
13827;175354;228;79;37;3;34;.919;3600000;0
13827;180377;228;0;0;0;0;.00nan;0;0
13827;185851;222;0;0;0;0;.00nan;0;0
13829;195238;200;61;31;4;27;.871;3600000;0
13829;174325;197;79;27;1;26;.963;3600000;0
13829;201585;197;0;0;0;0;.00nan;0;0
13829;187295;200;0;0;0;0;.00nan;0;0
13831;179452;226;77;40;4;36;.900;3776000;0
13831;-1;207;82;42;3;39;.929;3776000;0
13831;-1;207;0;0;0;0;.00nan;0;0
13831;192629;226;0;0;0;0;.00nan;0;0
13833;187628;227;73;34;3;31;.912;3600000;0
13833;-1;227;0;0;0;0;.00nan;0;0
13833;176932;176;0;0;0;0;.00nan;0;0
13833;182006;176;24;30;7;23;.767;3600000;0
13835;182324;4960;52;15;2;13;.867;1228000;0
13835;194219;4960;25;31;7;24;.774;2372000;0
13835;181338;230;42;19;5;14;.737;3600000;0
13835;186495;230;0;0;0;0;.00nan;0;0
13837;170351;194;0;0;0;0;.00nan;0;0
13837;-1;194;63;29;3;26;.897;3808000;0
13837;-1;181;0;0;0;0;.00nan;0;0
13837;192552;181;93;42;2;40;.952;3808000;0
13839;-1;203;52;13;2;11;.846;1838000;0
13839;184648;196;58;27;3;24;.889;3600000;0
13839;191078;203;27;13;4;9;.692;1762000;0
13839;191118;196;0;0;0;0;.00nan;0;0
13841;179679;212;90;43;2;41;.953;3600000;0
13841;-1;206;0;0;0;0;.00nan;0;0
13841;186641;212;0;0;0;0;.00nan;0;0
13841;202998;206;53;32;4;28;.875;3600000;0
13843;201560;202;77;28;1;27;.964;3600000;0
13843;196299;202;0;0;0;0;.00nan;0;0
13843;182128;215;55;6;0;6;1.000;480000;0
13843;-1;215;48;37;7;30;.811;3120000;0
13845;182454;4864;100;31;0;31;1.000;3600000;0
13845;183737;4864;0;0;0;0;.00nan;0;0
13845;169226;186;0;0;0;0;.00nan;0;0
13845;185778;186;70;22;2;20;.909;3544000;0
13847;183695;232;0;0;0;0;.00nan;0;0
13847;-1;1371;63;22;2;20;.909;3591000;0
13847;179691;232;86;29;1;28;.966;3600000;0
13847;192688;1371;0;0;0;0;.00nan;0;0
13849;189885;225;87;24;1;23;.958;3600000;0
13849;-1;225;0;0;0;0;.00nan;0;0
13849;-1;214;0;0;0;0;.00nan;0;0
13849;191518;214;58;34;4;30;.882;3600000;0
1128;190125;184;98;46;1;45;.978;3587000;0
1128;179668;184;0;0;0;0;.00nan;0;0
1128;181338;230;0;0;0;0;.00nan;0;0
1128;186495;230;100;24;0;24;1.000;3600000;0
1129;169226;186;37;15;3;12;.800;3593000;0
1129;184907;4959;0;0;0;0;.00nan;0;0
1129;185778;186;0;0;0;0;.00nan;0;0
1129;-1;4959;68;28;2;26;.929;3600000;0
1130;175354;228;0;0;0;0;.00nan;0;0
1130;179647;195;51;14;3;11;.786;3600000;0
1130;180377;228;75;37;4;33;.892;3579000;0
1130;191849;195;0;0;0;0;.00nan;0;0
1131;173770;193;76;24;1;23;.958;3600000;0
1131;201562;2620;0;0;0;0;.00nan;0;0
1131;-1;2620;62;32;3;29;.906;3600000;0
1131;186451;193;0;0;0;0;.00nan;0;0
1132;192915;179;0;0;0;0;.00nan;0;0
1132;189773;231;0;0;0;0;.00nan;0;0
1132;185034;231;65;25;3;22;.880;3600000;0
1132;-1;179;70;44;6;38;.864;3600000;0
1133;-1;1371;0;0;0;0;.00nan;0;0
1133;-1;220;0;0;0;0;.00nan;0;0
1133;187443;220;89;30;1;29;.967;3600000;0
1133;192688;1371;80;30;2;28;.933;3548000;0
1134;194416;191;90;25;0;25;1.000;3545000;0
1134;194893;191;24;4;3;1;.250;567000;0
1134;-1;180;79;45;4;41;.911;4112000;0
1134;197707;180;0;0;0;0;.00nan;0;0
1135;179452;226;0;0;0;0;.00nan;0;0
1135;184788;198;0;0;0;0;.00nan;0;0
1135;181431;198;74;32;3;29;.906;3517000;0
1135;192629;226;98;32;1;31;.969;3600000;0
1456;184907;4959;0;0;0;0;.00nan;0;0
1456;181338;230;0;0;0;0;.00nan;0;0
1456;186495;230;76;18;1;17;.944;3600000;0
1456;-1;4959;83;51;4;47;.922;3600000;0
1457;173770;193;75;38;3;35;.921;3599000;0
1457;179647;195;64;26;2;24;.923;3600000;0
1457;186451;193;0;0;0;0;.00nan;0;0
1457;191849;195;0;0;0;0;.00nan;0;0
1458;189773;231;0;0;0;0;.00nan;0;0
1458;185034;231;100;17;0;17;1.000;3600000;0
1458;-1;220;0;0;0;0;.00nan;0;0
1458;187443;220;93;33;1;32;.970;3564000;0
1459;194416;191;0;0;0;0;.00nan;0;0
1459;194893;191;68;29;3;26;.897;3600000;0
1459;179452;226;0;0;0;0;.00nan;0;0
1459;192629;226;56;45;6;39;.867;3600000;0
1508;179647;195;69;28;2;26;.929;3540000;0
1508;181338;230;0;0;0;0;.00nan;0;0
1508;186495;230;100;25;0;25;1.000;3600000;0
1508;191849;195;0;0;0;0;.00nan;0;0
1509;194416;191;0;0;0;0;.00nan;0;0
1509;194893;191;66;31;3;28;.903;3544000;0
1509;189773;231;0;0;0;0;.00nan;0;0
1509;185034;231;94;41;2;39;.951;3600000;0
1671;189773;231;0;0;0;0;.00nan;0;0
1671;185034;231;57;38;4;34;.895;3533000;0
1671;181338;230;0;0;0;0;.00nan;0;0
1671;186495;230;68;23;2;21;.913;3600000;0
13850;18801;2473;0;0;0;0;.00nan;0;0
13850;31165;2473;84;24;1;23;.958;3600000;0
13850;77086;710;0;0;0;0;.00nan;0;0
13850;81085;710;63;31;4;27;.871;3600000;0
13851;2720;2465;35;18;4;14;.778;1181000;0
13851;5997;706;58;14;2;12;.857;3600000;0
13851;8478;706;0;0;0;0;.00nan;0;0
13851;145636;2465;28;24;5;19;.792;2419000;0
13852;181748;711;74;26;1;25;.962;3900000;0
13852;145787;714;100;43;1;42;.977;3900000;0
13852;145843;714;0;0;0;0;.00nan;0;0
13852;156932;711;0;0;0;0;.00nan;0;0
13853;1213;713;56;18;2;16;.889;3578000;0
13853;43925;712;88;26;1;25;.962;3600000;0
13853;61425;712;0;0;0;0;.00nan;0;0
13853;71648;713;0;0;0;0;.00nan;0;0
13854;883;707;74;24;1;23;.958;3545000;0
13854;8477;2474;0;0;0;0;.00nan;0;0
13854;-1;707;0;0;0;0;.00nan;0;0
13854;72229;2474;86;22;0;22;1.000;3600000;0
13855;1213;713;12;19;6;13;.684;2473000;0
13855;5997;706;26;27;6;21;.778;2987000;0
13855;8478;706;52;2;0;2;1.000;613000;0
13855;71648;713;49;9;1;8;.889;1124000;0
13856;883;707;33;36;6;30;.833;3600000;0
13856;31165;2473;100;23;0;23;1.000;3600000;0
13856;-1;707;0;0;0;0;.00nan;0;0
13856;149455;2473;0;0;0;0;.00nan;0;0
13857;5997;706;72;23;1;22;.957;3549000;0
13857;8478;706;0;0;0;0;.00nan;0;0
13857;37070;714;100;37;0;37;1.000;3600000;0
13857;145787;714;0;0;0;0;.00nan;0;0
13858;2720;2465;46;5;1;4;.800;850000;0
13858;43925;712;50;23;3;20;.870;3600000;0
13858;61425;712;0;0;0;0;.00nan;0;0
13858;145636;2465;32;31;6;25;.806;2750000;0
13859;8477;2474;0;0;0;0;.00nan;0;0
13859;44200;711;15;15;5;10;.667;3545000;0
13859;72229;2474;70;49;4;45;.918;3600000;0
13859;156932;711;0;0;0;0;.00nan;0;0
13860;1213;713;81;32;2;30;.938;3600000;0
13860;71648;713;0;0;0;0;.00nan;0;0
13860;77086;710;0;0;0;0;.00nan;0;0
13860;81085;710;46;27;4;23;.852;3560000;0
13861;883;707;34;16;4;12;.750;915000;0
13861;5997;706;0;0;0;0;.00nan;0;0
13861;8478;706;72;18;1;17;.944;3600000;0
13861;-1;707;62;26;2;24;.923;2685000;0
13862;1213;713;91;19;0;19;1.000;3600000;0
13862;31165;2473;65;24;2;22;.917;3514000;0
13862;71648;713;0;0;0;0;.00nan;0;0
13862;149455;2473;0;0;0;0;.00nan;0;0
13863;2720;2465;0;0;0;0;.00nan;0;0
13863;8477;2474;0;0;0;0;.00nan;0;0
13863;72229;2474;67;32;4;28;.875;3900000;0
13863;145636;2465;61;35;4;31;.886;3900000;0
13864;44200;711;48;26;4;22;.846;3600000;0
13864;77086;710;0;0;0;0;.00nan;0;0
13864;81085;710;31;42;8;34;.810;3600000;0
13864;156932;711;0;0;0;0;.00nan;0;0
13865;37070;714;65;29;3;26;.897;3600000;0
13865;43925;712;88;19;0;19;1.000;3600000;0
13865;61425;712;0;0;0;0;.00nan;0;0
13865;145787;714;0;0;0;0;.00nan;0;0
13866;8477;2474;0;0;0;0;.00nan;0;0
13866;43925;712;63;25;3;22;.880;3514000;0
13866;61425;712;0;0;0;0;.00nan;0;0
13866;72229;2474;85;26;1;25;.962;3600000;0
13867;31165;2473;100;38;0;38;1.000;3600000;0
13867;44200;711;75;18;1;17;.944;3562000;0
13867;149455;2473;0;0;0;0;.00nan;0;0
13867;156932;711;0;0;0;0;.00nan;0;0
13868;883;707;68;30;2;28;.933;3059000;0
13868;1213;713;70;19;1;18;.947;3600000;0
13868;-1;707;26;6;3;3;.500;541000;0
13868;71648;713;0;0;0;0;.00nan;0;0
13869;8477;2474;0;0;0;0;.00nan;0;0
13869;37070;714;54;30;4;26;.867;3578000;0
13869;72229;2474;84;34;2;32;.941;3600000;0
13869;145787;714;0;0;0;0;.00nan;0;0
13870;2720;2465;0;0;0;0;.00nan;0;0
13870;77086;710;0;0;0;0;.00nan;0;0
13870;81085;710;90;17;0;17;1.000;3600000;0
13870;145636;2465;69;41;4;37;.902;3600000;0
13871;5997;706;39;31;6;25;.806;2388000;0
13871;8478;706;63;8;0;8;1.000;1212000;0
13871;43925;712;54;35;6;29;.829;2826000;0
13871;61425;712;51;8;1;7;.875;721000;0
13872;37070;714;99;41;1;40;.976;3600000;0
13872;77086;710;0;0;0;0;.00nan;0;0
13872;81085;710;56;25;3;22;.880;3579000;0
13872;145787;714;0;0;0;0;.00nan;0;0
13873;883;707;51;31;4;27;.871;3600000;0
13873;-1;707;0;0;0;0;.00nan;0;0
13873;44200;711;64;17;1;16;.941;3600000;0
13873;156932;711;0;0;0;0;.00nan;0;0
13874;1213;713;45;26;5;21;.808;3518000;0
13874;5997;706;61;27;3;24;.889;3600000;0
13874;8478;706;0;0;0;0;.00nan;0;0
13874;71648;713;0;0;0;0;.00nan;0;0
13875;2720;2465;78;40;3;37;.925;3570000;0
13875;31165;2473;61;19;2;17;.895;3600000;0
13875;145636;2465;0;0;0;0;.00nan;0;0
13875;149455;2473;0;0;0;0;.00nan;0;0
13876;8477;2474;0;0;0;0;.00nan;0;0
13876;43925;712;0;0;0;0;.00nan;0;0
13876;61425;712;85;24;1;23;.958;3600000;0
13876;72229;2474;97;40;2;38;.950;3558000;0
13877;2720;2465;98;33;1;32;.970;2616000;0
13877;44200;711;0;0;0;0;.00nan;0;0
13877;145636;2465;21;10;4;6;.600;984000;0
13877;156932;711;72;7;0;7;1.000;3600000;0
13878;31165;2473;46;16;3;13;.813;3600000;0
13878;37070;714;35;31;6;25;.806;3009000;0
13878;145787;714;42;4;1;3;.750;591000;0
13878;149455;2473;0;0;0;0;.00nan;0;0
13879;1213;713;100;43;3;40;.930;3900000;0
13879;44200;711;0;0;0;0;.00nan;0;0
13879;71648;713;0;0;0;0;.00nan;0;0
13879;156932;711;48;25;3;22;.880;3900000;0
13880;883;707;37;41;7;34;.829;3600000;0
13880;2720;2465;90;21;0;21;1.000;3600000;0
13880;-1;707;0;0;0;0;.00nan;0;0
13880;145636;2465;0;0;0;0;.00nan;0;0
13881;5997;706;81;12;0;12;1.000;3600000;0
13881;8477;2474;0;0;0;0;.00nan;0;0
13881;8478;706;0;0;0;0;.00nan;0;0
13881;72229;2474;92;43;2;41;.953;3543000;0
13882;43925;712;45;32;5;27;.844;3600000;0
13882;61425;712;0;0;0;0;.00nan;0;0
13882;77086;710;71;22;1;21;.955;3600000;0
13882;81085;710;0;0;0;0;.00nan;0;0
13883;1213;713;0;0;0;0;.00nan;0;0
13883;2720;2465;0;0;0;0;.00nan;0;0
13883;71648;713;76;25;1;24;.960;3600000;0
13883;145636;2465;37;41;7;34;.829;3600000;0
13884;31165;2473;16;18;6;12;.667;3600000;0
13884;43925;712;85;31;2;29;.935;3600000;0
13884;61425;712;0;0;0;0;.00nan;0;0
13884;149455;2473;0;0;0;0;.00nan;0;0
13885;8477;2474;0;0;0;0;.00nan;0;0
13885;72229;2474;89;55;4;51;.927;3556000;0
13885;77086;710;0;0;0;0;.00nan;0;0
13885;81085;710;68;26;2;24;.923;3600000;0
13886;5997;706;74;34;3;31;.912;3600000;0
13886;8478;706;0;0;0;0;.00nan;0;0
13886;44200;711;74;22;1;21;.955;3600000;0
13886;156932;711;0;0;0;0;.00nan;0;0
13887;883;707;53;24;3;21;.875;3586000;0
13887;37070;714;60;22;2;20;.909;3600000;0
13887;-1;707;0;0;0;0;.00nan;0;0
13887;145787;714;0;0;0;0;.00nan;0;0
13888;8477;2474;0;0;0;0;.00nan;0;0
13888;31165;2473;0;0;0;0;.00nan;0;0
13888;72229;2474;50;27;4;23;.852;3547000;0
13888;149455;2473;70;27;2;25;.926;3600000;0
13889;1213;713;79;32;3;29;.906;3553000;0
13889;37070;714;81;37;2;35;.946;3600000;0
13889;71648;713;0;0;0;0;.00nan;0;0
13889;145787;714;0;0;0;0;.00nan;0;0
13890;883;707;0;0;0;0;.00nan;0;0
13890;-1;707;35;24;5;19;.792;3552000;0
13890;43925;712;41;19;4;15;.789;3600000;0
13890;61425;712;0;0;0;0;.00nan;0;0
13891;5997;706;77;30;2;28;.933;3520000;0
13891;8478;706;0;0;0;0;.00nan;0;0
13891;77086;710;0;0;0;0;.00nan;0;0
13891;81085;710;100;25;0;25;1.000;3600000;0
13892;31165;2473;41;30;5;25;.833;3600000;0
13892;77086;710;0;0;0;0;.00nan;0;0
13892;81085;710;53;16;2;14;.875;3600000;0
13892;149455;2473;0;0;0;0;.00nan;0;0
13893;1213;713;78;26;1;25;.962;3600000;0
13893;43925;712;77;30;2;28;.933;3562000;0
13893;61425;712;0;0;0;0;.00nan;0;0
13893;71648;713;0;0;0;0;.00nan;0;0
13894;37070;714;78;46;4;42;.913;3561000;0
13894;44200;711;43;11;2;9;.818;3600000;0
13894;145787;714;0;0;0;0;.00nan;0;0
13894;156932;711;0;0;0;0;.00nan;0;0
13895;883;707;74;24;2;22;.917;3600000;0
13895;8477;2474;0;0;0;0;.00nan;0;0
13895;-1;707;0;0;0;0;.00nan;0;0
13895;72229;2474;59;24;3;21;.875;3551000;0
13896;2720;2465;87;39;3;36;.923;3600000;0
13896;5997;706;83;27;1;26;.963;3600000;0
13896;8478;706;0;0;0;0;.00nan;0;0
13896;145636;2465;0;0;0;0;.00nan;0;0
13897;5997;706;0;0;0;0;.00nan;0;0
13897;8478;706;73;28;3;25;.893;3600000;0
13897;31165;2473;55;32;4;28;.875;3576000;0
13897;149455;2473;0;0;0;0;.00nan;0;0
13898;2720;2465;0;0;0;0;.00nan;0;0
13898;37070;714;73;22;1;21;.955;3600000;0
13898;145636;2465;68;37;3;34;.919;3540000;0
13898;145787;714;0;0;0;0;.00nan;0;0
13899;1213;713;50;13;2;11;.846;3600000;0
13899;8477;2474;0;0;0;0;.00nan;0;0
13899;71648;713;0;0;0;0;.00nan;0;0
13899;72229;2474;92;33;1;32;.970;3600000;0
13900;883;707;23;46;9;37;.804;3600000;0
13900;-1;707;0;0;0;0;.00nan;0;0
13900;77086;710;0;0;0;0;.00nan;0;0
13900;81085;710;70;8;0;8;1.000;3600000;0
13901;5997;706;0;0;0;0;.00nan;0;0
13901;8478;706;47;17;3;14;.824;3900000;0
13901;37070;714;91;36;3;33;.917;3900000;0
13901;145787;714;0;0;0;0;.00nan;0;0
13902;1213;713;58;22;2;20;.909;3575000;0
13902;71648;713;0;0;0;0;.00nan;0;0
13902;77086;710;0;0;0;0;.00nan;0;0
13902;81085;710;83;22;1;21;.955;3600000;0
13903;8477;2474;0;0;0;0;.00nan;0;0
13903;-1;711;76;10;0;10;1.000;3600000;0
13903;44200;711;0;0;0;0;.00nan;0;0
13903;72229;2474;98;49;2;47;.959;3582000;0
13904;883;707;0;0;0;0;.00nan;0;0
13904;31165;2473;0;0;0;0;.00nan;0;0
13904;-1;707;84;33;2;31;.939;3900000;0
13904;149455;2473;69;29;2;27;.931;3900000;0
13905;2720;2465;55;31;4;27;.871;3600000;0
13905;43925;712;62;13;1;12;.923;3600000;0
13905;61425;712;0;0;0;0;.00nan;0;0
13905;145636;2465;0;0;0;0;.00nan;0;0
13906;5997;706;20;23;6;17;.739;2688000;0
13906;8478;706;53;9;1;8;.889;856000;0
13906;43925;712;48;36;6;30;.833;3600000;0
13906;61425;712;0;0;0;0;.00nan;0;0
13907;883;707;92;46;2;44;.957;3724000;0
13907;1213;713;60;11;1;10;.909;3724000;0
13907;-1;707;0;0;0;0;.00nan;0;0
13907;71648;713;0;0;0;0;.00nan;0;0
13908;2720;2465;0;0;0;0;.00nan;0;0
13908;77086;710;95;24;0;24;1.000;3600000;0
13908;81085;710;0;0;0;0;.00nan;0;0
13908;145636;2465;59;50;5;45;.900;3600000;0
13909;8477;2474;0;0;0;0;.00nan;0;0
13909;37070;714;60;30;4;26;.867;3900000;0
13909;72229;2474;82;46;4;42;.913;3900000;0
13909;145787;714;0;0;0;0;.00nan;0;0
13910;-1;711;86;32;1;31;.969;3600000;0
13910;31165;2473;72;34;3;31;.912;3523000;0
13910;44200;711;0;0;0;0;.00nan;0;0
13910;149455;2473;0;0;0;0;.00nan;0;0
13911;1213;713;0;0;0;0;.00nan;0;0
13911;8477;2474;0;0;0;0;.00nan;0;0
13911;71648;713;78;21;1;20;.952;3600000;0
13911;72229;2474;68;51;5;46;.902;3600000;0
13912;2720;2465;67;45;5;40;.889;3600000;0
13912;31165;2473;59;14;2;12;.857;3600000;0
13912;145636;2465;0;0;0;0;.00nan;0;0
13912;149455;2473;0;0;0;0;.00nan;0;0
13913;883;707;0;0;0;0;.00nan;0;0
13913;-1;711;0;0;0;0;.00nan;0;0
13913;-1;707;65;37;3;34;.919;3557000;0
13913;44200;711;66;16;1;15;.938;3600000;0
13914;37070;714;73;47;5;42;.894;3587000;0
13914;77086;710;48;20;3;17;.850;3600000;0
13914;81085;710;0;0;0;0;.00nan;0;0
13914;145787;714;0;0;0;0;.00nan;0;0
13915;-1;711;0;0;0;0;.00nan;0;0
13915;43925;712;87;48;3;45;.938;3546000;0
13915;44200;711;55;10;1;9;.900;3600000;0
13915;61425;712;0;0;0;0;.00nan;0;0
13916;5997;706;59;23;2;21;.913;3600000;0
13916;8477;2474;0;0;0;0;.00nan;0;0
13916;8478;706;0;0;0;0;.00nan;0;0
13916;72229;2474;52;34;5;29;.853;3600000;0
13917;883;707;0;0;0;0;.00nan;0;0
13917;2720;2465;0;0;0;0;.00nan;0;0
13917;-1;707;90;20;0;20;1.000;3600000;0
13917;145636;2465;68;42;4;38;.905;3600000;0
13918;31165;2473;60;14;1;13;.929;3600000;0
13918;37070;714;58;26;3;23;.885;3519000;0
13918;145787;714;0;0;0;0;.00nan;0;0
13918;149455;2473;0;0;0;0;.00nan;0;0
13919;43925;712;0;0;0;0;.00nan;0;0
13919;61425;712;100;23;0;23;1.000;3600000;0
13919;77086;710;91;32;1;31;.969;3547000;0
13919;81085;710;0;0;0;0;.00nan;0;0
13920;1213;713;60;30;4;26;.867;3600000;0
13920;-1;711;23;16;5;11;.688;3533000;0
13920;44200;711;0;0;0;0;.00nan;0;0
13920;71648;713;0;0;0;0;.00nan;0;0
13921;5997;706;0;0;0;0;.00nan;0;0
13921;8478;706;89;33;1;32;.970;3900000;0
13921;-1;711;60;17;1;16;.941;3900000;0
13921;44200;711;0;0;0;0;.00nan;0;0
13922;31165;2473;54;17;2;15;.882;3900000;0
13922;43925;712;0;0;0;0;.00nan;0;0
13922;61425;712;79;40;2;38;.950;3900000;0
13922;149455;2473;0;0;0;0;.00nan;0;0
13923;883;707;0;0;0;0;.00nan;0;0
13923;37070;714;54;17;2;15;.882;3855000;0
13923;-1;707;71;34;3;31;.912;3855000;0
13923;145787;714;0;0;0;0;.00nan;0;0
13924;8477;2474;0;0;0;0;.00nan;0;0
13924;72229;2474;67;45;4;41;.911;3561000;0
13924;77086;710;72;15;2;13;.867;3600000;0
13924;81085;710;0;0;0;0;.00nan;0;0
13925;1213;713;58;20;2;18;.900;3600000;0
13925;2720;2465;23;28;7;21;.750;1625000;0
13925;71648;713;0;0;0;0;.00nan;0;0
13925;145636;2465;70;24;2;22;.917;1975000;0
13926;5997;706;87;32;1;31;.969;3900000;0
13926;8478;706;0;0;0;0;.00nan;0;0
13926;77086;710;69;22;1;21;.955;3900000;0
13926;81085;710;0;0;0;0;.00nan;0;0
13927;1213;713;42;22;4;18;.818;3594000;0
13927;37070;714;68;26;3;23;.885;3600000;0
13927;71648;713;0;0;0;0;.00nan;0;0
13927;145787;714;0;0;0;0;.00nan;0;0
13928;883;707;0;0;0;0;.00nan;0;0
13928;-1;707;82;29;3;26;.897;3732000;0
13928;43925;712;62;15;2;13;.867;3732000;0
13928;61425;712;0;0;0;0;.00nan;0;0
13929;2720;2465;0;0;0;0;.00nan;0;0
13929;-1;711;50;14;2;12;.857;3600000;0
13929;44200;711;0;0;0;0;.00nan;0;0
13929;145636;2465;97;53;3;50;.943;3600000;0
13930;8477;2474;95;38;2;36;.947;3600000;0
13930;31165;2473;52;21;3;18;.857;3548000;0
13930;72229;2474;0;0;0;0;.00nan;0;0
13930;149455;2473;0;0;0;0;.00nan;0;0
13931;-1;711;42;20;3;17;.850;3566000;0
13931;37070;714;0;0;0;0;.00nan;0;0
13931;44200;711;0;0;0;0;.00nan;0;0
13931;145787;714;92;40;2;38;.950;3600000;0
13932;1213;713;70;36;3;33;.917;3567000;0
13932;43925;712;0;0;0;0;.00nan;0;0
13932;61425;712;98;32;1;31;.969;3600000;0
13932;71648;713;0;0;0;0;.00nan;0;0
13933;883;707;0;0;0;0;.00nan;0;0
13933;8477;2474;0;0;0;0;.00nan;0;0
13933;-1;707;91;36;1;35;.972;3900000;0
13933;72229;2474;76;21;1;20;.952;3900000;0
13934;31165;2473;0;0;0;0;.00nan;0;0
13934;77086;710;55;25;3;22;.880;3900000;0
13934;81085;710;0;0;0;0;.00nan;0;0
13934;149455;2473;69;33;3;30;.909;3900000;0
13935;2720;2465;100;47;1;46;.979;3900000;0
13935;5997;706;0;0;0;0;.00nan;0;0
13935;8478;706;87;23;1;22;.957;3900000;0
13935;145636;2465;0;0;0;0;.00nan;0;0
13936;-1;711;0;0;0;0;.00nan;0;0
13936;44200;711;78;25;1;24;.960;3600000;0
13936;77086;710;81;36;2;34;.944;3600000;0
13936;81085;710;0;0;0;0;.00nan;0;0
13937;5997;706;68;25;3;22;.880;3600000;0
13937;8478;706;0;0;0;0;.00nan;0;0
13937;31165;2473;0;0;0;0;.00nan;0;0
13937;149455;2473;34;17;4;13;.765;3547000;0
13938;1213;713;58;15;1;14;.933;3600000;0
13938;8477;2474;0;0;0;0;.00nan;0;0
13938;71648;713;0;0;0;0;.00nan;0;0
13938;72229;2474;58;38;5;33;.868;3600000;0
13939;2720;2465;0;0;0;0;.00nan;0;0
13939;37070;714;86;34;2;32;.941;3600000;0
13939;145636;2465;55;27;4;23;.852;3512000;0
13939;145787;714;0;0;0;0;.00nan;0;0
13940;-1;711;0;0;0;0;.00nan;0;0
13940;43925;712;0;0;0;0;.00nan;0;0
13940;44200;711;100;18;0;18;1.000;3600000;0
13940;61425;712;74;33;3;30;.909;3600000;0
13941;883;707;51;27;4;23;.852;3600000;0
13941;-1;707;0;0;0;0;.00nan;0;0
13941;77086;710;96;20;0;20;1.000;3600000;0
13941;81085;710;0;0;0;0;.00nan;0;0
13942;883;707;0;0;0;0;.00nan;0;0
13942;31165;2473;82;32;3;29;.906;3690000;0
13942;-1;707;86;37;2;35;.946;3690000;0
13942;149455;2473;0;0;0;0;.00nan;0;0
13943;2720;2465;73;40;3;37;.925;3600000;0
13943;43925;712;0;0;0;0;.00nan;0;0
13943;61425;712;65;16;1;15;.938;3600000;0
13943;145636;2465;0;0;0;0;.00nan;0;0
13944;8477;2474;61;26;3;23;.885;3127000;0
13944;-1;711;0;0;0;0;.00nan;0;0
13944;44200;711;100;20;0;20;1.000;3600000;0
13944;72229;2474;34;11;3;8;.727;473000;0
13945;5997;706;79;9;0;9;1.000;3600000;0
13945;8478;706;0;0;0;0;.00nan;0;0
13945;37070;714;87;42;2;40;.952;3554000;0
13945;145787;714;0;0;0;0;.00nan;0;0
13946;1213;713;64;24;2;22;.917;3600000;0
13946;71648;713;0;0;0;0;.00nan;0;0
13946;77086;710;32;28;5;23;.821;3600000;0
13946;81085;710;0;0;0;0;.00nan;0;0
13947;883;707;58;35;5;30;.857;3600000;0
13947;5997;706;69;20;2;18;.900;3600000;0
13947;8478;706;0;0;0;0;.00nan;0;0
13947;-1;707;0;0;0;0;.00nan;0;0
13948;1213;713;98;49;1;48;.980;3600000;0
13948;31165;2473;52;23;3;20;.870;3564000;0
13948;71648;713;0;0;0;0;.00nan;0;0
13948;149455;2473;0;0;0;0;.00nan;0;0
13949;2720;2465;0;0;0;0;.00nan;0;0
13949;8477;2474;0;0;0;0;.00nan;0;0
13949;72229;2474;51;16;2;14;.875;3600000;0
13949;145636;2465;60;30;3;27;.900;3549000;0
13950;37070;714;44;37;6;31;.838;3258000;0
13950;43925;712;0;0;0;0;.00nan;0;0
13950;61425;712;100;21;0;21;1.000;3600000;0
13950;145787;714;53;3;0;3;1.000;342000;0
13951;-1;711;0;0;0;0;.00nan;0;0
13951;31165;2473;56;35;5;30;.857;3600000;0
13951;44200;711;54;28;3;25;.893;3600000;0
13951;149455;2473;0;0;0;0;.00nan;0;0
13952;5997;706;61;32;4;28;.875;3588000;0
13952;8478;706;0;0;0;0;.00nan;0;0
13952;43925;712;0;0;0;0;.00nan;0;0
13952;61425;712;75;26;2;24;.923;3600000;0
13953;883;707;51;28;4;24;.857;3600000;0
13953;1213;713;100;26;0;26;1.000;3600000;0
13953;-1;707;0;0;0;0;.00nan;0;0
13953;71648;713;0;0;0;0;.00nan;0;0
13954;8477;2474;0;0;0;0;.00nan;0;0
13954;37070;714;66;27;3;24;.889;3791000;0
13954;72229;2474;83;45;4;41;.911;3791000;0
13954;145787;714;0;0;0;0;.00nan;0;0
13955;2720;2465;0;0;0;0;.00nan;0;0
13955;77086;710;50;8;1;7;.875;3600000;0
13955;81085;710;0;0;0;0;.00nan;0;0
13955;145636;2465;50;43;6;37;.860;3600000;0
13956;1213;713;70;27;2;25;.926;3600000;0
13956;5997;706;0;0;0;0;.00nan;0;0
13956;8478;706;45;31;5;26;.839;3600000;0
13956;71648;713;0;0;0;0;.00nan;0;0
13957;2720;2465;79;38;3;35;.921;3594000;0
13957;31165;2473;58;20;2;18;.900;3600000;0
13957;145636;2465;0;0;0;0;.00nan;0;0
13957;149455;2473;0;0;0;0;.00nan;0;0
13958;37070;714;87;44;4;40;.909;3554000;0
13958;77086;710;67;32;3;29;.906;3600000;0
13958;81085;710;0;0;0;0;.00nan;0;0
13958;145787;714;0;0;0;0;.00nan;0;0
13959;8477;2474;0;0;0;0;.00nan;0;0
13959;43925;712;0;0;0;0;.00nan;0;0
13959;61425;712;49;19;3;16;.842;3896000;0
13959;72229;2474;96;45;3;42;.933;3900000;0
13960;883;707;0;0;0;0;.00nan;0;0
13960;-1;711;0;0;0;0;.00nan;0;0
13960;-1;707;55;28;3;25;.893;3583000;0
13960;44200;711;64;14;1;13;.929;3600000;0
13961;31165;2473;0;0;0;0;.00nan;0;0
13961;37070;714;60;38;5;33;.868;3600000;0
13961;145787;714;0;0;0;0;.00nan;0;0
13961;149455;2473;85;25;1;24;.960;3600000;0
13962;1213;713;63;34;4;30;.882;3600000;0
13962;-1;711;0;0;0;0;.00nan;0;0
13962;44200;711;69;21;1;20;.952;3600000;0
13962;71648;713;0;0;0;0;.00nan;0;0
13963;883;707;73;28;2;26;.929;3600000;0
13963;2720;2465;0;0;0;0;.00nan;0;0
13963;-1;707;0;0;0;0;.00nan;0;0
13963;145636;2465;40;17;3;14;.824;3552000;0
13964;5997;706;92;18;0;18;1.000;3600000;0
13964;8477;2474;0;0;0;0;.00nan;0;0
13964;8478;706;0;0;0;0;.00nan;0;0
13964;72229;2474;57;42;6;36;.857;3600000;0
13965;43925;712;0;0;0;0;.00nan;0;0
13965;61425;712;59;40;5;35;.875;3600000;0
13965;77086;710;67;25;2;23;.920;3600000;0
13965;81085;710;0;0;0;0;.00nan;0;0
13966;1213;713;42;22;4;18;.818;3855000;0
13966;2720;2465;95;49;3;46;.939;3855000;0
13966;71648;713;0;0;0;0;.00nan;0;0
13966;145636;2465;0;0;0;0;.00nan;0;0
13967;883;707;0;0;0;0;.00nan;0;0
13967;37070;714;72;29;2;27;.931;3563000;0
13967;-1;707;88;32;1;31;.969;3600000;0
13967;145787;714;0;0;0;0;.00nan;0;0
13968;31165;2473;100;26;0;26;1.000;3600000;0
13968;43925;712;49;32;4;28;.875;3600000;0
13968;61425;712;0;0;0;0;.00nan;0;0
13968;149455;2473;0;0;0;0;.00nan;0;0
13969;5997;706;49;29;4;25;.862;3559000;0
13969;8478;706;0;0;0;0;.00nan;0;0
13969;-1;711;0;0;0;0;.00nan;0;0
13969;44200;711;67;25;2;23;.920;3600000;0
13970;8477;2474;0;0;0;0;.00nan;0;0
13970;72229;2474;93;41;3;38;.927;3600000;0
13970;77086;710;62;23;2;21;.913;3600000;0
13970;81085;710;0;0;0;0;.00nan;0;0
13971;8477;2474;0;0;0;0;.00nan;0;0
13971;31165;2473;92;32;1;31;.969;3600000;0
13971;72229;2474;68;37;4;33;.892;3600000;0
13971;149455;2473;0;0;0;0;.00nan;0;0
13972;1213;713;45;18;3;15;.833;3600000;0
13972;37070;714;64;39;4;35;.897;3595000;0
13972;71648;713;0;0;0;0;.00nan;0;0
13972;145787;714;0;0;0;0;.00nan;0;0
13973;2720;2465;0;0;0;0;.00nan;0;0
13973;-1;711;0;0;0;0;.00nan;0;0
13973;44200;711;85;15;0;15;1.000;3600000;0
13973;145636;2465;96;59;5;54;.915;3600000;0
13974;5997;706;98;36;2;34;.944;3600000;0
13974;8478;706;0;0;0;0;.00nan;0;0
13974;77086;710;25;18;5;13;.722;3600000;0
13974;81085;710;0;0;0;0;.00nan;0;0
13975;883;707;100;43;1;42;.977;3600000;0
13975;-1;707;0;0;0;0;.00nan;0;0
13975;43925;712;0;0;0;0;.00nan;0;0
13975;61425;712;47;27;4;23;.852;3600000;0
13976;31165;2473;82;35;3;32;.914;3600000;0
13976;77086;710;69;39;4;35;.897;3544000;0
13976;81085;710;0;0;0;0;.00nan;0;0
13976;149455;2473;0;0;0;0;.00nan;0;0
13977;1213;713;89;26;1;25;.962;3600000;0
13977;43925;712;37;5;2;3;.600;1215000;0
13977;61425;712;31;19;4;15;.789;2385000;0
13977;71648;713;0;0;0;0;.00nan;0;0
13978;2720;2465;88;44;2;42;.955;3900000;0
13978;5997;706;76;19;2;17;.895;3900000;0
13978;8478;706;0;0;0;0;.00nan;0;0
13978;145636;2465;0;0;0;0;.00nan;0;0
13979;-1;711;0;0;0;0;.00nan;0;0
13979;37070;714;87;41;2;39;.951;3544000;0
13979;44200;711;72;21;1;20;.952;3600000;0
13979;145787;714;0;0;0;0;.00nan;0;0
13980;883;707;0;0;0;0;.00nan;0;0
13980;8477;2474;0;0;0;0;.00nan;0;0
13980;-1;707;100;27;0;27;1.000;3600000;0
13980;72229;2474;55;27;3;24;.889;3600000;0
13981;5997;706;97;27;0;27;1.000;3900000;0
13981;8478;706;0;0;0;0;.00nan;0;0
13981;31165;2473;88;26;0;26;1.000;3900000;0
13981;149455;2473;0;0;0;0;.00nan;0;0
13982;2720;2465;0;0;0;0;.00nan;0;0
13982;37070;714;95;39;2;37;.949;3900000;0
13982;145636;2465;82;30;2;28;.933;3900000;0
13982;145787;714;0;0;0;0;.00nan;0;0
13983;-1;711;0;0;0;0;.00nan;0;0
13983;43925;712;34;42;8;34;.810;3600000;0
13983;44200;711;91;24;1;23;.958;3600000;0
13983;61425;712;0;0;0;0;.00nan;0;0
13984;1213;713;100;26;0;26;1.000;3600000;0
13984;8477;2474;0;0;0;0;.00nan;0;0
13984;71648;713;0;0;0;0;.00nan;0;0
13984;72229;2474;83;36;2;34;.944;3569000;0
13985;883;707;33;40;7;33;.825;1996000;0
13985;-1;707;54;17;2;15;.882;1604000;0
13985;77086;710;0;0;0;0;.00nan;0;0
13985;81085;710;57;12;1;11;.917;3600000;0
13986;5997;706;42;24;4;20;.833;3600000;0
13986;8478;706;0;0;0;0;.00nan;0;0
13986;37070;714;84;32;2;30;.938;3600000;0
13986;145787;714;0;0;0;0;.00nan;0;0
13987;1213;713;46;16;3;13;.813;3600000;0
13987;71648;713;0;0;0;0;.00nan;0;0
13987;77086;710;80;33;2;31;.939;3600000;0
13987;81085;710;0;0;0;0;.00nan;0;0
13988;2720;2465;57;31;4;27;.871;3600000;0
13988;43925;712;63;19;2;17;.895;3600000;0
13988;61425;712;0;0;0;0;.00nan;0;0
13988;145636;2465;0;0;0;0;.00nan;0;0
13989;8477;2474;0;0;0;0;.00nan;0;0
13989;-1;711;71;20;1;19;.950;3600000;0
13989;44200;711;0;0;0;0;.00nan;0;0
13989;72229;2474;98;48;3;45;.938;3560000;0
13990;883;707;0;0;0;0;.00nan;0;0
13990;31165;2473;67;19;1;18;.947;3600000;0
13990;-1;707;77;34;2;32;.941;3600000;0
13990;149455;2473;0;0;0;0;.00nan;0;0
13991;1213;713;90;28;1;27;.964;3600000;0
13991;31165;2473;64;24;2;22;.917;3553000;0
13991;71648;713;0;0;0;0;.00nan;0;0
13991;149455;2473;0;0;0;0;.00nan;0;0
13992;37070;714;100;30;0;30;1.000;3600000;0
13992;43925;712;44;12;2;10;.833;3534000;0
13992;61425;712;0;0;0;0;.00nan;0;0
13992;145787;714;0;0;0;0;.00nan;0;0
13993;883;707;25;36;7;29;.806;3600000;0
13993;5997;706;59;15;1;14;.933;3600000;0
13993;8478;706;0;0;0;0;.00nan;0;0
13993;-1;707;0;0;0;0;.00nan;0;0
13994;2720;2465;0;0;0;0;.00nan;0;0
13994;8477;2474;60;25;3;22;.880;3600000;0
13994;72229;2474;0;0;0;0;.00nan;0;0
13994;145636;2465;99;49;1;48;.980;3600000;0
13995;-1;711;0;0;0;0;.00nan;0;0
13995;44200;711;73;24;2;22;.917;3552000;0
13995;77086;710;0;0;0;0;.00nan;0;0
13995;81085;710;86;31;1;30;.968;3600000;0
13996;5997;706;0;0;0;0;.00nan;0;0
13996;8478;706;58;30;3;27;.900;3600000;0
13996;43925;712;83;45;4;41;.911;3524000;0
13996;61425;712;0;0;0;0;.00nan;0;0
13997;883;707;0;0;0;0;.00nan;0;0
13997;1213;713;0;0;0;0;.00nan;0;0
13997;-1;707;45;29;5;24;.828;3600000;0
13997;71648;713;44;23;4;19;.826;3600000;0
13998;2720;2465;59;30;4;26;.867;3600000;0
13998;77086;710;67;20;1;19;.950;3600000;0
13998;81085;710;0;0;0;0;.00nan;0;0
13998;145636;2465;0;0;0;0;.00nan;0;0
13999;8477;2474;0;0;0;0;.00nan;0;0
13999;37070;714;61;26;2;24;.923;3581000;0
13999;72229;2474;100;34;1;33;.971;3600000;0
13999;145787;714;0;0;0;0;.00nan;0;0
14000;-1;711;0;0;0;0;.00nan;0;0
14000;31165;2473;88;29;1;28;.966;3600000;0
14000;44200;711;50;11;2;9;.818;3579000;0
14000;149455;2473;0;0;0;0;.00nan;0;0
14001;1213;713;55;27;3;24;.889;3564000;0
14001;5997;706;83;32;2;30;.938;3600000;0
14001;8478;706;0;0;0;0;.00nan;0;0
14001;71648;713;0;0;0;0;.00nan;0;0
14002;883;707;48;32;4;28;.875;3600000;0
14002;-1;711;0;0;0;0;.00nan;0;0
14002;-1;707;0;0;0;0;.00nan;0;0
14002;44200;711;64;22;2;20;.909;3600000;0
14003;8477;2474;0;0;0;0;.00nan;0;0
14003;43925;712;0;0;0;0;.00nan;0;0
14003;61425;712;88;19;0;19;1.000;3600000;0
14003;72229;2474;77;35;3;32;.914;3600000;0
14004;37070;714;68;33;3;30;.909;3586000;0
14004;77086;710;61;16;1;15;.938;3600000;0
14004;81085;710;0;0;0;0;.00nan;0;0
14004;145787;714;0;0;0;0;.00nan;0;0
14005;2720;2465;0;0;0;0;.00nan;0;0
14005;31165;2473;0;0;0;0;.00nan;0;0
14005;145636;2465;69;53;6;47;.887;3600000;0
14005;149455;2473;52;12;2;10;.833;3600000;0
14006;5997;706;59;19;2;17;.895;3885000;0
14006;8477;2474;0;0;0;0;.00nan;0;0
14006;8478;706;0;0;0;0;.00nan;0;0
14006;72229;2474;89;45;3;42;.933;3885000;0
14007;883;707;0;0;0;0;.00nan;0;0
14007;2720;2465;54;29;4;25;.862;3600000;0
14007;-1;707;40;26;5;21;.808;3589000;0
14007;145636;2465;0;0;0;0;.00nan;0;0
14008;31165;2473;70;28;2;26;.929;3538000;0
14008;37070;714;100;25;0;25;1.000;3600000;0
14008;145787;714;0;0;0;0;.00nan;0;0
14008;149455;2473;0;0;0;0;.00nan;0;0
14009;43925;712;0;0;0;0;.00nan;0;0
14009;61425;712;72;39;4;35;.897;3600000;0
14009;77086;710;27;32;7;25;.781;3600000;0
14009;81085;710;0;0;0;0;.00nan;0;0
14010;1213;713;96;43;1;42;.977;3787000;0
14010;-1;711;0;0;0;0;.00nan;0;0
14010;44200;711;72;20;2;18;.900;3787000;0
14010;71648;713;0;0;0;0;.00nan;0;0
14011;31165;2473;71;18;1;17;.944;3600000;0
14011;43925;712;50;41;6;35;.854;3600000;0
14011;61425;712;0;0;0;0;.00nan;0;0
14011;149455;2473;0;0;0;0;.00nan;0;0
14012;5997;706;75;36;4;32;.889;3696000;0
14012;8478;706;0;0;0;0;.00nan;0;0
14012;-1;711;0;0;0;0;.00nan;0;0
14012;44200;711;60;22;3;19;.864;3696000;0
14013;883;707;70;30;3;27;.900;3600000;0
14013;37070;714;85;32;2;30;.938;3600000;0
14013;-1;707;0;0;0;0;.00nan;0;0
14013;145787;714;0;0;0;0;.00nan;0;0
14014;8477;2474;67;11;0;11;1.000;800000;0
14014;72229;2474;44;38;6;32;.842;2800000;0
14014;77086;710;0;0;0;0;.00nan;0;0
14014;81085;710;62;13;1;12;.923;3600000;0
14015;1213;713;80;20;1;19;.950;3600000;0
14015;2720;2465;0;0;0;0;.00nan;0;0
14015;71648;713;0;0;0;0;.00nan;0;0
14015;145636;2465;35;43;7;36;.837;3600000;0
14016;2720;2465;96;36;1;35;.972;3600000;0
14016;5997;706;100;19;0;19;1.000;3600000;0
14016;8478;706;0;0;0;0;.00nan;0;0
14016;145636;2465;0;0;0;0;.00nan;0;0
14017;-1;711;0;0;0;0;.00nan;0;0
14017;37070;714;78;42;3;39;.929;3600000;0
14017;44200;711;79;15;0;15;1.000;3600000;0
14017;145787;714;0;0;0;0;.00nan;0;0
14018;1213;713;73;40;4;36;.900;3518000;0
14018;43925;712;0;0;0;0;.00nan;0;0
14018;61425;712;60;22;2;20;.909;3600000;0
14018;71648;713;0;0;0;0;.00nan;0;0
14019;883;707;0;0;0;0;.00nan;0;0
14019;8477;2474;0;0;0;0;.00nan;0;0
14019;-1;707;92;30;1;29;.967;3600000;0
14019;72229;2474;90;22;0;22;1.000;3600000;0
14020;31165;2473;83;31;2;29;.935;3900000;0
14020;77086;710;0;0;0;0;.00nan;0;0
14020;81085;710;79;32;2;30;.938;3900000;0
14020;149455;2473;0;0;0;0;.00nan;0;0
14021;1213;713;69;23;1;22;.957;3548000;0
14021;8477;2474;0;0;0;0;.00nan;0;0
14021;71648;713;0;0;0;0;.00nan;0;0
14021;72229;2474;100;41;0;41;1.000;3600000;0
14022;-1;711;0;0;0;0;.00nan;0;0
14022;43925;712;0;0;0;0;.00nan;0;0
14022;44200;711;95;20;0;20;1.000;3600000;0
14022;61425;712;81;30;1;29;.967;3600000;0
14023;883;707;86;35;2;33;.943;3589000;0
14023;-1;707;0;0;0;0;.00nan;0;0
14023;77086;710;0;0;0;0;.00nan;0;0
14023;81085;710;78;23;1;22;.957;3600000;0
14024;5997;706;66;22;2;20;.909;3600000;0
14024;8478;706;0;0;0;0;.00nan;0;0
14024;31165;2473;49;28;4;24;.857;3545000;0
14024;149455;2473;0;0;0;0;.00nan;0;0
14025;2720;2465;0;0;0;0;.00nan;0;0
14025;37070;714;44;24;4;20;.833;3526000;0
14025;145636;2465;63;20;2;18;.900;3600000;0
14025;145787;714;0;0;0;0;.00nan;0;0
14026;883;707;0;0;0;0;.00nan;0;0
14026;31165;2473;0;0;0;0;.00nan;0;0
14026;-1;707;59;30;3;27;.900;3583000;0
14026;149455;2473;66;19;2;17;.895;3600000;0
14027;5997;706;100;29;0;29;1.000;3600000;0
14027;8478;706;0;0;0;0;.00nan;0;0
14027;37070;714;0;0;0;0;.00nan;0;0
14027;145787;714;76;34;3;31;.912;3600000;0
14028;2720;2465;31;17;4;13;.765;1171000;0
14028;43925;712;0;0;0;0;.00nan;0;0
14028;61425;712;59;12;1;11;.917;3600000;0
14028;145636;2465;37;28;5;23;.821;2429000;0
14029;8477;2474;0;0;0;0;.00nan;0;0
14029;-1;711;0;0;0;0;.00nan;0;0
14029;44200;711;75;7;0;7;1.000;3600000;0
14029;72229;2474;82;39;3;36;.923;3600000;0
14030;1213;713;83;33;2;31;.939;3600000;0
14030;71648;713;0;0;0;0;.00nan;0;0
14030;77086;710;0;0;0;0;.00nan;0;0
14030;81085;710;85;38;3;35;.921;3544000;0
14031;883;707;45;42;7;35;.833;3600000;0
14031;5997;706;72;19;1;18;.947;3600000;0
14031;8478;706;0;0;0;0;.00nan;0;0
14031;-1;707;0;0;0;0;.00nan;0;0
14032;37070;714;86;34;2;32;.941;3600000;0
14032;43925;712;72;20;1;19;.950;3600000;0
14032;61425;712;0;0;0;0;.00nan;0;0
14032;145787;714;0;0;0;0;.00nan;0;0
14033;-1;711;0;0;0;0;.00nan;0;0
14033;44200;711;100;21;0;21;1.000;3600000;0
14033;77086;710;58;35;4;31;.886;3600000;0
14033;81085;710;0;0;0;0;.00nan;0;0
14034;1213;713;83;24;1;23;.958;3600000;0
14034;31165;2473;47;34;5;29;.853;3600000;0
14034;71648;713;0;0;0;0;.00nan;0;0
14034;149455;2473;0;0;0;0;.00nan;0;0
14035;2720;2465;0;0;0;0;.00nan;0;0
14035;8477;2474;0;0;0;0;.00nan;0;0
14035;72229;2474;74;34;2;32;.941;3600000;0
14035;145636;2465;55;22;3;19;.864;3554000;0
14036;-1;711;0;0;0;0;.00nan;0;0
14036;31165;2473;70;16;1;15;.938;3600000;0
14036;44200;711;78;30;2;28;.933;3600000;0
14036;149455;2473;0;0;0;0;.00nan;0;0
14037;883;707;23;9;4;5;.556;862000;0
14037;1213;713;62;18;2;16;.889;3600000;0
14037;-1;707;74;27;2;25;.926;2738000;0
14037;71648;713;0;0;0;0;.00nan;0;0
14038;8477;2474;91;35;2;33;.943;3600000;0
14038;37070;714;57;24;3;21;.875;3557000;0
14038;72229;2474;0;0;0;0;.00nan;0;0
14038;145787;714;0;0;0;0;.00nan;0;0
14039;2720;2465;45;33;5;28;.848;3600000;0
14039;77086;710;0;0;0;0;.00nan;0;0
14039;81085;710;72;19;1;18;.947;3600000;0
14039;145636;2465;0;0;0;0;.00nan;0;0
14040;5997;706;91;27;1;26;.963;3600000;0
14040;8478;706;0;0;0;0;.00nan;0;0
14040;43925;712;63;20;2;18;.900;3560000;0
14040;61425;712;0;0;0;0;.00nan;0;0
14041;883;707;90;48;3;45;.938;3549000;0
14041;-1;711;0;0;0;0;.00nan;0;0
14041;-1;707;0;0;0;0;.00nan;0;0
14041;44200;711;47;13;2;11;.846;3600000;0
14042;1213;713;59;20;2;18;.900;3537000;0
14042;5997;706;92;24;0;24;1.000;3600000;0
14042;8478;706;0;0;0;0;.00nan;0;0
14042;71648;713;0;0;0;0;.00nan;0;0
14043;2720;2465;0;0;0;0;.00nan;0;0
14043;31165;2473;39;14;3;11;.786;3600000;0
14043;145636;2465;77;49;5;44;.898;3600000;0
14043;149455;2473;0;0;0;0;.00nan;0;0
14044;37070;714;72;40;4;36;.900;3600000;0
14044;77086;710;0;0;0;0;.00nan;0;0
14044;81085;710;66;17;1;16;.941;3600000;0
14044;145787;714;0;0;0;0;.00nan;0;0
14045;8477;2474;0;0;0;0;.00nan;0;0
14045;43925;712;0;0;0;0;.00nan;0;0
14045;61425;712;63;10;1;9;.900;3600000;0
14045;72229;2474;90;44;2;42;.955;3555000;0
14046;31165;2473;60;28;3;25;.893;3568000;0
14046;37070;714;59;28;3;25;.893;3600000;0
14046;145787;714;0;0;0;0;.00nan;0;0
14046;149455;2473;0;0;0;0;.00nan;0;0
14047;1213;713;88;30;1;29;.967;3600000;0
14047;-1;711;0;0;0;0;.00nan;0;0
14047;44200;711;64;32;3;29;.906;3561000;0
14047;71648;713;0;0;0;0;.00nan;0;0
14048;883;707;0;0;0;0;.00nan;0;0
14048;2720;2465;41;2;1;1;.500;452000;0
14048;-1;707;63;27;3;24;.889;3600000;0
14048;145636;2465;19;30;7;23;.767;3148000;0
14049;5997;706;64;19;2;17;.895;3600000;0
14049;8477;2474;0;0;0;0;.00nan;0;0
14049;8478;706;0;0;0;0;.00nan;0;0
14049;72229;2474;51;32;5;27;.844;3600000;0
14050;43925;712;91;42;3;39;.929;3600000;0
14050;61425;712;0;0;0;0;.00nan;0;0
14050;77086;710;0;0;0;0;.00nan;0;0
14050;81085;710;40;23;4;19;.826;3553000;0
14051;883;707;100;34;0;34;1.000;3600000;0
14051;37070;714;50;13;2;11;.846;3517000;0
14051;-1;707;0;0;0;0;.00nan;0;0
14051;145787;714;0;0;0;0;.00nan;0;0
14052;31165;2473;59;17;2;15;.882;3600000;0
14052;43925;712;93;36;1;35;.972;3600000;0
14052;61425;712;0;0;0;0;.00nan;0;0
14052;149455;2473;0;0;0;0;.00nan;0;0
14053;8477;2474;0;0;0;0;.00nan;0;0
14053;72229;2474;59;28;2;26;.929;3900000;0
14053;77086;710;0;0;0;0;.00nan;0;0
14053;81085;710;57;17;2;15;.882;3900000;0
14054;5997;706;40;24;4;20;.833;3811000;0
14054;8478;706;0;0;0;0;.00nan;0;0
14054;-1;711;0;0;0;0;.00nan;0;0
14054;44200;711;52;24;3;21;.875;3778000;0
14055;1213;713;61;23;3;20;.870;3600000;0
14055;2720;2465;31;19;4;15;.789;1019000;0
14055;71648;713;0;0;0;0;.00nan;0;0
14055;145636;2465;78;30;2;28;.933;2581000;0
14056;8477;2474;63;16;1;15;.938;1382000;0
14056;31165;2473;0;0;0;0;.00nan;0;0
14056;72229;2474;29;28;6;22;.786;2218000;0
14056;149455;2473;70;23;2;21;.913;3600000;0
14057;1213;713;66;18;3;15;.833;3649000;0
14057;37070;714;77;40;4;36;.900;3649000;0
14057;71648;713;0;0;0;0;.00nan;0;0
14057;145787;714;0;0;0;0;.00nan;0;0
14058;2720;2465;0;0;0;0;.00nan;0;0
14058;-1;711;0;0;0;0;.00nan;0;0
14058;44200;711;47;15;3;12;.800;3900000;0
14058;145636;2465;100;55;3;52;.945;3900000;0
14059;883;707;100;42;0;42;1.000;3600000;0
14059;-1;707;0;0;0;0;.00nan;0;0
14059;43925;712;66;20;1;19;.950;3566000;0
14059;61425;712;0;0;0;0;.00nan;0;0
14060;5997;706;79;37;2;35;.946;3900000;0
14060;8478;706;0;0;0;0;.00nan;0;0
14060;77086;710;0;0;0;0;.00nan;0;0
14060;81085;710;63;21;2;19;.905;3900000;0
14061;5997;706;72;33;3;30;.909;3542000;0
14061;8478;706;0;0;0;0;.00nan;0;0
14061;31165;2473;56;9;1;8;.889;3600000;0
14061;149455;2473;0;0;0;0;.00nan;0;0
14062;-1;711;0;0;0;0;.00nan;0;0
14062;43925;712;54;39;7;32;.821;2474000;0
14062;44200;711;72;26;2;24;.923;3600000;0
14062;61425;712;57;12;1;11;.917;1126000;0
14063;883;707;78;43;4;39;.907;3535000;0
14063;-1;707;0;0;0;0;.00nan;0;0
14063;77086;710;0;0;0;0;.00nan;0;0
14063;81085;710;55;22;3;19;.864;3600000;0
14064;2720;2465;81;48;2;46;.958;3900000;0
14064;37070;714;76;25;2;23;.920;3900000;0
14064;145636;2465;0;0;0;0;.00nan;0;0
14064;145787;714;0;0;0;0;.00nan;0;0
14065;1213;713;79;24;1;23;.958;3900000;0
14065;31165;2473;87;29;1;28;.966;3900000;0
14065;71648;713;0;0;0;0;.00nan;0;0
14065;149455;2473;0;0;0;0;.00nan;0;0
14066;37070;714;93;31;1;30;.968;3600000;0
14066;43925;712;0;0;0;0;.00nan;0;0
14066;61425;712;57;27;4;23;.852;3600000;0
14066;145787;714;0;0;0;0;.00nan;0;0
14067;883;707;0;0;0;0;.00nan;0;0
14067;5997;706;79;13;0;13;1.000;3600000;0
14067;8478;706;0;0;0;0;.00nan;0;0
14067;-1;707;89;37;1;36;.973;3572000;0
14068;2720;2465;0;0;0;0;.00nan;0;0
14068;8477;2474;0;0;0;0;.00nan;0;0
14068;72229;2474;75;25;1;24;.960;3564000;0
14068;145636;2465;100;33;0;33;1.000;3600000;0
14069;-1;711;0;0;0;0;.00nan;0;0
14069;44200;711;37;27;5;22;.815;3779000;0
14069;77086;710;0;0;0;0;.00nan;0;0
14069;81085;710;94;50;4;46;.920;3779000;0
14070;5997;706;57;24;3;21;.875;3600000;0
14070;8478;706;0;0;0;0;.00nan;0;0
14070;77086;710;0;0;0;0;.00nan;0;0
14070;81085;710;62;32;4;28;.875;3600000;0
14071;2720;2465;97;46;2;44;.957;3600000;0
14071;-1;711;0;0;0;0;.00nan;0;0
14071;44200;711;71;15;1;14;.933;3600000;0
14071;145636;2465;0;0;0;0;.00nan;0;0
14072;1213;713;73;21;1;20;.952;3600000;0
14072;37070;714;0;0;0;0;.00nan;0;0
14072;71648;713;0;0;0;0;.00nan;0;0
14072;145787;714;74;36;3;33;.917;3582000;0
14073;883;707;53;15;2;13;.867;3600000;0
14073;-1;707;0;0;0;0;.00nan;0;0
14073;43925;712;56;26;3;23;.885;3562000;0
14073;61425;712;0;0;0;0;.00nan;0;0
14074;8477;2474;0;0;0;0;.00nan;0;0
14074;31165;2473;72;23;2;21;.913;3900000;0
14074;72229;2474;98;44;2;42;.955;3900000;0
14074;149455;2473;0;0;0;0;.00nan;0;0
14076;5997;706;66;28;2;26;.929;3900000;0
14076;8478;706;0;0;0;0;.00nan;0;0
14076;18801;2473;0;0;0;0;.00nan;0;0
14076;31165;2473;68;22;2;20;.909;3900000;0
14078;883;707;53;32;4;28;.875;3600000;0
14078;-1;707;0;0;0;0;.00nan;0;0
14078;43925;712;73;19;1;18;.947;3600000;0
14078;61425;712;0;0;0;0;.00nan;0;0
14080;71648;714;0;0;0;0;.00nan;0;0
14080;77086;710;71;25;2;23;.920;3600000;0
14080;81085;710;0;0;0;0;.00nan;0;0
14080;145787;714;60;36;4;32;.889;3532000;0
14082;1213;713;70;16;1;15;.938;3600000;0
14082;2720;713;0;0;0;0;.00nan;0;0
14082;145636;2465;69;42;4;38;.905;3600000;0
14082;145843;2465;0;0;0;0;.00nan;0;0
14088;5997;706;69;27;1;26;.963;2788000;0
14088;8478;706;17;6;4;2;.333;812000;0
14088;43925;712;90;32;1;31;.969;3600000;0
14088;61425;712;0;0;0;0;.00nan;0;0
14090;18801;2473;0;0;0;0;.00nan;0;0
14090;31165;2473;63;26;3;23;.885;3600000;0
14090;77086;710;0;0;0;0;.00nan;0;0
14090;81085;710;89;28;1;27;.964;3600000;0
14092;1213;713;72;20;2;18;.900;3600000;0
14092;71648;713;0;0;0;0;.00nan;0;0
14092;145787;714;75;52;5;47;.904;3600000;0
14092;145843;714;0;0;0;0;.00nan;0;0
14094;883;707;0;0;0;0;.00nan;0;0
14094;2720;2465;63;23;2;21;.913;3600000;0
14094;-1;707;94;39;3;36;.923;3543000;0
14094;145636;2465;0;0;0;0;.00nan;0;0
14096;1213;713;0;0;0;0;.00nan;0;0
14096;8477;2474;0;0;0;0;.00nan;0;0
14096;71648;713;60;29;3;26;.897;3600000;0
14096;72229;2474;74;44;4;40;.909;3583000;0
14098;5997;706;0;0;0;0;.00nan;0;0
14098;8478;706;46;25;4;21;.840;3555000;0
14098;77086;710;56;28;3;25;.893;3600000;0
14098;81085;710;0;0;0;0;.00nan;0;0
14102;883;707;52;33;5;28;.848;3600000;0
14102;-1;707;0;0;0;0;.00nan;0;0
14102;43925;712;0;0;0;0;.00nan;0;0
14102;61425;712;62;21;2;19;.905;3600000;0
14104;2720;2465;0;0;0;0;.00nan;0;0
14104;18801;2473;0;0;0;0;.00nan;0;0
14104;31165;2473;52;13;2;11;.846;3600000;0
14104;145636;2465;63;27;3;24;.889;3600000;0
14106;883;707;33;22;5;17;.773;2628000;0
14106;5997;706;47;21;3;18;.857;3600000;0
14106;8478;706;0;0;0;0;.00nan;0;0
14106;-1;707;22;9;4;5;.556;972000;0
14108;2720;2465;65;46;5;41;.891;3600000;0
14108;18801;2473;0;0;0;0;.00nan;0;0
14108;31165;2473;72;24;1;23;.958;3600000;0
14108;145636;2465;0;0;0;0;.00nan;0;0
14110;1213;713;15;27;7;20;.741;3600000;0
14110;43925;712;58;26;3;23;.885;3600000;0
14110;61425;712;0;0;0;0;.00nan;0;0
14110;71648;713;0;0;0;0;.00nan;0;0
14112;181748;711;0;0;0;0;.00nan;0;0
14112;145787;714;0;0;0;0;.00nan;0;0
14112;145843;714;62;38;4;34;.895;3600000;0
14112;156932;711;44;29;5;24;.828;3600000;0
14114;8477;2474;0;0;0;0;.00nan;0;0
14114;72229;2474;69;52;6;46;.885;3600000;0
14114;77086;710;0;0;0;0;.00nan;0;0
14114;81085;710;77;12;0;12;1.000;3600000;0
14116;2720;2465;0;0;0;0;.00nan;0;0
14116;18801;2473;0;0;0;0;.00nan;0;0
14116;31165;2473;83;36;3;33;.917;3674000;0
14116;145636;2465;62;31;4;27;.871;3674000;0
14120;1213;713;0;0;0;0;.00nan;0;0
14120;71648;713;68;19;2;17;.895;3600000;0
14120;145787;714;64;39;4;35;.897;3521000;0
14120;145843;714;0;0;0;0;.00nan;0;0
14122;43925;712;0;0;0;0;.00nan;0;0
14122;61425;712;73;31;3;28;.903;3600000;0
14122;77086;710;0;0;0;0;.00nan;0;0
14122;81085;710;8;21;6;15;.714;3600000;0
14124;5997;706;0;0;0;0;.00nan;0;0
14124;8477;2474;55;29;4;25;.862;3546000;0
14124;8478;706;58;26;3;23;.885;3600000;0
14124;72229;2474;0;0;0;0;.00nan;0;0
14126;2720;2465;76;35;2;33;.943;3582000;0
14126;18801;2473;0;0;0;0;.00nan;0;0
14126;31165;2473;86;28;1;27;.964;3600000;0
14126;145636;2465;0;0;0;0;.00nan;0;0
14128;1213;713;78;37;3;34;.919;3600000;0
14128;71648;713;0;0;0;0;.00nan;0;0
14128;77086;710;0;0;0;0;.00nan;0;0
14128;81085;710;50;24;4;20;.833;3553000;0
14130;8477;2474;0;0;0;0;.00nan;0;0
14130;72229;2474;74;36;3;33;.917;3600000;0
14130;145787;714;38;22;4;18;.818;3557000;0
14130;145843;714;0;0;0;0;.00nan;0;0
14132;5997;706;0;0;0;0;.00nan;0;0
14132;8478;706;94;19;0;19;1.000;3600000;0
14132;43925;712;88;35;2;33;.943;3550000;0
14132;61425;712;0;0;0;0;.00nan;0;0
14138;883;707;0;0;0;0;.00nan;0;0
14138;-1;707;47;24;4;20;.833;3600000;0
14138;43925;712;0;0;0;0;.00nan;0;0
14138;61425;712;28;24;5;19;.792;3600000;0
14140;1213;713;0;0;0;0;.00nan;0;0
14140;5997;706;0;0;0;0;.00nan;0;0
14140;8478;706;39;37;6;31;.838;3533000;0
14140;71648;713;52;31;4;27;.871;3600000;0
14142;77086;710;45;23;4;19;.826;3600000;0
14142;81085;710;0;0;0;0;.00nan;0;0
14142;145787;714;0;0;0;0;.00nan;0;0
14142;145843;714;50;45;6;39;.867;3578000;0
14144;2720;2465;0;0;0;0;.00nan;0;0
14144;8477;2474;90;32;1;31;.969;3600000;0
14144;72229;2474;0;0;0;0;.00nan;0;0
14144;145636;2465;60;26;3;23;.885;3561000;0
830;8477;2474;0;0;0;0;.00nan;0;0
830;-1;711;85;15;0;15;1.000;3600000;0
830;181748;711;0;0;0;0;.00nan;0;0
830;72229;2474;58;40;5;35;.875;3600000;0
831;5997;706;56;22;3;19;.864;3743000;0
831;8478;706;0;0;0;0;.00nan;0;0
831;37070;714;80;31;2;29;.935;3743000;0
831;145787;714;0;0;0;0;.00nan;0;0
832;1213;713;77;34;3;31;.912;4092000;0
832;43925;712;65;31;2;29;.935;4092000;0
832;61425;712;0;0;0;0;.00nan;0;0
832;71648;713;0;0;0;0;.00nan;0;0
833;31165;2473;82;43;4;39;.907;3600000;0
833;77086;710;0;0;0;0;.00nan;0;0
833;81085;710;76;24;1;23;.958;3600000;0
833;149455;2473;0;0;0;0;.00nan;0;0
834;8477;2474;0;0;0;0;.00nan;0;0
834;-1;711;27;16;4;12;.750;5024000;0
834;181748;711;0;0;0;0;.00nan;0;0
834;72229;2474;63;53;5;48;.906;5024000;0
835;5997;706;93;21;0;21;1.000;3600000;0
835;8478;706;0;0;0;0;.00nan;0;0
835;37070;714;23;28;6;22;.786;3600000;0
835;145787;714;0;0;0;0;.00nan;0;0
836;1213;713;52;30;5;25;.833;3600000;0
836;43925;712;75;29;2;27;.931;3600000;0
836;61425;712;0;0;0;0;.00nan;0;0
836;71648;713;0;0;0;0;.00nan;0;0
837;31165;2473;65;29;3;26;.897;3787000;0
837;77086;710;0;0;0;0;.00nan;0;0
837;81085;710;48;30;4;26;.867;3787000;0
837;149455;2473;0;0;0;0;.00nan;0;0
838;8477;2474;0;0;0;0;.00nan;0;0
838;-1;711;48;9;1;8;.889;4270000;0
838;181748;711;0;0;0;0;.00nan;0;0
838;72229;2474;93;65;2;63;.969;4270000;0
839;5997;706;75;27;2;25;.926;3600000;0
839;8478;706;0;0;0;0;.00nan;0;0
839;37070;714;79;38;3;35;.921;3571000;0
839;145787;714;0;0;0;0;.00nan;0;0
840;1213;713;50;25;3;22;.880;3583000;0
840;43925;712;77;31;2;29;.935;3600000;0
840;61425;712;0;0;0;0;.00nan;0;0
840;71648;713;0;0;0;0;.00nan;0;0
841;31165;2473;89;30;1;29;.967;3600000;0
841;77086;710;50;15;2;13;.867;3079000;0
841;81085;710;23;4;3;1;.250;521000;0
841;149455;2473;0;0;0;0;.00nan;0;0
842;8477;2474;0;0;0;0;.00nan;0;0
842;-1;711;50;7;1;6;.857;3600000;0
842;44200;711;0;0;0;0;.00nan;0;0
842;72229;2474;62;46;5;41;.891;3600000;0
843;5997;706;79;31;2;29;.935;3600000;0
843;8478;706;0;0;0;0;.00nan;0;0
843;37070;714;42;31;5;26;.839;3600000;0
843;145787;714;0;0;0;0;.00nan;0;0
844;1213;713;63;24;3;21;.875;3600000;0
844;43925;712;90;43;2;41;.953;3600000;0
844;61425;712;0;0;0;0;.00nan;0;0
844;71648;713;0;0;0;0;.00nan;0;0
845;31165;2473;70;30;3;27;.900;4126000;0
845;77086;710;0;0;0;0;.00nan;0;0
845;81085;710;80;38;2;36;.947;4126000;0
845;149455;2473;0;0;0;0;.00nan;0;0
1192;5997;706;68;23;2;21;.913;3600000;0
1192;8478;706;0;0;0;0;.00nan;0;0
1192;37070;714;94;53;3;50;.943;3551000;0
1192;145787;714;0;0;0;0;.00nan;0;0
1193;31165;2473;61;28;3;25;.893;3535000;0
1193;77086;710;67;25;2;23;.920;3600000;0
1193;81085;710;0;0;0;0;.00nan;0;0
1193;149455;2473;0;0;0;0;.00nan;0;0
1246;31165;2473;87;32;2;30;.938;4619000;0
1246;77086;710;71;28;1;27;.964;4619000;0
1246;81085;710;0;0;0;0;.00nan;0;0
1246;149455;2473;0;0;0;0;.00nan;0;0
1279;-1;711;0;0;0;0;.00nan;0;0
1279;43925;712;78;35;2;33;.943;3561000;0
1279;44200;711;58;13;1;12;.923;3600000;0
1279;61425;712;0;0;0;0;.00nan;0;0
1280;5997;706;61;24;2;22;.917;3890000;0
1280;8478;706;0;0;0;0;.00nan;0;0
1280;77086;710;82;30;1;29;.967;3890000;0
1280;81085;710;0;0;0;0;.00nan;0;0
1281;-1;711;0;0;0;0;.00nan;0;0
1281;43925;712;95;21;0;21;1.000;3600000;0
1281;44200;711;44;18;3;15;.833;3600000;0
1281;61425;712;0;0;0;0;.00nan;0;0
1282;5997;706;100;26;0;26;1.000;3600000;0
1282;8478;706;0;0;0;0;.00nan;0;0
1282;77086;710;70;33;3;30;.909;3600000;0
1282;81085;710;0;0;0;0;.00nan;0;0
1283;-1;711;0;0;0;0;.00nan;0;0
1283;43925;712;15;6;4;2;.333;294000;0
1283;44200;711;60;20;2;18;.900;3600000;0
1283;61425;712;84;40;2;38;.950;3306000;0
1284;5997;706;62;39;5;34;.872;3600000;0
1284;8478;706;0;0;0;0;.00nan;0;0
1284;77086;710;72;24;2;22;.917;3600000;0
1284;81085;710;0;0;0;0;.00nan;0;0
1285;-1;711;0;0;0;0;.00nan;0;0
1285;43925;712;0;0;0;0;.00nan;0;0
1285;44200;711;67;31;3;28;.903;3544000;0
1285;61425;712;66;27;2;25;.926;3600000;0
1286;5997;706;86;33;2;31;.939;3560000;0
1286;8478;706;0;0;0;0;.00nan;0;0
1286;77086;710;88;32;1;31;.969;3600000;0
1286;81085;710;0;0;0;0;.00nan;0;0
1545;-1;711;0;0;0;0;.00nan;0;0
1545;43925;712;0;0;0;0;.00nan;0;0
1545;44200;711;29;26;5;21;.808;5129000;0
1545;61425;712;83;61;4;57;.934;5129000;0
1546;5997;706;53;28;4;24;.857;3569000;0
1546;8478;706;0;0;0;0;.00nan;0;0
1546;77086;710;70;24;2;22;.917;3600000;0
1546;81085;710;0;0;0;0;.00nan;0;0
1613;-1;711;0;0;0;0;.00nan;0;0
1613;43925;712;61;37;5;32;.865;3164000;0
1613;44200;711;86;17;0;17;1.000;3600000;0
1613;61425;712;14;7;4;3;.429;436000;0
1629;-1;711;0;0;0;0;.00nan;0;0
1629;43925;712;72;35;3;32;.914;4408000;0
1629;44200;711;60;18;2;16;.889;4408000;0
1629;61425;712;0;0;0;0;.00nan;0;0
1654;-1;711;0;0;0;0;.00nan;0;0
1654;44200;711;94;16;0;16;1.000;3600000;0
1654;77086;710;80;36;2;34;.944;3550000;0
1654;81085;710;0;0;0;0;.00nan;0;0
1655;-1;711;0;0;0;0;.00nan;0;0
1655;44200;711;70;26;2;24;.923;3524000;0
1655;77086;710;91;20;0;20;1.000;3600000;0
1655;81085;710;0;0;0;0;.00nan;0;0
1656;-1;711;0;0;0;0;.00nan;0;0
1656;44200;711;82;15;0;15;1.000;3600000;0
1656;77086;710;80;30;1;29;.967;3556000;0
1656;81085;710;0;0;0;0;.00nan;0;0
1657;-1;711;0;0;0;0;.00nan;0;0
1657;44200;711;70;36;3;33;.917;5386000;0
1657;77086;710;97;52;2;50;.962;5386000;0
1657;81085;710;0;0;0;0;.00nan;0;0
1833;-1;711;0;0;0;0;.00nan;0;0
1833;44200;711;66;21;2;19;.905;3600000;0
1833;77086;710;57;32;3;29;.906;3600000;0
1833;81085;710;0;0;0;0;.00nan;0;0
1907;-1;711;0;0;0;0;.00nan;0;0
1907;44200;711;88;14;0;14;1.000;3600000;0
1907;77086;710;85;31;1;30;.968;3600000;0
1907;81085;710;0;0;0;0;.00nan;0;0
14145;32712;611;0;0;0;0;.00nan;0;0
14145;73396;620;0;0;0;0;.00nan;0;0
14145;73639;620;66;31;4;27;.871;3781000;0
14145;143100;611;87;36;3;33;.917;3781000;0
14146;34959;2319;0;0;0;0;.00nan;0;0
14146;56316;612;100;23;0;23;1.000;3600000;0
14146;74161;612;0;0;0;0;.00nan;0;0
14146;78262;2319;74;44;4;40;.909;3600000;0
14147;86394;619;69;28;2;26;.929;3714000;0
14147;144410;1910;90;46;3;43;.935;3714000;0
14147;148503;619;0;0;0;0;.00nan;0;0
14147;156221;1910;0;0;0;0;.00nan;0;0
14148;3075;617;57;17;2;15;.882;3600000;0
14148;173279;4644;75;39;3;36;.923;3600000;0
14148;156148;4644;0;0;0;0;.00nan;0;0
14148;156298;617;0;0;0;0;.00nan;0;0
14149;1061;2167;89;32;1;31;.969;3600000;0
14149;176206;2167;0;0;0;0;.00nan;0;0
14149;71046;614;0;0;0;0;.00nan;0;0
14149;73187;614;41;30;6;24;.800;3600000;0
14150;71046;614;0;0;0;0;.00nan;0;0
14150;73187;614;46;23;4;19;.826;3596000;0
14150;73396;620;0;0;0;0;.00nan;0;0
14150;73639;620;91;38;2;36;.947;3600000;0
14151;45323;622;0;0;0;0;.00nan;0;0
14151;144410;1910;52;8;1;7;.875;800000;0
14151;156221;1910;59;47;6;41;.872;2800000;0
14151;156322;622;53;10;1;9;.900;3600000;0
14152;3075;617;82;31;2;29;.935;3569000;0
14152;10141;2308;0;0;0;0;.00nan;0;0
14152;156254;2308;66;23;1;22;.957;3600000;0
14152;156298;617;0;0;0;0;.00nan;0;0
14153;32712;611;0;0;0;0;.00nan;0;0
14153;86394;619;63;47;6;41;.872;3561000;0
14153;143100;611;57;39;5;34;.872;3600000;0
14153;148503;619;0;0;0;0;.00nan;0;0
14154;173279;4644;79;48;4;44;.917;3600000;0
14154;56316;612;56;13;1;12;.923;3600000;0
14154;74161;612;0;0;0;0;.00nan;0;0
14154;156148;4644;0;0;0;0;.00nan;0;0
14155;1061;2167;17;8;4;4;.500;1092000;0
14155;176206;2167;47;20;4;16;.800;2451000;0
14155;34959;2319;27;30;6;24;.800;2961000;0
14155;78262;2319;53;3;0;3;1.000;639000;0
14156;32712;611;0;0;0;0;.00nan;0;0
14156;143100;611;46;24;4;20;.833;3600000;0
14156;144410;1910;79;36;2;34;.944;3112000;0
14156;156221;1910;35;12;3;9;.750;482000;0
14157;34959;2319;69;23;2;21;.913;3567000;0
14157;73396;620;96;40;1;39;.975;3600000;0
14157;73639;620;0;0;0;0;.00nan;0;0
14157;78262;2319;0;0;0;0;.00nan;0;0
14158;10141;2308;45;42;7;35;.833;3600000;0
14158;56316;612;80;51;4;47;.922;3600000;0
14158;74161;612;0;0;0;0;.00nan;0;0
14158;156254;2308;0;0;0;0;.00nan;0;0
14159;71046;614;0;0;0;0;.00nan;0;0
14159;73187;614;79;30;2;28;.933;3657000;0
14159;86394;619;79;35;3;32;.914;3657000;0
14159;148503;619;0;0;0;0;.00nan;0;0
14160;1061;2167;68;21;2;19;.905;3600000;0
14160;173279;4644;0;0;0;0;.00nan;0;0
14160;176206;2167;0;0;0;0;.00nan;0;0
14160;156148;4644;78;37;4;33;.892;3600000;0
14161;3075;617;92;62;5;57;.919;3600000;0
14161;45323;622;0;0;0;0;.00nan;0;0
14161;156298;617;0;0;0;0;.00nan;0;0
14161;156322;622;71;6;0;6;1.000;3600000;0
14162;10141;2308;75;53;5;48;.906;3590000;0
14162;45323;622;0;0;0;0;.00nan;0;0
14162;156254;2308;0;0;0;0;.00nan;0;0
14162;156322;622;34;16;4;12;.750;3600000;0
14163;71046;614;0;0;0;0;.00nan;0;0
14163;73187;614;79;25;1;24;.960;3600000;0
14163;144410;1910;0;0;0;0;.00nan;0;0
14163;156221;1910;88;60;2;58;.967;3600000;0
14164;1061;2167;57;36;5;31;.861;3664000;0
14164;10141;2308;27;24;6;18;.750;3664000;0
14164;176206;2167;0;0;0;0;.00nan;0;0
14164;156254;2308;0;0;0;0;.00nan;0;0
14165;32712;611;0;0;0;0;.00nan;0;0
14165;45323;622;0;0;0;0;.00nan;0;0
14165;143100;611;79;45;4;41;.911;3600000;0
14165;156322;622;60;13;1;12;.923;3600000;0
14166;173279;4644;69;20;1;19;.950;3600000;0
14166;73396;620;0;0;0;0;.00nan;0;0
14166;73639;620;61;20;2;18;.900;3600000;0
14166;156148;4644;0;0;0;0;.00nan;0;0
14167;34959;2319;96;51;4;47;.922;3558000;0
14167;78262;2319;0;0;0;0;.00nan;0;0
14167;86394;619;51;21;3;18;.857;3600000;0
14167;148503;619;0;0;0;0;.00nan;0;0
14168;3075;617;0;0;0;0;.00nan;0;0
14168;56316;612;72;23;1;22;.957;3600000;0
14168;74161;612;0;0;0;0;.00nan;0;0
14168;156298;617;64;42;5;37;.881;3600000;0
14169;34959;2319;22;26;6;20;.769;3600000;0
14169;78262;2319;0;0;0;0;.00nan;0;0
14169;144410;1910;87;39;3;36;.923;3600000;0
14169;156221;1910;0;0;0;0;.00nan;0;0
14170;10141;2308;0;0;0;0;.00nan;0;0
14170;73396;620;38;12;3;9;.750;1464000;0
14170;73639;620;30;15;4;11;.733;2136000;0
14170;156254;2308;58;25;3;22;.880;3600000;0
14171;32712;611;61;41;5;36;.878;3583000;0
14171;71046;614;0;0;0;0;.00nan;0;0
14171;73187;614;72;34;3;31;.912;3600000;0
14171;143100;611;0;0;0;0;.00nan;0;0
14172;173279;4644;59;35;4;31;.886;3599000;0
14172;86394;619;43;19;3;16;.842;3600000;0
14172;148503;619;0;0;0;0;.00nan;0;0
14172;156148;4644;0;0;0;0;.00nan;0;0
14173;1061;2167;63;29;4;25;.862;3600000;0
14173;3075;617;48;32;5;27;.844;3560000;0
14173;176206;2167;0;0;0;0;.00nan;0;0
14173;156298;617;0;0;0;0;.00nan;0;0
14174;45323;622;100;22;0;22;1.000;3600000;0
14174;56316;612;98;53;4;49;.925;3600000;0
14174;74161;612;0;0;0;0;.00nan;0;0
14174;156322;622;0;0;0;0;.00nan;0;0
14175;45323;622;56;23;3;20;.870;3600000;0
14175;71046;614;0;0;0;0;.00nan;0;0
14175;73187;614;52;46;5;41;.891;3600000;0
14175;156322;622;0;0;0;0;.00nan;0;0
14176;10141;2308;65;28;3;25;.893;3600000;0
14176;86394;619;100;30;0;30;1.000;3600000;0
14176;148503;619;0;0;0;0;.00nan;0;0
14176;156254;2308;0;0;0;0;.00nan;0;0
14177;1061;2167;7;15;6;9;.600;2146000;0
14177;176206;2167;47;13;2;11;.846;1454000;0
14177;56316;612;52;24;3;21;.875;3600000;0
14177;74161;612;0;0;0;0;.00nan;0;0
14178;173279;4644;0;0;0;0;.00nan;0;0
14178;144410;1910;16;8;4;4;.500;1517000;0
14178;156148;4644;50;24;3;21;.875;3600000;0
14178;156221;1910;49;26;4;22;.846;2083000;0
14179;32712;611;0;0;0;0;.00nan;0;0
14179;34959;2319;62;18;2;16;.889;3600000;0
14179;78262;2319;0;0;0;0;.00nan;0;0
14179;143100;611;43;29;5;24;.828;3600000;0
14180;3075;617;78;40;3;37;.925;3591000;0
14180;73396;620;79;36;2;34;.944;3600000;0
14180;73639;620;0;0;0;0;.00nan;0;0
14180;156298;617;0;0;0;0;.00nan;0;0
14181;10141;2308;0;0;0;0;.00nan;0;0
14181;144410;1910;44;30;5;25;.833;3540000;0
14181;156221;1910;0;0;0;0;.00nan;0;0
14181;156254;2308;52;22;3;19;.864;3600000;0
14182;56316;612;74;25;1;24;.960;3600000;0
14182;73396;620;0;0;0;0;.00nan;0;0
14182;73639;620;92;45;2;43;.956;3551000;0
14182;74161;612;0;0;0;0;.00nan;0;0
14183;173279;4644;36;18;4;14;.778;906000;0
14183;32712;611;0;0;0;0;.00nan;0;0
14183;143100;611;92;19;0;19;1.000;3600000;0
14183;156148;4644;61;23;2;21;.913;2694000;0
14184;3075;617;71;37;3;34;.919;3600000;0
14184;86394;619;97;24;0;24;1.000;3600000;0
14184;148503;619;0;0;0;0;.00nan;0;0
14184;156298;617;0;0;0;0;.00nan;0;0
14185;1061;2167;0;0;0;0;.00nan;0;0
14185;176206;2167;74;64;6;58;.906;3600000;0
14185;45323;622;0;0;0;0;.00nan;0;0
14185;156322;622;52;11;1;10;.909;3600000;0
14186;10141;2308;69;26;2;24;.923;3600000;0
14186;32712;611;0;0;0;0;.00nan;0;0
14186;143100;611;55;32;4;28;.875;3600000;0
14186;156254;2308;0;0;0;0;.00nan;0;0
14187;56316;612;82;30;2;28;.933;3633000;0
14187;74161;612;0;0;0;0;.00nan;0;0
14187;86394;619;94;46;3;43;.935;3633000;0
14187;148503;619;0;0;0;0;.00nan;0;0
14188;173279;4644;45;24;4;20;.833;3559000;0
14188;71046;614;0;0;0;0;.00nan;0;0
14188;73187;614;59;21;2;19;.905;3600000;0
14188;156148;4644;0;0;0;0;.00nan;0;0
14189;34959;2319;0;0;0;0;.00nan;0;0
14189;45323;622;0;0;0;0;.00nan;0;0
14189;78262;2319;69;37;3;34;.919;3600000;0
14189;156322;622;58;20;2;18;.900;3600000;0
14190;3075;617;0;0;0;0;.00nan;0;0
14190;144410;1910;0;0;0;0;.00nan;0;0
14190;156221;1910;71;41;5;36;.878;3600000;0
14190;156298;617;81;22;2;20;.909;3600000;0
14191;1061;2167;67;30;3;27;.900;3600000;0
14191;176206;2167;0;0;0;0;.00nan;0;0
14191;73396;620;72;26;2;24;.923;3600000;0
14191;73639;620;0;0;0;0;.00nan;0;0
14192;10141;2308;59;43;6;37;.860;3937000;0
14192;71046;614;0;0;0;0;.00nan;0;0
14192;73187;614;51;34;5;29;.853;3937000;0
14192;156254;2308;0;0;0;0;.00nan;0;0
14193;56316;612;45;26;5;21;.808;3567000;0
14193;74161;612;0;0;0;0;.00nan;0;0
14193;144410;1910;75;42;4;38;.905;3600000;0
14193;156221;1910;0;0;0;0;.00nan;0;0
14194;3075;617;78;37;3;34;.919;3584000;0
14194;32712;611;73;19;1;18;.947;3600000;0
14194;143100;611;0;0;0;0;.00nan;0;0
14194;156298;617;0;0;0;0;.00nan;0;0
14195;1061;2167;83;46;4;42;.913;3600000;0
14195;176206;2167;0;0;0;0;.00nan;0;0
14195;86394;619;0;0;0;0;.00nan;0;0
14195;148503;619;64;21;2;19;.905;3600000;0
14196;173279;4644;93;36;3;33;.917;4200000;0
14196;34959;2319;58;25;3;22;.880;4200000;0
14196;78262;2319;0;0;0;0;.00nan;0;0
14196;156148;4644;0;0;0;0;.00nan;0;0
14197;45323;622;0;0;0;0;.00nan;0;0
14197;73396;620;0;0;0;0;.00nan;0;0
14197;73639;620;72;59;6;53;.898;3600000;0
14197;156322;622;35;11;3;8;.727;3600000;0
14198;73396;620;57;6;0;6;1.000;1215000;0
14198;73639;620;12;24;6;18;.750;2385000;0
14198;86394;619;60;28;3;25;.893;3600000;0
14198;148503;619;0;0;0;0;.00nan;0;0
14199;10141;2308;39;29;5;24;.828;3000000;0
14199;34959;2319;38;22;5;17;.773;3600000;0
14199;78262;2319;0;0;0;0;.00nan;0;0
14199;156254;2308;27;6;3;3;.500;600000;0
14200;32712;611;0;0;0;0;.00nan;0;0
14200;56316;612;99;21;0;21;1.000;3600000;0
14200;74161;612;0;0;0;0;.00nan;0;0
14200;143100;611;69;54;6;48;.889;3600000;0
14201;3075;617;41;31;6;25;.806;2924000;0
14201;71046;614;0;0;0;0;.00nan;0;0
14201;73187;614;74;38;3;35;.921;3600000;0
14201;156298;617;57;5;0;5;1.000;676000;0
14202;1061;2167;65;27;3;24;.889;2989000;0
14202;176206;2167;30;7;3;4;.571;594000;0
14202;144410;1910;0;0;0;0;.00nan;0;0
14202;156221;1910;37;24;5;19;.792;3600000;0
14203;56316;612;73;20;1;19;.950;3600000;0
14203;71046;614;52;9;1;8;.889;1268000;0
14203;73187;614;38;34;6;28;.824;2332000;0
14203;74161;612;0;0;0;0;.00nan;0;0
14204;73396;620;79;28;1;27;.964;3580000;0
14204;73639;620;0;0;0;0;.00nan;0;0
14204;144410;1910;100;30;0;30;1.000;3600000;0
14204;156221;1910;0;0;0;0;.00nan;0;0
14205;1061;2167;55;33;5;28;.848;3600000;0
14205;176206;2167;0;0;0;0;.00nan;0;0
14205;32712;611;0;0;0;0;.00nan;0;0
14205;143100;611;79;26;2;24;.923;3600000;0
14206;10141;2308;0;0;0;0;.00nan;0;0
14206;173279;4644;0;0;0;0;.00nan;0;0
14206;156148;4644;89;53;4;49;.925;3547000;0
14206;156254;2308;58;22;3;19;.864;3600000;0
14207;3075;617;72;52;6;46;.885;3095000;0
14207;34959;2319;0;0;0;0;.00nan;0;0
14207;78262;2319;50;40;6;34;.850;4200000;0
14207;156298;617;56;6;0;6;1.000;1105000;0
14208;45323;622;0;0;0;0;.00nan;0;0
14208;86394;619;75;39;3;36;.923;3949000;0
14208;148503;619;0;0;0;0;.00nan;0;0
14208;156322;622;62;20;2;18;.900;3949000;0
14209;73396;620;54;30;4;26;.867;3548000;0
14209;73639;620;0;0;0;0;.00nan;0;0
14209;144410;1910;64;25;2;23;.920;3600000;0
14209;156221;1910;0;0;0;0;.00nan;0;0
14210;10141;2308;84;23;1;22;.957;3600000;0
14210;173279;4644;59;44;5;39;.886;3600000;0
14210;156148;4644;0;0;0;0;.00nan;0;0
14210;156254;2308;0;0;0;0;.00nan;0;0
14211;56316;612;56;13;2;11;.846;3652000;0
14211;71046;614;0;0;0;0;.00nan;0;0
14211;73187;614;91;37;1;36;.973;3652000;0
14211;74161;612;0;0;0;0;.00nan;0;0
14212;3075;617;0;0;0;0;.00nan;0;0
14212;34959;2319;61;26;3;23;.885;3600000;0
14212;78262;2319;0;0;0;0;.00nan;0;0
14212;156298;617;83;44;4;40;.909;3558000;0
14213;1061;2167;0;0;0;0;.00nan;0;0
14213;176206;2167;25;19;5;14;.737;3600000;0
14213;32712;611;0;0;0;0;.00nan;0;0
14213;143100;611;99;33;1;32;.970;3600000;0
14214;3075;617;82;40;3;37;.925;3549000;0
14214;71046;614;0;0;0;0;.00nan;0;0
14214;73187;614;57;18;2;16;.889;3600000;0
14214;156298;617;0;0;0;0;.00nan;0;0
14215;1061;2167;80;30;2;28;.933;3600000;0
14215;176206;2167;0;0;0;0;.00nan;0;0
14215;144410;1910;0;0;0;0;.00nan;0;0
14215;156221;1910;79;44;4;40;.909;3560000;0
14216;32712;611;81;44;4;40;.909;3426000;0
14216;56316;612;36;10;3;7;.700;3600000;0
14216;74161;612;0;0;0;0;.00nan;0;0
14216;143100;611;21;3;3;0;.000;174000;0
14217;73396;620;0;0;0;0;.00nan;0;0
14217;73639;620;63;44;5;39;.886;3569000;0
14217;86394;619;34;15;4;11;.733;3600000;0
14217;148503;619;0;0;0;0;.00nan;0;0
14218;10141;2308;0;0;0;0;.00nan;0;0
14218;34959;2319;47;22;3;19;.864;4059000;0
14218;78262;2319;0;0;0;0;.00nan;0;0
14218;156254;2308;70;42;4;38;.905;4059000;0
14219;173279;4644;57;35;4;31;.886;2015000;0
14219;45323;622;0;0;0;0;.00nan;0;0
14219;156148;4644;32;33;6;27;.818;1585000;0
14219;156322;622;72;7;0;7;1.000;3600000;0
14220;173279;4644;98;68;4;64;.941;3600000;0
14220;45323;622;0;0;0;0;.00nan;0;0
14220;156148;4644;0;0;0;0;.00nan;0;0
14220;156322;622;38;7;2;5;.714;3600000;0
14221;45323;622;0;0;0;0;.00nan;0;0
14221;73396;620;0;0;0;0;.00nan;0;0
14221;73639;620;59;40;4;36;.900;3600000;0
14221;156322;622;64;14;1;13;.929;3600000;0
14222;10141;2308;74;27;3;24;.889;3600000;0
14222;71046;614;0;0;0;0;.00nan;0;0
14222;73187;614;62;35;4;31;.886;3600000;0
14222;156254;2308;0;0;0;0;.00nan;0;0
14223;56316;612;60;26;3;23;.885;3600000;0
14223;74161;612;0;0;0;0;.00nan;0;0
14223;144410;1910;78;49;4;45;.918;3600000;0
14223;156221;1910;0;0;0;0;.00nan;0;0
14224;173279;4644;0;0;0;0;.00nan;0;0
14224;34959;2319;100;24;0;24;1.000;3600000;0
14224;78262;2319;0;0;0;0;.00nan;0;0
14224;156148;4644;62;32;4;28;.875;3600000;0
14225;3075;617;26;6;3;3;.500;225000;0
14225;32712;611;0;0;0;0;.00nan;0;0
14225;143100;611;82;36;2;34;.944;3600000;0
14225;156298;617;68;29;3;26;.897;3375000;0
14226;1061;2167;50;22;4;18;.818;3600000;0
14226;176206;2167;0;0;0;0;.00nan;0;0
14226;86394;619;100;30;0;30;1.000;3600000;0
14226;148503;619;0;0;0;0;.00nan;0;0
14227;173279;4644;72;32;3;29;.906;3585000;0
14227;71046;614;0;0;0;0;.00nan;0;0
14227;73187;614;76;23;1;22;.957;3600000;0
14227;156148;4644;0;0;0;0;.00nan;0;0
14228;1061;2167;26;29;7;22;.759;3600000;0
14228;176206;2167;0;0;0;0;.00nan;0;0
14228;73396;620;68;37;4;33;.892;3600000;0
14228;73639;620;0;0;0;0;.00nan;0;0
14229;10141;2308;97;22;0;22;1.000;3600000;0
14229;32712;611;94;31;2;29;.935;3543000;0
14229;143100;611;0;0;0;0;.00nan;0;0
14229;156254;2308;0;0;0;0;.00nan;0;0
14230;56316;612;33;17;4;13;.765;808000;0
14230;74161;612;54;28;3;25;.893;2792000;0
14230;86394;619;87;30;1;29;.967;3600000;0
14230;148503;619;0;0;0;0;.00nan;0;0
14231;34959;2319;25;12;4;8;.667;582000;0
14231;45323;622;0;0;0;0;.00nan;0;0
14231;78262;2319;65;35;3;32;.914;3018000;0
14231;156322;622;81;27;1;26;.963;3600000;0
14232;10141;2308;0;0;0;0;.00nan;0;0
14232;144410;1910;60;41;5;36;.878;3600000;0
14232;156221;1910;0;0;0;0;.00nan;0;0
14232;156254;2308;69;23;2;21;.913;3600000;0
14233;56316;612;99;23;0;23;1.000;3600000;0
14233;73396;620;0;0;0;0;.00nan;0;0
14233;73639;620;79;43;3;40;.930;3600000;0
14233;74161;612;0;0;0;0;.00nan;0;0
14234;173279;4644;0;0;0;0;.00nan;0;0
14234;32712;611;0;0;0;0;.00nan;0;0
14234;143100;611;72;22;2;20;.909;3538000;0
14234;156148;4644;100;37;0;37;1.000;3600000;0
14235;34959;2319;0;0;0;0;.00nan;0;0
14235;71046;614;0;0;0;0;.00nan;0;0
14235;73187;614;81;36;3;33;.917;3557000;0
14235;78262;2319;73;30;2;28;.933;3600000;0
14236;3075;617;56;39;5;34;.872;3559000;0
14236;86394;619;59;33;4;29;.879;3600000;0
14236;148503;619;0;0;0;0;.00nan;0;0
14236;156298;617;0;0;0;0;.00nan;0;0
14237;1061;2167;66;17;1;16;.941;992000;0
14237;176206;2167;52;44;6;38;.864;2608000;0
14237;45323;622;0;0;0;0;.00nan;0;0
14237;156322;622;76;8;0;8;1.000;3600000;0
14238;173279;4644;0;0;0;0;.00nan;0;0
14238;144410;1910;24;10;4;6;.600;946000;0
14238;156148;4644;34;32;6;26;.813;4081000;0
14238;156221;1910;60;29;3;26;.897;3135000;0
14239;3075;617;62;33;4;29;.879;3562000;0
14239;73396;620;0;0;0;0;.00nan;0;0
14239;73639;620;61;18;3;15;.833;3600000;0
14239;156298;617;0;0;0;0;.00nan;0;0
14240;10141;2308;0;0;0;0;.00nan;0;0
14240;86394;619;77;30;2;28;.933;3600000;0
14240;148503;619;0;0;0;0;.00nan;0;0
14240;156254;2308;55;25;3;22;.880;3600000;0
14241;1061;2167;96;40;2;38;.950;3600000;0
14241;176206;2167;0;0;0;0;.00nan;0;0
14241;56316;612;72;29;3;26;.897;3551000;0
14241;74161;612;0;0;0;0;.00nan;0;0
14242;45323;622;0;0;0;0;.00nan;0;0
14242;71046;614;0;0;0;0;.00nan;0;0
14242;73187;614;65;58;7;51;.879;3600000;0
14242;156322;622;87;15;0;15;1.000;3600000;0
14243;3075;617;54;39;5;34;.872;3529000;0
14243;144410;1910;71;35;3;32;.914;3600000;0
14243;156221;1910;0;0;0;0;.00nan;0;0
14243;156298;617;0;0;0;0;.00nan;0;0
14244;32712;611;0;0;0;0;.00nan;0;0
14244;71046;614;57;22;2;20;.909;3543000;0
14244;73187;614;0;0;0;0;.00nan;0;0
14244;143100;611;78;24;1;23;.958;3600000;0
14245;10141;2308;0;0;0;0;.00nan;0;0
14245;73396;620;0;0;0;0;.00nan;0;0
14245;73639;620;74;28;2;26;.929;3574000;0
14245;156254;2308;80;29;1;28;.966;3600000;0
14246;45323;622;0;0;0;0;.00nan;0;0
14246;56316;612;66;35;4;31;.886;3555000;0
14246;74161;612;0;0;0;0;.00nan;0;0
14246;156322;622;59;21;3;18;.857;3600000;0
14247;173279;4644;96;55;4;51;.927;3600000;0
14247;86394;619;57;22;3;19;.864;3600000;0
14247;148503;619;0;0;0;0;.00nan;0;0
14247;156148;4644;0;0;0;0;.00nan;0;0
14248;34959;2319;66;17;1;16;.941;3600000;0
14248;78262;2319;0;0;0;0;.00nan;0;0
14248;144410;1910;68;43;4;39;.907;3600000;0
14248;156221;1910;0;0;0;0;.00nan;0;0
14249;1061;2167;0;0;0;0;.00nan;0;0
14249;3075;617;0;0;0;0;.00nan;0;0
14249;176206;2167;50;22;4;18;.818;4200000;0
14249;156298;617;65;41;4;37;.902;4200000;0
14250;71046;614;0;0;0;0;.00nan;0;0
14250;73187;614;100;31;0;31;1.000;3600000;0
14250;144410;1910;0;0;0;0;.00nan;0;0
14250;156221;1910;47;31;5;26;.839;3600000;0
14251;173279;4644;81;33;2;31;.939;3600000;0
14251;73396;620;0;0;0;0;.00nan;0;0
14251;73639;620;47;21;3;18;.857;3558000;0
14251;156148;4644;0;0;0;0;.00nan;0;0
14252;3075;617;63;38;4;34;.895;2003000;0
14252;56316;612;56;19;2;17;.895;3600000;0
14252;74161;612;0;0;0;0;.00nan;0;0
14252;156298;617;63;17;1;16;.941;1597000;0
14253;34959;2319;83;30;2;28;.933;3549000;0
14253;78262;2319;0;0;0;0;.00nan;0;0
14253;86394;619;89;26;1;25;.962;3600000;0
14253;148503;619;0;0;0;0;.00nan;0;0
14254;1061;2167;50;37;5;32;.865;3600000;0
14254;10141;2308;0;0;0;0;.00nan;0;0
14254;176206;2167;0;0;0;0;.00nan;0;0
14254;156254;2308;52;19;3;16;.842;3600000;0
14255;32712;611;0;0;0;0;.00nan;0;0
14255;45323;622;0;0;0;0;.00nan;0;0
14255;143100;611;64;44;4;40;.909;3600000;0
14255;156322;622;75;23;1;22;.957;3600000;0
14256;71046;614;0;0;0;0;.00nan;0;0
14256;73187;614;50;36;5;31;.861;3600000;0
14256;86394;619;75;30;3;27;.900;3600000;0
14256;148503;619;0;0;0;0;.00nan;0;0
14257;10141;2308;0;0;0;0;.00nan;0;0
14257;56316;612;83;23;1;22;.957;3600000;0
14257;74161;612;0;0;0;0;.00nan;0;0
14257;156254;2308;93;47;2;45;.957;3559000;0
14258;32712;611;44;25;4;21;.840;3949000;0
14258;143100;611;0;0;0;0;.00nan;0;0
14258;144410;1910;82;35;3;32;.914;3949000;0
14258;156221;1910;0;0;0;0;.00nan;0;0
14259;1061;2167;60;23;3;20;.870;3600000;0
14259;173279;4644;49;34;5;29;.853;3589000;0
14259;176206;2167;0;0;0;0;.00nan;0;0
14259;156148;4644;0;0;0;0;.00nan;0;0
14260;34959;2319;39;29;6;23;.793;2287000;0
14260;73396;620;0;0;0;0;.00nan;0;0
14260;73639;620;53;23;4;19;.826;3600000;0
14260;78262;2319;64;10;0;10;1.000;1233000;0
14261;3075;617;47;39;6;33;.846;2142000;0
14261;45323;622;0;0;0;0;.00nan;0;0
14261;156298;617;22;25;6;19;.760;1458000;0
14261;156322;622;69;13;1;12;.923;3600000;0
14262;71046;614;0;0;0;0;.00nan;0;0
14262;73187;614;100;33;0;33;1.000;3600000;0
14262;73396;620;0;0;0;0;.00nan;0;0
14262;73639;620;67;39;4;35;.897;3600000;0
14263;173279;4644;84;54;5;49;.907;3600000;0
14263;56316;612;64;11;1;10;.909;3600000;0
14263;74161;612;0;0;0;0;.00nan;0;0
14263;156148;4644;0;0;0;0;.00nan;0;0
14264;32712;611;0;0;0;0;.00nan;0;0
14264;86394;619;57;25;3;22;.880;3600000;0
14264;143100;611;78;39;4;35;.897;3600000;0
14264;148503;619;0;0;0;0;.00nan;0;0
14265;3075;617;47;31;5;26;.839;3591000;0
14265;10141;2308;0;0;0;0;.00nan;0;0
14265;156254;2308;41;18;4;14;.778;3600000;0
14265;156298;617;0;0;0;0;.00nan;0;0
14266;1061;2167;59;6;0;6;1.000;680000;0
14266;176206;2167;39;31;6;25;.806;2920000;0
14266;34959;2319;60;23;2;21;.913;3600000;0
14266;78262;2319;0;0;0;0;.00nan;0;0
14267;45323;622;74;11;0;11;1.000;3600000;0
14267;144410;1910;37;26;5;21;.808;2154000;0
14267;156221;1910;68;23;1;22;.957;1446000;0
14267;156322;622;0;0;0;0;.00nan;0;0
14268;1061;2167;98;42;1;41;.976;4200000;0
14268;176206;2167;0;0;0;0;.00nan;0;0
14268;71046;614;0;0;0;0;.00nan;0;0
14268;73187;614;80;26;1;25;.962;4200000;0
14269;86394;619;90;17;0;17;1.000;3600000;0
14269;144410;1910;37;12;3;9;.750;585000;0
14269;148503;619;0;0;0;0;.00nan;0;0
14269;156221;1910;97;38;1;37;.974;3015000;0
14270;10141;2308;92;49;4;45;.918;3600000;0
14270;45323;622;58;15;1;14;.933;3600000;0
14270;156254;2308;0;0;0;0;.00nan;0;0
14270;156322;622;0;0;0;0;.00nan;0;0
14271;32712;611;65;17;1;16;.941;3600000;0
14271;73396;620;0;0;0;0;.00nan;0;0
14271;73639;620;66;41;5;36;.878;3600000;0
14271;143100;611;0;0;0;0;.00nan;0;0
14272;3075;617;62;24;3;21;.875;3600000;0
14272;173279;4644;37;26;5;21;.808;3593000;0
14272;156148;4644;0;0;0;0;.00nan;0;0
14272;156298;617;0;0;0;0;.00nan;0;0
14273;34959;2319;49;19;3;16;.842;3533000;0
14273;56316;612;100;34;1;33;.971;3600000;0
14273;74161;612;0;0;0;0;.00nan;0;0
14273;78262;2319;0;0;0;0;.00nan;0;0
14274;3075;617;0;0;0;0;.00nan;0;0
14274;71046;614;0;0;0;0;.00nan;0;0
14274;73187;614;82;28;2;26;.929;3600000;0
14274;156298;617;54;28;4;24;.857;3519000;0
14275;86394;619;92;20;0;20;1.000;3600000;0
14275;144410;1910;0;0;0;0;.00nan;0;0
14275;148503;619;0;0;0;0;.00nan;0;0
14275;156221;1910;68;46;5;41;.891;3600000;0
14276;10141;2308;0;0;0;0;.00nan;0;0
14276;73396;620;72;34;3;31;.912;3600000;0
14276;73639;620;0;0;0;0;.00nan;0;0
14276;156254;2308;39;28;5;23;.821;3567000;0
14277;32712;611;0;0;0;0;.00nan;0;0
14277;56316;612;0;0;0;0;.00nan;0;0
14277;74161;612;39;17;3;14;.824;3600000;0
14277;143100;611;100;41;0;41;1.000;3600000;0
14278;1061;2167;0;0;0;0;.00nan;0;0
14278;173279;4644;69;52;5;47;.904;4160000;0
14278;176206;2167;47;36;5;31;.861;4200000;0
14278;156148;4644;0;0;0;0;.00nan;0;0
14279;34959;2319;97;59;3;56;.949;3600000;0
14279;45323;622;0;0;0;0;.00nan;0;0
14279;78262;2319;0;0;0;0;.00nan;0;0
14279;156322;622;61;13;1;12;.923;3600000;0
14280;10141;2308;67;30;3;27;.900;3600000;0
14280;71046;614;0;0;0;0;.00nan;0;0
14280;73187;614;46;35;5;30;.857;3537000;0
14280;156254;2308;0;0;0;0;.00nan;0;0
14281;32712;611;0;0;0;0;.00nan;0;0
14281;143100;611;79;24;1;23;.958;3600000;0
14281;144410;1910;56;26;4;22;.846;3600000;0
14281;156221;1910;0;0;0;0;.00nan;0;0
14282;45323;622;0;0;0;0;.00nan;0;0
14282;86394;619;41;23;4;19;.826;3600000;0
14282;148503;619;0;0;0;0;.00nan;0;0
14282;156322;622;89;15;0;15;1.000;3600000;0
14283;173279;4644;0;0;0;0;.00nan;0;0
14283;73396;620;0;0;0;0;.00nan;0;0
14283;73639;620;83;43;3;40;.930;3704000;0
14283;156148;4644;49;22;4;18;.818;3704000;0
14284;1061;2167;93;47;2;45;.957;4078000;0
14284;176206;2167;0;0;0;0;.00nan;0;0
14284;34959;2319;76;17;1;16;.941;4078000;0
14284;78262;2319;0;0;0;0;.00nan;0;0
14285;3075;617;39;31;5;26;.839;1746000;0
14285;56316;612;64;22;2;20;.909;3600000;0
14285;74161;612;0;0;0;0;.00nan;0;0
14285;156298;617;76;27;1;26;.963;1854000;0
14286;173279;4644;91;47;3;44;.936;3600000;0
14286;71046;614;0;0;0;0;.00nan;0;0
14286;73187;614;93;19;0;19;1.000;3600000;0
14286;156148;4644;0;0;0;0;.00nan;0;0
14287;34959;2319;66;19;1;18;.947;3600000;0
14287;73396;620;0;0;0;0;.00nan;0;0
14287;73639;620;74;44;4;40;.909;3600000;0
14287;78262;2319;0;0;0;0;.00nan;0;0
14288;56316;612;51;16;3;13;.813;3600000;0
14288;74161;612;0;0;0;0;.00nan;0;0
14288;144410;1910;0;0;0;0;.00nan;0;0
14288;156221;1910;56;40;5;35;.875;3600000;0
14289;3075;617;41;39;6;33;.846;2929000;0
14289;10141;2308;0;0;0;0;.00nan;0;0
14289;156254;2308;49;22;3;19;.864;3600000;0
14289;156298;617;50;7;1;6;.857;671000;0
14290;1061;2167;78;50;5;45;.900;3600000;0
14290;176206;2167;0;0;0;0;.00nan;0;0
14290;86394;619;73;24;2;22;.917;3600000;0
14290;148503;619;0;0;0;0;.00nan;0;0
14291;32712;611;0;0;0;0;.00nan;0;0
14291;45323;622;0;0;0;0;.00nan;0;0
14291;143100;611;92;68;5;63;.926;3600000;0
14291;156322;622;58;13;1;12;.923;3600000;0
14292;45323;622;0;0;0;0;.00nan;0;0
14292;144410;1910;0;0;0;0;.00nan;0;0
14292;156221;1910;89;56;4;52;.929;3600000;0
14292;156322;622;48;7;1;6;.857;3600000;0
14293;10141;2308;31;15;4;11;.733;901000;0
14293;56316;612;69;24;2;22;.917;3600000;0
14293;74161;612;0;0;0;0;.00nan;0;0
14293;156254;2308;63;34;3;31;.912;2699000;0
14294;1061;2167;17;23;6;17;.739;1799000;0
14294;176206;2167;59;13;1;12;.923;1801000;0
14294;32712;611;0;0;0;0;.00nan;0;0
14294;143100;611;88;30;2;28;.933;3600000;0
14295;73396;620;0;0;0;0;.00nan;0;0
14295;73639;620;89;45;3;42;.933;3576000;0
14295;86394;619;52;13;2;11;.846;3600000;0
14295;148503;619;0;0;0;0;.00nan;0;0
14296;3075;617;74;46;4;42;.913;3562000;0
14296;173279;4644;73;28;2;26;.929;3600000;0
14296;156148;4644;0;0;0;0;.00nan;0;0
14296;156298;617;0;0;0;0;.00nan;0;0
14297;34959;2319;0;0;0;0;.00nan;0;0
14297;71046;614;0;0;0;0;.00nan;0;0
14297;73187;614;72;34;2;32;.941;3600000;0
14297;78262;2319;70;34;3;31;.912;3587000;0
14298;71046;614;0;0;0;0;.00nan;0;0
14298;73187;614;100;41;2;39;.951;3600000;0
14298;86394;619;60;28;4;24;.857;3564000;0
14298;148503;619;0;0;0;0;.00nan;0;0
14299;32712;611;0;0;0;0;.00nan;0;0
14299;73396;620;77;37;3;34;.919;3600000;0
14299;73639;620;0;0;0;0;.00nan;0;0
14299;143100;611;68;22;2;20;.909;3600000;0
14300;10141;2308;0;0;0;0;.00nan;0;0
14300;173279;4644;42;40;6;34;.850;3600000;0
14300;156148;4644;0;0;0;0;.00nan;0;0
14300;156254;2308;69;28;2;26;.929;3600000;0
14301;45323;622;0;0;0;0;.00nan;0;0
14301;56316;612;40;36;6;30;.833;3600000;0
14301;74161;612;0;0;0;0;.00nan;0;0
14301;156322;622;60;25;3;22;.880;3600000;0
14302;3075;617;41;46;7;39;.848;3600000;0
14302;34959;2319;82;16;0;16;1.000;3600000;0
14302;78262;2319;0;0;0;0;.00nan;0;0
14302;156298;617;0;0;0;0;.00nan;0;0
14303;1061;2167;65;38;4;34;.895;3772000;0
14303;176206;2167;0;0;0;0;.00nan;0;0
14303;144410;1910;0;0;0;0;.00nan;0;0
14303;156221;1910;53;29;5;24;.828;3772000;0
14304;73396;620;0;0;0;0;.00nan;0;0
14304;73639;620;43;42;7;35;.833;3955000;0
14304;144410;1910;0;0;0;0;.00nan;0;0
14304;156221;1910;48;40;6;34;.850;3955000;0
14305;32712;611;0;0;0;0;.00nan;0;0
14305;71046;614;0;0;0;0;.00nan;0;0
14305;73187;614;47;27;4;23;.852;3600000;0
14305;143100;611;81;40;3;37;.925;3600000;0
14306;3075;617;62;45;5;40;.889;3600000;0
14306;86394;619;0;0;0;0;.00nan;0;0
14306;148503;619;100;22;0;22;1.000;3600000;0
14306;156298;617;0;0;0;0;.00nan;0;0
14307;173279;4644;43;36;6;30;.833;3050000;0
14307;56316;612;53;20;3;17;.850;3600000;0
14307;74161;612;0;0;0;0;.00nan;0;0
14307;156148;4644;48;11;1;10;.909;550000;0
14308;10141;2308;0;0;0;0;.00nan;0;0
14308;34959;2319;39;26;5;21;.808;4200000;0
14308;78262;2319;0;0;0;0;.00nan;0;0
14308;156254;2308;48;38;5;33;.868;4200000;0
14309;1061;2167;26;26;6;20;.769;1829000;0
14309;176206;2167;71;33;3;30;.909;1771000;0
14309;45323;622;0;0;0;0;.00nan;0;0
14309;156322;622;72;7;0;7;1.000;3600000;0
14310;71046;614;0;0;0;0;.00nan;0;0
14310;73187;614;60;24;2;22;.917;3600000;0
14310;144410;1910;0;0;0;0;.00nan;0;0
14310;156221;1910;48;35;5;30;.857;3600000;0
14311;45323;622;0;0;0;0;.00nan;0;0
14311;73396;620;31;9;3;6;.667;908000;0
14311;73639;620;38;36;6;30;.833;2692000;0
14311;156322;622;41;15;3;12;.800;3600000;0
14312;10141;2308;98;48;2;46;.958;3566000;0
14312;86394;619;0;0;0;0;.00nan;0;0
14312;148503;619;89;29;1;28;.966;3600000;0
14312;156254;2308;0;0;0;0;.00nan;0;0
14313;1061;2167;75;51;5;46;.902;3600000;0
14313;176206;2167;0;0;0;0;.00nan;0;0
14313;56316;612;87;13;0;13;1.000;3600000;0
14313;74161;612;0;0;0;0;.00nan;0;0
14314;173279;4644;38;31;6;25;.806;2340000;0
14314;34959;2319;20;21;6;15;.714;3600000;0
14314;78262;2319;0;0;0;0;.00nan;0;0
14314;156148;4644;58;14;1;13;.929;1245000;0
14315;3075;617;0;0;0;0;.00nan;0;0
14315;32712;611;0;0;0;0;.00nan;0;0
14315;143100;611;90;30;1;29;.967;3600000;0
14315;156298;617;68;44;5;39;.886;3600000;0
14316;3075;617;65;27;2;25;.926;3838000;0
14316;144410;1910;0;0;0;0;.00nan;0;0
14316;156221;1910;72;30;3;27;.900;3838000;0
14316;156298;617;0;0;0;0;.00nan;0;0
14317;10141;2308;45;32;5;27;.844;3190000;0
14317;32712;611;0;0;0;0;.00nan;0;0
14317;143100;611;69;35;3;32;.914;3600000;0
14317;156254;2308;25;6;3;3;.500;410000;0
14318;173279;4644;98;46;1;45;.978;3551000;0
14318;86394;619;100;25;0;25;1.000;3600000;0
14318;148503;619;0;0;0;0;.00nan;0;0
14318;156148;4644;0;0;0;0;.00nan;0;0
14319;34959;2319;74;41;4;37;.902;4074000;0
14319;56316;612;44;18;3;15;.833;4074000;0
14319;74161;612;0;0;0;0;.00nan;0;0
14319;78262;2319;0;0;0;0;.00nan;0;0
14320;1061;2167;82;46;4;42;.913;3578000;0
14320;176206;2167;0;0;0;0;.00nan;0;0
14320;73396;620;0;0;0;0;.00nan;0;0
14320;73639;620;64;26;3;23;.885;3600000;0
14321;45323;622;54;13;2;11;.846;3600000;0
14321;71046;614;0;0;0;0;.00nan;0;0
14321;73187;614;70;38;4;34;.895;3563000;0
14321;156322;622;0;0;0;0;.00nan;0;0
14322;1061;2167;0;0;0;0;.00nan;0;0
14322;176206;2167;78;38;3;35;.921;3574000;0
14322;71046;614;0;0;0;0;.00nan;0;0
14322;73187;614;64;23;2;21;.913;3600000;0
14323;10141;2308;45;17;3;14;.824;3600000;0
14323;144410;1910;63;38;5;33;.868;2828000;0
14323;156221;1910;20;15;5;10;.667;772000;0
14323;156254;2308;0;0;0;0;.00nan;0;0
14324;56316;612;84;22;1;21;.955;3600000;0
14324;73396;620;0;0;0;0;.00nan;0;0
14324;73639;620;63;48;5;43;.896;3600000;0
14324;74161;612;0;0;0;0;.00nan;0;0
14325;173279;4644;0;0;0;0;.00nan;0;0
14325;32712;611;0;0;0;0;.00nan;0;0
14325;143100;611;87;17;0;17;1.000;3600000;0
14325;156148;4644;45;39;6;33;.846;3600000;0
14326;34959;2319;0;0;0;0;.00nan;0;0
14326;78262;2319;74;41;3;38;.927;4200000;0
14326;86394;619;63;30;3;27;.900;4200000;0
14326;148503;619;0;0;0;0;.00nan;0;0
14327;3075;617;73;45;4;41;.911;3600000;0
14327;45323;622;0;0;0;0;.00nan;0;0
14327;156298;617;0;0;0;0;.00nan;0;0
14327;156322;622;68;24;2;22;.917;3600000;0
14328;173279;4644;65;25;2;23;.920;3600000;0
14328;144410;1910;0;0;0;0;.00nan;0;0
14328;156148;4644;0;0;0;0;.00nan;0;0
14328;156221;1910;42;40;7;33;.825;3600000;0
14329;71046;614;65;12;0;12;1.000;1224000;0
14329;73187;614;15;17;6;11;.647;2289000;0
14329;73396;620;0;0;0;0;.00nan;0;0
14329;73639;620;59;35;4;31;.886;3600000;0
14330;32712;611;0;0;0;0;.00nan;0;0
14330;34959;2319;55;26;4;22;.846;3515000;0
14330;78262;2319;0;0;0;0;.00nan;0;0
14330;143100;611;77;27;2;25;.926;3600000;0
14331;56316;612;83;28;1;27;.964;3600000;0
14331;74161;612;0;0;0;0;.00nan;0;0
14331;86394;619;77;30;2;28;.933;3569000;0
14331;148503;619;0;0;0;0;.00nan;0;0
14332;1061;2167;46;23;4;19;.826;3514000;0
14332;3075;617;79;31;2;29;.935;3600000;0
14332;176206;2167;0;0;0;0;.00nan;0;0
14332;156298;617;0;0;0;0;.00nan;0;0
14333;10141;2308;0;0;0;0;.00nan;0;0
14333;45323;622;0;0;0;0;.00nan;0;0
14333;156254;2308;41;30;5;25;.833;3600000;0
14333;156322;622;73;16;1;15;.938;3600000;0
14334;1061;2167;78;29;2;27;.931;3583000;0
14334;10141;2308;0;0;0;0;.00nan;0;0
14334;176206;2167;0;0;0;0;.00nan;0;0
14334;156254;2308;100;28;0;28;1.000;3600000;0
14335;56316;612;70;17;1;16;.941;3600000;0
14335;71046;614;43;10;2;8;.800;855000;0
14335;73187;614;80;52;6;46;.885;2745000;0
14335;74161;612;0;0;0;0;.00nan;0;0
14336;32712;611;0;0;0;0;.00nan;0;0
14336;86394;619;42;18;3;15;.833;3600000;0
14336;143100;611;100;35;0;35;1.000;3600000;0
14336;148503;619;0;0;0;0;.00nan;0;0
14337;173279;4644;60;40;5;35;.875;3600000;0
14337;45323;622;0;0;0;0;.00nan;0;0
14337;156148;4644;0;0;0;0;.00nan;0;0
14337;156322;622;95;18;0;18;1.000;3600000;0
14338;34959;2319;80;35;2;33;.943;4021000;0
14338;78262;2319;0;0;0;0;.00nan;0;0
14338;144410;1910;0;0;0;0;.00nan;0;0
14338;156221;1910;90;46;3;43;.935;4021000;0
14339;3075;617;0;0;0;0;.00nan;0;0
14339;73396;620;48;0;0;0;.00nan;289000;0
14339;73639;620;10;27;7;20;.741;3311000;0
14339;156298;617;78;32;2;30;.938;3600000;0
14340;34959;2319;100;27;0;27;1.000;3600000;0
14340;71046;614;0;0;0;0;.00nan;0;0
14340;73187;614;55;34;4;30;.882;3600000;0
14340;78262;2319;0;0;0;0;.00nan;0;0
14341;10141;2308;0;0;0;0;.00nan;0;0
14341;71046;614;0;0;0;0;.00nan;0;0
14341;73187;614;56;41;5;36;.878;4193000;0
14341;156254;2308;41;25;4;21;.840;4193000;0
14342;32712;611;0;0;0;0;.00nan;0;0
14342;143100;611;100;22;0;22;1.000;3600000;0
14342;144410;1910;44;28;4;24;.857;3600000;0
14342;156221;1910;0;0;0;0;.00nan;0;0
14343;173279;4644;39;22;4;18;.818;4129000;0
14343;73396;620;77;45;3;42;.933;4098000;0
14343;73639;620;0;0;0;0;.00nan;0;0
14343;156148;4644;0;0;0;0;.00nan;0;0
14344;3075;617;87;29;1;28;.966;3600000;0
14344;56316;612;61;24;3;21;.875;3580000;0
14344;74161;612;0;0;0;0;.00nan;0;0
14344;156298;617;0;0;0;0;.00nan;0;0
14345;1061;2167;0;0;0;0;.00nan;0;0
14345;176206;2167;54;35;4;31;.886;3600000;0
14345;34959;2319;74;22;1;21;.955;3600000;0
14345;78262;2319;0;0;0;0;.00nan;0;0
14346;45323;622;0;0;0;0;.00nan;0;0
14346;86394;619;66;65;8;57;.877;3600000;0
14346;148503;619;0;0;0;0;.00nan;0;0
14346;156322;622;51;15;2;13;.867;3600000;0
14347;56316;612;52;14;2;12;.857;3600000;0
14347;74161;612;0;0;0;0;.00nan;0;0
14347;144410;1910;0;0;0;0;.00nan;0;0
14347;156221;1910;82;52;5;47;.904;3600000;0
14348;3075;617;29;39;7;32;.821;3600000;0
14348;10141;2308;59;30;4;26;.867;3600000;0
14348;156254;2308;0;0;0;0;.00nan;0;0
14348;156298;617;0;0;0;0;.00nan;0;0
14349;32712;611;0;0;0;0;.00nan;0;0
14349;45323;622;0;0;0;0;.00nan;0;0
14349;143100;611;98;59;3;56;.949;3600000;0
14349;156322;622;86;14;0;14;1.000;3600000;0
14350;1061;2167;91;42;1;41;.976;3600000;0
14350;176206;2167;0;0;0;0;.00nan;0;0
14350;86394;619;36;26;5;21;.808;3600000;0
14350;148503;619;0;0;0;0;.00nan;0;0
14351;173279;4644;76;35;2;33;.943;3560000;0
14351;71046;614;0;0;0;0;.00nan;0;0
14351;73187;614;100;36;1;35;.972;3600000;0
14351;156148;4644;0;0;0;0;.00nan;0;0
14352;34959;2319;67;15;1;14;.933;3600000;0
14352;73396;620;46;40;6;34;.850;3600000;0
14352;73639;620;0;0;0;0;.00nan;0;0
14352;78262;2319;0;0;0;0;.00nan;0;0
14353;34959;2319;14;15;5;10;.667;2064000;0
14353;71046;614;0;0;0;0;.00nan;0;0
14353;73187;614;63;22;2;20;.909;3600000;0
14353;78262;2319;55;13;1;12;.923;1536000;0
14354;73396;620;61;30;3;27;.900;2498000;0
14354;73639;620;30;20;4;16;.800;1102000;0
14354;86394;619;42;12;3;9;.750;3600000;0
14354;148503;619;0;0;0;0;.00nan;0;0
14355;10141;2308;0;0;0;0;.00nan;0;0
14355;56316;612;77;25;1;24;.960;3600000;0
14355;74161;612;0;0;0;0;.00nan;0;0
14355;156254;2308;96;51;3;48;.941;3557000;0
14356;3075;617;0;0;0;0;.00nan;0;0
14356;173279;4644;77;33;3;30;.909;3973000;0
14356;156148;4644;0;0;0;0;.00nan;0;0
14356;156298;617;88;34;2;32;.941;3973000;0
14357;1061;2167;64;27;4;23;.852;3543000;0
14357;176206;2167;0;0;0;0;.00nan;0;0
14357;32712;611;0;0;0;0;.00nan;0;0
14357;143100;611;57;27;3;24;.889;3600000;0
14358;45323;622;0;0;0;0;.00nan;0;0
14358;144410;1910;0;0;0;0;.00nan;0;0
14358;156221;1910;49;27;4;23;.852;3600000;0
14358;156322;622;77;25;2;23;.920;3600000;0
14359;1061;2167;56;39;5;34;.872;3600000;0
14359;176206;2167;0;0;0;0;.00nan;0;0
14359;144410;1910;0;0;0;0;.00nan;0;0
14359;156221;1910;83;28;1;27;.964;3600000;0
14360;32712;611;55;33;4;29;.879;4200000;0
14360;73396;620;0;0;0;0;.00nan;0;0
14360;73639;620;49;27;4;23;.852;4200000;0
14360;143100;611;0;0;0;0;.00nan;0;0
14361;71046;614;0;0;0;0;.00nan;0;0
14361;73187;614;54;24;3;21;.875;3600000;0
14361;86394;619;100;41;0;41;1.000;3600000;0
14361;148503;619;0;0;0;0;.00nan;0;0
14362;10141;2308;64;21;2;19;.905;3600000;0
14362;173279;4644;40;33;6;27;.818;3600000;0
14362;156148;4644;0;0;0;0;.00nan;0;0
14362;156254;2308;0;0;0;0;.00nan;0;0
14363;3075;617;61;34;4;30;.882;3600000;0
14363;34959;2319;0;0;0;0;.00nan;0;0
14363;78262;2319;68;21;1;20;.952;3600000;0
14363;156298;617;0;0;0;0;.00nan;0;0
14364;45323;622;49;21;3;18;.857;3600000;0
14364;56316;612;59;47;6;41;.872;3331000;0
14364;74161;612;52;3;0;3;1.000;269000;0
14364;156322;622;0;0;0;0;.00nan;0;0
14365;32712;611;0;0;0;0;.00nan;0;0
14365;71046;614;0;0;0;0;.00nan;0;0
14365;73187;614;70;27;2;25;.926;3600000;0
14365;143100;611;82;37;3;34;.919;3567000;0
14366;73396;620;83;34;2;32;.941;3600000;0
14366;73639;620;0;0;0;0;.00nan;0;0
14366;144410;1910;49;7;1;6;.857;581000;0
14366;156221;1910;26;32;6;26;.813;3019000;0
14367;10141;2308;0;0;0;0;.00nan;0;0
14367;34959;2319;80;28;1;27;.964;3600000;0
14367;78262;2319;0;0;0;0;.00nan;0;0
14367;156254;2308;100;40;0;40;1.000;3600000;0
14368;173279;4644;52;46;6;40;.870;3600000;0
14368;56316;612;94;21;0;21;1.000;3600000;0
14368;74161;612;0;0;0;0;.00nan;0;0
14368;156148;4644;0;0;0;0;.00nan;0;0
14369;3075;617;0;0;0;0;.00nan;0;0
14369;86394;619;55;29;5;24;.828;3971000;0
14369;148503;619;0;0;0;0;.00nan;0;0
14369;156298;617;60;40;4;36;.900;3943000;0
14370;1061;2167;42;42;7;35;.833;2516000;0
14370;176206;2167;71;15;0;15;1.000;1084000;0
14370;45323;622;0;0;0;0;.00nan;0;0
14370;156322;622;64;17;1;16;.941;3600000;0
14371;71046;614;0;0;0;0;.00nan;0;0
14371;73187;614;79;28;2;26;.929;3600000;0
14371;144410;1910;49;23;3;20;.870;3600000;0
14371;156221;1910;0;0;0;0;.00nan;0;0
14372;3075;617;50;28;4;24;.857;2371000;0
14372;32712;611;0;0;0;0;.00nan;0;0
14372;143100;611;61;31;4;27;.871;3600000;0
14372;156298;617;54;16;2;14;.875;1229000;0
14373;10141;2308;0;0;0;0;.00nan;0;0
14373;86394;619;0;0;0;0;.00nan;0;0
14373;148503;619;35;41;7;34;.829;3600000;0
14373;156254;2308;71;34;4;30;.882;3600000;0
14374;173279;4644;68;36;3;33;.917;3582000;0
14374;34959;2319;77;26;1;25;.962;3600000;0
14374;78262;2319;0;0;0;0;.00nan;0;0
14374;156148;4644;0;0;0;0;.00nan;0;0
14375;1061;2167;0;0;0;0;.00nan;0;0
14375;176206;2167;82;58;5;53;.914;3600000;0
14375;56316;612;98;26;0;26;1.000;3600000;0
14375;74161;612;0;0;0;0;.00nan;0;0
14376;45323;622;0;0;0;0;.00nan;0;0
14376;73396;620;86;57;4;53;.930;3600000;0
14376;73639;620;0;0;0;0;.00nan;0;0
14376;156322;622;63;11;1;10;.909;3600000;0
14377;45323;622;0;0;0;0;.00nan;0;0
14377;71046;614;30;24;5;19;.792;1839000;0
14377;73187;614;48;22;3;19;.864;1761000;0
14377;156322;622;63;13;1;12;.923;3600000;0
14378;1061;2167;71;33;3;30;.909;3600000;0
14378;176206;2167;0;0;0;0;.00nan;0;0
14378;73396;620;0;0;0;0;.00nan;0;0
14378;73639;620;100;21;0;21;1.000;3600000;0
14379;10141;2308;84;31;1;30;.968;3600000;0
14379;32712;611;0;0;0;0;.00nan;0;0
14379;143100;611;81;27;2;25;.926;3584000;0
14379;156254;2308;0;0;0;0;.00nan;0;0
14380;34959;2319;53;26;3;23;.885;3559000;0
14380;56316;612;82;33;2;31;.939;3600000;0
14380;74161;612;0;0;0;0;.00nan;0;0
14380;78262;2319;0;0;0;0;.00nan;0;0
14381;173279;4644;0;0;0;0;.00nan;0;0
14381;86394;619;56;20;2;18;.900;3570000;0
14381;148503;619;0;0;0;0;.00nan;0;0
14381;156148;4644;75;24;1;23;.958;3600000;0
14382;3075;617;91;46;2;44;.957;3600000;0
14382;144410;1910;0;0;0;0;.00nan;0;0
14382;156221;1910;76;38;3;35;.921;3568000;0
14382;156298;617;0;0;0;0;.00nan;0;0
14383;10141;2308;0;0;0;0;.00nan;0;0
14383;144410;1910;68;16;0;16;1.000;867000;0
14383;156221;1910;33;30;6;24;.800;2733000;0
14383;156254;2308;72;31;3;28;.903;3600000;0
14384;56316;612;47;13;2;11;.846;3600000;0
14384;73396;620;0;0;0;0;.00nan;0;0
14384;73639;620;68;37;4;33;.892;3538000;0
14384;74161;612;0;0;0;0;.00nan;0;0
14385;173279;4644;54;40;5;35;.875;3567000;0
14385;32712;611;0;0;0;0;.00nan;0;0
14385;143100;611;69;25;2;23;.920;3600000;0
14385;156148;4644;0;0;0;0;.00nan;0;0
14386;34959;2319;89;38;2;36;.947;3600000;0
14386;78262;2319;0;0;0;0;.00nan;0;0
14386;86394;619;63;28;3;25;.893;3579000;0
14386;148503;619;0;0;0;0;.00nan;0;0
14387;1061;2167;0;0;0;0;.00nan;0;0
14387;176206;2167;61;30;5;25;.833;3573000;0
14387;71046;614;0;0;0;0;.00nan;0;0
14387;73187;614;78;42;3;39;.929;3600000;0
14388;3075;617;40;50;8;42;.840;3600000;0
14388;45323;622;0;0;0;0;.00nan;0;0
14388;156298;617;0;0;0;0;.00nan;0;0
14388;156322;622;45;9;2;7;.778;3600000;0
14389;71046;614;0;0;0;0;.00nan;0;0
14389;73187;614;88;26;1;25;.962;3600000;0
14389;73396;620;67;34;3;31;.912;3538000;0
14389;73639;620;0;0;0;0;.00nan;0;0
14390;10141;2308;98;53;2;51;.962;3592000;0
14390;45323;622;0;0;0;0;.00nan;0;0
14390;156254;2308;0;0;0;0;.00nan;0;0
14390;156322;622;62;16;1;15;.938;3600000;0
14391;56316;612;70;29;3;26;.897;3616000;0
14391;74161;612;0;0;0;0;.00nan;0;0
14391;86394;619;84;39;4;35;.897;3616000;0
14391;148503;619;0;0;0;0;.00nan;0;0
14392;173279;4644;0;0;0;0;.00nan;0;0
14392;144410;1910;0;0;0;0;.00nan;0;0
14392;156148;4644;45;27;4;23;.852;4172000;0
14392;156221;1910;68;34;4;30;.882;4200000;0
14393;32712;611;0;0;0;0;.00nan;0;0
14393;34959;2319;81;33;3;30;.909;3547000;0
14393;78262;2319;0;0;0;0;.00nan;0;0
14393;143100;611;85;39;2;37;.949;3600000;0
14394;1061;2167;100;27;0;27;1.000;3600000;0
14394;3075;617;86;30;1;29;.967;3600000;0
14394;176206;2167;0;0;0;0;.00nan;0;0
14394;156298;617;0;0;0;0;.00nan;0;0
14395;32712;611;0;0;0;0;.00nan;0;0
14395;34959;2319;50;24;4;20;.833;3621000;0
14395;78262;2319;0;0;0;0;.00nan;0;0
14395;143100;611;75;31;3;28;.903;3621000;0
14396;45323;622;0;0;0;0;.00nan;0;0
14396;86394;619;32;28;6;22;.786;3600000;0
14396;148503;619;0;0;0;0;.00nan;0;0
14396;156322;622;64;21;2;19;.905;3600000;0
14397;56316;612;47;18;3;15;.833;3600000;0
14397;71046;614;0;0;0;0;.00nan;0;0
14397;73187;614;65;47;6;41;.872;3600000;0
14397;74161;612;0;0;0;0;.00nan;0;0
14398;34959;2319;66;19;1;18;.947;3600000;0
14398;78262;2319;0;0;0;0;.00nan;0;0
14398;144410;1910;0;0;0;0;.00nan;0;0
14398;156221;1910;71;48;5;43;.896;3600000;0
14399;3075;617;72;27;2;25;.926;3568000;0
14399;73396;620;0;0;0;0;.00nan;0;0
14399;73639;620;98;30;0;30;1.000;3600000;0
14399;156298;617;0;0;0;0;.00nan;0;0
14400;32712;611;0;0;0;0;.00nan;0;0
14400;86394;619;73;31;3;28;.903;3670000;0
14400;143100;611;87;47;4;43;.915;3670000;0
14400;148503;619;0;0;0;0;.00nan;0;0
14401;1061;2167;87;35;2;33;.943;3600000;0
14401;10141;2308;0;0;0;0;.00nan;0;0
14401;176206;2167;0;0;0;0;.00nan;0;0
14401;156254;2308;84;26;1;25;.962;3600000;0
14402;173279;4644;97;79;5;74;.937;3600000;0
14402;45323;622;0;0;0;0;.00nan;0;0
14402;156148;4644;0;0;0;0;.00nan;0;0
14402;156322;622;46;11;2;9;.818;3600000;0
14403;10141;2308;79;24;2;22;.917;3574000;0
14403;73396;620;0;0;0;0;.00nan;0;0
14403;73639;620;82;26;1;25;.962;3600000;0
14403;156254;2308;0;0;0;0;.00nan;0;0
14404;32712;611;0;0;0;0;.00nan;0;0
14404;56316;612;79;36;3;33;.917;3600000;0
14404;74161;612;0;0;0;0;.00nan;0;0
14404;143100;611;54;37;6;31;.838;3600000;0
14405;86394;619;100;33;0;33;1.000;3600000;0
14405;144410;1910;0;0;0;0;.00nan;0;0
14405;148503;619;0;0;0;0;.00nan;0;0
14405;156221;1910;77;31;3;28;.903;3600000;0
14406;1061;2167;67;30;3;27;.900;3600000;0
14406;173279;4644;62;36;4;32;.889;3588000;0
14406;176206;2167;0;0;0;0;.00nan;0;0
14406;156148;4644;0;0;0;0;.00nan;0;0
14407;34959;2319;0;0;0;0;.00nan;0;0
14407;45323;622;0;0;0;0;.00nan;0;0
14407;78262;2319;73;54;5;49;.907;3562000;0
14407;156322;622;51;22;3;19;.864;3600000;0
14408;3075;617;74;33;2;31;.939;3560000;0
14408;71046;614;0;0;0;0;.00nan;0;0
14408;73187;614;93;29;1;28;.966;3600000;0
14408;156298;617;0;0;0;0;.00nan;0;0
14410;1061;2167;88;44;3;41;.932;3022000;0
14410;176206;2167;32;10;3;7;.700;578000;0
14410;45323;622;0;0;0;0;.00nan;0;0
14410;156322;622;80;23;1;22;.957;3600000;0
14412;173279;4644;78;25;1;24;.960;3600000;0
14412;34959;2319;93;25;0;25;1.000;3600000;0
14412;78262;2319;0;0;0;0;.00nan;0;0
14412;156148;4644;0;0;0;0;.00nan;0;0
14414;3075;617;95;48;3;45;.938;3575000;0
14414;74161;2308;0;0;0;0;.00nan;0;0
14414;156254;2308;69;19;2;17;.895;3600000;0
14414;156298;617;0;0;0;0;.00nan;0;0
14416;73639;620;29;34;7;27;.794;3280000;0
14416;86394;619;56;29;3;26;.897;3600000;0
14416;148503;619;0;0;0;0;.00nan;0;0
14416;156221;620;50;1;0;1;1.000;320000;0
14418;71046;1910;0;0;0;0;.00nan;0;0
14418;73187;614;35;15;4;11;.733;3654000;0
14418;73396;614;0;0;0;0;.00nan;0;0
14418;144410;1910;80;41;3;38;.927;3654000;0
14420;32712;611;0;0;0;0;.00nan;0;0
14420;56316;612;87;18;0;18;1.000;3600000;0
14420;143100;611;92;35;1;34;.971;3600000;0
14420;156178;612;0;0;0;0;.00nan;0;0
14422;73187;614;0;0;0;0;.00nan;0;0
14422;73396;614;65;50;6;44;.880;3600000;0
14422;86394;619;61;5;0;5;1.000;921000;0
14422;148503;619;13;24;7;17;.708;2641000;0
14424;3075;617;53;10;1;9;.900;1318000;0
14424;73639;620;0;0;0;0;.00nan;0;0
14424;156221;620;98;27;0;27;1.000;3600000;0
14424;156298;617;23;27;6;21;.778;2282000;0
14426;34959;2319;0;0;0;0;.00nan;0;0
14426;45323;622;87;29;1;28;.966;3600000;0
14426;78262;2319;60;40;5;35;.875;3600000;0
14426;156322;622;0;0;0;0;.00nan;0;0
14428;1061;2167;0;0;0;0;.00nan;0;0
14428;176206;2167;90;40;3;37;.925;3600000;0
14428;74161;2308;65;19;2;17;.895;3600000;0
14428;156254;2308;0;0;0;0;.00nan;0;0
14430;32712;611;74;22;1;21;.955;3600000;0
14430;71046;1910;81;34;2;32;.941;3564000;0
14430;143100;611;0;0;0;0;.00nan;0;0
14430;144410;1910;0;0;0;0;.00nan;0;0
14432;173279;4644;0;0;0;0;.00nan;0;0
14432;56316;612;65;25;2;23;.920;3600000;0
14432;156148;4644;73;52;5;47;.904;3600000;0
14432;156178;612;0;0;0;0;.00nan;0;0
14434;34959;2319;44;21;4;17;.810;3534000;0
14434;73639;620;0;0;0;0;.00nan;0;0
14434;78262;2319;0;0;0;0;.00nan;0;0
14434;156221;620;68;27;2;25;.926;3600000;0
14436;1061;2167;68;38;4;34;.895;3600000;0
14436;176206;2167;0;0;0;0;.00nan;0;0
14436;74161;2308;15;8;4;4;.500;659000;0
14436;156254;2308;63;19;1;18;.947;2933000;0
14438;3075;617;56;30;4;26;.867;3600000;0
14438;73187;614;55;17;2;15;.882;3600000;0
14438;73396;614;0;0;0;0;.00nan;0;0
14438;156298;617;0;0;0;0;.00nan;0;0
14440;71046;1910;0;0;0;0;.00nan;0;0
14440;86394;619;91;19;0;19;1.000;3600000;0
14440;144410;1910;83;49;3;46;.939;3600000;0
14440;148503;619;0;0;0;0;.00nan;0;0
14442;32712;611;0;0;0;0;.00nan;0;0
14442;56316;612;82;24;1;23;.958;3600000;0
14442;143100;611;62;44;6;38;.864;3600000;0
14442;156178;612;0;0;0;0;.00nan;0;0
14444;173279;4644;46;38;6;32;.842;2568000;0
14444;45323;622;0;0;0;0;.00nan;0;0
14444;156148;4644;49;14;2;12;.857;1032000;0
14444;156322;622;74;19;1;18;.947;3600000;0
14446;45323;622;0;0;0;0;.00nan;0;0
14446;86394;619;60;32;4;28;.875;3600000;0
14446;148503;619;0;0;0;0;.00nan;0;0
14446;156322;622;55;24;3;21;.875;3600000;0
14448;56316;612;78;10;0;10;1.000;3600000;0
14448;71046;1910;0;0;0;0;.00nan;0;0
14448;144410;1910;79;55;4;51;.927;3600000;0
14448;156178;612;0;0;0;0;.00nan;0;0
14450;32712;611;74;31;2;29;.935;3779000;0
14450;73639;620;0;0;0;0;.00nan;0;0
14450;143100;611;0;0;0;0;.00nan;0;0
14450;156221;620;87;31;3;28;.903;3779000;0
14452;3075;617;30;24;5;19;.792;3600000;0
14452;173279;4644;0;0;0;0;.00nan;0;0
14452;156148;4644;73;31;2;29;.935;3600000;0
14452;156298;617;0;0;0;0;.00nan;0;0
14454;34959;2319;74;37;3;34;.919;3600000;0
14454;73187;614;48;34;5;29;.853;3531000;0
14454;73396;614;0;0;0;0;.00nan;0;0
14454;78262;2319;0;0;0;0;.00nan;0;0
14456;1061;2167;64;39;4;35;.897;3600000;0
14456;176206;2167;0;0;0;0;.00nan;0;0
14456;74161;2308;0;0;0;0;.00nan;0;0
14456;156254;2308;65;24;2;22;.917;3600000;0
14458;1061;2167;0;0;0;0;.00nan;0;0
14458;3075;617;0;0;0;0;.00nan;0;0
14458;176206;2167;83;29;2;27;.931;3600000;0
14458;156298;617;53;25;3;22;.880;3584000;0
14460;34959;2319;0;0;0;0;.00nan;0;0
14460;73639;620;94;47;2;45;.957;3689000;0
14460;78262;2319;64;17;1;16;.941;3689000;0
14460;156221;620;0;0;0;0;.00nan;0;0
14462;32712;611;0;0;0;0;.00nan;0;0
14462;86394;619;0;0;0;0;.00nan;0;0
14462;143100;611;59;27;3;24;.889;3569000;0
14462;148503;619;54;17;2;15;.882;3600000;0
14464;73187;614;0;0;0;0;.00nan;0;0
14464;73396;614;100;26;0;26;1.000;3600000;0
14464;74161;2308;21;35;8;27;.771;3600000;0
14464;156254;2308;0;0;0;0;.00nan;0;0
14466;56316;612;78;11;0;11;1.000;3600000;0
14466;71046;1910;41;27;4;23;.852;2081000;0
14466;144410;1910;56;28;3;25;.893;1519000;0
14466;156178;612;0;0;0;0;.00nan;0;0
14468;173279;4644;98;58;3;55;.948;3600000;0
14468;45323;622;69;7;0;7;1.000;3600000;0
14468;156148;4644;0;0;0;0;.00nan;0;0
14468;156322;622;0;0;0;0;.00nan;0;0
14470;10141;2308;0;0;0;0;.00nan;0;0
14470;34959;2319;65;17;1;16;.941;3600000;0
14470;78262;2319;0;0;0;0;.00nan;0;0
14470;156254;2308;67;31;2;29;.935;3547000;0
14472;32712;611;0;0;0;0;.00nan;0;0
14472;86394;619;66;16;1;15;.938;3600000;0
14472;143100;611;69;36;4;32;.889;3600000;0
14472;148503;619;0;0;0;0;.00nan;0;0
14474;3075;617;0;0;0;0;.00nan;0;0
14474;56316;612;76;21;1;20;.952;3600000;0
14474;74161;612;0;0;0;0;.00nan;0;0
14474;156298;617;69;44;4;40;.909;3600000;0
14476;173279;4644;95;62;5;57;.919;3600000;0
14476;45323;622;56;13;1;12;.923;3600000;0
14476;156148;4644;0;0;0;0;.00nan;0;0
14476;156322;622;0;0;0;0;.00nan;0;0
14478;1061;2167;52;28;4;24;.857;3180000;0
14478;176206;2167;35;3;2;1;.333;535000;0
14478;144410;1910;0;0;0;0;.00nan;0;0
14478;156221;1910;38;25;5;20;.800;3715000;0
14480;71046;614;0;0;0;0;.00nan;0;0
14480;73187;614;76;36;3;33;.917;3600000;0
14480;73396;620;0;0;0;0;.00nan;0;0
14480;73639;620;100;23;0;23;1.000;3600000;0
14482;32712;611;56;12;1;11;.917;3544000;0
14482;143100;611;0;0;0;0;.00nan;0;0
14482;144410;1910;100;27;0;27;1.000;3600000;0
14482;156221;1910;0;0;0;0;.00nan;0;0
14484;1061;2167;0;0;0;0;.00nan;0;0
14484;176206;2167;69;33;3;30;.909;3600000;0
14484;86394;619;0;0;0;0;.00nan;0;0
14484;148503;619;44;33;5;28;.848;3592000;0
14486;10141;2308;97;45;1;44;.978;4200000;0
14486;56316;612;0;0;0;0;.00nan;0;0
14486;74161;612;85;24;1;23;.958;4200000;0
14486;156254;2308;0;0;0;0;.00nan;0;0
14488;3075;617;59;45;6;39;.867;2906000;0
14488;45323;622;0;0;0;0;.00nan;0;0
14488;156298;617;62;7;0;7;1.000;658000;0
14488;156322;622;35;18;4;14;.778;3600000;0
14490;173279;4644;0;0;0;0;.00nan;0;0
14490;73396;620;13;20;6;14;.700;2533000;0
14490;73639;620;48;8;1;7;.875;1067000;0
14490;156148;4644;58;28;3;25;.893;3600000;0
14492;34959;2319;0;0;0;0;.00nan;0;0
14492;71046;614;69;42;4;38;.905;3600000;0
14492;73187;614;0;0;0;0;.00nan;0;0
14492;78262;2319;95;20;0;20;1.000;3600000;0
604;45323;622;0;0;0;0;.00nan;0;0
604;73396;620;0;0;0;0;.00nan;0;0
604;73639;620;76;55;6;49;.891;3600000;0
604;156322;622;66;17;2;15;.882;3600000;0
605;34959;2319;44;35;6;29;.829;3600000;0
605;56316;612;79;27;2;25;.926;3600000;0
605;74161;612;0;0;0;0;.00nan;0;0
605;78262;2319;0;0;0;0;.00nan;0;0
606;71046;614;0;0;0;0;.00nan;0;0
606;73187;614;94;35;2;33;.943;3558000;0
606;86394;619;82;23;1;22;.957;3600000;0
606;148503;619;0;0;0;0;.00nan;0;0
607;10141;2308;60;29;4;25;.862;3733000;0
607;32712;611;0;0;0;0;.00nan;0;0
607;143100;611;67;29;3;26;.897;3733000;0
607;156254;2308;0;0;0;0;.00nan;0;0
608;45323;622;0;0;0;0;.00nan;0;0
608;73396;620;32;9;3;6;.667;663000;0
608;73639;620;43;45;7;38;.844;2937000;0
608;156322;622;81;13;0;13;1.000;3600000;0
609;34959;2319;78;38;4;34;.895;3600000;0
609;56316;612;86;35;3;32;.914;3600000;0
609;74161;612;0;0;0;0;.00nan;0;0
609;78262;2319;0;0;0;0;.00nan;0;0
610;71046;614;0;0;0;0;.00nan;0;0
610;73187;614;78;44;3;41;.932;3583000;0
610;86394;619;60;15;1;14;.933;3600000;0
610;148503;619;0;0;0;0;.00nan;0;0
611;10141;2308;0;0;0;0;.00nan;0;0
611;32712;611;0;0;0;0;.00nan;0;0
611;143100;611;82;29;2;27;.931;3954000;0
611;156254;2308;54;24;3;21;.875;3954000;0
612;45323;622;0;0;0;0;.00nan;0;0
612;73396;620;38;33;6;27;.818;2006000;0
612;73639;620;32;25;5;20;.800;1594000;0
612;156322;622;52;14;2;12;.857;3600000;0
613;34959;2319;36;15;4;11;.733;853000;0
613;56316;612;74;24;1;23;.958;3600000;0
613;74161;612;0;0;0;0;.00nan;0;0
613;78262;2319;64;26;2;24;.923;2747000;0
614;71046;614;0;0;0;0;.00nan;0;0
614;73187;614;69;33;3;30;.909;3631000;0
614;86394;619;56;18;2;16;.889;3631000;0
614;148503;619;0;0;0;0;.00nan;0;0
615;10141;2308;0;0;0;0;.00nan;0;0
615;32712;611;0;0;0;0;.00nan;0;0
615;143100;611;68;33;3;30;.909;3600000;0
615;156254;2308;42;25;4;21;.840;3542000;0
616;45323;622;0;0;0;0;.00nan;0;0
616;73396;620;48;23;4;19;.826;1194000;0
616;73639;620;56;27;3;24;.889;2406000;0
616;156322;622;83;11;0;11;1.000;3600000;0
617;34959;2319;68;42;4;38;.905;4200000;0
617;56316;612;50;27;4;23;.852;4200000;0
617;74161;612;0;0;0;0;.00nan;0;0
617;78262;2319;0;0;0;0;.00nan;0;0
618;71046;614;0;0;0;0;.00nan;0;0
618;73187;614;46;35;6;29;.829;3600000;0
618;86394;619;56;25;3;22;.880;3600000;0
618;148503;619;0;0;0;0;.00nan;0;0
619;10141;2308;0;0;0;0;.00nan;0;0
619;32712;611;53;19;2;17;.895;1594000;0
619;143100;611;9;17;6;11;.647;2006000;0
619;156254;2308;63;22;2;20;.909;3600000;0
976;10141;2308;0;0;0;0;.00nan;0;0
976;32712;611;0;0;0;0;.00nan;0;0
976;143100;611;52;31;4;27;.871;3591000;0
976;156254;2308;85;32;2;30;.938;3600000;0
1044;10141;2308;0;0;0;0;.00nan;0;0
1044;32712;611;0;0;0;0;.00nan;0;0
1044;143100;611;98;48;2;46;.958;4200000;0
1044;156254;2308;81;35;2;33;.943;4200000;0
1123;10141;2308;0;0;0;0;.00nan;0;0
1123;32712;611;0;0;0;0;.00nan;0;0
1123;143100;611;71;39;4;35;.897;3955000;0
1123;156254;2308;62;30;3;27;.900;3955000;0
1163;10141;2308;0;0;0;0;.00nan;0;0
1163;45323;622;0;0;0;0;.00nan;0;0
1163;156254;2308;45;48;7;41;.854;3600000;0
1163;156322;622;70;25;2;23;.920;3600000;0
1164;56316;612;20;20;5;15;.750;3600000;0
1164;74161;612;0;0;0;0;.00nan;0;0
1164;86394;619;71;38;4;34;.895;3600000;0
1164;148503;619;0;0;0;0;.00nan;0;0
1165;10141;2308;0;0;0;0;.00nan;0;0
1165;45323;622;0;0;0;0;.00nan;0;0
1165;156254;2308;49;45;6;39;.867;3600000;0
1165;156322;622;80;22;1;21;.955;3600000;0
1166;56316;612;84;29;1;28;.966;3600000;0
1166;74161;612;0;0;0;0;.00nan;0;0
1166;86394;619;70;25;2;23;.920;3600000;0
1166;148503;619;0;0;0;0;.00nan;0;0
1167;10141;2308;0;0;0;0;.00nan;0;0
1167;45323;622;0;0;0;0;.00nan;0;0
1167;156254;2308;72;49;6;43;.878;3600000;0
1167;156322;622;96;18;0;18;1.000;3600000;0
1168;56316;612;82;28;2;26;.929;3600000;0
1168;74161;612;0;0;0;0;.00nan;0;0
1168;86394;619;58;27;3;24;.889;3600000;0
1168;148503;619;0;0;0;0;.00nan;0;0
1169;10141;2308;0;0;0;0;.00nan;0;0
1169;45323;622;0;0;0;0;.00nan;0;0
1169;156254;2308;59;35;4;31;.886;3600000;0
1169;156322;622;72;18;1;17;.944;3600000;0
1170;56316;612;61;32;4;28;.875;3600000;0
1170;74161;612;0;0;0;0;.00nan;0;0
1170;86394;619;85;37;2;35;.946;3600000;0
1170;148503;619;0;0;0;0;.00nan;0;0
1490;56316;612;49;34;6;28;.824;3600000;0
1490;74161;612;0;0;0;0;.00nan;0;0
1490;86394;619;62;25;2;23;.920;3600000;0
1490;148503;619;0;0;0;0;.00nan;0;0
1512;56316;612;74;20;1;19;.950;3600000;0
1512;74161;612;0;0;0;0;.00nan;0;0
1512;86394;619;37;31;7;24;.774;3600000;0
1512;148503;619;0;0;0;0;.00nan;0;0
1547;56316;612;100;42;1;41;.976;3600000;0
1547;74161;612;0;0;0;0;.00nan;0;0
1547;86394;619;14;28;7;21;.750;2557000;0
1547;148503;619;65;17;1;16;.941;1043000;0
1614;45323;622;0;0;0;0;.00nan;0;0
1614;56316;612;100;42;1;41;.976;3600000;0
1614;74161;612;0;0;0;0;.00nan;0;0
1614;156322;622;71;30;3;27;.900;3580000;0
1615;45323;622;0;0;0;0;.00nan;0;0
1615;56316;612;100;36;0;36;1.000;3600000;0
1615;74161;612;0;0;0;0;.00nan;0;0
1615;156322;622;45;23;4;19;.826;3600000;0
1616;45323;622;0;0;0;0;.00nan;0;0
1616;56316;612;100;31;0;31;1.000;3600000;0
1616;74161;612;0;0;0;0;.00nan;0;0
1616;156322;622;77;28;2;26;.929;3591000;0
1617;45323;622;0;0;0;0;.00nan;0;0
1617;56316;612;64;35;3;32;.914;3600000;0
1617;74161;612;0;0;0;0;.00nan;0;0
1617;156322;622;100;29;0;29;1.000;3600000;0
1778;45323;622;0;0;0;0;.00nan;0;0
1778;56316;612;100;46;2;44;.957;3600000;0
1778;74161;612;0;0;0;0;.00nan;0;0
1778;156322;622;77;36;3;33;.917;3545000;0
14493;173840;718;71;32;3;29;.906;3570000;0
14493;184437;716;0;0;0;0;.00nan;0;0
14493;179151;718;0;0;0;0;.00nan;0;0
14493;76486;716;70;17;1;16;.941;3600000;0
14494;180929;715;9;13;6;7;.538;2935000;0
14494;-1;2188;43;11;2;9;.818;763000;0
14494;55932;2188;44;45;7;38;.844;2785000;0
14494;161163;715;49;6;1;5;.833;665000;0
14495;168414;717;0;0;0;0;.00nan;0;0
14495;49545;717;55;34;5;29;.853;3600000;0
14495;62884;2529;81;30;2;28;.933;3600000;0
14495;94134;2529;0;0;0;0;.00nan;0;0
14496;-1;720;0;0;0;0;.00nan;0;0
14496;54658;719;80;26;1;25;.962;3600000;0
14496;55918;720;72;31;2;29;.935;3583000;0
14496;77009;719;0;0;0;0;.00nan;0;0
14497;168414;717;0;0;0;0;.00nan;0;0
14497;-1;721;98;45;3;42;.933;3557000;0
14497;49545;717;85;25;1;24;.960;3600000;0
14497;56611;721;0;0;0;0;.00nan;0;0
14498;-1;720;0;0;0;0;.00nan;0;0
14498;55918;720;61;41;5;36;.878;3900000;0
14498;62884;2529;51;31;5;26;.839;3900000;0
14498;94134;2529;0;0;0;0;.00nan;0;0
14499;184437;716;0;0;0;0;.00nan;0;0
14499;-1;2188;0;0;0;0;.00nan;0;0
14499;55932;2188;62;25;3;22;.880;3600000;0
14499;76486;716;39;31;5;26;.839;3551000;0
14500;180929;715;77;32;2;30;.938;3600000;0
14500;54658;719;70;34;3;31;.912;3600000;0
14500;77009;719;0;0;0;0;.00nan;0;0
14500;161163;715;0;0;0;0;.00nan;0;0
14501;184437;716;19;19;6;13;.684;3141000;0
14501;54658;719;54;35;5;30;.857;3600000;0
14501;76486;716;48;5;1;4;.800;424000;0
14501;77009;719;0;0;0;0;.00nan;0;0
14502;180929;715;69;29;2;27;.931;3600000;0
14502;62884;2529;58;27;3;24;.889;3600000;0
14502;94134;2529;0;0;0;0;.00nan;0;0
14502;161163;715;0;0;0;0;.00nan;0;0
14503;173840;718;0;0;0;0;.00nan;0;0
14503;179151;718;86;30;1;29;.967;3600000;0
14503;-1;2188;0;0;0;0;.00nan;0;0
14503;55932;2188;70;34;3;31;.912;3556000;0
14504;-1;721;89;47;3;44;.936;3600000;0
14504;-1;720;0;0;0;0;.00nan;0;0
14504;55918;720;41;22;4;18;.818;3561000;0
14504;56611;721;0;0;0;0;.00nan;0;0
14505;182339;715;79;29;2;27;.931;3600000;0
14505;-1;721;77;46;4;42;.913;3570000;0
14505;180929;715;0;0;0;0;.00nan;0;0
14505;56611;721;0;0;0;0;.00nan;0;0
14506;184437;716;0;0;0;0;.00nan;0;0
14506;62884;2529;0;0;0;0;.00nan;0;0
14506;76486;716;90;18;0;18;1.000;3600000;0
14506;94134;2529;75;30;2;28;.933;3557000;0
14507;168414;717;0;0;0;0;.00nan;0;0
14507;-1;720;0;0;0;0;.00nan;0;0
14507;49545;717;87;22;1;21;.955;3811000;0
14507;55918;720;77;36;2;34;.944;3811000;0
14508;173840;718;0;0;0;0;.00nan;0;0
14508;179151;718;38;14;3;11;.786;3600000;0
14508;54658;719;67;44;6;38;.864;3600000;0
14508;77009;719;0;0;0;0;.00nan;0;0
14509;184437;716;0;0;0;0;.00nan;0;0
14509;-1;721;62;39;4;35;.897;3600000;0
14509;56611;721;0;0;0;0;.00nan;0;0
14509;76486;716;66;18;1;17;.944;3600000;0
14510;182339;715;0;0;0;0;.00nan;0;0
14510;168414;717;0;0;0;0;.00nan;0;0
14510;180929;715;38;26;5;21;.808;3600000;0
14510;49545;717;32;30;6;24;.800;3572000;0
14511;173840;718;0;0;0;0;.00nan;0;0
14511;179151;718;68;25;2;23;.920;3600000;0
14511;62884;2529;52;39;5;34;.872;3600000;0
14511;94134;2529;0;0;0;0;.00nan;0;0
14512;181446;2188;85;27;1;26;.963;3600000;0
14512;54658;719;70;30;2;28;.933;3565000;0
14512;55932;2188;0;0;0;0;.00nan;0;0
14512;77009;719;0;0;0;0;.00nan;0;0
14513;173840;718;62;20;2;18;.900;3568000;0
14513;179151;718;0;0;0;0;.00nan;0;0
14513;-1;721;0;0;0;0;.00nan;0;0
14513;56611;721;99;41;1;40;.976;3600000;0
14514;181446;2188;66;38;4;34;.895;3541000;0
14514;55932;2188;0;0;0;0;.00nan;0;0
14514;62884;2529;0;0;0;0;.00nan;0;0
14514;94134;2529;66;24;2;22;.917;3600000;0
14515;168414;717;0;0;0;0;.00nan;0;0
14515;184437;716;0;0;0;0;.00nan;0;0
14515;49545;717;59;32;4;28;.875;3579000;0
14515;76486;716;66;23;2;21;.913;3600000;0
14516;182339;715;65;24;3;21;.875;3600000;0
14516;180929;715;0;0;0;0;.00nan;0;0
14516;-1;720;32;25;5;20;.800;3565000;0
14516;55918;720;0;0;0;0;.00nan;0;0
14517;184437;716;0;0;0;0;.00nan;0;0
14517;-1;720;0;0;0;0;.00nan;0;0
14517;55918;720;52;37;4;33;.892;3600000;0
14517;76486;716;54;24;3;21;.875;3600000;0
14518;168414;717;0;0;0;0;.00nan;0;0
14518;173840;718;0;0;0;0;.00nan;0;0
14518;179151;718;52;18;2;16;.889;3600000;0
14518;49545;717;68;39;4;35;.897;3587000;0
14519;-1;721;0;0;0;0;.00nan;0;0
14519;181446;2188;35;19;4;15;.789;3555000;0
14519;55932;2188;0;0;0;0;.00nan;0;0
14519;56611;721;59;26;3;23;.885;3600000;0
14520;54658;719;69;30;3;27;.900;3900000;0
14520;62884;2529;93;35;3;32;.914;3900000;0
14520;77009;719;0;0;0;0;.00nan;0;0
14520;94134;2529;0;0;0;0;.00nan;0;0
14521;-1;721;78;50;5;45;.900;3600000;0
14521;54658;719;94;24;0;24;1.000;3600000;0
14521;56611;721;0;0;0;0;.00nan;0;0
14521;77009;719;0;0;0;0;.00nan;0;0
14522;182339;715;59;19;2;17;.895;3900000;0
14522;184437;716;0;0;0;0;.00nan;0;0
14522;180929;715;0;0;0;0;.00nan;0;0
14522;76486;716;70;26;2;24;.923;3900000;0
14523;168414;717;0;0;0;0;.00nan;0;0
14523;181446;2188;88;34;2;32;.941;3600000;0
14523;49545;717;44;21;3;18;.857;3559000;0
14523;55932;2188;0;0;0;0;.00nan;0;0
14524;173840;718;0;0;0;0;.00nan;0;0
14524;179151;718;49;22;3;19;.864;3545000;0
14524;-1;720;0;0;0;0;.00nan;0;0
14524;55918;720;70;28;2;26;.929;3600000;0
14525;-1;721;49;36;5;31;.861;3600000;0
14525;56611;721;0;0;0;0;.00nan;0;0
14525;62884;2529;0;0;0;0;.00nan;0;0
14525;94134;2529;70;24;1;23;.958;3600000;0
14526;182339;715;0;0;0;0;.00nan;0;0
14526;173840;718;0;0;0;0;.00nan;0;0
14526;179151;718;63;37;4;33;.892;3542000;0
14526;180929;715;71;26;2;24;.923;3600000;0
14527;181446;2188;63;22;2;20;.909;3600000;0
14527;-1;720;0;0;0;0;.00nan;0;0
14527;55918;720;39;23;4;19;.826;3554000;0
14527;55932;2188;0;0;0;0;.00nan;0;0
14528;168414;717;0;0;0;0;.00nan;0;0
14528;49545;717;100;23;0;23;1.000;3600000;0
14528;54658;719;51;25;3;22;.880;3600000;0
14528;77009;719;0;0;0;0;.00nan;0;0
14529;168414;717;0;0;0;0;.00nan;0;0
14529;49545;717;70;35;3;32;.914;3535000;0
14529;62884;2529;81;29;1;28;.966;3600000;0
14529;94134;2529;0;0;0;0;.00nan;0;0
14530;173840;718;87;22;1;21;.955;3600000;0
14530;184437;716;0;0;0;0;.00nan;0;0
14530;179151;718;0;0;0;0;.00nan;0;0
14530;76486;716;58;16;2;14;.875;3544000;0
14531;182339;715;29;24;5;19;.792;3600000;0
14531;180929;715;0;0;0;0;.00nan;0;0
14531;181446;2188;70;26;2;24;.923;3600000;0
14531;55932;2188;0;0;0;0;.00nan;0;0
14532;-1;720;0;0;0;0;.00nan;0;0
14532;54658;719;0;0;0;0;.00nan;0;0
14532;55918;720;83;29;1;28;.966;3900000;0
14532;77009;719;97;30;1;29;.967;3900000;0
14533;184437;716;0;0;0;0;.00nan;0;0
14533;181446;2188;70;38;4;34;.895;3900000;0
14533;55932;2188;0;0;0;0;.00nan;0;0
14533;76486;716;51;28;4;24;.857;3900000;0
14534;182339;715;0;0;0;0;.00nan;0;0
14534;180929;715;68;23;2;21;.913;3600000;0
14534;54658;719;45;30;5;25;.833;3600000;0
14534;77009;719;0;0;0;0;.00nan;0;0
14535;168414;717;0;0;0;0;.00nan;0;0
14535;-1;721;34;32;6;26;.813;2422000;0
14535;49545;717;38;25;5;20;.800;3600000;0
14535;56611;721;70;15;0;15;1.000;1168000;0
14536;-1;720;0;0;0;0;.00nan;0;0
14536;55918;720;59;34;4;30;.882;3600000;0
14536;62884;2529;36;26;5;21;.808;3600000;0
14536;94134;2529;0;0;0;0;.00nan;0;0
14537;-1;721;0;0;0;0;.00nan;0;0
14537;-1;720;0;0;0;0;.00nan;0;0
14537;55918;720;66;25;3;22;.880;3900000;0
14537;56611;721;67;32;3;29;.906;3900000;0
14538;182339;715;0;0;0;0;.00nan;0;0
14538;180929;715;66;31;3;28;.903;3900000;0
14538;62884;2529;55;29;3;26;.897;3900000;0
14538;94134;2529;0;0;0;0;.00nan;0;0
14539;173840;718;0;0;0;0;.00nan;0;0
14539;179151;718;59;18;2;16;.889;3536000;0
14539;181446;2188;100;46;0;46;1.000;3600000;0
14539;55932;2188;0;0;0;0;.00nan;0;0
14540;184437;716;0;0;0;0;.00nan;0;0
14540;54658;719;50;30;4;26;.867;3595000;0
14540;76486;716;58;23;3;20;.870;3600000;0
14540;77009;719;0;0;0;0;.00nan;0;0
14541;184437;716;0;0;0;0;.00nan;0;0
14541;62884;2529;48;27;3;24;.889;3900000;0
14541;76486;716;71;28;3;25;.893;3900000;0
14541;94134;2529;0;0;0;0;.00nan;0;0
14542;182339;715;0;0;0;0;.00nan;0;0
14542;-1;721;0;0;0;0;.00nan;0;0
14542;180929;715;41;26;4;22;.846;3567000;0
14542;56611;721;93;47;2;45;.957;3600000;0
14543;173840;718;0;0;0;0;.00nan;0;0
14543;179151;718;54;18;2;16;.889;3900000;0
14543;54658;719;73;33;2;31;.939;3900000;0
14543;77009;719;0;0;0;0;.00nan;0;0
14544;175712;717;0;0;0;0;.00nan;0;0
14544;-1;720;67;30;3;27;.900;3600000;0
14544;49545;717;48;25;4;21;.840;3564000;0
14544;55918;720;0;0;0;0;.00nan;0;0
14545;184437;716;0;0;0;0;.00nan;0;0
14545;-1;721;0;0;0;0;.00nan;0;0
14545;56611;721;68;46;5;41;.891;3600000;0
14545;76486;716;66;17;1;16;.941;3600000;0
14546;173840;718;80;20;1;19;.950;3600000;0
14546;179151;718;0;0;0;0;.00nan;0;0
14546;62884;2529;21;25;6;19;.760;2653000;0
14546;94134;2529;50;10;1;9;.900;947000;0
14547;182339;715;0;0;0;0;.00nan;0;0
14547;175712;717;70;29;2;27;.931;3600000;0
14547;180929;715;68;35;3;32;.914;3596000;0
14547;49545;717;0;0;0;0;.00nan;0;0
14548;181446;2188;87;44;3;41;.932;3550000;0
14548;54658;719;0;0;0;0;.00nan;0;0
14548;77009;719;74;24;2;22;.917;3600000;0
14548;161180;2188;0;0;0;0;.00nan;0;0
14549;184437;716;0;0;0;0;.00nan;0;0
14549;175712;717;59;35;4;31;.886;3600000;0
14549;49545;717;0;0;0;0;.00nan;0;0
14549;76486;716;86;24;1;23;.958;3600000;0
14550;182339;715;65;37;4;33;.892;3600000;0
14550;180929;715;0;0;0;0;.00nan;0;0
14550;-1;720;0;0;0;0;.00nan;0;0
14550;55918;720;41;35;6;29;.829;3543000;0
14551;173840;718;84;14;0;14;1.000;3600000;0
14551;179151;718;0;0;0;0;.00nan;0;0
14551;-1;721;0;0;0;0;.00nan;0;0
14551;56611;721;85;36;1;35;.972;3600000;0
14552;181446;2188;94;23;0;23;1.000;3600000;0
14552;62884;2529;24;7;3;4;.571;599000;0
14552;94134;2529;63;36;4;32;.889;3001000;0
14552;161180;2188;0;0;0;0;.00nan;0;0
14553;-1;721;67;32;3;29;.906;3600000;0
14553;181446;2188;72;23;2;21;.913;3600000;0
14553;56611;721;0;0;0;0;.00nan;0;0
14553;161180;2188;0;0;0;0;.00nan;0;0
14554;54658;719;39;23;4;19;.826;3600000;0
14554;62884;2529;0;0;0;0;.00nan;0;0
14554;77009;719;0;0;0;0;.00nan;0;0
14554;94134;2529;64;26;3;23;.885;3600000;0
14555;173840;718;34;26;5;21;.808;3570000;0
14555;179151;718;0;0;0;0;.00nan;0;0
14555;175712;717;63;28;3;25;.893;3600000;0
14555;49545;717;0;0;0;0;.00nan;0;0
14556;184437;716;0;0;0;0;.00nan;0;0
14556;-1;720;38;41;6;35;.854;2766000;0
14556;55918;720;27;7;3;4;.571;834000;0
14556;76486;716;59;13;1;12;.923;3600000;0
14557;182339;715;46;7;1;6;.857;754000;0
14557;184437;716;0;0;0;0;.00nan;0;0
14557;180929;715;18;26;6;20;.769;2846000;0
14557;76486;716;55;22;3;19;.864;3600000;0
14558;173840;718;65;30;3;27;.900;3600000;0
14558;179151;718;0;0;0;0;.00nan;0;0
14558;-1;720;0;0;0;0;.00nan;0;0
14558;55918;720;89;34;2;32;.941;3600000;0
14559;175712;717;78;36;3;33;.917;3600000;0
14559;181446;2188;43;34;6;28;.824;3600000;0
14559;49545;717;0;0;0;0;.00nan;0;0
14559;161180;2188;0;0;0;0;.00nan;0;0
14560;-1;721;0;0;0;0;.00nan;0;0
14560;54658;719;79;23;1;22;.957;3600000;0
14560;56611;721;42;16;3;13;.813;3600000;0
14560;77009;719;0;0;0;0;.00nan;0;0
14561;-1;721;74;31;2;29;.935;3600000;0
14561;56611;721;0;0;0;0;.00nan;0;0
14561;62884;2529;51;23;3;20;.870;3547000;0
14561;94134;2529;0;0;0;0;.00nan;0;0
14562;182339;715;0;0;0;0;.00nan;0;0
14562;173840;718;57;23;3;20;.870;3600000;0
14562;179151;718;0;0;0;0;.00nan;0;0
14562;180929;715;43;32;5;27;.844;3562000;0
14563;181446;2188;99;39;1;38;.974;3900000;0
14563;-1;720;74;25;1;24;.960;3900000;0
14563;55918;720;0;0;0;0;.00nan;0;0
14563;161180;2188;0;0;0;0;.00nan;0;0
14564;175712;717;76;23;1;22;.957;3600000;0
14564;49545;717;0;0;0;0;.00nan;0;0
14564;54658;719;90;38;2;36;.947;3569000;0
14564;77009;719;0;0;0;0;.00nan;0;0
14565;173840;718;47;35;5;30;.857;3558000;0
14565;184437;716;0;0;0;0;.00nan;0;0
14565;179151;718;0;0;0;0;.00nan;0;0
14565;76486;716;61;28;3;25;.893;3600000;0
14566;182339;715;84;40;3;37;.925;3600000;0
14566;180929;715;0;0;0;0;.00nan;0;0
14566;181446;2188;31;39;7;32;.821;3600000;0
14566;161180;2188;0;0;0;0;.00nan;0;0
14567;175712;717;93;35;1;34;.971;3600000;0
14567;49545;717;0;0;0;0;.00nan;0;0
14567;62884;2529;77;33;3;30;.909;3600000;0
14567;94134;2529;0;0;0;0;.00nan;0;0
14568;-1;720;0;0;0;0;.00nan;0;0
14568;54658;719;93;57;4;53;.930;3731000;0
14568;55918;720;69;29;3;26;.897;3731000;0
14568;77009;719;0;0;0;0;.00nan;0;0
14569;175712;717;72;24;2;22;.917;3900000;0
14569;-1;721;0;0;0;0;.00nan;0;0
14569;49545;717;0;0;0;0;.00nan;0;0
14569;56611;721;77;36;2;34;.944;3900000;0
14570;-1;720;0;0;0;0;.00nan;0;0
14570;55918;720;55;23;3;20;.870;3888000;0
14570;62884;2529;0;0;0;0;.00nan;0;0
14570;94134;2529;51;25;3;22;.880;3900000;0
14571;184437;716;0;0;0;0;.00nan;0;0
14571;181446;2188;93;32;2;30;.938;3600000;0
14571;76486;716;89;43;3;40;.930;3545000;0
14571;161180;2188;0;0;0;0;.00nan;0;0
14572;182339;715;0;0;0;0;.00nan;0;0
14572;180929;715;55;28;4;24;.857;3600000;0
14572;54658;719;61;40;5;35;.875;3600000;0
14572;77009;719;0;0;0;0;.00nan;0;0
14573;184437;716;0;0;0;0;.00nan;0;0
14573;54658;719;68;50;6;44;.880;3600000;0
14573;76486;716;79;21;1;20;.952;3600000;0
14573;77009;719;0;0;0;0;.00nan;0;0
14574;182339;715;52;2;0;2;1.000;657000;0
14574;180929;715;26;31;7;24;.774;2930000;0
14574;62884;2529;40;25;5;20;.800;3600000;0
14574;94134;2529;0;0;0;0;.00nan;0;0
14575;173840;718;0;0;0;0;.00nan;0;0
14575;179151;718;47;10;2;8;.800;3600000;0
14575;181446;2188;64;28;3;25;.893;3584000;0
14575;161180;2188;0;0;0;0;.00nan;0;0
14576;-1;721;80;43;4;39;.907;3654000;0
14576;-1;720;0;0;0;0;.00nan;0;0
14576;55918;720;72;35;3;32;.914;3654000;0
14576;56611;721;0;0;0;0;.00nan;0;0
14577;182339;715;0;0;0;0;.00nan;0;0
14577;-1;721;0;0;0;0;.00nan;0;0
14577;180929;715;88;42;2;40;.952;3900000;0
14577;56611;721;81;31;2;29;.935;3900000;0
14578;184437;716;0;0;0;0;.00nan;0;0
14578;62884;2529;70;38;3;35;.921;3578000;0
14578;76486;716;63;23;2;21;.913;3600000;0
14578;94134;2529;0;0;0;0;.00nan;0;0
14579;175712;717;87;41;3;38;.927;3600000;0
14579;-1;720;58;26;2;24;.923;2457000;0
14579;49545;717;0;0;0;0;.00nan;0;0
14579;55918;720;27;17;5;12;.706;1143000;0
14580;173840;718;0;0;0;0;.00nan;0;0
14580;179151;718;78;23;1;22;.957;3600000;0
14580;54658;719;0;0;0;0;.00nan;0;0
14580;77009;719;73;48;4;44;.917;3600000;0
14581;184437;716;0;0;0;0;.00nan;0;0
14581;-1;721;80;49;4;45;.918;3900000;0
14581;56611;721;0;0;0;0;.00nan;0;0
14581;76486;716;55;27;4;23;.852;3900000;0
14582;182339;715;77;37;3;34;.919;3600000;0
14582;175712;717;52;36;4;32;.889;3584000;0
14582;180929;715;0;0;0;0;.00nan;0;0
14582;49545;717;0;0;0;0;.00nan;0;0
14583;173840;718;0;0;0;0;.00nan;0;0
14583;179151;718;75;30;2;28;.933;3600000;0
14583;62884;2529;79;43;3;40;.930;3565000;0
14583;94134;2529;0;0;0;0;.00nan;0;0
14584;181446;2188;57;27;4;23;.852;3600000;0
14584;54658;719;63;36;5;31;.861;3600000;0
14584;77009;719;0;0;0;0;.00nan;0;0
14584;161180;2188;0;0;0;0;.00nan;0;0
14585;173840;718;0;0;0;0;.00nan;0;0
14585;179151;718;71;32;3;29;.906;3600000;0
14585;-1;721;59;43;5;38;.884;3600000;0
14585;56611;721;0;0;0;0;.00nan;0;0
14586;181446;2188;78;29;3;26;.897;3600000;0
14586;62884;2529;0;0;0;0;.00nan;0;0
14586;94134;2529;60;28;4;24;.857;3600000;0
14586;161180;2188;0;0;0;0;.00nan;0;0
14587;184437;716;0;0;0;0;.00nan;0;0
14587;175712;717;49;34;5;29;.853;3600000;0
14587;49545;717;0;0;0;0;.00nan;0;0
14587;76486;716;77;16;1;15;.938;3600000;0
14588;182339;715;0;0;0;0;.00nan;0;0
14588;180929;715;63;30;3;27;.900;3574000;0
14588;-1;720;0;0;0;0;.00nan;0;0
14588;55918;720;86;32;1;31;.969;3600000;0
14589;184437;716;28;31;6;25;.806;3600000;0
14589;-1;720;0;0;0;0;.00nan;0;0
14589;55918;720;68;30;3;27;.900;3600000;0
14589;76486;716;0;0;0;0;.00nan;0;0
14590;173840;718;50;32;5;27;.844;3551000;0
14590;179151;718;0;0;0;0;.00nan;0;0
14590;175712;717;43;26;4;22;.846;2315000;0
14590;49545;717;55;3;0;3;1.000;1285000;0
14591;-1;721;0;0;0;0;.00nan;0;0
14591;181446;2188;86;15;0;15;1.000;3600000;0
14591;56611;721;77;39;3;36;.923;3600000;0
14591;161180;2188;0;0;0;0;.00nan;0;0
14592;54658;719;71;21;1;20;.952;3600000;0
14592;62884;2529;43;33;5;28;.848;3600000;0
14592;77009;719;0;0;0;0;.00nan;0;0
14592;94134;2529;0;0;0;0;.00nan;0;0
14593;-1;721;24;7;3;4;.571;394000;0
14593;54658;719;49;16;2;14;.875;3600000;0
14593;56611;721;88;28;1;27;.964;3180000;0
14593;77009;719;0;0;0;0;.00nan;0;0
14594;182339;715;0;0;0;0;.00nan;0;0
14594;184437;716;0;0;0;0;.00nan;0;0
14594;180929;715;54;29;3;26;.897;3571000;0
14594;76486;716;75;23;2;21;.913;3600000;0
14595;175712;717;56;19;2;17;.895;3600000;0
14595;181446;2188;57;45;6;39;.867;3600000;0
14595;49545;717;0;0;0;0;.00nan;0;0
14595;161180;2188;0;0;0;0;.00nan;0;0
14596;173840;718;0;0;0;0;.00nan;0;0
14596;179151;718;61;18;2;16;.889;3900000;0
14596;-1;720;100;46;2;44;.957;3900000;0
14596;55918;720;0;0;0;0;.00nan;0;0
14597;-1;721;65;32;3;29;.906;2987000;0
14597;56611;721;19;10;4;6;.600;613000;0
14597;62884;2529;0;0;0;0;.00nan;0;0
14597;94134;2529;61;13;1;12;.923;3600000;0
14598;182339;715;0;0;0;0;.00nan;0;0
14598;173840;718;0;0;0;0;.00nan;0;0
14598;179151;718;63;26;3;23;.885;3544000;0
14598;180929;715;82;27;1;26;.963;3600000;0
14599;181446;2188;93;31;1;30;.968;3600000;0
14599;55918;720;98;48;2;46;.958;3541000;0
14599;55932;720;0;0;0;0;.00nan;0;0
14599;161180;2188;0;0;0;0;.00nan;0;0
14600;175712;717;77;26;2;24;.923;3600000;0
14600;49545;717;0;0;0;0;.00nan;0;0
14600;54658;719;75;42;4;38;.905;3552000;0
14600;77009;719;0;0;0;0;.00nan;0;0
14601;175712;717;50;25;4;21;.840;3804000;0
14601;49545;717;0;0;0;0;.00nan;0;0
14601;62884;2529;0;0;0;0;.00nan;0;0
14601;94134;2529;83;37;3;34;.919;3804000;0
14602;173840;718;33;33;6;27;.818;3572000;0
14602;184437;716;0;0;0;0;.00nan;0;0
14602;179151;718;0;0;0;0;.00nan;0;0
14602;76486;716;74;32;4;28;.875;3600000;0
14603;182339;715;0;0;0;0;.00nan;0;0
14603;180929;715;53;28;5;23;.821;3600000;0
14603;181446;2188;85;37;2;35;.946;3600000;0
14603;161180;2188;0;0;0;0;.00nan;0;0
14604;54658;719;30;39;7;32;.821;3600000;0
14604;55918;720;64;22;2;20;.909;3600000;0
14604;55932;720;0;0;0;0;.00nan;0;0
14604;77009;719;0;0;0;0;.00nan;0;0
14605;184437;716;0;0;0;0;.00nan;0;0
14605;181446;2188;58;30;4;26;.867;3539000;0
14605;76486;716;57;14;2;12;.857;3600000;0
14605;161180;2188;0;0;0;0;.00nan;0;0
14606;182339;715;67;26;2;24;.923;3600000;0
14606;180929;715;0;0;0;0;.00nan;0;0
14606;54658;719;59;32;4;28;.875;3536000;0
14606;77009;719;0;0;0;0;.00nan;0;0
14607;175712;717;0;0;0;0;.00nan;0;0
14607;-1;721;84;43;3;40;.930;3570000;0
14607;49545;717;76;22;1;21;.955;3600000;0
14607;56611;721;0;0;0;0;.00nan;0;0
14608;55918;720;0;0;0;0;.00nan;0;0
14608;55932;720;63;34;4;30;.882;3565000;0
14608;62884;2529;76;30;2;28;.933;3600000;0
14608;94134;2529;0;0;0;0;.00nan;0;0
14609;-1;721;0;0;0;0;.00nan;0;0
14609;55918;720;71;35;3;32;.914;3562000;0
14609;55932;720;0;0;0;0;.00nan;0;0
14609;56611;721;90;32;2;30;.938;3600000;0
14610;182339;715;0;0;0;0;.00nan;0;0
14610;180929;715;88;28;1;27;.964;3600000;0
14610;62884;2529;74;34;2;32;.941;3544000;0
14610;94134;2529;0;0;0;0;.00nan;0;0
14611;173840;718;0;0;0;0;.00nan;0;0
14611;179151;718;82;26;2;24;.923;3900000;0
14611;181446;2188;0;0;0;0;.00nan;0;0
14611;161180;2188;85;37;2;35;.946;3900000;0
14612;184437;716;0;0;0;0;.00nan;0;0
14612;54658;719;80;33;3;30;.909;3572000;0
14612;76486;716;65;24;2;22;.917;3600000;0
14612;77009;719;0;0;0;0;.00nan;0;0
14613;184437;716;0;0;0;0;.00nan;0;0
14613;62884;2529;38;38;7;31;.816;3600000;0
14613;76486;716;100;30;0;30;1.000;3600000;0
14613;94134;2529;0;0;0;0;.00nan;0;0
14614;182339;715;84;17;0;17;1.000;3600000;0
14614;-1;721;75;50;5;45;.900;3600000;0
14614;180929;715;0;0;0;0;.00nan;0;0
14614;56611;721;0;0;0;0;.00nan;0;0
14615;173840;718;63;21;2;19;.905;3600000;0
14615;179151;718;0;0;0;0;.00nan;0;0
14615;54658;719;64;26;3;23;.885;3589000;0
14615;77009;719;0;0;0;0;.00nan;0;0
14616;175712;717;54;29;3;26;.897;3600000;0
14616;49545;717;0;0;0;0;.00nan;0;0
14616;55918;720;43;29;5;24;.828;3567000;0
14616;55932;720;0;0;0;0;.00nan;0;0
14617;184437;716;0;0;0;0;.00nan;0;0
14617;-1;721;0;0;0;0;.00nan;0;0
14617;56611;721;74;48;5;43;.896;3620000;0
14617;76486;716;38;17;4;13;.765;3620000;0
14618;173840;718;85;16;0;16;1.000;3600000;0
14618;179151;718;0;0;0;0;.00nan;0;0
14618;62884;2529;0;0;0;0;.00nan;0;0
14618;94134;2529;85;56;5;51;.911;3600000;0
14619;182339;715;75;23;1;22;.957;3600000;0
14619;175712;717;52;2;0;2;1.000;670000;0
14619;180929;715;0;0;0;0;.00nan;0;0
14619;49545;717;46;32;6;26;.813;2930000;0
14620;181446;2188;68;21;2;19;.905;3566000;0
14620;54658;719;99;41;1;40;.976;3600000;0
14620;77009;719;0;0;0;0;.00nan;0;0
14620;161180;2188;0;0;0;0;.00nan;0;0
14621;184437;716;76;23;1;22;.957;3600000;0
14621;175712;717;85;40;2;38;.950;3552000;0
14621;49545;717;0;0;0;0;.00nan;0;0
14621;76486;716;0;0;0;0;.00nan;0;0
14622;182339;715;67;20;1;19;.950;3600000;0
14622;180929;715;0;0;0;0;.00nan;0;0
14622;55918;720;64;33;3;30;.909;3537000;0
14622;55932;720;0;0;0;0;.00nan;0;0
14623;173840;718;0;0;0;0;.00nan;0;0
14623;179151;718;54;14;2;12;.857;3600000;0
14623;-1;721;39;31;5;26;.839;3600000;0
14623;56611;721;0;0;0;0;.00nan;0;0
14624;181446;2188;73;25;2;23;.920;3900000;0
14624;62884;2529;0;0;0;0;.00nan;0;0
14624;94134;2529;80;30;2;28;.933;3900000;0
14624;161180;2188;0;0;0;0;.00nan;0;0
14625;-1;721;0;0;0;0;.00nan;0;0
14625;181446;2188;64;12;1;11;.917;3600000;0
14625;56611;721;70;40;4;36;.900;3600000;0
14625;161180;2188;0;0;0;0;.00nan;0;0
14626;54658;719;53;42;7;35;.833;3600000;0
14626;62884;2529;66;27;3;24;.889;3600000;0
14626;77009;719;0;0;0;0;.00nan;0;0
14626;94134;2529;0;0;0;0;.00nan;0;0
14627;173840;718;79;24;1;23;.958;3600000;0
14627;179151;718;0;0;0;0;.00nan;0;0
14627;175712;717;0;0;0;0;.00nan;0;0
14627;49545;717;90;42;2;40;.952;3562000;0
14628;184437;716;0;0;0;0;.00nan;0;0
14628;55918;720;0;0;0;0;.00nan;0;0
14628;55932;720;72;33;3;30;.909;3585000;0
14628;76486;716;76;22;1;21;.955;3600000;0
14629;182339;715;53;32;5;27;.844;3600000;0
14629;184437;716;0;0;0;0;.00nan;0;0
14629;180929;715;0;0;0;0;.00nan;0;0
14629;76486;716;54;27;4;23;.852;3600000;0
14630;173840;718;0;0;0;0;.00nan;0;0
14630;179151;718;52;23;3;20;.870;3600000;0
14630;55918;720;24;30;6;24;.800;2290000;0
14630;55932;720;57;13;1;12;.923;1310000;0
14631;175712;717;75;19;1;18;.947;3600000;0
14631;181446;2188;26;5;3;2;.400;254000;0
14631;49545;717;0;0;0;0;.00nan;0;0
14631;161180;2188;91;39;2;37;.949;3346000;0
14632;-1;721;96;55;3;52;.945;3900000;0
14632;54658;719;0;0;0;0;.00nan;0;0
14632;56611;721;0;0;0;0;.00nan;0;0
14632;77009;719;70;29;3;26;.897;3900000;0
14633;-1;721;0;0;0;0;.00nan;0;0
14633;56611;721;82;30;1;29;.967;3600000;0
14633;62884;2529;50;22;4;18;.818;3600000;0
14633;94134;2529;0;0;0;0;.00nan;0;0
14634;182339;715;0;0;0;0;.00nan;0;0
14634;173840;718;77;34;3;31;.912;3900000;0
14634;179151;718;0;0;0;0;.00nan;0;0
14634;180929;715;78;38;3;35;.921;3900000;0
14635;175712;717;0;0;0;0;.00nan;0;0
14635;49545;717;53;18;2;16;.889;3600000;0
14635;54658;719;59;36;4;32;.889;3555000;0
14635;77009;719;0;0;0;0;.00nan;0;0
14636;181446;2188;53;32;4;28;.875;3548000;0
14636;55918;720;0;0;0;0;.00nan;0;0
14636;55932;720;82;38;2;36;.947;3600000;0
14636;161180;2188;0;0;0;0;.00nan;0;0
14638;-1;721;36;37;6;31;.838;3101000;0
14638;180929;715;69;26;2;24;.923;3600000;0
14638;56611;721;48;0;0;0;.00nan;499000;0
14638;161163;715;0;0;0;0;.00nan;0;0
14640;184437;716;0;0;0;0;.00nan;0;0
14640;-1;720;70;27;3;24;.889;3600000;0
14640;61170;720;0;0;0;0;.00nan;0;0
14640;76486;716;57;31;4;27;.871;3600000;0
14642;168414;717;91;48;3;45;.938;3555000;0
14642;173840;718;0;0;0;0;.00nan;0;0
14642;179151;718;64;21;2;19;.905;3600000;0
14642;49545;717;0;0;0;0;.00nan;0;0
14644;-1;2188;0;0;0;0;.00nan;0;0
14644;55932;2188;63;33;3;30;.909;3600000;0
14644;62884;2529;100;27;0;27;1.000;3600000;0
14644;94134;2529;0;0;0;0;.00nan;0;0
14648;168414;717;0;0;0;0;.00nan;0;0
14648;-1;2188;67;28;3;25;.893;3544000;0
14648;49545;717;79;32;2;30;.938;3600000;0
14648;55932;2188;0;0;0;0;.00nan;0;0
14650;-1;721;90;33;1;32;.970;3780000;0
14650;180929;715;76;28;2;26;.929;3780000;0
14650;56611;721;0;0;0;0;.00nan;0;0
14650;161163;715;0;0;0;0;.00nan;0;0
14652;184437;716;84;27;1;26;.963;3600000;0
14652;-1;720;0;0;0;0;.00nan;0;0
14652;61170;720;47;19;3;16;.842;3563000;0
14652;76486;716;0;0;0;0;.00nan;0;0
14654;168414;717;62;24;3;21;.875;3856000;0
14654;-1;721;0;0;0;0;.00nan;0;0
14654;49545;717;0;0;0;0;.00nan;0;0
14654;56611;721;94;43;3;40;.930;3900000;0
14656;180929;715;0;0;0;0;.00nan;0;0
14656;-1;2188;0;0;0;0;.00nan;0;0
14656;55932;2188;91;40;2;38;.950;3600000;0
14656;161163;715;52;27;4;23;.852;3517000;0
14660;173840;718;53;16;3;13;.813;3746000;0
14660;179151;718;0;0;0;0;.00nan;0;0
14660;54658;719;93;49;2;47;.959;3762000;0
14660;77009;719;0;0;0;0;.00nan;0;0
14662;-1;720;0;0;0;0;.00nan;0;0
14662;54658;719;29;24;6;18;.750;3259000;0
14662;55918;720;68;36;4;32;.889;3600000;0
14662;77009;719;53;4;0;4;1.000;323000;0
14664;168414;717;0;0;0;0;.00nan;0;0
14664;-1;2188;52;29;4;25;.862;3565000;0
14664;49545;717;79;43;3;40;.930;3600000;0
14664;55932;2188;0;0;0;0;.00nan;0;0
14666;173840;718;59;22;3;19;.864;3600000;0
14666;179151;718;0;0;0;0;.00nan;0;0
14666;-1;721;16;32;7;25;.781;2436000;0
14666;56611;721;56;20;2;18;.900;1164000;0
14668;184437;716;0;0;0;0;.00nan;0;0
14668;180929;715;94;36;1;35;.972;3600000;0
14668;76486;716;31;21;4;17;.810;3600000;0
14668;161163;715;0;0;0;0;.00nan;0;0
14670;-1;721;38;6;2;4;.667;446000;0
14670;54658;719;0;0;0;0;.00nan;0;0
14670;56611;721;47;35;6;29;.829;3154000;0
14670;77009;719;41;16;3;13;.813;3600000;0
14672;168414;717;74;30;2;28;.933;3573000;0
14672;-1;2188;0;0;0;0;.00nan;0;0
14672;49545;717;0;0;0;0;.00nan;0;0
14672;55932;2188;79;25;1;24;.960;3600000;0
14674;173840;718;0;0;0;0;.00nan;0;0
14674;179151;718;33;19;4;15;.789;3900000;0
14674;180929;715;0;0;0;0;.00nan;0;0
14674;161163;715;59;33;4;29;.879;3900000;0
14676;184437;716;77;21;1;20;.952;3600000;0
14676;-1;720;93;35;2;33;.943;3543000;0
14676;55918;720;0;0;0;0;.00nan;0;0
14676;76486;716;0;0;0;0;.00nan;0;0
196;182339;715;89;32;1;31;.969;3600000;0
196;180929;715;0;0;0;0;.00nan;0;0
196;181446;2188;59;38;5;33;.868;3600000;0
196;161180;2188;0;0;0;0;.00nan;0;0
197;173840;718;0;0;0;0;.00nan;0;0
197;179151;718;63;30;3;27;.900;3600000;0
197;175712;717;77;23;1;22;.957;3600000;0
197;49545;717;0;0;0;0;.00nan;0;0
198;184437;716;0;0;0;0;.00nan;0;0
198;181446;2188;32;25;5;20;.800;3600000;0
198;76486;716;67;15;1;14;.933;3600000;0
198;161180;2188;0;0;0;0;.00nan;0;0
199;182339;715;0;0;0;0;.00nan;0;0
199;173840;718;60;30;3;27;.900;3558000;0
199;179151;718;0;0;0;0;.00nan;0;0
199;180929;715;84;40;2;38;.950;3600000;0
200;184437;716;0;0;0;0;.00nan;0;0
200;175712;717;0;0;0;0;.00nan;0;0
200;49545;717;68;23;2;21;.913;3600000;0
200;76486;716;79;42;4;38;.905;3542000;0
201;173840;718;0;0;0;0;.00nan;0;0
201;179151;718;77;24;1;23;.958;3600000;0
201;181446;2188;22;22;6;16;.727;1821000;0
201;161180;2188;55;11;1;10;.909;1779000;0
202;173840;718;97;34;1;33;.971;3600000;0
202;184437;716;0;0;0;0;.00nan;0;0
202;179151;718;0;0;0;0;.00nan;0;0
202;76486;716;76;36;4;32;.889;3600000;0
203;182339;715;63;33;3;30;.909;3600000;0
203;175712;717;72;18;1;17;.944;3600000;0
203;180929;715;0;0;0;0;.00nan;0;0
203;49545;717;0;0;0;0;.00nan;0;0
204;182339;715;0;0;0;0;.00nan;0;0
204;184437;716;0;0;0;0;.00nan;0;0
204;180929;715;62;34;4;30;.882;3544000;0
204;76486;716;63;26;3;23;.885;3600000;0
205;175712;717;85;32;2;30;.938;3600000;0
205;181446;2188;0;0;0;0;.00nan;0;0
205;49545;717;0;0;0;0;.00nan;0;0
205;161180;2188;57;36;4;32;.889;3528000;0
206;182339;715;89;35;2;33;.943;3900000;0
206;180929;715;0;0;0;0;.00nan;0;0
206;181446;2188;70;25;2;23;.920;3900000;0
206;161180;2188;0;0;0;0;.00nan;0;0
207;173840;718;0;0;0;0;.00nan;0;0
207;179151;718;47;29;4;25;.862;3553000;0
207;175712;717;0;0;0;0;.00nan;0;0
207;49545;717;69;28;3;25;.893;3600000;0
208;184437;716;0;0;0;0;.00nan;0;0
208;181446;2188;50;32;5;27;.844;3600000;0
208;76486;716;84;28;1;27;.964;3600000;0
208;161180;2188;0;0;0;0;.00nan;0;0
209;182339;715;55;36;5;31;.861;3600000;0
209;173840;718;56;27;3;24;.889;3600000;0
209;179151;718;0;0;0;0;.00nan;0;0
209;180929;715;0;0;0;0;.00nan;0;0
210;184437;716;0;0;0;0;.00nan;0;0
210;175712;717;72;27;2;25;.926;3600000;0
210;49545;717;0;0;0;0;.00nan;0;0
210;76486;716;75;22;1;21;.955;3600000;0
211;173840;718;0;0;0;0;.00nan;0;0
211;179151;718;73;36;4;32;.889;3559000;0
211;181446;2188;68;29;3;26;.897;3600000;0
211;161180;2188;0;0;0;0;.00nan;0;0
212;173840;718;0;0;0;0;.00nan;0;0
212;184437;716;0;0;0;0;.00nan;0;0
212;179151;718;78;19;1;18;.947;3600000;0
212;76486;716;61;38;5;33;.868;3600000;0
213;182339;715;63;24;2;22;.917;3600000;0
213;175712;717;0;0;0;0;.00nan;0;0
213;180929;715;0;0;0;0;.00nan;0;0
213;49545;717;41;26;4;22;.846;3574000;0
214;182339;715;0;0;0;0;.00nan;0;0
214;184437;716;0;0;0;0;.00nan;0;0
214;180929;715;100;32;1;31;.969;3600000;0
214;76486;716;92;34;2;32;.941;3581000;0
215;175712;717;75;57;5;52;.912;3844000;0
215;181446;2188;74;42;4;38;.905;3844000;0
215;49545;717;0;0;0;0;.00nan;0;0
215;161180;2188;0;0;0;0;.00nan;0;0
216;-1;721;82;44;4;40;.909;3600000;0
216;55918;720;79;24;1;23;.958;3600000;0
216;55932;720;0;0;0;0;.00nan;0;0
216;56611;721;0;0;0;0;.00nan;0;0
217;54658;719;55;38;4;34;.895;3555000;0
217;62884;2529;62;26;3;23;.885;3600000;0
217;77009;719;0;0;0;0;.00nan;0;0
217;94134;2529;0;0;0;0;.00nan;0;0
218;54658;719;78;34;4;30;.882;3534000;0
218;55918;720;0;0;0;0;.00nan;0;0
218;55932;720;83;33;2;31;.939;3600000;0
218;77009;719;0;0;0;0;.00nan;0;0
219;-1;721;0;0;0;0;.00nan;0;0
219;56611;721;53;34;5;29;.853;3600000;0
219;62884;2529;74;20;1;19;.950;3600000;0
219;94134;2529;0;0;0;0;.00nan;0;0
220;55918;720;0;0;0;0;.00nan;0;0
220;55932;720;63;34;4;30;.882;3582000;0
220;62884;2529;0;0;0;0;.00nan;0;0
220;94134;2529;82;30;2;28;.933;3600000;0
221;-1;721;15;32;8;24;.750;2943000;0
221;54658;719;87;26;1;25;.962;3600000;0
221;56611;721;33;7;2;5;.714;657000;0
221;77009;719;0;0;0;0;.00nan;0;0
222;-1;721;0;0;0;0;.00nan;0;0
222;55918;720;0;0;0;0;.00nan;0;0
222;55932;720;64;26;2;24;.923;3600000;0
222;56611;721;60;44;5;39;.886;3600000;0
223;54658;719;65;39;4;35;.897;3600000;0
223;62884;2529;85;26;1;25;.962;3600000;0
223;77009;719;0;0;0;0;.00nan;0;0
223;94134;2529;0;0;0;0;.00nan;0;0
224;54658;719;39;15;3;12;.800;3721000;0
224;55918;720;0;0;0;0;.00nan;0;0
224;55932;720;59;36;4;32;.889;3721000;0
224;77009;719;0;0;0;0;.00nan;0;0
225;-1;721;70;38;4;34;.895;3574000;0
225;56611;721;0;0;0;0;.00nan;0;0
225;62884;2529;62;21;2;19;.905;3600000;0
225;94134;2529;0;0;0;0;.00nan;0;0
226;55918;720;93;17;0;17;1.000;3600000;0
226;55932;720;0;0;0;0;.00nan;0;0
226;62884;2529;73;31;2;29;.935;3563000;0
226;94134;2529;0;0;0;0;.00nan;0;0
227;-1;721;82;24;0;24;1.000;3032000;0
227;54658;719;83;25;1;24;.960;3600000;0
227;56611;721;29;8;3;5;.625;551000;0
227;77009;719;0;0;0;0;.00nan;0;0
502;184437;716;0;0;0;0;.00nan;0;0
502;54658;719;52;35;5;30;.857;3572000;0
502;76486;716;50;21;4;17;.810;3600000;0
502;77009;719;0;0;0;0;.00nan;0;0
503;182339;715;0;0;0;0;.00nan;0;0
503;180929;715;82;22;1;21;.955;3600000;0
503;55918;720;0;0;0;0;.00nan;0;0
503;55932;720;13;24;6;18;.750;3600000;0
504;175712;717;69;19;2;17;.895;3772000;0
504;49545;717;0;0;0;0;.00nan;0;0
504;62884;2529;98;39;1;38;.974;3772000;0
504;94134;2529;0;0;0;0;.00nan;0;0
505;173840;718;55;27;3;24;.889;3600000;0
505;179151;718;0;0;0;0;.00nan;0;0
505;181446;2188;74;41;4;37;.902;3551000;0
505;161180;2188;0;0;0;0;.00nan;0;0
506;184437;716;0;0;0;0;.00nan;0;0
506;54658;719;46;35;5;30;.857;3600000;0
506;76486;716;71;22;1;21;.955;3600000;0
506;77009;719;0;0;0;0;.00nan;0;0
507;182339;715;0;0;0;0;.00nan;0;0
507;180929;715;68;17;1;16;.941;3600000;0
507;55918;720;64;39;4;35;.897;3600000;0
507;55932;720;0;0;0;0;.00nan;0;0
508;175712;717;60;23;2;21;.913;3569000;0
508;49545;717;0;0;0;0;.00nan;0;0
508;62884;2529;72;18;1;17;.944;3600000;0
508;94134;2529;0;0;0;0;.00nan;0;0
509;173840;718;0;0;0;0;.00nan;0;0
509;179151;718;38;33;5;28;.848;3600000;0
509;181446;2188;0;0;0;0;.00nan;0;0
509;161180;2188;99;39;1;38;.974;3600000;0
510;184437;716;0;0;0;0;.00nan;0;0
510;54658;719;100;34;0;34;1.000;3600000;0
510;76486;716;49;24;4;20;.833;3600000;0
510;77009;719;0;0;0;0;.00nan;0;0
511;182339;715;0;0;0;0;.00nan;0;0
511;180929;715;75;29;2;27;.931;3552000;0
511;55918;720;79;24;1;23;.958;3600000;0
511;55932;720;0;0;0;0;.00nan;0;0
512;175712;717;74;26;2;24;.923;3600000;0
512;49545;717;0;0;0;0;.00nan;0;0
512;62884;2529;33;18;4;14;.778;3537000;0
512;94134;2529;0;0;0;0;.00nan;0;0
513;173840;718;0;0;0;0;.00nan;0;0
513;179151;718;68;6;0;6;1.000;3600000;0
513;181446;2188;0;0;0;0;.00nan;0;0
513;161180;2188;54;34;4;30;.882;3600000;0
514;184437;716;0;0;0;0;.00nan;0;0
514;54658;719;87;39;1;38;.974;5044000;0
514;76486;716;83;38;2;36;.947;5044000;0
514;77009;719;0;0;0;0;.00nan;0;0
515;182339;715;0;0;0;0;.00nan;0;0
515;180929;715;63;23;2;21;.913;3600000;0
515;55918;720;57;41;5;36;.878;3600000;0
515;55932;720;0;0;0;0;.00nan;0;0
516;175712;717;52;26;3;23;.885;3600000;0
516;49545;717;0;0;0;0;.00nan;0;0
516;62884;2529;100;30;0;30;1.000;3600000;0
516;94134;2529;0;0;0;0;.00nan;0;0
517;173840;718;0;0;0;0;.00nan;0;0
517;179151;718;84;28;2;26;.929;3600000;0
517;181446;2188;0;0;0;0;.00nan;0;0
517;161180;2188;42;22;4;18;.818;3514000;0
717;184437;716;0;0;0;0;.00nan;0;0
717;54658;719;86;31;1;30;.968;3600000;0
717;76486;716;56;34;4;30;.882;3600000;0
717;77009;719;0;0;0;0;.00nan;0;0
718;182339;715;0;0;0;0;.00nan;0;0
718;180929;715;54;17;2;15;.882;3600000;0
718;55918;720;68;33;3;30;.909;3552000;0
718;55932;720;0;0;0;0;.00nan;0;0
719;175712;717;92;18;0;18;1.000;3600000;0
719;49545;717;0;0;0;0;.00nan;0;0
719;62884;2529;75;28;2;26;.929;3516000;0
719;94134;2529;0;0;0;0;.00nan;0;0
720;173840;718;0;0;0;0;.00nan;0;0
720;179151;718;66;23;2;21;.913;3600000;0
720;181446;2188;0;0;0;0;.00nan;0;0
720;161180;2188;61;36;4;32;.889;3550000;0
742;184437;716;0;0;0;0;.00nan;0;0
742;54658;719;82;41;4;37;.902;3838000;0
742;76486;716;53;20;3;17;.850;3838000;0
742;77009;719;0;0;0;0;.00nan;0;0
743;175712;717;53;25;4;21;.840;3600000;0
743;49545;717;0;0;0;0;.00nan;0;0
743;62884;2529;88;46;5;41;.891;3585000;0
743;94134;2529;0;0;0;0;.00nan;0;0
781;184437;716;0;0;0;0;.00nan;0;0
781;54658;719;77;32;2;30;.938;3600000;0
781;76486;716;48;20;3;17;.850;3581000;0
781;77009;719;0;0;0;0;.00nan;0;0
782;175712;717;83;28;1;27;.964;3600000;0
782;49545;717;0;0;0;0;.00nan;0;0
782;62884;2529;69;26;2;24;.923;3571000;0
782;94134;2529;0;0;0;0;.00nan;0;0
925;182339;715;0;0;0;0;.00nan;0;0
925;180929;715;60;22;2;20;.909;3600000;0
925;54658;719;80;43;3;40;.930;3600000;0
925;77009;719;0;0;0;0;.00nan;0;0
926;173840;718;0;0;0;0;.00nan;0;0
926;179151;718;91;42;2;40;.952;3967000;0
926;175712;717;90;36;1;35;.972;3967000;0
926;49545;717;0;0;0;0;.00nan;0;0
927;182339;715;0;0;0;0;.00nan;0;0
927;180929;715;54;28;4;24;.857;4005000;0
927;54658;719;62;33;3;30;.909;4005000;0
927;77009;719;0;0;0;0;.00nan;0;0
928;173840;718;0;0;0;0;.00nan;0;0
928;179151;718;62;25;3;22;.880;3904000;0
928;175712;717;47;27;4;23;.852;3955000;0
928;49545;717;0;0;0;0;.00nan;0;0
929;182339;715;0;0;0;0;.00nan;0;0
929;180929;715;55;28;3;25;.893;3546000;0
929;54658;719;74;23;1;22;.957;3600000;0
929;77009;719;0;0;0;0;.00nan;0;0
930;173840;718;0;0;0;0;.00nan;0;0
930;179151;718;63;21;2;19;.905;3600000;0
930;175712;717;46;23;4;19;.826;3541000;0
930;49545;717;0;0;0;0;.00nan;0;0
931;182339;715;0;0;0;0;.00nan;0;0
931;180929;715;90;18;0;18;1.000;3600000;0
931;54658;719;69;36;4;32;.889;3600000;0
931;77009;719;0;0;0;0;.00nan;0;0
932;173840;718;0;0;0;0;.00nan;0;0
932;179151;718;67;19;1;18;.947;3600000;0
932;175712;717;93;43;2;41;.953;3576000;0
932;49545;717;0;0;0;0;.00nan;0;0
1220;182339;715;0;0;0;0;.00nan;0;0
1220;180929;715;78;29;2;27;.931;3600000;0
1220;54658;719;70;39;4;35;.897;3600000;0
1220;77009;719;0;0;0;0;.00nan;0;0
1221;173840;718;0;0;0;0;.00nan;0;0
1221;179151;718;74;33;3;30;.909;3532000;0
1221;175712;717;68;16;1;15;.938;3600000;0
1221;49545;717;0;0;0;0;.00nan;0;0
1256;182339;715;0;0;0;0;.00nan;0;0
1256;180929;715;63;22;2;20;.909;3600000;0
1256;54658;719;55;35;5;30;.857;3600000;0
1256;77009;719;0;0;0;0;.00nan;0;0
1257;173840;718;0;0;0;0;.00nan;0;0
1257;179151;718;86;35;1;34;.971;3600000;0
1257;175712;717;44;39;6;33;.846;3600000;0
1257;49545;717;0;0;0;0;.00nan;0;0
1337;182339;715;0;0;0;0;.00nan;0;0
1337;173840;718;0;0;0;0;.00nan;0;0
1337;179151;718;81;22;1;21;.955;3600000;0
1337;180929;715;59;20;2;18;.900;3567000;0
1338;182339;715;0;0;0;0;.00nan;0;0
1338;173840;718;0;0;0;0;.00nan;0;0
1338;179151;718;50;39;5;34;.872;3565000;0
1338;180929;715;37;24;4;20;.833;3600000;0
1339;182339;715;0;0;0;0;.00nan;0;0
1339;173840;718;0;0;0;0;.00nan;0;0
1339;179151;718;63;24;3;21;.875;3600000;0
1339;180929;715;71;39;4;35;.897;3543000;0
1340;182339;715;0;0;0;0;.00nan;0;0
1340;173840;718;0;0;0;0;.00nan;0;0
1340;179151;718;36;19;4;15;.789;3562000;0
1340;180929;715;88;38;3;35;.921;3600000;0
1548;182339;715;0;0;0;0;.00nan;0;0
1548;173840;718;0;0;0;0;.00nan;0;0
1548;179151;718;68;27;2;25;.926;3600000;0
1548;180929;715;48;22;3;19;.864;3564000;0
1618;182339;715;0;0;0;0;.00nan;0;0
1618;173840;718;0;0;0;0;.00nan;0;0
1618;179151;718;76;30;4;26;.867;3588000;0
1618;180929;715;83;37;2;35;.946;3600000;0
1647;182339;715;0;0;0;0;.00nan;0;0
1647;173840;718;0;0;0;0;.00nan;0;0
1647;179151;718;43;19;4;15;.789;3600000;0
1647;180929;715;56;45;6;39;.867;3573000;0
14677;3435;675;46;19;3;16;.842;3600000;0
14677;172527;675;0;0;0;0;.00nan;0;0
14677;53870;490;0;0;0;0;.00nan;0;0
14677;81096;490;65;41;5;36;.878;3600000;0
14678;46139;473;78;23;2;21;.913;3546000;0
14678;46318;5004;0;0;0;0;.00nan;0;0
14678;66552;5004;94;33;1;32;.970;3600000;0
14678;85127;473;0;0;0;0;.00nan;0;0
14679;190235;481;0;0;0;0;.00nan;0;0
14679;56296;481;34;26;5;21;.808;3562000;0
14679;67222;482;0;0;0;0;.00nan;0;0
14679;87894;482;45;27;4;23;.852;3600000;0
14680;163528;682;0;0;0;0;.00nan;0;0
14680;11500;682;86;25;1;24;.960;3600000;0
14680;-1;676;0;0;0;0;.00nan;0;0
14680;43158;676;67;24;2;22;.917;3556000;0
14681;38277;476;52;28;4;24;.857;3575000;0
14681;-1;480;0;0;0;0;.00nan;0;0
14681;63107;480;99;48;3;45;.938;3600000;0
14681;67276;476;0;0;0;0;.00nan;0;0
14682;66491;474;34;31;6;25;.806;2306000;0
14682;66551;472;0;0;0;0;.00nan;0;0
14682;71297;472;60;21;3;18;.857;3600000;0
14682;153779;474;32;10;3;7;.700;1294000;0
14683;38277;476;61;22;2;20;.909;3600000;0
14683;53870;490;48;7;1;6;.857;250000;0
14683;67276;476;0;0;0;0;.00nan;0;0
14683;81096;490;55;45;6;39;.867;3350000;0
14684;12048;4535;0;0;0;0;.00nan;0;0
14684;190235;481;0;0;0;0;.00nan;0;0
14684;56296;481;56;14;2;12;.857;3851000;0
14684;70573;4535;90;45;3;42;.933;3851000;0
14685;163528;682;75;22;1;21;.955;3600000;0
14685;11500;682;0;0;0;0;.00nan;0;0
14685;168926;5004;98;45;2;43;.956;3574000;0
14685;46318;5004;0;0;0;0;.00nan;0;0
14686;-1;480;0;0;0;0;.00nan;0;0
14686;63107;480;89;30;1;29;.967;3600000;0
14686;66551;472;59;22;2;20;.909;3544000;0
14686;71297;472;0;0;0;0;.00nan;0;0
14687;46139;473;30;23;4;19;.826;3545000;0
14687;67222;482;56;24;3;21;.875;3600000;0
14687;85127;473;0;0;0;0;.00nan;0;0
14687;87894;482;0;0;0;0;.00nan;0;0
14688;3435;675;88;38;2;36;.947;3600000;0
14688;172527;675;0;0;0;0;.00nan;0;0
14688;66491;474;39;31;6;25;.806;3600000;0
14688;153779;474;0;0;0;0;.00nan;0;0
14689;12048;4535;0;0;0;0;.00nan;0;0
14689;38277;476;41;28;5;23;.821;3599000;0
14689;70573;4535;79;45;4;41;.911;3600000;0
14689;78920;476;0;0;0;0;.00nan;0;0
14690;-1;676;0;0;0;0;.00nan;0;0
14690;38277;476;0;0;0;0;.00nan;0;0
14690;43158;676;81;46;4;42;.913;3600000;0
14690;78920;476;86;47;3;44;.936;3600000;0
14691;163528;682;56;16;2;14;.875;3600000;0
14691;11500;682;0;0;0;0;.00nan;0;0
14691;53870;490;0;0;0;0;.00nan;0;0
14691;81096;490;70;44;4;40;.909;3600000;0
14692;168926;5004;79;44;3;41;.932;3600000;0
14692;46318;5004;0;0;0;0;.00nan;0;0
14692;67222;482;81;12;0;12;1.000;3600000;0
14692;87894;482;0;0;0;0;.00nan;0;0
14693;3435;675;44;35;6;29;.829;3106000;0
14693;172527;675;52;4;0;4;1.000;428000;0
14693;66551;472;58;27;4;23;.852;3600000;0
14693;71297;472;0;0;0;0;.00nan;0;0
14694;12048;4535;51;34;5;29;.853;3600000;0
14694;-1;480;0;0;0;0;.00nan;0;0
14694;63107;480;70;39;3;36;.923;3600000;0
14694;70573;4535;0;0;0;0;.00nan;0;0
14695;190235;481;0;0;0;0;.00nan;0;0
14695;56296;481;43;14;3;11;.786;3600000;0
14695;66491;474;86;52;4;48;.923;3584000;0
14695;153779;474;0;0;0;0;.00nan;0;0
14696;-1;480;0;0;0;0;.00nan;0;0
14696;63107;480;39;17;4;13;.765;3757000;0
14696;67222;482;79;36;3;33;.917;3755000;0
14696;87894;482;0;0;0;0;.00nan;0;0
14697;3435;675;48;31;4;27;.871;2124000;0
14697;172527;675;58;7;0;7;1.000;1463000;0
14697;38277;476;0;0;0;0;.00nan;0;0
14697;78920;476;56;15;2;13;.867;3600000;0
14698;190235;481;67;46;6;40;.870;3559000;0
14698;56296;481;0;0;0;0;.00nan;0;0
14698;66551;472;64;37;4;33;.892;3600000;0
14698;71297;472;0;0;0;0;.00nan;0;0
14699;-1;676;0;0;0;0;.00nan;0;0
14699;43158;676;85;33;2;31;.939;3600000;0
14699;53870;490;80;18;0;18;1.000;1166000;0
14699;81096;490;24;34;7;27;.794;2434000;0
14700;163528;682;23;17;5;12;.706;3543000;0
14700;11500;682;0;0;0;0;.00nan;0;0
14700;66491;474;89;65;4;61;.938;3600000;0
14700;153779;474;0;0;0;0;.00nan;0;0
14701;12048;4535;0;0;0;0;.00nan;0;0
14701;46139;473;64;36;4;32;.889;3587000;0
14701;70573;4535;67;30;3;27;.900;3600000;0
14701;85127;473;0;0;0;0;.00nan;0;0
14702;38277;476;0;0;0;0;.00nan;0;0
14702;67222;482;74;33;3;30;.909;3762000;0
14702;78920;476;58;35;4;31;.886;3762000;0
14702;87894;482;0;0;0;0;.00nan;0;0
14703;168926;5004;75;30;3;27;.900;3600000;0
14703;46318;5004;0;0;0;0;.00nan;0;0
14703;53870;490;0;0;0;0;.00nan;0;0
14703;81096;490;42;34;5;29;.853;3544000;0
14704;163528;682;100;27;0;27;1.000;3600000;0
14704;11500;682;0;0;0;0;.00nan;0;0
14704;-1;480;0;0;0;0;.00nan;0;0
14704;63107;480;64;39;4;35;.897;3600000;0
14705;-1;676;0;0;0;0;.00nan;0;0
14705;43158;676;76;24;1;23;.958;3546000;0
14705;66551;472;0;0;0;0;.00nan;0;0
14705;71297;472;100;39;0;39;1.000;3600000;0
14706;3435;675;97;38;2;36;.947;3550000;0
14706;172527;675;0;0;0;0;.00nan;0;0
14706;12048;4535;0;0;0;0;.00nan;0;0
14706;70573;4535;91;20;0;20;1.000;3600000;0
14707;46139;473;84;18;0;18;1.000;3600000;0
14707;66491;474;98;42;1;41;.976;3600000;0
14707;85127;473;0;0;0;0;.00nan;0;0
14707;153779;474;0;0;0;0;.00nan;0;0
14708;38277;476;0;0;0;0;.00nan;0;0
14708;66551;472;53;37;5;32;.865;3600000;0
14708;71297;472;0;0;0;0;.00nan;0;0
14708;78920;476;92;36;2;34;.944;3600000;0
14709;168926;5004;73;36;4;32;.889;3600000;0
14709;-1;480;0;0;0;0;.00nan;0;0
14709;46318;5004;0;0;0;0;.00nan;0;0
14709;63107;480;80;25;2;23;.920;3600000;0
14710;66491;474;30;29;6;23;.793;3600000;0
14710;67222;482;0;0;0;0;.00nan;0;0
14710;87894;482;69;26;2;24;.923;3600000;0
14710;153779;474;0;0;0;0;.00nan;0;0
14711;-1;676;63;31;4;27;.871;3600000;0
14711;190235;481;0;0;0;0;.00nan;0;0
14711;43158;676;0;0;0;0;.00nan;0;0
14711;56296;481;82;27;1;26;.963;3600000;0
14712;163528;682;98;26;0;26;1.000;3600000;0
14712;11500;682;0;0;0;0;.00nan;0;0
14712;12048;4535;0;0;0;0;.00nan;0;0
14712;70573;4535;83;38;2;36;.947;3600000;0
14713;46139;473;39;12;3;9;.750;3600000;0
14713;53870;490;0;0;0;0;.00nan;0;0
14713;81096;490;64;45;5;40;.889;3568000;0
14713;85127;473;0;0;0;0;.00nan;0;0
14714;-1;480;64;17;1;16;.941;3561000;0
14714;53870;490;100;41;0;41;1.000;3600000;0
14714;63107;480;0;0;0;0;.00nan;0;0
14714;81096;490;0;0;0;0;.00nan;0;0
14715;3435;675;47;37;6;31;.838;3822000;0
14715;172527;675;0;0;0;0;.00nan;0;0
14715;190235;481;0;0;0;0;.00nan;0;0
14715;56296;481;37;27;5;22;.815;3822000;0
14716;168926;5004;53;25;4;21;.840;4020000;0
14716;46318;5004;0;0;0;0;.00nan;0;0
14716;66491;474;77;43;4;39;.907;4020000;0
14716;153779;474;0;0;0;0;.00nan;0;0
14717;66551;472;0;0;0;0;.00nan;0;0
14717;67222;482;100;36;0;36;1.000;3600000;0
14717;71297;472;65;34;3;31;.912;3600000;0
14717;87894;482;0;0;0;0;.00nan;0;0
14718;163528;682;65;29;3;26;.897;3600000;0
14718;11500;682;0;0;0;0;.00nan;0;0
14718;46139;473;0;0;0;0;.00nan;0;0
14718;85127;473;96;22;0;22;1.000;3600000;0
14719;12048;4535;70;18;1;17;.944;1571000;0
14719;-1;676;0;0;0;0;.00nan;0;0
14719;43158;676;67;26;3;23;.885;3600000;0
14719;70573;4535;9;19;6;13;.684;2029000;0
14720;3435;675;60;32;4;28;.875;3600000;0
14720;172527;675;0;0;0;0;.00nan;0;0
14720;168926;5004;72;24;1;23;.958;3600000;0
14720;46318;5004;0;0;0;0;.00nan;0;0
14721;-1;676;0;0;0;0;.00nan;0;0
14721;43158;676;67;27;3;24;.889;3600000;0
14721;46139;473;0;0;0;0;.00nan;0;0
14721;85127;473;50;33;4;29;.879;3571000;0
14722;163528;682;63;17;1;16;.941;3600000;0
14722;11500;682;0;0;0;0;.00nan;0;0
14722;66551;472;28;25;6;19;.760;3600000;0
14722;71297;472;0;0;0;0;.00nan;0;0
14723;190235;481;91;26;1;25;.962;3600000;0
14723;-1;480;0;0;0;0;.00nan;0;0
14723;56296;481;0;0;0;0;.00nan;0;0
14723;63107;480;55;36;6;30;.833;3600000;0
14724;12048;4535;76;25;2;23;.920;4020000;0
14724;53870;490;86;37;2;35;.946;4020000;0
14724;70573;4535;0;0;0;0;.00nan;0;0
14724;81096;490;0;0;0;0;.00nan;0;0
14725;38277;476;0;0;0;0;.00nan;0;0
14725;66491;474;47;49;7;42;.857;3600000;0
14725;78920;476;55;21;2;19;.905;3600000;0
14725;153779;474;0;0;0;0;.00nan;0;0
14726;3435;675;95;32;1;31;.969;3600000;0
14726;172527;675;0;0;0;0;.00nan;0;0
14726;46139;473;65;22;2;20;.909;3568000;0
14726;85127;473;0;0;0;0;.00nan;0;0
14727;190235;481;0;0;0;0;.00nan;0;0
14727;53870;490;68;27;2;25;.926;3137000;0
14727;56296;481;46;10;2;8;.800;3600000;0
14727;81096;490;41;13;3;10;.769;463000;0
14728;163528;682;47;39;5;34;.872;3600000;0
14728;11500;682;0;0;0;0;.00nan;0;0
14728;67222;482;67;40;4;36;.900;3600000;0
14728;87894;482;0;0;0;0;.00nan;0;0
14729;-1;676;0;0;0;0;.00nan;0;0
14729;-1;480;0;0;0;0;.00nan;0;0
14729;43158;676;79;42;3;39;.929;3600000;0
14729;63107;480;48;29;5;24;.828;3587000;0
14730;168926;5004;48;36;5;31;.861;3600000;0
14730;46318;5004;0;0;0;0;.00nan;0;0
14730;66551;472;0;0;0;0;.00nan;0;0
14730;71297;472;94;20;0;20;1.000;3600000;0
14731;38277;476;74;22;1;21;.955;4020000;0
14731;46139;473;79;35;1;34;.971;4020000;0
14731;78920;476;0;0;0;0;.00nan;0;0
14731;85127;473;0;0;0;0;.00nan;0;0
14732;53870;490;0;0;0;0;.00nan;0;0
14732;67222;482;57;26;3;23;.885;3600000;0
14732;81096;490;66;38;4;34;.895;3544000;0
14732;87894;482;0;0;0;0;.00nan;0;0
14733;168926;5004;78;37;3;34;.919;3575000;0
14733;190235;481;0;0;0;0;.00nan;0;0
14733;46318;5004;0;0;0;0;.00nan;0;0
14733;56296;481;53;12;2;10;.833;3600000;0
14734;3435;675;84;33;2;31;.939;3600000;0
14734;172527;675;0;0;0;0;.00nan;0;0
14734;-1;676;44;15;3;12;.800;3553000;0
14734;43158;676;0;0;0;0;.00nan;0;0
14735;12048;4535;0;0;0;0;.00nan;0;0
14735;66551;472;73;34;3;31;.912;3524000;0
14735;70573;4535;71;19;1;18;.947;3600000;0
14735;71297;472;0;0;0;0;.00nan;0;0
14736;-1;480;0;0;0;0;.00nan;0;0
14736;63107;480;70;17;1;16;.941;3600000;0
14736;66491;474;0;0;0;0;.00nan;0;0
14736;153779;474;79;35;2;33;.943;3600000;0
14737;190235;481;65;30;3;27;.900;3600000;0
14737;56296;481;0;0;0;0;.00nan;0;0
14737;67222;482;0;0;0;0;.00nan;0;0
14737;87894;482;51;32;5;27;.844;3544000;0
14738;163528;682;52;25;3;22;.880;3600000;0
14738;11500;682;0;0;0;0;.00nan;0;0
14738;190235;481;0;0;0;0;.00nan;0;0
14738;56296;481;83;29;1;28;.966;3600000;0
14739;168926;5004;94;55;4;51;.927;3553000;0
14739;38277;476;0;0;0;0;.00nan;0;0
14739;46318;5004;0;0;0;0;.00nan;0;0
14739;78920;476;64;18;2;16;.889;3600000;0
14740;12048;4535;0;0;0;0;.00nan;0;0
14740;67222;482;0;0;0;0;.00nan;0;0
14740;70573;4535;63;34;3;31;.912;4020000;0
14740;87894;482;72;36;3;33;.917;4020000;0
14741;-1;676;0;0;0;0;.00nan;0;0
14741;43158;676;58;14;2;12;.857;3600000;0
14741;66491;474;81;51;4;47;.922;3600000;0
14741;153779;474;0;0;0;0;.00nan;0;0
14742;46139;473;89;15;0;15;1.000;3600000;0
14742;66551;472;0;0;0;0;.00nan;0;0
14742;71297;472;48;28;4;24;.857;3600000;0
14742;85127;473;0;0;0;0;.00nan;0;0
14743;53870;490;0;0;0;0;.00nan;0;0
14743;66551;472;77;30;2;28;.933;3759000;0
14743;71297;472;0;0;0;0;.00nan;0;0
14743;81096;490;91;45;3;42;.933;3759000;0
14744;12048;4535;56;24;4;20;.833;4020000;0
14744;66491;474;71;48;4;44;.917;4020000;0
14744;70573;4535;0;0;0;0;.00nan;0;0
14744;153779;474;0;0;0;0;.00nan;0;0
14745;3435;675;74;30;2;28;.933;3545000;0
14745;172527;675;0;0;0;0;.00nan;0;0
14745;67222;482;79;25;1;24;.960;3600000;0
14745;87894;482;0;0;0;0;.00nan;0;0
14746;168926;5004;0;0;0;0;.00nan;0;0
14746;-1;676;0;0;0;0;.00nan;0;0
14746;43158;676;100;24;0;24;1.000;3600000;0
14746;46318;5004;97;42;1;41;.976;3600000;0
14747;163528;682;78;30;2;28;.933;3600000;0
14747;11500;682;0;0;0;0;.00nan;0;0
14747;38277;476;0;0;0;0;.00nan;0;0
14747;78920;476;69;39;3;36;.923;3581000;0
14748;190235;481;0;0;0;0;.00nan;0;0
14748;46139;473;61;44;5;39;.886;3996000;0
14748;56296;481;56;36;6;30;.833;3996000;0
14748;85127;473;0;0;0;0;.00nan;0;0
14749;190235;481;0;0;0;0;.00nan;0;0
14749;38277;476;0;0;0;0;.00nan;0;0
14749;56296;481;78;44;4;40;.909;3640000;0
14749;78920;476;60;24;3;21;.875;3640000;0
14750;12048;4535;0;0;0;0;.00nan;0;0
14750;168926;5004;79;36;3;33;.917;3600000;0
14750;46318;5004;0;0;0;0;.00nan;0;0
14750;70573;4535;71;22;2;20;.909;3600000;0
14751;-1;676;0;0;0;0;.00nan;0;0
14751;43158;676;78;37;3;34;.919;3600000;0
14751;67222;482;97;34;1;33;.971;3600000;0
14751;87894;482;0;0;0;0;.00nan;0;0
14752;3435;675;62;34;4;30;.882;3600000;0
14752;163528;682;0;0;0;0;.00nan;0;0
14752;172527;675;0;0;0;0;.00nan;0;0
14752;11500;682;97;20;0;20;1.000;3600000;0
14753;-1;480;0;0;0;0;.00nan;0;0
14753;46139;473;53;40;5;35;.875;3544000;0
14753;63107;480;59;28;4;24;.857;3600000;0
14753;85127;473;0;0;0;0;.00nan;0;0
14754;53870;490;0;0;0;0;.00nan;0;0
14754;66491;474;77;33;3;30;.909;3600000;0
14754;81096;490;76;43;4;39;.907;3589000;0
14754;153779;474;0;0;0;0;.00nan;0;0
14755;-1;480;0;0;0;0;.00nan;0;0
14755;53870;490;0;0;0;0;.00nan;0;0
14755;63107;480;73;18;1;17;.944;3600000;0
14755;81096;490;65;40;4;36;.900;3600000;0
14756;46139;473;89;24;1;23;.958;3600000;0
14756;66551;472;0;0;0;0;.00nan;0;0
14756;71297;472;94;39;2;37;.949;3553000;0
14756;85127;473;0;0;0;0;.00nan;0;0
14757;3435;675;83;35;1;34;.971;3600000;0
14757;172527;675;0;0;0;0;.00nan;0;0
14757;66491;474;69;29;3;26;.897;3575000;0
14757;153779;474;0;0;0;0;.00nan;0;0
14758;-1;676;0;0;0;0;.00nan;0;0
14758;190235;481;60;42;5;37;.881;3600000;0
14758;43158;676;69;15;1;14;.933;3600000;0
14758;56296;481;0;0;0;0;.00nan;0;0
14759;38277;476;0;0;0;0;.00nan;0;0
14759;67222;482;98;50;2;48;.960;3540000;0
14759;78920;476;100;33;0;33;1.000;3600000;0
14759;87894;482;0;0;0;0;.00nan;0;0
14760;163528;682;0;0;0;0;.00nan;0;0
14760;11500;682;76;27;2;25;.926;3585000;0
14760;12048;4535;0;0;0;0;.00nan;0;0
14760;70573;4535;93;33;1;32;.970;3600000;0
14761;168926;5004;91;31;1;30;.968;3600000;0
14761;190235;481;0;0;0;0;.00nan;0;0
14761;46318;5004;0;0;0;0;.00nan;0;0
14761;56296;481;53;27;4;23;.852;3600000;0
14762;3435;675;67;30;3;27;.900;3586000;0
14762;172527;675;0;0;0;0;.00nan;0;0
14762;38277;476;0;0;0;0;.00nan;0;0
14762;78920;476;62;15;1;14;.933;3600000;0
14763;53870;490;0;0;0;0;.00nan;0;0
14763;67222;482;55;14;2;12;.857;3600000;0
14763;81096;490;94;47;3;44;.936;3562000;0
14763;87894;482;0;0;0;0;.00nan;0;0
14764;163528;682;65;22;2;20;.909;3740000;0
14764;11500;682;0;0;0;0;.00nan;0;0
14764;66551;472;91;33;1;32;.970;3740000;0
14764;71297;472;0;0;0;0;.00nan;0;0
14765;-1;676;0;0;0;0;.00nan;0;0
14765;43158;676;57;30;3;27;.900;3569000;0
14765;46139;473;68;22;2;20;.909;3600000;0
14765;85127;473;0;0;0;0;.00nan;0;0
14766;12048;4535;0;0;0;0;.00nan;0;0
14766;66491;474;80;41;3;38;.927;3600000;0
14766;70573;4535;50;16;2;14;.875;3600000;0
14766;153779;474;0;0;0;0;.00nan;0;0
14767;3435;675;93;52;3;49;.942;3578000;0
14767;172527;675;0;0;0;0;.00nan;0;0
14767;66551;472;0;0;0;0;.00nan;0;0
14767;71297;472;68;22;1;21;.955;3600000;0
14768;38277;476;0;0;0;0;.00nan;0;0
14768;53870;490;56;4;0;4;1.000;332000;0
14768;78920;476;85;14;0;14;1.000;3600000;0
14768;81096;490;57;47;6;41;.872;3268000;0
14769;168926;5004;84;47;4;43;.915;3583000;0
14769;-1;676;0;0;0;0;.00nan;0;0
14769;43158;676;71;26;2;24;.923;3600000;0
14769;46318;5004;0;0;0;0;.00nan;0;0
14770;163528;682;100;29;0;29;1.000;3600000;0
14770;11500;682;0;0;0;0;.00nan;0;0
14770;46139;473;92;48;4;44;.917;3600000;0
14770;85127;473;0;0;0;0;.00nan;0;0
14771;-1;480;0;0;0;0;.00nan;0;0
14771;63107;480;62;13;1;12;.923;3600000;0
14771;66491;474;74;52;5;47;.904;3600000;0
14771;153779;474;0;0;0;0;.00nan;0;0
14772;12048;4535;0;0;0;0;.00nan;0;0
14772;190235;481;85;17;0;17;1.000;3600000;0
14772;56296;481;0;0;0;0;.00nan;0;0
14772;70573;4535;91;49;4;45;.918;3600000;0
14773;190235;481;82;25;1;24;.960;3600000;0
14773;-1;480;0;0;0;0;.00nan;0;0
14773;56296;481;0;0;0;0;.00nan;0;0
14773;63107;480;88;42;2;40;.952;3600000;0
14774;163528;682;57;15;2;13;.867;3600000;0
14774;11500;682;0;0;0;0;.00nan;0;0
14774;168926;5004;42;37;6;31;.838;2948000;0
14774;46318;5004;64;9;0;9;1.000;652000;0
14775;3435;675;59;39;5;34;.872;3073000;0
14775;172527;675;56;13;1;12;.923;527000;0
14775;67222;482;55;24;3;21;.875;3600000;0
14775;87894;482;0;0;0;0;.00nan;0;0
14776;53870;490;0;0;0;0;.00nan;0;0
14776;66551;472;59;19;2;17;.895;3600000;0
14776;71297;472;0;0;0;0;.00nan;0;0
14776;81096;490;89;54;4;50;.926;3590000;0
14777;38277;476;0;0;0;0;.00nan;0;0
14777;46139;473;76;37;3;34;.919;3546000;0
14777;78920;476;64;26;2;24;.923;3600000;0
14777;85127;473;0;0;0;0;.00nan;0;0
14778;-1;676;0;0;0;0;.00nan;0;0
14778;43158;676;58;17;2;15;.882;3600000;0
14778;66491;474;65;51;6;45;.882;3600000;0
14778;153779;474;0;0;0;0;.00nan;0;0
14779;3435;675;73;34;3;31;.912;4020000;0
14779;172527;675;0;0;0;0;.00nan;0;0
14779;12048;4535;0;0;0;0;.00nan;0;0
14779;70573;4535;78;32;3;29;.906;4020000;0
14780;168926;5004;61;48;6;42;.875;3600000;0
14780;46318;5004;0;0;0;0;.00nan;0;0
14780;66551;472;0;0;0;0;.00nan;0;0
14780;71297;472;53;19;2;17;.895;3600000;0
14781;46139;473;77;26;1;25;.962;3600000;0
14781;67222;482;0;0;0;0;.00nan;0;0
14781;85127;473;0;0;0;0;.00nan;0;0
14781;87894;482;52;30;4;26;.867;3600000;0
14782;-1;676;0;0;0;0;.00nan;0;0
14782;38277;476;0;0;0;0;.00nan;0;0
14782;43158;676;62;40;4;36;.900;3595000;0
14782;78920;476;56;22;3;19;.864;3600000;0
14783;163528;682;76;31;2;29;.935;3553000;0
14783;11500;682;0;0;0;0;.00nan;0;0
14783;-1;480;0;0;0;0;.00nan;0;0
14783;63107;480;100;45;1;44;.978;3600000;0
14784;3435;675;0;0;0;0;.00nan;0;0
14784;172527;675;89;42;2;40;.952;3591000;0
14784;-1;676;0;0;0;0;.00nan;0;0
14784;43158;676;61;15;1;14;.933;3600000;0
14785;190235;481;0;0;0;0;.00nan;0;0
14785;56296;481;100;24;0;24;1.000;3600000;0
14785;67222;482;61;31;4;27;.871;3600000;0
14785;87894;482;0;0;0;0;.00nan;0;0
14786;163528;682;21;24;6;18;.750;3600000;0
14786;11500;682;0;0;0;0;.00nan;0;0
14786;38277;476;0;0;0;0;.00nan;0;0
14786;78920;476;76;23;2;21;.913;3600000;0
14787;-1;480;0;0;0;0;.00nan;0;0
14787;63107;480;75;38;4;34;.895;3546000;0
14787;66551;472;65;29;3;26;.897;3600000;0
14787;71297;472;0;0;0;0;.00nan;0;0
14788;46139;473;0;0;0;0;.00nan;0;0
14788;66491;474;51;33;5;28;.848;3592000;0
14788;85127;473;32;19;4;15;.789;3600000;0
14788;153779;474;0;0;0;0;.00nan;0;0
14789;12048;4535;59;20;2;18;.900;3600000;0
14789;168926;5004;37;20;4;16;.800;3517000;0
14789;46318;5004;0;0;0;0;.00nan;0;0
14789;70573;4535;0;0;0;0;.00nan;0;0
14790;53870;490;0;0;0;0;.00nan;0;0
14790;66491;474;54;5;0;5;1.000;452000;0
14790;81096;490;82;26;1;25;.962;3600000;0
14790;153779;474;25;29;7;22;.759;3148000;0
14791;46139;473;51;14;2;12;.857;3600000;0
14791;53870;490;56;46;6;40;.870;2472000;0
14791;81096;490;43;24;4;20;.833;1128000;0
14791;85127;473;0;0;0;0;.00nan;0;0
14792;168926;5004;93;32;1;31;.969;3600000;0
14792;38277;476;0;0;0;0;.00nan;0;0
14792;46318;5004;0;0;0;0;.00nan;0;0
14792;78920;476;66;27;3;24;.889;3568000;0
14793;66551;472;0;0;0;0;.00nan;0;0
14793;67222;482;58;34;4;30;.882;3705000;0
14793;71297;472;73;34;3;31;.912;3705000;0
14793;87894;482;0;0;0;0;.00nan;0;0
14794;12048;4535;0;0;0;0;.00nan;0;0
14794;-1;676;0;0;0;0;.00nan;0;0
14794;43158;676;77;26;1;25;.962;3600000;0
14794;70573;4535;66;36;3;33;.917;3512000;0
14795;163528;682;58;19;2;17;.895;3600000;0
14795;11500;682;0;0;0;0;.00nan;0;0
14795;190235;481;0;0;0;0;.00nan;0;0
14795;56296;481;60;36;4;32;.889;3600000;0
14796;3435;675;88;44;3;41;.932;3600000;0
14796;172527;675;0;0;0;0;.00nan;0;0
14796;-1;480;0;0;0;0;.00nan;0;0
14796;63107;480;60;17;2;15;.882;3600000;0
14797;190235;481;0;0;0;0;.00nan;0;0
14797;56296;481;50;28;4;24;.857;3600000;0
14797;66551;472;51;39;6;33;.846;3599000;0
14797;71297;472;0;0;0;0;.00nan;0;0
14798;12048;4535;0;0;0;0;.00nan;0;0
14798;38277;476;0;0;0;0;.00nan;0;0
14798;70573;4535;92;44;3;41;.932;3600000;0
14798;78920;476;90;19;0;19;1.000;3600000;0
14799;-1;676;0;0;0;0;.00nan;0;0
14799;43158;676;70;19;2;17;.895;3600000;0
14799;53870;490;49;1;0;1;1.000;245000;0
14799;81096;490;62;50;6;44;.880;3355000;0
14800;-1;480;0;0;0;0;.00nan;0;0
14800;63107;480;85;37;3;34;.919;3600000;0
14800;67222;482;49;25;4;21;.840;2249000;0
14800;87894;482;53;22;3;19;.864;1351000;0
14801;3435;675;88;50;4;46;.920;3600000;0
14801;172527;675;0;0;0;0;.00nan;0;0
14801;46139;473;71;17;1;16;.941;3600000;0
14801;85127;473;0;0;0;0;.00nan;0;0
14802;168926;5004;57;26;3;23;.885;3600000;0
14802;46318;5004;0;0;0;0;.00nan;0;0
14802;66491;474;61;37;5;32;.865;3584000;0
14802;153779;474;0;0;0;0;.00nan;0;0
14803;3435;675;80;29;2;27;.931;3600000;0
14803;172527;675;0;0;0;0;.00nan;0;0
14803;53870;490;75;34;3;31;.912;3547000;0
14803;81096;490;0;0;0;0;.00nan;0;0
14804;168926;5004;75;39;4;35;.897;3600000;0
14804;-1;480;49;19;3;16;.842;3600000;0
14804;46318;5004;0;0;0;0;.00nan;0;0
14804;63107;480;0;0;0;0;.00nan;0;0
14805;66491;474;0;0;0;0;.00nan;0;0
14805;67222;482;100;28;0;28;1.000;3600000;0
14805;87894;482;0;0;0;0;.00nan;0;0
14805;153779;474;61;37;4;33;.892;3600000;0
14806;190235;481;39;34;6;28;.824;3600000;0
14806;46139;473;85;30;2;28;.933;3600000;0
14806;56296;481;0;0;0;0;.00nan;0;0
14806;85127;473;0;0;0;0;.00nan;0;0
14807;163528;682;79;28;1;27;.964;3656000;0
14807;11500;682;0;0;0;0;.00nan;0;0
14807;-1;676;74;25;2;23;.920;3656000;0
14807;43158;676;0;0;0;0;.00nan;0;0
14808;12048;4535;60;7;0;7;1.000;1424000;0
14808;66551;472;37;28;6;22;.786;4020000;0
14808;70573;4535;53;38;6;32;.842;2596000;0
14808;71297;472;0;0;0;0;.00nan;0;0
14809;190235;481;0;0;0;0;.00nan;0;0
14809;56296;481;59;16;2;14;.875;3600000;0
14809;66491;474;39;31;6;25;.806;2285000;0
14809;153779;474;54;12;1;11;.917;1315000;0
14810;38277;476;0;0;0;0;.00nan;0;0
14810;-1;480;0;0;0;0;.00nan;0;0
14810;63107;480;100;37;0;37;1.000;3600000;0
14810;78920;476;70;24;2;22;.917;3530000;0
14811;168926;5004;48;33;5;28;.848;3550000;0
14811;46318;5004;0;0;0;0;.00nan;0;0
14811;53870;490;0;0;0;0;.00nan;0;0
14811;81096;490;71;39;4;35;.897;3600000;0
14812;-1;676;0;0;0;0;.00nan;0;0
14812;43158;676;84;25;1;24;.960;3600000;0
14812;66551;472;78;31;2;29;.935;3600000;0
14812;71297;472;0;0;0;0;.00nan;0;0
14813;163528;682;82;21;1;20;.952;3600000;0
14813;11500;682;0;0;0;0;.00nan;0;0
14813;67222;482;74;51;5;46;.902;3600000;0
14813;87894;482;0;0;0;0;.00nan;0;0
14814;12048;4535;58;24;3;21;.875;4020000;0
14814;46139;473;90;38;3;35;.921;4020000;0
14814;70573;4535;0;0;0;0;.00nan;0;0
14814;85127;473;0;0;0;0;.00nan;0;0
14815;3435;675;79;34;3;31;.912;3600000;0
14815;163528;682;70;26;2;24;.923;3600000;0
14815;172527;675;0;0;0;0;.00nan;0;0
14815;11500;682;0;0;0;0;.00nan;0;0
14816;38277;476;0;0;0;0;.00nan;0;0
14816;66491;474;79;56;5;51;.911;3600000;0
14816;78920;476;43;13;2;11;.846;3600000;0
14816;153779;474;0;0;0;0;.00nan;0;0
14817;190235;481;0;0;0;0;.00nan;0;0
14817;53870;490;0;0;0;0;.00nan;0;0
14817;56296;481;47;35;5;30;.857;3600000;0
14817;81096;490;100;31;1;30;.968;3600000;0
14818;-1;676;0;0;0;0;.00nan;0;0
14818;43158;676;64;19;2;17;.895;3600000;0
14818;67222;482;0;0;0;0;.00nan;0;0
14818;87894;482;57;39;5;34;.872;3600000;0
14819;12048;4535;0;0;0;0;.00nan;0;0
14819;-1;480;0;0;0;0;.00nan;0;0
14819;63107;480;79;32;2;30;.938;3616000;0
14819;70573;4535;74;32;3;29;.906;3616000;0
14820;168926;5004;72;45;4;41;.911;3600000;0
14820;46139;473;67;16;1;15;.938;3600000;0
14820;46318;5004;0;0;0;0;.00nan;0;0
14820;85127;473;0;0;0;0;.00nan;0;0
14821;190235;481;69;27;2;25;.926;3600000;0
14821;38277;476;0;0;0;0;.00nan;0;0
14821;56296;481;0;0;0;0;.00nan;0;0
14821;78920;476;84;26;1;25;.962;3600000;0
14822;3435;675;92;35;1;34;.971;3600000;0
14822;172527;675;0;0;0;0;.00nan;0;0
14822;168926;5004;52;24;3;21;.875;3576000;0
14822;46318;5004;0;0;0;0;.00nan;0;0
14823;-1;676;0;0;0;0;.00nan;0;0
14823;-1;480;0;0;0;0;.00nan;0;0
14823;43158;676;81;27;1;26;.963;3600000;0
14823;63107;480;91;38;2;36;.947;3583000;0
14824;163528;682;53;10;1;9;.900;3600000;0
14824;11500;682;0;0;0;0;.00nan;0;0
14824;53870;490;0;0;0;0;.00nan;0;0
14824;81096;490;97;58;4;54;.931;3600000;0
14825;12048;4535;69;18;1;17;.944;2436000;0
14825;67222;482;90;30;1;29;.967;3600000;0
14825;70573;4535;28;13;4;9;.692;1164000;0
14825;87894;482;0;0;0;0;.00nan;0;0
14826;66491;474;94;37;1;36;.973;3600000;0
14826;66551;472;0;0;0;0;.00nan;0;0
14826;71297;472;38;13;3;10;.769;3518000;0
14826;153779;474;0;0;0;0;.00nan;0;0
14827;3435;675;86;48;4;44;.917;3590000;0
14827;172527;675;0;0;0;0;.00nan;0;0
14827;190235;481;0;0;0;0;.00nan;0;0
14827;56296;481;71;19;2;17;.895;3600000;0
14828;12048;4535;0;0;0;0;.00nan;0;0
14828;53870;490;0;0;0;0;.00nan;0;0
14828;70573;4535;36;22;4;18;.818;3581000;0
14828;81096;490;93;41;2;39;.951;3600000;0
14829;168926;5004;75;36;3;33;.917;3591000;0
14829;46318;5004;0;0;0;0;.00nan;0;0
14829;67222;482;71;22;2;20;.909;3600000;0
14829;87894;482;0;0;0;0;.00nan;0;0
14830;38277;476;0;0;0;0;.00nan;0;0
14830;66551;472;0;0;0;0;.00nan;0;0
14830;71297;472;77;24;1;23;.958;3600000;0
14830;78920;476;96;44;3;41;.932;3517000;0
14831;-1;480;0;0;0;0;.00nan;0;0
14831;46139;473;67;34;3;31;.912;3545000;0
14831;63107;480;83;24;1;23;.958;3600000;0
14831;85127;473;0;0;0;0;.00nan;0;0
14832;163528;682;69;9;0;9;1.000;3600000;0
14832;11500;682;0;0;0;0;.00nan;0;0
14832;66491;474;53;12;1;11;.917;687000;0
14832;153779;474;70;51;6;45;.882;2913000;0
14833;-1;480;28;13;4;9;.692;3600000;0
14833;53870;490;0;0;0;0;.00nan;0;0
14833;63107;480;0;0;0;0;.00nan;0;0
14833;81096;490;72;51;5;46;.902;3544000;0
14834;190235;481;75;24;2;22;.917;3600000;0
14834;56296;481;0;0;0;0;.00nan;0;0
14834;66551;472;73;31;3;28;.903;3552000;0
14834;71297;472;0;0;0;0;.00nan;0;0
14835;3435;675;67;34;3;31;.912;3528000;0
14835;172527;675;0;0;0;0;.00nan;0;0
14835;-1;676;0;0;0;0;.00nan;0;0
14835;43158;676;92;29;1;28;.966;3600000;0
14836;168926;5004;67;37;4;33;.892;3711000;0
14836;38277;476;0;0;0;0;.00nan;0;0
14836;46318;5004;0;0;0;0;.00nan;0;0
14836;78920;476;67;25;3;22;.880;3711000;0
14837;46139;473;75;22;2;20;.909;3600000;0
14837;66491;474;30;22;4;18;.818;1136000;0
14837;85127;473;0;0;0;0;.00nan;0;0
14837;153779;474;64;30;3;27;.900;2464000;0
14838;163528;682;100;30;1;29;.967;3600000;0
14838;11500;682;0;0;0;0;.00nan;0;0
14838;12048;4535;0;0;0;0;.00nan;0;0
14838;70573;4535;88;33;2;31;.939;3569000;0
14839;53870;490;0;0;0;0;.00nan;0;0
14839;66491;474;46;26;4;22;.846;3590000;0
14839;81096;490;79;36;3;33;.917;3600000;0
14839;153779;474;0;0;0;0;.00nan;0;0
14840;190235;481;0;0;0;0;.00nan;0;0
14840;46139;473;40;22;4;18;.818;3600000;0
14840;56296;481;99;42;2;40;.952;3600000;0
14840;85127;473;0;0;0;0;.00nan;0;0
14841;3435;675;67;40;5;35;.875;3524000;0
14841;172527;675;0;0;0;0;.00nan;0;0
14841;53870;490;0;0;0;0;.00nan;0;0
14841;81096;490;78;29;3;26;.897;3600000;0
14842;168926;5004;0;0;0;0;.00nan;0;0
14842;46318;5004;76;49;4;45;.918;3600000;0
14842;66551;472;0;0;0;0;.00nan;0;0
14842;71297;472;77;25;1;24;.960;3600000;0
14843;-1;676;0;0;0;0;.00nan;0;0
14843;38277;476;0;0;0;0;.00nan;0;0
14843;43158;676;88;31;1;30;.968;3600000;0
14843;78920;476;66;32;3;29;.906;3526000;0
14844;-1;480;0;0;0;0;.00nan;0;0
14844;63107;480;51;29;4;25;.862;3600000;0
14844;67222;482;38;45;7;38;.844;3600000;0
14844;87894;482;0;0;0;0;.00nan;0;0
14845;12048;4535;0;0;0;0;.00nan;0;0
14845;66491;474;80;46;4;42;.913;3538000;0
14845;70573;4535;69;27;2;25;.926;3600000;0
14845;153779;474;0;0;0;0;.00nan;0;0
14846;3435;675;34;44;8;36;.818;3600000;0
14846;172527;675;0;0;0;0;.00nan;0;0
14846;46139;473;0;0;0;0;.00nan;0;0
14846;85127;473;59;20;2;18;.900;3600000;0
14847;66491;474;0;0;0;0;.00nan;0;0
14847;67222;482;98;24;0;24;1.000;3600000;0
14847;87894;482;0;0;0;0;.00nan;0;0
14847;153779;474;93;50;3;47;.940;3600000;0
14848;190235;481;73;42;4;38;.905;3735000;0
14848;38277;476;57;25;3;22;.880;3735000;0
14848;56296;481;0;0;0;0;.00nan;0;0
14848;78920;476;0;0;0;0;.00nan;0;0
14849;163528;682;65;31;4;27;.871;3600000;0
14849;11500;682;0;0;0;0;.00nan;0;0
14849;-1;480;0;0;0;0;.00nan;0;0
14849;63107;480;76;24;1;23;.958;3600000;0
14850;53870;490;0;0;0;0;.00nan;0;0
14850;66551;472;68;16;1;15;.938;3600000;0
14850;71297;472;0;0;0;0;.00nan;0;0
14850;81096;490;96;40;2;38;.950;3545000;0
14851;12048;4535;0;0;0;0;.00nan;0;0
14851;-1;676;0;0;0;0;.00nan;0;0
14851;43158;676;74;31;2;29;.935;4020000;0
14851;70573;4535;85;37;2;35;.946;4020000;0
14852;3435;675;0;0;0;0;.00nan;0;0
14852;172527;675;57;39;4;35;.897;3513000;0
14852;-1;480;0;0;0;0;.00nan;0;0
14852;63107;480;70;28;2;26;.929;3600000;0
14853;3435;675;73;39;5;34;.872;3600000;0
14853;172527;675;0;0;0;0;.00nan;0;0
14853;168926;5004;85;32;2;30;.938;3600000;0
14853;46318;5004;0;0;0;0;.00nan;0;0
14854;163528;682;54;25;4;21;.840;3600000;0
14854;11500;682;0;0;0;0;.00nan;0;0
14854;-1;676;0;0;0;0;.00nan;0;0
14854;43158;676;90;40;2;38;.950;3600000;0
14855;-1;480;0;0;0;0;.00nan;0;0
14855;63107;480;32;27;5;22;.815;3600000;0
14855;66551;472;0;0;0;0;.00nan;0;0
14855;71297;472;100;49;2;47;.959;3600000;0
14856;38277;476;0;0;0;0;.00nan;0;0
14856;46139;473;89;33;1;32;.970;4020000;0
14856;78920;476;100;54;1;53;.981;4020000;0
14856;85127;473;0;0;0;0;.00nan;0;0
14857;53870;490;0;0;0;0;.00nan;0;0
14857;66491;474;67;24;2;22;.917;3554000;0
14857;81096;490;97;35;1;34;.971;3600000;0
14857;153779;474;0;0;0;0;.00nan;0;0
14858;190235;481;0;0;0;0;.00nan;0;0
14858;53870;490;0;0;0;0;.00nan;0;0
14858;56296;481;54;23;3;20;.870;3600000;0
14858;81096;490;89;47;4;43;.915;3542000;0
14859;38277;476;0;0;0;0;.00nan;0;0
14859;67222;482;76;59;7;52;.881;3600000;0
14859;78920;476;99;29;0;29;1.000;3600000;0
14859;87894;482;0;0;0;0;.00nan;0;0
14860;168926;5004;75;36;2;34;.944;3586000;0
14860;-1;676;0;0;0;0;.00nan;0;0
14860;43158;676;73;21;1;20;.952;3600000;0
14860;46318;5004;0;0;0;0;.00nan;0;0
14861;163528;682;66;33;4;29;.879;3543000;0
14861;11500;682;0;0;0;0;.00nan;0;0
14861;66551;472;86;36;3;33;.917;3600000;0
14861;71297;472;0;0;0;0;.00nan;0;0
14862;-1;480;0;0;0;0;.00nan;0;0
14862;46139;473;78;39;3;36;.923;3908000;0
14862;63107;480;66;22;2;20;.909;3908000;0
14862;85127;473;0;0;0;0;.00nan;0;0
14863;3435;675;76;34;3;31;.912;3546000;0
14863;172527;675;0;0;0;0;.00nan;0;0
14863;12048;4535;0;0;0;0;.00nan;0;0
14863;70573;4535;72;25;1;24;.960;3600000;0
14864;190235;481;0;0;0;0;.00nan;0;0
14864;-1;480;0;0;0;0;.00nan;0;0
14864;56296;481;79;34;2;32;.941;3785000;0
14864;63107;480;66;28;3;25;.893;3785000;0
14865;12048;4535;0;0;0;0;.00nan;0;0
14865;38277;476;0;0;0;0;.00nan;0;0
14865;70573;4535;76;39;3;36;.923;3600000;0
14865;78920;476;91;28;1;27;.964;3600000;0
14866;168926;5004;76;25;1;24;.960;3600000;0
14866;46318;5004;0;0;0;0;.00nan;0;0
14866;53870;490;0;0;0;0;.00nan;0;0
14866;81096;490;78;30;2;28;.933;3582000;0
14867;-1;676;0;0;0;0;.00nan;0;0
14867;43158;676;56;24;3;21;.875;3600000;0
14867;67222;482;75;49;4;45;.918;3578000;0
14867;87894;482;0;0;0;0;.00nan;0;0
14868;66491;474;71;33;3;30;.909;3600000;0
14868;66551;472;0;0;0;0;.00nan;0;0
14868;71297;472;27;25;5;20;.800;3535000;0
14868;153779;474;0;0;0;0;.00nan;0;0
14869;163528;682;85;29;1;28;.966;3600000;0
14869;11500;682;0;0;0;0;.00nan;0;0
14869;46139;473;66;23;2;21;.913;3583000;0
14869;85127;473;0;0;0;0;.00nan;0;0
14870;3435;675;72;55;6;49;.891;3354000;0
14870;172527;675;55;5;0;5;1.000;246000;0
14870;38277;476;0;0;0;0;.00nan;0;0
14870;78920;476;38;19;4;15;.789;3600000;0
14871;168926;5004;95;41;2;39;.951;3577000;0
14871;46139;473;63;16;1;15;.938;3600000;0
14871;46318;5004;0;0;0;0;.00nan;0;0
14871;85127;473;0;0;0;0;.00nan;0;0
14872;-1;676;79;29;2;27;.931;3600000;0
14872;43158;676;0;0;0;0;.00nan;0;0
14872;66551;472;70;38;3;35;.921;3543000;0
14872;71297;472;0;0;0;0;.00nan;0;0
14873;163528;682;0;0;0;0;.00nan;0;0
14873;11500;682;67;34;4;30;.882;3600000;0
14873;67222;482;100;33;0;33;1.000;3600000;0
14873;87894;482;0;0;0;0;.00nan;0;0
14874;12048;4535;0;0;0;0;.00nan;0;0
14874;53870;490;0;0;0;0;.00nan;0;0
14874;70573;4535;83;22;1;21;.955;3600000;0
14874;81096;490;79;41;2;39;.951;3600000;0
14875;190235;481;79;14;0;14;1.000;3600000;0
14875;56296;481;0;0;0;0;.00nan;0;0
14875;66491;474;71;53;6;47;.887;3600000;0
14875;153779;474;0;0;0;0;.00nan;0;0
14876;168926;5004;100;50;2;48;.960;3600000;0
14876;190235;481;16;17;6;11;.647;3600000;0
14876;46318;5004;0;0;0;0;.00nan;0;0
14876;56296;481;0;0;0;0;.00nan;0;0
14877;-1;676;0;0;0;0;.00nan;0;0
14877;43158;676;74;20;1;19;.950;3600000;0
14877;53870;490;51;5;0;5;1.000;602000;0
14877;81096;490;56;46;6;40;.870;2998000;0
14878;3435;675;61;22;2;20;.909;3600000;0
14878;172527;675;0;0;0;0;.00nan;0;0
14878;67222;482;51;29;4;25;.862;3513000;0
14878;87894;482;0;0;0;0;.00nan;0;0
14879;163528;682;100;29;0;29;1.000;3600000;0
14879;11500;682;0;0;0;0;.00nan;0;0
14879;38277;476;0;0;0;0;.00nan;0;0
14879;78920;476;69;30;3;27;.900;3600000;0
14880;-1;480;0;0;0;0;.00nan;0;0
14880;63107;480;100;18;0;18;1.000;3600000;0
14880;66491;474;60;56;7;49;.875;2877000;0
14880;153779;474;62;13;1;12;.923;723000;0
14881;12048;4535;0;0;0;0;.00nan;0;0
14881;66551;472;0;0;0;0;.00nan;0;0
14881;70573;4535;72;31;2;29;.935;4020000;0
14881;71297;472;65;26;2;24;.923;4020000;0
14882;3435;675;55;33;4;29;.879;3555000;0
14882;172527;675;0;0;0;0;.00nan;0;0
14882;66491;474;85;35;2;33;.943;3600000;0
14882;153779;474;0;0;0;0;.00nan;0;0
14883;38277;476;0;0;0;0;.00nan;0;0
14883;-1;480;0;0;0;0;.00nan;0;0
14883;63107;480;52;25;4;21;.840;3548000;0
14883;78920;476;91;38;3;35;.921;3600000;0
14884;53870;490;0;0;0;0;.00nan;0;0
14884;67222;482;49;18;3;15;.833;3600000;0
14884;81096;490;81;56;5;51;.911;3567000;0
14884;87894;482;0;0;0;0;.00nan;0;0
14885;163528;682;83;18;1;17;.944;3600000;0
14885;11500;682;0;0;0;0;.00nan;0;0
14885;168926;5004;46;31;6;25;.806;2788000;0
14885;46318;5004;45;11;2;9;.818;812000;0
14886;-1;676;0;0;0;0;.00nan;0;0
14886;43158;676;76;26;1;25;.962;3600000;0
14886;46139;473;70;45;5;40;.889;3600000;0
14886;85127;473;0;0;0;0;.00nan;0;0
14887;12048;4535;69;35;4;31;.886;4000000;0
14887;190235;481;0;0;0;0;.00nan;0;0
14887;56296;481;71;30;3;27;.900;4000000;0
14887;70573;4535;0;0;0;0;.00nan;0;0
14888;168926;5004;82;26;1;25;.962;3600000;0
14888;46318;5004;0;0;0;0;.00nan;0;0
14888;67222;482;55;5;0;5;1.000;526000;0
14888;87894;482;25;29;6;23;.793;3074000;0
14889;163528;682;46;32;5;27;.844;3600000;0
14889;11500;682;0;0;0;0;.00nan;0;0
14889;190235;481;0;0;0;0;.00nan;0;0
14889;56296;481;98;36;2;34;.944;3600000;0
14890;12048;4535;0;0;0;0;.00nan;0;0
14890;-1;480;0;0;0;0;.00nan;0;0
14890;63107;480;100;37;2;35;.946;3600000;0
14890;70573;4535;67;35;4;31;.886;3545000;0
14891;3435;675;99;40;1;39;.975;3600000;0
14891;172527;675;0;0;0;0;.00nan;0;0
14891;66551;472;38;33;6;27;.818;2802000;0
14891;71297;472;51;5;0;5;1.000;798000;0
14892;46139;473;0;0;0;0;.00nan;0;0
14892;53870;490;0;0;0;0;.00nan;0;0
14892;81096;490;85;51;4;47;.922;3600000;0
14892;85127;473;100;29;0;29;1.000;3600000;0
14893;38277;476;0;0;0;0;.00nan;0;0
14893;66491;474;92;45;2;43;.956;3600000;0
14893;78920;476;76;10;0;10;1.000;3600000;0
14893;153779;474;0;0;0;0;.00nan;0;0
14894;3435;675;89;37;3;34;.919;3874000;0
14894;172527;675;0;0;0;0;.00nan;0;0
14894;-1;480;0;0;0;0;.00nan;0;0
14894;63107;480;77;40;4;36;.900;3874000;0
14895;38277;476;0;0;0;0;.00nan;0;0
14895;66551;472;0;0;0;0;.00nan;0;0
14895;71297;472;59;33;4;29;.879;3647000;0
14895;78920;476;85;39;3;36;.923;3647000;0
14896;12048;4535;0;0;0;0;.00nan;0;0
14896;168926;5004;82;29;2;27;.931;4020000;0
14896;46318;5004;0;0;0;0;.00nan;0;0
14896;70573;4535;74;25;2;23;.920;4020000;0
14897;-1;676;0;0;0;0;.00nan;0;0
14897;190235;481;0;0;0;0;.00nan;0;0
14897;43158;676;64;26;2;24;.923;3600000;0
14897;56296;481;100;32;0;32;1.000;3600000;0
14898;46139;473;0;0;0;0;.00nan;0;0
14898;67222;482;51;32;4;28;.875;3561000;0
14898;85127;473;57;28;3;25;.893;3600000;0
14898;87894;482;0;0;0;0;.00nan;0;0
14899;163528;682;76;13;0;13;1.000;3600000;0
14899;11500;682;0;0;0;0;.00nan;0;0
14899;66491;474;97;48;1;47;.979;3563000;0
14899;153779;474;0;0;0;0;.00nan;0;0
14900;38277;476;0;0;0;0;.00nan;0;0
14900;53870;490;50;23;3;20;.870;1606000;0
14900;78920;476;67;24;2;22;.917;3600000;0
14900;81096;490;35;39;7;32;.821;1994000;0
14901;3435;675;70;32;3;29;.906;3600000;0
14901;163528;682;63;15;1;14;.933;3600000;0
14901;172527;675;0;0;0;0;.00nan;0;0
14901;11500;682;0;0;0;0;.00nan;0;0
14902;-1;676;0;0;0;0;.00nan;0;0
14902;-1;480;0;0;0;0;.00nan;0;0
14902;43158;676;60;31;3;28;.903;3600000;0
14902;63107;480;77;32;2;30;.938;3600000;0
14903;66551;472;69;34;4;30;.882;3513000;0
14903;67222;482;91;34;2;32;.941;3600000;0
14903;71297;472;0;0;0;0;.00nan;0;0
14903;87894;482;0;0;0;0;.00nan;0;0
14904;12048;4535;0;0;0;0;.00nan;0;0
14904;46139;473;53;30;4;26;.867;3986000;0
14904;70573;4535;42;27;5;22;.815;3986000;0
14904;85127;473;0;0;0;0;.00nan;0;0
14905;168926;5004;26;27;6;21;.778;3600000;0
14905;46318;5004;0;0;0;0;.00nan;0;0
14905;66491;474;81;39;2;37;.949;3600000;0
14905;153779;474;0;0;0;0;.00nan;0;0
14906;3435;675;42;19;4;15;.789;1650000;0
14906;172527;675;54;22;2;20;.909;1950000;0
14906;190235;481;0;0;0;0;.00nan;0;0
14906;56296;481;92;20;0;20;1.000;3600000;0
14907;163528;682;79;23;2;21;.913;3600000;0
14907;11500;682;0;0;0;0;.00nan;0;0
14907;53870;490;0;0;0;0;.00nan;0;0
14907;81096;490;80;48;5;43;.896;3600000;0
14908;168926;5004;62;43;5;38;.884;3547000;0
14908;-1;480;0;0;0;0;.00nan;0;0
14908;46318;5004;0;0;0;0;.00nan;0;0
14908;63107;480;55;24;4;20;.833;3600000;0
14909;12048;4535;0;0;0;0;.00nan;0;0
14909;67222;482;0;0;0;0;.00nan;0;0
14909;70573;4535;79;26;2;24;.923;3600000;0
14909;87894;482;62;40;4;36;.900;3515000;0
14910;-1;676;0;0;0;0;.00nan;0;0
14910;43158;676;59;19;2;17;.895;3600000;0
14910;66491;474;41;38;6;32;.842;2646000;0
14910;153779;474;51;13;2;11;.846;954000;0
14911;46139;473;63;21;2;19;.905;3600000;0
14911;66551;472;40;40;6;34;.850;3600000;0
14911;71297;472;0;0;0;0;.00nan;0;0
14911;85127;473;0;0;0;0;.00nan;0;0
14912;53870;490;41;34;5;29;.853;3558000;0
14912;66551;472;0;0;0;0;.00nan;0;0
14912;71297;472;64;26;3;23;.885;3600000;0
14912;81096;490;0;0;0;0;.00nan;0;0
14913;-1;480;51;2;0;2;1.000;421000;0
14913;46139;473;0;0;0;0;.00nan;0;0
14913;63107;480;46;31;6;25;.806;3179000;0
14913;85127;473;82;33;2;31;.939;3600000;0
14914;12048;4535;62;19;1;18;.947;3600000;0
14914;66491;474;39;34;6;28;.824;3182000;0
14914;70573;4535;0;0;0;0;.00nan;0;0
14914;153779;474;52;2;0;2;1.000;418000;0
14915;168926;5004;89;38;3;35;.921;4020000;0
14915;190235;481;0;0;0;0;.00nan;0;0
14915;46318;5004;0;0;0;0;.00nan;0;0
14915;56296;481;54;17;3;14;.824;4020000;0
14916;38277;476;0;0;0;0;.00nan;0;0
14916;67222;482;94;39;2;37;.949;3600000;0
14916;78920;476;48;27;4;23;.852;3524000;0
14916;87894;482;0;0;0;0;.00nan;0;0
14917;163528;682;83;36;2;34;.944;3556000;0
14917;11500;682;0;0;0;0;.00nan;0;0
14917;-1;676;0;0;0;0;.00nan;0;0
14917;43158;676;90;28;1;27;.964;3600000;0
14918;3435;675;0;0;0;0;.00nan;0;0
14918;172527;675;81;37;2;35;.946;3600000;0
14918;67222;482;43;20;4;16;.800;3573000;0
14918;87894;482;0;0;0;0;.00nan;0;0
14919;38277;476;0;0;0;0;.00nan;0;0
14919;53870;490;0;0;0;0;.00nan;0;0
14919;78920;476;50;14;2;12;.857;3600000;0
14919;81096;490;91;59;3;56;.949;3568000;0
14920;168926;5004;81;50;5;45;.900;3600000;0
14920;-1;676;76;25;1;24;.960;3600000;0
14920;43158;676;0;0;0;0;.00nan;0;0
14920;46318;5004;0;0;0;0;.00nan;0;0
14921;163528;682;100;24;0;24;1.000;3600000;0
14921;11500;682;0;0;0;0;.00nan;0;0
14921;-1;480;0;0;0;0;.00nan;0;0
14921;63107;480;60;20;2;18;.900;3582000;0
14922;12048;4535;0;0;0;0;.00nan;0;0
14922;66551;472;0;0;0;0;.00nan;0;0
14922;70573;4535;100;32;0;32;1.000;3600000;0
14922;71297;472;63;25;3;22;.880;3600000;0
14923;46139;473;73;25;2;23;.920;3600000;0
14923;66491;474;74;33;3;30;.909;3562000;0
14923;85127;473;0;0;0;0;.00nan;0;0
14923;153779;474;0;0;0;0;.00nan;0;0
14924;3435;675;59;17;2;15;.882;3600000;0
14924;172527;675;0;0;0;0;.00nan;0;0
14924;53870;490;0;0;0;0;.00nan;0;0
14924;81096;490;93;39;3;36;.923;3591000;0
14925;163528;682;48;34;5;29;.853;3545000;0
14925;11500;682;0;0;0;0;.00nan;0;0
14925;38277;476;76;43;4;39;.907;3600000;0
14925;78920;476;0;0;0;0;.00nan;0;0
14926;46139;473;0;0;0;0;.00nan;0;0
14926;66551;472;73;17;1;16;.941;3600000;0
14926;71297;472;0;0;0;0;.00nan;0;0
14926;85127;473;61;28;3;25;.893;3543000;0
14927;168926;5004;74;41;4;37;.902;3600000;0
14927;46318;5004;0;0;0;0;.00nan;0;0
14927;67222;482;94;18;0;18;1.000;3600000;0
14927;87894;482;0;0;0;0;.00nan;0;0
14928;190235;481;0;0;0;0;.00nan;0;0
14928;-1;480;48;29;4;25;.862;3600000;0
14928;56296;481;53;40;6;34;.850;3539000;0
14928;63107;480;0;0;0;0;.00nan;0;0
14929;-1;676;0;0;0;0;.00nan;0;0
14929;43158;676;44;13;2;11;.846;3600000;0
14929;66491;474;33;36;7;29;.806;2960000;0
14929;153779;474;52;4;0;4;1.000;640000;0
14930;163528;682;73;28;2;26;.929;4020000;0
14930;11500;682;0;0;0;0;.00nan;0;0
14930;190235;481;85;37;2;35;.946;4020000;0
14930;56296;481;0;0;0;0;.00nan;0;0
14931;12048;4535;0;0;0;0;.00nan;0;0
14931;53870;490;0;0;0;0;.00nan;0;0
14931;70573;4535;58;17;2;15;.882;3600000;0
14931;81096;490;84;52;4;48;.923;3584000;0
14932;66551;472;69;31;2;29;.935;3600000;0
14932;67222;482;61;40;5;35;.875;3600000;0
14932;71297;472;0;0;0;0;.00nan;0;0
14932;87894;482;0;0;0;0;.00nan;0;0
14933;3435;675;97;51;4;47;.922;3579000;0
14933;172527;675;0;0;0;0;.00nan;0;0
14933;-1;676;0;0;0;0;.00nan;0;0
14933;43158;676;43;10;2;8;.800;3600000;0
14934;38277;476;0;0;0;0;.00nan;0;0
14934;-1;480;0;0;0;0;.00nan;0;0
14934;63107;480;79;30;1;29;.967;3600000;0
14934;78920;476;82;36;2;34;.944;3566000;0
14935;168926;5004;42;29;6;23;.793;1849000;0
14935;46139;473;55;14;2;12;.857;3600000;0
14935;46318;5004;83;22;0;22;1.000;1751000;0
14935;85127;473;0;0;0;0;.00nan;0;0
14936;3435;675;56;45;6;39;.867;3336000;0
14936;172527;675;41;2;1;1;.500;264000;0
14936;46139;473;58;18;2;16;.889;3600000;0
14936;85127;473;0;0;0;0;.00nan;0;0
14937;66491;474;27;15;4;11;.733;1107000;0
14937;67222;482;0;0;0;0;.00nan;0;0
14937;87894;482;61;22;2;20;.909;3600000;0
14937;153779;474;84;31;2;29;.935;2493000;0
14938;-1;676;0;0;0;0;.00nan;0;0
14938;-1;480;0;0;0;0;.00nan;0;0
14938;43158;676;100;30;0;30;1.000;3600000;0
14938;63107;480;65;36;5;31;.861;3600000;0
14939;190235;481;0;0;0;0;.00nan;0;0
14939;56296;481;77;22;1;21;.955;3600000;0
14939;66551;472;0;0;0;0;.00nan;0;0
14939;71297;472;69;34;3;31;.912;3576000;0
14940;12048;4535;0;0;0;0;.00nan;0;0
14940;168926;5004;60;37;5;32;.865;3600000;0
14940;46318;5004;0;0;0;0;.00nan;0;0
14940;70573;4535;90;28;1;27;.964;3600000;0
14941;38277;476;0;0;0;0;.00nan;0;0
14941;46139;473;0;0;0;0;.00nan;0;0
14941;78920;476;95;21;0;21;1.000;3600000;0
14941;85127;473;76;37;2;35;.946;3576000;0
14942;168926;5004;0;0;0;0;.00nan;0;0
14942;46318;5004;83;24;1;23;.958;3600000;0
14942;66491;474;76;37;3;34;.919;3549000;0
14942;153779;474;0;0;0;0;.00nan;0;0
14943;-1;480;0;0;0;0;.00nan;0;0
14943;63107;480;76;23;2;21;.913;3542000;0
14943;67222;482;100;39;1;38;.974;3600000;0
14943;87894;482;0;0;0;0;.00nan;0;0
14944;3435;675;96;51;3;48;.941;3562000;0
14944;172527;675;0;0;0;0;.00nan;0;0
14944;66551;472;62;16;2;14;.875;3600000;0
14944;71297;472;0;0;0;0;.00nan;0;0
14945;-1;676;0;0;0;0;.00nan;0;0
14945;190235;481;0;0;0;0;.00nan;0;0
14945;43158;676;86;32;1;31;.969;3600000;0
14945;56296;481;51;27;4;23;.852;3599000;0
14946;163528;682;78;28;2;26;.929;3600000;0
14946;11500;682;0;0;0;0;.00nan;0;0
14946;12048;4535;0;0;0;0;.00nan;0;0
14946;70573;4535;39;39;6;33;.846;3600000;0
14947;163528;682;75;7;0;7;1.000;3600000;0
14947;11500;682;0;0;0;0;.00nan;0;0
14947;53870;490;0;0;0;0;.00nan;0;0
14947;81096;490;60;54;7;47;.870;3600000;0
14948;190235;481;0;0;0;0;.00nan;0;0
14948;38277;476;0;0;0;0;.00nan;0;0
14948;56296;481;70;30;2;28;.933;4020000;0
14948;78920;476;100;47;2;45;.957;4020000;0
14949;46139;473;65;8;1;7;.875;3600000;0
14949;53870;490;0;0;0;0;.00nan;0;0
14949;81096;490;88;51;4;47;.922;3600000;0
14949;85127;473;0;0;0;0;.00nan;0;0
14950;163528;682;83;17;0;17;1.000;3600000;0
14950;11500;682;0;0;0;0;.00nan;0;0
14950;168926;5004;87;47;3;44;.936;3600000;0
14950;46318;5004;0;0;0;0;.00nan;0;0
14951;-1;676;0;0;0;0;.00nan;0;0
14951;43158;676;52;28;4;24;.857;3572000;0
14951;66551;472;0;0;0;0;.00nan;0;0
14951;71297;472;66;26;3;23;.885;3600000;0
14952;12048;4535;0;0;0;0;.00nan;0;0
14952;67222;482;97;41;2;39;.951;3600000;0
14952;70573;4535;51;21;3;18;.857;3600000;0
14952;87894;482;0;0;0;0;.00nan;0;0
14953;3435;675;91;19;0;19;1.000;3600000;0
14953;172527;675;0;0;0;0;.00nan;0;0
14953;66491;474;0;0;0;0;.00nan;0;0
14953;153779;474;97;35;1;34;.971;3584000;0
14954;3435;675;80;45;4;41;.911;3600000;0
14954;163528;682;79;31;3;28;.903;3600000;0
14954;172527;675;0;0;0;0;.00nan;0;0
14954;11500;682;0;0;0;0;.00nan;0;0
14955;38277;476;0;0;0;0;.00nan;0;0
14955;66491;474;70;52;5;47;.904;3600000;0
14955;78920;476;85;11;0;11;1.000;3600000;0
14955;153779;474;0;0;0;0;.00nan;0;0
14956;12048;4535;0;0;0;0;.00nan;0;0
14956;-1;676;0;0;0;0;.00nan;0;0
14956;43158;676;50;29;4;25;.862;3549000;0
14956;70573;4535;61;32;3;29;.906;3600000;0
14957;-1;480;0;0;0;0;.00nan;0;0
14957;63107;480;64;33;3;30;.909;3600000;0
14957;66551;472;76;32;2;30;.938;3600000;0
14957;71297;472;0;0;0;0;.00nan;0;0
14958;190235;481;69;13;0;13;1.000;2469000;0
14958;46139;473;41;30;5;25;.833;3546000;0
14958;56296;481;21;10;4;6;.600;1131000;0
14958;85127;473;0;0;0;0;.00nan;0;0
14959;3435;675;89;32;2;30;.938;4020000;0
14959;172527;675;0;0;0;0;.00nan;0;0
14959;12048;4535;0;0;0;0;.00nan;0;0
14959;70573;4535;68;25;2;23;.920;4020000;0
14960;190235;481;0;0;0;0;.00nan;0;0
14960;56296;481;47;16;3;13;.813;3600000;0
14960;66491;474;37;38;7;31;.816;2575000;0
14960;153779;474;63;15;1;14;.933;1025000;0
14961;46139;473;85;27;1;26;.963;3600000;0
14961;67222;482;76;32;2;30;.938;3558000;0
14961;85127;473;0;0;0;0;.00nan;0;0
14961;87894;482;0;0;0;0;.00nan;0;0
14962;-1;676;74;9;0;9;1.000;3600000;0
14962;46105;676;0;0;0;0;.00nan;0;0
14962;53870;490;52;14;2;12;.857;854000;0
14962;81096;490;47;49;8;41;.837;2746000;0
14963;168926;5004;83;51;3;48;.941;4012000;0
14963;-1;480;0;0;0;0;.00nan;0;0
14963;46318;5004;0;0;0;0;.00nan;0;0
14963;63107;480;56;18;3;15;.833;4020000;0
14964;38277;476;0;0;0;0;.00nan;0;0
14964;66551;472;44;4;1;3;.750;743000;0
14964;71297;472;31;27;6;21;.778;2857000;0
14964;78920;476;88;29;1;28;.966;3600000;0
14965;190235;481;0;0;0;0;.00nan;0;0
14965;53870;490;0;0;0;0;.00nan;0;0
14965;56296;481;59;24;4;20;.833;3806000;0
14965;81096;490;80;47;5;42;.894;3769000;0
14966;3435;675;65;34;3;31;.912;4019000;0
14966;172527;675;0;0;0;0;.00nan;0;0
14966;168926;5004;76;35;3;32;.914;4020000;0
14966;46318;5004;0;0;0;0;.00nan;0;0
14967;163528;682;29;22;4;18;.818;3549000;0
14967;11500;682;0;0;0;0;.00nan;0;0
14967;67222;482;75;33;3;30;.909;3600000;0
14967;87894;482;0;0;0;0;.00nan;0;0
14968;-1;676;69;51;5;46;.902;3600000;0
14968;46105;676;0;0;0;0;.00nan;0;0
14968;46139;473;95;20;0;20;1.000;3600000;0
14968;85127;473;0;0;0;0;.00nan;0;0
14969;12048;4535;0;0;0;0;.00nan;0;0
14969;38277;476;0;0;0;0;.00nan;0;0
14969;70573;4535;65;28;3;25;.893;3576000;0
14969;78920;476;87;29;1;28;.966;3600000;0
14970;-1;480;0;0;0;0;.00nan;0;0
14970;63107;480;83;13;0;13;1.000;3600000;0
14970;66491;474;79;35;3;32;.914;3600000;0
14970;153779;474;0;0;0;0;.00nan;0;0
14971;12048;4535;0;0;0;0;.00nan;0;0
14971;190235;481;0;0;0;0;.00nan;0;0
14971;56296;481;100;19;0;19;1.000;3600000;0
14971;70573;4535;89;34;1;33;.971;3565000;0
14972;3435;675;86;49;3;46;.939;3835000;0
14972;172527;675;0;0;0;0;.00nan;0;0
14972;38277;476;0;0;0;0;.00nan;0;0
14972;78920;476;83;32;2;30;.938;3835000;0
14973;-1;676;0;0;0;0;.00nan;0;0
14973;43158;676;88;18;0;18;1.000;3600000;0
14973;67222;482;61;30;3;27;.900;3600000;0
14973;87894;482;0;0;0;0;.00nan;0;0
14974;163528;682;75;18;1;17;.944;3600000;0
14974;11500;682;0;0;0;0;.00nan;0;0
14974;66491;474;59;44;5;39;.886;3600000;0
14974;153779;474;0;0;0;0;.00nan;0;0
14975;-1;480;0;0;0;0;.00nan;0;0
14975;53870;490;0;0;0;0;.00nan;0;0
14975;63107;480;78;21;1;20;.952;3600000;0
14975;81096;490;67;35;4;31;.886;3600000;0
14976;168926;5004;86;35;2;33;.943;3545000;0
14976;46318;5004;0;0;0;0;.00nan;0;0
14976;66551;472;70;19;1;18;.947;3600000;0
14976;71297;472;0;0;0;0;.00nan;0;0
14977;3435;675;65;34;3;31;.912;3872000;0
14977;172527;675;0;0;0;0;.00nan;0;0
14977;190235;481;0;0;0;0;.00nan;0;0
14977;56296;481;60;16;2;14;.875;3872000;0
14978;168926;5004;44;46;7;39;.848;3600000;0
14978;38277;476;0;0;0;0;.00nan;0;0
14978;46318;5004;0;0;0;0;.00nan;0;0
14978;78920;476;83;25;1;24;.960;3600000;0
14979;53870;490;0;0;0;0;.00nan;0;0
14979;67222;482;43;25;4;21;.840;3647000;0
14979;81096;490;74;33;3;30;.909;3647000;0
14979;87894;482;0;0;0;0;.00nan;0;0
14980;163528;682;73;30;2;28;.933;4020000;0
14980;11500;682;0;0;0;0;.00nan;0;0
14980;46139;473;79;30;2;28;.933;4020000;0
14980;85127;473;0;0;0;0;.00nan;0;0
14981;12048;4535;96;42;1;41;.976;3853000;0
14981;-1;480;0;0;0;0;.00nan;0;0
14981;63107;480;78;31;2;29;.935;3853000;0
14981;70573;4535;0;0;0;0;.00nan;0;0
14982;66491;474;71;44;4;40;.909;3600000;0
14982;66551;472;86;15;0;15;1.000;3600000;0
14982;71297;472;0;0;0;0;.00nan;0;0
14982;153779;474;0;0;0;0;.00nan;0;0
14983;190235;481;0;0;0;0;.00nan;0;0
14983;56296;481;80;35;3;32;.914;3600000;0
14983;67222;482;25;26;7;19;.731;3019000;0
14983;87894;482;61;11;0;11;1.000;581000;0
14984;-1;676;0;0;0;0;.00nan;0;0
14984;38277;476;0;0;0;0;.00nan;0;0
14984;43158;676;54;37;5;32;.865;3537000;0
14984;78920;476;78;36;3;33;.917;3600000;0
14985;168926;5004;0;0;0;0;.00nan;0;0
14985;46318;5004;71;48;4;44;.917;3600000;0
14985;53870;490;0;0;0;0;.00nan;0;0
14985;81096;490;76;18;1;17;.944;3600000;0
14986;3435;675;68;34;3;31;.912;3566000;0
14986;172527;675;0;0;0;0;.00nan;0;0
14986;-1;480;0;0;0;0;.00nan;0;0
14986;63107;480;56;16;2;14;.875;3600000;0
14987;163528;682;66;36;4;32;.889;4020000;0
14987;11500;682;0;0;0;0;.00nan;0;0
14987;66551;472;75;40;4;36;.900;4020000;0
14987;71297;472;0;0;0;0;.00nan;0;0
14988;12048;4535;59;6;0;6;1.000;488000;0
14988;46139;473;82;17;0;17;1.000;3600000;0
14988;70573;4535;17;21;6;15;.714;3112000;0
14988;85127;473;0;0;0;0;.00nan;0;0
14992;3435;675;66;28;3;25;.893;3579000;0
14992;172527;675;0;0;0;0;.00nan;0;0
14992;66491;474;100;39;1;38;.974;3600000;0
14992;67276;474;0;0;0;0;.00nan;0;0
14998;190243;5004;0;0;0;0;.00nan;0;0
14998;-1;480;61;21;2;19;.905;3600000;0
14998;46318;5004;28;33;7;26;.788;3600000;0
14998;63107;480;0;0;0;0;.00nan;0;0
15000;12048;4535;0;0;0;0;.00nan;0;0
15000;53870;490;0;0;0;0;.00nan;0;0
15000;70573;4535;92;29;1;28;.966;3600000;0
15000;81096;490;52;28;4;24;.857;3600000;0
15002;38277;476;50;20;3;17;.850;3600000;0
15002;66491;474;43;32;5;27;.844;2799000;0
15002;67276;476;0;0;0;0;.00nan;0;0
15002;153779;474;35;18;4;14;.778;801000;0
15004;3435;675;92;18;0;18;1.000;3600000;0
15004;172527;675;0;0;0;0;.00nan;0;0
15004;53870;490;40;8;2;6;.750;706000;0
15004;81096;490;46;48;7;41;.854;2894000;0
15006;163528;682;73;26;2;24;.923;3600000;0
15006;11500;682;0;0;0;0;.00nan;0;0
15006;190235;481;0;0;0;0;.00nan;0;0
15006;56296;481;90;32;1;31;.969;3600000;0
15008;12048;4535;0;0;0;0;.00nan;0;0
15008;-1;676;0;0;0;0;.00nan;0;0
15008;43158;676;75;43;2;41;.953;3588000;0
15008;70573;4535;86;30;1;29;.967;3600000;0
15014;3435;675;75;22;1;21;.955;3600000;0
15014;172527;675;0;0;0;0;.00nan;0;0
15014;53870;490;95;42;2;40;.952;3600000;0
15014;81096;490;0;0;0;0;.00nan;0;0
15020;38277;476;0;0;0;0;.00nan;0;0
15020;66491;474;0;0;0;0;.00nan;0;0
15020;67276;476;72;19;1;18;.947;3600000;0
15020;153779;474;97;54;2;52;.963;3600000;0
15022;12048;4535;84;37;3;34;.919;3910000;0
15022;190235;481;85;34;2;32;.941;3910000;0
15022;56296;481;0;0;0;0;.00nan;0;0
15022;70573;4535;0;0;0;0;.00nan;0;0
15026;12048;4535;0;0;0;0;.00nan;0;0
15026;-1;676;0;0;0;0;.00nan;0;0
15026;43158;676;61;14;1;13;.929;3600000;0
15026;70573;4535;85;40;2;38;.950;3549000;0
15028;3435;675;60;51;7;44;.863;3600000;0
15028;172527;675;0;0;0;0;.00nan;0;0
15028;-1;480;0;0;0;0;.00nan;0;0
15028;63107;480;92;26;1;25;.962;3600000;0
15030;53870;490;0;0;0;0;.00nan;0;0
15030;66551;472;39;19;3;16;.842;4020000;0
15030;71297;472;0;0;0;0;.00nan;0;0
15030;81096;490;100;60;3;57;.950;4020000;0
15032;190235;481;0;0;0;0;.00nan;0;0
15032;56296;481;32;9;3;6;.667;3600000;0
15032;66491;474;60;31;4;27;.871;3545000;0
15032;153779;474;0;0;0;0;.00nan;0;0
15034;46139;473;55;17;3;14;.824;4020000;0
15034;46318;5004;82;48;3;45;.938;4020000;0
15034;66552;5004;0;0;0;0;.00nan;0;0
15034;85127;473;0;0;0;0;.00nan;0;0
15036;38277;476;35;22;5;17;.773;4020000;0
15036;67222;482;0;0;0;0;.00nan;0;0
15036;67276;476;0;0;0;0;.00nan;0;0
15036;87894;482;81;59;5;54;.915;4020000;0
15040;12048;4535;71;52;5;47;.904;3600000;0
15040;-1;480;36;21;4;17;.810;3600000;0
15040;63107;480;0;0;0;0;.00nan;0;0
15040;70573;4535;0;0;0;0;.00nan;0;0
15044;163528;682;75;11;0;11;1.000;3600000;0
15044;11500;682;0;0;0;0;.00nan;0;0
15044;53870;490;82;52;5;47;.904;3600000;0
15044;81096;490;0;0;0;0;.00nan;0;0
15046;-1;676;67;32;3;29;.906;3737000;0
15046;190235;481;65;26;2;24;.923;3737000;0
15046;43158;676;0;0;0;0;.00nan;0;0
15046;56296;481;0;0;0;0;.00nan;0;0
15048;46318;5004;0;0;0;0;.00nan;0;0
15048;66491;474;69;16;0;16;1.000;1463000;0
15048;66552;5004;59;28;3;25;.893;3600000;0
15048;153779;474;20;27;7;20;.741;2137000;0
15052;3435;675;95;36;1;35;.972;4020000;0
15052;172527;675;0;0;0;0;.00nan;0;0
15052;-1;676;0;0;0;0;.00nan;0;0
15052;43158;676;80;23;1;22;.957;4020000;0
15056;190235;481;0;0;0;0;.00nan;0;0
15056;53870;490;0;0;0;0;.00nan;0;0
15056;56296;481;83;13;0;13;1.000;3600000;0
15056;81096;490;88;64;4;60;.938;3600000;0
15058;163528;682;100;30;1;29;.967;3600000;0
15058;11500;682;0;0;0;0;.00nan;0;0
15058;12048;4535;0;0;0;0;.00nan;0;0
15058;70573;4535;67;31;3;28;.903;3526000;0
15062;3435;675;0;0;0;0;.00nan;0;0
15062;172527;675;66;36;4;32;.889;3545000;0
15062;190235;481;0;0;0;0;.00nan;0;0
15062;56296;481;58;26;3;23;.885;3600000;0
15068;-1;480;0;0;0;0;.00nan;0;0
15068;53870;490;94;71;5;66;.930;3600000;0
15068;63107;480;77;9;0;9;1.000;3600000;0
15068;81096;490;0;0;0;0;.00nan;0;0
15070;-1;676;87;55;5;50;.909;3600000;0
15070;38277;476;89;24;0;24;1.000;3600000;0
15070;43158;676;0;0;0;0;.00nan;0;0
15070;67276;476;0;0;0;0;.00nan;0;0
15072;46318;5004;0;0;0;0;.00nan;0;0
15072;66491;474;71;44;5;39;.886;3917000;0
15072;66552;5004;62;39;4;35;.897;3917000;0
15072;153779;474;0;0;0;0;.00nan;0;0
480;3435;675;76;38;3;35;.921;3600000;0
480;172527;675;0;0;0;0;.00nan;0;0
480;67222;482;100;25;0;25;1.000;3600000;0
480;87894;482;0;0;0;0;.00nan;0;0
481;12048;4535;0;0;0;0;.00nan;0;0
481;66551;472;93;34;1;33;.971;3600000;0
481;70573;4535;80;32;2;30;.938;3591000;0
481;71297;472;0;0;0;0;.00nan;0;0
482;3435;675;58;24;3;21;.875;3543000;0
482;172527;675;0;0;0;0;.00nan;0;0
482;67222;482;82;29;2;27;.931;3600000;0
482;87894;482;0;0;0;0;.00nan;0;0
483;12048;4535;0;0;0;0;.00nan;0;0
483;66551;472;26;31;7;24;.774;3132000;0
483;70573;4535;53;24;3;21;.875;3600000;0
483;71297;472;60;7;0;7;1.000;468000;0
527;12048;4535;0;0;0;0;.00nan;0;0
527;66551;472;69;28;2;26;.929;3600000;0
527;70573;4535;56;27;4;23;.852;3529000;0
527;71297;472;0;0;0;0;.00nan;0;0
539;38277;476;0;0;0;0;.00nan;0;0
539;66551;472;87;46;3;43;.935;3942000;0
539;71297;472;0;0;0;0;.00nan;0;0
539;78920;476;52;31;4;27;.871;3942000;0
540;-1;676;0;0;0;0;.00nan;0;0
540;43158;676;90;29;1;28;.966;3600000;0
540;67222;482;84;54;4;50;.926;3600000;0
540;87894;482;0;0;0;0;.00nan;0;0
541;190235;481;0;0;0;0;.00nan;0;0
541;46139;473;86;32;3;29;.906;3671000;0
541;56296;481;69;39;4;35;.897;3688000;0
541;85127;473;0;0;0;0;.00nan;0;0
542;163528;682;100;27;0;27;1.000;3600000;0
542;11500;682;0;0;0;0;.00nan;0;0
542;-1;480;0;0;0;0;.00nan;0;0
542;63107;480;80;37;2;35;.946;3561000;0
543;38277;476;0;0;0;0;.00nan;0;0
543;66551;472;86;31;1;30;.968;4131000;0
543;71297;472;0;0;0;0;.00nan;0;0
543;78920;476;76;30;2;28;.933;4131000;0
544;-1;676;50;7;1;6;.857;692000;0
544;43158;676;17;23;6;17;.739;2908000;0
544;67222;482;69;39;4;35;.897;3600000;0
544;87894;482;0;0;0;0;.00nan;0;0
545;190235;481;0;0;0;0;.00nan;0;0
545;46139;473;91;39;1;38;.974;3600000;0
545;56296;481;82;39;3;36;.923;3515000;0
545;85127;473;0;0;0;0;.00nan;0;0
546;163528;682;84;25;1;24;.960;3600000;0
546;11500;682;0;0;0;0;.00nan;0;0
546;-1;480;0;0;0;0;.00nan;0;0
546;63107;480;57;34;4;30;.882;3600000;0
547;38277;476;0;0;0;0;.00nan;0;0
547;66551;472;82;35;2;33;.943;3545000;0
547;71297;472;0;0;0;0;.00nan;0;0
547;78920;476;80;27;1;26;.963;3600000;0
548;-1;676;0;0;0;0;.00nan;0;0
548;43158;676;70;22;1;21;.955;3600000;0
548;67222;482;93;48;3;45;.938;3513000;0
548;87894;482;0;0;0;0;.00nan;0;0
549;190235;481;0;0;0;0;.00nan;0;0
549;46139;473;48;13;2;11;.846;3600000;0
549;56296;481;61;48;6;42;.875;3600000;0
549;85127;473;0;0;0;0;.00nan;0;0
550;163528;682;63;33;4;29;.879;3564000;0
550;11500;682;0;0;0;0;.00nan;0;0
550;-1;480;0;0;0;0;.00nan;0;0
550;63107;480;86;36;2;34;.944;3600000;0
551;38277;476;0;0;0;0;.00nan;0;0
551;66551;472;90;30;1;29;.967;3600000;0
551;71297;472;0;0;0;0;.00nan;0;0
551;78920;476;100;23;0;23;1.000;3600000;0
552;-1;676;0;0;0;0;.00nan;0;0
552;43158;676;73;33;2;31;.939;3600000;0
552;67222;482;29;25;6;19;.760;3261000;0
552;87894;482;53;2;0;2;1.000;339000;0
553;190235;481;0;0;0;0;.00nan;0;0
553;46139;473;86;20;0;20;1.000;3600000;0
553;56296;481;62;41;5;36;.878;3600000;0
553;85127;473;0;0;0;0;.00nan;0;0
554;163528;682;43;35;5;30;.857;3600000;0
554;11500;682;0;0;0;0;.00nan;0;0
554;-1;480;0;0;0;0;.00nan;0;0
554;63107;480;90;31;1;30;.968;3600000;0
748;38277;476;0;0;0;0;.00nan;0;0
748;66551;472;83;37;3;34;.919;3600000;0
748;71297;472;0;0;0;0;.00nan;0;0
748;78920;476;57;27;4;23;.852;3579000;0
749;-1;676;0;0;0;0;.00nan;0;0
749;43158;676;69;21;1;20;.952;3600000;0
749;67222;482;87;37;2;35;.946;3600000;0
749;87894;482;0;0;0;0;.00nan;0;0
750;163528;682;87;26;1;25;.962;3600000;0
750;11500;682;0;0;0;0;.00nan;0;0
750;-1;480;0;0;0;0;.00nan;0;0
750;63107;480;84;35;2;33;.943;3567000;0
858;38277;476;0;0;0;0;.00nan;0;0
858;66551;472;47;35;6;29;.829;3551000;0
858;71297;472;0;0;0;0;.00nan;0;0
858;78920;476;37;24;5;19;.792;3600000;0
859;163528;682;71;24;3;21;.875;3566000;0
859;11500;682;0;0;0;0;.00nan;0;0
859;-1;480;0;0;0;0;.00nan;0;0
859;63107;480;96;41;2;39;.951;3600000;0
977;38277;476;0;0;0;0;.00nan;0;0
977;66551;472;62;34;4;30;.882;3600000;0
977;71297;472;0;0;0;0;.00nan;0;0
977;78920;476;64;14;1;13;.929;3600000;0
978;163528;682;61;28;3;25;.893;4555000;0
978;11500;682;0;0;0;0;.00nan;0;0
978;-1;480;0;0;0;0;.00nan;0;0
978;63107;480;57;31;4;27;.871;4555000;0
1045;38277;476;0;0;0;0;.00nan;0;0
1045;46139;473;45;26;5;21;.808;3690000;0
1045;78920;476;76;41;4;37;.902;3690000;0
1045;85127;473;0;0;0;0;.00nan;0;0
1046;163528;682;87;32;2;30;.938;3600000;0
1046;11500;682;0;0;0;0;.00nan;0;0
1046;-1;676;0;0;0;0;.00nan;0;0
1046;43158;676;76;36;4;32;.889;3579000;0
1047;38277;476;0;0;0;0;.00nan;0;0
1047;46139;473;68;23;2;21;.913;3600000;0
1047;78920;476;50;32;5;27;.844;3600000;0
1047;85127;473;0;0;0;0;.00nan;0;0
1048;163528;682;68;22;2;20;.909;3600000;0
1048;11500;682;0;0;0;0;.00nan;0;0
1048;-1;676;0;0;0;0;.00nan;0;0
1048;43158;676;47;28;4;24;.857;3590000;0
1049;38277;476;0;0;0;0;.00nan;0;0
1049;46139;473;67;25;2;23;.920;3600000;0
1049;78920;476;41;34;5;29;.853;3600000;0
1049;85127;473;0;0;0;0;.00nan;0;0
1050;163528;682;62;40;6;34;.850;3600000;0
1050;11500;682;0;0;0;0;.00nan;0;0
1050;-1;676;0;0;0;0;.00nan;0;0
1050;43158;676;80;31;1;30;.968;3600000;0
1051;38277;476;0;0;0;0;.00nan;0;0
1051;46139;473;72;36;4;32;.889;3600000;0
1051;78920;476;100;31;0;31;1.000;3600000;0
1051;85127;473;0;0;0;0;.00nan;0;0
1052;163528;682;66;25;3;22;.880;3600000;0
1052;11500;682;0;0;0;0;.00nan;0;0
1052;-1;676;0;0;0;0;.00nan;0;0
1052;43158;676;29;19;4;15;.789;3585000;0
1258;38277;476;0;0;0;0;.00nan;0;0
1258;46139;473;40;25;5;20;.800;3548000;0
1258;78920;476;79;44;4;40;.909;3600000;0
1258;85127;473;0;0;0;0;.00nan;0;0
1259;163528;682;100;40;1;39;.975;3600000;0
1259;11500;682;0;0;0;0;.00nan;0;0
1259;-1;676;0;0;0;0;.00nan;0;0
1259;43158;676;68;35;3;32;.914;3600000;0
1341;38277;476;0;0;0;0;.00nan;0;0
1341;46139;473;65;27;3;24;.889;3600000;0
1341;78920;476;53;35;5;30;.857;3550000;0
1341;85127;473;0;0;0;0;.00nan;0;0
1425;38277;476;0;0;0;0;.00nan;0;0
1425;46139;473;63;35;4;31;.886;3567000;0
1425;78920;476;70;35;3;32;.914;3600000;0
1425;85127;473;0;0;0;0;.00nan;0;0
1469;163528;682;66;30;3;27;.900;3867000;0
1469;11500;682;0;0;0;0;.00nan;0;0
1469;38277;476;0;0;0;0;.00nan;0;0
1469;78920;476;89;53;4;49;.925;3867000;0
1470;163528;682;54;14;2;12;.857;3600000;0
1470;11500;682;0;0;0;0;.00nan;0;0
1470;38277;476;0;0;0;0;.00nan;0;0
1470;78920;476;70;51;5;46;.902;3600000;0
1471;163528;682;47;30;5;25;.833;3672000;0
1471;11500;682;0;0;0;0;.00nan;0;0
1471;38277;476;0;0;0;0;.00nan;0;0
1471;78920;476;63;40;6;34;.850;3672000;0
1472;163528;682;68;33;3;30;.909;3749000;0
1472;11500;682;0;0;0;0;.00nan;0;0
1472;38277;476;0;0;0;0;.00nan;0;0
1472;78920;476;82;35;2;33;.943;3749000;0
1619;163528;682;96;29;1;28;.966;3600000;0
1619;11500;682;0;0;0;0;.00nan;0;0
1619;38277;476;0;0;0;0;.00nan;0;0
1619;78920;476;73;31;2;29;.935;3542000;0
15073;167480;503;0;0;0;0;.00nan;0;0
15073;170536;503;86;42;3;39;.929;3562000;0
15073;170547;500;91;35;2;33;.943;3600000;0
15073;63707;500;0;0;0;0;.00nan;0;0
15074;187813;499;0;0;0;0;.00nan;0;0
15074;175593;499;97;25;0;25;1.000;3674000;0
15074;181910;497;0;0;0;0;.00nan;0;0
15074;142810;497;93;37;1;36;.973;3674000;0
15075;-1;504;0;0;0;0;.00nan;0;0
15075;-1;504;60;35;4;31;.886;3600000;0
15075;49674;498;59;20;2;18;.900;3600000;0
15075;158630;498;0;0;0;0;.00nan;0;0
15076;6603;2591;0;0;0;0;.00nan;0;0
15076;174898;2591;100;39;0;39;1.000;3600000;0
15076;-1;505;0;0;0;0;.00nan;0;0
15076;43730;505;45;29;5;24;.828;3600000;0
15077;180188;4636;0;0;0;0;.00nan;0;0
15077;185413;4636;80;33;2;31;.939;3600000;0
15077;197409;502;0;0;0;0;.00nan;0;0
15077;152624;502;73;16;1;15;.938;3600000;0
15078;203533;495;0;0;0;0;.00nan;0;0
15078;178114;496;0;0;0;0;.00nan;0;0
15078;186234;496;94;21;0;21;1.000;3600000;0
15078;148508;495;86;39;2;37;.949;3564000;0
15079;6603;2591;61;32;3;29;.906;3600000;0
15079;174898;2591;0;0;0;0;.00nan;0;0
15079;-1;504;97;24;0;24;1.000;3600000;0
15079;-1;504;0;0;0;0;.00nan;0;0
15080;180188;4636;0;0;0;0;.00nan;0;0
15080;185413;4636;32;26;5;21;.808;3600000;0
15080;-1;505;0;0;0;0;.00nan;0;0
15080;43730;505;94;23;0;23;1.000;3600000;0
15081;178114;496;0;0;0;0;.00nan;0;0
15081;186234;496;48;23;3;20;.870;3600000;0
15081;197409;502;0;0;0;0;.00nan;0;0
15081;152624;502;100;32;0;32;1.000;3600000;0
15082;203533;495;0;0;0;0;.00nan;0;0
15082;181910;497;0;0;0;0;.00nan;0;0
15082;142810;497;91;22;0;22;1.000;3600000;0
15082;148508;495;97;41;2;39;.951;3563000;0
15083;167480;503;0;0;0;0;.00nan;0;0
15083;170536;503;44;31;5;26;.839;3514000;0
15083;49674;498;0;0;0;0;.00nan;0;0
15083;158630;498;45;19;3;16;.842;3600000;0
15084;187813;499;0;0;0;0;.00nan;0;0
15084;170547;500;75;27;2;25;.926;3600000;0
15084;175593;499;64;29;3;26;.897;3600000;0
15084;63707;500;0;0;0;0;.00nan;0;0
15085;6603;2591;81;33;2;31;.939;3600000;0
15085;174898;2591;0;0;0;0;.00nan;0;0
15085;-1;504;75;46;4;42;.913;3591000;0
15085;-1;504;0;0;0;0;.00nan;0;0
15086;180188;4636;44;23;4;19;.826;3600000;0
15086;185413;4636;0;0;0;0;.00nan;0;0
15086;-1;505;0;0;0;0;.00nan;0;0
15086;43730;505;78;24;1;23;.958;3600000;0
15087;178114;496;95;35;1;34;.971;3600000;0
15087;186234;496;0;0;0;0;.00nan;0;0
15087;197409;502;0;0;0;0;.00nan;0;0
15087;152624;502;78;26;2;24;.923;3600000;0
15088;203533;495;0;0;0;0;.00nan;0;0
15088;181910;497;0;0;0;0;.00nan;0;0
15088;142810;497;73;35;3;32;.914;3543000;0
15088;148508;495;89;33;2;31;.939;3600000;0
15089;167480;503;0;0;0;0;.00nan;0;0
15089;170536;503;74;31;2;29;.935;3600000;0
15089;49674;498;0;0;0;0;.00nan;0;0
15089;158630;498;46;21;4;17;.810;3571000;0
15090;187813;499;0;0;0;0;.00nan;0;0
15090;170547;500;42;21;4;17;.810;3515000;0
15090;175593;499;86;33;2;31;.939;3600000;0
15090;63707;500;0;0;0;0;.00nan;0;0
15091;187813;499;70;27;2;25;.926;3600000;0
15091;175593;499;0;0;0;0;.00nan;0;0
15091;49674;498;0;0;0;0;.00nan;0;0
15091;158630;498;58;29;3;26;.897;3588000;0
15092;203533;495;0;0;0;0;.00nan;0;0
15092;170547;500;86;38;2;36;.947;3600000;0
15092;63707;500;0;0;0;0;.00nan;0;0
15092;148508;495;79;31;3;28;.903;3572000;0
15093;167480;503;0;0;0;0;.00nan;0;0
15093;170536;503;89;30;1;29;.967;3600000;0
15093;-1;504;94;40;2;38;.950;3558000;0
15093;-1;504;0;0;0;0;.00nan;0;0
15094;178114;496;0;0;0;0;.00nan;0;0
15094;-1;505;0;0;0;0;.00nan;0;0
15094;186234;496;56;21;2;19;.905;3600000;0
15094;43730;505;61;24;3;21;.875;3567000;0
15095;6603;2591;85;37;2;35;.946;3515000;0
15095;174898;2591;0;0;0;0;.00nan;0;0
15095;180188;4636;83;15;0;15;1.000;3600000;0
15095;185413;4636;0;0;0;0;.00nan;0;0
15096;181910;497;0;0;0;0;.00nan;0;0
15096;197409;502;0;0;0;0;.00nan;0;0
15096;142810;497;61;42;5;37;.881;3565000;0
15096;152624;502;63;19;2;17;.895;3600000;0
15097;187813;499;0;0;0;0;.00nan;0;0
15097;175593;499;51;30;4;26;.867;3895000;0
15097;49674;498;0;0;0;0;.00nan;0;0
15097;158630;498;61;31;4;27;.871;3900000;0
15098;203533;495;47;33;4;29;.879;3900000;0
15098;170547;500;71;46;4;42;.913;3900000;0
15098;63707;500;0;0;0;0;.00nan;0;0
15098;148508;495;0;0;0;0;.00nan;0;0
15099;167480;503;0;0;0;0;.00nan;0;0
15099;170536;503;64;39;4;35;.897;3600000;0
15099;-1;504;86;30;1;29;.967;3600000;0
15099;-1;504;0;0;0;0;.00nan;0;0
15100;178114;496;0;0;0;0;.00nan;0;0
15100;-1;505;0;0;0;0;.00nan;0;0
15100;186234;496;52;26;3;23;.885;3600000;0
15100;43730;505;96;38;2;36;.947;3600000;0
15101;6603;2591;0;0;0;0;.00nan;0;0
15101;174898;2591;83;24;1;23;.958;3900000;0
15101;180188;4636;86;23;1;22;.957;3900000;0
15101;185413;4636;0;0;0;0;.00nan;0;0
15102;181910;497;0;0;0;0;.00nan;0;0
15102;197409;502;0;0;0;0;.00nan;0;0
15102;142810;497;69;31;3;28;.903;3600000;0
15102;152624;502;75;23;1;22;.957;3600000;0
15103;181910;497;0;0;0;0;.00nan;0;0
15103;-1;505;0;0;0;0;.00nan;0;0
15103;43730;505;83;28;1;27;.964;3600000;0
15103;142810;497;72;25;2;23;.920;3567000;0
15104;170547;500;73;25;1;24;.960;3600000;0
15104;197409;502;0;0;0;0;.00nan;0;0
15104;63707;500;0;0;0;0;.00nan;0;0
15104;152624;502;71;34;3;31;.912;3547000;0
15105;6603;2591;66;24;2;22;.917;3600000;0
15105;178114;496;63;32;3;29;.906;3600000;0
15105;174898;2591;0;0;0;0;.00nan;0;0
15105;186234;496;0;0;0;0;.00nan;0;0
15106;187813;499;0;0;0;0;.00nan;0;0
15106;167480;503;0;0;0;0;.00nan;0;0
15106;170536;503;76;42;4;38;.905;3600000;0
15106;175593;499;92;34;1;33;.971;3600000;0
15107;-1;504;72;35;2;33;.943;3600000;0
15107;-1;504;0;0;0;0;.00nan;0;0
15107;180188;4636;0;0;0;0;.00nan;0;0
15107;185413;4636;99;37;1;36;.973;3600000;0
15108;203533;495;0;0;0;0;.00nan;0;0
15108;49674;498;63;21;2;19;.905;3544000;0
15108;148508;495;81;28;1;27;.964;3600000;0
15108;158630;498;0;0;0;0;.00nan;0;0
15109;181910;497;0;0;0;0;.00nan;0;0
15109;-1;505;0;0;0;0;.00nan;0;0
15109;43730;505;72;33;3;30;.909;3600000;0
15109;142810;497;62;25;3;22;.880;3576000;0
15110;170547;500;56;40;5;35;.875;3600000;0
15110;197409;502;0;0;0;0;.00nan;0;0
15110;63707;500;0;0;0;0;.00nan;0;0
15110;152624;502;80;31;2;29;.935;3600000;0
15111;6603;2591;0;0;0;0;.00nan;0;0
15111;178114;496;82;27;1;26;.963;3895000;0
15111;174898;2591;90;41;2;39;.951;3895000;0
15111;186234;496;0;0;0;0;.00nan;0;0
15112;187813;499;0;0;0;0;.00nan;0;0
15112;167480;503;0;0;0;0;.00nan;0;0
15112;170536;503;82;31;1;30;.968;3600000;0
15112;175593;499;59;25;3;22;.880;3558000;0
15113;-1;504;77;36;2;34;.944;3600000;0
15113;-1;504;0;0;0;0;.00nan;0;0
15113;180188;4636;56;22;3;19;.864;3581000;0
15113;185413;4636;0;0;0;0;.00nan;0;0
15114;203533;495;0;0;0;0;.00nan;0;0
15114;49674;498;0;0;0;0;.00nan;0;0
15114;148508;495;68;31;3;28;.903;3600000;0
15114;158630;498;58;35;4;31;.886;3576000;0
15115;6603;2591;61;25;2;23;.920;3829000;0
15115;174898;2591;0;0;0;0;.00nan;0;0
15115;181910;497;0;0;0;0;.00nan;0;0
15115;142810;497;76;36;3;33;.917;3819000;0
15116;197409;502;0;0;0;0;.00nan;0;0
15116;49674;498;0;0;0;0;.00nan;0;0
15116;152624;502;90;20;0;20;1.000;3600000;0
15116;158630;498;88;40;2;38;.950;3555000;0
15117;203533;495;0;0;0;0;.00nan;0;0
15117;167480;503;42;3;1;2;.667;395000;0
15117;170536;503;47;36;6;30;.833;3205000;0
15117;148508;495;74;18;1;17;.944;3600000;0
15118;170547;500;100;25;0;25;1.000;3600000;0
15118;-1;505;42;29;5;24;.828;3600000;0
15118;43730;505;0;0;0;0;.00nan;0;0
15118;63707;500;0;0;0;0;.00nan;0;0
15119;178114;496;0;0;0;0;.00nan;0;0
15119;180188;4636;52;34;5;29;.853;3543000;0
15119;185413;4636;0;0;0;0;.00nan;0;0
15119;186234;496;61;32;3;29;.906;3600000;0
15120;187813;499;0;0;0;0;.00nan;0;0
15120;175593;499;85;14;0;14;1.000;3600000;0
15120;-1;504;86;39;2;37;.949;3589000;0
15120;-1;504;0;0;0;0;.00nan;0;0
15121;6603;2591;0;0;0;0;.00nan;0;0
15121;174898;2591;69;31;3;28;.903;3578000;0
15121;181910;497;0;0;0;0;.00nan;0;0
15121;142810;497;86;42;2;40;.952;3600000;0
15122;197409;502;0;0;0;0;.00nan;0;0
15122;49674;498;1;20;7;13;.650;1943000;0
15122;152624;502;59;27;3;24;.889;3600000;0
15122;158630;498;73;13;0;13;1.000;1657000;0
15123;203533;495;0;0;0;0;.00nan;0;0
15123;167480;503;0;0;0;0;.00nan;0;0
15123;170536;503;94;47;3;44;.936;3600000;0
15123;148508;495;64;23;2;21;.913;3600000;0
15124;170547;500;97;33;1;32;.970;3600000;0
15124;-1;505;0;0;0;0;.00nan;0;0
15124;43730;505;70;24;2;22;.917;3558000;0
15124;63707;500;0;0;0;0;.00nan;0;0
15125;178114;496;0;0;0;0;.00nan;0;0
15125;180188;4636;0;0;0;0;.00nan;0;0
15125;185413;4636;96;31;1;30;.968;3827000;0
15125;186234;496;74;33;2;31;.939;3827000;0
15126;187813;499;0;0;0;0;.00nan;0;0
15126;175593;499;58;23;2;21;.913;3600000;0
15126;-1;504;79;44;4;40;.909;3558000;0
15126;-1;504;0;0;0;0;.00nan;0;0
15127;187813;499;94;33;1;32;.970;3600000;0
15127;203533;495;0;0;0;0;.00nan;0;0
15127;175593;499;0;0;0;0;.00nan;0;0
15127;148508;495;64;21;2;19;.905;3577000;0
15128;180188;4636;0;0;0;0;.00nan;0;0
15128;185413;4636;64;25;2;23;.920;3600000;0
15128;181910;497;49;28;4;24;.857;3513000;0
15128;142810;497;0;0;0;0;.00nan;0;0
15129;6603;2591;0;0;0;0;.00nan;0;0
15129;170547;500;77;28;1;27;.964;3900000;0
15129;174898;2591;93;29;1;28;.966;3900000;0
15129;63707;500;0;0;0;0;.00nan;0;0
15130;167480;503;0;0;0;0;.00nan;0;0
15130;170536;503;100;25;0;25;1.000;3600000;0
15130;197409;502;0;0;0;0;.00nan;0;0
15130;152624;502;82;27;1;26;.963;3545000;0
15131;-1;505;0;0;0;0;.00nan;0;0
15131;43730;505;79;36;2;34;.944;3900000;0
15131;49674;498;64;28;2;26;.929;3900000;0
15131;158630;498;0;0;0;0;.00nan;0;0
15132;178114;496;95;31;1;30;.968;3600000;0
15132;-1;504;63;30;3;27;.900;3600000;0
15132;-1;504;0;0;0;0;.00nan;0;0
15132;186234;496;0;0;0;0;.00nan;0;0
15133;187813;499;0;0;0;0;.00nan;0;0
15133;203533;495;0;0;0;0;.00nan;0;0
15133;175593;499;79;38;3;35;.921;3600000;0
15133;148508;495;73;19;1;18;.947;3600000;0
15134;180188;4636;22;24;6;18;.750;2493000;0
15134;185413;4636;59;7;0;7;1.000;1107000;0
15134;181910;497;0;0;0;0;.00nan;0;0
15134;142810;497;88;18;0;18;1.000;3600000;0
15135;6603;2591;92;57;3;54;.947;3568000;0
15135;170547;500;0;0;0;0;.00nan;0;0
15135;174898;2591;0;0;0;0;.00nan;0;0
15135;63707;500;92;30;1;29;.967;3600000;0
15136;167480;503;0;0;0;0;.00nan;0;0
15136;170536;503;86;36;2;34;.944;3588000;0
15136;197409;502;0;0;0;0;.00nan;0;0
15136;152624;502;67;16;1;15;.938;3600000;0
15137;-1;505;0;0;0;0;.00nan;0;0
15137;43730;505;74;28;2;26;.929;3600000;0
15137;49674;498;0;0;0;0;.00nan;0;0
15137;158630;498;71;39;3;36;.923;3549000;0
15138;178114;496;0;0;0;0;.00nan;0;0
15138;-1;504;85;29;1;28;.966;3600000;0
15138;-1;504;0;0;0;0;.00nan;0;0
15138;186234;496;72;26;2;24;.923;3566000;0
15139;167480;503;0;0;0;0;.00nan;0;0
15139;170536;503;99;41;1;40;.976;3600000;0
15139;-1;505;0;0;0;0;.00nan;0;0
15139;43730;505;50;15;2;13;.867;3566000;0
15140;187813;499;0;0;0;0;.00nan;0;0
15140;175593;499;85;36;2;34;.944;3580000;0
15140;197409;502;0;0;0;0;.00nan;0;0
15140;152624;502;65;16;1;15;.938;3600000;0
15141;178114;496;51;36;5;31;.861;3565000;0
15141;181910;497;0;0;0;0;.00nan;0;0
15141;186234;496;0;0;0;0;.00nan;0;0
15141;142810;497;100;51;3;48;.941;3600000;0
15142;6603;2591;0;0;0;0;.00nan;0;0
15142;174898;2591;61;39;5;34;.872;3600000;0
15142;49674;498;98;32;1;31;.969;3600000;0
15142;158630;498;0;0;0;0;.00nan;0;0
15143;170547;500;74;42;4;38;.905;3600000;0
15143;180188;4636;0;0;0;0;.00nan;0;0
15143;185413;4636;69;24;1;23;.958;3600000;0
15143;63707;500;0;0;0;0;.00nan;0;0
15144;203533;495;0;0;0;0;.00nan;0;0
15144;-1;504;0;0;0;0;.00nan;0;0
15144;-1;504;97;25;0;25;1.000;3600000;0
15144;148508;495;64;21;2;19;.905;3520000;0
15145;167480;503;0;0;0;0;.00nan;0;0
15145;170536;503;100;44;2;42;.955;3600000;0
15145;-1;505;0;0;0;0;.00nan;0;0
15145;43730;505;59;21;3;18;.857;3600000;0
15146;187813;499;0;0;0;0;.00nan;0;0
15146;175593;499;100;53;1;52;.981;3600000;0
15146;197409;502;0;0;0;0;.00nan;0;0
15146;152624;502;60;20;2;18;.900;3595000;0
15147;178114;496;0;0;0;0;.00nan;0;0
15147;181910;497;0;0;0;0;.00nan;0;0
15147;186234;496;22;21;5;16;.762;3556000;0
15147;142810;497;54;32;4;28;.875;3600000;0
15148;6603;2591;98;34;1;33;.971;3600000;0
15148;174898;2591;0;0;0;0;.00nan;0;0
15148;49674;498;0;0;0;0;.00nan;0;0
15148;158630;498;72;27;2;25;.926;3600000;0
15149;170547;500;71;32;3;29;.906;3600000;0
15149;180188;4636;58;18;2;16;.889;3600000;0
15149;185413;4636;0;0;0;0;.00nan;0;0
15149;63707;500;0;0;0;0;.00nan;0;0
15150;203533;495;0;0;0;0;.00nan;0;0
15150;-1;504;0;0;0;0;.00nan;0;0
15150;-1;504;58;36;4;32;.889;3900000;0
15150;148508;495;76;41;4;37;.902;3900000;0
15151;187813;499;0;0;0;0;.00nan;0;0
15151;175593;499;61;33;4;29;.879;3600000;0
15151;-1;505;0;0;0;0;.00nan;0;0
15151;43730;505;75;26;1;25;.962;3600000;0
15152;180188;4636;38;26;4;22;.846;3552000;0
15152;185413;4636;0;0;0;0;.00nan;0;0
15152;49674;498;84;35;2;33;.943;3600000;0
15152;158630;498;0;0;0;0;.00nan;0;0
15153;178114;496;0;0;0;0;.00nan;0;0
15153;170547;500;85;27;2;25;.926;3600000;0
15153;186234;496;70;35;3;32;.914;3600000;0
15153;63707;500;0;0;0;0;.00nan;0;0
15154;6603;2591;0;0;0;0;.00nan;0;0
15154;167480;503;0;0;0;0;.00nan;0;0
15154;170536;503;71;30;3;27;.900;3600000;0
15154;174898;2591;75;26;2;24;.923;3600000;0
15155;-1;504;97;41;2;39;.951;3600000;0
15155;-1;504;0;0;0;0;.00nan;0;0
15155;181910;497;0;0;0;0;.00nan;0;0
15155;142810;497;39;26;5;21;.808;3600000;0
15156;203533;495;0;0;0;0;.00nan;0;0
15156;197409;502;0;0;0;0;.00nan;0;0
15156;148508;495;79;43;4;39;.907;3600000;0
15156;152624;502;51;29;5;24;.828;3549000;0
15157;187813;499;0;0;0;0;.00nan;0;0
15157;175593;499;86;43;3;40;.930;3600000;0
15157;-1;505;0;0;0;0;.00nan;0;0
15157;43730;505;71;23;2;21;.913;3600000;0
15158;180188;4636;0;0;0;0;.00nan;0;0
15158;185413;4636;100;34;0;34;1.000;3600000;0
15158;49674;498;0;0;0;0;.00nan;0;0
15158;158630;498;41;32;6;26;.813;3600000;0
15159;178114;496;0;0;0;0;.00nan;0;0
15159;170547;500;89;36;2;34;.944;3900000;0
15159;186234;496;74;32;2;30;.938;3900000;0
15159;63707;500;0;0;0;0;.00nan;0;0
15160;6603;2591;100;44;1;43;.977;3900000;0
15160;167480;503;0;0;0;0;.00nan;0;0
15160;170536;503;85;28;1;27;.964;3900000;0
15160;174898;2591;0;0;0;0;.00nan;0;0
15161;-1;504;97;36;1;35;.972;3600000;0
15161;-1;504;0;0;0;0;.00nan;0;0
15161;181910;497;0;0;0;0;.00nan;0;0
15161;142810;497;62;25;2;23;.920;3561000;0
15162;203533;495;0;0;0;0;.00nan;0;0
15162;197409;502;0;0;0;0;.00nan;0;0
15162;148508;495;77;32;2;30;.938;3600000;0
15162;152624;502;55;36;5;31;.861;3600000;0
15163;203533;495;0;0;0;0;.00nan;0;0
15163;-1;505;0;0;0;0;.00nan;0;0
15163;43730;505;75;26;1;25;.962;3900000;0
15163;148508;495;80;30;1;29;.967;3900000;0
15164;187813;499;0;0;0;0;.00nan;0;0
15164;6603;2591;0;0;0;0;.00nan;0;0
15164;174898;2591;71;36;3;33;.917;3559000;0
15164;175593;499;66;28;2;26;.929;3600000;0
15165;167480;503;0;0;0;0;.00nan;0;0
15165;170536;503;69;26;2;24;.923;3574000;0
15165;180188;4636;0;0;0;0;.00nan;0;0
15165;185413;4636;73;22;1;21;.955;3600000;0
15166;170547;500;76;21;1;20;.952;3600000;0
15166;181910;497;58;34;5;29;.853;3600000;0
15166;63707;500;0;0;0;0;.00nan;0;0
15166;142810;497;0;0;0;0;.00nan;0;0
15167;178114;496;90;33;1;32;.970;3567000;0
15167;186234;496;0;0;0;0;.00nan;0;0
15167;49674;498;0;0;0;0;.00nan;0;0
15167;158630;498;98;25;0;25;1.000;3600000;0
15168;-1;504;73;48;5;43;.896;3564000;0
15168;-1;504;0;0;0;0;.00nan;0;0
15168;197409;502;0;0;0;0;.00nan;0;0
15168;152624;502;47;23;4;19;.826;3600000;0
15169;203533;495;0;0;0;0;.00nan;0;0
15169;-1;505;60;22;2;20;.909;3600000;0
15169;43730;505;0;0;0;0;.00nan;0;0
15169;148508;495;32;28;5;23;.821;3600000;0
15170;187813;499;0;0;0;0;.00nan;0;0
15170;6603;2591;100;24;0;24;1.000;3600000;0
15170;174898;2591;0;0;0;0;.00nan;0;0
15170;175593;499;73;46;4;42;.913;3600000;0
15171;167480;503;0;0;0;0;.00nan;0;0
15171;170536;503;98;41;1;40;.976;3900000;0
15171;180188;4636;80;25;1;24;.960;3900000;0
15171;185413;4636;0;0;0;0;.00nan;0;0
15172;170547;500;63;29;3;26;.897;3600000;0
15172;181910;497;0;0;0;0;.00nan;0;0
15172;63707;500;0;0;0;0;.00nan;0;0
15172;142810;497;68;22;2;20;.909;3600000;0
15173;178114;496;0;0;0;0;.00nan;0;0
15173;186234;496;21;23;6;17;.739;3600000;0
15173;49674;498;0;0;0;0;.00nan;0;0
15173;158630;498;72;32;3;29;.906;3600000;0
15174;-1;504;0;0;0;0;.00nan;0;0
15174;-1;504;88;49;4;45;.918;3900000;0
15174;197409;502;0;0;0;0;.00nan;0;0
15174;152624;502;51;28;4;24;.857;3900000;0
15175;167480;503;0;0;0;0;.00nan;0;0
15175;178114;496;0;0;0;0;.00nan;0;0
15175;170536;503;72;43;4;39;.907;3600000;0
15175;186234;496;69;20;1;19;.950;3600000;0
15176;181910;497;0;0;0;0;.00nan;0;0
15176;49674;498;83;29;1;28;.966;3600000;0
15176;142810;497;67;27;2;25;.926;3600000;0
15176;158630;498;0;0;0;0;.00nan;0;0
15177;170547;500;100;42;1;41;.976;3600000;0
15177;-1;504;62;33;3;30;.909;3562000;0
15177;-1;504;0;0;0;0;.00nan;0;0
15177;63707;500;0;0;0;0;.00nan;0;0
15178;187813;499;0;0;0;0;.00nan;0;0
15178;175593;499;95;35;1;34;.971;3600000;0
15178;180188;4636;48;26;4;22;.846;3600000;0
15178;185413;4636;0;0;0;0;.00nan;0;0
15179;-1;505;0;0;0;0;.00nan;0;0
15179;43730;505;52;24;3;21;.875;3600000;0
15179;197409;502;0;0;0;0;.00nan;0;0
15179;152624;502;100;44;0;44;1.000;3600000;0
15180;203533;495;0;0;0;0;.00nan;0;0
15180;6603;2591;42;38;6;32;.842;3173000;0
15180;174898;2591;64;6;0;6;1.000;427000;0
15180;148508;495;61;23;2;21;.913;3600000;0
15181;167480;503;64;19;1;18;.947;2942000;0
15181;178114;496;60;17;2;15;.882;3600000;0
15181;170536;503;45;15;3;12;.800;574000;0
15181;186234;496;0;0;0;0;.00nan;0;0
15182;181910;497;0;0;0;0;.00nan;0;0
15182;49674;498;0;0;0;0;.00nan;0;0
15182;142810;497;68;26;2;24;.923;3554000;0
15182;158630;498;72;25;1;24;.960;3600000;0
15183;170547;500;72;22;2;20;.909;3600000;0
15183;-1;504;80;39;3;36;.923;3579000;0
15183;-1;504;0;0;0;0;.00nan;0;0
15183;63707;500;0;0;0;0;.00nan;0;0
15184;187813;499;0;0;0;0;.00nan;0;0
15184;175593;499;99;24;0;24;1.000;3600000;0
15184;180188;4636;0;0;0;0;.00nan;0;0
15184;185413;4636;39;28;5;23;.821;3600000;0
15185;-1;505;0;0;0;0;.00nan;0;0
15185;43730;505;63;31;3;28;.903;3600000;0
15185;197409;502;0;0;0;0;.00nan;0;0
15185;152624;502;100;33;0;33;1.000;3600000;0
15186;203533;495;48;13;2;11;.846;3600000;0
15186;6603;2591;73;50;5;45;.900;3600000;0
15186;174898;2591;0;0;0;0;.00nan;0;0
15186;148508;495;0;0;0;0;.00nan;0;0
15187;6603;2591;0;0;0;0;.00nan;0;0
15187;174898;2591;99;49;2;47;.959;3600000;0
15187;197409;502;0;0;0;0;.00nan;0;0
15187;152624;502;65;23;3;20;.870;3562000;0
15188;203533;495;0;0;0;0;.00nan;0;0
15188;180188;4636;68;27;2;25;.926;3549000;0
15188;185413;4636;0;0;0;0;.00nan;0;0
15188;148508;495;100;44;1;43;.977;3600000;0
15189;-1;504;64;48;5;43;.896;3600000;0
15189;-1;504;0;0;0;0;.00nan;0;0
15189;-1;505;0;0;0;0;.00nan;0;0
15189;43730;505;74;26;2;24;.923;3600000;0
15190;167480;503;0;0;0;0;.00nan;0;0
15190;170536;503;86;39;3;36;.923;3900000;0
15190;181910;497;0;0;0;0;.00nan;0;0
15190;142810;497;66;26;3;23;.885;3850000;0
15191;170547;500;100;28;0;28;1.000;3600000;0
15191;49674;498;62;41;5;36;.878;3600000;0
15191;63707;500;0;0;0;0;.00nan;0;0
15191;158630;498;0;0;0;0;.00nan;0;0
15192;187813;499;0;0;0;0;.00nan;0;0
15192;178114;496;0;0;0;0;.00nan;0;0
15192;175593;499;94;34;1;33;.971;3600000;0
15192;186234;496;48;24;3;21;.875;3567000;0
15193;6603;2591;85;39;2;37;.949;3900000;0
15193;174898;2591;0;0;0;0;.00nan;0;0
15193;197409;502;0;0;0;0;.00nan;0;0
15193;152624;502;78;26;2;24;.923;3900000;0
15194;203533;495;0;0;0;0;.00nan;0;0
15194;180188;4636;49;32;4;28;.875;3590000;0
15194;185413;4636;0;0;0;0;.00nan;0;0
15194;148508;495;75;33;2;31;.939;3600000;0
15195;-1;504;46;39;6;33;.846;3600000;0
15195;-1;504;0;0;0;0;.00nan;0;0
15195;-1;505;0;0;0;0;.00nan;0;0
15195;43730;505;61;21;3;18;.857;3600000;0
15196;167480;503;0;0;0;0;.00nan;0;0
15196;170536;503;99;36;1;35;.972;3600000;0
15196;181910;497;89;47;3;44;.936;3534000;0
15196;142810;497;0;0;0;0;.00nan;0;0
15197;170547;500;50;41;6;35;.854;3600000;0
15197;49674;498;0;0;0;0;.00nan;0;0
15197;63707;500;0;0;0;0;.00nan;0;0
15197;158630;498;77;33;2;31;.939;3600000;0
15198;187813;499;0;0;0;0;.00nan;0;0
15198;178114;496;0;0;0;0;.00nan;0;0
15198;175593;499;63;28;3;25;.893;3600000;0
15198;186234;496;37;33;5;28;.848;3555000;0
15199;6603;2591;96;48;3;45;.938;3600000;0
15199;174898;2591;0;0;0;0;.00nan;0;0
15199;-1;505;0;0;0;0;.00nan;0;0
15199;43730;505;42;21;4;17;.810;3575000;0
15200;180188;4636;0;0;0;0;.00nan;0;0
15200;185413;4636;92;17;0;17;1.000;3600000;0
15200;197409;502;0;0;0;0;.00nan;0;0
15200;152624;502;93;28;1;27;.964;3548000;0
15201;203533;495;0;0;0;0;.00nan;0;0
15201;178114;496;0;0;0;0;.00nan;0;0
15201;186234;496;62;28;4;24;.857;3555000;0
15201;148508;495;92;32;2;30;.938;3600000;0
15202;187813;499;0;0;0;0;.00nan;0;0
15202;175593;499;81;40;3;37;.925;3535000;0
15202;181910;497;0;0;0;0;.00nan;0;0
15202;142810;497;57;22;2;20;.909;3600000;0
15203;-1;504;76;44;4;40;.909;3627000;0
15203;-1;504;0;0;0;0;.00nan;0;0
15203;49674;498;75;28;3;25;.893;3627000;0
15203;158630;498;0;0;0;0;.00nan;0;0
15204;167480;503;0;0;0;0;.00nan;0;0
15204;170536;503;68;39;4;35;.897;3558000;0
15204;170547;500;57;19;3;16;.842;3600000;0
15204;63707;500;0;0;0;0;.00nan;0;0
15205;6603;2591;0;0;0;0;.00nan;0;0
15205;174898;2591;75;37;3;34;.919;3563000;0
15205;-1;505;0;0;0;0;.00nan;0;0
15205;43730;505;77;30;2;28;.933;3600000;0
15206;180188;4636;0;0;0;0;.00nan;0;0
15206;185413;4636;47;28;5;23;.821;3600000;0
15206;197409;502;0;0;0;0;.00nan;0;0
15206;152624;502;100;23;0;23;1.000;3600000;0
15207;203533;495;0;0;0;0;.00nan;0;0
15207;178114;496;77;29;2;27;.931;3590000;0
15207;186234;496;0;0;0;0;.00nan;0;0
15207;148508;495;79;26;1;25;.962;3600000;0
15208;187813;499;0;0;0;0;.00nan;0;0
15208;175593;499;78;31;2;29;.935;3600000;0
15208;181910;497;0;0;0;0;.00nan;0;0
15208;142810;497;78;26;1;25;.962;3600000;0
15209;-1;504;9;25;7;18;.720;3600000;0
15209;-1;504;0;0;0;0;.00nan;0;0
15209;49674;498;0;0;0;0;.00nan;0;0
15209;158630;498;100;35;0;35;1.000;3600000;0
15210;167480;503;0;0;0;0;.00nan;0;0
15210;170536;503;50;35;5;30;.857;3600000;0
15210;170547;500;83;30;2;28;.933;3600000;0
15210;63707;500;0;0;0;0;.00nan;0;0
15211;167480;503;51;35;4;31;.886;3079000;0
15211;170536;503;22;5;3;2;.400;521000;0
15211;49674;498;0;0;0;0;.00nan;0;0
15211;158630;498;62;18;2;16;.889;3600000;0
15212;187813;499;72;31;2;29;.935;3600000;0
15212;170547;500;67;38;4;34;.895;3590000;0
15212;175593;499;0;0;0;0;.00nan;0;0
15212;63707;500;0;0;0;0;.00nan;0;0
15213;203533;495;0;0;0;0;.00nan;0;0
15213;181910;497;0;0;0;0;.00nan;0;0
15213;142810;497;60;29;3;26;.897;3600000;0
15213;148508;495;70;48;5;43;.896;3553000;0
15214;180188;4636;72;36;4;32;.889;3600000;0
15214;185413;4636;0;0;0;0;.00nan;0;0
15214;-1;505;0;0;0;0;.00nan;0;0
15214;43730;505;76;27;2;25;.926;3600000;0
15215;178114;496;0;0;0;0;.00nan;0;0
15215;186234;496;83;32;1;31;.969;3900000;0
15215;197409;502;79;29;1;28;.966;3900000;0
15215;152624;502;0;0;0;0;.00nan;0;0
15216;6603;2591;74;41;4;37;.902;3600000;0
15216;174898;2591;0;0;0;0;.00nan;0;0
15216;-1;504;88;30;1;29;.967;3600000;0
15216;-1;504;0;0;0;0;.00nan;0;0
15217;167480;503;52;33;3;30;.909;3516000;0
15217;170536;503;0;0;0;0;.00nan;0;0
15217;49674;498;84;26;1;25;.962;3600000;0
15217;158630;498;0;0;0;0;.00nan;0;0
15218;187813;499;0;0;0;0;.00nan;0;0
15218;170547;500;73;38;4;34;.895;3600000;0
15218;175593;499;90;36;2;34;.944;3600000;0
15218;63707;500;0;0;0;0;.00nan;0;0
15219;203533;495;0;0;0;0;.00nan;0;0
15219;181910;497;0;0;0;0;.00nan;0;0
15219;142810;497;82;37;3;34;.919;3560000;0
15219;148508;495;71;22;1;21;.955;3600000;0
15220;180188;4636;86;31;1;30;.968;3600000;0
15220;185413;4636;0;0;0;0;.00nan;0;0
15220;-1;505;0;0;0;0;.00nan;0;0
15220;43730;505;95;25;0;25;1.000;3600000;0
15221;178114;496;75;35;3;32;.914;3531000;0
15221;186234;496;0;0;0;0;.00nan;0;0
15221;197409;502;0;0;0;0;.00nan;0;0
15221;152624;502;81;28;1;27;.964;3600000;0
15222;6603;2591;86;28;1;27;.964;3600000;0
15222;174898;2591;0;0;0;0;.00nan;0;0
15222;-1;504;37;35;6;29;.829;3275000;0
15222;-1;504;50;1;0;1;1.000;325000;0
15223;181910;497;0;0;0;0;.00nan;0;0
15223;197409;502;0;0;0;0;.00nan;0;0
15223;142810;497;92;47;3;44;.936;3675000;0
15223;152624;502;67;20;2;18;.900;3675000;0
15224;6603;2591;0;0;0;0;.00nan;0;0
15224;174898;2591;70;26;2;24;.923;3600000;0
15224;180188;4636;0;0;0;0;.00nan;0;0
15224;185413;4636;70;22;1;21;.955;3600000;0
15225;178114;496;0;0;0;0;.00nan;0;0
15225;-1;505;0;0;0;0;.00nan;0;0
15225;186234;496;83;24;1;23;.958;3663000;0
15225;43730;505;94;36;2;34;.944;3663000;0
15226;167480;503;0;0;0;0;.00nan;0;0
15226;170536;503;100;48;2;46;.958;3600000;0
15226;-1;504;76;33;3;30;.909;3561000;0
15226;-1;504;0;0;0;0;.00nan;0;0
15227;187813;499;0;0;0;0;.00nan;0;0
15227;175593;499;100;26;0;26;1.000;3600000;0
15227;49674;498;0;0;0;0;.00nan;0;0
15227;158630;498;38;23;5;18;.783;3600000;0
15228;203533;495;0;0;0;0;.00nan;0;0
15228;170547;500;100;43;1;42;.977;3718000;0
15228;63707;500;0;0;0;0;.00nan;0;0
15228;148508;495;85;29;2;27;.931;3718000;0
15229;181910;497;89;34;2;32;.941;3900000;0
15229;197409;502;0;0;0;0;.00nan;0;0
15229;142810;497;0;0;0;0;.00nan;0;0
15229;152624;502;71;28;2;26;.929;3900000;0
15230;6603;2591;59;49;6;43;.878;3544000;0
15230;174898;2591;0;0;0;0;.00nan;0;0
15230;180188;4636;45;24;5;19;.792;3600000;0
15230;185413;4636;0;0;0;0;.00nan;0;0
15231;178114;496;87;33;2;31;.939;3900000;0
15231;-1;505;0;0;0;0;.00nan;0;0
15231;186234;496;0;0;0;0;.00nan;0;0
15231;43730;505;66;27;2;25;.926;3900000;0
15232;167480;503;66;14;0;14;1.000;1481000;0
15232;170536;503;18;21;6;15;.714;2119000;0
15232;-1;504;68;26;2;24;.923;3600000;0
15232;-1;504;0;0;0;0;.00nan;0;0
15233;187813;499;0;0;0;0;.00nan;0;0
15233;175593;499;98;46;3;43;.935;3557000;0
15233;49674;498;0;0;0;0;.00nan;0;0
15233;158630;498;97;40;1;39;.975;3600000;0
15234;203533;495;0;0;0;0;.00nan;0;0
15234;170547;500;0;0;0;0;.00nan;0;0
15234;63707;500;83;35;2;33;.943;3900000;0
15234;148508;495;65;30;2;28;.933;3900000;0
15235;187813;499;0;0;0;0;.00nan;0;0
15235;167480;503;0;0;0;0;.00nan;0;0
15235;170536;503;85;49;4;45;.918;3600000;0
15235;175593;499;91;16;0;16;1.000;3600000;0
15236;203533;495;0;0;0;0;.00nan;0;0
15236;49674;498;0;0;0;0;.00nan;0;0
15236;148508;495;32;32;6;26;.813;3513000;0
15236;158630;498;67;39;4;35;.897;3600000;0
15237;-1;504;40;30;5;25;.833;3591000;0
15237;-1;504;0;0;0;0;.00nan;0;0
15237;180188;4636;0;0;0;0;.00nan;0;0
15237;185413;4636;56;26;3;23;.885;3600000;0
15238;181910;497;0;0;0;0;.00nan;0;0
15238;-1;505;0;0;0;0;.00nan;0;0
15238;43730;505;45;15;3;12;.800;3580000;0
15238;142810;497;99;48;1;47;.979;3600000;0
15239;6603;2591;0;0;0;0;.00nan;0;0
15239;178114;496;0;0;0;0;.00nan;0;0
15239;174898;2591;77;40;4;36;.900;3600000;0
15239;186234;496;76;24;1;23;.958;3600000;0
15240;170547;500;99;25;0;25;1.000;3600000;0
15240;197409;502;0;0;0;0;.00nan;0;0
15240;63707;500;0;0;0;0;.00nan;0;0
15240;152624;502;68;28;3;25;.893;3600000;0
15241;187813;499;0;0;0;0;.00nan;0;0
15241;167480;503;0;0;0;0;.00nan;0;0
15241;170536;503;91;39;1;38;.974;3900000;0
15241;175593;499;80;24;1;23;.958;3900000;0
15242;203533;495;0;0;0;0;.00nan;0;0
15242;49674;498;0;0;0;0;.00nan;0;0
15242;148508;495;78;14;0;14;1.000;3600000;0
15242;158630;498;64;42;4;38;.905;3600000;0
15243;-1;504;100;56;0;56;1.000;3600000;0
15243;-1;504;0;0;0;0;.00nan;0;0
15243;180188;4636;81;26;1;25;.962;3570000;0
15243;185413;4636;0;0;0;0;.00nan;0;0
15244;181910;497;0;0;0;0;.00nan;0;0
15244;-1;505;0;0;0;0;.00nan;0;0
15244;43730;505;68;25;2;23;.920;3900000;0
15244;142810;497;76;30;2;28;.933;3900000;0
15245;6603;2591;83;30;1;29;.967;3900000;0
15245;178114;496;0;0;0;0;.00nan;0;0
15245;174898;2591;0;0;0;0;.00nan;0;0
15245;186234;496;97;38;1;37;.974;3900000;0
15246;170547;500;68;30;3;27;.900;3600000;0
15246;197409;502;0;0;0;0;.00nan;0;0
15246;63707;500;0;0;0;0;.00nan;0;0
15246;152624;502;53;30;5;25;.833;3551000;0
15247;187813;499;0;0;0;0;.00nan;0;0
15247;175593;499;31;27;5;22;.815;3600000;0
15247;-1;504;92;39;1;38;.974;3600000;0
15247;-1;504;0;0;0;0;.00nan;0;0
15248;170547;500;82;29;1;28;.966;3600000;0
15248;-1;505;0;0;0;0;.00nan;0;0
15248;43730;505;84;33;3;30;.909;3559000;0
15248;63707;500;0;0;0;0;.00nan;0;0
15249;178114;496;99;38;1;37;.974;3600000;0
15249;180188;4636;0;0;0;0;.00nan;0;0
15249;185413;4636;75;29;2;27;.931;3600000;0
15249;186234;496;0;0;0;0;.00nan;0;0
15250;203533;495;0;0;0;0;.00nan;0;0
15250;167480;503;0;0;0;0;.00nan;0;0
15250;170536;503;68;33;3;30;.909;3558000;0
15250;148508;495;70;19;1;18;.947;3600000;0
15251;6603;2591;0;0;0;0;.00nan;0;0
15251;174898;2591;100;32;0;32;1.000;3600000;0
15251;181910;497;0;0;0;0;.00nan;0;0
15251;142810;497;60;28;3;25;.893;3600000;0
15252;197409;502;0;0;0;0;.00nan;0;0
15252;49674;498;100;28;0;28;1.000;3600000;0
15252;152624;502;74;25;2;23;.920;3561000;0
15252;158630;498;0;0;0;0;.00nan;0;0
15253;187813;499;0;0;0;0;.00nan;0;0
15253;175593;499;40;28;5;23;.821;3600000;0
15253;-1;504;96;31;1;30;.968;3600000;0
15253;-1;504;0;0;0;0;.00nan;0;0
15254;170547;500;100;28;0;28;1.000;3600000;0
15254;-1;505;0;0;0;0;.00nan;0;0
15254;43730;505;89;32;1;31;.969;3600000;0
15254;63707;500;0;0;0;0;.00nan;0;0
15255;178114;496;52;32;4;28;.875;3600000;0
15255;180188;4636;100;21;0;21;1.000;3600000;0
15255;185413;4636;0;0;0;0;.00nan;0;0
15255;186234;496;0;0;0;0;.00nan;0;0
15256;203533;495;0;0;0;0;.00nan;0;0
15256;167480;503;0;0;0;0;.00nan;0;0
15256;170536;503;100;43;1;42;.977;3600000;0
15256;148508;495;27;24;5;19;.792;3600000;0
15257;6603;2591;0;0;0;0;.00nan;0;0
15257;174898;2591;91;42;3;39;.929;3600000;0
15257;181910;497;0;0;0;0;.00nan;0;0
15257;142810;497;100;20;0;20;1.000;3600000;0
15258;197409;502;0;0;0;0;.00nan;0;0
15258;49674;498;86;33;2;31;.939;3600000;0
15258;152624;502;49;22;3;19;.864;3600000;0
15258;158630;498;0;0;0;0;.00nan;0;0
15259;-1;505;0;0;0;0;.00nan;0;0
15259;43730;505;93;17;0;17;1.000;3600000;0
15259;49674;498;0;0;0;0;.00nan;0;0
15259;158630;498;95;31;1;30;.968;3552000;0
15260;167480;503;0;0;0;0;.00nan;0;0
15260;170536;503;100;55;1;54;.982;3600000;0
15260;197409;502;0;0;0;0;.00nan;0;0
15260;152624;502;65;18;2;16;.889;3551000;0
15261;178114;496;58;34;5;29;.853;3600000;0
15261;-1;504;83;32;2;30;.938;3600000;0
15261;-1;504;0;0;0;0;.00nan;0;0
15261;186234;496;0;0;0;0;.00nan;0;0
15262;6603;2591;89;39;2;37;.949;3600000;0
15262;170547;500;52;21;3;18;.857;3570000;0
15262;174898;2591;0;0;0;0;.00nan;0;0
15262;63707;500;0;0;0;0;.00nan;0;0
15263;180188;4636;79;20;0;20;1.000;3900000;0
15263;185413;4636;0;0;0;0;.00nan;0;0
15263;181910;497;0;0;0;0;.00nan;0;0
15263;142810;497;100;38;0;38;1.000;3900000;0
15264;187813;499;0;0;0;0;.00nan;0;0
15264;203533;495;87;29;1;28;.966;3600000;0
15264;175593;499;70;32;3;29;.906;3541000;0
15264;148508;495;0;0;0;0;.00nan;0;0
15265;-1;505;0;0;0;0;.00nan;0;0
15265;43730;505;100;28;0;28;1.000;3600000;0
15265;49674;498;67;33;3;30;.909;3047000;0
15265;158630;498;41;14;3;11;.786;553000;0
15266;167480;503;0;0;0;0;.00nan;0;0
15266;170536;503;72;50;5;45;.900;3600000;0
15266;197409;502;0;0;0;0;.00nan;0;0
15266;152624;502;90;18;0;18;1.000;3600000;0
15267;178114;496;0;0;0;0;.00nan;0;0
15267;-1;504;0;0;0;0;.00nan;0;0
15267;-1;504;98;39;2;37;.949;3600000;0
15267;186234;496;54;25;3;22;.880;3582000;0
15268;6603;2591;100;33;0;33;1.000;3600000;0
15268;170547;500;79;24;1;23;.958;3578000;0
15268;174898;2591;0;0;0;0;.00nan;0;0
15268;63707;500;0;0;0;0;.00nan;0;0
15269;180188;4636;51;17;2;15;.882;3600000;0
15269;185413;4636;0;0;0;0;.00nan;0;0
15269;181910;497;0;0;0;0;.00nan;0;0
15269;142810;497;53;33;5;28;.848;3600000;0
15270;187813;499;0;0;0;0;.00nan;0;0
15270;203533;495;0;0;0;0;.00nan;0;0
15270;175593;499;80;54;5;49;.907;3600000;0
15270;148508;495;55;19;2;17;.895;3600000;0
15271;6603;2591;70;25;2;23;.920;3600000;0
15271;174898;2591;0;0;0;0;.00nan;0;0
15271;49674;498;85;28;1;27;.964;3600000;0
15271;158630;498;0;0;0;0;.00nan;0;0
15272;-1;504;33;15;4;11;.733;959000;0
15272;-1;504;67;25;1;24;.960;2641000;0
15272;185442;495;0;0;0;0;.00nan;0;0
15272;148508;495;99;25;0;25;1.000;3600000;0
15273;170547;500;58;32;4;28;.875;3551000;0
15273;180188;4636;88;37;2;35;.946;3600000;0
15273;185413;4636;0;0;0;0;.00nan;0;0
15273;63707;500;0;0;0;0;.00nan;0;0
15274;167480;503;0;0;0;0;.00nan;0;0
15274;170536;503;83;43;3;40;.930;3600000;0
15274;-1;505;0;0;0;0;.00nan;0;0
15274;43730;505;95;23;0;23;1.000;3600000;0
15275;187813;499;0;0;0;0;.00nan;0;0
15275;175593;499;79;29;1;28;.966;3659000;0
15275;-1;502;0;0;0;0;.00nan;0;0
15275;152624;502;69;27;2;25;.926;3659000;0
15276;178114;496;89;31;1;30;.968;3600000;0
15276;181910;497;0;0;0;0;.00nan;0;0
15276;186234;496;0;0;0;0;.00nan;0;0
15276;142810;497;57;19;2;17;.895;3577000;0
15277;6603;2591;100;25;0;25;1.000;3600000;0
15277;174898;2591;0;0;0;0;.00nan;0;0
15277;49674;498;0;0;0;0;.00nan;0;0
15277;158630;498;63;18;1;17;.944;3564000;0
15278;-1;504;52;44;6;38;.864;3600000;0
15278;-1;504;0;0;0;0;.00nan;0;0
15278;185442;495;0;0;0;0;.00nan;0;0
15278;148508;495;73;22;1;21;.955;3600000;0
15279;170547;500;85;29;1;28;.966;3600000;0
15279;180188;4636;77;32;3;29;.906;3590000;0
15279;185413;4636;0;0;0;0;.00nan;0;0
15279;63707;500;0;0;0;0;.00nan;0;0
15280;167480;503;0;0;0;0;.00nan;0;0
15280;170536;503;78;40;3;37;.925;3600000;0
15280;-1;505;0;0;0;0;.00nan;0;0
15280;43730;505;100;23;0;23;1.000;3600000;0
15281;187813;499;0;0;0;0;.00nan;0;0
15281;175593;499;87;39;3;36;.923;3900000;0
15281;-1;502;0;0;0;0;.00nan;0;0
15281;152624;502;67;34;3;31;.912;3900000;0
15282;178114;496;0;0;0;0;.00nan;0;0
15282;181910;497;98;47;2;45;.957;3600000;0
15282;186234;496;77;25;1;24;.960;3600000;0
15282;142810;497;0;0;0;0;.00nan;0;0
15283;6603;2591;78;26;2;24;.923;3600000;0
15283;167480;503;0;0;0;0;.00nan;0;0
15283;170536;503;88;50;4;46;.920;3558000;0
15283;174898;2591;0;0;0;0;.00nan;0;0
15284;185442;495;87;33;1;32;.970;3900000;0
15284;-1;502;0;0;0;0;.00nan;0;0
15284;148508;495;0;0;0;0;.00nan;0;0
15284;152624;502;100;30;1;29;.967;3900000;0
15285;178114;496;0;0;0;0;.00nan;0;0
15285;170547;500;70;32;3;29;.906;3600000;0
15285;186234;496;91;32;1;31;.969;3600000;0
15285;63707;500;0;0;0;0;.00nan;0;0
15286;187813;499;0;0;0;0;.00nan;0;0
15286;175593;499;88;47;3;44;.936;3585000;0
15286;-1;505;0;0;0;0;.00nan;0;0
15286;43730;505;77;26;2;24;.923;3600000;0
15287;180188;4636;0;0;0;0;.00nan;0;0
15287;185413;4636;56;30;3;27;.900;3600000;0
15287;49674;498;0;0;0;0;.00nan;0;0
15287;158630;498;81;33;2;31;.939;3600000;0
15288;-1;504;87;31;1;30;.968;3600000;0
15288;-1;504;0;0;0;0;.00nan;0;0
15288;181910;497;0;0;0;0;.00nan;0;0
15288;142810;497;79;32;2;30;.938;3600000;0
15289;6603;2591;97;35;1;34;.971;3600000;0
15289;167480;503;0;0;0;0;.00nan;0;0
15289;170536;503;73;35;3;32;.914;3534000;0
15289;174898;2591;0;0;0;0;.00nan;0;0
15290;185442;495;82;33;1;32;.970;3600000;0
15290;-1;502;0;0;0;0;.00nan;0;0
15290;148508;495;0;0;0;0;.00nan;0;0
15290;152624;502;63;25;2;23;.920;3600000;0
15291;178114;496;0;0;0;0;.00nan;0;0
15291;170547;500;90;27;1;26;.963;3900000;0
15291;186234;496;86;32;1;31;.969;3900000;0
15291;63707;500;0;0;0;0;.00nan;0;0
15292;187813;499;0;0;0;0;.00nan;0;0
15292;175593;499;49;34;5;29;.853;3600000;0
15292;-1;505;0;0;0;0;.00nan;0;0
15292;43730;505;72;24;1;23;.958;3600000;0
15293;180188;4636;84;23;1;22;.957;3600000;0
15293;185413;4636;0;0;0;0;.00nan;0;0
15293;49674;498;0;0;0;0;.00nan;0;0
15293;158630;498;82;33;2;31;.939;3551000;0
15294;-1;504;18;8;4;4;.500;1187000;0
15294;-1;504;58;16;1;15;.938;2413000;0
15294;181910;497;0;0;0;0;.00nan;0;0
15294;142810;497;100;24;0;24;1.000;3600000;0
15295;178114;496;0;0;0;0;.00nan;0;0
15295;186234;496;60;23;2;21;.913;3544000;0
15295;49674;498;81;29;1;28;.966;3600000;0
15295;158630;498;0;0;0;0;.00nan;0;0
15296;-1;504;73;42;4;38;.905;3600000;0
15296;-1;504;0;0;0;0;.00nan;0;0
15296;-1;502;0;0;0;0;.00nan;0;0
15296;152624;502;95;22;0;22;1.000;3600000;0
15297;170547;500;85;26;1;25;.962;3600000;0
15297;181910;497;0;0;0;0;.00nan;0;0
15297;63707;500;0;0;0;0;.00nan;0;0
15297;142810;497;68;23;2;21;.913;3575000;0
15298;167480;503;0;0;0;0;.00nan;0;0
15298;170536;503;54;47;7;40;.851;3600000;0
15298;180188;4636;38;14;3;11;.786;3600000;0
15298;185413;4636;0;0;0;0;.00nan;0;0
15299;187813;499;50;21;3;18;.857;3900000;0
15299;6603;2591;88;43;3;40;.930;3900000;0
15299;174898;2591;0;0;0;0;.00nan;0;0
15299;175593;499;0;0;0;0;.00nan;0;0
15300;185442;495;100;31;0;31;1.000;3600000;0
15300;-1;505;0;0;0;0;.00nan;0;0
15300;43730;505;62;33;3;30;.909;3600000;0
15300;148508;495;0;0;0;0;.00nan;0;0
15301;178114;496;93;30;1;29;.967;3600000;0
15301;186234;496;0;0;0;0;.00nan;0;0
15301;49674;498;0;0;0;0;.00nan;0;0
15301;158630;498;89;38;2;36;.947;3547000;0
15302;-1;504;85;41;2;39;.951;3574000;0
15302;-1;504;0;0;0;0;.00nan;0;0
15302;-1;502;0;0;0;0;.00nan;0;0
15302;152624;502;92;31;1;30;.968;3600000;0
15303;170547;500;76;27;2;25;.926;3600000;0
15303;181910;497;0;0;0;0;.00nan;0;0
15303;63707;500;0;0;0;0;.00nan;0;0
15303;142810;497;93;44;3;41;.932;3600000;0
15304;167480;503;0;0;0;0;.00nan;0;0
15304;170536;503;89;45;2;43;.956;3600000;0
15304;180188;4636;0;0;0;0;.00nan;0;0
15304;185413;4636;71;18;1;17;.944;3600000;0
15305;187813;499;0;0;0;0;.00nan;0;0
15305;6603;2591;50;33;5;28;.848;3600000;0
15305;174898;2591;0;0;0;0;.00nan;0;0
15305;175593;499;58;29;4;25;.862;3600000;0
15306;185442;495;63;41;5;36;.878;3600000;0
15306;-1;505;0;0;0;0;.00nan;0;0
15306;43730;505;20;29;7;22;.759;3515000;0
15306;148508;495;0;0;0;0;.00nan;0;0
15307;181910;497;0;0;0;0;.00nan;0;0
15307;49674;498;83;26;1;25;.962;3900000;0
15307;142810;497;88;31;1;30;.968;3900000;0
15307;158630;498;0;0;0;0;.00nan;0;0
15308;167480;503;0;0;0;0;.00nan;0;0
15308;178114;496;98;27;0;27;1.000;3600000;0
15308;170536;503;64;39;5;34;.872;3600000;0
15308;186234;496;0;0;0;0;.00nan;0;0
15309;170547;500;100;22;0;22;1.000;3600000;0
15309;-1;504;0;0;0;0;.00nan;0;0
15309;-1;504;67;39;4;35;.897;3600000;0
15309;63707;500;0;0;0;0;.00nan;0;0
15310;-1;505;0;0;0;0;.00nan;0;0
15310;-1;502;0;0;0;0;.00nan;0;0
15310;43730;505;75;31;2;29;.935;3900000;0
15310;152624;502;80;31;2;29;.935;3900000;0
15311;6603;2591;0;0;0;0;.00nan;0;0
15311;174898;2591;66;39;4;35;.897;3570000;0
15311;185442;495;61;22;2;20;.909;3600000;0
15311;148508;495;0;0;0;0;.00nan;0;0
15312;187813;499;0;0;0;0;.00nan;0;0
15312;175593;499;41;37;6;31;.838;3600000;0
15312;180188;4636;0;0;0;0;.00nan;0;0
15312;185413;4636;62;23;2;21;.913;3600000;0
15313;181910;497;0;0;0;0;.00nan;0;0
15313;49674;498;0;0;0;0;.00nan;0;0
15313;142810;497;64;46;5;41;.891;3600000;0
15313;158630;498;65;19;1;18;.947;3600000;0
15314;167480;503;0;0;0;0;.00nan;0;0
15314;178114;496;37;18;4;14;.778;3600000;0
15314;170536;503;90;45;2;43;.956;3600000;0
15314;186234;496;0;0;0;0;.00nan;0;0
15315;170547;500;83;24;1;23;.958;3600000;0
15315;-1;504;65;42;4;38;.905;3600000;0
15315;-1;504;0;0;0;0;.00nan;0;0
15315;63707;500;0;0;0;0;.00nan;0;0
15316;-1;505;0;0;0;0;.00nan;0;0
15316;-1;502;0;0;0;0;.00nan;0;0
15316;43730;505;72;22;1;21;.955;3600000;0
15316;152624;502;77;44;4;40;.909;3600000;0
15317;6603;2591;68;35;4;31;.886;3520000;0
15317;174898;2591;0;0;0;0;.00nan;0;0
15317;185442;495;73;24;2;22;.917;3600000;0
15317;148508;495;0;0;0;0;.00nan;0;0
15318;187813;499;0;0;0;0;.00nan;0;0
15318;175593;499;65;42;5;37;.881;3600000;0
15318;180188;4636;100;25;0;25;1.000;3600000;0
15318;185413;4636;0;0;0;0;.00nan;0;0
15319;-1;504;89;52;4;48;.923;3534000;0
15319;-1;504;0;0;0;0;.00nan;0;0
15319;-1;505;0;0;0;0;.00nan;0;0
15319;43730;505;80;29;2;27;.931;3600000;0
15320;167480;503;0;0;0;0;.00nan;0;0
15320;170536;503;93;39;2;37;.949;3600000;0
15320;181910;497;0;0;0;0;.00nan;0;0
15320;142810;497;62;44;6;38;.864;3600000;0
15321;170547;500;49;28;4;24;.857;3591000;0
15321;49674;498;0;0;0;0;.00nan;0;0
15321;63707;500;0;0;0;0;.00nan;0;0
15321;158630;498;82;36;3;33;.917;3600000;0
15322;187813;499;0;0;0;0;.00nan;0;0
15322;178114;496;86;38;2;36;.947;3600000;0
15322;175593;499;52;20;3;17;.850;3545000;0
15322;186234;496;0;0;0;0;.00nan;0;0
15323;6603;2591;40;21;4;17;.810;2099000;0
15323;174898;2591;63;14;1;13;.929;1501000;0
15323;-1;502;0;0;0;0;.00nan;0;0
15323;152624;502;61;18;2;16;.889;3600000;0
15324;180188;4636;64;21;2;19;.905;3600000;0
15324;185413;4636;0;0;0;0;.00nan;0;0
15324;185442;495;43;31;5;26;.839;3600000;0
15324;148508;495;0;0;0;0;.00nan;0;0
15325;-1;504;81;37;2;35;.946;3850000;0
15325;-1;504;0;0;0;0;.00nan;0;0
15325;-1;505;0;0;0;0;.00nan;0;0
15325;43730;505;63;17;1;16;.941;3850000;0
15326;167480;503;0;0;0;0;.00nan;0;0
15326;170536;503;52;43;6;37;.860;3600000;0
15326;181910;497;0;0;0;0;.00nan;0;0
15326;142810;497;69;30;4;26;.867;3600000;0
15327;170547;500;52;22;3;19;.864;3582000;0
15327;49674;498;62;19;2;17;.895;3600000;0
15327;63707;500;0;0;0;0;.00nan;0;0
15327;158630;498;0;0;0;0;.00nan;0;0
15328;187813;499;0;0;0;0;.00nan;0;0
15328;178114;496;61;18;2;16;.889;3600000;0
15328;175593;499;71;31;4;27;.871;3517000;0
15328;186234;496;0;0;0;0;.00nan;0;0
15329;6603;2591;99;42;1;41;.976;3600000;0
15329;174898;2591;0;0;0;0;.00nan;0;0
15329;-1;502;88;29;2;27;.931;3564000;0
15329;152624;502;0;0;0;0;.00nan;0;0
15330;180188;4636;100;23;0;23;1.000;3600000;0
15330;185413;4636;0;0;0;0;.00nan;0;0
15330;185442;495;82;28;1;27;.964;3600000;0
15330;148508;495;0;0;0;0;.00nan;0;0
15331;6603;2591;62;39;4;35;.897;3600000;0
15331;174898;2591;0;0;0;0;.00nan;0;0
15331;185442;495;100;24;0;24;1.000;3600000;0
15331;148508;495;0;0;0;0;.00nan;0;0
15332;180188;4636;17;21;6;15;.714;2667000;0
15332;185413;4636;55;5;0;5;1.000;933000;0
15332;-1;502;0;0;0;0;.00nan;0;0
15332;152624;502;100;26;0;26;1.000;3600000;0
15333;178114;496;78;33;2;31;.939;3588000;0
15333;170547;500;80;24;1;23;.958;3600000;0
15333;186234;496;0;0;0;0;.00nan;0;0
15333;63707;500;0;0;0;0;.00nan;0;0
15334;167480;503;0;0;0;0;.00nan;0;0
15334;170536;503;58;42;5;37;.881;3531000;0
15334;-1;505;0;0;0;0;.00nan;0;0
15334;43730;505;44;20;3;17;.850;3600000;0
15335;187813;499;0;0;0;0;.00nan;0;0
15335;175593;499;72;39;3;36;.923;3600000;0
15335;181910;497;85;13;0;13;1.000;3600000;0
15335;142810;497;0;0;0;0;.00nan;0;0
15336;-1;504;0;0;0;0;.00nan;0;0
15336;-1;504;60;38;4;34;.895;3518000;0
15336;49674;498;0;0;0;0;.00nan;0;0
15336;158630;498;68;28;2;26;.929;3600000;0
15337;6603;2591;75;32;3;29;.906;3537000;0
15337;174898;2591;0;0;0;0;.00nan;0;0
15337;180188;4636;0;0;0;0;.00nan;0;0
15337;185413;4636;96;39;1;38;.974;3600000;0
15338;178114;496;100;27;0;27;1.000;3600000;0
15338;186234;496;0;0;0;0;.00nan;0;0
15338;-1;502;0;0;0;0;.00nan;0;0
15338;152624;502;58;18;3;15;.833;3600000;0
15339;170547;500;93;34;1;33;.971;3600000;0
15339;185442;495;63;29;3;26;.897;3541000;0
15339;63707;500;0;0;0;0;.00nan;0;0
15339;148508;495;0;0;0;0;.00nan;0;0
15340;167480;503;0;0;0;0;.00nan;0;0
15340;170536;503;69;32;3;29;.906;3600000;0
15340;49674;498;95;25;0;25;1.000;3600000;0
15340;158630;498;0;0;0;0;.00nan;0;0
15341;181910;497;61;34;4;30;.882;3600000;0
15341;-1;505;0;0;0;0;.00nan;0;0
15341;43730;505;68;20;1;19;.950;3600000;0
15341;142810;497;0;0;0;0;.00nan;0;0
15342;187813;499;0;0;0;0;.00nan;0;0
15342;175593;499;75;35;3;32;.914;3900000;0
15342;-1;504;78;38;3;35;.921;3900000;0
15342;-1;504;0;0;0;0;.00nan;0;0
15343;6603;2591;51;35;4;31;.886;3575000;0
15343;178114;496;54;23;3;20;.870;3600000;0
15343;174898;2591;0;0;0;0;.00nan;0;0
15343;186234;496;0;0;0;0;.00nan;0;0
15344;185442;495;81;22;1;21;.955;3600000;0
15344;-1;502;0;0;0;0;.00nan;0;0
15344;148508;495;0;0;0;0;.00nan;0;0
15344;152624;502;85;40;3;37;.925;3533000;0
15345;170547;500;55;25;3;22;.880;3568000;0
15345;180188;4636;69;26;2;24;.923;3600000;0
15345;185413;4636;0;0;0;0;.00nan;0;0
15345;63707;500;0;0;0;0;.00nan;0;0
15346;187813;499;0;0;0;0;.00nan;0;0
15346;167480;503;0;0;0;0;.00nan;0;0
15346;170536;503;81;39;3;36;.923;3600000;0
15346;175593;499;100;35;0;35;1.000;3600000;0
15347;181910;497;0;0;0;0;.00nan;0;0
15347;49674;498;100;41;2;39;.951;3900000;0
15347;142810;497;63;31;2;29;.935;3900000;0
15347;158630;498;0;0;0;0;.00nan;0;0
15348;-1;504;86;60;5;55;.917;3600000;0
15348;-1;504;0;0;0;0;.00nan;0;0
15348;-1;505;0;0;0;0;.00nan;0;0
15348;43730;505;82;26;1;25;.962;3600000;0
15349;180188;4636;68;33;3;30;.909;3600000;0
15349;185413;4636;0;0;0;0;.00nan;0;0
15349;181910;497;0;0;0;0;.00nan;0;0
15349;142810;497;60;38;4;34;.895;3600000;0
15350;-1;504;86;44;3;41;.932;3900000;0
15350;-1;504;0;0;0;0;.00nan;0;0
15350;185442;495;61;29;3;26;.897;3900000;0
15350;148508;495;0;0;0;0;.00nan;0;0
15351;167480;503;0;0;0;0;.00nan;0;0
15351;178114;496;0;0;0;0;.00nan;0;0
15351;170536;503;85;40;3;37;.925;3600000;0
15351;186234;496;84;16;0;16;1.000;3600000;0
15352;6603;2591;93;53;3;50;.943;3589000;0
15352;174898;2591;0;0;0;0;.00nan;0;0
15352;-1;505;0;0;0;0;.00nan;0;0
15352;43730;505;77;21;1;20;.952;3600000;0
15353;187813;499;0;0;0;0;.00nan;0;0
15353;175593;499;98;36;1;35;.972;3600000;0
15353;-1;502;0;0;0;0;.00nan;0;0
15353;152624;502;89;32;2;30;.938;3600000;0
15354;170547;500;36;33;6;27;.818;3588000;0
15354;49674;498;0;0;0;0;.00nan;0;0
15354;63707;500;0;0;0;0;.00nan;0;0
15354;158630;498;60;30;4;26;.867;3600000;0
15355;167480;503;0;0;0;0;.00nan;0;0
15355;170536;503;92;36;2;34;.944;3900000;0
15355;180188;4636;0;0;0;0;.00nan;0;0
15355;185413;4636;61;24;2;22;.917;3900000;0
15356;185442;495;75;24;2;22;.917;3600000;0
15356;181910;497;76;26;1;25;.962;2971000;0
15356;142810;497;25;5;3;2;.400;577000;0
15356;148508;495;0;0;0;0;.00nan;0;0
15357;178114;496;0;0;0;0;.00nan;0;0
15357;-1;504;90;41;2;39;.951;3600000;0
15357;-1;504;0;0;0;0;.00nan;0;0
15357;186234;496;91;29;1;28;.966;3600000;0
15358;170547;500;73;41;4;37;.902;3600000;0
15358;-1;505;72;21;1;20;.952;3600000;0
15358;43730;505;0;0;0;0;.00nan;0;0
15358;63707;500;0;0;0;0;.00nan;0;0
15359;187813;499;60;23;3;20;.870;3583000;0
15359;6603;2591;96;35;1;34;.971;3600000;0
15359;174898;2591;0;0;0;0;.00nan;0;0
15359;175593;499;0;0;0;0;.00nan;0;0
15360;-1;502;0;0;0;0;.00nan;0;0
15360;49674;498;96;32;1;31;.969;3900000;0
15360;152624;502;100;40;1;39;.975;3900000;0
15360;158630;498;0;0;0;0;.00nan;0;0
15361;-1;504;81;41;3;38;.927;3559000;0
15361;-1;504;0;0;0;0;.00nan;0;0
15361;180188;4636;79;24;1;23;.958;3600000;0
15361;185413;4636;0;0;0;0;.00nan;0;0
15362;167480;503;0;0;0;0;.00nan;0;0
15362;170536;503;77;48;5;43;.896;3600000;0
15362;185442;495;74;28;2;26;.929;3600000;0
15362;148508;495;0;0;0;0;.00nan;0;0
15363;178114;496;51;26;4;22;.846;3600000;0
15363;181910;497;0;0;0;0;.00nan;0;0
15363;186234;496;0;0;0;0;.00nan;0;0
15363;142810;497;96;27;0;27;1.000;3600000;0
15364;-1;505;0;0;0;0;.00nan;0;0
15364;-1;502;0;0;0;0;.00nan;0;0
15364;43730;505;39;34;5;29;.853;3600000;0
15364;152624;502;80;23;2;21;.913;3600000;0
15365;187813;499;0;0;0;0;.00nan;0;0
15365;170547;500;45;31;5;26;.839;3586000;0
15365;175593;499;63;32;4;28;.875;3600000;0
15365;63707;500;0;0;0;0;.00nan;0;0
15366;6603;2591;80;39;3;36;.923;3585000;0
15366;174898;2591;0;0;0;0;.00nan;0;0
15366;49674;498;76;25;2;23;.920;3600000;0
15366;158630;498;0;0;0;0;.00nan;0;0
15367;187813;499;0;0;0;0;.00nan;0;0
15367;175593;499;60;29;3;26;.897;3565000;0
15367;-1;505;0;0;0;0;.00nan;0;0
15367;43730;505;77;31;2;29;.935;3600000;0
15368;180188;4636;0;0;0;0;.00nan;0;0
15368;185413;4636;87;27;1;26;.963;3600000;0
15368;49674;498;50;34;5;29;.853;3600000;0
15368;158630;498;0;0;0;0;.00nan;0;0
15369;178114;496;0;0;0;0;.00nan;0;0
15369;185442;495;94;39;2;37;.949;3569000;0
15369;186234;496;100;30;0;30;1.000;3600000;0
15369;148508;495;0;0;0;0;.00nan;0;0
15370;167480;503;0;0;0;0;.00nan;0;0
15370;170536;503;82;35;3;32;.914;3569000;0
15370;170547;500;81;32;2;30;.938;3600000;0
15370;63707;500;0;0;0;0;.00nan;0;0
15371;6603;2591;94;21;0;21;1.000;3600000;0
15371;174898;2591;0;0;0;0;.00nan;0;0
15371;181910;497;0;0;0;0;.00nan;0;0
15371;142810;497;88;39;2;37;.949;3578000;0
15372;-1;504;93;47;4;43;.915;3600000;0
15372;-1;504;0;0;0;0;.00nan;0;0
15372;-1;502;0;0;0;0;.00nan;0;0
15372;152624;502;79;25;1;24;.960;3600000;0
15373;180188;4636;47;27;4;23;.852;3599000;0
15373;185413;4636;0;0;0;0;.00nan;0;0
15373;-1;505;0;0;0;0;.00nan;0;0
15373;43730;505;86;43;3;40;.930;3600000;0
15374;187813;499;0;0;0;0;.00nan;0;0
15374;175593;499;76;32;2;30;.938;3900000;0
15374;185442;495;80;27;2;25;.926;3900000;0
15374;148508;495;0;0;0;0;.00nan;0;0
15375;178114;496;0;0;0;0;.00nan;0;0
15375;186234;496;100;26;0;26;1.000;3600000;0
15375;49674;498;74;45;6;39;.867;3600000;0
15375;158630;498;0;0;0;0;.00nan;0;0
15376;6603;2591;89;51;2;49;.961;3563000;0
15376;174898;2591;0;0;0;0;.00nan;0;0
15376;-1;502;0;0;0;0;.00nan;0;0
15376;152624;502;100;22;0;22;1.000;3600000;0
15377;167480;503;0;0;0;0;.00nan;0;0
15377;170536;503;43;34;6;28;.824;3600000;0
15377;181910;497;0;0;0;0;.00nan;0;0
15377;142810;497;65;17;1;16;.941;3600000;0
15378;170547;500;0;0;0;0;.00nan;0;0
15378;-1;504;64;34;4;30;.882;3600000;0
15378;-1;504;0;0;0;0;.00nan;0;0
15378;63707;500;84;30;1;29;.967;3600000;0
15379;178114;496;0;0;0;0;.00nan;0;0
15379;-1;505;0;0;0;0;.00nan;0;0
15379;186234;496;63;48;5;43;.896;3579000;0
15379;43730;505;64;27;3;24;.889;3600000;0
15380;187813;499;0;0;0;0;.00nan;0;0
15380;175593;499;88;38;3;35;.921;3512000;0
15380;180188;4636;0;0;0;0;.00nan;0;0
15380;185413;4636;86;34;1;33;.971;3600000;0
15381;185442;495;53;23;3;20;.870;3600000;0
15381;49674;498;0;0;0;0;.00nan;0;0
15381;148508;495;0;0;0;0;.00nan;0;0
15381;158630;498;100;28;0;28;1.000;3600000;0
15382;6603;2591;0;0;0;0;.00nan;0;0
15382;170547;500;92;46;2;44;.957;3828000;0
15382;174898;2591;91;32;1;31;.969;3828000;0
15382;63707;500;0;0;0;0;.00nan;0;0
15383;181910;497;0;0;0;0;.00nan;0;0
15383;-1;502;0;0;0;0;.00nan;0;0
15383;142810;497;77;36;3;33;.917;3600000;0
15383;152624;502;64;22;2;20;.909;3600000;0
15384;167480;503;0;0;0;0;.00nan;0;0
15384;170536;503;90;29;1;28;.966;3600000;0
15384;-1;504;0;0;0;0;.00nan;0;0
15384;-1;504;65;18;2;16;.889;3564000;0
15385;-1;505;0;0;0;0;.00nan;0;0
15385;43730;505;70;25;1;24;.960;3900000;0
15385;49674;498;0;0;0;0;.00nan;0;0
15385;158630;498;80;25;1;24;.960;3900000;0
15386;180188;4636;0;0;0;0;.00nan;0;0
15386;185413;4636;51;22;3;19;.864;3600000;0
15386;185442;495;61;35;5;30;.857;3600000;0
15386;148508;495;0;0;0;0;.00nan;0;0
15387;187813;499;0;0;0;0;.00nan;0;0
15387;178114;496;61;32;4;28;.875;3900000;0
15387;175593;499;47;29;4;25;.862;3900000;0
15387;186234;496;0;0;0;0;.00nan;0;0
15388;167480;503;0;0;0;0;.00nan;0;0
15388;170536;503;57;44;6;38;.864;3600000;0
15388;-1;502;0;0;0;0;.00nan;0;0
15388;152624;502;65;17;1;16;.941;3600000;0
15389;170547;500;50;23;3;20;.870;3548000;0
15389;181910;497;0;0;0;0;.00nan;0;0
15389;63707;500;0;0;0;0;.00nan;0;0
15389;142810;497;82;33;2;31;.939;3600000;0
15390;6603;2591;91;34;1;33;.971;3600000;0
15390;174898;2591;0;0;0;0;.00nan;0;0
15390;-1;504;77;32;2;30;.938;3581000;0
15390;-1;504;0;0;0;0;.00nan;0;0
15391;187813;499;0;0;0;0;.00nan;0;0
15391;175593;499;79;31;2;29;.935;3600000;0
15391;49674;498;67;24;3;21;.875;3587000;0
15391;158630;498;0;0;0;0;.00nan;0;0
15392;185442;495;62;24;3;21;.875;3536000;0
15392;-1;505;0;0;0;0;.00nan;0;0
15392;43730;505;77;23;1;22;.957;3600000;0
15392;148508;495;0;0;0;0;.00nan;0;0
15393;178114;496;74;22;1;21;.955;3600000;0
15393;180188;4636;71;25;2;23;.920;3543000;0
15393;185413;4636;0;0;0;0;.00nan;0;0
15393;186234;496;0;0;0;0;.00nan;0;0
15394;6603;2591;66;25;2;23;.920;3540000;0
15394;167480;503;0;0;0;0;.00nan;0;0
15394;170536;503;100;46;0;46;1.000;3600000;0
15394;174898;2591;0;0;0;0;.00nan;0;0
15395;170547;500;100;39;1;38;.974;3600000;0
15395;-1;502;0;0;0;0;.00nan;0;0
15395;63707;500;0;0;0;0;.00nan;0;0
15395;152624;502;51;26;4;22;.846;3600000;0
15396;-1;504;65;26;2;24;.923;3900000;0
15396;-1;504;0;0;0;0;.00nan;0;0
15396;181910;497;0;0;0;0;.00nan;0;0
15396;142810;497;75;33;2;31;.939;3900000;0
15397;167480;503;0;0;0;0;.00nan;0;0
15397;170536;503;92;34;1;33;.971;3600000;0
15397;170547;500;83;27;2;25;.926;3600000;0
15397;63707;500;0;0;0;0;.00nan;0;0
15398;187813;499;56;16;2;14;.875;3600000;0
15398;175593;499;0;0;0;0;.00nan;0;0
15398;181910;497;0;0;0;0;.00nan;0;0
15398;142810;497;82;39;3;36;.923;3600000;0
15399;-1;504;70;41;4;37;.902;3600000;0
15399;-1;504;0;0;0;0;.00nan;0;0
15399;49674;498;71;19;1;18;.947;3600000;0
15399;158630;498;0;0;0;0;.00nan;0;0
15400;6603;2591;80;41;4;37;.902;3600000;0
15400;174898;2591;0;0;0;0;.00nan;0;0
15400;-1;505;0;0;0;0;.00nan;0;0
15400;43730;505;92;21;0;21;1.000;3600000;0
15401;180188;4636;60;30;3;27;.900;3900000;0
15401;185413;4636;0;0;0;0;.00nan;0;0
15401;-1;502;0;0;0;0;.00nan;0;0
15401;152624;502;88;35;3;32;.914;3900000;0
15402;178114;496;27;20;5;15;.750;3600000;0
15402;185442;495;97;23;0;23;1.000;3600000;0
15402;186234;496;0;0;0;0;.00nan;0;0
15402;148508;495;0;0;0;0;.00nan;0;0
15404;203533;495;0;0;0;0;.00nan;0;0
15404;197409;502;0;0;0;0;.00nan;0;0
15404;148508;495;58;33;4;29;.879;3544000;0
15404;152624;502;84;34;3;31;.912;3600000;0
15406;180188;4636;0;0;0;0;.00nan;0;0
15406;185413;4636;79;24;1;23;.958;3546000;0
15406;181910;497;0;0;0;0;.00nan;0;0
15406;142810;497;100;29;0;29;1.000;3600000;0
15408;6603;2591;0;0;0;0;.00nan;0;0
15408;178114;496;0;0;0;0;.00nan;0;0
15408;174898;2591;74;42;4;38;.905;3538000;0
15408;186234;496;71;29;2;27;.931;3600000;0
15410;-1;505;0;0;0;0;.00nan;0;0
15410;43730;505;71;25;2;23;.920;3600000;0
15410;49674;498;61;38;4;34;.895;3577000;0
15410;158630;498;0;0;0;0;.00nan;0;0
15412;187813;499;0;0;0;0;.00nan;0;0
15412;175593;499;70;35;3;32;.914;3581000;0
15412;-1;504;94;38;2;36;.947;3600000;0
15412;-1;504;0;0;0;0;.00nan;0;0
15414;167480;503;0;0;0;0;.00nan;0;0
15414;170536;503;92;39;1;38;.974;3900000;0
15414;170547;500;78;28;1;27;.964;3900000;0
15414;63707;500;0;0;0;0;.00nan;0;0
15416;180188;4636;58;19;2;17;.895;3600000;0
15416;185413;4636;0;0;0;0;.00nan;0;0
15416;181910;497;52;4;0;4;1.000;618000;0
15416;142810;497;26;26;6;20;.769;2982000;0
15418;187813;499;100;45;1;44;.978;3900000;0
15418;203533;495;84;27;1;26;.963;3900000;0
15418;175593;499;0;0;0;0;.00nan;0;0
15418;148508;495;0;0;0;0;.00nan;0;0
15420;-1;505;81;27;2;25;.926;3900000;0
15420;43730;505;0;0;0;0;.00nan;0;0
15420;197409;502;85;41;2;39;.951;3900000;0
15420;152624;502;0;0;0;0;.00nan;0;0
15422;6603;2591;60;26;3;23;.885;3600000;0
15422;178114;496;61;22;2;20;.909;3600000;0
15422;174898;2591;0;0;0;0;.00nan;0;0
15422;186234;496;0;0;0;0;.00nan;0;0
15424;-1;504;0;0;0;0;.00nan;0;0
15424;-1;504;53;35;4;31;.886;3600000;0
15424;49674;498;0;0;0;0;.00nan;0;0
15424;158630;498;67;25;2;23;.920;3600000;0
15426;167480;503;100;38;0;38;1.000;3600000;0
15426;170536;503;0;0;0;0;.00nan;0;0
15426;170547;500;0;0;0;0;.00nan;0;0
15426;63707;500;75;30;2;28;.933;3600000;0
15428;187813;499;0;0;0;0;.00nan;0;0
15428;175593;499;37;16;4;12;.750;3531000;0
15428;181910;497;87;42;2;40;.952;3600000;0
15428;142810;497;0;0;0;0;.00nan;0;0
15430;6603;2591;0;0;0;0;.00nan;0;0
15430;174898;2591;89;36;2;34;.944;3600000;0
15430;-1;505;0;0;0;0;.00nan;0;0
15430;43730;505;54;32;4;28;.875;3600000;0
15432;180188;4636;68;31;3;28;.903;3900000;0
15432;185413;4636;0;0;0;0;.00nan;0;0
15432;197409;502;0;0;0;0;.00nan;0;0
15432;152624;502;50;21;3;18;.857;3900000;0
15434;203533;495;0;0;0;0;.00nan;0;0
15434;167480;503;84;56;4;52;.929;3900000;0
15434;170536;503;0;0;0;0;.00nan;0;0
15434;148508;495;53;26;4;22;.846;3900000;0
15436;178114;496;0;0;0;0;.00nan;0;0
15436;170547;500;91;32;1;31;.969;3900000;0
15436;186234;496;79;29;1;28;.966;3900000;0
15436;63707;500;0;0;0;0;.00nan;0;0
15438;-1;504;77;25;1;24;.960;3600000;0
15438;-1;504;0;0;0;0;.00nan;0;0
15438;49674;498;0;0;0;0;.00nan;0;0
15438;158630;498;62;33;3;30;.909;3578000;0
15440;178114;496;56;37;5;32;.865;3600000;0
15440;186234;496;0;0;0;0;.00nan;0;0
15440;197409;502;82;18;0;18;1.000;3600000;0
15440;152624;502;0;0;0;0;.00nan;0;0
15442;6603;2591;92;42;2;40;.952;3600000;0
15442;170547;500;0;0;0;0;.00nan;0;0
15442;174898;2591;0;0;0;0;.00nan;0;0
15442;63707;500;40;23;4;19;.826;3567000;0
15444;167480;503;0;0;0;0;.00nan;0;0
15444;170536;503;90;40;2;38;.950;3575000;0
15444;-1;504;0;0;0;0;.00nan;0;0
15444;-1;504;99;27;0;27;1.000;3600000;0
15446;187813;499;64;28;3;25;.893;3552000;0
15446;175593;499;0;0;0;0;.00nan;0;0
15446;49674;498;79;27;1;26;.963;3600000;0
15446;158630;498;0;0;0;0;.00nan;0;0
15448;203533;495;76;29;2;27;.931;3600000;0
15448;181910;497;0;0;0;0;.00nan;0;0
15448;142810;497;90;42;3;39;.929;3548000;0
15448;148508;495;0;0;0;0;.00nan;0;0
15450;180188;4636;0;0;0;0;.00nan;0;0
15450;185413;4636;72;17;1;16;.941;3600000;0
15450;-1;505;60;36;5;31;.861;3600000;0
15450;43730;505;0;0;0;0;.00nan;0;0
15452;203533;495;0;0;0;0;.00nan;0;0
15452;-1;504;0;0;0;0;.00nan;0;0
15452;-1;504;65;37;4;33;.892;3600000;0
15452;148508;495;51;16;2;14;.875;3600000;0
15454;187813;499;0;0;0;0;.00nan;0;0
15454;167480;503;0;0;0;0;.00nan;0;0
15454;170536;503;83;54;5;49;.907;3600000;0
15454;175593;499;54;16;2;14;.875;3600000;0
15456;180188;4636;79;23;1;22;.957;3600000;0
15456;185413;4636;0;0;0;0;.00nan;0;0
15456;49674;498;0;0;0;0;.00nan;0;0
15456;158630;498;54;26;3;23;.885;3548000;0
15458;178114;496;0;0;0;0;.00nan;0;0
15458;-1;505;0;0;0;0;.00nan;0;0
15458;186234;496;77;39;3;36;.923;3565000;0
15458;43730;505;65;26;2;24;.923;3600000;0
15460;170547;500;91;38;1;37;.974;3600000;0
15460;181910;497;0;0;0;0;.00nan;0;0
15460;63707;500;0;0;0;0;.00nan;0;0
15460;142810;497;45;26;3;23;.885;3600000;0
15462;6603;2591;0;0;0;0;.00nan;0;0
15462;174898;2591;64;49;5;44;.898;3900000;0
15462;197409;502;28;18;5;13;.722;3900000;0
15462;152624;502;0;0;0;0;.00nan;0;0
15464;6603;2591;78;27;1;26;.963;3900000;0
15464;174898;2591;0;0;0;0;.00nan;0;0
15464;49674;498;0;0;0;0;.00nan;0;0
15464;158630;498;91;31;1;30;.968;3900000;0
15466;187813;499;0;0;0;0;.00nan;0;0
15466;203533;495;0;0;0;0;.00nan;0;0
15466;175593;499;64;39;4;35;.897;3600000;0
15466;148508;495;92;21;0;21;1.000;3600000;0
15468;170547;500;77;41;3;38;.927;3793000;0
15468;181910;497;0;0;0;0;.00nan;0;0
15468;63707;500;0;0;0;0;.00nan;0;0
15468;142810;497;70;26;2;24;.923;3793000;0
15470;178114;496;0;0;0;0;.00nan;0;0
15470;180188;4636;73;17;1;16;.941;3900000;0
15470;185413;4636;0;0;0;0;.00nan;0;0
15470;186234;496;96;35;1;34;.971;3900000;0
15472;-1;504;0;0;0;0;.00nan;0;0
15472;-1;504;88;52;5;47;.904;3600000;0
15472;197409;502;0;0;0;0;.00nan;0;0
15472;152624;502;62;16;1;15;.938;3600000;0
15474;167480;503;0;0;0;0;.00nan;0;0
15474;170536;503;71;27;2;25;.926;3527000;0
15474;-1;505;0;0;0;0;.00nan;0;0
15474;43730;505;100;35;0;35;1.000;3600000;0
15476;-1;504;99;33;1;32;.970;3600000;0
15476;-1;504;0;0;0;0;.00nan;0;0
15476;180188;4636;0;0;0;0;.00nan;0;0
15476;185413;4636;68;17;2;15;.882;3594000;0
15478;187813;499;73;29;2;27;.931;3558000;0
15478;175593;499;0;0;0;0;.00nan;0;0
15478;-1;505;0;0;0;0;.00nan;0;0
15478;43730;505;79;25;1;24;.960;3600000;0
15480;203533;495;0;0;0;0;.00nan;0;0
15480;167480;503;97;45;1;44;.978;3600000;0
15480;170536;503;0;0;0;0;.00nan;0;0
15480;148508;495;61;21;2;19;.905;3544000;0
15482;6603;2591;0;0;0;0;.00nan;0;0
15482;174898;2591;81;24;2;22;.917;3741000;0
15482;49674;498;93;48;3;45;.938;3741000;0
15482;158630;498;0;0;0;0;.00nan;0;0
15484;178114;496;67;28;3;25;.893;3600000;0
15484;170547;500;0;0;0;0;.00nan;0;0
15484;186234;496;0;0;0;0;.00nan;0;0
15484;63707;500;94;57;4;53;.930;3545000;0
15486;181910;497;83;35;3;32;.914;3600000;0
15486;197409;502;0;0;0;0;.00nan;0;0
15486;142810;497;0;0;0;0;.00nan;0;0
15486;152624;502;96;18;0;18;1.000;3600000;0
529;-1;505;0;0;0;0;.00nan;0;0
529;43730;505;67;25;2;23;.920;3562000;0
529;49674;498;63;17;1;16;.941;3600000;0
529;158630;498;0;0;0;0;.00nan;0;0
530;170547;500;100;31;0;31;1.000;3600000;0
530;185442;495;76;33;2;31;.939;3532000;0
530;63707;500;0;0;0;0;.00nan;0;0
530;148508;495;0;0;0;0;.00nan;0;0
531;-1;505;0;0;0;0;.00nan;0;0
531;43730;505;71;36;3;33;.917;3545000;0
531;49674;498;0;0;0;0;.00nan;0;0
531;158630;498;83;31;2;29;.935;3600000;0
532;170547;500;83;32;2;30;.938;3588000;0
532;185442;495;71;16;1;15;.938;3600000;0
532;63707;500;0;0;0;0;.00nan;0;0
532;148508;495;0;0;0;0;.00nan;0;0
533;-1;505;0;0;0;0;.00nan;0;0
533;43730;505;91;34;2;32;.941;3586000;0
533;49674;498;0;0;0;0;.00nan;0;0
533;158630;498;94;26;0;26;1.000;3600000;0
534;170547;500;67;39;4;35;.897;3584000;0
534;185442;495;68;24;2;22;.917;3600000;0
534;63707;500;0;0;0;0;.00nan;0;0
534;148508;495;0;0;0;0;.00nan;0;0
535;-1;505;0;0;0;0;.00nan;0;0
535;43730;505;100;25;0;25;1.000;3600000;0
535;49674;498;0;0;0;0;.00nan;0;0
535;158630;498;95;43;2;41;.953;3600000;0
536;170547;500;93;50;4;46;.920;5646000;0
536;185442;495;80;43;3;40;.930;5646000;0
536;63707;500;0;0;0;0;.00nan;0;0
536;148508;495;0;0;0;0;.00nan;0;0
751;-1;505;0;0;0;0;.00nan;0;0
751;43730;505;86;32;1;31;.969;3600000;0
751;49674;498;0;0;0;0;.00nan;0;0
751;158630;498;79;35;2;33;.943;3600000;0
752;170547;500;82;28;1;27;.964;3600000;0
752;185442;495;61;31;3;28;.903;3528000;0
752;63707;500;0;0;0;0;.00nan;0;0
752;148508;495;0;0;0;0;.00nan;0;0
860;-1;505;0;0;0;0;.00nan;0;0
860;43730;505;45;29;5;24;.828;3600000;0
860;49674;498;0;0;0;0;.00nan;0;0
860;158630;498;66;34;4;30;.882;3600000;0
861;170547;500;75;25;1;24;.960;3689000;0
861;185442;495;100;29;0;29;1.000;3689000;0
861;63707;500;0;0;0;0;.00nan;0;0
861;148508;495;0;0;0;0;.00nan;0;0
979;185442;495;59;34;5;29;.853;3600000;0
979;49674;498;0;0;0;0;.00nan;0;0
979;148508;495;0;0;0;0;.00nan;0;0
979;158630;498;94;37;1;36;.973;3600000;0
980;185442;495;85;28;1;27;.964;3600000;0
980;49674;498;0;0;0;0;.00nan;0;0
980;148508;495;0;0;0;0;.00nan;0;0
980;158630;498;43;34;5;29;.853;3600000;0
981;185442;495;43;29;5;24;.828;3560000;0
981;49674;498;0;0;0;0;.00nan;0;0
981;148508;495;0;0;0;0;.00nan;0;0
981;158630;498;76;37;4;33;.892;3600000;0
982;185442;495;48;22;3;19;.864;3521000;0
982;49674;498;0;0;0;0;.00nan;0;0
982;148508;495;0;0;0;0;.00nan;0;0
982;158630;498;100;33;1;32;.970;3600000;0
1222;185442;495;71;32;4;28;.875;3600000;0
1222;49674;498;0;0;0;0;.00nan;0;0
1222;148508;495;0;0;0;0;.00nan;0;0
1222;158630;498;100;39;1;38;.974;3600000;0
15487;6389;545;0;0;0;0;.00nan;0;0
15487;32347;543;94;54;1;53;.981;3900000;0
15487;67683;545;66;15;1;14;.933;3900000;0
15487;150345;543;0;0;0;0;.00nan;0;0
15488;6541;550;0;0;0;0;.00nan;0;0
15488;170042;550;81;25;1;24;.960;3600000;0
15488;71660;546;65;23;3;20;.870;3578000;0
15488;150187;546;0;0;0;0;.00nan;0;0
15489;483;2190;61;33;4;29;.879;3562000;0
15489;172303;2190;0;0;0;0;.00nan;0;0
15489;59933;551;0;0;0;0;.00nan;0;0
15489;86343;551;72;36;3;33;.917;3600000;0
15490;483;2190;83;15;0;15;1.000;3600000;0
15490;172303;2190;0;0;0;0;.00nan;0;0
15490;150203;547;65;42;5;37;.881;3600000;0
15490;158979;547;0;0;0;0;.00nan;0;0
15491;59933;551;0;0;0;0;.00nan;0;0
15491;71660;546;99;44;1;43;.977;3600000;0
15491;86343;551;46;14;2;12;.857;3587000;0
15491;150187;546;0;0;0;0;.00nan;0;0
15492;6389;545;57;27;3;24;.889;3586000;0
15492;49864;549;72;29;2;27;.931;3600000;0
15492;67683;545;0;0;0;0;.00nan;0;0
15492;72108;549;0;0;0;0;.00nan;0;0
15493;162979;548;38;39;6;33;.846;3102000;0
15493;32347;543;86;26;1;25;.962;3600000;0
15493;150345;543;0;0;0;0;.00nan;0;0
15493;160650;548;54;4;0;4;1.000;498000;0
15494;6541;550;0;0;0;0;.00nan;0;0
15494;170042;550;93;36;3;33;.917;3573000;0
15494;150203;547;71;24;2;22;.917;3600000;0
15494;158979;547;0;0;0;0;.00nan;0;0
15495;6389;545;87;29;1;28;.966;3600000;0
15495;67683;545;0;0;0;0;.00nan;0;0
15495;150203;547;0;0;0;0;.00nan;0;0
15495;158979;547;62;46;5;41;.891;3600000;0
15496;162979;548;64;32;3;29;.906;3600000;0
15496;59933;551;0;0;0;0;.00nan;0;0
15496;86343;551;43;21;4;17;.810;3600000;0
15496;160650;548;0;0;0;0;.00nan;0;0
15497;32347;543;52;30;4;26;.867;3600000;0
15497;71660;546;80;31;1;30;.968;3600000;0
15497;150187;546;0;0;0;0;.00nan;0;0
15497;150345;543;0;0;0;0;.00nan;0;0
15498;483;2190;83;24;1;23;.958;3676000;0
15498;6541;550;0;0;0;0;.00nan;0;0
15498;172303;2190;0;0;0;0;.00nan;0;0
15498;170042;550;85;31;2;29;.935;3676000;0
15499;6389;545;85;18;0;18;1.000;3600000;0
15499;67683;545;0;0;0;0;.00nan;0;0
15499;71660;546;24;31;6;25;.806;3297000;0
15499;150187;546;43;3;1;2;.667;303000;0
15500;483;2190;44;30;5;25;.833;3600000;0
15500;172303;2190;0;0;0;0;.00nan;0;0
15500;32347;543;100;39;1;38;.974;3600000;0
15500;150345;543;0;0;0;0;.00nan;0;0
15501;49864;549;67;27;3;24;.889;3900000;0
15501;59933;551;91;40;3;37;.925;3900000;0
15501;72108;549;0;0;0;0;.00nan;0;0
15501;86343;551;0;0;0;0;.00nan;0;0
15502;49864;549;52;24;3;21;.875;3573000;0
15502;71660;546;89;38;2;36;.947;3600000;0
15502;72108;549;0;0;0;0;.00nan;0;0
15502;150187;546;0;0;0;0;.00nan;0;0
15503;59933;551;0;0;0;0;.00nan;0;0
15503;86343;551;64;34;3;31;.912;3573000;0
15503;150203;547;63;28;2;26;.929;3600000;0
15503;158979;547;0;0;0;0;.00nan;0;0
15504;483;2190;49;33;5;28;.848;3586000;0
15504;6389;545;79;43;3;40;.930;3600000;0
15504;172303;2190;0;0;0;0;.00nan;0;0
15504;67683;545;0;0;0;0;.00nan;0;0
15505;162979;548;0;0;0;0;.00nan;0;0
15505;6541;550;63;33;4;29;.879;3611000;0
15505;170042;550;0;0;0;0;.00nan;0;0
15505;160650;548;53;23;3;20;.870;3611000;0
15506;147;543;0;0;0;0;.00nan;0;0
15506;32347;543;59;34;4;30;.882;3570000;0
15506;150203;547;0;0;0;0;.00nan;0;0
15506;158979;547;72;31;2;29;.935;3600000;0
15507;483;2190;55;31;3;28;.903;3900000;0
15507;172303;2190;0;0;0;0;.00nan;0;0
15507;49864;549;61;28;3;25;.893;3900000;0
15507;72108;549;0;0;0;0;.00nan;0;0
15508;162979;548;82;21;1;20;.952;3600000;0
15508;71660;546;74;35;3;32;.914;3538000;0
15508;150187;546;0;0;0;0;.00nan;0;0
15508;160650;548;0;0;0;0;.00nan;0;0
15509;6389;545;100;23;0;23;1.000;3600000;0
15509;6541;550;0;0;0;0;.00nan;0;0
15509;170042;550;88;48;4;44;.917;3600000;0
15509;67683;545;0;0;0;0;.00nan;0;0
15510;162979;548;81;41;3;38;.927;3537000;0
15510;6389;545;88;23;1;22;.957;3600000;0
15510;67683;545;0;0;0;0;.00nan;0;0
15510;160650;548;0;0;0;0;.00nan;0;0
15511;71660;546;100;42;2;40;.952;3600000;0
15511;150187;546;0;0;0;0;.00nan;0;0
15511;150203;547;31;28;5;23;.821;3600000;0
15511;158979;547;0;0;0;0;.00nan;0;0
15512;147;543;0;0;0;0;.00nan;0;0
15512;32347;543;85;39;3;36;.923;3600000;0
15512;59933;551;0;0;0;0;.00nan;0;0
15512;86343;551;100;30;0;30;1.000;3600000;0
15513;6541;550;0;0;0;0;.00nan;0;0
15513;170042;550;100;33;0;33;1.000;3600000;0
15513;49864;549;58;30;3;27;.900;3600000;0
15513;72108;549;0;0;0;0;.00nan;0;0
15514;162979;548;75;32;2;30;.938;3600000;0
15514;150203;547;0;0;0;0;.00nan;0;0
15514;158979;547;76;32;3;29;.906;3576000;0
15514;160650;548;0;0;0;0;.00nan;0;0
15515;147;543;0;0;0;0;.00nan;0;0
15515;32347;543;55;27;3;24;.889;3600000;0
15515;49864;549;0;0;0;0;.00nan;0;0
15515;72108;549;53;37;5;32;.865;3600000;0
15516;483;2190;80;25;1;24;.960;3600000;0
15516;172303;2190;0;0;0;0;.00nan;0;0
15516;71660;546;71;42;4;38;.905;3600000;0
15516;150187;546;0;0;0;0;.00nan;0;0
15517;49864;549;94;20;0;20;1.000;3600000;0
15517;72108;549;0;0;0;0;.00nan;0;0
15517;150203;547;82;31;1;30;.968;3587000;0
15517;158979;547;0;0;0;0;.00nan;0;0
15518;483;2190;63;23;2;21;.913;3600000;0
15518;162979;548;0;0;0;0;.00nan;0;0
15518;172303;2190;0;0;0;0;.00nan;0;0
15518;160650;548;74;37;3;34;.919;3591000;0
15519;6389;545;60;22;2;20;.909;3600000;0
15519;59933;551;0;0;0;0;.00nan;0;0
15519;67683;545;0;0;0;0;.00nan;0;0
15519;86343;551;53;36;5;31;.861;3600000;0
15520;147;543;0;0;0;0;.00nan;0;0
15520;6541;550;0;0;0;0;.00nan;0;0
15520;170042;550;70;42;4;38;.905;3600000;0
15520;32347;543;48;24;3;21;.875;3600000;0
15521;162979;548;56;35;5;30;.857;3900000;0
15521;49864;549;58;36;5;31;.861;3900000;0
15521;72108;549;0;0;0;0;.00nan;0;0
15521;160650;548;0;0;0;0;.00nan;0;0
15522;59933;551;0;0;0;0;.00nan;0;0
15522;86343;551;63;40;4;36;.900;3595000;0
15522;150203;547;59;28;3;25;.893;3600000;0
15522;158979;547;0;0;0;0;.00nan;0;0
15523;6389;545;67;18;1;17;.944;3600000;0
15523;6541;550;0;0;0;0;.00nan;0;0
15523;170042;550;43;23;4;19;.826;3600000;0
15523;67683;545;0;0;0;0;.00nan;0;0
15524;49864;549;0;0;0;0;.00nan;0;0
15524;59933;551;0;0;0;0;.00nan;0;0
15524;72108;549;98;25;0;25;1.000;3600000;0
15524;86343;551;58;24;2;22;.917;3526000;0
15525;162979;548;80;36;2;34;.944;3547000;0
15525;71660;546;87;27;1;26;.963;3600000;0
15525;150187;546;0;0;0;0;.00nan;0;0
15525;160650;548;0;0;0;0;.00nan;0;0
15526;147;543;0;0;0;0;.00nan;0;0
15526;483;2190;0;0;0;0;.00nan;0;0
15526;172303;2190;89;35;2;33;.943;3600000;0
15526;32347;543;67;30;3;27;.900;3566000;0
15527;71660;546;86;40;3;37;.925;3600000;0
15527;150187;546;0;0;0;0;.00nan;0;0
15527;150203;547;60;21;2;19;.905;3600000;0
15527;158979;547;0;0;0;0;.00nan;0;0
15528;162979;548;0;0;0;0;.00nan;0;0
15528;6541;550;0;0;0;0;.00nan;0;0
15528;170042;550;79;35;3;32;.914;3900000;0
15528;160650;548;72;36;3;33;.917;3900000;0
15529;6389;545;0;0;0;0;.00nan;0;0
15529;49864;549;0;0;0;0;.00nan;0;0
15529;67683;545;54;25;3;22;.880;3600000;0
15529;72108;549;56;46;7;39;.848;3600000;0
15530;483;2190;91;33;1;32;.970;3600000;0
15530;172303;2190;0;0;0;0;.00nan;0;0
15530;59933;551;31;27;6;21;.778;2554000;0
15530;86343;551;46;6;1;5;.833;1046000;0
15531;483;2190;26;24;6;18;.750;2686000;0
15531;172303;2190;54;11;1;10;.909;856000;0
15531;49864;549;42;37;6;31;.838;3136000;0
15531;72108;549;65;6;0;6;1.000;464000;0
15532;6541;550;100;23;0;23;1.000;3600000;0
15532;170042;550;0;0;0;0;.00nan;0;0
15532;59933;551;0;0;0;0;.00nan;0;0
15532;86343;551;54;23;3;20;.870;3600000;0
15533;147;543;0;0;0;0;.00nan;0;0
15533;162979;548;100;33;0;33;1.000;3600000;0
15533;32347;543;55;34;5;29;.853;3600000;0
15533;160650;548;0;0;0;0;.00nan;0;0
15534;483;2190;90;21;0;21;1.000;3600000;0
15534;172303;2190;0;0;0;0;.00nan;0;0
15534;71660;546;44;47;7;40;.851;3600000;0
15534;150187;546;0;0;0;0;.00nan;0;0
15535;6389;545;93;34;1;33;.971;3600000;0
15535;67683;545;0;0;0;0;.00nan;0;0
15535;150203;547;81;45;3;42;.933;3514000;0
15535;158979;547;0;0;0;0;.00nan;0;0
15536;6541;550;49;30;4;26;.867;3600000;0
15536;170042;550;0;0;0;0;.00nan;0;0
15536;150203;547;50;11;2;9;.818;1109000;0
15536;158979;547;35;31;6;25;.806;2491000;0
15537;49864;549;74;25;2;23;.920;3600000;0
15537;71660;546;74;36;4;32;.889;3533000;0
15537;72108;549;0;0;0;0;.00nan;0;0
15537;150187;546;0;0;0;0;.00nan;0;0
15538;147;543;34;28;6;22;.786;3586000;0
15538;6389;545;88;45;3;42;.933;3600000;0
15538;32347;543;0;0;0;0;.00nan;0;0
15538;67683;545;0;0;0;0;.00nan;0;0
15539;483;2190;70;25;2;23;.920;3600000;0
15539;162979;548;96;42;3;39;.929;3583000;0
15539;172303;2190;0;0;0;0;.00nan;0;0
15539;160650;548;0;0;0;0;.00nan;0;0
15540;6541;550;0;0;0;0;.00nan;0;0
15540;170042;550;74;35;3;32;.914;3589000;0
15540;59933;551;0;0;0;0;.00nan;0;0
15540;86343;551;53;17;2;15;.882;3600000;0
15541;162979;548;83;28;2;26;.929;3542000;0
15541;150203;547;90;44;1;43;.977;3600000;0
15541;158979;547;0;0;0;0;.00nan;0;0
15541;160650;548;0;0;0;0;.00nan;0;0
15542;147;543;0;0;0;0;.00nan;0;0
15542;32347;543;81;32;2;30;.938;3600000;0
15542;71660;546;72;35;3;32;.914;3564000;0
15542;150187;546;0;0;0;0;.00nan;0;0
15543;483;2190;71;37;4;33;.892;3852000;0
15543;6389;545;51;32;5;27;.844;3852000;0
15543;172303;2190;0;0;0;0;.00nan;0;0
15543;67683;545;0;0;0;0;.00nan;0;0
15544;162979;548;54;27;4;23;.852;3600000;0
15544;59933;551;0;0;0;0;.00nan;0;0
15544;86343;551;91;30;1;29;.967;3600000;0
15544;160650;548;0;0;0;0;.00nan;0;0
15545;147;543;0;0;0;0;.00nan;0;0
15545;6541;550;0;0;0;0;.00nan;0;0
15545;170042;550;73;42;4;38;.905;3900000;0
15545;32347;543;68;41;4;37;.902;3900000;0
15546;49864;549;100;44;0;44;1.000;3600000;0
15546;72108;549;0;0;0;0;.00nan;0;0
15546;150203;547;82;26;1;25;.962;3547000;0
15546;158979;547;0;0;0;0;.00nan;0;0
15547;483;2190;74;29;2;27;.931;3600000;0
15547;172303;2190;0;0;0;0;.00nan;0;0
15547;150203;547;54;32;4;28;.875;3600000;0
15547;158979;547;0;0;0;0;.00nan;0;0
15548;6541;550;0;0;0;0;.00nan;0;0
15548;170042;550;89;33;2;31;.939;3600000;0
15548;49864;549;51;31;4;27;.871;3513000;0
15548;72108;549;0;0;0;0;.00nan;0;0
15549;6389;545;100;25;0;25;1.000;3600000;0
15549;67683;545;0;0;0;0;.00nan;0;0
15549;71660;546;0;0;0;0;.00nan;0;0
15549;150187;546;61;39;4;35;.897;3600000;0
15550;147;543;70;20;1;19;.950;3600000;0
15550;32347;543;0;0;0;0;.00nan;0;0
15550;59933;551;0;0;0;0;.00nan;0;0
15550;86343;551;90;49;3;46;.939;3564000;0
15551;162979;548;69;23;2;21;.913;3600000;0
15551;49864;549;0;0;0;0;.00nan;0;0
15551;72108;549;59;28;3;25;.893;3577000;0
15551;160650;548;0;0;0;0;.00nan;0;0
15552;6389;545;66;39;4;35;.897;3819000;0
15552;59933;551;78;41;3;38;.927;3819000;0
15552;67683;545;0;0;0;0;.00nan;0;0
15552;86343;551;0;0;0;0;.00nan;0;0
15553;6541;550;0;0;0;0;.00nan;0;0
15553;170042;550;64;25;3;22;.880;3900000;0
15553;71660;546;61;26;3;23;.885;3900000;0
15553;150187;546;0;0;0;0;.00nan;0;0
15554;147;543;85;29;1;28;.966;3600000;0
15554;32347;543;0;0;0;0;.00nan;0;0
15554;150203;547;0;0;0;0;.00nan;0;0
15554;158979;547;24;35;7;28;.800;3600000;0
15555;162979;548;94;50;2;48;.960;3561000;0
15555;6389;545;82;22;1;21;.955;3600000;0
15555;67683;545;0;0;0;0;.00nan;0;0
15555;160650;548;0;0;0;0;.00nan;0;0
15556;59933;551;0;0;0;0;.00nan;0;0
15556;71660;546;42;32;5;27;.844;3208000;0
15556;86343;551;71;19;1;18;.947;3600000;0
15556;150187;546;47;8;1;7;.875;392000;0
15557;147;543;0;0;0;0;.00nan;0;0
15557;32347;543;88;32;2;30;.938;3600000;0
15557;49864;549;86;44;3;41;.932;3568000;0
15557;72108;549;0;0;0;0;.00nan;0;0
15558;483;2190;76;25;2;23;.920;3556000;0
15558;6541;550;0;0;0;0;.00nan;0;0
15558;172303;2190;0;0;0;0;.00nan;0;0
15558;170042;550;89;32;1;31;.969;3600000;0
15559;162979;548;90;34;1;33;.971;3900000;0
15559;6389;545;77;18;1;17;.944;3900000;0
15559;67683;545;0;0;0;0;.00nan;0;0
15559;160650;548;0;0;0;0;.00nan;0;0
15560;483;2190;73;31;3;28;.903;3885000;0
15560;6541;550;0;0;0;0;.00nan;0;0
15560;172303;2190;0;0;0;0;.00nan;0;0
15560;170042;550;99;43;3;40;.930;3900000;0
15561;147;543;75;28;2;26;.929;3600000;0
15561;32347;543;0;0;0;0;.00nan;0;0
15561;49864;549;53;38;5;33;.868;3600000;0
15561;72108;549;0;0;0;0;.00nan;0;0
15562;59933;551;0;0;0;0;.00nan;0;0
15562;71660;546;74;46;5;41;.891;3600000;0
15562;86343;551;91;33;1;32;.970;3600000;0
15562;150187;546;0;0;0;0;.00nan;0;0
15563;162979;548;100;28;0;28;1.000;3600000;0
15563;49864;549;60;42;4;38;.905;3600000;0
15563;72108;549;0;0;0;0;.00nan;0;0
15563;160650;548;0;0;0;0;.00nan;0;0
15564;147;543;52;28;4;24;.857;3544000;0
15564;32347;543;0;0;0;0;.00nan;0;0
15564;150203;547;58;31;3;28;.903;3600000;0
15564;158979;547;0;0;0;0;.00nan;0;0
15565;483;2190;81;24;2;22;.917;3900000;0
15565;172303;2190;0;0;0;0;.00nan;0;0
15565;71660;546;96;45;2;43;.956;3900000;0
15565;150187;546;0;0;0;0;.00nan;0;0
15566;6541;550;0;0;0;0;.00nan;0;0
15566;170042;550;92;29;1;28;.966;3600000;0
15566;59933;551;51;3;0;3;1.000;806000;0
15566;86343;551;23;27;6;21;.778;2794000;0
15567;483;2190;91;40;3;37;.925;3900000;0
15567;172303;2190;0;0;0;0;.00nan;0;0
15567;49864;549;65;25;3;22;.880;3900000;0
15567;72108;549;0;0;0;0;.00nan;0;0
15568;6389;545;76;38;3;35;.921;3548000;0
15568;67683;545;0;0;0;0;.00nan;0;0
15568;150203;547;0;0;0;0;.00nan;0;0
15568;158979;547;87;37;2;35;.946;3600000;0
15569;147;543;39;10;3;7;.700;1462000;0
15569;32347;543;18;17;6;11;.647;2138000;0
15569;59933;551;0;0;0;0;.00nan;0;0
15569;86343;551;85;31;1;30;.968;3600000;0
15570;49864;549;38;27;5;22;.815;3590000;0
15570;71660;546;74;29;3;26;.897;3600000;0
15570;72108;549;0;0;0;0;.00nan;0;0
15570;150187;546;0;0;0;0;.00nan;0;0
15571;59933;551;0;0;0;0;.00nan;0;0
15571;86343;551;64;28;3;25;.893;3574000;0
15571;150203;547;0;0;0;0;.00nan;0;0
15571;158979;547;97;36;1;35;.972;3600000;0
15572;483;2190;75;29;2;27;.931;3900000;0
15572;162979;548;75;24;2;22;.917;3900000;0
15572;172303;2190;0;0;0;0;.00nan;0;0
15572;160650;548;0;0;0;0;.00nan;0;0
15573;6389;545;81;27;2;25;.926;3600000;0
15573;6541;550;0;0;0;0;.00nan;0;0
15573;170042;550;97;44;3;41;.932;3594000;0
15573;67683;545;0;0;0;0;.00nan;0;0
15574;147;543;91;35;1;34;.971;3600000;0
15574;162979;548;78;51;6;45;.882;3600000;0
15574;32347;543;0;0;0;0;.00nan;0;0
15574;160650;548;0;0;0;0;.00nan;0;0
15575;483;2190;96;34;1;33;.971;3600000;0
15575;6389;545;73;34;3;31;.912;3573000;0
15575;172303;2190;0;0;0;0;.00nan;0;0
15575;67683;545;0;0;0;0;.00nan;0;0
15576;6541;550;0;0;0;0;.00nan;0;0
15576;170042;550;59;23;3;20;.870;3519000;0
15576;150203;547;100;33;1;32;.970;3600000;0
15576;158979;547;0;0;0;0;.00nan;0;0
15577;49864;549;68;41;3;38;.927;3600000;0
15577;59933;551;76;26;1;25;.962;3600000;0
15577;72108;549;0;0;0;0;.00nan;0;0
15577;86343;551;0;0;0;0;.00nan;0;0
15578;162979;548;0;0;0;0;.00nan;0;0
15578;59933;551;0;0;0;0;.00nan;0;0
15578;86343;551;62;22;2;20;.909;3900000;0
15578;160650;548;84;38;2;36;.947;3900000;0
15579;483;2190;71;39;4;35;.897;3552000;0
15579;172303;2190;0;0;0;0;.00nan;0;0
15579;150203;547;0;0;0;0;.00nan;0;0
15579;158979;547;70;32;3;29;.906;3600000;0
15580;6389;545;87;15;0;15;1.000;3600000;0
15580;67683;545;0;0;0;0;.00nan;0;0
15580;71660;546;98;54;3;51;.944;3600000;0
15580;150187;546;0;0;0;0;.00nan;0;0
15581;6541;550;70;27;2;25;.926;3600000;0
15581;170042;550;0;0;0;0;.00nan;0;0
15581;49864;549;84;31;1;30;.968;3600000;0
15581;72108;549;0;0;0;0;.00nan;0;0
15582;6389;545;53;14;2;12;.857;3600000;0
15582;49864;549;0;0;0;0;.00nan;0;0
15582;67683;545;0;0;0;0;.00nan;0;0
15582;72108;549;62;40;4;36;.900;3544000;0
15583;71660;546;80;42;4;38;.905;3600000;0
15583;150187;546;0;0;0;0;.00nan;0;0
15583;150203;547;77;25;1;24;.960;3600000;0
15583;158979;547;0;0;0;0;.00nan;0;0
15584;147;543;0;0;0;0;.00nan;0;0
15584;6541;550;0;0;0;0;.00nan;0;0
15584;170042;550;98;44;2;42;.955;3600000;0
15584;32347;543;80;37;3;34;.919;3544000;0
15585;483;2190;56;23;3;20;.870;3600000;0
15585;172303;2190;0;0;0;0;.00nan;0;0
15585;59933;551;0;0;0;0;.00nan;0;0
15585;86343;551;56;34;4;30;.882;3600000;0
15586;162979;548;37;20;5;15;.750;3575000;0
15586;6541;550;0;0;0;0;.00nan;0;0
15586;170042;550;82;36;3;33;.917;3600000;0
15586;160650;548;0;0;0;0;.00nan;0;0
15587;59933;551;58;20;2;18;.900;3600000;0
15587;71660;546;63;36;4;32;.889;3548000;0
15587;86343;551;0;0;0;0;.00nan;0;0
15587;150187;546;0;0;0;0;.00nan;0;0
15588;483;2190;82;14;0;14;1.000;3600000;0
15588;6541;550;0;0;0;0;.00nan;0;0
15588;172303;2190;0;0;0;0;.00nan;0;0
15588;170042;550;98;47;3;44;.936;3600000;0
15589;162979;548;30;26;6;20;.769;1959000;0
15589;150203;547;49;38;5;33;.868;3600000;0
15589;158979;547;0;0;0;0;.00nan;0;0
15589;160650;548;56;14;1;13;.929;1595000;0
15590;147;543;79;34;3;31;.912;3554000;0
15590;6389;545;73;21;1;20;.952;3600000;0
15590;32347;543;0;0;0;0;.00nan;0;0
15590;67683;545;0;0;0;0;.00nan;0;0
15591;6541;550;0;0;0;0;.00nan;0;0
15591;170042;550;68;22;2;20;.909;3600000;0
15591;71660;546;89;23;1;22;.957;3600000;0
15591;150187;546;0;0;0;0;.00nan;0;0
15592;49864;549;91;44;3;41;.932;3600000;0
15592;72108;549;0;0;0;0;.00nan;0;0
15592;150203;547;0;0;0;0;.00nan;0;0
15592;158979;547;75;23;1;22;.957;3600000;0
15593;162979;548;0;0;0;0;.00nan;0;0
15593;71660;546;39;34;6;28;.824;2586000;0
15593;150187;546;47;14;2;12;.857;1014000;0
15593;160650;548;65;31;3;28;.903;3600000;0
15594;6389;545;77;25;1;24;.960;3600000;0
15594;59933;551;0;0;0;0;.00nan;0;0
15594;67683;545;0;0;0;0;.00nan;0;0
15594;86343;551;86;39;3;36;.923;3526000;0
15595;147;543;80;37;3;34;.919;3577000;0
15595;483;2190;92;32;2;30;.938;3600000;0
15595;172303;2190;0;0;0;0;.00nan;0;0
15595;32347;543;0;0;0;0;.00nan;0;0
15596;59933;551;44;6;1;5;.833;1548000;0
15596;71660;546;0;0;0;0;.00nan;0;0
15596;86343;551;7;16;6;10;.625;2052000;0
15596;150187;546;81;39;3;36;.923;3600000;0
15597;6389;545;69;30;3;27;.900;3600000;0
15597;6541;550;71;21;1;20;.952;3231000;0
15597;170042;550;25;6;3;3;.500;325000;0
15597;67683;545;0;0;0;0;.00nan;0;0
15598;483;2190;87;33;1;32;.970;3600000;0
15598;162979;548;0;0;0;0;.00nan;0;0
15598;172303;2190;0;0;0;0;.00nan;0;0
15598;160650;548;77;41;3;38;.927;3544000;0
15599;6541;550;0;0;0;0;.00nan;0;0
15599;170042;550;93;39;2;37;.949;3555000;0
15599;59933;551;0;0;0;0;.00nan;0;0
15599;86343;551;67;18;1;17;.944;3600000;0
15600;6389;545;0;0;0;0;.00nan;0;0
15600;49864;549;70;28;2;26;.929;3557000;0
15600;67683;545;99;26;0;26;1.000;3600000;0
15600;72108;549;0;0;0;0;.00nan;0;0
15601;49864;549;67;22;2;20;.909;3600000;0
15601;71660;546;60;39;4;35;.897;3518000;0
15601;72108;549;0;0;0;0;.00nan;0;0
15601;150187;546;0;0;0;0;.00nan;0;0
15602;483;2190;85;30;1;29;.967;3543000;0
15602;6389;545;0;0;0;0;.00nan;0;0
15602;172303;2190;0;0;0;0;.00nan;0;0
15602;67683;545;100;27;0;27;1.000;3600000;0
15603;59933;551;0;0;0;0;.00nan;0;0
15603;86343;551;88;31;2;29;.935;3600000;0
15603;150203;547;61;30;3;27;.900;3565000;0
15603;158979;547;0;0;0;0;.00nan;0;0
15604;147;543;44;17;3;14;.824;2915000;0
15604;6541;550;0;0;0;0;.00nan;0;0
15604;170042;550;72;35;3;32;.914;3600000;0
15604;32347;543;19;8;4;4;.500;685000;0
15605;162979;548;98;33;2;31;.939;3600000;0
15605;6541;550;0;0;0;0;.00nan;0;0
15605;170042;550;80;37;4;33;.892;3524000;0
15605;160650;548;0;0;0;0;.00nan;0;0
15606;147;543;72;34;3;31;.912;3737000;0
15606;32347;543;0;0;0;0;.00nan;0;0
15606;49864;549;82;42;4;38;.905;3737000;0
15606;72108;549;0;0;0;0;.00nan;0;0
15607;49864;549;100;43;1;42;.977;3900000;0
15607;72108;549;0;0;0;0;.00nan;0;0
15607;150203;547;92;35;1;34;.971;3900000;0
15607;158979;547;0;0;0;0;.00nan;0;0
15608;49864;549;0;0;0;0;.00nan;0;0
15608;59933;551;0;0;0;0;.00nan;0;0
15608;72108;549;95;20;0;20;1.000;3600000;0
15608;86343;551;78;43;4;39;.907;3600000;0
15609;147;543;60;23;3;20;.870;3600000;0
15609;162979;548;52;42;6;36;.857;3600000;0
15609;32347;543;0;0;0;0;.00nan;0;0
15609;160650;548;0;0;0;0;.00nan;0;0
15610;6389;545;0;0;0;0;.00nan;0;0
15610;67683;545;65;25;3;22;.880;3600000;0
15610;71660;546;56;43;5;38;.884;3582000;0
15610;150187;546;0;0;0;0;.00nan;0;0
15611;483;2190;70;26;3;23;.885;3900000;0
15611;172303;2190;0;0;0;0;.00nan;0;0
15611;150203;547;98;54;3;51;.944;3900000;0
15611;158979;547;0;0;0;0;.00nan;0;0
15612;147;543;100;25;0;25;1.000;3600000;0
15612;162979;548;79;25;1;24;.960;3590000;0
15612;32347;543;0;0;0;0;.00nan;0;0
15612;160650;548;0;0;0;0;.00nan;0;0
15613;71660;546;81;30;2;28;.933;3600000;0
15613;150187;546;0;0;0;0;.00nan;0;0
15613;150203;547;0;0;0;0;.00nan;0;0
15613;158979;547;52;31;5;26;.839;3600000;0
15614;147;543;97;42;2;40;.952;3600000;0
15614;483;2190;89;28;1;27;.964;3600000;0
15614;172303;2190;0;0;0;0;.00nan;0;0
15614;32347;543;0;0;0;0;.00nan;0;0
15615;162979;548;0;0;0;0;.00nan;0;0
15615;6389;545;43;34;5;29;.853;3587000;0
15615;67683;545;0;0;0;0;.00nan;0;0
15615;160650;548;69;35;3;32;.914;3600000;0
15616;147;543;96;44;3;41;.932;3900000;0
15616;32347;543;0;0;0;0;.00nan;0;0
15616;150203;547;65;33;3;30;.909;3900000;0
15616;158979;547;0;0;0;0;.00nan;0;0
15617;162979;548;0;0;0;0;.00nan;0;0
15617;71660;546;63;41;5;36;.878;3854000;0
15617;150187;546;0;0;0;0;.00nan;0;0
15617;160650;548;60;36;5;31;.861;3900000;0
15618;6389;545;77;21;1;20;.952;3600000;0
15618;59933;551;0;0;0;0;.00nan;0;0
15618;67683;545;0;0;0;0;.00nan;0;0
15618;86343;551;71;37;4;33;.892;3600000;0
15619;483;2190;87;28;2;26;.929;3600000;0
15619;6541;550;50;28;3;25;.893;3600000;0
15619;172303;2190;0;0;0;0;.00nan;0;0
15619;170042;550;0;0;0;0;.00nan;0;0
15620;6541;550;0;0;0;0;.00nan;0;0
15620;170042;550;89;30;1;29;.967;3900000;0
15620;49864;549;0;0;0;0;.00nan;0;0
15620;72108;549;94;37;1;36;.973;3900000;0
15621;162979;548;57;31;4;27;.871;3900000;0
15621;150203;547;61;31;4;27;.871;3900000;0
15621;158979;547;0;0;0;0;.00nan;0;0
15621;160650;548;0;0;0;0;.00nan;0;0
15622;147;543;94;43;2;41;.953;3900000;0
15622;6389;545;100;33;2;31;.939;3900000;0
15622;32347;543;0;0;0;0;.00nan;0;0
15622;67683;545;0;0;0;0;.00nan;0;0
15623;483;2190;77;27;2;25;.926;3600000;0
15623;172303;2190;0;0;0;0;.00nan;0;0
15623;59933;551;58;30;4;26;.867;3582000;0
15623;86343;551;0;0;0;0;.00nan;0;0
15624;162979;548;69;29;3;26;.897;3557000;0
15624;49864;549;100;41;2;39;.951;3600000;0
15624;72108;549;0;0;0;0;.00nan;0;0
15624;160650;548;0;0;0;0;.00nan;0;0
15625;6541;550;0;0;0;0;.00nan;0;0
15625;170042;550;97;52;3;49;.942;3600000;0
15625;150203;547;89;16;0;16;1.000;3600000;0
15625;158979;547;0;0;0;0;.00nan;0;0
15626;147;543;0;0;0;0;.00nan;0;0
15626;32347;543;31;17;5;12;.706;3625000;0
15626;71660;546;67;53;6;47;.887;3625000;0
15626;150187;546;0;0;0;0;.00nan;0;0
15627;483;2190;0;0;0;0;.00nan;0;0
15627;172303;2190;67;34;3;31;.912;3900000;0
15627;59933;551;0;0;0;0;.00nan;0;0
15627;86343;551;67;29;3;26;.897;3900000;0
15628;162979;548;0;0;0;0;.00nan;0;0
15628;49864;549;0;0;0;0;.00nan;0;0
15628;72108;549;76;37;3;34;.919;3900000;0
15628;160650;548;68;30;3;27;.900;3900000;0
15629;6389;545;76;23;2;21;.913;3900000;0
15629;59933;551;77;36;2;34;.944;3900000;0
15629;67683;545;0;0;0;0;.00nan;0;0
15629;86343;551;0;0;0;0;.00nan;0;0
15630;147;543;68;28;2;26;.929;3600000;0
15630;32347;543;0;0;0;0;.00nan;0;0
15630;71660;546;0;0;0;0;.00nan;0;0
15630;150187;546;70;32;3;29;.906;3600000;0
15631;6541;550;62;46;6;40;.870;3575000;0
15631;170042;550;0;0;0;0;.00nan;0;0
15631;150203;547;58;34;4;30;.882;3600000;0
15631;158979;547;0;0;0;0;.00nan;0;0
15632;147;543;0;0;0;0;.00nan;0;0
15632;32347;543;77;23;1;22;.957;3600000;0
15632;59933;551;0;0;0;0;.00nan;0;0
15632;86343;551;30;40;7;33;.825;3600000;0
15633;162979;548;43;23;4;19;.826;766000;0
15633;59933;551;0;0;0;0;.00nan;0;0
15633;86343;551;68;23;2;21;.913;3600000;0
15633;160650;548;60;24;2;22;.917;2834000;0
15634;6389;545;0;0;0;0;.00nan;0;0
15634;67683;545;100;28;0;28;1.000;3600000;0
15634;150203;547;66;40;4;36;.900;3600000;0
15634;158979;547;0;0;0;0;.00nan;0;0
15635;483;2190;63;25;2;23;.920;3600000;0
15635;172303;2190;0;0;0;0;.00nan;0;0
15635;49864;549;44;33;5;28;.848;3600000;0
15635;72108;549;0;0;0;0;.00nan;0;0
15636;6541;550;0;0;0;0;.00nan;0;0
15636;170042;550;87;31;1;30;.968;3600000;0
15636;71660;546;74;40;4;36;.900;3600000;0
15636;150187;546;0;0;0;0;.00nan;0;0
15637;483;2190;62;28;3;25;.893;3600000;0
15637;172303;2190;0;0;0;0;.00nan;0;0
15637;49864;549;26;21;5;16;.762;2364000;0
15637;72108;549;64;14;1;13;.929;1236000;0
15638;147;543;84;27;1;26;.963;3600000;0
15638;32347;543;0;0;0;0;.00nan;0;0
15638;71660;546;58;26;3;23;.885;3545000;0
15638;150187;546;0;0;0;0;.00nan;0;0
15639;162979;548;0;0;0;0;.00nan;0;0
15639;150203;547;0;0;0;0;.00nan;0;0
15639;158979;547;56;34;4;30;.882;3533000;0
15639;160650;548;88;34;2;32;.941;3600000;0
15640;6389;545;0;0;0;0;.00nan;0;0
15640;49864;549;100;44;1;43;.977;3600000;0
15640;67683;545;68;35;4;31;.886;3600000;0
15640;72108;549;0;0;0;0;.00nan;0;0
15641;71660;546;100;46;1;45;.978;3600000;0
15641;150187;546;0;0;0;0;.00nan;0;0
15641;150203;547;0;0;0;0;.00nan;0;0
15641;158979;547;76;32;2;30;.938;3577000;0
15642;483;2190;64;15;1;14;.933;3600000;0
15642;162979;548;0;0;0;0;.00nan;0;0
15642;172303;2190;0;0;0;0;.00nan;0;0
15642;160650;548;82;38;2;36;.947;3566000;0
15643;147;543;0;0;0;0;.00nan;0;0
15643;6541;550;0;0;0;0;.00nan;0;0
15643;170042;550;70;41;4;37;.902;3600000;0
15643;32347;543;75;23;1;22;.957;3600000;0
15644;49864;549;63;30;3;27;.900;3600000;0
15644;59933;551;37;20;4;16;.800;3544000;0
15644;72108;549;0;0;0;0;.00nan;0;0
15644;86343;551;0;0;0;0;.00nan;0;0
15645;6389;545;62;22;2;20;.909;3600000;0
15645;67683;545;0;0;0;0;.00nan;0;0
15645;150203;547;70;34;3;31;.912;3552000;0
15645;158979;547;0;0;0;0;.00nan;0;0
15646;483;2190;27;32;7;25;.781;3600000;0
15646;172303;2190;0;0;0;0;.00nan;0;0
15646;71660;546;73;29;2;27;.931;3600000;0
15646;150187;546;0;0;0;0;.00nan;0;0
15647;6541;550;50;9;1;8;.889;587000;0
15647;170042;550;26;30;6;24;.800;3013000;0
15647;59933;551;0;0;0;0;.00nan;0;0
15647;86343;551;72;28;2;26;.929;3600000;0
15648;6389;545;73;23;1;22;.957;3600000;0
15648;6541;550;0;0;0;0;.00nan;0;0
15648;170042;550;90;43;2;41;.953;3576000;0
15648;67683;545;0;0;0;0;.00nan;0;0
15649;483;2190;80;28;2;26;.929;3545000;0
15649;172303;2190;0;0;0;0;.00nan;0;0
15649;71660;546;86;29;1;28;.966;3600000;0
15649;150187;546;0;0;0;0;.00nan;0;0
15650;147;543;48;27;4;23;.852;3523000;0
15650;32347;543;0;0;0;0;.00nan;0;0
15650;59933;551;0;0;0;0;.00nan;0;0
15650;86343;551;74;26;2;24;.923;3600000;0
15651;147;543;0;0;0;0;.00nan;0;0
15651;32347;543;71;23;1;22;.957;3600000;0
15651;49864;549;50;40;6;34;.850;3600000;0
15651;72108;549;0;0;0;0;.00nan;0;0
15652;483;2190;48;23;4;19;.826;3542000;0
15652;172303;2190;0;0;0;0;.00nan;0;0
15652;150203;547;0;0;0;0;.00nan;0;0
15652;158979;547;77;35;2;33;.943;3600000;0
15653;6389;545;81;22;1;21;.955;3900000;0
15653;67683;545;0;0;0;0;.00nan;0;0
15653;71660;546;91;33;1;32;.970;3900000;0
15653;150187;546;0;0;0;0;.00nan;0;0
15654;162979;548;0;0;0;0;.00nan;0;0
15654;6541;550;0;0;0;0;.00nan;0;0
15654;170042;550;57;20;2;18;.900;3600000;0
15654;160650;548;61;29;3;26;.897;3600000;0
15655;49864;549;98;25;0;25;1.000;3600000;0
15655;72108;549;0;0;0;0;.00nan;0;0
15655;150203;547;0;0;0;0;.00nan;0;0
15655;158979;547;69;31;3;28;.903;3556000;0
15656;6541;550;0;0;0;0;.00nan;0;0
15656;170042;550;60;19;2;17;.895;3600000;0
15656;71660;546;0;0;0;0;.00nan;0;0
15656;150187;546;95;30;1;29;.967;3600000;0
15657;147;543;64;19;2;17;.895;3600000;0
15657;6389;545;69;42;4;38;.905;3547000;0
15657;32347;543;0;0;0;0;.00nan;0;0
15657;67683;545;0;0;0;0;.00nan;0;0
15658;162979;548;61;26;2;24;.923;3558000;0
15658;59933;551;88;28;1;27;.964;3600000;0
15658;86343;551;0;0;0;0;.00nan;0;0
15658;160650;548;0;0;0;0;.00nan;0;0
15659;162979;548;56;2;0;2;1.000;551000;0
15659;6389;545;65;22;2;20;.909;3600000;0
15659;67683;545;0;0;0;0;.00nan;0;0
15659;160650;548;49;42;6;36;.857;3049000;0
15660;59933;551;0;0;0;0;.00nan;0;0
15660;86343;551;58;29;3;26;.897;3600000;0
15660;150203;547;81;23;2;21;.913;3600000;0
15660;158979;547;0;0;0;0;.00nan;0;0
15661;147;543;0;0;0;0;.00nan;0;0
15661;483;2190;43;16;3;13;.813;513000;0
15661;172303;2190;70;30;3;27;.900;3087000;0
15661;32347;543;72;25;2;23;.920;3600000;0
15662;6541;550;0;0;0;0;.00nan;0;0
15662;170042;550;100;30;0;30;1.000;3600000;0
15662;49864;549;46;28;4;24;.857;3600000;0
15662;72108;549;0;0;0;0;.00nan;0;0
15663;49864;549;82;25;1;24;.960;3600000;0
15663;71660;546;82;30;2;28;.933;3549000;0
15663;72108;549;0;0;0;0;.00nan;0;0
15663;150187;546;0;0;0;0;.00nan;0;0
15664;147;543;0;0;0;0;.00nan;0;0
15664;32347;543;69;29;4;25;.862;3649000;0
15664;150203;547;76;42;3;39;.929;3649000;0
15664;158979;547;0;0;0;0;.00nan;0;0
15665;483;2190;72;27;2;25;.926;3600000;0
15665;6389;545;83;28;1;27;.964;3600000;0
15665;172303;2190;0;0;0;0;.00nan;0;0
15665;67683;545;0;0;0;0;.00nan;0;0
15666;6541;550;0;0;0;0;.00nan;0;0
15666;170042;550;89;42;3;39;.929;3636000;0
15666;49864;549;0;0;0;0;.00nan;0;0
15666;72108;549;72;24;2;22;.917;3636000;0
15667;147;543;76;31;3;28;.903;3600000;0
15667;32347;543;0;0;0;0;.00nan;0;0
15667;71660;546;29;13;4;9;.692;1024000;0
15667;150187;546;89;20;0;20;1.000;2493000;0
15668;59933;551;0;0;0;0;.00nan;0;0
15668;86343;551;82;38;3;35;.921;3600000;0
15668;150203;547;27;18;5;13;.722;3556000;0
15668;158979;547;0;0;0;0;.00nan;0;0
15669;483;2190;63;25;2;23;.920;3600000;0
15669;162979;548;63;38;4;34;.895;3600000;0
15669;172303;2190;0;0;0;0;.00nan;0;0
15669;160650;548;0;0;0;0;.00nan;0;0
15670;49864;549;70;24;2;22;.917;3600000;0
15670;71660;546;63;41;5;36;.878;3600000;0
15670;72108;549;0;0;0;0;.00nan;0;0
15670;150187;546;0;0;0;0;.00nan;0;0
15671;147;543;0;0;0;0;.00nan;0;0
15671;32347;543;57;35;4;31;.886;3600000;0
15671;150203;547;86;38;2;36;.947;3600000;0
15671;158979;547;0;0;0;0;.00nan;0;0
15672;162979;548;75;39;3;36;.923;3900000;0
15672;6541;550;0;0;0;0;.00nan;0;0
15672;170042;550;96;44;3;41;.932;3900000;0
15672;160650;548;0;0;0;0;.00nan;0;0
15673;6389;545;78;38;3;35;.921;3600000;0
15673;59933;551;41;30;5;25;.833;3538000;0
15673;67683;545;0;0;0;0;.00nan;0;0
15673;86343;551;0;0;0;0;.00nan;0;0
15674;162979;548;66;16;1;15;.938;1514000;0
15674;150203;547;34;7;3;4;.571;347000;0
15674;158979;547;35;28;5;23;.821;3253000;0
15674;160650;548;33;15;4;11;.733;2086000;0
15675;6389;545;65;25;3;22;.880;3580000;0
15675;49864;549;90;37;1;36;.973;3600000;0
15675;67683;545;0;0;0;0;.00nan;0;0
15675;72108;549;0;0;0;0;.00nan;0;0
15676;59933;551;0;0;0;0;.00nan;0;0
15676;71660;546;51;29;4;25;.862;3563000;0
15676;86343;551;81;35;2;33;.943;3600000;0
15676;150187;546;0;0;0;0;.00nan;0;0
15677;483;2190;70;21;1;20;.952;3600000;0
15677;6541;550;0;0;0;0;.00nan;0;0
15677;172303;2190;0;0;0;0;.00nan;0;0
15677;170042;550;92;47;3;44;.936;3600000;0
15678;49864;549;64;20;2;18;.900;3600000;0
15678;72108;549;0;0;0;0;.00nan;0;0
15678;150203;547;48;27;4;23;.852;3594000;0
15678;158979;547;0;0;0;0;.00nan;0;0
15679;162979;548;0;0;0;0;.00nan;0;0
15679;71660;546;75;24;2;22;.917;3600000;0
15679;150187;546;0;0;0;0;.00nan;0;0
15679;160650;548;51;35;5;30;.857;3600000;0
15680;147;543;0;0;0;0;.00nan;0;0
15680;483;2190;83;49;5;44;.898;3600000;0
15680;172303;2190;0;0;0;0;.00nan;0;0
15680;32347;543;77;33;2;31;.939;3600000;0
15681;6389;545;77;18;1;17;.944;3600000;0
15681;6541;550;0;0;0;0;.00nan;0;0
15681;170042;550;86;47;4;43;.915;3600000;0
15681;67683;545;0;0;0;0;.00nan;0;0
15682;162979;548;41;34;6;28;.824;3600000;0
15682;49864;549;53;27;4;23;.852;3600000;0
15682;72108;549;0;0;0;0;.00nan;0;0
15682;160650;548;0;0;0;0;.00nan;0;0
15683;6541;550;0;0;0;0;.00nan;0;0
15683;170042;550;91;35;2;33;.943;3600000;0
15683;150203;547;42;29;5;24;.828;3600000;0
15683;158979;547;0;0;0;0;.00nan;0;0
15684;483;2190;67;43;4;39;.907;3600000;0
15684;6389;545;100;32;0;32;1.000;3600000;0
15684;172303;2190;0;0;0;0;.00nan;0;0
15684;67683;545;0;0;0;0;.00nan;0;0
15685;147;543;68;36;4;32;.889;3600000;0
15685;32347;543;0;0;0;0;.00nan;0;0
15685;59933;551;100;32;0;32;1.000;3600000;0
15685;86343;551;0;0;0;0;.00nan;0;0
15686;162979;548;67;23;2;21;.913;3583000;0
15686;71660;546;98;41;1;40;.976;3600000;0
15686;150187;546;0;0;0;0;.00nan;0;0
15686;160650;548;0;0;0;0;.00nan;0;0
15687;483;2190;71;29;3;26;.897;3600000;0
15687;172303;2190;0;0;0;0;.00nan;0;0
15687;150203;547;52;31;4;27;.871;3600000;0
15687;158979;547;0;0;0;0;.00nan;0;0
15688;6389;545;74;25;2;23;.920;3664000;0
15688;67683;545;0;0;0;0;.00nan;0;0
15688;71660;546;93;36;1;35;.972;3664000;0
15688;150187;546;0;0;0;0;.00nan;0;0
15689;147;543;0;0;0;0;.00nan;0;0
15689;32347;543;78;11;0;11;1.000;3600000;0
15689;49864;549;45;35;6;29;.829;3600000;0
15689;72108;549;0;0;0;0;.00nan;0;0
15690;6541;550;0;0;0;0;.00nan;0;0
15690;170042;550;84;38;3;35;.921;3574000;0
15690;59933;551;70;19;1;18;.947;3600000;0
15690;86343;551;0;0;0;0;.00nan;0;0
15691;71660;546;52;32;5;27;.844;3600000;0
15691;150187;546;0;0;0;0;.00nan;0;0
15691;150203;547;83;30;1;29;.967;3600000;0
15691;158979;547;0;0;0;0;.00nan;0;0
15692;162979;548;82;36;2;34;.944;3588000;0
15692;6389;545;71;20;1;19;.950;3600000;0
15692;67683;545;0;0;0;0;.00nan;0;0
15692;160650;548;0;0;0;0;.00nan;0;0
15693;483;2190;62;25;3;22;.880;3576000;0
15693;172303;2190;0;0;0;0;.00nan;0;0
15693;59933;551;0;0;0;0;.00nan;0;0
15693;86343;551;98;30;1;29;.967;3600000;0
15694;147;543;0;0;0;0;.00nan;0;0
15694;6541;550;0;0;0;0;.00nan;0;0
15694;170042;550;77;50;5;45;.900;3600000;0
15694;32347;543;84;25;1;24;.960;3600000;0
15695;49864;549;54;22;3;19;.864;3567000;0
15695;59933;551;84;35;2;33;.943;3600000;0
15695;72108;549;0;0;0;0;.00nan;0;0
15695;86343;551;0;0;0;0;.00nan;0;0
15696;147;543;0;0;0;0;.00nan;0;0
15696;162979;548;0;0;0;0;.00nan;0;0
15696;32347;543;63;22;3;19;.864;3583000;0
15696;160650;548;94;35;2;33;.943;3600000;0
15697;6389;545;45;18;3;15;.833;3575000;0
15697;67683;545;0;0;0;0;.00nan;0;0
15697;150203;547;92;63;2;61;.968;3600000;0
15697;158979;547;0;0;0;0;.00nan;0;0
15698;483;2190;92;17;0;17;1.000;3600000;0
15698;172303;2190;0;0;0;0;.00nan;0;0
15698;71660;546;98;46;2;44;.957;3566000;0
15698;150187;546;0;0;0;0;.00nan;0;0
15699;147;543;86;20;0;20;1.000;3600000;0
15699;6389;545;92;41;3;38;.927;3600000;0
15699;32347;543;0;0;0;0;.00nan;0;0
15699;67683;545;0;0;0;0;.00nan;0;0
15700;162979;548;99;43;1;42;.977;3600000;0
15700;59933;551;0;0;0;0;.00nan;0;0
15700;86343;551;63;20;2;18;.900;3554000;0
15700;160650;548;0;0;0;0;.00nan;0;0
15701;483;2190;76;27;2;25;.926;3900000;0
15701;172303;2190;0;0;0;0;.00nan;0;0
15701;49864;549;78;34;2;32;.941;3900000;0
15701;72108;549;0;0;0;0;.00nan;0;0
15702;6541;550;0;0;0;0;.00nan;0;0
15702;170042;550;32;15;4;11;.733;3900000;0
15702;71660;546;91;47;4;43;.915;3900000;0
15702;150187;546;0;0;0;0;.00nan;0;0
15704;162979;548;92;52;4;48;.923;3583000;0
15704;32347;543;75;23;2;21;.913;3600000;0
15704;150345;543;0;0;0;0;.00nan;0;0
15704;160650;548;0;0;0;0;.00nan;0;0
15706;6389;545;58;22;2;20;.909;3600000;0
15706;59933;551;0;0;0;0;.00nan;0;0
15706;67683;545;0;0;0;0;.00nan;0;0
15706;86343;551;75;29;3;26;.897;3544000;0
15708;6541;550;0;0;0;0;.00nan;0;0
15708;170042;550;83;29;1;28;.966;3600000;0
15708;49864;549;51;24;3;21;.875;3600000;0
15708;72108;549;0;0;0;0;.00nan;0;0
15710;71660;546;48;47;7;40;.851;3600000;0
15710;150187;546;0;0;0;0;.00nan;0;0
15710;150203;547;70;27;2;25;.926;3600000;0
15710;158979;547;0;0;0;0;.00nan;0;0
15712;162979;548;100;26;0;26;1.000;3600000;0
15712;49864;549;26;27;6;21;.778;2646000;0
15712;72108;549;65;7;0;7;1.000;954000;0
15712;160650;548;0;0;0;0;.00nan;0;0
15714;6541;550;0;0;0;0;.00nan;0;0
15714;170042;550;93;36;2;34;.944;3600000;0
15714;32347;543;59;36;5;31;.861;3600000;0
15714;150345;543;0;0;0;0;.00nan;0;0
15716;483;2190;48;19;3;16;.842;3600000;0
15716;6389;545;70;37;4;33;.892;3556000;0
15716;172303;2190;0;0;0;0;.00nan;0;0
15716;67683;545;0;0;0;0;.00nan;0;0
15718;59933;551;0;0;0;0;.00nan;0;0
15718;71660;546;91;36;2;34;.944;3900000;0
15718;86343;551;76;25;2;23;.920;3896000;0
15718;150187;546;0;0;0;0;.00nan;0;0
15720;162979;548;64;29;3;26;.897;3600000;0
15720;71660;546;0;0;0;0;.00nan;0;0
15720;150187;546;52;31;4;27;.871;3554000;0
15720;160650;548;0;0;0;0;.00nan;0;0
15722;6389;545;80;27;2;25;.926;3900000;0
15722;6541;550;99;49;2;47;.959;3900000;0
15722;170042;550;0;0;0;0;.00nan;0;0
15722;67683;545;0;0;0;0;.00nan;0;0
15724;483;2190;0;0;0;0;.00nan;0;0
15724;172303;2190;59;30;4;26;.867;3596000;0
15724;49864;549;0;0;0;0;.00nan;0;0
15724;72108;549;88;35;2;33;.943;3600000;0
15726;32347;543;0;0;0;0;.00nan;0;0
15726;59933;551;21;23;6;17;.739;2169000;0
15726;86343;551;68;8;0;8;1.000;1431000;0
15726;150345;543;60;32;4;28;.875;3600000;0
15728;59933;551;0;0;0;0;.00nan;0;0
15728;86343;551;83;18;0;18;1.000;3600000;0
15728;150203;547;68;30;2;28;.933;3562000;0
15728;158979;547;0;0;0;0;.00nan;0;0
15730;162979;548;62;28;3;25;.893;3600000;0
15730;71660;546;65;41;5;36;.878;3587000;0
15730;150187;546;0;0;0;0;.00nan;0;0
15730;160650;548;0;0;0;0;.00nan;0;0
15732;6389;545;87;15;0;15;1.000;3600000;0
15732;6541;550;0;0;0;0;.00nan;0;0
15732;170042;550;46;36;6;30;.833;3600000;0
15732;67683;545;0;0;0;0;.00nan;0;0
15734;483;2190;68;20;2;18;.900;3900000;0
15734;172303;2190;0;0;0;0;.00nan;0;0
15734;49864;549;77;24;1;23;.958;3900000;0
15734;72108;549;0;0;0;0;.00nan;0;0
15736;162979;548;0;0;0;0;.00nan;0;0
15736;6389;545;93;17;0;17;1.000;3600000;0
15736;67683;545;0;0;0;0;.00nan;0;0
15736;160650;548;92;42;1;41;.976;3543000;0
15738;32347;543;85;29;1;28;.966;3600000;0
15738;71660;546;0;0;0;0;.00nan;0;0
15738;150187;546;51;36;5;31;.861;3600000;0
15738;150345;543;0;0;0;0;.00nan;0;0
15740;483;2190;0;0;0;0;.00nan;0;0
15740;172303;2190;92;29;1;28;.966;3600000;0
15740;59933;551;0;0;0;0;.00nan;0;0
15740;86343;551;54;40;5;35;.875;3600000;0
15742;49864;549;0;0;0;0;.00nan;0;0
15742;72108;549;71;30;3;27;.900;3559000;0
15742;150203;547;0;0;0;0;.00nan;0;0
15742;158979;547;57;14;1;13;.929;3600000;0
15744;49864;549;37;16;4;12;.750;3523000;0
15744;71660;546;84;30;2;28;.933;3600000;0
15744;72108;549;0;0;0;0;.00nan;0;0
15744;150187;546;0;0;0;0;.00nan;0;0
15746;32347;543;78;35;3;32;.914;3900000;0
15746;59933;551;0;0;0;0;.00nan;0;0
15746;86343;551;70;32;3;29;.906;3900000;0
15746;150345;543;0;0;0;0;.00nan;0;0
15748;6541;550;0;0;0;0;.00nan;0;0
15748;170042;550;74;33;3;30;.909;3900000;0
15748;150203;547;0;0;0;0;.00nan;0;0
15748;158979;547;67;34;3;31;.912;3900000;0
15750;483;2190;48;16;2;14;.875;3900000;0
15750;162979;548;92;34;2;32;.941;3900000;0
15750;172303;2190;0;0;0;0;.00nan;0;0
15750;160650;548;0;0;0;0;.00nan;0;0
15752;32347;543;0;0;0;0;.00nan;0;0
15752;71660;546;0;0;0;0;.00nan;0;0
15752;150187;546;63;46;4;42;.913;3600000;0
15752;150345;543;79;25;1;24;.960;3600000;0
15754;483;2190;0;0;0;0;.00nan;0;0
15754;162979;548;0;0;0;0;.00nan;0;0
15754;172303;2190;63;32;4;28;.875;3600000;0
15754;160650;548;60;25;3;22;.880;3600000;0
15756;49864;549;0;0;0;0;.00nan;0;0
15756;72108;549;60;31;4;27;.871;3600000;0
15756;150203;547;75;22;1;21;.955;3600000;0
15756;158979;547;0;0;0;0;.00nan;0;0
15758;6389;545;92;35;2;33;.943;3600000;0
15758;59933;551;50;24;3;21;.875;3543000;0
15758;67683;545;0;0;0;0;.00nan;0;0
15758;86343;551;0;0;0;0;.00nan;0;0
724;6389;545;45;29;5;24;.828;3600000;0
724;67683;545;0;0;0;0;.00nan;0;0
724;71660;546;79;36;2;34;.944;3600000;0
724;150187;546;0;0;0;0;.00nan;0;0
725;483;2190;86;26;1;25;.962;3600000;0
725;6541;550;0;0;0;0;.00nan;0;0
725;172303;2190;0;0;0;0;.00nan;0;0
725;170042;550;50;24;3;21;.875;3560000;0
726;147;543;78;24;1;23;.958;3600000;0
726;32347;543;0;0;0;0;.00nan;0;0
726;49864;549;70;34;3;31;.912;3579000;0
726;72108;549;0;0;0;0;.00nan;0;0
727;59933;551;0;0;0;0;.00nan;0;0
727;86343;551;79;29;2;27;.931;4019000;0
727;150203;547;89;31;1;30;.968;4019000;0
727;158979;547;0;0;0;0;.00nan;0;0
728;6389;545;63;27;3;24;.889;3560000;0
728;67683;545;0;0;0;0;.00nan;0;0
728;71660;546;99;41;2;39;.951;3600000;0
728;150187;546;0;0;0;0;.00nan;0;0
729;483;2190;30;22;5;17;.773;3600000;0
729;6541;550;0;0;0;0;.00nan;0;0
729;172303;2190;0;0;0;0;.00nan;0;0
729;170042;550;72;26;2;24;.923;3600000;0
730;147;543;0;0;0;0;.00nan;0;0
730;32347;543;91;20;0;20;1.000;3600000;0
730;49864;549;80;36;3;33;.917;3600000;0
730;72108;549;0;0;0;0;.00nan;0;0
731;59933;551;60;7;0;7;1.000;1319000;0
731;86343;551;1;12;6;6;.500;2281000;0
731;150203;547;74;31;2;29;.935;3600000;0
731;158979;547;0;0;0;0;.00nan;0;0
732;6389;545;19;23;6;17;.739;3600000;0
732;67683;545;0;0;0;0;.00nan;0;0
732;71660;546;99;47;1;46;.979;3600000;0
732;150187;546;0;0;0;0;.00nan;0;0
733;483;2190;44;27;5;22;.815;3969000;0
733;6541;550;0;0;0;0;.00nan;0;0
733;172303;2190;0;0;0;0;.00nan;0;0
733;170042;550;73;53;6;47;.887;3969000;0
734;147;543;0;0;0;0;.00nan;0;0
734;32347;543;82;25;1;24;.960;3600000;0
734;49864;549;74;33;2;31;.939;3564000;0
734;72108;549;0;0;0;0;.00nan;0;0
735;59933;551;0;0;0;0;.00nan;0;0
735;86343;551;96;33;1;32;.970;3600000;0
735;150203;547;69;31;2;29;.935;3600000;0
735;158979;547;0;0;0;0;.00nan;0;0
736;6389;545;60;12;1;11;.917;3600000;0
736;67683;545;0;0;0;0;.00nan;0;0
736;71660;546;55;35;5;30;.857;3600000;0
736;150187;546;0;0;0;0;.00nan;0;0
737;483;2190;51;25;4;21;.840;3600000;0
737;6541;550;0;0;0;0;.00nan;0;0
737;172303;2190;0;0;0;0;.00nan;0;0
737;170042;550;72;24;1;23;.958;3600000;0
738;147;543;0;0;0;0;.00nan;0;0
738;32347;543;56;29;4;25;.862;3600000;0
738;49864;549;53;37;5;32;.865;3562000;0
738;72108;549;0;0;0;0;.00nan;0;0
739;59933;551;0;0;0;0;.00nan;0;0
739;86343;551;50;24;3;21;.875;3600000;0
739;150203;547;83;49;4;45;.918;3569000;0
739;158979;547;0;0;0;0;.00nan;0;0
1115;6389;545;71;23;1;22;.957;3600000;0
1115;67683;545;0;0;0;0;.00nan;0;0
1115;71660;546;79;36;2;34;.944;3600000;0
1115;150187;546;0;0;0;0;.00nan;0;0
1116;483;2190;63;17;2;15;.882;3600000;0
1116;6541;550;0;0;0;0;.00nan;0;0
1116;172303;2190;0;0;0;0;.00nan;0;0
1116;170042;550;72;33;3;30;.909;3543000;0
1117;59933;551;0;0;0;0;.00nan;0;0
1117;86343;551;100;34;1;33;.971;3600000;0
1117;150203;547;50;25;3;22;.880;3562000;0
1117;158979;547;0;0;0;0;.00nan;0;0
1136;6389;545;62;15;1;14;.933;3600000;0
1136;67683;545;0;0;0;0;.00nan;0;0
1136;71660;546;95;42;2;40;.952;3554000;0
1136;150187;546;0;0;0;0;.00nan;0;0
1137;483;2190;68;23;2;21;.913;3600000;0
1137;6541;550;0;0;0;0;.00nan;0;0
1137;172303;2190;0;0;0;0;.00nan;0;0
1137;170042;550;88;41;3;38;.927;3550000;0
1138;59933;551;0;0;0;0;.00nan;0;0
1138;86343;551;76;17;1;16;.941;3600000;0
1138;150203;547;49;28;4;24;.857;3600000;0
1138;158979;547;0;0;0;0;.00nan;0;0
1194;6389;545;22;19;5;14;.737;3600000;0
1194;67683;545;0;0;0;0;.00nan;0;0
1194;71660;546;89;41;2;39;.951;3600000;0
1194;150187;546;0;0;0;0;.00nan;0;0
1223;483;2190;52;18;2;16;.889;3600000;0
1223;172303;2190;0;0;0;0;.00nan;0;0
1223;71660;546;68;45;4;41;.911;3600000;0
1223;150187;546;0;0;0;0;.00nan;0;0
1224;147;543;0;0;0;0;.00nan;0;0
1224;32347;543;80;45;4;41;.911;4262000;0
1224;59933;551;0;0;0;0;.00nan;0;0
1224;86343;551;63;24;3;21;.875;4262000;0
1225;483;2190;58;24;3;21;.875;3600000;0
1225;172303;2190;0;0;0;0;.00nan;0;0
1225;71660;546;70;37;5;32;.865;3589000;0
1225;150187;546;0;0;0;0;.00nan;0;0
1226;147;543;0;0;0;0;.00nan;0;0
1226;32347;543;61;32;3;29;.906;3600000;0
1226;59933;551;0;0;0;0;.00nan;0;0
1226;86343;551;53;28;4;24;.857;3553000;0
1227;483;2190;78;24;1;23;.958;3600000;0
1227;172303;2190;0;0;0;0;.00nan;0;0
1227;71660;546;86;30;2;28;.933;3593000;0
1227;150187;546;0;0;0;0;.00nan;0;0
1228;147;543;0;0;0;0;.00nan;0;0
1228;32347;543;52;22;3;19;.864;3600000;0
1228;59933;551;0;0;0;0;.00nan;0;0
1228;86343;551;39;18;4;14;.778;3552000;0
1229;483;2190;45;20;3;17;.850;3543000;0
1229;172303;2190;0;0;0;0;.00nan;0;0
1229;71660;546;90;37;1;36;.973;3600000;0
1229;150187;546;0;0;0;0;.00nan;0;0
1230;147;543;0;0;0;0;.00nan;0;0
1230;32347;543;66;33;4;29;.879;3544000;0
1230;59933;551;0;0;0;0;.00nan;0;0
1230;86343;551;75;36;3;33;.917;3600000;0
1510;483;2190;49;18;3;15;.833;3600000;0
1510;172303;2190;0;0;0;0;.00nan;0;0
1510;71660;546;66;40;4;36;.900;3600000;0
1510;150187;546;0;0;0;0;.00nan;0;0
1511;147;543;0;0;0;0;.00nan;0;0
1511;32347;543;45;15;2;13;.867;3530000;0
1511;59933;551;0;0;0;0;.00nan;0;0
1511;86343;551;100;39;0;39;1.000;3600000;0
1527;147;543;0;0;0;0;.00nan;0;0
1527;32347;543;74;38;4;34;.895;3563000;0
1527;59933;551;0;0;0;0;.00nan;0;0
1527;86343;551;67;34;3;31;.912;3600000;0
1579;483;2190;100;37;0;37;1.000;4847000;0
1579;172303;2190;0;0;0;0;.00nan;0;0
1579;59933;551;0;0;0;0;.00nan;0;0
1579;86343;551;88;34;1;33;.971;4847000;0
1580;147;543;0;0;0;0;.00nan;0;0
1580;32347;543;64;26;3;23;.885;3635000;0
1580;71660;546;85;46;4;42;.913;3635000;0
1580;150187;546;0;0;0;0;.00nan;0;0
1581;483;2190;52;33;4;29;.879;4891000;0
1581;172303;2190;0;0;0;0;.00nan;0;0
1581;59933;551;0;0;0;0;.00nan;0;0
1581;86343;551;89;48;5;43;.896;4891000;0
1582;147;543;0;0;0;0;.00nan;0;0
1582;32347;543;95;20;0;20;1.000;3600000;0
1582;71660;546;98;49;1;48;.980;3558000;0
1582;150187;546;0;0;0;0;.00nan;0;0
1583;483;2190;83;31;2;29;.935;3600000;0
1583;172303;2190;0;0;0;0;.00nan;0;0
1583;59933;551;0;0;0;0;.00nan;0;0
1583;86343;551;64;31;3;28;.903;3551000;0
1584;147;543;0;0;0;0;.00nan;0;0
1584;32347;543;83;46;4;42;.913;3549000;0
1584;71660;546;69;33;3;30;.909;3600000;0
1584;150187;546;0;0;0;0;.00nan;0;0
1585;483;2190;100;24;0;24;1.000;3600000;0
1585;172303;2190;0;0;0;0;.00nan;0;0
1585;59933;551;0;0;0;0;.00nan;0;0
1585;86343;551;86;42;2;40;.952;3547000;0
1586;147;543;0;0;0;0;.00nan;0;0
1586;32347;543;72;30;2;28;.933;3600000;0
1586;71660;546;69;32;3;29;.906;3600000;0
1586;150187;546;0;0;0;0;.00nan;0;0
1763;147;543;0;0;0;0;.00nan;0;0
1763;32347;543;83;26;1;25;.962;3600000;0
1763;71660;546;83;37;3;34;.919;3539000;0
1763;150187;546;0;0;0;0;.00nan;0;0
15759;2153;456;0;0;0;0;.00nan;0;0
15759;182561;456;73;16;1;15;.938;3600000;0
15759;187783;457;80;32;2;30;.938;3568000;0
15759;183205;457;0;0;0;0;.00nan;0;0
15760;187783;457;21;25;6;19;.760;2528000;0
15760;183205;457;31;9;3;6;.667;1072000;0
15760;15558;452;0;0;0;0;.00nan;0;0
15760;15564;452;26;24;6;18;.750;3600000;0
15761;161695;4337;77;25;2;23;.920;3600000;0
15761;167492;458;0;0;0;0;.00nan;0;0
15761;10565;4337;0;0;0;0;.00nan;0;0
15761;22349;458;37;30;5;25;.833;3600000;0
15762;166839;1086;0;0;0;0;.00nan;0;0
15762;193010;2579;0;0;0;0;.00nan;0;0
15762;172079;1086;52;29;4;25;.862;3587000;0
15762;92283;2579;74;33;3;30;.909;3600000;0
15763;193005;455;10;25;7;18;.720;2929000;0
15763;172723;459;0;0;0;0;.00nan;0;0
15763;10794;455;18;10;4;6;.600;671000;0
15763;85947;459;75;37;3;34;.919;3600000;0
15764;161695;4337;0;0;0;0;.00nan;0;0
15764;9216;460;0;0;0;0;.00nan;0;0
15764;10565;4337;56;27;3;24;.889;3600000;0
15764;75464;460;44;25;4;21;.840;3560000;0
15765;2153;456;0;0;0;0;.00nan;0;0
15765;182561;456;59;43;4;39;.907;3600000;0
15765;172723;459;0;0;0;0;.00nan;0;0
15765;85947;459;77;19;1;18;.947;3600000;0
15766;2153;456;0;0;0;0;.00nan;0;0
15766;182561;456;41;27;5;22;.815;3808000;0
15766;187783;457;0;0;0;0;.00nan;0;0
15766;53830;457;48;23;4;19;.826;3808000;0
15767;166839;1086;0;0;0;0;.00nan;0;0
15767;193005;455;58;42;5;37;.881;3600000;0
15767;172079;1086;1;29;9;20;.690;3600000;0
15767;10794;455;0;0;0;0;.00nan;0;0
15768;2153;456;49;25;4;21;.840;3562000;0
15768;182561;456;0;0;0;0;.00nan;0;0
15768;187783;457;0;0;0;0;.00nan;0;0
15768;53830;457;68;27;3;24;.889;3600000;0
15769;172723;459;0;0;0;0;.00nan;0;0
15769;15558;452;50;9;1;8;.889;1265000;0
15769;15564;452;22;23;6;17;.739;2335000;0
15769;85947;459;58;31;3;28;.903;3600000;0
15770;193010;2579;51;20;2;18;.900;3580000;0
15770;167492;458;75;27;1;26;.963;3600000;0
15770;22349;458;0;0;0;0;.00nan;0;0
15770;92283;2579;0;0;0;0;.00nan;0;0
15771;193010;2579;58;17;2;15;.882;3600000;0
15771;168066;460;36;30;6;24;.800;1892000;0
15771;75464;460;46;21;3;18;.857;1708000;0
15771;92283;2579;0;0;0;0;.00nan;0;0
15772;193005;455;60;36;4;32;.889;3900000;0
15772;10794;455;0;0;0;0;.00nan;0;0
15772;15558;452;0;0;0;0;.00nan;0;0
15772;15564;452;86;45;4;41;.911;3900000;0
15773;166839;1086;0;0;0;0;.00nan;0;0
15773;187783;457;0;0;0;0;.00nan;0;0
15773;172079;1086;65;25;3;22;.880;3600000;0
15773;53830;457;65;40;5;35;.875;3590000;0
15774;167492;458;45;28;4;24;.857;3600000;0
15774;168066;460;75;21;1;20;.952;3600000;0
15774;22349;458;0;0;0;0;.00nan;0;0
15774;75464;460;0;0;0;0;.00nan;0;0
15775;166839;1086;58;19;2;17;.895;3900000;0
15775;187783;457;0;0;0;0;.00nan;0;0
15775;172079;1086;0;0;0;0;.00nan;0;0
15775;53830;457;92;44;2;42;.955;3900000;0
15776;167492;458;20;49;10;39;.796;3600000;0
15776;15558;452;0;0;0;0;.00nan;0;0
15776;15564;452;43;22;4;18;.818;3600000;0
15776;22349;458;0;0;0;0;.00nan;0;0
15777;2153;456;0;0;0;0;.00nan;0;0
15777;182561;456;85;34;2;32;.941;3600000;0
15777;193010;2579;43;27;4;23;.852;3577000;0
15777;92283;2579;0;0;0;0;.00nan;0;0
15778;161695;4337;52;29;5;24;.828;3650000;0
15778;193005;455;45;29;4;25;.862;3650000;0
15778;10565;4337;0;0;0;0;.00nan;0;0
15778;10794;455;0;0;0;0;.00nan;0;0
15779;168066;460;11;21;6;15;.714;1718000;0
15779;15558;452;0;0;0;0;.00nan;0;0
15779;15564;452;57;29;3;26;.897;3600000;0
15779;75464;460;31;19;4;15;.789;1882000;0
15780;2153;456;33;4;2;2;.500;719000;0
15780;166839;1086;0;0;0;0;.00nan;0;0
15780;182561;456;1;14;7;7;.500;2860000;0
15780;172079;1086;54;47;7;40;.851;3600000;0
15781;193005;455;60;31;3;28;.903;3900000;0
15781;172723;459;0;0;0;0;.00nan;0;0
15781;10794;455;0;0;0;0;.00nan;0;0
15781;85947;459;68;29;3;26;.897;3900000;0
15782;2153;456;0;0;0;0;.00nan;0;0
15782;166839;1086;63;23;2;21;.913;3750000;0
15782;182561;456;92;33;1;32;.970;3750000;0
15782;172079;1086;0;0;0;0;.00nan;0;0
15783;161695;4337;38;40;7;33;.825;3600000;0
15783;10565;4337;0;0;0;0;.00nan;0;0
15783;15558;452;94;33;1;32;.970;3600000;0
15783;15564;452;0;0;0;0;.00nan;0;0
15784;161695;4337;0;0;0;0;.00nan;0;0
15784;187783;457;50;10;1;9;.900;1873000;0
15784;183205;457;13;20;6;14;.700;1727000;0
15784;10565;4337;65;36;3;33;.917;3600000;0
15785;193010;2579;51;21;3;18;.857;3600000;0
15785;168066;460;26;34;7;27;.794;3600000;0
15785;75464;460;0;0;0;0;.00nan;0;0
15785;92283;2579;0;0;0;0;.00nan;0;0
15786;193005;455;59;28;3;25;.893;3600000;0
15786;162331;458;0;0;0;0;.00nan;0;0
15786;9216;455;0;0;0;0;.00nan;0;0
15786;22349;458;48;34;4;30;.882;3599000;0
15787;193010;2579;0;0;0;0;.00nan;0;0
15787;168066;460;73;25;1;24;.960;3600000;0
15787;75464;460;0;0;0;0;.00nan;0;0
15787;92283;2579;98;23;0;23;1.000;3600000;0
15788;198243;459;65;30;3;27;.900;3600000;0
15788;162331;458;53;32;5;27;.844;3600000;0
15788;172723;459;0;0;0;0;.00nan;0;0
15788;22349;458;0;0;0;0;.00nan;0;0
15789;187783;457;0;0;0;0;.00nan;0;0
15789;15558;452;55;9;1;8;.889;812000;0
15789;15564;452;18;25;6;19;.760;2788000;0
15789;53830;457;99;48;2;46;.958;3600000;0
15790;166839;1086;0;0;0;0;.00nan;0;0
15790;172079;1086;38;35;6;29;.829;3559000;0
15790;172723;459;0;0;0;0;.00nan;0;0
15790;85947;459;59;36;4;32;.889;3600000;0
15791;2153;456;0;0;0;0;.00nan;0;0
15791;182561;456;45;27;5;22;.815;3600000;0
15791;167492;458;100;36;2;34;.944;3600000;0
15791;22349;458;0;0;0;0;.00nan;0;0
15792;161695;4337;56;4;0;4;1.000;531000;0
15792;193010;2579;0;0;0;0;.00nan;0;0
15792;10565;4337;1;19;8;11;.579;3069000;0
15792;92283;2579;38;28;5;23;.821;3600000;0
15793;2153;456;0;0;0;0;.00nan;0;0
15793;182561;456;31;27;5;22;.815;3562000;0
15793;168066;460;66;25;3;22;.880;3600000;0
15793;75464;460;0;0;0;0;.00nan;0;0
15794;193005;455;58;28;3;25;.893;3600000;0
15794;187783;457;0;0;0;0;.00nan;0;0
15794;9216;455;0;0;0;0;.00nan;0;0
15794;53830;457;64;30;4;26;.867;3564000;0
15795;2153;456;0;0;0;0;.00nan;0;0
15795;182561;456;50;30;4;26;.867;3600000;0
15795;193010;2579;39;40;6;34;.850;3215000;0
15795;92283;2579;39;1;1;0;.000;341000;0
15796;193005;455;97;22;0;22;1.000;3600000;0
15796;167492;458;58;41;4;37;.902;3600000;0
15796;9216;455;0;0;0;0;.00nan;0;0
15796;22349;458;0;0;0;0;.00nan;0;0
15797;161695;4337;33;31;6;25;.806;3600000;0
15797;187783;457;0;0;0;0;.00nan;0;0
15797;10565;4337;0;0;0;0;.00nan;0;0
15797;53830;457;62;23;2;21;.913;3600000;0
15798;172723;459;0;0;0;0;.00nan;0;0
15798;15558;452;0;0;0;0;.00nan;0;0
15798;15564;452;59;33;4;29;.879;3600000;0
15798;85947;459;50;43;6;37;.860;3552000;0
15799;193005;455;7;9;5;4;.444;1025000;0
15799;9216;455;61;19;2;17;.895;2530000;0
15799;168066;460;42;29;5;24;.828;3600000;0
15799;75464;460;0;0;0;0;.00nan;0;0
15800;167492;458;0;0;0;0;.00nan;0;0
15800;168066;460;18;18;6;12;.667;3330000;0
15800;22349;458;79;28;1;27;.964;3600000;0
15800;75464;460;48;0;0;0;.00nan;270000;0
15801;166839;1086;0;0;0;0;.00nan;0;0
15801;172079;1086;36;23;4;19;.826;3600000;0
15801;167492;458;23;25;6;19;.760;2627000;0
15801;22349;458;63;12;0;12;1.000;907000;0
15802;193005;455;39;40;6;34;.850;3000000;0
15802;9216;455;58;2;0;2;1.000;554000;0
15802;15558;452;0;0;0;0;.00nan;0;0
15802;15564;452;42;24;4;20;.833;3600000;0
15803;193010;2579;0;0;0;0;.00nan;0;0
15803;168066;460;0;0;0;0;.00nan;0;0
15803;75464;460;80;38;3;35;.921;3600000;0
15803;92283;2579;51;37;5;32;.865;3533000;0
15804;161695;4337;52;33;4;29;.879;3600000;0
15804;2153;456;0;0;0;0;.00nan;0;0
15804;182561;456;43;25;5;20;.800;3554000;0
15804;10565;4337;0;0;0;0;.00nan;0;0
15805;187783;457;0;0;0;0;.00nan;0;0
15805;172723;459;0;0;0;0;.00nan;0;0
15805;53830;457;61;33;4;29;.879;3584000;0
15805;85947;459;54;19;3;16;.842;3600000;0
15806;193010;2579;39;27;4;23;.852;3543000;0
15806;167492;458;0;0;0;0;.00nan;0;0
15806;22349;458;54;29;3;26;.897;3600000;0
15806;92283;2579;0;0;0;0;.00nan;0;0
15807;2153;456;0;0;0;0;.00nan;0;0
15807;182561;456;73;31;3;28;.903;3600000;0
15807;15558;452;0;0;0;0;.00nan;0;0
15807;15564;452;57;36;5;31;.861;3512000;0
15808;167492;458;44;21;4;17;.810;809000;0
15808;172723;459;0;0;0;0;.00nan;0;0
15808;22349;458;46;27;4;23;.852;2791000;0
15808;85947;459;64;23;2;21;.913;3600000;0
15809;161695;4337;86;39;2;37;.949;3600000;0
15809;166839;1086;0;0;0;0;.00nan;0;0
15809;172079;1086;59;32;3;29;.906;3556000;0
15809;10565;4337;0;0;0;0;.00nan;0;0
15810;187783;457;0;0;0;0;.00nan;0;0
15810;193010;2579;41;2;1;1;.500;342000;0
15810;53830;457;40;21;4;17;.810;3600000;0
15810;92283;2579;44;33;6;27;.818;3258000;0
15811;172723;459;0;0;0;0;.00nan;0;0
15811;168066;460;73;41;3;38;.927;3600000;0
15811;75464;460;0;0;0;0;.00nan;0;0
15811;85947;459;47;29;5;24;.828;3525000;0
15812;166839;1086;8;15;6;9;.600;2708000;0
15812;193005;455;0;0;0;0;.00nan;0;0
15812;172079;1086;58;7;0;7;1.000;892000;0
15812;9216;455;44;35;5;30;.857;3600000;0
15813;2153;456;59;38;6;32;.842;3600000;0
15813;182561;456;0;0;0;0;.00nan;0;0
15813;15558;452;31;29;6;23;.793;2314000;0
15813;15564;452;49;9;1;8;.889;1283000;0
15814;166839;1086;0;0;0;0;.00nan;0;0
15814;187783;457;0;0;0;0;.00nan;0;0
15814;172079;1086;65;34;3;31;.912;3600000;0
15814;53830;457;46;37;6;31;.838;3600000;0
15815;2153;456;0;0;0;0;.00nan;0;0
15815;182561;456;70;21;1;20;.952;3600000;0
15815;167492;458;60;34;4;30;.882;3600000;0
15815;22349;458;0;0;0;0;.00nan;0;0
15816;168066;460;26;33;7;26;.788;3145000;0
15816;15558;452;0;0;0;0;.00nan;0;0
15816;15564;452;58;34;3;31;.912;3600000;0
15816;75464;460;49;8;1;7;.875;455000;0
15817;161695;4337;0;0;0;0;.00nan;0;0
15817;193010;2579;69;24;2;22;.917;3600000;0
15817;10565;4337;54;32;4;28;.875;3579000;0
15817;92283;2579;0;0;0;0;.00nan;0;0
15818;161695;4337;61;15;1;14;.933;3600000;0
15818;10565;4337;0;0;0;0;.00nan;0;0
15818;168066;460;0;0;0;0;.00nan;0;0
15818;75464;460;93;50;3;47;.940;3600000;0
15819;193005;455;0;0;0;0;.00nan;0;0
15819;193010;2579;44;19;3;16;.842;2402000;0
15819;9216;455;59;11;1;10;.909;3600000;0
15819;92283;2579;21;10;4;6;.600;1198000;0
15820;166839;1086;68;31;3;28;.903;3600000;0
15820;187783;457;0;0;0;0;.00nan;0;0
15820;172079;1086;0;0;0;0;.00nan;0;0
15820;53830;457;12;18;6;12;.667;3600000;0
15821;167492;458;0;0;0;0;.00nan;0;0
15821;172723;459;0;0;0;0;.00nan;0;0
15821;22349;458;35;33;6;27;.818;3600000;0
15821;85947;459;79;28;1;27;.964;3600000;0
15822;187783;457;0;0;0;0;.00nan;0;0
15822;167492;458;0;0;0;0;.00nan;0;0
15822;22349;458;50;28;5;23;.821;3600000;0
15822;53830;457;78;23;2;21;.913;3600000;0
15823;2153;456;0;0;0;0;.00nan;0;0
15823;166839;1086;0;0;0;0;.00nan;0;0
15823;182561;456;65;32;4;28;.875;3600000;0
15823;172079;1086;39;34;6;28;.824;3542000;0
15824;161695;4337;0;0;0;0;.00nan;0;0
15824;10565;4337;80;35;3;32;.914;3900000;0
15824;15558;452;0;0;0;0;.00nan;0;0
15824;15564;452;73;38;3;35;.921;3900000;0
15825;193010;2579;65;30;3;27;.900;3869000;0
15825;172723;459;0;0;0;0;.00nan;0;0
15825;85947;459;82;31;2;29;.935;3869000;0
15825;92283;2579;0;0;0;0;.00nan;0;0
15826;167492;458;46;33;5;28;.848;3521000;0
15826;15558;452;53;23;3;20;.870;3600000;0
15826;15564;452;0;0;0;0;.00nan;0;0
15826;22349;458;0;0;0;0;.00nan;0;0
15827;161695;4337;40;33;5;28;.848;3600000;0
15827;10565;4337;0;0;0;0;.00nan;0;0
15827;176196;457;0;0;0;0;.00nan;0;0
15827;53830;457;27;30;6;24;.800;3545000;0
15828;2153;456;67;25;2;23;.920;3600000;0
15828;166839;1086;53;34;4;30;.882;3525000;0
15828;182561;456;0;0;0;0;.00nan;0;0
15828;172079;1086;0;0;0;0;.00nan;0;0
15829;193005;455;0;0;0;0;.00nan;0;0
15829;193010;2579;52;2;0;2;1.000;272000;0
15829;9216;455;32;38;7;31;.816;3550000;0
15829;92283;2579;29;29;6;23;.793;3328000;0
15830;167492;458;84;34;2;32;.941;3600000;0
15830;168066;460;29;30;6;24;.800;3600000;0
15830;22349;458;0;0;0;0;.00nan;0;0
15830;75464;460;0;0;0;0;.00nan;0;0
15831;2153;456;59;16;1;15;.938;1679000;0
15831;182561;456;20;23;6;17;.739;1921000;0
15831;193005;455;0;0;0;0;.00nan;0;0
15831;9216;455;57;29;4;25;.862;3600000;0
15832;167492;458;47;18;2;16;.889;2021000;0
15832;22349;458;17;26;6;20;.769;1579000;0
15832;176196;457;0;0;0;0;.00nan;0;0
15832;53830;457;69;28;2;26;.929;3600000;0
15833;161695;4337;0;0;0;0;.00nan;0;0
15833;166839;1086;0;0;0;0;.00nan;0;0
15833;172079;1086;80;34;3;31;.912;3600000;0
15833;10565;4337;32;35;6;29;.829;3600000;0
15834;193010;2579;25;21;5;16;.762;1859000;0
15834;15558;452;0;0;0;0;.00nan;0;0
15834;15564;452;63;34;4;30;.882;3600000;0
15834;92283;2579;65;19;1;18;.947;1713000;0
15835;168066;460;83;33;1;32;.970;3600000;0
15835;176196;457;0;0;0;0;.00nan;0;0
15835;53830;457;80;32;2;30;.938;3585000;0
15835;75464;460;0;0;0;0;.00nan;0;0
15836;166839;1086;42;34;5;29;.853;3528000;0
15836;172079;1086;0;0;0;0;.00nan;0;0
15836;172723;459;0;0;0;0;.00nan;0;0
15836;85947;459;56;21;3;18;.857;3600000;0
15837;168066;460;56;21;3;18;.857;3600000;0
15837;176196;457;0;0;0;0;.00nan;0;0
15837;53830;457;73;36;4;32;.889;3545000;0
15837;75464;460;0;0;0;0;.00nan;0;0
15838;166839;1086;0;0;0;0;.00nan;0;0
15838;193010;2579;8;16;6;10;.625;2121000;0
15838;172079;1086;43;22;4;18;.818;3600000;0
15838;92283;2579;64;16;1;15;.938;1479000;0
15839;2153;456;0;0;0;0;.00nan;0;0
15839;182561;456;88;37;3;34;.919;3600000;0
15839;15558;452;38;7;2;5;.714;831000;0
15839;15564;452;24;32;7;25;.781;2769000;0
15840;161695;4337;57;30;3;27;.900;3600000;0
15840;10565;4337;0;0;0;0;.00nan;0;0
15840;172723;459;0;0;0;0;.00nan;0;0
15840;85947;459;58;32;4;28;.875;3543000;0
15841;193005;455;0;0;0;0;.00nan;0;0
15841;167492;458;49;21;3;18;.857;3600000;0
15841;9216;455;51;29;4;25;.862;3586000;0
15841;22349;458;0;0;0;0;.00nan;0;0
15842;172723;459;0;0;0;0;.00nan;0;0
15842;176196;457;93;35;1;34;.971;3355000;0
15842;53830;457;27;7;3;4;.571;545000;0
15842;85947;459;36;18;4;14;.778;3900000;0
15843;161695;4337;0;0;0;0;.00nan;0;0
15843;167492;458;0;0;0;0;.00nan;0;0
15843;10565;4337;68;30;3;27;.900;3600000;0
15843;22349;458;44;29;5;24;.828;3549000;0
15844;2153;456;77;37;3;34;.919;3546000;0
15844;182561;456;0;0;0;0;.00nan;0;0
15844;15558;452;0;0;0;0;.00nan;0;0
15844;15564;452;71;29;2;27;.931;3600000;0
15845;193005;455;22;35;8;27;.771;3600000;0
15845;9216;455;0;0;0;0;.00nan;0;0
15845;168066;460;23;11;4;7;.636;916000;0
15845;75464;460;96;25;0;25;1.000;2684000;0
15846;2153;456;0;0;0;0;.00nan;0;0
15846;182561;456;58;26;3;23;.885;3600000;0
15846;168066;460;67;37;4;33;.892;3558000;0
15846;75464;460;0;0;0;0;.00nan;0;0
15847;166839;1086;0;0;0;0;.00nan;0;0
15847;172079;1086;42;33;5;28;.848;3600000;0
15847;15558;452;56;19;3;16;.842;3600000;0
15847;15564;452;0;0;0;0;.00nan;0;0
15848;193010;2579;0;0;0;0;.00nan;0;0
15848;167492;458;50;25;4;21;.840;3558000;0
15848;22349;458;0;0;0;0;.00nan;0;0
15848;92283;2579;44;23;3;20;.870;3600000;0
15849;161695;4337;0;0;0;0;.00nan;0;0
15849;10565;4337;79;32;2;30;.938;3600000;0
15849;172723;459;0;0;0;0;.00nan;0;0
15849;85947;459;55;34;4;30;.882;3547000;0
15850;166839;1086;68;56;6;50;.893;3600000;0
15850;172079;1086;0;0;0;0;.00nan;0;0
15850;15558;452;0;0;0;0;.00nan;0;0
15850;15564;452;100;27;0;27;1.000;3600000;0
15851;193010;2579;46;23;4;19;.826;3600000;0
15851;167492;458;0;0;0;0;.00nan;0;0
15851;22349;458;31;29;6;23;.793;3599000;0
15851;92283;2579;0;0;0;0;.00nan;0;0
15852;172723;459;60;21;2;19;.905;3600000;0
15852;168066;460;0;0;0;0;.00nan;0;0
15852;75464;460;51;20;3;17;.850;3577000;0
15852;85947;459;0;0;0;0;.00nan;0;0
15853;193005;455;45;12;2;10;.833;1355000;0
15853;9216;455;29;27;6;21;.778;2245000;0
15853;172723;459;0;0;0;0;.00nan;0;0
15853;85947;459;42;21;4;17;.810;3600000;0
15854;161695;4337;53;16;2;14;.875;3343000;0
15854;166839;1086;0;0;0;0;.00nan;0;0
15854;172079;1086;37;40;7;33;.825;3592000;0
15854;10565;4337;26;5;3;2;.400;257000;0
15855;193010;2579;36;27;5;22;.815;3655000;0
15855;15558;452;0;0;0;0;.00nan;0;0
15855;15564;452;23;26;6;20;.769;3655000;0
15855;92283;2579;0;0;0;0;.00nan;0;0
15856;193005;455;0;0;0;0;.00nan;0;0
15856;9216;455;62;14;2;12;.857;3600000;0
15856;168066;460;52;25;3;22;.880;3580000;0
15856;75464;460;0;0;0;0;.00nan;0;0
15857;161695;4337;0;0;0;0;.00nan;0;0
15857;166839;1086;31;32;6;26;.813;3548000;0
15857;172079;1086;0;0;0;0;.00nan;0;0
15857;10565;4337;60;38;4;34;.895;3600000;0
15858;172723;459;0;0;0;0;.00nan;0;0
15858;168066;460;60;9;0;9;1.000;1237000;0
15858;75464;460;19;21;6;15;.714;2354000;0
15858;85947;459;35;22;5;17;.773;3600000;0
15859;167492;458;49;32;5;27;.844;3600000;0
15859;168066;460;25;34;6;28;.824;3600000;0
15859;22349;458;0;0;0;0;.00nan;0;0
15859;75464;460;0;0;0;0;.00nan;0;0
15860;161695;4337;64;20;1;19;.950;2063000;0
15860;2153;456;0;0;0;0;.00nan;0;0
15860;182561;456;62;34;4;30;.882;3600000;0
15860;10565;4337;10;17;6;11;.647;1537000;0
15861;15558;452;0;0;0;0;.00nan;0;0
15861;15564;452;82;31;2;29;.935;3600000;0
15861;176196;457;0;0;0;0;.00nan;0;0
15861;53830;457;29;37;8;29;.784;3600000;0
15862;193005;455;0;0;0;0;.00nan;0;0
15862;167492;458;0;0;0;0;.00nan;0;0
15862;9216;455;63;14;1;13;.929;3600000;0
15862;22349;458;89;49;2;47;.959;3578000;0
15863;193010;2579;0;0;0;0;.00nan;0;0
15863;172723;459;0;0;0;0;.00nan;0;0
15863;85947;459;91;31;1;30;.968;3600000;0
15863;92283;2579;73;38;3;35;.921;3564000;0
15864;193005;455;51;23;3;20;.870;3600000;0
15864;9216;455;0;0;0;0;.00nan;0;0
15864;168066;460;26;29;6;23;.793;3600000;0
15864;75464;460;0;0;0;0;.00nan;0;0
15865;161695;4337;38;28;5;23;.821;3595000;0
15865;2153;456;43;18;4;14;.778;3600000;0
15865;182561;456;0;0;0;0;.00nan;0;0
15865;10565;4337;0;0;0;0;.00nan;0;0
15866;193010;2579;70;26;2;24;.923;3600000;0
15866;172723;459;0;0;0;0;.00nan;0;0
15866;85947;459;53;29;4;25;.862;3524000;0
15866;92283;2579;0;0;0;0;.00nan;0;0
15867;193010;2579;64;31;4;27;.871;3600000;0
15867;176196;457;0;0;0;0;.00nan;0;0
15867;53830;457;46;19;3;16;.842;3600000;0
15867;92283;2579;0;0;0;0;.00nan;0;0
15868;193005;455;0;0;0;0;.00nan;0;0
15868;9216;455;48;28;4;24;.857;3600000;0
15868;172723;459;0;0;0;0;.00nan;0;0
15868;85947;459;90;21;0;21;1.000;3600000;0
15869;193005;455;62;44;5;39;.886;3900000;0
15869;9216;455;0;0;0;0;.00nan;0;0
15869;176196;457;58;36;5;31;.861;3900000;0
15869;53830;457;0;0;0;0;.00nan;0;0
15870;166839;1086;0;0;0;0;.00nan;0;0
15870;172079;1086;24;18;5;13;.722;3891000;0
15870;167492;458;0;0;0;0;.00nan;0;0
15870;22349;458;52;36;5;31;.861;3900000;0
15871;161695;4337;0;0;0;0;.00nan;0;0
15871;10565;4337;59;27;3;24;.889;3600000;0
15871;15558;452;28;22;5;17;.773;2857000;0
15871;15564;452;25;11;4;7;.636;743000;0
15872;166839;1086;71;44;4;40;.909;3600000;0
15872;172079;1086;0;0;0;0;.00nan;0;0
15872;168066;460;64;17;1;16;.941;3600000;0
15872;75464;460;0;0;0;0;.00nan;0;0
15873;161695;4337;37;34;6;28;.824;3600000;0
15873;2153;456;0;0;0;0;.00nan;0;0
15873;182561;456;64;29;2;27;.931;3600000;0
15873;10565;4337;0;0;0;0;.00nan;0;0
15874;193010;2579;0;0;0;0;.00nan;0;0
15874;172723;459;0;0;0;0;.00nan;0;0
15874;85947;459;66;30;3;27;.900;3564000;0
15874;92283;2579;72;20;1;19;.950;3600000;0
15875;2153;456;0;0;0;0;.00nan;0;0
15875;182561;456;52;15;2;13;.867;3543000;0
15875;176196;457;0;0;0;0;.00nan;0;0
15875;53830;457;82;25;1;24;.960;3600000;0
15876;161695;4337;0;0;0;0;.00nan;0;0
15876;193005;455;0;0;0;0;.00nan;0;0
15876;9216;455;65;28;3;25;.893;3600000;0
15876;10565;4337;30;29;6;23;.793;3600000;0
15877;166839;1086;0;0;0;0;.00nan;0;0
15877;172079;1086;58;30;3;27;.900;3551000;0
15877;15558;452;0;0;0;0;.00nan;0;0
15877;15564;452;80;30;1;29;.967;3600000;0
15878;161695;4337;56;32;6;26;.813;3600000;0
15878;10565;4337;0;0;0;0;.00nan;0;0
15878;176196;457;0;0;0;0;.00nan;0;0
15878;53830;457;28;37;7;30;.811;3552000;0
15879;167492;458;33;52;9;43;.827;3600000;0
15879;172723;459;0;0;0;0;.00nan;0;0
15879;22349;458;0;0;0;0;.00nan;0;0
15879;85947;459;35;16;4;12;.750;3600000;0
15880;172723;459;0;0;0;0;.00nan;0;0
15880;168066;460;23;22;5;17;.773;3900000;0
15880;75464;460;0;0;0;0;.00nan;0;0
15880;85947;459;43;34;5;29;.853;3900000;0
15881;166839;1086;58;30;4;26;.867;3900000;0
15881;172079;1086;0;0;0;0;.00nan;0;0
15881;15558;452;51;32;4;28;.875;3900000;0
15881;15564;452;0;0;0;0;.00nan;0;0
15882;2153;456;0;0;0;0;.00nan;0;0
15882;182561;456;53;17;2;15;.882;3600000;0
15882;193005;455;35;38;7;31;.816;3600000;0
15882;9216;455;0;0;0;0;.00nan;0;0
15883;166839;1086;0;0;0;0;.00nan;0;0
15883;172079;1086;24;23;6;17;.739;3600000;0
15883;168066;460;21;24;6;18;.750;1508000;0
15883;75464;460;58;17;2;15;.882;2092000;0
15884;2153;456;0;0;0;0;.00nan;0;0
15884;182561;456;56;18;2;16;.889;3600000;0
15884;172723;459;0;0;0;0;.00nan;0;0
15884;85947;459;57;25;3;22;.880;3600000;0
15885;15558;452;0;0;0;0;.00nan;0;0
15885;15564;452;73;22;1;21;.955;3600000;0
15885;176196;457;0;0;0;0;.00nan;0;0
15885;53830;457;59;50;7;43;.860;3600000;0
15886;161695;4337;29;31;6;25;.806;2945000;0
15886;10565;4337;44;4;1;3;.750;598000;0
15886;15558;452;0;0;0;0;.00nan;0;0
15886;15564;452;16;23;6;17;.739;3600000;0
15887;193005;455;0;0;0;0;.00nan;0;0
15887;193010;2579;58;32;4;28;.875;3600000;0
15887;9216;455;32;29;6;23;.793;3600000;0
15887;92283;2579;0;0;0;0;.00nan;0;0
15888;193005;455;20;20;5;15;.750;3600000;0
15888;193010;2579;0;0;0;0;.00nan;0;0
15888;9216;455;0;0;0;0;.00nan;0;0
15888;92283;2579;63;22;2;20;.909;3600000;0
15890;187783;457;0;0;0;0;.00nan;0;0
15890;193010;2579;0;0;0;0;.00nan;0;0
15890;183205;457;67;32;3;29;.906;3600000;0
15890;92283;2579;53;33;4;29;.879;3582000;0
15892;167492;458;26;26;6;20;.769;2978000;0
15892;15558;452;0;0;0;0;.00nan;0;0
15892;15564;452;45;11;2;9;.818;3600000;0
15892;22349;458;49;7;1;6;.857;622000;0
15894;2153;456;0;0;0;0;.00nan;0;0
15894;182561;456;52;30;3;27;.900;3556000;0
15894;9216;460;89;30;1;29;.967;3600000;0
15894;75464;460;0;0;0;0;.00nan;0;0
15896;161695;4337;40;33;5;28;.848;3588000;0
15896;193005;455;36;17;4;13;.765;3600000;0
15896;10565;4337;0;0;0;0;.00nan;0;0
15896;10794;455;0;0;0;0;.00nan;0;0
15898;166839;1086;0;0;0;0;.00nan;0;0
15898;172079;1086;64;39;4;35;.897;3600000;0
15898;172723;459;0;0;0;0;.00nan;0;0
15898;85947;459;68;18;1;17;.944;3600000;0
15900;9216;460;0;0;0;0;.00nan;0;0
15900;15558;452;0;0;0;0;.00nan;0;0
15900;15564;452;55;21;2;19;.905;3600000;0
15900;75464;460;44;33;5;28;.848;3600000;0
15902;166839;1086;0;0;0;0;.00nan;0;0
15902;187783;457;0;0;0;0;.00nan;0;0
15902;172079;1086;82;32;1;31;.969;3600000;0
15902;183205;457;76;35;4;31;.886;3600000;0
15904;2153;456;0;0;0;0;.00nan;0;0
15904;182561;456;60;29;3;26;.897;3600000;0
15904;172723;459;0;0;0;0;.00nan;0;0
15904;85947;459;90;37;2;35;.946;3600000;0
15906;161695;4337;62;18;1;17;.944;3600000;0
15906;167492;458;53;28;4;24;.857;3600000;0
15906;10565;4337;0;0;0;0;.00nan;0;0
15906;22349;458;0;0;0;0;.00nan;0;0
15908;193005;455;0;0;0;0;.00nan;0;0
15908;193010;2579;85;39;2;37;.949;3543000;0
15908;10794;455;86;31;1;30;.968;3600000;0
15908;92283;2579;0;0;0;0;.00nan;0;0
15910;193010;2579;0;0;0;0;.00nan;0;0
15910;172723;459;0;0;0;0;.00nan;0;0
15910;85947;459;49;29;3;26;.897;3591000;0
15910;92283;2579;78;22;1;21;.955;3600000;0
15912;193005;455;34;29;5;24;.828;3558000;0
15912;9216;460;84;38;3;35;.921;3600000;0
15912;10794;455;0;0;0;0;.00nan;0;0
15912;75464;460;0;0;0;0;.00nan;0;0
15914;166839;1086;58;28;3;25;.893;3600000;0
15914;172079;1086;0;0;0;0;.00nan;0;0
15914;15558;452;54;15;2;13;.867;3600000;0
15914;15564;452;0;0;0;0;.00nan;0;0
15916;2153;456;87;30;1;29;.967;3600000;0
15916;182561;456;0;0;0;0;.00nan;0;0
15916;187783;457;34;27;6;21;.778;3600000;0
15916;183205;457;0;0;0;0;.00nan;0;0
15918;161695;4337;0;0;0;0;.00nan;0;0
15918;167492;458;0;0;0;0;.00nan;0;0
15918;10565;4337;65;31;3;28;.903;3900000;0
15918;22349;458;62;33;3;30;.909;3900000;0
15920;161695;4337;71;26;2;24;.923;3600000;0
15920;193005;455;35;12;3;9;.750;1658000;0
15920;10565;4337;0;0;0;0;.00nan;0;0
15920;10794;455;25;20;5;15;.750;1942000;0
15922;193010;2579;57;26;3;23;.885;3575000;0
15922;15558;452;0;0;0;0;.00nan;0;0
15922;15564;452;73;26;2;24;.923;3600000;0
15922;92283;2579;0;0;0;0;.00nan;0;0
15924;187783;457;0;0;0;0;.00nan;0;0
15924;167492;458;41;26;5;21;.808;3900000;0
15924;183205;457;56;30;5;25;.833;3900000;0
15924;22349;458;0;0;0;0;.00nan;0;0
15926;2153;456;0;0;0;0;.00nan;0;0
15926;166839;1086;0;0;0;0;.00nan;0;0
15926;182561;456;18;33;7;26;.788;3600000;0
15926;172079;1086;88;24;1;23;.958;3600000;0
15928;9216;460;36;36;6;30;.833;3600000;0
15928;172723;459;0;0;0;0;.00nan;0;0
15928;75464;460;0;0;0;0;.00nan;0;0
15928;85947;459;57;19;2;17;.895;3600000;0
385;2153;456;0;0;0;0;.00nan;0;0
385;182561;456;49;35;5;30;.857;3543000;0
385;193005;455;57;27;3;24;.889;3600000;0
385;9216;455;0;0;0;0;.00nan;0;0
386;161695;4337;53;28;4;24;.857;3600000;0
386;193010;2579;36;26;5;21;.808;3554000;0
386;10565;4337;0;0;0;0;.00nan;0;0
386;92283;2579;0;0;0;0;.00nan;0;0
413;193005;455;23;28;6;22;.786;2833000;0
413;9216;455;36;6;2;4;.667;767000;0
413;172723;459;0;0;0;0;.00nan;0;0
413;85947;459;72;37;4;33;.892;3600000;0
414;161695;4337;0;0;0;0;.00nan;0;0
414;10565;4337;53;48;6;42;.875;3600000;0
414;15558;452;0;0;0;0;.00nan;0;0
414;15564;452;81;26;1;25;.962;3600000;0
479;172723;459;0;0;0;0;.00nan;0;0
479;15558;452;0;0;0;0;.00nan;0;0
479;15564;452;74;24;1;23;.958;3600000;0
479;85947;459;63;41;5;36;.878;3600000;0
15929;-1;165;0;0;0;0;.00nan;0;0
15929;-1;165;65;25;4;21;.840;4051000;0
15929;175651;4715;0;0;0;0;.00nan;0;0
15929;85336;4715;93;47;3;44;.936;4038000;0
15930;183730;4919;0;0;0;0;.00nan;0;0
15930;175658;4919;77;35;2;33;.943;3600000;0
15930;181874;4998;0;0;0;0;.00nan;0;0
15930;85228;4998;60;31;3;28;.903;3570000;0
15931;-1;165;0;0;0;0;.00nan;0;0
15931;-1;165;41;32;6;26;.813;3600000;0
15931;175651;4715;0;0;0;0;.00nan;0;0
15931;85336;4715;91;24;1;23;.958;3600000;0
15932;183730;4919;0;0;0;0;.00nan;0;0
15932;175658;4919;75;24;1;23;.958;3600000;0
15932;181874;4998;0;0;0;0;.00nan;0;0
15932;85228;4998;66;35;4;31;.886;3600000;0
15933;161583;4839;0;0;0;0;.00nan;0;0
15933;166423;1368;0;0;0;0;.00nan;0;0
15933;-1;4839;46;35;5;30;.857;3556000;0
15933;87164;1368;47;27;4;23;.852;3600000;0
15934;-1;165;0;0;0;0;.00nan;0;0
15934;-1;165;50;30;6;24;.800;3600000;0
15934;181874;4998;0;0;0;0;.00nan;0;0
15934;85228;4998;65;28;3;25;.893;3600000;0
15935;-1;4992;0;0;0;0;.00nan;0;0
15935;37897;4714;0;0;0;0;.00nan;0;0
15935;182097;4992;80;34;3;31;.912;3600000;0
15935;59231;4714;37;26;5;21;.808;3543000;0
15936;183730;4919;0;0;0;0;.00nan;0;0
15936;175651;4715;0;0;0;0;.00nan;0;0
15936;175658;4919;69;29;2;27;.931;3600000;0
15936;85336;4715;63;35;5;30;.857;3600000;0
15937;161583;4839;68;37;4;33;.892;3542000;0
15937;166423;1368;0;0;0;0;.00nan;0;0
15937;-1;4839;0;0;0;0;.00nan;0;0
15937;87164;1368;63;21;2;19;.905;3600000;0
15938;183730;4919;49;29;4;25;.862;3600000;0
15938;175651;4715;36;37;6;31;.838;3574000;0
15938;175658;4919;0;0;0;0;.00nan;0;0
15938;85336;4715;0;0;0;0;.00nan;0;0
15939;-1;165;51;20;3;17;.850;3600000;0
15939;-1;165;0;0;0;0;.00nan;0;0
15939;181874;4998;59;34;4;30;.882;3577000;0
15939;85228;4998;0;0;0;0;.00nan;0;0
15940;-1;4992;27;24;6;18;.750;3600000;0
15940;37897;4714;0;0;0;0;.00nan;0;0
15940;182097;4992;0;0;0;0;.00nan;0;0
15940;59231;4714;95;52;3;49;.942;3600000;0
15941;-1;165;0;0;0;0;.00nan;0;0
15941;-1;165;78;27;1;26;.963;3600000;0
15941;175651;4715;0;0;0;0;.00nan;0;0
15941;85336;4715;63;45;5;40;.889;3600000;0
15942;185812;4997;0;0;0;0;.00nan;0;0
15942;187391;4246;41;21;4;17;.810;3600000;0
15942;64925;4997;46;32;5;27;.844;3555000;0
15942;161129;4246;0;0;0;0;.00nan;0;0
15943;-1;165;64;29;2;27;.931;3600000;0
15943;-1;165;0;0;0;0;.00nan;0;0
15943;175651;4715;23;9;4;5;.556;835000;0
15943;85336;4715;61;28;4;24;.857;2765000;0
15944;161583;4839;67;24;2;22;.917;3600000;0
15944;-1;4839;0;0;0;0;.00nan;0;0
15944;37897;4714;0;0;0;0;.00nan;0;0
15944;59231;4714;76;35;3;32;.914;3573000;0
15945;169478;4991;0;0;0;0;.00nan;0;0
15945;181874;4998;0;0;0;0;.00nan;0;0
15945;85228;4998;89;21;0;21;1.000;3600000;0
15945;85984;4991;46;29;5;24;.828;3600000;0
15946;166423;1368;0;0;0;0;.00nan;0;0
15946;-1;4992;27;38;7;31;.816;3167000;0
15946;182097;4992;43;3;1;2;.667;433000;0
15946;87164;1368;88;20;0;20;1.000;3600000;0
15947;185812;4997;0;0;0;0;.00nan;0;0
15947;187391;4246;15;20;6;14;.700;3180000;0
15947;64925;4997;95;25;1;24;.960;3600000;0
15947;161129;4246;53;3;0;3;1.000;420000;0
15948;166423;1368;0;0;0;0;.00nan;0;0
15948;-1;4992;67;41;4;37;.902;3600000;0
15948;182097;4992;0;0;0;0;.00nan;0;0
15948;87164;1368;29;31;7;24;.774;3600000;0
15949;169478;4991;0;0;0;0;.00nan;0;0
15949;181874;4998;0;0;0;0;.00nan;0;0
15949;85228;4998;62;37;4;33;.892;3593000;0
15949;85984;4991;72;32;3;29;.906;3600000;0
15950;161583;4839;66;27;2;25;.926;3600000;0
15950;-1;4839;0;0;0;0;.00nan;0;0
15950;37897;4714;73;36;4;32;.889;3580000;0
15950;59231;4714;0;0;0;0;.00nan;0;0
15951;183730;4919;0;0;0;0;.00nan;0;0
15951;-1;165;0;0;0;0;.00nan;0;0
15951;-1;165;90;44;3;41;.932;3600000;0
15951;175658;4919;83;14;0;14;1.000;3600000;0
15952;185812;4997;81;36;2;34;.944;3600000;0
15952;187391;4246;0;0;0;0;.00nan;0;0
15952;64925;4997;0;0;0;0;.00nan;0;0
15952;161129;4246;73;36;3;33;.917;3552000;0
15953;166423;1368;44;4;1;3;.750;360000;0
15953;175651;4715;0;0;0;0;.00nan;0;0
15953;85336;4715;54;16;2;14;.875;3600000;0
15953;87164;1368;40;40;6;34;.850;3240000;0
15954;169478;4991;0;0;0;0;.00nan;0;0
15954;-1;4992;0;0;0;0;.00nan;0;0
15954;182097;4992;93;45;3;42;.933;3673000;0
15954;85984;4991;55;25;4;21;.840;3673000;0
15955;183730;4919;0;0;0;0;.00nan;0;0
15955;175658;4919;33;40;7;33;.825;3584000;0
15955;181874;4998;34;34;6;28;.824;3600000;0
15955;85228;4998;0;0;0;0;.00nan;0;0
15956;37897;4714;0;0;0;0;.00nan;0;0
15956;187391;4246;34;25;5;20;.800;3521000;0
15956;59231;4714;61;29;3;26;.897;3600000;0
15956;161129;4246;0;0;0;0;.00nan;0;0
15957;169478;4991;100;27;0;27;1.000;3600000;0
15957;-1;4992;43;42;6;36;.857;3600000;0
15957;182097;4992;0;0;0;0;.00nan;0;0
15957;85984;4991;0;0;0;0;.00nan;0;0
15958;166423;1368;0;0;0;0;.00nan;0;0
15958;175651;4715;44;27;4;23;.852;3585000;0
15958;85336;4715;0;0;0;0;.00nan;0;0
15958;87164;1368;69;24;2;22;.917;3600000;0
15959;-1;165;0;0;0;0;.00nan;0;0
15959;-1;165;59;25;3;22;.880;3600000;0
15959;181874;4998;0;0;0;0;.00nan;0;0
15959;85228;4998;61;32;4;28;.875;3572000;0
15960;185812;4997;0;0;0;0;.00nan;0;0
15960;187391;4246;63;21;2;19;.905;3600000;0
15960;64925;4997;61;33;4;29;.879;3600000;0
15960;161129;4246;0;0;0;0;.00nan;0;0
15961;-1;165;60;38;4;34;.895;3557000;0
15961;169478;4991;73;34;3;31;.912;3600000;0
15961;-1;165;0;0;0;0;.00nan;0;0
15961;85984;4991;0;0;0;0;.00nan;0;0
15962;183730;4919;0;0;0;0;.00nan;0;0
15962;175651;4715;0;0;0;0;.00nan;0;0
15962;175658;4919;35;29;5;24;.828;3571000;0
15962;85336;4715;70;40;4;36;.900;3600000;0
15963;-1;4992;0;0;0;0;.00nan;0;0
15963;37897;4714;0;0;0;0;.00nan;0;0
15963;182097;4992;59;38;6;32;.842;3800000;0
15963;59231;4714;45;29;5;24;.828;3800000;0
15964;161583;4839;77;40;4;36;.900;3600000;0
15964;166423;1368;0;0;0;0;.00nan;0;0
15964;-1;4839;0;0;0;0;.00nan;0;0
15964;87164;1368;89;14;0;14;1.000;3600000;0
15965;185812;4997;58;30;4;26;.867;3600000;0
15965;187391;4246;0;0;0;0;.00nan;0;0
15965;64925;4997;0;0;0;0;.00nan;0;0
15965;161129;4246;99;30;1;29;.967;3600000;0
15966;161583;4839;0;0;0;0;.00nan;0;0
15966;166423;1368;0;0;0;0;.00nan;0;0
15966;-1;4839;76;45;4;41;.911;3600000;0
15966;87164;1368;65;15;1;14;.933;3600000;0
15967;175651;4715;76;28;2;26;.929;3600000;0
15967;181874;4998;57;7;0;7;1.000;810000;0
15967;85228;4998;11;25;7;18;.720;2790000;0
15967;85336;4715;0;0;0;0;.00nan;0;0
15968;-1;165;0;0;0;0;.00nan;0;0
15968;169478;4991;0;0;0;0;.00nan;0;0
15968;-1;165;29;28;7;21;.750;3730000;0
15968;85984;4991;42;39;6;33;.846;3697000;0
15969;-1;4992;100;34;0;34;1.000;3600000;0
15969;37897;4714;0;0;0;0;.00nan;0;0
15969;182097;4992;0;0;0;0;.00nan;0;0
15969;59231;4714;65;21;2;19;.905;3598000;0
15970;-1;165;0;0;0;0;.00nan;0;0
15970;-1;165;63;36;5;31;.861;3651000;0
15970;175651;4715;68;31;4;27;.871;3604000;0
15970;85336;4715;0;0;0;0;.00nan;0;0
15971;183730;4919;0;0;0;0;.00nan;0;0
15971;175658;4919;77;29;2;27;.931;3600000;0
15971;181874;4998;0;0;0;0;.00nan;0;0
15971;85228;4998;51;23;3;20;.870;3543000;0
15972;37897;4714;0;0;0;0;.00nan;0;0
15972;185812;4997;0;0;0;0;.00nan;0;0
15972;59231;4714;65;22;2;20;.909;3600000;0
15972;64925;4997;46;40;6;34;.850;3600000;0
15973;169478;4991;87;46;4;42;.913;4200000;0
15973;-1;4992;64;34;4;30;.882;4200000;0
15973;182097;4992;0;0;0;0;.00nan;0;0
15973;85984;4991;0;0;0;0;.00nan;0;0
15974;161583;4839;57;37;5;32;.865;3600000;0
15974;-1;4839;0;0;0;0;.00nan;0;0
15974;187391;4246;77;30;2;28;.933;3600000;0
15974;161129;4246;0;0;0;0;.00nan;0;0
15975;175651;4715;0;0;0;0;.00nan;0;0
15975;181874;4998;42;19;3;16;.842;3598000;0
15975;85228;4998;0;0;0;0;.00nan;0;0
15975;85336;4715;85;28;1;27;.964;3600000;0
15976;169478;4991;0;0;0;0;.00nan;0;0
15976;-1;4992;0;0;0;0;.00nan;0;0
15976;182097;4992;57;32;4;28;.875;3600000;0
15976;85984;4991;90;31;1;30;.968;3600000;0
15977;183730;4919;85;25;1;24;.960;3600000;0
15977;-1;165;8;39;9;30;.769;3600000;0
15977;-1;165;0;0;0;0;.00nan;0;0
15977;175658;4919;0;0;0;0;.00nan;0;0
15978;161583;4839;0;0;0;0;.00nan;0;0
15978;-1;4839;48;37;5;32;.865;3543000;0
15978;187391;4246;0;0;0;0;.00nan;0;0
15978;161129;4246;43;24;4;20;.833;3600000;0
15979;37897;4714;0;0;0;0;.00nan;0;0
15979;185812;4997;65;41;4;37;.902;3570000;0
15979;59231;4714;77;23;2;21;.913;3600000;0
15979;64925;4997;0;0;0;0;.00nan;0;0
15980;-1;165;0;0;0;0;.00nan;0;0
15980;-1;165;98;32;2;30;.938;3600000;0
15980;181874;4998;0;0;0;0;.00nan;0;0
15980;85228;4998;53;38;5;33;.868;3600000;0
15981;183730;4919;0;0;0;0;.00nan;0;0
15981;166423;1368;0;0;0;0;.00nan;0;0
15981;175658;4919;81;36;3;33;.917;3546000;0
15981;87164;1368;90;33;1;32;.970;3600000;0
15982;37897;4714;0;0;0;0;.00nan;0;0
15982;187391;4246;72;45;4;41;.911;3596000;0
15982;59231;4714;64;25;3;22;.880;3600000;0
15982;161129;4246;0;0;0;0;.00nan;0;0
15983;166423;1368;0;0;0;0;.00nan;0;0
15983;175651;4715;0;0;0;0;.00nan;0;0
15983;85336;4715;75;35;4;31;.886;3600000;0
15983;87164;1368;75;22;1;21;.955;3600000;0
15984;-1;165;84;36;3;33;.917;3600000;0
15984;-1;165;0;0;0;0;.00nan;0;0
15984;181874;4998;90;27;0;27;1.000;2530000;0
15984;85228;4998;25;15;4;11;.733;1070000;0
15985;169478;4991;89;33;1;32;.970;3600000;0
15985;185812;4997;0;0;0;0;.00nan;0;0
15985;64925;4997;71;41;5;36;.878;3600000;0
15985;85984;4991;0;0;0;0;.00nan;0;0
15986;161583;4839;65;26;2;24;.923;3595000;0
15986;-1;4839;0;0;0;0;.00nan;0;0
15986;37897;4714;0;0;0;0;.00nan;0;0
15986;59231;4714;58;14;1;13;.929;3600000;0
15987;-1;4992;59;22;3;19;.864;3565000;0
15987;182097;4992;0;0;0;0;.00nan;0;0
15987;187391;4246;79;34;2;32;.941;3600000;0
15987;161129;4246;0;0;0;0;.00nan;0;0
15988;169478;4991;0;0;0;0;.00nan;0;0
15988;185812;4997;65;39;5;34;.872;3600000;0
15988;64925;4997;0;0;0;0;.00nan;0;0
15988;85984;4991;58;32;4;28;.875;3600000;0
15989;166423;1368;0;0;0;0;.00nan;0;0
15989;175651;4715;67;27;3;24;.889;3600000;0
15989;85336;4715;0;0;0;0;.00nan;0;0
15989;87164;1368;44;30;5;25;.833;3600000;0
15990;-1;165;64;24;2;22;.917;3024000;0
15990;-1;165;39;14;3;11;.786;576000;0
15990;181874;4998;0;0;0;0;.00nan;0;0
15990;85228;4998;63;22;2;20;.909;3600000;0
15991;-1;4992;0;0;0;0;.00nan;0;0
15991;182097;4992;55;27;3;24;.889;3562000;0
15991;187391;4246;0;0;0;0;.00nan;0;0
15991;161129;4246;86;34;2;32;.941;3600000;0
15992;161583;4839;0;0;0;0;.00nan;0;0
15992;-1;4839;54;29;4;25;.862;3570000;0
15992;37897;4714;0;0;0;0;.00nan;0;0
15992;59231;4714;51;23;3;20;.870;3600000;0
15993;-1;165;88;36;2;34;.944;3600000;0
15993;-1;165;0;0;0;0;.00nan;0;0
15993;175651;4715;0;0;0;0;.00nan;0;0
15993;85336;4715;77;37;3;34;.919;3558000;0
15994;-1;4992;25;23;5;18;.783;3513000;0
15994;182097;4992;0;0;0;0;.00nan;0;0
15994;185812;4997;0;0;0;0;.00nan;0;0
15994;64925;4997;80;42;3;39;.929;3600000;0
15995;166423;1368;0;0;0;0;.00nan;0;0
15995;181874;4998;49;21;4;17;.810;3600000;0
15995;85228;4998;0;0;0;0;.00nan;0;0
15995;87164;1368;87;30;1;29;.967;3600000;0
15996;161583;4839;32;26;5;21;.808;3600000;0
15996;169478;4991;42;33;6;27;.818;3600000;0
15996;-1;4839;0;0;0;0;.00nan;0;0
15996;85984;4991;0;0;0;0;.00nan;0;0
15997;37897;4714;47;6;1;5;.833;389000;0
15997;187391;4246;58;32;5;27;.844;3600000;0
15997;59231;4714;6;26;8;18;.692;3211000;0
15997;161129;4246;0;0;0;0;.00nan;0;0
15998;161583;4839;0;0;0;0;.00nan;0;0
15998;169478;4991;0;0;0;0;.00nan;0;0
15998;-1;4839;58;26;3;23;.885;3600000;0
15998;85984;4991;37;31;6;25;.806;3600000;0
15999;183730;4919;0;0;0;0;.00nan;0;0
15999;175651;4715;44;32;5;27;.844;3631000;0
15999;175658;4919;65;28;4;24;.857;3631000;0
15999;85336;4715;0;0;0;0;.00nan;0;0
16000;-1;4992;0;0;0;0;.00nan;0;0
16000;182097;4992;43;28;5;23;.821;3600000;0
16000;185812;4997;21;24;6;18;.750;2069000;0
16000;64925;4997;57;14;1;13;.929;1531000;0
16001;166423;1368;0;0;0;0;.00nan;0;0
16001;181874;4998;0;0;0;0;.00nan;0;0
16001;85228;4998;49;32;5;27;.844;3600000;0
16001;87164;1368;37;33;6;27;.818;3552000;0
16002;37897;4714;0;0;0;0;.00nan;0;0
16002;187391;4246;0;0;0;0;.00nan;0;0
16002;59231;4714;61;19;2;17;.895;3551000;0
16002;161129;4246;79;30;1;29;.967;3600000;0
16003;161583;4839;60;48;6;42;.875;3600000;0
16003;169478;4991;56;19;2;17;.895;3600000;0
16003;-1;4839;0;0;0;0;.00nan;0;0
16003;85984;4991;0;0;0;0;.00nan;0;0
16004;183730;4919;23;10;4;6;.600;1078000;0
16004;166423;1368;68;21;2;19;.905;3600000;0
16004;175658;4919;73;13;0;13;1.000;2522000;0
16004;87164;1368;0;0;0;0;.00nan;0;0
16005;161583;4839;54;38;5;33;.868;3600000;0
16005;166423;1368;0;0;0;0;.00nan;0;0
16005;-1;4839;0;0;0;0;.00nan;0;0
16005;87164;1368;91;20;0;20;1.000;3600000;0
16006;183730;4919;0;0;0;0;.00nan;0;0
16006;175651;4715;0;0;0;0;.00nan;0;0
16006;175658;4919;64;17;1;16;.941;3600000;0
16006;85336;4715;71;33;4;29;.879;3600000;0
16007;37897;4714;0;0;0;0;.00nan;0;0
16007;185812;4997;0;0;0;0;.00nan;0;0
16007;59231;4714;68;28;2;26;.929;3600000;0
16007;64925;4997;95;29;1;28;.966;3600000;0
16008;-1;165;58;31;4;27;.871;3559000;0
16008;169478;4991;0;0;0;0;.00nan;0;0
16008;-1;165;0;0;0;0;.00nan;0;0
16008;85984;4991;80;29;2;27;.931;3600000;0
16009;-1;4992;69;26;2;24;.923;3600000;0
16009;182097;4992;0;0;0;0;.00nan;0;0
16009;187391;4246;76;36;3;33;.917;3573000;0
16009;161129;4246;0;0;0;0;.00nan;0;0
16010;-1;165;0;0;0;0;.00nan;0;0
16010;169478;4991;86;35;2;33;.943;3581000;0
16010;-1;165;78;27;1;26;.963;3600000;0
16010;85984;4991;0;0;0;0;.00nan;0;0
16011;161583;4839;71;29;3;26;.897;3600000;0
16011;166423;1368;0;0;0;0;.00nan;0;0
16011;-1;4839;0;0;0;0;.00nan;0;0
16011;87164;1368;56;32;4;28;.875;3562000;0
16012;37897;4714;0;0;0;0;.00nan;0;0
16012;185812;4997;100;52;1;51;.981;3600000;0
16012;59231;4714;65;21;2;19;.905;3568000;0
16012;64925;4997;0;0;0;0;.00nan;0;0
16013;183730;4919;56;30;4;26;.867;3597000;0
16013;175658;4919;0;0;0;0;.00nan;0;0
16013;181874;4998;0;0;0;0;.00nan;0;0
16013;85228;4998;66;29;2;27;.931;3600000;0
16014;-1;4992;53;24;3;21;.875;2025000;0
16014;182097;4992;28;15;4;11;.733;1575000;0
16014;187391;4246;0;0;0;0;.00nan;0;0
16014;161129;4246;82;33;2;31;.939;3600000;0
16015;37897;4714;0;0;0;0;.00nan;0;0
16015;187391;4246;28;29;6;23;.793;3798000;0
16015;59231;4714;39;39;7;32;.821;3798000;0
16015;161129;4246;0;0;0;0;.00nan;0;0
16016;-1;165;42;23;4;19;.826;3600000;0
16016;-1;165;0;0;0;0;.00nan;0;0
16016;181874;4998;55;3;0;3;1.000;587000;0
16016;85228;4998;48;48;7;41;.854;3013000;0
16017;183730;4919;0;0;0;0;.00nan;0;0
16017;175651;4715;0;0;0;0;.00nan;0;0
16017;175658;4919;100;28;1;27;.964;4200000;0
16017;85336;4715;94;43;1;42;.977;4200000;0
16018;166423;1368;0;0;0;0;.00nan;0;0
16018;169478;4991;0;0;0;0;.00nan;0;0
16018;85984;4991;40;18;4;14;.778;3636000;0
16018;87164;1368;56;32;5;27;.844;3636000;0
16019;37897;4714;66;30;3;27;.900;3600000;0
16019;185812;4997;0;0;0;0;.00nan;0;0
16019;59231;4714;0;0;0;0;.00nan;0;0
16019;64925;4997;52;38;6;32;.842;3589000;0
16020;-1;4992;13;17;6;11;.647;1904000;0
16020;182097;4992;54;12;1;11;.917;1696000;0
16020;187391;4246;0;0;0;0;.00nan;0;0
16020;161129;4246;71;33;3;30;.909;3600000;0
16021;161583;4839;40;25;4;21;.840;3529000;0
16021;169478;4991;92;38;2;36;.947;3600000;0
16021;-1;4839;0;0;0;0;.00nan;0;0
16021;85984;4991;0;0;0;0;.00nan;0;0
16022;175651;4715;76;30;2;28;.933;4200000;0
16022;181874;4998;0;0;0;0;.00nan;0;0
16022;85228;4998;73;25;2;23;.920;4200000;0
16022;85336;4715;0;0;0;0;.00nan;0;0
16023;183730;4919;69;37;4;33;.892;3600000;0
16023;-1;165;0;0;0;0;.00nan;0;0
16023;-1;165;56;27;3;24;.889;3600000;0
16023;175658;4919;0;0;0;0;.00nan;0;0
16024;-1;4992;28;30;6;24;.800;3556000;0
16024;182097;4992;0;0;0;0;.00nan;0;0
16024;185812;4997;72;36;4;32;.889;3600000;0
16024;64925;4997;0;0;0;0;.00nan;0;0
16025;37897;4714;0;0;0;0;.00nan;0;0
16025;187391;4246;78;33;2;31;.939;3564000;0
16025;59231;4714;85;15;0;15;1.000;3600000;0
16025;161129;4246;0;0;0;0;.00nan;0;0
16026;183730;4919;0;0;0;0;.00nan;0;0
16026;-1;165;81;21;1;20;.952;3600000;0
16026;-1;165;0;0;0;0;.00nan;0;0
16026;175658;4919;81;38;3;35;.921;3600000;0
16027;169478;4991;0;0;0;0;.00nan;0;0
16027;-1;4992;70;38;3;35;.921;3595000;0
16027;182097;4992;0;0;0;0;.00nan;0;0
16027;85984;4991;90;23;1;22;.957;3600000;0
16028;161583;4839;41;30;5;25;.833;3540000;0
16028;-1;4839;0;0;0;0;.00nan;0;0
16028;181874;4998;0;0;0;0;.00nan;0;0
16028;85228;4998;36;13;3;10;.769;3600000;0
16029;166423;1368;0;0;0;0;.00nan;0;0
16029;175651;4715;0;0;0;0;.00nan;0;0
16029;85336;4715;41;38;6;32;.842;3581000;0
16029;87164;1368;48;26;4;22;.846;3600000;0
16030;169478;4991;73;38;4;34;.895;3587000;0
16030;185812;4997;0;0;0;0;.00nan;0;0
16030;64925;4997;69;23;2;21;.913;3600000;0
16030;85984;4991;0;0;0;0;.00nan;0;0
16031;166423;1368;71;31;3;28;.903;3600000;0
16031;175651;4715;42;20;4;16;.800;3566000;0
16031;85336;4715;0;0;0;0;.00nan;0;0
16031;87164;1368;0;0;0;0;.00nan;0;0
16032;161583;4839;59;31;3;28;.903;3592000;0
16032;-1;4839;0;0;0;0;.00nan;0;0
16032;181874;4998;85;23;1;22;.957;3600000;0
16032;85228;4998;0;0;0;0;.00nan;0;0
16033;183730;4919;69;36;3;33;.917;3600000;0
16033;-1;165;0;0;0;0;.00nan;0;0
16033;-1;165;62;45;5;40;.889;3591000;0
16033;175658;4919;0;0;0;0;.00nan;0;0
16034;37897;4714;0;0;0;0;.00nan;0;0
16034;187391;4246;19;12;5;7;.583;1176000;0
16034;59231;4714;90;30;1;29;.967;3600000;0
16034;161129;4246;25;20;5;15;.750;2424000;0
16035;161583;4839;74;25;1;24;.960;3600000;0
16035;166423;1368;0;0;0;0;.00nan;0;0
16035;-1;4839;0;0;0;0;.00nan;0;0
16035;87164;1368;39;29;5;24;.828;3600000;0
16036;-1;165;81;31;2;29;.935;3600000;0
16036;-1;165;0;0;0;0;.00nan;0;0
16036;175651;4715;0;0;0;0;.00nan;0;0
16036;85336;4715;61;42;6;36;.857;3600000;0
16037;183730;4919;0;0;0;0;.00nan;0;0
16037;175658;4919;64;22;2;20;.909;3600000;0
16037;181874;4998;0;0;0;0;.00nan;0;0
16037;85228;4998;89;49;3;46;.939;3600000;0
16038;169478;4991;0;0;0;0;.00nan;0;0
16038;185812;4997;78;46;4;42;.913;3514000;0
16038;64925;4997;0;0;0;0;.00nan;0;0
16038;85984;4991;70;25;2;23;.920;3600000;0
16039;37897;4714;0;0;0;0;.00nan;0;0
16039;187391;4246;53;27;4;23;.852;3600000;0
16039;59231;4714;100;37;1;36;.973;3600000;0
16039;161129;4246;0;0;0;0;.00nan;0;0
16040;169478;4991;0;0;0;0;.00nan;0;0
16040;185812;4997;0;0;0;0;.00nan;0;0
16040;64925;4997;92;36;2;34;.944;3600000;0
16040;85984;4991;82;36;3;33;.917;3598000;0
16041;-1;165;0;0;0;0;.00nan;0;0
16041;-1;165;56;28;4;24;.857;3600000;0
16041;181874;4998;0;0;0;0;.00nan;0;0
16041;85228;4998;43;30;5;25;.833;3570000;0
16042;161583;4839;0;0;0;0;.00nan;0;0
16042;166423;1368;85;38;3;35;.921;3600000;0
16042;-1;4839;25;23;5;18;.783;3600000;0
16042;87164;1368;0;0;0;0;.00nan;0;0
16043;183730;4919;31;27;6;21;.778;3047000;0
16043;175651;4715;50;25;3;22;.880;3600000;0
16043;175658;4919;37;7;2;5;.714;553000;0
16043;85336;4715;0;0;0;0;.00nan;0;0
16044;37897;4714;62;28;3;25;.893;4200000;0
16044;187391;4246;0;0;0;0;.00nan;0;0
16044;59231;4714;0;0;0;0;.00nan;0;0
16044;161129;4246;100;48;3;45;.938;4200000;0
16045;161583;4839;66;35;4;31;.886;3600000;0
16045;166423;1368;0;0;0;0;.00nan;0;0
16045;-1;4839;0;0;0;0;.00nan;0;0
16045;87164;1368;59;25;3;22;.880;3600000;0
16046;169478;4991;61;34;4;30;.882;3591000;0
16046;185812;4997;75;33;3;30;.909;3600000;0
16046;64925;4997;0;0;0;0;.00nan;0;0
16046;85984;4991;0;0;0;0;.00nan;0;0
16047;-1;165;63;25;3;22;.880;3555000;0
16047;-1;165;0;0;0;0;.00nan;0;0
16047;181874;4998;59;22;2;20;.909;3600000;0
16047;85228;4998;0;0;0;0;.00nan;0;0
16048;183730;4919;0;0;0;0;.00nan;0;0
16048;175651;4715;0;0;0;0;.00nan;0;0
16048;175658;4919;100;37;1;36;.973;3600000;0
16048;85336;4715;35;24;5;19;.792;3600000;0
16049;161583;4839;49;31;5;26;.839;3524000;0
16049;-1;4839;0;0;0;0;.00nan;0;0
16049;37897;4714;0;0;0;0;.00nan;0;0
16049;59231;4714;53;23;3;20;.870;3600000;0
16050;161583;4839;0;0;0;0;.00nan;0;0
16050;-1;4839;55;33;4;29;.879;3600000;0
16050;37897;4714;0;0;0;0;.00nan;0;0
16050;59231;4714;100;27;0;27;1.000;3600000;0
16051;175651;4715;0;0;0;0;.00nan;0;0
16051;181874;4998;0;0;0;0;.00nan;0;0
16051;85228;4998;52;31;4;27;.871;3600000;0
16051;85336;4715;100;30;0;30;1.000;3600000;0
16052;183730;4919;0;0;0;0;.00nan;0;0
16052;166423;1368;0;0;0;0;.00nan;0;0
16052;175658;4919;75;35;4;31;.886;3600000;0
16052;87164;1368;43;32;5;27;.844;3600000;0
16053;-1;4992;26;28;6;22;.786;3511000;0
16053;182097;4992;0;0;0;0;.00nan;0;0
16053;185812;4997;0;0;0;0;.00nan;0;0
16053;64925;4997;58;33;4;29;.879;3600000;0
16054;161583;4839;78;44;4;40;.909;3550000;0
16054;169478;4991;0;0;0;0;.00nan;0;0
16054;-1;4839;0;0;0;0;.00nan;0;0
16054;85984;4991;57;30;3;27;.900;3600000;0
16055;37897;4714;0;0;0;0;.00nan;0;0
16055;187391;4246;0;0;0;0;.00nan;0;0
16055;59231;4714;82;27;1;26;.963;3600000;0
16055;161129;4246;55;25;3;22;.880;3511000;0
16056;161583;4839;0;0;0;0;.00nan;0;0
16056;169478;4991;48;27;4;23;.852;3600000;0
16056;-1;4839;32;37;6;31;.838;3565000;0
16056;85984;4991;0;0;0;0;.00nan;0;0
16057;166423;1368;0;0;0;0;.00nan;0;0
16057;-1;165;63;25;2;23;.920;3600000;0
16057;-1;165;0;0;0;0;.00nan;0;0
16057;87164;1368;49;34;5;29;.853;3600000;0
16058;-1;4992;0;0;0;0;.00nan;0;0
16058;182097;4992;12;23;7;16;.696;3600000;0
16058;185812;4997;0;0;0;0;.00nan;0;0
16058;64925;4997;82;36;2;34;.944;3600000;0
16059;183730;4919;0;0;0;0;.00nan;0;0
16059;175658;4919;53;26;3;23;.885;3600000;0
16059;181874;4998;57;4;0;4;1.000;574000;0
16059;85228;4998;24;37;7;30;.811;3026000;0
16060;37897;4714;65;21;2;19;.905;1138000;0
16060;187391;4246;54;24;3;21;.875;3600000;0
16060;59231;4714;20;28;7;21;.750;2462000;0
16060;161129;4246;0;0;0;0;.00nan;0;0
16061;-1;4992;79;39;4;35;.897;3575000;0
16061;37897;4714;0;0;0;0;.00nan;0;0
16061;182097;4992;0;0;0;0;.00nan;0;0
16061;59231;4714;76;36;3;33;.917;3600000;0
16062;169478;4991;0;0;0;0;.00nan;0;0
16062;-1;4992;23;13;4;9;.692;1006000;0
16062;182097;4992;35;23;5;18;.783;2594000;0
16062;85984;4991;55;24;3;21;.875;3600000;0
16063;161583;4839;49;34;6;28;.824;3600000;0
16063;183730;4919;0;0;0;0;.00nan;0;0
16063;175658;4919;64;27;2;25;.926;3600000;0
16063;-1;4839;0;0;0;0;.00nan;0;0
16064;-1;165;0;0;0;0;.00nan;0;0
16064;-1;165;73;21;1;20;.952;3600000;0
16064;181874;4998;0;0;0;0;.00nan;0;0
16064;85228;4998;38;25;5;20;.800;3600000;0
16065;166423;1368;49;2;0;2;1.000;247000;0
16065;-1;4992;68;42;4;38;.905;3600000;0
16065;182097;4992;0;0;0;0;.00nan;0;0
16065;87164;1368;50;37;6;31;.838;3302000;0
16066;175651;4715;0;0;0;0;.00nan;0;0
16066;185812;4997;62;22;2;20;.909;3568000;0
16066;64925;4997;0;0;0;0;.00nan;0;0
16066;85336;4715;90;15;0;15;1.000;3600000;0
16067;37897;4714;0;0;0;0;.00nan;0;0
16067;187391;4246;59;44;6;38;.864;3680000;0
16067;59231;4714;30;27;7;20;.741;3656000;0
16067;161129;4246;0;0;0;0;.00nan;0;0
16068;161583;4839;0;0;0;0;.00nan;0;0
16068;183730;4919;0;0;0;0;.00nan;0;0
16068;175658;4919;94;40;2;38;.950;3600000;0
16068;-1;4839;66;36;4;32;.889;3525000;0
16069;-1;165;72;35;3;32;.914;3600000;0
16069;-1;165;0;0;0;0;.00nan;0;0
16069;181874;4998;63;47;6;41;.872;3600000;0
16069;85228;4998;0;0;0;0;.00nan;0;0
16070;166423;1368;0;0;0;0;.00nan;0;0
16070;-1;4992;0;0;0;0;.00nan;0;0
16070;182097;4992;85;40;4;36;.900;3600000;0
16070;87164;1368;43;29;5;24;.828;3572000;0
16071;175651;4715;0;0;0;0;.00nan;0;0
16071;185812;4997;0;0;0;0;.00nan;0;0
16071;64925;4997;80;35;3;32;.914;3600000;0
16071;85336;4715;47;29;5;24;.828;3522000;0
16072;37897;4714;0;0;0;0;.00nan;0;0
16072;187391;4246;0;0;0;0;.00nan;0;0
16072;59231;4714;76;39;3;36;.923;4200000;0
16072;161129;4246;52;31;3;28;.903;4200000;0
16073;161583;4839;68;22;2;20;.909;3600000;0
16073;183730;4919;0;0;0;0;.00nan;0;0
16073;175658;4919;74;34;3;31;.912;3546000;0
16073;-1;4839;0;0;0;0;.00nan;0;0
16074;-1;165;0;0;0;0;.00nan;0;0
16074;-1;165;82;34;2;32;.941;3600000;0
16074;181874;4998;0;0;0;0;.00nan;0;0
16074;146184;4998;70;29;3;26;.897;3546000;0
16075;183730;4919;0;0;0;0;.00nan;0;0
16075;175651;4715;43;25;4;21;.840;3866000;0
16075;175658;4919;41;23;5;18;.783;3866000;0
16075;85336;4715;0;0;0;0;.00nan;0;0
16076;-1;4992;0;0;0;0;.00nan;0;0
16076;182097;4992;73;28;2;26;.929;3600000;0
16076;185812;4997;0;0;0;0;.00nan;0;0
16076;64925;4997;66;42;4;38;.905;3546000;0
16077;161583;4839;54;26;4;22;.846;4021000;0
16077;166423;1368;0;0;0;0;.00nan;0;0
16077;-1;4839;0;0;0;0;.00nan;0;0
16077;87164;1368;42;35;5;30;.857;4021000;0
16078;169478;4991;62;29;4;25;.862;3600000;0
16078;37897;4714;0;0;0;0;.00nan;0;0
16078;59231;4714;66;30;3;27;.900;3600000;0
16078;85984;4991;0;0;0;0;.00nan;0;0
16079;169478;4991;0;0;0;0;.00nan;0;0
16079;37897;4714;0;0;0;0;.00nan;0;0
16079;59231;4714;36;37;7;30;.811;3600000;0
16079;85984;4991;82;36;3;33;.917;3600000;0
16080;-1;4992;57;31;4;27;.871;3600000;0
16080;182097;4992;0;0;0;0;.00nan;0;0
16080;185812;4997;23;34;7;27;.794;3600000;0
16080;64925;4997;0;0;0;0;.00nan;0;0
16081;-1;165;86;35;2;33;.943;3600000;0
16081;-1;165;0;0;0;0;.00nan;0;0
16081;181874;4998;0;0;0;0;.00nan;0;0
16081;146184;4998;66;41;4;37;.902;3571000;0
16082;183730;4919;0;0;0;0;.00nan;0;0
16082;175651;4715;0;0;0;0;.00nan;0;0
16082;175658;4919;53;52;6;46;.885;4200000;0
16082;85336;4715;30;27;6;21;.778;4200000;0
16083;161583;4839;0;0;0;0;.00nan;0;0
16083;166423;1368;46;36;5;31;.861;4200000;0
16083;-1;4839;70;41;5;36;.878;4200000;0
16083;87164;1368;0;0;0;0;.00nan;0;0
16084;161583;4839;0;0;0;0;.00nan;0;0
16084;175651;4715;0;0;0;0;.00nan;0;0
16084;-1;4839;82;41;3;38;.927;4200000;0
16084;85336;4715;67;33;3;30;.909;4200000;0
16085;161583;4839;57;28;3;25;.893;3600000;0
16085;175651;4715;46;22;4;18;.818;3591000;0
16085;-1;4839;0;0;0;0;.00nan;0;0
16085;85336;4715;0;0;0;0;.00nan;0;0
16086;183730;4919;0;0;0;0;.00nan;0;0
16086;-1;165;0;0;0;0;.00nan;0;0
16086;-1;165;46;23;4;19;.826;3600000;0
16086;175658;4919;60;47;6;41;.872;3541000;0
16087;166423;1368;0;0;0;0;.00nan;0;0
16087;-1;4992;0;0;0;0;.00nan;0;0
16087;182097;4992;28;25;6;19;.760;3579000;0
16087;87164;1368;57;30;4;26;.867;3600000;0
16088;185812;4997;95;31;1;30;.968;3600000;0
16088;187391;4246;86;32;2;30;.938;3562000;0
16088;64925;4997;0;0;0;0;.00nan;0;0
16088;161129;4246;0;0;0;0;.00nan;0;0
16089;169478;4991;0;0;0;0;.00nan;0;0
16089;37897;4714;0;0;0;0;.00nan;0;0
16089;59231;4714;82;33;2;31;.939;3600000;0
16089;85984;4991;51;41;5;36;.878;3600000;0
16090;166423;1368;0;0;0;0;.00nan;0;0
16090;-1;4992;38;33;6;27;.818;3600000;0
16090;182097;4992;0;0;0;0;.00nan;0;0
16090;87164;1368;55;28;4;24;.857;3600000;0
16091;183730;4919;67;15;1;14;.933;1805000;0
16091;175658;4919;20;22;6;16;.727;1816000;0
16091;181874;4998;0;0;0;0;.00nan;0;0
16091;146184;4998;42;31;6;25;.806;3623000;0
16092;-1;165;27;29;6;23;.793;3600000;0
16092;-1;165;0;0;0;0;.00nan;0;0
16092;175651;4715;0;0;0;0;.00nan;0;0
16092;85336;4715;92;51;3;48;.941;3600000;0
16093;185812;4997;0;0;0;0;.00nan;0;0
16093;187391;4246;0;0;0;0;.00nan;0;0
16093;64925;4997;46;20;3;17;.850;3680000;0
16093;161129;4246;49;23;4;19;.826;3680000;0
16094;169478;4991;62;27;3;24;.889;3600000;0
16094;37897;4714;100;45;2;43;.956;3600000;0
16094;59231;4714;0;0;0;0;.00nan;0;0
16094;85984;4991;0;0;0;0;.00nan;0;0
16095;166423;1368;55;18;2;16;.889;3600000;0
16095;-1;4992;41;10;2;8;.800;970000;0
16095;182097;4992;24;27;6;21;.778;2630000;0
16095;87164;1368;0;0;0;0;.00nan;0;0
16096;166423;1368;0;0;0;0;.00nan;0;0
16096;-1;165;0;0;0;0;.00nan;0;0
16096;-1;165;36;26;5;21;.808;3600000;0
16096;87164;1368;83;37;2;35;.946;3600000;0
16097;161583;4839;0;0;0;0;.00nan;0;0
16097;175651;4715;0;0;0;0;.00nan;0;0
16097;-1;4839;55;28;3;25;.893;3572000;0
16097;85336;4715;85;27;1;26;.963;3600000;0
16098;-1;4992;59;28;4;24;.857;3701000;0
16098;182097;4992;0;0;0;0;.00nan;0;0
16098;187391;4246;64;42;5;37;.881;3701000;0
16098;161129;4246;0;0;0;0;.00nan;0;0
16099;169478;4991;0;0;0;0;.00nan;0;0
16099;181874;4998;53;16;2;14;.875;1295000;0
16099;85984;4991;100;27;0;27;1.000;3600000;0
16099;146184;4998;55;29;4;25;.862;2305000;0
16100;37897;4714;0;0;0;0;.00nan;0;0
16100;185812;4997;84;48;4;44;.917;4178000;0
16100;59231;4714;59;33;4;29;.879;4200000;0
16100;64925;4997;0;0;0;0;.00nan;0;0
16101;169478;4991;28;17;4;13;.765;4200000;0
16101;181874;4998;0;0;0;0;.00nan;0;0
16101;85984;4991;0;0;0;0;.00nan;0;0
16101;146184;4998;74;39;4;35;.897;4200000;0
16102;-1;4992;0;0;0;0;.00nan;0;0
16102;182097;4992;44;17;3;14;.824;3600000;0
16102;187391;4246;0;0;0;0;.00nan;0;0
16102;161129;4246;50;52;7;45;.865;3600000;0
16103;161583;4839;58;27;4;23;.852;3600000;0
16103;175651;4715;25;21;6;15;.714;3260000;0
16103;-1;4839;0;0;0;0;.00nan;0;0
16103;85336;4715;49;1;0;1;1.000;315000;0
16104;37897;4714;32;13;4;9;.692;1049000;0
16104;185812;4997;0;0;0;0;.00nan;0;0
16104;59231;4714;67;19;1;18;.947;2551000;0
16104;64925;4997;79;24;1;23;.958;3600000;0
16105;183730;4919;81;26;1;25;.962;3600000;0
16105;166423;1368;0;0;0;0;.00nan;0;0
16105;175658;4919;0;0;0;0;.00nan;0;0
16105;87164;1368;45;27;4;23;.852;3600000;0
16106;-1;4992;40;19;3;16;.842;3564000;0
16106;182097;4992;0;0;0;0;.00nan;0;0
16106;187391;4246;58;22;2;20;.909;3600000;0
16106;161129;4246;0;0;0;0;.00nan;0;0
16107;183730;4919;0;0;0;0;.00nan;0;0
16107;166423;1368;100;32;0;32;1.000;3600000;0
16107;175658;4919;65;28;4;24;.857;3600000;0
16107;87164;1368;0;0;0;0;.00nan;0;0
16108;169478;4991;0;0;0;0;.00nan;0;0
16108;185812;4997;70;32;3;29;.906;3589000;0
16108;64925;4997;0;0;0;0;.00nan;0;0
16108;85984;4991;74;23;2;21;.913;3600000;0
16109;175651;4715;0;0;0;0;.00nan;0;0
16109;181874;4998;0;0;0;0;.00nan;0;0
16109;85336;4715;80;38;3;35;.921;3572000;0
16109;146184;4998;71;23;2;21;.913;3600000;0
16110;161583;4839;40;4;2;2;.500;443000;0
16110;183730;4919;0;0;0;0;.00nan;0;0
16110;175658;4919;51;26;4;22;.846;3600000;0
16110;-1;4839;31;28;6;22;.786;3157000;0
16111;185812;4997;0;0;0;0;.00nan;0;0
16111;187391;4246;0;0;0;0;.00nan;0;0
16111;64925;4997;32;25;5;20;.800;3600000;0
16111;161129;4246;53;23;3;20;.870;3600000;0
16112;166423;1368;56;41;5;36;.878;3591000;0
16112;-1;165;56;26;4;22;.846;3600000;0
16112;-1;165;0;0;0;0;.00nan;0;0
16112;87164;1368;0;0;0;0;.00nan;0;0
16113;166423;1368;0;0;0;0;.00nan;0;0
16113;-1;165;0;0;0;0;.00nan;0;0
16113;-1;165;64;36;3;33;.917;4191000;0
16113;87164;1368;85;39;2;37;.949;4191000;0
16114;161583;4839;100;48;2;46;.958;3600000;0
16114;183730;4919;0;0;0;0;.00nan;0;0
16114;175658;4919;51;23;3;20;.870;3600000;0
16114;-1;4839;0;0;0;0;.00nan;0;0
16115;175651;4715;60;36;4;32;.889;3590000;0
16115;181874;4998;0;0;0;0;.00nan;0;0
16115;85336;4715;0;0;0;0;.00nan;0;0
16115;146184;4998;55;14;2;12;.857;3600000;0
16116;169478;4991;0;0;0;0;.00nan;0;0
16116;-1;4992;55;27;3;24;.889;3600000;0
16116;182097;4992;0;0;0;0;.00nan;0;0
16116;85984;4991;100;29;0;29;1.000;3600000;0
16117;37897;4714;0;0;0;0;.00nan;0;0
16117;185812;4997;66;38;4;34;.895;4134000;0
16117;59231;4714;52;29;5;24;.828;4133000;0
16117;64925;4997;0;0;0;0;.00nan;0;0
16118;-1;165;38;22;4;18;.818;3600000;0
16118;-1;165;0;0;0;0;.00nan;0;0
16118;175651;4715;0;0;0;0;.00nan;0;0
16118;85336;4715;69;24;2;22;.917;3600000;0
16119;-1;165;0;0;0;0;.00nan;0;0
16119;-1;165;39;23;4;19;.826;3546000;0
16119;175651;4715;0;0;0;0;.00nan;0;0
16119;85336;4715;73;31;3;28;.903;3600000;0
16120;169478;4991;0;0;0;0;.00nan;0;0
16120;-1;4992;0;0;0;0;.00nan;0;0
16120;182097;4992;58;26;3;23;.885;3589000;0
16120;85984;4991;74;22;1;21;.955;3600000;0
16121;161583;4839;58;34;3;31;.912;3546000;0
16121;166423;1368;0;0;0;0;.00nan;0;0
16121;-1;4839;0;0;0;0;.00nan;0;0
16121;87164;1368;64;19;2;17;.895;3600000;0
16122;175651;4715;0;0;0;0;.00nan;0;0
16122;-1;4992;71;39;4;35;.897;3600000;0
16122;182097;4992;0;0;0;0;.00nan;0;0
16122;85336;4715;85;33;3;30;.909;3600000;0
16123;183730;4919;0;0;0;0;.00nan;0;0
16123;175658;4919;87;32;2;30;.938;3600000;0
16123;181874;4998;0;0;0;0;.00nan;0;0
16123;146184;4998;74;42;4;38;.905;3574000;0
16124;185812;4997;0;0;0;0;.00nan;0;0
16124;187391;4246;0;0;0;0;.00nan;0;0
16124;64925;4997;74;26;2;24;.923;3600000;0
16124;161129;4246;55;26;3;23;.885;3597000;0
16125;169478;4991;0;0;0;0;.00nan;0;0
16125;37897;4714;0;0;0;0;.00nan;0;0
16125;59231;4714;56;29;4;25;.862;3762000;0
16125;85984;4991;49;30;5;25;.833;3762000;0
16126;161583;4839;0;0;0;0;.00nan;0;0
16126;166423;1368;24;21;5;16;.762;3549000;0
16126;-1;4839;80;39;3;36;.923;3600000;0
16126;87164;1368;0;0;0;0;.00nan;0;0
16127;175651;4715;75;26;2;24;.923;3600000;0
16127;-1;4992;0;0;0;0;.00nan;0;0
16127;182097;4992;73;36;3;33;.917;3549000;0
16127;85336;4715;0;0;0;0;.00nan;0;0
16128;185812;4997;50;29;4;25;.862;3582000;0
16128;187391;4246;53;22;3;19;.864;3600000;0
16128;64925;4997;0;0;0;0;.00nan;0;0
16128;161129;4246;0;0;0;0;.00nan;0;0
16129;183730;4919;62;34;3;31;.912;3600000;0
16129;175658;4919;0;0;0;0;.00nan;0;0
16129;181874;4998;0;0;0;0;.00nan;0;0
16129;146184;4998;71;27;2;25;.926;3600000;0
16130;169478;4991;87;47;4;43;.915;4200000;0
16130;37897;4714;0;0;0;0;.00nan;0;0
16130;59231;4714;62;38;4;34;.895;4200000;0
16130;85984;4991;0;0;0;0;.00nan;0;0
16131;183730;4919;0;0;0;0;.00nan;0;0
16131;175658;4919;63;24;3;21;.875;3600000;0
16131;181874;4998;56;43;6;37;.860;3600000;0
16131;146184;4998;0;0;0;0;.00nan;0;0
16132;183730;4919;0;0;0;0;.00nan;0;0
16132;-1;165;57;31;4;27;.871;3600000;0
16132;-1;165;0;0;0;0;.00nan;0;0
16132;175658;4919;55;39;5;34;.872;3522000;0
16133;175651;4715;0;0;0;0;.00nan;0;0
16133;181874;4998;0;0;0;0;.00nan;0;0
16133;85336;4715;75;44;4;40;.909;3600000;0
16133;146184;4998;56;17;2;15;.882;3600000;0
16134;-1;4992;63;20;2;18;.900;3600000;0
16134;37897;4714;0;0;0;0;.00nan;0;0
16134;182097;4992;0;0;0;0;.00nan;0;0
16134;59231;4714;21;37;8;29;.784;3600000;0
16135;169478;4991;0;0;0;0;.00nan;0;0
16135;187391;4246;0;0;0;0;.00nan;0;0
16135;85984;4991;62;21;2;19;.905;3600000;0
16135;161129;4246;65;34;4;30;.882;3516000;0
16136;166423;1368;0;0;0;0;.00nan;0;0
16136;185812;4997;0;0;0;0;.00nan;0;0
16136;64925;4997;88;32;2;30;.938;3600000;0
16136;87164;1368;60;27;3;24;.889;3545000;0
16137;169478;4991;72;36;3;33;.917;3574000;0
16137;37897;4714;88;30;1;29;.967;3600000;0
16137;59231;4714;0;0;0;0;.00nan;0;0
16137;85984;4991;0;0;0;0;.00nan;0;0
16138;166423;1368;36;35;6;29;.829;3613000;0
16138;185812;4997;49;33;5;28;.848;3613000;0
16138;64925;4997;0;0;0;0;.00nan;0;0
16138;87164;1368;0;0;0;0;.00nan;0;0
16139;183730;4919;69;36;3;33;.917;3564000;0
16139;-1;165;0;0;0;0;.00nan;0;0
16139;-1;165;73;29;2;27;.931;3600000;0
16139;175658;4919;0;0;0;0;.00nan;0;0
16140;175651;4715;93;33;1;32;.970;4200000;0
16140;181874;4998;99;39;1;38;.974;4200000;0
16140;85336;4715;0;0;0;0;.00nan;0;0
16140;146184;4998;0;0;0;0;.00nan;0;0
16141;-1;4992;0;0;0;0;.00nan;0;0
16141;182097;4992;73;32;4;28;.875;3843000;0
16141;187391;4246;43;29;5;24;.828;3843000;0
16141;161129;4246;0;0;0;0;.00nan;0;0
16142;166423;1368;0;0;0;0;.00nan;0;0
16142;185812;4997;0;0;0;0;.00nan;0;0
16142;64925;4997;72;27;2;25;.926;3600000;0
16142;87164;1368;42;29;5;24;.828;3600000;0
16143;-1;165;0;0;0;0;.00nan;0;0
16143;-1;165;82;40;3;37;.925;3600000;0
16143;181874;4998;0;0;0;0;.00nan;0;0
16143;146184;4998;60;28;4;24;.857;3600000;0
16144;-1;4992;22;4;3;1;.250;343000;0
16144;182097;4992;61;29;3;26;.897;3257000;0
16144;187391;4246;0;0;0;0;.00nan;0;0
16144;161129;4246;71;31;2;29;.935;3600000;0
16145;169478;4991;0;0;0;0;.00nan;0;0
16145;187391;4246;0;0;0;0;.00nan;0;0
16145;85984;4991;51;25;4;21;.840;3600000;0
16145;161129;4246;32;36;6;30;.833;3600000;0
16146;183730;4919;0;0;0;0;.00nan;0;0
16146;175651;4715;0;0;0;0;.00nan;0;0
16146;175658;4919;78;28;2;26;.929;4200000;0
16146;85336;4715;75;36;2;34;.944;4200000;0
16147;161583;4839;46;23;3;20;.870;3600000;0
16147;-1;4839;0;0;0;0;.00nan;0;0
16147;185812;4998;75;11;0;11;1.000;3600000;0
16147;146184;4998;0;0;0;0;.00nan;0;0
16148;166423;1368;0;0;0;0;.00nan;0;0
16148;-1;4992;61;27;3;24;.889;3600000;0
16148;182097;4992;0;0;0;0;.00nan;0;0
16148;87164;1368;62;22;2;20;.909;3600000;0
16149;187657;4997;0;0;0;0;.00nan;0;0
16149;37897;4714;0;0;0;0;.00nan;0;0
16149;59231;4714;58;26;3;23;.885;3600000;0
16149;64925;4997;100;35;0;35;1.000;3600000;0
16150;169478;4991;78;25;1;24;.960;3600000;0
16150;187391;4246;2;21;7;14;.667;2060000;0
16150;85984;4991;0;0;0;0;.00nan;0;0
16150;161129;4246;58;15;1;14;.933;1540000;0
16151;166423;1368;66;31;3;28;.903;3600000;0
16151;-1;4992;0;0;0;0;.00nan;0;0
16151;182097;4992;64;36;4;32;.889;3564000;0
16151;87164;1368;0;0;0;0;.00nan;0;0
16152;183730;4919;58;26;3;23;.885;3600000;0
16152;175651;4715;55;32;4;28;.875;3600000;0
16152;175658;4919;0;0;0;0;.00nan;0;0
16152;85336;4715;0;0;0;0;.00nan;0;0
16153;161583;4839;0;0;0;0;.00nan;0;0
16153;-1;4839;76;38;3;35;.921;3566000;0
16153;185812;4998;0;0;0;0;.00nan;0;0
16153;146184;4998;81;23;1;22;.957;3600000;0
16154;169478;4991;0;0;0;0;.00nan;0;0
16154;187391;4246;0;0;0;0;.00nan;0;0
16154;85984;4991;51;24;3;21;.875;3982000;0
16154;161129;4246;69;38;4;34;.895;3982000;0
16155;161583;4839;42;30;5;25;.833;3600000;0
16155;-1;4839;0;0;0;0;.00nan;0;0
16155;185812;4998;80;28;2;26;.929;3600000;0
16155;146184;4998;0;0;0;0;.00nan;0;0
16156;183730;4919;0;0;0;0;.00nan;0;0
16156;-1;165;61;24;2;22;.917;3600000;0
16156;-1;165;0;0;0;0;.00nan;0;0
16156;175658;4919;62;26;3;23;.885;3558000;0
16157;187657;4997;0;0;0;0;.00nan;0;0
16157;169478;4991;0;0;0;0;.00nan;0;0
16157;64925;4997;62;21;2;19;.905;3600000;0
16157;85984;4991;65;43;5;38;.884;3600000;0
16158;-1;165;0;0;0;0;.00nan;0;0
16158;-1;165;54;27;3;24;.889;3559000;0
16158;175651;4715;0;0;0;0;.00nan;0;0
16158;85336;4715;87;29;1;28;.966;3600000;0
16159;161583;4839;0;0;0;0;.00nan;0;0
16159;-1;4992;25;29;6;23;.793;3545000;0
16159;-1;4839;69;39;4;35;.897;3600000;0
16159;182097;4992;0;0;0;0;.00nan;0;0
16160;183730;4919;0;0;0;0;.00nan;0;0
16160;166423;1368;0;0;0;0;.00nan;0;0
16160;175658;4919;28;21;6;15;.714;3910000;0
16160;87164;1368;60;30;5;25;.833;3910000;0
16161;37897;4714;0;0;0;0;.00nan;0;0
16161;187391;4246;32;23;5;18;.783;1987000;0
16161;59231;4714;50;23;3;20;.870;3600000;0
16161;161129;4246;66;12;0;12;1.000;1587000;0
16162;169478;4991;63;13;1;12;.923;3600000;0
16162;187391;4246;73;33;3;30;.909;3301000;0
16162;85984;4991;0;0;0;0;.00nan;0;0
16162;161129;4246;22;4;3;1;.250;299000;0
16163;183730;4919;85;27;2;25;.926;3600000;0
16163;166423;1368;56;44;6;38;.864;2999000;0
16163;175658;4919;0;0;0;0;.00nan;0;0
16163;87164;1368;39;6;2;4;.667;601000;0
16164;-1;165;51;32;5;27;.844;3600000;0
16164;-1;165;0;0;0;0;.00nan;0;0
16164;185812;4998;100;44;2;42;.955;3600000;0
16164;146184;4998;0;0;0;0;.00nan;0;0
16165;161583;4839;67;42;4;38;.905;3600000;0
16165;-1;4992;0;0;0;0;.00nan;0;0
16165;-1;4839;0;0;0;0;.00nan;0;0
16165;182097;4992;45;18;3;15;.833;3600000;0
16166;187657;4997;0;0;0;0;.00nan;0;0
16166;37897;4714;0;0;0;0;.00nan;0;0
16166;59231;4714;87;36;2;34;.944;3600000;0
16166;64925;4997;45;29;5;24;.828;3600000;0
16167;166423;1368;58;8;0;8;1.000;714000;0
16167;-1;4992;46;19;3;16;.842;3600000;0
16167;182097;4992;0;0;0;0;.00nan;0;0
16167;87164;1368;15;38;9;29;.763;2886000;0
16168;169478;4991;0;0;0;0;.00nan;0;0
16168;187391;4246;70;40;3;37;.925;4184000;0
16168;85984;4991;60;29;3;26;.897;4200000;0
16168;161129;4246;0;0;0;0;.00nan;0;0
16169;161583;4839;0;0;0;0;.00nan;0;0
16169;183730;4919;0;0;0;0;.00nan;0;0
16169;175658;4919;63;21;2;19;.905;4200000;0
16169;-1;4839;97;50;2;48;.960;4200000;0
16170;187657;4997;0;0;0;0;.00nan;0;0
16170;37897;4714;0;0;0;0;.00nan;0;0
16170;59231;4714;72;25;2;23;.920;3600000;0
16170;64925;4997;74;36;3;33;.917;3600000;0
16171;-1;165;0;0;0;0;.00nan;0;0
16171;-1;165;83;28;2;26;.929;3600000;0
16171;37897;4714;0;0;0;0;.00nan;0;0
16171;59231;4714;75;39;4;35;.897;3568000;0
16172;161583;4839;42;34;6;28;.824;3742000;0
16172;166423;1368;0;0;0;0;.00nan;0;0
16172;-1;4839;0;0;0;0;.00nan;0;0
16172;87164;1368;40;27;5;22;.815;3742000;0
16173;175651;4715;0;0;0;0;.00nan;0;0
16173;185812;4998;49;20;3;17;.850;3554000;0
16173;85336;4715;89;35;2;33;.943;3600000;0
16173;146184;4998;0;0;0;0;.00nan;0;0
16174;169478;4991;0;0;0;0;.00nan;0;0
16174;-1;4992;87;47;3;44;.936;3600000;0
16174;182097;4992;0;0;0;0;.00nan;0;0
16174;85984;4991;30;17;4;13;.765;3554000;0
16175;187657;4997;0;0;0;0;.00nan;0;0
16175;187391;4246;0;0;0;0;.00nan;0;0
16175;64925;4997;37;27;6;21;.778;3592000;0
16175;161129;4246;64;27;3;24;.889;3600000;0
16176;161583;4839;0;0;0;0;.00nan;0;0
16176;166423;1368;69;28;3;25;.893;3600000;0
16176;-1;4839;42;31;5;26;.839;3600000;0
16176;87164;1368;0;0;0;0;.00nan;0;0
16177;169478;4991;83;26;1;25;.962;3600000;0
16177;-1;4992;0;0;0;0;.00nan;0;0
16177;182097;4992;86;40;4;36;.900;3600000;0
16177;85984;4991;0;0;0;0;.00nan;0;0
16178;187657;4997;56;25;3;22;.880;3600000;0
16178;187391;4246;51;25;4;21;.840;3600000;0
16178;64925;4997;0;0;0;0;.00nan;0;0
16178;161129;4246;0;0;0;0;.00nan;0;0
16179;-1;165;57;29;4;25;.862;3600000;0
16179;-1;165;0;0;0;0;.00nan;0;0
16179;37897;4714;0;0;0;0;.00nan;0;0
16179;59231;4714;87;32;3;29;.906;3600000;0
16180;183730;4919;0;0;0;0;.00nan;0;0
16180;175658;4919;79;25;2;23;.920;3600000;0
16180;185812;4998;0;0;0;0;.00nan;0;0
16180;146184;4998;31;36;7;29;.806;3600000;0
16181;161583;4839;65;34;4;30;.882;3600000;0
16181;166423;1368;0;0;0;0;.00nan;0;0
16181;-1;4839;0;0;0;0;.00nan;0;0
16181;87164;1368;58;11;1;10;.909;3600000;0
16182;183730;4919;51;20;3;17;.850;3600000;0
16182;-1;165;0;0;0;0;.00nan;0;0
16182;-1;165;41;27;5;22;.815;3579000;0
16182;175658;4919;0;0;0;0;.00nan;0;0
16183;187657;4997;0;0;0;0;.00nan;0;0
16183;187391;4246;0;0;0;0;.00nan;0;0
16183;64925;4997;73;38;4;34;.895;4200000;0
16183;161129;4246;49;30;4;26;.867;4200000;0
16184;175651;4715;43;13;2;11;.846;1478000;0
16184;185812;4998;58;26;3;23;.885;3600000;0
16184;85336;4715;44;20;4;16;.800;2122000;0
16184;146184;4998;0;0;0;0;.00nan;0;0
16185;169478;4991;0;0;0;0;.00nan;0;0
16185;-1;4992;76;35;3;32;.914;4200000;0
16185;182097;4992;0;0;0;0;.00nan;0;0
16185;85984;4991;79;34;3;31;.912;4200000;0
16186;183730;4919;48;0;0;0;.00nan;283000;0
16186;-1;165;80;31;2;29;.935;3600000;0
16186;-1;165;0;0;0;0;.00nan;0;0
16186;175658;4919;52;43;6;37;.860;3317000;0
16187;161583;4839;74;34;3;31;.912;3600000;0
16187;175651;4715;0;0;0;0;.00nan;0;0
16187;-1;4839;0;0;0;0;.00nan;0;0
16187;85336;4715;44;24;5;19;.792;3558000;0
16188;-1;4992;0;0;0;0;.00nan;0;0
16188;182097;4992;44;32;5;27;.844;3600000;0
16188;185812;4998;74;26;2;24;.923;3600000;0
16188;146184;4998;0;0;0;0;.00nan;0;0
16189;169478;4991;45;5;1;4;.800;1114000;0
16189;187391;4246;57;36;4;32;.889;3600000;0
16189;85984;4991;34;32;6;26;.813;2486000;0
16189;161129;4246;0;0;0;0;.00nan;0;0
16190;187657;4997;0;0;0;0;.00nan;0;0
16190;166423;1368;0;0;0;0;.00nan;0;0
16190;64925;4997;51;44;6;38;.864;3600000;0
16190;87164;1368;60;25;3;22;.880;3600000;0
16191;169478;4991;45;28;5;23;.821;3600000;0
16191;187391;4246;0;0;0;0;.00nan;0;0
16191;85984;4991;0;0;0;0;.00nan;0;0
16191;161129;4246;77;30;2;28;.933;3600000;0
16192;161583;4839;0;0;0;0;.00nan;0;0
16192;175651;4715;0;0;0;0;.00nan;0;0
16192;-1;4839;61;27;4;23;.852;3600000;0
16192;85336;4715;54;25;3;22;.880;3600000;0
16193;-1;4992;54;33;4;29;.879;3600000;0
16193;182097;4992;0;0;0;0;.00nan;0;0
16193;185812;4998;0;0;0;0;.00nan;0;0
16193;146184;4998;52;30;5;25;.833;3567000;0
16194;187657;4997;73;23;2;21;.913;3600000;0
16194;166423;1368;27;8;3;5;.625;483000;0
16194;64925;4997;0;0;0;0;.00nan;0;0
16194;87164;1368;78;22;1;21;.955;3066000;0
16195;183730;4919;77;49;4;45;.918;3600000;0
16195;-1;165;49;2;0;2;1.000;261000;0
16195;-1;165;16;26;7;19;.731;3339000;0
16195;175658;4919;0;0;0;0;.00nan;0;0
16196;183730;4919;0;0;0;0;.00nan;0;0
16196;-1;165;91;49;3;46;.939;3712000;0
16196;-1;165;0;0;0;0;.00nan;0;0
16196;175658;4919;69;21;2;19;.905;3712000;0
16197;187657;4997;0;0;0;0;.00nan;0;0
16197;166423;1368;64;37;4;33;.892;3559000;0
16197;64925;4997;79;29;2;27;.931;3600000;0
16197;87164;1368;0;0;0;0;.00nan;0;0
16198;161583;4839;86;39;2;37;.949;3600000;0
16198;187657;4997;0;0;0;0;.00nan;0;0
16198;-1;4839;0;0;0;0;.00nan;0;0
16198;64925;4997;51;21;3;18;.857;3555000;0
16199;37897;4714;0;0;0;0;.00nan;0;0
16199;187391;4246;75;23;2;21;.913;3526000;0
16199;59231;4714;100;29;0;29;1.000;3600000;0
16199;161129;4246;0;0;0;0;.00nan;0;0
16200;161583;4839;0;0;0;0;.00nan;0;0
16200;-1;165;0;0;0;0;.00nan;0;0
16200;-1;165;64;22;3;19;.864;3600000;0
16200;-1;4839;68;47;5;42;.894;3600000;0
16201;183730;4919;0;0;0;0;.00nan;0;0
16201;175658;4919;22;25;6;19;.760;3600000;0
16201;185812;4998;68;34;3;31;.912;3600000;0
16201;146184;4998;0;0;0;0;.00nan;0;0
16202;187657;4997;58;45;6;39;.867;3934000;0
16202;166423;1368;0;0;0;0;.00nan;0;0
16202;64925;4997;0;0;0;0;.00nan;0;0
16202;87164;1368;37;31;5;26;.839;3934000;0
16203;169478;4991;0;0;0;0;.00nan;0;0
16203;-1;4992;24;21;6;15;.714;2291000;0
16203;182097;4992;62;8;0;8;1.000;1309000;0
16203;85984;4991;12;32;8;24;.750;3580000;0
16204;37897;4714;0;0;0;0;.00nan;0;0
16204;187391;4246;0;0;0;0;.00nan;0;0
16204;59231;4714;100;25;0;25;1.000;3600000;0
16204;161129;4246;60;31;3;28;.903;3600000;0
16205;166423;1368;0;0;0;0;.00nan;0;0
16205;-1;165;53;27;3;24;.889;4200000;0
16205;-1;165;0;0;0;0;.00nan;0;0
16205;87164;1368;76;39;3;36;.923;4200000;0
16206;183730;4919;75;26;1;25;.962;3600000;0
16206;175651;4715;0;0;0;0;.00nan;0;0
16206;175658;4919;0;0;0;0;.00nan;0;0
16206;85336;4715;66;32;3;29;.906;3541000;0
16207;169478;4991;65;28;4;24;.857;3573000;0
16207;-1;4992;0;0;0;0;.00nan;0;0
16207;182097;4992;76;34;2;32;.941;3600000;0
16207;85984;4991;0;0;0;0;.00nan;0;0
16208;161583;4839;52;35;5;30;.857;3600000;0
16208;187657;4997;0;0;0;0;.00nan;0;0
16208;-1;4839;0;0;0;0;.00nan;0;0
16208;64925;4997;78;30;2;28;.933;3600000;0
16209;37897;4714;0;0;0;0;.00nan;0;0
16209;187391;4246;85;45;3;42;.933;3570000;0
16209;59231;4714;71;19;1;18;.947;3600000;0
16209;161129;4246;0;0;0;0;.00nan;0;0
16210;175651;4715;60;34;5;29;.853;3600000;0
16210;185812;4998;76;28;2;26;.929;3600000;0
16210;85336;4715;0;0;0;0;.00nan;0;0
16210;146184;4998;0;0;0;0;.00nan;0;0
16211;37897;4714;80;24;2;22;.917;3600000;0
16211;187391;4246;0;0;0;0;.00nan;0;0
16211;59231;4714;0;0;0;0;.00nan;0;0
16211;161129;4246;54;36;5;31;.861;3600000;0
16212;-1;165;0;0;0;0;.00nan;0;0
16212;-1;165;62;25;3;22;.880;3600000;0
16212;175651;4715;0;0;0;0;.00nan;0;0
16212;85336;4715;57;26;4;22;.846;3600000;0
16213;-1;165;0;0;0;0;.00nan;0;0
16213;-1;165;57;36;5;31;.861;3600000;0
16213;185812;4998;41;35;6;29;.829;3572000;0
16213;146184;4998;0;0;0;0;.00nan;0;0
16214;183730;4919;0;0;0;0;.00nan;0;0
16214;175651;4715;0;0;0;0;.00nan;0;0
16214;175658;4919;29;24;5;19;.792;3600000;0
16214;85336;4715;85;34;2;32;.941;3600000;0
16215;187657;4997;0;0;0;0;.00nan;0;0
16215;-1;4992;0;0;0;0;.00nan;0;0
16215;182097;4992;68;27;2;25;.926;3600000;0
16215;64925;4997;99;34;1;33;.971;3600000;0
16216;169478;4991;0;0;0;0;.00nan;0;0
16216;37897;4714;0;0;0;0;.00nan;0;0
16216;59231;4714;100;28;0;28;1.000;3600000;0
16216;85984;4991;44;29;5;24;.828;3600000;0
16217;161583;4839;91;35;2;33;.943;3600000;0
16217;-1;4839;0;0;0;0;.00nan;0;0
16217;187391;4246;41;25;4;21;.840;3556000;0
16217;161129;4246;0;0;0;0;.00nan;0;0
16218;-1;165;59;17;2;15;.882;3600000;0
16218;-1;165;0;0;0;0;.00nan;0;0
16218;185812;4998;0;0;0;0;.00nan;0;0
16218;146184;4998;60;32;4;28;.875;3539000;0
16219;187657;4997;68;33;3;30;.909;4200000;0
16219;-1;4992;68;34;3;31;.912;4200000;0
16219;182097;4992;0;0;0;0;.00nan;0;0
16219;64925;4997;0;0;0;0;.00nan;0;0
16220;183730;4919;89;44;4;40;.909;4200000;0
16220;175651;4715;48;26;4;22;.846;4200000;0
16220;175658;4919;0;0;0;0;.00nan;0;0
16220;85336;4715;0;0;0;0;.00nan;0;0
16221;161583;4839;0;0;0;0;.00nan;0;0
16221;-1;4839;69;33;4;29;.879;3566000;0
16221;187391;4246;0;0;0;0;.00nan;0;0
16221;161129;4246;63;24;3;21;.875;3600000;0
16222;169478;4991;56;39;5;34;.872;3600000;0
16222;37897;4714;0;0;0;0;.00nan;0;0
16222;59231;4714;84;32;2;30;.938;3600000;0
16222;85984;4991;0;0;0;0;.00nan;0;0
16223;175651;4715;0;0;0;0;.00nan;0;0
16223;185812;4998;52;41;6;35;.854;3322000;0
16223;85336;4715;72;31;3;28;.903;3600000;0
16223;146184;4998;52;2;0;2;1.000;278000;0
16224;187657;4997;0;0;0;0;.00nan;0;0
16224;37897;4714;0;0;0;0;.00nan;0;0
16224;59231;4714;59;18;2;16;.889;3600000;0
16224;64925;4997;56;25;4;21;.840;3571000;0
16225;187657;4997;84;39;2;37;.949;4200000;0
16225;169478;4991;0;0;0;0;.00nan;0;0
16225;64925;4997;0;0;0;0;.00nan;0;0
16225;85984;4991;92;43;2;41;.953;4200000;0
16226;37897;4714;0;0;0;0;.00nan;0;0
16226;187391;4246;78;35;3;32;.914;3567000;0
16226;59231;4714;70;15;1;14;.933;3600000;0
16226;161129;4246;0;0;0;0;.00nan;0;0
16227;161583;4839;91;20;0;20;1.000;3600000;0
16227;166423;1368;0;0;0;0;.00nan;0;0
16227;-1;4839;0;0;0;0;.00nan;0;0
16227;87164;1368;60;21;2;19;.905;3526000;0
16228;183730;4919;0;0;0;0;.00nan;0;0
16228;175658;4919;67;27;3;24;.889;3600000;0
16228;-1;4992;0;0;0;0;.00nan;0;0
16228;182097;4992;57;32;4;28;.875;3561000;0
16229;-1;165;34;19;4;15;.789;3600000;0
16229;-1;165;0;0;0;0;.00nan;0;0
16229;185812;4998;78;33;3;30;.909;3600000;0
16229;146184;4998;0;0;0;0;.00nan;0;0
16230;187657;4997;0;0;0;0;.00nan;0;0
16230;169478;4991;70;22;2;20;.909;3600000;0
16230;64925;4997;54;30;4;26;.867;3600000;0
16230;85984;4991;0;0;0;0;.00nan;0;0
16231;37897;4714;0;0;0;0;.00nan;0;0
16231;187391;4246;0;0;0;0;.00nan;0;0
16231;59231;4714;67;23;2;21;.913;3600000;0
16231;161129;4246;59;28;3;25;.893;3570000;0
16232;161583;4839;58;21;2;19;.905;3590000;0
16232;166423;1368;86;27;1;26;.963;3600000;0
16232;-1;4839;0;0;0;0;.00nan;0;0
16232;87164;1368;0;0;0;0;.00nan;0;0
16233;183730;4919;43;30;5;25;.833;3588000;0
16233;175658;4919;0;0;0;0;.00nan;0;0
16233;-1;4992;55;28;4;24;.857;3600000;0
16233;182097;4992;0;0;0;0;.00nan;0;0
16234;-1;165;0;0;0;0;.00nan;0;0
16234;-1;165;70;30;3;27;.900;3518000;0
16234;175651;4715;0;0;0;0;.00nan;0;0
16234;85336;4715;77;20;1;19;.950;3600000;0
16235;187657;4997;72;34;3;31;.912;3600000;0
16235;169478;4991;0;0;0;0;.00nan;0;0
16235;64925;4997;0;0;0;0;.00nan;0;0
16235;85984;4991;53;34;5;29;.853;3525000;0
16236;37897;4714;0;0;0;0;.00nan;0;0
16236;187391;4246;70;20;1;19;.950;3600000;0
16236;59231;4714;68;40;4;36;.900;3600000;0
16236;161129;4246;0;0;0;0;.00nan;0;0
16238;185812;4997;0;0;0;0;.00nan;0;0
16238;187391;4246;54;24;4;20;.833;3517000;0
16238;64925;4997;72;27;2;25;.926;3600000;0
16238;161129;4246;0;0;0;0;.00nan;0;0
16240;166423;1368;0;0;0;0;.00nan;0;0
16240;37897;4714;0;0;0;0;.00nan;0;0
16240;59231;4714;71;40;4;36;.900;3600000;0
16240;87164;1368;27;24;6;18;.750;3536000;0
16242;183730;4919;0;0;0;0;.00nan;0;0
16242;169478;4991;86;30;1;29;.967;3102000;0
16242;175658;4919;62;22;2;20;.909;3600000;0
16242;85984;4991;25;13;4;9;.692;479000;0
16244;161583;4839;76;30;2;28;.933;3600000;0
16244;175651;4715;0;0;0;0;.00nan;0;0
16244;-1;4839;0;0;0;0;.00nan;0;0
16244;85336;4715;35;22;5;17;.773;3600000;0
16246;-1;165;0;0;0;0;.00nan;0;0
16246;-1;165;13;19;6;13;.684;3544000;0
16246;-1;4992;81;49;5;44;.898;3600000;0
16246;182097;4992;0;0;0;0;.00nan;0;0
1834;169478;4991;0;0;0;0;.00nan;0;0
1834;37897;4714;0;0;0;0;.00nan;0;0
1834;59231;4714;75;31;3;28;.903;3600000;0
1834;85984;4991;45;21;4;17;.810;3568000;0
1835;187657;4997;49;9;1;8;.889;1473000;0
1835;166423;1368;0;0;0;0;.00nan;0;0
1835;64925;4997;39;29;5;24;.828;2127000;0
1835;87164;1368;59;22;3;19;.864;3600000;0
1836;183730;4919;0;0;0;0;.00nan;0;0
1836;175651;4715;0;0;0;0;.00nan;0;0
1836;175658;4919;66;26;2;24;.923;3600000;0
1836;85336;4715;63;42;5;37;.881;3600000;0
1837;-1;165;0;0;0;0;.00nan;0;0
1837;-1;165;80;25;1;24;.960;3600000;0
1837;185812;4998;0;0;0;0;.00nan;0;0
1837;146184;4998;46;40;6;34;.850;3600000;0
1838;169478;4991;0;0;0;0;.00nan;0;0
1838;37897;4714;0;0;0;0;.00nan;0;0
1838;59231;4714;89;36;2;34;.944;3600000;0
1838;85984;4991;33;26;6;20;.769;3600000;0
1839;187657;4997;0;0;0;0;.00nan;0;0
1839;166423;1368;0;0;0;0;.00nan;0;0
1839;64925;4997;69;42;4;38;.905;4326000;0
1839;87164;1368;48;17;3;14;.824;4326000;0
1840;183730;4919;0;0;0;0;.00nan;0;0
1840;175651;4715;0;0;0;0;.00nan;0;0
1840;175658;4919;16;19;6;13;.684;3524000;0
1840;85336;4715;78;41;4;37;.902;3600000;0
1841;-1;165;0;0;0;0;.00nan;0;0
1841;-1;165;34;25;5;20;.800;3600000;0
1841;185812;4998;0;0;0;0;.00nan;0;0
1841;146184;4998;96;41;2;39;.951;3600000;0
1927;183730;4919;0;0;0;0;.00nan;0;0
1927;175651;4715;0;0;0;0;.00nan;0;0
1927;175658;4919;48;23;4;19;.826;3523000;0
1927;85336;4715;87;34;2;32;.941;3600000;0
16247;501;1527;0;0;0;0;.00nan;0;0
16247;161535;167;76;26;1;25;.962;3600000;0
16247;19708;1527;91;38;2;36;.947;3565000;0
16247;57155;167;0;0;0;0;.00nan;0;0
16248;184229;3916;79;40;3;37;.925;3566000;0
16248;178950;3916;0;0;0;0;.00nan;0;0
16248;59592;171;61;22;2;20;.909;3600000;0
16248;65125;171;0;0;0;0;.00nan;0;0
16249;178695;174;0;0;0;0;.00nan;0;0
16249;37786;174;87;27;1;26;.963;3600000;0
16249;44189;4247;96;41;2;39;.951;3589000;0
16249;57564;4247;0;0;0;0;.00nan;0;0
16250;173961;172;0;0;0;0;.00nan;0;0
16250;191026;172;67;34;3;31;.912;3600000;0
16250;59592;171;40;33;6;27;.818;1893000;0
16250;65125;171;66;23;2;21;.913;1707000;0
16251;184229;3916;64;23;2;21;.913;3600000;0
16251;178950;3916;0;0;0;0;.00nan;0;0
16251;44561;170;0;0;0;0;.00nan;0;0
16251;91212;170;88;45;3;42;.933;3553000;0
16252;178695;174;74;34;2;32;.941;3900000;0
16252;37786;174;0;0;0;0;.00nan;0;0
16252;44189;4247;81;41;2;39;.951;3900000;0
16252;57564;4247;0;0;0;0;.00nan;0;0
16253;-1;175;69;30;2;28;.933;3900000;0
16253;78820;169;0;0;0;0;.00nan;0;0
16253;86151;169;76;36;2;34;.944;3900000;0
16253;86344;175;0;0;0;0;.00nan;0;0
16254;501;1527;67;17;1;16;.941;3600000;0
16254;161535;167;39;32;6;26;.813;2827000;0
16254;19708;1527;0;0;0;0;.00nan;0;0
16254;57155;167;54;10;1;9;.900;773000;0
16255;44189;4247;95;32;2;30;.938;3900000;0
16255;57564;4247;0;0;0;0;.00nan;0;0
16255;59592;171;0;0;0;0;.00nan;0;0
16255;65125;171;81;29;2;27;.931;3900000;0
16256;44561;170;0;0;0;0;.00nan;0;0
16256;78820;169;0;0;0;0;.00nan;0;0
16256;86151;169;100;25;0;25;1.000;3600000;0
16256;91212;170;83;35;3;32;.914;3600000;0
16257;501;1527;100;38;2;36;.947;3600000;0
16257;19708;1527;0;0;0;0;.00nan;0;0
16257;178695;174;40;37;6;31;.838;3600000;0
16257;37786;174;0;0;0;0;.00nan;0;0
16258;184229;3916;0;0;0;0;.00nan;0;0
16258;173961;172;0;0;0;0;.00nan;0;0
16258;178950;3916;66;23;2;21;.913;3600000;0
16258;191026;172;47;41;6;35;.854;3600000;0
16259;161535;167;74;22;2;20;.909;3900000;0
16259;-1;175;84;40;2;38;.950;3900000;0
16259;57155;167;0;0;0;0;.00nan;0;0
16259;86344;175;0;0;0;0;.00nan;0;0
16260;501;1527;50;24;3;21;.875;3600000;0
16260;19708;1527;0;0;0;0;.00nan;0;0
16260;178695;174;100;46;0;46;1.000;3600000;0
16260;37786;174;0;0;0;0;.00nan;0;0
16261;184229;3916;74;34;4;30;.882;3900000;0
16261;173961;172;77;44;4;40;.909;3900000;0
16261;178950;3916;0;0;0;0;.00nan;0;0
16261;191026;172;0;0;0;0;.00nan;0;0
16262;44189;4247;0;0;0;0;.00nan;0;0
16262;57564;4247;40;28;5;23;.821;3600000;0
16262;59592;171;73;29;2;27;.931;3600000;0
16262;65125;171;0;0;0;0;.00nan;0;0
16263;161535;167;0;0;0;0;.00nan;0;0
16263;-1;175;0;0;0;0;.00nan;0;0
16263;57155;167;61;29;3;26;.897;3573000;0
16263;86344;175;63;24;2;22;.917;3600000;0
16264;-1;175;57;33;4;29;.879;3600000;0
16264;78820;169;0;0;0;0;.00nan;0;0
16264;86151;169;48;32;5;27;.844;3547000;0
16264;86344;175;0;0;0;0;.00nan;0;0
16265;184229;3916;0;0;0;0;.00nan;0;0
16265;178950;3916;90;32;2;30;.938;3900000;0
16265;59592;171;61;24;2;22;.917;3900000;0
16265;65125;171;0;0;0;0;.00nan;0;0
16266;501;1527;0;0;0;0;.00nan;0;0
16266;19708;1527;64;35;3;32;.914;3600000;0
16266;44189;4247;82;23;1;22;.957;3600000;0
16266;57564;4247;0;0;0;0;.00nan;0;0
16267;178695;174;96;41;3;38;.927;3900000;0
16267;37786;174;0;0;0;0;.00nan;0;0
16267;44561;170;0;0;0;0;.00nan;0;0
16267;91212;170;49;22;3;19;.864;3900000;0
16268;161535;167;72;33;3;30;.909;3545000;0
16268;173961;172;0;0;0;0;.00nan;0;0
16268;191026;172;77;33;2;31;.939;3600000;0
16268;57155;167;0;0;0;0;.00nan;0;0
16269;-1;175;52;24;3;21;.875;3600000;0
16269;78820;169;0;0;0;0;.00nan;0;0
16269;86151;169;100;25;0;25;1.000;3600000;0
16269;86344;175;0;0;0;0;.00nan;0;0
16270;184229;3916;39;27;5;22;.815;3600000;0
16270;178950;3916;0;0;0;0;.00nan;0;0
16270;59592;171;0;0;0;0;.00nan;0;0
16270;65125;171;73;26;2;24;.923;3600000;0
16271;501;1527;44;45;6;39;.867;3577000;0
16271;19708;1527;0;0;0;0;.00nan;0;0
16271;44189;4247;90;33;2;31;.939;3173000;0
16271;57564;4247;24;4;3;1;.250;427000;0
16272;178695;174;0;0;0;0;.00nan;0;0
16272;37786;174;60;27;3;24;.889;3600000;0
16272;44561;170;84;49;5;44;.898;3517000;0
16272;91212;170;0;0;0;0;.00nan;0;0
16273;161535;167;0;0;0;0;.00nan;0;0
16273;173961;172;65;24;3;21;.875;3545000;0
16273;191026;172;0;0;0;0;.00nan;0;0
16273;57155;167;68;28;2;26;.929;3600000;0
16274;501;1527;0;0;0;0;.00nan;0;0
16274;19708;1527;60;21;2;19;.905;3600000;0
16274;173961;172;0;0;0;0;.00nan;0;0
16274;191026;172;69;40;4;36;.900;3594000;0
16275;184229;3916;0;0;0;0;.00nan;0;0
16275;178950;3916;58;32;5;27;.844;3600000;0
16275;44189;4247;30;9;3;6;.667;555000;0
16275;57564;4247;70;19;1;18;.947;3045000;0
16276;173961;172;0;0;0;0;.00nan;0;0
16276;191026;172;62;27;3;24;.889;3600000;0
16276;59592;171;51;29;4;25;.862;3589000;0
16276;65125;171;0;0;0;0;.00nan;0;0
16277;44561;170;0;0;0;0;.00nan;0;0
16277;78820;169;0;0;0;0;.00nan;0;0
16277;86151;169;94;22;0;22;1.000;3600000;0
16277;91212;170;54;37;6;31;.838;3600000;0
16278;501;1527;68;24;2;22;.917;3900000;0
16278;-1;175;91;39;2;37;.949;3900000;0
16278;19708;1527;0;0;0;0;.00nan;0;0
16278;86344;175;0;0;0;0;.00nan;0;0
16279;173961;172;67;27;2;25;.926;3900000;0
16279;191026;172;0;0;0;0;.00nan;0;0
16279;44189;4247;92;40;2;38;.950;3900000;0
16279;57564;4247;0;0;0;0;.00nan;0;0
16280;178695;174;100;40;1;39;.975;3600000;0
16280;37786;174;0;0;0;0;.00nan;0;0
16280;59592;171;0;0;0;0;.00nan;0;0
16280;65125;171;50;24;4;20;.833;3600000;0
16281;161535;167;99;32;1;31;.969;3600000;0
16281;184229;3916;65;25;2;23;.920;3555000;0
16281;178950;3916;0;0;0;0;.00nan;0;0
16281;57155;167;0;0;0;0;.00nan;0;0
16282;501;1527;0;0;0;0;.00nan;0;0
16282;-1;175;0;0;0;0;.00nan;0;0
16282;19708;1527;84;33;2;31;.939;3600000;0
16282;86344;175;58;29;3;26;.897;3551000;0
16283;184229;3916;0;0;0;0;.00nan;0;0
16283;178950;3916;96;20;0;20;1.000;3600000;0
16283;44561;170;76;28;1;27;.964;3572000;0
16283;91212;170;0;0;0;0;.00nan;0;0
16284;173961;172;0;0;0;0;.00nan;0;0
16284;191026;172;87;49;3;46;.939;3564000;0
16284;44189;4247;0;0;0;0;.00nan;0;0
16284;57564;4247;95;27;1;26;.963;3600000;0
16285;161535;167;0;0;0;0;.00nan;0;0
16285;178695;174;65;33;3;30;.909;3900000;0
16285;37786;174;0;0;0;0;.00nan;0;0
16285;57155;167;87;41;3;38;.927;3900000;0
16286;44561;170;0;0;0;0;.00nan;0;0
16286;78820;169;0;0;0;0;.00nan;0;0
16286;86151;169;37;28;5;23;.821;3600000;0
16286;91212;170;65;28;2;26;.929;3600000;0
16287;501;1527;83;27;1;26;.963;3600000;0
16287;19708;1527;0;0;0;0;.00nan;0;0
16287;44189;4247;0;0;0;0;.00nan;0;0
16287;57564;4247;63;32;3;29;.906;3516000;0
16288;44189;4247;30;20;4;16;.800;3900000;0
16288;44203;170;67;38;4;34;.895;3900000;0
16288;57564;4247;0;0;0;0;.00nan;0;0
16288;91212;170;0;0;0;0;.00nan;0;0
16289;501;1527;0;0;0;0;.00nan;0;0
16289;19708;1527;62;33;3;30;.909;3900000;0
16289;184229;3916;96;42;3;39;.929;3900000;0
16289;178950;3916;0;0;0;0;.00nan;0;0
16290;173961;172;0;0;0;0;.00nan;0;0
16290;191026;172;60;25;3;22;.880;3521000;0
16290;59592;171;95;43;1;42;.977;3600000;0
16290;65125;171;0;0;0;0;.00nan;0;0
16291;161535;167;52;29;4;25;.862;3600000;0
16291;14191;169;0;0;0;0;.00nan;0;0
16291;57155;167;0;0;0;0;.00nan;0;0
16291;78820;169;90;20;0;20;1.000;3600000;0
16292;501;1527;100;27;0;27;1.000;3600000;0
16292;19708;1527;0;0;0;0;.00nan;0;0
16292;184229;3916;0;0;0;0;.00nan;0;0
16292;178950;3916;70;37;4;33;.892;3600000;0
16293;44189;4247;0;0;0;0;.00nan;0;0
16293;57564;4247;69;28;3;25;.893;3900000;0
16293;59592;171;0;0;0;0;.00nan;0;0
16293;65125;171;72;34;3;31;.912;3900000;0
16294;178695;174;64;38;5;33;.868;3518000;0
16294;173961;172;58;28;3;25;.893;3600000;0
16294;37786;174;0;0;0;0;.00nan;0;0
16294;191026;172;0;0;0;0;.00nan;0;0
16295;-1;175;74;28;2;26;.929;3892000;0
16295;44203;170;96;33;1;32;.970;3892000;0
16295;86344;175;0;0;0;0;.00nan;0;0
16295;91212;170;0;0;0;0;.00nan;0;0
16296;161535;167;0;0;0;0;.00nan;0;0
16296;14191;169;0;0;0;0;.00nan;0;0
16296;57155;167;78;36;2;34;.944;3900000;0
16296;78820;169;77;28;2;26;.929;3900000;0
16297;173961;172;0;0;0;0;.00nan;0;0
16297;191026;172;92;38;2;36;.947;3600000;0
16297;59592;171;52;28;4;24;.857;3553000;0
16297;65125;171;0;0;0;0;.00nan;0;0
16298;-1;175;0;0;0;0;.00nan;0;0
16298;44203;170;10;31;8;23;.742;2678000;0
16298;86344;175;59;31;4;27;.871;3600000;0
16298;91212;170;44;6;1;5;.833;922000;0
16299;161535;167;77;29;2;27;.931;3549000;0
16299;184229;3916;63;16;1;15;.938;3600000;0
16299;178950;3916;0;0;0;0;.00nan;0;0
16299;57155;167;0;0;0;0;.00nan;0;0
16300;501;1527;78;29;2;27;.931;3600000;0
16300;19708;1527;0;0;0;0;.00nan;0;0
16300;178695;174;74;35;3;32;.914;3587000;0
16300;37786;174;0;0;0;0;.00nan;0;0
16301;14191;169;0;0;0;0;.00nan;0;0
16301;44189;4247;74;44;5;39;.886;3600000;0
16301;57564;4247;0;0;0;0;.00nan;0;0
16301;78820;169;100;27;0;27;1.000;3600000;0
16302;14191;169;0;0;0;0;.00nan;0;0
16302;184229;3916;0;0;0;0;.00nan;0;0
16302;178950;3916;60;26;3;23;.885;3600000;0
16302;78820;169;87;38;4;34;.895;3542000;0
16303;-1;175;0;0;0;0;.00nan;0;0
16303;44203;170;97;47;3;44;.936;3600000;0
16303;86344;175;31;24;5;19;.792;3553000;0
16303;91212;170;0;0;0;0;.00nan;0;0
16304;501;1527;66;42;4;38;.905;3900000;0
16304;161535;167;0;0;0;0;.00nan;0;0
16304;19708;1527;0;0;0;0;.00nan;0;0
16304;57155;167;87;39;4;35;.897;3900000;0
16305;178695;174;75;44;4;40;.909;3537000;0
16305;37786;174;0;0;0;0;.00nan;0;0
16305;44189;4247;73;27;2;25;.926;3600000;0
16305;57564;4247;0;0;0;0;.00nan;0;0
16306;173961;172;0;0;0;0;.00nan;0;0
16306;191026;172;75;33;2;31;.939;3900000;0
16306;59592;171;82;33;2;31;.939;3874000;0
16306;65125;171;0;0;0;0;.00nan;0;0
16307;14191;169;60;19;2;17;.895;3600000;0
16307;184229;3916;54;31;4;27;.871;3524000;0
16307;178950;3916;0;0;0;0;.00nan;0;0
16307;78820;169;0;0;0;0;.00nan;0;0
16308;-1;175;0;0;0;0;.00nan;0;0
16308;44203;170;100;28;0;28;1.000;3600000;0
16308;86344;175;85;25;1;24;.960;3595000;0
16308;91212;170;0;0;0;0;.00nan;0;0
16309;178695;174;54;42;6;36;.857;3600000;0
16309;37786;174;0;0;0;0;.00nan;0;0
16309;44189;4247;0;0;0;0;.00nan;0;0
16309;57564;4247;50;21;3;18;.857;3600000;0
16310;178695;174;0;0;0;0;.00nan;0;0
16310;173961;172;0;0;0;0;.00nan;0;0
16310;37786;174;73;36;2;34;.944;3542000;0
16310;191026;172;92;29;1;28;.966;3600000;0
16311;178695;174;99;45;1;44;.978;3690000;0
16311;37786;174;0;0;0;0;.00nan;0;0
16311;59592;171;0;0;0;0;.00nan;0;0
16311;65125;171;84;41;2;39;.951;3690000;0
16312;14191;169;0;0;0;0;.00nan;0;0
16312;173961;172;52;28;4;24;.857;3600000;0
16312;191026;172;0;0;0;0;.00nan;0;0
16312;78820;169;71;29;3;26;.897;3600000;0
16313;161535;167;87;35;2;33;.943;3600000;0
16313;44203;170;42;24;4;20;.833;3556000;0
16313;57155;167;0;0;0;0;.00nan;0;0
16313;91212;170;0;0;0;0;.00nan;0;0
16314;178695;174;92;37;2;35;.946;3545000;0
16314;37786;174;0;0;0;0;.00nan;0;0
16314;59592;171;73;22;1;21;.955;3600000;0
16314;65125;171;0;0;0;0;.00nan;0;0
16315;501;1527;0;0;0;0;.00nan;0;0
16315;19708;1527;60;20;3;17;.850;3538000;0
16315;184229;3916;100;38;1;37;.974;3600000;0
16315;178950;3916;0;0;0;0;.00nan;0;0
16316;14191;169;54;31;5;26;.839;3600000;0
16316;173961;172;0;0;0;0;.00nan;0;0
16316;191026;172;60;38;4;34;.895;3600000;0
16316;78820;169;0;0;0;0;.00nan;0;0
16317;161535;167;0;0;0;0;.00nan;0;0
16317;44203;170;90;22;0;22;1.000;3600000;0
16317;57155;167;94;31;1;30;.968;3590000;0
16317;91212;170;0;0;0;0;.00nan;0;0
16318;501;1527;66;23;2;21;.913;3600000;0
16318;19708;1527;0;0;0;0;.00nan;0;0
16318;184229;3916;0;0;0;0;.00nan;0;0
16318;178950;3916;82;46;4;42;.913;3531000;0
16319;14191;169;0;0;0;0;.00nan;0;0
16319;44203;170;68;39;5;34;.872;3600000;0
16319;78820;169;54;25;4;21;.840;3600000;0
16319;91212;170;0;0;0;0;.00nan;0;0
16320;184229;3916;81;44;3;41;.932;3900000;0
16320;178950;3916;0;0;0;0;.00nan;0;0
16320;59592;171;0;0;0;0;.00nan;0;0
16320;65125;171;78;36;3;33;.917;3900000;0
16321;178695;174;72;30;2;28;.933;3779000;0
16321;37786;174;0;0;0;0;.00nan;0;0
16321;44189;4247;0;0;0;0;.00nan;0;0
16321;57564;4247;80;36;3;33;.917;3779000;0
16322;-1;175;0;0;0;0;.00nan;0;0
16322;173961;172;0;0;0;0;.00nan;0;0
16322;191026;172;60;24;3;21;.875;3600000;0
16322;86344;175;46;31;4;27;.871;3539000;0
16323;501;1527;0;0;0;0;.00nan;0;0
16323;161535;167;0;0;0;0;.00nan;0;0
16323;19708;1527;64;17;1;16;.941;3900000;0
16323;57155;167;93;22;1;21;.955;3900000;0
16324;184229;3916;0;0;0;0;.00nan;0;0
16324;178950;3916;79;29;1;28;.966;3900000;0
16324;59592;171;75;21;1;20;.952;3900000;0
16324;65125;171;0;0;0;0;.00nan;0;0
16325;178695;174;0;0;0;0;.00nan;0;0
16325;37786;174;73;38;4;34;.895;3600000;0
16325;44189;4247;100;24;0;24;1.000;3600000;0
16325;57564;4247;0;0;0;0;.00nan;0;0
16326;-1;175;0;0;0;0;.00nan;0;0
16326;173961;172;50;31;4;27;.871;3676000;0
16326;191026;172;0;0;0;0;.00nan;0;0
16326;86344;175;68;31;3;28;.903;3676000;0
16327;14191;169;55;23;3;20;.870;3630000;0
16327;44203;170;0;0;0;0;.00nan;0;0
16327;78820;169;0;0;0;0;.00nan;0;0
16327;91212;170;56;29;4;25;.862;3630000;0
16328;501;1527;72;22;2;20;.909;3900000;0
16328;161535;167;70;25;2;23;.920;3900000;0
16328;19708;1527;0;0;0;0;.00nan;0;0
16328;57155;167;0;0;0;0;.00nan;0;0
16329;14191;169;0;0;0;0;.00nan;0;0
16329;-1;175;0;0;0;0;.00nan;0;0
16329;78820;169;73;30;2;28;.933;3600000;0
16329;86344;175;51;24;3;21;.875;3595000;0
16330;501;1527;81;29;2;27;.931;3771000;0
16330;19708;1527;0;0;0;0;.00nan;0;0
16330;59592;171;0;0;0;0;.00nan;0;0
16330;65125;171;58;29;3;26;.897;3771000;0
16331;184229;3916;43;18;3;15;.833;3600000;0
16331;178950;3916;0;0;0;0;.00nan;0;0
16331;44203;170;76;42;4;38;.905;3573000;0
16331;91212;170;0;0;0;0;.00nan;0;0
16332;14191;169;73;30;2;28;.933;3900000;0
16332;-1;175;80;36;2;34;.944;3900000;0
16332;78820;169;0;0;0;0;.00nan;0;0
16332;86344;175;0;0;0;0;.00nan;0;0
16333;161535;167;84;25;2;23;.920;3600000;0
16333;44189;4247;72;46;4;42;.913;3543000;0
16333;57155;167;0;0;0;0;.00nan;0;0
16333;57564;4247;0;0;0;0;.00nan;0;0
16334;161535;167;0;0;0;0;.00nan;0;0
16334;57155;167;80;30;3;27;.900;3565000;0
16334;59592;171;68;27;2;25;.926;3600000;0
16334;65125;171;0;0;0;0;.00nan;0;0
16335;501;1527;0;0;0;0;.00nan;0;0
16335;19708;1527;77;21;1;20;.952;3600000;0
16335;178695;174;88;41;3;38;.927;3520000;0
16335;37786;174;0;0;0;0;.00nan;0;0
16336;184229;3916;0;0;0;0;.00nan;0;0
16336;173961;172;0;0;0;0;.00nan;0;0
16336;178950;3916;51;25;3;22;.880;3552000;0
16336;191026;172;98;38;2;36;.947;3600000;0
16337;14191;169;0;0;0;0;.00nan;0;0
16337;44203;170;0;0;0;0;.00nan;0;0
16337;78820;169;59;33;4;29;.879;3600000;0
16337;91212;170;63;38;5;33;.868;3600000;0
16338;-1;175;0;0;0;0;.00nan;0;0
16338;44189;4247;0;0;0;0;.00nan;0;0
16338;57564;4247;75;41;3;38;.927;3543000;0
16338;86344;175;65;24;2;22;.917;3600000;0
16339;-1;175;65;29;3;26;.897;3600000;0
16339;59592;171;0;0;0;0;.00nan;0;0
16339;65125;171;81;15;0;15;1.000;3600000;0
16339;86344;175;0;0;0;0;.00nan;0;0
16340;44189;4247;0;0;0;0;.00nan;0;0
16340;57564;4247;72;23;1;22;.957;3600000;0
16340;59592;171;0;0;0;0;.00nan;0;0
16340;65125;171;58;38;5;33;.868;3600000;0
16341;14191;169;0;0;0;0;.00nan;0;0
16341;44203;170;62;17;2;15;.882;3600000;0
16341;78820;169;61;42;5;37;.881;3600000;0
16341;91212;170;0;0;0;0;.00nan;0;0
16342;178695;174;43;33;6;27;.818;3651000;0
16342;173961;172;0;0;0;0;.00nan;0;0
16342;37786;174;0;0;0;0;.00nan;0;0
16342;191026;172;49;41;7;34;.829;3680000;0
16343;-1;175;0;0;0;0;.00nan;0;0
16343;184229;3916;73;25;1;24;.960;3600000;0
16343;178950;3916;0;0;0;0;.00nan;0;0
16343;86344;175;72;41;4;37;.902;3600000;0
16344;501;1527;76;35;4;31;.886;3900000;0
16344;161535;167;73;49;4;45;.918;3900000;0
16344;19708;1527;0;0;0;0;.00nan;0;0
16344;57155;167;0;0;0;0;.00nan;0;0
16345;184229;3916;0;0;0;0;.00nan;0;0
16345;178950;3916;85;28;1;27;.964;3600000;0
16345;59592;171;32;32;6;26;.813;3600000;0
16345;65125;171;0;0;0;0;.00nan;0;0
16346;14191;169;65;26;3;23;.885;3659000;0
16346;44203;170;0;0;0;0;.00nan;0;0
16346;78820;169;0;0;0;0;.00nan;0;0
16346;91212;170;84;47;4;43;.915;3683000;0
16347;501;1527;68;16;0;16;1.000;1207000;0
16347;161535;167;0;0;0;0;.00nan;0;0
16347;19708;1527;30;23;5;18;.783;2393000;0
16347;57155;167;91;38;1;37;.974;3600000;0
16348;178695;174;0;0;0;0;.00nan;0;0
16348;173961;172;89;33;2;31;.939;3900000;0
16348;37786;174;86;34;2;32;.941;3896000;0
16348;191026;172;0;0;0;0;.00nan;0;0
16349;-1;175;65;27;3;24;.889;3600000;0
16349;44189;4247;58;29;4;25;.862;3588000;0
16349;57564;4247;0;0;0;0;.00nan;0;0
16349;86344;175;0;0;0;0;.00nan;0;0
16350;173961;172;0;0;0;0;.00nan;0;0
16350;191026;172;85;33;3;30;.909;3600000;0
16350;59592;171;0;0;0;0;.00nan;0;0
16350;65125;171;33;27;5;22;.815;3558000;0
16351;184229;3916;81;32;2;30;.938;3600000;0
16351;178950;3916;0;0;0;0;.00nan;0;0
16351;44203;170;63;31;3;28;.903;3561000;0
16351;91212;170;0;0;0;0;.00nan;0;0
16352;14191;169;0;0;0;0;.00nan;0;0
16352;-1;175;0;0;0;0;.00nan;0;0
16352;78820;169;66;32;3;29;.906;3600000;0
16352;86344;175;61;34;4;30;.882;3548000;0
16353;161535;167;87;34;2;32;.941;3568000;0
16353;44189;4247;0;0;0;0;.00nan;0;0
16353;57155;167;0;0;0;0;.00nan;0;0
16353;57564;4247;67;20;1;19;.950;3600000;0
16354;-1;175;0;0;0;0;.00nan;0;0
16354;44203;170;0;0;0;0;.00nan;0;0
16354;86344;175;78;30;3;27;.900;3900000;0
16354;91212;170;67;30;3;27;.900;3900000;0
16355;501;1527;40;30;5;25;.833;3600000;0
16355;19708;1527;0;0;0;0;.00nan;0;0
16355;44189;4247;67;21;2;19;.905;3600000;0
16355;57564;4247;0;0;0;0;.00nan;0;0
16356;161535;167;0;0;0;0;.00nan;0;0
16356;184229;3916;43;29;5;24;.828;3515000;0
16356;178950;3916;0;0;0;0;.00nan;0;0
16356;57155;167;70;31;3;28;.903;3600000;0
16357;14191;169;67;23;2;21;.913;3202000;0
16357;178695;174;48;32;6;26;.813;3545000;0
16357;37786;174;0;0;0;0;.00nan;0;0
16357;78820;169;28;6;3;3;.500;398000;0
16358;173961;172;0;0;0;0;.00nan;0;0
16358;191026;172;92;40;2;38;.950;3545000;0
16358;59592;171;90;29;1;28;.966;3600000;0
16358;65125;171;0;0;0;0;.00nan;0;0
16359;173961;172;79;35;3;32;.914;3515000;0
16359;191026;172;0;0;0;0;.00nan;0;0
16359;59592;171;0;0;0;0;.00nan;0;0
16359;65125;171;92;31;1;30;.968;3600000;0
16360;-1;175;58;18;2;16;.889;3600000;0
16360;44203;170;61;49;6;43;.878;3600000;0
16360;86344;175;0;0;0;0;.00nan;0;0
16360;91212;170;0;0;0;0;.00nan;0;0
16361;161535;167;58;19;2;17;.895;3575000;0
16361;184229;3916;0;0;0;0;.00nan;0;0
16361;178950;3916;67;18;1;17;.944;3600000;0
16361;57155;167;0;0;0;0;.00nan;0;0
16362;501;1527;0;0;0;0;.00nan;0;0
16362;19708;1527;95;22;0;22;1.000;3600000;0
16362;44189;4247;0;0;0;0;.00nan;0;0
16362;57564;4247;79;49;4;45;.918;3600000;0
16363;14191;169;0;0;0;0;.00nan;0;0
16363;178695;174;0;0;0;0;.00nan;0;0
16363;37786;174;89;33;1;32;.970;3600000;0
16363;78820;169;52;28;4;24;.857;3600000;0
16364;161535;167;0;0;0;0;.00nan;0;0
16364;44189;4247;69;35;4;31;.886;3592000;0
16364;57155;167;69;28;3;25;.893;3600000;0
16364;57564;4247;0;0;0;0;.00nan;0;0
16365;178695;174;83;29;2;27;.931;3600000;0
16365;37786;174;0;0;0;0;.00nan;0;0
16365;44203;170;0;0;0;0;.00nan;0;0
16365;91212;170;49;22;3;19;.864;3554000;0
16366;14191;169;50;31;4;27;.871;3900000;0
16366;-1;175;0;0;0;0;.00nan;0;0
16366;78820;169;0;0;0;0;.00nan;0;0
16366;86344;175;58;29;4;25;.862;3900000;0
16367;14191;169;0;0;0;0;.00nan;0;0
16367;173961;172;0;0;0;0;.00nan;0;0
16367;191026;172;61;25;3;22;.880;3589000;0
16367;78820;169;100;32;1;31;.969;3600000;0
16368;161535;167;100;30;0;30;1.000;3600000;0
16368;57155;167;0;0;0;0;.00nan;0;0
16368;59592;171;64;20;2;18;.900;3573000;0
16368;65125;171;0;0;0;0;.00nan;0;0
16369;501;1527;0;0;0;0;.00nan;0;0
16369;19708;1527;31;29;6;23;.793;3682000;0
16369;44189;4247;0;0;0;0;.00nan;0;0
16369;57564;4247;67;42;5;37;.881;3682000;0
16370;178695;174;73;39;4;35;.897;3600000;0
16370;173961;172;21;11;4;7;.636;959000;0
16370;37786;174;0;0;0;0;.00nan;0;0
16370;191026;172;67;19;1;18;.947;2601000;0
16371;14191;169;40;48;8;40;.833;3600000;0
16371;184229;3916;47;22;4;18;.818;3600000;0
16371;178950;3916;0;0;0;0;.00nan;0;0
16371;78820;169;0;0;0;0;.00nan;0;0
16372;-1;175;98;33;1;32;.970;3600000;0
16372;44203;170;77;25;2;23;.920;3568000;0
16372;86344;175;0;0;0;0;.00nan;0;0
16372;91212;170;0;0;0;0;.00nan;0;0
16373;161535;167;68;24;2;22;.917;3600000;0
16373;44189;4247;58;35;4;31;.886;3561000;0
16373;57155;167;0;0;0;0;.00nan;0;0
16373;57564;4247;0;0;0;0;.00nan;0;0
16374;501;1527;69;31;2;29;.935;3600000;0
16374;19708;1527;0;0;0;0;.00nan;0;0
16374;178695;174;0;0;0;0;.00nan;0;0
16374;37786;174;26;30;6;24;.800;3600000;0
16375;173961;172;73;21;1;20;.952;3585000;0
16375;191026;172;0;0;0;0;.00nan;0;0
16375;59592;171;0;0;0;0;.00nan;0;0
16375;65125;171;95;25;0;25;1.000;3600000;0
16376;14191;169;0;0;0;0;.00nan;0;0
16376;184229;3916;0;0;0;0;.00nan;0;0
16376;178950;3916;51;30;4;26;.867;3570000;0
16376;78820;169;82;27;2;25;.926;3600000;0
16377;-1;175;0;0;0;0;.00nan;0;0
16377;44203;170;0;0;0;0;.00nan;0;0
16377;86344;175;90;22;0;22;1.000;3600000;0
16377;91212;170;52;32;4;28;.875;3600000;0
16378;44189;4247;0;0;0;0;.00nan;0;0
16378;44203;170;86;51;4;47;.922;3600000;0
16378;57564;4247;82;27;1;26;.963;3600000;0
16378;91212;170;0;0;0;0;.00nan;0;0
16379;501;1527;61;22;3;19;.864;3600000;0
16379;19708;1527;0;0;0;0;.00nan;0;0
16379;178695;174;87;45;4;41;.911;3600000;0
16379;37786;174;0;0;0;0;.00nan;0;0
16380;14191;169;0;0;0;0;.00nan;0;0
16380;184229;3916;67;23;2;21;.913;3600000;0
16380;178950;3916;0;0;0;0;.00nan;0;0
16380;78820;169;78;23;1;22;.957;3600000;0
16381;-1;175;0;0;0;0;.00nan;0;0
16381;59592;171;61;21;2;19;.905;3600000;0
16381;65125;171;0;0;0;0;.00nan;0;0
16381;86344;175;68;34;4;30;.882;3600000;0
16382;161535;167;86;28;1;27;.964;3600000;0
16382;173961;172;0;0;0;0;.00nan;0;0
16382;191026;172;53;25;3;22;.880;3560000;0
16382;57155;167;0;0;0;0;.00nan;0;0
16383;44189;4247;45;15;3;12;.800;3606000;0
16383;44203;170;0;0;0;0;.00nan;0;0
16383;57564;4247;0;0;0;0;.00nan;0;0
16383;91212;170;60;28;4;24;.857;3606000;0
16384;501;1527;0;0;0;0;.00nan;0;0
16384;19708;1527;100;33;0;33;1.000;3600000;0
16384;178695;174;50;39;5;34;.872;3600000;0
16384;37786;174;0;0;0;0;.00nan;0;0
16385;14191;169;75;31;3;28;.903;3600000;0
16385;184229;3916;0;0;0;0;.00nan;0;0
16385;178950;3916;60;35;4;31;.886;3592000;0
16385;78820;169;0;0;0;0;.00nan;0;0
16386;-1;175;80;34;3;31;.912;3600000;0
16386;59592;171;0;0;0;0;.00nan;0;0
16386;65125;171;100;33;0;33;1.000;3600000;0
16386;86344;175;0;0;0;0;.00nan;0;0
16387;161535;167;94;29;1;28;.966;3571000;0
16387;173961;172;95;21;0;21;1.000;3600000;0
16387;191026;172;0;0;0;0;.00nan;0;0
16387;57155;167;0;0;0;0;.00nan;0;0
16388;14191;169;0;0;0;0;.00nan;0;0
16388;184229;3916;65;29;3;26;.897;3598000;0
16388;178950;3916;0;0;0;0;.00nan;0;0
16388;78820;169;73;32;2;30;.938;3600000;0
16389;44189;4247;0;0;0;0;.00nan;0;0
16389;57564;4247;100;40;0;40;1.000;3600000;0
16389;59592;171;70;21;1;20;.952;3546000;0
16389;65125;171;0;0;0;0;.00nan;0;0
16390;-1;175;83;33;2;31;.939;3900000;0
16390;178695;174;70;29;2;27;.931;3900000;0
16390;37786;174;0;0;0;0;.00nan;0;0
16390;86344;175;0;0;0;0;.00nan;0;0
16391;161535;167;52;21;3;18;.857;3600000;0
16391;178695;174;50;26;4;22;.846;3544000;0
16391;37786;174;0;0;0;0;.00nan;0;0
16391;57155;167;0;0;0;0;.00nan;0;0
16392;501;1527;0;0;0;0;.00nan;0;0
16392;19708;1527;77;21;1;20;.952;3600000;0
16392;186527;171;0;0;0;0;.00nan;0;0
16392;65125;171;88;41;2;39;.951;3542000;0
16393;14191;169;59;21;2;19;.905;3600000;0
16393;44203;170;72;40;4;36;.900;3568000;0
16393;78820;169;0;0;0;0;.00nan;0;0
16393;91212;170;0;0;0;0;.00nan;0;0
16394;184229;3916;85;52;4;48;.923;3532000;0
16394;173961;172;89;35;2;33;.943;3600000;0
16394;178950;3916;0;0;0;0;.00nan;0;0
16394;191026;172;0;0;0;0;.00nan;0;0
16395;-1;175;0;0;0;0;.00nan;0;0
16395;44189;4247;70;17;1;16;.941;3600000;0
16395;57564;4247;0;0;0;0;.00nan;0;0
16395;86344;175;59;28;4;24;.857;3600000;0
16396;161535;167;0;0;0;0;.00nan;0;0
16396;178695;174;0;0;0;0;.00nan;0;0
16396;37786;174;48;28;4;24;.857;3581000;0
16396;57155;167;61;22;2;20;.909;3600000;0
16397;501;1527;77;37;2;35;.946;3600000;0
16397;19708;1527;0;0;0;0;.00nan;0;0
16397;186527;171;74;29;3;26;.897;3600000;0
16397;65125;171;0;0;0;0;.00nan;0;0
16398;-1;175;81;30;1;29;.967;3587000;0
16398;44189;4247;0;0;0;0;.00nan;0;0
16398;57564;4247;91;21;0;21;1.000;3600000;0
16398;86344;175;0;0;0;0;.00nan;0;0
16399;178695;174;78;24;1;23;.958;3600000;0
16399;173961;172;0;0;0;0;.00nan;0;0
16399;37786;174;0;0;0;0;.00nan;0;0
16399;191026;172;74;31;3;28;.903;3539000;0
16400;14191;169;0;0;0;0;.00nan;0;0
16400;44203;170;0;0;0;0;.00nan;0;0
16400;78820;169;83;28;1;27;.964;3600000;0
16400;91212;170;84;34;2;32;.941;3556000;0
16401;161535;167;77;42;3;39;.929;3552000;0
16401;184229;3916;0;0;0;0;.00nan;0;0
16401;178950;3916;75;30;2;28;.933;3600000;0
16401;57155;167;0;0;0;0;.00nan;0;0
16402;501;1527;0;0;0;0;.00nan;0;0
16402;19708;1527;57;23;2;21;.913;3564000;0
16402;186527;171;0;0;0;0;.00nan;0;0
16402;65125;171;95;28;1;27;.964;3600000;0
16403;186527;171;98;22;0;22;1.000;3600000;0
16403;44203;170;84;44;3;41;.932;3600000;0
16403;65125;171;0;0;0;0;.00nan;0;0
16403;91212;170;0;0;0;0;.00nan;0;0
16404;501;1527;66;22;3;19;.864;3600000;0
16404;19708;1527;0;0;0;0;.00nan;0;0
16404;184229;3916;48;36;6;30;.833;3262000;0
16404;178950;3916;56;4;0;4;1.000;338000;0
16405;-1;175;0;0;0;0;.00nan;0;0
16405;178695;174;11;18;6;12;.667;1851000;0
16405;37786;174;67;18;1;17;.944;1749000;0
16405;86344;175;64;29;4;25;.862;3600000;0
16406;161535;167;51;35;5;30;.857;3600000;0
16406;173961;172;75;26;2;24;.923;3600000;0
16406;191026;172;0;0;0;0;.00nan;0;0
16406;57155;167;0;0;0;0;.00nan;0;0
16407;14191;169;0;0;0;0;.00nan;0;0
16407;44189;4247;88;35;2;33;.943;3900000;0
16407;57564;4247;0;0;0;0;.00nan;0;0
16407;78820;169;64;28;2;26;.929;3900000;0
16408;186527;171;81;26;2;24;.923;3600000;0
16408;44203;170;0;0;0;0;.00nan;0;0
16408;65125;171;0;0;0;0;.00nan;0;0
16408;91212;170;57;32;4;28;.875;3567000;0
16409;501;1527;64;20;2;18;.900;3600000;0
16409;19708;1527;0;0;0;0;.00nan;0;0
16409;184229;3916;0;0;0;0;.00nan;0;0
16409;178950;3916;55;43;5;38;.884;3600000;0
16410;-1;175;86;29;1;28;.966;3600000;0
16410;178695;174;86;39;3;36;.923;3576000;0
16410;37786;174;0;0;0;0;.00nan;0;0
16410;86344;175;0;0;0;0;.00nan;0;0
16411;161535;167;0;0;0;0;.00nan;0;0
16411;173961;172;0;0;0;0;.00nan;0;0
16411;191026;172;59;28;3;25;.893;3900000;0
16411;57155;167;60;31;3;28;.903;3900000;0
16412;14191;169;92;39;3;36;.923;3900000;0
16412;44189;4247;0;0;0;0;.00nan;0;0
16412;57564;4247;55;20;3;17;.850;3900000;0
16412;78820;169;0;0;0;0;.00nan;0;0
16413;178695;174;45;43;7;36;.837;3600000;0
16413;37786;174;0;0;0;0;.00nan;0;0
16413;186527;171;59;35;4;31;.886;3600000;0
16413;65125;171;0;0;0;0;.00nan;0;0
16414;-1;175;0;0;0;0;.00nan;0;0
16414;44203;170;85;30;1;29;.967;3600000;0
16414;86344;175;60;23;3;20;.870;3600000;0
16414;91212;170;0;0;0;0;.00nan;0;0
16415;161535;167;81;28;2;26;.929;3600000;0
16415;14191;169;0;0;0;0;.00nan;0;0
16415;57155;167;0;0;0;0;.00nan;0;0
16415;78820;169;41;25;5;20;.800;3600000;0
16416;173961;172;0;0;0;0;.00nan;0;0
16416;191026;172;82;36;3;33;.917;3537000;0
16416;186527;171;100;30;1;29;.967;3600000;0
16416;65125;171;0;0;0;0;.00nan;0;0
16417;-1;175;89;17;0;17;1.000;3600000;0
16417;184229;3916;0;0;0;0;.00nan;0;0
16417;178950;3916;89;36;2;34;.944;3514000;0
16417;86344;175;0;0;0;0;.00nan;0;0
16418;44189;4247;56;20;2;18;.900;3600000;0
16418;44203;170;0;0;0;0;.00nan;0;0
16418;57564;4247;0;0;0;0;.00nan;0;0
16418;91212;170;68;29;3;26;.897;3600000;0
16419;501;1527;71;24;1;23;.958;3600000;0
16419;14191;169;96;47;3;44;.936;3596000;0
16419;19708;1527;0;0;0;0;.00nan;0;0
16419;78820;169;0;0;0;0;.00nan;0;0
16420;161535;167;0;0;0;0;.00nan;0;0
16420;178695;174;0;0;0;0;.00nan;0;0
16420;37786;174;54;30;4;26;.867;3900000;0
16420;57155;167;66;31;4;27;.871;3900000;0
16421;-1;175;0;0;0;0;.00nan;0;0
16421;184229;3916;83;26;1;25;.962;3600000;0
16421;178950;3916;0;0;0;0;.00nan;0;0
16421;86344;175;43;41;7;34;.829;3600000;0
16422;44189;4247;0;0;0;0;.00nan;0;0
16422;44203;170;69;45;6;39;.867;3600000;0
16422;57564;4247;55;16;2;14;.875;3600000;0
16422;91212;170;0;0;0;0;.00nan;0;0
16423;178695;174;76;51;5;46;.902;3600000;0
16423;173961;172;63;19;2;17;.895;3600000;0
16423;37786;174;0;0;0;0;.00nan;0;0
16423;191026;172;0;0;0;0;.00nan;0;0
16424;501;1527;0;0;0;0;.00nan;0;0
16424;14191;169;0;0;0;0;.00nan;0;0
16424;19708;1527;80;21;1;20;.952;3600000;0
16424;78820;169;98;40;2;38;.950;3600000;0
16425;161535;167;49;26;4;22;.846;3600000;0
16425;186527;171;99;30;0;30;1.000;3600000;0
16425;57155;167;0;0;0;0;.00nan;0;0
16425;65125;171;0;0;0;0;.00nan;0;0
16426;186527;171;93;29;1;28;.966;3600000;0
16426;44203;170;77;28;2;26;.929;3586000;0
16426;65125;171;0;0;0;0;.00nan;0;0
16426;91212;170;0;0;0;0;.00nan;0;0
16427;501;1527;57;16;2;14;.875;3600000;0
16427;19708;1527;0;0;0;0;.00nan;0;0
16427;44189;4247;91;49;3;46;.939;3599000;0
16427;57564;4247;0;0;0;0;.00nan;0;0
16428;161535;167;0;0;0;0;.00nan;0;0
16428;178695;174;77;35;3;32;.914;3600000;0
16428;37786;174;0;0;0;0;.00nan;0;0
16428;57155;167;54;25;4;21;.840;3571000;0
16429;184229;3916;100;32;0;32;1.000;3600000;0
16429;173961;172;0;0;0;0;.00nan;0;0
16429;178950;3916;0;0;0;0;.00nan;0;0
16429;191026;172;83;40;3;37;.925;3600000;0
16430;14191;169;0;0;0;0;.00nan;0;0
16430;-1;175;66;17;1;16;.941;3600000;0
16430;78820;169;61;28;3;25;.893;3562000;0
16430;86344;175;0;0;0;0;.00nan;0;0
16431;186527;171;63;22;2;20;.909;3549000;0
16431;44203;170;0;0;0;0;.00nan;0;0
16431;65125;171;0;0;0;0;.00nan;0;0
16431;91212;170;91;31;1;30;.968;3600000;0
16432;161535;167;66;31;3;28;.903;3563000;0
16432;44189;4247;0;0;0;0;.00nan;0;0
16432;57155;167;0;0;0;0;.00nan;0;0
16432;57564;4247;78;24;1;23;.958;3600000;0
16433;501;1527;0;0;0;0;.00nan;0;0
16433;19708;1527;26;15;5;10;.667;3672000;0
16433;178695;174;0;0;0;0;.00nan;0;0
16433;37786;174;74;44;4;40;.909;3672000;0
16434;184229;3916;81;35;2;33;.943;3600000;0
16434;173961;172;68;32;3;29;.906;3587000;0
16434;178950;3916;0;0;0;0;.00nan;0;0
16434;191026;172;0;0;0;0;.00nan;0;0
16435;14191;169;37;39;7;32;.821;2960000;0
16435;-1;175;0;0;0;0;.00nan;0;0
16435;78820;169;28;7;3;4;.571;640000;0
16435;86344;175;84;33;2;31;.939;3600000;0
16436;-1;175;89;33;1;32;.970;3600000;0
16436;44203;170;73;36;3;33;.917;3588000;0
16436;86344;175;0;0;0;0;.00nan;0;0
16436;91212;170;0;0;0;0;.00nan;0;0
16437;161535;167;0;0;0;0;.00nan;0;0
16437;44203;170;78;35;3;32;.914;3709000;0
16437;57155;167;86;30;2;28;.933;3709000;0
16437;91212;170;0;0;0;0;.00nan;0;0
16438;501;1527;84;35;2;33;.943;3900000;0
16438;14191;169;0;0;0;0;.00nan;0;0
16438;19708;1527;0;0;0;0;.00nan;0;0
16438;78820;169;80;29;2;27;.931;3900000;0
16439;184229;3916;75;27;2;25;.926;3900000;0
16439;178950;3916;0;0;0;0;.00nan;0;0
16439;186527;171;68;21;2;19;.905;3900000;0
16439;65125;171;0;0;0;0;.00nan;0;0
16440;178695;174;39;31;6;25;.806;2148000;0
16440;37786;174;26;15;4;11;.733;1452000;0
16440;44189;4247;73;22;1;21;.955;3600000;0
16440;57564;4247;0;0;0;0;.00nan;0;0
16441;-1;175;0;0;0;0;.00nan;0;0
16441;173961;172;53;30;4;26;.867;3515000;0
16441;191026;172;0;0;0;0;.00nan;0;0
16441;86344;175;72;29;2;27;.931;3600000;0
16442;161535;167;64;32;4;28;.875;3600000;0
16442;44203;170;62;29;3;26;.897;2898000;0
16442;57155;167;0;0;0;0;.00nan;0;0
16442;91212;170;16;8;4;4;.500;702000;0
16443;501;1527;0;0;0;0;.00nan;0;0
16443;14191;169;85;24;1;23;.958;3600000;0
16443;19708;1527;36;28;5;23;.821;3600000;0
16443;78820;169;0;0;0;0;.00nan;0;0
16444;184229;3916;0;0;0;0;.00nan;0;0
16444;178950;3916;67;32;3;29;.906;3900000;0
16444;186527;171;50;26;3;23;.885;3900000;0
16444;65125;171;0;0;0;0;.00nan;0;0
16445;178695;174;41;29;5;24;.828;2056000;0
16445;37786;174;60;21;2;19;.905;1544000;0
16445;44189;4247;82;24;1;23;.958;3600000;0
16445;57564;4247;0;0;0;0;.00nan;0;0
16446;-1;175;0;0;0;0;.00nan;0;0
16446;173961;172;0;0;0;0;.00nan;0;0
16446;191026;172;56;30;4;26;.867;3599000;0
16446;86344;175;90;34;2;32;.941;3600000;0
16447;501;1527;58;19;3;16;.842;3900000;0
16447;14191;169;0;0;0;0;.00nan;0;0
16447;19708;1527;0;0;0;0;.00nan;0;0
16447;78820;169;81;34;3;31;.912;3900000;0
16448;184229;3916;62;36;5;31;.861;3600000;0
16448;178950;3916;0;0;0;0;.00nan;0;0
16448;44189;4247;0;0;0;0;.00nan;0;0
16448;57564;4247;91;36;2;34;.944;3600000;0
16449;-1;175;74;28;2;26;.929;3573000;0
16449;173961;172;100;39;0;39;1.000;3600000;0
16449;191026;172;0;0;0;0;.00nan;0;0
16449;86344;175;0;0;0;0;.00nan;0;0
16450;186527;171;43;18;3;15;.833;3600000;0
16450;44203;170;100;28;0;28;1.000;3600000;0
16450;65125;171;0;0;0;0;.00nan;0;0
16450;91212;170;0;0;0;0;.00nan;0;0
16451;161535;167;53;20;3;17;.850;3600000;0
16451;178695;174;0;0;0;0;.00nan;0;0
16451;37786;174;65;36;4;32;.889;3551000;0
16451;57155;167;0;0;0;0;.00nan;0;0
16452;178695;174;85;43;3;40;.930;3600000;0
16452;37786;174;0;0;0;0;.00nan;0;0
16452;186527;171;100;26;0;26;1.000;3600000;0
16452;65125;171;0;0;0;0;.00nan;0;0
16453;14191;169;0;0;0;0;.00nan;0;0
16453;44203;170;75;45;4;41;.911;3600000;0
16453;78820;169;100;20;0;20;1.000;3600000;0
16453;91212;170;0;0;0;0;.00nan;0;0
16454;173961;172;64;29;3;26;.897;3573000;0
16454;191026;172;0;0;0;0;.00nan;0;0
16454;44189;4247;83;28;2;26;.929;3600000;0
16454;57564;4247;0;0;0;0;.00nan;0;0
16455;501;1527;73;29;2;27;.931;3600000;0
16455;-1;175;55;31;5;26;.839;3600000;0
16455;19708;1527;0;0;0;0;.00nan;0;0
16455;86344;175;0;0;0;0;.00nan;0;0
16456;161535;167;97;37;1;36;.973;3600000;0
16456;184229;3916;98;26;0;26;1.000;3600000;0
16456;178950;3916;0;0;0;0;.00nan;0;0
16456;57155;167;0;0;0;0;.00nan;0;0
16457;178695;174;0;0;0;0;.00nan;0;0
16457;37786;174;38;22;4;18;.818;3588000;0
16457;186527;171;55;29;3;26;.897;3600000;0
16457;65125;171;0;0;0;0;.00nan;0;0
16458;173961;172;0;0;0;0;.00nan;0;0
16458;191026;172;100;35;0;35;1.000;3600000;0
16458;44189;4247;0;0;0;0;.00nan;0;0
16458;57564;4247;59;27;3;24;.889;3600000;0
16459;14191;169;0;0;0;0;.00nan;0;0
16459;44203;170;0;0;0;0;.00nan;0;0
16459;78820;169;76;25;1;24;.960;3600000;0
16459;91212;170;50;42;6;36;.857;3600000;0
16460;501;1527;0;0;0;0;.00nan;0;0
16460;-1;175;0;0;0;0;.00nan;0;0
16460;19708;1527;77;28;2;26;.929;3600000;0
16460;86344;175;70;40;4;36;.900;3560000;0
16461;161535;167;51;21;3;18;.857;3582000;0
16461;184229;3916;83;29;1;28;.966;3600000;0
16461;178950;3916;0;0;0;0;.00nan;0;0
16461;57155;167;0;0;0;0;.00nan;0;0
16462;501;1527;50;25;3;22;.880;3600000;0
16462;-1;175;91;35;2;33;.943;3556000;0
16462;19708;1527;0;0;0;0;.00nan;0;0
16462;86344;175;0;0;0;0;.00nan;0;0
16463;184229;3916;78;23;1;22;.957;3600000;0
16463;178950;3916;0;0;0;0;.00nan;0;0
16463;44189;4247;72;36;3;33;.917;3598000;0
16463;57564;4247;0;0;0;0;.00nan;0;0
16464;14191;169;64;24;2;22;.917;3600000;0
16464;186527;171;33;20;4;16;.800;1142000;0
16464;65125;171;45;23;4;19;.826;2458000;0
16464;78820;169;0;0;0;0;.00nan;0;0
16465;501;1527;59;23;3;20;.870;3730000;0
16465;19708;1527;0;0;0;0;.00nan;0;0
16465;173961;172;0;0;0;0;.00nan;0;0
16465;191026;172;88;33;2;31;.939;3730000;0
16466;178695;174;35;31;6;25;.806;2583000;0
16466;184229;3916;0;0;0;0;.00nan;0;0
16466;178950;3916;100;34;0;34;1.000;3600000;0
16466;37786;174;68;16;0;16;1.000;1017000;0
16467;161535;167;0;0;0;0;.00nan;0;0
16467;44189;4247;0;0;0;0;.00nan;0;0
16467;57155;167;56;21;2;19;.905;3558000;0
16467;57564;4247;96;33;1;32;.970;3600000;0
16468;-1;175;57;27;4;23;.852;3600000;0
16468;44203;170;94;31;1;30;.968;3600000;0
16468;86344;175;0;0;0;0;.00nan;0;0
16468;91212;170;0;0;0;0;.00nan;0;0
16469;14191;169;0;0;0;0;.00nan;0;0
16469;186527;171;75;25;2;23;.920;3600000;0
16469;65125;171;0;0;0;0;.00nan;0;0
16469;78820;169;64;33;3;30;.909;3600000;0
16470;501;1527;0;0;0;0;.00nan;0;0
16470;19708;1527;55;27;4;23;.852;3525000;0
16470;173961;172;96;45;2;43;.956;3600000;0
16470;191026;172;0;0;0;0;.00nan;0;0
16471;161535;167;62;27;4;23;.852;3557000;0
16471;44189;4247;63;26;2;24;.923;3600000;0
16471;57155;167;0;0;0;0;.00nan;0;0
16471;57564;4247;0;0;0;0;.00nan;0;0
16472;178695;174;43;11;2;9;.818;1311000;0
16472;184229;3916;0;0;0;0;.00nan;0;0
16472;178950;3916;49;28;4;24;.857;3600000;0
16472;37786;174;51;32;5;27;.844;2289000;0
16473;-1;175;0;0;0;0;.00nan;0;0
16473;44203;170;0;0;0;0;.00nan;0;0
16473;86344;175;58;28;4;24;.857;3600000;0
16473;91212;170;64;39;5;34;.872;3600000;0
16474;184229;3916;72;30;3;27;.900;3600000;0
16474;178950;3916;0;0;0;0;.00nan;0;0
16474;44203;170;41;24;5;19;.792;3516000;0
16474;91212;170;0;0;0;0;.00nan;0;0
16475;501;1527;80;25;1;24;.960;3600000;0
16475;19708;1527;0;0;0;0;.00nan;0;0
16475;186527;171;62;34;3;31;.912;3512000;0
16475;65125;171;0;0;0;0;.00nan;0;0
16476;-1;175;86;33;2;31;.939;3600000;0
16476;178695;174;50;26;4;22;.846;3568000;0
16476;37786;174;0;0;0;0;.00nan;0;0
16476;86344;175;0;0;0;0;.00nan;0;0
16477;14191;169;0;0;0;0;.00nan;0;0
16477;173961;172;0;0;0;0;.00nan;0;0
16477;191026;172;82;39;3;36;.923;3600000;0
16477;78820;169;100;28;0;28;1.000;3600000;0
16478;161535;167;63;27;3;24;.889;3600000;0
16478;44189;4247;0;0;0;0;.00nan;0;0
16478;57155;167;0;0;0;0;.00nan;0;0
16478;57564;4247;68;17;1;16;.941;3600000;0
16479;184229;3916;0;0;0;0;.00nan;0;0
16479;178950;3916;57;18;3;15;.833;3600000;0
16479;44203;170;0;0;0;0;.00nan;0;0
16479;91212;170;47;26;4;22;.846;3600000;0
16480;501;1527;81;27;2;25;.926;3598000;0
16480;19708;1527;0;0;0;0;.00nan;0;0
16480;186527;171;98;38;1;37;.974;3600000;0
16480;65125;171;0;0;0;0;.00nan;0;0
16481;-1;175;0;0;0;0;.00nan;0;0
16481;178695;174;0;0;0;0;.00nan;0;0
16481;37786;174;55;30;4;26;.867;3600000;0
16481;86344;175;56;37;5;32;.865;3548000;0
16482;14191;169;0;0;0;0;.00nan;0;0
16482;173961;172;38;20;4;16;.800;3533000;0
16482;191026;172;0;0;0;0;.00nan;0;0
16482;78820;169;76;30;2;28;.933;3600000;0
16483;161535;167;0;0;0;0;.00nan;0;0
16483;44189;4247;89;36;2;34;.944;3600000;0
16483;57155;167;76;34;4;30;.882;3512000;0
16483;57564;4247;0;0;0;0;.00nan;0;0
16484;173961;172;65;27;3;24;.889;3225000;0
16484;191026;172;34;10;3;7;.700;375000;0
16484;44203;170;56;21;2;19;.905;3600000;0
16484;91212;170;0;0;0;0;.00nan;0;0
16485;501;1527;100;32;0;32;1.000;3600000;0
16485;161535;167;83;47;4;43;.915;3600000;0
16485;19708;1527;0;0;0;0;.00nan;0;0
16485;57155;167;0;0;0;0;.00nan;0;0
16486;178695;174;50;41;6;35;.854;3600000;0
16486;37786;174;0;0;0;0;.00nan;0;0
16486;44203;170;74;27;2;25;.926;3600000;0
16486;91212;170;0;0;0;0;.00nan;0;0
16487;501;1527;57;39;5;34;.872;3555000;0
16487;19708;1527;0;0;0;0;.00nan;0;0
16487;44189;4247;0;0;0;0;.00nan;0;0
16487;57564;4247;60;27;3;24;.889;3600000;0
16488;184229;3916;75;27;1;26;.963;3600000;0
16488;173961;172;63;23;2;21;.913;3577000;0
16488;178950;3916;0;0;0;0;.00nan;0;0
16488;191026;172;0;0;0;0;.00nan;0;0
16489;14191;169;0;0;0;0;.00nan;0;0
16489;-1;175;87;28;1;27;.964;3900000;0
16489;78820;169;82;21;1;20;.952;3900000;0
16489;86344;175;0;0;0;0;.00nan;0;0
16490;161535;167;0;0;0;0;.00nan;0;0
16490;186527;171;86;19;0;19;1.000;3600000;0
16490;57155;167;90;31;1;30;.968;3565000;0
16490;65125;171;0;0;0;0;.00nan;0;0
16491;178695;174;0;0;0;0;.00nan;0;0
16491;37786;174;96;37;1;36;.973;3600000;0
16491;44203;170;0;0;0;0;.00nan;0;0
16491;91212;170;53;30;4;26;.867;3600000;0
16492;184229;3916;0;0;0;0;.00nan;0;0
16492;173961;172;0;0;0;0;.00nan;0;0
16492;178950;3916;72;31;2;29;.935;3900000;0
16492;191026;172;60;21;2;19;.905;3900000;0
16493;501;1527;0;0;0;0;.00nan;0;0
16493;19708;1527;69;24;2;22;.917;3600000;0
16493;44189;4247;86;49;4;45;.918;3582000;0
16493;57564;4247;0;0;0;0;.00nan;0;0
16494;14191;169;0;0;0;0;.00nan;0;0
16494;-1;175;0;0;0;0;.00nan;0;0
16494;78820;169;47;24;4;20;.833;3600000;0
16494;86344;175;74;23;1;22;.957;3600000;0
16495;161535;167;100;39;0;39;1.000;3600000;0
16495;186527;171;0;0;0;0;.00nan;0;0
16495;57155;167;0;0;0;0;.00nan;0;0
16495;65125;171;46;24;4;20;.833;3600000;0
16496;501;1527;63;30;3;27;.900;3600000;0
16496;19708;1527;0;0;0;0;.00nan;0;0
16496;186527;171;54;32;5;27;.844;3522000;0
16496;65125;171;0;0;0;0;.00nan;0;0
16497;184229;3916;98;34;1;33;.971;3600000;0
16497;178950;3916;0;0;0;0;.00nan;0;0
16497;44189;4247;88;37;2;35;.946;3597000;0
16497;57564;4247;0;0;0;0;.00nan;0;0
16498;178695;174;81;19;1;18;.947;3600000;0
16498;173961;172;0;0;0;0;.00nan;0;0
16498;37786;174;0;0;0;0;.00nan;0;0
16498;191026;172;38;22;4;18;.818;3600000;0
16499;14191;169;0;0;0;0;.00nan;0;0
16499;44203;170;80;35;2;33;.943;3600000;0
16499;78820;169;55;27;3;24;.889;3600000;0
16499;91212;170;0;0;0;0;.00nan;0;0
16500;161535;167;66;29;4;25;.862;3900000;0
16500;-1;175;50;20;4;16;.800;3900000;0
16500;57155;167;0;0;0;0;.00nan;0;0
16500;86344;175;0;0;0;0;.00nan;0;0
16501;186527;171;0;0;0;0;.00nan;0;0
16501;44189;4247;0;0;0;0;.00nan;0;0
16501;57564;4247;79;33;2;31;.939;3600000;0
16501;65125;171;50;30;4;26;.867;3558000;0
16502;501;1527;51;19;2;17;.895;3600000;0
16502;19708;1527;0;0;0;0;.00nan;0;0
16502;184229;3916;0;0;0;0;.00nan;0;0
16502;178950;3916;74;41;3;38;.927;3600000;0
16503;178695;174;85;41;3;38;.927;3547000;0
16503;173961;172;76;31;2;29;.935;3600000;0
16503;37786;174;0;0;0;0;.00nan;0;0
16503;191026;172;0;0;0;0;.00nan;0;0
16504;14191;169;0;0;0;0;.00nan;0;0
16504;44203;170;0;0;0;0;.00nan;0;0
16504;78820;169;65;29;3;26;.897;3600000;0
16504;91212;170;53;34;4;30;.882;3559000;0
16505;161535;167;0;0;0;0;.00nan;0;0
16505;-1;175;0;0;0;0;.00nan;0;0
16505;57155;167;79;33;2;31;.939;3600000;0
16505;86344;175;72;45;5;40;.889;3600000;0
16506;173961;172;65;27;3;24;.889;3600000;0
16506;191026;172;0;0;0;0;.00nan;0;0
16506;44203;170;66;50;6;44;.880;2661000;0
16506;91212;170;35;7;2;5;.714;939000;0
16507;501;1527;60;37;4;33;.892;3555000;0
16507;161535;167;99;51;3;48;.941;3600000;0
16507;19708;1527;0;0;0;0;.00nan;0;0
16507;57155;167;0;0;0;0;.00nan;0;0
16508;184229;3916;71;47;4;43;.915;3884000;0
16508;178950;3916;0;0;0;0;.00nan;0;0
16508;44189;4247;0;0;0;0;.00nan;0;0
16508;57564;4247;58;32;5;27;.844;3884000;0
16509;178695;174;94;38;2;36;.947;3600000;0
16509;37786;174;0;0;0;0;.00nan;0;0
16509;186527;171;43;28;5;23;.821;3600000;0
16509;65125;171;0;0;0;0;.00nan;0;0
16510;14191;169;59;6;0;6;1.000;1371000;0
16510;-1;175;68;29;3;26;.897;3600000;0
16510;78820;169;25;18;5;13;.722;2157000;0
16510;86344;175;0;0;0;0;.00nan;0;0
16511;173961;172;0;0;0;0;.00nan;0;0
16511;191026;172;45;32;5;27;.844;3600000;0
16511;44203;170;0;0;0;0;.00nan;0;0
16511;91212;170;100;26;0;26;1.000;3600000;0
16512;501;1527;80;20;1;19;.950;3600000;0
16512;161535;167;0;0;0;0;.00nan;0;0
16512;19708;1527;0;0;0;0;.00nan;0;0
16512;57155;167;96;38;2;36;.947;3582000;0
16513;184229;3916;0;0;0;0;.00nan;0;0
16513;178950;3916;89;31;1;30;.968;3790000;0
16513;44189;4247;100;29;0;29;1.000;3790000;0
16513;57564;4247;0;0;0;0;.00nan;0;0
16514;178695;174;100;25;0;25;1.000;3600000;0
16514;37786;174;0;0;0;0;.00nan;0;0
16514;186527;171;0;0;0;0;.00nan;0;0
16514;65125;171;83;29;1;28;.966;3545000;0
16515;14191;169;0;0;0;0;.00nan;0;0
16515;-1;175;0;0;0;0;.00nan;0;0
16515;78820;169;98;43;2;41;.953;3549000;0
16515;86344;175;72;20;1;19;.950;3600000;0
16516;178695;174;100;27;0;27;1.000;3600000;0
16516;173961;172;67;33;3;30;.909;3600000;0
16516;37786;174;0;0;0;0;.00nan;0;0
16516;191026;172;0;0;0;0;.00nan;0;0
16517;186527;171;80;37;3;34;.919;3673000;0
16517;44203;170;0;0;0;0;.00nan;0;0
16517;65125;171;0;0;0;0;.00nan;0;0
16517;91212;170;92;44;2;42;.955;3673000;0
16518;161535;167;99;41;1;40;.976;3600000;0
16518;44189;4247;69;29;3;26;.897;3572000;0
16518;57155;167;0;0;0;0;.00nan;0;0
16518;57564;4247;0;0;0;0;.00nan;0;0
16519;178695;174;65;24;2;22;.917;3600000;0
16519;184229;3916;59;12;1;11;.917;1363000;0
16519;178950;3916;63;33;5;28;.848;2237000;0
16519;37786;174;0;0;0;0;.00nan;0;0
16520;501;1527;39;39;7;32;.821;3600000;0
16520;19708;1527;0;0;0;0;.00nan;0;0
16520;173961;172;0;0;0;0;.00nan;0;0
16520;191026;172;91;36;2;34;.944;3600000;0
16521;14191;169;0;0;0;0;.00nan;0;0
16521;-1;175;77;22;1;21;.955;3600000;0
16521;78820;169;65;26;3;23;.885;3587000;0
16521;86344;175;0;0;0;0;.00nan;0;0
16522;186527;171;100;37;0;37;1.000;3600000;0
16522;44203;170;17;24;6;18;.750;2732000;0
16522;65125;171;0;0;0;0;.00nan;0;0
16522;91212;170;66;13;0;13;1.000;868000;0
16523;178695;174;0;0;0;0;.00nan;0;0
16523;184229;3916;98;37;1;36;.973;3600000;0
16523;178950;3916;0;0;0;0;.00nan;0;0
16523;37786;174;11;30;8;22;.733;3600000;0
16524;501;1527;0;0;0;0;.00nan;0;0
16524;19708;1527;81;27;1;26;.963;3600000;0
16524;173961;172;72;37;3;34;.919;3515000;0
16524;191026;172;0;0;0;0;.00nan;0;0
16525;14191;169;48;24;4;20;.833;3600000;0
16525;-1;175;0;0;0;0;.00nan;0;0
16525;78820;169;0;0;0;0;.00nan;0;0
16525;86344;175;65;26;3;23;.885;3600000;0
16526;161535;167;0;0;0;0;.00nan;0;0
16526;44189;4247;0;0;0;0;.00nan;0;0
16526;57155;167;31;30;6;24;.800;3600000;0
16526;57564;4247;60;20;2;18;.900;3600000;0
16528;501;1527;0;0;0;0;.00nan;0;0
16528;19708;1527;68;23;2;21;.913;3600000;0
16528;44189;4247;0;0;0;0;.00nan;0;0
16528;57564;4247;48;38;5;33;.868;3600000;0
16530;-1;175;51;31;4;27;.871;3522000;0
16530;178695;174;95;40;2;38;.950;3600000;0
16530;37786;174;0;0;0;0;.00nan;0;0
16530;86344;175;0;0;0;0;.00nan;0;0
16532;161535;167;0;0;0;0;.00nan;0;0
16532;59592;171;100;28;0;28;1.000;3600000;0
16532;65125;171;0;0;0;0;.00nan;0;0
16532;77084;167;45;24;4;20;.833;3600000;0
16534;184229;3916;73;27;2;25;.926;3600000;0
16534;178950;3916;0;0;0;0;.00nan;0;0
16534;78820;169;0;0;0;0;.00nan;0;0
16534;86151;169;82;25;1;24;.960;3600000;0
16536;173961;172;0;0;0;0;.00nan;0;0
16536;191026;172;48;24;4;20;.833;3900000;0
16536;44561;170;0;0;0;0;.00nan;0;0
16536;91212;170;83;51;4;47;.922;3900000;0
1672;173961;172;0;0;0;0;.00nan;0;0
1672;191026;172;54;32;4;28;.875;3514000;0
1672;44189;4247;81;27;2;25;.926;3600000;0
1672;57564;4247;0;0;0;0;.00nan;0;0
1673;501;1527;100;27;0;27;1.000;3600000;0
1673;161535;167;91;46;3;43;.935;3600000;0
1673;19708;1527;0;0;0;0;.00nan;0;0
1673;57155;167;0;0;0;0;.00nan;0;0
1674;14191;169;0;0;0;0;.00nan;0;0
1674;-1;175;96;35;1;34;.971;3793000;0
1674;78820;169;79;22;2;20;.909;3793000;0
1674;86344;175;0;0;0;0;.00nan;0;0
1675;184229;3916;68;23;2;21;.913;3577000;0
1675;178950;3916;0;0;0;0;.00nan;0;0
1675;186527;171;93;38;1;37;.974;3600000;0
1675;65125;171;0;0;0;0;.00nan;0;0
1676;173961;172;0;0;0;0;.00nan;0;0
1676;191026;172;61;38;4;34;.895;3600000;0
1676;44189;4247;100;26;0;26;1.000;3600000;0
1676;57564;4247;0;0;0;0;.00nan;0;0
1677;501;1527;63;28;4;24;.857;3600000;0
1677;161535;167;70;46;6;40;.870;3592000;0
1677;19708;1527;0;0;0;0;.00nan;0;0
1677;57155;167;0;0;0;0;.00nan;0;0
1678;14191;169;0;0;0;0;.00nan;0;0
1678;-1;175;0;0;0;0;.00nan;0;0
1678;78820;169;58;29;4;25;.862;3600000;0
1678;86344;175;89;34;1;33;.971;3600000;0
1679;184229;3916;95;30;1;29;.967;3835000;0
1679;178950;3916;0;0;0;0;.00nan;0;0
1679;186527;171;64;23;2;21;.913;3835000;0
1679;65125;171;0;0;0;0;.00nan;0;0
1779;184229;3916;91;22;0;22;1.000;3600000;0
1779;178950;3916;0;0;0;0;.00nan;0;0
1779;186527;171;73;41;4;37;.902;3600000;0
1779;65125;171;0;0;0;0;.00nan;0;0
1842;-1;175;0;0;0;0;.00nan;0;0
1842;44189;4247;48;33;5;28;.848;3539000;0
1842;57564;4247;0;0;0;0;.00nan;0;0
1842;86344;175;73;37;3;34;.919;3600000;0
1843;501;1527;67;28;3;25;.893;3676000;0
1843;19708;1527;0;0;0;0;.00nan;0;0
1843;184229;3916;75;26;2;24;.923;3676000;0
1843;178950;3916;0;0;0;0;.00nan;0;0
1844;-1;175;0;0;0;0;.00nan;0;0
1844;44189;4247;46;29;5;24;.828;3541000;0
1844;57564;4247;0;0;0;0;.00nan;0;0
1844;86344;175;81;37;3;34;.919;3600000;0
1845;501;1527;88;33;1;32;.970;3600000;0
1845;19708;1527;0;0;0;0;.00nan;0;0
1845;184229;3916;60;39;6;33;.846;3600000;0
1845;178950;3916;0;0;0;0;.00nan;0;0
16537;189318;431;0;0;0;0;.00nan;0;0
16537;179478;432;0;0;0;0;.00nan;0;0
16537;182093;432;95;30;1;29;.967;3600000;0
16537;182225;431;74;35;2;33;.943;3600000;0
16538;183885;449;0;0;0;0;.00nan;0;0
16538;174241;421;70;17;1;16;.941;3600000;0
16538;74680;421;0;0;0;0;.00nan;0;0
16538;141530;449;86;54;3;51;.944;3513000;0
16539;178841;419;55;15;2;13;.867;3600000;0
16539;179143;423;87;62;5;57;.919;3600000;0
16539;-1;419;0;0;0;0;.00nan;0;0
16539;180781;423;0;0;0;0;.00nan;0;0
16540;183885;449;80;51;4;47;.922;3600000;0
16540;174241;421;72;21;1;20;.952;3600000;0
16540;74680;421;0;0;0;0;.00nan;0;0
16540;141530;449;0;0;0;0;.00nan;0;0
16541;178841;419;51;15;2;13;.867;3600000;0
16541;179143;423;0;0;0;0;.00nan;0;0
16541;-1;419;0;0;0;0;.00nan;0;0
16541;180781;423;67;49;5;44;.898;3600000;0
16542;168360;444;71;43;3;40;.930;3600000;0
16542;168855;444;0;0;0;0;.00nan;0;0
16542;179215;418;71;28;2;26;.929;3600000;0
16542;180965;418;0;0;0;0;.00nan;0;0
16543;171787;4849;0;0;0;0;.00nan;0;0
16543;179071;420;0;0;0;0;.00nan;0;0
16543;179259;4849;98;24;0;24;1.000;3600000;0
16543;186076;420;61;39;4;35;.897;3600000;0
16544;168360;444;56;38;5;33;.868;3600000;0
16544;168855;444;0;0;0;0;.00nan;0;0
16544;179215;418;78;36;2;34;.944;3600000;0
16544;180965;418;0;0;0;0;.00nan;0;0
16545;171787;4849;0;0;0;0;.00nan;0;0
16545;179071;420;0;0;0;0;.00nan;0;0
16545;179259;4849;48;30;4;26;.867;3600000;0
16545;186076;420;90;31;1;30;.968;3600000;0
16546;177155;411;60;8;0;8;1.000;1157000;0
16546;184033;411;13;21;6;15;.714;2443000;0
16546;179689;415;0;0;0;0;.00nan;0;0
16546;94557;415;77;43;3;40;.930;3600000;0
16547;163177;425;0;0;0;0;.00nan;0;0
16547;178679;435;0;0;0;0;.00nan;0;0
16547;-1;425;96;17;0;17;1.000;3600000;0
16547;91448;435;58;43;4;39;.907;3600000;0
16548;165023;438;0;0;0;0;.00nan;0;0
16548;170499;427;59;29;3;26;.897;3518000;0
16548;173954;438;77;26;1;25;.962;3600000;0
16548;149863;427;0;0;0;0;.00nan;0;0
16549;170928;443;0;0;0;0;.00nan;0;0
16549;182180;443;39;26;4;22;.846;3557000;0
16549;-1;433;0;0;0;0;.00nan;0;0
16549;-1;433;48;20;3;17;.850;3600000;0
16550;183832;436;29;30;6;24;.800;3298000;0
16550;170886;440;70;31;3;28;.903;3600000;0
16550;175723;440;0;0;0;0;.00nan;0;0
16550;191861;436;40;2;1;1;.500;302000;0
16551;-1;413;82;30;2;28;.933;3550000;0
16551;-1;412;65;20;1;19;.950;3600000;0
16551;-1;413;0;0;0;0;.00nan;0;0
16551;-1;412;0;0;0;0;.00nan;0;0
16552;168360;444;53;23;3;20;.870;3600000;0
16552;168855;444;0;0;0;0;.00nan;0;0
16552;179071;420;82;57;5;52;.912;3518000;0
16552;186076;420;0;0;0;0;.00nan;0;0
16553;173575;437;0;0;0;0;.00nan;0;0
16553;181100;442;55;32;4;28;.875;3580000;0
16553;-1;442;0;0;0;0;.00nan;0;0
16553;139865;437;67;26;2;24;.923;3600000;0
16554;171930;422;65;22;3;19;.864;3600000;0
16554;183885;449;36;33;6;27;.818;3190000;0
16554;179127;422;0;0;0;0;.00nan;0;0
16554;141530;449;45;5;1;4;.800;410000;0
16555;170499;427;83;36;3;33;.917;4200000;0
16555;85987;426;0;0;0;0;.00nan;0;0
16555;86226;426;68;34;3;31;.912;4200000;0
16555;149863;427;0;0;0;0;.00nan;0;0
16556;184336;429;0;0;0;0;.00nan;0;0
16556;170878;430;0;0;0;0;.00nan;0;0
16556;181135;430;72;36;3;33;.917;3580000;0
16556;-1;429;70;18;1;17;.944;3600000;0
16557;171787;4849;82;35;2;33;.943;3542000;0
16557;179215;418;0;0;0;0;.00nan;0;0
16557;179259;4849;0;0;0;0;.00nan;0;0
16557;180965;418;92;20;0;20;1.000;3600000;0
16558;168206;414;0;0;0;0;.00nan;0;0
16558;184183;410;36;35;6;29;.829;2769000;0
16558;175989;410;52;5;0;5;1.000;771000;0
16558;181346;414;67;41;4;37;.902;3600000;0
16559;179143;423;97;61;4;57;.934;3600000;0
16559;174241;421;61;15;1;14;.933;3600000;0
16559;180781;423;0;0;0;0;.00nan;0;0
16559;74680;421;0;0;0;0;.00nan;0;0
16560;173519;441;0;0;0;0;.00nan;0;0
16560;179657;441;44;41;6;35;.854;3600000;0
16560;187263;434;95;20;0;20;1.000;3600000;0
16560;152650;434;0;0;0;0;.00nan;0;0
16561;174386;428;34;26;6;20;.769;2626000;0
16561;174420;439;0;0;0;0;.00nan;0;0
16561;182210;439;66;19;2;17;.895;3600000;0
16561;86531;428;57;10;1;9;.900;974000;0
16562;178890;417;91;35;2;33;.943;3600000;0
16562;179689;415;0;0;0;0;.00nan;0;0
16562;-1;417;0;0;0;0;.00nan;0;0
16562;94557;415;65;43;4;39;.907;3521000;0
16563;163177;425;0;0;0;0;.00nan;0;0
16563;170928;443;0;0;0;0;.00nan;0;0
16563;-1;425;55;16;2;14;.875;3600000;0
16563;182180;443;63;40;4;36;.900;3595000;0
16564;173575;437;0;0;0;0;.00nan;0;0
16564;181100;442;66;33;3;30;.909;3600000;0
16564;-1;442;0;0;0;0;.00nan;0;0
16564;139865;437;100;35;0;35;1.000;3600000;0
16565;171930;422;60;13;1;12;.923;3600000;0
16565;183885;449;97;55;3;52;.945;3554000;0
16565;179127;422;0;0;0;0;.00nan;0;0
16565;141530;449;0;0;0;0;.00nan;0;0
16566;184336;429;65;31;4;27;.871;3600000;0
16566;-1;429;0;0;0;0;.00nan;0;0
16566;85987;426;0;0;0;0;.00nan;0;0
16566;86226;426;88;24;1;23;.958;3600000;0
16567;184183;410;0;0;0;0;.00nan;0;0
16567;-1;413;0;0;0;0;.00nan;0;0
16567;175989;410;59;36;4;32;.889;3584000;0
16567;-1;413;79;30;2;28;.933;3600000;0
16568;183832;436;47;30;4;26;.867;3600000;0
16568;187263;434;81;22;1;21;.955;3600000;0
16568;191861;436;0;0;0;0;.00nan;0;0
16568;152650;434;0;0;0;0;.00nan;0;0
16569;168360;444;0;0;0;0;.00nan;0;0
16569;168855;444;75;21;1;20;.952;3549000;0
16569;179071;420;0;0;0;0;.00nan;0;0
16569;186076;420;100;32;0;32;1.000;3600000;0
16570;171787;4849;0;0;0;0;.00nan;0;0
16570;179215;418;100;22;0;22;1.000;3600000;0
16570;179259;4849;58;39;5;34;.872;3600000;0
16570;180965;418;0;0;0;0;.00nan;0;0
16571;179143;423;0;0;0;0;.00nan;0;0
16571;174241;421;0;0;0;0;.00nan;0;0
16571;180781;423;89;50;4;46;.920;3600000;0
16571;74680;421;75;10;0;10;1.000;3600000;0
16572;168206;414;66;19;1;18;.947;3600000;0
16572;181346;414;0;0;0;0;.00nan;0;0
16572;-1;412;72;35;3;32;.914;3591000;0
16572;-1;412;0;0;0;0;.00nan;0;0
16573;173519;441;0;0;0;0;.00nan;0;0
16573;174420;439;0;0;0;0;.00nan;0;0
16573;179657;441;63;49;6;43;.878;3600000;0
16573;182210;439;93;15;0;15;1.000;3600000;0
16574;177155;411;0;0;0;0;.00nan;0;0
16574;184033;411;64;18;2;16;.889;3600000;0
16574;178890;417;77;46;5;41;.891;3600000;0
16574;-1;417;0;0;0;0;.00nan;0;0
16575;170886;440;65;26;2;24;.923;3551000;0
16575;174386;428;96;37;1;36;.973;3600000;0
16575;175723;440;0;0;0;0;.00nan;0;0
16575;86531;428;0;0;0;0;.00nan;0;0
16576;170499;427;72;26;2;24;.923;3600000;0
16576;-1;433;57;32;3;29;.906;3600000;0
16576;-1;433;0;0;0;0;.00nan;0;0
16576;149863;427;0;0;0;0;.00nan;0;0
16577;183832;436;0;0;0;0;.00nan;0;0
16577;173519;441;0;0;0;0;.00nan;0;0
16577;179657;441;100;44;1;43;.977;3600000;0
16577;191861;436;54;23;2;21;.913;3549000;0
16578;177155;411;55;5;0;5;1.000;666000;0
16578;168206;414;94;32;2;30;.938;3600000;0
16578;184033;411;32;32;6;26;.813;2934000;0
16578;181346;414;0;0;0;0;.00nan;0;0
16579;173575;437;0;0;0;0;.00nan;0;0
16579;189318;431;57;13;1;12;.923;995000;0
16579;182225;431;30;25;6;19;.760;2605000;0
16579;139865;437;76;36;3;33;.917;3600000;0
16580;173519;441;63;32;3;29;.906;3600000;0
16580;174386;428;62;36;4;32;.889;3600000;0
16580;179657;441;0;0;0;0;.00nan;0;0
16580;86531;428;0;0;0;0;.00nan;0;0
16581;184336;429;70;24;2;22;.917;3600000;0
16581;-1;429;0;0;0;0;.00nan;0;0
16581;-1;433;0;0;0;0;.00nan;0;0
16581;-1;433;79;36;3;33;.917;3574000;0
16582;177155;411;0;0;0;0;.00nan;0;0
16582;184033;411;61;34;3;31;.912;3600000;0
16582;-1;413;59;12;1;11;.917;1452000;0
16582;-1;413;31;28;6;22;.786;2148000;0
16583;168360;444;78;29;2;27;.931;3600000;0
16583;183885;449;0;0;0;0;.00nan;0;0
16583;168855;444;0;0;0;0;.00nan;0;0
16583;141530;449;65;34;3;31;.912;3570000;0
16584;163177;425;0;0;0;0;.00nan;0;0
16584;170499;427;50;33;5;28;.848;3756000;0
16584;-1;425;42;32;6;26;.813;3756000;0
16584;149863;427;0;0;0;0;.00nan;0;0
16585;170886;440;0;0;0;0;.00nan;0;0
16585;175723;440;42;17;3;14;.824;4006000;0
16585;181100;442;0;0;0;0;.00nan;0;0
16585;-1;442;68;49;4;45;.918;4006000;0
16586;179071;420;0;0;0;0;.00nan;0;0
16586;174241;421;57;25;3;22;.880;3600000;0
16586;186076;420;70;41;4;37;.902;3560000;0
16586;74680;421;0;0;0;0;.00nan;0;0
16587;179689;415;0;0;0;0;.00nan;0;0
16587;-1;412;91;53;4;49;.925;4200000;0
16587;-1;412;0;0;0;0;.00nan;0;0
16587;94557;415;54;39;4;35;.897;4200000;0
16588;170878;430;0;0;0;0;.00nan;0;0
16588;170928;443;0;0;0;0;.00nan;0;0
16588;181135;430;69;27;2;25;.926;3600000;0
16588;182180;443;62;30;3;27;.900;3600000;0
16589;178679;435;0;0;0;0;.00nan;0;0
16589;85987;426;0;0;0;0;.00nan;0;0
16589;86226;426;80;11;0;11;1.000;3600000;0
16589;91448;435;73;42;4;38;.905;3600000;0
16590;171930;422;0;0;0;0;.00nan;0;0
16590;179127;422;85;29;1;28;.966;3600000;0
16590;179215;418;0;0;0;0;.00nan;0;0
16590;180965;418;54;26;3;23;.885;3547000;0
16591;171787;4849;0;0;0;0;.00nan;0;0
16591;178841;419;35;19;5;14;.737;3776000;0
16591;179259;4849;84;51;4;47;.922;3776000;0
16591;-1;419;0;0;0;0;.00nan;0;0
16592;184183;410;0;0;0;0;.00nan;0;0
16592;178890;417;61;43;5;38;.884;3600000;0
16592;175989;410;77;24;1;23;.958;3600000;0
16592;-1;417;0;0;0;0;.00nan;0;0
16593;173575;437;53;46;6;40;.870;3600000;0
16593;187263;434;68;21;2;19;.905;3600000;0
16593;139865;437;0;0;0;0;.00nan;0;0
16593;152650;434;0;0;0;0;.00nan;0;0
16594;174420;439;0;0;0;0;.00nan;0;0
16594;179478;432;41;4;1;3;.750;308000;0
16594;182093;432;29;34;6;28;.824;3292000;0
16594;182210;439;57;11;1;10;.909;3600000;0
16595;179071;420;82;40;3;37;.925;3771000;0
16595;174241;421;0;0;0;0;.00nan;0;0
16595;186076;420;0;0;0;0;.00nan;0;0
16595;74680;421;63;20;2;18;.900;3771000;0
16596;183832;436;65;17;1;16;.941;3600000;0
16596;189318;431;54;39;5;34;.872;3600000;0
16596;182225;431;0;0;0;0;.00nan;0;0
16596;191861;436;0;0;0;0;.00nan;0;0
16597;170886;440;39;24;4;20;.833;3519000;0
16597;175723;440;0;0;0;0;.00nan;0;0
16597;181100;442;100;53;2;51;.962;3600000;0
16597;-1;442;0;0;0;0;.00nan;0;0
16598;165023;438;0;0;0;0;.00nan;0;0
16598;173954;438;85;32;2;30;.938;3600000;0
16598;-1;433;0;0;0;0;.00nan;0;0
16598;-1;433;43;31;5;26;.839;3600000;0
16599;184183;410;0;0;0;0;.00nan;0;0
16599;175989;410;79;29;2;27;.931;3600000;0
16599;179689;415;46;31;4;27;.871;3585000;0
16599;94557;415;0;0;0;0;.00nan;0;0
16600;168360;444;0;0;0;0;.00nan;0;0
16600;183885;449;98;42;2;40;.952;3600000;0
16600;168855;444;74;19;1;18;.947;3600000;0
16600;141530;449;0;0;0;0;.00nan;0;0
16601;170928;443;99;28;0;28;1.000;3600000;0
16601;182180;443;0;0;0;0;.00nan;0;0
16601;85987;426;0;0;0;0;.00nan;0;0
16601;86226;426;80;26;1;25;.962;3552000;0
16602;178679;435;26;28;6;22;.786;2648000;0
16602;170878;430;61;15;1;14;.933;3600000;0
16602;181135;430;0;0;0;0;.00nan;0;0
16602;91448;435;55;3;0;3;1.000;952000;0
16603;168206;414;61;29;3;26;.897;3600000;0
16603;-1;413;0;0;0;0;.00nan;0;0
16603;181346;414;0;0;0;0;.00nan;0;0
16603;-1;413;78;42;4;38;.905;3551000;0
16604;171930;422;48;25;4;21;.840;4200000;0
16604;179127;422;0;0;0;0;.00nan;0;0
16604;179215;418;70;47;4;43;.915;4200000;0
16604;180965;418;0;0;0;0;.00nan;0;0
16605;171787;4849;28;27;6;21;.778;3600000;0
16605;178841;419;65;19;1;18;.947;3600000;0
16605;179259;4849;0;0;0;0;.00nan;0;0
16605;-1;419;0;0;0;0;.00nan;0;0
16606;178890;417;0;0;0;0;.00nan;0;0
16606;-1;417;94;19;0;19;1.000;3600000;0
16606;-1;412;0;0;0;0;.00nan;0;0
16606;-1;412;70;33;3;30;.909;3600000;0
16607;163177;425;74;30;2;28;.933;3600000;0
16607;184336;429;51;39;5;34;.872;3600000;0
16607;-1;425;0;0;0;0;.00nan;0;0
16607;-1;429;0;0;0;0;.00nan;0;0
16608;174420;439;0;0;0;0;.00nan;0;0
16608;179478;432;53;35;4;31;.886;3600000;0
16608;182093;432;0;0;0;0;.00nan;0;0
16608;182210;439;68;23;1;22;.957;3600000;0
16609;184183;410;90;32;1;31;.969;3600000;0
16609;175989;410;0;0;0;0;.00nan;0;0
16609;-1;412;72;31;2;29;.935;3570000;0
16609;-1;412;0;0;0;0;.00nan;0;0
16610;165023;438;0;0;0;0;.00nan;0;0
16610;173954;438;82;31;2;29;.935;3600000;0
16610;184336;429;0;0;0;0;.00nan;0;0
16610;-1;429;67;17;1;16;.941;3600000;0
16611;174386;428;80;40;3;37;.925;3600000;0
16611;187263;434;88;15;0;15;1.000;3600000;0
16611;86531;428;0;0;0;0;.00nan;0;0
16611;152650;434;0;0;0;0;.00nan;0;0
16612;171787;4849;0;0;0;0;.00nan;0;0
16612;171930;422;45;20;3;17;.850;3518000;0
16612;179127;422;0;0;0;0;.00nan;0;0
16612;179259;4849;66;21;1;20;.952;3600000;0
16613;173519;441;0;0;0;0;.00nan;0;0
16613;179657;441;88;42;3;39;.929;3600000;0
16613;187263;434;73;9;0;9;1.000;3600000;0
16613;152650;434;0;0;0;0;.00nan;0;0
16614;178890;417;48;13;2;11;.846;1668000;0
16614;-1;413;52;33;5;28;.848;3600000;0
16614;-1;417;29;29;5;24;.828;1932000;0
16614;-1;413;0;0;0;0;.00nan;0;0
16615;183885;449;67;33;3;30;.909;3559000;0
16615;179071;420;0;0;0;0;.00nan;0;0
16615;186076;420;74;26;1;25;.962;3600000;0
16615;141530;449;0;0;0;0;.00nan;0;0
16616;173575;437;0;0;0;0;.00nan;0;0
16616;170928;443;64;24;2;22;.917;3600000;0
16616;182180;443;0;0;0;0;.00nan;0;0
16616;139865;437;60;25;3;22;.880;3581000;0
16617;170886;440;0;0;0;0;.00nan;0;0
16617;175723;440;61;37;4;33;.892;4200000;0
16617;85987;426;64;37;4;33;.892;4200000;0
16617;86226;426;0;0;0;0;.00nan;0;0
16618;189318;431;0;0;0;0;.00nan;0;0
16618;178679;435;0;0;0;0;.00nan;0;0
16618;182225;431;60;28;3;25;.893;4200000;0
16618;91448;435;80;47;3;44;.936;4200000;0
16619;178841;419;72;27;3;24;.889;4056000;0
16619;174241;421;65;23;2;21;.913;4056000;0
16619;-1;419;0;0;0;0;.00nan;0;0
16619;74680;421;0;0;0;0;.00nan;0;0
16620;165023;438;91;31;1;30;.968;3600000;0
16620;173954;438;0;0;0;0;.00nan;0;0
16620;184336;429;49;34;5;29;.853;3600000;0
16620;-1;429;0;0;0;0;.00nan;0;0
16621;163177;425;0;0;0;0;.00nan;0;0
16621;179478;432;57;5;0;5;1.000;480000;0
16621;-1;425;59;18;2;16;.889;3600000;0
16621;182093;432;24;35;7;28;.800;3120000;0
16622;183832;436;56;20;2;18;.900;3584000;0
16622;170878;430;0;0;0;0;.00nan;0;0
16622;181135;430;85;30;1;29;.967;3600000;0
16622;191861;436;0;0;0;0;.00nan;0;0
16623;168206;414;0;0;0;0;.00nan;0;0
16623;179689;415;0;0;0;0;.00nan;0;0
16623;181346;414;53;32;4;28;.875;4200000;0
16623;94557;415;58;32;4;28;.875;4200000;0
16624;179143;423;78;35;2;33;.943;3600000;0
16624;179215;418;0;0;0;0;.00nan;0;0
16624;180781;423;0;0;0;0;.00nan;0;0
16624;180965;418;63;28;3;25;.893;3600000;0
16625;173519;441;54;33;5;28;.848;3600000;0
16625;170499;427;89;21;0;21;1.000;3600000;0
16625;179657;441;0;0;0;0;.00nan;0;0
16625;149863;427;0;0;0;0;.00nan;0;0
16626;177155;411;0;0;0;0;.00nan;0;0
16626;184033;411;100;27;0;27;1.000;3600000;0
16626;184183;410;0;0;0;0;.00nan;0;0
16626;175989;410;56;24;3;21;.875;3600000;0
16627;-1;413;0;0;0;0;.00nan;0;0
16627;179689;415;81;32;1;31;.969;3600000;0
16627;-1;413;38;27;5;22;.815;3600000;0
16627;94557;415;0;0;0;0;.00nan;0;0
16628;173575;437;83;30;2;28;.933;3600000;0
16628;178679;435;60;48;5;43;.896;3600000;0
16628;91448;435;0;0;0;0;.00nan;0;0
16628;139865;437;0;0;0;0;.00nan;0;0
16629;183885;449;0;0;0;0;.00nan;0;0
16629;179071;420;71;30;3;27;.900;4200000;0
16629;186076;420;0;0;0;0;.00nan;0;0
16629;141530;449;87;44;3;41;.932;4200000;0
16630;183832;436;0;0;0;0;.00nan;0;0
16630;191861;436;73;23;1;22;.957;3600000;0
16630;85987;426;0;0;0;0;.00nan;0;0
16630;86226;426;75;31;2;29;.935;3549000;0
16631;189318;431;51;28;4;24;.857;3600000;0
16631;170928;443;0;0;0;0;.00nan;0;0
16631;182180;443;77;12;0;12;1.000;3600000;0
16631;182225;431;0;0;0;0;.00nan;0;0
16632;181100;442;0;0;0;0;.00nan;0;0
16632;-1;442;62;39;4;35;.897;3597000;0
16632;-1;433;0;0;0;0;.00nan;0;0
16632;-1;433;48;17;3;14;.824;3600000;0
16633;178841;419;58;27;3;24;.889;3600000;0
16633;174241;421;0;0;0;0;.00nan;0;0
16633;-1;419;0;0;0;0;.00nan;0;0
16633;74680;421;60;28;4;24;.857;3550000;0
16634;170499;427;100;36;1;35;.972;3600000;0
16634;179478;432;42;32;5;27;.844;3600000;0
16634;182093;432;0;0;0;0;.00nan;0;0
16634;149863;427;0;0;0;0;.00nan;0;0
16635;170878;430;87;33;1;32;.970;3997000;0
16635;170886;440;79;30;2;28;.933;3997000;0
16635;175723;440;0;0;0;0;.00nan;0;0
16635;181135;430;0;0;0;0;.00nan;0;0
16636;179143;423;0;0;0;0;.00nan;0;0
16636;179215;418;60;25;3;22;.880;3600000;0
16636;180781;423;65;36;4;32;.889;3600000;0
16636;180965;418;0;0;0;0;.00nan;0;0
16637;168206;414;68;22;2;20;.909;3600000;0
16637;178890;417;50;40;5;35;.875;3600000;0
16637;-1;417;0;0;0;0;.00nan;0;0
16637;181346;414;0;0;0;0;.00nan;0;0
16638;171787;4849;62;28;3;25;.893;3560000;0
16638;171930;422;82;28;2;26;.929;3600000;0
16638;179127;422;0;0;0;0;.00nan;0;0
16638;179259;4849;0;0;0;0;.00nan;0;0
16639;177155;411;0;0;0;0;.00nan;0;0
16639;184033;411;88;39;3;36;.923;3600000;0
16639;-1;412;47;26;4;22;.846;3600000;0
16639;-1;412;0;0;0;0;.00nan;0;0
16640;184183;410;0;0;0;0;.00nan;0;0
16640;175989;410;61;23;2;21;.913;3600000;0
16640;-1;412;0;0;0;0;.00nan;0;0
16640;-1;412;63;34;3;31;.912;3600000;0
16641;163177;425;62;9;0;9;1.000;1081000;0
16641;183832;436;0;0;0;0;.00nan;0;0
16641;-1;425;32;30;6;24;.800;2519000;0
16641;191861;436;58;17;3;14;.824;3600000;0
16642;189318;431;0;0;0;0;.00nan;0;0
16642;170499;427;97;22;0;22;1.000;3600000;0
16642;182225;431;80;35;3;32;.914;3600000;0
16642;149863;427;0;0;0;0;.00nan;0;0
16643;171787;4849;49;9;1;8;.889;439000;0
16643;174241;421;68;18;1;17;.944;3600000;0
16643;179259;4849;47;46;7;39;.848;3161000;0
16643;74680;421;0;0;0;0;.00nan;0;0
16644;168360;444;33;31;6;25;.806;3227000;0
16644;168855;444;48;0;0;0;.00nan;373000;0
16644;178841;419;70;32;3;29;.906;3600000;0
16644;-1;419;0;0;0;0;.00nan;0;0
16645;165023;438;0;0;0;0;.00nan;0;0
16645;173575;437;0;0;0;0;.00nan;0;0
16645;173954;438;66;33;3;30;.909;3600000;0
16645;139865;437;100;31;0;31;1.000;3600000;0
16646;168206;414;100;35;0;35;1.000;3600000;0
16646;179689;415;0;0;0;0;.00nan;0;0
16646;181346;414;0;0;0;0;.00nan;0;0
16646;94557;415;49;28;4;24;.857;3600000;0
16647;163177;425;52;43;7;36;.837;3600000;0
16647;-1;425;0;0;0;0;.00nan;0;0
16647;-1;433;76;29;2;27;.931;3600000;0
16647;-1;433;0;0;0;0;.00nan;0;0
16648;184336;429;0;0;0;0;.00nan;0;0
16648;170928;443;0;0;0;0;.00nan;0;0
16648;182180;443;76;27;2;25;.926;3659000;0
16648;-1;429;92;29;1;28;.966;3659000;0
16649;178679;435;0;0;0;0;.00nan;0;0
16649;174386;428;71;20;1;19;.950;3600000;0
16649;86531;428;0;0;0;0;.00nan;0;0
16649;91448;435;70;46;5;41;.891;3600000;0
16650;171930;422;65;37;4;33;.892;4180000;0
16650;179127;422;0;0;0;0;.00nan;0;0
16650;179143;423;64;43;4;39;.907;4200000;0
16650;180781;423;0;0;0;0;.00nan;0;0
16651;173519;441;0;0;0;0;.00nan;0;0
16651;179657;441;85;36;3;33;.917;3600000;0
16651;181100;442;23;18;5;13;.722;1911000;0
16651;-1;442;59;13;1;12;.923;1689000;0
16652;178890;417;43;35;6;29;.829;3640000;0
16652;-1;413;0;0;0;0;.00nan;0;0
16652;-1;417;0;0;0;0;.00nan;0;0
16652;-1;413;64;38;5;33;.868;3640000;0
16653;177155;411;0;0;0;0;.00nan;0;0
16653;184033;411;51;22;3;19;.864;3600000;0
16653;184183;410;0;0;0;0;.00nan;0;0
16653;175989;410;43;24;4;20;.833;3550000;0
16654;170886;440;0;0;0;0;.00nan;0;0
16654;179478;432;70;31;3;28;.903;3600000;0
16654;175723;440;57;33;4;29;.879;3541000;0
16654;182093;432;0;0;0;0;.00nan;0;0
16655;187263;434;75;9;0;9;1.000;3600000;0
16655;85987;426;0;0;0;0;.00nan;0;0
16655;86226;426;73;44;4;40;.909;3600000;0
16655;152650;434;0;0;0;0;.00nan;0;0
16656;170878;430;0;0;0;0;.00nan;0;0
16656;174420;439;0;0;0;0;.00nan;0;0
16656;181135;430;81;49;4;45;.918;3600000;0
16656;182210;439;69;17;1;16;.941;3600000;0
16657;173575;437;0;0;0;0;.00nan;0;0
16657;170499;427;56;25;3;22;.880;3600000;0
16657;139865;437;70;26;2;24;.923;3600000;0
16657;149863;427;0;0;0;0;.00nan;0;0
16658;183832;436;100;33;0;33;1.000;3600000;0
16658;179478;432;0;0;0;0;.00nan;0;0
16658;182093;432;77;31;2;29;.935;3598000;0
16658;191861;436;0;0;0;0;.00nan;0;0
16659;171787;4849;73;61;6;55;.902;3600000;0
16659;174241;421;0;0;0;0;.00nan;0;0
16659;179259;4849;0;0;0;0;.00nan;0;0
16659;74680;421;69;23;2;21;.913;3600000;0
16660;168360;444;0;0;0;0;.00nan;0;0
16660;168855;444;78;39;3;36;.923;3600000;0
16660;178841;419;0;0;0;0;.00nan;0;0
16660;-1;419;63;12;1;11;.917;3600000;0
16661;165023;438;95;41;2;39;.951;3600000;0
16661;189318;431;71;28;3;25;.893;3595000;0
16661;173954;438;0;0;0;0;.00nan;0;0
16661;182225;431;0;0;0;0;.00nan;0;0
16662;-1;413;68;36;3;33;.917;4200000;0
16662;179689;415;71;31;3;28;.903;4200000;0
16662;-1;413;0;0;0;0;.00nan;0;0
16662;94557;415;0;0;0;0;.00nan;0;0
16663;170886;440;56;32;4;28;.875;3600000;0
16663;175723;440;0;0;0;0;.00nan;0;0
16663;-1;433;100;28;0;28;1.000;3600000;0
16663;-1;433;0;0;0;0;.00nan;0;0
16664;170928;443;100;33;0;33;1.000;3600000;0
16664;174386;428;0;0;0;0;.00nan;0;0
16664;182180;443;0;0;0;0;.00nan;0;0
16664;86531;428;45;21;3;18;.857;3600000;0
16665;178679;435;51;37;5;32;.865;3600000;0
16665;184336;429;64;18;1;17;.944;3600000;0
16665;-1;429;0;0;0;0;.00nan;0;0
16665;91448;435;0;0;0;0;.00nan;0;0
16666;171930;422;0;0;0;0;.00nan;0;0
16666;179127;422;50;14;2;12;.857;3600000;0
16666;179143;423;0;0;0;0;.00nan;0;0
16666;180781;423;64;45;5;40;.889;3600000;0
16667;173519;441;82;25;1;24;.960;3600000;0
16667;179657;441;0;0;0;0;.00nan;0;0
16667;181100;442;49;25;3;22;.880;3542000;0
16667;-1;442;0;0;0;0;.00nan;0;0
16668;168206;414;100;35;1;34;.971;3600000;0
16668;178890;417;0;0;0;0;.00nan;0;0
16668;-1;417;62;32;3;29;.906;3563000;0
16668;181346;414;0;0;0;0;.00nan;0;0
16669;177155;411;85;30;1;29;.967;3600000;0
16669;184033;411;0;0;0;0;.00nan;0;0
16669;-1;412;66;29;2;27;.931;3569000;0
16669;-1;412;0;0;0;0;.00nan;0;0
16670;170878;430;79;53;5;48;.906;3716000;0
16670;181135;430;0;0;0;0;.00nan;0;0
16670;187263;434;30;20;4;16;.800;3716000;0
16670;152650;434;0;0;0;0;.00nan;0;0
16671;174420;439;64;18;1;17;.944;3600000;0
16671;182210;439;0;0;0;0;.00nan;0;0
16671;85987;426;65;34;4;30;.882;3600000;0
16671;86226;426;0;0;0;0;.00nan;0;0
16672;177155;411;0;0;0;0;.00nan;0;0
16672;184033;411;60;29;3;26;.897;3527000;0
16672;179689;415;55;16;1;15;.938;3600000;0
16672;94557;415;0;0;0;0;.00nan;0;0
16673;178679;435;0;0;0;0;.00nan;0;0
16673;-1;433;66;17;1;16;.941;3600000;0
16673;-1;433;0;0;0;0;.00nan;0;0
16673;91448;435;93;57;4;53;.930;3600000;0
16674;170499;427;88;27;1;26;.963;3600000;0
16674;184336;429;0;0;0;0;.00nan;0;0
16674;-1;429;47;34;5;29;.853;3600000;0
16674;149863;427;0;0;0;0;.00nan;0;0
16675;163177;425;0;0;0;0;.00nan;0;0
16675;170886;440;0;0;0;0;.00nan;0;0
16675;175723;440;33;32;6;26;.813;3600000;0
16675;-1;425;70;18;1;17;.944;3600000;0
16676;183832;436;74;26;2;24;.923;3600000;0
16676;174386;428;82;33;3;30;.909;3571000;0
16676;191861;436;0;0;0;0;.00nan;0;0
16676;86531;428;0;0;0;0;.00nan;0;0
16677;171930;422;66;30;3;27;.900;3571000;0
16677;178841;419;63;23;2;21;.913;3600000;0
16677;179127;422;0;0;0;0;.00nan;0;0
16677;-1;419;0;0;0;0;.00nan;0;0
16678;-1;413;74;36;3;33;.917;3600000;0
16678;-1;412;55;32;4;28;.875;3558000;0
16678;-1;413;0;0;0;0;.00nan;0;0
16678;-1;412;0;0;0;0;.00nan;0;0
16679;179071;420;0;0;0;0;.00nan;0;0
16679;179143;423;0;0;0;0;.00nan;0;0
16679;180781;423;93;23;0;23;1.000;3600000;0
16679;186076;420;37;29;5;24;.828;3600000;0
16680;173575;437;0;0;0;0;.00nan;0;0
16680;174420;439;0;0;0;0;.00nan;0;0
16680;182210;439;32;15;4;11;.733;3534000;0
16680;139865;437;89;35;2;33;.943;3600000;0
16681;189318;431;0;0;0;0;.00nan;0;0
16681;182225;431;67;39;4;35;.897;3600000;0
16681;-1;433;26;26;6;20;.769;2161000;0
16681;-1;433;55;6;0;6;1.000;1353000;0
16682;181100;442;25;28;6;22;.786;1987000;0
16682;-1;442;55;16;2;14;.875;1613000;0
16682;187263;434;57;17;2;15;.882;3600000;0
16682;152650;434;0;0;0;0;.00nan;0;0
16683;171930;422;0;0;0;0;.00nan;0;0
16683;178841;419;59;18;2;16;.889;3600000;0
16683;179127;422;62;30;3;27;.900;3579000;0
16683;-1;419;0;0;0;0;.00nan;0;0
16684;171787;4849;0;0;0;0;.00nan;0;0
16684;168360;444;54;21;3;18;.857;3546000;0
16684;168855;444;0;0;0;0;.00nan;0;0
16684;179259;4849;97;40;1;39;.975;3600000;0
16685;170878;430;0;0;0;0;.00nan;0;0
16685;181135;430;60;28;3;25;.893;3537000;0
16685;85987;426;0;0;0;0;.00nan;0;0
16685;86226;426;83;26;1;25;.962;3600000;0
16686;170928;443;69;29;2;27;.931;3568000;0
16686;179478;432;99;38;1;37;.974;3600000;0
16686;182093;432;0;0;0;0;.00nan;0;0
16686;182180;443;0;0;0;0;.00nan;0;0
16687;183885;449;0;0;0;0;.00nan;0;0
16687;179215;418;0;0;0;0;.00nan;0;0
16687;180965;418;68;49;6;43;.878;4200000;0
16687;141530;449;38;36;6;30;.833;4200000;0
16688;165023;438;55;19;4;15;.789;3647000;0
16688;178679;435;0;0;0;0;.00nan;0;0
16688;173954;438;0;0;0;0;.00nan;0;0
16688;91448;435;66;41;5;36;.878;3647000;0
16689;168206;414;0;0;0;0;.00nan;0;0
16689;184183;410;0;0;0;0;.00nan;0;0
16689;175989;410;39;24;4;20;.833;3600000;0
16689;181346;414;100;33;0;33;1.000;3600000;0
16690;183832;436;0;0;0;0;.00nan;0;0
16690;173519;441;0;0;0;0;.00nan;0;0
16690;179657;441;74;34;3;31;.912;3600000;0
16690;191861;436;46;24;4;20;.833;3556000;0
16691;178890;417;65;16;1;15;.938;3600000;0
16691;179689;415;82;38;3;35;.921;3600000;0
16691;-1;417;0;0;0;0;.00nan;0;0
16691;94557;415;0;0;0;0;.00nan;0;0
16692;184183;410;55;38;5;33;.868;3600000;0
16692;-1;413;0;0;0;0;.00nan;0;0
16692;175989;410;0;0;0;0;.00nan;0;0
16692;-1;413;61;23;2;21;.913;3600000;0
16693;179071;420;73;40;4;36;.900;3600000;0
16693;179143;423;0;0;0;0;.00nan;0;0
16693;180781;423;81;26;1;25;.962;3600000;0
16693;186076;420;0;0;0;0;.00nan;0;0
16694;173575;437;0;0;0;0;.00nan;0;0
16694;-1;433;62;27;2;25;.926;3513000;0
16694;-1;433;0;0;0;0;.00nan;0;0
16694;139865;437;100;33;0;33;1.000;3600000;0
16695;170878;430;42;26;4;22;.846;1146000;0
16695;181135;430;54;21;2;19;.905;2454000;0
16695;85987;426;76;19;1;18;.947;3600000;0
16695;86226;426;0;0;0;0;.00nan;0;0
16696;189318;431;66;50;6;44;.880;4200000;0
16696;174420;439;18;21;6;15;.714;2926000;0
16696;182210;439;59;3;0;3;1.000;1273000;0
16696;182225;431;0;0;0;0;.00nan;0;0
16697;181100;442;100;37;0;37;1.000;3600000;0
16697;-1;442;0;0;0;0;.00nan;0;0
16697;187263;434;67;25;2;23;.920;3579000;0
16697;152650;434;0;0;0;0;.00nan;0;0
16698;171787;4849;68;46;5;41;.891;3600000;0
16698;168360;444;0;0;0;0;.00nan;0;0
16698;168855;444;51;20;3;17;.850;3600000;0
16698;179259;4849;0;0;0;0;.00nan;0;0
16699;165023;438;0;0;0;0;.00nan;0;0
16699;173954;438;85;28;1;27;.964;3600000;0
16699;170928;443;0;0;0;0;.00nan;0;0
16699;182180;443;67;23;2;21;.913;3560000;0
16700;183885;449;92;51;4;47;.922;3902000;0
16700;179215;418;68;34;3;31;.912;3902000;0
16700;180965;418;0;0;0;0;.00nan;0;0
16700;141530;449;0;0;0;0;.00nan;0;0
16701;178679;435;64;29;3;26;.897;3528000;0
16701;179478;432;0;0;0;0;.00nan;0;0
16701;182093;432;85;22;1;21;.955;3600000;0
16701;91448;435;0;0;0;0;.00nan;0;0
16702;168206;414;61;18;2;16;.889;3310000;0
16702;181346;414;24;6;3;3;.500;290000;0
16702;-1;412;0;0;0;0;.00nan;0;0
16702;-1;412;59;26;3;23;.885;3600000;0
16703;163177;425;0;0;0;0;.00nan;0;0
16703;174386;428;89;39;2;37;.949;3912000;0
16703;-1;425;77;22;1;21;.955;3912000;0
16703;86531;428;0;0;0;0;.00nan;0;0
16704;177155;411;0;0;0;0;.00nan;0;0
16704;184033;411;78;32;3;29;.906;3600000;0
16704;178890;417;0;0;0;0;.00nan;0;0
16704;-1;417;57;30;5;25;.833;3580000;0
16705;173519;441;75;33;2;31;.939;4200000;0
16705;170886;440;76;33;2;31;.939;4200000;0
16705;175723;440;0;0;0;0;.00nan;0;0
16705;179657;441;0;0;0;0;.00nan;0;0
16706;170499;427;0;0;0;0;.00nan;0;0
16706;184336;429;89;29;1;28;.966;3600000;0
16706;-1;429;0;0;0;0;.00nan;0;0
16706;149863;427;32;44;8;36;.818;3600000;0
16707;177155;411;0;0;0;0;.00nan;0;0
16707;168206;414;41;33;5;28;.848;3600000;0
16707;184033;411;66;30;3;27;.900;3600000;0
16707;181346;414;0;0;0;0;.00nan;0;0
16708;165023;438;0;0;0;0;.00nan;0;0
16708;173954;438;47;33;5;28;.848;3523000;0
16708;184336;429;74;33;3;30;.909;3600000;0
16708;-1;429;0;0;0;0;.00nan;0;0
16709;183832;436;88;23;1;22;.957;3658000;0
16709;189318;431;0;0;0;0;.00nan;0;0
16709;182225;431;94;45;2;43;.956;3658000;0
16709;191861;436;0;0;0;0;.00nan;0;0
16710;179478;432;36;27;5;22;.815;3573000;0
16710;181100;442;70;36;4;32;.889;3600000;0
16710;182093;432;0;0;0;0;.00nan;0;0
16710;-1;442;0;0;0;0;.00nan;0;0
16711;163177;425;67;27;2;25;.926;3600000;0
16711;173519;441;0;0;0;0;.00nan;0;0
16711;179657;441;57;30;4;26;.867;3537000;0
16711;-1;425;0;0;0;0;.00nan;0;0
16712;177155;411;0;0;0;0;.00nan;0;0
16712;184033;411;81;32;2;30;.938;3600000;0
16712;-1;413;82;33;3;30;.909;3566000;0
16712;186332;413;0;0;0;0;.00nan;0;0
16713;178679;435;0;0;0;0;.00nan;0;0
16713;85987;426;79;24;1;23;.958;3600000;0
16713;86226;426;0;0;0;0;.00nan;0;0
16713;91448;435;44;39;6;33;.846;3600000;0
16714;184183;410;82;28;1;27;.964;3600000;0
16714;178890;417;86;43;3;40;.930;3600000;0
16714;175989;410;0;0;0;0;.00nan;0;0
16714;-1;417;0;0;0;0;.00nan;0;0
16715;189318;431;74;30;2;28;.933;3600000;0
16715;174386;428;76;25;1;24;.960;3600000;0
16715;182225;431;0;0;0;0;.00nan;0;0
16715;86531;428;0;0;0;0;.00nan;0;0
16716;168360;444;0;0;0;0;.00nan;0;0
16716;168855;444;78;19;1;18;.947;3600000;0
16716;179071;420;0;0;0;0;.00nan;0;0
16716;186076;420;77;43;3;40;.930;3566000;0
16717;179478;432;0;0;0;0;.00nan;0;0
16717;181100;442;0;0;0;0;.00nan;0;0
16717;182093;432;65;22;1;21;.955;3754000;0
16717;-1;442;94;38;2;36;.947;3754000;0
16718;170878;430;67;19;1;18;.947;3059000;0
16718;170928;443;51;30;5;25;.833;3552000;0
16718;181135;430;31;10;3;7;.700;541000;0
16718;182180;443;0;0;0;0;.00nan;0;0
16719;178841;419;63;18;1;17;.944;3600000;0
16719;179215;418;0;0;0;0;.00nan;0;0
16719;-1;419;0;0;0;0;.00nan;0;0
16719;180965;418;75;39;4;35;.897;3600000;0
16720;183885;449;76;46;4;42;.913;4200000;0
16720;179143;423;48;27;4;23;.852;4200000;0
16720;180781;423;0;0;0;0;.00nan;0;0
16720;141530;449;0;0;0;0;.00nan;0;0
16721;179689;415;68;35;3;32;.914;3595000;0
16721;-1;412;80;31;2;29;.935;3600000;0
16721;-1;412;0;0;0;0;.00nan;0;0
16721;94557;415;0;0;0;0;.00nan;0;0
16722;171930;422;68;28;3;25;.893;3901000;0
16722;179127;422;0;0;0;0;.00nan;0;0
16722;174241;421;46;24;4;20;.833;3901000;0
16722;74680;421;0;0;0;0;.00nan;0;0
16723;173575;437;0;0;0;0;.00nan;0;0
16723;170886;440;0;0;0;0;.00nan;0;0
16723;175723;440;48;30;4;26;.867;3600000;0
16723;139865;437;99;36;1;35;.972;3600000;0
16724;170499;427;73;36;4;32;.889;3569000;0
16724;187263;434;55;18;3;15;.833;3600000;0
16724;149863;427;0;0;0;0;.00nan;0;0
16724;152650;434;0;0;0;0;.00nan;0;0
16725;174420;439;0;0;0;0;.00nan;0;0
16725;182210;439;90;15;0;15;1.000;3600000;0
16725;-1;433;98;44;1;43;.977;3568000;0
16725;-1;433;0;0;0;0;.00nan;0;0
16726;168360;444;24;13;5;8;.615;3600000;0
16726;168855;444;0;0;0;0;.00nan;0;0
16726;179071;420;29;30;6;24;.800;3135000;0
16726;186076;420;53;4;0;4;1.000;427000;0
16727;170928;443;0;0;0;0;.00nan;0;0
16727;182180;443;69;39;2;37;.949;4200000;0
16727;85987;426;0;0;0;0;.00nan;0;0
16727;86226;426;92;36;2;34;.944;4159000;0
16728;184183;410;0;0;0;0;.00nan;0;0
16728;175989;410;54;33;5;28;.848;3563000;0
16728;179689;415;0;0;0;0;.00nan;0;0
16728;94557;415;67;34;3;31;.912;3600000;0
16729;163177;425;0;0;0;0;.00nan;0;0
16729;165023;438;90;32;1;31;.969;3600000;0
16729;173954;438;0;0;0;0;.00nan;0;0
16729;-1;425;69;30;2;28;.933;3574000;0
16730;178679;435;64;43;5;38;.884;3600000;0
16730;170878;430;0;0;0;0;.00nan;0;0
16730;181135;430;67;39;4;35;.897;3600000;0
16730;91448;435;0;0;0;0;.00nan;0;0
16731;178841;419;79;24;1;23;.958;3600000;0
16731;179215;418;71;30;2;28;.933;3600000;0
16731;-1;419;0;0;0;0;.00nan;0;0
16731;180965;418;0;0;0;0;.00nan;0;0
16732;168206;414;0;0;0;0;.00nan;0;0
16732;-1;413;79;27;3;24;.889;3812000;0
16732;181346;414;61;22;2;20;.909;3812000;0
16732;-1;413;0;0;0;0;.00nan;0;0
16733;183885;449;0;0;0;0;.00nan;0;0
16733;179143;423;0;0;0;0;.00nan;0;0
16733;180781;423;59;21;2;19;.905;3600000;0
16733;141530;449;86;29;1;28;.966;3600000;0
16734;178890;417;0;0;0;0;.00nan;0;0
16734;-1;417;60;27;3;24;.889;3600000;0
16734;-1;412;0;0;0;0;.00nan;0;0
16734;-1;412;62;32;4;28;.875;3566000;0
16735;170886;440;78;22;1;21;.955;3600000;0
16735;174386;428;0;0;0;0;.00nan;0;0
16735;175723;440;0;0;0;0;.00nan;0;0
16735;86531;428;84;33;2;31;.939;3556000;0
16736;171930;422;0;0;0;0;.00nan;0;0
16736;179127;422;100;25;0;25;1.000;3600000;0
16736;174241;421;0;0;0;0;.00nan;0;0
16736;74680;421;42;31;6;25;.806;3600000;0
16737;173519;441;0;0;0;0;.00nan;0;0
16737;184336;429;0;0;0;0;.00nan;0;0
16737;179657;441;57;35;4;31;.886;3600000;0
16737;-1;429;54;20;3;17;.850;3600000;0
16738;-1;433;0;0;0;0;.00nan;0;0
16738;187263;434;0;0;0;0;.00nan;0;0
16738;-1;433;48;26;4;22;.846;3600000;0
16738;152650;434;83;28;1;27;.964;3600000;0
16739;170499;427;0;0;0;0;.00nan;0;0
16739;174420;439;0;0;0;0;.00nan;0;0
16739;182210;439;67;24;2;22;.917;3600000;0
16739;149863;427;72;52;5;47;.904;3600000;0
16740;183832;436;69;23;2;21;.913;3600000;0
16740;173575;437;51;2;0;2;1.000;325000;0
16740;191861;436;0;0;0;0;.00nan;0;0
16740;139865;437;67;34;4;30;.882;3219000;0
16741;184183;410;0;0;0;0;.00nan;0;0
16741;175989;410;53;42;6;36;.857;3600000;0
16741;-1;412;57;22;3;19;.864;3600000;0
16741;-1;412;0;0;0;0;.00nan;0;0
16742;178679;435;0;0;0;0;.00nan;0;0
16742;170928;443;62;32;3;29;.906;3600000;0
16742;182180;443;0;0;0;0;.00nan;0;0
16742;91448;435;73;31;2;29;.935;3600000;0
16743;163177;425;0;0;0;0;.00nan;0;0
16743;-1;425;48;19;3;16;.842;3600000;0
16743;-1;433;61;38;4;34;.895;3558000;0
16743;-1;433;0;0;0;0;.00nan;0;0
16744;173519;441;0;0;0;0;.00nan;0;0
16744;189318;431;0;0;0;0;.00nan;0;0
16744;179657;441;82;35;3;32;.914;3600000;0
16744;182225;431;91;21;0;21;1.000;3600000;0
16745;170878;430;52;31;4;27;.871;4200000;0
16745;174386;428;66;42;4;38;.905;4200000;0
16745;181135;430;0;0;0;0;.00nan;0;0
16745;86531;428;0;0;0;0;.00nan;0;0
16746;179071;420;0;0;0;0;.00nan;0;0
16746;179215;418;0;0;0;0;.00nan;0;0
16746;180965;418;100;27;0;27;1.000;3600000;0
16746;186076;420;75;33;3;30;.909;3573000;0
16747;173575;437;0;0;0;0;.00nan;0;0
16747;189318;431;0;0;0;0;.00nan;0;0
16747;182225;431;85;31;1;30;.968;3600000;0
16747;139865;437;52;31;4;27;.871;3600000;0
16748;183885;449;70;51;5;46;.902;3600000;0
16748;178841;419;95;20;0;20;1.000;3600000;0
16748;-1;419;0;0;0;0;.00nan;0;0
16748;141530;449;0;0;0;0;.00nan;0;0
16749;165023;438;36;34;6;28;.824;3600000;0
16749;183832;436;76;23;1;22;.957;3600000;0
16749;173954;438;0;0;0;0;.00nan;0;0
16749;191861;436;0;0;0;0;.00nan;0;0
16750;168360;444;0;0;0;0;.00nan;0;0
16750;168855;444;91;33;1;32;.970;3600000;0
16750;174241;421;75;31;2;29;.935;3600000;0
16750;74680;421;0;0;0;0;.00nan;0;0
16751;168206;414;0;0;0;0;.00nan;0;0
16751;179689;415;64;34;4;30;.882;3629000;0
16751;181346;414;44;28;5;23;.821;3629000;0
16751;94557;415;0;0;0;0;.00nan;0;0
16752;170878;430;0;0;0;0;.00nan;0;0
16752;179478;432;58;34;4;30;.882;4200000;0
16752;181135;430;69;44;4;40;.909;4200000;0
16752;182093;432;0;0;0;0;.00nan;0;0
16753;178679;435;0;0;0;0;.00nan;0;0
16753;170928;443;0;0;0;0;.00nan;0;0
16753;182180;443;65;19;1;18;.947;3600000;0
16753;91448;435;70;30;2;28;.933;3540000;0
16754;177155;411;0;0;0;0;.00nan;0;0
16754;184033;411;66;26;2;24;.923;3541000;0
16754;-1;412;76;24;1;23;.958;3600000;0
16754;-1;412;0;0;0;0;.00nan;0;0
16755;174386;428;0;0;0;0;.00nan;0;0
16755;85987;426;0;0;0;0;.00nan;0;0
16755;86226;426;57;37;4;33;.892;3561000;0
16755;86531;428;69;28;2;26;.929;3600000;0
16756;171787;4849;0;0;0;0;.00nan;0;0
16756;179143;423;0;0;0;0;.00nan;0;0
16756;179259;4849;71;31;2;29;.935;3600000;0
16756;180781;423;59;35;4;31;.886;3558000;0
16757;178890;417;42;25;4;21;.840;3591000;0
16757;-1;413;74;31;3;28;.903;3600000;0
16757;-1;417;0;0;0;0;.00nan;0;0
16757;-1;413;0;0;0;0;.00nan;0;0
16758;184336;429;38;26;5;21;.808;3600000;0
16758;170886;440;77;25;1;24;.960;3600000;0
16758;175723;440;0;0;0;0;.00nan;0;0
16758;-1;429;0;0;0;0;.00nan;0;0
16759;174420;439;0;0;0;0;.00nan;0;0
16759;182210;439;93;30;1;29;.967;3600000;0
16759;187263;434;40;31;5;26;.839;3600000;0
16759;152650;434;0;0;0;0;.00nan;0;0
16760;163177;425;0;0;0;0;.00nan;0;0
16760;-1;425;79;10;0;10;1.000;3600000;0
16760;181100;442;59;38;4;34;.895;3600000;0
16760;-1;442;0;0;0;0;.00nan;0;0
16761;179071;420;100;44;2;42;.955;3600000;0
16761;179215;418;70;37;3;34;.919;3546000;0
16761;180965;418;0;0;0;0;.00nan;0;0
16761;186076;420;0;0;0;0;.00nan;0;0
16762;183885;449;58;26;3;23;.885;2529000;0
16762;178841;419;60;16;2;14;.875;3600000;0
16762;-1;419;0;0;0;0;.00nan;0;0
16762;141530;449;30;14;4;10;.714;1071000;0
16763;170499;427;79;31;2;29;.935;4200000;0
16763;181100;442;0;0;0;0;.00nan;0;0
16763;-1;442;83;38;2;36;.947;4200000;0
16763;149863;427;0;0;0;0;.00nan;0;0
16764;177155;411;86;34;2;32;.941;3572000;0
16764;184033;411;0;0;0;0;.00nan;0;0
16764;184183;410;0;0;0;0;.00nan;0;0
16764;175989;410;75;9;0;9;1.000;3600000;0
16765;183832;436;0;0;0;0;.00nan;0;0
16765;184336;429;0;0;0;0;.00nan;0;0
16765;-1;429;71;27;2;25;.926;3600000;0
16765;191861;436;46;22;3;19;.864;3548000;0
16766;-1;413;0;0;0;0;.00nan;0;0
16766;179689;415;0;0;0;0;.00nan;0;0
16766;-1;413;90;44;3;41;.932;3600000;0
16766;94557;415;75;25;2;23;.920;3600000;0
16767;168360;444;42;32;5;27;.844;3549000;0
16767;168855;444;0;0;0;0;.00nan;0;0
16767;174241;421;0;0;0;0;.00nan;0;0
16767;74680;421;73;32;3;29;.906;3600000;0
16768;179478;432;0;0;0;0;.00nan;0;0
16768;182093;432;59;27;3;24;.889;3600000;0
16768;85987;426;79;21;1;20;.952;3600000;0
16768;86226;426;0;0;0;0;.00nan;0;0
16769;173519;441;0;0;0;0;.00nan;0;0
16769;173575;437;0;0;0;0;.00nan;0;0
16769;179657;441;67;26;2;24;.923;3600000;0
16769;139865;437;55;31;4;27;.871;3557000;0
16770;171787;4849;50;25;3;22;.880;4200000;0
16770;179143;423;79;36;3;33;.917;4200000;0
16770;179259;4849;0;0;0;0;.00nan;0;0
16770;180781;423;0;0;0;0;.00nan;0;0
16771;168206;414;88;31;1;30;.968;4200000;0
16771;178890;417;0;0;0;0;.00nan;0;0
16771;-1;417;91;33;1;32;.970;4200000;0
16771;181346;414;0;0;0;0;.00nan;0;0
16772;165023;438;51;23;3;20;.870;2438000;0
16772;173954;438;11;12;5;7;.583;1162000;0
16772;170886;440;0;0;0;0;.00nan;0;0
16772;175723;440;45;19;3;16;.842;3600000;0
16773;174420;439;0;0;0;0;.00nan;0;0
16773;182210;439;66;17;1;16;.941;3553000;0
16773;187263;434;100;41;0;41;1.000;3600000;0
16773;152650;434;0;0;0;0;.00nan;0;0
16774;178679;435;0;0;0;0;.00nan;0;0
16774;-1;433;66;18;1;17;.944;3600000;0
16774;-1;433;0;0;0;0;.00nan;0;0
16774;91448;435;52;41;6;35;.854;3600000;0
16775;177155;411;0;0;0;0;.00nan;0;0
16775;184033;411;61;50;5;45;.900;4154000;0
16775;179689;415;43;41;6;35;.854;4104000;0
16775;94557;415;0;0;0;0;.00nan;0;0
16776;184183;410;0;0;0;0;.00nan;0;0
16776;-1;413;0;0;0;0;.00nan;0;0
16776;175989;410;40;25;5;20;.800;3600000;0
16776;-1;413;71;25;2;23;.920;3600000;0
16777;173519;441;0;0;0;0;.00nan;0;0
16777;174386;428;100;25;0;25;1.000;3600000;0
16777;179657;441;66;38;4;34;.895;3600000;0
16777;86531;428;0;0;0;0;.00nan;0;0
16778;165023;438;0;0;0;0;.00nan;0;0
16778;170499;427;84;35;2;33;.943;4200000;0
16778;173954;438;76;34;2;32;.941;4200000;0
16778;149863;427;0;0;0;0;.00nan;0;0
16779;173575;437;0;0;0;0;.00nan;0;0
16779;174386;428;85;21;1;20;.952;3600000;0
16779;86531;428;0;0;0;0;.00nan;0;0
16779;139865;437;78;37;3;34;.919;3586000;0
16780;171787;4849;0;0;0;0;.00nan;0;0
16780;183885;449;74;25;2;23;.920;3600000;0
16780;179259;4849;58;31;4;27;.871;3600000;0
16780;141530;449;0;0;0;0;.00nan;0;0
16781;168206;414;77;28;1;27;.964;3600000;0
16781;184183;410;98;43;2;41;.953;3570000;0
16781;175989;410;0;0;0;0;.00nan;0;0
16781;181346;414;0;0;0;0;.00nan;0;0
16782;184336;429;72;28;2;26;.929;3758000;0
16782;181100;442;85;31;1;30;.968;3758000;0
16782;-1;429;0;0;0;0;.00nan;0;0
16782;-1;442;0;0;0;0;.00nan;0;0
16783;183832;436;70;18;1;17;.944;3600000;0
16783;179478;432;45;11;2;9;.818;1434000;0
16783;182093;432;35;26;6;20;.769;2166000;0
16783;191861;436;0;0;0;0;.00nan;0;0
16784;178841;419;56;11;1;10;.909;3600000;0
16784;179071;420;0;0;0;0;.00nan;0;0
16784;-1;419;0;0;0;0;.00nan;0;0
16784;186076;420;82;56;5;51;.911;3600000;0
16785;171930;422;0;0;0;0;.00nan;0;0
16785;168360;444;43;5;1;4;.800;455000;0
16785;168855;444;42;35;6;29;.829;3145000;0
16785;179127;422;82;26;1;25;.962;3600000;0
16786;-1;433;0;0;0;0;.00nan;0;0
16786;-1;433;72;31;2;29;.935;3548000;0
16786;85987;426;0;0;0;0;.00nan;0;0
16786;86226;426;99;37;1;36;.973;3600000;0
16787;170928;443;86;49;4;45;.918;3565000;0
16787;174420;439;0;0;0;0;.00nan;0;0
16787;182180;443;0;0;0;0;.00nan;0;0
16787;182210;439;52;15;2;13;.867;3600000;0
16788;174241;421;69;22;2;20;.909;3600000;0
16788;179215;418;0;0;0;0;.00nan;0;0
16788;180965;418;67;36;3;33;.917;3600000;0
16788;74680;421;0;0;0;0;.00nan;0;0
16789;178679;435;0;0;0;0;.00nan;0;0
16789;187263;434;70;8;0;8;1.000;3600000;0
16789;91448;435;81;49;4;45;.918;3600000;0
16789;152650;434;0;0;0;0;.00nan;0;0
16790;-1;413;47;30;5;25;.833;3600000;0
16790;-1;412;78;27;1;26;.963;3600000;0
16790;-1;413;0;0;0;0;.00nan;0;0
16790;-1;412;0;0;0;0;.00nan;0;0
16791;177155;411;0;0;0;0;.00nan;0;0
16791;184033;411;54;29;4;25;.862;3567000;0
16791;178890;417;80;28;2;26;.929;3600000;0
16791;-1;417;0;0;0;0;.00nan;0;0
16792;189318;431;0;0;0;0;.00nan;0;0
16792;170886;440;67;26;2;24;.923;3791000;0
16792;175723;440;0;0;0;0;.00nan;0;0
16792;182225;431;84;27;1;26;.963;3791000;0
16793;163177;425;0;0;0;0;.00nan;0;0
16793;170878;430;89;41;2;39;.951;3599000;0
16793;-1;425;72;7;0;7;1.000;3600000;0
16793;181135;430;0;0;0;0;.00nan;0;0
16794;171787;4849;38;29;5;24;.828;3600000;0
16794;183885;449;0;0;0;0;.00nan;0;0
16794;179259;4849;0;0;0;0;.00nan;0;0
16794;141530;449;78;29;1;28;.966;3600000;0
16795;165023;438;41;35;6;29;.829;3600000;0
16795;173954;438;0;0;0;0;.00nan;0;0
16795;181100;442;0;0;0;0;.00nan;0;0
16795;-1;442;58;21;2;19;.905;3600000;0
16796;183832;436;0;0;0;0;.00nan;0;0
16796;173575;437;0;0;0;0;.00nan;0;0
16796;191861;436;37;17;4;13;.765;3600000;0
16796;139865;437;62;42;5;37;.881;3600000;0
16797;178841;419;0;0;0;0;.00nan;0;0
16797;179071;420;29;10;3;7;.700;512000;0
16797;-1;419;47;17;3;14;.824;3600000;0
16797;186076;420;67;44;4;40;.909;3088000;0
16798;178890;417;0;0;0;0;.00nan;0;0
16798;179689;415;59;45;6;39;.867;3600000;0
16798;-1;417;75;34;2;32;.941;3600000;0
16798;94557;415;0;0;0;0;.00nan;0;0
16799;171930;422;61;36;4;32;.889;3578000;0
16799;168360;444;72;30;2;28;.933;3600000;0
16799;168855;444;0;0;0;0;.00nan;0;0
16799;179127;422;0;0;0;0;.00nan;0;0
16800;170499;427;81;27;1;26;.963;3600000;0
16800;-1;433;60;19;2;17;.895;3579000;0
16800;-1;433;0;0;0;0;.00nan;0;0
16800;149863;427;0;0;0;0;.00nan;0;0
16801;170928;443;0;0;0;0;.00nan;0;0
16801;182180;443;56;40;5;35;.875;3600000;0
16801;187263;434;83;20;1;19;.950;3600000;0
16801;152650;434;0;0;0;0;.00nan;0;0
16802;174241;421;0;0;0;0;.00nan;0;0
16802;179215;418;69;37;3;34;.919;3600000;0
16802;180965;418;0;0;0;0;.00nan;0;0
16802;74680;421;28;19;5;14;.737;3600000;0
16803;178679;435;41;26;4;22;.846;1016000;0
16803;174420;439;0;0;0;0;.00nan;0;0
16803;182210;439;88;20;0;20;1.000;3600000;0
16803;91448;435;80;43;4;39;.907;2584000;0
16804;168206;414;0;0;0;0;.00nan;0;0
16804;181346;414;97;27;0;27;1.000;3600000;0
16804;-1;412;0;0;0;0;.00nan;0;0
16804;-1;412;58;30;4;26;.867;3600000;0
16805;173519;441;0;0;0;0;.00nan;0;0
16805;189318;431;0;0;0;0;.00nan;0;0
16805;179657;441;64;30;4;26;.867;4152000;0
16805;182225;431;85;45;3;42;.933;4122000;0
16806;170886;440;0;0;0;0;.00nan;0;0
16806;179478;432;71;30;2;28;.933;3600000;0
16806;175723;440;67;25;3;22;.880;3555000;0
16806;182093;432;0;0;0;0;.00nan;0;0
16807;163177;425;0;0;0;0;.00nan;0;0
16807;-1;425;73;26;1;25;.962;3600000;0
16807;85987;426;72;38;4;34;.895;3600000;0
16807;86226;426;0;0;0;0;.00nan;0;0
16808;189318;431;0;0;0;0;.00nan;0;0
16808;179478;432;36;27;5;22;.815;3887000;0
16808;182093;432;0;0;0;0;.00nan;0;0
16808;182225;431;71;36;4;32;.889;3887000;0
16809;177155;411;0;0;0;0;.00nan;0;0
16809;168206;414;0;0;0;0;.00nan;0;0
16809;184033;411;64;29;3;26;.897;3589000;0
16809;181346;414;81;27;1;26;.963;3600000;0
16810;179689;415;71;7;0;7;1.000;3600000;0
16810;-1;412;88;55;3;52;.945;3600000;0
16810;-1;412;0;0;0;0;.00nan;0;0
16810;94557;415;0;0;0;0;.00nan;0;0
16811;183832;436;43;30;6;24;.800;3600000;0
16811;-1;433;80;38;2;36;.947;3600000;0
16811;191861;436;0;0;0;0;.00nan;0;0
16811;-1;433;0;0;0;0;.00nan;0;0
16812;168206;414;78;31;3;28;.903;3572000;0
16812;-1;413;0;0;0;0;.00nan;0;0
16812;181346;414;0;0;0;0;.00nan;0;0
16812;-1;413;99;41;1;40;.976;3600000;0
16813;179071;420;63;40;4;36;.900;3600000;0
16813;174241;421;49;23;3;20;.870;3600000;0
16813;186076;420;0;0;0;0;.00nan;0;0
16813;74680;421;0;0;0;0;.00nan;0;0
16814;189318;431;0;0;0;0;.00nan;0;0
16814;182225;431;87;44;3;41;.932;3911000;0
16814;85987;426;0;0;0;0;.00nan;0;0
16814;86226;426;64;24;2;22;.917;3911000;0
16815;183832;436;0;0;0;0;.00nan;0;0
16815;170499;427;0;0;0;0;.00nan;0;0
16815;191861;436;66;29;2;27;.931;3600000;0
16815;149863;427;58;26;3;23;.885;3600000;0
16816;184183;410;0;0;0;0;.00nan;0;0
16816;175989;410;52;29;4;25;.862;3600000;0
16816;179689;415;60;28;3;25;.893;3600000;0
16816;94557;415;0;0;0;0;.00nan;0;0
16817;165023;438;0;0;0;0;.00nan;0;0
16817;173954;438;60;18;2;16;.889;3600000;0
16817;170928;443;49;25;4;21;.840;3561000;0
16817;182180;443;0;0;0;0;.00nan;0;0
16818;173575;437;0;0;0;0;.00nan;0;0
16818;170878;430;0;0;0;0;.00nan;0;0
16818;181135;430;69;32;3;29;.906;3600000;0
16818;139865;437;60;40;5;35;.875;3566000;0
16819;168360;444;86;26;1;25;.962;3600000;0
16819;168855;444;0;0;0;0;.00nan;0;0
16819;179143;423;0;0;0;0;.00nan;0;0
16819;180781;423;64;33;3;30;.909;3576000;0
16820;178890;417;64;35;4;31;.886;4179000;0
16820;-1;417;0;0;0;0;.00nan;0;0
16820;-1;412;76;36;3;33;.917;4179000;0
16820;-1;412;0;0;0;0;.00nan;0;0
16821;173519;441;51;34;5;29;.853;3600000;0
16821;170886;440;0;0;0;0;.00nan;0;0
16821;175723;440;54;17;2;15;.882;3600000;0
16821;179657;441;0;0;0;0;.00nan;0;0
16822;174386;428;63;31;4;27;.871;3600000;0
16822;181100;442;40;33;6;27;.818;2839000;0
16822;-1;442;62;7;0;7;1.000;739000;0
16822;86531;428;0;0;0;0;.00nan;0;0
16823;171930;422;81;31;2;29;.935;3600000;0
16823;183885;449;98;45;3;42;.933;3579000;0
16823;179127;422;0;0;0;0;.00nan;0;0
16823;141530;449;0;0;0;0;.00nan;0;0
16824;171787;4849;0;0;0;0;.00nan;0;0
16824;179215;418;0;0;0;0;.00nan;0;0
16824;179259;4849;46;33;5;28;.848;3600000;0
16824;180965;418;99;37;1;36;.973;3600000;0
16825;178679;435;0;0;0;0;.00nan;0;0
16825;184336;429;0;0;0;0;.00nan;0;0
16825;-1;429;75;20;1;19;.950;3600000;0
16825;91448;435;98;55;2;53;.964;3577000;0
16826;174420;439;0;0;0;0;.00nan;0;0
16826;182210;439;83;24;1;23;.958;3549000;0
16826;187263;434;86;20;0;20;1.000;3600000;0
16826;152650;434;0;0;0;0;.00nan;0;0
16827;173575;437;0;0;0;0;.00nan;0;0
16827;85987;426;97;17;0;17;1.000;3600000;0
16827;86226;426;0;0;0;0;.00nan;0;0
16827;139865;437;76;38;3;35;.921;3600000;0
16828;170499;427;71;30;3;27;.900;3600000;0
16828;170886;440;100;30;0;30;1.000;3600000;0
16828;175723;440;0;0;0;0;.00nan;0;0
16828;149863;427;0;0;0;0;.00nan;0;0
16829;184183;410;63;40;5;35;.875;3600000;0
16829;178890;417;0;0;0;0;.00nan;0;0
16829;175989;410;0;0;0;0;.00nan;0;0
16829;-1;417;64;27;2;25;.926;3600000;0
16830;179071;420;0;0;0;0;.00nan;0;0
16830;174241;421;0;0;0;0;.00nan;0;0
16830;186076;420;79;48;5;43;.896;3600000;0
16830;74680;421;70;20;2;18;.900;3600000;0
16831;165023;438;66;17;1;16;.941;3600000;0
16831;178679;435;45;43;6;37;.860;3233000;0
16831;173954;438;0;0;0;0;.00nan;0;0
16831;91448;435;53;2;0;2;1.000;367000;0
16832;179478;432;36;39;6;33;.846;3600000;0
16832;182093;432;0;0;0;0;.00nan;0;0
16832;-1;433;63;17;1;16;.941;3600000;0
16832;-1;433;0;0;0;0;.00nan;0;0
16833;189318;431;0;0;0;0;.00nan;0;0
16833;170878;430;45;37;6;31;.838;3600000;0
16833;181135;430;0;0;0;0;.00nan;0;0
16833;182225;431;76;31;3;28;.903;3600000;0
16834;168360;444;0;0;0;0;.00nan;0;0
16834;168855;444;65;14;1;13;.929;3600000;0
16834;179143;423;65;46;5;41;.891;3600000;0
16834;180781;423;0;0;0;0;.00nan;0;0
16835;174386;428;0;0;0;0;.00nan;0;0
16835;181100;442;0;0;0;0;.00nan;0;0
16835;-1;442;58;36;4;32;.889;3779000;0
16835;86531;428;49;22;3;19;.864;3757000;0
16836;171930;422;0;0;0;0;.00nan;0;0
16836;183885;449;96;49;2;47;.959;4200000;0
16836;179127;422;66;20;2;18;.900;4200000;0
16836;141530;449;0;0;0;0;.00nan;0;0
16837;171787;4849;54;36;4;32;.889;3600000;0
16837;179215;418;34;10;3;7;.700;348000;0
16837;179259;4849;0;0;0;0;.00nan;0;0
16837;180965;418;47;26;4;22;.846;3252000;0
16838;177155;411;0;0;0;0;.00nan;0;0
16838;184033;411;91;31;2;29;.935;3600000;0
16838;-1;413;73;39;3;36;.923;3543000;0
16838;-1;413;0;0;0;0;.00nan;0;0
16839;184336;429;76;28;1;27;.964;3600000;0
16839;170928;443;0;0;0;0;.00nan;0;0
16839;182180;443;37;47;7;40;.851;3600000;0
16839;-1;429;0;0;0;0;.00nan;0;0
16840;163177;425;0;0;0;0;.00nan;0;0
16840;-1;425;71;44;4;40;.909;3533000;0
16840;187263;434;52;17;2;15;.882;3600000;0
16840;152650;434;0;0;0;0;.00nan;0;0
16841;163177;425;93;50;4;46;.920;3600000;0
16841;174420;439;0;0;0;0;.00nan;0;0
16841;-1;425;0;0;0;0;.00nan;0;0
16841;182210;439;77;10;0;10;1.000;3600000;0
16842;165023;438;53;10;1;9;.900;1463000;0
16842;173954;438;35;20;4;16;.800;2137000;0
16842;170878;430;0;0;0;0;.00nan;0;0
16842;181135;430;92;35;2;33;.943;3600000;0
16843;168206;414;0;0;0;0;.00nan;0;0
16843;-1;413;0;0;0;0;.00nan;0;0
16843;181346;414;85;33;2;31;.939;3600000;0
16843;-1;413;54;22;3;19;.864;3551000;0
16844;170878;430;0;0;0;0;.00nan;0;0
16844;181135;430;62;27;4;23;.852;3579000;0
16844;85987;426;85;30;2;28;.933;3600000;0
16844;86226;426;0;0;0;0;.00nan;0;0
16845;173575;437;0;0;0;0;.00nan;0;0
16845;174386;428;97;40;1;39;.975;3600000;0
16845;86531;428;0;0;0;0;.00nan;0;0
16845;139865;437;98;53;2;51;.962;3600000;0
16846;171930;422;68;25;2;23;.920;3563000;0
16846;179071;420;0;0;0;0;.00nan;0;0
16846;179127;422;0;0;0;0;.00nan;0;0
16846;186076;420;78;25;1;24;.960;3600000;0
16847;183885;449;69;46;5;41;.891;3600000;0
16847;174241;421;56;20;2;18;.900;3600000;0
16847;74680;421;0;0;0;0;.00nan;0;0
16847;141530;449;0;0;0;0;.00nan;0;0
16848;163177;425;0;0;0;0;.00nan;0;0
16848;189318;431;100;28;0;28;1.000;3600000;0
16848;-1;425;71;24;1;23;.958;3566000;0
16848;182225;431;0;0;0;0;.00nan;0;0
16849;170928;443;50;25;4;21;.840;3551000;0
16849;181100;442;64;29;3;26;.897;3600000;0
16849;182180;443;0;0;0;0;.00nan;0;0
16849;-1;442;0;0;0;0;.00nan;0;0
16850;171787;4849;0;0;0;0;.00nan;0;0
16850;178841;419;57;18;3;15;.833;4200000;0
16850;179259;4849;97;57;3;54;.947;4200000;0
16850;-1;419;0;0;0;0;.00nan;0;0
16851;165023;438;0;0;0;0;.00nan;0;0
16851;173954;438;86;34;2;32;.941;3600000;0
16851;187263;434;32;26;5;21;.808;3600000;0
16851;152650;434;0;0;0;0;.00nan;0;0
16852;184183;410;0;0;0;0;.00nan;0;0
16852;175989;410;54;38;5;33;.868;3600000;0
16852;179689;415;66;22;2;20;.909;3600000;0
16852;94557;415;0;0;0;0;.00nan;0;0
16853;173519;441;0;0;0;0;.00nan;0;0
16853;179478;432;97;17;0;17;1.000;3600000;0
16853;179657;441;68;30;3;27;.900;3600000;0
16853;182093;432;0;0;0;0;.00nan;0;0
16854;170499;427;58;19;2;17;.895;3600000;0
16854;174386;428;0;0;0;0;.00nan;0;0
16854;86531;428;59;28;4;24;.857;3520000;0
16854;149863;427;0;0;0;0;.00nan;0;0
16855;178890;417;44;32;6;26;.813;3339000;0
16855;-1;417;49;1;0;1;1.000;261000;0
16855;-1;412;89;30;1;29;.967;3600000;0
16855;-1;412;0;0;0;0;.00nan;0;0
16856;177155;411;0;0;0;0;.00nan;0;0
16856;168206;414;78;25;2;23;.920;3600000;0
16856;184033;411;38;33;5;28;.848;3600000;0
16856;181346;414;0;0;0;0;.00nan;0;0
16857;184336;429;75;38;3;35;.921;3600000;0
16857;174420;439;0;0;0;0;.00nan;0;0
16857;182210;439;91;15;0;15;1.000;3600000;0
16857;-1;429;0;0;0;0;.00nan;0;0
16858;183832;436;75;29;2;27;.931;3586000;0
16858;170886;440;98;37;1;36;.973;3600000;0
16858;175723;440;0;0;0;0;.00nan;0;0
16858;191861;436;0;0;0;0;.00nan;0;0
16859;171930;422;0;0;0;0;.00nan;0;0
16859;179071;420;66;37;5;32;.865;3845000;0
16859;179127;422;66;28;4;24;.857;3845000;0
16859;186076;420;0;0;0;0;.00nan;0;0
16860;173575;437;0;0;0;0;.00nan;0;0
16860;189318;431;0;0;0;0;.00nan;0;0
16860;182225;431;44;27;4;23;.852;3566000;0
16860;139865;437;68;32;3;29;.906;3600000;0
16861;-1;433;70;28;3;25;.893;3518000;0
16861;-1;433;0;0;0;0;.00nan;0;0
16861;85987;426;0;0;0;0;.00nan;0;0
16861;86226;426;72;26;1;25;.962;3600000;0
16862;178679;435;0;0;0;0;.00nan;0;0
16862;181100;442;0;0;0;0;.00nan;0;0
16862;-1;442;75;30;2;28;.933;3812000;0
16862;91448;435;76;35;3;32;.914;3812000;0
16863;183885;449;69;27;2;25;.926;3600000;0
16863;174241;421;0;0;0;0;.00nan;0;0
16863;74680;421;74;20;1;19;.950;3600000;0
16863;141530;449;0;0;0;0;.00nan;0;0
16864;171787;4849;79;50;4;46;.920;4095000;0
16864;178841;419;0;0;0;0;.00nan;0;0
16864;179259;4849;0;0;0;0;.00nan;0;0
16864;-1;419;61;27;3;24;.889;4095000;0
16865;165023;438;76;39;3;36;.923;3600000;0
16865;173954;438;0;0;0;0;.00nan;0;0
16865;174420;439;0;0;0;0;.00nan;0;0
16865;182210;439;63;21;2;19;.905;3600000;0
16866;179689;415;0;0;0;0;.00nan;0;0
16866;-1;412;74;27;2;25;.926;3600000;0
16866;-1;412;0;0;0;0;.00nan;0;0
16866;94557;415;61;35;4;31;.886;3559000;0
16867;173519;441;76;31;2;29;.935;3567000;0
16867;179478;432;73;19;1;18;.947;3600000;0
16867;179657;441;0;0;0;0;.00nan;0;0
16867;182093;432;0;0;0;0;.00nan;0;0
16868;179143;423;0;0;0;0;.00nan;0;0
16868;179215;418;61;48;5;43;.896;3600000;0
16868;180781;423;71;28;2;26;.929;3600000;0
16868;180965;418;0;0;0;0;.00nan;0;0
16869;184183;410;22;14;4;10;.714;1175000;0
16869;178890;417;0;0;0;0;.00nan;0;0
16869;175989;410;42;16;3;13;.813;2425000;0
16869;-1;417;62;21;2;19;.905;3600000;0
16870;177155;411;68;29;2;27;.931;3600000;0
16870;184033;411;0;0;0;0;.00nan;0;0
16870;-1;413;0;0;0;0;.00nan;0;0
16870;-1;413;61;29;3;26;.897;3600000;0
16871;184336;429;0;0;0;0;.00nan;0;0
16871;-1;429;30;29;6;23;.793;3600000;0
16871;187263;434;0;0;0;0;.00nan;0;0
16871;152650;434;42;24;4;20;.833;3600000;0
16872;163177;425;21;23;6;17;.739;3207000;0
16872;170499;427;0;0;0;0;.00nan;0;0
16872;-1;425;50;1;0;1;1.000;393000;0
16872;149863;427;63;34;3;31;.912;3600000;0
16873;170878;430;0;0;0;0;.00nan;0;0
16873;181135;430;33;26;5;21;.808;3600000;0
16873;-1;433;0;0;0;0;.00nan;0;0
16873;-1;433;69;22;2;20;.909;3600000;0
16874;179143;423;86;43;2;41;.953;3526000;0
16874;179215;418;0;0;0;0;.00nan;0;0
16874;180781;423;0;0;0;0;.00nan;0;0
16874;180965;418;100;26;0;26;1.000;3600000;0
16875;184183;410;0;0;0;0;.00nan;0;0
16875;175989;410;75;22;1;21;.955;3600000;0
16875;-1;412;55;29;4;25;.862;3600000;0
16875;-1;412;0;0;0;0;.00nan;0;0
16876;163177;425;0;0;0;0;.00nan;0;0
16876;173575;437;0;0;0;0;.00nan;0;0
16876;-1;425;66;23;2;21;.913;4200000;0
16876;139865;437;98;54;2;52;.963;4200000;0
16877;163177;425;0;0;0;0;.00nan;0;0
16877;-1;425;71;25;2;23;.920;3600000;0
16877;-1;433;64;32;3;29;.906;3600000;0
16877;-1;433;0;0;0;0;.00nan;0;0
16878;170499;427;82;29;2;27;.931;3600000;0
16878;170878;430;53;3;0;3;1.000;624000;0
16878;181135;430;29;28;6;22;.786;2976000;0
16878;149863;427;0;0;0;0;.00nan;0;0
16879;-1;413;98;33;2;31;.939;3600000;0
16879;179689;415;66;47;5;42;.894;3600000;0
16879;-1;413;0;0;0;0;.00nan;0;0
16879;94557;415;0;0;0;0;.00nan;0;0
16880;183885;449;70;36;4;32;.889;4107000;0
16880;179071;420;0;0;0;0;.00nan;0;0
16880;186076;420;29;18;5;13;.722;4107000;0
16880;141530;449;0;0;0;0;.00nan;0;0
16881;177155;411;0;0;0;0;.00nan;0;0
16881;184033;411;44;16;3;13;.813;3571000;0
16881;184183;410;100;35;1;34;.971;3600000;0
16881;175989;410;0;0;0;0;.00nan;0;0
16882;189318;431;0;0;0;0;.00nan;0;0
16882;184336;429;39;23;4;19;.826;3557000;0
16882;182225;431;81;34;2;32;.941;3600000;0
16882;-1;429;0;0;0;0;.00nan;0;0
16883;183832;436;75;29;2;27;.931;3600000;0
16883;181100;442;73;50;5;45;.900;3600000;0
16883;-1;442;0;0;0;0;.00nan;0;0
16883;191861;436;0;0;0;0;.00nan;0;0
16884;168360;444;55;38;5;33;.868;3600000;0
16884;168855;444;0;0;0;0;.00nan;0;0
16884;178841;419;47;27;4;23;.852;3600000;0
16884;-1;419;0;0;0;0;.00nan;0;0
16885;168206;414;84;38;2;36;.947;3600000;0
16885;178890;417;84;30;1;29;.967;3600000;0
16885;-1;417;0;0;0;0;.00nan;0;0
16885;181346;414;0;0;0;0;.00nan;0;0
16886;165023;438;0;0;0;0;.00nan;0;0
16886;173519;441;0;0;0;0;.00nan;0;0
16886;173954;438;78;21;1;20;.952;3600000;0
16886;179657;441;53;39;5;34;.872;3600000;0
16887;171930;422;71;22;1;21;.955;3600000;0
16887;179127;422;0;0;0;0;.00nan;0;0
16887;179143;423;67;48;4;44;.917;3600000;0
16887;180781;423;0;0;0;0;.00nan;0;0
16888;171787;4849;0;0;0;0;.00nan;0;0
16888;174241;421;76;21;1;20;.952;3600000;0
16888;179259;4849;72;41;4;37;.902;3600000;0
16888;74680;421;0;0;0;0;.00nan;0;0
16889;179478;432;71;32;2;30;.938;3555000;0
16889;182093;432;0;0;0;0;.00nan;0;0
16889;187263;434;72;19;1;18;.947;3600000;0
16889;152650;434;0;0;0;0;.00nan;0;0
16890;174386;428;97;50;2;48;.960;3578000;0
16890;174420;439;0;0;0;0;.00nan;0;0
16890;182210;439;63;17;1;16;.941;3600000;0
16890;86531;428;0;0;0;0;.00nan;0;0
16891;178890;417;0;0;0;0;.00nan;0;0
16891;-1;413;0;0;0;0;.00nan;0;0
16891;-1;417;73;33;3;30;.909;3923000;0
16891;-1;413;75;32;2;30;.938;3923000;0
16892;183885;449;100;35;0;35;1.000;3600000;0
16892;179071;420;37;15;3;12;.800;3600000;0
16892;186076;420;0;0;0;0;.00nan;0;0
16892;141530;449;0;0;0;0;.00nan;0;0
16893;173575;437;0;0;0;0;.00nan;0;0
16893;184336;429;0;0;0;0;.00nan;0;0
16893;-1;429;76;16;0;16;1.000;3600000;0
16893;139865;437;98;51;3;48;.941;3600000;0
16894;170499;427;60;29;3;26;.897;4200000;0
16894;85987;426;0;0;0;0;.00nan;0;0
16894;86226;426;92;39;3;36;.923;4200000;0
16894;149863;427;0;0;0;0;.00nan;0;0
16895;189318;431;97;43;2;41;.953;3640000;0
16895;170886;440;54;23;3;20;.870;3640000;0
16895;175723;440;0;0;0;0;.00nan;0;0
16895;182225;431;0;0;0;0;.00nan;0;0
16896;183832;436;0;0;0;0;.00nan;0;0
16896;181100;442;0;0;0;0;.00nan;0;0
16896;-1;442;89;39;2;37;.949;3562000;0
16896;191861;436;59;14;1;13;.929;3600000;0
16897;168360;444;0;0;0;0;.00nan;0;0
16897;168855;444;57;29;3;26;.897;3600000;0
16897;178841;419;0;0;0;0;.00nan;0;0
16897;-1;419;51;27;4;23;.852;3558000;0
16898;170878;430;85;32;2;30;.938;3600000;0
16898;181135;430;0;0;0;0;.00nan;0;0
16898;-1;433;68;32;3;29;.906;3569000;0
16898;-1;433;0;0;0;0;.00nan;0;0
16899;178679;435;0;0;0;0;.00nan;0;0
16899;170928;443;0;0;0;0;.00nan;0;0
16899;182180;443;47;23;4;19;.826;3600000;0
16899;91448;435;84;40;3;37;.925;3600000;0
16900;168206;414;0;0;0;0;.00nan;0;0
16900;179689;415;0;0;0;0;.00nan;0;0
16900;181346;414;99;37;1;36;.973;3600000;0
16900;94557;415;97;52;3;49;.942;3537000;0
16901;177155;411;90;38;3;35;.921;3600000;0
16901;184033;411;0;0;0;0;.00nan;0;0
16901;-1;412;0;0;0;0;.00nan;0;0
16901;-1;412;49;29;4;25;.862;3543000;0
16902;165023;438;86;16;0;16;1.000;3600000;0
16902;173954;438;0;0;0;0;.00nan;0;0
16902;174386;428;0;0;0;0;.00nan;0;0
16902;86531;428;61;29;3;26;.897;3600000;0
16903;171930;422;0;0;0;0;.00nan;0;0
16903;179127;422;63;22;2;20;.909;3600000;0
16903;179143;423;0;0;0;0;.00nan;0;0
16903;180781;423;72;45;6;39;.867;3600000;0
16904;171787;4849;78;39;2;37;.949;3512000;0
16904;174241;421;0;0;0;0;.00nan;0;0
16904;179259;4849;0;0;0;0;.00nan;0;0
16904;74680;421;86;19;0;19;1.000;3600000;0
16905;179478;432;60;12;1;11;.917;1439000;0
16905;182093;432;39;22;4;18;.818;2161000;0
16905;187263;434;0;0;0;0;.00nan;0;0
16905;152650;434;87;15;0;15;1.000;3600000;0
16906;173519;441;0;0;0;0;.00nan;0;0
16906;174420;439;63;15;1;14;.933;3600000;0
16906;179657;441;85;43;4;39;.907;3600000;0
16906;182210;439;0;0;0;0;.00nan;0;0
16907;177155;411;0;0;0;0;.00nan;0;0
16907;184033;411;51;26;4;22;.846;3600000;0
16907;179689;415;94;38;1;37;.974;3600000;0
16907;94557;415;0;0;0;0;.00nan;0;0
16908;173575;437;69;45;5;40;.889;3600000;0
16908;187263;434;0;0;0;0;.00nan;0;0
16908;139865;437;0;0;0;0;.00nan;0;0
16908;152650;434;68;16;1;15;.938;3600000;0
16909;178679;435;0;0;0;0;.00nan;0;0
16909;170499;427;78;28;2;26;.929;3600000;0
16909;91448;435;60;44;5;39;.886;3600000;0
16909;149863;427;0;0;0;0;.00nan;0;0
16910;189318;431;0;0;0;0;.00nan;0;0
16910;181100;442;0;0;0;0;.00nan;0;0
16910;182225;431;74;20;1;19;.950;3600000;0
16910;-1;442;60;40;5;35;.875;3600000;0
16911;183832;436;38;14;3;11;.786;3570000;0
16911;174386;428;88;38;2;36;.947;3600000;0
16911;191861;436;0;0;0;0;.00nan;0;0
16911;86531;428;0;0;0;0;.00nan;0;0
16912;171787;4849;0;0;0;0;.00nan;0;0
16912;171930;422;51;21;3;18;.857;3809000;0
16912;179127;422;0;0;0;0;.00nan;0;0
16912;179259;4849;81;31;2;29;.935;3809000;0
16913;163177;425;0;0;0;0;.00nan;0;0
16913;-1;425;27;19;5;14;.737;3546000;0
16913;85987;426;0;0;0;0;.00nan;0;0
16913;86226;426;65;40;4;36;.900;3600000;0
16914;184183;410;0;0;0;0;.00nan;0;0
16914;-1;413;0;0;0;0;.00nan;0;0
16914;175989;410;91;31;1;30;.968;3600000;0
16914;-1;413;55;38;6;32;.842;3600000;0
16915;189318;431;37;31;6;25;.806;3556000;0
16915;181100;442;61;37;4;33;.892;3600000;0
16915;182225;431;0;0;0;0;.00nan;0;0
16915;-1;442;0;0;0;0;.00nan;0;0
16916;179143;423;0;0;0;0;.00nan;0;0
16916;174241;421;58;18;2;16;.889;3600000;0
16916;180781;423;61;39;5;34;.872;3600000;0
16916;74680;421;0;0;0;0;.00nan;0;0
16917;183885;449;62;48;5;43;.896;3518000;0
16917;178841;419;64;23;3;20;.870;3600000;0
16917;-1;419;0;0;0;0;.00nan;0;0
16917;141530;449;0;0;0;0;.00nan;0;0
16918;165023;438;93;28;1;27;.964;3600000;0
16918;173954;438;0;0;0;0;.00nan;0;0
16918;170878;430;0;0;0;0;.00nan;0;0
16918;181135;430;38;26;5;21;.808;3600000;0
16919;173519;441;0;0;0;0;.00nan;0;0
16919;170928;443;0;0;0;0;.00nan;0;0
16919;179657;441;53;30;4;26;.867;3578000;0
16919;182180;443;61;24;3;21;.875;3600000;0
16920;168360;444;47;12;2;10;.833;3600000;0
16920;168855;444;0;0;0;0;.00nan;0;0
16920;179215;418;0;0;0;0;.00nan;0;0
16920;180965;418;58;34;4;30;.882;3600000;0
16921;168206;414;44;33;5;28;.848;3573000;0
16921;181346;414;0;0;0;0;.00nan;0;0
16921;-1;412;40;22;4;18;.818;3600000;0
16921;-1;412;0;0;0;0;.00nan;0;0
16922;171787;4849;52;26;3;23;.885;3569000;0
16922;171930;422;0;0;0;0;.00nan;0;0
16922;179127;422;80;26;1;25;.962;3600000;0
16922;179259;4849;0;0;0;0;.00nan;0;0
16923;178890;417;45;27;4;23;.852;3562000;0
16923;179689;415;84;41;2;39;.951;3600000;0
16923;-1;417;0;0;0;0;.00nan;0;0
16923;94557;415;0;0;0;0;.00nan;0;0
16924;184336;429;0;0;0;0;.00nan;0;0
16924;179478;432;75;29;2;27;.931;3600000;0
16924;182093;432;0;0;0;0;.00nan;0;0
16924;-1;429;81;34;3;31;.912;3545000;0
16925;170886;440;0;0;0;0;.00nan;0;0
16925;174420;439;0;0;0;0;.00nan;0;0
16925;175723;440;70;48;4;44;.917;3600000;0
16925;182210;439;77;25;1;24;.960;3600000;0
16926;-1;413;77;24;1;23;.958;3553000;0
16926;-1;412;100;37;0;37;1.000;3600000;0
16926;-1;413;0;0;0;0;.00nan;0;0
16926;-1;412;0;0;0;0;.00nan;0;0
16927;173575;437;0;0;0;0;.00nan;0;0
16927;170886;440;100;23;0;23;1.000;3600000;0
16927;175723;440;0;0;0;0;.00nan;0;0
16927;139865;437;74;42;4;38;.905;3600000;0
16928;170499;427;55;26;3;23;.885;3546000;0
16928;170928;443;84;24;1;23;.958;3600000;0
16928;182180;443;0;0;0;0;.00nan;0;0
16928;149863;427;0;0;0;0;.00nan;0;0
16929;183832;436;69;31;3;28;.903;3589000;0
16929;174420;439;0;0;0;0;.00nan;0;0
16929;182210;439;59;16;2;14;.875;3600000;0
16929;191861;436;0;0;0;0;.00nan;0;0
16930;179143;423;61;41;5;36;.878;3600000;0
16930;174241;421;0;0;0;0;.00nan;0;0
16930;180781;423;0;0;0;0;.00nan;0;0
16930;74680;421;74;17;1;16;.941;3600000;0
16931;183885;449;72;40;4;36;.900;3600000;0
16931;178841;419;0;0;0;0;.00nan;0;0
16931;-1;419;59;16;1;15;.938;3600000;0
16931;141530;449;0;0;0;0;.00nan;0;0
16932;165023;438;0;0;0;0;.00nan;0;0
16932;173954;438;61;31;4;27;.871;3841000;0
16932;179478;432;0;0;0;0;.00nan;0;0
16932;182093;432;58;22;3;19;.864;3841000;0
16933;174386;428;74;33;2;31;.939;3600000;0
16933;-1;433;58;32;3;29;.906;3548000;0
16933;-1;433;0;0;0;0;.00nan;0;0
16933;86531;428;0;0;0;0;.00nan;0;0
16934;163177;425;57;25;3;22;.880;3600000;0
16934;170878;430;36;26;5;21;.808;3529000;0
16934;-1;425;0;0;0;0;.00nan;0;0
16934;181135;430;0;0;0;0;.00nan;0;0
16935;168360;444;0;0;0;0;.00nan;0;0
16935;168855;444;35;24;4;20;.833;3598000;0
16935;179215;418;74;36;3;33;.917;3600000;0
16935;180965;418;0;0;0;0;.00nan;0;0
16936;173519;441;46;30;5;25;.833;3600000;0
16936;178679;435;0;0;0;0;.00nan;0;0
16936;179657;441;0;0;0;0;.00nan;0;0
16936;91448;435;99;37;2;35;.946;3600000;0
16937;168206;414;0;0;0;0;.00nan;0;0
16937;184183;410;81;38;2;36;.947;4200000;0
16937;175989;410;0;0;0;0;.00nan;0;0
16937;181346;414;64;24;2;22;.917;4200000;0
16938;177155;411;83;42;3;39;.929;3600000;0
16938;184033;411;0;0;0;0;.00nan;0;0
16938;178890;417;0;0;0;0;.00nan;0;0
16938;-1;417;51;26;4;22;.846;3557000;0
16939;183832;436;70;27;2;25;.926;3600000;0
16939;170886;440;62;35;4;31;.886;3518000;0
16939;175723;440;0;0;0;0;.00nan;0;0
16939;191861;436;0;0;0;0;.00nan;0;0
16940;184183;410;0;0;0;0;.00nan;0;0
16940;175989;410;43;27;5;22;.815;3600000;0
16940;-1;412;95;39;1;38;.974;3600000;0
16940;-1;412;0;0;0;0;.00nan;0;0
16941;173519;441;0;0;0;0;.00nan;0;0
16941;179657;441;72;41;4;37;.902;3600000;0
16941;85987;426;0;0;0;0;.00nan;0;0
16941;86226;426;75;26;1;25;.962;3600000;0
16942;178679;435;0;0;0;0;.00nan;0;0
16942;170499;427;83;31;1;30;.968;4200000;0
16942;91448;435;91;39;1;38;.974;4200000;0
16942;149863;427;0;0;0;0;.00nan;0;0
16943;174241;421;55;19;3;16;.842;3600000;0
16943;179215;418;73;43;4;39;.907;3600000;0
16943;180965;418;0;0;0;0;.00nan;0;0
16943;74680;421;0;0;0;0;.00nan;0;0
16944;-1;413;0;0;0;0;.00nan;0;0
16944;179689;415;75;31;2;29;.935;3600000;0
16944;-1;413;69;30;3;27;.900;3551000;0
16944;94557;415;0;0;0;0;.00nan;0;0
16945;168360;444;82;15;0;15;1.000;3600000;0
16945;183885;449;87;35;2;33;.943;3600000;0
16945;168855;444;0;0;0;0;.00nan;0;0
16945;141530;449;0;0;0;0;.00nan;0;0
16946;174386;428;100;37;1;36;.973;3600000;0
16946;179478;432;60;28;3;25;.893;3567000;0
16946;182093;432;0;0;0;0;.00nan;0;0
16946;86531;428;0;0;0;0;.00nan;0;0
16947;184336;429;51;28;3;25;.893;3551000;0
16947;-1;429;0;0;0;0;.00nan;0;0
16947;-1;433;0;0;0;0;.00nan;0;0
16947;-1;433;93;38;1;37;.974;3600000;0
16948;170878;430;0;0;0;0;.00nan;0;0
16948;181100;442;31;43;8;35;.814;3600000;0
16948;181135;430;59;21;3;18;.857;3600000;0
16948;-1;442;0;0;0;0;.00nan;0;0
16949;170499;427;0;0;0;0;.00nan;0;0
16949;170928;443;0;0;0;0;.00nan;0;0
16949;182180;443;77;33;2;31;.939;3554000;0
16949;149863;427;89;29;1;28;.966;3600000;0
16950;179071;420;0;0;0;0;.00nan;0;0
16950;179143;423;0;0;0;0;.00nan;0;0
16950;180781;423;59;17;3;14;.824;3592000;0
16950;186076;420;89;39;2;37;.949;3600000;0
16951;171930;422;91;51;3;48;.941;3813000;0
16951;178841;419;52;26;4;22;.846;3813000;0
16951;179127;422;0;0;0;0;.00nan;0;0
16951;-1;419;0;0;0;0;.00nan;0;0
16952;168206;414;76;33;2;31;.939;4200000;0
16952;178890;417;89;42;2;40;.952;4200000;0
16952;-1;417;0;0;0;0;.00nan;0;0
16952;181346;414;0;0;0;0;.00nan;0;0
16953;177155;411;0;0;0;0;.00nan;0;0
16953;184033;411;68;33;3;30;.909;3549000;0
16953;-1;412;59;22;2;20;.909;3600000;0
16953;-1;412;0;0;0;0;.00nan;0;0
16954;183832;436;52;17;2;15;.882;3600000;0
16954;187263;434;74;20;1;19;.950;3600000;0
16954;191861;436;0;0;0;0;.00nan;0;0
16954;152650;434;0;0;0;0;.00nan;0;0
16955;189318;431;0;0;0;0;.00nan;0;0
16955;174420;439;0;0;0;0;.00nan;0;0
16955;182210;439;86;24;1;23;.958;3600000;0
16955;182225;431;88;53;4;49;.925;3600000;0
16956;163177;425;0;0;0;0;.00nan;0;0
16956;165023;438;36;26;4;22;.846;3600000;0
16956;173954;438;0;0;0;0;.00nan;0;0
16956;-1;425;75;20;1;19;.950;3600000;0
16957;168360;444;87;12;0;12;1.000;3600000;0
16957;183885;449;98;60;1;59;.983;3548000;0
16957;168855;444;0;0;0;0;.00nan;0;0
16957;141530;449;0;0;0;0;.00nan;0;0
16958;181100;442;0;0;0;0;.00nan;0;0
16958;-1;442;56;41;5;36;.878;3600000;0
16958;85987;426;87;28;1;27;.964;3600000;0
16958;86226;426;0;0;0;0;.00nan;0;0
16959;174241;421;0;0;0;0;.00nan;0;0
16959;179215;418;61;8;0;8;1.000;632000;0
16959;180965;418;35;37;6;31;.838;2949000;0
16959;74680;421;44;22;4;18;.818;3600000;0
16960;168206;414;0;0;0;0;.00nan;0;0
16960;179689;415;0;0;0;0;.00nan;0;0
16960;181346;414;74;20;1;19;.950;3600000;0
16960;94557;415;91;44;3;41;.932;3541000;0
16961;174386;428;88;39;2;37;.949;3600000;0
16961;179478;432;0;0;0;0;.00nan;0;0
16961;182093;432;77;20;1;19;.950;3600000;0
16961;86531;428;0;0;0;0;.00nan;0;0
16962;165023;438;0;0;0;0;.00nan;0;0
16962;173954;438;61;23;3;20;.870;3780000;0
16962;-1;433;67;22;2;20;.909;3780000;0
16962;-1;433;0;0;0;0;.00nan;0;0
16963;179071;420;87;32;1;31;.969;3662000;0
16963;179143;423;76;27;2;25;.926;3662000;0
16963;180781;423;0;0;0;0;.00nan;0;0
16963;186076;420;0;0;0;0;.00nan;0;0
16964;173519;441;0;0;0;0;.00nan;0;0
16964;170878;430;72;21;1;20;.952;3544000;0
16964;179657;441;100;25;0;25;1.000;3600000;0
16964;181135;430;0;0;0;0;.00nan;0;0
16965;171930;422;0;0;0;0;.00nan;0;0
16965;178841;419;0;0;0;0;.00nan;0;0
16965;179127;422;74;44;4;40;.909;3543000;0
16965;-1;419;65;23;2;21;.913;3600000;0
16966;178890;417;0;0;0;0;.00nan;0;0
16966;-1;413;84;37;2;35;.946;3600000;0
16966;-1;417;55;28;4;24;.857;3520000;0
16966;-1;413;0;0;0;0;.00nan;0;0
16967;177155;411;40;34;5;29;.853;4200000;0
16967;184033;411;0;0;0;0;.00nan;0;0
16967;184183;410;57;44;5;39;.886;4200000;0
16967;175989;410;0;0;0;0;.00nan;0;0
16968;170886;440;0;0;0;0;.00nan;0;0
16968;175723;440;100;42;1;41;.976;4200000;0
16968;187263;434;0;0;0;0;.00nan;0;0
16968;152650;434;75;31;1;30;.968;4200000;0
16969;173575;437;52;11;1;10;.909;611000;0
16969;174420;439;0;0;0;0;.00nan;0;0
16969;182210;439;74;9;0;9;1.000;3600000;0
16969;139865;437;71;60;6;54;.900;2989000;0
16970;163177;425;84;32;1;31;.969;3582000;0
16970;184336;429;0;0;0;0;.00nan;0;0
16970;-1;425;0;0;0;0;.00nan;0;0
16970;-1;429;95;23;0;23;1.000;3600000;0
16971;168206;414;29;5;3;2;.400;532000;0
16971;-1;413;67;30;3;27;.900;3600000;0
16971;181346;414;62;34;4;30;.882;3068000;0
16971;-1;413;0;0;0;0;.00nan;0;0
16972;165023;438;97;35;2;33;.943;3719000;0
16972;170499;427;83;35;3;32;.914;3719000;0
16972;173954;438;0;0;0;0;.00nan;0;0
16972;149863;427;0;0;0;0;.00nan;0;0
16973;163177;425;51;6;1;5;.833;790000;0
16973;170928;443;74;35;3;32;.914;3600000;0
16973;-1;425;17;22;6;16;.727;2810000;0
16973;182180;443;0;0;0;0;.00nan;0;0
16974;174386;428;93;48;3;45;.938;3600000;0
16974;187263;434;20;8;4;4;.500;3598000;0
16974;86531;428;0;0;0;0;.00nan;0;0
16974;152650;434;0;0;0;0;.00nan;0;0
16975;173519;441;0;0;0;0;.00nan;0;0
16975;179657;441;55;39;6;33;.846;3600000;0
16975;-1;433;92;27;1;26;.963;3600000;0
16975;-1;433;0;0;0;0;.00nan;0;0
16976;171787;4849;0;0;0;0;.00nan;0;0
16976;179071;420;81;22;1;21;.955;3600000;0
16976;179259;4849;70;35;4;31;.886;3600000;0
16976;186076;420;0;0;0;0;.00nan;0;0
16977;184183;410;66;30;3;27;.900;3778000;0
16977;175989;410;0;0;0;0;.00nan;0;0
16977;179689;415;67;36;4;32;.889;3778000;0
16977;94557;415;0;0;0;0;.00nan;0;0
16978;174420;439;0;0;0;0;.00nan;0;0
16978;181100;442;88;56;5;51;.911;3600000;0
16978;182210;439;54;9;1;8;.889;3600000;0
16978;-1;442;0;0;0;0;.00nan;0;0
16979;183832;436;69;18;1;17;.944;3645000;0
16979;178679;435;0;0;0;0;.00nan;0;0
16979;191861;436;0;0;0;0;.00nan;0;0
16979;91448;435;94;55;2;53;.964;3645000;0
16980;178841;419;63;17;2;15;.882;3600000;0
16980;174241;421;29;28;6;22;.786;2081000;0
16980;-1;419;0;0;0;0;.00nan;0;0
16980;74680;421;46;12;2;10;.833;1519000;0
16981;168360;444;61;30;3;27;.900;3600000;0
16981;168855;444;0;0;0;0;.00nan;0;0
16981;179143;423;0;0;0;0;.00nan;0;0
16981;180781;423;99;39;2;37;.949;3600000;0
16982;173575;437;0;0;0;0;.00nan;0;0
16982;179478;432;69;25;2;23;.920;3600000;0
16982;182093;432;0;0;0;0;.00nan;0;0
16982;139865;437;38;34;6;28;.824;3600000;0
16983;171930;422;79;34;2;32;.941;3600000;0
16983;179127;422;0;0;0;0;.00nan;0;0
16983;179215;418;54;37;5;32;.865;3600000;0
16983;180965;418;0;0;0;0;.00nan;0;0
16984;177155;411;0;0;0;0;.00nan;0;0
16984;168206;414;0;0;0;0;.00nan;0;0
16984;184033;411;82;37;2;35;.946;3600000;0
16984;181346;414;6;33;9;24;.727;3600000;0
16985;178890;417;83;32;2;30;.938;4200000;0
16985;-1;417;0;0;0;0;.00nan;0;0
16985;-1;412;96;55;2;53;.964;4200000;0
16985;-1;412;0;0;0;0;.00nan;0;0
16986;173519;441;69;32;4;28;.875;3584000;0
16986;174386;428;56;23;3;20;.870;3600000;0
16986;179657;441;0;0;0;0;.00nan;0;0
16986;86531;428;0;0;0;0;.00nan;0;0
16987;184336;429;65;37;4;33;.892;4072000;0
16987;-1;429;0;0;0;0;.00nan;0;0
16987;85987;426;0;0;0;0;.00nan;0;0
16987;86226;426;88;54;3;51;.944;4072000;0
16988;170886;440;61;31;3;28;.903;3600000;0
16988;170928;443;0;0;0;0;.00nan;0;0
16988;175723;440;0;0;0;0;.00nan;0;0
16988;182180;443;43;28;4;24;.857;3600000;0
16989;189318;431;37;6;2;4;.667;559000;0
16989;182225;431;29;28;6;22;.786;3041000;0
16989;187263;434;50;23;3;20;.870;3600000;0
16989;152650;434;0;0;0;0;.00nan;0;0
16990;177155;411;10;22;7;15;.682;2854000;0
16990;184033;411;53;3;0;3;1.000;746000;0
16990;-1;413;71;37;3;34;.919;3600000;0
16990;-1;413;0;0;0;0;.00nan;0;0
16991;171787;4849;65;45;4;41;.911;4080000;0
16991;179071;420;55;32;5;27;.844;4080000;0
16991;179259;4849;0;0;0;0;.00nan;0;0
16991;186076;420;0;0;0;0;.00nan;0;0
16992;170499;427;88;25;1;24;.960;3600000;0
16992;170878;430;50;1;0;1;1.000;312000;0
16992;181135;430;19;20;6;14;.700;3288000;0
16992;149863;427;0;0;0;0;.00nan;0;0
16993;184183;410;0;0;0;0;.00nan;0;0
16993;178890;417;0;0;0;0;.00nan;0;0
16993;175989;410;72;26;2;24;.923;3600000;0
16993;-1;417;59;29;3;26;.897;3600000;0
16994;174420;439;68;15;1;14;.933;3600000;0
16994;181100;442;0;0;0;0;.00nan;0;0
16994;182210;439;0;0;0;0;.00nan;0;0
16994;-1;442;84;50;4;46;.920;3600000;0
16995;183832;436;0;0;0;0;.00nan;0;0
16995;170928;443;95;35;1;34;.971;3600000;0
16995;182180;443;0;0;0;0;.00nan;0;0
16995;191861;436;51;29;4;25;.862;3600000;0
16996;178841;419;0;0;0;0;.00nan;0;0
16996;174241;421;100;30;0;30;1.000;3600000;0
16996;-1;419;43;32;5;27;.844;3600000;0
16996;74680;421;0;0;0;0;.00nan;0;0
16997;165023;438;0;0;0;0;.00nan;0;0
16997;173954;438;86;39;2;37;.949;3600000;0
16997;85987;426;75;33;3;30;.909;3600000;0
16997;86226;426;0;0;0;0;.00nan;0;0
16998;168360;444;0;0;0;0;.00nan;0;0
16998;168855;444;67;20;2;18;.900;4200000;0
16998;179143;423;97;51;2;49;.961;4200000;0
16998;180781;423;0;0;0;0;.00nan;0;0
16999;173575;437;0;0;0;0;.00nan;0;0
16999;179478;432;66;15;1;14;.933;3904000;0
16999;182093;432;0;0;0;0;.00nan;0;0
16999;139865;437;90;46;2;44;.957;3904000;0
17000;171930;422;0;0;0;0;.00nan;0;0
17000;179127;422;79;34;3;31;.912;3544000;0
17000;179215;418;0;0;0;0;.00nan;0;0
17000;180965;418;61;23;2;21;.913;3600000;0
17001;179689;415;0;0;0;0;.00nan;0;0
17001;-1;412;0;0;0;0;.00nan;0;0
17001;-1;412;50;29;4;25;.862;3548000;0
17001;94557;415;82;35;2;33;.943;3600000;0
17002;189318;431;0;0;0;0;.00nan;0;0
17002;174386;428;0;0;0;0;.00nan;0;0
17002;182225;431;46;20;3;17;.850;3600000;0
17002;86531;428;61;23;2;21;.913;3600000;0
17003;178679;435;72;34;3;31;.912;3600000;0
17003;170886;440;0;0;0;0;.00nan;0;0
17003;175723;440;88;17;0;17;1.000;3600000;0
17003;91448;435;0;0;0;0;.00nan;0;0
17004;163177;425;0;0;0;0;.00nan;0;0
17004;-1;425;61;17;1;16;.941;3600000;0
17004;-1;433;71;38;4;34;.895;3600000;0
17004;-1;433;0;0;0;0;.00nan;0;0
17005;184336;429;0;0;0;0;.00nan;0;0
17005;170878;430;78;37;3;34;.919;4002000;0
17005;181135;430;0;0;0;0;.00nan;0;0
17005;-1;429;69;21;2;19;.905;4002000;0
17006;178890;417;64;35;4;31;.886;3543000;0
17006;179689;415;76;33;3;30;.909;3600000;0
17006;-1;417;0;0;0;0;.00nan;0;0
17006;94557;415;0;0;0;0;.00nan;0;0
17007;170499;427;72;25;1;24;.960;3600000;0
17007;184336;429;67;27;2;25;.926;3577000;0
17007;-1;429;0;0;0;0;.00nan;0;0
17007;149863;427;0;0;0;0;.00nan;0;0
17008;189318;431;0;0;0;0;.00nan;0;0
17008;182225;431;88;41;3;38;.927;3600000;0
17008;187263;434;85;16;0;16;1.000;3600000;0
17008;152650;434;0;0;0;0;.00nan;0;0
17009;170878;430;0;0;0;0;.00nan;0;0
17009;181135;430;52;35;4;31;.886;3564000;0
17009;85987;426;0;0;0;0;.00nan;0;0
17009;86226;426;70;31;3;28;.903;3600000;0
17010;178679;435;0;0;0;0;.00nan;0;0
17010;170928;443;0;0;0;0;.00nan;0;0
17010;182180;443;60;23;2;21;.913;3600000;0
17010;91448;435;83;40;3;37;.925;3600000;0
17011;184183;410;98;43;2;41;.953;3597000;0
17011;-1;413;0;0;0;0;.00nan;0;0
17011;175989;410;0;0;0;0;.00nan;0;0
17011;-1;413;100;28;0;28;1.000;3600000;0
17012;173519;441;0;0;0;0;.00nan;0;0
17012;173575;437;0;0;0;0;.00nan;0;0
17012;179657;441;36;22;4;18;.818;3597000;0
17012;139865;437;78;28;2;26;.929;3600000;0
17013;183885;449;0;0;0;0;.00nan;0;0
17013;179215;418;81;23;2;21;.913;3600000;0
17013;180965;418;0;0;0;0;.00nan;0;0
17013;141530;449;51;24;3;21;.875;3600000;0
17014;179478;432;0;0;0;0;.00nan;0;0
17014;181100;442;83;46;4;42;.913;3600000;0
17014;182093;432;61;27;3;24;.889;3600000;0
17014;-1;442;0;0;0;0;.00nan;0;0
17015;168206;414;77;31;2;29;.935;3600000;0
17015;181346;414;0;0;0;0;.00nan;0;0
17015;-1;412;49;33;5;28;.848;3600000;0
17015;-1;412;0;0;0;0;.00nan;0;0
17016;178841;419;51;11;2;9;.818;3600000;0
17016;179143;423;0;0;0;0;.00nan;0;0
17016;-1;419;0;0;0;0;.00nan;0;0
17016;180781;423;83;53;3;50;.943;3600000;0
17017;171930;422;90;20;0;20;1.000;3600000;0
17017;179071;420;65;37;4;33;.892;2352000;0
17017;179127;422;0;0;0;0;.00nan;0;0
17017;186076;420;63;18;1;17;.944;1248000;0
17018;171787;4849;0;0;0;0;.00nan;0;0
17018;168360;444;60;19;2;17;.895;3600000;0
17018;168855;444;0;0;0;0;.00nan;0;0
17018;179259;4849;66;28;3;25;.893;3544000;0
17019;177155;411;0;0;0;0;.00nan;0;0
17019;184033;411;53;25;3;22;.880;3600000;0
17019;179689;415;59;34;4;30;.882;3562000;0
17019;94557;415;0;0;0;0;.00nan;0;0
17020;184336;429;0;0;0;0;.00nan;0;0
17020;174386;428;49;38;5;33;.868;3600000;0
17020;-1;429;79;38;2;36;.947;3600000;0
17020;86531;428;0;0;0;0;.00nan;0;0
17021;170886;440;0;0;0;0;.00nan;0;0
17021;175723;440;58;41;5;36;.878;3600000;0
17021;187263;434;49;24;4;20;.833;3600000;0
17021;152650;434;0;0;0;0;.00nan;0;0
17022;183832;436;61;36;4;32;.889;3568000;0
17022;174420;439;0;0;0;0;.00nan;0;0
17022;182210;439;47;19;3;16;.842;3600000;0
17022;191861;436;0;0;0;0;.00nan;0;0
17023;183885;449;89;46;3;43;.935;3559000;0
17023;179215;418;0;0;0;0;.00nan;0;0
17023;180965;418;74;20;1;19;.950;3600000;0
17023;141530;449;0;0;0;0;.00nan;0;0
17024;165023;438;60;46;6;40;.870;3600000;0
17024;173954;438;0;0;0;0;.00nan;0;0
17024;85987;426;0;0;0;0;.00nan;0;0
17024;86226;426;63;24;3;21;.875;3600000;0
17025;168206;414;0;0;0;0;.00nan;0;0
17025;184183;410;0;0;0;0;.00nan;0;0
17025;175989;410;79;50;4;46;.920;4200000;0
17025;181346;414;57;32;4;28;.875;4200000;0
17026;170928;443;84;28;2;26;.929;3600000;0
17026;182180;443;0;0;0;0;.00nan;0;0
17026;-1;433;0;0;0;0;.00nan;0;0
17026;-1;433;57;27;3;24;.889;3575000;0
17027;163177;425;0;0;0;0;.00nan;0;0
17027;178679;435;0;0;0;0;.00nan;0;0
17027;-1;425;96;21;0;21;1.000;3600000;0
17027;91448;435;77;36;3;33;.917;3600000;0
17028;178841;419;0;0;0;0;.00nan;0;0
17028;179143;423;28;7;3;4;.571;110000;0
17028;-1;419;51;13;2;11;.846;3600000;0
17028;180781;423;70;43;4;39;.907;3490000;0
17029;-1;413;0;0;0;0;.00nan;0;0
17029;-1;412;0;0;0;0;.00nan;0;0
17029;-1;413;50;23;3;20;.870;3564000;0
17029;-1;412;69;31;2;29;.935;3600000;0
17030;171930;422;98;17;0;17;1.000;3600000;0
17030;179071;420;35;47;8;39;.830;3115000;0
17030;179127;422;0;0;0;0;.00nan;0;0
17030;186076;420;68;10;0;10;1.000;485000;0
17031;171787;4849;90;42;3;39;.929;3573000;0
17031;168360;444;0;0;0;0;.00nan;0;0
17031;168855;444;65;18;1;17;.944;3600000;0
17031;179259;4849;0;0;0;0;.00nan;0;0
17032;177155;411;82;29;2;27;.931;3600000;0
17032;184033;411;0;0;0;0;.00nan;0;0
17032;178890;417;65;41;5;36;.878;3600000;0
17032;-1;417;0;0;0;0;.00nan;0;0
17033;170886;440;59;43;6;37;.860;2601000;0
17033;174420;439;81;16;0;16;1.000;3600000;0
17033;175723;440;55;11;1;10;.909;999000;0
17033;182210;439;0;0;0;0;.00nan;0;0
17035;170886;440;0;0;0;0;.00nan;0;0
17035;-1;413;0;0;0;0;.00nan;0;0
17035;175723;440;68;34;4;30;.882;3600000;0
17035;-1;413;81;23;1;22;.957;3600000;0
17037;173575;437;0;0;0;0;.00nan;0;0
17037;-1;412;64;28;2;26;.929;4200000;0
17037;-1;412;0;0;0;0;.00nan;0;0
17037;139865;437;77;29;2;27;.931;4200000;0
17039;171787;4849;0;0;0;0;.00nan;0;0
17039;184183;410;62;18;2;16;.889;3806000;0
17039;179259;4849;83;45;3;42;.933;3806000;0
17039;175989;410;0;0;0;0;.00nan;0;0
17041;171930;422;93;31;1;30;.968;3600000;0
17041;168206;414;71;30;2;28;.933;3545000;0
17041;179127;422;0;0;0;0;.00nan;0;0
17041;181346;414;0;0;0;0;.00nan;0;0
17043;179143;423;0;0;0;0;.00nan;0;0
17043;179478;432;64;29;2;27;.931;3600000;0
17043;180781;423;66;35;3;32;.914;3600000;0
17043;182093;432;0;0;0;0;.00nan;0;0
17045;168360;444;50;23;4;19;.826;3736000;0
17045;168855;444;0;0;0;0;.00nan;0;0
17045;174386;428;82;43;3;40;.930;3736000;0
17045;86531;428;0;0;0;0;.00nan;0;0
17047;177155;411;0;0;0;0;.00nan;0;0
17047;184033;411;73;32;3;29;.906;3592000;0
17047;174241;421;65;21;2;19;.905;3600000;0
17047;74680;421;0;0;0;0;.00nan;0;0
17049;163177;425;0;0;0;0;.00nan;0;0
17049;-1;425;68;17;1;16;.941;3600000;0
17049;181100;442;49;32;4;28;.875;3600000;0
17049;-1;442;0;0;0;0;.00nan;0;0
17051;189318;431;0;0;0;0;.00nan;0;0
17051;178679;435;67;13;0;13;1.000;1103000;0
17051;182225;431;54;14;2;12;.857;3600000;0
17051;91448;435;48;39;6;33;.846;2497000;0
17053;183832;436;81;15;0;15;1.000;3600000;0
17053;183885;449;79;40;2;38;.950;3569000;0
17053;191861;436;0;0;0;0;.00nan;0;0
17053;141530;449;0;0;0;0;.00nan;0;0
17055;170878;430;37;32;6;26;.813;3600000;0
17055;179215;418;45;5;1;4;.800;1064000;0
17055;180965;418;38;35;6;29;.829;2481000;0
17055;181135;430;0;0;0;0;.00nan;0;0
17057;178890;417;48;20;3;17;.850;3600000;0
17057;-1;417;0;0;0;0;.00nan;0;0
17057;85987;426;65;24;2;22;.917;3600000;0
17057;86226;426;0;0;0;0;.00nan;0;0
17059;178841;419;96;40;1;39;.975;3600000;0
17059;184336;429;53;45;7;38;.844;3254000;0
17059;-1;419;0;0;0;0;.00nan;0;0
17059;-1;429;49;1;0;1;1.000;346000;0
17061;174420;439;0;0;0;0;.00nan;0;0
17061;179689;415;98;45;2;43;.956;3574000;0
17061;182210;439;63;15;1;14;.933;3600000;0
17061;94557;415;0;0;0;0;.00nan;0;0
17063;170499;427;71;23;2;21;.913;3600000;0
17063;170928;443;0;0;0;0;.00nan;0;0
17063;182180;443;64;32;3;29;.906;3552000;0
17063;149863;427;0;0;0;0;.00nan;0;0
17065;173519;441;0;0;0;0;.00nan;0;0
17065;179071;420;0;0;0;0;.00nan;0;0
17065;179657;441;58;36;4;32;.889;3774000;0
17065;186076;420;65;28;3;25;.893;3774000;0
17067;165023;438;0;0;0;0;.00nan;0;0
17067;173954;438;65;33;4;29;.879;4200000;0
17067;-1;433;0;0;0;0;.00nan;0;0
17067;-1;433;67;34;4;30;.882;4200000;0
17069;183885;449;83;42;2;40;.952;3564000;0
17069;-1;413;88;24;1;23;.958;3600000;0
17069;-1;413;0;0;0;0;.00nan;0;0
17069;141530;449;0;0;0;0;.00nan;0;0
17071;171930;422;34;19;4;15;.789;3573000;0
17071;183832;436;80;38;2;36;.947;3600000;0
17071;179127;422;0;0;0;0;.00nan;0;0
17071;191861;436;0;0;0;0;.00nan;0;0
17073;189318;431;0;0;0;0;.00nan;0;0
17073;182225;431;52;23;3;20;.870;3600000;0
17073;-1;412;67;41;4;37;.902;3596000;0
17073;-1;412;0;0;0;0;.00nan;0;0
17075;174386;428;62;41;5;36;.878;3600000;0
17075;85987;426;0;0;0;0;.00nan;0;0
17075;86226;426;79;25;1;24;.960;3600000;0
17075;86531;428;0;0;0;0;.00nan;0;0
17077;177155;411;74;19;1;18;.947;3600000;0
17077;165023;438;79;50;4;46;.920;3600000;0
17077;184033;411;0;0;0;0;.00nan;0;0
17077;173954;438;0;0;0;0;.00nan;0;0
17079;178679;435;73;39;3;36;.923;3553000;0
17079;170499;427;0;0;0;0;.00nan;0;0
17079;91448;435;0;0;0;0;.00nan;0;0
17079;149863;427;60;22;2;20;.909;3600000;0
17081;163177;425;0;0;0;0;.00nan;0;0
17081;184336;429;91;35;1;34;.971;3600000;0
17081;-1;425;68;25;2;23;.920;3600000;0
17081;-1;429;0;0;0;0;.00nan;0;0
17083;170878;430;59;22;2;20;.909;1418000;0
17083;174241;421;90;19;0;19;1.000;3600000;0
17083;181135;430;36;28;6;22;.786;2182000;0
17083;74680;421;0;0;0;0;.00nan;0;0
17085;179143;423;0;0;0;0;.00nan;0;0
17085;179478;432;84;38;2;36;.947;3600000;0
17085;180781;423;55;33;4;29;.879;3578000;0
17085;182093;432;0;0;0;0;.00nan;0;0
17087;168206;414;78;29;2;27;.931;3600000;0
17087;179071;420;64;40;5;35;.875;3600000;0
17087;181346;414;0;0;0;0;.00nan;0;0
17087;186076;420;0;0;0;0;.00nan;0;0
17089;179689;415;0;0;0;0;.00nan;0;0
17089;187263;434;70;21;1;20;.952;3600000;0
17089;94557;415;59;32;4;28;.875;3600000;0
17089;152650;434;0;0;0;0;.00nan;0;0
17091;181100;442;57;42;6;36;.857;3117000;0
17091;-1;442;40;10;2;8;.800;483000;0
17091;-1;433;72;9;0;9;1.000;3600000;0
17091;-1;433;0;0;0;0;.00nan;0;0
17093;184183;410;0;0;0;0;.00nan;0;0
17093;179215;418;0;0;0;0;.00nan;0;0
17093;175989;410;89;29;1;28;.966;3600000;0
17093;180965;418;69;35;3;32;.914;3537000;0
17095;173519;441;0;0;0;0;.00nan;0;0
17095;170886;440;38;29;5;24;.828;3718000;0
17095;175723;440;0;0;0;0;.00nan;0;0
17095;179657;441;52;44;6;38;.864;3718000;0
17097;168360;444;69;24;1;23;.958;3600000;0
17097;168855;444;0;0;0;0;.00nan;0;0
17097;170928;443;0;0;0;0;.00nan;0;0
17097;182180;443;50;29;4;25;.862;3600000;0
17099;171787;4849;0;0;0;0;.00nan;0;0
17099;178841;419;100;27;0;27;1.000;3600000;0
17099;179259;4849;86;47;3;44;.936;3600000;0
17099;-1;419;0;0;0;0;.00nan;0;0
17101;178890;417;98;47;3;44;.936;3600000;0
17101;174420;439;0;0;0;0;.00nan;0;0
17101;-1;417;0;0;0;0;.00nan;0;0
17101;182210;439;59;10;1;9;.900;3600000;0
17103;171787;4849;43;34;6;28;.824;4146000;0
17103;179259;4849;0;0;0;0;.00nan;0;0
17103;181100;442;0;0;0;0;.00nan;0;0
17103;-1;442;38;24;5;19;.792;4146000;0
17105;170886;440;0;0;0;0;.00nan;0;0
17105;175723;440;68;49;5;44;.898;3600000;0
17105;187263;434;0;0;0;0;.00nan;0;0
17105;152650;434;88;20;0;20;1.000;3600000;0
17107;177155;411;0;0;0;0;.00nan;0;0
17107;184033;411;50;23;3;20;.870;3600000;0
17107;-1;413;0;0;0;0;.00nan;0;0
17107;-1;413;45;44;7;37;.841;3600000;0
17109;179071;420;0;0;0;0;.00nan;0;0
17109;186076;420;76;42;3;39;.929;3600000;0
17109;85987;426;51;26;4;22;.846;3558000;0
17109;86226;426;0;0;0;0;.00nan;0;0
17111;183885;449;0;0;0;0;.00nan;0;0
17111;179143;423;58;41;5;36;.878;3576000;0
17111;180781;423;0;0;0;0;.00nan;0;0
17111;141530;449;33;18;4;14;.778;3600000;0
17113;184183;410;49;24;4;20;.833;3571000;0
17113;178890;417;0;0;0;0;.00nan;0;0
17113;175989;410;0;0;0;0;.00nan;0;0
17113;-1;417;60;30;3;27;.900;3600000;0
17115;168360;444;0;0;0;0;.00nan;0;0
17115;168855;444;76;25;1;24;.960;3600000;0
17115;170499;427;68;32;3;29;.906;3522000;0
17115;149863;427;0;0;0;0;.00nan;0;0
17117;178679;435;49;13;2;11;.846;1083000;0
17117;174241;421;67;25;2;23;.920;3600000;0
17117;74680;421;0;0;0;0;.00nan;0;0
17117;91448;435;29;33;7;26;.788;2517000;0
17119;163177;425;73;38;4;34;.895;3600000;0
17119;178841;419;88;31;1;30;.968;3600000;0
17119;-1;419;0;0;0;0;.00nan;0;0
17119;-1;425;0;0;0;0;.00nan;0;0
17121;165023;438;0;0;0;0;.00nan;0;0
17121;173954;438;46;20;3;17;.850;3600000;0
17121;170878;430;0;0;0;0;.00nan;0;0
17121;181135;430;66;25;2;23;.920;3600000;0
17123;171930;422;0;0;0;0;.00nan;0;0
17123;179127;422;96;25;0;25;1.000;3600000;0
17123;179478;432;0;0;0;0;.00nan;0;0
17123;182093;432;66;32;3;29;.906;3600000;0
17125;189318;431;76;27;2;25;.926;3966000;0
17125;184336;429;0;0;0;0;.00nan;0;0
17125;182225;431;0;0;0;0;.00nan;0;0
17125;-1;429;87;46;3;43;.935;3966000;0
17127;179689;415;62;35;4;31;.886;3821000;0
17127;-1;412;0;0;0;0;.00nan;0;0
17127;-1;412;60;26;3;23;.885;3821000;0
17127;94557;415;0;0;0;0;.00nan;0;0
17129;183832;436;0;0;0;0;.00nan;0;0
17129;173575;437;0;0;0;0;.00nan;0;0
17129;191861;436;62;30;3;27;.900;3600000;0
17129;139865;437;68;38;4;34;.895;3564000;0
17131;174420;439;39;24;4;20;.833;4016000;0
17131;182210;439;0;0;0;0;.00nan;0;0
17131;-1;433;78;49;5;44;.898;4036000;0
17131;-1;433;0;0;0;0;.00nan;0;0
17133;168206;414;0;0;0;0;.00nan;0;0
17133;179215;418;72;28;2;26;.929;3600000;0
17133;180965;418;0;0;0;0;.00nan;0;0
17133;181346;414;64;31;3;28;.903;3600000;0
17135;170928;443;60;32;3;29;.906;4200000;0
17135;174386;428;0;0;0;0;.00nan;0;0
17135;182180;443;0;0;0;0;.00nan;0;0
17135;86531;428;75;36;3;33;.917;4200000;0
17137;178890;417;62;31;3;28;.903;3543000;0
17137;179215;418;0;0;0;0;.00nan;0;0
17137;-1;417;0;0;0;0;.00nan;0;0
17137;180965;418;94;38;1;37;.974;3600000;0
17139;179143;423;56;38;5;33;.868;3600000;0
17139;180781;423;0;0;0;0;.00nan;0;0
17139;85987;426;0;0;0;0;.00nan;0;0
17139;86226;426;81;32;2;30;.938;3600000;0
17141;183885;449;80;31;3;28;.903;3600000;0
17141;179478;432;45;25;4;21;.840;3562000;0
17141;182093;432;0;0;0;0;.00nan;0;0
17141;141530;449;0;0;0;0;.00nan;0;0
17143;173519;441;59;17;2;15;.882;3600000;0
17143;179657;441;0;0;0;0;.00nan;0;0
17143;-1;412;62;27;3;24;.889;3570000;0
17143;-1;412;0;0;0;0;.00nan;0;0
17145;171787;4849;83;31;1;30;.968;3600000;0
17145;170878;430;37;26;5;21;.808;3600000;0
17145;179259;4849;0;0;0;0;.00nan;0;0
17145;181135;430;0;0;0;0;.00nan;0;0
17147;174420;439;0;0;0;0;.00nan;0;0
17147;182210;439;59;37;3;34;.919;4200000;0
17147;187263;434;0;0;0;0;.00nan;0;0
17147;152650;434;64;35;3;32;.914;4200000;0
17149;163177;425;0;0;0;0;.00nan;0;0
17149;179689;415;69;32;2;30;.938;3579000;0
17149;-1;425;94;33;1;32;.970;3600000;0
17149;94557;415;0;0;0;0;.00nan;0;0
17151;178679;435;0;0;0;0;.00nan;0;0
17151;170499;427;18;30;7;23;.767;3600000;0
17151;91448;435;70;31;3;28;.903;3600000;0
17151;149863;427;0;0;0;0;.00nan;0;0
17153;171930;422;0;0;0;0;.00nan;0;0
17153;179127;422;69;25;2;23;.920;3600000;0
17153;174386;428;33;36;7;29;.806;3600000;0
17153;86531;428;0;0;0;0;.00nan;0;0
17155;168206;414;83;41;2;39;.951;3600000;0
17155;183832;436;69;31;3;28;.903;3584000;0
17155;181346;414;0;0;0;0;.00nan;0;0
17155;191861;436;0;0;0;0;.00nan;0;0
17157;189318;431;0;0;0;0;.00nan;0;0
17157;184336;429;33;28;5;23;.821;3600000;0
17157;182225;431;65;29;2;27;.931;3600000;0
17157;-1;429;0;0;0;0;.00nan;0;0
17159;177155;411;60;21;2;19;.905;3600000;0
17159;184033;411;0;0;0;0;.00nan;0;0
17159;-1;413;98;41;1;40;.976;3600000;0
17159;-1;413;0;0;0;0;.00nan;0;0
17161;170928;443;64;37;4;33;.892;3596000;0
17161;182180;443;0;0;0;0;.00nan;0;0
17161;-1;433;0;0;0;0;.00nan;0;0
17161;-1;433;50;19;3;16;.842;3600000;0
17163;179071;420;75;39;3;36;.923;3600000;0
17163;174241;421;36;23;4;19;.826;3566000;0
17163;186076;420;0;0;0;0;.00nan;0;0
17163;74680;421;0;0;0;0;.00nan;0;0
17165;184183;410;0;0;0;0;.00nan;0;0
17165;175989;410;41;18;4;14;.778;3600000;0
17165;181100;442;63;42;5;37;.881;3600000;0
17165;-1;442;0;0;0;0;.00nan;0;0
17167;173575;437;0;0;0;0;.00nan;0;0
17167;178841;419;0;0;0;0;.00nan;0;0
17167;-1;419;52;18;2;16;.889;3600000;0
17167;139865;437;69;34;3;31;.912;3583000;0
17169;165023;438;59;33;4;29;.879;3600000;0
17169;173954;438;0;0;0;0;.00nan;0;0
17169;170886;440;0;0;0;0;.00nan;0;0
17169;175723;440;70;20;1;19;.950;3600000;0
17170;23251;994;0;0;0;0;.00nan;0;0
17170;62530;994;65;36;4;32;.889;3514000;0
17170;146445;894;0;0;0;0;.00nan;0;0
17170;157416;894;70;27;2;25;.926;3600000;0
17171;164710;891;0;0;0;0;.00nan;0;0
17171;76885;874;64;34;4;30;.882;3681000;0
17171;80616;874;0;0;0;0;.00nan;0;0
17171;151940;891;60;24;3;21;.875;3681000;0
17172;4219;1415;0;0;0;0;.00nan;0;0
17172;57426;879;0;0;0;0;.00nan;0;0
17172;86283;879;75;45;3;42;.933;3600000;0
17172;154414;1415;41;26;4;22;.846;3544000;0
17173;28833;3965;85;41;3;38;.927;3600000;0
17173;180177;3965;0;0;0;0;.00nan;0;0
17173;70099;890;34;34;6;28;.824;3600000;0
17173;142583;890;0;0;0;0;.00nan;0;0
17174;9858;966;0;0;0;0;.00nan;0;0
17174;196005;966;74;31;2;29;.935;3600000;0
17174;56306;978;0;0;0;0;.00nan;0;0
17174;157295;978;57;23;3;20;.870;3555000;0
17175;168842;880;0;0;0;0;.00nan;0;0
17175;176765;880;71;26;3;23;.885;3900000;0
17175;82245;945;0;0;0;0;.00nan;0;0
17175;146479;945;86;43;3;40;.930;3900000;0
17176;8101;897;0;0;0;0;.00nan;0;0
17176;201288;957;0;0;0;0;.00nan;0;0
17176;78348;897;76;30;2;28;.933;3600000;0
17176;161128;957;56;35;4;31;.886;3541000;0
17177;201288;957;0;0;0;0;.00nan;0;0
17177;146445;894;65;23;2;21;.913;3600000;0
17177;157416;894;0;0;0;0;.00nan;0;0
17177;161128;957;66;32;3;29;.906;3586000;0
17178;28833;3965;88;32;1;31;.969;3577000;0
17178;180177;3965;0;0;0;0;.00nan;0;0
17178;76885;874;96;20;0;20;1.000;3600000;0
17178;80616;874;0;0;0;0;.00nan;0;0
17179;56306;978;75;40;4;36;.900;3600000;0
17179;82245;945;70;7;0;7;1.000;1448000;0
17179;146479;945;11;16;6;10;.625;2067000;0
17179;157295;978;0;0;0;0;.00nan;0;0
17180;57426;879;74;36;3;33;.917;3900000;0
17180;70099;890;0;0;0;0;.00nan;0;0
17180;86283;879;0;0;0;0;.00nan;0;0
17180;142583;890;62;29;3;26;.897;3900000;0
17181;4219;1415;0;0;0;0;.00nan;0;0
17181;164710;891;96;22;0;22;1.000;3600000;0
17181;151940;891;0;0;0;0;.00nan;0;0
17181;154414;1415;78;21;1;20;.952;3563000;0
17182;9858;966;94;28;2;26;.929;3600000;0
17182;23251;994;0;0;0;0;.00nan;0;0
17182;196005;966;0;0;0;0;.00nan;0;0
17182;62530;994;100;39;1;38;.974;3600000;0
17183;8101;897;65;23;3;20;.870;3150000;0
17183;168842;880;0;0;0;0;.00nan;0;0
17183;176765;880;71;33;3;30;.909;3600000;0
17183;78348;897;36;12;3;9;.750;450000;0
17184;56306;978;89;41;2;39;.951;3517000;0
17184;76885;874;100;23;0;23;1.000;3600000;0
17184;80616;874;0;0;0;0;.00nan;0;0
17184;157295;978;0;0;0;0;.00nan;0;0
17185;23251;994;0;0;0;0;.00nan;0;0
17185;57426;879;34;27;5;22;.815;3600000;0
17185;62530;994;99;36;2;34;.944;3600000;0
17185;86283;879;0;0;0;0;.00nan;0;0
17186;168842;880;0;0;0;0;.00nan;0;0
17186;201288;957;56;33;4;29;.879;3557000;0
17186;176765;880;68;27;3;24;.889;3600000;0
17186;161128;957;0;0;0;0;.00nan;0;0
17187;164710;891;75;24;2;22;.917;3543000;0
17187;70099;890;0;0;0;0;.00nan;0;0
17187;142583;890;91;30;1;29;.967;3600000;0
17187;151940;891;0;0;0;0;.00nan;0;0
17188;4219;1415;73;16;1;15;.938;3600000;0
17188;9858;966;0;0;0;0;.00nan;0;0
17188;196005;966;74;47;4;43;.915;3600000;0
17188;154414;1415;0;0;0;0;.00nan;0;0
17189;8101;897;0;0;0;0;.00nan;0;0
17189;28833;3965;0;0;0;0;.00nan;0;0
17189;180177;3965;100;37;0;37;1.000;3600000;0
17189;78348;897;92;38;2;36;.947;3543000;0
17190;82245;945;0;0;0;0;.00nan;0;0
17190;146445;894;67;21;1;20;.952;2684000;0
17190;146479;945;80;41;3;38;.927;3600000;0
17190;157416;894;25;14;4;10;.714;836000;0
17191;168842;880;0;0;0;0;.00nan;0;0
17191;201288;957;0;0;0;0;.00nan;0;0
17191;176765;880;92;18;0;18;1.000;3600000;0
17191;161128;957;38;35;5;30;.857;3600000;0
17192;164710;891;61;35;5;30;.857;3600000;0
17192;70099;890;0;0;0;0;.00nan;0;0
17192;142583;890;35;27;6;21;.778;3528000;0
17192;151940;891;0;0;0;0;.00nan;0;0
17193;164710;891;40;22;4;18;.818;3600000;0
17193;168842;880;0;0;0;0;.00nan;0;0
17193;176765;880;96;34;1;33;.971;3600000;0
17193;151940;891;0;0;0;0;.00nan;0;0
17194;4219;1415;0;0;0;0;.00nan;0;0
17194;56306;978;75;40;3;37;.925;3575000;0
17194;154414;1415;65;19;2;17;.895;3600000;0
17194;157295;978;0;0;0;0;.00nan;0;0
17195;8101;897;0;0;0;0;.00nan;0;0
17195;57426;879;76;33;2;31;.939;3900000;0
17195;78348;897;65;23;2;21;.913;3900000;0
17195;86283;879;0;0;0;0;.00nan;0;0
17196;76885;874;50;30;4;26;.867;3546000;0
17196;80616;874;0;0;0;0;.00nan;0;0
17196;82245;945;88;43;3;40;.930;3600000;0
17196;146479;945;0;0;0;0;.00nan;0;0
17197;70099;890;0;0;0;0;.00nan;0;0
17197;142583;890;90;33;2;31;.939;3600000;0
17197;146445;894;0;0;0;0;.00nan;0;0
17197;157416;894;72;42;4;38;.905;3576000;0
17198;9858;966;100;26;0;26;1.000;3600000;0
17198;201288;957;0;0;0;0;.00nan;0;0
17198;196005;966;0;0;0;0;.00nan;0;0
17198;161128;957;73;29;2;27;.931;3597000;0
17199;28833;3965;79;24;1;23;.958;3600000;0
17199;180177;3965;0;0;0;0;.00nan;0;0
17199;146445;894;86;38;2;36;.947;3564000;0
17199;157416;894;0;0;0;0;.00nan;0;0
17200;70099;890;0;0;0;0;.00nan;0;0
17200;76885;874;94;28;1;27;.964;3600000;0
17200;80616;874;0;0;0;0;.00nan;0;0
17200;142583;890;52;26;3;23;.885;3566000;0
17201;201288;957;66;37;4;33;.892;3600000;0
17201;56306;978;85;37;3;34;.919;3600000;0
17201;157295;978;0;0;0;0;.00nan;0;0
17201;161128;957;0;0;0;0;.00nan;0;0
17202;9858;966;67;17;1;16;.941;3600000;0
17202;196005;966;0;0;0;0;.00nan;0;0
17202;57426;879;0;0;0;0;.00nan;0;0
17202;86283;879;71;31;2;29;.935;3597000;0
17203;8101;897;0;0;0;0;.00nan;0;0
17203;164710;891;0;0;0;0;.00nan;0;0
17203;78348;897;97;34;0;34;1.000;3900000;0
17203;151940;891;100;25;0;25;1.000;3900000;0
17204;4219;1415;0;0;0;0;.00nan;0;0
17204;82245;945;0;0;0;0;.00nan;0;0
17204;146479;945;81;48;4;44;.917;3600000;0
17204;154414;1415;70;20;1;19;.950;3600000;0
17205;168842;880;0;0;0;0;.00nan;0;0
17205;23251;994;0;0;0;0;.00nan;0;0
17205;176765;880;75;36;3;33;.917;3543000;0
17205;62530;994;88;25;1;24;.960;3600000;0
17206;4219;1415;75;32;2;30;.938;3550000;0
17206;70099;890;0;0;0;0;.00nan;0;0
17206;142583;890;99;40;1;39;.975;3600000;0
17206;154414;1415;0;0;0;0;.00nan;0;0
17207;56306;978;0;0;0;0;.00nan;0;0
17207;146445;894;51;35;5;30;.857;3600000;0
17207;157295;978;86;18;1;17;.944;3600000;0
17207;157416;894;0;0;0;0;.00nan;0;0
17208;23251;994;0;0;0;0;.00nan;0;0
17208;62530;994;60;37;4;33;.892;3600000;0
17208;76885;874;67;32;3;29;.906;3600000;0
17208;80616;874;0;0;0;0;.00nan;0;0
17209;8101;897;0;0;0;0;.00nan;0;0
17209;9858;966;75;28;3;25;.893;3614000;0
17209;196005;966;0;0;0;0;.00nan;0;0
17209;78348;897;99;47;2;45;.957;3614000;0
17210;164710;891;0;0;0;0;.00nan;0;0
17210;82245;945;0;0;0;0;.00nan;0;0
17210;146479;945;66;34;3;31;.912;3900000;0
17210;151940;891;87;42;3;39;.929;3900000;0
17211;201288;957;0;0;0;0;.00nan;0;0
17211;28833;3965;84;23;1;22;.957;3600000;0
17211;180177;3965;0;0;0;0;.00nan;0;0
17211;161128;957;59;25;3;22;.880;3515000;0
17212;168842;880;98;26;0;26;1.000;3600000;0
17212;176765;880;0;0;0;0;.00nan;0;0
17212;57426;879;84;37;2;35;.946;3571000;0
17212;86283;879;0;0;0;0;.00nan;0;0
17213;168842;880;42;37;6;31;.838;3600000;0
17213;176765;880;0;0;0;0;.00nan;0;0
17213;76885;874;71;24;2;22;.917;3600000;0
17213;80616;874;0;0;0;0;.00nan;0;0
17214;201288;957;0;0;0;0;.00nan;0;0
17214;82245;945;91;48;4;44;.917;3643000;0
17214;146479;945;0;0;0;0;.00nan;0;0
17214;161128;957;65;30;3;27;.900;3643000;0
17215;56306;978;87;37;3;34;.919;3611000;0
17215;57426;879;0;0;0;0;.00nan;0;0
17215;86283;879;56;19;2;17;.895;3611000;0
17215;157295;978;0;0;0;0;.00nan;0;0
17216;23251;994;58;7;0;7;1.000;1391000;0
17216;62530;994;28;26;6;20;.769;2209000;0
17216;70099;890;0;0;0;0;.00nan;0;0
17216;142583;890;44;21;4;17;.810;3600000;0
17217;164710;891;67;18;1;17;.944;3600000;0
17217;28833;3965;0;0;0;0;.00nan;0;0
17217;180177;3965;72;41;3;38;.927;3569000;0
17217;151940;891;0;0;0;0;.00nan;0;0
17218;9858;966;0;0;0;0;.00nan;0;0
17218;196005;966;54;20;2;18;.900;3600000;0
17218;146445;894;65;28;3;25;.893;3600000;0
17218;157416;894;0;0;0;0;.00nan;0;0
17219;4219;1415;72;24;2;22;.917;3550000;0
17219;8101;897;0;0;0;0;.00nan;0;0
17219;78348;897;82;21;1;20;.952;3600000;0
17219;154414;1415;0;0;0;0;.00nan;0;0
17220;23251;994;0;0;0;0;.00nan;0;0
17220;28833;3965;0;0;0;0;.00nan;0;0
17220;180177;3965;90;29;1;28;.966;3900000;0
17220;62530;994;64;17;1;16;.941;3900000;0
17221;76885;874;47;14;2;12;.857;3679000;0
17221;80616;874;0;0;0;0;.00nan;0;0
17221;146445;894;0;0;0;0;.00nan;0;0
17221;157416;894;76;37;3;34;.919;3679000;0
17222;8101;897;0;0;0;0;.00nan;0;0
17222;23251;994;0;0;0;0;.00nan;0;0
17222;62530;994;76;49;5;44;.898;3900000;0
17222;78348;897;35;31;5;26;.839;3900000;0
17223;201288;957;88;32;2;30;.938;3600000;0
17223;70099;890;0;0;0;0;.00nan;0;0
17223;142583;890;47;33;5;28;.848;3600000;0
17223;161128;957;0;0;0;0;.00nan;0;0
17224;57426;879;52;29;4;25;.862;3600000;0
17224;82245;945;0;0;0;0;.00nan;0;0
17224;86283;879;0;0;0;0;.00nan;0;0
17224;146479;945;80;39;3;36;.923;3600000;0
17225;164710;891;0;0;0;0;.00nan;0;0
17225;56306;978;0;0;0;0;.00nan;0;0
17225;151940;891;61;25;3;22;.880;3585000;0
17225;157295;978;92;37;2;35;.946;3600000;0
17226;4219;1415;0;0;0;0;.00nan;0;0
17226;28833;3965;98;54;3;51;.944;3600000;0
17226;180177;3965;0;0;0;0;.00nan;0;0
17226;154414;1415;100;23;0;23;1.000;3600000;0
17227;9858;966;68;49;5;44;.898;3600000;0
17227;168842;880;0;0;0;0;.00nan;0;0
17227;176765;880;83;25;1;24;.960;3600000;0
17227;196005;966;0;0;0;0;.00nan;0;0
17228;57426;879;55;23;3;20;.870;3600000;0
17228;86283;879;0;0;0;0;.00nan;0;0
17228;146445;894;0;0;0;0;.00nan;0;0
17228;157416;894;82;49;4;45;.918;3573000;0
17229;56306;978;50;43;6;37;.860;3600000;0
17229;70099;890;0;0;0;0;.00nan;0;0
17229;142583;890;58;22;3;19;.864;3600000;0
17229;157295;978;0;0;0;0;.00nan;0;0
17230;201288;957;0;0;0;0;.00nan;0;0
17230;76885;874;0;0;0;0;.00nan;0;0
17230;80616;874;70;32;4;28;.875;3600000;0
17230;161128;957;90;29;1;28;.966;3600000;0
17231;164710;891;88;27;1;26;.963;3900000;0
17231;23251;994;0;0;0;0;.00nan;0;0
17231;62530;994;96;42;1;41;.976;3900000;0
17231;151940;891;0;0;0;0;.00nan;0;0
17232;9858;966;47;19;2;17;.895;3545000;0
17232;28833;3965;0;0;0;0;.00nan;0;0
17232;196005;966;0;0;0;0;.00nan;0;0
17232;180177;3965;77;20;1;19;.950;3600000;0
17233;4219;1415;0;0;0;0;.00nan;0;0
17233;168842;880;0;0;0;0;.00nan;0;0
17233;176765;880;100;27;0;27;1.000;3600000;0
17233;154414;1415;58;28;3;25;.893;3600000;0
17234;8101;897;0;0;0;0;.00nan;0;0
17234;78348;897;59;34;4;30;.882;3811000;0
17234;82245;945;0;0;0;0;.00nan;0;0
17234;146479;945;95;38;3;35;.921;3811000;0
17235;28833;3965;78;47;4;43;.915;3600000;0
17235;180177;3965;0;0;0;0;.00nan;0;0
17235;57426;879;0;0;0;0;.00nan;0;0
17235;86283;879;65;15;1;14;.933;3600000;0
17236;28833;3965;0;0;0;0;.00nan;0;0
17236;180177;3965;61;39;4;35;.897;3600000;0
17236;57426;879;79;12;0;12;1.000;3600000;0
17236;86283;879;0;0;0;0;.00nan;0;0
17237;168842;880;0;0;0;0;.00nan;0;0
17237;176765;880;68;26;2;24;.923;3573000;0
17237;56306;978;98;26;0;26;1.000;3600000;0
17237;157295;978;0;0;0;0;.00nan;0;0
17238;4219;1415;0;0;0;0;.00nan;0;0
17238;76885;874;48;26;4;22;.846;3600000;0
17238;80616;874;0;0;0;0;.00nan;0;0
17238;154414;1415;85;23;1;22;.957;3600000;0
17239;8101;897;96;23;0;23;1.000;3600000;0
17239;78348;897;0;0;0;0;.00nan;0;0
17239;146445;894;63;44;5;39;.886;3600000;0
17239;157416;894;0;0;0;0;.00nan;0;0
17240;164710;891;0;0;0;0;.00nan;0;0
17240;201288;957;0;0;0;0;.00nan;0;0
17240;151940;891;48;32;5;27;.844;3598000;0
17240;161128;957;54;23;3;20;.870;3600000;0
17241;23251;994;0;0;0;0;.00nan;0;0
17241;62530;994;79;33;3;30;.909;3600000;0
17241;82245;945;63;8;0;8;1.000;907000;0
17241;146479;945;25;21;6;15;.714;2693000;0
17242;9858;966;47;25;4;21;.840;3553000;0
17242;196005;966;0;0;0;0;.00nan;0;0
17242;70099;890;0;0;0;0;.00nan;0;0
17242;142583;890;82;42;2;40;.952;3600000;0
17243;4219;1415;0;0;0;0;.00nan;0;0
17243;146445;894;0;0;0;0;.00nan;0;0
17243;154414;1415;60;19;2;17;.895;3600000;0
17243;157416;894;76;38;3;35;.921;3600000;0
17244;8101;897;60;36;5;31;.861;3542000;0
17244;56306;978;63;34;4;30;.882;3600000;0
17244;78348;897;0;0;0;0;.00nan;0;0
17244;157295;978;0;0;0;0;.00nan;0;0
17245;28833;3965;93;28;1;27;.964;3600000;0
17245;180177;3965;0;0;0;0;.00nan;0;0
17245;82245;945;71;30;2;28;.933;3547000;0
17245;146479;945;0;0;0;0;.00nan;0;0
17246;9858;966;92;48;3;45;.938;3732000;0
17246;196005;966;0;0;0;0;.00nan;0;0
17246;76885;874;59;19;2;17;.895;3732000;0
17246;80616;874;0;0;0;0;.00nan;0;0
17247;168842;880;0;0;0;0;.00nan;0;0
17247;176765;880;66;17;1;16;.941;3600000;0
17247;70099;890;0;0;0;0;.00nan;0;0
17247;142583;890;86;42;3;39;.929;3595000;0
17248;23251;994;0;0;0;0;.00nan;0;0
17248;201288;957;0;0;0;0;.00nan;0;0
17248;62530;994;78;41;3;38;.927;3900000;0
17248;161128;957;71;32;3;29;.906;3900000;0
17249;164710;891;62;35;4;31;.886;3900000;0
17249;57426;879;63;34;4;30;.882;3900000;0
17249;86283;879;0;0;0;0;.00nan;0;0
17249;151940;891;0;0;0;0;.00nan;0;0
17250;168842;880;0;0;0;0;.00nan;0;0
17250;176765;880;29;25;6;19;.760;3600000;0
17250;146445;894;90;32;2;30;.938;3600000;0
17250;157416;894;0;0;0;0;.00nan;0;0
17251;28833;3965;0;0;0;0;.00nan;0;0
17251;180177;3965;85;36;3;33;.917;3900000;0
17251;56306;978;0;0;0;0;.00nan;0;0
17251;157295;978;63;29;3;26;.897;3900000;0
17252;8101;897;0;0;0;0;.00nan;0;0
17252;76885;874;75;19;1;18;.947;3600000;0
17252;78348;897;93;43;2;41;.953;3600000;0
17252;80616;874;0;0;0;0;.00nan;0;0
17253;201288;957;78;31;2;29;.935;3544000;0
17253;57426;879;93;28;1;27;.964;3600000;0
17253;86283;879;0;0;0;0;.00nan;0;0
17253;161128;957;0;0;0;0;.00nan;0;0
17254;70099;890;76;22;1;21;.955;3900000;0
17254;82245;945;0;0;0;0;.00nan;0;0
17254;142583;890;0;0;0;0;.00nan;0;0
17254;146479;945;73;23;1;22;.957;3900000;0
17255;4219;1415;0;0;0;0;.00nan;0;0
17255;23251;994;0;0;0;0;.00nan;0;0
17255;62530;994;85;33;1;32;.970;3578000;0
17255;154414;1415;84;18;0;18;1.000;3600000;0
17256;9858;966;0;0;0;0;.00nan;0;0
17256;164710;891;77;26;1;25;.962;3600000;0
17256;196005;966;52;27;3;24;.889;3544000;0
17256;151940;891;0;0;0;0;.00nan;0;0
17257;23251;994;0;0;0;0;.00nan;0;0
17257;56306;978;71;33;3;30;.909;3600000;0
17257;62530;994;54;28;4;24;.857;3564000;0
17257;157295;978;0;0;0;0;.00nan;0;0
17258;8101;897;0;0;0;0;.00nan;0;0
17258;70099;890;0;0;0;0;.00nan;0;0
17258;78348;897;47;32;5;27;.844;3600000;0
17258;142583;890;39;36;6;30;.833;3593000;0
17259;4219;1415;0;0;0;0;.00nan;0;0
17259;201288;957;0;0;0;0;.00nan;0;0
17259;154414;1415;51;26;4;22;.846;3600000;0
17259;161128;957;89;30;1;29;.967;3600000;0
17260;9858;966;0;0;0;0;.00nan;0;0
17260;196005;966;100;37;0;37;1.000;3600000;0
17260;82245;945;73;33;3;30;.909;3600000;0
17260;146479;945;0;0;0;0;.00nan;0;0
17261;57426;879;0;0;0;0;.00nan;0;0
17261;76885;874;75;27;2;25;.926;3600000;0
17261;80616;874;0;0;0;0;.00nan;0;0
17261;86283;879;56;30;4;26;.867;3600000;0
17262;164710;891;0;0;0;0;.00nan;0;0
17262;146445;894;57;26;3;23;.885;3573000;0
17262;151940;891;92;31;1;30;.968;3600000;0
17262;157416;894;0;0;0;0;.00nan;0;0
17263;168842;880;0;0;0;0;.00nan;0;0
17263;28833;3965;20;10;4;6;.600;1145000;0
17263;176765;880;59;19;2;17;.895;3600000;0
17263;180177;3965;69;28;2;26;.929;2455000;0
17264;23251;994;0;0;0;0;.00nan;0;0
17264;57426;879;72;22;2;20;.909;3900000;0
17264;62530;994;83;32;2;30;.938;3900000;0
17264;86283;879;0;0;0;0;.00nan;0;0
17265;9858;966;0;0;0;0;.00nan;0;0
17265;196005;966;100;25;0;25;1.000;3600000;0
17265;146445;894;68;36;3;33;.917;3600000;0
17265;157416;894;0;0;0;0;.00nan;0;0
17266;28833;3965;0;0;0;0;.00nan;0;0
17266;180177;3965;78;53;5;48;.906;3600000;0
17266;76885;874;58;18;2;16;.889;3600000;0
17266;80616;874;0;0;0;0;.00nan;0;0
17267;168842;880;0;0;0;0;.00nan;0;0
17267;176765;880;66;18;1;17;.944;3600000;0
17267;82245;945;0;0;0;0;.00nan;0;0
17267;146479;945;91;43;2;41;.953;3600000;0
17268;201288;957;79;31;2;29;.935;3900000;0
17268;70099;890;0;0;0;0;.00nan;0;0
17268;142583;890;95;42;2;40;.952;3900000;0
17268;161128;957;0;0;0;0;.00nan;0;0
17269;4219;1415;0;0;0;0;.00nan;0;0
17269;164710;891;0;0;0;0;.00nan;0;0
17269;151940;891;63;25;2;23;.920;3580000;0
17269;154414;1415;96;24;0;24;1.000;3600000;0
17270;8101;897;0;0;0;0;.00nan;0;0
17270;28833;3965;95;27;1;26;.963;3600000;0
17270;180177;3965;0;0;0;0;.00nan;0;0
17270;78348;897;65;26;3;23;.885;3550000;0
17271;168842;880;0;0;0;0;.00nan;0;0
17271;201288;957;0;0;0;0;.00nan;0;0
17271;176765;880;66;33;3;30;.909;3600000;0
17271;161128;957;91;20;0;20;1.000;3600000;0
17272;56306;978;57;25;3;22;.880;3600000;0
17272;146445;894;0;0;0;0;.00nan;0;0
17272;157295;978;0;0;0;0;.00nan;0;0
17272;157416;894;62;33;4;29;.879;3548000;0
17273;9858;966;63;16;1;15;.938;1256000;0
17273;196005;966;34;31;6;25;.806;2344000;0
17273;76885;874;61;27;4;23;.852;3600000;0
17273;80616;874;0;0;0;0;.00nan;0;0
17274;57426;879;58;19;2;17;.895;3600000;0
17274;76885;874;61;27;3;24;.889;3600000;0
17274;80616;874;0;0;0;0;.00nan;0;0
17274;86283;879;0;0;0;0;.00nan;0;0
17275;23251;994;0;0;0;0;.00nan;0;0
17275;28833;3965;80;37;3;34;.919;3600000;0
17275;180177;3965;0;0;0;0;.00nan;0;0
17275;62530;994;98;25;0;25;1.000;3600000;0
17276;8101;897;0;0;0;0;.00nan;0;0
17276;201288;957;0;0;0;0;.00nan;0;0
17276;78348;897;87;34;2;32;.941;3600000;0
17276;161128;957;72;30;3;27;.900;3562000;0
17277;164710;891;66;35;4;31;.886;3579000;0
17277;70099;890;0;0;0;0;.00nan;0;0
17277;142583;890;69;23;2;21;.913;3600000;0
17277;151940;891;0;0;0;0;.00nan;0;0
17278;4219;1415;0;0;0;0;.00nan;0;0
17278;168842;880;0;0;0;0;.00nan;0;0
17278;176765;880;68;34;4;30;.882;3582000;0
17278;154414;1415;90;38;2;36;.947;3600000;0
17279;9858;966;56;28;4;24;.857;3687000;0
17279;196005;966;0;0;0;0;.00nan;0;0
17279;82245;945;0;0;0;0;.00nan;0;0
17279;146479;945;68;42;5;37;.881;3682000;0
17280;9858;966;0;0;0;0;.00nan;0;0
17280;196005;966;75;23;1;22;.957;3600000;0
17280;56306;978;83;38;2;36;.947;3568000;0
17280;157295;978;0;0;0;0;.00nan;0;0
17281;82245;945;0;0;0;0;.00nan;0;0
17281;146445;894;60;39;5;34;.872;3568000;0
17281;146479;945;65;33;4;29;.879;3600000;0
17281;157416;894;0;0;0;0;.00nan;0;0
17282;201288;957;0;0;0;0;.00nan;0;0
17282;57426;879;61;33;4;29;.879;3520000;0
17282;86283;879;0;0;0;0;.00nan;0;0
17282;161128;957;71;32;2;30;.938;3600000;0
17283;70099;890;0;0;0;0;.00nan;0;0
17283;76885;874;79;22;1;21;.955;3600000;0
17283;80616;874;0;0;0;0;.00nan;0;0
17283;142583;890;73;40;3;37;.925;3575000;0
17284;4219;1415;0;0;0;0;.00nan;0;0
17284;28833;3965;70;40;4;36;.900;3600000;0
17284;180177;3965;0;0;0;0;.00nan;0;0
17284;154414;1415;82;17;0;17;1.000;3600000;0
17285;168842;880;0;0;0;0;.00nan;0;0
17285;23251;994;0;0;0;0;.00nan;0;0
17285;176765;880;81;29;1;28;.966;3600000;0
17285;62530;994;75;33;2;31;.939;3600000;0
17286;4219;1415;0;0;0;0;.00nan;0;0
17286;28833;3965;0;0;0;0;.00nan;0;0
17286;180177;3965;62;32;4;28;.875;3528000;0
17286;154414;1415;65;21;2;19;.905;3600000;0
17287;201288;957;69;30;3;27;.900;3600000;0
17287;76885;874;94;19;0;19;1.000;3600000;0
17287;80616;874;0;0;0;0;.00nan;0;0
17287;161128;957;0;0;0;0;.00nan;0;0
17288;164710;891;0;0;0;0;.00nan;0;0
17288;168842;880;0;0;0;0;.00nan;0;0
17288;176765;880;40;15;3;12;.800;3561000;0
17288;151940;891;73;24;1;23;.958;3600000;0
17289;56306;978;0;0;0;0;.00nan;0;0
17289;82245;945;88;31;1;30;.968;3600000;0
17289;146479;945;0;0;0;0;.00nan;0;0
17289;157295;978;39;22;4;18;.818;3557000;0
17290;4219;1415;0;0;0;0;.00nan;0;0
17290;23251;994;0;0;0;0;.00nan;0;0
17290;62530;994;80;38;3;35;.921;3556000;0
17290;154414;1415;75;25;1;24;.960;3600000;0
17291;8101;897;0;0;0;0;.00nan;0;0
17291;76885;874;69;35;3;32;.914;3900000;0
17291;78348;897;75;34;3;31;.912;3900000;0
17291;80616;874;0;0;0;0;.00nan;0;0
17292;201288;957;0;0;0;0;.00nan;0;0
17292;146445;894;0;0;0;0;.00nan;0;0
17292;157416;894;75;34;3;31;.912;3561000;0
17292;161128;957;75;23;1;22;.957;3600000;0
17293;28833;3965;0;0;0;0;.00nan;0;0
17293;180177;3965;69;19;1;18;.947;3600000;0
17293;70099;890;0;0;0;0;.00nan;0;0
17293;142583;890;64;35;3;32;.914;3600000;0
17294;9858;966;0;0;0;0;.00nan;0;0
17294;196005;966;78;31;2;29;.935;3600000;0
17294;57426;879;46;29;4;25;.862;3553000;0
17294;86283;879;0;0;0;0;.00nan;0;0
17295;4219;1415;55;29;4;25;.862;3894000;0
17295;8101;897;0;0;0;0;.00nan;0;0
17295;78348;897;63;35;3;32;.914;3894000;0
17295;154414;1415;0;0;0;0;.00nan;0;0
17296;56306;978;78;45;4;41;.911;3600000;0
17296;76885;874;74;21;1;20;.952;3600000;0
17296;80616;874;0;0;0;0;.00nan;0;0
17296;157295;978;0;0;0;0;.00nan;0;0
17297;9858;966;71;40;4;36;.900;3600000;0
17297;201288;957;0;0;0;0;.00nan;0;0
17297;196005;966;0;0;0;0;.00nan;0;0
17297;161128;957;13;18;6;12;.667;3573000;0
17298;28833;3965;43;25;4;21;.840;3549000;0
17298;180177;3965;0;0;0;0;.00nan;0;0
17298;82245;945;74;27;2;25;.926;3600000;0
17298;146479;945;0;0;0;0;.00nan;0;0
17299;164710;891;63;29;3;26;.897;3552000;0
17299;57426;879;0;0;0;0;.00nan;0;0
17299;86283;879;69;27;2;25;.926;3600000;0
17299;151940;891;0;0;0;0;.00nan;0;0
17300;168842;880;0;0;0;0;.00nan;0;0
17300;176765;880;86;38;2;36;.947;3900000;0
17300;70099;890;0;0;0;0;.00nan;0;0
17300;142583;890;91;38;2;36;.947;3882000;0
17301;23251;994;0;0;0;0;.00nan;0;0
17301;62530;994;39;27;5;22;.815;3570000;0
17301;146445;894;86;43;3;40;.930;3600000;0
17301;157416;894;0;0;0;0;.00nan;0;0
17302;164710;891;0;0;0;0;.00nan;0;0
17302;76885;874;98;27;1;26;.963;3600000;0
17302;80616;874;0;0;0;0;.00nan;0;0
17302;151940;891;66;31;3;28;.903;3600000;0
17303;4219;1415;0;0;0;0;.00nan;0;0
17303;9858;966;0;0;0;0;.00nan;0;0
17303;196005;966;78;47;4;43;.915;3600000;0
17303;154414;1415;87;20;0;20;1.000;3600000;0
17304;56306;978;41;34;5;29;.853;3600000;0
17304;57426;879;73;27;2;25;.926;3600000;0
17304;86283;879;0;0;0;0;.00nan;0;0
17304;157295;978;0;0;0;0;.00nan;0;0
17305;23251;994;0;0;0;0;.00nan;0;0
17305;62530;994;67;42;4;38;.905;3544000;0
17305;70099;890;0;0;0;0;.00nan;0;0
17305;142583;890;88;40;3;37;.925;3600000;0
17306;8101;897;0;0;0;0;.00nan;0;0
17306;78348;897;84;31;1;30;.968;3600000;0
17306;82245;945;0;0;0;0;.00nan;0;0
17306;146479;945;56;28;3;25;.893;3546000;0
17307;28833;3965;0;0;0;0;.00nan;0;0
17307;180177;3965;63;19;2;17;.895;3600000;0
17307;146445;894;0;0;0;0;.00nan;0;0
17307;157416;894;72;39;4;35;.897;3539000;0
17308;76885;874;97;16;0;16;1.000;3600000;0
17308;80616;874;0;0;0;0;.00nan;0;0
17308;82245;945;0;0;0;0;.00nan;0;0
17308;146479;945;75;40;4;36;.900;3600000;0
17309;23251;994;0;0;0;0;.00nan;0;0
17309;201288;957;49;18;3;15;.833;3600000;0
17309;62530;994;44;55;8;47;.855;3600000;0
17309;161128;957;0;0;0;0;.00nan;0;0
17310;57426;879;72;18;2;16;.889;3900000;0
17310;86283;879;0;0;0;0;.00nan;0;0
17310;146445;894;97;52;2;50;.962;3900000;0
17310;157416;894;0;0;0;0;.00nan;0;0
17311;4219;1415;0;0;0;0;.00nan;0;0
17311;70099;890;82;33;2;31;.939;3900000;0
17311;142583;890;0;0;0;0;.00nan;0;0
17311;154414;1415;73;27;2;25;.926;3900000;0
17312;9858;966;0;0;0;0;.00nan;0;0
17312;164710;891;71;19;1;18;.947;3600000;0
17312;196005;966;40;19;4;15;.789;3600000;0
17312;151940;891;0;0;0;0;.00nan;0;0
17313;168842;880;0;0;0;0;.00nan;0;0
17313;176765;880;32;28;5;23;.821;3600000;0
17313;56306;978;0;0;0;0;.00nan;0;0
17313;157295;978;100;39;1;38;.974;3600000;0
17314;70099;890;0;0;0;0;.00nan;0;0
17314;142583;890;52;28;4;24;.857;3600000;0
17314;146445;894;100;31;0;31;1.000;3600000;0
17314;157416;894;0;0;0;0;.00nan;0;0
17315;201288;957;0;0;0;0;.00nan;0;0
17315;56306;978;86;23;0;23;1.000;1272000;0
17315;157295;978;54;46;6;40;.870;2328000;0
17315;161128;957;63;13;1;12;.923;3600000;0
17316;164710;891;73;28;2;26;.929;3632000;0
17316;23251;994;0;0;0;0;.00nan;0;0
17316;62530;994;99;52;1;51;.981;3632000;0
17316;151940;891;0;0;0;0;.00nan;0;0
17317;57426;879;64;17;2;15;.882;3600000;0
17317;82245;945;95;52;4;48;.923;3600000;0
17317;86283;879;0;0;0;0;.00nan;0;0
17317;146479;945;0;0;0;0;.00nan;0;0
17318;168842;880;0;0;0;0;.00nan;0;0
17318;28833;3965;68;27;3;24;.889;3600000;0
17318;176765;880;40;21;4;17;.810;3580000;0
17318;180177;3965;0;0;0;0;.00nan;0;0
17319;8101;897;0;0;0;0;.00nan;0;0
17319;9858;966;0;0;0;0;.00nan;0;0
17319;196005;966;62;28;2;26;.929;3571000;0
17319;78348;897;87;30;1;29;.967;3600000;0
17320;4219;1415;0;0;0;0;.00nan;0;0
17320;76885;874;75;35;3;32;.914;3900000;0
17320;80616;874;0;0;0;0;.00nan;0;0
17320;154414;1415;70;34;3;31;.912;3900000;0
17321;8101;897;0;0;0;0;.00nan;0;0
17321;56306;978;0;0;0;0;.00nan;0;0
17321;78348;897;93;38;2;36;.947;3900000;0
17321;157295;978;94;37;2;35;.946;3900000;0
17322;4219;1415;0;0;0;0;.00nan;0;0
17322;146445;894;95;30;1;29;.967;3600000;0
17322;154414;1415;40;16;3;13;.813;3540000;0
17322;157416;894;0;0;0;0;.00nan;0;0
17323;9858;966;70;27;2;25;.926;3600000;0
17323;23251;994;73;36;3;33;.917;3590000;0
17323;196005;966;0;0;0;0;.00nan;0;0
17323;62530;994;0;0;0;0;.00nan;0;0
17324;201288;957;31;26;6;20;.769;2966000;0
17324;82245;945;85;37;2;35;.946;2825000;0
17324;146479;945;40;20;4;16;.800;885000;0
17324;161128;957;46;4;1;3;.750;744000;0
17325;8101;897;0;0;0;0;.00nan;0;0
17325;57426;879;0;0;0;0;.00nan;0;0
17325;78348;897;85;35;2;33;.943;3600000;0
17325;86283;879;24;33;7;26;.788;3600000;0
17326;56306;978;0;0;0;0;.00nan;0;0
17326;70099;890;93;23;0;23;1.000;3600000;0
17326;142583;890;0;0;0;0;.00nan;0;0
17326;157295;978;94;36;1;35;.972;3585000;0
17327;164710;891;0;0;0;0;.00nan;0;0
17327;28833;3965;0;0;0;0;.00nan;0;0
17327;180177;3965;76;39;3;36;.923;3600000;0
17327;151940;891;68;27;2;25;.926;3600000;0
17328;168842;880;12;18;6;12;.667;1252000;0
17328;176765;880;84;28;2;26;.929;2348000;0
17328;76885;874;70;29;3;26;.897;3600000;0
17328;80616;874;0;0;0;0;.00nan;0;0
17329;56306;978;0;0;0;0;.00nan;0;0
17329;146445;894;90;33;1;32;.970;3900000;0
17329;157295;978;84;29;1;28;.966;3900000;0
17329;157416;894;0;0;0;0;.00nan;0;0
17330;23251;994;0;0;0;0;.00nan;0;0
17330;62530;994;92;44;3;41;.932;3600000;0
17330;76885;874;74;24;2;22;.917;3600000;0
17330;80616;874;0;0;0;0;.00nan;0;0
17331;8101;897;0;0;0;0;.00nan;0;0
17331;168842;880;0;0;0;0;.00nan;0;0
17331;176765;880;66;34;4;30;.882;3636000;0
17331;78348;897;93;45;3;42;.933;3636000;0
17332;201288;957;0;0;0;0;.00nan;0;0
17332;28833;3965;27;6;3;3;.500;568000;0
17332;180177;3965;88;37;3;34;.919;2963000;0
17332;161128;957;51;32;4;28;.875;3600000;0
17333;164710;891;68;29;3;26;.897;3900000;0
17333;82245;945;0;0;0;0;.00nan;0;0
17333;146479;945;71;35;3;32;.914;3900000;0
17333;151940;891;0;0;0;0;.00nan;0;0
17334;4219;1415;0;0;0;0;.00nan;0;0
17334;57426;879;0;0;0;0;.00nan;0;0
17334;86283;879;84;20;0;20;1.000;3600000;0
17334;154414;1415;57;27;3;24;.889;3600000;0
17335;9858;966;0;0;0;0;.00nan;0;0
17335;196005;966;43;30;4;26;.867;3600000;0
17335;70099;890;69;21;1;20;.952;3600000;0
17335;142583;890;0;0;0;0;.00nan;0;0
17336;164710;891;0;0;0;0;.00nan;0;0
17336;56306;978;0;0;0;0;.00nan;0;0
17336;151940;891;72;27;2;25;.926;3628000;0
17336;157295;978;71;36;3;33;.917;3628000;0
17337;76885;874;0;0;0;0;.00nan;0;0
17337;80616;874;75;25;1;24;.960;3600000;0
17337;146445;894;96;45;3;42;.933;3551000;0
17337;157416;894;0;0;0;0;.00nan;0;0
17338;8101;897;0;0;0;0;.00nan;0;0
17338;23251;994;0;0;0;0;.00nan;0;0
17338;62530;994;92;35;2;33;.943;3549000;0
17338;78348;897;76;22;1;21;.955;3600000;0
17339;70099;890;0;0;0;0;.00nan;0;0
17339;82245;945;65;22;2;20;.909;3600000;0
17339;142583;890;48;35;5;30;.857;3600000;0
17339;146479;945;0;0;0;0;.00nan;0;0
17340;4219;1415;0;0;0;0;.00nan;0;0
17340;201288;957;0;0;0;0;.00nan;0;0
17340;154414;1415;49;39;5;34;.872;3600000;0
17340;161128;957;86;28;1;27;.964;3600000;0
17341;9858;966;100;24;0;24;1.000;3600000;0
17341;168842;880;0;0;0;0;.00nan;0;0
17341;176765;880;67;27;2;25;.926;3546000;0
17341;196005;966;0;0;0;0;.00nan;0;0
17342;164710;891;51;24;4;20;.833;3517000;0
17342;146445;894;0;0;0;0;.00nan;0;0
17342;151940;891;0;0;0;0;.00nan;0;0
17342;157416;894;73;28;2;26;.929;3600000;0
17343;23251;994;0;0;0;0;.00nan;0;0
17343;56306;978;70;38;4;34;.895;3900000;0
17343;62530;994;81;45;4;41;.911;3900000;0
17343;157295;978;0;0;0;0;.00nan;0;0
17344;201288;957;49;24;3;21;.875;3600000;0
17344;76885;874;99;40;1;39;.975;3600000;0
17344;80616;874;0;0;0;0;.00nan;0;0
17344;161128;957;0;0;0;0;.00nan;0;0
17345;4219;1415;0;0;0;0;.00nan;0;0
17345;82245;945;64;10;0;10;1.000;1429000;0
17345;146479;945;26;27;6;21;.778;2171000;0
17345;154414;1415;74;20;1;19;.950;3600000;0
17346;168842;880;0;0;0;0;.00nan;0;0
17346;176765;880;80;39;4;35;.897;3551000;0
17346;57426;879;0;0;0;0;.00nan;0;0
17346;86283;879;73;26;2;24;.923;3600000;0
17347;8101;897;0;0;0;0;.00nan;0;0
17347;70099;890;69;21;1;20;.952;3146000;0
17347;78348;897;97;52;4;48;.923;3600000;0
17347;142583;890;17;6;4;2;.333;429000;0
17348;9858;966;81;38;3;35;.921;3585000;0
17348;28833;3965;0;0;0;0;.00nan;0;0
17348;196005;966;0;0;0;0;.00nan;0;0
17348;180177;3965;66;26;2;24;.923;3600000;0
17349;57426;879;0;0;0;0;.00nan;0;0
17349;86283;879;77;9;0;9;1.000;3600000;0
17349;146445;894;71;41;3;38;.927;3600000;0
17349;157416;894;0;0;0;0;.00nan;0;0
17350;4219;1415;0;0;0;0;.00nan;0;0
17350;56306;978;0;0;0;0;.00nan;0;0
17350;154414;1415;70;27;2;25;.926;3600000;0
17350;157295;978;81;35;3;32;.914;3595000;0
17351;8101;897;0;0;0;0;.00nan;0;0
17351;168842;880;0;0;0;0;.00nan;0;0
17351;176765;880;54;21;3;18;.857;3600000;0
17351;78348;897;59;34;4;30;.882;3600000;0
17352;28833;3965;93;43;2;41;.953;3857000;0
17352;180177;3965;0;0;0;0;.00nan;0;0
17352;70099;890;77;31;3;28;.903;3857000;0
17352;142583;890;0;0;0;0;.00nan;0;0
17353;23251;994;0;0;0;0;.00nan;0;0
17353;62530;994;83;38;2;36;.947;3600000;0
17353;82245;945;50;32;4;28;.875;3600000;0
17353;146479;945;0;0;0;0;.00nan;0;0
17354;164710;891;0;0;0;0;.00nan;0;0
17354;201288;957;0;0;0;0;.00nan;0;0
17354;151940;891;71;27;2;25;.926;3900000;0
17354;161128;957;80;32;2;30;.938;3867000;0
17355;23251;994;0;0;0;0;.00nan;0;0
17355;56306;978;24;24;6;18;.750;2112000;0
17355;62530;994;82;42;4;38;.905;3600000;0
17355;157295;978;78;22;0;22;1.000;1449000;0
17356;70099;890;0;0;0;0;.00nan;0;0
17356;76885;874;68;14;1;13;.929;3600000;0
17356;80616;874;0;0;0;0;.00nan;0;0
17356;142583;890;22;26;6;20;.769;3600000;0
17357;8101;897;65;19;1;18;.947;2407000;0
17357;78348;897;35;20;4;16;.800;1193000;0
17357;82245;945;0;0;0;0;.00nan;0;0
17357;146479;945;81;28;2;26;.929;3600000;0
17358;164710;891;66;29;3;26;.897;3544000;0
17358;146445;894;72;19;1;18;.947;3600000;0
17358;151940;891;0;0;0;0;.00nan;0;0
17358;157416;894;0;0;0;0;.00nan;0;0
17359;9858;966;57;33;4;29;.879;3600000;0
17359;196005;966;0;0;0;0;.00nan;0;0
17359;57426;879;0;0;0;0;.00nan;0;0
17359;86283;879;35;25;5;20;.800;3600000;0
17360;8101;897;0;0;0;0;.00nan;0;0
17360;78348;897;82;40;3;37;.925;3900000;0
17360;146445;894;74;30;3;27;.900;3900000;0
17360;157416;894;0;0;0;0;.00nan;0;0
17361;164710;891;0;0;0;0;.00nan;0;0
17361;23251;994;0;0;0;0;.00nan;0;0
17361;62530;994;79;32;2;30;.938;3900000;0
17361;151940;891;46;17;2;15;.882;3900000;0
17362;9858;966;81;28;2;26;.929;3600000;0
17362;196005;966;0;0;0;0;.00nan;0;0
17362;82245;945;18;19;6;13;.684;1684000;0
17362;146479;945;57;11;1;10;.909;1916000;0
17363;20645;957;65;21;2;19;.905;1660000;0
17363;57426;879;56;4;0;4;1.000;1287000;0
17363;86283;879;40;20;5;15;.750;2313000;0
17363;161128;957;50;24;4;20;.833;1940000;0
17364;168842;880;0;0;0;0;.00nan;0;0
17364;176765;880;87;40;3;37;.925;3551000;0
17364;70099;890;92;34;1;33;.971;3600000;0
17364;142583;890;0;0;0;0;.00nan;0;0
17365;4219;1415;0;0;0;0;.00nan;0;0
17365;76885;874;100;27;0;27;1.000;3600000;0
17365;80616;874;0;0;0;0;.00nan;0;0
17365;154414;1415;71;20;1;19;.950;3600000;0
17366;76885;874;70;16;1;15;.938;3600000;0
17366;80616;874;0;0;0;0;.00nan;0;0
17366;82245;945;0;0;0;0;.00nan;0;0
17366;146479;945;62;39;5;34;.872;3600000;0
17367;4219;1415;0;0;0;0;.00nan;0;0
17367;8101;897;0;0;0;0;.00nan;0;0
17367;78348;897;77;30;2;28;.933;3600000;0
17367;154414;1415;86;19;0;19;1.000;3600000;0
17368;20645;957;0;0;0;0;.00nan;0;0
17368;70099;890;0;0;0;0;.00nan;0;0
17368;142583;890;71;34;3;31;.912;3514000;0
17368;161128;957;81;28;1;27;.964;3600000;0
17369;164710;891;52;22;3;19;.864;3600000;0
17369;57426;879;0;0;0;0;.00nan;0;0
17369;86283;879;97;26;0;26;1.000;3600000;0
17369;151940;891;0;0;0;0;.00nan;0;0
17370;28833;3965;0;0;0;0;.00nan;0;0
17370;180177;3965;91;38;2;36;.947;3600000;0
17370;56306;978;0;0;0;0;.00nan;0;0
17370;157295;978;22;27;7;20;.741;3600000;0
17371;9858;966;0;0;0;0;.00nan;0;0
17371;196005;966;84;15;0;15;1.000;3600000;0
17371;146445;894;92;38;2;36;.947;3600000;0
17371;157416;894;0;0;0;0;.00nan;0;0
17372;168842;880;0;0;0;0;.00nan;0;0
17372;23251;994;0;0;0;0;.00nan;0;0
17372;176765;880;74;28;2;26;.929;3900000;0
17372;62530;994;79;38;2;36;.947;3900000;0
17373;28833;3965;81;31;2;29;.935;3900000;0
17373;180177;3965;0;0;0;0;.00nan;0;0
17373;56306;978;82;35;2;33;.943;3900000;0
17373;157295;978;0;0;0;0;.00nan;0;0
17374;8101;897;0;0;0;0;.00nan;0;0
17374;164710;891;61;31;3;28;.903;3582000;0
17374;78348;897;88;31;2;29;.935;3600000;0
17374;151940;891;0;0;0;0;.00nan;0;0
17375;20645;957;0;0;0;0;.00nan;0;0
17375;146445;894;63;32;4;28;.875;3600000;0
17375;157416;894;0;0;0;0;.00nan;0;0
17375;161128;957;83;13;0;13;1.000;3600000;0
17376;9858;966;0;0;0;0;.00nan;0;0
17376;196005;966;65;39;3;36;.923;3577000;0
17376;56306;978;0;0;0;0;.00nan;0;0
17376;157295;978;56;16;2;14;.875;3600000;0
17377;23251;994;0;0;0;0;.00nan;0;0
17377;57426;879;0;0;0;0;.00nan;0;0
17377;62530;994;67;28;2;26;.929;3600000;0
17377;86283;879;76;23;1;22;.957;3600000;0
17378;8101;897;0;0;0;0;.00nan;0;0
17378;70099;890;73;33;3;30;.909;3756000;0
17378;78348;897;80;29;2;27;.931;3756000;0
17378;142583;890;0;0;0;0;.00nan;0;0
17379;4219;1415;0;0;0;0;.00nan;0;0
17379;164710;891;61;34;4;30;.882;3600000;0
17379;151940;891;0;0;0;0;.00nan;0;0
17379;154414;1415;100;19;0;19;1.000;3600000;0
17380;28833;3965;0;0;0;0;.00nan;0;0
17380;180177;3965;90;48;2;46;.958;3567000;0
17380;76885;874;85;21;1;20;.952;3600000;0
17380;80616;874;0;0;0;0;.00nan;0;0
17381;168842;880;57;7;0;7;1.000;523000;0
17381;176765;880;12;23;7;16;.696;3030000;0
17381;82245;945;0;0;0;0;.00nan;0;0
17381;146479;945;70;45;5;40;.889;3600000;0
17382;9858;966;63;38;5;33;.868;3516000;0
17382;20645;957;0;0;0;0;.00nan;0;0
17382;196005;966;0;0;0;0;.00nan;0;0
17382;161128;957;68;28;3;25;.893;3600000;0
17383;8101;897;83;28;1;27;.964;2430000;0
17383;168842;880;0;0;0;0;.00nan;0;0
17383;176765;880;87;33;2;31;.939;3600000;0
17383;78348;897;23;9;4;5;.556;1170000;0
17384;28833;3965;84;38;3;35;.921;3600000;0
17384;180177;3965;0;0;0;0;.00nan;0;0
17384;146445;894;34;16;4;12;.750;3550000;0
17384;157416;894;0;0;0;0;.00nan;0;0
17385;164710;891;0;0;0;0;.00nan;0;0
17385;56306;978;77;26;1;25;.962;3600000;0
17385;151940;891;63;26;2;24;.923;3543000;0
17385;157295;978;0;0;0;0;.00nan;0;0
17386;168842;880;0;0;0;0;.00nan;0;0
17386;176765;880;8;30;8;22;.733;3600000;0
17386;76885;874;74;28;2;26;.929;3600000;0
17386;80616;874;0;0;0;0;.00nan;0;0
17387;23251;994;0;0;0;0;.00nan;0;0
17387;62530;994;68;29;3;26;.897;3600000;0
17387;82245;945;52;2;0;2;1.000;382000;0
17387;146479;945;12;20;6;14;.700;3218000;0
17388;8101;897;0;0;0;0;.00nan;0;0
17388;57426;879;0;0;0;0;.00nan;0;0
17388;78348;897;56;37;5;32;.865;3900000;0
17388;86283;879;56;33;5;28;.848;3900000;0
17389;4219;1415;0;0;0;0;.00nan;0;0
17389;70099;890;0;0;0;0;.00nan;0;0
17389;142583;890;82;40;3;37;.925;3600000;0
17389;154414;1415;64;21;2;19;.905;3600000;0
17390;23251;994;0;0;0;0;.00nan;0;0
17390;62530;994;75;27;3;24;.889;3900000;0
17390;146445;894;0;0;0;0;.00nan;0;0
17390;157416;894;69;31;3;28;.903;3890000;0
17391;20645;957;0;0;0;0;.00nan;0;0
17391;76885;874;100;31;0;31;1.000;3600000;0
17391;80616;874;0;0;0;0;.00nan;0;0
17391;161128;957;66;21;1;20;.952;3564000;0
17392;57426;879;0;0;0;0;.00nan;0;0
17392;70099;890;79;30;2;28;.933;3600000;0
17392;86283;879;79;36;3;33;.917;3544000;0
17392;142583;890;0;0;0;0;.00nan;0;0
17393;9858;966;0;0;0;0;.00nan;0;0
17393;164710;891;0;0;0;0;.00nan;0;0
17393;196005;966;79;29;1;28;.966;3570000;0
17393;151940;891;100;27;0;27;1.000;3600000;0
17394;28833;3965;0;0;0;0;.00nan;0;0
17394;180177;3965;48;37;5;32;.865;3600000;0
17394;82245;945;0;0;0;0;.00nan;0;0
17394;146479;945;72;28;2;26;.929;3600000;0
17395;4219;1415;0;0;0;0;.00nan;0;0
17395;168842;880;64;30;3;27;.900;3900000;0
17395;176765;880;0;0;0;0;.00nan;0;0
17395;154414;1415;72;34;3;31;.912;3900000;0
17396;8101;897;0;0;0;0;.00nan;0;0
17396;56306;978;0;0;0;0;.00nan;0;0
17396;78348;897;74;33;3;30;.909;3600000;0
17396;157295;978;85;37;2;35;.946;3600000;0
17397;20645;957;0;0;0;0;.00nan;0;0
17397;70099;890;87;29;1;28;.966;3600000;0
17397;142583;890;0;0;0;0;.00nan;0;0
17397;161128;957;56;33;4;29;.879;3600000;0
17398;4219;1415;0;0;0;0;.00nan;0;0
17398;146445;894;100;43;1;42;.977;3858000;0
17398;154414;1415;54;14;2;12;.857;3858000;0
17398;157416;894;0;0;0;0;.00nan;0;0
17399;8101;897;0;0;0;0;.00nan;0;0
17399;76885;874;72;20;2;18;.900;3600000;0
17399;78348;897;66;38;4;34;.895;3513000;0
17399;80616;874;0;0;0;0;.00nan;0;0
17400;9858;966;0;0;0;0;.00nan;0;0
17400;23251;994;0;0;0;0;.00nan;0;0
17400;196005;966;69;18;1;17;.944;3600000;0
17400;62530;994;51;28;4;24;.857;3600000;0
17401;20645;957;60;27;3;24;.889;3900000;0
17401;82245;945;86;44;3;41;.932;3900000;0
17401;146479;945;0;0;0;0;.00nan;0;0
17401;161128;957;0;0;0;0;.00nan;0;0
17402;56306;978;35;30;6;24;.800;2922000;0
17402;57426;879;0;0;0;0;.00nan;0;0
17402;86283;879;56;34;5;29;.853;3600000;0
17402;157295;978;22;13;4;9;.692;678000;0
17403;168842;880;0;0;0;0;.00nan;0;0
17403;28833;3965;68;26;3;23;.885;3600000;0
17403;176765;880;61;43;5;38;.884;3579000;0
17403;180177;3965;0;0;0;0;.00nan;0;0
17404;56306;978;0;0;0;0;.00nan;0;0
17404;76885;874;34;17;4;13;.765;3900000;0
17404;80616;874;0;0;0;0;.00nan;0;0
17404;157295;978;69;45;4;41;.911;3900000;0
17405;164710;891;0;0;0;0;.00nan;0;0
17405;82245;945;0;0;0;0;.00nan;0;0
17405;146479;945;48;51;7;44;.863;3600000;0
17405;151940;891;81;16;0;16;1.000;3600000;0
17406;57426;879;0;0;0;0;.00nan;0;0
17406;70099;890;0;0;0;0;.00nan;0;0
17406;86283;879;85;28;1;27;.964;3600000;0
17406;142583;890;49;24;4;20;.833;3600000;0
17407;4219;1415;62;16;1;15;.938;3600000;0
17407;23251;994;0;0;0;0;.00nan;0;0
17407;62530;994;39;34;6;28;.824;3600000;0
17407;154414;1415;0;0;0;0;.00nan;0;0
17408;20645;957;0;0;0;0;.00nan;0;0
17408;28833;3965;0;0;0;0;.00nan;0;0
17408;180177;3965;81;34;2;32;.941;3572000;0
17408;161128;957;93;32;1;31;.969;3600000;0
17409;9858;966;0;0;0;0;.00nan;0;0
17409;168842;880;0;0;0;0;.00nan;0;0
17409;176765;880;53;17;3;14;.824;3735000;0
17409;196005;966;85;33;2;31;.939;3735000;0
17410;164710;891;81;31;2;29;.935;3600000;0
17410;168842;880;19;22;6;16;.727;2550000;0
17410;176765;880;70;12;0;12;1.000;1050000;0
17410;151940;891;0;0;0;0;.00nan;0;0
17411;8101;897;59;21;3;18;.857;3526000;0
17411;78348;897;0;0;0;0;.00nan;0;0
17411;146445;894;96;27;1;26;.963;3600000;0
17411;157416;894;0;0;0;0;.00nan;0;0
17412;23251;994;0;0;0;0;.00nan;0;0
17412;62530;994;51;34;5;29;.853;3548000;0
17412;70099;890;64;34;3;31;.912;3600000;0
17412;142583;890;0;0;0;0;.00nan;0;0
17413;82245;945;0;0;0;0;.00nan;0;0
17413;146445;894;65;27;2;25;.926;3600000;0
17413;146479;945;77;40;3;37;.925;3561000;0
17413;157416;894;0;0;0;0;.00nan;0;0
17414;8101;897;0;0;0;0;.00nan;0;0
17414;20645;957;0;0;0;0;.00nan;0;0
17414;78348;897;63;28;3;25;.893;3600000;0
17414;161128;957;50;34;5;29;.853;3588000;0
17415;164710;891;0;0;0;0;.00nan;0;0
17415;76885;874;68;22;1;21;.955;3600000;0
17415;80616;874;0;0;0;0;.00nan;0;0
17415;151940;891;48;32;5;27;.844;3600000;0
17416;4219;1415;0;0;0;0;.00nan;0;0
17416;56306;978;69;32;3;29;.906;3600000;0
17416;154414;1415;87;17;0;17;1.000;3600000;0
17416;157295;978;0;0;0;0;.00nan;0;0
17417;9858;966;67;16;1;15;.938;3600000;0
17417;28833;3965;55;32;4;28;.875;3600000;0
17417;196005;966;0;0;0;0;.00nan;0;0
17417;180177;3965;0;0;0;0;.00nan;0;0
17418;168842;880;0;0;0;0;.00nan;0;0
17418;176765;880;71;31;3;28;.903;3600000;0
17418;57426;879;0;0;0;0;.00nan;0;0
17418;86283;879;49;25;4;21;.840;3600000;0
17419;8101;897;0;0;0;0;.00nan;0;0
17419;23251;994;0;0;0;0;.00nan;0;0
17419;62530;994;48;42;6;36;.857;3600000;0
17419;78348;897;58;22;3;19;.864;3600000;0
17420;168842;880;0;0;0;0;.00nan;0;0
17420;176765;880;89;28;1;27;.964;3600000;0
17420;56306;978;0;0;0;0;.00nan;0;0
17420;157295;978;57;38;4;34;.895;3600000;0
17421;9858;966;80;34;2;32;.941;3600000;0
17421;196005;966;0;0;0;0;.00nan;0;0
17421;76885;874;88;26;1;25;.962;3600000;0
17421;80616;874;0;0;0;0;.00nan;0;0
17422;57426;879;79;29;2;27;.931;3600000;0
17422;82245;945;0;0;0;0;.00nan;0;0
17422;86283;879;0;0;0;0;.00nan;0;0
17422;146479;945;32;38;7;31;.816;3600000;0
17423;70099;890;74;22;1;21;.955;3600000;0
17423;142583;890;0;0;0;0;.00nan;0;0
17423;146445;894;0;0;0;0;.00nan;0;0
17423;157416;894;45;34;5;29;.853;3600000;0
17424;164710;891;33;21;5;16;.762;3600000;0
17424;28833;3965;43;4;1;3;.750;426000;0
17424;180177;3965;27;27;6;21;.778;3174000;0
17424;151940;891;0;0;0;0;.00nan;0;0
17425;4219;1415;0;0;0;0;.00nan;0;0
17425;20645;957;73;32;2;30;.938;3900000;0
17425;154414;1415;73;26;2;24;.923;3900000;0
17425;161128;957;0;0;0;0;.00nan;0;0
17426;76885;874;70;15;1;14;.933;3600000;0
17426;80616;874;0;0;0;0;.00nan;0;0
17426;146445;894;76;36;3;33;.917;3516000;0
17426;157416;894;0;0;0;0;.00nan;0;0
17427;8101;897;0;0;0;0;.00nan;0;0
17427;28833;3965;79;30;2;28;.933;3600000;0
17427;180177;3965;0;0;0;0;.00nan;0;0
17427;78348;897;51;47;7;40;.851;3600000;0
17428;9858;966;0;0;0;0;.00nan;0;0
17428;196005;966;82;26;1;25;.962;3600000;0
17428;70099;890;0;0;0;0;.00nan;0;0
17428;142583;890;63;31;4;27;.871;3600000;0
17429;56306;978;90;26;1;25;.962;3600000;0
17429;82245;945;90;42;3;39;.929;3532000;0
17429;146479;945;0;0;0;0;.00nan;0;0
17429;157295;978;0;0;0;0;.00nan;0;0
17430;20645;957;0;0;0;0;.00nan;0;0
17430;23251;994;0;0;0;0;.00nan;0;0
17430;62530;994;90;41;3;38;.927;3633000;0
17430;161128;957;66;40;4;36;.900;3633000;0
17431;4219;1415;0;0;0;0;.00nan;0;0
17431;57426;879;0;0;0;0;.00nan;0;0
17431;86283;879;81;29;1;28;.966;3900000;0
17431;154414;1415;96;28;1;27;.964;3900000;0
17432;23251;994;0;0;0;0;.00nan;0;0
17432;62530;994;58;27;3;24;.889;3516000;0
17432;76885;874;97;28;1;27;.964;3600000;0
17432;80616;874;0;0;0;0;.00nan;0;0
17433;8101;897;0;0;0;0;.00nan;0;0
17433;9858;966;0;0;0;0;.00nan;0;0
17433;196005;966;76;25;1;24;.960;3600000;0
17433;78348;897;63;28;2;26;.929;3563000;0
17434;164710;891;53;23;3;20;.870;3600000;0
17434;20645;957;65;9;0;9;1.000;1258000;0
17434;151940;891;0;0;0;0;.00nan;0;0
17434;161128;957;39;33;6;27;.818;2342000;0
17435;56306;978;0;0;0;0;.00nan;0;0
17435;70099;890;43;27;4;23;.852;3578000;0
17435;142583;890;0;0;0;0;.00nan;0;0
17435;157295;978;80;42;3;39;.929;3600000;0
17436;4219;1415;0;0;0;0;.00nan;0;0
17436;82245;945;58;46;6;40;.870;3600000;0
17436;146479;945;0;0;0;0;.00nan;0;0
17436;154414;1415;83;17;1;16;.941;3600000;0
17437;168842;880;65;24;2;22;.917;3548000;0
17437;176765;880;0;0;0;0;.00nan;0;0
17437;146445;894;87;30;1;29;.967;3600000;0
17437;157416;894;0;0;0;0;.00nan;0;0
17438;168842;880;0;0;0;0;.00nan;0;0
17438;176765;880;62;19;2;17;.895;3600000;0
17438;146445;894;55;5;0;5;1.000;1149000;0
17438;157416;894;44;37;6;31;.838;2451000;0
17439;20645;957;0;0;0;0;.00nan;0;0
17439;56306;978;0;0;0;0;.00nan;0;0
17439;157295;978;81;41;3;38;.927;3542000;0
17439;161128;957;75;22;1;21;.955;3600000;0
17440;23251;994;0;0;0;0;.00nan;0;0
17440;28833;3965;0;0;0;0;.00nan;0;0
17440;180177;3965;73;27;2;25;.926;3596000;0
17440;62530;994;91;20;0;20;1.000;3600000;0
17441;70099;890;53;25;4;21;.840;3550000;0
17441;82245;945;80;39;3;36;.923;3600000;0
17441;142583;890;0;0;0;0;.00nan;0;0
17441;146479;945;0;0;0;0;.00nan;0;0
17442;57426;879;54;29;4;25;.862;3520000;0
17442;76885;874;83;31;2;29;.935;3600000;0
17442;80616;874;0;0;0;0;.00nan;0;0
17442;86283;879;0;0;0;0;.00nan;0;0
17443;8101;897;0;0;0;0;.00nan;0;0
17443;164710;891;0;0;0;0;.00nan;0;0
17443;78348;897;70;39;4;35;.897;3577000;0
17443;151940;891;77;32;3;29;.906;3600000;0
17444;4219;1415;0;0;0;0;.00nan;0;0
17444;9858;966;0;0;0;0;.00nan;0;0
17444;196005;966;85;37;2;35;.946;3669000;0
17444;154414;1415;84;24;1;23;.958;3669000;0
17445;4219;1415;51;21;3;18;.857;3585000;0
17445;9858;966;92;32;1;31;.969;3600000;0
17445;196005;966;0;0;0;0;.00nan;0;0
17445;154414;1415;0;0;0;0;.00nan;0;0
17446;8101;897;0;0;0;0;.00nan;0;0
17446;28833;3965;77;40;4;36;.900;3900000;0
17446;180177;3965;0;0;0;0;.00nan;0;0
17446;78348;897;57;27;4;23;.852;3900000;0
17447;57426;879;0;0;0;0;.00nan;0;0
17447;86283;879;98;25;0;25;1.000;3600000;0
17447;146445;894;63;39;4;35;.897;3600000;0
17447;157416;894;0;0;0;0;.00nan;0;0
17448;164710;891;0;0;0;0;.00nan;0;0
17448;56306;978;0;0;0;0;.00nan;0;0
17448;151940;891;38;12;3;9;.750;3900000;0
17448;157295;978;88;44;3;41;.932;3900000;0
17449;76885;874;61;32;4;28;.875;3534000;0
17449;80616;874;0;0;0;0;.00nan;0;0
17449;82245;945;73;29;2;27;.931;3600000;0
17449;146479;945;0;0;0;0;.00nan;0;0
17450;20645;957;98;42;2;40;.952;3600000;0
17450;23251;994;0;0;0;0;.00nan;0;0
17450;62530;994;82;42;3;39;.929;3547000;0
17450;161128;957;0;0;0;0;.00nan;0;0
17451;168842;880;0;0;0;0;.00nan;0;0
17451;176765;880;65;33;3;30;.909;3600000;0
17451;70099;890;0;0;0;0;.00nan;0;0
17451;142583;890;67;51;6;45;.882;3600000;0
17452;164710;891;0;0;0;0;.00nan;0;0
17452;146445;894;96;36;1;35;.972;3600000;0
17452;151940;891;74;34;3;31;.912;3560000;0
17452;157416;894;0;0;0;0;.00nan;0;0
17453;4219;1415;0;0;0;0;.00nan;0;0
17453;76885;874;69;30;3;27;.900;3600000;0
17453;80616;874;0;0;0;0;.00nan;0;0
17453;154414;1415;48;23;4;19;.826;3559000;0
17454;8101;897;0;0;0;0;.00nan;0;0
17454;23251;994;87;45;3;42;.933;3566000;0
17454;62530;994;0;0;0;0;.00nan;0;0
17454;78348;897;83;28;2;26;.929;3600000;0
17455;20645;957;78;28;3;25;.893;3600000;0
17455;56306;978;0;0;0;0;.00nan;0;0
17455;157295;978;67;39;4;35;.897;3579000;0
17455;161128;957;0;0;0;0;.00nan;0;0
17456;57426;879;0;0;0;0;.00nan;0;0
17456;70099;890;87;40;3;37;.925;3596000;0
17456;86283;879;82;24;1;23;.958;3600000;0
17456;142583;890;0;0;0;0;.00nan;0;0
17457;168842;880;0;0;0;0;.00nan;0;0
17457;28833;3965;51;37;6;31;.838;3239000;0
17457;176765;880;68;27;2;25;.926;3600000;0
17457;180177;3965;55;3;0;3;1.000;361000;0
17458;9858;966;0;0;0;0;.00nan;0;0
17458;196005;966;42;30;5;25;.833;3600000;0
17458;82245;945;89;20;0;20;1.000;3600000;0
17458;146479;945;0;0;0;0;.00nan;0;0
17459;56306;978;0;0;0;0;.00nan;0;0
17459;70099;890;0;0;0;0;.00nan;0;0
17459;142583;890;59;23;3;20;.870;3600000;0
17459;157295;978;59;36;4;32;.889;3571000;0
17460;5354;897;85;38;3;35;.921;3600000;0
17460;8101;897;0;0;0;0;.00nan;0;0
17460;76885;874;92;17;0;17;1.000;3600000;0
17460;80616;874;0;0;0;0;.00nan;0;0
17461;28833;3965;0;0;0;0;.00nan;0;0
17461;180177;3965;37;23;4;19;.826;3600000;0
17461;82245;945;99;37;1;36;.973;3600000;0
17461;146479;945;0;0;0;0;.00nan;0;0
17462;23251;994;0;0;0;0;.00nan;0;0
17462;57426;879;91;17;0;17;1.000;3600000;0
17462;62530;994;98;49;1;48;.980;3571000;0
17462;86283;879;0;0;0;0;.00nan;0;0
17463;164710;891;0;0;0;0;.00nan;0;0
17463;20645;957;63;23;2;21;.913;3579000;0
17463;151940;891;88;24;1;23;.958;3600000;0
17463;161128;957;0;0;0;0;.00nan;0;0
17464;4219;1415;0;0;0;0;.00nan;0;0
17464;146445;894;46;35;5;30;.857;3890000;0
17464;154414;1415;22;21;5;16;.762;3900000;0
17464;157416;894;0;0;0;0;.00nan;0;0
17465;9858;966;0;0;0;0;.00nan;0;0
17465;168842;880;99;23;0;23;1.000;3600000;0
17465;176765;880;0;0;0;0;.00nan;0;0
17465;196005;966;80;45;4;41;.911;3600000;0
17466;23251;994;91;28;1;27;.964;3600000;0
17466;56306;978;0;0;0;0;.00nan;0;0
17466;62530;994;0;0;0;0;.00nan;0;0
17466;157295;978;75;32;2;30;.938;3544000;0
17467;164710;891;0;0;0;0;.00nan;0;0
17467;57426;879;0;0;0;0;.00nan;0;0
17467;86283;879;80;29;2;27;.931;3900000;0
17467;151940;891;75;30;2;28;.933;3900000;0
17468;9858;966;64;30;3;27;.900;3900000;0
17468;196005;966;0;0;0;0;.00nan;0;0
17468;70099;890;64;30;3;27;.900;3900000;0
17468;142583;890;0;0;0;0;.00nan;0;0
17469;28833;3965;58;28;3;25;.893;3566000;0
17469;180177;3965;0;0;0;0;.00nan;0;0
17469;146445;894;74;26;2;24;.923;3600000;0
17469;157416;894;0;0;0;0;.00nan;0;0
17470;82245;945;83;40;3;37;.925;3660000;0
17470;85749;1415;0;0;0;0;.00nan;0;0
17470;146479;945;0;0;0;0;.00nan;0;0
17470;154414;1415;50;13;2;11;.846;3660000;0
17471;56306;978;0;0;0;0;.00nan;0;0
17471;57426;879;0;0;0;0;.00nan;0;0
17471;86283;879;45;28;5;23;.821;3566000;0
17471;157295;978;64;34;4;30;.882;3600000;0
17472;23251;994;0;0;0;0;.00nan;0;0
17472;62530;994;49;42;6;36;.857;3600000;0
17472;85749;1415;54;13;2;11;.846;3600000;0
17472;154414;1415;0;0;0;0;.00nan;0;0
17473;8101;897;0;0;0;0;.00nan;0;0
17473;70099;890;0;0;0;0;.00nan;0;0
17473;78348;897;76;31;2;29;.935;3900000;0
17473;142583;890;83;38;2;36;.947;3900000;0
17474;20645;957;0;0;0;0;.00nan;0;0
17474;28833;3965;0;0;0;0;.00nan;0;0
17474;180177;3965;81;37;3;34;.919;3572000;0
17474;161128;957;61;15;1;14;.933;3600000;0
17475;164710;891;0;0;0;0;.00nan;0;0
17475;82245;945;55;30;4;26;.867;3540000;0
17475;146479;945;0;0;0;0;.00nan;0;0
17475;151940;891;77;30;2;28;.933;3600000;0
17476;9858;966;0;0;0;0;.00nan;0;0
17476;196005;966;69;37;4;33;.892;3600000;0
17476;76885;874;76;25;1;24;.960;3600000;0
17476;80616;874;0;0;0;0;.00nan;0;0
17477;168842;880;54;23;3;20;.870;3600000;0
17477;176765;880;0;0;0;0;.00nan;0;0
17477;146445;894;0;0;0;0;.00nan;0;0
17477;157416;894;84;59;5;54;.915;3600000;0
17478;8101;897;0;0;0;0;.00nan;0;0
17478;78348;897;74;33;3;30;.909;3600000;0
17478;146445;894;63;32;4;28;.875;3600000;0
17478;157416;894;0;0;0;0;.00nan;0;0
17479;56306;978;60;35;4;31;.886;3265000;0
17479;76885;874;50;26;4;22;.846;3600000;0
17479;80616;874;0;0;0;0;.00nan;0;0
17479;157295;978;22;5;3;2;.400;335000;0
17480;20645;957;68;18;1;17;.944;3600000;0
17480;82245;945;47;35;6;29;.829;2859000;0
17480;146479;945;59;7;0;7;1.000;741000;0
17480;161128;957;0;0;0;0;.00nan;0;0
17481;28833;3965;98;35;2;33;.943;3900000;0
17481;180177;3965;0;0;0;0;.00nan;0;0
17481;57426;879;60;23;2;21;.913;3900000;0
17481;86283;879;0;0;0;0;.00nan;0;0
17482;23251;994;0;0;0;0;.00nan;0;0
17482;62530;994;73;32;3;29;.906;3600000;0
17482;70099;890;0;0;0;0;.00nan;0;0
17482;142583;890;61;38;4;34;.895;3600000;0
17483;168842;880;72;44;4;40;.909;3600000;0
17483;176765;880;0;0;0;0;.00nan;0;0
17483;85749;1415;39;24;5;19;.792;3592000;0
17483;154414;1415;0;0;0;0;.00nan;0;0
17484;9858;966;0;0;0;0;.00nan;0;0
17484;164710;891;0;0;0;0;.00nan;0;0
17484;196005;966;100;36;0;36;1.000;3900000;0
17484;151940;891;80;21;0;21;1.000;3900000;0
17485;28833;3965;0;0;0;0;.00nan;0;0
17485;180177;3965;84;41;3;38;.927;3600000;0
17485;57426;879;0;0;0;0;.00nan;0;0
17485;86283;879;81;15;0;15;1.000;3600000;0
17486;9858;966;0;0;0;0;.00nan;0;0
17486;28833;3965;77;28;2;26;.929;3600000;0
17486;196005;966;50;20;3;17;.850;3600000;0
17486;180177;3965;0;0;0;0;.00nan;0;0
17487;56306;978;88;52;5;47;.904;3567000;0
17487;85749;1415;44;21;4;17;.810;3600000;0
17487;154414;1415;0;0;0;0;.00nan;0;0
17487;157295;978;0;0;0;0;.00nan;0;0
17488;76885;874;46;23;4;19;.826;3570000;0
17488;80616;874;0;0;0;0;.00nan;0;0
17488;146445;894;100;61;2;59;.967;3600000;0
17488;157416;894;0;0;0;0;.00nan;0;0
17489;8101;897;0;0;0;0;.00nan;0;0
17489;57426;879;0;0;0;0;.00nan;0;0
17489;78348;897;97;45;1;44;.978;3900000;0
17489;86283;879;79;26;1;25;.962;3900000;0
17490;168842;880;65;29;3;26;.897;3600000;0
17490;176765;880;0;0;0;0;.00nan;0;0
17490;82245;945;72;27;2;25;.926;3600000;0
17490;146479;945;0;0;0;0;.00nan;0;0
17491;164710;891;0;0;0;0;.00nan;0;0
17491;23251;994;0;0;0;0;.00nan;0;0
17491;62530;994;87;41;2;39;.951;3900000;0
17491;151940;891;75;22;2;20;.909;3900000;0
17492;9858;966;0;0;0;0;.00nan;0;0
17492;20645;957;0;0;0;0;.00nan;0;0
17492;196005;966;78;36;3;33;.917;3600000;0
17492;161128;957;41;28;4;24;.857;3580000;0
17493;70099;890;0;0;0;0;.00nan;0;0
17493;142583;890;62;21;2;19;.905;3600000;0
17493;146445;894;0;0;0;0;.00nan;0;0
17493;157416;894;49;39;6;33;.846;3600000;0
17494;23251;994;46;6;1;5;.833;351000;0
17494;62530;994;66;37;4;33;.892;3249000;0
17494;76885;874;63;22;3;19;.864;3600000;0
17494;80616;874;0;0;0;0;.00nan;0;0
17495;57426;879;0;0;0;0;.00nan;0;0
17495;82245;945;85;43;3;40;.930;3520000;0
17495;86283;879;83;24;1;23;.958;3600000;0
17495;146479;945;0;0;0;0;.00nan;0;0
17496;164710;891;46;18;3;15;.833;3600000;0
17496;28833;3965;0;0;0;0;.00nan;0;0
17496;180177;3965;60;36;4;32;.889;3550000;0
17496;151940;891;0;0;0;0;.00nan;0;0
17497;168842;880;75;20;1;19;.950;3600000;0
17497;176765;880;0;0;0;0;.00nan;0;0
17497;56306;978;0;0;0;0;.00nan;0;0
17497;157295;978;72;33;3;30;.909;3575000;0
17498;8101;897;0;0;0;0;.00nan;0;0
17498;78348;897;72;35;3;32;.914;3600000;0
17498;85749;1415;78;13;0;13;1.000;3600000;0
17498;154414;1415;0;0;0;0;.00nan;0;0
17499;164710;891;0;0;0;0;.00nan;0;0
17499;76885;874;97;31;2;29;.935;3544000;0
17499;80616;874;0;0;0;0;.00nan;0;0
17499;151940;891;90;26;1;25;.962;3600000;0
17500;23251;994;0;0;0;0;.00nan;0;0
17500;62530;994;88;27;2;25;.926;3547000;0
17500;146445;894;83;26;1;25;.962;3600000;0
17500;157416;894;0;0;0;0;.00nan;0;0
17501;28833;3965;74;28;2;26;.929;3600000;0
17501;180177;3965;0;0;0;0;.00nan;0;0
17501;56306;978;53;29;4;25;.862;3557000;0
17501;157295;978;0;0;0;0;.00nan;0;0
17502;168842;880;25;30;7;23;.767;3600000;0
17502;176765;880;0;0;0;0;.00nan;0;0
17502;57426;879;75;20;1;19;.950;3600000;0
17502;86283;879;0;0;0;0;.00nan;0;0
17503;70099;890;41;30;5;25;.833;3600000;0
17503;82245;945;0;0;0;0;.00nan;0;0
17503;142583;890;0;0;0;0;.00nan;0;0
17503;146479;945;35;38;7;31;.816;3553000;0
17504;20645;957;59;13;1;12;.923;1237000;0
17504;85749;1415;57;21;2;19;.905;3600000;0
17504;154414;1415;0;0;0;0;.00nan;0;0
17504;161128;957;24;23;6;17;.739;2363000;0
17505;8101;897;0;0;0;0;.00nan;0;0
17505;20645;957;85;28;1;27;.964;3600000;0
17505;78348;897;54;23;3;20;.870;3560000;0
17505;161128;957;0;0;0;0;.00nan;0;0
17506;82245;945;56;24;3;21;.875;3579000;0
17506;146445;894;100;37;1;36;.973;3600000;0
17506;146479;945;0;0;0;0;.00nan;0;0
17506;157416;894;0;0;0;0;.00nan;0;0
17507;57426;879;61;28;3;25;.893;3900000;0
17507;85749;1415;48;23;3;20;.870;3900000;0
17507;86283;879;0;0;0;0;.00nan;0;0
17507;154414;1415;0;0;0;0;.00nan;0;0
17508;164710;891;0;0;0;0;.00nan;0;0
17508;70099;890;0;0;0;0;.00nan;0;0
17508;142583;890;65;19;1;18;.947;3600000;0
17508;151940;891;51;37;5;32;.865;3600000;0
17509;23251;994;0;0;0;0;.00nan;0;0
17509;28833;3965;0;0;0;0;.00nan;0;0
17509;180177;3965;92;36;1;35;.972;3600000;0
17509;62530;994;63;28;3;25;.893;3528000;0
17510;9858;966;0;0;0;0;.00nan;0;0
17510;196005;966;42;33;5;28;.848;3600000;0
17510;56306;978;0;0;0;0;.00nan;0;0
17510;157295;978;73;32;2;30;.938;3600000;0
17511;168842;880;86;37;2;35;.946;3600000;0
17511;176765;880;0;0;0;0;.00nan;0;0
17511;76885;874;58;28;3;25;.893;3600000;0
17511;80616;874;0;0;0;0;.00nan;0;0
17512;9858;966;0;0;0;0;.00nan;0;0
17512;196005;966;87;33;2;31;.939;3558000;0
17512;146445;894;0;0;0;0;.00nan;0;0
17512;157416;894;89;20;0;20;1.000;3600000;0
17513;8101;897;0;0;0;0;.00nan;0;0
17513;56306;978;72;33;3;30;.909;3600000;0
17513;78348;897;48;28;4;24;.857;3598000;0
17513;157295;978;0;0;0;0;.00nan;0;0
17514;28833;3965;80;45;3;42;.933;3600000;0
17514;180177;3965;0;0;0;0;.00nan;0;0
17514;76885;874;96;20;0;20;1.000;3600000;0
17514;80616;874;0;0;0;0;.00nan;0;0
17515;23251;994;0;0;0;0;.00nan;0;0
17515;62530;994;76;19;1;18;.947;3600000;0
17515;82245;945;0;0;0;0;.00nan;0;0
17515;146479;945;77;39;3;36;.923;3600000;0
17516;20645;957;0;0;0;0;.00nan;0;0
17516;57426;879;75;28;2;26;.929;3577000;0
17516;86283;879;0;0;0;0;.00nan;0;0
17516;161128;957;84;21;1;20;.952;3600000;0
17517;164710;891;75;18;2;16;.889;3600000;0
17517;168842;880;31;29;6;23;.793;2649000;0
17517;176765;880;47;6;1;5;.833;951000;0
17517;151940;891;0;0;0;0;.00nan;0;0
17518;70099;890;0;0;0;0;.00nan;0;0
17518;85749;1415;35;32;6;26;.813;3600000;0
17518;142583;890;83;37;2;35;.946;3600000;0
17518;154414;1415;0;0;0;0;.00nan;0;0
17519;8101;897;0;0;0;0;.00nan;0;0
17519;9858;966;100;31;1;30;.968;3600000;0
17519;196005;966;0;0;0;0;.00nan;0;0
17519;78348;897;35;40;7;33;.825;3600000;0
17520;168842;880;74;30;2;28;.933;3600000;0
17520;23251;994;0;0;0;0;.00nan;0;0
17520;176765;880;0;0;0;0;.00nan;0;0
17520;62530;994;68;32;3;29;.906;3573000;0
17521;8101;897;69;28;3;25;.893;3568000;0
17521;164710;891;0;0;0;0;.00nan;0;0
17521;78348;897;0;0;0;0;.00nan;0;0
17521;151940;891;81;26;1;25;.962;3600000;0
17522;20645;957;69;29;2;27;.931;3669000;0
17522;146445;894;0;0;0;0;.00nan;0;0
17522;157416;894;92;48;3;45;.938;3669000;0
17522;161128;957;0;0;0;0;.00nan;0;0
17523;56306;978;0;0;0;0;.00nan;0;0
17523;82245;945;96;37;1;36;.973;3600000;0
17523;146479;945;0;0;0;0;.00nan;0;0
17523;157295;978;75;27;2;25;.926;3545000;0
17524;9858;966;0;0;0;0;.00nan;0;0
17524;196005;966;72;36;3;33;.917;3600000;0
17524;57426;879;0;0;0;0;.00nan;0;0
17524;86283;879;86;14;0;14;1.000;3600000;0
17525;70099;890;65;31;3;28;.903;3900000;0
17525;76885;874;56;29;3;26;.897;3900000;0
17525;80616;874;0;0;0;0;.00nan;0;0
17525;142583;890;0;0;0;0;.00nan;0;0
17526;28833;3965;0;0;0;0;.00nan;0;0
17526;180177;3965;77;42;4;38;.905;3600000;0
17526;85749;1415;82;17;0;17;1.000;3600000;0
17526;154414;1415;0;0;0;0;.00nan;0;0
17527;56306;978;0;0;0;0;.00nan;0;0
17527;146445;894;80;33;3;30;.909;3600000;0
17527;157295;978;94;19;0;19;1.000;3600000;0
17527;157416;894;0;0;0;0;.00nan;0;0
17528;57426;879;0;0;0;0;.00nan;0;0
17528;76885;874;81;24;1;23;.958;3600000;0
17528;80616;874;0;0;0;0;.00nan;0;0
17528;86283;879;34;30;5;25;.833;3600000;0
17529;8101;897;0;0;0;0;.00nan;0;0
17529;78348;897;83;29;1;28;.966;3600000;0
17529;82245;945;0;0;0;0;.00nan;0;0
17529;146479;945;71;27;3;24;.889;3521000;0
17530;164710;891;0;0;0;0;.00nan;0;0
17530;85749;1415;74;20;1;19;.950;3600000;0
17530;151940;891;43;37;6;31;.838;3600000;0
17530;154414;1415;0;0;0;0;.00nan;0;0
17531;28833;3965;75;45;4;41;.911;3600000;0
17531;180177;3965;0;0;0;0;.00nan;0;0
17531;70099;890;0;0;0;0;.00nan;0;0
17531;142583;890;59;17;1;16;.941;3600000;0
17532;9858;966;0;0;0;0;.00nan;0;0
17532;23251;994;0;0;0;0;.00nan;0;0
17532;196005;966;72;22;1;21;.955;3600000;0
17532;62530;994;76;29;2;27;.931;3600000;0
17533;168842;880;58;16;1;15;.938;3600000;0
17533;20645;957;0;0;0;0;.00nan;0;0
17533;176765;880;0;0;0;0;.00nan;0;0
17533;161128;957;40;31;5;26;.839;3600000;0
17535;4219;1415;0;0;0;0;.00nan;0;0
17535;56306;978;0;0;0;0;.00nan;0;0
17535;154414;1415;72;16;1;15;.938;3600000;0
17535;157295;978;67;32;3;29;.906;3594000;0
17537;168842;880;0;0;0;0;.00nan;0;0
17537;176765;880;50;38;5;33;.868;3600000;0
17537;70099;890;0;0;0;0;.00nan;0;0
17537;142583;890;73;32;2;30;.938;3600000;0
17539;8519;879;100;31;0;31;1.000;3600000;0
17539;201288;957;0;0;0;0;.00nan;0;0
17539;146762;879;0;0;0;0;.00nan;0;0
17539;161128;957;92;42;3;39;.929;3600000;0
17541;9858;966;0;0;0;0;.00nan;0;0
17541;28833;3965;0;0;0;0;.00nan;0;0
17541;180177;3965;100;37;1;36;.973;3783000;0
17541;83678;966;55;18;2;16;.889;3783000;0
17543;23251;994;0;0;0;0;.00nan;0;0
17543;62530;994;62;28;3;25;.893;3600000;0
17543;76885;874;56;20;2;18;.900;3600000;0
17543;80616;874;0;0;0;0;.00nan;0;0
17545;8101;897;0;0;0;0;.00nan;0;0
17545;164710;891;0;0;0;0;.00nan;0;0
17545;78348;897;39;35;6;29;.829;3573000;0
17545;151940;891;49;25;4;21;.840;3600000;0
17547;82245;945;0;0;0;0;.00nan;0;0
17547;146445;894;0;0;0;0;.00nan;0;0
17547;146479;945;85;50;4;46;.920;3600000;0
17547;157416;894;98;25;0;25;1.000;3600000;0
17549;23251;994;0;0;0;0;.00nan;0;0
17549;201288;957;0;0;0;0;.00nan;0;0
17549;62530;994;97;43;1;42;.977;3900000;0
17549;161128;957;75;20;1;19;.950;3900000;0
17551;28833;3965;0;0;0;0;.00nan;0;0
17551;180177;3965;65;23;2;21;.913;3600000;0
17551;82245;945;0;0;0;0;.00nan;0;0
17551;146479;945;56;26;3;23;.885;3580000;0
17553;164710;891;0;0;0;0;.00nan;0;0
17553;146445;894;40;9;2;7;.778;696000;0
17553;151940;891;75;27;2;25;.926;3600000;0
17553;157416;894;35;32;6;26;.813;2904000;0
17555;4219;1415;0;0;0;0;.00nan;0;0
17555;76885;874;61;39;5;34;.872;3600000;0
17555;80616;874;0;0;0;0;.00nan;0;0
17555;154414;1415;68;23;2;21;.913;3600000;0
17557;8101;897;0;0;0;0;.00nan;0;0
17557;70099;890;0;0;0;0;.00nan;0;0
17557;78348;897;70;40;3;37;.925;3900000;0
17557;142583;890;78;30;3;27;.900;3900000;0
17559;56306;978;0;0;0;0;.00nan;0;0
17559;86283;879;72;28;2;26;.929;3581000;0
17559;146762;879;0;0;0;0;.00nan;0;0
17559;157295;978;81;26;1;25;.962;3600000;0
17561;9858;966;41;33;5;28;.848;3563000;0
17561;168842;880;0;0;0;0;.00nan;0;0
17561;176765;880;76;36;3;33;.917;3600000;0
17561;83678;966;0;0;0;0;.00nan;0;0
17563;9858;966;0;0;0;0;.00nan;0;0
17563;70099;890;60;24;2;22;.917;3900000;0
17563;83678;966;98;55;2;53;.964;3900000;0
17563;142583;890;0;0;0;0;.00nan;0;0
17565;28833;3965;36;27;5;22;.815;3563000;0
17565;180177;3965;0;0;0;0;.00nan;0;0
17565;82245;945;61;35;4;31;.886;3600000;0
17565;146479;945;0;0;0;0;.00nan;0;0
17567;164710;891;59;18;2;16;.889;3600000;0
17567;146445;894;34;17;4;13;.765;3513000;0
17567;151940;891;0;0;0;0;.00nan;0;0
17567;157416;894;0;0;0;0;.00nan;0;0
17569;23251;994;48;32;4;28;.875;3600000;0
17569;57426;879;0;0;0;0;.00nan;0;0
17569;62530;994;0;0;0;0;.00nan;0;0
17569;86283;879;74;8;0;8;1.000;3600000;0
17571;8101;897;56;22;3;19;.864;3600000;0
17571;168842;880;63;39;4;35;.897;3582000;0
17571;176765;880;0;0;0;0;.00nan;0;0
17571;78348;897;0;0;0;0;.00nan;0;0
17573;4219;1415;40;24;4;20;.833;3600000;0
17573;76885;874;0;0;0;0;.00nan;0;0
17573;80616;874;56;30;5;25;.833;3579000;0
17573;154414;1415;0;0;0;0;.00nan;0;0
17575;201288;957;49;36;5;31;.861;3600000;0
17575;56306;978;82;28;1;27;.964;3600000;0
17575;157295;978;0;0;0;0;.00nan;0;0
17575;161128;957;0;0;0;0;.00nan;0;0
17577;9858;966;0;0;0;0;.00nan;0;0
17577;82245;945;0;0;0;0;.00nan;0;0
17577;83678;966;69;26;2;24;.923;3600000;0
17577;146479;945;59;45;5;40;.889;3600000;0
17579;168842;880;0;0;0;0;.00nan;0;0
17579;176765;880;39;25;5;20;.800;3600000;0
17579;146445;894;0;0;0;0;.00nan;0;0
17579;157416;894;87;35;2;33;.943;3600000;0
17581;28833;3965;52;34;4;30;.882;3600000;0
17581;180177;3965;0;0;0;0;.00nan;0;0
17581;76885;874;96;19;0;19;1.000;3600000;0
17581;80616;874;0;0;0;0;.00nan;0;0
17583;8101;897;0;0;0;0;.00nan;0;0
17583;201288;957;0;0;0;0;.00nan;0;0
17583;78348;897;100;48;2;46;.958;3900000;0
17583;161128;957;64;26;2;24;.923;3900000;0
17585;164710;891;0;0;0;0;.00nan;0;0
17585;56306;978;90;42;2;40;.952;3556000;0
17585;151940;891;93;23;0;23;1.000;3600000;0
17585;157295;978;0;0;0;0;.00nan;0;0
17587;4219;1415;0;0;0;0;.00nan;0;0
17587;23251;994;0;0;0;0;.00nan;0;0
17587;62530;994;74;50;5;45;.900;3600000;0
17587;154414;1415;82;16;0;16;1.000;3600000;0
17589;57426;879;0;0;0;0;.00nan;0;0
17589;70099;890;0;0;0;0;.00nan;0;0
17589;86283;879;54;20;3;17;.850;3579000;0
17589;142583;890;72;30;2;28;.933;3600000;0
17591;201288;957;54;20;3;17;.850;3900000;0
17591;82245;945;91;44;3;41;.932;3900000;0
17591;146479;945;0;0;0;0;.00nan;0;0
17591;161128;957;0;0;0;0;.00nan;0;0
17593;164710;891;0;0;0;0;.00nan;0;0
17593;168842;880;77;26;1;25;.962;3600000;0
17593;176765;880;0;0;0;0;.00nan;0;0
17593;151940;891;51;38;5;33;.868;3600000;0
17595;8101;897;48;24;3;21;.875;3544000;0
17595;56306;978;0;0;0;0;.00nan;0;0
17595;78348;897;0;0;0;0;.00nan;0;0
17595;157295;978;83;38;2;36;.947;3600000;0
17597;9858;966;77;31;2;29;.935;3572000;0
17597;70099;890;100;43;1;42;.977;3600000;0
17597;83678;966;0;0;0;0;.00nan;0;0
17597;142583;890;0;0;0;0;.00nan;0;0
17599;4219;1415;0;0;0;0;.00nan;0;0
17599;57426;879;51;33;4;29;.879;3561000;0
17599;86283;879;0;0;0;0;.00nan;0;0
17599;154414;1415;60;24;2;22;.917;3600000;0
17601;28833;3965;0;0;0;0;.00nan;0;0
17601;180177;3965;88;31;1;30;.968;3900000;0
17601;146445;894;78;24;1;23;.958;3900000;0
17601;157416;894;0;0;0;0;.00nan;0;0
17603;23251;994;85;54;4;50;.926;3593000;0
17603;62530;994;0;0;0;0;.00nan;0;0
17603;76885;874;66;19;2;17;.895;3600000;0
17603;80616;874;0;0;0;0;.00nan;0;0
17605;76885;874;80;27;1;26;.963;3600000;0
17605;80616;874;0;0;0;0;.00nan;0;0
17605;82245;945;0;0;0;0;.00nan;0;0
17605;146479;945;53;33;5;28;.848;3600000;0
17607;4219;1415;0;0;0;0;.00nan;0;0
17607;23251;994;0;0;0;0;.00nan;0;0
17607;62530;994;71;25;2;23;.920;3600000;0
17607;154414;1415;64;28;3;25;.893;3550000;0
17609;8101;897;0;0;0;0;.00nan;0;0
17609;56306;978;0;0;0;0;.00nan;0;0
17609;78348;897;56;29;4;25;.862;3543000;0
17609;157295;978;64;31;3;28;.903;3600000;0
17611;168842;880;0;0;0;0;.00nan;0;0
17611;28833;3965;0;0;0;0;.00nan;0;0
17611;176765;880;62;27;2;25;.926;3600000;0
17611;180177;3965;55;26;3;23;.885;3543000;0
17613;9858;966;0;0;0;0;.00nan;0;0
17613;201288;957;0;0;0;0;.00nan;0;0
17613;83678;966;80;23;1;22;.957;3633000;0
17613;161128;957;70;25;2;23;.920;3633000;0
17615;164710;891;69;26;3;23;.885;3582000;0
17615;57426;879;0;0;0;0;.00nan;0;0
17615;86283;879;83;29;1;28;.966;3600000;0
17615;151940;891;0;0;0;0;.00nan;0;0
17617;70099;890;0;0;0;0;.00nan;0;0
17617;142583;890;92;32;1;31;.969;3600000;0
17617;146445;894;0;0;0;0;.00nan;0;0
17617;157416;894;56;27;3;24;.889;3558000;0
17619;9858;966;62;49;6;43;.878;3600000;0
17619;196005;966;0;0;0;0;.00nan;0;0
17619;70099;890;51;17;2;15;.882;3600000;0
17619;142583;890;0;0;0;0;.00nan;0;0
17621;4219;1415;66;26;2;24;.923;3600000;0
17621;168842;880;61;31;3;28;.903;3600000;0
17621;176765;880;0;0;0;0;.00nan;0;0
17621;154414;1415;0;0;0;0;.00nan;0;0
17623;56306;978;88;20;0;20;1.000;3600000;0
17623;146445;894;94;44;2;42;.955;3600000;0
17623;157295;978;0;0;0;0;.00nan;0;0
17623;157416;894;0;0;0;0;.00nan;0;0
17625;164710;891;0;0;0;0;.00nan;0;0
17625;201288;957;71;32;3;29;.906;3600000;0
17625;151940;891;57;40;4;36;.900;3568000;0
17625;161128;957;0;0;0;0;.00nan;0;0
17627;57426;879;77;31;2;29;.935;3600000;0
17627;82245;945;68;32;4;28;.875;3576000;0
17627;86283;879;0;0;0;0;.00nan;0;0
17627;146479;945;0;0;0;0;.00nan;0;0
17629;8101;897;0;0;0;0;.00nan;0;0
17629;23251;994;49;21;3;18;.857;3580000;0
17629;62530;994;0;0;0;0;.00nan;0;0
17629;78348;897;100;37;1;36;.973;3600000;0
17631;28833;3965;54;48;6;42;.875;3032000;0
17631;180177;3965;50;1;0;1;1.000;568000;0
17631;76885;874;0;0;0;0;.00nan;0;0
17631;80616;874;60;18;2;16;.889;3600000;0
787;9858;966;73;24;2;22;.917;3600000;0
787;196005;966;0;0;0;0;.00nan;0;0
787;56306;978;0;0;0;0;.00nan;0;0
787;157295;978;66;33;3;30;.909;3551000;0
788;8101;897;0;0;0;0;.00nan;0;0
788;70099;890;0;0;0;0;.00nan;0;0
788;78348;897;71;28;2;26;.929;3600000;0
788;142583;890;75;37;3;34;.919;3569000;0
789;9858;966;68;16;1;15;.938;3600000;0
789;196005;966;0;0;0;0;.00nan;0;0
789;56306;978;0;0;0;0;.00nan;0;0
789;157295;978;75;34;3;31;.912;3517000;0
790;8101;897;0;0;0;0;.00nan;0;0
790;70099;890;0;0;0;0;.00nan;0;0
790;78348;897;58;30;4;26;.867;3578000;0
790;142583;890;72;30;2;28;.933;3600000;0
984;8101;897;0;0;0;0;.00nan;0;0
984;70099;890;0;0;0;0;.00nan;0;0
984;78348;897;100;29;1;28;.966;3600000;0
984;142583;890;54;32;4;28;.875;3600000;0
1053;8101;897;60;8;0;8;1.000;487000;0
1053;76885;874;66;23;2;21;.913;3600000;0
1053;78348;897;34;36;7;29;.806;3113000;0
1053;80616;874;0;0;0;0;.00nan;0;0
1054;20645;957;0;0;0;0;.00nan;0;0
1054;57426;879;100;24;0;24;1.000;3600000;0
1054;86283;879;0;0;0;0;.00nan;0;0
1054;161128;957;45;30;5;25;.833;3600000;0
1055;164710;891;0;0;0;0;.00nan;0;0
1055;168842;880;0;0;0;0;.00nan;0;0
1055;176765;880;71;29;3;26;.897;3543000;0
1055;151940;891;76;23;2;21;.913;3600000;0
1056;9858;966;76;37;3;34;.919;3600000;0
1056;196005;966;0;0;0;0;.00nan;0;0
1056;85749;1415;67;24;2;22;.917;3600000;0
1056;154414;1415;0;0;0;0;.00nan;0;0
1057;8101;897;0;0;0;0;.00nan;0;0
1057;76885;874;69;20;2;18;.900;3600000;0
1057;78348;897;83;49;3;46;.939;3598000;0
1057;80616;874;0;0;0;0;.00nan;0;0
1058;20645;957;0;0;0;0;.00nan;0;0
1058;57426;879;0;0;0;0;.00nan;0;0
1058;86283;879;62;17;2;15;.882;3575000;0
1058;161128;957;79;24;1;23;.958;3600000;0
1059;164710;891;0;0;0;0;.00nan;0;0
1059;168842;880;0;0;0;0;.00nan;0;0
1059;176765;880;78;35;3;32;.914;3669000;0
1059;151940;891;77;29;2;27;.931;3669000;0
1060;9858;966;72;31;2;29;.935;3600000;0
1060;196005;966;0;0;0;0;.00nan;0;0
1060;85749;1415;44;21;3;18;.857;3559000;0
1060;154414;1415;0;0;0;0;.00nan;0;0
1061;8101;897;0;0;0;0;.00nan;0;0
1061;76885;874;73;18;1;17;.944;3600000;0
1061;78348;897;79;36;2;34;.944;3551000;0
1061;80616;874;0;0;0;0;.00nan;0;0
1062;20645;957;0;0;0;0;.00nan;0;0
1062;57426;879;0;0;0;0;.00nan;0;0
1062;86283;879;59;29;4;25;.862;3600000;0
1062;161128;957;73;19;1;18;.947;3600000;0
1063;164710;891;0;0;0;0;.00nan;0;0
1063;168842;880;0;0;0;0;.00nan;0;0
1063;176765;880;72;26;2;24;.923;3594000;0
1063;151940;891;78;25;1;24;.960;3600000;0
1064;9858;966;92;55;1;54;.982;3600000;0
1064;196005;966;0;0;0;0;.00nan;0;0
1064;85749;1415;55;18;2;16;.889;3553000;0
1064;154414;1415;0;0;0;0;.00nan;0;0
1065;8101;897;0;0;0;0;.00nan;0;0
1065;76885;874;53;22;3;19;.864;3544000;0
1065;78348;897;99;50;2;48;.960;3600000;0
1065;80616;874;0;0;0;0;.00nan;0;0
1066;20645;957;0;0;0;0;.00nan;0;0
1066;57426;879;0;0;0;0;.00nan;0;0
1066;86283;879;30;25;5;20;.800;3600000;0
1066;161128;957;100;47;1;46;.979;3600000;0
1067;164710;891;0;0;0;0;.00nan;0;0
1067;168842;880;0;0;0;0;.00nan;0;0
1067;176765;880;62;22;2;20;.909;3613000;0
1067;151940;891;58;24;3;21;.875;3613000;0
1068;9858;966;69;43;5;38;.884;3600000;0
1068;196005;966;0;0;0;0;.00nan;0;0
1068;85749;1415;59;21;2;19;.905;3600000;0
1068;154414;1415;0;0;0;0;.00nan;0;0
1247;8101;897;0;0;0;0;.00nan;0;0
1247;76885;874;49;17;3;14;.824;3600000;0
1247;78348;897;55;46;6;40;.870;3600000;0
1247;80616;874;0;0;0;0;.00nan;0;0
1248;20645;957;0;0;0;0;.00nan;0;0
1248;57426;879;0;0;0;0;.00nan;0;0
1248;86283;879;100;36;0;36;1.000;3600000;0
1248;161128;957;56;33;4;29;.879;3600000;0
1249;164710;891;0;0;0;0;.00nan;0;0
1249;168842;880;0;0;0;0;.00nan;0;0
1249;176765;880;100;31;0;31;1.000;3600000;0
1249;151940;891;79;20;1;19;.950;3600000;0
1250;9858;966;53;30;4;26;.867;3600000;0
1250;196005;966;0;0;0;0;.00nan;0;0
1250;85749;1415;82;28;1;27;.964;3600000;0
1250;154414;1415;0;0;0;0;.00nan;0;0
1287;20645;957;0;0;0;0;.00nan;0;0
1287;57426;879;0;0;0;0;.00nan;0;0
1287;86283;879;76;28;2;26;.929;3577000;0
1287;161128;957;76;21;1;20;.952;3600000;0
1288;164710;891;0;0;0;0;.00nan;0;0
1288;168842;880;0;0;0;0;.00nan;0;0
1288;176765;880;55;23;3;20;.870;3547000;0
1288;151940;891;76;29;2;27;.931;3600000;0
1289;9858;966;91;27;1;26;.963;3600000;0
1289;196005;966;0;0;0;0;.00nan;0;0
1289;85749;1415;51;17;2;15;.882;3552000;0
1289;154414;1415;0;0;0;0;.00nan;0;0
1426;9858;966;91;42;3;39;.929;3600000;0
1426;196005;966;0;0;0;0;.00nan;0;0
1426;85749;1415;83;16;0;16;1.000;3600000;0
1426;154414;1415;0;0;0;0;.00nan;0;0
1473;20645;957;0;0;0;0;.00nan;0;0
1473;76885;874;46;22;4;18;.818;3600000;0
1473;80616;874;0;0;0;0;.00nan;0;0
1473;161128;957;78;35;3;32;.914;3600000;0
1474;164710;891;0;0;0;0;.00nan;0;0
1474;85749;1415;69;20;1;19;.950;3600000;0
1474;151940;891;98;41;3;38;.927;3600000;0
1474;154414;1415;0;0;0;0;.00nan;0;0
1475;20645;957;0;0;0;0;.00nan;0;0
1475;76885;874;40;29;5;24;.828;3562000;0
1475;80616;874;0;0;0;0;.00nan;0;0
1475;161128;957;59;29;3;26;.897;3600000;0
1476;164710;891;0;0;0;0;.00nan;0;0
1476;85749;1415;56;26;4;22;.846;4615000;0
1476;151940;891;88;47;3;44;.936;4615000;0
1476;154414;1415;0;0;0;0;.00nan;0;0
1477;20645;957;0;0;0;0;.00nan;0;0
1477;76885;874;43;25;4;21;.840;3600000;0
1477;80616;874;0;0;0;0;.00nan;0;0
1477;161128;957;50;20;2;18;.900;3600000;0
1478;164710;891;0;0;0;0;.00nan;0;0
1478;85749;1415;67;17;1;16;.941;3568000;0
1478;151940;891;96;27;0;27;1.000;3600000;0
1478;154414;1415;0;0;0;0;.00nan;0;0
1479;20645;957;0;0;0;0;.00nan;0;0
1479;76885;874;96;24;0;24;1.000;3600000;0
1479;80616;874;0;0;0;0;.00nan;0;0
1479;161128;957;89;32;1;31;.969;3573000;0
1480;164710;891;0;0;0;0;.00nan;0;0
1480;85749;1415;49;18;3;15;.833;3545000;0
1480;151940;891;86;34;2;32;.941;3600000;0
1480;154414;1415;0;0;0;0;.00nan;0;0
1630;20645;957;0;0;0;0;.00nan;0;0
1630;76885;874;80;26;1;25;.962;3600000;0
1630;80616;874;0;0;0;0;.00nan;0;0
1630;161128;957;90;35;2;33;.943;3546000;0
1631;164710;891;0;0;0;0;.00nan;0;0
1631;85749;1415;56;20;2;18;.900;3600000;0
1631;151940;891;75;47;4;43;.915;3523000;0
1631;154414;1415;0;0;0;0;.00nan;0;0
1658;20645;957;0;0;0;0;.00nan;0;0
1658;76885;874;75;25;1;24;.960;3600000;0
1658;80616;874;0;0;0;0;.00nan;0;0
1658;161128;957;70;39;4;35;.897;3600000;0
1659;164710;891;0;0;0;0;.00nan;0;0
1659;85749;1415;80;32;2;30;.938;3600000;0
1659;151940;891;46;35;5;30;.857;3600000;0
1659;154414;1415;0;0;0;0;.00nan;0;0
1703;20645;957;0;0;0;0;.00nan;0;0
1703;76885;874;73;26;1;25;.962;3600000;0
1703;80616;874;0;0;0;0;.00nan;0;0
1703;161128;957;73;33;3;30;.909;3545000;0
1704;164710;891;0;0;0;0;.00nan;0;0
1704;85749;1415;51;13;2;11;.846;3600000;0
1704;151940;891;78;45;4;41;.911;3600000;0
1704;154414;1415;0;0;0;0;.00nan;0;0
1764;76885;874;43;29;5;24;.828;3588000;0
1764;80616;874;0;0;0;0;.00nan;0;0
1764;85749;1415;57;29;3;26;.897;3600000;0
1764;154414;1415;0;0;0;0;.00nan;0;0
1765;76885;874;82;38;3;35;.921;3534000;0
1765;80616;874;0;0;0;0;.00nan;0;0
1765;85749;1415;62;23;2;21;.913;3600000;0
1765;154414;1415;0;0;0;0;.00nan;0;0
1766;76885;874;83;29;2;27;.931;3580000;0
1766;80616;874;0;0;0;0;.00nan;0;0
1766;85749;1415;100;25;0;25;1.000;3600000;0
1766;154414;1415;0;0;0;0;.00nan;0;0
1767;76885;874;54;31;4;27;.871;3570000;0
1767;80616;874;0;0;0;0;.00nan;0;0
1767;85749;1415;68;21;2;19;.905;3600000;0
1767;154414;1415;0;0;0;0;.00nan;0;0
17632;63529;3730;53;25;3;22;.880;3592000;0
17632;76628;3730;0;0;0;0;.00nan;0;0
17632;146249;3913;0;0;0;0;.00nan;0;0
17632;148573;3913;84;32;2;30;.938;3600000;0
17633;11614;2197;71;44;4;40;.909;3900000;0
17633;189433;4924;55;29;4;25;.862;3900000;0
17633;186219;4924;0;0;0;0;.00nan;0;0
17633;94508;2197;0;0;0;0;.00nan;0;0
17634;1756;758;58;28;3;25;.893;3600000;0
17634;176686;4923;0;0;0;0;.00nan;0;0
17634;94107;758;0;0;0;0;.00nan;0;0
17634;148956;4923;58;31;4;27;.871;3591000;0
17635;-1;1093;71;20;1;19;.950;3600000;0
17635;170530;1492;0;0;0;0;.00nan;0;0
17635;67446;1492;57;33;4;29;.879;3600000;0
17635;68233;1093;0;0;0;0;.00nan;0;0
17636;359;759;58;30;4;26;.867;3545000;0
17636;169680;759;0;0;0;0;.00nan;0;0
17636;85489;760;96;37;2;35;.946;3600000;0
17636;149112;760;0;0;0;0;.00nan;0;0
17637;-1;4989;0;0;0;0;.00nan;0;0
17637;174894;762;88;44;3;41;.932;3564000;0
17637;71485;4989;80;25;1;24;.960;3600000;0
17637;148652;762;0;0;0;0;.00nan;0;0
17638;67122;1503;53;30;4;26;.867;3600000;0
17638;67818;3721;14;27;7;20;.741;2770000;0
17638;68689;1503;0;0;0;0;.00nan;0;0
17638;91194;3721;43;11;2;9;.818;830000;0
17639;279;766;80;28;2;26;.929;3600000;0
17639;164424;750;40;34;6;28;.824;3600000;0
17639;164521;750;0;0;0;0;.00nan;0;0
17639;82711;766;0;0;0;0;.00nan;0;0
17640;57993;772;60;23;2;21;.913;3600000;0
17640;148576;1497;70;34;3;31;.912;3575000;0
17640;149191;1497;0;0;0;0;.00nan;0;0
17640;149262;772;0;0;0;0;.00nan;0;0
17641;197595;2199;71;23;2;21;.913;3600000;0
17641;63529;3730;76;39;3;36;.923;3561000;0
17641;76406;2199;0;0;0;0;.00nan;0;0
17641;76628;3730;0;0;0;0;.00nan;0;0
17642;177124;775;0;0;0;0;.00nan;0;0
17642;169615;911;0;0;0;0;.00nan;0;0
17642;180990;775;55;39;5;34;.872;3600000;0
17642;93756;911;100;28;0;28;1.000;3600000;0
17643;170548;2545;78;26;1;25;.962;3600000;0
17643;146249;3913;0;0;0;0;.00nan;0;0
17643;148573;3913;52;25;3;22;.880;3580000;0
17643;148829;2545;0;0;0;0;.00nan;0;0
17644;175757;755;0;0;0;0;.00nan;0;0
17644;180154;755;64;32;4;28;.875;3559000;0
17644;142648;769;0;0;0;0;.00nan;0;0
17644;149221;769;61;26;3;23;.885;3600000;0
17645;359;759;43;21;4;17;.810;3600000;0
17645;11614;2197;11;15;6;9;.600;1673000;0
17645;169680;759;0;0;0;0;.00nan;0;0
17645;94508;2197;72;30;2;28;.933;1927000;0
17646;164424;750;30;29;6;23;.793;3600000;0
17646;164521;750;0;0;0;0;.00nan;0;0
17646;67294;774;0;0;0;0;.00nan;0;0
17646;149280;774;98;25;0;25;1.000;3600000;0
17647;189433;4924;0;0;0;0;.00nan;0;0
17647;186219;4924;89;43;3;40;.930;3600000;0
17647;85489;760;65;19;2;17;.895;3600000;0
17647;149112;760;0;0;0;0;.00nan;0;0
17648;-1;4989;0;0;0;0;.00nan;0;0
17648;67122;1503;0;0;0;0;.00nan;0;0
17648;68689;1503;60;29;4;25;.862;3519000;0
17648;71485;4989;68;26;2;24;.923;3600000;0
17649;174894;762;70;29;2;27;.931;3600000;0
17649;67818;3721;55;30;4;26;.867;3552000;0
17649;91194;3721;0;0;0;0;.00nan;0;0
17649;148652;762;0;0;0;0;.00nan;0;0
17650;279;766;89;29;1;28;.966;3900000;0
17650;81733;768;0;0;0;0;.00nan;0;0
17650;82711;766;0;0;0;0;.00nan;0;0
17650;82817;768;86;27;1;26;.963;3900000;0
17651;3508;746;89;16;0;16;1.000;3600000;0
17651;201933;746;0;0;0;0;.00nan;0;0
17651;142648;769;0;0;0;0;.00nan;0;0
17651;149221;769;88;44;3;41;.932;3600000;0
17652;170543;754;74;21;1;20;.952;3600000;0
17652;63529;3730;48;26;4;22;.846;3600000;0
17652;76628;3730;0;0;0;0;.00nan;0;0
17652;148904;754;0;0;0;0;.00nan;0;0
17653;3165;767;0;0;0;0;.00nan;0;0
17653;169615;911;49;25;4;21;.840;3600000;0
17653;91358;767;82;28;1;27;.964;3600000;0
17653;93756;911;0;0;0;0;.00nan;0;0
17654;170548;2545;94;42;3;39;.929;3600000;0
17654;197595;2199;37;26;5;21;.808;3549000;0
17654;76406;2199;0;0;0;0;.00nan;0;0
17654;148829;2545;0;0;0;0;.00nan;0;0
17655;175757;755;0;0;0;0;.00nan;0;0
17655;180154;755;57;15;2;13;.867;3600000;0
17655;146249;3913;0;0;0;0;.00nan;0;0
17655;148573;3913;50;34;5;29;.853;3600000;0
17656;67294;774;0;0;0;0;.00nan;0;0
17656;81733;768;0;0;0;0;.00nan;0;0
17656;82817;768;35;36;6;30;.833;3600000;0
17656;149280;774;90;35;2;33;.943;3600000;0
17657;164424;750;68;25;2;23;.920;3600000;0
17657;164521;750;0;0;0;0;.00nan;0;0
17657;-1;1093;42;32;6;26;.813;2940000;0
17657;68233;1093;37;8;2;6;.750;660000;0
17658;1756;758;63;30;3;27;.900;3600000;0
17658;-1;4989;42;3;1;2;.667;418000;0
17658;71485;4989;41;34;6;28;.824;3182000;0
17658;94107;758;0;0;0;0;.00nan;0;0
17659;176686;4923;77;34;2;32;.941;3900000;0
17659;67818;3721;83;33;2;31;.939;3900000;0
17659;91194;3721;0;0;0;0;.00nan;0;0
17659;148956;4923;0;0;0;0;.00nan;0;0
17660;279;766;0;0;0;0;.00nan;0;0
17660;57993;772;72;22;2;20;.909;3892000;0
17660;82711;766;90;27;1;26;.963;3892000;0
17660;149262;772;0;0;0;0;.00nan;0;0
17661;3508;746;66;25;2;23;.920;3600000;0
17661;201933;746;0;0;0;0;.00nan;0;0
17661;146249;3913;0;0;0;0;.00nan;0;0
17661;148573;3913;96;40;3;37;.925;3581000;0
17662;177124;775;0;0;0;0;.00nan;0;0
17662;3165;767;0;0;0;0;.00nan;0;0
17662;180990;775;91;17;0;17;1.000;3600000;0
17662;91358;767;79;35;2;33;.943;3529000;0
17663;63529;3730;49;22;3;19;.864;3581000;0
17663;76628;3730;0;0;0;0;.00nan;0;0
17663;142648;769;0;0;0;0;.00nan;0;0
17663;149221;769;99;32;1;31;.969;3600000;0
17664;170543;754;61;31;3;28;.903;3600000;0
17664;170548;2545;36;35;6;29;.829;3600000;0
17664;148829;2545;0;0;0;0;.00nan;0;0
17664;148904;754;0;0;0;0;.00nan;0;0
17665;175757;755;65;25;3;22;.880;3600000;0
17665;180154;755;0;0;0;0;.00nan;0;0
17665;197595;2199;0;0;0;0;.00nan;0;0
17665;76406;2199;39;20;4;16;.800;3600000;0
17666;359;759;65;31;3;28;.903;3600000;0
17666;169680;759;0;0;0;0;.00nan;0;0
17666;174894;762;100;35;0;35;1.000;3600000;0
17666;148652;762;0;0;0;0;.00nan;0;0
17667;57993;772;48;32;5;27;.844;3600000;0
17667;67294;774;0;0;0;0;.00nan;0;0
17667;149262;772;0;0;0;0;.00nan;0;0
17667;149280;774;83;29;2;27;.931;3600000;0
17668;-1;1093;99;40;2;38;.950;3900000;0
17668;68233;1093;0;0;0;0;.00nan;0;0
17668;81733;768;58;21;2;19;.905;3900000;0
17668;82817;768;0;0;0;0;.00nan;0;0
17669;11614;2197;72;29;2;27;.931;3600000;0
17669;85489;760;87;19;0;19;1.000;3600000;0
17669;94508;2197;0;0;0;0;.00nan;0;0
17669;149112;760;0;0;0;0;.00nan;0;0
17670;-1;4989;70;35;3;32;.914;3900000;0
17670;176686;4923;0;0;0;0;.00nan;0;0
17670;71485;4989;0;0;0;0;.00nan;0;0
17670;148956;4923;87;36;3;33;.917;3900000;0
17671;1756;758;61;21;2;19;.905;3600000;0
17671;67818;3721;0;0;0;0;.00nan;0;0
17671;91194;3721;59;33;4;29;.879;3590000;0
17671;94107;758;0;0;0;0;.00nan;0;0
17672;164424;750;47;37;6;31;.838;2971000;0
17672;164521;750;58;5;0;5;1.000;579000;0
17672;170530;1492;44;29;4;25;.862;3600000;0
17672;67446;1492;0;0;0;0;.00nan;0;0
17673;279;766;32;31;6;25;.806;3600000;0
17673;82711;766;0;0;0;0;.00nan;0;0
17673;148576;1497;75;30;2;28;.933;3600000;0
17673;149191;1497;0;0;0;0;.00nan;0;0
17674;3508;746;24;4;3;1;.250;445000;0
17674;201933;746;69;21;1;20;.952;3155000;0
17674;197595;2199;64;43;6;37;.860;3571000;0
17674;76406;2199;0;0;0;0;.00nan;0;0
17675;170548;2545;49;20;3;17;.850;3588000;0
17675;142648;769;69;28;2;26;.929;3600000;0
17675;148829;2545;0;0;0;0;.00nan;0;0
17675;149221;769;0;0;0;0;.00nan;0;0
17676;170543;754;43;30;6;24;.800;2596000;0
17676;175757;755;65;12;0;12;1.000;1322000;0
17676;180154;755;46;23;4;19;.826;2278000;0
17676;148904;754;50;9;1;8;.889;1004000;0
17677;189433;4924;0;0;0;0;.00nan;0;0
17677;174894;762;71;36;3;33;.917;3600000;0
17677;186219;4924;39;23;4;19;.826;3554000;0
17677;148652;762;0;0;0;0;.00nan;0;0
17678;67294;774;0;0;0;0;.00nan;0;0
17678;148576;1497;0;0;0;0;.00nan;0;0
17678;149191;1497;100;33;0;33;1.000;3600000;0
17678;149280;774;55;22;3;19;.864;3600000;0
17679;359;759;48;24;3;21;.875;3523000;0
17679;169680;759;0;0;0;0;.00nan;0;0
17679;67122;1503;0;0;0;0;.00nan;0;0
17679;68689;1503;99;45;1;44;.978;3600000;0
17680;-1;1093;0;0;0;0;.00nan;0;0
17680;57993;772;69;32;3;29;.906;3600000;0
17680;68233;1093;60;32;4;28;.875;3556000;0
17680;149262;772;0;0;0;0;.00nan;0;0
17681;170530;1492;63;43;5;38;.884;3600000;0
17681;67446;1492;0;0;0;0;.00nan;0;0
17681;81733;768;0;0;0;0;.00nan;0;0
17681;82817;768;77;23;1;22;.957;3600000;0
17682;3508;746;72;18;1;17;.944;3600000;0
17682;170543;754;93;46;3;43;.935;3600000;0
17682;201933;746;0;0;0;0;.00nan;0;0
17682;148904;754;0;0;0;0;.00nan;0;0
17683;169615;911;68;25;2;23;.920;3600000;0
17683;63529;3730;58;38;5;33;.868;3600000;0
17683;76628;3730;0;0;0;0;.00nan;0;0
17683;93756;911;0;0;0;0;.00nan;0;0
17684;174894;762;0;0;0;0;.00nan;0;0
17684;85489;760;24;5;3;2;.400;311000;0
17684;148652;762;55;16;2;14;.875;3600000;0
17684;149112;760;73;38;3;35;.921;3289000;0
17685;359;759;87;31;2;29;.935;3600000;0
17685;189264;4923;0;0;0;0;.00nan;0;0
17685;169680;759;0;0;0;0;.00nan;0;0
17685;176686;4923;58;31;4;27;.871;3543000;0
17686;189433;4924;0;0;0;0;.00nan;0;0
17686;186219;4924;67;29;3;26;.897;3547000;0
17686;67122;1503;0;0;0;0;.00nan;0;0
17686;68689;1503;79;24;1;23;.958;3600000;0
17687;1756;758;48;13;2;11;.846;3600000;0
17687;11614;2197;0;0;0;0;.00nan;0;0
17687;94107;758;0;0;0;0;.00nan;0;0
17687;94508;2197;96;46;3;43;.935;3600000;0
17688;-1;1093;66;28;3;25;.893;3600000;0
17688;68233;1093;0;0;0;0;.00nan;0;0
17688;148576;1497;50;34;5;29;.853;3582000;0
17688;149191;1497;0;0;0;0;.00nan;0;0
17689;279;766;0;0;0;0;.00nan;0;0
17689;82711;766;79;34;3;31;.912;3600000;0
17689;146249;3913;0;0;0;0;.00nan;0;0
17689;148573;3913;82;52;4;48;.923;3552000;0
17690;4281;772;0;0;0;0;.00nan;0;0
17690;170530;1492;100;32;0;32;1.000;3600000;0
17690;67446;1492;0;0;0;0;.00nan;0;0
17690;149262;772;69;23;1;22;.957;3600000;0
17691;164424;750;53;32;4;28;.875;3600000;0
17691;164521;750;0;0;0;0;.00nan;0;0
17691;67818;3721;100;31;0;31;1.000;3600000;0
17691;91194;3721;0;0;0;0;.00nan;0;0
17692;177124;775;0;0;0;0;.00nan;0;0
17692;180990;775;84;31;2;29;.935;3600000;0
17692;63529;3730;65;46;5;41;.891;3600000;0
17692;76628;3730;0;0;0;0;.00nan;0;0
17693;169615;911;70;18;1;17;.944;3600000;0
17693;170548;2545;74;24;2;22;.917;3579000;0
17693;93756;911;0;0;0;0;.00nan;0;0
17693;148829;2545;0;0;0;0;.00nan;0;0
17694;11614;2197;99;23;0;23;1.000;3600000;0
17694;174894;762;68;21;2;19;.905;3555000;0
17694;94508;2197;0;0;0;0;.00nan;0;0
17694;148652;762;0;0;0;0;.00nan;0;0
17695;189264;4923;81;28;1;27;.964;3600000;0
17695;189433;4924;96;45;3;42;.933;3544000;0
17695;176686;4923;0;0;0;0;.00nan;0;0
17695;186219;4924;0;0;0;0;.00nan;0;0
17696;67122;1503;47;21;3;18;.857;3556000;0
17696;68689;1503;0;0;0;0;.00nan;0;0
17696;85489;760;72;29;2;27;.931;3600000;0
17696;149112;760;0;0;0;0;.00nan;0;0
17697;359;759;40;22;4;18;.818;3600000;0
17697;1756;758;0;0;0;0;.00nan;0;0
17697;169680;759;0;0;0;0;.00nan;0;0
17697;94107;758;83;28;1;27;.964;3600000;0
17698;67294;774;0;0;0;0;.00nan;0;0
17698;146249;3913;0;0;0;0;.00nan;0;0
17698;148573;3913;100;21;0;21;1.000;3600000;0
17698;149280;774;77;23;1;22;.957;3600000;0
17699;67818;3721;88;29;1;28;.966;3600000;0
17699;81733;768;0;0;0;0;.00nan;0;0
17699;82817;768;56;25;3;22;.880;3527000;0
17699;91194;3721;0;0;0;0;.00nan;0;0
17700;170530;1492;92;19;0;19;1.000;3600000;0
17700;67446;1492;0;0;0;0;.00nan;0;0
17700;148576;1497;0;0;0;0;.00nan;0;0
17700;149191;1497;86;32;1;31;.969;3545000;0
17701;164424;750;76;19;1;18;.947;3600000;0
17701;164521;750;0;0;0;0;.00nan;0;0
17701;-1;4989;0;0;0;0;.00nan;0;0
17701;71485;4989;62;47;5;42;.894;3600000;0
17702;279;766;93;41;3;38;.927;3600000;0
17702;197595;2199;0;0;0;0;.00nan;0;0
17702;76406;2199;57;17;2;15;.882;3600000;0
17702;82711;766;0;0;0;0;.00nan;0;0
17703;177124;775;0;0;0;0;.00nan;0;0
17703;170548;2545;93;30;1;29;.967;3600000;0
17703;180990;775;78;37;3;34;.919;3531000;0
17703;148829;2545;0;0;0;0;.00nan;0;0
17704;3165;767;44;23;4;19;.826;3600000;0
17704;63529;3730;44;30;5;25;.833;3545000;0
17704;76628;3730;0;0;0;0;.00nan;0;0
17704;91358;767;0;0;0;0;.00nan;0;0
17705;169615;911;0;0;0;0;.00nan;0;0
17705;175757;755;0;0;0;0;.00nan;0;0
17705;180154;755;68;25;2;23;.920;3560000;0
17705;93756;911;83;26;1;25;.962;3600000;0
17706;189264;4923;0;0;0;0;.00nan;0;0
17706;176686;4923;63;16;1;15;.938;3900000;0
17706;85489;760;95;47;1;46;.979;3900000;0
17706;149112;760;0;0;0;0;.00nan;0;0
17707;4281;772;0;0;0;0;.00nan;0;0
17707;67818;3721;80;39;3;36;.923;3565000;0
17707;91194;3721;0;0;0;0;.00nan;0;0
17707;149262;772;79;30;2;28;.933;3600000;0
17708;11614;2197;100;44;2;42;.955;3900000;0
17708;67122;1503;0;0;0;0;.00nan;0;0
17708;68689;1503;66;24;2;22;.917;3900000;0
17708;94508;2197;0;0;0;0;.00nan;0;0
17709;1756;758;47;13;3;10;.769;3600000;0
17709;189433;4924;0;0;0;0;.00nan;0;0
17709;186219;4924;56;44;5;39;.886;3542000;0
17709;94107;758;0;0;0;0;.00nan;0;0
17710;-1;1093;68;26;2;24;.923;3600000;0
17710;68233;1093;0;0;0;0;.00nan;0;0
17710;146249;3913;0;0;0;0;.00nan;0;0
17710;148573;3913;54;28;4;24;.857;3523000;0
17711;-1;4989;0;0;0;0;.00nan;0;0
17711;71485;4989;65;40;5;35;.875;3600000;0
17711;81733;768;59;28;3;25;.893;3600000;0
17711;82817;768;0;0;0;0;.00nan;0;0
17712;197595;2199;92;29;1;28;.966;3600000;0
17712;67294;774;0;0;0;0;.00nan;0;0
17712;76406;2199;0;0;0;0;.00nan;0;0
17712;149280;774;82;15;0;15;1.000;3600000;0
17713;279;766;0;0;0;0;.00nan;0;0
17713;82711;766;100;23;0;23;1.000;3824000;0
17713;142648;769;0;0;0;0;.00nan;0;0
17713;149221;769;93;33;1;32;.970;3824000;0
17714;177124;775;0;0;0;0;.00nan;0;0
17714;175757;755;57;20;2;18;.900;3581000;0
17714;180154;755;0;0;0;0;.00nan;0;0
17714;180990;775;90;35;1;34;.971;3600000;0
17715;3165;767;0;0;0;0;.00nan;0;0
17715;170548;2545;74;33;3;30;.909;3514000;0
17715;91358;767;80;30;1;29;.967;3600000;0
17715;148829;2545;0;0;0;0;.00nan;0;0
17716;3508;746;65;27;2;25;.926;3900000;0
17716;169615;911;78;26;2;24;.923;3900000;0
17716;201933;746;0;0;0;0;.00nan;0;0
17716;93756;911;0;0;0;0;.00nan;0;0
17717;279;766;0;0;0;0;.00nan;0;0
17717;170543;754;0;0;0;0;.00nan;0;0
17717;82711;766;78;28;2;26;.929;3600000;0
17717;148904;754;78;38;3;35;.921;3564000;0
17718;11614;2197;80;33;2;31;.939;3900000;0
17718;189264;4923;71;32;2;30;.938;3900000;0
17718;176686;4923;0;0;0;0;.00nan;0;0
17718;94508;2197;0;0;0;0;.00nan;0;0
17719;4281;772;0;0;0;0;.00nan;0;0
17719;167061;772;60;15;1;14;.933;3600000;0
17719;-1;4989;0;0;0;0;.00nan;0;0
17719;71485;4989;80;31;2;29;.935;3573000;0
17720;1756;758;79;37;3;34;.919;3600000;0
17720;85489;760;100;33;0;33;1.000;3600000;0
17720;94107;758;0;0;0;0;.00nan;0;0
17720;149112;760;0;0;0;0;.00nan;0;0
17721;170530;1492;64;34;3;31;.912;3600000;0
17721;67446;1492;0;0;0;0;.00nan;0;0
17721;146249;3913;0;0;0;0;.00nan;0;0
17721;148573;3913;93;23;0;23;1.000;3600000;0
17722;-1;1093;69;29;3;26;.897;3600000;0
17722;197595;2199;0;0;0;0;.00nan;0;0
17722;68233;1093;0;0;0;0;.00nan;0;0
17722;76406;2199;96;24;0;24;1.000;3600000;0
17723;359;759;0;0;0;0;.00nan;0;0
17723;164424;750;91;39;2;37;.949;3730000;0
17723;164521;750;0;0;0;0;.00nan;0;0
17723;169680;759;81;28;1;27;.964;3730000;0
17724;67818;3721;71;23;3;20;.870;3900000;0
17724;91194;3721;0;0;0;0;.00nan;0;0
17724;148576;1497;92;34;3;31;.912;3900000;0
17724;149191;1497;0;0;0;0;.00nan;0;0
17725;168089;774;0;0;0;0;.00nan;0;0
17725;142648;769;0;0;0;0;.00nan;0;0
17725;149221;769;92;36;2;34;.944;3900000;0
17725;149280;774;59;21;2;19;.905;3900000;0
17726;177124;775;0;0;0;0;.00nan;0;0
17726;3508;746;68;26;2;24;.923;3600000;0
17726;201933;746;0;0;0;0;.00nan;0;0
17726;180990;775;61;29;3;26;.897;3567000;0
17727;3165;767;0;0;0;0;.00nan;0;0
17727;175757;755;0;0;0;0;.00nan;0;0
17727;180154;755;76;34;2;32;.941;3547000;0
17727;91358;767;90;32;1;31;.969;3600000;0
17728;168089;774;0;0;0;0;.00nan;0;0
17728;170543;754;71;33;2;31;.939;3600000;0
17728;148904;754;0;0;0;0;.00nan;0;0
17728;149280;774;44;29;5;24;.828;3600000;0
17729;174894;762;50;20;3;17;.850;3600000;0
17729;67122;1503;0;0;0;0;.00nan;0;0
17729;68689;1503;38;29;5;24;.828;3538000;0
17729;148652;762;0;0;0;0;.00nan;0;0
17730;164424;750;47;32;5;27;.844;3588000;0
17730;164521;750;0;0;0;0;.00nan;0;0
17730;189433;4924;0;0;0;0;.00nan;0;0
17730;186219;4924;70;35;3;32;.914;3600000;0
17731;170530;1492;97;47;3;44;.936;3589000;0
17731;197595;2199;76;21;2;19;.905;3600000;0
17731;67446;1492;0;0;0;0;.00nan;0;0
17731;76406;2199;0;0;0;0;.00nan;0;0
17732;359;759;95;36;2;34;.944;3900000;0
17732;169680;759;0;0;0;0;.00nan;0;0
17732;43971;768;78;37;2;35;.946;3900000;0
17732;82817;768;0;0;0;0;.00nan;0;0
17733;-1;4989;46;26;4;22;.846;3600000;0
17733;71485;4989;0;0;0;0;.00nan;0;0
17733;148576;1497;0;0;0;0;.00nan;0;0
17733;149191;1497;81;22;1;21;.955;3600000;0
17734;-1;1093;66;38;4;34;.895;3600000;0
17734;68233;1093;0;0;0;0;.00nan;0;0
17734;142648;769;0;0;0;0;.00nan;0;0
17734;149221;769;62;15;1;14;.933;3600000;0
17735;3165;767;0;0;0;0;.00nan;0;0
17735;3508;746;54;15;2;13;.867;3600000;0
17735;201933;746;0;0;0;0;.00nan;0;0
17735;91358;767;81;42;3;39;.929;3546000;0
17736;-1;1093;65;20;2;18;.900;3600000;0
17736;170543;754;0;0;0;0;.00nan;0;0
17736;68233;1093;0;0;0;0;.00nan;0;0
17736;148904;754;54;38;5;33;.868;3600000;0
17737;189264;4923;0;0;0;0;.00nan;0;0
17737;176686;4923;65;18;1;17;.944;3600000;0
17737;67122;1503;46;30;5;25;.833;3600000;0
17737;68689;1503;0;0;0;0;.00nan;0;0
17738;164424;750;50;28;4;24;.857;3600000;0
17738;164521;750;0;0;0;0;.00nan;0;0
17738;11614;2197;0;0;0;0;.00nan;0;0
17738;94508;2197;88;29;1;28;.966;3600000;0
17739;1756;758;97;22;0;22;1.000;3600000;0
17739;174894;762;81;25;1;24;.960;3572000;0
17739;94107;758;0;0;0;0;.00nan;0;0
17739;148652;762;0;0;0;0;.00nan;0;0
17740;67818;3721;85;33;2;31;.939;3600000;0
17740;91194;3721;0;0;0;0;.00nan;0;0
17740;146249;3913;0;0;0;0;.00nan;0;0
17740;148573;3913;64;35;4;31;.886;3560000;0
17741;189433;4924;51;40;6;34;.850;3600000;0
17741;186219;4924;0;0;0;0;.00nan;0;0
17741;43971;768;41;15;3;12;.800;3600000;0
17741;82817;768;0;0;0;0;.00nan;0;0
17742;279;766;96;21;0;21;1.000;3600000;0
17742;169615;911;0;0;0;0;.00nan;0;0
17742;82711;766;0;0;0;0;.00nan;0;0
17742;93756;911;78;41;4;37;.902;3600000;0
17743;359;759;59;24;3;21;.875;3561000;0
17743;4281;772;0;0;0;0;.00nan;0;0
17743;167061;772;71;28;2;26;.929;3600000;0
17743;169680;759;0;0;0;0;.00nan;0;0
17744;170530;1492;66;11;0;11;1.000;1100000;0
17744;67446;1492;22;20;6;14;.700;2500000;0
17744;142648;769;99;26;0;26;1.000;3600000;0
17744;149221;769;0;0;0;0;.00nan;0;0
17745;170548;2545;92;16;0;16;1.000;3600000;0
17745;63529;3730;74;21;1;20;.952;1439000;0
17745;76628;3730;24;26;6;20;.769;2161000;0
17745;148829;2545;0;0;0;0;.00nan;0;0
17746;170530;1492;64;35;4;31;.886;3600000;0
17746;170543;754;0;0;0;0;.00nan;0;0
17746;67446;1492;0;0;0;0;.00nan;0;0
17746;148904;754;79;20;1;19;.950;3600000;0
17747;189264;4923;82;24;1;23;.958;3600000;0
17747;174894;762;45;32;5;27;.844;3600000;0
17747;176686;4923;0;0;0;0;.00nan;0;0
17747;148652;762;0;0;0;0;.00nan;0;0
17748;11614;2197;36;21;4;17;.810;3600000;0
17748;43971;768;69;28;3;25;.893;3600000;0
17748;82817;768;0;0;0;0;.00nan;0;0
17748;94508;2197;0;0;0;0;.00nan;0;0
17749;168089;774;0;0;0;0;.00nan;0;0
17749;169615;911;49;34;5;29;.853;3600000;0
17749;93756;911;0;0;0;0;.00nan;0;0
17749;149280;774;87;33;1;32;.970;3600000;0
17750;1756;758;94;35;1;34;.971;3600000;0
17750;67122;1503;0;0;0;0;.00nan;0;0
17750;68689;1503;69;25;3;22;.880;3522000;0
17750;94107;758;0;0;0;0;.00nan;0;0
17751;164424;750;66;23;2;21;.913;3600000;0
17751;164521;750;0;0;0;0;.00nan;0;0
17751;85489;760;78;37;3;34;.919;3580000;0
17751;149112;760;0;0;0;0;.00nan;0;0
17752;-1;4989;0;0;0;0;.00nan;0;0
17752;71485;4989;100;29;0;29;1.000;3600000;0
17752;146249;3913;0;0;0;0;.00nan;0;0
17752;148573;3913;55;25;4;21;.840;3600000;0
17753;197595;2199;0;0;0;0;.00nan;0;0
17753;67818;3721;0;0;0;0;.00nan;0;0
17753;76406;2199;67;27;2;25;.926;3555000;0
17753;91194;3721;90;28;1;27;.964;3600000;0
17754;4281;772;0;0;0;0;.00nan;0;0
17754;167061;772;100;25;0;25;1.000;3600000;0
17754;189433;4924;0;0;0;0;.00nan;0;0
17754;186219;4924;61;22;2;20;.909;3575000;0
17755;279;766;72;21;1;20;.952;3600000;0
17755;177124;775;0;0;0;0;.00nan;0;0
17755;180990;775;70;41;4;37;.902;3600000;0
17755;82711;766;0;0;0;0;.00nan;0;0
17756;359;759;57;22;2;20;.909;3600000;0
17756;169680;759;0;0;0;0;.00nan;0;0
17756;148576;1497;82;45;4;41;.911;3527000;0
17756;149191;1497;0;0;0;0;.00nan;0;0
17757;175757;755;0;0;0;0;.00nan;0;0
17757;180154;755;100;34;0;34;1.000;3600000;0
17757;63529;3730;58;24;3;21;.875;3600000;0
17757;76628;3730;0;0;0;0;.00nan;0;0
17758;4281;772;0;0;0;0;.00nan;0;0
17758;167061;772;45;19;3;16;.842;3572000;0
17758;11614;2197;74;29;2;27;.931;3600000;0
17758;94508;2197;0;0;0;0;.00nan;0;0
17759;177124;775;0;0;0;0;.00nan;0;0
17759;168089;774;0;0;0;0;.00nan;0;0
17759;180990;775;74;25;1;24;.960;3575000;0
17759;149280;774;86;15;0;15;1.000;3600000;0
17760;-1;1093;0;0;0;0;.00nan;0;0
17760;169615;911;0;0;0;0;.00nan;0;0
17760;68233;1093;28;36;7;29;.806;3600000;0
17760;93756;911;72;20;2;18;.900;3600000;0
17761;43971;768;85;28;1;27;.964;3600000;0
17761;82817;768;0;0;0;0;.00nan;0;0
17761;85489;760;0;0;0;0;.00nan;0;0
17761;149112;760;79;43;3;40;.930;3600000;0
17762;-1;4989;0;0;0;0;.00nan;0;0
17762;197595;2199;73;20;1;19;.950;3565000;0
17762;71485;4989;100;41;0;41;1.000;3600000;0
17762;76406;2199;0;0;0;0;.00nan;0;0
17763;67818;3721;82;23;2;21;.913;3600000;0
17763;91194;3721;0;0;0;0;.00nan;0;0
17763;142648;769;40;32;5;27;.844;3600000;0
17763;149221;769;0;0;0;0;.00nan;0;0
17764;189433;4924;37;27;5;22;.815;3600000;0
17764;186219;4924;0;0;0;0;.00nan;0;0
17764;148576;1497;0;0;0;0;.00nan;0;0
17764;149191;1497;100;25;0;25;1.000;3600000;0
17765;279;766;0;0;0;0;.00nan;0;0
17765;3165;767;0;0;0;0;.00nan;0;0
17765;82711;766;37;25;5;20;.800;3600000;0
17765;91358;767;33;38;7;31;.816;3600000;0
17766;3508;746;60;17;2;15;.882;3600000;0
17766;201933;746;0;0;0;0;.00nan;0;0
17766;63529;3730;56;51;7;44;.863;3600000;0
17766;76628;3730;0;0;0;0;.00nan;0;0
17767;170548;2545;44;18;3;15;.833;3587000;0
17767;175757;755;0;0;0;0;.00nan;0;0
17767;180154;755;92;36;1;35;.972;3600000;0
17767;148829;2545;0;0;0;0;.00nan;0;0
17768;11614;2197;97;52;3;49;.942;3552000;0
17768;94508;2197;0;0;0;0;.00nan;0;0
17768;148576;1497;78;22;1;21;.955;3600000;0
17768;149191;1497;0;0;0;0;.00nan;0;0
17769;3165;767;0;0;0;0;.00nan;0;0
17769;168089;774;0;0;0;0;.00nan;0;0
17769;91358;767;52;20;3;17;.850;3592000;0
17769;149280;774;81;15;1;14;.933;3600000;0
17770;177124;775;0;0;0;0;.00nan;0;0
17770;-1;1093;32;19;4;15;.789;1029000;0
17770;180990;775;61;23;2;21;.913;3600000;0
17770;68233;1093;80;28;2;26;.929;2571000;0
17771;4281;772;0;0;0;0;.00nan;0;0
17771;167061;772;73;21;1;20;.952;3600000;0
17771;85489;760;62;20;2;18;.900;3562000;0
17771;149112;760;0;0;0;0;.00nan;0;0
17772;359;759;60;29;3;26;.897;3900000;0
17772;169680;759;0;0;0;0;.00nan;0;0
17772;146249;3913;94;45;3;42;.933;3900000;0
17772;148573;3913;0;0;0;0;.00nan;0;0
17773;-1;4989;0;0;0;0;.00nan;0;0
17773;71485;4989;91;39;2;37;.949;3561000;0
17773;142648;769;0;0;0;0;.00nan;0;0
17773;149221;769;84;21;1;20;.952;3600000;0
17774;170543;754;65;32;3;29;.906;3600000;0
17774;67818;3721;43;26;4;22;.846;3564000;0
17774;91194;3721;0;0;0;0;.00nan;0;0
17774;148904;754;0;0;0;0;.00nan;0;0
17775;169615;911;79;22;1;21;.955;3600000;0
17775;170530;1492;90;38;2;36;.947;3553000;0
17775;67446;1492;0;0;0;0;.00nan;0;0
17775;93756;911;0;0;0;0;.00nan;0;0
17776;3508;746;74;20;1;19;.950;3600000;0
17776;170548;2545;0;0;0;0;.00nan;0;0
17776;201933;746;0;0;0;0;.00nan;0;0
17776;148829;2545;81;46;4;42;.913;3600000;0
17777;3165;767;0;0;0;0;.00nan;0;0
17777;-1;1093;39;31;5;26;.839;3554000;0
17777;68233;1093;0;0;0;0;.00nan;0;0
17777;91358;767;78;41;4;37;.902;3600000;0
17778;85489;760;49;28;4;24;.857;3600000;0
17778;148576;1497;0;0;0;0;.00nan;0;0
17778;149112;760;0;0;0;0;.00nan;0;0
17778;149191;1497;87;20;0;20;1.000;3600000;0
17779;189433;4924;68;38;4;34;.895;3599000;0
17779;186219;4924;0;0;0;0;.00nan;0;0
17779;146249;3913;0;0;0;0;.00nan;0;0
17779;148573;3913;54;24;3;21;.875;3600000;0
17780;-1;4989;25;29;6;23;.793;3600000;0
17780;170543;754;0;0;0;0;.00nan;0;0
17780;71485;4989;0;0;0;0;.00nan;0;0
17780;148904;754;52;29;5;24;.828;3600000;0
17781;43971;768;63;22;2;20;.909;3600000;0
17781;67122;1503;65;29;3;26;.897;3580000;0
17781;68689;1503;0;0;0;0;.00nan;0;0
17781;82817;768;0;0;0;0;.00nan;0;0
17782;177124;775;0;0;0;0;.00nan;0;0
17782;170530;1492;51;47;6;41;.872;3600000;0
17782;180990;775;72;31;3;28;.903;3600000;0
17782;67446;1492;0;0;0;0;.00nan;0;0
17783;164424;750;0;0;0;0;.00nan;0;0
17783;164521;750;61;26;3;23;.885;3806000;0
17783;174894;762;79;39;2;37;.949;3806000;0
17783;148652;762;0;0;0;0;.00nan;0;0
17784;359;759;71;35;3;32;.914;3874000;0
17784;169680;759;0;0;0;0;.00nan;0;0
17784;197595;2199;0;0;0;0;.00nan;0;0
17784;76406;2199;89;38;3;35;.921;3900000;0
17785;279;766;70;30;2;28;.933;3870000;0
17785;63529;3730;81;24;1;23;.958;3870000;0
17785;76628;3730;0;0;0;0;.00nan;0;0
17785;82711;766;0;0;0;0;.00nan;0;0
17786;3508;746;87;16;0;16;1.000;3600000;0
17786;175757;755;89;53;5;48;.906;3600000;0
17786;180154;755;0;0;0;0;.00nan;0;0
17786;201933;746;0;0;0;0;.00nan;0;0
17787;4281;772;0;0;0;0;.00nan;0;0
17787;167061;772;52;23;3;20;.870;3600000;0
17787;67122;1503;0;0;0;0;.00nan;0;0
17787;68689;1503;53;28;4;24;.857;3600000;0
17788;11614;2197;100;51;0;51;1.000;3600000;0
17788;94508;2197;0;0;0;0;.00nan;0;0
17788;146249;3913;0;0;0;0;.00nan;0;0
17788;148573;3913;74;32;2;30;.938;3513000;0
17789;174894;762;72;33;2;31;.939;3900000;0
17789;43971;768;90;37;2;35;.946;3900000;0
17789;82817;768;0;0;0;0;.00nan;0;0
17789;148652;762;0;0;0;0;.00nan;0;0
17790;3165;767;0;0;0;0;.00nan;0;0
17790;170530;1492;64;38;4;34;.895;3547000;0
17790;67446;1492;0;0;0;0;.00nan;0;0
17790;91358;767;56;23;3;20;.870;3600000;0
17791;1756;758;75;28;2;26;.929;3589000;0
17791;164424;750;88;27;1;26;.963;3600000;0
17791;164521;750;0;0;0;0;.00nan;0;0
17791;94107;758;0;0;0;0;.00nan;0;0
17792;189433;4924;0;0;0;0;.00nan;0;0
17792;186219;4924;71;29;2;27;.931;3553000;0
17792;197595;2199;96;21;0;21;1.000;3600000;0
17792;76406;2199;0;0;0;0;.00nan;0;0
17793;359;759;63;19;2;17;.895;3600000;0
17793;169680;759;0;0;0;0;.00nan;0;0
17793;142648;769;0;0;0;0;.00nan;0;0
17793;149221;769;84;36;3;33;.917;3575000;0
17794;168089;774;0;0;0;0;.00nan;0;0
17794;63529;3730;0;0;0;0;.00nan;0;0
17794;76628;3730;72;38;4;34;.895;3600000;0
17794;149280;774;44;17;3;14;.824;3600000;0
17795;169615;911;0;0;0;0;.00nan;0;0
17795;67818;3721;73;29;2;27;.931;3860000;0
17795;91194;3721;0;0;0;0;.00nan;0;0
17795;93756;911;93;35;2;33;.943;3900000;0
17796;279;766;0;0;0;0;.00nan;0;0
17796;170548;2545;0;0;0;0;.00nan;0;0
17796;82711;766;63;34;3;31;.912;3543000;0
17796;148829;2545;63;20;2;18;.900;3600000;0
17797;359;759;69;21;2;19;.905;3600000;0
17797;169680;759;0;0;0;0;.00nan;0;0
17797;170543;754;62;36;4;32;.889;3600000;0
17797;148904;754;0;0;0;0;.00nan;0;0
17798;4281;772;68;20;1;19;.950;3600000;0
17798;167061;772;0;0;0;0;.00nan;0;0
17798;174894;762;72;34;2;32;.941;3548000;0
17798;148652;762;0;0;0;0;.00nan;0;0
17799;85489;760;52;39;5;34;.872;3600000;0
17799;146249;3913;0;0;0;0;.00nan;0;0
17799;148573;3913;79;24;1;23;.958;3600000;0
17799;149112;760;0;0;0;0;.00nan;0;0
17800;1756;758;72;47;5;42;.894;3549000;0
17800;43971;768;51;22;3;19;.864;3600000;0
17800;82817;768;0;0;0;0;.00nan;0;0
17800;94107;758;0;0;0;0;.00nan;0;0
17801;164424;750;79;34;2;32;.941;3600000;0
17801;164521;750;0;0;0;0;.00nan;0;0
17801;189264;4923;0;0;0;0;.00nan;0;0
17801;176686;4923;49;37;5;32;.865;3600000;0
17802;11614;2197;53;45;6;39;.867;3600000;0
17802;197595;2199;76;27;2;25;.926;3600000;0
17802;76406;2199;0;0;0;0;.00nan;0;0
17802;94508;2197;0;0;0;0;.00nan;0;0
17803;67122;1503;0;0;0;0;.00nan;0;0
17803;68689;1503;51;28;4;24;.857;3600000;0
17803;148576;1497;90;28;1;27;.964;3600000;0
17803;149191;1497;0;0;0;0;.00nan;0;0
17804;189433;4924;67;39;4;35;.897;3590000;0
17804;186219;4924;0;0;0;0;.00nan;0;0
17804;142648;769;73;34;3;31;.912;3600000;0
17804;149221;769;0;0;0;0;.00nan;0;0
17805;279;766;81;36;2;34;.944;3600000;0
17805;3508;746;50;23;3;20;.870;3600000;0
17805;201933;746;0;0;0;0;.00nan;0;0
17805;82711;766;0;0;0;0;.00nan;0;0
17806;177124;775;88;31;2;29;.935;3600000;0
17806;180990;775;0;0;0;0;.00nan;0;0
17806;67818;3721;54;26;3;23;.885;3551000;0
17806;91194;3721;0;0;0;0;.00nan;0;0
17807;-1;1093;80;28;1;27;.964;3600000;0
17807;63529;3730;73;35;3;32;.914;3588000;0
17807;68233;1093;0;0;0;0;.00nan;0;0
17807;76628;3730;0;0;0;0;.00nan;0;0
17808;-1;4989;0;0;0;0;.00nan;0;0
17808;169615;911;61;21;2;19;.905;3600000;0
17808;71485;4989;57;35;4;31;.886;3586000;0
17808;93756;911;0;0;0;0;.00nan;0;0
17809;168089;774;0;0;0;0;.00nan;0;0
17809;170548;2545;0;0;0;0;.00nan;0;0
17809;148829;2545;40;31;5;26;.839;3600000;0
17809;149280;774;84;20;1;19;.950;3600000;0
17810;189433;4924;0;0;0;0;.00nan;0;0
17810;170543;754;52;21;3;18;.857;3560000;0
17810;186219;4924;81;33;2;31;.939;3600000;0
17810;148904;754;0;0;0;0;.00nan;0;0
17811;1756;758;86;36;2;34;.944;3900000;0
17811;4281;772;0;0;0;0;.00nan;0;0
17811;167061;772;78;36;2;34;.944;3900000;0
17811;94107;758;0;0;0;0;.00nan;0;0
17812;189264;4923;63;37;4;33;.892;3600000;0
17812;176686;4923;0;0;0;0;.00nan;0;0
17812;43971;768;0;0;0;0;.00nan;0;0
17812;82817;768;39;32;5;27;.844;3570000;0
17813;164424;750;79;35;2;33;.943;3900000;0
17813;164521;750;0;0;0;0;.00nan;0;0
17813;67122;1503;0;0;0;0;.00nan;0;0
17813;68689;1503;81;29;2;27;.931;3900000;0
17814;197595;2199;0;0;0;0;.00nan;0;0
17814;76406;2199;78;21;1;20;.952;3600000;0
17814;85489;760;40;34;6;28;.824;3140000;0
17814;149112;760;51;2;0;2;1.000;460000;0
17815;174894;762;38;36;6;30;.833;3600000;0
17815;148576;1497;0;0;0;0;.00nan;0;0
17815;148652;762;0;0;0;0;.00nan;0;0
17815;149191;1497;74;37;3;34;.919;3600000;0
17816;11614;2197;69;23;2;21;.913;3600000;0
17816;94508;2197;0;0;0;0;.00nan;0;0
17816;142648;769;0;0;0;0;.00nan;0;0
17816;149221;769;64;32;3;29;.906;3580000;0
17817;3508;746;73;23;2;21;.913;3600000;0
17817;168089;774;0;0;0;0;.00nan;0;0
17817;201933;746;0;0;0;0;.00nan;0;0
17817;149280;774;31;24;5;19;.792;3600000;0
17818;177124;775;0;0;0;0;.00nan;0;0
17818;-1;4989;0;0;0;0;.00nan;0;0
17818;180990;775;66;26;3;23;.885;3900000;0
17818;71485;4989;86;43;3;40;.930;3900000;0
17819;170530;1492;26;5;3;2;.400;221000;0
17819;63529;3730;64;44;5;39;.886;3600000;0
17819;67446;1492;56;29;3;26;.897;3379000;0
17819;76628;3730;0;0;0;0;.00nan;0;0
17820;3165;767;0;0;0;0;.00nan;0;0
17820;67818;3721;82;28;1;27;.964;3600000;0
17820;91194;3721;0;0;0;0;.00nan;0;0
17820;91358;767;56;27;3;24;.889;3600000;0
17821;-1;1093;65;18;1;17;.944;3559000;0
17821;170548;2545;0;0;0;0;.00nan;0;0
17821;68233;1093;0;0;0;0;.00nan;0;0
17821;148829;2545;100;33;0;33;1.000;3600000;0
17822;279;766;60;19;2;17;.895;3600000;0
17822;175757;755;0;0;0;0;.00nan;0;0
17822;180154;755;74;36;3;33;.917;3600000;0
17822;82711;766;0;0;0;0;.00nan;0;0
17823;11614;2197;48;38;6;32;.842;3600000;0
17823;170543;754;0;0;0;0;.00nan;0;0
17823;94508;2197;0;0;0;0;.00nan;0;0
17823;148904;754;87;19;0;19;1.000;3600000;0
17824;4281;772;0;0;0;0;.00nan;0;0
17824;167061;772;95;36;1;35;.972;3600000;0
17824;189264;4923;0;0;0;0;.00nan;0;0
17824;176686;4923;54;16;2;14;.875;3600000;0
17825;1756;758;39;23;4;19;.826;3600000;0
17825;94107;758;0;0;0;0;.00nan;0;0
17825;148576;1497;24;25;6;19;.760;3583000;0
17825;149191;1497;0;0;0;0;.00nan;0;0
17826;85489;760;88;30;1;29;.967;3600000;0
17826;142648;769;0;0;0;0;.00nan;0;0
17826;149112;760;0;0;0;0;.00nan;0;0
17826;149221;769;71;36;3;33;.917;3561000;0
17827;3508;746;98;18;0;18;1.000;3600000;0
17827;-1;1093;81;30;1;29;.967;3558000;0
17827;201933;746;0;0;0;0;.00nan;0;0
17827;68233;1093;0;0;0;0;.00nan;0;0
17828;3165;767;0;0;0;0;.00nan;0;0
17828;-1;4989;0;0;0;0;.00nan;0;0
17828;71485;4989;70;40;4;36;.900;3600000;0
17828;91358;767;32;17;5;12;.706;3564000;0
17829;170530;1492;88;19;0;19;1.000;3600000;0
17829;170548;2545;0;0;0;0;.00nan;0;0
17829;67446;1492;0;0;0;0;.00nan;0;0
17829;148829;2545;85;26;1;25;.962;3600000;0
17830;168089;774;0;0;0;0;.00nan;0;0
17830;175757;755;74;55;5;50;.909;3600000;0
17830;180154;755;0;0;0;0;.00nan;0;0
17830;149280;774;64;17;1;16;.941;3600000;0
17831;359;759;67;15;1;14;.933;3600000;0
17831;169615;911;0;0;0;0;.00nan;0;0
17831;169680;759;0;0;0;0;.00nan;0;0
17831;93756;911;72;49;5;44;.898;3600000;0
17832;170543;754;0;0;0;0;.00nan;0;0
17832;85489;760;44;24;4;20;.833;3600000;0
17832;148904;754;83;30;2;28;.933;3600000;0
17832;149112;760;0;0;0;0;.00nan;0;0
17833;174894;762;0;0;0;0;.00nan;0;0
17833;197595;2199;78;22;1;21;.955;3600000;0
17833;76406;2199;0;0;0;0;.00nan;0;0
17833;148652;762;90;38;2;36;.947;3600000;0
17834;189264;4923;64;30;3;27;.900;3585000;0
17834;176686;4923;0;0;0;0;.00nan;0;0
17834;148576;1497;0;0;0;0;.00nan;0;0
17834;149191;1497;89;33;2;31;.939;3600000;0
17835;3508;746;83;12;0;12;1.000;3600000;0
17835;170530;1492;81;41;4;37;.902;3600000;0
17835;201933;746;0;0;0;0;.00nan;0;0
17835;67446;1492;0;0;0;0;.00nan;0;0
17836;63529;3730;81;41;3;38;.927;3564000;0
17836;67818;3721;0;0;0;0;.00nan;0;0
17836;76628;3730;0;0;0;0;.00nan;0;0
17836;91194;3721;58;10;1;9;.900;3600000;0
17837;189433;4924;65;50;6;44;.880;3600000;0
17837;169615;911;60;21;2;19;.905;3600000;0
17837;186219;4924;0;0;0;0;.00nan;0;0
17837;93756;911;0;0;0;0;.00nan;0;0
17838;-1;1093;70;22;1;21;.955;3734000;0
17838;175757;755;0;0;0;0;.00nan;0;0
17838;180154;755;61;21;2;19;.905;3734000;0
17838;68233;1093;0;0;0;0;.00nan;0;0
17839;359;759;100;39;1;38;.974;3600000;0
17839;177124;775;0;0;0;0;.00nan;0;0
17839;169680;759;0;0;0;0;.00nan;0;0
17839;180990;775;81;35;3;32;.914;3533000;0
17840;174894;762;72;20;1;19;.950;3600000;0
17840;146249;3913;0;0;0;0;.00nan;0;0
17840;148573;3913;29;21;5;16;.762;3600000;0
17840;148652;762;0;0;0;0;.00nan;0;0
17841;197595;2199;98;23;0;23;1.000;3600000;0
17841;67122;1503;75;39;3;36;.923;3600000;0
17841;68689;1503;0;0;0;0;.00nan;0;0
17841;76406;2199;0;0;0;0;.00nan;0;0
17842;1756;758;78;22;1;21;.955;3600000;0
17842;94107;758;0;0;0;0;.00nan;0;0
17842;142648;769;48;8;1;7;.875;1374000;0
17842;149221;769;36;27;5;22;.815;2226000;0
17843;11614;2197;0;0;0;0;.00nan;0;0
17843;169615;911;0;0;0;0;.00nan;0;0
17843;93756;911;75;22;1;21;.955;3600000;0
17843;94508;2197;93;46;2;44;.957;3600000;0
17844;-1;4989;0;0;0;0;.00nan;0;0
17844;63529;3730;61;31;4;27;.871;3513000;0
17844;71485;4989;95;37;2;35;.946;3600000;0
17844;76628;3730;0;0;0;0;.00nan;0;0
17845;170548;2545;0;0;0;0;.00nan;0;0
17845;67818;3721;70;26;2;24;.923;3596000;0
17845;91194;3721;0;0;0;0;.00nan;0;0
17845;148829;2545;70;17;1;16;.941;3600000;0
17846;177124;775;0;0;0;0;.00nan;0;0
17846;189433;4924;0;0;0;0;.00nan;0;0
17846;180990;775;100;37;0;37;1.000;3600000;0
17846;186219;4924;59;37;4;33;.892;3600000;0
17847;170530;1492;0;0;0;0;.00nan;0;0
17847;175757;755;57;30;4;26;.867;3600000;0
17847;180154;755;0;0;0;0;.00nan;0;0
17847;67446;1492;100;32;0;32;1.000;3600000;0
17848;359;759;54;26;4;22;.846;3600000;0
17848;3165;767;0;0;0;0;.00nan;0;0
17848;169680;759;0;0;0;0;.00nan;0;0
17848;91358;767;51;36;5;31;.861;3600000;0
17849;170543;754;87;32;1;31;.969;3600000;0
17849;174894;762;0;0;0;0;.00nan;0;0
17849;148652;762;37;22;4;18;.818;3600000;0
17849;148904;754;0;0;0;0;.00nan;0;0
17850;189264;4923;0;0;0;0;.00nan;0;0
17850;176686;4923;67;24;2;22;.917;3600000;0
17850;142648;769;0;0;0;0;.00nan;0;0
17850;149221;769;54;26;3;23;.885;3590000;0
17851;279;766;80;47;4;43;.915;3600000;0
17851;168089;774;0;0;0;0;.00nan;0;0
17851;82711;766;0;0;0;0;.00nan;0;0
17851;149280;774;96;19;0;19;1.000;3600000;0
17852;67122;1503;0;0;0;0;.00nan;0;0
17852;68689;1503;85;28;1;27;.964;3600000;0
17852;146249;3913;0;0;0;0;.00nan;0;0
17852;148573;3913;72;34;3;31;.912;3551000;0
17853;1756;758;0;0;0;0;.00nan;0;0
17853;197595;2199;77;28;2;26;.929;3600000;0
17853;76406;2199;0;0;0;0;.00nan;0;0
17853;94107;758;92;44;3;41;.932;3600000;0
17854;4281;772;0;0;0;0;.00nan;0;0
17854;167061;772;73;40;4;36;.900;3552000;0
17854;43971;768;76;22;2;20;.909;3600000;0
17854;82817;768;0;0;0;0;.00nan;0;0
17855;164424;750;92;28;1;27;.964;3600000;0
17855;164521;750;0;0;0;0;.00nan;0;0
17855;148576;1497;28;26;6;20;.769;2190000;0
17855;149191;1497;64;11;0;11;1.000;1410000;0
17856;177124;775;0;0;0;0;.00nan;0;0
17856;11614;2197;68;32;3;29;.906;3572000;0
17856;180990;775;71;27;2;25;.926;3600000;0
17856;94508;2197;0;0;0;0;.00nan;0;0
17857;169615;911;52;25;3;22;.880;3600000;0
17857;85489;760;57;32;4;28;.875;3559000;0
17857;93756;911;0;0;0;0;.00nan;0;0
17857;149112;760;0;0;0;0;.00nan;0;0
17858;-1;4989;0;0;0;0;.00nan;0;0
17858;170548;2545;0;0;0;0;.00nan;0;0
17858;71485;4989;76;28;2;26;.929;3543000;0
17858;148829;2545;91;25;1;24;.960;3600000;0
17859;3508;746;82;16;0;16;1.000;3600000;0
17859;201933;746;0;0;0;0;.00nan;0;0
17859;67818;3721;94;40;2;38;.950;3542000;0
17859;91194;3721;0;0;0;0;.00nan;0;0
17860;3165;767;0;0;0;0;.00nan;0;0
17860;189433;4924;63;16;1;15;.938;3600000;0
17860;186219;4924;0;0;0;0;.00nan;0;0
17860;91358;767;52;34;4;30;.882;3600000;0
17861;174894;762;29;14;4;10;.714;2309000;0
17861;142648;769;66;33;3;30;.909;3600000;0
17861;148652;762;49;7;1;6;.857;1274000;0
17861;149221;769;0;0;0;0;.00nan;0;0
17862;189264;4923;100;29;0;29;1.000;3600000;0
17862;176686;4923;0;0;0;0;.00nan;0;0
17862;197595;2199;0;0;0;0;.00nan;0;0
17862;76406;2199;90;36;1;35;.972;3556000;0
17863;170543;754;63;30;2;28;.933;3540000;0
17863;67122;1503;100;28;0;28;1.000;3600000;0
17863;68689;1503;0;0;0;0;.00nan;0;0
17863;148904;754;0;0;0;0;.00nan;0;0
17864;1756;758;61;27;3;24;.889;3545000;0
17864;94107;758;0;0;0;0;.00nan;0;0
17864;146249;3913;0;0;0;0;.00nan;0;0
17864;148573;3913;81;38;2;36;.947;3600000;0
17865;279;766;0;0;0;0;.00nan;0;0
17865;-1;1093;0;0;0;0;.00nan;0;0
17865;68233;1093;67;25;2;23;.920;3600000;0
17865;82711;766;44;23;4;19;.826;3517000;0
17866;43971;768;82;15;1;14;.933;3600000;0
17866;82817;768;0;0;0;0;.00nan;0;0
17866;148576;1497;42;43;6;37;.860;3182000;0
17866;149191;1497;54;3;0;3;1.000;418000;0
17867;4281;772;0;0;0;0;.00nan;0;0
17867;167061;772;78;34;2;32;.941;3600000;0
17867;164424;750;74;21;1;20;.952;3600000;0
17867;164521;750;0;0;0;0;.00nan;0;0
17868;3165;767;0;0;0;0;.00nan;0;0
17868;11614;2197;0;0;0;0;.00nan;0;0
17868;91358;767;45;18;3;15;.833;3549000;0
17868;94508;2197;100;42;1;41;.976;3600000;0
17869;177124;775;0;0;0;0;.00nan;0;0
17869;180990;775;69;37;4;33;.892;3571000;0
17869;85489;760;77;35;3;32;.914;3600000;0
17869;149112;760;0;0;0;0;.00nan;0;0
17870;3508;746;62;13;1;12;.923;3600000;0
17870;-1;4989;0;0;0;0;.00nan;0;0
17870;201933;746;0;0;0;0;.00nan;0;0
17870;71485;4989;70;25;2;23;.920;3590000;0
17871;175757;755;0;0;0;0;.00nan;0;0
17871;180154;755;52;26;3;23;.885;3563000;0
17871;67818;3721;0;0;0;0;.00nan;0;0
17871;91194;3721;76;32;2;30;.938;3600000;0
17872;189264;4923;0;0;0;0;.00nan;0;0
17872;176686;4923;64;22;2;20;.909;3600000;0
17872;146249;3913;0;0;0;0;.00nan;0;0
17872;148573;3913;58;34;5;29;.853;3600000;0
17873;67122;1503;64;29;3;26;.897;3868000;0
17873;68689;1503;0;0;0;0;.00nan;0;0
17873;142648;769;0;0;0;0;.00nan;0;0
17873;149221;769;84;46;3;43;.935;3900000;0
17874;1756;758;70;25;2;23;.920;3600000;0
17874;170543;754;39;34;6;28;.824;3232000;0
17874;94107;758;0;0;0;0;.00nan;0;0
17874;148904;754;58;5;0;5;1.000;368000;0
17875;168089;774;0;0;0;0;.00nan;0;0
17875;-1;1093;100;27;0;27;1.000;3600000;0
17875;68233;1093;0;0;0;0;.00nan;0;0
17875;149280;774;46;5;1;4;.800;3545000;0
17876;359;759;52;24;3;21;.875;3522000;0
17876;169680;759;0;0;0;0;.00nan;0;0
17876;63529;3730;81;25;1;24;.960;3600000;0
17876;76628;3730;0;0;0;0;.00nan;0;0
17877;279;766;71;24;2;22;.917;3900000;0
17877;170530;1492;0;0;0;0;.00nan;0;0
17877;67446;1492;69;29;2;27;.931;3900000;0
17877;82711;766;0;0;0;0;.00nan;0;0
17878;3165;767;0;0;0;0;.00nan;0;0
17878;85489;760;82;35;3;32;.914;3545000;0
17878;91358;767;76;26;2;24;.923;3600000;0
17878;149112;760;0;0;0;0;.00nan;0;0
17879;-1;4989;0;0;0;0;.00nan;0;0
17879;175757;755;26;14;4;10;.714;1172000;0
17879;180154;755;65;20;2;18;.900;2428000;0
17879;71485;4989;79;22;1;21;.955;3600000;0
17880;189264;4923;70;30;2;28;.933;3600000;0
17880;170543;754;0;0;0;0;.00nan;0;0
17880;176686;4923;0;0;0;0;.00nan;0;0
17880;148904;754;58;33;3;30;.909;3542000;0
17881;189433;4924;0;0;0;0;.00nan;0;0
17881;186219;4924;61;16;1;15;.938;3600000;0
17881;63529;3730;0;0;0;0;.00nan;0;0
17881;76628;3730;96;46;2;44;.957;3550000;0
17882;168089;774;0;0;0;0;.00nan;0;0
17882;170530;1492;99;43;2;41;.953;3600000;0
17882;67446;1492;0;0;0;0;.00nan;0;0
17882;149280;774;45;19;3;16;.842;3549000;0
17883;169615;911;0;0;0;0;.00nan;0;0
17883;174894;762;53;4;0;4;1.000;604000;0
17883;93756;911;50;18;3;15;.833;3600000;0
17883;148652;762;43;39;6;33;.846;2996000;0
17884;359;759;73;32;3;29;.906;3581000;0
17884;169680;759;0;0;0;0;.00nan;0;0
17884;170548;2545;0;0;0;0;.00nan;0;0
17884;148829;2545;77;27;1;26;.963;3600000;0
17885;43971;768;69;31;3;28;.903;3872000;0
17885;197595;2199;0;0;0;0;.00nan;0;0
17885;76406;2199;81;38;3;35;.921;3900000;0
17885;82817;768;0;0;0;0;.00nan;0;0
17886;359;759;96;50;3;47;.940;3600000;0
17886;3508;746;94;17;0;17;1.000;3600000;0
17886;169680;759;0;0;0;0;.00nan;0;0
17886;149191;746;0;0;0;0;.00nan;0;0
17887;177124;775;0;0;0;0;.00nan;0;0
17887;174894;762;40;18;4;14;.778;3600000;0
17887;180990;775;42;42;6;36;.857;3549000;0
17887;148652;762;0;0;0;0;.00nan;0;0
17888;11614;2197;0;0;0;0;.00nan;0;0
17888;63529;3730;77;31;2;29;.935;3600000;0
17888;76628;3730;0;0;0;0;.00nan;0;0
17888;94508;2197;70;35;4;31;.886;3576000;0
17889;169615;911;83;27;2;25;.926;3900000;0
17889;67122;1503;57;13;2;11;.846;3900000;0
17889;68689;1503;0;0;0;0;.00nan;0;0
17889;93756;911;0;0;0;0;.00nan;0;0
17890;279;766;57;18;2;16;.889;3600000;0
17890;67818;3721;39;37;6;31;.838;3600000;0
17890;82711;766;0;0;0;0;.00nan;0;0
17890;91194;3721;0;0;0;0;.00nan;0;0
17891;189433;4924;70;24;2;22;.917;3900000;0
17891;170548;2545;79;26;2;24;.923;3900000;0
17891;186219;4924;0;0;0;0;.00nan;0;0
17891;148829;2545;0;0;0;0;.00nan;0;0
17892;43971;768;65;25;3;22;.880;3541000;0
17892;82817;768;0;0;0;0;.00nan;0;0
17892;146249;3913;0;0;0;0;.00nan;0;0
17892;148573;3913;100;43;1;42;.977;3600000;0
17893;164424;750;56;28;3;25;.893;3600000;0
17893;164521;750;0;0;0;0;.00nan;0;0
17893;197595;2199;47;34;5;29;.853;3558000;0
17893;76406;2199;0;0;0;0;.00nan;0;0
17894;168089;774;0;0;0;0;.00nan;0;0
17894;67818;3721;64;33;4;29;.879;3600000;0
17894;91194;3721;0;0;0;0;.00nan;0;0
17894;149280;774;71;24;1;23;.958;3600000;0
17895;3508;746;52;9;1;8;.889;3600000;0
17895;189433;4924;0;0;0;0;.00nan;0;0
17895;186219;4924;94;49;2;47;.959;3600000;0
17895;149191;746;0;0;0;0;.00nan;0;0
17896;177124;775;0;0;0;0;.00nan;0;0
17896;180990;775;70;32;3;29;.906;3600000;0
17896;67122;1503;39;23;4;19;.826;3545000;0
17896;68689;1503;0;0;0;0;.00nan;0;0
17897;63529;3730;76;30;2;28;.933;3593000;0
17897;76628;3730;0;0;0;0;.00nan;0;0
17897;85489;760;100;32;0;32;1.000;3600000;0
17897;149112;760;0;0;0;0;.00nan;0;0
17898;3165;767;75;32;3;29;.906;3600000;0
17898;174894;762;0;0;0;0;.00nan;0;0
17898;91358;767;0;0;0;0;.00nan;0;0
17898;148652;762;100;29;0;29;1.000;3600000;0
17899;189264;4923;0;0;0;0;.00nan;0;0
17899;169615;911;0;0;0;0;.00nan;0;0
17899;176686;4923;69;20;1;19;.950;3600000;0
17899;93756;911;87;41;3;38;.927;3581000;0
17900;279;766;0;0;0;0;.00nan;0;0
17900;-1;4989;0;0;0;0;.00nan;0;0
17900;71485;4989;40;29;5;24;.828;3600000;0
17900;82711;766;93;32;1;31;.969;3600000;0
17901;11614;2197;0;0;0;0;.00nan;0;0
17901;170548;2545;0;0;0;0;.00nan;0;0
17901;94508;2197;67;26;2;24;.923;3600000;0
17901;148829;2545;70;21;1;20;.952;3600000;0
17902;359;759;67;25;3;22;.880;3600000;0
17902;169680;759;0;0;0;0;.00nan;0;0
17902;175757;755;0;0;0;0;.00nan;0;0
17902;180154;755;57;38;5;33;.868;3547000;0
17903;170543;754;90;42;2;40;.952;3570000;0
17903;43971;768;80;24;1;23;.958;3600000;0
17903;82817;768;0;0;0;0;.00nan;0;0
17903;148904;754;0;0;0;0;.00nan;0;0
17904;164424;750;95;28;1;27;.964;3600000;0
17904;164521;750;0;0;0;0;.00nan;0;0
17904;146249;3913;79;37;3;34;.919;3530000;0
17904;148573;3913;0;0;0;0;.00nan;0;0
17905;180606;1497;0;0;0;0;.00nan;0;0
17905;197595;2199;0;0;0;0;.00nan;0;0
17905;76406;2199;75;23;1;22;.957;3600000;0
17905;148576;1497;75;27;2;25;.926;3578000;0
17906;4281;772;0;0;0;0;.00nan;0;0
17906;167061;772;72;34;3;31;.912;3900000;0
17906;142648;769;75;36;3;33;.917;3900000;0
17906;149221;769;0;0;0;0;.00nan;0;0
17907;168089;774;0;0;0;0;.00nan;0;0
17907;-1;4989;0;0;0;0;.00nan;0;0
17907;71485;4989;49;28;4;24;.857;3600000;0
17907;149280;774;64;18;1;17;.944;3600000;0
17908;3508;746;60;17;2;15;.882;3600000;0
17908;11614;2197;0;0;0;0;.00nan;0;0
17908;94508;2197;88;44;3;41;.932;3583000;0
17908;149191;746;0;0;0;0;.00nan;0;0
17909;177124;775;0;0;0;0;.00nan;0;0
17909;189264;4923;93;27;1;26;.963;3900000;0
17909;176686;4923;0;0;0;0;.00nan;0;0
17909;180990;775;100;36;1;35;.972;3900000;0
17910;170530;1492;27;7;3;4;.571;160000;0
17910;67446;1492;78;27;2;25;.926;3440000;0
17910;67818;3721;96;42;2;40;.952;3600000;0
17910;91194;3721;0;0;0;0;.00nan;0;0
17911;3165;767;0;0;0;0;.00nan;0;0
17911;67122;1503;0;0;0;0;.00nan;0;0
17911;68689;1503;64;22;2;20;.909;3553000;0
17911;91358;767;89;33;1;32;.970;3600000;0
17912;1756;758;100;39;1;38;.974;3600000;0
17912;169615;911;76;26;2;24;.923;3541000;0
17912;93756;911;0;0;0;0;.00nan;0;0
17912;94107;758;0;0;0;0;.00nan;0;0
17913;170548;2545;67;19;1;18;.947;3600000;0
17913;85489;760;67;40;4;36;.900;3600000;0
17913;148829;2545;0;0;0;0;.00nan;0;0
17913;149112;760;0;0;0;0;.00nan;0;0
17914;189433;4924;0;0;0;0;.00nan;0;0
17914;175757;755;0;0;0;0;.00nan;0;0
17914;180154;755;83;27;1;26;.963;3600000;0
17914;186219;4924;69;30;3;27;.900;3537000;0
17915;164424;750;59;21;2;19;.905;3600000;0
17915;164521;750;0;0;0;0;.00nan;0;0
17915;170543;754;0;0;0;0;.00nan;0;0
17915;148904;754;77;33;3;30;.909;3573000;0
17916;180606;1497;100;40;1;39;.975;3900000;0
17916;146249;3913;0;0;0;0;.00nan;0;0
17916;148573;3913;95;39;1;38;.974;3900000;0
17916;148576;1497;0;0;0;0;.00nan;0;0
17917;4281;772;0;0;0;0;.00nan;0;0
17917;167061;772;47;37;6;31;.838;3748000;0
17917;197595;2199;58;35;5;30;.857;3748000;0
17917;76406;2199;0;0;0;0;.00nan;0;0
17918;43971;768;56;23;3;20;.870;3600000;0
17918;82817;768;0;0;0;0;.00nan;0;0
17918;142648;769;0;0;0;0;.00nan;0;0
17918;149221;769;70;38;4;34;.895;3570000;0
17919;3508;746;72;21;1;20;.952;3600000;0
17919;85489;760;92;60;5;55;.917;3600000;0
17919;149112;760;0;0;0;0;.00nan;0;0
17919;149191;746;0;0;0;0;.00nan;0;0
17920;177124;775;0;0;0;0;.00nan;0;0
17920;1756;758;91;21;0;21;1.000;3600000;0
17920;180990;775;56;34;5;29;.853;3600000;0
17920;94107;758;0;0;0;0;.00nan;0;0
17921;-1;1093;82;36;2;34;.944;3900000;0
17921;67818;3721;63;24;2;22;.917;3900000;0
17921;68233;1093;0;0;0;0;.00nan;0;0
17921;91194;3721;0;0;0;0;.00nan;0;0
17922;-1;4989;0;0;0;0;.00nan;0;0
17922;170530;1492;32;20;5;15;.750;3517000;0
17922;67446;1492;0;0;0;0;.00nan;0;0
17922;71485;4989;75;32;3;29;.906;3600000;0
17923;3165;767;0;0;0;0;.00nan;0;0
17923;189264;4923;0;0;0;0;.00nan;0;0
17923;176686;4923;71;32;2;30;.938;3600000;0
17923;91358;767;41;32;5;27;.844;3600000;0
17924;11614;2197;0;0;0;0;.00nan;0;0
17924;175757;755;97;28;0;28;1.000;3600000;0
17924;180154;755;0;0;0;0;.00nan;0;0
17924;94508;2197;39;12;3;9;.750;3600000;0
17925;170543;754;0;0;0;0;.00nan;0;0
17925;180606;1497;0;0;0;0;.00nan;0;0
17925;148576;1497;95;35;2;33;.943;3545000;0
17925;148904;754;82;28;1;27;.964;3600000;0
17926;4281;772;0;0;0;0;.00nan;0;0
17926;167061;772;77;21;1;20;.952;3600000;0
17926;146249;3913;0;0;0;0;.00nan;0;0
17926;148573;3913;73;42;4;38;.905;3600000;0
17927;164424;750;36;20;4;16;.800;3600000;0
17927;164521;750;0;0;0;0;.00nan;0;0
17927;142648;769;75;36;3;33;.917;3600000;0
17927;149221;769;0;0;0;0;.00nan;0;0
17928;170548;2545;95;40;2;38;.950;3600000;0
17928;174894;762;0;0;0;0;.00nan;0;0
17928;148652;762;63;27;3;24;.889;3543000;0
17928;148829;2545;0;0;0;0;.00nan;0;0
17929;63529;3730;77;41;4;37;.902;3600000;0
17929;67122;1503;0;0;0;0;.00nan;0;0
17929;68689;1503;20;23;6;17;.739;3600000;0
17929;76628;3730;0;0;0;0;.00nan;0;0
17930;-1;4989;0;0;0;0;.00nan;0;0
17930;-1;1093;79;21;1;20;.952;3600000;0
17930;68233;1093;0;0;0;0;.00nan;0;0
17930;71485;4989;33;35;6;29;.829;3600000;0
17931;1756;758;76;26;3;23;.885;3587000;0
17931;3165;767;94;33;1;32;.970;3600000;0
17931;91358;767;0;0;0;0;.00nan;0;0
17931;94107;758;0;0;0;0;.00nan;0;0
17932;175757;755;64;29;3;26;.897;3565000;0
17932;180154;755;0;0;0;0;.00nan;0;0
17932;85489;760;79;29;2;27;.931;3600000;0
17932;149112;760;0;0;0;0;.00nan;0;0
17933;4281;772;0;0;0;0;.00nan;0;0
17933;167061;772;65;13;1;12;.923;3600000;0
17933;170543;754;0;0;0;0;.00nan;0;0
17933;148904;754;55;27;3;24;.889;3553000;0
17934;197595;2199;57;34;5;29;.853;3600000;0
17934;76406;2199;0;0;0;0;.00nan;0;0
17934;146249;3913;0;0;0;0;.00nan;0;0
17934;148573;3913;91;36;2;34;.944;3600000;0
17935;168089;774;0;0;0;0;.00nan;0;0
17935;189433;4924;28;30;6;24;.800;2791000;0
17935;186219;4924;62;9;0;9;1.000;809000;0
17935;149280;774;59;28;4;24;.857;3600000;0
17936;279;766;53;32;4;28;.875;3600000;0
17936;359;759;0;0;0;0;.00nan;0;0
17936;169680;759;79;32;1;31;.969;3600000;0
17936;82711;766;0;0;0;0;.00nan;0;0
17937;180606;1497;60;38;4;34;.895;3600000;0
17937;142648;769;100;26;0;26;1.000;3600000;0
17937;148576;1497;0;0;0;0;.00nan;0;0
17937;149221;769;0;0;0;0;.00nan;0;0
17938;174894;762;0;0;0;0;.00nan;0;0
17938;63529;3730;76;36;3;33;.917;3600000;0
17938;76628;3730;0;0;0;0;.00nan;0;0
17938;148652;762;95;21;0;21;1.000;3600000;0
17939;189264;4923;68;35;3;32;.914;3600000;0
17939;170548;2545;68;19;1;18;.947;3057000;0
17939;176686;4923;0;0;0;0;.00nan;0;0
17939;148829;2545;30;10;3;7;.700;543000;0
17940;3508;746;59;29;3;26;.897;3569000;0
17940;67122;1503;100;44;2;42;.955;3600000;0
17940;68689;1503;0;0;0;0;.00nan;0;0
17940;149191;746;0;0;0;0;.00nan;0;0
17941;169615;911;97;39;1;38;.974;3600000;0
17941;43971;768;58;20;2;18;.900;3544000;0
17941;82817;768;0;0;0;0;.00nan;0;0
17941;93756;911;0;0;0;0;.00nan;0;0
17942;11614;2197;0;0;0;0;.00nan;0;0
17942;170530;1492;84;25;1;24;.960;3600000;0
17942;67446;1492;0;0;0;0;.00nan;0;0
17942;94508;2197;74;29;2;27;.931;3600000;0
17943;279;766;58;38;5;33;.868;3600000;0
17943;189433;4924;0;0;0;0;.00nan;0;0
17943;186219;4924;48;26;4;22;.846;3600000;0
17943;82711;766;0;0;0;0;.00nan;0;0
17944;359;759;100;29;0;29;1.000;3600000;0
17944;168089;774;0;0;0;0;.00nan;0;0
17944;169680;759;0;0;0;0;.00nan;0;0
17944;149280;774;71;27;2;25;.926;3533000;0
17945;3508;746;64;13;1;12;.923;3600000;0
17945;174894;762;0;0;0;0;.00nan;0;0
17945;148652;762;97;46;2;44;.957;3567000;0
17945;149191;746;0;0;0;0;.00nan;0;0
17946;189264;4923;0;0;0;0;.00nan;0;0
17946;176686;4923;50;14;2;12;.857;3600000;0
17946;63529;3730;98;46;3;43;.935;3576000;0
17946;76628;3730;0;0;0;0;.00nan;0;0
17947;175757;755;0;0;0;0;.00nan;0;0
17947;180154;755;75;30;2;28;.933;3600000;0
17947;67122;1503;0;0;0;0;.00nan;0;0
17947;68689;1503;95;17;0;17;1.000;3600000;0
17948;1756;758;82;37;3;34;.919;3600000;0
17948;170548;2545;58;35;4;31;.886;3543000;0
17948;94107;758;0;0;0;0;.00nan;0;0
17948;148829;2545;0;0;0;0;.00nan;0;0
17949;177124;775;0;0;0;0;.00nan;0;0
17949;180990;775;83;37;2;35;.946;3600000;0
17949;43971;768;70;19;1;18;.947;3600000;0
17949;82817;768;0;0;0;0;.00nan;0;0
17950;164424;750;77;33;2;31;.939;3600000;0
17950;164521;750;0;0;0;0;.00nan;0;0
17950;169615;911;0;0;0;0;.00nan;0;0
17950;93756;911;30;27;5;22;.815;3600000;0
17951;279;766;72;21;2;19;.905;3547000;0
17951;11614;2197;0;0;0;0;.00nan;0;0
17951;82711;766;0;0;0;0;.00nan;0;0
17951;94508;2197;91;28;1;27;.964;3600000;0
17952;168089;774;0;0;0;0;.00nan;0;0
17952;85489;760;0;0;0;0;.00nan;0;0
17952;149112;760;83;28;1;27;.964;3600000;0
17952;149280;774;86;14;0;14;1.000;3600000;0
17953;170543;754;85;16;0;16;1.000;3600000;0
17953;146249;3913;0;0;0;0;.00nan;0;0
17953;148573;3913;80;29;1;28;.966;3573000;0
17953;148904;754;0;0;0;0;.00nan;0;0
17954;189433;4924;100;49;1;48;.980;3600000;0
17954;170530;1492;79;27;2;25;.926;3548000;0
17954;186219;4924;0;0;0;0;.00nan;0;0
17954;67446;1492;0;0;0;0;.00nan;0;0
17955;359;759;100;28;0;28;1.000;3600000;0
17955;-1;1093;22;19;6;13;.684;2526000;0
17955;169680;759;0;0;0;0;.00nan;0;0
17955;68233;1093;33;12;3;9;.750;1074000;0
17956;174894;762;0;0;0;0;.00nan;0;0
17956;175757;755;0;0;0;0;.00nan;0;0
17956;180154;755;93;34;1;33;.971;3600000;0
17956;148652;762;47;32;4;28;.875;3600000;0
17957;3508;746;76;24;1;23;.958;3600000;0
17957;189264;4923;0;0;0;0;.00nan;0;0
17957;176686;4923;100;31;0;31;1.000;3600000;0
17957;149191;746;0;0;0;0;.00nan;0;0
17958;170548;2545;0;0;0;0;.00nan;0;0
17958;67122;1503;63;21;2;19;.905;3900000;0
17958;68689;1503;0;0;0;0;.00nan;0;0
17958;148829;2545;100;40;2;38;.950;3900000;0
17959;1756;758;85;17;0;17;1.000;3600000;0
17959;63529;3730;73;25;1;24;.960;3600000;0
17959;76628;3730;0;0;0;0;.00nan;0;0
17959;94107;758;0;0;0;0;.00nan;0;0
17960;-1;4989;61;28;2;26;.929;3863000;0
17960;67818;3721;62;27;3;24;.889;3880000;0
17960;71485;4989;0;0;0;0;.00nan;0;0
17960;91194;3721;0;0;0;0;.00nan;0;0
17961;3165;767;0;0;0;0;.00nan;0;0
17961;43971;768;52;15;2;13;.867;3554000;0
17961;82817;768;0;0;0;0;.00nan;0;0
17961;91358;767;98;40;1;39;.975;3600000;0
17962;177124;775;0;0;0;0;.00nan;0;0
17962;164424;750;87;19;0;19;1.000;3600000;0
17962;164521;750;0;0;0;0;.00nan;0;0
17962;180990;775;71;40;3;37;.925;3600000;0
17963;169615;911;45;25;5;20;.800;3555000;0
17963;180606;1497;0;0;0;0;.00nan;0;0
17963;93756;911;0;0;0;0;.00nan;0;0
17963;148576;1497;85;34;3;31;.912;3600000;0
17964;11614;2197;0;0;0;0;.00nan;0;0
17964;168089;774;0;0;0;0;.00nan;0;0
17964;94508;2197;88;34;2;32;.941;3568000;0
17964;149280;774;79;20;1;19;.950;3600000;0
17965;279;766;87;34;2;32;.941;3545000;0
17965;82711;766;0;0;0;0;.00nan;0;0
17965;85489;760;94;30;1;29;.967;3600000;0
17965;149112;760;0;0;0;0;.00nan;0;0
17966;142648;769;78;21;2;19;.905;3900000;0
17966;146249;3913;66;27;2;25;.926;3900000;0
17966;148573;3913;0;0;0;0;.00nan;0;0
17966;149221;769;0;0;0;0;.00nan;0;0
17967;-1;1093;55;11;1;10;.909;3600000;0
17967;189433;4924;0;0;0;0;.00nan;0;0
17967;186219;4924;72;52;5;47;.904;3600000;0
17967;68233;1093;0;0;0;0;.00nan;0;0
17968;170543;754;63;35;4;31;.886;3900000;0
17968;197595;2199;52;21;4;17;.810;3900000;0
17968;76406;2199;0;0;0;0;.00nan;0;0
17968;148904;754;0;0;0;0;.00nan;0;0
17969;359;759;59;30;4;26;.867;3587000;0
17969;169680;759;0;0;0;0;.00nan;0;0
17969;170530;1492;0;0;0;0;.00nan;0;0
17969;67446;1492;83;38;3;35;.921;3600000;0
17970;189264;4923;0;0;0;0;.00nan;0;0
17970;175757;755;62;34;4;30;.882;3600000;0
17970;176686;4923;76;23;1;22;.957;3600000;0
17970;180154;755;0;0;0;0;.00nan;0;0
17971;4281;772;54;9;1;8;.889;3600000;0
17971;167061;772;0;0;0;0;.00nan;0;0
17971;169615;911;0;0;0;0;.00nan;0;0
17971;93756;911;81;30;3;27;.900;3565000;0
17972;1756;758;97;50;2;48;.960;3600000;0
17972;3508;746;100;20;0;20;1.000;3600000;0
17972;94107;758;0;0;0;0;.00nan;0;0
17972;149191;746;0;0;0;0;.00nan;0;0
17973;3165;767;0;0;0;0;.00nan;0;0
17973;164424;750;64;32;3;29;.906;3600000;0
17973;164521;750;0;0;0;0;.00nan;0;0
17973;91358;767;46;26;5;21;.808;3600000;0
17974;177124;775;0;0;0;0;.00nan;0;0
17974;180606;1497;0;0;0;0;.00nan;0;0
17974;180990;775;78;33;2;31;.939;3600000;0
17974;148576;1497;44;36;5;31;.861;3600000;0
17975;11614;2197;0;0;0;0;.00nan;0;0
17975;-1;1093;83;40;2;38;.950;3600000;0
17975;68233;1093;0;0;0;0;.00nan;0;0
17975;94508;2197;41;18;3;15;.833;3600000;0
17976;170530;1492;25;6;3;3;.500;485000;0
17976;67446;1492;82;31;2;29;.935;3115000;0
17976;85489;760;71;26;1;25;.962;3600000;0
17976;149112;760;0;0;0;0;.00nan;0;0
17977;197595;2199;79;21;1;20;.952;3600000;0
17977;76406;2199;0;0;0;0;.00nan;0;0
17977;142648;769;0;0;0;0;.00nan;0;0
17977;149221;769;53;35;5;30;.857;3600000;0
17978;177124;775;0;0;0;0;.00nan;0;0
17978;4281;772;0;0;0;0;.00nan;0;0
17978;180990;775;73;19;1;18;.947;3600000;0
17978;63932;772;55;48;6;42;.875;3600000;0
17979;1756;758;66;21;2;19;.905;3600000;0
17979;175757;755;0;0;0;0;.00nan;0;0
17979;180154;755;72;39;3;36;.923;3566000;0
17979;94107;758;0;0;0;0;.00nan;0;0
17980;3165;767;0;0;0;0;.00nan;0;0
17980;180606;1497;65;28;2;26;.929;3600000;0
17980;91358;767;39;28;5;23;.821;3600000;0
17980;148576;1497;0;0;0;0;.00nan;0;0
17981;170543;754;58;28;4;24;.857;3600000;0
17981;142648;769;41;27;5;22;.815;3543000;0
17981;148904;754;0;0;0;0;.00nan;0;0
17981;149221;769;0;0;0;0;.00nan;0;0
17982;-1;1093;100;29;0;29;1.000;3600000;0
17982;68233;1093;0;0;0;0;.00nan;0;0
17982;85489;760;91;44;3;41;.932;3600000;0
17982;149112;760;0;0;0;0;.00nan;0;0
17983;3165;767;0;0;0;0;.00nan;0;0
17983;4281;772;0;0;0;0;.00nan;0;0
17983;63932;772;80;29;2;27;.931;3600000;0
17983;91358;767;53;34;4;30;.882;3556000;0
17984;-1;4989;0;0;0;0;.00nan;0;0
17984;189433;4924;55;20;2;18;.900;3900000;0
17984;186219;4924;0;0;0;0;.00nan;0;0
17984;71485;4989;89;36;2;34;.944;3900000;0
17985;169615;911;74;20;1;19;.950;3881000;0
17985;93756;911;0;0;0;0;.00nan;0;0
17985;146249;3913;0;0;0;0;.00nan;0;0
17985;148573;3913;94;45;2;43;.956;3881000;0
17986;170548;2545;71;22;2;20;.909;3600000;0
17986;43971;768;60;33;4;29;.879;3540000;0
17986;82817;768;0;0;0;0;.00nan;0;0
17986;148829;2545;0;0;0;0;.00nan;0;0
17987;168089;774;0;0;0;0;.00nan;0;0
17987;174894;762;0;0;0;0;.00nan;0;0
17987;148652;762;46;30;4;26;.867;3600000;0
17987;149280;774;93;19;0;19;1.000;3600000;0
17988;189264;4923;85;27;1;26;.963;3581000;0
17988;170530;1492;0;0;0;0;.00nan;0;0
17988;176686;4923;0;0;0;0;.00nan;0;0
17988;67446;1492;99;25;0;25;1.000;3600000;0
17989;279;766;0;0;0;0;.00nan;0;0
17989;67122;1503;0;0;0;0;.00nan;0;0
17989;68689;1503;61;41;5;36;.878;3561000;0
17989;82711;766;48;23;3;20;.870;3600000;0
17990;3508;746;78;26;1;25;.962;3600000;0
17990;164424;750;87;39;2;37;.949;3545000;0
17990;164521;750;0;0;0;0;.00nan;0;0
17990;149191;746;0;0;0;0;.00nan;0;0
17991;177124;775;91;32;2;30;.938;3597000;0
17991;180990;775;0;0;0;0;.00nan;0;0
17991;146249;3913;0;0;0;0;.00nan;0;0
17991;148573;3913;94;31;1;30;.968;3600000;0
17992;359;759;31;18;4;14;.778;3838000;0
17992;-1;4989;0;0;0;0;.00nan;0;0
17992;169680;759;0;0;0;0;.00nan;0;0
17992;71485;4989;72;45;5;40;.889;3838000;0
17993;43971;768;95;24;0;24;1.000;3600000;0
17993;63529;3730;0;0;0;0;.00nan;0;0
17993;76628;3730;74;46;5;41;.891;3600000;0
17993;82817;768;0;0;0;0;.00nan;0;0
17994;189433;4924;0;0;0;0;.00nan;0;0
17994;186219;4924;69;49;5;44;.898;3600000;0
17994;67818;3721;0;0;0;0;.00nan;0;0
17994;91194;3721;65;13;1;12;.923;3600000;0
17995;169615;911;0;0;0;0;.00nan;0;0
17995;197595;2199;79;32;2;30;.938;3887000;0
17995;76406;2199;0;0;0;0;.00nan;0;0
17995;93756;911;72;29;2;27;.931;3900000;0
17996;170548;2545;0;0;0;0;.00nan;0;0
17996;180606;1497;0;0;0;0;.00nan;0;0
17996;148576;1497;75;33;3;30;.909;3600000;0
17996;148829;2545;85;14;0;14;1.000;3600000;0
17997;168089;774;0;0;0;0;.00nan;0;0
17997;67122;1503;81;36;2;34;.944;3900000;0
17997;68689;1503;0;0;0;0;.00nan;0;0
17997;149280;774;58;18;2;16;.889;3900000;0
17998;189264;4923;64;28;3;25;.893;3600000;0
17998;-1;1093;48;27;4;23;.852;3543000;0
17998;176686;4923;0;0;0;0;.00nan;0;0
17998;68233;1093;0;0;0;0;.00nan;0;0
17999;170530;1492;0;0;0;0;.00nan;0;0
17999;174894;762;0;0;0;0;.00nan;0;0
17999;67446;1492;55;30;4;26;.867;3580000;0
17999;148652;762;76;22;2;20;.909;3600000;0
18000;279;766;40;21;4;17;.810;3600000;0
18000;1756;758;20;29;7;22;.759;3600000;0
18000;82711;766;0;0;0;0;.00nan;0;0
18000;94107;758;0;0;0;0;.00nan;0;0
18001;3508;746;70;28;2;26;.929;3600000;0
18001;43971;768;56;33;4;29;.879;3517000;0
18001;82817;768;0;0;0;0;.00nan;0;0
18001;149191;746;0;0;0;0;.00nan;0;0
18002;177124;775;0;0;0;0;.00nan;0;0
18002;180990;775;72;33;3;30;.909;3569000;0
18002;197595;2199;64;21;2;19;.905;3600000;0
18002;76406;2199;0;0;0;0;.00nan;0;0
18003;-1;4989;0;0;0;0;.00nan;0;0
18003;71485;4989;69;44;5;39;.886;3600000;0
18003;85489;760;68;27;2;25;.926;3600000;0
18003;149112;760;0;0;0;0;.00nan;0;0
18004;180606;1497;0;0;0;0;.00nan;0;0
18004;63529;3730;53;34;5;29;.853;3522000;0
18004;76628;3730;0;0;0;0;.00nan;0;0
18004;148576;1497;54;23;3;20;.870;3600000;0
18005;359;759;60;20;3;17;.850;3719000;0
18005;169680;759;0;0;0;0;.00nan;0;0
18005;67818;3721;97;31;2;29;.935;3719000;0
18005;91194;3721;0;0;0;0;.00nan;0;0
18006;3165;767;60;28;4;24;.857;3563000;0
18006;91358;767;0;0;0;0;.00nan;0;0
18006;146249;3913;0;0;0;0;.00nan;0;0
18006;148573;3913;84;33;2;31;.939;3600000;0
18007;169615;911;67;45;5;40;.889;3554000;0
18007;170543;754;55;28;4;24;.857;3600000;0
18007;93756;911;0;0;0;0;.00nan;0;0
18007;148904;754;0;0;0;0;.00nan;0;0
18008;167061;772;0;0;0;0;.00nan;0;0
18008;170548;2545;100;34;1;33;.971;3897000;0
18008;63932;772;68;28;2;26;.929;3897000;0
18008;148829;2545;0;0;0;0;.00nan;0;0
18009;164424;750;90;18;0;18;1.000;3600000;0
18009;164521;750;0;0;0;0;.00nan;0;0
18009;175757;755;93;44;2;42;.955;3588000;0
18009;180154;755;0;0;0;0;.00nan;0;0
18010;1756;758;53;40;6;34;.850;3600000;0
18010;168089;774;77;23;1;22;.957;3600000;0
18010;94107;758;0;0;0;0;.00nan;0;0
18010;149280;774;0;0;0;0;.00nan;0;0
18011;-1;1093;49;1;0;1;1.000;357000;0
18011;174894;762;0;0;0;0;.00nan;0;0
18011;68233;1093;36;34;6;28;.824;3243000;0
18011;148652;762;72;28;2;26;.929;3600000;0
18012;170530;1492;65;27;3;24;.889;3600000;0
18012;67122;1503;0;0;0;0;.00nan;0;0
18012;67446;1492;0;0;0;0;.00nan;0;0
18012;68689;1503;81;31;2;29;.935;3600000;0
18013;279;766;72;22;1;21;.955;3600000;0
18013;189264;4923;0;0;0;0;.00nan;0;0
18013;176686;4923;46;30;4;26;.867;3600000;0
18013;82711;766;0;0;0;0;.00nan;0;0
18014;3508;746;61;14;1;13;.929;3600000;0
18014;180606;1497;73;44;4;40;.909;3600000;0
18014;148576;1497;0;0;0;0;.00nan;0;0
18014;149191;746;0;0;0;0;.00nan;0;0
18015;177124;775;0;0;0;0;.00nan;0;0
18015;170543;754;72;39;3;36;.923;3600000;0
18015;180990;775;59;31;4;27;.871;3600000;0
18015;148904;754;0;0;0;0;.00nan;0;0
18016;3241;2197;0;0;0;0;.00nan;0;0
18016;-1;4989;100;23;0;23;1.000;3600000;0
18016;71485;4989;0;0;0;0;.00nan;0;0
18016;94508;2197;93;34;1;33;.971;3585000;0
18017;167061;772;43;22;4;18;.818;3532000;0
18017;63529;3730;72;32;2;30;.938;3600000;0
18017;63932;772;0;0;0;0;.00nan;0;0
18017;76628;3730;0;0;0;0;.00nan;0;0
18018;67818;3721;57;30;4;26;.867;3543000;0
18018;85489;760;80;35;2;33;.943;3600000;0
18018;91194;3721;0;0;0;0;.00nan;0;0
18018;149112;760;0;0;0;0;.00nan;0;0
18019;3165;767;0;0;0;0;.00nan;0;0
18019;197595;2199;0;0;0;0;.00nan;0;0
18019;76406;2199;72;19;1;18;.947;3600000;0
18019;91358;767;69;33;2;31;.939;3600000;0
18020;169615;911;0;0;0;0;.00nan;0;0
18020;93756;911;100;42;2;40;.952;3900000;0
18020;142648;769;74;24;2;22;.917;3900000;0
18020;149221;769;0;0;0;0;.00nan;0;0
18021;164424;750;85;20;1;19;.950;3600000;0
18021;164521;750;0;0;0;0;.00nan;0;0
18021;170548;2545;0;0;0;0;.00nan;0;0
18021;148829;2545;85;43;4;39;.907;3600000;0
18022;175757;755;58;14;1;13;.929;1345000;0
18022;180154;755;59;35;4;31;.886;2255000;0
18022;43971;768;68;16;1;15;.938;3600000;0
18022;82817;768;0;0;0;0;.00nan;0;0
18023;168089;774;0;0;0;0;.00nan;0;0
18023;189264;4923;85;40;3;37;.925;3600000;0
18023;176686;4923;0;0;0;0;.00nan;0;0
18023;149280;774;78;14;0;14;1.000;3600000;0
18024;-1;1093;74;43;3;40;.930;3600000;0
18024;67122;1503;50;15;2;13;.867;3600000;0
18024;68233;1093;0;0;0;0;.00nan;0;0
18024;68689;1503;0;0;0;0;.00nan;0;0
18025;1756;758;97;40;2;38;.950;3600000;0
18025;170530;1492;0;0;0;0;.00nan;0;0
18025;67446;1492;70;29;3;26;.897;3563000;0
18025;94107;758;0;0;0;0;.00nan;0;0
18026;279;766;0;0;0;0;.00nan;0;0
18026;174894;762;0;0;0;0;.00nan;0;0
18026;82711;766;68;34;3;31;.912;3600000;0
18026;148652;762;58;41;5;36;.878;3524000;0
18027;3508;746;94;27;1;26;.963;3548000;0
18027;167061;772;100;37;0;37;1.000;3600000;0
18027;63932;772;0;0;0;0;.00nan;0;0
18027;149191;746;0;0;0;0;.00nan;0;0
18028;177124;775;0;0;0;0;.00nan;0;0
18028;180990;775;52;19;3;16;.842;3600000;0
18028;142648;769;83;18;0;18;1.000;3600000;0
18028;149221;769;0;0;0;0;.00nan;0;0
18029;4281;3730;0;0;0;0;.00nan;0;0
18029;164424;750;67;16;1;15;.938;3600000;0
18029;164521;750;0;0;0;0;.00nan;0;0
18029;63529;3730;53;27;3;24;.889;3573000;0
18030;3241;2197;0;0;0;0;.00nan;0;0
18030;67818;3721;52;25;3;22;.880;3600000;0
18030;91194;3721;0;0;0;0;.00nan;0;0
18030;94508;2197;75;44;4;40;.909;3544000;0
18031;3165;767;0;0;0;0;.00nan;0;0
18031;170543;754;100;26;0;26;1.000;3600000;0
18031;91358;767;76;20;1;19;.950;3600000;0
18031;148904;754;0;0;0;0;.00nan;0;0
18032;175757;755;0;0;0;0;.00nan;0;0
18032;180154;755;80;38;2;36;.947;3900000;0
18032;180606;1497;0;0;0;0;.00nan;0;0
18032;148576;1497;59;18;2;16;.889;3900000;0
18033;1756;758;78;21;1;20;.952;3600000;0
18033;-1;1093;82;28;2;26;.929;3543000;0
18033;68233;1093;0;0;0;0;.00nan;0;0
18033;94107;758;0;0;0;0;.00nan;0;0
18034;359;759;66;24;2;22;.917;3600000;0
18034;189433;4924;64;34;3;31;.912;3573000;0
18034;169680;759;0;0;0;0;.00nan;0;0
18034;186219;4924;0;0;0;0;.00nan;0;0
18035;3165;767;0;0;0;0;.00nan;0;0
18035;91358;767;33;33;6;27;.818;3600000;0
18035;142648;769;81;22;1;21;.955;3600000;0
18035;149221;769;0;0;0;0;.00nan;0;0
18036;197595;2199;74;38;4;34;.895;3567000;0
18036;76406;2199;0;0;0;0;.00nan;0;0
18036;146249;3913;0;0;0;0;.00nan;0;0
18036;148573;3913;58;17;2;15;.882;3600000;0
18037;167061;772;73;36;3;33;.917;3600000;0
18037;175757;755;51;34;5;29;.853;3532000;0
18037;180154;755;0;0;0;0;.00nan;0;0
18037;63932;772;0;0;0;0;.00nan;0;0
18038;168089;774;0;0;0;0;.00nan;0;0
18038;174894;762;74;52;5;47;.904;3600000;0
18038;148652;762;0;0;0;0;.00nan;0;0
18038;149280;774;75;9;0;9;1.000;3600000;0
18039;189264;4923;0;0;0;0;.00nan;0;0
18039;170530;1492;67;42;4;38;.905;3585000;0
18039;176686;4923;46;14;3;11;.786;3600000;0
18039;67446;1492;0;0;0;0;.00nan;0;0
18040;-1;4989;0;0;0;0;.00nan;0;0
18040;71485;4989;73;46;5;41;.891;3600000;0
18040;85489;760;66;19;1;18;.947;3600000;0
18040;149112;760;0;0;0;0;.00nan;0;0
18041;177124;775;0;0;0;0;.00nan;0;0
18041;170543;754;86;30;1;29;.967;3600000;0
18041;180990;775;64;28;3;25;.893;3534000;0
18041;148904;754;0;0;0;0;.00nan;0;0
18042;3508;746;39;24;5;19;.792;3600000;0
18042;43971;768;92;35;1;34;.971;3600000;0
18042;82817;768;0;0;0;0;.00nan;0;0
18042;149191;746;0;0;0;0;.00nan;0;0
18043;164424;750;79;28;1;27;.964;3600000;0
18043;164521;750;0;0;0;0;.00nan;0;0
18043;170548;2545;71;39;4;35;.897;3600000;0
18043;148829;2545;0;0;0;0;.00nan;0;0
18044;169615;911;60;36;4;32;.889;3600000;0
18044;197595;2199;0;0;0;0;.00nan;0;0
18044;76406;2199;100;42;1;41;.976;3600000;0
18044;93756;911;0;0;0;0;.00nan;0;0
18045;4281;3730;0;0;0;0;.00nan;0;0
18045;180606;1497;57;26;4;22;.846;3900000;0
18045;63529;3730;79;38;4;34;.895;3900000;0
18045;148576;1497;0;0;0;0;.00nan;0;0
18046;279;766;100;29;0;29;1.000;3600000;0
18046;174894;762;0;0;0;0;.00nan;0;0
18046;82711;766;0;0;0;0;.00nan;0;0
18046;148652;762;91;40;2;38;.950;3577000;0
18047;8504;774;0;0;0;0;.00nan;0;0
18047;189264;4923;66;32;3;29;.906;3600000;0
18047;176686;4923;0;0;0;0;.00nan;0;0
18047;149280;774;38;20;4;16;.800;3544000;0
18048;3241;2197;0;0;0;0;.00nan;0;0
18048;-1;4989;0;0;0;0;.00nan;0;0
18048;71485;4989;92;23;0;23;1.000;3600000;0
18048;94508;2197;64;27;3;24;.889;3600000;0
18049;-1;1093;44;24;4;20;.833;3600000;0
18049;67122;1503;0;0;0;0;.00nan;0;0
18049;68233;1093;0;0;0;0;.00nan;0;0
18049;68689;1503;93;18;0;18;1.000;3600000;0
18050;1756;758;0;0;0;0;.00nan;0;0
18050;170530;1492;0;0;0;0;.00nan;0;0
18050;67446;1492;85;48;3;45;.938;3600000;0
18050;94107;758;60;17;2;15;.882;3600000;0
18051;67818;3721;87;16;0;16;1.000;3900000;0
18051;85489;760;0;0;0;0;.00nan;0;0
18051;91194;3721;0;0;0;0;.00nan;0;0
18051;149112;760;85;25;0;25;1.000;3900000;0
18052;3165;767;0;0;0;0;.00nan;0;0
18052;170543;754;0;0;0;0;.00nan;0;0
18052;91358;767;83;31;2;29;.935;3900000;0
18052;148904;754;74;29;2;27;.931;3900000;0
18053;4281;3730;0;0;0;0;.00nan;0;0
18053;167061;772;0;0;0;0;.00nan;0;0
18053;63529;3730;63;22;2;20;.909;3600000;0
18053;63932;772;67;28;3;25;.893;3555000;0
18054;169615;911;0;0;0;0;.00nan;0;0
18054;93756;911;100;27;0;27;1.000;3900000;0
18054;146249;3913;0;0;0;0;.00nan;0;0
18054;148573;3913;96;24;0;24;1.000;3900000;0
18055;175757;755;0;0;0;0;.00nan;0;0
18055;180154;755;57;45;6;39;.867;3600000;0
18055;43971;768;95;21;0;21;1.000;3600000;0
18055;82817;768;0;0;0;0;.00nan;0;0
18056;3508;746;26;6;3;3;.500;571000;0
18056;164424;750;100;37;0;37;1.000;3600000;0
18056;164521;750;0;0;0;0;.00nan;0;0
18056;149191;746;70;24;2;22;.917;3029000;0
18057;170548;2545;0;0;0;0;.00nan;0;0
18057;180606;1497;0;0;0;0;.00nan;0;0
18057;148576;1497;82;29;1;28;.966;3557000;0
18057;148829;2545;94;17;0;17;1.000;3600000;0
18058;177124;775;0;0;0;0;.00nan;0;0
18058;180990;775;88;44;4;40;.909;3562000;0
18058;142648;769;0;0;0;0;.00nan;0;0
18058;149221;769;62;23;3;20;.870;3600000;0
18059;-1;1093;52;22;3;19;.864;3577000;0
18059;174894;762;91;33;1;32;.970;3600000;0
18059;68233;1093;0;0;0;0;.00nan;0;0
18059;148652;762;0;0;0;0;.00nan;0;0
18060;279;766;89;32;1;31;.969;3600000;0
18060;189264;4923;58;3;0;3;1.000;402000;0
18060;176686;4923;42;32;6;26;.813;3198000;0
18060;82711;766;0;0;0;0;.00nan;0;0
18061;3241;2197;83;26;1;25;.962;2973000;0
18061;67818;3721;50;15;2;13;.867;3600000;0
18061;91194;3721;0;0;0;0;.00nan;0;0
18061;94508;2197;39;13;3;10;.769;577000;0
18062;170530;1492;0;0;0;0;.00nan;0;0
18062;67122;1503;0;0;0;0;.00nan;0;0
18062;67446;1492;78;34;3;31;.912;3600000;0
18062;68689;1503;63;25;2;23;.920;3600000;0
18063;1756;758;77;31;2;29;.935;3600000;0
18063;8504;774;0;0;0;0;.00nan;0;0
18063;94107;758;0;0;0;0;.00nan;0;0
18063;149280;774;50;19;3;16;.842;3552000;0
18064;359;759;61;27;3;24;.889;3900000;0
18064;-1;4989;0;0;0;0;.00nan;0;0
18064;169680;759;0;0;0;0;.00nan;0;0
18064;71485;4989;65;33;3;30;.909;3900000;0
18065;169615;911;0;0;0;0;.00nan;0;0
18065;170543;754;90;36;1;35;.972;3588000;0
18065;93756;911;98;23;0;23;1.000;3600000;0
18065;148904;754;0;0;0;0;.00nan;0;0
18066;167061;772;0;0;0;0;.00nan;0;0
18066;170548;2545;86;25;1;24;.960;3544000;0
18066;63932;772;100;32;0;32;1.000;3600000;0
18066;148829;2545;0;0;0;0;.00nan;0;0
18067;4281;3730;0;0;0;0;.00nan;0;0
18067;43971;768;77;17;1;16;.941;3600000;0
18067;63529;3730;98;64;4;60;.938;3600000;0
18067;82817;768;0;0;0;0;.00nan;0;0
18068;164424;750;53;16;2;14;.875;3600000;0
18068;164521;750;0;0;0;0;.00nan;0;0
18068;175757;755;100;51;1;50;.980;3600000;0
18068;180154;755;0;0;0;0;.00nan;0;0
18069;177124;775;0;0;0;0;.00nan;0;0
18069;180990;775;72;26;1;25;.962;3600000;0
18069;197595;2199;71;31;4;27;.871;3600000;0
18069;76406;2199;0;0;0;0;.00nan;0;0
18070;3508;746;56;24;3;21;.875;3900000;0
18070;180606;1497;79;45;3;42;.933;3900000;0
18070;148576;1497;0;0;0;0;.00nan;0;0
18070;149191;746;0;0;0;0;.00nan;0;0
18071;3165;767;0;0;0;0;.00nan;0;0
18071;91358;767;73;22;1;21;.955;3600000;0
18071;142648;769;55;35;5;30;.857;3600000;0
18071;149221;769;0;0;0;0;.00nan;0;0
18072;170530;1492;79;24;1;23;.958;3542000;0
18072;174894;762;0;0;0;0;.00nan;0;0
18072;67446;1492;0;0;0;0;.00nan;0;0
18072;148652;762;85;17;0;17;1.000;3600000;0
18073;189264;4923;58;18;2;16;.889;3600000;0
18073;-1;1093;26;22;5;17;.773;3600000;0
18073;176686;4923;0;0;0;0;.00nan;0;0
18073;68233;1093;0;0;0;0;.00nan;0;0
18074;8504;774;0;0;0;0;.00nan;0;0
18074;67122;1503;0;0;0;0;.00nan;0;0
18074;68689;1503;72;26;2;24;.923;3561000;0
18074;149280;774;77;18;1;17;.944;3600000;0
18075;279;766;40;15;3;12;.800;3600000;0
18075;1756;758;52;42;5;37;.881;3565000;0
18075;82711;766;0;0;0;0;.00nan;0;0
18075;94107;758;0;0;0;0;.00nan;0;0
18076;-1;4989;0;0;0;0;.00nan;0;0
18076;189433;4924;0;0;0;0;.00nan;0;0
18076;186219;4924;27;28;5;23;.821;3572000;0
18076;71485;4989;68;35;4;31;.886;3600000;0
18077;359;759;39;34;6;28;.824;3600000;0
18077;169680;759;0;0;0;0;.00nan;0;0
18077;67818;3721;61;25;2;23;.920;3600000;0
18077;91194;3721;0;0;0;0;.00nan;0;0
18078;3508;746;53;24;3;21;.875;3600000;0
18078;167061;772;0;0;0;0;.00nan;0;0
18078;63932;772;89;44;4;40;.909;3600000;0
18078;149191;746;0;0;0;0;.00nan;0;0
18079;177124;775;0;0;0;0;.00nan;0;0
18079;180990;775;72;31;3;28;.903;3900000;0
18079;146249;3913;0;0;0;0;.00nan;0;0
18079;148573;3913;67;28;3;25;.893;3900000;0
18080;170548;2545;38;21;4;17;.810;1248000;0
18080;43971;768;89;23;1;22;.957;3600000;0
18080;82817;768;0;0;0;0;.00nan;0;0
18080;148829;2545;45;30;5;25;.833;2352000;0
18081;4281;3730;0;0;0;0;.00nan;0;0
18081;164424;750;0;0;0;0;.00nan;0;0
18081;164521;750;82;28;1;27;.964;3600000;0
18081;63529;3730;85;36;2;34;.944;3553000;0
18082;3165;767;0;0;0;0;.00nan;0;0
18082;197595;2199;56;29;4;25;.862;3900000;0
18082;76406;2199;0;0;0;0;.00nan;0;0
18082;91358;767;62;33;4;29;.879;3900000;0
18083;175757;755;47;31;5;26;.839;3558000;0
18083;180154;755;0;0;0;0;.00nan;0;0
18083;180606;1497;0;0;0;0;.00nan;0;0
18083;148576;1497;60;33;4;29;.879;3600000;0
18084;169615;911;0;0;0;0;.00nan;0;0
18084;93756;911;50;26;4;22;.846;3582000;0
18084;142648;769;0;0;0;0;.00nan;0;0
18084;149221;769;70;33;3;30;.909;3600000;0
18085;279;766;97;41;2;39;.951;3600000;0
18085;67122;1503;21;22;6;16;.727;3142000;0
18085;68689;1503;60;7;0;7;1.000;458000;0
18085;82711;766;0;0;0;0;.00nan;0;0
18086;1756;758;71;35;4;31;.886;3600000;0
18086;-1;1093;93;20;0;20;1.000;3600000;0
18086;68233;1093;0;0;0;0;.00nan;0;0
18086;94107;758;0;0;0;0;.00nan;0;0
18087;189433;4924;86;46;3;43;.935;3615000;0
18087;186219;4924;0;0;0;0;.00nan;0;0
18087;67818;3721;43;17;4;13;.765;3615000;0
18087;91194;3721;0;0;0;0;.00nan;0;0
18088;167061;772;0;0;0;0;.00nan;0;0
18088;175757;755;0;0;0;0;.00nan;0;0
18088;180154;755;73;35;3;32;.914;3900000;0
18088;63932;772;44;22;3;19;.864;3900000;0
18089;3165;767;0;0;0;0;.00nan;0;0
18089;91358;767;56;25;3;22;.880;3600000;0
18089;146249;3913;0;0;0;0;.00nan;0;0
18089;148573;3913;71;28;2;26;.929;3600000;0
18090;170543;754;72;43;3;40;.930;3600000;0
18090;142648;769;100;23;0;23;1.000;3600000;0
18090;148904;754;0;0;0;0;.00nan;0;0
18090;149221;769;0;0;0;0;.00nan;0;0
18091;8504;774;0;0;0;0;.00nan;0;0
18091;85489;760;67;38;4;34;.895;3600000;0
18091;149112;760;0;0;0;0;.00nan;0;0
18091;149280;774;84;16;0;16;1.000;3600000;0
18092;3241;2197;0;0;0;0;.00nan;0;0
18092;170530;1492;96;37;1;36;.973;3600000;0
18092;67446;1492;0;0;0;0;.00nan;0;0
18092;94508;2197;61;24;2;22;.917;3561000;0
18093;3508;746;0;0;0;0;.00nan;0;0
18093;189264;4923;0;0;0;0;.00nan;0;0
18093;176686;4923;50;24;3;21;.875;3565000;0
18093;149191;746;90;37;2;35;.946;3600000;0
18094;177124;775;76;31;2;29;.935;3600000;0
18094;180606;1497;0;0;0;0;.00nan;0;0
18094;180990;775;0;0;0;0;.00nan;0;0
18094;148576;1497;41;30;5;25;.833;3600000;0
18095;164424;750;72;38;3;35;.921;3900000;0
18095;164521;750;0;0;0;0;.00nan;0;0
18095;43971;768;0;0;0;0;.00nan;0;0
18095;82817;768;53;18;3;15;.833;3900000;0
18096;4281;3730;0;0;0;0;.00nan;0;0
18096;174894;762;65;25;2;23;.920;3600000;0
18096;63529;3730;73;32;3;29;.906;3594000;0
18096;148652;762;0;0;0;0;.00nan;0;0
18097;8504;774;0;0;0;0;.00nan;0;0
18097;189433;4924;51;8;1;7;.875;1517000;0
18097;186219;4924;19;23;6;17;.739;2083000;0
18097;149280;774;43;12;2;10;.833;3600000;0
18098;3241;2197;0;0;0;0;.00nan;0;0
18098;-1;1093;43;27;5;22;.815;3557000;0
18098;68233;1093;0;0;0;0;.00nan;0;0
18098;94508;2197;58;31;4;27;.871;3600000;0
18099;170530;1492;0;0;0;0;.00nan;0;0
18099;67446;1492;82;35;2;33;.943;3600000;0
18099;85489;760;82;24;1;23;.958;3600000;0
18099;149112;760;0;0;0;0;.00nan;0;0
18100;279;766;0;0;0;0;.00nan;0;0
18100;359;759;57;29;4;25;.862;3600000;0
18100;169680;759;0;0;0;0;.00nan;0;0
18100;82711;766;94;30;1;29;.967;3600000;0
18101;170543;754;15;22;6;16;.727;3579000;0
18101;197595;2199;87;41;3;38;.927;3600000;0
18101;76406;2199;0;0;0;0;.00nan;0;0
18101;148904;754;0;0;0;0;.00nan;0;0
18102;3508;746;90;32;1;31;.969;3600000;0
18102;67122;1503;61;38;4;34;.895;3600000;0
18102;68689;1503;0;0;0;0;.00nan;0;0
18102;149191;746;0;0;0;0;.00nan;0;0
18103;177124;775;0;0;0;0;.00nan;0;0
18103;167061;772;0;0;0;0;.00nan;0;0
18103;180990;775;77;26;1;25;.962;3600000;0
18103;63932;772;70;38;3;35;.921;3518000;0
18104;1756;758;88;37;1;36;.973;3600000;0
18104;4281;3730;0;0;0;0;.00nan;0;0
18104;63529;3730;98;27;0;27;1.000;3600000;0
18104;94107;758;0;0;0;0;.00nan;0;0
18105;3165;767;58;21;2;19;.905;3600000;0
18105;180606;1497;0;0;0;0;.00nan;0;0
18105;91358;767;0;0;0;0;.00nan;0;0
18105;148576;1497;37;21;4;17;.810;3550000;0
18106;170548;2545;55;23;3;20;.870;3600000;0
18106;174894;762;0;0;0;0;.00nan;0;0
18106;148652;762;44;28;5;23;.821;3547000;0
18106;148829;2545;0;0;0;0;.00nan;0;0
18107;189264;4923;81;34;2;32;.941;3600000;0
18107;175757;755;0;0;0;0;.00nan;0;0
18107;176686;4923;0;0;0;0;.00nan;0;0
18107;180154;755;49;29;4;25;.862;3575000;0
18108;359;759;85;26;1;25;.962;3600000;0
18108;8504;774;0;0;0;0;.00nan;0;0
18108;169680;759;0;0;0;0;.00nan;0;0
18108;149280;774;65;38;4;34;.895;3600000;0
18109;-1;1093;0;0;0;0;.00nan;0;0
18109;68233;1093;76;26;1;25;.962;3600000;0
18109;85489;760;63;34;4;30;.882;3600000;0
18109;149112;760;0;0;0;0;.00nan;0;0
18110;-1;4989;0;0;0;0;.00nan;0;0
18110;67818;3721;0;0;0;0;.00nan;0;0
18110;71485;4989;96;36;1;35;.972;3600000;0
18110;91194;3721;52;24;3;21;.875;3517000;0
18111;189433;4924;80;38;3;35;.921;3516000;0
18111;170530;1492;73;20;1;19;.950;3600000;0
18111;186219;4924;0;0;0;0;.00nan;0;0
18111;67446;1492;0;0;0;0;.00nan;0;0
18112;279;766;74;10;0;10;1.000;3600000;0
18112;3241;2197;0;0;0;0;.00nan;0;0
18112;82711;766;0;0;0;0;.00nan;0;0
18112;94508;2197;97;40;2;38;.950;3585000;0
18113;170543;754;77;34;2;32;.941;3600000;0
18113;146249;3913;0;0;0;0;.00nan;0;0
18113;148573;3913;72;33;3;30;.909;3598000;0
18113;148904;754;0;0;0;0;.00nan;0;0
18114;3508;746;62;13;1;12;.923;3600000;0
18114;174894;762;61;40;5;35;.875;3600000;0
18114;148652;762;0;0;0;0;.00nan;0;0
18114;149191;746;0;0;0;0;.00nan;0;0
18115;177124;775;0;0;0;0;.00nan;0;0
18115;180990;775;90;42;3;39;.929;3583000;0
18115;43971;768;85;24;1;23;.958;3600000;0
18115;82817;768;0;0;0;0;.00nan;0;0
18116;4281;3730;0;0;0;0;.00nan;0;0
18116;189264;4923;0;0;0;0;.00nan;0;0
18116;176686;4923;87;23;1;22;.957;3900000;0
18116;63529;3730;97;44;1;43;.977;3900000;0
18117;3165;767;0;0;0;0;.00nan;0;0
18117;167061;772;0;0;0;0;.00nan;0;0
18117;63932;772;69;27;2;25;.926;3866000;0
18117;91358;767;74;22;1;21;.955;3866000;0
18118;169615;911;71;21;1;20;.952;3600000;0
18118;180606;1497;0;0;0;0;.00nan;0;0
18118;93756;911;0;0;0;0;.00nan;0;0
18118;148576;1497;61;25;2;23;.920;3544000;0
18119;1756;758;66;27;2;25;.926;3552000;0
18119;170548;2545;0;0;0;0;.00nan;0;0
18119;94107;758;0;0;0;0;.00nan;0;0
18119;148829;2545;86;24;1;23;.958;3600000;0
18120;175757;755;0;0;0;0;.00nan;0;0
18120;180154;755;78;35;3;32;.914;3600000;0
18120;67122;1503;0;0;0;0;.00nan;0;0
18120;68689;1503;81;16;0;16;1.000;3600000;0
18121;197595;2199;0;0;0;0;.00nan;0;0
18121;76406;2199;55;23;3;20;.870;3600000;0
18121;142648;769;0;0;0;0;.00nan;0;0
18121;149221;769;46;28;4;24;.857;3600000;0
18122;3241;2197;0;0;0;0;.00nan;0;0
18122;8504;774;0;0;0;0;.00nan;0;0
18122;94508;2197;53;36;5;31;.861;3590000;0
18122;149280;774;46;26;4;22;.846;3600000;0
18123;-1;1093;61;13;1;12;.923;3600000;0
18123;189433;4924;0;0;0;0;.00nan;0;0
18123;186219;4924;75;32;2;30;.938;3550000;0
18123;68233;1093;0;0;0;0;.00nan;0;0
18124;359;759;100;24;0;24;1.000;3600000;0
18124;169680;759;0;0;0;0;.00nan;0;0
18124;170530;1492;97;39;1;38;.974;3549000;0
18124;67446;1492;0;0;0;0;.00nan;0;0
18125;279;766;42;25;5;20;.800;3578000;0
18125;82711;766;0;0;0;0;.00nan;0;0
18125;85489;760;59;29;3;26;.897;3600000;0
18125;149112;760;0;0;0;0;.00nan;0;0
18126;1756;758;93;60;5;55;.917;3600000;0
18126;3508;746;57;17;2;15;.882;3600000;0
18126;94107;758;0;0;0;0;.00nan;0;0
18126;149191;746;0;0;0;0;.00nan;0;0
18127;177124;775;0;0;0;0;.00nan;0;0
18127;164424;750;44;22;4;18;.818;3561000;0
18127;164521;750;0;0;0;0;.00nan;0;0
18127;180990;775;80;42;3;39;.929;3600000;0
18128;4281;3730;100;33;0;33;1.000;3600000;0
18128;63529;3730;0;0;0;0;.00nan;0;0
18128;67122;1503;0;0;0;0;.00nan;0;0
18128;68689;1503;42;23;4;19;.826;3600000;0
18129;3165;767;0;0;0;0;.00nan;0;0
18129;43971;768;81;20;1;19;.950;3600000;0
18129;91358;767;86;34;2;32;.941;3544000;0
18129;154296;768;0;0;0;0;.00nan;0;0
18130;167061;772;42;4;1;3;.750;489000;0
18130;169615;911;64;20;1;19;.950;3600000;0
18130;63932;772;32;32;6;26;.813;3111000;0
18130;93756;911;0;0;0;0;.00nan;0;0
18131;189264;4923;85;29;2;27;.931;3600000;0
18131;170548;2545;40;26;4;22;.846;3539000;0
18131;176686;4923;0;0;0;0;.00nan;0;0
18131;148829;2545;0;0;0;0;.00nan;0;0
18132;174894;762;0;0;0;0;.00nan;0;0
18132;175757;755;76;29;3;26;.897;3669000;0
18132;180154;755;0;0;0;0;.00nan;0;0
18132;148652;762;78;28;2;26;.929;3669000;0
18133;142648;769;58;27;3;24;.889;3810000;0
18133;146249;3913;0;0;0;0;.00nan;0;0
18133;148573;3913;92;43;4;39;.907;3810000;0
18133;149221;769;0;0;0;0;.00nan;0;0
18134;359;759;81;30;2;28;.933;3900000;0
18134;-1;1093;71;26;2;24;.923;3900000;0
18134;169680;759;0;0;0;0;.00nan;0;0
18134;68233;1093;0;0;0;0;.00nan;0;0
18135;279;766;72;22;2;20;.909;3600000;0
18135;189433;4924;82;41;3;38;.927;3593000;0
18135;186219;4924;0;0;0;0;.00nan;0;0
18135;82711;766;0;0;0;0;.00nan;0;0
18136;3165;767;78;45;4;41;.911;3600000;0
18136;164424;750;55;26;3;23;.885;3600000;0
18136;164521;750;0;0;0;0;.00nan;0;0
18136;91358;767;0;0;0;0;.00nan;0;0
18137;169615;911;56;26;3;23;.885;3600000;0
18137;43971;768;60;19;2;17;.895;3600000;0
18137;93756;911;0;0;0;0;.00nan;0;0
18137;154296;768;0;0;0;0;.00nan;0;0
18138;170548;2545;0;0;0;0;.00nan;0;0
18138;67122;1503;57;23;3;20;.870;3600000;0
18138;68689;1503;0;0;0;0;.00nan;0;0
18138;148829;2545;100;26;0;26;1.000;3600000;0
18139;1756;758;54;29;4;25;.862;3541000;0
18139;175757;755;0;0;0;0;.00nan;0;0
18139;180154;755;85;36;2;34;.944;3600000;0
18139;94107;758;0;0;0;0;.00nan;0;0
18140;-1;4989;80;36;2;34;.944;3585000;0
18140;170530;1492;82;27;1;26;.963;3600000;0
18140;67446;1492;0;0;0;0;.00nan;0;0
18140;71485;4989;0;0;0;0;.00nan;0;0
18141;8504;774;0;0;0;0;.00nan;0;0
18141;67818;3721;35;19;4;15;.789;2064000;0
18141;91194;3721;65;18;1;17;.944;1536000;0
18141;149280;774;91;29;1;28;.966;3600000;0
18142;177124;775;0;0;0;0;.00nan;0;0
18142;189264;4923;0;0;0;0;.00nan;0;0
18142;176686;4923;57;22;3;19;.864;3571000;0
18142;180990;775;91;38;1;37;.974;3600000;0
18143;3241;2197;51;36;5;31;.861;2990000;0
18143;3508;746;100;24;0;24;1.000;3600000;0
18143;94508;2197;53;10;1;9;.900;610000;0
18143;149191;746;0;0;0;0;.00nan;0;0
18144;167061;772;0;0;0;0;.00nan;0;0
18144;170543;754;60;34;5;29;.853;3600000;0
18144;63932;772;100;28;0;28;1.000;3600000;0
18144;148904;754;0;0;0;0;.00nan;0;0
18145;4281;3730;70;34;4;30;.882;3600000;0
18145;63529;3730;0;0;0;0;.00nan;0;0
18145;85489;760;0;0;0;0;.00nan;0;0
18145;149112;760;72;23;1;22;.957;3600000;0
18146;164424;750;57;31;4;27;.871;3600000;0
18146;164521;750;0;0;0;0;.00nan;0;0
18146;169615;911;0;0;0;0;.00nan;0;0
18146;93756;911;100;28;0;28;1.000;3600000;0
18147;180606;1497;80;26;1;25;.962;3600000;0
18147;142648;769;0;0;0;0;.00nan;0;0
18147;148576;1497;0;0;0;0;.00nan;0;0
18147;149221;769;72;45;5;40;.889;3600000;0
18148;8504;774;0;0;0;0;.00nan;0;0
18148;-1;4989;0;0;0;0;.00nan;0;0
18148;71485;4989;67;33;3;30;.909;3600000;0
18148;149280;774;86;34;2;32;.941;3600000;0
18149;170530;1492;0;0;0;0;.00nan;0;0
18149;67446;1492;65;37;4;33;.892;3600000;0
18149;67818;3721;50;19;3;16;.842;3600000;0
18149;91194;3721;0;0;0;0;.00nan;0;0
18150;3165;767;0;0;0;0;.00nan;0;0
18150;189264;4923;79;36;3;33;.917;3552000;0
18150;176686;4923;0;0;0;0;.00nan;0;0
18150;91358;767;80;30;2;28;.933;3600000;0
18151;3241;2197;0;0;0;0;.00nan;0;0
18151;4281;3730;0;0;0;0;.00nan;0;0
18151;63529;3730;69;22;1;21;.955;3600000;0
18151;94508;2197;84;34;2;32;.941;3595000;0
18152;167061;772;0;0;0;0;.00nan;0;0
18152;63932;772;64;32;3;29;.906;3564000;0
18152;142648;769;90;34;2;32;.941;3600000;0
18152;149221;769;0;0;0;0;.00nan;0;0
18153;177124;775;0;0;0;0;.00nan;0;0
18153;1756;758;0;0;0;0;.00nan;0;0
18153;180990;775;97;30;1;29;.967;3900000;0
18153;94107;758;70;21;1;20;.952;3900000;0
18154;175757;755;0;0;0;0;.00nan;0;0
18154;180154;755;84;24;1;23;.958;3600000;0
18154;85489;760;76;35;2;33;.943;3552000;0
18154;149112;760;0;0;0;0;.00nan;0;0
18155;170543;754;58;33;4;29;.879;3600000;0
18155;43971;768;71;23;1;22;.957;3600000;0
18155;148904;754;0;0;0;0;.00nan;0;0
18155;154296;768;0;0;0;0;.00nan;0;0
18156;3508;746;68;19;1;18;.947;3600000;0
18156;189433;4924;0;0;0;0;.00nan;0;0
18156;186219;4924;93;52;3;49;.942;3538000;0
18156;149191;746;0;0;0;0;.00nan;0;0
18157;359;759;99;21;0;21;1.000;3600000;0
18157;169680;759;0;0;0;0;.00nan;0;0
18157;170548;2545;73;36;3;33;.917;3600000;0
18157;148829;2545;0;0;0;0;.00nan;0;0
18158;180606;1497;0;0;0;0;.00nan;0;0
18158;197595;2199;88;30;2;28;.933;3900000;0
18158;76406;2199;0;0;0;0;.00nan;0;0
18158;148576;1497;85;36;2;34;.944;3900000;0
18159;-1;4989;82;36;3;33;.917;2576000;0
18159;-1;1093;53;15;2;13;.867;3600000;0
18159;68233;1093;0;0;0;0;.00nan;0;0
18159;71485;4989;31;15;4;11;.733;1024000;0
18160;279;766;100;22;0;22;1.000;3600000;0
18160;67818;3721;90;37;2;35;.946;3524000;0
18160;82711;766;0;0;0;0;.00nan;0;0
18160;91194;3721;0;0;0;0;.00nan;0;0
18161;189264;4923;0;0;0;0;.00nan;0;0
18161;169615;911;83;35;3;32;.914;3596000;0
18161;176686;4923;68;26;2;24;.923;3600000;0
18161;93756;911;0;0;0;0;.00nan;0;0
18162;3241;2197;0;0;0;0;.00nan;0;0
18162;175757;755;0;0;0;0;.00nan;0;0
18162;180154;755;52;36;5;31;.861;3780000;0
18162;94508;2197;23;27;6;21;.778;3780000;0
18163;167061;772;0;0;0;0;.00nan;0;0
18163;197595;2199;76;42;3;39;.929;3900000;0
18163;63932;772;68;26;3;23;.885;3900000;0
18163;87758;2199;0;0;0;0;.00nan;0;0
18164;177124;775;0;0;0;0;.00nan;0;0
18164;180990;775;77;36;2;34;.944;3600000;0
18164;68689;1503;0;0;0;0;.00nan;0;0
18164;76406;1503;69;35;3;32;.914;3569000;0
18165;1756;758;85;30;2;28;.933;3600000;0
18165;3165;767;0;0;0;0;.00nan;0;0
18165;91358;767;90;31;1;30;.968;3600000;0
18165;94107;758;0;0;0;0;.00nan;0;0
18166;170548;2545;0;0;0;0;.00nan;0;0
18166;85489;760;39;31;5;26;.839;3547000;0
18166;148829;2545;58;29;4;25;.862;3600000;0
18166;149112;760;0;0;0;0;.00nan;0;0
18167;43971;768;97;31;1;30;.968;3900000;0
18167;142648;769;0;0;0;0;.00nan;0;0
18167;149221;769;100;43;1;42;.977;3900000;0
18167;154296;768;0;0;0;0;.00nan;0;0
18168;4281;3730;0;0;0;0;.00nan;0;0
18168;189433;4924;68;30;3;27;.900;3600000;0
18168;186219;4924;0;0;0;0;.00nan;0;0
18168;63529;3730;60;30;4;26;.867;3600000;0
18169;164424;750;83;27;1;26;.963;3600000;0
18169;164521;750;0;0;0;0;.00nan;0;0
18169;170543;754;84;40;3;37;.925;3592000;0
18169;148904;754;0;0;0;0;.00nan;0;0
18170;359;759;82;33;2;31;.939;3572000;0
18170;3508;746;98;31;1;30;.968;3600000;0
18170;169680;759;0;0;0;0;.00nan;0;0
18170;149191;746;0;0;0;0;.00nan;0;0
18171;180606;1497;0;0;0;0;.00nan;0;0
18171;146249;3913;0;0;0;0;.00nan;0;0
18171;148573;3913;75;44;4;40;.909;3600000;0
18171;148576;1497;66;29;3;26;.897;3600000;0
18172;279;766;34;11;3;8;.727;3900000;0
18172;-1;4989;0;0;0;0;.00nan;0;0
18172;71485;4989;97;51;3;48;.941;3900000;0
18172;82711;766;0;0;0;0;.00nan;0;0
18173;-1;1093;84;34;2;32;.941;3600000;0
18173;67818;3721;39;15;3;12;.800;3553000;0
18173;68233;1093;0;0;0;0;.00nan;0;0
18173;91194;3721;0;0;0;0;.00nan;0;0
18174;177124;775;0;0;0;0;.00nan;0;0
18174;174894;762;30;24;5;19;.792;3600000;0
18174;180990;775;93;36;1;35;.972;3600000;0
18174;148652;762;0;0;0;0;.00nan;0;0
18175;3241;2197;0;0;0;0;.00nan;0;0
18175;170548;2545;98;31;2;29;.935;3900000;0
18175;94508;2197;96;33;2;31;.939;3900000;0
18175;148829;2545;0;0;0;0;.00nan;0;0
18176;167061;772;0;0;0;0;.00nan;0;0
18176;63932;772;86;23;1;22;.957;3600000;0
18176;146249;3913;0;0;0;0;.00nan;0;0
18176;148573;3913;81;33;2;31;.939;3555000;0
18177;3165;767;0;0;0;0;.00nan;0;0
18177;68689;1503;0;0;0;0;.00nan;0;0
18177;76406;1503;69;28;2;26;.929;3900000;0
18177;91358;767;98;39;2;37;.949;3900000;0
18178;1756;758;53;31;5;26;.839;3600000;0
18178;169615;911;0;0;0;0;.00nan;0;0
18178;93756;911;84;25;1;24;.960;3600000;0
18178;94107;758;0;0;0;0;.00nan;0;0
18179;3508;746;93;18;0;18;1.000;3600000;0
18179;85489;760;62;41;4;37;.902;3600000;0
18179;149112;760;0;0;0;0;.00nan;0;0
18179;149191;746;0;0;0;0;.00nan;0;0
18180;43971;768;89;29;1;28;.966;3600000;0
18180;197595;2199;51;29;4;25;.862;3600000;0
18180;87758;2199;0;0;0;0;.00nan;0;0
18180;154296;768;0;0;0;0;.00nan;0;0
18181;189433;4924;0;0;0;0;.00nan;0;0
18181;175757;755;0;0;0;0;.00nan;0;0
18181;180154;755;65;24;2;22;.917;3600000;0
18181;186219;4924;72;26;1;25;.962;3600000;0
18182;164424;750;67;28;3;25;.893;3588000;0
18182;164521;750;0;0;0;0;.00nan;0;0
18182;142648;769;0;0;0;0;.00nan;0;0
18182;149221;769;75;33;2;31;.939;3600000;0
18183;359;759;91;34;2;32;.941;3600000;0
18183;4281;3730;0;0;0;0;.00nan;0;0
18183;169680;759;0;0;0;0;.00nan;0;0
18183;63529;3730;62;44;6;38;.864;3600000;0
18184;170543;754;85;26;1;25;.962;3600000;0
18184;180606;1497;61;21;2;19;.905;3583000;0
18184;148576;1497;0;0;0;0;.00nan;0;0
18184;148904;754;0;0;0;0;.00nan;0;0
18185;3165;767;0;0;0;0;.00nan;0;0
18185;174894;762;93;43;2;41;.953;3038000;0
18185;91358;767;66;22;2;20;.909;3600000;0
18185;148652;762;27;7;3;4;.571;562000;0
18186;169615;911;91;19;0;19;1.000;3600000;0
18186;68689;1503;0;0;0;0;.00nan;0;0
18186;76406;1503;78;31;2;29;.935;3569000;0
18186;93756;911;0;0;0;0;.00nan;0;0
18187;43971;768;78;13;0;13;1.000;3600000;0
18187;146249;3913;0;0;0;0;.00nan;0;0
18187;148573;3913;87;43;4;39;.907;3600000;0
18187;154296;768;0;0;0;0;.00nan;0;0
18188;189433;4924;100;31;1;30;.968;3600000;0
18188;170548;2545;35;19;4;15;.789;2127000;0
18188;186219;4924;0;0;0;0;.00nan;0;0
18188;148829;2545;83;19;0;19;1.000;1473000;0
18189;164424;750;76;22;1;21;.955;3600000;0
18189;164521;750;0;0;0;0;.00nan;0;0
18189;197595;2199;75;42;4;38;.905;3600000;0
18189;87758;2199;0;0;0;0;.00nan;0;0
18190;359;759;68;19;1;18;.947;3600000;0
18190;169680;759;0;0;0;0;.00nan;0;0
18190;175757;755;0;0;0;0;.00nan;0;0
18190;180154;755;86;52;4;48;.923;3600000;0
18191;8504;774;0;0;0;0;.00nan;0;0
18191;170530;1492;0;0;0;0;.00nan;0;0
18191;67446;1492;100;38;1;37;.974;3600000;0
18191;149280;774;70;24;2;22;.917;3557000;0
18192;169615;911;81;27;1;26;.963;3600000;0
18192;174894;762;57;32;4;28;.875;3600000;0
18192;93756;911;0;0;0;0;.00nan;0;0
18192;148652;762;0;0;0;0;.00nan;0;0
18193;3508;746;68;14;1;13;.929;3600000;0
18193;-1;4989;0;0;0;0;.00nan;0;0
18193;71485;4989;98;46;2;44;.957;3567000;0
18193;149191;746;0;0;0;0;.00nan;0;0
18194;177124;775;100;31;0;31;1.000;3600000;0
18194;180990;775;0;0;0;0;.00nan;0;0
18194;85489;760;61;28;3;25;.893;3600000;0
18194;149112;760;0;0;0;0;.00nan;0;0
18195;164424;750;54;31;3;28;.903;3567000;0
18195;164521;750;0;0;0;0;.00nan;0;0
18195;146249;3913;0;0;0;0;.00nan;0;0
18195;148573;3913;74;24;2;22;.917;3600000;0
18196;8504;774;0;0;0;0;.00nan;0;0
18196;-1;1093;76;42;4;38;.905;3554000;0
18196;68233;1093;0;0;0;0;.00nan;0;0
18196;149280;774;37;13;3;10;.769;3600000;0
18197;279;766;0;0;0;0;.00nan;0;0
18197;170530;1492;42;38;6;32;.842;2704000;0
18197;67446;1492;52;14;2;12;.857;896000;0
18197;82711;766;65;24;2;22;.917;3600000;0
18198;1756;758;97;46;3;43;.935;3600000;0
18198;94107;758;0;0;0;0;.00nan;0;0
18198;142648;769;78;15;0;15;1.000;3600000;0
18198;149221;769;0;0;0;0;.00nan;0;0
18199;167061;772;0;0;0;0;.00nan;0;0
18199;180606;1497;0;0;0;0;.00nan;0;0
18199;63932;772;77;12;0;12;1.000;3600000;0
18199;148576;1497;90;39;1;38;.974;3600000;0
18200;177124;775;0;0;0;0;.00nan;0;0
18200;3241;2197;0;0;0;0;.00nan;0;0
18200;180990;775;67;18;1;17;.944;3600000;0
18200;94508;2197;73;33;3;30;.909;3588000;0
18201;3165;767;0;0;0;0;.00nan;0;0
18201;85489;760;55;25;3;22;.880;3600000;0
18201;91358;767;66;22;2;20;.909;3600000;0
18201;149112;760;0;0;0;0;.00nan;0;0
18202;-1;4989;0;0;0;0;.00nan;0;0
18202;175757;755;61;38;5;33;.868;3600000;0
18202;180154;755;0;0;0;0;.00nan;0;0
18202;71485;4989;99;33;1;32;.970;3600000;0
18203;1756;758;66;39;4;35;.897;3561000;0
18203;170543;754;66;26;2;24;.923;3600000;0
18203;94107;758;0;0;0;0;.00nan;0;0
18203;148904;754;0;0;0;0;.00nan;0;0
18204;279;766;71;36;3;33;.917;3600000;0
18204;-1;1093;26;19;5;14;.737;3568000;0
18204;68233;1093;0;0;0;0;.00nan;0;0
18204;82711;766;0;0;0;0;.00nan;0;0
18205;359;759;70;25;2;23;.920;3900000;0
18205;189433;4924;0;0;0;0;.00nan;0;0
18205;169680;759;0;0;0;0;.00nan;0;0
18205;186219;4924;87;39;2;37;.949;3900000;0
18206;189264;4923;51;28;4;24;.857;3548000;0
18206;176686;4923;0;0;0;0;.00nan;0;0
18206;142648;769;0;0;0;0;.00nan;0;0
18206;149221;769;62;22;3;19;.864;3600000;0
18207;174894;762;71;31;3;28;.903;3600000;0
18207;146249;3913;62;8;0;8;1.000;626000;0
18207;148573;3913;35;31;6;25;.806;2974000;0
18207;148652;762;0;0;0;0;.00nan;0;0
18208;3165;767;74;33;2;31;.939;3600000;0
18208;3241;2197;0;0;0;0;.00nan;0;0
18208;91358;767;0;0;0;0;.00nan;0;0
18208;94508;2197;57;31;4;27;.871;3554000;0
18209;169615;911;0;0;0;0;.00nan;0;0
18209;85489;760;96;36;1;35;.972;3600000;0
18209;93756;911;57;24;3;21;.875;3567000;0
18209;149112;760;0;0;0;0;.00nan;0;0
18210;164424;750;83;43;2;41;.953;3600000;0
18210;164521;750;0;0;0;0;.00nan;0;0
18210;43971;768;83;25;1;24;.960;3600000;0
18210;154296;768;0;0;0;0;.00nan;0;0
18211;68689;1503;0;0;0;0;.00nan;0;0
18211;76406;1503;55;28;4;24;.857;3559000;0
18211;87758;2199;0;0;0;0;.00nan;0;0
18211;149262;2199;38;16;3;13;.813;3600000;0
18212;-1;4989;60;6;0;6;1.000;824000;0
18212;170548;2545;0;0;0;0;.00nan;0;0
18212;71485;4989;25;31;7;24;.774;2776000;0
18212;148829;2545;99;33;1;32;.970;3600000;0
18213;175757;755;0;0;0;0;.00nan;0;0
18213;180154;755;45;34;5;29;.853;3546000;0
18213;67818;3721;64;29;3;26;.897;3600000;0
18213;91194;3721;0;0;0;0;.00nan;0;0
18214;189264;4923;0;0;0;0;.00nan;0;0
18214;170543;754;73;33;3;30;.909;3550000;0
18214;176686;4923;79;27;1;26;.963;3600000;0
18214;148904;754;0;0;0;0;.00nan;0;0
18215;-1;1093;72;25;2;23;.920;3600000;0
18215;170530;1492;0;0;0;0;.00nan;0;0
18215;67446;1492;70;35;3;32;.914;3544000;0
18215;68233;1093;0;0;0;0;.00nan;0;0
18216;279;766;45;24;4;20;.833;3553000;0
18216;8504;774;0;0;0;0;.00nan;0;0
18216;82711;766;0;0;0;0;.00nan;0;0
18216;149280;774;67;35;3;32;.914;3600000;0
18217;3508;746;41;24;5;19;.792;3600000;0
18217;67818;3721;70;22;2;20;.909;3600000;0
18217;91194;3721;0;0;0;0;.00nan;0;0
18217;149191;746;0;0;0;0;.00nan;0;0
18218;68689;1503;0;0;0;0;.00nan;0;0
18218;76406;1503;61;27;4;23;.852;3865000;0
18218;146249;3913;0;0;0;0;.00nan;0;0
18218;148573;3913;82;38;3;35;.921;3865000;0
18219;4281;3730;0;0;0;0;.00nan;0;0
18219;-1;4989;0;0;0;0;.00nan;0;0
18219;63529;3730;52;32;5;27;.844;3600000;0
18219;71485;4989;91;26;0;26;1.000;3600000;0
18220;3241;2197;0;0;0;0;.00nan;0;0
18220;169615;911;83;14;0;14;1.000;3600000;0
18220;93756;911;0;0;0;0;.00nan;0;0
18220;94018;2197;98;37;1;36;.973;3562000;0
18221;174894;762;0;0;0;0;.00nan;0;0
18221;87758;2199;0;0;0;0;.00nan;0;0
18221;148652;762;100;26;0;26;1.000;3600000;0
18221;149262;2199;64;28;2;26;.929;3579000;0
18222;177124;775;0;0;0;0;.00nan;0;0
18222;189433;4924;0;0;0;0;.00nan;0;0
18222;180990;775;99;43;1;42;.977;3600000;0
18222;186219;4924;44;40;5;35;.875;3600000;0
18223;167061;772;0;0;0;0;.00nan;0;0
18223;43971;768;83;23;1;22;.957;3791000;0
18223;63932;772;92;46;2;44;.957;3791000;0
18223;154296;768;0;0;0;0;.00nan;0;0
18224;164424;750;36;22;5;17;.773;3600000;0
18224;164521;750;0;0;0;0;.00nan;0;0
18224;180606;1497;0;0;0;0;.00nan;0;0
18224;94508;1497;100;37;0;37;1.000;3600000;0
18225;359;759;54;35;6;29;.829;3892000;0
18225;177124;775;0;0;0;0;.00nan;0;0
18225;169680;759;0;0;0;0;.00nan;0;0
18225;180990;775;74;49;6;43;.878;3900000;0
18226;1756;758;86;30;2;28;.933;3582000;0
18226;94107;758;0;0;0;0;.00nan;0;0
18226;148573;3913;91;26;1;25;.962;3600000;0
18226;148576;3913;0;0;0;0;.00nan;0;0
18227;3165;767;0;0;0;0;.00nan;0;0
18227;189433;4924;73;41;4;37;.902;3543000;0
18227;186219;4924;0;0;0;0;.00nan;0;0
18227;91358;767;56;17;2;15;.882;3600000;0
18228;189264;4923;0;0;0;0;.00nan;0;0
18228;170543;2199;92;35;1;34;.971;3600000;0
18228;176686;4923;51;20;3;17;.850;3538000;0
18228;87758;2199;0;0;0;0;.00nan;0;0
18229;166023;754;0;0;0;0;.00nan;0;0
18229;174894;762;68;25;2;23;.920;3657000;0
18229;148652;762;0;0;0;0;.00nan;0;0
18229;148904;754;75;23;1;22;.957;3657000;0
18230;3241;2197;0;0;0;0;.00nan;0;0
18230;85489;760;70;27;2;25;.926;3900000;0
18230;94018;2197;81;33;2;31;.939;3900000;0
18230;149112;760;0;0;0;0;.00nan;0;0
18231;167061;772;0;0;0;0;.00nan;0;0
18231;164424;750;70;26;2;24;.923;3695000;0
18231;164521;750;0;0;0;0;.00nan;0;0
18231;63932;772;45;21;3;18;.857;3695000;0
18232;-1;1093;0;0;0;0;.00nan;0;0
18232;175757;755;0;0;0;0;.00nan;0;0
18232;180154;755;100;47;3;44;.936;3900000;0
18232;68233;1093;58;25;3;22;.880;3900000;0
18233;170548;2545;100;27;0;27;1.000;3600000;0
18233;67818;3721;84;35;2;33;.943;3532000;0
18233;91194;3721;0;0;0;0;.00nan;0;0
18233;148829;2545;0;0;0;0;.00nan;0;0
18234;180606;1497;84;30;1;29;.967;2749000;0
18234;43971;768;45;17;3;14;.824;3600000;0
18234;94508;1497;45;21;4;17;.810;828000;0
18234;154296;768;0;0;0;0;.00nan;0;0
18235;68689;1503;0;0;0;0;.00nan;0;0
18235;76406;1503;100;35;1;34;.971;3600000;0
18235;142648;769;38;25;5;20;.800;3600000;0
18235;149221;769;0;0;0;0;.00nan;0;0
18236;189264;4923;63;15;1;14;.933;3600000;0
18236;176686;4923;0;0;0;0;.00nan;0;0
18236;148573;3913;96;43;2;41;.953;3581000;0
18236;148576;3913;0;0;0;0;.00nan;0;0
18237;3165;767;0;0;0;0;.00nan;0;0
18237;169680;759;0;0;0;0;.00nan;0;0
18237;197595;759;51;24;3;21;.875;3900000;0
18237;91358;767;100;48;3;45;.938;3900000;0
18238;189433;4924;0;0;0;0;.00nan;0;0
18238;169615;911;51;28;4;24;.857;3545000;0
18238;186219;4924;64;31;3;28;.903;3600000;0
18238;93756;911;0;0;0;0;.00nan;0;0
18239;1756;758;78;35;3;32;.914;3900000;0
18239;170543;2199;81;30;3;27;.900;3900000;0
18239;87758;2199;0;0;0;0;.00nan;0;0
18239;94107;758;0;0;0;0;.00nan;0;0
18240;166023;754;0;0;0;0;.00nan;0;0
18240;68689;1503;0;0;0;0;.00nan;0;0
18240;76406;1503;97;27;0;27;1.000;3600000;0
18240;148904;754;58;19;2;17;.895;3594000;0
18241;3508;746;46;23;4;19;.826;3537000;0
18241;-1;1093;70;31;2;29;.935;3600000;0
18241;68233;1093;0;0;0;0;.00nan;0;0
18241;149191;746;0;0;0;0;.00nan;0;0
18242;4281;3730;91;44;1;43;.977;3600000;0
18242;63529;3730;0;0;0;0;.00nan;0;0
18242;67818;3721;31;19;4;15;.789;3600000;0
18242;91194;3721;0;0;0;0;.00nan;0;0
18243;170530;1492;50;32;4;28;.875;3600000;0
18243;175757;755;49;9;1;8;.889;848000;0
18243;180154;755;28;29;6;23;.793;2752000;0
18243;67446;1492;0;0;0;0;.00nan;0;0
18244;174894;762;0;0;0;0;.00nan;0;0
18244;142648;769;0;0;0;0;.00nan;0;0
18244;148652;762;92;56;3;53;.946;3673000;0
18244;149221;769;62;22;2;20;.909;3673000;0
18245;169615;911;0;0;0;0;.00nan;0;0
18245;169680;759;0;0;0;0;.00nan;0;0
18245;197595;759;94;39;3;36;.923;3900000;0
18245;93756;911;78;39;3;36;.923;3900000;0
18246;8504;774;0;0;0;0;.00nan;0;0
18246;175757;755;80;57;6;51;.895;3600000;0
18246;180154;755;0;0;0;0;.00nan;0;0
18246;149280;774;93;17;0;17;1.000;3600000;0
18247;-1;1093;51;37;5;32;.865;3900000;0
18247;170548;2545;48;35;5;30;.857;3900000;0
18247;68233;1093;0;0;0;0;.00nan;0;0
18247;148829;2545;0;0;0;0;.00nan;0;0
18248;177124;775;70;14;0;14;1.000;3019000;0
18248;-1;4989;45;6;1;5;.833;441000;0
18248;180990;775;31;8;3;5;.625;581000;0
18248;71485;4989;34;31;6;25;.806;3159000;0
18249;3508;746;62;13;1;12;.923;3600000;0
18249;170530;1492;0;0;0;0;.00nan;0;0
18249;67446;1492;76;51;6;45;.882;3600000;0
18249;149191;746;0;0;0;0;.00nan;0;0
18250;189264;4923;0;0;0;0;.00nan;0;0
18250;176686;4923;33;21;5;16;.762;3600000;0
18250;63529;1497;79;30;2;28;.933;3600000;0
18250;94508;1497;0;0;0;0;.00nan;0;0
18251;3241;2197;0;0;0;0;.00nan;0;0
18251;94018;2197;97;42;1;41;.976;3600000;0
18251;142648;769;84;14;0;14;1.000;3600000;0
18251;149221;769;0;0;0;0;.00nan;0;0
18252;1756;758;82;34;3;31;.912;3600000;0
18252;167061;772;0;0;0;0;.00nan;0;0
18252;63932;772;32;19;5;14;.737;3548000;0
18252;94107;758;0;0;0;0;.00nan;0;0
18253;166023;754;0;0;0;0;.00nan;0;0
18253;85489;760;0;0;0;0;.00nan;0;0
18253;148904;754;69;32;2;30;.938;3584000;0
18253;149112;760;97;37;1;36;.973;3600000;0
18254;189433;4924;96;32;1;31;.969;3900000;0
18254;170543;2199;84;25;1;24;.960;3900000;0
18254;186219;4924;0;0;0;0;.00nan;0;0
18254;87758;2199;0;0;0;0;.00nan;0;0
18255;3508;746;94;41;3;38;.927;3600000;0
18255;8504;774;0;0;0;0;.00nan;0;0
18255;149191;746;0;0;0;0;.00nan;0;0
18255;149280;774;100;32;0;32;1.000;3600000;0
18256;3957;3730;21;26;6;20;.769;2419000;0
18256;4281;3730;31;10;3;7;.700;1181000;0
18256;-1;1093;42;15;3;12;.800;3600000;0
18256;68233;1093;0;0;0;0;.00nan;0;0
18257;3165;767;0;0;0;0;.00nan;0;0
18257;-1;4989;0;0;0;0;.00nan;0;0
18257;71485;4989;72;29;3;26;.897;3600000;0
18257;91358;767;100;28;0;28;1.000;3600000;0
18258;177124;775;0;0;0;0;.00nan;0;0
18258;180990;775;64;40;4;36;.900;3600000;0
18258;67818;3721;0;0;0;0;.00nan;0;0
18258;91194;3721;100;27;0;27;1.000;3600000;0
18259;170530;1492;69;37;5;32;.865;3566000;0
18259;170548;2545;0;0;0;0;.00nan;0;0
18259;67446;1492;0;0;0;0;.00nan;0;0
18259;148829;2545;52;20;3;17;.850;3600000;0
18260;279;766;70;27;2;25;.926;3665000;0
18260;175757;755;0;0;0;0;.00nan;0;0
18260;180154;755;62;30;3;27;.900;3665000;0
18260;82711;766;0;0;0;0;.00nan;0;0
18261;174894;762;78;25;1;24;.960;3766000;0
18261;63529;1497;92;41;2;39;.951;3766000;0
18261;94508;1497;0;0;0;0;.00nan;0;0
18261;148652;762;0;0;0;0;.00nan;0;0
18262;189264;4923;90;48;2;46;.958;3600000;0
18262;176686;4923;0;0;0;0;.00nan;0;0
18262;43971;768;47;24;4;20;.833;3582000;0
18262;154296;768;0;0;0;0;.00nan;0;0
18263;3241;2197;100;25;0;25;1.000;3600000;0
18263;170543;2199;17;18;6;12;.667;3600000;0
18263;87758;2199;0;0;0;0;.00nan;0;0
18263;94018;2197;0;0;0;0;.00nan;0;0
18264;167061;772;0;0;0;0;.00nan;0;0
18264;63932;772;100;29;0;29;1.000;3600000;0
18264;68689;1503;0;0;0;0;.00nan;0;0
18264;76406;1503;23;26;6;20;.769;3600000;0
18265;1756;758;64;25;2;23;.920;3900000;0
18265;164424;750;64;20;2;18;.900;3900000;0
18265;164521;750;0;0;0;0;.00nan;0;0
18265;94107;758;0;0;0;0;.00nan;0;0
18266;85489;760;90;33;1;32;.970;3600000;0
18266;142648;769;0;0;0;0;.00nan;0;0
18266;149112;760;0;0;0;0;.00nan;0;0
18266;149221;769;44;32;5;27;.844;3600000;0
18267;186219;4924;0;0;0;0;.00nan;0;0
18267;81691;4924;86;34;1;33;.971;3600000;0
18267;148573;3913;57;29;4;25;.862;3600000;0
18267;148576;3913;0;0;0;0;.00nan;0;0
18268;166023;754;0;0;0;0;.00nan;0;0
18268;169680;759;0;0;0;0;.00nan;0;0
18268;197595;759;86;19;0;19;1.000;3600000;0
18268;148904;754;77;49;5;44;.898;3600000;0
18269;8504;774;0;0;0;0;.00nan;0;0
18269;170548;2545;0;0;0;0;.00nan;0;0
18269;148829;2545;83;31;2;29;.935;3528000;0
18269;149280;774;100;31;0;31;1.000;3600000;0
18270;-1;4989;38;42;6;36;.857;3305000;0
18270;169615;911;84;26;1;25;.962;3600000;0
18270;71485;4989;59;8;0;8;1.000;295000;0
18270;93756;911;0;0;0;0;.00nan;0;0
18271;3165;767;0;0;0;0;.00nan;0;0
18271;67818;3721;0;0;0;0;.00nan;0;0
18271;91194;3721;67;27;2;25;.926;3600000;0
18271;91358;767;60;52;7;45;.865;3600000;0
18272;3957;3730;50;32;5;27;.844;3600000;0
18272;4281;3730;0;0;0;0;.00nan;0;0
18272;170530;1492;33;21;4;17;.810;1902000;0
18272;67446;1492;37;29;5;24;.828;1698000;0
18273;279;766;0;0;0;0;.00nan;0;0
18273;3508;746;100;33;1;32;.970;3600000;0
18273;82711;766;69;29;2;27;.931;3557000;0
18273;149191;746;0;0;0;0;.00nan;0;0
18274;167061;772;0;0;0;0;.00nan;0;0
18274;63932;772;70;35;3;32;.914;3600000;0
18274;85489;762;0;0;0;0;.00nan;0;0
18274;148652;762;46;23;4;19;.826;3564000;0
18275;164424;750;81;30;2;28;.933;3600000;0
18275;164521;750;0;0;0;0;.00nan;0;0
18275;189264;4923;0;0;0;0;.00nan;0;0
18275;176686;4923;72;43;4;39;.907;3529000;0
18276;3241;2197;0;0;0;0;.00nan;0;0
18276;94018;2197;70;43;4;39;.907;3560000;0
18276;148573;3913;79;35;3;32;.914;3600000;0
18276;148576;3913;0;0;0;0;.00nan;0;0
18277;1756;1497;69;34;3;31;.912;3646000;0
18277;63529;1497;0;0;0;0;.00nan;0;0
18277;68689;1503;0;0;0;0;.00nan;0;0
18277;76406;1503;55;30;4;26;.867;3646000;0
18278;189433;758;74;38;3;35;.921;3542000;0
18278;43971;768;100;30;1;29;.967;3600000;0
18278;76628;758;0;0;0;0;.00nan;0;0
18278;154296;768;0;0;0;0;.00nan;0;0
18279;170543;2199;69;32;2;30;.938;3900000;0
18279;174894;760;0;0;0;0;.00nan;0;0
18279;87758;2199;0;0;0;0;.00nan;0;0
18279;149112;760;99;44;2;42;.955;3900000;0
18280;166023;754;83;28;1;27;.964;3600000;0
18280;186219;4924;0;0;0;0;.00nan;0;0
18280;81691;4924;42;32;5;27;.844;3600000;0
18280;148904;754;0;0;0;0;.00nan;0;0
18281;169680;759;0;0;0;0;.00nan;0;0
18281;197595;759;70;26;2;24;.923;3600000;0
18281;142648;769;81;39;3;36;.923;3600000;0
18281;149221;769;0;0;0;0;.00nan;0;0
18282;3957;3730;0;0;0;0;.00nan;0;0
18282;4281;3730;85;39;3;36;.923;3900000;0
18282;8504;774;0;0;0;0;.00nan;0;0
18282;149280;774;79;32;3;29;.906;3900000;0
18283;177124;775;0;0;0;0;.00nan;0;0
18283;-1;1093;37;31;5;26;.839;3600000;0
18283;180990;775;83;34;2;32;.941;3600000;0
18283;68233;1093;0;0;0;0;.00nan;0;0
18284;169615;911;0;0;0;0;.00nan;0;0
18284;67818;3721;53;28;4;24;.857;3547000;0
18284;91194;3721;0;0;0;0;.00nan;0;0
18284;93756;911;96;45;2;43;.956;3600000;0
18285;279;766;100;42;1;41;.976;3900000;0
18285;170548;2545;88;36;1;35;.972;3900000;0
18285;82711;766;0;0;0;0;.00nan;0;0
18285;148829;2545;0;0;0;0;.00nan;0;0
18286;164424;750;100;28;0;28;1.000;3600000;0
18286;164521;750;0;0;0;0;.00nan;0;0
18286;85489;762;74;38;4;34;.895;3600000;0
18286;148652;762;0;0;0;0;.00nan;0;0
18287;167061;772;0;0;0;0;.00nan;0;0
18287;189264;4923;62;29;3;26;.897;3575000;0
18287;176686;4923;0;0;0;0;.00nan;0;0
18287;63932;772;56;19;2;17;.895;3600000;0
18288;3241;2197;80;32;2;30;.938;3545000;0
18288;166023;754;0;0;0;0;.00nan;0;0
18288;94018;2197;0;0;0;0;.00nan;0;0
18288;148904;754;98;24;0;24;1.000;3600000;0
18289;43971;768;61;29;3;26;.897;3600000;0
18289;68689;1503;0;0;0;0;.00nan;0;0
18289;76406;1503;73;49;5;44;.898;3600000;0
18289;154296;768;0;0;0;0;.00nan;0;0
18290;1756;1497;0;0;0;0;.00nan;0;0
18290;189433;758;71;32;2;30;.938;3600000;0
18290;63529;1497;77;40;3;37;.925;3546000;0
18290;76628;758;0;0;0;0;.00nan;0;0
18291;174894;760;59;29;4;25;.862;3600000;0
18291;148573;3913;40;30;5;25;.833;3544000;0
18291;148576;3913;0;0;0;0;.00nan;0;0
18291;149112;760;0;0;0;0;.00nan;0;0
18292;186219;4924;0;0;0;0;.00nan;0;0
18292;81691;4924;61;36;4;32;.889;3600000;0
18292;142648;769;0;0;0;0;.00nan;0;0
18292;149221;769;74;20;1;19;.950;3600000;0
18293;169680;759;89;36;1;35;.972;3600000;0
18293;170543;2199;68;32;3;29;.906;3520000;0
18293;197595;759;0;0;0;0;.00nan;0;0
18293;87758;2199;0;0;0;0;.00nan;0;0
18294;177124;775;0;0;0;0;.00nan;0;0
18294;170530;1492;52;36;5;31;.861;3580000;0
18294;180990;775;63;30;3;27;.900;3600000;0
18294;67446;1492;0;0;0;0;.00nan;0;0
18295;3165;767;0;0;0;0;.00nan;0;0
18295;-1;1093;74;17;1;16;.941;3600000;0
18295;68233;1093;0;0;0;0;.00nan;0;0
18295;91358;767;66;37;4;33;.892;3600000;0
18296;279;766;72;22;1;21;.955;3600000;0
18296;3957;3730;63;26;3;23;.885;3513000;0
18296;4281;3730;0;0;0;0;.00nan;0;0
18296;82711;766;0;0;0;0;.00nan;0;0
18297;43971;768;48;25;3;22;.880;3551000;0
18297;85489;762;93;31;1;30;.968;3600000;0
18297;148652;762;0;0;0;0;.00nan;0;0
18297;154296;768;0;0;0;0;.00nan;0;0
18298;164424;750;69;18;1;17;.944;3600000;0
18298;164521;750;0;0;0;0;.00nan;0;0
18298;68689;1503;0;0;0;0;.00nan;0;0
18298;76406;1503;49;33;5;28;.848;3600000;0
18299;3508;746;0;0;0;0;.00nan;0;0
18299;175757;755;80;46;4;42;.913;3600000;0
18299;180154;755;0;0;0;0;.00nan;0;0
18299;149191;746;61;24;3;21;.875;3600000;0
18300;169680;759;0;0;0;0;.00nan;0;0
18300;197595;759;66;18;1;17;.944;3600000;0
18300;148573;3913;53;45;6;39;.867;3600000;0
18300;148576;3913;0;0;0;0;.00nan;0;0
18301;177124;775;89;43;2;41;.953;3543000;0
18301;8504;774;0;0;0;0;.00nan;0;0
18301;180990;775;0;0;0;0;.00nan;0;0
18301;149280;774;100;22;0;22;1.000;3600000;0
18302;3165;767;0;0;0;0;.00nan;0;0
18302;170530;1492;92;42;2;40;.952;3600000;0
18302;67446;1492;0;0;0;0;.00nan;0;0
18302;91358;767;76;33;3;30;.909;3553000;0
18303;-1;1093;10;25;7;18;.720;3283000;0
18303;169615;911;35;31;6;25;.806;3600000;0
18303;68233;1093;55;4;0;4;1.000;301000;0
18303;93756;911;0;0;0;0;.00nan;0;0
18304;166023;754;0;0;0;0;.00nan;0;0
18304;67818;3721;38;23;4;19;.826;3600000;0
18304;91194;3721;0;0;0;0;.00nan;0;0
18304;148904;754;94;35;1;34;.971;3600000;0
18305;167061;772;70;31;3;28;.903;3777000;0
18305;174894;760;70;40;4;36;.900;3777000;0
18305;63932;772;0;0;0;0;.00nan;0;0
18305;149112;760;0;0;0;0;.00nan;0;0
18306;170548;2545;0;0;0;0;.00nan;0;0
18306;175757;755;0;0;0;0;.00nan;0;0
18306;180154;755;100;27;0;27;1.000;3600000;0
18306;148829;2545;89;39;2;37;.949;3592000;0
18307;1756;1497;73;27;2;25;.926;3600000;0
18307;3241;2197;0;0;0;0;.00nan;0;0
18307;63529;1497;0;0;0;0;.00nan;0;0
18307;94018;2197;74;44;5;39;.886;3600000;0
18308;-1;4989;0;0;0;0;.00nan;0;0
18308;71485;4989;70;39;5;34;.872;3600000;0
18308;142648;769;60;18;2;16;.889;3600000;0
18308;149221;769;0;0;0;0;.00nan;0;0
18309;279;766;62;31;4;27;.871;3559000;0
18309;177124;775;0;0;0;0;.00nan;0;0
18309;180990;775;69;27;3;24;.889;3600000;0
18309;82711;766;0;0;0;0;.00nan;0;0
18310;3165;767;0;0;0;0;.00nan;0;0
18310;8504;774;0;0;0;0;.00nan;0;0
18310;91358;767;100;41;1;40;.976;3600000;0
18310;149280;774;68;25;2;23;.920;3564000;0
18311;169615;911;67;25;3;22;.880;3785000;0
18311;170530;1492;0;0;0;0;.00nan;0;0
18311;67446;1492;87;38;2;36;.947;3785000;0
18311;93756;911;0;0;0;0;.00nan;0;0
18312;166023;754;0;0;0;0;.00nan;0;0
18312;-1;4989;0;0;0;0;.00nan;0;0
18312;71485;4989;86;41;3;38;.927;3600000;0
18312;148904;754;43;25;4;21;.840;3600000;0
18313;167061;772;0;0;0;0;.00nan;0;0
18313;169680;759;0;0;0;0;.00nan;0;0
18313;197595;759;57;20;2;18;.900;3600000;0
18313;63932;772;48;38;6;32;.842;3600000;0
18314;3508;746;65;23;2;21;.913;3900000;0
18314;170548;2545;100;46;2;44;.957;3900000;0
18314;148829;2545;0;0;0;0;.00nan;0;0
18314;149191;746;0;0;0;0;.00nan;0;0
18315;174894;760;100;53;1;52;.981;3600000;0
18315;43971;768;0;0;0;0;.00nan;0;0
18315;149112;760;0;0;0;0;.00nan;0;0
18315;154296;768;50;18;2;16;.889;3564000;0
18316;3241;2197;0;0;0;0;.00nan;0;0
18316;164424;750;49;23;3;20;.870;3600000;0
18316;164521;750;0;0;0;0;.00nan;0;0
18316;94018;2197;67;39;5;34;.872;3600000;0
18317;3957;3730;0;0;0;0;.00nan;0;0
18317;4281;3730;66;31;4;27;.871;3879000;0
18317;175757;755;56;9;0;9;1.000;715000;0
18317;180154;755;62;26;3;23;.885;3164000;0
18318;1756;1497;0;0;0;0;.00nan;0;0
18318;186219;4924;0;0;0;0;.00nan;0;0
18318;63529;1497;67;30;2;28;.933;3793000;0
18318;81691;4924;82;30;3;27;.900;3793000;0
18319;67818;3721;94;35;1;34;.971;3900000;0
18319;91194;3721;0;0;0;0;.00nan;0;0
18319;142648;769;0;0;0;0;.00nan;0;0
18319;149221;769;100;41;1;40;.976;3900000;0
18320;189433;758;82;24;1;23;.958;3600000;0
18320;76628;758;0;0;0;0;.00nan;0;0
18320;85489;762;87;46;3;43;.935;3543000;0
18320;148652;762;0;0;0;0;.00nan;0;0
18321;189264;4923;0;0;0;0;.00nan;0;0
18321;176686;4923;47;19;3;16;.842;3616000;0
18321;68689;1503;0;0;0;0;.00nan;0;0
18321;76406;1503;74;30;2;28;.933;3616000;0
18322;279;766;49;22;3;19;.864;3600000;0
18322;3165;767;0;0;0;0;.00nan;0;0
18322;82711;766;0;0;0;0;.00nan;0;0
18322;91358;767;54;30;4;26;.867;3563000;0
18323;8504;774;0;0;0;0;.00nan;0;0
18323;169615;911;0;0;0;0;.00nan;0;0
18323;93756;911;99;38;1;37;.974;3600000;0
18323;149280;774;75;27;2;25;.926;3563000;0
18324;167061;772;0;0;0;0;.00nan;0;0
18324;186219;4924;0;0;0;0;.00nan;0;0
18324;63932;772;62;22;2;20;.909;3600000;0
18324;81691;4924;84;47;4;43;.915;3600000;0
18325;3508;746;100;25;0;25;1.000;3600000;0
18325;3957;3730;98;37;1;36;.973;3578000;0
18325;4281;3730;0;0;0;0;.00nan;0;0
18325;149191;746;0;0;0;0;.00nan;0;0
18326;-1;4989;0;0;0;0;.00nan;0;0
18326;195887;3913;0;0;0;0;.00nan;0;0
18326;71485;4989;71;28;3;25;.893;3900000;0
18326;148573;3913;85;39;3;36;.923;3900000;0
18327;3241;2197;0;0;0;0;.00nan;0;0
18327;43971;768;73;18;1;17;.944;3600000;0
18327;94018;2197;66;39;4;35;.897;3600000;0
18327;154296;768;0;0;0;0;.00nan;0;0
18328;164424;750;53;15;2;13;.867;3546000;0
18328;164521;750;0;0;0;0;.00nan;0;0
18328;174894;760;96;33;1;32;.970;3600000;0
18328;149112;760;0;0;0;0;.00nan;0;0
18329;170543;2199;0;0;0;0;.00nan;0;0
18329;67818;3721;53;17;2;15;.882;3900000;0
18329;87758;2199;100;48;2;46;.958;3900000;0
18329;91194;3721;0;0;0;0;.00nan;0;0
18330;1756;1497;81;49;4;45;.918;3600000;0
18330;169680;759;0;0;0;0;.00nan;0;0
18330;197595;759;67;20;1;19;.950;3600000;0
18330;63529;1497;0;0;0;0;.00nan;0;0
18331;189264;4923;70;26;2;24;.923;3600000;0
18331;176686;4923;0;0;0;0;.00nan;0;0
18331;85489;762;56;29;4;25;.862;3573000;0
18331;148652;762;0;0;0;0;.00nan;0;0
18332;189433;758;90;39;2;37;.949;3600000;0
18332;68689;1503;0;0;0;0;.00nan;0;0
18332;76406;1503;74;37;3;34;.919;3598000;0
18332;76628;758;0;0;0;0;.00nan;0;0
18333;279;766;47;30;4;26;.867;3586000;0
18333;169615;911;80;34;2;32;.941;3600000;0
18333;82711;766;0;0;0;0;.00nan;0;0
18333;93756;911;0;0;0;0;.00nan;0;0
18334;3241;2197;64;31;3;28;.903;3600000;0
18334;167061;772;0;0;0;0;.00nan;0;0
18334;63932;772;38;26;6;20;.769;3600000;0
18334;94018;2197;0;0;0;0;.00nan;0;0
18335;195887;3913;0;0;0;0;.00nan;0;0
18335;67818;3721;64;35;3;32;.914;3600000;0
18335;91194;3721;0;0;0;0;.00nan;0;0
18335;148573;3913;100;28;1;27;.964;3600000;0
18336;186219;4924;0;0;0;0;.00nan;0;0
18336;43971;768;92;18;0;18;1.000;3600000;0
18336;81691;4924;98;47;1;46;.979;3600000;0
18336;154296;768;0;0;0;0;.00nan;0;0
18337;164424;750;75;31;3;28;.903;3600000;0
18337;164521;750;0;0;0;0;.00nan;0;0
18337;169680;759;0;0;0;0;.00nan;0;0
18337;197595;759;67;36;4;32;.889;3552000;0
18338;-1;4989;53;43;6;37;.860;3562000;0
18338;170543;2199;46;20;4;16;.800;3600000;0
18338;71485;4989;0;0;0;0;.00nan;0;0
18338;87758;2199;0;0;0;0;.00nan;0;0
18339;3957;3730;0;0;0;0;.00nan;0;0
18339;4281;3730;88;40;2;38;.950;3900000;0
18339;170548;2545;0;0;0;0;.00nan;0;0
18339;148829;2545;99;41;2;39;.951;3900000;0
18340;1756;1497;0;0;0;0;.00nan;0;0
18340;174894;760;44;33;6;27;.818;3600000;0
18340;63529;1497;97;44;3;41;.932;3600000;0
18340;149112;760;0;0;0;0;.00nan;0;0
18341;177124;775;0;0;0;0;.00nan;0;0
18341;175757;755;59;29;3;26;.897;3600000;0
18341;180154;755;0;0;0;0;.00nan;0;0
18341;180990;775;48;26;4;22;.846;3555000;0
18342;166023;754;0;0;0;0;.00nan;0;0
18342;-1;1093;0;0;0;0;.00nan;0;0
18342;68233;1093;73;25;1;24;.960;3600000;0
18342;148904;754;63;30;3;27;.900;3549000;0
18343;169680;759;0;0;0;0;.00nan;0;0
18343;43971;768;86;31;1;30;.968;3600000;0
18343;197595;759;66;41;4;37;.902;3600000;0
18343;154296;768;0;0;0;0;.00nan;0;0
18344;170530;1492;56;41;6;35;.854;3600000;0
18344;67446;1492;0;0;0;0;.00nan;0;0
18344;142648;769;59;32;4;28;.875;3600000;0
18344;149221;769;0;0;0;0;.00nan;0;0
18345;164424;750;98;21;0;21;1.000;3600000;0
18345;164521;750;0;0;0;0;.00nan;0;0
18345;186219;4924;0;0;0;0;.00nan;0;0
18345;81691;4924;73;35;3;32;.914;3600000;0
18346;68689;1503;0;0;0;0;.00nan;0;0
18346;76406;1503;31;23;5;18;.783;3546000;0
18346;85489;762;63;32;4;28;.875;3600000;0
18346;148652;762;0;0;0;0;.00nan;0;0
18347;177124;775;0;0;0;0;.00nan;0;0
18347;3508;746;100;26;0;26;1.000;3600000;0
18347;180990;775;87;43;4;39;.907;3600000;0
18347;149191;746;0;0;0;0;.00nan;0;0
18348;3165;767;0;0;0;0;.00nan;0;0
18348;170548;2545;90;38;3;35;.921;3600000;0
18348;91358;767;65;37;5;32;.865;3530000;0
18348;148829;2545;0;0;0;0;.00nan;0;0
18349;169615;911;63;16;1;15;.938;3600000;0
18349;175757;755;95;47;2;45;.957;3558000;0
18349;180154;755;0;0;0;0;.00nan;0;0
18349;93756;911;0;0;0;0;.00nan;0;0
18350;3241;2197;0;0;0;0;.00nan;0;0
18350;189433;758;95;51;3;48;.941;3900000;0
18350;76628;758;0;0;0;0;.00nan;0;0
18350;94018;2197;59;29;3;26;.897;3860000;0
18351;8504;774;65;29;3;26;.897;3600000;0
18351;142648;769;0;0;0;0;.00nan;0;0
18351;149221;769;63;34;4;30;.882;3584000;0
18351;149280;774;0;0;0;0;.00nan;0;0
18352;-1;1093;79;32;2;30;.938;3600000;0
18352;170543;2199;36;18;4;14;.778;3571000;0
18352;68233;1093;0;0;0;0;.00nan;0;0
18352;87758;2199;0;0;0;0;.00nan;0;0
18353;189264;4923;0;0;0;0;.00nan;0;0
18353;174894;760;76;34;2;32;.941;3549000;0
18353;176686;4923;69;16;1;15;.938;3600000;0
18353;149112;760;0;0;0;0;.00nan;0;0
18354;1756;1497;75;19;1;18;.947;3600000;0
18354;-1;4989;0;0;0;0;.00nan;0;0
18354;63529;1497;0;0;0;0;.00nan;0;0
18354;71485;4989;87;37;2;35;.946;3544000;0
18355;167061;772;0;0;0;0;.00nan;0;0
18355;63932;772;51;36;5;31;.861;3600000;0
18355;67818;3721;0;0;0;0;.00nan;0;0
18355;91194;3721;71;20;1;19;.950;3600000;0
18356;170530;1492;0;0;0;0;.00nan;0;0
18356;195887;3913;0;0;0;0;.00nan;0;0
18356;67446;1492;75;30;2;28;.933;3600000;0
18356;148573;3913;74;39;3;36;.923;3545000;0
18357;279;766;0;0;0;0;.00nan;0;0
18357;166023;754;0;0;0;0;.00nan;0;0
18357;82711;766;77;22;1;21;.955;3600000;0
18357;148904;754;53;33;4;29;.879;3600000;0
18358;3508;746;68;24;2;22;.917;3600000;0
18358;169615;911;23;6;3;3;.500;362000;0
18358;93756;911;58;33;3;30;.909;3238000;0
18358;149191;746;0;0;0;0;.00nan;0;0
18359;3165;767;0;0;0;0;.00nan;0;0
18359;3957;3730;89;17;0;17;1.000;3600000;0
18359;4281;3730;0;0;0;0;.00nan;0;0
18359;91358;767;77;41;3;38;.927;3600000;0
18360;177124;775;0;0;0;0;.00nan;0;0
18360;170548;2545;0;0;0;0;.00nan;0;0
18360;180990;775;87;29;1;28;.966;3600000;0
18360;148829;2545;70;24;2;22;.917;3543000;0
18361;3241;2197;0;0;0;0;.00nan;0;0
18361;189264;4923;77;12;0;12;1.000;3600000;0
18361;176686;4923;0;0;0;0;.00nan;0;0
18361;94018;2197;63;49;6;43;.878;3600000;0
18362;8504;774;0;0;0;0;.00nan;0;0
18362;166023;754;0;0;0;0;.00nan;0;0
18362;148904;754;75;38;3;35;.921;3563000;0
18362;149280;774;76;26;2;24;.923;3600000;0
18363;-1;1093;100;33;1;32;.970;3600000;0
18363;195887;3913;0;0;0;0;.00nan;0;0
18363;68233;1093;0;0;0;0;.00nan;0;0
18363;148573;3913;73;34;3;31;.912;3600000;0
18364;189433;758;99;37;1;36;.973;3600000;0
18364;174894;760;79;41;2;39;.951;3600000;0
18364;76628;758;0;0;0;0;.00nan;0;0
18364;149112;760;0;0;0;0;.00nan;0;0
18365;167061;772;0;0;0;0;.00nan;0;0
18365;-1;4989;57;28;3;25;.893;2790000;0
18365;63932;772;64;15;1;14;.933;3600000;0
18365;71485;4989;29;14;4;10;.714;810000;0
18366;1756;1497;0;0;0;0;.00nan;0;0
18366;63529;1497;78;45;4;41;.911;3567000;0
18366;67818;3721;57;20;2;18;.900;3600000;0
18366;91194;3721;0;0;0;0;.00nan;0;0
18367;170530;1492;68;43;5;38;.884;3600000;0
18367;170543;2199;54;12;1;11;.917;3600000;0
18367;67446;1492;0;0;0;0;.00nan;0;0
18367;87758;2199;0;0;0;0;.00nan;0;0
18368;279;766;60;30;4;26;.867;3552000;0
18368;82711;766;0;0;0;0;.00nan;0;0
18368;142648;769;0;0;0;0;.00nan;0;0
18368;149221;769;86;36;2;34;.944;3600000;0
18369;177124;775;0;0;0;0;.00nan;0;0
18369;3957;3730;52;28;3;25;.893;3559000;0
18369;4281;3730;0;0;0;0;.00nan;0;0
18369;180990;775;70;29;2;27;.931;3600000;0
18370;169615;911;62;26;3;23;.885;3600000;0
18370;170548;2545;42;31;5;26;.839;3575000;0
18370;93756;911;0;0;0;0;.00nan;0;0
18370;148829;2545;0;0;0;0;.00nan;0;0
18371;3165;767;0;0;0;0;.00nan;0;0
18371;175757;755;0;0;0;0;.00nan;0;0
18371;180154;755;100;32;0;32;1.000;3600000;0
18371;91358;767;27;25;5;20;.800;3600000;0
18372;3241;2197;85;27;1;26;.963;3600000;0
18372;85489;762;50;28;4;24;.857;3600000;0
18372;94018;2197;0;0;0;0;.00nan;0;0
18372;148652;762;0;0;0;0;.00nan;0;0
18373;8504;774;0;0;0;0;.00nan;0;0
18373;170543;2199;56;29;3;26;.897;3600000;0
18373;87758;2199;0;0;0;0;.00nan;0;0
18373;149280;774;48;22;4;18;.818;3566000;0
18374;-1;1093;58;27;3;24;.889;3600000;0
18374;68233;1093;0;0;0;0;.00nan;0;0
18374;142648;769;100;36;0;36;1.000;3600000;0
18374;149221;769;0;0;0;0;.00nan;0;0
18375;174894;760;63;17;1;16;.941;3600000;0
18375;68689;1503;0;0;0;0;.00nan;0;0
18375;76406;1503;89;29;2;27;.931;3587000;0
18375;149112;760;0;0;0;0;.00nan;0;0
18376;164424;750;72;40;4;36;.900;3549000;0
18376;164521;750;0;0;0;0;.00nan;0;0
18376;-1;4989;0;0;0;0;.00nan;0;0
18376;71485;4989;74;30;2;28;.933;3600000;0
18377;43971;768;91;30;1;29;.967;3600000;0
18377;67818;3721;97;42;2;40;.952;3545000;0
18377;91194;3721;0;0;0;0;.00nan;0;0
18377;154296;768;0;0;0;0;.00nan;0;0
18378;189264;4923;0;0;0;0;.00nan;0;0
18378;176686;4923;88;18;1;17;.944;3900000;0
18378;186219;4924;0;0;0;0;.00nan;0;0
18378;81691;4924;94;31;1;30;.968;3900000;0
18379;166023;754;0;0;0;0;.00nan;0;0
18379;170530;1492;69;40;4;36;.900;3556000;0
18379;67446;1492;0;0;0;0;.00nan;0;0
18379;148904;754;72;26;2;24;.923;3600000;0
18380;279;766;0;0;0;0;.00nan;0;0
18380;195887;3913;0;0;0;0;.00nan;0;0
18380;82711;766;94;25;1;24;.960;3600000;0
18380;148573;3913;97;41;2;39;.951;3599000;0
18381;189433;758;81;32;2;30;.938;3895000;0
18381;169680;759;0;0;0;0;.00nan;0;0
18381;197595;759;100;40;2;38;.950;3900000;0
18381;76628;758;0;0;0;0;.00nan;0;0
18382;3165;767;0;0;0;0;.00nan;0;0
18382;3508;746;66;30;3;27;.900;3600000;0
18382;91358;767;76;45;4;41;.911;3543000;0
18382;149191;746;0;0;0;0;.00nan;0;0
18383;3957;3730;58;39;5;34;.872;3600000;0
18383;4281;3730;0;0;0;0;.00nan;0;0
18383;169615;911;81;31;2;29;.935;3600000;0
18383;93756;911;0;0;0;0;.00nan;0;0
18384;3241;2197;0;0;0;0;.00nan;0;0
18384;68689;1503;0;0;0;0;.00nan;0;0
18384;76406;1503;68;27;2;25;.926;3869000;0
18384;94018;2197;94;48;3;45;.938;3869000;0
18385;8504;774;0;0;0;0;.00nan;0;0
18385;195887;3913;0;0;0;0;.00nan;0;0
18385;148573;3913;48;47;7;40;.851;3600000;0
18385;149280;774;82;16;0;16;1.000;3600000;0
18386;174894;760;0;0;0;0;.00nan;0;0
18386;85489;762;90;33;1;32;.970;3600000;0
18386;148652;762;0;0;0;0;.00nan;0;0
18386;149112;760;64;24;2;22;.917;3593000;0
18387;-1;4989;0;0;0;0;.00nan;0;0
18387;43971;768;52;26;4;22;.846;3600000;0
18387;71485;4989;74;40;5;35;.875;3570000;0
18387;154296;768;0;0;0;0;.00nan;0;0
18388;164424;750;87;29;1;28;.966;3600000;0
18388;164521;750;0;0;0;0;.00nan;0;0
18388;67818;3721;80;32;2;30;.938;3544000;0
18388;91194;3721;0;0;0;0;.00nan;0;0
18389;189433;758;47;23;4;19;.826;3600000;0
18389;186219;4924;0;0;0;0;.00nan;0;0
18389;76628;758;0;0;0;0;.00nan;0;0
18389;81691;4924;92;38;2;36;.947;3600000;0
18390;279;766;72;24;1;23;.958;3600000;0
18390;170543;2199;57;29;3;26;.897;3513000;0
18390;82711;766;0;0;0;0;.00nan;0;0
18390;87758;2199;0;0;0;0;.00nan;0;0
18391;189264;4923;68;39;4;35;.897;3600000;0
18391;169680;759;66;40;5;35;.875;3566000;0
18391;176686;4923;0;0;0;0;.00nan;0;0
18391;197595;759;0;0;0;0;.00nan;0;0
18392;186219;4924;0;0;0;0;.00nan;0;0
18392;68689;1503;0;0;0;0;.00nan;0;0
18392;76406;1503;89;28;1;27;.964;3600000;0
18392;81691;4924;59;26;3;23;.885;3527000;0
18393;169680;759;0;0;0;0;.00nan;0;0
18393;197595;759;78;25;1;24;.960;3600000;0
18393;85489;762;41;16;3;13;.813;872000;0
18393;148652;762;44;29;5;24;.828;2728000;0
18394;3957;3730;0;0;0;0;.00nan;0;0
18394;4281;3730;49;26;4;22;.846;3600000;0
18394;166023;754;80;27;1;26;.963;3600000;0
18394;148904;754;0;0;0;0;.00nan;0;0
18395;-1;4989;0;0;0;0;.00nan;0;0
18395;189264;4923;0;0;0;0;.00nan;0;0
18395;176686;4923;46;25;4;21;.840;3597000;0
18395;71485;4989;69;25;2;23;.920;3600000;0
18396;167061;772;0;0;0;0;.00nan;0;0
18396;8504;774;0;0;0;0;.00nan;0;0
18396;63932;772;44;25;4;21;.840;3577000;0
18396;149280;774;61;23;2;21;.913;3600000;0
18397;189433;758;0;0;0;0;.00nan;0;0
18397;67818;3721;73;23;2;21;.913;3900000;0
18397;76628;758;90;41;2;39;.951;3900000;0
18397;91194;3721;0;0;0;0;.00nan;0;0
18398;3508;746;75;23;1;22;.957;3600000;0
18398;195887;3913;59;22;3;19;.864;1943000;0
18398;148573;3913;29;28;6;22;.786;1657000;0
18398;149191;746;0;0;0;0;.00nan;0;0
18399;-1;1093;79;41;3;38;.927;3585000;0
18399;43971;768;95;37;2;35;.946;3600000;0
18399;68233;1093;0;0;0;0;.00nan;0;0
18399;154296;768;0;0;0;0;.00nan;0;0
18400;186219;4924;0;0;0;0;.00nan;0;0
18400;81691;4924;93;37;1;36;.973;3600000;0
18400;85489;762;31;22;5;17;.773;3600000;0
18400;148652;762;0;0;0;0;.00nan;0;0
18401;164424;750;77;22;1;21;.955;3600000;0
18401;164521;750;0;0;0;0;.00nan;0;0
18401;170530;1492;100;43;0;43;1.000;3600000;0
18401;67446;1492;0;0;0;0;.00nan;0;0
18402;170543;2199;81;27;1;26;.963;3600000;0
18402;175757;755;0;0;0;0;.00nan;0;0
18402;180154;755;63;41;5;36;.878;3600000;0
18402;87758;2199;0;0;0;0;.00nan;0;0
18403;169680;759;0;0;0;0;.00nan;0;0
18403;197595;759;94;21;0;21;1.000;3600000;0
18403;68689;1503;40;3;1;2;.667;285000;0
18403;76406;1503;49;33;6;27;.818;3315000;0
18404;279;766;75;23;1;22;.957;3600000;0
18404;1756;1497;51;29;5;24;.828;3600000;0
18404;63529;1497;0;0;0;0;.00nan;0;0
18404;82711;766;0;0;0;0;.00nan;0;0
18405;170548;2545;0;0;0;0;.00nan;0;0
18405;142648;769;78;31;2;29;.935;3600000;0
18405;148829;2545;70;37;3;34;.919;3600000;0
18405;149221;769;0;0;0;0;.00nan;0;0
18406;177124;775;0;0;0;0;.00nan;0;0
18406;3165;767;68;14;1;13;.929;3600000;0
18406;180990;775;93;54;4;50;.926;3600000;0
18406;91358;767;0;0;0;0;.00nan;0;0
18407;166023;754;0;0;0;0;.00nan;0;0
18407;170548;2545;77;20;1;19;.950;3900000;0
18407;148829;2545;0;0;0;0;.00nan;0;0
18407;148904;754;100;45;1;44;.978;3900000;0
18408;189264;4923;62;15;1;14;.933;3600000;0
18408;176686;4923;0;0;0;0;.00nan;0;0
18408;67818;3721;42;24;4;20;.833;2373000;0
18408;91194;3721;47;14;2;12;.857;1227000;0
18409;279;766;57;18;2;16;.889;3600000;0
18409;167061;772;61;33;4;29;.879;3600000;0
18409;63932;772;0;0;0;0;.00nan;0;0
18409;82711;766;0;0;0;0;.00nan;0;0
18410;-1;4989;0;0;0;0;.00nan;0;0
18410;189433;758;59;31;4;27;.871;3544000;0
18410;71485;4989;67;32;3;29;.906;3600000;0
18410;76628;758;0;0;0;0;.00nan;0;0
18411;175757;755;0;0;0;0;.00nan;0;0
18411;195887;3913;0;0;0;0;.00nan;0;0
18411;180154;755;79;28;1;27;.964;3600000;0
18411;148573;3913;65;23;2;21;.913;3544000;0
18412;170530;1492;98;51;3;48;.941;3600000;0
18412;43971;768;66;24;2;22;.917;3600000;0
18412;67446;1492;0;0;0;0;.00nan;0;0
18412;154296;768;0;0;0;0;.00nan;0;0
18413;164424;750;84;30;3;27;.900;3600000;0
18413;164521;750;0;0;0;0;.00nan;0;0
18413;-1;1093;62;33;4;29;.879;3600000;0
18413;68233;1093;0;0;0;0;.00nan;0;0
18414;3508;746;91;38;2;36;.947;3600000;0
18414;170543;2199;70;34;3;31;.912;3600000;0
18414;87758;2199;0;0;0;0;.00nan;0;0
18414;149191;746;0;0;0;0;.00nan;0;0
18415;1756;1497;0;0;0;0;.00nan;0;0
18415;8504;774;0;0;0;0;.00nan;0;0
18415;63529;1497;73;52;5;47;.904;3600000;0
18415;149280;774;93;17;0;17;1.000;3600000;0
18416;3957;3730;85;29;1;28;.966;3732000;0
18416;4281;3730;0;0;0;0;.00nan;0;0
18416;142648;769;0;0;0;0;.00nan;0;0
18416;149221;769;72;25;2;23;.920;3732000;0
18417;3165;767;0;0;0;0;.00nan;0;0
18417;169615;911;73;34;4;30;.882;3549000;0
18417;91358;767;70;38;3;35;.921;3600000;0
18417;93756;911;0;0;0;0;.00nan;0;0
18418;166023;754;0;0;0;0;.00nan;0;0
18418;175757;755;0;0;0;0;.00nan;0;0
18418;180154;755;57;25;3;22;.880;3600000;0
18418;148904;754;55;26;4;22;.846;3566000;0
18419;67818;3721;79;31;2;29;.935;3900000;0
18419;85489;762;82;33;2;31;.939;3900000;0
18419;91194;3721;0;0;0;0;.00nan;0;0
18419;148652;762;0;0;0;0;.00nan;0;0
18420;167061;772;0;0;0;0;.00nan;0;0
18420;170530;1492;74;36;3;33;.917;3517000;0
18420;63932;772;73;24;1;23;.958;3600000;0
18420;67446;1492;0;0;0;0;.00nan;0;0
18421;-1;4989;0;0;0;0;.00nan;0;0
18421;68689;1503;0;0;0;0;.00nan;0;0
18421;71485;4989;67;32;3;29;.906;3900000;0
18421;76406;1503;59;25;3;22;.880;3900000;0
18422;170548;2545;0;0;0;0;.00nan;0;0
18422;195887;3913;0;0;0;0;.00nan;0;0
18422;148573;3913;66;33;4;29;.879;3600000;0
18422;148829;2545;72;21;1;20;.952;3600000;0
18423;279;766;32;10;3;7;.700;369000;0
18423;43971;768;69;35;5;30;.857;3821000;0
18423;82711;766;63;31;3;28;.903;3452000;0
18423;154296;768;0;0;0;0;.00nan;0;0
18424;174894;760;44;28;5;23;.821;3600000;0
18424;186219;4924;0;0;0;0;.00nan;0;0
18424;81691;4924;100;26;0;26;1.000;3600000;0
18424;149112;760;0;0;0;0;.00nan;0;0
18425;8504;774;0;0;0;0;.00nan;0;0
18425;164424;750;84;25;1;24;.960;3600000;0
18425;164521;750;0;0;0;0;.00nan;0;0
18425;149280;774;81;31;2;29;.935;3598000;0
18426;3957;3730;0;0;0;0;.00nan;0;0
18426;4281;3730;71;35;4;31;.886;3572000;0
18426;170543;2199;55;22;3;19;.864;3600000;0
18426;87758;2199;0;0;0;0;.00nan;0;0
18427;3241;2197;79;37;3;34;.919;3517000;0
18427;169680;759;0;0;0;0;.00nan;0;0
18427;197595;759;74;18;1;17;.944;3600000;0
18427;94018;2197;0;0;0;0;.00nan;0;0
18428;1756;1497;77;23;1;22;.957;3600000;0
18428;-1;1093;80;27;2;25;.926;3573000;0
18428;63529;1497;0;0;0;0;.00nan;0;0
18428;68233;1093;0;0;0;0;.00nan;0;0
18429;3508;746;66;16;1;15;.938;3600000;0
18429;142648;769;95;33;2;31;.939;3553000;0
18429;149191;746;0;0;0;0;.00nan;0;0
18429;149221;769;0;0;0;0;.00nan;0;0
18430;177124;775;0;0;0;0;.00nan;0;0
18430;169615;911;40;23;4;19;.826;2184000;0
18430;180990;775;45;28;4;24;.857;3600000;0
18430;93756;911;52;9;1;8;.889;1370000;0
18431;3508;746;59;11;1;10;.909;3542000;0
18431;166023;754;100;37;0;37;1.000;3600000;0
18431;148904;754;0;0;0;0;.00nan;0;0
18431;149191;746;0;0;0;0;.00nan;0;0
18432;-1;4989;0;0;0;0;.00nan;0;0
18432;71485;4989;73;34;3;31;.912;3580000;0
18432;85489;762;80;22;1;21;.955;3600000;0
18432;148652;762;0;0;0;0;.00nan;0;0
18433;189264;4923;0;0;0;0;.00nan;0;0
18433;189433;758;0;0;0;0;.00nan;0;0
18433;176686;4923;62;29;4;25;.862;3600000;0
18433;155943;758;95;34;1;33;.971;3600000;0
18434;167061;772;0;0;0;0;.00nan;0;0
18434;-1;1093;80;35;3;32;.914;3600000;0
18434;63932;772;66;24;2;22;.917;3600000;0
18434;68233;1093;0;0;0;0;.00nan;0;0
18435;67818;3721;74;24;1;23;.958;3546000;0
18435;68689;1503;0;0;0;0;.00nan;0;0
18435;76406;1503;100;28;0;28;1.000;3600000;0
18435;91194;3721;0;0;0;0;.00nan;0;0
18436;3957;3730;95;37;1;36;.973;3600000;0
18436;4281;3730;0;0;0;0;.00nan;0;0
18436;195887;3913;100;31;0;31;1.000;3600000;0
18436;148573;3913;0;0;0;0;.00nan;0;0
18437;8504;774;0;0;0;0;.00nan;0;0
18437;43971;768;78;32;2;30;.938;3900000;0
18437;149280;774;82;29;2;27;.931;3900000;0
18437;154296;768;0;0;0;0;.00nan;0;0
18438;3241;2197;0;0;0;0;.00nan;0;0
18438;186219;4924;0;0;0;0;.00nan;0;0
18438;81691;4924;79;24;2;22;.917;3900000;0
18438;94018;2197;87;31;2;29;.935;3900000;0
18439;279;766;19;27;7;20;.741;3600000;0
18439;164424;750;72;36;3;33;.917;3600000;0
18439;164521;750;0;0;0;0;.00nan;0;0
18439;82711;766;0;0;0;0;.00nan;0;0
18440;170543;2199;33;9;3;6;.667;3600000;0
18440;170548;2545;68;37;4;33;.892;3600000;0
18440;87758;2199;0;0;0;0;.00nan;0;0
18440;148829;2545;0;0;0;0;.00nan;0;0
18441;169680;759;86;16;0;16;1.000;3600000;0
18441;174894;760;0;0;0;0;.00nan;0;0
18441;197595;759;0;0;0;0;.00nan;0;0
18441;149112;760;65;46;5;41;.891;3600000;0
18442;1756;1497;0;0;0;0;.00nan;0;0
18442;170530;1492;0;0;0;0;.00nan;0;0
18442;63529;1497;79;23;1;22;.957;3600000;0
18442;67446;1492;80;33;2;31;.939;3585000;0
18443;175757;755;0;0;0;0;.00nan;0;0
18443;180154;755;70;49;5;44;.898;3600000;0
18443;142648;769;0;0;0;0;.00nan;0;0
18443;149221;769;69;19;1;18;.947;3600000;0
18445;170548;2545;0;0;0;0;.00nan;0;0
18445;146249;3913;0;0;0;0;.00nan;0;0
18445;148573;3913;64;27;3;24;.889;3868000;0
18445;148829;2545;76;36;3;33;.917;3900000;0
18447;1756;758;35;19;4;15;.789;3600000;0
18447;189433;4924;39;31;6;25;.806;3598000;0
18447;186219;4924;0;0;0;0;.00nan;0;0
18447;94107;758;0;0;0;0;.00nan;0;0
18449;63529;3730;100;39;0;39;1.000;3600000;0
18449;76628;3730;0;0;0;0;.00nan;0;0
18449;148576;1497;54;29;4;25;.862;3600000;0
18449;149191;1497;0;0;0;0;.00nan;0;0
18451;279;766;63;31;4;27;.871;3600000;0
18451;-1;1093;49;36;5;31;.861;3599000;0
18451;68233;1093;0;0;0;0;.00nan;0;0
18451;82711;766;0;0;0;0;.00nan;0;0
18453;174894;762;52;29;4;25;.862;3600000;0
18453;197595;2199;77;19;1;18;.947;3600000;0
18453;76406;2199;0;0;0;0;.00nan;0;0
18453;148652;762;0;0;0;0;.00nan;0;0
18455;85489;760;75;22;1;21;.955;3600000;0
18455;142648;769;0;0;0;0;.00nan;0;0
18455;149112;760;0;0;0;0;.00nan;0;0
18455;149221;769;69;35;3;32;.914;3576000;0
18457;3508;746;100;36;0;36;1.000;3600000;0
18457;201933;746;0;0;0;0;.00nan;0;0
18457;81733;768;92;50;4;46;.920;3600000;0
18457;82817;768;0;0;0;0;.00nan;0;0
18459;169615;911;64;43;4;39;.907;3560000;0
18459;192065;772;0;0;0;0;.00nan;0;0
18459;57993;772;74;35;3;32;.914;3600000;0
18459;93756;911;0;0;0;0;.00nan;0;0
18461;170543;754;73;36;3;33;.917;3566000;0
18461;67122;1503;71;24;2;22;.917;3600000;0
18461;68689;1503;0;0;0;0;.00nan;0;0
18461;148904;754;0;0;0;0;.00nan;0;0
18463;164424;750;70;31;3;28;.903;3600000;0
18463;164521;750;0;0;0;0;.00nan;0;0
18463;175757;755;0;0;0;0;.00nan;0;0
18463;180154;755;55;27;4;23;.852;3543000;0
18465;176686;4923;0;0;0;0;.00nan;0;0
18465;67294;774;0;0;0;0;.00nan;0;0
18465;148956;4923;51;27;3;24;.889;3900000;0
18465;149280;774;82;40;3;37;.925;3900000;0
18467;170530;1492;48;38;6;32;.842;2978000;0
18467;67446;1492;54;5;0;5;1.000;622000;0
18467;67818;3721;82;19;1;18;.947;3600000;0
18467;91194;3721;0;0;0;0;.00nan;0;0
18469;177124;775;63;28;3;25;.893;3594000;0
18469;11614;2197;93;41;2;39;.951;3600000;0
18469;180990;775;0;0;0;0;.00nan;0;0
18469;94508;2197;0;0;0;0;.00nan;0;0
18471;359;759;58;17;2;15;.882;3600000;0
18471;-1;4989;62;7;0;7;1.000;471000;0
18471;169680;759;0;0;0;0;.00nan;0;0
18471;71485;4989;20;25;7;18;.720;3129000;0
18473;3165;767;0;0;0;0;.00nan;0;0
18473;-1;4989;0;0;0;0;.00nan;0;0
18473;71485;4989;80;30;2;28;.933;3558000;0
18473;91358;767;100;30;0;30;1.000;3600000;0
18475;359;759;78;26;1;25;.962;3600000;0
18475;169680;759;0;0;0;0;.00nan;0;0
18475;148576;1497;54;28;3;25;.893;3572000;0
18475;149191;1497;0;0;0;0;.00nan;0;0
18477;174894;762;91;35;2;33;.943;3600000;0
18477;67294;774;0;0;0;0;.00nan;0;0
18477;148652;762;0;0;0;0;.00nan;0;0
18477;149280;774;45;25;3;22;.880;3581000;0
18479;169615;911;80;51;4;47;.922;3900000;0
18479;81733;768;0;0;0;0;.00nan;0;0
18479;82817;768;64;29;4;25;.862;3900000;0
18479;93756;911;0;0;0;0;.00nan;0;0
18481;1756;758;74;37;4;33;.892;3862000;0
18481;94107;758;0;0;0;0;.00nan;0;0
18481;142648;769;0;0;0;0;.00nan;0;0
18481;149221;769;59;25;3;22;.880;3823000;0
18483;164424;750;73;39;3;36;.923;3600000;0
18483;164521;750;0;0;0;0;.00nan;0;0
18483;11614;2197;68;44;5;39;.886;3600000;0
18483;94508;2197;0;0;0;0;.00nan;0;0
18485;175757;755;0;0;0;0;.00nan;0;0
18485;180154;755;83;39;3;36;.923;3600000;0
18485;67122;1503;0;0;0;0;.00nan;0;0
18485;68689;1503;36;20;4;16;.800;3551000;0
18487;63529;3730;44;44;7;37;.841;3600000;0
18487;76628;3730;0;0;0;0;.00nan;0;0
18487;146249;3913;0;0;0;0;.00nan;0;0
18487;148573;3913;98;43;2;41;.953;3600000;0
18489;-1;1093;100;34;0;34;1.000;3600000;0
18489;176686;4923;89;34;1;33;.971;3600000;0
18489;68233;1093;0;0;0;0;.00nan;0;0
18489;148956;4923;0;0;0;0;.00nan;0;0
18491;170543;754;47;39;5;34;.872;3600000;0
18491;192065;772;0;0;0;0;.00nan;0;0
18491;57993;772;58;16;2;14;.875;3600000;0
18491;148904;754;0;0;0;0;.00nan;0;0
18493;279;766;73;22;1;21;.955;3900000;0
18493;170530;1492;100;51;1;50;.980;3900000;0
18493;67446;1492;0;0;0;0;.00nan;0;0
18493;82711;766;0;0;0;0;.00nan;0;0
18495;3508;746;73;33;3;30;.909;3561000;0
18495;189433;4924;82;32;2;30;.938;3600000;0
18495;201933;746;0;0;0;0;.00nan;0;0
18495;186219;4924;0;0;0;0;.00nan;0;0
18497;67818;3721;93;39;2;37;.949;3900000;0
18497;85489;760;69;26;2;24;.923;3900000;0
18497;91194;3721;0;0;0;0;.00nan;0;0
18497;149112;760;0;0;0;0;.00nan;0;0
18499;177124;775;0;0;0;0;.00nan;0;0
18499;180990;775;66;27;3;24;.889;3600000;0
18499;197595;2199;58;29;4;25;.862;3588000;0
18499;76406;2199;0;0;0;0;.00nan;0;0
18501;177124;775;79;14;0;14;1.000;3600000;0
18501;180990;775;0;0;0;0;.00nan;0;0
18501;192065;772;68;37;4;33;.892;3600000;0
18501;57993;772;0;0;0;0;.00nan;0;0
18503;164424;750;0;0;0;0;.00nan;0;0
18503;164521;750;94;19;0;19;1.000;3600000;0
18503;170530;1492;0;0;0;0;.00nan;0;0
18503;67446;1492;47;53;7;46;.868;3600000;0
18505;189433;4924;0;0;0;0;.00nan;0;0
18505;186219;4924;94;35;1;34;.971;3582000;0
18505;197595;2199;0;0;0;0;.00nan;0;0
18505;76406;2199;99;22;0;22;1.000;3600000;0
18507;11614;2197;0;0;0;0;.00nan;0;0
18507;174894;762;0;0;0;0;.00nan;0;0
18507;94508;2197;77;36;3;33;.917;3900000;0
18507;148652;762;63;24;3;21;.875;3900000;0
18509;359;759;0;0;0;0;.00nan;0;0
18509;-1;4989;98;54;3;51;.944;3600000;0
18509;169680;759;82;28;2;26;.929;3600000;0
18509;71485;4989;0;0;0;0;.00nan;0;0
18511;3508;746;0;0;0;0;.00nan;0;0
18511;170548;2545;89;56;4;52;.929;3600000;0
18511;201933;746;48;8;2;6;.750;3600000;0
18511;148829;2545;0;0;0;0;.00nan;0;0
18513;-1;1093;79;39;3;36;.923;3900000;0
18513;68233;1093;0;0;0;0;.00nan;0;0
18513;81733;768;65;31;3;28;.903;3900000;0
18513;82817;768;0;0;0;0;.00nan;0;0
18515;63529;3730;0;0;0;0;.00nan;0;0
18515;76628;3730;60;28;3;25;.893;3512000;0
18515;142648;769;94;35;1;34;.971;3600000;0
18515;149221;769;0;0;0;0;.00nan;0;0
18517;169615;911;0;0;0;0;.00nan;0;0
18517;93756;911;86;15;0;15;1.000;3600000;0
18517;146249;3913;72;35;2;33;.943;3536000;0
18517;148573;3913;0;0;0;0;.00nan;0;0
18519;279;766;0;0;0;0;.00nan;0;0
18519;3165;767;0;0;0;0;.00nan;0;0
18519;82711;766;68;27;3;24;.889;3900000;0
18519;91358;767;86;34;3;31;.912;3900000;0
18521;1756;758;0;0;0;0;.00nan;0;0
18521;175757;755;65;34;3;31;.912;3531000;0
18521;180154;755;0;0;0;0;.00nan;0;0
18521;94107;758;99;40;1;39;.975;3600000;0
18523;176686;4923;0;0;0;0;.00nan;0;0
18523;85489;760;0;0;0;0;.00nan;0;0
18523;148956;4923;68;34;4;30;.882;3539000;0
18523;149112;760;73;29;2;27;.931;3600000;0
18525;170543;754;0;0;0;0;.00nan;0;0
18525;148576;1497;0;0;0;0;.00nan;0;0
18525;148904;754;75;25;1;24;.960;3600000;0
18525;149191;1497;68;35;3;32;.914;3530000;0
18527;67294;774;71;18;1;17;.944;3600000;0
18527;67818;3721;0;0;0;0;.00nan;0;0
18527;91194;3721;100;49;0;49;1.000;3600000;0
18527;149280;774;0;0;0;0;.00nan;0;0
18529;175757;755;0;0;0;0;.00nan;0;0
18529;180154;755;95;33;1;32;.970;3600000;0
18529;85489;760;11;19;6;13;.684;2510000;0
18529;149112;760;53;4;0;4;1.000;1090000;0
18531;189433;4924;0;0;0;0;.00nan;0;0
18531;186219;4924;81;26;1;25;.962;3600000;0
18531;192065;772;0;0;0;0;.00nan;0;0
18531;57993;772;64;24;3;21;.875;3589000;0
18533;164424;750;0;0;0;0;.00nan;0;0
18533;164521;750;56;36;4;32;.889;3594000;0
18533;170543;754;90;39;2;37;.949;3600000;0
18533;148904;754;0;0;0;0;.00nan;0;0
18535;3508;746;81;34;2;32;.941;3600000;0
18535;201933;746;0;0;0;0;.00nan;0;0
18535;197595;2199;0;0;0;0;.00nan;0;0
18535;76406;2199;77;36;3;33;.917;3578000;0
18537;67122;1503;66;37;4;33;.892;3540000;0
18537;68689;1503;0;0;0;0;.00nan;0;0
18537;148576;1497;80;33;2;31;.939;3600000;0
18537;149191;1497;0;0;0;0;.00nan;0;0
18539;-1;1093;60;21;2;19;.905;3583000;0
18539;174894;762;97;35;1;34;.971;3600000;0
18539;68233;1093;0;0;0;0;.00nan;0;0
18539;148652;762;0;0;0;0;.00nan;0;0
18541;169615;911;0;0;0;0;.00nan;0;0
18541;63529;3730;59;33;4;29;.879;3558000;0
18541;76628;3730;0;0;0;0;.00nan;0;0
18541;93756;911;94;45;3;42;.933;3600000;0
18543;67294;774;0;0;0;0;.00nan;0;0
18543;67818;3721;69;15;0;15;1.000;792000;0
18543;91194;3721;53;41;6;35;.854;2808000;0
18543;149280;774;55;19;3;16;.842;3600000;0
18545;3165;767;0;0;0;0;.00nan;0;0
18545;91358;767;71;27;2;25;.926;3600000;0
18545;146249;3913;54;3;0;3;1.000;543000;0
18545;148573;3913;39;36;6;30;.833;3057000;0
18547;279;766;36;18;4;14;.778;3900000;0
18547;11614;2197;79;45;4;41;.911;3900000;0
18547;82711;766;0;0;0;0;.00nan;0;0
18547;94508;2197;0;0;0;0;.00nan;0;0
18549;359;759;69;28;3;25;.893;3600000;0
18549;169680;759;0;0;0;0;.00nan;0;0
18549;81733;768;0;0;0;0;.00nan;0;0
18549;82817;768;40;26;4;22;.846;3553000;0
18551;176686;4923;0;0;0;0;.00nan;0;0
18551;142648;769;90;29;0;29;1.000;2564000;0
18551;148956;4923;44;17;3;14;.824;3600000;0
18551;149221;769;27;14;4;10;.714;1036000;0
18553;177124;775;31;25;6;19;.760;2903000;0
18553;-1;4989;0;0;0;0;.00nan;0;0
18553;180990;775;58;3;0;3;1.000;697000;0
18553;71485;4989;91;39;2;37;.949;3600000;0
18555;1756;758;80;25;1;24;.960;3600000;0
18555;170548;2545;62;25;2;23;.920;3568000;0
18555;94107;758;0;0;0;0;.00nan;0;0
18555;148829;2545;0;0;0;0;.00nan;0;0
18557;169615;911;76;30;3;27;.900;3600000;0
18557;93756;911;0;0;0;0;.00nan;0;0
18557;146249;3913;68;40;4;36;.900;3545000;0
18557;148573;3913;0;0;0;0;.00nan;0;0
18559;197595;2199;71;35;3;32;.914;3600000;0
18559;76406;2199;0;0;0;0;.00nan;0;0
18559;85489;760;0;0;0;0;.00nan;0;0
18559;149112;760;44;27;4;23;.852;3600000;0
18561;192065;772;94;39;1;38;.974;3600000;0
18561;57993;772;0;0;0;0;.00nan;0;0
18561;67122;1503;0;0;0;0;.00nan;0;0
18561;68689;1503;78;31;2;29;.935;3549000;0
18563;279;766;0;0;0;0;.00nan;0;0
18563;67818;3721;85;38;2;36;.947;3589000;0
18563;82711;766;90;21;0;21;1.000;3600000;0
18563;91194;3721;0;0;0;0;.00nan;0;0
18565;164424;750;52;21;3;18;.857;3600000;0
18565;164521;750;0;0;0;0;.00nan;0;0
18565;189433;4924;55;36;5;31;.861;3529000;0
18565;186219;4924;0;0;0;0;.00nan;0;0
18567;1756;758;0;0;0;0;.00nan;0;0
18567;11614;2197;57;6;0;6;1.000;684000;0
18567;94107;758;46;18;3;15;.833;3600000;0
18567;94508;2197;42;42;6;36;.857;2916000;0
18569;3165;767;34;21;4;17;.810;2264000;0
18569;81733;768;45;17;3;14;.824;3600000;0
18569;82817;768;0;0;0;0;.00nan;0;0
18569;91358;767;69;21;1;20;.952;1336000;0
18571;177124;775;0;0;0;0;.00nan;0;0
18571;176686;4923;67;31;3;28;.903;3563000;0
18571;180990;775;78;24;1;23;.958;3600000;0
18571;148956;4923;0;0;0;0;.00nan;0;0
18573;170543;754;0;0;0;0;.00nan;0;0
18573;175757;755;85;34;2;32;.941;3589000;0
18573;180154;755;0;0;0;0;.00nan;0;0
18573;148904;754;78;25;1;24;.960;3600000;0
18575;67294;774;88;18;0;18;1.000;3600000;0
18575;148576;1497;0;0;0;0;.00nan;0;0
18575;149191;1497;89;36;2;34;.944;3600000;0
18575;149280;774;0;0;0;0;.00nan;0;0
18577;-1;4989;89;31;1;30;.968;3600000;0
18577;170548;2545;0;0;0;0;.00nan;0;0
18577;71485;4989;0;0;0;0;.00nan;0;0
18577;148829;2545;39;22;4;18;.818;3600000;0
18579;-1;1093;0;0;0;0;.00nan;0;0
18579;68233;1093;74;30;2;28;.933;3600000;0
18579;142648;769;0;0;0;0;.00nan;0;0
18579;149221;769;58;23;3;20;.870;3544000;0
18581;3508;746;68;16;1;15;.938;3610000;0
18581;170530;1492;94;50;2;48;.960;3610000;0
18581;201933;746;0;0;0;0;.00nan;0;0
18581;67446;1492;0;0;0;0;.00nan;0;0
18583;359;759;0;0;0;0;.00nan;0;0
18583;169680;759;82;24;1;23;.958;3900000;0
18583;63529;3730;0;0;0;0;.00nan;0;0
18583;76628;3730;95;42;1;41;.976;3900000;0
18585;-1;4989;0;0;0;0;.00nan;0;0
18585;174894;762;65;25;3;22;.880;3600000;0
18585;71485;4989;55;54;7;47;.870;3600000;0
18585;148652;762;0;0;0;0;.00nan;0;0
18587;3508;746;49;30;4;26;.867;3900000;0
18587;201933;746;0;0;0;0;.00nan;0;0
18587;67818;3721;90;50;4;46;.920;3900000;0
18587;91194;3721;0;0;0;0;.00nan;0;0
18589;1756;758;94;45;3;42;.933;3600000;0
18589;169615;911;0;0;0;0;.00nan;0;0
18589;93756;911;53;16;2;14;.875;3600000;0
18589;94107;758;0;0;0;0;.00nan;0;0
18591;177124;775;67;21;2;19;.905;3600000;0
18591;175757;755;0;0;0;0;.00nan;0;0
18591;180154;755;93;49;4;45;.918;3600000;0
18591;180990;775;0;0;0;0;.00nan;0;0
18593;359;759;81;25;1;24;.960;3600000;0
18593;3165;767;0;0;0;0;.00nan;0;0
18593;169680;759;0;0;0;0;.00nan;0;0
18593;91358;767;89;44;2;42;.955;3600000;0
18595;63529;3730;57;25;3;22;.880;3561000;0
18595;76628;3730;0;0;0;0;.00nan;0;0
18595;146249;3913;0;0;0;0;.00nan;0;0
18595;148573;3913;80;37;2;35;.946;3600000;0
18597;279;766;0;0;0;0;.00nan;0;0
18597;176686;4923;0;0;0;0;.00nan;0;0
18597;82711;766;80;22;1;21;.955;3600000;0
18597;148956;4923;73;34;2;32;.941;3559000;0
18599;67122;1503;86;24;1;23;.958;3600000;0
18599;68689;1503;0;0;0;0;.00nan;0;0
18599;148576;1497;72;28;2;26;.929;3600000;0
18599;149191;1497;0;0;0;0;.00nan;0;0
18601;170548;2545;31;21;5;16;.762;2024000;0
18601;142648;769;0;0;0;0;.00nan;0;0
18601;148829;2545;67;11;0;11;1.000;1576000;0
18601;149221;769;11;27;7;20;.741;3541000;0
18603;-1;1093;87;59;5;54;.915;3595000;0
18603;67294;774;57;26;3;23;.885;3600000;0
18603;68233;1093;0;0;0;0;.00nan;0;0
18603;149280;774;0;0;0;0;.00nan;0;0
18605;11614;2197;78;33;3;30;.909;3900000;0
18605;189433;4924;0;0;0;0;.00nan;0;0
18605;186219;4924;70;29;3;26;.897;3900000;0
18605;94508;2197;0;0;0;0;.00nan;0;0
18607;164424;750;79;25;1;24;.960;3600000;0
18607;164521;750;0;0;0;0;.00nan;0;0
18607;170543;754;74;29;2;27;.931;3548000;0
18607;148904;754;0;0;0;0;.00nan;0;0
18609;197595;2199;80;32;2;30;.938;3600000;0
18609;76406;2199;0;0;0;0;.00nan;0;0
18609;81733;768;0;0;0;0;.00nan;0;0
18609;82817;768;44;24;4;20;.833;3534000;0
18611;192065;772;0;0;0;0;.00nan;0;0
18611;57993;772;62;23;3;20;.870;3600000;0
18611;85489;760;72;27;2;25;.926;3600000;0
18611;149112;760;0;0;0;0;.00nan;0;0
18613;3508;746;0;0;0;0;.00nan;0;0
18613;201933;746;59;26;3;23;.885;3600000;0
18613;85489;760;0;0;0;0;.00nan;0;0
18613;149112;760;42;38;6;32;.842;3600000;0
18615;-1;1093;0;0;0;0;.00nan;0;0
18615;68233;1093;82;39;3;36;.923;3600000;0
18615;148576;1497;0;0;0;0;.00nan;0;0
18615;149191;1497;56;18;2;16;.889;3600000;0
18617;175757;755;67;35;3;32;.914;3563000;0
18617;176686;4923;59;12;1;11;.917;3600000;0
18617;180154;755;0;0;0;0;.00nan;0;0
18617;148956;4923;0;0;0;0;.00nan;0;0
18619;359;759;0;0;0;0;.00nan;0;0
18619;169680;759;72;32;2;30;.938;3600000;0
18619;170530;1492;41;30;6;24;.800;2751000;0
18619;67446;1492;67;16;1;15;.938;849000;0
18621;169615;911;36;18;4;14;.778;3136000;0
18621;93756;911;42;4;1;3;.750;464000;0
18621;146249;3913;70;31;3;28;.903;3600000;0
18621;148573;3913;0;0;0;0;.00nan;0;0
18623;197595;2199;0;0;0;0;.00nan;0;0
18623;67818;3721;0;0;0;0;.00nan;0;0
18623;76406;2199;75;26;2;24;.923;3677000;0
18623;91194;3721;79;34;3;31;.912;3677000;0
18625;-1;4989;74;32;2;30;.938;3600000;0
18625;170548;2545;0;0;0;0;.00nan;0;0
18625;71485;4989;0;0;0;0;.00nan;0;0
18625;148829;2545;49;20;3;17;.850;3553000;0
18627;1756;758;0;0;0;0;.00nan;0;0
18627;174894;762;0;0;0;0;.00nan;0;0
18627;94107;758;97;48;3;45;.938;3600000;0
18627;148652;762;75;31;2;29;.935;3600000;0
18629;63529;3730;0;0;0;0;.00nan;0;0
18629;67122;1503;0;0;0;0;.00nan;0;0
18629;68689;1503;64;28;3;25;.893;3545000;0
18629;76628;3730;92;31;1;30;.968;3600000;0
18631;170543;754;0;0;0;0;.00nan;0;0
18631;81733;768;60;20;2;18;.900;3600000;0
18631;82817;768;0;0;0;0;.00nan;0;0
18631;148904;754;61;37;4;33;.892;3541000;0
18633;3165;767;70;21;1;20;.952;3600000;0
18633;91358;767;0;0;0;0;.00nan;0;0
18633;142648;769;65;32;3;29;.906;3528000;0
18633;149221;769;0;0;0;0;.00nan;0;0
18635;177124;775;0;0;0;0;.00nan;0;0
18635;164424;750;0;0;0;0;.00nan;0;0
18635;164521;750;76;18;1;17;.944;3600000;0
18635;180990;775;61;35;4;31;.886;3600000;0
18637;192065;772;71;30;3;27;.900;3528000;0
18637;57993;772;0;0;0;0;.00nan;0;0
18637;67294;774;0;0;0;0;.00nan;0;0
18637;149280;774;70;22;1;21;.955;3600000;0
18639;11614;2197;0;0;0;0;.00nan;0;0
18639;189433;4924;86;33;1;32;.970;3600000;0
18639;186219;4924;0;0;0;0;.00nan;0;0
18639;94508;2197;78;31;2;29;.935;3600000;0
429;3508;746;100;26;0;26;1.000;3600000;0
429;67818;3721;79;32;2;30;.938;3535000;0
429;91194;3721;0;0;0;0;.00nan;0;0
429;149191;746;0;0;0;0;.00nan;0;0
430;1756;1497;0;0;0;0;.00nan;0;0
430;43971;768;92;21;0;21;1.000;3600000;0
430;63529;1497;77;48;4;44;.917;3600000;0
430;154296;768;0;0;0;0;.00nan;0;0
431;8504;774;0;0;0;0;.00nan;0;0
431;189433;758;0;0;0;0;.00nan;0;0
431;149280;774;73;27;2;25;.926;3600000;0
431;155943;758;56;28;3;25;.893;3545000;0
432;169680;759;0;0;0;0;.00nan;0;0
432;170548;2545;0;0;0;0;.00nan;0;0
432;197595;759;57;22;3;19;.864;3600000;0
432;148829;2545;54;31;4;27;.871;3547000;0
433;279;766;44;19;4;15;.789;3557000;0
433;177124;775;0;0;0;0;.00nan;0;0
433;180990;775;88;37;2;35;.946;3600000;0
433;82711;766;0;0;0;0;.00nan;0;0
434;167061;772;0;0;0;0;.00nan;0;0
434;164424;750;93;40;2;38;.950;5875000;0
434;164521;750;0;0;0;0;.00nan;0;0
434;63932;772;100;56;1;55;.982;5875000;0
435;170543;2199;63;26;2;24;.923;3600000;0
435;87758;2199;0;0;0;0;.00nan;0;0
435;142648;769;0;0;0;0;.00nan;0;0
435;149221;769;67;35;3;32;.914;3600000;0
436;189264;4923;100;31;0;31;1.000;3600000;0
436;169615;911;84;39;2;37;.949;3561000;0
436;176686;4923;0;0;0;0;.00nan;0;0
436;93756;911;0;0;0;0;.00nan;0;0
437;3508;746;75;27;2;25;.926;3600000;0
437;67818;3721;60;34;4;30;.882;3572000;0
437;91194;3721;0;0;0;0;.00nan;0;0
437;149191;746;0;0;0;0;.00nan;0;0
438;1756;1497;0;0;0;0;.00nan;0;0
438;43971;768;83;14;0;14;1.000;3600000;0
438;63529;1497;98;54;4;50;.926;3600000;0
438;154296;768;0;0;0;0;.00nan;0;0
439;8504;774;0;0;0;0;.00nan;0;0
439;189433;758;0;0;0;0;.00nan;0;0
439;149280;774;67;22;2;20;.909;3600000;0
439;155943;758;85;38;3;35;.921;3591000;0
440;169680;759;0;0;0;0;.00nan;0;0
440;170548;2545;83;47;3;44;.936;3561000;0
440;197595;759;69;23;2;21;.913;3600000;0
440;148829;2545;0;0;0;0;.00nan;0;0
441;279;766;45;27;5;22;.815;3552000;0
441;177124;775;0;0;0;0;.00nan;0;0
441;180990;775;65;28;3;25;.893;3600000;0
441;82711;766;0;0;0;0;.00nan;0;0
442;167061;772;0;0;0;0;.00nan;0;0
442;164424;750;53;24;3;21;.875;3554000;0
442;164521;750;0;0;0;0;.00nan;0;0
442;63932;772;91;36;2;34;.944;3600000;0
443;170543;2199;52;32;4;28;.875;3561000;0
443;87758;2199;0;0;0;0;.00nan;0;0
443;142648;769;0;0;0;0;.00nan;0;0
443;149221;769;55;27;3;24;.889;3600000;0
444;189264;4923;0;0;0;0;.00nan;0;0
444;169615;911;76;27;1;26;.963;3600000;0
444;176686;4923;29;27;6;21;.778;3600000;0
444;93756;911;0;0;0;0;.00nan;0;0
445;3508;746;47;19;3;16;.842;3542000;0
445;67818;3721;82;33;2;31;.939;3600000;0
445;91194;3721;0;0;0;0;.00nan;0;0
445;149191;746;0;0;0;0;.00nan;0;0
446;1756;1497;0;0;0;0;.00nan;0;0
446;43971;768;56;10;1;9;.900;3600000;0
446;63529;1497;91;45;2;43;.956;3563000;0
446;154296;768;0;0;0;0;.00nan;0;0
447;8504;774;0;0;0;0;.00nan;0;0
447;189433;758;0;0;0;0;.00nan;0;0
447;149280;774;94;86;3;83;.965;12300000;0
447;155943;758;99;92;2;90;.978;12300000;0
448;169680;759;0;0;0;0;.00nan;0;0
448;170548;2545;51;25;3;22;.880;3573000;0
448;197595;759;86;31;1;30;.968;3600000;0
448;148829;2545;0;0;0;0;.00nan;0;0
449;279;766;41;19;4;15;.789;3562000;0
449;177124;775;0;0;0;0;.00nan;0;0
449;180990;775;74;36;2;34;.944;3600000;0
449;82711;766;0;0;0;0;.00nan;0;0
450;167061;772;0;0;0;0;.00nan;0;0
450;164424;750;60;24;3;21;.875;3580000;0
450;164521;750;0;0;0;0;.00nan;0;0
450;63932;772;66;23;2;21;.913;3600000;0
451;170543;2199;36;28;5;23;.821;3545000;0
451;87758;2199;0;0;0;0;.00nan;0;0
451;142648;769;0;0;0;0;.00nan;0;0
451;149221;769;56;30;4;26;.867;3600000;0
452;189264;4923;0;0;0;0;.00nan;0;0
452;169615;911;99;34;2;32;.941;3600000;0
452;176686;4923;82;38;3;35;.921;3544000;0
452;93756;911;0;0;0;0;.00nan;0;0
453;3508;746;53;21;3;18;.857;4395000;0
453;67818;3721;63;37;4;33;.892;4395000;0
453;91194;3721;0;0;0;0;.00nan;0;0
453;149191;746;0;0;0;0;.00nan;0;0
454;1756;1497;96;39;2;37;.949;3025000;0
454;43971;768;80;18;1;17;.944;3600000;0
454;63529;1497;36;11;3;8;.727;575000;0
454;154296;768;0;0;0;0;.00nan;0;0
455;8504;774;0;0;0;0;.00nan;0;0
455;189433;758;0;0;0;0;.00nan;0;0
455;149280;774;44;33;5;28;.848;3556000;0
455;155943;758;64;32;3;29;.906;3600000;0
456;169680;759;0;0;0;0;.00nan;0;0
456;170548;2545;82;40;3;37;.925;3549000;0
456;197595;759;90;31;1;30;.968;3600000;0
456;148829;2545;0;0;0;0;.00nan;0;0
457;279;766;70;31;3;28;.903;3753000;0
457;177124;775;0;0;0;0;.00nan;0;0
457;180990;775;89;33;2;31;.939;3753000;0
457;82711;766;0;0;0;0;.00nan;0;0
458;167061;772;0;0;0;0;.00nan;0;0
458;164424;750;83;43;3;40;.930;3584000;0
458;164521;750;0;0;0;0;.00nan;0;0
458;63932;772;61;20;1;19;.950;3600000;0
459;170543;2199;52;33;4;29;.879;3600000;0
459;87758;2199;0;0;0;0;.00nan;0;0
459;142648;769;0;0;0;0;.00nan;0;0
459;149221;769;80;27;1;26;.963;3600000;0
460;189264;4923;0;0;0;0;.00nan;0;0
460;169615;911;80;31;2;29;.935;3600000;0
460;176686;4923;87;35;1;34;.971;3600000;0
460;93756;911;0;0;0;0;.00nan;0;0
555;3508;746;71;27;2;25;.926;3600000;0
555;67818;3721;60;29;3;26;.897;3581000;0
555;91194;3721;0;0;0;0;.00nan;0;0
555;149191;746;0;0;0;0;.00nan;0;0
556;8504;774;0;0;0;0;.00nan;0;0
556;189433;758;0;0;0;0;.00nan;0;0
556;149280;774;71;29;3;26;.897;3633000;0
556;155943;758;58;29;4;25;.862;3633000;0
557;170543;2199;63;36;4;32;.889;3600000;0
557;87758;2199;0;0;0;0;.00nan;0;0
557;142648;769;0;0;0;0;.00nan;0;0
557;149221;769;100;35;0;35;1.000;3600000;0
558;189264;4923;0;0;0;0;.00nan;0;0
558;169615;911;79;41;4;37;.902;3560000;0
558;176686;4923;65;31;3;28;.903;3600000;0
558;93756;911;0;0;0;0;.00nan;0;0
632;8504;774;0;0;0;0;.00nan;0;0
632;189433;758;0;0;0;0;.00nan;0;0
632;149280;774;73;21;1;20;.952;3600000;0
632;155943;758;70;39;4;35;.897;3600000;0
633;189264;4923;0;0;0;0;.00nan;0;0
633;169615;911;72;26;1;25;.962;3562000;0
633;176686;4923;100;38;0;38;1.000;3600000;0
633;93756;911;0;0;0;0;.00nan;0;0
670;177124;775;0;0;0;0;.00nan;0;0
670;3508;746;83;11;0;11;1.000;3600000;0
670;180990;775;97;41;1;40;.976;3600000;0
670;149191;746;0;0;0;0;.00nan;0;0
671;8504;774;0;0;0;0;.00nan;0;0
671;189264;4923;0;0;0;0;.00nan;0;0
671;176686;4923;82;43;4;39;.907;3547000;0
671;149280;774;52;16;2;14;.875;3600000;0
672;169680;759;0;0;0;0;.00nan;0;0
672;197595;759;86;30;2;28;.933;3600000;0
672;142648;769;0;0;0;0;.00nan;0;0
672;149221;769;48;21;3;18;.857;3546000;0
673;167061;772;0;0;0;0;.00nan;0;0
673;43971;768;81;21;1;20;.952;3600000;0
673;63932;772;84;43;3;40;.930;3589000;0
673;154296;768;0;0;0;0;.00nan;0;0
674;177124;775;0;0;0;0;.00nan;0;0
674;3508;746;64;19;1;18;.947;3600000;0
674;180990;775;30;35;7;28;.800;3600000;0
674;149191;746;0;0;0;0;.00nan;0;0
675;8504;774;0;0;0;0;.00nan;0;0
675;189264;4923;53;4;0;4;1.000;299000;0
675;176686;4923;51;37;6;31;.838;3301000;0
675;149280;774;100;22;0;22;1.000;3600000;0
676;169680;759;0;0;0;0;.00nan;0;0
676;197595;759;81;37;3;34;.919;4253000;0
676;142648;769;0;0;0;0;.00nan;0;0
676;149221;769;64;33;4;29;.879;4253000;0
677;167061;772;0;0;0;0;.00nan;0;0
677;43971;768;70;16;1;15;.938;3600000;0
677;63932;772;73;47;5;42;.894;3600000;0
677;154296;768;0;0;0;0;.00nan;0;0
678;177124;775;0;0;0;0;.00nan;0;0
678;3508;746;70;29;2;27;.931;3908000;0
678;180990;775;67;35;3;32;.914;3908000;0
678;149191;746;0;0;0;0;.00nan;0;0
679;8504;774;0;0;0;0;.00nan;0;0
679;189264;4923;0;0;0;0;.00nan;0;0
679;176686;4923;73;27;2;25;.926;3600000;0
679;149280;774;75;33;3;30;.909;3551000;0
680;169680;759;0;0;0;0;.00nan;0;0
680;197595;759;68;33;3;30;.909;3558000;0
680;142648;769;0;0;0;0;.00nan;0;0
680;149221;769;92;36;2;34;.944;3600000;0
681;167061;772;0;0;0;0;.00nan;0;0
681;43971;768;73;22;1;21;.955;3600000;0
681;63932;772;61;31;4;27;.871;3600000;0
681;154296;768;0;0;0;0;.00nan;0;0
682;177124;775;0;0;0;0;.00nan;0;0
682;3508;746;55;22;3;19;.864;3595000;0
682;180990;775;100;46;1;45;.978;3600000;0
682;149191;746;0;0;0;0;.00nan;0;0
683;8504;774;0;0;0;0;.00nan;0;0
683;189264;4923;0;0;0;0;.00nan;0;0
683;176686;4923;100;29;0;29;1.000;3600000;0
683;149280;774;92;27;1;26;.963;3573000;0
684;169680;759;0;0;0;0;.00nan;0;0
684;197595;759;52;29;4;25;.862;3556000;0
684;142648;769;0;0;0;0;.00nan;0;0
684;149221;769;78;32;2;30;.938;3600000;0
685;167061;772;0;0;0;0;.00nan;0;0
685;43971;768;81;18;1;17;.944;3600000;0
685;63932;772;76;42;4;38;.905;3600000;0
685;154296;768;0;0;0;0;.00nan;0;0
1069;177124;775;0;0;0;0;.00nan;0;0
1069;3508;746;67;20;2;18;.900;3600000;0
1069;180990;775;90;41;3;38;.927;3600000;0
1069;149191;746;0;0;0;0;.00nan;0;0
1070;8504;774;0;0;0;0;.00nan;0;0
1070;189264;4923;0;0;0;0;.00nan;0;0
1070;176686;4923;60;26;3;23;.885;3584000;0
1070;149280;774;89;30;2;28;.933;3600000;0
1071;169680;759;0;0;0;0;.00nan;0;0
1071;197595;759;100;40;1;39;.975;3600000;0
1071;142648;769;0;0;0;0;.00nan;0;0
1071;149221;769;45;27;5;22;.815;3600000;0
1125;8504;774;0;0;0;0;.00nan;0;0
1125;189264;4923;0;0;0;0;.00nan;0;0
1125;176686;4923;88;29;1;28;.966;3600000;0
1125;149280;774;56;33;5;28;.848;3600000;0
1126;169680;759;0;0;0;0;.00nan;0;0
1126;197595;759;91;27;1;26;.963;3600000;0
1126;142648;769;0;0;0;0;.00nan;0;0
1126;149221;769;69;36;4;32;.889;3600000;0
1172;8504;774;0;0;0;0;.00nan;0;0
1172;189264;4923;0;0;0;0;.00nan;0;0
1172;176686;4923;78;34;3;31;.912;3572000;0
1172;149280;774;67;23;2;21;.913;3600000;0
1232;3508;746;98;39;1;38;.974;3600000;0
1232;169680;759;0;0;0;0;.00nan;0;0
1232;197595;759;100;31;0;31;1.000;3600000;0
1232;149191;746;0;0;0;0;.00nan;0;0
1233;8504;774;0;0;0;0;.00nan;0;0
1233;43971;768;91;19;0;19;1.000;3600000;0
1233;149280;774;76;41;4;37;.902;3600000;0
1233;154296;768;0;0;0;0;.00nan;0;0
1234;3508;746;26;10;4;6;.600;3570000;0
1234;169680;759;0;0;0;0;.00nan;0;0
1234;197595;759;85;36;2;34;.944;3600000;0
1234;149191;746;0;0;0;0;.00nan;0;0
1235;8504;774;0;0;0;0;.00nan;0;0
1235;43971;768;84;40;3;37;.925;3514000;0
1235;149280;774;84;23;1;22;.957;3600000;0
1235;154296;768;0;0;0;0;.00nan;0;0
1236;3508;746;83;43;4;39;.907;3844000;0
1236;169680;759;0;0;0;0;.00nan;0;0
1236;197595;759;66;31;3;28;.903;3844000;0
1236;149191;746;0;0;0;0;.00nan;0;0
1237;8504;774;0;0;0;0;.00nan;0;0
1237;43971;768;98;21;0;21;1.000;3600000;0
1237;149280;774;67;44;4;40;.909;3600000;0
1237;154296;768;0;0;0;0;.00nan;0;0
1238;3508;746;72;22;2;20;.909;3600000;0
1238;169680;759;0;0;0;0;.00nan;0;0
1238;197595;759;62;43;5;38;.884;3600000;0
1238;149191;746;0;0;0;0;.00nan;0;0
1239;8504;774;0;0;0;0;.00nan;0;0
1239;43971;768;100;30;0;30;1.000;3600000;0
1239;149280;774;72;34;3;31;.912;3600000;0
1239;154296;768;0;0;0;0;.00nan;0;0
1513;3508;746;70;31;2;29;.935;3600000;0
1513;169680;759;0;0;0;0;.00nan;0;0
1513;197595;759;80;25;1;24;.960;3600000;0
1513;149191;746;0;0;0;0;.00nan;0;0
1514;8504;774;0;0;0;0;.00nan;0;0
1514;43971;768;79;39;3;36;.923;3697000;0
1514;149280;774;58;33;4;29;.879;3650000;0
1514;154296;768;0;0;0;0;.00nan;0;0
1549;169680;759;0;0;0;0;.00nan;0;0
1549;43971;768;100;18;0;18;1.000;3600000;0
1549;197595;759;84;32;2;30;.938;3540000;0
1549;154296;768;0;0;0;0;.00nan;0;0
1550;169680;759;62;18;0;18;1.000;1693000;0
1550;43971;768;32;30;6;24;.800;4847000;0
1550;197595;759;54;32;5;27;.844;3154000;0
1550;154296;768;0;0;0;0;.00nan;0;0
1551;169680;759;0;0;0;0;.00nan;0;0
1551;43971;768;79;12;0;12;1.000;3600000;0
1551;197595;759;98;50;2;48;.960;3537000;0
1551;154296;768;0;0;0;0;.00nan;0;0
1552;169680;759;0;0;0;0;.00nan;0;0
1552;43971;768;89;28;1;27;.964;3600000;0
1552;197595;759;98;48;3;45;.938;3561000;0
1552;154296;768;0;0;0;0;.00nan;0;0
1768;169680;759;52;10;1;9;.900;1109000;0
1768;43971;768;100;27;0;27;1.000;3600000;0
1768;197595;759;42;34;6;28;.824;2491000;0
1768;154296;768;0;0;0;0;.00nan;0;0
18640;11438;2557;0;0;0;0;.00nan;0;0
18640;32255;2557;61;28;3;25;.893;3600000;0
18640;40088;1928;86;28;1;27;.964;3600000;0
18640;155769;1928;0;0;0;0;.00nan;0;0
18641;13041;580;25;36;7;29;.806;3600000;0
18641;13065;580;0;0;0;0;.00nan;0;0
18641;174736;1918;0;0;0;0;.00nan;0;0
18641;190423;1918;87;27;1;26;.963;3600000;0
18642;4504;586;0;0;0;0;.00nan;0;0
18642;13033;586;62;21;2;19;.905;3600000;0
18642;185220;583;40;38;6;32;.842;3600000;0
18642;-1;583;0;0;0;0;.00nan;0;0
18643;170037;567;0;0;0;0;.00nan;0;0
18643;40088;1928;0;0;0;0;.00nan;0;0
18643;143879;567;86;24;1;23;.958;3600000;0
18643;155769;1928;39;36;6;30;.833;3600000;0
18644;34168;563;0;0;0;0;.00nan;0;0
18644;61999;1922;75;39;4;35;.897;3900000;0
18644;67625;1922;0;0;0;0;.00nan;0;0
18644;73939;563;60;36;4;32;.889;3900000;0
18645;6202;1927;79;34;2;32;.941;3586000;0
18645;7063;2287;92;15;0;15;1.000;3600000;0
18645;14459;2287;0;0;0;0;.00nan;0;0
18645;153618;1927;0;0;0;0;.00nan;0;0
18646;7412;585;0;0;0;0;.00nan;0;0
18646;19473;2277;0;0;0;0;.00nan;0;0
18646;19954;2277;76;18;1;17;.944;3783000;0
18646;35052;585;86;35;2;33;.943;3783000;0
18647;4504;586;0;0;0;0;.00nan;0;0
18647;6202;1927;0;0;0;0;.00nan;0;0
18647;13033;586;81;32;2;30;.938;3600000;0
18647;153618;1927;65;39;4;35;.897;3565000;0
18648;7063;2287;72;20;1;19;.950;3600000;0
18648;7412;585;0;0;0;0;.00nan;0;0
18648;14459;2287;0;0;0;0;.00nan;0;0
18648;35052;585;74;44;5;39;.886;3600000;0
18649;11438;2557;75;29;2;27;.931;3588000;0
18649;19473;2277;82;23;1;22;.957;3600000;0
18649;19954;2277;0;0;0;0;.00nan;0;0
18649;32255;2557;0;0;0;0;.00nan;0;0
18650;174736;1918;41;22;4;18;.818;1127000;0
18650;190423;1918;70;30;2;28;.933;2473000;0
18650;61999;1922;0;0;0;0;.00nan;0;0
18650;67625;1922;92;18;0;18;1.000;3600000;0
18651;13041;580;59;38;4;34;.895;3600000;0
18651;13065;580;0;0;0;0;.00nan;0;0
18651;185220;583;40;27;5;22;.815;3600000;0
18651;-1;583;0;0;0;0;.00nan;0;0
18652;4504;586;0;0;0;0;.00nan;0;0
18652;13033;586;49;15;3;12;.800;3600000;0
18652;174736;1918;57;47;6;41;.872;3600000;0
18652;190423;1918;0;0;0;0;.00nan;0;0
18653;34168;563;0;0;0;0;.00nan;0;0
18653;40088;1928;0;0;0;0;.00nan;0;0
18653;73939;563;73;34;3;31;.912;3600000;0
18653;155769;1928;47;33;5;28;.848;3552000;0
18654;7412;585;0;0;0;0;.00nan;0;0
18654;11438;2557;93;22;0;22;1.000;3600000;0
18654;32255;2557;0;0;0;0;.00nan;0;0
18654;35052;585;72;37;4;33;.892;3600000;0
18655;170037;567;61;35;4;31;.886;3552000;0
18655;61999;1922;0;0;0;0;.00nan;0;0
18655;67625;1922;60;23;2;21;.913;3600000;0
18655;143879;567;0;0;0;0;.00nan;0;0
18656;7063;2287;53;23;3;20;.870;3546000;0
18656;13041;580;61;22;2;20;.909;3600000;0
18656;13065;580;0;0;0;0;.00nan;0;0
18656;14459;2287;0;0;0;0;.00nan;0;0
18657;7412;585;0;0;0;0;.00nan;0;0
18657;174736;1918;78;26;1;25;.962;3600000;0
18657;190423;1918;0;0;0;0;.00nan;0;0
18657;35052;585;55;26;4;22;.846;3600000;0
18658;170037;567;62;26;3;23;.885;3600000;0
18658;185220;583;0;0;0;0;.00nan;0;0
18658;-1;583;72;38;4;34;.895;3557000;0
18658;143879;567;0;0;0;0;.00nan;0;0
18659;4504;586;0;0;0;0;.00nan;0;0
18659;13033;586;58;26;4;22;.846;3600000;0
18659;34168;563;54;4;0;4;1.000;750000;0
18659;73939;563;32;39;7;32;.821;2850000;0
18660;6202;1927;0;0;0;0;.00nan;0;0
18660;40088;1928;0;0;0;0;.00nan;0;0
18660;153618;1927;38;32;6;26;.813;3600000;0
18660;155769;1928;59;21;2;19;.905;3600000;0
18661;11438;2557;83;18;0;18;1.000;3600000;0
18661;13041;580;0;0;0;0;.00nan;0;0
18661;13065;580;58;22;2;20;.909;3564000;0
18661;32255;2557;0;0;0;0;.00nan;0;0
18662;170037;567;65;22;2;20;.909;3600000;0
18662;174736;1918;0;0;0;0;.00nan;0;0
18662;190423;1918;89;48;3;45;.938;3600000;0
18662;143879;567;0;0;0;0;.00nan;0;0
18663;7412;585;73;47;4;43;.915;3900000;0
18663;185220;583;60;31;4;27;.871;3900000;0
18663;35052;585;0;0;0;0;.00nan;0;0
18663;-1;583;0;0;0;0;.00nan;0;0
18664;13041;580;30;9;3;6;.667;451000;0
18664;13065;580;63;33;4;29;.879;3149000;0
18664;40088;1928;51;9;1;8;.889;3600000;0
18664;155769;1928;0;0;0;0;.00nan;0;0
18665;7063;2287;62;34;4;30;.882;3600000;0
18665;14459;2287;0;0;0;0;.00nan;0;0
18665;34168;563;0;0;0;0;.00nan;0;0
18665;73939;563;33;33;6;27;.818;3575000;0
18666;4504;586;0;0;0;0;.00nan;0;0
18666;13033;586;63;37;4;33;.892;3600000;0
18666;61999;1922;0;0;0;0;.00nan;0;0
18666;67625;1922;37;32;6;26;.813;3592000;0
18667;6202;1927;0;0;0;0;.00nan;0;0
18667;19473;2277;47;30;5;25;.833;3730000;0
18667;19954;2277;0;0;0;0;.00nan;0;0
18667;153618;1927;39;32;6;26;.813;3730000;0
18668;174736;1918;47;26;4;22;.846;3550000;0
18668;190423;1918;0;0;0;0;.00nan;0;0
18668;185220;583;85;37;2;35;.946;3600000;0
18668;-1;583;0;0;0;0;.00nan;0;0
18669;4504;586;0;0;0;0;.00nan;0;0
18669;13033;586;65;33;3;30;.909;3600000;0
18669;170037;567;61;36;5;31;.861;3569000;0
18669;143879;567;0;0;0;0;.00nan;0;0
18670;4504;586;0;0;0;0;.00nan;0;0
18670;13033;586;100;42;1;41;.976;3600000;0
18670;185220;583;77;37;3;34;.919;3539000;0
18670;-1;583;0;0;0;0;.00nan;0;0
18671;11438;2557;100;23;0;23;1.000;3600000;0
18671;174736;1918;0;0;0;0;.00nan;0;0
18671;32255;2557;0;0;0;0;.00nan;0;0
18671;190423;1918;66;26;2;24;.923;3538000;0
18672;7063;2287;58;33;4;29;.879;3600000;0
18672;14459;2287;0;0;0;0;.00nan;0;0
18672;40088;1928;0;0;0;0;.00nan;0;0
18672;155769;1928;31;20;5;15;.750;3569000;0
18673;170037;567;77;37;4;33;.892;3600000;0
18673;34168;563;0;0;0;0;.00nan;0;0
18673;73939;563;77;36;2;34;.944;3600000;0
18673;143879;567;0;0;0;0;.00nan;0;0
18674;6202;1927;0;0;0;0;.00nan;0;0
18674;19473;2277;58;28;3;25;.893;3600000;0
18674;19954;2277;0;0;0;0;.00nan;0;0
18674;153618;1927;83;40;4;36;.900;3577000;0
18675;13041;580;0;0;0;0;.00nan;0;0
18675;13065;580;62;35;4;31;.886;3897000;0
18675;61999;1922;52;35;5;30;.857;3897000;0
18675;67625;1922;0;0;0;0;.00nan;0;0
18676;7063;2287;0;0;0;0;.00nan;0;0
18676;7412;585;0;0;0;0;.00nan;0;0
18676;14459;2287;86;29;2;27;.931;3900000;0
18676;35052;585;96;42;2;40;.952;3900000;0
18677;4504;586;81;38;2;36;.947;3600000;0
18677;13033;586;0;0;0;0;.00nan;0;0
18677;61999;1922;0;0;0;0;.00nan;0;0
18677;67625;1922;71;35;3;32;.914;3600000;0
18678;11438;2557;43;28;5;23;.821;3566000;0
18678;32255;2557;0;0;0;0;.00nan;0;0
18678;185220;583;0;0;0;0;.00nan;0;0
18678;-1;583;57;23;3;20;.870;3600000;0
18679;6202;1927;59;41;5;36;.878;3742000;0
18679;34168;563;48;24;4;20;.833;3742000;0
18679;73939;563;0;0;0;0;.00nan;0;0
18679;153618;1927;0;0;0;0;.00nan;0;0
18680;19473;2277;0;0;0;0;.00nan;0;0
18680;19954;2277;60;35;4;31;.886;3600000;0
18680;40088;1928;94;17;0;17;1.000;3600000;0
18680;155769;1928;0;0;0;0;.00nan;0;0
18681;11438;2557;61;32;3;29;.906;3600000;0
18681;32255;2557;0;0;0;0;.00nan;0;0
18681;34168;563;0;0;0;0;.00nan;0;0
18681;73939;563;90;28;1;27;.964;3600000;0
18682;185220;583;61;30;3;27;.900;3581000;0
18682;-1;583;0;0;0;0;.00nan;0;0
18682;61999;1922;63;16;1;15;.938;3600000;0
18682;67625;1922;0;0;0;0;.00nan;0;0
18683;7412;585;0;0;0;0;.00nan;0;0
18683;170037;567;0;0;0;0;.00nan;0;0
18683;35052;585;96;53;3;50;.943;3558000;0
18683;143879;567;59;11;1;10;.909;3600000;0
18684;4504;586;0;0;0;0;.00nan;0;0
18684;13033;586;96;21;0;21;1.000;3600000;0
18684;13041;580;0;0;0;0;.00nan;0;0
18684;13065;580;68;34;3;31;.912;3600000;0
18685;174736;1918;60;37;5;32;.865;3569000;0
18685;190423;1918;0;0;0;0;.00nan;0;0
18685;34168;563;0;0;0;0;.00nan;0;0
18685;73939;563;66;33;3;30;.909;3600000;0
18686;4504;586;0;0;0;0;.00nan;0;0
18686;7412;585;49;22;3;19;.864;2413000;0
18686;13033;586;58;15;2;13;.867;3600000;0
18686;35052;585;44;25;4;21;.840;1187000;0
18687;185220;583;65;38;5;33;.868;3600000;0
18687;-1;583;0;0;0;0;.00nan;0;0
18687;40088;1928;0;0;0;0;.00nan;0;0
18687;155769;1928;57;23;2;21;.913;3600000;0
18688;7063;2287;58;19;2;17;.895;3600000;0
18688;11438;2557;83;25;1;24;.960;3600000;0
18688;14459;2287;0;0;0;0;.00nan;0;0
18688;32255;2557;0;0;0;0;.00nan;0;0
18689;6202;1927;79;34;1;33;.971;3900000;0
18689;61999;1922;0;0;0;0;.00nan;0;0
18689;67625;1922;88;30;1;29;.967;3900000;0
18689;153618;1927;0;0;0;0;.00nan;0;0
18690;13041;580;51;45;6;39;.867;3600000;0
18690;13065;580;0;0;0;0;.00nan;0;0
18690;170037;567;0;0;0;0;.00nan;0;0
18690;143879;567;72;19;1;18;.947;3600000;0
18691;7412;585;0;0;0;0;.00nan;0;0
18691;19473;2277;76;31;2;29;.935;3566000;0
18691;19954;2277;0;0;0;0;.00nan;0;0
18691;35052;585;79;30;1;29;.967;3600000;0
18692;174736;1918;88;35;2;33;.943;3573000;0
18692;190423;1918;0;0;0;0;.00nan;0;0
18692;40088;1928;87;25;1;24;.960;3600000;0
18692;155769;1928;0;0;0;0;.00nan;0;0
18693;34168;563;0;0;0;0;.00nan;0;0
18693;61999;1922;94;36;2;34;.944;3900000;0
18693;67625;1922;0;0;0;0;.00nan;0;0
18693;73939;563;62;27;2;25;.926;3900000;0
18694;7063;2287;30;21;5;16;.762;2112000;0
18694;14459;2287;66;12;0;12;1.000;1488000;0
18694;170037;567;54;25;3;22;.880;3600000;0
18694;143879;567;0;0;0;0;.00nan;0;0
18695;34168;563;0;0;0;0;.00nan;0;0
18695;185220;583;90;32;1;31;.969;3600000;0
18695;-1;583;0;0;0;0;.00nan;0;0
18695;73939;563;82;30;2;28;.933;3583000;0
18696;7412;585;0;0;0;0;.00nan;0;0
18696;11438;2557;79;24;1;23;.958;3600000;0
18696;35052;585;48;28;4;24;.857;3600000;0
18696;86268;2557;0;0;0;0;.00nan;0;0
18697;4504;586;0;0;0;0;.00nan;0;0
18697;13033;586;76;24;1;23;.958;3600000;0
18697;34168;563;0;0;0;0;.00nan;0;0
18697;73939;563;70;43;6;37;.860;3600000;0
18698;7063;2287;0;0;0;0;.00nan;0;0
18698;14459;2287;41;31;5;26;.839;3600000;0
18698;174736;1918;72;31;2;29;.935;3600000;0
18698;190423;1918;0;0;0;0;.00nan;0;0
18699;19473;2277;0;0;0;0;.00nan;0;0
18699;61999;1922;0;0;0;0;.00nan;0;0
18699;67614;2277;65;37;4;33;.892;3585000;0
18699;67625;1922;73;27;3;24;.889;3600000;0
18700;13041;580;0;0;0;0;.00nan;0;0
18700;13065;580;46;29;4;25;.862;3900000;0
18700;40088;1928;0;0;0;0;.00nan;0;0
18700;155769;1928;61;29;4;25;.862;3900000;0
18701;7412;585;40;30;6;24;.800;2781000;0
18701;170037;567;55;26;3;23;.885;3600000;0
18701;35052;585;48;7;1;6;.857;819000;0
18701;143879;567;0;0;0;0;.00nan;0;0
18702;19473;2277;0;0;0;0;.00nan;0;0
18702;185220;583;83;24;1;23;.958;3600000;0
18702;-1;583;0;0;0;0;.00nan;0;0
18702;67614;2277;55;34;4;30;.882;3600000;0
18703;6202;1927;0;0;0;0;.00nan;0;0
18703;34168;563;0;0;0;0;.00nan;0;0
18703;73939;563;35;22;5;17;.773;3555000;0
18703;153618;1927;74;40;4;36;.900;3600000;0
18704;11438;2557;0;0;0;0;.00nan;0;0
18704;174736;1918;0;0;0;0;.00nan;0;0
18704;190423;1918;86;32;2;30;.938;3600000;0
18704;86268;2557;60;33;4;29;.879;3513000;0
18705;13041;580;73;26;2;24;.923;3600000;0
18705;13065;580;0;0;0;0;.00nan;0;0
18705;40088;1928;48;32;5;27;.844;3600000;0
18705;155769;1928;0;0;0;0;.00nan;0;0
18706;7063;2287;86;28;1;27;.964;3600000;0
18706;14459;2287;0;0;0;0;.00nan;0;0
18706;34168;563;0;0;0;0;.00nan;0;0
18706;73939;563;65;24;2;22;.917;3589000;0
18707;11438;2557;0;0;0;0;.00nan;0;0
18707;170037;567;0;0;0;0;.00nan;0;0
18707;86268;2557;47;44;7;37;.841;3600000;0
18707;143879;567;60;14;1;13;.929;3600000;0
18708;7063;2287;0;0;0;0;.00nan;0;0
18708;14459;2287;91;41;3;38;.927;3900000;0
18708;61999;1922;57;35;3;32;.914;3900000;0
18708;67625;1922;0;0;0;0;.00nan;0;0
18709;4504;586;0;0;0;0;.00nan;0;0
18709;13033;586;46;38;6;32;.842;3722000;0
18709;174736;1918;54;32;5;27;.844;3722000;0
18709;190423;1918;0;0;0;0;.00nan;0;0
18710;7412;585;0;0;0;0;.00nan;0;0
18710;34168;563;0;0;0;0;.00nan;0;0
18710;35052;585;72;39;3;36;.923;3570000;0
18710;73939;563;65;19;2;17;.895;3600000;0
18711;4504;586;83;23;2;21;.913;3600000;0
18711;11438;2557;41;3;1;2;.667;985000;0
18711;13033;586;0;0;0;0;.00nan;0;0
18711;86268;2557;17;32;7;25;.781;2615000;0
18712;6202;1927;52;8;1;7;.875;678000;0
18712;185220;583;62;33;4;29;.879;3600000;0
18712;-1;583;0;0;0;0;.00nan;0;0
18712;153618;1927;29;31;6;25;.806;2922000;0
18713;7063;2287;0;0;0;0;.00nan;0;0
18713;14459;2287;61;18;2;16;.889;3880000;0
18713;19473;2277;0;0;0;0;.00nan;0;0
18713;67614;2277;69;27;2;25;.926;3900000;0
18714;13041;580;0;0;0;0;.00nan;0;0
18714;13065;580;66;41;4;37;.902;3600000;0
18714;170037;567;75;23;1;22;.957;3600000;0
18714;143879;567;0;0;0;0;.00nan;0;0
18715;170037;567;0;0;0;0;.00nan;0;0
18715;174736;1918;69;39;4;35;.897;3580000;0
18715;190423;1918;0;0;0;0;.00nan;0;0
18715;143879;567;55;26;3;23;.885;3600000;0
18716;7412;585;84;48;3;45;.938;3524000;0
18716;35052;585;0;0;0;0;.00nan;0;0
18716;40088;1928;80;26;1;25;.962;3600000;0
18716;155769;1928;0;0;0;0;.00nan;0;0
18717;6202;1927;100;31;0;31;1.000;3600000;0
18717;11438;2557;0;0;0;0;.00nan;0;0
18717;86268;2557;70;27;2;25;.926;3517000;0
18717;153618;1927;0;0;0;0;.00nan;0;0
18718;185220;583;48;35;6;29;.829;3600000;0
18718;-1;583;0;0;0;0;.00nan;0;0
18718;61999;1922;0;0;0;0;.00nan;0;0
18718;67625;1922;63;24;3;21;.875;3600000;0
18719;19473;2277;0;0;0;0;.00nan;0;0
18719;34168;563;0;0;0;0;.00nan;0;0
18719;67614;2277;78;24;1;23;.958;3600000;0
18719;73939;563;65;27;2;25;.926;3573000;0
18720;185220;583;99;42;1;41;.976;3600000;0
18720;-1;583;0;0;0;0;.00nan;0;0
18720;61999;1922;55;33;6;27;.818;3600000;0
18720;67625;1922;0;0;0;0;.00nan;0;0
18721;19473;2277;0;0;0;0;.00nan;0;0
18721;40088;1928;71;26;2;24;.923;3600000;0
18721;67614;2277;72;31;3;28;.903;3600000;0
18721;155769;1928;0;0;0;0;.00nan;0;0
18722;4504;586;0;0;0;0;.00nan;0;0
18722;11438;2557;0;0;0;0;.00nan;0;0
18722;13033;586;74;22;1;21;.955;3600000;0
18722;86268;2557;59;39;5;34;.872;3600000;0
18723;4504;586;0;0;0;0;.00nan;0;0
18723;7063;2287;0;0;0;0;.00nan;0;0
18723;13033;586;66;36;3;33;.917;3900000;0
18723;14459;2287;92;45;3;42;.933;3900000;0
18724;13041;580;70;29;2;27;.931;3600000;0
18724;13065;580;0;0;0;0;.00nan;0;0
18724;19473;2277;0;0;0;0;.00nan;0;0
18724;67614;2277;45;32;5;27;.844;3600000;0
18725;7412;585;0;0;0;0;.00nan;0;0
18725;13041;580;0;0;0;0;.00nan;0;0
18725;13065;580;44;20;4;16;.800;3540000;0
18725;35052;585;81;34;2;32;.941;3600000;0
18726;7063;2287;25;27;6;21;.778;3134000;0
18726;14459;2287;53;3;0;3;1.000;466000;0
18726;185220;583;68;24;2;22;.917;3600000;0
18726;-1;583;0;0;0;0;.00nan;0;0
18727;11438;2557;0;0;0;0;.00nan;0;0
18727;34168;563;63;21;3;18;.857;3886000;0
18727;73939;563;0;0;0;0;.00nan;0;0
18727;86268;2557;75;39;3;36;.923;3900000;0
18728;6202;1927;70;27;3;24;.889;3600000;0
18728;174736;1918;77;31;2;29;.935;3600000;0
18728;190423;1918;0;0;0;0;.00nan;0;0
18728;153618;1927;0;0;0;0;.00nan;0;0
18729;170037;567;96;32;1;31;.969;3600000;0
18729;40088;1928;42;30;5;25;.833;3600000;0
18729;143879;567;0;0;0;0;.00nan;0;0
18729;155769;1928;0;0;0;0;.00nan;0;0
18730;4504;586;0;0;0;0;.00nan;0;0
18730;13033;586;98;40;2;38;.950;3600000;0
18730;40088;1928;0;0;0;0;.00nan;0;0
18730;155769;1928;50;29;5;24;.828;3600000;0
18731;6202;1927;0;0;0;0;.00nan;0;0
18731;174736;1918;0;0;0;0;.00nan;0;0
18731;190423;1918;64;37;4;33;.892;3749000;0
18731;153618;1927;82;56;5;51;.911;3749000;0
18732;11438;2557;0;0;0;0;.00nan;0;0
18732;61999;1922;0;0;0;0;.00nan;0;0
18732;67625;1922;100;26;0;26;1.000;3600000;0
18732;86268;2557;42;31;5;26;.839;3600000;0
18733;170037;567;0;0;0;0;.00nan;0;0
18733;34168;563;0;0;0;0;.00nan;0;0
18733;73939;563;100;39;0;39;1.000;3600000;0
18733;143879;567;64;34;3;31;.912;3600000;0
18734;19473;2277;63;20;2;18;.900;3600000;0
18734;185220;583;0;0;0;0;.00nan;0;0
18734;-1;583;48;21;3;18;.857;3600000;0
18734;67614;2277;0;0;0;0;.00nan;0;0
18735;19473;2277;0;0;0;0;.00nan;0;0
18735;170037;567;59;26;2;24;.923;3900000;0
18735;67614;2277;70;25;2;23;.920;3900000;0
18735;143879;567;0;0;0;0;.00nan;0;0
18736;6202;1927;0;0;0;0;.00nan;0;0
18736;7412;585;0;0;0;0;.00nan;0;0
18736;35052;585;70;27;2;25;.926;3598000;0
18736;153618;1927;79;28;1;27;.964;3600000;0
18737;13041;580;67;18;1;17;.944;3600000;0
18737;13065;580;0;0;0;0;.00nan;0;0
18737;185220;583;72;34;3;31;.912;3545000;0
18737;-1;583;0;0;0;0;.00nan;0;0
18738;174736;1918;91;41;1;40;.976;3600000;0
18738;190423;1918;0;0;0;0;.00nan;0;0
18738;61999;1922;0;0;0;0;.00nan;0;0
18738;67625;1922;61;21;3;18;.857;3580000;0
18739;11438;2557;0;0;0;0;.00nan;0;0
18739;40088;1928;80;34;3;31;.912;3600000;0
18739;86268;2557;61;33;4;29;.879;3600000;0
18739;155769;1928;0;0;0;0;.00nan;0;0
18740;6202;1927;0;0;0;0;.00nan;0;0
18740;7063;2287;0;0;0;0;.00nan;0;0
18740;14459;2287;74;19;1;18;.947;3600000;0
18740;153618;1927;37;34;5;29;.853;3600000;0
18741;7412;585;0;0;0;0;.00nan;0;0
18741;35052;585;80;43;3;40;.930;3600000;0
18741;61999;1922;64;23;2;21;.913;3600000;0
18741;67625;1922;0;0;0;0;.00nan;0;0
18742;4504;586;0;0;0;0;.00nan;0;0
18742;13033;586;66;21;2;19;.905;3600000;0
18742;19473;2277;0;0;0;0;.00nan;0;0
18742;67614;2277;35;29;5;24;.828;3600000;0
18743;170037;567;78;21;1;20;.952;3600000;0
18743;185220;583;83;37;2;35;.946;3544000;0
18743;-1;583;0;0;0;0;.00nan;0;0
18743;143879;567;0;0;0;0;.00nan;0;0
18744;7412;585;72;37;3;34;.919;3652000;0
18744;34168;563;0;0;0;0;.00nan;0;0
18744;35052;585;0;0;0;0;.00nan;0;0
18744;73939;563;57;17;2;15;.882;3652000;0
18745;4504;586;0;0;0;0;.00nan;0;0
18745;6202;1927;43;39;6;33;.846;3600000;0
18745;13033;586;79;25;1;24;.960;3600000;0
18745;153618;1927;0;0;0;0;.00nan;0;0
18746;13041;580;0;0;0;0;.00nan;0;0
18746;13065;580;79;25;2;23;.920;3725000;0
18746;174736;1918;48;20;3;17;.850;3725000;0
18746;190423;1918;0;0;0;0;.00nan;0;0
18747;174736;1918;89;52;3;49;.942;3600000;0
18747;190423;1918;0;0;0;0;.00nan;0;0
18747;61999;1922;69;24;2;22;.917;3600000;0
18747;67625;1922;0;0;0;0;.00nan;0;0
18748;19473;2277;0;0;0;0;.00nan;0;0
18748;34168;563;0;0;0;0;.00nan;0;0
18748;67614;2277;91;38;2;36;.947;3586000;0
18748;73939;563;100;32;0;32;1.000;3600000;0
18749;6202;1927;0;0;0;0;.00nan;0;0
18749;170037;567;0;0;0;0;.00nan;0;0
18749;143879;567;62;14;1;13;.929;3900000;0
18749;153618;1927;91;47;1;46;.979;3900000;0
18750;40088;1928;65;27;2;25;.926;3600000;0
18750;61999;1922;0;0;0;0;.00nan;0;0
18750;67625;1922;82;28;1;27;.964;3600000;0
18750;155769;1928;0;0;0;0;.00nan;0;0
18751;4504;586;0;0;0;0;.00nan;0;0
18751;13033;586;72;37;4;33;.892;3600000;0
18751;170037;567;33;28;5;23;.821;3546000;0
18751;143879;567;0;0;0;0;.00nan;0;0
18752;174736;1918;87;43;4;39;.907;3600000;0
18752;190423;1918;0;0;0;0;.00nan;0;0
18752;34168;563;0;0;0;0;.00nan;0;0
18752;73939;563;92;22;0;22;1.000;3600000;0
18753;7063;2287;0;0;0;0;.00nan;0;0
18753;14459;2287;75;27;2;25;.926;3900000;0
18753;185220;583;81;27;2;25;.926;3900000;0
18753;-1;583;0;0;0;0;.00nan;0;0
18754;6202;1927;0;0;0;0;.00nan;0;0
18754;40088;1928;0;0;0;0;.00nan;0;0
18754;153618;1927;32;38;7;31;.816;3600000;0
18754;155769;1928;67;27;2;25;.926;3600000;0
18755;7412;585;0;0;0;0;.00nan;0;0
18755;13041;580;87;27;0;27;1.000;3900000;0
18755;13065;580;0;0;0;0;.00nan;0;0
18755;35052;585;90;26;0;26;1.000;3900000;0
18756;19473;2277;0;0;0;0;.00nan;0;0
18756;61999;1922;68;22;2;20;.909;3900000;0
18756;67614;2277;89;39;2;37;.949;3900000;0
18756;67625;1922;0;0;0;0;.00nan;0;0
18757;7063;2287;67;32;3;29;.906;3600000;0
18757;14459;2287;0;0;0;0;.00nan;0;0
18757;174736;1918;0;0;0;0;.00nan;0;0
18757;190423;1918;50;33;5;28;.848;3550000;0
18758;34168;563;0;0;0;0;.00nan;0;0
18758;185220;583;0;0;0;0;.00nan;0;0
18758;-1;583;79;30;1;29;.967;3600000;0
18758;73939;563;43;18;3;15;.833;3600000;0
18759;4504;586;0;0;0;0;.00nan;0;0
18759;6202;1927;73;31;3;28;.903;3600000;0
18759;13033;586;53;28;4;24;.857;3576000;0
18759;153618;1927;0;0;0;0;.00nan;0;0
18760;7412;585;38;8;2;6;.750;1753000;0
18760;13041;580;66;33;3;30;.909;3600000;0
18760;13065;580;0;0;0;0;.00nan;0;0
18760;35052;585;11;19;6;13;.684;1847000;0
18761;11438;2557;0;0;0;0;.00nan;0;0
18761;19473;2277;100;26;0;26;1.000;3600000;0
18761;67614;2277;0;0;0;0;.00nan;0;0
18761;86268;2557;58;40;5;35;.875;3600000;0
18762;7063;2287;0;0;0;0;.00nan;0;0
18762;7412;585;0;0;0;0;.00nan;0;0
18762;14459;2287;80;17;0;17;1.000;3600000;0
18762;35052;585;56;37;4;33;.892;3600000;0
18763;7063;2287;0;0;0;0;.00nan;0;0
18763;14459;2287;61;30;3;27;.900;3557000;0
18763;170037;567;83;26;1;25;.962;3600000;0
18763;143879;567;0;0;0;0;.00nan;0;0
18764;13041;580;0;0;0;0;.00nan;0;0
18764;13065;580;91;44;1;43;.977;3600000;0
18764;61999;1922;0;0;0;0;.00nan;0;0
18764;67625;1922;24;12;4;8;.667;3600000;0
18765;170037;567;0;0;0;0;.00nan;0;0
18765;174736;1918;21;24;6;18;.750;3600000;0
18765;190423;1918;0;0;0;0;.00nan;0;0
18765;143879;567;79;25;1;24;.960;3600000;0
18766;7412;585;0;0;0;0;.00nan;0;0
18766;185220;583;47;28;4;24;.857;3600000;0
18766;35052;585;80;30;1;29;.967;3600000;0
18766;-1;583;0;0;0;0;.00nan;0;0
18767;4504;586;0;0;0;0;.00nan;0;0
18767;11438;2557;0;0;0;0;.00nan;0;0
18767;13033;586;72;21;2;19;.905;3600000;0
18767;86268;2557;66;43;4;39;.907;3566000;0
18768;174736;1918;0;0;0;0;.00nan;0;0
18768;190423;1918;75;24;1;23;.958;3600000;0
18768;40088;1928;58;30;3;27;.900;3553000;0
18768;155769;1928;0;0;0;0;.00nan;0;0
18769;13041;580;82;38;3;35;.921;3600000;0
18769;13065;580;0;0;0;0;.00nan;0;0
18769;34168;563;0;0;0;0;.00nan;0;0
18769;73939;563;84;16;0;16;1.000;3600000;0
18770;6202;1927;0;0;0;0;.00nan;0;0
18770;61999;1922;0;0;0;0;.00nan;0;0
18770;67625;1922;67;23;3;20;.870;3900000;0
18770;153618;1927;97;46;3;43;.935;3900000;0
18771;7063;2287;58;27;3;24;.889;3600000;0
18771;14459;2287;0;0;0;0;.00nan;0;0
18771;19473;2277;69;24;2;22;.917;3600000;0
18771;67614;2277;0;0;0;0;.00nan;0;0
18772;185220;583;50;9;1;8;.889;877000;0
18772;-1;583;20;19;6;13;.684;2723000;0
18772;40088;1928;0;0;0;0;.00nan;0;0
18772;155769;1928;54;22;3;19;.864;3600000;0
18773;13041;580;0;0;0;0;.00nan;0;0
18773;13065;580;51;25;3;22;.880;3600000;0
18773;34168;563;0;0;0;0;.00nan;0;0
18773;73939;563;86;29;1;28;.966;3600000;0
18774;6202;1927;37;26;5;21;.808;3563000;0
18774;11438;2557;61;24;3;21;.875;3600000;0
18774;86268;2557;0;0;0;0;.00nan;0;0
18774;153618;1927;0;0;0;0;.00nan;0;0
18775;19473;2277;0;0;0;0;.00nan;0;0
18775;170037;567;74;29;3;26;.897;3858000;0
18775;67614;2277;66;25;3;22;.880;3900000;0
18775;143879;567;0;0;0;0;.00nan;0;0
18776;6202;1927;0;0;0;0;.00nan;0;0
18776;7063;2287;71;27;2;25;.926;3600000;0
18776;14459;2287;0;0;0;0;.00nan;0;0
18776;153618;1927;65;40;4;36;.900;3566000;0
18777;7063;2287;0;0;0;0;.00nan;0;0
18777;14459;2287;58;24;3;21;.875;3600000;0
18777;170037;567;21;24;6;18;.750;2103000;0
18777;143879;567;54;11;1;10;.909;1497000;0
18778;7412;585;0;0;0;0;.00nan;0;0
18778;35052;585;80;41;2;39;.951;3547000;0
18778;61999;1922;0;0;0;0;.00nan;0;0
18778;67625;1922;70;21;1;20;.952;3600000;0
18779;4504;586;0;0;0;0;.00nan;0;0
18779;13033;586;75;22;1;21;.955;3600000;0
18779;174736;1918;72;39;5;34;.872;3600000;0
18779;190423;1918;0;0;0;0;.00nan;0;0
18780;34168;563;0;0;0;0;.00nan;0;0
18780;40088;1928;83;29;1;28;.966;3600000;0
18780;73939;563;63;27;2;25;.926;3573000;0
18780;155769;1928;0;0;0;0;.00nan;0;0
18781;6202;1927;45;11;2;9;.818;792000;0
18781;11438;2557;0;0;0;0;.00nan;0;0
18781;86268;2557;64;30;3;27;.900;3600000;0
18781;153618;1927;18;28;6;22;.786;2808000;0
18782;13041;580;96;49;3;46;.939;3600000;0
18782;13065;580;0;0;0;0;.00nan;0;0
18782;19473;2277;0;0;0;0;.00nan;0;0
18782;67614;2277;45;23;4;19;.826;3547000;0
18783;4504;586;39;26;5;21;.808;3567000;0
18783;13033;586;0;0;0;0;.00nan;0;0
18783;185220;583;70;41;4;37;.902;3600000;0
18783;-1;583;0;0;0;0;.00nan;0;0
18784;7063;2287;78;25;1;24;.960;3600000;0
18784;14459;2287;0;0;0;0;.00nan;0;0
18784;34168;563;0;0;0;0;.00nan;0;0
18784;73939;563;52;25;3;22;.880;3553000;0
18785;6202;1927;41;14;3;11;.786;3555000;0
18785;7412;585;100;44;2;42;.955;3600000;0
18785;35052;585;0;0;0;0;.00nan;0;0
18785;153618;1927;0;0;0;0;.00nan;0;0
18786;170037;567;77;34;2;32;.941;3600000;0
18786;61999;1922;28;26;6;20;.769;3600000;0
18786;67625;1922;0;0;0;0;.00nan;0;0
18786;143879;567;0;0;0;0;.00nan;0;0
18787;13041;580;0;0;0;0;.00nan;0;0
18787;13065;580;63;21;2;19;.905;3600000;0
18787;19473;2277;65;34;3;31;.912;3600000;0
18787;67614;2277;0;0;0;0;.00nan;0;0
18788;11438;2557;0;0;0;0;.00nan;0;0
18788;34168;563;0;0;0;0;.00nan;0;0
18788;73939;563;77;33;2;31;.939;3600000;0
18788;86268;2557;66;29;3;26;.897;3574000;0
18789;170037;567;72;37;3;34;.919;3900000;0
18789;40088;1928;70;32;3;29;.906;3900000;0
18789;143879;567;0;0;0;0;.00nan;0;0
18789;155769;1928;0;0;0;0;.00nan;0;0
18790;6202;1927;0;0;0;0;.00nan;0;0
18790;61999;1922;0;0;0;0;.00nan;0;0
18790;67625;1922;32;22;4;18;.818;3600000;0
18790;153618;1927;87;30;2;28;.933;3600000;0
18791;13041;580;30;31;6;25;.806;3600000;0
18791;13065;580;0;0;0;0;.00nan;0;0
18791;40088;1928;65;8;0;8;1.000;2501000;0
18791;155769;1928;24;11;4;7;.636;1099000;0
18792;19473;2277;0;0;0;0;.00nan;0;0
18792;185220;583;21;26;6;20;.769;2987000;0
18792;-1;583;53;8;1;7;.875;613000;0
18792;67614;2277;71;28;2;26;.929;3600000;0
18793;7412;585;0;0;0;0;.00nan;0;0
18793;174736;1918;64;19;2;17;.895;3600000;0
18793;190423;1918;0;0;0;0;.00nan;0;0
18793;35052;585;61;38;5;33;.868;3600000;0
18794;4504;586;0;0;0;0;.00nan;0;0
18794;13033;586;66;23;2;21;.913;3600000;0
18794;34168;563;0;0;0;0;.00nan;0;0
18794;73939;563;69;31;3;28;.903;3594000;0
18795;7063;2287;64;18;2;16;.889;3600000;0
18795;14459;2287;0;0;0;0;.00nan;0;0
18795;61999;1922;0;0;0;0;.00nan;0;0
18795;67625;1922;79;45;4;41;.911;3538000;0
18796;11438;2557;85;34;3;31;.912;3600000;0
18796;13041;580;0;0;0;0;.00nan;0;0
18796;13065;580;42;31;6;25;.806;3600000;0
18796;86268;2557;0;0;0;0;.00nan;0;0
18797;170037;567;0;0;0;0;.00nan;0;0
18797;185220;583;0;0;0;0;.00nan;0;0
18797;-1;583;20;29;7;22;.759;3600000;0
18797;143879;567;78;24;1;23;.958;3600000;0
18798;7412;585;60;34;3;31;.912;3600000;0
18798;35052;585;0;0;0;0;.00nan;0;0
18798;40088;1928;87;19;0;19;1.000;3600000;0
18798;155769;1928;0;0;0;0;.00nan;0;0
18799;7063;2287;95;48;4;44;.917;3600000;0
18799;13041;580;54;23;3;20;.870;3600000;0
18799;13065;580;0;0;0;0;.00nan;0;0
18799;14459;2287;0;0;0;0;.00nan;0;0
18800;6202;1927;50;1;0;1;1.000;347000;0
18800;34168;563;0;0;0;0;.00nan;0;0
18800;73939;563;80;38;4;34;.895;3600000;0
18800;153618;1927;28;30;6;24;.800;3244000;0
18801;11438;2557;0;0;0;0;.00nan;0;0
18801;61999;1922;69;25;2;23;.920;3600000;0
18801;67625;1922;0;0;0;0;.00nan;0;0
18801;86268;2557;62;28;3;25;.893;3567000;0
18802;19473;2277;0;0;0;0;.00nan;0;0
18802;174736;1918;0;0;0;0;.00nan;0;0
18802;190423;1918;69;41;4;37;.902;3900000;0
18802;67614;2277;48;27;4;23;.852;3900000;0
18803;7063;2287;0;0;0;0;.00nan;0;0
18803;14459;2287;79;27;1;26;.963;3600000;0
18803;40088;1928;60;18;2;16;.889;3561000;0
18803;155769;1928;0;0;0;0;.00nan;0;0
18804;7412;585;0;0;0;0;.00nan;0;0
18804;19473;2277;0;0;0;0;.00nan;0;0
18804;35052;585;60;35;4;31;.886;3600000;0
18804;67614;2277;71;23;2;21;.913;3600000;0
18805;7063;2287;59;21;3;18;.857;3600000;0
18805;11438;2557;63;56;7;49;.875;3600000;0
18805;14459;2287;0;0;0;0;.00nan;0;0
18805;86268;2557;0;0;0;0;.00nan;0;0
18806;4504;586;0;0;0;0;.00nan;0;0
18806;13033;586;76;26;2;24;.923;3600000;0
18806;13041;580;81;40;4;36;.900;3585000;0
18806;13065;580;0;0;0;0;.00nan;0;0
18807;174736;1918;78;23;1;22;.957;3600000;0
18807;190423;1918;0;0;0;0;.00nan;0;0
18807;185220;583;63;34;4;30;.882;3600000;0
18807;-1;583;0;0;0;0;.00nan;0;0
18808;7063;2287;23;13;4;9;.692;3600000;0
18808;11438;2557;0;0;0;0;.00nan;0;0
18808;14459;2287;0;0;0;0;.00nan;0;0
18808;86268;2557;84;29;1;28;.966;3600000;0
18809;34168;563;0;0;0;0;.00nan;0;0
18809;61999;1922;0;0;0;0;.00nan;0;0
18809;67625;1922;83;25;1;24;.960;3600000;0
18809;73939;563;52;29;5;24;.828;3600000;0
18810;6202;1927;0;0;0;0;.00nan;0;0
18810;170037;567;44;23;4;19;.826;3600000;0
18810;143879;567;0;0;0;0;.00nan;0;0
18810;153618;1927;54;41;5;36;.878;3563000;0
18811;19473;2277;72;34;3;31;.912;3600000;0
18811;40088;1928;92;18;0;18;1.000;3600000;0
18811;67614;2277;0;0;0;0;.00nan;0;0
18811;155769;1928;0;0;0;0;.00nan;0;0
18812;174736;1918;0;0;0;0;.00nan;0;0
18812;190423;1918;49;27;3;24;.889;3585000;0
18812;185220;583;0;0;0;0;.00nan;0;0
18812;-1;583;63;25;2;23;.920;3600000;0
18813;7412;585;58;29;4;25;.862;1676000;0
18813;35052;585;21;19;5;14;.737;1924000;0
18813;40088;1928;73;9;0;9;1.000;3600000;0
18813;155769;1928;0;0;0;0;.00nan;0;0
18814;34168;563;0;0;0;0;.00nan;0;0
18814;61999;1922;51;33;5;28;.848;3593000;0
18814;67625;1922;0;0;0;0;.00nan;0;0
18814;73939;563;81;46;3;43;.935;3600000;0
18815;6202;1927;46;38;6;32;.842;3600000;0
18815;170037;567;0;0;0;0;.00nan;0;0
18815;143879;567;73;36;3;33;.917;3600000;0
18815;153618;1927;0;0;0;0;.00nan;0;0
18816;4504;586;39;15;3;12;.800;3600000;0
18816;13033;586;0;0;0;0;.00nan;0;0
18816;13041;580;0;0;0;0;.00nan;0;0
18816;13065;580;69;40;4;36;.900;3600000;0
18817;6202;1927;0;0;0;0;.00nan;0;0
18817;19473;2277;0;0;0;0;.00nan;0;0
18817;67614;2277;65;28;3;25;.893;3636000;0
18817;153618;1927;64;33;4;29;.879;3636000;0
18818;185220;583;72;30;2;28;.933;3569000;0
18818;-1;583;0;0;0;0;.00nan;0;0
18818;40088;1928;96;30;1;29;.967;3600000;0
18818;155769;1928;0;0;0;0;.00nan;0;0
18819;4504;586;0;0;0;0;.00nan;0;0
18819;13033;586;78;24;1;23;.958;3600000;0
18819;19473;2277;0;0;0;0;.00nan;0;0
18819;67614;2277;73;36;2;34;.944;3553000;0
18820;7063;2287;0;0;0;0;.00nan;0;0
18820;14459;2287;58;17;2;15;.882;3600000;0
18820;174736;1918;66;34;5;29;.853;3600000;0
18820;190423;1918;0;0;0;0;.00nan;0;0
18821;11438;2557;51;25;4;21;.840;3543000;0
18821;185220;583;0;0;0;0;.00nan;0;0
18821;-1;583;56;25;3;22;.880;3600000;0
18821;86268;2557;0;0;0;0;.00nan;0;0
18822;170037;567;14;19;6;13;.684;3600000;0
18822;61999;1922;0;0;0;0;.00nan;0;0
18822;67625;1922;95;20;0;20;1.000;3600000;0
18822;143879;567;0;0;0;0;.00nan;0;0
18823;13041;580;84;28;2;26;.929;3900000;0
18823;13065;580;0;0;0;0;.00nan;0;0
18823;34168;563;0;0;0;0;.00nan;0;0
18823;73939;563;81;30;2;28;.933;3900000;0
18824;4504;586;0;0;0;0;.00nan;0;0
18824;7412;585;0;0;0;0;.00nan;0;0
18824;13033;586;60;27;4;23;.852;3600000;0
18824;35052;585;42;44;6;38;.864;3529000;0
18825;6202;1927;0;0;0;0;.00nan;0;0
18825;61999;1922;0;0;0;0;.00nan;0;0
18825;67625;1922;46;30;5;25;.833;3600000;0
18825;153618;1927;83;32;2;30;.938;3600000;0
18826;11438;2557;0;0;0;0;.00nan;0;0
18826;174736;1918;78;23;1;22;.957;3600000;0
18826;190423;1918;0;0;0;0;.00nan;0;0
18826;86268;2557;54;25;3;22;.880;3517000;0
18827;13041;580;0;0;0;0;.00nan;0;0
18827;13065;580;36;35;7;28;.800;3600000;0
18827;34168;563;0;0;0;0;.00nan;0;0
18827;73939;563;61;13;1;12;.923;3600000;0
18828;6202;1927;35;15;4;11;.733;1630000;0
18828;174736;1918;81;28;1;27;.964;3600000;0
18828;190423;1918;0;0;0;0;.00nan;0;0
18828;153618;1927;80;18;0;18;1.000;1970000;0
18829;4504;586;0;0;0;0;.00nan;0;0
18829;13033;586;56;27;3;24;.889;3575000;0
18829;34168;563;0;0;0;0;.00nan;0;0
18829;73939;563;79;35;2;33;.943;3600000;0
18830;6202;1927;0;0;0;0;.00nan;0;0
18830;185220;583;59;33;4;29;.879;3600000;0
18830;-1;583;0;0;0;0;.00nan;0;0
18830;153618;1927;100;27;0;27;1.000;3600000;0
18831;7412;585;0;0;0;0;.00nan;0;0
18831;11438;2557;55;28;4;24;.857;3736000;0
18831;35052;585;79;33;3;30;.909;3736000;0
18831;86268;2557;0;0;0;0;.00nan;0;0
18832;4504;586;77;38;3;35;.921;3600000;0
18832;13033;586;0;0;0;0;.00nan;0;0
18832;61999;1922;47;35;5;30;.857;3536000;0
18832;67625;1922;0;0;0;0;.00nan;0;0
18833;11438;2557;0;0;0;0;.00nan;0;0
18833;170037;567;0;0;0;0;.00nan;0;0
18833;86268;2557;85;43;3;40;.930;3900000;0
18833;143879;567;63;31;3;28;.903;3900000;0
18834;7063;2287;43;4;1;3;.750;1233000;0
18834;14459;2287;48;25;4;21;.840;2351000;0
18834;174736;1918;70;39;4;35;.897;3600000;0
18834;190423;1918;0;0;0;0;.00nan;0;0
18835;185220;583;52;42;6;36;.857;3600000;0
18835;-1;583;0;0;0;0;.00nan;0;0
18835;40088;1928;68;24;2;22;.917;3600000;0
18835;155769;1928;0;0;0;0;.00nan;0;0
18836;6202;1927;0;0;0;0;.00nan;0;0
18836;13041;580;0;0;0;0;.00nan;0;0
18836;13065;580;93;20;0;20;1.000;3600000;0
18836;153618;1927;72;27;2;25;.926;3546000;0
18837;19473;2277;0;0;0;0;.00nan;0;0
18837;34168;563;0;0;0;0;.00nan;0;0
18837;67614;2277;68;31;3;28;.903;3565000;0
18837;73939;563;54;18;2;16;.889;3600000;0
18838;7412;585;63;5;0;5;1.000;860000;0
18838;34168;563;0;0;0;0;.00nan;0;0
18838;35052;585;35;32;6;26;.813;2740000;0
18838;73939;563;54;23;3;20;.870;3600000;0
18839;4504;586;0;0;0;0;.00nan;0;0
18839;7063;2287;0;0;0;0;.00nan;0;0
18839;13033;586;62;28;2;26;.929;3900000;0
18839;14459;2287;71;26;2;24;.923;3900000;0
18840;13041;580;77;39;4;35;.897;3598000;0
18840;13065;580;0;0;0;0;.00nan;0;0
18840;174736;1918;0;0;0;0;.00nan;0;0
18840;190423;1918;82;27;2;25;.926;3600000;0
18841;11438;2557;0;0;0;0;.00nan;0;0
18841;19473;2277;0;0;0;0;.00nan;0;0
18841;67614;2277;74;26;1;25;.962;3600000;0
18841;86268;2557;63;33;4;29;.879;3600000;0
18842;40088;1928;0;0;0;0;.00nan;0;0
18842;61999;1922;0;0;0;0;.00nan;0;0
18842;67625;1922;65;43;5;38;.884;3873000;0
18842;155769;1928;71;38;4;34;.895;3873000;0
18843;4504;586;0;0;0;0;.00nan;0;0
18843;13033;586;81;27;1;26;.963;3600000;0
18843;40088;1928;55;30;4;26;.867;3600000;0
18843;155769;1928;0;0;0;0;.00nan;0;0
18844;19473;2277;0;0;0;0;.00nan;0;0
18844;170037;567;57;18;2;16;.889;3854000;0
18844;67614;2277;90;32;1;31;.969;3854000;0
18844;143879;567;0;0;0;0;.00nan;0;0
18845;174736;1918;91;36;1;35;.972;3900000;0
18845;190423;1918;0;0;0;0;.00nan;0;0
18845;34168;563;0;0;0;0;.00nan;0;0
18845;73939;563;75;22;1;21;.955;3900000;0
18846;4504;586;0;0;0;0;.00nan;0;0
18846;11438;2557;79;42;3;39;.929;3600000;0
18846;13033;586;66;33;5;28;.848;3517000;0
18846;86268;2557;0;0;0;0;.00nan;0;0
18847;13041;580;0;0;0;0;.00nan;0;0
18847;13065;580;92;56;4;52;.929;3578000;0
18847;185220;583;46;21;3;18;.857;3600000;0
18847;-1;583;0;0;0;0;.00nan;0;0
18848;4504;586;0;0;0;0;.00nan;0;0
18848;13033;586;80;13;0;13;1.000;3600000;0
18848;19473;2277;0;0;0;0;.00nan;0;0
18848;67614;2277;98;46;2;44;.957;3561000;0
18849;7412;585;0;0;0;0;.00nan;0;0
18849;174736;1918;58;24;3;21;.875;3887000;0
18849;190423;1918;0;0;0;0;.00nan;0;0
18849;35052;585;75;33;3;30;.909;3900000;0
18850;6202;1927;0;0;0;0;.00nan;0;0
18850;7063;2287;0;0;0;0;.00nan;0;0
18850;14459;2287;62;24;3;21;.875;3600000;0
18850;153618;1927;57;37;4;33;.892;3555000;0
18851;11438;2557;72;40;4;36;.900;3600000;0
18851;34168;563;0;0;0;0;.00nan;0;0
18851;73939;563;87;16;0;16;1.000;3600000;0
18851;86268;2557;0;0;0;0;.00nan;0;0
18852;13041;580;27;34;7;27;.794;3600000;0
18852;13065;580;0;0;0;0;.00nan;0;0
18852;170037;567;76;23;1;22;.957;3600000;0
18852;143879;567;0;0;0;0;.00nan;0;0
18853;19473;2277;0;0;0;0;.00nan;0;0
18853;174736;1918;0;0;0;0;.00nan;0;0
18853;190423;1918;94;23;0;23;1.000;3600000;0
18853;67614;2277;93;46;3;43;.935;3600000;0
18854;7412;585;34;40;8;32;.800;3600000;0
18854;185220;583;48;33;5;28;.848;3600000;0
18854;35052;585;0;0;0;0;.00nan;0;0
18854;-1;583;0;0;0;0;.00nan;0;0
18855;7063;2287;57;22;3;19;.864;3700000;0
18855;14459;2287;0;0;0;0;.00nan;0;0
18855;40088;1928;79;32;2;30;.938;3700000;0
18855;155769;1928;0;0;0;0;.00nan;0;0
18856;6202;1927;58;17;2;15;.882;3600000;0
18856;13041;580;0;0;0;0;.00nan;0;0
18856;13065;580;57;33;4;29;.879;3600000;0
18856;153618;1927;0;0;0;0;.00nan;0;0
18857;11438;2557;49;12;2;10;.833;1345000;0
18857;61999;1922;0;0;0;0;.00nan;0;0
18857;67625;1922;98;29;0;29;1.000;3600000;0
18857;86268;2557;31;17;4;13;.765;2255000;0
18858;4504;586;0;0;0;0;.00nan;0;0
18858;13033;586;100;31;0;31;1.000;3600000;0
18858;13041;580;78;26;3;23;.885;3600000;0
18858;13065;580;0;0;0;0;.00nan;0;0
18859;170037;567;84;28;1;27;.964;3600000;0
18859;40088;1928;97;48;2;46;.958;3563000;0
18859;143879;567;0;0;0;0;.00nan;0;0
18859;155769;1928;0;0;0;0;.00nan;0;0
18860;7412;585;0;0;0;0;.00nan;0;0
18860;19473;2277;0;0;0;0;.00nan;0;0
18860;35052;585;100;29;0;29;1.000;3600000;0
18860;67614;2277;71;23;2;21;.913;3529000;0
18861;7063;2287;0;0;0;0;.00nan;0;0
18861;14459;2287;70;31;3;28;.903;3869000;0
18861;185220;583;78;37;3;34;.919;3900000;0
18861;-1;583;0;0;0;0;.00nan;0;0
18862;7412;585;0;0;0;0;.00nan;0;0
18862;185220;583;0;0;0;0;.00nan;0;0
18862;35052;585;72;28;2;26;.929;3600000;0
18862;-1;583;38;25;4;21;.840;3563000;0
18863;4504;586;0;0;0;0;.00nan;0;0
18863;13033;586;70;35;4;31;.886;3900000;0
18863;170037;567;62;37;4;33;.892;3900000;0
18863;143879;567;0;0;0;0;.00nan;0;0
18864;19473;2277;0;0;0;0;.00nan;0;0
18864;174736;1918;0;0;0;0;.00nan;0;0
18864;190423;1918;58;30;3;27;.900;3600000;0
18864;67614;2277;76;29;2;27;.931;3600000;0
18865;34168;563;0;0;0;0;.00nan;0;0
18865;40088;1928;53;24;3;21;.875;3600000;0
18865;73939;563;80;43;4;39;.907;3578000;0
18865;155769;1928;0;0;0;0;.00nan;0;0
18866;7063;2287;86;22;1;21;.955;3600000;0
18866;11438;2557;62;29;4;25;.862;3600000;0
18866;14459;2287;0;0;0;0;.00nan;0;0
18866;86268;2557;0;0;0;0;.00nan;0;0
18867;6202;1927;0;0;0;0;.00nan;0;0
18867;13041;580;0;0;0;0;.00nan;0;0
18867;13065;580;70;27;2;25;.926;3526000;0
18867;153618;1927;100;29;0;29;1.000;3600000;0
18868;4504;586;73;23;1;22;.957;3600000;0
18868;7412;585;76;43;3;40;.930;3515000;0
18868;13033;586;0;0;0;0;.00nan;0;0
18868;35052;585;0;0;0;0;.00nan;0;0
18869;6202;1927;0;0;0;0;.00nan;0;0
18869;174736;1918;70;29;3;26;.897;3600000;0
18869;190423;1918;0;0;0;0;.00nan;0;0
18869;153618;1927;30;37;7;30;.811;3600000;0
18870;11438;2557;0;0;0;0;.00nan;0;0
18870;40088;1928;0;0;0;0;.00nan;0;0
18870;86268;2557;74;41;3;38;.927;3737000;0
18870;155769;1928;63;21;2;19;.905;3737000;0
18871;19473;2277;0;0;0;0;.00nan;0;0
18871;61999;1922;0;0;0;0;.00nan;0;0
18871;67614;2277;100;26;0;26;1.000;3600000;0
18871;67625;1922;61;22;2;20;.909;3583000;0
18872;13041;580;82;42;4;38;.905;3600000;0
18872;13065;580;0;0;0;0;.00nan;0;0
18872;170037;567;100;25;0;25;1.000;3600000;0
18872;143879;567;0;0;0;0;.00nan;0;0
18873;7063;2287;0;0;0;0;.00nan;0;0
18873;14459;2287;77;32;2;30;.938;3600000;0
18873;170037;567;32;32;7;25;.781;3600000;0
18873;143879;567;0;0;0;0;.00nan;0;0
18874;7412;585;0;0;0;0;.00nan;0;0
18874;35052;585;99;43;1;42;.977;3600000;0
18874;40088;1928;63;19;2;17;.895;3572000;0
18874;155769;1928;0;0;0;0;.00nan;0;0
18875;34168;563;0;0;0;0;.00nan;0;0
18875;185220;583;75;38;3;35;.921;3538000;0
18875;-1;583;0;0;0;0;.00nan;0;0
18875;73939;563;79;26;1;25;.962;3600000;0
18876;170037;567;0;0;0;0;.00nan;0;0
18876;174736;1918;60;36;4;32;.889;3600000;0
18876;190423;1918;0;0;0;0;.00nan;0;0
18876;143879;567;91;22;0;22;1.000;3600000;0
18877;174736;1918;0;0;0;0;.00nan;0;0
18877;190423;1918;47;38;5;33;.868;3583000;0
18877;40088;1928;56;19;3;16;.842;3600000;0
18877;155769;1928;0;0;0;0;.00nan;0;0
18878;4504;586;0;0;0;0;.00nan;0;0
18878;7063;2287;68;19;1;18;.947;3600000;0
18878;13033;586;73;28;2;26;.929;3600000;0
18878;14459;2287;0;0;0;0;.00nan;0;0
18879;6202;1927;0;0;0;0;.00nan;0;0
18879;7412;585;0;0;0;0;.00nan;0;0
18879;35052;585;72;35;3;32;.914;3600000;0
18879;153618;1927;46;31;5;26;.839;3600000;0
18880;11438;2557;58;41;5;36;.878;3600000;0
18880;13041;580;65;25;2;23;.920;3600000;0
18880;13065;580;0;0;0;0;.00nan;0;0
18880;86268;2557;0;0;0;0;.00nan;0;0
18881;19473;2277;0;0;0;0;.00nan;0;0
18881;61999;1922;0;0;0;0;.00nan;0;0
18881;67614;2277;100;32;0;32;1.000;3600000;0
18881;67625;1922;83;30;1;29;.967;3552000;0
18882;7412;585;80;48;4;44;.917;3900000;0
18882;35052;585;0;0;0;0;.00nan;0;0
18882;61999;1922;0;0;0;0;.00nan;0;0
18882;67625;1922;57;31;4;27;.871;3900000;0
18883;6202;1927;64;33;3;30;.909;3585000;0
18883;185220;583;79;26;2;24;.923;3600000;0
18883;-1;583;0;0;0;0;.00nan;0;0
18883;153618;1927;0;0;0;0;.00nan;0;0
18884;4504;586;0;0;0;0;.00nan;0;0
18884;13033;586;49;30;4;26;.867;3900000;0
18884;40088;1928;0;0;0;0;.00nan;0;0
18884;155769;1928;47;33;4;29;.879;3900000;0
18885;7063;2287;0;0;0;0;.00nan;0;0
18885;14459;2287;100;26;0;26;1.000;3600000;0
18885;19473;2277;0;0;0;0;.00nan;0;0
18885;67614;2277;28;43;8;35;.814;3600000;0
18886;170037;567;0;0;0;0;.00nan;0;0
18886;34168;563;0;0;0;0;.00nan;0;0
18886;73939;563;52;18;3;15;.833;3600000;0
18886;143879;567;42;26;5;21;.808;3580000;0
18887;11438;2557;0;0;0;0;.00nan;0;0
18887;13041;580;64;11;0;11;1.000;2353000;0
18887;13065;580;37;22;4;18;.818;1199000;0
18887;86268;2557;69;24;2;22;.917;3600000;0
18888;174736;1918;65;15;2;13;.867;3542000;0
18888;190423;1918;0;0;0;0;.00nan;0;0
18888;34168;563;0;0;0;0;.00nan;0;0
18888;73939;563;100;24;0;24;1.000;3600000;0
18889;34168;563;0;0;0;0;.00nan;0;0
18889;185220;583;32;27;6;21;.778;2308000;0
18889;-1;583;70;9;0;9;1.000;1292000;0
18889;73939;563;98;25;0;25;1.000;3600000;0
18890;11438;2557;0;0;0;0;.00nan;0;0
18890;170037;567;32;23;5;18;.783;3589000;0
18890;86268;2557;81;39;3;36;.923;3600000;0
18890;143879;567;0;0;0;0;.00nan;0;0
18891;6202;1927;0;0;0;0;.00nan;0;0
18891;13041;580;64;25;3;22;.880;3560000;0
18891;13065;580;0;0;0;0;.00nan;0;0
18891;153618;1927;86;33;1;32;.970;3600000;0
18892;7412;585;0;0;0;0;.00nan;0;0
18892;13041;580;0;0;0;0;.00nan;0;0
18892;13065;580;67;23;2;21;.913;3600000;0
18892;35052;585;55;27;3;24;.889;3556000;0
18893;4504;586;0;0;0;0;.00nan;0;0
18893;13033;586;52;27;4;23;.852;3600000;0
18893;40088;1928;40;32;5;27;.844;3600000;0
18893;155769;1928;0;0;0;0;.00nan;0;0
18894;11438;2557;0;0;0;0;.00nan;0;0
18894;174736;1918;100;33;0;33;1.000;3600000;0
18894;190423;1918;0;0;0;0;.00nan;0;0
18894;86268;2557;47;23;3;20;.870;3600000;0
18895;7063;2287;65;34;4;30;.882;3600000;0
18895;14459;2287;0;0;0;0;.00nan;0;0
18895;61999;1922;39;27;5;22;.815;3550000;0
18895;67625;1922;0;0;0;0;.00nan;0;0
18896;19473;2277;0;0;0;0;.00nan;0;0
18896;170037;567;0;0;0;0;.00nan;0;0
18896;67614;2277;75;35;3;32;.914;3691000;0
18896;143879;567;40;22;4;18;.818;3691000;0
18897;174736;1918;10;29;7;22;.759;1747000;0
18897;190423;1918;70;20;1;19;.950;1853000;0
18897;40088;1928;0;0;0;0;.00nan;0;0
18897;155769;1928;92;22;0;22;1.000;3600000;0
18898;11438;2557;71;45;6;39;.867;3703000;0
18898;185220;583;23;18;5;13;.722;3703000;0
18898;-1;583;0;0;0;0;.00nan;0;0
18898;86268;2557;0;0;0;0;.00nan;0;0
18899;7063;2287;80;33;2;31;.939;3600000;0
18899;14459;2287;0;0;0;0;.00nan;0;0
18899;34168;563;0;0;0;0;.00nan;0;0
18899;73939;563;72;34;4;30;.882;3548000;0
18900;7412;585;70;25;1;24;.960;3600000;0
18900;170037;567;74;36;3;33;.917;3592000;0
18900;35052;585;0;0;0;0;.00nan;0;0
18900;143879;567;0;0;0;0;.00nan;0;0
18901;13041;580;79;28;2;26;.929;3600000;0
18901;13065;580;0;0;0;0;.00nan;0;0
18901;19473;2277;51;21;3;18;.857;3593000;0
18901;67614;2277;0;0;0;0;.00nan;0;0
18902;170037;567;65;43;5;38;.884;3548000;0
18902;61999;1922;0;0;0;0;.00nan;0;0
18902;67625;1922;59;30;4;26;.867;3600000;0
18902;143879;567;0;0;0;0;.00nan;0;0
18903;6202;1927;0;0;0;0;.00nan;0;0
18903;11438;2557;0;0;0;0;.00nan;0;0
18903;86268;2557;75;31;2;29;.935;3600000;0
18903;153618;1927;63;28;4;24;.857;3515000;0
18904;4504;586;0;0;0;0;.00nan;0;0
18904;13033;586;72;19;1;18;.947;3600000;0
18904;174736;1918;84;31;2;29;.935;3545000;0
18904;190423;1918;0;0;0;0;.00nan;0;0
18905;185220;583;0;0;0;0;.00nan;0;0
18905;-1;583;81;36;2;34;.944;3900000;0
18905;61999;1922;0;0;0;0;.00nan;0;0
18905;67625;1922;59;21;2;19;.905;3900000;0
18906;7412;585;0;0;0;0;.00nan;0;0
18906;34168;563;0;0;0;0;.00nan;0;0
18906;35052;585;53;24;4;20;.833;3900000;0
18906;73939;563;91;47;4;43;.915;3900000;0
18907;6202;1927;0;0;0;0;.00nan;0;0
18907;40088;1928;0;0;0;0;.00nan;0;0
18907;153618;1927;50;31;4;27;.871;3644000;0
18907;155769;1928;45;17;3;14;.824;3644000;0
18908;11438;2557;0;0;0;0;.00nan;0;0
18908;170037;567;0;0;0;0;.00nan;0;0
18908;86268;2557;92;37;1;36;.973;3600000;0
18908;143879;567;66;19;2;17;.895;3544000;0
18909;7063;2287;0;0;0;0;.00nan;0;0
18909;13041;580;0;0;0;0;.00nan;0;0
18909;13065;580;60;23;3;20;.870;3552000;0
18909;14459;2287;83;35;2;33;.943;3600000;0
18910;4504;586;0;0;0;0;.00nan;0;0
18910;6202;1927;99;44;1;43;.977;3600000;0
18910;13033;586;37;14;3;11;.786;3549000;0
18910;153618;1927;0;0;0;0;.00nan;0;0
18911;174736;1918;75;26;2;24;.923;3600000;0
18911;190423;1918;0;0;0;0;.00nan;0;0
18911;185220;583;59;38;4;34;.895;3569000;0
18911;-1;583;0;0;0;0;.00nan;0;0
18912;19473;2277;0;0;0;0;.00nan;0;0
18912;40088;1928;93;23;0;23;1.000;3600000;0
18912;67614;2277;45;29;5;24;.828;3600000;0
18912;155769;1928;0;0;0;0;.00nan;0;0
18913;7412;585;65;31;4;27;.871;3621000;0
18913;35052;585;0;0;0;0;.00nan;0;0
18913;61999;1922;47;15;3;12;.800;3621000;0
18913;67625;1922;0;0;0;0;.00nan;0;0
18914;7063;2287;35;26;5;21;.808;3600000;0
18914;13041;580;60;14;1;13;.929;3600000;0
18914;13065;580;0;0;0;0;.00nan;0;0
18914;14459;2287;0;0;0;0;.00nan;0;0
18915;6202;1927;0;0;0;0;.00nan;0;0
18915;19473;2277;0;0;0;0;.00nan;0;0
18915;67614;2277;38;20;5;15;.750;3900000;0
18915;153618;1927;65;41;5;36;.878;3900000;0
18916;19473;2277;0;0;0;0;.00nan;0;0
18916;185220;583;66;31;3;28;.903;3600000;0
18916;-1;583;0;0;0;0;.00nan;0;0
18916;67614;2277;46;28;4;24;.857;3559000;0
18917;7063;2287;0;0;0;0;.00nan;0;0
18917;7412;585;0;0;0;0;.00nan;0;0
18917;14459;2287;76;24;1;23;.958;3600000;0
18917;35052;585;38;39;6;33;.846;3600000;0
18918;40088;1928;80;26;1;25;.962;3682000;0
18918;61999;1922;0;0;0;0;.00nan;0;0
18918;67625;1922;72;21;2;19;.905;3682000;0
18918;155769;1928;0;0;0;0;.00nan;0;0
18919;170037;567;64;22;2;20;.909;3600000;0
18919;34168;563;0;0;0;0;.00nan;0;0
18919;73939;563;54;50;8;42;.840;3600000;0
18919;143879;567;0;0;0;0;.00nan;0;0
18920;7412;585;0;0;0;0;.00nan;0;0
18920;174736;1918;63;13;1;12;.923;3600000;0
18920;190423;1918;0;0;0;0;.00nan;0;0
18920;35052;585;95;46;2;44;.957;3557000;0
18921;4504;586;0;0;0;0;.00nan;0;0
18921;13033;586;79;32;2;30;.938;3600000;0
18921;61999;1922;0;0;0;0;.00nan;0;0
18921;67625;1922;46;35;6;29;.829;3600000;0
18922;7063;2287;65;23;2;21;.913;3600000;0
18922;14459;2287;0;0;0;0;.00nan;0;0
18922;185220;583;83;29;1;28;.966;3600000;0
18922;-1;583;0;0;0;0;.00nan;0;0
18923;34168;563;0;0;0;0;.00nan;0;0
18923;40088;1928;0;0;0;0;.00nan;0;0
18923;73939;563;87;31;1;30;.968;3600000;0
18923;155769;1928;52;29;4;25;.862;3600000;0
18924;7412;585;43;44;7;37;.841;3600000;0
18924;170037;567;90;23;0;23;1.000;3600000;0
18924;35052;585;0;0;0;0;.00nan;0;0
18924;143879;567;0;0;0;0;.00nan;0;0
18925;4504;586;0;0;0;0;.00nan;0;0
18925;7063;2287;61;7;0;7;1.000;1183000;0
18925;13033;586;61;28;3;25;.893;3600000;0
18925;14459;2287;57;25;4;21;.840;2381000;0
18926;11438;2557;0;0;0;0;.00nan;0;0
18926;40088;1928;69;18;1;17;.944;3600000;0
18926;86268;2557;70;32;3;29;.906;3554000;0
18926;155769;1928;0;0;0;0;.00nan;0;0
18927;6202;1927;75;37;3;34;.919;3521000;0
18927;185220;583;0;0;0;0;.00nan;0;0
18927;-1;583;93;34;1;33;.971;3600000;0
18927;153618;1927;0;0;0;0;.00nan;0;0
18928;13041;580;30;18;5;13;.722;1965000;0
18928;13065;580;78;16;0;16;1.000;1635000;0
18928;61999;1922;68;25;2;23;.920;3600000;0
18928;67625;1922;0;0;0;0;.00nan;0;0
18929;19473;2277;0;0;0;0;.00nan;0;0
18929;174736;1918;0;0;0;0;.00nan;0;0
18929;190423;1918;63;30;3;27;.900;3551000;0
18929;67614;2277;85;29;1;28;.966;3600000;0
18930;11438;2557;0;0;0;0;.00nan;0;0
18930;19473;2277;0;0;0;0;.00nan;0;0
18930;67614;2277;74;21;1;20;.952;3600000;0
18930;86268;2557;51;24;3;21;.875;3600000;0
18931;11438;2557;96;39;2;37;.949;3900000;0
18931;61999;1922;0;0;0;0;.00nan;0;0
18931;67625;1922;73;33;2;31;.939;3900000;0
18931;86268;2557;0;0;0;0;.00nan;0;0
18932;7063;2287;33;17;4;13;.765;1138000;0
18932;14459;2287;56;19;2;17;.895;2626000;0
18932;61999;1922;47;37;5;32;.865;3764000;0
18932;67625;1922;0;0;0;0;.00nan;0;0
18933;6202;1927;0;0;0;0;.00nan;0;0
18933;7412;585;0;0;0;0;.00nan;0;0
18933;35052;585;89;26;1;25;.962;3600000;0
18933;153618;1927;74;33;3;30;.909;3543000;0
18934;40088;1928;89;18;0;18;1.000;3600000;0
18934;61999;1922;0;0;0;0;.00nan;0;0
18934;67625;1922;78;42;4;38;.905;3600000;0
18934;155769;1928;0;0;0;0;.00nan;0;0
18935;170037;567;67;23;2;21;.913;3600000;0
18935;185220;583;60;39;5;34;.872;3600000;0
18935;-1;583;0;0;0;0;.00nan;0;0
18935;143879;567;0;0;0;0;.00nan;0;0
18936;13041;580;0;0;0;0;.00nan;0;0
18936;13065;580;60;12;1;11;.917;3600000;0
18936;174736;1918;76;29;2;27;.931;3581000;0
18936;190423;1918;0;0;0;0;.00nan;0;0
18937;4504;586;0;0;0;0;.00nan;0;0
18937;13033;586;65;19;2;17;.895;3600000;0
18937;19473;2277;0;0;0;0;.00nan;0;0
18937;67614;2277;55;32;4;28;.875;3519000;0
18938;4504;586;75;11;0;11;1.000;3600000;0
18938;7412;585;19;28;6;22;.786;1945000;0
18938;13033;586;0;0;0;0;.00nan;0;0
18938;35052;585;47;17;3;14;.824;1655000;0
18939;7063;2287;0;0;0;0;.00nan;0;0
18939;14459;2287;67;51;5;46;.902;3706000;0
18939;40088;1928;28;16;4;12;.750;3693000;0
18939;155769;1928;0;0;0;0;.00nan;0;0
18940;19473;2277;0;0;0;0;.00nan;0;0
18940;34168;563;0;0;0;0;.00nan;0;0
18940;67614;2277;57;15;2;13;.867;3550000;0
18940;73939;563;95;38;1;37;.974;3600000;0
18941;6202;1927;98;44;2;42;.955;3581000;0
18941;170037;567;85;24;1;23;.958;3600000;0
18941;143879;567;0;0;0;0;.00nan;0;0
18941;153618;1927;0;0;0;0;.00nan;0;0
18942;11438;2557;0;0;0;0;.00nan;0;0
18942;185220;583;0;0;0;0;.00nan;0;0
18942;-1;583;51;22;3;19;.864;3553000;0
18942;86268;2557;78;30;2;28;.933;3600000;0
18943;4504;586;0;0;0;0;.00nan;0;0
18943;13033;586;36;16;4;12;.750;3600000;0
18943;185220;583;14;18;6;12;.667;1658000;0
18943;-1;583;26;27;6;21;.778;1942000;0
18944;6202;1927;98;50;2;48;.960;3547000;0
18944;40088;1928;67;18;1;17;.944;3600000;0
18944;153618;1927;0;0;0;0;.00nan;0;0
18944;155769;1928;0;0;0;0;.00nan;0;0
18945;13041;580;64;47;6;41;.872;3600000;0
18945;13065;580;0;0;0;0;.00nan;0;0
18945;61999;1922;0;0;0;0;.00nan;0;0
18945;67625;1922;49;18;3;15;.833;3600000;0
18946;7412;585;0;0;0;0;.00nan;0;0
18946;11438;2557;84;28;1;27;.964;3600000;0
18946;35052;585;66;28;2;26;.929;3545000;0
18946;86268;2557;0;0;0;0;.00nan;0;0
18947;174736;1918;86;36;2;34;.944;3600000;0
18947;190423;1918;0;0;0;0;.00nan;0;0
18947;61999;1922;42;23;4;19;.826;3518000;0
18947;67625;1922;0;0;0;0;.00nan;0;0
18948;13041;580;56;28;3;25;.893;3900000;0
18948;13065;580;0;0;0;0;.00nan;0;0
18948;185220;583;87;34;3;31;.912;3900000;0
18948;-1;583;0;0;0;0;.00nan;0;0
18949;6202;1927;0;0;0;0;.00nan;0;0
18949;34168;563;0;0;0;0;.00nan;0;0
18949;73939;563;40;33;6;27;.818;3600000;0
18949;153618;1927;99;40;1;39;.975;3600000;0
18950;4504;586;0;0;0;0;.00nan;0;0
18950;13033;586;76;40;3;37;.925;3664000;0
18950;170037;567;79;30;2;28;.933;3664000;0
18950;143879;567;0;0;0;0;.00nan;0;0
18951;7063;2287;84;26;1;25;.962;3600000;0
18951;14459;2287;0;0;0;0;.00nan;0;0
18951;19473;2277;56;26;3;23;.885;3513000;0
18951;67614;2277;0;0;0;0;.00nan;0;0
18953;7063;2287;0;0;0;0;.00nan;0;0
18953;14459;2287;71;38;3;35;.921;3594000;0
18953;170037;567;88;31;2;29;.935;3600000;0
18953;143879;567;0;0;0;0;.00nan;0;0
18955;4504;586;0;0;0;0;.00nan;0;0
18955;13033;586;100;25;0;25;1.000;3600000;0
18955;34168;563;0;0;0;0;.00nan;0;0
18955;73939;563;56;31;4;27;.871;3600000;0
18957;13041;580;0;0;0;0;.00nan;0;0
18957;13065;580;55;27;3;24;.889;3580000;0
18957;174736;1918;0;0;0;0;.00nan;0;0
18957;190423;1918;77;30;2;28;.933;3600000;0
18959;19473;2277;88;28;1;27;.964;3600000;0
18959;19954;2277;0;0;0;0;.00nan;0;0
18959;185220;583;47;32;5;27;.844;3600000;0
18959;-1;583;0;0;0;0;.00nan;0;0
18961;11438;2557;0;0;0;0;.00nan;0;0
18961;32255;2557;60;40;5;35;.875;3575000;0
18961;61999;1922;49;30;4;26;.867;3600000;0
18961;67625;1922;0;0;0;0;.00nan;0;0
18963;7412;585;0;0;0;0;.00nan;0;0
18963;35052;585;58;52;6;46;.885;3600000;0
18963;40088;1928;95;22;0;22;1.000;3600000;0
18963;155769;1928;0;0;0;0;.00nan;0;0
18965;34168;563;0;0;0;0;.00nan;0;0
18965;185220;583;0;0;0;0;.00nan;0;0
18965;-1;583;36;19;4;15;.789;3600000;0
18965;73939;563;100;26;0;26;1.000;3600000;0
18967;170037;567;0;0;0;0;.00nan;0;0
18967;174736;1918;45;35;6;29;.829;3600000;0
18967;190423;1918;0;0;0;0;.00nan;0;0
18967;143879;567;47;18;3;15;.833;3600000;0
18969;11438;2557;64;35;4;31;.886;3600000;0
18969;13041;580;18;23;6;17;.739;3038000;0
18969;13065;580;54;4;0;4;1.000;518000;0
18969;32255;2557;0;0;0;0;.00nan;0;0
18971;4504;586;0;0;0;0;.00nan;0;0
18971;13033;586;34;22;4;18;.818;3515000;0
18971;40088;1928;81;32;2;30;.938;3600000;0
18971;155769;1928;0;0;0;0;.00nan;0;0
18973;7412;585;43;46;7;39;.848;3600000;0
18973;35052;585;0;0;0;0;.00nan;0;0
18973;61999;1922;0;0;0;0;.00nan;0;0
18973;67625;1922;68;36;4;32;.889;3600000;0
18975;6202;1927;0;0;0;0;.00nan;0;0
18975;7063;2287;87;31;1;30;.968;3900000;0
18975;14459;2287;0;0;0;0;.00nan;0;0
18975;153618;1927;97;42;1;41;.976;3900000;0
18977;4504;586;0;0;0;0;.00nan;0;0
18977;13033;586;94;31;1;30;.968;3900000;0
18977;174736;1918;79;28;1;27;.964;3900000;0
18977;190423;1918;0;0;0;0;.00nan;0;0
18979;7412;585;0;0;0;0;.00nan;0;0
18979;19473;2277;65;31;3;28;.903;3900000;0
18979;19954;2277;0;0;0;0;.00nan;0;0
18979;35052;585;81;34;3;31;.912;3900000;0
18981;34168;563;0;0;0;0;.00nan;0;0
18981;185220;583;77;33;2;31;.939;3749000;0
18981;-1;583;0;0;0;0;.00nan;0;0
18981;73939;563;62;25;3;22;.880;3749000;0
18983;11438;2557;74;45;4;41;.911;3571000;0
18983;32255;2557;0;0;0;0;.00nan;0;0
18983;61999;1922;0;0;0;0;.00nan;0;0
18983;67625;1922;55;17;3;14;.824;3600000;0
18985;7063;2287;42;3;1;2;.667;427000;0
18985;14459;2287;45;40;6;34;.850;3173000;0
18985;170037;567;48;15;2;13;.867;3600000;0
18985;143879;567;0;0;0;0;.00nan;0;0
18987;13041;580;72;48;6;42;.875;3530000;0
18987;13065;580;0;0;0;0;.00nan;0;0
18987;40088;1928;0;0;0;0;.00nan;0;0
18987;155769;1928;32;17;4;13;.765;3600000;0
18989;4504;586;0;0;0;0;.00nan;0;0
18989;11438;2557;78;17;0;17;1.000;1203000;0
18989;13033;586;61;14;1;13;.929;3600000;0
18989;32255;2557;36;30;5;25;.833;2397000;0
18991;7063;2287;100;29;0;29;1.000;3600000;0
18991;14459;2287;0;0;0;0;.00nan;0;0
18991;40088;1928;31;23;5;18;.783;3600000;0
18991;155769;1928;0;0;0;0;.00nan;0;0
18993;6202;1927;0;0;0;0;.00nan;0;0
18993;34168;563;0;0;0;0;.00nan;0;0
18993;73939;563;58;26;3;23;.885;3600000;0
18993;153618;1927;43;34;6;28;.824;3600000;0
18995;7412;585;60;24;3;21;.875;3750000;0
18995;19473;2277;0;0;0;0;.00nan;0;0
18995;19954;2277;52;28;4;24;.857;3750000;0
18995;35052;585;0;0;0;0;.00nan;0;0
18997;174736;1918;0;0;0;0;.00nan;0;0
18997;190423;1918;76;28;1;27;.964;3630000;0
18997;185220;583;0;0;0;0;.00nan;0;0
18997;-1;583;86;36;2;34;.944;3630000;0
18999;13041;580;0;0;0;0;.00nan;0;0
18999;13065;580;75;35;2;33;.943;3600000;0
18999;61999;1922;33;16;4;12;.750;3600000;0
18999;67625;1922;0;0;0;0;.00nan;0;0
19001;7063;2287;63;25;2;23;.920;3600000;0
19001;13041;580;70;20;1;19;.950;3150000;0
19001;13065;580;21;3;3;0;.000;403000;0
19001;14459;2287;0;0;0;0;.00nan;0;0
19003;11438;2557;76;42;3;39;.929;3580000;0
19003;32255;2557;0;0;0;0;.00nan;0;0
19003;34168;563;0;0;0;0;.00nan;0;0
19003;73939;563;71;25;2;23;.920;3600000;0
19005;6202;1927;0;0;0;0;.00nan;0;0
19005;185220;583;73;22;1;21;.955;3900000;0
19005;-1;583;0;0;0;0;.00nan;0;0
19005;153618;1927;85;33;1;32;.970;3900000;0
19007;19473;2277;61;23;2;21;.913;3600000;0
19007;19954;2277;0;0;0;0;.00nan;0;0
19007;174736;1918;0;0;0;0;.00nan;0;0
19007;190423;1918;58;26;3;23;.885;3548000;0
19009;4504;586;0;0;0;0;.00nan;0;0
19009;13033;586;47;32;6;26;.813;3900000;0
19009;61999;1922;31;28;6;22;.786;2342000;0
19009;67625;1922;53;5;0;5;1.000;1558000;0
19011;170037;567;15;21;6;15;.714;3556000;0
19011;40088;1928;53;39;5;34;.872;3600000;0
19011;143879;567;0;0;0;0;.00nan;0;0
19011;155769;1928;0;0;0;0;.00nan;0;0
19013;4504;586;54;30;5;25;.833;3600000;0
19013;13033;586;0;0;0;0;.00nan;0;0
19013;40088;1928;0;0;0;0;.00nan;0;0
19013;155769;1928;88;27;1;26;.963;3600000;0
19015;7412;585;0;0;0;0;.00nan;0;0
19015;174736;1918;69;25;2;23;.920;3589000;0
19015;190423;1918;0;0;0;0;.00nan;0;0
19015;35052;585;100;29;0;29;1.000;3600000;0
19017;6202;1927;43;36;6;30;.833;3900000;0
19017;19473;2277;55;2;0;2;1.000;897000;0
19017;19954;2277;30;26;6;20;.769;3003000;0
19017;153618;1927;0;0;0;0;.00nan;0;0
19019;7063;2287;0;0;0;0;.00nan;0;0
19019;14459;2287;66;23;2;21;.913;3600000;0
19019;185220;583;0;0;0;0;.00nan;0;0
19019;-1;583;66;30;3;27;.900;3582000;0
19021;34168;563;0;0;0;0;.00nan;0;0
19021;61999;1922;0;0;0;0;.00nan;0;0
19021;67625;1922;94;36;1;35;.972;3900000;0
19021;73939;563;85;27;1;26;.963;3900000;0
19023;11438;2557;0;0;0;0;.00nan;0;0
19023;170037;567;0;0;0;0;.00nan;0;0
19023;32255;2557;93;45;3;42;.933;3804000;0
19023;143879;567;62;19;2;17;.895;3804000;0
19025;7063;2287;69;39;3;36;.923;3708000;0
19025;13041;580;64;20;2;18;.900;3708000;0
19025;13065;580;0;0;0;0;.00nan;0;0
19025;14459;2287;0;0;0;0;.00nan;0;0
19027;4504;586;0;0;0;0;.00nan;0;0
19027;13033;586;100;31;0;31;1.000;3600000;0
19027;170037;567;71;29;2;27;.931;3548000;0
19027;143879;567;0;0;0;0;.00nan;0;0
19029;174736;1918;0;0;0;0;.00nan;0;0
19029;190423;1918;96;44;2;42;.955;3900000;0
19029;40088;1928;65;21;2;19;.905;3900000;0
19029;155769;1928;0;0;0;0;.00nan;0;0
19031;11438;2557;62;35;5;30;.857;3600000;0
19031;32255;2557;0;0;0;0;.00nan;0;0
19031;61999;1922;54;18;2;16;.889;3600000;0
19031;67625;1922;0;0;0;0;.00nan;0;0
19033;6202;1927;0;0;0;0;.00nan;0;0
19033;19473;2277;77;29;1;28;.966;3900000;0
19033;19954;2277;0;0;0;0;.00nan;0;0
19033;153618;1927;92;34;1;33;.971;3894000;0
19035;34168;563;0;0;0;0;.00nan;0;0
19035;185220;583;66;23;2;21;.913;3600000;0
19035;-1;583;0;0;0;0;.00nan;0;0
19035;73939;563;50;24;3;21;.875;3600000;0
755;13041;580;49;33;5;28;.848;3600000;0
755;13065;580;0;0;0;0;.00nan;0;0
755;174736;1918;83;30;3;27;.900;3600000;0
755;190423;1918;0;0;0;0;.00nan;0;0
756;19473;2277;0;0;0;0;.00nan;0;0
756;185220;583;67;26;2;24;.923;3600000;0
756;-1;583;0;0;0;0;.00nan;0;0
756;67614;2277;76;28;3;25;.893;3600000;0
757;13041;580;42;23;4;19;.826;3535000;0
757;13065;580;0;0;0;0;.00nan;0;0
757;174736;1918;69;27;2;25;.926;3600000;0
757;190423;1918;0;0;0;0;.00nan;0;0
758;19473;2277;0;0;0;0;.00nan;0;0
758;185220;583;85;27;1;26;.963;3600000;0
758;-1;583;0;0;0;0;.00nan;0;0
758;67614;2277;64;32;3;29;.906;3532000;0
933;4504;586;0;0;0;0;.00nan;0;0
933;13033;586;61;26;3;23;.885;3600000;0
933;185220;583;44;21;4;17;.810;3568000;0
933;-1;583;0;0;0;0;.00nan;0;0
934;7063;2287;0;0;0;0;.00nan;0;0
934;14459;2287;51;41;6;35;.854;3600000;0
934;61999;1922;0;0;0;0;.00nan;0;0
934;67625;1922;85;34;2;32;.941;3600000;0
935;170037;567;98;33;1;32;.970;3600000;0
935;34168;563;0;0;0;0;.00nan;0;0
935;73939;563;57;35;4;31;.886;3600000;0
935;143879;567;0;0;0;0;.00nan;0;0
936;174736;1918;76;41;4;37;.902;3600000;0
936;190423;1918;0;0;0;0;.00nan;0;0
936;40088;1928;68;23;2;21;.913;3600000;0
936;155769;1928;0;0;0;0;.00nan;0;0
937;4504;586;0;0;0;0;.00nan;0;0
937;13033;586;47;27;5;22;.815;3600000;0
937;185220;583;25;24;6;18;.750;1956000;0
937;-1;583;56;10;1;9;.900;1560000;0
938;7063;2287;79;28;2;26;.929;3727000;0
938;14459;2287;0;0;0;0;.00nan;0;0
938;61999;1922;0;0;0;0;.00nan;0;0
938;67625;1922;85;31;1;30;.968;3727000;0
939;170037;567;56;29;4;25;.862;3908000;0
939;34168;563;0;0;0;0;.00nan;0;0
939;73939;563;67;30;3;27;.900;3908000;0
939;143879;567;0;0;0;0;.00nan;0;0
940;174736;1918;68;29;3;26;.897;3581000;0
940;190423;1918;0;0;0;0;.00nan;0;0
940;40088;1928;72;24;2;22;.917;3600000;0
940;155769;1928;0;0;0;0;.00nan;0;0
941;4504;586;0;0;0;0;.00nan;0;0
941;13033;586;66;27;3;24;.889;3600000;0
941;185220;583;79;49;4;45;.918;3570000;0
941;-1;583;0;0;0;0;.00nan;0;0
942;7063;2287;91;35;2;33;.943;3600000;0
942;14459;2287;0;0;0;0;.00nan;0;0
942;61999;1922;0;0;0;0;.00nan;0;0
942;67625;1922;50;26;3;23;.885;3543000;0
943;170037;567;55;36;5;31;.861;3646000;0
943;34168;563;0;0;0;0;.00nan;0;0
943;73939;563;36;21;4;17;.810;3646000;0
943;143879;567;0;0;0;0;.00nan;0;0
944;174736;1918;52;22;3;19;.864;3546000;0
944;190423;1918;0;0;0;0;.00nan;0;0
944;40088;1928;73;30;2;28;.933;3600000;0
944;155769;1928;0;0;0;0;.00nan;0;0
1197;7063;2287;46;37;6;31;.838;3283000;0
1197;14459;2287;42;3;1;2;.667;317000;0
1197;61999;1922;0;0;0;0;.00nan;0;0
1197;67625;1922;69;29;2;27;.931;3600000;0
1198;170037;567;87;37;2;35;.946;3600000;0
1198;34168;563;0;0;0;0;.00nan;0;0
1198;73939;563;76;40;3;37;.925;3580000;0
1198;143879;567;0;0;0;0;.00nan;0;0
1251;170037;567;69;36;5;31;.861;3600000;0
1251;34168;563;81;21;0;21;1.000;2576000;0
1251;73939;563;24;10;4;6;.600;1024000;0
1251;143879;567;0;0;0;0;.00nan;0;0
1290;4504;586;0;0;0;0;.00nan;0;0
1290;13033;586;98;24;0;24;1.000;3600000;0
1290;61999;1922;0;0;0;0;.00nan;0;0
1290;67625;1922;86;41;3;38;.927;3600000;0
1291;34168;563;0;0;0;0;.00nan;0;0
1291;40088;1928;62;28;3;25;.893;4358000;0
1291;73939;563;88;37;2;35;.946;4358000;0
1291;155769;1928;0;0;0;0;.00nan;0;0
1292;4504;586;0;0;0;0;.00nan;0;0
1292;13033;586;58;24;3;21;.875;3531000;0
1292;61999;1922;0;0;0;0;.00nan;0;0
1292;67625;1922;84;38;2;36;.947;3600000;0
1293;34168;563;0;0;0;0;.00nan;0;0
1293;40088;1928;90;27;0;27;1.000;4906000;0
1293;73939;563;80;34;1;33;.971;4906000;0
1293;155769;1928;0;0;0;0;.00nan;0;0
1294;4504;586;0;0;0;0;.00nan;0;0
1294;13033;586;84;23;1;22;.957;3600000;0
1294;61999;1922;0;0;0;0;.00nan;0;0
1294;67625;1922;65;25;2;23;.920;3548000;0
1295;34168;563;0;0;0;0;.00nan;0;0
1295;40088;1928;100;26;0;26;1.000;3600000;0
1295;73939;563;70;24;2;22;.917;3559000;0
1295;155769;1928;0;0;0;0;.00nan;0;0
1528;4504;586;0;0;0;0;.00nan;0;0
1528;13033;586;75;24;1;23;.958;3600000;0
1528;61999;1922;0;0;0;0;.00nan;0;0
1528;67625;1922;73;37;3;34;.919;3557000;0
1529;34168;563;0;0;0;0;.00nan;0;0
1529;40088;1928;81;28;1;27;.964;3600000;0
1529;73939;563;66;22;2;20;.909;3587000;0
1529;155769;1928;0;0;0;0;.00nan;0;0
1587;34168;563;0;0;0;0;.00nan;0;0
1587;61999;1922;0;0;0;0;.00nan;0;0
1587;67625;1922;75;22;1;21;.955;3600000;0
1587;73939;563;94;38;2;36;.947;3552000;0
1588;4504;586;0;0;0;0;.00nan;0;0
1588;13033;586;100;29;0;29;1.000;3600000;0
1588;40088;1928;73;32;2;30;.938;3573000;0
1588;155769;1928;0;0;0;0;.00nan;0;0
1589;4504;586;0;0;0;0;.00nan;0;0
1589;13033;586;57;19;3;16;.842;3600000;0
1589;40088;1928;44;33;5;28;.848;3531000;0
1589;155769;1928;0;0;0;0;.00nan;0;0
1590;4504;586;0;0;0;0;.00nan;0;0
1590;13033;586;50;30;4;26;.867;3600000;0
1590;40088;1928;100;30;1;29;.967;3600000;0
1590;155769;1928;0;0;0;0;.00nan;0;0
1591;4504;586;0;0;0;0;.00nan;0;0
1591;13033;586;16;23;6;17;.739;3600000;0
1591;40088;1928;46;26;5;21;.808;3600000;0
1591;155769;1928;0;0;0;0;.00nan;0;0
1771;4504;586;0;0;0;0;.00nan;0;0
1771;13033;586;100;28;0;28;1.000;3600000;0
1771;40088;1928;78;41;4;37;.902;3600000;0
1771;155769;1928;0;0;0;0;.00nan;0;0
1797;4504;586;0;0;0;0;.00nan;0;0
1797;13033;586;77;22;1;21;.955;3600000;0
1797;40088;1928;68;28;3;25;.893;3587000;0
1797;155769;1928;0;0;0;0;.00nan;0;0
19036;180053;1836;0;0;0;0;.00nan;0;0
19036;190508;4538;0;0;0;0;.00nan;0;0
19036;-1;1836;98;25;0;25;1.000;3600000;0
19036;145038;4538;13;37;8;29;.784;3600000;0
19037;177519;638;71;14;0;14;1.000;3600000;0
19037;182872;635;0;0;0;0;.00nan;0;0
19037;-1;635;70;34;3;31;.912;3600000;0
19037;58112;638;0;0;0;0;.00nan;0;0
19038;26308;1825;75;45;4;41;.911;3600000;0
19038;174806;1825;0;0;0;0;.00nan;0;0
19038;64116;626;0;0;0;0;.00nan;0;0
19038;156632;626;72;27;1;26;.963;3600000;0
19039;172398;633;0;0;0;0;.00nan;0;0
19039;-1;633;48;27;4;23;.852;3600000;0
19039;-1;1809;51;2;0;2;1.000;538000;0
19039;51328;1809;53;39;6;33;.846;2986000;0
19040;11107;649;0;0;0;0;.00nan;0;0
19040;200985;646;89;37;1;36;.973;3600000;0
19040;180731;649;59;18;2;16;.889;3549000;0
19040;-1;646;0;0;0;0;.00nan;0;0
19041;8426;629;99;25;0;25;1.000;3600000;0
19041;164404;1838;34;30;6;24;.800;2654000;0
19041;174017;1838;68;14;0;14;1.000;946000;0
19041;-1;629;0;0;0;0;.00nan;0;0
19042;1838;644;82;22;1;21;.955;3600000;0
19042;-1;648;23;26;6;20;.769;2165000;0
19042;-1;648;59;11;1;10;.909;1435000;0
19042;61683;644;0;0;0;0;.00nan;0;0
19043;182872;635;62;28;3;25;.893;1336000;0
19043;164404;1838;0;0;0;0;.00nan;0;0
19043;174017;1838;67;17;1;16;.941;3600000;0
19043;-1;635;47;35;6;29;.829;2264000;0
19044;11107;649;0;0;0;0;.00nan;0;0
19044;180053;1836;0;0;0;0;.00nan;0;0
19044;180731;649;66;40;5;35;.875;3600000;0
19044;-1;1836;98;25;0;25;1.000;3600000;0
19045;172398;633;0;0;0;0;.00nan;0;0
19045;26308;1825;83;52;5;47;.904;3600000;0
19045;174806;1825;0;0;0;0;.00nan;0;0
19045;-1;633;54;20;2;18;.900;3600000;0
19046;1838;644;24;14;4;10;.714;1027000;0
19046;190508;4538;0;0;0;0;.00nan;0;0
19046;61683;644;73;25;1;24;.960;2573000;0
19046;145038;4538;83;30;1;29;.967;3600000;0
19047;8426;629;53;34;5;29;.853;3600000;0
19047;-1;648;76;29;2;27;.931;3600000;0
19047;-1;648;0;0;0;0;.00nan;0;0
19047;-1;629;0;0;0;0;.00nan;0;0
19048;200985;646;38;9;2;7;.778;656000;0
19048;-1;646;38;42;6;36;.857;2944000;0
19048;64116;626;0;0;0;0;.00nan;0;0
19048;156632;626;97;17;0;17;1.000;3600000;0
19049;177519;638;69;17;1;16;.941;3600000;0
19049;-1;1809;0;0;0;0;.00nan;0;0
19049;51328;1809;69;42;4;38;.905;3600000;0
19049;58112;638;0;0;0;0;.00nan;0;0
19050;164404;1838;0;0;0;0;.00nan;0;0
19050;174017;1838;55;34;4;30;.882;3536000;0
19050;180053;1836;0;0;0;0;.00nan;0;0
19050;-1;1836;56;16;2;14;.875;3600000;0
19051;182872;635;0;0;0;0;.00nan;0;0
19051;172398;633;0;0;0;0;.00nan;0;0
19051;-1;635;99;49;1;48;.980;3600000;0
19051;-1;633;51;14;2;12;.857;3553000;0
19052;26308;1825;83;46;3;43;.935;3600000;0
19052;174806;1825;0;0;0;0;.00nan;0;0
19052;190508;4538;0;0;0;0;.00nan;0;0
19052;145038;4538;54;19;2;17;.895;3600000;0
19053;-1;1809;49;37;5;32;.865;3942000;0
19053;51328;1809;0;0;0;0;.00nan;0;0
19053;64116;626;0;0;0;0;.00nan;0;0
19053;156632;626;46;20;4;16;.800;3942000;0
19054;200985;646;0;0;0;0;.00nan;0;0
19054;-1;648;92;41;2;39;.951;4586000;0
19054;-1;648;0;0;0;0;.00nan;0;0
19054;-1;646;96;41;1;40;.976;4586000;0
19055;177519;638;48;36;5;31;.861;3600000;0
19055;8426;629;83;39;2;37;.949;3600000;0
19055;-1;629;0;0;0;0;.00nan;0;0
19055;58112;638;0;0;0;0;.00nan;0;0
19056;1838;644;66;27;2;25;.926;3531000;0
19056;11107;649;0;0;0;0;.00nan;0;0
19056;180731;649;95;23;0;23;1.000;3600000;0
19056;61683;644;0;0;0;0;.00nan;0;0
19057;164404;1838;0;0;0;0;.00nan;0;0
19057;174017;1838;42;17;3;14;.824;3600000;0
19057;26308;1825;67;44;5;39;.886;3585000;0
19057;174806;1825;0;0;0;0;.00nan;0;0
19058;8426;629;36;13;3;10;.769;501000;0
19058;11107;649;50;14;3;11;.786;1737000;0
19058;180731;649;13;15;6;9;.600;1863000;0
19058;-1;629;84;30;1;29;.967;3099000;0
19059;1838;644;64;27;3;24;.889;3543000;0
19059;172398;633;0;0;0;0;.00nan;0;0
19059;-1;633;100;46;2;44;.957;3600000;0
19059;61683;644;0;0;0;0;.00nan;0;0
19060;190508;4538;74;39;4;35;.897;3589000;0
19060;-1;1809;0;0;0;0;.00nan;0;0
19060;51328;1809;78;32;3;29;.906;3600000;0
19060;145038;4538;0;0;0;0;.00nan;0;0
19061;-1;648;43;36;6;30;.833;3150000;0
19061;-1;648;43;3;1;2;.667;450000;0
19061;180053;1836;49;1;0;1;1.000;538000;0
19061;-1;1836;10;30;8;22;.733;3037000;0
19062;177519;638;0;0;0;0;.00nan;0;0
19062;200985;646;0;0;0;0;.00nan;0;0
19062;-1;646;72;37;3;34;.919;3877000;0
19062;58112;638;55;27;4;23;.852;3877000;0
19063;182872;635;0;0;0;0;.00nan;0;0
19063;-1;635;73;35;4;31;.886;3569000;0
19063;64116;626;0;0;0;0;.00nan;0;0
19063;156632;626;44;14;3;11;.786;3600000;0
19064;164404;1838;0;0;0;0;.00nan;0;0
19064;11107;649;0;0;0;0;.00nan;0;0
19064;174017;1838;79;40;4;36;.900;3840000;0
19064;180731;649;35;24;5;19;.792;3840000;0
19065;180053;1836;0;0;0;0;.00nan;0;0
19065;-1;1836;90;32;1;31;.969;3600000;0
19065;64116;626;0;0;0;0;.00nan;0;0
19065;156632;626;89;40;2;38;.950;3555000;0
19066;182872;635;0;0;0;0;.00nan;0;0
19066;200985;646;0;0;0;0;.00nan;0;0
19066;-1;635;73;20;1;19;.950;3600000;0
19066;-1;646;83;41;3;38;.927;3525000;0
19067;-1;648;66;28;2;26;.929;4113000;0
19067;26308;1825;60;35;3;32;.914;4113000;0
19067;174806;1825;0;0;0;0;.00nan;0;0
19067;-1;648;0;0;0;0;.00nan;0;0
19068;172398;633;0;0;0;0;.00nan;0;0
19068;8426;629;70;30;2;28;.933;3600000;0
19068;-1;633;42;20;3;17;.850;3565000;0
19068;-1;629;0;0;0;0;.00nan;0;0
19069;1838;644;53;24;3;21;.875;3600000;0
19069;-1;1809;0;0;0;0;.00nan;0;0
19069;51328;1809;65;38;4;34;.895;3567000;0
19069;61683;644;0;0;0;0;.00nan;0;0
19070;177519;638;83;25;1;24;.960;3600000;0
19070;190508;4538;0;0;0;0;.00nan;0;0
19070;58112;638;0;0;0;0;.00nan;0;0
19070;145038;4538;78;44;4;40;.909;3600000;0
19071;11107;649;0;0;0;0;.00nan;0;0
19071;26308;1825;92;56;4;52;.929;4177000;0
19071;174806;1825;0;0;0;0;.00nan;0;0
19071;180731;649;51;27;3;24;.889;4177000;0
19072;180053;1836;0;0;0;0;.00nan;0;0
19072;-1;1836;19;16;5;11;.688;3774000;0
19072;-1;1809;42;42;6;36;.857;3774000;0
19072;51328;1809;0;0;0;0;.00nan;0;0
19073;172398;633;17;26;6;20;.769;2577000;0
19073;164404;1838;70;21;1;20;.952;2462000;0
19073;174017;1838;26;11;4;7;.636;1138000;0
19073;-1;633;58;8;0;8;1.000;1010000;0
19074;182872;635;0;0;0;0;.00nan;0;0
19074;-1;635;98;56;4;52;.929;3587000;0
19074;190508;4538;47;12;2;10;.833;3600000;0
19074;145038;4538;0;0;0;0;.00nan;0;0
19075;1838;644;41;22;4;18;.818;3600000;0
19075;200985;646;57;40;5;35;.875;3564000;0
19075;-1;646;0;0;0;0;.00nan;0;0
19075;61683;644;0;0;0;0;.00nan;0;0
19076;177519;638;99;45;2;43;.956;4423000;0
19076;-1;648;0;0;0;0;.00nan;0;0
19076;-1;648;59;23;3;20;.870;4423000;0
19076;58112;638;0;0;0;0;.00nan;0;0
19077;8426;629;24;25;6;19;.760;3179000;0
19077;-1;629;51;13;2;11;.846;421000;0
19077;64116;626;0;0;0;0;.00nan;0;0
19077;156632;626;55;15;2;13;.867;3600000;0
19078;164404;1838;0;0;0;0;.00nan;0;0
19078;174017;1838;45;19;3;16;.842;3600000;0
19078;-1;648;38;21;4;17;.810;3587000;0
19078;-1;648;0;0;0;0;.00nan;0;0
19079;182872;635;0;0;0;0;.00nan;0;0
19079;-1;635;91;40;2;38;.950;3600000;0
19079;-1;1809;0;0;0;0;.00nan;0;0
19079;51328;1809;63;29;3;26;.897;3549000;0
19080;200985;646;0;0;0;0;.00nan;0;0
19080;26308;1825;81;29;2;27;.931;3600000;0
19080;174806;1825;0;0;0;0;.00nan;0;0
19080;-1;646;33;19;4;15;.789;3572000;0
19081;172398;633;0;0;0;0;.00nan;0;0
19081;190508;4538;0;0;0;0;.00nan;0;0
19081;-1;633;68;28;2;26;.929;3600000;0
19081;145038;4538;57;30;4;26;.867;3600000;0
19082;1838;644;83;35;3;32;.914;3600000;0
19082;8426;629;0;0;0;0;.00nan;0;0
19082;-1;629;100;28;0;28;1.000;3600000;0
19082;61683;644;0;0;0;0;.00nan;0;0
19083;11107;649;0;0;0;0;.00nan;0;0
19083;180731;649;46;34;5;29;.853;3600000;0
19083;64116;626;63;23;2;21;.913;3600000;0
19083;156632;626;0;0;0;0;.00nan;0;0
19084;177519;638;82;39;2;37;.949;3142000;0
19084;180053;1836;0;0;0;0;.00nan;0;0
19084;-1;1836;84;13;0;13;1.000;3600000;0
19084;58112;638;18;7;4;3;.429;458000;0
19085;164404;1838;0;0;0;0;.00nan;0;0
19085;174017;1838;67;33;3;30;.909;3520000;0
19085;64116;626;0;0;0;0;.00nan;0;0
19085;156632;626;79;24;1;23;.958;3600000;0
19086;1838;644;100;32;0;32;1.000;3600000;0
19086;180053;1836;0;0;0;0;.00nan;0;0
19086;-1;1836;87;33;2;31;.939;3542000;0
19086;61683;644;0;0;0;0;.00nan;0;0
19087;182872;635;72;24;1;23;.958;1719000;0
19087;26308;1825;99;44;3;41;.932;3600000;0
19087;-1;635;26;13;4;9;.692;1832000;0
19087;174806;1825;0;0;0;0;.00nan;0;0
19088;172398;633;0;0;0;0;.00nan;0;0
19088;200985;646;0;0;0;0;.00nan;0;0
19088;-1;633;61;15;1;14;.933;3600000;0
19088;-1;646;52;43;6;37;.860;3600000;0
19089;-1;648;71;29;2;27;.931;3600000;0
19089;-1;648;0;0;0;0;.00nan;0;0
19089;190508;4538;0;0;0;0;.00nan;0;0
19089;145038;4538;81;24;1;23;.958;3600000;0
19090;8426;629;0;0;0;0;.00nan;0;0
19090;-1;1809;0;0;0;0;.00nan;0;0
19090;-1;629;100;29;0;29;1.000;3600000;0
19090;51328;1809;82;38;2;36;.947;3514000;0
19091;177519;638;82;39;3;36;.923;3827000;0
19091;11107;649;0;0;0;0;.00nan;0;0
19091;180731;649;57;17;2;15;.882;3827000;0
19091;58112;638;0;0;0;0;.00nan;0;0
19092;11107;649;0;0;0;0;.00nan;0;0
19092;190508;4538;60;6;0;6;1.000;335000;0
19092;180731;649;69;22;2;20;.909;3600000;0
19092;145038;4538;39;43;6;37;.860;3265000;0
19093;8426;629;0;0;0;0;.00nan;0;0
19093;26308;1825;0;0;0;0;.00nan;0;0
19093;174806;1825;85;49;3;46;.939;3565000;0
19093;-1;629;75;28;1;27;.964;3600000;0
19094;164404;1838;0;0;0;0;.00nan;0;0
19094;174017;1838;55;22;3;19;.864;3600000;0
19094;-1;1809;54;4;0;4;1.000;340000;0
19094;51328;1809;40;49;7;42;.857;3260000;0
19095;200985;646;93;50;3;47;.940;3572000;0
19095;180053;1836;0;0;0;0;.00nan;0;0
19095;-1;1836;52;16;2;14;.875;3600000;0
19095;-1;646;0;0;0;0;.00nan;0;0
19096;172398;633;0;0;0;0;.00nan;0;0
19096;-1;648;39;33;5;28;.848;3598000;0
19096;-1;648;0;0;0;0;.00nan;0;0
19096;-1;633;61;29;3;26;.897;3600000;0
19097;177519;638;67;51;6;45;.882;3600000;0
19097;58112;638;0;0;0;0;.00nan;0;0
19097;64116;626;0;0;0;0;.00nan;0;0
19097;156632;626;89;17;0;17;1.000;3600000;0
19098;1838;644;53;19;3;16;.842;3600000;0
19098;182872;635;0;0;0;0;.00nan;0;0
19098;-1;635;51;44;7;37;.841;3600000;0
19098;61683;644;0;0;0;0;.00nan;0;0
19099;26308;1825;38;34;6;28;.824;2928000;0
19099;174806;1825;29;16;4;12;.750;672000;0
19099;64116;626;0;0;0;0;.00nan;0;0
19099;156632;626;51;21;3;18;.857;3600000;0
19100;1838;644;55;15;2;13;.867;3600000;0
19100;164404;1838;0;0;0;0;.00nan;0;0
19100;174017;1838;62;30;3;27;.900;3588000;0
19100;61683;644;0;0;0;0;.00nan;0;0
19101;26308;1825;92;52;3;49;.942;4276000;0
19101;174806;1825;0;0;0;0;.00nan;0;0
19101;180053;1836;0;0;0;0;.00nan;0;0
19101;-1;1836;75;33;2;31;.939;4276000;0
19102;200985;646;78;45;4;41;.911;3600000;0
19102;-1;646;0;0;0;0;.00nan;0;0
19102;-1;1809;83;35;3;32;.914;3600000;0
19102;51328;1809;0;0;0;0;.00nan;0;0
19103;177519;638;87;31;2;29;.935;3600000;0
19103;172398;633;0;0;0;0;.00nan;0;0
19103;-1;633;34;18;4;14;.778;3562000;0
19103;58112;638;0;0;0;0;.00nan;0;0
19104;190508;4538;77;52;5;47;.904;4187000;0
19104;64116;626;0;0;0;0;.00nan;0;0
19104;145038;4538;0;0;0;0;.00nan;0;0
19104;156632;626;66;38;4;34;.895;4188000;0
19105;11107;649;0;0;0;0;.00nan;0;0
19105;-1;648;73;26;2;24;.923;3515000;0
19105;-1;648;0;0;0;0;.00nan;0;0
19105;180731;649;100;26;0;26;1.000;3600000;0
19106;182872;635;0;0;0;0;.00nan;0;0
19106;8426;629;56;31;4;27;.871;3600000;0
19106;-1;635;47;31;5;26;.839;3600000;0
19106;-1;629;0;0;0;0;.00nan;0;0
19107;8426;629;80;41;4;37;.902;3600000;0
19107;180053;1836;0;0;0;0;.00nan;0;0
19107;-1;1836;52;23;3;20;.870;3600000;0
19107;-1;629;0;0;0;0;.00nan;0;0
19108;11107;649;0;0;0;0;.00nan;0;0
19108;180731;649;72;29;2;27;.931;3667000;0
19108;-1;1809;0;0;0;0;.00nan;0;0
19108;51328;1809;84;38;3;35;.921;3667000;0
19109;182872;635;0;0;0;0;.00nan;0;0
19109;-1;648;69;26;2;24;.923;3600000;0
19109;-1;635;78;39;3;36;.923;3578000;0
19109;-1;648;0;0;0;0;.00nan;0;0
19110;200985;646;59;34;5;29;.853;3600000;0
19110;190508;4538;0;0;0;0;.00nan;0;0
19110;-1;646;0;0;0;0;.00nan;0;0
19110;145038;4538;100;33;0;33;1.000;3600000;0
19111;172398;633;0;0;0;0;.00nan;0;0
19111;-1;633;96;37;2;35;.946;3600000;0
19111;64116;626;82;21;1;20;.952;3600000;0
19111;156632;626;0;0;0;0;.00nan;0;0
19112;1838;644;0;0;0;0;.00nan;0;0
19112;26308;1825;70;38;5;33;.868;3588000;0
19112;174806;1825;0;0;0;0;.00nan;0;0
19112;61683;644;50;25;4;21;.840;3600000;0
19113;177519;638;29;23;5;18;.783;2322000;0
19113;164404;1838;0;0;0;0;.00nan;0;0
19113;174017;1838;67;31;2;29;.935;3600000;0
19113;58112;638;53;17;2;15;.882;1278000;0
19114;172398;633;0;0;0;0;.00nan;0;0
19114;180053;1836;0;0;0;0;.00nan;0;0
19114;-1;633;68;38;4;34;.895;3600000;0
19114;-1;1836;43;33;5;28;.848;3548000;0
19115;182872;635;0;0;0;0;.00nan;0;0
19115;11107;649;0;0;0;0;.00nan;0;0
19115;-1;635;91;36;1;35;.972;3600000;0
19115;180731;649;62;18;2;16;.889;3566000;0
19116;177519;638;64;48;6;42;.875;3914000;0
19116;26308;1825;72;57;5;52;.912;3914000;0
19116;174806;1825;0;0;0;0;.00nan;0;0
19116;58112;638;0;0;0;0;.00nan;0;0
19117;-1;648;76;15;0;15;1.000;3600000;0
19117;-1;648;0;0;0;0;.00nan;0;0
19117;-1;1809;41;2;1;1;.500;362000;0
19117;51328;1809;35;39;6;33;.846;3238000;0
19118;8426;629;67;27;2;25;.926;3600000;0
19118;190508;4538;0;0;0;0;.00nan;0;0
19118;-1;629;0;0;0;0;.00nan;0;0
19118;145038;4538;55;35;4;31;.886;3584000;0
19119;164404;1838;0;0;0;0;.00nan;0;0
19119;174017;1838;63;19;2;17;.895;3600000;0
19119;200985;646;0;0;0;0;.00nan;0;0
19119;-1;646;20;38;8;30;.789;3600000;0
19120;1838;644;72;35;3;32;.914;3600000;0
19120;-1;644;0;0;0;0;.00nan;0;0
19120;64116;626;0;0;0;0;.00nan;0;0
19120;156632;626;60;30;4;26;.867;3547000;0
19121;8426;629;65;40;4;36;.900;3600000;0
19121;164404;1838;34;26;5;21;.808;3577000;0
19121;174017;1838;0;0;0;0;.00nan;0;0
19121;-1;629;0;0;0;0;.00nan;0;0
19122;11107;649;0;0;0;0;.00nan;0;0
19122;200985;646;95;38;1;37;.974;3600000;0
19122;180731;649;52;21;3;18;.857;3514000;0
19122;-1;646;0;0;0;0;.00nan;0;0
19123;172398;633;59;26;3;23;.885;3566000;0
19123;-1;633;0;0;0;0;.00nan;0;0
19123;-1;1809;0;0;0;0;.00nan;0;0
19123;51328;1809;90;40;2;38;.950;3600000;0
19124;180053;1836;0;0;0;0;.00nan;0;0
19124;190508;4538;0;0;0;0;.00nan;0;0
19124;-1;1836;100;28;0;28;1.000;3600000;0
19124;145038;4538;72;40;4;36;.900;3600000;0
19125;1838;644;51;24;4;20;.833;3584000;0
19125;-1;644;0;0;0;0;.00nan;0;0
19125;-1;648;68;29;3;26;.897;3600000;0
19125;-1;648;0;0;0;0;.00nan;0;0
19126;177519;638;58;33;4;29;.879;3565000;0
19126;182872;635;0;0;0;0;.00nan;0;0
19126;-1;635;81;39;3;36;.923;3600000;0
19126;58112;638;0;0;0;0;.00nan;0;0
19127;164404;1838;0;0;0;0;.00nan;0;0
19127;174017;1838;83;37;2;35;.946;3694000;0
19127;180053;1836;0;0;0;0;.00nan;0;0
19127;-1;1836;56;26;3;23;.885;3694000;0
19128;1838;644;60;25;3;22;.880;3557000;0
19128;11107;649;0;0;0;0;.00nan;0;0
19128;-1;644;0;0;0;0;.00nan;0;0
19128;180731;649;82;29;2;27;.931;3600000;0
19129;182872;635;73;13;0;13;1.000;976000;0
19129;172398;633;0;0;0;0;.00nan;0;0
19129;-1;635;32;29;6;23;.793;2624000;0
19129;-1;633;95;22;0;22;1.000;3600000;0
19130;26308;1825;76;32;3;29;.906;3600000;0
19130;174806;1825;0;0;0;0;.00nan;0;0
19130;190508;4538;61;20;2;18;.900;3600000;0
19130;145038;4538;0;0;0;0;.00nan;0;0
19131;200985;646;0;0;0;0;.00nan;0;0
19131;-1;648;62;14;1;13;.929;3856000;0
19131;-1;648;0;0;0;0;.00nan;0;0
19131;-1;646;93;35;2;33;.943;3856000;0
19132;-1;1809;0;0;0;0;.00nan;0;0
19132;51328;1809;88;36;1;35;.972;3543000;0
19132;64116;626;0;0;0;0;.00nan;0;0
19132;156632;626;81;12;0;12;1.000;3600000;0
19133;177519;638;86;37;2;35;.946;4671000;0
19133;8426;629;77;43;3;40;.930;4671000;0
19133;-1;629;0;0;0;0;.00nan;0;0
19133;58112;638;0;0;0;0;.00nan;0;0
19134;-1;648;42;39;6;33;.846;3308000;0
19134;-1;648;49;2;0;2;1.000;292000;0
19134;180053;1836;0;0;0;0;.00nan;0;0
19134;-1;1836;77;25;2;23;.920;3600000;0
19135;182872;635;0;0;0;0;.00nan;0;0
19135;-1;635;49;49;6;43;.878;3600000;0
19135;64116;626;0;0;0;0;.00nan;0;0
19135;156632;626;44;19;3;16;.842;3600000;0
19136;164404;1838;0;0;0;0;.00nan;0;0
19136;174017;1838;66;35;4;31;.886;3600000;0
19136;26308;1825;16;21;6;15;.714;2240000;0
19136;174806;1825;56;7;0;7;1.000;1331000;0
19137;190508;4538;0;0;0;0;.00nan;0;0
19137;-1;1809;36;40;6;34;.850;3600000;0
19137;51328;1809;0;0;0;0;.00nan;0;0
19137;145038;4538;64;25;3;22;.880;3600000;0
19138;177519;638;60;19;2;17;.895;3600000;0
19138;200985;646;0;0;0;0;.00nan;0;0
19138;-1;646;82;39;3;36;.923;3555000;0
19138;58112;638;0;0;0;0;.00nan;0;0
19139;8426;629;73;22;1;21;.955;3600000;0
19139;11107;649;0;0;0;0;.00nan;0;0
19139;180731;649;63;32;3;29;.906;3513000;0
19139;-1;629;0;0;0;0;.00nan;0;0
19140;1838;644;0;0;0;0;.00nan;0;0
19140;172398;633;0;0;0;0;.00nan;0;0
19140;-1;644;53;31;4;27;.871;3564000;0
19140;-1;633;82;44;3;41;.932;3600000;0
19141;182872;635;0;0;0;0;.00nan;0;0
19141;-1;635;36;42;7;35;.833;3600000;0
19141;180053;1836;0;0;0;0;.00nan;0;0
19141;-1;1836;39;14;3;11;.786;3600000;0
19142;164404;1838;0;0;0;0;.00nan;0;0
19142;11107;649;64;22;2;20;.909;3600000;0
19142;174017;1838;55;23;3;20;.870;3590000;0
19142;180731;649;0;0;0;0;.00nan;0;0
19143;1838;644;68;26;3;23;.885;3600000;0
19143;-1;644;0;0;0;0;.00nan;0;0
19143;-1;1809;0;0;0;0;.00nan;0;0
19143;51328;1809;87;54;4;50;.926;3575000;0
19144;172398;633;0;0;0;0;.00nan;0;0
19144;8426;629;94;40;2;38;.950;4779000;0
19144;-1;633;80;31;1;30;.968;4779000;0
19144;-1;629;0;0;0;0;.00nan;0;0
19145;177519;638;90;42;3;39;.929;3600000;0
19145;190508;4538;0;0;0;0;.00nan;0;0
19145;58112;638;0;0;0;0;.00nan;0;0
19145;145038;4538;96;28;0;28;1.000;3600000;0
19146;182872;635;0;0;0;0;.00nan;0;0
19146;200985;646;23;9;4;5;.556;841000;0
19146;-1;635;60;29;3;26;.897;3600000;0
19146;-1;646;64;29;3;26;.897;2759000;0
19147;-1;648;0;0;0;0;.00nan;0;0
19147;26308;1825;51;39;6;33;.846;2667000;0
19147;174806;1825;74;13;0;13;1.000;933000;0
19147;-1;648;71;21;1;20;.952;3600000;0
19148;180053;1836;0;0;0;0;.00nan;0;0
19148;-1;1836;49;23;4;19;.826;3600000;0
19148;64116;626;21;18;5;13;.722;2518000;0
19148;156632;626;25;14;4;10;.714;1082000;0
19149;172398;633;0;0;0;0;.00nan;0;0
19149;164404;1838;0;0;0;0;.00nan;0;0
19149;174017;1838;56;42;5;37;.881;3542000;0
19149;-1;633;52;17;3;14;.824;3600000;0
19150;180053;1836;71;26;1;25;.962;3600000;0
19150;-1;1836;0;0;0;0;.00nan;0;0
19150;-1;1809;0;0;0;0;.00nan;0;0
19150;51328;1809;46;36;6;30;.833;3600000;0
19151;182872;635;0;0;0;0;.00nan;0;0
19151;-1;635;66;39;4;35;.897;3600000;0
19151;190508;4538;0;0;0;0;.00nan;0;0
19151;145038;4538;74;34;3;31;.912;3600000;0
19152;11107;649;0;0;0;0;.00nan;0;0
19152;26308;1825;80;49;4;45;.918;3569000;0
19152;174806;1825;0;0;0;0;.00nan;0;0
19152;180731;649;59;20;2;18;.900;3600000;0
19153;8426;629;87;33;1;32;.970;3600000;0
19153;-1;629;0;0;0;0;.00nan;0;0
19153;64116;626;0;0;0;0;.00nan;0;0
19153;156632;626;70;32;3;29;.906;3582000;0
19154;1838;644;84;18;0;18;1.000;3600000;0
19154;200985;646;69;41;4;37;.902;3600000;0
19154;-1;644;0;0;0;0;.00nan;0;0
19154;-1;646;0;0;0;0;.00nan;0;0
19155;177519;638;74;40;3;37;.925;4781000;0
19155;-1;648;55;32;4;28;.875;4781000;0
19155;-1;648;0;0;0;0;.00nan;0;0
19155;58112;638;0;0;0;0;.00nan;0;0
19156;177519;638;68;32;3;29;.906;3526000;0
19156;180053;1836;0;0;0;0;.00nan;0;0
19156;-1;1836;57;16;1;15;.938;3600000;0
19156;58112;638;0;0;0;0;.00nan;0;0
19157;11107;649;0;0;0;0;.00nan;0;0
19157;180731;649;91;39;2;37;.949;3600000;0
19157;64116;626;0;0;0;0;.00nan;0;0
19157;156632;626;62;34;4;30;.882;3564000;0
19158;172398;633;0;0;0;0;.00nan;0;0
19158;190508;4538;91;44;2;42;.955;3578000;0
19158;-1;633;62;18;1;17;.944;3600000;0
19158;145038;4538;0;0;0;0;.00nan;0;0
19159;200985;646;0;0;0;0;.00nan;0;0
19159;26308;1825;48;18;3;15;.833;3600000;0
19159;174806;1825;0;0;0;0;.00nan;0;0
19159;-1;646;44;23;4;19;.826;3600000;0
19160;164404;1838;0;0;0;0;.00nan;0;0
19160;174017;1838;77;23;1;22;.957;3600000;0
19160;-1;648;24;29;6;23;.793;3600000;0
19160;-1;648;0;0;0;0;.00nan;0;0
19161;1838;644;47;12;2;10;.833;3600000;0
19161;8426;629;74;44;4;40;.909;3520000;0
19161;-1;644;0;0;0;0;.00nan;0;0
19161;-1;629;0;0;0;0;.00nan;0;0
19162;164404;1838;0;0;0;0;.00nan;0;0
19162;174017;1838;99;38;1;37;.974;3600000;0
19162;190508;4538;0;0;0;0;.00nan;0;0
19162;145038;4538;52;31;4;27;.871;3600000;0
19163;182872;635;43;55;8;47;.855;3600000;0
19163;-1;635;0;0;0;0;.00nan;0;0
19163;180053;1836;0;0;0;0;.00nan;0;0
19163;-1;1836;58;25;3;22;.880;3600000;0
19164;26308;1825;55;34;4;30;.882;3552000;0
19164;174806;1825;0;0;0;0;.00nan;0;0
19164;-1;1809;0;0;0;0;.00nan;0;0
19164;51328;1809;73;30;2;28;.933;3600000;0
19165;172398;633;0;0;0;0;.00nan;0;0
19165;11107;649;0;0;0;0;.00nan;0;0
19165;180731;649;81;28;2;26;.929;3600000;0
19165;-1;633;92;28;1;27;.964;3600000;0
19166;8426;629;55;33;4;29;.879;3585000;0
19166;200985;646;0;0;0;0;.00nan;0;0
19166;-1;646;79;31;2;29;.935;3600000;0
19166;-1;629;0;0;0;0;.00nan;0;0
19167;-1;648;65;55;6;49;.891;3600000;0
19167;-1;648;0;0;0;0;.00nan;0;0
19167;64116;626;69;30;3;27;.900;3600000;0
19167;156632;626;0;0;0;0;.00nan;0;0
19168;1838;644;61;20;2;18;.900;3600000;0
19168;177519;638;52;46;6;40;.870;3600000;0
19168;-1;644;0;0;0;0;.00nan;0;0
19168;58112;638;0;0;0;0;.00nan;0;0
19169;182872;635;0;0;0;0;.00nan;0;0
19169;-1;635;95;35;1;34;.971;3600000;0
19169;-1;1809;0;0;0;0;.00nan;0;0
19169;51328;1809;46;21;4;17;.810;3600000;0
19170;-1;648;0;0;0;0;.00nan;0;0
19170;26308;1825;70;55;5;50;.909;3600000;0
19170;174806;1825;0;0;0;0;.00nan;0;0
19170;-1;648;58;11;1;10;.909;3600000;0
19171;177519;638;91;49;3;46;.939;3600000;0
19171;11107;649;0;0;0;0;.00nan;0;0
19171;180731;649;22;19;5;14;.737;3521000;0
19171;58112;638;0;0;0;0;.00nan;0;0
19172;182872;635;0;0;0;0;.00nan;0;0
19172;26308;1825;0;0;0;0;.00nan;0;0
19172;-1;635;78;40;4;36;.900;3936000;0
19172;174806;1825;70;38;3;35;.921;3930000;0
19173;8426;629;56;20;2;18;.900;3600000;0
19173;-1;1809;0;0;0;0;.00nan;0;0
19173;-1;629;0;0;0;0;.00nan;0;0
19173;51328;1809;49;31;5;26;.839;3600000;0
19174;172398;633;0;0;0;0;.00nan;0;0
19174;200985;646;55;43;5;38;.884;3600000;0
19174;-1;633;69;37;3;34;.919;3600000;0
19174;-1;646;0;0;0;0;.00nan;0;0
19175;-1;648;80;31;2;29;.935;3600000;0
19175;-1;648;0;0;0;0;.00nan;0;0
19175;190508;4538;0;0;0;0;.00nan;0;0
19175;145038;4538;71;40;4;36;.900;3562000;0
19176;164404;1838;0;0;0;0;.00nan;0;0
19176;174017;1838;86;51;4;47;.922;4175000;0
19176;64116;626;59;28;3;25;.893;4175000;0
19176;156632;626;0;0;0;0;.00nan;0;0
19177;1838;644;66;29;2;27;.931;3541000;0
19177;-1;644;0;0;0;0;.00nan;0;0
19177;180053;1836;0;0;0;0;.00nan;0;0
19177;-1;1836;83;22;1;21;.955;3600000;0
19178;164404;1838;65;20;1;19;.950;3600000;0
19178;174017;1838;0;0;0;0;.00nan;0;0
19178;-1;1809;0;0;0;0;.00nan;0;0
19178;51328;1809;75;40;3;37;.925;3563000;0
19179;200985;646;48;7;1;6;.857;616000;0
19179;180053;1836;0;0;0;0;.00nan;0;0
19179;-1;1836;73;18;1;17;.944;3600000;0
19179;-1;646;20;29;7;22;.759;2984000;0
19180;1838;644;28;13;4;9;.692;3600000;0
19180;182872;635;0;0;0;0;.00nan;0;0
19180;-1;644;0;0;0;0;.00nan;0;0
19180;-1;635;51;41;6;35;.854;3600000;0
19181;172398;633;0;0;0;0;.00nan;0;0
19181;-1;648;25;20;5;15;.750;3568000;0
19181;-1;648;0;0;0;0;.00nan;0;0
19181;-1;633;62;29;3;26;.897;3600000;0
19182;11107;649;0;0;0;0;.00nan;0;0
19182;190508;4538;100;39;2;37;.949;3600000;0
19182;180731;649;50;24;3;21;.875;3568000;0
19182;145038;4538;0;0;0;0;.00nan;0;0
19183;8426;629;80;31;2;29;.935;3600000;0
19183;26308;1825;76;38;3;35;.921;3564000;0
19183;174806;1825;0;0;0;0;.00nan;0;0
19183;-1;629;0;0;0;0;.00nan;0;0
19184;177519;638;99;52;2;50;.962;4242000;0
19184;58112;638;0;0;0;0;.00nan;0;0
19184;64116;626;0;0;0;0;.00nan;0;0
19184;156632;626;59;21;3;18;.857;4242000;0
19185;172398;633;0;0;0;0;.00nan;0;0
19185;11107;649;0;0;0;0;.00nan;0;0
19185;180731;649;52;25;3;22;.880;3600000;0
19185;-1;633;53;37;5;32;.865;3584000;0
19186;26308;1825;65;35;3;32;.914;3567000;0
19186;174806;1825;0;0;0;0;.00nan;0;0
19186;-1;1809;82;30;1;29;.967;3600000;0
19186;51328;1809;0;0;0;0;.00nan;0;0
19187;164404;1838;0;0;0;0;.00nan;0;0
19187;174017;1838;79;24;1;23;.958;3600000;0
19187;190508;4538;0;0;0;0;.00nan;0;0
19187;145038;4538;67;30;3;27;.900;3558000;0
19188;8426;629;54;26;3;23;.885;3547000;0
19188;200985;646;72;26;2;24;.923;3600000;0
19188;-1;646;0;0;0;0;.00nan;0;0
19188;-1;629;0;0;0;0;.00nan;0;0
19189;-1;648;72;35;3;32;.914;3670000;0
19189;-1;648;0;0;0;0;.00nan;0;0
19189;64116;626;35;19;4;15;.789;3670000;0
19189;156632;626;0;0;0;0;.00nan;0;0
19190;1838;644;78;22;1;21;.955;3600000;0
19190;177519;638;98;45;2;43;.956;3584000;0
19190;-1;644;0;0;0;0;.00nan;0;0
19190;58112;638;0;0;0;0;.00nan;0;0
19191;26308;1825;100;43;2;41;.953;3600000;0
19191;174806;1825;0;0;0;0;.00nan;0;0
19191;180053;1836;0;0;0;0;.00nan;0;0
19191;-1;1836;57;24;3;21;.875;3546000;0
19192;11107;649;0;0;0;0;.00nan;0;0
19192;-1;648;100;47;1;46;.979;5205000;0
19192;-1;648;0;0;0;0;.00nan;0;0
19192;180731;649;94;41;2;39;.951;5205000;0
19193;182872;635;0;0;0;0;.00nan;0;0
19193;8426;629;86;30;1;29;.967;3600000;0
19193;-1;635;81;35;2;33;.943;3600000;0
19193;-1;629;0;0;0;0;.00nan;0;0
19194;200985;646;0;0;0;0;.00nan;0;0
19194;-1;646;59;29;3;26;.897;3600000;0
19194;-1;1809;0;0;0;0;.00nan;0;0
19194;51328;1809;100;34;0;34;1.000;3600000;0
19195;190508;4538;0;0;0;0;.00nan;0;0
19195;64116;626;0;0;0;0;.00nan;0;0
19195;145038;4538;79;48;4;44;.917;3600000;0
19195;156632;626;84;25;1;24;.960;3600000;0
19196;1838;644;76;31;3;28;.903;3571000;0
19196;164404;1838;0;0;0;0;.00nan;0;0
19196;174017;1838;71;27;2;25;.926;3600000;0
19196;-1;644;0;0;0;0;.00nan;0;0
19197;177519;638;55;31;4;27;.871;3776000;0
19197;172398;633;0;0;0;0;.00nan;0;0
19197;-1;633;73;40;3;37;.925;3776000;0
19197;58112;638;0;0;0;0;.00nan;0;0
19198;177519;638;94;46;2;44;.957;3600000;0
19198;164404;1838;0;0;0;0;.00nan;0;0
19198;174017;1838;89;17;0;17;1.000;3600000;0
19198;58112;638;0;0;0;0;.00nan;0;0
19199;1838;644;60;21;2;19;.905;3600000;0
19199;-1;644;0;0;0;0;.00nan;0;0
19199;26308;1825;76;50;5;45;.900;3600000;0
19199;174806;1825;0;0;0;0;.00nan;0;0
19200;11107;649;0;0;0;0;.00nan;0;0
19200;180731;649;74;22;2;20;.909;3600000;0
19200;-1;1809;0;0;0;0;.00nan;0;0
19200;51328;1809;42;46;8;38;.826;3600000;0
19201;172398;633;0;0;0;0;.00nan;0;0
19201;-1;633;49;43;6;37;.860;3600000;0
19201;64116;626;0;0;0;0;.00nan;0;0
19201;156632;626;65;29;3;26;.897;3600000;0
19202;200985;646;64;33;3;30;.909;3600000;0
19202;190508;4538;89;19;0;19;1.000;3600000;0
19202;-1;646;0;0;0;0;.00nan;0;0
19202;145038;4538;0;0;0;0;.00nan;0;0
19203;182872;635;0;0;0;0;.00nan;0;0
19203;-1;648;40;20;3;17;.850;3945000;0
19203;-1;635;75;40;4;36;.900;3945000;0
19203;-1;648;0;0;0;0;.00nan;0;0
19204;8426;629;89;40;2;38;.950;3600000;0
19204;180053;1836;0;0;0;0;.00nan;0;0
19204;-1;1836;26;21;5;16;.762;3600000;0
19204;-1;629;0;0;0;0;.00nan;0;0
19205;164404;1838;0;0;0;0;.00nan;0;0
19205;174017;1838;72;17;1;16;.941;3600000;0
19205;200985;646;0;0;0;0;.00nan;0;0
19205;-1;646;46;38;6;32;.842;3600000;0
19206;182872;635;0;0;0;0;.00nan;0;0
19206;11107;649;0;0;0;0;.00nan;0;0
19206;-1;635;74;44;5;39;.886;3600000;0
19206;180731;649;57;26;4;22;.846;3600000;0
19207;172398;633;0;0;0;0;.00nan;0;0
19207;180053;1836;0;0;0;0;.00nan;0;0
19207;-1;633;78;56;4;52;.929;3600000;0
19207;-1;1836;97;22;0;22;1.000;3600000;0
19208;-1;648;59;16;1;15;.938;3600000;0
19208;-1;648;0;0;0;0;.00nan;0;0
19208;-1;1809;0;0;0;0;.00nan;0;0
19208;51328;1809;58;36;4;32;.889;3600000;0
19209;8426;629;61;19;2;17;.895;3600000;0
19209;190508;4538;38;25;5;20;.800;2335000;0
19209;-1;629;0;0;0;0;.00nan;0;0
19209;145038;4538;75;15;0;15;1.000;1265000;0
19210;1838;644;55;25;3;22;.880;3585000;0
19210;-1;644;0;0;0;0;.00nan;0;0
19210;64116;626;0;0;0;0;.00nan;0;0
19210;156632;626;86;31;1;30;.968;3600000;0
19211;177519;638;0;0;0;0;.00nan;0;0
19211;26308;1825;89;43;2;41;.953;3563000;0
19211;174806;1825;0;0;0;0;.00nan;0;0
19211;58112;638;77;28;1;27;.964;3600000;0
19212;11107;649;0;0;0;0;.00nan;0;0
19212;180053;1836;0;0;0;0;.00nan;0;0
19212;180731;649;58;39;5;34;.872;3600000;0
19212;-1;1836;86;24;2;22;.917;3600000;0
19213;182872;635;0;0;0;0;.00nan;0;0
19213;164404;1838;0;0;0;0;.00nan;0;0
19213;174017;1838;88;21;0;21;1.000;3600000;0
19213;-1;635;89;45;2;43;.956;3549000;0
19214;172398;633;0;0;0;0;.00nan;0;0
19214;26308;1825;38;22;4;18;.818;3539000;0
19214;174806;1825;0;0;0;0;.00nan;0;0
19214;-1;633;71;25;2;23;.920;3600000;0
19215;177519;638;79;38;3;35;.921;3600000;0
19215;-1;1809;0;0;0;0;.00nan;0;0
19215;51328;1809;66;36;4;32;.889;3568000;0
19215;58112;638;0;0;0;0;.00nan;0;0
19216;200985;646;94;41;2;39;.951;3872000;0
19216;-1;646;0;0;0;0;.00nan;0;0
19216;64116;626;0;0;0;0;.00nan;0;0
19216;156632;626;73;26;1;25;.962;3872000;0
19217;8426;629;76;30;3;27;.900;3582000;0
19217;-1;648;77;27;1;26;.963;3600000;0
19217;-1;648;0;0;0;0;.00nan;0;0
19217;-1;629;0;0;0;0;.00nan;0;0
19218;1838;644;0;0;0;0;.00nan;0;0
19218;-1;644;76;27;1;26;.963;3600000;0
19218;190508;4538;70;35;3;32;.914;3600000;0
19218;145038;4538;0;0;0;0;.00nan;0;0
19219;182872;635;0;0;0;0;.00nan;0;0
19219;164404;1838;0;0;0;0;.00nan;0;0
19219;174017;1838;76;28;2;26;.929;3600000;0
19219;-1;635;79;47;4;43;.915;3546000;0
19220;11107;649;0;0;0;0;.00nan;0;0
19220;180053;1836;0;0;0;0;.00nan;0;0
19220;180731;649;87;26;1;25;.962;3600000;0
19220;-1;1836;64;24;2;22;.917;3559000;0
19221;172398;633;0;0;0;0;.00nan;0;0
19221;26308;1825;42;28;5;23;.821;3600000;0
19221;174806;1825;0;0;0;0;.00nan;0;0
19221;-1;633;75;23;1;22;.957;3600000;0
19222;1838;644;81;32;1;31;.969;3600000;0
19222;-1;644;0;0;0;0;.00nan;0;0
19222;190508;4538;7;29;8;21;.724;2894000;0
19222;145038;4538;53;10;1;9;.900;706000;0
19223;8426;629;40;32;6;26;.813;3035000;0
19223;-1;648;63;19;2;17;.895;3600000;0
19223;-1;648;0;0;0;0;.00nan;0;0
19223;-1;629;53;4;0;4;1.000;565000;0
19224;200985;646;0;0;0;0;.00nan;0;0
19224;-1;646;70;43;4;39;.907;3561000;0
19224;64116;626;57;21;3;18;.857;3600000;0
19224;156632;626;0;0;0;0;.00nan;0;0
19225;177519;638;78;26;2;24;.923;3600000;0
19225;-1;1809;0;0;0;0;.00nan;0;0
19225;51328;1809;45;27;4;23;.852;3583000;0
19225;58112;638;0;0;0;0;.00nan;0;0
19226;180053;1836;0;0;0;0;.00nan;0;0
19226;190508;4538;61;33;4;29;.879;3553000;0
19226;-1;1836;79;28;2;26;.929;3600000;0
19226;145038;4538;0;0;0;0;.00nan;0;0
19227;177519;638;74;46;3;43;.935;7378000;0
19227;182872;635;0;0;0;0;.00nan;0;0
19227;-1;635;78;64;4;60;.938;7378000;0
19227;58112;638;0;0;0;0;.00nan;0;0
19228;26308;1825;0;0;0;0;.00nan;0;0
19228;174806;1825;93;54;4;50;.926;3600000;0
19228;64116;626;0;0;0;0;.00nan;0;0
19228;156632;626;95;18;0;18;1.000;3600000;0
19229;172398;633;0;0;0;0;.00nan;0;0
19229;-1;633;100;30;0;30;1.000;3600000;0
19229;-1;1809;0;0;0;0;.00nan;0;0
19229;51328;1809;68;32;3;29;.906;3600000;0
19230;11107;649;0;0;0;0;.00nan;0;0
19230;200985;646;23;24;6;18;.750;2283000;0
19230;180731;649;100;25;0;25;1.000;3600000;0
19230;-1;646;63;15;1;14;.933;1317000;0
19231;8426;629;73;29;2;27;.931;3600000;0
19231;164404;1838;0;0;0;0;.00nan;0;0
19231;174017;1838;72;41;5;36;.878;3600000;0
19231;-1;629;0;0;0;0;.00nan;0;0
19232;1838;644;47;25;4;21;.840;3538000;0
19232;-1;644;0;0;0;0;.00nan;0;0
19232;-1;648;99;39;2;37;.949;3600000;0
19232;-1;648;0;0;0;0;.00nan;0;0
19233;164404;1838;0;0;0;0;.00nan;0;0
19233;174017;1838;52;24;3;21;.875;3549000;0
19233;26308;1825;0;0;0;0;.00nan;0;0
19233;174806;1825;85;35;2;33;.943;3600000;0
19234;8426;629;17;8;4;4;.500;312000;0
19234;11107;649;0;0;0;0;.00nan;0;0
19234;180731;649;57;31;4;27;.871;3600000;0
19234;-1;629;58;49;7;42;.857;3288000;0
19235;1838;644;76;30;2;28;.933;3600000;0
19235;172398;633;0;0;0;0;.00nan;0;0
19235;-1;644;0;0;0;0;.00nan;0;0
19235;-1;633;74;44;4;40;.909;3531000;0
19236;190508;4538;42;20;4;16;.800;3600000;0
19236;-1;1809;0;0;0;0;.00nan;0;0
19236;51328;1809;75;32;3;29;.906;3600000;0
19236;145038;4538;0;0;0;0;.00nan;0;0
19237;-1;648;75;43;4;39;.907;3514000;0
19237;-1;648;0;0;0;0;.00nan;0;0
19237;180053;1836;0;0;0;0;.00nan;0;0
19237;-1;1836;64;22;2;20;.909;3600000;0
19238;182872;635;0;0;0;0;.00nan;0;0
19238;-1;635;55;40;6;34;.850;3600000;0
19238;64116;626;0;0;0;0;.00nan;0;0
19238;156632;626;60;30;3;27;.900;3600000;0
19239;177519;638;61;29;3;26;.897;3600000;0
19239;200985;646;0;0;0;0;.00nan;0;0
19239;-1;646;53;31;4;27;.871;3600000;0
19239;58112;638;0;0;0;0;.00nan;0;0
19240;164404;1838;48;4;1;3;.750;603000;0
19240;174017;1838;31;29;6;23;.793;2997000;0
19240;180053;1836;37;15;3;12;.800;3600000;0
19240;-1;1836;0;0;0;0;.00nan;0;0
19241;182872;635;0;0;0;0;.00nan;0;0
19241;172398;633;0;0;0;0;.00nan;0;0
19241;-1;635;68;39;4;35;.897;3589000;0
19241;-1;633;46;16;3;13;.813;3600000;0
19242;26308;1825;0;0;0;0;.00nan;0;0
19242;174806;1825;63;43;5;38;.884;3600000;0
19242;190508;4538;73;26;2;24;.923;3600000;0
19242;145038;4538;0;0;0;0;.00nan;0;0
19243;-1;1809;40;3;1;2;.667;357000;0
19243;51328;1809;41;33;6;27;.818;3243000;0
19243;64116;626;0;0;0;0;.00nan;0;0
19243;156632;626;46;5;1;4;.800;3600000;0
19244;200985;646;40;34;5;29;.853;3600000;0
19244;-1;648;68;20;1;19;.950;3600000;0
19244;-1;648;0;0;0;0;.00nan;0;0
19244;-1;646;0;0;0;0;.00nan;0;0
19245;177519;638;60;33;3;30;.909;4122000;0
19245;8426;629;51;27;4;23;.852;4122000;0
19245;-1;629;0;0;0;0;.00nan;0;0
19245;58112;638;0;0;0;0;.00nan;0;0
19246;1838;644;0;0;0;0;.00nan;0;0
19246;11107;649;0;0;0;0;.00nan;0;0
19246;-1;644;39;26;5;21;.808;3600000;0
19246;180731;649;80;33;2;31;.939;3600000;0
19247;11107;649;0;0;0;0;.00nan;0;0
19247;26308;1825;89;45;3;42;.933;4190000;0
19247;174806;1825;0;0;0;0;.00nan;0;0
19247;180731;649;70;29;2;27;.931;4190000;0
19248;17625;1809;18;19;6;13;.684;1274000;0
19248;180053;1836;0;0;0;0;.00nan;0;0
19248;-1;1836;63;26;3;23;.885;3600000;0
19248;51328;1809;69;24;2;22;.917;2326000;0
19249;172398;633;0;0;0;0;.00nan;0;0
19249;164404;1838;0;0;0;0;.00nan;0;0
19249;174017;1838;76;38;3;35;.921;3600000;0
19249;-1;633;37;19;4;15;.789;3600000;0
19250;182872;635;0;0;0;0;.00nan;0;0
19250;-1;635;74;43;4;39;.907;5277000;0
19250;190508;4538;48;21;3;18;.857;5277000;0
19250;145038;4538;0;0;0;0;.00nan;0;0
19251;1838;644;47;12;2;10;.833;3600000;0
19251;200985;646;0;0;0;0;.00nan;0;0
19251;-1;644;0;0;0;0;.00nan;0;0
19251;-1;646;73;46;5;41;.891;3600000;0
19252;177519;638;78;35;3;32;.914;3577000;0
19252;-1;648;0;0;0;0;.00nan;0;0
19252;-1;648;79;25;1;24;.960;3600000;0
19252;58112;638;0;0;0;0;.00nan;0;0
19253;8426;629;42;30;5;25;.833;3600000;0
19253;-1;629;0;0;0;0;.00nan;0;0
19253;64116;626;100;25;0;25;1.000;3600000;0
19253;156632;626;0;0;0;0;.00nan;0;0
19254;164404;1838;0;0;0;0;.00nan;0;0
19254;11107;649;0;0;0;0;.00nan;0;0
19254;174017;1838;92;39;2;37;.949;3600000;0
19254;180731;649;72;34;3;31;.912;3568000;0
19255;180053;1836;0;0;0;0;.00nan;0;0
19255;-1;1836;65;26;3;23;.885;3600000;0
19255;64116;626;39;44;7;37;.841;3153000;0
19255;156632;626;51;2;0;2;1.000;447000;0
19256;182872;635;71;27;2;25;.926;3561000;0
19256;200985;646;61;13;1;12;.923;3600000;0
19256;-1;635;0;0;0;0;.00nan;0;0
19256;-1;646;0;0;0;0;.00nan;0;0
19257;-1;648;60;29;3;26;.897;3556000;0
19257;26308;1825;0;0;0;0;.00nan;0;0
19257;174806;1825;93;35;1;34;.971;3600000;0
19257;-1;648;0;0;0;0;.00nan;0;0
19258;172398;633;0;0;0;0;.00nan;0;0
19258;8426;629;58;30;4;26;.867;3600000;0
19258;-1;633;63;38;5;33;.868;3547000;0
19258;-1;629;0;0;0;0;.00nan;0;0
19259;1838;644;72;21;1;20;.952;3600000;0
19259;17625;1809;0;0;0;0;.00nan;0;0
19259;-1;644;0;0;0;0;.00nan;0;0
19259;51328;1809;81;47;4;43;.915;3600000;0
19260;177519;638;52;34;4;30;.882;3549000;0
19260;190508;4538;69;31;3;28;.903;3600000;0
19260;58112;638;0;0;0;0;.00nan;0;0
19260;145038;4538;0;0;0;0;.00nan;0;0
19261;11107;649;0;0;0;0;.00nan;0;0
19261;190508;4538;54;44;6;38;.864;2974000;0
19261;180731;649;77;23;2;21;.913;3600000;0
19261;145038;4538;52;8;1;7;.875;626000;0
19262;8426;629;66;19;1;18;.947;3600000;0
19262;26308;1825;0;0;0;0;.00nan;0;0
19262;174806;1825;97;56;2;54;.964;3562000;0
19262;-1;629;0;0;0;0;.00nan;0;0
19263;164404;1838;0;0;0;0;.00nan;0;0
19263;17625;1809;0;0;0;0;.00nan;0;0
19263;174017;1838;82;14;0;14;1.000;3600000;0
19263;51328;1809;70;28;2;26;.929;3575000;0
19264;200985;646;0;0;0;0;.00nan;0;0
19264;180053;1836;0;0;0;0;.00nan;0;0
19264;-1;1836;65;16;1;15;.938;3600000;0
19264;-1;646;97;42;2;40;.952;3590000;0
19265;172398;633;0;0;0;0;.00nan;0;0
19265;-1;648;77;28;1;27;.964;3600000;0
19265;-1;648;0;0;0;0;.00nan;0;0
19265;-1;633;82;33;2;31;.939;3555000;0
19266;177519;638;98;46;3;43;.935;3600000;0
19266;58112;638;0;0;0;0;.00nan;0;0
19266;64116;626;0;0;0;0;.00nan;0;0
19266;156632;626;58;18;2;16;.889;3600000;0
19267;1838;644;0;0;0;0;.00nan;0;0
19267;182872;635;99;80;1;79;.988;6955000;0
19267;-1;644;33;33;5;28;.848;7249000;0
19267;-1;635;25;5;3;2;.400;294000;0
19268;182872;635;0;0;0;0;.00nan;0;0
19268;-1;635;64;55;7;48;.873;3600000;0
19268;180053;1836;0;0;0;0;.00nan;0;0
19268;-1;1836;63;15;1;14;.933;3600000;0
19269;172398;633;56;33;5;28;.848;3186000;0
19269;11107;649;0;0;0;0;.00nan;0;0
19269;180731;649;98;23;0;23;1.000;3600000;0
19269;-1;633;28;9;3;6;.667;414000;0
19270;17625;1809;0;0;0;0;.00nan;0;0
19270;26308;1825;0;0;0;0;.00nan;0;0
19270;174806;1825;91;43;2;41;.953;3619000;0
19270;51328;1809;61;25;3;22;.880;3619000;0
19271;164404;1838;0;0;0;0;.00nan;0;0
19271;174017;1838;91;24;1;23;.958;3600000;0
19271;190508;4538;77;44;5;39;.886;3600000;0
19271;145038;4538;0;0;0;0;.00nan;0;0
19272;8426;629;77;23;1;22;.957;3600000;0
19272;200985;646;0;0;0;0;.00nan;0;0
19272;-1;646;76;41;4;37;.902;3600000;0
19272;-1;629;0;0;0;0;.00nan;0;0
19273;-1;648;86;32;1;31;.969;3600000;0
19273;-1;648;0;0;0;0;.00nan;0;0
19273;64116;626;0;0;0;0;.00nan;0;0
19273;156632;626;53;30;4;26;.867;3600000;0
19274;1838;644;66;16;1;15;.938;3600000;0
19274;177519;638;53;36;5;31;.861;3600000;0
19274;-1;644;0;0;0;0;.00nan;0;0
19274;58112;638;0;0;0;0;.00nan;0;0
19275;164404;1838;87;31;2;29;.935;3600000;0
19275;174017;1838;0;0;0;0;.00nan;0;0
19275;-1;648;62;15;1;14;.933;3600000;0
19275;-1;648;0;0;0;0;.00nan;0;0
19276;182872;635;67;11;0;11;1.000;953000;0
19276;17625;1809;0;0;0;0;.00nan;0;0
19276;-1;635;25;36;7;29;.806;2647000;0
19276;51328;1809;79;22;1;21;.955;3600000;0
19277;200985;646;0;0;0;0;.00nan;0;0
19277;26308;1825;0;0;0;0;.00nan;0;0
19277;174806;1825;59;34;4;30;.882;3572000;0
19277;-1;646;69;27;2;25;.926;3600000;0
19278;172398;633;0;0;0;0;.00nan;0;0
19278;190508;4538;51;44;6;38;.864;3600000;0
19278;-1;633;54;29;3;26;.897;3600000;0
19278;145038;4538;0;0;0;0;.00nan;0;0
19279;1838;644;52;24;4;20;.833;3600000;0
19279;8426;629;52;42;6;36;.857;3006000;0
19279;-1;644;0;0;0;0;.00nan;0;0
19279;-1;629;70;8;0;8;1.000;518000;0
19280;11107;649;0;0;0;0;.00nan;0;0
19280;180731;649;84;36;3;33;.917;3543000;0
19280;64116;626;0;0;0;0;.00nan;0;0
19280;156632;626;78;34;2;32;.941;3600000;0
19281;177519;638;80;28;2;26;.929;3564000;0
19281;180053;1836;0;0;0;0;.00nan;0;0
19281;-1;1836;86;25;1;24;.960;3600000;0
19281;58112;638;0;0;0;0;.00nan;0;0
19282;164404;1838;0;0;0;0;.00nan;0;0
19282;174017;1838;57;34;4;30;.882;3600000;0
19282;64116;626;0;0;0;0;.00nan;0;0
19282;156632;626;53;33;5;28;.848;3582000;0
19283;8426;629;98;47;2;45;.957;3561000;0
19283;180053;1836;0;0;0;0;.00nan;0;0
19283;-1;1836;100;27;0;27;1.000;3600000;0
19283;-1;629;0;0;0;0;.00nan;0;0
19284;11107;649;0;0;0;0;.00nan;0;0
19284;17625;1809;0;0;0;0;.00nan;0;0
19284;180731;649;72;19;1;18;.947;3600000;0
19284;51328;1809;63;40;4;36;.900;3600000;0
19285;182872;635;51;2;0;2;1.000;478000;0
19285;-1;648;66;26;2;24;.923;3600000;0
19285;-1;635;31;28;6;22;.786;3122000;0
19285;-1;648;0;0;0;0;.00nan;0;0
19286;200985;646;0;0;0;0;.00nan;0;0
19286;190508;4538;96;37;1;36;.973;3600000;0
19286;-1;646;59;35;4;31;.886;3600000;0
19286;145038;4538;0;0;0;0;.00nan;0;0
19287;172398;633;61;16;2;14;.875;1273000;0
19287;-1;633;32;29;6;23;.793;2327000;0
19287;64116;626;0;0;0;0;.00nan;0;0
19287;156632;626;83;30;1;29;.967;3600000;0
19288;1838;644;0;0;0;0;.00nan;0;0
19288;-1;644;26;21;5;16;.762;3600000;0
19288;26308;1825;41;20;3;17;.850;510000;0
19288;174806;1825;35;42;7;35;.833;3090000;0
19289;177519;638;92;34;2;32;.941;3600000;0
19289;164404;1838;0;0;0;0;.00nan;0;0
19289;174017;1838;77;34;3;31;.912;3545000;0
19289;58112;638;0;0;0;0;.00nan;0;0
19290;1838;644;100;30;0;30;1.000;3600000;0
19290;164404;1838;0;0;0;0;.00nan;0;0
19290;174017;1838;78;29;1;28;.966;3555000;0
19290;-1;644;0;0;0;0;.00nan;0;0
19291;26308;1825;88;36;1;35;.972;3600000;0
19291;174806;1825;0;0;0;0;.00nan;0;0
19291;180053;1836;0;0;0;0;.00nan;0;0
19291;-1;1836;48;15;2;13;.867;3561000;0
19292;17625;1809;54;24;3;21;.875;3600000;0
19292;200985;646;0;0;0;0;.00nan;0;0
19292;-1;646;30;26;6;20;.769;3600000;0
19292;51328;1809;0;0;0;0;.00nan;0;0
19293;177519;638;64;28;4;24;.857;4125000;0
19293;172398;633;0;0;0;0;.00nan;0;0
19293;-1;633;76;36;3;33;.917;4125000;0
19293;58112;638;0;0;0;0;.00nan;0;0
19294;190508;4538;37;18;4;14;.778;1119000;0
19294;64116;626;0;0;0;0;.00nan;0;0
19294;145038;4538;55;29;3;26;.897;2481000;0
19294;156632;626;57;21;3;18;.857;3600000;0
19295;11107;649;0;0;0;0;.00nan;0;0
19295;-1;648;89;32;1;31;.969;3600000;0
19295;-1;648;0;0;0;0;.00nan;0;0
19295;180731;649;64;28;4;24;.857;3600000;0
19296;182872;635;0;0;0;0;.00nan;0;0
19296;8426;629;83;16;0;16;1.000;3600000;0
19296;-1;635;68;24;2;22;.917;3589000;0
19296;-1;629;0;0;0;0;.00nan;0;0
19297;1838;644;100;47;2;45;.957;3600000;0
19297;-1;644;0;0;0;0;.00nan;0;0
19297;180053;1836;0;0;0;0;.00nan;0;0
19297;-1;1836;49;29;4;25;.862;3600000;0
19298;182872;635;78;34;3;31;.912;3557000;0
19298;26308;1825;0;0;0;0;.00nan;0;0
19298;-1;635;0;0;0;0;.00nan;0;0
19298;174806;1825;50;14;2;12;.857;3600000;0
19299;172398;633;0;0;0;0;.00nan;0;0
19299;200985;646;0;0;0;0;.00nan;0;0
19299;-1;633;35;14;3;11;.786;3543000;0
19299;-1;646;99;42;2;40;.952;3600000;0
19300;-1;648;52;36;5;31;.861;4027000;0
19300;-1;648;0;0;0;0;.00nan;0;0
19300;190508;4538;0;0;0;0;.00nan;0;0
19300;145038;4538;54;25;4;21;.840;4027000;0
19301;8426;629;49;21;3;18;.857;3600000;0
19301;17625;1809;0;0;0;0;.00nan;0;0
19301;-1;629;0;0;0;0;.00nan;0;0
19301;51328;1809;69;45;4;41;.911;3577000;0
19302;177519;638;86;55;5;50;.909;4210000;0
19302;11107;649;0;0;0;0;.00nan;0;0
19302;180731;649;43;25;4;21;.840;4210000;0
19302;58112;638;0;0;0;0;.00nan;0;0
19303;8426;629;73;32;2;30;.938;4127000;0
19303;164404;1838;0;0;0;0;.00nan;0;0
19303;174017;1838;86;37;1;36;.973;4127000;0
19303;-1;629;0;0;0;0;.00nan;0;0
19304;11107;649;0;0;0;0;.00nan;0;0
19304;200985;646;0;0;0;0;.00nan;0;0
19304;180731;649;80;36;2;34;.944;6172000;0
19304;-1;646;93;79;3;76;.962;6206000;0
19305;172398;633;70;26;2;24;.923;3600000;0
19305;17625;1809;0;0;0;0;.00nan;0;0
19305;-1;633;0;0;0;0;.00nan;0;0
19305;51328;1809;53;27;3;24;.889;3600000;0
19306;180053;1836;0;0;0;0;.00nan;0;0
19306;190508;4538;100;44;1;43;.977;3600000;0
19306;-1;1836;54;26;3;23;.885;3529000;0
19306;145038;4538;0;0;0;0;.00nan;0;0
19307;1838;644;9;16;6;10;.625;3299000;0
19307;-1;644;50;1;0;1;1.000;301000;0
19307;-1;648;0;0;0;0;.00nan;0;0
19307;-1;648;78;26;1;25;.962;3600000;0
19308;26308;1825;0;0;0;0;.00nan;0;0
19308;174806;1825;83;33;2;31;.939;3600000;0
19308;64116;626;0;0;0;0;.00nan;0;0
19308;156632;626;63;23;3;20;.870;3546000;0
19309;177519;638;0;0;0;0;.00nan;0;0
19309;182872;635;0;0;0;0;.00nan;0;0
19309;-1;635;65;31;3;28;.903;3600000;0
19309;58112;638;100;28;0;28;1.000;3600000;0
19310;172398;633;0;0;0;0;.00nan;0;0
19310;180053;1836;0;0;0;0;.00nan;0;0
19310;-1;633;55;34;4;30;.882;3535000;0
19310;-1;1836;77;32;2;30;.938;3600000;0
19311;182872;635;0;0;0;0;.00nan;0;0
19311;11107;649;0;0;0;0;.00nan;0;0
19311;-1;635;92;42;1;41;.976;3600000;0
19311;180731;649;79;26;2;24;.923;3598000;0
19312;177519;638;60;15;1;14;.933;1270000;0
19312;26308;1825;100;36;1;35;.972;3600000;0
19312;174806;1825;0;0;0;0;.00nan;0;0
19312;58112;638;13;18;6;12;.667;2330000;0
19313;17625;1809;0;0;0;0;.00nan;0;0
19313;-1;648;79;26;1;25;.962;3600000;0
19313;-1;648;0;0;0;0;.00nan;0;0
19313;51328;1809;43;38;6;32;.842;3600000;0
19314;164404;1838;0;0;0;0;.00nan;0;0
19314;174017;1838;59;17;2;15;.882;3600000;0
19314;200985;646;73;44;4;40;.909;3565000;0
19314;-1;646;0;0;0;0;.00nan;0;0
19315;8426;629;74;27;2;25;.926;3600000;0
19315;190508;4538;81;40;3;37;.925;3580000;0
19315;-1;629;0;0;0;0;.00nan;0;0
19315;145038;4538;0;0;0;0;.00nan;0;0
19316;1838;644;0;0;0;0;.00nan;0;0
19316;-1;644;63;26;2;24;.923;3600000;0
19316;64116;626;0;0;0;0;.00nan;0;0
19316;156632;626;71;20;1;19;.950;3600000;0
19317;-1;648;64;36;4;32;.889;3543000;0
19317;-1;648;0;0;0;0;.00nan;0;0
19317;180053;1836;0;0;0;0;.00nan;0;0
19317;-1;1836;61;25;3;22;.880;3600000;0
19318;182872;635;0;0;0;0;.00nan;0;0
19318;-1;635;62;46;6;40;.870;3600000;0
19318;64116;626;0;0;0;0;.00nan;0;0
19318;156632;626;62;20;2;18;.900;3600000;0
19319;164404;1838;0;0;0;0;.00nan;0;0
19319;174017;1838;100;30;0;30;1.000;3600000;0
19319;26308;1825;0;0;0;0;.00nan;0;0
19319;174806;1825;45;24;4;20;.833;3600000;0
19320;17625;1809;0;0;0;0;.00nan;0;0
19320;190508;4538;0;0;0;0;.00nan;0;0
19320;51328;1809;56;30;3;27;.900;3779000;0
19320;145038;4538;63;35;4;31;.886;3779000;0
19321;177519;638;53;27;4;23;.852;3600000;0
19321;200985;646;0;0;0;0;.00nan;0;0
19321;-1;646;47;35;5;30;.857;3558000;0
19321;58112;638;0;0;0;0;.00nan;0;0
19322;8426;629;37;35;6;29;.829;2974000;0
19322;11107;649;0;0;0;0;.00nan;0;0
19322;180731;649;52;24;4;20;.833;3600000;0
19322;-1;629;59;7;0;7;1.000;543000;0
19323;1838;644;54;28;4;24;.857;3868000;0
19323;172398;633;0;0;0;0;.00nan;0;0
19323;-1;644;0;0;0;0;.00nan;0;0
19323;-1;633;81;44;3;41;.932;3868000;0
19324;164404;1838;0;0;0;0;.00nan;0;0
19324;174017;1838;68;38;5;33;.868;3600000;0
19324;180053;1836;0;0;0;0;.00nan;0;0
19324;-1;1836;64;26;2;24;.923;3600000;0
19325;1838;644;65;25;2;23;.920;3600000;0
19325;11107;649;0;0;0;0;.00nan;0;0
19325;-1;644;0;0;0;0;.00nan;0;0
19325;180731;649;44;25;4;21;.840;3585000;0
19326;182872;635;47;11;2;9;.818;537000;0
19326;172398;633;0;0;0;0;.00nan;0;0
19326;-1;635;47;39;6;33;.846;3063000;0
19326;-1;633;62;25;3;22;.880;3600000;0
19327;26308;1825;0;0;0;0;.00nan;0;0
19327;174806;1825;41;23;5;18;.783;3636000;0
19327;190508;4538;63;30;4;26;.867;3636000;0
19327;145038;4538;0;0;0;0;.00nan;0;0
19328;200985;646;0;0;0;0;.00nan;0;0
19328;-1;648;57;31;4;27;.871;4026000;0
19328;-1;648;0;0;0;0;.00nan;0;0
19328;-1;646;96;38;3;35;.921;4026000;0
19329;17625;1809;77;15;0;15;1.000;1403000;0
19329;51328;1809;15;23;6;17;.739;2197000;0
19329;64116;626;0;0;0;0;.00nan;0;0
19329;156632;626;78;9;0;9;1.000;3600000;0
19330;177519;638;56;26;4;22;.846;3773000;0
19330;8426;629;65;40;5;35;.875;3773000;0
19330;-1;629;0;0;0;0;.00nan;0;0
19330;58112;638;0;0;0;0;.00nan;0;0
19331;164404;1838;0;0;0;0;.00nan;0;0
19331;11107;649;0;0;0;0;.00nan;0;0
19331;174017;1838;85;38;2;36;.947;3544000;0
19331;180731;649;86;31;1;30;.968;3600000;0
19332;1838;644;74;10;0;10;1.000;3600000;0
19332;17625;1809;0;0;0;0;.00nan;0;0
19332;-1;644;0;0;0;0;.00nan;0;0
19332;51328;1809;89;58;4;54;.931;3600000;0
19333;172398;633;54;20;2;18;.900;2711000;0
19333;8426;629;95;35;1;34;.971;3600000;0
19333;-1;633;31;15;4;11;.733;889000;0
19333;-1;629;0;0;0;0;.00nan;0;0
19334;177519;638;48;27;4;23;.852;3514000;0
19334;190508;4538;0;0;0;0;.00nan;0;0
19334;58112;638;0;0;0;0;.00nan;0;0
19334;145038;4538;70;28;2;26;.929;3600000;0
19335;182872;635;0;0;0;0;.00nan;0;0
19335;200985;646;0;0;0;0;.00nan;0;0
19335;-1;635;72;28;3;25;.893;3549000;0
19335;-1;646;73;25;1;24;.960;3600000;0
19336;180053;1836;0;0;0;0;.00nan;0;0
19336;-1;1836;46;33;6;27;.818;3600000;0
19336;64116;626;0;0;0;0;.00nan;0;0
19336;156632;626;85;43;3;40;.930;3600000;0
19337;164404;1838;0;0;0;0;.00nan;0;0
19337;174017;1838;50;34;5;29;.853;3590000;0
19337;190508;4538;57;28;4;24;.857;3600000;0
19337;145038;4538;0;0;0;0;.00nan;0;0
19338;182872;635;86;40;3;37;.925;3561000;0
19338;-1;635;0;0;0;0;.00nan;0;0
19338;180053;1836;0;0;0;0;.00nan;0;0
19338;-1;1836;53;18;2;16;.889;3600000;0
19339;17625;1809;0;0;0;0;.00nan;0;0
19339;26308;1825;0;0;0;0;.00nan;0;0
19339;174806;1825;62;31;3;28;.903;3600000;0
19339;51328;1809;33;29;5;24;.828;3582000;0
19340;172398;633;0;0;0;0;.00nan;0;0
19340;11107;649;0;0;0;0;.00nan;0;0
19340;180731;649;45;18;3;15;.833;3600000;0
19340;-1;633;58;39;5;34;.872;3538000;0
19341;8426;629;48;24;3;21;.875;3515000;0
19341;200985;646;0;0;0;0;.00nan;0;0
19341;-1;646;82;28;1;27;.964;3600000;0
19341;-1;629;0;0;0;0;.00nan;0;0
19342;-1;648;51;25;4;21;.840;2288000;0
19342;-1;648;69;13;0;13;1.000;1312000;0
19342;64116;626;0;0;0;0;.00nan;0;0
19342;156632;626;70;19;1;18;.947;3600000;0
19343;1838;644;79;24;1;23;.958;3600000;0
19343;177519;638;75;38;4;34;.895;3600000;0
19343;-1;644;0;0;0;0;.00nan;0;0
19343;58112;638;0;0;0;0;.00nan;0;0
19344;177519;638;38;34;6;28;.824;2913000;0
19344;180053;1836;56;27;4;23;.852;3600000;0
19344;-1;1836;0;0;0;0;.00nan;0;0
19344;58112;638;45;7;1;6;.857;687000;0
19345;11107;649;46;36;6;30;.833;3600000;0
19345;180731;649;0;0;0;0;.00nan;0;0
19345;64116;626;0;0;0;0;.00nan;0;0
19345;156632;626;72;35;3;32;.914;3600000;0
19346;182872;635;0;0;0;0;.00nan;0;0
19346;17625;1809;88;22;1;21;.955;3600000;0
19346;-1;635;89;35;2;33;.943;3543000;0
19346;51328;1809;0;0;0;0;.00nan;0;0
19347;172398;633;0;0;0;0;.00nan;0;0
19347;190508;4538;0;0;0;0;.00nan;0;0
19347;-1;633;78;30;2;28;.933;3600000;0
19347;145038;4538;75;39;3;36;.923;3563000;0
19348;200985;646;0;0;0;0;.00nan;0;0
19348;26308;1825;65;32;3;29;.906;3600000;0
19348;174806;1825;0;0;0;0;.00nan;0;0
19348;-1;646;77;41;4;37;.902;3578000;0
19349;164404;1838;0;0;0;0;.00nan;0;0
19349;174017;1838;42;29;5;24;.828;3563000;0
19349;-1;648;56;28;3;25;.893;3600000;0
19349;-1;648;0;0;0;0;.00nan;0;0
19350;1838;644;54;22;3;19;.864;3546000;0
19350;8426;629;93;38;2;36;.947;3600000;0
19350;-1;644;0;0;0;0;.00nan;0;0
19350;-1;629;0;0;0;0;.00nan;0;0
19351;164404;1838;0;0;0;0;.00nan;0;0
19351;17625;1809;0;0;0;0;.00nan;0;0
19351;174017;1838;69;23;2;21;.913;3600000;0
19351;51328;1809;55;26;3;23;.885;3582000;0
19352;200985;646;0;0;0;0;.00nan;0;0
19352;180053;1836;0;0;0;0;.00nan;0;0
19352;-1;1836;61;19;2;17;.895;3600000;0
19352;-1;646;83;41;4;37;.902;3600000;0
19353;172398;633;0;0;0;0;.00nan;0;0
19353;-1;648;63;23;2;21;.913;3600000;0
19353;-1;648;0;0;0;0;.00nan;0;0
19353;-1;633;66;34;3;31;.912;3554000;0
19354;11107;649;0;0;0;0;.00nan;0;0
19354;190508;4538;73;31;2;29;.935;3600000;0
19354;180731;649;76;35;3;32;.914;3579000;0
19354;145038;4538;0;0;0;0;.00nan;0;0
19355;8426;629;0;0;0;0;.00nan;0;0
19355;26308;1825;48;40;6;34;.850;3600000;0
19355;174806;1825;0;0;0;0;.00nan;0;0
19355;-1;629;49;16;3;13;.813;3600000;0
19356;177519;638;91;32;1;31;.969;3856000;0
19356;58112;638;0;0;0;0;.00nan;0;0
19356;64116;626;0;0;0;0;.00nan;0;0
19356;156632;626;75;29;2;27;.931;3847000;0
19357;177519;638;100;57;1;56;.982;3600000;0
19357;11107;649;0;0;0;0;.00nan;0;0
19357;180731;649;54;24;4;20;.833;3600000;0
19357;58112;638;0;0;0;0;.00nan;0;0
19358;182872;635;0;0;0;0;.00nan;0;0
19358;26308;1825;90;36;2;34;.944;3600000;0
19358;-1;635;51;20;3;17;.850;3544000;0
19358;174806;1825;0;0;0;0;.00nan;0;0
19359;8426;629;57;28;3;25;.893;3541000;0
19359;17625;1809;0;0;0;0;.00nan;0;0
19359;-1;629;0;0;0;0;.00nan;0;0
19359;51328;1809;96;29;1;28;.966;3600000;0
19360;172398;633;0;0;0;0;.00nan;0;0
19360;200985;646;0;0;0;0;.00nan;0;0
19360;-1;633;32;24;5;19;.792;3600000;0
19360;-1;646;94;34;1;33;.971;3600000;0
19361;-1;648;59;33;4;29;.879;3666000;0
19361;-1;648;0;0;0;0;.00nan;0;0
19361;190508;4538;0;0;0;0;.00nan;0;0
19361;145038;4538;61;25;3;22;.880;3677000;0
19362;164404;1838;0;0;0;0;.00nan;0;0
19362;174017;1838;87;34;2;32;.941;3597000;0
19362;64116;626;0;0;0;0;.00nan;0;0
19362;156632;626;88;27;1;26;.963;3600000;0
19363;1838;644;0;0;0;0;.00nan;0;0
19363;-1;644;71;33;3;30;.909;3600000;0
19363;180053;1836;0;0;0;0;.00nan;0;0
19363;-1;1836;39;37;6;31;.838;3600000;0
19364;1838;644;97;19;0;19;1.000;3600000;0
19364;182872;635;0;0;0;0;.00nan;0;0
19364;-1;644;0;0;0;0;.00nan;0;0
19364;-1;635;58;36;5;31;.861;3600000;0
19365;172398;633;0;0;0;0;.00nan;0;0
19365;164404;1838;0;0;0;0;.00nan;0;0
19365;174017;1838;57;27;3;24;.889;3600000;0
19365;-1;633;38;34;6;28;.824;3600000;0
19366;17625;1809;49;12;2;10;.833;1283000;0
19366;180053;1836;0;0;0;0;.00nan;0;0
19366;-1;1836;62;11;1;10;.909;3600000;0
19366;51328;1809;61;46;5;41;.891;2317000;0
19367;182872;635;0;0;0;0;.00nan;0;0
19367;-1;635;60;30;3;27;.900;3547000;0
19367;190508;4538;99;29;1;28;.966;3600000;0
19367;145038;4538;0;0;0;0;.00nan;0;0
19368;11107;649;0;0;0;0;.00nan;0;0
19368;26308;1825;15;32;8;24;.750;3600000;0
19368;174806;1825;0;0;0;0;.00nan;0;0
19368;180731;649;65;22;2;20;.909;3600000;0
19369;8426;629;27;14;4;10;.714;746000;0
19369;-1;629;43;36;6;30;.833;2854000;0
19369;64116;626;0;0;0;0;.00nan;0;0
19369;156632;626;100;22;0;22;1.000;3600000;0
19370;1838;644;88;17;0;17;1.000;3600000;0
19370;200985;646;0;0;0;0;.00nan;0;0
19370;-1;644;0;0;0;0;.00nan;0;0
19370;-1;646;68;27;2;25;.926;3544000;0
19371;177519;638;82;39;3;36;.923;3600000;0
19371;-1;648;40;19;4;15;.789;3550000;0
19371;-1;648;0;0;0;0;.00nan;0;0
19371;58112;638;0;0;0;0;.00nan;0;0
19372;177519;638;83;41;4;37;.902;3600000;0
19372;164404;1838;0;0;0;0;.00nan;0;0
19372;174017;1838;33;24;5;19;.792;3575000;0
19372;58112;638;0;0;0;0;.00nan;0;0
19373;1838;644;72;20;1;19;.950;3600000;0
19373;-1;644;0;0;0;0;.00nan;0;0
19373;26308;1825;89;54;4;50;.926;3600000;0
19373;174806;1825;0;0;0;0;.00nan;0;0
19374;11107;649;0;0;0;0;.00nan;0;0
19374;17625;1809;87;32;2;30;.938;3567000;0
19374;180731;649;77;21;1;20;.952;3600000;0
19374;51328;1809;0;0;0;0;.00nan;0;0
19375;172398;633;0;0;0;0;.00nan;0;0
19375;-1;633;60;63;8;55;.873;3600000;0
19375;64116;626;0;0;0;0;.00nan;0;0
19375;156632;626;69;28;2;26;.929;3600000;0
19376;200985;646;0;0;0;0;.00nan;0;0
19376;190508;4538;74;26;2;24;.923;3600000;0
19376;-1;646;49;23;4;19;.826;3574000;0
19376;145038;4538;0;0;0;0;.00nan;0;0
19377;182872;635;0;0;0;0;.00nan;0;0
19377;-1;648;46;14;2;12;.857;3600000;0
19377;-1;635;53;38;5;33;.868;3600000;0
19377;-1;648;0;0;0;0;.00nan;0;0
19378;8426;629;24;29;6;23;.793;2248000;0
19378;180053;1836;0;0;0;0;.00nan;0;0
19378;-1;1836;41;31;5;26;.839;3600000;0
19378;-1;629;39;9;2;7;.778;1352000;0
19379;26308;1825;81;49;4;45;.918;3533000;0
19379;174806;1825;0;0;0;0;.00nan;0;0
19379;180053;1836;0;0;0;0;.00nan;0;0
19379;-1;1836;55;18;2;16;.889;3600000;0
19380;11107;649;0;0;0;0;.00nan;0;0
19380;-1;648;57;38;5;33;.868;3581000;0
19380;-1;648;0;0;0;0;.00nan;0;0
19380;180731;649;81;33;3;30;.909;3600000;0
19381;182872;635;0;0;0;0;.00nan;0;0
19381;8426;629;47;31;4;27;.871;3594000;0
19381;-1;635;77;35;3;32;.914;3600000;0
19381;-1;629;0;0;0;0;.00nan;0;0
19382;17625;1809;0;0;0;0;.00nan;0;0
19382;200985;646;0;0;0;0;.00nan;0;0
19382;-1;646;61;35;4;31;.886;3574000;0
19382;51328;1809;54;22;3;19;.864;3600000;0
19383;190508;4538;0;0;0;0;.00nan;0;0
19383;64116;626;0;0;0;0;.00nan;0;0
19383;145038;4538;33;35;6;29;.829;3600000;0
19383;156632;626;100;40;2;38;.950;3600000;0
19384;1838;644;53;29;4;25;.862;3576000;0
19384;164404;1838;0;0;0;0;.00nan;0;0
19384;174017;1838;64;26;3;23;.885;3600000;0
19384;-1;644;0;0;0;0;.00nan;0;0
19385;177519;638;74;36;3;33;.917;3600000;0
19385;172398;633;0;0;0;0;.00nan;0;0
19385;-1;633;52;35;4;31;.886;3600000;0
19385;58112;638;0;0;0;0;.00nan;0;0
19386;11107;649;0;0;0;0;.00nan;0;0
19386;180053;1836;0;0;0;0;.00nan;0;0
19386;180731;649;62;28;3;25;.893;3592000;0
19386;-1;1836;87;27;1;26;.963;3600000;0
19387;182872;635;0;0;0;0;.00nan;0;0
19387;164404;1838;0;0;0;0;.00nan;0;0
19387;174017;1838;94;18;0;18;1.000;3600000;0
19387;-1;635;57;36;5;31;.861;3600000;0
19388;172398;633;0;0;0;0;.00nan;0;0
19388;26308;1825;79;33;2;31;.939;3665000;0
19388;174806;1825;0;0;0;0;.00nan;0;0
19388;-1;633;66;32;3;29;.906;3665000;0
19389;177519;638;49;33;5;28;.848;3879000;0
19389;17625;1809;0;0;0;0;.00nan;0;0
19389;51328;1809;62;38;4;34;.895;3879000;0
19389;58112;638;0;0;0;0;.00nan;0;0
19390;200985;646;56;7;0;7;1.000;476000;0
19390;-1;646;47;35;6;29;.829;3124000;0
19390;64116;626;0;0;0;0;.00nan;0;0
19390;156632;626;91;29;1;28;.966;3600000;0
19391;8426;629;89;35;1;34;.971;3600000;0
19391;-1;648;29;20;5;15;.750;3600000;0
19391;-1;648;0;0;0;0;.00nan;0;0
19391;-1;629;0;0;0;0;.00nan;0;0
19392;1838;644;0;0;0;0;.00nan;0;0
19392;-1;644;24;24;6;18;.750;3520000;0
19392;190508;4538;79;34;4;30;.882;3600000;0
19392;145038;4538;0;0;0;0;.00nan;0;0
19393;164404;1838;0;0;0;0;.00nan;0;0
19393;174017;1838;53;13;2;11;.846;3600000;0
19393;200985;646;0;0;0;0;.00nan;0;0
19393;-1;646;69;43;5;38;.884;3600000;0
19394;182872;635;54;4;0;4;1.000;542000;0
19394;11107;649;0;0;0;0;.00nan;0;0
19394;-1;635;45;44;7;37;.841;3058000;0
19394;180731;649;74;20;1;19;.950;3600000;0
19395;172398;633;55;30;4;26;.867;3545000;0
19395;180053;1836;0;0;0;0;.00nan;0;0
19395;-1;633;0;0;0;0;.00nan;0;0
19395;-1;1836;57;28;3;25;.893;3600000;0
19396;8426;629;64;37;3;34;.919;4371000;0
19396;190508;4538;0;0;0;0;.00nan;0;0
19396;-1;629;0;0;0;0;.00nan;0;0
19396;145038;4538;70;33;2;31;.939;4371000;0
19397;17625;1809;0;0;0;0;.00nan;0;0
19397;-1;648;0;0;0;0;.00nan;0;0
19397;-1;648;67;19;1;18;.947;3600000;0
19397;51328;1809;95;44;2;42;.955;3571000;0
19398;1838;644;100;25;0;25;1.000;3600000;0
19398;-1;644;0;0;0;0;.00nan;0;0
19398;64116;626;81;48;5;43;.896;3600000;0
19398;156632;626;0;0;0;0;.00nan;0;0
19399;177519;638;0;0;0;0;.00nan;0;0
19399;26308;1825;22;25;6;19;.760;2736000;0
19399;174806;1825;50;10;1;9;.900;864000;0
19399;58112;638;54;32;4;28;.875;3600000;0
19401;1838;644;88;29;1;28;.966;3600000;0
19401;8426;629;41;41;6;35;.854;3600000;0
19401;-1;629;0;0;0;0;.00nan;0;0
19401;61683;644;0;0;0;0;.00nan;0;0
19403;-1;648;57;29;4;25;.862;3543000;0
19403;-1;648;0;0;0;0;.00nan;0;0
19403;190508;4538;70;35;3;32;.914;3600000;0
19403;145038;4538;0;0;0;0;.00nan;0;0
19405;180053;1836;0;0;0;0;.00nan;0;0
19405;-1;1836;45;25;4;21;.840;3600000;0
19405;64116;626;0;0;0;0;.00nan;0;0
19405;156632;626;33;25;5;20;.800;3600000;0
19407;172398;633;0;0;0;0;.00nan;0;0
19407;164404;1838;0;0;0;0;.00nan;0;0
19407;174017;1838;89;40;3;37;.925;3533000;0
19407;-1;633;82;27;1;26;.963;3600000;0
19409;177519;638;92;51;2;49;.961;4272000;0
19409;11107;649;0;0;0;0;.00nan;0;0
19409;180731;649;77;30;3;27;.900;4272000;0
19409;58112;638;0;0;0;0;.00nan;0;0
19411;26308;1825;100;32;1;31;.969;3600000;0
19411;174806;1825;0;0;0;0;.00nan;0;0
19411;-1;1809;0;0;0;0;.00nan;0;0
19411;51328;1809;22;27;7;20;.741;3600000;0
19413;182872;635;0;0;0;0;.00nan;0;0
19413;200985;646;52;17;2;15;.882;3914000;0
19413;-1;635;69;34;3;31;.912;3914000;0
19413;-1;646;0;0;0;0;.00nan;0;0
19415;177519;638;24;31;7;24;.774;3600000;0
19415;58112;638;0;0;0;0;.00nan;0;0
19415;64116;626;0;0;0;0;.00nan;0;0
19415;156632;626;85;22;1;21;.955;3600000;0
19417;172398;633;0;0;0;0;.00nan;0;0
19417;11107;649;0;0;0;0;.00nan;0;0
19417;180731;649;100;30;1;29;.967;3600000;0
19417;-1;633;40;26;4;22;.846;3600000;0
19419;8426;629;72;32;4;28;.875;3600000;0
19419;-1;1809;62;8;0;8;1.000;1149000;0
19419;-1;629;0;0;0;0;.00nan;0;0
19419;51328;1809;38;33;6;27;.818;2451000;0
19421;200985;646;0;0;0;0;.00nan;0;0
19421;190508;4538;0;0;0;0;.00nan;0;0
19421;-1;646;100;35;0;35;1.000;3600000;0
19421;145038;4538;69;21;1;20;.952;3573000;0
19423;182872;635;0;0;0;0;.00nan;0;0
19423;164404;1838;0;0;0;0;.00nan;0;0
19423;174017;1838;74;21;1;20;.952;3600000;0
19423;-1;635;59;39;5;34;.872;3600000;0
19425;1838;644;65;31;3;28;.903;3600000;0
19425;26308;1825;85;47;4;43;.915;3586000;0
19425;174806;1825;0;0;0;0;.00nan;0;0
19425;61683;644;0;0;0;0;.00nan;0;0
19427;-1;648;71;56;6;50;.893;3600000;0
19427;-1;648;0;0;0;0;.00nan;0;0
19427;180053;1836;0;0;0;0;.00nan;0;0
19427;-1;1836;65;22;2;20;.909;3600000;0
19429;182872;635;80;33;3;30;.909;3537000;0
19429;172398;633;70;24;1;23;.958;3600000;0
19429;-1;635;0;0;0;0;.00nan;0;0
19429;-1;633;0;0;0;0;.00nan;0;0
19431;200985;646;45;4;1;3;.750;380000;0
19431;-1;648;0;0;0;0;.00nan;0;0
19431;-1;648;48;31;5;26;.839;3600000;0
19431;-1;646;44;35;6;29;.829;3190000;0
19433;8426;629;0;0;0;0;.00nan;0;0
19433;11107;649;65;24;2;22;.917;3600000;0
19433;180731;649;0;0;0;0;.00nan;0;0
19433;-1;629;63;29;3;26;.897;3582000;0
19435;1838;644;0;0;0;0;.00nan;0;0
19435;-1;1809;38;17;4;13;.765;931000;0
19435;51328;1809;87;38;2;36;.947;2655000;0
19435;61683;644;39;17;4;13;.765;3600000;0
19437;180053;1836;87;20;0;20;1.000;3600000;0
19437;190508;4538;87;43;3;40;.930;3600000;0
19437;-1;1836;0;0;0;0;.00nan;0;0
19437;145038;4538;0;0;0;0;.00nan;0;0
19439;177519;638;53;16;2;14;.875;1318000;0
19439;58112;638;53;30;4;26;.867;2282000;0
19439;64116;626;82;11;0;11;1.000;3600000;0
19439;156632;626;0;0;0;0;.00nan;0;0
19441;164404;1838;86;29;1;28;.966;3600000;0
19441;174017;1838;0;0;0;0;.00nan;0;0
19441;26308;1825;0;0;0;0;.00nan;0;0
19441;174806;1825;89;38;2;36;.947;3572000;0
19443;26308;1825;53;38;5;33;.868;3600000;0
19443;174806;1825;0;0;0;0;.00nan;0;0
19443;-1;1809;0;0;0;0;.00nan;0;0
19443;51328;1809;97;42;2;40;.952;3600000;0
19445;8426;629;67;32;2;30;.938;3600000;0
19445;200985;646;0;0;0;0;.00nan;0;0
19445;-1;646;36;35;6;29;.829;3600000;0
19445;-1;629;0;0;0;0;.00nan;0;0
19447;172398;633;0;0;0;0;.00nan;0;0
19447;11107;649;0;0;0;0;.00nan;0;0
19447;180731;649;63;29;3;26;.897;3524000;0
19447;-1;633;91;34;1;33;.971;3600000;0
19449;164404;1838;0;0;0;0;.00nan;0;0
19449;174017;1838;57;22;2;20;.909;3600000;0
19449;190508;4538;0;0;0;0;.00nan;0;0
19449;145038;4538;64;37;3;34;.919;3600000;0
19451;177519;638;63;19;1;18;.947;3600000;0
19451;182872;635;0;0;0;0;.00nan;0;0
19451;-1;635;79;34;2;32;.941;3585000;0
19451;58112;638;0;0;0;0;.00nan;0;0
19453;1838;644;75;46;5;41;.891;3600000;0
19453;61683;644;0;0;0;0;.00nan;0;0
19453;64116;626;0;0;0;0;.00nan;0;0
19453;156632;626;56;18;2;16;.889;3600000;0
19455;-1;648;55;33;5;28;.848;3538000;0
19455;-1;648;0;0;0;0;.00nan;0;0
19455;180053;1836;52;22;3;19;.864;3600000;0
19455;-1;1836;0;0;0;0;.00nan;0;0
19457;200985;646;24;33;7;26;.788;2666000;0
19457;180053;1836;0;0;0;0;.00nan;0;0
19457;-1;1836;70;27;2;25;.926;3600000;0
19457;-1;646;29;10;3;7;.700;934000;0
19459;11107;649;73;25;2;23;.920;3600000;0
19459;26308;1825;0;0;0;0;.00nan;0;0
19459;174806;1825;70;46;5;41;.891;3600000;0
19459;180731;649;0;0;0;0;.00nan;0;0
19461;8426;629;0;0;0;0;.00nan;0;0
19461;190508;4538;79;28;3;25;.893;3588000;0
19461;-1;629;63;26;2;24;.923;3600000;0
19461;145038;4538;0;0;0;0;.00nan;0;0
19463;1838;644;0;0;0;0;.00nan;0;0
19463;61683;644;64;31;4;27;.871;3600000;0
19463;64116;626;100;28;0;28;1.000;3600000;0
19463;156632;626;0;0;0;0;.00nan;0;0
19465;177519;638;0;0;0;0;.00nan;0;0
19465;-1;648;0;0;0;0;.00nan;0;0
19465;-1;648;92;22;0;22;1.000;3600000;0
19465;58112;638;70;30;3;27;.900;3600000;0
19467;182872;635;40;25;4;21;.840;3558000;0
19467;-1;635;0;0;0;0;.00nan;0;0
19467;-1;1809;68;19;2;17;.895;3600000;0
19467;51328;1809;0;0;0;0;.00nan;0;0
19469;172398;633;94;21;0;21;1.000;3600000;0
19469;164404;1838;44;34;5;29;.853;3600000;0
19469;174017;1838;0;0;0;0;.00nan;0;0
19469;-1;633;0;0;0;0;.00nan;0;0
19471;180053;1836;0;0;0;0;.00nan;0;0
19471;-1;1836;58;17;2;15;.882;3600000;0
19471;-1;1809;0;0;0;0;.00nan;0;0
19471;51328;1809;86;57;5;52;.912;3600000;0
19473;177519;638;49;31;5;26;.839;3600000;0
19473;190508;4538;0;0;0;0;.00nan;0;0
19473;58112;638;0;0;0;0;.00nan;0;0
19473;145038;4538;93;18;0;18;1.000;3600000;0
19475;164404;1838;0;0;0;0;.00nan;0;0
19475;11107;649;0;0;0;0;.00nan;0;0
19475;174017;1838;72;26;2;24;.923;3518000;0
19475;180731;649;100;41;0;41;1.000;3600000;0
19477;182872;635;0;0;0;0;.00nan;0;0
19477;8426;629;95;24;0;24;1.000;3600000;0
19477;-1;635;91;36;2;34;.944;3545000;0
19477;-1;629;0;0;0;0;.00nan;0;0
19479;-1;648;82;40;3;37;.925;3600000;0
19479;-1;648;0;0;0;0;.00nan;0;0
19479;64116;626;0;0;0;0;.00nan;0;0
19479;156632;626;51;30;5;25;.833;3588000;0
19481;1838;644;71;26;2;24;.923;3600000;0
19481;172398;633;23;22;6;16;.727;2112000;0
19481;-1;633;70;14;0;14;1.000;1488000;0
19481;61683;644;0;0;0;0;.00nan;0;0
19483;200985;646;0;0;0;0;.00nan;0;0
19483;26308;1825;65;26;2;24;.923;3554000;0
19483;174806;1825;0;0;0;0;.00nan;0;0
19483;-1;646;82;28;1;27;.964;3600000;0
19485;172398;633;0;0;0;0;.00nan;0;0
19485;190508;4538;67;32;3;29;.906;3600000;0
19485;-1;633;71;25;2;23;.920;3600000;0
19485;145038;4538;0;0;0;0;.00nan;0;0
19487;1838;644;0;0;0;0;.00nan;0;0
19487;177519;638;0;0;0;0;.00nan;0;0
19487;58112;638;72;39;4;35;.897;3688000;0
19487;61683;644;50;30;5;25;.833;3688000;0
19489;182872;635;28;15;4;11;.733;1102000;0
19489;11107;649;0;0;0;0;.00nan;0;0
19489;-1;635;79;36;2;34;.944;2498000;0
19489;180731;649;89;21;0;21;1.000;3600000;0
19491;8426;629;81;27;1;26;.963;3600000;0
19491;-1;648;0;0;0;0;.00nan;0;0
19491;-1;648;58;29;4;25;.862;3600000;0
19491;-1;629;0;0;0;0;.00nan;0;0
19493;180053;1836;50;16;3;13;.813;3600000;0
19493;-1;1836;0;0;0;0;.00nan;0;0
19493;-1;1809;83;55;5;50;.909;3600000;0
19493;51328;1809;0;0;0;0;.00nan;0;0
19495;200985;646;59;44;5;39;.886;3579000;0
19495;-1;646;0;0;0;0;.00nan;0;0
19495;64116;626;69;26;3;23;.885;3600000;0
19495;156632;626;0;0;0;0;.00nan;0;0
19497;164404;1838;88;19;0;19;1.000;3600000;0
19497;174017;1838;0;0;0;0;.00nan;0;0
19497;26308;1825;0;0;0;0;.00nan;0;0
19497;174806;1825;62;33;4;29;.879;3600000;0
686;11107;649;0;0;0;0;.00nan;0;0
686;190508;4538;87;34;2;32;.941;3517000;0
686;180731;649;100;31;0;31;1.000;3600000;0
686;145038;4538;0;0;0;0;.00nan;0;0
687;177519;638;69;32;3;29;.906;4039000;0
687;172398;633;0;0;0;0;.00nan;0;0
687;-1;633;56;19;2;17;.895;4039000;0
687;58112;638;0;0;0;0;.00nan;0;0
688;11107;649;0;0;0;0;.00nan;0;0
688;190508;4538;58;43;6;37;.860;3600000;0
688;180731;649;80;30;1;29;.967;3600000;0
688;145038;4538;0;0;0;0;.00nan;0;0
689;177519;638;89;27;1;26;.963;4200000;0
689;172398;633;0;0;0;0;.00nan;0;0
689;-1;633;75;25;1;24;.960;4200000;0
689;58112;638;0;0;0;0;.00nan;0;0
744;177519;638;52;36;5;31;.861;3600000;0
744;172398;633;0;0;0;0;.00nan;0;0
744;-1;633;70;26;2;24;.923;3600000;0
744;58112;638;0;0;0;0;.00nan;0;0
791;172398;633;0;0;0;0;.00nan;0;0
791;180053;1836;0;0;0;0;.00nan;0;0
791;-1;633;84;37;2;35;.946;3600000;0
791;-1;1836;31;25;5;20;.800;3600000;0
792;1838;644;41;27;5;22;.815;3699000;0
792;8426;629;44;33;6;27;.818;3684000;0
792;-1;644;0;0;0;0;.00nan;0;0
792;-1;629;0;0;0;0;.00nan;0;0
793;164404;1838;0;0;0;0;.00nan;0;0
793;174017;1838;41;23;4;19;.826;3520000;0
793;-1;648;72;23;2;21;.913;3600000;0
793;-1;648;0;0;0;0;.00nan;0;0
794;11107;649;0;0;0;0;.00nan;0;0
794;180731;649;82;30;3;27;.900;3600000;0
794;64116;626;0;0;0;0;.00nan;0;0
794;156632;626;44;24;4;20;.833;3551000;0
795;172398;633;0;0;0;0;.00nan;0;0
795;180053;1836;0;0;0;0;.00nan;0;0
795;-1;633;58;38;4;34;.895;3560000;0
795;-1;1836;44;18;3;15;.833;3600000;0
796;1838;644;68;22;2;20;.909;3600000;0
796;8426;629;76;50;5;45;.900;3600000;0
796;-1;644;0;0;0;0;.00nan;0;0
796;-1;629;0;0;0;0;.00nan;0;0
797;164404;1838;0;0;0;0;.00nan;0;0
797;174017;1838;51;17;3;14;.824;3600000;0
797;-1;648;29;13;4;9;.692;934000;0
797;-1;648;79;36;3;33;.917;2666000;0
798;11107;649;0;0;0;0;.00nan;0;0
798;180731;649;82;37;3;34;.919;3600000;0
798;64116;626;0;0;0;0;.00nan;0;0
798;156632;626;79;27;1;26;.963;3600000;0
799;172398;633;0;0;0;0;.00nan;0;0
799;180053;1836;0;0;0;0;.00nan;0;0
799;-1;633;81;40;3;37;.925;3588000;0
799;-1;1836;76;27;1;26;.963;3600000;0
800;1838;644;76;31;2;29;.935;3531000;0
800;8426;629;100;26;0;26;1.000;3600000;0
800;-1;644;0;0;0;0;.00nan;0;0
800;-1;629;0;0;0;0;.00nan;0;0
801;164404;1838;0;0;0;0;.00nan;0;0
801;174017;1838;60;31;4;27;.871;3600000;0
801;-1;648;35;31;6;25;.806;2927000;0
801;-1;648;56;5;0;5;1.000;619000;0
802;11107;649;0;0;0;0;.00nan;0;0
802;180731;649;93;44;3;41;.932;3548000;0
802;64116;626;0;0;0;0;.00nan;0;0
802;156632;626;77;20;1;19;.950;3600000;0
803;172398;633;0;0;0;0;.00nan;0;0
803;180053;1836;0;0;0;0;.00nan;0;0
803;-1;633;23;34;7;27;.794;3600000;0
803;-1;1836;79;26;2;24;.923;3600000;0
804;1838;644;78;26;2;24;.923;3600000;0
804;8426;629;74;26;1;25;.962;3600000;0
804;-1;644;0;0;0;0;.00nan;0;0
804;-1;629;0;0;0;0;.00nan;0;0
805;164404;1838;0;0;0;0;.00nan;0;0
805;174017;1838;77;26;1;25;.962;3600000;0
805;-1;648;86;42;3;39;.929;3531000;0
805;-1;648;0;0;0;0;.00nan;0;0
806;11107;649;0;0;0;0;.00nan;0;0
806;180731;649;65;40;5;35;.875;3549000;0
806;64116;626;0;0;0;0;.00nan;0;0
806;156632;626;58;26;3;23;.885;3600000;0
1141;172398;633;0;0;0;0;.00nan;0;0
1141;180053;1836;0;0;0;0;.00nan;0;0
1141;-1;633;73;23;2;21;.913;3570000;0
1141;-1;1836;78;27;1;26;.963;3600000;0
1142;1838;644;71;22;2;20;.909;4200000;0
1142;8426;629;97;37;2;35;.946;4200000;0
1142;-1;644;0;0;0;0;.00nan;0;0
1142;-1;629;0;0;0;0;.00nan;0;0
1143;164404;1838;0;0;0;0;.00nan;0;0
1143;174017;1838;62;31;4;27;.871;3572000;0
1143;-1;648;61;24;3;21;.875;3600000;0
1143;-1;648;0;0;0;0;.00nan;0;0
1144;11107;649;0;0;0;0;.00nan;0;0
1144;180731;649;97;30;1;29;.967;3600000;0
1144;64116;626;0;0;0;0;.00nan;0;0
1144;156632;626;51;24;4;20;.833;3600000;0
1199;1838;644;49;25;4;21;.840;3579000;0
1199;8426;629;89;44;3;41;.932;3600000;0
1199;-1;644;0;0;0;0;.00nan;0;0
1199;-1;629;0;0;0;0;.00nan;0;0
1200;164404;1838;0;0;0;0;.00nan;0;0
1200;174017;1838;76;25;1;24;.960;3600000;0
1200;-1;648;63;34;4;30;.882;3580000;0
1200;-1;648;0;0;0;0;.00nan;0;0
1201;11107;649;0;0;0;0;.00nan;0;0
1201;180731;649;80;44;4;40;.909;3600000;0
1201;64116;626;53;9;1;8;.889;1576000;0
1201;156632;626;40;24;5;19;.792;1937000;0
1252;11107;649;0;0;0;0;.00nan;0;0
1252;180731;649;50;31;5;26;.839;3600000;0
1252;64116;626;0;0;0;0;.00nan;0;0
1252;156632;626;78;30;2;28;.933;3600000;0
1296;8426;629;76;46;4;42;.913;4200000;0
1296;180053;1836;0;0;0;0;.00nan;0;0
1296;-1;1836;63;29;4;25;.862;4200000;0
1296;-1;629;0;0;0;0;.00nan;0;0
1297;164404;1838;0;0;0;0;.00nan;0;0
1297;174017;1838;68;25;2;23;.920;3580000;0
1297;64116;626;0;0;0;0;.00nan;0;0
1297;156632;626;84;13;0;13;1.000;3600000;0
1298;8426;629;51;36;5;31;.861;3600000;0
1298;180053;1836;0;0;0;0;.00nan;0;0
1298;-1;1836;81;26;1;25;.962;3600000;0
1298;-1;629;0;0;0;0;.00nan;0;0
1299;164404;1838;0;0;0;0;.00nan;0;0
1299;174017;1838;55;35;4;31;.886;3544000;0
1299;64116;626;0;0;0;0;.00nan;0;0
1299;156632;626;55;22;3;19;.864;3600000;0
1300;8426;629;82;40;3;37;.925;3600000;0
1300;180053;1836;0;0;0;0;.00nan;0;0
1300;-1;1836;60;17;2;15;.882;3600000;0
1300;-1;629;0;0;0;0;.00nan;0;0
1301;164404;1838;0;0;0;0;.00nan;0;0
1301;174017;1838;69;37;4;33;.892;3627000;0
1301;64116;626;0;0;0;0;.00nan;0;0
1301;156632;626;53;23;3;20;.870;3627000;0
1302;8426;629;85;39;2;37;.949;3575000;0
1302;180053;1836;0;0;0;0;.00nan;0;0
1302;-1;1836;73;12;0;12;1.000;3600000;0
1302;-1;629;0;0;0;0;.00nan;0;0
1303;164404;1838;0;0;0;0;.00nan;0;0
1303;174017;1838;63;25;3;22;.880;3806000;0
1303;64116;626;0;0;0;0;.00nan;0;0
1303;156632;626;69;27;2;25;.926;3806000;0
1530;180053;1836;0;0;0;0;.00nan;0;0
1530;-1;1836;43;28;4;24;.857;3600000;0
1530;64116;626;0;0;0;0;.00nan;0;0
1530;156632;626;91;33;1;32;.970;3600000;0
1531;180053;1836;0;0;0;0;.00nan;0;0
1531;-1;1836;53;39;5;34;.872;4200000;0
1531;64116;626;0;0;0;0;.00nan;0;0
1531;156632;626;100;56;5;51;.911;4200000;0
1532;180053;1836;0;0;0;0;.00nan;0;0
1532;-1;1836;64;15;1;14;.933;3600000;0
1532;64116;626;0;0;0;0;.00nan;0;0
1532;156632;626;63;32;3;29;.906;3567000;0
1533;180053;1836;0;0;0;0;.00nan;0;0
1533;-1;1836;90;29;1;28;.966;3600000;0
1533;64116;626;0;0;0;0;.00nan;0;0
1533;156632;626;83;39;3;36;.923;3579000;0
1680;180053;1836;0;0;0;0;.00nan;0;0
1680;-1;1836;67;33;3;30;.909;4200000;0
1680;64116;626;0;0;0;0;.00nan;0;0
1680;156632;626;66;25;3;22;.880;4200000;0
1750;180053;1836;0;0;0;0;.00nan;0;0
1750;-1;1836;84;34;2;32;.941;3548000;0
1750;64116;626;0;0;0;0;.00nan;0;0
1750;156632;626;76;25;1;24;.960;3600000;0
1772;180053;1836;0;0;0;0;.00nan;0;0
1772;-1;1836;73;31;3;28;.903;3600000;0
1772;64116;626;0;0;0;0;.00nan;0;0
1772;156632;626;67;24;2;22;.917;3600000;0
19498;5565;843;0;0;0;0;.00nan;0;0
19498;9455;843;100;43;1;42;.977;3600000;0
19498;13373;835;65;24;2;22;.917;3546000;0
19498;86485;835;0;0;0;0;.00nan;0;0
19499;30696;2508;35;5;2;3;.600;846000;0
19499;31439;2488;51;23;3;20;.870;3600000;0
19499;185506;2508;29;27;6;21;.778;2754000;0
19499;147845;2488;0;0;0;0;.00nan;0;0
19500;805;846;76;27;2;25;.926;3600000;0
19500;47742;841;0;0;0;0;.00nan;0;0
19500;47754;841;69;37;4;33;.892;3552000;0
19500;154162;846;0;0;0;0;.00nan;0;0
19501;-1;2517;66;30;4;26;.867;3600000;0
19501;180311;2517;0;0;0;0;.00nan;0;0
19501;47769;844;65;45;5;40;.889;3552000;0
19501;152266;844;0;0;0;0;.00nan;0;0
19502;5573;2493;0;0;0;0;.00nan;0;0
19502;180279;845;71;22;1;21;.955;3600000;0
19502;47982;845;0;0;0;0;.00nan;0;0
19502;48141;2493;35;29;6;23;.793;3600000;0
19503;5565;843;0;0;0;0;.00nan;0;0
19503;9455;843;95;40;2;38;.950;3600000;0
19503;47742;841;0;0;0;0;.00nan;0;0
19503;47754;841;100;26;0;26;1.000;3600000;0
19504;805;846;58;17;2;15;.882;3600000;0
19504;31439;2488;66;39;5;34;.872;3600000;0
19504;147845;2488;0;0;0;0;.00nan;0;0
19504;154162;846;0;0;0;0;.00nan;0;0
19505;5573;2493;0;0;0;0;.00nan;0;0
19505;13373;835;80;20;1;19;.950;3600000;0
19505;48141;2493;63;45;5;40;.889;3600000;0
19505;86485;835;0;0;0;0;.00nan;0;0
19506;-1;2517;0;0;0;0;.00nan;0;0
19506;180279;845;83;28;1;27;.964;3600000;0
19506;180311;2517;56;39;5;34;.872;3600000;0
19506;47982;845;0;0;0;0;.00nan;0;0
19507;30696;2508;64;33;3;30;.909;3577000;0
19507;185506;2508;0;0;0;0;.00nan;0;0
19507;47769;844;0;0;0;0;.00nan;0;0
19507;152266;844;77;24;1;23;.958;3600000;0
19508;31439;2488;0;0;0;0;.00nan;0;0
19508;180279;845;77;24;1;23;.958;3600000;0
19508;47982;845;0;0;0;0;.00nan;0;0
19508;147845;2488;92;46;3;43;.935;3574000;0
19509;47742;841;0;0;0;0;.00nan;0;0
19509;47754;841;59;22;3;19;.864;3600000;0
19509;47769;844;42;18;3;15;.833;2481000;0
19509;152266;844;14;14;5;9;.643;1119000;0
19510;805;846;0;0;0;0;.00nan;0;0
19510;30696;2508;34;23;6;17;.739;1943000;0
19510;185506;2508;58;27;3;24;.889;1657000;0
19510;154162;846;73;21;1;20;.952;3600000;0
19511;5565;843;0;0;0;0;.00nan;0;0
19511;5573;2493;0;0;0;0;.00nan;0;0
19511;9455;843;17;30;8;22;.733;3600000;0
19511;48141;2493;81;32;2;30;.938;3600000;0
19512;13373;835;77;39;3;36;.923;3748000;0
19512;-1;2517;0;0;0;0;.00nan;0;0
19512;180311;2517;57;26;4;22;.846;3748000;0
19512;86485;835;0;0;0;0;.00nan;0;0
19513;13373;835;89;42;2;40;.952;3591000;0
19513;47742;841;0;0;0;0;.00nan;0;0
19513;47754;841;91;31;1;30;.968;3600000;0
19513;86485;835;0;0;0;0;.00nan;0;0
19514;-1;2517;0;0;0;0;.00nan;0;0
19514;31439;2488;64;31;4;27;.871;3600000;0
19514;180311;2517;76;37;3;34;.919;3600000;0
19514;147845;2488;0;0;0;0;.00nan;0;0
19515;5573;2493;0;0;0;0;.00nan;0;0
19515;30696;2508;92;34;1;33;.971;3600000;0
19515;185506;2508;0;0;0;0;.00nan;0;0
19515;48141;2493;65;23;2;21;.913;3546000;0
19516;805;846;59;27;3;24;.889;3600000;0
19516;47769;844;0;0;0;0;.00nan;0;0
19516;152266;844;59;33;4;29;.879;3566000;0
19516;154162;846;0;0;0;0;.00nan;0;0
19517;5565;843;0;0;0;0;.00nan;0;0
19517;9455;843;100;36;1;35;.972;3600000;0
19517;180279;845;65;24;2;22;.917;3600000;0
19517;47982;845;0;0;0;0;.00nan;0;0
19518;13373;835;31;31;6;25;.806;3600000;0
19518;31439;2488;0;0;0;0;.00nan;0;0
19518;86485;835;0;0;0;0;.00nan;0;0
19518;147845;2488;45;23;4;19;.826;3600000;0
19519;5565;843;41;29;5;24;.828;3596000;0
19519;9455;843;0;0;0;0;.00nan;0;0
19519;30696;2508;0;0;0;0;.00nan;0;0
19519;185506;2508;72;34;3;31;.912;3600000;0
19520;-1;2517;0;0;0;0;.00nan;0;0
19520;180311;2517;61;38;4;34;.895;3600000;0
19520;47742;841;0;0;0;0;.00nan;0;0
19520;47754;841;91;46;3;43;.935;3600000;0
19521;5573;2493;0;0;0;0;.00nan;0;0
19521;47769;844;87;33;2;31;.939;3600000;0
19521;48141;2493;49;27;4;23;.852;3554000;0
19521;152266;844;0;0;0;0;.00nan;0;0
19522;805;846;63;35;4;31;.886;3600000;0
19522;180279;845;0;0;0;0;.00nan;0;0
19522;47982;845;83;29;1;28;.966;3600000;0
19522;154162;846;0;0;0;0;.00nan;0;0
19523;31439;2488;49;21;4;17;.810;3600000;0
19523;47769;844;0;0;0;0;.00nan;0;0
19523;147845;2488;0;0;0;0;.00nan;0;0
19523;152266;844;53;33;5;28;.848;3580000;0
19524;805;846;57;17;2;15;.882;3900000;0
19524;13373;835;82;33;2;31;.939;3900000;0
19524;86485;835;0;0;0;0;.00nan;0;0
19524;154162;846;0;0;0;0;.00nan;0;0
19525;5573;2493;64;23;2;21;.913;3545000;0
19525;47742;841;0;0;0;0;.00nan;0;0
19525;47754;841;100;39;1;38;.974;3600000;0
19525;48141;2493;0;0;0;0;.00nan;0;0
19526;5565;843;50;20;2;18;.900;1899000;0
19526;9455;843;23;28;7;21;.750;1701000;0
19526;-1;2517;28;23;5;18;.783;3600000;0
19526;180311;2517;0;0;0;0;.00nan;0;0
19527;805;846;73;25;2;23;.920;3600000;0
19527;5565;843;0;0;0;0;.00nan;0;0
19527;9455;843;76;41;4;37;.902;3549000;0
19527;154162;846;0;0;0;0;.00nan;0;0
19528;13373;835;77;30;3;27;.900;3600000;0
19528;30696;2508;66;41;4;37;.902;3580000;0
19528;185506;2508;0;0;0;0;.00nan;0;0
19528;86485;835;0;0;0;0;.00nan;0;0
19529;31439;2488;0;0;0;0;.00nan;0;0
19529;47742;841;0;0;0;0;.00nan;0;0
19529;47754;841;47;22;3;19;.864;3587000;0
19529;147845;2488;99;35;1;34;.971;3600000;0
19530;5573;2493;0;0;0;0;.00nan;0;0
19530;-1;2517;0;0;0;0;.00nan;0;0
19530;180311;2517;61;22;2;20;.909;3557000;0
19530;48141;2493;97;37;1;36;.973;3600000;0
19531;180279;845;87;27;1;26;.963;3600000;0
19531;47769;844;88;40;2;38;.950;3587000;0
19531;47982;845;0;0;0;0;.00nan;0;0
19531;152266;844;0;0;0;0;.00nan;0;0
19532;5573;2493;0;0;0;0;.00nan;0;0
19532;31439;2488;0;0;0;0;.00nan;0;0
19532;48141;2493;59;30;3;27;.900;3600000;0
19532;147845;2488;52;30;5;25;.833;3541000;0
19533;30696;2508;50;7;1;6;.857;952000;0
19533;185506;2508;33;35;6;29;.829;2648000;0
19533;47742;841;0;0;0;0;.00nan;0;0
19533;47754;841;90;30;2;28;.933;3600000;0
19534;5565;843;0;0;0;0;.00nan;0;0
19534;9455;843;54;35;5;30;.857;3600000;0
19534;47769;844;50;2;0;2;1.000;370000;0
19534;152266;844;25;23;6;17;.739;3230000;0
19535;13373;835;100;36;0;36;1.000;3600000;0
19535;180279;845;38;23;4;19;.826;3600000;0
19535;47982;845;0;0;0;0;.00nan;0;0
19535;86485;835;0;0;0;0;.00nan;0;0
19536;5565;843;0;0;0;0;.00nan;0;0
19536;9455;843;100;26;0;26;1.000;3600000;0
19536;31439;2488;0;0;0;0;.00nan;0;0
19536;147845;2488;50;24;3;21;.875;3600000;0
19537;180279;845;47;16;3;13;.813;3757000;0
19537;47742;841;0;0;0;0;.00nan;0;0
19537;47754;841;83;39;2;37;.949;3757000;0
19537;47982;845;0;0;0;0;.00nan;0;0
19538;805;846;92;18;0;18;1.000;3600000;0
19538;5573;2493;0;0;0;0;.00nan;0;0
19538;48141;2493;84;41;3;38;.927;3600000;0
19538;154162;846;0;0;0;0;.00nan;0;0
19539;-1;2517;0;0;0;0;.00nan;0;0
19539;30696;2508;57;42;6;36;.857;3178000;0
19539;180311;2517;76;24;1;23;.958;3600000;0
19539;185506;2508;56;4;0;4;1.000;422000;0
19540;5565;843;0;0;0;0;.00nan;0;0
19540;9455;843;85;36;2;34;.944;3900000;0
19540;13373;835;70;20;2;18;.900;3900000;0
19540;86485;835;0;0;0;0;.00nan;0;0
19541;805;846;68;34;4;30;.882;3550000;0
19541;47742;841;0;0;0;0;.00nan;0;0
19541;47754;841;66;32;3;29;.906;3600000;0
19541;154162;846;0;0;0;0;.00nan;0;0
19542;5573;2493;0;0;0;0;.00nan;0;0
19542;180279;845;53;27;4;23;.852;3600000;0
19542;47982;845;0;0;0;0;.00nan;0;0
19542;48141;2493;58;39;6;33;.846;3580000;0
19543;-1;2517;70;22;1;21;.955;3600000;0
19543;180311;2517;0;0;0;0;.00nan;0;0
19543;47769;844;63;27;3;24;.889;3599000;0
19543;152266;844;0;0;0;0;.00nan;0;0
19544;30696;2508;0;0;0;0;.00nan;0;0
19544;31439;2488;0;0;0;0;.00nan;0;0
19544;185506;2508;90;31;1;30;.968;3600000;0
19544;147845;2488;70;28;3;25;.893;3557000;0
19545;13373;835;50;21;3;18;.857;3600000;0
19545;47769;844;0;0;0;0;.00nan;0;0
19545;86485;835;0;0;0;0;.00nan;0;0
19545;152266;844;52;31;4;27;.871;3600000;0
19546;805;846;97;21;0;21;1.000;3600000;0
19546;31439;2488;62;40;5;35;.875;3600000;0
19546;147845;2488;0;0;0;0;.00nan;0;0
19546;154162;846;0;0;0;0;.00nan;0;0
19547;5565;843;0;0;0;0;.00nan;0;0
19547;9455;843;51;39;7;32;.821;3600000;0
19547;47742;841;86;20;0;20;1.000;3600000;0
19547;47754;841;0;0;0;0;.00nan;0;0
19548;30696;2508;74;38;3;35;.921;3518000;0
19548;185506;2508;0;0;0;0;.00nan;0;0
19548;47769;844;78;24;1;23;.958;3600000;0
19548;152266;844;0;0;0;0;.00nan;0;0
19549;-1;2517;0;0;0;0;.00nan;0;0
19549;180279;845;0;0;0;0;.00nan;0;0
19549;180311;2517;95;32;1;31;.969;3600000;0
19549;47982;845;40;31;5;26;.839;3600000;0
19550;5573;2493;0;0;0;0;.00nan;0;0
19550;13373;835;84;34;3;31;.912;3900000;0
19550;48141;2493;74;30;3;27;.900;3900000;0
19550;86485;835;0;0;0;0;.00nan;0;0
19551;13373;835;69;39;4;35;.897;3600000;0
19551;-1;2517;0;0;0;0;.00nan;0;0
19551;180311;2517;79;13;0;13;1.000;3600000;0
19551;86485;835;0;0;0;0;.00nan;0;0
19552;805;846;57;13;2;11;.846;3600000;0
19552;30696;2508;79;23;1;22;.957;1745000;0
19552;185506;2508;44;33;5;28;.848;1855000;0
19552;154162;846;0;0;0;0;.00nan;0;0
19553;47742;841;78;32;2;30;.938;3900000;0
19553;47754;841;0;0;0;0;.00nan;0;0
19553;47769;844;0;0;0;0;.00nan;0;0
19553;152266;844;82;38;2;36;.947;3900000;0
19554;31439;2488;0;0;0;0;.00nan;0;0
19554;180279;845;58;23;2;21;.913;3791000;0
19554;47982;845;0;0;0;0;.00nan;0;0
19554;147845;2488;60;29;3;26;.897;3791000;0
19555;13373;835;63;27;3;24;.889;3600000;0
19555;31439;2488;87;20;0;20;1.000;3600000;0
19555;86485;835;0;0;0;0;.00nan;0;0
19555;147845;2488;0;0;0;0;.00nan;0;0
19556;805;846;77;25;1;24;.960;3600000;0
19556;180279;845;70;34;3;31;.912;3524000;0
19556;47982;845;0;0;0;0;.00nan;0;0
19556;154162;846;0;0;0;0;.00nan;0;0
19557;5573;2493;0;0;0;0;.00nan;0;0
19557;47769;844;51;27;3;24;.889;3583000;0
19557;48141;2493;100;32;1;31;.969;3600000;0
19557;152266;844;0;0;0;0;.00nan;0;0
19558;-1;2517;0;0;0;0;.00nan;0;0
19558;180311;2517;85;30;1;29;.967;3600000;0
19558;47742;841;0;0;0;0;.00nan;0;0
19558;47754;841;43;28;5;23;.821;3600000;0
19559;5565;843;0;0;0;0;.00nan;0;0
19559;9455;843;53;25;3;22;.880;3568000;0
19559;30696;2508;61;21;2;19;.905;3600000;0
19559;185506;2508;0;0;0;0;.00nan;0;0
19560;805;846;54;19;2;17;.895;3600000;0
19560;13373;835;84;39;3;36;.923;3600000;0
19560;86485;835;0;0;0;0;.00nan;0;0
19560;154162;846;0;0;0;0;.00nan;0;0
19561;5573;2493;0;0;0;0;.00nan;0;0
19561;47742;841;0;0;0;0;.00nan;0;0
19561;47754;841;32;18;4;14;.778;3560000;0
19561;48141;2493;77;36;3;33;.917;3600000;0
19562;31439;2488;0;0;0;0;.00nan;0;0
19562;47769;844;0;0;0;0;.00nan;0;0
19562;147845;2488;79;23;1;22;.957;3600000;0
19562;152266;844;83;33;2;31;.939;3600000;0
19563;30696;2508;0;0;0;0;.00nan;0;0
19563;180279;845;77;28;3;25;.893;3900000;0
19563;185506;2508;96;56;3;53;.946;3900000;0
19563;47982;845;0;0;0;0;.00nan;0;0
19564;31439;2488;96;18;0;18;1.000;3600000;0
19564;47742;841;0;0;0;0;.00nan;0;0
19564;47754;841;94;35;2;33;.943;3515000;0
19564;147845;2488;0;0;0;0;.00nan;0;0
19565;805;846;73;27;2;25;.926;3671000;0
19565;5565;843;0;0;0;0;.00nan;0;0
19565;9455;843;84;35;1;34;.971;3671000;0
19565;154162;846;0;0;0;0;.00nan;0;0
19566;5573;2493;0;0;0;0;.00nan;0;0
19566;-1;2517;0;0;0;0;.00nan;0;0
19566;180311;2517;96;37;2;35;.946;3900000;0
19566;48141;2493;98;41;2;39;.951;3900000;0
19567;13373;835;84;22;1;21;.955;3600000;0
19567;30696;2508;74;39;3;36;.923;3558000;0
19567;185506;2508;0;0;0;0;.00nan;0;0
19567;86485;835;0;0;0;0;.00nan;0;0
19568;180279;845;0;0;0;0;.00nan;0;0
19568;47769;844;82;44;4;40;.909;3600000;0
19568;47982;845;81;21;1;20;.952;3600000;0
19568;152266;844;0;0;0;0;.00nan;0;0
19569;13373;835;40;2;1;1;.500;480000;0
19569;180279;845;46;18;3;15;.833;3600000;0
19569;47982;845;0;0;0;0;.00nan;0;0
19569;86485;835;51;42;6;36;.857;3120000;0
19570;30696;2508;0;0;0;0;.00nan;0;0
19570;185506;2508;61;36;4;32;.889;3600000;0
19570;47742;841;0;0;0;0;.00nan;0;0
19570;47754;841;89;25;1;24;.960;3600000;0
19571;5573;2493;100;34;0;34;1.000;3600000;0
19571;31439;2488;0;0;0;0;.00nan;0;0
19571;48141;2493;0;0;0;0;.00nan;0;0
19571;147845;2488;62;22;2;20;.909;3540000;0
19572;805;846;36;22;4;18;.818;3900000;0
19572;-1;2517;69;40;4;36;.900;3900000;0
19572;180311;2517;0;0;0;0;.00nan;0;0
19572;154162;846;0;0;0;0;.00nan;0;0
19573;5565;843;0;0;0;0;.00nan;0;0
19573;9455;843;63;22;3;19;.864;3600000;0
19573;47769;844;0;0;0;0;.00nan;0;0
19573;152266;844;100;29;0;29;1.000;3600000;0
19574;5565;843;0;0;0;0;.00nan;0;0
19574;9455;843;97;52;3;49;.942;3600000;0
19574;31439;2488;91;19;0;19;1.000;3600000;0
19574;147845;2488;0;0;0;0;.00nan;0;0
19575;805;846;70;27;2;25;.926;3600000;0
19575;5573;2493;90;50;4;46;.920;3537000;0
19575;48141;2493;0;0;0;0;.00nan;0;0
19575;154162;846;0;0;0;0;.00nan;0;0
19576;-1;2517;0;0;0;0;.00nan;0;0
19576;30696;2508;94;49;3;46;.939;3844000;0
19576;180311;2517;84;36;2;34;.944;3844000;0
19576;185506;2508;0;0;0;0;.00nan;0;0
19577;13373;835;67;25;2;23;.920;3900000;0
19577;47769;844;0;0;0;0;.00nan;0;0
19577;86485;835;0;0;0;0;.00nan;0;0
19577;152266;844;80;32;2;30;.938;3900000;0
19578;180279;845;81;38;3;35;.921;3600000;0
19578;47742;841;0;0;0;0;.00nan;0;0
19578;47754;841;44;32;6;26;.813;3600000;0
19578;47982;845;0;0;0;0;.00nan;0;0
19579;5565;843;39;38;6;32;.842;3600000;0
19579;9455;843;0;0;0;0;.00nan;0;0
19579;180279;845;72;22;1;21;.955;3600000;0
19579;47982;845;0;0;0;0;.00nan;0;0
19580;13373;835;87;32;2;30;.938;3600000;0
19580;47742;841;0;0;0;0;.00nan;0;0
19580;47754;841;28;22;5;17;.773;3600000;0
19580;86485;835;0;0;0;0;.00nan;0;0
19581;805;846;0;0;0;0;.00nan;0;0
19581;47769;844;100;34;0;34;1.000;3600000;0
19581;152266;844;0;0;0;0;.00nan;0;0
19581;154162;846;67;34;3;31;.912;3600000;0
19582;5573;2493;0;0;0;0;.00nan;0;0
19582;30696;2508;0;0;0;0;.00nan;0;0
19582;185506;2508;69;33;3;30;.909;3590000;0
19582;48141;2493;66;22;2;20;.909;3600000;0
19583;-1;2517;0;0;0;0;.00nan;0;0
19583;31439;2488;0;0;0;0;.00nan;0;0
19583;180311;2517;60;24;3;21;.875;3600000;0
19583;147845;2488;67;42;4;38;.905;3597000;0
19584;13373;835;82;25;1;24;.960;3600000;0
19584;180279;845;29;27;6;21;.778;2470000;0
19584;47982;845;38;7;2;5;.714;1130000;0
19584;86485;835;0;0;0;0;.00nan;0;0
19585;805;846;61;21;2;19;.905;3600000;0
19585;13373;835;70;34;4;30;.882;3528000;0
19585;86485;835;0;0;0;0;.00nan;0;0
19585;154162;846;0;0;0;0;.00nan;0;0
19586;31439;2488;0;0;0;0;.00nan;0;0
19586;47769;844;35;38;7;31;.816;2778000;0
19586;147845;2488;100;27;0;27;1.000;3600000;0
19586;152266;844;46;5;1;4;.800;822000;0
19587;5565;843;0;0;0;0;.00nan;0;0
19587;9455;843;38;42;7;35;.833;3600000;0
19587;47742;841;0;0;0;0;.00nan;0;0
19587;47754;841;42;24;4;20;.833;3600000;0
19588;5573;2493;57;34;4;30;.882;3600000;0
19588;-1;2517;0;0;0;0;.00nan;0;0
19588;180311;2517;68;23;2;21;.913;3600000;0
19588;48141;2493;0;0;0;0;.00nan;0;0
19589;30696;2508;96;38;1;37;.974;3600000;0
19589;180279;845;57;20;2;18;.900;3572000;0
19589;185506;2508;0;0;0;0;.00nan;0;0
19589;47982;845;0;0;0;0;.00nan;0;0
19590;5565;843;0;0;0;0;.00nan;0;0
19590;5573;2493;0;0;0;0;.00nan;0;0
19590;9455;843;79;39;4;35;.897;3791000;0
19590;48141;2493;45;18;3;15;.833;3791000;0
19591;805;846;72;26;2;24;.923;3600000;0
19591;31439;2488;0;0;0;0;.00nan;0;0
19591;147845;2488;74;34;3;31;.912;3600000;0
19591;154162;846;0;0;0;0;.00nan;0;0
19592;-1;2517;0;0;0;0;.00nan;0;0
19592;180311;2517;42;17;3;14;.824;3600000;0
19592;47742;841;0;0;0;0;.00nan;0;0
19592;47754;841;46;46;7;39;.848;3600000;0
19593;30696;2508;78;52;4;48;.923;3543000;0
19593;185506;2508;0;0;0;0;.00nan;0;0
19593;47769;844;0;0;0;0;.00nan;0;0
19593;152266;844;93;47;3;44;.936;3600000;0
19594;5573;2493;0;0;0;0;.00nan;0;0
19594;180279;845;0;0;0;0;.00nan;0;0
19594;47982;845;64;27;3;24;.889;3900000;0
19594;48141;2493;76;34;3;31;.912;3900000;0
19595;5565;843;0;0;0;0;.00nan;0;0
19595;9455;843;54;29;4;25;.862;3600000;0
19595;-1;2517;0;0;0;0;.00nan;0;0
19595;180311;2517;67;16;1;15;.938;3600000;0
19596;31439;2488;0;0;0;0;.00nan;0;0
19596;47742;841;0;0;0;0;.00nan;0;0
19596;47754;841;50;34;5;29;.853;3579000;0
19596;147845;2488;70;32;4;28;.875;3600000;0
19597;5573;2493;0;0;0;0;.00nan;0;0
19597;47769;844;0;0;0;0;.00nan;0;0
19597;48141;2493;61;25;3;22;.880;3558000;0
19597;152266;844;100;37;1;36;.973;3600000;0
19598;13373;835;82;24;1;23;.958;3900000;0
19598;30696;2508;0;0;0;0;.00nan;0;0
19598;185506;2508;84;31;1;30;.968;3900000;0
19598;86485;835;0;0;0;0;.00nan;0;0
19599;805;846;45;30;4;26;.867;3600000;0
19599;180279;845;70;31;3;28;.903;3600000;0
19599;47982;845;0;0;0;0;.00nan;0;0
19599;154162;846;0;0;0;0;.00nan;0;0
19600;5565;843;0;0;0;0;.00nan;0;0
19600;9455;843;28;31;7;24;.774;3600000;0
19600;47769;844;72;41;3;38;.927;3600000;0
19600;152266;844;0;0;0;0;.00nan;0;0
19601;13373;835;66;44;5;39;.886;3600000;0
19601;47742;841;0;0;0;0;.00nan;0;0
19601;47754;841;63;25;2;23;.920;3600000;0
19601;86485;835;0;0;0;0;.00nan;0;0
19602;30696;2508;97;63;5;58;.921;3549000;0
19602;31439;2488;42;15;3;12;.800;3600000;0
19602;185506;2508;0;0;0;0;.00nan;0;0
19602;147845;2488;0;0;0;0;.00nan;0;0
19603;805;846;94;22;0;22;1.000;3600000;0
19603;5573;2493;0;0;0;0;.00nan;0;0
19603;48141;2493;66;20;1;19;.950;3594000;0
19603;154162;846;0;0;0;0;.00nan;0;0
19604;-1;2517;0;0;0;0;.00nan;0;0
19604;180279;845;65;31;4;27;.871;3566000;0
19604;180311;2517;79;30;2;28;.933;3600000;0
19604;47982;845;0;0;0;0;.00nan;0;0
19605;5565;843;0;0;0;0;.00nan;0;0
19605;9455;843;78;35;2;33;.943;3558000;0
19605;31439;2488;0;0;0;0;.00nan;0;0
19605;147845;2488;91;29;1;28;.966;3600000;0
19606;5573;2493;0;0;0;0;.00nan;0;0
19606;47742;841;0;0;0;0;.00nan;0;0
19606;47754;841;64;27;3;24;.889;3600000;0
19606;48141;2493;66;34;4;30;.882;3557000;0
19607;805;846;44;24;4;20;.833;3600000;0
19607;30696;2508;38;31;6;25;.806;3235000;0
19607;185506;2508;51;3;0;3;1.000;347000;0
19607;154162;846;0;0;0;0;.00nan;0;0
19608;-1;2517;0;0;0;0;.00nan;0;0
19608;180311;2517;64;16;1;15;.938;3600000;0
19608;47769;844;0;0;0;0;.00nan;0;0
19608;152266;844;70;35;3;32;.914;3600000;0
19609;13373;835;70;40;4;36;.900;3600000;0
19609;180279;845;12;14;6;8;.571;2250000;0
19609;47982;845;50;2;0;2;1.000;1284000;0
19609;86485;835;0;0;0;0;.00nan;0;0
19610;805;846;53;32;4;28;.875;3573000;0
19610;-1;2517;90;40;2;38;.950;3600000;0
19610;180311;2517;0;0;0;0;.00nan;0;0
19610;154162;846;0;0;0;0;.00nan;0;0
19611;5565;843;0;0;0;0;.00nan;0;0
19611;9455;843;55;26;4;22;.846;3549000;0
19611;180279;845;84;34;2;32;.941;3600000;0
19611;47982;845;0;0;0;0;.00nan;0;0
19612;13373;835;67;33;3;30;.909;3573000;0
19612;31439;2488;93;30;1;29;.967;3600000;0
19612;86485;835;0;0;0;0;.00nan;0;0
19612;147845;2488;0;0;0;0;.00nan;0;0
19613;47742;841;63;22;3;19;.864;3600000;0
19613;47754;841;0;0;0;0;.00nan;0;0
19613;47769;844;31;31;6;25;.806;2569000;0
19613;152266;844;76;17;0;17;1.000;1031000;0
19614;805;846;0;0;0;0;.00nan;0;0
19614;-1;2517;0;0;0;0;.00nan;0;0
19614;180311;2517;34;23;5;18;.783;3791000;0
19614;154162;846;55;31;4;27;.871;3791000;0
19615;5573;2493;35;19;4;15;.789;3545000;0
19615;30696;2508;93;52;3;49;.942;3600000;0
19615;185506;2508;0;0;0;0;.00nan;0;0
19615;48141;2493;0;0;0;0;.00nan;0;0
19616;31439;2488;89;28;2;26;.929;3600000;0
19616;180279;845;42;34;6;28;.824;3192000;0
19616;47982;845;49;1;0;1;1.000;408000;0
19616;147845;2488;0;0;0;0;.00nan;0;0
19617;805;846;63;28;3;25;.893;3900000;0
19617;47742;841;0;0;0;0;.00nan;0;0
19617;47754;841;93;62;3;59;.952;3900000;0
19617;154162;846;0;0;0;0;.00nan;0;0
19618;5565;843;59;7;0;7;1.000;756000;0
19618;5573;2493;0;0;0;0;.00nan;0;0
19618;9455;843;24;29;7;22;.759;2759000;0
19618;48141;2493;61;39;5;34;.872;3600000;0
19619;-1;2517;0;0;0;0;.00nan;0;0
19619;30696;2508;41;9;2;7;.778;765000;0
19619;180311;2517;64;19;2;17;.895;3600000;0
19619;185506;2508;71;55;6;49;.891;2835000;0
19620;13373;835;68;20;1;19;.950;3646000;0
19620;47769;844;0;0;0;0;.00nan;0;0
19620;86485;835;0;0;0;0;.00nan;0;0
19620;152266;844;74;34;2;32;.941;3646000;0
19621;-1;2517;0;0;0;0;.00nan;0;0
19621;31439;2488;0;0;0;0;.00nan;0;0
19621;180311;2517;79;35;2;33;.943;3600000;0
19621;147845;2488;37;27;5;22;.815;3600000;0
19622;805;846;43;19;3;16;.842;3548000;0
19622;47769;844;99;51;2;49;.961;3600000;0
19622;152266;844;0;0;0;0;.00nan;0;0
19622;154162;846;0;0;0;0;.00nan;0;0
19623;5565;843;0;0;0;0;.00nan;0;0
19623;9455;843;76;28;3;25;.893;3900000;0
19623;30696;2508;76;35;3;32;.914;3900000;0
19623;185506;2508;0;0;0;0;.00nan;0;0
19624;180279;845;0;0;0;0;.00nan;0;0
19624;47742;841;0;0;0;0;.00nan;0;0
19624;47754;841;39;32;5;27;.844;3560000;0
19624;47982;845;45;18;3;15;.833;3600000;0
19625;5573;2493;44;30;5;25;.833;3600000;0
19625;13373;835;65;22;2;20;.909;3600000;0
19625;48141;2493;0;0;0;0;.00nan;0;0
19625;86485;835;0;0;0;0;.00nan;0;0
19626;805;846;27;24;5;19;.792;3600000;0
19626;5565;843;0;0;0;0;.00nan;0;0
19626;9455;843;93;40;2;38;.950;3600000;0
19626;154162;846;0;0;0;0;.00nan;0;0
19627;30696;2508;89;42;2;40;.952;3587000;0
19627;185506;2508;0;0;0;0;.00nan;0;0
19627;47742;841;0;0;0;0;.00nan;0;0
19627;47754;841;74;26;1;25;.962;3600000;0
19628;5573;2493;89;32;1;31;.969;3600000;0
19628;31439;2488;71;27;2;25;.926;3546000;0
19628;48141;2493;0;0;0;0;.00nan;0;0
19628;147845;2488;0;0;0;0;.00nan;0;0
19629;13373;835;76;29;2;27;.931;3600000;0
19629;-1;2517;0;0;0;0;.00nan;0;0
19629;180311;2517;70;33;3;30;.909;3562000;0
19629;86485;835;0;0;0;0;.00nan;0;0
19630;180279;845;85;30;1;29;.967;3600000;0
19630;47769;844;0;0;0;0;.00nan;0;0
19630;47982;845;0;0;0;0;.00nan;0;0
19630;152266;844;76;31;3;28;.903;3526000;0
19631;805;846;87;27;1;26;.963;3600000;0
19631;47769;844;52;38;5;33;.868;3600000;0
19631;152266;844;0;0;0;0;.00nan;0;0
19631;154162;846;0;0;0;0;.00nan;0;0
19632;13373;835;71;30;2;28;.933;3530000;0
19632;30696;2508;100;34;0;34;1.000;3600000;0
19632;185506;2508;0;0;0;0;.00nan;0;0
19632;86485;835;0;0;0;0;.00nan;0;0
19633;5573;2493;59;23;2;21;.913;3577000;0
19633;31439;2488;100;26;0;26;1.000;3600000;0
19633;48141;2493;0;0;0;0;.00nan;0;0
19633;147845;2488;0;0;0;0;.00nan;0;0
19634;5565;843;0;0;0;0;.00nan;0;0
19634;9455;843;76;42;4;38;.905;3820000;0
19634;47742;841;0;0;0;0;.00nan;0;0
19634;47754;841;69;33;3;30;.909;3820000;0
19635;-1;2517;0;0;0;0;.00nan;0;0
19635;180279;845;0;0;0;0;.00nan;0;0
19635;180311;2517;54;26;3;23;.885;3600000;0
19635;47982;845;75;32;2;30;.938;3600000;0
19636;5565;843;83;31;1;30;.968;3600000;0
19636;9455;843;0;0;0;0;.00nan;0;0
19636;13373;835;85;38;3;35;.921;3535000;0
19636;86485;835;0;0;0;0;.00nan;0;0
19637;805;846;0;0;0;0;.00nan;0;0
19637;180279;845;63;46;5;41;.891;3600000;0
19637;47982;845;0;0;0;0;.00nan;0;0
19637;154162;846;53;15;2;13;.867;3600000;0
19638;5573;2493;0;0;0;0;.00nan;0;0
19638;47769;844;0;0;0;0;.00nan;0;0
19638;48141;2493;88;32;1;31;.969;3900000;0
19638;152266;844;65;21;1;20;.952;3900000;0
19639;-1;2517;0;0;0;0;.00nan;0;0
19639;31439;2488;0;0;0;0;.00nan;0;0
19639;180311;2517;85;31;1;30;.968;3600000;0
19639;147845;2488;67;29;2;27;.931;3566000;0
19640;30696;2508;88;44;3;41;.932;3600000;0
19640;185506;2508;0;0;0;0;.00nan;0;0
19640;47742;841;0;0;0;0;.00nan;0;0
19640;47754;841;38;31;6;25;.806;3600000;0
19641;5565;843;0;0;0;0;.00nan;0;0
19641;9455;843;60;28;3;25;.893;3600000;0
19641;-1;2517;0;0;0;0;.00nan;0;0
19641;180311;2517;40;26;5;21;.808;3514000;0
19642;30696;2508;0;0;0;0;.00nan;0;0
19642;31439;2488;94;22;0;22;1.000;3600000;0
19642;185506;2508;73;30;2;28;.933;3516000;0
19642;147845;2488;0;0;0;0;.00nan;0;0
19643;5565;843;0;0;0;0;.00nan;0;0
19643;9455;843;86;47;3;44;.936;3600000;0
19643;180279;845;74;29;2;27;.931;3600000;0
19643;47982;845;0;0;0;0;.00nan;0;0
19644;47742;841;0;0;0;0;.00nan;0;0
19644;47754;841;69;21;2;19;.905;3600000;0
19644;47769;844;75;46;4;42;.913;3572000;0
19644;152266;844;0;0;0;0;.00nan;0;0
19645;5573;2493;0;0;0;0;.00nan;0;0
19645;13373;835;65;15;1;14;.933;3600000;0
19645;48141;2493;71;40;3;37;.925;3565000;0
19645;86485;835;0;0;0;0;.00nan;0;0
19646;805;846;0;0;0;0;.00nan;0;0
19646;-1;2517;61;43;5;38;.884;3600000;0
19646;180311;2517;0;0;0;0;.00nan;0;0
19646;154162;846;58;23;3;20;.870;3600000;0
19647;13373;835;100;26;1;25;.962;3600000;0
19647;-1;2517;0;0;0;0;.00nan;0;0
19647;180311;2517;61;23;2;21;.913;3543000;0
19647;86485;835;0;0;0;0;.00nan;0;0
19648;31439;2488;0;0;0;0;.00nan;0;0
19648;47742;841;0;0;0;0;.00nan;0;0
19648;47754;841;53;26;3;23;.885;3715000;0
19648;147845;2488;88;33;2;31;.939;3715000;0
19649;805;846;0;0;0;0;.00nan;0;0
19649;30696;2508;84;50;4;46;.920;3600000;0
19649;185506;2508;0;0;0;0;.00nan;0;0
19649;154162;846;44;16;3;13;.813;3600000;0
19650;5565;843;0;0;0;0;.00nan;0;0
19650;9455;843;81;27;2;25;.926;3600000;0
19650;47769;844;0;0;0;0;.00nan;0;0
19650;152266;844;90;31;1;30;.968;3600000;0
19651;5573;2493;0;0;0;0;.00nan;0;0
19651;180279;845;0;0;0;0;.00nan;0;0
19651;47982;845;88;20;0;20;1.000;3600000;0
19651;48141;2493;78;32;2;30;.938;3530000;0
19652;5565;843;0;0;0;0;.00nan;0;0
19652;9455;843;79;21;1;20;.952;3554000;0
19652;31439;2488;100;22;0;22;1.000;3600000;0
19652;147845;2488;0;0;0;0;.00nan;0;0
19653;13373;835;75;34;3;31;.912;3600000;0
19653;47742;841;94;15;0;15;1.000;3600000;0
19653;47754;841;0;0;0;0;.00nan;0;0
19653;86485;835;0;0;0;0;.00nan;0;0
19654;805;846;68;20;2;18;.900;3900000;0
19654;5573;2493;93;38;2;36;.947;3900000;0
19654;48141;2493;0;0;0;0;.00nan;0;0
19654;154162;846;0;0;0;0;.00nan;0;0
19655;-1;2517;0;0;0;0;.00nan;0;0
19655;180311;2517;75;25;2;23;.920;3600000;0
19655;47769;844;55;35;5;30;.857;3600000;0
19655;152266;844;0;0;0;0;.00nan;0;0
19656;30696;2508;0;0;0;0;.00nan;0;0
19656;180279;845;0;0;0;0;.00nan;0;0
19656;185506;2508;52;41;6;35;.854;3549000;0
19656;47982;845;40;18;4;14;.778;3600000;0
19657;5565;843;0;0;0;0;.00nan;0;0
19657;9455;843;67;43;5;38;.884;3600000;0
19657;-1;2517;0;0;0;0;.00nan;0;0
19657;180311;2517;74;20;1;19;.950;3600000;0
19658;805;846;0;0;0;0;.00nan;0;0
19658;47742;841;83;40;2;38;.950;3590000;0
19658;47754;841;0;0;0;0;.00nan;0;0
19658;154162;846;75;22;1;21;.955;3600000;0
19659;5573;2493;0;0;0;0;.00nan;0;0
19659;30696;2508;68;31;3;28;.903;3600000;0
19659;185506;2508;0;0;0;0;.00nan;0;0
19659;48141;2493;59;38;5;33;.868;3552000;0
19660;13373;835;32;22;4;18;.818;3560000;0
19660;47769;844;0;0;0;0;.00nan;0;0
19660;86485;835;0;0;0;0;.00nan;0;0
19660;152266;844;76;34;3;31;.912;3600000;0
19661;31439;2488;43;5;1;4;.800;464000;0
19661;180279;845;55;15;2;13;.867;3600000;0
19661;47982;845;0;0;0;0;.00nan;0;0
19661;147845;2488;39;30;6;24;.800;3136000;0
19662;805;846;0;0;0;0;.00nan;0;0
19662;13373;835;0;0;0;0;.00nan;0;0
19662;86485;835;90;47;3;44;.936;3581000;0
19662;154162;846;55;13;2;11;.846;3600000;0
19663;31439;2488;71;19;1;18;.947;3600000;0
19663;47769;844;47;40;6;34;.850;3600000;0
19663;147845;2488;0;0;0;0;.00nan;0;0
19663;152266;844;0;0;0;0;.00nan;0;0
19664;180279;845;39;25;4;21;.840;3600000;0
19664;47742;841;0;0;0;0;.00nan;0;0
19664;47754;841;46;33;5;28;.848;3566000;0
19664;47982;845;0;0;0;0;.00nan;0;0
19665;5573;2493;0;0;0;0;.00nan;0;0
19665;-1;2517;0;0;0;0;.00nan;0;0
19665;180311;2517;66;28;2;26;.929;3600000;0
19665;48141;2493;41;32;6;26;.813;3600000;0
19666;5565;843;0;0;0;0;.00nan;0;0
19666;9455;843;41;30;5;25;.833;3559000;0
19666;30696;2508;60;34;4;30;.882;3600000;0
19666;185506;2508;0;0;0;0;.00nan;0;0
19667;5565;843;0;0;0;0;.00nan;0;0
19667;5573;2493;0;0;0;0;.00nan;0;0
19667;9455;843;69;33;3;30;.909;3600000;0
19667;48141;2493;59;34;4;30;.882;3563000;0
19668;-1;2517;0;0;0;0;.00nan;0;0
19668;180311;2517;80;28;1;27;.964;3900000;0
19668;47742;841;0;0;0;0;.00nan;0;0
19668;47754;841;95;27;1;26;.963;3900000;0
19669;30696;2508;28;34;6;28;.824;2253000;0
19669;185506;2508;58;14;1;13;.929;1347000;0
19669;47769;844;0;0;0;0;.00nan;0;0
19669;152266;844;70;25;2;23;.920;3600000;0
19670;13373;835;77;41;4;37;.902;3759000;0
19670;180279;845;0;0;0;0;.00nan;0;0
19670;47982;845;60;26;3;23;.885;3759000;0
19670;86485;835;0;0;0;0;.00nan;0;0
19671;5565;843;0;0;0;0;.00nan;0;0
19671;9455;843;66;34;3;31;.912;3600000;0
19671;13373;835;90;34;1;33;.971;3600000;0
19671;86485;835;0;0;0;0;.00nan;0;0
19672;805;846;0;0;0;0;.00nan;0;0
19672;31439;2488;0;0;0;0;.00nan;0;0
19672;147845;2488;37;27;5;22;.815;3546000;0
19672;154162;846;80;39;3;36;.923;3600000;0
19673;13373;835;0;0;0;0;.00nan;0;0
19673;31439;2488;55;32;4;28;.875;3557000;0
19673;86485;835;85;26;2;24;.923;3600000;0
19673;147845;2488;0;0;0;0;.00nan;0;0
19674;805;846;0;0;0;0;.00nan;0;0
19674;5565;843;0;0;0;0;.00nan;0;0
19674;9455;843;41;39;6;33;.846;3600000;0
19674;154162;846;47;16;3;13;.813;3600000;0
19675;5573;2493;100;22;0;22;1.000;3600000;0
19675;47742;841;0;0;0;0;.00nan;0;0
19675;47754;841;54;29;3;26;.897;3600000;0
19675;48141;2493;0;0;0;0;.00nan;0;0
19676;-1;2517;19;21;6;15;.714;3600000;0
19676;30696;2508;0;0;0;0;.00nan;0;0
19676;180311;2517;0;0;0;0;.00nan;0;0
19676;185506;2508;95;42;2;40;.952;3600000;0
19677;180279;845;52;14;2;12;.857;3600000;0
19677;47769;844;27;27;6;21;.778;2163000;0
19677;47982;845;0;0;0;0;.00nan;0;0
19677;152266;844;54;18;2;16;.889;1437000;0
19678;5565;843;94;44;3;41;.932;3578000;0
19678;9455;843;0;0;0;0;.00nan;0;0
19678;47742;841;0;0;0;0;.00nan;0;0
19678;47754;841;84;30;1;29;.967;3600000;0
19679;805;846;0;0;0;0;.00nan;0;0
19679;47769;844;0;0;0;0;.00nan;0;0
19679;152266;844;80;39;3;36;.923;3587000;0
19679;154162;846;85;34;2;32;.941;3600000;0
19680;5573;2493;90;37;2;35;.946;3600000;0
19680;31439;2488;0;0;0;0;.00nan;0;0
19680;48141;2493;0;0;0;0;.00nan;0;0
19680;147845;2488;40;16;3;13;.813;3600000;0
19681;-1;2517;0;0;0;0;.00nan;0;0
19681;180279;845;11;20;6;14;.700;3287000;0
19681;180311;2517;99;40;3;37;.925;3600000;0
19681;47982;845;48;0;0;0;.00nan;313000;0
19682;13373;835;57;18;2;16;.889;3600000;0
19682;30696;2508;0;0;0;0;.00nan;0;0
19682;185506;2508;82;42;4;38;.905;3553000;0
19682;86485;835;0;0;0;0;.00nan;0;0
19683;30696;2508;0;0;0;0;.00nan;0;0
19683;180279;845;37;20;4;16;.800;3518000;0
19683;185506;2508;88;38;2;36;.947;3600000;0
19683;47982;845;0;0;0;0;.00nan;0;0
19684;-1;2517;0;0;0;0;.00nan;0;0
19684;31439;2488;55;38;5;33;.868;3600000;0
19684;180311;2517;73;25;2;23;.920;3600000;0
19684;147845;2488;0;0;0;0;.00nan;0;0
19685;30696;2508;34;33;6;27;.818;2960000;0
19685;185506;2508;69;8;0;8;1.000;940000;0
19685;47742;841;68;21;2;19;.905;2918000;0
19685;47754;841;29;12;4;8;.667;982000;0
19686;5573;2493;82;39;2;37;.949;3860000;0
19686;47769;844;80;30;2;28;.933;3900000;0
19686;48141;2493;0;0;0;0;.00nan;0;0
19686;152266;844;0;0;0;0;.00nan;0;0
19687;805;846;0;0;0;0;.00nan;0;0
19687;180279;845;0;0;0;0;.00nan;0;0
19687;47982;845;100;30;0;30;1.000;3600000;0
19687;154162;846;72;30;2;28;.933;3600000;0
19688;5565;843;0;0;0;0;.00nan;0;0
19688;9455;843;87;32;1;31;.969;3548000;0
19688;13373;835;0;0;0;0;.00nan;0;0
19688;86485;835;100;35;0;35;1.000;3600000;0
19689;805;846;0;0;0;0;.00nan;0;0
19689;31439;2488;55;3;0;3;1.000;533000;0
19689;147845;2488;32;31;7;24;.774;3067000;0
19689;154162;846;48;26;4;22;.846;3600000;0
19690;5565;843;0;0;0;0;.00nan;0;0
19690;5573;2493;0;0;0;0;.00nan;0;0
19690;9455;843;75;37;3;34;.919;3900000;0
19690;48141;2493;71;34;3;31;.912;3900000;0
19691;-1;2517;0;0;0;0;.00nan;0;0
19691;180311;2517;83;31;2;29;.935;3643000;0
19691;47742;841;0;0;0;0;.00nan;0;0
19691;47754;841;92;31;1;30;.968;3643000;0
19692;30696;2508;0;0;0;0;.00nan;0;0
19692;185506;2508;81;14;0;14;1.000;3600000;0
19692;47769;844;0;0;0;0;.00nan;0;0
19692;152266;844;58;29;3;26;.897;3600000;0
19693;805;846;0;0;0;0;.00nan;0;0
19693;5565;843;0;0;0;0;.00nan;0;0
19693;9455;843;33;32;6;26;.813;3600000;0
19693;154162;846;71;22;1;21;.955;3600000;0
19694;13373;835;0;0;0;0;.00nan;0;0
19694;31439;2488;0;0;0;0;.00nan;0;0
19694;86485;835;66;34;4;30;.882;3577000;0
19694;147845;2488;67;27;3;24;.889;3600000;0
19695;5573;2493;82;52;5;47;.904;3600000;0
19695;47742;841;0;0;0;0;.00nan;0;0
19695;47754;841;64;17;1;16;.941;3600000;0
19695;48141;2493;0;0;0;0;.00nan;0;0
19696;-1;2517;0;0;0;0;.00nan;0;0
19696;30696;2508;0;0;0;0;.00nan;0;0
19696;180311;2517;99;31;1;30;.968;3600000;0
19696;185506;2508;51;31;4;27;.871;3600000;0
19697;180279;845;0;0;0;0;.00nan;0;0
19697;47769;844;0;0;0;0;.00nan;0;0
19697;47982;845;63;28;3;25;.893;3600000;0
19697;152266;844;61;38;5;33;.868;3518000;0
19698;5573;2493;69;29;2;27;.931;3600000;0
19698;13373;835;0;0;0;0;.00nan;0;0
19698;48141;2493;0;0;0;0;.00nan;0;0
19698;86485;835;60;29;3;26;.897;3593000;0
19699;30696;2508;0;0;0;0;.00nan;0;0
19699;31439;2488;82;30;1;29;.967;3900000;0
19699;185506;2508;93;31;1;30;.968;3900000;0
19699;147845;2488;0;0;0;0;.00nan;0;0
19700;805;846;0;0;0;0;.00nan;0;0
19700;-1;2517;0;0;0;0;.00nan;0;0
19700;180311;2517;51;43;6;37;.860;3643000;0
19700;154162;846;29;34;7;27;.794;3643000;0
19701;47742;841;0;0;0;0;.00nan;0;0
19701;47754;841;79;29;2;27;.931;3650000;0
19701;47769;844;90;32;1;31;.969;3650000;0
19701;152266;844;0;0;0;0;.00nan;0;0
19702;5565;843;0;0;0;0;.00nan;0;0
19702;9455;843;74;41;4;37;.902;3579000;0
19702;180279;845;0;0;0;0;.00nan;0;0
19702;47982;845;58;28;3;25;.893;3600000;0
19703;5565;843;0;0;0;0;.00nan;0;0
19703;9455;843;79;27;1;26;.963;3600000;0
19703;47769;844;0;0;0;0;.00nan;0;0
19703;152266;844;77;22;2;20;.909;3549000;0
19704;31439;2488;0;0;0;0;.00nan;0;0
19704;47742;841;0;0;0;0;.00nan;0;0
19704;47754;841;72;22;1;21;.955;3600000;0
19704;147845;2488;73;36;3;33;.917;3552000;0
19705;5573;2493;92;42;2;40;.952;3600000;0
19705;180279;845;0;0;0;0;.00nan;0;0
19705;47982;845;81;35;3;32;.914;3546000;0
19705;48141;2493;0;0;0;0;.00nan;0;0
19706;13373;835;0;0;0;0;.00nan;0;0
19706;-1;2517;0;0;0;0;.00nan;0;0
19706;180311;2517;62;28;3;25;.893;3600000;0
19706;86485;835;66;23;2;21;.913;3600000;0
19707;805;846;0;0;0;0;.00nan;0;0
19707;30696;2508;0;0;0;0;.00nan;0;0
19707;185506;2508;75;45;3;42;.933;3600000;0
19707;154162;846;65;19;2;17;.895;3600000;0
19708;13373;835;83;38;3;35;.921;3561000;0
19708;47742;841;0;0;0;0;.00nan;0;0
19708;47754;841;88;30;2;28;.933;3600000;0
19708;86485;835;0;0;0;0;.00nan;0;0
19709;5565;843;0;0;0;0;.00nan;0;0
19709;9455;843;72;32;2;30;.938;3600000;0
19709;31439;2488;61;39;5;34;.872;3600000;0
19709;147845;2488;0;0;0;0;.00nan;0;0
19710;805;846;52;17;3;14;.824;3900000;0
19710;5573;2493;0;0;0;0;.00nan;0;0
19710;48141;2493;97;50;3;47;.940;3900000;0
19710;154162;846;0;0;0;0;.00nan;0;0
19711;-1;2517;64;19;2;17;.895;3600000;0
19711;180311;2517;0;0;0;0;.00nan;0;0
19711;47769;844;32;20;4;16;.800;968000;0
19711;152266;844;66;20;1;19;.950;2632000;0
19712;30696;2508;0;0;0;0;.00nan;0;0
19712;180279;845;64;17;1;16;.941;2493000;0
19712;185506;2508;94;53;3;50;.943;3600000;0
19712;47982;845;22;11;4;7;.636;1051000;0
19713;13373;835;86;33;2;31;.939;3600000;0
19713;47769;844;84;26;2;24;.923;2601000;0
19713;86485;835;0;0;0;0;.00nan;0;0
19713;152266;844;26;12;4;8;.667;999000;0
19714;31439;2488;57;23;2;21;.913;3229000;0
19714;180279;845;0;0;0;0;.00nan;0;0
19714;47982;845;18;24;6;18;.750;3582000;0
19714;147845;2488;28;5;3;2;.400;371000;0
19715;805;846;0;0;0;0;.00nan;0;0
19715;47742;841;0;0;0;0;.00nan;0;0
19715;47754;841;95;42;1;41;.976;3600000;0
19715;154162;846;54;31;4;27;.871;3600000;0
19716;5565;843;48;4;1;3;.750;300000;0
19716;9455;843;51;51;7;44;.863;3300000;0
19716;-1;2517;90;19;0;19;1.000;3600000;0
19716;180311;2517;0;0;0;0;.00nan;0;0
19717;5573;2493;0;0;0;0;.00nan;0;0
19717;30696;2508;84;41;1;40;.976;3900000;0
19717;185506;2508;0;0;0;0;.00nan;0;0
19717;48141;2493;87;32;1;31;.969;3900000;0
19718;5565;843;0;0;0;0;.00nan;0;0
19718;9455;843;46;24;4;20;.833;3600000;0
19718;30696;2508;0;0;0;0;.00nan;0;0
19718;185506;2508;97;42;1;41;.976;3600000;0
19719;805;846;0;0;0;0;.00nan;0;0
19719;13373;835;33;30;6;24;.800;2793000;0
19719;86485;835;58;5;0;5;1.000;807000;0
19719;154162;846;51;31;4;27;.871;3600000;0
19720;5573;2493;55;12;2;10;.833;3600000;0
19720;-1;2517;63;24;3;21;.875;3600000;0
19720;180311;2517;0;0;0;0;.00nan;0;0
19720;48141;2493;0;0;0;0;.00nan;0;0
19721;31439;2488;84;26;1;25;.962;3600000;0
19721;47769;844;93;43;3;40;.930;3526000;0
19721;147845;2488;0;0;0;0;.00nan;0;0
19721;152266;844;0;0;0;0;.00nan;0;0
19722;180279;845;54;45;5;40;.889;3600000;0
19722;47742;841;0;0;0;0;.00nan;0;0
19722;47754;841;74;26;2;24;.923;3600000;0
19722;47982;845;0;0;0;0;.00nan;0;0
19724;13715;841;0;0;0;0;.00nan;0;0
19724;-1;2517;54;7;1;6;.857;1337000;0
19724;180311;2517;47;30;6;24;.800;2263000;0
19724;47754;841;80;27;2;25;.926;3600000;0
19726;5565;843;0;0;0;0;.00nan;0;0
19726;5573;2493;25;23;6;17;.739;1883000;0
19726;9455;843;66;27;2;25;.926;3600000;0
19726;48141;2493;46;20;3;17;.850;1717000;0
19728;30696;2508;32;8;3;5;.625;542000;0
19728;31439;2488;0;0;0;0;.00nan;0;0
19728;185506;2508;55;35;4;31;.886;3058000;0
19728;147845;2488;59;33;4;29;.879;3600000;0
19730;13373;835;0;0;0;0;.00nan;0;0
19730;180279;845;86;13;0;13;1.000;3600000;0
19730;47742;845;0;0;0;0;.00nan;0;0
19730;86485;835;60;34;4;30;.882;3600000;0
19732;805;846;45;10;2;8;.800;3600000;0
19732;47769;844;0;0;0;0;.00nan;0;0
19732;152266;844;79;37;4;33;.892;3600000;0
19732;154162;846;0;0;0;0;.00nan;0;0
19734;805;846;0;0;0;0;.00nan;0;0
19734;47769;844;62;39;5;34;.872;3589000;0
19734;152266;844;0;0;0;0;.00nan;0;0
19734;154162;846;44;18;3;15;.833;3600000;0
19736;30696;2508;87;47;3;44;.936;3569000;0
19736;180279;845;56;15;2;13;.867;3600000;0
19736;185506;2508;0;0;0;0;.00nan;0;0
19736;47742;845;0;0;0;0;.00nan;0;0
19738;13715;841;70;34;3;31;.912;3900000;0
19738;31439;2488;73;27;3;24;.889;3900000;0
19738;47754;841;0;0;0;0;.00nan;0;0
19738;147845;2488;0;0;0;0;.00nan;0;0
19740;5565;843;78;38;3;35;.921;3516000;0
19740;9455;843;0;0;0;0;.00nan;0;0
19740;13373;835;100;38;1;37;.974;3600000;0
19740;86485;835;0;0;0;0;.00nan;0;0
19742;5573;2493;0;0;0;0;.00nan;0;0
19742;-1;2517;35;23;5;18;.783;3698000;0
19742;180311;2517;0;0;0;0;.00nan;0;0
19742;48141;2493;66;38;4;34;.895;3698000;0
19744;30696;2508;0;0;0;0;.00nan;0;0
19744;185506;2508;58;45;6;39;.867;3600000;0
19744;47742;841;0;0;0;0;.00nan;0;0
19744;47754;841;67;31;3;28;.903;3600000;0
19746;5565;843;0;0;0;0;.00nan;0;0
19746;9455;843;58;14;1;13;.929;3600000;0
19746;47769;844;43;32;6;26;.813;3600000;0
19746;152266;844;0;0;0;0;.00nan;0;0
19748;805;846;58;23;3;20;.870;3900000;0
19748;31439;2488;0;0;0;0;.00nan;0;0
19748;147845;2488;66;28;3;25;.893;3900000;0
19748;154162;846;0;0;0;0;.00nan;0;0
19750;5573;2493;0;0;0;0;.00nan;0;0
19750;-1;2517;44;17;3;14;.824;3600000;0
19750;180311;2517;0;0;0;0;.00nan;0;0
19750;48141;2493;71;42;4;38;.905;3600000;0
19752;13373;835;87;50;3;47;.940;3900000;0
19752;180279;845;0;0;0;0;.00nan;0;0
19752;47982;845;60;21;3;18;.857;3899000;0
19752;86485;835;0;0;0;0;.00nan;0;0
19754;-1;2517;0;0;0;0;.00nan;0;0
19754;180311;2517;77;16;1;15;.938;3600000;0
19754;47769;844;72;39;3;36;.923;2613000;0
19754;152266;844;38;21;4;17;.810;987000;0
19756;5573;2493;53;40;5;35;.875;3600000;0
19756;47742;841;72;22;1;21;.955;3600000;0
19756;47754;841;0;0;0;0;.00nan;0;0
19756;48141;2493;0;0;0;0;.00nan;0;0
19758;5565;843;15;6;4;2;.333;1132000;0
19758;9455;843;33;13;3;10;.769;2768000;0
19758;30696;2508;38;31;6;25;.806;3061000;0
19758;185506;2508;58;9;1;8;.889;839000;0
19760;13373;835;0;0;0;0;.00nan;0;0
19760;180279;845;85;40;3;37;.925;3583000;0
19760;47982;845;0;0;0;0;.00nan;0;0
19760;86485;835;57;20;2;18;.900;3600000;0
19762;805;846;0;0;0;0;.00nan;0;0
19762;31439;2488;64;42;4;38;.905;3565000;0
19762;147845;2488;0;0;0;0;.00nan;0;0
19762;154162;846;58;24;3;21;.875;3600000;0
19764;5573;2493;0;0;0;0;.00nan;0;0
19764;47742;841;0;0;0;0;.00nan;0;0
19764;47754;841;76;43;4;39;.907;3900000;0
19764;48141;2493;40;24;4;20;.833;3900000;0
19766;30696;2508;0;0;0;0;.00nan;0;0
19766;180279;845;72;29;2;27;.931;3600000;0
19766;185506;2508;40;36;6;30;.833;3600000;0
19766;47982;845;0;0;0;0;.00nan;0;0
19768;13373;835;96;39;2;37;.949;3900000;0
19768;31439;2488;81;34;2;32;.941;3900000;0
19768;86485;835;0;0;0;0;.00nan;0;0
19768;147845;2488;0;0;0;0;.00nan;0;0
19770;5565;843;0;0;0;0;.00nan;0;0
19770;9455;843;53;37;5;32;.865;3600000;0
19770;-1;2517;85;27;2;25;.926;3600000;0
19770;180311;2517;0;0;0;0;.00nan;0;0
19772;805;846;83;22;1;21;.955;3600000;0
19772;47769;844;98;47;3;44;.936;3600000;0
19772;152266;844;0;0;0;0;.00nan;0;0
19772;154162;846;0;0;0;0;.00nan;0;0
19774;805;846;0;0;0;0;.00nan;0;0
19774;13373;835;0;0;0;0;.00nan;0;0
19774;86485;835;80;39;4;35;.897;3536000;0
19774;154162;846;64;18;2;16;.889;3600000;0
19776;5573;2493;44;35;5;30;.857;3600000;0
19776;31439;2488;0;0;0;0;.00nan;0;0
19776;48141;2493;0;0;0;0;.00nan;0;0
19776;147845;2488;94;20;0;20;1.000;3600000;0
19778;47742;841;48;18;3;15;.833;3544000;0
19778;47754;841;0;0;0;0;.00nan;0;0
19778;47769;844;0;0;0;0;.00nan;0;0
19778;152266;844;90;36;2;34;.944;3600000;0
19780;5565;843;56;26;3;23;.885;3576000;0
19780;9455;843;0;0;0;0;.00nan;0;0
19780;30696;2508;78;32;2;30;.938;3600000;0
19780;185506;2508;0;0;0;0;.00nan;0;0
19782;-1;2517;0;0;0;0;.00nan;0;0
19782;180279;845;0;0;0;0;.00nan;0;0
19782;180311;2517;59;39;5;34;.872;3577000;0
19782;47982;845;51;31;4;27;.871;3600000;0
19784;31439;2488;0;0;0;0;.00nan;0;0
19784;47742;841;49;1;0;1;1.000;464000;0
19784;47754;841;40;32;7;25;.781;3075000;0
19784;147845;2488;36;27;5;22;.815;3600000;0
19786;13373;835;73;38;3;35;.921;3585000;0
19786;180279;845;100;27;0;27;1.000;3600000;0
19786;47982;845;0;0;0;0;.00nan;0;0
19786;86485;835;0;0;0;0;.00nan;0;0
19788;-1;2517;0;0;0;0;.00nan;0;0
19788;180311;2517;53;9;1;8;.889;3600000;0
19788;47769;844;68;32;3;29;.906;3515000;0
19788;152266;844;0;0;0;0;.00nan;0;0
19790;805;846;0;0;0;0;.00nan;0;0
19790;5565;843;0;0;0;0;.00nan;0;0
19790;9455;843;67;39;4;35;.897;3850000;0
19790;154162;846;49;20;3;17;.850;3817000;0
19792;5573;2493;84;28;1;27;.964;3900000;0
19792;30696;2508;0;0;0;0;.00nan;0;0
19792;185506;2508;94;35;1;34;.971;3900000;0
19792;48141;2493;0;0;0;0;.00nan;0;0
228;805;846;57;14;2;12;.857;3716000;0
228;30696;2508;87;44;3;41;.932;3716000;0
228;185506;2508;0;0;0;0;.00nan;0;0
228;154162;846;0;0;0;0;.00nan;0;0
229;5573;2493;0;0;0;0;.00nan;0;0
229;-1;2517;0;0;0;0;.00nan;0;0
229;180311;2517;40;31;5;26;.839;3600000;0
229;48141;2493;81;30;2;28;.933;3600000;0
230;31439;2488;63;34;4;30;.882;3600000;0
230;47742;841;0;0;0;0;.00nan;0;0
230;47754;841;56;20;3;17;.850;3600000;0
230;147845;2488;0;0;0;0;.00nan;0;0
231;13373;835;84;47;4;43;.915;3600000;0
231;180279;845;79;22;1;21;.955;3600000;0
231;47982;845;0;0;0;0;.00nan;0;0
231;86485;835;0;0;0;0;.00nan;0;0
232;805;846;62;17;2;15;.882;3600000;0
232;30696;2508;53;42;6;36;.857;2887000;0
232;185506;2508;47;8;1;7;.875;713000;0
232;154162;846;0;0;0;0;.00nan;0;0
233;5573;2493;0;0;0;0;.00nan;0;0
233;-1;2517;0;0;0;0;.00nan;0;0
233;180311;2517;47;21;3;18;.857;3517000;0
233;48141;2493;81;28;1;27;.964;3600000;0
234;31439;2488;0;0;0;0;.00nan;0;0
234;47742;841;0;0;0;0;.00nan;0;0
234;47754;841;64;33;3;30;.909;3590000;0
234;147845;2488;71;20;1;19;.950;3600000;0
235;13373;835;64;35;4;31;.886;3600000;0
235;180279;845;86;29;1;28;.966;3600000;0
235;47982;845;0;0;0;0;.00nan;0;0
235;86485;835;0;0;0;0;.00nan;0;0
236;805;846;80;8;0;8;1.000;3600000;0
236;30696;2508;79;47;4;43;.915;3600000;0
236;185506;2508;0;0;0;0;.00nan;0;0
236;154162;846;0;0;0;0;.00nan;0;0
237;5573;2493;0;0;0;0;.00nan;0;0
237;-1;2517;0;0;0;0;.00nan;0;0
237;180311;2517;57;18;2;16;.889;3600000;0
237;48141;2493;58;32;4;28;.875;3576000;0
238;31439;2488;0;0;0;0;.00nan;0;0
238;47742;841;0;0;0;0;.00nan;0;0
238;47754;841;52;23;3;20;.870;3600000;0
238;147845;2488;100;30;0;30;1.000;3600000;0
239;13373;835;99;34;2;32;.941;3600000;0
239;180279;845;52;24;3;21;.875;3563000;0
239;47982;845;0;0;0;0;.00nan;0;0
239;86485;835;0;0;0;0;.00nan;0;0
240;805;846;62;17;2;15;.882;3600000;0
240;30696;2508;85;42;3;39;.929;3549000;0
240;185506;2508;0;0;0;0;.00nan;0;0
240;154162;846;0;0;0;0;.00nan;0;0
241;5573;2493;0;0;0;0;.00nan;0;0
241;-1;2517;56;21;3;18;.857;1266000;0
241;180311;2517;33;20;5;15;.750;2334000;0
241;48141;2493;80;30;2;28;.933;3600000;0
242;31439;2488;0;0;0;0;.00nan;0;0
242;47742;841;0;0;0;0;.00nan;0;0
242;47754;841;94;31;1;30;.968;3600000;0
242;147845;2488;68;36;3;33;.917;3537000;0
243;206465;835;0;0;0;0;.00nan;0;0
243;180279;845;32;23;6;17;.739;3587000;0
243;47982;845;0;0;0;0;.00nan;0;0
243;86485;835;69;41;4;37;.902;3600000;0
343;5573;2493;32;30;6;24;.800;2591000;0
343;-1;2517;69;23;1;22;.957;3600000;0
343;180311;2517;0;0;0;0;.00nan;0;0
343;-1;2493;48;16;2;14;.875;1009000;0
344;31439;2488;0;0;0;0;.00nan;0;0
344;47742;841;0;0;0;0;.00nan;0;0
344;47754;841;73;29;1;28;.966;3600000;0
344;147845;2488;84;36;3;33;.917;3532000;0
345;206465;835;0;0;0;0;.00nan;0;0
345;180279;845;79;15;0;15;1.000;3600000;0
345;47982;845;0;0;0;0;.00nan;0;0
345;86485;835;41;32;5;27;.844;3600000;0
346;5573;2493;0;0;0;0;.00nan;0;0
346;-1;2517;51;30;5;25;.833;3666000;0
346;180311;2517;0;0;0;0;.00nan;0;0
346;48141;2493;56;32;4;28;.875;3666000;0
347;31439;2488;0;0;0;0;.00nan;0;0
347;47742;841;0;0;0;0;.00nan;0;0
347;47754;841;60;32;3;29;.906;3550000;0
347;147845;2488;63;19;2;17;.895;3600000;0
348;13373;835;100;38;1;37;.974;3600000;0
348;180279;845;40;18;4;14;.778;3600000;0
348;47982;845;0;0;0;0;.00nan;0;0
348;86485;835;0;0;0;0;.00nan;0;0
411;31439;2488;0;0;0;0;.00nan;0;0
411;47742;841;0;0;0;0;.00nan;0;0
411;47754;841;58;26;3;23;.885;3564000;0
411;147845;2488;87;33;1;32;.970;3600000;0
412;13373;835;63;25;2;23;.920;3600000;0
412;180279;845;42;32;5;27;.844;3600000;0
412;47982;845;0;0;0;0;.00nan;0;0
412;86485;835;0;0;0;0;.00nan;0;0
415;805;846;69;20;2;18;.900;3600000;0
415;5573;2493;0;0;0;0;.00nan;0;0
415;-1;846;0;0;0;0;.00nan;0;0
415;48141;2493;55;40;5;35;.875;3600000;0
416;13373;835;84;32;2;30;.938;3578000;0
416;31439;2488;0;0;0;0;.00nan;0;0
416;86485;835;0;0;0;0;.00nan;0;0
416;147845;2488;82;22;1;21;.955;3600000;0
417;805;846;84;32;2;30;.938;4244000;0
417;5573;2493;0;0;0;0;.00nan;0;0
417;-1;846;0;0;0;0;.00nan;0;0
417;48141;2493;92;46;3;43;.935;4244000;0
418;13373;835;37;29;6;23;.793;3600000;0
418;31439;2488;0;0;0;0;.00nan;0;0
418;86485;835;0;0;0;0;.00nan;0;0
418;147845;2488;80;31;2;29;.935;3600000;0
419;805;846;56;13;1;12;.923;3600000;0
419;5573;2493;55;6;0;6;1.000;446000;0
419;-1;846;0;0;0;0;.00nan;0;0
419;48141;2493;59;55;7;48;.873;3154000;0
420;13373;835;65;30;3;27;.900;3600000;0
420;31439;2488;0;0;0;0;.00nan;0;0
420;86485;835;0;0;0;0;.00nan;0;0
420;147845;2488;71;23;2;21;.913;3600000;0
421;805;846;71;31;3;28;.903;3660000;0
421;5573;2493;70;38;4;34;.895;3660000;0
421;-1;846;0;0;0;0;.00nan;0;0
421;48141;2493;0;0;0;0;.00nan;0;0
422;13373;835;72;31;2;29;.935;3600000;0
422;31439;2488;0;0;0;0;.00nan;0;0
422;86485;835;0;0;0;0;.00nan;0;0
422;147845;2488;46;25;4;21;.840;3549000;0
518;13373;835;96;34;1;33;.971;3600000;0
518;31439;2488;0;0;0;0;.00nan;0;0
518;86485;835;0;0;0;0;.00nan;0;0
518;147845;2488;75;35;2;33;.943;3567000;0
528;13373;835;79;34;2;32;.941;3587000;0
528;31439;2488;0;0;0;0;.00nan;0;0
528;86485;835;0;0;0;0;.00nan;0;0
528;147845;2488;72;19;1;18;.947;3600000;0
559;805;846;75;33;2;31;.939;4605000;0
559;31439;2488;0;0;0;0;.00nan;0;0
559;-1;846;0;0;0;0;.00nan;0;0
559;147845;2488;99;38;1;37;.974;4605000;0
560;805;846;68;17;1;16;.941;3600000;0
560;31439;2488;0;0;0;0;.00nan;0;0
560;-1;846;0;0;0;0;.00nan;0;0
560;147845;2488;89;46;3;43;.935;3587000;0
561;805;846;29;17;4;13;.765;3514000;0
561;31439;2488;0;0;0;0;.00nan;0;0
561;-1;846;0;0;0;0;.00nan;0;0
561;147845;2488;79;31;2;29;.935;3600000;0
562;805;846;100;25;0;25;1.000;3600000;0
562;31439;2488;0;0;0;0;.00nan;0;0
562;-1;846;0;0;0;0;.00nan;0;0
562;147845;2488;92;43;2;41;.953;3600000;0
745;805;846;68;15;1;14;.933;3600000;0
745;31439;2488;0;0;0;0;.00nan;0;0
745;-1;846;0;0;0;0;.00nan;0;0
745;147845;2488;76;38;3;35;.921;3569000;0
807;805;846;44;19;3;16;.842;3599000;0
807;31439;2488;0;0;0;0;.00nan;0;0
807;-1;846;0;0;0;0;.00nan;0;0
807;147845;2488;93;41;2;39;.951;3600000;0
945;805;846;57;23;3;20;.870;3600000;0
945;31439;2488;0;0;0;0;.00nan;0;0
945;-1;846;0;0;0;0;.00nan;0;0
945;147845;2488;83;30;2;28;.933;3600000;0
19793;46912;2173;42;19;4;15;.789;1131000;0
19793;54290;1477;0;0;0;0;.00nan;0;0
19793;56231;2173;70;24;1;23;.958;2469000;0
19793;63402;1477;71;20;1;19;.950;3600000;0
19794;13613;2193;0;0;0;0;.00nan;0;0
19794;64230;522;0;0;0;0;.00nan;0;0
19794;76951;2193;91;30;1;29;.967;3900000;0
19794;147264;522;100;38;1;37;.974;3900000;0
19795;11925;521;0;0;0;0;.00nan;0;0
19795;185041;1475;0;0;0;0;.00nan;0;0
19795;179830;1475;68;23;2;21;.913;3744000;0
19795;63848;521;67;26;3;23;.885;3744000;0
19796;4618;1877;0;0;0;0;.00nan;0;0
19796;84287;1877;86;30;1;29;.967;3600000;0
19796;143063;1861;100;28;0;28;1.000;3600000;0
19796;152202;1861;0;0;0;0;.00nan;0;0
19797;22413;3922;0;0;0;0;.00nan;0;0
19797;68565;1869;0;0;0;0;.00nan;0;0
19797;86686;1869;50;12;2;10;.833;3600000;0
19797;143507;3922;75;36;3;33;.917;3548000;0
19798;9373;1854;35;43;7;36;.837;3600000;0
19798;78587;1871;0;0;0;0;.00nan;0;0
19798;143036;1871;80;20;1;19;.950;3600000;0
19798;143479;1854;0;0;0;0;.00nan;0;0
19799;7534;1481;78;40;3;37;.925;3600000;0
19799;53889;1481;0;0;0;0;.00nan;0;0
19799;68627;523;0;0;0;0;.00nan;0;0
19799;73973;523;57;13;1;12;.923;3600000;0
19800;7534;1481;73;18;1;17;.944;3600000;0
19800;53889;1481;0;0;0;0;.00nan;0;0
19800;54290;1477;0;0;0;0;.00nan;0;0
19800;63402;1477;60;21;2;19;.905;3594000;0
19801;4618;1877;79;42;3;39;.929;3581000;0
19801;11925;521;0;0;0;0;.00nan;0;0
19801;63848;521;70;20;1;19;.950;3600000;0
19801;84287;1877;0;0;0;0;.00nan;0;0
19802;22413;3922;0;0;0;0;.00nan;0;0
19802;185041;1475;0;0;0;0;.00nan;0;0
19802;179830;1475;47;26;4;22;.846;3600000;0
19802;143507;3922;94;37;1;36;.973;3600000;0
19803;9373;1854;91;33;1;32;.970;3600000;0
19803;64230;522;0;0;0;0;.00nan;0;0
19803;143479;1854;0;0;0;0;.00nan;0;0
19803;147264;522;66;17;2;15;.882;3543000;0
19804;13613;2193;0;0;0;0;.00nan;0;0
19804;68627;523;67;22;2;20;.909;3550000;0
19804;73973;523;0;0;0;0;.00nan;0;0
19804;76951;2193;82;25;1;24;.960;3600000;0
19805;46912;2173;85;27;1;26;.963;3600000;0
19805;56231;2173;0;0;0;0;.00nan;0;0
19805;78587;1871;0;0;0;0;.00nan;0;0
19805;143036;1871;54;23;3;20;.870;3600000;0
19806;68565;1869;0;0;0;0;.00nan;0;0
19806;86686;1869;66;18;1;17;.944;3600000;0
19806;143063;1861;65;40;5;35;.875;3600000;0
19806;152202;1861;0;0;0;0;.00nan;0;0
19807;11882;1477;71;19;1;18;.947;3600000;0
19807;185041;1475;0;0;0;0;.00nan;0;0
19807;44487;1475;62;34;4;30;.882;3600000;0
19807;63402;1477;0;0;0;0;.00nan;0;0
19808;177156;1481;0;0;0;0;.00nan;0;0
19808;7534;1481;77;42;3;39;.929;3900000;0
19808;64230;522;0;0;0;0;.00nan;0;0
19808;147264;522;81;40;3;37;.925;3900000;0
19809;11925;521;55;22;3;19;.864;3900000;0
19809;46912;2173;66;36;3;33;.917;3900000;0
19809;56231;2173;0;0;0;0;.00nan;0;0
19809;63848;521;0;0;0;0;.00nan;0;0
19810;47112;2193;80;25;1;24;.960;3600000;0
19810;76951;2193;0;0;0;0;.00nan;0;0
19810;143063;1861;45;33;5;28;.848;3317000;0
19810;152202;1861;26;8;3;5;.625;283000;0
19811;9373;1854;0;0;0;0;.00nan;0;0
19811;22413;3922;0;0;0;0;.00nan;0;0
19811;143479;1854;88;31;1;30;.968;3600000;0
19811;143507;3922;75;28;2;26;.929;3598000;0
19812;4618;1877;63;49;6;43;.878;3600000;0
19812;68565;1869;0;0;0;0;.00nan;0;0
19812;84287;1877;0;0;0;0;.00nan;0;0
19812;86686;1869;32;16;4;12;.750;3600000;0
19813;67764;1871;0;0;0;0;.00nan;0;0
19813;68627;523;0;0;0;0;.00nan;0;0
19813;73973;523;70;29;3;26;.897;3740000;0
19813;143036;1871;63;32;4;28;.875;3740000;0
19814;177156;1481;0;0;0;0;.00nan;0;0
19814;7534;1481;83;29;1;28;.966;3686000;0
19814;68565;1869;0;0;0;0;.00nan;0;0
19814;86686;1869;87;28;2;26;.929;3686000;0
19815;4618;1877;73;33;3;30;.909;3600000;0
19815;22413;3922;0;0;0;0;.00nan;0;0
19815;84287;1877;0;0;0;0;.00nan;0;0
19815;143507;3922;87;16;0;16;1.000;3600000;0
19816;185041;1475;0;0;0;0;.00nan;0;0
19816;44487;1475;96;42;2;40;.952;3600000;0
19816;64230;522;0;0;0;0;.00nan;0;0
19816;147264;522;76;19;1;18;.947;3600000;0
19817;9373;1854;100;29;0;29;1.000;3600000;0
19817;143063;1861;0;0;0;0;.00nan;0;0
19817;143479;1854;0;0;0;0;.00nan;0;0
19817;152202;1861;51;40;5;35;.875;3600000;0
19818;11925;521;27;22;5;17;.773;1555000;0
19818;47112;2193;0;0;0;0;.00nan;0;0
19818;63848;521;31;32;6;26;.813;2045000;0
19818;76951;2193;39;18;4;14;.778;3600000;0
19819;46912;2173;0;0;0;0;.00nan;0;0
19819;56231;2173;80;42;4;38;.905;3555000;0
19819;68627;523;0;0;0;0;.00nan;0;0
19819;73973;523;56;23;3;20;.870;3600000;0
19820;11882;1477;0;0;0;0;.00nan;0;0
19820;63402;1477;85;29;1;28;.966;3600000;0
19820;67764;1871;0;0;0;0;.00nan;0;0
19820;143036;1871;72;31;3;28;.903;3545000;0
19821;11882;1477;0;0;0;0;.00nan;0;0
19821;47112;2193;0;0;0;0;.00nan;0;0
19821;63402;1477;87;31;2;29;.935;3600000;0
19821;76951;2193;74;33;3;30;.909;3559000;0
19822;64230;522;63;42;5;37;.881;3600000;0
19822;68627;523;0;0;0;0;.00nan;0;0
19822;73973;523;100;36;0;36;1.000;3600000;0
19822;147264;522;0;0;0;0;.00nan;0;0
19823;4618;1877;0;0;0;0;.00nan;0;0
19823;185041;1475;0;0;0;0;.00nan;0;0
19823;44487;1475;92;31;1;30;.968;3900000;0
19823;84287;1877;100;35;1;34;.971;3900000;0
19824;11925;521;0;0;0;0;.00nan;0;0
19824;63848;521;45;20;3;17;.850;3553000;0
19824;67764;1871;0;0;0;0;.00nan;0;0
19824;143036;1871;77;30;2;28;.933;3600000;0
19825;46912;2173;52;21;3;18;.857;3600000;0
19825;56231;2173;0;0;0;0;.00nan;0;0
19825;143063;1861;0;0;0;0;.00nan;0;0
19825;152202;1861;65;24;2;22;.917;3600000;0
19826;177156;1481;0;0;0;0;.00nan;0;0
19826;7534;1481;76;21;1;20;.952;3600000;0
19826;22413;3922;46;25;4;21;.840;3600000;0
19826;143507;3922;0;0;0;0;.00nan;0;0
19827;9373;1854;87;48;3;45;.938;3600000;0
19827;68565;1869;0;0;0;0;.00nan;0;0
19827;86686;1869;53;16;2;14;.875;3600000;0
19827;143479;1854;0;0;0;0;.00nan;0;0
19828;177156;1481;60;37;4;33;.892;3900000;0
19828;7534;1481;0;0;0;0;.00nan;0;0
19828;11925;521;70;15;0;15;1.000;2815000;0
19828;63848;521;23;13;4;9;.692;1085000;0
19829;185041;1475;0;0;0;0;.00nan;0;0
19829;44487;1475;50;40;6;34;.850;3600000;0
19829;143063;1861;0;0;0;0;.00nan;0;0
19829;152202;1861;75;24;2;22;.917;3600000;0
19830;4618;1877;65;26;2;24;.923;3600000;0
19830;9373;1854;35;27;5;22;.815;3600000;0
19830;84287;1877;0;0;0;0;.00nan;0;0
19830;143479;1854;0;0;0;0;.00nan;0;0
19831;47112;2193;74;25;2;23;.920;3600000;0
19831;68565;1869;0;0;0;0;.00nan;0;0
19831;76951;2193;0;0;0;0;.00nan;0;0
19831;86686;1869;70;33;3;30;.909;3553000;0
19832;22413;3922;0;0;0;0;.00nan;0;0
19832;46912;2173;0;0;0;0;.00nan;0;0
19832;56231;2173;74;26;1;25;.962;3600000;0
19832;143507;3922;51;23;3;20;.870;3546000;0
19833;64230;522;24;29;6;23;.793;3600000;0
19833;67764;1871;0;0;0;0;.00nan;0;0
19833;143036;1871;76;30;2;28;.933;3600000;0
19833;147264;522;0;0;0;0;.00nan;0;0
19834;11882;1477;0;0;0;0;.00nan;0;0
19834;63402;1477;76;40;4;36;.900;3600000;0
19834;68627;523;0;0;0;0;.00nan;0;0
19834;73973;523;44;16;3;13;.813;3600000;0
19835;46912;2173;85;32;2;30;.938;3900000;0
19835;56231;2173;0;0;0;0;.00nan;0;0
19835;64230;522;0;0;0;0;.00nan;0;0
19835;147264;522;87;36;2;34;.944;3900000;0
19836;177156;1481;0;0;0;0;.00nan;0;0
19836;4618;1877;0;0;0;0;.00nan;0;0
19836;7534;1481;57;19;2;17;.895;3600000;0
19836;84287;1877;51;44;6;38;.864;3600000;0
19837;9373;1854;67;45;4;41;.911;3600000;0
19837;47112;2193;68;18;1;17;.944;3600000;0
19837;76951;2193;0;0;0;0;.00nan;0;0
19837;143479;1854;0;0;0;0;.00nan;0;0
19838;11882;1477;0;0;0;0;.00nan;0;0
19838;11925;521;60;29;4;25;.862;3900000;0
19838;63402;1477;46;29;4;25;.862;3900000;0
19838;63848;521;0;0;0;0;.00nan;0;0
19839;67764;1871;0;0;0;0;.00nan;0;0
19839;143036;1871;93;16;0;16;1.000;3600000;0
19839;143063;1861;82;58;5;53;.914;3600000;0
19839;152202;1861;0;0;0;0;.00nan;0;0
19840;22413;3922;92;36;1;35;.972;3900000;0
19840;68627;523;0;0;0;0;.00nan;0;0
19840;73973;523;92;38;1;37;.974;3900000;0
19840;143507;3922;0;0;0;0;.00nan;0;0
19841;185041;1475;0;0;0;0;.00nan;0;0
19841;44487;1475;38;26;5;21;.808;3600000;0
19841;68565;1869;76;23;1;22;.957;3600000;0
19841;86686;1869;0;0;0;0;.00nan;0;0
19842;11882;1477;0;0;0;0;.00nan;0;0
19842;63402;1477;100;32;0;32;1.000;3600000;0
19842;64230;522;62;21;2;19;.905;1818000;0
19842;147264;522;36;19;5;14;.737;1782000;0
19843;177156;1481;35;17;4;13;.765;3528000;0
19843;7534;1481;0;0;0;0;.00nan;0;0
19843;143063;1861;0;0;0;0;.00nan;0;0
19843;152202;1861;78;29;2;27;.931;3600000;0
19844;9373;1854;64;24;2;22;.917;3571000;0
19844;185041;1475;0;0;0;0;.00nan;0;0
19844;44487;1475;98;22;0;22;1.000;3600000;0
19844;143479;1854;0;0;0;0;.00nan;0;0
19845;4618;1877;63;46;6;40;.870;3600000;0
19845;47112;2193;0;0;0;0;.00nan;0;0
19845;76951;2193;52;9;1;8;.889;3600000;0
19845;84287;1877;0;0;0;0;.00nan;0;0
19846;46912;2173;0;0;0;0;.00nan;0;0
19846;56231;2173;39;34;5;29;.853;3600000;0
19846;68565;1869;0;0;0;0;.00nan;0;0
19846;86686;1869;76;22;1;21;.955;3600000;0
19847;22413;3922;0;0;0;0;.00nan;0;0
19847;67764;1871;0;0;0;0;.00nan;0;0
19847;143036;1871;63;20;2;18;.900;3600000;0
19847;143507;3922;68;32;3;29;.906;3600000;0
19848;11925;521;0;0;0;0;.00nan;0;0
19848;63848;521;88;36;1;35;.972;3900000;0
19848;68627;523;0;0;0;0;.00nan;0;0
19848;73973;523;86;28;1;27;.964;3900000;0
19849;11925;521;62;26;3;23;.885;3600000;0
19849;63848;521;0;0;0;0;.00nan;0;0
19849;64230;522;69;40;4;36;.900;3600000;0
19849;147264;522;0;0;0;0;.00nan;0;0
19850;4618;1877;0;0;0;0;.00nan;0;0
19850;46912;2173;0;0;0;0;.00nan;0;0
19850;56231;2173;59;26;3;23;.885;3564000;0
19850;84287;1877;92;37;2;35;.946;3600000;0
19851;177156;1481;0;0;0;0;.00nan;0;0
19851;7534;1481;60;16;2;14;.875;3694000;0
19851;9373;1854;0;0;0;0;.00nan;0;0
19851;143479;1854;71;20;1;19;.950;3694000;0
19852;185041;1475;48;0;0;0;.00nan;243000;0
19852;44487;1475;15;24;6;18;.750;3357000;0
19852;47112;2193;0;0;0;0;.00nan;0;0
19852;76951;2193;72;20;1;19;.950;3600000;0
19853;68627;523;0;0;0;0;.00nan;0;0
19853;73973;523;51;15;2;13;.867;3600000;0
19853;143063;1861;40;17;4;13;.765;1040000;0
19853;152202;1861;61;36;4;32;.889;2560000;0
19854;11882;1477;0;0;0;0;.00nan;0;0
19854;22413;3922;0;0;0;0;.00nan;0;0
19854;63402;1477;60;28;3;25;.893;3584000;0
19854;143507;3922;70;23;2;21;.913;3600000;0
19855;67764;1871;0;0;0;0;.00nan;0;0
19855;68565;1869;0;0;0;0;.00nan;0;0
19855;86686;1869;100;35;0;35;1.000;3600000;0
19855;143036;1871;61;21;2;19;.905;3514000;0
19856;11882;1477;0;0;0;0;.00nan;0;0
19856;63402;1477;100;33;0;33;1.000;3600000;0
19856;68565;1869;0;0;0;0;.00nan;0;0
19856;86686;1869;80;30;1;29;.967;3564000;0
19857;177156;1481;0;0;0;0;.00nan;0;0
19857;7534;1481;75;37;3;34;.919;3600000;0
19857;185041;1475;0;0;0;0;.00nan;0;0
19857;44487;1475;56;29;4;25;.862;3577000;0
19858;22413;3922;0;0;0;0;.00nan;0;0
19858;64230;522;90;38;2;36;.947;3579000;0
19858;143507;3922;92;29;1;28;.966;3600000;0
19858;147264;522;0;0;0;0;.00nan;0;0
19859;11925;521;0;0;0;0;.00nan;0;0
19859;63848;521;70;17;1;16;.941;3600000;0
19859;143063;1861;0;0;0;0;.00nan;0;0
19859;152202;1861;98;52;3;49;.942;3600000;0
19860;46912;2173;37;35;6;29;.829;3018000;0
19860;47112;2193;0;0;0;0;.00nan;0;0
19860;56231;2173;40;3;1;2;.667;582000;0
19860;76951;2193;83;29;2;27;.931;3600000;0
19861;4618;1877;48;32;5;27;.844;3600000;0
19861;67764;1871;0;0;0;0;.00nan;0;0
19861;84287;1877;0;0;0;0;.00nan;0;0
19861;143036;1871;78;12;0;12;1.000;3600000;0
19862;9373;1854;69;37;3;34;.919;3591000;0
19862;68627;523;0;0;0;0;.00nan;0;0
19862;73973;523;52;16;2;14;.875;3600000;0
19862;143479;1854;0;0;0;0;.00nan;0;0
19863;4618;1877;0;0;0;0;.00nan;0;0
19863;64230;522;0;0;0;0;.00nan;0;0
19863;84287;1877;81;26;1;25;.962;3600000;0
19863;147264;522;49;24;3;21;.875;3553000;0
19864;185041;1475;70;37;3;34;.919;3562000;0
19864;44487;1475;0;0;0;0;.00nan;0;0
19864;67764;1871;0;0;0;0;.00nan;0;0
19864;143036;1871;77;23;1;22;.957;3600000;0
19865;9373;1854;46;24;3;21;.875;3600000;0
19865;46912;2173;85;17;0;17;1.000;3600000;0
19865;56231;2173;0;0;0;0;.00nan;0;0
19865;143479;1854;0;0;0;0;.00nan;0;0
19866;177156;1481;0;0;0;0;.00nan;0;0
19866;7534;1481;100;31;0;31;1.000;3600000;0
19866;47112;2193;77;23;1;22;.957;3544000;0
19866;76951;2193;0;0;0;0;.00nan;0;0
19867;11882;1477;0;0;0;0;.00nan;0;0
19867;63402;1477;75;29;2;27;.931;3600000;0
19867;143063;1861;0;0;0;0;.00nan;0;0
19867;152202;1861;63;35;4;31;.886;3600000;0
19868;11925;521;0;0;0;0;.00nan;0;0
19868;22413;3922;0;0;0;0;.00nan;0;0
19868;63848;521;87;29;1;28;.966;3600000;0
19868;143507;3922;47;28;5;23;.821;3600000;0
19869;68565;1869;0;0;0;0;.00nan;0;0
19869;68627;523;0;0;0;0;.00nan;0;0
19869;73973;523;79;13;0;13;1.000;3600000;0
19869;86686;1869;79;38;3;35;.921;3600000;0
19870;4618;1877;22;25;6;19;.760;2812000;0
19870;11882;1477;0;0;0;0;.00nan;0;0
19870;63402;1477;56;13;1;12;.923;3600000;0
19870;84287;1877;50;8;1;7;.875;788000;0
19871;64230;522;44;35;5;30;.857;3600000;0
19871;68565;1869;0;0;0;0;.00nan;0;0
19871;86686;1869;89;29;1;28;.966;3600000;0
19871;147264;522;0;0;0;0;.00nan;0;0
19872;9373;1854;0;0;0;0;.00nan;0;0
19872;11925;521;73;22;1;21;.955;3600000;0
19872;63848;521;0;0;0;0;.00nan;0;0
19872;143479;1854;83;31;2;29;.935;3558000;0
19873;177156;1481;0;0;0;0;.00nan;0;0
19873;7534;1481;54;17;2;15;.882;3600000;0
19873;46912;2173;61;29;3;26;.897;3568000;0
19873;56231;2173;0;0;0;0;.00nan;0;0
19874;22413;3922;83;25;1;24;.960;3600000;0
19874;143063;1861;55;22;2;20;.909;3596000;0
19874;143507;3922;0;0;0;0;.00nan;0;0
19874;152202;1861;0;0;0;0;.00nan;0;0
19875;47112;2193;49;24;3;21;.875;3544000;0
19875;67764;1871;0;0;0;0;.00nan;0;0
19875;76951;2193;0;0;0;0;.00nan;0;0
19875;143036;1871;73;29;2;27;.931;3600000;0
19876;185041;1475;0;0;0;0;.00nan;0;0
19876;44487;1475;69;43;4;39;.907;3513000;0
19876;68627;523;0;0;0;0;.00nan;0;0
19876;73973;523;59;16;2;14;.875;3600000;0
19877;177156;1481;0;0;0;0;.00nan;0;0
19877;7534;1481;81;33;2;31;.939;3600000;0
19877;67764;1871;49;1;0;1;1.000;366000;0
19877;143036;1871;26;28;6;22;.786;3234000;0
19878;4618;1877;0;0;0;0;.00nan;0;0
19878;68627;523;0;0;0;0;.00nan;0;0
19878;73973;523;64;11;1;10;.909;3600000;0
19878;84287;1877;60;38;4;34;.895;3600000;0
19879;44487;1475;68;22;2;20;.909;3600000;0
19879;46912;2173;70;33;3;30;.909;3577000;0
19879;56231;2173;0;0;0;0;.00nan;0;0
19879;85507;1475;0;0;0;0;.00nan;0;0
19880;9373;1854;33;32;6;26;.813;2693000;0
19880;11882;1477;0;0;0;0;.00nan;0;0
19880;63402;1477;52;14;2;12;.857;3600000;0
19880;143479;1854;14;7;4;3;.429;907000;0
19881;22413;3922;52;20;3;17;.850;1082000;0
19881;47112;2193;0;0;0;0;.00nan;0;0
19881;76951;2193;100;26;0;26;1.000;3600000;0
19881;143507;3922;23;28;6;22;.786;2518000;0
19882;64230;522;92;24;0;24;1.000;3600000;0
19882;143063;1861;59;29;3;26;.897;3588000;0
19882;147264;522;0;0;0;0;.00nan;0;0
19882;152202;1861;0;0;0;0;.00nan;0;0
19883;11925;521;0;0;0;0;.00nan;0;0
19883;63848;521;56;30;3;27;.900;3600000;0
19883;68565;1869;0;0;0;0;.00nan;0;0
19883;86686;1869;81;34;2;32;.941;3600000;0
19884;177156;1481;0;0;0;0;.00nan;0;0
19884;7534;1481;100;45;2;43;.956;3900000;0
19884;68627;523;0;0;0;0;.00nan;0;0
19884;73973;523;72;30;2;28;.933;3900000;0
19885;4618;1877;47;29;5;24;.828;3573000;0
19885;84287;1877;0;0;0;0;.00nan;0;0
19885;143063;1861;0;0;0;0;.00nan;0;0
19885;152202;1861;62;34;3;31;.912;3600000;0
19886;11925;521;0;0;0;0;.00nan;0;0
19886;44487;1475;84;30;2;28;.933;3600000;0
19886;63848;521;69;19;1;18;.947;3600000;0
19886;85507;1475;0;0;0;0;.00nan;0;0
19887;9373;1854;0;0;0;0;.00nan;0;0
19887;67764;1871;0;0;0;0;.00nan;0;0
19887;143036;1871;70;19;1;18;.947;3746000;0
19887;143479;1854;74;31;2;29;.935;3746000;0
19888;47112;2193;0;0;0;0;.00nan;0;0
19888;64230;522;0;0;0;0;.00nan;0;0
19888;76951;2193;87;34;2;32;.941;3600000;0
19888;147264;522;82;50;5;45;.900;3600000;0
19889;11882;1477;0;0;0;0;.00nan;0;0
19889;46912;2173;63;48;5;43;.896;3514000;0
19889;56231;2173;0;0;0;0;.00nan;0;0
19889;63402;1477;58;24;3;21;.875;3600000;0
19890;22413;3922;0;0;0;0;.00nan;0;0
19890;68565;1869;0;0;0;0;.00nan;0;0
19890;86686;1869;58;23;3;20;.870;3600000;0
19890;143507;3922;77;46;4;42;.913;3600000;0
19891;177156;1481;0;0;0;0;.00nan;0;0
19891;7534;1481;55;44;6;38;.864;3600000;0
19891;11882;1477;0;0;0;0;.00nan;0;0
19891;63402;1477;85;26;1;25;.962;3600000;0
19892;9373;1854;91;49;3;46;.939;3600000;0
19892;64230;522;61;21;2;19;.905;3600000;0
19892;143479;1854;0;0;0;0;.00nan;0;0
19892;147264;522;0;0;0;0;.00nan;0;0
19893;4618;1877;0;0;0;0;.00nan;0;0
19893;11925;521;51;24;3;21;.875;3600000;0
19893;63848;521;0;0;0;0;.00nan;0;0
19893;84287;1877;76;41;4;37;.902;3600000;0
19894;68565;1869;52;0;0;0;.00nan;1200000;0
19894;86686;1869;7;15;6;9;.600;2700000;0
19894;143063;1861;41;37;6;31;.838;3030000;0
19894;152202;1861;78;13;0;13;1.000;870000;0
19895;22413;3922;0;0;0;0;.00nan;0;0
19895;44487;1475;91;41;2;39;.951;3570000;0
19895;85507;1475;0;0;0;0;.00nan;0;0
19895;143507;3922;100;29;0;29;1.000;3600000;0
19896;46912;2173;56;35;4;31;.886;3600000;0
19896;56231;2173;0;0;0;0;.00nan;0;0
19896;67764;1871;0;0;0;0;.00nan;0;0
19896;143036;1871;61;19;2;17;.895;3600000;0
19897;47112;2193;0;0;0;0;.00nan;0;0
19897;68627;523;0;0;0;0;.00nan;0;0
19897;73973;523;89;15;0;15;1.000;3900000;0
19897;76951;2193;96;39;0;39;1.000;3900000;0
19898;177156;1481;0;0;0;0;.00nan;0;0
19898;7534;1481;47;32;4;28;.875;3559000;0
19898;64230;522;0;0;0;0;.00nan;0;0
19898;147264;522;69;28;2;26;.929;3600000;0
19899;4618;1877;68;34;4;30;.882;3567000;0
19899;68565;1869;0;0;0;0;.00nan;0;0
19899;84287;1877;0;0;0;0;.00nan;0;0
19899;86686;1869;73;27;2;25;.926;3600000;0
19900;11882;1477;0;0;0;0;.00nan;0;0
19900;44487;1475;85;33;2;31;.939;3516000;0
19900;63402;1477;93;20;0;20;1.000;3600000;0
19900;85507;1475;0;0;0;0;.00nan;0;0
19901;9373;1854;45;24;4;20;.833;3635000;0
19901;22413;3922;0;0;0;0;.00nan;0;0
19901;143479;1854;0;0;0;0;.00nan;0;0
19901;143507;3922;57;26;3;23;.885;3635000;0
19902;47112;2193;0;0;0;0;.00nan;0;0
19902;76951;2193;83;9;0;9;1.000;3600000;0
19902;143063;1861;0;0;0;0;.00nan;0;0
19902;152202;1861;89;47;3;44;.936;3600000;0
19903;11925;521;66;25;2;23;.920;3900000;0
19903;46912;2173;0;0;0;0;.00nan;0;0
19903;56231;2173;84;46;2;44;.957;3900000;0
19903;63848;521;0;0;0;0;.00nan;0;0
19904;67764;1871;0;0;0;0;.00nan;0;0
19904;68627;523;0;0;0;0;.00nan;0;0
19904;73973;523;66;16;1;15;.938;3900000;0
19904;143036;1871;92;30;1;29;.967;3900000;0
19905;11882;1477;0;0;0;0;.00nan;0;0
19905;63402;1477;70;31;3;28;.903;3600000;0
19905;67764;1871;0;0;0;0;.00nan;0;0
19905;143036;1871;80;24;2;22;.917;3600000;0
19906;44487;1475;57;24;3;21;.875;3600000;0
19906;64230;522;62;28;4;24;.857;3551000;0
19906;85507;1475;0;0;0;0;.00nan;0;0
19906;147264;522;0;0;0;0;.00nan;0;0
19907;11925;521;72;28;2;26;.929;3600000;0
19907;47112;2193;0;0;0;0;.00nan;0;0
19907;63848;521;0;0;0;0;.00nan;0;0
19907;76951;2193;52;21;3;18;.857;3600000;0
19908;9373;1854;89;32;1;31;.969;3900000;0
19908;143063;1861;0;0;0;0;.00nan;0;0
19908;143479;1854;0;0;0;0;.00nan;0;0
19908;152202;1861;72;23;1;22;.957;3900000;0
19909;4618;1877;0;0;0;0;.00nan;0;0
19909;22413;3922;0;0;0;0;.00nan;0;0
19909;84287;1877;76;41;4;37;.902;3545000;0
19909;143507;3922;74;32;3;29;.906;3600000;0
19910;177156;1481;0;0;0;0;.00nan;0;0
19910;7534;1481;84;17;0;17;1.000;3600000;0
19910;68565;1869;0;0;0;0;.00nan;0;0
19910;86686;1869;70;39;4;35;.897;3600000;0
19911;46912;2173;43;32;6;26;.813;2954000;0
19911;56231;2173;60;7;0;7;1.000;646000;0
19911;68627;523;0;0;0;0;.00nan;0;0
19911;73973;523;65;21;2;19;.905;3600000;0
19912;177156;1481;0;0;0;0;.00nan;0;0
19912;7534;1481;85;32;1;31;.969;3900000;0
19912;22413;3922;0;0;0;0;.00nan;0;0
19912;143507;3922;82;24;1;23;.958;3900000;0
19913;4618;1877;89;43;3;40;.930;3632000;0
19913;44487;1475;75;26;2;24;.923;3632000;0
19913;84287;1877;0;0;0;0;.00nan;0;0
19913;85507;1475;0;0;0;0;.00nan;0;0
19914;9373;1854;0;0;0;0;.00nan;0;0
19914;68565;1869;0;0;0;0;.00nan;0;0
19914;86686;1869;74;25;2;23;.920;3716000;0
19914;143479;1854;73;39;3;36;.923;3716000;0
19915;11882;1477;0;0;0;0;.00nan;0;0
19915;47112;2193;0;0;0;0;.00nan;0;0
19915;63402;1477;85;28;1;27;.964;3600000;0
19915;76951;2193;67;28;3;25;.893;3579000;0
19916;46912;2173;0;0;0;0;.00nan;0;0
19916;56231;2173;90;33;2;31;.939;3600000;0
19916;143063;1861;0;0;0;0;.00nan;0;0
19916;152202;1861;51;32;4;28;.875;3573000;0
19917;11925;521;56;28;4;24;.857;3900000;0
19917;63848;521;0;0;0;0;.00nan;0;0
19917;67764;1871;0;0;0;0;.00nan;0;0
19917;143036;1871;86;42;4;38;.905;3900000;0
19918;64230;522;0;0;0;0;.00nan;0;0
19918;68627;523;0;0;0;0;.00nan;0;0
19918;73973;523;46;20;3;17;.850;3588000;0
19918;147264;522;79;35;2;33;.943;3600000;0
19919;11882;1477;0;0;0;0;.00nan;0;0
19919;63402;1477;74;42;5;37;.881;3600000;0
19919;68627;523;0;0;0;0;.00nan;0;0
19919;73973;523;66;22;2;20;.909;3600000;0
19920;64230;522;100;51;2;49;.961;3600000;0
19920;67764;1871;0;0;0;0;.00nan;0;0
19920;143036;1871;71;27;3;24;.889;3579000;0
19920;147264;522;0;0;0;0;.00nan;0;0
19921;4618;1877;0;0;0;0;.00nan;0;0
19921;9373;1854;71;35;3;32;.914;3649000;0
19921;84287;1877;64;31;4;27;.871;3649000;0
19921;143479;1854;0;0;0;0;.00nan;0;0
19922;177156;1481;0;0;0;0;.00nan;0;0
19922;7534;1481;85;27;2;25;.926;3748000;0
19922;11925;521;85;32;1;31;.969;3748000;0
19922;63848;521;0;0;0;0;.00nan;0;0
19923;44487;1475;70;26;2;24;.923;3558000;0
19923;85507;1475;0;0;0;0;.00nan;0;0
19923;143063;1861;94;30;1;29;.967;3600000;0
19923;152202;1861;0;0;0;0;.00nan;0;0
19924;22413;3922;93;29;1;28;.966;3600000;0
19924;46912;2173;55;30;4;26;.867;3600000;0
19924;56231;2173;0;0;0;0;.00nan;0;0
19924;143507;3922;0;0;0;0;.00nan;0;0
19925;47112;2193;0;0;0;0;.00nan;0;0
19925;68565;1869;0;0;0;0;.00nan;0;0
19925;76951;2193;60;24;2;22;.917;3600000;0
19925;86686;1869;93;37;1;36;.973;3600000;0
19926;11882;1477;85;28;2;26;.929;3900000;0
19926;11925;521;85;30;2;28;.933;3900000;0
19926;63402;1477;0;0;0;0;.00nan;0;0
19926;63848;521;0;0;0;0;.00nan;0;0
19927;177156;1481;0;0;0;0;.00nan;0;0
19927;4618;1877;62;44;6;38;.864;2973000;0
19927;7534;1481;43;11;2;9;.818;3600000;0
19927;84287;1877;64;11;0;11;1.000;627000;0
19928;44487;1475;0;0;0;0;.00nan;0;0
19928;68565;1869;0;0;0;0;.00nan;0;0
19928;85507;1475;58;21;2;19;.905;3544000;0
19928;86686;1869;98;39;1;38;.974;3600000;0
19929;9373;1854;0;0;0;0;.00nan;0;0
19929;47112;2193;46;21;3;18;.857;3543000;0
19929;76951;2193;0;0;0;0;.00nan;0;0
19929;143479;1854;83;31;2;29;.935;3600000;0
19930;46912;2173;74;34;2;32;.941;3600000;0
19930;56231;2173;0;0;0;0;.00nan;0;0
19930;64230;522;0;0;0;0;.00nan;0;0
19930;147264;522;57;21;3;18;.857;3551000;0
19931;67764;1871;0;0;0;0;.00nan;0;0
19931;143036;1871;57;24;3;21;.875;3546000;0
19931;143063;1861;0;0;0;0;.00nan;0;0
19931;152202;1861;87;29;1;28;.966;3600000;0
19932;22413;3922;53;2;0;2;1.000;315000;0
19932;68627;523;0;0;0;0;.00nan;0;0
19932;73973;523;65;22;2;20;.909;3600000;0
19932;143507;3922;67;36;4;32;.889;3203000;0
19933;11882;1477;0;0;0;0;.00nan;0;0
19933;63402;1477;52;30;4;26;.867;3582000;0
19933;64230;522;0;0;0;0;.00nan;0;0
19933;147264;522;79;30;2;28;.933;3600000;0
19934;4618;1877;72;40;3;37;.925;3593000;0
19934;47112;2193;56;17;2;15;.882;3600000;0
19934;76951;2193;0;0;0;0;.00nan;0;0
19934;84287;1877;0;0;0;0;.00nan;0;0
19935;9373;1854;83;24;1;23;.958;3600000;0
19935;44487;1475;62;17;2;15;.882;3569000;0
19935;85507;1475;0;0;0;0;.00nan;0;0
19935;143479;1854;0;0;0;0;.00nan;0;0
19936;11925;521;76;35;3;32;.914;3600000;0
19936;63848;521;0;0;0;0;.00nan;0;0
19936;68627;523;42;14;3;11;.786;2857000;0
19936;73973;523;24;11;4;7;.636;743000;0
19937;177156;1481;0;0;0;0;.00nan;0;0
19937;7534;1481;66;20;2;18;.900;3600000;0
19937;143063;1861;66;35;3;32;.914;3216000;0
19937;152202;1861;26;8;3;5;.625;384000;0
19938;22413;3922;0;0;0;0;.00nan;0;0
19938;67764;1871;0;0;0;0;.00nan;0;0
19938;143036;1871;66;27;3;24;.889;3600000;0
19938;143507;3922;57;27;4;23;.852;3583000;0
19939;46912;2173;69;34;3;31;.912;3570000;0
19939;56231;2173;0;0;0;0;.00nan;0;0
19939;68565;1869;74;17;1;16;.941;3600000;0
19939;86686;1869;0;0;0;0;.00nan;0;0
19940;11882;1477;0;0;0;0;.00nan;0;0
19940;22413;3922;0;0;0;0;.00nan;0;0
19940;63402;1477;100;27;0;27;1.000;3600000;0
19940;143507;3922;52;44;6;38;.864;3600000;0
19941;177156;1481;54;28;3;25;.893;3545000;0
19941;7534;1481;0;0;0;0;.00nan;0;0
19941;9373;1854;88;44;2;42;.955;3600000;0
19941;143479;1854;0;0;0;0;.00nan;0;0
19942;44487;1475;41;2;1;1;.500;306000;0
19942;47112;2193;0;0;0;0;.00nan;0;0
19942;76951;2193;84;25;1;24;.960;3600000;0
19942;85507;1475;32;38;7;31;.816;3294000;0
19943;11925;521;72;29;3;26;.897;3546000;0
19943;63848;521;0;0;0;0;.00nan;0;0
19943;64230;522;83;32;2;30;.938;3600000;0
19943;147264;522;0;0;0;0;.00nan;0;0
19944;4618;1877;0;0;0;0;.00nan;0;0
19944;46912;2173;0;0;0;0;.00nan;0;0
19944;56231;2173;77;39;2;37;.949;3900000;0
19944;84287;1877;96;43;2;41;.953;3900000;0
19945;67764;1871;0;0;0;0;.00nan;0;0
19945;68565;1869;0;0;0;0;.00nan;0;0
19945;86686;1869;100;36;1;35;.972;3600000;0
19945;143036;1871;40;16;3;13;.813;3524000;0
19946;68627;523;0;0;0;0;.00nan;0;0
19946;73973;523;64;18;2;16;.889;3900000;0
19946;143063;1861;100;55;2;53;.964;3900000;0
19946;152202;1861;0;0;0;0;.00nan;0;0
19947;4618;1877;70;37;4;33;.892;3600000;0
19947;67764;1871;0;0;0;0;.00nan;0;0
19947;84287;1877;0;0;0;0;.00nan;0;0
19947;143036;1871;70;20;1;19;.950;3600000;0
19948;177156;1481;0;0;0;0;.00nan;0;0
19948;7534;1481;54;41;5;36;.878;3600000;0
19948;44487;1475;90;38;2;36;.947;3600000;0
19948;85507;1475;0;0;0;0;.00nan;0;0
19949;9373;1854;89;42;2;40;.952;3600000;0
19949;68627;523;0;0;0;0;.00nan;0;0
19949;73973;523;28;23;5;18;.783;3600000;0
19949;143479;1854;0;0;0;0;.00nan;0;0
19950;46912;2173;75;41;3;38;.927;3732000;0
19950;47112;2193;64;18;2;16;.889;3732000;0
19950;56231;2173;0;0;0;0;.00nan;0;0
19950;76951;2193;0;0;0;0;.00nan;0;0
19951;11925;521;71;20;1;19;.950;3546000;0
19951;63848;521;0;0;0;0;.00nan;0;0
19951;143063;1861;100;28;0;28;1.000;3600000;0
19951;152202;1861;0;0;0;0;.00nan;0;0
19952;22413;3922;96;31;1;30;.968;3600000;0
19952;64230;522;0;0;0;0;.00nan;0;0
19952;143507;3922;0;0;0;0;.00nan;0;0
19952;147264;522;82;35;2;33;.943;3544000;0
19953;11882;1477;0;0;0;0;.00nan;0;0
19953;63402;1477;96;20;0;20;1.000;3600000;0
19953;68565;1869;0;0;0;0;.00nan;0;0
19953;86686;1869;92;35;2;33;.943;3568000;0
19954;11882;1477;0;0;0;0;.00nan;0;0
19954;63402;1477;66;19;1;18;.947;3600000;0
19954;143063;1861;88;55;5;50;.909;3600000;0
19954;152202;1861;0;0;0;0;.00nan;0;0
19955;177156;1481;0;0;0;0;.00nan;0;0
19955;7534;1481;99;35;1;34;.971;3600000;0
19955;47112;2193;62;23;2;21;.913;3541000;0
19955;76951;2193;0;0;0;0;.00nan;0;0
19956;4618;1877;0;0;0;0;.00nan;0;0
19956;64230;522;88;22;1;21;.955;3900000;0
19956;84287;1877;88;29;1;28;.966;3900000;0
19956;147264;522;0;0;0;0;.00nan;0;0
19957;11925;521;0;0;0;0;.00nan;0;0
19957;22413;3922;0;0;0;0;.00nan;0;0
19957;63848;521;39;24;4;20;.833;3558000;0
19957;143507;3922;68;28;3;25;.893;3600000;0
19958;9373;1854;77;41;3;38;.927;3519000;0
19958;46912;2173;71;17;1;16;.941;3600000;0
19958;56231;2173;0;0;0;0;.00nan;0;0
19958;143479;1854;0;0;0;0;.00nan;0;0
19959;44487;1475;77;31;1;30;.968;3600000;0
19959;67764;1871;98;24;0;24;1.000;3600000;0
19959;85507;1475;0;0;0;0;.00nan;0;0
19959;143036;1871;0;0;0;0;.00nan;0;0
19960;68565;1869;0;0;0;0;.00nan;0;0
19960;68627;523;0;0;0;0;.00nan;0;0
19960;73973;523;60;21;2;19;.905;3600000;0
19960;86686;1869;56;33;5;28;.848;3600000;0
19961;177156;1481;0;0;0;0;.00nan;0;0
19961;7534;1481;64;27;2;25;.926;3893000;0
19961;46912;2173;91;39;2;37;.949;3900000;0
19961;56231;2173;0;0;0;0;.00nan;0;0
19962;4618;1877;95;35;3;32;.914;3565000;0
19962;11882;1477;0;0;0;0;.00nan;0;0
19962;63402;1477;59;13;1;12;.923;3600000;0
19962;84287;1877;0;0;0;0;.00nan;0;0
19963;44487;1475;53;3;0;3;1.000;345000;0
19963;68627;523;79;13;0;13;1.000;3600000;0
19963;73973;523;0;0;0;0;.00nan;0;0
19963;85507;1475;50;40;6;34;.850;3255000;0
19964;9373;1854;0;0;0;0;.00nan;0;0
19964;11925;521;67;24;2;22;.917;3600000;0
19964;63848;521;0;0;0;0;.00nan;0;0
19964;143479;1854;91;30;1;29;.967;3600000;0
19965;47112;2193;0;0;0;0;.00nan;0;0
19965;67764;1871;83;37;2;35;.946;3514000;0
19965;76951;2193;98;23;0;23;1.000;3600000;0
19965;143036;1871;0;0;0;0;.00nan;0;0
19966;22413;3922;0;0;0;0;.00nan;0;0
19966;143063;1861;0;0;0;0;.00nan;0;0
19966;143507;3922;68;38;4;34;.895;3600000;0
19966;152202;1861;100;36;0;36;1.000;3600000;0
19967;64230;522;0;0;0;0;.00nan;0;0
19967;68565;1869;0;0;0;0;.00nan;0;0
19967;86686;1869;75;36;3;33;.917;3600000;0
19967;147264;522;28;22;5;17;.773;3518000;0
19968;9373;1854;46;42;5;37;.881;3600000;0
19968;11882;1477;0;0;0;0;.00nan;0;0
19968;63402;1477;63;18;2;16;.889;3600000;0
19968;143479;1854;0;0;0;0;.00nan;0;0
19969;64230;522;43;22;3;19;.864;3541000;0
19969;143063;1861;0;0;0;0;.00nan;0;0
19969;147264;522;0;0;0;0;.00nan;0;0
19969;152202;1861;94;44;2;42;.955;3600000;0
19970;11925;521;0;0;0;0;.00nan;0;0
19970;63848;521;100;25;0;25;1.000;3600000;0
19970;68565;1869;0;0;0;0;.00nan;0;0
19970;86686;1869;85;38;3;35;.921;3600000;0
19971;44487;1475;33;26;5;21;.808;3600000;0
19971;46912;2173;89;35;2;33;.943;3600000;0
19971;56231;2173;0;0;0;0;.00nan;0;0
19971;85507;1475;0;0;0;0;.00nan;0;0
19972;22413;3922;47;28;4;24;.857;3552000;0
19972;47112;2193;0;0;0;0;.00nan;0;0
19972;76951;2193;61;18;2;16;.889;3600000;0
19972;143507;3922;0;0;0;0;.00nan;0;0
19973;177156;1481;0;0;0;0;.00nan;0;0
19973;7534;1481;83;16;0;16;1.000;3600000;0
19973;67764;1871;0;0;0;0;.00nan;0;0
19973;143036;1871;50;32;5;27;.844;3600000;0
19974;4618;1877;58;32;4;28;.875;3546000;0
19974;68627;523;47;13;2;11;.846;3600000;0
19974;73973;523;0;0;0;0;.00nan;0;0
19974;84287;1877;0;0;0;0;.00nan;0;0
19975;11882;1477;0;0;0;0;.00nan;0;0
19975;46912;2173;58;26;3;23;.885;3589000;0
19975;56231;2173;0;0;0;0;.00nan;0;0
19975;63402;1477;65;18;2;16;.889;3600000;0
19976;47112;2193;0;0;0;0;.00nan;0;0
19976;64230;522;0;0;0;0;.00nan;0;0
19976;76951;2193;43;27;5;22;.815;3900000;0
19976;147264;522;79;53;5;48;.906;3900000;0
19977;11925;521;64;16;1;15;.938;3600000;0
19977;44487;1475;0;0;0;0;.00nan;0;0
19977;63848;521;0;0;0;0;.00nan;0;0
19977;85507;1475;53;29;4;25;.862;3600000;0
19978;4618;1877;87;37;2;35;.946;3600000;0
19978;84287;1877;0;0;0;0;.00nan;0;0
19978;143063;1861;52;29;4;25;.862;3514000;0
19978;152202;1861;0;0;0;0;.00nan;0;0
19979;22413;3922;0;0;0;0;.00nan;0;0
19979;68565;1869;0;0;0;0;.00nan;0;0
19979;86686;1869;56;25;3;22;.880;3600000;0
19979;143507;3922;44;34;5;29;.853;3559000;0
19980;9373;1854;93;38;1;37;.974;3572000;0
19980;67764;1871;0;0;0;0;.00nan;0;0
19980;143036;1871;83;14;0;14;1.000;3600000;0
19980;143479;1854;0;0;0;0;.00nan;0;0
19981;177156;1481;0;0;0;0;.00nan;0;0
19981;7534;1481;85;46;4;42;.913;3600000;0
19981;68627;523;0;0;0;0;.00nan;0;0
19981;73973;523;78;26;1;25;.962;3600000;0
19982;177156;1481;0;0;0;0;.00nan;0;0
19982;7534;1481;97;37;2;35;.946;3600000;0
19982;11882;1477;0;0;0;0;.00nan;0;0
19982;63402;1477;75;25;1;24;.960;3600000;0
19983;4618;1877;57;49;6;43;.878;3600000;0
19983;11925;521;72;16;1;15;.938;3600000;0
19983;63848;521;0;0;0;0;.00nan;0;0
19983;84287;1877;0;0;0;0;.00nan;0;0
19984;22413;3922;0;0;0;0;.00nan;0;0
19984;44487;1475;30;26;6;20;.769;3600000;0
19984;85507;1475;0;0;0;0;.00nan;0;0
19984;143507;3922;87;29;1;28;.966;3600000;0
19985;9373;1854;65;33;5;28;.848;3600000;0
19985;64230;522;73;23;2;21;.913;3600000;0
19985;143479;1854;0;0;0;0;.00nan;0;0
19985;147264;522;0;0;0;0;.00nan;0;0
19986;47112;2193;69;14;1;13;.929;3600000;0
19986;68627;523;0;0;0;0;.00nan;0;0
19986;73973;523;79;46;4;42;.913;3600000;0
19986;76951;2193;0;0;0;0;.00nan;0;0
19987;46912;2173;0;0;0;0;.00nan;0;0
19987;56231;2173;73;53;5;48;.906;3600000;0
19987;67764;1871;0;0;0;0;.00nan;0;0
19987;143036;1871;54;13;2;11;.846;3600000;0
19988;68565;1869;0;0;0;0;.00nan;0;0
19988;86686;1869;62;21;2;19;.905;3600000;0
19988;143063;1861;43;28;4;24;.857;3600000;0
19988;152202;1861;0;0;0;0;.00nan;0;0
19989;11882;1477;0;0;0;0;.00nan;0;0
19989;44487;1475;40;35;6;29;.829;3080000;0
19989;63402;1477;52;28;4;24;.857;3600000;0
19989;85507;1475;73;14;0;14;1.000;502000;0
19990;177156;1481;0;0;0;0;.00nan;0;0
19990;7534;1481;88;24;1;23;.958;3600000;0
19990;64230;522;0;0;0;0;.00nan;0;0
19990;147264;522;79;34;2;32;.941;3600000;0
19991;11925;521;85;23;1;22;.957;3600000;0
19991;46912;2173;98;50;2;48;.960;3600000;0
19991;56231;2173;0;0;0;0;.00nan;0;0
19991;63848;521;0;0;0;0;.00nan;0;0
19992;47112;2193;0;0;0;0;.00nan;0;0
19992;76951;2193;86;25;1;24;.960;3600000;0
19992;143063;1861;0;0;0;0;.00nan;0;0
19992;152202;1861;61;46;5;41;.891;3600000;0
19993;9373;1854;49;31;5;26;.839;3600000;0
19993;22413;3922;0;0;0;0;.00nan;0;0
19993;143479;1854;0;0;0;0;.00nan;0;0
19993;143507;3922;67;17;1;16;.941;3600000;0
19994;4618;1877;96;41;2;39;.951;3563000;0
19994;68565;1869;0;0;0;0;.00nan;0;0
19994;84287;1877;0;0;0;0;.00nan;0;0
19994;86686;1869;100;26;0;26;1.000;3600000;0
19995;67764;1871;0;0;0;0;.00nan;0;0
19995;68627;523;0;0;0;0;.00nan;0;0
19995;73973;523;62;22;2;20;.909;3600000;0
19995;143036;1871;58;21;3;18;.857;3600000;0
19996;177156;1481;0;0;0;0;.00nan;0;0
19996;7534;1481;50;26;4;22;.846;3600000;0
19996;68565;1869;0;0;0;0;.00nan;0;0
19996;86686;1869;47;38;6;32;.842;3600000;0
19997;4618;1877;0;0;0;0;.00nan;0;0
19997;22413;3922;0;0;0;0;.00nan;0;0
19997;84287;1877;84;30;1;29;.967;3600000;0
19997;143507;3922;81;34;2;32;.941;3563000;0
19998;44487;1475;62;29;3;26;.897;3600000;0
19998;64230;522;27;15;4;11;.733;972000;0
19998;85507;1475;0;0;0;0;.00nan;0;0
19998;147264;522;49;28;4;24;.857;2628000;0
19999;9373;1854;0;0;0;0;.00nan;0;0
19999;143063;1861;0;0;0;0;.00nan;0;0
19999;143479;1854;53;22;3;19;.864;3600000;0
19999;152202;1861;51;34;4;30;.882;3600000;0
20000;11925;521;99;39;2;37;.949;3600000;0
20000;47112;2193;34;26;5;21;.808;3600000;0
20000;63848;521;0;0;0;0;.00nan;0;0
20000;76951;2193;0;0;0;0;.00nan;0;0
20001;46912;2173;75;47;3;44;.936;3600000;0
20001;56231;2173;0;0;0;0;.00nan;0;0
20001;68627;523;0;0;0;0;.00nan;0;0
20001;73973;523;80;18;1;17;.944;3600000;0
20002;11882;1477;0;0;0;0;.00nan;0;0
20002;63402;1477;79;24;1;23;.958;3600000;0
20002;67764;1871;0;0;0;0;.00nan;0;0
20002;143036;1871;54;26;3;23;.885;3571000;0
20003;11882;1477;0;0;0;0;.00nan;0;0
20003;47112;2193;62;20;2;18;.900;3600000;0
20003;63402;1477;71;42;5;37;.881;3600000;0
20003;76951;2193;0;0;0;0;.00nan;0;0
20004;64230;522;0;0;0;0;.00nan;0;0
20004;68627;523;0;0;0;0;.00nan;0;0
20004;73973;523;87;17;0;17;1.000;3600000;0
20004;147264;522;84;41;3;38;.927;3600000;0
20005;4618;1877;90;33;2;31;.939;3600000;0
20005;44487;1475;54;19;3;16;.842;3570000;0
20005;84287;1877;0;0;0;0;.00nan;0;0
20005;85507;1475;0;0;0;0;.00nan;0;0
20006;11925;521;0;0;0;0;.00nan;0;0
20006;63848;521;46;28;5;23;.821;3757000;0
20006;67764;1871;0;0;0;0;.00nan;0;0
20006;143036;1871;43;20;4;16;.800;3757000;0
20007;46912;2173;64;23;2;21;.913;3600000;0
20007;56231;2173;0;0;0;0;.00nan;0;0
20007;143063;1861;0;0;0;0;.00nan;0;0
20007;152202;1861;61;30;5;25;.833;3600000;0
20008;177156;1481;0;0;0;0;.00nan;0;0
20008;7534;1481;64;37;4;33;.892;3600000;0
20008;22413;3922;87;44;3;41;.932;3600000;0
20008;143507;3922;0;0;0;0;.00nan;0;0
20009;9373;1854;88;30;2;28;.933;3600000;0
20009;68565;1869;0;0;0;0;.00nan;0;0
20009;86686;1869;50;22;4;18;.818;3600000;0
20009;143479;1854;0;0;0;0;.00nan;0;0
20010;177156;1481;0;0;0;0;.00nan;0;0
20010;7534;1481;64;33;4;29;.879;3600000;0
20010;11925;521;34;26;5;21;.808;3521000;0
20010;63848;521;0;0;0;0;.00nan;0;0
20011;44487;1475;0;0;0;0;.00nan;0;0
20011;85507;1475;53;20;3;17;.850;3526000;0
20011;143063;1861;0;0;0;0;.00nan;0;0
20011;152202;1861;99;54;1;53;.981;3600000;0
20012;4618;1877;72;32;3;29;.906;3600000;0
20012;9373;1854;93;20;0;20;1.000;3600000;0
20012;84287;1877;0;0;0;0;.00nan;0;0
20012;143479;1854;0;0;0;0;.00nan;0;0
20013;47112;2193;55;13;1;12;.923;3600000;0
20013;68565;1869;0;0;0;0;.00nan;0;0
20013;76951;2193;0;0;0;0;.00nan;0;0
20013;86686;1869;51;42;6;36;.857;3600000;0
20014;22413;3922;0;0;0;0;.00nan;0;0
20014;46912;2173;88;42;2;40;.952;3600000;0
20014;56231;2173;0;0;0;0;.00nan;0;0
20014;143507;3922;56;29;4;25;.862;3531000;0
20015;64230;522;78;29;2;27;.931;3900000;0
20015;67764;1871;0;0;0;0;.00nan;0;0
20015;143036;1871;79;28;2;26;.929;3900000;0
20015;147264;522;0;0;0;0;.00nan;0;0
20016;11882;1477;0;0;0;0;.00nan;0;0
20016;63402;1477;87;43;2;41;.953;3545000;0
20016;68627;523;0;0;0;0;.00nan;0;0
20016;73973;523;87;22;1;21;.955;3600000;0
20017;46912;2173;70;49;6;43;.878;3600000;0
20017;56231;2173;0;0;0;0;.00nan;0;0
20017;64230;522;0;0;0;0;.00nan;0;0
20017;147264;522;85;13;0;13;1.000;3600000;0
20018;177156;1481;0;0;0;0;.00nan;0;0
20018;4618;1877;20;27;6;21;.778;2204000;0
20018;7534;1481;98;27;1;26;.963;3600000;0
20018;84287;1877;49;7;1;6;.857;1396000;0
20019;9373;1854;98;54;2;52;.963;3600000;0
20019;47112;2193;76;9;0;9;1.000;3600000;0
20019;76951;2193;0;0;0;0;.00nan;0;0
20019;143479;1854;0;0;0;0;.00nan;0;0
20020;11882;1477;0;0;0;0;.00nan;0;0
20020;11925;521;85;32;1;31;.969;3900000;0
20020;63402;1477;90;21;1;20;.952;3900000;0
20020;63848;521;0;0;0;0;.00nan;0;0
20021;67764;1871;0;0;0;0;.00nan;0;0
20021;143036;1871;72;20;1;19;.950;3600000;0
20021;143063;1861;89;40;2;38;.950;3547000;0
20021;152202;1861;0;0;0;0;.00nan;0;0
20022;22413;3922;58;39;5;34;.872;3600000;0
20022;68627;523;0;0;0;0;.00nan;0;0
20022;73973;523;74;29;2;27;.931;3600000;0
20022;143507;3922;0;0;0;0;.00nan;0;0
20023;44487;1475;65;25;3;22;.880;3552000;0
20023;68565;1869;0;0;0;0;.00nan;0;0
20023;85507;1475;0;0;0;0;.00nan;0;0
20023;86686;1869;76;26;1;25;.962;3600000;0
20024;11882;1477;0;0;0;0;.00nan;0;0
20024;63402;1477;92;29;1;28;.966;3600000;0
20024;64230;522;0;0;0;0;.00nan;0;0
20024;147264;522;41;38;6;32;.842;3600000;0
20025;177156;1481;0;0;0;0;.00nan;0;0
20025;7534;1481;91;16;0;16;1.000;3600000;0
20025;143063;1861;0;0;0;0;.00nan;0;0
20025;152202;1861;87;46;3;43;.935;3600000;0
20026;9373;1854;67;26;2;24;.923;3514000;0
20026;44487;1475;95;23;0;23;1.000;3600000;0
20026;85507;1475;0;0;0;0;.00nan;0;0
20026;143479;1854;0;0;0;0;.00nan;0;0
20027;4618;1877;45;49;7;42;.857;3132000;0
20027;47112;2193;59;10;1;9;.900;3600000;0
20027;76951;2193;0;0;0;0;.00nan;0;0
20027;84287;1877;42;4;1;3;.750;468000;0
20028;46912;2173;0;0;0;0;.00nan;0;0
20028;56231;2173;74;48;4;44;.917;3890000;0
20028;68565;1869;0;0;0;0;.00nan;0;0
20028;86686;1869;70;27;3;24;.889;3890000;0
20029;22413;3922;98;47;1;46;.979;3874000;0
20029;67764;1871;0;0;0;0;.00nan;0;0
20029;143036;1871;54;18;2;16;.889;3874000;0
20029;143507;3922;0;0;0;0;.00nan;0;0
20030;11925;521;95;35;1;34;.971;3600000;0
20030;63848;521;0;0;0;0;.00nan;0;0
20030;68627;523;0;0;0;0;.00nan;0;0
20030;73973;523;74;21;2;19;.905;3546000;0
20031;11925;521;54;19;2;17;.895;3548000;0
20031;63848;521;0;0;0;0;.00nan;0;0
20031;64230;522;90;32;1;31;.969;3600000;0
20031;147264;522;0;0;0;0;.00nan;0;0
20032;4618;1877;0;0;0;0;.00nan;0;0
20032;46912;2173;59;33;4;29;.879;3900000;0
20032;56231;2173;0;0;0;0;.00nan;0;0
20032;84287;1877;60;34;4;30;.882;3900000;0
20033;177156;1481;0;0;0;0;.00nan;0;0
20033;7534;1481;66;21;2;19;.905;3600000;0
20033;9373;1854;56;27;3;24;.889;3600000;0
20033;143479;1854;0;0;0;0;.00nan;0;0
20034;44487;1475;97;49;2;47;.959;3600000;0
20034;47112;2193;52;34;5;29;.853;3600000;0
20034;76951;2193;0;0;0;0;.00nan;0;0
20034;85507;1475;0;0;0;0;.00nan;0;0
20035;68627;523;0;0;0;0;.00nan;0;0
20035;73973;523;86;13;0;13;1.000;3600000;0
20035;143063;1861;97;62;1;61;.984;3591000;0
20035;152202;1861;0;0;0;0;.00nan;0;0
20036;11882;1477;0;0;0;0;.00nan;0;0
20036;22413;3922;97;62;3;59;.952;3600000;0
20036;63402;1477;96;30;1;29;.967;3600000;0
20036;143507;3922;0;0;0;0;.00nan;0;0
20037;67764;1871;0;0;0;0;.00nan;0;0
20037;68565;1869;0;0;0;0;.00nan;0;0
20037;86686;1869;77;40;3;37;.925;3900000;0
20037;143036;1871;84;36;3;33;.917;3900000;0
20038;11882;1477;0;0;0;0;.00nan;0;0
20038;63402;1477;76;24;1;23;.958;3600000;0
20038;68565;1869;0;0;0;0;.00nan;0;0
20038;86686;1869;88;44;3;41;.932;3600000;0
20039;177156;1481;30;8;3;5;.625;405000;0
20039;7534;1481;79;17;0;17;1.000;3195000;0
20039;44487;1475;55;37;6;31;.838;2899000;0
20039;85507;1475;52;3;0;3;1.000;701000;0
20040;22413;3922;100;44;2;42;.955;3600000;0
20040;64230;522;46;28;4;24;.857;3553000;0
20040;143507;3922;0;0;0;0;.00nan;0;0
20040;147264;522;0;0;0;0;.00nan;0;0
20041;11925;521;0;0;0;0;.00nan;0;0
20041;63848;521;22;17;5;12;.706;3554000;0
20041;143063;1861;0;0;0;0;.00nan;0;0
20041;152202;1861;97;54;2;52;.963;3600000;0
20042;46912;2173;87;49;3;46;.939;3515000;0
20042;47112;2193;89;27;1;26;.963;3600000;0
20042;56231;2173;0;0;0;0;.00nan;0;0
20042;76951;2193;0;0;0;0;.00nan;0;0
20043;4618;1877;98;64;4;60;.938;3600000;0
20043;67764;1871;73;10;0;10;1.000;3600000;0
20043;84287;1877;0;0;0;0;.00nan;0;0
20043;143036;1871;0;0;0;0;.00nan;0;0
20044;9373;1854;61;41;5;36;.878;3600000;0
20044;68627;523;0;0;0;0;.00nan;0;0
20044;73973;523;68;21;1;20;.952;3600000;0
20044;143479;1854;0;0;0;0;.00nan;0;0
20045;4618;1877;96;43;2;41;.953;3600000;0
20045;64230;522;0;0;0;0;.00nan;0;0
20045;84287;1877;0;0;0;0;.00nan;0;0
20045;147264;522;80;23;1;22;.957;3600000;0
20046;44487;1475;97;29;1;28;.966;3900000;0
20046;67764;1871;84;21;1;20;.952;3900000;0
20046;85507;1475;0;0;0;0;.00nan;0;0
20046;143036;1871;0;0;0;0;.00nan;0;0
20047;9373;1854;42;30;5;25;.833;3600000;0
20047;46912;2173;16;31;7;24;.774;3011000;0
20047;56231;2173;56;4;0;4;1.000;522000;0
20047;143479;1854;0;0;0;0;.00nan;0;0
20048;177156;1481;0;0;0;0;.00nan;0;0
20048;7534;1481;76;36;3;33;.917;3600000;0
20048;47112;2193;0;0;0;0;.00nan;0;0
20048;76951;2193;55;17;2;15;.882;3600000;0
20049;11882;1477;0;0;0;0;.00nan;0;0
20049;63402;1477;45;14;3;11;.786;3600000;0
20049;143063;1861;80;55;4;51;.927;3548000;0
20049;152202;1861;0;0;0;0;.00nan;0;0
20050;11925;521;80;20;1;19;.950;3900000;0
20050;22413;3922;93;32;1;31;.969;3900000;0
20050;63848;521;0;0;0;0;.00nan;0;0
20050;143507;3922;0;0;0;0;.00nan;0;0
20051;68565;1869;0;0;0;0;.00nan;0;0
20051;68627;523;0;0;0;0;.00nan;0;0
20051;73973;523;67;23;2;21;.913;3600000;0
20051;86686;1869;100;44;0;44;1.000;3600000;0
20052;4618;1877;53;36;5;31;.861;2745000;0
20052;11882;1477;0;0;0;0;.00nan;0;0
20052;63402;1477;67;21;2;19;.905;3600000;0
20052;84287;1877;27;13;4;9;.692;855000;0
20053;64230;522;26;11;4;7;.636;1104000;0
20053;68565;1869;0;0;0;0;.00nan;0;0
20053;86686;1869;69;28;2;26;.929;3600000;0
20053;147264;522;86;26;0;26;1.000;2424000;0
20054;9373;1854;91;36;1;35;.972;3600000;0
20054;11925;521;66;23;2;21;.913;3580000;0
20054;63848;521;0;0;0;0;.00nan;0;0
20054;143479;1854;0;0;0;0;.00nan;0;0
20055;177156;1481;0;0;0;0;.00nan;0;0
20055;7534;1481;87;30;2;28;.933;3600000;0
20055;46912;2173;55;15;2;13;.867;1304000;0
20055;56231;2173;36;31;6;25;.806;2296000;0
20056;22413;3922;86;35;2;33;.943;3600000;0
20056;143063;1861;0;0;0;0;.00nan;0;0
20056;143507;3922;0;0;0;0;.00nan;0;0
20056;152202;1861;61;29;4;25;.862;3531000;0
20057;47112;2193;49;22;3;19;.864;3900000;0
20057;67764;1871;0;0;0;0;.00nan;0;0
20057;76951;2193;0;0;0;0;.00nan;0;0
20057;143036;1871;64;30;3;27;.900;3900000;0
20058;44487;1475;28;27;6;21;.778;1968000;0
20058;68627;523;0;0;0;0;.00nan;0;0
20058;73973;523;81;29;2;27;.931;3600000;0
20058;85507;1475;69;27;2;25;.926;1632000;0
20059;177156;1481;0;0;0;0;.00nan;0;0
20059;7534;1481;84;38;2;36;.947;3564000;0
20059;67764;1871;0;0;0;0;.00nan;0;0
20059;143036;1871;100;24;0;24;1.000;3600000;0
20060;4618;1877;0;0;0;0;.00nan;0;0
20060;68627;523;0;0;0;0;.00nan;0;0
20060;73973;523;39;16;3;13;.813;3600000;0
20060;84287;1877;67;48;5;43;.896;3520000;0
20061;44487;1475;0;0;0;0;.00nan;0;0
20061;46912;2173;70;28;2;26;.929;3557000;0
20061;56231;2173;0;0;0;0;.00nan;0;0
20061;85507;1475;74;24;1;23;.958;3600000;0
20062;9373;1854;64;29;3;26;.897;3600000;0
20062;11882;1477;0;0;0;0;.00nan;0;0
20062;63402;1477;100;27;0;27;1.000;3600000;0
20062;143479;1854;0;0;0;0;.00nan;0;0
20063;22413;3922;59;49;6;43;.878;3600000;0
20063;47112;2193;0;0;0;0;.00nan;0;0
20063;76951;2193;61;15;2;13;.867;3600000;0
20063;143507;3922;0;0;0;0;.00nan;0;0
20064;64230;522;0;0;0;0;.00nan;0;0
20064;143063;1861;60;35;5;30;.857;3600000;0
20064;147264;522;94;35;1;34;.971;3600000;0
20064;152202;1861;0;0;0;0;.00nan;0;0
20065;11925;521;79;25;2;23;.920;3600000;0
20065;63848;521;0;0;0;0;.00nan;0;0
20065;68565;1869;0;0;0;0;.00nan;0;0
20065;86686;1869;56;29;4;25;.862;3562000;0
20066;177156;1481;0;0;0;0;.00nan;0;0
20066;7534;1481;53;30;4;26;.867;3563000;0
20066;68627;523;0;0;0;0;.00nan;0;0
20066;73973;523;65;24;3;21;.875;3600000;0
20067;4618;1877;100;27;0;27;1.000;3600000;0
20067;84287;1877;0;0;0;0;.00nan;0;0
20067;143063;1861;0;0;0;0;.00nan;0;0
20067;152202;1861;52;26;3;23;.885;3600000;0
20068;11925;521;65;16;1;15;.938;3600000;0
20068;44487;1475;58;37;5;32;.865;3600000;0
20068;63848;521;0;0;0;0;.00nan;0;0
20068;85507;1475;0;0;0;0;.00nan;0;0
20069;9373;1854;75;34;2;32;.941;3566000;0
20069;67764;1871;0;0;0;0;.00nan;0;0
20069;143036;1871;94;29;1;28;.966;3600000;0
20069;143479;1854;0;0;0;0;.00nan;0;0
20070;47112;2193;0;0;0;0;.00nan;0;0
20070;64230;522;0;0;0;0;.00nan;0;0
20070;76951;2193;54;12;1;11;.917;3600000;0
20070;147264;522;68;37;4;33;.892;3600000;0
20071;11882;1477;0;0;0;0;.00nan;0;0
20071;46912;2173;91;44;2;42;.955;3556000;0
20071;56231;2173;0;0;0;0;.00nan;0;0
20071;63402;1477;82;15;0;15;1.000;3600000;0
20072;22413;3922;71;35;4;31;.886;3600000;0
20072;68565;1869;54;28;3;25;.893;3600000;0
20072;86686;1869;0;0;0;0;.00nan;0;0
20072;143507;3922;0;0;0;0;.00nan;0;0
20073;177156;1481;0;0;0;0;.00nan;0;0
20073;7534;1481;63;41;4;37;.902;3591000;0
20073;11882;1477;0;0;0;0;.00nan;0;0
20073;63402;1477;68;23;2;21;.913;3600000;0
20074;9373;1854;71;36;3;33;.917;3544000;0
20074;64230;522;97;35;1;34;.971;3600000;0
20074;143479;1854;0;0;0;0;.00nan;0;0
20074;147264;522;0;0;0;0;.00nan;0;0
20075;4618;1877;65;36;4;32;.889;3600000;0
20075;11925;521;0;0;0;0;.00nan;0;0
20075;63848;521;81;13;0;13;1.000;3600000;0
20075;84287;1877;0;0;0;0;.00nan;0;0
20076;68565;1869;0;0;0;0;.00nan;0;0
20076;86686;1869;77;32;3;29;.906;3600000;0
20076;143063;1861;83;34;2;32;.941;3600000;0
20076;152202;1861;0;0;0;0;.00nan;0;0
20077;22413;3922;42;29;6;23;.793;2426000;0
20077;44487;1475;49;25;4;21;.840;3600000;0
20077;85507;1475;0;0;0;0;.00nan;0;0
20077;143507;3922;46;12;2;10;.833;1174000;0
20078;46912;2173;100;53;0;53;1.000;3600000;0
20078;56231;2173;0;0;0;0;.00nan;0;0
20078;67764;1871;0;0;0;0;.00nan;0;0
20078;143036;1871;52;33;4;29;.879;3600000;0
20079;47112;2193;100;39;1;38;.974;3600000;0
20079;68627;523;0;0;0;0;.00nan;0;0
20079;73973;523;57;30;3;27;.900;3547000;0
20079;76951;2193;0;0;0;0;.00nan;0;0
20080;177156;1481;0;0;0;0;.00nan;0;0
20080;7534;1481;69;35;3;32;.914;3600000;0
20080;64230;522;0;0;0;0;.00nan;0;0
20080;147264;522;100;30;0;30;1.000;3600000;0
20081;4618;1877;76;34;3;31;.912;3818000;0
20081;68565;1869;0;0;0;0;.00nan;0;0
20081;84287;1877;0;0;0;0;.00nan;0;0
20081;86686;1869;56;32;4;28;.875;3818000;0
20082;11882;1477;0;0;0;0;.00nan;0;0
20082;44487;1475;67;43;5;38;.884;3600000;0
20082;63402;1477;57;20;3;17;.850;3600000;0
20082;85507;1475;0;0;0;0;.00nan;0;0
20083;9373;1854;63;32;3;29;.906;3529000;0
20083;22413;3922;76;21;1;20;.952;3600000;0
20083;143479;1854;0;0;0;0;.00nan;0;0
20083;143507;3922;0;0;0;0;.00nan;0;0
20084;47112;2193;0;0;0;0;.00nan;0;0
20084;76951;2193;59;14;1;13;.929;3600000;0
20084;143063;1861;0;0;0;0;.00nan;0;0
20084;152202;1861;89;52;3;49;.942;3529000;0
20085;11925;521;0;0;0;0;.00nan;0;0
20085;46912;2173;78;53;5;48;.906;3600000;0
20085;56231;2173;0;0;0;0;.00nan;0;0
20085;63848;521;60;14;1;13;.929;3600000;0
20086;67764;1871;65;16;2;14;.875;1223000;0
20086;68627;523;0;0;0;0;.00nan;0;0
20086;73973;523;47;35;5;30;.857;3600000;0
20086;143036;1871;34;17;4;13;.765;2362000;0
20087;11882;1477;24;33;7;26;.788;3600000;0
20087;63402;1477;0;0;0;0;.00nan;0;0
20087;67764;1871;0;0;0;0;.00nan;0;0
20087;78587;1871;67;24;2;22;.917;3600000;0
20088;44487;1475;89;23;1;22;.957;3600000;0
20088;64230;522;0;0;0;0;.00nan;0;0
20088;85507;1475;0;0;0;0;.00nan;0;0
20088;147264;522;70;38;2;36;.947;3588000;0
20089;11925;521;62;41;5;36;.878;3591000;0
20089;47112;2193;59;26;3;23;.885;3600000;0
20089;63848;521;0;0;0;0;.00nan;0;0
20089;76951;2193;0;0;0;0;.00nan;0;0
20090;9373;1854;100;32;0;32;1.000;3600000;0
20090;143063;1861;74;36;3;33;.917;3600000;0
20090;143479;1854;0;0;0;0;.00nan;0;0
20090;152202;1861;0;0;0;0;.00nan;0;0
20091;4618;1877;56;23;2;21;.913;3900000;0
20091;22413;3922;80;30;2;28;.933;3900000;0
20091;84287;1877;0;0;0;0;.00nan;0;0
20091;143507;3922;0;0;0;0;.00nan;0;0
20092;177156;1481;0;0;0;0;.00nan;0;0
20092;7534;1481;66;35;4;31;.886;3621000;0
20092;68565;1869;0;0;0;0;.00nan;0;0
20092;86686;1869;63;37;5;32;.865;3621000;0
20093;46912;2173;29;30;7;23;.767;1931000;0
20093;56231;2173;63;18;1;17;.944;1669000;0
20093;68627;523;61;26;3;23;.885;3600000;0
20093;143036;523;0;0;0;0;.00nan;0;0
20094;177156;1481;0;0;0;0;.00nan;0;0
20094;7534;1481;100;25;0;25;1.000;3600000;0
20094;22413;3922;97;34;1;33;.971;3569000;0
20094;143507;3922;0;0;0;0;.00nan;0;0
20095;4618;1877;100;37;1;36;.973;3600000;0
20095;44487;1475;52;26;4;22;.846;3600000;0
20095;84287;1877;0;0;0;0;.00nan;0;0
20095;85507;1475;0;0;0;0;.00nan;0;0
20096;9373;1854;74;29;2;27;.931;3600000;0
20096;68565;1869;0;0;0;0;.00nan;0;0
20096;86686;1869;51;32;5;27;.844;3600000;0
20096;143479;1854;0;0;0;0;.00nan;0;0
20097;11882;1477;0;0;0;0;.00nan;0;0
20097;47112;2193;0;0;0;0;.00nan;0;0
20097;63402;1477;75;36;3;33;.917;3630000;0
20097;76951;2193;66;25;2;23;.920;3630000;0
20098;46912;2173;0;0;0;0;.00nan;0;0
20098;56231;2173;58;31;4;27;.871;3600000;0
20098;143063;1861;48;32;5;27;.844;3595000;0
20098;152202;1861;0;0;0;0;.00nan;0;0
20099;11925;521;0;0;0;0;.00nan;0;0
20099;63848;521;37;32;6;26;.813;3600000;0
20099;67764;1871;0;0;0;0;.00nan;0;0
20099;78587;1871;79;26;2;24;.923;3600000;0
20100;64230;522;0;0;0;0;.00nan;0;0
20100;68627;523;0;0;0;0;.00nan;0;0
20100;143036;523;82;27;1;26;.963;3553000;0
20100;147264;522;100;32;0;32;1.000;3600000;0
20101;11882;1477;0;0;0;0;.00nan;0;0
20101;63402;1477;50;27;4;23;.852;3600000;0
20101;68627;523;0;0;0;0;.00nan;0;0
20101;143036;523;73;39;3;36;.923;3600000;0
20102;64230;522;0;0;0;0;.00nan;0;0
20102;67764;1871;0;0;0;0;.00nan;0;0
20102;78587;1871;85;20;0;20;1.000;3600000;0
20102;147264;522;82;32;2;30;.938;3517000;0
20103;4618;1877;0;0;0;0;.00nan;0;0
20103;9373;1854;68;24;2;22;.917;3550000;0
20103;84287;1877;100;35;1;34;.971;3600000;0
20103;143479;1854;0;0;0;0;.00nan;0;0
20104;177156;1481;0;0;0;0;.00nan;0;0
20104;7534;1481;72;38;4;34;.895;3562000;0
20104;11925;521;85;36;2;34;.944;3600000;0
20104;63848;521;0;0;0;0;.00nan;0;0
20105;44487;1475;37;17;4;13;.765;3843000;0
20105;85507;1475;0;0;0;0;.00nan;0;0
20105;143063;1861;0;0;0;0;.00nan;0;0
20105;152202;1861;65;43;5;38;.884;3843000;0
20106;22413;3922;78;36;3;33;.917;3515000;0
20106;46912;2173;76;28;1;27;.964;3600000;0
20106;56231;2173;0;0;0;0;.00nan;0;0
20106;143507;3922;0;0;0;0;.00nan;0;0
20107;47112;2193;61;29;3;26;.897;3600000;0
20107;68565;1869;0;0;0;0;.00nan;0;0
20107;76951;2193;0;0;0;0;.00nan;0;0
20107;86686;1869;49;32;5;27;.844;3563000;0
20108;11882;1477;0;0;0;0;.00nan;0;0
20108;11925;521;89;42;3;39;.929;3600000;0
20108;63402;1477;78;29;1;28;.966;3600000;0
20108;63848;521;0;0;0;0;.00nan;0;0
20109;177156;1481;0;0;0;0;.00nan;0;0
20109;4618;1877;73;41;4;37;.902;3600000;0
20109;7534;1481;71;20;1;19;.950;3600000;0
20109;84287;1877;0;0;0;0;.00nan;0;0
20110;44487;1475;0;0;0;0;.00nan;0;0
20110;68565;1869;0;0;0;0;.00nan;0;0
20110;85507;1475;89;43;2;41;.953;3568000;0
20110;86686;1869;76;21;1;20;.952;3600000;0
20111;9373;1854;66;49;5;44;.898;3587000;0
20111;47112;2193;0;0;0;0;.00nan;0;0
20111;76951;2193;34;16;4;12;.750;3600000;0
20111;143479;1854;0;0;0;0;.00nan;0;0
20112;46912;2173;100;49;1;48;.980;3600000;0
20112;56231;2173;0;0;0;0;.00nan;0;0
20112;64230;522;0;0;0;0;.00nan;0;0
20112;147264;522;65;33;3;30;.909;3567000;0
20113;67764;1871;0;0;0;0;.00nan;0;0
20113;78587;1871;40;14;3;11;.786;3600000;0
20113;143063;1861;0;0;0;0;.00nan;0;0
20113;152202;1861;64;39;4;35;.897;3544000;0
20114;22413;3922;0;0;0;0;.00nan;0;0
20114;68627;523;0;0;0;0;.00nan;0;0
20114;143036;523;90;26;1;25;.962;3600000;0
20114;143507;3922;53;37;5;32;.865;3600000;0
20115;11882;1477;0;0;0;0;.00nan;0;0
20115;63402;1477;56;31;4;27;.871;3600000;0
20115;64230;522;93;31;1;30;.968;3600000;0
20115;147264;522;0;0;0;0;.00nan;0;0
20116;4618;1877;0;0;0;0;.00nan;0;0
20116;47112;2193;57;11;1;10;.909;3600000;0
20116;76951;2193;0;0;0;0;.00nan;0;0
20116;84287;1877;79;54;5;49;.907;3600000;0
20117;9373;1854;0;0;0;0;.00nan;0;0
20117;44487;1475;79;23;2;21;.913;3900000;0
20117;85507;1475;0;0;0;0;.00nan;0;0
20117;143479;1854;85;42;2;40;.952;3900000;0
20118;11925;521;0;0;0;0;.00nan;0;0
20118;63848;521;94;36;1;35;.972;3545000;0
20118;68627;523;0;0;0;0;.00nan;0;0
20118;143036;523;100;21;0;21;1.000;3600000;0
20119;177156;1481;0;0;0;0;.00nan;0;0
20119;7534;1481;65;16;1;15;.938;3600000;0
20119;143063;1861;27;16;4;12;.750;950000;0
20119;152202;1861;53;24;3;21;.875;2650000;0
20120;22413;3922;0;0;0;0;.00nan;0;0
20120;67764;1871;0;0;0;0;.00nan;0;0
20120;78587;1871;100;25;0;25;1.000;3600000;0
20120;143507;3922;85;46;3;43;.935;3600000;0
20121;46912;2173;49;33;5;28;.848;3600000;0
20121;56231;2173;0;0;0;0;.00nan;0;0
20121;68565;1869;0;0;0;0;.00nan;0;0
20121;86686;1869;73;27;2;25;.926;3600000;0
20122;11882;1477;0;0;0;0;.00nan;0;0
20122;22413;3922;66;41;4;37;.902;3600000;0
20122;63402;1477;70;17;1;16;.941;3600000;0
20122;143507;3922;0;0;0;0;.00nan;0;0
20123;177156;1481;0;0;0;0;.00nan;0;0
20123;7534;1481;73;32;3;29;.906;3600000;0
20123;9373;1854;35;37;7;30;.811;2295000;0
20123;143479;1854;64;10;0;10;1.000;1305000;0
20124;44487;1475;58;44;6;38;.864;3340000;0
20124;47112;2193;0;0;0;0;.00nan;0;0
20124;76951;2193;74;29;2;27;.931;3600000;0
20124;85507;1475;50;1;0;1;1.000;260000;0
20125;11925;521;0;0;0;0;.00nan;0;0
20125;63848;521;100;34;0;34;1.000;3600000;0
20125;64230;522;48;0;0;0;.00nan;482000;0
20125;147264;522;25;27;6;21;.778;3118000;0
20126;67764;1871;0;0;0;0;.00nan;0;0
20126;68565;1869;0;0;0;0;.00nan;0;0
20126;78587;1871;56;22;3;19;.864;3550000;0
20126;86686;1869;100;43;2;41;.953;3600000;0
20127;1072;523;0;0;0;0;.00nan;0;0
20127;143036;523;61;26;3;23;.885;3600000;0
20127;143063;1861;0;0;0;0;.00nan;0;0
20127;152202;1861;73;54;5;49;.907;3538000;0
20128;4618;1877;100;38;0;38;1.000;3600000;0
20128;46912;2173;66;33;3;30;.909;3600000;0
20128;56231;2173;0;0;0;0;.00nan;0;0
20128;84287;1877;0;0;0;0;.00nan;0;0
20129;4618;1877;90;36;2;34;.944;3600000;0
20129;67764;1871;0;0;0;0;.00nan;0;0
20129;78587;1871;67;16;1;15;.938;3600000;0
20129;84287;1877;0;0;0;0;.00nan;0;0
20130;177156;1481;0;0;0;0;.00nan;0;0
20130;7534;1481;44;21;4;17;.810;3577000;0
20130;44487;1475;0;0;0;0;.00nan;0;0
20130;85507;1475;95;39;2;37;.949;3600000;0
20131;1072;523;0;0;0;0;.00nan;0;0
20131;9373;1854;74;50;5;45;.900;3600000;0
20131;143036;523;74;20;1;19;.950;3600000;0
20131;143479;1854;0;0;0;0;.00nan;0;0
20132;46912;2173;94;41;2;39;.951;3600000;0
20132;47112;2193;42;16;3;13;.813;3542000;0
20132;56231;2173;0;0;0;0;.00nan;0;0
20132;76951;2193;0;0;0;0;.00nan;0;0
20133;11925;521;0;0;0;0;.00nan;0;0
20133;63848;521;69;16;1;15;.938;3600000;0
20133;143063;1861;76;50;6;44;.880;3600000;0
20133;152202;1861;0;0;0;0;.00nan;0;0
20134;22413;3922;62;36;4;32;.889;3900000;0
20134;64230;522;0;0;0;0;.00nan;0;0
20134;143507;3922;0;0;0;0;.00nan;0;0
20134;147264;522;84;43;4;39;.907;3900000;0
20135;11882;1477;0;0;0;0;.00nan;0;0
20135;63402;1477;86;30;1;29;.967;3600000;0
20135;68565;1869;0;0;0;0;.00nan;0;0
20135;86686;1869;34;26;5;21;.808;3600000;0
20136;11882;1477;0;0;0;0;.00nan;0;0
20136;63402;1477;79;23;1;22;.957;3600000;0
20136;143063;1861;0;0;0;0;.00nan;0;0
20136;152202;1861;71;51;5;46;.902;3600000;0
20137;177156;1481;0;0;0;0;.00nan;0;0
20137;7534;1481;72;31;3;28;.903;3600000;0
20137;47112;2193;62;9;0;9;1.000;933000;0
20137;76951;2193;22;23;6;17;.739;2667000;0
20138;4618;1877;95;53;4;49;.925;3600000;0
20138;64230;522;0;0;0;0;.00nan;0;0
20138;84287;1877;0;0;0;0;.00nan;0;0
20138;147264;522;54;17;2;15;.882;3600000;0
20139;11925;521;0;0;0;0;.00nan;0;0
20139;22413;3922;50;2;0;2;1.000;274000;0
20139;63848;521;93;21;0;21;1.000;3600000;0
20139;143507;3922;27;34;7;27;.794;3326000;0
20140;9373;1854;31;32;6;26;.813;2925000;0
20140;46912;2173;81;27;1;26;.963;3600000;0
20140;56231;2173;0;0;0;0;.00nan;0;0
20140;143479;1854;52;4;0;4;1.000;675000;0
20141;44487;1475;36;32;6;26;.813;3556000;0
20141;67764;1871;0;0;0;0;.00nan;0;0
20141;78587;1871;62;31;5;26;.839;3600000;0
20141;85507;1475;0;0;0;0;.00nan;0;0
20142;1072;523;0;0;0;0;.00nan;0;0
20142;68565;1869;66;29;3;26;.897;3017000;0
20142;86686;1869;24;6;3;3;.500;583000;0
20142;143036;523;80;30;2;28;.933;3600000;0
20143;177156;1481;0;0;0;0;.00nan;0;0
20143;7534;1481;79;25;1;24;.960;3600000;0
20143;46912;2173;50;46;6;40;.870;3600000;0
20143;56231;2173;0;0;0;0;.00nan;0;0
20144;4618;1877;0;0;0;0;.00nan;0;0
20144;11882;1477;0;0;0;0;.00nan;0;0
20144;63402;1477;64;24;3;21;.875;3600000;0
20144;84287;1877;67;45;5;40;.889;3600000;0
20145;1072;523;0;0;0;0;.00nan;0;0
20145;44487;1475;49;36;6;30;.833;2819000;0
20145;85507;1475;23;11;4;7;.636;781000;0
20145;143036;523;68;23;2;21;.913;3600000;0
20146;9373;1854;0;0;0;0;.00nan;0;0
20146;11925;521;0;0;0;0;.00nan;0;0
20146;63848;521;51;30;4;26;.867;3567000;0
20146;143479;1854;81;39;3;36;.923;3600000;0
20147;47112;2193;25;12;4;8;.667;3600000;0
20147;67764;1871;0;0;0;0;.00nan;0;0
20147;76951;2193;0;0;0;0;.00nan;0;0
20147;78587;1871;100;37;0;37;1.000;3600000;0
20148;22413;3922;0;0;0;0;.00nan;0;0
20148;143063;1861;0;0;0;0;.00nan;0;0
20148;143507;3922;71;23;1;22;.957;3900000;0
20148;152202;1861;86;29;1;28;.966;3900000;0
20149;64230;522;0;0;0;0;.00nan;0;0
20149;68565;1869;0;0;0;0;.00nan;0;0
20149;86686;1869;86;36;2;34;.944;3600000;0
20149;147264;522;100;47;1;46;.979;3600000;0
20150;9373;1854;44;37;5;32;.865;3600000;0
20150;11882;1477;0;0;0;0;.00nan;0;0
20150;63402;1477;59;12;2;10;.833;3600000;0
20150;143479;1854;0;0;0;0;.00nan;0;0
20151;64230;522;54;20;3;17;.850;3600000;0
20151;143063;1861;0;0;0;0;.00nan;0;0
20151;147264;522;0;0;0;0;.00nan;0;0
20151;152202;1861;80;44;4;40;.909;3545000;0
20152;11925;521;0;0;0;0;.00nan;0;0
20152;63848;521;62;30;3;27;.900;3575000;0
20152;68565;1869;0;0;0;0;.00nan;0;0
20152;86686;1869;99;35;1;34;.971;3600000;0
20153;44487;1475;86;24;1;23;.958;3900000;0
20153;46912;2173;0;0;0;0;.00nan;0;0
20153;56231;2173;88;36;1;35;.972;3900000;0
20153;85507;1475;0;0;0;0;.00nan;0;0
20154;22413;3922;68;47;6;41;.872;3292000;0
20154;47112;2193;0;0;0;0;.00nan;0;0
20154;76951;2193;76;19;1;18;.947;3600000;0
20154;143507;3922;52;3;0;3;1.000;308000;0
20155;177156;1481;0;0;0;0;.00nan;0;0
20155;7534;1481;100;45;1;44;.978;3600000;0
20155;67764;1871;0;0;0;0;.00nan;0;0
20155;78587;1871;60;34;4;30;.882;3600000;0
20156;1072;523;0;0;0;0;.00nan;0;0
20156;4618;1877;71;50;6;44;.880;2980000;0
20156;84287;1877;54;5;0;5;1.000;620000;0
20156;143036;523;56;12;1;11;.917;3600000;0
20158;22413;3922;77;34;3;31;.912;3900000;0
20158;46912;2173;66;32;3;29;.906;3900000;0
20158;56231;2173;0;0;0;0;.00nan;0;0
20158;143507;3922;0;0;0;0;.00nan;0;0
20160;4618;1877;0;0;0;0;.00nan;0;0
20160;185041;1475;54;6;0;6;1.000;897000;0
20160;179830;1475;33;33;6;27;.818;2703000;0
20160;84287;1877;57;20;3;17;.850;3600000;0
20162;13613;2193;0;0;0;0;.00nan;0;0
20162;64230;522;68;50;5;45;.900;3600000;0
20162;76951;2193;76;19;1;18;.947;3600000;0
20162;147264;522;0;0;0;0;.00nan;0;0
20164;11925;521;0;0;0;0;.00nan;0;0
20164;63848;521;75;38;3;35;.921;3600000;0
20164;68627;523;58;36;4;32;.889;3544000;0
20164;73973;523;0;0;0;0;.00nan;0;0
20166;68565;1869;0;0;0;0;.00nan;0;0
20166;78587;1871;63;19;2;17;.895;3900000;0
20166;86686;1869;72;29;2;27;.931;3900000;0
20166;143036;1871;0;0;0;0;.00nan;0;0
20168;9373;1854;73;29;1;28;.966;3600000;0
20168;143063;1861;0;0;0;0;.00nan;0;0
20168;143479;1854;0;0;0;0;.00nan;0;0
20168;152202;1861;81;32;2;30;.938;3544000;0
20170;7534;1481;84;34;2;32;.941;3600000;0
20170;53889;1481;0;0;0;0;.00nan;0;0
20170;54290;1477;64;30;3;27;.900;3086000;0
20170;63402;1477;23;5;3;2;.400;514000;0
20172;9373;1854;62;10;0;10;1.000;1002000;0
20172;64230;522;0;0;0;0;.00nan;0;0
20172;143479;1854;19;26;6;20;.769;2598000;0
20172;147264;522;73;36;3;33;.917;3600000;0
20174;7534;1481;0;0;0;0;.00nan;0;0
20174;53889;1481;70;30;2;28;.933;3578000;0
20174;143063;1861;74;22;1;21;.955;3600000;0
20174;152202;1861;0;0;0;0;.00nan;0;0
20176;11925;521;49;25;3;22;.880;3562000;0
20176;22413;3922;0;0;0;0;.00nan;0;0
20176;63848;521;0;0;0;0;.00nan;0;0
20176;143507;3922;92;37;2;35;.946;3600000;0
20178;68627;523;0;0;0;0;.00nan;0;0
20178;73973;523;100;28;0;28;1.000;3600000;0
20178;78587;1871;0;0;0;0;.00nan;0;0
20178;143036;1871;51;34;5;29;.853;3600000;0
20180;4618;1877;60;33;4;29;.879;3516000;0
20180;46912;2173;0;0;0;0;.00nan;0;0
20180;56231;2173;75;33;2;31;.939;3600000;0
20180;84287;1877;0;0;0;0;.00nan;0;0
20182;185041;1475;100;38;1;37;.974;3600000;0
20182;179830;1475;0;0;0;0;.00nan;0;0
20182;68565;1869;60;23;2;21;.913;3582000;0
20182;86686;1869;0;0;0;0;.00nan;0;0
20184;13613;2193;64;21;2;19;.905;3600000;0
20184;54290;1477;0;0;0;0;.00nan;0;0
20184;63402;1477;52;34;5;29;.853;3600000;0
20184;76951;2193;0;0;0;0;.00nan;0;0
20186;68627;523;0;0;0;0;.00nan;0;0
20186;73973;523;46;18;3;15;.833;3600000;0
20186;78587;1871;0;0;0;0;.00nan;0;0
20186;143036;1871;65;41;5;36;.878;3600000;0
20188;7534;1481;100;28;0;28;1.000;3600000;0
20188;185041;1475;0;0;0;0;.00nan;0;0
20188;179830;1475;58;33;4;29;.879;3600000;0
20188;53889;1481;0;0;0;0;.00nan;0;0
20190;4618;1877;0;0;0;0;.00nan;0;0
20190;54290;1477;0;0;0;0;.00nan;0;0
20190;63402;1477;77;24;1;23;.958;3600000;0
20190;84287;1877;82;37;4;33;.892;3600000;0
20192;46912;2173;58;25;3;22;.880;3900000;0
20192;56231;2173;0;0;0;0;.00nan;0;0
20192;143063;1861;0;0;0;0;.00nan;0;0
20192;152202;1861;70;36;3;33;.917;3900000;0
20194;9373;1854;92;49;3;46;.939;3843000;0
20194;68565;1869;0;0;0;0;.00nan;0;0
20194;86686;1869;54;14;2;12;.857;3843000;0
20194;143479;1854;0;0;0;0;.00nan;0;0
20196;22413;3922;0;0;0;0;.00nan;0;0
20196;64230;522;80;27;1;26;.963;3600000;0
20196;143507;3922;54;21;2;19;.905;3588000;0
20196;147264;522;0;0;0;0;.00nan;0;0
20198;11925;521;0;0;0;0;.00nan;0;0
20198;13613;2193;0;0;0;0;.00nan;0;0
20198;63848;521;77;24;1;23;.958;3600000;0
20198;76951;2193;67;31;2;29;.935;3550000;0
20200;22413;3922;63;25;3;22;.880;3733000;0
20200;46912;2173;0;0;0;0;.00nan;0;0
20200;56231;2173;89;40;2;38;.950;3733000;0
20200;143507;3922;0;0;0;0;.00nan;0;0
20202;7534;1481;55;38;5;33;.868;3600000;0
20202;53889;1481;0;0;0;0;.00nan;0;0
20202;143063;1861;89;34;1;33;.971;3600000;0
20202;152202;1861;0;0;0;0;.00nan;0;0
20204;185041;1475;69;38;4;34;.895;3900000;0
20204;179830;1475;0;0;0;0;.00nan;0;0
20204;68565;1869;39;22;4;18;.818;3900000;0
20204;86686;1869;0;0;0;0;.00nan;0;0
20206;54290;1477;83;37;2;35;.946;3600000;0
20206;63402;1477;0;0;0;0;.00nan;0;0
20206;78587;1871;58;26;4;22;.846;3583000;0
20206;143036;1871;0;0;0;0;.00nan;0;0
20208;13613;2193;82;34;3;31;.912;3694000;0
20208;68627;523;65;22;2;20;.909;3694000;0
20208;73973;523;0;0;0;0;.00nan;0;0
20208;76951;2193;0;0;0;0;.00nan;0;0
20210;11925;521;47;32;5;27;.844;3600000;0
20210;63848;521;0;0;0;0;.00nan;0;0
20210;64230;522;0;0;0;0;.00nan;0;0
20210;147264;522;79;28;1;27;.964;3600000;0
20212;4618;1877;78;31;4;27;.871;3900000;0
20212;9373;1854;0;0;0;0;.00nan;0;0
20212;84287;1877;0;0;0;0;.00nan;0;0
20212;143479;1854;65;36;4;32;.889;3900000;0
20214;7534;1481;67;36;3;33;.917;3900000;0
20214;22413;3922;0;0;0;0;.00nan;0;0
20214;53889;1481;0;0;0;0;.00nan;0;0
20214;143507;3922;58;29;3;26;.897;3900000;0
20216;4618;1877;0;0;0;0;.00nan;0;0
20216;9373;1854;46;28;4;24;.857;3514000;0
20216;84287;1877;81;33;2;31;.939;3600000;0
20216;143479;1854;0;0;0;0;.00nan;0;0
20218;68627;523;55;10;1;9;.900;3600000;0
20218;73973;523;0;0;0;0;.00nan;0;0
20218;78587;1871;0;0;0;0;.00nan;0;0
20218;143036;1871;75;32;3;29;.906;3514000;0
20220;11925;521;69;35;2;33;.943;3826000;0
20220;46912;2173;89;45;3;42;.933;3826000;0
20220;56231;2173;0;0;0;0;.00nan;0;0
20220;63848;521;0;0;0;0;.00nan;0;0
20222;13613;2193;0;0;0;0;.00nan;0;0
20222;54290;1477;0;0;0;0;.00nan;0;0
20222;63402;1477;78;20;1;19;.950;3600000;0
20222;76951;2193;65;19;2;17;.895;3600000;0
20224;68565;1869;0;0;0;0;.00nan;0;0
20224;86686;1869;63;22;2;20;.909;3600000;0
20224;143063;1861;0;0;0;0;.00nan;0;0
20224;152202;1861;86;52;4;48;.923;3563000;0
20226;185041;1475;64;31;4;27;.871;3886000;0
20226;179830;1475;0;0;0;0;.00nan;0;0
20226;64230;522;0;0;0;0;.00nan;0;0
20226;147264;522;64;36;3;33;.917;3886000;0
20228;9373;1854;0;0;0;0;.00nan;0;0
20228;68627;523;0;0;0;0;.00nan;0;0
20228;73973;523;30;20;5;15;.750;3600000;0
20228;143479;1854;60;47;6;41;.872;3600000;0
20230;11925;521;49;23;3;20;.870;3600000;0
20230;63848;521;0;0;0;0;.00nan;0;0
20230;143063;1861;0;0;0;0;.00nan;0;0
20230;152202;1861;38;33;5;28;.848;3600000;0
20232;4618;1877;0;0;0;0;.00nan;0;0
20232;68565;1869;0;0;0;0;.00nan;0;0
20232;84287;1877;79;36;2;34;.944;3549000;0
20232;86686;1869;66;17;1;16;.941;3600000;0
20234;22413;3922;0;0;0;0;.00nan;0;0
20234;54290;1477;0;0;0;0;.00nan;0;0
20234;63402;1477;95;46;2;44;.957;3900000;0
20234;143507;3922;75;31;2;29;.935;3900000;0
20236;185041;1475;0;0;0;0;.00nan;0;0
20236;179830;1475;83;36;2;34;.944;3600000;0
20236;46912;2173;73;38;3;35;.921;3583000;0
20236;56231;2173;0;0;0;0;.00nan;0;0
20238;13613;2193;0;0;0;0;.00nan;0;0
20238;76951;2193;57;31;4;27;.871;3600000;0
20238;78587;1871;68;20;1;19;.950;3600000;0
20238;143036;1871;0;0;0;0;.00nan;0;0
20240;7534;1481;62;27;3;24;.889;3747000;0
20240;53889;1481;0;0;0;0;.00nan;0;0
20240;64230;522;0;0;0;0;.00nan;0;0
20240;147264;522;61;35;4;31;.886;3747000;0
20242;13613;2193;51;19;3;16;.842;3520000;0
20242;64230;522;93;34;1;33;.971;3600000;0
20242;76951;2193;0;0;0;0;.00nan;0;0
20242;147264;522;0;0;0;0;.00nan;0;0
20244;7534;1481;0;0;0;0;.00nan;0;0
20244;53889;1481;83;42;3;39;.929;3600000;0
20244;68565;1869;49;34;5;29;.853;3580000;0
20244;86686;1869;0;0;0;0;.00nan;0;0
20246;9373;1854;60;32;4;28;.875;3600000;0
20246;78587;1871;0;0;0;0;.00nan;0;0
20246;143036;1871;96;17;0;17;1.000;3600000;0
20246;143479;1854;0;0;0;0;.00nan;0;0
20248;22413;3922;63;27;2;25;.926;3600000;0
20248;185041;1475;23;26;6;20;.769;3600000;0
20248;179830;1475;0;0;0;0;.00nan;0;0
20248;143507;3922;0;0;0;0;.00nan;0;0
20250;11925;521;0;0;0;0;.00nan;0;0
20250;46912;2173;0;0;0;0;.00nan;0;0
20250;56231;2173;86;45;3;42;.933;3600000;0
20250;63848;521;88;17;0;17;1.000;3600000;0
20252;4618;1877;26;11;4;7;.636;700000;0
20252;54290;1477;80;25;1;24;.960;3600000;0
20252;63402;1477;0;0;0;0;.00nan;0;0
20252;84287;1877;49;35;6;29;.829;2900000;0
20254;68627;523;67;14;1;13;.929;3600000;0
20254;73973;523;0;0;0;0;.00nan;0;0
20254;143063;1861;84;60;3;57;.950;3537000;0
20254;152202;1861;0;0;0;0;.00nan;0;0
634;1072;523;0;0;0;0;.00nan;0;0
634;64230;522;0;0;0;0;.00nan;0;0
634;143036;523;52;28;4;24;.857;3600000;0
634;147264;522;70;27;2;25;.926;3600000;0
635;11882;1477;0;0;0;0;.00nan;0;0
635;11925;521;30;20;5;15;.750;3600000;0
635;63402;1477;85;35;2;33;.943;3600000;0
635;63848;521;0;0;0;0;.00nan;0;0
636;47112;2193;81;14;0;14;1.000;3600000;0
636;68565;1869;0;0;0;0;.00nan;0;0
636;76951;2193;0;0;0;0;.00nan;0;0
636;86686;1869;79;39;3;36;.923;3600000;0
637;177156;1481;65;11;0;11;1.000;1494000;0
637;7534;1481;25;23;6;17;.739;2086000;0
637;67764;1871;0;0;0;0;.00nan;0;0
637;78587;1871;41;18;4;14;.778;3600000;0
638;1072;523;0;0;0;0;.00nan;0;0
638;64230;522;0;0;0;0;.00nan;0;0
638;143036;523;79;25;2;23;.920;3600000;0
638;147264;522;81;48;5;43;.896;3600000;0
639;11882;1477;0;0;0;0;.00nan;0;0
639;11925;521;61;31;3;28;.903;3577000;0
639;63402;1477;81;22;1;21;.955;3600000;0
639;63848;521;0;0;0;0;.00nan;0;0
640;47112;2193;0;0;0;0;.00nan;0;0
640;68565;1869;0;0;0;0;.00nan;0;0
640;76951;2193;39;30;5;25;.833;3592000;0
640;86686;1869;60;29;3;26;.897;3600000;0
641;177156;1481;0;0;0;0;.00nan;0;0
641;7534;1481;98;34;1;33;.971;3600000;0
641;67764;1871;0;0;0;0;.00nan;0;0
641;78587;1871;78;26;2;24;.923;3576000;0
642;1072;523;0;0;0;0;.00nan;0;0
642;64230;522;0;0;0;0;.00nan;0;0
642;143036;523;86;33;2;31;.939;4528000;0
642;147264;522;94;43;3;40;.930;4528000;0
643;11882;1477;0;0;0;0;.00nan;0;0
643;11925;521;100;30;0;30;1.000;3600000;0
643;63402;1477;69;34;3;31;.912;3600000;0
643;63848;521;0;0;0;0;.00nan;0;0
644;47112;2193;0;0;0;0;.00nan;0;0
644;68565;1869;0;0;0;0;.00nan;0;0
644;76951;2193;63;16;1;15;.938;3600000;0
644;86686;1869;73;52;6;46;.885;3600000;0
645;177156;1481;51;8;1;7;.875;761000;0
645;7534;1481;33;36;6;30;.833;2839000;0
645;67764;1871;0;0;0;0;.00nan;0;0
645;78587;1871;69;27;2;25;.926;3600000;0
808;1072;523;0;0;0;0;.00nan;0;0
808;64230;522;0;0;0;0;.00nan;0;0
808;143036;523;20;14;5;9;.643;3600000;0
808;147264;522;30;32;6;26;.813;3565000;0
809;11882;1477;0;0;0;0;.00nan;0;0
809;11925;521;54;33;4;29;.879;3600000;0
809;63402;1477;100;34;0;34;1.000;3600000;0
809;63848;521;0;0;0;0;.00nan;0;0
810;47112;2193;0;0;0;0;.00nan;0;0
810;68565;1869;0;0;0;0;.00nan;0;0
810;76951;2193;75;18;1;17;.944;3600000;0
810;86686;1869;90;56;4;52;.929;3600000;0
811;177156;1481;0;0;0;0;.00nan;0;0
811;7534;1481;92;20;0;20;1.000;3600000;0
811;67764;1871;0;0;0;0;.00nan;0;0
811;78587;1871;82;33;2;31;.939;3536000;0
946;177156;1481;0;0;0;0;.00nan;0;0
946;7534;1481;90;48;2;46;.958;3600000;0
946;67764;1871;0;0;0;0;.00nan;0;0
946;78587;1871;65;29;3;26;.897;3557000;0
1011;1072;523;0;0;0;0;.00nan;0;0
1011;177156;1481;0;0;0;0;.00nan;0;0
1011;7534;1481;76;31;2;29;.935;3541000;0
1011;143036;523;74;20;1;19;.950;3600000;0
1012;11882;1477;0;0;0;0;.00nan;0;0
1012;47112;2193;0;0;0;0;.00nan;0;0
1012;63402;1477;57;28;4;24;.857;4089000;0
1012;76951;2193;51;34;5;29;.853;4089000;0
1013;1072;523;0;0;0;0;.00nan;0;0
1013;177156;1481;0;0;0;0;.00nan;0;0
1013;7534;1481;93;50;3;47;.940;3583000;0
1013;143036;523;86;28;2;26;.929;3600000;0
1014;11882;1477;70;19;1;18;.947;1375000;0
1014;47112;2193;0;0;0;0;.00nan;0;0
1014;63402;1477;32;24;5;19;.792;2225000;0
1014;76951;2193;52;25;3;22;.880;3600000;0
1015;1072;523;51;2;0;2;1.000;240000;0
1015;177156;1481;0;0;0;0;.00nan;0;0
1015;7534;1481;83;35;3;32;.914;3600000;0
1015;143036;523;32;30;6;24;.800;3360000;0
1016;11882;1477;58;8;0;8;1.000;567000;0
1016;47112;2193;0;0;0;0;.00nan;0;0
1016;63402;1477;26;24;6;18;.750;3033000;0
1016;76951;2193;61;16;1;15;.938;3600000;0
1017;1072;523;0;0;0;0;.00nan;0;0
1017;177156;1481;0;0;0;0;.00nan;0;0
1017;7534;1481;94;41;2;39;.951;4690000;0
1017;143036;523;100;47;1;46;.979;4690000;0
1018;11882;1477;0;0;0;0;.00nan;0;0
1018;47112;2193;45;6;1;5;.833;1908000;0
1018;63402;1477;90;52;4;48;.923;3600000;0
1018;76951;2193;41;16;4;12;.750;1658000;0
1260;1072;523;0;0;0;0;.00nan;0;0
1260;177156;1481;0;0;0;0;.00nan;0;0
1260;7534;1481;100;44;1;43;.977;3600000;0
1260;143036;523;73;30;2;28;.933;3569000;0
1261;11882;1477;0;0;0;0;.00nan;0;0
1261;47112;2193;89;15;0;15;1.000;3600000;0
1261;63402;1477;92;49;3;46;.939;3600000;0
1261;76951;2193;0;0;0;0;.00nan;0;0
1342;1072;523;0;0;0;0;.00nan;0;0
1342;177156;1481;0;0;0;0;.00nan;0;0
1342;7534;1481;67;43;5;38;.884;3600000;0
1342;143036;523;70;24;2;22;.917;3600000;0
1343;11882;1477;0;0;0;0;.00nan;0;0
1343;47112;2193;100;29;0;29;1.000;3600000;0
1343;63402;1477;57;29;4;25;.862;3600000;0
1343;76951;2193;0;0;0;0;.00nan;0;0
1460;1072;523;0;0;0;0;.00nan;0;0
1460;47112;2193;64;18;2;16;.889;3600000;0
1460;76951;2193;0;0;0;0;.00nan;0;0
1460;143036;523;79;39;3;36;.923;3600000;0
1461;1072;523;0;0;0;0;.00nan;0;0
1461;47112;2193;56;32;4;28;.875;4841000;0
1461;76951;2193;0;0;0;0;.00nan;0;0
1461;143036;523;69;51;5;46;.902;4841000;0
1462;1072;523;0;0;0;0;.00nan;0;0
1462;47112;2193;72;31;3;28;.903;3573000;0
1462;76951;2193;0;0;0;0;.00nan;0;0
1462;143036;523;95;46;2;44;.957;3600000;0
1463;1072;523;0;0;0;0;.00nan;0;0
1463;47112;2193;0;0;0;0;.00nan;0;0
1463;76951;2193;68;20;1;19;.950;3600000;0
1463;143036;523;54;26;3;23;.885;3554000;0
1620;1072;523;0;0;0;0;.00nan;0;0
1620;47112;2193;0;0;0;0;.00nan;0;0
1620;76951;2193;68;31;3;28;.903;3600000;0
1620;143036;523;87;33;2;31;.939;3600000;0
1648;1072;523;0;0;0;0;.00nan;0;0
1648;47112;2193;0;0;0;0;.00nan;0;0
1648;76951;2193;64;25;2;23;.920;3561000;0
1648;143036;523;99;35;1;34;.971;3600000;0
1681;1072;523;0;0;0;0;.00nan;0;0
1681;47112;2193;0;0;0;0;.00nan;0;0
1681;76951;2193;74;33;2;31;.939;3558000;0
1681;143036;523;74;22;1;21;.955;3600000;0
20255;11352;1923;74;23;2;21;.913;3900000;0
20255;-1;4794;0;0;0;0;.00nan;0;0
20255;56653;1923;0;0;0;0;.00nan;0;0
20255;67663;4794;85;31;2;29;.935;3900000;0
20256;20196;1925;43;28;5;23;.821;3900000;0
20256;-1;1930;0;0;0;0;.00nan;0;0
20256;89930;1925;0;0;0;0;.00nan;0;0
20256;155945;1930;62;44;5;39;.886;3900000;0
20257;6127;584;26;5;3;2;.400;585000;0
20257;185240;582;73;32;3;29;.906;3600000;0
20257;185744;582;0;0;0;0;.00nan;0;0
20257;-1;584;45;28;5;23;.821;3015000;0
20258;19010;1931;50;16;2;14;.875;3600000;0
20258;56480;2632;0;0;0;0;.00nan;0;0
20258;67454;2632;52;33;5;28;.848;3600000;0
20258;155917;1931;0;0;0;0;.00nan;0;0
20259;40087;579;0;0;0;0;.00nan;0;0
20259;50683;579;69;44;5;39;.886;3569000;0
20259;56901;2259;0;0;0;0;.00nan;0;0
20259;67162;2259;67;37;4;33;.892;3600000;0
20260;185240;582;0;0;0;0;.00nan;0;0
20260;185744;582;81;26;2;24;.923;3600000;0
20260;56901;2259;67;43;6;37;.860;3600000;0
20260;67162;2259;0;0;0;0;.00nan;0;0
20261;11687;1920;0;0;0;0;.00nan;0;0
20261;-1;1930;72;14;0;14;1.000;1337000;0
20261;72514;1920;64;30;4;26;.867;3600000;0
20261;155945;1930;17;16;5;11;.688;2207000;0
20262;20196;1925;0;0;0;0;.00nan;0;0
20262;53936;1934;0;0;0;0;.00nan;0;0
20262;56155;1934;75;63;7;56;.889;3600000;0
20262;89930;1925;75;19;1;18;.947;3600000;0
20263;6127;584;49;19;4;15;.789;3600000;0
20263;40087;579;0;0;0;0;.00nan;0;0
20263;-1;584;0;0;0;0;.00nan;0;0
20263;50683;579;48;29;5;24;.828;3544000;0
20264;19010;1931;0;0;0;0;.00nan;0;0
20264;56155;1934;0;0;0;0;.00nan;0;0
20264;146762;1934;100;39;2;37;.949;3600000;0
20264;155917;1931;39;29;6;23;.793;3600000;0
20265;11687;1920;69;26;2;24;.923;3567000;0
20265;19010;1931;0;0;0;0;.00nan;0;0
20265;72514;1920;0;0;0;0;.00nan;0;0
20265;155917;1931;79;24;1;23;.958;3600000;0
20266;185240;582;0;0;0;0;.00nan;0;0
20266;185744;582;44;17;3;14;.824;3600000;0
20266;56480;2632;0;0;0;0;.00nan;0;0
20266;67454;2632;88;56;5;51;.911;3578000;0
20267;-1;4794;53;33;4;29;.879;1999000;0
20267;185240;582;0;0;0;0;.00nan;0;0
20267;185744;582;67;17;1;16;.941;3600000;0
20267;67663;4794;68;23;2;21;.913;1601000;0
20268;11687;1920;62;24;3;21;.875;3900000;0
20268;56155;1934;0;0;0;0;.00nan;0;0
20268;72514;1920;0;0;0;0;.00nan;0;0
20268;146762;1934;74;34;3;31;.912;3900000;0
20269;6127;584;79;23;1;22;.957;3600000;0
20269;-1;584;0;0;0;0;.00nan;0;0
20269;56480;2632;20;31;7;24;.774;2983000;0
20269;67454;2632;48;7;1;6;.857;617000;0
20270;20196;1925;0;0;0;0;.00nan;0;0
20270;40087;579;0;0;0;0;.00nan;0;0
20270;50683;579;58;48;6;42;.875;3557000;0
20270;89930;1925;43;19;4;15;.789;3600000;0
20271;56901;2259;13;24;7;17;.708;2175000;0
20271;67162;2259;56;11;1;10;.909;1425000;0
20271;149981;1930;75;39;4;35;.897;3600000;0
20271;155945;1930;0;0;0;0;.00nan;0;0
20272;11352;1923;80;40;3;37;.925;3900000;0
20272;56653;1923;0;0;0;0;.00nan;0;0
20272;149981;1930;69;33;3;30;.909;3900000;0
20272;155945;1930;0;0;0;0;.00nan;0;0
20273;20196;1925;0;0;0;0;.00nan;0;0
20273;56155;1934;0;0;0;0;.00nan;0;0
20273;89930;1925;80;30;1;29;.967;3600000;0
20273;146762;1934;46;43;7;36;.837;3600000;0
20274;6127;584;71;20;1;19;.950;3600000;0
20274;-1;584;0;0;0;0;.00nan;0;0
20274;56155;1934;51;40;6;34;.850;3334000;0
20274;146762;1934;41;4;1;3;.750;266000;0
20275;11352;1923;0;0;0;0;.00nan;0;0
20275;56653;1923;70;26;2;24;.923;3600000;0
20275;56901;2259;63;37;3;34;.919;3541000;0
20275;67162;2259;0;0;0;0;.00nan;0;0
20276;185240;582;66;22;2;20;.909;3600000;0
20276;185744;582;0;0;0;0;.00nan;0;0
20276;40087;579;0;0;0;0;.00nan;0;0
20276;50683;579;47;34;5;29;.853;3600000;0
20277;11687;1920;55;24;3;21;.875;3596000;0
20277;56480;2632;0;0;0;0;.00nan;0;0
20277;67454;2632;78;33;2;31;.939;3600000;0
20277;72514;1920;0;0;0;0;.00nan;0;0
20278;-1;4794;58;47;6;41;.872;3600000;0
20278;67663;4794;0;0;0;0;.00nan;0;0
20278;149981;1930;51;18;3;15;.833;3600000;0
20278;155945;1930;0;0;0;0;.00nan;0;0
20279;11687;1920;0;0;0;0;.00nan;0;0
20279;185240;582;0;0;0;0;.00nan;0;0
20279;185744;582;84;25;1;24;.960;3600000;0
20279;72514;1920;39;31;5;26;.839;3600000;0
20280;6127;584;30;24;5;19;.792;3600000;0
20280;-1;584;0;0;0;0;.00nan;0;0
20280;56901;2259;0;0;0;0;.00nan;0;0
20280;67162;2259;97;52;2;50;.962;3600000;0
20281;19010;1931;0;0;0;0;.00nan;0;0
20281;40087;579;22;32;7;25;.781;3600000;0
20281;50683;579;0;0;0;0;.00nan;0;0
20281;155917;1931;89;24;1;23;.958;3600000;0
20282;20196;1925;48;16;2;14;.875;3600000;0
20282;-1;4794;37;28;5;23;.821;2206000;0
20282;67663;4794;24;28;6;22;.786;1394000;0
20282;89930;1925;0;0;0;0;.00nan;0;0
20283;-1;4794;0;0;0;0;.00nan;0;0
20283;56901;2259;70;28;2;26;.929;3632000;0
20283;67162;2259;0;0;0;0;.00nan;0;0
20283;67663;4794;92;57;3;54;.947;3632000;0
20284;185240;582;0;0;0;0;.00nan;0;0
20284;185744;582;69;15;1;14;.933;3600000;0
20284;149981;1930;63;36;4;32;.889;3600000;0
20284;155945;1930;0;0;0;0;.00nan;0;0
20285;40087;579;0;0;0;0;.00nan;0;0
20285;50683;579;80;34;3;31;.912;3600000;0
20285;56480;2632;50;1;0;1;1.000;388000;0
20285;67454;2632;45;40;7;33;.825;3212000;0
20286;-1;4794;59;38;4;34;.895;3600000;0
20286;40087;579;83;16;0;16;1.000;3600000;0
20286;50683;579;0;0;0;0;.00nan;0;0
20286;67663;4794;0;0;0;0;.00nan;0;0
20287;6127;584;94;28;1;27;.964;3600000;0
20287;11687;1920;38;32;5;27;.844;3600000;0
20287;-1;584;0;0;0;0;.00nan;0;0
20287;72514;1920;0;0;0;0;.00nan;0;0
20288;20196;1925;0;0;0;0;.00nan;0;0
20288;185240;582;76;23;1;22;.957;3600000;0
20288;185744;582;0;0;0;0;.00nan;0;0
20288;89930;1925;60;31;4;27;.871;3600000;0
20289;11352;1923;26;30;6;24;.800;3600000;0
20289;19010;1931;78;29;2;27;.931;3600000;0
20289;56653;1923;0;0;0;0;.00nan;0;0
20289;155917;1931;0;0;0;0;.00nan;0;0
20290;56480;2632;36;22;5;17;.773;3593000;0
20290;56901;2259;0;0;0;0;.00nan;0;0
20290;67162;2259;60;34;4;30;.882;3600000;0
20290;67454;2632;0;0;0;0;.00nan;0;0
20291;11352;1923;0;0;0;0;.00nan;0;0
20291;56155;1934;13;5;4;1;.200;662000;0
20291;56653;1923;60;29;4;25;.862;3600000;0
20291;146762;1934;22;35;7;28;.800;2938000;0
20292;6127;584;58;35;4;31;.886;3563000;0
20292;11352;1923;73;27;2;25;.926;3600000;0
20292;-1;584;0;0;0;0;.00nan;0;0
20292;56653;1923;0;0;0;0;.00nan;0;0
20293;40087;579;48;26;4;22;.846;3578000;0
20293;50683;579;0;0;0;0;.00nan;0;0
20293;149981;1930;61;26;3;23;.885;3600000;0
20293;155945;1930;0;0;0;0;.00nan;0;0
20294;11687;1920;0;0;0;0;.00nan;0;0
20294;19010;1931;0;0;0;0;.00nan;0;0
20294;72514;1920;45;35;6;29;.829;3693000;0
20294;155917;1931;64;41;5;36;.878;3693000;0
20295;20196;1925;52;31;5;26;.839;3534000;0
20295;56480;2632;66;32;3;29;.906;3600000;0
20295;67454;2632;0;0;0;0;.00nan;0;0
20295;89930;1925;0;0;0;0;.00nan;0;0
20296;6127;584;76;24;2;22;.917;3600000;0
20296;-1;584;0;0;0;0;.00nan;0;0
20296;56155;1934;66;14;1;13;.929;1302000;0
20296;146762;1934;38;35;6;29;.829;2298000;0
20297;20196;1925;0;0;0;0;.00nan;0;0
20297;40087;579;0;0;0;0;.00nan;0;0
20297;50683;579;29;29;6;23;.793;3533000;0
20297;89930;1925;57;29;4;25;.862;3600000;0
20298;19010;1931;17;23;6;17;.739;2708000;0
20298;56901;2259;73;33;2;31;.939;3600000;0
20298;67162;2259;0;0;0;0;.00nan;0;0
20298;155917;1931;56;5;0;5;1.000;892000;0
20299;-1;4794;0;0;0;0;.00nan;0;0
20299;56480;2632;55;3;0;3;1.000;737000;0
20299;67454;2632;23;20;6;14;.700;2863000;0
20299;67663;4794;40;47;7;40;.851;3558000;0
20300;11352;1923;0;0;0;0;.00nan;0;0
20300;185240;582;0;0;0;0;.00nan;0;0
20300;185744;582;55;25;4;21;.840;3900000;0
20300;56653;1923;65;37;4;33;.892;3900000;0
20301;11687;1920;55;35;5;30;.857;3600000;0
20301;-1;4794;54;44;6;38;.864;3544000;0
20301;67663;4794;0;0;0;0;.00nan;0;0
20301;72514;1920;0;0;0;0;.00nan;0;0
20302;56155;1934;0;0;0;0;.00nan;0;0
20302;56901;2259;0;0;0;0;.00nan;0;0
20302;67162;2259;57;34;4;30;.882;3546000;0
20302;146762;1934;64;29;3;26;.897;3600000;0
20303;20196;1925;0;0;0;0;.00nan;0;0
20303;-1;4794;69;51;6;45;.882;3600000;0
20303;67663;4794;0;0;0;0;.00nan;0;0
20303;89930;1925;68;16;1;15;.938;3600000;0
20304;11352;1923;81;42;3;39;.929;3568000;0
20304;185240;582;0;0;0;0;.00nan;0;0
20304;185744;582;76;26;2;24;.923;3600000;0
20304;56653;1923;0;0;0;0;.00nan;0;0
20305;40087;579;63;32;4;28;.875;3592000;0
20305;50683;579;0;0;0;0;.00nan;0;0
20305;149981;1930;59;18;3;15;.833;3600000;0
20305;155945;1930;0;0;0;0;.00nan;0;0
20306;11687;1920;100;31;0;31;1.000;3600000;0
20306;56901;2259;48;34;5;29;.853;3600000;0
20306;67162;2259;0;0;0;0;.00nan;0;0
20306;72514;1920;0;0;0;0;.00nan;0;0
20307;6127;584;5;13;6;7;.538;1218000;0
20307;53879;584;60;19;2;17;.895;2382000;0
20307;56480;2632;87;32;2;30;.938;3600000;0
20307;67454;2632;0;0;0;0;.00nan;0;0
20308;11352;1923;51;2;0;2;1.000;284000;0
20308;11687;1920;31;30;6;24;.800;2398000;0
20308;56653;1923;13;26;7;19;.731;3316000;0
20308;72514;1920;83;20;0;20;1.000;1202000;0
20309;184159;1934;86;31;2;29;.935;3900000;0
20309;146762;1934;0;0;0;0;.00nan;0;0
20309;149981;1930;0;0;0;0;.00nan;0;0
20309;155945;1930;72;27;2;25;.926;3900000;0
20310;6127;584;67;28;2;26;.929;3600000;0
20310;-1;4794;85;47;3;44;.936;3567000;0
20310;53879;584;0;0;0;0;.00nan;0;0
20310;67663;4794;0;0;0;0;.00nan;0;0
20311;20196;1925;60;23;3;20;.870;3900000;0
20311;89930;1925;0;0;0;0;.00nan;0;0
20311;149981;1930;85;49;3;46;.939;3900000;0
20311;155945;1930;0;0;0;0;.00nan;0;0
20312;11352;1923;81;30;2;28;.933;3600000;0
20312;19010;1931;0;0;0;0;.00nan;0;0
20312;56653;1923;0;0;0;0;.00nan;0;0
20312;155917;1931;44;28;5;23;.821;3600000;0
20313;185240;582;0;0;0;0;.00nan;0;0
20313;185744;582;34;32;6;26;.813;3600000;0
20313;56480;2632;42;3;1;2;.667;240000;0
20313;67454;2632;47;40;6;34;.850;3305000;0
20314;6127;584;0;0;0;0;.00nan;0;0
20314;11687;1920;0;0;0;0;.00nan;0;0
20314;53879;584;59;26;3;23;.885;3600000;0
20314;72514;1920;80;43;4;39;.907;3563000;0
20315;20196;1925;0;0;0;0;.00nan;0;0
20315;56901;2259;0;0;0;0;.00nan;0;0
20315;67162;2259;40;40;6;34;.850;3894000;0
20315;89930;1925;25;34;6;28;.824;3900000;0
20316;19010;1931;57;21;3;18;.857;3600000;0
20316;-1;4794;0;0;0;0;.00nan;0;0
20316;67663;4794;40;28;5;23;.821;3545000;0
20316;155917;1931;0;0;0;0;.00nan;0;0
20317;56901;2259;49;52;7;45;.865;3600000;0
20317;67162;2259;0;0;0;0;.00nan;0;0
20317;149981;1930;78;10;0;10;1.000;3600000;0
20317;155945;1930;0;0;0;0;.00nan;0;0
20318;-1;4794;46;40;6;34;.850;3600000;0
20318;56901;2259;0;0;0;0;.00nan;0;0
20318;67162;2259;75;28;2;26;.929;3600000;0
20318;67663;4794;0;0;0;0;.00nan;0;0
20319;11687;1920;40;38;7;31;.816;3305000;0
20319;56480;2632;89;31;2;29;.935;3600000;0
20319;67454;2632;0;0;0;0;.00nan;0;0
20319;72514;1920;37;6;2;4;.667;295000;0
20320;6127;584;35;16;4;12;.750;3600000;0
20320;11352;1923;52;35;6;29;.829;3549000;0
20320;53879;584;0;0;0;0;.00nan;0;0
20320;56653;1923;0;0;0;0;.00nan;0;0
20321;11352;1923;0;0;0;0;.00nan;0;0
20321;184159;1934;57;37;6;31;.838;3888000;0
20321;56653;1923;32;29;6;23;.793;3900000;0
20321;146762;1934;0;0;0;0;.00nan;0;0
20322;19010;1931;0;0;0;0;.00nan;0;0
20322;185240;582;0;0;0;0;.00nan;0;0
20322;185744;582;48;19;3;16;.842;3600000;0
20322;155917;1931;59;44;5;39;.886;3567000;0
20323;11687;1920;0;0;0;0;.00nan;0;0
20323;20196;1925;62;24;4;20;.833;3600000;0
20323;72514;1920;50;45;6;39;.867;3600000;0
20323;89930;1925;0;0;0;0;.00nan;0;0
20324;40087;579;50;2;0;2;1.000;861000;0
20324;50683;579;22;24;6;18;.750;2739000;0
20324;56901;2259;84;31;1;30;.968;3600000;0
20324;67162;2259;0;0;0;0;.00nan;0;0
20325;19010;1931;39;38;7;31;.816;3568000;0
20325;-1;4794;35;31;6;25;.806;3338000;0
20325;67663;4794;54;3;0;3;1.000;262000;0
20325;155917;1931;0;0;0;0;.00nan;0;0
20326;56480;2632;0;0;0;0;.00nan;0;0
20326;67454;2632;68;34;3;31;.912;3600000;0
20326;149981;1930;32;16;4;12;.750;1134000;0
20326;155945;1930;31;26;6;20;.769;2466000;0
20327;6127;584;31;18;4;14;.778;1055000;0
20327;185240;582;0;0;0;0;.00nan;0;0
20327;185744;582;51;34;5;29;.853;3600000;0
20327;53879;584;57;19;2;17;.895;2538000;0
20328;11352;1923;0;0;0;0;.00nan;0;0
20328;56480;2632;67;45;5;40;.889;3900000;0
20328;56653;1923;55;35;5;30;.857;3900000;0
20328;67454;2632;0;0;0;0;.00nan;0;0
20329;6127;584;39;28;5;23;.821;3600000;0
20329;53879;584;0;0;0;0;.00nan;0;0
20329;149981;1930;91;38;2;36;.947;3600000;0
20329;155945;1930;0;0;0;0;.00nan;0;0
20330;19010;1931;0;0;0;0;.00nan;0;0
20330;20196;1925;0;0;0;0;.00nan;0;0
20330;89930;1925;81;13;0;13;1.000;3600000;0
20330;155917;1931;53;36;4;32;.889;3600000;0
20331;11687;1920;87;21;0;21;1.000;3600000;0
20331;40087;579;53;3;0;3;1.000;680000;0
20331;50683;579;51;37;6;31;.838;2920000;0
20331;72514;1920;0;0;0;0;.00nan;0;0
20332;184159;1934;82;32;2;30;.938;3600000;0
20332;56901;2259;0;0;0;0;.00nan;0;0
20332;67162;2259;33;23;5;18;.783;3600000;0
20332;146762;1934;0;0;0;0;.00nan;0;0
20333;-1;4794;0;0;0;0;.00nan;0;0
20333;56480;2632;0;0;0;0;.00nan;0;0
20333;67454;2632;75;25;1;24;.960;3600000;0
20333;67663;4794;73;58;6;52;.897;3600000;0
20334;185240;582;0;0;0;0;.00nan;0;0
20334;185744;582;91;25;1;24;.960;3600000;0
20334;149981;1930;43;25;4;21;.840;3600000;0
20334;155945;1930;0;0;0;0;.00nan;0;0
20335;11687;1920;36;38;6;32;.842;3600000;0
20335;184159;1934;45;29;5;24;.828;3600000;0
20335;72514;1920;0;0;0;0;.00nan;0;0
20335;146762;1934;0;0;0;0;.00nan;0;0
20336;40087;579;0;0;0;0;.00nan;0;0
20336;50683;579;59;47;5;42;.894;3600000;0
20336;56480;2632;10;32;8;24;.750;3600000;0
20336;67454;2632;0;0;0;0;.00nan;0;0
20337;184159;1934;76;24;1;23;.958;3600000;0
20337;-1;4794;50;39;6;33;.846;3600000;0
20337;67663;4794;0;0;0;0;.00nan;0;0
20337;146762;1934;0;0;0;0;.00nan;0;0
20338;6127;584;68;20;1;19;.950;3600000;0
20338;53879;584;0;0;0;0;.00nan;0;0
20338;149981;1930;34;32;6;26;.813;2587000;0
20338;155945;1930;44;4;1;3;.750;1013000;0
20339;11687;1920;64;10;0;10;1.000;1259000;0
20339;40087;579;50;34;5;29;.853;3600000;0
20339;50683;579;0;0;0;0;.00nan;0;0
20339;72514;1920;24;22;6;16;.727;2289000;0
20340;19010;1931;70;53;6;47;.887;3556000;0
20340;185240;582;0;0;0;0;.00nan;0;0
20340;185744;582;45;22;4;18;.818;3600000;0
20340;155917;1931;0;0;0;0;.00nan;0;0
20341;184159;1934;41;23;4;19;.826;2238000;0
20341;185240;582;78;13;0;13;1.000;3600000;0
20341;185744;582;0;0;0;0;.00nan;0;0
20341;146762;1934;53;22;3;19;.864;1362000;0
20342;6127;584;48;0;0;0;.00nan;256000;0
20342;20196;1925;0;0;0;0;.00nan;0;0
20342;53879;584;58;43;6;37;.860;3344000;0
20342;89930;1925;88;37;3;34;.919;3600000;0
20343;184159;1934;52;37;5;32;.865;3600000;0
20343;40087;579;0;0;0;0;.00nan;0;0
20343;50683;579;34;29;6;23;.793;3563000;0
20343;146762;1934;0;0;0;0;.00nan;0;0
20344;-1;4794;88;42;3;39;.929;3600000;0
20344;67663;4794;0;0;0;0;.00nan;0;0
20344;149981;1930;49;25;4;21;.840;3568000;0
20344;155945;1930;0;0;0;0;.00nan;0;0
20345;11352;1923;42;36;6;30;.833;3600000;0
20345;40087;579;0;0;0;0;.00nan;0;0
20345;50683;579;77;20;1;19;.950;3600000;0
20345;56653;1923;0;0;0;0;.00nan;0;0
20346;20196;1925;0;0;0;0;.00nan;0;0
20346;56901;2259;78;33;2;31;.939;3900000;0
20346;67162;2259;0;0;0;0;.00nan;0;0
20346;89930;1925;77;30;2;28;.933;3900000;0
20347;11352;1923;0;0;0;0;.00nan;0;0
20347;20196;1925;0;0;0;0;.00nan;0;0
20347;56653;1923;43;23;4;19;.826;3531000;0
20347;89930;1925;64;23;2;21;.913;3600000;0
20348;11687;1920;69;33;3;30;.909;3554000;0
20348;185240;582;54;17;2;15;.882;3600000;0
20348;185744;582;0;0;0;0;.00nan;0;0
20348;72514;1920;0;0;0;0;.00nan;0;0
20349;184159;1934;21;21;6;15;.714;1381000;0
20349;56480;2632;0;0;0;0;.00nan;0;0
20349;67454;2632;42;36;6;30;.833;3600000;0
20349;146762;1934;37;33;6;27;.818;2219000;0
20350;6127;584;74;30;2;28;.933;3600000;0
20350;19010;1931;0;0;0;0;.00nan;0;0
20350;53879;584;0;0;0;0;.00nan;0;0
20350;155917;1931;69;38;3;35;.921;3542000;0
20351;11352;1923;45;19;3;16;.842;3600000;0
20351;-1;4794;71;39;4;35;.897;3560000;0
20351;56653;1923;0;0;0;0;.00nan;0;0
20351;67663;4794;0;0;0;0;.00nan;0;0
20352;6127;584;32;24;5;19;.792;3600000;0
20352;19010;1931;54;51;7;44;.863;2232000;0
20352;53879;584;0;0;0;0;.00nan;0;0
20352;155917;1931;46;18;3;15;.833;1368000;0
20353;20196;1925;66;22;2;20;.909;3600000;0
20353;56480;2632;48;30;4;26;.867;1958000;0
20353;67454;2632;30;22;6;16;.727;1642000;0
20353;89930;1925;0;0;0;0;.00nan;0;0
20354;11687;1920;73;21;1;20;.952;1479000;0
20354;72514;1920;44;30;5;25;.833;2088000;0
20354;149981;1930;0;0;0;0;.00nan;0;0
20354;155945;1930;48;26;4;22;.846;3600000;0
20355;19010;1931;0;0;0;0;.00nan;0;0
20355;184159;1934;70;30;3;27;.900;3600000;0
20355;146762;1934;0;0;0;0;.00nan;0;0
20355;155917;1931;54;34;4;30;.882;3544000;0
20356;185240;582;0;0;0;0;.00nan;0;0
20356;185744;582;65;20;2;18;.900;3600000;0
20356;40087;579;66;31;3;28;.903;2801000;0
20356;50683;579;20;11;4;7;.636;799000;0
20357;6127;584;0;0;0;0;.00nan;0;0
20357;53879;584;66;21;1;20;.952;3600000;0
20357;56901;2259;0;0;0;0;.00nan;0;0
20357;67162;2259;89;42;3;39;.929;3553000;0
20358;184159;1934;0;0;0;0;.00nan;0;0
20358;-1;4794;46;30;4;26;.867;3600000;0
20358;67663;4794;0;0;0;0;.00nan;0;0
20358;146762;1934;85;29;1;28;.966;3600000;0
20359;11687;1920;36;33;6;27;.818;2085000;0
20359;20196;1925;0;0;0;0;.00nan;0;0
20359;72514;1920;44;17;3;14;.824;1515000;0
20359;89930;1925;46;18;3;15;.833;3600000;0
20360;-1;4794;54;44;6;38;.864;3111000;0
20360;40087;579;0;0;0;0;.00nan;0;0
20360;50683;579;69;20;2;18;.900;3600000;0
20360;67663;4794;57;5;0;5;1.000;489000;0
20361;19010;1931;78;34;3;31;.912;3600000;0
20361;56480;2632;30;24;6;18;.750;2919000;0
20361;67454;2632;40;9;2;7;.778;681000;0
20361;155917;1931;0;0;0;0;.00nan;0;0
20362;6127;584;52;9;1;8;.889;3600000;0
20362;-1;4794;61;9;0;9;1.000;530000;0
20362;53879;584;0;0;0;0;.00nan;0;0
20362;67663;4794;49;59;8;51;.864;3070000;0
20363;11352;1923;42;28;5;23;.821;3600000;0
20363;11687;1920;23;4;3;1;.250;363000;0
20363;56653;1923;0;0;0;0;.00nan;0;0
20363;72514;1920;53;37;5;32;.865;3237000;0
20364;19010;1931;0;0;0;0;.00nan;0;0
20364;149981;1930;25;31;7;24;.774;3577000;0
20364;155917;1931;54;32;6;26;.813;3600000;0
20364;155945;1930;0;0;0;0;.00nan;0;0
20365;184159;1934;70;44;4;40;.909;3551000;0
20365;40087;579;70;28;2;26;.929;3600000;0
20365;50683;579;0;0;0;0;.00nan;0;0
20365;146762;1934;0;0;0;0;.00nan;0;0
20366;185240;582;0;0;0;0;.00nan;0;0
20366;185744;582;75;27;2;25;.926;3600000;0
20366;56901;2259;76;62;6;56;.903;3600000;0
20366;67162;2259;0;0;0;0;.00nan;0;0
20367;184159;1934;0;0;0;0;.00nan;0;0
20367;146762;1934;73;47;4;43;.915;3900000;0
20367;149981;1930;0;0;0;0;.00nan;0;0
20367;155945;1930;51;32;4;28;.875;3900000;0
20368;11352;1923;0;0;0;0;.00nan;0;0
20368;56480;2632;0;0;0;0;.00nan;0;0
20368;56653;1923;54;29;4;25;.862;3600000;0
20368;67454;2632;50;37;5;32;.865;3550000;0
20369;11352;1923;64;22;2;20;.909;3600000;0
20369;56653;1923;0;0;0;0;.00nan;0;0
20369;56901;2259;0;0;0;0;.00nan;0;0
20369;67162;2259;35;29;5;24;.828;3600000;0
20370;184159;1934;82;43;3;40;.930;3600000;0
20370;56480;2632;0;0;0;0;.00nan;0;0
20370;67454;2632;90;18;0;18;1.000;3600000;0
20370;146762;1934;0;0;0;0;.00nan;0;0
20371;11687;1920;50;31;5;26;.839;3700000;0
20371;-1;4794;51;40;6;34;.850;3700000;0
20371;67663;4794;0;0;0;0;.00nan;0;0
20371;72514;1920;0;0;0;0;.00nan;0;0
20372;56480;2632;0;0;0;0;.00nan;0;0
20372;67454;2632;79;38;2;36;.947;3600000;0
20372;149981;1930;38;28;5;23;.821;3600000;0
20372;155945;1930;0;0;0;0;.00nan;0;0
20373;20196;1925;0;0;0;0;.00nan;0;0
20373;185240;582;31;23;5;18;.783;2992000;0
20373;185744;582;33;14;4;10;.714;608000;0
20373;89930;1925;44;35;6;29;.829;3600000;0
20374;19010;1931;53;37;5;32;.865;3600000;0
20374;40087;579;0;0;0;0;.00nan;0;0
20374;50683;579;86;33;2;31;.939;3600000;0
20374;155917;1931;0;0;0;0;.00nan;0;0
20375;11352;1923;45;29;4;25;.862;3600000;0
20375;40087;579;74;28;2;26;.929;3600000;0
20375;50683;579;0;0;0;0;.00nan;0;0
20375;56653;1923;0;0;0;0;.00nan;0;0
20376;6127;584;40;27;4;23;.852;3600000;0
20376;20196;1925;55;39;5;34;.872;3558000;0
20376;53879;584;0;0;0;0;.00nan;0;0
20376;89930;1925;0;0;0;0;.00nan;0;0
20377;19010;1931;0;0;0;0;.00nan;0;0
20377;56901;2259;77;43;4;39;.907;3900000;0
20377;67162;2259;0;0;0;0;.00nan;0;0
20377;155917;1931;71;33;4;29;.879;3900000;0
20378;-1;4794;56;38;5;33;.868;3653000;0
20378;185240;582;0;0;0;0;.00nan;0;0
20378;185744;582;20;23;6;17;.739;3674000;0
20378;67663;4794;0;0;0;0;.00nan;0;0
20379;6127;584;82;37;3;34;.919;3600000;0
20379;40087;579;0;0;0;0;.00nan;0;0
20379;50683;579;68;44;5;39;.886;3567000;0
20379;53879;584;0;0;0;0;.00nan;0;0
20380;19010;1931;0;0;0;0;.00nan;0;0
20380;149981;1930;50;23;3;20;.870;3600000;0
20380;155917;1931;32;24;5;19;.792;3526000;0
20380;155945;1930;0;0;0;0;.00nan;0;0
20381;11687;1920;0;0;0;0;.00nan;0;0
20381;56901;2259;71;30;2;28;.933;3600000;0
20381;67162;2259;0;0;0;0;.00nan;0;0
20381;72514;1920;63;29;3;26;.897;3556000;0
20382;11352;1923;72;43;4;39;.907;3572000;0
20382;20196;1925;0;0;0;0;.00nan;0;0
20382;56653;1923;0;0;0;0;.00nan;0;0
20382;89930;1925;47;13;2;11;.846;3600000;0
20383;11352;1923;51;2;0;2;1.000;503000;0
20383;56653;1923;41;44;7;37;.841;3097000;0
20383;149981;1930;0;0;0;0;.00nan;0;0
20383;155945;1930;59;26;3;23;.885;3600000;0
20384;184159;1934;53;35;5;30;.857;3599000;0
20384;185240;582;0;0;0;0;.00nan;0;0
20384;185744;582;65;27;3;24;.889;3600000;0
20384;146762;1934;0;0;0;0;.00nan;0;0
20385;19010;1931;80;41;3;38;.927;3766000;0
20385;20196;1925;66;21;2;19;.905;3766000;0
20385;89930;1925;0;0;0;0;.00nan;0;0
20385;155917;1931;0;0;0;0;.00nan;0;0
20386;56480;2632;60;13;1;12;.923;3600000;0
20386;56901;2259;0;0;0;0;.00nan;0;0
20386;67162;2259;65;43;4;39;.907;3600000;0
20386;67454;2632;0;0;0;0;.00nan;0;0
20387;11352;1923;47;20;4;16;.800;3600000;0
20387;-1;4794;33;48;9;39;.813;3600000;0
20387;56653;1923;0;0;0;0;.00nan;0;0
20387;67663;4794;0;0;0;0;.00nan;0;0
20388;6127;584;88;20;0;20;1.000;3600000;0
20388;185240;582;0;0;0;0;.00nan;0;0
20388;185744;582;91;42;3;39;.929;3600000;0
20388;53879;584;0;0;0;0;.00nan;0;0
20389;40087;579;0;0;0;0;.00nan;0;0
20389;50683;579;64;29;4;25;.862;3565000;0
20389;56901;2259;94;46;2;44;.957;3600000;0
20389;67162;2259;0;0;0;0;.00nan;0;0
20390;-1;4794;0;0;0;0;.00nan;0;0
20390;185240;582;0;0;0;0;.00nan;0;0
20390;185744;582;52;26;4;22;.846;3892000;0
20390;67663;4794;94;45;3;42;.933;3892000;0
20391;20196;1925;25;25;6;19;.760;3548000;0
20391;89930;1925;0;0;0;0;.00nan;0;0
20391;149981;1930;69;39;4;35;.897;3600000;0
20391;155945;1930;0;0;0;0;.00nan;0;0
20392;11687;1920;30;33;6;27;.818;3580000;0
20392;19010;1931;0;0;0;0;.00nan;0;0
20392;72514;1920;0;0;0;0;.00nan;0;0
20392;155917;1931;58;35;4;31;.886;3600000;0
20393;6127;584;69;27;2;25;.926;3900000;0
20393;53879;584;0;0;0;0;.00nan;0;0
20393;56901;2259;0;0;0;0;.00nan;0;0
20393;67162;2259;92;39;2;37;.949;3900000;0
20394;11687;1920;0;0;0;0;.00nan;0;0
20394;72514;1920;55;37;5;32;.865;3600000;0
20394;149981;1930;41;2;1;1;.500;415000;0
20394;155945;1930;9;16;6;10;.625;3163000;0
20395;6127;584;51;1;0;1;1.000;348000;0
20395;11352;1923;51;46;7;39;.848;3600000;0
20395;53879;584;27;27;6;21;.778;3252000;0
20395;56653;1923;0;0;0;0;.00nan;0;0
20396;184159;1934;65;43;4;39;.907;3900000;0
20396;56480;2632;0;0;0;0;.00nan;0;0
20396;67454;2632;59;29;4;25;.862;3884000;0
20396;146762;1934;0;0;0;0;.00nan;0;0
20397;-1;4794;89;53;4;49;.925;3600000;0
20397;40087;579;0;0;0;0;.00nan;0;0
20397;50683;579;75;22;1;21;.955;3600000;0
20397;67663;4794;0;0;0;0;.00nan;0;0
20398;185240;582;70;28;2;26;.929;3823000;0
20398;185744;582;0;0;0;0;.00nan;0;0
20398;40087;579;64;31;3;28;.903;3823000;0
20398;50683;579;0;0;0;0;.00nan;0;0
20399;19010;1931;85;35;2;33;.943;3600000;0
20399;184159;1934;34;4;2;2;.500;683000;0
20399;146762;1934;6;21;7;14;.667;2917000;0
20399;155917;1931;0;0;0;0;.00nan;0;0
20400;20196;1925;0;0;0;0;.00nan;0;0
20400;56480;2632;85;35;2;33;.943;3600000;0
20400;67454;2632;0;0;0;0;.00nan;0;0
20400;89930;1925;35;35;6;29;.829;3600000;0
20401;11352;1923;0;0;0;0;.00nan;0;0
20401;56653;1923;59;20;2;18;.900;3600000;0
20401;56901;2259;38;17;3;14;.824;1266000;0
20401;67162;2259;42;36;6;30;.833;2334000;0
20402;20196;1925;0;0;0;0;.00nan;0;0
20402;89930;1925;41;18;3;15;.833;3600000;0
20402;149981;1930;51;39;5;34;.872;3588000;0
20402;155945;1930;0;0;0;0;.00nan;0;0
20403;6127;584;17;26;7;19;.731;2868000;0
20403;40087;579;0;0;0;0;.00nan;0;0
20403;50683;579;76;35;3;32;.914;3600000;0
20403;53879;584;55;6;0;6;1.000;732000;0
20404;19010;1931;0;0;0;0;.00nan;0;0
20404;56480;2632;0;0;0;0;.00nan;0;0
20404;67454;2632;61;31;4;27;.871;3543000;0
20404;155917;1931;99;51;3;48;.941;3600000;0
20405;11687;1920;40;26;4;22;.846;3721000;0
20405;184159;1934;34;24;5;19;.792;3721000;0
20405;72514;1920;0;0;0;0;.00nan;0;0
20405;146762;1934;0;0;0;0;.00nan;0;0
20406;6127;584;0;0;0;0;.00nan;0;0
20406;-1;4794;0;0;0;0;.00nan;0;0
20406;53879;584;39;16;3;13;.813;3600000;0
20406;67663;4794;49;41;6;35;.854;3600000;0
20407;19010;1931;74;45;4;41;.911;3600000;0
20407;20196;1925;47;32;5;27;.844;3573000;0
20407;89930;1925;0;0;0;0;.00nan;0;0
20407;155917;1931;0;0;0;0;.00nan;0;0
20408;40087;579;69;22;1;21;.955;3600000;0
20408;50683;579;0;0;0;0;.00nan;0;0
20408;56901;2259;0;0;0;0;.00nan;0;0
20408;67162;2259;71;34;3;31;.912;3513000;0
20409;11352;1923;48;32;5;27;.844;3900000;0
20409;185240;582;0;0;0;0;.00nan;0;0
20409;185744;582;64;36;5;31;.861;3900000;0
20409;56653;1923;0;0;0;0;.00nan;0;0
20410;184159;1934;0;0;0;0;.00nan;0;0
20410;146762;1934;53;31;5;26;.839;3662000;0
20410;149981;1930;0;0;0;0;.00nan;0;0
20410;155945;1930;59;34;4;30;.882;3662000;0
20411;11687;1920;0;0;0;0;.00nan;0;0
20411;56480;2632;32;33;6;27;.818;3104000;0
20411;67454;2632;49;1;0;1;1.000;443000;0
20411;72514;1920;66;44;5;39;.886;3600000;0
20412;11352;1923;70;31;3;28;.903;3549000;0
20412;-1;4794;0;0;0;0;.00nan;0;0
20412;56653;1923;0;0;0;0;.00nan;0;0
20412;67663;4794;89;32;1;31;.969;3600000;0
20413;6127;584;61;41;4;37;.902;3547000;0
20413;185240;582;0;0;0;0;.00nan;0;0
20413;185744;582;46;21;3;18;.857;3600000;0
20413;53879;584;0;0;0;0;.00nan;0;0
20414;11687;1920;0;0;0;0;.00nan;0;0
20414;20196;1925;0;0;0;0;.00nan;0;0
20414;72514;1920;55;40;5;35;.875;3600000;0
20414;89930;1925;76;31;2;29;.935;3600000;0
20415;19010;1931;45;5;1;4;.800;850000;0
20415;56480;2632;27;23;5;18;.783;2844000;0
20415;67454;2632;22;9;4;5;.556;756000;0
20415;155917;1931;44;38;6;32;.842;2750000;0
20416;-1;4794;0;0;0;0;.00nan;0;0
20416;56901;2259;81;29;2;27;.931;3600000;0
20416;67162;2259;0;0;0;0;.00nan;0;0
20416;67663;4794;42;34;5;29;.853;3600000;0
20417;11352;1923;52;26;4;22;.846;3670000;0
20417;40087;579;0;0;0;0;.00nan;0;0
20417;50683;579;51;36;5;31;.861;3670000;0
20417;56653;1923;0;0;0;0;.00nan;0;0
20418;185240;582;59;24;3;21;.875;3600000;0
20418;185744;582;0;0;0;0;.00nan;0;0
20418;56901;2259;0;0;0;0;.00nan;0;0
20418;67162;2259;63;40;5;35;.875;3525000;0
20419;20196;1925;84;25;1;24;.960;3600000;0
20419;184159;1934;55;30;3;27;.900;3534000;0
20419;89930;1925;0;0;0;0;.00nan;0;0
20419;146762;1934;0;0;0;0;.00nan;0;0
20420;19010;1931;38;37;6;31;.838;3600000;0
20420;149981;1930;72;33;3;30;.909;3600000;0
20420;155917;1931;0;0;0;0;.00nan;0;0
20420;155945;1930;0;0;0;0;.00nan;0;0
20421;56480;2632;0;0;0;0;.00nan;0;0
20421;67454;2632;82;24;2;22;.917;3600000;0
20421;149981;1930;0;0;0;0;.00nan;0;0
20421;155945;1930;65;38;4;34;.895;3577000;0
20422;11687;1920;0;0;0;0;.00nan;0;0
20422;184159;1934;0;0;0;0;.00nan;0;0
20422;72514;1920;43;27;4;23;.852;3592000;0
20422;146762;1934;65;30;3;27;.900;3600000;0
20424;20196;1925;31;25;5;20;.800;3521000;0
20424;40087;579;0;0;0;0;.00nan;0;0
20424;50683;579;95;50;3;47;.940;3600000;0
20424;89930;1925;0;0;0;0;.00nan;0;0
20426;11687;1920;0;0;0;0;.00nan;0;0
20426;-1;1930;0;0;0;0;.00nan;0;0
20426;72514;1920;56;17;2;15;.882;3600000;0
20426;155945;1930;50;31;4;27;.871;3600000;0
20428;11352;1923;52;21;3;18;.857;3600000;0
20428;56480;2632;0;0;0;0;.00nan;0;0
20428;56653;1923;0;0;0;0;.00nan;0;0
20428;67454;2632;68;42;5;37;.881;3557000;0
20430;19010;1931;96;59;4;55;.932;3600000;0
20430;185240;582;0;0;0;0;.00nan;0;0
20430;185744;582;67;18;1;17;.944;3600000;0
20430;155917;1931;0;0;0;0;.00nan;0;0
20432;6127;584;57;18;2;16;.889;3600000;0
20432;-1;584;0;0;0;0;.00nan;0;0
20432;53936;1934;0;0;0;0;.00nan;0;0
20432;56155;1934;40;33;5;28;.848;3600000;0
20434;-1;4794;80;35;2;33;.943;3600000;0
20434;56901;2259;77;34;3;31;.912;3547000;0
20434;67162;2259;0;0;0;0;.00nan;0;0
20434;67663;4794;0;0;0;0;.00nan;0;0
20436;-1;4794;0;0;0;0;.00nan;0;0
20436;56901;2259;0;0;0;0;.00nan;0;0
20436;67162;2259;46;36;6;30;.833;3600000;0
20436;67663;4794;100;25;0;25;1.000;3600000;0
20438;-1;1930;49;23;3;20;.870;3600000;0
20438;56480;2632;48;30;5;25;.833;3572000;0
20438;67454;2632;0;0;0;0;.00nan;0;0
20438;155945;1930;0;0;0;0;.00nan;0;0
20440;11352;1923;0;0;0;0;.00nan;0;0
20440;11687;1920;65;42;5;37;.881;3517000;0
20440;56653;1923;52;21;3;18;.857;3600000;0
20440;72514;1920;0;0;0;0;.00nan;0;0
20442;19010;1931;0;0;0;0;.00nan;0;0
20442;185240;582;45;16;3;13;.813;3600000;0
20442;185744;582;0;0;0;0;.00nan;0;0
20442;155917;1931;72;40;5;35;.875;3600000;0
20444;40087;579;58;32;4;28;.875;3560000;0
20444;50683;579;0;0;0;0;.00nan;0;0
20444;53936;1934;46;20;3;17;.850;3600000;0
20444;56155;1934;0;0;0;0;.00nan;0;0
20446;6127;584;0;0;0;0;.00nan;0;0
20446;20196;1925;0;0;0;0;.00nan;0;0
20446;-1;584;62;43;5;38;.884;3570000;0
20446;89930;1925;48;21;3;18;.857;3600000;0
20448;11352;1923;46;24;4;20;.833;3600000;0
20448;56480;2632;0;0;0;0;.00nan;0;0
20448;56653;1923;0;0;0;0;.00nan;0;0
20448;67454;2632;55;39;5;34;.872;3600000;0
20450;19010;1931;26;30;7;23;.767;2881000;0
20450;40087;579;0;0;0;0;.00nan;0;0
20450;50683;579;55;20;2;18;.900;3600000;0
20450;155917;1931;64;16;1;15;.938;719000;0
20452;20196;1925;66;20;1;19;.950;3600000;0
20452;-1;1930;0;0;0;0;.00nan;0;0
20452;89930;1925;0;0;0;0;.00nan;0;0
20452;155945;1930;74;43;4;39;.907;3600000;0
20454;6127;584;92;21;0;21;1.000;3600000;0
20454;11687;1920;0;0;0;0;.00nan;0;0
20454;-1;584;0;0;0;0;.00nan;0;0
20454;72514;1920;87;54;5;49;.907;3600000;0
20456;53936;1934;70;41;4;37;.902;3580000;0
20456;56155;1934;0;0;0;0;.00nan;0;0
20456;56901;2259;0;0;0;0;.00nan;0;0
20456;67162;2259;62;23;2;21;.913;3600000;0
20458;-1;4794;26;27;6;21;.778;2379000;0
20458;185240;582;86;15;0;15;1.000;3600000;0
20458;185744;582;0;0;0;0;.00nan;0;0
20458;67663;4794;40;15;3;12;.800;1221000;0
20460;6127;584;69;32;3;29;.906;3600000;0
20460;40087;579;26;30;6;24;.800;2772000;0
20460;-1;584;0;0;0;0;.00nan;0;0
20460;50683;579;63;6;0;6;1.000;828000;0
20462;11687;1920;42;29;4;25;.862;3600000;0
20462;53936;1934;0;0;0;0;.00nan;0;0
20462;56155;1934;99;41;1;40;.976;3600000;0
20462;72514;1920;0;0;0;0;.00nan;0;0
20464;11352;1923;0;0;0;0;.00nan;0;0
20464;19010;1931;0;0;0;0;.00nan;0;0
20464;56653;1923;74;26;2;24;.923;3600000;0
20464;155917;1931;59;35;4;31;.886;3524000;0
20466;20196;1925;0;0;0;0;.00nan;0;0
20466;56901;2259;95;40;2;38;.950;3576000;0
20466;67162;2259;0;0;0;0;.00nan;0;0
20466;89930;1925;68;21;1;20;.952;3600000;0
20468;-1;4794;53;25;3;22;.880;3600000;0
20468;56480;2632;67;30;4;26;.867;3544000;0
20468;67454;2632;0;0;0;0;.00nan;0;0
20468;67663;4794;0;0;0;0;.00nan;0;0
20470;185240;582;64;18;1;17;.944;3600000;0
20470;185744;582;0;0;0;0;.00nan;0;0
20470;-1;1930;39;29;5;24;.828;2164000;0
20470;155945;1930;48;12;2;10;.833;1436000;0
256;19010;1931;57;13;1;12;.923;1351000;0
256;185240;582;0;0;0;0;.00nan;0;0
256;185744;582;44;17;3;14;.824;3600000;0
256;155917;1931;46;36;6;30;.833;2249000;0
257;11352;1923;46;29;4;25;.862;3074000;0
257;20196;1925;0;0;0;0;.00nan;0;0
257;56653;1923;38;9;3;6;.667;557000;0
257;89930;1925;26;21;6;15;.714;3631000;0
258;6127;584;83;39;3;36;.923;3600000;0
258;-1;584;0;0;0;0;.00nan;0;0
258;56480;2632;51;42;6;36;.857;3600000;0
258;67454;2632;0;0;0;0;.00nan;0;0
259;11352;1923;60;24;3;21;.875;3555000;0
259;185240;582;0;0;0;0;.00nan;0;0
259;185744;582;82;33;2;31;.939;3600000;0
259;56653;1923;0;0;0;0;.00nan;0;0
260;19010;1931;31;44;8;36;.818;3600000;0
260;56480;2632;0;0;0;0;.00nan;0;0
260;67454;2632;51;27;4;23;.852;3600000;0
260;155917;1931;0;0;0;0;.00nan;0;0
261;6127;584;70;36;3;33;.917;3600000;0
261;20196;1925;0;0;0;0;.00nan;0;0
261;-1;584;0;0;0;0;.00nan;0;0
261;89930;1925;58;31;4;27;.871;3562000;0
262;185240;582;0;0;0;0;.00nan;0;0
262;185744;582;61;27;3;24;.889;3590000;0
262;56480;2632;64;26;2;24;.923;3600000;0
262;67454;2632;0;0;0;0;.00nan;0;0
263;6127;584;0;0;0;0;.00nan;0;0
263;11352;1923;22;37;8;29;.784;2781000;0
263;53879;584;60;24;3;21;.875;3600000;0
263;56653;1923;57;10;1;9;.900;819000;0
264;19010;1931;64;21;2;19;.905;1671000;0
264;20196;1925;0;0;0;0;.00nan;0;0
264;89930;1925;62;20;2;18;.900;3600000;0
264;155917;1931;14;20;6;14;.700;1929000;0
265;6127;584;90;40;2;38;.950;3600000;0
265;185240;582;22;26;6;20;.769;2474000;0
265;185744;582;42;3;1;2;.667;1126000;0
265;53879;584;0;0;0;0;.00nan;0;0
266;20196;1925;0;0;0;0;.00nan;0;0
266;56480;2632;20;25;6;19;.760;2657000;0
266;67454;2632;53;12;1;11;.917;943000;0
266;89930;1925;55;37;5;32;.865;3600000;0
267;11352;1923;0;0;0;0;.00nan;0;0
267;19010;1931;98;45;2;43;.956;3900000;0
267;56653;1923;50;16;2;14;.875;3900000;0
267;155917;1931;0;0;0;0;.00nan;0;0
268;20196;1925;0;0;0;0;.00nan;0;0
268;185240;582;0;0;0;0;.00nan;0;0
268;185744;582;67;26;2;24;.923;3544000;0
268;89930;1925;72;26;1;25;.962;3600000;0
269;6127;584;51;28;4;24;.857;3600000;0
269;19010;1931;0;0;0;0;.00nan;0;0
269;53879;584;0;0;0;0;.00nan;0;0
269;155917;1931;65;44;5;39;.886;3546000;0
270;11352;1923;68;31;3;28;.903;3600000;0
270;56480;2632;72;22;1;21;.955;3600000;0
270;56653;1923;0;0;0;0;.00nan;0;0
270;67454;2632;0;0;0;0;.00nan;0;0
271;19010;1931;98;44;2;42;.955;3900000;0
271;185240;582;53;22;2;20;.909;3900000;0
271;185744;582;0;0;0;0;.00nan;0;0
271;155917;1931;0;0;0;0;.00nan;0;0
272;11352;1923;53;40;6;34;.850;3600000;0
272;20196;1925;0;0;0;0;.00nan;0;0
272;56653;1923;0;0;0;0;.00nan;0;0
272;89930;1925;72;27;1;26;.963;3600000;0
273;6127;584;0;0;0;0;.00nan;0;0
273;53879;584;58;20;2;18;.900;3600000;0
273;56480;2632;0;0;0;0;.00nan;0;0
273;67454;2632;57;39;5;34;.872;3600000;0
274;11352;1923;62;38;4;34;.895;3600000;0
274;185240;582;0;0;0;0;.00nan;0;0
274;185744;582;22;16;5;11;.688;3587000;0
274;56653;1923;0;0;0;0;.00nan;0;0
275;19010;1931;57;30;4;26;.867;2978000;0
275;56480;2632;0;0;0;0;.00nan;0;0
275;67454;2632;88;37;2;35;.946;3600000;0
275;155917;1931;16;6;4;2;.333;622000;0
276;6127;584;54;42;6;36;.857;3673000;0
276;20196;1925;0;0;0;0;.00nan;0;0
276;53879;584;0;0;0;0;.00nan;0;0
276;89930;1925;66;43;5;38;.884;3673000;0
277;185240;582;64;23;2;21;.913;3600000;0
277;185744;582;0;0;0;0;.00nan;0;0
277;56480;2632;0;0;0;0;.00nan;0;0
277;67454;2632;55;40;5;35;.875;3600000;0
278;6127;584;65;16;1;15;.938;3600000;0
278;11352;1923;0;0;0;0;.00nan;0;0
278;53879;584;0;0;0;0;.00nan;0;0
278;56653;1923;76;34;2;32;.941;3587000;0
279;19010;1931;57;34;5;29;.853;2595000;0
279;20196;1925;0;0;0;0;.00nan;0;0
279;89930;1925;73;25;2;23;.920;3600000;0
279;155917;1931;20;11;4;7;.636;1005000;0
280;6127;584;52;29;4;25;.862;3523000;0
280;185240;582;77;39;2;37;.949;3600000;0
280;185744;582;0;0;0;0;.00nan;0;0
280;53879;584;0;0;0;0;.00nan;0;0
281;20196;1925;63;38;4;34;.895;3798000;0
281;56480;2632;0;0;0;0;.00nan;0;0
281;67454;2632;72;31;3;28;.903;3798000;0
281;89930;1925;0;0;0;0;.00nan;0;0
282;11352;1923;78;27;1;26;.963;3600000;0
282;19010;1931;0;0;0;0;.00nan;0;0
282;56653;1923;0;0;0;0;.00nan;0;0
282;155917;1931;60;39;5;34;.872;3600000;0
283;20196;1925;47;7;1;6;.857;1240000;0
283;185240;582;75;28;3;25;.893;3600000;0
283;185744;582;0;0;0;0;.00nan;0;0
283;89930;1925;25;22;6;16;.727;2360000;0
284;6127;584;59;29;4;25;.862;3600000;0
284;19010;1931;63;41;5;36;.878;3600000;0
284;53879;584;0;0;0;0;.00nan;0;0
284;155917;1931;0;0;0;0;.00nan;0;0
285;11352;1923;59;30;4;26;.867;3600000;0
285;56480;2632;52;39;5;34;.872;3557000;0
285;56653;1923;0;0;0;0;.00nan;0;0
285;67454;2632;0;0;0;0;.00nan;0;0
286;-1;4794;0;0;0;0;.00nan;0;0
286;67663;4794;18;38;8;30;.789;3600000;0
286;149981;1930;40;21;4;17;.810;3600000;0
286;155945;1930;0;0;0;0;.00nan;0;0
287;11687;1920;0;0;0;0;.00nan;0;0
287;40087;579;0;0;0;0;.00nan;0;0
287;50683;579;56;30;4;26;.867;3600000;0
287;72514;1920;68;45;5;40;.889;3594000;0
288;184159;1934;61;26;3;23;.885;3589000;0
288;56901;2259;87;24;1;23;.958;3600000;0
288;67162;2259;0;0;0;0;.00nan;0;0
288;146762;1934;0;0;0;0;.00nan;0;0
289;11687;1920;0;0;0;0;.00nan;0;0
289;72514;1920;66;36;4;32;.889;3710000;0
289;149981;1930;57;25;3;22;.880;3710000;0
289;155945;1930;0;0;0;0;.00nan;0;0
290;-1;4794;0;0;0;0;.00nan;0;0
290;56901;2259;0;0;0;0;.00nan;0;0
290;67162;2259;79;34;2;32;.941;3600000;0
290;67663;4794;53;24;3;21;.875;3544000;0
291;184159;1934;67;26;2;24;.923;3600000;0
291;40087;579;0;0;0;0;.00nan;0;0
291;50683;579;49;26;4;22;.846;3536000;0
291;146762;1934;0;0;0;0;.00nan;0;0
292;56901;2259;91;35;1;34;.971;3600000;0
292;67162;2259;0;0;0;0;.00nan;0;0
292;149981;1930;39;22;4;18;.818;3600000;0
292;155945;1930;0;0;0;0;.00nan;0;0
293;11687;1920;81;58;6;52;.897;3600000;0
293;184159;1934;39;15;3;12;.800;3600000;0
293;72514;1920;0;0;0;0;.00nan;0;0
293;146762;1934;0;0;0;0;.00nan;0;0
294;-1;4794;46;32;4;28;.875;3260000;0
294;40087;579;0;0;0;0;.00nan;0;0
294;50683;579;56;17;2;15;.882;3600000;0
294;67663;4794;22;5;3;2;.400;340000;0
295;184159;1934;95;36;1;35;.972;3900000;0
295;146762;1934;0;0;0;0;.00nan;0;0
295;149981;1930;95;28;1;27;.964;3900000;0
295;155945;1930;0;0;0;0;.00nan;0;0
296;40087;579;53;3;0;3;1.000;330000;0
296;50683;579;45;35;6;29;.829;3270000;0
296;56901;2259;0;0;0;0;.00nan;0;0
296;67162;2259;82;26;1;25;.962;3600000;0
297;11687;1920;0;0;0;0;.00nan;0;0
297;-1;4794;70;37;3;34;.919;3541000;0
297;67663;4794;0;0;0;0;.00nan;0;0
297;72514;1920;64;18;1;17;.944;3600000;0
298;40087;579;0;0;0;0;.00nan;0;0
298;50683;579;74;35;3;32;.914;3549000;0
298;149981;1930;99;38;1;37;.974;3600000;0
298;155945;1930;0;0;0;0;.00nan;0;0
299;184159;1934;100;28;0;28;1.000;3600000;0
299;-1;4794;83;41;3;38;.927;3600000;0
299;67663;4794;0;0;0;0;.00nan;0;0
299;146762;1934;0;0;0;0;.00nan;0;0
300;11687;1920;69;33;3;30;.909;3600000;0
300;56901;2259;33;27;5;22;.815;3550000;0
300;67162;2259;0;0;0;0;.00nan;0;0
300;72514;1920;0;0;0;0;.00nan;0;0
301;-1;4794;53;39;5;34;.872;3597000;0
301;67663;4794;0;0;0;0;.00nan;0;0
301;149981;1930;63;32;4;28;.875;3600000;0
301;155945;1930;0;0;0;0;.00nan;0;0
302;11687;1920;0;0;0;0;.00nan;0;0
302;40087;579;58;7;0;7;1.000;886000;0
302;50683;579;40;27;6;21;.778;2679000;0
302;72514;1920;80;48;5;43;.896;3600000;0
303;184159;1934;72;30;2;28;.933;3600000;0
303;56901;2259;0;0;0;0;.00nan;0;0
303;67162;2259;59;33;4;29;.879;3543000;0
303;146762;1934;0;0;0;0;.00nan;0;0
304;11687;1920;90;44;3;41;.932;3600000;0
304;72514;1920;0;0;0;0;.00nan;0;0
304;149981;1930;42;19;4;15;.789;3600000;0
304;155945;1930;0;0;0;0;.00nan;0;0
305;-1;4794;68;31;3;28;.903;3600000;0
305;56901;2259;38;25;6;19;.760;3275000;0
305;67162;2259;49;2;0;2;1.000;325000;0
305;67663;4794;0;0;0;0;.00nan;0;0
306;184159;1934;60;46;6;40;.870;3561000;0
306;40087;579;0;0;0;0;.00nan;0;0
306;50683;579;36;16;4;12;.750;3600000;0
306;146762;1934;0;0;0;0;.00nan;0;0
307;56901;2259;45;12;2;10;.833;1513000;0
307;67162;2259;32;26;6;20;.769;2087000;0
307;149981;1930;49;29;5;24;.828;3600000;0
307;155945;1930;0;0;0;0;.00nan;0;0
308;11687;1920;0;0;0;0;.00nan;0;0
308;184159;1934;56;40;5;35;.875;3600000;0
308;72514;1920;83;25;1;24;.960;3600000;0
308;146762;1934;0;0;0;0;.00nan;0;0
309;-1;4794;87;47;5;42;.894;3628000;0
309;40087;579;0;0;0;0;.00nan;0;0
309;50683;579;46;23;4;19;.826;3628000;0
309;67663;4794;0;0;0;0;.00nan;0;0
310;184159;1934;80;25;1;24;.960;3600000;0
310;146762;1934;0;0;0;0;.00nan;0;0
310;149981;1930;62;26;3;23;.885;3514000;0
310;155945;1930;0;0;0;0;.00nan;0;0
311;40087;579;60;33;4;29;.879;3600000;0
311;50683;579;0;0;0;0;.00nan;0;0
311;56901;2259;42;34;5;29;.853;3600000;0
311;67162;2259;0;0;0;0;.00nan;0;0
312;11687;1920;57;35;4;31;.886;3569000;0
312;-1;4794;0;0;0;0;.00nan;0;0
312;67663;4794;73;28;2;26;.929;3600000;0
312;72514;1920;0;0;0;0;.00nan;0;0
313;40087;579;0;0;0;0;.00nan;0;0
313;50683;579;31;23;5;18;.783;3600000;0
313;149981;1930;0;0;0;0;.00nan;0;0
313;155945;1930;47;38;6;32;.842;3600000;0
314;184159;1934;72;29;2;27;.931;3600000;0
314;-1;4794;48;32;5;27;.844;3600000;0
314;67663;4794;0;0;0;0;.00nan;0;0
314;146762;1934;0;0;0;0;.00nan;0;0
315;11687;1920;0;0;0;0;.00nan;0;0
315;56901;2259;0;0;0;0;.00nan;0;0
315;67162;2259;55;30;4;26;.867;3550000;0
315;72514;1920;76;36;3;33;.917;3600000;0
865;184159;1934;88;50;4;46;.920;3545000;0
865;185240;582;0;0;0;0;.00nan;0;0
865;185744;582;44;15;3;12;.800;3600000;0
865;146762;1934;0;0;0;0;.00nan;0;0
866;6127;584;68;18;1;17;.944;3600000;0
866;53879;584;0;0;0;0;.00nan;0;0
866;149981;1930;63;38;5;33;.868;3600000;0
866;155945;1930;0;0;0;0;.00nan;0;0
867;19010;1931;79;50;4;46;.920;3570000;0
867;20196;1925;0;0;0;0;.00nan;0;0
867;89930;1925;55;18;2;16;.889;3600000;0
867;155917;1931;0;0;0;0;.00nan;0;0
868;11352;1923;0;0;0;0;.00nan;0;0
868;56480;2632;0;0;0;0;.00nan;0;0
868;56653;1923;43;46;7;39;.848;3600000;0
868;67454;2632;76;31;2;29;.935;3600000;0
869;184159;1934;51;39;6;33;.846;3600000;0
869;185240;582;0;0;0;0;.00nan;0;0
869;185744;582;15;24;7;17;.708;3552000;0
869;146762;1934;0;0;0;0;.00nan;0;0
870;6127;584;51;22;3;19;.864;3600000;0
870;53879;584;0;0;0;0;.00nan;0;0
870;149981;1930;53;38;7;31;.816;3600000;0
870;155945;1930;0;0;0;0;.00nan;0;0
871;19010;1931;0;0;0;0;.00nan;0;0
871;20196;1925;0;0;0;0;.00nan;0;0
871;89930;1925;40;9;2;7;.778;3600000;0
871;155917;1931;51;50;7;43;.860;3600000;0
872;11352;1923;99;29;1;28;.966;3600000;0
872;56480;2632;0;0;0;0;.00nan;0;0
872;56653;1923;0;0;0;0;.00nan;0;0
872;67454;2632;75;33;3;30;.909;3571000;0
873;184159;1934;74;43;4;39;.907;3528000;0
873;185240;582;0;0;0;0;.00nan;0;0
873;185744;582;61;19;2;17;.895;3600000;0
873;146762;1934;0;0;0;0;.00nan;0;0
874;6127;584;10;20;6;14;.700;3600000;0
874;53879;584;0;0;0;0;.00nan;0;0
874;149981;1930;83;34;2;32;.941;3600000;0
874;155945;1930;0;0;0;0;.00nan;0;0
875;19010;1931;0;0;0;0;.00nan;0;0
875;20196;1925;0;0;0;0;.00nan;0;0
875;89930;1925;32;20;4;16;.800;3600000;0
875;155917;1931;100;51;0;51;1.000;3600000;0
876;11352;1923;37;31;5;26;.839;3563000;0
876;56480;2632;0;0;0;0;.00nan;0;0
876;56653;1923;0;0;0;0;.00nan;0;0
876;67454;2632;52;18;3;15;.833;3600000;0
1240;184159;1934;56;53;6;47;.887;3600000;0
1240;185240;582;0;0;0;0;.00nan;0;0
1240;185744;582;68;17;1;16;.941;3600000;0
1240;146762;1934;0;0;0;0;.00nan;0;0
1241;6127;584;36;21;4;17;.810;3552000;0
1241;53879;584;0;0;0;0;.00nan;0;0
1241;149981;1930;98;39;2;37;.949;3600000;0
1241;155945;1930;0;0;0;0;.00nan;0;0
1242;19010;1931;0;0;0;0;.00nan;0;0
1242;20196;1925;0;0;0;0;.00nan;0;0
1242;89930;1925;55;19;2;17;.895;3600000;0
1242;155917;1931;53;36;5;31;.861;3575000;0
1243;11352;1923;73;43;5;38;.884;3560000;0
1243;56480;2632;0;0;0;0;.00nan;0;0
1243;56653;1923;0;0;0;0;.00nan;0;0
1243;67454;2632;56;25;4;21;.840;3600000;0
1262;6127;584;79;27;1;26;.963;3600000;0
1262;53879;584;0;0;0;0;.00nan;0;0
1262;149981;1930;80;38;3;35;.921;3600000;0
1262;155945;1930;0;0;0;0;.00nan;0;0
1344;185240;582;0;0;0;0;.00nan;0;0
1344;185744;582;77;26;2;24;.923;3600000;0
1344;56480;2632;0;0;0;0;.00nan;0;0
1344;67454;2632;61;29;3;26;.897;3543000;0
1345;6127;584;89;31;1;30;.968;3600000;0
1345;20196;1925;0;0;0;0;.00nan;0;0
1345;53879;584;0;0;0;0;.00nan;0;0
1345;89930;1925;74;46;5;41;.891;3600000;0
1346;185240;582;64;16;1;15;.938;1502000;0
1346;185744;582;32;21;4;17;.810;2048000;0
1346;56480;2632;0;0;0;0;.00nan;0;0
1346;67454;2632;55;33;4;29;.879;3600000;0
1347;6127;584;94;50;3;47;.940;4129000;0
1347;20196;1925;0;0;0;0;.00nan;0;0
1347;53879;584;0;0;0;0;.00nan;0;0
1347;89930;1925;83;37;2;35;.946;4129000;0
1348;185240;582;0;0;0;0;.00nan;0;0
1348;185744;582;64;29;3;26;.897;3600000;0
1348;56480;2632;0;0;0;0;.00nan;0;0
1348;67454;2632;17;35;7;28;.800;3600000;0
1349;6127;584;62;35;4;31;.886;3784000;0
1349;20196;1925;0;0;0;0;.00nan;0;0
1349;53879;584;0;0;0;0;.00nan;0;0
1349;89930;1925;90;39;3;36;.923;3784000;0
1621;185240;582;0;0;0;0;.00nan;0;0
1621;185744;582;55;24;3;21;.875;3600000;0
1621;56480;2632;0;0;0;0;.00nan;0;0
1621;67454;2632;92;50;4;46;.920;3600000;0
1622;6127;584;83;34;2;32;.941;3600000;0
1622;20196;1925;0;0;0;0;.00nan;0;0
1622;53879;584;0;0;0;0;.00nan;0;0
1622;89930;1925;61;49;6;43;.878;3600000;0
1649;6127;584;70;42;5;37;.881;3553000;0
1649;20196;1925;0;0;0;0;.00nan;0;0
1649;53879;584;0;0;0;0;.00nan;0;0
1649;89930;1925;58;33;4;29;.879;3600000;0
1682;20196;1925;0;0;0;0;.00nan;0;0
1682;185240;582;50;9;1;8;.889;1256000;0
1682;185744;582;19;22;6;16;.727;2344000;0
1682;89930;1925;65;24;2;22;.917;3600000;0
1683;20196;1925;0;0;0;0;.00nan;0;0
1683;185240;582;50;31;5;26;.839;3600000;0
1683;185744;582;0;0;0;0;.00nan;0;0
1683;89930;1925;46;29;6;23;.793;3545000;0
1684;20196;1925;0;0;0;0;.00nan;0;0
1684;185240;582;70;28;3;25;.893;3693000;0
1684;185744;582;0;0;0;0;.00nan;0;0
1684;89930;1925;72;27;2;25;.926;3693000;0
1908;20196;1925;0;0;0;0;.00nan;0;0
1908;185240;582;71;24;1;23;.958;3600000;0
1908;185744;582;0;0;0;0;.00nan;0;0
1908;89930;1925;71;33;3;30;.909;3553000;0
20471;6998;2161;0;0;0;0;.00nan;0;0
20471;193486;2161;79;42;4;38;.905;3582000;0
20471;177771;2163;84;35;2;33;.943;3600000;0
20471;161081;2163;0;0;0;0;.00nan;0;0
20472;163361;2164;59;14;1;13;.929;3600000;0
20472;-1;2164;0;0;0;0;.00nan;0;0
20472;179350;4840;76;35;2;33;.943;3574000;0
20472;-1;4840;0;0;0;0;.00nan;0;0
20473;19346;2158;60;12;1;11;.917;3600000;0
20473;21607;2162;0;0;0;0;.00nan;0;0
20473;-1;2162;97;71;2;69;.972;3600000;0
20473;161069;2158;0;0;0;0;.00nan;0;0
20474;6998;2161;0;0;0;0;.00nan;0;0
20474;193486;2161;94;38;1;37;.974;3600000;0
20474;177771;2163;0;0;0;0;.00nan;0;0
20474;161081;2163;42;31;5;26;.839;3600000;0
20475;163361;2164;59;31;4;27;.871;3600000;0
20475;-1;2164;0;0;0;0;.00nan;0;0
20475;179350;4840;27;24;5;19;.792;3562000;0
20475;-1;4840;0;0;0;0;.00nan;0;0
20476;19346;2158;60;14;2;12;.857;3900000;0
20476;21607;2162;0;0;0;0;.00nan;0;0
20476;-1;2162;90;45;2;43;.956;3900000;0
20476;161069;2158;0;0;0;0;.00nan;0;0
20477;163361;2164;74;22;1;21;.955;3600000;0
20477;21607;2162;0;0;0;0;.00nan;0;0
20477;-1;2164;0;0;0;0;.00nan;0;0
20477;-1;2162;50;26;3;23;.885;3541000;0
20478;6998;2161;80;29;2;27;.931;3600000;0
20478;193486;2161;0;0;0;0;.00nan;0;0
20478;179350;4840;60;34;3;31;.912;3548000;0
20478;-1;4840;0;0;0;0;.00nan;0;0
20479;177771;2163;0;0;0;0;.00nan;0;0
20479;19346;2158;62;14;1;13;.929;3600000;0
20479;161069;2158;0;0;0;0;.00nan;0;0
20479;161081;2163;68;47;5;42;.894;3600000;0
20480;163361;2164;0;0;0;0;.00nan;0;0
20480;21607;2162;0;0;0;0;.00nan;0;0
20480;-1;2164;84;34;2;32;.941;3600000;0
20480;-1;2162;64;35;4;31;.886;3536000;0
20481;6998;2161;0;0;0;0;.00nan;0;0
20481;193486;2161;72;25;2;23;.920;3900000;0
20481;179350;4840;0;0;0;0;.00nan;0;0
20481;-1;4840;98;37;2;35;.946;3900000;0
20482;177771;2163;0;0;0;0;.00nan;0;0
20482;19346;2158;0;0;0;0;.00nan;0;0
20482;161069;2158;75;17;1;16;.941;3871000;0
20482;161081;2163;92;46;2;44;.957;3871000;0
20483;177771;2163;0;0;0;0;.00nan;0;0
20483;21607;2162;0;0;0;0;.00nan;0;0
20483;-1;2162;74;33;3;30;.909;3539000;0
20483;161081;2163;81;22;1;21;.955;3600000;0
20484;19346;2158;55;11;1;10;.909;3600000;0
20484;179350;4840;98;72;5;67;.931;3600000;0
20484;-1;4840;0;0;0;0;.00nan;0;0
20484;161069;2158;0;0;0;0;.00nan;0;0
20485;177771;2163;63;29;3;26;.897;3547000;0
20485;21607;2162;0;0;0;0;.00nan;0;0
20485;-1;2162;74;37;2;35;.946;3600000;0
20485;161081;2163;0;0;0;0;.00nan;0;0
20486;19346;2158;60;13;1;12;.923;3600000;0
20486;179350;4840;70;22;1;21;.955;1258000;0
20486;-1;4840;45;38;6;32;.842;2342000;0
20486;161069;2158;0;0;0;0;.00nan;0;0
20487;163361;2164;78;54;5;49;.907;3600000;0
20487;19346;2158;55;13;2;11;.846;3600000;0
20487;-1;2164;0;0;0;0;.00nan;0;0
20487;161069;2158;0;0;0;0;.00nan;0;0
20488;177771;2163;0;0;0;0;.00nan;0;0
20488;21607;2162;0;0;0;0;.00nan;0;0
20488;-1;2162;57;41;5;36;.878;3600000;0
20488;161081;2163;59;18;2;16;.889;3600000;0
20489;163361;2164;0;0;0;0;.00nan;0;0
20489;19346;2158;0;0;0;0;.00nan;0;0
20489;-1;2164;48;54;8;46;.852;3600000;0
20489;161069;2158;48;9;1;8;.889;3600000;0
20490;177771;2163;64;16;1;15;.938;3600000;0
20490;21607;2162;0;0;0;0;.00nan;0;0
20490;-1;2162;87;41;2;39;.951;3600000;0
20490;161081;2163;0;0;0;0;.00nan;0;0
20491;6998;2161;0;0;0;0;.00nan;0;0
20491;163361;2164;59;27;3;24;.889;3513000;0
20491;193486;2161;81;25;1;24;.960;3600000;0
20491;-1;2164;0;0;0;0;.00nan;0;0
20492;21607;2162;57;7;0;7;1.000;2471000;0
20492;-1;2162;15;6;4;2;.333;1077000;0
20492;179350;4840;90;37;2;35;.946;3600000;0
20492;-1;4840;0;0;0;0;.00nan;0;0
20493;177771;2163;0;0;0;0;.00nan;0;0
20493;19346;2158;68;14;1;13;.929;3600000;0
20493;161069;2158;0;0;0;0;.00nan;0;0
20493;161081;2163;86;37;3;34;.919;3556000;0
20494;6998;2161;84;32;2;30;.938;3593000;0
20494;163361;2164;0;0;0;0;.00nan;0;0
20494;193486;2161;0;0;0;0;.00nan;0;0
20494;-1;2164;87;27;1;26;.963;3600000;0
20495;21607;2162;0;0;0;0;.00nan;0;0
20495;-1;2162;52;29;4;25;.862;3900000;0
20495;179350;4840;76;41;4;37;.902;3900000;0
20495;-1;4840;0;0;0;0;.00nan;0;0
20496;177771;2163;51;39;5;34;.872;3600000;0
20496;19346;2158;0;0;0;0;.00nan;0;0
20496;161069;2158;62;17;1;16;.941;3600000;0
20496;161081;2163;0;0;0;0;.00nan;0;0
20497;163361;2164;91;46;2;44;.957;3600000;0
20497;21607;2162;62;32;3;29;.906;3548000;0
20497;-1;2164;0;0;0;0;.00nan;0;0
20497;-1;2162;0;0;0;0;.00nan;0;0
20498;19346;2158;79;14;0;14;1.000;3600000;0
20498;179350;4840;88;52;3;49;.942;3600000;0
20498;-1;4840;0;0;0;0;.00nan;0;0
20498;161069;2158;0;0;0;0;.00nan;0;0
20499;6998;2161;69;38;4;34;.895;3900000;0
20499;193486;2161;0;0;0;0;.00nan;0;0
20499;177771;2163;0;0;0;0;.00nan;0;0
20499;161081;2163;66;35;4;31;.886;3900000;0
20500;163361;2164;0;0;0;0;.00nan;0;0
20500;21607;2162;0;0;0;0;.00nan;0;0
20500;-1;2164;98;34;0;34;1.000;3900000;0
20500;-1;2162;100;20;0;20;1.000;3900000;0
20501;19346;2158;65;3;0;3;1.000;3600000;0
20501;179350;4840;98;66;4;62;.939;3600000;0
20501;-1;4840;0;0;0;0;.00nan;0;0
20501;161069;2158;0;0;0;0;.00nan;0;0
20502;6998;2161;0;0;0;0;.00nan;0;0
20502;193486;2161;65;31;3;28;.903;3588000;0
20502;177771;2163;75;26;2;24;.923;3600000;0
20502;161081;2163;0;0;0;0;.00nan;0;0
20503;6998;2161;76;27;1;26;.963;3600000;0
20503;193486;2161;0;0;0;0;.00nan;0;0
20503;21607;2162;0;0;0;0;.00nan;0;0
20503;-1;2162;75;29;2;27;.931;3579000;0
20504;163361;2164;0;0;0;0;.00nan;0;0
20504;19346;2158;53;9;1;8;.889;3600000;0
20504;-1;2164;90;65;5;60;.923;3600000;0
20504;161069;2158;0;0;0;0;.00nan;0;0
20505;177771;2163;0;0;0;0;.00nan;0;0
20505;179350;4840;89;44;3;41;.932;3900000;0
20505;-1;4840;0;0;0;0;.00nan;0;0
20505;161081;2163;34;14;3;11;.786;3900000;0
20506;6998;2161;0;0;0;0;.00nan;0;0
20506;193486;2161;87;31;1;30;.968;3600000;0
20506;21607;2162;0;0;0;0;.00nan;0;0
20506;-1;2162;76;33;2;31;.939;3600000;0
20507;163361;2164;98;66;2;64;.970;3900000;0
20507;19346;2158;71;24;2;22;.917;3900000;0
20507;-1;2164;0;0;0;0;.00nan;0;0
20507;161069;2158;0;0;0;0;.00nan;0;0
20508;177771;2163;0;0;0;0;.00nan;0;0
20508;179350;4840;96;48;3;45;.938;3600000;0
20508;-1;4840;0;0;0;0;.00nan;0;0
20508;161081;2163;59;12;1;11;.917;3600000;0
20509;6998;2161;0;0;0;0;.00nan;0;0
20509;193486;2161;49;34;5;29;.853;3600000;0
20509;19346;2158;81;22;1;21;.955;3600000;0
20509;161069;2158;0;0;0;0;.00nan;0;0
20510;163361;2164;82;37;3;34;.919;3900000;0
20510;177771;2163;0;0;0;0;.00nan;0;0
20510;-1;2164;0;0;0;0;.00nan;0;0
20510;161081;2163;54;19;3;16;.842;3900000;0
20511;21607;2162;0;0;0;0;.00nan;0;0
20511;-1;2162;39;23;4;19;.826;3600000;0
20511;179350;4840;93;33;1;32;.970;3600000;0
20511;-1;4840;0;0;0;0;.00nan;0;0
20512;6998;2161;96;53;2;51;.962;3626000;0
20512;193486;2161;0;0;0;0;.00nan;0;0
20512;19346;2158;0;0;0;0;.00nan;0;0
20512;161069;2158;55;19;3;16;.842;3626000;0
20513;163361;2164;0;0;0;0;.00nan;0;0
20513;177771;2163;41;16;4;12;.750;3637000;0
20513;-1;2164;76;32;3;29;.906;3637000;0
20513;161081;2163;0;0;0;0;.00nan;0;0
20514;21607;2162;70;33;3;30;.909;3900000;0
20514;-1;2162;0;0;0;0;.00nan;0;0
20514;179350;4840;79;36;3;33;.917;3900000;0
20514;-1;4840;0;0;0;0;.00nan;0;0
20515;6998;2161;64;13;1;12;.923;3900000;0
20515;193486;2161;0;0;0;0;.00nan;0;0
20515;179350;4840;100;51;1;50;.980;3900000;0
20515;-1;4840;0;0;0;0;.00nan;0;0
20516;19346;2158;49;14;2;12;.857;3600000;0
20516;21607;2162;69;34;3;31;.912;2712000;0
20516;-1;2162;37;18;4;14;.778;888000;0
20516;161069;2158;0;0;0;0;.00nan;0;0
20517;163361;2164;72;38;3;35;.921;3600000;0
20517;177771;2163;41;19;4;15;.789;3564000;0
20517;-1;2164;0;0;0;0;.00nan;0;0
20517;161081;2163;0;0;0;0;.00nan;0;0
20518;6998;2161;0;0;0;0;.00nan;0;0
20518;193486;2161;56;23;3;20;.870;3536000;0
20518;179350;4840;0;0;0;0;.00nan;0;0
20518;-1;4840;95;40;1;39;.975;3600000;0
20519;19346;2158;0;0;0;0;.00nan;0;0
20519;21607;2162;0;0;0;0;.00nan;0;0
20519;-1;2162;69;55;5;50;.909;3600000;0
20519;161069;2158;71;7;0;7;1.000;3600000;0
20520;163361;2164;0;0;0;0;.00nan;0;0
20520;177771;2163;0;0;0;0;.00nan;0;0
20520;-1;2164;88;41;3;38;.927;3600000;0
20520;161081;2163;53;12;2;10;.833;3600000;0
20521;163361;2164;71;17;1;16;.941;3600000;0
20521;-1;2164;0;0;0;0;.00nan;0;0
20521;179350;4840;44;35;6;29;.829;3317000;0
20521;-1;4840;50;1;0;1;1.000;283000;0
20522;6998;2161;100;51;1;50;.980;3883000;0
20522;193486;2161;0;0;0;0;.00nan;0;0
20522;19346;2158;55;10;2;8;.800;3883000;0
20522;161069;2158;0;0;0;0;.00nan;0;0
20523;163361;2164;54;27;3;24;.889;3900000;0
20523;-1;2164;0;0;0;0;.00nan;0;0
20523;179350;4840;88;44;3;41;.932;3900000;0
20523;-1;4840;0;0;0;0;.00nan;0;0
20524;6998;2161;0;0;0;0;.00nan;0;0
20524;193486;2161;39;53;8;45;.849;3600000;0
20524;19346;2158;0;0;0;0;.00nan;0;0
20524;161069;2158;46;11;2;9;.818;3600000;0
20525;6998;2161;83;26;1;25;.962;3600000;0
20525;163361;2164;17;23;6;17;.739;2759000;0
20525;193486;2161;0;0;0;0;.00nan;0;0
20525;-1;2164;56;6;0;6;1.000;841000;0
20526;177771;2163;50;18;3;15;.833;3638000;0
20526;179350;4840;99;54;2;52;.963;3638000;0
20526;-1;4840;0;0;0;0;.00nan;0;0
20526;161081;2163;0;0;0;0;.00nan;0;0
20527;6998;2161;0;0;0;0;.00nan;0;0
20527;163361;2164;83;33;2;31;.939;3900000;0
20527;193486;2161;75;28;2;26;.929;3900000;0
20527;-1;2164;0;0;0;0;.00nan;0;0
20528;177771;2163;0;0;0;0;.00nan;0;0
20528;179350;4840;92;37;2;35;.946;3600000;0
20528;-1;4840;0;0;0;0;.00nan;0;0
20528;161081;2163;82;22;1;21;.955;3600000;0
20529;6998;2161;64;41;5;36;.878;3600000;0
20529;193486;2161;0;0;0;0;.00nan;0;0
20529;21607;2162;68;29;2;27;.931;3600000;0
20529;-1;2162;0;0;0;0;.00nan;0;0
20530;19346;2158;47;11;2;9;.818;3569000;0
20530;179350;4840;100;62;1;61;.984;3600000;0
20530;-1;4840;0;0;0;0;.00nan;0;0
20530;161069;2158;0;0;0;0;.00nan;0;0
20531;163361;2164;94;42;2;40;.952;3600000;0
20531;177771;2163;0;0;0;0;.00nan;0;0
20531;-1;2164;0;0;0;0;.00nan;0;0
20531;161081;2163;68;18;1;17;.944;3600000;0
20532;6998;2161;0;0;0;0;.00nan;0;0
20532;193486;2161;100;31;0;31;1.000;3600000;0
20532;21607;2162;0;0;0;0;.00nan;0;0
20532;-1;2162;66;25;2;23;.920;3513000;0
20533;19346;2158;0;0;0;0;.00nan;0;0
20533;179350;4840;88;70;6;64;.914;2956000;0
20533;-1;4840;55;16;2;14;.875;644000;0
20533;161069;2158;53;10;2;8;.800;3600000;0
20534;163361;2164;78;38;3;35;.921;3590000;0
20534;177771;2163;56;20;2;18;.900;3600000;0
20534;-1;2164;0;0;0;0;.00nan;0;0
20534;161081;2163;0;0;0;0;.00nan;0;0
20535;177771;2163;0;0;0;0;.00nan;0;0
20535;21607;2162;0;0;0;0;.00nan;0;0
20535;-1;2162;77;29;2;27;.931;3525000;0
20535;161081;2163;100;36;0;36;1.000;3600000;0
20536;6998;2161;0;0;0;0;.00nan;0;0
20536;193486;2161;90;45;2;43;.956;3600000;0
20536;19346;2158;61;11;1;10;.909;3600000;0
20536;161069;2158;0;0;0;0;.00nan;0;0
20537;177771;2163;0;0;0;0;.00nan;0;0
20537;21607;2162;88;44;2;42;.955;3600000;0
20537;-1;2162;0;0;0;0;.00nan;0;0
20537;161081;2163;73;19;1;18;.947;3600000;0
20538;6998;2161;91;65;4;61;.938;3600000;0
20538;193486;2161;0;0;0;0;.00nan;0;0
20538;19346;2158;0;0;0;0;.00nan;0;0
20538;161069;2158;50;21;3;18;.857;3600000;0
20539;6998;2161;0;0;0;0;.00nan;0;0
20539;193486;2161;85;36;2;34;.944;3600000;0
20539;21607;2162;0;0;0;0;.00nan;0;0
20539;-1;2162;45;26;4;22;.846;3587000;0
20540;163361;2164;93;59;4;55;.932;3900000;0
20540;19346;2158;30;17;4;13;.765;3900000;0
20540;-1;2164;0;0;0;0;.00nan;0;0
20540;161069;2158;0;0;0;0;.00nan;0;0
20541;177771;2163;0;0;0;0;.00nan;0;0
20541;179350;4840;58;39;5;34;.872;3600000;0
20541;-1;4840;0;0;0;0;.00nan;0;0
20541;161081;2163;65;19;1;18;.947;3600000;0
20542;6998;2161;96;33;2;31;.939;3900000;0
20542;193486;2161;0;0;0;0;.00nan;0;0
20542;21607;2162;81;29;2;27;.931;3900000;0
20542;-1;2162;0;0;0;0;.00nan;0;0
20543;163361;2164;0;0;0;0;.00nan;0;0
20543;19346;2158;0;0;0;0;.00nan;0;0
20543;-1;2164;82;41;3;38;.927;3561000;0
20543;161069;2158;67;15;1;14;.933;3600000;0
20544;177771;2163;0;0;0;0;.00nan;0;0
20544;179350;4840;76;42;3;39;.929;3600000;0
20544;-1;4840;0;0;0;0;.00nan;0;0
20544;161081;2163;58;13;1;12;.923;3600000;0
20545;6998;2161;0;0;0;0;.00nan;0;0
20545;163361;2164;74;39;3;36;.923;3583000;0
20545;193486;2161;71;27;2;25;.926;3600000;0
20545;-1;2164;0;0;0;0;.00nan;0;0
20546;21607;2162;0;0;0;0;.00nan;0;0
20546;-1;2162;81;27;1;26;.963;3600000;0
20546;179350;4840;46;42;6;36;.857;3600000;0
20546;-1;4840;0;0;0;0;.00nan;0;0
20547;177771;2163;0;0;0;0;.00nan;0;0
20547;19346;2158;56;19;2;17;.895;3600000;0
20547;161069;2158;0;0;0;0;.00nan;0;0
20547;161081;2163;70;41;4;37;.902;3577000;0
20548;6998;2161;83;31;1;30;.968;3900000;0
20548;163361;2164;99;38;1;37;.974;3900000;0
20548;193486;2161;0;0;0;0;.00nan;0;0
20548;-1;2164;0;0;0;0;.00nan;0;0
20549;21607;2162;78;35;2;33;.943;3600000;0
20549;-1;2162;0;0;0;0;.00nan;0;0
20549;179350;4840;81;54;3;51;.944;3574000;0
20549;-1;4840;0;0;0;0;.00nan;0;0
20550;177771;2163;86;43;3;40;.930;3574000;0
20550;19346;2158;0;0;0;0;.00nan;0;0
20550;161069;2158;62;11;1;10;.909;3600000;0
20550;161081;2163;0;0;0;0;.00nan;0;0
20551;6998;2161;0;0;0;0;.00nan;0;0
20551;193486;2161;97;18;0;18;1.000;3600000;0
20551;179350;4840;97;42;1;41;.976;3583000;0
20551;-1;4840;0;0;0;0;.00nan;0;0
20552;163361;2164;41;38;6;32;.842;2166000;0
20552;177771;2163;0;0;0;0;.00nan;0;0
20552;-1;2164;62;27;3;24;.889;1434000;0
20552;161081;2163;71;9;0;9;1.000;3600000;0
20553;19346;2158;88;16;0;16;1.000;3600000;0
20553;21607;2162;75;55;6;49;.891;3138000;0
20553;-1;2162;29;9;3;6;.667;462000;0
20553;161069;2158;0;0;0;0;.00nan;0;0
20554;6998;2161;0;0;0;0;.00nan;0;0
20554;193486;2161;70;34;3;31;.912;3599000;0
20554;179350;4840;0;0;0;0;.00nan;0;0
20554;-1;4840;88;39;2;37;.949;3600000;0
20555;163361;2164;85;55;5;50;.909;3600000;0
20555;177771;2163;0;0;0;0;.00nan;0;0
20555;-1;2164;0;0;0;0;.00nan;0;0
20555;161081;2163;83;13;0;13;1.000;3600000;0
20556;19346;2158;76;24;1;23;.958;3600000;0
20556;21607;2162;0;0;0;0;.00nan;0;0
20556;-1;2162;71;50;5;45;.900;3600000;0
20556;161069;2158;0;0;0;0;.00nan;0;0
20557;6998;2161;97;43;2;41;.953;3900000;0
20557;163361;2164;72;26;2;24;.923;3900000;0
20557;193486;2161;0;0;0;0;.00nan;0;0
20557;-1;2164;0;0;0;0;.00nan;0;0
20558;19346;2158;87;12;0;12;1.000;3600000;0
20558;21310;2162;0;0;0;0;.00nan;0;0
20558;21607;2162;91;78;6;72;.923;3600000;0
20558;161069;2158;0;0;0;0;.00nan;0;0
20559;177771;2163;0;0;0;0;.00nan;0;0
20559;179350;4840;82;62;3;59;.952;3543000;0
20559;-1;4840;0;0;0;0;.00nan;0;0
20559;161081;2163;56;16;2;14;.875;3600000;0
20560;6998;2161;0;0;0;0;.00nan;0;0
20560;163361;2164;54;28;4;24;.857;3600000;0
20560;193486;2161;72;21;1;20;.952;3600000;0
20560;-1;2164;0;0;0;0;.00nan;0;0
20561;19346;2158;63;13;1;12;.923;3600000;0
20561;21607;2162;46;6;1;5;.833;459000;0
20561;-1;2162;51;46;6;40;.870;3141000;0
20561;161069;2158;0;0;0;0;.00nan;0;0
20562;177771;2163;69;18;1;17;.944;3600000;0
20562;179350;4840;98;47;2;45;.957;3600000;0
20562;-1;4840;0;0;0;0;.00nan;0;0
20562;161081;2163;0;0;0;0;.00nan;0;0
20563;163361;2164;94;43;1;42;.977;3900000;0
20563;21607;2162;67;21;1;20;.952;3900000;0
20563;-1;2164;0;0;0;0;.00nan;0;0
20563;-1;2162;0;0;0;0;.00nan;0;0
20564;19346;2158;52;8;1;7;.875;3600000;0
20564;179350;4840;90;65;5;60;.923;3600000;0
20564;-1;4840;0;0;0;0;.00nan;0;0
20564;161069;2158;0;0;0;0;.00nan;0;0
20565;6998;2161;0;0;0;0;.00nan;0;0
20565;193486;2161;72;28;2;26;.929;3600000;0
20565;177771;2163;0;0;0;0;.00nan;0;0
20565;161081;2163;62;18;1;17;.944;3600000;0
20566;163361;2164;0;0;0;0;.00nan;0;0
20566;21607;2162;0;0;0;0;.00nan;0;0
20566;-1;2164;83;30;2;28;.933;3600000;0
20566;-1;2162;48;27;4;23;.852;3588000;0
20567;19346;2158;35;12;3;9;.750;3746000;0
20567;179350;4840;92;74;4;70;.946;3746000;0
20567;-1;4840;0;0;0;0;.00nan;0;0
20567;161069;2158;0;0;0;0;.00nan;0;0
20568;6998;2161;68;39;4;35;.897;3600000;0
20568;193486;2161;0;0;0;0;.00nan;0;0
20568;177771;2163;0;0;0;0;.00nan;0;0
20568;161081;2163;41;17;3;14;.824;3600000;0
20569;6998;2161;0;0;0;0;.00nan;0;0
20569;193486;2161;81;29;1;28;.966;3600000;0
20569;21607;2162;0;0;0;0;.00nan;0;0
20569;-1;2162;63;24;2;22;.917;3559000;0
20570;163361;2164;77;23;1;22;.957;3600000;0
20570;-1;2164;0;0;0;0;.00nan;0;0
20570;179350;4840;85;39;2;37;.949;3591000;0
20570;-1;4840;0;0;0;0;.00nan;0;0
20571;6998;2161;48;38;6;32;.842;3600000;0
20571;193486;2161;0;0;0;0;.00nan;0;0
20571;21607;2162;100;29;0;29;1.000;3600000;0
20571;-1;2162;0;0;0;0;.00nan;0;0
20572;163361;2164;0;0;0;0;.00nan;0;0
20572;-1;2164;42;24;4;20;.833;3900000;0
20572;179350;4840;67;31;4;27;.871;3900000;0
20572;-1;4840;0;0;0;0;.00nan;0;0
20573;6998;2161;0;0;0;0;.00nan;0;0
20573;193486;2161;61;38;4;34;.895;3600000;0
20573;177771;2163;0;0;0;0;.00nan;0;0
20573;161081;2163;55;14;1;13;.929;3600000;0
20574;21607;2162;64;26;2;24;.923;3600000;0
20574;-1;2162;0;0;0;0;.00nan;0;0
20574;179350;4840;83;44;3;41;.932;3554000;0
20574;-1;4840;0;0;0;0;.00nan;0;0
20575;163361;2164;39;35;6;29;.829;2598000;0
20575;19346;2158;61;11;1;10;.909;3600000;0
20575;-1;2164;60;22;2;20;.909;1002000;0
20575;161069;2158;0;0;0;0;.00nan;0;0
20576;6998;2161;84;47;3;44;.936;3600000;0
20576;193486;2161;0;0;0;0;.00nan;0;0
20576;177771;2163;83;26;1;25;.962;3600000;0
20576;161081;2163;0;0;0;0;.00nan;0;0
20577;21607;2162;0;0;0;0;.00nan;0;0
20577;-1;2162;96;19;0;19;1.000;3600000;0
20577;179350;4840;92;44;1;43;.977;3570000;0
20577;-1;4840;0;0;0;0;.00nan;0;0
20578;163361;2164;54;39;6;33;.846;2543000;0
20578;19346;2158;0;0;0;0;.00nan;0;0
20578;-1;2164;72;18;0;18;1.000;1057000;0
20578;161069;2158;78;20;1;19;.950;3600000;0
20579;163361;2164;47;25;5;20;.800;3600000;0
20579;21607;2162;0;0;0;0;.00nan;0;0
20579;-1;2164;0;0;0;0;.00nan;0;0
20579;-1;2162;37;41;7;34;.829;3575000;0
20580;6998;2161;94;29;2;27;.931;3600000;0
20580;193486;2161;0;0;0;0;.00nan;0;0
20580;179350;4840;83;38;3;35;.921;3550000;0
20580;-1;4840;0;0;0;0;.00nan;0;0
20581;177771;2163;0;0;0;0;.00nan;0;0
20581;19346;2158;53;23;3;20;.870;3778000;0
20581;161069;2158;0;0;0;0;.00nan;0;0
20581;161081;2163;74;38;4;34;.895;3778000;0
20582;163361;2164;0;0;0;0;.00nan;0;0
20582;21607;2162;82;43;3;40;.930;3900000;0
20582;-1;2164;54;26;3;23;.885;3900000;0
20582;-1;2162;0;0;0;0;.00nan;0;0
20583;6998;2161;0;0;0;0;.00nan;0;0
20583;193486;2161;42;17;3;14;.824;3600000;0
20583;179350;4840;82;46;4;42;.913;3572000;0
20583;-1;4840;0;0;0;0;.00nan;0;0
20584;177771;2163;83;48;3;45;.938;3512000;0
20584;19346;2158;0;0;0;0;.00nan;0;0
20584;161069;2158;100;32;1;31;.969;3600000;0
20584;161081;2163;0;0;0;0;.00nan;0;0
20585;6998;2161;0;0;0;0;.00nan;0;0
20585;193486;2161;93;47;3;44;.936;3600000;0
20585;19346;2158;77;12;0;12;1.000;3600000;0
20585;161069;2158;0;0;0;0;.00nan;0;0
20586;163361;2164;100;26;0;26;1.000;3600000;0
20586;-1;2164;0;0;0;0;.00nan;0;0
20586;179350;4840;97;36;2;34;.944;3549000;0
20586;-1;4840;0;0;0;0;.00nan;0;0
20587;177771;2163;0;0;0;0;.00nan;0;0
20587;21607;2162;100;47;2;45;.957;3600000;0
20587;-1;2162;0;0;0;0;.00nan;0;0
20587;161081;2163;63;26;4;22;.846;3515000;0
20588;6998;2161;33;27;5;22;.815;2220000;0
20588;193486;2161;39;29;5;24;.828;1380000;0
20588;19346;2158;63;9;1;8;.889;3600000;0
20588;161069;2158;0;0;0;0;.00nan;0;0
20589;163361;2164;82;23;2;21;.913;3600000;0
20589;-1;2164;0;0;0;0;.00nan;0;0
20589;179350;4840;62;37;4;33;.892;3541000;0
20589;-1;4840;0;0;0;0;.00nan;0;0
20590;177771;2163;57;15;2;13;.867;3600000;0
20590;21607;2162;0;0;0;0;.00nan;0;0
20590;-1;2162;63;51;5;46;.902;3600000;0
20590;161081;2163;0;0;0;0;.00nan;0;0
20592;21607;2162;0;0;0;0;.00nan;0;0
20592;-1;2162;100;30;0;30;1.000;3600000;0
20592;179350;4840;79;42;4;38;.905;3600000;0
20592;-1;4840;0;0;0;0;.00nan;0;0
20594;6998;2161;0;0;0;0;.00nan;0;0
20594;193486;2161;63;51;5;46;.902;3600000;0
20594;19346;2158;80;32;1;31;.969;3600000;0
20594;161069;2158;0;0;0;0;.00nan;0;0
20596;163361;2164;97;52;3;49;.942;3574000;0
20596;177771;2163;0;0;0;0;.00nan;0;0
20596;-1;2164;0;0;0;0;.00nan;0;0
20596;161081;2163;60;15;1;14;.933;3600000;0
20598;163361;2164;78;15;0;15;1.000;1278000;0
20598;177771;2163;85;25;1;24;.960;3600000;0
20598;-1;2164;48;24;4;20;.833;2322000;0
20598;161081;2163;0;0;0;0;.00nan;0;0
20600;6998;2161;30;32;6;26;.813;2774000;0
20600;193486;2161;54;13;1;12;.923;826000;0
20600;19346;2158;0;0;0;0;.00nan;0;0
20600;161069;2158;44;13;3;10;.769;3600000;0
20602;21607;2162;0;0;0;0;.00nan;0;0
20602;-1;2162;88;21;0;21;1.000;3600000;0
20602;179350;4840;77;43;4;39;.907;3600000;0
20602;-1;4840;0;0;0;0;.00nan;0;0
20604;163361;2164;98;55;3;52;.945;3600000;0
20604;19346;2158;99;22;0;22;1.000;3600000;0
20604;-1;2164;0;0;0;0;.00nan;0;0
20604;161069;2158;0;0;0;0;.00nan;0;0
20606;6998;2161;0;0;0;0;.00nan;0;0
20606;193486;2161;52;17;2;15;.882;3600000;0
20606;179350;4840;73;41;4;37;.902;3515000;0
20606;-1;4840;0;0;0;0;.00nan;0;0
20608;177771;2163;0;0;0;0;.00nan;0;0
20608;21607;2162;0;0;0;0;.00nan;0;0
20608;-1;2162;100;47;0;47;1.000;3900000;0
20608;161081;2163;93;25;0;25;1.000;3900000;0
20610;6998;2161;96;39;2;37;.949;3600000;0
20610;193486;2161;0;0;0;0;.00nan;0;0
20610;177771;2163;0;0;0;0;.00nan;0;0
20610;161081;2163;49;24;3;21;.875;3560000;0
20612;163361;2164;0;0;0;0;.00nan;0;0
20612;21607;2162;0;0;0;0;.00nan;0;0
20612;-1;2164;100;39;1;38;.974;3600000;0
20612;-1;2162;61;36;4;32;.889;3600000;0
20614;19346;2158;86;17;0;17;1.000;3600000;0
20614;179350;4840;42;16;3;13;.813;498000;0
20614;-1;4840;98;49;3;46;.939;3102000;0
20614;161069;2158;0;0;0;0;.00nan;0;0
20616;163361;2164;30;7;3;4;.571;325000;0
20616;19346;2158;76;8;0;8;1.000;3600000;0
20616;-1;2164;83;62;5;57;.919;3275000;0
20616;161069;2158;0;0;0;0;.00nan;0;0
20618;6998;2161;77;29;1;28;.966;3600000;0
20618;193486;2161;0;0;0;0;.00nan;0;0
20618;179350;4840;73;34;2;32;.941;3552000;0
20618;-1;4840;0;0;0;0;.00nan;0;0
20620;177771;2163;22;11;4;7;.636;3600000;0
20620;21607;2162;0;0;0;0;.00nan;0;0
20620;-1;2162;59;40;5;35;.875;3581000;0
20620;161081;2163;0;0;0;0;.00nan;0;0
20622;163361;2164;97;52;1;51;.981;3900000;0
20622;21607;2162;68;16;1;15;.938;3900000;0
20622;-1;2164;0;0;0;0;.00nan;0;0
20622;-1;2162;0;0;0;0;.00nan;0;0
20624;6998;2161;0;0;0;0;.00nan;0;0
20624;193486;2161;100;26;0;26;1.000;3600000;0
20624;179350;4840;63;31;3;28;.903;3600000;0
20624;-1;4840;0;0;0;0;.00nan;0;0
20626;177771;2163;0;0;0;0;.00nan;0;0
20626;19346;2158;49;15;2;13;.867;3600000;0
20626;161069;2158;0;0;0;0;.00nan;0;0
20626;161081;2163;64;47;5;42;.894;3600000;0
1428;163361;2164;66;52;6;46;.885;3600000;0
1428;19346;2158;100;25;0;25;1.000;3600000;0
1428;-1;2164;0;0;0;0;.00nan;0;0
1428;161069;2158;0;0;0;0;.00nan;0;0
1429;6998;2161;0;0;0;0;.00nan;0;0
1429;193486;2161;86;47;3;44;.936;3600000;0
1429;177771;2163;0;0;0;0;.00nan;0;0
1429;161081;2163;79;12;0;12;1.000;3600000;0
1430;163361;2164;97;59;4;55;.932;3600000;0
1430;19346;2158;86;13;0;13;1.000;3600000;0
1430;-1;2164;0;0;0;0;.00nan;0;0
1430;161069;2158;0;0;0;0;.00nan;0;0
1431;6998;2161;0;0;0;0;.00nan;0;0
1431;193486;2161;100;28;0;28;1.000;3600000;0
1431;177771;2163;0;0;0;0;.00nan;0;0
1431;161081;2163;62;16;1;15;.938;3593000;0
1632;6998;2161;0;0;0;0;.00nan;0;0
1632;193486;2161;72;44;4;40;.909;3550000;0
1632;177771;2163;0;0;0;0;.00nan;0;0
1632;161081;2163;60;23;3;20;.870;3600000;0
1660;177771;2163;0;0;0;0;.00nan;0;0
1660;19346;2158;100;20;0;20;1.000;3600000;0
1660;161069;2158;0;0;0;0;.00nan;0;0
1660;161081;2163;81;58;6;52;.897;3600000;0
1661;177771;2163;0;0;0;0;.00nan;0;0
1661;19346;2158;53;16;2;14;.875;3600000;0
1661;161069;2158;0;0;0;0;.00nan;0;0
1661;161081;2163;97;67;5;62;.925;3600000;0
1662;177771;2163;57;9;0;9;1.000;388000;0
1662;19346;2158;60;17;2;15;.882;3600000;0
1662;161069;2158;0;0;0;0;.00nan;0;0
1662;161081;2163;56;46;6;40;.870;3212000;0
20627;-1;3795;74;26;2;24;.923;3600000;0
20627;64734;3800;0;0;0;0;.00nan;0;0
20627;64736;3800;66;37;4;33;.892;3575000;0
20627;78845;3795;0;0;0;0;.00nan;0;0
20628;168001;4635;63;29;3;26;.897;3600000;0
20628;37467;3798;0;0;0;0;.00nan;0;0
20628;91413;3798;42;25;5;20;.800;3588000;0
20628;161023;4635;0;0;0;0;.00nan;0;0
20629;175530;3796;0;0;0;0;.00nan;0;0
20629;58856;3796;85;31;2;29;.935;3600000;0
20629;64734;3800;0;0;0;0;.00nan;0;0
20629;64736;3800;68;29;3;26;.897;3571000;0
20630;168021;3797;60;37;5;32;.865;3600000;0
20630;-1;3795;93;39;2;37;.949;3600000;0
20630;37638;3797;0;0;0;0;.00nan;0;0
20630;78845;3795;0;0;0;0;.00nan;0;0
20631;168001;4635;55;31;4;27;.871;3590000;0
20631;168021;3797;63;32;3;29;.906;3600000;0
20631;37638;3797;0;0;0;0;.00nan;0;0
20631;161023;4635;0;0;0;0;.00nan;0;0
20632;175530;3796;81;29;2;27;.931;3600000;0
20632;37467;3798;0;0;0;0;.00nan;0;0
20632;58856;3796;0;0;0;0;.00nan;0;0
20632;91413;3798;91;31;1;30;.968;3600000;0
20633;168001;4635;45;23;4;19;.826;3877000;0
20633;64734;3800;0;0;0;0;.00nan;0;0
20633;64736;3800;57;37;5;32;.865;3877000;0
20633;161023;4635;0;0;0;0;.00nan;0;0
20634;168021;3797;63;36;5;31;.861;3600000;0
20634;-1;3795;78;22;1;21;.955;3600000;0
20634;37638;3797;0;0;0;0;.00nan;0;0
20634;78845;3795;0;0;0;0;.00nan;0;0
20635;168021;3797;68;17;1;16;.941;3600000;0
20635;175530;3796;0;0;0;0;.00nan;0;0
20635;37638;3797;0;0;0;0;.00nan;0;0
20635;58856;3796;85;42;3;39;.929;3600000;0
20636;-1;3795;0;0;0;0;.00nan;0;0
20636;37467;3798;0;0;0;0;.00nan;0;0
20636;78845;3795;78;42;3;39;.929;3600000;0
20636;91413;3798;29;24;5;19;.792;3557000;0
20637;168001;4635;83;22;1;21;.955;3600000;0
20637;64734;3800;0;0;0;0;.00nan;0;0
20637;64736;3800;49;39;6;33;.846;3600000;0
20637;161023;4635;0;0;0;0;.00nan;0;0
20638;168021;3797;67;29;3;26;.897;3645000;0
20638;37467;3798;0;0;0;0;.00nan;0;0
20638;37638;3797;0;0;0;0;.00nan;0;0
20638;91413;3798;66;26;2;24;.923;3645000;0
20639;175530;3796;53;31;4;27;.871;3737000;0
20639;-1;3795;65;30;3;27;.900;3737000;0
20639;58856;3796;0;0;0;0;.00nan;0;0
20639;78845;3795;0;0;0;0;.00nan;0;0
20640;168001;4635;78;29;1;28;.966;3104000;0
20640;37467;3798;0;0;0;0;.00nan;0;0
20640;91413;3798;86;28;1;27;.964;3600000;0
20640;161023;4635;27;8;3;5;.625;496000;0
20641;175530;3796;0;0;0;0;.00nan;0;0
20641;-1;3795;0;0;0;0;.00nan;0;0
20641;58856;3796;85;31;2;29;.935;3600000;0
20641;78845;3795;43;29;6;23;.793;3600000;0
20642;168021;3797;69;34;4;30;.882;3574000;0
20642;37638;3797;0;0;0;0;.00nan;0;0
20642;64734;3800;82;32;3;29;.906;3600000;0
20642;64736;3800;0;0;0;0;.00nan;0;0
20643;168001;4635;40;22;4;18;.818;3590000;0
20643;-1;3795;60;29;3;26;.897;3600000;0
20643;78845;3795;0;0;0;0;.00nan;0;0
20643;161023;4635;0;0;0;0;.00nan;0;0
20644;168021;3797;56;31;4;27;.871;3566000;0
20644;37467;3798;0;0;0;0;.00nan;0;0
20644;37638;3797;0;0;0;0;.00nan;0;0
20644;91413;3798;84;35;2;33;.943;3600000;0
20645;175530;3796;0;0;0;0;.00nan;0;0
20645;58856;3796;70;20;1;19;.950;3600000;0
20645;64734;3800;0;0;0;0;.00nan;0;0
20645;64736;3800;40;30;5;25;.833;3600000;0
20646;175530;3796;79;33;2;31;.939;3600000;0
20646;-1;3795;0;0;0;0;.00nan;0;0
20646;58856;3796;0;0;0;0;.00nan;0;0
20646;78845;3795;67;28;3;25;.893;3554000;0
20647;168001;4635;44;24;4;20;.833;3600000;0
20647;175530;3796;0;0;0;0;.00nan;0;0
20647;58856;3796;89;33;1;32;.970;3600000;0
20647;161023;4635;0;0;0;0;.00nan;0;0
20648;168021;3797;55;23;3;20;.870;3600000;0
20648;37638;3797;0;0;0;0;.00nan;0;0
20648;64734;3800;41;13;2;11;.846;818000;0
20648;64736;3800;63;43;6;37;.860;2782000;0
20649;-1;3795;92;30;1;29;.967;3600000;0
20649;37467;3798;0;0;0;0;.00nan;0;0
20649;78845;3795;0;0;0;0;.00nan;0;0
20649;91413;3798;49;24;3;21;.875;3558000;0
20650;168001;4635;57;45;7;38;.844;3600000;0
20650;37467;3798;87;37;3;34;.919;3600000;0
20650;91413;3798;0;0;0;0;.00nan;0;0
20650;161023;4635;0;0;0;0;.00nan;0;0
20651;168001;4635;53;34;4;30;.882;3600000;0
20651;168021;3797;0;0;0;0;.00nan;0;0
20651;37638;3797;95;46;2;44;.957;3600000;0
20651;161023;4635;0;0;0;0;.00nan;0;0
20652;175530;3796;0;0;0;0;.00nan;0;0
20652;37467;3798;0;0;0;0;.00nan;0;0
20652;58856;3796;45;41;6;35;.854;3522000;0
20652;91413;3798;46;26;4;22;.846;3600000;0
20653;-1;3795;67;21;2;19;.905;3600000;0
20653;64734;3800;0;0;0;0;.00nan;0;0
20653;64736;3800;62;29;3;26;.897;3563000;0
20653;78845;3795;0;0;0;0;.00nan;0;0
20654;168021;3797;100;34;0;34;1.000;3600000;0
20654;175530;3796;41;33;6;27;.818;3600000;0
20654;37638;3797;0;0;0;0;.00nan;0;0
20654;58856;3796;0;0;0;0;.00nan;0;0
20655;37467;3798;0;0;0;0;.00nan;0;0
20655;64734;3800;0;0;0;0;.00nan;0;0
20655;64736;3800;92;47;4;43;.915;3774000;0
20655;91413;3798;59;30;3;27;.900;3778000;0
20656;168001;4635;25;24;6;18;.750;3600000;0
20656;-1;3795;94;36;2;34;.944;3600000;0
20656;78845;3795;0;0;0;0;.00nan;0;0
20656;161023;4635;0;0;0;0;.00nan;0;0
20657;175530;3796;0;0;0;0;.00nan;0;0
20657;-1;3795;88;29;2;27;.931;3900000;0
20657;58856;3796;88;36;2;34;.944;3900000;0
20657;78845;3795;0;0;0;0;.00nan;0;0
20658;168001;4635;0;0;0;0;.00nan;0;0
20658;168021;3797;56;31;5;26;.839;3900000;0
20658;37638;3797;0;0;0;0;.00nan;0;0
20658;161023;4635;38;35;5;30;.857;3900000;0
20659;168001;4635;39;17;4;13;.765;3600000;0
20659;175530;3796;35;16;4;12;.750;1282000;0
20659;58856;3796;48;33;5;28;.848;2318000;0
20659;161023;4635;0;0;0;0;.00nan;0;0
20660;64734;3800;0;0;0;0;.00nan;0;0
20660;64736;3800;83;39;4;35;.897;3527000;0
20660;85709;3798;64;22;2;20;.909;3600000;0
20660;91413;3798;0;0;0;0;.00nan;0;0
20661;168021;3797;67;32;4;28;.875;3600000;0
20661;-1;3795;24;27;6;21;.778;3544000;0
20661;37638;3797;0;0;0;0;.00nan;0;0
20661;78845;3795;0;0;0;0;.00nan;0;0
20662;168001;4635;0;0;0;0;.00nan;0;0
20662;85709;3798;0;0;0;0;.00nan;0;0
20662;91413;3798;90;33;2;31;.939;3741000;0
20662;161023;4635;79;27;1;26;.963;3741000;0
20663;175530;3796;0;0;0;0;.00nan;0;0
20663;-1;3795;72;20;1;19;.950;3600000;0
20663;58856;3796;84;37;2;35;.946;3600000;0
20663;78845;3795;0;0;0;0;.00nan;0;0
20664;168021;3797;53;37;5;32;.865;3600000;0
20664;37638;3797;0;0;0;0;.00nan;0;0
20664;85709;3798;83;24;1;23;.958;3600000;0
20664;91413;3798;0;0;0;0;.00nan;0;0
20665;168001;4635;56;31;4;27;.871;3521000;0
20665;64734;3800;0;0;0;0;.00nan;0;0
20665;64736;3800;75;23;2;21;.913;3600000;0
20665;161023;4635;0;0;0;0;.00nan;0;0
20666;168021;3797;0;0;0;0;.00nan;0;0
20666;175530;3796;75;24;2;22;.917;3600000;0
20666;37638;3797;47;28;4;24;.857;3517000;0
20666;58856;3796;0;0;0;0;.00nan;0;0
20667;64734;3800;0;0;0;0;.00nan;0;0
20667;64736;3800;52;45;6;39;.867;3532000;0
20667;85709;3798;55;27;4;23;.852;3600000;0
20667;91413;3798;0;0;0;0;.00nan;0;0
20668;168001;4635;50;29;4;25;.862;3600000;0
20668;175530;3796;57;12;1;11;.917;1268000;0
20668;58856;3796;28;20;5;15;.750;2287000;0
20668;161023;4635;0;0;0;0;.00nan;0;0
20669;-1;3795;52;31;5;26;.839;3854000;0
20669;78845;3795;0;0;0;0;.00nan;0;0
20669;85709;3798;0;0;0;0;.00nan;0;0
20669;91413;3798;65;32;4;28;.875;3854000;0
20670;168021;3797;72;22;2;20;.909;3600000;0
20670;37638;3797;0;0;0;0;.00nan;0;0
20670;64734;3800;0;0;0;0;.00nan;0;0
20670;64736;3800;63;36;4;32;.889;3583000;0
20671;-1;3795;0;0;0;0;.00nan;0;0
20671;64734;3800;0;0;0;0;.00nan;0;0
20671;64736;3800;75;36;3;33;.917;3600000;0
20671;78845;3795;37;20;4;16;.800;3551000;0
20672;58830;3796;72;30;2;28;.933;3600000;0
20672;58856;3796;0;0;0;0;.00nan;0;0
20672;64734;3800;0;0;0;0;.00nan;0;0
20672;64736;3800;56;31;4;27;.871;3595000;0
20673;168001;4635;66;31;3;28;.903;3545000;0
20673;-1;3795;75;30;2;28;.933;3600000;0
20673;57152;4635;0;0;0;0;.00nan;0;0
20673;78845;3795;0;0;0;0;.00nan;0;0
20674;168021;3797;36;31;6;25;.806;3600000;0
20674;37638;3797;0;0;0;0;.00nan;0;0
20674;85709;3798;100;29;0;29;1.000;3600000;0
20674;91413;3798;0;0;0;0;.00nan;0;0
20675;168001;4635;0;0;0;0;.00nan;0;0
20675;57152;4635;95;38;2;36;.947;3600000;0
20675;85709;3798;49;33;5;28;.848;3600000;0
20675;91413;3798;0;0;0;0;.00nan;0;0
20676;168021;3797;61;35;4;31;.886;3572000;0
20676;37638;3797;0;0;0;0;.00nan;0;0
20676;58830;3796;91;35;2;33;.943;3600000;0
20676;58856;3796;0;0;0;0;.00nan;0;0
20677;168001;4635;0;0;0;0;.00nan;0;0
20677;168021;3797;75;47;5;42;.894;3600000;0
20677;37638;3797;0;0;0;0;.00nan;0;0
20677;57152;4635;100;29;0;29;1.000;3600000;0
20678;58830;3796;47;36;6;30;.833;1928000;0
20678;58856;3796;55;24;3;21;.875;1672000;0
20678;85709;3798;79;36;4;32;.889;3600000;0
20678;91413;3798;0;0;0;0;.00nan;0;0
20679;-1;3795;91;35;1;34;.971;3600000;0
20679;64734;3800;0;0;0;0;.00nan;0;0
20679;64736;3800;82;51;4;47;.922;3600000;0
20679;78845;3795;0;0;0;0;.00nan;0;0
20680;168001;4635;0;0;0;0;.00nan;0;0
20680;57152;4635;52;26;4;22;.846;3600000;0
20680;64734;3800;0;0;0;0;.00nan;0;0
20680;64736;3800;92;36;1;35;.972;3600000;0
20681;168021;3797;90;43;4;39;.907;3757000;0
20681;37638;3797;0;0;0;0;.00nan;0;0
20681;58830;3796;66;33;3;30;.909;3757000;0
20681;58856;3796;0;0;0;0;.00nan;0;0
20682;58830;3796;24;28;7;21;.750;3134000;0
20682;58856;3796;72;10;0;10;1.000;466000;0
20682;85709;3798;60;26;3;23;.885;3600000;0
20682;91413;3798;0;0;0;0;.00nan;0;0
20683;168021;3797;18;23;6;17;.739;2395000;0
20683;37638;3797;47;14;2;12;.857;1135000;0
20683;64734;3800;57;5;0;5;1.000;1083000;0
20683;64736;3800;36;29;6;23;.793;2517000;0
20684;168001;4635;0;0;0;0;.00nan;0;0
20684;-1;3795;0;0;0;0;.00nan;0;0
20684;57152;4635;73;28;3;25;.893;3900000;0
20684;78845;3795;67;23;3;20;.870;3900000;0
20685;168001;4635;0;0;0;0;.00nan;0;0
20685;168021;3797;65;29;4;25;.862;3600000;0
20685;37638;3797;0;0;0;0;.00nan;0;0
20685;57152;4635;43;39;6;33;.846;3513000;0
20686;-1;3795;89;41;3;38;.927;3600000;0
20686;64734;3800;0;0;0;0;.00nan;0;0
20686;64736;3800;88;47;4;43;.915;3580000;0
20686;78845;3795;0;0;0;0;.00nan;0;0
20687;168001;4635;0;0;0;0;.00nan;0;0
20687;57152;4635;84;25;1;24;.960;3600000;0
20687;58830;3796;27;33;7;26;.788;3600000;0
20687;58856;3796;0;0;0;0;.00nan;0;0
20688;64734;3800;0;0;0;0;.00nan;0;0
20688;64736;3800;62;31;4;27;.871;3600000;0
20688;85709;3798;63;25;3;22;.880;3600000;0
20688;91413;3798;0;0;0;0;.00nan;0;0
20689;168021;3797;72;31;3;28;.903;3639000;0
20689;-1;3795;87;40;2;38;.950;3639000;0
20689;37638;3797;0;0;0;0;.00nan;0;0
20689;78845;3795;0;0;0;0;.00nan;0;0
20690;168021;3797;0;0;0;0;.00nan;0;0
20690;37638;3797;37;32;6;26;.813;3571000;0
20690;85709;3798;54;30;4;26;.867;3600000;0
20690;91413;3798;0;0;0;0;.00nan;0;0
20691;58830;3796;94;35;2;33;.943;3900000;0
20691;58856;3796;0;0;0;0;.00nan;0;0
20691;85709;3798;79;25;2;23;.920;3900000;0
20691;91413;3798;0;0;0;0;.00nan;0;0
20692;-1;3795;49;13;2;11;.846;3600000;0
20692;64734;3800;0;0;0;0;.00nan;0;0
20692;64736;3800;60;41;5;36;.878;3600000;0
20692;78845;3795;0;0;0;0;.00nan;0;0
20693;168021;4635;34;23;5;18;.783;3815000;0
20693;37638;3797;69;42;4;38;.905;3815000;0
20693;57152;4635;0;0;0;0;.00nan;0;0
20693;57340;3797;0;0;0;0;.00nan;0;0
20694;64734;3800;88;33;1;32;.970;3600000;0
20694;64736;3800;0;0;0;0;.00nan;0;0
20694;85709;3798;81;29;2;27;.931;3572000;0
20694;91413;3798;0;0;0;0;.00nan;0;0
20695;168021;4635;47;31;5;26;.839;3651000;0
20695;37638;3797;25;6;3;3;.500;598000;0
20695;57152;4635;0;0;0;0;.00nan;0;0
20695;57340;3797;99;53;1;52;.981;3053000;0
20696;58830;3796;57;26;3;23;.885;3562000;0
20696;58856;3796;0;0;0;0;.00nan;0;0
20696;64734;3800;0;0;0;0;.00nan;0;0
20696;64736;3800;78;27;2;25;.926;3600000;0
20697;57046;3795;0;0;0;0;.00nan;0;0
20697;78845;3795;60;25;3;22;.880;3600000;0
20697;85709;3798;45;31;5;26;.839;3590000;0
20697;91413;3798;0;0;0;0;.00nan;0;0
20698;168021;4635;100;28;0;28;1.000;3600000;0
20698;57152;4635;0;0;0;0;.00nan;0;0
20698;58830;3796;52;22;4;18;.818;3600000;0
20698;58856;3796;0;0;0;0;.00nan;0;0
20699;57046;3795;0;0;0;0;.00nan;0;0
20699;78845;3795;65;34;4;30;.882;3600000;0
20699;85709;3798;34;27;5;22;.815;3599000;0
20699;91413;3798;0;0;0;0;.00nan;0;0
20700;37638;3797;53;34;4;30;.882;3571000;0
20700;57340;3797;0;0;0;0;.00nan;0;0
20700;64734;3800;0;0;0;0;.00nan;0;0
20700;64736;3800;100;40;2;38;.950;3600000;0
20701;37638;3797;41;25;4;21;.840;3600000;0
20701;57340;3797;0;0;0;0;.00nan;0;0
20701;58830;3796;47;36;5;31;.861;3598000;0
20701;58856;3796;0;0;0;0;.00nan;0;0
20702;64734;3800;0;0;0;0;.00nan;0;0
20702;64736;3800;97;45;2;43;.956;3900000;0
20702;85709;3798;80;28;2;26;.929;3900000;0
20702;91413;3798;0;0;0;0;.00nan;0;0
20703;168021;4635;38;36;6;30;.833;3216000;0
20703;57046;3795;67;28;3;25;.893;3600000;0
20703;57152;4635;62;9;0;9;1.000;384000;0
20703;78845;3795;0;0;0;0;.00nan;0;0
20704;57046;3795;0;0;0;0;.00nan;0;0
20704;64734;3800;0;0;0;0;.00nan;0;0
20704;64736;3800;50;36;5;31;.861;3600000;0
20704;78845;3795;93;31;1;30;.968;3600000;0
20705;57046;3795;56;29;4;25;.862;3600000;0
20705;58830;3796;97;36;1;35;.972;3600000;0
20705;58856;3796;0;0;0;0;.00nan;0;0
20705;78845;3795;0;0;0;0;.00nan;0;0
20706;37638;3797;91;62;3;59;.952;3600000;0
20706;57340;3797;0;0;0;0;.00nan;0;0
20706;85709;3798;0;0;0;0;.00nan;0;0
20706;91413;3798;46;25;4;21;.840;3544000;0
20707;58830;3796;24;28;6;22;.786;2632000;0
20707;58856;3796;50;7;1;6;.857;968000;0
20707;64734;3800;0;0;0;0;.00nan;0;0
20707;64736;3800;92;35;2;33;.943;3600000;0
20708;168021;4635;68;25;2;23;.920;3600000;0
20708;57152;4635;0;0;0;0;.00nan;0;0
20708;64734;3800;0;0;0;0;.00nan;0;0
20708;64736;3800;60;30;4;26;.867;3527000;0
20709;168021;4635;45;19;4;15;.789;3600000;0
20709;57152;4635;0;0;0;0;.00nan;0;0
20709;58830;3796;37;35;6;29;.829;2923000;0
20709;58856;3796;54;5;0;5;1.000;677000;0
20710;37638;3797;40;33;6;27;.818;3543000;0
20710;57340;3797;0;0;0;0;.00nan;0;0
20710;64734;3800;0;0;0;0;.00nan;0;0
20710;64736;3800;85;43;4;39;.907;3600000;0
20711;57046;3795;0;0;0;0;.00nan;0;0
20711;78845;3795;57;26;3;23;.885;3758000;0
20711;85709;3798;82;45;4;41;.911;3758000;0
20711;91413;3798;0;0;0;0;.00nan;0;0
20712;57046;3795;66;29;3;26;.897;3710000;0
20712;78845;3795;0;0;0;0;.00nan;0;0
20712;85709;3798;72;44;4;40;.909;3710000;0
20712;91413;3798;0;0;0;0;.00nan;0;0
20713;37638;3797;0;0;0;0;.00nan;0;0
20713;57340;3797;53;39;5;34;.872;3600000;0
20713;58830;3796;0;0;0;0;.00nan;0;0
20713;58856;3796;65;24;3;21;.875;3600000;0
20714;168021;4635;56;32;4;28;.875;3600000;0
20714;57152;4635;0;0;0;0;.00nan;0;0
20714;58830;3796;88;28;1;27;.964;3600000;0
20714;58856;3796;0;0;0;0;.00nan;0;0
20715;64734;3800;0;0;0;0;.00nan;0;0
20715;64736;3800;100;39;1;38;.974;3600000;0
20715;85709;3798;52;30;4;26;.867;3600000;0
20715;91413;3798;0;0;0;0;.00nan;0;0
20716;37638;3797;78;30;2;28;.933;3516000;0
20716;57046;3795;0;0;0;0;.00nan;0;0
20716;57340;3797;0;0;0;0;.00nan;0;0
20716;78845;3795;100;27;0;27;1.000;3600000;0
20717;58830;3796;81;24;1;23;.958;3600000;0
20717;58856;3796;0;0;0;0;.00nan;0;0
20717;64734;3800;97;40;2;38;.950;3546000;0
20717;64736;3800;0;0;0;0;.00nan;0;0
20718;168021;4635;45;20;3;17;.850;3546000;0
20718;57152;4635;0;0;0;0;.00nan;0;0
20718;85709;3798;88;31;2;29;.935;3600000;0
20718;91413;3798;0;0;0;0;.00nan;0;0
20719;37638;3797;0;0;0;0;.00nan;0;0
20719;57046;3795;0;0;0;0;.00nan;0;0
20719;57340;3797;63;27;3;24;.889;3600000;0
20719;78845;3795;63;26;4;22;.846;3600000;0
20720;168021;4635;0;0;0;0;.00nan;0;0
20720;57046;3795;0;0;0;0;.00nan;0;0
20720;57152;4635;67;44;5;39;.886;3600000;0
20720;78845;3795;80;30;2;28;.933;3600000;0
20721;37638;3797;0;0;0;0;.00nan;0;0
20721;57340;3797;71;32;3;29;.906;3600000;0
20721;58830;3796;59;38;4;34;.895;3555000;0
20721;58856;3796;0;0;0;0;.00nan;0;0
20722;57046;3795;78;38;3;35;.921;3567000;0
20722;64734;3800;0;0;0;0;.00nan;0;0
20722;64736;3800;99;39;2;37;.949;3600000;0
20722;78845;3795;0;0;0;0;.00nan;0;0
20723;168021;4635;59;37;6;31;.838;3600000;0
20723;57152;4635;0;0;0;0;.00nan;0;0
20723;85709;3798;85;38;3;35;.921;3600000;0
20723;91413;3798;0;0;0;0;.00nan;0;0
20724;168021;4635;69;20;1;19;.950;3600000;0
20724;57152;4635;0;0;0;0;.00nan;0;0
20724;64734;3800;0;0;0;0;.00nan;0;0
20724;64736;3800;64;30;3;27;.900;3600000;0
20725;37638;3797;35;26;5;21;.808;3897000;0
20725;57046;3795;0;0;0;0;.00nan;0;0
20725;57340;3797;0;0;0;0;.00nan;0;0
20725;78845;3795;22;24;6;18;.750;3897000;0
20726;58830;3796;96;37;1;36;.973;3600000;0
20726;58856;3796;0;0;0;0;.00nan;0;0
20726;85709;3798;91;42;2;40;.952;3591000;0
20726;91413;3798;0;0;0;0;.00nan;0;0
20727;168021;4635;0;0;0;0;.00nan;0;0
20727;57152;4635;58;18;2;16;.889;3600000;0
20727;64734;3800;0;0;0;0;.00nan;0;0
20727;64736;3800;56;27;4;23;.852;3570000;0
20728;58830;3796;83;44;4;40;.909;3900000;0
20728;58856;3796;0;0;0;0;.00nan;0;0
20728;85709;3798;0;0;0;0;.00nan;0;0
20728;91413;3798;64;32;4;28;.875;3900000;0
20729;168021;4635;67;46;5;41;.891;3600000;0
20729;57152;4635;0;0;0;0;.00nan;0;0
20729;85709;3798;92;32;1;31;.969;3600000;0
20729;91413;3798;0;0;0;0;.00nan;0;0
20730;37638;3797;48;37;6;31;.838;2693000;0
20730;57340;3797;64;10;0;10;1.000;884000;0
20730;64734;3800;0;0;0;0;.00nan;0;0
20730;64736;3800;54;34;5;29;.853;3600000;0
20731;57046;3795;78;28;2;26;.929;3600000;0
20731;58830;3796;43;30;6;24;.800;3238000;0
20731;58856;3796;62;12;0;12;1.000;362000;0
20731;78845;3795;0;0;0;0;.00nan;0;0
20732;168021;4635;0;0;0;0;.00nan;0;0
20732;57046;3795;0;0;0;0;.00nan;0;0
20732;57152;4635;88;18;0;18;1.000;3600000;0
20732;78845;3795;69;34;3;31;.912;3600000;0
20733;37638;3797;0;0;0;0;.00nan;0;0
20733;57340;3797;76;38;3;35;.921;3600000;0
20733;85709;3798;0;0;0;0;.00nan;0;0
20733;91413;3798;63;36;4;32;.889;3600000;0
20734;58830;3796;0;0;0;0;.00nan;0;0
20734;58856;3796;53;32;5;27;.844;3600000;0
20734;64734;3800;0;0;0;0;.00nan;0;0
20734;64736;3800;48;35;6;29;.829;3600000;0
20736;-1;3798;35;19;5;14;.737;3899000;0
20736;-1;3795;75;43;4;39;.907;3899000;0
20736;37467;3798;0;0;0;0;.00nan;0;0
20736;78845;3795;0;0;0;0;.00nan;0;0
20738;58856;3796;0;0;0;0;.00nan;0;0
20738;64734;3800;0;0;0;0;.00nan;0;0
20738;64736;3800;97;48;3;45;.938;3600000;0
20738;91413;3796;74;26;2;24;.923;3600000;0
20740;168001;4635;87;37;2;35;.946;3600000;0
20740;168021;3797;34;31;6;25;.806;3001000;0
20740;37638;3797;45;8;2;6;.750;599000;0
20740;161023;4635;0;0;0;0;.00nan;0;0
20742;168001;4635;0;0;0;0;.00nan;0;0
20742;168021;3797;0;0;0;0;.00nan;0;0
20742;37638;3797;61;51;6;45;.882;3583000;0
20742;161023;4635;46;23;4;19;.826;3600000;0
20744;58856;3796;70;18;1;17;.944;3600000;0
20744;64734;3800;0;0;0;0;.00nan;0;0
20744;64736;3800;90;37;2;35;.946;3596000;0
20744;91413;3796;0;0;0;0;.00nan;0;0
20746;-1;3798;0;0;0;0;.00nan;0;0
20746;-1;3795;0;0;0;0;.00nan;0;0
20746;37467;3798;100;22;0;22;1.000;3600000;0
20746;78845;3795;64;44;5;39;.886;3600000;0
20748;168001;4635;29;26;5;21;.808;3600000;0
20748;64734;3800;0;0;0;0;.00nan;0;0
20748;64736;3800;89;38;3;35;.921;3600000;0
20748;161023;4635;0;0;0;0;.00nan;0;0
20750;168021;3797;70;19;1;18;.947;3600000;0
20750;37638;3797;0;0;0;0;.00nan;0;0
20750;58856;3796;59;13;1;12;.923;1164000;0
20750;91413;3796;49;34;6;28;.824;2436000;0
20752;-1;3798;0;0;0;0;.00nan;0;0
20752;-1;3795;64;40;4;36;.900;3600000;0
20752;37467;3798;70;22;1;21;.955;3600000;0
20752;78845;3795;0;0;0;0;.00nan;0;0
20754;168021;3797;0;0;0;0;.00nan;0;0
20754;37638;3797;86;36;3;33;.917;3569000;0
20754;58856;3796;0;0;0;0;.00nan;0;0
20754;91413;3796;63;23;2;21;.913;3600000;0
20756;-1;3795;52;25;3;22;.880;3600000;0
20756;64734;3800;0;0;0;0;.00nan;0;0
20756;64736;3800;70;44;5;39;.886;3552000;0
20756;78845;3795;0;0;0;0;.00nan;0;0
20758;168001;4635;77;30;2;28;.933;3600000;0
20758;-1;3798;72;32;3;29;.906;3556000;0
20758;37467;3798;0;0;0;0;.00nan;0;0
20758;161023;4635;0;0;0;0;.00nan;0;0
20760;-1;3798;0;0;0;0;.00nan;0;0
20760;-1;3795;0;0;0;0;.00nan;0;0
20760;37467;3798;45;33;5;28;.848;3565000;0
20760;78845;3795;56;27;4;23;.852;3600000;0
20762;168001;4635;0;0;0;0;.00nan;0;0
20762;58856;3796;68;27;2;25;.926;3600000;0
20762;91413;3796;0;0;0;0;.00nan;0;0
20762;161023;4635;37;28;5;23;.821;3600000;0
20764;168021;3797;70;22;1;21;.955;3675000;0
20764;37638;3797;0;0;0;0;.00nan;0;0
20764;64734;3800;92;44;2;42;.955;3675000;0
20764;64736;3800;0;0;0;0;.00nan;0;0
20766;168001;4635;72;20;1;19;.950;3600000;0
20766;168021;3797;70;35;3;32;.914;3516000;0
20766;37638;3797;0;0;0;0;.00nan;0;0
20766;161023;4635;0;0;0;0;.00nan;0;0
20768;-1;3798;97;25;0;25;1.000;3600000;0
20768;-1;3795;48;28;4;24;.857;3600000;0
20768;37467;3798;0;0;0;0;.00nan;0;0
20768;78845;3795;0;0;0;0;.00nan;0;0
20770;58856;3796;0;0;0;0;.00nan;0;0
20770;64734;3800;0;0;0;0;.00nan;0;0
20770;64736;3800;100;39;1;38;.974;3600000;0
20770;91413;3796;65;30;4;26;.867;3600000;0
1149;37638;3797;59;30;4;26;.867;3561000;0
1149;57340;3797;0;0;0;0;.00nan;0;0
1149;64734;3800;0;0;0;0;.00nan;0;0
1149;64736;3800;64;28;3;25;.893;3600000;0
1150;168021;4635;0;0;0;0;.00nan;0;0
1150;57152;4635;62;27;3;24;.889;3600000;0
1150;58830;3796;96;21;0;21;1.000;3600000;0
1150;58856;3796;0;0;0;0;.00nan;0;0
1151;37638;3797;49;19;3;16;.842;3600000;0
1151;57340;3797;0;0;0;0;.00nan;0;0
1151;64734;3800;0;0;0;0;.00nan;0;0
1151;64736;3800;49;32;4;28;.875;3573000;0
1152;168021;4635;43;24;4;20;.833;3600000;0
1152;57152;4635;0;0;0;0;.00nan;0;0
1152;58830;3796;78;38;3;35;.921;3600000;0
1152;58856;3796;0;0;0;0;.00nan;0;0
1153;37638;3797;62;36;4;32;.889;3600000;0
1153;57340;3797;0;0;0;0;.00nan;0;0
1153;64734;3800;0;0;0;0;.00nan;0;0
1153;64736;3800;26;25;6;19;.760;3566000;0
1154;168021;4635;52;15;2;13;.867;3600000;0
1154;57152;4635;0;0;0;0;.00nan;0;0
1154;58830;3796;81;42;4;38;.905;3545000;0
1154;58856;3796;0;0;0;0;.00nan;0;0
1155;37638;3797;44;30;5;25;.833;4051000;0
1155;57340;3797;0;0;0;0;.00nan;0;0
1155;64734;3800;0;0;0;0;.00nan;0;0
1155;64736;3800;53;31;4;27;.871;4051000;0
1156;168021;4635;35;25;5;20;.800;3909000;0
1156;57152;4635;0;0;0;0;.00nan;0;0
1156;58830;3796;59;42;6;36;.857;3909000;0
1156;58856;3796;0;0;0;0;.00nan;0;0
1464;37638;3797;80;25;1;24;.960;3600000;0
1464;57340;3797;0;0;0;0;.00nan;0;0
1464;64734;3800;0;0;0;0;.00nan;0;0
1464;64736;3800;62;41;5;36;.878;3600000;0
1465;168021;4635;67;28;2;26;.929;3580000;0
1465;57152;4635;0;0;0;0;.00nan;0;0
1465;58830;3796;100;30;0;30;1.000;3600000;0
1465;58856;3796;0;0;0;0;.00nan;0;0
1491;37638;3797;62;21;3;18;.857;3547000;0
1491;57340;3797;0;0;0;0;.00nan;0;0
1491;64734;3800;0;0;0;0;.00nan;0;0
1491;64736;3800;85;31;2;29;.935;3600000;0
1492;168021;4635;27;29;7;22;.759;3600000;0
1492;57152;4635;0;0;0;0;.00nan;0;0
1492;58830;3796;77;31;2;29;.935;3600000;0
1492;58856;3796;0;0;0;0;.00nan;0;0
1515;37638;3797;80;38;3;35;.921;3600000;0
1515;57340;3797;0;0;0;0;.00nan;0;0
1515;64734;3800;0;0;0;0;.00nan;0;0
1515;64736;3800;66;36;5;31;.861;3567000;0
1534;57046;3795;0;0;0;0;.00nan;0;0
1534;58830;3796;62;29;3;26;.897;3600000;0
1534;58856;3796;0;0;0;0;.00nan;0;0
1534;78845;3795;42;34;6;28;.824;3600000;0
1535;37638;3797;25;28;6;22;.786;3573000;0
1535;57340;3797;0;0;0;0;.00nan;0;0
1535;85709;3798;51;35;5;30;.857;2352000;0
1535;91413;3798;61;8;0;8;1.000;1248000;0
1536;57046;3795;0;0;0;0;.00nan;0;0
1536;58830;3796;66;39;4;35;.897;3571000;0
1536;58856;3796;0;0;0;0;.00nan;0;0
1536;78845;3795;71;25;2;23;.920;3600000;0
1537;37638;3797;41;26;5;21;.808;3574000;0
1537;57340;3797;0;0;0;0;.00nan;0;0
1537;85709;3798;79;35;3;32;.914;3600000;0
1537;91413;3798;0;0;0;0;.00nan;0;0
1538;57046;3795;0;0;0;0;.00nan;0;0
1538;58830;3796;99;41;1;40;.976;4880000;0
1538;58856;3796;0;0;0;0;.00nan;0;0
1538;78845;3795;92;48;2;46;.958;4880000;0
1539;37638;3797;77;30;2;28;.933;3600000;0
1539;57340;3797;0;0;0;0;.00nan;0;0
1539;85709;3798;40;21;4;17;.810;3511000;0
1539;91413;3798;0;0;0;0;.00nan;0;0
1540;57046;3795;0;0;0;0;.00nan;0;0
1540;58830;3796;66;26;2;24;.923;3600000;0
1540;58856;3796;0;0;0;0;.00nan;0;0
1540;78845;3795;73;30;3;27;.900;3600000;0
1541;37638;3797;86;31;2;29;.935;3600000;0
1541;57340;3797;0;0;0;0;.00nan;0;0
1541;85709;3798;47;23;4;19;.826;3588000;0
1541;91413;3798;0;0;0;0;.00nan;0;0
1751;57046;3795;0;0;0;0;.00nan;0;0
1751;58830;3796;91;41;1;40;.976;3600000;0
1751;58856;3796;0;0;0;0;.00nan;0;0
1751;78845;3795;71;28;2;26;.929;3546000;0
1752;37638;3797;78;46;4;42;.913;3600000;0
1752;57340;3797;0;0;0;0;.00nan;0;0
1752;85709;3798;93;23;0;23;1.000;3600000;0
1752;91413;3798;0;0;0;0;.00nan;0;0
1773;37638;3797;63;22;2;20;.909;3600000;0
1773;57340;3797;0;0;0;0;.00nan;0;0
1773;85709;3798;97;54;3;51;.944;3543000;0
1773;91413;3798;0;0;0;0;.00nan;0;0
1798;37638;3797;63;23;2;21;.913;3902000;0
1798;57340;3797;0;0;0;0;.00nan;0;0
1798;85709;3798;75;26;1;25;.962;3902000;0
1798;91413;3798;0;0;0;0;.00nan;0;0
1879;58830;3796;90;35;1;34;.971;3600000;0
1879;58856;3796;0;0;0;0;.00nan;0;0
1879;85709;3798;56;24;3;21;.875;3585000;0
1879;91413;3798;0;0;0;0;.00nan;0;0
1880;58830;3796;51;40;6;34;.850;3600000;0
1880;58856;3796;0;0;0;0;.00nan;0;0
1880;85709;3798;88;19;0;19;1.000;3600000;0
1880;91413;3798;0;0;0;0;.00nan;0;0
20771;1765;1425;36;6;2;4;.667;880000;0
20771;3517;1425;39;37;6;31;.838;2720000;0
20771;165030;1453;60;41;5;36;.878;3600000;0
20771;45584;1453;0;0;0;0;.00nan;0;0
20772;11751;1427;56;14;1;13;.929;3600000;0
20772;165030;1453;68;58;6;52;.897;3600000;0
20772;45584;1453;0;0;0;0;.00nan;0;0
20772;-1;1427;0;0;0;0;.00nan;0;0
20773;-1;1426;0;0;0;0;.00nan;0;0
20773;56058;1426;82;26;1;25;.962;3600000;0
20773;143412;1429;72;28;2;26;.929;3600000;0
20773;148691;1429;0;0;0;0;.00nan;0;0
20774;4127;1440;100;37;1;36;.973;3600000;0
20774;-1;4961;55;35;5;30;.857;3600000;0
20774;185775;1440;0;0;0;0;.00nan;0;0
20774;68961;4961;0;0;0;0;.00nan;0;0
20775;17596;1443;53;13;2;11;.846;3600000;0
20775;32819;1430;49;61;8;53;.869;3600000;0
20775;181269;1443;0;0;0;0;.00nan;0;0
20775;157903;1430;0;0;0;0;.00nan;0;0
20776;5923;4742;63;38;4;34;.895;3600000;0
20776;9524;1422;0;0;0;0;.00nan;0;0
20776;36946;4742;0;0;0;0;.00nan;0;0
20776;66271;1422;100;34;0;34;1.000;3600000;0
20777;1765;1425;49;28;5;23;.821;3547000;0
20777;3517;1425;0;0;0;0;.00nan;0;0
20777;5923;4742;71;33;3;30;.909;3600000;0
20777;36946;4742;0;0;0;0;.00nan;0;0
20778;-1;1426;0;0;0;0;.00nan;0;0
20778;56058;1426;89;50;3;47;.940;3569000;0
20778;143412;1429;89;29;1;28;.966;3600000;0
20778;148691;1429;0;0;0;0;.00nan;0;0
20779;4127;1440;0;0;0;0;.00nan;0;0
20779;32819;1430;41;26;4;22;.846;3900000;0
20779;185775;1440;84;43;4;39;.907;3900000;0
20779;157903;1430;0;0;0;0;.00nan;0;0
20780;9524;1422;0;0;0;0;.00nan;0;0
20780;-1;4961;62;44;4;40;.909;3578000;0
20780;66271;1422;77;34;3;31;.912;3600000;0
20780;68961;4961;0;0;0;0;.00nan;0;0
20781;11751;1427;29;31;6;25;.806;2824000;0
20781;17596;1443;0;0;0;0;.00nan;0;0
20781;181269;1443;28;22;5;17;.773;3600000;0
20781;-1;1427;53;14;1;13;.929;776000;0
20782;1765;1425;35;20;4;16;.800;3600000;0
20782;3517;1425;0;0;0;0;.00nan;0;0
20782;-1;4961;29;31;7;24;.774;3600000;0
20782;68961;4961;0;0;0;0;.00nan;0;0
20783;11751;1427;81;30;3;27;.900;3600000;0
20783;-1;1426;0;0;0;0;.00nan;0;0
20783;-1;1427;0;0;0;0;.00nan;0;0
20783;56058;1426;72;48;5;43;.896;3582000;0
20784;165030;1453;80;31;1;30;.968;3600000;0
20784;45584;1453;0;0;0;0;.00nan;0;0
20784;143412;1429;46;21;3;18;.857;3513000;0
20784;148691;1429;0;0;0;0;.00nan;0;0
20785;9524;1422;75;39;3;36;.923;3600000;0
20785;32819;1430;60;38;4;34;.895;3600000;0
20785;66271;1422;0;0;0;0;.00nan;0;0
20785;157903;1430;0;0;0;0;.00nan;0;0
20786;5923;4742;73;32;3;29;.906;3600000;0
20786;-1;4961;69;46;5;41;.891;3538000;0
20786;36946;4742;0;0;0;0;.00nan;0;0
20786;68961;4961;0;0;0;0;.00nan;0;0
20787;4127;1440;71;38;3;35;.921;3025000;0
20787;17596;1443;73;8;0;8;1.000;3600000;0
20787;181269;1443;0;0;0;0;.00nan;0;0
20787;185775;1440;28;8;3;5;.625;575000;0
20788;11751;1427;0;0;0;0;.00nan;0;0
20788;-1;1427;47;21;3;18;.857;3560000;0
20788;143412;1429;0;0;0;0;.00nan;0;0
20788;148691;1429;88;38;2;36;.947;3600000;0
20789;1765;1425;61;39;4;35;.897;3900000;0
20789;3517;1425;0;0;0;0;.00nan;0;0
20789;17596;1443;45;25;4;21;.840;3900000;0
20789;181269;1443;0;0;0;0;.00nan;0;0
20790;165030;1453;0;0;0;0;.00nan;0;0
20790;-1;1426;0;0;0;0;.00nan;0;0
20790;45584;1453;76;26;2;24;.923;3600000;0
20790;56058;1426;45;32;5;27;.844;3600000;0
20791;4127;1440;0;0;0;0;.00nan;0;0
20791;5923;4742;0;0;0;0;.00nan;0;0
20791;36946;4742;74;28;2;26;.929;3600000;0
20791;185775;1440;35;22;5;17;.773;3600000;0
20792;9524;1422;0;0;0;0;.00nan;0;0
20792;32819;1430;0;0;0;0;.00nan;0;0
20792;66271;1422;94;21;0;21;1.000;3600000;0
20792;157903;1430;78;45;4;41;.911;3600000;0
20793;9524;1422;0;0;0;0;.00nan;0;0
20793;-1;1426;0;0;0;0;.00nan;0;0
20793;56058;1426;82;43;4;39;.907;3600000;0
20793;66271;1422;45;36;6;30;.833;3515000;0
20794;-1;4961;0;0;0;0;.00nan;0;0
20794;68961;4961;43;29;5;24;.828;3539000;0
20794;143412;1429;71;33;3;30;.909;3600000;0
20794;148691;1429;0;0;0;0;.00nan;0;0
20795;165030;1453;63;57;8;49;.860;3600000;0
20795;17596;1443;53;9;1;8;.889;3600000;0
20795;181269;1443;0;0;0;0;.00nan;0;0
20795;45584;1453;0;0;0;0;.00nan;0;0
20796;11751;1427;66;41;4;37;.902;3785000;0
20796;32819;1430;56;21;3;18;.857;3785000;0
20796;-1;1427;0;0;0;0;.00nan;0;0
20796;157903;1430;0;0;0;0;.00nan;0;0
20797;4127;1440;87;35;1;34;.971;3600000;0
20797;5923;4742;71;27;2;25;.926;3580000;0
20797;36946;4742;0;0;0;0;.00nan;0;0
20797;185775;1440;0;0;0;0;.00nan;0;0
20798;1765;1425;0;0;0;0;.00nan;0;0
20798;3517;1425;49;20;3;17;.850;3600000;0
20798;11751;1427;0;0;0;0;.00nan;0;0
20798;-1;1427;55;42;5;37;.881;3600000;0
20799;-1;4961;33;20;4;16;.800;3591000;0
20799;68961;4961;0;0;0;0;.00nan;0;0
20799;143412;1429;0;0;0;0;.00nan;0;0
20799;148691;1429;69;34;3;31;.912;3600000;0
20800;4127;1440;0;0;0;0;.00nan;0;0
20800;165030;1453;42;35;5;30;.857;3600000;0
20800;185775;1440;90;37;2;35;.946;3600000;0
20800;45584;1453;0;0;0;0;.00nan;0;0
20801;9524;1422;29;23;5;18;.783;3552000;0
20801;-1;1426;0;0;0;0;.00nan;0;0
20801;56058;1426;85;47;4;43;.915;3600000;0
20801;66271;1422;0;0;0;0;.00nan;0;0
20802;17596;1443;55;16;2;14;.875;3600000;0
20802;32819;1430;54;50;6;44;.880;3033000;0
20802;181269;1443;0;0;0;0;.00nan;0;0
20802;157903;1430;60;6;0;6;1.000;567000;0
20803;4127;1440;0;0;0;0;.00nan;0;0
20803;11751;1427;49;25;4;21;.840;3600000;0
20803;185775;1440;87;32;1;31;.969;3600000;0
20803;-1;1427;0;0;0;0;.00nan;0;0
20804;1765;1425;68;22;1;21;.955;3600000;0
20804;3517;1425;0;0;0;0;.00nan;0;0
20804;165030;1453;35;30;6;24;.800;3080000;0
20804;45584;1453;53;5;0;5;1.000;520000;0
20805;-1;4961;60;36;4;32;.889;3600000;0
20805;-1;1426;0;0;0;0;.00nan;0;0
20805;56058;1426;60;29;3;26;.897;3600000;0
20805;68961;4961;0;0;0;0;.00nan;0;0
20806;9524;1422;56;5;0;5;1.000;619000;0
20806;17596;1443;98;33;1;32;.970;3600000;0
20806;181269;1443;0;0;0;0;.00nan;0;0
20806;66271;1422;45;34;6;28;.824;2981000;0
20807;4127;1440;35;36;7;29;.806;2344000;0
20807;32819;1430;76;23;1;22;.957;3600000;0
20807;185775;1440;46;12;2;10;.833;1256000;0
20807;157903;1430;0;0;0;0;.00nan;0;0
20808;5923;4742;77;31;2;29;.935;3600000;0
20808;36946;4742;0;0;0;0;.00nan;0;0
20808;143412;1429;69;37;5;32;.865;3600000;0
20808;148691;1429;0;0;0;0;.00nan;0;0
20809;11751;1427;44;39;6;33;.846;3345000;0
20809;32819;1430;54;23;3;20;.870;3600000;0
20809;-1;1427;47;3;1;2;.667;255000;0
20809;157903;1430;0;0;0;0;.00nan;0;0
20810;-1;4961;100;39;2;37;.949;3600000;0
20810;-1;1426;0;0;0;0;.00nan;0;0
20810;56058;1426;65;32;3;29;.906;3591000;0
20810;68961;4961;0;0;0;0;.00nan;0;0
20811;9524;1422;100;39;1;38;.974;3600000;0
20811;66271;1422;0;0;0;0;.00nan;0;0
20811;143412;1429;0;0;0;0;.00nan;0;0
20811;148691;1429;70;35;3;32;.914;3600000;0
20812;5923;4742;0;0;0;0;.00nan;0;0
20812;165030;1453;58;20;2;18;.900;3600000;0
20812;36946;4742;53;39;5;34;.872;3600000;0
20812;45584;1453;0;0;0;0;.00nan;0;0
20813;1765;1425;82;39;3;36;.923;3013000;0
20813;3517;1425;28;7;3;4;.571;587000;0
20813;17596;1443;62;17;1;16;.941;3600000;0
20813;181269;1443;0;0;0;0;.00nan;0;0
20814;5923;4742;100;29;0;29;1.000;3600000;0
20814;36946;4742;0;0;0;0;.00nan;0;0
20814;-1;1426;0;0;0;0;.00nan;0;0
20814;56058;1426;80;29;2;27;.931;3514000;0
20815;11751;1427;46;38;6;32;.842;3600000;0
20815;-1;1427;0;0;0;0;.00nan;0;0
20815;143412;1429;49;20;3;17;.850;3600000;0
20815;148691;1429;0;0;0;0;.00nan;0;0
20816;-1;4961;66;34;3;31;.912;3600000;0
20816;32819;1430;100;28;0;28;1.000;3600000;0
20816;68961;4961;0;0;0;0;.00nan;0;0
20816;157903;1430;0;0;0;0;.00nan;0;0
20817;4127;1440;0;0;0;0;.00nan;0;0
20817;17596;1443;58;13;2;11;.846;3600000;0
20817;181269;1443;0;0;0;0;.00nan;0;0
20817;185775;1440;56;48;6;42;.875;3600000;0
20818;9524;1422;66;32;4;28;.875;3600000;0
20818;165030;1453;8;50;10;40;.800;3600000;0
20818;45584;1453;0;0;0;0;.00nan;0;0
20818;66271;1422;0;0;0;0;.00nan;0;0
20819;1765;1425;65;18;1;17;.944;3600000;0
20819;3517;1425;0;0;0;0;.00nan;0;0
20819;11751;1427;0;0;0;0;.00nan;0;0
20819;-1;1427;86;41;3;38;.927;3566000;0
20820;4127;1440;100;30;0;30;1.000;3600000;0
20820;165030;1453;0;0;0;0;.00nan;0;0
20820;185775;1440;0;0;0;0;.00nan;0;0
20820;45584;1453;57;36;4;32;.889;3600000;0
20821;32819;1430;60;32;4;28;.875;3600000;0
20821;143412;1429;0;0;0;0;.00nan;0;0
20821;148691;1429;36;33;5;28;.848;3553000;0
20821;157903;1430;0;0;0;0;.00nan;0;0
20822;5923;4742;29;30;6;24;.800;3600000;0
20822;36946;4742;0;0;0;0;.00nan;0;0
20822;-1;1426;50;25;3;22;.880;2087000;0
20822;56058;1426;1;11;6;5;.455;1513000;0
20823;-1;4961;18;28;6;22;.786;1409000;0
20823;17596;1443;72;9;0;9;1.000;3600000;0
20823;181269;1443;0;0;0;0;.00nan;0;0
20823;68961;4961;59;32;4;28;.875;2191000;0
20824;9524;1422;0;0;0;0;.00nan;0;0
20824;66271;1422;57;42;5;37;.881;3550000;0
20824;143412;1429;95;47;3;44;.936;3600000;0
20824;148691;1429;0;0;0;0;.00nan;0;0
20825;9524;1422;50;22;3;19;.864;3600000;0
20825;11751;1427;52;29;4;25;.862;3576000;0
20825;-1;1427;0;0;0;0;.00nan;0;0
20825;66271;1422;0;0;0;0;.00nan;0;0
20826;4127;1440;87;43;3;40;.930;3600000;0
20826;185775;1440;0;0;0;0;.00nan;0;0
20826;-1;1426;0;0;0;0;.00nan;0;0
20826;56058;1426;65;33;5;28;.848;3532000;0
20827;-1;4961;52;56;7;49;.875;2655000;0
20827;17596;1443;30;13;4;9;.692;3600000;0
20827;181269;1443;0;0;0;0;.00nan;0;0
20827;68961;4961;32;12;3;9;.750;945000;0
20828;1765;1425;0;0;0;0;.00nan;0;0
20828;3517;1425;54;15;2;13;.867;3600000;0
20828;32819;1430;75;39;3;36;.923;3574000;0
20828;157903;1430;0;0;0;0;.00nan;0;0
20829;5923;4742;51;32;5;27;.844;3600000;0
20829;165030;1453;27;28;6;22;.786;3552000;0
20829;36946;4742;0;0;0;0;.00nan;0;0
20829;45584;1453;0;0;0;0;.00nan;0;0
20830;1765;1425;55;26;3;23;.885;3600000;0
20830;3517;1425;0;0;0;0;.00nan;0;0
20830;32819;1430;66;23;2;21;.913;3600000;0
20830;157903;1430;0;0;0;0;.00nan;0;0
20831;17596;1443;77;21;1;20;.952;3600000;0
20831;181269;1443;0;0;0;0;.00nan;0;0
20831;143412;1429;88;55;3;52;.945;3600000;0
20831;148691;1429;0;0;0;0;.00nan;0;0
20832;165030;1453;48;30;4;26;.867;3583000;0
20832;-1;4961;72;23;2;21;.913;3600000;0
20832;45584;1453;0;0;0;0;.00nan;0;0
20832;68961;4961;0;0;0;0;.00nan;0;0
20833;4127;1440;0;0;0;0;.00nan;0;0
20833;185775;1440;99;43;1;42;.977;3600000;0
20833;-1;1426;46;6;1;5;.833;752000;0
20833;56058;1426;32;33;7;26;.788;2848000;0
20834;5923;4742;0;0;0;0;.00nan;0;0
20834;9524;1422;0;0;0;0;.00nan;0;0
20834;36946;4742;66;33;3;30;.909;3557000;0
20834;66271;1422;91;40;2;38;.950;3600000;0
20835;165030;1453;49;50;7;43;.860;2956000;0
20835;17596;1443;98;21;0;21;1.000;3600000;0
20835;181269;1443;0;0;0;0;.00nan;0;0
20835;45584;1453;20;9;4;5;.556;644000;0
20836;1765;1425;0;0;0;0;.00nan;0;0
20836;3517;1425;67;25;2;23;.920;3600000;0
20836;-1;1426;0;0;0;0;.00nan;0;0
20836;56058;1426;98;52;5;47;.904;3600000;0
20837;11751;1427;54;31;4;27;.871;3564000;0
20837;-1;4961;98;43;3;40;.930;3600000;0
20837;-1;1427;0;0;0;0;.00nan;0;0
20837;68961;4961;0;0;0;0;.00nan;0;0
20838;165030;1453;66;29;2;27;.931;3900000;0
20838;45584;1453;0;0;0;0;.00nan;0;0
20838;143412;1429;94;34;2;32;.941;3900000;0
20838;148691;1429;0;0;0;0;.00nan;0;0
20839;4127;1440;0;0;0;0;.00nan;0;0
20839;9524;1422;47;18;3;15;.833;3717000;0
20839;185775;1440;65;36;4;32;.889;3717000;0
20839;66271;1422;0;0;0;0;.00nan;0;0
20840;5923;4742;48;24;3;21;.875;3575000;0
20840;32819;1430;62;24;2;22;.917;3600000;0
20840;36946;4742;0;0;0;0;.00nan;0;0
20840;157903;1430;0;0;0;0;.00nan;0;0
20841;11751;1427;0;0;0;0;.00nan;0;0
20841;165030;1453;65;34;4;30;.882;3536000;0
20841;45584;1453;0;0;0;0;.00nan;0;0
20841;-1;1427;66;30;2;28;.933;3600000;0
20842;1765;1425;50;22;4;18;.818;3713000;0
20842;3517;1425;0;0;0;0;.00nan;0;0
20842;-1;4961;82;49;3;46;.939;3713000;0
20842;68961;4961;0;0;0;0;.00nan;0;0
20843;4127;1440;97;46;3;43;.935;3900000;0
20843;9524;1422;0;0;0;0;.00nan;0;0
20843;185775;1440;0;0;0;0;.00nan;0;0
20843;66271;1422;72;29;3;26;.897;3900000;0
20844;5923;4742;0;0;0;0;.00nan;0;0
20844;32819;1430;76;43;5;38;.884;3900000;0
20844;36946;4742;33;25;5;20;.800;3900000;0
20844;157903;1430;0;0;0;0;.00nan;0;0
20845;17596;1443;63;20;2;18;.900;3600000;0
20845;181269;1443;0;0;0;0;.00nan;0;0
20845;143412;1429;68;16;2;14;.875;1011000;0
20845;148691;1429;44;38;6;32;.842;2589000;0
20846;5923;4742;59;12;1;11;.917;3600000;0
20846;-1;4961;93;46;3;43;.935;3532000;0
20846;36946;4742;0;0;0;0;.00nan;0;0
20846;68961;4961;0;0;0;0;.00nan;0;0
20847;11751;1427;44;38;6;32;.842;3600000;0
20847;17596;1443;59;18;2;16;.889;3600000;0
20847;181269;1443;0;0;0;0;.00nan;0;0
20847;-1;1427;0;0;0;0;.00nan;0;0
20848;165030;1453;75;29;2;27;.931;3900000;0
20848;-1;1426;0;0;0;0;.00nan;0;0
20848;45584;1453;0;0;0;0;.00nan;0;0
20848;56058;1426;91;37;2;35;.946;3900000;0
20849;4127;1440;0;0;0;0;.00nan;0;0
20849;185775;1440;53;38;5;33;.868;3600000;0
20849;143412;1429;42;20;4;16;.800;3600000;0
20849;148691;1429;0;0;0;0;.00nan;0;0
20850;1765;1425;0;0;0;0;.00nan;0;0
20850;3517;1425;46;31;5;26;.839;3600000;0
20850;9524;1422;44;46;8;38;.826;3600000;0
20850;66271;1422;0;0;0;0;.00nan;0;0
20851;5923;4742;0;0;0;0;.00nan;0;0
20851;32819;1430;36;31;6;25;.806;2222000;0
20851;36946;4742;87;14;0;14;1.000;3600000;0
20851;157903;1430;51;9;1;8;.889;1378000;0
20852;1765;1425;0;0;0;0;.00nan;0;0
20852;32819;1425;49;18;3;15;.833;3600000;0
20852;-1;1426;23;12;4;8;.667;1175000;0
20852;56058;1426;66;19;1;18;.947;2349000;0
20853;4127;1440;32;23;5;18;.783;3544000;0
20853;185775;1440;0;0;0;0;.00nan;0;0
20853;143412;1429;0;0;0;0;.00nan;0;0
20853;148691;1429;49;24;4;20;.833;3600000;0
20854;11751;1427;0;0;0;0;.00nan;0;0
20854;165030;1453;0;0;0;0;.00nan;0;0
20854;45584;1453;54;33;4;29;.879;3900000;0
20854;-1;1427;68;32;4;28;.875;3900000;0
20855;-1;4961;74;44;4;40;.909;3584000;0
20855;195618;1430;0;0;0;0;.00nan;0;0
20855;68961;4961;0;0;0;0;.00nan;0;0
20855;157903;1430;60;25;3;22;.880;3600000;0
20856;9524;1422;0;0;0;0;.00nan;0;0
20856;17596;1443;0;0;0;0;.00nan;0;0
20856;181269;1443;53;29;4;25;.862;3600000;0
20856;66271;1422;100;49;1;48;.980;3600000;0
20857;17596;1443;60;12;1;11;.917;3600000;0
20857;181269;1443;0;0;0;0;.00nan;0;0
20857;-1;1426;69;14;0;14;1.000;842000;0
20857;56058;1426;42;39;6;33;.846;2758000;0
20858;11751;1427;68;28;3;25;.893;3600000;0
20858;-1;1427;0;0;0;0;.00nan;0;0
20858;143412;1429;33;17;4;13;.765;1959000;0
20858;148691;1429;52;9;1;8;.889;1569000;0
20859;165030;1453;42;35;5;30;.857;3600000;0
20859;-1;4961;37;37;7;30;.811;3516000;0
20859;45584;1453;0;0;0;0;.00nan;0;0
20859;68961;4961;0;0;0;0;.00nan;0;0
20860;9524;1422;91;46;3;43;.935;3600000;0
20860;195618;1430;0;0;0;0;.00nan;0;0
20860;66271;1422;0;0;0;0;.00nan;0;0
20860;157903;1430;88;53;4;49;.925;3586000;0
20861;5923;4742;0;0;0;0;.00nan;0;0
20861;174175;1425;0;0;0;0;.00nan;0;0
20861;32819;1425;56;22;3;19;.864;3600000;0
20861;36946;4742;58;33;4;29;.879;3563000;0
20862;11751;1427;0;0;0;0;.00nan;0;0
20862;-1;4961;44;30;5;25;.833;3585000;0
20862;-1;1427;57;23;3;20;.870;3600000;0
20862;68961;4961;0;0;0;0;.00nan;0;0
20863;9524;1422;0;0;0;0;.00nan;0;0
20863;174175;1425;35;31;6;25;.806;1727000;0
20863;32819;1425;41;16;3;13;.813;1873000;0
20863;66271;1422;83;36;3;33;.917;3600000;0
20864;165030;1453;84;43;2;41;.953;3900000;0
20864;195618;1430;65;28;2;26;.929;3900000;0
20864;45584;1453;0;0;0;0;.00nan;0;0
20864;157903;1430;0;0;0;0;.00nan;0;0
20865;4127;1440;62;36;4;32;.889;3600000;0
20865;5923;4742;30;29;6;23;.793;3553000;0
20865;36946;4742;0;0;0;0;.00nan;0;0
20865;185775;1440;0;0;0;0;.00nan;0;0
20866;17596;1443;70;23;2;21;.913;3600000;0
20866;181269;1443;0;0;0;0;.00nan;0;0
20866;-1;1426;48;35;5;30;.857;2321000;0
20866;56058;1426;34;19;4;15;.789;1279000;0
20867;9524;1422;77;41;4;37;.902;3600000;0
20867;-1;1426;0;0;0;0;.00nan;0;0
20867;56058;1426;84;28;1;27;.964;3600000;0
20867;66271;1422;0;0;0;0;.00nan;0;0
20868;174175;1425;0;0;0;0;.00nan;0;0
20868;32819;1425;77;25;1;24;.960;3600000;0
20868;143412;1429;63;39;4;35;.897;3600000;0
20868;148691;1429;0;0;0;0;.00nan;0;0
20869;4127;1440;45;11;1;10;.909;1564000;0
20869;-1;4961;51;31;5;26;.839;3900000;0
20869;185775;1440;55;27;4;23;.852;2336000;0
20869;68961;4961;0;0;0;0;.00nan;0;0
20870;165030;1453;36;30;5;25;.833;3563000;0
20870;195618;1430;0;0;0;0;.00nan;0;0
20870;45584;1453;0;0;0;0;.00nan;0;0
20870;157903;1430;50;22;3;19;.864;3600000;0
20871;5923;4742;43;29;5;24;.828;3570000;0
20871;11751;1427;55;24;3;21;.875;3600000;0
20871;36946;4742;0;0;0;0;.00nan;0;0
20871;-1;1427;0;0;0;0;.00nan;0;0
20872;11751;1427;0;0;0;0;.00nan;0;0
20872;-1;1426;37;34;6;28;.824;3514000;0
20872;-1;1427;48;33;4;29;.879;3600000;0
20872;56058;1426;0;0;0;0;.00nan;0;0
20873;165030;1453;29;31;6;25;.806;3600000;0
20873;174175;1425;39;19;4;15;.789;880000;0
20873;32819;1425;97;22;0;22;1.000;2720000;0
20873;45584;1453;0;0;0;0;.00nan;0;0
20874;4127;1440;59;35;4;31;.886;3600000;0
20874;-1;4961;44;18;3;15;.833;3600000;0
20874;185775;1440;0;0;0;0;.00nan;0;0
20874;68961;4961;0;0;0;0;.00nan;0;0
20875;9524;1422;0;0;0;0;.00nan;0;0
20875;195618;1430;66;23;2;21;.913;3600000;0
20875;66271;1422;66;43;5;38;.884;3600000;0
20875;157903;1430;0;0;0;0;.00nan;0;0
20876;5923;4742;0;0;0;0;.00nan;0;0
20876;17596;1443;57;11;1;10;.909;3600000;0
20876;181269;1443;0;0;0;0;.00nan;0;0
20876;36946;4742;61;47;6;41;.872;3600000;0
20877;195618;1430;0;0;0;0;.00nan;0;0
20877;-1;1426;0;0;0;0;.00nan;0;0
20877;56058;1426;52;34;5;29;.853;3610000;0
20877;157903;1430;42;24;4;20;.833;3610000;0
20878;4127;1440;0;0;0;0;.00nan;0;0
20878;174175;1425;0;0;0;0;.00nan;0;0
20878;32819;1425;85;18;0;18;1.000;3600000;0
20878;185775;1440;66;42;4;38;.905;3600000;0
20879;-1;4961;34;25;5;20;.800;3547000;0
20879;68961;4961;0;0;0;0;.00nan;0;0
20879;143412;1429;82;33;3;30;.909;3600000;0
20879;148691;1429;0;0;0;0;.00nan;0;0
20880;5923;4742;77;27;3;24;.889;3562000;0
20880;9524;1422;0;0;0;0;.00nan;0;0
20880;36946;4742;0;0;0;0;.00nan;0;0
20880;66271;1422;89;36;2;34;.944;3600000;0
20881;11751;1427;38;41;7;34;.829;3104000;0
20881;17596;1443;65;32;3;29;.906;3600000;0
20881;181269;1443;0;0;0;0;.00nan;0;0
20881;-1;1427;49;2;0;2;1.000;496000;0
20882;5923;4742;0;0;0;0;.00nan;0;0
20882;11751;1427;0;0;0;0;.00nan;0;0
20882;36946;4742;84;26;1;25;.962;3578000;0
20882;-1;1427;81;18;0;18;1.000;3600000;0
20883;-1;4961;75;40;4;36;.900;3869000;0
20883;68961;4961;0;0;0;0;.00nan;0;0
20883;143412;1429;0;0;0;0;.00nan;0;0
20883;148691;1429;69;30;3;27;.900;3869000;0
20884;9524;1422;46;24;4;20;.833;3670000;0
20884;165030;1453;97;46;3;43;.935;3670000;0
20884;45584;1453;0;0;0;0;.00nan;0;0
20884;66271;1422;0;0;0;0;.00nan;0;0
20885;4127;1440;0;0;0;0;.00nan;0;0
20885;174175;1425;0;0;0;0;.00nan;0;0
20885;32819;1425;48;9;2;7;.778;3600000;0
20885;185775;1440;83;46;4;42;.913;3600000;0
20886;195618;1430;99;44;1;43;.977;3600000;0
20886;-1;1426;0;0;0;0;.00nan;0;0
20886;56058;1426;49;30;5;25;.833;3600000;0
20886;157903;1430;0;0;0;0;.00nan;0;0
20887;4127;1440;34;18;4;14;.778;3537000;0
20887;185775;1440;0;0;0;0;.00nan;0;0
20887;-1;1426;0;0;0;0;.00nan;0;0
20887;56058;1426;88;33;2;31;.939;3600000;0
20888;17596;1443;73;19;1;18;.947;3600000;0
20888;181269;1443;0;0;0;0;.00nan;0;0
20888;143412;1429;65;40;5;35;.875;3600000;0
20888;148691;1429;0;0;0;0;.00nan;0;0
20889;9524;1422;0;0;0;0;.00nan;0;0
20889;-1;4961;0;0;0;0;.00nan;0;0
20889;66271;1422;84;38;2;36;.947;3600000;0
20889;68961;4961;44;32;5;27;.844;3600000;0
20890;165030;1453;67;41;4;37;.902;3900000;0
20890;174175;1425;0;0;0;0;.00nan;0;0
20890;32819;1425;66;37;4;33;.892;3900000;0
20890;45584;1453;0;0;0;0;.00nan;0;0
20891;5923;4742;30;21;4;17;.810;3900000;0
20891;195618;1430;0;0;0;0;.00nan;0;0
20891;36946;4742;0;0;0;0;.00nan;0;0
20891;157903;1430;64;36;4;32;.889;3900000;0
20892;11751;1427;0;0;0;0;.00nan;0;0
20892;-1;1427;66;25;2;23;.920;3600000;0
20892;143412;1429;0;0;0;0;.00nan;0;0
20892;148691;1429;39;26;4;22;.846;3538000;0
20893;-1;4961;12;17;6;11;.647;1395000;0
20893;174175;1425;66;30;4;26;.867;3600000;0
20893;32819;1425;0;0;0;0;.00nan;0;0
20893;68961;4961;58;23;2;21;.913;2205000;0
20894;4127;1440;33;5;2;3;.600;545000;0
20894;185775;1440;50;39;6;33;.846;3055000;0
20894;-1;1426;0;0;0;0;.00nan;0;0
20894;56058;1426;85;35;2;33;.943;3600000;0
20895;5923;4742;0;0;0;0;.00nan;0;0
20895;9524;1422;80;30;1;29;.967;3600000;0
20895;36946;4742;76;26;2;24;.923;3577000;0
20895;66271;1422;0;0;0;0;.00nan;0;0
20896;165030;1453;26;45;8;37;.822;3139000;0
20896;17596;1443;0;0;0;0;.00nan;0;0
20896;181269;1443;54;7;1;6;.857;3600000;0
20896;45584;1453;47;7;1;6;.857;461000;0
20897;165030;1453;40;31;6;25;.806;3600000;0
20897;185136;1426;0;0;0;0;.00nan;0;0
20897;45584;1453;0;0;0;0;.00nan;0;0
20897;56058;1426;60;25;3;22;.880;3600000;0
20898;11751;1427;58;23;2;21;.913;3600000;0
20898;-1;4961;55;38;5;33;.868;3600000;0
20898;-1;1427;0;0;0;0;.00nan;0;0
20898;68961;4961;0;0;0;0;.00nan;0;0
20899;5923;4742;57;23;3;20;.870;3600000;0
20899;36946;4742;0;0;0;0;.00nan;0;0
20899;143412;1429;68;42;5;37;.881;3534000;0
20899;148691;1429;0;0;0;0;.00nan;0;0
20900;4127;1440;0;0;0;0;.00nan;0;0
20900;17596;1443;77;20;2;18;.900;3900000;0
20900;181269;1443;0;0;0;0;.00nan;0;0
20900;185775;1440;97;65;2;63;.969;3900000;0
20901;11751;1427;45;4;1;3;.750;408000;0
20901;17596;1443;0;0;0;0;.00nan;0;0
20901;181269;1443;71;28;2;26;.929;3600000;0
20901;-1;1427;32;41;7;34;.829;3192000;0
20902;174175;1425;0;0;0;0;.00nan;0;0
20902;32819;1425;61;19;2;17;.895;3600000;0
20902;185136;1426;0;0;0;0;.00nan;0;0
20902;56058;1426;73;43;4;39;.907;3599000;0
20903;5923;4742;0;0;0;0;.00nan;0;0
20903;36946;4742;46;24;4;20;.833;3600000;0
20903;143412;1429;0;0;0;0;.00nan;0;0
20903;148691;1429;52;42;6;36;.857;3556000;0
20904;165030;1453;50;40;5;35;.875;3600000;0
20904;195618;1430;0;0;0;0;.00nan;0;0
20904;45584;1453;0;0;0;0;.00nan;0;0
20904;157903;1430;56;17;2;15;.882;3600000;0
20905;4127;1440;76;48;5;43;.896;3600000;0
20905;9524;1422;0;0;0;0;.00nan;0;0
20905;185775;1440;0;0;0;0;.00nan;0;0
20905;66271;1422;89;31;1;30;.968;3600000;0
20906;174175;1425;0;0;0;0;.00nan;0;0
20906;32819;1425;57;34;4;30;.882;3900000;0
20906;143412;1429;54;34;4;30;.882;3900000;0
20906;148691;1429;0;0;0;0;.00nan;0;0
20907;-1;4961;82;30;2;28;.933;3544000;0
20907;-1;1426;0;0;0;0;.00nan;0;0
20907;56058;1426;89;30;1;29;.967;3600000;0
20907;68961;4961;0;0;0;0;.00nan;0;0
20908;174175;1425;0;0;0;0;.00nan;0;0
20908;32819;1425;57;34;4;30;.882;3600000;0
20908;143412;1429;33;4;2;2;.500;804000;0
20908;148691;1429;30;31;6;25;.806;2796000;0
20909;4127;1440;52;41;5;36;.878;3600000;0
20909;195618;1430;0;0;0;0;.00nan;0;0
20909;185775;1440;0;0;0;0;.00nan;0;0
20909;157903;1430;54;18;2;16;.889;3600000;0
20910;9524;1422;0;0;0;0;.00nan;0;0
20910;11751;1427;33;30;6;24;.800;3600000;0
20910;-1;1427;0;0;0;0;.00nan;0;0
20910;66271;1422;58;19;2;17;.895;3600000;0
20911;5923;4742;25;12;4;8;.667;904000;0
20911;17596;1443;69;17;1;16;.941;3600000;0
20911;181269;1443;0;0;0;0;.00nan;0;0
20911;36946;4742;71;49;6;43;.878;2696000;0
20912;4127;1440;0;0;0;0;.00nan;0;0
20912;11751;1427;43;17;3;14;.824;3600000;0
20912;185775;1440;73;44;4;40;.909;3550000;0
20912;-1;1427;0;0;0;0;.00nan;0;0
20913;9524;1422;43;48;7;41;.854;3557000;0
20913;174175;1425;0;0;0;0;.00nan;0;0
20913;32819;1425;42;30;5;25;.833;3600000;0
20913;66271;1422;0;0;0;0;.00nan;0;0
20914;195618;1430;0;0;0;0;.00nan;0;0
20914;143412;1429;60;36;4;32;.889;3570000;0
20914;148691;1429;0;0;0;0;.00nan;0;0
20914;157903;1430;60;27;3;24;.889;3600000;0
20915;5923;4742;38;30;5;25;.833;3554000;0
20915;36946;4742;0;0;0;0;.00nan;0;0
20915;-1;1426;0;0;0;0;.00nan;0;0
20915;56058;1426;65;32;4;28;.875;3600000;0
20916;5923;4742;0;0;0;0;.00nan;0;0
20916;36946;4742;76;23;1;22;.957;3600000;0
20916;-1;1426;51;2;0;2;1.000;719000;0
20916;56058;1426;39;30;6;24;.800;2881000;0
20917;165030;1453;74;30;2;28;.933;3600000;0
20917;-1;4961;22;12;4;8;.667;1039000;0
20917;45584;1453;0;0;0;0;.00nan;0;0
20917;68961;4961;67;10;0;10;1.000;2500000;0
20918;4127;1440;36;41;7;34;.829;3188000;0
20918;11751;1427;0;0;0;0;.00nan;0;0
20918;185775;1440;46;12;2;10;.833;412000;0
20918;-1;1427;64;39;4;35;.897;3600000;0
20919;174175;1425;54;27;4;23;.852;3600000;0
20919;195618;1430;46;38;6;32;.842;2655000;0
20919;32819;1425;0;0;0;0;.00nan;0;0
20919;157903;1430;33;13;3;10;.769;945000;0
20920;17596;1443;90;15;0;15;1.000;3600000;0
20920;181269;1443;0;0;0;0;.00nan;0;0
20920;143412;1429;0;0;0;0;.00nan;0;0
20920;148691;1429;85;45;4;41;.911;3600000;0
20921;165030;1453;84;35;2;33;.943;3600000;0
20921;-1;4961;39;21;4;17;.810;3531000;0
20921;45584;1453;0;0;0;0;.00nan;0;0
20921;68961;4961;0;0;0;0;.00nan;0;0
20922;9524;1422;45;6;1;5;.833;471000;0
20922;17596;1443;63;17;2;15;.882;3600000;0
20922;181269;1443;0;0;0;0;.00nan;0;0
20922;66271;1422;37;45;8;37;.822;3129000;0
20923;11751;1427;72;37;3;34;.919;3900000;0
20923;-1;1426;0;0;0;0;.00nan;0;0
20923;-1;1427;0;0;0;0;.00nan;0;0
20923;56058;1426;83;46;3;43;.935;3900000;0
20924;9524;1422;0;0;0;0;.00nan;0;0
20924;66271;1422;40;28;5;23;.821;3600000;0
20924;143412;1429;81;29;2;27;.931;3600000;0
20924;148691;1429;0;0;0;0;.00nan;0;0
20925;4127;1440;0;0;0;0;.00nan;0;0
20925;165030;1453;68;26;3;23;.885;3900000;0
20925;185775;1440;78;43;3;40;.930;3900000;0
20925;45584;1453;0;0;0;0;.00nan;0;0
20926;17596;1443;46;18;3;15;.833;3600000;0
20926;195618;1430;0;0;0;0;.00nan;0;0
20926;181269;1443;0;0;0;0;.00nan;0;0
20926;157903;1430;49;36;5;31;.861;3576000;0
20927;5923;4742;31;24;5;19;.792;3600000;0
20927;-1;4961;36;42;7;35;.833;3592000;0
20927;36946;4742;0;0;0;0;.00nan;0;0
20927;68961;4961;0;0;0;0;.00nan;0;0
20928;11751;1427;0;0;0;0;.00nan;0;0
20928;-1;1426;0;0;0;0;.00nan;0;0
20928;-1;1427;65;29;3;26;.897;3600000;0
20928;56058;1426;46;28;5;23;.821;3553000;0
20929;9524;1422;61;30;3;27;.900;3600000;0
20929;66271;1422;0;0;0;0;.00nan;0;0
20929;143412;1429;0;0;0;0;.00nan;0;0
20929;148691;1429;45;30;5;25;.833;3568000;0
20930;174175;1425;0;0;0;0;.00nan;0;0
20930;195618;1430;0;0;0;0;.00nan;0;0
20930;32819;1425;43;27;4;23;.852;3561000;0
20930;157903;1430;73;33;3;30;.909;3600000;0
20931;5923;4742;41;30;5;25;.833;3743000;0
20931;-1;4961;82;50;4;46;.920;3743000;0
20931;36946;4742;0;0;0;0;.00nan;0;0
20931;68961;4961;0;0;0;0;.00nan;0;0
20932;4127;1440;0;0;0;0;.00nan;0;0
20932;165030;1453;65;45;6;39;.867;3600000;0
20932;185775;1440;76;36;3;33;.917;3600000;0
20932;45584;1453;0;0;0;0;.00nan;0;0
20933;165030;1453;45;39;6;33;.846;3600000;0
20933;45584;1453;0;0;0;0;.00nan;0;0
20933;143412;1429;53;28;4;24;.857;3600000;0
20933;148691;1429;0;0;0;0;.00nan;0;0
20934;9524;1422;69;25;2;23;.920;3600000;0
20934;-1;4961;26;32;7;25;.781;3064000;0
20934;66271;1422;0;0;0;0;.00nan;0;0
20934;68961;4961;49;7;1;6;.857;536000;0
20935;195618;1430;59;37;5;32;.865;3600000;0
20935;-1;1426;0;0;0;0;.00nan;0;0
20935;56058;1426;70;22;2;20;.909;3600000;0
20935;157903;1430;0;0;0;0;.00nan;0;0
20936;4127;1440;49;27;4;23;.852;2746000;0
20936;5923;4742;52;26;3;23;.885;3600000;0
20936;36946;4742;0;0;0;0;.00nan;0;0
20936;185775;1440;18;8;4;4;.500;854000;0
20937;17596;1443;63;13;1;12;.923;3600000;0
20937;174175;1425;0;0;0;0;.00nan;0;0
20937;32819;1425;84;51;4;47;.922;3600000;0
20937;181269;1443;0;0;0;0;.00nan;0;0
20938;5923;4742;43;12;2;10;.833;804000;0
20938;11751;1427;73;35;3;32;.914;3600000;0
20938;36946;4742;36;29;6;23;.793;2796000;0
20938;-1;1427;0;0;0;0;.00nan;0;0
20939;17596;1443;70;19;1;18;.947;3600000;0
20939;174175;1425;32;35;6;29;.829;2241000;0
20939;32819;1425;65;16;1;15;.938;1359000;0
20939;181269;1443;0;0;0;0;.00nan;0;0
20940;165030;1453;0;0;0;0;.00nan;0;0
20940;45584;1453;25;29;6;23;.793;3600000;0
20940;143412;1429;80;29;2;27;.931;3600000;0
20940;148691;1429;0;0;0;0;.00nan;0;0
20941;4127;1440;28;15;4;11;.733;1379000;0
20941;9524;1422;0;0;0;0;.00nan;0;0
20941;185775;1440;24;19;6;13;.684;2221000;0
20941;66271;1422;67;25;2;23;.920;3600000;0
20942;195618;1430;0;0;0;0;.00nan;0;0
20942;-1;1426;0;0;0;0;.00nan;0;0
20942;56058;1426;50;37;5;32;.865;3600000;0
20942;157903;1430;90;37;2;35;.946;3600000;0
20943;195618;1430;63;30;3;27;.900;3708000;0
20943;143412;1429;51;27;4;23;.852;3708000;0
20943;148691;1429;0;0;0;0;.00nan;0;0
20943;157903;1430;0;0;0;0;.00nan;0;0
20944;195618;1430;0;0;0;0;.00nan;0;0
20944;-1;1426;0;0;0;0;.00nan;0;0
20944;56058;1426;57;32;4;28;.875;3550000;0
20944;157903;1430;78;30;2;28;.933;3600000;0
20945;-1;4961;85;56;4;52;.929;3600000;0
20945;17596;1443;46;6;1;5;.833;3600000;0
20945;181269;1443;0;0;0;0;.00nan;0;0
20945;68961;4961;0;0;0;0;.00nan;0;0
20946;4127;1440;33;32;6;26;.813;3600000;0
20946;174175;1425;0;0;0;0;.00nan;0;0
20946;32819;1425;66;38;4;34;.895;3600000;0
20946;185775;1440;0;0;0;0;.00nan;0;0
20947;9524;1422;75;31;2;29;.935;3776000;0
20947;165030;1453;84;39;3;36;.923;3776000;0
20947;45584;1453;0;0;0;0;.00nan;0;0
20947;66271;1422;0;0;0;0;.00nan;0;0
20948;5923;4742;80;29;1;28;.966;3600000;0
20948;11751;1427;43;29;5;24;.828;3600000;0
20948;36946;4742;0;0;0;0;.00nan;0;0
20948;-1;1427;0;0;0;0;.00nan;0;0
20949;4127;1440;0;0;0;0;.00nan;0;0
20949;11751;1427;0;0;0;0;.00nan;0;0
20949;185775;1440;90;44;3;41;.932;3600000;0
20949;-1;1427;38;22;4;18;.818;3558000;0
20950;-1;4961;36;31;6;25;.806;3231000;0
20950;174175;1425;73;35;3;32;.914;3600000;0
20950;32819;1425;0;0;0;0;.00nan;0;0
20950;68961;4961;44;7;1;6;.857;369000;0
20951;-1;1426;0;0;0;0;.00nan;0;0
20951;56058;1426;76;42;4;38;.905;3664000;0
20951;143412;1429;62;27;3;24;.889;3664000;0
20951;148691;1429;0;0;0;0;.00nan;0;0
20952;5923;4742;0;0;0;0;.00nan;0;0
20952;165030;1453;43;31;4;27;.871;3548000;0
20952;36946;4742;73;36;3;33;.917;3600000;0
20952;45584;1453;0;0;0;0;.00nan;0;0
20953;9524;1422;0;0;0;0;.00nan;0;0
20953;17596;1443;0;0;0;0;.00nan;0;0
20953;181269;1443;95;26;0;26;1.000;3600000;0
20953;66271;1422;59;43;6;37;.860;3600000;0
20954;-1;1426;0;0;0;0;.00nan;0;0
20954;56058;1426;91;36;2;34;.944;3600000;0
20954;143412;1429;61;33;4;29;.879;3580000;0
20954;148691;1429;0;0;0;0;.00nan;0;0
20955;11751;1427;43;23;5;18;.783;3600000;0
20955;174175;1425;0;0;0;0;.00nan;0;0
20955;32819;1425;100;45;2;43;.956;3600000;0
20955;-1;1427;0;0;0;0;.00nan;0;0
20956;4127;1440;42;41;6;35;.854;3565000;0
20956;-1;4961;39;23;4;19;.826;3600000;0
20956;185775;1440;0;0;0;0;.00nan;0;0
20956;68961;4961;0;0;0;0;.00nan;0;0
20957;9524;1422;65;23;2;21;.913;3600000;0
20957;195618;1430;33;33;6;27;.818;2099000;0
20957;66271;1422;0;0;0;0;.00nan;0;0
20957;157903;1430;18;10;4;6;.600;1501000;0
20958;5923;4742;58;41;5;36;.878;3600000;0
20958;17596;1443;0;0;0;0;.00nan;0;0
20958;181269;1443;52;15;2;13;.867;3600000;0
20958;36946;4742;0;0;0;0;.00nan;0;0
20959;11751;1427;51;19;3;16;.842;3600000;0
20959;174175;1425;21;33;7;26;.788;2376000;0
20959;32819;1425;52;17;2;15;.882;1224000;0
20959;-1;1427;0;0;0;0;.00nan;0;0
20960;165030;1453;79;31;1;30;.968;3600000;0
20960;-1;1426;0;0;0;0;.00nan;0;0
20960;45584;1453;0;0;0;0;.00nan;0;0
20960;56058;1426;54;25;3;22;.880;3568000;0
20961;4127;1440;0;0;0;0;.00nan;0;0
20961;-1;4961;52;27;3;24;.889;3529000;0
20961;185775;1440;77;30;2;28;.933;3600000;0
20961;68961;4961;0;0;0;0;.00nan;0;0
20962;9524;1422;0;0;0;0;.00nan;0;0
20962;195618;1430;0;0;0;0;.00nan;0;0
20962;66271;1422;99;37;1;36;.973;3600000;0
20962;157903;1430;73;37;3;34;.919;3573000;0
20963;5923;4742;0;0;0;0;.00nan;0;0
20963;17596;1443;63;24;3;21;.875;3600000;0
20963;181269;1443;0;0;0;0;.00nan;0;0
20963;36946;4742;74;48;5;43;.896;3596000;0
20964;-1;4961;20;28;7;21;.750;2855000;0
20964;68961;4961;44;4;1;3;.750;745000;0
20964;143412;1429;0;0;0;0;.00nan;0;0
20964;148691;1429;62;24;2;22;.917;3600000;0
20965;165030;1453;54;26;3;23;.885;3600000;0
20965;-1;4961;0;0;0;0;.00nan;0;0
20965;45584;1453;0;0;0;0;.00nan;0;0
20965;68961;4961;58;37;5;32;.865;3600000;0
20966;9524;1422;39;30;5;25;.833;3635000;0
20966;174175;1425;0;0;0;0;.00nan;0;0
20966;32819;1425;57;32;4;28;.875;3635000;0
20966;66271;1422;0;0;0;0;.00nan;0;0
20967;5923;4742;23;6;3;3;.500;449000;0
20967;195618;1430;0;0;0;0;.00nan;0;0
20967;36946;4742;61;22;2;20;.909;3151000;0
20967;157903;1430;55;32;4;28;.875;3600000;0
20968;11751;1427;20;9;4;5;.556;945000;0
20968;17596;1443;79;24;1;23;.958;3600000;0
20968;181269;1443;0;0;0;0;.00nan;0;0
20968;-1;1427;61;34;4;30;.882;2655000;0
20969;11751;1427;79;40;3;37;.925;3600000;0
20969;17596;1443;76;27;2;25;.926;3600000;0
20969;181269;1443;0;0;0;0;.00nan;0;0
20969;-1;1427;0;0;0;0;.00nan;0;0
20970;195618;1430;48;24;3;21;.875;3600000;0
20970;-1;1426;0;0;0;0;.00nan;0;0
20970;56058;1426;65;38;4;34;.895;3600000;0
20970;157903;1430;0;0;0;0;.00nan;0;0
20971;5923;4742;63;30;4;26;.867;3600000;0
20971;174175;1425;100;30;0;30;1.000;3600000;0
20971;32819;1425;0;0;0;0;.00nan;0;0
20971;36946;4742;0;0;0;0;.00nan;0;0
20972;9524;1422;0;0;0;0;.00nan;0;0
20972;165030;1453;67;38;4;34;.895;3600000;0
20972;45584;1453;0;0;0;0;.00nan;0;0
20972;66271;1422;83;21;1;20;.952;3600000;0
20973;4127;1440;0;0;0;0;.00nan;0;0
20973;185775;1440;67;40;4;36;.900;3569000;0
20973;143412;1429;67;28;3;25;.893;3600000;0
20973;148691;1429;0;0;0;0;.00nan;0;0
20974;9524;1422;40;36;6;30;.833;3087000;0
20974;11751;1427;82;26;1;25;.962;3600000;0
20974;-1;1427;0;0;0;0;.00nan;0;0
20974;66271;1422;41;2;1;1;.500;513000;0
20975;17596;1443;49;19;3;16;.842;3600000;0
20975;181269;1443;0;0;0;0;.00nan;0;0
20975;-1;1426;48;38;6;32;.842;3113000;0
20975;56058;1426;60;7;0;7;1.000;487000;0
20976;4127;1440;0;0;0;0;.00nan;0;0
20976;185775;1440;93;29;1;28;.966;3600000;0
20976;143412;1429;61;34;3;31;.912;3569000;0
20976;148691;1429;0;0;0;0;.00nan;0;0
20977;-1;4961;62;28;4;24;.857;3600000;0
20977;195618;1430;0;0;0;0;.00nan;0;0
20977;68961;4961;0;0;0;0;.00nan;0;0
20977;157903;1430;34;35;6;29;.829;3576000;0
20978;5923;4742;0;0;0;0;.00nan;0;0
20978;165030;1453;69;26;2;24;.923;3600000;0
20978;36946;4742;63;22;3;19;.864;3546000;0
20978;45584;1453;0;0;0;0;.00nan;0;0
20979;174175;1425;98;27;0;27;1.000;3600000;0
20979;32819;1425;0;0;0;0;.00nan;0;0
20979;-1;1426;0;0;0;0;.00nan;0;0
20979;56058;1426;63;37;5;32;.865;3600000;0
20980;165030;1453;61;58;7;51;.879;3600000;0
20980;-1;4961;32;28;6;22;.786;3162000;0
20980;45584;1453;0;0;0;0;.00nan;0;0
20980;68961;4961;54;3;0;3;1.000;438000;0
20981;4127;1440;83;33;3;30;.909;3568000;0
20981;5923;4742;77;29;2;27;.931;3600000;0
20981;36946;4742;0;0;0;0;.00nan;0;0
20981;185775;1440;0;0;0;0;.00nan;0;0
20982;9524;1422;0;0;0;0;.00nan;0;0
20982;11751;1427;46;18;3;15;.833;3761000;0
20982;-1;1427;0;0;0;0;.00nan;0;0
20982;66271;1422;74;32;2;30;.938;3761000;0
20983;17596;1443;0;0;0;0;.00nan;0;0
20983;195618;1430;26;34;7;27;.794;2144000;0
20983;181269;1443;64;20;2;18;.900;3600000;0
20983;157903;1430;61;8;0;8;1.000;1456000;0
20984;11751;1427;50;27;4;23;.852;3733000;0
20984;195618;1430;0;0;0;0;.00nan;0;0
20984;-1;1427;0;0;0;0;.00nan;0;0
20984;157903;1430;75;45;5;40;.889;3733000;0
20985;-1;4961;41;33;6;27;.818;2896000;0
20985;-1;1426;0;0;0;0;.00nan;0;0
20985;56058;1426;44;18;3;15;.833;3600000;0
20985;68961;4961;48;8;1;7;.875;704000;0
20986;9524;1422;22;43;8;35;.814;3597000;0
20986;174175;1425;33;34;7;27;.794;3600000;0
20986;32819;1425;0;0;0;0;.00nan;0;0
20986;66271;1422;0;0;0;0;.00nan;0;0
20987;5923;4742;71;25;1;24;.960;3600000;0
20987;36946;4742;0;0;0;0;.00nan;0;0
20987;143412;1429;34;30;6;24;.800;3356000;0
20987;148691;1429;52;2;0;2;1.000;244000;0
20988;165030;1453;68;33;3;30;.909;3600000;0
20988;17596;1443;94;18;0;18;1.000;3600000;0
20988;181269;1443;0;0;0;0;.00nan;0;0
20988;45584;1453;0;0;0;0;.00nan;0;0
20989;17596;1443;31;14;4;10;.714;3600000;0
20989;181269;1443;0;0;0;0;.00nan;0;0
20989;143412;1429;98;39;1;38;.974;2612000;0
20989;148691;1429;28;13;4;9;.692;988000;0
20990;5923;4742;0;0;0;0;.00nan;0;0
20990;-1;4961;28;37;7;30;.811;3600000;0
20990;36946;4742;58;27;4;23;.852;3600000;0
20990;68961;4961;0;0;0;0;.00nan;0;0
20991;11751;1427;56;32;4;28;.875;3564000;0
20991;165030;1453;71;25;3;22;.880;3600000;0
20991;45584;1453;0;0;0;0;.00nan;0;0
20991;-1;1427;0;0;0;0;.00nan;0;0
20992;4127;1440;54;7;0;7;1.000;1304000;0
20992;174175;1425;0;0;0;0;.00nan;0;0
20992;32819;1425;89;20;0;20;1.000;3600000;0
20992;185775;1440;57;37;5;32;.865;2296000;0
20993;9524;1422;0;0;0;0;.00nan;0;0
20993;-1;1426;0;0;0;0;.00nan;0;0
20993;56058;1426;100;42;2;40;.952;3900000;0
20993;66271;1422;82;35;2;33;.943;3900000;0
20994;9524;1422;0;0;0;0;.00nan;0;0
20994;174175;1425;0;0;0;0;.00nan;0;0
20994;32819;1425;60;27;3;24;.889;3600000;0
20994;66271;1422;60;30;4;26;.867;3564000;0
20995;11751;1427;48;25;4;21;.840;3600000;0
20995;-1;1426;0;0;0;0;.00nan;0;0
20995;-1;1427;0;0;0;0;.00nan;0;0
20995;56058;1426;72;32;3;29;.906;3600000;0
20996;165030;1453;82;46;3;43;.935;3900000;0
20996;45584;1453;0;0;0;0;.00nan;0;0
20996;143412;1429;82;30;3;27;.900;3900000;0
20996;148691;1429;0;0;0;0;.00nan;0;0
20997;4127;1440;56;47;6;41;.872;3600000;0
20997;17596;1443;49;16;3;13;.813;3600000;0
20997;181269;1443;0;0;0;0;.00nan;0;0
20997;185775;1440;0;0;0;0;.00nan;0;0
20998;-1;4961;57;48;6;42;.875;3600000;0
20998;195618;1430;0;0;0;0;.00nan;0;0
20998;68961;4961;0;0;0;0;.00nan;0;0
20998;157903;1430;64;21;2;19;.905;3600000;0
20999;5923;4742;69;26;3;23;.885;3600000;0
20999;174175;1425;0;0;0;0;.00nan;0;0
20999;32819;1425;43;34;5;29;.853;3600000;0
20999;36946;4742;0;0;0;0;.00nan;0;0
21000;11751;1427;0;0;0;0;.00nan;0;0
21000;174175;1425;34;27;5;22;.815;3527000;0
21000;32819;1425;0;0;0;0;.00nan;0;0
21000;-1;1427;68;28;3;25;.893;3600000;0
21001;165030;1453;46;33;5;28;.848;3586000;0
21001;45584;1453;0;0;0;0;.00nan;0;0
21001;143412;1429;0;0;0;0;.00nan;0;0
21001;148691;1429;66;35;4;31;.886;3600000;0
21002;4127;1440;0;0;0;0;.00nan;0;0
21002;9524;1422;53;24;3;21;.875;3600000;0
21002;185775;1440;36;35;7;28;.800;3600000;0
21002;66271;1422;0;0;0;0;.00nan;0;0
21003;-1;4961;86;43;3;40;.930;3600000;0
21003;195618;1430;100;22;0;22;1.000;3600000;0
21003;68961;4961;0;0;0;0;.00nan;0;0
21003;157903;1430;0;0;0;0;.00nan;0;0
21004;17596;1443;0;0;0;0;.00nan;0;0
21004;181269;1443;56;20;2;18;.900;3600000;0
21004;-1;1426;0;0;0;0;.00nan;0;0
21004;56058;1426;58;41;5;36;.878;3600000;0
21005;-1;1426;0;0;0;0;.00nan;0;0
21005;56058;1426;75;19;1;18;.947;3600000;0
21005;143412;1429;50;30;4;26;.867;3600000;0
21005;148691;1429;0;0;0;0;.00nan;0;0
21006;-1;4961;38;23;4;19;.826;3559000;0
21006;174175;1425;0;0;0;0;.00nan;0;0
21006;32819;1425;62;28;3;25;.893;3600000;0
21006;68961;4961;0;0;0;0;.00nan;0;0
21007;9524;1422;59;25;3;22;.880;3535000;0
21007;165030;1453;100;47;1;46;.979;3600000;0
21007;45584;1453;0;0;0;0;.00nan;0;0
21007;66271;1422;0;0;0;0;.00nan;0;0
21008;4127;1440;84;55;4;51;.927;3600000;0
21008;195618;1430;76;18;1;17;.944;3600000;0
21008;185775;1440;0;0;0;0;.00nan;0;0
21008;157903;1430;0;0;0;0;.00nan;0;0
21009;5923;4742;58;36;4;32;.889;3600000;0
21009;17596;1443;98;20;0;20;1.000;3600000;0
21009;181269;1443;0;0;0;0;.00nan;0;0
21009;36946;4742;0;0;0;0;.00nan;0;0
21010;5923;4742;60;18;2;16;.889;869000;0
21010;11751;1427;55;16;2;14;.875;3600000;0
21010;36946;4742;24;29;6;23;.793;2731000;0
21010;-1;1427;0;0;0;0;.00nan;0;0
21011;174175;1425;47;26;4;22;.846;3600000;0
21011;195618;1430;0;0;0;0;.00nan;0;0
21011;32819;1425;0;0;0;0;.00nan;0;0
21011;157903;1430;100;29;0;29;1.000;3600000;0
21012;4127;1440;68;21;1;20;.952;2143000;0
21012;185775;1440;19;24;6;18;.750;1457000;0
21012;143412;1429;0;0;0;0;.00nan;0;0
21012;148691;1429;85;23;1;22;.957;3600000;0
21013;165030;1453;71;45;5;40;.889;3513000;0
21013;-1;1426;0;0;0;0;.00nan;0;0
21013;45584;1453;0;0;0;0;.00nan;0;0
21013;56058;1426;57;28;3;25;.893;3600000;0
21014;-1;4961;79;59;6;53;.898;3293000;0
21014;17596;1443;98;19;0;19;1.000;3600000;0
21014;181269;1443;0;0;0;0;.00nan;0;0
21014;68961;4961;40;2;1;1;.500;307000;0
21015;9524;1422;0;0;0;0;.00nan;0;0
21015;-1;1426;0;0;0;0;.00nan;0;0
21015;56058;1426;72;25;3;22;.880;3900000;0
21015;66271;1422;73;36;3;33;.917;3900000;0
21016;4127;1440;80;34;2;32;.941;3600000;0
21016;174175;1425;0;0;0;0;.00nan;0;0
21016;32819;1425;60;28;3;25;.893;3600000;0
21016;185775;1440;0;0;0;0;.00nan;0;0
21017;-1;4961;0;0;0;0;.00nan;0;0
21017;17596;1443;90;17;0;17;1.000;3600000;0
21017;181269;1443;0;0;0;0;.00nan;0;0
21017;68961;4961;63;42;5;37;.881;3600000;0
21018;195618;1430;0;0;0;0;.00nan;0;0
21018;143412;1429;47;29;4;25;.862;3600000;0
21018;148691;1429;0;0;0;0;.00nan;0;0
21018;157903;1430;41;32;5;27;.844;3572000;0
21019;5923;4742;55;42;5;37;.881;3521000;0
21019;11751;1427;67;31;3;28;.903;3600000;0
21019;36946;4742;0;0;0;0;.00nan;0;0
21019;-1;1427;0;0;0;0;.00nan;0;0
21020;11751;1427;58;21;4;17;.810;3600000;0
21020;-1;1426;0;0;0;0;.00nan;0;0
21020;-1;1427;0;0;0;0;.00nan;0;0
21020;56058;1426;89;37;3;34;.919;3600000;0
21021;5923;4742;0;0;0;0;.00nan;0;0
21021;36946;4742;40;35;6;29;.829;3600000;0
21021;143412;1429;0;0;0;0;.00nan;0;0
21021;148691;1429;87;35;2;33;.943;3600000;0
21022;165030;1453;54;28;4;24;.857;3615000;0
21022;174175;1425;73;30;3;27;.900;3615000;0
21022;32819;1425;0;0;0;0;.00nan;0;0
21022;45584;1453;0;0;0;0;.00nan;0;0
21023;4127;1440;0;0;0;0;.00nan;0;0
21023;195618;1430;60;21;2;19;.905;3600000;0
21023;185775;1440;83;51;4;47;.922;3526000;0
21023;157903;1430;0;0;0;0;.00nan;0;0
21024;9524;1422;40;35;6;29;.829;2503000;0
21024;17596;1443;66;20;1;19;.950;3600000;0
21024;181269;1443;0;0;0;0;.00nan;0;0
21024;66271;1422;49;20;3;17;.850;1097000;0
21025;174175;1425;0;0;0;0;.00nan;0;0
21025;32819;1425;68;37;4;33;.892;3561000;0
21025;143412;1429;66;26;3;23;.885;3600000;0
21025;148691;1429;0;0;0;0;.00nan;0;0
21026;11751;1427;63;36;4;32;.889;3612000;0
21026;-1;4961;61;39;5;34;.872;3612000;0
21026;-1;1427;0;0;0;0;.00nan;0;0
21026;68961;4961;0;0;0;0;.00nan;0;0
21027;165030;1453;72;51;5;46;.902;3600000;0
21027;195618;1430;100;19;0;19;1.000;3600000;0
21027;45584;1453;0;0;0;0;.00nan;0;0
21027;157903;1430;0;0;0;0;.00nan;0;0
21028;5923;4742;88;35;2;33;.943;3800000;0
21028;36946;4742;0;0;0;0;.00nan;0;0
21028;-1;1426;0;0;0;0;.00nan;0;0
21028;56058;1426;83;38;3;35;.921;3803000;0
21029;4127;1440;0;0;0;0;.00nan;0;0
21029;17596;1443;58;20;2;18;.900;3600000;0
21029;181269;1443;0;0;0;0;.00nan;0;0
21029;185775;1440;91;50;3;47;.940;3600000;0
21030;11751;1427;0;0;0;0;.00nan;0;0
21030;-1;4961;57;42;6;36;.857;3600000;0
21030;-1;1427;70;22;2;20;.909;3600000;0
21030;68961;4961;0;0;0;0;.00nan;0;0
21031;174175;1425;16;21;6;15;.714;1416000;0
21031;32819;1425;51;16;3;13;.813;2164000;0
21031;143412;1429;0;0;0;0;.00nan;0;0
21031;148691;1429;37;35;6;29;.829;3600000;0
21032;165030;1453;63;36;4;32;.889;3600000;0
21032;195618;1430;0;0;0;0;.00nan;0;0
21032;45584;1453;0;0;0;0;.00nan;0;0
21032;157903;1430;77;30;2;28;.933;3600000;0
21033;4127;1440;53;39;5;34;.872;3600000;0
21033;185775;1440;0;0;0;0;.00nan;0;0
21033;-1;1426;0;0;0;0;.00nan;0;0
21033;56058;1426;91;33;2;31;.939;3600000;0
21034;9524;1422;0;0;0;0;.00nan;0;0
21034;17596;1443;83;32;2;30;.938;3600000;0
21034;181269;1443;0;0;0;0;.00nan;0;0
21034;66271;1422;42;47;8;39;.830;3600000;0
21035;4127;1440;74;52;5;47;.904;3600000;0
21035;11751;1427;25;28;6;22;.786;3546000;0
21035;185775;1440;0;0;0;0;.00nan;0;0
21035;-1;1427;0;0;0;0;.00nan;0;0
21036;174175;1425;0;0;0;0;.00nan;0;0
21036;32819;1425;55;37;5;32;.865;3600000;0
21036;-1;1426;46;7;1;6;.857;448000;0
21036;56058;1426;29;28;6;22;.786;3065000;0
21037;-1;4961;62;32;5;27;.844;3900000;0
21037;68961;4961;0;0;0;0;.00nan;0;0
21037;143412;1429;0;0;0;0;.00nan;0;0
21037;148691;1429;48;35;5;30;.857;3900000;0
21038;165030;1453;28;35;7;28;.800;3600000;0
21038;17596;1443;58;10;1;9;.900;3600000;0
21038;181269;1443;0;0;0;0;.00nan;0;0
21038;45584;1453;0;0;0;0;.00nan;0;0
21039;11751;1427;74;28;3;25;.893;3620000;0
21039;195618;1430;0;0;0;0;.00nan;0;0
21039;-1;1427;0;0;0;0;.00nan;0;0
21039;157903;1430;86;33;2;31;.939;3620000;0
21040;5923;4742;47;17;3;14;.824;3568000;0
21040;9524;1422;70;28;2;26;.929;3600000;0
21040;36946;4742;0;0;0;0;.00nan;0;0
21040;66271;1422;0;0;0;0;.00nan;0;0
21041;5923;4742;0;0;0;0;.00nan;0;0
21041;174175;1425;44;19;3;16;.842;3600000;0
21041;32819;1425;0;0;0;0;.00nan;0;0
21041;36946;4742;74;25;1;24;.960;3600000;0
21042;11751;1427;51;28;4;24;.857;3600000;0
21042;-1;1427;0;0;0;0;.00nan;0;0
21042;143412;1429;97;26;1;25;.962;3600000;0
21042;148691;1429;0;0;0;0;.00nan;0;0
21043;4127;1440;79;45;4;41;.911;3600000;0
21043;165030;1453;100;36;0;36;1.000;3600000;0
21043;185775;1440;0;0;0;0;.00nan;0;0
21043;45584;1453;0;0;0;0;.00nan;0;0
21044;9524;1422;0;0;0;0;.00nan;0;0
21044;-1;4961;82;45;3;42;.933;3707000;0
21044;66271;1422;74;25;2;23;.920;3707000;0
21044;68961;4961;0;0;0;0;.00nan;0;0
21045;17596;1443;64;16;2;14;.875;3600000;0
21045;195618;1430;27;33;7;26;.788;3243000;0
21045;181269;1443;0;0;0;0;.00nan;0;0
21045;157903;1430;46;4;1;3;.750;357000;0
21046;5923;4742;61;43;5;38;.884;3900000;0
21046;36946;4742;0;0;0;0;.00nan;0;0
21046;-1;1426;0;0;0;0;.00nan;0;0
21046;56058;1426;60;43;5;38;.884;3900000;0
21047;165030;1453;47;22;3;19;.864;3600000;0
21047;174175;1425;0;0;0;0;.00nan;0;0
21047;32819;1425;75;30;2;28;.933;3600000;0
21047;45584;1453;0;0;0;0;.00nan;0;0
21048;4127;1440;40;36;6;30;.833;3181000;0
21048;11751;1427;65;20;1;19;.950;3600000;0
21048;185775;1440;48;6;1;5;.833;419000;0
21048;-1;1427;0;0;0;0;.00nan;0;0
21049;9524;1422;54;16;2;14;.875;3600000;0
21049;66271;1422;0;0;0;0;.00nan;0;0
21049;143412;1429;0;0;0;0;.00nan;0;0
21049;148691;1429;65;35;4;31;.886;3534000;0
21050;17596;1443;70;17;1;16;.941;3600000;0
21050;195618;1430;0;0;0;0;.00nan;0;0
21050;181269;1443;0;0;0;0;.00nan;0;0
21050;157903;1430;18;42;8;34;.810;3600000;0
21051;5923;4742;0;0;0;0;.00nan;0;0
21051;-1;4961;54;33;5;28;.848;3545000;0
21051;36946;4742;57;21;3;18;.857;3600000;0
21051;68961;4961;0;0;0;0;.00nan;0;0
21052;11751;1427;0;0;0;0;.00nan;0;0
21052;195618;1430;37;29;5;24;.828;2387000;0
21052;-1;1427;77;29;2;27;.931;3600000;0
21052;157903;1430;53;12;1;11;.917;1213000;0
21053;9524;1422;0;0;0;0;.00nan;0;0
21053;66271;1422;88;43;3;40;.930;3900000;0
21053;143412;1429;79;41;3;38;.927;3900000;0
21053;148691;1429;0;0;0;0;.00nan;0;0
21054;-1;4961;68;25;2;23;.920;3600000;0
21054;-1;1426;0;0;0;0;.00nan;0;0
21054;56058;1426;54;30;5;25;.833;3600000;0
21054;68961;4961;0;0;0;0;.00nan;0;0
21055;4127;1440;0;0;0;0;.00nan;0;0
21055;165030;1453;45;31;5;26;.839;3600000;0
21055;185775;1440;100;48;2;46;.958;3600000;0
21055;45584;1453;0;0;0;0;.00nan;0;0
21056;17596;1443;0;0;0;0;.00nan;0;0
21056;174175;1425;67;47;6;41;.872;2980000;0
21056;32819;1425;44;4;1;3;.750;620000;0
21056;181269;1443;51;13;2;11;.846;3600000;0
21057;195618;1430;0;0;0;0;.00nan;0;0
21057;143412;1429;0;0;0;0;.00nan;0;0
21057;148691;1429;80;30;1;29;.967;3600000;0
21057;157903;1430;44;26;4;22;.846;3600000;0
21058;11751;1427;36;14;3;11;.786;3600000;0
21058;165030;1453;56;38;5;33;.868;3600000;0
21058;45584;1453;0;0;0;0;.00nan;0;0
21058;-1;1427;0;0;0;0;.00nan;0;0
21059;17596;1443;65;24;3;21;.875;3600000;0
21059;181269;1443;0;0;0;0;.00nan;0;0
21059;-1;1426;53;10;1;9;.900;307000;0
21059;56058;1426;44;41;7;34;.829;3293000;0
21060;9524;1422;0;0;0;0;.00nan;0;0
21060;-1;4961;83;53;4;49;.925;3600000;0
21060;66271;1422;79;25;1;24;.960;3600000;0
21060;68961;4961;0;0;0;0;.00nan;0;0
21061;174175;1425;0;0;0;0;.00nan;0;0
21061;195618;1430;43;37;6;31;.838;3587000;0
21061;32819;1425;39;25;5;20;.800;3600000;0
21061;157903;1430;0;0;0;0;.00nan;0;0
21062;4127;1440;0;0;0;0;.00nan;0;0
21062;5923;4742;71;17;1;16;.941;3600000;0
21062;36946;4742;0;0;0;0;.00nan;0;0
21062;185775;1440;68;41;5;36;.878;3600000;0
21063;174175;1425;85;48;2;46;.958;3600000;0
21063;32819;1425;0;0;0;0;.00nan;0;0
21063;143412;1429;0;0;0;0;.00nan;0;0
21063;148691;1429;55;31;4;27;.871;3561000;0
21064;5923;4742;39;28;5;23;.821;3600000;0
21064;165030;1453;0;0;0;0;.00nan;0;0
21064;36946;4742;0;0;0;0;.00nan;0;0
21064;45584;1453;31;34;6;28;.824;3571000;0
21065;4127;1440;28;38;7;31;.816;3206000;0
21065;-1;4961;13;18;6;12;.667;3600000;0
21065;185775;1440;45;5;1;4;.800;385000;0
21065;68961;4961;0;0;0;0;.00nan;0;0
21066;9524;1422;49;42;5;37;.881;3600000;0
21066;11751;1427;70;24;2;22;.917;3600000;0
21066;-1;1427;0;0;0;0;.00nan;0;0
21066;66271;1422;0;0;0;0;.00nan;0;0
21067;17596;1443;58;15;1;14;.933;3600000;0
21067;181269;1443;0;0;0;0;.00nan;0;0
21067;-1;1426;0;0;0;0;.00nan;0;0
21067;56058;1426;72;59;7;52;.881;3600000;0
21069;-1;4961;4;18;7;11;.611;2264000;0
21069;-1;1426;0;0;0;0;.00nan;0;0
21069;56058;1426;67;36;4;32;.889;3600000;0
21069;68961;4961;52;8;1;7;.875;1336000;0
21071;5923;4742;23;23;6;17;.739;2013000;0
21071;17596;1443;0;0;0;0;.00nan;0;0
21071;181269;1443;64;27;3;24;.889;3600000;0
21071;36946;4742;70;20;1;19;.950;1587000;0
21073;165030;1453;73;44;4;40;.909;3560000;0
21073;32819;1430;62;19;2;17;.895;3600000;0
21073;45584;1453;0;0;0;0;.00nan;0;0
21073;157903;1430;0;0;0;0;.00nan;0;0
21075;9524;1422;0;0;0;0;.00nan;0;0
21075;11751;1427;66;28;2;26;.929;3600000;0
21075;-1;1427;0;0;0;0;.00nan;0;0
21075;66271;1422;77;40;4;36;.900;3541000;0
21077;4127;1440;0;0;0;0;.00nan;0;0
21077;185775;1440;81;36;3;33;.917;3543000;0
21077;143412;1429;0;0;0;0;.00nan;0;0
21077;148691;1429;60;23;2;21;.913;3600000;0
21079;11751;1427;40;34;6;28;.824;3324000;0
21079;32819;1430;77;25;1;24;.960;3600000;0
21079;-1;1427;39;1;1;0;.000;276000;0
21079;157903;1430;0;0;0;0;.00nan;0;0
21081;165030;1453;72;26;2;24;.923;3600000;0
21081;-1;1426;0;0;0;0;.00nan;0;0
21081;45584;1453;0;0;0;0;.00nan;0;0
21081;56058;1426;64;38;5;33;.868;3587000;0
21083;4127;1440;0;0;0;0;.00nan;0;0
21083;9524;1422;0;0;0;0;.00nan;0;0
21083;185775;1440;80;65;6;59;.908;3600000;0
21083;66271;1422;89;32;2;30;.938;3600000;0
21085;1765;1425;0;0;0;0;.00nan;0;0
21085;3517;1425;59;39;5;34;.872;3600000;0
21085;17596;1443;0;0;0;0;.00nan;0;0
21085;181269;1443;73;20;1;19;.950;3600000;0
21087;5923;4742;70;27;2;25;.926;3600000;0
21087;-1;4961;59;34;5;29;.853;3600000;0
21087;36946;4742;0;0;0;0;.00nan;0;0
21087;68961;4961;0;0;0;0;.00nan;0;0
21089;9524;1422;77;31;3;28;.903;3600000;0
21089;66271;1422;0;0;0;0;.00nan;0;0
21089;143412;1429;84;35;2;33;.943;3600000;0
21089;148691;1429;0;0;0;0;.00nan;0;0
21091;5923;4742;0;0;0;0;.00nan;0;0
21091;165030;1453;0;0;0;0;.00nan;0;0
21091;36946;4742;98;28;0;28;1.000;3600000;0
21091;45584;1453;44;26;4;22;.846;3600000;0
21093;17596;1443;62;14;1;13;.929;3600000;0
21093;32819;1430;90;68;6;62;.912;3600000;0
21093;181269;1443;0;0;0;0;.00nan;0;0
21093;157903;1430;0;0;0;0;.00nan;0;0
21095;4127;1440;32;23;5;18;.783;2310000;0
21095;11751;1427;0;0;0;0;.00nan;0;0
21095;185775;1440;45;17;3;14;.824;1290000;0
21095;-1;1427;49;27;4;23;.852;3600000;0
21097;1765;1425;52;26;4;22;.846;3600000;0
21097;3517;1425;0;0;0;0;.00nan;0;0
21097;-1;4961;65;48;7;41;.854;3600000;0
21097;68961;4961;0;0;0;0;.00nan;0;0
21099;1765;1425;58;6;0;6;1.000;581000;0
21099;3517;1425;15;28;7;21;.750;3013000;0
21099;32819;1430;52;36;5;31;.861;3600000;0
21099;157903;1430;0;0;0;0;.00nan;0;0
21101;5923;4742;0;0;0;0;.00nan;0;0
21101;-1;4961;62;22;2;20;.909;3600000;0
21101;36946;4742;61;29;4;25;.862;3556000;0
21101;68961;4961;0;0;0;0;.00nan;0;0
21103;4127;1440;0;0;0;0;.00nan;0;0
21103;11751;1427;79;14;0;14;1.000;3600000;0
21103;185775;1440;83;36;3;33;.917;3600000;0
21103;-1;1427;0;0;0;0;.00nan;0;0
21105;165030;1453;78;32;2;30;.938;3600000;0
21105;-1;1426;0;0;0;0;.00nan;0;0
21105;45584;1453;0;0;0;0;.00nan;0;0
21105;56058;1426;36;20;4;16;.800;3587000;0
21107;9524;1422;0;0;0;0;.00nan;0;0
21107;66271;1422;66;20;1;19;.950;3600000;0
21107;143412;1429;0;0;0;0;.00nan;0;0
21107;148691;1429;75;35;3;32;.914;3538000;0
21109;1765;1425;89;51;3;48;.941;3600000;0
21109;3517;1425;0;0;0;0;.00nan;0;0
21109;17596;1443;89;14;0;14;1.000;3600000;0
21109;181269;1443;0;0;0;0;.00nan;0;0
21111;165030;1453;40;27;4;23;.852;3600000;0
21111;-1;1426;68;19;1;18;.947;3600000;0
21111;45584;1453;0;0;0;0;.00nan;0;0
21111;56058;1426;0;0;0;0;.00nan;0;0
21113;9524;1422;98;47;3;44;.936;3600000;0
21113;66271;1422;0;0;0;0;.00nan;0;0
21113;143412;1429;30;26;6;20;.769;3600000;0
21113;148691;1429;0;0;0;0;.00nan;0;0
21115;4127;1440;57;42;6;36;.857;3341000;0
21115;-1;4961;55;20;3;17;.850;3600000;0
21115;185775;1440;53;4;0;4;1.000;259000;0
21115;68961;4961;0;0;0;0;.00nan;0;0
21117;5923;4742;37;44;7;37;.841;3556000;0
21117;32819;1430;65;8;0;8;1.000;826000;0
21117;36946;4742;0;0;0;0;.00nan;0;0
21117;157903;1430;8;14;6;8;.571;2774000;0
21119;-1;4961;23;4;3;1;.250;198000;0
21119;17596;1443;83;11;0;11;1.000;3600000;0
21119;181269;1443;0;0;0;0;.00nan;0;0
21119;68961;4961;90;72;7;65;.903;3402000;0
21121;1765;1425;0;0;0;0;.00nan;0;0
21121;3517;1425;49;32;5;27;.844;3545000;0
21121;-1;1426;0;0;0;0;.00nan;0;0
21121;56058;1426;84;40;4;36;.900;3600000;0
21123;9524;1422;0;0;0;0;.00nan;0;0
21123;165030;1453;37;35;6;29;.829;3600000;0
21123;45584;1453;0;0;0;0;.00nan;0;0
21123;66271;1422;100;30;0;30;1.000;3600000;0
21125;5923;4742;81;41;2;39;.951;3600000;0
21125;32819;1430;63;27;3;24;.889;3552000;0
21125;36946;4742;0;0;0;0;.00nan;0;0
21125;157903;1430;0;0;0;0;.00nan;0;0
21127;11751;1427;74;28;2;26;.929;3600000;0
21127;-1;1427;0;0;0;0;.00nan;0;0
21127;143412;1429;53;26;3;23;.885;3545000;0
21127;148691;1429;0;0;0;0;.00nan;0;0
21129;1765;1425;49;22;3;19;.864;3600000;0
21129;3517;1425;0;0;0;0;.00nan;0;0
21129;143412;1429;0;0;0;0;.00nan;0;0
21129;148691;1429;66;37;4;33;.892;3579000;0
21131;5923;4742;68;14;1;13;.929;1353000;0
21131;165030;1453;0;0;0;0;.00nan;0;0
21131;36946;4742;44;21;4;17;.810;2247000;0
21131;45584;1453;29;31;6;25;.806;3576000;0
21133;4127;1440;47;6;1;5;.833;405000;0
21133;17596;1443;69;15;2;13;.867;3600000;0
21133;181269;1443;0;0;0;0;.00nan;0;0
21133;185775;1440;66;58;6;52;.897;3195000;0
21135;9524;1422;88;46;3;43;.935;3544000;0
21135;32819;1430;68;25;2;23;.920;3600000;0
21135;66271;1422;0;0;0;0;.00nan;0;0
21135;157903;1430;0;0;0;0;.00nan;0;0
21137;11751;1427;0;0;0;0;.00nan;0;0
21137;-1;1426;44;34;4;30;.882;3548000;0
21137;-1;1427;68;31;2;29;.935;3600000;0
21137;56058;1426;0;0;0;0;.00nan;0;0
1553;17596;1443;0;0;0;0;.00nan;0;0
1553;181269;1443;99;23;0;23;1.000;3600000;0
1553;-1;1426;0;0;0;0;.00nan;0;0
1553;56058;1426;82;38;2;36;.947;3575000;0
1554;5923;4742;60;19;2;17;.895;3600000;0
1554;174175;1425;51;9;1;8;.889;749000;0
1554;32819;1425;26;28;6;22;.786;2851000;0
1554;36946;4742;0;0;0;0;.00nan;0;0
1555;9524;1422;0;0;0;0;.00nan;0;0
1555;66271;1422;50;29;4;25;.862;3574000;0
1555;143412;1429;0;0;0;0;.00nan;0;0
1555;148691;1429;99;49;2;47;.959;3600000;0
1556;11751;1427;93;23;0;23;1.000;3600000;0
1556;195618;1430;0;0;0;0;.00nan;0;0
1556;-1;1427;0;0;0;0;.00nan;0;0
1556;157903;1430;72;22;1;21;.955;3600000;0
1623;5923;4742;66;45;6;39;.867;3600000;0
1623;17596;1443;43;13;2;11;.846;3600000;0
1623;181269;1443;0;0;0;0;.00nan;0;0
1623;36946;4742;0;0;0;0;.00nan;0;0
1624;11751;1427;59;23;3;20;.870;3600000;0
1624;-1;1427;0;0;0;0;.00nan;0;0
1624;143412;1429;41;14;3;11;.786;525000;0
1624;148691;1429;78;37;3;34;.919;3075000;0
1650;11751;1427;88;37;3;34;.919;3576000;0
1650;17596;1443;50;12;2;10;.833;3600000;0
1650;181269;1443;0;0;0;0;.00nan;0;0
1650;-1;1427;0;0;0;0;.00nan;0;0
