Game Id;PlayerId;TeamId;Game Rating;SA;GA;SV;SV%;TOI;PIM
0;1669;33;0;0;0;0;.00nan;0;0
0;20432;31;54;28;3;25;.893;4200000;0
0;86360;31;0;0;0;0;.00nan;0;0
0;149452;33;77;42;3;39;.929;4200000;0
1;20693;24;0;0;0;0;.00nan;0;0
1;174718;25;0;0;0;0;.00nan;0;0
1;57338;24;30;22;5;17;.773;3587000;0
1;148958;25;68;35;3;32;.914;3600000;0
2;9235;4838;0;0;0;0;.00nan;0;0
2;169868;4182;0;0;0;0;.00nan;0;0
2;143749;4838;77;44;3;41;.932;3577000;0
2;147945;4182;66;23;2;21;.913;3600000;0
3;556;3;83;52;4;48;.923;3600000;0
3;615;3;0;0;0;0;.00nan;0;0
3;57859;15;12;23;7;16;.696;2649000;0
3;85727;15;41;2;1;1;.500;951000;0
4;8424;28;0;0;0;0;.00nan;0;0
4;144705;17;0;0;0;0;.00nan;0;0
4;146862;17;91;31;1;30;.968;3600000;0
4;152835;28;69;28;2;26;.929;3553000;0
5;163695;9;0;0;0;0;.00nan;0;0
5;174718;25;77;26;1;25;.962;3600000;0
5;175092;9;81;32;2;30;.938;3600000;0
5;148958;25;0;0;0;0;.00nan;0;0
6;19391;32;0;0;0;0;.00nan;0;0
6;176995;30;0;0;0;0;.00nan;0;0
6;36674;30;74;30;2;28;.933;3600000;0
6;58830;32;95;41;3;38;.927;3590000;0
7;5311;8;0;0;0;0;.00nan;0;0
7;13714;8;62;45;5;40;.889;3553000;0
7;166381;27;0;0;0;0;.00nan;0;0
7;175660;27;58;33;4;29;.879;3600000;0
8;2059;23;68;35;4;31;.886;3600000;0
8;167642;18;0;0;0;0;.00nan;0;0
8;55802;18;85;27;1;26;.963;3600000;0
8;65762;23;0;0;0;0;.00nan;0;0
9;46492;0;75;35;3;32;.914;3600000;0
9;86192;21;58;38;5;33;.868;3557000;0
9;91178;0;0;0;0;0;.00nan;0;0
9;143156;21;0;0;0;0;.00nan;0;0
10;676;34;89;43;4;39;.907;3600000;0
10;168712;14;100;23;0;23;1.000;3600000;0
10;59540;14;0;0;0;0;.00nan;0;0
10;78806;34;0;0;0;0;.00nan;0;0
11;166751;5;0;0;0;0;.00nan;0;0
11;36755;5;89;40;2;38;.950;3600000;0
11;69536;10;0;0;0;0;.00nan;0;0
11;152717;10;50;28;4;24;.857;3554000;0
12;163423;26;0;0;0;0;.00nan;0;0
12;179154;26;83;32;1;31;.969;3600000;0
12;141998;35;0;0;0;0;.00nan;0;0
12;143473;35;78;32;3;29;.906;3532000;0
13;166646;16;0;0;0;0;.00nan;0;0
13;37818;29;75;31;3;28;.903;3515000;0
13;53842;16;78;25;1;24;.960;3600000;0
13;152710;29;0;0;0;0;.00nan;0;0
14;1669;33;0;0;0;0;.00nan;0;0
14;169868;4182;0;0;0;0;.00nan;0;0
14;147945;4182;100;30;0;30;1.000;3600000;0
14;149452;33;50;21;3;18;.857;3600000;0
15;841;11;0;0;0;0;.00nan;0;0
15;9235;4838;58;30;4;26;.867;4046000;0
15;31972;11;76;47;5;42;.894;4046000;0
15;143749;4838;0;0;0;0;.00nan;0;0
16;43757;12;62;29;4;25;.862;3600000;0
16;69536;10;0;0;0;0;.00nan;0;0
16;85798;12;0;0;0;0;.00nan;0;0
16;152717;10;81;28;1;27;.964;3600000;0
17;14866;20;93;23;0;23;1.000;3600000;0
17;20693;24;0;0;0;0;.00nan;0;0
17;34745;20;0;0;0;0;.00nan;0;0
17;57338;24;80;50;4;46;.920;3600000;0
18;556;3;100;32;0;32;1.000;3600000;0
18;615;3;0;0;0;0;.00nan;0;0
18;676;34;82;35;2;33;.943;3588000;0
18;78806;34;0;0;0;0;.00nan;0;0
19;19391;32;0;0;0;0;.00nan;0;0
19;37818;29;83;40;3;37;.925;3875000;0
19;58830;32;93;40;2;38;.950;3875000;0
19;152710;29;0;0;0;0;.00nan;0;0
20;1669;33;0;0;0;0;.00nan;0;0
20;163695;9;75;24;1;23;.958;3600000;0
20;175092;9;0;0;0;0;.00nan;0;0
20;149452;33;79;34;2;32;.941;3600000;0
21;168712;14;0;0;0;0;.00nan;0;0
21;59540;14;55;24;3;21;.875;3556000;0
21;86192;21;72;29;2;27;.931;3600000;0
21;143156;21;0;0;0;0;.00nan;0;0
22;166751;5;0;0;0;0;.00nan;0;0
22;20432;31;31;23;5;18;.783;3600000;0
22;36755;5;70;37;4;33;.892;3600000;0
22;86360;31;0;0;0;0;.00nan;0;0
23;174718;25;71;26;2;24;.923;3600000;0
23;144705;17;0;0;0;0;.00nan;0;0
23;146862;17;84;45;3;42;.933;3600000;0
23;148958;25;0;0;0;0;.00nan;0;0
24;20693;24;82;46;4;42;.913;3600000;0
24;176995;30;0;0;0;0;.00nan;0;0
24;36674;30;42;37;6;31;.838;3600000;0
24;57338;24;0;0;0;0;.00nan;0;0
25;166646;16;0;0;0;0;.00nan;0;0
25;8424;28;0;0;0;0;.00nan;0;0
25;53842;16;82;33;2;31;.939;3600000;0
25;152835;28;61;43;5;38;.884;3600000;0
26;848;22;29;26;5;21;.808;3600000;0
26;987;22;0;0;0;0;.00nan;0;0
26;46492;0;0;0;0;0;.00nan;0;0
26;91178;0;99;45;2;43;.956;3600000;0
27;169868;4182;0;0;0;0;.00nan;0;0
27;141998;35;69;30;3;27;.900;3600000;0
27;143473;35;0;0;0;0;.00nan;0;0
27;147945;4182;59;36;4;32;.889;3600000;0
28;2059;23;43;30;5;25;.833;3600000;0
28;167642;18;0;0;0;0;.00nan;0;0
28;55802;18;97;25;0;25;1.000;3600000;0
28;65762;23;0;0;0;0;.00nan;0;0
29;841;11;0;0;0;0;.00nan;0;0
29;5311;8;0;0;0;0;.00nan;0;0
29;13714;8;75;32;3;29;.906;3600000;0
29;31972;11;63;38;4;34;.895;3577000;0
30;163565;19;0;0;0;0;.00nan;0;0
30;9235;4838;85;44;3;41;.932;3600000;0
30;14305;19;18;25;7;18;.720;3600000;0
30;143749;4838;0;0;0;0;.00nan;0;0
31;166381;27;78;28;1;27;.964;3600000;0
31;175660;27;0;0;0;0;.00nan;0;0
31;57859;15;0;0;0;0;.00nan;0;0
31;85727;15;66;28;3;25;.893;3571000;0
32;556;3;79;28;2;26;.929;3600000;0
32;615;3;0;0;0;0;.00nan;0;0
32;20432;31;0;0;0;0;.00nan;0;0
32;86360;31;64;30;3;27;.900;3596000;0
33;163565;19;0;0;0;0;.00nan;0;0
33;14305;19;94;44;2;42;.955;3632000;0
33;57859;15;0;0;0;0;.00nan;0;0
33;85727;15;60;21;3;18;.857;3632000;0
34;166751;5;0;0;0;0;.00nan;0;0
34;168712;14;0;0;0;0;.00nan;0;0
34;36755;5;100;43;1;42;.977;3600000;0
34;59540;14;43;15;3;12;.800;3526000;0
35;37818;29;66;29;3;26;.897;3600000;0
35;69536;10;100;41;0;41;1.000;3600000;0
35;152710;29;0;0;0;0;.00nan;0;0
35;152717;10;0;0;0;0;.00nan;0;0
36;43757;12;76;31;2;29;.935;3680000;0
36;85798;12;0;0;0;0;.00nan;0;0
36;86192;21;100;35;1;34;.971;3680000;0
36;143156;21;0;0;0;0;.00nan;0;0
37;8424;28;0;0;0;0;.00nan;0;0
37;174718;25;60;29;3;26;.897;3600000;0
37;148958;25;0;0;0;0;.00nan;0;0
37;152835;28;53;32;5;27;.844;3575000;0
38;14866;20;50;19;2;17;.895;4200000;0
38;176995;30;0;0;0;0;.00nan;0;0
38;34745;20;0;0;0;0;.00nan;0;0
38;36674;30;100;46;2;44;.957;4200000;0
39;20432;31;88;23;1;22;.957;3600000;0
39;46492;0;0;0;0;0;.00nan;0;0
39;86360;31;0;0;0;0;.00nan;0;0
39;91178;0;91;37;2;35;.946;3556000;0
40;166646;16;0;0;0;0;.00nan;0;0
40;53842;16;95;25;0;25;1.000;3600000;0
40;144705;17;0;0;0;0;.00nan;0;0
40;146862;17;81;40;3;37;.925;3600000;0
41;676;34;70;30;3;27;.900;3527000;0
41;2059;23;81;33;2;31;.939;3600000;0
41;65762;23;0;0;0;0;.00nan;0;0
41;78806;34;0;0;0;0;.00nan;0;0
42;848;22;0;0;0;0;.00nan;0;0
42;987;22;57;32;4;28;.875;3600000;0
42;43757;12;0;0;0;0;.00nan;0;0
42;85798;12;49;38;6;32;.842;3581000;0
43;1669;33;32;31;6;25;.806;3574000;0
43;167642;18;0;0;0;0;.00nan;0;0
43;55802;18;39;20;4;16;.800;3600000;0
43;149452;33;0;0;0;0;.00nan;0;0
44;166381;27;0;0;0;0;.00nan;0;0
44;19391;32;0;0;0;0;.00nan;0;0
44;175660;27;61;23;3;20;.870;4073000;0
44;58830;32;71;33;4;29;.879;4073000;0
45;5311;8;0;0;0;0;.00nan;0;0
45;13714;8;81;40;3;37;.925;3600000;0
45;169868;4182;64;32;4;28;.875;3600000;0
45;147945;4182;0;0;0;0;.00nan;0;0
46;841;11;0;0;0;0;.00nan;0;0
46;31972;11;100;41;1;40;.976;3600000;0
46;57859;15;0;0;0;0;.00nan;0;0
46;85727;15;70;26;2;24;.923;3575000;0
47;163423;26;0;0;0;0;.00nan;0;0
47;9235;4838;0;0;0;0;.00nan;0;0
47;179154;26;97;38;1;37;.974;4105000;0
47;143749;4838;77;28;2;26;.929;4105000;0
48;556;3;81;54;6;48;.889;3240000;0
48;615;3;42;3;1;2;.667;360000;0
48;14866;20;53;26;4;22;.846;3600000;0
48;34745;20;0;0;0;0;.00nan;0;0
49;166751;5;0;0;0;0;.00nan;0;0
49;20693;24;83;26;2;24;.923;3600000;0
49;36755;5;59;33;4;29;.879;3547000;0
49;57338;24;0;0;0;0;.00nan;0;0
50;176995;30;0;0;0;0;.00nan;0;0
50;36674;30;71;33;4;29;.879;3600000;0
50;46492;0;0;0;0;0;.00nan;0;0
50;91178;0;100;35;0;35;1.000;3600000;0
51;8424;28;0;0;0;0;.00nan;0;0
51;37818;29;54;28;3;25;.893;3600000;0
51;152710;29;0;0;0;0;.00nan;0;0
51;152835;28;59;41;6;35;.854;3600000;0
52;1669;33;0;0;0;0;.00nan;0;0
52;86192;21;73;25;2;23;.920;3600000;0
52;143156;21;0;0;0;0;.00nan;0;0
52;149452;33;59;38;5;33;.868;3600000;0
53;676;34;92;26;1;25;.962;3600000;0
53;167642;18;0;0;0;0;.00nan;0;0
53;55802;18;83;49;4;45;.918;3600000;0
53;78806;34;0;0;0;0;.00nan;0;0
54;2059;23;61;29;3;26;.897;3551000;0
54;20432;31;77;25;2;23;.920;3600000;0
54;65762;23;0;0;0;0;.00nan;0;0
54;86360;31;0;0;0;0;.00nan;0;0
55;166646;16;0;0;0;0;.00nan;0;0
55;166381;27;61;24;3;21;.875;3600000;0
55;175660;27;0;0;0;0;.00nan;0;0
55;53842;16;60;34;4;30;.882;3544000;0
56;43757;12;58;18;2;16;.889;3600000;0
56;85798;12;0;0;0;0;.00nan;0;0
56;141998;35;65;33;3;30;.909;3547000;0
56;143473;35;0;0;0;0;.00nan;0;0
57;9235;4838;74;31;2;29;.935;3600000;0
57;19391;32;0;0;0;0;.00nan;0;0
57;58830;32;19;16;5;11;.688;3600000;0
57;143749;4838;0;0;0;0;.00nan;0;0
58;163423;26;0;0;0;0;.00nan;0;0
58;163565;19;0;0;0;0;.00nan;0;0
58;14305;19;83;27;1;26;.963;3600000;0
58;179154;26;65;28;2;26;.929;3567000;0
59;169868;4182;0;0;0;0;.00nan;0;0
59;57859;15;0;0;0;0;.00nan;0;0
59;85727;15;68;23;2;21;.913;3600000;0
59;147945;4182;57;51;7;44;.863;3600000;0
60;5311;8;0;0;0;0;.00nan;0;0
60;13714;8;84;39;3;36;.923;3600000;0
60;174718;25;0;0;0;0;.00nan;0;0
60;148958;25;60;30;4;26;.867;3553000;0
61;841;11;0;0;0;0;.00nan;0;0
61;163695;9;90;28;1;27;.964;3600000;0
61;175092;9;0;0;0;0;.00nan;0;0
61;31972;11;35;24;5;19;.792;3600000;0
62;168712;14;0;0;0;0;.00nan;0;0
62;176995;30;0;0;0;0;.00nan;0;0
62;36674;30;71;26;2;24;.923;3600000;0
62;59540;14;79;36;3;33;.917;3564000;0
63;848;22;0;0;0;0;.00nan;0;0
63;987;22;29;23;6;17;.739;3600000;0
63;69536;10;0;0;0;0;.00nan;0;0
63;152717;10;84;35;2;33;.943;3600000;0
64;556;3;56;27;3;24;.889;3521000;0
64;615;3;0;0;0;0;.00nan;0;0
64;166751;5;0;0;0;0;.00nan;0;0
64;36755;5;98;35;1;34;.971;3600000;0
65;163565;19;0;0;0;0;.00nan;0;0
65;14305;19;62;26;3;23;.885;3574000;0
65;43757;12;0;0;0;0;.00nan;0;0
65;85798;12;77;21;1;20;.952;3600000;0
66;848;22;63;26;2;24;.923;3560000;0
66;987;22;0;0;0;0;.00nan;0;0
66;46492;0;0;0;0;0;.00nan;0;0
66;91178;0;91;38;1;37;.974;3600000;0
67;2059;23;74;27;2;25;.926;3600000;0
67;37818;29;35;22;5;17;.773;3285000;0
67;65762;23;0;0;0;0;.00nan;0;0
67;152710;29;58;6;0;6;1.000;315000;0
68;14866;20;65;20;2;18;.900;3600000;0
68;34745;20;0;0;0;0;.00nan;0;0
68;144705;17;57;45;5;40;.889;3600000;0
68;146862;17;0;0;0;0;.00nan;0;0
69;8424;28;58;12;1;11;.917;1342000;0
69;20432;31;100;25;0;25;1.000;3600000;0
69;86360;31;0;0;0;0;.00nan;0;0
69;152835;28;43;38;6;32;.842;2258000;0
70;9235;4838;0;0;0;0;.00nan;0;0
70;174718;25;75;13;0;13;1.000;3600000;0
70;143749;4838;52;32;5;27;.844;3600000;0
70;148958;25;0;0;0;0;.00nan;0;0
71;676;34;88;26;2;24;.923;3888000;0
71;163423;26;92;48;3;45;.938;3888000;0
71;179154;26;0;0;0;0;.00nan;0;0
71;78806;34;0;0;0;0;.00nan;0;0
72;166646;16;39;20;4;16;.800;3590000;0
72;168712;14;73;34;3;31;.912;3600000;0
72;53842;16;0;0;0;0;.00nan;0;0
72;59540;14;0;0;0;0;.00nan;0;0
73;841;11;77;19;1;18;.947;1743000;0
73;1669;33;0;0;0;0;.00nan;0;0
73;31972;11;33;17;4;13;.765;1857000;0
73;149452;33;93;31;1;30;.968;3600000;0
74;20693;24;81;46;3;43;.935;3600000;0
74;57338;24;0;0;0;0;.00nan;0;0
74;141998;35;35;33;6;27;.818;3600000;0
74;143473;35;0;0;0;0;.00nan;0;0
75;5311;8;0;0;0;0;.00nan;0;0
75;13714;8;100;36;0;36;1.000;3600000;0
75;57859;15;70;19;1;18;.947;3551000;0
75;85727;15;0;0;0;0;.00nan;0;0
76;167642;18;82;26;2;24;.923;3600000;0
76;19391;32;53;11;1;10;.909;1546000;0
76;55802;18;0;0;0;0;.00nan;0;0
76;58830;32;25;19;5;14;.737;2054000;0
77;169868;4182;66;26;2;24;.923;3570000;0
77;86192;21;88;29;1;28;.966;3600000;0
77;143156;21;0;0;0;0;.00nan;0;0
77;147945;4182;0;0;0;0;.00nan;0;0
78;163695;9;64;50;5;45;.900;3600000;0
78;166381;27;0;0;0;0;.00nan;0;0
78;175092;9;0;0;0;0;.00nan;0;0
78;175660;27;72;11;0;11;1.000;3600000;0
79;166751;5;69;28;3;25;.893;3600000;0
79;176995;30;0;0;0;0;.00nan;0;0
79;36674;30;40;20;4;16;.800;3570000;0
79;36755;5;0;0;0;0;.00nan;0;0
80;163565;19;92;33;1;32;.970;3600000;0
80;163695;9;0;0;0;0;.00nan;0;0
80;14305;19;0;0;0;0;.00nan;0;0
80;175092;9;70;36;3;33;.917;3520000;0
81;46492;0;0;0;0;0;.00nan;0;0
81;91178;0;100;28;0;28;1.000;3600000;0
81;144705;17;0;0;0;0;.00nan;0;0
81;146862;17;54;33;5;28;.848;3600000;0
82;8424;28;0;0;0;0;.00nan;0;0
82;14866;20;0;0;0;0;.00nan;0;0
82;34745;20;39;19;4;15;.789;3545000;0
82;152835;28;99;56;3;53;.946;3600000;0
83;163565;19;0;0;0;0;.00nan;0;0
83;14305;19;56;20;2;18;.900;3600000;0
83;168712;14;0;0;0;0;.00nan;0;0
83;59540;14;49;31;5;26;.839;3600000;0
84;556;3;77;46;4;42;.913;3595000;0
84;615;3;0;0;0;0;.00nan;0;0
84;46492;0;0;0;0;0;.00nan;0;0
84;91178;0;66;21;2;19;.905;3600000;0
85;20432;31;71;48;4;44;.917;3584000;0
85;57859;15;52;22;3;19;.864;3600000;0
85;85727;15;0;0;0;0;.00nan;0;0
85;86360;31;0;0;0;0;.00nan;0;0
86;69536;10;0;0;0;0;.00nan;0;0
86;144705;17;58;34;3;31;.912;4200000;0
86;146862;17;0;0;0;0;.00nan;0;0
86;152717;10;66;34;3;31;.912;4200000;0
87;163423;26;0;0;0;0;.00nan;0;0
87;20693;24;76;27;2;25;.926;3557000;0
87;179154;26;96;39;1;38;.974;3600000;0
87;57338;24;0;0;0;0;.00nan;0;0
88;841;11;75;46;4;42;.913;3732000;0
88;31972;11;0;0;0;0;.00nan;0;0
88;37818;29;63;24;3;21;.875;3732000;0
88;152710;29;0;0;0;0;.00nan;0;0
89;848;22;0;0;0;0;.00nan;0;0
89;987;22;68;18;1;17;.944;3561000;0
89;5311;8;0;0;0;0;.00nan;0;0
89;13714;8;100;45;0;45;1.000;3600000;0
90;166751;5;0;0;0;0;.00nan;0;0
90;169868;4182;43;9;2;7;.778;1310000;0
90;36755;5;46;32;5;27;.844;3600000;0
90;147945;4182;15;21;6;15;.714;2290000;0
91;163695;9;52;12;2;10;.833;3600000;0
91;174718;25;58;24;3;21;.875;3560000;0
91;175092;9;0;0;0;0;.00nan;0;0
91;148958;25;0;0;0;0;.00nan;0;0
92;19391;32;84;39;3;36;.923;3600000;0
92;58830;32;0;0;0;0;.00nan;0;0
92;141998;35;0;0;0;0;.00nan;0;0
92;143473;35;82;46;4;42;.913;3556000;0
93;166646;16;0;0;0;0;.00nan;0;0
93;167642;18;43;11;2;9;.818;704000;0
93;53842;16;89;35;2;33;.943;3600000;0
93;55802;18;15;27;7;20;.741;2896000;0
94;1669;33;40;22;4;18;.818;3797000;0
94;2059;23;53;35;5;30;.857;3797000;0
94;65762;23;0;0;0;0;.00nan;0;0
94;149452;33;0;0;0;0;.00nan;0;0
95;176995;30;0;0;0;0;.00nan;0;0
95;36674;30;67;25;2;23;.920;3600000;0
95;86192;21;51;22;3;19;.864;3580000;0
95;143156;21;0;0;0;0;.00nan;0;0
96;166381;27;0;0;0;0;.00nan;0;0
96;175660;27;73;26;2;24;.923;3510000;0
96;43757;12;0;0;0;0;.00nan;0;0
96;85798;12;100;42;0;42;1.000;3600000;0
97;676;34;61;22;3;19;.864;4031000;0
97;9235;4838;100;53;2;51;.962;4031000;0
97;78806;34;0;0;0;0;.00nan;0;0
97;143749;4838;0;0;0;0;.00nan;0;0
98;14866;20;9;15;6;9;.600;1254000;0
98;34745;20;58;12;1;11;.917;2346000;0
98;69536;10;87;41;3;38;.927;3600000;0
98;152717;10;0;0;0;0;.00nan;0;0
99;163565;19;64;28;3;25;.893;3591000;0
99;163695;9;0;0;0;0;.00nan;0;0
99;14305;19;0;0;0;0;.00nan;0;0
99;175092;9;64;25;2;23;.920;3600000;0
100;169868;4182;0;0;0;0;.00nan;0;0
100;57859;15;0;0;0;0;.00nan;0;0
100;85727;15;92;25;1;24;.960;3600000;0
100;147945;4182;98;47;2;45;.957;3600000;0
101;166751;5;0;0;0;0;.00nan;0;0
101;19391;32;0;0;0;0;.00nan;0;0
101;36755;5;63;27;3;24;.889;3600000;0
101;58830;32;42;26;4;22;.846;3559000;0
102;168712;14;0;0;0;0;.00nan;0;0
102;59540;14;76;27;2;25;.926;3600000;0
102;144705;17;0;0;0;0;.00nan;0;0
102;146862;17;79;41;3;38;.927;3556000;0
103;676;34;0;0;0;0;.00nan;0;0
103;166646;16;0;0;0;0;.00nan;0;0
103;53842;16;77;25;2;23;.920;3600000;0
103;78806;34;44;33;6;27;.818;3600000;0
104;5311;8;0;0;0;0;.00nan;0;0
104;13714;8;59;21;2;19;.905;3568000;0
104;20693;24;100;44;1;43;.977;3600000;0
104;57338;24;0;0;0;0;.00nan;0;0
105;841;11;0;0;0;0;.00nan;0;0
105;20432;31;61;27;3;24;.889;3589000;0
105;31972;11;90;39;2;37;.949;3600000;0
105;86360;31;0;0;0;0;.00nan;0;0
106;556;3;100;38;0;38;1.000;3600000;0
106;615;3;0;0;0;0;.00nan;0;0
106;848;22;0;0;0;0;.00nan;0;0
106;987;22;52;17;2;15;.882;3522000;0
107;163423;26;0;0;0;0;.00nan;0;0
107;8424;28;0;0;0;0;.00nan;0;0
107;179154;26;80;34;2;32;.941;3600000;0
107;152835;28;48;26;4;22;.846;3547000;0
108;176995;30;81;29;2;27;.931;3600000;0
108;36674;30;0;0;0;0;.00nan;0;0
108;141998;35;61;38;4;34;.895;3528000;0
108;143473;35;0;0;0;0;.00nan;0;0
109;167642;18;0;0;0;0;.00nan;0;0
109;55802;18;43;35;7;28;.800;3531000;0
109;86192;21;55;35;5;30;.857;3600000;0
109;143156;21;0;0;0;0;.00nan;0;0
110;9235;4838;0;0;0;0;.00nan;0;0
110;174718;25;65;30;3;27;.900;4200000;0
110;143749;4838;94;45;3;42;.933;4200000;0
110;148958;25;0;0;0;0;.00nan;0;0
111;841;11;73;53;6;47;.887;3877000;0
111;31972;11;0;0;0;0;.00nan;0;0
111;57859;15;45;34;5;29;.853;3877000;0
111;85727;15;0;0;0;0;.00nan;0;0
112;46492;0;0;0;0;0;.00nan;0;0
112;69536;10;0;0;0;0;.00nan;0;0
112;91178;0;62;38;4;34;.895;4200000;0
112;152717;10;68;41;4;37;.902;4200000;0
113;166646;16;71;35;4;31;.886;3600000;0
113;14866;20;79;20;1;19;.950;3600000;0
113;34745;20;0;0;0;0;.00nan;0;0
113;53842;16;0;0;0;0;.00nan;0;0
114;166381;27;85;19;0;19;1.000;3179000;0
114;175660;27;28;5;3;2;.400;421000;0
114;43757;12;0;0;0;0;.00nan;0;0
114;85798;12;58;40;5;35;.875;3600000;0
115;2059;23;65;29;3;26;.897;3600000;0
115;65762;23;0;0;0;0;.00nan;0;0
115;141998;35;0;0;0;0;.00nan;0;0
115;143473;35;100;32;0;32;1.000;3600000;0
116;676;34;62;24;3;21;.875;3567000;0
116;163565;19;0;0;0;0;.00nan;0;0
116;14305;19;82;26;2;24;.923;3600000;0
116;78806;34;0;0;0;0;.00nan;0;0
117;169868;4182;0;0;0;0;.00nan;0;0
117;37818;29;0;0;0;0;.00nan;0;0
117;147945;4182;90;29;1;28;.966;3600000;0
117;152710;29;44;26;4;22;.846;3600000;0
118;166751;5;0;0;0;0;.00nan;0;0
118;163695;9;88;30;1;29;.967;3600000;0
118;175092;9;0;0;0;0;.00nan;0;0
118;36755;5;63;30;3;27;.900;3577000;0
119;848;22;28;24;6;18;.750;3600000;0
119;987;22;0;0;0;0;.00nan;0;0
119;168712;14;0;0;0;0;.00nan;0;0
119;59540;14;76;30;2;28;.933;3600000;0
120;19391;32;0;0;0;0;.00nan;0;0
120;58830;32;83;33;2;31;.939;3912000;0
120;144705;17;0;0;0;0;.00nan;0;0
120;146862;17;66;28;3;25;.893;3912000;0
121;1669;33;0;0;0;0;.00nan;0;0
121;8424;28;59;6;0;6;1.000;344000;0
121;149452;33;49;23;4;19;.826;3600000;0
121;152835;28;37;36;6;30;.833;3199000;0
122;556;3;32;23;5;18;.783;3600000;0
122;615;3;0;0;0;0;.00nan;0;0
122;20693;24;99;37;1;36;.973;3600000;0
122;57338;24;0;0;0;0;.00nan;0;0
123;2059;23;0;0;0;0;.00nan;0;0
123;65762;23;44;20;3;17;.850;3518000;0
123;86192;21;80;26;1;25;.962;3600000;0
123;143156;21;0;0;0;0;.00nan;0;0
124;9235;4838;63;57;6;51;.895;3600000;0
124;166381;27;0;0;0;0;.00nan;0;0
124;175660;27;100;26;0;26;1.000;3600000;0
124;143749;4838;0;0;0;0;.00nan;0;0
125;5311;8;0;0;0;0;.00nan;0;0
125;13714;8;40;28;5;23;.821;3580000;0
125;46492;0;0;0;0;0;.00nan;0;0
125;91178;0;65;33;4;29;.879;3600000;0
126;166646;16;0;0;0;0;.00nan;0;0
126;53842;16;74;36;3;33;.917;3571000;0
126;69536;10;74;25;2;23;.920;3600000;0
126;152717;10;0;0;0;0;.00nan;0;0
127;841;11;0;0;0;0;.00nan;0;0
127;14866;20;97;31;1;30;.968;3600000;0
127;31972;11;71;51;5;46;.902;3600000;0
127;34745;20;0;0;0;0;.00nan;0;0
128;167642;18;49;1;0;1;1.000;240000;0
128;176995;30;0;0;0;0;.00nan;0;0
128;36674;30;69;26;2;24;.923;3600000;0
128;55802;18;40;39;7;32;.821;3360000;0
129;163695;9;0;0;0;0;.00nan;0;0
129;175092;9;84;26;1;25;.962;3600000;0
129;37818;29;71;24;2;22;.917;3589000;0
129;152710;29;0;0;0;0;.00nan;0;0
130;676;34;58;50;6;44;.880;3600000;0
130;57859;15;0;0;0;0;.00nan;0;0
130;78806;34;0;0;0;0;.00nan;0;0
130;85727;15;75;31;2;29;.935;3600000;0
131;163565;19;80;44;3;41;.932;3600000;0
131;14305;19;0;0;0;0;.00nan;0;0
131;20693;24;96;23;0;23;1.000;3600000;0
131;57338;24;0;0;0;0;.00nan;0;0
132;20432;31;0;0;0;0;.00nan;0;0
132;169868;4182;68;25;2;23;.920;3600000;0
132;86360;31;56;27;3;24;.889;3546000;0
132;147945;4182;0;0;0;0;.00nan;0;0
133;848;22;0;0;0;0;.00nan;0;0
133;987;22;74;20;1;19;.950;3600000;0
133;166751;5;0;0;0;0;.00nan;0;0
133;36755;5;57;35;4;31;.886;3600000;0
134;19391;32;63;31;3;28;.903;3600000;0
134;58830;32;0;0;0;0;.00nan;0;0
134;86192;21;46;35;6;29;.829;3600000;0
134;143156;21;0;0;0;0;.00nan;0;0
135;163423;26;0;0;0;0;.00nan;0;0
135;168712;14;0;0;0;0;.00nan;0;0
135;179154;26;93;41;2;39;.951;3600000;0
135;59540;14;58;24;3;21;.875;3544000;0
136;174718;25;18;8;4;4;.500;781000;0
136;43757;12;0;0;0;0;.00nan;0;0
136;85798;12;60;19;2;17;.895;3600000;0
136;148958;25;58;21;2;19;.905;2819000;0
137;9235;4838;72;19;0;19;1.000;2481000;0
137;143749;4838;29;12;4;8;.667;1119000;0
137;144705;17;0;0;0;0;.00nan;0;0
137;146862;17;82;27;1;26;.963;3600000;0
138;8424;28;56;20;3;17;.850;3525000;0
138;166381;27;0;0;0;0;.00nan;0;0
138;175660;27;100;45;1;44;.978;3600000;0
138;152835;28;0;0;0;0;.00nan;0;0
139;1669;33;0;0;0;0;.00nan;0;0
139;2059;23;83;26;1;25;.962;3600000;0
139;65762;23;0;0;0;0;.00nan;0;0
139;149452;33;71;31;2;29;.935;3578000;0
140;676;34;100;38;0;38;1.000;3600000;0
140;46492;0;0;0;0;0;.00nan;0;0
140;78806;34;0;0;0;0;.00nan;0;0
140;91178;0;87;37;4;33;.892;3600000;0
141;163423;26;0;0;0;0;.00nan;0;0
141;179154;26;93;33;1;32;.970;3600000;0
141;176995;30;0;0;0;0;.00nan;0;0
141;36674;30;68;28;2;26;.929;3545000;0
142;5311;8;0;0;0;0;.00nan;0;0
142;13714;8;64;22;3;19;.864;3600000;0
142;141998;35;54;41;5;36;.878;3577000;0
142;143473;35;0;0;0;0;.00nan;0;0
143;163565;19;77;27;1;26;.963;3600000;0
143;14305;19;0;0;0;0;.00nan;0;0
143;43757;12;73;29;2;27;.931;3543000;0
143;85798;12;0;0;0;0;.00nan;0;0
144;163695;9;82;40;3;37;.925;3600000;0
144;8424;28;0;0;0;0;.00nan;0;0
144;175092;9;0;0;0;0;.00nan;0;0
144;152835;28;40;31;5;26;.839;3600000;0
145;168712;14;0;0;0;0;.00nan;0;0
145;20432;31;62;15;1;14;.933;3600000;0
145;59540;14;87;30;2;28;.933;3600000;0
145;86360;31;0;0;0;0;.00nan;0;0
146;166751;5;0;0;0;0;.00nan;0;0
146;36755;5;69;38;4;34;.895;3583000;0
146;37818;29;63;18;2;16;.889;3600000;0
146;152710;29;0;0;0;0;.00nan;0;0
147;57859;15;0;0;0;0;.00nan;0;0
147;85727;15;100;38;1;37;.974;3600000;0
147;86192;21;0;0;0;0;.00nan;0;0
147;143156;21;76;33;2;31;.939;3600000;0
148;556;3;93;63;3;60;.952;3600000;0
148;615;3;0;0;0;0;.00nan;0;0
148;166381;27;0;0;0;0;.00nan;0;0
148;175660;27;62;20;2;18;.900;3600000;0
149;848;22;62;29;3;26;.897;3623000;0
149;987;22;0;0;0;0;.00nan;0;0
149;14866;20;0;0;0;0;.00nan;0;0
149;34745;20;62;34;4;30;.882;3623000;0
150;166646;16;0;0;0;0;.00nan;0;0
150;53842;16;67;24;2;22;.917;3600000;0
150;69536;10;0;0;0;0;.00nan;0;0
150;152717;10;73;45;5;40;.889;3600000;0
151;163423;26;57;24;3;21;.875;3600000;0
151;167642;18;38;27;5;22;.815;3585000;0
151;179154;26;0;0;0;0;.00nan;0;0
151;55802;18;0;0;0;0;.00nan;0;0
152;43757;12;0;0;0;0;.00nan;0;0
152;85798;12;86;31;1;30;.968;3600000;0
152;144705;17;0;0;0;0;.00nan;0;0
152;146862;17;70;32;2;30;.938;3570000;0
153;1669;33;0;0;0;0;.00nan;0;0
153;169868;4182;0;0;0;0;.00nan;0;0
153;147945;4182;81;31;2;29;.935;3600000;0
153;149452;33;59;28;4;24;.857;3516000;0
154;9235;4838;56;26;3;23;.885;3600000;0
154;19391;32;0;0;0;0;.00nan;0;0
154;58830;32;50;26;4;22;.846;3576000;0
154;143749;4838;0;0;0;0;.00nan;0;0
155;841;11;51;27;4;23;.852;3600000;0
155;2059;23;49;29;5;24;.828;3551000;0
155;31972;11;0;0;0;0;.00nan;0;0
155;65762;23;0;0;0;0;.00nan;0;0
156;676;34;83;38;2;36;.947;3600000;0
156;46492;0;67;30;3;27;.900;3545000;0
156;78806;34;0;0;0;0;.00nan;0;0
156;91178;0;0;0;0;0;.00nan;0;0
157;69536;10;14;20;6;14;.700;3116000;0
157;141998;35;0;0;0;0;.00nan;0;0
157;143473;35;86;30;1;29;.967;3600000;0
157;152717;10;57;3;0;3;1.000;484000;0
158;1669;33;0;0;0;0;.00nan;0;0
158;167642;18;0;0;0;0;.00nan;0;0
158;55802;18;52;30;4;26;.867;3596000;0
158;149452;33;60;28;3;25;.893;3600000;0
159;19391;32;0;0;0;0;.00nan;0;0
159;43757;12;0;0;0;0;.00nan;0;0
159;58830;32;92;43;3;40;.930;3600000;0
159;85798;12;38;24;4;20;.833;3600000;0
160;166751;5;0;0;0;0;.00nan;0;0
160;163695;9;0;0;0;0;.00nan;0;0
160;175092;9;63;36;3;33;.917;4200000;0
160;36755;5;72;35;3;32;.914;4200000;0
161;556;3;91;40;2;38;.950;3600000;0
161;615;3;0;0;0;0;.00nan;0;0
161;20432;31;25;7;3;4;.571;408000;0
161;86360;31;51;20;3;17;.850;3192000;0
162;676;34;72;22;2;20;.909;1766000;0
162;166381;27;0;0;0;0;.00nan;0;0
162;175660;27;75;23;1;22;.957;3600000;0
162;78806;34;27;25;6;19;.760;1834000;0
163;141998;35;75;25;2;23;.920;3600000;0
163;143473;35;0;0;0;0;.00nan;0;0
163;144705;17;0;0;0;0;.00nan;0;0
163;146862;17;38;41;7;34;.829;3600000;0
164;8424;28;73;25;2;23;.920;3600000;0
164;46492;0;0;0;0;0;.00nan;0;0
164;91178;0;93;42;3;39;.929;3598000;0
164;152835;28;0;0;0;0;.00nan;0;0
165;14866;20;57;35;4;31;.886;3600000;0
165;168712;14;0;0;0;0;.00nan;0;0
165;34745;20;0;0;0;0;.00nan;0;0
165;59540;14;91;20;0;20;1.000;3600000;0
166;848;22;0;0;0;0;.00nan;0;0
166;987;22;35;18;4;14;.778;3600000;0
166;57859;15;0;0;0;0;.00nan;0;0
166;85727;15;66;46;5;41;.891;3589000;0
167;174718;25;0;0;0;0;.00nan;0;0
167;37818;29;50;26;4;22;.846;3590000;0
167;148958;25;82;33;2;31;.939;3600000;0
167;152710;29;0;0;0;0;.00nan;0;0
168;166646;16;0;0;0;0;.00nan;0;0
168;53842;16;83;34;2;32;.941;3630000;0
168;86192;21;95;41;1;40;.976;3629000;0
168;143156;21;0;0;0;0;.00nan;0;0
169;169868;4182;67;34;4;30;.882;3600000;0
169;176995;30;0;0;0;0;.00nan;0;0
169;36674;30;63;36;5;31;.861;3600000;0
169;147945;4182;0;0;0;0;.00nan;0;0
170;841;11;0;0;0;0;.00nan;0;0
170;20693;24;54;44;6;38;.864;3600000;0
170;31972;11;71;21;1;20;.952;3600000;0
170;57338;24;0;0;0;0;.00nan;0;0
171;2059;23;54;25;3;22;.880;3556000;0
171;163423;26;0;0;0;0;.00nan;0;0
171;179154;26;81;24;1;23;.958;3600000;0
171;65762;23;0;0;0;0;.00nan;0;0
172;5311;8;66;14;0;14;1.000;2317000;0
172;9235;4838;0;0;0;0;.00nan;0;0
172;13714;8;26;14;4;10;.714;1883000;0
172;143749;4838;100;57;4;53;.930;4200000;0
173;174718;25;64;23;2;21;.913;3600000;0
173;69536;10;71;24;1;23;.958;1329000;0
173;148958;25;0;0;0;0;.00nan;0;0
173;152717;10;53;28;4;24;.857;2271000;0
174;163565;19;88;18;0;18;1.000;3600000;0
174;9235;4838;38;35;6;29;.829;2973000;0
174;14305;19;0;0;0;0;.00nan;0;0
174;143749;4838;54;7;1;6;.857;627000;0
175;168712;14;0;0;0;0;.00nan;0;0
175;37818;29;85;36;3;33;.917;3600000;0
175;59540;14;91;18;0;18;1.000;3600000;0
175;152710;29;0;0;0;0;.00nan;0;0
176;8424;28;0;0;0;0;.00nan;0;0
176;20432;31;98;29;1;28;.966;3600000;0
176;86360;31;0;0;0;0;.00nan;0;0
176;152835;28;83;32;2;30;.938;3592000;0
177;163423;26;0;0;0;0;.00nan;0;0
177;163695;9;58;34;4;30;.882;3581000;0
177;179154;26;93;49;2;47;.959;3600000;0
177;175092;9;0;0;0;0;.00nan;0;0
178;2059;23;62;22;2;20;.909;3600000;0
178;167642;18;47;23;4;19;.826;3561000;0
178;55802;18;0;0;0;0;.00nan;0;0
178;65762;23;0;0;0;0;.00nan;0;0
179;46492;0;0;0;0;0;.00nan;0;0
179;57859;15;0;0;0;0;.00nan;0;0
179;85727;15;67;25;2;23;.920;3600000;0
179;91178;0;74;43;4;39;.907;3586000;0
180;20432;31;0;0;0;0;.00nan;0;0
180;86360;31;82;32;2;30;.938;3600000;0
180;144705;17;85;40;3;37;.925;3573000;0
180;146862;17;0;0;0;0;.00nan;0;0
181;848;22;0;0;0;0;.00nan;0;0
181;987;22;91;12;0;12;1.000;3600000;0
181;166646;16;0;0;0;0;.00nan;0;0
181;53842;16;75;41;4;37;.902;3600000;0
182;166751;5;0;0;0;0;.00nan;0;0
182;36755;5;83;34;3;31;.912;3971000;0
182;86192;21;81;41;4;37;.902;3971000;0
182;143156;21;0;0;0;0;.00nan;0;0
183;19391;32;0;0;0;0;.00nan;0;0
183;58830;32;80;39;3;36;.923;3600000;0
183;141998;35;0;0;0;0;.00nan;0;0
183;143473;35;52;31;4;27;.871;3579000;0
184;169868;4182;44;4;1;3;.750;590000;0
184;43757;12;0;0;0;0;.00nan;0;0
184;85798;12;60;32;3;29;.906;3600000;0
184;147945;4182;67;50;6;44;.880;3010000;0
185;1669;33;0;0;0;0;.00nan;0;0
185;176995;30;0;0;0;0;.00nan;0;0
185;36674;30;80;32;2;30;.938;3600000;0
185;149452;33;62;29;3;26;.897;3546000;0
186;163565;19;0;0;0;0;.00nan;0;0
186;14305;19;83;34;2;32;.941;3600000;0
186;20693;24;71;32;3;29;.906;3559000;0
186;57338;24;0;0;0;0;.00nan;0;0
187;5311;8;0;0;0;0;.00nan;0;0
187;13714;8;73;26;2;24;.923;3664000;0
187;69536;10;0;0;0;0;.00nan;0;0
187;152717;10;83;31;3;28;.903;3664000;0
188;676;34;69;21;1;20;.952;3600000;0
188;841;11;0;0;0;0;.00nan;0;0
188;31972;11;69;37;4;33;.892;3600000;0
188;78806;34;0;0;0;0;.00nan;0;0
189;556;3;55;36;5;31;.861;3600000;0
189;615;3;0;0;0;0;.00nan;0;0
189;8424;28;0;0;0;0;.00nan;0;0
189;152835;28;67;34;4;30;.882;3600000;0
190;14866;20;70;23;2;21;.913;3600000;0
190;34745;20;0;0;0;0;.00nan;0;0
190;37818;29;98;51;3;48;.941;3543000;0
190;152710;29;0;0;0;0;.00nan;0;0
191;9235;4838;0;0;0;0;.00nan;0;0
191;166381;27;0;0;0;0;.00nan;0;0
191;175660;27;63;27;3;24;.889;3600000;0
191;143749;4838;85;50;5;45;.900;3558000;0
192;848;22;0;0;0;0;.00nan;0;0
192;987;22;56;13;2;11;.846;3600000;0
192;163695;9;0;0;0;0;.00nan;0;0
192;175092;9;88;44;3;41;.932;3566000;0
193;163423;26;60;8;0;8;1.000;994000;0
193;168712;14;0;0;0;0;.00nan;0;0
193;179154;26;39;35;6;29;.829;2606000;0
193;59540;14;53;27;3;24;.889;3600000;0
194;166751;5;0;0;0;0;.00nan;0;0
194;36755;5;77;40;3;37;.925;3600000;0
194;144705;17;0;0;0;0;.00nan;0;0
194;146862;17;24;11;4;7;.636;3573000;0
195;166646;16;0;0;0;0;.00nan;0;0
195;53842;16;65;37;4;33;.892;3551000;0
195;86192;21;95;31;2;29;.935;3600000;0
195;143156;21;0;0;0;0;.00nan;0;0
196;556;3;0;0;0;0;.00nan;0;0
196;615;3;74;45;5;40;.889;3600000;0
196;2059;23;30;34;6;28;.824;3588000;0
196;65762;23;0;0;0;0;.00nan;0;0
197;20432;31;76;17;1;16;.941;3600000;0
197;174718;25;0;0;0;0;.00nan;0;0
197;86360;31;0;0;0;0;.00nan;0;0
197;148958;25;71;31;2;29;.935;3560000;0
198;43757;12;0;0;0;0;.00nan;0;0
198;85798;12;72;22;1;21;.955;3600000;0
198;141998;35;98;39;2;37;.949;3569000;0
198;143473;35;0;0;0;0;.00nan;0;0
199;1669;33;0;0;0;0;.00nan;0;0
199;19391;32;0;0;0;0;.00nan;0;0
199;58830;32;62;32;3;29;.906;4084000;0
199;149452;33;74;41;4;37;.902;4084000;0
200;5311;8;0;0;0;0;.00nan;0;0
200;13714;8;49;20;3;17;.850;3600000;0
200;169868;4182;0;0;0;0;.00nan;0;0
200;147945;4182;59;41;6;35;.854;3600000;0
201;166381;27;35;27;5;22;.815;3600000;0
201;20693;24;80;37;2;35;.946;3600000;0
201;175660;27;0;0;0;0;.00nan;0;0
201;57338;24;0;0;0;0;.00nan;0;0
202;841;11;0;0;0;0;.00nan;0;0
202;167642;18;0;0;0;0;.00nan;0;0
202;31972;11;89;25;1;24;.960;3577000;0
202;55802;18;100;26;0;26;1.000;3600000;0
203;166646;16;68;25;2;23;.920;3600000;0
203;46492;0;0;0;0;0;.00nan;0;0
203;53842;16;0;0;0;0;.00nan;0;0
203;91178;0;72;28;3;25;.893;3545000;0
204;37818;29;58;41;5;36;.878;3600000;0
204;57859;15;0;0;0;0;.00nan;0;0
204;85727;15;63;24;2;22;.917;3600000;0
204;152710;29;0;0;0;0;.00nan;0;0
205;14866;20;88;37;3;34;.919;3600000;0
205;34745;20;0;0;0;0;.00nan;0;0
205;69536;10;90;46;4;42;.913;3600000;0
205;152717;10;0;0;0;0;.00nan;0;0
206;8424;28;0;0;0;0;.00nan;0;0
206;176995;30;0;0;0;0;.00nan;0;0
206;36674;30;72;29;1;28;.966;3600000;0
206;152835;28;77;29;2;27;.931;3562000;0
207;676;34;65;40;5;35;.875;3520000;0
207;163565;19;68;34;3;31;.912;3600000;0
207;14305;19;0;0;0;0;.00nan;0;0
207;78806;34;0;0;0;0;.00nan;0;0
208;841;11;46;28;4;24;.857;3600000;0
208;9235;4838;0;0;0;0;.00nan;0;0
208;31972;11;0;0;0;0;.00nan;0;0
208;143749;4838;100;37;0;37;1.000;3600000;0
209;166751;5;0;0;0;0;.00nan;0;0
209;168712;14;0;0;0;0;.00nan;0;0
209;36755;5;82;32;2;30;.938;3598000;0
209;59540;14;69;18;1;17;.944;3600000;0
210;163423;26;0;0;0;0;.00nan;0;0
210;19391;32;86;26;1;25;.962;3600000;0
210;179154;26;56;32;4;28;.875;3600000;0
210;58830;32;0;0;0;0;.00nan;0;0
211;163695;9;48;34;5;29;.853;3600000;0
211;175092;9;0;0;0;0;.00nan;0;0
211;144705;17;0;0;0;0;.00nan;0;0
211;146862;17;55;22;3;19;.864;3600000;0
212;556;3;30;7;3;4;.571;134000;0
212;615;3;42;36;6;30;.833;3466000;0
212;176995;30;0;0;0;0;.00nan;0;0
212;36674;30;49;24;3;21;.875;3600000;0
213;20432;31;75;44;4;40;.909;3600000;0
213;57859;15;59;20;3;17;.850;3600000;0
213;85727;15;0;0;0;0;.00nan;0;0
213;86360;31;0;0;0;0;.00nan;0;0
214;2059;23;91;36;1;35;.972;3600000;0
214;8424;28;60;33;3;30;.909;3561000;0
214;65762;23;0;0;0;0;.00nan;0;0
214;152835;28;0;0;0;0;.00nan;0;0
215;848;22;42;21;4;17;.810;2321000;0
215;987;22;60;7;0;7;1.000;1263000;0
215;14866;20;0;0;0;0;.00nan;0;0
215;34745;20;90;32;2;30;.938;3600000;0
216;20693;24;60;30;4;26;.867;4129000;0
216;46492;0;0;0;0;0;.00nan;0;0
216;57338;24;0;0;0;0;.00nan;0;0
216;91178;0;82;44;4;40;.909;4200000;0
217;1669;33;0;0;0;0;.00nan;0;0
217;43757;12;52;31;4;27;.871;3600000;0
217;85798;12;0;0;0;0;.00nan;0;0
217;149452;33;96;27;1;26;.963;3600000;0
218;5311;8;81;22;1;21;.955;3600000;0
218;13714;8;0;0;0;0;.00nan;0;0
218;141998;35;0;0;0;0;.00nan;0;0
218;143473;35;97;38;2;36;.947;3600000;0
219;167642;18;0;0;0;0;.00nan;0;0
219;169868;4182;60;29;3;26;.897;3534000;0
219;55802;18;94;31;1;30;.968;3600000;0
219;147945;4182;0;0;0;0;.00nan;0;0
220;676;34;56;30;4;26;.867;3600000;0
220;166381;27;0;0;0;0;.00nan;0;0
220;175660;27;86;26;1;25;.962;3600000;0
220;78806;34;0;0;0;0;.00nan;0;0
221;174718;25;39;37;6;31;.838;3549000;0
221;37818;29;54;26;4;22;.846;3600000;0
221;148958;25;0;0;0;0;.00nan;0;0
221;152710;29;0;0;0;0;.00nan;0;0
222;166646;16;0;0;0;0;.00nan;0;0
222;163423;26;78;38;4;34;.895;3600000;0
222;179154;26;0;0;0;0;.00nan;0;0
222;53842;16;50;28;5;23;.821;3600000;0
223;2059;23;0;0;0;0;.00nan;0;0
223;65762;23;52;39;5;34;.872;3600000;0
223;144705;17;81;34;2;32;.941;3600000;0
223;146862;17;0;0;0;0;.00nan;0;0
224;168712;14;0;0;0;0;.00nan;0;0
224;59540;14;81;28;2;26;.929;4200000;0
224;86192;21;78;35;2;33;.943;4200000;0
224;143156;21;0;0;0;0;.00nan;0;0
225;841;11;0;0;0;0;.00nan;0;0
225;163565;19;0;0;0;0;.00nan;0;0
225;14305;19;65;26;2;24;.923;3600000;0
225;31972;11;57;39;6;33;.846;3600000;0
226;848;22;58;23;2;21;.913;3600000;0
226;987;22;0;0;0;0;.00nan;0;0
226;167642;18;75;38;3;35;.921;3600000;0
226;55802;18;0;0;0;0;.00nan;0;0
227;5311;8;0;0;0;0;.00nan;0;0
227;13714;8;59;24;2;22;.917;3553000;0
227;169868;4182;0;0;0;0;.00nan;0;0
227;147945;4182;73;22;1;21;.955;3600000;0
228;163695;9;59;32;4;28;.875;4200000;0
228;175092;9;0;0;0;0;.00nan;0;0
228;46492;0;0;0;0;0;.00nan;0;0
228;91178;0;71;33;4;29;.879;4200000;0
229;168712;14;0;0;0;0;.00nan;0;0
229;20693;24;67;23;2;21;.913;3854000;0
229;57338;24;0;0;0;0;.00nan;0;0
229;59540;14;75;32;3;29;.906;3854000;0
230;176995;30;0;0;0;0;.00nan;0;0
230;36674;30;50;26;4;22;.846;3588000;0
230;144705;17;0;0;0;0;.00nan;0;0
230;146862;17;68;32;3;29;.906;3600000;0
231;9235;4838;0;0;0;0;.00nan;0;0
231;14866;20;50;15;2;13;.867;3600000;0
231;34745;20;0;0;0;0;.00nan;0;0
231;143749;4838;98;60;3;57;.950;3600000;0
232;163423;26;0;0;0;0;.00nan;0;0
232;179154;26;83;42;3;39;.929;3600000;0
232;43757;12;38;31;5;26;.839;3599000;0
232;85798;12;0;0;0;0;.00nan;0;0
233;1669;33;0;0;0;0;.00nan;0;0
233;163565;19;65;28;3;25;.893;3600000;0
233;14305;19;0;0;0;0;.00nan;0;0
233;149452;33;61;35;4;31;.886;3594000;0
234;20432;31;63;23;2;21;.913;4200000;0
234;86360;31;0;0;0;0;.00nan;0;0
234;141998;35;95;44;2;42;.955;4200000;0
234;143473;35;0;0;0;0;.00nan;0;0
235;19391;32;0;0;0;0;.00nan;0;0
235;58830;32;74;27;2;25;.926;4060000;0
235;69536;10;0;0;0;0;.00nan;0;0
235;152717;10;72;34;3;31;.912;4060000;0
236;841;11;0;0;0;0;.00nan;0;0
236;31972;11;83;35;2;33;.943;3557000;0
236;37818;29;89;22;1;21;.955;3600000;0
236;152710;29;0;0;0;0;.00nan;0;0
237;676;34;39;30;6;24;.800;3014000;0
237;57859;15;0;0;0;0;.00nan;0;0
237;78806;34;45;5;1;4;.800;586000;0
237;85727;15;67;33;4;29;.879;3600000;0
238;167642;18;0;0;0;0;.00nan;0;0
238;169868;4182;0;0;0;0;.00nan;0;0
238;55802;18;55;34;4;30;.882;3600000;0
238;147945;4182;73;30;3;27;.900;3600000;0
239;5311;8;0;0;0;0;.00nan;0;0
239;163565;19;0;0;0;0;.00nan;0;0
239;13714;8;42;29;5;24;.828;3600000;0
239;14305;19;77;21;1;20;.952;3600000;0
240;848;22;0;0;0;0;.00nan;0;0
240;987;22;42;13;3;10;.769;3600000;0
240;2059;23;76;45;5;40;.889;3600000;0
240;65762;23;0;0;0;0;.00nan;0;0
241;556;3;58;20;2;18;.900;3574000;0
241;615;3;0;0;0;0;.00nan;0;0
241;166751;5;0;0;0;0;.00nan;0;0
241;36755;5;89;34;1;33;.971;3600000;0
242;168712;14;0;0;0;0;.00nan;0;0
242;43757;12;0;0;0;0;.00nan;0;0
242;59540;14;50;23;3;20;.870;3560000;0
242;85798;12;77;30;2;28;.933;3600000;0
243;9235;4838;0;0;0;0;.00nan;0;0
243;143749;4838;72;42;5;37;.881;3896000;0
243;144705;17;64;41;4;37;.902;3896000;0
243;146862;17;0;0;0;0;.00nan;0;0
244;20693;24;74;26;2;24;.923;3600000;0
244;57338;24;0;0;0;0;.00nan;0;0
244;69536;10;49;7;1;6;.857;877000;0
244;152717;10;37;31;6;25;.806;2723000;0
245;20432;31;36;30;6;24;.800;2424000;0
245;174718;25;36;26;5;21;.808;3600000;0
245;86360;31;46;7;1;6;.857;1094000;0
245;148958;25;0;0;0;0;.00nan;0;0
246;2059;23;0;0;0;0;.00nan;0;0
246;176995;30;0;0;0;0;.00nan;0;0
246;36674;30;61;16;1;15;.938;3600000;0
246;65762;23;48;34;5;29;.853;3600000;0
247;848;22;22;19;6;13;.684;3600000;0
247;987;22;0;0;0;0;.00nan;0;0
247;169868;4182;81;39;3;36;.923;3600000;0
247;147945;4182;0;0;0;0;.00nan;0;0
248;166381;27;0;0;0;0;.00nan;0;0
248;175660;27;84;33;2;31;.939;3600000;0
248;37818;29;84;40;3;37;.925;3569000;0
248;152710;29;0;0;0;0;.00nan;0;0
249;841;11;55;25;3;22;.880;3600000;0
249;31972;11;0;0;0;0;.00nan;0;0
249;141998;35;0;0;0;0;.00nan;0;0
249;143473;35;48;51;8;43;.843;3600000;0
250;166751;5;84;42;3;39;.929;3600000;0
250;8424;28;64;14;1;13;.929;3600000;0
250;36755;5;0;0;0;0;.00nan;0;0
250;152835;28;0;0;0;0;.00nan;0;0
251;19391;32;0;0;0;0;.00nan;0;0
251;46492;0;0;0;0;0;.00nan;0;0
251;58830;32;75;41;3;38;.927;3557000;0
251;91178;0;99;37;1;36;.973;3600000;0
252;163565;19;55;35;4;31;.886;3583000;0
252;14305;19;0;0;0;0;.00nan;0;0
252;37818;29;0;0;0;0;.00nan;0;0
252;152710;29;60;30;3;27;.900;3600000;0
253;556;3;100;48;2;46;.958;3600000;0
253;615;3;0;0;0;0;.00nan;0;0
253;166646;16;0;0;0;0;.00nan;0;0
253;53842;16;11;12;5;7;.583;3600000;0
254;676;34;54;25;3;22;.880;4200000;0
254;9235;4838;0;0;0;0;.00nan;0;0
254;78806;34;0;0;0;0;.00nan;0;0
254;143749;4838;75;37;3;34;.919;4200000;0
255;1669;33;36;31;5;26;.839;3600000;0
255;174718;25;60;30;3;27;.900;3600000;0
255;148958;25;0;0;0;0;.00nan;0;0
255;149452;33;0;0;0;0;.00nan;0;0
256;167642;18;0;0;0;0;.00nan;0;0
256;20432;31;0;0;0;0;.00nan;0;0
256;55802;18;81;38;2;36;.947;3564000;0
256;86360;31;72;18;1;17;.944;3600000;0
257;163695;9;0;0;0;0;.00nan;0;0
257;175092;9;63;42;5;37;.881;3576000;0
257;144705;17;0;0;0;0;.00nan;0;0
257;146862;17;60;22;3;19;.864;3600000;0
258;20693;24;89;37;2;35;.946;3555000;0
258;57338;24;0;0;0;0;.00nan;0;0
258;57859;15;0;0;0;0;.00nan;0;0
258;85727;15;77;18;1;17;.944;3600000;0
259;848;22;39;29;5;24;.828;3600000;0
259;987;22;0;0;0;0;.00nan;0;0
259;176995;30;0;0;0;0;.00nan;0;0
259;36674;30;61;27;4;23;.852;3600000;0
260;69536;10;82;39;3;36;.923;4200000;0
260;86192;21;72;32;3;29;.906;4200000;0
260;143156;21;0;0;0;0;.00nan;0;0
260;152717;10;0;0;0;0;.00nan;0;0
261;19391;32;82;34;3;31;.912;3553000;0
261;43757;12;0;0;0;0;.00nan;0;0
261;58830;32;0;0;0;0;.00nan;0;0
261;85798;12;99;36;1;35;.972;3600000;0
262;14866;20;100;29;0;29;1.000;3600000;0
262;168712;14;0;0;0;0;.00nan;0;0
262;34745;20;0;0;0;0;.00nan;0;0
262;59540;14;75;32;3;29;.906;3600000;0
263;5311;8;0;0;0;0;.00nan;0;0
263;163423;26;65;36;4;32;.889;3551000;0
263;13714;8;85;37;3;34;.919;3600000;0
263;179154;26;0;0;0;0;.00nan;0;0
264;2059;23;52;22;3;19;.864;3600000;0
264;169868;4182;0;0;0;0;.00nan;0;0
264;65762;23;0;0;0;0;.00nan;0;0
264;147945;4182;70;43;4;39;.907;3583000;0
265;166381;27;0;0;0;0;.00nan;0;0
265;175660;27;81;28;2;26;.929;3600000;0
265;141998;35;19;29;7;22;.759;1880000;0
265;143473;35;76;17;0;17;1.000;1720000;0
266;166646;16;51;30;4;26;.867;3600000;0
266;8424;28;0;0;0;0;.00nan;0;0
266;53842;16;0;0;0;0;.00nan;0;0
266;152835;28;100;19;0;19;1.000;3600000;0
267;676;34;0;0;0;0;.00nan;0;0
267;168712;14;0;0;0;0;.00nan;0;0
267;59540;14;39;33;6;27;.818;3600000;0
267;78806;34;82;38;3;35;.921;3600000;0
268;9235;4838;73;46;5;41;.891;3600000;0
268;20693;24;0;0;0;0;.00nan;0;0
268;57338;24;53;15;2;13;.867;3600000;0
268;143749;4838;0;0;0;0;.00nan;0;0
269;174718;25;0;0;0;0;.00nan;0;0
269;46492;0;0;0;0;0;.00nan;0;0
269;91178;0;85;33;3;30;.909;3600000;0
269;148958;25;45;25;4;21;.840;3544000;0
270;163565;19;0;0;0;0;.00nan;0;0
270;14305;19;69;26;2;24;.923;3600000;0
270;141998;35;0;0;0;0;.00nan;0;0
270;143473;35;62;37;4;33;.892;3560000;0
271;167642;18;0;0;0;0;.00nan;0;0
271;37818;29;100;31;0;31;1.000;3600000;0
271;55802;18;77;32;2;30;.938;3568000;0
271;152710;29;0;0;0;0;.00nan;0;0
272;163695;9;44;27;4;23;.852;3600000;0
272;20432;31;81;11;0;11;1.000;3600000;0
272;175092;9;0;0;0;0;.00nan;0;0
272;86360;31;0;0;0;0;.00nan;0;0
273;163423;26;0;0;0;0;.00nan;0;0
273;179154;26;60;29;3;26;.897;3600000;0
273;86192;21;77;29;2;27;.931;3600000;0
273;143156;21;0;0;0;0;.00nan;0;0
274;1669;33;0;0;0;0;.00nan;0;0
274;5311;8;0;0;0;0;.00nan;0;0
274;13714;8;94;34;2;32;.941;3839000;0
274;149452;33;96;49;1;48;.980;3839000;0
275;166381;27;0;0;0;0;.00nan;0;0
275;175660;27;75;31;2;29;.935;4200000;0
275;43757;12;0;0;0;0;.00nan;0;0
275;85798;12;77;35;2;33;.943;4200000;0
276;169868;4182;52;30;4;26;.867;4178000;0
276;176995;30;0;0;0;0;.00nan;0;0
276;36674;30;72;33;3;30;.909;4178000;0
276;147945;4182;0;0;0;0;.00nan;0;0
277;841;11;0;0;0;0;.00nan;0;0
277;2059;23;78;36;3;33;.917;3600000;0
277;31972;11;44;26;5;21;.808;3581000;0
277;65762;23;0;0;0;0;.00nan;0;0
278;167642;18;0;0;0;0;.00nan;0;0
278;55802;18;66;32;4;28;.875;3545000;0
278;57859;15;0;0;0;0;.00nan;0;0
278;85727;15;48;19;3;16;.842;3600000;0
279;168712;14;68;16;1;15;.938;3204000;0
279;174718;25;66;30;5;25;.833;3672000;0
279;59540;14;35;9;3;6;.667;468000;0
279;148958;25;0;0;0;0;.00nan;0;0
280;166751;5;0;0;0;0;.00nan;0;0
280;36755;5;60;38;4;34;.895;3600000;0
280;69536;10;0;0;0;0;.00nan;0;0
280;152717;10;91;22;0;22;1.000;3600000;0
281;163695;9;0;0;0;0;.00nan;0;0
281;175092;9;61;45;6;39;.867;3600000;0
281;37818;29;65;30;4;26;.867;3600000;0
281;152710;29;0;0;0;0;.00nan;0;0
282;20693;24;50;33;5;28;.848;3600000;0
282;57338;24;0;0;0;0;.00nan;0;0
282;86192;21;77;30;2;28;.933;3600000;0
282;143156;21;0;0;0;0;.00nan;0;0
283;19391;32;0;0;0;0;.00nan;0;0
283;20432;31;99;26;0;26;1.000;3600000;0
283;58830;32;46;41;6;35;.854;3600000;0
283;86360;31;0;0;0;0;.00nan;0;0
284;14866;20;63;27;3;24;.889;3600000;0
284;34745;20;0;0;0;0;.00nan;0;0
284;46492;0;0;0;0;0;.00nan;0;0
284;91178;0;67;45;5;40;.889;3600000;0
285;676;34;60;24;2;22;.917;4200000;0
285;848;22;0;0;0;0;.00nan;0;0
285;987;22;81;34;2;32;.941;4200000;0
285;78806;34;0;0;0;0;.00nan;0;0
286;43757;12;0;0;0;0;.00nan;0;0
286;85798;12;64;23;2;21;.913;3600000;0
286;141998;35;49;23;3;20;.870;3549000;0
286;143473;35;0;0;0;0;.00nan;0;0
287;1669;33;0;0;0;0;.00nan;0;0
287;176995;30;0;0;0;0;.00nan;0;0
287;36674;30;62;32;3;29;.906;3911000;0
287;149452;33;94;45;4;41;.911;3911000;0
288;163423;26;0;0;0;0;.00nan;0;0
288;9235;4838;34;35;7;28;.800;3600000;0
288;179154;26;63;30;3;27;.900;3600000;0
288;143749;4838;0;0;0;0;.00nan;0;0
289;163565;19;81;27;1;26;.963;3600000;0
289;14305;19;0;0;0;0;.00nan;0;0
289;144705;17;0;0;0;0;.00nan;0;0
289;146862;17;93;33;2;31;.939;3547000;0
290;2059;23;85;35;3;32;.914;3567000;0
290;5311;8;0;0;0;0;.00nan;0;0
290;13714;8;55;15;2;13;.867;3600000;0
290;65762;23;0;0;0;0;.00nan;0;0
291;841;11;0;0;0;0;.00nan;0;0
291;169868;4182;0;0;0;0;.00nan;0;0
291;31972;11;69;31;3;28;.903;3557000;0
291;147945;4182;70;25;2;23;.920;3600000;0
292;166751;5;0;0;0;0;.00nan;0;0
292;163695;9;91;32;1;31;.969;3600000;0
292;175092;9;0;0;0;0;.00nan;0;0
292;36755;5;67;27;2;25;.926;3600000;0
293;676;34;100;28;0;28;1.000;3600000;0
293;78806;34;0;0;0;0;.00nan;0;0
293;86192;21;97;45;2;43;.956;3558000;0
293;143156;21;0;0;0;0;.00nan;0;0
294;8424;28;0;0;0;0;.00nan;0;0
294;174718;25;52;19;2;17;.895;1835000;0
294;148958;25;12;22;7;15;.682;1765000;0
294;152835;28;71;28;3;25;.893;3600000;0
295;168712;14;0;0;0;0;.00nan;0;0
295;59540;14;75;32;2;30;.938;3600000;0
295;69536;10;0;0;0;0;.00nan;0;0
295;152717;10;30;31;6;25;.806;3600000;0
296;1669;33;0;0;0;0;.00nan;0;0
296;141998;35;0;0;0;0;.00nan;0;0
296;143473;35;58;25;3;22;.880;3600000;0
296;149452;33;73;42;5;37;.881;3526000;0
297;167642;18;0;0;0;0;.00nan;0;0
297;14866;20;0;0;0;0;.00nan;0;0
297;34745;20;100;26;0;26;1.000;3600000;0
297;55802;18;81;54;6;48;.889;3600000;0
298;163565;19;0;0;0;0;.00nan;0;0
298;14305;19;56;35;5;30;.857;3600000;0
298;166381;27;0;0;0;0;.00nan;0;0
298;175660;27;68;25;2;23;.920;3600000;0
299;841;11;0;0;0;0;.00nan;0;0
299;31972;11;75;36;3;33;.917;3600000;0
299;144705;17;0;0;0;0;.00nan;0;0
299;146862;17;50;28;4;24;.857;3563000;0
300;20693;24;29;13;4;9;.692;2174000;0
300;46492;0;0;0;0;0;.00nan;0;0
300;57338;24;64;10;0;10;1.000;1426000;0
300;91178;0;37;43;7;36;.837;3600000;0
301;556;3;59;45;6;39;.867;3577000;0
301;615;3;0;0;0;0;.00nan;0;0
301;848;22;0;0;0;0;.00nan;0;0
301;987;22;51;19;3;16;.842;3600000;0
302;20432;31;92;46;3;43;.935;3600000;0
302;57859;15;57;29;4;25;.862;3600000;0
302;85727;15;0;0;0;0;.00nan;0;0
302;86360;31;0;0;0;0;.00nan;0;0
303;19391;32;0;0;0;0;.00nan;0;0
303;37818;29;67;20;2;18;.900;3600000;0
303;58830;32;76;46;4;42;.913;3532000;0
303;152710;29;0;0;0;0;.00nan;0;0
304;163423;26;66;9;0;9;1.000;1250000;0
304;179154;26;20;23;6;17;.739;2350000;0
304;176995;30;0;0;0;0;.00nan;0;0
304;36674;30;100;24;0;24;1.000;3600000;0
305;166646;16;0;0;0;0;.00nan;0;0
305;5311;8;0;0;0;0;.00nan;0;0
305;13714;8;73;41;4;37;.902;3544000;0
305;53842;16;58;21;3;18;.857;3600000;0
306;2059;23;62;27;3;24;.889;3580000;0
306;169868;4182;0;0;0;0;.00nan;0;0
306;65762;23;0;0;0;0;.00nan;0;0
306;147945;4182;71;19;1;18;.947;3600000;0
307;163695;9;0;0;0;0;.00nan;0;0
307;175092;9;89;33;2;31;.939;3600000;0
307;86192;21;0;0;0;0;.00nan;0;0
307;143156;21;58;37;5;32;.865;3600000;0
308;166381;27;65;25;2;23;.920;3600000;0
308;175660;27;0;0;0;0;.00nan;0;0
308;144705;17;40;37;6;31;.838;2023000;0
308;146862;17;65;10;0;10;1.000;1577000;0
309;46492;0;90;36;2;34;.944;3545000;0
309;69536;10;95;38;1;37;.974;3600000;0
309;91178;0;0;0;0;0;.00nan;0;0
309;152717;10;0;0;0;0;.00nan;0;0
310;8424;28;74;43;4;39;.907;3547000;0
310;20693;24;60;26;3;23;.885;3600000;0
310;57338;24;0;0;0;0;.00nan;0;0
310;152835;28;0;0;0;0;.00nan;0;0
311;676;34;72;45;5;40;.889;3600000;0
311;848;22;65;16;1;15;.938;3600000;0
311;987;22;0;0;0;0;.00nan;0;0
311;78806;34;0;0;0;0;.00nan;0;0
312;5311;8;85;26;1;25;.962;3600000;0
312;13714;8;0;0;0;0;.00nan;0;0
312;176995;30;0;0;0;0;.00nan;0;0
312;36674;30;52;33;5;28;.848;3600000;0
313;841;11;99;34;1;33;.971;3600000;0
313;2059;23;37;27;5;22;.815;3600000;0
313;31972;11;0;0;0;0;.00nan;0;0
313;65762;23;0;0;0;0;.00nan;0;0
314;9235;4838;0;0;0;0;.00nan;0;0
314;43757;12;0;0;0;0;.00nan;0;0
314;85798;12;67;27;3;24;.889;3600000;0
314;143749;4838;49;27;5;22;.815;3539000;0
315;166646;16;0;0;0;0;.00nan;0;0
315;166751;5;0;0;0;0;.00nan;0;0
315;36755;5;80;30;2;28;.933;3600000;0
315;53842;16;57;31;3;28;.903;3585000;0
316;174718;25;66;33;3;30;.909;4200000;0
316;141998;35;55;31;3;28;.903;4200000;0
316;143473;35;0;0;0;0;.00nan;0;0
316;148958;25;0;0;0;0;.00nan;0;0
317;168712;14;0;0;0;0;.00nan;0;0
317;57859;15;64;24;2;22;.917;3600000;0
317;59540;14;66;45;5;40;.889;3600000;0
317;85727;15;0;0;0;0;.00nan;0;0
318;1669;33;0;0;0;0;.00nan;0;0
318;19391;32;0;0;0;0;.00nan;0;0
318;58830;32;52;37;5;32;.865;3600000;0
318;149452;33;84;37;2;35;.946;3600000;0
319;163565;19;0;0;0;0;.00nan;0;0
319;167642;18;85;30;1;29;.967;3600000;0
319;14305;19;69;38;3;35;.921;3553000;0
319;55802;18;0;0;0;0;.00nan;0;0
320;163695;9;95;38;1;37;.974;3600000;0
320;168712;14;32;17;4;13;.765;3600000;0
320;175092;9;0;0;0;0;.00nan;0;0
320;59540;14;0;0;0;0;.00nan;0;0
321;46492;0;0;0;0;0;.00nan;0;0
321;86192;21;47;29;4;25;.862;3600000;0
321;91178;0;58;40;5;35;.875;3600000;0
321;143156;21;0;0;0;0;.00nan;0;0
322;556;3;68;23;2;21;.913;3600000;0
322;615;3;0;0;0;0;.00nan;0;0
322;37818;29;50;28;4;24;.857;3598000;0
322;152710;29;0;0;0;0;.00nan;0;0
323;5311;8;0;0;0;0;.00nan;0;0
323;13714;8;56;20;3;17;.850;3636000;0
323;20432;31;73;33;4;29;.879;3636000;0
323;86360;31;0;0;0;0;.00nan;0;0
324;9235;4838;58;58;6;52;.897;4200000;0
324;176995;30;27;28;6;22;.786;2550000;0
324;36674;30;48;2;0;2;1.000;1650000;0
324;143749;4838;0;0;0;0;.00nan;0;0
325;841;11;0;0;0;0;.00nan;0;0
325;14866;20;0;0;0;0;.00nan;0;0
325;31972;11;62;35;4;31;.886;3563000;0
325;34745;20;62;23;2;21;.913;3600000;0
326;848;22;0;0;0;0;.00nan;0;0
326;987;22;59;33;4;29;.879;3600000;0
326;69536;10;86;33;3;30;.909;3600000;0
326;152717;10;0;0;0;0;.00nan;0;0
327;676;34;80;27;1;26;.963;3600000;0
327;57859;15;56;25;3;22;.880;3546000;0
327;78806;34;0;0;0;0;.00nan;0;0
327;85727;15;0;0;0;0;.00nan;0;0
328;8424;28;0;0;0;0;.00nan;0;0
328;37818;29;0;0;0;0;.00nan;0;0
328;152710;29;39;26;5;21;.808;3600000;0
328;152835;28;100;38;0;38;1.000;3600000;0
329;166646;16;0;0;0;0;.00nan;0;0
329;53842;16;37;29;5;24;.828;3927000;0
329;141998;35;50;36;6;30;.833;3927000;0
329;143473;35;0;0;0;0;.00nan;0;0
330;1669;33;0;0;0;0;.00nan;0;0
330;20693;24;0;0;0;0;.00nan;0;0
330;57338;24;98;28;1;27;.964;3600000;0
330;149452;33;38;37;6;31;.838;3600000;0
331;163423;26;0;0;0;0;.00nan;0;0
331;19391;32;0;0;0;0;.00nan;0;0
331;179154;26;34;38;7;31;.816;3600000;0
331;58830;32;77;31;2;29;.935;3600000;0
332;169868;4182;0;0;0;0;.00nan;0;0
332;174718;25;0;0;0;0;.00nan;0;0
332;147945;4182;38;31;6;25;.806;3600000;0
332;148958;25;71;28;2;26;.929;3600000;0
333;20432;31;68;38;4;34;.895;3669000;0
333;43757;12;0;0;0;0;.00nan;0;0
333;85798;12;76;33;3;30;.909;3669000;0
333;86360;31;0;0;0;0;.00nan;0;0
334;9235;4838;0;0;0;0;.00nan;0;0
334;167642;18;0;0;0;0;.00nan;0;0
334;55802;18;76;24;2;22;.917;3600000;0
334;143749;4838;58;35;5;30;.857;3600000;0
335;2059;23;100;30;1;29;.967;4165000;0
335;163565;19;80;28;2;26;.929;4165000;0
335;14305;19;0;0;0;0;.00nan;0;0
335;65762;23;0;0;0;0;.00nan;0;0
336;168712;14;0;0;0;0;.00nan;0;0
336;59540;14;71;26;1;25;.962;4200000;0
336;144705;17;0;0;0;0;.00nan;0;0
336;146862;17;95;52;1;51;.981;4200000;0
337;166751;5;0;0;0;0;.00nan;0;0
337;36755;5;73;38;4;34;.895;3600000;0
337;86192;21;69;21;1;20;.952;3600000;0
337;143156;21;0;0;0;0;.00nan;0;0
338;14866;20;63;30;3;27;.900;3600000;0
338;166381;27;0;0;0;0;.00nan;0;0
338;175660;27;59;33;4;29;.879;3600000;0
338;34745;20;0;0;0;0;.00nan;0;0
339;841;11;0;0;0;0;.00nan;0;0
339;163695;9;63;23;2;21;.913;3600000;0
339;175092;9;0;0;0;0;.00nan;0;0
339;31972;11;76;39;3;36;.923;3600000;0
340;848;22;0;0;0;0;.00nan;0;0
340;987;22;72;34;4;30;.882;3517000;0
340;57859;15;0;0;0;0;.00nan;0;0
340;85727;15;78;29;2;27;.931;3600000;0
341;166751;5;100;47;2;45;.957;3600000;0
341;174718;25;60;24;3;21;.875;3545000;0
341;36755;5;0;0;0;0;.00nan;0;0
341;148958;25;0;0;0;0;.00nan;0;0
342;37818;29;81;25;1;24;.960;3600000;0
342;144705;17;52;38;5;33;.868;3600000;0
342;146862;17;0;0;0;0;.00nan;0;0
342;152710;29;0;0;0;0;.00nan;0;0
343;676;34;87;39;3;36;.923;3509000;0
343;69536;10;92;26;1;25;.962;3600000;0
343;78806;34;0;0;0;0;.00nan;0;0
343;152717;10;0;0;0;0;.00nan;0;0
344;20432;31;0;0;0;0;.00nan;0;0
344;20693;24;0;0;0;0;.00nan;0;0
344;57338;24;78;24;1;23;.958;3600000;0
344;86360;31;42;40;6;34;.850;3600000;0
345;8424;28;0;0;0;0;.00nan;0;0
345;169868;4182;0;0;0;0;.00nan;0;0
345;147945;4182;69;26;2;24;.923;4200000;0
345;152835;28;85;30;2;28;.933;4200000;0
346;166646;16;0;0;0;0;.00nan;0;0
346;1669;33;0;0;0;0;.00nan;0;0
346;53842;16;63;38;4;34;.895;3600000;0
346;149452;33;98;37;1;36;.973;3600000;0
347;46492;0;0;0;0;0;.00nan;0;0
347;91178;0;84;36;2;34;.944;3600000;0
347;141998;35;0;0;0;0;.00nan;0;0
347;143473;35;53;33;6;27;.818;3600000;0
348;167642;18;0;0;0;0;.00nan;0;0
348;19391;32;42;19;4;15;.789;3545000;0
348;55802;18;82;29;3;26;.897;3600000;0
348;58830;32;0;0;0;0;.00nan;0;0
349;5311;8;0;0;0;0;.00nan;0;0
349;13714;8;53;33;5;28;.848;3578000;0
349;43757;12;0;0;0;0;.00nan;0;0
349;85798;12;62;30;4;26;.867;3600000;0
350;163423;26;0;0;0;0;.00nan;0;0
350;179154;26;97;37;1;36;.973;4200000;0
350;176995;30;0;0;0;0;.00nan;0;0
350;36674;30;85;31;1;30;.968;4200000;0
351;163565;19;0;0;0;0;.00nan;0;0
351;14305;19;29;33;7;26;.788;3515000;0
351;14866;20;0;0;0;0;.00nan;0;0
351;34745;20;49;28;5;23;.821;3600000;0
352;2059;23;73;23;2;21;.913;3798000;0
352;9235;4838;0;0;0;0;.00nan;0;0
352;65762;23;0;0;0;0;.00nan;0;0
352;143749;4838;100;45;1;44;.978;3798000;0
353;556;3;68;31;2;29;.935;3525000;0
353;615;3;0;0;0;0;.00nan;0;0
353;168712;14;0;0;0;0;.00nan;0;0
353;59540;14;88;21;0;21;1.000;3600000;0
354;841;11;65;26;2;24;.923;3595000;0
354;31972;11;0;0;0;0;.00nan;0;0
354;69536;10;0;0;0;0;.00nan;0;0
354;152717;10;96;24;0;24;1.000;3600000;0
355;163423;26;79;47;5;42;.894;3600000;0
355;20432;31;91;19;0;19;1.000;3600000;0
355;179154;26;0;0;0;0;.00nan;0;0
355;86360;31;0;0;0;0;.00nan;0;0
356;19391;32;0;0;0;0;.00nan;0;0
356;174718;25;54;27;3;24;.889;3870000;0
356;58830;32;77;43;4;39;.907;3870000;0
356;148958;25;0;0;0;0;.00nan;0;0
357;1669;33;0;0;0;0;.00nan;0;0
357;86192;21;76;32;3;29;.906;4200000;0
357;143156;21;0;0;0;0;.00nan;0;0
357;149452;33;93;43;3;40;.930;4200000;0
358;848;22;0;0;0;0;.00nan;0;0
358;987;22;45;20;3;17;.850;3550000;0
358;37818;29;88;37;2;35;.946;3600000;0
358;152710;29;0;0;0;0;.00nan;0;0
359;46492;0;48;8;1;7;.875;933000;0
359;57859;15;0;0;0;0;.00nan;0;0
359;85727;15;54;36;5;31;.861;3600000;0
359;91178;0;44;36;6;30;.833;2667000;0
360;166751;5;0;0;0;0;.00nan;0;0
360;36755;5;86;49;3;46;.939;4200000;0
360;144705;17;0;0;0;0;.00nan;0;0
360;146862;17;55;23;3;20;.870;4200000;0
361;556;3;69;29;2;27;.931;4200000;0
361;615;3;0;0;0;0;.00nan;0;0
361;169868;4182;74;30;2;28;.933;4200000;0
361;147945;4182;0;0;0;0;.00nan;0;0
362;676;34;60;26;3;23;.885;3523000;0
362;20693;24;92;40;2;38;.950;3600000;0
362;57338;24;0;0;0;0;.00nan;0;0
362;78806;34;0;0;0;0;.00nan;0;0
363;163695;9;0;0;0;0;.00nan;0;0
363;8424;28;0;0;0;0;.00nan;0;0
363;175092;9;63;22;2;20;.909;3600000;0
363;152835;28;83;36;3;33;.917;3560000;0
364;43757;12;0;0;0;0;.00nan;0;0
364;85798;12;91;19;0;19;1.000;3600000;0
364;141998;35;65;36;4;32;.889;3600000;0
364;143473;35;0;0;0;0;.00nan;0;0
365;5311;8;0;0;0;0;.00nan;0;0
365;163565;19;99;40;1;39;.975;3600000;0
365;13714;8;35;33;6;27;.818;3600000;0
365;14305;19;0;0;0;0;.00nan;0;0
366;2059;23;90;46;2;44;.957;3600000;0
366;176995;30;0;0;0;0;.00nan;0;0
366;36674;30;52;21;3;18;.857;3533000;0
366;65762;23;0;0;0;0;.00nan;0;0
367;9235;4838;80;51;5;46;.902;3600000;0
367;14866;20;72;19;1;18;.947;3600000;0
367;34745;20;0;0;0;0;.00nan;0;0
367;143749;4838;0;0;0;0;.00nan;0;0
368;166646;16;72;33;2;31;.939;3600000;0
368;174718;25;0;0;0;0;.00nan;0;0
368;53842;16;0;0;0;0;.00nan;0;0
368;148958;25;59;43;5;38;.884;3600000;0
369;841;11;0;0;0;0;.00nan;0;0
369;31972;11;41;24;4;20;.833;3546000;0
369;86192;21;0;0;0;0;.00nan;0;0
369;143156;21;77;30;2;28;.933;3600000;0
370;163695;9;70;31;3;28;.903;3600000;0
370;168712;14;0;0;0;0;.00nan;0;0
370;175092;9;0;0;0;0;.00nan;0;0
370;59540;14;68;36;4;32;.889;3595000;0
371;1669;33;41;39;7;32;.821;3600000;0
371;46492;0;0;0;0;0;.00nan;0;0
371;91178;0;83;35;3;32;.914;3600000;0
371;149452;33;0;0;0;0;.00nan;0;0
372;5311;8;56;36;5;31;.861;3543000;0
372;13714;8;0;0;0;0;.00nan;0;0
372;166381;27;0;0;0;0;.00nan;0;0
372;175660;27;57;34;4;30;.882;3600000;0
373;676;34;0;0;0;0;.00nan;0;0
373;20693;24;61;24;2;22;.917;3546000;0
373;57338;24;0;0;0;0;.00nan;0;0
373;78806;34;71;20;1;19;.950;3600000;0
374;163423;26;0;0;0;0;.00nan;0;0
374;20432;31;57;26;4;22;.846;3607000;0
374;179154;26;87;43;3;40;.930;3590000;0
374;86360;31;0;0;0;0;.00nan;0;0
375;169868;4182;0;0;0;0;.00nan;0;0
375;144705;17;67;43;5;38;.884;3550000;0
375;146862;17;0;0;0;0;.00nan;0;0
375;147945;4182;50;23;3;20;.870;3600000;0
376;19391;32;0;0;0;0;.00nan;0;0
376;57859;15;0;0;0;0;.00nan;0;0
376;58830;32;83;29;1;28;.966;3600000;0
376;85727;15;74;33;2;31;.939;3559000;0
377;14866;20;64;18;2;16;.889;3557000;0
377;34745;20;0;0;0;0;.00nan;0;0
377;43757;12;0;0;0;0;.00nan;0;0
377;85798;12;100;36;1;35;.972;3600000;0
378;9235;4838;0;0;0;0;.00nan;0;0
378;141998;35;0;0;0;0;.00nan;0;0
378;143473;35;46;17;3;14;.824;3600000;0
378;143749;4838;93;57;4;53;.930;3600000;0
379;166751;5;0;0;0;0;.00nan;0;0
379;36755;5;64;34;4;30;.882;3600000;0
379;46492;0;0;0;0;0;.00nan;0;0
379;91178;0;94;18;0;18;1.000;3600000;0
380;166381;27;0;0;0;0;.00nan;0;0
380;168712;14;0;0;0;0;.00nan;0;0
380;175660;27;56;25;3;22;.880;3600000;0
380;59540;14;76;27;2;25;.926;3600000;0
381;556;3;75;43;4;39;.907;3828000;0
381;615;3;0;0;0;0;.00nan;0;0
381;86192;21;44;25;5;20;.800;3828000;0
381;143156;21;0;0;0;0;.00nan;0;0
382;841;11;0;0;0;0;.00nan;0;0
382;848;22;0;0;0;0;.00nan;0;0
382;987;22;69;19;1;18;.947;3600000;0
382;31972;11;62;49;6;43;.878;3600000;0
383;1669;33;0;0;0;0;.00nan;0;0
383;174718;25;60;31;4;27;.871;3600000;0
383;148958;25;0;0;0;0;.00nan;0;0
383;149452;33;25;28;6;22;.786;3530000;0
384;166646;16;0;0;0;0;.00nan;0;0
384;176995;30;0;0;0;0;.00nan;0;0
384;36674;30;87;36;2;34;.944;3547000;0
384;53842;16;100;34;0;34;1.000;3600000;0
385;5311;8;0;0;0;0;.00nan;0;0
385;163565;19;0;0;0;0;.00nan;0;0
385;13714;8;44;26;5;21;.808;3874000;0
385;14305;19;67;46;6;40;.870;3874000;0
386;2059;23;66;25;2;23;.920;3600000;0
386;65762;23;0;0;0;0;.00nan;0;0
386;69536;10;0;0;0;0;.00nan;0;0
386;152717;10;90;55;5;50;.909;3600000;0
387;163423;26;0;0;0;0;.00nan;0;0
387;179154;26;90;44;2;42;.955;3558000;0
387;37818;29;64;16;1;15;.938;3600000;0
387;152710;29;0;0;0;0;.00nan;0;0
388;20432;31;34;18;4;14;.778;1835000;0
388;20693;24;93;48;4;44;.917;3600000;0
388;57338;24;0;0;0;0;.00nan;0;0
388;86360;31;53;12;1;11;.917;1709000;0
389;9235;4838;78;42;3;39;.929;3600000;0
389;141998;35;64;20;2;18;.900;3600000;0
389;143473;35;0;0;0;0;.00nan;0;0
389;143749;4838;0;0;0;0;.00nan;0;0
390;167642;18;0;0;0;0;.00nan;0;0
390;55802;18;82;42;4;38;.905;3566000;0
390;57859;15;82;19;1;18;.947;3600000;0
390;85727;15;0;0;0;0;.00nan;0;0
391;163695;9;0;0;0;0;.00nan;0;0
391;175092;9;74;33;3;30;.909;3600000;0
391;46492;0;0;0;0;0;.00nan;0;0
391;91178;0;51;36;5;31;.861;3533000;0
392;841;11;0;0;0;0;.00nan;0;0
392;166751;5;0;0;0;0;.00nan;0;0
392;31972;11;97;31;1;30;.968;3600000;0
392;36755;5;62;33;4;29;.879;3600000;0
393;166381;27;0;0;0;0;.00nan;0;0
393;175660;27;69;36;3;33;.917;3598000;0
393;144705;17;0;0;0;0;.00nan;0;0
393;146862;17;85;33;2;31;.939;3600000;0
394;556;3;65;19;2;17;.895;3600000;0
394;615;3;0;0;0;0;.00nan;0;0
394;8424;28;0;0;0;0;.00nan;0;0
394;152835;28;86;46;3;43;.935;3566000;0
395;163423;26;26;6;3;3;.500;575000;0
395;14866;20;0;0;0;0;.00nan;0;0
395;179154;26;94;44;2;42;.955;3025000;0
395;34745;20;73;21;1;20;.952;3600000;0
396;848;22;78;31;2;29;.935;3600000;0
396;987;22;0;0;0;0;.00nan;0;0
396;168712;14;0;0;0;0;.00nan;0;0
396;59540;14;41;30;5;25;.833;3600000;0
397;1669;33;0;0;0;0;.00nan;0;0
397;20432;31;78;36;3;33;.917;3578000;0
397;86360;31;0;0;0;0;.00nan;0;0
397;149452;33;82;24;1;23;.958;3600000;0
398;163565;19;0;0;0;0;.00nan;0;0
398;14305;19;67;37;5;32;.865;4200000;0
398;174718;25;40;33;5;28;.848;4164000;0
398;148958;25;0;0;0;0;.00nan;0;0
399;676;34;98;42;2;40;.952;3600000;0
399;43757;12;0;0;0;0;.00nan;0;0
399;78806;34;0;0;0;0;.00nan;0;0
399;85798;12;72;22;1;21;.955;3600000;0
400;176995;30;0;0;0;0;.00nan;0;0
400;36674;30;61;35;4;31;.886;3535000;0
400;57859;15;0;0;0;0;.00nan;0;0
400;85727;15;48;19;3;16;.842;3600000;0
401;5311;8;0;0;0;0;.00nan;0;0
401;13714;8;85;33;2;31;.939;3600000;0
401;19391;32;71;33;3;30;.909;3600000;0
401;58830;32;0;0;0;0;.00nan;0;0
402;169868;4182;0;0;0;0;.00nan;0;0
402;69536;10;0;0;0;0;.00nan;0;0
402;147945;4182;65;30;3;27;.900;3600000;0
402;152717;10;73;42;4;38;.905;3569000;0
403;166646;16;0;0;0;0;.00nan;0;0
403;2059;23;88;35;2;33;.943;3600000;0
403;53842;16;63;37;4;33;.892;3600000;0
403;65762;23;0;0;0;0;.00nan;0;0
404;168712;14;0;0;0;0;.00nan;0;0
404;59540;14;64;15;1;14;.933;3600000;0
404;141998;35;0;0;0;0;.00nan;0;0
404;143473;35;51;31;5;26;.839;3600000;0
405;20693;24;84;34;2;32;.941;3600000;0
405;37818;29;53;36;5;31;.861;3600000;0
405;57338;24;0;0;0;0;.00nan;0;0
405;152710;29;0;0;0;0;.00nan;0;0
406;166646;16;62;36;4;32;.889;3600000;0
406;167642;18;58;27;3;24;.889;3600000;0
406;53842;16;0;0;0;0;.00nan;0;0
406;55802;18;0;0;0;0;.00nan;0;0
407;163695;9;84;29;1;28;.966;3600000;0
407;175092;9;0;0;0;0;.00nan;0;0
407;43757;12;0;0;0;0;.00nan;0;0
407;85798;12;56;27;3;24;.889;3537000;0
408;176995;30;0;0;0;0;.00nan;0;0
408;36674;30;59;35;5;30;.857;3558000;0
408;69536;10;0;0;0;0;.00nan;0;0
408;152717;10;57;30;4;26;.867;3600000;0
409;163423;26;0;0;0;0;.00nan;0;0
409;9235;4838;0;0;0;0;.00nan;0;0
409;179154;26;56;17;2;15;.882;3600000;0
409;143749;4838;83;57;5;52;.912;3600000;0
410;46492;0;0;0;0;0;.00nan;0;0
410;91178;0;82;26;1;25;.962;3600000;0
410;144705;17;0;0;0;0;.00nan;0;0
410;146862;17;82;33;2;31;.939;3579000;0
411;556;3;73;22;1;21;.955;3600000;0
411;615;3;0;0;0;0;.00nan;0;0
411;166751;5;0;0;0;0;.00nan;0;0
411;36755;5;70;40;4;36;.900;3600000;0
412;1669;33;0;0;0;0;.00nan;0;0
412;8424;28;0;0;0;0;.00nan;0;0
412;149452;33;74;33;3;30;.909;3600000;0
412;152835;28;66;35;4;31;.886;3566000;0
413;14866;20;61;33;4;29;.879;3600000;0
413;34745;20;0;0;0;0;.00nan;0;0
413;86192;21;0;0;0;0;.00nan;0;0
413;143156;21;44;40;6;34;.850;3550000;0
414;848;22;0;0;0;0;.00nan;0;0
414;987;22;80;28;2;26;.929;3600000;0
414;166381;27;0;0;0;0;.00nan;0;0
414;175660;27;71;38;4;34;.895;3583000;0
415;174718;25;0;0;0;0;.00nan;0;0
415;141998;35;90;32;2;30;.938;3649000;0
415;143473;35;0;0;0;0;.00nan;0;0
415;148958;25;80;35;3;32;.914;3649000;0
416;676;34;92;46;3;43;.935;4200000;0
416;5311;8;68;34;3;31;.912;4200000;0
416;13714;8;0;0;0;0;.00nan;0;0
416;78806;34;0;0;0;0;.00nan;0;0
417;20432;31;78;31;2;29;.935;3600000;0
417;169868;4182;0;0;0;0;.00nan;0;0
417;86360;31;0;0;0;0;.00nan;0;0
417;147945;4182;69;36;4;32;.889;3546000;0
418;2059;23;91;43;2;41;.953;3799000;0
418;57859;15;0;0;0;0;.00nan;0;0
418;65762;23;0;0;0;0;.00nan;0;0
418;85727;15;75;27;1;26;.963;3799000;0
419;168712;14;0;0;0;0;.00nan;0;0
419;37818;29;85;35;2;33;.943;3778000;0
419;59540;14;60;29;3;26;.897;3778000;0
419;152710;29;0;0;0;0;.00nan;0;0
420;167642;18;0;0;0;0;.00nan;0;0
420;55802;18;68;17;1;16;.941;3600000;0
420;69536;10;44;37;6;31;.838;3600000;0
420;152717;10;0;0;0;0;.00nan;0;0
421;14866;20;0;0;0;0;.00nan;0;0
421;174718;25;0;0;0;0;.00nan;0;0
421;34745;20;21;21;6;15;.714;3600000;0
421;148958;25;80;29;1;28;.966;3600000;0
422;1669;33;82;37;3;34;.919;3648000;0
422;144705;17;48;22;4;18;.818;3648000;0
422;146862;17;0;0;0;0;.00nan;0;0
422;149452;33;0;0;0;0;.00nan;0;0
423;166381;27;66;34;4;30;.882;3555000;0
423;175660;27;0;0;0;0;.00nan;0;0
423;86192;21;85;37;3;34;.919;3600000;0
423;143156;21;0;0;0;0;.00nan;0;0
424;163565;19;85;31;1;30;.968;3600000;0
424;14305;19;0;0;0;0;.00nan;0;0
424;19391;32;0;0;0;0;.00nan;0;0
424;58830;32;89;39;3;36;.923;3580000;0
425;166646;16;66;9;0;9;1.000;828000;0
425;169868;4182;83;36;2;34;.944;3600000;0
425;53842;16;26;25;6;19;.760;2772000;0
425;147945;4182;0;0;0;0;.00nan;0;0
426;841;11;0;0;0;0;.00nan;0;0
426;9235;4838;58;28;4;24;.857;3515000;0
426;31972;11;70;23;2;21;.913;3600000;0
426;143749;4838;0;0;0;0;.00nan;0;0
427;43757;12;0;0;0;0;.00nan;0;0
427;46492;0;0;0;0;0;.00nan;0;0
427;85798;12;84;21;1;20;.952;3600000;0
427;91178;0;91;41;2;39;.951;3578000;0
428;848;22;56;22;2;20;.909;3600000;0
428;987;22;0;0;0;0;.00nan;0;0
428;8424;28;0;0;0;0;.00nan;0;0
428;152835;28;58;42;5;37;.881;3600000;0
429;166751;5;0;0;0;0;.00nan;0;0
429;163423;26;81;26;1;25;.962;3600000;0
429;179154;26;0;0;0;0;.00nan;0;0
429;36755;5;78;47;4;43;.915;3600000;0
430;5311;8;0;0;0;0;.00nan;0;0
430;13714;8;79;33;3;30;.909;3567000;0
430;176995;30;0;0;0;0;.00nan;0;0
430;36674;30;96;37;1;36;.973;3600000;0
431;8424;28;71;36;4;32;.889;3753000;0
431;86192;21;48;27;3;24;.889;3753000;0
431;143156;21;0;0;0;0;.00nan;0;0
431;152835;28;0;0;0;0;.00nan;0;0
432;556;3;100;35;0;35;1.000;3600000;0
432;615;3;0;0;0;0;.00nan;0;0
432;57859;15;58;13;1;12;.923;3561000;0
432;85727;15;0;0;0;0;.00nan;0;0
433;20693;24;80;39;3;36;.923;4141000;0
433;43757;12;84;35;2;33;.943;4141000;0
433;57338;24;0;0;0;0;.00nan;0;0
433;85798;12;0;0;0;0;.00nan;0;0
434;676;34;63;34;4;30;.882;3514000;0
434;1669;33;0;0;0;0;.00nan;0;0
434;78806;34;0;0;0;0;.00nan;0;0
434;149452;33;68;30;3;27;.900;3600000;0
435;166751;5;81;52;5;47;.904;3600000;0
435;36755;5;0;0;0;0;.00nan;0;0
435;141998;35;0;0;0;0;.00nan;0;0
435;143473;35;58;18;2;16;.889;3600000;0
436;167642;18;0;0;0;0;.00nan;0;0
436;174718;25;57;19;2;17;.895;3636000;0
436;55802;18;78;37;3;34;.919;3636000;0
436;148958;25;0;0;0;0;.00nan;0;0
437;169868;4182;0;0;0;0;.00nan;0;0
437;37818;29;55;29;4;25;.862;3577000;0
437;147945;4182;93;37;3;34;.919;3600000;0
437;152710;29;0;0;0;0;.00nan;0;0
438;2059;23;99;38;1;37;.974;3600000;0
438;20432;31;57;18;2;16;.889;3594000;0
438;65762;23;0;0;0;0;.00nan;0;0
438;86360;31;0;0;0;0;.00nan;0;0
439;9235;4838;0;0;0;0;.00nan;0;0
439;176995;30;0;0;0;0;.00nan;0;0
439;36674;30;75;21;1;20;.952;3600000;0
439;143749;4838;39;35;6;29;.829;3600000;0
440;841;11;0;0;0;0;.00nan;0;0
440;19391;32;0;0;0;0;.00nan;0;0
440;31972;11;76;32;3;29;.906;3600000;0
440;58830;32;64;37;4;33;.892;3561000;0
441;20693;24;0;0;0;0;.00nan;0;0
441;57338;24;45;32;5;27;.844;3600000;0
441;144705;17;0;0;0;0;.00nan;0;0
441;146862;17;84;34;2;32;.941;3600000;0
442;163695;9;100;43;0;43;1.000;3600000;0
442;175092;9;0;0;0;0;.00nan;0;0
442;69536;10;0;0;0;0;.00nan;0;0
442;152717;10;68;28;2;26;.929;3513000;0
443;848;22;0;0;0;0;.00nan;0;0
443;987;22;51;25;4;21;.840;4200000;0
443;163565;19;0;0;0;0;.00nan;0;0
443;14305;19;69;45;4;41;.911;4192000;0
444;5311;8;60;26;4;22;.846;3600000;0
444;13714;8;0;0;0;0;.00nan;0;0
444;46492;0;39;15;3;12;.800;3013000;0
444;91178;0;33;9;3;6;.667;574000;0
445;166381;27;0;0;0;0;.00nan;0;0
445;19391;32;94;45;3;42;.933;3598000;0
445;175660;27;65;20;2;18;.900;3633000;0
445;58830;32;0;0;0;0;.00nan;0;0
446;166751;5;0;0;0;0;.00nan;0;0
446;36755;5;67;43;4;39;.907;3600000;0
446;57859;15;71;20;1;19;.950;3600000;0
446;85727;15;0;0;0;0;.00nan;0;0
447;676;34;66;29;3;26;.897;3527000;0
447;14866;20;95;28;1;27;.964;3600000;0
447;34745;20;0;0;0;0;.00nan;0;0
447;78806;34;0;0;0;0;.00nan;0;0
448;8424;28;0;0;0;0;.00nan;0;0
448;168712;14;0;0;0;0;.00nan;0;0
448;59540;14;97;26;1;25;.962;3600000;0
448;152835;28;75;33;3;30;.909;3546000;0
449;166646;16;0;0;0;0;.00nan;0;0
449;176995;30;0;0;0;0;.00nan;0;0
449;36674;30;65;38;4;34;.895;3560000;0
449;53842;16;70;29;2;27;.931;3600000;0
450;556;3;45;39;6;33;.846;3600000;0
450;615;3;0;0;0;0;.00nan;0;0
450;141998;35;92;34;1;33;.971;3600000;0
450;143473;35;0;0;0;0;.00nan;0;0
451;167642;18;0;0;0;0;.00nan;0;0
451;20432;31;100;36;0;36;1.000;3600000;0
451;55802;18;97;44;2;42;.955;3600000;0
451;86360;31;0;0;0;0;.00nan;0;0
452;169868;4182;0;0;0;0;.00nan;0;0
452;174718;25;100;29;0;29;1.000;3600000;0
452;147945;4182;82;41;3;38;.927;3600000;0
452;148958;25;0;0;0;0;.00nan;0;0
453;2059;23;96;31;1;30;.968;3600000;0
453;37818;29;43;21;4;17;.810;3600000;0
453;65762;23;0;0;0;0;.00nan;0;0
453;152710;29;0;0;0;0;.00nan;0;0
454;1669;33;0;0;0;0;.00nan;0;0
454;57859;15;0;0;0;0;.00nan;0;0
454;85727;15;39;29;5;24;.828;3815000;0
454;149452;33;82;56;6;50;.893;3815000;0
455;163565;19;0;0;0;0;.00nan;0;0
455;14305;19;45;19;4;15;.789;3600000;0
455;86192;21;0;0;0;0;.00nan;0;0
455;143156;21;87;43;3;40;.930;3600000;0
456;848;22;0;0;0;0;.00nan;0;0
456;987;22;45;19;3;16;.842;3584000;0
456;163695;9;70;29;2;27;.931;3600000;0
456;175092;9;0;0;0;0;.00nan;0;0
457;556;3;69;30;3;27;.900;3688000;0
457;615;3;0;0;0;0;.00nan;0;0
457;163423;26;0;0;0;0;.00nan;0;0
457;179154;26;58;18;2;16;.889;3688000;0
458;841;11;0;0;0;0;.00nan;0;0
458;31972;11;54;39;5;34;.872;3575000;0
458;43757;12;0;0;0;0;.00nan;0;0
458;85798;12;78;35;3;32;.914;3600000;0
459;9235;4838;0;0;0;0;.00nan;0;0
459;46492;0;0;0;0;0;.00nan;0;0
459;91178;0;65;20;2;18;.900;3600000;0
459;143749;4838;85;42;3;39;.929;3592000;0
460;166646;16;0;0;0;0;.00nan;0;0
460;2059;23;87;28;1;27;.964;3600000;0
460;53842;16;71;36;4;32;.889;3600000;0
460;65762;23;0;0;0;0;.00nan;0;0
461;163695;9;0;0;0;0;.00nan;0;0
461;175092;9;45;26;4;22;.846;3585000;0
461;86192;21;76;28;2;26;.929;3600000;0
461;143156;21;0;0;0;0;.00nan;0;0
462;168712;14;0;0;0;0;.00nan;0;0
462;59540;14;91;29;1;28;.966;3600000;0
462;69536;10;0;0;0;0;.00nan;0;0
462;152717;10;55;24;3;21;.875;3565000;0
463;848;22;58;27;3;24;.889;3600000;0
463;987;22;0;0;0;0;.00nan;0;0
463;144705;17;62;50;7;43;.860;3600000;0
463;146862;17;0;0;0;0;.00nan;0;0
464;676;34;72;21;1;20;.952;3600000;0
464;166751;5;0;0;0;0;.00nan;0;0
464;36755;5;84;41;3;38;.927;3536000;0
464;78806;34;0;0;0;0;.00nan;0;0
465;8424;28;0;0;0;0;.00nan;0;0
465;20693;24;81;25;1;24;.960;3600000;0
465;57338;24;0;0;0;0;.00nan;0;0
465;152835;28;75;28;2;26;.929;3570000;0
466;5311;8;70;27;2;25;.926;3600000;0
466;13714;8;0;0;0;0;.00nan;0;0
466;19391;32;48;31;5;26;.839;3600000;0
466;58830;32;0;0;0;0;.00nan;0;0
467;1669;33;55;40;6;34;.850;3600000;0
467;14866;20;55;27;4;23;.852;3600000;0
467;34745;20;0;0;0;0;.00nan;0;0
467;149452;33;0;0;0;0;.00nan;0;0
468;163423;26;75;24;2;22;.917;3600000;0
468;179154;26;0;0;0;0;.00nan;0;0
468;141998;35;64;39;5;34;.872;3600000;0
468;143473;35;0;0;0;0;.00nan;0;0
469;43757;12;100;29;0;29;1.000;3600000;0
469;46492;0;79;20;0;20;1.000;1437000;0
469;85798;12;0;0;0;0;.00nan;0;0
469;91178;0;41;25;5;20;.800;2163000;0
470;20432;31;51;33;4;29;.879;3600000;0
470;176995;30;0;0;0;0;.00nan;0;0
470;36674;30;81;22;1;21;.955;3600000;0
470;86360;31;0;0;0;0;.00nan;0;0
471;167642;18;73;40;3;37;.925;3581000;0
471;37818;29;62;21;2;19;.905;3600000;0
471;55802;18;0;0;0;0;.00nan;0;0
471;152710;29;0;0;0;0;.00nan;0;0
472;166381;27;0;0;0;0;.00nan;0;0
472;169868;4182;43;31;5;26;.839;2227000;0
472;175660;27;31;27;5;22;.815;4200000;0
472;147945;4182;71;13;0;13;1.000;1973000;0
473;2059;23;0;0;0;0;.00nan;0;0
473;174718;25;71;29;2;27;.931;3600000;0
473;65762;23;47;24;4;20;.833;3578000;0
473;148958;25;0;0;0;0;.00nan;0;0
474;14866;20;0;0;0;0;.00nan;0;0
474;34745;20;100;37;0;37;1.000;3600000;0
474;57859;15;33;30;6;24;.800;3600000;0
474;85727;15;0;0;0;0;.00nan;0;0
475;163565;19;0;0;0;0;.00nan;0;0
475;14305;19;97;47;2;45;.957;4200000;0
475;69536;10;66;23;2;21;.913;4200000;0
475;152717;10;0;0;0;0;.00nan;0;0
476;841;11;32;3;2;1;.333;462000;0
476;5311;8;0;0;0;0;.00nan;0;0
476;13714;8;55;25;3;22;.880;3600000;0
476;31972;11;75;37;5;32;.865;3138000;0
477;556;3;43;24;4;20;.833;3546000;0
477;615;3;0;0;0;0;.00nan;0;0
477;9235;4838;0;0;0;0;.00nan;0;0
477;143749;4838;76;38;3;35;.921;3600000;0
478;166751;5;0;0;0;0;.00nan;0;0
478;163565;19;60;23;2;21;.913;3600000;0
478;14305;19;0;0;0;0;.00nan;0;0
478;36755;5;54;33;4;29;.879;3528000;0
479;166646;16;0;0;0;0;.00nan;0;0
479;20693;24;53;38;5;33;.868;4200000;0
479;53842;16;69;39;5;34;.872;4200000;0
479;57338;24;0;0;0;0;.00nan;0;0
480;19391;32;88;32;2;30;.938;3545000;0
480;58830;32;0;0;0;0;.00nan;0;0
480;144705;17;0;0;0;0;.00nan;0;0
480;146862;17;90;31;1;30;.968;3600000;0
481;163423;26;0;0;0;0;.00nan;0;0
481;169868;4182;0;0;0;0;.00nan;0;0
481;179154;26;100;35;0;35;1.000;3600000;0
481;147945;4182;60;21;2;19;.905;3600000;0
482;176995;30;0;0;0;0;.00nan;0;0
482;36674;30;94;31;1;30;.968;3600000;0
482;37818;29;72;27;3;24;.889;3567000;0
482;152710;29;0;0;0;0;.00nan;0;0
483;166646;16;90;18;0;18;1.000;3600000;0
483;163695;9;81;35;3;32;.914;3600000;0
483;175092;9;0;0;0;0;.00nan;0;0
483;53842;16;0;0;0;0;.00nan;0;0
484;168712;14;0;0;0;0;.00nan;0;0
484;46492;0;0;0;0;0;.00nan;0;0
484;59540;14;74;43;4;39;.907;3600000;0
484;91178;0;62;27;3;24;.889;3600000;0
485;9235;4838;0;0;0;0;.00nan;0;0
485;57859;15;65;12;1;11;.917;3600000;0
485;85727;15;0;0;0;0;.00nan;0;0
485;143749;4838;95;46;4;42;.913;3600000;0
486;676;34;68;30;3;27;.900;3537000;0
486;69536;10;0;0;0;0;.00nan;0;0
486;78806;34;0;0;0;0;.00nan;0;0
486;152717;10;88;33;2;31;.939;3600000;0
487;20432;31;63;31;4;27;.871;3580000;0
487;86360;31;0;0;0;0;.00nan;0;0
487;141998;35;0;0;0;0;.00nan;0;0
487;143473;35;80;32;3;29;.906;3600000;0
488;8424;28;51;27;4;23;.852;3600000;0
488;86192;21;89;44;3;41;.932;3600000;0
488;143156;21;0;0;0;0;.00nan;0;0
488;152835;28;0;0;0;0;.00nan;0;0
489;848;22;0;0;0;0;.00nan;0;0
489;987;22;73;10;0;10;1.000;3600000;0
489;167642;18;0;0;0;0;.00nan;0;0
489;55802;18;55;42;5;37;.881;3600000;0
490;1669;33;0;0;0;0;.00nan;0;0
490;2059;23;51;17;3;14;.824;3595000;0
490;65762;23;0;0;0;0;.00nan;0;0
490;149452;33;90;40;2;38;.950;3600000;0
491;5311;8;0;0;0;0;.00nan;0;0
491;13714;8;51;36;5;31;.861;4057000;0
491;174718;25;0;0;0;0;.00nan;0;0
491;148958;25;67;32;4;28;.875;4057000;0
492;556;3;73;40;4;36;.900;3600000;0
492;615;3;0;0;0;0;.00nan;0;0
492;43757;12;60;22;2;20;.909;3600000;0
492;85798;12;0;0;0;0;.00nan;0;0
493;841;11;0;0;0;0;.00nan;0;0
493;166381;27;0;0;0;0;.00nan;0;0
493;175660;27;100;27;0;27;1.000;3600000;0
493;31972;11;74;42;4;38;.905;3600000;0
494;166751;5;0;0;0;0;.00nan;0;0
494;19391;32;79;35;2;33;.943;3600000;0
494;36755;5;68;38;4;34;.895;3553000;0
494;58830;32;0;0;0;0;.00nan;0;0
495;848;22;69;29;3;26;.897;3600000;0
495;987;22;0;0;0;0;.00nan;0;0
495;14866;20;48;0;0;0;.00nan;246000;0
495;34745;20;43;36;6;30;.833;3354000;0
496;166381;27;0;0;0;0;.00nan;0;0
496;169868;4182;58;39;5;34;.872;3600000;0
496;175660;27;52;13;2;11;.846;3600000;0
496;147945;4182;0;0;0;0;.00nan;0;0
497;8424;28;0;0;0;0;.00nan;0;0
497;46492;0;0;0;0;0;.00nan;0;0
497;91178;0;93;40;2;38;.950;3554000;0
497;152835;28;84;25;1;24;.960;3600000;0
498;14866;20;87;27;2;25;.926;3600000;0
498;168712;14;0;0;0;0;.00nan;0;0
498;34745;20;0;0;0;0;.00nan;0;0
498;59540;14;37;24;5;19;.792;3600000;0
499;37818;29;44;23;4;19;.826;3528000;0
499;141998;35;0;0;0;0;.00nan;0;0
499;143473;35;79;37;3;34;.919;3600000;0
499;152710;29;0;0;0;0;.00nan;0;0
500;167642;18;57;5;0;5;1.000;611000;0
500;55802;18;25;23;6;17;.739;2989000;0
500;69536;10;0;0;0;0;.00nan;0;0
500;152717;10;63;25;3;22;.880;3600000;0
501;676;34;0;0;0;0;.00nan;0;0
501;1669;33;0;0;0;0;.00nan;0;0
501;78806;34;45;26;4;22;.846;3600000;0
501;149452;33;60;43;5;38;.884;3600000;0
502;20693;24;96;62;4;58;.935;4191000;0
502;57338;24;0;0;0;0;.00nan;0;0
502;57859;15;49;34;5;29;.853;4191000;0
502;85727;15;0;0;0;0;.00nan;0;0
503;9235;4838;0;0;0;0;.00nan;0;0
503;20432;31;37;12;3;9;.750;3528000;0
503;86360;31;0;0;0;0;.00nan;0;0
503;143749;4838;90;47;2;45;.957;3600000;0
504;2059;23;69;28;3;25;.893;3600000;0
504;163423;26;0;0;0;0;.00nan;0;0
504;179154;26;48;31;4;27;.871;3544000;0
504;65762;23;0;0;0;0;.00nan;0;0
505;166646;16;0;0;0;0;.00nan;0;0
505;53842;16;86;34;2;32;.941;3600000;0
505;144705;17;0;0;0;0;.00nan;0;0
505;146862;17;28;37;7;30;.811;3600000;0
506;556;3;91;35;1;34;.971;3600000;0
506;615;3;0;0;0;0;.00nan;0;0
506;5311;8;50;26;4;22;.846;3600000;0
506;13714;8;0;0;0;0;.00nan;0;0
507;163565;19;0;0;0;0;.00nan;0;0
507;14305;19;84;32;1;31;.969;3600000;0
507;176995;30;0;0;0;0;.00nan;0;0
507;36674;30;87;41;2;39;.951;3568000;0
508;841;11;0;0;0;0;.00nan;0;0
508;31972;11;54;35;5;30;.857;3600000;0
508;43757;12;0;0;0;0;.00nan;0;0
508;85798;12;83;23;1;22;.957;3600000;0
509;676;34;52;23;3;20;.870;3600000;0
509;166751;5;73;40;4;36;.900;3600000;0
509;36755;5;0;0;0;0;.00nan;0;0
509;78806;34;0;0;0;0;.00nan;0;0
510;167642;18;93;40;1;39;.975;3600000;0
510;55802;18;0;0;0;0;.00nan;0;0
510;86192;21;54;26;4;22;.846;3600000;0
510;143156;21;0;0;0;0;.00nan;0;0
511;163695;9;85;32;1;31;.969;3569000;0
511;19391;32;100;30;0;30;1.000;3600000;0
511;175092;9;0;0;0;0;.00nan;0;0
511;58830;32;0;0;0;0;.00nan;0;0
512;174718;25;69;26;3;23;.885;3600000;0
512;144705;17;22;27;6;21;.778;2666000;0
512;146862;17;58;16;2;14;.875;934000;0
512;148958;25;0;0;0;0;.00nan;0;0
513;9235;4838;0;0;0;0;.00nan;0;0
513;37818;29;65;22;2;20;.909;3600000;0
513;143749;4838;92;51;4;47;.922;3543000;0
513;152710;29;0;0;0;0;.00nan;0;0
514;1669;33;0;0;0;0;.00nan;0;0
514;163423;26;0;0;0;0;.00nan;0;0
514;179154;26;60;30;4;26;.867;3538000;0
514;149452;33;61;19;2;17;.895;3600000;0
515;848;22;66;19;2;17;.895;3640000;0
515;987;22;0;0;0;0;.00nan;0;0
515;57859;15;91;44;1;43;.977;3640000;0
515;85727;15;0;0;0;0;.00nan;0;0
516;8424;28;0;0;0;0;.00nan;0;0
516;168712;14;0;0;0;0;.00nan;0;0
516;59540;14;70;19;1;18;.947;3600000;0
516;152835;28;72;31;3;28;.903;3528000;0
517;166646;16;0;0;0;0;.00nan;0;0
517;163695;9;0;0;0;0;.00nan;0;0
517;175092;9;50;36;5;31;.861;3600000;0
517;53842;16;67;34;4;30;.882;3600000;0
518;166751;5;0;0;0;0;.00nan;0;0
518;36755;5;28;40;7;33;.825;3600000;0
518;69536;10;49;33;6;27;.818;3600000;0
518;152717;10;0;0;0;0;.00nan;0;0
519;556;3;82;33;2;31;.939;3600000;0
519;615;3;0;0;0;0;.00nan;0;0
519;20693;24;57;33;5;28;.848;3600000;0
519;57338;24;0;0;0;0;.00nan;0;0
520;14866;20;65;20;2;18;.900;3600000;0
520;20432;31;62;38;5;33;.868;3600000;0
520;34745;20;0;0;0;0;.00nan;0;0
520;86360;31;0;0;0;0;.00nan;0;0
521;46492;0;59;4;0;4;1.000;463000;0
521;86192;21;0;0;0;0;.00nan;0;0
521;91178;0;32;29;6;23;.793;3137000;0
521;143156;21;74;23;1;22;.957;3600000;0
522;163565;19;100;33;0;33;1.000;3600000;0
522;14305;19;0;0;0;0;.00nan;0;0
522;169868;4182;0;0;0;0;.00nan;0;0
522;147945;4182;75;35;3;32;.914;3600000;0
523;174718;25;50;1;0;1;1.000;1036000;0
523;141998;35;0;0;0;0;.00nan;0;0
523;143473;35;78;37;2;35;.946;3600000;0
523;148958;25;15;20;6;14;.700;2564000;0
524;5311;8;49;19;3;16;.842;3537000;0
524;13714;8;0;0;0;0;.00nan;0;0
524;43757;12;0;0;0;0;.00nan;0;0
524;85798;12;99;44;1;43;.977;3600000;0
525;166381;27;0;0;0;0;.00nan;0;0
525;175660;27;86;24;1;23;.958;3600000;0
525;176995;30;0;0;0;0;.00nan;0;0
525;36674;30;95;43;2;41;.953;3600000;0
526;841;11;0;0;0;0;.00nan;0;0
526;2059;23;81;36;2;34;.944;3600000;0
526;31972;11;55;35;5;30;.857;3600000;0
526;65762;23;0;0;0;0;.00nan;0;0
527;168712;14;0;0;0;0;.00nan;0;0
527;59540;14;88;36;1;35;.972;3758000;0
527;69536;10;0;0;0;0;.00nan;0;0
527;152717;10;68;23;2;21;.913;3758000;0
528;14866;20;64;23;3;20;.870;3557000;0
528;34745;20;0;0;0;0;.00nan;0;0
528;86192;21;95;43;2;41;.953;3600000;0
528;143156;21;0;0;0;0;.00nan;0;0
529;20432;31;16;6;4;2;.333;395000;0
529;37818;29;73;27;2;25;.926;3600000;0
529;86360;31;67;26;2;24;.923;3205000;0
529;152710;29;0;0;0;0;.00nan;0;0
530;556;3;88;38;3;35;.921;4200000;0
530;615;3;0;0;0;0;.00nan;0;0
530;8424;28;59;27;3;24;.889;4200000;0
530;152835;28;0;0;0;0;.00nan;0;0
531;163695;9;78;36;2;34;.944;3600000;0
531;175092;9;0;0;0;0;.00nan;0;0
531;46492;0;95;36;1;35;.972;3600000;0
531;91178;0;0;0;0;0;.00nan;0;0
532;848;22;0;0;0;0;.00nan;0;0
532;987;22;61;23;2;21;.913;3600000;0
532;20693;24;75;42;4;38;.905;3550000;0
532;57338;24;0;0;0;0;.00nan;0;0
533;166646;16;0;0;0;0;.00nan;0;0
533;166751;5;0;0;0;0;.00nan;0;0
533;36755;5;83;41;3;38;.927;3591000;0
533;53842;16;87;30;1;29;.967;3600000;0
534;1669;33;0;0;0;0;.00nan;0;0
534;57859;15;0;0;0;0;.00nan;0;0
534;85727;15;55;26;3;23;.885;3534000;0
534;149452;33;90;41;2;39;.951;3600000;0
535;163423;26;0;0;0;0;.00nan;0;0
535;179154;26;98;43;2;41;.953;3600000;0
535;141998;35;0;0;0;0;.00nan;0;0
535;143473;35;49;36;6;30;.833;3600000;0
536;5311;8;0;0;0;0;.00nan;0;0
536;13714;8;86;33;2;31;.939;3600000;0
536;43757;12;0;0;0;0;.00nan;0;0
536;85798;12;79;38;3;35;.921;3556000;0
537;19391;32;79;35;2;33;.943;3562000;0
537;174718;25;76;24;1;23;.958;3600000;0
537;58830;32;0;0;0;0;.00nan;0;0
537;148958;25;0;0;0;0;.00nan;0;0
538;169868;4182;0;0;0;0;.00nan;0;0
538;176995;30;0;0;0;0;.00nan;0;0
538;36674;30;52;33;5;28;.848;3931000;0
538;147945;4182;64;32;4;28;.875;3931000;0
539;163565;19;88;29;1;28;.966;3600000;0
539;9235;4838;62;33;4;29;.879;3600000;0
539;14305;19;0;0;0;0;.00nan;0;0
539;143749;4838;0;0;0;0;.00nan;0;0
540;841;11;0;0;0;0;.00nan;0;0
540;166381;27;0;0;0;0;.00nan;0;0
540;175660;27;98;23;0;23;1.000;3600000;0
540;31972;11;92;49;3;46;.939;3600000;0
541;57859;15;81;29;2;27;.931;4200000;0
541;85727;15;0;0;0;0;.00nan;0;0
541;144705;17;0;0;0;0;.00nan;0;0
541;146862;17;100;43;2;41;.953;4200000;0
542;676;34;85;45;4;41;.911;4200000;0
542;2059;23;52;29;4;25;.862;4200000;0
542;65762;23;0;0;0;0;.00nan;0;0
542;78806;34;0;0;0;0;.00nan;0;0
543;9235;4838;0;0;0;0;.00nan;0;0
543;166381;27;0;0;0;0;.00nan;0;0
543;175660;27;83;14;0;14;1.000;3600000;0
543;143749;4838;97;74;6;68;.919;3600000;0
544;841;11;28;8;3;5;.625;491000;0
544;167642;18;0;0;0;0;.00nan;0;0
544;31972;11;67;18;1;17;.944;3036000;0
544;55802;18;74;22;2;20;.909;3600000;0
545;8424;28;0;0;0;0;.00nan;0;0
545;168712;14;0;0;0;0;.00nan;0;0
545;59540;14;65;16;2;14;.875;3600000;0
545;152835;28;83;41;3;38;.927;3560000;0
546;1669;33;0;0;0;0;.00nan;0;0
546;166751;5;71;35;3;32;.914;4035000;0
546;36755;5;0;0;0;0;.00nan;0;0
546;149452;33;69;38;4;34;.895;4035000;0
547;37818;29;64;31;3;28;.903;3600000;0
547;86192;21;58;40;6;34;.850;3600000;0
547;143156;21;0;0;0;0;.00nan;0;0
547;152710;29;0;0;0;0;.00nan;0;0
548;556;3;94;18;0;18;1.000;3600000;0
548;615;3;0;0;0;0;.00nan;0;0
548;69536;10;0;0;0;0;.00nan;0;0
548;152717;10;67;40;4;36;.900;3600000;0
549;848;22;66;26;3;23;.885;3576000;0
549;987;22;0;0;0;0;.00nan;0;0
549;14866;20;97;36;2;34;.944;3600000;0
549;34745;20;0;0;0;0;.00nan;0;0
550;163423;26;0;0;0;0;.00nan;0;0
550;179154;26;77;48;4;44;.917;3511000;0
550;174718;25;0;0;0;0;.00nan;0;0
550;148958;25;76;29;2;27;.931;3600000;0
551;5311;8;0;0;0;0;.00nan;0;0
551;13714;8;71;27;2;25;.926;3624000;0
551;141998;35;0;0;0;0;.00nan;0;0
551;143473;35;96;36;1;35;.972;3624000;0
552;163565;19;83;35;2;33;.943;3600000;0
552;14305;19;0;0;0;0;.00nan;0;0
552;43757;12;0;0;0;0;.00nan;0;0
552;85798;12;31;16;4;12;.750;3566000;0
553;676;34;0;0;0;0;.00nan;0;0
553;169868;4182;0;0;0;0;.00nan;0;0
553;78806;34;98;45;3;42;.933;3600000;0
553;147945;4182;98;24;0;24;1.000;3600000;0
554;166646;16;0;0;0;0;.00nan;0;0
554;19391;32;97;51;3;48;.941;3600000;0
554;53842;16;63;22;2;20;.909;3600000;0
554;58830;32;0;0;0;0;.00nan;0;0
555;168712;14;45;31;5;26;.839;3579000;0
555;46492;0;0;0;0;0;.00nan;0;0
555;59540;14;0;0;0;0;.00nan;0;0
555;91178;0;66;29;3;26;.897;3600000;0
556;163695;9;0;0;0;0;.00nan;0;0
556;175092;9;62;40;4;36;.900;3600000;0
556;69536;10;44;30;5;25;.833;3592000;0
556;152717;10;0;0;0;0;.00nan;0;0
557;37818;29;0;0;0;0;.00nan;0;0
557;144705;17;0;0;0;0;.00nan;0;0
557;146862;17;66;37;4;33;.892;3525000;0
557;152710;29;66;25;2;23;.920;3600000;0
558;20693;24;72;28;2;26;.929;3552000;0
558;57338;24;0;0;0;0;.00nan;0;0
558;141998;35;99;31;1;30;.968;3600000;0
558;143473;35;0;0;0;0;.00nan;0;0
559;20432;31;0;0;0;0;.00nan;0;0
559;86192;21;0;0;0;0;.00nan;0;0
559;86360;31;92;31;2;29;.935;3600000;0
559;143156;21;62;31;3;28;.903;3544000;0
560;8424;28;76;40;4;36;.900;3600000;0
560;57859;15;30;22;5;17;.773;3600000;0
560;85727;15;0;0;0;0;.00nan;0;0
560;152835;28;0;0;0;0;.00nan;0;0
561;1669;33;0;0;0;0;.00nan;0;0
561;14866;20;0;0;0;0;.00nan;0;0
561;34745;20;67;22;3;19;.864;3600000;0
561;149452;33;76;44;4;40;.909;3567000;0
562;167642;18;0;0;0;0;.00nan;0;0
562;166381;27;0;0;0;0;.00nan;0;0
562;175660;27;54;25;3;22;.880;3567000;0
562;55802;18;69;28;2;26;.929;3600000;0
563;166646;16;66;13;1;12;.923;3600000;0
563;19391;32;0;0;0;0;.00nan;0;0
563;53842;16;0;0;0;0;.00nan;0;0
563;58830;32;78;34;3;31;.912;3579000;0
564;166751;5;74;21;1;20;.952;3600000;0
564;163695;9;31;15;4;11;.733;1179000;0
564;175092;9;56;24;3;21;.875;2421000;0
564;36755;5;0;0;0;0;.00nan;0;0
565;556;3;93;35;1;34;.971;3600000;0
565;615;3;0;0;0;0;.00nan;0;0
565;46492;0;74;31;2;29;.935;3593000;0
565;91178;0;0;0;0;0;.00nan;0;0
566;848;22;0;0;0;0;.00nan;0;0
566;987;22;64;27;4;23;.852;3600000;0
566;20693;24;0;0;0;0;.00nan;0;0
566;57338;24;100;35;0;35;1.000;3600000;0
567;20432;31;50;28;4;24;.857;3600000;0
567;86360;31;0;0;0;0;.00nan;0;0
567;144705;17;10;24;7;17;.708;3600000;0
567;146862;17;0;0;0;0;.00nan;0;0
568;163565;19;0;0;0;0;.00nan;0;0
568;167642;18;82;25;1;24;.960;4200000;0
568;14305;19;98;39;1;38;.974;4200000;0
568;55802;18;0;0;0;0;.00nan;0;0
569;676;34;64;24;2;22;.917;3523000;0
569;176995;30;90;30;1;29;.967;3600000;0
569;36674;30;0;0;0;0;.00nan;0;0
569;78806;34;0;0;0;0;.00nan;0;0
570;841;11;0;0;0;0;.00nan;0;0
570;5311;8;0;0;0;0;.00nan;0;0
570;13714;8;63;21;2;19;.905;3600000;0
570;31972;11;65;42;5;37;.881;3600000;0
571;163423;26;0;0;0;0;.00nan;0;0
571;179154;26;89;33;2;31;.939;3600000;0
571;174718;25;49;30;4;26;.867;3514000;0
571;148958;25;0;0;0;0;.00nan;0;0
572;9235;4838;72;45;5;40;.889;3547000;0
572;169868;4182;0;0;0;0;.00nan;0;0
572;143749;4838;0;0;0;0;.00nan;0;0
572;147945;4182;42;17;3;14;.824;3600000;0
573;163695;9;98;42;2;40;.952;3575000;0
573;168712;14;0;0;0;0;.00nan;0;0
573;175092;9;0;0;0;0;.00nan;0;0
573;59540;14;97;20;0;20;1.000;3600000;0
574;57859;15;77;33;3;30;.909;4200000;0
574;85727;15;0;0;0;0;.00nan;0;0
574;86192;21;91;49;3;46;.939;4200000;0
574;143156;21;0;0;0;0;.00nan;0;0
575;14866;20;91;35;2;33;.943;3540000;0
575;20693;24;0;0;0;0;.00nan;0;0
575;34745;20;0;0;0;0;.00nan;0;0
575;57338;24;93;43;1;42;.977;3600000;0
576;163423;26;0;0;0;0;.00nan;0;0
576;179154;26;68;30;3;27;.900;3600000;0
576;144705;17;0;0;0;0;.00nan;0;0
576;146862;17;79;41;4;37;.902;3572000;0
577;166646;16;0;0;0;0;.00nan;0;0
577;176995;30;0;0;0;0;.00nan;0;0
577;36674;30;24;39;8;31;.795;3600000;0
577;53842;16;48;23;3;20;.870;3600000;0
578;1669;33;0;0;0;0;.00nan;0;0
578;174718;25;0;0;0;0;.00nan;0;0
578;148958;25;52;30;4;26;.867;3550000;0
578;149452;33;66;31;3;28;.903;3600000;0
579;19391;32;91;33;1;32;.970;3600000;0
579;20432;31;62;33;4;29;.879;3600000;0
579;58830;32;0;0;0;0;.00nan;0;0
579;86360;31;0;0;0;0;.00nan;0;0
580;37818;29;88;50;4;46;.920;3600000;0
580;43757;12;0;0;0;0;.00nan;0;0
580;85798;12;100;25;0;25;1.000;3600000;0
580;152710;29;0;0;0;0;.00nan;0;0
581;848;22;0;0;0;0;.00nan;0;0
581;987;22;89;16;0;16;1.000;3600000;0
581;5311;8;0;0;0;0;.00nan;0;0
581;13714;8;80;40;3;37;.925;3600000;0
582;676;34;59;21;2;19;.905;3600000;0
582;167642;18;0;0;0;0;.00nan;0;0
582;55802;18;62;30;4;26;.867;3518000;0
582;78806;34;0;0;0;0;.00nan;0;0
583;556;3;52;42;6;36;.857;3600000;0
583;615;3;0;0;0;0;.00nan;0;0
583;2059;23;76;28;3;25;.893;3600000;0
583;65762;23;0;0;0;0;.00nan;0;0
584;8424;28;90;57;4;53;.930;3600000;0
584;166381;27;0;0;0;0;.00nan;0;0
584;175660;27;56;10;1;9;.900;3600000;0
584;152835;28;0;0;0;0;.00nan;0;0
585;841;11;0;0;0;0;.00nan;0;0
585;166751;5;86;35;2;33;.943;3600000;0
585;31972;11;87;25;1;24;.960;3600000;0
585;36755;5;0;0;0;0;.00nan;0;0
586;14866;20;0;0;0;0;.00nan;0;0
586;34745;20;90;26;1;25;.962;3600000;0
586;69536;10;0;0;0;0;.00nan;0;0
586;152717;10;93;45;2;43;.956;3571000;0
587;163565;19;0;0;0;0;.00nan;0;0
587;8424;28;0;0;0;0;.00nan;0;0
587;14305;19;35;20;4;16;.800;3544000;0
587;152835;28;75;28;2;26;.929;3600000;0
588;163695;9;0;0;0;0;.00nan;0;0
588;20693;24;56;27;3;24;.889;3545000;0
588;175092;9;90;36;2;34;.944;3600000;0
588;57338;24;0;0;0;0;.00nan;0;0
589;46492;0;74;25;2;23;.920;3600000;0
589;91178;0;0;0;0;0;.00nan;0;0
589;144705;17;0;0;0;0;.00nan;0;0
589;146862;17;67;35;3;32;.914;3577000;0
590;174718;25;74;38;4;34;.895;4177000;0
590;86192;21;75;37;3;34;.919;4177000;0
590;143156;21;0;0;0;0;.00nan;0;0
590;148958;25;0;0;0;0;.00nan;0;0
591;676;34;52;19;2;17;.895;3491000;0
591;168712;14;0;0;0;0;.00nan;0;0
591;59540;14;100;27;0;27;1.000;3600000;0
591;78806;34;0;0;0;0;.00nan;0;0
592;5311;8;63;31;2;29;.935;4200000;0
592;163423;26;0;0;0;0;.00nan;0;0
592;13714;8;0;0;0;0;.00nan;0;0
592;179154;26;84;38;2;36;.947;4200000;0
593;166646;16;0;0;0;0;.00nan;0;0
593;20432;31;63;30;4;26;.867;3600000;0
593;53842;16;93;37;1;36;.973;3600000;0
593;86360;31;0;0;0;0;.00nan;0;0
594;1669;33;0;0;0;0;.00nan;0;0
594;176995;30;0;0;0;0;.00nan;0;0
594;36674;30;67;46;5;41;.891;3600000;0
594;149452;33;87;29;1;28;.966;3600000;0
595;2059;23;93;30;1;29;.967;3600000;0
595;65762;23;0;0;0;0;.00nan;0;0
595;141998;35;0;0;0;0;.00nan;0;0
595;143473;35;90;44;4;40;.909;3600000;0
596;848;22;59;29;3;26;.897;3544000;0
596;987;22;0;0;0;0;.00nan;0;0
596;43757;12;0;0;0;0;.00nan;0;0
596;85798;12;84;36;2;34;.944;3600000;0
597;556;3;84;32;3;29;.906;3600000;0
597;615;3;0;0;0;0;.00nan;0;0
597;169868;4182;0;0;0;0;.00nan;0;0
597;147945;4182;100;35;0;35;1.000;3600000;0
598;9235;4838;0;0;0;0;.00nan;0;0
598;37818;29;68;24;3;21;.875;3600000;0
598;143749;4838;60;40;5;35;.875;3555000;0
598;152710;29;0;0;0;0;.00nan;0;0
599;166751;5;36;18;4;14;.778;1185000;0
599;166381;27;0;0;0;0;.00nan;0;0
599;175660;27;57;28;4;24;.857;3600000;0
599;36755;5;63;24;2;22;.917;2383000;0
600;841;11;95;36;1;35;.972;4200000;0
600;19391;32;91;30;1;29;.967;4200000;0
600;31972;11;0;0;0;0;.00nan;0;0
600;58830;32;0;0;0;0;.00nan;0;0
601;174718;25;0;0;0;0;.00nan;0;0
601;69536;10;98;41;2;39;.951;3555000;0
601;148958;25;74;25;1;24;.960;3600000;0
601;152717;10;0;0;0;0;.00nan;0;0
602;14866;20;70;16;1;15;.938;3600000;0
602;34745;20;0;0;0;0;.00nan;0;0
602;57859;15;0;0;0;0;.00nan;0;0
602;85727;15;85;41;4;37;.902;3600000;0
603;163565;19;100;31;0;31;1.000;3600000;0
603;14305;19;0;0;0;0;.00nan;0;0
603;19391;32;0;0;0;0;.00nan;0;0
603;58830;32;96;38;1;37;.974;3587000;0
604;676;34;75;26;2;24;.923;3600000;0
604;176995;30;0;0;0;0;.00nan;0;0
604;36674;30;46;32;5;27;.844;3600000;0
604;78806;34;0;0;0;0;.00nan;0;0
605;5311;8;0;0;0;0;.00nan;0;0
605;13714;8;70;27;2;25;.926;3556000;0
605;37818;29;95;36;1;35;.972;3600000;0
605;152710;29;0;0;0;0;.00nan;0;0
606;163695;9;73;35;3;32;.914;3600000;0
606;20432;31;45;31;6;25;.806;3600000;0
606;175092;9;0;0;0;0;.00nan;0;0
606;86360;31;0;0;0;0;.00nan;0;0
607;57859;15;0;0;0;0;.00nan;0;0
607;85727;15;78;20;1;19;.950;3600000;0
607;141998;35;0;0;0;0;.00nan;0;0
607;143473;35;85;40;2;38;.950;3600000;0
608;166646;16;0;0;0;0;.00nan;0;0
608;168712;14;0;0;0;0;.00nan;0;0
608;53842;16;55;31;4;27;.871;3600000;0
608;59540;14;100;36;1;35;.972;3600000;0
609;86192;21;64;27;2;25;.926;3645000;0
609;143156;21;0;0;0;0;.00nan;0;0
609;144705;17;0;0;0;0;.00nan;0;0
609;146862;17;70;33;3;30;.909;3645000;0
610;2059;23;62;24;2;22;.917;3575000;0
610;65762;23;0;0;0;0;.00nan;0;0
610;69536;10;0;0;0;0;.00nan;0;0
610;152717;10;100;30;0;30;1.000;3600000;0
611;20693;24;48;23;3;20;.870;3952000;0
611;46492;0;0;0;0;0;.00nan;0;0
611;57338;24;0;0;0;0;.00nan;0;0
611;91178;0;59;32;4;28;.875;3952000;0
612;841;11;0;0;0;0;.00nan;0;0
612;8424;28;54;27;4;23;.852;3600000;0
612;31972;11;100;18;0;18;1.000;3600000;0
612;152835;28;0;0;0;0;.00nan;0;0
613;1669;33;0;0;0;0;.00nan;0;0
613;163423;26;74;38;3;35;.921;3548000;0
613;179154;26;0;0;0;0;.00nan;0;0
613;149452;33;66;22;2;20;.909;3600000;0
614;556;3;94;17;0;17;1.000;3600000;0
614;615;3;0;0;0;0;.00nan;0;0
614;167642;18;60;6;0;6;1.000;672000;0
614;55802;18;29;28;6;22;.786;2928000;0
615;848;22;0;0;0;0;.00nan;0;0
615;987;22;44;9;2;7;.778;3600000;0
615;9235;4838;0;0;0;0;.00nan;0;0
615;143749;4838;98;61;3;58;.951;3600000;0
616;174718;25;56;33;4;29;.879;3587000;0
616;176995;30;0;0;0;0;.00nan;0;0
616;36674;30;63;20;2;18;.900;3600000;0
616;148958;25;0;0;0;0;.00nan;0;0
617;14866;20;85;27;1;26;.963;3600000;0
617;166381;27;0;0;0;0;.00nan;0;0
617;175660;27;76;35;2;33;.943;3584000;0
617;34745;20;0;0;0;0;.00nan;0;0
618;19391;32;76;54;6;48;.889;3600000;0
618;43757;12;0;0;0;0;.00nan;0;0
618;58830;32;0;0;0;0;.00nan;0;0
618;85798;12;60;13;1;12;.923;3600000;0
619;166751;5;0;0;0;0;.00nan;0;0
619;163565;19;75;25;2;23;.920;3600000;0
619;14305;19;0;0;0;0;.00nan;0;0
619;36755;5;91;46;4;42;.913;3518000;0
620;2059;23;96;25;0;25;1.000;3600000;0
620;65762;23;0;0;0;0;.00nan;0;0
620;86192;21;0;0;0;0;.00nan;0;0
620;143156;21;82;32;2;30;.938;3519000;0
621;676;34;0;0;0;0;.00nan;0;0
621;20693;24;39;42;6;36;.857;3949000;0
621;57338;24;0;0;0;0;.00nan;0;0
621;78806;34;68;37;5;32;.865;3949000;0
622;166646;16;0;0;0;0;.00nan;0;0
622;163423;26;57;36;5;31;.861;3174000;0
622;179154;26;24;5;3;2;.400;426000;0
622;53842;16;61;19;2;17;.895;3600000;0
623;5311;8;0;0;0;0;.00nan;0;0
623;163695;9;0;0;0;0;.00nan;0;0
623;13714;8;75;27;2;25;.926;3600000;0
623;175092;9;65;46;6;40;.870;3600000;0
624;169868;4182;0;0;0;0;.00nan;0;0
624;46492;0;0;0;0;0;.00nan;0;0
624;91178;0;86;32;1;31;.969;3600000;0
624;147945;4182;77;34;2;32;.941;3600000;0
625;166381;27;0;0;0;0;.00nan;0;0
625;20432;31;0;0;0;0;.00nan;0;0
625;175660;27;60;16;2;14;.875;3600000;0
625;86360;31;48;35;5;30;.857;3600000;0
626;841;11;0;0;0;0;.00nan;0;0
626;8424;28;0;0;0;0;.00nan;0;0
626;31972;11;85;38;2;36;.947;3600000;0
626;152835;28;99;21;0;21;1.000;3600000;0
627;848;22;0;0;0;0;.00nan;0;0
627;987;22;64;18;1;17;.944;3554000;0
627;2059;23;100;40;0;40;1.000;3600000;0
627;65762;23;0;0;0;0;.00nan;0;0
628;1669;33;0;0;0;0;.00nan;0;0
628;163565;19;0;0;0;0;.00nan;0;0
628;14305;19;89;34;2;32;.941;3577000;0
628;149452;33;99;41;1;40;.976;3600000;0
629;37818;29;100;40;1;39;.975;3600000;0
629;141998;35;0;0;0;0;.00nan;0;0
629;143473;35;69;35;3;32;.914;3577000;0
629;152710;29;0;0;0;0;.00nan;0;0
630;168712;14;0;0;0;0;.00nan;0;0
630;19391;32;86;26;1;25;.962;3600000;0
630;58830;32;0;0;0;0;.00nan;0;0
630;59540;14;60;27;3;24;.889;3543000;0
631;167642;18;0;0;0;0;.00nan;0;0
631;174718;25;43;24;4;20;.833;3581000;0
631;55802;18;80;30;2;28;.933;3600000;0
631;148958;25;0;0;0;0;.00nan;0;0
632;163695;9;65;36;4;32;.889;3845000;0
632;175092;9;0;0;0;0;.00nan;0;0
632;43757;12;80;28;1;27;.964;2743000;0
632;85798;12;25;11;4;7;.636;1102000;0
633;556;3;62;33;4;29;.879;3514000;0
633;615;3;0;0;0;0;.00nan;0;0
633;176995;30;0;0;0;0;.00nan;0;0
633;36674;30;67;29;2;27;.931;3600000;0
634;676;34;79;31;1;30;.968;3600000;0
634;78806;34;0;0;0;0;.00nan;0;0
634;144705;17;0;0;0;0;.00nan;0;0
634;146862;17;42;35;6;29;.829;3600000;0
635;166646;16;0;0;0;0;.00nan;0;0
635;163423;26;0;0;0;0;.00nan;0;0
635;179154;26;46;35;5;30;.857;3600000;0
635;53842;16;97;36;2;34;.944;3600000;0
636;5311;8;91;23;1;22;.957;3600000;0
636;9235;4838;0;0;0;0;.00nan;0;0
636;13714;8;0;0;0;0;.00nan;0;0
636;143749;4838;57;31;4;27;.871;3600000;0
637;556;3;83;31;2;29;.935;3600000;0
637;615;3;0;0;0;0;.00nan;0;0
637;46492;0;0;0;0;0;.00nan;0;0
637;91178;0;55;29;4;25;.862;3528000;0
638;163565;19;100;39;0;39;1.000;3600000;0
638;14305;19;0;0;0;0;.00nan;0;0
638;57859;15;0;0;0;0;.00nan;0;0
638;85727;15;66;20;1;19;.950;3544000;0
639;166751;5;0;0;0;0;.00nan;0;0
639;167642;18;0;0;0;0;.00nan;0;0
639;36755;5;71;32;4;28;.875;4200000;0
639;55802;18;54;29;4;25;.862;4200000;0
640;166381;27;0;0;0;0;.00nan;0;0
640;175660;27;92;19;0;19;1.000;3600000;0
640;37818;29;90;52;4;48;.923;3600000;0
640;152710;29;0;0;0;0;.00nan;0;0
641;841;11;0;0;0;0;.00nan;0;0
641;31972;11;53;20;3;17;.850;3543000;0
641;144705;17;90;34;2;32;.941;3600000;0
641;146862;17;0;0;0;0;.00nan;0;0
642;2059;23;86;39;2;37;.949;4055000;0
642;20693;24;79;40;3;37;.925;4055000;0
642;57338;24;0;0;0;0;.00nan;0;0
642;65762;23;0;0;0;0;.00nan;0;0
643;20432;31;0;0;0;0;.00nan;0;0
643;69536;10;0;0;0;0;.00nan;0;0
643;86360;31;42;26;4;22;.846;3600000;0
643;152717;10;99;42;1;41;.976;3600000;0
644;14866;20;61;17;2;15;.882;3600000;0
644;169868;4182;0;0;0;0;.00nan;0;0
644;34745;20;0;0;0;0;.00nan;0;0
644;147945;4182;95;43;3;40;.930;3600000;0
645;848;22;67;19;1;18;.947;4200000;0
645;987;22;0;0;0;0;.00nan;0;0
645;8424;28;0;0;0;0;.00nan;0;0
645;152835;28;96;41;1;40;.976;4200000;0
646;86192;21;22;31;7;24;.774;3294000;0
646;141998;35;0;0;0;0;.00nan;0;0
646;143156;21;51;3;0;3;1.000;306000;0
646;143473;35;77;30;2;28;.933;3600000;0
647;19391;32;62;31;4;27;.871;3600000;0
647;174718;25;0;0;0;0;.00nan;0;0
647;58830;32;0;0;0;0;.00nan;0;0
647;148958;25;98;31;1;30;.968;3600000;0
648;176995;30;0;0;0;0;.00nan;0;0
648;36674;30;74;34;4;30;.882;4063000;0
648;43757;12;0;0;0;0;.00nan;0;0
648;85798;12;65;30;3;27;.900;4063000;0
649;163695;9;0;0;0;0;.00nan;0;0
649;9235;4838;69;41;4;37;.902;3600000;0
649;175092;9;88;32;1;31;.969;3600000;0
649;143749;4838;0;0;0;0;.00nan;0;0
650;1669;33;0;0;0;0;.00nan;0;0
650;163423;26;0;0;0;0;.00nan;0;0
650;179154;26;62;43;6;37;.860;3600000;0
650;149452;33;62;22;3;19;.864;3600000;0
651;676;34;93;39;3;36;.923;3498000;0
651;166646;16;0;0;0;0;.00nan;0;0
651;53842;16;100;36;1;35;.972;3600000;0
651;78806;34;0;0;0;0;.00nan;0;0
652;14866;20;63;25;2;23;.920;3600000;0
652;34745;20;0;0;0;0;.00nan;0;0
652;86192;21;47;39;6;33;.846;3600000;0
652;143156;21;0;0;0;0;.00nan;0;0
653;2059;23;99;35;1;34;.971;3600000;0
653;46492;0;0;0;0;0;.00nan;0;0
653;65762;23;0;0;0;0;.00nan;0;0
653;91178;0;67;31;3;28;.903;3553000;0
654;556;3;44;18;3;15;.833;3600000;0
654;615;3;0;0;0;0;.00nan;0;0
654;841;11;0;0;0;0;.00nan;0;0
654;31972;11;58;42;6;36;.857;3600000;0
655;37818;29;93;28;1;27;.964;3600000;0
655;69536;10;0;0;0;0;.00nan;0;0
655;152710;29;0;0;0;0;.00nan;0;0
655;152717;10;57;26;3;23;.885;3542000;0
656;20693;24;100;43;0;43;1.000;3600000;0
656;57338;24;0;0;0;0;.00nan;0;0
656;57859;15;0;0;0;0;.00nan;0;0
656;85727;15;68;39;5;34;.872;3600000;0
657;168712;14;0;0;0;0;.00nan;0;0
657;169868;4182;0;0;0;0;.00nan;0;0
657;59540;14;75;25;2;23;.920;3600000;0
657;147945;4182;64;42;5;37;.881;3600000;0
658;166751;5;40;8;2;6;.750;496000;0
658;166381;27;0;0;0;0;.00nan;0;0
658;175660;27;36;17;4;13;.765;3600000;0
658;36755;5;41;41;7;34;.829;3104000;0
659;167642;18;0;0;0;0;.00nan;0;0
659;55802;18;50;40;5;35;.875;4200000;0
659;144705;17;0;0;0;0;.00nan;0;0
659;146862;17;56;39;5;34;.872;4200000;0
660;163565;19;0;0;0;0;.00nan;0;0
660;14305;19;57;34;4;30;.882;3600000;0
660;20432;31;70;34;3;31;.912;3600000;0
660;86360;31;0;0;0;0;.00nan;0;0
661;5311;8;0;0;0;0;.00nan;0;0
661;8424;28;64;27;3;24;.889;3600000;0
661;13714;8;44;38;7;31;.816;3600000;0
661;152835;28;0;0;0;0;.00nan;0;0
662;676;34;0;0;0;0;.00nan;0;0
662;19391;32;89;36;2;34;.944;3600000;0
662;58830;32;0;0;0;0;.00nan;0;0
662;78806;34;40;26;5;21;.808;3600000;0
663;163423;26;65;32;3;29;.906;3590000;0
663;179154;26;0;0;0;0;.00nan;0;0
663;174718;25;55;17;2;15;.882;3600000;0
663;148958;25;0;0;0;0;.00nan;0;0
664;166646;16;65;36;4;32;.889;3556000;0
664;43757;12;0;0;0;0;.00nan;0;0
664;53842;16;0;0;0;0;.00nan;0;0
664;85798;12;50;17;3;14;.824;3600000;0
665;848;22;64;20;2;18;.900;3600000;0
665;987;22;0;0;0;0;.00nan;0;0
665;1669;33;64;33;3;30;.909;3584000;0
665;149452;33;0;0;0;0;.00nan;0;0
666;163695;9;77;30;2;28;.933;3600000;0
666;175092;9;0;0;0;0;.00nan;0;0
666;141998;35;0;0;0;0;.00nan;0;0
666;143473;35;73;24;1;23;.958;3600000;0
667;9235;4838;99;53;2;51;.962;3600000;0
667;176995;30;0;0;0;0;.00nan;0;0
667;36674;30;64;26;3;23;.885;3549000;0
667;143749;4838;0;0;0;0;.00nan;0;0
668;14866;20;52;6;1;5;.833;1603000;0
668;34745;20;25;33;7;26;.788;1972000;0
668;86192;21;0;0;0;0;.00nan;0;0
668;143156;21;43;34;6;28;.824;3600000;0
669;166751;5;19;9;4;5;.556;650000;0
669;8424;28;0;0;0;0;.00nan;0;0
669;36755;5;77;30;2;28;.933;2950000;0
669;152835;28;75;22;1;21;.955;3600000;0
670;163695;9;0;0;0;0;.00nan;0;0
670;175092;9;72;26;1;25;.962;3600000;0
670;69536;10;0;0;0;0;.00nan;0;0
670;152717;10;30;20;5;15;.750;3600000;0
671;841;11;0;0;0;0;.00nan;0;0
671;31972;11;48;36;5;31;.861;3532000;0
671;46492;0;0;0;0;0;.00nan;0;0
671;91178;0;67;33;4;29;.879;3600000;0
672;2059;23;100;39;0;39;1.000;3600000;0
672;168712;14;0;0;0;0;.00nan;0;0
672;59540;14;83;26;1;25;.962;3549000;0
672;65762;23;0;0;0;0;.00nan;0;0
673;163565;19;77;31;2;29;.935;3600000;0
673;14305;19;0;0;0;0;.00nan;0;0
673;37818;29;67;32;3;29;.906;3589000;0
673;152710;29;0;0;0;0;.00nan;0;0
674;166381;27;0;0;0;0;.00nan;0;0
674;175660;27;71;35;3;32;.914;3563000;0
674;57859;15;69;22;1;21;.955;3600000;0
674;85727;15;0;0;0;0;.00nan;0;0
675;848;22;0;0;0;0;.00nan;0;0
675;987;22;56;26;4;22;.846;3600000;0
675;166646;16;0;0;0;0;.00nan;0;0
675;53842;16;99;50;1;49;.980;3600000;0
676;20693;24;91;39;3;36;.923;3600000;0
676;169868;4182;60;30;4;26;.867;3573000;0
676;57338;24;0;0;0;0;.00nan;0;0
676;147945;4182;0;0;0;0;.00nan;0;0
677;5311;8;0;0;0;0;.00nan;0;0
677;13714;8;81;23;2;21;.913;3600000;0
677;144705;17;0;0;0;0;.00nan;0;0
677;146862;17;82;50;5;45;.900;3600000;0
678;676;34;83;46;4;42;.913;3600000;0
678;78806;34;0;0;0;0;.00nan;0;0
678;141998;35;0;0;0;0;.00nan;0;0
678;143473;35;92;32;1;31;.969;3600000;0
679;1669;33;0;0;0;0;.00nan;0;0
679;9235;4838;0;0;0;0;.00nan;0;0
679;143749;4838;99;35;1;34;.971;3600000;0
679;149452;33;60;28;3;25;.893;3555000;0
680;169868;4182;0;0;0;0;.00nan;0;0
680;86192;21;64;44;5;39;.886;3515000;0
680;143156;21;0;0;0;0;.00nan;0;0
680;147945;4182;86;38;3;35;.921;3600000;0
681;556;3;0;0;0;0;.00nan;0;0
681;615;3;84;29;1;28;.966;3600000;0
681;5311;8;51;33;4;29;.879;3600000;0
681;13714;8;0;0;0;0;.00nan;0;0
682;163565;19;91;22;0;22;1.000;1319000;0
682;14305;19;56;37;4;33;.892;2281000;0
682;14866;20;79;11;0;11;1.000;3600000;0
682;34745;20;0;0;0;0;.00nan;0;0
683;163423;26;51;4;0;4;1.000;637000;0
683;166381;27;76;26;2;24;.923;3600000;0
683;179154;26;20;38;7;31;.816;2963000;0
683;175660;27;0;0;0;0;.00nan;0;0
684;848;22;64;14;1;13;.929;3600000;0
684;987;22;0;0;0;0;.00nan;0;0
684;19391;32;83;61;6;55;.902;3600000;0
684;58830;32;0;0;0;0;.00nan;0;0
685;841;11;35;33;6;27;.818;2690000;0
685;174718;25;89;18;0;18;1.000;3600000;0
685;31972;11;53;9;1;8;.889;910000;0
685;148958;25;0;0;0;0;.00nan;0;0
686;176995;30;0;0;0;0;.00nan;0;0
686;36674;30;57;30;4;26;.867;3555000;0
686;43757;12;0;0;0;0;.00nan;0;0
686;85798;12;69;30;3;27;.900;3600000;0
687;8424;28;0;0;0;0;.00nan;0;0
687;167642;18;75;19;1;18;.947;3600000;0
687;55802;18;0;0;0;0;.00nan;0;0
687;152835;28;89;38;2;36;.947;3542000;0
688;166751;5;0;0;0;0;.00nan;0;0
688;36755;5;77;44;4;40;.909;3600000;0
688;37818;29;59;20;2;18;.900;3600000;0
688;152710;29;0;0;0;0;.00nan;0;0
689;69536;10;56;26;3;23;.885;3545000;0
689;144705;17;0;0;0;0;.00nan;0;0
689;146862;17;93;38;2;36;.947;3600000;0
689;152717;10;0;0;0;0;.00nan;0;0
690;174718;25;25;7;3;4;.571;327000;0
690;46492;0;79;33;2;31;.939;3600000;0
690;91178;0;0;0;0;0;.00nan;0;0
690;148958;25;33;26;5;21;.808;3273000;0
691;5311;8;0;0;0;0;.00nan;0;0
691;163695;9;0;0;0;0;.00nan;0;0
691;13714;8;70;28;3;25;.893;3600000;0
691;175092;9;72;43;4;39;.907;3569000;0
692;556;3;75;33;3;30;.909;3714000;0
692;615;3;0;0;0;0;.00nan;0;0
692;144705;17;88;36;2;34;.944;3714000;0
692;146862;17;0;0;0;0;.00nan;0;0
693;676;34;75;21;1;20;.952;3600000;0
693;163423;26;0;0;0;0;.00nan;0;0
693;179154;26;67;33;3;30;.909;3600000;0
693;78806;34;0;0;0;0;.00nan;0;0
694;166646;16;0;0;0;0;.00nan;0;0
694;20432;31;72;40;4;36;.900;3600000;0
694;53842;16;81;41;3;38;.927;3600000;0
694;86360;31;0;0;0;0;.00nan;0;0
695;14866;20;61;16;1;15;.938;3600000;0
695;34745;20;0;0;0;0;.00nan;0;0
695;141998;35;0;0;0;0;.00nan;0;0
695;143473;35;100;41;0;41;1.000;3600000;0
696;8424;28;0;0;0;0;.00nan;0;0
696;176995;30;0;0;0;0;.00nan;0;0
696;36674;30;100;41;1;40;.976;3600000;0
696;152835;28;87;39;3;36;.923;3518000;0
697;167642;18;0;0;0;0;.00nan;0;0
697;169868;4182;0;0;0;0;.00nan;0;0
697;55802;18;89;35;2;33;.943;3594000;0
697;147945;4182;94;21;0;21;1.000;3600000;0
698;1669;33;0;0;0;0;.00nan;0;0
698;166381;27;0;0;0;0;.00nan;0;0
698;175660;27;59;26;3;23;.885;4200000;0
698;149452;33;69;36;3;33;.917;4200000;0
699;2059;23;100;40;1;39;.975;3600000;0
699;43757;12;0;0;0;0;.00nan;0;0
699;65762;23;0;0;0;0;.00nan;0;0
699;85798;12;60;33;4;29;.879;3600000;0
700;9235;4838;100;36;1;35;.972;3600000;0
700;86192;21;57;19;2;17;.895;3541000;0
700;143156;21;0;0;0;0;.00nan;0;0
700;143749;4838;0;0;0;0;.00nan;0;0
701;166751;5;0;0;0;0;.00nan;0;0
701;36755;5;50;46;6;40;.870;3600000;0
701;57859;15;0;0;0;0;.00nan;0;0
701;85727;15;70;25;2;23;.920;3600000;0
702;168712;14;0;0;0;0;.00nan;0;0
702;59540;14;39;22;5;17;.773;3810000;0
702;69536;10;0;0;0;0;.00nan;0;0
702;152717;10;55;31;4;27;.871;3810000;0
703;166646;16;0;0;0;0;.00nan;0;0
703;37818;29;70;31;2;29;.935;3600000;0
703;53842;16;45;23;4;19;.826;3519000;0
703;152710;29;0;0;0;0;.00nan;0;0
704;848;22;0;0;0;0;.00nan;0;0
704;987;22;100;34;0;34;1.000;3600000;0
704;174718;25;94;47;2;45;.957;3525000;0
704;148958;25;0;0;0;0;.00nan;0;0
705;20432;31;99;39;1;38;.974;3600000;0
705;46492;0;0;0;0;0;.00nan;0;0
705;86360;31;0;0;0;0;.00nan;0;0
705;91178;0;79;42;3;39;.929;3536000;0
706;676;34;52;35;5;30;.857;3541000;0
706;5311;8;0;0;0;0;.00nan;0;0
706;13714;8;76;31;3;28;.903;3600000;0
706;78806;34;0;0;0;0;.00nan;0;0
707;1669;33;0;0;0;0;.00nan;0;0
707;43757;12;0;0;0;0;.00nan;0;0
707;85798;12;74;35;2;33;.943;3600000;0
707;149452;33;68;34;3;31;.912;3541000;0
708;556;3;86;38;3;35;.921;3600000;0
708;615;3;0;0;0;0;.00nan;0;0
708;19391;32;0;0;0;0;.00nan;0;0
708;58830;32;92;45;2;43;.956;3600000;0
709;163695;9;43;28;5;23;.821;3600000;0
709;175092;9;0;0;0;0;.00nan;0;0
709;144705;17;0;0;0;0;.00nan;0;0
709;146862;17;84;47;4;43;.915;3600000;0
710;163423;26;83;43;4;39;.907;3600000;0
710;179154;26;0;0;0;0;.00nan;0;0
710;69536;10;31;24;5;19;.792;3550000;0
710;152717;10;0;0;0;0;.00nan;0;0
711;2059;23;96;44;1;43;.977;4200000;0
711;8424;28;0;0;0;0;.00nan;0;0
711;65762;23;0;0;0;0;.00nan;0;0
711;152835;28;80;25;1;24;.960;4152000;0
712;14866;20;68;25;2;23;.920;3600000;0
712;34745;20;0;0;0;0;.00nan;0;0
712;141998;35;0;0;0;0;.00nan;0;0
712;143473;35;76;60;6;54;.900;3600000;0
713;167642;18;0;0;0;0;.00nan;0;0
713;176995;30;0;0;0;0;.00nan;0;0
713;36674;30;66;31;3;28;.903;3573000;0
713;55802;18;57;17;2;15;.882;3600000;0
714;841;11;0;0;0;0;.00nan;0;0
714;163565;19;60;18;2;16;.889;4123000;0
714;14305;19;0;0;0;0;.00nan;0;0
714;31972;11;92;38;1;37;.974;4123000;0
715;9235;4838;0;0;0;0;.00nan;0;0
715;20693;24;77;21;1;20;.952;3600000;0
715;57338;24;0;0;0;0;.00nan;0;0
715;143749;4838;95;45;2;43;.956;3600000;0
716;166381;27;0;0;0;0;.00nan;0;0
716;175660;27;73;24;2;22;.917;3600000;0
716;86192;21;68;46;5;41;.891;3600000;0
716;143156;21;0;0;0;0;.00nan;0;0
717;556;3;77;35;3;32;.914;3646000;0
717;615;3;0;0;0;0;.00nan;0;0
717;676;34;0;0;0;0;.00nan;0;0
717;78806;34;73;36;2;34;.944;3646000;0
718;166646;16;50;1;0;1;1.000;381000;0
718;53842;16;58;37;5;32;.865;3219000;0
718;57859;15;86;29;2;27;.931;3600000;0
718;85727;15;0;0;0;0;.00nan;0;0
719;166751;5;0;0;0;0;.00nan;0;0
719;20432;31;0;0;0;0;.00nan;0;0
719;36755;5;60;34;4;30;.882;3547000;0
719;86360;31;67;31;3;28;.903;3600000;0
720;848;22;0;0;0;0;.00nan;0;0
720;987;22;87;35;3;32;.914;4020000;0
720;163423;26;0;0;0;0;.00nan;0;0
720;179154;26;63;37;4;33;.892;4020000;0
721;163565;19;0;0;0;0;.00nan;0;0
721;14305;19;69;40;4;36;.900;3600000;0
721;86192;21;0;0;0;0;.00nan;0;0
721;143156;21;68;18;1;17;.944;3600000;0
722;8424;28;23;27;6;21;.778;2776000;0
722;169868;4182;0;0;0;0;.00nan;0;0
722;147945;4182;66;14;1;13;.929;3600000;0
722;152835;28;51;7;1;6;.857;824000;0
723;163695;9;0;0;0;0;.00nan;0;0
723;19391;32;84;25;1;24;.960;3600000;0
723;175092;9;63;24;2;22;.917;3545000;0
723;58830;32;0;0;0;0;.00nan;0;0
724;9235;4838;0;0;0;0;.00nan;0;0
724;69536;10;0;0;0;0;.00nan;0;0
724;143749;4838;97;52;2;50;.962;3600000;0
724;152717;10;59;11;1;10;.909;3600000;0
725;1669;33;0;0;0;0;.00nan;0;0
725;37818;29;84;32;2;30;.938;4148000;0
725;149452;33;94;46;2;44;.957;4200000;0
725;152710;29;0;0;0;0;.00nan;0;0
726;20693;24;92;35;2;33;.943;3600000;0
726;43757;12;0;0;0;0;.00nan;0;0
726;57338;24;0;0;0;0;.00nan;0;0
726;85798;12;74;44;6;38;.864;3600000;0
727;2059;23;70;24;2;22;.917;3600000;0
727;174718;25;60;26;3;23;.885;3569000;0
727;65762;23;0;0;0;0;.00nan;0;0
727;148958;25;0;0;0;0;.00nan;0;0
728;841;11;0;0;0;0;.00nan;0;0
728;166381;27;0;0;0;0;.00nan;0;0
728;175660;27;80;30;2;28;.933;3600000;0
728;31972;11;63;37;4;33;.892;3582000;0
729;166751;5;0;0;0;0;.00nan;0;0
729;163423;26;0;0;0;0;.00nan;0;0
729;179154;26;96;28;1;27;.964;3600000;0
729;36755;5;73;30;2;28;.933;3578000;0
730;556;3;71;31;3;28;.903;3750000;0
730;615;3;0;0;0;0;.00nan;0;0
730;144705;17;70;24;2;22;.917;3750000;0
730;146862;17;0;0;0;0;.00nan;0;0
731;676;34;50;35;5;30;.857;3552000;0
731;20432;31;70;28;3;25;.893;3600000;0
731;78806;34;0;0;0;0;.00nan;0;0
731;86360;31;0;0;0;0;.00nan;0;0
732;848;22;40;12;3;9;.750;3600000;0
732;987;22;0;0;0;0;.00nan;0;0
732;9235;4838;98;62;4;58;.935;3600000;0
732;143749;4838;0;0;0;0;.00nan;0;0
733;166646;16;0;0;0;0;.00nan;0;0
733;14866;20;75;31;2;29;.935;3600000;0
733;34745;20;0;0;0;0;.00nan;0;0
733;53842;16;50;29;5;24;.828;3600000;0
734;176995;30;0;0;0;0;.00nan;0;0
734;36674;30;84;32;1;31;.969;3557000;0
734;141998;35;0;0;0;0;.00nan;0;0
734;143473;35;92;19;0;19;1.000;3600000;0
735;167642;18;50;32;4;28;.875;4200000;0
735;168712;14;0;0;0;0;.00nan;0;0
735;55802;18;0;0;0;0;.00nan;0;0
735;59540;14;48;26;4;22;.846;4200000;0
736;163565;19;97;39;2;37;.949;3600000;0
736;14305;19;0;0;0;0;.00nan;0;0
736;46492;0;56;6;0;6;1.000;860000;0
736;91178;0;27;26;6;20;.769;2740000;0
737;841;11;71;22;1;21;.955;4200000;0
737;31972;11;0;0;0;0;.00nan;0;0
737;86192;21;100;45;1;44;.978;4200000;0
737;143156;21;0;0;0;0;.00nan;0;0
738;37818;29;56;24;3;21;.875;3600000;0
738;43757;12;0;0;0;0;.00nan;0;0
738;85798;12;100;33;0;33;1.000;3600000;0
738;152710;29;0;0;0;0;.00nan;0;0
739;8424;28;0;0;0;0;.00nan;0;0
739;19391;32;0;0;0;0;.00nan;0;0
739;58830;32;63;48;6;42;.875;3600000;0
739;152835;28;75;23;1;22;.957;3600000;0
740;163695;9;63;22;2;20;.909;3600000;0
740;175092;9;0;0;0;0;.00nan;0;0
740;57859;15;79;41;3;38;.927;3600000;0
740;85727;15;0;0;0;0;.00nan;0;0
741;5311;8;86;36;2;34;.944;3600000;0
741;13714;8;0;0;0;0;.00nan;0;0
741;14866;20;0;0;0;0;.00nan;0;0
741;34745;20;55;27;3;24;.889;3597000;0
742;169868;4182;0;0;0;0;.00nan;0;0
742;174718;25;0;0;0;0;.00nan;0;0
742;147945;4182;100;40;1;39;.975;3600000;0
742;148958;25;79;37;3;34;.919;3585000;0
743;2059;23;94;31;1;30;.968;3600000;0
743;65762;23;0;0;0;0;.00nan;0;0
743;141998;35;0;0;0;0;.00nan;0;0
743;143473;35;65;30;2;28;.933;3552000;0
744;166381;27;0;0;0;0;.00nan;0;0
744;175660;27;51;29;4;25;.862;3553000;0
744;46492;0;76;26;2;24;.923;3600000;0
744;91178;0;0;0;0;0;.00nan;0;0
745;57859;15;0;0;0;0;.00nan;0;0
745;69536;10;0;0;0;0;.00nan;0;0
745;85727;15;60;29;3;26;.897;3577000;0
745;152717;10;88;30;1;29;.967;3600000;0
746;676;34;69;28;3;25;.893;3959000;0
746;166751;5;77;35;2;33;.943;3959000;0
746;36755;5;0;0;0;0;.00nan;0;0
746;78806;34;0;0;0;0;.00nan;0;0
747;848;22;89;25;1;24;.960;3600000;0
747;987;22;0;0;0;0;.00nan;0;0
747;144705;17;0;0;0;0;.00nan;0;0
747;146862;17;95;38;2;36;.947;3579000;0
748;556;3;76;24;1;23;.958;3600000;0
748;615;3;0;0;0;0;.00nan;0;0
748;163695;9;0;0;0;0;.00nan;0;0
748;175092;9;67;38;4;34;.895;3600000;0
749;20432;31;82;27;2;25;.926;3777000;0
749;43757;12;85;30;1;29;.967;3777000;0
749;85798;12;0;0;0;0;.00nan;0;0
749;86360;31;0;0;0;0;.00nan;0;0
750;163423;26;0;0;0;0;.00nan;0;0
750;163565;19;0;0;0;0;.00nan;0;0
750;14305;19;54;24;3;21;.875;3600000;0
750;179154;26;94;46;2;44;.957;3600000;0
751;166646;16;60;22;3;19;.864;3559000;0
751;1669;33;0;0;0;0;.00nan;0;0
751;53842;16;0;0;0;0;.00nan;0;0
751;149452;33;93;42;1;41;.976;3600000;0
752;168712;14;0;0;0;0;.00nan;0;0
752;176995;30;0;0;0;0;.00nan;0;0
752;36674;30;69;46;5;41;.891;3600000;0
752;59540;14;34;16;4;12;.750;3600000;0
753;167642;18;0;0;0;0;.00nan;0;0
753;174718;25;71;23;1;22;.957;3600000;0
753;55802;18;44;25;4;21;.840;3600000;0
753;148958;25;0;0;0;0;.00nan;0;0
754;9235;4838;68;44;5;39;.886;3600000;0
754;86192;21;63;15;1;14;.933;3600000;0
754;143156;21;0;0;0;0;.00nan;0;0
754;143749;4838;0;0;0;0;.00nan;0;0
755;20693;24;44;32;5;27;.844;3600000;0
755;37818;29;76;27;2;25;.926;3600000;0
755;57338;24;0;0;0;0;.00nan;0;0
755;152710;29;0;0;0;0;.00nan;0;0
756;5311;8;0;0;0;0;.00nan;0;0
756;13714;8;55;20;2;18;.900;3561000;0
756;166381;27;0;0;0;0;.00nan;0;0
756;175660;27;91;35;1;34;.971;3600000;0
757;169868;4182;97;29;1;28;.966;3600000;0
757;141998;35;0;0;0;0;.00nan;0;0
757;143473;35;98;43;3;40;.930;3543000;0
757;147945;4182;0;0;0;0;.00nan;0;0
758;676;34;57;26;3;23;.885;3600000;0
758;163695;9;78;14;0;14;1.000;3600000;0
758;175092;9;0;0;0;0;.00nan;0;0
758;78806;34;0;0;0;0;.00nan;0;0
759;163423;26;0;0;0;0;.00nan;0;0
759;14866;20;80;14;0;14;1.000;3600000;0
759;179154;26;76;43;4;39;.907;3600000;0
759;34745;20;0;0;0;0;.00nan;0;0
760;1669;33;0;0;0;0;.00nan;0;0
760;167642;18;0;0;0;0;.00nan;0;0
760;55802;18;100;31;1;30;.968;3600000;0
760;149452;33;83;26;2;24;.923;3542000;0
761;841;11;29;37;6;31;.838;2784000;0
761;31972;11;60;4;0;4;1.000;816000;0
761;46492;0;76;30;2;28;.933;3600000;0
761;91178;0;0;0;0;0;.00nan;0;0
762;43757;12;59;10;1;9;.900;1781000;0
762;57859;15;0;0;0;0;.00nan;0;0
762;85727;15;56;22;3;19;.864;3600000;0
762;85798;12;44;38;6;32;.842;1819000;0
763;166751;5;0;0;0;0;.00nan;0;0
763;9235;4838;0;0;0;0;.00nan;0;0
763;36755;5;62;31;3;28;.903;3600000;0
763;143749;4838;86;50;4;46;.920;3600000;0
764;556;3;78;36;3;33;.917;3600000;0
764;615;3;0;0;0;0;.00nan;0;0
764;86192;21;73;14;0;14;1.000;1287000;0
764;143156;21;34;21;4;17;.810;2313000;0
765;20693;24;0;0;0;0;.00nan;0;0
765;57338;24;58;39;5;34;.872;3700000;0
765;144705;17;0;0;0;0;.00nan;0;0
765;146862;17;41;35;6;29;.829;3671000;0
766;20432;31;0;0;0;0;.00nan;0;0
766;69536;10;0;0;0;0;.00nan;0;0
766;86360;31;42;35;6;29;.829;3575000;0
766;152717;10;61;34;4;30;.882;3600000;0
767;8424;28;0;0;0;0;.00nan;0;0
767;19391;32;88;34;3;31;.912;3567000;0
767;58830;32;0;0;0;0;.00nan;0;0
767;152835;28;86;28;1;27;.964;3600000;0
768;848;22;0;0;0;0;.00nan;0;0
768;987;22;100;24;0;24;1.000;3600000;0
768;37818;29;0;0;0;0;.00nan;0;0
768;152710;29;71;40;4;36;.900;3600000;0
769;166646;16;0;0;0;0;.00nan;0;0
769;163565;19;93;34;1;33;.971;3546000;0
769;14305;19;0;0;0;0;.00nan;0;0
769;53842;16;100;29;0;29;1.000;3600000;0
770;174718;25;56;27;3;24;.889;3600000;0
770;176995;30;0;0;0;0;.00nan;0;0
770;36674;30;100;39;0;39;1.000;3600000;0
770;148958;25;0;0;0;0;.00nan;0;0
771;2059;23;17;14;5;9;.643;2098000;0
771;168712;14;0;0;0;0;.00nan;0;0
771;59540;14;50;32;6;26;.813;3738000;0
771;65762;23;68;12;0;12;1.000;1640000;0
772;166381;27;61;29;4;25;.862;3132000;0
772;175660;27;29;9;3;6;.667;468000;0
772;141998;35;0;0;0;0;.00nan;0;0
772;143473;35;99;40;1;39;.975;3600000;0
773;168712;14;46;25;4;21;.840;3536000;0
773;169868;4182;0;0;0;0;.00nan;0;0
773;59540;14;0;0;0;0;.00nan;0;0
773;147945;4182;88;41;2;39;.951;3600000;0
774;556;3;83;32;2;30;.938;3600000;0
774;615;3;0;0;0;0;.00nan;0;0
774;1669;33;0;0;0;0;.00nan;0;0
774;149452;33;49;36;5;31;.861;3600000;0
775;168712;14;0;0;0;0;.00nan;0;0
775;59540;14;65;29;3;26;.897;3600000;0
775;141998;35;0;0;0;0;.00nan;0;0
775;143473;35;100;28;0;28;1.000;3600000;0
776;841;11;69;33;2;31;.939;3600000;0
776;169868;4182;0;0;0;0;.00nan;0;0
776;31972;11;0;0;0;0;.00nan;0;0
776;147945;4182;95;44;1;43;.977;3600000;0
777;556;3;70;23;2;21;.913;3600000;0
777;615;3;0;0;0;0;.00nan;0;0
777;166751;5;82;43;3;40;.930;3575000;0
777;36755;5;0;0;0;0;.00nan;0;0
778;1669;33;0;0;0;0;.00nan;0;0
778;166381;27;0;0;0;0;.00nan;0;0
778;175660;27;80;32;2;30;.938;3600000;0
778;149452;33;65;55;6;49;.891;3600000;0
779;841;11;0;0;0;0;.00nan;0;0
779;163565;19;0;0;0;0;.00nan;0;0
779;14305;19;68;32;3;29;.906;3563000;0
779;31972;11;77;28;2;26;.929;3600000;0
780;5311;8;0;0;0;0;.00nan;0;0
780;13714;8;74;26;1;25;.962;3547000;0
780;86192;21;100;26;0;26;1.000;3600000;0
780;143156;21;0;0;0;0;.00nan;0;0
781;848;22;0;0;0;0;.00nan;0;0
781;987;22;75;21;1;20;.952;3600000;0
781;8424;28;0;0;0;0;.00nan;0;0
781;152835;28;61;42;5;37;.881;3600000;0
782;163695;9;27;20;5;15;.750;3525000;0
782;175092;9;0;0;0;0;.00nan;0;0
782;176995;30;0;0;0;0;.00nan;0;0
782;36674;30;80;35;3;32;.914;3600000;0
783;163423;26;0;0;0;0;.00nan;0;0
783;179154;26;100;44;1;43;.977;3600000;0
783;46492;0;0;0;0;0;.00nan;0;0
783;91178;0;95;35;2;33;.943;3573000;0
784;2059;23;92;36;1;35;.972;3546000;0
784;57859;15;97;24;0;24;1.000;3600000;0
784;65762;23;0;0;0;0;.00nan;0;0
784;85727;15;0;0;0;0;.00nan;0;0
785;676;34;48;24;4;20;.833;3776000;0
785;37818;29;78;47;5;42;.894;3776000;0
785;78806;34;0;0;0;0;.00nan;0;0
785;152710;29;0;0;0;0;.00nan;0;0
786;5311;8;71;28;3;25;.893;3600000;0
786;13714;8;0;0;0;0;.00nan;0;0
786;69536;10;50;30;4;26;.867;3600000;0
786;152717;10;0;0;0;0;.00nan;0;0
787;19391;32;0;0;0;0;.00nan;0;0
787;20693;24;61;27;3;24;.889;3600000;0
787;57338;24;0;0;0;0;.00nan;0;0
787;58830;32;71;42;4;38;.905;3600000;0
788;14866;20;64;36;4;32;.889;3984000;0
788;34745;20;0;0;0;0;.00nan;0;0
788;144705;17;0;0;0;0;.00nan;0;0
788;146862;17;87;42;3;39;.929;3980000;0
789;9235;4838;66;29;3;26;.897;3559000;0
789;167642;18;0;0;0;0;.00nan;0;0
789;55802;18;67;24;2;22;.917;3600000;0
789;143749;4838;0;0;0;0;.00nan;0;0
790;20432;31;26;24;6;18;.750;3600000;0
790;86192;21;97;46;2;44;.957;3600000;0
790;86360;31;0;0;0;0;.00nan;0;0
790;143156;21;0;0;0;0;.00nan;0;0
791;163423;26;77;43;4;39;.907;3571000;0
791;8424;28;0;0;0;0;.00nan;0;0
791;179154;26;0;0;0;0;.00nan;0;0
791;152835;28;67;32;3;29;.906;3600000;0
792;166646;16;0;0;0;0;.00nan;0;0
792;174718;25;78;39;3;36;.923;3600000;0
792;53842;16;37;25;5;20;.800;3530000;0
792;148958;25;0;0;0;0;.00nan;0;0
793;2059;23;76;37;3;34;.919;3600000;0
793;163695;9;0;0;0;0;.00nan;0;0
793;175092;9;50;29;4;25;.862;3586000;0
793;65762;23;0;0;0;0;.00nan;0;0
794;14866;20;50;28;4;24;.857;3522000;0
794;34745;20;0;0;0;0;.00nan;0;0
794;37818;29;99;59;2;57;.966;3600000;0
794;152710;29;0;0;0;0;.00nan;0;0
795;176995;30;0;0;0;0;.00nan;0;0
795;36674;30;72;34;3;31;.912;3729000;0
795;69536;10;0;0;0;0;.00nan;0;0
795;152717;10;51;31;4;27;.871;3729000;0
796;676;34;0;0;0;0;.00nan;0;0
796;19391;32;100;33;0;33;1.000;3600000;0
796;58830;32;0;0;0;0;.00nan;0;0
796;78806;34;64;28;3;25;.893;3600000;0
797;848;22;67;17;1;16;.941;3600000;0
797;987;22;0;0;0;0;.00nan;0;0
797;20432;31;0;0;0;0;.00nan;0;0
797;86360;31;72;41;4;37;.902;3600000;0
798;5311;8;0;0;0;0;.00nan;0;0
798;13714;8;81;24;1;23;.958;3600000;0
798;57859;15;62;41;5;36;.878;3600000;0
798;85727;15;0;0;0;0;.00nan;0;0
799;9235;4838;45;55;9;46;.836;3600000;0
799;43757;12;0;0;0;0;.00nan;0;0
799;85798;12;70;22;2;20;.909;3600000;0
799;143749;4838;0;0;0;0;.00nan;0;0
800;166646;16;0;0;0;0;.00nan;0;0
800;20693;24;78;38;4;34;.895;3600000;0
800;53842;16;60;14;1;13;.929;3600000;0
800;57338;24;0;0;0;0;.00nan;0;0
801;174718;25;0;0;0;0;.00nan;0;0
801;86192;21;54;32;4;28;.875;4087000;0
801;143156;21;0;0;0;0;.00nan;0;0
801;148958;25;74;37;3;34;.919;4087000;0
802;163565;19;91;23;1;22;.957;3600000;0
802;167642;18;80;30;1;29;.967;3107000;0
802;14305;19;0;0;0;0;.00nan;0;0
802;55802;18;30;9;3;6;.667;493000;0
803;46492;0;90;33;1;32;.970;3600000;0
803;91178;0;0;0;0;0;.00nan;0;0
803;141998;35;0;0;0;0;.00nan;0;0
803;143473;35;48;32;4;28;.875;3600000;0
804;166751;5;66;25;3;22;.880;3600000;0
804;2059;23;69;37;4;33;.892;3544000;0
804;36755;5;0;0;0;0;.00nan;0;0
804;65762;23;0;0;0;0;.00nan;0;0
805;163423;26;0;0;0;0;.00nan;0;0
805;179154;26;66;37;4;33;.892;3600000;0
805;144705;17;74;28;2;26;.929;3600000;0
805;146862;17;0;0;0;0;.00nan;0;0
806;848;22;0;0;0;0;.00nan;0;0
806;987;22;92;36;2;34;.944;4200000;0
806;176995;30;0;0;0;0;.00nan;0;0
806;36674;30;92;36;2;34;.944;4200000;0
807;163695;9;0;0;0;0;.00nan;0;0
807;14866;20;56;12;1;11;.917;3600000;0
807;175092;9;97;53;2;51;.962;3600000;0
807;34745;20;0;0;0;0;.00nan;0;0
808;5311;8;0;0;0;0;.00nan;0;0
808;13714;8;50;31;4;27;.871;3536000;0
808;37818;29;90;36;2;34;.944;3600000;0
808;152710;29;0;0;0;0;.00nan;0;0
809;57859;15;38;22;4;18;.818;3562000;0
809;69536;10;0;0;0;0;.00nan;0;0
809;85727;15;0;0;0;0;.00nan;0;0
809;152717;10;90;48;3;45;.938;3600000;0
810;168712;14;0;0;0;0;.00nan;0;0
810;20432;31;62;35;4;31;.886;3563000;0
810;59540;14;48;18;3;15;.833;3600000;0
810;86360;31;0;0;0;0;.00nan;0;0
811;556;3;44;24;5;19;.792;4200000;0
811;615;3;0;0;0;0;.00nan;0;0
811;8424;28;0;0;0;0;.00nan;0;0
811;152835;28;83;45;5;40;.889;4200000;0
812;676;34;87;33;2;31;.939;3777000;0
812;169868;4182;0;0;0;0;.00nan;0;0
812;78806;34;0;0;0;0;.00nan;0;0
812;147945;4182;71;38;3;35;.921;3777000;0
813;19391;32;0;0;0;0;.00nan;0;0
813;20693;24;0;0;0;0;.00nan;0;0
813;57338;24;56;23;3;20;.870;3686000;0
813;58830;32;76;44;4;40;.909;3686000;0
814;1669;33;0;0;0;0;.00nan;0;0
814;43757;12;0;0;0;0;.00nan;0;0
814;85798;12;63;27;2;25;.926;3600000;0
814;149452;33;70;46;5;41;.891;3600000;0
815;167642;18;0;0;0;0;.00nan;0;0
815;166381;27;0;0;0;0;.00nan;0;0
815;175660;27;60;21;2;19;.905;3580000;0
815;55802;18;99;45;1;44;.978;3600000;0
816;141998;35;100;31;0;31;1.000;3600000;0
816;143473;35;0;0;0;0;.00nan;0;0
816;144705;17;0;0;0;0;.00nan;0;0
816;146862;17;67;22;2;20;.909;3555000;0
817;2059;23;0;0;0;0;.00nan;0;0
817;14866;20;0;0;0;0;.00nan;0;0
817;34745;20;70;24;2;22;.917;3600000;0
817;65762;23;56;32;4;28;.875;3525000;0
818;169868;4182;0;0;0;0;.00nan;0;0
818;69536;10;78;25;1;24;.960;3600000;0
818;147945;4182;83;36;3;33;.917;3569000;0
818;152717;10;0;0;0;0;.00nan;0;0
819;176995;30;0;0;0;0;.00nan;0;0
819;36674;30;50;24;4;20;.833;3568000;0
819;86192;21;96;42;2;40;.952;3600000;0
819;143156;21;0;0;0;0;.00nan;0;0
820;676;34;43;24;4;20;.833;3515000;0
820;43757;12;0;0;0;0;.00nan;0;0
820;78806;34;0;0;0;0;.00nan;0;0
820;85798;12;71;34;3;31;.912;3600000;0
821;166646;16;0;0;0;0;.00nan;0;0
821;9235;4838;0;0;0;0;.00nan;0;0
821;53842;16;66;17;2;15;.882;3867000;0
821;143749;4838;96;38;1;37;.974;3867000;0
822;163695;9;46;28;4;24;.857;3600000;0
822;20432;31;47;33;5;28;.848;3600000;0
822;175092;9;0;0;0;0;.00nan;0;0
822;86360;31;0;0;0;0;.00nan;0;0
823;166381;27;54;15;2;13;.867;1425000;0
823;175660;27;39;20;4;16;.800;2175000;0
823;46492;0;84;40;2;38;.950;3600000;0
823;91178;0;0;0;0;0;.00nan;0;0
824;163565;19;0;0;0;0;.00nan;0;0
824;14305;19;100;36;0;36;1.000;3600000;0
824;144705;17;0;0;0;0;.00nan;0;0
824;146862;17;90;35;2;33;.943;3540000;0
825;556;3;100;46;1;45;.978;3600000;0
825;615;3;0;0;0;0;.00nan;0;0
825;168712;14;0;0;0;0;.00nan;0;0
825;59540;14;32;25;5;20;.800;3600000;0
826;8424;28;35;29;6;23;.793;3600000;0
826;141998;35;100;38;2;36;.947;3600000;0
826;143473;35;0;0;0;0;.00nan;0;0
826;152835;28;0;0;0;0;.00nan;0;0
827;5311;8;0;0;0;0;.00nan;0;0
827;13714;8;92;41;3;38;.927;3600000;0
827;14866;20;44;20;4;16;.800;2275000;0
827;34745;20;63;11;0;11;1.000;1305000;0
828;848;22;98;26;0;26;1.000;3600000;0
828;987;22;0;0;0;0;.00nan;0;0
828;169868;4182;70;51;6;45;.882;3600000;0
828;147945;4182;0;0;0;0;.00nan;0;0
829;163423;26;0;0;0;0;.00nan;0;0
829;179154;26;86;38;3;35;.921;3600000;0
829;57859;15;0;0;0;0;.00nan;0;0
829;85727;15;77;23;1;22;.957;3600000;0
830;1669;33;0;0;0;0;.00nan;0;0
830;69536;10;0;0;0;0;.00nan;0;0
830;149452;33;99;39;1;38;.974;3600000;0
830;152717;10;64;31;4;27;.871;3600000;0
831;2059;23;71;29;2;27;.931;3600000;0
831;174718;25;84;25;1;24;.960;3600000;0
831;65762;23;0;0;0;0;.00nan;0;0
831;148958;25;0;0;0;0;.00nan;0;0
832;166751;5;76;30;2;28;.933;3600000;0
832;167642;18;48;30;4;26;.867;3550000;0
832;36755;5;0;0;0;0;.00nan;0;0
832;55802;18;0;0;0;0;.00nan;0;0
833;20693;24;79;28;2;26;.929;3600000;0
833;37818;29;34;29;6;23;.793;3600000;0
833;57338;24;0;0;0;0;.00nan;0;0
833;152710;29;0;0;0;0;.00nan;0;0
834;841;11;0;0;0;0;.00nan;0;0
834;19391;32;69;46;5;41;.891;3545000;0
834;31972;11;42;26;4;22;.846;3600000;0
834;58830;32;0;0;0;0;.00nan;0;0
835;166646;16;0;0;0;0;.00nan;0;0
835;43757;12;0;0;0;0;.00nan;0;0
835;53842;16;92;33;1;32;.970;3600000;0
835;85798;12;65;33;3;30;.909;3552000;0
836;163695;9;0;0;0;0;.00nan;0;0
836;169868;4182;0;0;0;0;.00nan;0;0
836;175092;9;80;32;2;30;.938;3600000;0
836;147945;4182;73;21;1;20;.952;3600000;0
837;37818;29;0;0;0;0;.00nan;0;0
837;46492;0;59;30;3;27;.900;3600000;0
837;91178;0;0;0;0;0;.00nan;0;0
837;152710;29;100;30;0;30;1.000;3600000;0
838;166381;27;0;0;0;0;.00nan;0;0
838;175660;27;69;30;3;27;.900;3600000;0
838;69536;10;0;0;0;0;.00nan;0;0
838;152717;10;87;29;1;28;.966;3600000;0
839;86192;21;52;17;2;15;.882;3544000;0
839;143156;21;0;0;0;0;.00nan;0;0
839;144705;17;0;0;0;0;.00nan;0;0
839;146862;17;100;35;1;34;.971;3600000;0
840;556;3;85;29;1;28;.966;3600000;0
840;615;3;0;0;0;0;.00nan;0;0
840;163565;19;0;0;0;0;.00nan;0;0
840;14305;19;79;30;2;28;.933;3600000;0
841;5311;8;0;0;0;0;.00nan;0;0
841;13714;8;85;30;1;29;.967;3600000;0
841;20432;31;62;31;4;27;.871;2148000;0
841;86360;31;59;7;0;7;1.000;1452000;0
842;676;34;41;24;4;20;.833;3553000;0
842;8424;28;0;0;0;0;.00nan;0;0
842;78806;34;0;0;0;0;.00nan;0;0
842;152835;28;86;33;2;31;.939;3600000;0
843;167642;18;0;0;0;0;.00nan;0;0
843;55802;18;79;36;1;35;.972;4200000;0
843;141998;35;0;0;0;0;.00nan;0;0
843;143473;35;86;33;1;32;.970;4200000;0
844;20693;24;0;0;0;0;.00nan;0;0
844;174718;25;0;0;0;0;.00nan;0;0
844;57338;24;88;36;2;34;.944;3589000;0
844;148958;25;75;25;1;24;.960;3600000;0
845;841;11;49;32;5;27;.844;3553000;0
845;176995;30;0;0;0;0;.00nan;0;0
845;31972;11;0;0;0;0;.00nan;0;0
845;36674;30;63;27;3;24;.889;3600000;0
846;1669;33;0;0;0;0;.00nan;0;0
846;163423;26;0;0;0;0;.00nan;0;0
846;179154;26;100;37;0;37;1.000;3600000;0
846;149452;33;97;29;1;28;.966;3598000;0
847;166751;5;83;40;3;37;.925;4179000;0
847;2059;23;59;19;2;17;.895;4179000;0
847;36755;5;0;0;0;0;.00nan;0;0
847;65762;23;0;0;0;0;.00nan;0;0
848;43757;12;0;0;0;0;.00nan;0;0
848;57859;15;0;0;0;0;.00nan;0;0
848;85727;15;72;34;3;31;.912;3924000;0
848;85798;12;86;33;2;31;.939;3924000;0
849;163423;26;45;5;1;4;.800;667000;0
849;167642;18;0;0;0;0;.00nan;0;0
849;179154;26;35;32;6;26;.813;2933000;0
849;55802;18;47;27;4;23;.852;3600000;0
850;556;3;87;35;2;33;.943;3600000;0
850;615;3;0;0;0;0;.00nan;0;0
850;174718;25;0;0;0;0;.00nan;0;0
850;148958;25;61;29;3;26;.897;3600000;0
851;166751;5;30;37;7;30;.811;2822000;0
851;176995;30;62;29;4;25;.862;3600000;0
851;36674;30;0;0;0;0;.00nan;0;0
851;36755;5;53;3;0;3;1.000;778000;0
852;163695;9;44;37;6;31;.838;2966000;0
852;166381;27;0;0;0;0;.00nan;0;0
852;175092;9;33;12;3;9;.750;634000;0
852;175660;27;72;28;2;26;.929;3600000;0
853;166646;16;56;25;3;22;.880;3600000;0
853;46492;0;43;22;4;18;.818;3600000;0
853;53842;16;0;0;0;0;.00nan;0;0
853;91178;0;0;0;0;0;.00nan;0;0
854;1669;33;0;0;0;0;.00nan;0;0
854;141998;35;39;1;1;0;.000;270000;0
854;143473;35;78;44;4;40;.909;3322000;0
854;149452;33;78;32;2;30;.938;3600000;0
855;20432;31;0;0;0;0;.00nan;0;0
855;37818;29;0;0;0;0;.00nan;0;0
855;86360;31;73;48;5;43;.896;3993000;0
855;152710;29;59;32;4;28;.875;3993000;0
856;14866;20;67;29;3;26;.897;3600000;0
856;34745;20;0;0;0;0;.00nan;0;0
856;144705;17;88;33;2;31;.939;3600000;0
856;146862;17;0;0;0;0;.00nan;0;0
857;163565;19;65;26;2;24;.923;3600000;0
857;8424;28;0;0;0;0;.00nan;0;0
857;14305;19;0;0;0;0;.00nan;0;0
857;152835;28;61;28;3;25;.893;3570000;0
858;676;34;49;37;6;31;.838;3194000;0
858;69536;10;100;32;0;32;1.000;3600000;0
858;78806;34;57;7;0;7;1.000;406000;0
858;152717;10;0;0;0;0;.00nan;0;0
859;2059;23;63;24;2;22;.917;3600000;0
859;19391;32;0;0;0;0;.00nan;0;0
859;58830;32;68;36;4;32;.889;3599000;0
859;65762;23;0;0;0;0;.00nan;0;0
860;841;11;0;0;0;0;.00nan;0;0
860;168712;14;0;0;0;0;.00nan;0;0
860;31972;11;67;26;2;24;.923;3600000;0
860;59540;14;40;22;4;18;.818;3513000;0
861;9235;4838;0;0;0;0;.00nan;0;0
861;57859;15;26;14;4;10;.714;3558000;0
861;85727;15;0;0;0;0;.00nan;0;0
861;143749;4838;100;49;2;47;.959;3600000;0
862;848;22;0;0;0;0;.00nan;0;0
862;987;22;52;31;5;26;.839;3898000;0
862;86192;21;69;33;4;29;.879;3891000;0
862;143156;21;0;0;0;0;.00nan;0;0
863;5311;8;0;0;0;0;.00nan;0;0
863;13714;8;100;36;1;35;.972;3600000;0
863;43757;12;43;24;4;20;.833;3600000;0
863;85798;12;0;0;0;0;.00nan;0;0
864;166381;27;66;28;3;25;.893;3600000;0
864;20693;24;71;41;4;37;.902;3595000;0
864;175660;27;0;0;0;0;.00nan;0;0
864;57338;24;0;0;0;0;.00nan;0;0
865;163565;19;94;43;2;41;.953;4200000;0
865;14305;19;0;0;0;0;.00nan;0;0
865;46492;0;86;37;2;35;.946;4200000;0
865;91178;0;0;0;0;0;.00nan;0;0
866;163423;26;0;0;0;0;.00nan;0;0
866;163695;9;0;0;0;0;.00nan;0;0
866;179154;26;69;23;2;21;.913;3600000;0
866;175092;9;41;27;4;23;.852;3586000;0
867;8424;28;0;0;0;0;.00nan;0;0
867;141998;35;0;0;0;0;.00nan;0;0
867;143473;35;64;18;2;16;.889;3600000;0
867;152835;28;71;34;3;31;.912;3548000;0
868;166646;16;0;0;0;0;.00nan;0;0
868;2059;23;59;24;3;21;.875;3600000;0
868;53842;16;63;21;2;19;.905;3600000;0
868;65762;23;0;0;0;0;.00nan;0;0
869;166751;5;0;0;0;0;.00nan;0;0
869;169868;4182;0;0;0;0;.00nan;0;0
869;36755;5;84;30;2;28;.933;4200000;0
869;147945;4182;64;24;2;22;.917;4200000;0
870;167642;18;0;0;0;0;.00nan;0;0
870;43757;12;0;0;0;0;.00nan;0;0
870;55802;18;92;48;3;45;.938;3556000;0
870;85798;12;70;29;2;27;.931;3600000;0
871;19391;32;100;35;0;35;1.000;3600000;0
871;176995;30;0;0;0;0;.00nan;0;0
871;36674;30;43;30;4;26;.867;3600000;0
871;58830;32;0;0;0;0;.00nan;0;0
872;841;11;77;22;1;21;.955;3600000;0
872;9235;4838;87;36;2;34;.944;3545000;0
872;31972;11;0;0;0;0;.00nan;0;0
872;143749;4838;0;0;0;0;.00nan;0;0
873;174718;25;87;35;2;33;.943;4200000;0
873;57859;15;0;0;0;0;.00nan;0;0
873;85727;15;95;41;2;39;.951;4200000;0
873;148958;25;0;0;0;0;.00nan;0;0
874;556;3;81;32;1;31;.969;3600000;0
874;615;3;0;0;0;0;.00nan;0;0
874;20432;31;57;41;6;35;.854;3600000;0
874;86360;31;0;0;0;0;.00nan;0;0
875;556;3;87;34;1;33;.971;3600000;0
875;615;3;0;0;0;0;.00nan;0;0
875;37818;29;99;27;0;27;1.000;3600000;0
875;152710;29;0;0;0;0;.00nan;0;0
876;163423;26;38;32;6;26;.813;2324000;0
876;179154;26;81;19;0;19;1.000;1276000;0
876;86192;21;55;21;3;18;.857;3600000;0
876;143156;21;0;0;0;0;.00nan;0;0
877;848;22;75;27;2;25;.926;3600000;0
877;987;22;0;0;0;0;.00nan;0;0
877;20693;24;78;38;3;35;.921;3566000;0
877;57338;24;0;0;0;0;.00nan;0;0
878;14866;20;73;21;1;20;.952;3600000;0
878;34745;20;0;0;0;0;.00nan;0;0
878;69536;10;83;38;2;36;.947;3600000;0
878;152717;10;0;0;0;0;.00nan;0;0
879;166646;16;79;25;1;24;.960;3544000;0
879;19391;32;0;0;0;0;.00nan;0;0
879;53842;16;0;0;0;0;.00nan;0;0
879;58830;32;100;45;0;45;1.000;3600000;0
880;2059;23;0;0;0;0;.00nan;0;0
880;5311;8;55;28;4;24;.857;4200000;0
880;13714;8;0;0;0;0;.00nan;0;0
880;65762;23;59;41;4;37;.902;4200000;0
881;1669;33;0;0;0;0;.00nan;0;0
881;9235;4838;0;0;0;0;.00nan;0;0
881;143749;4838;98;59;3;56;.949;3600000;0
881;149452;33;63;17;1;16;.941;3600000;0
882;166381;27;0;0;0;0;.00nan;0;0
882;168712;14;0;0;0;0;.00nan;0;0
882;175660;27;80;31;2;29;.935;3600000;0
882;59540;14;56;34;5;29;.853;3600000;0
883;46492;0;53;24;4;20;.833;3562000;0
883;91178;0;0;0;0;0;.00nan;0;0
883;144705;17;0;0;0;0;.00nan;0;0
883;146862;17;65;21;2;19;.905;3600000;0
884;676;34;45;26;4;22;.846;3538000;0
884;174718;25;0;0;0;0;.00nan;0;0
884;78806;34;0;0;0;0;.00nan;0;0
884;148958;25;98;48;3;45;.938;3600000;0
885;163565;19;0;0;0;0;.00nan;0;0
885;14305;19;78;44;5;39;.886;4200000;0
885;168712;14;48;28;5;23;.821;4200000;0
885;59540;14;0;0;0;0;.00nan;0;0
886;8424;28;0;0;0;0;.00nan;0;0
886;43757;12;0;0;0;0;.00nan;0;0
886;85798;12;80;34;2;32;.941;4200000;0
886;152835;28;82;33;2;31;.939;4200000;0
887;163695;9;57;21;3;18;.857;3600000;0
887;167642;18;0;0;0;0;.00nan;0;0
887;175092;9;0;0;0;0;.00nan;0;0
887;55802;18;81;41;4;37;.902;3548000;0
888;37818;29;80;39;3;36;.923;3600000;0
888;57859;15;0;0;0;0;.00nan;0;0
888;85727;15;48;15;2;13;.867;3600000;0
888;152710;29;0;0;0;0;.00nan;0;0
889;166751;5;92;43;2;41;.953;3643000;0
889;5311;8;0;0;0;0;.00nan;0;0
889;13714;8;72;20;1;19;.950;3643000;0
889;36755;5;0;0;0;0;.00nan;0;0
890;69536;10;0;0;0;0;.00nan;0;0
890;86192;21;54;34;4;30;.882;3600000;0
890;143156;21;0;0;0;0;.00nan;0;0
890;152717;10;90;29;1;28;.966;3600000;0
891;556;3;77;31;2;29;.935;4168000;0
891;615;3;0;0;0;0;.00nan;0;0
891;163423;26;0;0;0;0;.00nan;0;0
891;179154;26;87;38;1;37;.974;4168000;0
892;20693;24;94;30;1;29;.967;3600000;0
892;57338;24;0;0;0;0;.00nan;0;0
892;144705;17;88;39;3;36;.923;3568000;0
892;146862;17;0;0;0;0;.00nan;0;0
893;14866;20;54;21;3;18;.857;3600000;0
893;20432;31;68;50;5;45;.900;3575000;0
893;34745;20;0;0;0;0;.00nan;0;0
893;86360;31;0;0;0;0;.00nan;0;0
894;848;22;47;27;4;23;.852;3591000;0
894;987;22;0;0;0;0;.00nan;0;0
894;141998;35;0;0;0;0;.00nan;0;0
894;143473;35;85;28;2;26;.929;3600000;0
895;163695;9;0;0;0;0;.00nan;0;0
895;175092;9;92;50;3;47;.940;3600000;0
895;176995;30;48;0;0;0;.00nan;261000;0
895;36674;30;36;29;6;23;.793;3339000;0
896;2059;23;88;36;2;34;.944;3585000;0
896;169868;4182;0;0;0;0;.00nan;0;0
896;65762;23;0;0;0;0;.00nan;0;0
896;147945;4182;85;28;1;27;.964;3600000;0
897;8424;28;60;27;3;24;.889;4200000;0
897;9235;4838;0;0;0;0;.00nan;0;0
897;143749;4838;77;45;4;41;.911;4200000;0
897;152835;28;0;0;0;0;.00nan;0;0
898;1669;33;0;0;0;0;.00nan;0;0
898;166381;27;0;0;0;0;.00nan;0;0
898;175660;27;86;44;3;41;.932;4200000;0
898;149452;33;76;34;3;31;.912;4200000;0
899;168712;14;0;0;0;0;.00nan;0;0
899;46492;0;0;0;0;0;.00nan;0;0
899;59540;14;65;27;3;24;.889;3600000;0
899;91178;0;56;39;5;34;.872;3527000;0
900;19391;32;0;0;0;0;.00nan;0;0
900;174718;25;0;0;0;0;.00nan;0;0
900;58830;32;39;49;8;41;.837;3600000;0
900;148958;25;61;20;2;18;.900;3600000;0
901;166646;16;0;0;0;0;.00nan;0;0
901;167642;18;0;0;0;0;.00nan;0;0
901;53842;16;49;24;4;20;.833;3571000;0
901;55802;18;93;33;2;31;.939;3600000;0
902;69536;10;0;0;0;0;.00nan;0;0
902;144705;17;0;0;0;0;.00nan;0;0
902;146862;17;90;33;1;32;.970;3600000;0
902;152717;10;52;38;5;33;.868;3600000;0
903;848;22;0;0;0;0;.00nan;0;0
903;987;22;100;34;0;34;1.000;3600000;0
903;20432;31;79;32;2;30;.938;3567000;0
903;86360;31;0;0;0;0;.00nan;0;0
904;676;34;0;0;0;0;.00nan;0;0
904;78806;34;62;37;4;33;.892;3560000;0
904;86192;21;59;24;3;21;.875;3600000;0
904;143156;21;0;0;0;0;.00nan;0;0
905;14866;20;58;27;4;23;.852;3598000;0
905;34745;20;0;0;0;0;.00nan;0;0
905;37818;29;100;48;3;45;.938;3600000;0
905;152710;29;0;0;0;0;.00nan;0;0
906;163423;26;0;0;0;0;.00nan;0;0
906;179154;26;93;34;1;33;.971;3600000;0
906;57859;15;0;0;0;0;.00nan;0;0
906;85727;15;51;21;3;18;.857;3590000;0
907;5311;8;0;0;0;0;.00nan;0;0
907;8424;28;0;0;0;0;.00nan;0;0
907;13714;8;75;43;5;38;.884;3600000;0
907;152835;28;59;18;2;16;.889;3600000;0
908;166751;5;0;0;0;0;.00nan;0;0
908;36755;5;63;51;6;45;.882;3956000;0
908;141998;35;0;0;0;0;.00nan;0;0
908;143473;35;53;32;5;27;.844;3956000;0
909;556;3;0;0;0;0;.00nan;0;0
909;615;3;68;23;2;21;.913;3600000;0
909;9235;4838;0;0;0;0;.00nan;0;0
909;143749;4838;81;56;5;51;.911;3600000;0
910;2059;23;100;28;0;28;1.000;3600000;0
910;163695;9;0;0;0;0;.00nan;0;0
910;175092;9;70;26;2;24;.923;3529000;0
910;65762;23;0;0;0;0;.00nan;0;0
911;167642;18;43;37;6;31;.838;3207000;0
911;176995;30;0;0;0;0;.00nan;0;0
911;36674;30;60;27;4;23;.852;3600000;0
911;55802;18;61;4;0;4;1.000;375000;0
912;166646;16;84;33;2;31;.939;3600000;0
912;169868;4182;0;0;0;0;.00nan;0;0
912;53842;16;0;0;0;0;.00nan;0;0
912;147945;4182;86;41;4;37;.902;3600000;0
913;841;11;0;0;0;0;.00nan;0;0
913;1669;33;0;0;0;0;.00nan;0;0
913;31972;11;41;36;6;30;.833;3600000;0
913;149452;33;58;25;3;22;.880;3600000;0
914;163565;19;80;43;4;39;.907;4200000;0
914;14305;19;0;0;0;0;.00nan;0;0
914;166381;27;0;0;0;0;.00nan;0;0
914;175660;27;76;32;4;28;.875;4175000;0
915;20432;31;0;0;0;0;.00nan;0;0
915;69536;10;53;27;4;23;.852;3549000;0
915;86360;31;85;42;3;39;.929;3600000;0
915;152717;10;0;0;0;0;.00nan;0;0
916;676;34;84;33;1;32;.970;3600000;0
916;20693;24;41;22;4;18;.818;3600000;0
916;57338;24;0;0;0;0;.00nan;0;0
916;78806;34;0;0;0;0;.00nan;0;0
917;46492;0;98;49;2;47;.959;4200000;0
917;57859;15;84;35;2;33;.943;4200000;0
917;85727;15;0;0;0;0;.00nan;0;0
917;91178;0;0;0;0;0;.00nan;0;0
918;168712;14;0;0;0;0;.00nan;0;0
918;59540;14;82;35;4;31;.886;3558000;0
918;86192;21;0;0;0;0;.00nan;0;0
918;143156;21;70;34;3;31;.912;3600000;0
919;166751;5;92;42;3;39;.929;3600000;0
919;174718;25;0;0;0;0;.00nan;0;0
919;36755;5;0;0;0;0;.00nan;0;0
919;148958;25;88;17;0;17;1.000;3600000;0
920;19391;32;76;27;2;25;.926;3544000;0
920;43757;12;0;0;0;0;.00nan;0;0
920;58830;32;0;0;0;0;.00nan;0;0
920;85798;12;81;27;1;26;.963;3600000;0
921;1669;33;0;0;0;0;.00nan;0;0
921;163565;19;0;0;0;0;.00nan;0;0
921;14305;19;78;32;2;30;.938;3600000;0
921;149452;33;60;39;5;34;.872;3600000;0
922;556;3;93;68;6;62;.912;4200000;0
922;615;3;0;0;0;0;.00nan;0;0
922;14866;20;0;0;0;0;.00nan;0;0
922;34745;20;22;26;6;20;.769;4159000;0
923;848;22;0;0;0;0;.00nan;0;0
923;987;22;36;18;4;14;.778;3600000;0
923;163423;26;0;0;0;0;.00nan;0;0
923;179154;26;73;52;5;47;.904;3600000;0
924;167642;18;0;0;0;0;.00nan;0;0
924;166381;27;0;0;0;0;.00nan;0;0
924;175660;27;56;32;4;28;.875;3555000;0
924;55802;18;85;42;3;39;.929;3600000;0
925;163695;9;0;0;0;0;.00nan;0;0
925;169868;4182;0;0;0;0;.00nan;0;0
925;175092;9;41;18;3;15;.833;3600000;0
925;147945;4182;53;31;4;27;.871;3590000;0
926;166751;5;0;0;0;0;.00nan;0;0
926;14866;20;74;23;1;22;.957;3600000;0
926;34745;20;0;0;0;0;.00nan;0;0
926;36755;5;69;38;4;34;.895;3600000;0
927;37818;29;35;27;5;22;.815;3600000;0
927;46492;0;0;0;0;0;.00nan;0;0
927;91178;0;41;36;6;30;.833;3592000;0
927;152710;29;0;0;0;0;.00nan;0;0
928;43757;12;0;0;0;0;.00nan;0;0
928;85798;12;65;28;3;25;.893;3585000;0
928;144705;17;0;0;0;0;.00nan;0;0
928;146862;17;79;29;2;27;.931;3600000;0
929;676;34;79;30;3;27;.900;3581000;0
929;20432;31;100;35;1;34;.971;3600000;0
929;78806;34;0;0;0;0;.00nan;0;0
929;86360;31;0;0;0;0;.00nan;0;0
930;8424;28;0;0;0;0;.00nan;0;0
930;9235;4838;52;32;6;26;.813;2546000;0
930;143749;4838;50;16;2;14;.875;1054000;0
930;152835;28;56;18;2;16;.889;3600000;0
931;166646;16;0;0;0;0;.00nan;0;0
931;53842;16;68;31;3;28;.903;3541000;0
931;57859;15;91;35;2;33;.943;3600000;0
931;85727;15;0;0;0;0;.00nan;0;0
932;556;3;54;28;4;24;.857;3599000;0
932;615;3;0;0;0;0;.00nan;0;0
932;1669;33;67;35;3;32;.914;3600000;0
932;149452;33;0;0;0;0;.00nan;0;0
933;19391;32;95;58;6;52;.897;3600000;0
933;58830;32;0;0;0;0;.00nan;0;0
933;141998;35;0;0;0;0;.00nan;0;0
933;143473;35;76;49;5;44;.898;3600000;0
934;166381;27;35;32;6;26;.813;3050000;0
934;175660;27;48;0;0;0;.00nan;550000;0
934;176995;30;0;0;0;0;.00nan;0;0
934;36674;30;74;23;1;22;.957;3600000;0
935;5311;8;0;0;0;0;.00nan;0;0
935;163423;26;89;31;2;29;.935;3600000;0
935;13714;8;51;37;5;32;.865;3600000;0
935;179154;26;0;0;0;0;.00nan;0;0
936;2059;23;79;35;1;34;.971;4200000;0
936;20693;24;93;38;1;37;.974;4200000;0
936;57338;24;0;0;0;0;.00nan;0;0
936;65762;23;0;0;0;0;.00nan;0;0
937;841;11;0;0;0;0;.00nan;0;0
937;31972;11;92;45;3;42;.933;4200000;0
937;69536;10;0;0;0;0;.00nan;0;0
937;152717;10;96;48;3;45;.938;4200000;0
938;168712;14;0;0;0;0;.00nan;0;0
938;59540;14;92;29;1;28;.966;3600000;0
938;86192;21;98;37;2;35;.946;3545000;0
938;143156;21;0;0;0;0;.00nan;0;0
939;167642;18;0;0;0;0;.00nan;0;0
939;55802;18;92;32;1;31;.969;3600000;0
939;141998;35;45;24;4;20;.833;3600000;0
939;143473;35;0;0;0;0;.00nan;0;0
940;163695;9;48;24;3;21;.875;3600000;0
940;9235;4838;0;0;0;0;.00nan;0;0
940;175092;9;0;0;0;0;.00nan;0;0
940;143749;4838;65;33;4;29;.879;3579000;0
941;168712;14;84;38;2;36;.947;3893000;0
941;57859;15;91;43;3;40;.930;3893000;0
941;59540;14;0;0;0;0;.00nan;0;0
941;85727;15;0;0;0;0;.00nan;0;0
942;848;22;0;0;0;0;.00nan;0;0
942;987;22;84;17;0;17;1.000;3600000;0
942;166751;5;0;0;0;0;.00nan;0;0
942;36755;5;78;41;4;37;.902;3600000;0
943;37818;29;97;36;1;35;.972;3600000;0
943;144705;17;0;0;0;0;.00nan;0;0
943;146862;17;66;41;5;36;.878;3600000;0
943;152710;29;0;0;0;0;.00nan;0;0
944;20432;31;63;26;3;23;.885;3600000;0
944;46492;0;72;34;4;30;.882;3574000;0
944;86360;31;0;0;0;0;.00nan;0;0
944;91178;0;0;0;0;0;.00nan;0;0
945;8424;28;0;0;0;0;.00nan;0;0
945;43757;12;0;0;0;0;.00nan;0;0
945;85798;12;97;44;1;43;.977;4200000;0
945;152835;28;82;29;1;28;.966;4200000;0
946;163423;26;0;0;0;0;.00nan;0;0
946;19391;32;0;0;0;0;.00nan;0;0
946;179154;26;100;46;1;45;.978;4200000;0
946;58830;32;84;25;1;24;.960;4200000;0
947;166646;16;0;0;0;0;.00nan;0;0
947;1669;33;0;0;0;0;.00nan;0;0
947;53842;16;85;25;1;24;.960;3579000;0
947;149452;33;100;26;0;26;1.000;3600000;0
948;5311;8;0;0;0;0;.00nan;0;0
948;13714;8;72;24;2;22;.917;3715000;0
948;174718;25;0;0;0;0;.00nan;0;0
948;148958;25;100;43;1;42;.977;3715000;0
949;20693;24;64;37;4;33;.892;3600000;0
949;169868;4182;0;0;0;0;.00nan;0;0
949;57338;24;0;0;0;0;.00nan;0;0
949;147945;4182;22;22;5;17;.773;3594000;0
950;2059;23;99;30;1;29;.967;3994000;0
950;166381;27;0;0;0;0;.00nan;0;0
950;175660;27;77;28;2;26;.929;3994000;0
950;65762;23;0;0;0;0;.00nan;0;0
951;841;11;0;0;0;0;.00nan;0;0
951;163565;19;0;0;0;0;.00nan;0;0
951;14305;19;90;36;2;34;.944;3600000;0
951;31972;11;67;44;5;39;.886;3600000;0
952;556;3;61;28;3;25;.893;3600000;0
952;615;3;0;0;0;0;.00nan;0;0
952;43757;12;65;30;4;26;.867;3541000;0
952;85798;12;0;0;0;0;.00nan;0;0
953;676;34;97;44;2;42;.955;3579000;0
953;14866;20;0;0;0;0;.00nan;0;0
953;55802;20;56;10;1;9;.900;3600000;0
953;78806;34;0;0;0;0;.00nan;0;0
954;163565;19;78;33;3;30;.909;3600000;0
954;14305;19;0;0;0;0;.00nan;0;0
954;69536;10;0;0;0;0;.00nan;0;0
954;152717;10;51;28;4;24;.857;3566000;0
955;19391;32;88;22;0;22;1.000;1224000;0
955;57859;15;0;0;0;0;.00nan;0;0
955;58830;32;16;25;7;18;.720;2376000;0
955;85727;15;90;29;1;28;.966;3600000;0
956;848;22;85;17;0;17;1.000;3600000;0
956;987;22;0;0;0;0;.00nan;0;0
956;163695;9;0;0;0;0;.00nan;0;0
956;175092;9;76;37;3;34;.919;3600000;0
957;167642;18;0;0;0;0;.00nan;0;0
957;169868;4182;0;0;0;0;.00nan;0;0
957;34745;18;61;36;4;32;.889;3544000;0
957;147945;4182;74;31;2;29;.935;3600000;0
958;1669;33;0;0;0;0;.00nan;0;0
958;5311;8;0;0;0;0;.00nan;0;0
958;13714;8;70;31;3;28;.903;3600000;0
958;149452;33;48;31;5;26;.839;3600000;0
959;9235;4838;0;0;0;0;.00nan;0;0
959;46492;0;0;0;0;0;.00nan;0;0
959;91178;0;84;15;0;15;1.000;3600000;0
959;143749;4838;93;37;1;36;.973;3546000;0
960;166751;5;0;0;0;0;.00nan;0;0
960;36755;5;60;42;5;37;.881;3600000;0
960;37818;29;52;17;2;15;.882;3600000;0
960;152710;29;0;0;0;0;.00nan;0;0
961;556;3;0;0;0;0;.00nan;0;0
961;615;3;65;34;4;30;.882;3600000;0
961;676;34;0;0;0;0;.00nan;0;0
961;78806;34;100;29;0;29;1.000;3600000;0
962;20432;31;100;47;1;46;.979;3600000;0
962;86360;31;0;0;0;0;.00nan;0;0
962;144705;17;0;0;0;0;.00nan;0;0
962;146862;17;75;32;2;30;.938;3551000;0
963;8424;28;0;0;0;0;.00nan;0;0
963;86192;21;27;5;3;2;.400;426000;0
963;143156;21;85;32;1;31;.969;3174000;0
963;152835;28;68;40;5;35;.875;3600000;0
964;168712;14;0;0;0;0;.00nan;0;0
964;174718;25;99;36;1;35;.972;3600000;0
964;59540;14;79;38;3;35;.921;3566000;0
964;148958;25;0;0;0;0;.00nan;0;0
965;841;11;80;25;2;23;.920;3600000;0
965;163423;26;0;0;0;0;.00nan;0;0
965;179154;26;61;47;6;41;.872;3600000;0
965;31972;11;0;0;0;0;.00nan;0;0
966;166646;16;0;0;0;0;.00nan;0;0
966;53842;16;100;32;1;31;.969;3600000;0
966;141998;35;0;0;0;0;.00nan;0;0
966;143473;35;61;23;2;21;.913;3586000;0
967;20693;24;55;27;4;23;.852;3600000;0
967;176995;30;0;0;0;0;.00nan;0;0
967;36674;30;94;34;1;33;.971;3600000;0
967;57338;24;0;0;0;0;.00nan;0;0
968;14866;20;68;34;3;31;.912;3555000;0
968;43757;12;0;0;0;0;.00nan;0;0
968;55802;20;0;0;0;0;.00nan;0;0
968;85798;12;85;30;2;28;.933;3600000;0
969;166381;27;0;0;0;0;.00nan;0;0
969;175660;27;88;28;1;27;.964;3600000;0
969;69536;10;0;0;0;0;.00nan;0;0
969;152717;10;95;48;3;45;.938;3584000;0
970;19391;32;58;37;5;32;.865;3600000;0
970;46492;0;0;0;0;0;.00nan;0;0
970;58830;32;0;0;0;0;.00nan;0;0
970;91178;0;13;20;6;14;.700;3540000;0
971;841;11;0;0;0;0;.00nan;0;0
971;166646;16;73;25;2;23;.920;3600000;0
971;31972;11;73;32;3;29;.906;3582000;0
971;53842;16;0;0;0;0;.00nan;0;0
972;2059;23;73;29;2;27;.931;3552000;0
972;163565;19;0;0;0;0;.00nan;0;0
972;14305;19;90;29;1;28;.966;3600000;0
972;65762;23;0;0;0;0;.00nan;0;0
973;167642;18;61;7;0;7;1.000;1173000;0
973;20693;24;0;0;0;0;.00nan;0;0
973;34745;18;43;35;7;28;.800;2427000;0
973;57338;24;50;18;3;15;.833;3600000;0
974;9235;4838;0;0;0;0;.00nan;0;0
974;168712;14;63;14;1;13;.929;3600000;0
974;59540;14;0;0;0;0;.00nan;0;0
974;143749;4838;79;40;4;36;.900;3600000;0
975;37818;29;100;27;0;27;1.000;3600000;0
975;86192;21;68;27;2;25;.926;3600000;0
975;143156;21;0;0;0;0;.00nan;0;0
975;152710;29;0;0;0;0;.00nan;0;0
976;676;34;0;0;0;0;.00nan;0;0
976;78806;34;66;48;6;42;.875;4130000;0
976;141998;35;0;0;0;0;.00nan;0;0
976;143473;35;61;43;5;38;.884;4130000;0
977;163695;9;69;20;2;18;.900;3600000;0
977;8424;28;0;0;0;0;.00nan;0;0
977;175092;9;0;0;0;0;.00nan;0;0
977;152835;28;73;33;3;30;.909;3580000;0
978;5311;8;0;0;0;0;.00nan;0;0
978;13714;8;29;17;4;13;.765;3600000;0
978;174718;25;0;0;0;0;.00nan;0;0
978;148958;25;100;46;1;45;.978;3600000;0
979;169868;4182;0;0;0;0;.00nan;0;0
979;176995;30;0;0;0;0;.00nan;0;0
979;36674;30;74;21;1;20;.952;4159000;0
979;147945;4182;94;50;2;48;.960;4159000;0
980;163695;9;0;0;0;0;.00nan;0;0
980;167642;18;0;0;0;0;.00nan;0;0
980;175092;9;71;19;1;18;.947;3600000;0
980;34745;18;63;47;6;41;.872;3600000;0
981;37818;29;35;32;6;26;.813;3600000;0
981;69536;10;75;33;3;30;.909;3600000;0
981;152710;29;0;0;0;0;.00nan;0;0
981;152717;10;0;0;0;0;.00nan;0;0
982;168712;14;0;0;0;0;.00nan;0;0
982;20693;24;59;41;5;36;.878;3571000;0
982;57338;24;0;0;0;0;.00nan;0;0
982;59540;14;48;27;4;23;.852;3600000;0
983;848;22;0;0;0;0;.00nan;0;0
983;987;22;100;29;0;29;1.000;3600000;0
983;141998;35;59;42;5;37;.881;3600000;0
983;143473;35;0;0;0;0;.00nan;0;0
984;1669;33;0;0;0;0;.00nan;0;0
984;144705;17;0;0;0;0;.00nan;0;0
984;146862;17;50;25;5;20;.800;3600000;0
984;149452;33;81;26;2;24;.923;3600000;0
985;19391;32;0;0;0;0;.00nan;0;0
985;169868;4182;84;24;1;23;.958;3600000;0
985;58830;32;87;42;2;40;.952;3580000;0
985;147945;4182;0;0;0;0;.00nan;0;0
986;174718;25;73;29;2;27;.931;3600000;0
986;43757;12;0;0;0;0;.00nan;0;0
986;85798;12;89;29;1;28;.966;3600000;0
986;148958;25;0;0;0;0;.00nan;0;0
987;2059;23;70;27;2;25;.926;3600000;0
987;166381;27;0;0;0;0;.00nan;0;0
987;175660;27;58;36;5;31;.861;3600000;0
987;65762;23;0;0;0;0;.00nan;0;0
988;841;11;81;27;2;25;.926;3600000;0
988;163423;26;0;0;0;0;.00nan;0;0
988;179154;26;57;38;5;33;.868;3600000;0
988;31972;11;0;0;0;0;.00nan;0;0
989;8424;28;71;37;4;33;.892;4102000;0
989;46492;0;0;0;0;0;.00nan;0;0
989;91178;0;71;33;3;30;.909;4102000;0
989;152835;28;0;0;0;0;.00nan;0;0
990;166751;5;0;0;0;0;.00nan;0;0
990;5311;8;0;0;0;0;.00nan;0;0
990;13714;8;54;19;3;16;.842;3592000;0
990;36755;5;87;36;2;34;.944;3600000;0
991;556;3;87;44;4;40;.909;3561000;0
991;615;3;0;0;0;0;.00nan;0;0
991;163565;19;62;23;3;20;.870;3600000;0
991;14305;19;0;0;0;0;.00nan;0;0
992;163695;9;98;45;3;42;.933;3600000;0
992;8424;28;0;0;0;0;.00nan;0;0
992;175092;9;0;0;0;0;.00nan;0;0
992;152835;28;57;29;4;25;.862;3545000;0
993;57859;15;0;0;0;0;.00nan;0;0
993;85727;15;82;22;2;20;.909;4200000;0
993;144705;17;0;0;0;0;.00nan;0;0
993;146862;17;97;44;2;42;.955;4200000;0
994;167642;18;0;0;0;0;.00nan;0;0
994;168712;14;0;0;0;0;.00nan;0;0
994;34745;18;52;44;6;38;.864;3600000;0
994;59540;14;58;18;2;16;.889;3600000;0
995;676;34;0;0;0;0;.00nan;0;0
995;37818;29;0;0;0;0;.00nan;0;0
995;78806;34;74;29;3;26;.897;3600000;0
995;152710;29;78;27;1;26;.963;3600000;0
996;69536;10;0;0;0;0;.00nan;0;0
996;141998;35;0;0;0;0;.00nan;0;0
996;143473;35;87;34;3;31;.912;3600000;0
996;152717;10;76;41;4;37;.902;3583000;0
997;14866;20;70;26;2;24;.923;3600000;0
997;20693;24;89;55;4;51;.927;3584000;0
997;55802;20;0;0;0;0;.00nan;0;0
997;57338;24;0;0;0;0;.00nan;0;0
998;20432;31;100;27;0;27;1.000;3600000;0
998;176995;30;0;0;0;0;.00nan;0;0
998;36674;30;97;35;1;34;.971;3554000;0
998;86360;31;0;0;0;0;.00nan;0;0
999;1669;33;0;0;0;0;.00nan;0;0
999;46492;0;60;28;3;25;.893;3600000;0
999;91178;0;0;0;0;0;.00nan;0;0
999;149452;33;40;28;5;23;.821;3526000;0
1000;166646;16;0;0;0;0;.00nan;0;0
1000;43757;12;0;0;0;0;.00nan;0;0
1000;53842;16;83;32;2;30;.938;3600000;0
1000;85798;12;62;39;5;34;.872;3600000;0
1001;2059;23;66;15;1;14;.933;3600000;0
1001;9235;4838;93;44;2;42;.955;3561000;0
1001;65762;23;0;0;0;0;.00nan;0;0
1001;143749;4838;0;0;0;0;.00nan;0;0
1002;556;3;0;0;0;0;.00nan;0;0
1002;615;3;88;47;3;44;.936;3600000;0
1002;166381;27;0;0;0;0;.00nan;0;0
1002;175660;27;85;14;0;14;1.000;3600000;0
1003;841;11;40;12;3;9;.750;497000;0
1003;848;22;74;23;1;22;.957;3600000;0
1003;987;22;0;0;0;0;.00nan;0;0
1003;31972;11;51;32;4;28;.875;3103000;0
1004;166751;5;0;0;0;0;.00nan;0;0
1004;36755;5;56;40;5;35;.875;3600000;0
1004;43757;12;72;22;2;20;.909;3600000;0
1004;85798;12;0;0;0;0;.00nan;0;0
1005;166646;16;47;34;5;29;.853;3806000;0
1005;5311;8;63;35;4;31;.886;3806000;0
1005;13714;8;0;0;0;0;.00nan;0;0
1005;53842;16;0;0;0;0;.00nan;0;0
1006;163423;26;0;0;0;0;.00nan;0;0
1006;163565;19;63;15;1;14;.933;3017000;0
1006;14305;19;35;9;3;6;.667;583000;0
1006;179154;26;34;25;6;19;.760;3516000;0
1007;19391;32;40;28;6;22;.786;2260000;0
1007;169868;4182;0;0;0;0;.00nan;0;0
1007;58830;32;60;16;1;15;.938;1340000;0
1007;147945;4182;70;21;1;20;.952;3600000;0
1008;167642;18;0;0;0;0;.00nan;0;0
1008;34745;18;68;40;4;36;.900;3584000;0
1008;46492;0;0;0;0;0;.00nan;0;0
1008;91178;0;60;26;3;23;.885;3600000;0
1009;1669;33;0;0;0;0;.00nan;0;0
1009;168712;14;0;0;0;0;.00nan;0;0
1009;59540;14;47;11;2;9;.818;3600000;0
1009;149452;33;76;38;4;34;.895;3600000;0
1010;57859;15;0;0;0;0;.00nan;0;0
1010;69536;10;77;42;5;37;.881;3600000;0
1010;85727;15;64;22;2;20;.909;3600000;0
1010;152717;10;0;0;0;0;.00nan;0;0
1011;163695;9;0;0;0;0;.00nan;0;0
1011;20693;24;69;32;3;29;.906;3600000;0
1011;175092;9;100;31;0;31;1.000;3600000;0
1011;57338;24;0;0;0;0;.00nan;0;0
1012;176995;30;0;0;0;0;.00nan;0;0
1012;36674;30;61;23;2;21;.913;3545000;0
1012;37818;29;91;37;1;36;.973;3600000;0
1012;152710;29;0;0;0;0;.00nan;0;0
1013;8424;28;0;0;0;0;.00nan;0;0
1013;144705;17;87;28;1;27;.964;3600000;0
1013;146862;17;0;0;0;0;.00nan;0;0
1013;152835;28;47;36;5;31;.861;3600000;0
1014;556;3;90;39;2;37;.949;3557000;0
1014;615;3;0;0;0;0;.00nan;0;0
1014;841;11;0;0;0;0;.00nan;0;0
1014;31972;11;100;36;1;35;.972;3600000;0
1015;676;34;0;0;0;0;.00nan;0;0
1015;20432;31;99;37;2;35;.946;3600000;0
1015;78806;34;56;34;4;30;.882;3494000;0
1015;86360;31;0;0;0;0;.00nan;0;0
1016;14866;20;0;0;0;0;.00nan;0;0
1016;174718;25;0;0;0;0;.00nan;0;0
1016;55802;20;69;35;3;32;.914;3562000;0
1016;148958;25;82;29;1;28;.966;3600000;0
1017;86192;21;100;34;0;34;1.000;3600000;0
1017;141998;35;0;0;0;0;.00nan;0;0
1017;143156;21;0;0;0;0;.00nan;0;0
1017;143473;35;67;29;2;27;.931;3521000;0
1018;2059;23;79;13;0;13;1.000;3600000;0
1018;19391;32;0;0;0;0;.00nan;0;0
1018;58830;32;87;39;2;37;.949;3559000;0
1018;65762;23;0;0;0;0;.00nan;0;0
1019;166751;5;86;33;2;31;.939;3600000;0
1019;9235;4838;78;21;0;21;1.000;3217000;0
1019;36755;5;0;0;0;0;.00nan;0;0
1019;143749;4838;22;5;3;2;.400;336000;0
1020;163423;26;93;45;1;44;.978;3653000;0
1020;166381;27;0;0;0;0;.00nan;0;0
1020;179154;26;0;0;0;0;.00nan;0;0
1020;175660;27;74;29;2;27;.931;3653000;0
1021;167642;18;0;0;0;0;.00nan;0;0
1021;20693;24;0;0;0;0;.00nan;0;0
1021;34745;18;83;36;3;33;.917;3600000;0
1021;57338;24;54;30;4;26;.867;3544000;0
1022;166646;16;0;0;0;0;.00nan;0;0
1022;1669;33;0;0;0;0;.00nan;0;0
1022;53842;16;65;20;2;18;.900;3600000;0
1022;149452;33;77;46;4;42;.913;3597000;0
1023;176995;30;0;0;0;0;.00nan;0;0
1023;36674;30;67;48;5;43;.896;3600000;0
1023;57859;15;58;19;2;17;.895;3600000;0
1023;85727;15;0;0;0;0;.00nan;0;0
1024;174718;25;66;28;2;26;.929;3600000;0
1024;43757;12;0;0;0;0;.00nan;0;0
1024;85798;12;91;43;4;39;.907;3530000;0
1024;148958;25;0;0;0;0;.00nan;0;0
1025;848;22;0;0;0;0;.00nan;0;0
1025;987;22;100;25;0;25;1.000;3600000;0
1025;163565;19;48;35;6;29;.829;2817000;0
1025;14305;19;64;8;0;8;1.000;783000;0
1026;163695;9;27;11;4;7;.636;1099000;0
1026;175092;9;75;20;1;19;.950;2501000;0
1026;141998;35;0;0;0;0;.00nan;0;0
1026;143473;35;92;39;1;38;.974;3600000;0
1027;69536;10;0;0;0;0;.00nan;0;0
1027;86192;21;54;27;4;23;.852;3717000;0
1027;143156;21;0;0;0;0;.00nan;0;0
1027;152717;10;51;26;5;21;.808;3717000;0
1028;14866;20;0;0;0;0;.00nan;0;0
1028;19391;32;89;43;3;40;.930;3600000;0
1028;55802;20;84;27;1;26;.963;3600000;0
1028;58830;32;0;0;0;0;.00nan;0;0
1029;848;22;43;30;5;25;.833;3580000;0
1029;987;22;0;0;0;0;.00nan;0;0
1029;166381;27;0;0;0;0;.00nan;0;0
1029;175660;27;64;29;3;26;.897;3600000;0
1030;166751;5;0;0;0;0;.00nan;0;0
1030;36755;5;78;29;2;27;.931;3752000;0
1030;46492;0;0;0;0;0;.00nan;0;0
1030;91178;0;90;34;1;33;.971;3752000;0
1031;57859;15;0;0;0;0;.00nan;0;0
1031;85727;15;76;31;2;29;.935;3600000;0
1031;86192;21;0;0;0;0;.00nan;0;0
1031;143156;21;76;53;5;48;.906;3600000;0
1032;168712;14;0;0;0;0;.00nan;0;0
1032;59540;14;50;18;3;15;.833;3600000;0
1032;144705;17;0;0;0;0;.00nan;0;0
1032;146862;17;26;43;8;35;.814;3600000;0
1033;556;3;100;33;0;33;1.000;3600000;0
1033;615;3;0;0;0;0;.00nan;0;0
1033;20693;24;87;38;2;36;.947;3582000;0
1033;57338;24;0;0;0;0;.00nan;0;0
1034;676;34;0;0;0;0;.00nan;0;0
1034;841;11;0;0;0;0;.00nan;0;0
1034;31972;11;84;38;2;36;.947;3532000;0
1034;78806;34;80;22;1;21;.955;3600000;0
1035;163423;26;0;0;0;0;.00nan;0;0
1035;179154;26;49;36;5;31;.861;3600000;0
1035;37818;29;29;37;7;30;.811;3551000;0
1035;152710;29;0;0;0;0;.00nan;0;0
1036;166646;16;0;0;0;0;.00nan;0;0
1036;43757;12;0;0;0;0;.00nan;0;0
1036;53842;16;69;34;3;31;.912;3938000;0
1036;85798;12;82;31;2;29;.935;3938000;0
1037;163565;19;0;0;0;0;.00nan;0;0
1037;14305;19;98;50;3;47;.940;3891000;0
1037;174718;25;59;35;4;31;.886;3891000;0
1037;148958;25;0;0;0;0;.00nan;0;0
1038;5311;8;0;0;0;0;.00nan;0;0
1038;13714;8;66;24;2;22;.917;3785000;0
1038;176995;30;0;0;0;0;.00nan;0;0
1038;36674;30;99;36;1;35;.972;3785000;0
1039;9235;4838;66;48;5;43;.896;4200000;0
1039;169868;4182;0;0;0;0;.00nan;0;0
1039;143749;4838;0;0;0;0;.00nan;0;0
1039;147945;4182;26;25;5;20;.800;4200000;0
1040;166381;27;0;0;0;0;.00nan;0;0
1040;175660;27;54;27;3;24;.889;3547000;0
1040;141998;35;0;0;0;0;.00nan;0;0
1040;143473;35;95;33;1;32;.970;3600000;0
1041;1669;33;0;0;0;0;.00nan;0;0
1041;19391;32;0;0;0;0;.00nan;0;0
1041;58830;32;62;26;3;23;.885;3538000;0
1041;149452;33;87;33;1;32;.970;3600000;0
1042;167642;18;61;16;2;14;.875;622000;0
1042;14866;20;0;0;0;0;.00nan;0;0
1042;34745;18;28;29;6;23;.793;2978000;0
1042;55802;20;66;21;2;19;.905;3600000;0
1043;2059;23;79;24;1;23;.958;3600000;0
1043;5311;8;80;34;2;32;.941;3594000;0
1043;13714;8;0;0;0;0;.00nan;0;0
1043;65762;23;0;0;0;0;.00nan;0;0
1044;848;22;50;29;5;24;.828;4173000;0
1044;987;22;0;0;0;0;.00nan;0;0
1044;46492;0;0;0;0;0;.00nan;0;0
1044;91178;0;62;41;4;37;.902;4173000;0
1045;37818;29;73;44;4;40;.909;3600000;0
1045;57859;15;0;0;0;0;.00nan;0;0
1045;85727;15;72;16;1;15;.938;3600000;0
1045;152710;29;0;0;0;0;.00nan;0;0
1046;556;3;75;40;3;37;.925;3553000;0
1046;615;3;0;0;0;0;.00nan;0;0
1046;168712;14;0;0;0;0;.00nan;0;0
1046;59540;14;69;20;1;19;.950;3600000;0
1047;166751;5;45;21;3;18;.857;1428000;0
1047;36755;5;13;24;7;17;.708;2172000;0
1047;43757;12;0;0;0;0;.00nan;0;0
1047;85798;12;55;21;3;18;.857;3600000;0
1048;163695;9;0;0;0;0;.00nan;0;0
1048;175092;9;99;38;1;37;.974;3600000;0
1048;144705;17;67;28;2;26;.929;3592000;0
1048;146862;17;0;0;0;0;.00nan;0;0
1049;676;34;0;0;0;0;.00nan;0;0
1049;8424;28;0;0;0;0;.00nan;0;0
1049;78806;34;74;19;1;18;.947;3600000;0
1049;152835;28;54;37;5;32;.865;3600000;0
1050;841;11;48;26;4;22;.846;3568000;0
1050;20693;24;52;20;3;17;.850;3600000;0
1050;31972;11;0;0;0;0;.00nan;0;0
1050;57338;24;0;0;0;0;.00nan;0;0
1051;20432;31;91;43;4;39;.907;3600000;0
1051;86192;21;44;19;3;16;.842;3600000;0
1051;86360;31;0;0;0;0;.00nan;0;0
1051;143156;21;0;0;0;0;.00nan;0;0
1052;163423;26;0;0;0;0;.00nan;0;0
1052;179154;26;52;21;3;18;.857;3600000;0
1052;69536;10;0;0;0;0;.00nan;0;0
1052;152717;10;53;32;5;27;.844;3525000;0
1053;166646;16;0;0;0;0;.00nan;0;0
1053;163565;19;86;43;3;40;.930;3562000;0
1053;14305;19;0;0;0;0;.00nan;0;0
1053;53842;16;69;25;2;23;.920;3600000;0
1054;9235;4838;26;20;5;15;.750;1579000;0
1054;176995;30;0;0;0;0;.00nan;0;0
1054;36674;30;86;27;1;26;.963;3600000;0
1054;143749;4838;45;37;6;31;.838;2021000;0
1055;14866;20;66;25;2;23;.920;3600000;0
1055;169868;4182;0;0;0;0;.00nan;0;0
1055;55802;20;0;0;0;0;.00nan;0;0
1055;147945;4182;59;27;3;24;.889;3561000;0
1056;163565;19;0;0;0;0;.00nan;0;0
1056;14305;19;17;20;6;14;.700;3600000;0
1056;19391;32;99;50;2;48;.960;3600000;0
1056;58830;32;0;0;0;0;.00nan;0;0
1057;166381;27;0;0;0;0;.00nan;0;0
1057;174718;25;0;0;0;0;.00nan;0;0
1057;175660;27;68;37;4;33;.892;3748000;0
1057;148958;25;77;36;3;33;.917;3748000;0
1058;166751;5;0;0;0;0;.00nan;0;0
1058;36755;5;66;48;6;42;.875;3600000;0
1058;46492;0;0;0;0;0;.00nan;0;0
1058;91178;0;78;32;3;29;.906;3600000;0
1059;556;3;58;35;4;31;.886;3517000;0
1059;615;3;0;0;0;0;.00nan;0;0
1059;848;22;0;0;0;0;.00nan;0;0
1059;987;22;95;42;2;40;.952;3600000;0
1060;20693;24;97;33;2;31;.939;3600000;0
1060;57338;24;0;0;0;0;.00nan;0;0
1060;86192;21;57;38;5;33;.868;3600000;0
1060;143156;21;0;0;0;0;.00nan;0;0
1061;43757;12;0;0;0;0;.00nan;0;0
1061;69536;10;0;0;0;0;.00nan;0;0
1061;85798;12;64;29;3;26;.897;4148000;0
1061;152717;10;84;56;4;52;.929;4148000;0
1062;20432;31;100;35;1;34;.971;3600000;0
1062;37818;29;72;27;2;25;.926;3545000;0
1062;86360;31;0;0;0;0;.00nan;0;0
1062;152710;29;0;0;0;0;.00nan;0;0
1063;676;34;10;15;6;9;.600;2358000;0
1063;163695;9;100;41;2;39;.951;3600000;0
1063;175092;9;0;0;0;0;.00nan;0;0
1063;78806;34;66;11;0;11;1.000;1242000;0
1064;841;11;0;0;0;0;.00nan;0;0
1064;168712;14;0;0;0;0;.00nan;0;0
1064;31972;11;91;44;4;40;.909;3682000;0
1064;59540;14;50;28;5;23;.821;3682000;0
1065;176995;30;0;0;0;0;.00nan;0;0
1065;36674;30;78;30;2;28;.933;3600000;0
1065;144705;17;0;0;0;0;.00nan;0;0
1065;146862;17;92;42;3;39;.929;3600000;0
1066;8424;28;0;0;0;0;.00nan;0;0
1066;57859;15;0;0;0;0;.00nan;0;0
1066;85727;15;56;31;4;27;.871;3938000;0
1066;152835;28;81;39;3;36;.923;3942000;0
1067;163423;26;0;0;0;0;.00nan;0;0
1067;166381;27;82;16;0;16;1.000;3600000;0
1067;179154;26;83;52;4;48;.923;3600000;0
1067;175660;27;0;0;0;0;.00nan;0;0
1068;166646;16;0;0;0;0;.00nan;0;0
1068;53842;16;49;20;3;17;.850;3513000;0
1068;141998;35;0;0;0;0;.00nan;0;0
1068;143473;35;100;36;1;35;.972;3600000;0
1069;5311;8;87;31;1;30;.968;3600000;0
1069;167642;18;0;0;0;0;.00nan;0;0
1069;13714;8;0;0;0;0;.00nan;0;0
1069;34745;18;30;23;5;18;.783;3600000;0
1070;1669;33;0;0;0;0;.00nan;0;0
1070;169868;4182;80;40;3;37;.925;3600000;0
1070;147945;4182;0;0;0;0;.00nan;0;0
1070;149452;33;85;42;4;38;.905;3566000;0
1071;2059;23;76;44;5;39;.886;3589000;0
1071;14866;20;72;34;3;31;.912;3600000;0
1071;55802;20;0;0;0;0;.00nan;0;0
1071;65762;23;0;0;0;0;.00nan;0;0
1072;848;22;51;22;3;19;.864;4184000;0
1072;987;22;0;0;0;0;.00nan;0;0
1072;86192;21;0;0;0;0;.00nan;0;0
1072;143156;21;84;43;3;40;.930;4200000;0
1073;9235;4838;84;62;6;56;.903;3821000;0
1073;69536;10;44;25;5;20;.800;3821000;0
1073;143749;4838;0;0;0;0;.00nan;0;0
1073;152717;10;0;0;0;0;.00nan;0;0
1074;168712;14;77;21;1;20;.952;3600000;0
1074;19391;32;0;0;0;0;.00nan;0;0
1074;58830;32;75;31;3;28;.903;3596000;0
1074;59540;14;0;0;0;0;.00nan;0;0
1075;841;11;35;32;6;26;.813;3600000;0
1075;174718;25;0;0;0;0;.00nan;0;0
1075;31972;11;0;0;0;0;.00nan;0;0
1075;148958;25;83;18;0;18;1.000;3600000;0
1076;556;3;0;0;0;0;.00nan;0;0
1076;615;3;88;55;4;51;.927;3517000;0
1076;57859;15;86;31;2;29;.935;3600000;0
1076;85727;15;0;0;0;0;.00nan;0;0
1077;166751;5;79;31;3;28;.903;3600000;0
1077;20693;24;0;0;0;0;.00nan;0;0
1077;36755;5;0;0;0;0;.00nan;0;0
1077;57338;24;37;19;4;15;.789;3556000;0
1078;163565;19;99;46;1;45;.978;3646000;0
1078;14305;19;0;0;0;0;.00nan;0;0
1078;141998;35;65;28;2;26;.929;3646000;0
1078;143473;35;0;0;0;0;.00nan;0;0
1079;14866;20;0;0;0;0;.00nan;0;0
1079;176995;30;0;0;0;0;.00nan;0;0
1079;36674;30;100;28;0;28;1.000;3600000;0
1079;55802;20;47;22;3;19;.864;3600000;0
1080;169868;4182;0;0;0;0;.00nan;0;0
1080;46492;0;0;0;0;0;.00nan;0;0
1080;91178;0;86;42;3;39;.929;4045000;0
1080;147945;4182;78;36;2;34;.944;4045000;0
1081;556;3;100;42;2;40;.952;3825000;0
1081;615;3;0;0;0;0;.00nan;0;0
1081;163695;9;67;33;3;30;.909;3825000;0
1081;175092;9;0;0;0;0;.00nan;0;0
1082;166751;5;0;0;0;0;.00nan;0;0
1082;168712;14;0;0;0;0;.00nan;0;0
1082;36755;5;83;54;4;50;.926;3600000;0
1082;59540;14;59;10;1;9;.900;3600000;0
1083;20693;24;57;18;2;16;.889;3600000;0
1083;57338;24;0;0;0;0;.00nan;0;0
1083;69536;10;0;0;0;0;.00nan;0;0
1083;152717;10;72;35;4;31;.886;3542000;0
1084;19391;32;75;38;3;35;.921;3550000;0
1084;58830;32;0;0;0;0;.00nan;0;0
1084;86192;21;58;21;2;19;.905;3600000;0
1084;143156;21;0;0;0;0;.00nan;0;0
1085;676;34;0;0;0;0;.00nan;0;0
1085;8424;28;0;0;0;0;.00nan;0;0
1085;78806;34;42;28;5;23;.821;3541000;0
1085;152835;28;82;41;4;37;.902;3600000;0
1086;848;22;0;0;0;0;.00nan;0;0
1086;987;22;71;42;4;38;.905;3600000;0
1086;57859;15;0;0;0;0;.00nan;0;0
1086;85727;15;97;37;1;36;.973;3600000;0
1087;841;11;0;0;0;0;.00nan;0;0
1087;1669;33;0;0;0;0;.00nan;0;0
1087;31972;11;90;46;2;44;.957;3570000;0
1087;149452;33;97;36;1;35;.972;3600000;0
1088;5311;8;0;0;0;0;.00nan;0;0
1088;13714;8;90;54;4;50;.926;4200000;0
1088;141998;35;0;0;0;0;.00nan;0;0
1088;143473;35;64;33;4;29;.879;4200000;0
1089;167642;18;0;0;0;0;.00nan;0;0
1089;34745;18;100;30;0;30;1.000;3600000;0
1089;144705;17;41;19;3;16;.842;3600000;0
1089;146862;17;0;0;0;0;.00nan;0;0
1090;166646;16;0;0;0;0;.00nan;0;0
1090;163565;19;0;0;0;0;.00nan;0;0
1090;14305;19;63;19;1;18;.947;3600000;0
1090;53842;16;22;31;7;24;.774;3600000;0
1091;166381;27;82;37;3;34;.919;4200000;0
1091;174718;25;0;0;0;0;.00nan;0;0
1091;175660;27;0;0;0;0;.00nan;0;0
1091;148958;25;72;35;3;32;.914;4200000;0
1092;2059;23;51;32;4;28;.875;3517000;0
1092;46492;0;69;26;2;24;.923;3600000;0
1092;65762;23;0;0;0;0;.00nan;0;0
1092;91178;0;0;0;0;0;.00nan;0;0
1093;9235;4838;0;0;0;0;.00nan;0;0
1093;20432;31;67;23;2;21;.913;3600000;0
1093;86360;31;0;0;0;0;.00nan;0;0
1093;143749;4838;59;36;4;32;.889;3600000;0
1094;8424;28;81;36;2;34;.944;3586000;0
1094;14866;20;78;25;1;24;.960;3600000;0
1094;55802;20;0;0;0;0;.00nan;0;0
1094;152835;28;0;0;0;0;.00nan;0;0
1095;163423;26;0;0;0;0;.00nan;0;0
1095;179154;26;100;41;0;41;1.000;3600000;0
1095;43757;12;0;0;0;0;.00nan;0;0
1095;85798;12;70;20;1;19;.950;3600000;0
1096;166646;16;51;33;5;28;.848;3600000;0
1096;166381;27;0;0;0;0;.00nan;0;0
1096;175660;27;69;19;1;18;.947;3600000;0
1096;53842;16;0;0;0;0;.00nan;0;0
1097;163695;9;0;0;0;0;.00nan;0;0
1097;175092;9;66;33;4;29;.879;3600000;0
1097;86192;21;74;24;1;23;.958;3600000;0
1097;143156;21;0;0;0;0;.00nan;0;0
1098;676;34;0;0;0;0;.00nan;0;0
1098;57859;15;0;0;0;0;.00nan;0;0
1098;78806;34;47;27;4;23;.852;3600000;0
1098;85727;15;97;32;1;31;.969;3600000;0
1099;848;22;46;10;2;8;.800;3600000;0
1099;987;22;0;0;0;0;.00nan;0;0
1099;166751;5;0;0;0;0;.00nan;0;0
1099;36755;5;98;50;3;47;.940;3600000;0
1100;1669;33;0;0;0;0;.00nan;0;0
1100;37818;29;37;24;5;19;.792;3799000;0
1100;149452;33;92;59;6;53;.898;3799000;0
1100;152710;29;0;0;0;0;.00nan;0;0
1101;19391;32;0;0;0;0;.00nan;0;0
1101;58830;32;89;42;3;39;.929;3548000;0
1101;69536;10;0;0;0;0;.00nan;0;0
1101;152717;10;69;29;2;27;.931;3600000;0
1102;556;3;100;32;0;32;1.000;3600000;0
1102;615;3;0;0;0;0;.00nan;0;0
1102;141998;35;0;0;0;0;.00nan;0;0
1102;143473;35;60;40;5;35;.875;3600000;0
1103;167642;18;0;0;0;0;.00nan;0;0
1103;34745;18;69;47;5;42;.894;3570000;0
1103;46492;0;0;0;0;0;.00nan;0;0
1103;91178;0;64;36;4;32;.889;3600000;0
1104;163565;19;78;34;3;31;.912;3600000;0
1104;14305;19;0;0;0;0;.00nan;0;0
1104;174718;25;64;40;5;35;.875;3528000;0
1104;148958;25;0;0;0;0;.00nan;0;0
1105;2059;23;54;39;5;34;.872;3600000;0
1105;65762;23;0;0;0;0;.00nan;0;0
1105;144705;17;0;0;0;0;.00nan;0;0
1105;146862;17;76;25;1;24;.960;3600000;0
1106;9235;4838;0;0;0;0;.00nan;0;0
1106;169868;4182;0;0;0;0;.00nan;0;0
1106;143749;4838;84;35;3;32;.914;3595000;0
1106;147945;4182;70;23;2;21;.913;3600000;0
1107;841;11;0;0;0;0;.00nan;0;0
1107;20432;31;47;19;3;16;.842;3600000;0
1107;31972;11;72;42;4;38;.905;3563000;0
1107;86360;31;0;0;0;0;.00nan;0;0
1108;14866;20;0;0;0;0;.00nan;0;0
1108;55802;20;100;43;1;42;.977;3600000;0
1108;57859;15;67;34;3;31;.912;3546000;0
1108;85727;15;0;0;0;0;.00nan;0;0
1109;163423;26;0;0;0;0;.00nan;0;0
1109;20693;24;22;12;4;8;.667;3600000;0
1109;179154;26;61;42;5;37;.881;3543000;0
1109;57338;24;0;0;0;0;.00nan;0;0
1110;5311;8;0;0;0;0;.00nan;0;0
1110;13714;8;81;33;2;31;.939;4200000;0
1110;168712;14;0;0;0;0;.00nan;0;0
1110;59540;14;73;23;2;21;.913;4200000;0
1111;169868;4182;40;36;6;30;.833;2767000;0
1111;43757;12;0;0;0;0;.00nan;0;0
1111;85798;12;72;23;2;21;.913;3600000;0
1111;147945;4182;60;6;0;6;1.000;833000;0
1112;848;22;66;11;1;10;.909;3600000;0
1112;987;22;0;0;0;0;.00nan;0;0
1112;19391;32;52;39;5;34;.872;3600000;0
1112;58830;32;0;0;0;0;.00nan;0;0
1113;676;34;0;0;0;0;.00nan;0;0
1113;163695;9;65;40;4;36;.900;3888000;0
1113;175092;9;0;0;0;0;.00nan;0;0
1113;78806;34;63;30;3;27;.900;3888000;0
1114;166646;16;0;0;0;0;.00nan;0;0
1114;53842;16;83;32;1;31;.969;3600000;0
1114;141998;35;54;8;1;7;.875;482000;0
1114;143473;35;52;28;4;24;.857;3118000;0
1115;1669;33;0;0;0;0;.00nan;0;0
1115;166751;5;0;0;0;0;.00nan;0;0
1115;36755;5;91;42;2;40;.952;3600000;0
1115;149452;33;70;34;3;31;.912;3600000;0
1116;556;3;82;30;1;29;.967;3960000;0
1116;615;3;0;0;0;0;.00nan;0;0
1116;69536;10;88;41;2;39;.951;3960000;0
1116;152717;10;0;0;0;0;.00nan;0;0
1117;8424;28;0;0;0;0;.00nan;0;0
1117;167642;18;0;0;0;0;.00nan;0;0
1117;34745;18;70;43;4;39;.907;3568000;0
1117;152835;28;53;26;3;23;.885;3600000;0
1118;37818;29;74;26;2;24;.923;3570000;0
1118;86192;21;86;33;1;32;.970;3600000;0
1118;143156;21;0;0;0;0;.00nan;0;0
1118;152710;29;0;0;0;0;.00nan;0;0
1119;2059;23;62;21;2;19;.905;3547000;0
1119;176995;30;0;0;0;0;.00nan;0;0
1119;36674;30;96;27;1;26;.963;3600000;0
1119;65762;23;0;0;0;0;.00nan;0;0
1120;166381;27;0;0;0;0;.00nan;0;0
1120;20432;31;76;45;4;41;.911;3556000;0
1120;175660;27;63;29;3;26;.897;3600000;0
1120;86360;31;0;0;0;0;.00nan;0;0
1121;841;11;0;0;0;0;.00nan;0;0
1121;174718;25;76;21;2;19;.905;3590000;0
1121;31972;11;86;31;1;30;.968;3600000;0
1121;148958;25;0;0;0;0;.00nan;0;0
1122;9235;4838;0;0;0;0;.00nan;0;0
1122;168712;14;61;14;1;13;.929;3600000;0
1122;59540;14;0;0;0;0;.00nan;0;0
1122;143749;4838;80;50;4;46;.920;3600000;0
1123;14866;20;65;17;1;16;.941;3600000;0
1123;19391;32;41;9;2;7;.778;346000;0
1123;55802;20;0;0;0;0;.00nan;0;0
1123;58830;32;61;47;6;41;.872;3254000;0
1124;5311;8;0;0;0;0;.00nan;0;0
1124;13714;8;86;31;2;29;.935;3600000;0
1124;20693;24;20;32;7;25;.781;3176000;0
1124;57338;24;50;1;0;1;1.000;424000;0
1125;848;22;0;0;0;0;.00nan;0;0
1125;987;22;39;15;3;12;.800;3555000;0
1125;69536;10;0;0;0;0;.00nan;0;0
1125;152717;10;99;47;2;45;.957;3600000;0
1126;8424;28;29;30;6;24;.800;2764000;0
1126;57859;15;48;4;0;4;1.000;841000;0
1126;85727;15;47;36;6;30;.833;3359000;0
1126;152835;28;61;12;0;12;1.000;1436000;0
1127;556;3;0;0;0;0;.00nan;0;0
1127;615;3;76;35;3;32;.914;3572000;0
1127;167642;18;0;0;0;0;.00nan;0;0
1127;34745;18;71;22;2;20;.909;3600000;0
1128;676;34;29;22;5;17;.773;3600000;0
1128;37818;29;0;0;0;0;.00nan;0;0
1128;78806;34;0;0;0;0;.00nan;0;0
1128;152710;29;91;41;1;40;.976;3600000;0
1129;163423;26;0;0;0;0;.00nan;0;0
1129;179154;26;52;33;4;29;.879;3600000;0
1129;43757;12;41;19;3;16;.842;3037000;0
1129;85798;12;25;6;3;3;.500;532000;0
1130;163565;19;0;0;0;0;.00nan;0;0
1130;14305;19;73;27;2;25;.926;4200000;0
1130;20432;31;81;32;2;30;.938;4200000;0
1130;86360;31;0;0;0;0;.00nan;0;0
1131;176995;30;0;0;0;0;.00nan;0;0
1131;36674;30;76;31;3;28;.903;3575000;0
1131;46492;0;0;0;0;0;.00nan;0;0
1131;91178;0;75;31;2;29;.935;3600000;0
1132;169868;4182;0;0;0;0;.00nan;0;0
1132;144705;17;0;0;0;0;.00nan;0;0
1132;146862;17;88;47;4;43;.915;3539000;0
1132;147945;4182;62;23;2;21;.913;3600000;0
1133;9235;4838;0;0;0;0;.00nan;0;0
1133;141998;35;0;0;0;0;.00nan;0;0
1133;143473;35;72;22;1;21;.955;3600000;0
1133;143749;4838;84;34;2;32;.941;3583000;0
1134;2059;23;67;31;3;28;.903;3541000;0
1134;166381;27;0;0;0;0;.00nan;0;0
1134;175660;27;97;32;1;31;.969;3600000;0
1134;65762;23;0;0;0;0;.00nan;0;0
1135;163695;9;50;28;4;24;.857;3600000;0
1135;175092;9;0;0;0;0;.00nan;0;0
1135;37818;29;83;26;1;25;.962;3600000;0
1135;152710;29;0;0;0;0;.00nan;0;0
1136;676;34;87;31;1;30;.968;3600000;0
1136;78806;34;0;0;0;0;.00nan;0;0
1136;86192;21;92;39;2;37;.949;3577000;0
1136;143156;21;0;0;0;0;.00nan;0;0
1137;20693;24;68;36;4;32;.889;3600000;0
1137;57338;24;0;0;0;0;.00nan;0;0
1137;57859;15;0;0;0;0;.00nan;0;0
1137;85727;15;48;21;3;18;.857;3600000;0
1138;8424;28;0;0;0;0;.00nan;0;0
1138;69536;10;0;0;0;0;.00nan;0;0
1138;152717;10;70;48;5;43;.896;3600000;0
1138;152835;28;66;30;3;27;.900;3600000;0
1139;166751;5;0;0;0;0;.00nan;0;0
1139;14866;20;0;0;0;0;.00nan;0;0
1139;36755;5;88;50;4;46;.920;3600000;0
1139;55802;20;45;28;5;23;.821;3549000;0
1140;1669;33;0;0;0;0;.00nan;0;0
1140;9235;4838;98;40;1;39;.975;3600000;0
1140;143749;4838;0;0;0;0;.00nan;0;0
1140;149452;33;100;27;0;27;1.000;3600000;0
1141;167642;18;0;0;0;0;.00nan;0;0
1141;19391;32;66;27;3;24;.889;3600000;0
1141;34745;18;85;22;1;21;.955;3600000;0
1141;58830;32;0;0;0;0;.00nan;0;0
1142;174718;25;0;0;0;0;.00nan;0;0
1142;176995;30;0;0;0;0;.00nan;0;0
1142;36674;30;77;34;3;31;.912;3600000;0
1142;148958;25;54;32;4;28;.875;3584000;0
1143;5311;8;0;0;0;0;.00nan;0;0
1143;13714;8;76;20;1;19;.950;3600000;0
1143;144705;17;0;0;0;0;.00nan;0;0
1143;146862;17;97;41;2;39;.951;3600000;0
1144;168712;14;0;0;0;0;.00nan;0;0
1144;43757;12;0;0;0;0;.00nan;0;0
1144;59540;14;53;31;5;26;.839;3600000;0
1144;85798;12;72;28;2;26;.929;3600000;0
1145;163565;19;77;33;4;29;.879;3600000;0
1145;14305;19;0;0;0;0;.00nan;0;0
1145;169868;4182;0;0;0;0;.00nan;0;0
1145;147945;4182;58;23;3;20;.870;3600000;0
1146;841;11;82;31;2;29;.935;3576000;0
1146;163423;26;0;0;0;0;.00nan;0;0
1146;179154;26;95;39;1;38;.974;3600000;0
1146;31972;11;0;0;0;0;.00nan;0;0
1147;556;3;35;35;6;29;.829;3600000;0
1147;615;3;0;0;0;0;.00nan;0;0
1147;46492;0;0;0;0;0;.00nan;0;0
1147;91178;0;100;42;0;42;1.000;3600000;0
1148;163695;9;0;0;0;0;.00nan;0;0
1148;20432;31;0;0;0;0;.00nan;0;0
1148;175092;9;72;38;3;35;.921;3589000;0
1148;86360;31;77;30;2;28;.933;3600000;0
1149;166751;5;0;0;0;0;.00nan;0;0
1149;36755;5;80;36;3;33;.917;3587000;0
1149;57859;15;100;33;1;32;.970;3600000;0
1149;85727;15;0;0;0;0;.00nan;0;0
1150;848;22;84;29;2;27;.931;3600000;0
1150;987;22;0;0;0;0;.00nan;0;0
1150;37818;29;60;43;6;37;.860;3165000;0
1150;152710;29;60;8;0;8;1.000;435000;0
1151;676;34;0;0;0;0;.00nan;0;0
1151;78806;34;49;22;3;19;.864;3600000;0
1151;144705;17;89;49;4;45;.918;3575000;0
1151;146862;17;0;0;0;0;.00nan;0;0
1152;556;3;0;0;0;0;.00nan;0;0
1152;615;3;71;28;2;26;.929;3600000;0
1152;174718;25;39;18;3;15;.833;3561000;0
1152;148958;25;0;0;0;0;.00nan;0;0
1153;168712;14;0;0;0;0;.00nan;0;0
1153;20693;24;79;41;4;37;.902;3712000;0
1153;57338;24;0;0;0;0;.00nan;0;0
1153;59540;14;50;20;3;17;.850;3712000;0
1154;8424;28;0;0;0;0;.00nan;0;0
1154;14866;20;70;44;5;39;.886;4200000;0
1154;55802;20;0;0;0;0;.00nan;0;0
1154;152835;28;74;58;5;53;.914;4200000;0
1155;841;11;0;0;0;0;.00nan;0;0
1155;166646;16;0;0;0;0;.00nan;0;0
1155;31972;11;58;36;5;31;.861;3520000;0
1155;53842;16;67;35;3;32;.914;3600000;0
1156;176995;30;0;0;0;0;.00nan;0;0
1156;36674;30;82;45;4;41;.911;3568000;0
1156;141998;35;0;0;0;0;.00nan;0;0
1156;143473;35;67;33;3;30;.909;3600000;0
1157;9235;4838;90;46;3;43;.935;3562000;0
1157;19391;32;0;0;0;0;.00nan;0;0
1157;58830;32;81;25;1;24;.960;3600000;0
1157;143749;4838;0;0;0;0;.00nan;0;0
1158;5311;8;90;40;3;37;.925;3977000;0
1158;13714;8;0;0;0;0;.00nan;0;0
1158;86192;21;99;35;2;33;.943;3977000;0
1158;143156;21;0;0;0;0;.00nan;0;0
1159;167642;18;0;0;0;0;.00nan;0;0
1159;166381;27;0;0;0;0;.00nan;0;0
1159;175660;27;100;26;0;26;1.000;3600000;0
1159;34745;18;59;29;4;25;.862;3600000;0
1160;1669;33;0;0;0;0;.00nan;0;0
1160;43757;12;0;0;0;0;.00nan;0;0
1160;85798;12;82;33;2;31;.939;3600000;0
1160;149452;33;97;59;4;55;.932;3513000;0
1161;163565;19;0;0;0;0;.00nan;0;0
1161;14305;19;84;30;2;28;.933;4200000;0
1161;169868;4182;96;41;2;39;.951;4200000;0
1161;147945;4182;0;0;0;0;.00nan;0;0
1162;2059;23;64;19;2;17;.895;3600000;0
1162;163423;26;0;0;0;0;.00nan;0;0
1162;179154;26;68;35;4;31;.886;3530000;0
1162;65762;23;0;0;0;0;.00nan;0;0
1163;46492;0;0;0;0;0;.00nan;0;0
1163;69536;10;0;0;0;0;.00nan;0;0
1163;91178;0;85;36;2;34;.944;4191000;0
1163;152717;10;74;26;2;24;.923;4200000;0
1164;166751;5;0;0;0;0;.00nan;0;0
1164;36755;5;38;35;6;29;.829;3600000;0
1164;37818;29;73;17;1;16;.941;3600000;0
1164;152710;29;0;0;0;0;.00nan;0;0
1165;166646;16;0;0;0;0;.00nan;0;0
1165;9235;4838;88;46;3;43;.935;3959000;0
1165;53842;16;53;26;4;22;.846;3948000;0
1165;143749;4838;0;0;0;0;.00nan;0;0
1166;163565;19;0;0;0;0;.00nan;0;0
1166;167642;18;0;0;0;0;.00nan;0;0
1166;14305;19;74;20;1;19;.950;3600000;0
1166;34745;18;84;39;2;37;.949;3577000;0
1167;43757;12;0;0;0;0;.00nan;0;0
1167;85798;12;75;33;3;30;.909;3600000;0
1167;86192;21;52;40;6;34;.850;3600000;0
1167;143156;21;0;0;0;0;.00nan;0;0
1168;1669;33;0;0;0;0;.00nan;0;0
1168;5311;8;0;0;0;0;.00nan;0;0
1168;13714;8;67;23;2;21;.913;3595000;0
1168;149452;33;86;29;1;28;.966;3600000;0
1169;8424;28;0;0;0;0;.00nan;0;0
1169;46492;0;76;34;3;31;.912;3600000;0
1169;91178;0;0;0;0;0;.00nan;0;0
1169;152835;28;51;31;4;27;.871;3544000;0
1170;168712;14;0;0;0;0;.00nan;0;0
1170;20693;24;75;38;3;35;.921;3553000;0
1170;57338;24;0;0;0;0;.00nan;0;0
1170;59540;14;79;25;1;24;.960;3600000;0
1171;57859;15;41;16;3;13;.813;1962000;0
1171;85727;15;8;19;6;13;.684;1638000;0
1171;144705;17;0;0;0;0;.00nan;0;0
1171;146862;17;79;45;5;40;.889;3600000;0
1172;676;34;0;0;0;0;.00nan;0;0
1172;174718;25;0;0;0;0;.00nan;0;0
1172;78806;34;82;27;1;26;.963;3600000;0
1172;148958;25;81;28;2;26;.929;3572000;0
1173;848;22;94;29;1;28;.966;3795000;0
1173;987;22;0;0;0;0;.00nan;0;0
1173;20432;31;94;38;2;36;.947;3795000;0
1173;86360;31;0;0;0;0;.00nan;0;0
1174;556;3;59;27;3;24;.889;3600000;0
1174;615;3;0;0;0;0;.00nan;0;0
1174;19391;32;56;9;0;9;1.000;584000;0
1174;58830;32;46;42;6;36;.857;3016000;0
1175;163695;9;24;45;9;36;.800;3600000;0
1175;14866;20;0;0;0;0;.00nan;0;0
1175;175092;9;0;0;0;0;.00nan;0;0
1175;55802;20;74;21;1;20;.952;3600000;0
1176;841;11;0;0;0;0;.00nan;0;0
1176;31972;11;84;39;2;37;.949;4200000;0
1176;141998;35;0;0;0;0;.00nan;0;0
1176;143473;35;96;37;2;35;.946;4200000;0
1177;166381;27;0;0;0;0;.00nan;0;0
1177;175660;27;71;41;4;37;.902;3586000;0
1177;176995;30;0;0;0;0;.00nan;0;0
1177;36674;30;63;31;3;28;.903;3600000;0
1178;163423;26;0;0;0;0;.00nan;0;0
1178;169868;4182;0;0;0;0;.00nan;0;0
1178;179154;26;61;26;3;23;.885;3600000;0
1178;147945;4182;87;21;0;21;1.000;3600000;0
1179;2059;23;62;23;2;21;.913;3600000;0
1179;163565;19;23;11;4;7;.636;934000;0
1179;14305;19;90;21;0;21;1.000;2633000;0
1179;65762;23;0;0;0;0;.00nan;0;0
1180;5311;8;0;0;0;0;.00nan;0;0
1180;13714;8;81;39;3;36;.923;3600000;0
1180;168712;14;0;0;0;0;.00nan;0;0
1180;59540;14;93;31;1;30;.968;3600000;0
1181;20693;24;26;6;3;3;.500;346000;0
1181;57338;24;83;39;3;36;.923;3254000;0
1181;86192;21;100;34;0;34;1.000;3600000;0
1181;143156;21;0;0;0;0;.00nan;0;0
1182;676;34;82;33;3;30;.909;3543000;0
1182;848;22;61;18;2;16;.889;3600000;0
1182;987;22;0;0;0;0;.00nan;0;0
1182;78806;34;0;0;0;0;.00nan;0;0
1183;166751;5;0;0;0;0;.00nan;0;0
1183;20432;31;97;42;1;41;.976;3600000;0
1183;36755;5;75;43;5;38;.884;3600000;0
1183;86360;31;0;0;0;0;.00nan;0;0
1184;8424;28;0;0;0;0;.00nan;0;0
1184;37818;29;51;22;3;19;.864;3581000;0
1184;152710;29;0;0;0;0;.00nan;0;0
1184;152835;28;78;29;2;27;.931;3600000;0
1185;167642;18;0;0;0;0;.00nan;0;0
1185;34745;18;81;44;4;40;.909;3600000;0
1185;141998;35;0;0;0;0;.00nan;0;0
1185;143473;35;68;26;2;24;.923;3600000;0
1186;166381;27;0;0;0;0;.00nan;0;0
1186;19391;32;75;37;3;34;.919;3600000;0
1186;175660;27;100;28;0;28;1.000;3600000;0
1186;58830;32;0;0;0;0;.00nan;0;0
1187;841;11;0;0;0;0;.00nan;0;0
1187;169868;4182;0;0;0;0;.00nan;0;0
1187;31972;11;80;32;2;30;.938;4200000;0
1187;147945;4182;96;46;2;44;.957;4200000;0
1188;14866;20;0;0;0;0;.00nan;0;0
1188;46492;0;0;0;0;0;.00nan;0;0
1188;55802;20;57;29;4;25;.862;3600000;0
1188;91178;0;100;34;1;33;.971;3600000;0
1189;37818;29;0;0;0;0;.00nan;0;0
1189;144705;17;0;0;0;0;.00nan;0;0
1189;146862;17;59;16;2;14;.875;3600000;0
1189;152710;29;84;38;3;35;.921;3584000;0
1190;20693;24;92;19;0;19;1.000;3600000;0
1190;57338;24;0;0;0;0;.00nan;0;0
1190;69536;10;25;24;6;18;.750;3258000;0
1190;152717;10;62;7;0;7;1.000;342000;0
1191;848;22;0;0;0;0;.00nan;0;0
1191;987;22;70;17;1;16;.941;3600000;0
1191;174718;25;87;33;2;31;.939;3551000;0
1191;148958;25;0;0;0;0;.00nan;0;0
1192;556;3;75;28;2;26;.929;3600000;0
1192;615;3;0;0;0;0;.00nan;0;0
1192;166646;16;54;29;4;25;.862;3571000;0
1192;53842;16;0;0;0;0;.00nan;0;0
1193;1669;33;0;0;0;0;.00nan;0;0
1193;163695;9;0;0;0;0;.00nan;0;0
1193;175092;9;61;31;3;28;.903;3574000;0
1193;149452;33;81;29;1;28;.966;3600000;0
1194;163565;19;0;0;0;0;.00nan;0;0
1194;14305;19;97;22;0;22;1.000;3600000;0
1194;176995;30;0;0;0;0;.00nan;0;0
1194;36674;30;51;32;4;28;.875;3600000;0
1195;2059;23;43;22;4;18;.818;3750000;0
1195;9235;4838;0;0;0;0;.00nan;0;0
1195;65762;23;0;0;0;0;.00nan;0;0
1195;143749;4838;79;44;5;39;.886;3750000;0
1196;8424;28;0;0;0;0;.00nan;0;0
1196;20432;31;89;36;2;34;.944;4200000;0
1196;86360;31;0;0;0;0;.00nan;0;0
1196;152835;28;69;31;2;29;.935;4200000;0
1197;69536;10;0;0;0;0;.00nan;0;0
1197;86192;21;90;46;5;41;.891;3996000;0
1197;143156;21;0;0;0;0;.00nan;0;0
1197;152717;10;58;27;4;23;.852;3996000;0
1198;163423;26;0;0;0;0;.00nan;0;0
1198;167642;18;0;0;0;0;.00nan;0;0
1198;179154;26;97;31;0;31;1.000;4200000;0
1198;34745;18;100;47;0;47;1.000;4200000;0
1199;2059;23;78;33;2;31;.939;3600000;0
1199;43757;12;0;0;0;0;.00nan;0;0
1199;65762;23;0;0;0;0;.00nan;0;0
1199;85798;12;60;26;3;23;.885;3600000;0
1200;166381;27;0;0;0;0;.00nan;0;0
1200;169868;4182;0;0;0;0;.00nan;0;0
1200;175660;27;47;29;5;24;.828;3589000;0
1200;147945;4182;59;36;4;32;.889;3600000;0
1201;163695;9;0;0;0;0;.00nan;0;0
1201;175092;9;86;39;2;37;.949;3600000;0
1201;57859;15;0;0;0;0;.00nan;0;0
1201;85727;15;64;11;1;10;.909;3600000;0
1202;848;22;0;0;0;0;.00nan;0;0
1202;987;22;86;29;1;28;.966;3600000;0
1202;168712;14;0;0;0;0;.00nan;0;0
1202;59540;14;80;33;3;30;.909;3564000;0
1203;20432;31;92;40;2;38;.950;3600000;0
1203;86360;31;0;0;0;0;.00nan;0;0
1203;144705;17;46;26;4;22;.846;3565000;0
1203;146862;17;0;0;0;0;.00nan;0;0
1204;556;3;67;35;3;32;.914;3600000;0
1204;615;3;0;0;0;0;.00nan;0;0
1204;37818;29;66;34;4;30;.882;3551000;0
1204;152710;29;0;0;0;0;.00nan;0;0
1205;14866;20;0;0;0;0;.00nan;0;0
1205;20693;24;87;52;5;47;.904;3580000;0
1205;55802;20;52;18;3;15;.833;3600000;0
1205;57338;24;0;0;0;0;.00nan;0;0
1206;166646;16;0;0;0;0;.00nan;0;0
1206;5311;8;0;0;0;0;.00nan;0;0
1206;13714;8;71;43;4;39;.907;3555000;0
1206;53842;16;76;29;2;27;.931;3600000;0
1207;1669;33;0;0;0;0;.00nan;0;0
1207;141998;35;0;0;0;0;.00nan;0;0
1207;143473;35;24;31;7;24;.774;3575000;0
1207;149452;33;71;40;5;35;.875;3600000;0
1208;19391;32;0;0;0;0;.00nan;0;0
1208;176995;30;0;0;0;0;.00nan;0;0
1208;36674;30;94;26;1;25;.962;3600000;0
1208;58830;32;84;39;2;37;.949;3544000;0
1209;841;11;0;0;0;0;.00nan;0;0
1209;166381;27;59;14;1;13;.929;3600000;0
1209;175660;27;0;0;0;0;.00nan;0;0
1209;31972;11;64;47;5;42;.894;3600000;0
1210;676;34;0;0;0;0;.00nan;0;0
1210;46492;0;0;0;0;0;.00nan;0;0
1210;78806;34;76;44;5;39;.886;3633000;0
1210;91178;0;54;31;4;27;.871;3675000;0
1211;14866;20;30;29;6;23;.793;3558000;0
1211;55802;20;0;0;0;0;.00nan;0;0
1211;57859;15;68;43;5;38;.884;3600000;0
1211;85727;15;0;0;0;0;.00nan;0;0
1212;166751;5;0;0;0;0;.00nan;0;0
1212;36755;5;78;32;3;29;.906;3600000;0
1212;86192;21;64;23;2;21;.913;3600000;0
1212;143156;21;0;0;0;0;.00nan;0;0
1213;5311;8;65;33;4;29;.879;3600000;0
1213;167642;18;48;38;5;33;.868;3571000;0
1213;13714;8;0;0;0;0;.00nan;0;0
1213;34745;18;0;0;0;0;.00nan;0;0
1214;163565;19;0;0;0;0;.00nan;0;0
1214;14305;19;100;42;1;41;.976;3600000;0
1214;169868;4182;0;0;0;0;.00nan;0;0
1214;147945;4182;40;20;4;16;.800;3600000;0
1215;9235;4838;0;0;0;0;.00nan;0;0
1215;43757;12;0;0;0;0;.00nan;0;0
1215;85798;12;77;25;1;24;.960;3600000;0
1215;143749;4838;69;34;3;31;.912;3558000;0
1216;20432;31;95;29;1;28;.966;3600000;0
1216;20693;24;75;23;2;21;.913;3591000;0
1216;57338;24;0;0;0;0;.00nan;0;0
1216;86360;31;0;0;0;0;.00nan;0;0
1217;163695;9;84;26;1;25;.962;3600000;0
1217;175092;9;0;0;0;0;.00nan;0;0
1217;37818;29;61;21;2;19;.905;3589000;0
1217;152710;29;0;0;0;0;.00nan;0;0
1218;166646;16;0;0;0;0;.00nan;0;0
1218;19391;32;29;18;4;14;.778;840000;0
1218;53842;16;80;31;2;29;.935;3600000;0
1218;58830;32;48;34;5;29;.853;2760000;0
1219;163423;26;0;0;0;0;.00nan;0;0
1219;179154;26;92;40;2;38;.950;3529000;0
1219;174718;25;0;0;0;0;.00nan;0;0
1219;148958;25;100;42;0;42;1.000;3600000;0
1220;841;11;0;0;0;0;.00nan;0;0
1220;31972;11;93;44;1;43;.977;3600000;0
1220;141998;35;0;0;0;0;.00nan;0;0
1220;143473;35;62;23;2;21;.913;3597000;0
1221;676;34;53;31;4;27;.871;3530000;0
1221;168712;14;0;0;0;0;.00nan;0;0
1221;59540;14;80;31;2;29;.935;3600000;0
1221;78806;34;0;0;0;0;.00nan;0;0
1222;8424;28;0;0;0;0;.00nan;0;0
1222;144705;17;0;0;0;0;.00nan;0;0
1222;146862;17;59;28;3;25;.893;4200000;0
1222;152835;28;73;36;3;33;.917;4200000;0
1223;556;3;56;35;5;30;.857;3600000;0
1223;615;3;0;0;0;0;.00nan;0;0
1223;69536;10;0;0;0;0;.00nan;0;0
1223;152717;10;64;14;1;13;.929;3600000;0
1224;848;22;100;22;1;21;.955;3600000;0
1224;987;22;0;0;0;0;.00nan;0;0
1224;1669;33;0;0;0;0;.00nan;0;0
1224;149452;33;76;46;4;42;.913;3600000;0
1225;167642;18;86;22;0;22;1.000;1547000;0
1225;176995;30;66;24;2;22;.917;3600000;0
1225;34745;18;21;33;7;26;.788;2053000;0
1225;36674;30;0;0;0;0;.00nan;0;0
1226;2059;23;41;31;5;26;.839;3525000;0
1226;166381;27;0;0;0;0;.00nan;0;0
1226;175660;27;66;28;3;25;.893;3600000;0
1226;65762;23;0;0;0;0;.00nan;0;0
1227;166751;5;0;0;0;0;.00nan;0;0
1227;36755;5;71;38;4;34;.895;3655000;0
1227;46492;0;0;0;0;0;.00nan;0;0
1227;91178;0;68;28;3;25;.893;3655000;0
1228;166646;16;60;13;1;12;.923;3600000;0
1228;174718;25;0;0;0;0;.00nan;0;0
1228;53842;16;0;0;0;0;.00nan;0;0
1228;148958;25;98;37;2;35;.946;3554000;0
1229;168712;14;59;27;3;24;.889;3570000;0
1229;57859;15;100;45;1;44;.978;3600000;0
1229;59540;14;0;0;0;0;.00nan;0;0
1229;85727;15;0;0;0;0;.00nan;0;0
1230;841;11;89;36;2;34;.944;3600000;0
1230;31972;11;0;0;0;0;.00nan;0;0
1230;43757;12;0;0;0;0;.00nan;0;0
1230;85798;12;63;27;3;24;.889;3557000;0
1231;556;3;71;49;5;44;.898;3600000;0
1231;615;3;0;0;0;0;.00nan;0;0
1231;14866;20;0;0;0;0;.00nan;0;0
1231;55802;20;75;19;1;18;.947;3600000;0
1232;1669;33;0;0;0;0;.00nan;0;0
1232;69536;10;79;38;3;35;.921;3600000;0
1232;149452;33;67;22;2;20;.909;3600000;0
1232;152717;10;0;0;0;0;.00nan;0;0
1233;86192;21;0;0;0;0;.00nan;0;0
1233;143156;21;100;32;0;32;1.000;3600000;0
1233;144705;17;69;27;2;25;.926;3556000;0
1233;146862;17;0;0;0;0;.00nan;0;0
1234;163565;19;65;41;4;37;.902;3518000;0
1234;14305;19;0;0;0;0;.00nan;0;0
1234;141998;35;66;21;2;19;.905;3600000;0
1234;143473;35;0;0;0;0;.00nan;0;0
1235;5311;8;59;17;2;15;.882;3600000;0
1235;163423;26;70;35;3;32;.914;3583000;0
1235;13714;8;0;0;0;0;.00nan;0;0
1235;179154;26;0;0;0;0;.00nan;0;0
1236;8424;28;0;0;0;0;.00nan;0;0
1236;20693;24;71;32;2;30;.938;4200000;0
1236;57338;24;0;0;0;0;.00nan;0;0
1236;152835;28;79;32;2;30;.938;4200000;0
1237;2059;23;61;16;1;15;.938;3600000;0
1237;9235;4838;90;47;3;44;.936;3600000;0
1237;65762;23;0;0;0;0;.00nan;0;0
1237;143749;4838;0;0;0;0;.00nan;0;0
1238;163695;9;0;0;0;0;.00nan;0;0
1238;175092;9;76;24;1;23;.958;3600000;0
1238;57859;15;55;28;4;24;.857;3600000;0
1238;85727;15;0;0;0;0;.00nan;0;0
1239;166751;5;0;0;0;0;.00nan;0;0
1239;14866;20;0;0;0;0;.00nan;0;0
1239;36755;5;78;40;3;37;.925;3571000;0
1239;55802;20;83;25;1;24;.960;3600000;0
1240;556;3;81;46;5;41;.891;3600000;0
1240;615;3;0;0;0;0;.00nan;0;0
1240;37818;29;82;30;1;29;.967;3600000;0
1240;152710;29;0;0;0;0;.00nan;0;0
1241;676;34;0;0;0;0;.00nan;0;0
1241;78806;34;100;37;2;35;.946;3600000;0
1241;144705;17;0;0;0;0;.00nan;0;0
1241;146862;17;71;38;3;35;.921;3600000;0
1242;8424;28;45;24;4;20;.833;3527000;0
1242;69536;10;0;0;0;0;.00nan;0;0
1242;152717;10;76;26;2;24;.923;3600000;0
1242;152835;28;0;0;0;0;.00nan;0;0
1243;848;22;0;0;0;0;.00nan;0;0
1243;987;22;92;16;0;16;1.000;3600000;0
1243;86192;21;0;0;0;0;.00nan;0;0
1243;143156;21;58;40;5;35;.875;3600000;0
1244;168712;14;0;0;0;0;.00nan;0;0
1244;20432;31;50;27;5;22;.815;3600000;0
1244;59540;14;93;34;2;32;.941;3600000;0
1244;86360;31;0;0;0;0;.00nan;0;0
1245;163423;26;0;0;0;0;.00nan;0;0
1245;179154;26;52;22;3;19;.864;3674000;0
1245;46492;0;0;0;0;0;.00nan;0;0
1245;91178;0;40;21;4;17;.810;3674000;0
1246;1669;33;68;24;2;22;.917;3600000;0
1246;19391;32;0;0;0;0;.00nan;0;0
1246;58830;32;100;42;1;41;.976;3600000;0
1246;149452;33;0;0;0;0;.00nan;0;0
1247;166646;16;0;0;0;0;.00nan;0;0
1247;5311;8;0;0;0;0;.00nan;0;0
1247;13714;8;49;36;5;31;.861;3582000;0
1247;53842;16;68;33;4;29;.879;3600000;0
1248;163565;19;0;0;0;0;.00nan;0;0
1248;14305;19;100;46;2;44;.957;3600000;0
1248;166381;27;0;0;0;0;.00nan;0;0
1248;175660;27;24;26;6;20;.769;3600000;0
1249;169868;4182;0;0;0;0;.00nan;0;0
1249;43757;12;0;0;0;0;.00nan;0;0
1249;85798;12;100;29;0;29;1.000;3600000;0
1249;147945;4182;98;31;1;30;.968;3558000;0
1250;841;11;0;0;0;0;.00nan;0;0
1250;176995;30;0;0;0;0;.00nan;0;0
1250;31972;11;70;29;2;27;.931;3777000;0
1250;36674;30;55;24;3;21;.875;3777000;0
1251;174718;25;0;0;0;0;.00nan;0;0
1251;141998;35;0;0;0;0;.00nan;0;0
1251;143473;35;95;48;3;45;.938;3600000;0
1251;148958;25;69;35;4;31;.886;3586000;0
1252;9235;4838;75;41;3;38;.927;3581000;0
1252;167642;18;0;0;0;0;.00nan;0;0
1252;34745;18;79;22;1;21;.955;3600000;0
1252;143749;4838;0;0;0;0;.00nan;0;0
1253;2059;23;74;29;2;27;.931;3600000;0
1253;43757;12;56;33;4;29;.879;3561000;0
1253;65762;23;0;0;0;0;.00nan;0;0
1253;85798;12;0;0;0;0;.00nan;0;0
1254;14866;20;0;0;0;0;.00nan;0;0
1254;46492;0;0;0;0;0;.00nan;0;0
1254;55802;20;81;44;4;40;.909;4200000;0
1254;91178;0;75;47;4;43;.915;4200000;0
1255;168712;14;0;0;0;0;.00nan;0;0
1255;37818;29;67;30;3;27;.900;3600000;0
1255;59540;14;100;26;0;26;1.000;3600000;0
1255;152710;29;0;0;0;0;.00nan;0;0
1256;676;34;79;36;2;34;.944;3600000;0
1256;78806;34;0;0;0;0;.00nan;0;0
1256;86192;21;64;29;3;26;.897;3544000;0
1256;143156;21;0;0;0;0;.00nan;0;0
1257;166751;5;0;0;0;0;.00nan;0;0
1257;20693;24;74;25;2;23;.920;3600000;0
1257;36755;5;59;29;3;26;.897;3600000;0
1257;57338;24;0;0;0;0;.00nan;0;0
1258;556;3;89;39;2;37;.949;3600000;0
1258;615;3;0;0;0;0;.00nan;0;0
1258;20432;31;43;24;4;20;.833;3538000;0
1258;86360;31;0;0;0;0;.00nan;0;0
1259;8424;28;0;0;0;0;.00nan;0;0
1259;69536;10;0;0;0;0;.00nan;0;0
1259;152717;10;47;27;4;23;.852;3600000;0
1259;152835;28;98;39;1;38;.974;3600000;0
1260;848;22;0;0;0;0;.00nan;0;0
1260;987;22;79;30;2;28;.933;3600000;0
1260;144705;17;0;0;0;0;.00nan;0;0
1260;146862;17;83;38;3;35;.921;3563000;0
1261;163423;26;0;0;0;0;.00nan;0;0
1261;19391;32;0;0;0;0;.00nan;0;0
1261;179154;26;46;33;5;28;.848;3554000;0
1261;58830;32;73;30;3;27;.900;3600000;0
1262;841;11;0;0;0;0;.00nan;0;0
1262;169868;4182;0;0;0;0;.00nan;0;0
1262;31972;11;98;54;2;52;.963;3600000;0
1262;147945;4182;100;24;0;24;1.000;3600000;0
1263;166381;27;0;0;0;0;.00nan;0;0
1263;175660;27;57;23;3;20;.870;3549000;0
1263;176995;30;0;0;0;0;.00nan;0;0
1263;36674;30;90;40;2;38;.950;3600000;0
1264;57859;15;0;0;0;0;.00nan;0;0
1264;85727;15;96;41;2;39;.951;3600000;0
1264;141998;35;83;24;1;23;.958;2403000;0
1264;143473;35;27;16;4;12;.750;1197000;0
1265;1669;33;0;0;0;0;.00nan;0;0
1265;174718;25;83;26;1;25;.962;3600000;0
1265;148958;25;0;0;0;0;.00nan;0;0
1265;149452;33;85;40;3;37;.925;3532000;0
1266;167642;18;0;0;0;0;.00nan;0;0
1266;34745;18;100;33;0;33;1.000;3600000;0
1266;43757;12;0;0;0;0;.00nan;0;0
1266;85798;12;54;30;3;27;.900;3600000;0
1267;163565;19;0;0;0;0;.00nan;0;0
1267;14305;19;68;22;2;20;.909;3550000;0
1267;176995;30;0;0;0;0;.00nan;0;0
1267;36674;30;82;29;1;28;.966;3600000;0
1268;166646;16;0;0;0;0;.00nan;0;0
1268;9235;4838;0;0;0;0;.00nan;0;0
1268;53842;16;68;22;2;20;.909;3600000;0
1268;143749;4838;50;33;4;29;.879;3549000;0
1269;848;22;0;0;0;0;.00nan;0;0
1269;987;22;73;27;2;25;.926;3600000;0
1269;86192;21;69;34;3;31;.912;3600000;0
1269;143156;21;0;0;0;0;.00nan;0;0
1270;163423;26;0;0;0;0;.00nan;0;0
1270;169868;4182;0;0;0;0;.00nan;0;0
1270;179154;26;73;35;3;32;.914;3551000;0
1270;147945;4182;69;24;2;22;.917;3600000;0
1271;5311;8;0;0;0;0;.00nan;0;0
1271;13714;8;70;21;1;20;.952;3600000;0
1271;19391;32;0;0;0;0;.00nan;0;0
1271;58830;32;56;31;4;27;.871;3600000;0
1272;37818;29;0;0;0;0;.00nan;0;0
1272;46492;0;0;0;0;0;.00nan;0;0
1272;91178;0;71;41;4;37;.902;3600000;0
1272;152710;29;70;21;1;20;.952;3600000;0
1273;676;34;0;0;0;0;.00nan;0;0
1273;69536;10;0;0;0;0;.00nan;0;0
1273;78806;34;100;30;0;30;1.000;3600000;0
1273;152717;10;98;41;1;40;.976;3541000;0
1274;14866;20;0;0;0;0;.00nan;0;0
1274;20432;31;76;56;5;51;.911;3600000;0
1274;55802;20;91;18;0;18;1.000;3600000;0
1274;86360;31;0;0;0;0;.00nan;0;0
1275;556;3;61;38;5;33;.868;3518000;0
1275;615;3;0;0;0;0;.00nan;0;0
1275;144705;17;0;0;0;0;.00nan;0;0
1275;146862;17;95;41;3;38;.927;3600000;0
1276;166751;5;0;0;0;0;.00nan;0;0
1276;8424;28;0;0;0;0;.00nan;0;0
1276;36755;5;67;50;5;45;.900;3600000;0
1276;152835;28;74;21;2;19;.905;3600000;0
1277;1669;33;0;0;0;0;.00nan;0;0
1277;168712;14;0;0;0;0;.00nan;0;0
1277;59540;14;97;15;0;15;1.000;3600000;0
1277;149452;33;98;45;1;44;.978;3567000;0
1278;163695;9;52;25;4;21;.840;3668000;0
1278;20693;24;57;29;3;26;.897;3668000;0
1278;175092;9;0;0;0;0;.00nan;0;0
1278;57338;24;0;0;0;0;.00nan;0;0
1279;2059;23;100;29;1;28;.966;4200000;0
1279;167642;18;0;0;0;0;.00nan;0;0
1279;34745;18;95;35;1;34;.971;4200000;0
1279;65762;23;0;0;0;0;.00nan;0;0
1280;163565;19;70;42;4;38;.905;3698000;0
1280;14305;19;0;0;0;0;.00nan;0;0
1280;166381;27;0;0;0;0;.00nan;0;0
1280;175660;27;41;30;5;25;.833;3698000;0
1281;841;11;0;0;0;0;.00nan;0;0
1281;166646;16;49;14;2;12;.857;3600000;0
1281;31972;11;78;46;5;41;.891;3600000;0
1281;53842;16;0;0;0;0;.00nan;0;0
1282;169868;4182;58;34;4;30;.882;3600000;0
1282;141998;35;56;5;0;5;1.000;442000;0
1282;143473;35;40;36;6;30;.833;3084000;0
1282;147945;4182;0;0;0;0;.00nan;0;0
1283;5311;8;44;21;3;18;.857;3600000;0
1283;9235;4838;28;16;4;12;.750;1057000;0
1283;13714;8;0;0;0;0;.00nan;0;0
1283;143749;4838;63;23;2;21;.913;2543000;0
1284;174718;25;0;0;0;0;.00nan;0;0
1284;57859;15;0;0;0;0;.00nan;0;0
1284;85727;15;58;35;4;31;.886;3564000;0
1284;148958;25;72;32;3;29;.906;3600000;0
1285;176995;30;0;0;0;0;.00nan;0;0
1285;36674;30;100;35;0;35;1.000;3600000;0
1285;43757;12;0;0;0;0;.00nan;0;0
1285;85798;12;47;33;4;29;.879;3600000;0
1286;166751;5;86;43;3;40;.930;4042000;0
1286;36755;5;0;0;0;0;.00nan;0;0
1286;144705;17;0;0;0;0;.00nan;0;0
1286;146862;17;72;28;4;24;.857;4042000;0
1287;848;22;0;0;0;0;.00nan;0;0
1287;987;22;83;26;1;25;.962;3600000;0
1287;69536;10;43;24;4;20;.833;1303000;0
1287;152717;10;37;26;6;20;.769;2297000;0
1288;1669;33;0;0;0;0;.00nan;0;0
1288;20693;24;79;24;1;23;.958;3600000;0
1288;57338;24;0;0;0;0;.00nan;0;0
1288;149452;33;72;26;2;24;.923;3600000;0
1289;20432;31;60;33;4;29;.879;3600000;0
1289;46492;0;0;0;0;0;.00nan;0;0
1289;86360;31;0;0;0;0;.00nan;0;0
1289;91178;0;89;30;1;29;.967;3600000;0
1290;163695;9;54;18;2;16;.889;1056000;0
1290;14866;20;0;0;0;0;.00nan;0;0
1290;175092;9;20;23;6;17;.739;2544000;0
1290;55802;20;66;24;2;22;.917;3600000;0
1291;556;3;33;30;6;24;.800;3600000;0
1291;615;3;0;0;0;0;.00nan;0;0
1291;86192;21;71;26;2;24;.923;3600000;0
1291;143156;21;0;0;0;0;.00nan;0;0
1292;841;11;0;0;0;0;.00nan;0;0
1292;167642;18;0;0;0;0;.00nan;0;0
1292;31972;11;71;38;4;34;.895;3564000;0
1292;34745;18;71;21;2;19;.905;3600000;0
1293;166646;16;0;0;0;0;.00nan;0;0
1293;166381;27;0;0;0;0;.00nan;0;0
1293;175660;27;90;28;1;27;.964;3600000;0
1293;53842;16;78;37;3;34;.919;3568000;0
1294;556;3;88;46;3;43;.935;3550000;0
1294;615;3;0;0;0;0;.00nan;0;0
1294;163695;9;84;27;1;26;.963;3600000;0
1294;175092;9;0;0;0;0;.00nan;0;0
1295;168712;14;0;0;0;0;.00nan;0;0
1295;57859;15;55;47;6;41;.872;3924000;0
1295;59540;14;60;40;5;35;.875;3924000;0
1295;85727;15;0;0;0;0;.00nan;0;0
1296;8424;28;0;0;0;0;.00nan;0;0
1296;37818;29;71;19;1;18;.947;3600000;0
1296;152710;29;0;0;0;0;.00nan;0;0
1296;152835;28;52;42;6;36;.857;3600000;0
1297;166751;5;0;0;0;0;.00nan;0;0
1297;36755;5;47;30;4;26;.867;3581000;0
1297;144705;17;63;20;2;18;.900;3600000;0
1297;146862;17;0;0;0;0;.00nan;0;0
1298;676;34;0;0;0;0;.00nan;0;0
1298;14866;20;99;26;0;26;1.000;3600000;0
1298;55802;20;0;0;0;0;.00nan;0;0
1298;78806;34;64;40;4;36;.900;3600000;0
1299;19391;32;82;29;1;28;.966;3600000;0
1299;169868;4182;0;0;0;0;.00nan;0;0
1299;58830;32;0;0;0;0;.00nan;0;0
1299;147945;4182;79;39;4;35;.897;3600000;0
1300;9235;4838;0;0;0;0;.00nan;0;0
1300;174718;25;67;24;3;21;.875;3646000;0
1300;143749;4838;99;46;2;44;.957;3646000;0
1300;148958;25;0;0;0;0;.00nan;0;0
1301;2059;23;47;26;4;22;.846;3564000;0
1301;176995;30;0;0;0;0;.00nan;0;0
1301;36674;30;97;46;3;43;.935;3600000;0
1301;65762;23;0;0;0;0;.00nan;0;0
1302;848;22;86;28;1;27;.964;3600000;0
1302;987;22;0;0;0;0;.00nan;0;0
1302;20693;24;51;38;5;33;.868;3600000;0
1302;57338;24;0;0;0;0;.00nan;0;0
1303;8424;28;0;0;0;0;.00nan;0;0
1303;20432;31;100;34;0;34;1.000;3600000;0
1303;86360;31;0;0;0;0;.00nan;0;0
1303;152835;28;58;30;3;27;.900;3600000;0
1304;163423;26;0;0;0;0;.00nan;0;0
1304;179154;26;72;41;4;37;.902;3589000;0
1304;141998;35;0;0;0;0;.00nan;0;0
1304;143473;35;74;33;3;30;.909;3600000;0
1305;167642;18;0;0;0;0;.00nan;0;0
1305;34745;18;98;48;2;46;.958;3545000;0
1305;43757;12;0;0;0;0;.00nan;0;0
1305;85798;12;69;18;1;17;.944;3600000;0
1306;166646;16;0;0;0;0;.00nan;0;0
1306;169868;4182;0;0;0;0;.00nan;0;0
1306;53842;16;95;22;0;22;1.000;3678000;0
1306;147945;4182;94;38;1;37;.974;3678000;0
1307;2059;23;55;27;3;24;.889;4200000;0
1307;19391;32;0;0;0;0;.00nan;0;0
1307;58830;32;95;46;3;43;.935;4200000;0
1307;65762;23;0;0;0;0;.00nan;0;0
1308;841;11;0;0;0;0;.00nan;0;0
1308;176995;30;0;0;0;0;.00nan;0;0
1308;31972;11;73;29;3;26;.897;3600000;0
1308;36674;30;99;48;2;46;.958;3600000;0
1309;5311;8;0;0;0;0;.00nan;0;0
1309;167642;18;56;49;6;43;.878;3600000;0
1309;13714;8;74;27;2;25;.926;3600000;0
1309;34745;18;0;0;0;0;.00nan;0;0
1310;163565;19;0;0;0;0;.00nan;0;0
1310;9235;4838;0;0;0;0;.00nan;0;0
1310;14305;19;61;25;3;22;.880;4034000;0
1310;143749;4838;99;52;2;50;.962;4034000;0
1311;166381;27;0;0;0;0;.00nan;0;0
1311;174718;25;0;0;0;0;.00nan;0;0
1311;175660;27;56;30;4;26;.867;3600000;0
1311;148958;25;68;34;3;31;.912;3600000;0
1313;166751;5;0;0;0;0;.00nan;0;0
1313;166381;27;0;0;0;0;.00nan;0;0
1313;175660;27;78;11;0;11;1.000;3600000;0
1313;36755;5;92;62;3;59;.952;3600000;0
1315;841;15;0;0;0;0;.00nan;0;0
1315;163565;19;0;0;0;0;.00nan;0;0
1315;14305;19;82;23;1;22;.957;3600000;0
1315;85727;15;53;32;5;27;.844;3600000;0
1317;166646;16;0;0;0;0;.00nan;0;0
1317;176995;30;0;0;0;0;.00nan;0;0
1317;36674;30;45;29;5;24;.828;3600000;0
1317;53842;16;98;35;2;33;.943;3600000;0
1319;31972;11;0;0;0;0;.00nan;0;0
1319;57859;11;92;22;0;22;1.000;3600000;0
1319;144705;17;0;0;0;0;.00nan;0;0
1319;146862;17;87;28;1;27;.964;3597000;0
1321;501;8;54;20;2;18;.900;1488000;0
1321;5311;8;12;17;6;11;.647;2112000;0
1321;46492;0;0;0;0;0;.00nan;0;0
1321;91178;0;54;30;5;25;.833;3600000;0
1323;556;3;63;25;3;22;.880;3600000;0
1323;615;3;0;0;0;0;.00nan;0;0
1323;37818;29;36;24;5;19;.792;3578000;0
1323;152710;29;0;0;0;0;.00nan;0;0
1325;676;34;79;40;3;37;.925;3574000;0
1325;78806;34;0;0;0;0;.00nan;0;0
1325;141998;35;0;0;0;0;.00nan;0;0
1325;143473;35;63;20;2;18;.900;3600000;0
1327;2059;23;0;0;0;0;.00nan;0;0
1327;168712;14;0;0;0;0;.00nan;0;0
1327;59540;14;90;29;1;28;.966;3600000;0
1327;65762;23;54;27;3;24;.889;3550000;0
1329;14866;20;94;24;0;24;1.000;3600000;0
1329;20432;31;43;39;6;33;.846;3600000;0
1329;34745;20;0;0;0;0;.00nan;0;0
1329;86360;31;0;0;0;0;.00nan;0;0
1331;19391;32;0;0;0;0;.00nan;0;0
1331;58830;32;69;38;3;35;.921;3600000;0
1331;69536;10;40;24;4;20;.833;3568000;0
1331;152717;10;0;0;0;0;.00nan;0;0
1333;173727;18;0;0;0;0;.00nan;0;0
1333;43757;12;0;0;0;0;.00nan;0;0
1333;55802;18;99;47;1;46;.979;3600000;0
1333;85798;12;60;34;4;30;.882;3600000;0
1335;1669;33;0;0;0;0;.00nan;0;0
1335;170314;25;62;23;2;21;.913;3600000;0
1335;148958;25;0;0;0;0;.00nan;0;0
1335;149452;33;45;29;5;24;.828;3600000;0
1337;169868;4182;0;0;0;0;.00nan;0;0
1337;86192;21;89;42;2;40;.952;3586000;0
1337;143156;21;0;0;0;0;.00nan;0;0
1337;147945;4182;99;34;1;33;.971;3600000;0
1339;163423;26;0;0;0;0;.00nan;0;0
1339;9235;4838;0;0;0;0;.00nan;0;0
1339;179154;26;93;36;1;35;.972;3600000;0
1339;143749;4838;66;27;2;25;.926;3600000;0
1341;848;22;0;0;0;0;.00nan;0;0
1341;987;22;44;27;4;23;.852;3600000;0
1341;8424;28;0;0;0;0;.00nan;0;0
1341;152835;28;91;46;3;43;.935;3600000;0
1343;163695;9;0;0;0;0;.00nan;0;0
1343;20693;24;0;0;0;0;.00nan;0;0
1343;175092;9;60;32;3;29;.906;3600000;0
1343;57338;24;96;24;0;24;1.000;3600000;0
1345;501;8;0;0;0;0;.00nan;0;0
1345;5311;8;77;30;2;28;.933;3600000;0
1345;8424;28;0;0;0;0;.00nan;0;0
1345;152835;28;64;31;3;28;.903;3558000;0
1347;163565;19;0;0;0;0;.00nan;0;0
1347;14305;19;54;26;3;23;.885;3582000;0
1347;173727;18;0;0;0;0;.00nan;0;0
1347;55802;18;71;25;1;24;.960;3600000;0
1349;1669;33;0;0;0;0;.00nan;0;0
1349;14866;20;61;13;1;12;.923;3600000;0
1349;34745;20;0;0;0;0;.00nan;0;0
1349;149452;33;49;29;4;25;.862;3600000;0
1351;841;15;0;0;0;0;.00nan;0;0
1351;166751;5;0;0;0;0;.00nan;0;0
1351;36755;5;60;47;6;41;.872;3600000;0
1351;85727;15;60;16;2;14;.875;3600000;0
1353;166381;27;0;0;0;0;.00nan;0;0
1353;170314;25;62;29;4;25;.862;3555000;0
1353;175660;27;79;31;2;29;.935;3600000;0
1353;148958;25;0;0;0;0;.00nan;0;0
1355;9235;4838;68;31;3;28;.903;3600000;0
1355;169868;4182;0;0;0;0;.00nan;0;0
1355;143749;4838;0;0;0;0;.00nan;0;0
1355;147945;4182;44;36;6;30;.833;3600000;0
1357;43757;12;0;0;0;0;.00nan;0;0
1357;85798;12;97;45;1;44;.978;4200000;0
1357;86192;21;87;25;1;24;.960;4200000;0
1357;143156;21;0;0;0;0;.00nan;0;0
1359;676;34;0;0;0;0;.00nan;0;0
1359;46492;0;100;29;0;29;1.000;3600000;0
1359;78806;34;87;32;1;31;.969;3524000;0
1359;91178;0;0;0;0;0;.00nan;0;0
1361;848;22;51;10;1;9;.900;1325000;0
1361;987;22;25;22;5;17;.773;2275000;0
1361;37818;29;100;30;0;30;1.000;3600000;0
1361;152710;29;0;0;0;0;.00nan;0;0
1363;556;3;83;40;3;37;.925;3878000;0
1363;615;3;0;0;0;0;.00nan;0;0
1363;176995;30;0;0;0;0;.00nan;0;0
1363;36674;30;58;22;2;20;.909;3878000;0
1365;20693;24;0;0;0;0;.00nan;0;0
1365;57338;24;39;27;5;22;.815;3600000;0
1365;144705;17;0;0;0;0;.00nan;0;0
1365;146862;17;70;32;3;29;.906;3600000;0
1367;166646;16;0;0;0;0;.00nan;0;0
1367;31972;11;0;0;0;0;.00nan;0;0
1367;53842;16;76;30;2;28;.933;3600000;0
1367;57859;11;69;42;4;38;.905;3520000;0
1369;163695;9;70;30;2;28;.933;3736000;0
1369;168712;14;0;0;0;0;.00nan;0;0
1369;175092;9;0;0;0;0;.00nan;0;0
1369;59540;14;80;23;1;22;.957;3736000;0
1371;163423;26;46;4;1;3;.750;657000;0
1371;179154;26;38;37;6;31;.838;2943000;0
1371;141998;35;46;21;4;17;.810;3600000;0
1371;143473;35;0;0;0;0;.00nan;0;0
1373;2059;23;92;37;2;35;.946;3600000;0
1373;19391;32;51;24;3;21;.875;3600000;0
1373;58830;32;0;0;0;0;.00nan;0;0
1373;65762;23;0;0;0;0;.00nan;0;0
1375;20432;31;30;29;6;23;.793;3333000;0
1375;69536;10;0;0;0;0;.00nan;0;0
1375;86360;31;50;1;0;1;1.000;240000;0
1375;152717;10;56;29;4;25;.862;3600000;0
1377;20432;31;0;0;0;0;.00nan;0;0
1377;176995;30;0;0;0;0;.00nan;0;0
1377;36674;30;87;33;2;31;.939;3600000;0
1377;86360;31;55;34;4;30;.882;3515000;0
1379;501;8;49;29;5;24;.828;3522000;0
1379;5311;8;0;0;0;0;.00nan;0;0
1379;19391;32;0;0;0;0;.00nan;0;0
1379;58830;32;71;35;3;32;.914;3600000;0
1381;556;3;0;0;0;0;.00nan;0;0
1381;615;3;80;39;3;36;.923;3600000;0
1381;170314;25;34;25;5;20;.800;3523000;0
1381;148958;25;0;0;0;0;.00nan;0;0
1383;848;22;100;23;0;23;1.000;3600000;0
1383;987;22;0;0;0;0;.00nan;0;0
1383;163565;19;58;31;3;28;.903;3600000;0
1383;14305;19;0;0;0;0;.00nan;0;0
1385;14866;20;0;0;0;0;.00nan;0;0
1385;34745;20;66;26;2;24;.923;3600000;0
1385;141998;35;0;0;0;0;.00nan;0;0
1385;143473;35;49;28;4;24;.857;3600000;0
1387;8424;28;54;23;3;20;.870;3530000;0
1387;144705;17;94;34;1;33;.971;3600000;0
1387;146862;17;0;0;0;0;.00nan;0;0
1387;152835;28;0;0;0;0;.00nan;0;0
1389;166646;16;66;29;3;26;.897;3600000;0
1389;46492;0;81;49;4;45;.918;3600000;0
1389;53842;16;0;0;0;0;.00nan;0;0
1389;91178;0;0;0;0;0;.00nan;0;0
1391;1669;33;98;36;2;34;.944;4200000;0
1391;169868;4182;92;43;2;41;.953;4200000;0
1391;147945;4182;0;0;0;0;.00nan;0;0
1391;149452;33;0;0;0;0;.00nan;0;0
1393;163695;9;0;0;0;0;.00nan;0;0
1393;175092;9;73;37;3;34;.919;3600000;0
1393;37818;29;66;19;2;17;.895;3600000;0
1393;152710;29;0;0;0;0;.00nan;0;0
1395;2059;23;0;0;0;0;.00nan;0;0
1395;31972;11;91;41;2;39;.951;3561000;0
1395;57859;11;0;0;0;0;.00nan;0;0
1395;65762;23;87;30;1;29;.967;3600000;0
1397;676;34;39;34;6;28;.824;3600000;0
1397;163423;26;65;39;3;36;.923;3600000;0
1397;179154;26;0;0;0;0;.00nan;0;0
1397;78806;34;0;0;0;0;.00nan;0;0
1399;9235;4838;0;0;0;0;.00nan;0;0
1399;43757;12;58;26;3;23;.885;3554000;0
1399;85798;12;0;0;0;0;.00nan;0;0
1399;143749;4838;100;40;2;38;.950;3600000;0
1401;841;15;79;37;2;35;.946;3600000;0
1401;173727;18;51;31;4;27;.871;3555000;0
1401;55802;18;0;0;0;0;.00nan;0;0
1401;85727;15;0;0;0;0;.00nan;0;0
1403;168712;14;68;33;3;30;.909;3765000;0
1403;20693;24;61;24;2;22;.917;3761000;0
1403;57338;24;0;0;0;0;.00nan;0;0
1403;59540;14;0;0;0;0;.00nan;0;0
1405;69536;10;57;35;4;31;.886;3600000;0
1405;86192;21;0;0;0;0;.00nan;0;0
1405;143156;21;92;37;1;36;.973;3600000;0
1405;152717;10;0;0;0;0;.00nan;0;0
1407;166751;5;66;48;5;43;.896;3739000;0
1407;166381;27;0;0;0;0;.00nan;0;0
1407;175660;27;41;30;6;24;.800;3739000;0
1407;36755;5;0;0;0;0;.00nan;0;0
1409;19391;32;87;33;2;31;.939;3600000;0
1409;58830;32;0;0;0;0;.00nan;0;0
1409;86192;21;75;37;3;34;.919;3551000;0
1409;143156;21;0;0;0;0;.00nan;0;0
1411;848;22;0;0;0;0;.00nan;0;0
1411;987;22;43;30;5;25;.833;3600000;0
1411;166751;5;31;9;3;6;.667;929000;0
1411;36755;5;11;23;7;16;.696;2671000;0
1413;1669;33;0;0;0;0;.00nan;0;0
1413;46492;0;58;34;4;30;.882;3600000;0
1413;91178;0;0;0;0;0;.00nan;0;0
1413;149452;33;80;22;1;21;.955;3600000;0
1415;556;3;74;41;3;38;.927;3600000;0
1415;615;3;0;0;0;0;.00nan;0;0
1415;166381;27;0;0;0;0;.00nan;0;0
1415;175660;27;79;15;0;15;1.000;3600000;0
1417;841;15;0;0;0;0;.00nan;0;0
1417;170314;25;100;26;0;26;1.000;3600000;0
1417;85727;15;59;18;2;16;.889;3576000;0
1417;148958;25;0;0;0;0;.00nan;0;0
1419;20693;24;0;0;0;0;.00nan;0;0
1419;173727;18;50;1;0;1;1.000;345000;0
1419;55802;18;50;43;6;37;.860;3199000;0
1419;57338;24;41;29;5;24;.828;3600000;0
1421;501;8;0;0;0;0;.00nan;0;0
1421;5311;8;77;38;3;35;.921;4200000;0
1421;8424;28;0;0;0;0;.00nan;0;0
1421;152835;28;86;40;3;37;.925;4200000;0
1423;163565;19;0;0;0;0;.00nan;0;0
1423;14305;19;73;23;2;21;.913;3600000;0
1423;20432;31;67;42;5;37;.881;3600000;0
1423;86360;31;0;0;0;0;.00nan;0;0
1425;43757;12;0;0;0;0;.00nan;0;0
1425;85798;12;28;28;6;22;.786;3697000;0
1425;141998;35;70;45;5;40;.889;3679000;0
1425;143473;35;0;0;0;0;.00nan;0;0
1427;9235;4838;0;0;0;0;.00nan;0;0
1427;168712;14;0;0;0;0;.00nan;0;0
1427;59540;14;36;24;5;19;.792;3600000;0
1427;143749;4838;57;43;6;37;.860;3600000;0
1429;676;34;0;0;0;0;.00nan;0;0
1429;78806;34;74;26;2;24;.923;3600000;0
1429;144705;17;73;27;2;25;.926;3096000;0
1429;146862;17;22;5;3;2;.400;504000;0
1431;166646;16;0;0;0;0;.00nan;0;0
1431;37818;29;94;34;1;33;.971;3600000;0
1431;53842;16;52;28;4;24;.857;3600000;0
1431;152710;29;0;0;0;0;.00nan;0;0
1433;2059;23;86;32;1;31;.969;3600000;0
1433;31972;11;0;0;0;0;.00nan;0;0
1433;57859;11;72;27;2;25;.926;3542000;0
1433;65762;23;0;0;0;0;.00nan;0;0
1435;163423;26;0;0;0;0;.00nan;0;0
1435;179154;26;75;36;3;33;.917;3600000;0
1435;176995;30;0;0;0;0;.00nan;0;0
1435;36674;30;69;19;2;17;.895;3600000;0
1437;163695;9;59;34;4;30;.882;3600000;0
1437;169868;4182;34;20;4;16;.800;1465000;0
1437;175092;9;0;0;0;0;.00nan;0;0
1437;147945;4182;41;21;4;17;.810;2135000;0
1439;14866;20;99;27;0;27;1.000;3600000;0
1439;34745;20;0;0;0;0;.00nan;0;0
1439;69536;10;59;36;4;32;.889;3600000;0
1439;152717;10;0;0;0;0;.00nan;0;0
1441;556;3;56;35;5;30;.857;3600000;0
1441;615;3;0;0;0;0;.00nan;0;0
1441;168712;14;83;24;1;23;.958;3600000;0
1441;59540;14;0;0;0;0;.00nan;0;0
1443;8424;28;71;31;2;29;.935;4200000;0
1443;20432;31;0;0;0;0;.00nan;0;0
1443;86360;31;75;30;2;28;.933;4200000;0
1443;152835;28;0;0;0;0;.00nan;0;0
1445;176995;30;0;0;0;0;.00nan;0;0
1445;36674;30;76;25;1;24;.960;3600000;0
1445;46492;0;0;0;0;0;.00nan;0;0
1445;91178;0;71;35;3;32;.914;3551000;0
1447;676;34;77;35;3;32;.914;3600000;0
1447;170314;25;76;11;0;11;1.000;3600000;0
1447;78806;34;0;0;0;0;.00nan;0;0
1447;148958;25;0;0;0;0;.00nan;0;0
1449;166751;5;43;22;4;18;.818;3600000;0
1449;36755;5;0;0;0;0;.00nan;0;0
1449;86192;21;0;0;0;0;.00nan;0;0
1449;143156;21;78;27;2;25;.926;3600000;0
1451;20693;24;77;39;4;35;.897;3694000;0
1451;31972;11;64;28;3;25;.893;3694000;0
1451;57338;24;0;0;0;0;.00nan;0;0
1451;57859;11;0;0;0;0;.00nan;0;0
1453;14866;20;70;34;4;30;.882;3861000;0
1453;34745;20;0;0;0;0;.00nan;0;0
1453;37818;29;0;0;0;0;.00nan;0;0
1453;152710;29;65;39;5;34;.872;3861000;0
1455;9235;4838;36;21;5;16;.762;2218000;0
1455;169868;4182;0;0;0;0;.00nan;0;0
1455;143749;4838;29;10;3;7;.700;1382000;0
1455;147945;4182;60;19;2;17;.895;3600000;0
1457;848;22;86;29;2;27;.931;3600000;0
1457;987;22;0;0;0;0;.00nan;0;0
1457;2059;23;50;8;1;7;.875;1165000;0
1457;65762;23;34;31;6;25;.806;2435000;0
1459;166381;27;0;0;0;0;.00nan;0;0
1459;173727;18;37;32;6;26;.813;3600000;0
1459;175660;27;57;17;2;15;.882;3600000;0
1459;55802;18;0;0;0;0;.00nan;0;0
1461;166646;16;47;19;3;16;.842;3560000;0
1461;163565;19;78;29;2;27;.931;3600000;0
1461;14305;19;0;0;0;0;.00nan;0;0
1461;53842;16;0;0;0;0;.00nan;0;0
1463;163423;26;52;31;4;27;.871;3600000;0
1463;179154;26;0;0;0;0;.00nan;0;0
1463;141998;35;0;0;0;0;.00nan;0;0
1463;143473;35;100;35;0;35;1.000;3600000;0
1465;163695;9;0;0;0;0;.00nan;0;0
1465;175092;9;100;27;0;27;1.000;3600000;0
1465;69536;10;0;0;0;0;.00nan;0;0
1465;152717;10;71;21;1;20;.952;3564000;0
1467;501;8;78;52;5;47;.904;3600000;0
1467;841;15;53;15;2;13;.867;3600000;0
1467;5311;8;0;0;0;0;.00nan;0;0
1467;85727;15;0;0;0;0;.00nan;0;0
1469;19391;32;0;0;0;0;.00nan;0;0
1469;58830;32;63;40;4;36;.900;4156000;0
1469;144705;17;0;0;0;0;.00nan;0;0
1469;146862;17;43;19;4;15;.789;4200000;0
1471;1669;33;23;23;6;17;.739;2366000;0
1471;43757;12;66;40;5;35;.875;3600000;0
1471;85798;12;0;0;0;0;.00nan;0;0
1471;149452;33;63;9;0;9;1.000;1181000;0
1473;14866;20;78;46;5;41;.891;3600000;0
1473;34745;20;0;0;0;0;.00nan;0;0
1473;37818;29;77;31;2;29;.935;3600000;0
1473;152710;29;0;0;0;0;.00nan;0;0
1475;501;8;0;0;0;0;.00nan;0;0
1475;5311;8;66;18;1;17;.944;3600000;0
1475;9235;4838;0;0;0;0;.00nan;0;0
1475;143749;4838;82;36;2;34;.944;3571000;0
1477;841;15;0;0;0;0;.00nan;0;0
1477;166381;27;0;0;0;0;.00nan;0;0
1477;175660;27;83;31;2;29;.935;3687000;0
1477;85727;15;75;23;1;22;.957;3687000;0
1479;166751;5;0;0;0;0;.00nan;0;0
1479;36755;5;35;27;5;22;.815;3600000;0
1479;46492;0;92;33;1;32;.970;3600000;0
1479;91178;0;0;0;0;0;.00nan;0;0
1481;20432;31;98;37;2;35;.946;3600000;0
1481;20693;24;0;0;0;0;.00nan;0;0
1481;57338;24;44;34;5;29;.853;3600000;0
1481;86360;31;0;0;0;0;.00nan;0;0
1483;163565;19;0;0;0;0;.00nan;0;0
1483;14305;19;70;40;3;37;.925;4200000;0
1483;170314;25;54;26;3;23;.885;4200000;0
1483;148958;25;0;0;0;0;.00nan;0;0
1485;166646;16;0;0;0;0;.00nan;0;0
1485;8424;28;0;0;0;0;.00nan;0;0
1485;53842;16;98;46;3;43;.935;3537000;0
1485;152835;28;78;23;1;22;.957;3600000;0
1487;556;3;47;28;4;24;.857;3600000;0
1487;615;3;0;0;0;0;.00nan;0;0
1487;69536;10;0;0;0;0;.00nan;0;0
1487;152717;10;73;36;3;33;.917;3600000;0
1489;848;22;0;0;0;0;.00nan;0;0
1489;987;22;79;23;1;22;.957;3545000;0
1489;2059;23;98;23;0;23;1.000;3600000;0
1489;65762;23;0;0;0;0;.00nan;0;0
1491;1669;33;0;0;0;0;.00nan;0;0
1491;43757;12;0;0;0;0;.00nan;0;0
1491;85798;12;68;27;3;24;.889;3600000;0
1491;149452;33;73;45;5;40;.889;3530000;0
1493;31972;11;0;0;0;0;.00nan;0;0
1493;57859;11;63;41;4;37;.902;3555000;0
1493;144705;17;0;0;0;0;.00nan;0;0
1493;146862;17;69;29;3;26;.897;3600000;0
1495;19391;32;0;0;0;0;.00nan;0;0
1495;173727;18;76;23;1;22;.957;3600000;0
1495;55802;18;0;0;0;0;.00nan;0;0
1495;58830;32;77;41;4;37;.902;3600000;0
1497;168712;14;0;0;0;0;.00nan;0;0
1497;169868;4182;0;0;0;0;.00nan;0;0
1497;59540;14;88;40;3;37;.925;3600000;0
1497;147945;4182;42;36;6;30;.833;3600000;0
1499;676;34;65;31;3;28;.903;3600000;0
1499;78806;34;0;0;0;0;.00nan;0;0
1499;141998;35;0;0;0;0;.00nan;0;0
1499;143473;35;49;27;4;23;.852;3600000;0
1501;176995;30;0;0;0;0;.00nan;0;0
1501;36674;30;29;27;6;21;.778;3600000;0
1501;86192;21;91;51;1;50;.980;3600000;0
1501;143156;21;0;0;0;0;.00nan;0;0
1503;163423;26;0;0;0;0;.00nan;0;0
1503;163695;9;0;0;0;0;.00nan;0;0
1503;179154;26;43;29;5;24;.828;4200000;0
1503;175092;9;42;32;5;27;.844;4200000;0
1505;14866;20;0;0;0;0;.00nan;0;0
1505;34745;20;73;19;1;18;.947;3600000;0
1505;144705;17;40;49;7;42;.857;3600000;0
1505;146862;17;0;0;0;0;.00nan;0;0
1507;2059;23;75;33;3;30;.909;3600000;0
1507;163423;26;54;43;6;37;.860;3600000;0
1507;179154;26;0;0;0;0;.00nan;0;0
1507;65762;23;0;0;0;0;.00nan;0;0
1509;841;15;80;23;1;22;.957;3600000;0
1509;176995;30;0;0;0;0;.00nan;0;0
1509;36674;30;59;20;2;18;.900;3546000;0
1509;85727;15;0;0;0;0;.00nan;0;0
1511;20693;24;58;26;3;23;.885;3577000;0
1511;46492;0;0;0;0;0;.00nan;0;0
1511;57338;24;0;0;0;0;.00nan;0;0
1511;91178;0;81;32;3;29;.906;3600000;0
1513;556;3;0;0;0;0;.00nan;0;0
1513;615;3;88;56;5;51;.911;3600000;0
1513;69536;10;85;28;1;27;.964;3600000;0
1513;152717;10;0;0;0;0;.00nan;0;0
1515;8424;28;79;30;1;29;.967;3600000;0
1515;9235;4838;34;19;4;15;.789;3600000;0
1515;143749;4838;0;0;0;0;.00nan;0;0
1515;152835;28;0;0;0;0;.00nan;0;0
1517;1669;33;35;17;4;13;.765;4200000;0
1517;166751;5;81;41;4;37;.902;4200000;0
1517;36755;5;0;0;0;0;.00nan;0;0
1517;149452;33;0;0;0;0;.00nan;0;0
1519;501;8;59;37;4;33;.892;3600000;0
1519;5311;8;0;0;0;0;.00nan;0;0
1519;141998;35;52;23;3;20;.870;3600000;0
1519;143473;35;0;0;0;0;.00nan;0;0
1521;166646;16;63;36;4;32;.889;3600000;0
1521;163565;19;49;36;5;31;.861;3579000;0
1521;14305;19;0;0;0;0;.00nan;0;0
1521;53842;16;0;0;0;0;.00nan;0;0
1523;173727;18;0;0;0;0;.00nan;0;0
1523;37818;29;0;0;0;0;.00nan;0;0
1523;55802;18;60;26;3;23;.885;3600000;0
1523;152710;29;61;37;4;33;.892;3593000;0
1525;676;34;0;0;0;0;.00nan;0;0
1525;169868;4182;59;32;3;29;.906;3548000;0
1525;78806;34;93;43;2;41;.953;3600000;0
1525;147945;4182;0;0;0;0;.00nan;0;0
1527;43757;12;82;27;1;26;.963;3600000;0
1527;85798;12;0;0;0;0;.00nan;0;0
1527;86192;21;0;0;0;0;.00nan;0;0
1527;143156;21;56;39;5;34;.872;3600000;0
1529;848;22;40;28;5;23;.821;3600000;0
1529;987;22;0;0;0;0;.00nan;0;0
1529;170314;25;0;0;0;0;.00nan;0;0
1529;148958;25;92;34;1;33;.971;3600000;0
1531;19391;32;69;31;3;28;.903;3690000;0
1531;31972;11;73;26;2;24;.923;3690000;0
1531;57859;11;0;0;0;0;.00nan;0;0
1531;58830;32;0;0;0;0;.00nan;0;0
1533;163695;9;70;40;5;35;.875;3977000;0
1533;20432;31;0;0;0;0;.00nan;0;0
1533;175092;9;0;0;0;0;.00nan;0;0
1533;86360;31;66;41;4;37;.902;3977000;0
1535;166381;27;0;0;0;0;.00nan;0;0
1535;168712;14;98;26;0;26;1.000;3600000;0
1535;175660;27;63;34;4;30;.882;3600000;0
1535;59540;14;0;0;0;0;.00nan;0;0
2350;14866;20;0;0;0;0;.00nan;0;0
2350;20693;24;64;28;2;26;.929;3600000;0
2350;55802;20;70;18;1;17;.944;3600000;0
2350;57338;24;0;0;0;0;.00nan;0;0
2351;37818;29;59;32;4;28;.875;3573000;0
2351;46492;0;0;0;0;0;.00nan;0;0
2351;91178;0;81;36;3;33;.917;3600000;0
2351;152710;29;0;0;0;0;.00nan;0;0
2352;848;22;0;0;0;0;.00nan;0;0
2352;987;22;80;28;1;27;.964;3600000;0
2352;86192;21;57;38;5;33;.868;3600000;0
2352;143156;21;0;0;0;0;.00nan;0;0
2353;168712;14;0;0;0;0;.00nan;0;0
2353;57859;15;0;0;0;0;.00nan;0;0
2353;59540;14;77;32;2;30;.938;3560000;0
2353;85727;15;66;19;1;18;.947;3600000;0
2354;166381;27;0;0;0;0;.00nan;0;0
2354;169868;4182;0;0;0;0;.00nan;0;0
2354;175660;27;84;16;0;16;1.000;3600000;0
2354;147945;4182;76;38;3;35;.921;3600000;0
2355;5311;8;0;0;0;0;.00nan;0;0
2355;13714;8;78;31;2;29;.935;3577000;0
2355;43757;12;0;0;0;0;.00nan;0;0
2355;85798;12;81;24;1;23;.958;3600000;0
2356;163565;19;0;0;0;0;.00nan;0;0
2356;14305;19;65;22;2;20;.909;3600000;0
2356;176995;30;0;0;0;0;.00nan;0;0
2356;36674;30;69;41;4;37;.902;3580000;0
2357;166646;16;0;0;0;0;.00nan;0;0
2357;174718;25;0;0;0;0;.00nan;0;0
2357;53842;16;45;32;5;27;.844;3543000;0
2357;148958;25;80;40;4;36;.900;3600000;0
2358;14866;20;52;20;3;17;.850;3552000;0
2358;20693;24;100;41;2;39;.951;3600000;0
2358;55802;20;0;0;0;0;.00nan;0;0
2358;57338;24;0;0;0;0;.00nan;0;0
2359;37818;29;40;18;4;14;.778;3721000;0
2359;46492;0;0;0;0;0;.00nan;0;0
2359;91178;0;96;43;3;40;.930;3721000;0
2359;152710;29;0;0;0;0;.00nan;0;0
2360;848;22;0;0;0;0;.00nan;0;0
2360;987;22;39;22;4;18;.818;3535000;0
2360;86192;21;99;42;2;40;.952;3600000;0
2360;143156;21;0;0;0;0;.00nan;0;0
2361;168712;14;0;0;0;0;.00nan;0;0
2361;57859;15;0;0;0;0;.00nan;0;0
2361;59540;14;85;39;3;36;.923;3522000;0
2361;85727;15;93;30;1;29;.967;3600000;0
2362;166381;27;0;0;0;0;.00nan;0;0
2362;169868;4182;52;14;2;12;.857;1491000;0
2362;175660;27;77;20;1;19;.950;3600000;0
2362;147945;4182;40;35;6;29;.829;2109000;0
2363;5311;8;0;0;0;0;.00nan;0;0
2363;13714;8;81;40;3;37;.925;3600000;0
2363;43757;12;0;0;0;0;.00nan;0;0
2363;85798;12;48;29;4;25;.862;3588000;0
2364;163565;19;0;0;0;0;.00nan;0;0
2364;14305;19;53;25;4;21;.840;3600000;0
2364;176995;30;67;9;0;9;1.000;1133000;0
2364;36674;30;40;30;6;24;.800;2467000;0
2365;166646;16;0;0;0;0;.00nan;0;0
2365;174718;25;0;0;0;0;.00nan;0;0
2365;53842;16;62;28;3;25;.893;3600000;0
2365;148958;25;60;38;4;34;.895;3578000;0
2366;14866;20;64;14;1;13;.929;3600000;0
2366;20693;24;72;46;5;41;.891;3600000;0
2366;55802;20;0;0;0;0;.00nan;0;0
2366;57338;24;0;0;0;0;.00nan;0;0
2367;37818;29;38;27;5;22;.815;3546000;0
2367;46492;0;0;0;0;0;.00nan;0;0
2367;91178;0;83;41;4;37;.902;3600000;0
2367;152710;29;0;0;0;0;.00nan;0;0
2368;848;22;0;0;0;0;.00nan;0;0
2368;987;22;66;26;2;24;.923;3600000;0
2368;86192;21;58;29;4;25;.862;3546000;0
2368;143156;21;0;0;0;0;.00nan;0;0
2369;168712;14;0;0;0;0;.00nan;0;0
2369;57859;15;0;0;0;0;.00nan;0;0
2369;59540;14;94;37;1;36;.973;3600000;0
2369;85727;15;61;29;3;26;.897;3526000;0
2370;166381;27;47;12;2;10;.833;2426000;0
2370;169868;4182;0;0;0;0;.00nan;0;0
2370;175660;27;21;10;4;6;.600;1174000;0
2370;147945;4182;61;40;5;35;.875;3600000;0
2371;5311;8;0;0;0;0;.00nan;0;0
2371;13714;8;55;23;3;20;.870;3600000;0
2371;43757;12;0;0;0;0;.00nan;0;0
2371;85798;12;52;26;4;22;.846;3591000;0
2372;163565;19;0;0;0;0;.00nan;0;0
2372;14305;19;66;24;3;21;.875;3600000;0
2372;176995;30;0;0;0;0;.00nan;0;0
2372;36674;30;81;36;2;34;.944;3600000;0
2373;166646;16;0;0;0;0;.00nan;0;0
2373;174718;25;0;0;0;0;.00nan;0;0
2373;53842;16;76;28;2;26;.929;3600000;0
2373;148958;25;62;34;4;30;.882;3532000;0
2374;14866;20;52;33;5;28;.848;3549000;0
2374;20693;24;76;41;4;37;.902;3600000;0
2374;55802;20;0;0;0;0;.00nan;0;0
2374;57338;24;0;0;0;0;.00nan;0;0
2375;37818;29;89;40;2;38;.950;3600000;0
2375;46492;0;65;16;1;15;.938;1397000;0
2375;91178;0;20;23;6;17;.739;2203000;0
2375;152710;29;0;0;0;0;.00nan;0;0
2376;848;22;0;0;0;0;.00nan;0;0
2376;987;22;72;32;3;29;.906;3523000;0
2376;86192;21;91;30;1;29;.967;3600000;0
2376;143156;21;0;0;0;0;.00nan;0;0
2377;168712;14;51;3;0;3;1.000;509000;0
2377;57859;15;0;0;0;0;.00nan;0;0
2377;59540;14;66;50;6;44;.880;3091000;0
2377;85727;15;75;25;2;23;.920;3600000;0
2378;166381;27;0;0;0;0;.00nan;0;0
2378;169868;4182;0;0;0;0;.00nan;0;0
2378;175660;27;48;23;4;19;.826;3600000;0
2378;147945;4182;23;40;9;31;.775;3600000;0
2379;5311;8;0;0;0;0;.00nan;0;0
2379;13714;8;78;26;1;25;.962;3600000;0
2379;43757;12;0;0;0;0;.00nan;0;0
2379;85798;12;49;38;6;32;.842;3600000;0
2380;163565;19;0;0;0;0;.00nan;0;0
2380;14305;19;42;15;3;12;.800;3600000;0
2380;176995;30;0;0;0;0;.00nan;0;0
2380;36674;30;96;32;1;31;.969;3600000;0
2381;166646;16;0;0;0;0;.00nan;0;0
2381;174718;25;0;0;0;0;.00nan;0;0
2381;53842;16;64;28;4;24;.857;3968000;0
2381;148958;25;77;43;5;38;.884;3968000;0
161;14866;20;59;14;1;13;.929;3600000;0
161;20693;24;94;40;2;38;.950;3578000;0
161;55802;20;0;0;0;0;.00nan;0;0
161;57338;24;0;0;0;0;.00nan;0;0
162;37818;29;51;28;4;24;.857;2327000;0
162;46492;0;0;0;0;0;.00nan;0;0
162;91178;0;95;25;1;24;.960;3600000;0
162;152710;29;48;7;1;6;.857;1273000;0
163;848;22;0;0;0;0;.00nan;0;0
163;987;22;52;24;3;21;.875;3600000;0
163;86192;21;59;35;4;31;.886;3572000;0
163;143156;21;0;0;0;0;.00nan;0;0
164;168712;14;0;0;0;0;.00nan;0;0
164;57859;15;0;0;0;0;.00nan;0;0
164;59540;14;100;53;0;53;1.000;3600000;0
164;85727;15;57;11;1;10;.909;3571000;0
165;166381;27;0;0;0;0;.00nan;0;0
165;169868;4182;51;18;2;16;.889;1227000;0
165;175660;27;88;15;0;15;1.000;3600000;0
165;147945;4182;46;25;4;21;.840;2373000;0
166;5311;8;0;0;0;0;.00nan;0;0
166;13714;8;88;43;3;40;.930;3564000;0
166;43757;12;0;0;0;0;.00nan;0;0
166;85798;12;81;29;2;27;.931;3600000;0
167;163565;19;0;0;0;0;.00nan;0;0
167;14305;19;51;26;4;22;.846;3525000;0
167;176995;30;0;0;0;0;.00nan;0;0
167;36674;30;71;25;2;23;.920;3600000;0
168;166646;16;62;7;0;7;1.000;998000;0
168;174718;25;0;0;0;0;.00nan;0;0
168;53842;16;21;21;6;15;.714;2602000;0
168;148958;25;90;28;1;27;.964;3600000;0
190;14866;20;81;31;2;29;.935;3613000;0
190;20693;24;76;34;3;31;.912;3613000;0
190;55802;20;0;0;0;0;.00nan;0;0
190;57338;24;0;0;0;0;.00nan;0;0
191;848;22;0;0;0;0;.00nan;0;0
191;987;22;20;11;4;7;.636;3550000;0
191;86192;21;92;41;3;38;.927;3600000;0
191;143156;21;0;0;0;0;.00nan;0;0
192;168712;14;0;0;0;0;.00nan;0;0
192;57859;15;0;0;0;0;.00nan;0;0
192;59540;14;98;25;0;25;1.000;3600000;0
192;85727;15;64;20;2;18;.900;3573000;0
193;5311;8;0;0;0;0;.00nan;0;0
193;13714;8;75;26;2;24;.923;3600000;0
193;43757;12;0;0;0;0;.00nan;0;0
193;85798;12;61;46;6;40;.870;3600000;0
194;163565;19;0;0;0;0;.00nan;0;0
194;14305;19;63;26;3;23;.885;3564000;0
194;176995;30;0;0;0;0;.00nan;0;0
194;36674;30;79;31;2;29;.935;3600000;0
195;166646;16;81;46;4;42;.913;3568000;0
195;174718;25;0;0;0;0;.00nan;0;0
195;53842;16;0;0;0;0;.00nan;0;0
195;148958;25;75;35;3;32;.914;3600000;0
205;848;22;0;0;0;0;.00nan;0;0
205;987;22;77;20;1;19;.950;3600000;0
205;86192;21;63;46;5;41;.891;3600000;0
205;143156;21;0;0;0;0;.00nan;0;0
206;168712;14;0;0;0;0;.00nan;0;0
206;57859;15;0;0;0;0;.00nan;0;0
206;59540;14;74;28;3;25;.893;3600000;0
206;85727;15;50;15;2;13;.867;3600000;0
207;166646;16;82;26;1;25;.962;3600000;0
207;174718;25;0;0;0;0;.00nan;0;0
207;53842;16;0;0;0;0;.00nan;0;0
207;148958;25;69;37;4;33;.892;3600000;0
220;14866;20;95;37;2;35;.946;3600000;0
220;55802;20;0;0;0;0;.00nan;0;0
220;57859;15;0;0;0;0;.00nan;0;0
220;85727;15;47;21;3;18;.857;3560000;0
221;848;22;0;0;0;0;.00nan;0;0
221;987;22;64;23;2;21;.913;3600000;0
221;46492;0;0;0;0;0;.00nan;0;0
221;91178;0;80;36;3;33;.917;3551000;0
222;5311;8;0;0;0;0;.00nan;0;0
222;13714;8;78;27;2;25;.926;3812000;0
222;166381;27;0;0;0;0;.00nan;0;0
222;175660;27;65;28;3;25;.893;3812000;0
223;166646;16;33;29;6;23;.793;2618000;0
223;176995;30;0;0;0;0;.00nan;0;0
223;36674;30;94;51;4;47;.922;3600000;0
223;53842;16;42;3;1;2;.667;982000;0
224;14866;20;94;48;2;46;.958;4414000;0
224;55802;20;0;0;0;0;.00nan;0;0
224;57859;15;0;0;0;0;.00nan;0;0
224;85727;15;86;34;1;33;.971;4414000;0
225;848;22;0;0;0;0;.00nan;0;0
225;987;22;87;43;2;41;.953;4566000;0
225;46492;0;0;0;0;0;.00nan;0;0
225;91178;0;73;39;3;36;.923;4566000;0
226;5311;8;0;0;0;0;.00nan;0;0
226;13714;8;92;45;4;41;.911;4315000;0
226;166381;27;0;0;0;0;.00nan;0;0
226;175660;27;72;41;3;38;.927;4315000;0
227;166646;16;0;0;0;0;.00nan;0;0
227;176995;30;0;0;0;0;.00nan;0;0
227;36674;30;65;29;3;26;.897;3600000;0
227;53842;16;70;35;4;31;.886;3547000;0
228;14866;20;74;33;3;30;.909;3600000;0
228;55802;20;0;0;0;0;.00nan;0;0
228;57859;15;0;0;0;0;.00nan;0;0
228;85727;15;41;38;7;31;.816;3600000;0
229;848;22;0;0;0;0;.00nan;0;0
229;987;22;100;30;0;30;1.000;3600000;0
229;46492;0;0;0;0;0;.00nan;0;0
229;91178;0;98;49;3;46;.939;3600000;0
230;5311;8;0;0;0;0;.00nan;0;0
230;13714;8;89;27;1;26;.963;3600000;0
230;166381;27;0;0;0;0;.00nan;0;0
230;175660;27;51;32;5;27;.844;3600000;0
231;166646;16;0;0;0;0;.00nan;0;0
231;176995;30;0;0;0;0;.00nan;0;0
231;36674;30;100;37;0;37;1.000;3600000;0
231;53842;16;69;25;2;23;.920;3527000;0
232;14866;20;77;28;2;26;.929;3600000;0
232;55802;20;0;0;0;0;.00nan;0;0
232;57859;15;0;0;0;0;.00nan;0;0
232;85727;15;63;35;4;31;.886;3536000;0
233;848;22;0;0;0;0;.00nan;0;0
233;987;22;61;38;4;34;.895;3580000;0
233;46492;0;0;0;0;0;.00nan;0;0
233;91178;0;71;33;3;30;.909;3600000;0
234;5311;8;0;0;0;0;.00nan;0;0
234;13714;8;95;31;1;30;.968;3959000;0
234;166381;27;0;0;0;0;.00nan;0;0
234;175660;27;74;21;2;19;.905;3959000;0
235;166646;16;0;0;0;0;.00nan;0;0
235;176995;30;52;4;0;4;1.000;449000;0
235;36674;30;40;34;6;28;.824;3151000;0
235;53842;16;88;36;2;34;.944;3600000;0
384;14866;20;63;32;4;28;.875;3545000;0
384;55802;20;0;0;0;0;.00nan;0;0
384;57859;15;0;0;0;0;.00nan;0;0
384;85727;15;91;46;3;43;.935;3600000;0
385;848;22;70;17;1;16;.941;1241000;0
385;987;22;29;16;4;12;.750;2359000;0
385;46492;0;0;0;0;0;.00nan;0;0
385;91178;0;66;29;3;26;.897;3600000;0
386;5311;8;0;0;0;0;.00nan;0;0
386;13714;8;90;50;4;46;.920;3600000;0
386;166381;27;0;0;0;0;.00nan;0;0
386;175660;27;76;21;1;20;.952;3600000;0
387;166646;16;0;0;0;0;.00nan;0;0
387;176995;30;0;0;0;0;.00nan;0;0
387;36674;30;32;24;5;19;.792;3600000;0
387;53842;16;100;27;0;27;1.000;3600000;0
400;14866;20;82;37;3;34;.919;3600000;0
400;55802;20;0;0;0;0;.00nan;0;0
400;57859;15;49;1;0;1;1.000;328000;0
400;85727;15;33;36;7;29;.806;3272000;0
401;848;22;88;34;1;33;.971;3600000;0
401;987;22;0;0;0;0;.00nan;0;0
401;46492;0;0;0;0;0;.00nan;0;0
401;91178;0;61;31;4;27;.871;3600000;0
402;5311;8;0;0;0;0;.00nan;0;0
402;13714;8;51;26;3;23;.885;3536000;0
402;166381;27;0;0;0;0;.00nan;0;0
402;175660;27;100;34;1;33;.971;3600000;0
403;166646;16;0;0;0;0;.00nan;0;0
403;176995;30;0;0;0;0;.00nan;0;0
403;36674;30;69;30;3;27;.900;3523000;0
403;53842;16;73;21;1;20;.952;3600000;0
409;5311;8;0;0;0;0;.00nan;0;0
409;13714;8;68;31;3;28;.903;3572000;0
409;166381;27;0;0;0;0;.00nan;0;0
409;175660;27;71;29;2;27;.931;3600000;0
410;166646;16;0;0;0;0;.00nan;0;0
410;176995;30;0;0;0;0;.00nan;0;0
410;36674;30;72;39;3;36;.923;3600000;0
410;53842;16;80;25;1;24;.960;3600000;0
414;848;22;85;27;1;26;.963;3600000;0
414;987;22;0;0;0;0;.00nan;0;0
414;14866;20;89;43;2;41;.953;3541000;0
414;55802;20;0;0;0;0;.00nan;0;0
415;166646;16;0;0;0;0;.00nan;0;0
415;166381;27;0;0;0;0;.00nan;0;0
415;175660;27;24;19;6;13;.684;3511000;0
415;53842;16;79;52;4;48;.923;3600000;0
416;848;22;68;25;2;23;.920;3600000;0
416;987;22;0;0;0;0;.00nan;0;0
416;14866;20;55;17;3;14;.824;3587000;0
416;55802;20;0;0;0;0;.00nan;0;0
417;166646;16;0;0;0;0;.00nan;0;0
417;166381;27;0;0;0;0;.00nan;0;0
417;175660;27;74;18;1;17;.944;3600000;0
417;53842;16;57;37;6;31;.838;3600000;0
418;848;22;99;36;2;34;.944;3600000;0
418;987;22;0;0;0;0;.00nan;0;0
418;14866;20;66;36;4;32;.889;3550000;0
418;55802;20;0;0;0;0;.00nan;0;0
419;166646;16;0;0;0;0;.00nan;0;0
419;166381;27;0;0;0;0;.00nan;0;0
419;175660;27;68;20;1;19;.950;3600000;0
419;53842;16;47;33;5;28;.848;3600000;0
420;848;22;57;21;2;19;.905;3600000;0
420;987;22;0;0;0;0;.00nan;0;0
420;14866;20;59;33;5;28;.848;3600000;0
420;55802;20;0;0;0;0;.00nan;0;0
421;166646;16;0;0;0;0;.00nan;0;0
421;166381;27;0;0;0;0;.00nan;0;0
421;175660;27;53;22;3;19;.864;3572000;0
421;53842;16;85;31;1;30;.968;3600000;0
437;166646;16;55;4;0;4;1.000;373000;0
437;166381;27;0;0;0;0;.00nan;0;0
437;175660;27;76;19;1;18;.947;3600000;0
437;53842;16;45;45;7;38;.844;3227000;0
438;166646;16;82;35;2;33;.943;3582000;0
438;166381;27;0;0;0;0;.00nan;0;0
438;175660;27;68;18;1;17;.944;3600000;0
438;53842;16;0;0;0;0;.00nan;0;0
445;848;22;40;20;4;16;.800;3600000;0
445;987;22;0;0;0;0;.00nan;0;0
445;166381;27;0;0;0;0;.00nan;0;0
445;175660;27;45;35;6;29;.829;3600000;0
446;848;22;40;15;3;12;.800;4001000;0
446;987;22;0;0;0;0;.00nan;0;0
446;166381;27;0;0;0;0;.00nan;0;0
446;175660;27;74;42;4;38;.905;4001000;0
447;848;22;84;34;2;32;.941;3600000;0
447;987;22;0;0;0;0;.00nan;0;0
447;166381;27;0;0;0;0;.00nan;0;0
447;175660;27;63;28;3;25;.893;3563000;0
448;848;22;77;28;2;26;.929;3600000;0
448;987;22;0;0;0;0;.00nan;0;0
448;166381;27;0;0;0;0;.00nan;0;0
448;175660;27;64;35;4;31;.886;3514000;0
1536;175912;57;0;0;0;0;.00nan;0;0
1536;180316;52;0;0;0;0;.00nan;0;0
1536;37857;52;89;26;1;25;.962;3600000;0
1536;57152;57;75;47;5;42;.894;3600000;0
1537;172340;48;0;0;0;0;.00nan;0;0
1537;163471;62;27;39;7;32;.821;3600000;0
1537;36346;62;0;0;0;0;.00nan;0;0
1537;78775;48;64;26;3;23;.885;3600000;0
1538;60773;37;0;0;0;0;.00nan;0;0
1538;79132;49;27;26;6;20;.769;1750000;0
1538;91225;49;68;20;1;19;.950;1850000;0
1538;141850;37;60;15;2;13;.867;3600000;0
1539;501;42;0;0;0;0;.00nan;0;0
1539;37077;4837;41;22;4;18;.818;3600000;0
1539;47112;4837;0;0;0;0;.00nan;0;0
1539;141496;42;33;27;5;22;.815;3570000;0
1540;168586;44;0;0;0;0;.00nan;0;0
1540;59239;43;0;0;0;0;.00nan;0;0
1540;64811;44;74;29;2;27;.931;3600000;0
1540;90164;43;54;28;4;24;.857;3563000;0
1541;170294;60;0;0;0;0;.00nan;0;0
1541;171608;46;0;0;0;0;.00nan;0;0
1541;68938;46;87;28;1;27;.964;3600000;0
1541;85797;60;63;20;2;18;.900;3573000;0
1542;170314;4619;56;37;5;32;.865;3720000;0
1542;38276;47;0;0;0;0;.00nan;0;0
1542;64800;4619;0;0;0;0;.00nan;0;0
1542;87798;47;54;42;6;36;.857;3720000;0
1543;162945;38;0;0;0;0;.00nan;0;0
1543;58037;53;65;28;3;25;.893;3600000;0
1543;78581;53;0;0;0;0;.00nan;0;0
1543;85428;38;61;39;5;34;.872;3600000;0
1544;171838;41;64;34;4;30;.882;3600000;0
1544;164715;63;80;28;1;27;.964;3600000;0
1544;170977;41;0;0;0;0;.00nan;0;0
1544;149584;63;0;0;0;0;.00nan;0;0
1545;168651;40;0;0;0;0;.00nan;0;0
1545;171673;50;68;30;3;27;.900;3900000;0
1545;68799;50;0;0;0;0;.00nan;0;0
1545;142492;40;79;40;3;37;.925;3900000;0
1546;173727;61;79;27;1;26;.963;3900000;0
1546;170598;54;0;0;0;0;.00nan;0;0
1546;57207;61;0;0;0;0;.00nan;0;0
1546;94615;54;95;39;1;38;.974;3900000;0
1547;163462;55;67;27;2;25;.926;3600000;0
1547;173699;36;0;0;0;0;.00nan;0;0
1547;74734;36;62;30;3;27;.900;3578000;0
1547;86862;55;0;0;0;0;.00nan;0;0
1548;175912;57;56;5;0;5;1.000;589000;0
1548;180316;52;0;0;0;0;.00nan;0;0
1548;37857;52;55;19;2;17;.895;3600000;0
1548;57152;57;38;32;6;26;.813;3011000;0
1549;165582;64;92;43;2;41;.953;3600000;0
1549;168872;64;0;0;0;0;.00nan;0;0
1549;176136;45;0;0;0;0;.00nan;0;0
1549;141484;45;63;36;4;32;.889;3557000;0
1550;60773;37;0;0;0;0;.00nan;0;0
1550;79132;49;90;67;5;62;.925;3600000;0
1550;91225;49;0;0;0;0;.00nan;0;0
1550;141850;37;67;4;0;4;1.000;3600000;0
1551;176206;58;0;0;0;0;.00nan;0;0
1551;46780;58;73;52;5;47;.904;3576000;0
1551;58100;56;60;35;4;31;.886;3600000;0
1551;91398;56;0;0;0;0;.00nan;0;0
1552;501;42;80;24;2;22;.917;2612000;0
1552;37077;4837;0;0;0;0;.00nan;0;0
1552;47112;4837;64;33;3;30;.909;3600000;0
1552;141496;42;26;11;4;7;.636;988000;0
1553;168586;44;0;0;0;0;.00nan;0;0
1553;59239;43;0;0;0;0;.00nan;0;0
1553;64811;44;98;49;2;47;.959;3900000;0
1553;90164;43;88;31;2;29;.935;3900000;0
1554;180929;51;83;35;2;33;.943;3600000;0
1554;58054;59;45;20;3;17;.850;3600000;0
1554;69902;59;0;0;0;0;.00nan;0;0
1554;149455;51;0;0;0;0;.00nan;0;0
1555;168651;40;42;46;7;39;.848;3305000;0
1555;171673;50;72;31;3;28;.903;3600000;0
1555;68799;50;0;0;0;0;.00nan;0;0
1555;142492;40;55;4;0;4;1.000;295000;0
1556;162945;38;78;37;4;33;.892;3600000;0
1556;175084;65;0;0;0;0;.00nan;0;0
1556;38209;65;83;33;3;30;.909;3600000;0
1556;85428;38;0;0;0;0;.00nan;0;0
1557;171838;41;84;40;3;37;.925;3600000;0
1557;163462;55;0;0;0;0;.00nan;0;0
1557;170977;41;0;0;0;0;.00nan;0;0
1557;86862;55;71;17;1;16;.941;3600000;0
1558;173727;61;0;0;0;0;.00nan;0;0
1558;170598;54;0;0;0;0;.00nan;0;0
1558;57207;61;58;25;3;22;.880;3529000;0
1558;94615;54;100;43;1;42;.977;3600000;0
1559;164715;63;0;0;0;0;.00nan;0;0
1559;178413;39;73;26;3;23;.885;3600000;0
1559;85636;39;0;0;0;0;.00nan;0;0
1559;149584;63;79;47;4;43;.915;3565000;0
1560;176206;58;0;0;0;0;.00nan;0;0
1560;180929;51;43;32;6;26;.813;3600000;0
1560;46780;58;71;30;2;28;.933;3600000;0
1560;149455;51;0;0;0;0;.00nan;0;0
1561;58054;59;88;21;0;21;1.000;3600000;0
1561;58100;56;63;40;4;36;.900;3600000;0
1561;69902;59;0;0;0;0;.00nan;0;0
1561;91398;56;0;0;0;0;.00nan;0;0
1562;170294;60;75;18;0;18;1.000;2430000;0
1562;171608;46;56;7;1;6;.857;1196000;0
1562;68938;46;38;23;5;18;.783;2382000;0
1562;85797;60;28;14;4;10;.714;1170000;0
1563;170314;4619;54;43;6;37;.860;3316000;0
1563;38276;47;0;0;0;0;.00nan;0;0
1563;64800;4619;57;5;0;5;1.000;284000;0
1563;87798;47;73;33;3;30;.909;3600000;0
1564;175084;65;0;0;0;0;.00nan;0;0
1564;38209;65;72;42;4;38;.905;3563000;0
1564;58037;53;79;26;2;24;.923;3600000;0
1564;78581;53;0;0;0;0;.00nan;0;0
1565;178413;39;0;0;0;0;.00nan;0;0
1565;173699;36;39;1;1;0;.000;590000;0
1565;74734;36;71;58;6;52;.897;3010000;0
1565;85636;39;62;21;2;19;.905;3600000;0
1566;165582;64;77;40;3;37;.925;3759000;0
1566;168872;64;0;0;0;0;.00nan;0;0
1566;170598;54;0;0;0;0;.00nan;0;0
1566;94615;54;65;35;4;31;.886;3759000;0
1567;164715;63;0;0;0;0;.00nan;0;0
1567;59239;43;14;18;6;12;.667;2875000;0
1567;90164;43;52;6;1;5;.833;724000;0
1567;149584;63;65;56;6;50;.893;3600000;0
1568;171838;41;65;46;4;42;.913;3600000;0
1568;170977;41;0;0;0;0;.00nan;0;0
1568;58037;53;68;23;2;21;.913;3600000;0
1568;78581;53;0;0;0;0;.00nan;0;0
1569;168586;44;0;0;0;0;.00nan;0;0
1569;170294;60;0;0;0;0;.00nan;0;0
1569;64811;44;85;40;3;37;.925;3600000;0
1569;85797;60;40;22;4;18;.818;3586000;0
1570;163462;55;69;27;2;25;.926;3600000;0
1570;180929;51;0;0;0;0;.00nan;0;0
1570;86862;55;0;0;0;0;.00nan;0;0
1570;149455;51;67;32;3;29;.906;3600000;0
1571;60773;37;0;0;0;0;.00nan;0;0
1571;79132;49;0;0;0;0;.00nan;0;0
1571;91225;49;91;54;2;52;.963;3600000;0
1571;141850;37;52;17;3;14;.824;3559000;0
1572;162945;38;0;0;0;0;.00nan;0;0
1572;175912;57;0;0;0;0;.00nan;0;0
1572;57152;57;67;30;4;26;.867;3900000;0
1572;85428;38;100;54;4;50;.926;3900000;0
1573;168651;40;91;43;3;40;.930;3585000;0
1573;37077;4837;0;0;0;0;.00nan;0;0
1573;47112;4837;55;18;2;16;.889;3600000;0
1573;142492;40;0;0;0;0;.00nan;0;0
1574;164715;63;0;0;0;0;.00nan;0;0
1574;59239;43;0;0;0;0;.00nan;0;0
1574;90164;43;64;14;1;13;.929;3600000;0
1574;149584;63;87;50;3;47;.940;3574000;0
1575;501;42;0;0;0;0;.00nan;0;0
1575;171608;46;0;0;0;0;.00nan;0;0
1575;68938;46;89;30;1;29;.967;3600000;0
1575;141496;42;65;34;3;31;.912;3535000;0
1576;176206;58;0;0;0;0;.00nan;0;0
1576;46780;58;34;26;5;21;.808;3600000;0
1576;58037;53;0;0;0;0;.00nan;0;0
1576;78581;53;69;26;2;24;.923;3600000;0
1577;170314;4619;85;30;1;29;.967;3600000;0
1577;38276;47;0;0;0;0;.00nan;0;0
1577;64800;4619;0;0;0;0;.00nan;0;0
1577;87798;47;96;22;0;22;1.000;3600000;0
1578;175084;65;42;37;6;31;.838;3600000;0
1578;38209;65;0;0;0;0;.00nan;0;0
1578;58054;59;42;30;5;25;.833;3600000;0
1578;69902;59;0;0;0;0;.00nan;0;0
1579;168586;44;60;28;3;25;.893;3600000;0
1579;170294;60;63;35;4;31;.886;3561000;0
1579;64811;44;0;0;0;0;.00nan;0;0
1579;85797;60;0;0;0;0;.00nan;0;0
1580;163471;62;11;9;5;4;.444;555000;0
1580;170314;4619;0;0;0;0;.00nan;0;0
1580;36346;62;49;31;4;27;.871;3045000;0
1580;64800;4619;41;32;5;27;.844;3600000;0
1581;58100;56;99;43;2;41;.953;3600000;0
1581;59239;43;47;18;4;14;.778;3539000;0
1581;90164;43;0;0;0;0;.00nan;0;0
1581;91398;56;0;0;0;0;.00nan;0;0
1582;171838;41;65;33;3;30;.909;3900000;0
1582;173699;36;0;0;0;0;.00nan;0;0
1582;170977;41;0;0;0;0;.00nan;0;0
1582;74734;36;86;42;3;39;.929;3900000;0
1583;163462;55;0;0;0;0;.00nan;0;0
1583;180929;51;47;33;5;28;.848;3600000;0
1583;86862;55;60;20;2;18;.900;3600000;0
1583;149455;51;0;0;0;0;.00nan;0;0
1584;60773;37;63;14;1;13;.929;3600000;0
1584;79132;49;83;46;4;42;.913;3600000;0
1584;91225;49;0;0;0;0;.00nan;0;0
1584;141850;37;0;0;0;0;.00nan;0;0
1585;162945;38;0;0;0;0;.00nan;0;0
1585;58054;59;0;0;0;0;.00nan;0;0
1585;69902;59;42;23;4;19;.826;3552000;0
1585;85428;38;88;43;3;40;.930;3600000;0
1586;168651;40;91;32;2;30;.938;3572000;0
1586;37077;4837;0;0;0;0;.00nan;0;0
1586;47112;4837;79;22;1;21;.955;3600000;0
1586;142492;40;0;0;0;0;.00nan;0;0
1587;501;42;84;29;2;27;.931;3600000;0
1587;171608;46;53;32;4;28;.875;3562000;0
1587;68938;46;0;0;0;0;.00nan;0;0
1587;141496;42;0;0;0;0;.00nan;0;0
1588;170598;54;74;27;1;26;.963;1802000;0
1588;176136;45;0;0;0;0;.00nan;0;0
1588;94615;54;8;23;7;16;.696;1798000;0
1588;141484;45;69;16;1;15;.938;3600000;0
1589;176206;58;61;30;4;26;.867;3600000;0
1589;46780;58;0;0;0;0;.00nan;0;0
1589;58037;53;79;35;3;32;.914;3600000;0
1589;78581;53;0;0;0;0;.00nan;0;0
1590;165582;64;67;45;5;40;.889;3600000;0
1590;168872;64;0;0;0;0;.00nan;0;0
1590;171673;50;0;0;0;0;.00nan;0;0
1590;68799;50;66;30;3;27;.900;3600000;0
1591;178413;39;0;0;0;0;.00nan;0;0
1591;180316;52;0;0;0;0;.00nan;0;0
1591;37857;52;83;35;2;33;.943;3600000;0
1591;85636;39;52;36;5;31;.861;3600000;0
1592;172340;48;0;0;0;0;.00nan;0;0
1592;173727;61;52;46;7;39;.848;3600000;0
1592;57207;61;0;0;0;0;.00nan;0;0
1592;78775;48;56;20;2;18;.900;3600000;0
1593;175084;65;0;0;0;0;.00nan;0;0
1593;175912;57;74;36;3;33;.917;3562000;0
1593;38209;65;83;26;1;25;.962;3600000;0
1593;57152;57;0;0;0;0;.00nan;0;0
1594;171838;41;0;0;0;0;.00nan;0;0
1594;170977;41;48;44;6;38;.864;3600000;0
1594;176206;58;0;0;0;0;.00nan;0;0
1594;46780;58;56;16;2;14;.875;3600000;0
1595;165582;64;0;0;0;0;.00nan;0;0
1595;168872;64;61;21;2;19;.905;3600000;0
1595;170598;54;0;0;0;0;.00nan;0;0
1595;94615;54;60;31;4;27;.871;3546000;0
1596;175084;65;47;36;6;30;.833;2957000;0
1596;38209;65;52;4;0;4;1.000;643000;0
1596;58054;59;72;28;1;27;.964;3600000;0
1596;69902;59;0;0;0;0;.00nan;0;0
1597;178413;39;0;0;0;0;.00nan;0;0
1597;180316;52;0;0;0;0;.00nan;0;0
1597;37857;52;26;34;7;27;.794;3600000;0
1597;85636;39;76;36;3;33;.917;3600000;0
1598;168586;44;0;0;0;0;.00nan;0;0
1598;64811;44;100;20;0;20;1.000;3600000;0
1598;79132;49;97;55;2;53;.964;3600000;0
1598;91225;49;0;0;0;0;.00nan;0;0
1599;163471;62;0;0;0;0;.00nan;0;0
1599;36346;62;89;38;3;35;.921;3784000;0
1599;37077;4837;0;0;0;0;.00nan;0;0
1599;47112;4837;75;37;4;33;.892;3784000;0
1600;178413;39;86;24;1;23;.958;3600000;0
1600;176136;45;0;0;0;0;.00nan;0;0
1600;85636;39;0;0;0;0;.00nan;0;0
1600;141484;45;73;33;3;30;.909;3537000;0
1601;173727;61;70;32;3;29;.906;3600000;0
1601;38276;47;0;0;0;0;.00nan;0;0
1601;57207;61;0;0;0;0;.00nan;0;0
1601;87798;47;81;33;2;31;.939;3600000;0
1602;168586;44;0;0;0;0;.00nan;0;0
1602;64811;44;48;27;4;23;.852;3521000;0
1602;79132;49;0;0;0;0;.00nan;0;0
1602;91225;49;86;32;2;30;.938;3600000;0
1603;176136;45;82;43;3;40;.930;3600000;0
1603;58100;56;0;0;0;0;.00nan;0;0
1603;91398;56;70;24;2;22;.917;3600000;0
1603;141484;45;0;0;0;0;.00nan;0;0
1604;172340;48;66;28;2;26;.929;3600000;0
1604;170314;4619;97;57;3;54;.947;3546000;0
1604;64800;4619;0;0;0;0;.00nan;0;0
1604;78775;48;0;0;0;0;.00nan;0;0
1605;501;42;0;0;0;0;.00nan;0;0
1605;165582;64;79;38;4;34;.895;3600000;0
1605;168872;64;0;0;0;0;.00nan;0;0
1605;141496;42;74;20;1;19;.950;3600000;0
1606;164715;63;38;34;5;29;.853;2383000;0
1606;180316;52;0;0;0;0;.00nan;0;0
1606;37857;52;49;18;3;15;.833;3600000;0
1606;149584;63;47;13;2;11;.846;1217000;0
1607;168651;40;0;0;0;0;.00nan;0;0
1607;37077;4837;72;20;2;18;.900;3600000;0
1607;47112;4837;0;0;0;0;.00nan;0;0
1607;142492;40;65;37;4;33;.892;3563000;0
1608;175912;57;0;0;0;0;.00nan;0;0
1608;176206;58;0;0;0;0;.00nan;0;0
1608;46780;58;65;24;3;21;.875;3600000;0
1608;57152;57;44;32;5;27;.844;3557000;0
1609;178413;39;0;0;0;0;.00nan;0;0
1609;58100;56;37;35;6;29;.829;3600000;0
1609;85636;39;40;28;5;23;.821;3600000;0
1609;91398;56;0;0;0;0;.00nan;0;0
1610;171838;41;92;39;2;37;.949;3600000;0
1610;170977;41;0;0;0;0;.00nan;0;0
1610;180316;52;0;0;0;0;.00nan;0;0
1610;37857;52;78;24;1;23;.958;3600000;0
1611;180929;51;59;15;1;14;.933;994000;0
1611;60773;37;0;0;0;0;.00nan;0;0
1611;141850;37;90;30;1;29;.967;3600000;0
1611;149455;51;45;33;6;27;.818;2606000;0
1612;162945;38;98;51;3;48;.941;3554000;0
1612;175084;65;0;0;0;0;.00nan;0;0
1612;38209;65;94;28;1;27;.964;3600000;0
1612;85428;38;0;0;0;0;.00nan;0;0
1613;170314;4619;78;22;1;21;.955;3600000;0
1613;37077;4837;0;0;0;0;.00nan;0;0
1613;47112;4837;77;37;3;34;.919;3600000;0
1613;64800;4619;0;0;0;0;.00nan;0;0
1614;164715;63;0;0;0;0;.00nan;0;0
1614;59239;43;0;0;0;0;.00nan;0;0
1614;90164;43;71;27;2;25;.926;3591000;0
1614;149584;63;99;32;1;31;.969;3600000;0
1615;501;42;0;0;0;0;.00nan;0;0
1615;171673;50;62;21;2;19;.905;3600000;0
1615;68799;50;0;0;0;0;.00nan;0;0
1615;141496;42;71;39;3;36;.923;3573000;0
1616;168586;44;50;32;4;28;.875;3531000;0
1616;38276;47;0;0;0;0;.00nan;0;0
1616;64811;44;0;0;0;0;.00nan;0;0
1616;87798;47;81;34;2;32;.941;3600000;0
1617;163462;55;90;28;1;27;.964;3600000;0
1617;173699;36;85;41;3;38;.927;3553000;0
1617;74734;36;0;0;0;0;.00nan;0;0
1617;86862;55;0;0;0;0;.00nan;0;0
1618;170598;54;53;42;5;37;.881;3600000;0
1618;171608;46;0;0;0;0;.00nan;0;0
1618;68938;46;79;24;1;23;.958;3600000;0
1618;94615;54;0;0;0;0;.00nan;0;0
1619;163471;62;32;27;6;21;.778;3091000;0
1619;173727;61;89;25;1;24;.960;3600000;0
1619;36346;62;58;9;0;9;1.000;509000;0
1619;57207;61;0;0;0;0;.00nan;0;0
1620;178413;39;0;0;0;0;.00nan;0;0
1620;58100;56;0;0;0;0;.00nan;0;0
1620;85636;39;52;32;6;26;.813;3600000;0
1620;91398;56;93;33;1;32;.970;3600000;0
1621;170294;60;0;0;0;0;.00nan;0;0
1621;79132;49;88;38;2;36;.947;3555000;0
1621;85797;60;75;8;0;8;1.000;3600000;0
1621;91225;49;0;0;0;0;.00nan;0;0
1622;171838;41;53;26;3;23;.885;2466000;0
1622;170977;41;41;15;4;11;.733;1134000;0
1622;180316;52;65;19;1;18;.947;3600000;0
1622;37857;52;0;0;0;0;.00nan;0;0
1623;165582;64;82;28;1;27;.964;3900000;0
1623;168872;64;0;0;0;0;.00nan;0;0
1623;180929;51;93;36;1;35;.972;3900000;0
1623;149455;51;0;0;0;0;.00nan;0;0
1624;176206;58;0;0;0;0;.00nan;0;0
1624;46780;58;82;37;3;34;.919;3567000;0
1624;58054;59;67;19;1;18;.947;3600000;0
1624;69902;59;0;0;0;0;.00nan;0;0
1625;501;42;73;20;1;19;.950;3600000;0
1625;176136;45;0;0;0;0;.00nan;0;0
1625;141484;45;62;23;2;21;.913;3600000;0
1625;141496;42;0;0;0;0;.00nan;0;0
1626;171673;50;0;0;0;0;.00nan;0;0
1626;60773;37;100;33;1;32;.970;3600000;0
1626;68799;50;59;35;4;31;.886;3600000;0
1626;141850;37;0;0;0;0;.00nan;0;0
1627;172340;48;0;0;0;0;.00nan;0;0
1627;168651;40;88;55;4;51;.927;3526000;0
1627;78775;48;74;27;2;25;.926;3600000;0
1627;142492;40;0;0;0;0;.00nan;0;0
1628;175084;65;91;42;1;41;.976;3600000;0
1628;38209;65;0;0;0;0;.00nan;0;0
1628;58037;53;0;0;0;0;.00nan;0;0
1628;78581;53;63;32;3;29;.906;3583000;0
1629;163462;55;0;0;0;0;.00nan;0;0
1629;59239;43;0;0;0;0;.00nan;0;0
1629;86862;55;57;40;6;34;.850;3600000;0
1629;90164;43;44;20;3;17;.850;3600000;0
1630;170598;54;0;0;0;0;.00nan;0;0
1630;171608;46;58;22;2;20;.909;3820000;0
1630;68938;46;0;0;0;0;.00nan;0;0
1630;94615;54;100;44;1;43;.977;3820000;0
1631;163471;62;69;10;0;10;1.000;939000;0
1631;173727;61;0;0;0;0;.00nan;0;0
1631;36346;62;49;40;6;34;.850;2661000;0
1631;57207;61;42;24;5;19;.792;3600000;0
1632;164715;63;87;29;1;28;.966;3600000;0
1632;173699;36;86;37;2;35;.946;3121000;0
1632;74734;36;25;6;3;3;.500;479000;0
1632;149584;63;0;0;0;0;.00nan;0;0
1633;162945;38;0;0;0;0;.00nan;0;0
1633;175912;57;0;0;0;0;.00nan;0;0
1633;57152;57;85;31;1;30;.968;3600000;0
1633;85428;38;88;38;2;36;.947;3572000;0
1634;170294;60;44;22;3;19;.864;3600000;0
1634;79132;49;59;34;4;30;.882;3000000;0
1634;85797;60;0;0;0;0;.00nan;0;0
1634;91225;49;44;14;3;11;.786;600000;0
1635;37077;4837;56;7;0;7;1.000;894000;0
1635;38276;47;0;0;0;0;.00nan;0;0
1635;47112;4837;43;29;6;23;.793;2706000;0
1635;87798;47;61;25;3;22;.880;3600000;0
1636;175912;57;66;33;3;30;.909;3544000;0
1636;176206;58;79;36;2;34;.944;3600000;0
1636;46780;58;0;0;0;0;.00nan;0;0
1636;57152;57;0;0;0;0;.00nan;0;0
1637;162945;38;36;31;5;26;.839;3600000;0
1637;58054;59;0;0;0;0;.00nan;0;0
1637;69902;59;67;17;2;15;.882;3600000;0
1637;85428;38;0;0;0;0;.00nan;0;0
1638;168586;44;0;0;0;0;.00nan;0;0
1638;170314;4619;90;36;2;34;.944;3600000;0
1638;64800;4619;0;0;0;0;.00nan;0;0
1638;64811;44;41;32;5;27;.844;3600000;0
1639;175084;65;0;0;0;0;.00nan;0;0
1639;38209;65;98;51;3;48;.941;3514000;0
1639;58037;53;75;29;1;28;.966;3600000;0
1639;78581;53;0;0;0;0;.00nan;0;0
1640;172340;48;67;19;2;17;.895;3600000;0
1640;168651;40;86;37;2;35;.946;3008000;0
1640;78775;48;0;0;0;0;.00nan;0;0
1640;142492;40;35;11;3;8;.727;592000;0
1641;172340;48;0;0;0;0;.00nan;0;0
1641;168586;44;0;0;0;0;.00nan;0;0
1641;64811;44;85;41;3;38;.927;3600000;0
1641;78775;48;87;19;0;19;1.000;3600000;0
1642;180929;51;0;0;0;0;.00nan;0;0
1642;60773;37;0;0;0;0;.00nan;0;0
1642;141850;37;66;15;1;14;.933;3600000;0
1642;149455;51;72;44;4;40;.909;3600000;0
1643;173699;36;0;0;0;0;.00nan;0;0
1643;59239;43;84;30;1;29;.967;3600000;0
1643;74734;36;74;45;4;41;.911;3600000;0
1643;90164;43;0;0;0;0;.00nan;0;0
1644;163462;55;46;26;4;22;.846;3525000;0
1644;164715;63;0;0;0;0;.00nan;0;0
1644;86862;55;0;0;0;0;.00nan;0;0
1644;149584;63;79;33;2;31;.939;3600000;0
1645;175912;57;0;0;0;0;.00nan;0;0
1645;57152;57;66;28;4;24;.857;3600000;0
1645;58037;53;41;37;6;31;.838;3568000;0
1645;78581;53;0;0;0;0;.00nan;0;0
1646;501;42;0;0;0;0;.00nan;0;0
1646;176136;45;0;0;0;0;.00nan;0;0
1646;141484;45;86;32;2;30;.938;3605000;0
1646;141496;42;85;22;1;21;.955;3605000;0
1647;168586;44;0;0;0;0;.00nan;0;0
1647;37077;4837;0;0;0;0;.00nan;0;0
1647;47112;4837;88;13;0;13;1.000;3600000;0
1647;64811;44;44;35;5;30;.857;3600000;0
1648;168651;40;95;32;1;31;.969;3900000;0
1648;170294;60;0;0;0;0;.00nan;0;0
1648;85797;60;74;20;1;19;.950;3900000;0
1648;142492;40;0;0;0;0;.00nan;0;0
1649;180316;52;0;0;0;0;.00nan;0;0
1649;37857;52;54;35;5;30;.857;3600000;0
1649;38276;47;0;0;0;0;.00nan;0;0
1649;87798;47;91;34;1;33;.971;3600000;0
1650;180929;51;81;39;2;37;.949;3600000;0
1650;58037;53;41;23;4;19;.826;3540000;0
1650;78581;53;0;0;0;0;.00nan;0;0
1650;149455;51;0;0;0;0;.00nan;0;0
1651;170314;4619;54;20;3;17;.850;3600000;0
1651;64800;4619;0;0;0;0;.00nan;0;0
1651;79132;49;73;39;4;35;.897;3553000;0
1651;91225;49;0;0;0;0;.00nan;0;0
1652;178413;39;0;0;0;0;.00nan;0;0
1652;59239;43;0;0;0;0;.00nan;0;0
1652;85636;39;65;38;4;34;.895;3600000;0
1652;90164;43;74;23;1;22;.957;3600000;0
1653;162945;38;0;0;0;0;.00nan;0;0
1653;58054;59;65;18;1;17;.944;3600000;0
1653;69902;59;0;0;0;0;.00nan;0;0
1653;85428;38;85;38;2;36;.947;3561000;0
1654;164715;63;59;35;4;31;.886;3809000;0
1654;173699;36;62;31;3;28;.903;3809000;0
1654;74734;36;0;0;0;0;.00nan;0;0
1654;149584;63;0;0;0;0;.00nan;0;0
1655;175084;65;0;0;0;0;.00nan;0;0
1655;38209;65;72;24;1;23;.958;3600000;0
1655;58100;56;32;34;6;28;.824;2814000;0
1655;91398;56;57;4;0;4;1.000;786000;0
1656;165582;64;100;41;1;40;.976;3600000;0
1656;168872;64;0;0;0;0;.00nan;0;0
1656;173727;61;37;19;4;15;.789;3600000;0
1656;57207;61;0;0;0;0;.00nan;0;0
1657;175912;57;0;0;0;0;.00nan;0;0
1657;176206;58;0;0;0;0;.00nan;0;0
1657;46780;58;77;35;2;33;.943;3600000;0
1657;57152;57;52;25;3;22;.880;3576000;0
1658;168586;44;65;34;3;31;.912;3559000;0
1658;37077;4837;0;0;0;0;.00nan;0;0
1658;47112;4837;74;30;2;28;.933;3600000;0
1658;64811;44;0;0;0;0;.00nan;0;0
1659;172340;48;0;0;0;0;.00nan;0;0
1659;163471;62;72;37;4;33;.892;3558000;0
1659;36346;62;0;0;0;0;.00nan;0;0
1659;78775;48;67;24;2;22;.917;3600000;0
1660;180316;52;87;42;3;39;.929;3540000;0
1660;37857;52;0;0;0;0;.00nan;0;0
1660;38276;47;0;0;0;0;.00nan;0;0
1660;87798;47;82;27;1;26;.963;3600000;0
1661;180929;51;0;0;0;0;.00nan;0;0
1661;58037;53;0;0;0;0;.00nan;0;0
1661;78581;53;43;17;3;14;.824;3804000;0
1661;149455;51;73;40;4;36;.900;3804000;0
1662;170314;4619;0;0;0;0;.00nan;0;0
1662;64800;4619;64;33;3;30;.909;3600000;0
1662;79132;49;0;0;0;0;.00nan;0;0
1662;91225;49;61;38;4;34;.895;3559000;0
1663;171838;41;53;30;5;25;.833;3511000;0
1663;170977;41;0;0;0;0;.00nan;0;0
1663;176206;58;60;28;3;25;.893;3600000;0
1663;46780;58;0;0;0;0;.00nan;0;0
1664;501;42;0;0;0;0;.00nan;0;0
1664;170598;54;0;0;0;0;.00nan;0;0
1664;94615;54;59;27;3;24;.889;3600000;0
1664;141496;42;96;39;1;38;.974;3600000;0
1665;178413;39;72;33;3;30;.909;3574000;0
1665;59239;43;0;0;0;0;.00nan;0;0
1665;85636;39;0;0;0;0;.00nan;0;0
1665;90164;43;90;35;2;33;.943;3600000;0
1666;171608;46;67;22;2;20;.909;3600000;0
1666;171673;50;58;33;4;29;.879;3534000;0
1666;68799;50;0;0;0;0;.00nan;0;0
1666;68938;46;0;0;0;0;.00nan;0;0
1667;176136;45;71;51;5;46;.902;3600000;0
1667;60773;37;0;0;0;0;.00nan;0;0
1667;141484;45;0;0;0;0;.00nan;0;0
1667;141850;37;59;12;1;11;.917;3600000;0
1668;175084;65;61;35;4;31;.886;3600000;0
1668;38209;65;0;0;0;0;.00nan;0;0
1668;58054;59;0;0;0;0;.00nan;0;0
1668;69902;59;80;26;1;25;.962;3600000;0
1669;163462;55;0;0;0;0;.00nan;0;0
1669;164715;63;0;0;0;0;.00nan;0;0
1669;86862;55;62;20;3;17;.850;3900000;0
1669;149584;63;95;51;3;48;.941;3900000;0
1670;165582;64;62;34;4;30;.882;3563000;0
1670;168872;64;0;0;0;0;.00nan;0;0
1670;173727;61;0;0;0;0;.00nan;0;0
1670;57207;61;75;31;3;28;.903;3600000;0
1671;162945;38;70;28;2;26;.929;3600000;0
1671;173699;36;68;26;3;23;.885;3600000;0
1671;74734;36;0;0;0;0;.00nan;0;0
1671;85428;38;0;0;0;0;.00nan;0;0
1672;175912;57;82;42;3;39;.929;3900000;0
1672;57152;57;0;0;0;0;.00nan;0;0
1672;58100;56;0;0;0;0;.00nan;0;0
1672;91398;56;69;25;3;22;.880;3900000;0
1673;171838;41;0;0;0;0;.00nan;0;0
1673;170977;41;69;31;3;28;.903;3900000;0
1673;175084;65;0;0;0;0;.00nan;0;0
1673;38209;65;78;38;3;35;.921;3900000;0
1674;168651;40;0;0;0;0;.00nan;0;0
1674;170294;60;0;0;0;0;.00nan;0;0
1674;85797;60;82;26;1;25;.962;3702000;0
1674;142492;40;92;42;2;40;.952;3702000;0
1675;501;42;58;30;3;27;.900;3900000;0
1675;170598;54;86;40;3;37;.925;3900000;0
1675;94615;54;0;0;0;0;.00nan;0;0
1675;141496;42;0;0;0;0;.00nan;0;0
1676;171608;46;0;0;0;0;.00nan;0;0
1676;171673;50;0;0;0;0;.00nan;0;0
1676;68799;50;26;18;5;13;.722;3539000;0
1676;68938;46;59;27;3;24;.889;3600000;0
1677;37077;4837;0;0;0;0;.00nan;0;0
1677;47112;4837;96;22;0;22;1.000;3600000;0
1677;79132;49;72;46;4;42;.913;3600000;0
1677;91225;49;0;0;0;0;.00nan;0;0
1678;163462;55;0;0;0;0;.00nan;0;0
1678;58100;56;0;0;0;0;.00nan;0;0
1678;86862;55;71;31;3;28;.903;3600000;0
1678;91398;56;100;32;0;32;1.000;3600000;0
1679;172340;48;50;21;3;18;.857;3572000;0
1679;38276;47;0;0;0;0;.00nan;0;0
1679;78775;48;0;0;0;0;.00nan;0;0
1679;87798;47;97;33;1;32;.970;3600000;0
1680;37077;4837;0;0;0;0;.00nan;0;0
1680;47112;4837;48;17;3;14;.824;3600000;0
1680;79132;49;0;0;0;0;.00nan;0;0
1680;91225;49;76;45;4;41;.911;3595000;0
1681;178413;39;0;0;0;0;.00nan;0;0
1681;176136;45;92;49;3;46;.939;3600000;0
1681;85636;39;46;23;4;19;.826;3551000;0
1681;141484;45;0;0;0;0;.00nan;0;0
1682;173727;61;72;35;4;31;.886;3900000;0
1682;170314;4619;73;47;4;43;.915;3900000;0
1682;57207;61;0;0;0;0;.00nan;0;0
1682;64800;4619;0;0;0;0;.00nan;0;0
1683;170598;54;0;0;0;0;.00nan;0;0
1683;171673;50;54;27;3;24;.889;3600000;0
1683;68799;50;0;0;0;0;.00nan;0;0
1683;94615;54;71;41;4;37;.902;3570000;0
1684;175084;65;0;0;0;0;.00nan;0;0
1684;38209;65;81;43;3;40;.930;3900000;0
1684;58054;59;92;45;3;42;.933;3900000;0
1684;69902;59;0;0;0;0;.00nan;0;0
1685;163471;62;76;42;4;38;.905;3600000;0
1685;168586;44;0;0;0;0;.00nan;0;0
1685;36346;62;0;0;0;0;.00nan;0;0
1685;64811;44;48;21;3;18;.857;3600000;0
1686;180929;51;49;27;4;23;.852;3600000;0
1686;58100;56;51;20;3;17;.850;3600000;0
1686;91398;56;0;0;0;0;.00nan;0;0
1686;149455;51;0;0;0;0;.00nan;0;0
1687;171838;41;90;40;2;38;.950;3600000;0
1687;162945;38;0;0;0;0;.00nan;0;0
1687;170977;41;0;0;0;0;.00nan;0;0
1687;85428;38;82;38;3;35;.921;3556000;0
1688;178413;39;0;0;0;0;.00nan;0;0
1688;60773;37;0;0;0;0;.00nan;0;0
1688;85636;39;75;38;4;34;.895;3554000;0
1688;141850;37;61;24;3;21;.875;3600000;0
1689;173727;61;0;0;0;0;.00nan;0;0
1689;170314;4619;81;42;3;39;.929;3552000;0
1689;57207;61;75;30;2;28;.933;3600000;0
1689;64800;4619;0;0;0;0;.00nan;0;0
1690;175084;65;0;0;0;0;.00nan;0;0
1690;38209;65;54;33;4;29;.879;3543000;0
1690;58037;53;0;0;0;0;.00nan;0;0
1690;78581;53;89;43;3;40;.930;3600000;0
1691;164715;63;71;19;1;18;.947;3600000;0
1691;173699;36;0;0;0;0;.00nan;0;0
1691;74734;36;57;55;7;48;.873;3600000;0
1691;149584;63;0;0;0;0;.00nan;0;0
1692;501;42;0;0;0;0;.00nan;0;0
1692;171673;50;97;21;0;21;1.000;3600000;0
1692;68799;50;0;0;0;0;.00nan;0;0
1692;141496;42;78;46;4;42;.913;3600000;0
1693;170294;60;0;0;0;0;.00nan;0;0
1693;38276;47;0;0;0;0;.00nan;0;0
1693;85797;60;100;42;3;39;.929;3900000;0
1693;87798;47;65;21;3;18;.857;3900000;0
1694;168651;40;70;29;2;27;.931;3900000;0
1694;180316;52;0;0;0;0;.00nan;0;0
1694;37857;52;89;33;2;31;.939;3900000;0
1694;142492;40;0;0;0;0;.00nan;0;0
1695;163462;55;0;0;0;0;.00nan;0;0
1695;175912;57;10;26;7;19;.731;3180000;0
1695;57152;57;43;5;1;4;.800;420000;0
1695;86862;55;76;25;2;23;.920;3600000;0
1696;170598;54;0;0;0;0;.00nan;0;0
1696;176136;45;0;0;0;0;.00nan;0;0
1696;94615;54;58;27;4;23;.852;3555000;0
1696;141484;45;78;37;3;34;.919;3600000;0
1697;163471;62;25;33;7;26;.788;3111000;0
1697;168586;44;0;0;0;0;.00nan;0;0
1697;36346;62;42;3;1;2;.667;489000;0
1697;64811;44;72;18;1;17;.944;3600000;0
1698;171838;41;0;0;0;0;.00nan;0;0
1698;170977;41;53;34;5;29;.853;3600000;0
1698;175084;65;77;31;2;29;.935;3600000;0
1698;38209;65;0;0;0;0;.00nan;0;0
1699;501;42;0;0;0;0;.00nan;0;0
1699;165582;64;94;42;2;40;.952;3755000;0
1699;168872;64;0;0;0;0;.00nan;0;0
1699;141496;42;66;30;3;27;.900;3755000;0
1700;172340;48;0;0;0;0;.00nan;0;0
1700;170294;60;37;25;4;21;.840;3600000;0
1700;78775;48;63;21;1;20;.952;3600000;0
1700;85797;60;0;0;0;0;.00nan;0;0
1701;178413;39;89;48;2;46;.958;3900000;0
1701;60773;37;74;25;2;23;.920;3900000;0
1701;85636;39;0;0;0;0;.00nan;0;0
1701;141850;37;0;0;0;0;.00nan;0;0
1702;162945;38;68;34;3;31;.912;3600000;0
1702;58037;53;67;19;1;18;.947;3600000;0
1702;78581;53;0;0;0;0;.00nan;0;0
1702;85428;38;0;0;0;0;.00nan;0;0
1703;176206;58;0;0;0;0;.00nan;0;0
1703;46780;58;83;38;2;36;.947;3600000;0
1703;58054;59;82;31;1;30;.968;3600000;0
1703;69902;59;0;0;0;0;.00nan;0;0
1704;38276;47;0;0;0;0;.00nan;0;0
1704;79132;49;99;51;1;50;.980;3600000;0
1704;87798;47;46;10;2;8;.800;3571000;0
1704;91225;49;0;0;0;0;.00nan;0;0
1705;170598;54;54;35;5;30;.857;3554000;0
1705;176136;45;61;24;3;21;.875;3600000;0
1705;94615;54;0;0;0;0;.00nan;0;0
1705;141484;45;0;0;0;0;.00nan;0;0
1706;164715;63;0;0;0;0;.00nan;0;0
1706;173699;36;100;40;0;40;1.000;3600000;0
1706;74734;36;0;0;0;0;.00nan;0;0
1706;149584;63;52;33;5;28;.848;3600000;0
1707;163462;55;71;29;3;26;.897;3582000;0
1707;175912;57;0;0;0;0;.00nan;0;0
1707;57152;57;80;27;1;26;.963;3600000;0
1707;86862;55;0;0;0;0;.00nan;0;0
1708;180929;51;0;0;0;0;.00nan;0;0
1708;58100;56;0;0;0;0;.00nan;0;0
1708;91398;56;49;25;4;21;.840;3568000;0
1708;149455;51;93;48;3;45;.938;3600000;0
1709;165582;64;0;0;0;0;.00nan;0;0
1709;168872;64;100;62;4;58;.935;3600000;0
1709;171673;50;35;28;6;22;.786;3342000;0
1709;68799;50;42;3;1;2;.667;258000;0
1710;172340;48;39;21;4;17;.810;3545000;0
1710;173727;61;60;27;3;24;.889;3600000;0
1710;57207;61;0;0;0;0;.00nan;0;0
1710;78775;48;0;0;0;0;.00nan;0;0
1711;176206;58;97;48;2;46;.958;3600000;0
1711;46780;58;0;0;0;0;.00nan;0;0
1711;58054;59;90;25;1;24;.960;3600000;0
1711;69902;59;0;0;0;0;.00nan;0;0
1712;171608;46;0;0;0;0;.00nan;0;0
1712;59239;43;0;0;0;0;.00nan;0;0
1712;68938;46;66;30;4;26;.867;3600000;0
1712;90164;43;80;31;2;29;.935;3600000;0
1713;170314;4619;89;36;2;34;.944;3700000;0
1713;64800;4619;0;0;0;0;.00nan;0;0
1713;79132;49;0;0;0;0;.00nan;0;0
1713;91225;49;73;30;3;27;.900;3700000;0
1714;162945;38;0;0;0;0;.00nan;0;0
1714;58037;53;0;0;0;0;.00nan;0;0
1714;78581;53;75;23;1;22;.957;3600000;0
1714;85428;38;69;45;5;40;.889;3600000;0
1715;168651;40;81;47;4;43;.915;3525000;0
1715;180316;52;0;0;0;0;.00nan;0;0
1715;37857;52;89;33;2;31;.939;3600000;0
1715;142492;40;0;0;0;0;.00nan;0;0
1716;171608;46;78;26;1;25;.962;3600000;0
1716;59239;43;0;0;0;0;.00nan;0;0
1716;68938;46;0;0;0;0;.00nan;0;0
1716;90164;43;73;36;4;32;.889;3579000;0
1717;171838;41;60;32;4;28;.875;3569000;0
1717;163462;55;63;20;2;18;.900;3600000;0
1717;170977;41;0;0;0;0;.00nan;0;0
1717;86862;55;0;0;0;0;.00nan;0;0
1718;163471;62;98;60;4;56;.933;3600000;0
1718;170294;60;0;0;0;0;.00nan;0;0
1718;36346;62;0;0;0;0;.00nan;0;0
1718;85797;60;96;37;2;35;.946;3600000;0
1719;163471;62;0;0;0;0;.00nan;0;0
1719;170294;60;0;0;0;0;.00nan;0;0
1719;36346;62;82;42;3;39;.929;3600000;0
1719;85797;60;91;19;0;19;1.000;3600000;0
1720;165582;64;82;47;3;44;.936;3600000;0
1720;168872;64;0;0;0;0;.00nan;0;0
1720;60773;37;0;0;0;0;.00nan;0;0
1720;141850;37;76;10;0;10;1.000;3600000;0
1721;162945;38;85;32;2;30;.938;3558000;0
1721;175084;65;0;0;0;0;.00nan;0;0
1721;38209;65;94;20;0;20;1.000;3600000;0
1721;85428;38;0;0;0;0;.00nan;0;0
1722;172340;48;0;0;0;0;.00nan;0;0
1722;37077;4837;0;0;0;0;.00nan;0;0
1722;47112;4837;85;38;3;35;.921;3900000;0
1722;78775;48;65;32;3;29;.906;3900000;0
1723;58100;56;50;35;5;30;.857;3900000;0
1723;59239;43;25;11;4;7;.636;998000;0
1723;90164;43;70;20;1;19;.950;2902000;0
1723;91398;56;0;0;0;0;.00nan;0;0
1724;180316;52;83;31;1;30;.968;3900000;0
1724;37857;52;0;0;0;0;.00nan;0;0
1724;38276;47;0;0;0;0;.00nan;0;0
1724;87798;47;100;39;1;38;.974;3900000;0
1725;175912;57;0;0;0;0;.00nan;0;0
1725;176206;58;42;24;4;20;.833;3516000;0
1725;46780;58;0;0;0;0;.00nan;0;0
1725;57152;57;74;28;2;26;.929;3600000;0
1726;164715;63;45;30;5;25;.833;2885000;0
1726;180929;51;68;49;5;44;.898;3600000;0
1726;149455;51;0;0;0;0;.00nan;0;0
1726;149584;63;19;8;4;4;.500;715000;0
1727;171608;46;0;0;0;0;.00nan;0;0
1727;58100;56;0;0;0;0;.00nan;0;0
1727;68938;46;81;32;2;30;.938;3600000;0
1727;91398;56;64;28;3;25;.893;3599000;0
1728;168586;44;0;0;0;0;.00nan;0;0
1728;37077;4837;0;0;0;0;.00nan;0;0
1728;47112;4837;91;29;1;28;.966;3600000;0
1728;64811;44;44;45;7;38;.844;3600000;0
1729;171838;41;82;48;3;45;.938;3600000;0
1729;170977;41;0;0;0;0;.00nan;0;0
1729;176206;58;0;0;0;0;.00nan;0;0
1729;46780;58;100;21;0;21;1.000;3600000;0
1730;58054;59;72;32;4;28;.875;3600000;0
1730;59239;43;0;0;0;0;.00nan;0;0
1730;69902;59;0;0;0;0;.00nan;0;0
1730;90164;43;34;28;5;23;.821;3548000;0
1731;170294;60;0;0;0;0;.00nan;0;0
1731;170314;4619;52;31;5;26;.839;3540000;0
1731;64800;4619;0;0;0;0;.00nan;0;0
1731;85797;60;69;26;3;23;.885;3600000;0
1732;175912;57;0;0;0;0;.00nan;0;0
1732;57152;57;71;47;6;41;.872;3600000;0
1732;58037;53;0;0;0;0;.00nan;0;0
1732;78581;53;59;23;3;20;.870;3600000;0
1733;171673;50;54;23;3;20;.870;3615000;0
1733;176136;45;88;49;4;45;.918;3615000;0
1733;68799;50;0;0;0;0;.00nan;0;0
1733;141484;45;0;0;0;0;.00nan;0;0
1734;180316;52;0;0;0;0;.00nan;0;0
1734;37857;52;67;37;3;34;.919;3550000;0
1734;38276;47;0;0;0;0;.00nan;0;0
1734;87798;47;82;29;2;27;.931;3600000;0
1735;168651;40;68;14;1;13;.929;3600000;0
1735;79132;49;84;48;3;45;.938;3578000;0
1735;91225;49;0;0;0;0;.00nan;0;0
1735;142492;40;0;0;0;0;.00nan;0;0
1736;173699;36;82;31;2;29;.935;3900000;0
1736;175084;65;0;0;0;0;.00nan;0;0
1736;38209;65;82;32;2;30;.938;3900000;0
1736;74734;36;0;0;0;0;.00nan;0;0
1737;162945;38;0;0;0;0;.00nan;0;0
1737;163462;55;0;0;0;0;.00nan;0;0
1737;85428;38;92;43;3;40;.930;3600000;0
1737;86862;55;95;25;0;25;1.000;3600000;0
1738;170598;54;59;36;4;32;.889;2971000;0
1738;60773;37;0;0;0;0;.00nan;0;0
1738;94615;54;19;9;4;5;.556;629000;0
1738;141850;37;57;10;1;9;.900;3600000;0
1739;172340;48;54;20;3;17;.850;3900000;0
1739;173727;61;96;62;3;59;.952;3900000;0
1739;57207;61;0;0;0;0;.00nan;0;0
1739;78775;48;0;0;0;0;.00nan;0;0
1740;58054;59;80;24;1;23;.958;3600000;0
1740;58100;56;81;42;3;39;.929;3579000;0
1740;69902;59;0;0;0;0;.00nan;0;0
1740;91398;56;0;0;0;0;.00nan;0;0
1741;171838;41;0;0;0;0;.00nan;0;0
1741;170977;41;61;37;5;32;.865;3827000;0
1741;176206;58;0;0;0;0;.00nan;0;0
1741;46780;58;57;27;4;23;.852;3827000;0
1742;164715;63;64;10;0;10;1.000;1401000;0
1742;180929;51;81;25;1;24;.960;3600000;0
1742;149455;51;0;0;0;0;.00nan;0;0
1742;149584;63;29;26;5;21;.808;2199000;0
1743;162945;38;89;41;3;38;.927;3600000;0
1743;163462;55;0;0;0;0;.00nan;0;0
1743;85428;38;0;0;0;0;.00nan;0;0
1743;86862;55;37;21;4;17;.810;3560000;0
1744;168586;44;83;28;1;27;.964;3600000;0
1744;37077;4837;71;28;2;26;.929;3561000;0
1744;47112;4837;0;0;0;0;.00nan;0;0
1744;64811;44;0;0;0;0;.00nan;0;0
1745;501;42;63;35;4;31;.886;3562000;0
1745;171673;50;0;0;0;0;.00nan;0;0
1745;68799;50;52;23;3;20;.870;3600000;0
1745;141496;42;0;0;0;0;.00nan;0;0
1746;165582;64;60;28;3;25;.893;3727000;0
1746;168872;64;0;0;0;0;.00nan;0;0
1746;176136;45;0;0;0;0;.00nan;0;0
1746;141484;45;83;45;4;41;.911;3771000;0
1747;175912;57;58;31;5;26;.839;3585000;0
1747;57152;57;0;0;0;0;.00nan;0;0
1747;58037;53;59;26;3;23;.885;3600000;0
1747;78581;53;0;0;0;0;.00nan;0;0
1748;168651;40;0;0;0;0;.00nan;0;0
1748;79132;49;0;0;0;0;.00nan;0;0
1748;91225;49;62;43;5;38;.884;3554000;0
1748;142492;40;41;23;4;19;.826;3600000;0
1749;170598;54;0;0;0;0;.00nan;0;0
1749;60773;37;49;5;1;4;.800;3600000;0
1749;94615;54;80;43;3;40;.930;3575000;0
1749;141850;37;0;0;0;0;.00nan;0;0
1750;178413;39;0;0;0;0;.00nan;0;0
1750;171608;46;31;17;4;13;.765;782000;0
1750;68938;46;64;23;2;21;.913;2818000;0
1750;85636;39;82;39;2;37;.949;3600000;0
1751;172340;48;0;0;0;0;.00nan;0;0
1751;173727;61;0;0;0;0;.00nan;0;0
1751;57207;61;77;20;1;19;.950;3600000;0
1751;78775;48;87;50;4;46;.920;3600000;0
1752;173699;36;0;0;0;0;.00nan;0;0
1752;59239;43;59;21;3;18;.857;3900000;0
1752;74734;36;97;50;3;47;.940;3900000;0
1752;90164;43;0;0;0;0;.00nan;0;0
1753;171838;41;97;40;2;38;.950;3900000;0
1753;170977;41;0;0;0;0;.00nan;0;0
1753;58037;53;0;0;0;0;.00nan;0;0
1753;78581;53;66;20;2;18;.900;3900000;0
1754;165582;64;75;26;2;24;.923;3600000;0
1754;168872;64;0;0;0;0;.00nan;0;0
1754;176136;45;63;47;6;41;.872;3600000;0
1754;141484;45;0;0;0;0;.00nan;0;0
1755;501;42;0;0;0;0;.00nan;0;0
1755;171673;50;79;31;2;29;.935;3544000;0
1755;68799;50;0;0;0;0;.00nan;0;0
1755;141496;42;78;24;1;23;.958;3600000;0
1756;170294;60;0;0;0;0;.00nan;0;0
1756;170314;4619;92;50;3;47;.940;3900000;0
1756;64800;4619;0;0;0;0;.00nan;0;0
1756;85797;60;55;23;3;20;.870;3900000;0
1757;178413;39;100;32;0;32;1.000;3600000;0
1757;171608;46;65;34;4;30;.882;3600000;0
1757;68938;46;0;0;0;0;.00nan;0;0
1757;85636;39;0;0;0;0;.00nan;0;0
1758;180316;52;0;0;0;0;.00nan;0;0
1758;180929;51;94;45;3;42;.933;3600000;0
1758;37857;52;27;24;5;19;.792;3520000;0
1758;149455;51;0;0;0;0;.00nan;0;0
1759;163471;62;72;50;5;45;.900;3900000;0
1759;36346;62;0;0;0;0;.00nan;0;0
1759;37077;4837;0;0;0;0;.00nan;0;0
1759;47112;4837;28;20;5;15;.750;3900000;0
1760;173727;61;0;0;0;0;.00nan;0;0
1760;170294;60;0;0;0;0;.00nan;0;0
1760;57207;61;54;27;3;24;.889;3888000;0
1760;85797;60;66;35;4;31;.886;3888000;0
1761;172340;48;68;22;2;20;.909;3600000;0
1761;170314;4619;74;40;4;36;.900;3600000;0
1761;64800;4619;0;0;0;0;.00nan;0;0
1761;78775;48;0;0;0;0;.00nan;0;0
1762;168651;40;78;44;3;41;.932;3595000;0
1762;38276;47;0;0;0;0;.00nan;0;0
1762;87798;47;88;30;2;28;.933;3600000;0
1762;142492;40;0;0;0;0;.00nan;0;0
1763;178413;39;73;46;4;42;.913;3600000;0
1763;58054;59;100;24;0;24;1.000;3600000;0
1763;69902;59;0;0;0;0;.00nan;0;0
1763;85636;39;0;0;0;0;.00nan;0;0
1764;173727;61;58;28;4;24;.857;3512000;0
1764;170294;60;0;0;0;0;.00nan;0;0
1764;57207;61;0;0;0;0;.00nan;0;0
1764;85797;60;77;34;2;32;.941;3600000;0
1765;180316;52;0;0;0;0;.00nan;0;0
1765;180929;51;73;52;6;46;.885;3600000;0
1765;37857;52;61;29;3;26;.897;3600000;0
1765;149455;51;0;0;0;0;.00nan;0;0
1766;162945;38;0;0;0;0;.00nan;0;0
1766;58037;53;70;32;3;29;.906;3728000;0
1766;78581;53;0;0;0;0;.00nan;0;0
1766;85428;38;80;27;2;25;.926;3728000;0
1767;175912;57;0;0;0;0;.00nan;0;0
1767;176206;58;0;0;0;0;.00nan;0;0
1767;46780;58;68;25;2;23;.920;3600000;0
1767;57152;57;45;43;7;36;.837;3600000;0
1768;501;42;0;0;0;0;.00nan;0;0
1768;176136;45;0;0;0;0;.00nan;0;0
1768;141484;45;100;39;1;38;.974;3900000;0
1768;141496;42;82;21;1;20;.952;3900000;0
1769;164715;63;98;49;3;46;.939;3869000;0
1769;59239;43;0;0;0;0;.00nan;0;0
1769;90164;43;57;22;3;19;.864;3900000;0
1769;149584;63;0;0;0;0;.00nan;0;0
1770;171608;46;0;0;0;0;.00nan;0;0
1770;171673;50;77;21;1;20;.952;3600000;0
1770;68799;50;0;0;0;0;.00nan;0;0
1770;68938;46;70;33;3;30;.909;3530000;0
1771;171838;41;0;0;0;0;.00nan;0;0
1771;170977;41;61;32;4;28;.875;3600000;0
1771;175084;65;0;0;0;0;.00nan;0;0
1771;38209;65;78;29;2;27;.931;3600000;0
1772;163462;55;0;0;0;0;.00nan;0;0
1772;173699;36;77;48;4;44;.917;3600000;0
1772;74734;36;0;0;0;0;.00nan;0;0
1772;86862;55;74;19;1;18;.947;3600000;0
1773;175912;57;0;0;0;0;.00nan;0;0
1773;180316;52;0;0;0;0;.00nan;0;0
1773;37857;52;61;24;3;21;.875;3900000;0
1773;57152;57;83;42;3;39;.929;3900000;0
1774;178413;39;0;0;0;0;.00nan;0;0
1774;180929;51;39;27;6;21;.778;3600000;0
1774;85636;39;55;13;2;11;.846;3600000;0
1774;149455;51;0;0;0;0;.00nan;0;0
1775;170598;54;0;0;0;0;.00nan;0;0
1775;79132;49;49;30;4;26;.867;3900000;0
1775;91225;49;0;0;0;0;.00nan;0;0
1775;94615;54;84;54;4;50;.926;3900000;0
1776;171608;46;0;0;0;0;.00nan;0;0
1776;60773;37;0;0;0;0;.00nan;0;0
1776;68938;46;92;30;1;29;.967;3600000;0
1776;141850;37;55;32;4;28;.875;3600000;0
1777;58037;53;76;33;3;30;.909;3600000;0
1777;58054;59;100;30;0;30;1.000;3600000;0
1777;69902;59;0;0;0;0;.00nan;0;0
1777;78581;53;0;0;0;0;.00nan;0;0
1778;164715;63;99;44;2;42;.955;3600000;0
1778;59239;43;0;0;0;0;.00nan;0;0
1778;90164;43;29;16;4;12;.750;3550000;0
1778;149584;63;0;0;0;0;.00nan;0;0
1779;171673;50;59;20;2;18;.900;3600000;0
1779;176136;45;70;47;5;42;.894;3600000;0
1779;68799;50;0;0;0;0;.00nan;0;0
1779;141484;45;0;0;0;0;.00nan;0;0
1780;165582;64;96;38;2;36;.947;3600000;0
1780;168872;64;0;0;0;0;.00nan;0;0
1780;38276;47;0;0;0;0;.00nan;0;0
1780;87798;47;78;32;3;29;.906;3543000;0
1781;168651;40;83;38;2;36;.947;3600000;0
1781;170314;4619;46;28;5;23;.821;3600000;0
1781;64800;4619;0;0;0;0;.00nan;0;0
1781;142492;40;0;0;0;0;.00nan;0;0
1782;162945;38;0;0;0;0;.00nan;0;0
1782;175084;65;0;0;0;0;.00nan;0;0
1782;38209;65;73;36;3;33;.917;3600000;0
1782;85428;38;64;44;5;39;.886;3585000;0
1783;163462;55;70;22;2;20;.909;3600000;0
1783;173699;36;0;0;0;0;.00nan;0;0
1783;74734;36;35;38;6;32;.842;3600000;0
1783;86862;55;0;0;0;0;.00nan;0;0
1784;172340;48;0;0;0;0;.00nan;0;0
1784;163471;62;99;54;3;51;.944;3600000;0
1784;36346;62;0;0;0;0;.00nan;0;0
1784;78775;48;11;19;6;13;.684;3600000;0
1785;171838;41;89;56;3;53;.946;3584000;0
1785;170977;41;0;0;0;0;.00nan;0;0
1785;58037;53;0;0;0;0;.00nan;0;0
1785;78581;53;68;26;2;24;.923;3600000;0
1786;168586;44;0;0;0;0;.00nan;0;0
1786;170294;60;0;0;0;0;.00nan;0;0
1786;64811;44;75;45;5;40;.889;3600000;0
1786;85797;60;50;36;6;30;.833;3542000;0
1787;175912;57;53;31;4;27;.871;3547000;0
1787;180316;52;84;38;3;35;.921;3600000;0
1787;37857;52;0;0;0;0;.00nan;0;0
1787;57152;57;0;0;0;0;.00nan;0;0
1788;170598;54;0;0;0;0;.00nan;0;0
1788;79132;49;0;0;0;0;.00nan;0;0
1788;91225;49;83;28;1;27;.964;3600000;0
1788;94615;54;39;32;5;27;.844;3600000;0
1789;162945;38;72;20;1;19;.950;3600000;0
1789;58100;56;62;32;3;29;.906;3567000;0
1789;85428;38;0;0;0;0;.00nan;0;0
1789;91398;56;0;0;0;0;.00nan;0;0
1790;173727;61;57;30;3;27;.900;3559000;0
1790;37077;4837;0;0;0;0;.00nan;0;0
1790;47112;4837;70;24;2;22;.917;3600000;0
1790;57207;61;0;0;0;0;.00nan;0;0
1791;501;42;0;0;0;0;.00nan;0;0
1791;176206;58;0;0;0;0;.00nan;0;0
1791;46780;58;65;37;4;33;.892;3890000;0
1791;141496;42;46;21;3;18;.857;3890000;0
1792;164715;63;0;0;0;0;.00nan;0;0
1792;58054;59;0;0;0;0;.00nan;0;0
1792;69902;59;89;16;0;16;1.000;3600000;0
1792;149584;63;41;37;6;31;.838;3600000;0
1793;171673;50;0;0;0;0;.00nan;0;0
1793;176136;45;0;0;0;0;.00nan;0;0
1793;68799;50;69;15;1;14;.933;3600000;0
1793;141484;45;92;64;2;62;.969;3570000;0
1794;165582;64;95;44;1;43;.977;3900000;0
1794;168872;64;0;0;0;0;.00nan;0;0
1794;38276;47;76;18;1;17;.944;3900000;0
1794;87798;47;0;0;0;0;.00nan;0;0
1795;168651;40;0;0;0;0;.00nan;0;0
1795;170314;4619;26;21;5;16;.762;3546000;0
1795;64800;4619;0;0;0;0;.00nan;0;0
1795;142492;40;74;43;4;39;.907;3600000;0
1796;173699;36;94;42;2;40;.952;3600000;0
1796;175084;65;26;5;3;2;.400;467000;0
1796;38209;65;62;23;3;20;.870;3133000;0
1796;74734;36;0;0;0;0;.00nan;0;0
1797;163462;55;0;0;0;0;.00nan;0;0
1797;59239;43;49;21;3;18;.857;3600000;0
1797;86862;55;47;31;4;27;.871;3571000;0
1797;90164;43;0;0;0;0;.00nan;0;0
1798;171838;41;0;0;0;0;.00nan;0;0
1798;170977;41;82;47;4;43;.915;3568000;0
1798;58100;56;0;0;0;0;.00nan;0;0
1798;91398;56;66;25;2;23;.920;3600000;0
1799;168586;44;67;34;4;30;.882;3633000;0
1799;170294;60;0;0;0;0;.00nan;0;0
1799;64811;44;0;0;0;0;.00nan;0;0
1799;85797;60;55;25;3;22;.880;3633000;0
1800;171608;46;0;0;0;0;.00nan;0;0
1800;60773;37;0;0;0;0;.00nan;0;0
1800;68938;46;54;40;6;34;.850;3600000;0
1800;141850;37;67;16;1;15;.938;3600000;0
1801;173727;61;0;0;0;0;.00nan;0;0
1801;37077;4837;39;23;4;19;.826;3600000;0
1801;47112;4837;0;0;0;0;.00nan;0;0
1801;57207;61;78;27;1;26;.963;3600000;0
1802;501;42;78;20;1;19;.950;3600000;0
1802;176206;58;69;47;5;42;.894;3600000;0
1802;46780;58;0;0;0;0;.00nan;0;0
1802;141496;42;0;0;0;0;.00nan;0;0
1803;178413;39;6;21;7;14;.667;3600000;0
1803;180929;51;100;52;3;49;.942;3600000;0
1803;85636;39;0;0;0;0;.00nan;0;0
1803;149455;51;0;0;0;0;.00nan;0;0
1804;173727;61;85;38;3;35;.921;3600000;0
1804;170314;4619;58;44;6;38;.864;3600000;0
1804;57207;61;0;0;0;0;.00nan;0;0
1804;64800;4619;0;0;0;0;.00nan;0;0
1805;172340;48;79;35;2;33;.943;3600000;0
1805;168651;40;69;31;3;28;.903;3600000;0
1805;78775;48;0;0;0;0;.00nan;0;0
1805;142492;40;0;0;0;0;.00nan;0;0
1806;165582;64;73;26;2;24;.923;3600000;0
1806;168872;64;0;0;0;0;.00nan;0;0
1806;60773;37;0;0;0;0;.00nan;0;0
1806;141850;37;59;33;4;29;.879;3559000;0
1807;163471;62;97;48;3;45;.938;3600000;0
1807;36346;62;0;0;0;0;.00nan;0;0
1807;37077;4837;0;0;0;0;.00nan;0;0
1807;47112;4837;43;35;6;29;.829;3600000;0
1808;170598;54;0;0;0;0;.00nan;0;0
1808;38276;47;0;0;0;0;.00nan;0;0
1808;87798;47;53;14;2;12;.857;3600000;0
1808;94615;54;91;54;4;50;.926;3583000;0
1809;173699;36;0;0;0;0;.00nan;0;0
1809;58100;56;100;25;0;25;1.000;3600000;0
1809;74734;36;65;32;3;29;.906;3600000;0
1809;91398;56;0;0;0;0;.00nan;0;0
1810;175912;57;0;0;0;0;.00nan;0;0
1810;176206;58;0;0;0;0;.00nan;0;0
1810;46780;58;74;46;5;41;.891;3872000;0
1810;57152;57;83;37;4;33;.892;3872000;0
1811;168586;44;26;8;3;5;.625;491000;0
1811;59239;43;0;0;0;0;.00nan;0;0
1811;64811;44;41;34;6;28;.824;3109000;0
1811;90164;43;64;35;4;31;.886;3600000;0
1812;163471;62;35;23;5;18;.783;3600000;0
1812;170598;54;66;7;0;7;1.000;772000;0
1812;36346;62;0;0;0;0;.00nan;0;0
1812;94615;54;32;31;6;25;.806;2776000;0
1813;164715;63;74;39;4;35;.897;3900000;0
1813;58100;56;80;38;4;34;.895;3900000;0
1813;91398;56;0;0;0;0;.00nan;0;0
1813;149584;63;0;0;0;0;.00nan;0;0
1814;176206;58;0;0;0;0;.00nan;0;0
1814;180316;52;0;0;0;0;.00nan;0;0
1814;37857;52;68;15;1;14;.933;3600000;0
1814;46780;58;49;46;6;40;.870;3600000;0
1815;501;42;0;0;0;0;.00nan;0;0
1815;79132;49;69;34;3;31;.912;3575000;0
1815;91225;49;0;0;0;0;.00nan;0;0
1815;141496;42;91;24;1;23;.958;3600000;0
1816;176136;45;67;30;3;27;.900;3557000;0
1816;60773;37;0;0;0;0;.00nan;0;0
1816;141484;45;0;0;0;0;.00nan;0;0
1816;141850;37;50;16;2;14;.875;3600000;0
1817;162945;38;0;0;0;0;.00nan;0;0
1817;58054;59;0;0;0;0;.00nan;0;0
1817;69902;59;78;11;0;11;1.000;3600000;0
1817;85428;38;98;71;5;66;.930;3600000;0
1818;170294;60;0;0;0;0;.00nan;0;0
1818;37077;4837;0;0;0;0;.00nan;0;0
1818;47112;4837;37;32;5;27;.844;3600000;0
1818;85797;60;60;28;3;25;.893;3600000;0
1819;171608;46;84;35;3;32;.914;3556000;0
1819;171673;50;66;26;2;24;.923;3600000;0
1819;68799;50;0;0;0;0;.00nan;0;0
1819;68938;46;0;0;0;0;.00nan;0;0
1820;172340;48;100;31;0;31;1.000;3600000;0
1820;170314;4619;95;32;1;31;.969;3544000;0
1820;64800;4619;0;0;0;0;.00nan;0;0
1820;78775;48;0;0;0;0;.00nan;0;0
1821;171838;41;87;48;4;44;.917;3821000;0
1821;170977;41;0;0;0;0;.00nan;0;0
1821;58037;53;38;26;5;21;.808;3821000;0
1821;78581;53;0;0;0;0;.00nan;0;0
1822;175084;65;0;0;0;0;.00nan;0;0
1822;175912;57;0;0;0;0;.00nan;0;0
1822;38209;65;72;33;2;31;.939;3600000;0
1822;57152;57;69;44;5;39;.886;3600000;0
1823;163462;55;48;28;5;23;.821;3600000;0
1823;178413;39;32;34;6;28;.824;3545000;0
1823;85636;39;0;0;0;0;.00nan;0;0
1823;86862;55;0;0;0;0;.00nan;0;0
1824;168651;40;99;50;3;47;.940;3600000;0
1824;173727;61;55;35;5;30;.857;3600000;0
1824;57207;61;0;0;0;0;.00nan;0;0
1824;142492;40;0;0;0;0;.00nan;0;0
1825;168586;44;68;33;3;30;.909;3600000;0
1825;59239;43;43;34;5;29;.853;3600000;0
1825;64811;44;0;0;0;0;.00nan;0;0
1825;90164;43;0;0;0;0;.00nan;0;0
1826;163471;62;56;26;3;23;.885;3679000;0
1826;170598;54;62;32;4;28;.875;3679000;0
1826;36346;62;0;0;0;0;.00nan;0;0
1826;94615;54;0;0;0;0;.00nan;0;0
1827;164715;63;0;0;0;0;.00nan;0;0
1827;58100;56;60;26;3;23;.885;3099000;0
1827;91398;56;24;5;3;2;.400;430000;0
1827;149584;63;64;41;4;37;.902;3600000;0
1828;171838;41;98;44;2;42;.955;3600000;0
1828;170977;41;0;0;0;0;.00nan;0;0
1828;58037;53;0;0;0;0;.00nan;0;0
1828;78581;53;80;12;0;12;1.000;3600000;0
1829;176206;58;81;37;4;33;.892;3573000;0
1829;180316;52;78;37;3;34;.919;3600000;0
1829;37857;52;0;0;0;0;.00nan;0;0
1829;46780;58;0;0;0;0;.00nan;0;0
1830;165582;64;100;46;1;45;.978;3900000;0
1830;168872;64;0;0;0;0;.00nan;0;0
1830;38276;47;0;0;0;0;.00nan;0;0
1830;87798;47;83;30;1;29;.967;3900000;0
1831;173699;36;37;18;4;14;.778;3524000;0
1831;180929;51;0;0;0;0;.00nan;0;0
1831;74734;36;0;0;0;0;.00nan;0;0
1831;149455;51;76;27;2;25;.926;3600000;0
1832;172340;48;83;30;2;28;.933;3600000;0
1832;170314;4619;0;0;0;0;.00nan;0;0
1832;64800;4619;58;38;5;33;.868;3600000;0
1832;78775;48;0;0;0;0;.00nan;0;0
1833;501;42;73;18;1;17;.944;3600000;0
1833;79132;49;0;0;0;0;.00nan;0;0
1833;91225;49;49;42;5;37;.881;3600000;0
1833;141496;42;0;0;0;0;.00nan;0;0
1834;162945;38;72;48;5;43;.896;3600000;0
1834;58054;59;66;21;2;19;.905;3600000;0
1834;69902;59;0;0;0;0;.00nan;0;0
1834;85428;38;0;0;0;0;.00nan;0;0
1835;176136;45;0;0;0;0;.00nan;0;0
1835;60773;37;0;0;0;0;.00nan;0;0
1835;141484;45;100;44;1;43;.977;3600000;0
1835;141850;37;52;24;3;21;.875;3570000;0
1836;163462;55;0;0;0;0;.00nan;0;0
1836;178413;39;0;0;0;0;.00nan;0;0
1836;85636;39;56;29;4;25;.862;3600000;0
1836;86862;55;90;28;1;27;.964;3600000;0
1837;168651;40;0;0;0;0;.00nan;0;0
1837;173727;61;0;0;0;0;.00nan;0;0
1837;57207;61;57;12;1;11;.917;3600000;0
1837;142492;40;78;41;4;37;.902;3600000;0
1838;175084;65;74;29;3;26;.897;3600000;0
1838;175912;57;60;40;4;36;.900;3600000;0
1838;38209;65;0;0;0;0;.00nan;0;0
1838;57152;57;0;0;0;0;.00nan;0;0
1839;165582;64;70;23;2;21;.913;3900000;0
1839;168872;64;0;0;0;0;.00nan;0;0
1839;38276;47;100;40;2;38;.950;3900000;0
1839;87798;47;0;0;0;0;.00nan;0;0
1840;173699;36;0;0;0;0;.00nan;0;0
1840;180929;51;89;26;1;25;.962;3600000;0
1840;74734;36;69;41;4;37;.902;3600000;0
1840;149455;51;0;0;0;0;.00nan;0;0
1841;170294;60;0;0;0;0;.00nan;0;0
1841;37077;4837;0;0;0;0;.00nan;0;0
1841;47112;4837;98;30;0;30;1.000;3600000;0
1841;85797;60;44;28;5;23;.821;3600000;0
1842;171608;46;0;0;0;0;.00nan;0;0
1842;171673;50;97;19;0;19;1.000;3600000;0
1842;68799;50;0;0;0;0;.00nan;0;0
1842;68938;46;65;29;2;27;.931;3523000;0
1843;58037;53;0;0;0;0;.00nan;0;0
1843;58054;59;0;0;0;0;.00nan;0;0
1843;69902;59;88;37;2;35;.946;3569000;0
1843;78581;53;75;21;1;20;.952;3600000;0
1844;501;42;0;0;0;0;.00nan;0;0
1844;171673;50;82;12;0;12;1.000;3600000;0
1844;68799;50;0;0;0;0;.00nan;0;0
1844;141496;42;80;42;3;39;.929;3600000;0
1845;178413;39;0;0;0;0;.00nan;0;0
1845;60773;37;0;0;0;0;.00nan;0;0
1845;85636;39;71;39;4;35;.897;3600000;0
1845;141850;37;66;16;1;15;.938;3600000;0
1846;162945;38;0;0;0;0;.00nan;0;0
1846;180929;51;56;23;3;20;.870;3562000;0
1846;85428;38;76;23;1;22;.957;3600000;0
1846;149455;51;0;0;0;0;.00nan;0;0
1847;58100;56;98;46;3;43;.935;3900000;0
1847;59239;43;0;0;0;0;.00nan;0;0
1847;90164;43;62;22;3;19;.864;3900000;0
1847;91398;56;0;0;0;0;.00nan;0;0
1848;176136;45;88;48;3;45;.938;3900000;0
1848;38276;47;0;0;0;0;.00nan;0;0
1848;87798;47;59;16;3;13;.813;3900000;0
1848;141484;45;0;0;0;0;.00nan;0;0
1849;170314;4619;87;15;0;15;1.000;3600000;0
1849;37077;4837;0;0;0;0;.00nan;0;0
1849;47112;4837;69;32;3;29;.906;3600000;0
1849;64800;4619;0;0;0;0;.00nan;0;0
1850;172340;48;51;28;4;24;.857;3560000;0
1850;168586;44;0;0;0;0;.00nan;0;0
1850;64811;44;84;40;3;37;.925;3600000;0
1850;78775;48;0;0;0;0;.00nan;0;0
1851;58100;56;32;32;6;26;.813;2480000;0
1851;60773;37;0;0;0;0;.00nan;0;0
1851;91398;56;42;9;2;7;.778;1120000;0
1851;141850;37;68;20;1;19;.950;3600000;0
1852;170294;60;0;0;0;0;.00nan;0;0
1852;171608;46;0;0;0;0;.00nan;0;0
1852;68938;46;100;31;0;31;1.000;3600000;0
1852;85797;60;50;42;6;36;.857;3600000;0
1853;173727;61;72;17;1;16;.941;3600000;0
1853;57207;61;0;0;0;0;.00nan;0;0
1853;79132;49;97;47;2;45;.957;3600000;0
1853;91225;49;0;0;0;0;.00nan;0;0
1854;501;42;0;0;0;0;.00nan;0;0
1854;176136;45;47;9;1;8;.889;1143000;0
1854;141484;45;49;37;6;31;.838;2457000;0
1854;141496;42;95;26;0;26;1.000;3600000;0
1855;162945;38;0;0;0;0;.00nan;0;0
1855;59239;43;47;18;3;15;.833;3600000;0
1855;85428;38;58;40;4;36;.900;3600000;0
1855;90164;43;0;0;0;0;.00nan;0;0
1856;58037;53;0;0;0;0;.00nan;0;0
1856;58054;59;97;29;1;28;.966;3900000;0
1856;69902;59;0;0;0;0;.00nan;0;0
1856;78581;53;93;29;1;28;.966;3900000;0
1857;163471;62;75;56;6;50;.893;3584000;0
1857;170314;4619;55;25;4;21;.840;3600000;0
1857;36346;62;0;0;0;0;.00nan;0;0
1857;64800;4619;0;0;0;0;.00nan;0;0
1858;164715;63;63;42;5;37;.881;3600000;0
1858;180316;52;0;0;0;0;.00nan;0;0
1858;37857;52;64;34;3;31;.912;3600000;0
1858;149584;63;0;0;0;0;.00nan;0;0
1859;171673;50;56;32;5;27;.844;3600000;0
1859;38276;47;0;0;0;0;.00nan;0;0
1859;68799;50;0;0;0;0;.00nan;0;0
1859;87798;47;85;29;2;27;.931;3600000;0
1860;168651;40;86;42;3;39;.929;3600000;0
1860;37077;4837;0;0;0;0;.00nan;0;0
1860;47112;4837;43;27;4;23;.852;3563000;0
1860;142492;40;0;0;0;0;.00nan;0;0
1861;163462;55;0;0;0;0;.00nan;0;0
1861;176206;58;0;0;0;0;.00nan;0;0
1861;46780;58;58;32;4;28;.875;3600000;0
1861;86862;55;100;34;0;34;1.000;3600000;0
1862;165582;64;22;23;6;17;.739;2370000;0
1862;168872;64;60;7;0;7;1.000;1230000;0
1862;170598;54;0;0;0;0;.00nan;0;0
1862;94615;54;70;38;3;35;.921;3600000;0
1863;171838;41;97;38;2;36;.947;3586000;0
1863;173699;36;70;25;1;24;.960;3600000;0
1863;170977;41;0;0;0;0;.00nan;0;0
1863;74734;36;0;0;0;0;.00nan;0;0
1864;175912;57;0;0;0;0;.00nan;0;0
1864;180929;51;90;44;2;42;.955;3600000;0
1864;57152;57;98;22;0;22;1.000;3600000;0
1864;149455;51;0;0;0;0;.00nan;0;0
1865;172340;48;0;0;0;0;.00nan;0;0
1865;168586;44;75;33;2;31;.939;3600000;0
1865;64811;44;0;0;0;0;.00nan;0;0
1865;78775;48;34;28;5;23;.821;3600000;0
1866;163471;62;0;0;0;0;.00nan;0;0
1866;170314;4619;68;31;3;28;.903;3626000;0
1866;36346;62;74;37;4;33;.892;3626000;0
1866;64800;4619;0;0;0;0;.00nan;0;0
1867;58100;56;0;0;0;0;.00nan;0;0
1867;60773;37;100;39;1;38;.974;3900000;0
1867;91398;56;96;31;1;30;.968;3900000;0
1867;141850;37;0;0;0;0;.00nan;0;0
1868;173727;61;0;0;0;0;.00nan;0;0
1868;57207;61;72;23;2;21;.913;3600000;0
1868;79132;49;0;0;0;0;.00nan;0;0
1868;91225;49;90;48;4;44;.917;3551000;0
1869;176206;58;68;38;4;34;.895;3578000;0
1869;180929;51;0;0;0;0;.00nan;0;0
1869;46780;58;0;0;0;0;.00nan;0;0
1869;149455;51;64;24;3;21;.875;3600000;0
1870;501;42;0;0;0;0;.00nan;0;0
1870;176136;45;0;0;0;0;.00nan;0;0
1870;141484;45;91;54;4;50;.926;3562000;0
1870;141496;42;68;23;2;21;.913;3600000;0
1871;162945;38;76;35;2;33;.943;3600000;0
1871;59239;43;0;0;0;0;.00nan;0;0
1871;85428;38;0;0;0;0;.00nan;0;0
1871;90164;43;91;29;1;28;.966;3600000;0
1872;180316;52;68;34;3;31;.912;3546000;0
1872;37857;52;0;0;0;0;.00nan;0;0
1872;58054;59;0;0;0;0;.00nan;0;0
1872;69902;59;74;30;2;28;.933;3600000;0
1873;171673;50;0;0;0;0;.00nan;0;0
1873;38276;47;0;0;0;0;.00nan;0;0
1873;68799;50;62;46;6;40;.870;3562000;0
1873;87798;47;42;26;4;22;.846;3600000;0
1874;168651;40;0;0;0;0;.00nan;0;0
1874;37077;4837;89;36;1;35;.972;3900000;0
1874;47112;4837;0;0;0;0;.00nan;0;0
1874;142492;40;77;31;1;30;.968;3900000;0
1875;171838;41;80;48;4;44;.917;3600000;0
1875;170977;41;0;0;0;0;.00nan;0;0
1875;175084;65;0;0;0;0;.00nan;0;0
1875;38209;65;61;17;1;16;.941;3600000;0
1876;163462;55;0;0;0;0;.00nan;0;0
1876;173699;36;0;0;0;0;.00nan;0;0
1876;74734;36;77;33;2;31;.939;3600000;0
1876;86862;55;37;19;4;15;.789;3600000;0
1877;165582;64;45;21;4;17;.810;3900000;0
1877;168872;64;0;0;0;0;.00nan;0;0
1877;170598;54;71;44;4;40;.909;3900000;0
1877;94615;54;0;0;0;0;.00nan;0;0
1878;175912;57;60;37;4;33;.892;3853000;0
1878;57152;57;0;0;0;0;.00nan;0;0
1878;58037;53;0;0;0;0;.00nan;0;0
1878;78581;53;49;32;5;27;.844;3853000;0
1879;170294;60;0;0;0;0;.00nan;0;0
1879;171608;46;0;0;0;0;.00nan;0;0
1879;68938;46;73;34;3;31;.912;3600000;0
1879;85797;60;84;18;0;18;1.000;3600000;0
1880;176206;58;0;0;0;0;.00nan;0;0
1880;180316;52;0;0;0;0;.00nan;0;0
1880;37857;52;16;30;7;23;.767;3600000;0
1880;46780;58;65;23;2;21;.913;3600000;0
1881;178413;39;64;39;4;35;.897;3670000;0
1881;60773;37;0;0;0;0;.00nan;0;0
1881;85636;39;0;0;0;0;.00nan;0;0
1881;141850;37;45;31;5;26;.839;3670000;0
1882;163462;55;82;22;1;21;.955;3600000;0
1882;173699;36;78;26;1;25;.962;1530000;0
1882;74734;36;48;30;4;26;.867;2070000;0
1882;86862;55;0;0;0;0;.00nan;0;0
1883;163471;62;19;7;4;3;.429;814000;0
1883;36346;62;80;22;1;21;.955;3086000;0
1883;79132;49;63;44;5;39;.886;3900000;0
1883;91225;49;0;0;0;0;.00nan;0;0
1884;501;42;73;23;2;21;.913;3600000;0
1884;165582;64;61;39;5;34;.872;3564000;0
1884;168872;64;0;0;0;0;.00nan;0;0
1884;141496;42;0;0;0;0;.00nan;0;0
1885;172340;48;62;31;4;27;.871;3583000;0
1885;168586;44;0;0;0;0;.00nan;0;0
1885;64811;44;72;34;3;31;.912;3600000;0
1885;78775;48;0;0;0;0;.00nan;0;0
1886;170598;54;0;0;0;0;.00nan;0;0
1886;60773;37;0;0;0;0;.00nan;0;0
1886;94615;54;73;53;5;48;.906;3600000;0
1886;141850;37;55;10;1;9;.900;3600000;0
1887;176206;58;0;0;0;0;.00nan;0;0
1887;46780;58;77;43;4;39;.907;3600000;0
1887;58037;53;0;0;0;0;.00nan;0;0
1887;78581;53;90;26;1;25;.962;3600000;0
1888;180316;52;0;0;0;0;.00nan;0;0
1888;37857;52;99;43;2;41;.953;3851000;0
1888;58054;59;63;23;3;20;.870;3859000;0
1888;69902;59;0;0;0;0;.00nan;0;0
1889;170314;4619;81;25;1;24;.960;3600000;0
1889;37077;4837;0;0;0;0;.00nan;0;0
1889;47112;4837;93;44;2;42;.955;3580000;0
1889;64800;4619;0;0;0;0;.00nan;0;0
1890;164715;63;0;0;0;0;.00nan;0;0
1890;175084;65;0;0;0;0;.00nan;0;0
1890;38209;65;61;29;3;26;.897;3900000;0
1890;149584;63;77;37;3;34;.919;3900000;0
1891;163462;55;0;0;0;0;.00nan;0;0
1891;175912;57;0;0;0;0;.00nan;0;0
1891;57152;57;70;28;2;26;.929;3569000;0
1891;86862;55;98;21;0;21;1.000;3600000;0
1892;180929;51;84;41;3;38;.927;3572000;0
1892;58100;56;0;0;0;0;.00nan;0;0
1892;91398;56;56;16;2;14;.875;3600000;0
1892;149455;51;0;0;0;0;.00nan;0;0
1893;171838;41;80;36;4;32;.889;3547000;0
1893;170977;41;0;0;0;0;.00nan;0;0
1893;180316;52;0;0;0;0;.00nan;0;0
1893;37857;52;68;34;3;31;.912;3600000;0
1894;180929;51;0;0;0;0;.00nan;0;0
1894;58100;56;47;19;3;16;.842;3600000;0
1894;91398;56;0;0;0;0;.00nan;0;0
1894;149455;51;83;50;4;46;.920;3557000;0
1895;170598;54;0;0;0;0;.00nan;0;0
1895;60773;37;0;0;0;0;.00nan;0;0
1895;94615;54;73;48;5;43;.896;3600000;0
1895;141850;37;82;13;0;13;1.000;3600000;0
1896;162945;38;52;3;0;3;1.000;947000;0
1896;164715;63;60;40;5;35;.875;3600000;0
1896;85428;38;26;26;6;20;.769;2637000;0
1896;149584;63;0;0;0;0;.00nan;0;0
1897;58054;59;74;24;2;22;.917;3600000;0
1897;59239;43;0;0;0;0;.00nan;0;0
1897;69902;59;0;0;0;0;.00nan;0;0
1897;90164;43;66;27;3;24;.889;3570000;0
1898;171608;46;44;35;5;30;.857;3600000;0
1898;176136;45;100;48;1;47;.979;3600000;0
1898;68938;46;0;0;0;0;.00nan;0;0
1898;141484;45;0;0;0;0;.00nan;0;0
1899;178413;39;0;0;0;0;.00nan;0;0
1899;58037;53;0;0;0;0;.00nan;0;0
1899;78581;53;48;29;5;24;.828;3600000;0
1899;85636;39;91;32;1;31;.969;3600000;0
1900;501;42;55;5;0;5;1.000;1076000;0
1900;171673;50;68;21;2;19;.905;3600000;0
1900;68799;50;0;0;0;0;.00nan;0;0
1900;141496;42;42;34;6;28;.824;2524000;0
1901;168651;40;72;34;3;31;.912;3600000;0
1901;170294;60;0;0;0;0;.00nan;0;0
1901;85797;60;48;26;4;22;.846;3548000;0
1901;142492;40;0;0;0;0;.00nan;0;0
1902;168586;44;0;0;0;0;.00nan;0;0
1902;173727;61;92;48;4;44;.917;3900000;0
1902;57207;61;0;0;0;0;.00nan;0;0
1902;64811;44;57;32;4;28;.875;3900000;0
1903;173699;36;89;50;3;47;.940;3559000;0
1903;175912;57;0;0;0;0;.00nan;0;0
1903;57152;57;66;22;2;20;.909;3600000;0
1903;74734;36;0;0;0;0;.00nan;0;0
1904;171838;41;92;64;5;59;.922;3731000;0
1904;170977;41;0;0;0;0;.00nan;0;0
1904;180316;52;48;23;4;19;.826;3731000;0
1904;37857;52;0;0;0;0;.00nan;0;0
1905;165582;64;62;29;4;25;.862;3630000;0
1905;168872;64;0;0;0;0;.00nan;0;0
1905;170598;54;80;38;3;35;.921;3630000;0
1905;94615;54;0;0;0;0;.00nan;0;0
1906;172340;48;0;0;0;0;.00nan;0;0
1906;163471;62;70;66;7;59;.894;3600000;0
1906;36346;62;0;0;0;0;.00nan;0;0
1906;78775;48;64;17;1;16;.941;3600000;0
1907;176206;58;85;39;3;36;.923;3600000;0
1907;46780;58;0;0;0;0;.00nan;0;0
1907;59239;43;54;30;4;26;.867;3546000;0
1907;90164;43;0;0;0;0;.00nan;0;0
1908;175084;65;0;0;0;0;.00nan;0;0
1908;38209;65;65;45;5;40;.889;3600000;0
1908;58054;59;73;25;2;23;.920;3600000;0
1908;69902;59;0;0;0;0;.00nan;0;0
1909;170314;4619;63;22;2;20;.909;3768000;0
1909;64800;4619;0;0;0;0;.00nan;0;0
1909;79132;49;94;58;3;55;.948;3768000;0
1909;91225;49;0;0;0;0;.00nan;0;0
1910;501;42;0;0;0;0;.00nan;0;0
1910;171673;50;0;0;0;0;.00nan;0;0
1910;68799;50;77;29;2;27;.931;3600000;0
1910;141496;42;67;30;3;27;.900;3533000;0
1911;37077;4837;0;0;0;0;.00nan;0;0
1911;38276;47;51;6;1;5;.833;3600000;0
1911;47112;4837;97;56;3;53;.946;3567000;0
1911;87798;47;0;0;0;0;.00nan;0;0
1912;168651;40;0;0;0;0;.00nan;0;0
1912;170294;60;0;0;0;0;.00nan;0;0
1912;85797;60;56;22;3;19;.864;3900000;0
1912;142492;40;77;41;3;38;.927;3900000;0
1913;168586;44;64;32;4;28;.875;3655000;0
1913;173727;61;0;0;0;0;.00nan;0;0
1913;57207;61;63;38;5;33;.868;3655000;0
1913;64811;44;0;0;0;0;.00nan;0;0
1914;163462;55;0;0;0;0;.00nan;0;0
1914;173699;36;0;0;0;0;.00nan;0;0
1914;74734;36;96;41;2;39;.951;3586000;0
1914;86862;55;79;22;1;21;.955;3600000;0
1915;164715;63;0;0;0;0;.00nan;0;0
1915;175912;57;0;0;0;0;.00nan;0;0
1915;57152;57;100;28;0;28;1.000;3600000;0
1915;149584;63;56;28;4;24;.857;3600000;0
1916;165582;64;0;0;0;0;.00nan;0;0
1916;168872;64;50;31;4;27;.871;3547000;0
1916;171673;50;79;29;2;27;.931;3600000;0
1916;68799;50;0;0;0;0;.00nan;0;0
1917;172340;48;80;22;1;21;.955;3600000;0
1917;78775;48;0;0;0;0;.00nan;0;0
1917;79132;49;0;0;0;0;.00nan;0;0
1917;91225;49;73;48;4;44;.917;3600000;0
1918;162945;38;0;0;0;0;.00nan;0;0
1918;178413;39;0;0;0;0;.00nan;0;0
1918;85428;38;64;49;6;43;.878;3600000;0
1918;85636;39;61;25;3;22;.880;3600000;0
1919;175084;65;70;30;3;27;.900;3714000;0
1919;176206;58;0;0;0;0;.00nan;0;0
1919;38209;65;0;0;0;0;.00nan;0;0
1919;46780;58;54;28;4;24;.857;3714000;0
1920;171608;46;0;0;0;0;.00nan;0;0
1920;176136;45;41;15;3;12;.800;1392000;0
1920;68938;46;44;18;3;15;.833;3600000;0
1920;141484;45;35;39;7;32;.821;2208000;0
1921;163462;55;97;34;1;33;.971;3558000;0
1921;58037;53;0;0;0;0;.00nan;0;0
1921;78581;53;94;20;0;20;1.000;3600000;0
1921;86862;55;0;0;0;0;.00nan;0;0
1922;165582;64;75;34;3;31;.912;3536000;0
1922;168872;64;0;0;0;0;.00nan;0;0
1922;171608;46;0;0;0;0;.00nan;0;0
1922;68938;46;87;34;1;33;.971;3600000;0
1923;170598;54;90;57;4;53;.930;3600000;0
1923;60773;37;0;0;0;0;.00nan;0;0
1923;94615;54;0;0;0;0;.00nan;0;0
1923;141850;37;57;13;1;12;.923;3600000;0
1924;168586;44;0;0;0;0;.00nan;0;0
1924;170314;4619;49;43;6;37;.860;2442000;0
1924;64800;4619;44;6;1;5;.833;1158000;0
1924;64811;44;63;25;2;23;.920;3600000;0
1925;163471;62;81;40;3;37;.925;3545000;0
1925;170294;60;0;0;0;0;.00nan;0;0
1925;36346;62;0;0;0;0;.00nan;0;0
1925;85797;60;59;20;2;18;.900;3600000;0
1926;172340;48;0;0;0;0;.00nan;0;0
1926;37077;4837;0;0;0;0;.00nan;0;0
1926;47112;4837;50;24;4;20;.833;3613000;0
1926;78775;48;69;32;3;29;.906;3613000;0
1927;501;42;0;0;0;0;.00nan;0;0
1927;176136;45;77;34;2;32;.941;3580000;0
1927;141484;45;0;0;0;0;.00nan;0;0
1927;141496;42;80;28;1;27;.964;3600000;0
1928;164715;63;52;34;5;29;.853;3600000;0
1928;180929;51;0;0;0;0;.00nan;0;0
1928;149455;51;83;39;2;37;.949;3600000;0
1928;149584;63;0;0;0;0;.00nan;0;0
1929;171673;50;76;42;4;38;.905;3600000;0
1929;38276;47;0;0;0;0;.00nan;0;0
1929;68799;50;0;0;0;0;.00nan;0;0
1929;87798;47;80;17;1;16;.941;3600000;0
1930;168651;40;40;25;5;20;.800;3600000;0
1930;173727;61;80;31;2;29;.935;3600000;0
1930;57207;61;0;0;0;0;.00nan;0;0
1930;142492;40;0;0;0;0;.00nan;0;0
1931;163462;55;0;0;0;0;.00nan;0;0
1931;59239;43;0;0;0;0;.00nan;0;0
1931;86862;55;76;33;3;30;.909;3637000;0
1931;90164;43;69;24;2;22;.917;3637000;0
1932;170598;54;0;0;0;0;.00nan;0;0
1932;60773;37;0;0;0;0;.00nan;0;0
1932;94615;54;57;38;4;34;.895;3551000;0
1932;141850;37;62;25;3;22;.880;3600000;0
1933;178413;39;88;34;2;32;.941;3600000;0
1933;58037;53;0;0;0;0;.00nan;0;0
1933;78581;53;88;56;5;51;.911;3600000;0
1933;85636;39;0;0;0;0;.00nan;0;0
1934;168586;44;99;37;1;36;.973;3600000;0
1934;170314;4619;77;30;2;28;.933;3600000;0
1934;64800;4619;0;0;0;0;.00nan;0;0
1934;64811;44;0;0;0;0;.00nan;0;0
1935;175912;57;0;0;0;0;.00nan;0;0
1935;57152;57;99;33;1;32;.970;3600000;0
1935;58100;56;0;0;0;0;.00nan;0;0
1935;91398;56;44;23;4;19;.826;3600000;0
1936;180316;52;0;0;0;0;.00nan;0;0
1936;37857;52;60;41;5;36;.878;3600000;0
1936;58054;59;76;26;2;24;.923;3600000;0
1936;69902;59;0;0;0;0;.00nan;0;0
1937;163471;62;81;28;1;27;.964;3600000;0
1937;173727;61;62;32;3;29;.906;3570000;0
1937;36346;62;0;0;0;0;.00nan;0;0
1937;57207;61;0;0;0;0;.00nan;0;0
1938;178413;39;0;0;0;0;.00nan;0;0
1938;58100;56;68;47;5;42;.894;3600000;0
1938;85636;39;98;29;1;28;.966;3600000;0
1938;91398;56;0;0;0;0;.00nan;0;0
1939;180316;52;54;22;2;20;.909;3600000;0
1939;37857;52;0;0;0;0;.00nan;0;0
1939;58054;59;74;30;3;27;.900;3600000;0
1939;69902;59;0;0;0;0;.00nan;0;0
1940;170294;60;0;0;0;0;.00nan;0;0
1940;79132;49;61;40;5;35;.875;3600000;0
1940;85797;60;59;17;2;15;.882;3600000;0
1940;91225;49;0;0;0;0;.00nan;0;0
1941;171838;41;70;22;1;21;.955;3600000;0
1941;162945;38;0;0;0;0;.00nan;0;0
1941;170977;41;0;0;0;0;.00nan;0;0
1941;85428;38;100;25;0;25;1.000;3600000;0
1942;168651;40;48;38;6;32;.842;3600000;0
1942;37077;4837;0;0;0;0;.00nan;0;0
1942;47112;4837;72;25;2;23;.920;3600000;0
1942;142492;40;0;0;0;0;.00nan;0;0
1943;501;42;0;0;0;0;.00nan;0;0
1943;171608;46;86;39;2;37;.949;3600000;0
1943;68938;46;0;0;0;0;.00nan;0;0
1943;141496;42;61;32;3;29;.906;3552000;0
1944;175912;57;0;0;0;0;.00nan;0;0
1944;57152;57;99;40;2;38;.950;3600000;0
1944;59239;43;0;0;0;0;.00nan;0;0
1944;90164;43;49;20;3;17;.850;3600000;0
1945;165582;64;62;25;3;22;.880;3596000;0
1945;168872;64;0;0;0;0;.00nan;0;0
1945;176136;45;0;0;0;0;.00nan;0;0
1945;141484;45;83;34;2;32;.941;3600000;0
1946;164715;63;0;0;0;0;.00nan;0;0
1946;58037;53;0;0;0;0;.00nan;0;0
1946;78581;53;69;25;2;23;.920;3900000;0
1946;149584;63;94;42;2;40;.952;3900000;0
1947;171673;50;49;32;5;27;.844;3536000;0
1947;38276;47;0;0;0;0;.00nan;0;0
1947;68799;50;0;0;0;0;.00nan;0;0
1947;87798;47;59;22;3;19;.864;3600000;0
1948;175084;65;0;0;0;0;.00nan;0;0
1948;176206;58;32;29;6;23;.793;2296000;0
1948;38209;65;86;33;2;31;.939;3600000;0
1948;46780;58;59;7;0;7;1.000;1304000;0
1949;163462;55;0;0;0;0;.00nan;0;0
1949;180929;51;0;0;0;0;.00nan;0;0
1949;86862;55;77;23;1;22;.957;3600000;0
1949;149455;51;82;45;4;41;.911;3600000;0
1950;165582;64;0;0;0;0;.00nan;0;0
1950;168872;64;71;21;1;20;.952;3600000;0
1950;176136;45;87;52;5;47;.904;3600000;0
1950;141484;45;0;0;0;0;.00nan;0;0
1951;172340;48;0;0;0;0;.00nan;0;0
1951;163471;62;98;57;3;54;.947;3529000;0
1951;36346;62;0;0;0;0;.00nan;0;0
1951;78775;48;81;22;1;21;.955;3600000;0
1952;170294;60;0;0;0;0;.00nan;0;0
1952;79132;49;0;0;0;0;.00nan;0;0
1952;85797;60;34;19;4;15;.789;3600000;0
1952;91225;49;93;37;1;36;.973;3600000;0
1953;168651;40;0;0;0;0;.00nan;0;0
1953;37077;4837;47;29;5;24;.828;3638000;0
1953;47112;4837;0;0;0;0;.00nan;0;0
1953;142492;40;65;38;4;34;.895;3638000;0
1954;176206;58;0;0;0;0;.00nan;0;0
1954;46780;58;67;28;2;26;.929;3600000;0
1954;58037;53;0;0;0;0;.00nan;0;0
1954;78581;53;73;33;3;30;.909;3583000;0
1955;501;42;69;36;3;33;.917;3720000;0
1955;171608;46;0;0;0;0;.00nan;0;0
1955;68938;46;68;23;2;21;.913;3720000;0
1955;141496;42;0;0;0;0;.00nan;0;0
1956;173727;61;0;0;0;0;.00nan;0;0
1956;38276;47;28;21;5;16;.762;3584000;0
1956;57207;61;88;51;4;47;.922;3600000;0
1956;87798;47;0;0;0;0;.00nan;0;0
1957;171838;41;76;41;3;38;.927;3562000;0
1957;170977;41;0;0;0;0;.00nan;0;0
1957;175084;65;55;13;1;12;.923;3600000;0
1957;38209;65;0;0;0;0;.00nan;0;0
1958;163462;55;93;22;0;22;1.000;3600000;0
1958;164715;63;90;35;2;33;.943;3537000;0
1958;86862;55;0;0;0;0;.00nan;0;0
1958;149584;63;0;0;0;0;.00nan;0;0
1959;173699;36;77;35;2;33;.943;3600000;0
1959;180929;51;34;28;5;23;.821;3600000;0
1959;74734;36;0;0;0;0;.00nan;0;0
1959;149455;51;0;0;0;0;.00nan;0;0
1960;178413;39;32;40;7;33;.825;3600000;0
1960;58100;56;62;22;3;19;.864;3600000;0
1960;85636;39;0;0;0;0;.00nan;0;0
1960;91398;56;0;0;0;0;.00nan;0;0
1961;163471;62;81;35;2;33;.943;3600000;0
1961;36346;62;0;0;0;0;.00nan;0;0
1961;37077;4837;0;0;0;0;.00nan;0;0
1961;47112;4837;64;35;3;32;.914;3555000;0
1962;171838;41;74;46;4;42;.913;3600000;0
1962;170977;41;0;0;0;0;.00nan;0;0
1962;58037;53;0;0;0;0;.00nan;0;0
1962;78581;53;72;23;1;22;.957;3600000;0
1963;178413;39;0;0;0;0;.00nan;0;0
1963;180929;51;0;0;0;0;.00nan;0;0
1963;85636;39;73;23;1;22;.957;3600000;0
1963;149455;51;36;45;8;37;.822;3600000;0
1964;172340;48;63;27;2;25;.926;3900000;0
1964;38276;47;0;0;0;0;.00nan;0;0
1964;78775;48;0;0;0;0;.00nan;0;0
1964;87798;47;83;31;2;29;.935;3900000;0
1965;175912;57;0;0;0;0;.00nan;0;0
1965;176206;58;55;34;4;30;.882;3600000;0
1965;46780;58;0;0;0;0;.00nan;0;0
1965;57152;57;92;37;1;36;.973;3600000;0
1966;173699;36;0;0;0;0;.00nan;0;0
1966;58054;59;61;21;2;19;.905;3600000;0
1966;69902;59;0;0;0;0;.00nan;0;0
1966;74734;36;84;46;3;43;.935;3572000;0
1967;165582;64;87;29;1;28;.966;3600000;0
1967;168872;64;0;0;0;0;.00nan;0;0
1967;176136;45;0;0;0;0;.00nan;0;0
1967;141484;45;76;32;2;30;.938;3549000;0
1968;163462;55;93;21;0;21;1.000;3600000;0
1968;164715;63;0;0;0;0;.00nan;0;0
1968;86862;55;0;0;0;0;.00nan;0;0
1968;149584;63;79;42;3;39;.929;3600000;0
1969;171673;50;86;39;2;37;.949;3549000;0
1969;60773;37;0;0;0;0;.00nan;0;0
1969;68799;50;0;0;0;0;.00nan;0;0
1969;141850;37;75;25;1;24;.960;3600000;0
1970;162945;38;0;0;0;0;.00nan;0;0
1970;175084;65;0;0;0;0;.00nan;0;0
1970;38209;65;80;18;1;17;.944;3600000;0
1970;85428;38;86;41;2;39;.951;3600000;0
1971;58100;56;0;0;0;0;.00nan;0;0
1971;59239;43;0;0;0;0;.00nan;0;0
1971;90164;43;69;18;1;17;.944;3600000;0
1971;91398;56;83;37;2;35;.946;3545000;0
1972;168586;44;0;0;0;0;.00nan;0;0
1972;170294;60;59;37;4;33;.892;3600000;0
1972;64811;44;29;23;5;18;.783;3566000;0
1972;85797;60;0;0;0;0;.00nan;0;0
1973;501;42;0;0;0;0;.00nan;0;0
1973;79132;49;98;52;1;51;.981;3583000;0
1973;91225;49;0;0;0;0;.00nan;0;0
1973;141496;42;98;25;0;25;1.000;3600000;0
1974;170314;4619;90;54;4;50;.926;3600000;0
1974;38276;47;90;22;0;22;1.000;3600000;0
1974;64800;4619;0;0;0;0;.00nan;0;0
1974;87798;47;0;0;0;0;.00nan;0;0
1975;163471;62;66;33;3;30;.909;3600000;0
1975;168651;40;26;29;6;23;.793;3267000;0
1975;36346;62;0;0;0;0;.00nan;0;0
1975;142492;40;50;3;0;3;1.000;333000;0
1976;168586;44;38;33;6;27;.818;3600000;0
1976;170294;60;0;0;0;0;.00nan;0;0
1976;64811;44;0;0;0;0;.00nan;0;0
1976;85797;60;49;36;5;31;.861;3600000;0
1977;165582;64;57;33;4;29;.879;3573000;0
1977;168872;64;0;0;0;0;.00nan;0;0
1977;60773;37;0;0;0;0;.00nan;0;0
1977;141850;37;51;22;3;19;.864;3600000;0
1978;163462;55;76;40;4;36;.900;3600000;0
1978;59239;43;50;21;3;18;.857;3600000;0
1978;86862;55;0;0;0;0;.00nan;0;0
1978;90164;43;0;0;0;0;.00nan;0;0
1979;170598;54;49;37;6;31;.838;2599000;0
1979;171608;46;0;0;0;0;.00nan;0;0
1979;68938;46;49;16;2;14;.875;3600000;0
1979;94615;54;52;12;1;11;.917;1001000;0
1980;164715;63;80;37;3;34;.919;3573000;0
1980;176206;58;0;0;0;0;.00nan;0;0
1980;46780;58;73;19;1;18;.947;3600000;0
1980;149584;63;0;0;0;0;.00nan;0;0
1981;171838;41;74;43;4;39;.907;3600000;0
1981;170977;41;0;0;0;0;.00nan;0;0
1981;175084;65;0;0;0;0;.00nan;0;0
1981;38209;65;90;27;2;25;.926;3600000;0
1982;172340;48;0;0;0;0;.00nan;0;0
1982;173727;61;100;24;0;24;1.000;3600000;0
1982;57207;61;0;0;0;0;.00nan;0;0
1982;78775;48;81;38;2;36;.947;3516000;0
1983;173699;36;83;48;4;44;.917;3600000;0
1983;58037;53;0;0;0;0;.00nan;0;0
1983;74734;36;0;0;0;0;.00nan;0;0
1983;78581;53;90;22;0;22;1.000;3600000;0
1984;175912;57;0;0;0;0;.00nan;0;0
1984;180316;52;0;0;0;0;.00nan;0;0
1984;37857;52;100;42;1;41;.976;3600000;0
1984;57152;57;51;35;5;30;.857;3600000;0
1985;165582;64;0;0;0;0;.00nan;0;0
1985;168872;64;88;35;3;32;.914;3600000;0
1985;180929;51;67;34;4;30;.882;3019000;0
1985;149455;51;26;7;3;4;.571;581000;0
1986;171838;41;0;0;0;0;.00nan;0;0
1986;162945;38;66;18;1;17;.944;3600000;0
1986;170977;41;61;46;5;41;.891;3600000;0
1986;85428;38;0;0;0;0;.00nan;0;0
1987;170314;4619;53;36;4;32;.889;3561000;0
1987;37077;4837;0;0;0;0;.00nan;0;0
1987;47112;4837;83;46;3;43;.935;3600000;0
1987;64800;4619;0;0;0;0;.00nan;0;0
1988;501;42;0;0;0;0;.00nan;0;0
1988;79132;49;99;58;2;56;.966;3600000;0
1988;91225;49;0;0;0;0;.00nan;0;0
1988;141496;42;49;23;4;19;.826;3589000;0
1989;163462;55;0;0;0;0;.00nan;0;0
1989;59239;43;0;0;0;0;.00nan;0;0
1989;86862;55;82;33;2;31;.939;3600000;0
1989;90164;43;66;25;3;22;.880;3593000;0
1990;176206;58;38;36;6;30;.833;3356000;0
1990;46780;58;53;3;0;3;1.000;244000;0
1990;58054;59;59;23;3;20;.870;3600000;0
1990;69902;59;0;0;0;0;.00nan;0;0
1991;171673;50;71;13;1;12;.923;3900000;0
1991;176136;45;97;47;1;46;.979;3900000;0
1991;68799;50;0;0;0;0;.00nan;0;0
1991;141484;45;0;0;0;0;.00nan;0;0
1992;163471;62;78;31;2;29;.935;3600000;0
1992;168651;40;0;0;0;0;.00nan;0;0
1992;36346;62;0;0;0;0;.00nan;0;0
1992;142492;40;56;31;4;27;.871;3533000;0
1993;175084;65;81;43;3;40;.930;3600000;0
1993;38209;65;0;0;0;0;.00nan;0;0
1993;58037;53;0;0;0;0;.00nan;0;0
1993;78581;53;68;22;2;20;.909;3600000;0
1994;178413;39;50;32;5;27;.844;3600000;0
1994;58100;56;0;0;0;0;.00nan;0;0
1994;85636;39;0;0;0;0;.00nan;0;0
1994;91398;56;61;24;4;20;.833;3600000;0
1995;173727;61;22;27;6;21;.778;2197000;0
1995;38276;47;60;24;3;21;.875;3600000;0
1995;57207;61;73;19;1;18;.947;1403000;0
1995;87798;47;0;0;0;0;.00nan;0;0
1996;164715;63;53;21;3;18;.857;3127000;0
1996;173699;36;0;0;0;0;.00nan;0;0
1996;74734;36;100;43;2;41;.953;3600000;0
1996;149584;63;18;9;4;5;.556;473000;0
1997;175912;57;85;43;3;40;.930;3900000;0
1997;180316;52;56;20;3;17;.850;3900000;0
1997;37857;52;0;0;0;0;.00nan;0;0
1997;57152;57;0;0;0;0;.00nan;0;0
1998;180929;51;0;0;0;0;.00nan;0;0
1998;60773;37;0;0;0;0;.00nan;0;0
1998;141850;37;55;10;1;9;.900;3600000;0
1998;149455;51;87;54;3;51;.944;3600000;0
1999;180316;52;0;0;0;0;.00nan;0;0
1999;37857;52;87;25;1;24;.960;3600000;0
1999;58054;59;66;36;4;32;.889;3600000;0
1999;69902;59;0;0;0;0;.00nan;0;0
2000;170598;54;86;49;3;46;.939;3578000;0
2000;171608;46;0;0;0;0;.00nan;0;0
2000;68938;46;57;16;2;14;.875;3600000;0
2000;94615;54;0;0;0;0;.00nan;0;0
2001;170314;4619;61;29;4;25;.862;3600000;0
2001;37077;4837;84;23;1;22;.957;3600000;0
2001;47112;4837;0;0;0;0;.00nan;0;0
2001;64800;4619;0;0;0;0;.00nan;0;0
2002;171673;50;0;0;0;0;.00nan;0;0
2002;176136;45;0;0;0;0;.00nan;0;0
2002;68799;50;62;11;2;9;.818;3600000;0
2002;141484;45;92;61;5;56;.918;3600000;0
2003;172340;48;62;37;4;33;.892;3656000;0
2003;170294;60;0;0;0;0;.00nan;0;0
2003;78775;48;0;0;0;0;.00nan;0;0
2003;85797;60;72;34;3;31;.912;3656000;0
2004;172340;48;0;0;0;0;.00nan;0;0
2004;170294;60;72;27;2;25;.926;3900000;0
2004;78775;48;80;32;2;30;.938;3900000;0
2004;85797;60;0;0;0;0;.00nan;0;0
2005;165582;64;100;34;0;34;1.000;3600000;0
2005;168872;64;0;0;0;0;.00nan;0;0
2005;170598;54;72;41;5;36;.878;3600000;0
2005;94615;54;0;0;0;0;.00nan;0;0
2006;163471;62;0;0;0;0;.00nan;0;0
2006;168586;44;0;0;0;0;.00nan;0;0
2006;36346;62;82;55;4;51;.927;3600000;0
2006;64811;44;34;25;5;20;.800;3543000;0
2007;37077;4837;50;29;4;25;.862;2485000;0
2007;38276;47;0;0;0;0;.00nan;0;0
2007;47112;4837;31;17;4;13;.765;1115000;0
2007;87798;47;100;29;0;29;1.000;3600000;0
2008;176206;58;0;0;0;0;.00nan;0;0
2008;180316;52;0;0;0;0;.00nan;0;0
2008;37857;52;85;25;1;24;.960;3600000;0
2008;46780;58;67;33;3;30;.909;3541000;0
2009;168651;40;38;28;5;23;.821;3600000;0
2009;173727;61;66;23;3;20;.870;3600000;0
2009;57207;61;0;0;0;0;.00nan;0;0
2009;142492;40;0;0;0;0;.00nan;0;0
2010;178413;39;0;0;0;0;.00nan;0;0
2010;180929;51;0;0;0;0;.00nan;0;0
2010;85636;39;84;23;1;22;.957;3600000;0
2010;149455;51;83;44;4;40;.909;3600000;0
2011;171838;41;46;21;3;18;.857;3588000;0
2011;162945;38;0;0;0;0;.00nan;0;0
2011;170977;41;0;0;0;0;.00nan;0;0
2011;85428;38;89;32;1;31;.969;3600000;0
2012;170294;60;0;0;0;0;.00nan;0;0
2012;37077;4837;0;0;0;0;.00nan;0;0
2012;47112;4837;88;28;1;27;.964;3600000;0
2012;85797;60;60;20;2;18;.900;3544000;0
2013;165582;64;56;24;3;21;.875;3567000;0
2013;168872;64;0;0;0;0;.00nan;0;0
2013;173727;61;74;47;4;43;.915;3600000;0
2013;57207;61;0;0;0;0;.00nan;0;0
2014;501;42;0;0;0;0;.00nan;0;0
2014;60773;37;0;0;0;0;.00nan;0;0
2014;141496;42;82;45;4;41;.911;3900000;0
2014;141850;37;62;35;4;31;.886;3876000;0
2015;176136;45;41;17;3;14;.824;3516000;0
2015;79132;49;100;36;1;35;.972;3600000;0
2015;91225;49;0;0;0;0;.00nan;0;0
2015;141484;45;0;0;0;0;.00nan;0;0
2016;168651;40;31;26;5;21;.808;3600000;0
2016;170314;4619;85;30;1;29;.967;3600000;0
2016;64800;4619;0;0;0;0;.00nan;0;0
2016;142492;40;0;0;0;0;.00nan;0;0
2017;164715;63;65;27;2;25;.926;3600000;0
2017;180929;51;0;0;0;0;.00nan;0;0
2017;149455;51;59;36;4;32;.889;3600000;0
2017;149584;63;0;0;0;0;.00nan;0;0
2018;163471;62;52;44;6;38;.864;3600000;0
2018;36346;62;0;0;0;0;.00nan;0;0
2018;38276;47;0;0;0;0;.00nan;0;0
2018;87798;47;86;13;0;13;1.000;3600000;0
2019;175084;65;0;0;0;0;.00nan;0;0
2019;175912;57;0;0;0;0;.00nan;0;0
2019;38209;65;50;31;4;27;.871;3717000;0
2019;57152;57;62;37;5;32;.865;3717000;0
2020;170598;54;100;48;2;46;.958;3600000;0
2020;171673;50;49;19;3;16;.842;3575000;0
2020;68799;50;0;0;0;0;.00nan;0;0
2020;94615;54;0;0;0;0;.00nan;0;0
2021;173699;36;39;35;6;29;.829;2866000;0
2021;59239;43;0;0;0;0;.00nan;0;0
2021;74734;36;55;4;0;4;1.000;734000;0
2021;90164;43;69;20;2;18;.900;3600000;0
2022;171838;41;96;43;1;42;.977;3900000;0
2022;170977;41;0;0;0;0;.00nan;0;0
2022;180316;52;0;0;0;0;.00nan;0;0
2022;37857;52;93;33;1;32;.970;3900000;0
2023;170294;60;0;0;0;0;.00nan;0;0
2023;37077;4837;61;19;2;17;.895;3600000;0
2023;47112;4837;0;0;0;0;.00nan;0;0
2023;85797;60;77;40;3;37;.925;3546000;0
2024;165582;64;0;0;0;0;.00nan;0;0
2024;168872;64;72;44;5;39;.886;3780000;0
2024;173727;61;0;0;0;0;.00nan;0;0
2024;57207;61;61;34;4;30;.882;3780000;0
2025;164715;63;0;0;0;0;.00nan;0;0
2025;180929;51;39;28;5;23;.821;3600000;0
2025;149455;51;0;0;0;0;.00nan;0;0
2025;149584;63;75;32;2;30;.938;3600000;0
2026;172340;48;45;30;5;25;.833;3351000;0
2026;168586;44;0;0;0;0;.00nan;0;0
2026;64811;44;83;28;2;26;.929;3600000;0
2026;78775;48;49;2;0;2;1.000;249000;0
2027;162945;38;0;0;0;0;.00nan;0;0
2027;176206;58;0;0;0;0;.00nan;0;0
2027;46780;58;90;33;1;32;.970;3600000;0
2027;85428;38;67;24;2;22;.917;3600000;0
2028;501;42;0;0;0;0;.00nan;0;0
2028;60773;37;0;0;0;0;.00nan;0;0
2028;141496;42;97;42;2;40;.952;3551000;0
2028;141850;37;64;14;1;13;.929;3600000;0
2029;171608;46;0;0;0;0;.00nan;0;0
2029;58100;56;74;27;2;25;.926;3513000;0
2029;68938;46;97;24;0;24;1.000;3600000;0
2029;91398;56;0;0;0;0;.00nan;0;0
2030;176136;45;0;0;0;0;.00nan;0;0
2030;79132;49;51;32;5;27;.844;3515000;0
2030;91225;49;0;0;0;0;.00nan;0;0
2030;141484;45;88;45;3;42;.933;3600000;0
2031;168651;40;0;0;0;0;.00nan;0;0
2031;170314;4619;85;32;1;31;.969;3600000;0
2031;64800;4619;0;0;0;0;.00nan;0;0
2031;142492;40;98;42;2;40;.952;3568000;0
2032;163471;62;72;52;6;46;.885;3600000;0
2032;36346;62;0;0;0;0;.00nan;0;0
2032;38276;47;0;0;0;0;.00nan;0;0
2032;87798;47;62;12;1;11;.917;3600000;0
2033;175084;65;40;30;5;25;.833;3600000;0
2033;38209;65;0;0;0;0;.00nan;0;0
2033;58037;53;0;0;0;0;.00nan;0;0
2033;78581;53;94;35;2;33;.943;3600000;0
2034;170598;54;0;0;0;0;.00nan;0;0
2034;171673;50;0;0;0;0;.00nan;0;0
2034;68799;50;87;34;2;32;.941;3551000;0
2034;94615;54;97;41;1;40;.976;3600000;0
2035;163462;55;98;39;2;37;.949;3581000;0
2035;178413;39;91;34;1;33;.971;3600000;0
2035;85636;39;0;0;0;0;.00nan;0;0
2035;86862;55;0;0;0;0;.00nan;0;0
2036;175912;57;0;0;0;0;.00nan;0;0
2036;57152;57;66;41;5;36;.878;3600000;0
2036;58054;59;74;22;2;20;.909;3600000;0
2036;69902;59;0;0;0;0;.00nan;0;0
2037;171838;41;0;0;0;0;.00nan;0;0
2037;170977;41;89;33;1;32;.970;3600000;0
2037;180316;52;82;33;2;31;.939;3545000;0
2037;37857;52;0;0;0;0;.00nan;0;0
2038;172340;48;0;0;0;0;.00nan;0;0
2038;168586;44;67;32;4;28;.875;3600000;0
2038;64811;44;0;0;0;0;.00nan;0;0
2038;78775;48;53;20;3;17;.850;3600000;0
2039;176206;58;74;35;4;31;.886;3900000;0
2039;46780;58;0;0;0;0;.00nan;0;0
2039;58054;59;63;31;4;27;.871;3900000;0
2039;69902;59;0;0;0;0;.00nan;0;0
2040;171608;46;0;0;0;0;.00nan;0;0
2040;58100;56;0;0;0;0;.00nan;0;0
2040;68938;46;32;29;6;23;.793;3563000;0
2040;91398;56;76;43;4;39;.907;3600000;0
2041;175084;65;58;8;0;8;1.000;366000;0
2041;38209;65;41;38;6;32;.842;3234000;0
2041;58037;53;84;34;2;32;.941;3600000;0
2041;78581;53;0;0;0;0;.00nan;0;0
2042;163462;55;0;0;0;0;.00nan;0;0
2042;178413;39;0;0;0;0;.00nan;0;0
2042;85636;39;50;25;4;21;.840;3600000;0
2042;86862;55;45;33;5;28;.848;3541000;0
2043;173699;36;52;40;6;34;.850;3096000;0
2043;59239;43;0;0;0;0;.00nan;0;0
2043;74734;36;60;7;0;7;1.000;504000;0
2043;90164;43;61;22;2;20;.909;3600000;0
2044;162945;38;28;31;6;25;.806;3235000;0
2044;175912;57;83;39;3;36;.923;3600000;0
2044;57152;57;0;0;0;0;.00nan;0;0
2044;85428;38;49;1;0;1;1.000;365000;0
2045;168651;40;55;35;5;30;.857;3600000;0
2045;170314;4619;77;41;4;37;.902;3600000;0
2045;64800;4619;0;0;0;0;.00nan;0;0
2045;142492;40;0;0;0;0;.00nan;0;0
2046;171608;46;0;0;0;0;.00nan;0;0
2046;58100;56;0;0;0;0;.00nan;0;0
2046;68938;46;60;33;4;29;.879;3543000;0
2046;91398;56;68;28;3;25;.893;3600000;0
2047;171838;41;92;36;2;34;.944;3900000;0
2047;170977;41;0;0;0;0;.00nan;0;0
2047;175084;65;0;0;0;0;.00nan;0;0
2047;38209;65;77;26;2;24;.923;3900000;0
2048;176136;45;88;50;3;47;.940;3600000;0
2048;60773;37;0;0;0;0;.00nan;0;0
2048;141484;45;0;0;0;0;.00nan;0;0
2048;141850;37;84;30;1;29;.967;3600000;0
2049;173699;36;87;56;4;52;.929;3600000;0
2049;59239;43;0;0;0;0;.00nan;0;0
2049;74734;36;0;0;0;0;.00nan;0;0
2049;90164;43;80;20;1;19;.950;3600000;0
2050;172340;48;81;38;3;35;.921;3600000;0
2050;38276;47;0;0;0;0;.00nan;0;0
2050;78775;48;0;0;0;0;.00nan;0;0
2050;87798;47;41;24;4;20;.833;3542000;0
2051;170294;60;0;0;0;0;.00nan;0;0
2051;170314;4619;55;38;5;33;.868;3600000;0
2051;64800;4619;0;0;0;0;.00nan;0;0
2051;85797;60;64;21;2;19;.905;3600000;0
2052;168586;44;0;0;0;0;.00nan;0;0
2052;173727;61;0;0;0;0;.00nan;0;0
2052;57207;61;90;31;1;30;.968;3600000;0
2052;64811;44;64;33;3;30;.909;3513000;0
2053;170294;60;0;0;0;0;.00nan;0;0
2053;170314;4619;90;35;2;33;.943;3900000;0
2053;64800;4619;0;0;0;0;.00nan;0;0
2053;85797;60;81;33;2;31;.939;3900000;0
2054;164715;63;70;42;4;38;.905;3600000;0
2054;180316;52;0;0;0;0;.00nan;0;0
2054;37857;52;58;22;3;19;.864;3600000;0
2054;149584;63;0;0;0;0;.00nan;0;0
2055;172340;48;0;0;0;0;.00nan;0;0
2055;78775;48;74;19;1;18;.947;3600000;0
2055;79132;49;89;57;4;53;.930;3600000;0
2055;91225;49;0;0;0;0;.00nan;0;0
2056;171673;50;35;29;6;23;.793;2052000;0
2056;60773;37;0;0;0;0;.00nan;0;0
2056;68799;50;61;15;1;14;.933;1548000;0
2056;141850;37;92;36;2;34;.944;3600000;0
2057;176136;45;0;0;0;0;.00nan;0;0
2057;37077;4837;0;0;0;0;.00nan;0;0
2057;47112;4837;59;15;1;14;.933;3600000;0
2057;141484;45;79;33;2;31;.939;3600000;0
2058;171608;46;0;0;0;0;.00nan;0;0
2058;59239;43;0;0;0;0;.00nan;0;0
2058;68938;46;69;47;5;42;.894;3590000;0
2058;90164;43;49;21;3;18;.857;3600000;0
2059;162945;38;0;0;0;0;.00nan;0;0
2059;58054;59;66;20;1;19;.950;3600000;0
2059;69902;59;0;0;0;0;.00nan;0;0
2059;85428;38;58;51;6;45;.882;3600000;0
2060;175912;57;0;0;0;0;.00nan;0;0
2060;57152;57;49;33;5;28;.848;3589000;0
2060;58037;53;0;0;0;0;.00nan;0;0
2060;78581;53;65;31;3;28;.903;3600000;0
2061;501;42;0;0;0;0;.00nan;0;0
2061;38276;47;0;0;0;0;.00nan;0;0
2061;87798;47;63;16;1;15;.938;3600000;0
2061;141496;42;97;53;3;50;.943;3579000;0
2062;163471;62;51;33;5;28;.848;3600000;0
2062;168651;40;0;0;0;0;.00nan;0;0
2062;36346;62;0;0;0;0;.00nan;0;0
2062;142492;40;67;26;2;24;.923;3600000;0
2063;163462;55;69;33;3;30;.909;3557000;0
2063;175084;65;0;0;0;0;.00nan;0;0
2063;38209;65;83;28;2;26;.929;3600000;0
2063;86862;55;0;0;0;0;.00nan;0;0
2064;178413;39;78;34;3;31;.912;3560000;0
2064;58100;56;93;36;2;34;.944;3600000;0
2064;85636;39;0;0;0;0;.00nan;0;0
2064;91398;56;0;0;0;0;.00nan;0;0
2065;173699;36;48;38;5;33;.868;3600000;0
2065;180929;51;0;0;0;0;.00nan;0;0
2065;74734;36;0;0;0;0;.00nan;0;0
2065;149455;51;85;26;1;25;.962;3600000;0
2066;168586;44;59;31;4;27;.871;3600000;0
2066;173727;61;10;25;8;17;.680;2541000;0
2066;57207;61;37;10;3;7;.700;1059000;0
2066;64811;44;0;0;0;0;.00nan;0;0
2067;163471;62;81;34;2;32;.941;2981000;0
2067;168651;40;52;20;4;16;.800;3600000;0
2067;36346;62;35;13;3;10;.769;584000;0
2067;142492;40;0;0;0;0;.00nan;0;0
2068;171838;41;0;0;0;0;.00nan;0;0
2068;170977;41;51;42;6;36;.857;3600000;0
2068;175912;57;0;0;0;0;.00nan;0;0
2068;57152;57;47;12;2;10;.833;3600000;0
2069;164715;63;0;0;0;0;.00nan;0;0
2069;180316;52;87;40;2;38;.950;3600000;0
2069;37857;52;0;0;0;0;.00nan;0;0
2069;149584;63;64;42;5;37;.881;3600000;0
2070;172340;48;49;20;3;17;.850;3900000;0
2070;78775;48;0;0;0;0;.00nan;0;0
2070;79132;49;88;40;3;37;.925;3900000;0
2070;91225;49;0;0;0;0;.00nan;0;0
2071;171673;50;63;27;3;24;.889;3900000;0
2071;60773;37;66;30;3;27;.900;3900000;0
2071;68799;50;0;0;0;0;.00nan;0;0
2071;141850;37;0;0;0;0;.00nan;0;0
2072;162945;38;30;37;7;30;.811;2202000;0
2072;58037;53;0;0;0;0;.00nan;0;0
2072;78581;53;81;31;2;29;.935;3600000;0
2072;85428;38;51;10;1;9;.900;1398000;0
2073;176136;45;100;33;0;33;1.000;3600000;0
2073;37077;4837;60;24;2;22;.917;3514000;0
2073;47112;4837;0;0;0;0;.00nan;0;0
2073;141484;45;0;0;0;0;.00nan;0;0
2074;171608;46;69;37;5;32;.865;3600000;0
2074;59239;43;85;26;1;25;.962;3600000;0
2074;68938;46;0;0;0;0;.00nan;0;0
2074;90164;43;0;0;0;0;.00nan;0;0
2075;176206;58;0;0;0;0;.00nan;0;0
2075;46780;58;95;43;1;42;.977;3600000;0
2075;58054;59;59;23;3;20;.870;3600000;0
2075;69902;59;0;0;0;0;.00nan;0;0
2076;501;42;0;0;0;0;.00nan;0;0
2076;38276;47;83;27;2;25;.926;3547000;0
2076;87798;47;0;0;0;0;.00nan;0;0
2076;141496;42;88;31;1;30;.968;3600000;0
2077;163462;55;0;0;0;0;.00nan;0;0
2077;180929;51;68;47;4;43;.915;3560000;0
2077;86862;55;49;13;2;11;.846;3600000;0
2077;149455;51;0;0;0;0;.00nan;0;0
2078;165582;64;32;15;4;11;.733;3600000;0
2078;168872;64;0;0;0;0;.00nan;0;0
2078;170598;54;63;42;5;37;.881;3600000;0
2078;94615;54;0;0;0;0;.00nan;0;0
2079;173699;36;0;0;0;0;.00nan;0;0
2079;175084;65;61;37;4;33;.892;3587000;0
2079;38209;65;0;0;0;0;.00nan;0;0
2079;74734;36;74;30;2;28;.933;3600000;0
2080;178413;39;79;41;4;37;.902;3900000;0
2080;58100;56;76;36;4;32;.889;3900000;0
2080;85636;39;0;0;0;0;.00nan;0;0
2080;91398;56;0;0;0;0;.00nan;0;0
2081;171838;41;96;51;3;48;.941;3569000;0
2081;170977;41;0;0;0;0;.00nan;0;0
2081;58037;53;0;0;0;0;.00nan;0;0
2081;78581;53;71;22;1;21;.955;3600000;0
2082;165582;64;0;0;0;0;.00nan;0;0
2082;168872;64;56;27;3;24;.889;3725000;0
2082;170598;54;0;0;0;0;.00nan;0;0
2082;94615;54;81;50;4;46;.920;3725000;0
2083;171838;41;75;44;4;40;.909;3600000;0
2083;170977;41;0;0;0;0;.00nan;0;0
2083;176206;58;0;0;0;0;.00nan;0;0
2083;46780;58;62;15;1;14;.933;3600000;0
2084;172340;48;0;0;0;0;.00nan;0;0
2084;37077;4837;0;0;0;0;.00nan;0;0
2084;47112;4837;57;33;3;30;.909;3600000;0
2084;78775;48;66;35;4;31;.886;3591000;0
2085;175084;65;0;0;0;0;.00nan;0;0
2085;175912;57;0;0;0;0;.00nan;0;0
2085;38209;65;64;34;4;30;.882;3600000;0
2085;57152;57;74;22;1;21;.955;3600000;0
2086;163462;55;0;0;0;0;.00nan;0;0
2086;173699;36;72;33;3;30;.909;3900000;0
2086;74734;36;0;0;0;0;.00nan;0;0
2086;86862;55;63;26;3;23;.885;3900000;0
2087;501;42;0;0;0;0;.00nan;0;0
2087;173727;61;0;0;0;0;.00nan;0;0
2087;57207;61;55;39;5;34;.872;3600000;0
2087;141496;42;93;18;0;18;1.000;3600000;0
2088;168586;44;0;0;0;0;.00nan;0;0
2088;170314;4619;73;36;3;33;.917;3745000;0
2088;64800;4619;0;0;0;0;.00nan;0;0
2088;64811;44;99;39;2;37;.949;3745000;0
2089;168651;40;97;36;1;35;.972;3900000;0
2089;180316;52;0;0;0;0;.00nan;0;0
2089;37857;52;100;35;1;34;.971;3900000;0
2089;142492;40;0;0;0;0;.00nan;0;0
2090;163471;62;70;31;3;28;.903;3600000;0
2090;36346;62;0;0;0;0;.00nan;0;0
2090;79132;49;0;0;0;0;.00nan;0;0
2090;91225;49;95;36;2;34;.944;3600000;0
2091;168586;44;0;0;0;0;.00nan;0;0
2091;170314;4619;54;3;0;3;1.000;1246000;0
2091;64800;4619;28;27;6;21;.778;2654000;0
2091;64811;44;69;53;6;47;.887;3900000;0
2092;168651;40;0;0;0;0;.00nan;0;0
2092;180316;52;0;0;0;0;.00nan;0;0
2092;37857;52;92;23;0;23;1.000;3600000;0
2092;142492;40;76;30;2;28;.933;3558000;0
2093;172340;48;0;0;0;0;.00nan;0;0
2093;37077;4837;0;0;0;0;.00nan;0;0
2093;47112;4837;60;36;4;32;.889;3566000;0
2093;78775;48;55;15;2;13;.867;3600000;0
2094;163471;62;0;0;0;0;.00nan;0;0
2094;36346;62;69;29;2;27;.931;3600000;0
2094;79132;49;67;36;4;32;.889;3523000;0
2094;91225;49;0;0;0;0;.00nan;0;0
2095;164715;63;100;40;0;40;1.000;3600000;0
2095;58054;59;50;30;5;25;.833;3600000;0
2095;69902;59;0;0;0;0;.00nan;0;0
2095;149584;63;0;0;0;0;.00nan;0;0
2096;501;42;0;0;0;0;.00nan;0;0
2096;173727;61;0;0;0;0;.00nan;0;0
2096;57207;61;71;25;2;23;.920;3600000;0
2096;141496;42;77;41;3;38;.927;3544000;0
2097;173699;36;74;54;6;48;.889;3600000;0
2097;58100;56;0;0;0;0;.00nan;0;0
2097;74734;36;0;0;0;0;.00nan;0;0
2097;91398;56;67;14;1;13;.929;3600000;0
2098;175912;57;32;33;6;27;.818;3025000;0
2098;57152;57;51;7;1;6;.857;575000;0
2098;58037;53;0;0;0;0;.00nan;0;0
2098;78581;53;46;23;3;20;.870;3600000;0
2099;180929;51;91;44;2;42;.955;3744000;0
2099;58054;59;79;20;1;19;.950;3744000;0
2099;69902;59;0;0;0;0;.00nan;0;0
2099;149455;51;0;0;0;0;.00nan;0;0
2100;172340;48;82;38;3;35;.921;3600000;0
2100;170294;60;0;0;0;0;.00nan;0;0
2100;78775;48;0;0;0;0;.00nan;0;0
2100;85797;60;48;24;4;20;.833;3572000;0
2101;162945;38;0;0;0;0;.00nan;0;0
2101;176206;58;0;0;0;0;.00nan;0;0
2101;46780;58;78;32;3;29;.906;3600000;0
2101;85428;38;99;21;0;21;1.000;3600000;0
2102;58100;56;55;10;1;9;.900;1617000;0
2102;59239;43;0;0;0;0;.00nan;0;0
2102;90164;43;72;34;3;31;.912;3600000;0
2102;91398;56;18;20;6;14;.700;1983000;0
2103;171608;46;0;0;0;0;.00nan;0;0
2103;60773;37;0;0;0;0;.00nan;0;0
2103;68938;46;83;51;5;46;.902;3583000;0
2103;141850;37;64;24;2;22;.917;3600000;0
2104;170598;54;86;26;1;25;.962;3600000;0
2104;176136;45;0;0;0;0;.00nan;0;0
2104;94615;54;0;0;0;0;.00nan;0;0
2104;141484;45;73;28;2;26;.929;3556000;0
2105;165582;64;26;7;3;4;.571;325000;0
2105;168872;64;98;51;2;49;.961;3275000;0
2105;171673;50;100;29;0;29;1.000;3600000;0
2105;68799;50;0;0;0;0;.00nan;0;0
2106;163462;55;0;0;0;0;.00nan;0;0
2106;58037;53;0;0;0;0;.00nan;0;0
2106;78581;53;62;28;2;26;.929;3600000;0
2106;86862;55;78;25;1;24;.960;3600000;0
2107;173727;61;96;35;1;34;.971;3600000;0
2107;37077;4837;0;0;0;0;.00nan;0;0
2107;47112;4837;81;28;2;26;.929;3600000;0
2107;57207;61;0;0;0;0;.00nan;0;0
2108;164715;63;0;0;0;0;.00nan;0;0
2108;173699;36;65;42;6;36;.857;2112000;0
2108;74734;36;77;24;2;22;.917;1488000;0
2108;149584;63;58;20;2;18;.900;3600000;0
2109;168586;44;0;0;0;0;.00nan;0;0
2109;38276;47;0;0;0;0;.00nan;0;0
2109;64811;44;87;35;2;33;.943;3600000;0
2109;87798;47;65;21;3;18;.857;3542000;0
2110;163471;62;70;38;3;35;.921;3600000;0
2110;170294;60;0;0;0;0;.00nan;0;0
2110;36346;62;0;0;0;0;.00nan;0;0
2110;85797;60;54;40;5;35;.875;3532000;0
2111;58100;56;0;0;0;0;.00nan;0;0
2111;59239;43;78;24;1;23;.958;3600000;0
2111;90164;43;0;0;0;0;.00nan;0;0
2111;91398;56;92;33;2;31;.939;3600000;0
2112;171838;41;79;33;3;30;.909;3600000;0
2112;162945;38;0;0;0;0;.00nan;0;0
2112;170977;41;0;0;0;0;.00nan;0;0
2112;85428;38;70;33;4;29;.879;3584000;0
2113;178413;39;69;20;1;19;.950;3600000;0
2113;180316;52;0;0;0;0;.00nan;0;0
2113;37857;52;36;19;5;14;.737;3600000;0
2113;85636;39;0;0;0;0;.00nan;0;0
2114;180929;51;0;0;0;0;.00nan;0;0
2114;58054;59;100;18;0;18;1.000;3600000;0
2114;69902;59;0;0;0;0;.00nan;0;0
2114;149455;51;82;56;5;51;.911;3600000;0
2115;168651;40;71;31;3;28;.903;3600000;0
2115;79132;49;66;40;4;36;.900;3600000;0
2115;91225;49;0;0;0;0;.00nan;0;0
2115;142492;40;0;0;0;0;.00nan;0;0
2116;175912;57;0;0;0;0;.00nan;0;0
2116;176206;58;59;31;4;27;.871;3716000;0
2116;46780;58;0;0;0;0;.00nan;0;0
2116;57152;57;67;46;5;41;.891;3716000;0
2117;171608;46;0;0;0;0;.00nan;0;0
2117;60773;37;0;0;0;0;.00nan;0;0
2117;68938;46;50;38;5;33;.868;3600000;0
2117;141850;37;94;18;0;18;1.000;3600000;0
2118;170598;54;0;0;0;0;.00nan;0;0
2118;176136;45;73;32;2;30;.938;3570000;0
2118;94615;54;100;32;0;32;1.000;3600000;0
2118;141484;45;0;0;0;0;.00nan;0;0
2119;172340;48;0;0;0;0;.00nan;0;0
2119;170314;4619;88;33;1;32;.970;3600000;0
2119;64800;4619;0;0;0;0;.00nan;0;0
2119;78775;48;57;31;4;27;.871;3600000;0
2120;164715;63;81;40;3;37;.925;3600000;0
2120;175084;65;0;0;0;0;.00nan;0;0
2120;38209;65;94;28;1;27;.964;3600000;0
2120;149584;63;0;0;0;0;.00nan;0;0
2121;501;42;0;0;0;0;.00nan;0;0
2121;171673;50;70;29;2;27;.931;3600000;0
2121;68799;50;0;0;0;0;.00nan;0;0
2121;141496;42;91;39;3;36;.923;3557000;0
2122;163462;55;62;26;3;23;.885;3600000;0
2122;173699;36;78;31;2;29;.935;2852000;0
2122;74734;36;33;15;4;11;.733;748000;0
2122;86862;55;0;0;0;0;.00nan;0;0
2123;173727;61;0;0;0;0;.00nan;0;0
2123;37077;4837;68;46;5;41;.891;3597000;0
2123;47112;4837;0;0;0;0;.00nan;0;0
2123;57207;61;70;29;3;26;.897;3600000;0
2124;168586;44;71;33;3;30;.909;3600000;0
2124;38276;47;73;37;4;33;.892;3554000;0
2124;64811;44;0;0;0;0;.00nan;0;0
2124;87798;47;0;0;0;0;.00nan;0;0
2125;178413;39;0;0;0;0;.00nan;0;0
2125;180316;52;70;33;2;31;.939;3600000;0
2125;37857;52;0;0;0;0;.00nan;0;0
2125;85636;39;75;23;1;22;.957;3600000;0
2126;168651;40;0;0;0;0;.00nan;0;0
2126;79132;49;0;0;0;0;.00nan;0;0
2126;91225;49;66;32;3;29;.906;3900000;0
2126;142492;40;63;26;3;23;.885;3900000;0
2127;163471;62;0;0;0;0;.00nan;0;0
2127;170314;4619;0;0;0;0;.00nan;0;0
2127;36346;62;77;42;3;39;.929;3600000;0
2127;64800;4619;73;28;2;26;.929;3600000;0
2128;171838;41;91;50;4;46;.920;3600000;0
2128;170977;41;0;0;0;0;.00nan;0;0
2128;58037;53;0;0;0;0;.00nan;0;0
2128;78581;53;70;16;1;15;.938;3600000;0
2129;175084;65;0;0;0;0;.00nan;0;0
2129;175912;57;79;27;1;26;.963;3900000;0
2129;38209;65;100;49;1;48;.980;3900000;0
2129;57152;57;0;0;0;0;.00nan;0;0
2130;501;42;57;13;2;11;.846;3600000;0
2130;170598;54;0;0;0;0;.00nan;0;0
2130;94615;54;76;52;5;47;.904;3600000;0
2130;141496;42;0;0;0;0;.00nan;0;0
2131;165582;64;65;26;2;24;.923;3543000;0
2131;168872;64;0;0;0;0;.00nan;0;0
2131;171608;46;0;0;0;0;.00nan;0;0
2131;68938;46;86;28;1;27;.964;3600000;0
2132;168586;44;0;0;0;0;.00nan;0;0
2132;38276;47;0;0;0;0;.00nan;0;0
2132;64811;44;100;34;0;34;1.000;3600000;0
2132;87798;47;66;19;1;18;.947;3568000;0
2133;178413;39;70;19;2;17;.895;3600000;0
2133;180929;51;38;36;6;30;.833;3135000;0
2133;85636;39;0;0;0;0;.00nan;0;0
2133;149455;51;32;8;3;5;.625;465000;0
2134;171673;50;66;32;3;29;.906;3900000;0
2134;60773;37;0;0;0;0;.00nan;0;0
2134;68799;50;0;0;0;0;.00nan;0;0
2134;141850;37;60;26;3;23;.885;3900000;0
2135;172340;48;0;0;0;0;.00nan;0;0
2135;37077;4837;0;0;0;0;.00nan;0;0
2135;47112;4837;65;36;4;32;.889;3600000;0
2135;78775;48;40;35;6;29;.829;3513000;0
2136;175084;65;0;0;0;0;.00nan;0;0
2136;176206;58;0;0;0;0;.00nan;0;0
2136;38209;65;51;15;2;13;.867;3600000;0
2136;46780;58;92;43;3;40;.930;3564000;0
2137;501;42;0;0;0;0;.00nan;0;0
2137;170598;54;78;35;3;32;.914;3542000;0
2137;94615;54;0;0;0;0;.00nan;0;0
2137;141496;42;72;32;2;30;.938;3600000;0
2138;173699;36;79;51;5;46;.902;3600000;0
2138;59239;43;0;0;0;0;.00nan;0;0
2138;74734;36;0;0;0;0;.00nan;0;0
2138;90164;43;65;20;2;18;.900;3600000;0
2139;165582;64;0;0;0;0;.00nan;0;0
2139;168872;64;72;30;2;28;.933;3600000;0
2139;171608;46;58;29;3;26;.897;3551000;0
2139;68938;46;0;0;0;0;.00nan;0;0
2140;176136;45;58;8;0;8;1.000;656000;0
2140;58100;56;65;21;2;19;.905;3600000;0
2140;91398;56;0;0;0;0;.00nan;0;0
2140;141484;45;40;29;6;23;.793;2944000;0
2141;163471;62;55;24;3;21;.875;3517000;0
2141;168651;40;0;0;0;0;.00nan;0;0
2141;36346;62;0;0;0;0;.00nan;0;0
2141;142492;40;100;42;1;41;.976;3600000;0
2142;162945;38;77;45;3;42;.933;3600000;0
2142;175912;57;0;0;0;0;.00nan;0;0
2142;57152;57;54;26;4;22;.846;3577000;0
2142;85428;38;0;0;0;0;.00nan;0;0
2143;163471;62;90;36;2;34;.944;3600000;0
2143;168586;44;0;0;0;0;.00nan;0;0
2143;36346;62;0;0;0;0;.00nan;0;0
2143;64811;44;72;37;3;34;.919;3545000;0
2144;162945;38;0;0;0;0;.00nan;0;0
2144;180929;51;83;35;4;31;.886;3600000;0
2144;85428;38;83;24;1;23;.958;3600000;0
2144;149455;51;0;0;0;0;.00nan;0;0
2145;58100;56;68;52;6;46;.885;2381000;0
2145;60773;37;0;0;0;0;.00nan;0;0
2145;91398;56;51;13;2;11;.846;1219000;0
2145;141850;37;61;18;2;16;.889;3600000;0
2146;37077;4837;0;0;0;0;.00nan;0;0
2146;47112;4837;42;20;3;17;.850;3730000;0
2146;79132;49;87;51;4;47;.922;3730000;0
2146;91225;49;0;0;0;0;.00nan;0;0
2147;501;42;0;0;0;0;.00nan;0;0
2147;38276;47;0;0;0;0;.00nan;0;0
2147;87798;47;35;18;4;14;.778;3600000;0
2147;141496;42;100;50;1;49;.980;3600000;0
2148;175912;57;0;0;0;0;.00nan;0;0
2148;57152;57;33;38;6;32;.842;3600000;0
2148;58054;59;100;28;0;28;1.000;3600000;0
2148;69902;59;0;0;0;0;.00nan;0;0
2149;171673;50;57;23;3;20;.870;3600000;0
2149;176136;45;67;52;6;46;.885;2711000;0
2149;68799;50;0;0;0;0;.00nan;0;0
2149;141484;45;62;10;0;10;1.000;889000;0
2150;171838;41;97;45;2;43;.956;3600000;0
2150;170977;41;0;0;0;0;.00nan;0;0
2150;58037;53;0;0;0;0;.00nan;0;0
2150;78581;53;67;15;1;14;.933;3600000;0
2151;164715;63;0;0;0;0;.00nan;0;0
2151;173699;36;38;30;6;24;.800;3600000;0
2151;74734;36;0;0;0;0;.00nan;0;0
2151;149584;63;65;20;1;19;.950;3600000;0
2152;168651;40;0;0;0;0;.00nan;0;0
2152;170294;60;0;0;0;0;.00nan;0;0
2152;85797;60;74;30;2;28;.933;3900000;0
2152;142492;40;100;37;2;35;.946;3900000;0
2153;175084;65;0;0;0;0;.00nan;0;0
2153;180316;52;0;0;0;0;.00nan;0;0
2153;37857;52;36;26;5;21;.808;3565000;0
2153;38209;65;63;29;3;26;.897;3600000;0
2154;163462;55;0;0;0;0;.00nan;0;0
2154;59239;43;0;0;0;0;.00nan;0;0
2154;86862;55;79;37;3;34;.919;3574000;0
2154;90164;43;58;18;2;16;.889;3600000;0
2155;172340;48;0;0;0;0;.00nan;0;0
2155;170598;54;0;0;0;0;.00nan;0;0
2155;78775;48;63;29;3;26;.897;3600000;0
2155;94615;54;52;37;5;32;.865;3521000;0
2156;173727;61;0;0;0;0;.00nan;0;0
2156;170314;4619;82;41;3;38;.927;3600000;0
2156;57207;61;70;38;4;34;.895;3550000;0
2156;64800;4619;0;0;0;0;.00nan;0;0
2157;163471;62;0;0;0;0;.00nan;0;0
2157;168586;44;0;0;0;0;.00nan;0;0
2157;36346;62;83;33;2;31;.939;3900000;0
2157;64811;44;76;24;2;22;.917;3900000;0
2158;171838;41;98;48;2;46;.958;3568000;0
2158;170977;41;0;0;0;0;.00nan;0;0
2158;58037;53;0;0;0;0;.00nan;0;0
2158;78581;53;90;16;0;16;1.000;3600000;0
2159;165582;64;77;22;1;21;.955;3600000;0
2159;168872;64;0;0;0;0;.00nan;0;0
2159;176136;45;0;0;0;0;.00nan;0;0
2159;141484;45;54;36;6;30;.833;3600000;0
2160;162945;38;86;17;0;17;1.000;3600000;0
2160;180929;51;53;27;3;24;.889;3600000;0
2160;85428;38;0;0;0;0;.00nan;0;0
2160;149455;51;0;0;0;0;.00nan;0;0
2161;58100;56;0;0;0;0;.00nan;0;0
2161;60773;37;75;30;2;28;.933;3600000;0
2161;91398;56;68;37;4;33;.892;3600000;0
2161;141850;37;0;0;0;0;.00nan;0;0
2162;37077;4837;44;18;3;15;.833;3600000;0
2162;47112;4837;0;0;0;0;.00nan;0;0
2162;79132;49;0;0;0;0;.00nan;0;0
2162;91225;49;82;45;4;41;.911;3600000;0
2163;501;42;77;47;4;43;.915;3593000;0
2163;38276;47;52;19;3;16;.842;3600000;0
2163;87798;47;0;0;0;0;.00nan;0;0
2163;141496;42;0;0;0;0;.00nan;0;0
2164;178413;39;0;0;0;0;.00nan;0;0
2164;58054;59;62;22;3;19;.864;3600000;0
2164;69902;59;0;0;0;0;.00nan;0;0
2164;85636;39;59;26;4;22;.846;3559000;0
2165;164715;63;96;39;2;37;.949;3600000;0
2165;59239;43;43;22;4;18;.818;3575000;0
2165;90164;43;0;0;0;0;.00nan;0;0
2165;149584;63;0;0;0;0;.00nan;0;0
2166;171608;46;0;0;0;0;.00nan;0;0
2166;171673;50;0;0;0;0;.00nan;0;0
2166;68799;50;37;21;4;17;.810;3600000;0
2166;68938;46;77;25;1;24;.960;3600000;0
2167;168651;40;27;31;6;25;.806;2871000;0
2167;170294;60;0;0;0;0;.00nan;0;0
2167;85797;60;83;32;2;30;.938;3600000;0
2167;142492;40;61;6;0;6;1.000;729000;0
2168;175084;65;100;37;2;35;.946;3900000;0
2168;180316;52;0;0;0;0;.00nan;0;0
2168;37857;52;68;29;2;27;.931;3900000;0
2168;38209;65;0;0;0;0;.00nan;0;0
2169;172340;48;42;28;5;23;.821;3600000;0
2169;170598;54;99;33;1;32;.970;3600000;0
2169;78775;48;0;0;0;0;.00nan;0;0
2169;94615;54;0;0;0;0;.00nan;0;0
2170;173727;61;55;37;5;32;.865;3600000;0
2170;170314;4619;0;0;0;0;.00nan;0;0
2170;57207;61;0;0;0;0;.00nan;0;0
2170;64800;4619;68;24;2;22;.917;3600000;0
2171;163462;55;38;18;4;14;.778;3900000;0
2171;173699;36;0;0;0;0;.00nan;0;0
2171;74734;36;66;38;4;34;.895;3900000;0
2171;86862;55;0;0;0;0;.00nan;0;0
2172;175912;57;84;33;2;31;.939;3900000;0
2172;176206;58;0;0;0;0;.00nan;0;0
2172;46780;58;100;39;2;37;.949;3900000;0
2172;57152;57;0;0;0;0;.00nan;0;0
2173;165582;64;0;0;0;0;.00nan;0;0
2173;168872;64;100;42;2;40;.952;3600000;0
2173;171608;46;24;37;7;30;.811;3600000;0
2173;68938;46;0;0;0;0;.00nan;0;0
2174;178413;39;63;23;2;21;.913;3600000;0
2174;176206;58;45;37;6;31;.838;3342000;0
2174;46780;58;41;2;1;1;.500;258000;0
2174;85636;39;0;0;0;0;.00nan;0;0
2175;180316;52;0;0;0;0;.00nan;0;0
2175;37857;52;83;32;1;31;.969;3600000;0
2175;58037;53;0;0;0;0;.00nan;0;0
2175;78581;53;82;40;3;37;.925;3539000;0
2176;176136;45;68;12;0;12;1.000;399000;0
2176;38276;47;0;0;0;0;.00nan;0;0
2176;87798;47;44;11;2;9;.818;3600000;0
2176;141484;45;63;60;7;53;.883;3201000;0
2177;170314;4619;68;17;1;16;.941;3600000;0
2177;64800;4619;0;0;0;0;.00nan;0;0
2177;79132;49;47;42;6;36;.857;3014000;0
2177;91225;49;49;9;1;8;.889;586000;0
2178;171608;46;0;0;0;0;.00nan;0;0
2178;171673;50;66;29;3;26;.897;3600000;0
2178;68799;50;0;0;0;0;.00nan;0;0
2178;68938;46;47;38;5;33;.868;3555000;0
2179;163471;62;82;34;2;32;.941;3572000;0
2179;173727;61;100;33;0;33;1.000;3600000;0
2179;36346;62;0;0;0;0;.00nan;0;0
2179;57207;61;0;0;0;0;.00nan;0;0
2180;171838;41;0;0;0;0;.00nan;0;0
2180;170977;41;65;54;7;47;.870;3600000;0
2180;175084;65;0;0;0;0;.00nan;0;0
2180;38209;65;63;15;1;14;.933;3600000;0
2181;172340;48;0;0;0;0;.00nan;0;0
2181;170294;60;54;5;0;5;1.000;1287000;0
2181;78775;48;86;33;2;31;.939;3600000;0
2181;85797;60;31;21;5;16;.762;2313000;0
2182;162945;38;48;38;6;32;.842;3576000;0
2182;180316;52;0;0;0;0;.00nan;0;0
2182;37857;52;68;36;4;32;.889;3600000;0
2182;85428;38;0;0;0;0;.00nan;0;0
2183;173699;36;78;52;5;47;.904;3600000;0
2183;59239;43;0;0;0;0;.00nan;0;0
2183;74734;36;0;0;0;0;.00nan;0;0
2183;90164;43;80;19;1;18;.947;3600000;0
2184;176206;58;0;0;0;0;.00nan;0;0
2184;46780;58;53;31;4;27;.871;3600000;0
2184;58054;59;76;19;1;18;.947;3600000;0
2184;69902;59;0;0;0;0;.00nan;0;0
2185;163462;55;0;0;0;0;.00nan;0;0
2185;164715;63;0;0;0;0;.00nan;0;0
2185;86862;55;52;35;5;30;.857;3596000;0
2185;149584;63;70;39;4;35;.897;3600000;0
2186;178413;39;0;0;0;0;.00nan;0;0
2186;175912;57;0;0;0;0;.00nan;0;0
2186;57152;57;99;38;1;37;.974;3600000;0
2186;85636;39;70;26;2;24;.923;3549000;0
2187;165582;64;86;32;2;30;.938;3600000;0
2187;168872;64;0;0;0;0;.00nan;0;0
2187;180929;51;0;0;0;0;.00nan;0;0
2187;149455;51;83;48;3;45;.938;3600000;0
2188;168586;44;0;0;0;0;.00nan;0;0
2188;168651;40;40;15;3;12;.800;757000;0
2188;64811;44;51;21;3;18;.857;3600000;0
2188;142492;40;48;36;6;30;.833;2843000;0
2189;171838;41;88;49;4;45;.918;3597000;0
2189;170977;41;0;0;0;0;.00nan;0;0
2189;175084;65;0;0;0;0;.00nan;0;0
2189;38209;65;52;22;3;19;.864;3600000;0
2190;180316;52;0;0;0;0;.00nan;0;0
2190;37857;52;56;28;4;24;.857;3516000;0
2190;58037;53;0;0;0;0;.00nan;0;0
2190;78581;53;57;16;2;14;.875;3600000;0
2191;172340;48;59;19;2;17;.895;3600000;0
2191;170294;60;0;0;0;0;.00nan;0;0
2191;78775;48;0;0;0;0;.00nan;0;0
2191;85797;60;48;34;6;28;.824;3600000;0
2192;162945;38;98;40;2;38;.950;3600000;0
2192;175912;57;0;0;0;0;.00nan;0;0
2192;57152;57;55;35;4;31;.886;3513000;0
2192;85428;38;0;0;0;0;.00nan;0;0
2193;501;42;0;0;0;0;.00nan;0;0
2193;37077;4837;0;0;0;0;.00nan;0;0
2193;47112;4837;63;22;2;20;.909;3550000;0
2193;141496;42;99;42;1;41;.976;3600000;0
2194;164715;63;0;0;0;0;.00nan;0;0
2194;59239;43;0;0;0;0;.00nan;0;0
2194;90164;43;93;19;0;19;1.000;3600000;0
2194;149584;63;72;49;5;44;.898;3600000;0
2195;176206;58;0;0;0;0;.00nan;0;0
2195;46780;58;65;39;5;34;.872;3600000;0
2195;58054;59;39;17;4;13;.765;3600000;0
2195;69902;59;0;0;0;0;.00nan;0;0
2196;171608;46;0;0;0;0;.00nan;0;0
2196;176136;45;51;38;5;33;.868;3595000;0
2196;68938;46;47;25;4;21;.840;3600000;0
2196;141484;45;0;0;0;0;.00nan;0;0
2197;170314;4619;88;34;1;33;.971;3600000;0
2197;64800;4619;0;0;0;0;.00nan;0;0
2197;79132;49;56;45;6;39;.867;3600000;0
2197;91225;49;0;0;0;0;.00nan;0;0
2198;171673;50;100;30;0;30;1.000;3600000;0
2198;60773;37;0;0;0;0;.00nan;0;0
2198;68799;50;0;0;0;0;.00nan;0;0
2198;141850;37;83;37;3;34;.919;3600000;0
2199;173727;61;85;46;3;43;.935;3567000;0
2199;38276;47;0;0;0;0;.00nan;0;0
2199;57207;61;0;0;0;0;.00nan;0;0
2199;87798;47;66;19;1;18;.947;3600000;0
2200;163462;55;0;0;0;0;.00nan;0;0
2200;58100;56;21;3;3;0;.000;446000;0
2200;86862;55;100;39;1;38;.974;3600000;0
2200;91398;56;59;33;4;29;.879;3154000;0
2201;163471;62;80;15;0;15;1.000;3600000;0
2201;170598;54;0;0;0;0;.00nan;0;0
2201;36346;62;0;0;0;0;.00nan;0;0
2201;94615;54;62;33;4;29;.879;3600000;0
2202;178413;39;0;0;0;0;.00nan;0;0
2202;173699;36;100;51;2;49;.961;3900000;0
2202;74734;36;0;0;0;0;.00nan;0;0
2202;85636;39;71;27;2;25;.926;3900000;0
2203;168586;44;79;26;2;24;.923;3600000;0
2203;168651;40;74;44;4;40;.909;3573000;0
2203;64811;44;0;0;0;0;.00nan;0;0
2203;142492;40;0;0;0;0;.00nan;0;0
2204;180316;52;100;37;0;37;1.000;3600000;0
2204;37857;52;0;0;0;0;.00nan;0;0
2204;58037;53;0;0;0;0;.00nan;0;0
2204;78581;53;68;24;2;22;.917;3600000;0
2205;165582;64;79;19;1;18;.947;3900000;0
2205;168872;64;0;0;0;0;.00nan;0;0
2205;180929;51;96;53;1;52;.981;3900000;0
2205;149455;51;0;0;0;0;.00nan;0;0
2206;172340;48;0;0;0;0;.00nan;0;0
2206;173727;61;0;0;0;0;.00nan;0;0
2206;57207;61;73;40;5;35;.875;3900000;0
2206;78775;48;58;35;5;30;.857;3900000;0
2207;162945;38;0;0;0;0;.00nan;0;0
2207;175084;65;84;36;2;34;.944;3600000;0
2207;38209;65;0;0;0;0;.00nan;0;0
2207;85428;38;60;29;3;26;.897;3550000;0
2208;501;42;64;29;3;26;.897;3558000;0
2208;37077;4837;74;29;2;27;.931;3600000;0
2208;47112;4837;0;0;0;0;.00nan;0;0
2208;141496;42;0;0;0;0;.00nan;0;0
2209;171838;41;89;48;3;45;.938;3600000;0
2209;170977;41;0;0;0;0;.00nan;0;0
2209;176206;58;75;26;2;24;.923;3600000;0
2209;46780;58;0;0;0;0;.00nan;0;0
2210;164715;63;59;47;5;42;.894;3600000;0
2210;59239;43;0;0;0;0;.00nan;0;0
2210;90164;43;84;25;1;24;.960;3600000;0
2210;149584;63;0;0;0;0;.00nan;0;0
2211;175912;57;68;44;5;39;.886;3600000;0
2211;57152;57;0;0;0;0;.00nan;0;0
2211;58054;59;0;0;0;0;.00nan;0;0
2211;69902;59;95;18;0;18;1.000;3600000;0
2212;170294;60;0;0;0;0;.00nan;0;0
2212;170314;4619;55;10;1;9;.900;1306000;0
2212;64800;4619;33;17;4;13;.765;2294000;0
2212;85797;60;88;25;1;24;.960;3600000;0
2213;171608;46;87;40;3;37;.925;3588000;0
2213;171673;50;67;23;2;21;.913;3600000;0
2213;68799;50;0;0;0;0;.00nan;0;0
2213;68938;46;0;0;0;0;.00nan;0;0
2214;38276;47;45;12;2;10;.833;3600000;0
2214;79132;49;0;0;0;0;.00nan;0;0
2214;87798;47;0;0;0;0;.00nan;0;0
2214;91225;49;94;52;4;48;.923;3571000;0
2215;163462;55;50;31;5;26;.839;3560000;0
2215;58100;56;52;27;4;23;.852;3600000;0
2215;86862;55;0;0;0;0;.00nan;0;0
2215;91398;56;0;0;0;0;.00nan;0;0
2216;163471;62;85;28;1;27;.964;3600000;0
2216;170598;54;89;41;2;39;.951;3600000;0
2216;36346;62;0;0;0;0;.00nan;0;0
2216;94615;54;0;0;0;0;.00nan;0;0
2217;178413;39;84;34;2;32;.941;3900000;0
2217;173699;36;0;0;0;0;.00nan;0;0
2217;74734;36;95;40;2;38;.950;3900000;0
2217;85636;39;0;0;0;0;.00nan;0;0
2218;163471;62;62;34;4;30;.882;3600000;0
2218;168651;40;0;0;0;0;.00nan;0;0
2218;36346;62;0;0;0;0;.00nan;0;0
2218;142492;40;83;32;1;31;.969;3600000;0
2219;173699;36;48;6;1;5;.833;326000;0
2219;58100;56;0;0;0;0;.00nan;0;0
2219;74734;36;31;38;7;31;.816;3274000;0
2219;91398;56;92;30;2;28;.933;3600000;0
2220;170294;60;78;25;2;23;.920;3600000;0
2220;38276;47;0;0;0;0;.00nan;0;0
2220;85797;60;0;0;0;0;.00nan;0;0
2220;87798;47;54;24;3;21;.875;3582000;0
2221;180316;52;0;0;0;0;.00nan;0;0
2221;180929;51;0;0;0;0;.00nan;0;0
2221;37857;52;71;28;2;26;.929;3582000;0
2221;149455;51;89;39;1;38;.974;3600000;0
2222;168586;44;0;0;0;0;.00nan;0;0
2222;64811;44;66;16;2;14;.875;3600000;0
2222;79132;49;59;39;4;35;.897;3565000;0
2222;91225;49;0;0;0;0;.00nan;0;0
2223;171608;46;0;0;0;0;.00nan;0;0
2223;60773;37;0;0;0;0;.00nan;0;0
2223;68938;46;68;33;3;30;.909;3514000;0
2223;141850;37;57;12;1;11;.917;3600000;0
2224;171838;41;70;39;4;35;.897;3600000;0
2224;162945;38;78;21;1;20;.952;3600000;0
2224;170977;41;0;0;0;0;.00nan;0;0
2224;85428;38;0;0;0;0;.00nan;0;0
2225;501;42;0;0;0;0;.00nan;0;0
2225;173727;61;67;32;3;29;.906;3600000;0
2225;57207;61;0;0;0;0;.00nan;0;0
2225;141496;42;89;35;2;33;.943;3600000;0
2226;175912;57;0;0;0;0;.00nan;0;0
2226;57152;57;97;44;1;43;.977;3900000;0
2226;58054;59;0;0;0;0;.00nan;0;0
2226;69902;59;84;23;1;22;.957;3900000;0
2227;170314;4619;75;26;2;24;.923;3600000;0
2227;37077;4837;54;32;4;28;.875;3558000;0
2227;47112;4837;0;0;0;0;.00nan;0;0
2227;64800;4619;0;0;0;0;.00nan;0;0
2228;176206;58;0;0;0;0;.00nan;0;0
2228;46780;58;81;38;3;35;.921;3600000;0
2228;58037;53;0;0;0;0;.00nan;0;0
2228;78581;53;70;20;2;18;.900;3600000;0
2229;163462;55;0;0;0;0;.00nan;0;0
2229;164715;63;0;0;0;0;.00nan;0;0
2229;86862;55;43;28;4;24;.857;3584000;0
2229;149584;63;72;34;3;31;.912;3600000;0
2230;170598;54;99;43;1;42;.977;3600000;0
2230;171673;50;68;29;2;27;.931;3542000;0
2230;68799;50;0;0;0;0;.00nan;0;0
2230;94615;54;0;0;0;0;.00nan;0;0
2231;178413;39;0;0;0;0;.00nan;0;0
2231;59239;43;0;0;0;0;.00nan;0;0
2231;85636;39;85;42;3;39;.929;3554000;0
2231;90164;43;87;26;1;25;.962;3600000;0
2232;173699;36;0;0;0;0;.00nan;0;0
2232;58100;56;22;23;6;17;.739;3600000;0
2232;74734;36;77;37;3;34;.919;3600000;0
2232;91398;56;0;0;0;0;.00nan;0;0
2233;171838;41;53;41;6;35;.854;2642000;0
2233;170977;41;61;18;1;17;.944;958000;0
2233;58054;59;86;12;0;12;1.000;3600000;0
2233;69902;59;0;0;0;0;.00nan;0;0
2234;170294;60;0;0;0;0;.00nan;0;0
2234;38276;47;46;40;6;34;.850;3190000;0
2234;85797;60;100;41;0;41;1.000;3600000;0
2234;87798;47;49;1;0;1;1.000;410000;0
2235;172340;48;86;24;1;23;.958;3600000;0
2235;37077;4837;0;0;0;0;.00nan;0;0
2235;47112;4837;49;29;4;25;.862;3600000;0
2235;78775;48;0;0;0;0;.00nan;0;0
2236;168586;44;0;0;0;0;.00nan;0;0
2236;64811;44;80;28;2;26;.929;3600000;0
2236;79132;49;0;0;0;0;.00nan;0;0
2236;91225;49;69;41;4;37;.902;3578000;0
2237;171608;46;90;43;2;41;.953;3525000;0
2237;60773;37;0;0;0;0;.00nan;0;0
2237;68938;46;0;0;0;0;.00nan;0;0
2237;141850;37;88;16;0;16;1.000;3600000;0
2238;162945;38;0;0;0;0;.00nan;0;0
2238;58037;53;0;0;0;0;.00nan;0;0
2238;78581;53;87;31;2;29;.935;3600000;0
2238;85428;38;60;35;4;31;.886;3569000;0
2239;501;42;76;35;3;32;.914;3547000;0
2239;173727;61;0;0;0;0;.00nan;0;0
2239;57207;61;99;44;2;42;.955;3600000;0
2239;141496;42;0;0;0;0;.00nan;0;0
2240;170598;54;0;0;0;0;.00nan;0;0
2240;176136;45;66;16;1;15;.938;3600000;0
2240;94615;54;77;35;3;32;.914;3589000;0
2240;141484;45;0;0;0;0;.00nan;0;0
2241;165582;64;98;42;1;41;.976;3900000;0
2241;168872;64;0;0;0;0;.00nan;0;0
2241;171673;50;0;0;0;0;.00nan;0;0
2241;68799;50;72;24;1;23;.958;3900000;0
2242;163471;62;61;46;5;41;.891;3600000;0
2242;168651;40;90;29;1;28;.966;3600000;0
2242;36346;62;0;0;0;0;.00nan;0;0
2242;142492;40;0;0;0;0;.00nan;0;0
2243;175084;65;0;0;0;0;.00nan;0;0
2243;176206;58;99;44;1;43;.977;3623000;0
2243;38209;65;61;22;2;20;.909;3623000;0
2243;46780;58;0;0;0;0;.00nan;0;0
2244;163462;55;68;18;1;17;.944;3600000;0
2244;164715;63;56;44;6;38;.864;3600000;0
2244;86862;55;0;0;0;0;.00nan;0;0
2244;149584;63;0;0;0;0;.00nan;0;0
2245;178413;39;93;39;2;37;.949;3600000;0
2245;59239;43;62;36;4;32;.889;3600000;0
2245;85636;39;0;0;0;0;.00nan;0;0
2245;90164;43;0;0;0;0;.00nan;0;0
2246;180316;52;0;0;0;0;.00nan;0;0
2246;180929;51;61;29;3;26;.897;3543000;0
2246;37857;52;87;28;1;27;.964;3600000;0
2246;149455;51;0;0;0;0;.00nan;0;0
2247;170294;60;0;0;0;0;.00nan;0;0
2247;171608;46;0;0;0;0;.00nan;0;0
2247;68938;46;88;57;5;52;.912;3600000;0
2247;85797;60;82;24;1;23;.958;3600000;0
2248;180929;51;0;0;0;0;.00nan;0;0
2248;60773;37;56;4;0;4;1.000;1489000;0
2248;141850;37;25;9;4;5;.556;2111000;0
2248;149455;51;49;45;7;38;.844;3600000;0
2249;163471;62;81;35;2;33;.943;3600000;0
2249;36346;62;0;0;0;0;.00nan;0;0
2249;79132;49;68;35;3;32;.914;3600000;0
2249;91225;49;0;0;0;0;.00nan;0;0
2250;165582;64;54;24;4;20;.833;3600000;0
2250;168872;64;0;0;0;0;.00nan;0;0
2250;176136;45;40;26;4;22;.846;2294000;0
2250;141484;45;37;15;3;12;.800;1306000;0
2251;170598;54;0;0;0;0;.00nan;0;0
2251;171673;50;33;20;5;15;.750;3545000;0
2251;68799;50;0;0;0;0;.00nan;0;0
2251;94615;54;99;57;4;53;.930;3600000;0
2252;163462;55;0;0;0;0;.00nan;0;0
2252;58100;56;0;0;0;0;.00nan;0;0
2252;86862;55;83;29;2;27;.931;3600000;0
2252;91398;56;82;50;4;46;.920;3574000;0
2253;170294;60;0;0;0;0;.00nan;0;0
2253;171608;46;80;26;1;25;.962;3600000;0
2253;68938;46;0;0;0;0;.00nan;0;0
2253;85797;60;73;27;2;25;.926;3547000;0
2254;163471;62;0;0;0;0;.00nan;0;0
2254;36346;62;68;24;2;22;.917;3600000;0
2254;79132;49;0;0;0;0;.00nan;0;0
2254;91225;49;57;47;5;42;.894;3600000;0
2255;176206;58;0;0;0;0;.00nan;0;0
2255;46780;58;73;49;5;44;.898;3600000;0
2255;58054;59;72;23;1;22;.957;3600000;0
2255;69902;59;0;0;0;0;.00nan;0;0
2256;168651;40;0;0;0;0;.00nan;0;0
2256;38276;47;0;0;0;0;.00nan;0;0
2256;87798;47;69;26;2;24;.923;3600000;0
2256;142492;40;74;36;3;33;.917;3579000;0
2257;178413;39;0;0;0;0;.00nan;0;0
2257;175912;57;0;0;0;0;.00nan;0;0
2257;57152;57;99;35;1;34;.971;3900000;0
2257;85636;39;87;23;1;22;.957;3900000;0
2258;164715;63;0;0;0;0;.00nan;0;0
2258;173699;36;0;0;0;0;.00nan;0;0
2258;74734;36;85;49;4;45;.918;3900000;0
2258;149584;63;59;32;4;28;.875;3900000;0
2259;172340;48;0;0;0;0;.00nan;0;0
2259;168651;40;92;50;3;47;.940;3600000;0
2259;78775;48;34;20;4;16;.800;3562000;0
2259;142492;40;0;0;0;0;.00nan;0;0
2260;178413;39;57;29;4;25;.862;3658000;0
2260;58100;56;0;0;0;0;.00nan;0;0
2260;85636;39;0;0;0;0;.00nan;0;0
2260;91398;56;88;40;3;37;.925;3658000;0
2261;180929;51;56;37;5;32;.865;3600000;0
2261;60773;37;0;0;0;0;.00nan;0;0
2261;141850;37;55;18;2;16;.889;3600000;0
2261;149455;51;0;0;0;0;.00nan;0;0
2262;162945;38;91;40;1;39;.975;3600000;0
2262;59239;43;0;0;0;0;.00nan;0;0
2262;85428;38;0;0;0;0;.00nan;0;0
2262;90164;43;54;24;4;20;.833;3600000;0
2263;171838;41;100;47;2;45;.957;3900000;0
2263;170977;41;0;0;0;0;.00nan;0;0
2263;58037;53;64;23;2;21;.913;3900000;0
2263;78581;53;0;0;0;0;.00nan;0;0
2264;164715;63;70;26;2;24;.923;3569000;0
2264;175912;57;0;0;0;0;.00nan;0;0
2264;57152;57;100;33;0;33;1.000;3600000;0
2264;149584;63;0;0;0;0;.00nan;0;0
2265;165582;64;76;29;2;27;.931;3600000;0
2265;168872;64;0;0;0;0;.00nan;0;0
2265;171673;50;71;37;3;34;.919;3600000;0
2265;68799;50;0;0;0;0;.00nan;0;0
2266;501;42;0;0;0;0;.00nan;0;0
2266;170598;54;0;0;0;0;.00nan;0;0
2266;94615;54;46;28;5;23;.821;3600000;0
2266;141496;42;77;25;1;24;.960;3600000;0
2267;173727;61;33;21;5;16;.762;2123000;0
2267;170314;4619;85;32;2;30;.938;3600000;0
2267;57207;61;58;16;1;15;.938;1477000;0
2267;64800;4619;0;0;0;0;.00nan;0;0
2268;168586;44;0;0;0;0;.00nan;0;0
2268;170294;60;0;0;0;0;.00nan;0;0
2268;64811;44;61;26;3;23;.885;3598000;0
2268;85797;60;83;30;2;28;.933;3600000;0
2269;163471;62;80;33;2;31;.939;3543000;0
2269;168651;40;0;0;0;0;.00nan;0;0
2269;36346;62;0;0;0;0;.00nan;0;0
2269;142492;40;91;33;1;32;.970;3600000;0
2270;171838;41;100;42;1;41;.976;3600000;0
2270;162945;38;0;0;0;0;.00nan;0;0
2270;170977;41;0;0;0;0;.00nan;0;0
2270;85428;38;67;24;2;22;.917;3552000;0
2271;175084;65;0;0;0;0;.00nan;0;0
2271;180316;52;0;0;0;0;.00nan;0;0
2271;37857;52;84;26;1;25;.962;3600000;0
2271;38209;65;66;23;2;21;.913;3551000;0
2272;165582;64;0;0;0;0;.00nan;0;0
2272;168872;64;36;24;4;20;.833;3576000;0
2272;180929;51;0;0;0;0;.00nan;0;0
2272;149455;51;99;45;2;43;.956;3600000;0
2273;172340;48;66;21;2;19;.905;3900000;0
2273;78775;48;0;0;0;0;.00nan;0;0
2273;79132;49;92;45;2;43;.956;3900000;0
2273;91225;49;0;0;0;0;.00nan;0;0
2274;163462;55;0;0;0;0;.00nan;0;0
2274;58054;59;49;20;3;17;.850;3513000;0
2274;69902;59;0;0;0;0;.00nan;0;0
2274;86862;55;93;28;1;27;.964;3600000;0
2275;171608;46;0;0;0;0;.00nan;0;0
2275;176136;45;68;44;5;39;.886;3600000;0
2275;68938;46;79;23;1;22;.957;3600000;0
2275;141484;45;0;0;0;0;.00nan;0;0
2276;171673;50;48;21;3;18;.857;3543000;0
2276;60773;37;0;0;0;0;.00nan;0;0
2276;68799;50;0;0;0;0;.00nan;0;0
2276;141850;37;75;24;2;22;.917;3600000;0
2277;37077;4837;0;0;0;0;.00nan;0;0
2277;38276;47;0;0;0;0;.00nan;0;0
2277;47112;4837;84;40;3;37;.925;3900000;0
2277;87798;47;60;28;3;25;.893;3900000;0
2278;501;42;0;0;0;0;.00nan;0;0
2278;170598;54;88;49;4;45;.918;3600000;0
2278;94615;54;0;0;0;0;.00nan;0;0
2278;141496;42;82;17;0;17;1.000;3600000;0
2279;178413;39;0;0;0;0;.00nan;0;0
2279;176206;58;0;0;0;0;.00nan;0;0
2279;46780;58;97;48;2;46;.958;3566000;0
2279;85636;39;93;34;1;33;.971;3600000;0
2280;173727;61;0;0;0;0;.00nan;0;0
2280;170314;4619;69;29;3;26;.897;3900000;0
2280;57207;61;79;39;3;36;.923;3900000;0
2280;64800;4619;0;0;0;0;.00nan;0;0
2281;173699;36;0;0;0;0;.00nan;0;0
2281;58100;56;75;26;2;24;.923;3600000;0
2281;74734;36;65;31;3;28;.903;3600000;0
2281;91398;56;0;0;0;0;.00nan;0;0
2282;175912;57;62;7;0;7;1.000;671000;0
2282;57152;57;38;34;6;28;.824;2929000;0
2282;59239;43;57;20;2;18;.900;3600000;0
2282;90164;43;0;0;0;0;.00nan;0;0
2283;163471;62;0;0;0;0;.00nan;0;0
2283;36346;62;68;24;2;22;.917;3600000;0
2283;79132;49;0;0;0;0;.00nan;0;0
2283;91225;49;53;47;6;41;.872;3600000;0
2284;171838;41;87;48;4;44;.917;3598000;0
2284;170977;41;0;0;0;0;.00nan;0;0
2284;59239;43;0;0;0;0;.00nan;0;0
2284;90164;43;61;22;3;19;.864;3600000;0
2285;175084;65;0;0;0;0;.00nan;0;0
2285;180316;52;74;25;2;23;.920;3600000;0
2285;37857;52;0;0;0;0;.00nan;0;0
2285;38209;65;62;33;3;30;.909;3600000;0
2286;165582;64;14;11;5;6;.545;1112000;0
2286;168872;64;47;9;1;8;.889;2488000;0
2286;180929;51;82;31;1;30;.968;3600000;0
2286;149455;51;0;0;0;0;.00nan;0;0
2287;172340;48;0;0;0;0;.00nan;0;0
2287;37077;4837;98;40;2;38;.950;3599000;0
2287;47112;4837;0;0;0;0;.00nan;0;0
2287;78775;48;70;19;1;18;.947;3600000;0
2288;162945;38;81;51;4;47;.922;3540000;0
2288;58037;53;0;0;0;0;.00nan;0;0
2288;78581;53;66;22;2;20;.909;3600000;0
2288;85428;38;0;0;0;0;.00nan;0;0
2289;164715;63;0;0;0;0;.00nan;0;0
2289;173699;36;0;0;0;0;.00nan;0;0
2289;74734;36;44;35;6;29;.829;3549000;0
2289;149584;63;66;30;4;26;.867;3600000;0
2290;168586;44;38;6;2;4;.667;670000;0
2290;170294;60;0;0;0;0;.00nan;0;0
2290;64811;44;28;28;6;22;.786;2930000;0
2290;85797;60;49;32;5;27;.844;3600000;0
2291;163462;58;0;0;0;0;.00nan;0;0
2291;46780;58;89;33;1;32;.970;3600000;0
2291;58100;56;0;0;0;0;.00nan;0;0
2291;91398;56;55;31;4;27;.871;3600000;0
2292;501;42;0;0;0;0;.00nan;0;0
2292;171673;50;75;25;1;24;.960;3600000;0
2292;68799;50;0;0;0;0;.00nan;0;0
2292;141496;42;78;33;2;31;.939;3569000;0
2293;171608;46;46;22;4;18;.818;3563000;0
2293;176136;45;80;37;3;34;.919;3600000;0
2293;68938;46;0;0;0;0;.00nan;0;0
2293;141484;45;0;0;0;0;.00nan;0;0
2294;164715;63;91;47;3;44;.936;3600000;0
2294;178413;39;58;27;4;23;.852;3596000;0
2294;85636;39;0;0;0;0;.00nan;0;0
2294;149584;63;0;0;0;0;.00nan;0;0
2295;163471;62;97;61;3;58;.951;3572000;0
2295;36346;62;0;0;0;0;.00nan;0;0
2295;38276;47;0;0;0;0;.00nan;0;0
2295;87798;47;66;18;1;17;.944;3600000;0
2296;170598;54;0;0;0;0;.00nan;0;0
2296;60773;37;0;0;0;0;.00nan;0;0
2296;94615;54;68;43;5;38;.884;3600000;0
2296;141850;37;87;16;0;16;1.000;3600000;0
2297;171838;41;100;43;1;42;.977;3600000;0
2297;162945;38;48;23;3;20;.870;3514000;0
2297;170977;41;0;0;0;0;.00nan;0;0
2297;85428;38;0;0;0;0;.00nan;0;0
2298;501;42;72;30;2;28;.933;3600000;0
2298;171673;50;51;22;3;19;.864;3557000;0
2298;68799;50;0;0;0;0;.00nan;0;0
2298;141496;42;0;0;0;0;.00nan;0;0
2299;163462;58;0;0;0;0;.00nan;0;0
2299;46780;58;31;31;5;26;.839;3600000;0
2299;59239;43;0;0;0;0;.00nan;0;0
2299;90164;43;94;34;1;33;.971;3600000;0
2300;168586;44;0;0;0;0;.00nan;0;0
2300;170314;4619;100;34;0;34;1.000;3600000;0
2300;64800;4619;0;0;0;0;.00nan;0;0
2300;64811;44;69;26;2;24;.923;3554000;0
2301;164715;63;0;0;0;0;.00nan;0;0
2301;58100;56;0;0;0;0;.00nan;0;0
2301;91398;56;100;25;0;25;1.000;3600000;0
2301;149584;63;41;42;7;35;.833;3600000;0
2302;172340;48;75;29;2;27;.931;3900000;0
2302;168651;40;74;35;2;33;.943;3900000;0
2302;78775;48;0;0;0;0;.00nan;0;0
2302;142492;40;0;0;0;0;.00nan;0;0
2303;171608;59;0;0;0;0;.00nan;0;0
2303;175912;57;0;0;0;0;.00nan;0;0
2303;57152;57;99;53;1;52;.981;3600000;0
2303;58054;59;40;22;4;18;.818;3600000;0
2304;165582;64;89;19;0;19;1.000;3600000;0
2304;168872;64;0;0;0;0;.00nan;0;0
2304;176136;45;97;46;2;44;.957;3564000;0
2304;141484;45;0;0;0;0;.00nan;0;0
2305;37077;4837;0;0;0;0;.00nan;0;0
2305;47112;4837;65;24;3;21;.875;3644000;0
2305;79132;49;73;44;4;40;.909;3644000;0
2305;91225;49;0;0;0;0;.00nan;0;0
2306;163462;58;0;0;0;0;.00nan;0;0
2306;175912;57;0;0;0;0;.00nan;0;0
2306;46780;58;87;34;1;33;.971;3600000;0
2306;57152;57;65;44;4;40;.909;3600000;0
2307;178413;39;0;0;0;0;.00nan;0;0
2307;59239;43;0;0;0;0;.00nan;0;0
2307;85636;39;67;33;3;30;.909;3600000;0
2307;90164;43;82;28;1;27;.964;3600000;0
2308;170294;60;0;0;0;0;.00nan;0;0
2308;68938;46;0;0;0;0;.00nan;0;0
2308;79280;46;74;36;3;33;.917;3900000;0
2308;85797;60;78;28;3;25;.893;3900000;0
2309;172340;48;62;43;4;39;.907;3715000;0
2309;170314;4619;81;37;3;34;.919;3715000;0
2309;64800;4619;0;0;0;0;.00nan;0;0
2309;78775;48;0;0;0;0;.00nan;0;0
2310;180929;51;0;0;0;0;.00nan;0;0
2310;58037;53;0;0;0;0;.00nan;0;0
2310;78581;53;98;36;1;35;.972;3900000;0
2310;149455;51;89;34;1;33;.971;3900000;0
2311;164715;63;58;37;6;31;.838;3600000;0
2311;58100;56;85;33;2;31;.939;3600000;0
2311;91398;56;0;0;0;0;.00nan;0;0
2311;149584;63;0;0;0;0;.00nan;0;0
2312;170598;54;0;0;0;0;.00nan;0;0
2312;171673;50;76;18;1;17;.944;3600000;0
2312;68799;50;0;0;0;0;.00nan;0;0
2312;94615;54;94;49;3;46;.939;3600000;0
2313;168586;44;0;0;0;0;.00nan;0;0
2313;168651;40;0;0;0;0;.00nan;0;0
2313;64811;44;65;23;2;21;.913;3900000;0
2313;142492;40;86;37;2;35;.946;3900000;0
2314;162945;38;85;34;2;32;.941;3600000;0
2314;175084;65;47;27;4;23;.852;3537000;0
2314;38209;65;0;0;0;0;.00nan;0;0
2314;85428;38;0;0;0;0;.00nan;0;0
2315;163471;62;81;49;4;45;.918;3600000;0
2315;173727;61;100;26;0;26;1.000;3600000;0
2315;36346;62;0;0;0;0;.00nan;0;0
2315;57207;61;0;0;0;0;.00nan;0;0
2316;173699;36;0;0;0;0;.00nan;0;0
2316;65014;55;0;0;0;0;.00nan;0;0
2316;74734;36;84;31;2;29;.935;3580000;0
2316;86862;55;94;35;1;34;.971;3600000;0
2317;171608;59;0;0;0;0;.00nan;0;0
2317;180316;52;0;0;0;0;.00nan;0;0
2317;37857;52;53;35;4;31;.886;3600000;0
2317;58054;59;57;21;3;18;.857;3600000;0
2318;37077;4837;53;27;4;23;.852;3556000;0
2318;47112;4837;0;0;0;0;.00nan;0;0
2318;79132;49;0;0;0;0;.00nan;0;0
2318;91225;49;75;32;3;29;.906;3600000;0
2319;170598;54;98;49;3;46;.939;3600000;0
2319;60773;37;0;0;0;0;.00nan;0;0
2319;94615;54;0;0;0;0;.00nan;0;0
2319;141850;37;100;24;0;24;1.000;3600000;0
2320;162945;38;0;0;0;0;.00nan;0;0
2320;180929;51;97;36;1;35;.972;3600000;0
2320;85428;38;57;30;4;26;.867;3600000;0
2320;149455;51;0;0;0;0;.00nan;0;0
2321;163462;58;61;38;4;34;.895;3571000;0
2321;164715;63;0;0;0;0;.00nan;0;0
2321;46780;58;0;0;0;0;.00nan;0;0
2321;149584;63;84;35;2;33;.943;3600000;0
2322;178413;39;76;42;3;39;.929;3600000;0
2322;59239;43;54;28;4;24;.857;3600000;0
2322;85636;39;0;0;0;0;.00nan;0;0
2322;90164;43;0;0;0;0;.00nan;0;0
2323;170294;60;0;0;0;0;.00nan;0;0
2323;68938;46;0;0;0;0;.00nan;0;0
2323;79280;46;100;40;0;40;1.000;3600000;0
2323;85797;60;69;32;4;28;.875;3600000;0
2324;165582;64;61;26;3;23;.885;3526000;0
2324;168872;64;0;0;0;0;.00nan;0;0
2324;176136;45;95;32;1;31;.969;3600000;0
2324;141484;45;0;0;0;0;.00nan;0;0
2325;501;42;0;0;0;0;.00nan;0;0
2325;171673;50;0;0;0;0;.00nan;0;0
2325;68799;50;92;35;2;33;.943;3600000;0
2325;141496;42;84;35;3;32;.914;3559000;0
2326;170314;4619;89;43;2;41;.953;3549000;0
2326;38276;47;0;0;0;0;.00nan;0;0
2326;64800;4619;0;0;0;0;.00nan;0;0
2326;87798;47;84;27;1;26;.963;3600000;0
2327;168586;44;0;0;0;0;.00nan;0;0
2327;168651;40;60;26;3;23;.885;3900000;0
2327;64811;44;90;42;3;39;.929;3900000;0
2327;142492;40;0;0;0;0;.00nan;0;0
2328;175084;65;0;0;0;0;.00nan;0;0
2328;38209;65;85;27;1;26;.963;3600000;0
2328;58037;53;72;44;6;38;.864;2967000;0
2328;78581;53;58;7;0;7;1.000;633000;0
2329;58100;56;0;0;0;0;.00nan;0;0
2329;65014;55;49;23;3;20;.870;3600000;0
2329;86862;55;0;0;0;0;.00nan;0;0
2329;91398;56;55;31;4;27;.871;3584000;0
2330;163471;62;100;49;1;48;.980;3600000;0
2330;173727;61;65;30;3;27;.900;3559000;0
2330;36346;62;0;0;0;0;.00nan;0;0
2330;57207;61;0;0;0;0;.00nan;0;0
2331;171838;41;63;43;5;38;.884;3600000;0
2331;170977;41;0;0;0;0;.00nan;0;0
2331;175912;57;100;24;0;24;1.000;3600000;0
2331;57152;57;0;0;0;0;.00nan;0;0
2332;171838;41;51;27;4;23;.852;3600000;0
2332;170977;41;0;0;0;0;.00nan;0;0
2332;175084;65;35;32;6;26;.813;3581000;0
2332;38209;65;0;0;0;0;.00nan;0;0
2333;171608;59;0;0;0;0;.00nan;0;0
2333;180316;52;0;0;0;0;.00nan;0;0
2333;37857;52;57;43;6;37;.860;3600000;0
2333;58054;59;87;39;3;36;.923;3600000;0
2334;501;42;0;0;0;0;.00nan;0;0
2334;165582;64;0;0;0;0;.00nan;0;0
2334;168872;64;32;28;5;23;.821;3600000;0
2334;141496;42;99;27;0;27;1.000;3600000;0
2335;176136;45;0;0;0;0;.00nan;0;0
2335;60773;37;0;0;0;0;.00nan;0;0
2335;141484;45;84;40;3;37;.925;3600000;0
2335;141850;37;63;17;1;16;.941;3600000;0
2336;180929;51;0;0;0;0;.00nan;0;0
2336;58037;53;0;0;0;0;.00nan;0;0
2336;78581;53;57;24;4;20;.833;3900000;0
2336;149455;51;65;43;4;39;.907;3900000;0
2337;173699;36;0;0;0;0;.00nan;0;0
2337;65014;55;67;29;2;27;.931;3600000;0
2337;74734;36;72;31;3;28;.903;3600000;0
2337;86862;55;0;0;0;0;.00nan;0;0
2338;168586;44;73;26;2;24;.923;3600000;0
2338;64811;44;0;0;0;0;.00nan;0;0
2338;79132;49;36;33;6;27;.818;3600000;0
2338;91225;49;0;0;0;0;.00nan;0;0
2339;168651;40;0;0;0;0;.00nan;0;0
2339;170314;4619;92;36;1;35;.972;3900000;0
2339;64800;4619;0;0;0;0;.00nan;0;0
2339;142492;40;94;33;1;32;.970;3900000;0
2340;170598;54;0;0;0;0;.00nan;0;0
2340;38276;47;0;0;0;0;.00nan;0;0
2340;87798;47;45;18;3;15;.833;3600000;0
2340;94615;54;77;52;5;47;.904;3583000;0
2341;168586;44;0;0;0;0;.00nan;0;0
2341;64811;44;68;24;2;22;.917;3600000;0
2341;79132;49;0;0;0;0;.00nan;0;0
2341;91225;49;81;43;3;40;.930;3575000;0
2342;163471;62;91;31;1;30;.968;3600000;0
2342;173727;61;68;30;2;28;.933;3570000;0
2342;36346;62;0;0;0;0;.00nan;0;0
2342;57207;61;0;0;0;0;.00nan;0;0
2343;173699;36;0;0;0;0;.00nan;0;0
2343;74734;36;100;47;2;45;.957;3900000;0
2343;85336;56;0;0;0;0;.00nan;0;0
2343;91398;56;62;25;2;23;.920;3900000;0
2344;171838;41;0;0;0;0;.00nan;0;0
2344;170977;41;98;49;3;46;.939;3600000;0
2344;59239;43;0;0;0;0;.00nan;0;0
2344;90164;43;66;18;1;17;.944;3600000;0
2345;178413;39;0;0;0;0;.00nan;0;0
2345;180929;51;78;51;4;47;.922;3515000;0
2345;85636;39;62;20;2;18;.900;3600000;0
2345;149455;51;0;0;0;0;.00nan;0;0
2346;172340;48;0;0;0;0;.00nan;0;0
2346;168651;40;36;9;3;6;.667;493000;0
2346;78775;48;53;27;4;23;.852;3600000;0
2346;142492;40;67;42;5;37;.881;3107000;0
2347;501;42;49;8;1;7;.875;424000;0
2347;60773;37;0;0;0;0;.00nan;0;0
2347;141496;42;37;26;5;21;.808;3176000;0
2347;141850;37;74;20;1;19;.950;3600000;0
2348;162945;38;84;43;3;40;.930;3733000;0
2348;180316;52;0;0;0;0;.00nan;0;0
2348;37857;52;76;27;2;25;.926;3733000;0
2348;85428;38;0;0;0;0;.00nan;0;0
2349;164715;63;96;20;0;20;1.000;3600000;0
2349;65014;55;83;38;3;35;.921;3600000;0
2349;86862;55;0;0;0;0;.00nan;0;0
2349;149584;63;0;0;0;0;.00nan;0;0
2350;170598;54;35;15;4;11;.733;839000;0
2350;38276;47;78;24;1;23;.958;3600000;0
2350;87798;47;0;0;0;0;.00nan;0;0
2350;94615;54;72;36;4;32;.889;2761000;0
2351;172340;48;0;0;0;0;.00nan;0;0
2351;163471;62;57;32;4;28;.875;3600000;0
2351;36346;62;0;0;0;0;.00nan;0;0
2351;78775;48;82;23;1;22;.957;3600000;0
2352;164715;63;0;0;0;0;.00nan;0;0
2352;85336;56;0;0;0;0;.00nan;0;0
2352;91398;56;100;37;1;36;.973;3600000;0
2352;149584;63;81;34;2;32;.941;3562000;0
2353;170294;60;0;0;0;0;.00nan;0;0
2353;79132;49;98;36;1;35;.972;3600000;0
2353;85797;60;100;25;0;25;1.000;3600000;0
2353;91225;49;0;0;0;0;.00nan;0;0
2354;165582;64;52;18;3;15;.833;3600000;0
2354;168872;64;0;0;0;0;.00nan;0;0
2354;180929;51;0;0;0;0;.00nan;0;0
2354;149455;51;73;57;6;51;.895;3600000;0
2355;501;42;0;0;0;0;.00nan;0;0
2355;60773;37;74;22;1;21;.955;3600000;0
2355;141496;42;84;34;2;32;.941;3600000;0
2355;141850;37;0;0;0;0;.00nan;0;0
2356;162945;38;55;38;5;33;.868;3600000;0
2356;59239;43;0;0;0;0;.00nan;0;0
2356;85428;38;0;0;0;0;.00nan;0;0
2356;90164;43;68;17;1;16;.941;3600000;0
2357;173727;61;100;42;1;41;.976;3600000;0
2357;179306;61;0;0;0;0;.00nan;0;0
2357;37077;4837;58;32;4;28;.875;3600000;0
2357;47112;4837;0;0;0;0;.00nan;0;0
2358;171673;50;60;26;3;23;.885;3562000;0
2358;176136;45;99;37;1;36;.973;3600000;0
2358;68799;50;0;0;0;0;.00nan;0;0
2358;141484;45;0;0;0;0;.00nan;0;0
2359;170314;4619;50;30;4;26;.867;3786000;0
2359;38276;47;0;0;0;0;.00nan;0;0
2359;64800;4619;0;0;0;0;.00nan;0;0
2359;87798;47;66;29;3;26;.897;3786000;0
2360;175084;65;0;0;0;0;.00nan;0;0
2360;38209;65;43;29;5;24;.828;3600000;0
2360;58037;53;0;0;0;0;.00nan;0;0
2360;78581;53;43;50;7;43;.860;3535000;0
2361;178413;39;70;23;2;21;.913;3600000;0
2361;65014;55;76;36;3;33;.917;3600000;0
2361;85636;39;0;0;0;0;.00nan;0;0
2361;86862;55;0;0;0;0;.00nan;0;0
2362;173699;36;29;36;7;29;.806;2913000;0
2362;171608;59;0;0;0;0;.00nan;0;0
2362;58054;59;60;14;1;13;.929;3600000;0
2362;74734;36;16;7;4;3;.429;687000;0
2363;175912;57;83;34;2;32;.941;3515000;0
2363;180316;52;0;0;0;0;.00nan;0;0
2363;37857;52;86;18;0;18;1.000;3600000;0
2363;57152;57;0;0;0;0;.00nan;0;0
2364;163471;62;0;0;0;0;.00nan;0;0
2364;168586;44;0;0;0;0;.00nan;0;0
2364;36346;62;81;40;2;38;.950;3535000;0
2364;64811;44;87;19;0;19;1.000;3600000;0
2365;164715;63;33;29;6;23;.793;2646000;0
2365;85336;56;53;22;3;19;.864;3600000;0
2365;91398;56;0;0;0;0;.00nan;0;0
2365;149584;63;61;5;0;5;1.000;954000;0
2366;165582;64;77;25;2;23;.920;3541000;0
2366;168872;64;0;0;0;0;.00nan;0;0
2366;180929;51;93;33;1;32;.970;3600000;0
2366;149455;51;0;0;0;0;.00nan;0;0
2367;162945;50;80;35;3;32;.914;3600000;0
2367;171673;50;0;0;0;0;.00nan;0;0
2367;60773;37;0;0;0;0;.00nan;0;0
2367;141850;37;53;33;5;28;.848;3576000;0
2368;173727;61;88;39;2;37;.949;3545000;0
2368;179306;61;0;0;0;0;.00nan;0;0
2368;37077;4837;0;0;0;0;.00nan;0;0
2368;47112;4837;72;22;1;21;.955;3600000;0
2369;163462;58;0;0;0;0;.00nan;0;0
2369;173699;36;0;0;0;0;.00nan;0;0
2369;46780;58;62;30;4;26;.867;3789000;0
2369;74734;36;83;52;5;47;.904;3789000;0
2370;171838;41;81;39;3;36;.923;3600000;0
2370;170977;41;0;0;0;0;.00nan;0;0
2370;171608;59;0;0;0;0;.00nan;0;0
2370;58054;59;74;23;1;22;.957;3600000;0
2371;170598;54;0;0;0;0;.00nan;0;0
2371;68938;46;0;0;0;0;.00nan;0;0
2371;79280;46;59;21;3;18;.857;3600000;0
2371;94615;54;55;35;5;30;.857;3568000;0
2372;172340;48;44;26;4;22;.846;3570000;0
2372;168651;40;0;0;0;0;.00nan;0;0
2372;78775;48;0;0;0;0;.00nan;0;0
2372;142492;40;90;49;3;46;.939;3600000;0
2373;175084;65;55;38;5;33;.868;3127000;0
2373;38209;65;60;6;0;6;1.000;416000;0
2373;59239;43;54;3;0;3;1.000;707000;0
2373;90164;43;44;21;4;17;.810;2893000;0
2374;178413;39;0;0;0;0;.00nan;0;0
2374;65014;55;78;37;3;34;.919;3512000;0
2374;85636;39;63;17;1;16;.941;3600000;0
2374;86862;55;0;0;0;0;.00nan;0;0
2375;175912;57;0;0;0;0;.00nan;0;0
2375;180316;52;0;0;0;0;.00nan;0;0
2375;37857;52;62;27;3;24;.889;3841000;0
2375;57152;57;72;39;4;35;.897;3841000;0
2376;170294;60;0;0;0;0;.00nan;0;0
2376;79132;49;99;44;2;42;.955;3600000;0
2376;85797;60;54;21;3;18;.857;3600000;0
2376;91225;49;0;0;0;0;.00nan;0;0
2377;163462;58;72;44;4;40;.909;3586000;0
2377;171608;59;87;33;2;31;.939;3600000;0
2377;46780;58;0;0;0;0;.00nan;0;0
2377;58054;59;0;0;0;0;.00nan;0;0
2378;170598;54;97;53;4;49;.925;3600000;0
2378;68938;46;0;0;0;0;.00nan;0;0
2378;79280;46;86;16;0;16;1.000;3600000;0
2378;94615;54;0;0;0;0;.00nan;0;0
2379;501;42;0;0;0;0;.00nan;0;0
2379;176136;45;36;48;8;40;.833;3600000;0
2379;141484;45;0;0;0;0;.00nan;0;0
2379;141496;42;37;27;5;22;.815;3600000;0
2380;168586;44;0;0;0;0;.00nan;0;0
2380;170314;4619;83;32;2;30;.938;3600000;0
2380;64800;4619;0;0;0;0;.00nan;0;0
2380;64811;44;57;38;5;33;.868;3600000;0
2381;58037;53;0;0;0;0;.00nan;0;0
2381;68799;38;0;0;0;0;.00nan;0;0
2381;78581;53;92;32;1;31;.969;3600000;0
2381;85428;38;35;37;7;30;.811;3600000;0
2382;171838;41;95;54;2;52;.963;3900000;0
2382;170977;41;0;0;0;0;.00nan;0;0
2382;175084;65;0;0;0;0;.00nan;0;0
2382;38209;65;88;34;2;32;.941;3900000;0
2383;180929;51;0;0;0;0;.00nan;0;0
2383;60773;37;0;0;0;0;.00nan;0;0
2383;141850;37;86;20;1;19;.950;3600000;0
2383;149455;51;77;50;5;45;.900;3600000;0
2384;173727;61;99;34;1;33;.971;3600000;0
2384;170294;60;0;0;0;0;.00nan;0;0
2384;179306;61;0;0;0;0;.00nan;0;0
2384;85797;60;42;29;5;24;.828;3600000;0
2385;163471;62;80;47;4;43;.915;3600000;0
2385;36346;62;0;0;0;0;.00nan;0;0
2385;47112;4837;0;0;0;0;.00nan;0;0
2385;64722;4837;65;29;3;26;.897;3600000;0
2386;37077;55;63;28;3;25;.893;3560000;0
2386;59239;43;0;0;0;0;.00nan;0;0
2386;65014;55;0;0;0;0;.00nan;0;0
2386;90164;43;75;27;2;25;.926;3600000;0
2387;176136;45;31;12;3;9;.750;537000;0
2387;68938;46;0;0;0;0;.00nan;0;0
2387;79280;46;63;20;2;18;.900;3600000;0
2387;141484;45;92;36;1;35;.972;2993000;0
2388;168586;44;0;0;0;0;.00nan;0;0
2388;170314;4619;91;40;1;39;.975;3600000;0
2388;64800;4619;0;0;0;0;.00nan;0;0
2388;64811;44;48;29;4;25;.862;3600000;0
2389;172340;48;55;25;4;21;.840;1013000;0
2389;38276;47;0;0;0;0;.00nan;0;0
2389;78775;48;88;42;2;40;.952;2587000;0
2389;87798;47;62;13;1;12;.923;3600000;0
2390;178413;39;57;34;4;30;.882;3600000;0
2390;85336;56;55;45;7;38;.844;3299000;0
2390;85636;39;0;0;0;0;.00nan;0;0
2390;91398;56;49;1;0;1;1.000;301000;0
2391;173727;61;0;0;0;0;.00nan;0;0
2391;170294;60;68;13;0;13;1.000;1508000;0
2391;179306;61;34;35;6;29;.829;3593000;0
2391;85797;60;53;35;5;30;.857;2092000;0
2392;163471;62;63;30;3;27;.900;3600000;0
2392;36346;62;0;0;0;0;.00nan;0;0
2392;79132;49;54;28;4;24;.857;3553000;0
2392;91225;49;0;0;0;0;.00nan;0;0
2393;163462;58;0;0;0;0;.00nan;0;0
2393;180316;52;0;0;0;0;.00nan;0;0
2393;37857;52;100;20;0;20;1.000;3600000;0
2393;46780;58;57;36;5;31;.861;3600000;0
2394;165582;64;33;34;6;28;.824;3600000;0
2394;168872;64;0;0;0;0;.00nan;0;0
2394;60773;37;0;0;0;0;.00nan;0;0
2394;141850;37;78;22;1;21;.955;3600000;0
2395;58037;53;0;0;0;0;.00nan;0;0
2395;68799;38;78;44;4;40;.909;3653000;0
2395;78581;53;47;18;3;15;.833;3653000;0
2395;85428;38;0;0;0;0;.00nan;0;0
2396;168586;44;0;0;0;0;.00nan;0;0
2396;47112;4837;38;28;6;22;.786;3900000;0
2396;64722;4837;0;0;0;0;.00nan;0;0
2396;64811;44;45;37;6;31;.838;3888000;0
2397;180929;51;55;47;6;41;.872;3271000;0
2397;59239;43;0;0;0;0;.00nan;0;0
2397;90164;43;64;19;2;17;.895;3600000;0
2397;149455;51;57;3;0;3;1.000;329000;0
2398;171608;59;0;0;0;0;.00nan;0;0
2398;175912;57;0;0;0;0;.00nan;0;0
2398;57152;57;80;52;5;47;.904;3600000;0
2398;58054;59;62;18;2;16;.889;3600000;0
2399;164715;63;0;0;0;0;.00nan;0;0
2399;37077;55;0;0;0;0;.00nan;0;0
2399;65014;55;54;23;3;20;.870;3600000;0
2399;149584;63;46;33;5;28;.848;3584000;0
2400;172340;48;73;28;2;26;.929;3600000;0
2400;38276;47;0;0;0;0;.00nan;0;0
2400;78775;48;0;0;0;0;.00nan;0;0
2400;87798;47;60;24;3;21;.875;3542000;0
2401;171838;41;62;44;6;38;.864;2764000;0
2401;170977;41;64;11;0;11;1.000;836000;0
2401;175084;65;0;0;0;0;.00nan;0;0
2401;38209;65;67;24;2;22;.917;3600000;0
2402;168651;40;0;0;0;0;.00nan;0;0
2402;170598;54;0;0;0;0;.00nan;0;0
2402;94615;54;68;28;3;25;.893;3600000;0
2402;142492;40;67;24;2;22;.917;3600000;0
2403;178413;39;0;0;0;0;.00nan;0;0
2403;173699;36;0;0;0;0;.00nan;0;0
2403;74734;36;90;54;4;50;.926;3600000;0
2403;85636;39;100;21;0;21;1.000;3600000;0
2404;163471;62;0;0;0;0;.00nan;0;0
2404;36346;62;60;31;3;28;.903;3600000;0
2404;79132;49;41;22;4;18;.818;3551000;0
2404;91225;49;0;0;0;0;.00nan;0;0
2405;171838;41;0;0;0;0;.00nan;0;0
2405;170977;41;60;22;2;20;.909;3682000;0
2405;68799;38;0;0;0;0;.00nan;0;0
2405;85428;38;85;40;3;37;.925;3682000;0
2406;170294;60;0;0;0;0;.00nan;0;0
2406;170314;4619;83;46;4;42;.913;3600000;0
2406;64800;4619;0;0;0;0;.00nan;0;0
2406;85797;60;100;33;0;33;1.000;3600000;0
2407;180316;52;0;0;0;0;.00nan;0;0
2407;37857;52;74;30;2;28;.933;3600000;0
2407;37942;58;52;27;3;24;.889;3600000;0
2407;46780;58;0;0;0;0;.00nan;0;0
2408;162945;50;69;30;2;28;.933;3600000;0
2408;165582;64;0;0;0;0;.00nan;0;0
2408;168872;64;74;47;4;43;.915;3583000;0
2408;171673;50;0;0;0;0;.00nan;0;0
2409;172340;48;53;30;4;26;.867;3893000;0
2409;173727;61;36;26;5;21;.808;3893000;0
2409;179306;61;0;0;0;0;.00nan;0;0
2409;91456;48;0;0;0;0;.00nan;0;0
2410;168586;44;67;24;3;21;.875;3600000;0
2410;47112;4837;0;0;0;0;.00nan;0;0
2410;57434;44;0;0;0;0;.00nan;0;0
2410;78775;4837;59;38;4;34;.895;3584000;0
2411;501;42;91;28;1;27;.964;3600000;0
2411;68938;46;0;0;0;0;.00nan;0;0
2411;79280;46;62;23;2;21;.913;3559000;0
2411;141496;42;0;0;0;0;.00nan;0;0
2412;180929;51;0;0;0;0;.00nan;0;0
2412;59239;43;39;17;3;14;.824;3600000;0
2412;90164;43;0;0;0;0;.00nan;0;0
2412;149455;51;81;46;4;42;.913;3570000;0
2413;176136;45;0;0;0;0;.00nan;0;0
2413;75362;37;54;14;2;12;.857;3900000;0
2413;141484;45;68;39;2;37;.949;3900000;0
2413;141850;37;0;0;0;0;.00nan;0;0
2414;178413;39;0;0;0;0;.00nan;0;0
2414;175084;65;75;47;4;43;.915;3600000;0
2414;38209;65;0;0;0;0;.00nan;0;0
2414;85636;39;85;16;0;16;1.000;3600000;0
2415;164715;63;99;46;2;44;.957;3600000;0
2415;37077;55;47;16;3;13;.813;3551000;0
2415;65014;55;0;0;0;0;.00nan;0;0
2415;149584;63;0;0;0;0;.00nan;0;0
2416;168651;40;0;0;0;0;.00nan;0;0
2416;170598;54;94;51;3;48;.941;3757000;0
2416;94615;54;0;0;0;0;.00nan;0;0
2416;142492;40;63;22;2;20;.909;3757000;0
2417;173699;36;100;36;0;36;1.000;3600000;0
2417;74734;36;0;0;0;0;.00nan;0;0
2417;85336;56;61;25;2;23;.920;3530000;0
2417;85468;56;0;0;0;0;.00nan;0;0
2418;171608;59;0;0;0;0;.00nan;0;0
2418;175912;57;50;40;5;35;.875;3600000;0
2418;57152;57;0;0;0;0;.00nan;0;0
2418;58054;59;65;20;2;18;.900;3600000;0
2419;171838;41;99;45;1;44;.978;3600000;0
2419;170977;41;0;0;0;0;.00nan;0;0
2419;171608;59;59;22;2;20;.909;3561000;0
2419;58054;59;0;0;0;0;.00nan;0;0
2420;170294;60;0;0;0;0;.00nan;0;0
2420;170314;4619;89;53;3;50;.943;3550000;0
2420;64800;4619;0;0;0;0;.00nan;0;0
2420;85797;60;68;22;2;20;.909;3600000;0
2421;165582;64;64;27;3;24;.889;3600000;0
2421;168872;64;0;0;0;0;.00nan;0;0
2421;176136;45;84;45;4;41;.911;3600000;0
2421;141484;45;0;0;0;0;.00nan;0;0
2422;501;42;0;0;0;0;.00nan;0;0
2422;68938;46;0;0;0;0;.00nan;0;0
2422;79280;46;60;25;3;22;.880;3555000;0
2422;141496;42;95;36;1;35;.972;3600000;0
2423;175084;65;0;0;0;0;.00nan;0;0
2423;38209;65;78;47;4;43;.915;3600000;0
2423;58037;53;0;0;0;0;.00nan;0;0
2423;78581;53;61;24;3;21;.875;3600000;0
2424;164715;63;0;0;0;0;.00nan;0;0
2424;173699;36;96;38;2;36;.947;3600000;0
2424;74734;36;0;0;0;0;.00nan;0;0
2424;149584;63;61;25;3;22;.880;3579000;0
2425;163471;62;32;15;4;11;.733;1133000;0
2425;168586;44;0;0;0;0;.00nan;0;0
2425;36346;62;70;36;3;33;.917;2467000;0
2425;57434;44;72;19;1;18;.947;3600000;0
2426;180316;52;84;17;0;17;1.000;3600000;0
2426;37857;52;0;0;0;0;.00nan;0;0
2426;68799;38;68;43;5;38;.884;3600000;0
2426;85428;38;0;0;0;0;.00nan;0;0
2427;162945;50;76;21;1;20;.952;3600000;0
2427;170598;54;0;0;0;0;.00nan;0;0
2427;171673;50;0;0;0;0;.00nan;0;0
2427;94615;54;69;40;5;35;.875;3600000;0
2428;173727;61;45;27;4;23;.852;3570000;0
2428;179306;61;0;0;0;0;.00nan;0;0
2428;47112;4837;0;0;0;0;.00nan;0;0
2428;78775;4837;73;34;3;31;.912;3600000;0
2429;163471;62;62;31;4;27;.871;3551000;0
2429;168586;44;0;0;0;0;.00nan;0;0
2429;36346;62;0;0;0;0;.00nan;0;0
2429;57434;44;82;35;3;32;.914;3600000;0
2430;173699;36;0;0;0;0;.00nan;0;0
2430;74734;36;90;33;1;32;.970;3600000;0
2430;85336;56;61;21;2;19;.905;3546000;0
2430;85468;56;0;0;0;0;.00nan;0;0
2431;180316;52;37;24;5;19;.792;3591000;0
2431;37857;52;0;0;0;0;.00nan;0;0
2431;68799;38;0;0;0;0;.00nan;0;0
2431;85428;38;70;39;4;35;.897;3600000;0
2432;180929;51;45;38;6;32;.842;2744000;0
2432;75362;37;0;0;0;0;.00nan;0;0
2432;141850;37;45;11;2;9;.818;3600000;0
2432;149455;51;67;17;1;16;.941;856000;0
2433;171838;41;73;44;3;41;.932;3600000;0
2433;170977;41;0;0;0;0;.00nan;0;0
2433;59239;43;0;0;0;0;.00nan;0;0
2433;90164;43;56;22;2;20;.909;3600000;0
2434;176136;45;45;36;6;30;.833;3600000;0
2434;68938;46;0;0;0;0;.00nan;0;0
2434;79280;46;70;19;1;18;.947;3600000;0
2434;141484;45;0;0;0;0;.00nan;0;0
2435;170314;4619;89;41;3;38;.927;3600000;0
2435;38276;47;0;0;0;0;.00nan;0;0
2435;64800;4619;0;0;0;0;.00nan;0;0
2435;87798;47;62;19;2;17;.895;3600000;0
2436;164715;63;0;0;0;0;.00nan;0;0
2436;37077;55;0;0;0;0;.00nan;0;0
2436;65014;55;47;23;4;19;.826;3900000;0
2436;149584;63;58;37;4;33;.892;3900000;0
2437;162945;50;51;23;3;20;.870;3550000;0
2437;170598;54;99;45;2;43;.956;3600000;0
2437;171673;50;0;0;0;0;.00nan;0;0
2437;94615;54;0;0;0;0;.00nan;0;0
2438;173727;61;70;18;1;17;.944;3600000;0
2438;179306;61;0;0;0;0;.00nan;0;0
2438;47112;4837;83;18;0;18;1.000;1764000;0
2438;78775;4837;26;29;6;23;.793;1836000;0
2439;171608;59;0;0;0;0;.00nan;0;0
2439;175912;57;0;0;0;0;.00nan;0;0
2439;57152;57;99;51;3;48;.941;3600000;0
2439;58054;59;46;21;4;17;.810;3552000;0
2440;165582;64;72;28;2;26;.929;3600000;0
2440;168872;64;0;0;0;0;.00nan;0;0
2440;68938;46;0;0;0;0;.00nan;0;0
2440;79280;46;73;35;3;32;.914;3600000;0
2441;175912;57;75;28;3;25;.893;3577000;0
2441;180929;51;87;33;2;31;.939;3600000;0
2441;57152;57;0;0;0;0;.00nan;0;0
2441;149455;51;0;0;0;0;.00nan;0;0
2442;170294;60;0;0;0;0;.00nan;0;0
2442;79132;49;0;0;0;0;.00nan;0;0
2442;85797;60;44;22;4;18;.818;3551000;0
2442;91225;49;85;43;3;40;.930;3600000;0
2443;501;42;0;0;0;0;.00nan;0;0
2443;75362;37;0;0;0;0;.00nan;0;0
2443;141496;42;94;30;1;29;.967;3600000;0
2443;141850;37;61;25;3;22;.880;3600000;0
2444;171838;41;0;0;0;0;.00nan;0;0
2444;170977;41;58;33;4;29;.879;3526000;0
2444;59239;43;0;0;0;0;.00nan;0;0
2444;90164;43;63;22;2;20;.909;3600000;0
2445;172340;48;76;33;2;31;.939;3600000;0
2445;170314;4619;41;37;7;30;.811;3285000;0
2445;64800;4619;50;1;0;1;1.000;315000;0
2445;91456;48;0;0;0;0;.00nan;0;0
2446;171608;59;0;0;0;0;.00nan;0;0
2446;58037;53;0;0;0;0;.00nan;0;0
2446;58054;59;100;35;0;35;1.000;3600000;0
2446;78581;53;46;34;6;28;.824;3600000;0
2447;164715;63;99;45;1;44;.978;3600000;0
2447;178413;39;0;0;0;0;.00nan;0;0
2447;85636;39;71;31;3;28;.903;3560000;0
2447;149584;63;0;0;0;0;.00nan;0;0
2448;176136;45;31;16;4;12;.750;876000;0
2448;38276;47;77;18;1;17;.944;3600000;0
2448;87798;47;0;0;0;0;.00nan;0;0
2448;141484;45;74;38;4;34;.895;2724000;0
2449;37077;55;0;0;0;0;.00nan;0;0
2449;65014;55;63;25;3;22;.880;3600000;0
2449;85336;56;63;32;4;28;.875;3600000;0
2449;85468;56;0;0;0;0;.00nan;0;0
2450;173699;36;52;23;4;19;.826;3569000;0
2450;37942;58;0;0;0;0;.00nan;0;0
2450;46780;58;65;25;2;23;.920;3600000;0
2450;74734;36;0;0;0;0;.00nan;0;0
2451;168586;44;0;0;0;0;.00nan;0;0
2451;47112;4837;0;0;0;0;.00nan;0;0
2451;57434;44;50;21;3;18;.857;3543000;0
2451;78775;4837;78;34;2;32;.941;3600000;0
2452;163471;62;100;31;0;31;1.000;3600000;0
2452;170314;4619;92;30;1;29;.967;3580000;0
2452;36346;62;0;0;0;0;.00nan;0;0
2452;64800;4619;0;0;0;0;.00nan;0;0
2453;171838;41;98;48;2;46;.958;3530000;0
2453;170977;41;0;0;0;0;.00nan;0;0
2453;85336;56;0;0;0;0;.00nan;0;0
2453;85468;56;96;20;0;20;1.000;3600000;0
2454;175084;65;54;6;0;6;1.000;345000;0
2454;180316;52;0;0;0;0;.00nan;0;0
2454;37857;52;68;39;4;35;.897;3600000;0
2454;38209;65;37;38;7;31;.816;3255000;0
2455;165582;64;0;0;0;0;.00nan;0;0
2455;168872;64;78;38;3;35;.921;3600000;0
2455;68938;46;0;0;0;0;.00nan;0;0
2455;79280;46;43;28;4;24;.857;3542000;0
2456;175912;57;0;0;0;0;.00nan;0;0
2456;180929;51;0;0;0;0;.00nan;0;0
2456;57152;57;25;29;6;23;.793;3600000;0
2456;149455;51;88;36;2;34;.944;3600000;0
2457;170294;60;0;0;0;0;.00nan;0;0
2457;79132;49;76;40;3;37;.925;3583000;0
2457;85797;60;74;20;1;19;.950;3600000;0
2457;91225;49;0;0;0;0;.00nan;0;0
2458;501;42;84;47;3;44;.936;3615000;0
2458;75362;37;82;28;2;26;.929;3615000;0
2458;141496;42;0;0;0;0;.00nan;0;0
2458;141850;37;0;0;0;0;.00nan;0;0
2459;173699;36;0;0;0;0;.00nan;0;0
2459;68799;38;0;0;0;0;.00nan;0;0
2459;74734;36;96;37;2;35;.946;3900000;0
2459;85428;38;76;28;2;26;.929;3900000;0
2460;37077;55;98;42;2;40;.952;3556000;0
2460;37942;58;68;24;1;23;.958;3600000;0
2460;46780;58;0;0;0;0;.00nan;0;0
2460;65014;55;0;0;0;0;.00nan;0;0
2461;171608;59;0;0;0;0;.00nan;0;0
2461;58037;53;93;45;3;42;.933;3551000;0
2461;58054;59;72;24;2;22;.917;3600000;0
2461;78581;53;0;0;0;0;.00nan;0;0
2462;162945;50;59;29;4;25;.862;3600000;0
2462;168651;40;0;0;0;0;.00nan;0;0
2462;171673;50;0;0;0;0;.00nan;0;0
2462;142492;40;84;26;1;25;.962;3600000;0
2463;176136;45;86;55;5;50;.909;3584000;0
2463;38276;47;0;0;0;0;.00nan;0;0
2463;87798;47;58;24;3;21;.875;3600000;0
2463;141484;45;0;0;0;0;.00nan;0;0
2464;164715;63;59;25;3;22;.880;1742000;0
2464;178413;39;29;28;6;22;.786;3600000;0
2464;85636;39;0;0;0;0;.00nan;0;0
2464;149584;63;43;27;5;22;.815;1858000;0
2465;173727;61;64;11;1;10;.909;3600000;0
2465;170598;54;0;0;0;0;.00nan;0;0
2465;179306;61;0;0;0;0;.00nan;0;0
2465;94615;54;97;50;3;47;.940;3529000;0
2466;168586;44;0;0;0;0;.00nan;0;0
2466;47112;4837;0;0;0;0;.00nan;0;0
2466;57434;44;67;24;2;22;.917;3600000;0
2466;78775;4837;82;48;4;44;.917;3525000;0
2467;175084;65;77;31;2;29;.935;3600000;0
2467;180316;52;0;0;0;0;.00nan;0;0
2467;37857;52;100;28;0;28;1.000;3600000;0
2467;38209;65;0;0;0;0;.00nan;0;0
2468;501;42;0;0;0;0;.00nan;0;0
2468;165582;64;68;34;4;30;.882;3706000;0
2468;168872;64;0;0;0;0;.00nan;0;0
2468;141496;42;60;25;3;22;.880;3672000;0
2469;37942;58;0;0;0;0;.00nan;0;0
2469;46780;58;59;20;2;18;.900;3699000;0
2469;68799;38;92;47;3;44;.936;3699000;0
2469;85428;38;0;0;0;0;.00nan;0;0
2470;162945;50;81;23;1;22;.957;3564000;0
2470;168651;40;100;33;0;33;1.000;3600000;0
2470;171673;50;0;0;0;0;.00nan;0;0
2470;142492;40;0;0;0;0;.00nan;0;0
2471;178413;39;0;0;0;0;.00nan;0;0
2471;59239;43;0;0;0;0;.00nan;0;0
2471;85636;39;78;35;4;31;.886;3742000;0
2471;90164;43;58;26;3;23;.885;3742000;0
2472;173727;61;0;0;0;0;.00nan;0;0
2472;170598;54;82;44;4;40;.909;3567000;0
2472;179306;61;76;27;2;25;.926;3600000;0
2472;94615;54;0;0;0;0;.00nan;0;0
2473;163471;62;47;49;7;42;.857;3053000;0
2473;170294;60;42;20;4;16;.800;3600000;0
2473;36346;62;59;12;1;11;.917;547000;0
2473;85797;60;0;0;0;0;.00nan;0;0
2474;176136;45;0;0;0;0;.00nan;0;0
2474;79132;49;58;23;2;21;.913;3600000;0
2474;91225;49;0;0;0;0;.00nan;0;0
2474;141484;45;59;30;3;27;.900;3575000;0
2475;68938;46;0;0;0;0;.00nan;0;0
2475;75362;37;0;0;0;0;.00nan;0;0
2475;79280;46;87;48;4;44;.917;3600000;0
2475;141850;37;85;19;1;18;.947;3600000;0
2476;163471;62;70;35;3;32;.914;3600000;0
2476;170294;60;0;0;0;0;.00nan;0;0
2476;36346;62;0;0;0;0;.00nan;0;0
2476;85797;60;53;12;1;11;.917;3600000;0
2477;172340;48;37;21;4;17;.810;3900000;0
2477;170598;54;0;0;0;0;.00nan;0;0
2477;91456;48;0;0;0;0;.00nan;0;0
2477;94615;54;100;54;4;50;.926;3900000;0
2478;176136;45;0;0;0;0;.00nan;0;0
2478;79132;49;95;23;0;23;1.000;3600000;0
2478;91225;49;0;0;0;0;.00nan;0;0
2478;141484;45;63;40;4;36;.900;3600000;0
2479;171608;59;0;0;0;0;.00nan;0;0
2479;175084;65;0;0;0;0;.00nan;0;0
2479;38209;65;78;52;5;47;.904;3600000;0
2479;58054;59;62;21;2;19;.905;3600000;0
2480;68938;46;0;0;0;0;.00nan;0;0
2480;75362;37;84;34;1;33;.971;3600000;0
2480;79280;46;63;38;5;33;.868;3600000;0
2480;141850;37;0;0;0;0;.00nan;0;0
2481;173727;61;83;35;2;33;.943;3600000;0
2481;170314;4619;0;0;0;0;.00nan;0;0
2481;179306;61;0;0;0;0;.00nan;0;0
2481;64800;4619;92;42;3;39;.929;3600000;0
2482;164715;63;79;23;1;22;.957;3600000;0
2482;68799;38;0;0;0;0;.00nan;0;0
2482;85428;38;74;31;3;28;.903;3593000;0
2482;149584;63;0;0;0;0;.00nan;0;0
2483;162945;50;89;36;2;34;.944;3591000;0
2483;165582;64;98;37;1;36;.973;3600000;0
2483;168872;64;0;0;0;0;.00nan;0;0
2483;171673;50;0;0;0;0;.00nan;0;0
2484;168651;40;0;0;0;0;.00nan;0;0
2484;38276;47;0;0;0;0;.00nan;0;0
2484;87798;47;62;22;2;20;.909;3600000;0
2484;142492;40;50;37;5;32;.865;3600000;0
2485;180929;51;87;32;1;31;.969;3900000;0
2485;37942;58;0;0;0;0;.00nan;0;0
2485;46780;58;86;25;1;24;.960;3900000;0
2485;149455;51;0;0;0;0;.00nan;0;0
2486;172340;48;79;25;1;24;.960;3600000;0
2486;163471;62;65;42;4;38;.905;3600000;0
2486;36346;62;0;0;0;0;.00nan;0;0
2486;91456;48;0;0;0;0;.00nan;0;0
2487;59239;43;0;0;0;0;.00nan;0;0
2487;85336;56;0;0;0;0;.00nan;0;0
2487;85468;56;72;40;5;35;.875;3827000;0
2487;90164;43;59;30;4;26;.867;3827000;0
2488;501;42;0;0;0;0;.00nan;0;0
2488;165582;64;100;34;1;33;.971;3900000;0
2488;168872;64;0;0;0;0;.00nan;0;0
2488;141496;42;98;39;1;38;.974;3900000;0
2489;170294;60;0;0;0;0;.00nan;0;0
2489;170314;4619;84;45;3;42;.933;3570000;0
2489;64800;4619;0;0;0;0;.00nan;0;0
2489;85797;60;74;27;2;25;.926;3600000;0
2490;164715;63;0;0;0;0;.00nan;0;0
2490;178413;39;0;0;0;0;.00nan;0;0
2490;85636;39;86;31;2;29;.935;3900000;0
2490;149584;63;76;30;2;28;.933;3900000;0
2491;170598;54;0;0;0;0;.00nan;0;0
2491;38276;47;0;0;0;0;.00nan;0;0
2491;87798;47;71;22;1;21;.955;3600000;0
2491;94615;54;92;50;3;47;.940;3599000;0
2492;175084;65;0;0;0;0;.00nan;0;0
2492;180316;52;0;0;0;0;.00nan;0;0
2492;37857;52;91;43;3;40;.930;3600000;0
2492;38209;65;59;31;4;27;.871;3600000;0
2493;175912;57;0;0;0;0;.00nan;0;0
2493;37077;55;0;0;0;0;.00nan;0;0
2493;57152;57;81;29;1;28;.966;3571000;0
2493;65014;55;100;21;0;21;1.000;3600000;0
2494;171838;41;56;27;4;23;.852;3600000;0
2494;173699;36;0;0;0;0;.00nan;0;0
2494;170977;41;0;0;0;0;.00nan;0;0
2494;74734;36;99;39;1;38;.974;3600000;0
2495;59239;43;0;0;0;0;.00nan;0;0
2495;85336;56;100;32;0;32;1.000;3600000;0
2495;85468;56;0;0;0;0;.00nan;0;0
2495;90164;43;65;24;2;22;.917;3533000;0
2496;180929;51;0;0;0;0;.00nan;0;0
2496;37942;58;0;0;0;0;.00nan;0;0
2496;46780;58;37;20;4;16;.800;3534000;0
2496;149455;51;97;36;2;34;.944;3600000;0
2497;172340;48;0;0;0;0;.00nan;0;0
2497;170598;54;62;41;5;36;.878;3600000;0
2497;91456;48;100;25;0;25;1.000;3600000;0
2497;94615;54;0;0;0;0;.00nan;0;0
2498;501;42;86;45;3;42;.933;3600000;0
2498;165582;64;0;0;0;0;.00nan;0;0
2498;168872;64;51;30;4;26;.867;3547000;0
2498;141496;42;0;0;0;0;.00nan;0;0
2499;171838;41;0;0;0;0;.00nan;0;0
2499;170977;41;96;44;2;42;.955;3591000;0
2499;171608;59;0;0;0;0;.00nan;0;0
2499;58054;59;87;30;1;29;.967;3600000;0
2500;168586;44;0;0;0;0;.00nan;0;0
2500;57434;44;72;30;3;27;.900;3600000;0
2500;68938;46;0;0;0;0;.00nan;0;0
2500;79280;46;62;34;4;30;.882;3600000;0
2501;176136;45;0;0;0;0;.00nan;0;0
2501;47112;4837;0;0;0;0;.00nan;0;0
2501;78775;4837;58;18;2;16;.889;3838000;0
2501;141484;45;70;34;3;31;.912;3838000;0
2502;180316;52;42;3;1;2;.667;304000;0
2502;37857;52;22;27;6;21;.778;3296000;0
2502;58037;53;0;0;0;0;.00nan;0;0
2502;78581;53;78;32;2;30;.938;3600000;0
2503;162945;50;84;32;1;31;.969;3585000;0
2503;171673;50;0;0;0;0;.00nan;0;0
2503;75362;37;0;0;0;0;.00nan;0;0
2503;141850;37;90;20;0;20;1.000;3600000;0
2504;168651;40;0;0;0;0;.00nan;0;0
2504;173727;61;54;22;3;19;.864;3554000;0
2504;179306;61;0;0;0;0;.00nan;0;0
2504;142492;40;84;48;2;46;.958;3600000;0
2505;175084;65;55;42;5;37;.881;3600000;0
2505;37077;55;95;22;0;22;1.000;3600000;0
2505;38209;65;0;0;0;0;.00nan;0;0
2505;65014;55;0;0;0;0;.00nan;0;0
2506;178413;39;60;29;3;26;.897;3735000;0
2506;68799;38;0;0;0;0;.00nan;0;0
2506;85428;38;65;36;4;32;.889;3735000;0
2506;85636;39;0;0;0;0;.00nan;0;0
2507;173699;36;28;25;6;19;.760;2584000;0
2507;175912;57;71;29;2;27;.931;3600000;0
2507;57152;57;0;0;0;0;.00nan;0;0
2507;74734;36;60;6;0;6;1.000;1016000;0
2508;68799;38;76;29;2;27;.931;3552000;0
2508;85336;56;76;22;1;21;.955;3600000;0
2508;85428;38;0;0;0;0;.00nan;0;0
2508;85468;56;0;0;0;0;.00nan;0;0
2509;171608;59;0;0;0;0;.00nan;0;0
2509;175912;57;0;0;0;0;.00nan;0;0
2509;57152;57;45;39;6;33;.846;3600000;0
2509;58054;59;67;16;1;15;.938;3600000;0
2510;168586;44;0;0;0;0;.00nan;0;0
2510;57434;44;69;27;2;25;.926;3600000;0
2510;68938;46;0;0;0;0;.00nan;0;0
2510;79280;46;75;37;3;34;.919;3548000;0
2511;176136;45;0;0;0;0;.00nan;0;0
2511;47112;4837;0;0;0;0;.00nan;0;0
2511;78775;4837;67;24;2;22;.917;3541000;0
2511;141484;45;99;41;1;40;.976;3600000;0
2512;163471;62;43;32;5;27;.844;3573000;0
2512;170314;4619;63;30;3;27;.900;3600000;0
2512;36346;62;0;0;0;0;.00nan;0;0
2512;64800;4619;0;0;0;0;.00nan;0;0
2513;37077;55;0;0;0;0;.00nan;0;0
2513;58037;53;80;33;3;30;.909;3676000;0
2513;65014;55;70;29;2;27;.931;3676000;0
2513;78581;53;0;0;0;0;.00nan;0;0
2514;164715;63;57;26;4;22;.846;3543000;0
2514;173699;36;0;0;0;0;.00nan;0;0
2514;74734;36;79;40;3;37;.925;3600000;0
2514;149584;63;0;0;0;0;.00nan;0;0
2515;170294;60;0;0;0;0;.00nan;0;0
2515;38276;47;54;21;2;19;.905;3558000;0
2515;85797;60;99;38;1;37;.974;3600000;0
2515;87798;47;0;0;0;0;.00nan;0;0
2516;168651;40;0;0;0;0;.00nan;0;0
2516;173727;61;52;20;3;17;.850;3600000;0
2516;179306;61;0;0;0;0;.00nan;0;0
2516;142492;40;59;32;4;28;.875;3592000;0
2517;178413;39;0;0;0;0;.00nan;0;0
2517;59239;43;44;19;4;15;.789;3600000;0
2517;85636;39;95;30;1;29;.967;3600000;0
2517;90164;43;0;0;0;0;.00nan;0;0
2518;172340;48;0;0;0;0;.00nan;0;0
2518;170294;60;0;0;0;0;.00nan;0;0
2518;85797;60;93;35;2;33;.943;3600000;0
2518;91456;48;64;43;5;38;.884;3600000;0
2519;37942;58;81;27;1;26;.963;3600000;0
2519;46780;58;0;0;0;0;.00nan;0;0
2519;58037;53;0;0;0;0;.00nan;0;0
2519;78581;53;76;46;5;41;.891;3600000;0
2520;501;42;0;0;0;0;.00nan;0;0
2520;176136;45;0;0;0;0;.00nan;0;0
2520;141484;45;88;46;4;42;.913;3600000;0
2520;141496;42;30;25;6;19;.760;3514000;0
2521;172340;48;64;28;3;25;.893;3515000;0
2521;170294;60;73;23;1;22;.957;3600000;0
2521;85797;60;0;0;0;0;.00nan;0;0
2521;91456;48;0;0;0;0;.00nan;0;0
2522;162945;50;82;29;1;28;.966;3600000;0
2522;165582;64;98;49;4;45;.918;3600000;0
2522;168872;64;0;0;0;0;.00nan;0;0
2522;171673;50;0;0;0;0;.00nan;0;0
2523;180929;51;69;48;5;43;.896;3600000;0
2523;75362;37;0;0;0;0;.00nan;0;0
2523;141850;37;73;8;0;8;1.000;3600000;0
2523;149455;51;0;0;0;0;.00nan;0;0
2524;180316;52;0;0;0;0;.00nan;0;0
2524;37857;52;67;20;2;18;.900;3900000;0
2524;68799;38;97;56;2;54;.964;3900000;0
2524;85428;38;0;0;0;0;.00nan;0;0
2525;178413;39;0;0;0;0;.00nan;0;0
2525;68938;46;0;0;0;0;.00nan;0;0
2525;79280;46;64;28;3;25;.893;3600000;0
2525;85636;39;89;36;2;34;.944;3600000;0
2526;168651;40;0;0;0;0;.00nan;0;0
2526;170314;4619;75;25;3;22;.880;3900000;0
2526;64800;4619;0;0;0;0;.00nan;0;0
2526;142492;40;69;34;3;31;.912;3900000;0
2527;164715;63;0;0;0;0;.00nan;0;0
2527;37077;55;0;0;0;0;.00nan;0;0
2527;65014;55;71;28;3;25;.893;3600000;0
2527;149584;63;56;45;6;39;.867;3600000;0
2528;173699;36;0;0;0;0;.00nan;0;0
2528;59239;43;0;0;0;0;.00nan;0;0
2528;74734;36;90;54;4;50;.926;3600000;0
2528;90164;43;62;13;1;12;.923;3600000;0
2529;171838;41;86;31;2;29;.935;3600000;0
2529;170977;41;0;0;0;0;.00nan;0;0
2529;180316;52;0;0;0;0;.00nan;0;0
2529;37857;52;46;32;5;27;.844;3600000;0
2530;168651;40;0;0;0;0;.00nan;0;0
2530;170294;60;50;1;0;1;1.000;742000;0
2530;85797;60;39;28;6;22;.786;2858000;0
2530;142492;40;81;46;3;43;.935;3600000;0
2531;165582;64;48;55;7;48;.873;3591000;0
2531;168872;64;0;0;0;0;.00nan;0;0
2531;75362;37;0;0;0;0;.00nan;0;0
2531;141850;37;45;32;5;27;.844;3600000;0
2532;168586;44;0;0;0;0;.00nan;0;0
2532;57434;44;59;20;2;18;.900;3600000;0
2532;79132;49;54;43;6;37;.860;3600000;0
2532;91225;49;0;0;0;0;.00nan;0;0
2533;175084;65;0;0;0;0;.00nan;0;0
2533;38209;65;68;28;3;25;.893;3571000;0
2533;68799;38;100;35;1;34;.971;3600000;0
2533;85428;38;0;0;0;0;.00nan;0;0
2534;163471;62;93;36;1;35;.972;3900000;0
2534;36346;62;0;0;0;0;.00nan;0;0
2534;47112;4837;0;0;0;0;.00nan;0;0
2534;78775;4837;70;24;1;23;.958;3900000;0
2535;59239;43;0;0;0;0;.00nan;0;0
2535;85336;56;0;0;0;0;.00nan;0;0
2535;85468;56;49;40;6;34;.850;3600000;0
2535;90164;43;59;32;4;28;.875;3600000;0
2536;178413;39;0;0;0;0;.00nan;0;0
2536;68938;46;0;0;0;0;.00nan;0;0
2536;79280;46;85;52;3;49;.942;3600000;0
2536;85636;39;81;14;0;14;1.000;3600000;0
2537;162945;50;41;12;2;10;.833;3900000;0
2537;171673;50;0;0;0;0;.00nan;0;0
2537;176136;45;0;0;0;0;.00nan;0;0
2537;141484;45;99;42;2;40;.952;3900000;0
2538;171608;59;0;0;0;0;.00nan;0;0
2538;37077;55;0;0;0;0;.00nan;0;0
2538;58054;59;89;33;2;31;.939;3900000;0
2538;65014;55;81;34;2;32;.941;3900000;0
2539;501;42;0;0;0;0;.00nan;0;0
2539;170598;54;0;0;0;0;.00nan;0;0
2539;94615;54;79;46;4;42;.913;3579000;0
2539;141496;42;55;17;2;15;.882;3600000;0
2540;173727;61;96;50;3;47;.940;3587000;0
2540;179306;61;0;0;0;0;.00nan;0;0
2540;38276;47;0;0;0;0;.00nan;0;0
2540;87798;47;63;19;1;18;.947;3600000;0
2541;173699;36;0;0;0;0;.00nan;0;0
2541;58037;53;0;0;0;0;.00nan;0;0
2541;74734;36;86;31;2;29;.935;3600000;0
2541;78581;53;75;34;4;30;.882;3535000;0
2542;171838;41;0;0;0;0;.00nan;0;0
2542;170977;41;76;46;4;42;.913;3795000;0
2542;180316;52;0;0;0;0;.00nan;0;0
2542;37857;52;71;28;3;25;.893;3795000;0
2543;162945;50;92;25;1;24;.960;3600000;0
2543;165582;64;0;0;0;0;.00nan;0;0
2543;168872;64;86;44;2;42;.955;3600000;0
2543;171673;50;0;0;0;0;.00nan;0;0
2544;164715;63;81;33;2;31;.939;3600000;0
2544;180929;51;50;13;2;11;.846;620000;0
2544;149455;51;23;27;6;21;.778;2980000;0
2544;149584;63;0;0;0;0;.00nan;0;0
2545;168586;44;55;2;0;2;1.000;350000;0
2545;57434;44;69;38;4;34;.895;3250000;0
2545;79132;49;0;0;0;0;.00nan;0;0
2545;91225;49;63;42;5;37;.881;3600000;0
2546;37942;58;0;0;0;0;.00nan;0;0
2546;46780;58;84;43;3;40;.930;3900000;0
2546;68799;38;0;0;0;0;.00nan;0;0
2546;85428;38;70;41;3;38;.927;3900000;0
2547;172340;48;89;41;2;39;.951;3900000;0
2547;47112;4837;0;0;0;0;.00nan;0;0
2547;78775;4837;72;32;2;30;.938;3900000;0
2547;91456;48;0;0;0;0;.00nan;0;0
2548;59239;43;0;0;0;0;.00nan;0;0
2548;85336;56;61;41;5;36;.878;3600000;0
2548;85468;56;0;0;0;0;.00nan;0;0
2548;90164;43;76;31;2;29;.935;3600000;0
2549;176136;45;0;0;0;0;.00nan;0;0
2549;75362;37;58;18;2;16;.889;3600000;0
2549;141484;45;95;45;4;41;.911;3600000;0
2549;141850;37;0;0;0;0;.00nan;0;0
2550;163471;62;0;0;0;0;.00nan;0;0
2550;170314;4619;52;28;4;24;.857;3600000;0
2550;36346;62;67;41;5;36;.878;3543000;0
2550;64800;4619;0;0;0;0;.00nan;0;0
2551;37077;55;40;27;5;22;.815;3733000;0
2551;58037;53;75;45;6;39;.867;3783000;0
2551;65014;55;0;0;0;0;.00nan;0;0
2551;78581;53;0;0;0;0;.00nan;0;0
2552;501;42;100;31;0;31;1.000;3600000;0
2552;170598;54;42;34;6;28;.824;1964000;0
2552;94615;54;48;14;2;12;.857;1636000;0
2552;141496;42;0;0;0;0;.00nan;0;0
2553;173727;61;0;0;0;0;.00nan;0;0
2553;179306;61;63;33;3;30;.909;3900000;0
2553;38276;47;86;41;3;38;.927;3860000;0
2553;87798;47;0;0;0;0;.00nan;0;0
2554;173699;36;76;41;4;37;.902;3600000;0
2554;175084;65;28;24;5;19;.792;3574000;0
2554;38209;65;0;0;0;0;.00nan;0;0
2554;74734;36;0;0;0;0;.00nan;0;0
2555;171608;59;0;0;0;0;.00nan;0;0
2555;175912;57;86;52;3;49;.942;3052000;0
2555;57152;57;33;9;3;6;.667;548000;0
2555;58054;59;62;24;3;21;.875;3600000;0
2556;168651;40;0;0;0;0;.00nan;0;0
2556;170294;60;0;0;0;0;.00nan;0;0
2556;85797;60;76;19;1;18;.947;3600000;0
2556;142492;40;73;38;3;35;.921;3544000;0
2557;168586;44;0;0;0;0;.00nan;0;0
2557;57434;44;78;31;2;29;.935;3900000;0
2557;68938;46;0;0;0;0;.00nan;0;0
2557;79280;46;80;28;2;26;.929;3900000;0
2558;171838;41;100;32;0;32;1.000;3600000;0
2558;173699;36;0;0;0;0;.00nan;0;0
2558;170977;41;0;0;0;0;.00nan;0;0
2558;74734;36;63;28;3;25;.893;3600000;0
2559;171608;59;55;8;0;8;1.000;2628000;0
2559;37942;58;96;45;3;42;.933;3600000;0
2559;46780;58;0;0;0;0;.00nan;0;0
2559;58054;59;21;8;4;4;.500;972000;0
2560;162945;50;50;24;3;21;.875;3531000;0
2560;171673;50;0;0;0;0;.00nan;0;0
2560;176136;45;0;0;0;0;.00nan;0;0
2560;141484;45;97;36;1;35;.972;3600000;0
2561;170598;54;0;0;0;0;.00nan;0;0
2561;79132;49;74;24;1;23;.958;3600000;0
2561;91225;49;0;0;0;0;.00nan;0;0
2561;94615;54;62;40;4;36;.900;3600000;0
2562;168586;44;0;0;0;0;.00nan;0;0
2562;57434;44;34;38;7;31;.816;3600000;0
2562;68938;46;0;0;0;0;.00nan;0;0
2562;79280;46;79;40;3;37;.925;3600000;0
2563;163471;62;54;33;5;28;.848;3600000;0
2563;173727;61;49;26;4;22;.846;3600000;0
2563;179306;61;0;0;0;0;.00nan;0;0
2563;36346;62;0;0;0;0;.00nan;0;0
2564;165582;64;60;47;6;41;.872;3600000;0
2564;168872;64;0;0;0;0;.00nan;0;0
2564;75362;37;0;0;0;0;.00nan;0;0
2564;141850;37;56;17;2;15;.882;3600000;0
2565;171838;41;62;32;3;29;.906;3527000;0
2565;170977;41;0;0;0;0;.00nan;0;0
2565;68799;38;84;29;1;28;.966;3600000;0
2565;85428;38;0;0;0;0;.00nan;0;0
2566;170314;4619;26;8;3;5;.625;592000;0
2566;47112;4837;53;3;0;3;1.000;524000;0
2566;64800;4619;50;34;5;29;.853;2933000;0
2566;78775;4837;45;35;6;29;.829;3076000;0
2567;164715;63;0;0;0;0;.00nan;0;0
2567;180929;51;47;33;6;27;.818;2804000;0
2567;149455;51;62;10;0;10;1.000;796000;0
2567;149584;63;79;37;3;34;.919;3600000;0
2568;168651;40;0;0;0;0;.00nan;0;0
2568;38276;47;0;0;0;0;.00nan;0;0
2568;87798;47;54;25;3;22;.880;3889000;0
2568;142492;40;83;47;4;43;.915;3889000;0
2569;170598;54;49;38;5;33;.868;3600000;0
2569;79132;49;93;35;2;33;.943;3600000;0
2569;91225;49;0;0;0;0;.00nan;0;0
2569;94615;54;0;0;0;0;.00nan;0;0
2570;178413;39;0;0;0;0;.00nan;0;0
2570;175084;65;0;0;0;0;.00nan;0;0
2570;38209;65;74;33;3;30;.909;3600000;0
2570;85636;39;50;24;4;20;.833;3557000;0
2571;172340;48;40;23;4;19;.826;3600000;0
2571;168651;40;0;0;0;0;.00nan;0;0
2571;91456;48;0;0;0;0;.00nan;0;0
2571;142492;40;39;32;6;26;.813;3600000;0
2572;163471;62;81;42;3;39;.929;3554000;0
2572;170294;60;0;0;0;0;.00nan;0;0
2572;36346;62;0;0;0;0;.00nan;0;0
2572;85797;60;68;24;2;22;.917;3600000;0
2573;175084;65;0;0;0;0;.00nan;0;0
2573;38209;65;92;40;2;38;.950;3600000;0
2573;85336;56;62;24;3;21;.875;3545000;0
2573;85468;56;0;0;0;0;.00nan;0;0
2574;162945;50;87;29;1;28;.966;3600000;0
2574;171673;50;0;0;0;0;.00nan;0;0
2574;75362;37;73;43;4;39;.907;3600000;0
2574;141850;37;0;0;0;0;.00nan;0;0
2575;501;42;46;27;4;23;.852;3600000;0
2575;37942;58;0;0;0;0;.00nan;0;0
2575;46780;58;100;38;0;38;1.000;3600000;0
2575;141496;42;0;0;0;0;.00nan;0;0
2576;37077;55;0;0;0;0;.00nan;0;0
2576;59239;43;0;0;0;0;.00nan;0;0
2576;65014;55;90;31;1;30;.968;3600000;0
2576;90164;43;72;31;3;28;.903;3542000;0
2577;171608;59;0;0;0;0;.00nan;0;0
2577;58037;53;0;0;0;0;.00nan;0;0
2577;58054;59;66;27;3;24;.889;3600000;0
2577;78581;53;100;38;0;38;1.000;3600000;0
2578;175912;57;67;29;3;26;.897;3600000;0
2578;180929;51;48;27;4;23;.852;2422000;0
2578;57152;57;0;0;0;0;.00nan;0;0
2578;149455;51;20;20;5;15;.750;1178000;0
2579;172340;48;83;37;3;34;.919;3573000;0
2579;168586;44;0;0;0;0;.00nan;0;0
2579;57434;44;93;34;1;33;.971;3600000;0
2579;91456;48;0;0;0;0;.00nan;0;0
2580;163471;62;0;0;0;0;.00nan;0;0
2580;170294;60;0;0;0;0;.00nan;0;0
2580;36346;62;82;36;2;34;.944;3600000;0
2580;85797;60;66;16;1;15;.938;3600000;0
2581;37077;55;70;26;2;24;.923;3564000;0
2581;65014;55;0;0;0;0;.00nan;0;0
2581;85336;56;0;0;0;0;.00nan;0;0
2581;85468;56;92;36;1;35;.972;3600000;0
2582;171838;41;72;26;2;24;.923;3568000;0
2582;170977;41;0;0;0;0;.00nan;0;0
2582;175912;57;0;0;0;0;.00nan;0;0
2582;57152;57;83;25;1;24;.960;3600000;0
2583;180316;52;100;20;0;20;1.000;3600000;0
2583;37857;52;0;0;0;0;.00nan;0;0
2583;68799;38;40;32;6;26;.813;2093000;0
2583;85428;38;53;9;1;8;.889;1507000;0
2584;47112;4837;0;0;0;0;.00nan;0;0
2584;78775;4837;54;15;2;13;.867;3600000;0
2584;79132;49;90;44;3;41;.932;3600000;0
2584;91225;49;0;0;0;0;.00nan;0;0
2585;501;42;0;0;0;0;.00nan;0;0
2585;37942;58;0;0;0;0;.00nan;0;0
2585;46780;58;32;25;5;20;.800;3846000;0
2585;141496;42;72;36;4;32;.889;3846000;0
2586;175084;65;0;0;0;0;.00nan;0;0
2586;38209;65;91;49;4;45;.918;3562000;0
2586;59239;43;60;17;2;15;.882;3600000;0
2586;90164;43;0;0;0;0;.00nan;0;0
2587;171608;59;0;0;0;0;.00nan;0;0
2587;180929;51;92;65;5;60;.923;3600000;0
2587;58054;59;71;5;0;5;1.000;3600000;0
2587;149455;51;0;0;0;0;.00nan;0;0
2588;165582;64;88;40;3;37;.925;3578000;0
2588;168872;64;0;0;0;0;.00nan;0;0
2588;68938;46;0;0;0;0;.00nan;0;0
2588;79280;46;77;27;1;26;.963;3600000;0
2589;168651;40;0;0;0;0;.00nan;0;0
2589;170314;4619;51;34;4;30;.882;3600000;0
2589;64800;4619;0;0;0;0;.00nan;0;0
2589;142492;40;100;29;0;29;1.000;3600000;0
2590;164715;63;84;33;2;31;.939;3717000;0
2590;58037;53;0;0;0;0;.00nan;0;0
2590;78581;53;91;29;1;28;.966;3728000;0
2590;149584;63;0;0;0;0;.00nan;0;0
2591;162945;50;69;36;3;33;.917;3514000;0
2591;171673;50;0;0;0;0;.00nan;0;0
2591;75362;37;0;0;0;0;.00nan;0;0
2591;141850;37;68;24;1;23;.958;3600000;0
2592;173727;61;80;23;1;22;.957;3600000;0
2592;179306;61;0;0;0;0;.00nan;0;0
2592;38276;47;0;0;0;0;.00nan;0;0
2592;87798;47;58;37;5;32;.865;3600000;0
2593;170598;54;0;0;0;0;.00nan;0;0
2593;176136;45;0;0;0;0;.00nan;0;0
2593;94615;54;87;41;3;38;.927;3900000;0
2593;141484;45;69;30;3;27;.900;3900000;0
2594;178413;39;76;37;4;33;.892;3900000;0
2594;173699;36;0;0;0;0;.00nan;0;0
2594;74734;36;87;43;4;39;.907;3900000;0
2594;85636;39;0;0;0;0;.00nan;0;0
2595;172340;48;0;0;0;0;.00nan;0;0
2595;168586;44;0;0;0;0;.00nan;0;0
2595;57434;44;74;32;2;30;.938;3600000;0
2595;91456;48;72;36;3;33;.917;3575000;0
2596;171838;41;0;0;0;0;.00nan;0;0
2596;164715;63;0;0;0;0;.00nan;0;0
2596;170977;41;63;30;3;27;.900;3600000;0
2596;149584;63;42;25;4;21;.840;3600000;0
2597;180316;52;32;19;4;15;.789;3562000;0
2597;37857;52;0;0;0;0;.00nan;0;0
2597;68799;38;0;0;0;0;.00nan;0;0
2597;85428;38;92;41;2;39;.951;3600000;0
2598;47112;4837;0;0;0;0;.00nan;0;0
2598;78775;4837;70;21;1;20;.952;3600000;0
2598;79132;49;97;54;3;51;.944;3515000;0
2598;91225;49;0;0;0;0;.00nan;0;0
2599;165582;64;0;0;0;0;.00nan;0;0
2599;168872;64;68;27;2;25;.926;3600000;0
2599;68938;46;0;0;0;0;.00nan;0;0
2599;79280;46;53;26;3;23;.885;3561000;0
2600;173727;61;78;39;2;37;.949;3556000;0
2600;179306;61;0;0;0;0;.00nan;0;0
2600;38276;47;100;28;0;28;1.000;3600000;0
2600;87798;47;0;0;0;0;.00nan;0;0
2601;170598;54;86;25;1;24;.960;3900000;0
2601;176136;45;0;0;0;0;.00nan;0;0
2601;94615;54;0;0;0;0;.00nan;0;0
2601;141484;45;80;26;1;25;.962;3900000;0
2602;178413;39;0;0;0;0;.00nan;0;0
2602;173699;36;11;26;7;19;.731;1833000;0
2602;74734;36;50;21;3;18;.857;1767000;0
2602;85636;39;70;20;2;18;.900;3600000;0
2603;171608;59;0;0;0;0;.00nan;0;0
2603;175912;57;67;48;5;43;.896;3600000;0
2603;57152;57;0;0;0;0;.00nan;0;0
2603;58054;59;57;32;4;28;.875;3600000;0
2604;501;42;78;34;3;31;.912;3026000;0
2604;162945;50;74;23;2;21;.913;3600000;0
2604;171673;50;0;0;0;0;.00nan;0;0
2604;141496;42;31;10;3;7;.700;574000;0
2605;163471;62;69;55;6;49;.891;2897000;0
2605;36346;62;30;9;3;6;.667;703000;0
2605;38276;47;90;14;0;14;1.000;3600000;0
2605;87798;47;0;0;0;0;.00nan;0;0
2606;172340;48;69;31;3;28;.903;3600000;0
2606;170314;4619;56;35;4;31;.886;3600000;0
2606;64800;4619;0;0;0;0;.00nan;0;0
2606;91456;48;0;0;0;0;.00nan;0;0
2607;168651;40;0;0;0;0;.00nan;0;0
2607;47112;4837;0;0;0;0;.00nan;0;0
2607;78775;4837;100;37;1;36;.973;3600000;0
2607;142492;40;45;22;4;18;.818;3600000;0
2608;178413;39;0;0;0;0;.00nan;0;0
2608;85336;56;84;52;6;46;.885;3600000;0
2608;85468;56;0;0;0;0;.00nan;0;0
2608;85636;39;87;25;1;24;.960;3600000;0
2609;168586;44;0;0;0;0;.00nan;0;0
2609;170294;60;0;0;0;0;.00nan;0;0
2609;57434;44;66;32;4;28;.875;3900000;0
2609;85797;60;78;40;4;36;.900;3900000;0
2610;180929;51;0;0;0;0;.00nan;0;0
2610;59239;43;0;0;0;0;.00nan;0;0
2610;90164;43;65;16;2;14;.875;3600000;0
2610;149455;51;74;37;3;34;.919;3554000;0
2611;168586;44;0;0;0;0;.00nan;0;0
2611;170294;60;0;0;0;0;.00nan;0;0
2611;57434;44;74;33;3;30;.909;3600000;0
2611;85797;60;56;31;5;26;.839;3549000;0
2612;172340;48;0;0;0;0;.00nan;0;0
2612;163471;62;97;51;2;49;.961;3569000;0
2612;36346;62;0;0;0;0;.00nan;0;0
2612;91456;48;64;16;1;15;.938;3600000;0
2613;162945;50;42;27;5;22;.815;3600000;0
2613;171673;50;0;0;0;0;.00nan;0;0
2613;75362;37;73;27;2;25;.926;3600000;0
2613;141850;37;0;0;0;0;.00nan;0;0
2614;175084;65;0;0;0;0;.00nan;0;0
2614;38209;65;70;17;1;16;.941;3600000;0
2614;68799;38;0;0;0;0;.00nan;0;0
2614;85428;38;58;42;6;36;.857;3600000;0
2615;171608;59;0;0;0;0;.00nan;0;0
2615;37942;58;78;36;3;33;.917;3600000;0
2615;46780;58;0;0;0;0;.00nan;0;0
2615;58054;59;100;21;0;21;1.000;3600000;0
2616;165582;64;100;35;0;35;1.000;3600000;0
2616;168872;64;0;0;0;0;.00nan;0;0
2616;176136;45;0;0;0;0;.00nan;0;0
2616;141484;45;90;37;2;35;.946;3575000;0
2617;170314;4619;76;42;4;38;.905;3539000;0
2617;38276;47;52;26;3;23;.885;3600000;0
2617;64800;4619;0;0;0;0;.00nan;0;0
2617;87798;47;0;0;0;0;.00nan;0;0
2618;173699;36;0;0;0;0;.00nan;0;0
2618;58037;53;0;0;0;0;.00nan;0;0
2618;74734;36;78;30;3;27;.900;3583000;0
2618;78581;53;67;20;2;18;.900;3600000;0
2619;164715;63;97;48;2;46;.958;3600000;0
2619;85336;56;7;23;7;16;.696;2623000;0
2619;85468;56;32;5;2;3;.600;977000;0
2619;149584;63;0;0;0;0;.00nan;0;0
2620;168651;40;57;32;4;28;.875;3515000;0
2620;170598;54;0;0;0;0;.00nan;0;0
2620;94615;54;74;27;2;25;.926;3600000;0
2620;142492;40;0;0;0;0;.00nan;0;0
2621;178413;39;0;0;0;0;.00nan;0;0
2621;37077;55;0;0;0;0;.00nan;0;0
2621;65014;55;75;36;3;33;.917;3563000;0
2621;85636;39;81;28;1;27;.964;3600000;0
2622;173727;61;46;23;4;19;.826;3551000;0
2622;179306;61;0;0;0;0;.00nan;0;0
2622;79132;49;99;53;2;51;.962;3600000;0
2622;91225;49;0;0;0;0;.00nan;0;0
2623;171838;41;79;29;2;27;.931;3600000;0
2623;170977;41;0;0;0;0;.00nan;0;0
2623;175912;57;0;0;0;0;.00nan;0;0
2623;57152;57;46;30;5;25;.833;3566000;0
2624;165582;64;69;31;3;28;.903;3600000;0
2624;168872;64;0;0;0;0;.00nan;0;0
2624;75362;37;0;0;0;0;.00nan;0;0
2624;141850;37;78;35;2;33;.943;3600000;0
2625;180929;51;83;48;4;44;.917;3900000;0
2625;59239;43;0;0;0;0;.00nan;0;0
2625;90164;43;48;23;4;19;.826;3900000;0
2625;149455;51;0;0;0;0;.00nan;0;0
2626;170314;4619;19;15;5;10;.667;1107000;0
2626;47112;4837;48;22;4;18;.818;3568000;0
2626;64800;4619;84;24;2;22;.917;2793000;0
2626;78775;4837;29;8;3;5;.625;332000;0
2627;171838;41;35;22;5;17;.773;1363000;0
2627;170977;41;34;32;6;26;.813;2237000;0
2627;171608;59;0;0;0;0;.00nan;0;0
2627;58054;59;37;11;3;8;.727;3600000;0
2628;501;42;0;0;0;0;.00nan;0;0
2628;68938;46;0;0;0;0;.00nan;0;0
2628;79280;46;53;31;4;27;.871;3576000;0
2628;141496;42;93;40;2;38;.950;3600000;0
2629;173699;36;44;37;6;31;.838;3199000;0
2629;58037;53;0;0;0;0;.00nan;0;0
2629;74734;36;48;0;0;0;.00nan;345000;0
2629;78581;53;64;39;5;34;.872;3600000;0
2630;164715;63;0;0;0;0;.00nan;0;0
2630;85336;56;0;0;0;0;.00nan;0;0
2630;85468;56;100;27;0;27;1.000;3600000;0
2630;149584;63;62;45;5;40;.889;3600000;0
2631;162945;50;65;19;2;17;.895;3900000;0
2631;171673;50;0;0;0;0;.00nan;0;0
2631;176136;45;0;0;0;0;.00nan;0;0
2631;141484;45;100;49;2;47;.959;3900000;0
2632;168651;40;0;0;0;0;.00nan;0;0
2632;170598;54;0;0;0;0;.00nan;0;0
2632;94615;54;100;38;1;37;.974;3600000;0
2632;142492;40;60;23;3;20;.870;3533000;0
2633;175084;65;45;40;6;34;.850;3600000;0
2633;180316;52;0;0;0;0;.00nan;0;0
2633;37857;52;84;25;1;24;.960;3600000;0
2633;38209;65;0;0;0;0;.00nan;0;0
2634;178413;39;0;0;0;0;.00nan;0;0
2634;37077;55;0;0;0;0;.00nan;0;0
2634;65014;55;45;26;4;22;.846;3600000;0
2634;85636;39;75;33;3;30;.909;3600000;0
2635;173727;61;0;0;0;0;.00nan;0;0
2635;179306;61;94;26;0;26;1.000;3600000;0
2635;79132;49;98;47;2;45;.957;3575000;0
2635;91225;49;0;0;0;0;.00nan;0;0
2636;175912;57;93;40;2;38;.950;3600000;0
2636;37942;58;0;0;0;0;.00nan;0;0
2636;46780;58;81;42;3;39;.929;3592000;0
2636;57152;57;0;0;0;0;.00nan;0;0
2637;165582;64;0;0;0;0;.00nan;0;0
2637;168872;64;76;47;5;42;.894;3600000;0
2637;75362;37;81;23;1;22;.957;3600000;0
2637;141850;37;0;0;0;0;.00nan;0;0
2638;172340;48;29;9;3;6;.667;576000;0
2638;38276;47;0;0;0;0;.00nan;0;0
2638;87798;47;33;20;5;15;.750;3900000;0
2638;91456;48;85;39;2;37;.949;3324000;0
2639;180316;52;0;0;0;0;.00nan;0;0
2639;37857;52;87;24;2;22;.917;3600000;0
2639;68799;38;64;43;5;38;.884;3600000;0
2639;85428;38;0;0;0;0;.00nan;0;0
2640;175912;57;0;0;0;0;.00nan;0;0
2640;37942;58;70;37;4;33;.892;3900000;0
2640;46780;58;0;0;0;0;.00nan;0;0
2640;57152;57;60;37;4;33;.892;3900000;0
2641;501;42;100;30;0;30;1.000;3600000;0
2641;68938;46;50;16;2;14;.875;3352000;0
2641;79280;46;23;4;3;1;.250;248000;0
2641;141496;42;0;0;0;0;.00nan;0;0
2642;162945;50;74;19;1;18;.947;3600000;0
2642;171673;50;0;0;0;0;.00nan;0;0
2642;176136;45;47;23;3;20;.870;1350000;0
2642;141484;45;30;30;6;24;.800;2250000;0
2643;175084;65;0;0;0;0;.00nan;0;0
2643;38209;65;68;29;4;25;.862;3778000;0
2643;58037;53;0;0;0;0;.00nan;0;0
2643;78581;53;67;32;3;29;.906;3778000;0
2644;38276;47;51;20;4;16;.800;3621000;0
2644;79132;49;99;53;3;50;.943;3621000;0
2644;87798;47;0;0;0;0;.00nan;0;0
2644;91225;49;0;0;0;0;.00nan;0;0
2645;163471;62;98;46;1;45;.978;3560000;0
2645;170314;4619;94;27;0;27;1.000;3600000;0
2645;36346;62;0;0;0;0;.00nan;0;0
2645;64800;4619;0;0;0;0;.00nan;0;0
2646;37077;55;0;0;0;0;.00nan;0;0
2646;65014;55;72;24;3;21;.875;3600000;0
2646;85336;56;0;0;0;0;.00nan;0;0
2646;85468;56;67;35;4;31;.886;3600000;0
2647;172340;48;0;0;0;0;.00nan;0;0
2647;173727;61;0;0;0;0;.00nan;0;0
2647;179306;61;51;50;6;44;.880;3600000;0
2647;91456;48;63;18;2;16;.889;3600000;0
2648;38276;47;0;0;0;0;.00nan;0;0
2648;79132;49;0;0;0;0;.00nan;0;0
2648;87798;47;92;18;0;18;1.000;3600000;0
2648;91225;49;86;65;6;59;.908;3600000;0
2649;180316;52;0;0;0;0;.00nan;0;0
2649;37857;52;61;32;4;28;.875;3600000;0
2649;37942;58;0;0;0;0;.00nan;0;0
2649;46780;58;74;20;1;19;.950;3600000;0
2650;501;42;93;47;3;44;.936;3514000;0
2650;75362;37;0;0;0;0;.00nan;0;0
2650;141496;42;0;0;0;0;.00nan;0;0
2650;141850;37;52;10;1;9;.900;3600000;0
2651;176136;45;82;39;3;36;.923;3539000;0
2651;68938;46;0;0;0;0;.00nan;0;0
2651;79280;46;76;26;2;24;.923;3600000;0
2651;141484;45;0;0;0;0;.00nan;0;0
2652;164715;63;65;43;5;38;.884;3594000;0
2652;178413;39;0;0;0;0;.00nan;0;0
2652;85636;39;47;26;4;22;.846;3600000;0
2652;149584;63;0;0;0;0;.00nan;0;0
2653;168586;44;0;0;0;0;.00nan;0;0
2653;170294;60;0;0;0;0;.00nan;0;0
2653;57434;44;78;30;2;28;.933;3600000;0
2653;85797;60;43;28;5;23;.821;3600000;0
2654;59239;43;0;0;0;0;.00nan;0;0
2654;85336;56;31;32;6;26;.813;3211000;0
2654;85468;56;54;4;0;4;1.000;389000;0
2654;90164;43;95;22;0;22;1.000;3600000;0
2655;171838;41;84;63;5;58;.921;3600000;0
2655;170977;41;0;0;0;0;.00nan;0;0
2655;171608;59;0;0;0;0;.00nan;0;0
2655;58054;59;54;16;2;14;.875;3600000;0
2656;175912;57;71;35;3;32;.914;3565000;0
2656;57152;57;0;0;0;0;.00nan;0;0
2656;68799;38;0;0;0;0;.00nan;0;0
2656;85428;38;77;30;2;28;.933;3600000;0
2657;163471;62;92;60;4;56;.933;3900000;0
2657;36346;62;0;0;0;0;.00nan;0;0
2657;47112;4837;0;0;0;0;.00nan;0;0
2657;78775;4837;67;42;4;38;.905;3900000;0
2658;501;42;0;0;0;0;.00nan;0;0
2658;75362;37;0;0;0;0;.00nan;0;0
2658;141496;42;85;43;2;41;.953;3546000;0
2658;141850;37;74;25;1;24;.960;3600000;0
2659;175084;65;0;0;0;0;.00nan;0;0
2659;38209;65;98;58;3;55;.948;3567000;0
2659;58037;53;0;0;0;0;.00nan;0;0
2659;78581;53;71;24;2;22;.917;3600000;0
2660;164715;63;0;0;0;0;.00nan;0;0
2660;180929;51;41;29;6;23;.793;2866000;0
2660;149455;51;37;7;2;5;.714;734000;0
2660;149584;63;81;39;3;36;.923;3600000;0
2661;162945;50;25;11;4;7;.636;1070000;0
2661;165582;64;79;44;3;41;.932;3600000;0
2661;168872;64;0;0;0;0;.00nan;0;0
2661;171673;50;63;24;2;22;.917;2530000;0
2662;170598;54;0;0;0;0;.00nan;0;0
2662;68938;46;0;0;0;0;.00nan;0;0
2662;79280;46;86;31;1;30;.968;3600000;0
2662;94615;54;67;29;3;26;.897;3586000;0
2663;168651;40;53;33;5;28;.848;3600000;0
2663;173727;61;84;31;2;29;.935;3600000;0
2663;179306;61;0;0;0;0;.00nan;0;0
2663;142492;40;0;0;0;0;.00nan;0;0
2664;173699;36;0;0;0;0;.00nan;0;0
2664;37077;55;0;0;0;0;.00nan;0;0
2664;65014;55;76;27;2;25;.926;3600000;0
2664;74734;36;74;42;3;39;.929;3600000;0
2665;168586;44;0;0;0;0;.00nan;0;0
2665;170294;60;0;0;0;0;.00nan;0;0
2665;57434;44;30;23;5;18;.783;3600000;0
2665;85797;60;79;32;2;30;.938;3600000;0
2666;163471;62;62;17;1;16;.941;1888000;0
2666;36346;62;30;33;6;27;.818;1712000;0
2666;47112;4837;0;0;0;0;.00nan;0;0
2666;78775;4837;69;24;1;23;.958;3600000;0
2667;171838;41;0;0;0;0;.00nan;0;0
2667;170977;41;58;43;5;38;.884;3600000;0
2667;58037;53;0;0;0;0;.00nan;0;0
2667;78581;53;53;14;2;12;.857;3600000;0
2668;501;42;75;46;4;42;.913;3542000;0
2668;165582;64;0;0;0;0;.00nan;0;0
2668;168872;64;82;42;3;39;.929;3600000;0
2668;141496;42;0;0;0;0;.00nan;0;0
2669;170314;4619;88;29;1;28;.966;3600000;0
2669;64800;4619;0;0;0;0;.00nan;0;0
2669;79132;49;54;46;6;40;.870;3600000;0
2669;91225;49;0;0;0;0;.00nan;0;0
2670;180316;52;0;0;0;0;.00nan;0;0
2670;37857;52;100;40;0;40;1.000;3600000;0
2670;37942;58;81;23;1;22;.957;3546000;0
2670;46780;58;0;0;0;0;.00nan;0;0
2671;59239;43;0;0;0;0;.00nan;0;0
2671;85336;56;0;0;0;0;.00nan;0;0
2671;85468;56;43;35;5;30;.857;3592000;0
2671;90164;43;63;29;3;26;.897;3600000;0
2672;171608;59;0;0;0;0;.00nan;0;0
2672;175912;57;0;0;0;0;.00nan;0;0
2672;57152;57;74;53;6;47;.887;3600000;0
2672;58054;59;67;22;2;20;.909;3600000;0
2673;162945;50;41;16;3;13;.813;3600000;0
2673;171673;50;0;0;0;0;.00nan;0;0
2673;176136;45;0;0;0;0;.00nan;0;0
2673;141484;45;50;38;5;33;.868;3600000;0
2674;172340;48;55;45;7;38;.844;3600000;0
2674;38276;47;0;0;0;0;.00nan;0;0
2674;87798;47;100;28;0;28;1.000;3600000;0
2674;91456;48;0;0;0;0;.00nan;0;0
2675;175084;65;100;28;0;28;1.000;3600000;0
2675;38209;65;0;0;0;0;.00nan;0;0
2675;68799;38;77;41;4;37;.902;3600000;0
2675;85428;38;0;0;0;0;.00nan;0;0
2676;173699;36;46;41;6;35;.854;3010000;0
2676;37077;55;66;12;1;11;.917;3600000;0
2676;65014;55;0;0;0;0;.00nan;0;0
2676;74734;36;54;4;0;4;1.000;590000;0
2677;170598;54;63;37;4;33;.892;3600000;0
2677;68938;46;0;0;0;0;.00nan;0;0
2677;79280;46;86;25;1;24;.960;3600000;0
2677;94615;54;0;0;0;0;.00nan;0;0
2678;178413;39;69;23;2;21;.913;3546000;0
2678;180929;51;0;0;0;0;.00nan;0;0
2678;85636;39;0;0;0;0;.00nan;0;0
2678;149455;51;89;34;1;33;.971;3600000;0
2679;168651;40;97;45;1;44;.978;3582000;0
2679;173727;61;0;0;0;0;.00nan;0;0
2679;179306;61;100;27;0;27;1.000;3600000;0
2679;142492;40;0;0;0;0;.00nan;0;0
2680;162945;50;86;34;1;33;.971;3600000;0
2680;165582;64;52;37;5;32;.865;3600000;0
2680;168872;64;0;0;0;0;.00nan;0;0
2680;171673;50;0;0;0;0;.00nan;0;0
2681;172340;48;0;0;0;0;.00nan;0;0
2681;38276;47;0;0;0;0;.00nan;0;0
2681;87798;47;41;18;3;15;.833;3600000;0
2681;91456;48;51;52;8;44;.846;3600000;0
2682;170314;4619;73;34;3;31;.912;3600000;0
2682;64800;4619;0;0;0;0;.00nan;0;0
2682;79132;49;28;31;6;25;.806;3600000;0
2682;91225;49;0;0;0;0;.00nan;0;0
2683;176136;45;39;23;5;18;.783;1183000;0
2683;75362;37;86;18;0;18;1.000;3600000;0
2683;141484;45;70;41;4;37;.902;2417000;0
2683;141850;37;0;0;0;0;.00nan;0;0
2684;171608;59;77;32;3;29;.906;3561000;0
2684;180316;52;0;0;0;0;.00nan;0;0
2684;37857;52;93;31;1;30;.968;3600000;0
2684;58054;59;0;0;0;0;.00nan;0;0
2685;58037;53;75;21;1;20;.952;3600000;0
2685;68799;38;0;0;0;0;.00nan;0;0
2685;78581;53;0;0;0;0;.00nan;0;0
2685;85428;38;77;29;2;27;.931;3543000;0
2686;178413;39;0;0;0;0;.00nan;0;0
2686;180929;51;41;26;5;21;.808;1117000;0
2686;85636;39;78;10;0;10;1.000;3600000;0
2686;149455;51;92;53;3;50;.943;2483000;0
2687;164715;63;81;24;1;23;.958;3600000;0
2687;173699;36;0;0;0;0;.00nan;0;0
2687;74734;36;65;37;4;33;.892;3600000;0
2687;149584;63;0;0;0;0;.00nan;0;0
2689;162945;38;87;38;2;36;.947;3900000;0
2689;180929;51;98;40;2;38;.950;3900000;0
2689;85428;38;0;0;0;0;.00nan;0;0
2689;149455;51;0;0;0;0;.00nan;0;0
2691;171838;41;60;32;4;28;.875;3561000;0
2691;163462;55;60;22;2;20;.909;3600000;0
2691;170977;41;0;0;0;0;.00nan;0;0
2691;86862;55;0;0;0;0;.00nan;0;0
2693;173727;61;91;32;1;31;.969;3600000;0
2693;37077;4837;0;0;0;0;.00nan;0;0
2693;47112;4837;77;27;2;25;.926;3548000;0
2693;57207;61;0;0;0;0;.00nan;0;0
2695;58037;53;0;0;0;0;.00nan;0;0
2695;58054;59;46;18;3;15;.833;3600000;0
2695;69902;59;0;0;0;0;.00nan;0;0
2695;78581;53;100;27;0;27;1.000;3600000;0
2697;172340;48;43;26;5;21;.808;3621000;0
2697;171608;46;0;0;0;0;.00nan;0;0
2697;68938;46;66;37;4;33;.892;3621000;0
2697;78775;48;0;0;0;0;.00nan;0;0
2699;165582;64;88;29;1;28;.966;3900000;0
2699;168872;64;0;0;0;0;.00nan;0;0
2699;171673;50;86;28;1;27;.964;3900000;0
2699;68799;50;0;0;0;0;.00nan;0;0
2701;501;42;0;0;0;0;.00nan;0;0
2701;175912;57;0;0;0;0;.00nan;0;0
2701;57152;57;96;53;4;49;.925;3572000;0
2701;141496;42;64;23;2;21;.913;3600000;0
2703;170314;4619;82;31;2;29;.935;3600000;0
2703;176206;58;0;0;0;0;.00nan;0;0
2703;46780;58;42;27;4;23;.852;3596000;0
2703;147492;4619;0;0;0;0;.00nan;0;0
2705;170294;60;0;0;0;0;.00nan;0;0
2705;79132;49;67;38;4;34;.895;3542000;0
2705;85797;60;66;22;2;20;.909;3600000;0
2705;91225;49;0;0;0;0;.00nan;0;0
2707;163471;62;62;24;3;21;.875;3545000;0
2707;176136;45;0;0;0;0;.00nan;0;0
2707;36346;62;0;0;0;0;.00nan;0;0
2707;141484;45;86;37;2;35;.946;3600000;0
2709;175084;65;0;0;0;0;.00nan;0;0
2709;38209;65;54;38;5;33;.868;3516000;0
2709;38276;47;65;27;3;24;.889;3600000;0
2709;87798;47;0;0;0;0;.00nan;0;0
2711;173699;36;95;44;2;42;.955;3600000;0
2711;58100;56;53;3;0;3;1.000;258000;0
2711;74734;36;0;0;0;0;.00nan;0;0
2711;91398;56;28;24;6;18;.750;3342000;0
2713;168651;40;59;24;2;22;.917;3600000;0
2713;180316;52;0;0;0;0;.00nan;0;0
2713;37857;52;63;27;3;24;.889;3567000;0
2713;142492;40;0;0;0;0;.00nan;0;0
2715;164715;63;52;2;0;2;1.000;302000;0
2715;168586;44;0;0;0;0;.00nan;0;0
2715;64811;44;95;22;0;22;1.000;3600000;0
2715;149584;63;33;39;7;32;.821;3298000;0
2717;178413;39;0;0;0;0;.00nan;0;0
2717;59239;43;0;0;0;0;.00nan;0;0
2717;85636;39;80;44;4;40;.909;3600000;0
2717;90164;43;36;27;5;22;.815;3520000;0
2719;170598;54;0;0;0;0;.00nan;0;0
2719;60773;37;0;0;0;0;.00nan;0;0
2719;94615;54;75;42;4;38;.905;3600000;0
2719;141850;37;70;18;1;17;.944;3600000;0
37;175912;57;0;0;0;0;.00nan;0;0
37;180316;52;0;0;0;0;.00nan;0;0
37;37857;52;68;30;3;27;.900;3600000;0
37;57152;57;71;47;6;41;.872;3600000;0
38;175084;65;95;25;0;25;1.000;3600000;0
38;37942;58;0;0;0;0;.00nan;0;0
38;38209;65;0;0;0;0;.00nan;0;0
38;46780;58;68;37;4;33;.892;3600000;0
39;164715;63;79;37;3;34;.919;3600000;0
39;85336;56;0;0;0;0;.00nan;0;0
39;85468;56;47;24;4;20;.833;3546000;0
39;149584;63;0;0;0;0;.00nan;0;0
40;165582;64;84;41;4;37;.902;3540000;0
40;168872;64;0;0;0;0;.00nan;0;0
40;68938;46;0;0;0;0;.00nan;0;0
40;79280;46;88;38;2;36;.947;3600000;0
41;170294;60;0;0;0;0;.00nan;0;0
41;170314;4619;98;53;3;50;.943;4846000;0
41;64800;4619;0;0;0;0;.00nan;0;0
41;85797;60;70;44;4;40;.909;4846000;0
42;168586;44;0;0;0;0;.00nan;0;0
42;173727;61;37;31;6;25;.806;3543000;0
42;179306;61;0;0;0;0;.00nan;0;0
42;57434;44;76;41;5;36;.878;3600000;0
43;172340;48;51;21;3;18;.857;3600000;0
43;47112;4837;44;30;5;25;.833;3538000;0
43;78775;4837;0;0;0;0;.00nan;0;0
43;91456;48;0;0;0;0;.00nan;0;0
44;175912;57;0;0;0;0;.00nan;0;0
44;180316;52;0;0;0;0;.00nan;0;0
44;37857;52;61;34;4;30;.882;3545000;0
44;57152;57;78;38;3;35;.921;3600000;0
45;175084;65;0;0;0;0;.00nan;0;0
45;37942;58;0;0;0;0;.00nan;0;0
45;38209;65;83;40;2;38;.950;4503000;0
45;46780;58;98;28;1;27;.964;4503000;0
46;164715;63;0;0;0;0;.00nan;0;0
46;85336;56;67;28;3;25;.893;3600000;0
46;85468;56;0;0;0;0;.00nan;0;0
46;149584;63;44;41;6;35;.854;3600000;0
47;165582;64;74;34;3;31;.912;3550000;0
47;168872;64;0;0;0;0;.00nan;0;0
47;68938;46;0;0;0;0;.00nan;0;0
47;79280;46;87;39;2;37;.949;3600000;0
48;170294;60;0;0;0;0;.00nan;0;0
48;170314;4619;81;24;2;22;.917;3641000;0
48;64800;4619;0;0;0;0;.00nan;0;0
48;85797;60;81;24;1;23;.958;3641000;0
49;168586;44;0;0;0;0;.00nan;0;0
49;173727;61;87;35;2;33;.943;3600000;0
49;179306;61;0;0;0;0;.00nan;0;0
49;57434;44;48;23;3;20;.870;3550000;0
50;172340;48;57;32;4;28;.875;3544000;0
50;47112;4837;0;0;0;0;.00nan;0;0
50;78775;4837;56;23;3;20;.870;3600000;0
50;91456;48;0;0;0;0;.00nan;0;0
106;175912;57;0;0;0;0;.00nan;0;0
106;180316;52;0;0;0;0;.00nan;0;0
106;37857;52;72;32;3;29;.906;3600000;0
106;57152;57;65;41;5;36;.878;3565000;0
107;175084;65;0;0;0;0;.00nan;0;0
107;37942;58;0;0;0;0;.00nan;0;0
107;38209;65;96;42;3;39;.929;3600000;0
107;46780;58;62;37;5;32;.865;3576000;0
108;164715;63;0;0;0;0;.00nan;0;0
108;85336;56;64;31;4;27;.871;3600000;0
108;85468;56;0;0;0;0;.00nan;0;0
108;149584;63;54;36;5;31;.861;3546000;0
109;170294;60;0;0;0;0;.00nan;0;0
109;170314;4619;72;38;4;34;.895;3529000;0
109;64800;4619;0;0;0;0;.00nan;0;0
109;85797;60;99;35;2;33;.943;3600000;0
110;168586;44;0;0;0;0;.00nan;0;0
110;173727;61;80;33;2;31;.939;4157000;0
110;179306;61;0;0;0;0;.00nan;0;0
110;57434;44;69;37;3;34;.919;4157000;0
111;172340;48;74;39;3;36;.923;3600000;0
111;47112;4837;0;0;0;0;.00nan;0;0
111;78775;4837;82;34;2;32;.941;3600000;0
111;91456;48;0;0;0;0;.00nan;0;0
120;171608;59;0;0;0;0;.00nan;0;0
120;175084;65;0;0;0;0;.00nan;0;0
120;38209;65;70;52;5;47;.904;3600000;0
120;58054;59;62;15;1;14;.933;3600000;0
121;180316;52;0;0;0;0;.00nan;0;0
121;37857;52;66;31;4;27;.871;3600000;0
121;58037;53;0;0;0;0;.00nan;0;0
121;78581;53;46;44;7;37;.841;3600000;0
122;59239;43;0;0;0;0;.00nan;0;0
122;85336;56;90;38;2;36;.947;3600000;0
122;85468;56;0;0;0;0;.00nan;0;0
122;90164;43;43;18;3;15;.833;3578000;0
123;178413;39;0;0;0;0;.00nan;0;0
123;37077;55;0;0;0;0;.00nan;0;0
123;65014;55;73;29;2;27;.931;3600000;0
123;85636;39;70;28;3;25;.893;3593000;0
124;68938;46;0;0;0;0;.00nan;0;0
124;75362;37;0;0;0;0;.00nan;0;0
124;79280;46;92;46;3;43;.935;4245000;0
124;141850;37;70;28;2;26;.929;4245000;0
125;501;42;0;0;0;0;.00nan;0;0
125;162945;50;56;25;3;22;.880;3600000;0
125;171673;50;0;0;0;0;.00nan;0;0
125;141496;42;53;43;5;38;.884;3588000;0
126;173727;61;72;40;3;37;.925;4145000;0
126;179306;61;0;0;0;0;.00nan;0;0
126;38276;47;0;0;0;0;.00nan;0;0
126;87798;47;84;40;4;36;.900;4145000;0
127;170294;60;0;0;0;0;.00nan;0;0
127;47112;4837;0;0;0;0;.00nan;0;0
127;78775;4837;52;26;4;22;.846;3572000;0
127;85797;60;76;39;3;36;.923;3600000;0
128;171608;59;0;0;0;0;.00nan;0;0
128;175084;65;0;0;0;0;.00nan;0;0
128;38209;65;90;55;4;51;.927;3600000;0
128;58054;59;54;10;1;9;.900;3600000;0
129;180316;52;0;0;0;0;.00nan;0;0
129;37857;52;79;27;2;25;.926;3600000;0
129;58037;53;0;0;0;0;.00nan;0;0
129;78581;53;66;28;3;25;.893;3599000;0
130;59239;43;0;0;0;0;.00nan;0;0
130;85336;56;64;32;3;29;.906;3591000;0
130;85468;56;0;0;0;0;.00nan;0;0
130;90164;43;56;19;2;17;.895;3600000;0
131;178413;39;0;0;0;0;.00nan;0;0
131;37077;55;0;0;0;0;.00nan;0;0
131;65014;55;72;50;3;47;.940;5438000;0
131;85636;39;48;25;4;21;.840;5438000;0
132;68938;46;0;0;0;0;.00nan;0;0
132;75362;37;0;0;0;0;.00nan;0;0
132;79280;46;86;46;3;43;.935;3600000;0
132;141850;37;92;15;0;15;1.000;3600000;0
133;501;42;0;0;0;0;.00nan;0;0
133;162945;50;99;38;1;37;.974;3600000;0
133;171673;50;0;0;0;0;.00nan;0;0
133;141496;42;63;37;4;33;.892;3600000;0
134;173727;61;57;36;5;31;.861;3600000;0
134;179306;61;0;0;0;0;.00nan;0;0
134;38276;47;0;0;0;0;.00nan;0;0
134;87798;47;100;29;0;29;1.000;3600000;0
135;170294;60;0;0;0;0;.00nan;0;0
135;47112;4837;0;0;0;0;.00nan;0;0
135;78775;4837;48;33;5;28;.848;3600000;0
135;85797;60;70;23;2;21;.913;3600000;0
136;171608;59;0;0;0;0;.00nan;0;0
136;175084;65;0;0;0;0;.00nan;0;0
136;38209;65;93;67;2;65;.970;4671000;0
136;58054;59;78;28;1;27;.964;4671000;0
137;180316;52;0;0;0;0;.00nan;0;0
137;37857;52;95;32;1;31;.969;3600000;0
137;58037;53;0;0;0;0;.00nan;0;0
137;78581;53;92;40;2;38;.950;3546000;0
138;59239;43;0;0;0;0;.00nan;0;0
138;85336;56;77;35;3;32;.914;3549000;0
138;85468;56;0;0;0;0;.00nan;0;0
138;90164;43;80;31;1;30;.968;3600000;0
139;178413;39;0;0;0;0;.00nan;0;0
139;37077;55;0;0;0;0;.00nan;0;0
139;65014;55;97;31;1;30;.968;3600000;0
139;85636;39;70;29;2;27;.931;3548000;0
140;68938;46;0;0;0;0;.00nan;0;0
140;75362;37;0;0;0;0;.00nan;0;0
140;79280;46;86;27;1;26;.963;3600000;0
140;141850;37;66;28;3;25;.893;3545000;0
141;501;42;0;0;0;0;.00nan;0;0
141;162945;50;64;13;1;12;.923;3600000;0
141;171673;50;0;0;0;0;.00nan;0;0
141;141496;42;58;43;6;37;.860;3600000;0
142;173727;61;44;30;5;25;.833;3549000;0
142;179306;61;0;0;0;0;.00nan;0;0
142;38276;47;0;0;0;0;.00nan;0;0
142;87798;47;59;31;4;27;.871;3600000;0
143;170294;60;0;0;0;0;.00nan;0;0
143;47112;4837;0;0;0;0;.00nan;0;0
143;78775;4837;87;46;3;43;.935;3847000;0
143;85797;60;71;33;2;31;.939;3847000;0
208;59239;43;0;0;0;0;.00nan;0;0
208;85336;56;95;51;4;47;.922;3600000;0
208;85468;56;0;0;0;0;.00nan;0;0
208;90164;43;84;25;1;24;.960;3600000;0
209;68938;46;0;0;0;0;.00nan;0;0
209;75362;37;0;0;0;0;.00nan;0;0
209;79280;46;81;44;3;41;.932;3600000;0
209;141850;37;86;19;0;19;1.000;3600000;0
210;173727;61;72;44;5;39;.886;3600000;0
210;179306;61;0;0;0;0;.00nan;0;0
210;38276;47;0;0;0;0;.00nan;0;0
210;87798;47;66;26;2;24;.923;3600000;0
236;171608;59;0;0;0;0;.00nan;0;0
236;180316;52;0;0;0;0;.00nan;0;0
236;37857;52;89;42;2;40;.952;3649000;0
236;58054;59;67;23;3;20;.870;3649000;0
237;37077;55;64;8;0;8;1.000;1526000;0
237;59239;43;0;0;0;0;.00nan;0;0
237;65014;55;19;22;6;16;.727;2074000;0
237;90164;43;92;30;2;28;.933;3600000;0
238;162945;50;78;32;2;30;.938;3576000;0
238;171673;50;0;0;0;0;.00nan;0;0
238;75362;37;0;0;0;0;.00nan;0;0
238;141850;37;90;28;1;27;.964;3600000;0
239;170294;60;0;0;0;0;.00nan;0;0
239;38276;47;0;0;0;0;.00nan;0;0
239;85797;60;83;41;3;38;.927;3570000;0
239;87798;47;84;25;1;24;.960;3600000;0
240;171608;59;0;0;0;0;.00nan;0;0
240;180316;52;0;0;0;0;.00nan;0;0
240;37857;52;67;35;4;31;.886;3600000;0
240;58054;59;84;24;1;23;.958;3600000;0
241;37077;55;0;0;0;0;.00nan;0;0
241;59239;43;0;0;0;0;.00nan;0;0
241;65014;55;76;30;2;28;.933;3600000;0
241;90164;43;66;15;1;14;.933;3600000;0
242;162945;50;94;50;3;47;.940;3683000;0
242;171673;50;0;0;0;0;.00nan;0;0
242;75362;37;0;0;0;0;.00nan;0;0
242;141850;37;77;32;2;30;.938;3683000;0
243;170294;60;0;0;0;0;.00nan;0;0
243;38276;47;0;0;0;0;.00nan;0;0
243;85797;60;48;26;4;22;.846;3600000;0
243;87798;47;91;18;0;18;1.000;3600000;0
244;171608;59;0;0;0;0;.00nan;0;0
244;180316;52;0;0;0;0;.00nan;0;0
244;37857;52;46;31;5;26;.839;3600000;0
244;58054;59;86;31;2;29;.935;3600000;0
245;37077;55;0;0;0;0;.00nan;0;0
245;59239;43;0;0;0;0;.00nan;0;0
245;65014;55;70;38;3;35;.921;3600000;0
245;90164;43;88;16;0;16;1.000;3600000;0
246;162945;50;68;33;3;30;.909;3542000;0
246;171673;50;0;0;0;0;.00nan;0;0
246;75362;37;0;0;0;0;.00nan;0;0
246;141850;37;88;28;1;27;.964;3600000;0
247;170294;60;0;0;0;0;.00nan;0;0
247;38276;47;0;0;0;0;.00nan;0;0
247;85797;60;58;37;4;33;.892;3581000;0
247;87798;47;67;21;2;19;.905;3600000;0
364;171608;59;0;0;0;0;.00nan;0;0
364;180316;52;0;0;0;0;.00nan;0;0
364;37857;52;75;22;1;21;.955;3674000;0
364;58054;59;84;30;2;28;.933;3674000;0
369;171608;59;0;0;0;0;.00nan;0;0
369;180316;52;91;38;2;36;.947;3065000;0
369;37857;52;32;9;3;6;.667;456000;0
369;58054;59;69;30;3;27;.900;3600000;0
372;171608;59;0;0;0;0;.00nan;0;0
372;58054;59;70;38;4;34;.895;3592000;0
372;59239;43;0;0;0;0;.00nan;0;0
372;90164;43;72;29;3;26;.897;3600000;0
373;38276;47;0;0;0;0;.00nan;0;0
373;75362;37;0;0;0;0;.00nan;0;0
373;87798;47;85;39;3;36;.923;3738000;0
373;141850;37;83;35;2;33;.943;3738000;0
374;171608;59;0;0;0;0;.00nan;0;0
374;58054;59;50;31;4;27;.871;3584000;0
374;59239;43;0;0;0;0;.00nan;0;0
374;90164;43;87;30;3;27;.900;3600000;0
375;38276;47;0;0;0;0;.00nan;0;0
375;75362;37;0;0;0;0;.00nan;0;0
375;87798;47;76;25;2;23;.920;3600000;0
375;141850;37;73;44;4;40;.909;3517000;0
376;171608;59;0;0;0;0;.00nan;0;0
376;58054;59;71;39;5;34;.872;3600000;0
376;59239;43;0;0;0;0;.00nan;0;0
376;90164;43;58;33;4;29;.879;3600000;0
377;38276;47;0;0;0;0;.00nan;0;0
377;75362;37;0;0;0;0;.00nan;0;0
377;87798;47;63;15;1;14;.933;3592000;0
377;141850;37;100;28;0;28;1.000;3600000;0
378;171608;59;49;1;0;1;1.000;266000;0
378;58054;59;15;24;6;18;.750;3334000;0
378;59239;43;0;0;0;0;.00nan;0;0
378;90164;43;93;36;2;34;.944;3600000;0
379;38276;47;0;0;0;0;.00nan;0;0
379;75362;37;0;0;0;0;.00nan;0;0
379;87798;47;68;31;2;29;.935;4068000;0
379;141850;37;90;47;3;44;.936;4068000;0
422;38276;47;0;0;0;0;.00nan;0;0
422;75362;37;0;0;0;0;.00nan;0;0
422;87798;47;61;35;4;31;.886;3600000;0
422;141850;37;88;32;1;31;.969;3600000;0
425;38276;47;0;0;0;0;.00nan;0;0
425;75362;37;0;0;0;0;.00nan;0;0
425;87798;47;49;22;3;19;.864;3600000;0
425;141850;37;52;36;5;31;.861;3527000;0
427;38276;47;0;0;0;0;.00nan;0;0
427;75362;37;0;0;0;0;.00nan;0;0
427;87798;47;85;34;3;31;.912;4208000;0
427;141850;37;84;26;2;24;.923;4208000;0
429;59239;43;0;0;0;0;.00nan;0;0
429;75362;37;0;0;0;0;.00nan;0;0
429;90164;43;56;36;4;32;.889;4575000;0
429;141850;37;71;50;5;45;.900;4575000;0
430;59239;43;0;0;0;0;.00nan;0;0
430;75362;37;0;0;0;0;.00nan;0;0
430;90164;43;78;34;2;32;.941;3826000;0
430;141850;37;72;34;3;31;.912;3826000;0
431;59239;43;0;0;0;0;.00nan;0;0
431;75362;37;0;0;0;0;.00nan;0;0
431;90164;43;58;37;5;32;.865;3600000;0
431;141850;37;95;30;2;28;.933;3600000;0
432;59239;43;0;0;0;0;.00nan;0;0
432;75362;37;0;0;0;0;.00nan;0;0
432;90164;43;100;36;1;35;.972;3600000;0
432;141850;37;36;20;4;16;.800;3600000;0
449;59239;43;0;0;0;0;.00nan;0;0
449;75362;37;0;0;0;0;.00nan;0;0
449;90164;43;100;29;0;29;1.000;3600000;0
449;141850;37;75;27;2;25;.926;3589000;0
2720;176686;739;83;38;2;36;.947;3600000;0
2720;186234;739;0;0;0;0;.00nan;0;0
2720;56565;741;51;25;3;22;.880;3580000;0
2720;57695;741;0;0;0;0;.00nan;0;0
2721;3756;748;79;30;2;28;.933;3535000;0
2721;-1;748;0;0;0;0;.00nan;0;0
2721;185413;751;0;0;0;0;.00nan;0;0
2721;-1;751;98;20;0;20;1.000;3600000;0
2722;178114;752;0;0;0;0;.00nan;0;0
2722;-1;2168;0;0;0;0;.00nan;0;0
2722;33480;752;57;26;3;23;.885;3900000;0
2722;76405;2168;72;32;3;29;.906;3900000;0
2723;1957;734;75;31;3;28;.903;3746000;0
2723;6079;734;0;0;0;0;.00nan;0;0
2723;175764;1880;0;0;0;0;.00nan;0;0
2723;49900;1880;62;37;4;33;.892;3746000;0
2724;178098;738;0;0;0;0;.00nan;0;0
2724;185363;740;0;0;0;0;.00nan;0;0
2724;185442;738;65;34;3;31;.912;3600000;0
2724;152624;740;90;50;4;46;.920;3600000;0
2725;3508;745;45;29;4;25;.862;3554000;0
2725;6868;764;0;0;0;0;.00nan;0;0
2725;174898;764;99;43;2;41;.953;3600000;0
2725;180188;745;0;0;0;0;.00nan;0;0
2726;6570;3789;63;34;4;30;.882;3584000;0
2726;-1;3789;0;0;0;0;.00nan;0;0
2726;46792;743;71;26;2;24;.923;3600000;0
2726;148956;743;0;0;0;0;.00nan;0;0
2727;83;737;100;19;0;19;1.000;3600000;0
2727;190570;737;0;0;0;0;.00nan;0;0
2727;186219;736;0;0;0;0;.00nan;0;0
2727;44526;736;95;43;2;41;.953;3569000;0
2728;170543;747;53;41;5;36;.878;3600000;0
2728;190589;747;0;0;0;0;.00nan;0;0
2728;-1;733;0;0;0;0;.00nan;0;0
2728;85787;733;76;46;4;42;.913;3600000;0
2729;3928;744;70;23;2;21;.913;3548000;0
2729;43971;742;71;22;1;21;.955;3600000;0
2729;52204;742;0;0;0;0;.00nan;0;0
2729;64722;744;0;0;0;0;.00nan;0;0
2730;176686;739;99;48;1;47;.979;3600000;0
2730;186234;739;0;0;0;0;.00nan;0;0
2730;85281;749;0;0;0;0;.00nan;0;0
2730;86697;749;61;22;2;20;.909;3546000;0
2731;186235;732;34;27;6;21;.778;2536000;0
2731;192386;732;53;9;1;8;.889;1064000;0
2731;50065;729;75;27;1;26;.963;3600000;0
2731;93324;729;0;0;0;0;.00nan;0;0
2732;6868;764;34;31;6;25;.806;3600000;0
2732;174898;764;0;0;0;0;.00nan;0;0
2732;56565;741;85;33;2;31;.939;3600000;0
2732;57695;741;0;0;0;0;.00nan;0;0
2733;-1;2168;0;0;0;0;.00nan;0;0
2733;185413;751;20;34;7;27;.794;2321000;0
2733;-1;751;36;7;2;5;.714;1279000;0
2733;76405;2168;59;30;4;26;.867;3600000;0
2734;178098;738;80;34;3;31;.912;3569000;0
2734;170543;747;85;35;2;33;.943;3600000;0
2734;190589;747;0;0;0;0;.00nan;0;0
2734;185442;738;0;0;0;0;.00nan;0;0
2735;83;737;100;24;0;24;1.000;3600000;0
2735;175764;1880;0;0;0;0;.00nan;0;0
2735;190570;737;0;0;0;0;.00nan;0;0
2735;49900;1880;35;29;6;23;.793;3600000;0
2736;3508;745;52;21;3;18;.857;3600000;0
2736;180188;745;0;0;0;0;.00nan;0;0
2736;185363;740;75;28;2;26;.929;1283000;0
2736;152624;740;49;38;6;32;.842;2317000;0
2737;1957;734;0;0;0;0;.00nan;0;0
2737;6079;734;60;22;2;20;.909;3600000;0
2737;186219;736;0;0;0;0;.00nan;0;0
2737;44526;736;84;43;3;40;.930;3600000;0
2738;6570;3789;71;38;3;35;.921;3600000;0
2738;-1;733;0;0;0;0;.00nan;0;0
2738;-1;3789;0;0;0;0;.00nan;0;0
2738;85787;733;40;26;5;21;.808;3570000;0
2739;178114;752;0;0;0;0;.00nan;0;0
2739;33480;752;59;16;1;15;.938;3600000;0
2739;43971;742;75;49;5;44;.898;3600000;0
2739;52204;742;0;0;0;0;.00nan;0;0
2740;3928;744;66;18;1;17;.944;3600000;0
2740;176686;739;0;0;0;0;.00nan;0;0
2740;186234;739;91;42;2;40;.952;3600000;0
2740;64722;744;0;0;0;0;.00nan;0;0
2741;175764;1880;0;0;0;0;.00nan;0;0
2741;49900;1880;56;39;5;34;.872;3600000;0
2741;56565;741;100;29;0;29;1.000;3600000;0
2741;57695;741;0;0;0;0;.00nan;0;0
2742;83;737;100;26;0;26;1.000;3600000;0
2742;6570;3789;91;35;1;34;.971;3557000;0
2742;190570;737;0;0;0;0;.00nan;0;0
2742;-1;3789;0;0;0;0;.00nan;0;0
2743;3508;745;66;28;3;25;.893;3516000;0
2743;178114;752;0;0;0;0;.00nan;0;0
2743;33480;752;96;43;1;42;.977;3600000;0
2743;180188;745;0;0;0;0;.00nan;0;0
2744;6868;764;67;27;2;25;.926;3600000;0
2744;174898;764;0;0;0;0;.00nan;0;0
2744;50065;729;94;31;1;30;.968;3600000;0
2744;93324;729;0;0;0;0;.00nan;0;0
2745;185363;740;0;0;0;0;.00nan;0;0
2745;186235;732;0;0;0;0;.00nan;0;0
2745;192386;732;94;38;2;36;.947;3600000;0
2745;152624;740;46;32;5;27;.844;3600000;0
2746;1957;734;0;0;0;0;.00nan;0;0
2746;6079;734;78;27;1;26;.963;3600000;0
2746;46792;743;95;39;2;37;.949;3570000;0
2746;148956;743;0;0;0;0;.00nan;0;0
2747;170543;747;65;39;4;35;.897;3632000;0
2747;190589;747;0;0;0;0;.00nan;0;0
2747;186219;736;0;0;0;0;.00nan;0;0
2747;44526;736;49;30;5;25;.833;3632000;0
2748;-1;733;0;0;0;0;.00nan;0;0
2748;85281;749;61;28;3;25;.893;3795000;0
2748;85787;733;99;40;2;38;.950;3795000;0
2748;86697;749;0;0;0;0;.00nan;0;0
2749;3756;748;95;33;1;32;.970;3600000;0
2749;-1;748;0;0;0;0;.00nan;0;0
2749;43971;742;79;31;2;29;.935;3560000;0
2749;52204;742;0;0;0;0;.00nan;0;0
2750;3928;744;61;21;2;19;.905;3600000;0
2750;178098;738;63;29;4;25;.862;3576000;0
2750;185442;738;0;0;0;0;.00nan;0;0
2750;64722;744;0;0;0;0;.00nan;0;0
2751;-1;2168;0;0;0;0;.00nan;0;0
2751;185413;751;20;13;4;9;.692;945000;0
2751;-1;751;72;32;2;30;.938;2655000;0
2751;76405;2168;77;24;1;23;.958;3600000;0
2752;83;737;60;26;3;23;.885;3553000;0
2752;190570;737;0;0;0;0;.00nan;0;0
2752;56565;741;95;31;1;30;.968;3600000;0
2752;57695;741;0;0;0;0;.00nan;0;0
2753;185363;740;0;0;0;0;.00nan;0;0
2753;50065;729;88;42;2;40;.952;3600000;0
2753;93324;729;0;0;0;0;.00nan;0;0
2753;152624;740;55;23;3;20;.870;3548000;0
2754;6570;3789;57;39;6;33;.846;3600000;0
2754;186235;732;0;0;0;0;.00nan;0;0
2754;192386;732;87;38;2;36;.947;3600000;0
2754;-1;3789;0;0;0;0;.00nan;0;0
2755;176686;739;72;38;3;35;.921;3556000;0
2755;186234;739;0;0;0;0;.00nan;0;0
2755;46792;743;62;18;2;16;.889;3600000;0
2755;148956;743;0;0;0;0;.00nan;0;0
2756;186219;736;0;0;0;0;.00nan;0;0
2756;44526;736;77;47;4;43;.915;3600000;0
2756;85281;749;100;27;0;27;1.000;3600000;0
2756;86697;749;0;0;0;0;.00nan;0;0
2757;6868;764;31;25;5;20;.800;3548000;0
2757;174898;764;0;0;0;0;.00nan;0;0
2757;-1;733;0;0;0;0;.00nan;0;0
2757;85787;733;82;44;4;40;.909;3600000;0
2758;3756;748;79;44;4;40;.909;3600000;0
2758;-1;2168;0;0;0;0;.00nan;0;0
2758;-1;748;0;0;0;0;.00nan;0;0
2758;76405;2168;72;22;1;21;.955;3600000;0
2759;178098;738;70;20;1;19;.950;3600000;0
2759;175764;1880;0;0;0;0;.00nan;0;0
2759;185442;738;0;0;0;0;.00nan;0;0
2759;49900;1880;98;44;2;42;.955;3600000;0
2760;3508;745;100;34;0;34;1.000;3600000;0
2760;170543;747;72;30;2;28;.933;3556000;0
2760;180188;745;0;0;0;0;.00nan;0;0
2760;190589;747;0;0;0;0;.00nan;0;0
2761;185413;751;60;32;4;28;.875;3575000;0
2761;-1;751;0;0;0;0;.00nan;0;0
2761;43971;742;76;35;3;32;.914;3600000;0
2761;52204;742;0;0;0;0;.00nan;0;0
2762;3928;744;56;17;2;15;.882;3600000;0
2762;-1;733;0;0;0;0;.00nan;0;0
2762;64722;744;0;0;0;0;.00nan;0;0
2762;85787;733;73;42;4;38;.905;3551000;0
2763;83;737;90;35;1;34;.971;3600000;0
2763;176686;739;67;29;3;26;.897;3576000;0
2763;190570;737;0;0;0;0;.00nan;0;0
2763;186234;739;0;0;0;0;.00nan;0;0
2764;3756;748;94;39;3;36;.923;3652000;0
2764;170543;747;63;30;4;26;.867;3652000;0
2764;-1;748;0;0;0;0;.00nan;0;0
2764;190589;747;0;0;0;0;.00nan;0;0
2765;178098;738;0;0;0;0;.00nan;0;0
2765;-1;2168;0;0;0;0;.00nan;0;0
2765;185442;738;64;26;3;23;.885;3600000;0
2765;76405;2168;38;29;5;24;.828;3580000;0
2766;175764;1880;0;0;0;0;.00nan;0;0
2766;49900;1880;73;34;3;31;.912;3796000;0
2766;50065;729;0;0;0;0;.00nan;0;0
2766;93324;729;48;22;4;18;.818;3796000;0
2767;43971;742;98;47;1;46;.979;3559000;0
2767;46792;743;100;30;0;30;1.000;3600000;0
2767;52204;742;0;0;0;0;.00nan;0;0
2767;148956;743;0;0;0;0;.00nan;0;0
2768;3928;744;61;30;4;26;.867;3583000;0
2768;178114;752;0;0;0;0;.00nan;0;0
2768;33480;752;89;32;2;30;.938;3600000;0
2768;64722;744;0;0;0;0;.00nan;0;0
2769;6570;3789;92;34;1;33;.971;3900000;0
2769;-1;3789;0;0;0;0;.00nan;0;0
2769;56565;741;98;36;1;35;.972;3900000;0
2769;57695;741;0;0;0;0;.00nan;0;0
2770;83;737;97;48;2;46;.958;3600000;0
2770;190570;737;0;0;0;0;.00nan;0;0
2770;50065;729;73;19;1;18;.947;3600000;0
2770;93324;729;0;0;0;0;.00nan;0;0
2771;186235;732;0;0;0;0;.00nan;0;0
2771;192386;732;65;30;3;27;.900;3553000;0
2771;85281;749;73;30;2;28;.933;3600000;0
2771;86697;749;0;0;0;0;.00nan;0;0
2772;185363;740;0;0;0;0;.00nan;0;0
2772;186219;736;61;7;0;7;1.000;532000;0
2772;44526;736;50;41;6;35;.854;3068000;0
2772;152624;740;81;25;2;23;.920;3600000;0
2773;3508;745;62;18;2;16;.889;3900000;0
2773;6868;764;0;0;0;0;.00nan;0;0
2773;174898;764;100;54;2;52;.963;3900000;0
2773;180188;745;0;0;0;0;.00nan;0;0
2774;1957;734;0;0;0;0;.00nan;0;0
2774;6079;734;53;17;2;15;.882;3600000;0
2774;175764;1880;0;0;0;0;.00nan;0;0
2774;49900;1880;65;39;4;35;.897;3600000;0
2775;178098;738;90;28;1;27;.964;3600000;0
2775;176686;739;56;29;3;26;.897;3565000;0
2775;185442;738;0;0;0;0;.00nan;0;0
2775;186234;739;0;0;0;0;.00nan;0;0
2776;170543;747;73;48;5;43;.896;3600000;0
2776;190589;747;0;0;0;0;.00nan;0;0
2776;185413;751;0;0;0;0;.00nan;0;0
2776;-1;751;94;18;0;18;1.000;3600000;0
2777;3756;748;99;47;1;46;.979;3600000;0
2777;-1;748;0;0;0;0;.00nan;0;0
2777;85281;749;53;24;3;21;.875;3560000;0
2777;86697;749;0;0;0;0;.00nan;0;0
2778;3508;745;100;28;0;28;1.000;3600000;0
2778;3928;744;0;0;0;0;.00nan;0;0
2778;180188;745;0;0;0;0;.00nan;0;0
2778;64722;744;46;30;4;26;.867;3600000;0
2779;83;737;96;39;3;36;.923;3900000;0
2779;190570;737;0;0;0;0;.00nan;0;0
2779;192386;732;0;0;0;0;.00nan;0;0
2779;148788;732;71;28;3;25;.893;3900000;0
2780;178114;752;37;28;5;23;.821;3677000;0
2780;33480;752;0;0;0;0;.00nan;0;0
2780;56565;741;69;36;4;32;.889;3677000;0
2780;57695;741;0;0;0;0;.00nan;0;0
2781;6570;3789;63;29;3;26;.897;3600000;0
2781;6868;764;0;0;0;0;.00nan;0;0
2781;174898;764;48;27;4;23;.852;3556000;0
2781;-1;3789;0;0;0;0;.00nan;0;0
2782;-1;733;0;0;0;0;.00nan;0;0
2782;186219;736;0;0;0;0;.00nan;0;0
2782;44526;736;83;32;2;30;.938;3600000;0
2782;85787;733;98;55;3;52;.945;3583000;0
2783;43971;742;0;0;0;0;.00nan;0;0
2783;46792;743;65;29;3;26;.897;3600000;0
2783;52204;742;100;38;0;38;1.000;3600000;0
2783;148956;743;0;0;0;0;.00nan;0;0
2784;178098;738;0;0;0;0;.00nan;0;0
2784;185413;740;0;0;0;0;.00nan;0;0
2784;185442;738;89;36;2;34;.944;3900000;0
2784;152624;740;82;36;2;34;.944;3900000;0
2785;175764;1880;78;42;4;38;.905;3546000;0
2785;186235;751;0;0;0;0;.00nan;0;0
2785;-1;751;63;25;2;23;.920;3600000;0
2785;49900;1880;0;0;0;0;.00nan;0;0
2786;3756;748;87;37;2;35;.946;3600000;0
2786;-1;748;0;0;0;0;.00nan;0;0
2786;46792;743;60;43;5;38;.884;3600000;0
2786;148956;743;0;0;0;0;.00nan;0;0
2787;192386;732;62;9;0;9;1.000;1190000;0
2787;56565;741;100;53;3;50;.943;3600000;0
2787;57695;741;0;0;0;0;.00nan;0;0
2787;148788;732;11;18;6;12;.667;2410000;0
2788;-1;2168;0;0;0;0;.00nan;0;0
2788;76405;2168;65;35;4;31;.886;3736000;0
2788;85281;749;78;39;3;36;.923;3736000;0
2788;86697;749;0;0;0;0;.00nan;0;0
2789;176686;739;0;0;0;0;.00nan;0;0
2789;186219;736;0;0;0;0;.00nan;0;0
2789;186234;739;78;30;2;28;.933;3581000;0
2789;44526;736;95;32;1;31;.969;3600000;0
2790;83;737;69;21;1;20;.952;3547000;0
2790;190570;737;0;0;0;0;.00nan;0;0
2790;50065;729;100;39;0;39;1.000;3600000;0
2790;93324;729;0;0;0;0;.00nan;0;0
2791;3508;745;74;20;1;19;.950;3600000;0
2791;3928;744;50;32;6;26;.813;3600000;0
2791;180188;745;0;0;0;0;.00nan;0;0
2791;64722;744;0;0;0;0;.00nan;0;0
2792;6868;764;76;36;3;33;.917;3600000;0
2792;174898;764;0;0;0;0;.00nan;0;0
2792;43971;742;0;0;0;0;.00nan;0;0
2792;52204;742;85;32;2;30;.938;3600000;0
2793;1957;734;0;0;0;0;.00nan;0;0
2793;6079;734;58;22;3;19;.864;3600000;0
2793;-1;733;0;0;0;0;.00nan;0;0
2793;85787;733;100;38;0;38;1.000;3600000;0
2794;185413;740;0;0;0;0;.00nan;0;0
2794;186235;751;73;27;2;25;.926;3600000;0
2794;-1;751;0;0;0;0;.00nan;0;0
2794;152624;740;46;32;6;26;.813;3600000;0
2795;-1;733;0;0;0;0;.00nan;0;0
2795;56565;741;67;21;2;19;.905;3600000;0
2795;57695;741;0;0;0;0;.00nan;0;0
2795;85787;733;85;39;3;36;.923;3600000;0
2796;-1;2168;0;0;0;0;.00nan;0;0
2796;46792;743;83;27;1;26;.963;3600000;0
2796;76405;2168;75;29;2;27;.931;3584000;0
2796;148956;743;0;0;0;0;.00nan;0;0
2797;176686;739;64;34;3;31;.912;3600000;0
2797;186234;739;0;0;0;0;.00nan;0;0
2797;50065;729;76;27;2;25;.926;3600000;0
2797;93324;729;0;0;0;0;.00nan;0;0
2798;178098;738;92;32;1;31;.969;3600000;0
2798;185442;738;0;0;0;0;.00nan;0;0
2798;186219;736;0;0;0;0;.00nan;0;0
2798;44526;736;53;28;4;24;.857;3600000;0
2799;3928;744;100;25;0;25;1.000;3600000;0
2799;43971;742;69;37;4;33;.892;3600000;0
2799;52204;742;0;0;0;0;.00nan;0;0
2799;64722;744;0;0;0;0;.00nan;0;0
2800;178114;752;0;0;0;0;.00nan;0;0
2800;33480;752;86;12;0;12;1.000;3600000;0
2800;192386;732;0;0;0;0;.00nan;0;0
2800;148788;732;78;29;2;27;.931;3562000;0
2801;1957;734;0;0;0;0;.00nan;0;0
2801;6079;734;43;22;4;18;.818;3600000;0
2801;175764;1880;0;0;0;0;.00nan;0;0
2801;49900;1880;65;16;1;15;.938;3600000;0
2802;3508;745;65;24;2;22;.917;3600000;0
2802;6868;764;0;0;0;0;.00nan;0;0
2802;174898;764;50;36;5;31;.861;3600000;0
2802;180188;745;0;0;0;0;.00nan;0;0
2803;83;737;83;32;2;30;.938;3600000;0
2803;170543;747;0;0;0;0;.00nan;0;0
2803;190570;737;0;0;0;0;.00nan;0;0
2803;190589;747;48;23;3;20;.870;3561000;0
2804;6570;3789;0;0;0;0;.00nan;0;0
2804;-1;3789;74;24;2;22;.917;3600000;0
2804;50065;729;65;33;3;30;.909;3577000;0
2804;93324;729;0;0;0;0;.00nan;0;0
2805;3928;744;100;29;0;29;1.000;3600000;0
2805;43971;742;77;38;4;34;.895;3600000;0
2805;52204;742;0;0;0;0;.00nan;0;0
2805;64722;744;0;0;0;0;.00nan;0;0
2806;-1;733;0;0;0;0;.00nan;0;0
2806;192386;732;0;0;0;0;.00nan;0;0
2806;85787;733;99;38;1;37;.974;3600000;0
2806;148788;732;75;18;2;16;.889;3550000;0
2807;178114;752;0;0;0;0;.00nan;0;0
2807;33480;752;99;39;1;38;.974;3600000;0
2807;46792;743;82;37;2;35;.946;3572000;0
2807;148956;743;0;0;0;0;.00nan;0;0
2808;1957;734;0;0;0;0;.00nan;0;0
2808;6079;734;55;22;4;18;.818;3517000;0
2808;185413;740;0;0;0;0;.00nan;0;0
2808;152624;740;99;55;2;53;.964;3600000;0
2809;178098;738;0;0;0;0;.00nan;0;0
2809;170543;747;96;25;0;25;1.000;3600000;0
2809;190589;747;0;0;0;0;.00nan;0;0
2809;185442;738;58;37;4;33;.892;3600000;0
2810;3508;745;52;22;3;19;.864;3900000;0
2810;176686;739;76;30;3;27;.900;3900000;0
2810;180188;745;0;0;0;0;.00nan;0;0
2810;186234;739;0;0;0;0;.00nan;0;0
2811;3756;748;61;38;5;33;.868;3600000;0
2811;-1;748;0;0;0;0;.00nan;0;0
2811;186235;751;0;0;0;0;.00nan;0;0
2811;-1;751;86;32;2;30;.938;3600000;0
2812;6868;764;50;1;0;1;1.000;312000;0
2812;174898;764;44;38;6;32;.842;3288000;0
2812;175764;1880;0;0;0;0;.00nan;0;0
2812;49900;1880;78;35;2;33;.943;3600000;0
2813;-1;2168;0;0;0;0;.00nan;0;0
2813;186219;736;0;0;0;0;.00nan;0;0
2813;44526;736;53;31;4;27;.871;3600000;0
2813;76405;2168;86;26;1;25;.962;3600000;0
2814;83;737;79;37;4;33;.892;3600000;0
2814;190570;737;0;0;0;0;.00nan;0;0
2814;85281;749;50;17;3;14;.824;2683000;0
2814;86697;749;33;20;4;16;.800;917000;0
2815;6570;3789;100;27;0;27;1.000;3900000;0
2815;-1;733;0;0;0;0;.00nan;0;0
2815;-1;3789;0;0;0;0;.00nan;0;0
2815;85787;733;96;31;0;31;1.000;3900000;0
2816;178114;752;0;0;0;0;.00nan;0;0
2816;33480;752;61;30;3;27;.900;3600000;0
2816;43971;742;58;32;4;28;.875;3563000;0
2816;52204;742;0;0;0;0;.00nan;0;0
2817;1957;734;0;0;0;0;.00nan;0;0
2817;3928;744;89;36;2;34;.944;3597000;0
2817;6079;734;100;24;0;24;1.000;3600000;0
2817;64722;744;0;0;0;0;.00nan;0;0
2818;170543;747;100;28;0;28;1.000;3600000;0
2818;190589;747;0;0;0;0;.00nan;0;0
2818;185413;740;0;0;0;0;.00nan;0;0
2818;152624;740;86;28;1;27;.964;3560000;0
2819;83;737;82;38;3;35;.921;3900000;0
2819;3508;745;61;24;3;21;.875;3900000;0
2819;180188;745;0;0;0;0;.00nan;0;0
2819;190570;737;0;0;0;0;.00nan;0;0
2820;176686;739;0;0;0;0;.00nan;0;0
2820;186234;739;59;29;4;25;.862;3515000;0
2820;50065;729;83;37;2;35;.946;3600000;0
2820;93324;729;0;0;0;0;.00nan;0;0
2821;3756;748;81;34;2;32;.941;3600000;0
2821;-1;748;0;0;0;0;.00nan;0;0
2821;46792;743;0;0;0;0;.00nan;0;0
2821;148956;743;74;17;1;16;.941;3600000;0
2822;-1;2168;0;0;0;0;.00nan;0;0
2822;186235;751;0;0;0;0;.00nan;0;0
2822;-1;751;83;26;1;25;.962;3900000;0
2822;76405;2168;100;37;1;36;.973;3900000;0
2823;6868;764;54;29;4;25;.862;3564000;0
2823;174898;764;0;0;0;0;.00nan;0;0
2823;186219;736;0;0;0;0;.00nan;0;0
2823;44526;736;100;50;2;48;.960;3600000;0
2824;178098;738;93;50;3;47;.940;3600000;0
2824;185442;738;0;0;0;0;.00nan;0;0
2824;85281;749;72;25;2;23;.920;3600000;0
2824;86697;749;0;0;0;0;.00nan;0;0
2825;178114;752;0;0;0;0;.00nan;0;0
2825;33480;752;72;22;1;21;.955;3600000;0
2825;56565;741;71;42;5;37;.881;3600000;0
2825;57695;741;0;0;0;0;.00nan;0;0
2826;6570;3789;61;30;3;27;.900;3600000;0
2826;192386;732;0;0;0;0;.00nan;0;0
2826;-1;3789;0;0;0;0;.00nan;0;0
2826;148788;732;63;38;4;34;.895;3540000;0
2827;3508;745;70;23;3;20;.870;3600000;0
2827;6868;764;90;31;1;30;.968;3600000;0
2827;174898;764;0;0;0;0;.00nan;0;0
2827;180188;745;0;0;0;0;.00nan;0;0
2828;3928;744;86;38;3;35;.921;3585000;0
2828;50065;729;84;29;1;28;.966;3600000;0
2828;64722;744;0;0;0;0;.00nan;0;0
2828;93324;729;0;0;0;0;.00nan;0;0
2829;-1;2168;0;0;0;0;.00nan;0;0
2829;46792;743;75;38;4;34;.895;3900000;0
2829;76405;2168;46;22;4;18;.818;3900000;0
2829;148956;743;0;0;0;0;.00nan;0;0
2830;178098;738;56;22;3;19;.864;1794000;0
2830;185442;738;15;22;6;16;.727;1806000;0
2830;186235;751;74;23;2;21;.913;3600000;0
2830;-1;751;0;0;0;0;.00nan;0;0
2831;185413;740;0;0;0;0;.00nan;0;0
2831;85281;749;60;22;2;20;.909;3600000;0
2831;86697;749;0;0;0;0;.00nan;0;0
2831;152624;740;56;50;7;43;.860;3600000;0
2832;3756;748;57;19;2;17;.895;3555000;0
2832;-1;748;0;0;0;0;.00nan;0;0
2832;43971;742;85;25;1;24;.960;3600000;0
2832;52204;742;0;0;0;0;.00nan;0;0
2833;1957;734;0;0;0;0;.00nan;0;0
2833;6079;734;75;28;2;26;.929;3600000;0
2833;176686;739;73;40;4;36;.900;3529000;0
2833;186234;739;0;0;0;0;.00nan;0;0
2834;6570;3789;100;42;2;40;.952;3600000;0
2834;-1;3789;0;0;0;0;.00nan;0;0
2834;56565;741;44;30;5;25;.833;3600000;0
2834;57695;741;0;0;0;0;.00nan;0;0
2835;175764;1880;0;0;0;0;.00nan;0;0
2835;186219;736;0;0;0;0;.00nan;0;0
2835;44526;736;69;33;3;30;.909;3600000;0
2835;49900;1880;100;45;2;43;.956;3600000;0
2836;-1;733;0;0;0;0;.00nan;0;0
2836;192386;732;0;0;0;0;.00nan;0;0
2836;85787;733;61;33;4;29;.879;3598000;0
2836;148788;732;70;31;3;28;.903;3600000;0
2837;83;737;74;28;2;26;.929;3600000;0
2837;3928;744;66;36;4;32;.889;3600000;0
2837;190570;737;0;0;0;0;.00nan;0;0
2837;64722;744;0;0;0;0;.00nan;0;0
2838;43971;742;72;39;3;36;.923;3585000;0
2838;50065;729;78;23;1;22;.957;3600000;0
2838;52204;742;0;0;0;0;.00nan;0;0
2838;93324;729;0;0;0;0;.00nan;0;0
2839;170543;747;79;41;3;38;.927;3900000;0
2839;190589;747;0;0;0;0;.00nan;0;0
2839;46792;743;92;42;3;39;.929;3900000;0
2839;148956;743;0;0;0;0;.00nan;0;0
2840;185413;740;0;0;0;0;.00nan;0;0
2840;186235;751;0;0;0;0;.00nan;0;0
2840;-1;751;85;32;1;31;.969;3600000;0
2840;152624;740;72;23;2;21;.913;3570000;0
2841;6868;764;98;43;3;40;.930;3900000;0
2841;178114;752;0;0;0;0;.00nan;0;0
2841;174898;764;0;0;0;0;.00nan;0;0
2841;33480;752;54;21;3;18;.857;3900000;0
2842;-1;2168;58;40;5;35;.875;3600000;0
2842;76405;2168;0;0;0;0;.00nan;0;0
2842;85281;749;37;23;4;19;.826;2220000;0
2842;86697;749;48;7;2;5;.714;1380000;0
2843;1957;734;80;25;1;24;.960;3900000;0
2843;6079;734;0;0;0;0;.00nan;0;0
2843;186219;736;0;0;0;0;.00nan;0;0
2843;44526;736;88;37;1;36;.973;3900000;0
2844;175764;1880;0;0;0;0;.00nan;0;0
2844;176686;739;0;0;0;0;.00nan;0;0
2844;186234;739;56;19;3;16;.842;3600000;0
2844;49900;1880;22;43;8;35;.814;3600000;0
2845;192386;732;0;0;0;0;.00nan;0;0
2845;56565;741;64;43;5;38;.884;3600000;0
2845;57695;741;0;0;0;0;.00nan;0;0
2845;148788;732;75;27;2;25;.926;3600000;0
2846;3508;745;75;27;2;25;.926;3715000;0
2846;180188;745;0;0;0;0;.00nan;0;0
2846;-1;733;0;0;0;0;.00nan;0;0
2846;85787;733;69;32;3;29;.906;3715000;0
2847;3756;748;47;23;3;20;.870;3520000;0
2847;178098;738;90;30;1;29;.967;3600000;0
2847;-1;748;0;0;0;0;.00nan;0;0
2847;185442;738;0;0;0;0;.00nan;0;0
2848;83;737;97;36;1;35;.972;3600000;0
2848;14335;747;79;34;2;32;.941;3600000;0
2848;190570;737;0;0;0;0;.00nan;0;0
2848;190589;747;0;0;0;0;.00nan;0;0
2849;3928;744;44;38;6;32;.842;3600000;0
2849;178114;752;0;0;0;0;.00nan;0;0
2849;33480;752;74;20;1;19;.950;3600000;0
2849;64722;744;0;0;0;0;.00nan;0;0
2850;186235;751;0;0;0;0;.00nan;0;0
2850;-1;751;51;29;4;25;.862;3600000;0
2850;76405;2168;95;23;1;22;.957;3600000;0
2850;85670;2168;0;0;0;0;.00nan;0;0
2851;1957;734;0;0;0;0;.00nan;0;0
2851;6079;734;89;42;3;39;.929;3600000;0
2851;50065;729;71;37;4;33;.892;3547000;0
2851;93324;729;0;0;0;0;.00nan;0;0
2852;3508;745;79;28;1;27;.964;3600000;0
2852;6570;3789;64;29;2;27;.931;3545000;0
2852;180188;745;0;0;0;0;.00nan;0;0
2852;-1;3789;0;0;0;0;.00nan;0;0
2853;175764;1880;0;0;0;0;.00nan;0;0
2853;192386;732;0;0;0;0;.00nan;0;0
2853;49900;1880;92;43;2;41;.953;3585000;0
2853;148788;732;90;25;1;24;.960;3600000;0
2854;6868;764;0;0;0;0;.00nan;0;0
2854;174898;764;75;13;0;13;1.000;3600000;0
2854;46792;743;97;41;1;40;.976;3587000;0
2854;148956;743;0;0;0;0;.00nan;0;0
2855;43971;742;66;44;4;40;.909;3588000;0
2855;52204;742;0;0;0;0;.00nan;0;0
2855;85281;749;57;24;3;21;.875;3600000;0
2855;86697;749;0;0;0;0;.00nan;0;0
2856;14335;747;55;23;2;21;.913;3600000;0
2856;190589;747;0;0;0;0;.00nan;0;0
2856;56565;741;0;0;0;0;.00nan;0;0
2856;57695;741;97;35;1;34;.971;3600000;0
2857;83;737;92;29;1;28;.966;3600000;0
2857;3756;748;56;25;3;22;.880;3588000;0
2857;-1;748;0;0;0;0;.00nan;0;0
2857;190570;737;0;0;0;0;.00nan;0;0
2858;2643;739;96;23;0;23;1.000;3600000;0
2858;-1;733;0;0;0;0;.00nan;0;0
2858;186234;739;0;0;0;0;.00nan;0;0
2858;85787;733;60;40;5;35;.875;3600000;0
2859;6570;3789;84;31;3;28;.903;3600000;0
2859;-1;3789;0;0;0;0;.00nan;0;0
2859;76405;2168;85;37;2;35;.946;3600000;0
2859;85670;2168;0;0;0;0;.00nan;0;0
2860;83;737;0;0;0;0;.00nan;0;0
2860;178098;738;66;33;3;30;.909;3574000;0
2860;190570;737;81;38;2;36;.947;3600000;0
2860;185442;738;0;0;0;0;.00nan;0;0
2861;3508;745;92;44;3;41;.932;3809000;0
2861;178114;752;0;0;0;0;.00nan;0;0
2861;33480;752;62;21;2;19;.905;3809000;0
2861;180188;745;0;0;0;0;.00nan;0;0
2862;3928;744;100;24;0;24;1.000;3600000;0
2862;46792;743;42;31;5;26;.839;3600000;0
2862;64722;744;0;0;0;0;.00nan;0;0
2862;148956;743;0;0;0;0;.00nan;0;0
2863;175764;1880;30;30;6;24;.800;3524000;0
2863;185413;740;0;0;0;0;.00nan;0;0
2863;49900;1880;0;0;0;0;.00nan;0;0
2863;57107;740;84;52;4;48;.923;3600000;0
2864;186219;736;0;0;0;0;.00nan;0;0
2864;44526;736;100;32;0;32;1.000;3600000;0
2864;50065;729;91;32;2;30;.938;3547000;0
2864;93324;729;0;0;0;0;.00nan;0;0
2865;6868;764;0;0;0;0;.00nan;0;0
2865;174898;764;50;25;4;21;.840;3659000;0
2865;186235;751;73;35;3;32;.914;3659000;0
2865;-1;751;0;0;0;0;.00nan;0;0
2866;1957;734;0;0;0;0;.00nan;0;0
2866;6079;734;67;30;3;27;.900;3593000;0
2866;56565;741;78;28;2;26;.929;3600000;0
2866;57695;741;0;0;0;0;.00nan;0;0
2867;3756;748;15;28;7;21;.750;2569000;0
2867;-1;748;64;7;0;7;1.000;1031000;0
2867;192386;732;0;0;0;0;.00nan;0;0
2867;148788;732;89;36;2;34;.944;3600000;0
2868;14335;747;88;31;2;29;.935;3900000;0
2868;190589;747;0;0;0;0;.00nan;0;0
2868;43971;742;84;37;2;35;.946;3900000;0
2868;52204;742;0;0;0;0;.00nan;0;0
2869;2643;739;67;40;5;35;.875;3587000;0
2869;186234;739;0;0;0;0;.00nan;0;0
2869;76405;2168;59;31;4;27;.871;3600000;0
2869;85670;2168;0;0;0;0;.00nan;0;0
2870;6570;3789;0;0;0;0;.00nan;0;0
2870;185413;740;0;0;0;0;.00nan;0;0
2870;-1;3789;67;25;2;23;.920;3565000;0
2870;57107;740;87;27;1;26;.963;3600000;0
2871;178098;738;100;36;0;36;1.000;3600000;0
2871;185442;738;0;0;0;0;.00nan;0;0
2871;50065;729;80;36;2;34;.944;3547000;0
2871;93324;729;0;0;0;0;.00nan;0;0
2872;3928;744;76;34;2;32;.941;3600000;0
2872;46792;743;65;30;3;27;.900;3543000;0
2872;64722;744;0;0;0;0;.00nan;0;0
2872;148956;743;0;0;0;0;.00nan;0;0
2873;186219;736;0;0;0;0;.00nan;0;0
2873;186235;751;0;0;0;0;.00nan;0;0
2873;-1;751;60;23;2;21;.913;3600000;0
2873;44526;736;62;35;3;32;.914;3548000;0
2874;6868;764;79;35;2;33;.943;3600000;0
2874;178114;752;0;0;0;0;.00nan;0;0
2874;174898;764;0;0;0;0;.00nan;0;0
2874;33480;752;84;28;1;27;.964;3600000;0
2875;83;737;70;28;2;26;.929;3585000;0
2875;190570;737;0;0;0;0;.00nan;0;0
2875;-1;733;0;0;0;0;.00nan;0;0
2875;85787;733;95;25;0;25;1.000;3600000;0
2876;3756;748;100;37;1;36;.973;3900000;0
2876;-1;748;0;0;0;0;.00nan;0;0
2876;56565;741;81;29;1;28;.966;3900000;0
2876;57695;741;0;0;0;0;.00nan;0;0
2877;83;737;97;44;2;42;.955;3900000;0
2877;190570;737;0;0;0;0;.00nan;0;0
2877;192386;732;0;0;0;0;.00nan;0;0
2877;148788;732;79;22;2;20;.909;3900000;0
2878;1957;734;0;0;0;0;.00nan;0;0
2878;6079;734;66;32;3;29;.906;3600000;0
2878;175764;1880;0;0;0;0;.00nan;0;0
2878;49900;1880;56;34;4;30;.882;3579000;0
2879;3508;745;52;33;5;28;.848;3600000;0
2879;180188;745;0;0;0;0;.00nan;0;0
2879;85281;749;0;0;0;0;.00nan;0;0
2879;86697;749;96;30;1;29;.967;3600000;0
2880;2643;739;80;41;4;37;.902;3576000;0
2880;185413;740;0;0;0;0;.00nan;0;0
2880;186234;739;0;0;0;0;.00nan;0;0
2880;57107;740;83;29;2;27;.931;3600000;0
2881;6570;3789;72;32;3;29;.906;3874000;0
2881;-1;3789;0;0;0;0;.00nan;0;0
2881;50065;729;72;39;4;35;.897;3874000;0
2881;93324;729;0;0;0;0;.00nan;0;0
2882;3928;744;85;35;2;33;.943;3600000;0
2882;178114;752;0;0;0;0;.00nan;0;0
2882;33480;752;41;35;6;29;.829;3600000;0
2882;64722;744;0;0;0;0;.00nan;0;0
2883;186235;751;55;20;2;18;.900;3600000;0
2883;-1;751;0;0;0;0;.00nan;0;0
2883;43971;742;95;54;5;49;.907;3600000;0
2883;52204;742;0;0;0;0;.00nan;0;0
2884;-1;733;0;0;0;0;.00nan;0;0
2884;76405;2168;0;0;0;0;.00nan;0;0
2884;85670;2168;78;29;2;27;.931;3600000;0
2884;85787;733;82;49;4;45;.918;3600000;0
2885;3508;745;73;41;4;37;.902;3600000;0
2885;180188;745;0;0;0;0;.00nan;0;0
2885;85281;749;24;23;6;17;.739;3572000;0
2885;86697;749;0;0;0;0;.00nan;0;0
2886;3756;748;100;32;0;32;1.000;3600000;0
2886;6868;764;58;25;3;22;.880;3600000;0
2886;174898;764;0;0;0;0;.00nan;0;0
2886;-1;748;0;0;0;0;.00nan;0;0
2887;178098;738;77;33;1;32;.970;3900000;0
2887;185442;738;0;0;0;0;.00nan;0;0
2887;192386;732;0;0;0;0;.00nan;0;0
2887;148788;732;90;31;1;30;.968;3900000;0
2888;83;737;59;27;3;24;.889;3524000;0
2888;190570;737;0;0;0;0;.00nan;0;0
2888;186219;736;0;0;0;0;.00nan;0;0
2888;44526;736;99;45;1;44;.978;3600000;0
2889;1957;734;0;0;0;0;.00nan;0;0
2889;6079;734;89;32;1;31;.969;3600000;0
2889;175764;1880;0;0;0;0;.00nan;0;0
2889;49900;1880;62;30;3;27;.900;3533000;0
2890;3508;745;69;21;2;19;.905;3645000;0
2890;14335;747;80;40;3;37;.925;3645000;0
2890;180188;745;0;0;0;0;.00nan;0;0
2890;190589;747;0;0;0;0;.00nan;0;0
2891;3928;744;81;33;3;30;.909;3558000;0
2891;178114;752;0;0;0;0;.00nan;0;0
2891;33480;752;87;29;1;28;.966;3600000;0
2891;64722;744;0;0;0;0;.00nan;0;0
2892;43971;742;59;22;2;20;.909;3600000;0
2892;46792;743;0;0;0;0;.00nan;0;0
2892;52204;742;0;0;0;0;.00nan;0;0
2892;148956;743;86;30;1;29;.967;3600000;0
2893;56565;741;66;29;3;26;.897;3575000;0
2893;57695;741;0;0;0;0;.00nan;0;0
2893;85281;749;69;32;2;30;.938;3600000;0
2893;86697;749;0;0;0;0;.00nan;0;0
2894;6868;764;0;0;0;0;.00nan;0;0
2894;174898;764;78;33;2;31;.939;3600000;0
2894;76405;2168;0;0;0;0;.00nan;0;0
2894;85670;2168;78;36;3;33;.917;3543000;0
2895;1957;734;0;0;0;0;.00nan;0;0
2895;6079;734;98;39;2;37;.949;3550000;0
2895;178098;738;76;25;1;24;.960;3600000;0
2895;185442;738;0;0;0;0;.00nan;0;0
2896;192386;732;0;0;0;0;.00nan;0;0
2896;50065;729;58;36;5;31;.861;3600000;0
2896;93324;729;0;0;0;0;.00nan;0;0
2896;148788;732;75;30;2;28;.933;3600000;0
2897;83;737;79;32;2;30;.938;3900000;0
2897;190570;737;0;0;0;0;.00nan;0;0
2897;185413;740;0;0;0;0;.00nan;0;0
2897;57107;740;100;43;2;41;.953;3900000;0
2898;2643;739;60;17;2;15;.882;3600000;0
2898;175764;1880;45;5;1;4;.800;666000;0
2898;186234;739;0;0;0;0;.00nan;0;0
2898;49900;1880;26;28;7;21;.750;2934000;0
2899;-1;733;0;0;0;0;.00nan;0;0
2899;186219;736;0;0;0;0;.00nan;0;0
2899;44526;736;63;29;3;26;.897;3568000;0
2899;85787;733;76;25;1;24;.960;3600000;0
2900;3508;745;83;32;2;30;.938;3600000;0
2900;14335;747;47;32;5;27;.844;1790000;0
2900;180188;745;0;0;0;0;.00nan;0;0
2900;190589;747;71;11;0;11;1.000;1810000;0
2901;178114;752;49;30;4;26;.867;3600000;0
2901;33480;752;0;0;0;0;.00nan;0;0
2901;43971;742;53;44;6;38;.864;3019000;0
2901;52204;742;53;3;0;3;1.000;502000;0
2902;56565;741;90;40;2;38;.950;3600000;0
2902;57695;741;0;0;0;0;.00nan;0;0
2902;85281;749;59;21;3;18;.857;3562000;0
2902;86697;749;0;0;0;0;.00nan;0;0
2903;3756;748;58;30;3;27;.900;3600000;0
2903;3928;744;100;28;0;28;1.000;3600000;0
2903;-1;748;0;0;0;0;.00nan;0;0
2903;64722;744;0;0;0;0;.00nan;0;0
2904;178098;738;63;31;3;28;.903;3600000;0
2904;185442;738;0;0;0;0;.00nan;0;0
2904;76405;2168;62;36;4;32;.889;3578000;0
2904;85670;2168;0;0;0;0;.00nan;0;0
2905;1957;734;73;30;2;28;.933;3552000;0
2905;6079;734;0;0;0;0;.00nan;0;0
2905;192386;732;0;0;0;0;.00nan;0;0
2905;148788;732;100;34;1;33;.971;3600000;0
2906;83;737;70;31;3;28;.903;3743000;0
2906;6570;3789;59;31;4;27;.871;3743000;0
2906;190570;737;0;0;0;0;.00nan;0;0
2906;-1;3789;0;0;0;0;.00nan;0;0
2907;-1;733;0;0;0;0;.00nan;0;0
2907;46792;743;90;37;2;35;.946;3900000;0
2907;85787;733;74;29;2;27;.931;3900000;0
2907;148956;743;0;0;0;0;.00nan;0;0
2908;6868;764;65;25;3;22;.880;2676000;0
2908;174898;764;22;14;5;9;.643;924000;0
2908;186235;751;100;26;0;26;1.000;3600000;0
2908;-1;751;0;0;0;0;.00nan;0;0
2909;185413;740;0;0;0;0;.00nan;0;0
2909;50065;729;73;31;2;29;.935;3600000;0
2909;57107;740;59;34;4;30;.882;3600000;0
2909;93324;729;0;0;0;0;.00nan;0;0
2910;2643;739;73;20;1;19;.950;3600000;0
2910;186219;736;0;0;0;0;.00nan;0;0
2910;186234;739;0;0;0;0;.00nan;0;0
2910;44526;736;98;52;2;50;.962;3575000;0
2911;14335;747;61;37;5;32;.865;3626000;0
2911;190589;747;0;0;0;0;.00nan;0;0
2911;56565;741;60;31;4;27;.871;3626000;0
2911;57695;741;0;0;0;0;.00nan;0;0
2912;175764;1880;0;0;0;0;.00nan;0;0
2912;46792;743;94;33;1;32;.970;3550000;0
2912;49900;1880;100;30;0;30;1.000;3600000;0
2912;148956;743;0;0;0;0;.00nan;0;0
2913;3756;748;52;16;2;14;.875;3600000;0
2913;178098;738;81;28;1;27;.964;3600000;0
2913;-1;748;0;0;0;0;.00nan;0;0
2913;185442;738;0;0;0;0;.00nan;0;0
2914;50065;729;99;49;1;48;.980;3600000;0
2914;76405;2168;30;23;5;18;.783;3600000;0
2914;85670;2168;0;0;0;0;.00nan;0;0
2914;93324;729;0;0;0;0;.00nan;0;0
2915;3928;744;87;23;0;23;1.000;3900000;0
2915;186235;751;100;32;0;32;1.000;3900000;0
2915;-1;751;0;0;0;0;.00nan;0;0
2915;64722;744;0;0;0;0;.00nan;0;0
2916;178114;752;0;0;0;0;.00nan;0;0
2916;33480;752;62;31;3;28;.903;3550000;0
2916;-1;733;0;0;0;0;.00nan;0;0
2916;85787;733;73;33;2;31;.939;3600000;0
2917;6570;3789;100;32;0;32;1.000;3600000;0
2917;185413;740;84;34;1;33;.971;3598000;0
2917;-1;3789;0;0;0;0;.00nan;0;0
2917;57107;740;0;0;0;0;.00nan;0;0
2918;6868;764;0;0;0;0;.00nan;0;0
2918;174898;764;65;37;5;32;.865;3600000;0
2918;43971;742;0;0;0;0;.00nan;0;0
2918;52204;742;90;33;1;32;.970;3600000;0
2919;2643;739;77;24;2;22;.917;3600000;0
2919;175764;1880;0;0;0;0;.00nan;0;0
2919;186234;739;0;0;0;0;.00nan;0;0
2919;49900;1880;69;30;3;27;.900;3588000;0
2920;14335;747;99;42;2;40;.952;3600000;0
2920;190589;747;0;0;0;0;.00nan;0;0
2920;56565;741;67;29;3;26;.897;3600000;0
2920;57695;741;0;0;0;0;.00nan;0;0
2921;83;737;54;15;2;13;.867;3600000;0
2921;190570;737;0;0;0;0;.00nan;0;0
2921;46792;743;33;25;5;20;.800;2170000;0
2921;148956;743;82;15;0;15;1.000;1430000;0
2922;3508;745;70;32;4;28;.875;3600000;0
2922;180188;745;0;0;0;0;.00nan;0;0
2922;85281;749;0;0;0;0;.00nan;0;0
2922;86697;749;100;28;0;28;1.000;3600000;0
2923;186219;736;0;0;0;0;.00nan;0;0
2923;44526;736;100;31;0;31;1.000;3600000;0
2923;192386;732;55;17;2;15;.882;3516000;0
2923;148788;732;0;0;0;0;.00nan;0;0
2924;3756;748;29;21;5;16;.762;2124000;0
2924;-1;748;62;17;1;16;.941;1476000;0
2924;50065;729;88;36;2;34;.944;3600000;0
2924;93324;729;0;0;0;0;.00nan;0;0
2925;3928;744;100;33;0;33;1.000;3600000;0
2925;64722;744;0;0;0;0;.00nan;0;0
2925;76405;2168;67;27;2;25;.926;3553000;0
2925;85670;2168;0;0;0;0;.00nan;0;0
2926;6570;3789;80;27;3;24;.889;3900000;0
2926;178114;752;0;0;0;0;.00nan;0;0
2926;33480;752;98;56;3;53;.946;3900000;0
2926;-1;3789;0;0;0;0;.00nan;0;0
2927;-1;733;0;0;0;0;.00nan;0;0
2927;43971;742;79;22;1;21;.955;3600000;0
2927;52204;742;0;0;0;0;.00nan;0;0
2927;85787;733;69;29;2;27;.931;3544000;0
2928;83;737;95;46;4;42;.913;3900000;0
2928;2643;739;62;34;4;30;.882;3900000;0
2928;190570;737;0;0;0;0;.00nan;0;0
2928;186234;739;0;0;0;0;.00nan;0;0
2929;178098;738;0;0;0;0;.00nan;0;0
2929;185442;738;68;34;3;31;.912;3559000;0
2929;186235;751;69;24;2;22;.917;3600000;0
2929;-1;751;0;0;0;0;.00nan;0;0
2930;3508;745;0;0;0;0;.00nan;0;0
2930;180188;745;80;26;2;24;.923;3900000;0
2930;46792;743;75;32;2;30;.938;3900000;0
2930;148956;743;0;0;0;0;.00nan;0;0
2931;1957;734;0;0;0;0;.00nan;0;0
2931;6079;734;58;31;4;27;.871;3900000;0
2931;192386;732;0;0;0;0;.00nan;0;0
2931;148788;732;84;45;4;41;.911;3900000;0
2932;185413;740;0;0;0;0;.00nan;0;0
2932;57107;740;83;47;4;43;.915;3600000;0
2932;85281;749;0;0;0;0;.00nan;0;0
2932;86697;749;76;20;1;19;.950;3600000;0
2933;175764;1880;0;0;0;0;.00nan;0;0
2933;186219;736;0;0;0;0;.00nan;0;0
2933;44526;736;61;35;4;31;.886;3570000;0
2933;49900;1880;70;26;2;24;.923;3600000;0
2934;6868;764;0;0;0;0;.00nan;0;0
2934;14335;747;66;32;3;29;.906;3525000;0
2934;174898;764;100;48;1;47;.979;3600000;0
2934;190589;747;0;0;0;0;.00nan;0;0
2935;3928;744;95;37;2;35;.946;3900000;0
2935;43971;742;83;34;2;32;.941;3900000;0
2935;52204;742;0;0;0;0;.00nan;0;0
2935;64722;744;0;0;0;0;.00nan;0;0
2936;6079;734;0;0;0;0;.00nan;0;0
2936;178098;738;83;39;2;37;.949;3900000;0
2936;185442;738;0;0;0;0;.00nan;0;0
2936;44526;734;76;23;2;21;.913;3856000;0
2937;3508;745;53;28;4;24;.857;3600000;0
2937;180188;745;0;0;0;0;.00nan;0;0
2937;76405;2168;63;35;5;30;.857;3574000;0
2937;85670;2168;0;0;0;0;.00nan;0;0
2938;186235;751;0;0;0;0;.00nan;0;0
2938;-1;751;59;36;4;32;.889;3900000;0
2938;192386;732;0;0;0;0;.00nan;0;0
2938;148788;732;61;31;4;27;.871;3900000;0
2939;46792;743;75;58;6;52;.897;3600000;0
2939;85281;749;0;0;0;0;.00nan;0;0
2939;86697;749;64;26;3;23;.885;3600000;0
2939;148956;743;0;0;0;0;.00nan;0;0
2940;1957;736;85;55;4;51;.927;3600000;0
2940;175764;1880;0;0;0;0;.00nan;0;0
2940;186219;736;0;0;0;0;.00nan;0;0
2940;49900;1880;85;29;1;28;.966;3600000;0
2941;3756;748;56;21;3;18;.857;3900000;0
2941;-1;748;0;0;0;0;.00nan;0;0
2941;-1;733;57;33;3;30;.909;3900000;0
2941;85787;733;0;0;0;0;.00nan;0;0
2942;2643;739;50;30;5;25;.833;3679000;0
2942;186234;739;0;0;0;0;.00nan;0;0
2942;50065;729;79;39;4;35;.897;3679000;0
2942;93324;729;0;0;0;0;.00nan;0;0
2943;83;737;94;22;0;22;1.000;3600000;0
2943;6570;3789;90;28;1;27;.964;3546000;0
2943;190570;737;0;0;0;0;.00nan;0;0
2943;-1;3789;0;0;0;0;.00nan;0;0
2944;3928;744;78;26;1;25;.962;3600000;0
2944;6868;764;0;0;0;0;.00nan;0;0
2944;174898;764;61;22;2;20;.909;3600000;0
2944;64722;744;0;0;0;0;.00nan;0;0
2945;14335;747;68;23;2;21;.913;3600000;0
2945;190589;747;0;0;0;0;.00nan;0;0
2945;43971;742;66;36;4;32;.889;3600000;0
2945;52204;742;0;0;0;0;.00nan;0;0
2946;186235;751;84;37;3;34;.919;3600000;0
2946;-1;751;0;0;0;0;.00nan;0;0
2946;56565;741;100;34;0;34;1.000;3600000;0
2946;57695;741;0;0;0;0;.00nan;0;0
2947;6079;734;0;0;0;0;.00nan;0;0
2947;178114;752;0;0;0;0;.00nan;0;0
2947;33480;752;46;28;4;24;.857;3600000;0
2947;44526;734;100;27;0;27;1.000;3600000;0
2948;3508;745;62;24;2;22;.917;3600000;0
2948;3756;748;50;24;4;20;.833;3544000;0
2948;-1;748;0;0;0;0;.00nan;0;0
2948;180188;745;0;0;0;0;.00nan;0;0
2949;175764;1880;0;0;0;0;.00nan;0;0
2949;49900;1880;100;37;0;37;1.000;3600000;0
2949;76405;2168;63;32;3;29;.906;3600000;0
2949;85670;2168;0;0;0;0;.00nan;0;0
2950;14335;747;29;29;6;23;.793;3600000;0
2950;190589;747;0;0;0;0;.00nan;0;0
2950;192386;732;0;0;0;0;.00nan;0;0
2950;148788;732;81;30;2;28;.933;3600000;0
2951;185413;740;0;0;0;0;.00nan;0;0
2951;46792;743;52;32;5;27;.844;3600000;0
2951;57107;740;90;33;2;31;.939;3600000;0
2951;148956;743;0;0;0;0;.00nan;0;0
2952;-1;733;0;0;0;0;.00nan;0;0
2952;50065;729;86;27;2;25;.926;3600000;0
2952;85787;733;74;35;3;32;.914;3552000;0
2952;93324;729;0;0;0;0;.00nan;0;0
2953;2643;739;63;29;4;25;.862;3600000;0
2953;186234;739;0;0;0;0;.00nan;0;0
2953;56565;741;46;30;5;25;.833;3600000;0
2953;57695;741;0;0;0;0;.00nan;0;0
2954;6570;3789;46;25;4;21;.840;3531000;0
2954;178114;752;0;0;0;0;.00nan;0;0
2954;33480;752;70;23;2;21;.913;3600000;0
2954;-1;3789;0;0;0;0;.00nan;0;0
2955;3508;745;63;30;4;26;.867;3600000;0
2955;178098;738;83;30;1;29;.967;3600000;0
2955;180188;745;0;0;0;0;.00nan;0;0
2955;185442;738;0;0;0;0;.00nan;0;0
2956;83;737;83;25;1;24;.960;3600000;0
2956;190570;737;0;0;0;0;.00nan;0;0
2956;76405;2168;81;37;3;34;.919;3573000;0
2956;85670;2168;0;0;0;0;.00nan;0;0
2957;3756;748;83;41;3;38;.927;3600000;0
2957;3928;744;0;0;0;0;.00nan;0;0
2957;-1;748;0;0;0;0;.00nan;0;0
2957;64722;744;33;25;5;20;.800;3570000;0
2958;1957;736;74;43;4;39;.907;3532000;0
2958;186219;736;0;0;0;0;.00nan;0;0
2958;85281;749;0;0;0;0;.00nan;0;0
2958;86697;749;89;39;2;37;.949;3600000;0
2959;186235;751;0;0;0;0;.00nan;0;0
2959;-1;751;64;30;3;27;.900;3600000;0
2959;43971;742;51;32;4;28;.875;3555000;0
2959;52204;742;0;0;0;0;.00nan;0;0
2960;185413;740;0;0;0;0;.00nan;0;0
2960;50065;729;66;33;4;29;.879;3600000;0
2960;57107;740;91;36;2;34;.944;3600000;0
2960;93324;729;0;0;0;0;.00nan;0;0
2961;6868;764;0;0;0;0;.00nan;0;0
2961;174898;764;82;27;1;26;.963;3900000;0
2961;46792;743;91;34;1;33;.971;3900000;0
2961;148956;743;0;0;0;0;.00nan;0;0
2962;3756;748;60;30;4;26;.867;3900000;0
2962;-1;748;0;0;0;0;.00nan;0;0
2962;56565;741;58;34;4;30;.882;3900000;0
2962;57695;741;0;0;0;0;.00nan;0;0
2963;3508;745;76;21;1;20;.952;3600000;0
2963;6079;734;0;0;0;0;.00nan;0;0
2963;180188;745;0;0;0;0;.00nan;0;0
2963;44526;734;69;31;3;28;.903;3577000;0
2964;1957;736;31;14;4;10;.714;747000;0
2964;14335;747;82;24;2;22;.917;3600000;0
2964;190589;747;0;0;0;0;.00nan;0;0
2964;186219;736;66;36;3;33;.917;2853000;0
2965;178114;752;0;0;0;0;.00nan;0;0
2965;33480;752;24;27;6;21;.778;3568000;0
2965;192386;732;0;0;0;0;.00nan;0;0
2965;148788;732;69;42;4;38;.905;3600000;0
2966;178098;738;55;34;4;30;.882;3719000;0
2966;185442;738;0;0;0;0;.00nan;0;0
2966;-1;733;0;0;0;0;.00nan;0;0
2966;85787;733;76;31;3;28;.903;3719000;0
2967;2643;739;18;29;7;22;.759;3600000;0
2967;186234;739;0;0;0;0;.00nan;0;0
2967;85281;749;0;0;0;0;.00nan;0;0
2967;86697;749;50;23;3;20;.870;3600000;0
2968;43971;742;59;31;4;27;.871;3600000;0
2968;52204;742;0;0;0;0;.00nan;0;0
2968;76405;2168;84;29;1;28;.966;3600000;0
2968;85670;2168;0;0;0;0;.00nan;0;0
2969;83;737;95;44;3;41;.932;3900000;0
2969;190570;737;0;0;0;0;.00nan;0;0
2969;185413;740;0;0;0;0;.00nan;0;0
2969;57107;740;63;31;3;28;.903;3900000;0
2970;3928;744;48;19;2;17;.895;3594000;0
2970;6868;764;0;0;0;0;.00nan;0;0
2970;174898;764;74;20;1;19;.950;3600000;0
2970;64722;744;0;0;0;0;.00nan;0;0
2971;3756;748;98;40;2;38;.950;3900000;0
2971;178114;752;0;0;0;0;.00nan;0;0
2971;-1;748;0;0;0;0;.00nan;0;0
2971;33480;752;89;37;2;35;.946;3900000;0
2972;2643;739;71;33;4;29;.879;3590000;0
2972;14335;747;89;35;3;32;.914;3600000;0
2972;190589;747;0;0;0;0;.00nan;0;0
2972;186234;739;0;0;0;0;.00nan;0;0
2973;1957;736;21;48;9;39;.813;3600000;0
2973;186219;736;0;0;0;0;.00nan;0;0
2973;186235;751;55;18;2;16;.889;3600000;0
2973;-1;751;0;0;0;0;.00nan;0;0
2974;-1;733;0;0;0;0;.00nan;0;0
2974;85281;749;0;0;0;0;.00nan;0;0
2974;85787;733;90;41;2;39;.951;3600000;0
2974;86697;749;62;32;4;28;.875;3550000;0
2975;6570;3789;39;25;5;20;.800;3600000;0
2975;-1;3789;0;0;0;0;.00nan;0;0
2975;76405;2168;66;23;2;21;.913;3600000;0
2975;85670;2168;0;0;0;0;.00nan;0;0
2976;3508;745;50;29;4;25;.862;3600000;0
2976;180188;745;0;0;0;0;.00nan;0;0
2976;56565;741;94;33;1;32;.970;3600000;0
2976;57695;741;0;0;0;0;.00nan;0;0
2977;6079;734;0;0;0;0;.00nan;0;0
2977;44526;734;65;31;3;28;.903;3557000;0
2977;50065;729;83;32;2;30;.938;3600000;0
2977;93324;729;0;0;0;0;.00nan;0;0
2978;43971;742;83;34;2;32;.941;3900000;0
2978;192386;732;0;0;0;0;.00nan;0;0
2978;52204;742;0;0;0;0;.00nan;0;0
2978;148788;732;59;22;2;20;.909;3900000;0
2979;83;737;68;35;4;31;.886;3900000;0
2979;190570;737;0;0;0;0;.00nan;0;0
2979;46792;743;46;25;4;21;.840;3900000;0
2979;148956;743;0;0;0;0;.00nan;0;0
2980;175764;1880;0;0;0;0;.00nan;0;0
2980;185413;740;0;0;0;0;.00nan;0;0
2980;49900;1880;78;27;1;26;.963;3600000;0
2980;57107;740;74;45;4;41;.911;3600000;0
2981;3928;744;78;32;2;30;.938;3545000;0
2981;6868;764;0;0;0;0;.00nan;0;0
2981;174898;764;74;24;1;23;.958;3600000;0
2981;64722;744;0;0;0;0;.00nan;0;0
2982;14335;747;95;38;2;36;.947;3888000;0
2982;190589;747;0;0;0;0;.00nan;0;0
2982;-1;733;0;0;0;0;.00nan;0;0
2982;85787;733;99;47;2;45;.957;3900000;0
2983;2643;739;63;36;3;33;.917;3600000;0
2983;186234;739;0;0;0;0;.00nan;0;0
2983;186235;751;0;0;0;0;.00nan;0;0
2983;-1;751;23;30;7;23;.767;3600000;0
2984;178098;738;21;25;6;19;.760;3157000;0
2984;178114;752;80;44;4;40;.909;3600000;0
2984;33480;752;0;0;0;0;.00nan;0;0
2984;185442;738;55;4;0;4;1.000;431000;0
2985;3756;748;64;23;2;21;.913;3577000;0
2985;6570;3789;89;31;1;30;.968;3600000;0
2985;-1;748;0;0;0;0;.00nan;0;0
2985;-1;3789;0;0;0;0;.00nan;0;0
2986;192386;732;0;0;0;0;.00nan;0;0
2986;76405;2168;100;41;0;41;1.000;3600000;0
2986;85670;2168;0;0;0;0;.00nan;0;0
2986;148788;732;68;37;5;32;.865;3600000;0
2987;6079;734;0;0;0;0;.00nan;0;0
2987;43971;742;80;35;2;33;.943;3600000;0
2987;44526;734;66;28;3;25;.893;3545000;0
2987;52204;742;0;0;0;0;.00nan;0;0
2988;3508;745;89;29;1;28;.966;3600000;0
2988;3928;744;61;33;5;28;.848;3600000;0
2988;180188;745;0;0;0;0;.00nan;0;0
2988;64722;744;0;0;0;0;.00nan;0;0
2989;46792;743;0;0;0;0;.00nan;0;0
2989;56565;741;86;40;2;38;.950;3900000;0
2989;57695;741;0;0;0;0;.00nan;0;0
2989;148956;743;84;30;2;28;.933;3900000;0
2990;83;737;94;23;0;23;1.000;3900000;0
2990;6868;764;100;26;0;26;1.000;3900000;0
2990;174898;764;0;0;0;0;.00nan;0;0
2990;190570;737;0;0;0;0;.00nan;0;0
2991;3508;745;73;38;3;35;.921;3526000;0
2991;180188;745;0;0;0;0;.00nan;0;0
2991;85281;749;0;0;0;0;.00nan;0;0
2991;86697;749;83;25;1;24;.960;3600000;0
2992;-1;733;0;0;0;0;.00nan;0;0
2992;186235;751;0;0;0;0;.00nan;0;0
2992;-1;751;82;29;1;28;.966;3600000;0
2992;85787;733;78;31;2;29;.935;3576000;0
2993;178098;738;85;27;1;26;.963;3600000;0
2993;175764;1880;0;0;0;0;.00nan;0;0
2993;185442;738;0;0;0;0;.00nan;0;0
2993;49900;1880;70;31;4;27;.871;3600000;0
2994;3756;748;33;30;6;24;.800;3600000;0
2994;-1;748;0;0;0;0;.00nan;0;0
2994;192386;732;0;0;0;0;.00nan;0;0
2994;148788;732;100;39;1;38;.974;3600000;0
2995;6079;734;0;0;0;0;.00nan;0;0
2995;6570;3789;87;38;2;36;.947;3563000;0
2995;44526;734;75;26;1;25;.962;3600000;0
2995;-1;3789;0;0;0;0;.00nan;0;0
2996;3928;744;75;22;1;21;.955;3600000;0
2996;64722;744;0;0;0;0;.00nan;0;0
2996;76405;2168;70;28;3;25;.893;3513000;0
2996;85670;2168;0;0;0;0;.00nan;0;0
2997;178114;752;0;0;0;0;.00nan;0;0
2997;14335;747;50;31;5;26;.839;3600000;0
2997;33480;752;100;31;0;31;1.000;3600000;0
2997;190589;747;0;0;0;0;.00nan;0;0
2998;185413;740;0;0;0;0;.00nan;0;0
2998;56565;741;95;37;2;35;.946;3600000;0
2998;57107;740;38;19;4;15;.789;3576000;0
2998;57695;741;0;0;0;0;.00nan;0;0
2999;178098;738;0;0;0;0;.00nan;0;0
2999;175764;1880;85;32;2;30;.938;3578000;0
2999;185442;738;55;10;1;9;.900;3600000;0
2999;49900;1880;0;0;0;0;.00nan;0;0
3000;1957;736;0;0;0;0;.00nan;0;0
3000;186219;736;95;46;3;43;.935;3600000;0
3000;46792;743;67;15;1;14;.933;3600000;0
3000;148956;743;0;0;0;0;.00nan;0;0
3001;83;737;93;41;2;39;.951;3600000;0
3001;190570;737;0;0;0;0;.00nan;0;0
3001;43971;742;0;0;0;0;.00nan;0;0
3001;52204;742;59;26;3;23;.885;3600000;0
3002;6868;764;99;35;1;34;.971;3683000;0
3002;174898;764;0;0;0;0;.00nan;0;0
3002;85281;749;85;29;2;27;.931;3683000;0
3002;86697;749;0;0;0;0;.00nan;0;0
3003;83;737;68;18;1;17;.944;3600000;0
3003;190570;737;0;0;0;0;.00nan;0;0
3003;192386;732;98;46;3;43;.935;3564000;0
3003;148788;732;0;0;0;0;.00nan;0;0
3004;3508;745;72;29;3;26;.897;3600000;0
3004;6079;734;0;0;0;0;.00nan;0;0
3004;180188;745;0;0;0;0;.00nan;0;0
3004;44526;734;100;35;0;35;1.000;3600000;0
3005;6570;3789;30;9;3;6;.667;550000;0
3005;33480;3789;68;24;2;22;.917;3050000;0
3005;50065;729;100;39;0;39;1.000;3600000;0
3005;93324;729;0;0;0;0;.00nan;0;0
3006;186235;751;20;26;6;20;.769;3066000;0
3006;-1;751;48;0;0;0;.00nan;534000;0
3006;46792;743;80;29;1;28;.966;3600000;0
3006;148956;743;0;0;0;0;.00nan;0;0
3007;178114;752;0;0;0;0;.00nan;0;0
3007;43731;752;55;28;4;24;.857;3600000;0
3007;56565;741;41;39;7;32;.821;3575000;0
3007;57695;741;0;0;0;0;.00nan;0;0
3008;3756;748;73;34;3;31;.912;3900000;0
3008;-1;748;0;0;0;0;.00nan;0;0
3008;185413;740;0;0;0;0;.00nan;0;0
3008;57107;740;96;47;3;44;.936;3900000;0
3009;14335;747;93;37;1;36;.973;3600000;0
3009;175764;1880;0;0;0;0;.00nan;0;0
3009;190589;747;0;0;0;0;.00nan;0;0
3009;49900;1880;71;29;2;27;.931;3600000;0
3010;1957;736;67;48;5;43;.896;3600000;0
3010;2643;739;62;19;2;17;.895;3600000;0
3010;186219;736;0;0;0;0;.00nan;0;0
3010;186234;739;0;0;0;0;.00nan;0;0
3011;43971;742;82;35;2;33;.943;3560000;0
3011;52204;742;0;0;0;0;.00nan;0;0
3011;76405;2168;63;15;1;14;.933;3600000;0
3011;85670;2168;0;0;0;0;.00nan;0;0
3012;6868;764;0;0;0;0;.00nan;0;0
3012;174898;764;88;30;1;29;.967;3600000;0
3012;85281;749;0;0;0;0;.00nan;0;0
3012;86697;749;62;29;3;26;.897;3540000;0
3013;56565;741;82;28;2;26;.929;3600000;0
3013;57695;741;0;0;0;0;.00nan;0;0
3013;76405;2168;97;33;1;32;.970;3600000;0
3013;85670;2168;0;0;0;0;.00nan;0;0
3014;178098;738;83;35;2;33;.943;3600000;0
3014;185442;738;0;0;0;0;.00nan;0;0
3014;50065;729;65;30;3;27;.900;3600000;0
3014;93324;729;0;0;0;0;.00nan;0;0
3015;3928;744;62;32;3;29;.906;3600000;0
3015;6570;3789;0;0;0;0;.00nan;0;0
3015;33480;3789;51;16;2;14;.875;3600000;0
3015;64722;744;0;0;0;0;.00nan;0;0
3016;178114;752;0;0;0;0;.00nan;0;0
3016;186235;751;0;0;0;0;.00nan;0;0
3016;-1;751;54;33;4;29;.879;3600000;0
3016;43731;752;88;30;1;29;.967;3600000;0
3017;3756;748;74;32;3;29;.906;3579000;0
3017;175764;1880;0;0;0;0;.00nan;0;0
3017;-1;748;0;0;0;0;.00nan;0;0
3017;49900;1880;87;25;1;24;.960;3600000;0
3018;1957;736;87;45;3;42;.933;3543000;0
3018;186219;736;0;0;0;0;.00nan;0;0
3018;192386;732;0;0;0;0;.00nan;0;0
3018;148788;732;88;28;1;27;.964;3600000;0
3019;185413;740;0;0;0;0;.00nan;0;0
3019;-1;733;0;0;0;0;.00nan;0;0
3019;57107;740;37;32;6;26;.813;3600000;0
3019;85787;733;100;32;0;32;1.000;3600000;0
3020;43971;742;99;27;0;27;1.000;3600000;0
3020;46792;743;98;51;1;50;.980;3597000;0
3020;52204;742;0;0;0;0;.00nan;0;0
3020;148956;743;0;0;0;0;.00nan;0;0
3021;2643;739;74;27;2;25;.926;3900000;0
3021;3508;745;97;42;2;40;.952;3900000;0
3021;180188;745;0;0;0;0;.00nan;0;0
3021;186234;739;0;0;0;0;.00nan;0;0
3022;83;737;85;29;1;28;.966;3600000;0
3022;6079;734;0;0;0;0;.00nan;0;0
3022;190570;737;0;0;0;0;.00nan;0;0
3022;44526;734;63;35;4;31;.886;3600000;0
3023;3756;748;47;36;5;31;.861;3600000;0
3023;6570;3789;0;0;0;0;.00nan;0;0
3023;-1;748;0;0;0;0;.00nan;0;0
3023;33480;3789;51;29;4;25;.862;3600000;0
3024;14335;747;59;36;5;31;.861;3600000;0
3024;190589;747;0;0;0;0;.00nan;0;0
3024;50065;729;100;44;0;44;1.000;3600000;0
3024;93324;729;0;0;0;0;.00nan;0;0
3025;83;737;74;25;2;23;.920;3545000;0
3025;6079;734;0;0;0;0;.00nan;0;0
3025;190570;737;0;0;0;0;.00nan;0;0
3025;44526;734;73;23;1;22;.957;3600000;0
3026;178114;752;0;0;0;0;.00nan;0;0
3026;43731;752;70;35;3;32;.914;3600000;0
3026;46792;743;73;22;2;20;.909;3600000;0
3026;148956;743;0;0;0;0;.00nan;0;0
3027;1957;736;92;38;2;36;.947;3788000;0
3027;185413;740;0;0;0;0;.00nan;0;0
3027;186219;736;0;0;0;0;.00nan;0;0
3027;57107;740;95;39;1;38;.974;3788000;0
3028;178098;738;67;34;2;32;.941;3900000;0
3028;185442;738;0;0;0;0;.00nan;0;0
3028;-1;733;0;0;0;0;.00nan;0;0
3028;85787;733;93;42;2;40;.952;3900000;0
3029;186235;751;70;46;4;42;.913;3900000;0
3029;-1;751;0;0;0;0;.00nan;0;0
3029;43971;742;100;46;4;42;.913;3900000;0
3029;52204;742;0;0;0;0;.00nan;0;0
3030;56565;741;96;37;2;35;.946;3900000;0
3030;57695;741;0;0;0;0;.00nan;0;0
3030;76405;2168;0;0;0;0;.00nan;0;0
3030;85670;2168;100;40;2;38;.950;3900000;0
3031;2643;739;65;40;4;36;.900;3900000;0
3031;6868;764;0;0;0;0;.00nan;0;0
3031;174898;764;60;33;4;29;.879;3900000;0
3031;186234;739;0;0;0;0;.00nan;0;0
3032;178114;752;0;0;0;0;.00nan;0;0
3032;175764;1880;0;0;0;0;.00nan;0;0
3032;43731;752;73;39;3;36;.923;3848000;0
3032;49900;1880;84;33;2;31;.939;3848000;0
3033;83;737;60;32;5;27;.844;3600000;0
3033;178098;738;75;30;2;28;.933;3600000;0
3033;190570;737;0;0;0;0;.00nan;0;0
3033;185442;738;0;0;0;0;.00nan;0;0
3034;3928;744;75;27;2;25;.926;3600000;0
3034;186235;751;0;0;0;0;.00nan;0;0
3034;-1;751;77;31;3;28;.903;3552000;0
3034;64722;744;0;0;0;0;.00nan;0;0
3035;-1;733;0;0;0;0;.00nan;0;0
3035;192386;732;0;0;0;0;.00nan;0;0
3035;85787;733;91;28;1;27;.964;3600000;0
3035;148788;732;84;31;2;29;.935;3553000;0
3036;50065;729;100;38;0;38;1.000;3600000;0
3036;85281;749;71;20;1;19;.950;3554000;0
3036;86697;749;0;0;0;0;.00nan;0;0
3036;93324;729;0;0;0;0;.00nan;0;0
3037;2643;739;73;25;2;23;.920;3600000;0
3037;3756;748;63;32;3;29;.906;3580000;0
3037;-1;748;0;0;0;0;.00nan;0;0
3037;186234;739;0;0;0;0;.00nan;0;0
3038;6570;3789;0;0;0;0;.00nan;0;0
3038;175764;1880;0;0;0;0;.00nan;0;0
3038;33480;3789;64;26;2;24;.923;3587000;0
3038;49900;1880;77;28;1;27;.964;3600000;0
3039;14335;747;71;27;2;25;.926;3600000;0
3039;190589;747;0;0;0;0;.00nan;0;0
3039;43971;742;73;31;3;28;.903;3593000;0
3039;52204;742;0;0;0;0;.00nan;0;0
3040;3508;745;64;29;3;26;.897;3534000;0
3040;180188;745;0;0;0;0;.00nan;0;0
3040;56565;741;98;38;1;37;.974;3600000;0
3040;57695;741;0;0;0;0;.00nan;0;0
3041;1957;736;69;37;4;33;.892;3546000;0
3041;186219;736;0;0;0;0;.00nan;0;0
3041;46792;743;53;23;3;20;.870;3600000;0
3041;148956;743;0;0;0;0;.00nan;0;0
3042;6868;764;95;29;1;28;.966;3600000;0
3042;174898;764;0;0;0;0;.00nan;0;0
3042;185413;740;0;0;0;0;.00nan;0;0
3042;57107;740;66;27;3;24;.889;3557000;0
3043;83;737;74;33;3;30;.909;3600000;0
3043;190570;737;0;0;0;0;.00nan;0;0
3043;76405;2168;100;25;0;25;1.000;3600000;0
3043;85670;2168;0;0;0;0;.00nan;0;0
3044;6570;3789;56;23;2;21;.913;3600000;0
3044;175764;1880;50;28;4;24;.857;3583000;0
3044;33480;3789;0;0;0;0;.00nan;0;0
3044;49900;1880;0;0;0;0;.00nan;0;0
3045;14335;747;100;20;0;20;1.000;3600000;0
3045;190589;747;0;0;0;0;.00nan;0;0
3045;43971;742;89;40;3;37;.925;3600000;0
3045;52204;742;0;0;0;0;.00nan;0;0
3046;186235;751;96;30;1;29;.967;3600000;0
3046;-1;751;0;0;0;0;.00nan;0;0
3046;50065;729;98;42;2;40;.952;3552000;0
3046;93324;729;0;0;0;0;.00nan;0;0
3047;6079;734;0;0;0;0;.00nan;0;0
3047;-1;733;0;0;0;0;.00nan;0;0
3047;44526;734;76;22;1;21;.955;3600000;0
3047;85787;733;80;45;4;41;.911;3600000;0
3048;192386;732;0;0;0;0;.00nan;0;0
3048;85281;749;0;0;0;0;.00nan;0;0
3048;86697;749;87;35;1;34;.971;3600000;0
3048;148788;732;69;41;4;37;.902;3600000;0
3049;1957;736;92;54;4;50;.926;3523000;0
3049;3508;745;0;0;0;0;.00nan;0;0
3049;180188;745;71;24;2;22;.917;3600000;0
3049;186219;736;0;0;0;0;.00nan;0;0
3050;3928;744;100;31;0;31;1.000;3600000;0
3050;56565;741;80;28;2;26;.929;3600000;0
3050;57695;741;0;0;0;0;.00nan;0;0
3050;64722;744;0;0;0;0;.00nan;0;0
3051;185413;740;55;4;0;4;1.000;468000;0
3051;46792;743;74;32;4;28;.875;3600000;0
3051;57107;740;55;42;7;35;.833;3132000;0
3051;148956;743;0;0;0;0;.00nan;0;0
3052;83;737;93;33;1;32;.970;3545000;0
3052;3756;748;0;0;0;0;.00nan;0;0
3052;-1;748;87;19;0;19;1.000;3600000;0
3052;190570;737;0;0;0;0;.00nan;0;0
3053;6079;734;0;0;0;0;.00nan;0;0
3053;44526;734;100;28;0;28;1.000;3600000;0
3053;76405;2168;95;39;2;37;.949;3600000;0
3053;85670;2168;0;0;0;0;.00nan;0;0
3054;6570;3789;0;0;0;0;.00nan;0;0
3054;178098;738;79;32;2;30;.938;3600000;0
3054;33480;3789;54;26;3;23;.885;3558000;0
3054;185442;738;0;0;0;0;.00nan;0;0
3055;14335;747;63;36;4;32;.889;3600000;0
3055;190589;747;0;0;0;0;.00nan;0;0
3055;192386;732;0;0;0;0;.00nan;0;0
3055;148788;732;99;41;1;40;.976;3600000;0
3056;178114;752;0;0;0;0;.00nan;0;0
3056;43731;752;70;27;2;25;.926;3600000;0
3056;50065;729;83;42;3;39;.929;3549000;0
3056;93324;729;0;0;0;0;.00nan;0;0
3057;43971;742;70;47;6;41;.872;3179000;0
3057;52204;742;53;3;0;3;1.000;421000;0
3057;85281;749;86;26;1;25;.962;3600000;0
3057;86697;749;0;0;0;0;.00nan;0;0
3058;2643;739;96;33;1;32;.970;3600000;0
3058;186234;739;0;0;0;0;.00nan;0;0
3058;46792;743;59;36;4;32;.889;3600000;0
3058;148956;743;0;0;0;0;.00nan;0;0
3059;175764;1880;0;0;0;0;.00nan;0;0
3059;-1;733;0;0;0;0;.00nan;0;0
3059;49900;1880;71;39;4;35;.897;3582000;0
3059;85787;733;76;27;2;25;.926;3600000;0
3060;3756;748;0;0;0;0;.00nan;0;0
3060;6079;734;0;0;0;0;.00nan;0;0
3060;-1;748;89;34;2;32;.941;3600000;0
3060;44526;734;49;29;4;25;.862;3579000;0
3061;185413;740;0;0;0;0;.00nan;0;0
3061;56565;741;0;0;0;0;.00nan;0;0
3061;57107;740;77;52;5;47;.904;3567000;0
3061;57695;741;51;27;4;23;.852;3600000;0
3062;3928;744;63;26;3;23;.885;3687000;0
3062;6570;3789;72;23;2;21;.913;3687000;0
3062;33480;3789;0;0;0;0;.00nan;0;0
3062;64722;744;0;0;0;0;.00nan;0;0
3063;186235;751;0;0;0;0;.00nan;0;0
3063;-1;751;76;25;1;24;.960;3600000;0
3063;192386;732;0;0;0;0;.00nan;0;0
3063;148788;732;90;30;2;28;.933;3549000;0
3064;175764;1880;0;0;0;0;.00nan;0;0
3064;-1;733;0;0;0;0;.00nan;0;0
3064;49900;1880;50;32;5;27;.844;3546000;0
3064;85787;733;68;42;4;38;.905;3600000;0
3065;1957;736;87;29;1;28;.966;3900000;0
3065;178098;738;84;28;1;27;.964;3900000;0
3065;185442;738;0;0;0;0;.00nan;0;0
3065;186219;736;0;0;0;0;.00nan;0;0
3066;6868;764;0;0;0;0;.00nan;0;0
3066;178114;752;0;0;0;0;.00nan;0;0
3066;174898;764;87;35;3;32;.914;3900000;0
3066;43731;752;68;30;3;27;.900;3900000;0
3067;43971;742;55;31;4;27;.871;3600000;0
3067;52204;742;0;0;0;0;.00nan;0;0
3067;85281;749;0;0;0;0;.00nan;0;0
3067;86697;749;56;16;2;14;.875;3600000;0
3068;2643;739;77;14;0;14;1.000;3600000;0
3068;14335;747;88;37;2;35;.946;3552000;0
3068;190589;747;0;0;0;0;.00nan;0;0
3068;186234;739;0;0;0;0;.00nan;0;0
3069;178098;738;0;0;0;0;.00nan;0;0
3069;185442;738;52;25;4;21;.840;3544000;0
3069;56565;741;86;37;3;34;.919;3600000;0
3069;57695;741;0;0;0;0;.00nan;0;0
3070;6079;734;0;0;0;0;.00nan;0;0
3070;185413;740;0;0;0;0;.00nan;0;0
3070;44526;734;81;26;1;25;.962;3600000;0
3070;57107;740;69;28;2;26;.929;3582000;0
3071;6570;3789;75;24;1;23;.958;3600000;0
3071;33480;3789;0;0;0;0;.00nan;0;0
3071;-1;733;0;0;0;0;.00nan;0;0
3071;85787;733;50;29;4;25;.862;3600000;0
3072;83;737;75;31;3;28;.903;3900000;0
3072;190570;737;0;0;0;0;.00nan;0;0
3072;50065;729;81;35;3;32;.914;3900000;0
3072;93324;729;0;0;0;0;.00nan;0;0
3073;3928;744;94;38;1;37;.974;3544000;0
3073;186235;751;100;31;0;31;1.000;3600000;0
3073;-1;751;0;0;0;0;.00nan;0;0
3073;64722;744;0;0;0;0;.00nan;0;0
3074;3508;745;65;37;4;33;.892;3580000;0
3074;175764;1880;55;26;3;23;.885;3600000;0
3074;180188;745;0;0;0;0;.00nan;0;0
3074;49900;1880;0;0;0;0;.00nan;0;0
3075;1957;736;81;66;6;60;.909;3600000;0
3075;178114;752;0;0;0;0;.00nan;0;0
3075;186219;736;0;0;0;0;.00nan;0;0
3075;43731;752;72;25;2;23;.920;3600000;0
3076;6868;764;65;41;5;36;.878;3600000;0
3076;174898;764;0;0;0;0;.00nan;0;0
3076;76405;2168;92;36;1;35;.972;3600000;0
3076;85670;2168;0;0;0;0;.00nan;0;0
3077;3756;748;85;25;1;24;.960;3600000;0
3077;-1;748;0;0;0;0;.00nan;0;0
3077;85281;749;59;19;2;17;.895;3557000;0
3077;86697;749;0;0;0;0;.00nan;0;0
3078;14335;747;100;29;0;29;1.000;3600000;0
3078;190589;747;0;0;0;0;.00nan;0;0
3078;46792;743;0;0;0;0;.00nan;0;0
3078;148956;743;98;41;2;39;.951;3591000;0
3079;178114;752;0;0;0;0;.00nan;0;0
3079;43731;752;51;35;6;29;.829;3600000;0
3079;56565;741;78;33;3;30;.909;3600000;0
3079;57695;741;0;0;0;0;.00nan;0;0
3080;6079;734;0;0;0;0;.00nan;0;0
3080;-1;733;0;0;0;0;.00nan;0;0
3080;44526;734;32;18;4;14;.778;3600000;0
3080;85787;733;93;43;1;42;.977;3600000;0
3081;83;737;52;37;5;32;.865;3587000;0
3081;190570;737;0;0;0;0;.00nan;0;0
3081;186235;751;0;0;0;0;.00nan;0;0
3081;-1;751;46;27;4;23;.852;3600000;0
3082;185413;740;39;1;1;0;.000;483000;0
3082;50065;729;27;25;6;19;.760;3600000;0
3082;57107;740;30;31;7;24;.774;3096000;0
3082;93324;729;0;0;0;0;.00nan;0;0
3083;3928;744;63;32;4;28;.875;3549000;0
3083;64722;744;0;0;0;0;.00nan;0;0
3083;76405;2168;65;26;3;23;.885;3600000;0
3083;85670;2168;0;0;0;0;.00nan;0;0
3084;178098;738;50;28;4;24;.857;3600000;0
3084;185442;738;0;0;0;0;.00nan;0;0
3084;192386;732;0;0;0;0;.00nan;0;0
3084;148788;732;90;33;1;32;.970;3600000;0
3085;2643;739;79;24;1;23;.958;3600000;0
3085;175764;1880;0;0;0;0;.00nan;0;0
3085;186234;739;0;0;0;0;.00nan;0;0
3085;49900;1880;76;34;3;31;.912;3523000;0
3086;1957;736;86;45;4;41;.911;3600000;0
3086;3508;745;54;19;2;17;.895;3600000;0
3086;180188;745;0;0;0;0;.00nan;0;0
3086;186219;736;0;0;0;0;.00nan;0;0
3087;6868;764;0;0;0;0;.00nan;0;0
3087;174898;764;85;37;3;34;.919;3590000;0
3087;43971;742;100;33;1;32;.970;3600000;0
3087;52204;742;0;0;0;0;.00nan;0;0
3088;6079;734;0;0;0;0;.00nan;0;0
3088;-1;733;0;0;0;0;.00nan;0;0
3088;44526;734;74;23;2;21;.913;3600000;0
3088;85787;733;81;42;3;39;.929;3574000;0
3089;14335;747;42;30;5;25;.833;3597000;0
3089;190589;747;0;0;0;0;.00nan;0;0
3089;85281;749;0;0;0;0;.00nan;0;0
3089;86697;749;76;33;3;30;.909;3600000;0
3090;3756;748;100;26;0;26;1.000;3600000;0
3090;-1;748;0;0;0;0;.00nan;0;0
3090;46792;743;63;24;3;21;.875;3600000;0
3090;148956;743;0;0;0;0;.00nan;0;0
3091;3508;745;68;30;3;27;.900;3579000;0
3091;6570;3789;78;29;2;27;.931;3600000;0
3091;33480;3789;0;0;0;0;.00nan;0;0
3091;180188;745;0;0;0;0;.00nan;0;0
3092;3928;744;88;34;2;32;.941;3900000;0
3092;186235;751;70;27;2;25;.926;3900000;0
3092;-1;751;0;0;0;0;.00nan;0;0
3092;64722;744;0;0;0;0;.00nan;0;0
3093;192386;732;0;0;0;0;.00nan;0;0
3093;76405;2168;86;28;2;26;.929;3600000;0
3093;85670;2168;0;0;0;0;.00nan;0;0
3093;148788;732;75;29;1;28;.966;3600000;0
3094;2643;739;77;29;3;26;.897;3600000;0
3094;185413;740;0;0;0;0;.00nan;0;0
3094;186234;739;0;0;0;0;.00nan;0;0
3094;57107;740;69;45;5;40;.889;3553000;0
3095;178098;738;0;0;0;0;.00nan;0;0
3095;185442;738;61;30;4;26;.867;3537000;0
3095;56565;741;73;31;3;28;.903;3600000;0
3095;57695;741;0;0;0;0;.00nan;0;0
3096;14335;747;72;39;3;36;.923;3600000;0
3096;190589;747;0;0;0;0;.00nan;0;0
3096;-1;749;0;0;0;0;.00nan;0;0
3096;86697;749;63;36;4;32;.889;3528000;0
3097;1957;736;38;36;6;30;.833;3600000;0
3097;186219;736;0;0;0;0;.00nan;0;0
3097;50065;729;78;36;3;33;.917;3600000;0
3097;93324;729;0;0;0;0;.00nan;0;0
3098;178114;752;0;0;0;0;.00nan;0;0
3098;43731;752;59;44;6;38;.864;3600000;0
3098;46792;743;82;26;1;25;.962;3600000;0
3098;148956;743;0;0;0;0;.00nan;0;0
3099;3756;748;91;35;1;34;.971;3554000;0
3099;6868;764;0;0;0;0;.00nan;0;0
3099;174898;764;100;30;0;30;1.000;3600000;0
3099;-1;748;0;0;0;0;.00nan;0;0
3100;2643;739;100;33;0;33;1.000;3600000;0
3100;6079;734;0;0;0;0;.00nan;0;0
3100;186234;739;0;0;0;0;.00nan;0;0
3100;44526;734;67;19;1;18;.947;3546000;0
3101;175764;1880;0;0;0;0;.00nan;0;0
3101;186235;751;0;0;0;0;.00nan;0;0
3101;-1;751;97;48;1;47;.979;3600000;0
3101;49900;1880;100;23;0;23;1.000;3600000;0
3102;33480;3789;92;34;2;32;.941;3900000;0
3102;43971;742;0;0;0;0;.00nan;0;0
3102;-1;3789;0;0;0;0;.00nan;0;0
3102;52204;742;89;41;2;39;.951;3900000;0
3103;46792;743;57;31;4;27;.871;3600000;0
3103;76405;2168;0;0;0;0;.00nan;0;0
3103;85670;2168;100;26;0;26;1.000;3600000;0
3103;148956;743;0;0;0;0;.00nan;0;0
3104;178098;738;94;40;2;38;.950;3600000;0
3104;185442;738;0;0;0;0;.00nan;0;0
3104;192386;732;0;0;0;0;.00nan;0;0
3104;148788;732;74;38;3;35;.921;3600000;0
3105;83;737;51;32;4;28;.875;3600000;0
3105;190570;737;0;0;0;0;.00nan;0;0
3105;56565;741;100;40;0;40;1.000;3600000;0
3105;57695;741;0;0;0;0;.00nan;0;0
3106;3508;745;39;21;4;17;.810;937000;0
3106;180188;745;70;20;1;19;.950;2663000;0
3106;50065;729;100;41;2;39;.951;3600000;0
3106;93324;729;0;0;0;0;.00nan;0;0
3107;3928;744;100;25;0;25;1.000;3600000;0
3107;6868;764;0;0;0;0;.00nan;0;0
3107;174898;764;98;44;2;42;.955;3580000;0
3107;64722;744;0;0;0;0;.00nan;0;0
3108;3756;748;39;36;6;30;.833;3600000;0
3108;178114;752;0;0;0;0;.00nan;0;0
3108;-1;748;0;0;0;0;.00nan;0;0
3108;43731;752;84;32;1;31;.969;3600000;0
3109;1957;736;70;36;3;33;.917;3600000;0
3109;185413;740;0;0;0;0;.00nan;0;0
3109;186219;736;0;0;0;0;.00nan;0;0
3109;57107;740;45;31;5;26;.839;3568000;0
3110;2643;739;50;39;6;33;.846;3600000;0
3110;33480;3789;62;23;2;21;.913;3600000;0
3110;186234;739;0;0;0;0;.00nan;0;0
3110;-1;3789;0;0;0;0;.00nan;0;0
3111;6079;734;0;0;0;0;.00nan;0;0
3111;14335;747;71;26;2;24;.923;3529000;0
3111;190589;747;0;0;0;0;.00nan;0;0
3111;44526;734;100;32;0;32;1.000;3600000;0
3112;175764;1880;40;2;1;1;.500;629000;0
3112;-1;749;0;0;0;0;.00nan;0;0
3112;49900;1880;25;24;6;18;.750;2971000;0
3112;86697;749;65;34;4;30;.882;3600000;0
3113;1957;736;87;45;3;42;.933;3600000;0
3113;3928;744;73;21;1;20;.952;3600000;0
3113;186219;736;0;0;0;0;.00nan;0;0
3113;64722;744;0;0;0;0;.00nan;0;0
3114;186235;751;69;29;2;27;.931;3595000;0
3114;-1;751;0;0;0;0;.00nan;0;0
3114;46792;743;91;27;1;26;.963;3600000;0
3114;148956;743;0;0;0;0;.00nan;0;0
3115;6868;764;61;43;5;38;.884;3575000;0
3115;178114;752;54;27;3;24;.889;3600000;0
3115;174898;764;0;0;0;0;.00nan;0;0
3115;43731;752;0;0;0;0;.00nan;0;0
3116;185413;740;0;0;0;0;.00nan;0;0
3116;192386;732;0;0;0;0;.00nan;0;0
3116;57107;740;61;35;5;30;.857;3768000;0
3116;148788;732;56;32;4;28;.875;3768000;0
3117;-1;733;0;0;0;0;.00nan;0;0
3117;56565;741;51;30;4;26;.867;3587000;0
3117;57695;741;0;0;0;0;.00nan;0;0
3117;85787;733;75;25;2;23;.920;3600000;0
3118;3508;745;86;32;2;30;.938;3900000;0
3118;180188;745;0;0;0;0;.00nan;0;0
3118;43971;742;75;31;2;29;.935;3900000;0
3118;52204;742;0;0;0;0;.00nan;0;0
3119;178098;738;50;32;5;27;.844;3600000;0
3119;33480;3789;53;26;3;23;.885;3600000;0
3119;185442;738;0;0;0;0;.00nan;0;0
3119;-1;3789;0;0;0;0;.00nan;0;0
3120;14335;747;64;53;7;46;.868;3600000;0
3120;175764;1880;0;0;0;0;.00nan;0;0
3120;190589;747;0;0;0;0;.00nan;0;0
3120;49900;1880;72;23;2;21;.913;3600000;0
3121;6079;734;0;0;0;0;.00nan;0;0
3121;44526;734;71;33;3;30;.909;3580000;0
3121;85281;749;90;39;2;37;.949;3600000;0
3121;86697;749;0;0;0;0;.00nan;0;0
3122;-1;733;0;0;0;0;.00nan;0;0
3122;76405;2168;0;0;0;0;.00nan;0;0
3122;85670;2168;64;28;3;25;.893;3900000;0
3122;85787;733;91;48;3;45;.938;3900000;0
3123;2643;739;51;26;3;23;.885;3600000;0
3123;186234;739;0;0;0;0;.00nan;0;0
3123;50065;729;66;40;4;36;.900;3600000;0
3123;93324;729;0;0;0;0;.00nan;0;0
3124;83;737;77;21;1;20;.952;3600000;0
3124;190570;737;0;0;0;0;.00nan;0;0
3124;186235;751;0;0;0;0;.00nan;0;0
3124;-1;751;81;33;3;30;.909;3573000;0
3125;6868;764;0;0;0;0;.00nan;0;0
3125;174898;764;64;27;3;24;.889;3576000;0
3125;192386;732;0;0;0;0;.00nan;0;0
3125;148788;732;88;33;2;31;.939;3600000;0
3126;1957;736;59;36;4;32;.889;3687000;0
3126;186219;736;0;0;0;0;.00nan;0;0
3126;43971;742;63;38;5;33;.868;3687000;0
3126;52204;742;0;0;0;0;.00nan;0;0
3127;3508;745;51;27;4;23;.852;3600000;0
3127;180188;745;0;0;0;0;.00nan;0;0
3127;56565;741;43;39;6;33;.846;3034000;0
3127;57695;741;50;1;0;1;1.000;498000;0
3128;14335;747;75;33;2;31;.939;3600000;0
3128;190589;747;0;0;0;0;.00nan;0;0
3128;85281;749;39;30;6;24;.800;2567000;0
3128;86697;749;69;16;1;15;.938;1033000;0
3129;3928;744;68;25;3;22;.880;3600000;0
3129;46792;743;0;0;0;0;.00nan;0;0
3129;64722;744;0;0;0;0;.00nan;0;0
3129;148956;743;55;34;4;30;.882;3573000;0
3130;6079;734;0;0;0;0;.00nan;0;0
3130;186235;751;90;41;3;38;.927;3900000;0
3130;-1;751;0;0;0;0;.00nan;0;0
3130;44526;734;75;31;3;28;.903;3900000;0
3131;178098;738;0;0;0;0;.00nan;0;0
3131;185413;740;0;0;0;0;.00nan;0;0
3131;185442;738;72;37;3;34;.919;3600000;0
3131;57107;740;100;32;0;32;1.000;3600000;0
3132;3756;748;51;19;3;16;.842;3600000;0
3132;-1;748;0;0;0;0;.00nan;0;0
3132;-1;733;0;0;0;0;.00nan;0;0
3132;85787;733;71;44;5;39;.886;3531000;0
3133;2643;739;84;25;1;24;.960;3600000;0
3133;6570;3789;54;21;2;19;.905;3546000;0
3133;33480;3789;0;0;0;0;.00nan;0;0
3133;186234;739;0;0;0;0;.00nan;0;0
3134;192386;732;90;42;2;40;.952;3900000;0
3134;50065;729;86;32;2;30;.938;3900000;0
3134;93324;729;0;0;0;0;.00nan;0;0
3134;148788;732;0;0;0;0;.00nan;0;0
3135;43971;742;100;55;3;52;.945;3600000;0
3135;52204;742;0;0;0;0;.00nan;0;0
3135;56565;741;30;24;5;19;.792;3548000;0
3135;57695;741;0;0;0;0;.00nan;0;0
3136;3928;744;57;22;2;20;.909;3900000;0
3136;64722;744;0;0;0;0;.00nan;0;0
3136;76405;2168;88;34;2;32;.941;3900000;0
3136;85670;2168;0;0;0;0;.00nan;0;0
3137;83;737;46;17;3;14;.824;3600000;0
3137;1957;736;77;50;5;45;.900;3566000;0
3137;190570;737;0;0;0;0;.00nan;0;0
3137;186219;736;0;0;0;0;.00nan;0;0
3138;186235;751;0;0;0;0;.00nan;0;0
3138;-1;751;75;41;3;38;.927;3762000;0
3138;85281;749;79;37;4;33;.892;3779000;0
3138;86697;749;0;0;0;0;.00nan;0;0
3139;3508;745;56;24;3;21;.875;3600000;0
3139;178114;752;0;0;0;0;.00nan;0;0
3139;180188;745;0;0;0;0;.00nan;0;0
3139;43731;752;100;31;0;31;1.000;3600000;0
3140;3756;748;71;19;2;17;.895;3600000;0
3140;-1;748;0;0;0;0;.00nan;0;0
3140;46792;743;67;30;3;27;.900;3574000;0
3140;148956;743;0;0;0;0;.00nan;0;0
3141;6570;3789;48;27;5;22;.815;3600000;0
3141;14335;747;61;35;4;31;.886;3600000;0
3141;33480;3789;0;0;0;0;.00nan;0;0
3141;190589;747;0;0;0;0;.00nan;0;0
3142;185413;740;0;0;0;0;.00nan;0;0
3142;-1;733;0;0;0;0;.00nan;0;0
3142;57107;740;81;36;3;33;.917;3550000;0
3142;85787;733;65;22;2;20;.909;3600000;0
3143;175764;1880;60;24;2;22;.917;3900000;0
3143;49900;1880;0;0;0;0;.00nan;0;0
3143;50065;729;90;36;2;34;.944;3900000;0
3143;93324;729;0;0;0;0;.00nan;0;0
3144;6868;764;55;4;0;4;1.000;779000;0
3144;178098;738;0;0;0;0;.00nan;0;0
3144;174898;764;46;27;5;22;.815;2821000;0
3144;185442;738;74;33;2;31;.939;3600000;0
3145;83;737;0;0;0;0;.00nan;0;0
3145;190570;737;75;35;3;32;.914;3566000;0
3145;43971;742;94;31;1;30;.968;3600000;0
3145;52204;742;0;0;0;0;.00nan;0;0
3146;3508;745;70;19;1;18;.947;3600000;0
3146;180188;745;0;0;0;0;.00nan;0;0
3146;186235;751;59;27;3;24;.889;3551000;0
3146;-1;751;0;0;0;0;.00nan;0;0
3147;1957;736;90;52;4;48;.923;3600000;0
3147;178114;752;0;0;0;0;.00nan;0;0
3147;186219;736;0;0;0;0;.00nan;0;0
3147;43731;752;96;20;0;20;1.000;3600000;0
3148;46792;743;75;22;1;21;.955;3541000;0
3148;56565;741;100;23;0;23;1.000;3600000;0
3148;57695;741;0;0;0;0;.00nan;0;0
3148;148956;743;0;0;0;0;.00nan;0;0
3149;6079;734;86;25;1;24;.960;3600000;0
3149;44526;734;0;0;0;0;.00nan;0;0
3149;76405;2168;87;44;3;41;.932;3561000;0
3149;85670;2168;0;0;0;0;.00nan;0;0
3150;3928;744;0;0;0;0;.00nan;0;0
3150;185413;740;0;0;0;0;.00nan;0;0
3150;57107;740;62;43;6;37;.860;3600000;0
3150;64722;744;74;22;1;21;.955;3600000;0
3151;178098;738;51;23;2;21;.913;3543000;0
3151;185442;738;0;0;0;0;.00nan;0;0
3151;192386;732;0;0;0;0;.00nan;0;0
3151;148788;732;99;53;1;52;.981;3600000;0
3152;175764;1880;0;0;0;0;.00nan;0;0
3152;49900;1880;82;25;1;24;.960;3600000;0
3152;50065;729;49;28;3;25;.893;3552000;0
3152;93324;729;0;0;0;0;.00nan;0;0
3153;2643;739;62;29;3;26;.897;3600000;0
3153;6868;764;0;0;0;0;.00nan;0;0
3153;174898;764;42;26;5;21;.808;3527000;0
3153;186234;739;0;0;0;0;.00nan;0;0
3154;6570;3789;96;49;1;48;.980;3900000;0
3154;33480;3789;0;0;0;0;.00nan;0;0
3154;85281;749;0;0;0;0;.00nan;0;0
3154;86697;749;96;35;1;34;.971;3900000;0
3155;3756;748;61;37;3;34;.919;3539000;0
3155;14335;747;90;27;1;26;.963;3600000;0
3155;-1;748;0;0;0;0;.00nan;0;0
3155;190589;747;0;0;0;0;.00nan;0;0
3156;3756;748;0;0;0;0;.00nan;0;0
3156;-1;748;98;40;2;38;.950;3584000;0
3156;76405;2168;98;21;0;21;1.000;3600000;0
3156;85670;2168;0;0;0;0;.00nan;0;0
3157;6079;734;0;0;0;0;.00nan;0;0
3157;44526;734;65;31;2;29;.935;3900000;0
3157;56565;741;100;35;2;33;.943;3900000;0
3157;57695;741;0;0;0;0;.00nan;0;0
3158;83;737;56;26;3;23;.885;3571000;0
3158;175764;1880;0;0;0;0;.00nan;0;0
3158;190570;737;0;0;0;0;.00nan;0;0
3158;49900;1880;75;23;1;22;.957;3600000;0
3159;3508;745;63;31;4;27;.871;3596000;0
3159;180188;745;0;0;0;0;.00nan;0;0
3159;192386;732;0;0;0;0;.00nan;0;0
3159;148788;732;57;24;3;21;.875;3600000;0
3160;2643;739;70;25;2;23;.920;3600000;0
3160;3928;744;79;26;1;25;.962;3600000;0
3160;186234;739;0;0;0;0;.00nan;0;0
3160;64722;744;0;0;0;0;.00nan;0;0
3161;6570;3789;86;34;2;32;.941;3900000;0
3161;33480;3789;0;0;0;0;.00nan;0;0
3161;186235;751;0;0;0;0;.00nan;0;0
3161;-1;751;80;33;2;31;.939;3900000;0
3162;1957;736;0;0;0;0;.00nan;0;0
3162;178098;738;0;0;0;0;.00nan;0;0
3162;185442;738;70;27;2;25;.926;3600000;0
3162;186219;736;87;48;3;45;.938;3575000;0
3163;178114;752;0;0;0;0;.00nan;0;0
3163;-1;733;0;0;0;0;.00nan;0;0
3163;43731;752;47;23;4;19;.826;3552000;0
3163;85787;733;72;29;2;27;.931;3600000;0
3164;185413;740;0;0;0;0;.00nan;0;0
3164;43971;742;60;20;2;18;.900;3600000;0
3164;52204;742;0;0;0;0;.00nan;0;0
3164;57107;740;97;50;3;47;.940;3543000;0
3165;14335;747;98;41;2;39;.951;3600000;0
3165;190589;747;0;0;0;0;.00nan;0;0
3165;85281;749;62;33;3;30;.909;3544000;0
3165;86697;749;0;0;0;0;.00nan;0;0
3166;6079;734;0;0;0;0;.00nan;0;0
3166;178098;738;100;31;0;31;1.000;3600000;0
3166;185442;738;0;0;0;0;.00nan;0;0
3166;44526;734;15;31;8;23;.742;3600000;0
3167;3508;745;87;20;0;20;1.000;3600000;0
3167;180188;745;0;0;0;0;.00nan;0;0
3167;46792;743;89;46;3;43;.935;3600000;0
3167;148956;743;0;0;0;0;.00nan;0;0
3168;50065;729;71;41;4;37;.902;3600000;0
3168;56565;741;73;22;1;21;.955;3600000;0
3168;57695;741;0;0;0;0;.00nan;0;0
3168;93324;729;0;0;0;0;.00nan;0;0
3169;3928;744;38;31;6;25;.806;3012000;0
3169;192386;732;0;0;0;0;.00nan;0;0
3169;64722;744;41;2;1;1;.500;588000;0
3169;148788;732;95;44;3;41;.932;3600000;0
3170;186235;751;65;39;4;35;.897;3553000;0
3170;-1;751;0;0;0;0;.00nan;0;0
3170;76405;2168;79;38;3;35;.921;3600000;0
3170;85670;2168;0;0;0;0;.00nan;0;0
3171;1957;736;62;36;4;32;.889;3567000;0
3171;175764;1880;0;0;0;0;.00nan;0;0
3171;186219;736;0;0;0;0;.00nan;0;0
3171;49900;1880;67;23;3;20;.870;3600000;0
3172;6868;764;0;0;0;0;.00nan;0;0
3172;174898;764;71;30;3;27;.900;3600000;0
3172;185413;740;0;0;0;0;.00nan;0;0
3172;57107;740;72;40;4;36;.900;3566000;0
3173;2643;739;77;26;2;24;.923;3600000;0
3173;-1;733;0;0;0;0;.00nan;0;0
3173;186234;739;0;0;0;0;.00nan;0;0
3173;85787;733;50;38;5;33;.868;3600000;0
3174;14335;747;83;44;3;41;.932;3542000;0
3174;190589;747;0;0;0;0;.00nan;0;0
3174;85281;749;0;0;0;0;.00nan;0;0
3174;86697;749;84;19;1;18;.947;3600000;0
3175;178114;752;0;0;0;0;.00nan;0;0
3175;43731;752;48;21;3;18;.857;3600000;0
3175;43971;742;74;43;4;39;.907;3550000;0
3175;52204;742;0;0;0;0;.00nan;0;0
3176;3756;748;100;38;1;37;.974;3600000;0
3176;-1;748;0;0;0;0;.00nan;0;0
3176;56565;741;72;33;3;30;.909;3534000;0
3176;57695;741;0;0;0;0;.00nan;0;0
3177;6570;3789;0;0;0;0;.00nan;0;0
3177;33480;3789;62;17;2;15;.882;3600000;0
3177;-1;733;0;0;0;0;.00nan;0;0
3177;85787;733;79;44;3;41;.932;3577000;0
3178;2643;739;40;22;4;18;.818;3600000;0
3178;178098;738;89;32;1;31;.969;3600000;0
3178;185442;738;0;0;0;0;.00nan;0;0
3178;186234;739;0;0;0;0;.00nan;0;0
3179;3508;745;90;26;1;25;.962;3600000;0
3179;180188;745;0;0;0;0;.00nan;0;0
3179;186235;751;0;0;0;0;.00nan;0;0
3179;-1;751;45;29;4;25;.862;3600000;0
3180;6079;734;0;0;0;0;.00nan;0;0
3180;44526;734;90;23;1;22;.957;3812000;0
3180;50065;729;0;0;0;0;.00nan;0;0
3180;93324;729;100;33;0;33;1.000;3812000;0
3181;1957;736;65;33;4;29;.879;3900000;0
3181;186219;736;0;0;0;0;.00nan;0;0
3181;192386;732;0;0;0;0;.00nan;0;0
3181;148788;732;35;19;4;15;.789;3900000;0
3182;178114;752;0;0;0;0;.00nan;0;0
3182;43731;752;50;36;5;31;.861;3568000;0
3182;76405;2168;76;35;3;32;.914;3600000;0
3182;85670;2168;0;0;0;0;.00nan;0;0
3183;175764;1880;0;0;0;0;.00nan;0;0
3183;185413;740;80;37;3;34;.919;3879000;0
3183;49900;1880;63;31;3;28;.903;3900000;0
3183;57107;740;0;0;0;0;.00nan;0;0
3184;6868;764;0;0;0;0;.00nan;0;0
3184;174898;764;99;50;2;48;.960;3600000;0
3184;43971;742;76;36;3;33;.917;3600000;0
3184;52204;742;0;0;0;0;.00nan;0;0
3185;14335;747;66;25;3;22;.880;3900000;0
3185;190589;747;0;0;0;0;.00nan;0;0
3185;85281;749;62;27;3;24;.889;3900000;0
3185;86697;749;0;0;0;0;.00nan;0;0
3186;3756;748;33;31;6;25;.806;3600000;0
3186;175764;1880;0;0;0;0;.00nan;0;0
3186;-1;748;0;0;0;0;.00nan;0;0
3186;49900;1880;100;25;0;25;1.000;3600000;0
3187;6079;734;0;0;0;0;.00nan;0;0
3187;44526;734;72;28;2;26;.929;3543000;0
3187;192386;732;0;0;0;0;.00nan;0;0
3187;148788;732;99;37;1;36;.973;3600000;0
3188;6868;764;0;0;0;0;.00nan;0;0
3188;178098;738;47;17;3;14;.824;3585000;0
3188;174898;764;68;24;2;22;.917;3600000;0
3188;185442;738;0;0;0;0;.00nan;0;0
3189;3508;745;0;0;0;0;.00nan;0;0
3189;180188;745;82;23;1;22;.957;3600000;0
3189;186235;751;0;0;0;0;.00nan;0;0
3189;-1;751;70;40;3;37;.925;3575000;0
3190;-1;733;0;0;0;0;.00nan;0;0
3190;50065;729;0;0;0;0;.00nan;0;0
3190;85787;733;85;35;1;34;.971;3692000;0
3190;93324;729;69;25;2;23;.920;3692000;0
3191;46792;743;0;0;0;0;.00nan;0;0
3191;76405;2168;88;28;1;27;.964;3600000;0
3191;85670;2168;0;0;0;0;.00nan;0;0
3191;148956;743;70;43;4;39;.907;3600000;0
3192;2643;739;70;20;1;19;.950;3600000;0
3192;185413;740;0;0;0;0;.00nan;0;0
3192;186234;739;0;0;0;0;.00nan;0;0
3192;57107;740;66;27;3;24;.889;3513000;0
3193;43971;742;100;38;1;37;.974;3600000;0
3193;52204;742;0;0;0;0;.00nan;0;0
3193;56565;741;0;0;0;0;.00nan;0;0
3193;57695;741;60;34;4;30;.882;3600000;0
3194;83;737;94;37;2;35;.946;3528000;0
3194;6868;764;93;17;0;17;1.000;3600000;0
3194;174898;764;0;0;0;0;.00nan;0;0
3194;190570;737;0;0;0;0;.00nan;0;0
3195;3928;744;83;27;1;26;.963;3600000;0
3195;14335;747;58;28;3;25;.893;3536000;0
3195;190589;747;0;0;0;0;.00nan;0;0
3195;64722;744;0;0;0;0;.00nan;0;0
3196;178114;752;0;0;0;0;.00nan;0;0
3196;43731;752;40;32;6;26;.813;3581000;0
3196;85281;749;45;26;4;22;.846;3600000;0
3196;86697;749;0;0;0;0;.00nan;0;0
3197;1957;736;73;49;5;44;.898;3600000;0
3197;6570;3789;55;20;2;18;.900;3600000;0
3197;33480;3789;0;0;0;0;.00nan;0;0
3197;186219;736;0;0;0;0;.00nan;0;0
3198;175764;1880;0;0;0;0;.00nan;0;0
3198;49900;1880;57;34;5;29;.853;3682000;0
3198;76405;2168;51;36;6;30;.833;3684000;0
3198;85670;2168;0;0;0;0;.00nan;0;0
3199;2643;739;98;24;0;24;1.000;3600000;0
3199;186234;739;0;0;0;0;.00nan;0;0
3199;50065;729;84;29;1;28;.966;3549000;0
3199;93324;729;0;0;0;0;.00nan;0;0
3200;185413;740;0;0;0;0;.00nan;0;0
3200;192386;732;0;0;0;0;.00nan;0;0
3200;57107;740;75;36;3;33;.917;3521000;0
3200;148788;732;82;26;1;25;.962;3600000;0
3201;178098;738;60;35;4;31;.886;3600000;0
3201;185442;738;0;0;0;0;.00nan;0;0
3201;46792;743;93;30;1;29;.967;3600000;0
3201;148956;743;0;0;0;0;.00nan;0;0
3202;186235;751;70;31;3;28;.903;3600000;0
3202;-1;751;0;0;0;0;.00nan;0;0
3202;56565;741;100;32;0;32;1.000;3600000;0
3202;57695;741;0;0;0;0;.00nan;0;0
3203;3756;748;81;30;2;28;.933;3900000;0
3203;3928;744;100;41;2;39;.951;3900000;0
3203;-1;748;0;0;0;0;.00nan;0;0
3203;64722;744;0;0;0;0;.00nan;0;0
3204;6079;734;0;0;0;0;.00nan;0;0
3204;44526;734;65;21;2;19;.905;3600000;0
3204;85281;749;0;0;0;0;.00nan;0;0
3204;86697;749;61;35;4;31;.886;3523000;0
3205;3508;745;71;21;2;19;.905;3600000;0
3205;180188;745;0;0;0;0;.00nan;0;0
3205;43971;742;65;39;4;35;.897;3592000;0
3205;52204;742;0;0;0;0;.00nan;0;0
3206;83;737;55;22;3;19;.864;3600000;0
3206;1957;736;100;34;0;34;1.000;3600000;0
3206;190570;737;0;0;0;0;.00nan;0;0
3206;186219;736;0;0;0;0;.00nan;0;0
3207;6570;3789;68;21;1;20;.952;3600000;0
3207;33480;3789;0;0;0;0;.00nan;0;0
3207;-1;733;0;0;0;0;.00nan;0;0
3207;85787;733;88;34;2;32;.941;3558000;0
3208;2643;739;99;35;1;34;.971;3600000;0
3208;178114;752;0;0;0;0;.00nan;0;0
3208;186234;739;0;0;0;0;.00nan;0;0
3208;43731;752;86;32;2;30;.938;3559000;0
3209;178098;738;0;0;0;0;.00nan;0;0
3209;185413;740;0;0;0;0;.00nan;0;0
3209;185442;738;91;32;1;31;.969;3600000;0
3209;57107;740;27;40;8;32;.800;3600000;0
3210;14335;747;84;23;1;22;.957;3600000;0
3210;190589;747;0;0;0;0;.00nan;0;0
3210;46792;743;84;45;3;42;.933;3600000;0
3210;148956;743;0;0;0;0;.00nan;0;0
3211;6079;734;0;0;0;0;.00nan;0;0
3211;6868;764;97;36;2;34;.944;3600000;0
3211;174898;764;0;0;0;0;.00nan;0;0
3211;44526;734;56;30;4;26;.867;3555000;0
3212;6570;3789;84;27;1;26;.963;3611000;0
3212;33480;3789;0;0;0;0;.00nan;0;0
3212;43971;742;85;33;2;31;.939;3611000;0
3212;52204;742;0;0;0;0;.00nan;0;0
3213;83;737;83;30;2;28;.933;3900000;0
3213;190570;737;0;0;0;0;.00nan;0;0
3213;50065;729;96;40;2;38;.950;3900000;0
3213;93324;729;0;0;0;0;.00nan;0;0
3214;3508;745;85;21;1;20;.952;3600000;0
3214;3928;744;74;34;3;31;.912;3517000;0
3214;180188;745;0;0;0;0;.00nan;0;0
3214;64722;744;0;0;0;0;.00nan;0;0
3215;1957;736;69;37;4;33;.892;3600000;0
3215;186219;736;0;0;0;0;.00nan;0;0
3215;192386;732;0;0;0;0;.00nan;0;0
3215;148788;732;99;35;1;34;.971;3600000;0
3216;3756;748;66;30;3;27;.900;3900000;0
3216;-1;748;0;0;0;0;.00nan;0;0
3216;186235;751;0;0;0;0;.00nan;0;0
3216;-1;751;78;30;3;27;.900;3900000;0
3217;175764;1880;0;0;0;0;.00nan;0;0
3217;49900;1880;87;41;2;39;.951;3593000;0
3217;85281;749;67;18;1;17;.944;3600000;0
3217;86697;749;0;0;0;0;.00nan;0;0
3218;2643;739;72;37;3;34;.919;3600000;0
3218;185413;740;0;0;0;0;.00nan;0;0
3218;186234;739;0;0;0;0;.00nan;0;0
3218;57107;740;100;30;0;30;1.000;3600000;0
3219;14335;747;0;0;0;0;.00nan;0;0
3219;190589;747;68;24;2;22;.917;3592000;0
3219;46792;743;91;30;1;29;.967;3600000;0
3219;148956;743;0;0;0;0;.00nan;0;0
3220;3928;744;65;21;2;19;.905;3600000;0
3220;56565;741;84;50;4;46;.920;3564000;0
3220;57695;741;0;0;0;0;.00nan;0;0
3220;64722;744;0;0;0;0;.00nan;0;0
3221;3756;748;93;39;2;37;.949;3600000;0
3221;-1;748;0;0;0;0;.00nan;0;0
3221;76405;2168;56;26;3;23;.885;3544000;0
3221;85670;2168;0;0;0;0;.00nan;0;0
3222;83;737;90;31;1;30;.968;3600000;0
3222;6079;734;0;0;0;0;.00nan;0;0
3222;190570;737;0;0;0;0;.00nan;0;0
3222;44526;734;83;26;2;24;.923;3600000;0
3223;1957;736;92;61;4;57;.934;3600000;0
3223;6570;3789;75;22;1;21;.955;3600000;0
3223;33480;3789;0;0;0;0;.00nan;0;0
3223;186219;736;0;0;0;0;.00nan;0;0
3224;3508;745;100;27;0;27;1.000;3600000;0
3224;178098;738;82;53;5;48;.906;3600000;0
3224;180188;745;0;0;0;0;.00nan;0;0
3224;185442;738;0;0;0;0;.00nan;0;0
3225;192386;732;0;0;0;0;.00nan;0;0
3225;50065;729;98;56;5;51;.911;3600000;0
3225;93324;729;0;0;0;0;.00nan;0;0
3225;148788;732;39;19;4;15;.789;3600000;0
3226;6868;764;0;0;0;0;.00nan;0;0
3226;174898;764;95;37;2;35;.946;3900000;0
3226;186235;751;73;27;2;25;.926;3900000;0
3226;-1;751;0;0;0;0;.00nan;0;0
3227;178114;752;0;0;0;0;.00nan;0;0
3227;175764;1880;0;0;0;0;.00nan;0;0
3227;43731;752;69;35;3;32;.914;3600000;0
3227;49900;1880;97;28;0;28;1.000;3600000;0
3228;-1;733;0;0;0;0;.00nan;0;0
3228;43971;742;85;15;0;15;1.000;3600000;0
3228;52204;742;0;0;0;0;.00nan;0;0
3228;85787;733;55;37;4;33;.892;3600000;0
3229;46792;743;99;48;2;46;.958;3600000;0
3229;85281;749;62;30;5;25;.833;3600000;0
3229;86697;749;0;0;0;0;.00nan;0;0
3229;148956;743;0;0;0;0;.00nan;0;0
3230;178114;752;0;0;0;0;.00nan;0;0
3230;43731;752;77;30;2;28;.933;3600000;0
3230;56565;741;65;34;3;31;.912;3579000;0
3230;57695;741;0;0;0;0;.00nan;0;0
3231;6868;764;64;43;5;38;.884;3600000;0
3231;174898;764;0;0;0;0;.00nan;0;0
3231;76405;2168;88;20;0;20;1.000;3600000;0
3231;85670;2168;0;0;0;0;.00nan;0;0
3232;2643;739;93;44;2;42;.955;3565000;0
3232;6079;734;0;0;0;0;.00nan;0;0
3232;186234;739;0;0;0;0;.00nan;0;0
3232;44526;734;68;20;1;19;.950;3600000;0
3233;3508;745;88;25;1;24;.960;3600000;0
3233;3756;748;91;46;2;44;.957;3600000;0
3233;180188;745;0;0;0;0;.00nan;0;0
3233;88646;748;0;0;0;0;.00nan;0;0
3234;178098;738;68;35;4;31;.886;3600000;0
3234;185442;738;0;0;0;0;.00nan;0;0
3234;50065;729;100;39;1;38;.974;3600000;0
3234;93324;729;0;0;0;0;.00nan;0;0
3235;83;737;82;28;1;27;.964;3600000;0
3235;3928;744;76;28;2;26;.929;3548000;0
3235;190570;737;0;0;0;0;.00nan;0;0
3235;64722;744;0;0;0;0;.00nan;0;0
3236;185413;740;0;0;0;0;.00nan;0;0
3236;43971;742;83;32;2;30;.938;3600000;0
3236;52204;742;0;0;0;0;.00nan;0;0
3236;57107;740;43;25;4;21;.840;3560000;0
3237;6570;3789;48;33;5;28;.848;3600000;0
3237;175764;1880;0;0;0;0;.00nan;0;0
3237;33480;3789;0;0;0;0;.00nan;0;0
3237;49900;1880;92;40;1;39;.975;3600000;0
3238;1957;736;85;33;2;31;.939;3600000;0
3238;-1;733;0;0;0;0;.00nan;0;0
3238;186219;736;0;0;0;0;.00nan;0;0
3238;85787;733;51;24;3;21;.875;3549000;0
3239;46792;743;0;0;0;0;.00nan;0;0
3239;85281;749;0;0;0;0;.00nan;0;0
3239;86697;749;63;27;3;24;.889;3900000;0
3239;148956;743;96;57;3;54;.947;3900000;0
3240;3756;748;0;0;0;0;.00nan;0;0
3240;178114;752;0;0;0;0;.00nan;0;0
3240;43731;752;56;30;4;26;.867;3578000;0
3240;88646;748;70;29;3;26;.897;3600000;0
3241;6079;734;0;0;0;0;.00nan;0;0
3241;14335;747;100;31;1;30;.968;3900000;0
3241;190589;747;0;0;0;0;.00nan;0;0
3241;44526;734;90;31;1;30;.968;3900000;0
3242;50065;729;60;42;6;36;.857;2669000;0
3242;76405;2168;76;34;3;31;.912;3600000;0
3242;85670;2168;0;0;0;0;.00nan;0;0
3242;93324;729;50;3;0;3;1.000;931000;0
3243;186235;751;0;0;0;0;.00nan;0;0
3243;-1;751;69;39;3;36;.923;3600000;0
3243;85281;749;81;29;2;27;.931;3600000;0
3243;86697;749;0;0;0;0;.00nan;0;0
3244;185413;740;0;0;0;0;.00nan;0;0
3244;-1;733;0;0;0;0;.00nan;0;0
3244;57107;740;77;36;3;33;.917;3600000;0
3244;85787;733;59;38;4;34;.895;3557000;0
3245;3928;744;63;35;5;30;.857;3600000;0
3245;175764;1880;0;0;0;0;.00nan;0;0
3245;49900;1880;75;24;1;23;.958;3600000;0
3245;64722;744;0;0;0;0;.00nan;0;0
3246;6868;764;0;0;0;0;.00nan;0;0
3246;174898;764;85;30;2;28;.933;3546000;0
3246;43971;742;99;40;1;39;.975;3600000;0
3246;52204;742;0;0;0;0;.00nan;0;0
3247;83;737;58;32;5;27;.844;3600000;0
3247;190570;737;0;0;0;0;.00nan;0;0
3247;192386;732;0;0;0;0;.00nan;0;0
3247;148788;732;99;34;1;33;.971;3600000;0
3248;3508;745;73;33;3;30;.909;3900000;0
3248;180188;745;0;0;0;0;.00nan;0;0
3248;81085;743;73;42;3;39;.929;3900000;0
3248;148956;743;0;0;0;0;.00nan;0;0
3249;56565;741;73;41;4;37;.902;3600000;0
3249;57695;741;0;0;0;0;.00nan;0;0
3249;85281;749;0;0;0;0;.00nan;0;0
3249;86697;749;44;29;5;24;.828;3556000;0
3250;6079;734;0;0;0;0;.00nan;0;0
3250;-1;733;52;3;0;3;1.000;334000;0
3250;44526;734;64;16;1;15;.938;3600000;0
3250;85787;733;67;56;6;50;.893;3266000;0
3251;1957;736;100;40;1;39;.975;3600000;0
3251;186219;736;0;0;0;0;.00nan;0;0
3251;186234;739;48;26;4;22;.846;3600000;0
3251;46792;739;0;0;0;0;.00nan;0;0
3252;6570;3789;94;33;1;32;.970;3600000;0
3252;14335;747;41;37;6;31;.838;3080000;0
3252;33480;3789;0;0;0;0;.00nan;0;0
3252;196698;747;44;4;1;3;.750;520000;0
3253;3928;744;48;26;5;21;.808;3765000;0
3253;64722;744;0;0;0;0;.00nan;0;0
3253;81085;743;0;0;0;0;.00nan;0;0
3253;148956;743;78;43;4;39;.907;3765000;0
3254;178114;752;0;0;0;0;.00nan;0;0
3254;186235;751;86;27;1;26;.963;3600000;0
3254;-1;751;0;0;0;0;.00nan;0;0
3254;43731;752;63;34;4;30;.882;3600000;0
3255;185413;740;0;0;0;0;.00nan;0;0
3255;50065;729;74;44;5;39;.886;3517000;0
3255;57107;740;74;36;3;33;.917;3600000;0
3255;93324;729;0;0;0;0;.00nan;0;0
3256;175764;1880;0;0;0;0;.00nan;0;0
3256;43971;742;70;35;3;32;.914;3576000;0
3256;49900;1880;87;30;1;29;.967;3600000;0
3256;52204;742;0;0;0;0;.00nan;0;0
3257;6868;764;0;0;0;0;.00nan;0;0
3257;174898;764;79;36;3;33;.917;3690000;0
3257;76405;2168;67;37;4;33;.892;3690000;0
3257;85670;2168;0;0;0;0;.00nan;0;0
3258;3508;745;66;34;4;30;.882;3520000;0
3258;3756;748;0;0;0;0;.00nan;0;0
3258;180188;745;0;0;0;0;.00nan;0;0
3258;88646;748;84;42;2;40;.952;3600000;0
3259;83;737;60;30;3;27;.900;3600000;0
3259;178098;738;74;27;2;25;.926;3600000;0
3259;190570;737;0;0;0;0;.00nan;0;0
3259;185442;738;0;0;0;0;.00nan;0;0
3260;43971;742;58;37;5;32;.865;3600000;0
3260;52204;742;0;0;0;0;.00nan;0;0
3260;56565;741;0;0;0;0;.00nan;0;0
3260;57695;741;92;31;1;30;.968;3600000;0
3261;6079;734;0;0;0;0;.00nan;0;0
3261;175764;1880;0;0;0;0;.00nan;0;0
3261;44526;734;77;35;3;32;.914;3600000;0
3261;49900;1880;68;37;4;33;.892;3546000;0
3262;83;737;0;0;0;0;.00nan;0;0
3262;190570;737;78;28;2;26;.929;3600000;0
3262;186234;739;0;0;0;0;.00nan;0;0
3262;46792;739;71;16;1;15;.938;3600000;0
3263;1957;736;100;41;1;40;.976;3600000;0
3263;178098;738;0;0;0;0;.00nan;0;0
3263;185442;738;60;20;2;18;.900;3600000;0
3263;186219;736;0;0;0;0;.00nan;0;0
3264;6570;3789;86;28;1;27;.964;3600000;0
3264;33480;3789;0;0;0;0;.00nan;0;0
3264;192386;732;0;0;0;0;.00nan;0;0
3264;148788;732;95;47;2;45;.957;3600000;0
3265;178114;752;25;6;3;3;.500;491000;0
3265;43731;752;66;36;4;32;.889;3109000;0
3265;76405;2168;99;41;1;40;.976;3600000;0
3265;85670;2168;0;0;0;0;.00nan;0;0
3266;3928;744;87;42;3;39;.929;3529000;0
3266;185413;740;0;0;0;0;.00nan;0;0
3266;57107;740;100;40;1;39;.975;3600000;0
3266;64722;744;0;0;0;0;.00nan;0;0
3267;6868;764;0;0;0;0;.00nan;0;0
3267;174898;764;81;25;1;24;.960;3600000;0
3267;50065;729;97;41;2;39;.951;3558000;0
3267;93324;729;0;0;0;0;.00nan;0;0
3268;-1;733;0;0;0;0;.00nan;0;0
3268;81085;743;0;0;0;0;.00nan;0;0
3268;85787;733;90;33;2;31;.939;3566000;0
3268;148956;743;83;23;1;22;.957;3600000;0
3269;14335;747;73;31;3;28;.903;3561000;0
3269;196698;747;0;0;0;0;.00nan;0;0
3269;186235;751;0;0;0;0;.00nan;0;0
3269;-1;751;78;31;2;29;.935;3600000;0
3270;3756;748;0;0;0;0;.00nan;0;0
3270;85281;749;0;0;0;0;.00nan;0;0
3270;86697;749;76;32;3;29;.906;3600000;0
3270;88646;748;74;36;4;32;.889;3550000;0
3271;56565;741;0;0;0;0;.00nan;0;0
3271;57695;741;60;32;4;28;.875;3600000;0
3271;76405;2168;92;30;1;29;.967;3600000;0
3271;85670;2168;0;0;0;0;.00nan;0;0
3272;186234;739;0;0;0;0;.00nan;0;0
3272;192386;732;0;0;0;0;.00nan;0;0
3272;46792;739;100;25;0;25;1.000;3600000;0
3272;148788;732;84;35;2;33;.943;3568000;0
3273;1957;736;89;41;2;39;.951;3900000;0
3273;6570;3789;69;26;2;24;.923;3900000;0
3273;33480;3789;0;0;0;0;.00nan;0;0
3273;186219;736;0;0;0;0;.00nan;0;0
3274;9559;738;0;0;0;0;.00nan;0;0
3274;178098;738;89;35;2;33;.943;3600000;0
3274;175764;1880;0;0;0;0;.00nan;0;0
3274;49900;1880;81;24;1;23;.958;3600000;0
3275;3508;745;81;31;2;29;.935;3600000;0
3275;180188;745;0;0;0;0;.00nan;0;0
3275;43971;742;72;41;4;37;.902;3600000;0
3275;52204;742;0;0;0;0;.00nan;0;0
3276;3928;744;47;27;4;23;.852;3565000;0
3276;-1;744;0;0;0;0;.00nan;0;0
3276;50065;729;78;38;3;35;.921;3600000;0
3276;93324;729;0;0;0;0;.00nan;0;0
3277;83;737;65;24;2;22;.917;3600000;0
3277;178114;752;0;0;0;0;.00nan;0;0
3277;-1;737;0;0;0;0;.00nan;0;0
3277;43731;752;48;21;3;18;.857;3600000;0
3278;6868;764;0;0;0;0;.00nan;0;0
3278;174898;764;78;27;2;25;.926;3703000;0
3278;81085;743;88;41;3;38;.927;3703000;0
3278;148956;743;0;0;0;0;.00nan;0;0
3279;14335;747;68;22;1;21;.955;3900000;0
3279;196698;747;0;0;0;0;.00nan;0;0
3279;186235;751;82;29;1;28;.966;3900000;0
3279;-1;751;0;0;0;0;.00nan;0;0
3280;185413;740;0;0;0;0;.00nan;0;0
3280;57107;740;50;31;5;26;.839;3600000;0
3280;67294;733;0;0;0;0;.00nan;0;0
3280;85787;733;95;32;1;31;.969;3600000;0
3281;3756;748;0;0;0;0;.00nan;0;0
3281;85281;749;100;37;2;35;.946;3900000;0
3281;86697;749;0;0;0;0;.00nan;0;0
3281;88646;748;96;43;2;41;.953;3900000;0
3282;9559;738;0;0;0;0;.00nan;0;0
3282;178098;738;57;32;4;28;.875;3529000;0
3282;186234;739;0;0;0;0;.00nan;0;0
3282;46792;739;88;40;2;38;.950;3600000;0
3283;3199;732;0;0;0;0;.00nan;0;0
3283;6570;3789;64;22;2;20;.909;3544000;0
3283;33480;3789;0;0;0;0;.00nan;0;0
3283;148788;732;100;38;1;37;.974;3600000;0
3284;3508;745;78;19;1;18;.947;3600000;0
3284;192386;745;0;0;0;0;.00nan;0;0
3284;50065;729;62;29;3;26;.897;3560000;0
3284;93324;729;0;0;0;0;.00nan;0;0
3285;3928;744;0;0;0;0;.00nan;0;0
3285;-1;744;79;45;3;42;.933;3900000;0
3285;49900;1880;64;29;3;26;.897;3900000;0
3285;61276;1880;0;0;0;0;.00nan;0;0
3286;83;737;80;30;2;28;.933;3581000;0
3286;6079;734;0;0;0;0;.00nan;0;0
3286;-1;737;0;0;0;0;.00nan;0;0
3286;44526;734;58;11;1;10;.909;3600000;0
3287;3756;748;0;0;0;0;.00nan;0;0
3287;14335;747;86;36;2;34;.944;3803000;0
3287;196698;747;0;0;0;0;.00nan;0;0
3287;88646;748;73;30;3;27;.900;3803000;0
3288;178114;752;0;0;0;0;.00nan;0;0
3288;175764;743;0;0;0;0;.00nan;0;0
3288;43731;752;73;31;2;29;.935;3600000;0
3288;148956;743;52;25;3;22;.880;3556000;0
3289;185413;740;0;0;0;0;.00nan;0;0
3289;186219;736;70;44;4;40;.909;3900000;0
3289;52204;736;0;0;0;0;.00nan;0;0
3289;57107;740;61;32;4;28;.875;3900000;0
3290;174898;764;0;0;0;0;.00nan;0;0
3290;56565;741;76;23;1;22;.957;3600000;0
3290;57695;741;0;0;0;0;.00nan;0;0
3290;81085;764;69;26;2;24;.923;3600000;0
3291;186235;751;0;0;0;0;.00nan;0;0
3291;-1;751;76;47;4;43;.915;3559000;0
3291;85281;749;0;0;0;0;.00nan;0;0
3291;86697;749;52;19;3;16;.842;3600000;0
3292;3199;732;0;0;0;0;.00nan;0;0
3292;9559;738;0;0;0;0;.00nan;0;0
3292;178098;738;59;30;3;27;.900;3530000;0
3292;148788;732;100;39;1;38;.974;3600000;0
3293;3756;748;0;0;0;0;.00nan;0;0
3293;14335;747;43;41;7;34;.829;3900000;0
3293;196698;747;0;0;0;0;.00nan;0;0
3293;88646;748;50;47;7;40;.851;3900000;0
3294;3508;745;50;21;3;18;.857;3600000;0
3294;43971;742;74;38;4;34;.895;3585000;0
3294;192386;745;0;0;0;0;.00nan;0;0
3294;158276;742;0;0;0;0;.00nan;0;0
3295;6079;734;0;0;0;0;.00nan;0;0
3295;185413;740;0;0;0;0;.00nan;0;0
3295;44526;734;47;20;3;17;.850;3600000;0
3295;57107;740;75;54;5;49;.907;3595000;0
3296;6570;3789;83;26;1;25;.962;3600000;0
3296;174898;764;0;0;0;0;.00nan;0;0
3296;33480;3789;0;0;0;0;.00nan;0;0
3296;81085;764;41;28;5;23;.821;3600000;0
3297;83;737;94;39;1;38;.974;3619000;0
3297;178114;752;0;0;0;0;.00nan;0;0
3297;-1;737;0;0;0;0;.00nan;0;0
3297;43731;752;96;19;0;19;1.000;3619000;0
3298;1957;729;59;23;2;21;.913;3600000;0
3298;67294;733;0;0;0;0;.00nan;0;0
3298;85787;733;55;40;5;35;.875;3600000;0
3298;93324;729;0;0;0;0;.00nan;0;0
3299;175764;743;70;27;2;25;.926;3600000;0
3299;56565;741;48;20;3;17;.850;3550000;0
3299;57695;741;0;0;0;0;.00nan;0;0
3299;148956;743;0;0;0;0;.00nan;0;0
3300;3928;744;82;20;1;19;.950;3600000;0
3300;-1;744;0;0;0;0;.00nan;0;0
3300;186219;736;0;0;0;0;.00nan;0;0
3300;52204;736;84;32;2;30;.938;3575000;0
3301;186235;751;25;6;3;3;.500;400000;0
3301;-1;751;60;33;4;29;.879;3200000;0
3301;85281;749;84;31;1;30;.968;3600000;0
3301;86697;749;0;0;0;0;.00nan;0;0
3302;3508;745;82;36;3;33;.917;3600000;0
3302;192386;745;0;0;0;0;.00nan;0;0
3302;76405;2168;77;46;4;42;.913;3545000;0
3302;85670;2168;0;0;0;0;.00nan;0;0
3303;186234;739;0;0;0;0;.00nan;0;0
3303;43971;742;72;33;3;30;.909;3567000;0
3303;46792;739;100;37;1;36;.973;3600000;0
3303;158276;742;0;0;0;0;.00nan;0;0
3304;178114;752;0;0;0;0;.00nan;0;0
3304;43731;752;94;34;1;33;.971;3600000;0
3304;76405;2168;0;0;0;0;.00nan;0;0
3304;85670;2168;88;43;2;41;.953;3557000;0
3305;83;737;64;33;4;29;.879;3549000;0
3305;6570;3789;0;0;0;0;.00nan;0;0
3305;33480;3789;51;21;3;18;.857;3600000;0
3305;-1;737;0;0;0;0;.00nan;0;0
3306;175764;743;63;23;2;21;.913;3574000;0
3306;180188;743;0;0;0;0;.00nan;0;0
3306;50065;729;100;33;0;33;1.000;3600000;0
3306;93324;729;0;0;0;0;.00nan;0;0
3307;3199;732;91;40;1;39;.975;2966000;0
3307;3928;744;100;39;2;37;.949;3600000;0
3307;-1;744;0;0;0;0;.00nan;0;0
3307;148788;732;27;8;3;5;.625;593000;0
3308;49900;1880;53;35;4;31;.886;3559000;0
3308;56565;741;67;27;3;24;.889;3600000;0
3308;57695;741;0;0;0;0;.00nan;0;0
3308;61276;1880;0;0;0;0;.00nan;0;0
3309;186219;736;0;0;0;0;.00nan;0;0
3309;52204;736;100;38;1;37;.974;3600000;0
3309;67294;733;0;0;0;0;.00nan;0;0
3309;85787;733;72;46;6;40;.870;3600000;0
3310;3756;748;0;0;0;0;.00nan;0;0
3310;186234;739;0;0;0;0;.00nan;0;0
3310;46792;739;85;29;1;28;.966;3600000;0
3310;88646;748;40;30;5;25;.833;3600000;0
3311;83;737;69;37;4;33;.892;3600000;0
3311;6570;3789;75;21;1;20;.952;3600000;0
3311;33480;3789;0;0;0;0;.00nan;0;0
3311;-1;737;0;0;0;0;.00nan;0;0
3312;14335;747;100;29;0;29;1.000;3600000;0
3312;185413;740;0;0;0;0;.00nan;0;0
3312;196698;747;0;0;0;0;.00nan;0;0
3312;57107;740;73;37;3;34;.919;3600000;0
3313;6079;734;0;0;0;0;.00nan;0;0
3313;174898;764;0;0;0;0;.00nan;0;0
3313;44526;734;90;34;1;33;.971;3900000;0
3313;81085;764;92;33;1;32;.970;3900000;0
3314;43971;742;70;43;4;39;.907;3583000;0
3314;85281;749;100;44;2;42;.955;3600000;0
3314;86697;749;0;0;0;0;.00nan;0;0
3314;158276;742;0;0;0;0;.00nan;0;0
3315;3508;745;61;36;5;31;.861;3600000;0
3315;192386;745;0;0;0;0;.00nan;0;0
3315;56565;741;84;30;1;29;.967;3600000;0
3315;57695;741;0;0;0;0;.00nan;0;0
3316;9559;738;60;18;2;16;.889;3552000;0
3316;178098;738;0;0;0;0;.00nan;0;0
3316;175764;743;90;34;1;33;.971;3600000;0
3316;180188;743;0;0;0;0;.00nan;0;0
3317;3199;732;0;0;0;0;.00nan;0;0
3317;67294;733;0;0;0;0;.00nan;0;0
3317;85787;733;48;28;5;23;.821;3600000;0
3317;148788;732;72;30;2;28;.933;3600000;0
3318;178114;752;0;0;0;0;.00nan;0;0
3318;186235;751;0;0;0;0;.00nan;0;0
3318;-1;751;76;37;3;34;.919;3600000;0
3318;43731;752;100;34;0;34;1.000;3600000;0
3319;186234;739;0;0;0;0;.00nan;0;0
3319;46792;739;40;33;6;27;.818;3600000;0
3319;76405;2168;68;28;3;25;.893;3600000;0
3319;85670;2168;0;0;0;0;.00nan;0;0
3320;14335;747;72;33;3;30;.909;3590000;0
3320;196698;747;0;0;0;0;.00nan;0;0
3320;50065;729;68;30;2;28;.933;3600000;0
3320;93324;729;0;0;0;0;.00nan;0;0
3321;3928;744;99;38;1;37;.974;3600000;0
3321;-1;744;0;0;0;0;.00nan;0;0
3321;85281;749;0;0;0;0;.00nan;0;0
3321;86697;749;47;37;6;31;.838;3600000;0
3322;83;737;58;41;6;35;.854;3600000;0
3322;190570;737;0;0;0;0;.00nan;0;0
3322;185413;740;0;0;0;0;.00nan;0;0
3322;57107;740;74;27;2;25;.926;3600000;0
3323;174898;764;0;0;0;0;.00nan;0;0
3323;186219;736;0;0;0;0;.00nan;0;0
3323;52204;736;69;60;6;54;.900;3600000;0
3323;81085;764;63;21;2;19;.905;3600000;0
3324;6079;734;0;0;0;0;.00nan;0;0
3324;43971;742;67;41;5;36;.878;3600000;0
3324;44526;734;82;42;3;39;.929;3600000;0
3324;158276;742;0;0;0;0;.00nan;0;0
3325;6570;3789;53;26;4;22;.846;3650000;0
3325;178098;738;82;36;3;33;.917;3650000;0
3325;33480;3789;0;0;0;0;.00nan;0;0
3325;185442;738;0;0;0;0;.00nan;0;0
3326;3508;745;75;19;2;17;.895;3900000;0
3326;192386;745;0;0;0;0;.00nan;0;0
3326;67294;733;0;0;0;0;.00nan;0;0
3326;85787;733;97;46;2;44;.957;3900000;0
3327;186219;736;0;0;0;0;.00nan;0;0
3327;52204;736;64;32;3;29;.906;3600000;0
3327;56565;741;85;31;2;29;.935;3600000;0
3327;57695;741;0;0;0;0;.00nan;0;0
3328;3756;748;0;0;0;0;.00nan;0;0
3328;50065;729;100;42;0;42;1.000;3900000;0
3328;88646;748;97;34;0;34;1.000;3900000;0
3328;93324;729;0;0;0;0;.00nan;0;0
3329;3928;744;93;28;1;27;.964;3600000;0
3329;6079;734;0;0;0;0;.00nan;0;0
3329;-1;744;0;0;0;0;.00nan;0;0
3329;44526;734;48;26;3;23;.885;3556000;0
3330;3199;732;0;0;0;0;.00nan;0;0
3330;186234;739;0;0;0;0;.00nan;0;0
3330;46792;739;87;46;3;43;.935;3534000;0
3330;148788;732;75;26;1;25;.962;3600000;0
3331;175764;743;77;36;2;34;.944;3600000;0
3331;180188;743;0;0;0;0;.00nan;0;0
3331;85281;749;48;30;5;25;.833;3600000;0
3331;86697;749;0;0;0;0;.00nan;0;0
3332;178114;752;0;0;0;0;.00nan;0;0
3332;14335;747;100;41;1;40;.976;3600000;0
3332;196698;747;0;0;0;0;.00nan;0;0
3332;43731;752;89;35;2;33;.943;3600000;0
3333;43971;742;53;38;6;32;.842;3306000;0
3333;76405;2168;93;29;1;28;.966;3600000;0
3333;85670;2168;0;0;0;0;.00nan;0;0
3333;158276;742;57;5;0;5;1.000;294000;0
3334;3508;745;94;39;2;37;.949;3836000;0
3334;192386;745;0;0;0;0;.00nan;0;0
3334;49900;1880;88;29;1;28;.966;3836000;0
3334;61276;1880;0;0;0;0;.00nan;0;0
3335;6570;3789;60;30;4;26;.867;3600000;0
3335;33480;3789;0;0;0;0;.00nan;0;0
3335;185413;740;0;0;0;0;.00nan;0;0
3335;57107;740;100;51;0;51;1.000;3600000;0
3336;174898;764;0;0;0;0;.00nan;0;0
3336;186235;751;0;0;0;0;.00nan;0;0
3336;-1;751;38;21;5;16;.762;3900000;0
3336;81085;764;57;44;5;39;.886;3900000;0
3337;3756;748;0;0;0;0;.00nan;0;0
3337;6079;734;100;29;0;29;1.000;3600000;0
3337;44526;734;0;0;0;0;.00nan;0;0
3337;88646;748;77;27;2;25;.926;3580000;0
3338;178098;738;74;27;2;25;.926;3600000;0
3338;185442;738;0;0;0;0;.00nan;0;0
3338;186219;736;0;0;0;0;.00nan;0;0
3338;52204;736;47;47;6;41;.872;3600000;0
3339;6570;3789;42;30;5;25;.833;3572000;0
3339;33480;3789;0;0;0;0;.00nan;0;0
3339;186234;739;0;0;0;0;.00nan;0;0
3339;46792;739;79;42;4;38;.905;3600000;0
3340;178114;752;0;0;0;0;.00nan;0;0
3340;14335;747;88;32;2;30;.938;3900000;0
3340;196698;747;0;0;0;0;.00nan;0;0
3340;43731;752;85;34;2;32;.941;3900000;0
3341;49900;1880;67;33;3;30;.909;3900000;0
3341;50065;729;83;43;3;40;.930;3900000;0
3341;61276;1880;0;0;0;0;.00nan;0;0
3341;93324;729;0;0;0;0;.00nan;0;0
3342;3199;732;0;0;0;0;.00nan;0;0
3342;175764;743;74;33;2;31;.939;3574000;0
3342;180188;743;0;0;0;0;.00nan;0;0
3342;148788;732;100;37;1;36;.973;3600000;0
3343;185413;740;0;0;0;0;.00nan;0;0
3343;57107;740;89;40;2;38;.950;3569000;0
3343;76405;2168;99;39;1;38;.974;3600000;0
3343;85670;2168;0;0;0;0;.00nan;0;0
3344;186235;751;77;27;2;25;.926;3600000;0
3344;-1;751;0;0;0;0;.00nan;0;0
3344;67294;733;0;0;0;0;.00nan;0;0
3344;85787;733;85;42;3;39;.929;3587000;0
3345;3928;744;71;49;5;44;.898;3532000;0
3345;-1;744;0;0;0;0;.00nan;0;0
3345;85281;749;66;32;3;29;.906;3600000;0
3345;86697;749;0;0;0;0;.00nan;0;0
3346;43971;742;94;29;1;28;.966;3600000;0
3346;56565;741;66;40;4;36;.900;3600000;0
3346;57695;741;0;0;0;0;.00nan;0;0
3346;158276;742;0;0;0;0;.00nan;0;0
3347;83;737;37;21;4;17;.810;3600000;0
3347;178098;738;0;0;0;0;.00nan;0;0
3347;190570;737;0;0;0;0;.00nan;0;0
3347;185442;738;89;29;1;28;.966;3600000;0
3348;3756;748;0;0;0;0;.00nan;0;0
3348;56565;741;59;25;4;21;.840;3900000;0
3348;57695;741;0;0;0;0;.00nan;0;0
3348;88646;748;66;38;4;34;.895;3900000;0
3349;6079;734;89;24;1;23;.958;3600000;0
3349;186235;751;0;0;0;0;.00nan;0;0
3349;-1;751;43;47;7;40;.851;3600000;0
3349;44526;734;0;0;0;0;.00nan;0;0
3350;178114;752;0;0;0;0;.00nan;0;0
3350;14335;747;57;28;4;24;.857;3900000;0
3350;196698;747;0;0;0;0;.00nan;0;0
3350;43731;752;66;42;4;38;.905;3900000;0
3351;3508;745;0;0;0;0;.00nan;0;0
3351;192386;745;75;21;2;19;.905;3600000;0
3351;76405;2168;80;54;6;48;.889;3600000;0
3351;85670;2168;0;0;0;0;.00nan;0;0
3352;6570;3789;86;25;1;24;.960;3600000;0
3352;33480;3789;0;0;0;0;.00nan;0;0
3352;50065;729;67;36;3;33;.917;3535000;0
3352;93324;729;0;0;0;0;.00nan;0;0
3353;174898;764;0;0;0;0;.00nan;0;0
3353;175764;743;66;26;2;24;.923;3579000;0
3353;180188;743;0;0;0;0;.00nan;0;0
3353;81085;764;99;43;1;42;.977;3600000;0
3354;185413;740;0;0;0;0;.00nan;0;0
3354;186234;739;0;0;0;0;.00nan;0;0
3354;46792;739;71;28;2;26;.929;3586000;0
3354;57107;740;99;45;1;44;.978;3600000;0
3355;49900;1880;84;27;2;25;.926;3900000;0
3355;61276;1880;0;0;0;0;.00nan;0;0
3355;67294;733;0;0;0;0;.00nan;0;0
3355;85787;733;61;25;2;23;.920;3900000;0
3356;3928;744;74;57;8;49;.860;3600000;0
3356;-1;744;0;0;0;0;.00nan;0;0
3356;85281;749;0;0;0;0;.00nan;0;0
3356;86697;749;64;17;1;16;.941;3600000;0
3357;3199;732;0;0;0;0;.00nan;0;0
3357;43971;742;94;21;0;21;1.000;3600000;0
3357;148788;732;94;32;2;30;.938;3531000;0
3357;158276;742;0;0;0;0;.00nan;0;0
3358;178098;738;82;21;1;20;.952;3600000;0
3358;185442;738;0;0;0;0;.00nan;0;0
3358;186219;736;0;0;0;0;.00nan;0;0
3358;52204;736;84;37;2;35;.946;3600000;0
3359;3756;748;0;0;0;0;.00nan;0;0
3359;174898;764;0;0;0;0;.00nan;0;0
3359;81085;764;89;32;2;30;.938;3582000;0
3359;88646;748;90;20;0;20;1.000;3600000;0
3360;56565;741;23;12;4;8;.667;528000;0
3360;57695;741;63;27;3;24;.889;3072000;0
3360;76405;2168;82;37;3;34;.919;3600000;0
3360;85670;2168;0;0;0;0;.00nan;0;0
3361;6079;734;41;2;1;1;.500;293000;0
3361;186234;739;0;0;0;0;.00nan;0;0
3361;44526;734;35;33;6;27;.818;3307000;0
3361;46792;739;99;32;1;31;.969;3600000;0
3362;6570;3789;68;24;2;22;.917;3600000;0
3362;33480;3789;0;0;0;0;.00nan;0;0
3362;186235;751;0;0;0;0;.00nan;0;0
3362;-1;751;31;29;6;23;.793;3600000;0
3363;3928;744;92;32;1;31;.969;3849000;0
3363;14335;747;94;44;2;42;.955;3849000;0
3363;-1;744;0;0;0;0;.00nan;0;0
3363;196698;747;0;0;0;0;.00nan;0;0
3364;3508;745;88;27;1;26;.963;3600000;0
3364;175764;743;89;48;3;45;.938;3586000;0
3364;180188;743;0;0;0;0;.00nan;0;0
3364;192386;745;0;0;0;0;.00nan;0;0
3365;83;737;92;36;2;34;.944;3600000;0
3365;190570;737;0;0;0;0;.00nan;0;0
3365;49900;1880;72;32;3;29;.906;3562000;0
3365;61276;1880;0;0;0;0;.00nan;0;0
3366;178114;752;63;12;0;12;1.000;1621000;0
3366;43731;752;17;24;6;18;.750;1979000;0
3366;85281;749;0;0;0;0;.00nan;0;0
3366;86697;749;69;29;3;26;.897;3600000;0
3367;178098;738;0;0;0;0;.00nan;0;0
3367;185442;738;89;26;1;25;.962;3600000;0
3367;67294;733;0;0;0;0;.00nan;0;0
3367;85787;733;60;38;5;33;.868;3600000;0
3368;3928;744;81;32;2;30;.938;3559000;0
3368;14335;747;93;31;1;30;.968;3600000;0
3368;-1;744;0;0;0;0;.00nan;0;0
3368;196698;747;0;0;0;0;.00nan;0;0
3369;185413;740;0;0;0;0;.00nan;0;0
3369;50065;729;97;44;2;42;.955;3533000;0
3369;57107;740;100;31;0;31;1.000;3600000;0
3369;93324;729;0;0;0;0;.00nan;0;0
3370;83;737;82;40;2;38;.950;3600000;0
3370;190570;737;0;0;0;0;.00nan;0;0
3370;49900;1880;66;15;1;14;.933;3600000;0
3370;61276;1880;0;0;0;0;.00nan;0;0
3371;3199;732;0;0;0;0;.00nan;0;0
3371;186219;736;0;0;0;0;.00nan;0;0
3371;52204;736;75;52;5;47;.904;3600000;0
3371;148788;732;66;22;2;20;.909;3600000;0
3372;178114;752;0;0;0;0;.00nan;0;0
3372;43731;752;75;30;2;28;.933;3600000;0
3372;85281;749;63;42;6;36;.857;3600000;0
3372;86697;749;0;0;0;0;.00nan;0;0
3373;3508;745;69;33;3;30;.909;3567000;0
3373;175764;743;85;41;2;39;.951;3600000;0
3373;180188;743;0;0;0;0;.00nan;0;0
3373;192386;745;0;0;0;0;.00nan;0;0
3374;186235;751;90;36;1;35;.972;3818000;0
3374;-1;751;0;0;0;0;.00nan;0;0
3374;56565;741;82;32;2;30;.938;3818000;0
3374;57695;741;0;0;0;0;.00nan;0;0
3375;3756;748;0;0;0;0;.00nan;0;0
3375;76405;2168;57;49;6;43;.878;2904000;0
3375;85670;2168;59;14;1;13;.929;696000;0
3375;88646;748;83;31;2;29;.935;3600000;0
3376;3199;732;63;12;1;11;.917;1502000;0
3376;186234;739;0;0;0;0;.00nan;0;0
3376;46792;739;99;42;1;41;.976;3600000;0
3376;148788;732;27;20;5;15;.750;2098000;0
3377;83;737;64;32;3;29;.906;3600000;0
3377;190570;737;0;0;0;0;.00nan;0;0
3377;67294;733;0;0;0;0;.00nan;0;0
3377;85787;733;100;39;0;39;1.000;3600000;0
3378;6570;3789;78;22;1;21;.955;3600000;0
3378;33480;3789;0;0;0;0;.00nan;0;0
3378;49900;1880;64;37;4;33;.892;3600000;0
3378;61276;1880;0;0;0;0;.00nan;0;0
3379;186219;736;0;0;0;0;.00nan;0;0
3379;50065;729;100;30;0;30;1.000;3600000;0
3379;52204;736;98;48;2;46;.958;3533000;0
3379;93324;729;0;0;0;0;.00nan;0;0
3380;174898;764;0;0;0;0;.00nan;0;0
3380;43971;742;84;42;2;40;.952;3600000;0
3380;81085;764;60;27;3;24;.889;3570000;0
3380;158276;742;0;0;0;0;.00nan;0;0
3381;3508;745;75;22;1;21;.955;3600000;0
3381;178114;752;64;28;2;26;.929;3541000;0
3381;43731;752;0;0;0;0;.00nan;0;0
3381;192386;745;0;0;0;0;.00nan;0;0
3382;6079;734;0;0;0;0;.00nan;0;0
3382;6570;3789;87;36;2;34;.944;3597000;0
3382;33480;3789;0;0;0;0;.00nan;0;0
3382;44526;734;100;42;1;41;.976;3600000;0
3383;185413;740;0;0;0;0;.00nan;0;0
3383;186234;739;0;0;0;0;.00nan;0;0
3383;46792;739;44;24;4;20;.833;3600000;0
3383;57107;740;90;38;2;36;.947;3600000;0
3384;83;737;79;43;4;39;.907;3578000;0
3384;190570;737;0;0;0;0;.00nan;0;0
3384;85281;749;66;26;2;24;.923;3600000;0
3384;86697;749;0;0;0;0;.00nan;0;0
3385;3756;748;0;0;0;0;.00nan;0;0
3385;3928;744;90;37;2;35;.946;3900000;0
3385;-1;744;0;0;0;0;.00nan;0;0
3385;88646;748;100;42;2;40;.952;3900000;0
3386;3199;732;0;0;0;0;.00nan;0;0
3386;178098;738;100;27;0;27;1.000;3600000;0
3386;185442;738;0;0;0;0;.00nan;0;0
3386;148788;732;77;45;3;42;.933;3600000;0
3387;14335;747;78;35;2;33;.943;3600000;0
3387;196698;747;0;0;0;0;.00nan;0;0
3387;186235;751;71;39;3;36;.923;3566000;0
3387;-1;751;0;0;0;0;.00nan;0;0
3388;186219;736;99;62;2;60;.968;3600000;0
3388;43971;742;55;20;3;17;.850;3562000;0
3388;52204;736;0;0;0;0;.00nan;0;0
3388;158276;742;0;0;0;0;.00nan;0;0
3389;50065;729;17;13;5;8;.615;1029000;0
3389;67294;733;0;0;0;0;.00nan;0;0
3389;85787;733;99;38;1;37;.974;3600000;0
3389;93324;729;56;16;2;14;.875;2571000;0
3390;174898;764;0;0;0;0;.00nan;0;0
3390;56565;741;0;0;0;0;.00nan;0;0
3390;57695;741;91;20;0;20;1.000;3600000;0
3390;81085;764;60;37;4;33;.892;3600000;0
3391;14335;747;100;46;2;44;.957;3600000;0
3391;196698;747;0;0;0;0;.00nan;0;0
3391;76405;2168;62;30;4;26;.867;3534000;0
3391;85670;2168;0;0;0;0;.00nan;0;0
3392;186234;739;0;0;0;0;.00nan;0;0
3392;43971;742;100;46;2;44;.957;3880000;0
3392;46792;739;52;23;3;20;.870;3880000;0
3392;158276;742;0;0;0;0;.00nan;0;0
3393;6570;3789;0;0;0;0;.00nan;0;0
3393;33480;3789;45;28;4;24;.857;3701000;0
3393;85281;749;0;0;0;0;.00nan;0;0
3393;86697;749;60;37;5;32;.865;3701000;0
3394;178098;738;91;27;1;26;.963;3600000;0
3394;185442;738;0;0;0;0;.00nan;0;0
3394;50065;729;95;48;3;45;.938;3522000;0
3394;93324;729;0;0;0;0;.00nan;0;0
3395;3199;732;0;0;0;0;.00nan;0;0
3395;6079;734;0;0;0;0;.00nan;0;0
3395;44526;734;90;29;1;28;.966;3600000;0
3395;148788;732;81;35;2;33;.943;3560000;0
3396;178114;752;0;0;0;0;.00nan;0;0
3396;185413;740;50;2;0;2;1.000;337000;0
3396;43731;752;74;18;1;17;.944;3600000;0
3396;57107;740;52;42;6;36;.857;3263000;0
3397;3756;748;0;0;0;0;.00nan;0;0
3397;186219;736;0;0;0;0;.00nan;0;0
3397;52204;736;82;38;2;36;.947;3900000;0
3397;88646;748;71;27;2;25;.926;3900000;0
3398;83;737;64;9;1;8;.889;3600000;0
3398;190570;737;0;0;0;0;.00nan;0;0
3398;67294;733;0;0;0;0;.00nan;0;0
3398;85787;733;70;35;3;32;.914;3563000;0
3399;186235;751;23;29;6;23;.793;3600000;0
3399;-1;751;0;0;0;0;.00nan;0;0
3399;56565;741;0;0;0;0;.00nan;0;0
3399;57695;741;75;34;3;31;.912;3600000;0
3400;3508;745;84;25;1;24;.960;3600000;0
3400;175764;743;86;36;2;34;.944;3583000;0
3400;180188;743;0;0;0;0;.00nan;0;0
3400;192386;745;0;0;0;0;.00nan;0;0
3401;3199;732;46;28;5;23;.821;3600000;0
3401;174898;764;0;0;0;0;.00nan;0;0
3401;81085;764;85;37;2;35;.946;3600000;0
3401;148788;732;0;0;0;0;.00nan;0;0
3402;49900;1880;53;18;2;16;.889;3534000;0
3402;61276;1880;0;0;0;0;.00nan;0;0
3402;67294;733;100;53;0;53;1.000;3600000;0
3402;85787;733;0;0;0;0;.00nan;0;0
3403;3756;748;0;0;0;0;.00nan;0;0
3403;185413;740;0;0;0;0;.00nan;0;0
3403;57107;740;78;27;2;25;.926;3600000;0
3403;88646;748;71;32;3;29;.906;3562000;0
3404;14335;747;77;37;3;34;.919;3600000;0
3404;196698;747;0;0;0;0;.00nan;0;0
3404;76405;2168;49;29;5;24;.828;3556000;0
3404;85670;2168;0;0;0;0;.00nan;0;0
3405;6079;734;0;0;0;0;.00nan;0;0
3405;6570;3789;100;37;1;36;.973;3900000;0
3405;33480;3789;0;0;0;0;.00nan;0;0
3405;44526;734;89;33;1;32;.970;3900000;0
3406;178098;738;0;0;0;0;.00nan;0;0
3406;185442;738;81;31;2;29;.935;3600000;0
3406;43971;742;83;51;5;46;.902;3600000;0
3406;158276;742;0;0;0;0;.00nan;0;0
3407;3928;744;92;35;1;34;.971;3600000;0
3407;-1;744;0;0;0;0;.00nan;0;0
3407;85281;749;51;30;4;26;.867;3600000;0
3407;86697;749;0;0;0;0;.00nan;0;0
3408;178114;752;0;0;0;0;.00nan;0;0
3408;186234;739;0;0;0;0;.00nan;0;0
3408;43731;752;67;23;3;20;.870;3582000;0
3408;46792;739;95;35;1;34;.971;3600000;0
3409;186235;751;0;0;0;0;.00nan;0;0
3409;-1;751;59;36;4;32;.889;3600000;0
3409;50065;729;0;0;0;0;.00nan;0;0
3409;93324;729;71;44;5;39;.886;3569000;0
3410;174898;764;0;0;0;0;.00nan;0;0
3410;49900;1880;74;28;2;26;.929;3600000;0
3410;61276;1880;0;0;0;0;.00nan;0;0
3410;81085;764;55;27;4;23;.852;3555000;0
3411;3756;748;0;0;0;0;.00nan;0;0
3411;186219;736;0;0;0;0;.00nan;0;0
3411;52204;736;58;36;4;32;.889;3600000;0
3411;88646;748;64;41;5;36;.878;3541000;0
3412;185413;740;0;0;0;0;.00nan;0;0
3412;57107;740;89;40;2;38;.950;3900000;0
3412;76405;2168;97;49;2;47;.959;3900000;0
3412;85670;2168;0;0;0;0;.00nan;0;0
3413;6570;3789;76;35;3;32;.914;3892000;0
3413;33480;3789;0;0;0;0;.00nan;0;0
3413;186234;739;0;0;0;0;.00nan;0;0
3413;46792;739;100;44;2;42;.955;3892000;0
3414;3508;745;49;28;4;24;.857;3600000;0
3414;14335;747;99;40;1;39;.975;3600000;0
3414;196698;747;0;0;0;0;.00nan;0;0
3414;192386;745;0;0;0;0;.00nan;0;0
3415;50065;729;97;51;3;48;.941;3600000;0
3415;85281;749;52;28;4;24;.857;3554000;0
3415;86697;749;0;0;0;0;.00nan;0;0
3415;93324;729;0;0;0;0;.00nan;0;0
3416;174898;764;0;0;0;0;.00nan;0;0
3416;56565;741;38;24;5;19;.792;3545000;0
3416;57695;741;0;0;0;0;.00nan;0;0
3416;81085;764;75;40;4;36;.900;3600000;0
3417;6079;734;0;0;0;0;.00nan;0;0
3417;44526;734;73;9;0;9;1.000;3600000;0
3417;67294;733;49;37;7;30;.811;2860000;0
3417;85787;733;64;8;0;8;1.000;740000;0
3418;3199;732;0;0;0;0;.00nan;0;0
3418;49900;1880;87;29;1;28;.966;3600000;0
3418;61276;1880;0;0;0;0;.00nan;0;0
3418;148788;732;50;36;5;31;.861;3600000;0
3419;175764;743;77;38;3;35;.921;3566000;0
3419;180188;743;0;0;0;0;.00nan;0;0
3419;186235;751;0;0;0;0;.00nan;0;0
3419;-1;751;91;29;1;28;.966;3600000;0
3420;186219;736;58;3;0;3;1.000;467000;0
3420;52204;736;52;53;7;46;.868;3133000;0
3420;76405;2168;69;30;3;27;.900;3600000;0
3420;85670;2168;0;0;0;0;.00nan;0;0
3421;6079;734;0;0;0;0;.00nan;0;0
3421;44526;734;70;34;3;31;.912;3600000;0
3421;50065;729;52;35;5;30;.857;3562000;0
3421;93324;729;0;0;0;0;.00nan;0;0
3422;178114;752;0;0;0;0;.00nan;0;0
3422;43731;752;89;28;1;27;.964;3600000;0
3422;56565;741;93;42;2;40;.952;3581000;0
3422;57695;741;0;0;0;0;.00nan;0;0
3423;3756;748;0;0;0;0;.00nan;0;0
3423;186235;751;68;34;3;31;.912;3600000;0
3423;-1;751;0;0;0;0;.00nan;0;0
3423;88646;748;90;32;1;31;.969;3600000;0
3424;6079;734;90;30;1;29;.967;3600000;0
3424;6570;3789;59;36;4;32;.889;3600000;0
3424;33480;3789;0;0;0;0;.00nan;0;0
3424;44526;734;0;0;0;0;.00nan;0;0
3425;3928;744;100;30;0;30;1.000;3600000;0
3425;178098;738;0;0;0;0;.00nan;0;0
3425;185442;738;58;23;3;20;.870;3600000;0
3425;-1;744;0;0;0;0;.00nan;0;0
3426;3199;732;0;0;0;0;.00nan;0;0
3426;175764;743;36;24;5;19;.792;3600000;0
3426;180188;743;0;0;0;0;.00nan;0;0
3426;148788;732;78;29;2;27;.931;3600000;0
3427;185413;740;0;0;0;0;.00nan;0;0
3427;49900;1880;87;33;2;31;.939;3600000;0
3427;57107;740;55;31;5;26;.839;3600000;0
3427;61276;1880;0;0;0;0;.00nan;0;0
3428;186234;739;0;0;0;0;.00nan;0;0
3428;46792;739;32;17;4;13;.765;3542000;0
3428;67294;733;0;0;0;0;.00nan;0;0
3428;85787;733;99;38;2;36;.947;3600000;0
3429;186219;736;0;0;0;0;.00nan;0;0
3429;50065;729;76;22;1;21;.955;3600000;0
3429;52204;736;98;47;2;45;.957;3560000;0
3429;93324;729;0;0;0;0;.00nan;0;0
3430;175764;743;69;30;3;27;.900;3518000;0
3430;180188;743;0;0;0;0;.00nan;0;0
3430;56565;741;0;0;0;0;.00nan;0;0
3430;57695;741;100;34;1;33;.971;3600000;0
3431;14335;747;13;27;7;20;.741;3600000;0
3431;174898;764;0;0;0;0;.00nan;0;0
3431;196698;747;0;0;0;0;.00nan;0;0
3431;81085;764;75;33;2;31;.939;3600000;0
3432;83;737;79;28;2;26;.929;3619000;0
3432;190570;737;0;0;0;0;.00nan;0;0
3432;186234;739;0;0;0;0;.00nan;0;0
3432;46792;739;65;27;3;24;.889;3619000;0
3433;3756;748;0;0;0;0;.00nan;0;0
3433;178114;752;56;37;5;32;.865;3514000;0
3433;43731;752;0;0;0;0;.00nan;0;0
3433;88646;748;78;34;3;31;.912;3600000;0
3434;3508;745;64;24;2;22;.917;3565000;0
3434;185413;740;0;0;0;0;.00nan;0;0
3434;192386;745;0;0;0;0;.00nan;0;0
3434;57107;740;98;34;1;33;.971;3600000;0
3435;6570;3789;68;29;3;26;.897;3600000;0
3435;33480;3789;0;0;0;0;.00nan;0;0
3435;67294;733;0;0;0;0;.00nan;0;0
3435;85787;733;99;41;2;39;.951;3600000;0
3436;76405;2168;97;44;3;41;.932;3633000;0
3436;85281;749;0;0;0;0;.00nan;0;0
3436;85670;2168;0;0;0;0;.00nan;0;0
3436;86697;749;70;37;4;33;.892;3633000;0
3437;178098;738;72;34;4;30;.882;3539000;0
3437;185442;738;0;0;0;0;.00nan;0;0
3437;43971;742;100;53;2;51;.962;3600000;0
3437;158276;742;0;0;0;0;.00nan;0;0
3438;6079;734;0;0;0;0;.00nan;0;0
3438;186219;736;0;0;0;0;.00nan;0;0
3438;44526;734;86;21;0;21;1.000;3600000;0
3438;52204;736;58;42;5;37;.881;3600000;0
3439;14335;747;42;38;6;32;.842;3307000;0
3439;174898;764;0;0;0;0;.00nan;0;0
3439;196698;747;39;1;1;0;.000;269000;0
3439;81085;764;52;34;5;29;.853;3600000;0
3440;3199;732;0;0;0;0;.00nan;0;0
3440;49900;1880;73;23;1;22;.957;3600000;0
3440;61276;1880;0;0;0;0;.00nan;0;0
3440;148788;732;88;48;5;43;.896;3600000;0
3441;76405;2168;0;0;0;0;.00nan;0;0
3441;85281;749;54;21;3;18;.857;3549000;0
3441;85670;2168;81;35;2;33;.943;3600000;0
3441;86697;749;0;0;0;0;.00nan;0;0
3442;3928;744;71;37;4;33;.892;3900000;0
3442;-1;744;0;0;0;0;.00nan;0;0
3442;56565;741;67;38;4;34;.895;3900000;0
3442;57695;741;0;0;0;0;.00nan;0;0
3443;6570;3789;80;24;1;23;.958;3600000;0
3443;178098;738;98;52;3;49;.942;3562000;0
3443;33480;3789;0;0;0;0;.00nan;0;0
3443;185442;738;0;0;0;0;.00nan;0;0
3444;83;737;76;29;2;27;.931;3600000;0
3444;3508;745;58;23;3;20;.870;3573000;0
3444;190570;737;0;0;0;0;.00nan;0;0
3444;192386;745;0;0;0;0;.00nan;0;0
3445;186234;739;0;0;0;0;.00nan;0;0
3445;46792;739;73;27;2;25;.926;3547000;0
3445;50065;729;100;36;0;36;1.000;3600000;0
3445;93324;729;0;0;0;0;.00nan;0;0
3446;175764;743;27;31;6;25;.806;2702000;0
3446;180188;743;43;10;2;8;.800;898000;0
3446;186235;751;0;0;0;0;.00nan;0;0
3446;-1;751;85;30;1;29;.967;3600000;0
3447;178114;752;0;0;0;0;.00nan;0;0
3447;185413;740;62;7;0;7;1.000;496000;0
3447;43731;752;61;36;4;32;.889;3600000;0
3447;57107;740;30;27;6;21;.778;3022000;0
3448;3756;748;51;4;0;4;1.000;249000;0
3448;43971;742;71;35;3;32;.914;3600000;0
3448;88646;748;38;30;5;25;.833;3324000;0
3448;158276;742;0;0;0;0;.00nan;0;0
3449;14335;747;66;35;4;31;.886;3600000;0
3449;196698;747;0;0;0;0;.00nan;0;0
3449;76405;2168;98;41;1;40;.976;3600000;0
3449;85670;2168;0;0;0;0;.00nan;0;0
3450;3199;732;0;0;0;0;.00nan;0;0
3450;49900;1880;90;35;1;34;.971;3900000;0
3450;61276;1880;0;0;0;0;.00nan;0;0
3450;148788;732;100;59;1;58;.983;3894000;0
3451;174898;764;0;0;0;0;.00nan;0;0
3451;81085;764;66;42;5;37;.881;3600000;0
3451;85281;749;66;37;4;33;.892;3600000;0
3451;86697;749;0;0;0;0;.00nan;0;0
3452;3756;748;0;0;0;0;.00nan;0;0
3452;3928;744;67;20;1;19;.950;3600000;0
3452;-1;744;0;0;0;0;.00nan;0;0
3452;88646;748;70;51;5;46;.902;3600000;0
3453;178098;738;0;0;0;0;.00nan;0;0
3453;185442;738;77;26;1;25;.962;3600000;0
3453;67294;733;0;0;0;0;.00nan;0;0
3453;85787;733;89;42;3;39;.929;3573000;0
3454;83;737;65;34;3;31;.912;3590000;0
3454;6570;3789;60;19;2;17;.895;3600000;0
3454;33480;3789;0;0;0;0;.00nan;0;0
3454;190570;737;0;0;0;0;.00nan;0;0
3455;178114;752;0;0;0;0;.00nan;0;0
3455;43731;752;90;39;2;37;.949;3600000;0
3455;50065;729;50;37;6;31;.838;3241000;0
3455;93324;729;53;3;0;3;1.000;359000;0
3456;186219;736;65;9;0;9;1.000;884000;0
3456;52204;736;44;32;6;26;.813;2716000;0
3456;56565;741;77;31;2;29;.935;3600000;0
3456;57695;741;0;0;0;0;.00nan;0;0
3457;6079;734;0;0;0;0;.00nan;0;0
3457;175764;743;60;31;4;27;.871;3544000;0
3457;180188;743;0;0;0;0;.00nan;0;0
3457;44526;734;68;24;2;22;.917;3600000;0
3458;14335;747;75;42;4;38;.905;3550000;0
3458;196698;747;0;0;0;0;.00nan;0;0
3458;76405;2168;77;32;2;30;.938;3600000;0
3458;85670;2168;0;0;0;0;.00nan;0;0
3459;3199;732;0;0;0;0;.00nan;0;0
3459;185413;740;55;3;0;3;1.000;795000;0
3459;57107;740;16;30;8;22;.733;2805000;0
3459;148788;732;80;37;3;34;.919;3600000;0
3460;174898;764;0;0;0;0;.00nan;0;0
3460;81085;764;82;34;2;32;.941;3600000;0
3460;85281;749;70;29;3;26;.897;3546000;0
3460;86697;749;0;0;0;0;.00nan;0;0
3461;43971;742;100;42;1;41;.976;3600000;0
3461;49900;1880;43;24;4;20;.833;3600000;0
3461;61276;1880;0;0;0;0;.00nan;0;0
3461;158276;742;0;0;0;0;.00nan;0;0
3462;186234;739;0;0;0;0;.00nan;0;0
3462;46792;739;69;14;1;13;.929;3600000;0
3462;67294;733;0;0;0;0;.00nan;0;0
3462;85787;733;59;34;4;30;.882;3600000;0
3463;178098;738;94;44;3;41;.932;3600000;0
3463;178114;752;0;0;0;0;.00nan;0;0
3463;185442;738;0;0;0;0;.00nan;0;0
3463;43731;752;47;21;4;17;.810;3600000;0
3464;3928;744;88;37;2;35;.946;3547000;0
3464;-1;744;0;0;0;0;.00nan;0;0
3464;56565;741;88;30;1;29;.967;3600000;0
3464;57695;741;0;0;0;0;.00nan;0;0
3465;3756;748;0;0;0;0;.00nan;0;0
3465;43971;742;82;40;4;36;.900;3600000;0
3465;88646;748;51;35;5;30;.857;3562000;0
3465;158276;742;0;0;0;0;.00nan;0;0
3466;6570;3789;65;27;2;25;.926;3600000;0
3466;175764;743;72;45;5;40;.889;3600000;0
3466;33480;3789;0;0;0;0;.00nan;0;0
3466;180188;743;0;0;0;0;.00nan;0;0
3467;83;737;81;35;3;32;.914;3600000;0
3467;190570;737;0;0;0;0;.00nan;0;0
3467;49900;1880;100;32;0;32;1.000;3600000;0
3467;61276;1880;0;0;0;0;.00nan;0;0
3468;3508;745;85;32;1;31;.969;3900000;0
3468;186235;751;100;39;1;38;.974;3900000;0
3468;-1;751;0;0;0;0;.00nan;0;0
3468;192386;745;0;0;0;0;.00nan;0;0
3469;6079;734;0;0;0;0;.00nan;0;0
3469;185413;740;0;0;0;0;.00nan;0;0
3469;44526;734;55;36;5;31;.861;3600000;0
3469;57107;740;100;45;2;43;.956;3600000;0
3470;3199;732;0;0;0;0;.00nan;0;0
3470;186219;736;0;0;0;0;.00nan;0;0
3470;52204;736;87;49;4;45;.918;3600000;0
3470;148788;732;44;29;5;24;.828;3586000;0
3471;50065;729;72;40;4;36;.900;3558000;0
3471;56565;741;57;28;3;25;.893;3600000;0
3471;57695;741;0;0;0;0;.00nan;0;0
3471;93324;729;0;0;0;0;.00nan;0;0
3472;178114;752;0;0;0;0;.00nan;0;0
3472;43731;752;81;46;4;42;.913;3560000;0
3472;85281;749;78;28;2;26;.929;3600000;0
3472;86697;749;0;0;0;0;.00nan;0;0
3473;3508;745;93;49;3;46;.939;3655000;0
3473;3756;748;0;0;0;0;.00nan;0;0
3473;192386;745;0;0;0;0;.00nan;0;0
3473;88646;748;67;27;2;25;.926;3655000;0
3474;43971;742;67;34;3;31;.912;3600000;0
3474;76405;2168;69;22;2;20;.909;3600000;0
3474;85670;2168;0;0;0;0;.00nan;0;0
3474;158276;742;0;0;0;0;.00nan;0;0
3475;186234;739;0;0;0;0;.00nan;0;0
3475;186235;751;0;0;0;0;.00nan;0;0
3475;-1;751;89;32;2;30;.938;3600000;0
3475;46792;739;26;36;8;28;.778;3600000;0
3476;6079;734;0;0;0;0;.00nan;0;0
3476;178098;738;69;29;3;26;.897;3515000;0
3476;185442;738;0;0;0;0;.00nan;0;0
3476;44526;734;98;29;1;28;.966;3600000;0
3477;3928;744;98;28;1;27;.964;3600000;0
3477;14335;747;59;32;4;28;.875;3600000;0
3477;-1;744;0;0;0;0;.00nan;0;0
3477;196698;747;0;0;0;0;.00nan;0;0
3478;174898;764;0;0;0;0;.00nan;0;0
3478;67294;733;0;0;0;0;.00nan;0;0
3478;81085;764;89;29;1;28;.966;3600000;0
3478;85787;733;76;37;3;34;.919;3581000;0
3479;6570;3789;88;27;1;26;.963;3600000;0
3479;33480;3789;0;0;0;0;.00nan;0;0
3479;185413;740;0;0;0;0;.00nan;0;0
3479;57107;740;72;34;3;31;.912;3544000;0
3480;2643;729;0;0;0;0;.00nan;0;0
3480;175764;743;0;0;0;0;.00nan;0;0
3480;180188;743;77;28;1;27;.964;3600000;0
3480;50065;729;73;27;2;25;.926;3561000;0
3481;83;737;100;35;0;35;1.000;3641000;0
3481;190570;737;0;0;0;0;.00nan;0;0
3481;49900;1880;83;31;1;30;.968;3641000;0
3481;61276;1880;0;0;0;0;.00nan;0;0
3482;14335;747;53;20;2;18;.900;3658000;0
3482;196698;747;0;0;0;0;.00nan;0;0
3482;56565;741;94;47;3;44;.936;3658000;0
3482;57695;741;0;0;0;0;.00nan;0;0
3483;3508;745;40;33;6;27;.818;3553000;0
3483;192386;745;0;0;0;0;.00nan;0;0
3483;76405;2168;54;29;4;25;.862;3600000;0
3483;85670;2168;0;0;0;0;.00nan;0;0
3484;178098;738;95;41;2;39;.951;3600000;0
3484;185442;738;0;0;0;0;.00nan;0;0
3484;85281;749;0;0;0;0;.00nan;0;0
3484;86697;749;49;25;3;22;.880;3600000;0
3485;3928;744;83;30;2;28;.933;3600000;0
3485;-1;744;0;0;0;0;.00nan;0;0
3485;67294;733;0;0;0;0;.00nan;0;0
3485;85787;733;69;35;3;32;.914;3583000;0
3486;3199;732;0;0;0;0;.00nan;0;0
3486;186234;739;0;0;0;0;.00nan;0;0
3486;46792;739;85;40;3;37;.925;3525000;0
3486;148788;732;78;23;1;22;.957;3600000;0
3487;178114;752;0;0;0;0;.00nan;0;0
3487;186235;751;0;0;0;0;.00nan;0;0
3487;-1;751;66;29;3;26;.897;3600000;0
3487;43731;752;46;32;5;27;.844;3559000;0
3488;6079;734;0;0;0;0;.00nan;0;0
3488;186219;736;0;0;0;0;.00nan;0;0
3488;44526;734;65;20;2;18;.900;3600000;0
3488;52204;736;97;65;3;62;.954;3584000;0
3489;3756;748;0;0;0;0;.00nan;0;0
3489;174898;764;0;0;0;0;.00nan;0;0
3489;81085;764;58;36;4;32;.889;3600000;0
3489;88646;748;89;33;1;32;.970;3600000;0
3490;83;737;52;21;3;18;.857;3546000;0
3490;190570;737;0;0;0;0;.00nan;0;0
3490;185413;740;0;0;0;0;.00nan;0;0
3490;57107;740;97;40;2;38;.950;3600000;0
3491;175764;743;74;36;3;33;.917;3600000;0
3491;180188;743;0;0;0;0;.00nan;0;0
3491;49900;1880;78;28;2;26;.929;3600000;0
3491;61276;1880;0;0;0;0;.00nan;0;0
3492;2643;729;0;0;0;0;.00nan;0;0
3492;43971;742;52;31;4;27;.871;3600000;0
3492;50065;729;72;22;1;21;.955;3600000;0
3492;75268;742;0;0;0;0;.00nan;0;0
3493;56565;741;40;33;6;27;.818;1942000;0
3493;57695;741;53;30;4;26;.867;1658000;0
3493;85281;749;69;19;1;18;.947;3600000;0
3493;86697;749;0;0;0;0;.00nan;0;0
3494;186235;751;43;37;6;31;.838;3600000;0
3494;-1;751;0;0;0;0;.00nan;0;0
3494;76405;2168;70;26;2;24;.923;3600000;0
3494;85670;2168;0;0;0;0;.00nan;0;0
3495;178098;738;75;37;3;34;.919;3568000;0
3495;185442;738;0;0;0;0;.00nan;0;0
3495;186234;739;0;0;0;0;.00nan;0;0
3495;46792;739;75;32;2;30;.938;3600000;0
3496;83;737;0;0;0;0;.00nan;0;0
3496;190570;737;52;18;2;16;.889;3568000;0
3496;67294;733;0;0;0;0;.00nan;0;0
3496;85787;733;95;47;1;46;.979;3600000;0
3497;3756;748;0;0;0;0;.00nan;0;0
3497;3928;744;60;32;4;28;.875;3559000;0
3497;-1;744;0;0;0;0;.00nan;0;0
3497;88646;748;61;20;2;18;.900;3600000;0
3498;3199;732;0;0;0;0;.00nan;0;0
3498;3508;745;87;35;2;33;.943;3863000;0
3498;192386;745;0;0;0;0;.00nan;0;0
3498;148788;732;85;37;3;34;.919;3863000;0
3499;6079;734;0;0;0;0;.00nan;0;0
3499;178114;752;46;39;5;34;.872;3600000;0
3499;43731;752;0;0;0;0;.00nan;0;0
3499;44526;734;51;27;4;23;.852;3600000;0
3500;6570;3789;69;23;2;21;.913;3900000;0
3500;33480;3789;0;0;0;0;.00nan;0;0
3500;186219;736;0;0;0;0;.00nan;0;0
3500;52204;736;95;45;2;43;.956;3900000;0
3501;14335;747;62;36;4;32;.889;3600000;0
3501;174898;764;0;0;0;0;.00nan;0;0
3501;196698;747;0;0;0;0;.00nan;0;0
3501;81085;764;61;24;3;21;.875;3600000;0
3503;-1;733;0;0;0;0;.00nan;0;0
3503;56565;741;95;24;1;23;.958;3600000;0
3503;57695;741;0;0;0;0;.00nan;0;0
3503;85787;733;45;36;5;31;.861;3600000;0
3505;83;737;89;24;1;23;.958;3681000;0
3505;170543;747;73;28;2;26;.929;3681000;0
3505;190570;737;0;0;0;0;.00nan;0;0
3505;190589;747;0;0;0;0;.00nan;0;0
3507;6868;764;0;0;0;0;.00nan;0;0
3507;174898;764;100;29;0;29;1.000;3600000;0
3507;50065;729;82;34;2;32;.941;3600000;0
3507;93324;729;0;0;0;0;.00nan;0;0
3509;1957;734;72;34;3;31;.912;3525000;0
3509;3756;748;86;28;1;27;.964;3600000;0
3509;6079;734;0;0;0;0;.00nan;0;0
3509;-1;748;0;0;0;0;.00nan;0;0
3511;3508;745;59;31;3;28;.903;3600000;0
3511;180188;745;0;0;0;0;.00nan;0;0
3511;46792;743;45;27;5;22;.815;3600000;0
3511;148956;743;0;0;0;0;.00nan;0;0
3513;178098;738;79;35;3;32;.914;3576000;0
3513;175764;1880;78;31;2;29;.935;3600000;0
3513;185442;738;0;0;0;0;.00nan;0;0
3513;49900;1880;0;0;0;0;.00nan;0;0
3515;178114;752;0;0;0;0;.00nan;0;0
3515;33480;752;28;21;5;16;.762;3600000;0
3515;185413;751;37;34;6;28;.824;3576000;0
3515;-1;751;0;0;0;0;.00nan;0;0
3517;3928;744;24;12;4;8;.667;1134000;0
3517;6570;3789;71;25;2;23;.920;3600000;0
3517;-1;3789;0;0;0;0;.00nan;0;0
3517;64722;744;70;17;0;17;1.000;2447000;0
3519;176686;739;0;0;0;0;.00nan;0;0
3519;-1;2168;0;0;0;0;.00nan;0;0
3519;186234;739;80;29;1;28;.966;3600000;0
3519;76405;2168;94;44;3;41;.932;3537000;0
3521;186235;732;75;35;3;32;.914;3600000;0
3521;43971;742;47;36;6;30;.833;3055000;0
3521;192386;732;0;0;0;0;.00nan;0;0
3521;52204;742;41;9;2;7;.778;545000;0
3523;185363;740;0;0;0;0;.00nan;0;0
3523;186219;736;0;0;0;0;.00nan;0;0
3523;44526;736;77;50;5;45;.900;3600000;0
3523;152624;740;67;23;2;21;.913;3600000;0
3525;3508;745;64;25;3;22;.880;3900000;0
3525;6868;764;0;0;0;0;.00nan;0;0
3525;174898;764;87;42;3;39;.929;3900000;0
3525;180188;745;0;0;0;0;.00nan;0;0
3527;175764;1880;78;46;4;42;.913;3866000;0
3527;49900;1880;0;0;0;0;.00nan;0;0
3527;85281;749;46;30;5;25;.833;3856000;0
3527;86697;749;0;0;0;0;.00nan;0;0
3529;185413;751;0;0;0;0;.00nan;0;0
3529;-1;751;100;32;0;32;1.000;3600000;0
3529;56565;741;88;34;1;33;.971;3546000;0
3529;57695;741;0;0;0;0;.00nan;0;0
3531;170543;747;0;0;0;0;.00nan;0;0
3531;176686;739;84;37;3;34;.919;3600000;0
3531;190589;747;39;50;8;42;.840;3600000;0
3531;186234;739;0;0;0;0;.00nan;0;0
3533;6570;3789;61;26;3;23;.885;3529000;0
3533;178098;738;0;0;0;0;.00nan;0;0
3533;185442;738;98;44;1;43;.977;3600000;0
3533;-1;3789;0;0;0;0;.00nan;0;0
3535;185363;740;0;0;0;0;.00nan;0;0
3535;46792;743;81;36;3;33;.917;3588000;0
3535;148956;743;0;0;0;0;.00nan;0;0
3535;152624;740;82;27;1;26;.963;3600000;0
3537;3756;748;63;24;2;22;.917;3600000;0
3537;-1;748;0;0;0;0;.00nan;0;0
3537;186219;736;0;0;0;0;.00nan;0;0
3537;44526;736;67;31;3;28;.903;3600000;0
3539;-1;2168;0;0;0;0;.00nan;0;0
3539;43971;742;100;40;0;40;1.000;3600000;0
3539;52204;742;0;0;0;0;.00nan;0;0
3539;76405;2168;56;23;2;21;.913;3550000;0
3541;1957;734;0;0;0;0;.00nan;0;0
3541;3928;744;96;19;0;19;1.000;3600000;0
3541;6079;734;92;28;1;27;.964;3571000;0
3541;64722;744;0;0;0;0;.00nan;0;0
3543;-1;733;0;0;0;0;.00nan;0;0
3543;186235;732;94;27;0;27;1.000;3600000;0
3543;192386;732;0;0;0;0;.00nan;0;0
3543;85787;733;68;43;4;39;.907;3600000;0
3545;83;737;84;26;1;25;.962;3600000;0
3545;178114;752;0;0;0;0;.00nan;0;0
3545;33480;752;44;21;3;18;.857;3547000;0
3545;190570;737;0;0;0;0;.00nan;0;0
3547;83;737;48;5;1;4;.800;1228000;0
3547;6570;3789;100;38;1;37;.974;3600000;0
3547;190570;737;26;22;5;17;.773;2372000;0
3547;-1;3789;0;0;0;0;.00nan;0;0
3549;6868;764;51;36;5;31;.861;3589000;0
3549;170543;747;56;28;3;25;.893;3600000;0
3549;174898;764;0;0;0;0;.00nan;0;0
3549;190589;747;0;0;0;0;.00nan;0;0
3551;176686;739;0;0;0;0;.00nan;0;0
3551;186234;739;57;35;4;31;.886;3579000;0
3551;43971;742;62;23;3;20;.870;3600000;0
3551;52204;742;0;0;0;0;.00nan;0;0
3553;178098;738;60;25;3;22;.880;3547000;0
3553;-1;2168;76;25;1;24;.960;3600000;0
3553;185442;738;0;0;0;0;.00nan;0;0
3553;76405;2168;0;0;0;0;.00nan;0;0
3555;3508;745;0;0;0;0;.00nan;0;0
3555;3756;748;52;27;4;23;.852;3600000;0
3555;-1;748;0;0;0;0;.00nan;0;0
3555;180188;745;47;41;6;35;.854;3594000;0
3557;-1;733;27;25;5;20;.800;3600000;0
3557;50065;729;99;39;1;38;.974;3600000;0
3557;85787;733;0;0;0;0;.00nan;0;0
3557;93324;729;0;0;0;0;.00nan;0;0
3559;185413;751;58;27;3;24;.889;2496000;0
3559;-1;751;29;15;4;11;.733;1104000;0
3559;46792;743;0;0;0;0;.00nan;0;0
3559;148956;743;70;41;4;37;.902;3600000;0
3561;185363;740;37;21;4;17;.810;3585000;0
3561;85281;749;0;0;0;0;.00nan;0;0
3561;86697;749;73;27;2;25;.926;3600000;0
3561;152624;740;0;0;0;0;.00nan;0;0
3563;178114;752;66;23;2;21;.913;3600000;0
3563;33480;752;0;0;0;0;.00nan;0;0
3563;186235;732;52;33;4;29;.879;3577000;0
3563;192386;732;0;0;0;0;.00nan;0;0
3565;1957;734;70;22;1;21;.955;3600000;0
3565;3928;744;83;32;2;30;.938;3600000;0
3565;6079;734;0;0;0;0;.00nan;0;0
3565;64722;744;0;0;0;0;.00nan;0;0
3567;175764;1880;0;0;0;0;.00nan;0;0
3567;186219;736;68;33;3;30;.909;3585000;0
3567;44526;736;0;0;0;0;.00nan;0;0
3567;49900;1880;85;25;1;24;.960;3600000;0
3569;-1;733;0;0;0;0;.00nan;0;0
3569;85281;749;0;0;0;0;.00nan;0;0
3569;85787;733;57;37;5;32;.865;3600000;0
3569;86697;749;86;26;1;25;.962;3600000;0
3571;175764;1880;0;0;0;0;.00nan;0;0
3571;186219;736;0;0;0;0;.00nan;0;0
3571;44526;736;100;31;0;31;1.000;3600000;0
3571;49900;1880;57;22;2;20;.909;3542000;0
3573;178114;752;0;0;0;0;.00nan;0;0
3573;33480;752;65;28;2;26;.929;3567000;0
3573;185363;740;0;0;0;0;.00nan;0;0
3573;152624;740;94;38;1;37;.974;3600000;0
3575;178098;738;0;0;0;0;.00nan;0;0
3575;185413;751;0;0;0;0;.00nan;0;0
3575;185442;738;76;33;2;31;.939;3600000;0
3575;-1;751;61;34;4;30;.882;3523000;0
3577;3928;744;54;35;5;30;.857;3600000;0
3577;46792;743;81;34;2;32;.941;3600000;0
3577;64722;744;0;0;0;0;.00nan;0;0
3577;148956;743;0;0;0;0;.00nan;0;0
3579;6570;3789;78;30;2;28;.933;3900000;0
3579;6868;764;73;29;2;27;.931;3900000;0
3579;174898;764;0;0;0;0;.00nan;0;0
3579;-1;3789;0;0;0;0;.00nan;0;0
3581;3508;745;72;32;3;29;.906;3600000;0
3581;170543;747;36;35;6;29;.829;3600000;0
3581;180188;745;0;0;0;0;.00nan;0;0
3581;190589;747;0;0;0;0;.00nan;0;0
3583;1957;734;64;32;3;29;.906;3600000;0
3583;6079;734;0;0;0;0;.00nan;0;0
3583;186235;732;100;27;0;27;1.000;3600000;0
3583;192386;732;0;0;0;0;.00nan;0;0
3585;-1;2168;0;0;0;0;.00nan;0;0
3585;43971;742;0;0;0;0;.00nan;0;0
3585;52204;742;74;27;1;26;.963;3600000;0
3585;76405;2168;69;32;2;30;.938;3557000;0
3587;50065;729;86;26;1;25;.962;3569000;0
3587;56565;741;0;0;0;0;.00nan;0;0
3587;57695;741;88;22;0;22;1.000;3600000;0
3587;93324;729;0;0;0;0;.00nan;0;0
3589;83;737;53;36;5;31;.861;3532000;0
3589;176686;739;63;25;3;22;.880;3600000;0
3589;190570;737;0;0;0;0;.00nan;0;0
3589;186234;739;0;0;0;0;.00nan;0;0
3591;178098;738;88;27;1;26;.963;3600000;0
3591;170543;747;0;0;0;0;.00nan;0;0
3591;190589;747;64;35;4;31;.886;3600000;0
3591;185442;738;0;0;0;0;.00nan;0;0
3593;6570;3789;0;0;0;0;.00nan;0;0
3593;176686;739;0;0;0;0;.00nan;0;0
3593;186234;739;64;24;2;22;.917;3744000;0
3593;-1;3789;63;32;3;29;.906;3744000;0
3595;3508;745;0;0;0;0;.00nan;0;0
3595;180188;745;36;19;4;15;.789;3540000;0
3595;46792;743;0;0;0;0;.00nan;0;0
3595;148956;743;68;23;2;21;.913;3600000;0
3597;1957;734;0;0;0;0;.00nan;0;0
3597;6079;734;66;15;1;14;.933;3600000;0
3597;56565;741;0;0;0;0;.00nan;0;0
3597;57695;741;73;35;3;32;.914;3545000;0
3599;175764;1880;76;29;1;28;.966;3900000;0
3599;49900;1880;0;0;0;0;.00nan;0;0
3599;85281;749;78;31;1;30;.968;3900000;0
3599;86697;749;0;0;0;0;.00nan;0;0
3601;3756;748;95;49;2;47;.959;3900000;0
3601;3928;744;0;0;0;0;.00nan;0;0
3601;-1;748;0;0;0;0;.00nan;0;0
3601;64722;744;67;30;2;28;.933;3900000;0
3603;-1;2168;0;0;0;0;.00nan;0;0
3603;-1;733;82;40;2;38;.950;3567000;0
3603;76405;2168;75;10;0;10;1.000;3600000;0
3603;85787;733;0;0;0;0;.00nan;0;0
3605;83;737;0;0;0;0;.00nan;0;0
3605;190570;737;49;16;2;14;.875;3600000;0
3605;50065;729;0;0;0;0;.00nan;0;0
3605;93324;729;65;35;3;32;.914;3577000;0
3607;186219;736;0;0;0;0;.00nan;0;0
3607;186235;732;72;27;2;25;.926;3600000;0
3607;44526;736;59;41;6;35;.854;3600000;0
3607;192386;732;0;0;0;0;.00nan;0;0
3609;6868;764;0;0;0;0;.00nan;0;0
3609;174898;764;52;33;4;29;.879;3629000;0
3609;185363;740;38;19;4;15;.789;1043000;0
3609;152624;740;86;28;1;27;.964;2586000;0
3611;185413;751;63;36;3;33;.917;3596000;0
3611;-1;751;0;0;0;0;.00nan;0;0
3611;43971;742;75;27;2;25;.926;3600000;0
3611;52204;742;0;0;0;0;.00nan;0;0
3613;3928;744;100;40;2;38;.950;3900000;0
3613;178098;738;0;0;0;0;.00nan;0;0
3613;185442;738;72;31;2;29;.935;3900000;0
3613;64722;744;0;0;0;0;.00nan;0;0
3615;-1;2168;0;0;0;0;.00nan;0;0
3615;43971;742;67;31;3;28;.903;3559000;0
3615;52204;742;0;0;0;0;.00nan;0;0
3615;76405;2168;91;42;3;39;.929;3600000;0
3617;6868;764;54;44;5;39;.886;3600000;0
3617;178114;752;0;0;0;0;.00nan;0;0
3617;174898;764;0;0;0;0;.00nan;0;0
3617;33480;752;68;19;1;18;.947;3600000;0
3619;185413;751;39;19;4;15;.789;3522000;0
3619;-1;751;0;0;0;0;.00nan;0;0
3619;85281;749;84;38;3;35;.921;3600000;0
3619;86697;749;0;0;0;0;.00nan;0;0
3621;175764;1880;0;0;0;0;.00nan;0;0
3621;49900;1880;97;24;0;24;1.000;3600000;0
3621;56565;741;80;38;2;36;.947;3575000;0
3621;57695;741;0;0;0;0;.00nan;0;0
3623;176686;739;40;17;3;14;.824;3600000;0
3623;185363;740;0;0;0;0;.00nan;0;0
3623;186234;739;0;0;0;0;.00nan;0;0
3623;152624;740;100;52;0;52;1.000;3600000;0
3625;3756;748;80;28;2;26;.929;3600000;0
3625;-1;748;0;0;0;0;.00nan;0;0
3625;-1;733;0;0;0;0;.00nan;0;0
3625;85787;733;53;34;5;29;.853;3600000;0
3627;83;737;100;36;0;36;1.000;3600000;0
3627;170543;747;81;42;3;39;.929;3600000;0
3627;190570;737;0;0;0;0;.00nan;0;0
3627;190589;747;0;0;0;0;.00nan;0;0
3629;186219;736;0;0;0;0;.00nan;0;0
3629;44526;736;97;43;2;41;.953;3900000;0
3629;46792;743;77;27;2;25;.926;3900000;0
3629;148956;743;0;0;0;0;.00nan;0;0
3631;1957;734;0;0;0;0;.00nan;0;0
3631;6079;734;61;19;2;17;.895;3600000;0
3631;50065;729;74;40;3;37;.925;3600000;0
3631;93324;729;0;0;0;0;.00nan;0;0
3633;3508;745;94;38;2;36;.947;3900000;0
3633;180188;745;0;0;0;0;.00nan;0;0
3633;186235;732;93;48;2;46;.958;3900000;0
3633;192386;732;0;0;0;0;.00nan;0;0
3635;185363;740;0;0;0;0;.00nan;0;0
3635;56565;741;0;0;0;0;.00nan;0;0
3635;57695;741;41;30;5;25;.833;3568000;0
3635;152624;740;74;31;3;28;.903;3600000;0
3637;176686;739;0;0;0;0;.00nan;0;0
3637;186234;739;50;26;4;22;.846;3600000;0
3637;186235;732;0;0;0;0;.00nan;0;0
3637;192386;732;97;34;1;33;.971;3600000;0
3639;-1;733;0;0;0;0;.00nan;0;0
3639;50065;729;0;0;0;0;.00nan;0;0
3639;85787;733;91;39;2;37;.949;3600000;0
3639;93324;729;56;34;5;29;.853;3600000;0
3641;3508;745;0;0;0;0;.00nan;0;0
3641;180188;745;71;17;1;16;.941;3600000;0
3641;185413;751;0;0;0;0;.00nan;0;0
3641;-1;751;87;39;2;37;.949;3600000;0
3643;1957;734;100;30;0;30;1.000;3600000;0
3643;3928;744;0;0;0;0;.00nan;0;0
3643;6079;734;0;0;0;0;.00nan;0;0
3643;64722;744;73;29;2;27;.931;3541000;0
3645;3756;748;0;0;0;0;.00nan;0;0
3645;178114;752;77;31;3;28;.903;3900000;0
3645;-1;748;66;32;3;29;.906;3900000;0
3645;33480;752;0;0;0;0;.00nan;0;0
3647;-1;2168;62;17;2;15;.882;3600000;0
3647;186219;736;72;33;3;30;.909;3579000;0
3647;44526;736;0;0;0;0;.00nan;0;0
3647;76405;2168;0;0;0;0;.00nan;0;0
3649;6868;764;0;0;0;0;.00nan;0;0
3649;174898;764;68;26;2;24;.923;3600000;0
3649;175764;1880;0;0;0;0;.00nan;0;0
3649;49900;1880;86;37;3;34;.919;3570000;0
3651;178098;738;82;32;2;30;.938;3600000;0
3651;185442;738;0;0;0;0;.00nan;0;0
3651;43971;742;0;0;0;0;.00nan;0;0
3651;52204;742;54;31;4;27;.871;3552000;0
3653;170543;747;0;0;0;0;.00nan;0;0
3653;190589;747;70;32;4;28;.875;3594000;0
3653;46792;743;0;0;0;0;.00nan;0;0
3653;148956;743;72;32;3;29;.906;3600000;0
3655;83;737;61;23;2;21;.913;3600000;0
3655;6570;3789;62;27;3;24;.889;3600000;0
3655;190570;737;0;0;0;0;.00nan;0;0
3655;-1;3789;0;0;0;0;.00nan;0;0
885;83;737;94;35;1;34;.971;3600000;0
885;6079;734;0;0;0;0;.00nan;0;0
885;190570;737;0;0;0;0;.00nan;0;0
885;44526;734;34;28;6;22;.786;3600000;0
886;3199;732;0;0;0;0;.00nan;0;0
886;178098;738;66;33;3;30;.909;3600000;0
886;185442;738;0;0;0;0;.00nan;0;0
886;148788;732;73;42;4;38;.905;3556000;0
887;6570;3789;67;27;3;24;.889;3600000;0
887;33480;3789;0;0;0;0;.00nan;0;0
887;49900;1880;92;38;2;36;.947;3600000;0
887;61276;1880;0;0;0;0;.00nan;0;0
888;2643;729;0;0;0;0;.00nan;0;0
888;186234;739;0;0;0;0;.00nan;0;0
888;46792;739;100;24;0;24;1.000;3600000;0
888;50065;729;74;46;5;41;.891;3600000;0
889;14335;747;61;40;4;36;.900;3600000;0
889;196698;747;0;0;0;0;.00nan;0;0
889;76405;2168;59;40;5;35;.875;3600000;0
889;85670;2168;0;0;0;0;.00nan;0;0
890;3508;745;66;38;4;34;.895;3600000;0
890;186235;751;56;5;0;5;1.000;317000;0
890;-1;751;30;33;6;27;.818;3267000;0
890;192386;745;0;0;0;0;.00nan;0;0
891;3928;744;54;47;5;42;.894;4937000;0
891;-1;744;0;0;0;0;.00nan;0;0
891;85281;749;90;47;4;43;.915;4937000;0
891;86697;749;0;0;0;0;.00nan;0;0
892;178114;752;0;0;0;0;.00nan;0;0
892;43731;752;96;16;0;16;1.000;3600000;0
892;56565;741;97;47;1;46;.979;3579000;0
892;57695;741;0;0;0;0;.00nan;0;0
893;83;737;84;35;2;33;.943;3600000;0
893;6079;734;0;0;0;0;.00nan;0;0
893;190570;737;0;0;0;0;.00nan;0;0
893;44526;734;49;29;4;25;.862;3526000;0
894;3199;732;0;0;0;0;.00nan;0;0
894;178098;738;58;28;3;25;.893;3600000;0
894;185442;738;0;0;0;0;.00nan;0;0
894;148788;732;91;40;2;38;.950;3600000;0
895;6570;3789;100;31;1;30;.968;3600000;0
895;33480;3789;0;0;0;0;.00nan;0;0
895;49900;1880;77;36;3;33;.917;3559000;0
895;61276;1880;0;0;0;0;.00nan;0;0
896;2643;729;0;0;0;0;.00nan;0;0
896;186234;739;0;0;0;0;.00nan;0;0
896;46792;739;90;19;0;19;1.000;3600000;0
896;50065;729;97;43;1;42;.977;3563000;0
897;14335;747;85;15;0;15;1.000;3600000;0
897;196698;747;0;0;0;0;.00nan;0;0
897;76405;2168;76;41;4;37;.902;3600000;0
897;85670;2168;0;0;0;0;.00nan;0;0
898;3508;745;85;27;1;26;.963;3600000;0
898;186235;751;54;2;0;2;1.000;540000;0
898;-1;751;53;44;6;38;.864;3060000;0
898;192386;745;0;0;0;0;.00nan;0;0
899;3928;744;71;31;3;28;.903;3600000;0
899;-1;744;0;0;0;0;.00nan;0;0
899;85281;749;24;17;5;12;.706;3098000;0
899;86697;749;51;2;0;2;1.000;429000;0
900;178114;752;0;0;0;0;.00nan;0;0
900;43731;752;100;26;0;26;1.000;3600000;0
900;56565;741;90;39;2;37;.949;3564000;0
900;57695;741;0;0;0;0;.00nan;0;0
901;83;737;95;39;1;38;.974;4419000;0
901;6079;734;0;0;0;0;.00nan;0;0
901;190570;737;0;0;0;0;.00nan;0;0
901;44526;734;78;31;2;29;.935;4419000;0
902;3199;732;0;0;0;0;.00nan;0;0
902;178098;738;80;34;2;32;.941;3600000;0
902;185442;738;0;0;0;0;.00nan;0;0
902;148788;732;60;36;5;31;.861;3600000;0
903;6570;3789;89;26;1;25;.962;3600000;0
903;33480;3789;0;0;0;0;.00nan;0;0
903;49900;1880;25;25;6;19;.760;2558000;0
903;61276;1880;60;9;0;9;1.000;1042000;0
904;2643;729;0;0;0;0;.00nan;0;0
904;186234;739;0;0;0;0;.00nan;0;0
904;46792;739;99;34;1;33;.971;3600000;0
904;50065;729;98;43;2;41;.953;3585000;0
905;14335;747;94;21;0;21;1.000;3600000;0
905;196698;747;0;0;0;0;.00nan;0;0
905;76405;2168;72;27;2;25;.926;3600000;0
905;85670;2168;0;0;0;0;.00nan;0;0
906;3508;745;75;23;3;20;.870;3600000;0
906;186235;751;35;36;6;30;.833;3600000;0
906;-1;751;0;0;0;0;.00nan;0;0
906;192386;745;0;0;0;0;.00nan;0;0
907;3928;744;73;31;3;28;.903;3520000;0
907;-1;744;0;0;0;0;.00nan;0;0
907;85281;749;88;25;1;24;.960;3600000;0
907;86697;749;0;0;0;0;.00nan;0;0
908;178114;752;0;0;0;0;.00nan;0;0
908;43731;752;82;27;2;25;.926;3600000;0
908;56565;741;87;61;5;56;.918;3600000;0
908;57695;741;0;0;0;0;.00nan;0;0
909;83;737;41;27;5;22;.815;3600000;0
909;6079;734;0;0;0;0;.00nan;0;0
909;190570;737;0;0;0;0;.00nan;0;0
909;44526;734;95;36;1;35;.972;3600000;0
910;3199;732;0;0;0;0;.00nan;0;0
910;178098;738;78;25;1;24;.960;3600000;0
910;185442;738;0;0;0;0;.00nan;0;0
910;148788;732;77;29;2;27;.931;3600000;0
911;6570;3789;83;20;0;20;1.000;3600000;0
911;33480;3789;0;0;0;0;.00nan;0;0
911;49900;1880;90;37;2;35;.946;3567000;0
911;61276;1880;0;0;0;0;.00nan;0;0
912;2643;729;0;0;0;0;.00nan;0;0
912;186234;739;0;0;0;0;.00nan;0;0
912;46792;739;80;34;3;31;.912;3575000;0
912;50065;729;100;33;1;32;.970;3600000;0
913;14335;747;88;32;1;31;.969;3600000;0
913;196698;747;0;0;0;0;.00nan;0;0
913;76405;2168;79;31;2;29;.935;3571000;0
913;85670;2168;0;0;0;0;.00nan;0;0
914;3508;745;58;17;2;15;.882;3600000;0
914;186235;751;0;0;0;0;.00nan;0;0
914;-1;751;61;46;5;41;.891;3600000;0
914;192386;745;0;0;0;0;.00nan;0;0
915;3928;744;93;44;3;41;.932;3600000;0
915;-1;744;0;0;0;0;.00nan;0;0
915;85281;749;50;28;4;24;.857;3543000;0
915;86697;749;0;0;0;0;.00nan;0;0
916;178114;752;0;0;0;0;.00nan;0;0
916;43731;752;45;25;4;21;.840;4427000;0
916;56565;741;71;38;3;35;.921;4427000;0
916;57695;741;0;0;0;0;.00nan;0;0
1116;83;737;36;31;6;25;.806;3158000;0
1116;6079;734;0;0;0;0;.00nan;0;0
1116;190570;737;53;3;0;3;1.000;442000;0
1116;44526;734;95;29;1;28;.966;3600000;0
1117;3199;732;0;0;0;0;.00nan;0;0
1117;178098;738;80;37;3;34;.919;4287000;0
1117;185442;738;0;0;0;0;.00nan;0;0
1117;148788;732;91;39;2;37;.949;4287000;0
1118;6570;3789;86;40;3;37;.925;3600000;0
1118;33480;3789;0;0;0;0;.00nan;0;0
1118;49900;1880;86;32;2;30;.938;3600000;0
1118;61276;1880;0;0;0;0;.00nan;0;0
1119;2643;729;0;0;0;0;.00nan;0;0
1119;186234;739;0;0;0;0;.00nan;0;0
1119;46792;739;79;36;3;33;.917;3600000;0
1119;50065;729;41;22;4;18;.818;3592000;0
1120;3928;744;34;28;6;22;.786;3600000;0
1120;-1;744;0;0;0;0;.00nan;0;0
1120;85281;749;92;27;1;26;.963;3600000;0
1120;86697;749;0;0;0;0;.00nan;0;0
1121;178114;752;0;0;0;0;.00nan;0;0
1121;43731;752;61;37;3;34;.919;4713000;0
1121;56565;741;50;29;4;25;.862;4713000;0
1121;57695;741;0;0;0;0;.00nan;0;0
1191;83;737;56;35;4;31;.886;3600000;0
1191;6079;734;0;0;0;0;.00nan;0;0
1191;190570;737;0;0;0;0;.00nan;0;0
1191;44526;734;69;20;1;19;.950;3600000;0
1192;3199;732;38;7;2;5;.714;972000;0
1192;178098;738;67;33;4;29;.879;3600000;0
1192;185442;738;0;0;0;0;.00nan;0;0
1192;148788;732;35;32;6;26;.813;2628000;0
1193;6570;3789;73;46;4;42;.913;5532000;0
1193;33480;3789;0;0;0;0;.00nan;0;0
1193;49900;1880;63;37;3;34;.919;5565000;0
1193;61276;1880;0;0;0;0;.00nan;0;0
1194;3928;744;76;40;4;36;.900;3576000;0
1194;-1;744;0;0;0;0;.00nan;0;0
1194;85281;749;68;26;2;24;.923;3600000;0
1194;86697;749;0;0;0;0;.00nan;0;0
1315;83;737;100;49;1;48;.980;4410000;0
1315;6079;734;0;0;0;0;.00nan;0;0
1315;190570;737;0;0;0;0;.00nan;0;0
1315;44526;734;72;31;2;29;.935;4410000;0
1316;6570;3789;89;39;2;37;.949;3600000;0
1316;33480;3789;0;0;0;0;.00nan;0;0
1316;49900;1880;50;20;3;17;.850;3565000;0
1316;61276;1880;0;0;0;0;.00nan;0;0
1382;83;737;85;33;2;31;.939;3750000;0
1382;6570;3789;94;30;1;29;.967;3750000;0
1382;33480;3789;0;0;0;0;.00nan;0;0
1382;190570;737;0;0;0;0;.00nan;0;0
1383;178098;738;72;36;3;33;.917;3571000;0
1383;185442;738;0;0;0;0;.00nan;0;0
1383;186234;739;0;0;0;0;.00nan;0;0
1383;46792;739;88;41;2;39;.951;3600000;0
1384;3508;745;70;47;6;41;.872;3600000;0
1384;14335;747;83;39;2;37;.949;3600000;0
1384;196698;747;0;0;0;0;.00nan;0;0
1384;192386;745;0;0;0;0;.00nan;0;0
1385;178114;752;0;0;0;0;.00nan;0;0
1385;43731;752;95;37;2;35;.946;3513000;0
1385;85281;749;100;37;0;37;1.000;3600000;0
1385;86697;749;0;0;0;0;.00nan;0;0
1386;83;737;95;22;0;22;1.000;3600000;0
1386;6570;3789;67;25;2;23;.920;3554000;0
1386;33480;3789;0;0;0;0;.00nan;0;0
1386;190570;737;0;0;0;0;.00nan;0;0
1387;178098;738;88;58;4;54;.931;5646000;0
1387;185442;738;0;0;0;0;.00nan;0;0
1387;186234;739;0;0;0;0;.00nan;0;0
1387;46792;739;89;43;3;40;.930;5646000;0
1388;3508;745;74;36;4;32;.889;3569000;0
1388;14335;747;75;32;2;30;.938;3600000;0
1388;196698;747;0;0;0;0;.00nan;0;0
1388;192386;745;0;0;0;0;.00nan;0;0
1389;178114;752;71;39;4;35;.897;2466000;0
1389;43731;752;28;16;4;12;.750;1134000;0
1389;85281;749;74;40;4;36;.900;3600000;0
1389;86697;749;0;0;0;0;.00nan;0;0
1390;83;737;92;64;2;62;.969;5161000;0
1390;6570;3789;77;28;1;27;.964;5161000;0
1390;33480;3789;0;0;0;0;.00nan;0;0
1390;190570;737;0;0;0;0;.00nan;0;0
1391;178098;738;95;22;0;22;1.000;3600000;0
1391;185442;738;0;0;0;0;.00nan;0;0
1391;186234;739;0;0;0;0;.00nan;0;0
1391;46792;739;93;48;3;45;.938;3600000;0
1392;3508;745;67;18;1;17;.944;3600000;0
1392;14335;747;98;50;2;48;.960;3600000;0
1392;196698;747;0;0;0;0;.00nan;0;0
1392;192386;745;0;0;0;0;.00nan;0;0
1393;178114;752;0;0;0;0;.00nan;0;0
1393;43731;752;100;38;0;38;1.000;3600000;0
1393;85281;749;47;36;5;31;.861;3600000;0
1393;86697;749;0;0;0;0;.00nan;0;0
1394;83;737;77;48;5;43;.896;3600000;0
1394;6570;3789;73;26;2;24;.923;3600000;0
1394;33480;3789;0;0;0;0;.00nan;0;0
1394;190570;737;0;0;0;0;.00nan;0;0
1395;178098;738;76;25;2;23;.920;3600000;0
1395;185442;738;0;0;0;0;.00nan;0;0
1395;186234;739;0;0;0;0;.00nan;0;0
1395;46792;739;46;32;4;28;.875;3587000;0
1396;3508;745;97;50;3;47;.940;4112000;0
1396;14335;747;82;49;4;45;.918;4112000;0
1396;196698;747;0;0;0;0;.00nan;0;0
1396;192386;745;0;0;0;0;.00nan;0;0
1397;178114;752;0;0;0;0;.00nan;0;0
1397;43731;752;90;32;1;31;.969;3600000;0
1397;85281;749;32;35;7;28;.800;3600000;0
1397;86697;749;0;0;0;0;.00nan;0;0
1606;83;737;98;24;0;24;1.000;3600000;0
1606;6570;3789;49;14;2;12;.857;3593000;0
1606;33480;3789;0;0;0;0;.00nan;0;0
1606;190570;737;0;0;0;0;.00nan;0;0
1607;178098;738;52;30;4;26;.867;3578000;0
1607;185442;738;0;0;0;0;.00nan;0;0
1607;186234;739;0;0;0;0;.00nan;0;0
1607;46792;739;80;33;3;30;.909;3600000;0
1608;3508;745;95;42;1;41;.976;3600000;0
1608;14335;747;78;33;2;31;.939;3552000;0
1608;196698;747;0;0;0;0;.00nan;0;0
1608;192386;745;0;0;0;0;.00nan;0;0
1609;178114;752;0;0;0;0;.00nan;0;0
1609;43731;752;86;32;2;30;.938;3600000;0
1609;85281;749;58;27;3;24;.889;3590000;0
1609;86697;749;0;0;0;0;.00nan;0;0
1673;83;737;89;44;3;41;.932;3600000;0
1673;6570;3789;100;30;0;30;1.000;3600000;0
1673;33480;3789;0;0;0;0;.00nan;0;0
1673;190570;737;0;0;0;0;.00nan;0;0
1674;178098;738;39;31;5;26;.839;3600000;0
1674;185442;738;0;0;0;0;.00nan;0;0
1674;186234;739;0;0;0;0;.00nan;0;0
1674;46792;739;99;43;2;41;.953;3600000;0
1675;3508;745;99;44;2;42;.955;4759000;0
1675;14335;747;73;35;3;32;.914;4759000;0
1675;196698;747;0;0;0;0;.00nan;0;0
1675;192386;745;0;0;0;0;.00nan;0;0
1676;178114;752;80;15;0;15;1.000;1642000;0
1676;43731;752;34;19;4;15;.789;1958000;0
1676;85281;749;99;36;1;35;.972;3600000;0
1676;86697;749;0;0;0;0;.00nan;0;0
1739;178114;752;0;0;0;0;.00nan;0;0
1739;43731;752;72;38;5;33;.868;3600000;0
1739;85281;749;93;31;1;30;.968;3600000;0
1739;86697;749;0;0;0;0;.00nan;0;0
1841;6570;3789;59;22;2;20;.909;3600000;0
1841;33480;3789;0;0;0;0;.00nan;0;0
1841;186234;739;0;0;0;0;.00nan;0;0
1841;46792;739;61;37;4;33;.892;3577000;0
1842;3508;745;81;38;3;35;.921;3831000;0
1842;192386;745;0;0;0;0;.00nan;0;0
1842;85281;749;66;37;4;33;.892;3831000;0
1842;86697;749;0;0;0;0;.00nan;0;0
1843;6570;3789;72;27;2;25;.926;3600000;0
1843;33480;3789;0;0;0;0;.00nan;0;0
1843;186234;739;0;0;0;0;.00nan;0;0
1843;46792;739;86;39;3;36;.923;3600000;0
1844;3508;745;94;44;2;42;.955;3928000;0
1844;192386;745;0;0;0;0;.00nan;0;0
1844;85281;749;84;25;1;24;.960;3928000;0
1844;86697;749;0;0;0;0;.00nan;0;0
1845;6570;3789;44;30;5;25;.833;3819000;0
1845;33480;3789;0;0;0;0;.00nan;0;0
1845;186234;739;0;0;0;0;.00nan;0;0
1845;46792;739;72;43;4;39;.907;3819000;0
1846;3508;745;66;19;1;18;.947;3600000;0
1846;192386;745;0;0;0;0;.00nan;0;0
1846;85281;749;98;48;4;44;.917;3600000;0
1846;86697;749;0;0;0;0;.00nan;0;0
1847;6570;3789;69;17;1;16;.941;3600000;0
1847;33480;3789;0;0;0;0;.00nan;0;0
1847;186234;739;0;0;0;0;.00nan;0;0
1847;46792;739;92;42;2;40;.952;3572000;0
1848;3508;745;98;42;3;39;.929;3587000;0
1848;192386;745;0;0;0;0;.00nan;0;0
1848;85281;749;74;20;1;19;.950;3600000;0
1848;86697;749;0;0;0;0;.00nan;0;0
1975;6570;3789;62;21;2;19;.905;4307000;0
1975;33480;3789;0;0;0;0;.00nan;0;0
1975;186234;739;0;0;0;0;.00nan;0;0
1975;46792;739;100;44;1;43;.977;4307000;0
1976;3508;745;65;28;3;25;.893;3543000;0
1976;192386;745;0;0;0;0;.00nan;0;0
1976;85281;749;80;30;2;28;.933;3600000;0
1976;86697;749;0;0;0;0;.00nan;0;0
2022;6570;3789;78;39;3;36;.923;3600000;0
2022;33480;3789;0;0;0;0;.00nan;0;0
2022;186234;739;0;0;0;0;.00nan;0;0
2022;46792;739;94;20;0;20;1.000;3600000;0
2023;3508;745;23;26;6;20;.769;2760000;0
2023;192386;745;35;12;3;9;.750;840000;0
2023;85281;749;82;29;1;28;.966;3600000;0
2023;86697;749;0;0;0;0;.00nan;0;0
2071;6570;3789;64;15;1;14;.933;3704000;0
2071;33480;3789;0;0;0;0;.00nan;0;0
2071;186234;739;0;0;0;0;.00nan;0;0
2071;46792;739;87;36;2;34;.944;3704000;0
2074;6570;3789;92;38;3;35;.921;3600000;0
2074;33480;3789;0;0;0;0;.00nan;0;0
2074;85281;749;78;38;4;34;.895;3600000;0
2074;86697;749;0;0;0;0;.00nan;0;0
2075;6570;3789;72;19;1;18;.947;3600000;0
2075;33480;3789;0;0;0;0;.00nan;0;0
2075;85281;749;81;26;2;24;.923;3579000;0
2075;86697;749;0;0;0;0;.00nan;0;0
2076;6570;3789;100;39;0;39;1.000;3600000;0
2076;33480;3789;0;0;0;0;.00nan;0;0
2076;85281;749;74;33;2;31;.939;3525000;0
2076;86697;749;0;0;0;0;.00nan;0;0
2077;6570;3789;78;38;3;35;.921;3572000;0
2077;33480;3789;0;0;0;0;.00nan;0;0
2077;85281;749;67;25;2;23;.920;3600000;0
2077;86697;749;0;0;0;0;.00nan;0;0
2303;6570;3789;100;21;0;21;1.000;3600000;0
2303;33480;3789;0;0;0;0;.00nan;0;0
2303;85281;749;53;36;5;31;.861;3600000;0
2303;86697;749;0;0;0;0;.00nan;0;0
3656;6389;576;0;0;0;0;.00nan;0;0
3656;22684;570;83;29;2;27;.931;3900000;0
3656;64911;576;84;35;2;33;.943;3900000;0
3656;90734;570;0;0;0;0;.00nan;0;0
3657;320;564;71;30;2;28;.933;3600000;0
3657;61999;573;0;0;0;0;.00nan;0;0
3657;64925;573;73;47;4;43;.915;3534000;0
3657;78251;564;0;0;0;0;.00nan;0;0
3658;4386;571;81;25;1;24;.960;3900000;0
3658;37790;577;0;0;0;0;.00nan;0;0
3658;40087;571;0;0;0;0;.00nan;0;0
3658;85749;577;96;47;1;46;.979;3900000;0
3659;11925;574;59;30;4;26;.867;3529000;0
3659;185232;568;0;0;0;0;.00nan;0;0
3659;38228;568;70;31;2;29;.935;3600000;0
3659;68167;574;0;0;0;0;.00nan;0;0
3660;14047;578;82;26;1;25;.962;3545000;0
3660;14459;578;0;0;0;0;.00nan;0;0
3660;56126;575;0;0;0;0;.00nan;0;0
3660;66245;575;100;26;0;26;1.000;3600000;0
3661;483;569;97;21;0;21;1.000;3600000;0
3661;4504;565;0;0;0;0;.00nan;0;0
3661;7500;569;0;0;0;0;.00nan;0;0
3661;170042;565;87;30;1;29;.967;3553000;0
3662;174736;566;92;31;1;30;.968;3600000;0
3662;32255;566;0;0;0;0;.00nan;0;0
3662;73939;572;56;32;4;28;.875;3600000;0
3662;84430;572;0;0;0;0;.00nan;0;0
3663;6389;576;0;0;0;0;.00nan;0;0
3663;61999;573;0;0;0;0;.00nan;0;0
3663;64911;576;61;52;6;46;.885;3600000;0
3663;64925;573;51;19;3;16;.842;3600000;0
3664;22684;570;100;27;0;27;1.000;3600000;0
3664;185232;568;0;0;0;0;.00nan;0;0
3664;38228;568;64;25;3;22;.880;3600000;0
3664;90734;570;0;0;0;0;.00nan;0;0
3665;4386;571;82;32;2;30;.938;3600000;0
3665;40087;571;0;0;0;0;.00nan;0;0
3665;56126;575;30;32;6;26;.813;3360000;0
3665;66245;575;49;1;0;1;1.000;240000;0
3666;11438;562;0;0;0;0;.00nan;0;0
3666;174736;566;0;0;0;0;.00nan;0;0
3666;32255;566;45;15;3;12;.800;3600000;0
3666;76574;562;100;56;0;56;1.000;3600000;0
3667;320;564;0;0;0;0;.00nan;0;0
3667;483;569;93;41;3;38;.927;3575000;0
3667;7500;569;0;0;0;0;.00nan;0;0
3667;78251;564;68;22;2;20;.909;3600000;0
3668;320;564;0;0;0;0;.00nan;0;0
3668;14047;578;95;41;2;39;.951;3600000;0
3668;14459;578;0;0;0;0;.00nan;0;0
3668;78251;564;59;34;4;30;.882;3557000;0
3669;22684;570;70;21;2;19;.905;3600000;0
3669;61999;573;62;8;0;8;1.000;466000;0
3669;64925;573;51;42;7;35;.833;3134000;0
3669;90734;570;0;0;0;0;.00nan;0;0
3670;11925;574;52;35;4;31;.886;3900000;0
3670;37790;577;0;0;0;0;.00nan;0;0
3670;68167;574;0;0;0;0;.00nan;0;0
3670;85749;577;76;36;4;32;.889;3900000;0
3671;4386;571;78;35;2;33;.943;3600000;0
3671;40087;571;0;0;0;0;.00nan;0;0
3671;56126;575;34;35;7;28;.800;3222000;0
3671;66245;575;53;3;0;3;1.000;378000;0
3672;6389;576;0;0;0;0;.00nan;0;0
3672;11438;562;52;2;0;2;1.000;470000;0
3672;64911;576;51;13;2;11;.846;3600000;0
3672;76574;562;58;44;6;38;.864;3130000;0
3673;4504;565;100;40;1;39;.975;3600000;0
3673;170042;565;0;0;0;0;.00nan;0;0
3673;73939;572;0;0;0;0;.00nan;0;0
3673;84430;572;76;30;2;28;.933;3552000;0
3674;483;569;52;42;6;36;.857;3285000;0
3674;7500;569;48;0;0;0;.00nan;315000;0
3674;38228;568;0;0;0;0;.00nan;0;0
3674;64923;568;87;29;2;27;.931;3600000;0
3675;22684;570;0;0;0;0;.00nan;0;0
3675;37790;577;0;0;0;0;.00nan;0;0
3675;85749;577;90;17;0;17;1.000;3600000;0
3675;90734;570;69;23;1;22;.957;3590000;0
3676;4386;571;71;26;2;24;.923;3600000;0
3676;11438;562;0;0;0;0;.00nan;0;0
3676;40087;571;0;0;0;0;.00nan;0;0
3676;76574;562;95;46;2;44;.957;3583000;0
3677;11925;574;0;0;0;0;.00nan;0;0
3677;174736;566;36;20;4;16;.800;2108000;0
3677;32255;566;50;14;2;12;.857;1446000;0
3677;68167;574;63;34;4;30;.882;3600000;0
3678;14047;578;94;37;1;36;.973;3600000;0
3678;14459;578;0;0;0;0;.00nan;0;0
3678;73939;572;0;0;0;0;.00nan;0;0
3678;84430;572;38;26;5;21;.808;3600000;0
3679;4504;565;86;29;2;27;.931;3600000;0
3679;170042;565;0;0;0;0;.00nan;0;0
3679;38228;568;0;0;0;0;.00nan;0;0
3679;64923;568;71;39;3;36;.923;3600000;0
3680;6389;576;0;0;0;0;.00nan;0;0
3680;61999;573;0;0;0;0;.00nan;0;0
3680;64911;576;49;29;4;25;.862;3600000;0
3680;64925;573;99;45;1;44;.978;3600000;0
3681;320;564;0;0;0;0;.00nan;0;0
3681;56126;575;0;0;0;0;.00nan;0;0
3681;66245;575;68;40;4;36;.900;3600000;0
3681;78251;564;73;25;1;24;.960;3600000;0
3682;320;564;0;0;0;0;.00nan;0;0
3682;37790;577;0;0;0;0;.00nan;0;0
3682;78251;564;85;41;3;38;.927;3600000;0
3682;85749;577;70;26;2;24;.923;3600000;0
3683;11438;562;0;0;0;0;.00nan;0;0
3683;22684;570;63;15;1;14;.933;3600000;0
3683;76574;562;97;59;2;57;.966;3556000;0
3683;90734;570;0;0;0;0;.00nan;0;0
3684;61999;573;98;48;3;45;.938;3900000;0
3684;64925;573;0;0;0;0;.00nan;0;0
3684;73939;572;68;30;3;27;.900;3900000;0
3684;84430;572;0;0;0;0;.00nan;0;0
3685;6389;576;0;0;0;0;.00nan;0;0
3685;14047;578;33;25;6;19;.760;2965000;0
3685;14459;578;61;5;0;5;1.000;635000;0
3685;64911;576;81;22;1;21;.955;3600000;0
3686;483;569;98;49;1;48;.980;3553000;0
3686;4386;571;94;20;0;20;1.000;3600000;0
3686;7500;569;0;0;0;0;.00nan;0;0
3686;40087;571;0;0;0;0;.00nan;0;0
3687;320;564;68;36;4;32;.889;3600000;0
3687;22684;570;40;29;5;24;.828;3551000;0
3687;78251;564;0;0;0;0;.00nan;0;0
3687;90734;570;0;0;0;0;.00nan;0;0
3688;4386;571;66;28;3;25;.893;3600000;0
3688;11925;574;79;31;2;29;.935;3600000;0
3688;40087;571;0;0;0;0;.00nan;0;0
3688;68167;574;0;0;0;0;.00nan;0;0
3689;4504;565;73;22;1;21;.955;3600000;0
3689;6389;576;0;0;0;0;.00nan;0;0
3689;170042;565;0;0;0;0;.00nan;0;0
3689;64911;576;77;37;2;35;.946;3600000;0
3690;37790;577;0;0;0;0;.00nan;0;0
3690;73939;572;0;0;0;0;.00nan;0;0
3690;84430;572;96;50;4;46;.920;3513000;0
3690;85749;577;74;24;2;22;.917;3600000;0
3691;483;569;78;34;2;32;.941;3900000;0
3691;7500;569;0;0;0;0;.00nan;0;0
3691;56126;575;0;0;0;0;.00nan;0;0
3691;66245;575;78;30;2;28;.933;3900000;0
3692;14047;578;42;9;2;7;.778;1059000;0
3692;14459;578;34;27;6;21;.778;2541000;0
3692;174736;566;52;20;3;17;.850;3600000;0
3692;32255;566;0;0;0;0;.00nan;0;0
3693;38228;568;0;0;0;0;.00nan;0;0
3693;64923;568;45;35;5;30;.857;3600000;0
3693;64925;573;65;24;2;22;.917;2388000;0
3693;84945;573;24;14;4;10;.714;1163000;0
3694;14047;578;63;29;3;26;.897;3600000;0
3694;14459;578;0;0;0;0;.00nan;0;0
3694;61999;573;0;0;0;0;.00nan;0;0
3694;64925;573;95;36;1;35;.972;3600000;0
3695;11925;574;97;49;0;49;1.000;3900000;0
3695;22684;570;86;15;0;15;1.000;3900000;0
3695;68167;574;0;0;0;0;.00nan;0;0
3695;90734;570;0;0;0;0;.00nan;0;0
3696;11438;562;0;0;0;0;.00nan;0;0
3696;37790;577;0;0;0;0;.00nan;0;0
3696;76574;562;97;32;2;30;.938;3600000;0
3696;85749;577;50;21;3;18;.857;3600000;0
3697;4386;571;59;29;3;26;.897;3600000;0
3697;174736;566;0;0;0;0;.00nan;0;0
3697;32255;566;58;35;4;31;.886;3567000;0
3697;40087;571;0;0;0;0;.00nan;0;0
3698;6389;576;66;35;4;31;.886;3600000;0
3698;64911;576;0;0;0;0;.00nan;0;0
3698;73939;572;98;27;0;27;1.000;3600000;0
3698;84430;572;0;0;0;0;.00nan;0;0
3699;483;569;91;35;2;33;.943;3600000;0
3699;4504;565;58;30;4;26;.867;3600000;0
3699;7500;569;0;0;0;0;.00nan;0;0
3699;170042;565;0;0;0;0;.00nan;0;0
3700;174736;566;88;34;2;32;.941;3600000;0
3700;32255;566;0;0;0;0;.00nan;0;0
3700;61999;573;0;0;0;0;.00nan;0;0
3700;64925;573;19;46;10;36;.783;3600000;0
3701;11438;562;0;0;0;0;.00nan;0;0
3701;64925;573;0;0;0;0;.00nan;0;0
3701;76574;562;55;38;4;34;.895;3600000;0
3701;84945;573;100;24;0;24;1.000;3600000;0
3702;11925;574;59;22;3;19;.864;3900000;0
3702;14047;578;74;44;3;41;.932;3900000;0
3702;14459;578;0;0;0;0;.00nan;0;0
3702;68167;574;0;0;0;0;.00nan;0;0
3703;4504;565;0;0;0;0;.00nan;0;0
3703;170042;565;83;24;2;22;.917;3600000;0
3703;56126;575;0;0;0;0;.00nan;0;0
3703;66245;575;79;37;3;34;.919;3594000;0
3704;4386;571;90;31;1;30;.968;3600000;0
3704;6389;576;0;0;0;0;.00nan;0;0
3704;40087;571;0;0;0;0;.00nan;0;0
3704;64911;576;38;28;5;23;.821;3600000;0
3705;483;569;66;26;2;24;.923;3512000;0
3705;7500;569;0;0;0;0;.00nan;0;0
3705;73939;572;100;33;0;33;1.000;3600000;0
3705;84430;572;0;0;0;0;.00nan;0;0
3706;320;564;0;0;0;0;.00nan;0;0
3706;38228;568;72;34;3;31;.912;3600000;0
3706;64923;568;0;0;0;0;.00nan;0;0
3706;78251;564;100;33;0;33;1.000;3600000;0
3707;320;564;44;28;5;23;.821;3600000;0
3707;38228;568;0;0;0;0;.00nan;0;0
3707;64923;568;100;48;0;48;1.000;3600000;0
3707;78251;564;0;0;0;0;.00nan;0;0
3708;11438;562;77;38;3;35;.921;3900000;0
3708;73939;572;72;28;3;25;.893;3900000;0
3708;76574;562;0;0;0;0;.00nan;0;0
3708;84430;572;0;0;0;0;.00nan;0;0
3709;11925;574;0;0;0;0;.00nan;0;0
3709;56126;575;80;23;1;22;.957;3600000;0
3709;66245;575;0;0;0;0;.00nan;0;0
3709;68167;574;74;42;4;38;.905;3600000;0
3710;22684;570;76;43;4;39;.907;3600000;0
3710;32255;566;0;0;0;0;.00nan;0;0
3710;85633;566;100;33;0;33;1.000;3600000;0
3710;90734;570;0;0;0;0;.00nan;0;0
3711;483;569;61;33;4;29;.879;3600000;0
3711;7500;569;0;0;0;0;.00nan;0;0
3711;37790;577;0;0;0;0;.00nan;0;0
3711;85749;577;80;25;1;24;.960;3600000;0
3712;6389;576;0;0;0;0;.00nan;0;0
3712;14047;578;0;0;0;0;.00nan;0;0
3712;14459;578;63;32;4;28;.875;3600000;0
3712;64911;576;79;10;0;10;1.000;3600000;0
3713;6389;576;0;0;0;0;.00nan;0;0
3713;32255;566;0;0;0;0;.00nan;0;0
3713;64911;576;90;38;1;37;.974;3600000;0
3713;85633;566;91;19;0;19;1.000;3600000;0
3714;320;564;0;0;0;0;.00nan;0;0
3714;11925;574;99;50;2;48;.960;3600000;0
3714;68167;574;0;0;0;0;.00nan;0;0
3714;78251;564;64;35;4;31;.886;3560000;0
3715;4386;571;91;29;1;28;.966;3600000;0
3715;40087;571;0;0;0;0;.00nan;0;0
3715;73939;572;68;36;3;33;.917;3586000;0
3715;84430;572;0;0;0;0;.00nan;0;0
3716;22684;570;85;52;3;49;.942;3900000;0
3716;38228;568;0;0;0;0;.00nan;0;0
3716;64923;568;72;34;3;31;.912;3900000;0
3716;90734;570;0;0;0;0;.00nan;0;0
3717;483;569;56;12;1;11;.917;3600000;0
3717;7500;569;0;0;0;0;.00nan;0;0
3717;11438;562;76;17;0;17;1.000;1539000;0
3717;76574;562;24;27;6;21;.778;2061000;0
3718;4504;565;70;19;1;18;.947;3600000;0
3718;170042;565;0;0;0;0;.00nan;0;0
3718;64925;573;0;0;0;0;.00nan;0;0
3718;84945;573;93;49;3;46;.939;3549000;0
3719;6389;576;0;0;0;0;.00nan;0;0
3719;56126;575;69;13;0;13;1.000;1329000;0
3719;64911;576;76;34;2;32;.941;3600000;0
3719;66245;575;39;19;4;15;.789;2256000;0
3720;483;569;54;18;4;14;.778;3821000;0
3720;7500;569;0;0;0;0;.00nan;0;0
3720;14047;578;79;39;3;36;.923;3821000;0
3720;14459;578;0;0;0;0;.00nan;0;0
3721;4386;571;79;36;2;34;.944;3900000;0
3721;22684;570;83;36;2;34;.944;3900000;0
3721;40087;571;0;0;0;0;.00nan;0;0
3721;90734;570;0;0;0;0;.00nan;0;0
3722;32255;566;0;0;0;0;.00nan;0;0
3722;37790;577;0;0;0;0;.00nan;0;0
3722;85633;566;58;28;3;25;.893;3600000;0
3722;85749;577;91;32;2;30;.938;3600000;0
3723;38228;568;0;0;0;0;.00nan;0;0
3723;64923;568;93;54;3;51;.944;3706000;0
3723;73939;572;55;17;2;15;.882;3706000;0
3723;84430;572;0;0;0;0;.00nan;0;0
3724;320;564;0;0;0;0;.00nan;0;0
3724;11438;562;0;0;0;0;.00nan;0;0
3724;76574;562;92;49;3;46;.939;3558000;0
3724;78251;564;69;19;1;18;.947;3600000;0
3725;22684;570;0;0;0;0;.00nan;0;0
3725;56126;575;0;0;0;0;.00nan;0;0
3725;66245;575;74;35;3;32;.914;3569000;0
3725;90734;570;98;43;2;41;.953;3600000;0
3726;4386;571;0;0;0;0;.00nan;0;0
3726;40087;571;62;21;2;19;.905;3600000;0
3726;64925;573;0;0;0;0;.00nan;0;0
3726;84945;573;58;33;4;29;.879;3600000;0
3727;483;569;0;0;0;0;.00nan;0;0
3727;7500;569;73;36;3;33;.917;3600000;0
3727;37790;577;74;23;1;22;.957;3600000;0
3727;85749;577;0;0;0;0;.00nan;0;0
3728;4504;565;79;26;2;24;.923;3600000;0
3728;11925;574;54;31;4;27;.871;3568000;0
3728;170042;565;0;0;0;0;.00nan;0;0
3728;68167;574;0;0;0;0;.00nan;0;0
3729;6389;576;0;0;0;0;.00nan;0;0
3729;38228;568;0;0;0;0;.00nan;0;0
3729;64911;576;77;25;2;23;.920;3600000;0
3729;64923;568;74;36;3;33;.917;3572000;0
3730;32255;566;0;0;0;0;.00nan;0;0
3730;73939;572;0;0;0;0;.00nan;0;0
3730;84430;572;86;48;4;44;.917;3600000;0
3730;85633;566;33;35;6;29;.829;3560000;0
3731;320;564;78;23;1;22;.957;3600000;0
3731;4386;571;74;27;2;25;.926;3571000;0
3731;40087;571;0;0;0;0;.00nan;0;0
3731;78251;564;0;0;0;0;.00nan;0;0
3732;11438;562;0;0;0;0;.00nan;0;0
3732;22684;570;66;20;1;19;.950;3600000;0
3732;76574;562;98;48;2;46;.958;3594000;0
3732;90734;570;0;0;0;0;.00nan;0;0
3733;4504;565;87;39;2;37;.949;3600000;0
3733;170042;565;0;0;0;0;.00nan;0;0
3733;56126;575;43;33;6;27;.818;3600000;0
3733;66245;575;0;0;0;0;.00nan;0;0
3734;14047;578;97;35;1;34;.971;3900000;0
3734;14459;578;0;0;0;0;.00nan;0;0
3734;38228;568;91;22;1;21;.955;3900000;0
3734;64923;568;0;0;0;0;.00nan;0;0
3735;4504;565;0;0;0;0;.00nan;0;0
3735;11438;562;49;39;6;33;.846;3302000;0
3735;170042;565;85;14;0;14;1.000;3600000;0
3735;76574;562;41;2;1;1;.500;298000;0
3736;320;564;0;0;0;0;.00nan;0;0
3736;64925;573;0;0;0;0;.00nan;0;0
3736;78251;564;52;29;4;25;.862;3600000;0
3736;84945;573;58;37;5;32;.865;3600000;0
3737;22684;570;80;33;2;31;.939;3600000;0
3737;37790;577;0;0;0;0;.00nan;0;0
3737;85749;577;47;24;4;20;.833;3546000;0
3737;90734;570;0;0;0;0;.00nan;0;0
3738;4386;571;57;16;2;14;.875;3600000;0
3738;38228;568;0;0;0;0;.00nan;0;0
3738;40087;571;0;0;0;0;.00nan;0;0
3738;64923;568;45;36;5;31;.861;3600000;0
3739;6389;576;0;0;0;0;.00nan;0;0
3739;11925;574;75;25;1;24;.960;3600000;0
3739;64911;576;80;31;2;29;.935;3578000;0
3739;68167;574;0;0;0;0;.00nan;0;0
3740;483;569;54;29;5;24;.828;3600000;0
3740;7500;569;0;0;0;0;.00nan;0;0
3740;32255;566;0;0;0;0;.00nan;0;0
3740;85633;566;55;29;4;25;.862;3600000;0
3741;320;564;96;23;0;23;1.000;3600000;0
3741;22684;570;0;0;0;0;.00nan;0;0
3741;78251;564;0;0;0;0;.00nan;0;0
3741;90734;570;98;37;2;35;.946;3517000;0
3742;11438;562;0;0;0;0;.00nan;0;0
3742;14047;578;51;31;4;27;.871;3636000;0
3742;14459;578;0;0;0;0;.00nan;0;0
3742;76574;562;73;34;3;31;.912;3636000;0
3743;4504;565;0;0;0;0;.00nan;0;0
3743;170042;565;100;41;2;39;.951;3600000;0
3743;73939;572;48;26;4;22;.846;3511000;0
3743;84430;572;0;0;0;0;.00nan;0;0
3744;56126;575;0;0;0;0;.00nan;0;0
3744;64925;573;46;14;2;12;.857;462000;0
3744;66245;575;87;20;0;20;1.000;3600000;0
3744;84945;573;55;56;7;49;.875;3138000;0
3745;4386;571;0;0;0;0;.00nan;0;0
3745;32255;566;100;34;0;34;1.000;3600000;0
3745;40087;571;70;19;1;18;.947;3576000;0
3745;85633;566;0;0;0;0;.00nan;0;0
3746;6389;576;0;0;0;0;.00nan;0;0
3746;38228;568;83;29;2;27;.931;3582000;0
3746;64911;576;89;18;0;18;1.000;3600000;0
3746;64923;568;0;0;0;0;.00nan;0;0
3747;11925;574;0;0;0;0;.00nan;0;0
3747;37790;577;82;27;1;26;.963;3600000;0
3747;68167;574;68;31;3;28;.903;3600000;0
3747;85749;577;0;0;0;0;.00nan;0;0
3748;4386;571;81;27;1;26;.963;3600000;0
3748;14047;578;56;32;4;28;.875;3600000;0
3748;14459;578;0;0;0;0;.00nan;0;0
3748;40087;571;0;0;0;0;.00nan;0;0
3749;320;564;58;14;2;12;.857;3600000;0
3749;11438;562;0;0;0;0;.00nan;0;0
3749;76574;562;66;32;3;29;.906;3562000;0
3749;78251;564;0;0;0;0;.00nan;0;0
3750;4504;565;0;0;0;0;.00nan;0;0
3750;170042;565;87;26;2;24;.923;3600000;0
3750;37790;577;0;0;0;0;.00nan;0;0
3750;85749;577;98;43;3;40;.930;3558000;0
3751;14047;578;0;0;0;0;.00nan;0;0
3751;14459;578;63;38;5;33;.868;3580000;0
3751;22684;570;38;19;4;15;.789;3600000;0
3751;90734;570;0;0;0;0;.00nan;0;0
3752;4386;571;95;37;2;35;.946;3900000;0
3752;11925;574;70;34;2;32;.941;3900000;0
3752;40087;571;0;0;0;0;.00nan;0;0
3752;68167;574;0;0;0;0;.00nan;0;0
3753;6389;576;0;0;0;0;.00nan;0;0
3753;64911;576;69;17;1;16;.941;3600000;0
3753;73939;572;98;48;2;46;.958;3545000;0
3753;84430;572;0;0;0;0;.00nan;0;0
3754;32255;566;82;14;0;14;1.000;3600000;0
3754;56126;575;0;0;0;0;.00nan;0;0
3754;66245;575;69;40;4;36;.900;3600000;0
3754;85633;566;0;0;0;0;.00nan;0;0
3755;11438;562;60;48;6;42;.875;3600000;0
3755;38228;568;0;0;0;0;.00nan;0;0
3755;64923;568;65;23;2;21;.913;3600000;0
3755;76574;562;0;0;0;0;.00nan;0;0
3756;22684;570;94;17;0;17;1.000;3600000;0
3756;73939;572;0;0;0;0;.00nan;0;0
3756;84430;572;90;40;2;38;.950;3521000;0
3756;90734;570;0;0;0;0;.00nan;0;0
3757;11925;574;0;0;0;0;.00nan;0;0
3757;64925;573;0;0;0;0;.00nan;0;0
3757;68167;574;75;34;3;31;.912;3900000;0
3757;84945;573;87;47;3;44;.936;3900000;0
3758;4504;565;0;0;0;0;.00nan;0;0
3758;170042;565;85;52;4;48;.923;3600000;0
3758;32255;566;0;0;0;0;.00nan;0;0
3758;85633;566;92;27;1;26;.963;3600000;0
3759;6389;576;38;24;5;19;.792;3600000;0
3759;37790;577;0;0;0;0;.00nan;0;0
3759;64911;576;0;0;0;0;.00nan;0;0
3759;85749;577;100;39;0;39;1.000;3600000;0
3760;38228;568;71;22;1;21;.955;3600000;0
3760;56126;575;80;53;5;48;.906;3600000;0
3760;64923;568;0;0;0;0;.00nan;0;0
3760;66245;575;0;0;0;0;.00nan;0;0
3761;483;569;81;27;2;25;.926;3852000;0
3761;7500;569;0;0;0;0;.00nan;0;0
3761;14047;578;100;43;1;42;.977;3852000;0
3761;14459;578;0;0;0;0;.00nan;0;0
3762;483;569;0;0;0;0;.00nan;0;0
3762;7500;569;63;31;3;28;.903;3900000;0
3762;64925;573;0;0;0;0;.00nan;0;0
3762;84945;573;80;39;3;36;.923;3900000;0
3763;37790;577;0;0;0;0;.00nan;0;0
3763;73939;572;88;33;1;32;.970;3574000;0
3763;84430;572;0;0;0;0;.00nan;0;0
3763;85749;577;93;24;0;24;1.000;3600000;0
3764;11438;562;0;0;0;0;.00nan;0;0
3764;56126;575;0;0;0;0;.00nan;0;0
3764;66245;575;68;20;2;18;.900;3600000;0
3764;76574;562;72;42;4;38;.905;3587000;0
3765;4386;571;68;26;3;23;.885;3900000;0
3765;40087;571;0;0;0;0;.00nan;0;0
3765;64925;573;0;0;0;0;.00nan;0;0
3765;84945;573;52;28;3;25;.893;3891000;0
3766;320;564;42;29;5;24;.828;3600000;0
3766;32255;566;0;0;0;0;.00nan;0;0
3766;78251;564;0;0;0;0;.00nan;0;0
3766;85633;566;100;49;2;47;.959;3600000;0
3767;4504;565;74;34;2;32;.941;3586000;0
3767;170042;565;0;0;0;0;.00nan;0;0
3767;38228;568;0;0;0;0;.00nan;0;0
3767;64923;568;59;23;2;21;.913;3600000;0
3768;483;569;62;26;3;23;.885;3900000;0
3768;6389;576;0;0;0;0;.00nan;0;0
3768;7500;569;0;0;0;0;.00nan;0;0
3768;64911;576;64;24;3;21;.875;3900000;0
3769;38228;568;41;22;4;18;.818;3600000;0
3769;64923;568;0;0;0;0;.00nan;0;0
3769;73939;572;59;25;3;22;.880;3600000;0
3769;84430;572;0;0;0;0;.00nan;0;0
3770;320;564;0;0;0;0;.00nan;0;0
3770;6389;576;0;0;0;0;.00nan;0;0
3770;64911;576;97;41;1;40;.976;3900000;0
3770;78251;564;93;30;1;29;.967;3900000;0
3771;32255;566;0;0;0;0;.00nan;0;0
3771;64925;573;79;40;3;37;.925;3600000;0
3771;84945;573;0;0;0;0;.00nan;0;0
3771;85633;566;65;39;4;35;.897;3571000;0
3772;14047;578;58;32;4;28;.875;3600000;0
3772;14459;578;0;0;0;0;.00nan;0;0
3772;37790;577;0;0;0;0;.00nan;0;0
3772;85749;577;49;24;3;21;.875;3600000;0
3773;11438;562;0;0;0;0;.00nan;0;0
3773;11925;574;40;13;3;10;.769;3600000;0
3773;68167;574;0;0;0;0;.00nan;0;0
3773;76574;562;68;43;4;39;.907;3587000;0
3774;4504;565;0;0;0;0;.00nan;0;0
3774;170042;565;90;38;2;36;.947;3574000;0
3774;22684;570;77;23;1;22;.957;3600000;0
3774;90734;570;0;0;0;0;.00nan;0;0
3775;11438;562;89;31;2;29;.935;3900000;0
3775;64925;573;0;0;0;0;.00nan;0;0
3775;76574;562;0;0;0;0;.00nan;0;0
3775;84945;573;78;25;2;23;.920;3900000;0
3776;4504;565;81;44;3;41;.932;3900000;0
3776;170042;565;0;0;0;0;.00nan;0;0
3776;22684;570;59;24;3;21;.875;3873000;0
3776;90734;570;0;0;0;0;.00nan;0;0
3777;320;564;52;26;3;23;.885;3564000;0
3777;6389;576;83;32;1;31;.969;3600000;0
3777;64911;576;0;0;0;0;.00nan;0;0
3777;78251;564;0;0;0;0;.00nan;0;0
3778;4386;571;85;28;1;27;.964;3635000;0
3778;40087;571;0;0;0;0;.00nan;0;0
3778;56126;575;94;40;2;38;.950;3583000;0
3778;66245;575;0;0;0;0;.00nan;0;0
3779;11925;574;0;0;0;0;.00nan;0;0
3779;32255;566;100;32;0;32;1.000;3600000;0
3779;68167;574;54;37;4;33;.892;3600000;0
3779;85633;566;0;0;0;0;.00nan;0;0
3780;483;569;83;29;1;28;.966;3600000;0
3780;7500;569;0;0;0;0;.00nan;0;0
3780;73939;572;85;36;2;34;.944;3559000;0
3780;84430;572;0;0;0;0;.00nan;0;0
3781;14047;578;0;0;0;0;.00nan;0;0
3781;14459;578;99;42;2;40;.952;3600000;0
3781;37790;577;46;20;3;17;.850;3588000;0
3781;85749;577;0;0;0;0;.00nan;0;0
3782;14047;578;55;38;5;33;.868;3600000;0
3782;14459;578;0;0;0;0;.00nan;0;0
3782;73939;572;72;29;2;27;.931;3600000;0
3782;84430;572;0;0;0;0;.00nan;0;0
3783;11925;574;69;28;2;26;.929;3600000;0
3783;56126;575;97;29;1;28;.966;3600000;0
3783;66245;575;0;0;0;0;.00nan;0;0
3783;68167;574;0;0;0;0;.00nan;0;0
3784;4504;565;0;0;0;0;.00nan;0;0
3784;170042;565;92;56;2;54;.964;3600000;0
3784;22684;570;84;14;0;14;1.000;3600000;0
3784;90734;570;0;0;0;0;.00nan;0;0
3785;37790;577;0;0;0;0;.00nan;0;0
3785;38228;568;0;0;0;0;.00nan;0;0
3785;64923;568;74;27;2;25;.926;3600000;0
3785;85749;577;63;30;3;27;.900;3600000;0
3786;14047;578;0;0;0;0;.00nan;0;0
3786;14459;578;97;33;1;32;.970;3550000;0
3786;64925;573;100;28;0;28;1.000;3600000;0
3786;84945;573;0;0;0;0;.00nan;0;0
3787;6389;576;0;0;0;0;.00nan;0;0
3787;64721;566;0;0;0;0;.00nan;0;0
3787;64911;576;84;27;1;26;.963;3600000;0
3787;85633;566;84;38;2;36;.947;3544000;0
3788;320;564;0;0;0;0;.00nan;0;0
3788;4386;571;67;36;4;32;.889;3585000;0
3788;40087;571;0;0;0;0;.00nan;0;0
3788;78251;564;68;27;3;24;.889;3600000;0
3789;11438;562;0;0;0;0;.00nan;0;0
3789;22684;570;61;17;1;16;.941;3600000;0
3789;76574;562;87;41;2;39;.951;3579000;0
3789;90734;570;0;0;0;0;.00nan;0;0
3790;4504;565;91;26;1;25;.962;3600000;0
3790;170042;565;0;0;0;0;.00nan;0;0
3790;64925;573;75;25;2;23;.920;3559000;0
3790;84945;573;0;0;0;0;.00nan;0;0
3791;483;569;0;0;0;0;.00nan;0;0
3791;11925;574;0;0;0;0;.00nan;0;0
3791;14266;569;94;20;0;20;1.000;3600000;0
3791;68167;574;83;32;2;30;.938;3600000;0
3792;4386;571;0;0;0;0;.00nan;0;0
3792;6389;576;81;36;3;33;.917;3600000;0
3792;40087;571;51;27;4;23;.852;3557000;0
3792;64911;576;0;0;0;0;.00nan;0;0
3793;56126;575;61;31;4;27;.871;3600000;0
3793;66245;575;0;0;0;0;.00nan;0;0
3793;73939;572;92;38;3;35;.921;3600000;0
3793;84430;572;0;0;0;0;.00nan;0;0
3794;38228;568;0;0;0;0;.00nan;0;0
3794;64721;566;0;0;0;0;.00nan;0;0
3794;64923;568;89;36;2;34;.944;3600000;0
3794;85633;566;79;37;3;34;.919;3555000;0
3795;6389;576;0;0;0;0;.00nan;0;0
3795;22684;570;0;0;0;0;.00nan;0;0
3795;64911;576;77;25;1;24;.960;3569000;0
3795;90734;570;95;25;0;25;1.000;3600000;0
3796;4504;565;0;0;0;0;.00nan;0;0
3796;170042;565;48;34;6;28;.824;3600000;0
3796;37790;577;0;0;0;0;.00nan;0;0
3796;85749;577;50;18;3;15;.833;3600000;0
3797;11925;574;84;36;2;34;.944;3600000;0
3797;68167;574;0;0;0;0;.00nan;0;0
3797;73939;572;0;0;0;0;.00nan;0;0
3797;84430;572;88;30;1;29;.967;3600000;0
3798;320;564;0;0;0;0;.00nan;0;0
3798;14047;578;66;46;5;41;.891;3600000;0
3798;14459;578;0;0;0;0;.00nan;0;0
3798;78251;564;72;19;1;18;.947;3600000;0
3799;4386;571;76;16;1;15;.938;3600000;0
3799;11438;562;0;0;0;0;.00nan;0;0
3799;40087;571;0;0;0;0;.00nan;0;0
3799;76574;562;81;54;5;49;.907;3600000;0
3800;56126;575;0;0;0;0;.00nan;0;0
3800;64721;566;13;30;7;23;.767;3253000;0
3800;66245;575;84;29;2;27;.931;3600000;0
3800;85633;566;48;0;0;0;.00nan;347000;0
3801;483;569;0;0;0;0;.00nan;0;0
3801;14266;569;67;18;1;17;.944;3600000;0
3801;64925;573;95;42;2;40;.952;3600000;0
3801;84945;573;0;0;0;0;.00nan;0;0
3802;320;564;86;37;2;35;.946;3900000;0
3802;483;569;0;0;0;0;.00nan;0;0
3802;14266;569;84;32;2;30;.938;3900000;0
3802;78251;564;0;0;0;0;.00nan;0;0
3803;14047;578;46;28;4;24;.857;3546000;0
3803;14459;578;0;0;0;0;.00nan;0;0
3803;22684;570;0;0;0;0;.00nan;0;0
3803;90734;570;51;23;3;20;.870;3600000;0
3804;11438;562;0;0;0;0;.00nan;0;0
3804;11925;574;0;0;0;0;.00nan;0;0
3804;68167;574;63;23;2;21;.913;3600000;0
3804;76574;562;75;46;3;43;.935;3591000;0
3805;4386;571;83;25;1;24;.960;3600000;0
3805;4504;565;0;0;0;0;.00nan;0;0
3805;170042;565;62;31;3;28;.903;3535000;0
3805;40087;571;0;0;0;0;.00nan;0;0
3806;38228;568;0;0;0;0;.00nan;0;0
3806;56126;575;0;0;0;0;.00nan;0;0
3806;64923;568;78;24;1;23;.958;3765000;0
3806;66245;575;83;28;2;26;.929;3765000;0
3807;11925;574;65;23;2;21;.913;3600000;0
3807;37790;577;0;0;0;0;.00nan;0;0
3807;68167;574;0;0;0;0;.00nan;0;0
3807;85749;577;52;26;4;22;.846;3527000;0
3808;4504;565;0;0;0;0;.00nan;0;0
3808;14047;578;98;43;2;41;.953;3600000;0
3808;14459;578;0;0;0;0;.00nan;0;0
3808;170042;565;95;31;1;30;.968;3600000;0
3809;320;564;0;0;0;0;.00nan;0;0
3809;73939;572;25;31;6;25;.806;3286000;0
3809;78251;564;65;23;2;21;.913;3600000;0
3809;84430;572;56;5;0;5;1.000;314000;0
3810;11438;562;0;0;0;0;.00nan;0;0
3810;56126;575;92;28;1;27;.964;3600000;0
3810;66245;575;0;0;0;0;.00nan;0;0
3810;76574;562;74;39;3;36;.923;3551000;0
3811;64721;566;0;0;0;0;.00nan;0;0
3811;64925;573;46;26;3;23;.885;3900000;0
3811;84945;573;0;0;0;0;.00nan;0;0
3811;85633;566;99;50;3;47;.940;3900000;0
3812;483;569;0;0;0;0;.00nan;0;0
3812;14266;569;90;31;1;30;.968;3600000;0
3812;38228;568;0;0;0;0;.00nan;0;0
3812;64923;568;84;33;2;31;.939;3583000;0
3813;320;564;78;32;2;30;.938;3900000;0
3813;38228;568;90;38;2;36;.947;3900000;0
3813;64923;568;0;0;0;0;.00nan;0;0
3813;78251;564;0;0;0;0;.00nan;0;0
3814;483;569;0;0;0;0;.00nan;0;0
3814;14266;569;98;31;1;30;.968;3600000;0
3814;22684;570;58;24;3;21;.875;3600000;0
3814;90734;570;0;0;0;0;.00nan;0;0
3815;11438;562;100;39;1;38;.974;3600000;0
3815;64721;566;42;32;5;27;.844;3600000;0
3815;76574;562;0;0;0;0;.00nan;0;0
3815;85633;566;0;0;0;0;.00nan;0;0
3816;56126;575;0;0;0;0;.00nan;0;0
3816;64925;573;70;40;4;36;.900;3600000;0
3816;66245;575;99;38;1;37;.974;3600000;0
3816;84945;573;0;0;0;0;.00nan;0;0
3817;6389;576;0;0;0;0;.00nan;0;0
3817;37790;577;0;0;0;0;.00nan;0;0
3817;64911;576;90;22;1;21;.955;3600000;0
3817;85749;577;60;25;3;22;.880;3513000;0
3818;4504;565;0;0;0;0;.00nan;0;0
3818;14047;578;0;0;0;0;.00nan;0;0
3818;14459;578;84;33;2;31;.939;3900000;0
3818;170042;565;84;34;2;32;.941;3900000;0
3819;4386;571;85;28;2;26;.929;3600000;0
3819;40087;571;0;0;0;0;.00nan;0;0
3819;73939;572;0;0;0;0;.00nan;0;0
3819;84430;572;68;34;3;31;.912;3550000;0
3820;37790;577;0;0;0;0;.00nan;0;0
3820;38228;568;0;0;0;0;.00nan;0;0
3820;64923;568;80;40;3;37;.925;3517000;0
3820;85749;577;96;34;1;33;.971;3600000;0
3821;483;569;72;20;1;19;.950;3900000;0
3821;4386;571;65;23;1;22;.957;3900000;0
3821;32255;569;0;0;0;0;.00nan;0;0
3821;40087;571;0;0;0;0;.00nan;0;0
3822;37790;577;0;0;0;0;.00nan;0;0
3822;64925;573;82;37;2;35;.946;3547000;0
3822;84945;573;0;0;0;0;.00nan;0;0
3822;85749;577;100;27;0;27;1.000;3600000;0
3823;11925;574;0;0;0;0;.00nan;0;0
3823;14047;578;77;42;4;38;.905;3561000;0
3823;14459;578;0;0;0;0;.00nan;0;0
3823;68167;574;43;14;3;11;.786;3600000;0
3824;320;564;0;0;0;0;.00nan;0;0
3824;4504;565;0;0;0;0;.00nan;0;0
3824;170042;565;92;41;2;39;.951;3900000;0
3824;78251;564;50;11;2;9;.818;3900000;0
3825;22684;570;81;34;3;31;.912;3680000;0
3825;73939;572;83;33;2;31;.939;3680000;0
3825;84430;572;0;0;0;0;.00nan;0;0
3825;90734;570;0;0;0;0;.00nan;0;0
3826;11438;562;0;0;0;0;.00nan;0;0
3826;38228;568;0;0;0;0;.00nan;0;0
3826;64923;568;84;28;2;26;.929;3600000;0
3826;76574;562;87;47;3;44;.936;3598000;0
3827;11925;574;73;23;1;22;.957;3600000;0
3827;14047;578;0;0;0;0;.00nan;0;0
3827;14459;578;58;27;3;24;.889;3543000;0
3827;68167;574;0;0;0;0;.00nan;0;0
3828;6389;576;0;0;0;0;.00nan;0;0
3828;56126;575;0;0;0;0;.00nan;0;0
3828;64911;576;71;21;1;20;.952;3600000;0
3828;66245;575;81;37;2;35;.946;3582000;0
3829;483;569;100;28;0;28;1.000;3600000;0
3829;32255;569;0;0;0;0;.00nan;0;0
3829;64721;566;0;0;0;0;.00nan;0;0
3829;85633;566;73;27;2;25;.926;3547000;0
3830;11438;562;25;44;9;35;.795;3293000;0
3830;73939;572;90;19;0;19;1.000;3600000;0
3830;76574;562;49;2;0;2;1.000;307000;0
3830;84430;572;0;0;0;0;.00nan;0;0
3831;4386;571;97;39;1;38;.974;3600000;0
3831;22684;570;50;17;2;15;.882;3600000;0
3831;40087;571;0;0;0;0;.00nan;0;0
3831;90734;570;0;0;0;0;.00nan;0;0
3832;37790;577;0;0;0;0;.00nan;0;0
3832;64925;573;50;38;6;32;.842;2347000;0
3832;84945;573;66;12;0;12;1.000;1253000;0
3832;85749;577;62;24;3;21;.875;3600000;0
3833;483;569;24;12;4;8;.667;807000;0
3833;4504;565;84;32;2;30;.938;3600000;0
3833;170042;565;0;0;0;0;.00nan;0;0
3833;32255;569;55;7;0;7;1.000;2751000;0
3834;38228;568;73;38;4;34;.895;3900000;0
3834;64721;566;69;33;4;29;.879;3900000;0
3834;64923;568;0;0;0;0;.00nan;0;0
3834;85633;566;0;0;0;0;.00nan;0;0
3835;11925;574;0;0;0;0;.00nan;0;0
3835;64925;573;0;0;0;0;.00nan;0;0
3835;68167;574;71;26;2;24;.923;3600000;0
3835;84945;573;41;30;5;25;.833;3600000;0
3836;56126;575;54;18;2;16;.889;3900000;0
3836;66245;575;0;0;0;0;.00nan;0;0
3836;73939;572;89;34;2;32;.941;3900000;0
3836;84430;572;0;0;0;0;.00nan;0;0
3837;22684;570;71;20;1;19;.950;3600000;0
3837;38228;568;0;0;0;0;.00nan;0;0
3837;64923;568;95;46;2;44;.957;3581000;0
3837;90734;570;0;0;0;0;.00nan;0;0
3838;11438;562;0;0;0;0;.00nan;0;0
3838;37790;577;0;0;0;0;.00nan;0;0
3838;76574;562;96;49;3;46;.939;3553000;0
3838;85749;577;70;24;2;22;.917;3600000;0
3839;14047;578;91;34;2;32;.941;3600000;0
3839;14459;578;0;0;0;0;.00nan;0;0
3839;73939;572;0;0;0;0;.00nan;0;0
3839;84430;572;53;30;4;26;.867;3578000;0
3840;320;564;71;26;3;23;.885;3640000;0
3840;4386;571;72;23;2;21;.913;3640000;0
3840;40087;571;0;0;0;0;.00nan;0;0
3840;78251;564;0;0;0;0;.00nan;0;0
3841;483;569;0;0;0;0;.00nan;0;0
3841;14266;569;72;24;2;22;.917;3600000;0
3841;64911;576;61;22;3;19;.864;3560000;0
3841;142911;576;0;0;0;0;.00nan;0;0
3842;4504;565;0;0;0;0;.00nan;0;0
3842;170042;565;67;22;2;20;.909;3900000;0
3842;64721;566;0;0;0;0;.00nan;0;0
3842;85633;566;89;34;2;32;.941;3900000;0
3843;22684;570;0;0;0;0;.00nan;0;0
3843;64925;573;89;48;4;44;.917;3600000;0
3843;84945;573;0;0;0;0;.00nan;0;0
3843;90734;570;70;24;1;23;.958;3600000;0
3844;320;564;0;0;0;0;.00nan;0;0
3844;64911;576;72;28;2;26;.929;3565000;0
3844;78251;564;89;20;0;20;1.000;3600000;0
3844;142911;576;0;0;0;0;.00nan;0;0
3845;4504;565;0;0;0;0;.00nan;0;0
3845;11438;562;0;0;0;0;.00nan;0;0
3845;170042;565;90;19;0;19;1.000;3600000;0
3845;76574;562;97;38;1;37;.974;3600000;0
3846;38228;568;0;0;0;0;.00nan;0;0
3846;64923;568;100;27;0;27;1.000;3900000;0
3846;64925;573;0;0;0;0;.00nan;0;0
3846;84945;573;84;22;0;22;1.000;3900000;0
3847;14047;578;42;37;5;32;.865;2179000;0
3847;14459;578;57;13;1;12;.923;1421000;0
3847;64721;566;0;0;0;0;.00nan;0;0
3847;85633;566;61;14;1;13;.929;3600000;0
3848;4386;571;94;25;1;24;.960;3900000;0
3848;37790;577;0;0;0;0;.00nan;0;0
3848;40087;571;0;0;0;0;.00nan;0;0
3848;85749;577;97;40;1;39;.975;3900000;0
3849;483;569;0;0;0;0;.00nan;0;0
3849;14266;569;36;18;3;15;.833;3546000;0
3849;56126;575;0;0;0;0;.00nan;0;0
3849;66245;575;85;37;2;35;.946;3600000;0
3850;320;564;0;0;0;0;.00nan;0;0
3850;56126;575;61;31;3;28;.903;3600000;0
3850;66245;575;0;0;0;0;.00nan;0;0
3850;78251;564;76;24;2;22;.917;3600000;0
3851;14047;578;92;47;4;43;.915;3898000;0
3851;14459;578;0;0;0;0;.00nan;0;0
3851;37790;577;47;19;3;16;.842;3898000;0
3851;85749;577;0;0;0;0;.00nan;0;0
3852;4504;565;50;1;0;1;1.000;320000;0
3852;11438;562;95;41;2;39;.951;3600000;0
3852;170042;565;28;24;6;18;.750;3280000;0
3852;76574;562;0;0;0;0;.00nan;0;0
3853;38228;568;0;0;0;0;.00nan;0;0
3853;64911;576;87;34;2;32;.941;3900000;0
3853;64923;568;85;34;2;32;.941;3895000;0
3853;142911;576;0;0;0;0;.00nan;0;0
3854;11925;574;0;0;0;0;.00nan;0;0
3854;68167;574;100;38;1;37;.974;3600000;0
3854;73939;572;38;19;4;15;.789;3600000;0
3854;84430;572;0;0;0;0;.00nan;0;0
3855;483;569;0;0;0;0;.00nan;0;0
3855;14266;569;54;32;4;28;.875;3678000;0
3855;64721;566;86;34;3;31;.912;3678000;0
3855;85633;566;0;0;0;0;.00nan;0;0
3856;320;564;63;28;2;26;.929;3600000;0
3856;4504;565;0;0;0;0;.00nan;0;0
3856;170042;565;95;34;1;33;.971;3600000;0
3856;78251;564;0;0;0;0;.00nan;0;0
3857;11438;562;0;0;0;0;.00nan;0;0
3857;14047;578;92;44;3;41;.932;3600000;0
3857;14459;578;0;0;0;0;.00nan;0;0
3857;76574;562;53;39;5;34;.872;3513000;0
3858;64721;566;0;0;0;0;.00nan;0;0
3858;64925;573;0;0;0;0;.00nan;0;0
3858;84945;573;61;41;5;36;.878;3592000;0
3858;85633;566;47;20;3;17;.850;3600000;0
3859;37790;577;0;0;0;0;.00nan;0;0
3859;56126;575;0;0;0;0;.00nan;0;0
3859;66245;575;68;24;2;22;.917;3583000;0
3859;85749;577;75;19;1;18;.947;3600000;0
3860;11925;574;0;0;0;0;.00nan;0;0
3860;22684;570;0;0;0;0;.00nan;0;0
3860;68167;574;80;40;2;38;.950;3900000;0
3860;90734;570;75;30;2;28;.933;3900000;0
3861;4386;571;49;24;4;20;.833;3600000;0
3861;40087;571;0;0;0;0;.00nan;0;0
3861;73939;572;60;27;3;24;.889;3600000;0
3861;84430;572;0;0;0;0;.00nan;0;0
3862;38228;568;0;0;0;0;.00nan;0;0
3862;64911;576;0;0;0;0;.00nan;0;0
3862;64923;568;80;37;2;35;.946;3552000;0
3862;142911;576;66;18;1;17;.944;3600000;0
3863;22684;570;77;24;1;23;.958;3600000;0
3863;64721;566;91;38;2;36;.947;3598000;0
3863;85633;566;0;0;0;0;.00nan;0;0
3863;90734;570;0;0;0;0;.00nan;0;0
3864;4504;565;78;38;3;35;.921;3600000;0
3864;170042;565;0;0;0;0;.00nan;0;0
3864;64911;576;0;0;0;0;.00nan;0;0
3864;142911;576;96;21;0;21;1.000;3600000;0
3865;64925;573;96;47;3;44;.936;3600000;0
3865;73939;572;0;0;0;0;.00nan;0;0
3865;84430;572;90;35;2;33;.943;3600000;0
3865;84945;573;0;0;0;0;.00nan;0;0
3866;37790;577;0;0;0;0;.00nan;0;0
3866;56126;575;56;21;2;19;.905;3600000;0
3866;66245;575;0;0;0;0;.00nan;0;0
3866;85749;577;85;33;1;32;.970;3600000;0
3867;320;564;0;0;0;0;.00nan;0;0
3867;38228;568;79;39;3;36;.923;3600000;0
3867;64923;568;0;0;0;0;.00nan;0;0
3867;78251;564;65;43;5;38;.884;3557000;0
3868;483;569;0;0;0;0;.00nan;0;0
3868;11925;574;73;45;4;41;.911;3600000;0
3868;14266;569;89;33;1;32;.970;3600000;0
3868;68167;574;0;0;0;0;.00nan;0;0
3869;4386;571;100;28;0;28;1.000;3600000;0
3869;14047;578;0;0;0;0;.00nan;0;0
3869;14459;578;71;29;2;27;.931;3600000;0
3869;40087;571;0;0;0;0;.00nan;0;0
3870;320;564;0;0;0;0;.00nan;0;0
3870;11925;574;75;33;2;31;.939;3600000;0
3870;68167;574;0;0;0;0;.00nan;0;0
3870;78251;564;75;34;3;31;.912;3548000;0
3871;483;569;0;0;0;0;.00nan;0;0
3871;11438;562;83;35;2;33;.943;3549000;0
3871;14266;569;75;10;0;10;1.000;3600000;0
3871;76574;562;0;0;0;0;.00nan;0;0
3872;320;564;0;0;0;0;.00nan;0;0
3872;73939;572;95;48;2;46;.958;3900000;0
3872;78251;564;77;31;2;29;.935;3900000;0
3872;84430;572;0;0;0;0;.00nan;0;0
3873;483;569;0;0;0;0;.00nan;0;0
3873;14266;569;80;22;1;21;.955;3600000;0
3873;64925;573;88;35;2;33;.943;3553000;0
3873;84945;573;0;0;0;0;.00nan;0;0
3874;37790;577;0;0;0;0;.00nan;0;0
3874;64721;566;0;0;0;0;.00nan;0;0
3874;85633;566;75;27;3;24;.889;3553000;0
3874;85749;577;85;25;1;24;.960;3600000;0
3875;14047;578;85;44;3;41;.932;3568000;0
3875;14459;578;0;0;0;0;.00nan;0;0
3875;38228;568;0;0;0;0;.00nan;0;0
3875;64923;568;94;29;1;28;.966;3600000;0
3876;4386;571;76;28;2;26;.929;3600000;0
3876;4504;565;0;0;0;0;.00nan;0;0
3876;170042;565;55;33;4;29;.879;3533000;0
3876;40087;571;0;0;0;0;.00nan;0;0
3877;11925;574;87;36;2;34;.944;3600000;0
3877;64911;576;0;0;0;0;.00nan;0;0
3877;68167;574;0;0;0;0;.00nan;0;0
3877;142911;576;68;42;4;38;.905;3576000;0
3878;22684;570;76;35;4;31;.886;3600000;0
3878;56126;575;0;0;0;0;.00nan;0;0
3878;66245;575;66;51;5;46;.902;3600000;0
3878;90734;570;0;0;0;0;.00nan;0;0
3879;22684;570;71;29;3;26;.897;3900000;0
3879;37790;577;0;0;0;0;.00nan;0;0
3879;85749;577;74;41;3;38;.927;3900000;0
3879;90734;570;0;0;0;0;.00nan;0;0
3880;320;564;49;20;3;17;.850;3600000;0
3880;11925;574;0;0;0;0;.00nan;0;0
3880;68167;574;63;27;2;25;.926;3600000;0
3880;78251;564;0;0;0;0;.00nan;0;0
3881;64911;576;0;0;0;0;.00nan;0;0
3881;64925;573;0;0;0;0;.00nan;0;0
3881;84945;573;89;37;2;35;.946;3900000;0
3881;142911;576;60;17;2;15;.882;3900000;0
3882;11438;562;37;36;6;30;.833;3600000;0
3882;73939;572;84;24;1;23;.958;3600000;0
3882;76574;562;0;0;0;0;.00nan;0;0
3882;84430;572;0;0;0;0;.00nan;0;0
3883;4386;571;62;26;3;23;.885;3600000;0
3883;40087;571;0;0;0;0;.00nan;0;0
3883;64721;566;0;0;0;0;.00nan;0;0
3883;85633;566;78;40;4;36;.900;3577000;0
3884;14047;578;72;40;4;36;.900;3600000;0
3884;14459;578;0;0;0;0;.00nan;0;0
3884;38228;568;0;0;0;0;.00nan;0;0
3884;64923;568;91;17;0;17;1.000;3600000;0
3885;483;569;0;0;0;0;.00nan;0;0
3885;4504;565;0;0;0;0;.00nan;0;0
3885;14266;569;51;28;3;25;.893;3570000;0
3885;170042;565;94;42;2;40;.952;3600000;0
3886;11438;562;0;0;0;0;.00nan;0;0
3886;64911;576;0;0;0;0;.00nan;0;0
3886;76574;562;82;42;3;39;.929;3576000;0
3886;142911;576;77;32;2;30;.938;3600000;0
3887;320;564;0;0;0;0;.00nan;0;0
3887;64925;573;79;38;3;35;.921;3600000;0
3887;78251;564;97;36;1;35;.972;3600000;0
3887;84945;573;0;0;0;0;.00nan;0;0
3888;11925;574;65;32;3;29;.906;3568000;0
3888;37790;577;0;0;0;0;.00nan;0;0
3888;68167;574;0;0;0;0;.00nan;0;0
3888;85749;577;78;26;1;25;.962;3600000;0
3889;4504;565;0;0;0;0;.00nan;0;0
3889;170042;565;100;44;1;43;.977;3600000;0
3889;73939;572;59;28;3;25;.893;3561000;0
3889;84430;572;0;0;0;0;.00nan;0;0
3890;14047;578;16;8;4;4;.500;903000;0
3890;14459;578;30;30;6;24;.800;2697000;0
3890;56126;575;0;0;0;0;.00nan;0;0
3890;66245;575;88;18;0;18;1.000;3600000;0
3891;4386;571;64;25;2;23;.920;3600000;0
3891;38228;568;0;0;0;0;.00nan;0;0
3891;40087;571;0;0;0;0;.00nan;0;0
3891;64923;568;46;22;4;18;.818;3600000;0
3892;483;569;0;0;0;0;.00nan;0;0
3892;14266;569;73;35;3;32;.914;3600000;0
3892;22684;570;66;38;4;34;.895;3560000;0
3892;90734;570;0;0;0;0;.00nan;0;0
3893;320;564;0;0;0;0;.00nan;0;0
3893;64721;566;0;0;0;0;.00nan;0;0
3893;78251;564;88;39;2;37;.949;3600000;0
3893;85633;566;69;44;4;40;.909;3592000;0
3894;11438;562;63;31;3;28;.903;2608000;0
3894;22684;570;61;17;2;15;.882;3600000;0
3894;76574;562;43;22;4;18;.818;992000;0
3894;90734;570;0;0;0;0;.00nan;0;0
3895;38228;568;0;0;0;0;.00nan;0;0
3895;64923;568;83;27;1;26;.963;3600000;0
3895;64925;573;98;41;2;39;.951;3600000;0
3895;84945;573;0;0;0;0;.00nan;0;0
3896;37790;577;0;0;0;0;.00nan;0;0
3896;73939;572;88;23;1;22;.957;3600000;0
3896;84430;572;0;0;0;0;.00nan;0;0
3896;85749;577;63;22;3;19;.864;3563000;0
3897;4504;565;0;0;0;0;.00nan;0;0
3897;11925;574;0;0;0;0;.00nan;0;0
3897;170042;565;100;26;0;26;1.000;3600000;0
3897;68167;574;80;25;1;24;.960;3600000;0
3898;4386;571;84;27;2;25;.926;3788000;0
3898;40087;571;0;0;0;0;.00nan;0;0
3898;56126;575;0;0;0;0;.00nan;0;0
3898;66245;575;67;31;3;28;.903;3788000;0
3899;483;569;0;0;0;0;.00nan;0;0
3899;14266;569;89;25;1;24;.960;3600000;0
3899;64911;576;0;0;0;0;.00nan;0;0
3899;142911;576;72;47;4;43;.915;3600000;0
3900;4386;571;70;24;2;22;.917;3600000;0
3900;37790;577;0;0;0;0;.00nan;0;0
3900;40087;571;0;0;0;0;.00nan;0;0
3900;85749;577;55;33;4;29;.879;3552000;0
3901;11925;574;93;50;2;48;.960;3892000;0
3901;22684;570;79;24;1;23;.958;3892000;0
3901;68167;574;0;0;0;0;.00nan;0;0
3901;90734;570;0;0;0;0;.00nan;0;0
3902;11438;562;41;38;6;32;.842;3600000;0
3902;64911;576;0;0;0;0;.00nan;0;0
3902;76574;562;0;0;0;0;.00nan;0;0
3902;142911;576;64;21;2;19;.905;3600000;0
3903;320;564;0;0;0;0;.00nan;0;0
3903;73939;572;53;35;5;30;.857;3707000;0
3903;78251;564;67;33;4;29;.879;3703000;0
3903;84430;572;0;0;0;0;.00nan;0;0
3904;56126;575;0;0;0;0;.00nan;0;0
3904;64925;573;70;21;2;19;.905;3600000;0
3904;66245;575;51;22;3;19;.864;3565000;0
3904;84945;573;0;0;0;0;.00nan;0;0
3905;483;569;0;0;0;0;.00nan;0;0
3905;14266;569;54;28;4;24;.857;3600000;0
3905;64721;566;0;0;0;0;.00nan;0;0
3905;85633;566;100;33;0;33;1.000;3600000;0
3906;4504;565;0;0;0;0;.00nan;0;0
3906;170042;565;91;31;2;29;.935;3600000;0
3906;38228;568;0;0;0;0;.00nan;0;0
3906;64923;568;74;41;3;38;.927;3566000;0
3907;4504;565;0;0;0;0;.00nan;0;0
3907;170042;565;93;37;1;36;.973;3900000;0
3907;64721;566;0;0;0;0;.00nan;0;0
3907;85633;566;96;36;1;35;.972;3900000;0
3908;320;564;81;26;1;25;.962;3600000;0
3908;37790;577;0;0;0;0;.00nan;0;0
3908;78251;564;0;0;0;0;.00nan;0;0
3908;85749;577;74;30;2;28;.933;3559000;0
3909;22684;570;0;0;0;0;.00nan;0;0
3909;56126;575;0;0;0;0;.00nan;0;0
3909;66245;575;60;37;5;32;.865;3552000;0
3909;90734;570;41;22;4;18;.818;3600000;0
3910;483;569;0;0;0;0;.00nan;0;0
3910;11438;562;0;0;0;0;.00nan;0;0
3910;14266;569;77;19;1;18;.947;3900000;0
3910;76574;562;100;48;1;47;.979;3900000;0
3911;4386;571;100;42;1;41;.976;3600000;0
3911;40087;571;0;0;0;0;.00nan;0;0
3911;64925;573;0;0;0;0;.00nan;0;0
3911;84945;573;87;39;3;36;.923;3581000;0
3912;64911;576;0;0;0;0;.00nan;0;0
3912;73939;572;49;31;6;25;.806;3600000;0
3912;84430;572;0;0;0;0;.00nan;0;0
3912;142911;576;68;17;1;16;.941;3600000;0
3913;11925;574;84;39;2;37;.949;3600000;0
3913;38228;568;0;0;0;0;.00nan;0;0
3913;64923;568;44;27;4;23;.852;3561000;0
3913;68167;574;0;0;0;0;.00nan;0;0
3914;22684;570;77;23;1;22;.957;3600000;0
3914;64925;573;89;48;3;45;.938;3567000;0
3914;84945;573;0;0;0;0;.00nan;0;0
3914;90734;570;0;0;0;0;.00nan;0;0
3915;37790;577;0;0;0;0;.00nan;0;0
3915;38228;568;0;0;0;0;.00nan;0;0
3915;64923;568;52;20;3;17;.850;3554000;0
3915;85749;577;88;38;2;36;.947;3600000;0
3916;4504;565;67;10;0;10;1.000;647000;0
3916;11925;574;41;31;5;26;.839;3600000;0
3916;170042;565;59;33;6;27;.818;2906000;0
3916;68167;574;0;0;0;0;.00nan;0;0
3917;4386;571;0;0;0;0;.00nan;0;0
3917;40087;571;81;24;1;23;.958;3600000;0
3917;64911;576;0;0;0;0;.00nan;0;0
3917;142911;576;44;33;5;28;.848;3600000;0
3918;11438;562;0;0;0;0;.00nan;0;0
3918;56126;575;0;0;0;0;.00nan;0;0
3918;66245;575;62;16;2;14;.875;3600000;0
3918;76574;562;96;45;3;42;.933;3600000;0
3919;320;564;0;0;0;0;.00nan;0;0
3919;22684;570;0;0;0;0;.00nan;0;0
3919;78251;564;81;23;1;22;.957;3600000;0
3919;90734;570;65;29;2;27;.931;3592000;0
3920;320;564;61;22;2;20;.909;3600000;0
3920;4504;565;0;0;0;0;.00nan;0;0
3920;170042;565;67;40;4;36;.900;3590000;0
3920;78251;564;0;0;0;0;.00nan;0;0
3921;37790;577;0;0;0;0;.00nan;0;0
3921;64925;573;79;34;3;31;.912;3585000;0
3921;84945;573;0;0;0;0;.00nan;0;0
3921;85749;577;76;30;2;28;.933;3600000;0
3922;11925;574;0;0;0;0;.00nan;0;0
3922;14047;578;23;35;7;28;.800;3048000;0
3922;14459;578;60;8;0;8;1.000;552000;0
3922;68167;574;57;19;2;17;.895;3600000;0
3923;4386;571;66;23;2;21;.913;3600000;0
3923;11438;562;0;0;0;0;.00nan;0;0
3923;40087;571;0;0;0;0;.00nan;0;0
3923;76574;562;98;49;3;46;.939;3553000;0
3924;483;569;0;0;0;0;.00nan;0;0
3924;14266;569;46;30;4;26;.867;3575000;0
3924;64721;566;0;0;0;0;.00nan;0;0
3924;85633;566;83;26;2;24;.923;3600000;0
3925;38228;568;0;0;0;0;.00nan;0;0
3925;56126;575;0;0;0;0;.00nan;0;0
3925;64923;568;86;32;2;30;.938;3559000;0
3925;66245;575;91;29;1;28;.966;3600000;0
3926;11438;562;73;35;3;32;.914;3579000;0
3926;37790;577;0;0;0;0;.00nan;0;0
3926;76574;562;0;0;0;0;.00nan;0;0
3926;85749;577;52;17;2;15;.882;3600000;0
3927;11925;574;100;22;0;22;1.000;3600000;0
3927;64925;573;0;0;0;0;.00nan;0;0
3927;68167;574;0;0;0;0;.00nan;0;0
3927;84945;573;96;41;2;39;.951;3569000;0
3928;14047;578;0;0;0;0;.00nan;0;0
3928;14459;578;66;46;5;41;.891;3600000;0
3928;22684;570;69;22;2;20;.909;3600000;0
3928;90734;570;0;0;0;0;.00nan;0;0
3929;4504;565;76;28;2;26;.929;3600000;0
3929;170042;565;0;0;0;0;.00nan;0;0
3929;64911;576;0;0;0;0;.00nan;0;0
3929;142911;576;50;27;4;23;.852;3564000;0
3930;4386;571;92;41;2;39;.951;3566000;0
3930;40087;571;0;0;0;0;.00nan;0;0
3930;73939;572;94;41;1;40;.976;3600000;0
3930;84430;572;0;0;0;0;.00nan;0;0
3931;483;569;0;0;0;0;.00nan;0;0
3931;14266;569;90;38;1;37;.974;3900000;0
3931;38228;568;0;0;0;0;.00nan;0;0
3931;64923;568;91;32;1;31;.969;3900000;0
3932;320;564;0;0;0;0;.00nan;0;0
3932;11438;562;0;0;0;0;.00nan;0;0
3932;76574;562;88;70;6;64;.914;3600000;0
3932;78251;564;68;18;1;17;.944;3600000;0
3933;64911;576;0;0;0;0;.00nan;0;0
3933;64925;573;57;26;4;22;.846;3600000;0
3933;84945;573;0;0;0;0;.00nan;0;0
3933;142911;576;68;45;5;40;.889;3545000;0
3934;4504;565;92;38;1;37;.974;3900000;0
3934;170042;565;0;0;0;0;.00nan;0;0
3934;37790;577;0;0;0;0;.00nan;0;0
3934;85749;577;69;19;1;18;.947;3900000;0
3935;56126;575;0;0;0;0;.00nan;0;0
3935;66245;575;100;43;0;43;1.000;3600000;0
3935;73939;572;77;32;3;29;.906;3600000;0
3935;84430;572;0;0;0;0;.00nan;0;0
3936;483;569;88;18;0;18;1.000;3813000;0
3936;14047;578;94;45;1;44;.978;3813000;0
3936;14266;569;0;0;0;0;.00nan;0;0
3936;14459;578;0;0;0;0;.00nan;0;0
3937;4386;571;90;49;4;45;.918;3600000;0
3937;38228;568;0;0;0;0;.00nan;0;0
3937;40087;571;0;0;0;0;.00nan;0;0
3937;64923;568;33;26;5;21;.808;3548000;0
3938;483;569;0;0;0;0;.00nan;0;0
3938;14266;569;79;43;4;39;.907;3600000;0
3938;22684;570;100;28;0;28;1.000;3600000;0
3938;90734;570;0;0;0;0;.00nan;0;0
3939;64925;573;74;41;3;38;.927;3900000;0
3939;73939;572;79;39;3;36;.923;3900000;0
3939;84430;572;0;0;0;0;.00nan;0;0
3939;84945;573;0;0;0;0;.00nan;0;0
3940;11438;562;0;0;0;0;.00nan;0;0
3940;11925;574;71;29;2;27;.931;3600000;0
3940;68167;574;0;0;0;0;.00nan;0;0
3940;76574;562;65;40;5;35;.875;3600000;0
3941;14047;578;81;31;2;29;.935;3563000;0
3941;14459;578;0;0;0;0;.00nan;0;0
3941;56126;575;0;0;0;0;.00nan;0;0
3941;66245;575;100;34;0;34;1.000;3600000;0
3942;64721;566;0;0;0;0;.00nan;0;0
3942;64911;576;0;0;0;0;.00nan;0;0
3942;85633;566;97;45;2;43;.956;3563000;0
3942;142911;576;79;24;1;23;.958;3600000;0
3943;11925;574;58;41;5;36;.878;3544000;0
3943;37790;577;73;41;4;37;.902;3600000;0
3943;68167;574;0;0;0;0;.00nan;0;0
3943;85749;577;0;0;0;0;.00nan;0;0
3944;4504;565;0;0;0;0;.00nan;0;0
3944;11438;562;48;45;7;38;.844;3073000;0
3944;170042;565;54;17;3;14;.824;3600000;0
3944;76574;562;60;8;0;8;1.000;527000;0
3945;4386;571;85;41;3;38;.927;3521000;0
3945;22684;570;86;29;1;28;.966;3600000;0
3945;40087;571;0;0;0;0;.00nan;0;0
3945;90734;570;0;0;0;0;.00nan;0;0
3946;56126;575;0;0;0;0;.00nan;0;0
3946;66245;575;37;34;6;28;.824;3600000;0
3946;73939;572;0;0;0;0;.00nan;0;0
3946;84430;572;85;28;1;27;.964;3600000;0
3947;14047;578;0;0;0;0;.00nan;0;0
3947;14459;578;74;34;3;31;.912;3600000;0
3947;64721;566;95;32;1;31;.969;3600000;0
3947;85633;566;0;0;0;0;.00nan;0;0
3948;483;569;0;0;0;0;.00nan;0;0
3948;14266;569;74;32;3;29;.906;3600000;0
3948;64925;573;78;46;5;41;.891;3520000;0
3948;84945;573;0;0;0;0;.00nan;0;0
3949;320;564;54;3;0;3;1.000;652000;0
3949;38228;568;0;0;0;0;.00nan;0;0
3949;64923;568;100;39;2;37;.949;3600000;0
3949;78251;564;25;24;6;18;.750;2948000;0
3950;320;564;94;42;3;39;.929;3583000;0
3950;483;569;0;0;0;0;.00nan;0;0
3950;14266;569;74;17;1;16;.941;3600000;0
3950;78251;564;0;0;0;0;.00nan;0;0
3951;22684;570;96;33;1;32;.970;3600000;0
3951;64911;576;0;0;0;0;.00nan;0;0
3951;90734;570;0;0;0;0;.00nan;0;0
3951;142911;576;72;32;3;29;.906;3522000;0
3952;11438;562;0;0;0;0;.00nan;0;0
3952;56126;575;0;0;0;0;.00nan;0;0
3952;66245;575;70;34;3;31;.912;3900000;0
3952;76574;562;65;31;3;28;.903;3900000;0
3953;38228;568;0;0;0;0;.00nan;0;0
3953;64923;568;64;41;4;37;.902;3516000;0
3953;73939;572;84;39;2;37;.949;3600000;0
3953;84430;572;0;0;0;0;.00nan;0;0
3954;11925;574;67;25;2;23;.920;3600000;0
3954;64721;566;0;0;0;0;.00nan;0;0
3954;68167;574;0;0;0;0;.00nan;0;0
3954;85633;566;86;38;3;35;.921;3592000;0
3955;4386;571;46;26;4;22;.846;3600000;0
3955;11925;574;0;0;0;0;.00nan;0;0
3955;40087;571;0;0;0;0;.00nan;0;0
3955;68167;574;99;51;3;48;.941;3600000;0
3956;37790;577;0;0;0;0;.00nan;0;0
3956;64911;576;0;0;0;0;.00nan;0;0
3956;85749;577;88;36;2;34;.944;3600000;0
3956;142911;576;45;20;3;17;.850;3596000;0
3957;4504;565;0;0;0;0;.00nan;0;0
3957;170042;565;96;43;1;42;.977;3900000;0
3957;22684;570;87;24;1;23;.958;3900000;0
3957;90734;570;0;0;0;0;.00nan;0;0
3958;320;564;0;0;0;0;.00nan;0;0
3958;11438;562;0;0;0;0;.00nan;0;0
3958;76574;562;98;46;2;44;.957;3650000;0
3958;78251;564;71;26;3;23;.885;3650000;0
3959;14047;578;71;32;3;29;.906;3545000;0
3959;14459;578;0;0;0;0;.00nan;0;0
3959;64721;566;0;0;0;0;.00nan;0;0
3959;85633;566;91;33;1;32;.970;3600000;0
3960;483;569;62;9;0;9;1.000;1241000;0
3960;14266;569;34;27;5;22;.815;2359000;0
3960;56126;575;0;0;0;0;.00nan;0;0
3960;66245;575;64;26;3;23;.885;3600000;0
3961;38228;568;0;0;0;0;.00nan;0;0
3961;64911;576;0;0;0;0;.00nan;0;0
3961;64923;568;49;37;5;32;.865;3600000;0
3961;142911;576;70;29;2;27;.931;3600000;0
3962;4504;565;51;47;7;40;.851;3600000;0
3962;170042;565;0;0;0;0;.00nan;0;0
3962;22684;570;58;19;2;17;.895;3600000;0
3962;90734;570;0;0;0;0;.00nan;0;0
3963;11438;562;0;0;0;0;.00nan;0;0
3963;64925;573;77;23;2;21;.913;3600000;0
3963;76574;562;70;41;4;37;.902;3600000;0
3963;84945;573;0;0;0;0;.00nan;0;0
3964;483;569;0;0;0;0;.00nan;0;0
3964;14266;569;73;30;3;27;.900;3545000;0
3964;37790;577;0;0;0;0;.00nan;0;0
3964;85749;577;67;28;2;26;.929;3600000;0
3965;4386;571;86;30;2;28;.933;3600000;0
3965;14047;578;0;0;0;0;.00nan;0;0
3965;14459;578;79;44;4;40;.909;3566000;0
3965;40087;571;0;0;0;0;.00nan;0;0
3966;64721;566;89;33;1;32;.970;3600000;0
3966;73939;572;76;28;2;26;.929;3600000;0
3966;84430;572;0;0;0;0;.00nan;0;0
3966;85633;566;0;0;0;0;.00nan;0;0
3967;11925;574;52;28;4;24;.857;3600000;0
3967;56126;575;48;36;5;31;.861;3562000;0
3967;66245;575;0;0;0;0;.00nan;0;0
3967;68167;574;0;0;0;0;.00nan;0;0
3968;37790;577;0;0;0;0;.00nan;0;0
3968;64721;566;0;0;0;0;.00nan;0;0
3968;85633;566;46;31;5;26;.839;3600000;0
3968;85749;577;86;19;0;19;1.000;3600000;0
3969;320;564;0;0;0;0;.00nan;0;0
3969;73939;572;93;37;2;35;.946;3600000;0
3969;78251;564;9;24;7;17;.708;3600000;0
3969;84430;572;0;0;0;0;.00nan;0;0
3970;11438;562;0;0;0;0;.00nan;0;0
3970;64911;576;0;0;0;0;.00nan;0;0
3970;76574;562;75;50;4;46;.920;3526000;0
3970;142911;576;65;24;2;22;.917;3600000;0
3971;4386;571;96;22;0;22;1.000;3600000;0
3971;11925;574;70;21;2;19;.905;3543000;0
3971;40087;571;0;0;0;0;.00nan;0;0
3971;68167;574;0;0;0;0;.00nan;0;0
3972;14047;578;68;30;3;27;.900;3658000;0
3972;14459;578;0;0;0;0;.00nan;0;0
3972;64925;573;68;22;2;20;.909;3658000;0
3972;84945;573;0;0;0;0;.00nan;0;0
3973;4504;565;0;0;0;0;.00nan;0;0
3973;170042;565;49;25;4;21;.840;3600000;0
3973;56126;575;0;0;0;0;.00nan;0;0
3973;66245;575;100;38;0;38;1.000;3600000;0
3974;11438;562;86;34;2;32;.941;3900000;0
3974;38228;568;56;26;2;24;.923;3900000;0
3974;64923;568;0;0;0;0;.00nan;0;0
3974;76574;562;0;0;0;0;.00nan;0;0
3975;14047;578;91;38;2;36;.947;3580000;0
3975;14459;578;0;0;0;0;.00nan;0;0
3975;37790;577;0;0;0;0;.00nan;0;0
3975;85749;577;83;16;0;16;1.000;3600000;0
3976;4386;571;70;31;3;28;.903;3600000;0
3976;40087;571;0;0;0;0;.00nan;0;0
3976;56126;575;0;0;0;0;.00nan;0;0
3976;66245;575;43;30;5;25;.833;3575000;0
3977;320;564;33;34;6;28;.824;3047000;0
3977;64911;576;0;0;0;0;.00nan;0;0
3977;78251;564;42;4;1;3;.750;553000;0
3977;142911;576;64;37;4;33;.892;3600000;0
3978;22684;570;72;24;1;23;.958;3600000;0
3978;73939;572;52;36;5;31;.861;3600000;0
3978;84430;572;0;0;0;0;.00nan;0;0
3978;90734;570;0;0;0;0;.00nan;0;0
3979;64721;566;0;0;0;0;.00nan;0;0
3979;64925;573;36;50;8;42;.840;3600000;0
3979;84945;573;0;0;0;0;.00nan;0;0
3979;85633;566;83;37;2;35;.946;3600000;0
3980;483;569;0;0;0;0;.00nan;0;0
3980;11925;574;90;33;2;31;.939;3600000;0
3980;14266;569;66;42;4;38;.905;3583000;0
3980;68167;574;0;0;0;0;.00nan;0;0
3981;11438;562;0;0;0;0;.00nan;0;0
3981;64721;566;64;23;2;21;.913;3545000;0
3981;76574;562;100;43;1;42;.977;3600000;0
3981;85633;566;0;0;0;0;.00nan;0;0
3982;320;564;0;0;0;0;.00nan;0;0
3982;64911;576;0;0;0;0;.00nan;0;0
3982;78251;564;66;34;3;31;.912;3560000;0
3982;142911;576;100;39;1;38;.974;3600000;0
3983;483;569;88;29;1;28;.966;3600000;0
3983;14266;569;0;0;0;0;.00nan;0;0
3983;64925;573;0;0;0;0;.00nan;0;0
3983;84945;573;72;34;2;32;.941;3552000;0
3984;14047;578;62;9;0;9;1.000;560000;0
3984;14459;578;52;41;6;35;.854;3040000;0
3984;37790;577;0;0;0;0;.00nan;0;0
3984;85749;577;79;18;1;17;.944;3600000;0
3985;4504;565;95;38;2;36;.947;3600000;0
3985;170042;565;0;0;0;0;.00nan;0;0
3985;38228;568;0;0;0;0;.00nan;0;0
3985;64923;568;53;26;3;23;.885;3545000;0
3986;4386;571;68;45;5;40;.889;3600000;0
3986;40087;571;0;0;0;0;.00nan;0;0
3986;56126;575;68;26;2;24;.923;3600000;0
3986;66245;575;0;0;0;0;.00nan;0;0
3987;11925;574;0;0;0;0;.00nan;0;0
3987;68167;574;60;43;6;37;.860;3600000;0
3987;73939;572;83;32;2;30;.938;3600000;0
3987;84430;572;0;0;0;0;.00nan;0;0
3988;320;564;0;0;0;0;.00nan;0;0
3988;37790;577;0;0;0;0;.00nan;0;0
3988;78251;564;82;26;1;25;.962;3696000;0
3988;85749;577;92;39;2;37;.949;3696000;0
3989;22684;570;26;36;7;29;.806;3570000;0
3989;64925;573;80;50;5;45;.900;3600000;0
3989;84945;573;0;0;0;0;.00nan;0;0
3989;90734;570;0;0;0;0;.00nan;0;0
3990;4504;565;0;0;0;0;.00nan;0;0
3990;170042;565;95;35;1;34;.971;3600000;0
3990;64911;576;0;0;0;0;.00nan;0;0
3990;142911;576;54;26;3;23;.885;3577000;0
3991;56126;575;0;0;0;0;.00nan;0;0
3991;66245;575;88;41;4;37;.902;3600000;0
3991;73939;572;52;37;5;32;.865;3542000;0
3991;84430;572;0;0;0;0;.00nan;0;0
3992;11925;574;96;24;0;24;1.000;3600000;0
3992;14047;578;95;35;1;34;.971;3600000;0
3992;14459;578;0;0;0;0;.00nan;0;0
3992;68167;574;0;0;0;0;.00nan;0;0
3993;4386;571;94;34;1;33;.971;3600000;0
3993;40087;571;0;0;0;0;.00nan;0;0
3993;64925;573;0;0;0;0;.00nan;0;0
3993;84945;573;88;47;4;43;.915;3600000;0
3994;38228;568;0;0;0;0;.00nan;0;0
3994;64721;566;0;0;0;0;.00nan;0;0
3994;64923;568;68;22;2;20;.909;3600000;0
3994;85633;566;55;34;4;30;.882;3516000;0
3995;22684;570;63;31;3;28;.903;3600000;0
3995;37790;577;51;8;1;7;.875;915000;0
3995;85749;577;39;32;6;26;.813;2685000;0
3995;90734;570;0;0;0;0;.00nan;0;0
3996;4386;571;49;24;4;20;.833;3600000;0
3996;40087;571;0;0;0;0;.00nan;0;0
3996;73939;572;42;38;6;32;.842;2990000;0
3996;84430;572;58;7;0;7;1.000;610000;0
3997;483;569;0;0;0;0;.00nan;0;0
3997;14266;569;82;42;4;38;.905;3600000;0
3997;38228;568;92;34;1;33;.971;3600000;0
3997;64923;568;0;0;0;0;.00nan;0;0
3998;320;564;88;29;1;28;.966;3600000;0
3998;64721;566;81;19;0;19;1.000;1592000;0
3998;78251;564;0;0;0;0;.00nan;0;0
3998;85633;566;40;27;5;22;.815;2008000;0
3999;4504;565;0;0;0;0;.00nan;0;0
3999;170042;565;47;30;5;25;.833;3600000;0
3999;64925;573;91;42;2;40;.952;3600000;0
3999;84945;573;0;0;0;0;.00nan;0;0
4000;14047;578;43;27;4;23;.852;3600000;0
4000;14459;578;0;0;0;0;.00nan;0;0
4000;56126;575;0;0;0;0;.00nan;0;0
4000;66245;575;100;26;0;26;1.000;3600000;0
4001;22684;570;73;25;2;23;.920;3600000;0
4001;64721;566;0;0;0;0;.00nan;0;0
4001;85633;566;80;47;5;42;.894;3600000;0
4001;90734;570;0;0;0;0;.00nan;0;0
4002;11925;574;100;26;0;26;1.000;3600000;0
4002;38228;568;0;0;0;0;.00nan;0;0
4002;64923;568;61;25;2;23;.920;3558000;0
4002;68167;574;0;0;0;0;.00nan;0;0
4003;11438;562;0;0;0;0;.00nan;0;0
4003;14047;578;0;0;0;0;.00nan;0;0
4003;14459;578;78;37;3;34;.919;3600000;0
4003;76574;562;37;21;4;17;.810;3544000;0
4004;4504;565;44;20;3;17;.850;3600000;0
4004;170042;565;0;0;0;0;.00nan;0;0
4004;64925;573;0;0;0;0;.00nan;0;0
4004;84945;573;74;41;4;37;.902;3587000;0
4005;4386;571;100;27;0;27;1.000;3600000;0
4005;37790;577;0;0;0;0;.00nan;0;0
4005;40087;571;0;0;0;0;.00nan;0;0
4005;85749;577;69;37;4;33;.892;3600000;0
4006;56126;575;0;0;0;0;.00nan;0;0
4006;64911;576;0;0;0;0;.00nan;0;0
4006;66245;575;89;41;3;38;.927;3900000;0
4006;142911;576;46;22;3;19;.864;3900000;0
4007;483;569;0;0;0;0;.00nan;0;0
4007;14266;569;82;27;1;26;.963;3900000;0
4007;73939;572;100;42;1;41;.976;3900000;0
4007;84430;572;0;0;0;0;.00nan;0;0
4008;22684;570;100;30;0;30;1.000;3600000;0
4008;38228;568;0;0;0;0;.00nan;0;0
4008;64923;568;47;40;6;34;.850;3600000;0
4008;90734;570;0;0;0;0;.00nan;0;0
4009;11438;562;0;0;0;0;.00nan;0;0
4009;11925;574;38;17;4;13;.765;3600000;0
4009;68167;574;0;0;0;0;.00nan;0;0
4009;76574;562;100;38;1;37;.974;3600000;0
4010;37790;577;0;0;0;0;.00nan;0;0
4010;64721;566;0;0;0;0;.00nan;0;0
4010;85633;566;100;34;0;34;1.000;3600000;0
4010;85749;577;73;33;3;30;.909;3600000;0
4011;320;564;0;0;0;0;.00nan;0;0
4011;4504;565;0;0;0;0;.00nan;0;0
4011;170042;565;83;54;5;49;.907;3600000;0
4011;78251;564;80;27;1;26;.963;3600000;0
4012;4386;571;71;45;5;40;.889;3600000;0
4012;40087;571;0;0;0;0;.00nan;0;0
4012;64911;576;0;0;0;0;.00nan;0;0
4012;142911;576;43;25;4;21;.840;3600000;0
4013;14047;578;91;42;2;40;.952;3600000;0
4013;14459;578;0;0;0;0;.00nan;0;0
4013;73939;572;58;13;1;12;.923;3600000;0
4013;84430;572;0;0;0;0;.00nan;0;0
4014;483;569;0;0;0;0;.00nan;0;0
4014;14266;569;95;21;0;21;1.000;3600000;0
4014;56126;575;65;9;0;9;1.000;1456000;0
4014;66245;575;39;27;5;22;.815;2144000;0
4015;11438;562;0;0;0;0;.00nan;0;0
4015;22684;570;58;12;1;11;.917;3600000;0
4015;76574;562;94;45;2;43;.956;3600000;0
4015;90734;570;0;0;0;0;.00nan;0;0
4016;4504;565;0;0;0;0;.00nan;0;0
4016;11925;574;90;37;2;35;.946;3600000;0
4016;170042;565;53;25;3;22;.880;3554000;0
4016;68167;574;0;0;0;0;.00nan;0;0
4017;320;564;0;0;0;0;.00nan;0;0
4017;14047;578;84;41;3;38;.927;3855000;0
4017;14459;578;0;0;0;0;.00nan;0;0
4017;78251;564;51;18;2;16;.889;3855000;0
4018;483;569;0;0;0;0;.00nan;0;0
4018;4386;571;75;21;1;20;.952;3600000;0
4018;14266;569;74;27;2;25;.926;3600000;0
4018;40087;571;0;0;0;0;.00nan;0;0
4019;64925;573;98;46;1;45;.978;3569000;0
4019;73939;572;100;38;0;38;1.000;3600000;0
4019;84430;572;0;0;0;0;.00nan;0;0
4019;84945;573;0;0;0;0;.00nan;0;0
4020;56126;575;85;49;3;46;.939;3600000;0
4020;64721;566;0;0;0;0;.00nan;0;0
4020;66245;575;0;0;0;0;.00nan;0;0
4020;85633;566;61;41;5;36;.878;3536000;0
4021;37790;577;0;0;0;0;.00nan;0;0
4021;38228;568;0;0;0;0;.00nan;0;0
4021;64923;568;100;43;2;41;.953;3600000;0
4021;85749;577;62;43;5;38;.884;3600000;0
4022;320;564;96;32;1;31;.969;3600000;0
4022;56126;575;0;0;0;0;.00nan;0;0
4022;66245;575;75;40;3;37;.925;3531000;0
4022;78251;564;0;0;0;0;.00nan;0;0
4023;37790;577;0;0;0;0;.00nan;0;0
4023;64925;573;87;28;1;27;.964;3600000;0
4023;84945;573;0;0;0;0;.00nan;0;0
4023;85749;577;75;36;3;33;.917;3552000;0
4024;11925;574;93;28;1;27;.964;3600000;0
4024;64911;576;0;0;0;0;.00nan;0;0
4024;68167;574;0;0;0;0;.00nan;0;0
4024;142911;576;51;37;5;32;.865;3600000;0
4025;11438;562;0;0;0;0;.00nan;0;0
4025;64925;573;0;0;0;0;.00nan;0;0
4025;76574;562;100;44;0;44;1.000;3600000;0
4025;84945;573;70;33;3;30;.909;3600000;0
4026;14047;578;0;0;0;0;.00nan;0;0
4026;14459;578;65;42;4;38;.905;3600000;0
4026;64911;576;0;0;0;0;.00nan;0;0
4026;142911;576;99;30;0;30;1.000;3600000;0
4027;56126;575;75;38;3;35;.921;3571000;0
4027;64721;566;90;31;1;30;.968;3600000;0
4027;66245;575;0;0;0;0;.00nan;0;0
4027;85633;566;0;0;0;0;.00nan;0;0
4028;483;569;0;0;0;0;.00nan;0;0
4028;14266;569;100;30;1;29;.967;3600000;0
4028;37790;577;0;0;0;0;.00nan;0;0
4028;85749;577;68;32;3;29;.906;3521000;0
4029;320;564;79;31;3;28;.903;3600000;0
4029;22684;570;72;39;4;35;.897;3550000;0
4029;78251;564;0;0;0;0;.00nan;0;0
4029;90734;570;0;0;0;0;.00nan;0;0
4030;4386;571;71;32;3;29;.906;3896000;0
4030;38228;568;0;0;0;0;.00nan;0;0
4030;40087;571;0;0;0;0;.00nan;0;0
4030;64923;568;80;44;3;41;.932;3900000;0
4031;11438;562;0;0;0;0;.00nan;0;0
4031;37790;577;56;25;3;22;.880;3600000;0
4031;76574;562;90;31;2;29;.935;3600000;0
4031;85749;577;0;0;0;0;.00nan;0;0
4032;11925;574;63;41;5;36;.878;3547000;0
4032;64721;566;0;0;0;0;.00nan;0;0
4032;68167;574;0;0;0;0;.00nan;0;0
4032;85633;566;65;25;3;22;.880;3600000;0
4033;4504;565;0;0;0;0;.00nan;0;0
4033;14047;578;98;39;2;37;.949;3600000;0
4033;14459;578;0;0;0;0;.00nan;0;0
4033;170042;565;100;25;0;25;1.000;3600000;0
4034;483;569;0;0;0;0;.00nan;0;0
4034;14266;569;85;25;1;24;.960;3600000;0
4034;73939;572;37;28;5;23;.821;3600000;0
4034;84430;572;0;0;0;0;.00nan;0;0
4035;4386;571;82;25;1;24;.960;3600000;0
4035;22684;570;0;0;0;0;.00nan;0;0
4035;40087;571;0;0;0;0;.00nan;0;0
4035;90734;570;48;37;5;32;.865;3600000;0
4036;4504;565;0;0;0;0;.00nan;0;0
4036;14047;578;0;0;0;0;.00nan;0;0
4036;14459;578;63;22;2;20;.909;3600000;0
4036;170042;565;84;37;3;34;.919;3546000;0
4037;320;564;0;0;0;0;.00nan;0;0
4037;64911;576;0;0;0;0;.00nan;0;0
4037;78251;564;100;26;0;26;1.000;3600000;0
4037;142911;576;77;45;5;40;.889;3600000;0
4038;11925;574;39;21;4;17;.810;3600000;0
4038;56126;575;0;0;0;0;.00nan;0;0
4038;66245;575;100;34;0;34;1.000;3600000;0
4038;68167;574;0;0;0;0;.00nan;0;0
4039;11438;562;93;39;2;37;.949;3744000;0
4039;64721;566;78;23;1;22;.957;3744000;0
4039;76574;562;0;0;0;0;.00nan;0;0
4039;85633;566;0;0;0;0;.00nan;0;0
4040;38228;568;0;0;0;0;.00nan;0;0
4040;64923;568;75;48;4;44;.917;3600000;0
4040;73939;572;74;25;1;24;.960;3600000;0
4040;84430;572;0;0;0;0;.00nan;0;0
4041;483;569;80;29;2;27;.931;3518000;0
4041;14266;569;0;0;0;0;.00nan;0;0
4041;64925;573;100;49;0;49;1.000;3600000;0
4041;84945;573;0;0;0;0;.00nan;0;0
4042;11925;574;0;0;0;0;.00nan;0;0
4042;14047;578;85;28;2;26;.929;3900000;0
4042;14459;578;0;0;0;0;.00nan;0;0
4042;68167;574;74;29;2;27;.931;3900000;0
4043;4504;565;0;0;0;0;.00nan;0;0
4043;170042;565;86;32;2;30;.938;3600000;0
4043;22684;570;51;25;4;21;.840;3589000;0
4043;90734;570;0;0;0;0;.00nan;0;0
4044;37790;577;0;0;0;0;.00nan;0;0
4044;73939;572;41;2;1;1;.500;606000;0
4044;84430;572;30;25;6;19;.760;2994000;0
4044;85749;577;99;24;0;24;1.000;3600000;0
4045;38228;568;0;0;0;0;.00nan;0;0
4045;56126;575;0;0;0;0;.00nan;0;0
4045;64923;568;64;29;3;26;.897;3588000;0
4045;66245;575;74;31;2;29;.935;3600000;0
4046;483;569;0;0;0;0;.00nan;0;0
4046;4386;571;100;34;0;34;1.000;3600000;0
4046;14266;569;75;22;1;21;.955;3577000;0
4046;40087;571;0;0;0;0;.00nan;0;0
4047;320;564;0;0;0;0;.00nan;0;0
4047;14047;578;0;0;0;0;.00nan;0;0
4047;14459;578;65;36;4;32;.889;3600000;0
4047;78251;564;87;27;1;26;.963;3600000;0
4048;4386;571;87;14;0;14;1.000;3600000;0
4048;11438;562;0;0;0;0;.00nan;0;0
4048;40087;571;0;0;0;0;.00nan;0;0
4048;76574;562;98;52;2;50;.962;3596000;0
4049;56126;575;0;0;0;0;.00nan;0;0
4049;64925;573;60;33;3;30;.909;3567000;0
4049;66245;575;87;31;2;29;.935;3600000;0
4049;84945;573;0;0;0;0;.00nan;0;0
4050;37790;577;0;0;0;0;.00nan;0;0
4050;64911;576;0;0;0;0;.00nan;0;0
4050;85749;577;100;28;0;28;1.000;3600000;0
4050;142911;576;81;31;2;29;.935;3515000;0
4051;4504;565;0;0;0;0;.00nan;0;0
4051;170042;565;74;40;4;36;.900;3776000;0
4051;73939;572;71;43;5;38;.884;3776000;0
4051;84430;572;0;0;0;0;.00nan;0;0
4052;11925;574;96;38;2;36;.947;3600000;0
4052;38228;568;70;29;3;26;.897;3573000;0
4052;64923;568;0;0;0;0;.00nan;0;0
4052;68167;574;0;0;0;0;.00nan;0;0
4053;483;569;0;0;0;0;.00nan;0;0
4053;14266;569;62;28;3;25;.893;3600000;0
4053;64721;566;0;0;0;0;.00nan;0;0
4053;85633;566;62;45;6;39;.867;3600000;0
4054;22684;570;71;24;2;22;.917;3542000;0
4054;73939;572;0;0;0;0;.00nan;0;0
4054;84430;572;92;35;1;34;.971;3600000;0
4054;90734;570;0;0;0;0;.00nan;0;0
4055;483;569;0;0;0;0;.00nan;0;0
4055;14047;578;92;36;2;34;.944;3552000;0
4055;14266;569;94;14;0;14;1.000;3600000;0
4055;14459;578;0;0;0;0;.00nan;0;0
4056;4386;571;94;21;0;21;1.000;3600000;0
4056;4504;565;83;29;1;28;.966;3600000;0
4056;170042;565;0;0;0;0;.00nan;0;0
4056;40087;571;0;0;0;0;.00nan;0;0
4057;56126;575;0;0;0;0;.00nan;0;0
4057;64911;576;0;0;0;0;.00nan;0;0
4057;66245;575;99;44;1;43;.977;3600000;0
4057;142911;576;60;32;3;29;.906;3569000;0
4058;320;564;0;0;0;0;.00nan;0;0
4058;64721;566;92;34;2;32;.941;3600000;0
4058;78251;564;55;30;4;26;.867;3580000;0
4058;85633;566;0;0;0;0;.00nan;0;0
4059;11925;574;83;29;1;28;.966;3600000;0
4059;37790;577;0;0;0;0;.00nan;0;0
4059;68167;574;0;0;0;0;.00nan;0;0
4059;85749;577;61;23;2;21;.913;3600000;0
4060;320;564;28;23;6;17;.739;2119000;0
4060;38228;568;0;0;0;0;.00nan;0;0
4060;64923;568;79;46;3;43;.935;3600000;0
4060;78251;564;63;10;0;10;1.000;1481000;0
4061;320;564;0;0;0;0;.00nan;0;0
4061;64925;573;70;30;2;28;.933;3900000;0
4061;78251;564;82;32;2;30;.938;3900000;0
4061;84945;573;0;0;0;0;.00nan;0;0
4062;11438;562;0;0;0;0;.00nan;0;0
4062;73939;572;83;30;2;28;.933;3900000;0
4062;76574;562;100;44;2;42;.955;3900000;0
4062;84430;572;0;0;0;0;.00nan;0;0
4063;14047;578;47;45;6;39;.867;3600000;0
4063;14459;578;0;0;0;0;.00nan;0;0
4063;38228;568;0;0;0;0;.00nan;0;0
4063;64923;568;67;17;1;16;.941;3600000;0
4064;4504;565;0;0;0;0;.00nan;0;0
4064;170042;565;46;22;4;18;.818;3600000;0
4064;56126;575;0;0;0;0;.00nan;0;0
4064;66245;575;68;41;5;36;.878;3600000;0
4065;4386;571;72;35;4;31;.886;3600000;0
4065;40087;571;0;0;0;0;.00nan;0;0
4065;64721;566;0;0;0;0;.00nan;0;0
4065;85633;566;89;37;2;35;.946;3600000;0
4066;22684;570;0;0;0;0;.00nan;0;0
4066;64911;576;0;0;0;0;.00nan;0;0
4066;90734;570;58;26;3;23;.885;3600000;0
4066;142911;576;87;47;4;43;.915;3600000;0
4067;64721;566;76;30;2;28;.933;3560000;0
4067;73939;572;0;0;0;0;.00nan;0;0
4067;84430;572;99;44;1;43;.977;3600000;0
4067;85633;566;0;0;0;0;.00nan;0;0
4068;4504;565;0;0;0;0;.00nan;0;0
4068;11438;562;0;0;0;0;.00nan;0;0
4068;170042;565;100;25;0;25;1.000;3600000;0
4068;76574;562;67;37;4;33;.892;3600000;0
4069;11925;574;80;33;3;30;.909;3581000;0
4069;64925;573;60;31;3;28;.903;3600000;0
4069;68167;574;0;0;0;0;.00nan;0;0
4069;84945;573;0;0;0;0;.00nan;0;0
4070;14047;578;78;41;4;37;.902;3623000;0
4070;14459;578;0;0;0;0;.00nan;0;0
4070;64911;576;51;25;3;22;.880;3670000;0
4070;142911;576;0;0;0;0;.00nan;0;0
4071;37790;577;0;0;0;0;.00nan;0;0
4071;56126;575;0;0;0;0;.00nan;0;0
4071;66245;575;94;28;2;26;.929;3559000;0
4071;85749;577;88;15;0;15;1.000;3600000;0
4072;483;569;0;0;0;0;.00nan;0;0
4072;14266;569;77;32;3;29;.906;3600000;0
4072;22684;570;42;3;1;2;.667;269000;0
4072;90734;570;62;46;6;40;.870;3331000;0
4073;38228;568;0;0;0;0;.00nan;0;0
4073;64721;566;0;0;0;0;.00nan;0;0
4073;64923;568;86;31;2;29;.935;3600000;0
4073;85633;566;73;40;4;36;.900;3600000;0
4074;11925;574;61;41;5;36;.878;3600000;0
4074;22684;570;0;0;0;0;.00nan;0;0
4074;68167;574;0;0;0;0;.00nan;0;0
4074;90734;570;69;26;2;24;.923;3600000;0
4075;14047;578;0;0;0;0;.00nan;0;0
4075;14459;578;39;44;8;36;.818;3600000;0
4075;64925;573;0;0;0;0;.00nan;0;0
4075;84945;573;62;33;4;29;.879;3600000;0
4076;37790;577;0;0;0;0;.00nan;0;0
4076;56126;575;86;31;1;30;.968;3600000;0
4076;66245;575;0;0;0;0;.00nan;0;0
4076;85749;577;61;32;3;29;.906;3523000;0
4077;4504;565;0;0;0;0;.00nan;0;0
4077;11438;562;0;0;0;0;.00nan;0;0
4077;170042;565;66;33;4;29;.879;3514000;0
4077;76574;562;90;39;2;37;.949;3600000;0
4078;320;564;0;0;0;0;.00nan;0;0
4078;4386;571;61;36;4;32;.889;3600000;0
4078;40087;571;0;0;0;0;.00nan;0;0
4078;78251;564;36;25;5;20;.800;3543000;0
4079;64911;576;0;0;0;0;.00nan;0;0
4079;73939;572;31;9;3;6;.667;255000;0
4079;84430;572;88;35;1;34;.971;3645000;0
4079;142911;576;71;38;4;34;.895;3900000;0
4080;483;569;0;0;0;0;.00nan;0;0
4080;11925;574;79;40;4;36;.900;3600000;0
4080;14266;569;76;28;2;26;.929;3600000;0
4080;68167;574;0;0;0;0;.00nan;0;0
4081;320;564;0;0;0;0;.00nan;0;0
4081;56126;575;0;0;0;0;.00nan;0;0
4081;66245;575;98;60;3;57;.950;3600000;0
4081;78251;564;74;24;1;23;.958;3600000;0
4082;64721;566;0;0;0;0;.00nan;0;0
4082;64911;576;0;0;0;0;.00nan;0;0
4082;85633;566;53;31;4;27;.871;3600000;0
4082;142911;576;95;21;0;21;1.000;3600000;0
4083;11438;562;0;0;0;0;.00nan;0;0
4083;22684;570;0;0;0;0;.00nan;0;0
4083;76574;562;100;44;2;42;.955;3600000;0
4083;90734;570;51;24;3;21;.875;3550000;0
4084;320;564;0;0;0;0;.00nan;0;0
4084;37790;577;91;38;1;37;.974;3600000;0
4084;78251;564;72;33;2;31;.939;3600000;0
4084;85749;577;0;0;0;0;.00nan;0;0
4085;4386;571;49;24;4;20;.833;3600000;0
4085;14047;578;27;12;4;8;.667;866000;0
4085;14459;578;65;19;1;18;.947;2679000;0
4085;40087;571;0;0;0;0;.00nan;0;0
4086;4386;571;75;27;1;26;.963;3600000;0
4086;4504;565;0;0;0;0;.00nan;0;0
4086;170042;565;80;30;2;28;.933;3564000;0
4086;40087;571;0;0;0;0;.00nan;0;0
4087;483;569;0;0;0;0;.00nan;0;0
4087;14266;569;75;24;1;23;.958;3900000;0
4087;64911;576;0;0;0;0;.00nan;0;0
4087;142911;576;92;27;1;26;.963;3900000;0
4088;14047;578;79;47;4;43;.915;3585000;0
4088;14459;578;0;0;0;0;.00nan;0;0
4088;22684;570;0;0;0;0;.00nan;0;0
4088;90734;570;51;8;1;7;.875;3600000;0
4089;11438;562;86;36;2;34;.944;2675000;0
4089;38228;568;0;0;0;0;.00nan;0;0
4089;64923;568;67;23;2;21;.913;3600000;0
4089;76574;562;22;11;4;7;.636;925000;0
4090;64721;566;0;0;0;0;.00nan;0;0
4090;64925;573;54;25;3;22;.880;3600000;0
4090;84945;573;0;0;0;0;.00nan;0;0
4090;85633;566;100;37;0;37;1.000;3600000;0
4091;11925;574;51;26;4;22;.846;3600000;0
4091;68167;574;0;0;0;0;.00nan;0;0
4091;73939;572;53;12;1;11;.917;1300000;0
4091;84430;572;54;23;4;19;.826;2266000;0
4092;4504;565;0;0;0;0;.00nan;0;0
4092;170042;565;73;35;3;32;.914;3559000;0
4092;64721;566;0;0;0;0;.00nan;0;0
4092;85633;566;89;38;2;36;.947;3600000;0
4093;320;564;80;32;1;31;.969;3900000;0
4093;11925;574;100;51;1;50;.980;3900000;0
4093;68167;574;0;0;0;0;.00nan;0;0
4093;78251;564;0;0;0;0;.00nan;0;0
4094;14047;578;0;0;0;0;.00nan;0;0
4094;14459;578;99;49;1;48;.980;3600000;0
4094;37790;577;0;0;0;0;.00nan;0;0
4094;85749;577;47;18;3;15;.833;3511000;0
4095;4386;571;0;0;0;0;.00nan;0;0
4095;40087;571;100;30;0;30;1.000;3600000;0
4095;73939;572;79;27;2;25;.926;3572000;0
4095;84430;572;0;0;0;0;.00nan;0;0
4096;38228;568;54;35;4;31;.886;3581000;0
4096;64911;576;81;40;3;37;.925;3600000;0
4096;64923;568;0;0;0;0;.00nan;0;0
4096;142911;576;0;0;0;0;.00nan;0;0
4097;22684;570;0;0;0;0;.00nan;0;0
4097;56126;575;0;0;0;0;.00nan;0;0
4097;66245;575;99;42;1;41;.976;3600000;0
4097;90734;570;61;35;4;31;.886;3600000;0
4098;483;569;0;0;0;0;.00nan;0;0
4098;11438;562;0;0;0;0;.00nan;0;0
4098;14266;569;73;20;2;18;.900;3900000;0
4098;76574;562;97;56;2;54;.964;3900000;0
4099;11438;562;0;0;0;0;.00nan;0;0
4099;14047;578;88;28;2;26;.929;3577000;0
4099;14459;578;0;0;0;0;.00nan;0;0
4099;76574;562;100;39;0;39;1.000;3600000;0
4100;4504;565;0;0;0;0;.00nan;0;0
4100;170042;565;51;21;3;18;.857;3600000;0
4100;37790;577;44;29;5;24;.828;3600000;0
4100;85749;577;0;0;0;0;.00nan;0;0
4101;11925;574;0;0;0;0;.00nan;0;0
4101;64911;576;63;25;2;23;.920;3774000;0
4101;68167;574;79;35;3;32;.914;3774000;0
4101;142911;576;0;0;0;0;.00nan;0;0
4102;56126;575;0;0;0;0;.00nan;0;0
4102;66245;575;80;62;6;56;.903;3600000;0
4102;73939;572;43;17;3;14;.824;3600000;0
4102;84430;572;0;0;0;0;.00nan;0;0
4103;22684;570;0;0;0;0;.00nan;0;0
4103;64721;566;94;35;2;33;.943;3697000;0
4103;85633;566;0;0;0;0;.00nan;0;0
4103;90734;570;97;35;1;34;.971;3697000;0
4104;38228;568;50;1;0;1;1.000;456000;0
4104;64923;568;48;44;9;35;.795;3144000;0
4104;64925;573;78;45;4;41;.911;3600000;0
4104;84945;573;0;0;0;0;.00nan;0;0
4105;320;564;0;0;0;0;.00nan;0;0
4105;483;569;0;0;0;0;.00nan;0;0
4105;14266;569;100;30;0;30;1.000;3600000;0
4105;78251;564;76;32;2;30;.938;3600000;0
4107;4386;571;66;30;3;27;.900;3545000;0
4107;14047;578;75;30;2;28;.933;3600000;0
4107;14459;578;0;0;0;0;.00nan;0;0
4107;40087;571;0;0;0;0;.00nan;0;0
4109;320;564;0;0;0;0;.00nan;0;0
4109;6389;576;0;0;0;0;.00nan;0;0
4109;64911;576;65;15;1;14;.933;3600000;0
4109;78251;564;75;31;2;29;.935;3600000;0
4111;185232;568;0;0;0;0;.00nan;0;0
4111;38228;568;86;28;1;27;.964;3900000;0
4111;61999;573;0;0;0;0;.00nan;0;0
4111;64925;573;98;42;1;41;.976;3900000;0
4113;11438;562;0;0;0;0;.00nan;0;0
4113;73939;572;0;0;0;0;.00nan;0;0
4113;76574;562;98;46;1;45;.978;3600000;0
4113;84430;572;66;23;3;20;.870;3523000;0
4115;483;569;45;43;7;36;.837;3600000;0
4115;7500;569;0;0;0;0;.00nan;0;0
4115;11925;574;79;14;0;14;1.000;3600000;0
4115;68167;574;0;0;0;0;.00nan;0;0
4117;4504;565;0;0;0;0;.00nan;0;0
4117;170042;565;58;33;4;29;.879;3600000;0
4117;174736;566;39;35;5;30;.857;3581000;0
4117;32255;566;0;0;0;0;.00nan;0;0
4119;37790;577;72;25;1;24;.960;3600000;0
4119;56126;575;0;0;0;0;.00nan;0;0
4119;66245;575;78;33;2;31;.939;3600000;0
4119;85749;577;0;0;0;0;.00nan;0;0
4121;320;564;0;0;0;0;.00nan;0;0
4121;483;569;100;23;0;23;1.000;3600000;0
4121;7500;569;0;0;0;0;.00nan;0;0
4121;78251;564;61;22;3;19;.864;3600000;0
4123;4386;571;82;23;1;22;.957;3600000;0
4123;40087;571;0;0;0;0;.00nan;0;0
4123;61999;573;0;0;0;0;.00nan;0;0
4123;64925;573;89;36;2;34;.944;3582000;0
4125;6389;576;0;0;0;0;.00nan;0;0
4125;174736;566;81;26;1;25;.962;3600000;0
4125;32255;566;0;0;0;0;.00nan;0;0
4125;64911;576;87;49;4;45;.918;3600000;0
4127;11925;574;84;42;3;39;.929;3900000;0
4127;22684;570;0;0;0;0;.00nan;0;0
4127;68167;574;0;0;0;0;.00nan;0;0
4127;90734;570;68;28;3;25;.893;3900000;0
4129;4504;565;0;0;0;0;.00nan;0;0
4129;14047;578;66;34;4;30;.882;3561000;0
4129;14459;578;0;0;0;0;.00nan;0;0
4129;170042;565;70;21;2;19;.905;3600000;0
4131;11438;562;0;0;0;0;.00nan;0;0
4131;37790;577;0;0;0;0;.00nan;0;0
4131;76574;562;57;42;5;37;.881;3600000;0
4131;85749;577;63;14;1;13;.929;3600000;0
4133;185232;568;0;0;0;0;.00nan;0;0
4133;38228;568;76;27;2;25;.926;3577000;0
4133;73939;572;81;24;1;23;.958;3600000;0
4133;84430;572;0;0;0;0;.00nan;0;0
4135;483;569;66;28;2;26;.929;3600000;0
4135;7500;569;0;0;0;0;.00nan;0;0
4135;14047;578;0;0;0;0;.00nan;0;0
4135;14459;578;52;30;4;26;.867;3577000;0
4137;11925;574;0;0;0;0;.00nan;0;0
4137;22684;570;69;29;3;26;.897;3600000;0
4137;68167;574;38;38;6;32;.842;3600000;0
4137;90734;570;0;0;0;0;.00nan;0;0
4139;6389;576;66;36;3;33;.917;3786000;0
4139;56126;575;0;0;0;0;.00nan;0;0
4139;64911;576;0;0;0;0;.00nan;0;0
4139;66245;575;58;32;4;28;.875;3786000;0
4141;4386;571;0;0;0;0;.00nan;0;0
4141;40087;571;37;32;5;27;.844;3600000;0
4141;61999;573;83;39;2;37;.949;3600000;0
4141;64925;573;0;0;0;0;.00nan;0;0
4143;320;564;74;35;2;33;.943;3900000;0
4143;4504;565;75;33;2;31;.939;3900000;0
4143;170042;565;0;0;0;0;.00nan;0;0
4143;78251;564;0;0;0;0;.00nan;0;0
4145;11438;562;82;41;3;38;.927;3600000;0
4145;37790;577;63;23;2;21;.913;3600000;0
4145;76574;562;0;0;0;0;.00nan;0;0
4145;85749;577;0;0;0;0;.00nan;0;0
4147;174736;566;0;0;0;0;.00nan;0;0
4147;32255;566;37;16;3;13;.813;3571000;0
4147;73939;572;0;0;0;0;.00nan;0;0
4147;84430;572;93;40;2;38;.950;3600000;0
4149;61999;573;0;0;0;0;.00nan;0;0
4149;64925;573;51;31;5;26;.839;3600000;0
4149;73939;572;0;0;0;0;.00nan;0;0
4149;84430;572;100;31;0;31;1.000;3600000;0
4151;185232;568;0;0;0;0;.00nan;0;0
4151;37790;577;60;25;3;22;.880;3600000;0
4151;38228;568;43;26;4;22;.846;3554000;0
4151;85749;577;0;0;0;0;.00nan;0;0
4153;320;564;0;0;0;0;.00nan;0;0
4153;4386;571;66;32;3;29;.906;3535000;0
4153;40087;571;0;0;0;0;.00nan;0;0
4153;78251;564;76;24;1;23;.958;3600000;0
4155;22684;570;45;22;4;18;.818;3653000;0
4155;174736;566;77;37;3;34;.919;3653000;0
4155;32255;566;0;0;0;0;.00nan;0;0
4155;90734;570;0;0;0;0;.00nan;0;0
4157;4504;565;0;0;0;0;.00nan;0;0
4157;11925;574;42;28;4;24;.857;3534000;0
4157;170042;565;94;39;1;38;.974;3600000;0
4157;68167;574;0;0;0;0;.00nan;0;0
4159;483;569;100;17;0;17;1.000;3600000;0
4159;7500;569;0;0;0;0;.00nan;0;0
4159;14047;578;88;34;1;33;.971;3600000;0
4159;14459;578;0;0;0;0;.00nan;0;0
4161;11438;562;92;44;3;41;.932;3785000;0
4161;56126;575;64;28;2;26;.929;3785000;0
4161;66245;575;0;0;0;0;.00nan;0;0
4161;76574;562;0;0;0;0;.00nan;0;0
4163;37790;577;0;0;0;0;.00nan;0;0
4163;73939;572;0;0;0;0;.00nan;0;0
4163;84430;572;76;37;4;33;.892;3530000;0
4163;85749;577;58;20;2;18;.900;3600000;0
4165;6389;576;0;0;0;0;.00nan;0;0
4165;14047;578;0;0;0;0;.00nan;0;0
4165;14459;578;84;28;1;27;.964;3600000;0
4165;64911;576;44;32;5;27;.844;3600000;0
4167;4386;571;0;0;0;0;.00nan;0;0
4167;11438;562;0;0;0;0;.00nan;0;0
4167;40087;571;85;17;0;17;1.000;3600000;0
4167;76574;562;91;50;3;47;.940;3600000;0
4169;185232;568;59;21;2;19;.905;3600000;0
4169;38228;568;0;0;0;0;.00nan;0;0
4169;61999;573;71;45;5;40;.889;3600000;0
4169;64925;573;0;0;0;0;.00nan;0;0
4171;320;564;65;28;3;25;.893;3600000;0
4171;56126;575;70;31;3;28;.903;3171000;0
4171;66245;575;26;8;3;5;.625;429000;0
4171;78251;564;0;0;0;0;.00nan;0;0
4173;483;569;50;33;5;28;.848;3600000;0
4173;7500;569;0;0;0;0;.00nan;0;0
4173;22684;570;0;0;0;0;.00nan;0;0
4173;90734;570;70;25;2;23;.920;3600000;0
4175;4504;565;86;15;0;15;1.000;3600000;0
4175;170042;565;0;0;0;0;.00nan;0;0
4175;174736;566;0;0;0;0;.00nan;0;0
4175;32255;566;79;30;2;28;.933;3600000;0
4177;6389;576;0;0;0;0;.00nan;0;0
4177;37790;577;43;26;5;21;.808;3600000;0
4177;64911;576;100;26;0;26;1.000;3600000;0
4177;85749;577;0;0;0;0;.00nan;0;0
4179;4504;565;60;38;4;34;.895;3583000;0
4179;14047;578;62;27;3;24;.889;3600000;0
4179;14459;578;0;0;0;0;.00nan;0;0
4179;170042;565;0;0;0;0;.00nan;0;0
4181;483;569;92;48;3;45;.938;3900000;0
4181;7500;569;0;0;0;0;.00nan;0;0
4181;185232;568;0;0;0;0;.00nan;0;0
4181;38228;568;72;33;3;30;.909;3900000;0
4183;11438;562;0;0;0;0;.00nan;0;0
4183;22684;570;0;0;0;0;.00nan;0;0
4183;76574;562;98;51;1;50;.980;3586000;0
4183;90734;570;91;17;0;17;1.000;3600000;0
4185;4386;571;0;0;0;0;.00nan;0;0
4185;40087;571;70;26;2;24;.923;3600000;0
4185;73939;572;94;46;3;43;.935;3580000;0
4185;84430;572;0;0;0;0;.00nan;0;0
4187;320;564;0;0;0;0;.00nan;0;0
4187;61999;573;0;0;0;0;.00nan;0;0
4187;64925;573;86;50;4;46;.920;3544000;0
4187;78251;564;56;23;2;21;.913;3600000;0
4189;11925;574;0;0;0;0;.00nan;0;0
4189;174736;566;99;35;1;34;.971;3900000;0
4189;32255;566;0;0;0;0;.00nan;0;0
4189;68167;574;84;24;1;23;.958;3900000;0
4191;56126;575;0;0;0;0;.00nan;0;0
4191;66245;575;100;25;0;25;1.000;3600000;0
4191;73939;572;0;0;0;0;.00nan;0;0
4191;84430;572;62;30;4;26;.867;3600000;0
4193;22684;570;0;0;0;0;.00nan;0;0
4193;37790;577;0;0;0;0;.00nan;0;0
4193;85749;577;86;21;0;21;1.000;3600000;0
4193;90734;570;78;27;2;25;.926;3523000;0
4195;4386;571;98;30;1;29;.967;3600000;0
4195;185232;568;45;35;6;29;.829;3600000;0
4195;38228;568;0;0;0;0;.00nan;0;0
4195;40087;571;0;0;0;0;.00nan;0;0
4197;11438;562;47;19;4;15;.789;1061000;0
4197;14047;578;0;0;0;0;.00nan;0;0
4197;14459;578;51;14;2;12;.857;3600000;0
4197;76574;562;95;43;1;42;.977;2539000;0
4199;6389;576;0;0;0;0;.00nan;0;0
4199;11925;574;68;24;2;22;.917;3900000;0
4199;64911;576;70;27;2;25;.926;3900000;0
4199;68167;574;0;0;0;0;.00nan;0;0
4201;320;564;69;21;1;20;.952;3549000;0
4201;4504;565;0;0;0;0;.00nan;0;0
4201;170042;565;100;36;0;36;1.000;3600000;0
4201;78251;564;0;0;0;0;.00nan;0;0
4203;483;569;0;0;0;0;.00nan;0;0
4203;7500;569;77;25;1;24;.960;3600000;0
4203;61999;573;0;0;0;0;.00nan;0;0
4203;64925;573;70;36;4;32;.889;3600000;0
1398;483;569;0;0;0;0;.00nan;0;0
1398;14266;569;83;27;1;26;.963;3600000;0
1398;56126;575;0;0;0;0;.00nan;0;0
1398;66245;575;48;35;6;29;.829;3600000;0
1399;64721;566;0;0;0;0;.00nan;0;0
1399;64911;576;50;9;1;8;.889;1268000;0
1399;85633;566;47;29;5;24;.828;3600000;0
1399;142911;576;21;24;6;18;.750;2303000;0
1400;483;569;0;0;0;0;.00nan;0;0
1400;14266;569;70;33;3;30;.909;4444000;0
1400;56126;575;0;0;0;0;.00nan;0;0
1400;66245;575;92;67;4;63;.940;4444000;0
1401;64721;566;0;0;0;0;.00nan;0;0
1401;64911;576;0;0;0;0;.00nan;0;0
1401;85633;566;55;35;3;32;.914;4397000;0
1401;142911;576;82;40;2;38;.950;4397000;0
1525;64721;566;0;0;0;0;.00nan;0;0
1525;64911;576;0;0;0;0;.00nan;0;0
1525;85633;566;63;41;4;37;.902;3554000;0
1525;142911;576;59;29;3;26;.897;3600000;0
1559;4386;571;98;25;0;25;1.000;3600000;0
1559;40087;571;0;0;0;0;.00nan;0;0
1559;64911;576;0;0;0;0;.00nan;0;0
1559;142911;576;73;28;2;26;.929;3600000;0
1560;483;569;0;0;0;0;.00nan;0;0
1560;14266;569;100;30;0;30;1.000;3600000;0
1560;22684;570;0;0;0;0;.00nan;0;0
1560;90734;570;86;40;2;38;.950;3600000;0
1561;4504;565;0;0;0;0;.00nan;0;0
1561;170042;565;100;47;1;46;.979;3600000;0
1561;37790;577;0;0;0;0;.00nan;0;0
1561;85749;577;51;32;4;28;.875;3600000;0
1562;320;564;0;0;0;0;.00nan;0;0
1562;11925;574;90;53;4;49;.925;4211000;0
1562;68167;574;0;0;0;0;.00nan;0;0
1562;78251;564;69;28;3;25;.893;4211000;0
1563;4386;571;62;25;3;22;.880;3600000;0
1563;40087;571;0;0;0;0;.00nan;0;0
1563;64911;576;0;0;0;0;.00nan;0;0
1563;142911;576;71;38;4;34;.895;3600000;0
1564;483;569;0;0;0;0;.00nan;0;0
1564;14266;569;72;28;2;26;.929;3600000;0
1564;22684;570;0;0;0;0;.00nan;0;0
1564;90734;570;42;25;4;21;.840;3576000;0
1565;4504;565;67;30;3;27;.900;3600000;0
1565;170042;565;0;0;0;0;.00nan;0;0
1565;37790;577;0;0;0;0;.00nan;0;0
1565;85749;577;100;28;0;28;1.000;3600000;0
1566;320;564;0;0;0;0;.00nan;0;0
1566;11925;574;94;57;4;53;.930;3600000;0
1566;68167;574;0;0;0;0;.00nan;0;0
1566;78251;564;100;24;0;24;1.000;3600000;0
1567;4386;571;56;31;4;27;.871;3569000;0
1567;40087;571;0;0;0;0;.00nan;0;0
1567;64911;576;0;0;0;0;.00nan;0;0
1567;142911;576;100;46;3;43;.935;3600000;0
1568;483;569;0;0;0;0;.00nan;0;0
1568;14266;569;52;27;3;24;.889;4667000;0
1568;22684;570;0;0;0;0;.00nan;0;0
1568;90734;570;68;31;4;27;.871;4667000;0
1569;4504;565;66;36;4;32;.889;3600000;0
1569;170042;565;0;0;0;0;.00nan;0;0
1569;37790;577;0;0;0;0;.00nan;0;0
1569;85749;577;99;27;1;26;.963;3600000;0
1570;320;564;0;0;0;0;.00nan;0;0
1570;11925;574;75;32;3;29;.906;3600000;0
1570;68167;574;0;0;0;0;.00nan;0;0
1570;78251;564;73;38;4;34;.895;3600000;0
1571;4386;571;83;28;1;27;.964;3600000;0
1571;40087;571;0;0;0;0;.00nan;0;0
1571;64911;576;0;0;0;0;.00nan;0;0
1571;142911;576;75;31;2;29;.935;3584000;0
1572;483;569;0;0;0;0;.00nan;0;0
1572;14266;569;83;37;2;35;.946;4172000;0
1572;22684;570;0;0;0;0;.00nan;0;0
1572;90734;570;81;35;3;32;.914;4146000;0
1573;4504;565;39;45;7;38;.844;3892000;0
1573;170042;565;0;0;0;0;.00nan;0;0
1573;37790;577;0;0;0;0;.00nan;0;0
1573;85749;577;46;33;6;27;.818;3866000;0
1574;320;564;0;0;0;0;.00nan;0;0
1574;11925;574;100;27;0;27;1.000;3600000;0
1574;68167;574;0;0;0;0;.00nan;0;0
1574;78251;564;57;33;4;29;.879;3600000;0
1867;4386;571;53;20;2;18;.900;3600000;0
1867;40087;571;0;0;0;0;.00nan;0;0
1867;64911;576;0;0;0;0;.00nan;0;0
1867;142911;576;52;41;5;36;.878;3600000;0
1868;4504;565;91;45;3;42;.933;3595000;0
1868;170042;565;0;0;0;0;.00nan;0;0
1868;37790;577;0;0;0;0;.00nan;0;0
1868;85749;577;50;19;2;17;.895;3600000;0
1869;320;564;0;0;0;0;.00nan;0;0
1869;11925;574;69;24;2;22;.917;3600000;0
1869;68167;574;0;0;0;0;.00nan;0;0
1869;78251;564;55;29;4;25;.862;3513000;0
1898;320;564;0;0;0;0;.00nan;0;0
1898;11925;574;64;41;4;37;.902;3600000;0
1898;68167;574;0;0;0;0;.00nan;0;0
1898;78251;564;60;21;2;19;.905;3600000;0
1927;320;564;0;0;0;0;.00nan;0;0
1927;11925;574;97;48;3;45;.938;3600000;0
1927;68167;574;0;0;0;0;.00nan;0;0
1927;78251;564;77;28;2;26;.929;3600000;0
1977;483;569;0;0;0;0;.00nan;0;0
1977;4386;571;83;32;2;30;.938;3808000;0
1977;14266;569;87;30;1;29;.967;3808000;0
1977;40087;571;0;0;0;0;.00nan;0;0
1978;320;564;0;0;0;0;.00nan;0;0
1978;37790;577;0;0;0;0;.00nan;0;0
1978;78251;564;92;19;0;19;1.000;3600000;0
1978;85749;577;67;26;2;24;.923;3567000;0
1979;483;569;0;0;0;0;.00nan;0;0
1979;4386;571;68;22;2;20;.909;3600000;0
1979;14266;569;62;35;4;31;.886;3600000;0
1979;40087;571;0;0;0;0;.00nan;0;0
1980;320;564;0;0;0;0;.00nan;0;0
1980;37790;577;0;0;0;0;.00nan;0;0
1980;78251;564;79;32;3;29;.906;3600000;0
1980;85749;577;39;28;5;23;.821;3564000;0
1981;483;569;0;0;0;0;.00nan;0;0
1981;4386;571;78;28;2;26;.929;3600000;0
1981;14266;569;61;33;4;29;.879;3523000;0
1981;40087;571;0;0;0;0;.00nan;0;0
1982;320;564;0;0;0;0;.00nan;0;0
1982;37790;577;0;0;0;0;.00nan;0;0
1982;78251;564;85;27;1;26;.963;3600000;0
1982;85749;577;58;26;3;23;.885;3594000;0
1983;483;569;0;0;0;0;.00nan;0;0
1983;4386;571;100;34;0;34;1.000;3600000;0
1983;14266;569;75;29;2;27;.931;3530000;0
1983;40087;571;0;0;0;0;.00nan;0;0
1984;320;564;0;0;0;0;.00nan;0;0
1984;37790;577;48;0;0;0;.00nan;300000;0
1984;78251;564;45;23;4;19;.826;3600000;0
1984;85749;577;36;34;6;28;.824;3257000;0
2200;483;569;0;0;0;0;.00nan;0;0
2200;4386;571;55;23;3;20;.870;3540000;0
2200;14266;569;91;31;1;30;.968;3600000;0
2200;40087;571;0;0;0;0;.00nan;0;0
2230;483;569;0;0;0;0;.00nan;0;0
2230;4386;571;67;32;2;30;.938;3600000;0
2230;14266;569;88;32;1;31;.969;3600000;0
2230;40087;571;0;0;0;0;.00nan;0;0
2304;483;569;0;0;0;0;.00nan;0;0
2304;4386;571;79;18;1;17;.944;3600000;0
2304;14266;569;79;31;2;29;.935;3579000;0
2304;40087;571;0;0;0;0;.00nan;0;0
2382;483;569;0;0;0;0;.00nan;0;0
2382;14266;569;100;43;2;41;.953;3600000;0
2382;37790;577;83;37;3;34;.919;3596000;0
2382;85749;577;0;0;0;0;.00nan;0;0
2383;320;564;0;0;0;0;.00nan;0;0
2383;4386;571;78;42;3;39;.929;4549000;0
2383;40087;571;0;0;0;0;.00nan;0;0
2383;78251;564;99;42;2;40;.952;4549000;0
2384;320;564;0;0;0;0;.00nan;0;0
2384;4386;571;100;32;1;31;.969;3600000;0
2384;40087;571;0;0;0;0;.00nan;0;0
2384;78251;564;60;28;3;25;.893;3530000;0
2385;320;564;0;0;0;0;.00nan;0;0
2385;4386;571;71;25;2;23;.920;3670000;0
2385;40087;571;0;0;0;0;.00nan;0;0
2385;78251;564;81;36;3;33;.917;3670000;0
2386;320;564;62;13;1;12;.923;1416000;0
2386;4386;571;76;28;2;26;.929;3600000;0
2386;40087;571;0;0;0;0;.00nan;0;0
2386;78251;564;40;23;4;19;.826;2184000;0
151;320;564;0;0;0;0;.00nan;0;0
151;4386;571;21;11;4;7;.636;909000;0
151;40087;571;88;26;1;25;.962;3307000;0
151;78251;564;78;42;4;38;.905;4216000;0
169;320;564;0;0;0;0;.00nan;0;0
169;4386;571;56;18;2;16;.889;3600000;0
169;40087;571;0;0;0;0;.00nan;0;0
169;78251;564;65;30;3;27;.900;3600000;0
4204;1712;881;0;0;0;0;.00nan;0;0
4204;5354;881;61;32;3;29;.906;3553000;0
4204;20645;883;0;0;0;0;.00nan;0;0
4204;63551;883;77;29;1;28;.966;3600000;0
4205;494;876;0;0;0;0;.00nan;0;0
4205;3077;876;81;39;2;37;.949;3900000;0
4205;46904;897;0;0;0;0;.00nan;0;0
4205;78596;897;73;27;2;25;.926;3900000;0
4206;11716;893;87;29;1;28;.966;3600000;0
4206;12859;873;0;0;0;0;.00nan;0;0
4206;78348;873;38;34;6;28;.824;3600000;0
4206;80834;893;0;0;0;0;.00nan;0;0
4207;11670;957;90;27;1;26;.963;3580000;0
4207;65823;957;0;0;0;0;.00nan;0;0
4207;66009;887;0;0;0;0;.00nan;0;0
4207;76885;887;94;18;0;18;1.000;3600000;0
4208;67287;872;58;26;3;23;.885;3530000;0
4208;78815;886;86;26;1;25;.962;3600000;0
4208;147264;886;0;0;0;0;.00nan;0;0
4208;159705;872;0;0;0;0;.00nan;0;0
4209;28831;877;0;0;0;0;.00nan;0;0
4209;28833;892;0;0;0;0;.00nan;0;0
4209;34708;892;62;34;4;30;.882;3600000;0
4209;70879;877;25;21;5;16;.762;3600000;0
4210;65;875;65;28;2;26;.929;3544000;0
4210;779;882;94;34;1;33;.971;3600000;0
4210;7037;882;0;0;0;0;.00nan;0;0
4210;71075;875;0;0;0;0;.00nan;0;0
4211;1712;881;0;0;0;0;.00nan;0;0
4211;5354;881;93;29;1;28;.966;3600000;0
4211;28833;892;33;31;6;25;.806;3600000;0
4211;34708;892;0;0;0;0;.00nan;0;0
4212;779;882;0;0;0;0;.00nan;0;0
4212;7037;882;74;31;3;28;.903;3600000;0
4212;11716;893;60;34;4;30;.882;3547000;0
4212;80834;893;0;0;0;0;.00nan;0;0
4213;494;876;0;0;0;0;.00nan;0;0
4213;3077;876;35;23;5;18;.783;3562000;0
4213;11670;957;0;0;0;0;.00nan;0;0
4213;65823;957;68;27;3;24;.889;3600000;0
4214;65;875;0;0;0;0;.00nan;0;0
4214;66009;887;0;0;0;0;.00nan;0;0
4214;71075;875;60;20;2;18;.900;3600000;0
4214;76885;887;94;35;1;34;.971;3600000;0
4215;12859;873;0;0;0;0;.00nan;0;0
4215;67287;872;55;21;3;18;.857;3900000;0
4215;78348;873;88;39;3;36;.923;3900000;0
4215;159705;872;0;0;0;0;.00nan;0;0
4216;20645;883;0;0;0;0;.00nan;0;0
4216;63551;883;56;27;3;24;.889;3600000;0
4216;78815;886;49;34;5;29;.853;3584000;0
4216;147264;886;0;0;0;0;.00nan;0;0
4217;1712;881;47;5;1;4;.800;460000;0
4217;5354;881;33;33;6;27;.818;3140000;0
4217;46904;897;0;0;0;0;.00nan;0;0
4217;78596;897;99;35;1;34;.971;3600000;0
4218;11716;893;64;33;4;29;.879;3600000;0
4218;67287;872;92;36;2;34;.944;3600000;0
4218;80834;893;0;0;0;0;.00nan;0;0
4218;159705;872;0;0;0;0;.00nan;0;0
4219;12859;873;55;5;0;5;1.000;330000;0
4219;66009;887;0;0;0;0;.00nan;0;0
4219;76885;887;99;48;3;45;.938;3600000;0
4219;78348;873;22;27;6;21;.778;3270000;0
4220;779;882;37;26;5;21;.808;3868000;0
4220;7037;882;0;0;0;0;.00nan;0;0
4220;78815;886;50;29;4;25;.862;3861000;0
4220;147264;886;0;0;0;0;.00nan;0;0
4221;3077;876;0;0;0;0;.00nan;0;0
4221;28831;877;0;0;0;0;.00nan;0;0
4221;60863;876;70;40;4;36;.900;3600000;0
4221;70879;877;94;34;1;33;.971;3600000;0
4222;11670;957;0;0;0;0;.00nan;0;0
4222;20645;883;0;0;0;0;.00nan;0;0
4222;63551;883;91;18;0;18;1.000;3600000;0
4222;65823;957;82;41;3;38;.927;3600000;0
4223;65;875;75;45;3;42;.933;3600000;0
4223;28833;892;0;0;0;0;.00nan;0;0
4223;34708;892;97;27;0;27;1.000;3600000;0
4223;71075;875;0;0;0;0;.00nan;0;0
4224;779;882;97;31;0;31;1.000;3600000;0
4224;7037;882;0;0;0;0;.00nan;0;0
4224;66009;887;0;0;0;0;.00nan;0;0
4224;76885;887;68;34;3;31;.912;3600000;0
4225;11670;957;0;0;0;0;.00nan;0;0
4225;46904;897;82;26;1;25;.962;3600000;0
4225;65823;957;89;41;2;39;.951;3570000;0
4225;78596;897;0;0;0;0;.00nan;0;0
4226;494;876;84;31;1;30;.968;3600000;0
4226;3077;876;0;0;0;0;.00nan;0;0
4226;11716;893;57;38;5;33;.868;3600000;0
4226;80834;893;0;0;0;0;.00nan;0;0
4227;1712;881;88;29;1;28;.966;3600000;0
4227;5354;881;0;0;0;0;.00nan;0;0
4227;78815;886;54;33;5;28;.848;3600000;0
4227;147264;886;0;0;0;0;.00nan;0;0
4228;20645;883;0;0;0;0;.00nan;0;0
4228;63551;883;43;23;4;19;.826;3600000;0
4228;67287;872;44;30;5;25;.833;3575000;0
4228;159705;872;0;0;0;0;.00nan;0;0
4229;12859;873;0;0;0;0;.00nan;0;0
4229;28833;892;65;23;2;21;.913;3877000;0
4229;34708;892;0;0;0;0;.00nan;0;0
4229;78348;873;60;24;2;22;.917;3900000;0
4230;65;875;74;41;3;38;.927;3579000;0
4230;28831;877;0;0;0;0;.00nan;0;0
4230;70879;877;75;26;2;24;.923;3600000;0
4230;71075;875;0;0;0;0;.00nan;0;0
4231;494;876;0;0;0;0;.00nan;0;0
4231;779;882;63;31;4;27;.871;3600000;0
4231;3077;876;97;31;1;30;.968;3600000;0
4231;7037;882;0;0;0;0;.00nan;0;0
4232;28831;877;0;0;0;0;.00nan;0;0
4232;46904;897;0;0;0;0;.00nan;0;0
4232;70879;877;76;24;1;23;.958;3600000;0
4232;78596;897;66;23;2;21;.913;3544000;0
4233;494;876;0;0;0;0;.00nan;0;0
4233;1712;881;51;27;3;24;.889;3600000;0
4233;3077;876;30;39;7;32;.821;3600000;0
4233;5354;881;0;0;0;0;.00nan;0;0
4234;11716;893;98;38;2;36;.947;3600000;0
4234;28833;892;51;23;3;20;.870;3545000;0
4234;34708;892;0;0;0;0;.00nan;0;0
4234;80834;893;0;0;0;0;.00nan;0;0
4235;46904;897;89;28;1;27;.964;3600000;0
4235;66009;887;0;0;0;0;.00nan;0;0
4235;76885;887;50;28;4;24;.857;3600000;0
4235;78596;897;0;0;0;0;.00nan;0;0
4236;28831;877;76;26;2;24;.923;3600000;0
4236;67287;872;36;15;4;11;.733;2228000;0
4236;70879;877;0;0;0;0;.00nan;0;0
4236;159705;872;55;19;2;17;.895;1372000;0
4237;12859;873;45;24;4;20;.833;3600000;0
4237;78348;873;0;0;0;0;.00nan;0;0
4237;78815;886;27;25;6;19;.760;3190000;0
4237;147264;886;51;5;0;5;1.000;343000;0
4238;65;875;0;0;0;0;.00nan;0;0
4238;11670;957;0;0;0;0;.00nan;0;0
4238;65823;957;66;28;3;25;.893;3600000;0
4238;71075;875;51;32;4;28;.875;3552000;0
4239;779;882;0;0;0;0;.00nan;0;0
4239;7037;882;86;29;2;27;.931;3900000;0
4239;20645;883;79;38;2;36;.947;3900000;0
4239;63551;883;0;0;0;0;.00nan;0;0
4240;1712;881;0;0;0;0;.00nan;0;0
4240;5354;881;68;31;3;28;.903;3900000;0
4240;11716;893;77;38;3;35;.921;3900000;0
4240;80834;893;0;0;0;0;.00nan;0;0
4241;779;882;53;18;2;16;.889;2411000;0
4241;13337;882;47;21;4;17;.810;1189000;0
4241;67287;872;83;26;1;25;.962;3600000;0
4241;159705;872;0;0;0;0;.00nan;0;0
4242;3077;876;0;0;0;0;.00nan;0;0
4242;60863;876;79;25;2;23;.920;3900000;0
4242;66009;887;0;0;0;0;.00nan;0;0
4242;76885;887;67;27;2;25;.926;3900000;0
4243;28831;877;0;0;0;0;.00nan;0;0
4243;70879;877;62;33;3;30;.909;3900000;0
4243;78815;886;0;0;0;0;.00nan;0;0
4243;147264;886;99;39;3;36;.923;3900000;0
4244;11670;957;56;19;2;17;.895;3563000;0
4244;12859;873;0;0;0;0;.00nan;0;0
4244;65823;957;0;0;0;0;.00nan;0;0
4244;78348;873;100;38;1;37;.974;3600000;0
4245;28833;892;66;29;3;26;.897;3600000;0
4245;34708;892;0;0;0;0;.00nan;0;0
4245;46910;897;71;24;2;22;.917;3600000;0
4245;78596;897;0;0;0;0;.00nan;0;0
4246;65;875;0;0;0;0;.00nan;0;0
4246;44496;883;0;0;0;0;.00nan;0;0
4246;63551;883;73;26;2;24;.923;3900000;0
4246;71075;875;63;22;2;20;.909;3900000;0
4247;11716;893;89;42;2;40;.952;3561000;0
4247;28831;877;0;0;0;0;.00nan;0;0
4247;70879;877;76;26;1;25;.962;3600000;0
4247;80834;893;0;0;0;0;.00nan;0;0
4248;779;882;0;0;0;0;.00nan;0;0
4248;12859;873;0;0;0;0;.00nan;0;0
4248;13337;882;55;24;3;21;.875;3600000;0
4248;78348;873;53;36;5;31;.861;3551000;0
4249;44496;883;100;46;1;45;.978;3600000;0
4249;46910;897;45;19;3;16;.842;3543000;0
4249;63551;883;0;0;0;0;.00nan;0;0
4249;78596;897;0;0;0;0;.00nan;0;0
4250;3077;876;0;0;0;0;.00nan;0;0
4250;60863;876;46;20;3;17;.850;3522000;0
4250;78815;886;100;46;1;45;.978;3600000;0
4250;147264;886;0;0;0;0;.00nan;0;0
4251;11670;957;0;0;0;0;.00nan;0;0
4251;28833;892;74;21;1;20;.952;3600000;0
4251;34708;892;0;0;0;0;.00nan;0;0
4251;65823;957;87;51;3;48;.941;3533000;0
4252;66009;887;0;0;0;0;.00nan;0;0
4252;67287;872;0;0;0;0;.00nan;0;0
4252;76885;887;71;27;2;25;.926;3600000;0
4252;159705;872;88;39;3;36;.923;3552000;0
4253;65;875;0;0;0;0;.00nan;0;0
4253;1712;881;52;34;4;30;.882;3600000;0
4253;5354;881;0;0;0;0;.00nan;0;0
4253;71075;875;95;20;0;20;1.000;3600000;0
4254;11716;893;47;20;3;17;.850;3600000;0
4254;46910;897;26;33;7;26;.788;2553000;0
4254;78596;897;58;5;0;5;1.000;1047000;0
4254;80834;893;0;0;0;0;.00nan;0;0
4255;66009;887;60;9;0;9;1.000;936000;0
4255;76885;887;49;38;6;32;.842;2664000;0
4255;78815;886;100;23;0;23;1.000;3600000;0
4255;147264;886;0;0;0;0;.00nan;0;0
4256;779;882;0;0;0;0;.00nan;0;0
4256;13337;882;52;43;6;37;.860;3600000;0
4256;28831;877;0;0;0;0;.00nan;0;0
4256;70879;877;91;18;0;18;1.000;3600000;0
4257;1712;881;0;0;0;0;.00nan;0;0
4257;5354;881;94;21;0;21;1.000;3600000;0
4257;12859;873;0;0;0;0;.00nan;0;0
4257;78348;873;62;22;2;20;.909;3565000;0
4258;11670;957;0;0;0;0;.00nan;0;0
4258;65823;957;98;49;2;47;.959;3600000;0
4258;67287;872;61;36;4;32;.889;3547000;0
4258;159705;872;0;0;0;0;.00nan;0;0
4259;65;875;0;0;0;0;.00nan;0;0
4259;3077;876;0;0;0;0;.00nan;0;0
4259;60863;876;79;28;1;27;.964;3600000;0
4259;71075;875;61;27;3;24;.889;3533000;0
4260;28833;892;0;0;0;0;.00nan;0;0
4260;34708;892;77;41;3;38;.927;3600000;0
4260;44496;883;92;16;0;16;1.000;3600000;0
4260;63551;883;0;0;0;0;.00nan;0;0
4261;1712;881;0;0;0;0;.00nan;0;0
4261;5354;881;74;11;0;11;1.000;3600000;0
4261;11670;957;0;0;0;0;.00nan;0;0
4261;65823;957;98;53;1;52;.981;3562000;0
4262;46910;897;80;40;3;37;.925;3600000;0
4262;67287;872;61;20;2;18;.900;3600000;0
4262;78596;897;0;0;0;0;.00nan;0;0
4262;159705;872;0;0;0;0;.00nan;0;0
4263;3077;876;0;0;0;0;.00nan;0;0
4263;44496;883;52;23;3;20;.870;3600000;0
4263;60863;876;66;40;4;36;.900;3593000;0
4263;63551;883;0;0;0;0;.00nan;0;0
4264;28831;877;0;0;0;0;.00nan;0;0
4264;66009;887;58;42;5;37;.881;3549000;0
4264;70879;877;54;30;4;26;.867;3600000;0
4264;76885;887;0;0;0;0;.00nan;0;0
4265;11716;893;60;34;4;30;.882;3544000;0
4265;78815;886;57;23;3;20;.870;3600000;0
4265;80834;893;0;0;0;0;.00nan;0;0
4265;147264;886;0;0;0;0;.00nan;0;0
4266;65;875;0;0;0;0;.00nan;0;0
4266;12859;873;0;0;0;0;.00nan;0;0
4266;71075;875;74;29;2;27;.931;3682000;0
4266;78348;873;99;40;1;39;.975;3682000;0
4267;779;882;0;0;0;0;.00nan;0;0
4267;13337;882;50;34;5;29;.853;3600000;0
4267;28833;892;92;41;2;39;.951;3600000;0
4267;34708;892;0;0;0;0;.00nan;0;0
4268;1712;881;0;0;0;0;.00nan;0;0
4268;5354;881;100;29;0;29;1.000;3600000;0
4268;67287;872;95;42;2;40;.952;3589000;0
4268;159705;872;0;0;0;0;.00nan;0;0
4269;779;882;0;0;0;0;.00nan;0;0
4269;13337;882;67;31;3;28;.903;3743000;0
4269;46910;897;66;33;4;29;.879;3743000;0
4269;78596;897;0;0;0;0;.00nan;0;0
4270;12859;873;0;0;0;0;.00nan;0;0
4270;28831;877;0;0;0;0;.00nan;0;0
4270;70879;877;39;28;5;23;.821;3600000;0
4270;78348;873;97;31;1;30;.968;3600000;0
4271;11670;957;0;0;0;0;.00nan;0;0
4271;65823;957;77;40;4;36;.900;3576000;0
4271;78815;886;75;31;3;28;.903;3600000;0
4271;147264;886;0;0;0;0;.00nan;0;0
4272;3077;876;0;0;0;0;.00nan;0;0
4272;28833;892;0;0;0;0;.00nan;0;0
4272;34708;892;68;24;2;22;.917;3600000;0
4272;60863;876;79;34;3;31;.912;3600000;0
4273;65;875;100;34;0;34;1.000;3623000;0
4273;11716;893;77;26;1;25;.962;3623000;0
4273;71075;875;0;0;0;0;.00nan;0;0
4273;80834;893;0;0;0;0;.00nan;0;0
4274;44496;883;87;29;1;28;.966;3541000;0
4274;63551;883;0;0;0;0;.00nan;0;0
4274;66009;887;0;0;0;0;.00nan;0;0
4274;76885;887;100;29;0;29;1.000;3600000;0
4275;11670;957;0;0;0;0;.00nan;0;0
4275;11716;893;48;37;5;32;.865;3600000;0
4275;65823;957;86;28;1;27;.964;3600000;0
4275;80834;893;0;0;0;0;.00nan;0;0
4276;779;882;0;0;0;0;.00nan;0;0
4276;3077;876;0;0;0;0;.00nan;0;0
4276;13337;882;55;36;4;32;.889;3900000;0
4276;60863;876;47;22;4;18;.818;3900000;0
4277;1712;881;0;0;0;0;.00nan;0;0
4277;5354;881;68;36;3;33;.917;3600000;0
4277;66009;887;45;5;1;4;.800;482000;0
4277;76885;887;41;29;6;23;.793;3118000;0
4278;65;875;75;25;1;24;.960;3600000;0
4278;71075;875;0;0;0;0;.00nan;0;0
4278;78815;886;66;28;2;26;.929;3545000;0
4278;147264;886;0;0;0;0;.00nan;0;0
4279;12859;873;73;25;2;23;.920;3600000;0
4279;46910;897;58;18;3;15;.833;3578000;0
4279;78348;873;0;0;0;0;.00nan;0;0
4279;78596;897;0;0;0;0;.00nan;0;0
4280;28833;892;24;36;7;29;.806;3600000;0
4280;34708;892;0;0;0;0;.00nan;0;0
4280;67287;872;0;0;0;0;.00nan;0;0
4280;159705;872;81;32;2;30;.938;3600000;0
4281;28831;877;0;0;0;0;.00nan;0;0
4281;44496;883;75;26;1;25;.962;3600000;0
4281;63551;883;0;0;0;0;.00nan;0;0
4281;70879;877;72;28;2;26;.929;3562000;0
4282;779;882;0;0;0;0;.00nan;0;0
4282;1712;881;0;0;0;0;.00nan;0;0
4282;5354;881;70;24;2;22;.917;3900000;0
4282;13337;882;100;49;2;47;.959;3900000;0
4283;46910;897;0;0;0;0;.00nan;0;0
4283;78596;897;69;17;1;16;.941;3600000;0
4283;78815;886;32;32;6;26;.813;3600000;0
4283;147264;886;0;0;0;0;.00nan;0;0
4284;11716;893;74;34;3;31;.912;3541000;0
4284;44496;883;75;30;2;28;.933;3600000;0
4284;63551;883;0;0;0;0;.00nan;0;0
4284;80834;893;0;0;0;0;.00nan;0;0
4285;3077;876;0;0;0;0;.00nan;0;0
4285;12859;873;0;0;0;0;.00nan;0;0
4285;60863;876;64;39;4;35;.897;3600000;0
4285;78348;873;83;27;1;26;.963;3600000;0
4286;11670;957;79;39;3;36;.923;3900000;0
4286;28831;877;0;0;0;0;.00nan;0;0
4286;65823;957;0;0;0;0;.00nan;0;0
4286;70879;877;82;40;3;37;.925;3900000;0
4287;65;875;0;0;0;0;.00nan;0;0
4287;67287;872;74;24;1;23;.958;3600000;0
4287;71075;875;59;28;3;25;.893;3578000;0
4287;159705;872;0;0;0;0;.00nan;0;0
4288;28833;892;0;0;0;0;.00nan;0;0
4288;34708;892;32;24;5;19;.792;3600000;0
4288;66009;887;0;0;0;0;.00nan;0;0
4288;76885;887;86;40;2;38;.950;3600000;0
4289;3077;876;59;19;2;17;.895;3600000;0
4289;60863;876;0;0;0;0;.00nan;0;0
4289;67287;872;0;0;0;0;.00nan;0;0
4289;159705;872;57;31;5;26;.839;3600000;0
4290;779;882;0;0;0;0;.00nan;0;0
4290;13337;882;75;34;3;31;.912;3783000;0
4290;44496;883;52;30;4;26;.867;3783000;0
4290;63551;883;0;0;0;0;.00nan;0;0
4291;779;882;0;0;0;0;.00nan;0;0
4291;11670;957;0;0;0;0;.00nan;0;0
4291;13337;882;90;47;4;43;.915;3900000;0
4291;65823;957;67;36;4;32;.889;3900000;0
4292;11716;893;93;40;2;38;.950;3586000;0
4292;66009;887;0;0;0;0;.00nan;0;0
4292;76885;887;95;30;1;29;.967;3600000;0
4292;80834;893;0;0;0;0;.00nan;0;0
4293;28833;892;0;0;0;0;.00nan;0;0
4293;34708;892;61;27;3;24;.889;3554000;0
4293;78815;886;0;0;0;0;.00nan;0;0
4293;147264;886;74;24;1;23;.958;3600000;0
4294;1712;881;43;11;2;9;.818;743000;0
4294;5354;881;37;32;6;26;.813;2857000;0
4294;28831;877;69;37;4;33;.892;3600000;0
4294;70879;877;0;0;0;0;.00nan;0;0
4295;65;875;0;0;0;0;.00nan;0;0
4295;46910;897;46;40;6;34;.850;2500000;0
4295;71075;875;46;19;3;16;.842;3600000;0
4295;78596;897;67;17;1;16;.941;1100000;0
4296;12859;873;0;0;0;0;.00nan;0;0
4296;44496;883;0;0;0;0;.00nan;0;0
4296;63551;883;59;27;4;23;.852;3717000;0
4296;78348;873;70;31;3;28;.903;3717000;0
4297;65;875;0;0;0;0;.00nan;0;0
4297;3077;876;0;0;0;0;.00nan;0;0
4297;60863;876;53;22;3;19;.864;3600000;0
4297;71075;875;100;46;0;46;1.000;3600000;0
4298;44496;883;81;25;1;24;.960;3600000;0
4298;63551;883;0;0;0;0;.00nan;0;0
4298;78815;886;54;19;2;17;.895;3551000;0
4298;147264;886;0;0;0;0;.00nan;0;0
4299;28831;877;0;0;0;0;.00nan;0;0
4299;66009;887;0;0;0;0;.00nan;0;0
4299;70879;877;68;17;1;16;.941;3600000;0
4299;76885;887;79;48;4;44;.917;3600000;0
4300;779;882;0;0;0;0;.00nan;0;0
4300;12859;873;0;0;0;0;.00nan;0;0
4300;13337;882;53;32;4;28;.875;3600000;0
4300;78348;873;86;27;1;26;.963;3600000;0
4301;11670;957;88;38;2;36;.947;3600000;0
4301;46910;897;58;25;3;22;.880;3599000;0
4301;65823;957;0;0;0;0;.00nan;0;0
4301;78596;897;0;0;0;0;.00nan;0;0
4302;1712;881;0;0;0;0;.00nan;0;0
4302;5354;881;78;31;2;29;.935;3828000;0
4302;67287;872;0;0;0;0;.00nan;0;0
4302;159705;872;74;30;3;27;.900;3828000;0
4303;11716;893;78;31;2;29;.935;3600000;0
4303;28833;892;88;40;3;37;.925;3565000;0
4303;34708;892;0;0;0;0;.00nan;0;0
4303;80834;893;0;0;0;0;.00nan;0;0
4304;65;875;48;33;5;28;.848;3600000;0
4304;11716;893;82;27;1;26;.963;3600000;0
4304;71075;875;0;0;0;0;.00nan;0;0
4304;80834;893;0;0;0;0;.00nan;0;0
4305;5354;881;0;0;0;0;.00nan;0;0
4305;66009;887;0;0;0;0;.00nan;0;0
4305;76885;887;72;24;1;23;.958;3900000;0
4305;77082;881;74;19;1;18;.947;3900000;0
4306;13337;882;71;34;3;31;.912;3587000;0
4306;28831;877;0;0;0;0;.00nan;0;0
4306;59025;882;0;0;0;0;.00nan;0;0
4306;70879;877;83;24;2;22;.917;3600000;0
4307;28833;892;0;0;0;0;.00nan;0;0
4307;34708;892;53;36;5;31;.861;3868000;0
4307;46910;897;81;39;4;35;.897;3868000;0
4307;78596;897;0;0;0;0;.00nan;0;0
4308;11716;893;81;31;2;29;.935;3900000;0
4308;78815;886;93;38;2;36;.947;3900000;0
4308;80834;893;0;0;0;0;.00nan;0;0
4308;147264;886;0;0;0;0;.00nan;0;0
4309;11670;957;0;0;0;0;.00nan;0;0
4309;60863;876;0;0;0;0;.00nan;0;0
4309;65823;957;66;24;2;22;.917;3600000;0
4309;139409;876;92;25;1;24;.960;3600000;0
4310;12859;873;0;0;0;0;.00nan;0;0
4310;67287;872;92;31;1;30;.968;3600000;0
4310;78348;873;88;44;2;42;.955;3577000;0
4310;159705;872;0;0;0;0;.00nan;0;0
4311;65;875;0;0;0;0;.00nan;0;0
4311;44496;883;74;29;2;27;.931;3600000;0
4311;63551;883;0;0;0;0;.00nan;0;0
4311;71075;875;79;39;3;36;.923;3574000;0
4312;5354;881;0;0;0;0;.00nan;0;0
4312;13337;882;100;31;0;31;1.000;3600000;0
4312;59025;882;0;0;0;0;.00nan;0;0
4312;77082;881;64;31;3;28;.903;3600000;0
4313;28831;877;0;0;0;0;.00nan;0;0
4313;46910;897;0;0;0;0;.00nan;0;0
4313;70879;877;84;35;2;33;.943;3600000;0
4313;78596;897;80;41;3;38;.927;3571000;0
4314;28833;892;70;29;3;26;.897;3533000;0
4314;34708;892;0;0;0;0;.00nan;0;0
4314;60863;876;0;0;0;0;.00nan;0;0
4314;139409;876;70;28;2;26;.929;3600000;0
4315;66009;887;58;37;5;32;.865;3600000;0
4315;67287;872;0;0;0;0;.00nan;0;0
4315;76885;887;0;0;0;0;.00nan;0;0
4315;159705;872;88;34;2;32;.941;3600000;0
4316;12859;873;0;0;0;0;.00nan;0;0
4316;78348;873;63;23;2;21;.913;3600000;0
4316;78815;886;57;23;3;20;.870;3586000;0
4316;147264;886;0;0;0;0;.00nan;0;0
4317;11670;957;0;0;0;0;.00nan;0;0
4317;44496;883;0;0;0;0;.00nan;0;0
4317;63551;883;91;24;2;22;.917;3600000;0
4317;65823;957;62;30;3;27;.900;3557000;0
4318;13337;882;77;38;4;34;.895;3600000;0
4318;59025;882;0;0;0;0;.00nan;0;0
4318;78815;886;100;35;1;34;.971;3600000;0
4318;147264;886;0;0;0;0;.00nan;0;0
4319;5354;881;0;0;0;0;.00nan;0;0
4319;60863;876;0;0;0;0;.00nan;0;0
4319;77082;881;92;37;2;35;.946;3551000;0
4319;139409;876;54;11;1;10;.909;3600000;0
4320;11670;957;0;0;0;0;.00nan;0;0
4320;28831;877;0;0;0;0;.00nan;0;0
4320;65823;957;87;38;3;35;.921;3900000;0
4320;70879;877;72;33;3;30;.909;3900000;0
4321;11716;893;93;20;0;20;1.000;3600000;0
4321;12859;873;0;0;0;0;.00nan;0;0
4321;78348;873;94;36;1;35;.972;3581000;0
4321;80834;893;0;0;0;0;.00nan;0;0
4322;46910;897;0;0;0;0;.00nan;0;0
4322;67287;872;63;26;3;23;.885;3600000;0
4322;78596;897;71;39;4;35;.897;3564000;0
4322;159705;872;0;0;0;0;.00nan;0;0
4323;28833;892;0;0;0;0;.00nan;0;0
4323;34708;892;43;29;4;25;.862;3538000;0
4323;44496;883;0;0;0;0;.00nan;0;0
4323;63551;883;68;27;2;25;.926;3600000;0
4324;65;875;48;27;4;23;.852;3600000;0
4324;66009;887;0;0;0;0;.00nan;0;0
4324;71075;875;0;0;0;0;.00nan;0;0
4324;76885;887;100;26;0;26;1.000;3600000;0
4325;5354;881;0;0;0;0;.00nan;0;0
4325;12859;873;0;0;0;0;.00nan;0;0
4325;77082;881;82;32;2;30;.938;3900000;0
4325;78348;873;89;35;2;33;.943;3900000;0
4326;11716;893;82;27;2;25;.926;3600000;0
4326;46910;897;0;0;0;0;.00nan;0;0
4326;78596;897;54;27;3;24;.889;3600000;0
4326;80834;893;0;0;0;0;.00nan;0;0
4327;13337;882;82;16;1;15;.938;3600000;0
4327;59025;882;0;0;0;0;.00nan;0;0
4327;66009;887;0;0;0;0;.00nan;0;0
4327;76885;887;62;35;4;31;.886;3600000;0
4328;28831;877;0;0;0;0;.00nan;0;0
4328;70879;877;80;13;0;13;1.000;3600000;0
4328;78815;886;84;44;3;41;.932;3600000;0
4328;147264;886;0;0;0;0;.00nan;0;0
4329;11670;957;72;39;4;35;.897;3583000;0
4329;65823;957;0;0;0;0;.00nan;0;0
4329;67287;872;66;19;2;17;.895;3600000;0
4329;159705;872;0;0;0;0;.00nan;0;0
4330;65;875;89;38;2;36;.947;3679000;0
4330;28833;892;72;21;1;20;.952;3679000;0
4330;34708;892;0;0;0;0;.00nan;0;0
4330;71075;875;0;0;0;0;.00nan;0;0
4331;44496;883;28;20;5;15;.750;3576000;0
4331;60863;876;0;0;0;0;.00nan;0;0
4331;63551;883;0;0;0;0;.00nan;0;0
4331;139409;876;83;44;4;40;.909;3600000;0
4332;5354;881;0;0;0;0;.00nan;0;0
4332;77082;881;58;25;3;22;.880;3645000;0
4332;78815;886;64;32;4;28;.875;3645000;0
4332;147264;886;0;0;0;0;.00nan;0;0
4333;13337;882;100;44;1;43;.977;3668000;0
4333;44496;883;79;28;2;26;.929;3668000;0
4333;59025;882;0;0;0;0;.00nan;0;0
4333;63551;883;0;0;0;0;.00nan;0;0
4334;65;875;92;42;2;40;.952;3900000;0
4334;46910;897;0;0;0;0;.00nan;0;0
4334;71075;875;0;0;0;0;.00nan;0;0
4334;78596;897;66;23;2;21;.913;3900000;0
4335;11716;893;0;0;0;0;.00nan;0;0
4335;66009;887;0;0;0;0;.00nan;0;0
4335;76885;887;78;41;3;38;.927;3574000;0
4335;80834;893;73;24;2;22;.917;3600000;0
4336;12859;873;94;41;3;38;.927;3600000;0
4336;20645;877;45;5;1;4;.800;1589000;0
4336;28831;877;30;17;4;13;.765;1957000;0
4336;78348;873;0;0;0;0;.00nan;0;0
4337;60863;876;0;0;0;0;.00nan;0;0
4337;67287;872;54;28;4;24;.857;3900000;0
4337;139409;876;61;30;4;26;.867;3900000;0
4337;159705;872;0;0;0;0;.00nan;0;0
4338;11670;957;0;0;0;0;.00nan;0;0
4338;28833;892;2;21;7;14;.667;3600000;0
4338;34708;892;0;0;0;0;.00nan;0;0
4338;65823;957;100;41;2;39;.951;3600000;0
4339;65;875;75;35;3;32;.914;3597000;0
4339;13337;882;95;38;2;36;.947;3600000;0
4339;59025;882;0;0;0;0;.00nan;0;0
4339;71075;875;0;0;0;0;.00nan;0;0
4340;5354;881;0;0;0;0;.00nan;0;0
4340;11716;893;78;25;1;24;.960;3600000;0
4340;77082;881;74;29;2;27;.931;3600000;0
4340;80834;893;0;0;0;0;.00nan;0;0
4341;12859;873;0;0;0;0;.00nan;0;0
4341;60863;876;0;0;0;0;.00nan;0;0
4341;78348;873;96;36;2;34;.944;3890000;0
4341;139409;876;94;34;2;32;.941;3900000;0
4342;11670;957;0;0;0;0;.00nan;0;0
4342;65823;957;69;27;3;24;.889;3600000;0
4342;66009;887;0;0;0;0;.00nan;0;0
4342;76885;887;57;28;4;24;.857;3591000;0
4343;20645;877;70;30;2;28;.933;3600000;0
4343;28831;877;0;0;0;0;.00nan;0;0
4343;28833;892;0;0;0;0;.00nan;0;0
4343;34708;892;33;30;6;24;.800;3600000;0
4344;44496;883;17;14;5;9;.643;1655000;0
4344;46910;897;0;0;0;0;.00nan;0;0
4344;63551;883;57;18;2;16;.889;1945000;0
4344;78596;897;81;28;1;27;.964;3600000;0
4345;67287;872;65;20;2;18;.900;3550000;0
4345;78815;886;0;0;0;0;.00nan;0;0
4345;147264;886;67;22;1;21;.955;3600000;0
4345;159705;872;0;0;0;0;.00nan;0;0
4346;13337;882;90;31;2;29;.935;3600000;0
4346;59025;882;0;0;0;0;.00nan;0;0
4346;60863;876;0;0;0;0;.00nan;0;0
4346;139409;876;62;37;5;32;.865;3600000;0
4347;28831;877;0;0;0;0;.00nan;0;0
4347;44496;883;0;0;0;0;.00nan;0;0
4347;63551;883;65;39;5;34;.872;3600000;0
4347;70879;877;85;31;2;29;.935;3600000;0
4348;12859;873;0;0;0;0;.00nan;0;0
4348;66009;887;0;0;0;0;.00nan;0;0
4348;76885;887;81;29;1;28;.966;3600000;0
4348;78348;873;57;40;5;35;.875;3600000;0
4349;11670;957;0;0;0;0;.00nan;0;0
4349;11716;893;70;27;2;25;.926;3580000;0
4349;65823;957;91;40;1;39;.975;3600000;0
4349;80834;893;0;0;0;0;.00nan;0;0
4350;28833;892;0;0;0;0;.00nan;0;0
4350;34708;892;75;34;3;31;.912;3616000;0
4350;53879;881;78;28;2;26;.929;3616000;0
4350;77082;881;0;0;0;0;.00nan;0;0
4351;65;875;0;0;0;0;.00nan;0;0
4351;67287;872;72;32;2;30;.938;3900000;0
4351;71075;875;70;27;2;25;.926;3900000;0
4351;159705;872;0;0;0;0;.00nan;0;0
4352;65;875;57;26;3;23;.885;3557000;0
4352;53879;881;96;39;1;38;.974;3600000;0
4352;71075;875;0;0;0;0;.00nan;0;0
4352;77082;881;0;0;0;0;.00nan;0;0
4353;12859;873;0;0;0;0;.00nan;0;0
4353;46910;897;0;0;0;0;.00nan;0;0
4353;78348;873;100;29;1;28;.966;3600000;0
4353;78596;897;63;24;2;22;.917;3600000;0
4354;28831;877;0;0;0;0;.00nan;0;0
4354;60863;876;0;0;0;0;.00nan;0;0
4354;70879;877;61;27;3;24;.889;3600000;0
4354;139409;876;54;39;5;34;.872;3600000;0
4355;28833;892;100;28;0;28;1.000;3600000;0
4355;34708;892;0;0;0;0;.00nan;0;0
4355;66009;887;0;0;0;0;.00nan;0;0
4355;76885;887;78;32;2;30;.938;3552000;0
4356;11670;957;80;28;1;27;.964;3600000;0
4356;65823;957;0;0;0;0;.00nan;0;0
4356;78815;886;58;19;2;17;.895;3564000;0
4356;147264;886;0;0;0;0;.00nan;0;0
4357;13337;882;79;43;4;39;.907;3796000;0
4357;59025;882;0;0;0;0;.00nan;0;0
4357;67287;872;62;27;3;24;.889;3796000;0
4357;159705;872;0;0;0;0;.00nan;0;0
4358;11716;893;76;36;3;33;.917;3600000;0
4358;44496;883;0;0;0;0;.00nan;0;0
4358;63551;883;100;27;0;27;1.000;3600000;0
4358;80834;893;0;0;0;0;.00nan;0;0
4359;46910;897;0;0;0;0;.00nan;0;0
4359;53879;881;62;32;4;28;.875;3579000;0
4359;77082;881;0;0;0;0;.00nan;0;0
4359;78596;897;62;24;3;21;.875;3600000;0
4360;11716;893;86;37;1;36;.973;3900000;0
4360;60863;876;0;0;0;0;.00nan;0;0
4360;80834;893;0;0;0;0;.00nan;0;0
4360;139409;876;87;27;1;26;.963;3900000;0
4361;44496;883;0;0;0;0;.00nan;0;0
4361;63551;883;59;28;4;24;.857;3643000;0
4361;66009;887;63;28;3;25;.893;3643000;0
4361;76885;887;0;0;0;0;.00nan;0;0
4362;12859;873;0;0;0;0;.00nan;0;0
4362;28833;892;91;20;0;20;1.000;3600000;0
4362;34708;892;0;0;0;0;.00nan;0;0
4362;78348;873;57;42;6;36;.857;3600000;0
4363;11670;957;0;0;0;0;.00nan;0;0
4363;13337;882;94;26;1;25;.962;3600000;0
4363;59025;882;0;0;0;0;.00nan;0;0
4363;65823;957;55;27;3;24;.889;3541000;0
4364;28831;877;0;0;0;0;.00nan;0;0
4364;67287;872;75;33;3;30;.909;3600000;0
4364;70879;877;100;31;0;31;1.000;3600000;0
4364;159705;872;0;0;0;0;.00nan;0;0
4365;65;875;93;31;2;29;.935;3782000;0
4365;71075;875;0;0;0;0;.00nan;0;0
4365;78815;886;99;39;1;38;.974;3782000;0
4365;147264;886;0;0;0;0;.00nan;0;0
4366;46910;897;52;30;5;25;.833;3556000;0
4366;66009;887;0;0;0;0;.00nan;0;0
4366;76885;887;84;40;3;37;.925;3600000;0
4366;78596;897;0;0;0;0;.00nan;0;0
4367;11716;893;72;35;3;32;.914;3600000;0
4367;13337;882;84;30;2;28;.933;3600000;0
4367;59025;882;0;0;0;0;.00nan;0;0
4367;80834;893;0;0;0;0;.00nan;0;0
4368;60863;876;0;0;0;0;.00nan;0;0
4368;78815;886;0;0;0;0;.00nan;0;0
4368;139409;876;93;44;3;41;.932;3774000;0
4368;147264;886;57;31;4;27;.871;3774000;0
4369;65;875;97;38;0;38;1.000;3900000;0
4369;28831;877;0;0;0;0;.00nan;0;0
4369;70879;877;100;26;0;26;1.000;3900000;0
4369;71075;875;0;0;0;0;.00nan;0;0
4370;11670;957;77;34;2;32;.941;3600000;0
4370;12859;873;0;0;0;0;.00nan;0;0
4370;65823;957;0;0;0;0;.00nan;0;0
4370;78348;873;90;42;4;38;.905;3592000;0
4371;28833;892;100;38;0;38;1.000;3600000;0
4371;34708;892;0;0;0;0;.00nan;0;0
4371;67287;872;66;32;3;29;.906;3600000;0
4371;159705;872;0;0;0;0;.00nan;0;0
4372;44496;883;0;0;0;0;.00nan;0;0
4372;53879;881;84;31;2;29;.935;3600000;0
4372;63551;883;38;30;5;25;.833;3600000;0
4372;77082;881;0;0;0;0;.00nan;0;0
4373;28831;877;0;0;0;0;.00nan;0;0
4373;53879;881;83;44;4;40;.909;3681000;0
4373;70879;877;62;30;3;27;.900;3681000;0
4373;77082;881;0;0;0;0;.00nan;0;0
4374;13337;882;72;40;4;36;.900;3600000;0
4374;46910;897;100;27;0;27;1.000;3600000;0
4374;59025;882;0;0;0;0;.00nan;0;0
4374;78596;897;0;0;0;0;.00nan;0;0
4375;60863;876;0;0;0;0;.00nan;0;0
4375;66009;887;0;0;0;0;.00nan;0;0
4375;76885;887;60;29;3;26;.897;3600000;0
4375;139409;876;58;43;6;37;.860;3600000;0
4376;12859;873;0;0;0;0;.00nan;0;0
4376;44496;883;63;30;3;27;.900;2594000;0
4376;63551;883;23;12;4;8;.667;1006000;0
4376;78348;873;72;30;3;27;.900;3600000;0
4377;11716;893;57;41;6;35;.854;2680000;0
4377;67287;872;0;0;0;0;.00nan;0;0
4377;80834;893;55;7;0;7;1.000;920000;0
4377;159705;872;71;25;2;23;.920;3600000;0
4378;28833;892;44;16;3;13;.813;3600000;0
4378;34708;892;0;0;0;0;.00nan;0;0
4378;78815;886;25;13;4;9;.692;1187000;0
4378;147264;886;37;24;4;20;.833;2413000;0
4379;65;875;81;34;3;31;.912;3900000;0
4379;11670;957;0;0;0;0;.00nan;0;0
4379;65823;957;91;36;3;33;.917;3900000;0
4379;71075;875;0;0;0;0;.00nan;0;0
4380;28831;877;0;0;0;0;.00nan;0;0
4380;53879;881;64;30;3;27;.900;3828000;0
4380;70879;877;41;19;4;15;.789;3828000;0
4380;77082;881;0;0;0;0;.00nan;0;0
4381;13337;882;80;32;3;29;.906;3589000;0
4381;28833;892;86;26;1;25;.962;3600000;0
4381;34708;892;0;0;0;0;.00nan;0;0
4381;59025;882;0;0;0;0;.00nan;0;0
4382;11716;893;100;48;1;47;.979;3600000;0
4382;60863;876;0;0;0;0;.00nan;0;0
4382;80834;893;0;0;0;0;.00nan;0;0
4382;139409;876;72;26;2;24;.923;3557000;0
4383;11670;957;0;0;0;0;.00nan;0;0
4383;46910;897;60;16;1;15;.938;3600000;0
4383;65823;957;68;35;3;32;.914;3557000;0
4383;78596;897;0;0;0;0;.00nan;0;0
4384;44496;883;0;0;0;0;.00nan;0;0
4384;63551;883;71;27;3;24;.889;3900000;0
4384;67287;872;86;39;3;36;.923;3900000;0
4384;159705;872;0;0;0;0;.00nan;0;0
4385;11716;893;100;38;2;36;.947;3900000;0
4385;28831;877;0;0;0;0;.00nan;0;0
4385;70879;877;91;34;2;32;.941;3900000;0
4385;80834;893;0;0;0;0;.00nan;0;0
4386;46910;897;88;29;1;28;.966;3900000;0
4386;60863;876;0;0;0;0;.00nan;0;0
4386;78596;897;0;0;0;0;.00nan;0;0
4386;139409;876;94;23;1;22;.957;3900000;0
4387;66009;887;0;0;0;0;.00nan;0;0
4387;76885;887;69;26;3;23;.885;3592000;0
4387;78815;886;95;43;2;41;.953;3600000;0
4387;147264;886;0;0;0;0;.00nan;0;0
4388;11670;957;0;0;0;0;.00nan;0;0
4388;53879;881;93;35;2;33;.943;3600000;0
4388;65823;957;37;30;6;24;.800;3600000;0
4388;77082;881;0;0;0;0;.00nan;0;0
4389;65;875;0;0;0;0;.00nan;0;0
4389;12859;873;0;0;0;0;.00nan;0;0
4389;71075;875;73;24;1;23;.958;3900000;0
4389;78348;873;99;40;1;39;.975;3900000;0
4390;44496;883;0;0;0;0;.00nan;0;0
4390;63551;883;56;30;4;26;.867;3871000;0
4390;67287;872;55;26;3;23;.885;3871000;0
4390;159705;872;0;0;0;0;.00nan;0;0
4391;53879;881;63;29;3;26;.897;3548000;0
4391;66009;887;0;0;0;0;.00nan;0;0
4391;76885;887;80;24;1;23;.958;3600000;0
4391;77082;881;0;0;0;0;.00nan;0;0
4392;11716;893;68;23;3;20;.870;3900000;0
4392;78815;886;0;0;0;0;.00nan;0;0
4392;80834;893;0;0;0;0;.00nan;0;0
4392;147264;886;74;39;3;36;.923;3900000;0
4393;28831;877;0;0;0;0;.00nan;0;0
4393;46910;897;62;39;4;35;.897;3532000;0
4393;70879;877;73;22;2;20;.909;3600000;0
4393;78596;897;0;0;0;0;.00nan;0;0
4394;12859;873;0;0;0;0;.00nan;0;0
4394;60863;876;0;0;0;0;.00nan;0;0
4394;78348;873;76;37;3;34;.919;3900000;0
4394;139409;876;68;27;3;24;.889;3900000;0
4395;11670;957;0;0;0;0;.00nan;0;0
4395;65823;957;82;26;1;25;.962;3600000;0
4395;67287;872;69;22;2;20;.909;3550000;0
4395;159705;872;0;0;0;0;.00nan;0;0
4396;65;875;38;20;3;17;.850;3575000;0
4396;28833;892;89;29;1;28;.966;3600000;0
4396;34708;892;0;0;0;0;.00nan;0;0
4396;71075;875;0;0;0;0;.00nan;0;0
4397;11670;957;0;0;0;0;.00nan;0;0
4397;53879;881;0;0;0;0;.00nan;0;0
4397;65823;957;99;44;1;43;.977;3600000;0
4397;77082;881;67;29;3;26;.897;3555000;0
4398;44496;883;87;28;1;27;.964;3600000;0
4398;46910;897;0;0;0;0;.00nan;0;0
4398;63551;883;0;0;0;0;.00nan;0;0
4398;78596;897;64;35;4;31;.886;3600000;0
4399;12859;873;0;0;0;0;.00nan;0;0
4399;28831;877;0;0;0;0;.00nan;0;0
4399;70879;877;62;23;2;21;.913;3900000;0
4399;78348;873;95;42;2;40;.952;3900000;0
4400;67287;872;99;32;1;31;.969;3600000;0
4400;78815;886;61;31;3;28;.903;3576000;0
4400;147264;886;0;0;0;0;.00nan;0;0
4400;159705;872;0;0;0;0;.00nan;0;0
4401;28833;892;63;36;3;33;.917;3600000;0
4401;34708;892;0;0;0;0;.00nan;0;0
4401;66009;887;0;0;0;0;.00nan;0;0
4401;76885;887;83;38;2;36;.947;3600000;0
4402;65;875;0;0;0;0;.00nan;0;0
4402;11716;893;68;32;4;28;.875;3600000;0
4402;71075;875;91;27;1;26;.963;3600000;0
4402;80834;893;0;0;0;0;.00nan;0;0
4403;28833;892;77;32;3;29;.906;3548000;0
4403;34708;892;0;0;0;0;.00nan;0;0
4403;78815;886;97;39;1;38;.974;3600000;0
4403;147264;886;0;0;0;0;.00nan;0;0
4404;13337;882;52;37;5;32;.865;3534000;0
4404;53879;881;85;37;3;34;.919;3600000;0
4404;59025;882;0;0;0;0;.00nan;0;0
4404;77082;881;0;0;0;0;.00nan;0;0
4405;11716;893;90;27;1;26;.963;3900000;0
4405;67287;872;86;30;1;29;.967;3900000;0
4405;80834;893;0;0;0;0;.00nan;0;0
4405;159705;872;0;0;0;0;.00nan;0;0
4406;28831;877;0;0;0;0;.00nan;0;0
4406;66009;887;0;0;0;0;.00nan;0;0
4406;70879;877;100;30;1;29;.967;3600000;0
4406;76885;887;52;32;5;27;.844;3600000;0
4407;12859;873;0;0;0;0;.00nan;0;0
4407;46910;897;52;15;2;13;.867;3600000;0
4407;78348;873;65;26;3;23;.885;3562000;0
4407;78596;897;0;0;0;0;.00nan;0;0
4408;11670;957;0;0;0;0;.00nan;0;0
4408;28833;892;60;27;3;24;.889;3900000;0
4408;34708;892;0;0;0;0;.00nan;0;0
4408;65823;957;60;28;3;25;.893;3900000;0
4409;65;875;56;39;5;34;.872;3554000;0
4409;60863;876;0;0;0;0;.00nan;0;0
4409;71075;875;0;0;0;0;.00nan;0;0
4409;139409;876;68;35;3;32;.914;3600000;0
4410;44496;883;0;0;0;0;.00nan;0;0
4410;63551;883;70;22;1;21;.955;3600000;0
4410;78815;886;67;37;5;32;.865;3600000;0
4410;147264;886;0;0;0;0;.00nan;0;0
4411;46910;897;62;24;2;22;.917;3554000;0
4411;60863;876;0;0;0;0;.00nan;0;0
4411;78596;897;0;0;0;0;.00nan;0;0
4411;139409;876;96;27;1;26;.963;3600000;0
4412;11670;957;0;0;0;0;.00nan;0;0
4412;11716;893;92;33;2;31;.939;3586000;0
4412;65823;957;76;22;1;21;.955;3600000;0
4412;80834;893;0;0;0;0;.00nan;0;0
4413;65;875;46;30;5;25;.833;3600000;0
4413;66009;887;0;0;0;0;.00nan;0;0
4413;71075;875;0;0;0;0;.00nan;0;0
4413;76885;887;99;33;1;32;.970;3600000;0
4414;13337;882;84;43;4;39;.907;3600000;0
4414;59025;882;0;0;0;0;.00nan;0;0
4414;78815;886;84;26;1;25;.962;3600000;0
4414;147264;886;0;0;0;0;.00nan;0;0
4415;28831;877;0;0;0;0;.00nan;0;0
4415;67287;872;61;40;5;35;.875;3600000;0
4415;70879;877;75;21;1;20;.952;3600000;0
4415;159705;872;0;0;0;0;.00nan;0;0
4416;12859;873;0;0;0;0;.00nan;0;0
4416;53879;881;58;15;2;13;.867;3600000;0
4416;77082;881;0;0;0;0;.00nan;0;0
4416;78348;873;59;25;3;22;.880;3555000;0
4417;28833;892;66;21;2;19;.905;3886000;0
4417;34708;892;0;0;0;0;.00nan;0;0
4417;44496;883;0;0;0;0;.00nan;0;0
4417;63551;883;61;26;3;23;.885;3886000;0
4418;65;875;76;33;2;31;.939;3600000;0
4418;67287;872;80;38;3;35;.921;3600000;0
4418;71075;875;0;0;0;0;.00nan;0;0
4418;159705;872;0;0;0;0;.00nan;0;0
4419;44496;883;53;29;4;25;.862;3900000;0
4419;53879;881;62;41;4;37;.902;3900000;0
4419;63551;883;0;0;0;0;.00nan;0;0
4419;77082;881;0;0;0;0;.00nan;0;0
4420;12859;873;0;0;0;0;.00nan;0;0
4420;13337;882;79;38;3;35;.921;3519000;0
4420;59025;882;0;0;0;0;.00nan;0;0
4420;78348;873;74;23;1;22;.957;3600000;0
4421;60863;876;0;0;0;0;.00nan;0;0
4421;78815;886;82;39;2;37;.949;3741000;0
4421;139409;876;69;30;3;27;.900;3741000;0
4421;147264;886;0;0;0;0;.00nan;0;0
4422;11716;893;82;44;3;41;.932;3600000;0
4422;28831;877;0;0;0;0;.00nan;0;0
4422;70879;877;61;20;2;18;.900;3600000;0
4422;80834;893;0;0;0;0;.00nan;0;0
4423;11670;957;0;0;0;0;.00nan;0;0
4423;65823;957;31;31;6;25;.806;3600000;0
4423;66009;887;0;0;0;0;.00nan;0;0
4423;76885;887;57;24;3;21;.875;3600000;0
4424;65;875;100;44;1;43;.977;3600000;0
4424;67287;872;0;0;0;0;.00nan;0;0
4424;71075;875;0;0;0;0;.00nan;0;0
4424;159705;872;26;21;5;16;.762;3600000;0
4425;28833;892;36;11;3;8;.727;3600000;0
4425;34708;892;0;0;0;0;.00nan;0;0
4425;46910;897;64;46;5;41;.891;3535000;0
4425;78596;897;0;0;0;0;.00nan;0;0
4426;13337;882;68;16;1;15;.938;3577000;0
4426;59025;882;0;0;0;0;.00nan;0;0
4426;67287;872;100;42;0;42;1.000;3600000;0
4426;159705;872;0;0;0;0;.00nan;0;0
4427;46910;897;77;34;2;32;.941;3600000;0
4427;66009;887;49;26;4;22;.846;3600000;0
4427;76885;887;0;0;0;0;.00nan;0;0
4427;78596;897;0;0;0;0;.00nan;0;0
4428;12859;873;0;0;0;0;.00nan;0;0
4428;78348;873;61;29;3;26;.897;3600000;0
4428;78815;886;62;21;2;19;.905;3600000;0
4428;147264;886;0;0;0;0;.00nan;0;0
4429;11670;957;81;39;2;37;.949;3900000;0
4429;28831;877;0;0;0;0;.00nan;0;0
4429;65823;957;0;0;0;0;.00nan;0;0
4429;70879;877;82;30;2;28;.933;3900000;0
4430;28833;892;0;0;0;0;.00nan;0;0
4430;34708;892;42;26;5;21;.808;3515000;0
4430;60863;876;0;0;0;0;.00nan;0;0
4430;139409;876;68;35;3;32;.914;3600000;0
4431;65;875;94;31;1;30;.968;3600000;0
4431;53879;881;69;24;2;22;.917;3593000;0
4431;71075;875;0;0;0;0;.00nan;0;0
4431;77082;881;0;0;0;0;.00nan;0;0
4432;11716;893;31;28;6;22;.786;3091000;0
4432;44496;883;85;39;2;37;.949;3600000;0
4432;63551;883;0;0;0;0;.00nan;0;0
4432;80834;893;40;2;1;1;.500;509000;0
4433;46910;897;0;0;0;0;.00nan;0;0
4433;78596;897;59;23;2;21;.913;3600000;0
4433;78815;886;69;37;4;33;.892;3594000;0
4433;147264;886;0;0;0;0;.00nan;0;0
4434;28833;892;100;31;0;31;1.000;3600000;0
4434;34708;892;0;0;0;0;.00nan;0;0
4434;53879;881;0;0;0;0;.00nan;0;0
4434;77082;881;64;18;1;17;.944;3563000;0
4435;46910;897;80;17;0;17;1.000;3600000;0
4435;78596;897;0;0;0;0;.00nan;0;0
4435;78815;886;56;35;4;31;.886;3600000;0
4435;147264;886;0;0;0;0;.00nan;0;0
4436;11716;893;64;24;3;21;.875;3553000;0
4436;60863;876;0;0;0;0;.00nan;0;0
4436;80834;893;0;0;0;0;.00nan;0;0
4436;139409;876;78;27;2;25;.926;3600000;0
4437;11670;957;0;0;0;0;.00nan;0;0
4437;12859;873;84;34;2;32;.941;3900000;0
4437;65823;957;76;38;2;36;.947;3900000;0
4437;78348;873;0;0;0;0;.00nan;0;0
4438;66009;887;0;0;0;0;.00nan;0;0
4438;67287;872;64;31;3;28;.903;3600000;0
4438;76885;887;85;31;2;29;.935;3600000;0
4438;159705;872;0;0;0;0;.00nan;0;0
4439;65;875;0;0;0;0;.00nan;0;0
4439;13337;882;84;33;2;31;.939;3822000;0
4439;59025;882;0;0;0;0;.00nan;0;0
4439;71075;875;83;27;1;26;.963;3822000;0
4440;28831;877;0;0;0;0;.00nan;0;0
4440;44496;883;0;0;0;0;.00nan;0;0
4440;63551;883;56;18;2;16;.889;3600000;0
4440;70879;877;53;34;5;29;.853;3600000;0
4441;53879;881;69;37;3;34;.919;3565000;0
4441;67287;872;77;33;2;31;.939;3600000;0
4441;77082;881;0;0;0;0;.00nan;0;0
4441;159705;872;0;0;0;0;.00nan;0;0
4442;11716;893;0;0;0;0;.00nan;0;0
4442;46910;897;71;21;1;20;.952;3600000;0
4442;78596;897;0;0;0;0;.00nan;0;0
4442;80834;893;74;36;2;34;.944;3554000;0
4443;66009;887;0;0;0;0;.00nan;0;0
4443;76885;887;58;25;3;22;.880;3571000;0
4443;78815;886;0;0;0;0;.00nan;0;0
4443;147264;886;79;31;2;29;.935;3600000;0
4444;28831;877;0;0;0;0;.00nan;0;0
4444;60863;876;0;0;0;0;.00nan;0;0
4444;70879;877;53;25;3;22;.880;3547000;0
4444;139409;876;86;33;2;31;.939;3600000;0
4445;65;875;51;23;3;20;.870;3600000;0
4445;11670;957;46;5;1;4;.800;776000;0
4445;65823;957;21;24;6;18;.750;2824000;0
4445;71075;875;0;0;0;0;.00nan;0;0
4446;13337;882;58;29;4;25;.862;3600000;0
4446;28833;892;76;23;1;22;.957;3600000;0
4446;34708;892;0;0;0;0;.00nan;0;0
4446;59025;882;0;0;0;0;.00nan;0;0
4447;12859;873;0;0;0;0;.00nan;0;0
4447;44496;883;91;24;1;23;.958;3600000;0
4447;63551;883;0;0;0;0;.00nan;0;0
4447;78348;873;79;31;2;29;.935;3542000;0
4448;65;875;0;0;0;0;.00nan;0;0
4448;53879;881;73;28;2;26;.929;3746000;0
4448;71075;875;79;34;3;31;.912;3717000;0
4448;77082;881;0;0;0;0;.00nan;0;0
4449;44496;883;0;0;0;0;.00nan;0;0
4449;63551;883;76;38;4;34;.895;3600000;0
4449;66009;887;0;0;0;0;.00nan;0;0
4449;76885;887;83;26;1;25;.962;3600000;0
4450;12859;873;0;0;0;0;.00nan;0;0
4450;13337;882;73;25;1;24;.960;3900000;0
4450;59025;882;0;0;0;0;.00nan;0;0
4450;78348;873;93;33;1;32;.970;3900000;0
4451;11670;957;0;0;0;0;.00nan;0;0
4451;13337;882;0;0;0;0;.00nan;0;0
4451;59025;882;78;33;3;30;.909;3759000;0
4451;65823;957;61;34;4;30;.882;3759000;0
4452;46910;897;78;33;2;31;.939;3555000;0
4452;67287;872;89;20;0;20;1.000;3600000;0
4452;78596;897;0;0;0;0;.00nan;0;0
4452;159705;872;0;0;0;0;.00nan;0;0
4453;44496;883;87;42;4;38;.905;3900000;0
4453;60863;876;0;0;0;0;.00nan;0;0
4453;63551;883;0;0;0;0;.00nan;0;0
4453;139409;876;47;29;4;25;.862;3886000;0
4454;11716;893;41;22;4;18;.818;1128000;0
4454;66009;887;0;0;0;0;.00nan;0;0
4454;76885;887;32;24;5;19;.792;3600000;0
4454;80834;893;38;19;4;15;.789;2472000;0
4455;53879;881;74;25;1;24;.960;3600000;0
4455;77082;881;0;0;0;0;.00nan;0;0
4455;78815;886;67;23;2;21;.913;3571000;0
4455;147264;886;0;0;0;0;.00nan;0;0
4456;12859;873;0;0;0;0;.00nan;0;0
4456;28833;892;63;21;2;19;.905;3600000;0
4456;34708;892;0;0;0;0;.00nan;0;0
4456;78348;873;55;37;5;32;.865;3600000;0
4457;65;875;71;27;2;25;.926;3600000;0
4457;28831;877;0;0;0;0;.00nan;0;0
4457;70879;877;67;29;3;26;.897;3581000;0
4457;71075;875;0;0;0;0;.00nan;0;0
4458;11716;893;49;22;3;19;.864;3600000;0
4458;53879;881;97;26;0;26;1.000;3600000;0
4458;77082;881;0;0;0;0;.00nan;0;0
4458;80834;893;0;0;0;0;.00nan;0;0
4459;13337;882;100;32;0;32;1.000;3600000;0
4459;46910;897;76;23;1;22;.957;3599000;0
4459;59025;882;0;0;0;0;.00nan;0;0
4459;78596;897;0;0;0;0;.00nan;0;0
4460;60863;876;0;0;0;0;.00nan;0;0
4460;66009;887;0;0;0;0;.00nan;0;0
4460;76885;887;89;32;1;31;.969;3577000;0
4460;139409;876;100;30;0;30;1.000;3600000;0
4461;28831;877;0;0;0;0;.00nan;0;0
4461;70879;877;61;33;3;30;.909;3590000;0
4461;78815;886;86;34;2;32;.941;3600000;0
4461;147264;886;0;0;0;0;.00nan;0;0
4462;65;875;70;21;2;19;.905;3900000;0
4462;12859;873;0;0;0;0;.00nan;0;0
4462;71075;875;0;0;0;0;.00nan;0;0
4462;78348;873;83;31;2;29;.935;3900000;0
4463;11670;957;49;28;4;24;.857;2351000;0
4463;44496;883;0;0;0;0;.00nan;0;0
4463;63551;883;60;26;3;23;.885;3600000;0
4463;65823;957;59;26;3;23;.885;1249000;0
4464;28833;892;60;14;1;13;.929;3600000;0
4464;34708;892;0;0;0;0;.00nan;0;0
4464;67287;872;52;34;5;29;.853;3600000;0
4464;159705;872;0;0;0;0;.00nan;0;0
4465;46910;897;74;40;4;36;.900;3600000;0
4465;53879;881;100;24;0;24;1.000;3600000;0
4465;77082;881;0;0;0;0;.00nan;0;0
4465;78596;897;0;0;0;0;.00nan;0;0
4466;11716;893;0;0;0;0;.00nan;0;0
4466;28833;892;66;25;2;23;.920;3537000;0
4466;34708;892;0;0;0;0;.00nan;0;0
4466;80834;893;91;43;1;42;.977;3600000;0
4467;11670;957;0;0;0;0;.00nan;0;0
4467;60863;876;0;0;0;0;.00nan;0;0
4467;65823;957;76;30;2;28;.933;3900000;0
4467;139409;876;70;27;2;25;.926;3900000;0
4468;65;875;0;0;0;0;.00nan;0;0
4468;71075;875;49;37;5;32;.865;3600000;0
4468;78815;886;91;38;2;36;.947;3600000;0
4468;147264;886;0;0;0;0;.00nan;0;0
4469;13337;882;79;47;4;43;.915;3576000;0
4469;28831;877;0;0;0;0;.00nan;0;0
4469;59025;882;0;0;0;0;.00nan;0;0
4469;70879;877;66;24;3;21;.875;3600000;0
4470;12859;873;0;0;0;0;.00nan;0;0
4470;67287;872;100;29;0;29;1.000;3600000;0
4470;78348;873;97;43;2;41;.953;3600000;0
4470;159705;872;0;0;0;0;.00nan;0;0
4471;44496;883;100;27;0;27;1.000;3600000;0
4471;63551;883;0;0;0;0;.00nan;0;0
4471;66009;887;0;0;0;0;.00nan;0;0
4471;76885;887;98;41;2;39;.951;3582000;0
4472;53879;881;67;36;4;32;.889;3568000;0
4472;60863;876;0;0;0;0;.00nan;0;0
4472;77082;881;0;0;0;0;.00nan;0;0
4472;139409;876;92;31;1;30;.968;3600000;0
4473;11716;893;75;34;3;31;.912;3600000;0
4473;13337;882;98;37;2;35;.946;3600000;0
4473;59025;882;0;0;0;0;.00nan;0;0
4473;80834;893;0;0;0;0;.00nan;0;0
4474;12859;873;0;0;0;0;.00nan;0;0
4474;66009;887;59;30;3;27;.900;3593000;0
4474;76885;887;0;0;0;0;.00nan;0;0
4474;78348;873;68;24;2;22;.917;3600000;0
4475;11670;957;0;0;0;0;.00nan;0;0
4475;65823;957;45;31;5;26;.839;3576000;0
4475;78815;886;68;31;3;28;.903;3600000;0
4475;147264;886;0;0;0;0;.00nan;0;0
4476;44496;883;0;0;0;0;.00nan;0;0
4476;63551;883;60;32;3;29;.906;3560000;0
4476;67287;872;55;14;2;12;.857;3600000;0
4476;159705;872;0;0;0;0;.00nan;0;0
4477;28831;877;73;20;1;19;.950;1670000;0
4477;28833;892;55;29;4;25;.862;3600000;0
4477;34708;892;0;0;0;0;.00nan;0;0
4477;70879;877;11;21;7;14;.667;1930000;0
4478;65;875;0;0;0;0;.00nan;0;0
4478;46910;897;59;34;4;30;.882;3590000;0
4478;71075;875;69;20;2;18;.900;3600000;0
4478;78596;897;0;0;0;0;.00nan;0;0
4479;13337;882;66;29;3;26;.897;3900000;0
4479;59025;882;0;0;0;0;.00nan;0;0
4479;66009;887;0;0;0;0;.00nan;0;0
4479;76885;887;63;29;3;26;.897;3900000;0
4480;11670;957;60;34;4;30;.882;3600000;0
4480;46910;897;0;0;0;0;.00nan;0;0
4480;65823;957;0;0;0;0;.00nan;0;0
4480;78596;897;71;21;2;19;.905;3600000;0
4481;11716;893;0;0;0;0;.00nan;0;0
4481;12859;873;0;0;0;0;.00nan;0;0
4481;78348;873;57;24;3;21;.875;3552000;0
4481;80834;893;90;31;2;29;.935;3600000;0
4482;60863;876;81;34;3;31;.912;3600000;0
4482;67287;872;38;26;6;20;.769;3051000;0
4482;139409;876;0;0;0;0;.00nan;0;0
4482;159705;872;48;0;0;0;.00nan;549000;0
4483;28833;892;56;18;3;15;.833;3600000;0
4483;34708;892;0;0;0;0;.00nan;0;0
4483;78815;886;98;57;4;53;.930;3565000;0
4483;147264;886;0;0;0;0;.00nan;0;0
4484;28831;877;55;33;4;29;.879;3600000;0
4484;53879;881;30;28;6;22;.786;2743000;0
4484;70879;877;0;0;0;0;.00nan;0;0
4484;77082;881;51;9;1;8;.889;857000;0
4485;65;875;60;27;3;24;.889;3544000;0
4485;44496;883;0;0;0;0;.00nan;0;0
4485;63551;883;63;23;2;21;.913;3600000;0
4485;71075;875;0;0;0;0;.00nan;0;0
4486;46910;897;78;29;1;28;.966;3563000;0
4486;53879;881;100;27;0;27;1.000;3600000;0
4486;77082;881;0;0;0;0;.00nan;0;0
4486;78596;897;0;0;0;0;.00nan;0;0
4487;65;875;78;22;1;21;.955;3600000;0
4487;13337;882;98;44;2;42;.955;3600000;0
4487;59025;882;0;0;0;0;.00nan;0;0
4487;71075;875;0;0;0;0;.00nan;0;0
4488;66009;887;0;0;0;0;.00nan;0;0
4488;76885;887;61;24;3;21;.875;3600000;0
4488;78815;886;31;28;5;23;.821;3571000;0
4488;147264;886;0;0;0;0;.00nan;0;0
4489;12859;873;42;27;4;23;.852;3900000;0
4489;28831;877;0;0;0;0;.00nan;0;0
4489;70879;877;79;42;4;38;.905;3900000;0
4489;78348;873;0;0;0;0;.00nan;0;0
4490;11670;957;72;52;5;47;.904;3600000;0
4490;60863;876;0;0;0;0;.00nan;0;0
4490;65823;957;0;0;0;0;.00nan;0;0
4490;139409;876;93;27;1;26;.963;3600000;0
4491;11716;893;77;49;5;44;.898;3600000;0
4491;28833;892;0;0;0;0;.00nan;0;0
4491;34708;892;61;17;1;16;.941;3600000;0
4491;80834;893;0;0;0;0;.00nan;0;0
4492;13337;882;0;0;0;0;.00nan;0;0
4492;44496;883;59;23;2;21;.913;3900000;0
4492;59025;882;100;49;2;47;.959;3900000;0
4492;63551;883;0;0;0;0;.00nan;0;0
4493;46910;897;76;18;1;17;.944;3600000;0
4493;66009;887;0;0;0;0;.00nan;0;0
4493;76885;887;38;27;5;22;.815;3600000;0
4493;78596;897;0;0;0;0;.00nan;0;0
4494;11716;893;50;33;6;27;.818;3600000;0
4494;53879;881;100;33;0;33;1.000;3600000;0
4494;77082;881;0;0;0;0;.00nan;0;0
4494;80834;893;0;0;0;0;.00nan;0;0
4495;28833;892;62;33;4;29;.879;3748000;0
4495;34708;892;0;0;0;0;.00nan;0;0
4495;60863;876;0;0;0;0;.00nan;0;0
4495;139409;876;81;34;3;31;.912;3748000;0
4496;11670;957;25;15;4;11;.733;924000;0
4496;28831;877;0;0;0;0;.00nan;0;0
4496;65823;957;88;22;0;22;1.000;2976000;0
4496;70879;877;55;26;4;22;.846;3900000;0
4497;12859;873;0;0;0;0;.00nan;0;0
4497;67287;872;0;0;0;0;.00nan;0;0
4497;78348;873;91;39;2;37;.949;3600000;0
4497;159705;872;39;20;4;16;.800;3559000;0
4498;65;875;0;0;0;0;.00nan;0;0
4498;71075;875;93;47;2;45;.957;3600000;0
4498;78815;886;68;37;4;33;.892;3571000;0
4498;147264;886;0;0;0;0;.00nan;0;0
4499;28833;892;45;21;3;18;.857;3600000;0
4499;34708;892;0;0;0;0;.00nan;0;0
4499;46910;897;100;25;0;25;1.000;3600000;0
4499;78596;897;0;0;0;0;.00nan;0;0
4500;11716;893;0;0;0;0;.00nan;0;0
4500;44496;883;0;0;0;0;.00nan;0;0
4500;63551;883;93;27;1;26;.963;3600000;0
4500;80834;893;49;25;4;21;.840;3600000;0
4501;60863;876;0;0;0;0;.00nan;0;0
4501;66009;887;0;0;0;0;.00nan;0;0
4501;76885;887;80;29;2;27;.931;3600000;0
4501;139409;876;91;42;3;39;.929;3586000;0
4502;12859;873;0;0;0;0;.00nan;0;0
4502;78348;873;73;30;3;27;.900;3600000;0
4502;78815;886;42;35;5;30;.857;3577000;0
4502;147264;886;0;0;0;0;.00nan;0;0
4503;65;875;0;0;0;0;.00nan;0;0
4503;28831;877;100;28;0;28;1.000;3600000;0
4503;70879;877;0;0;0;0;.00nan;0;0
4503;71075;875;80;39;3;36;.923;3600000;0
4504;11670;957;58;31;4;27;.871;3600000;0
4504;13337;882;94;30;1;29;.967;3600000;0
4504;59025;882;0;0;0;0;.00nan;0;0
4504;65823;957;0;0;0;0;.00nan;0;0
4505;53879;881;66;46;6;40;.870;3600000;0
4505;67287;872;84;27;1;26;.963;3600000;0
4505;77082;881;0;0;0;0;.00nan;0;0
4505;159705;872;0;0;0;0;.00nan;0;0
4506;65;875;0;0;0;0;.00nan;0;0
4506;46910;897;54;24;3;21;.875;3565000;0
4506;63551;875;96;34;1;33;.971;3600000;0
4506;78596;897;0;0;0;0;.00nan;0;0
4507;11670;957;90;36;2;34;.944;3600000;0
4507;65823;957;0;0;0;0;.00nan;0;0
4507;66009;887;0;0;0;0;.00nan;0;0
4507;76885;887;49;22;3;19;.864;3561000;0
4508;60863;876;0;0;0;0;.00nan;0;0
4508;78815;886;94;20;0;20;1.000;3600000;0
4508;139409;876;78;41;3;38;.927;3600000;0
4508;147264;886;0;0;0;0;.00nan;0;0
4509;28831;877;58;32;5;27;.844;3592000;0
4509;28833;892;66;29;3;26;.897;3600000;0
4509;34708;892;0;0;0;0;.00nan;0;0
4509;70879;877;0;0;0;0;.00nan;0;0
4510;11716;893;0;0;0;0;.00nan;0;0
4510;12859;873;0;0;0;0;.00nan;0;0
4510;78348;873;54;34;5;29;.853;3564000;0
4510;80834;893;65;27;3;24;.889;3600000;0
4511;13337;882;80;32;2;30;.938;3595000;0
4511;59025;882;0;0;0;0;.00nan;0;0
4511;67287;872;87;25;1;24;.960;3600000;0
4511;159705;872;0;0;0;0;.00nan;0;0
4512;44496;883;65;17;1;16;.941;3600000;0
4512;46904;883;0;0;0;0;.00nan;0;0
4512;53879;881;70;37;3;34;.919;3576000;0
4512;77082;881;0;0;0;0;.00nan;0;0
4513;12859;873;0;0;0;0;.00nan;0;0
4513;53879;881;0;0;0;0;.00nan;0;0
4513;77082;881;87;30;1;29;.967;3600000;0
4513;78348;873;31;24;5;19;.792;3600000;0
4514;13337;882;62;35;4;31;.886;3600000;0
4514;46910;897;85;26;1;25;.962;3600000;0
4514;59025;882;0;0;0;0;.00nan;0;0
4514;78596;897;0;0;0;0;.00nan;0;0
4515;11716;893;85;32;2;30;.938;3600000;0
4515;66009;887;0;0;0;0;.00nan;0;0
4515;76885;887;75;24;1;23;.958;3600000;0
4515;80834;893;0;0;0;0;.00nan;0;0
4516;28831;877;0;0;0;0;.00nan;0;0
4516;60863;876;0;0;0;0;.00nan;0;0
4516;70879;877;100;35;1;34;.971;3600000;0
4516;139409;876;74;42;4;38;.905;3600000;0
4517;67287;872;66;19;1;18;.947;3600000;0
4517;78815;886;72;33;2;31;.939;3600000;0
4517;147264;886;0;0;0;0;.00nan;0;0
4517;159705;872;0;0;0;0;.00nan;0;0
4518;11670;957;39;34;6;28;.824;2467000;0
4518;28833;892;95;19;0;19;1.000;3600000;0
4518;34708;892;0;0;0;0;.00nan;0;0
4518;65823;957;49;12;2;10;.833;1133000;0
4519;65;875;0;0;0;0;.00nan;0;0
4519;44496;883;46;21;4;17;.810;3521000;0
4519;46904;883;0;0;0;0;.00nan;0;0
4519;63551;875;79;34;2;32;.941;3600000;0
4520;13337;882;0;0;0;0;.00nan;0;0
4520;59025;882;100;39;1;38;.974;3600000;0
4520;78815;886;60;33;4;29;.879;3600000;0
4520;147264;886;0;0;0;0;.00nan;0;0
4521;53879;881;73;21;1;20;.952;3600000;0
4521;60863;876;0;0;0;0;.00nan;0;0
4521;77082;881;0;0;0;0;.00nan;0;0
4521;139409;876;69;29;2;27;.931;3581000;0
4522;28833;892;58;28;3;25;.893;3627000;0
4522;34708;892;0;0;0;0;.00nan;0;0
4522;66009;887;0;0;0;0;.00nan;0;0
4522;76885;887;66;25;2;23;.920;3627000;0
4523;28831;877;0;0;0;0;.00nan;0;0
4523;44496;883;90;34;1;33;.971;3600000;0
4523;46904;883;0;0;0;0;.00nan;0;0
4523;70879;877;67;26;2;24;.923;3600000;0
4524;11670;957;78;34;3;31;.912;3900000;0
4524;11716;893;70;35;3;32;.914;3900000;0
4524;65823;957;0;0;0;0;.00nan;0;0
4524;80834;893;0;0;0;0;.00nan;0;0
4525;46910;897;69;47;5;42;.894;3600000;0
4525;67287;872;75;22;1;21;.955;3600000;0
4525;78596;897;0;0;0;0;.00nan;0;0
4525;159705;872;0;0;0;0;.00nan;0;0
4526;65;875;0;0;0;0;.00nan;0;0
4526;12859;873;0;0;0;0;.00nan;0;0
4526;63551;875;49;29;4;25;.862;3536000;0
4526;78348;873;68;24;2;22;.917;3600000;0
4527;28831;877;0;0;0;0;.00nan;0;0
4527;46910;897;62;28;3;25;.893;3600000;0
4527;70879;877;63;14;1;13;.929;3600000;0
4527;78596;897;0;0;0;0;.00nan;0;0
4528;11716;893;0;0;0;0;.00nan;0;0
4528;13337;882;66;43;4;39;.907;3569000;0
4528;59025;882;0;0;0;0;.00nan;0;0
4528;80834;893;79;34;3;31;.912;3600000;0
4529;11670;957;100;44;1;43;.977;3900000;0
4529;65823;957;0;0;0;0;.00nan;0;0
4529;78815;886;0;0;0;0;.00nan;0;0
4529;147264;886;90;38;1;37;.974;3900000;0
4530;12859;873;0;0;0;0;.00nan;0;0
4530;66009;887;0;0;0;0;.00nan;0;0
4530;76885;887;69;33;4;29;.879;3734000;0
4530;78348;873;62;29;3;26;.897;3734000;0
4531;28833;892;52;33;4;29;.879;3600000;0
4531;34708;892;0;0;0;0;.00nan;0;0
4531;67287;872;100;34;0;34;1.000;3600000;0
4531;159705;872;0;0;0;0;.00nan;0;0
4532;44496;883;0;0;0;0;.00nan;0;0
4532;46904;883;72;28;2;26;.929;3600000;0
4532;60863;876;0;0;0;0;.00nan;0;0
4532;139409;876;82;26;1;25;.962;3600000;0
4533;13337;882;42;37;6;31;.838;3600000;0
4533;28831;877;0;0;0;0;.00nan;0;0
4533;59025;882;0;0;0;0;.00nan;0;0
4533;70879;877;73;25;1;24;.960;3600000;0
4534;11716;893;100;27;0;27;1.000;3600000;0
4534;78815;886;69;23;2;21;.913;3553000;0
4534;80834;893;0;0;0;0;.00nan;0;0
4534;147264;886;0;0;0;0;.00nan;0;0
4535;46910;897;55;21;3;18;.857;3900000;0
4535;60863;876;0;0;0;0;.00nan;0;0
4535;78596;897;0;0;0;0;.00nan;0;0
4535;139409;876;71;32;3;29;.906;3900000;0
4536;66009;887;0;0;0;0;.00nan;0;0
4536;67287;872;91;29;1;28;.966;3600000;0
4536;76885;887;83;16;0;16;1.000;3600000;0
4536;159705;872;0;0;0;0;.00nan;0;0
4537;12859;873;0;0;0;0;.00nan;0;0
4537;44496;883;71;20;1;19;.950;3600000;0
4537;46904;883;0;0;0;0;.00nan;0;0
4537;78348;873;80;33;2;31;.939;3558000;0
4538;11670;957;84;43;3;40;.930;3600000;0
4538;53879;881;100;26;0;26;1.000;3600000;0
4538;65823;957;0;0;0;0;.00nan;0;0
4538;77082;881;0;0;0;0;.00nan;0;0
4539;65;875;0;0;0;0;.00nan;0;0
4539;28833;892;84;24;1;23;.958;3600000;0
4539;34708;892;0;0;0;0;.00nan;0;0
4539;63551;875;47;28;4;24;.857;3600000;0
4540;13337;882;59;34;4;30;.882;3571000;0
4540;59025;882;0;0;0;0;.00nan;0;0
4540;60863;876;0;0;0;0;.00nan;0;0
4540;139409;876;64;20;2;18;.900;3600000;0
4541;12859;873;0;0;0;0;.00nan;0;0
4541;46910;897;0;0;0;0;.00nan;0;0
4541;78348;873;49;30;5;25;.833;3600000;0
4541;78596;897;49;28;4;24;.857;3600000;0
4542;44496;883;74;13;0;13;1.000;3600000;0
4542;46904;883;0;0;0;0;.00nan;0;0
4542;78815;886;73;47;4;43;.915;3600000;0
4542;147264;886;0;0;0;0;.00nan;0;0
4543;28831;877;0;0;0;0;.00nan;0;0
4543;66009;887;0;0;0;0;.00nan;0;0
4543;70879;877;60;27;3;24;.889;3579000;0
4543;76885;887;100;48;1;47;.979;3600000;0
4544;11716;893;100;51;2;49;.961;3900000;0
4544;67287;872;0;0;0;0;.00nan;0;0
4544;80834;893;0;0;0;0;.00nan;0;0
4544;159705;872;64;21;2;19;.905;3900000;0
4545;28833;892;0;0;0;0;.00nan;0;0
4545;34708;892;64;32;3;29;.906;3600000;0
4545;53879;881;96;23;0;23;1.000;3600000;0
4545;77082;881;0;0;0;0;.00nan;0;0
4546;65;875;0;0;0;0;.00nan;0;0
4546;11670;957;81;51;5;46;.902;3545000;0
4546;63551;875;53;21;3;18;.857;3600000;0
4546;65823;957;0;0;0;0;.00nan;0;0
4547;53879;881;56;35;4;31;.886;3549000;0
4547;77082;881;0;0;0;0;.00nan;0;0
4547;78815;886;93;37;2;35;.946;3600000;0
4547;147264;886;0;0;0;0;.00nan;0;0
4548;11716;893;56;32;4;28;.875;3600000;0
4548;28831;877;0;0;0;0;.00nan;0;0
4548;70879;877;62;18;1;17;.944;3600000;0
4548;80834;893;0;0;0;0;.00nan;0;0
4549;65;875;0;0;0;0;.00nan;0;0
4549;60863;876;0;0;0;0;.00nan;0;0
4549;63551;875;71;28;2;26;.929;3600000;0
4549;139409;876;42;25;5;20;.800;3600000;0
4550;13337;882;84;40;3;37;.925;3586000;0
4550;59025;882;0;0;0;0;.00nan;0;0
4550;66009;887;0;0;0;0;.00nan;0;0
4550;76885;887;73;23;1;22;.957;3600000;0
4551;12859;873;0;0;0;0;.00nan;0;0
4551;28833;892;63;17;2;15;.882;3557000;0
4551;34708;892;0;0;0;0;.00nan;0;0
4551;78348;873;100;34;1;33;.971;3600000;0
4552;11670;957;98;54;4;50;.926;3600000;0
4552;65823;957;0;0;0;0;.00nan;0;0
4552;67287;872;65;28;3;25;.893;3600000;0
4552;159705;872;0;0;0;0;.00nan;0;0
4553;44496;883;62;25;3;22;.880;3600000;0
4553;46904;883;0;0;0;0;.00nan;0;0
4553;46910;897;100;35;0;35;1.000;3600000;0
4553;78596;897;0;0;0;0;.00nan;0;0
4554;13337;882;96;33;1;32;.970;3600000;0
4554;53879;881;68;31;3;28;.903;3559000;0
4554;59025;882;0;0;0;0;.00nan;0;0
4554;77082;881;0;0;0;0;.00nan;0;0
4555;11716;893;95;36;1;35;.972;3600000;0
4555;46910;897;31;19;5;14;.737;3600000;0
4555;78596;897;0;0;0;0;.00nan;0;0
4555;80834;893;0;0;0;0;.00nan;0;0
4556;28831;877;76;21;1;20;.952;3600000;0
4556;70879;877;0;0;0;0;.00nan;0;0
4556;78815;886;13;14;5;9;.643;1538000;0
4556;147264;886;62;20;2;18;.900;2062000;0
4557;11670;957;99;38;1;37;.974;3600000;0
4557;12859;873;0;0;0;0;.00nan;0;0
4557;65823;957;0;0;0;0;.00nan;0;0
4557;78348;873;60;22;3;19;.864;3533000;0
4558;60863;876;0;0;0;0;.00nan;0;0
4558;67287;872;66;27;2;25;.926;3900000;0
4558;139409;876;84;37;2;35;.946;3900000;0
4558;159705;872;0;0;0;0;.00nan;0;0
4559;28833;892;77;32;3;29;.906;3600000;0
4559;34708;892;0;0;0;0;.00nan;0;0
4559;44496;883;40;26;5;21;.808;3575000;0
4559;46904;883;0;0;0;0;.00nan;0;0
4560;65;875;0;0;0;0;.00nan;0;0
4560;63551;875;79;37;3;34;.919;3583000;0
4560;66009;887;0;0;0;0;.00nan;0;0
4560;76885;887;77;27;1;26;.963;3600000;0
4561;53879;881;0;0;0;0;.00nan;0;0
4561;66009;887;0;0;0;0;.00nan;0;0
4561;76885;887;71;27;2;25;.926;3550000;0
4561;77082;881;78;25;1;24;.960;3600000;0
4562;13337;882;0;0;0;0;.00nan;0;0
4562;28833;892;66;18;1;17;.944;3600000;0
4562;34708;892;0;0;0;0;.00nan;0;0
4562;59025;882;45;41;6;35;.854;3600000;0
4563;65;875;0;0;0;0;.00nan;0;0
4563;11716;893;0;0;0;0;.00nan;0;0
4563;63551;875;96;45;3;42;.933;3900000;0
4563;80834;893;73;31;3;28;.903;3900000;0
4564;12859;873;0;0;0;0;.00nan;0;0
4564;60863;876;0;0;0;0;.00nan;0;0
4564;78348;873;85;27;1;26;.963;3695000;0
4564;139409;876;100;28;0;28;1.000;3695000;0
4565;46910;897;99;41;1;40;.976;3600000;0
4565;78596;897;0;0;0;0;.00nan;0;0
4565;78815;886;60;24;3;21;.875;3562000;0
4565;147264;886;0;0;0;0;.00nan;0;0
4566;28831;877;0;0;0;0;.00nan;0;0
4566;67287;872;51;32;5;27;.844;3600000;0
4566;70879;877;100;33;1;32;.970;3600000;0
4566;159705;872;0;0;0;0;.00nan;0;0
4567;11670;957;94;43;3;40;.930;3848000;0
4567;44496;883;61;24;2;22;.917;3848000;0
4567;46904;883;0;0;0;0;.00nan;0;0
4567;65823;957;0;0;0;0;.00nan;0;0
4569;11670;957;0;0;0;0;.00nan;0;0
4569;28831;877;0;0;0;0;.00nan;0;0
4569;65823;957;86;44;2;42;.955;3600000;0
4569;70879;877;45;23;3;20;.870;3555000;0
4571;28833;892;79;35;3;32;.914;3900000;0
4571;34708;892;0;0;0;0;.00nan;0;0
4571;78815;886;61;24;3;21;.875;3900000;0
4571;147264;886;0;0;0;0;.00nan;0;0
4573;779;882;98;36;1;35;.972;3600000;0
4573;7037;882;0;0;0;0;.00nan;0;0
4573;20645;883;0;0;0;0;.00nan;0;0
4573;63551;883;64;21;2;19;.905;3556000;0
4575;65;875;0;0;0;0;.00nan;0;0
4575;67287;872;46;35;6;29;.829;3154000;0
4575;71075;875;79;29;2;27;.931;3600000;0
4575;159705;872;37;6;2;4;.667;446000;0
4577;494;876;0;0;0;0;.00nan;0;0
4577;3077;876;45;26;4;22;.846;3586000;0
4577;12859;873;0;0;0;0;.00nan;0;0
4577;78348;873;86;34;2;32;.941;3600000;0
4579;46904;897;0;0;0;0;.00nan;0;0
4579;66009;887;0;0;0;0;.00nan;0;0
4579;76885;887;77;31;2;29;.935;3900000;0
4579;78596;897;86;35;2;33;.943;3900000;0
4581;1712;881;0;0;0;0;.00nan;0;0
4581;5354;881;73;29;2;27;.931;3900000;0
4581;11716;893;86;38;2;36;.947;3900000;0
4581;80834;893;0;0;0;0;.00nan;0;0
4583;28833;892;0;0;0;0;.00nan;0;0
4583;34708;892;48;21;3;18;.857;3600000;0
4583;46904;897;0;0;0;0;.00nan;0;0
4583;78596;897;100;23;0;23;1.000;3600000;0
4585;11670;957;100;34;0;34;1.000;3600000;0
4585;11716;893;0;0;0;0;.00nan;0;0
4585;65823;957;0;0;0;0;.00nan;0;0
4585;80834;893;76;28;2;26;.929;3591000;0
4587;1712;881;80;43;4;39;.907;3709000;0
4587;5354;881;0;0;0;0;.00nan;0;0
4587;67287;872;0;0;0;0;.00nan;0;0
4587;159705;872;68;31;3;28;.903;3709000;0
4589;494;876;60;13;1;12;.923;3600000;0
4589;3077;876;0;0;0;0;.00nan;0;0
4589;12859;873;76;34;2;32;.941;3546000;0
4589;78348;873;0;0;0;0;.00nan;0;0
4591;779;882;0;0;0;0;.00nan;0;0
4591;7037;882;83;40;2;38;.950;3591000;0
4591;78815;886;0;0;0;0;.00nan;0;0
4591;147264;886;78;21;1;20;.952;3600000;0
4593;28831;877;50;23;3;20;.870;3576000;0
4593;66009;887;66;25;2;23;.920;3600000;0
4593;70879;877;0;0;0;0;.00nan;0;0
4593;76885;887;0;0;0;0;.00nan;0;0
4595;65;875;44;33;6;27;.818;3600000;0
4595;20645;883;77;41;3;38;.927;3600000;0
4595;63551;883;0;0;0;0;.00nan;0;0
4595;71075;875;0;0;0;0;.00nan;0;0
4597;11670;957;92;43;3;40;.930;3600000;0
4597;65823;957;0;0;0;0;.00nan;0;0
4597;78815;886;25;30;6;24;.800;2324000;0
4597;147264;886;49;7;1;6;.857;1276000;0
4599;11716;893;84;37;3;34;.919;3600000;0
4599;67287;872;36;24;4;20;.833;3547000;0
4599;80834;893;0;0;0;0;.00nan;0;0
4599;159705;872;0;0;0;0;.00nan;0;0
4601;65;875;0;0;0;0;.00nan;0;0
4601;12859;873;0;0;0;0;.00nan;0;0
4601;71075;875;41;37;6;31;.838;3600000;0
4601;78348;873;100;25;0;25;1.000;3600000;0
4603;494;876;0;0;0;0;.00nan;0;0
4603;3077;876;92;31;1;30;.968;3600000;0
4603;28833;892;42;27;5;22;.815;3600000;0
4603;34708;892;0;0;0;0;.00nan;0;0
4605;779;882;0;0;0;0;.00nan;0;0
4605;7037;882;39;30;5;25;.833;3600000;0
4605;66009;887;0;0;0;0;.00nan;0;0
4605;76885;887;98;36;2;34;.944;3600000;0
4607;1712;881;68;26;2;24;.923;3600000;0
4607;5354;881;0;0;0;0;.00nan;0;0
4607;46904;897;0;0;0;0;.00nan;0;0
4607;78596;897;48;22;3;19;.864;3600000;0
4609;20645;883;0;0;0;0;.00nan;0;0
4609;28831;877;0;0;0;0;.00nan;0;0
4609;63551;883;87;34;2;32;.941;3784000;0
4609;70879;877;65;30;3;27;.900;3784000;0
4611;20645;883;64;28;3;25;.893;3680000;0
4611;46904;897;0;0;0;0;.00nan;0;0
4611;63551;883;0;0;0;0;.00nan;0;0
4611;78596;897;61;26;4;22;.846;3696000;0
4613;1712;881;0;0;0;0;.00nan;0;0
4613;5354;881;60;30;4;26;.867;3587000;0
4613;78815;886;0;0;0;0;.00nan;0;0
4613;147264;886;85;33;2;31;.939;3600000;0
4615;65;875;71;48;5;43;.896;3709000;0
4615;11670;957;0;0;0;0;.00nan;0;0
4615;65823;957;43;23;4;19;.826;3695000;0
4615;71075;875;0;0;0;0;.00nan;0;0
4617;11716;893;0;0;0;0;.00nan;0;0
4617;67287;872;0;0;0;0;.00nan;0;0
4617;80834;893;28;35;7;28;.800;3600000;0
4617;159705;872;74;28;3;25;.893;3600000;0
4619;12859;873;0;0;0;0;.00nan;0;0
4619;66009;887;51;26;3;23;.885;3514000;0
4619;76885;887;0;0;0;0;.00nan;0;0
4619;78348;873;78;28;1;27;.964;3600000;0
4621;494;876;67;26;2;24;.923;3600000;0
4621;3077;876;0;0;0;0;.00nan;0;0
4621;28833;892;0;0;0;0;.00nan;0;0
4621;34708;892;69;34;3;31;.912;3572000;0
4623;779;882;52;45;6;39;.867;3600000;0
4623;7037;882;0;0;0;0;.00nan;0;0
4623;28831;877;72;30;3;27;.900;3600000;0
4623;70879;877;0;0;0;0;.00nan;0;0
4625;1712;881;35;31;6;25;.806;3017000;0
4625;5354;881;46;7;1;6;.857;583000;0
4625;46904;897;0;0;0;0;.00nan;0;0
4625;78596;897;97;26;0;26;1.000;3600000;0
4627;11716;893;87;16;0;16;1.000;3600000;0
4627;28833;892;76;29;2;27;.931;3597000;0
4627;34708;892;0;0;0;0;.00nan;0;0
4627;80834;893;0;0;0;0;.00nan;0;0
4629;66009;887;0;0;0;0;.00nan;0;0
4629;76885;887;89;28;1;27;.964;3591000;0
4629;78815;886;88;18;0;18;1.000;3600000;0
4629;147264;886;0;0;0;0;.00nan;0;0
4631;11670;957;83;46;3;43;.935;3600000;0
4631;65823;957;0;0;0;0;.00nan;0;0
4631;67287;872;100;32;0;32;1.000;3600000;0
4631;159705;872;0;0;0;0;.00nan;0;0
4633;12859;873;0;0;0;0;.00nan;0;0
4633;20645;883;0;0;0;0;.00nan;0;0
4633;63551;883;50;31;5;26;.839;3600000;0
4633;78348;873;70;24;2;22;.917;3600000;0
4635;494;876;0;0;0;0;.00nan;0;0
4635;779;882;65;27;3;24;.889;3900000;0
4635;3077;876;73;31;3;28;.903;3900000;0
4635;7037;882;0;0;0;0;.00nan;0;0
4637;65;875;88;44;3;41;.932;3532000;0
4637;28831;877;0;0;0;0;.00nan;0;0
4637;70879;877;63;25;2;23;.920;3600000;0
4637;71075;875;0;0;0;0;.00nan;0;0
4639;20645;883;33;38;7;31;.816;3251000;0
4639;46904;897;0;0;0;0;.00nan;0;0
4639;63551;883;51;2;0;2;1.000;349000;0
4639;78596;897;86;28;1;27;.964;3600000;0
4641;779;882;0;0;0;0;.00nan;0;0
4641;7037;882;31;27;5;22;.815;3586000;0
4641;28833;892;0;0;0;0;.00nan;0;0
4641;34708;892;73;31;3;28;.903;3600000;0
4643;1712;881;0;0;0;0;.00nan;0;0
4643;5354;881;90;33;1;32;.970;3600000;0
4643;12859;873;44;29;5;24;.828;3600000;0
4643;78348;873;0;0;0;0;.00nan;0;0
4645;65;875;0;0;0;0;.00nan;0;0
4645;67287;872;100;38;1;37;.974;3745000;0
4645;71075;875;92;29;2;27;.931;3745000;0
4645;159705;872;0;0;0;0;.00nan;0;0
4647;11716;893;50;37;5;32;.865;3600000;0
4647;66009;887;60;23;2;21;.913;3600000;0
4647;76885;887;0;0;0;0;.00nan;0;0
4647;80834;893;0;0;0;0;.00nan;0;0
4649;11670;957;53;4;0;4;1.000;327000;0
4649;65823;957;33;30;6;24;.800;3231000;0
4649;78815;886;68;45;5;40;.889;3600000;0
4649;147264;886;0;0;0;0;.00nan;0;0
4651;494;876;70;25;2;23;.920;3600000;0
4651;3077;876;0;0;0;0;.00nan;0;0
4651;28831;877;58;31;3;28;.903;3600000;0
4651;70879;877;0;0;0;0;.00nan;0;0
4653;20645;883;0;0;0;0;.00nan;0;0
4653;28833;892;0;0;0;0;.00nan;0;0
4653;34708;892;90;31;1;30;.968;3600000;0
4653;63551;883;27;20;5;15;.750;3600000;0
4655;11716;893;0;0;0;0;.00nan;0;0
4655;46904;897;0;0;0;0;.00nan;0;0
4655;78596;897;46;17;3;14;.824;3900000;0
4655;80834;893;45;25;3;22;.880;3900000;0
4657;1712;881;66;32;3;29;.906;3543000;0
4657;5354;881;0;0;0;0;.00nan;0;0
4657;28831;877;0;0;0;0;.00nan;0;0
4657;70879;877;82;31;2;29;.935;3600000;0
4659;65;875;0;0;0;0;.00nan;0;0
4659;67287;872;79;33;2;31;.939;3600000;0
4659;71075;875;36;22;5;17;.773;3600000;0
4659;159705;872;0;0;0;0;.00nan;0;0
4661;12859;873;0;0;0;0;.00nan;0;0
4661;66009;887;0;0;0;0;.00nan;0;0
4661;76885;887;97;49;3;46;.939;3590000;0
4661;78348;873;73;26;2;24;.923;3600000;0
4663;494;876;0;0;0;0;.00nan;0;0
4663;3077;876;82;34;2;32;.941;3900000;0
4663;11670;957;60;23;2;21;.913;3900000;0
4663;65823;957;0;0;0;0;.00nan;0;0
4665;779;882;20;26;7;19;.731;3600000;0
4665;7037;882;0;0;0;0;.00nan;0;0
4665;78815;886;58;26;3;23;.885;3600000;0
4665;147264;886;0;0;0;0;.00nan;0;0
1402;65;875;0;0;0;0;.00nan;0;0
1402;63551;875;68;39;4;35;.897;3600000;0
1402;67287;872;80;28;1;27;.964;3600000;0
1402;159705;872;0;0;0;0;.00nan;0;0
1403;12859;873;0;0;0;0;.00nan;0;0
1403;46910;897;40;20;4;16;.800;3544000;0
1403;78348;873;77;34;2;32;.941;3600000;0
1403;78596;897;0;0;0;0;.00nan;0;0
1404;65;875;0;0;0;0;.00nan;0;0
1404;63551;875;95;49;3;46;.939;3562000;0
1404;67287;872;100;32;1;31;.969;3600000;0
1404;159705;872;0;0;0;0;.00nan;0;0
1405;12859;873;0;0;0;0;.00nan;0;0
1405;46910;897;46;29;5;24;.828;3600000;0
1405;78348;873;96;22;0;22;1.000;3600000;0
1405;78596;897;0;0;0;0;.00nan;0;0
1497;12859;873;0;0;0;0;.00nan;0;0
1497;28831;877;0;0;0;0;.00nan;0;0
1497;70879;877;88;17;0;17;1.000;3600000;0
1497;78348;873;96;37;1;36;.973;3554000;0
1498;3284;883;58;32;4;28;.875;3516000;0
1498;44496;883;0;0;0;0;.00nan;0;0
1498;67287;872;65;22;2;20;.909;3600000;0
1498;159705;872;0;0;0;0;.00nan;0;0
1499;60863;876;0;0;0;0;.00nan;0;0
1499;66009;887;0;0;0;0;.00nan;0;0
1499;76885;887;87;36;1;35;.972;3570000;0
1499;139409;876;100;30;0;30;1.000;3600000;0
1500;28833;892;89;32;2;30;.938;3600000;0
1500;34708;892;0;0;0;0;.00nan;0;0
1500;53879;881;58;30;3;27;.900;3567000;0
1500;77082;881;0;0;0;0;.00nan;0;0
1501;12859;873;0;0;0;0;.00nan;0;0
1501;28831;877;0;0;0;0;.00nan;0;0
1501;70879;877;74;17;1;16;.941;3600000;0
1501;78348;873;83;43;4;39;.907;3600000;0
1502;3284;883;64;25;2;23;.920;3600000;0
1502;44496;883;0;0;0;0;.00nan;0;0
1502;67287;872;78;36;3;33;.917;3555000;0
1502;159705;872;0;0;0;0;.00nan;0;0
1503;60863;876;0;0;0;0;.00nan;0;0
1503;66009;887;0;0;0;0;.00nan;0;0
1503;76885;887;92;31;1;30;.968;3600000;0
1503;139409;876;81;30;2;28;.933;3569000;0
1504;28833;892;50;27;4;23;.852;3600000;0
1504;34708;892;0;0;0;0;.00nan;0;0
1504;53879;881;38;32;5;27;.844;3600000;0
1504;77082;881;0;0;0;0;.00nan;0;0
1505;12859;873;0;0;0;0;.00nan;0;0
1505;28831;877;0;0;0;0;.00nan;0;0
1505;70879;877;78;21;1;20;.952;3600000;0
1505;78348;873;77;34;2;32;.941;3600000;0
1506;3284;883;79;26;2;24;.923;3600000;0
1506;44496;883;0;0;0;0;.00nan;0;0
1506;67287;872;64;34;3;31;.912;3564000;0
1506;159705;872;0;0;0;0;.00nan;0;0
1507;60863;876;0;0;0;0;.00nan;0;0
1507;66009;887;0;0;0;0;.00nan;0;0
1507;76885;887;57;33;4;29;.879;3600000;0
1507;139409;876;100;24;0;24;1.000;3600000;0
1508;28833;892;94;49;2;47;.959;4844000;0
1508;34708;892;0;0;0;0;.00nan;0;0
1508;53879;881;72;24;1;23;.958;4844000;0
1508;77082;881;0;0;0;0;.00nan;0;0
1509;12859;873;0;0;0;0;.00nan;0;0
1509;28831;877;0;0;0;0;.00nan;0;0
1509;70879;877;87;26;1;25;.962;3600000;0
1509;78348;873;63;32;4;28;.875;3600000;0
1510;3284;883;51;23;3;20;.870;3637000;0
1510;44496;883;0;0;0;0;.00nan;0;0
1510;67287;872;59;32;4;28;.875;3637000;0
1510;159705;872;0;0;0;0;.00nan;0;0
1511;60863;876;0;0;0;0;.00nan;0;0
1511;66009;887;35;24;4;20;.833;3253000;0
1511;76885;887;25;6;3;3;.500;347000;0
1511;139409;876;93;29;1;28;.966;3600000;0
1512;28833;892;89;27;1;26;.963;3600000;0
1512;34708;892;0;0;0;0;.00nan;0;0
1512;53879;881;69;26;3;23;.885;3513000;0
1512;77082;881;0;0;0;0;.00nan;0;0
1740;3284;883;99;41;1;40;.976;3600000;0
1740;44496;883;0;0;0;0;.00nan;0;0
1740;67287;872;69;30;3;27;.900;3556000;0
1740;159705;872;0;0;0;0;.00nan;0;0
1741;60863;876;0;0;0;0;.00nan;0;0
1741;66009;887;0;0;0;0;.00nan;0;0
1741;76885;887;76;21;1;20;.952;3600000;0
1741;139409;876;88;48;2;46;.958;3584000;0
1742;28833;892;100;30;0;30;1.000;3600000;0
1742;34708;892;0;0;0;0;.00nan;0;0
1742;53879;881;73;33;3;30;.909;3600000;0
1742;77082;881;0;0;0;0;.00nan;0;0
1849;60863;876;0;0;0;0;.00nan;0;0
1849;66009;887;0;0;0;0;.00nan;0;0
1849;76885;887;50;28;4;24;.857;3600000;0
1849;139409;876;69;19;1;18;.947;3600000;0
1870;28831;877;0;0;0;0;.00nan;0;0
1870;60863;876;0;0;0;0;.00nan;0;0
1870;70879;877;92;31;1;30;.968;3600000;0
1870;139409;876;44;30;5;25;.833;3600000;0
1871;3284;883;96;18;0;18;1.000;3600000;0
1871;28833;892;71;31;2;29;.935;3569000;0
1871;34708;892;0;0;0;0;.00nan;0;0
1871;44496;883;0;0;0;0;.00nan;0;0
1872;28831;877;0;0;0;0;.00nan;0;0
1872;60863;876;0;0;0;0;.00nan;0;0
1872;70879;877;51;18;2;16;.889;3600000;0
1872;139409;876;70;32;3;29;.906;3591000;0
1873;3284;883;89;16;0;16;1.000;3600000;0
1873;28833;892;59;32;4;28;.875;3600000;0
1873;34708;892;0;0;0;0;.00nan;0;0
1873;44496;883;0;0;0;0;.00nan;0;0
1874;28831;877;0;0;0;0;.00nan;0;0
1874;60863;876;0;0;0;0;.00nan;0;0
1874;70879;877;40;33;6;27;.818;3600000;0
1874;139409;876;96;34;1;33;.971;3600000;0
1875;3284;883;70;23;2;21;.913;3542000;0
1875;28833;892;100;35;0;35;1.000;3600000;0
1875;34708;892;0;0;0;0;.00nan;0;0
1875;44496;883;0;0;0;0;.00nan;0;0
1876;28831;877;0;0;0;0;.00nan;0;0
1876;60863;876;0;0;0;0;.00nan;0;0
1876;70879;877;92;17;0;17;1.000;3600000;0
1876;139409;876;83;37;2;35;.946;3600000;0
1877;3284;883;83;29;2;27;.931;3559000;0
1877;28833;892;80;24;1;23;.958;3600000;0
1877;34708;892;0;0;0;0;.00nan;0;0
1877;44496;883;0;0;0;0;.00nan;0;0
2052;28831;877;0;0;0;0;.00nan;0;0
2052;60863;876;0;0;0;0;.00nan;0;0
2052;70879;877;63;12;1;11;.917;4199000;0
2052;139409;876;94;46;2;44;.957;4199000;0
2053;3284;883;90;25;1;24;.960;3600000;0
2053;28833;892;52;35;5;30;.857;3600000;0
2053;34708;892;0;0;0;0;.00nan;0;0
2053;44496;883;0;0;0;0;.00nan;0;0
2078;3284;883;74;27;2;25;.926;3588000;0
2078;28833;892;84;27;1;26;.963;3600000;0
2078;34708;892;0;0;0;0;.00nan;0;0
2078;44496;883;0;0;0;0;.00nan;0;0
2171;3284;883;79;42;4;38;.905;4082000;0
2171;28833;892;87;42;3;39;.929;4082000;0
2171;34708;892;0;0;0;0;.00nan;0;0
2171;44496;883;0;0;0;0;.00nan;0;0
2195;28831;877;0;0;0;0;.00nan;0;0
2195;28833;892;44;38;6;32;.842;2385000;0
2195;34708;892;41;9;2;7;.778;1215000;0
2195;70879;877;79;27;1;26;.963;3600000;0
2196;28831;877;0;0;0;0;.00nan;0;0
2196;28833;892;67;40;5;35;.875;3585000;0
2196;34708;892;0;0;0;0;.00nan;0;0
2196;70879;877;84;46;3;43;.935;3600000;0
2197;28831;877;0;0;0;0;.00nan;0;0
2197;28833;892;73;26;2;24;.923;3600000;0
2197;34708;892;0;0;0;0;.00nan;0;0
2197;70879;877;65;33;4;29;.879;3600000;0
2198;28831;877;0;0;0;0;.00nan;0;0
2198;28833;892;84;33;1;32;.970;3600000;0
2198;34708;892;0;0;0;0;.00nan;0;0
2198;70879;877;95;23;0;23;1.000;3600000;0
28;28831;877;0;0;0;0;.00nan;0;0
28;28833;892;88;37;2;35;.946;5099000;0
28;34708;892;0;0;0;0;.00nan;0;0
28;70879;877;93;37;1;36;.973;5099000;0
4666;7487;518;0;0;0;0;.00nan;0;0
4666;169323;519;70;40;4;36;.900;3862000;0
4666;22413;519;0;0;0;0;.00nan;0;0
4666;57993;518;63;31;3;28;.903;3862000;0
4667;1072;1472;0;0;0;0;.00nan;0;0
4667;64230;1472;91;33;2;31;.939;3572000;0
4667;143036;516;99;29;1;28;.966;3600000;0
4667;159851;516;0;0;0;0;.00nan;0;0
4668;177504;515;0;0;0;0;.00nan;0;0
4668;53889;1475;49;6;1;5;.833;376000;0
4668;68565;515;85;16;0;16;1.000;3600000;0
4668;143301;1475;46;41;6;35;.854;3224000;0
4669;7534;1481;97;49;1;48;.980;3900000;0
4669;32347;1481;0;0;0;0;.00nan;0;0
4669;80859;511;93;31;1;30;.968;3900000;0
4669;88646;511;0;0;0;0;.00nan;0;0
4670;16587;513;77;42;4;38;.905;3600000;0
4670;63107;1876;100;26;0;26;1.000;3600000;0
4670;63402;513;0;0;0;0;.00nan;0;0
4670;86394;1876;0;0;0;0;.00nan;0;0
4671;64961;524;82;31;1;30;.968;3600000;0
4671;76951;524;0;0;0;0;.00nan;0;0
4671;86228;512;69;30;4;26;.867;3600000;0
4671;142911;512;0;0;0;0;.00nan;0;0
4672;8223;520;0;0;0;0;.00nan;0;0
4672;62279;514;49;2;0;2;1.000;358000;0
4672;68627;514;38;27;5;22;.815;3242000;0
4672;155474;520;78;29;1;28;.966;3600000;0
4673;177504;515;0;0;0;0;.00nan;0;0
4673;68565;515;52;22;3;19;.864;3600000;0
4673;86228;512;63;36;4;32;.889;3600000;0
4673;142911;512;0;0;0;0;.00nan;0;0
4674;8223;520;0;0;0;0;.00nan;0;0
4674;169323;519;25;11;4;7;.636;1155000;0
4674;22413;519;33;19;4;15;.789;2445000;0
4674;155474;520;54;26;4;22;.846;3600000;0
4675;7534;1481;0;0;0;0;.00nan;0;0
4675;32347;1481;58;20;3;17;.850;3600000;0
4675;53889;1475;0;0;0;0;.00nan;0;0
4675;143301;1475;60;33;4;29;.879;3569000;0
4676;63107;1876;0;0;0;0;.00nan;0;0
4676;80859;511;77;11;0;11;1.000;3600000;0
4676;86394;1876;88;38;2;36;.947;3531000;0
4676;88646;511;0;0;0;0;.00nan;0;0
4677;62279;514;27;26;6;20;.769;2245000;0
4677;68627;514;66;9;0;9;1.000;1655000;0
4677;143036;516;64;50;6;44;.880;3900000;0
4677;159851;516;0;0;0;0;.00nan;0;0
4678;1072;1472;78;44;3;41;.932;3532000;0
4678;7487;518;0;0;0;0;.00nan;0;0
4678;57993;518;83;24;1;23;.958;3600000;0
4678;64230;1472;0;0;0;0;.00nan;0;0
4679;16587;513;0;0;0;0;.00nan;0;0
4679;63402;513;77;24;1;23;.958;3600000;0
4679;64961;524;89;33;2;31;.939;3597000;0
4679;76951;524;0;0;0;0;.00nan;0;0
4680;7534;1481;0;0;0;0;.00nan;0;0
4680;32347;1481;61;27;2;25;.926;3600000;0
4680;64961;524;0;0;0;0;.00nan;0;0
4680;76951;524;80;15;0;15;1.000;3600000;0
4681;169323;519;0;0;0;0;.00nan;0;0
4681;22413;519;81;37;3;34;.919;3759000;0
4681;80859;511;73;25;2;23;.920;3759000;0
4681;88646;511;0;0;0;0;.00nan;0;0
4682;1072;1472;0;0;0;0;.00nan;0;0
4682;16587;513;0;0;0;0;.00nan;0;0
4682;63402;513;61;35;4;31;.886;3559000;0
4682;64230;1472;71;28;2;26;.929;3600000;0
4683;7487;518;0;0;0;0;.00nan;0;0
4683;57993;518;71;29;3;26;.897;3600000;0
4683;143036;516;36;19;4;15;.789;3600000;0
4683;159851;516;0;0;0;0;.00nan;0;0
4684;177504;515;0;0;0;0;.00nan;0;0
4684;8223;520;0;0;0;0;.00nan;0;0
4684;68565;515;60;35;5;30;.857;3571000;0
4684;155474;520;68;30;3;27;.900;3600000;0
4685;63107;1876;0;0;0;0;.00nan;0;0
4685;86228;512;60;18;2;16;.889;3600000;0
4685;86394;1876;76;43;4;39;.907;3562000;0
4685;142911;512;0;0;0;0;.00nan;0;0
4686;53889;1475;0;0;0;0;.00nan;0;0
4686;62279;514;78;14;0;14;1.000;3600000;0
4686;68627;514;0;0;0;0;.00nan;0;0
4686;143301;1475;53;29;4;25;.862;3600000;0
4687;7487;518;0;0;0;0;.00nan;0;0
4687;57993;518;56;24;3;21;.875;3538000;0
4687;86228;512;91;27;1;26;.963;3600000;0
4687;142911;512;0;0;0;0;.00nan;0;0
4688;8223;520;0;0;0;0;.00nan;0;0
4688;63107;1876;0;0;0;0;.00nan;0;0
4688;86394;1876;66;37;4;33;.892;3600000;0
4688;155474;520;92;33;1;32;.970;3600000;0
4689;53889;1475;0;0;0;0;.00nan;0;0
4689;64961;524;29;17;4;13;.765;725000;0
4689;76951;524;91;23;0;23;1.000;2823000;0
4689;143301;1475;75;34;3;31;.912;3600000;0
4690;1072;1472;47;27;4;23;.852;3547000;0
4690;64230;1472;0;0;0;0;.00nan;0;0
4690;80859;511;74;28;3;25;.893;3600000;0
4690;143301;511;0;0;0;0;.00nan;0;0
4691;169323;519;0;0;0;0;.00nan;0;0
4691;22413;519;79;25;1;24;.960;3600000;0
4691;143036;516;66;25;2;23;.920;3594000;0
4691;159851;516;0;0;0;0;.00nan;0;0
4692;177504;515;0;0;0;0;.00nan;0;0
4692;7534;1481;50;32;5;27;.844;3596000;0
4692;32347;1481;0;0;0;0;.00nan;0;0
4692;68565;515;65;31;4;27;.871;3600000;0
4693;16587;513;0;0;0;0;.00nan;0;0
4693;62279;514;59;43;5;38;.884;3600000;0
4693;63402;513;69;31;2;29;.935;3600000;0
4693;68627;514;0;0;0;0;.00nan;0;0
4694;169323;519;0;0;0;0;.00nan;0;0
4694;22413;519;67;22;2;20;.909;3600000;0
4694;86228;512;71;42;4;38;.905;3520000;0
4694;142911;512;0;0;0;0;.00nan;0;0
4695;1072;1472;94;21;0;21;1.000;3600000;0
4695;53889;1475;0;0;0;0;.00nan;0;0
4695;64230;1472;0;0;0;0;.00nan;0;0
4695;143301;1475;81;32;2;30;.938;3560000;0
4696;8223;520;0;0;0;0;.00nan;0;0
4696;143036;516;90;43;3;40;.930;3900000;0
4696;155474;520;81;37;3;34;.919;3900000;0
4696;159851;516;0;0;0;0;.00nan;0;0
4697;7487;518;63;30;3;27;.900;3578000;0
4697;57993;518;0;0;0;0;.00nan;0;0
4697;80859;511;88;32;2;30;.938;3600000;0
4697;88646;511;0;0;0;0;.00nan;0;0
4698;177504;515;0;0;0;0;.00nan;0;0
4698;16587;513;0;0;0;0;.00nan;0;0
4698;63402;513;38;38;7;31;.816;3600000;0
4698;68565;515;80;28;1;27;.964;3600000;0
4699;63107;1876;0;0;0;0;.00nan;0;0
4699;64961;524;0;0;0;0;.00nan;0;0
4699;76951;524;52;22;3;19;.864;3565000;0
4699;86394;1876;74;26;2;24;.923;3600000;0
4700;7534;1481;0;0;0;0;.00nan;0;0
4700;32347;1481;48;25;4;21;.840;3600000;0
4700;62279;514;59;10;1;9;.900;3600000;0
4700;68627;514;0;0;0;0;.00nan;0;0
4701;62279;514;52;28;4;24;.857;3555000;0
4701;68627;514;0;0;0;0;.00nan;0;0
4701;86228;512;0;0;0;0;.00nan;0;0
4701;142911;512;69;28;3;25;.893;3600000;0
4702;1072;1472;0;0;0;0;.00nan;0;0
4702;8223;520;0;0;0;0;.00nan;0;0
4702;64230;1472;26;43;8;35;.814;3600000;0
4702;155474;520;91;32;2;30;.938;3600000;0
4703;169323;519;100;24;0;24;1.000;3600000;0
4703;22413;519;0;0;0;0;.00nan;0;0
4703;53889;1475;0;0;0;0;.00nan;0;0
4703;143301;1475;68;27;1;26;.963;3600000;0
4704;80859;511;71;26;3;23;.885;3600000;0
4704;88646;511;0;0;0;0;.00nan;0;0
4704;143036;516;34;30;6;24;.800;2576000;0
4704;159851;516;25;7;3;4;.571;1024000;0
4705;7534;1481;0;0;0;0;.00nan;0;0
4705;32347;1481;61;41;5;36;.878;3600000;0
4705;63107;1876;89;19;0;19;1.000;3600000;0
4705;86394;1876;0;0;0;0;.00nan;0;0
4706;64961;524;100;34;1;33;.971;3600000;0
4706;68565;515;54;29;3;26;.897;3542000;0
4706;76951;524;0;0;0;0;.00nan;0;0
4706;91403;515;0;0;0;0;.00nan;0;0
4707;7487;518;0;0;0;0;.00nan;0;0
4707;16587;513;73;39;4;35;.897;3600000;0
4707;57993;518;78;31;2;29;.935;3600000;0
4707;63402;513;0;0;0;0;.00nan;0;0
4708;1072;1472;0;0;0;0;.00nan;0;0
4708;7534;1481;72;33;3;30;.909;3567000;0
4708;32347;1481;0;0;0;0;.00nan;0;0
4708;64230;1472;63;20;2;18;.900;3600000;0
4709;16587;513;0;0;0;0;.00nan;0;0
4709;63402;513;94;37;1;36;.973;3600000;0
4709;80859;511;0;0;0;0;.00nan;0;0
4709;88646;511;48;14;2;12;.857;3584000;0
4710;86228;512;76;30;2;28;.933;3541000;0
4710;142911;512;0;0;0;0;.00nan;0;0
4710;143036;516;0;0;0;0;.00nan;0;0
4710;159851;516;78;24;1;23;.958;3600000;0
4711;7487;518;0;0;0;0;.00nan;0;0
4711;8223;520;0;0;0;0;.00nan;0;0
4711;57993;518;97;24;0;24;1.000;3600000;0
4711;155474;520;69;26;2;24;.923;3577000;0
4712;53889;1475;0;0;0;0;.00nan;0;0
4712;63107;1876;0;0;0;0;.00nan;0;0
4712;86394;1876;71;32;3;29;.906;3566000;0
4712;143301;1475;61;15;1;14;.933;3600000;0
4713;169323;519;84;37;2;35;.946;3567000;0
4713;22413;519;0;0;0;0;.00nan;0;0
4713;64961;524;82;26;1;25;.962;3600000;0
4713;76951;524;0;0;0;0;.00nan;0;0
4714;62279;514;49;18;3;15;.833;3600000;0
4714;68565;515;0;0;0;0;.00nan;0;0
4714;68627;514;0;0;0;0;.00nan;0;0
4714;91403;515;39;30;5;25;.833;3600000;0
4715;1072;1472;0;0;0;0;.00nan;0;0
4715;64230;1472;87;30;1;29;.967;3600000;0
4715;86228;512;41;14;3;11;.786;3545000;0
4715;142911;512;0;0;0;0;.00nan;0;0
4716;8223;520;0;0;0;0;.00nan;0;0
4716;80859;511;81;19;0;19;1.000;3600000;0
4716;88646;511;0;0;0;0;.00nan;0;0
4716;155474;520;47;30;5;25;.833;3600000;0
4717;7487;518;0;0;0;0;.00nan;0;0
4717;53889;1475;0;0;0;0;.00nan;0;0
4717;57993;518;42;22;4;18;.818;3600000;0
4717;143301;1475;54;41;6;35;.854;3547000;0
4718;63107;1876;71;28;2;26;.929;3592000;0
4718;68565;515;0;0;0;0;.00nan;0;0
4718;86394;1876;0;0;0;0;.00nan;0;0
4718;91403;515;100;27;0;27;1.000;3600000;0
4719;7534;1481;0;0;0;0;.00nan;0;0
4719;169323;519;96;21;0;21;1.000;3600000;0
4719;22413;519;0;0;0;0;.00nan;0;0
4719;32347;1481;86;34;2;32;.941;3594000;0
4720;62279;514;90;33;3;30;.909;3600000;0
4720;64961;524;0;0;0;0;.00nan;0;0
4720;68627;514;0;0;0;0;.00nan;0;0
4720;76951;524;51;29;5;24;.828;3559000;0
4721;16587;513;88;36;2;34;.944;3600000;0
4721;63402;513;0;0;0;0;.00nan;0;0
4721;143036;516;40;24;4;20;.833;3533000;0
4721;159851;516;0;0;0;0;.00nan;0;0
4722;169323;519;68;25;2;23;.920;3600000;0
4722;22413;519;0;0;0;0;.00nan;0;0
4722;68565;515;0;0;0;0;.00nan;0;0
4722;91403;515;48;27;4;23;.852;3530000;0
4723;1072;1472;59;21;3;18;.857;3581000;0
4723;64230;1472;0;0;0;0;.00nan;0;0
4723;64961;524;90;43;2;41;.953;3600000;0
4723;76951;524;0;0;0;0;.00nan;0;0
4724;80859;511;55;28;4;24;.857;3573000;0
4724;86228;512;100;53;2;51;.962;3600000;0
4724;88646;511;0;0;0;0;.00nan;0;0
4724;142911;512;0;0;0;0;.00nan;0;0
4725;53889;1475;0;0;0;0;.00nan;0;0
4725;143036;516;72;27;2;25;.926;3600000;0
4725;143301;1475;66;37;4;33;.892;3600000;0
4725;159851;516;0;0;0;0;.00nan;0;0
4726;7487;518;0;0;0;0;.00nan;0;0
4726;7534;1481;71;34;4;30;.882;3600000;0
4726;32347;1481;0;0;0;0;.00nan;0;0
4726;57993;518;75;35;3;32;.914;3600000;0
4727;62279;514;47;20;3;17;.850;3570000;0
4727;63107;1876;0;0;0;0;.00nan;0;0
4727;68627;514;0;0;0;0;.00nan;0;0
4727;86394;1876;97;41;1;40;.976;3600000;0
4728;8223;520;0;0;0;0;.00nan;0;0
4728;16587;513;0;0;0;0;.00nan;0;0
4728;63402;513;97;39;1;38;.974;3600000;0
4728;155474;520;100;30;0;30;1.000;3600000;0
4729;8223;520;0;0;0;0;.00nan;0;0
4729;86228;512;83;32;2;30;.938;3562000;0
4729;142911;512;0;0;0;0;.00nan;0;0
4729;155474;520;100;28;0;28;1.000;3600000;0
4730;16587;513;59;27;3;24;.889;3584000;0
4730;53889;1475;0;0;0;0;.00nan;0;0
4730;63402;513;0;0;0;0;.00nan;0;0
4730;143301;1475;69;26;2;24;.923;3600000;0
4731;64961;524;97;41;0;41;1.000;3900000;0
4731;76951;524;0;0;0;0;.00nan;0;0
4731;80859;511;100;30;0;30;1.000;3900000;0
4731;88646;511;0;0;0;0;.00nan;0;0
4732;7487;518;0;0;0;0;.00nan;0;0
4732;57993;518;60;29;4;25;.862;3652000;0
4732;68565;515;0;0;0;0;.00nan;0;0
4732;91403;515;76;38;3;35;.921;3652000;0
4733;7534;1481;0;0;0;0;.00nan;0;0
4733;32347;1481;65;25;2;23;.920;3542000;0
4733;143036;516;100;24;0;24;1.000;3600000;0
4733;159851;516;0;0;0;0;.00nan;0;0
4734;169323;519;60;32;4;28;.875;3600000;0
4734;22413;519;0;0;0;0;.00nan;0;0
4734;63107;1876;100;35;0;35;1.000;3600000;0
4734;86394;1876;0;0;0;0;.00nan;0;0
4735;1072;1472;0;0;0;0;.00nan;0;0
4735;62279;514;58;28;3;25;.893;3600000;0
4735;64230;1472;37;28;5;23;.821;3569000;0
4735;68627;514;0;0;0;0;.00nan;0;0
4736;7534;1481;0;0;0;0;.00nan;0;0
4736;8223;520;0;0;0;0;.00nan;0;0
4736;32347;1481;79;24;1;23;.958;3600000;0
4736;155474;520;57;21;2;19;.905;3547000;0
4737;169323;519;59;37;5;32;.865;3600000;0
4737;22413;519;0;0;0;0;.00nan;0;0
4737;62279;514;100;35;1;34;.971;3600000;0
4737;68627;514;0;0;0;0;.00nan;0;0
4738;1072;1472;85;23;1;22;.957;3600000;0
4738;64230;1472;0;0;0;0;.00nan;0;0
4738;68565;515;0;0;0;0;.00nan;0;0
4738;91403;515;84;49;3;46;.939;3550000;0
4739;53889;1475;0;0;0;0;.00nan;0;0
4739;80859;511;62;21;2;19;.905;3600000;0
4739;88646;511;0;0;0;0;.00nan;0;0
4739;143301;1475;69;47;5;42;.894;3600000;0
4740;63107;1876;61;36;4;32;.889;3557000;0
4740;86394;1876;0;0;0;0;.00nan;0;0
4740;143036;516;70;20;2;18;.900;3600000;0
4740;159851;516;0;0;0;0;.00nan;0;0
4741;7487;518;0;0;0;0;.00nan;0;0
4741;57993;518;99;25;0;25;1.000;3600000;0
4741;64961;524;68;53;5;48;.906;3600000;0
4741;76951;524;0;0;0;0;.00nan;0;0
4742;16587;513;0;0;0;0;.00nan;0;0
4742;63402;513;81;34;2;32;.941;3762000;0
4742;86228;512;82;32;1;31;.969;3762000;0
4742;142911;512;0;0;0;0;.00nan;0;0
4743;53889;1475;0;0;0;0;.00nan;0;0
4743;86228;512;80;23;1;22;.957;3600000;0
4743;142911;512;0;0;0;0;.00nan;0;0
4743;143301;1475;87;38;2;36;.947;3600000;0
4744;1072;1472;0;0;0;0;.00nan;0;0
4744;169323;519;53;38;5;33;.868;3600000;0
4744;22413;519;0;0;0;0;.00nan;0;0
4744;64230;1472;69;20;1;19;.950;3600000;0
4745;68565;515;0;0;0;0;.00nan;0;0
4745;91403;515;66;33;3;30;.909;3600000;0
4745;143036;516;58;33;4;29;.879;3600000;0
4745;159851;516;0;0;0;0;.00nan;0;0
4746;7534;1481;93;24;0;24;1.000;3600000;0
4746;16587;513;0;0;0;0;.00nan;0;0
4746;32347;1481;0;0;0;0;.00nan;0;0
4746;63402;513;88;36;1;35;.972;3600000;0
4747;7487;518;40;2;1;1;.500;681000;0
4747;57993;518;28;26;6;20;.769;2919000;0
4747;63107;1876;0;0;0;0;.00nan;0;0
4747;86394;1876;63;29;3;26;.897;3600000;0
4748;8223;520;0;0;0;0;.00nan;0;0
4748;64961;524;0;0;0;0;.00nan;0;0
4748;76951;524;65;27;3;24;.889;3543000;0
4748;155474;520;82;23;1;22;.957;3600000;0
4749;62279;514;62;33;3;30;.909;3600000;0
4749;68627;514;0;0;0;0;.00nan;0;0
4749;80859;511;100;24;0;24;1.000;3600000;0
4749;88646;511;0;0;0;0;.00nan;0;0
4750;7534;1481;68;35;3;32;.914;3600000;0
4750;32347;1481;0;0;0;0;.00nan;0;0
4750;86228;512;0;0;0;0;.00nan;0;0
4750;142911;512;75;25;1;24;.960;3600000;0
4751;8223;520;0;0;0;0;.00nan;0;0
4751;53889;1475;0;0;0;0;.00nan;0;0
4751;143301;1475;71;41;4;37;.902;3600000;0
4751;155474;520;40;15;3;12;.800;3600000;0
4752;1072;1472;100;30;0;30;1.000;3600000;0
4752;63107;1876;61;41;4;37;.902;3600000;0
4752;64230;1472;0;0;0;0;.00nan;0;0
4752;86394;1876;0;0;0;0;.00nan;0;0
4753;68565;515;0;0;0;0;.00nan;0;0
4753;80859;511;82;26;2;24;.923;3600000;0
4753;88646;511;0;0;0;0;.00nan;0;0
4753;91403;515;78;39;3;36;.923;3587000;0
4754;7487;518;0;0;0;0;.00nan;0;0
4754;57993;518;75;24;1;23;.958;3600000;0
4754;62279;514;59;21;2;19;.905;3564000;0
4754;68627;514;0;0;0;0;.00nan;0;0
4755;64961;524;96;32;1;31;.969;3600000;0
4755;76951;524;0;0;0;0;.00nan;0;0
4755;143036;516;66;30;2;28;.933;3600000;0
4755;159851;516;0;0;0;0;.00nan;0;0
4756;16587;513;0;0;0;0;.00nan;0;0
4756;169323;519;72;30;2;28;.933;3600000;0
4756;22413;519;0;0;0;0;.00nan;0;0
4756;63402;513;71;17;1;16;.941;3600000;0
4757;64961;524;81;41;4;37;.902;3600000;0
4757;76951;524;0;0;0;0;.00nan;0;0
4757;86228;512;79;25;1;24;.960;3600000;0
4757;142911;512;0;0;0;0;.00nan;0;0
4758;8223;520;0;0;0;0;.00nan;0;0
4758;62279;514;96;33;1;32;.970;3600000;0
4758;68627;514;0;0;0;0;.00nan;0;0
4758;155474;520;40;22;4;18;.818;3600000;0
4759;53889;1475;0;0;0;0;.00nan;0;0
4759;68565;515;0;0;0;0;.00nan;0;0
4759;91403;515;86;28;1;27;.964;3600000;0
4759;143301;1475;81;36;3;33;.917;3520000;0
4760;7534;1481;0;0;0;0;.00nan;0;0
4760;32347;1481;69;33;3;30;.909;3892000;0
4760;80859;511;60;18;2;16;.889;3892000;0
4760;88646;511;0;0;0;0;.00nan;0;0
4761;1072;1472;32;22;4;18;.818;2019000;0
4761;64230;1472;58;8;0;8;1.000;1581000;0
4761;143036;516;0;0;0;0;.00nan;0;0
4761;159851;516;77;28;2;26;.929;3600000;0
4762;7487;518;0;0;0;0;.00nan;0;0
4762;169323;519;58;42;6;36;.857;3600000;0
4762;22413;519;0;0;0;0;.00nan;0;0
4762;57993;518;97;31;1;30;.968;3600000;0
4763;16587;513;74;30;2;28;.933;3600000;0
4763;63107;1876;0;0;0;0;.00nan;0;0
4763;63402;513;0;0;0;0;.00nan;0;0
4763;86394;1876;52;42;5;37;.881;3600000;0
4764;8223;520;46;13;2;11;.846;1070000;0
4764;169323;519;0;0;0;0;.00nan;0;0
4764;22413;519;16;20;6;14;.700;3600000;0
4764;155474;520;24;24;6;18;.750;2530000;0
4765;1072;1472;44;33;6;27;.818;3600000;0
4765;7487;518;0;0;0;0;.00nan;0;0
4765;57993;518;92;37;2;35;.946;3600000;0
4765;64230;1472;0;0;0;0;.00nan;0;0
4766;84990;515;0;0;0;0;.00nan;0;0
4766;86228;512;52;27;4;23;.852;3546000;0
4766;91403;515;83;40;3;37;.925;3600000;0
4766;142911;512;0;0;0;0;.00nan;0;0
4767;7534;1481;63;16;1;15;.938;3600000;0
4767;32347;1481;0;0;0;0;.00nan;0;0
4767;53889;1475;0;0;0;0;.00nan;0;0
4767;143301;1475;83;39;2;37;.949;3600000;0
4768;63107;1876;0;0;0;0;.00nan;0;0
4768;80859;511;98;29;1;28;.966;3600000;0
4768;86394;1876;51;30;5;25;.833;3600000;0
4768;143301;511;0;0;0;0;.00nan;0;0
4769;16587;513;0;0;0;0;.00nan;0;0
4769;63402;513;100;43;1;42;.977;3600000;0
4769;64961;524;0;0;0;0;.00nan;0;0
4769;76951;524;67;29;3;26;.897;3517000;0
4770;62279;514;90;32;1;31;.969;3600000;0
4770;68627;514;0;0;0;0;.00nan;0;0
4770;143036;516;60;26;3;23;.885;3600000;0
4770;159851;516;0;0;0;0;.00nan;0;0
4771;63107;1876;45;21;4;17;.810;3600000;0
4771;86228;512;83;30;1;29;.967;3600000;0
4771;86394;1876;0;0;0;0;.00nan;0;0
4771;142911;512;0;0;0;0;.00nan;0;0
4772;53889;1475;68;33;3;30;.909;3600000;0
4772;62279;514;36;20;5;15;.750;3530000;0
4772;68627;514;0;0;0;0;.00nan;0;0
4772;143191;1475;0;0;0;0;.00nan;0;0
4773;169323;519;80;39;3;36;.923;3545000;0
4773;22413;519;0;0;0;0;.00nan;0;0
4773;80859;511;0;0;0;0;.00nan;0;0
4773;143301;511;52;16;2;14;.875;3600000;0
4774;7487;518;0;0;0;0;.00nan;0;0
4774;57993;518;70;27;2;25;.926;3600000;0
4774;143036;516;70;36;3;33;.917;3574000;0
4774;159851;516;0;0;0;0;.00nan;0;0
4775;7534;1481;0;0;0;0;.00nan;0;0
4775;32347;1481;79;39;3;36;.923;3707000;0
4775;64961;524;58;20;2;18;.900;3707000;0
4775;76951;524;0;0;0;0;.00nan;0;0
4776;1072;1472;0;0;0;0;.00nan;0;0
4776;16587;513;0;0;0;0;.00nan;0;0
4776;63402;513;77;48;5;43;.896;3527000;0
4776;64230;1472;71;33;3;30;.909;3600000;0
4777;8223;520;0;0;0;0;.00nan;0;0
4777;84990;515;0;0;0;0;.00nan;0;0
4777;91403;515;61;30;3;27;.900;3573000;0
4777;155474;520;83;37;2;35;.946;3600000;0
4778;169323;519;20;21;5;16;.762;3600000;0
4778;22413;519;0;0;0;0;.00nan;0;0
4778;143036;516;96;33;1;32;.970;3600000;0
4778;159851;516;0;0;0;0;.00nan;0;0
4779;1072;1472;53;36;5;31;.861;3600000;0
4779;64230;1472;0;0;0;0;.00nan;0;0
4779;80859;511;57;22;2;20;.909;3600000;0
4779;143301;511;0;0;0;0;.00nan;0;0
4780;7487;518;0;0;0;0;.00nan;0;0
4780;57993;518;75;23;1;22;.957;3600000;0
4780;86228;512;86;34;2;32;.941;3600000;0
4780;142911;512;0;0;0;0;.00nan;0;0
4781;7534;1481;85;30;1;29;.967;3565000;0
4781;32347;1481;0;0;0;0;.00nan;0;0
4781;84990;515;0;0;0;0;.00nan;0;0
4781;91403;515;92;25;0;25;1.000;3600000;0
4782;8223;520;0;0;0;0;.00nan;0;0
4782;63107;1876;73;34;3;31;.912;3900000;0
4782;86394;1876;0;0;0;0;.00nan;0;0
4782;155474;520;73;33;3;30;.909;3900000;0
4783;53889;1475;0;0;0;0;.00nan;0;0
4783;64961;524;69;27;2;25;.926;3600000;0
4783;76951;524;0;0;0;0;.00nan;0;0
4783;143191;1475;15;31;8;23;.742;3600000;0
4784;16587;513;0;0;0;0;.00nan;0;0
4784;62279;514;0;0;0;0;.00nan;0;0
4784;63402;513;55;29;3;26;.897;3577000;0
4784;68627;514;82;18;1;17;.944;3600000;0
4785;169323;519;56;24;3;21;.875;3900000;0
4785;22413;519;0;0;0;0;.00nan;0;0
4785;86228;512;59;30;3;27;.900;3900000;0
4785;142911;512;0;0;0;0;.00nan;0;0
4786;8223;520;0;0;0;0;.00nan;0;0
4786;143036;516;59;14;1;13;.929;3600000;0
4786;155474;520;74;38;3;35;.921;3552000;0
4786;159851;516;0;0;0;0;.00nan;0;0
4787;1072;1472;58;27;3;24;.889;3600000;0
4787;53889;1475;63;19;2;17;.895;1387000;0
4787;64230;1472;0;0;0;0;.00nan;0;0
4787;143191;1475;47;25;5;20;.800;2213000;0
4788;7487;518;0;0;0;0;.00nan;0;0
4788;57993;518;77;33;3;30;.909;3628000;0
4788;80859;511;72;24;2;22;.917;3628000;0
4788;143301;511;0;0;0;0;.00nan;0;0
4789;7534;1481;0;0;0;0;.00nan;0;0
4789;32347;1481;79;26;1;25;.962;3600000;0
4789;62279;514;74;29;2;27;.931;3589000;0
4789;68627;514;0;0;0;0;.00nan;0;0
4790;63107;1876;55;35;4;31;.886;3570000;0
4790;64961;524;59;21;2;19;.905;3600000;0
4790;76951;524;0;0;0;0;.00nan;0;0
4790;86394;1876;0;0;0;0;.00nan;0;0
4791;16587;513;71;38;4;34;.895;3600000;0
4791;63402;513;0;0;0;0;.00nan;0;0
4791;84990;515;0;0;0;0;.00nan;0;0
4791;91403;515;73;16;1;15;.938;3600000;0
4792;169323;519;62;22;3;19;.864;3600000;0
4792;22413;519;0;0;0;0;.00nan;0;0
4792;53889;1475;0;0;0;0;.00nan;0;0
4792;143191;1475;52;28;4;24;.857;3600000;0
4793;1072;1472;0;0;0;0;.00nan;0;0
4793;8223;520;0;0;0;0;.00nan;0;0
4793;64230;1472;73;23;2;21;.913;3600000;0
4793;155474;520;97;49;3;46;.939;3578000;0
4794;80859;511;63;21;3;18;.857;3600000;0
4794;143036;516;0;0;0;0;.00nan;0;0
4794;143301;511;0;0;0;0;.00nan;0;0
4794;159851;516;53;31;5;26;.839;3600000;0
4795;7487;518;55;17;2;15;.882;3547000;0
4795;16587;513;0;0;0;0;.00nan;0;0
4795;57993;518;0;0;0;0;.00nan;0;0
4795;63402;513;99;42;1;41;.976;3600000;0
4796;64961;524;57;44;5;39;.886;3600000;0
4796;76951;524;0;0;0;0;.00nan;0;0
4796;84990;515;0;0;0;0;.00nan;0;0
4796;91403;515;77;34;2;32;.941;3600000;0
4797;7534;1481;0;0;0;0;.00nan;0;0
4797;32347;1481;37;32;6;26;.813;3575000;0
4797;63107;1876;62;26;3;23;.885;3600000;0
4797;86394;1876;0;0;0;0;.00nan;0;0
4798;62279;514;0;0;0;0;.00nan;0;0
4798;68627;514;69;21;1;20;.952;3600000;0
4798;73973;512;0;0;0;0;.00nan;0;0
4798;86228;512;48;21;3;18;.857;3600000;0
4799;73973;512;0;0;0;0;.00nan;0;0
4799;86228;512;93;31;1;30;.968;3600000;0
4799;143036;516;43;34;5;29;.853;3600000;0
4799;159851;516;0;0;0;0;.00nan;0;0
4800;7487;518;0;0;0;0;.00nan;0;0
4800;8223;520;0;0;0;0;.00nan;0;0
4800;57993;518;42;26;4;22;.846;3559000;0
4800;155474;520;83;35;2;33;.943;3600000;0
4801;53889;1475;0;0;0;0;.00nan;0;0
4801;63107;1876;82;28;2;26;.929;3900000;0
4801;86394;1876;0;0;0;0;.00nan;0;0
4801;143191;1475;83;36;2;34;.944;3900000;0
4802;169323;519;54;33;5;28;.848;3600000;0
4802;22413;519;0;0;0;0;.00nan;0;0
4802;64961;524;100;26;0;26;1.000;3600000;0
4802;76951;524;0;0;0;0;.00nan;0;0
4803;62279;514;75;36;3;33;.917;3583000;0
4803;68627;514;0;0;0;0;.00nan;0;0
4803;84990;515;0;0;0;0;.00nan;0;0
4803;91403;515;76;24;1;23;.958;3600000;0
4804;1072;1472;59;16;1;15;.938;3600000;0
4804;7534;1481;74;35;3;32;.914;3555000;0
4804;32347;1481;0;0;0;0;.00nan;0;0
4804;64230;1472;0;0;0;0;.00nan;0;0
4805;16587;513;0;0;0;0;.00nan;0;0
4805;63402;513;74;50;5;45;.900;3592000;0
4805;80859;511;65;27;3;24;.889;3600000;0
4805;143301;511;0;0;0;0;.00nan;0;0
4806;7534;1481;0;0;0;0;.00nan;0;0
4806;169323;519;63;27;3;24;.889;3600000;0
4806;22413;519;0;0;0;0;.00nan;0;0
4806;32347;1481;53;32;4;28;.875;3549000;0
4807;1072;1472;79;26;2;24;.923;3600000;0
4807;64230;1472;0;0;0;0;.00nan;0;0
4807;73973;512;0;0;0;0;.00nan;0;0
4807;86228;512;65;41;5;36;.878;3600000;0
4808;8223;520;0;0;0;0;.00nan;0;0
4808;142911;511;0;0;0;0;.00nan;0;0
4808;143301;511;58;23;3;20;.870;3533000;0
4808;155474;520;90;31;1;30;.968;3600000;0
4809;16587;513;0;0;0;0;.00nan;0;0
4809;63402;513;61;35;5;30;.857;3591000;0
4809;143036;516;73;27;3;24;.889;3600000;0
4809;159851;516;0;0;0;0;.00nan;0;0
4810;7487;518;0;0;0;0;.00nan;0;0
4810;53889;1475;0;0;0;0;.00nan;0;0
4810;57993;518;78;22;1;21;.955;3600000;0
4810;143191;1475;77;36;2;34;.944;3569000;0
4811;63107;1876;82;31;2;29;.935;3622000;0
4811;84990;515;0;0;0;0;.00nan;0;0
4811;86394;1876;0;0;0;0;.00nan;0;0
4811;91403;515;99;34;1;33;.971;3622000;0
4812;62279;514;100;27;0;27;1.000;3600000;0
4812;64961;524;20;26;6;20;.769;1945000;0
4812;68627;514;0;0;0;0;.00nan;0;0
4812;76951;524;51;13;2;11;.846;1655000;0
4813;73973;512;0;0;0;0;.00nan;0;0
4813;80859;511;58;16;2;14;.875;3600000;0
4813;86228;512;46;29;4;25;.862;3564000;0
4813;143301;511;0;0;0;0;.00nan;0;0
4814;8223;520;0;0;0;0;.00nan;0;0
4814;16587;513;0;0;0;0;.00nan;0;0
4814;63402;513;86;29;1;28;.966;3600000;0
4814;155474;520;32;24;5;19;.792;3600000;0
4815;53889;1475;0;0;0;0;.00nan;0;0
4815;143036;516;36;15;3;12;.800;3600000;0
4815;143191;1475;78;53;5;48;.906;3600000;0
4815;159851;516;0;0;0;0;.00nan;0;0
4816;169323;519;81;28;2;26;.929;3600000;0
4816;22413;519;0;0;0;0;.00nan;0;0
4816;84990;515;0;0;0;0;.00nan;0;0
4816;91403;515;76;33;3;30;.909;3560000;0
4817;7487;518;0;0;0;0;.00nan;0;0
4817;7534;1481;66;24;2;22;.917;3600000;0
4817;57993;518;67;28;3;25;.893;3544000;0
4817;143083;1481;0;0;0;0;.00nan;0;0
4818;1072;1472;58;27;3;24;.889;3659000;0
4818;64230;1472;0;0;0;0;.00nan;0;0
4818;64961;524;0;0;0;0;.00nan;0;0
4818;76951;524;71;34;2;32;.941;3659000;0
4819;62279;514;75;26;2;24;.923;3900000;0
4819;63107;1876;69;28;2;26;.929;3900000;0
4819;68627;514;0;0;0;0;.00nan;0;0
4819;86394;1876;0;0;0;0;.00nan;0;0
4820;8223;520;0;0;0;0;.00nan;0;0
4820;73973;512;0;0;0;0;.00nan;0;0
4820;86228;512;66;24;2;22;.917;3542000;0
4820;155474;520;73;21;1;20;.952;3600000;0
4821;169323;519;0;0;0;0;.00nan;0;0
4821;22413;519;78;32;2;30;.938;3900000;0
4821;63107;1876;0;0;0;0;.00nan;0;0
4821;86394;1876;74;32;2;30;.938;3900000;0
4822;1072;1472;0;0;0;0;.00nan;0;0
4822;62279;514;0;0;0;0;.00nan;0;0
4822;64230;1472;69;36;4;32;.889;3684000;0
4822;68627;514;64;41;5;36;.878;3684000;0
4823;7534;1481;92;38;1;37;.974;3600000;0
4823;32347;1481;0;0;0;0;.00nan;0;0
4823;143036;516;29;10;3;7;.700;3521000;0
4823;159851;516;0;0;0;0;.00nan;0;0
4824;7487;518;0;0;0;0;.00nan;0;0
4824;18965;515;0;0;0;0;.00nan;0;0
4824;57993;518;66;28;3;25;.893;3600000;0
4824;91403;515;68;46;5;41;.891;3600000;0
4825;64961;524;96;39;1;38;.974;3900000;0
4825;76951;524;0;0;0;0;.00nan;0;0
4825;80859;511;75;20;1;19;.950;3900000;0
4825;143301;511;0;0;0;0;.00nan;0;0
4826;16587;513;0;0;0;0;.00nan;0;0
4826;53889;1475;0;0;0;0;.00nan;0;0
4826;63402;513;79;34;3;31;.912;3600000;0
4826;143191;1475;47;24;4;20;.833;3600000;0
4827;16587;513;0;0;0;0;.00nan;0;0
4827;63402;513;94;26;2;24;.923;3812000;0
4827;73973;512;0;0;0;0;.00nan;0;0
4827;86228;512;81;23;1;22;.957;3812000;0
4828;53889;1475;84;41;3;38;.927;3600000;0
4828;80859;511;91;14;0;14;1.000;3600000;0
4828;143191;1475;0;0;0;0;.00nan;0;0
4828;143301;511;0;0;0;0;.00nan;0;0
4829;1072;1472;73;21;1;20;.952;3576000;0
4829;18965;515;0;0;0;0;.00nan;0;0
4829;64230;1472;0;0;0;0;.00nan;0;0
4829;91403;515;100;43;0;43;1.000;3600000;0
4830;7534;1481;0;0;0;0;.00nan;0;0
4830;8223;520;0;0;0;0;.00nan;0;0
4830;32347;1481;64;43;5;38;.884;3600000;0
4830;155474;520;55;14;2;12;.857;3600000;0
4831;63107;1876;0;0;0;0;.00nan;0;0
4831;86394;1876;57;45;6;39;.867;3600000;0
4831;143036;516;58;24;3;21;.875;3600000;0
4831;159851;516;0;0;0;0;.00nan;0;0
4832;7487;518;0;0;0;0;.00nan;0;0
4832;57993;518;100;24;0;24;1.000;3600000;0
4832;64961;524;63;36;4;32;.889;3600000;0
4832;76951;524;0;0;0;0;.00nan;0;0
4833;169323;519;66;25;2;23;.920;3552000;0
4833;22413;519;0;0;0;0;.00nan;0;0
4833;62279;514;81;17;0;17;1.000;3600000;0
4833;68627;514;0;0;0;0;.00nan;0;0
4834;53889;1475;81;31;2;29;.935;3600000;0
4834;73973;512;0;0;0;0;.00nan;0;0
4834;86228;512;69;31;3;28;.903;3589000;0
4834;143191;1475;0;0;0;0;.00nan;0;0
4835;8223;520;0;0;0;0;.00nan;0;0
4835;64961;524;75;27;2;25;.926;3600000;0
4835;76951;524;0;0;0;0;.00nan;0;0
4835;155474;520;82;23;1;22;.957;3600000;0
4836;1072;1472;54;37;5;32;.865;3900000;0
4836;169323;519;66;46;5;41;.891;3900000;0
4836;22413;519;0;0;0;0;.00nan;0;0
4836;64230;1472;0;0;0;0;.00nan;0;0
4837;62279;514;34;24;5;19;.792;1908000;0
4837;68627;514;77;21;1;20;.952;1692000;0
4837;80859;511;54;14;2;12;.857;3600000;0
4837;143301;511;0;0;0;0;.00nan;0;0
4838;18965;515;0;0;0;0;.00nan;0;0
4838;91403;515;67;40;4;36;.900;3566000;0
4838;143036;516;0;0;0;0;.00nan;0;0
4838;159851;516;66;30;2;28;.933;3600000;0
4839;7487;518;0;0;0;0;.00nan;0;0
4839;57993;518;63;19;2;17;.895;3600000;0
4839;63107;1876;37;44;7;37;.841;3000000;0
4839;86394;1876;59;7;0;7;1.000;600000;0
4840;7534;1481;0;0;0;0;.00nan;0;0
4840;16587;513;63;21;3;18;.857;3600000;0
4840;32347;1481;73;45;5;40;.889;3600000;0
4840;63402;513;0;0;0;0;.00nan;0;0
4841;8223;520;0;0;0;0;.00nan;0;0
4841;53889;1475;86;28;1;27;.964;3600000;0
4841;143191;1475;0;0;0;0;.00nan;0;0
4841;155474;520;71;25;2;23;.920;3544000;0
4842;169323;519;46;32;5;27;.844;3600000;0
4842;22413;519;0;0;0;0;.00nan;0;0
4842;32347;513;0;0;0;0;.00nan;0;0
4842;63402;513;66;48;6;42;.875;3574000;0
4843;64961;524;73;31;3;28;.903;3600000;0
4843;76951;524;0;0;0;0;.00nan;0;0
4843;143036;516;40;31;6;25;.806;3600000;0
4843;159851;516;0;0;0;0;.00nan;0;0
4844;18965;515;0;0;0;0;.00nan;0;0
4844;80859;511;93;28;1;27;.964;3600000;0
4844;91403;515;37;36;6;30;.833;3600000;0
4844;143301;511;0;0;0;0;.00nan;0;0
4845;7534;1481;88;39;2;37;.949;3559000;0
4845;73973;512;0;0;0;0;.00nan;0;0
4845;86228;512;89;17;0;17;1.000;3600000;0
4845;143083;1481;0;0;0;0;.00nan;0;0
4846;1072;1472;0;0;0;0;.00nan;0;0
4846;63107;1876;95;42;3;39;.929;3600000;0
4846;64230;1472;47;29;4;25;.862;3547000;0
4846;86394;1876;0;0;0;0;.00nan;0;0
4847;7487;518;0;0;0;0;.00nan;0;0
4847;57993;518;43;20;4;16;.800;3900000;0
4847;62279;514;73;38;4;34;.895;3900000;0
4847;68627;514;0;0;0;0;.00nan;0;0
4848;7487;518;0;0;0;0;.00nan;0;0
4848;169323;519;82;41;3;38;.927;3586000;0
4848;22413;519;0;0;0;0;.00nan;0;0
4848;57993;518;59;16;1;15;.938;3600000;0
4849;1072;1472;0;0;0;0;.00nan;0;0
4849;64230;1472;99;24;0;24;1.000;3600000;0
4849;143036;516;48;33;5;28;.848;3600000;0
4849;159851;516;0;0;0;0;.00nan;0;0
4850;18965;515;0;0;0;0;.00nan;0;0
4850;53889;1475;67;36;4;32;.889;3600000;0
4850;91403;515;77;24;1;23;.958;3600000;0
4850;143191;1475;0;0;0;0;.00nan;0;0
4851;7534;1481;100;44;0;44;1.000;3600000;0
4851;80859;511;86;22;1;21;.955;3554000;0
4851;143083;1481;0;0;0;0;.00nan;0;0
4851;143301;511;0;0;0;0;.00nan;0;0
4852;32347;513;0;0;0;0;.00nan;0;0
4852;63107;1876;0;0;0;0;.00nan;0;0
4852;63402;513;81;41;4;37;.902;3600000;0
4852;86394;1876;72;32;3;29;.906;3600000;0
4853;64961;524;0;0;0;0;.00nan;0;0
4853;73973;512;0;0;0;0;.00nan;0;0
4853;76951;524;66;24;2;22;.917;3600000;0
4853;86228;512;69;32;3;29;.906;3548000;0
4854;8223;520;0;0;0;0;.00nan;0;0
4854;62279;514;0;0;0;0;.00nan;0;0
4854;68627;514;86;17;0;17;1.000;3600000;0
4854;155474;520;86;42;3;39;.929;3600000;0
4855;7534;1481;50;30;4;26;.867;3600000;0
4855;18965;515;0;0;0;0;.00nan;0;0
4855;91403;515;75;26;1;25;.962;3600000;0
4855;143083;1481;0;0;0;0;.00nan;0;0
4856;18965;515;0;0;0;0;.00nan;0;0
4856;73973;512;61;34;4;30;.882;3717000;0
4856;86228;512;0;0;0;0;.00nan;0;0
4856;91403;515;58;29;3;26;.897;3717000;0
4857;8223;520;67;16;1;15;.938;3600000;0
4857;169323;519;58;33;4;29;.879;3600000;0
4857;22413;519;0;0;0;0;.00nan;0;0
4857;155474;520;0;0;0;0;.00nan;0;0
4858;7534;1481;100;26;0;26;1.000;3600000;0
4858;53889;1475;72;31;3;28;.903;3600000;0
4858;143083;1481;0;0;0;0;.00nan;0;0
4858;143191;1475;0;0;0;0;.00nan;0;0
4859;63107;1876;79;27;2;25;.926;3600000;0
4859;80859;511;0;0;0;0;.00nan;0;0
4859;86394;1876;0;0;0;0;.00nan;0;0
4859;143301;511;85;30;1;29;.967;3600000;0
4860;62279;514;47;33;5;28;.848;3600000;0
4860;68627;514;0;0;0;0;.00nan;0;0
4860;143036;516;96;30;1;29;.967;3600000;0
4860;159851;516;0;0;0;0;.00nan;0;0
4861;1072;1472;0;0;0;0;.00nan;0;0
4861;7487;518;0;0;0;0;.00nan;0;0
4861;57993;518;41;25;5;20;.800;3593000;0
4861;64230;1472;82;32;3;29;.906;3600000;0
4862;32347;513;0;0;0;0;.00nan;0;0
4862;63402;513;84;29;2;27;.931;3600000;0
4862;64961;524;60;33;3;30;.909;3592000;0
4862;76951;524;0;0;0;0;.00nan;0;0
4863;169323;519;86;36;2;34;.944;3578000;0
4863;22413;519;0;0;0;0;.00nan;0;0
4863;80859;511;87;25;1;24;.960;3600000;0
4863;143301;511;0;0;0;0;.00nan;0;0
4864;1072;1472;0;0;0;0;.00nan;0;0
4864;32347;513;0;0;0;0;.00nan;0;0
4864;63402;513;89;41;2;39;.951;3600000;0
4864;64230;1472;24;15;4;11;.733;3553000;0
4865;7487;518;0;0;0;0;.00nan;0;0
4865;57993;518;82;31;2;29;.935;3600000;0
4865;143036;516;82;28;1;27;.964;3600000;0
4865;159851;516;0;0;0;0;.00nan;0;0
4866;8223;520;0;0;0;0;.00nan;0;0
4866;18965;515;45;12;3;9;.750;1245000;0
4866;91403;515;41;26;4;22;.846;2355000;0
4866;155474;520;47;26;4;22;.846;3600000;0
4867;63107;1876;0;0;0;0;.00nan;0;0
4867;73973;512;0;0;0;0;.00nan;0;0
4867;86228;512;77;37;3;34;.919;3568000;0
4867;86394;1876;69;20;1;19;.950;3600000;0
4868;7534;1481;77;41;4;37;.902;3588000;0
4868;64961;524;0;0;0;0;.00nan;0;0
4868;76951;524;49;27;3;24;.889;3600000;0
4868;143083;1481;0;0;0;0;.00nan;0;0
4869;53889;1475;0;0;0;0;.00nan;0;0
4869;62279;514;69;20;1;19;.950;3600000;0
4869;68627;514;0;0;0;0;.00nan;0;0
4869;143191;1475;97;44;3;41;.932;3600000;0
4870;7487;518;0;0;0;0;.00nan;0;0
4870;57993;518;73;43;5;38;.884;3900000;0
4870;73973;512;0;0;0;0;.00nan;0;0
4870;86228;512;62;34;5;29;.853;3900000;0
4871;8223;520;0;0;0;0;.00nan;0;0
4871;63107;1876;0;0;0;0;.00nan;0;0
4871;86394;1876;100;43;1;42;.977;3600000;0
4871;155474;520;43;22;3;19;.864;3521000;0
4872;53889;1475;0;0;0;0;.00nan;0;0
4872;64961;524;72;19;1;18;.947;3600000;0
4872;76951;524;0;0;0;0;.00nan;0;0
4872;143191;1475;61;30;3;27;.900;3600000;0
4873;1072;1472;0;0;0;0;.00nan;0;0
4873;64230;1472;74;35;3;32;.914;3600000;0
4873;80859;511;49;28;4;24;.857;3549000;0
4873;143301;511;0;0;0;0;.00nan;0;0
4874;169323;519;58;40;5;35;.875;3600000;0
4874;22413;519;0;0;0;0;.00nan;0;0
4874;143036;516;95;26;0;26;1.000;3600000;0
4874;159851;516;0;0;0;0;.00nan;0;0
4875;32347;513;0;0;0;0;.00nan;0;0
4875;62279;514;81;37;3;34;.919;3758000;0
4875;63402;513;68;26;2;24;.923;3758000;0
4875;68627;514;0;0;0;0;.00nan;0;0
4876;169323;519;81;27;1;26;.963;3893000;0
4876;22413;519;0;0;0;0;.00nan;0;0
4876;73973;512;0;0;0;0;.00nan;0;0
4876;86228;512;92;27;1;26;.963;3900000;0
4877;1072;1472;0;0;0;0;.00nan;0;0
4877;53889;1475;0;0;0;0;.00nan;0;0
4877;64230;1472;69;11;1;10;.909;3600000;0
4877;143191;1475;56;44;6;38;.864;3600000;0
4878;8223;520;0;0;0;0;.00nan;0;0
4878;143036;516;72;28;2;26;.929;3529000;0
4878;155474;520;100;34;0;34;1.000;3600000;0
4878;159851;516;0;0;0;0;.00nan;0;0
4879;7487;518;65;28;3;25;.893;3600000;0
4879;57993;518;0;0;0;0;.00nan;0;0
4879;80859;511;40;25;4;21;.840;3548000;0
4879;143301;511;0;0;0;0;.00nan;0;0
4880;18965;515;0;0;0;0;.00nan;0;0
4880;32347;513;0;0;0;0;.00nan;0;0
4880;63402;513;67;19;1;18;.947;3600000;0
4880;91403;515;60;35;4;31;.886;3600000;0
4881;63107;1876;0;0;0;0;.00nan;0;0
4881;64961;524;76;23;1;22;.957;3600000;0
4881;76951;524;0;0;0;0;.00nan;0;0
4881;86394;1876;68;32;3;29;.906;3570000;0
4882;7534;1481;98;36;1;35;.972;3600000;0
4882;62279;514;84;17;0;17;1.000;3600000;0
4882;68627;514;0;0;0;0;.00nan;0;0
4882;143083;1481;0;0;0;0;.00nan;0;0
4883;62279;514;73;27;2;25;.926;3566000;0
4883;68627;514;0;0;0;0;.00nan;0;0
4883;73973;512;0;0;0;0;.00nan;0;0
4883;86228;512;98;36;1;35;.972;3600000;0
4884;1072;1472;0;0;0;0;.00nan;0;0
4884;8223;520;0;0;0;0;.00nan;0;0
4884;64230;1472;55;20;3;17;.850;3600000;0
4884;155474;520;62;35;4;31;.886;3600000;0
4885;169323;519;0;0;0;0;.00nan;0;0
4885;22413;519;83;26;1;25;.962;3600000;0
4885;53889;1475;0;0;0;0;.00nan;0;0
4885;143191;1475;73;31;2;29;.935;3572000;0
4886;80859;511;47;27;4;23;.852;3600000;0
4886;143036;516;32;18;4;14;.778;1040000;0
4886;143301;511;0;0;0;0;.00nan;0;0
4886;159851;516;73;24;2;22;.917;2474000;0
4887;7534;1481;82;24;1;23;.958;3600000;0
4887;63107;1876;21;23;5;18;.783;3600000;0
4887;86394;1876;0;0;0;0;.00nan;0;0
4887;143083;1481;0;0;0;0;.00nan;0;0
4888;18965;515;0;0;0;0;.00nan;0;0
4888;64961;524;0;0;0;0;.00nan;0;0
4888;76951;524;76;32;2;30;.938;3600000;0
4888;91403;515;51;32;5;27;.844;3600000;0
4889;7487;518;0;0;0;0;.00nan;0;0
4889;32347;513;0;0;0;0;.00nan;0;0
4889;57993;518;55;24;4;20;.833;3863000;0
4889;63402;513;75;43;4;39;.907;3900000;0
4890;7534;1481;57;28;3;25;.893;3600000;0
4890;169323;519;66;43;4;39;.907;3546000;0
4890;22413;519;0;0;0;0;.00nan;0;0
4890;143083;1481;0;0;0;0;.00nan;0;0
4891;1072;1472;0;0;0;0;.00nan;0;0
4891;64230;1472;83;25;1;24;.960;3600000;0
4891;73973;512;0;0;0;0;.00nan;0;0
4891;86228;512;92;47;4;43;.915;3600000;0
4892;8223;520;0;0;0;0;.00nan;0;0
4892;179830;511;0;0;0;0;.00nan;0;0
4892;143301;511;64;27;2;25;.926;3900000;0
4892;155474;520;69;28;2;26;.929;3900000;0
4893;32347;513;0;0;0;0;.00nan;0;0
4893;63402;513;89;48;3;45;.938;3584000;0
4893;80859;516;85;27;1;26;.963;3600000;0
4893;143036;516;0;0;0;0;.00nan;0;0
4894;7487;518;0;0;0;0;.00nan;0;0
4894;53889;1475;0;0;0;0;.00nan;0;0
4894;57993;518;100;25;0;25;1.000;3600000;0
4894;143191;1475;80;27;1;26;.963;3600000;0
4895;18965;515;0;0;0;0;.00nan;0;0
4895;63107;1876;0;0;0;0;.00nan;0;0
4895;86394;1876;73;32;3;29;.906;3551000;0
4895;91403;515;75;28;2;26;.929;3600000;0
4896;62279;514;100;27;0;27;1.000;3600000;0
4896;64961;524;0;0;0;0;.00nan;0;0
4896;68627;514;0;0;0;0;.00nan;0;0
4896;76951;524;81;24;1;23;.958;3548000;0
4897;169323;519;0;0;0;0;.00nan;0;0
4897;22413;519;69;28;3;25;.893;3693000;0
4897;64961;524;74;46;4;42;.913;3693000;0
4897;76951;524;0;0;0;0;.00nan;0;0
4898;1072;1472;56;19;2;17;.895;3600000;0
4898;7534;1481;47;36;5;31;.861;3279000;0
4898;64230;1472;0;0;0;0;.00nan;0;0
4898;143083;1481;50;1;0;1;1.000;321000;0
4899;32347;513;0;0;0;0;.00nan;0;0
4899;179830;511;0;0;0;0;.00nan;0;0
4899;63402;513;39;45;7;38;.844;3600000;0
4899;143301;511;76;29;2;27;.931;3600000;0
4900;73973;512;0;0;0;0;.00nan;0;0
4900;80859;516;78;23;1;22;.957;3600000;0
4900;86228;512;49;24;3;21;.875;3576000;0
4900;143036;516;0;0;0;0;.00nan;0;0
4901;7487;518;0;0;0;0;.00nan;0;0
4901;8223;520;0;0;0;0;.00nan;0;0
4901;57993;518;98;39;2;37;.949;3600000;0
4901;155474;520;48;24;4;20;.833;3566000;0
4902;53889;1475;0;0;0;0;.00nan;0;0
4902;63107;1876;0;0;0;0;.00nan;0;0
4902;86394;1876;62;25;2;23;.920;3600000;0
4902;143191;1475;59;30;3;27;.900;3576000;0
4903;18965;515;0;0;0;0;.00nan;0;0
4903;62279;514;68;30;2;28;.933;3717000;0
4903;68627;514;0;0;0;0;.00nan;0;0
4903;91403;515;69;32;3;29;.906;3717000;0
4904;1072;1472;0;0;0;0;.00nan;0;0
4904;64230;1472;74;27;2;25;.926;3600000;0
4904;73973;512;0;0;0;0;.00nan;0;0
4904;86228;512;77;44;5;39;.886;3600000;0
4905;8223;520;0;0;0;0;.00nan;0;0
4905;179830;511;0;0;0;0;.00nan;0;0
4905;143301;511;69;31;3;28;.903;3600000;0
4905;155474;520;95;51;4;47;.922;3574000;0
4906;7487;518;0;0;0;0;.00nan;0;0
4906;53889;1475;100;41;1;40;.976;3900000;0
4906;57993;518;71;22;1;21;.955;3900000;0
4906;143191;1475;0;0;0;0;.00nan;0;0
4907;18965;515;0;0;0;0;.00nan;0;0
4907;63107;1876;0;0;0;0;.00nan;0;0
4907;86394;1876;61;28;3;25;.893;3600000;0
4907;91403;515;99;37;1;36;.973;3600000;0
4908;7534;1481;0;0;0;0;.00nan;0;0
4908;169323;519;100;37;1;36;.973;3900000;0
4908;22413;519;0;0;0;0;.00nan;0;0
4908;143083;1481;83;28;1;27;.964;3900000;0
4909;32347;513;64;28;3;25;.893;3600000;0
4909;63402;513;0;0;0;0;.00nan;0;0
4909;80859;516;100;47;2;45;.957;3600000;0
4909;143036;516;0;0;0;0;.00nan;0;0
4910;62279;514;88;32;2;30;.938;3900000;0
4910;64961;524;0;0;0;0;.00nan;0;0
4910;68627;514;0;0;0;0;.00nan;0;0
4910;76951;524;74;24;2;22;.917;3900000;0
4911;18965;515;0;0;0;0;.00nan;0;0
4911;169323;519;99;41;1;40;.976;3600000;0
4911;22413;519;0;0;0;0;.00nan;0;0
4911;91403;515;79;27;2;25;.926;3545000;0
4912;1072;1472;0;0;0;0;.00nan;0;0
4912;64230;1472;86;24;1;23;.958;3600000;0
4912;64961;524;0;0;0;0;.00nan;0;0
4912;76951;524;65;37;3;34;.919;3583000;0
4913;179830;511;0;0;0;0;.00nan;0;0
4913;57993;512;37;32;6;26;.813;2533000;0
4913;86228;512;58;17;1;16;.941;1067000;0
4913;143301;511;61;17;1;16;.941;3600000;0
4914;53889;1475;0;0;0;0;.00nan;0;0
4914;80859;516;71;24;2;22;.917;3600000;0
4914;143036;516;0;0;0;0;.00nan;0;0
4914;143191;1475;72;33;3;30;.909;3556000;0
4915;7534;1481;50;37;6;31;.838;3600000;0
4915;36496;518;0;0;0;0;.00nan;0;0
4915;143083;1481;0;0;0;0;.00nan;0;0
4915;143330;518;76;30;2;28;.933;3600000;0
4916;62279;514;68;35;4;31;.886;3657000;0
4916;63107;1876;0;0;0;0;.00nan;0;0
4916;68627;514;0;0;0;0;.00nan;0;0
4916;86394;1876;52;24;3;21;.875;3657000;0
4917;8223;520;0;0;0;0;.00nan;0;0
4917;32347;513;0;0;0;0;.00nan;0;0
4917;63402;513;84;27;1;26;.963;3600000;0
4917;155474;520;39;30;5;25;.833;3600000;0
4918;8223;520;0;0;0;0;.00nan;0;0
4918;57993;512;0;0;0;0;.00nan;0;0
4918;86228;512;43;23;4;19;.826;3600000;0
4918;155474;520;84;19;0;19;1.000;3600000;0
4919;32347;513;0;0;0;0;.00nan;0;0
4919;53889;1475;0;0;0;0;.00nan;0;0
4919;63402;513;37;19;4;15;.789;3600000;0
4919;143191;1475;97;29;0;29;1.000;3600000;0
4920;18965;515;58;29;3;26;.897;3564000;0
4920;36496;518;0;0;0;0;.00nan;0;0
4920;91403;515;0;0;0;0;.00nan;0;0
4920;143330;518;79;33;2;31;.939;3600000;0
4921;7534;1481;67;38;4;34;.895;3528000;0
4921;80859;516;78;27;2;25;.926;3600000;0
4921;143036;516;0;0;0;0;.00nan;0;0
4921;143083;1481;0;0;0;0;.00nan;0;0
4922;169323;519;95;25;0;25;1.000;3600000;0
4922;22413;519;0;0;0;0;.00nan;0;0
4922;63107;1876;0;0;0;0;.00nan;0;0
4922;86394;1876;75;37;3;34;.919;3600000;0
4923;179830;511;0;0;0;0;.00nan;0;0
4923;64961;524;54;12;1;11;.917;1391000;0
4923;76951;524;37;30;5;25;.833;2209000;0
4923;143301;511;100;32;0;32;1.000;3600000;0
4924;1072;1472;0;0;0;0;.00nan;0;0
4924;62279;514;86;39;2;37;.949;3558000;0
4924;64230;1472;89;29;1;28;.966;3600000;0
4924;68627;514;0;0;0;0;.00nan;0;0
4925;7534;1481;36;34;6;28;.824;3082000;0
4925;8223;520;0;0;0;0;.00nan;0;0
4925;143083;1481;51;3;0;3;1.000;518000;0
4925;155474;520;90;18;0;18;1.000;3600000;0
4926;169323;519;77;27;2;25;.926;3600000;0
4926;22413;519;0;0;0;0;.00nan;0;0
4926;62279;514;66;33;4;29;.879;3585000;0
4926;68627;514;0;0;0;0;.00nan;0;0
4927;1072;1472;65;24;2;22;.917;3600000;0
4927;18965;515;0;0;0;0;.00nan;0;0
4927;64230;1472;0;0;0;0;.00nan;0;0
4927;91403;515;62;35;4;31;.886;3562000;0
4928;179830;511;0;0;0;0;.00nan;0;0
4928;53889;1475;0;0;0;0;.00nan;0;0
4928;143191;1475;73;42;5;37;.881;3600000;0
4928;143301;511;45;12;2;10;.833;3600000;0
4929;63107;1876;0;0;0;0;.00nan;0;0
4929;80859;516;79;38;3;35;.921;3600000;0
4929;86394;1876;78;36;4;32;.889;3545000;0
4929;143036;516;0;0;0;0;.00nan;0;0
4930;36496;518;0;0;0;0;.00nan;0;0
4930;64961;524;100;40;1;39;.975;3600000;0
4930;76951;524;0;0;0;0;.00nan;0;0
4930;143330;518;79;36;3;33;.917;3527000;0
4931;32347;513;0;0;0;0;.00nan;0;0
4931;57993;512;99;38;1;37;.974;3600000;0
4931;63402;513;70;28;2;26;.929;3569000;0
4931;86228;512;0;0;0;0;.00nan;0;0
4932;53889;1475;0;0;0;0;.00nan;0;0
4932;57993;512;61;30;4;26;.867;3600000;0
4932;86228;512;0;0;0;0;.00nan;0;0
4932;143191;1475;25;36;7;29;.806;3600000;0
4933;1072;1472;0;0;0;0;.00nan;0;0
4933;169323;519;69;49;5;44;.898;3600000;0
4933;22413;519;0;0;0;0;.00nan;0;0
4933;64230;1472;55;18;2;16;.889;3600000;0
4934;18965;515;0;0;0;0;.00nan;0;0
4934;80859;516;61;27;3;24;.889;3600000;0
4934;91403;515;100;24;0;24;1.000;3600000;0
4934;143036;516;0;0;0;0;.00nan;0;0
4935;7534;1481;83;40;3;37;.925;3610000;0
4935;32347;513;0;0;0;0;.00nan;0;0
4935;63402;513;38;17;4;13;.765;3610000;0
4935;143083;1481;0;0;0;0;.00nan;0;0
4936;36496;518;0;0;0;0;.00nan;0;0
4936;63107;1876;59;20;2;18;.900;1424000;0
4936;86394;1876;33;38;7;31;.816;2176000;0
4936;143330;518;45;21;4;17;.810;3600000;0
4937;8223;520;0;0;0;0;.00nan;0;0
4937;64961;524;49;32;5;27;.844;3600000;0
4937;76951;524;0;0;0;0;.00nan;0;0
4937;155474;520;84;33;1;32;.970;3600000;0
4938;179830;511;0;0;0;0;.00nan;0;0
4938;62279;514;79;31;2;29;.935;3600000;0
4938;68627;514;0;0;0;0;.00nan;0;0
4938;143301;511;33;25;5;20;.800;3600000;0
4939;7534;1481;99;39;3;36;.923;3900000;0
4939;57993;512;50;25;3;22;.880;3900000;0
4939;86228;512;0;0;0;0;.00nan;0;0
4939;143083;1481;0;0;0;0;.00nan;0;0
4940;8223;520;93;33;1;32;.970;3600000;0
4940;53889;1475;0;0;0;0;.00nan;0;0
4940;143191;1475;89;47;2;45;.957;3593000;0
4940;155474;520;0;0;0;0;.00nan;0;0
4941;1072;1472;0;0;0;0;.00nan;0;0
4941;63107;1876;74;28;2;26;.929;3065000;0
4941;64230;1472;74;23;1;22;.957;3600000;0
4941;86394;1876;28;6;3;3;.500;535000;0
4942;18965;515;0;0;0;0;.00nan;0;0
4942;179830;511;85;27;1;26;.963;3600000;0
4942;91403;515;82;43;3;40;.930;3569000;0
4942;143301;511;0;0;0;0;.00nan;0;0
4943;64961;524;45;36;6;30;.833;2952000;0
4943;76951;524;43;3;1;2;.667;648000;0
4943;80859;516;89;20;0;20;1.000;3600000;0
4943;143036;516;0;0;0;0;.00nan;0;0
4944;36496;518;0;0;0;0;.00nan;0;0
4944;62279;514;92;30;1;29;.967;3600000;0
4944;68627;514;0;0;0;0;.00nan;0;0
4944;143330;518;73;34;3;31;.912;3516000;0
4945;169323;519;100;34;0;34;1.000;3600000;0
4945;22413;519;0;0;0;0;.00nan;0;0
4945;32347;513;0;0;0;0;.00nan;0;0
4945;63402;513;62;23;2;21;.913;3519000;0
4946;57993;512;0;0;0;0;.00nan;0;0
4946;64961;524;56;18;2;16;.889;3543000;0
4946;76951;524;0;0;0;0;.00nan;0;0
4946;86228;512;89;32;1;31;.969;3600000;0
4947;8223;520;0;0;0;0;.00nan;0;0
4947;62279;514;35;34;6;28;.824;3600000;0
4947;68627;514;0;0;0;0;.00nan;0;0
4947;155474;520;55;22;3;19;.864;3600000;0
4948;18965;515;0;0;0;0;.00nan;0;0
4948;53889;1475;79;33;2;31;.939;3600000;0
4948;91403;515;77;32;3;29;.906;3590000;0
4948;143191;1475;0;0;0;0;.00nan;0;0
4949;7534;1481;85;42;4;38;.905;3600000;0
4949;179830;511;0;0;0;0;.00nan;0;0
4949;143083;1481;0;0;0;0;.00nan;0;0
4949;143301;511;100;27;0;27;1.000;3600000;0
4950;1072;1472;0;0;0;0;.00nan;0;0
4950;64230;1472;68;29;3;26;.897;3578000;0
4950;80859;516;94;38;2;36;.947;3600000;0
4950;143036;516;0;0;0;0;.00nan;0;0
4951;169323;519;24;28;6;22;.786;3600000;0
4951;22413;519;0;0;0;0;.00nan;0;0
4951;36496;518;0;0;0;0;.00nan;0;0
4951;143330;518;86;45;4;41;.911;3600000;0
4952;32347;513;0;0;0;0;.00nan;0;0
4952;63107;1876;0;0;0;0;.00nan;0;0
4952;63402;513;72;28;3;25;.893;3600000;0
4952;86394;1876;51;27;4;23;.852;3545000;0
4953;8223;520;0;0;0;0;.00nan;0;0
4953;169323;519;89;43;3;40;.930;3600000;0
4953;22413;519;0;0;0;0;.00nan;0;0
4953;155474;520;81;30;1;29;.967;3600000;0
4954;1072;1472;0;0;0;0;.00nan;0;0
4954;36496;518;0;0;0;0;.00nan;0;0
4954;64230;1472;67;32;3;29;.906;3900000;0
4954;143330;518;65;28;3;25;.893;3900000;0
4955;18965;515;0;0;0;0;.00nan;0;0
4955;57993;512;98;49;3;46;.939;3900000;0
4955;86228;512;0;0;0;0;.00nan;0;0
4955;91403;515;47;22;3;19;.864;3900000;0
4956;7534;1481;45;16;3;13;.813;3600000;0
4956;53889;1475;0;0;0;0;.00nan;0;0
4956;143083;1481;0;0;0;0;.00nan;0;0
4956;143191;1475;63;33;4;29;.879;3600000;0
4957;179830;511;0;0;0;0;.00nan;0;0
4957;63107;1876;0;0;0;0;.00nan;0;0
4957;86394;1876;59;37;4;33;.892;3600000;0
4957;143301;511;61;11;1;10;.909;3600000;0
4958;32347;513;0;0;0;0;.00nan;0;0
4958;63402;513;72;31;3;28;.903;3600000;0
4958;64961;524;0;0;0;0;.00nan;0;0
4958;76951;524;70;25;2;23;.920;3600000;0
4959;62279;514;73;35;4;31;.886;3535000;0
4959;68627;514;0;0;0;0;.00nan;0;0
4959;80859;516;78;26;2;24;.923;3600000;0
4959;143036;516;0;0;0;0;.00nan;0;0
4960;57993;512;0;0;0;0;.00nan;0;0
4960;63107;1876;0;0;0;0;.00nan;0;0
4960;86228;512;76;26;1;25;.962;3600000;0
4960;86394;1876;73;38;3;35;.921;3600000;0
4961;8223;520;0;0;0;0;.00nan;0;0
4961;18965;515;0;0;0;0;.00nan;0;0
4961;91403;515;92;33;1;32;.970;3600000;0
4961;155474;520;79;38;2;36;.947;3544000;0
4962;53889;1475;0;0;0;0;.00nan;0;0
4962;62279;514;87;28;1;27;.964;3600000;0
4962;68627;514;0;0;0;0;.00nan;0;0
4962;143191;1475;53;40;6;34;.850;3600000;0
4963;169323;519;21;10;4;6;.600;999000;0
4963;22413;519;67;25;2;23;.920;2601000;0
4963;179830;511;0;0;0;0;.00nan;0;0
4963;143301;511;91;25;0;25;1.000;3600000;0
4964;36496;518;0;0;0;0;.00nan;0;0
4964;80859;516;89;34;2;32;.941;3900000;0
4964;143036;516;0;0;0;0;.00nan;0;0
4964;143330;518;100;48;2;46;.958;3900000;0
4965;7534;1481;80;47;4;43;.915;3572000;0
4965;64961;524;52;14;2;12;.857;3600000;0
4965;76951;524;0;0;0;0;.00nan;0;0
4965;143083;1481;0;0;0;0;.00nan;0;0
4966;1072;1472;64;29;3;26;.897;3828000;0
4966;32347;513;80;53;4;49;.925;3828000;0
4966;63402;513;0;0;0;0;.00nan;0;0
4966;64230;1472;0;0;0;0;.00nan;0;0
4967;169323;519;74;30;2;28;.933;3593000;0
4967;22413;519;0;0;0;0;.00nan;0;0
4967;80859;516;100;26;0;26;1.000;3600000;0
4967;143036;516;0;0;0;0;.00nan;0;0
4968;1072;1472;0;0;0;0;.00nan;0;0
4968;179830;511;0;0;0;0;.00nan;0;0
4968;64230;1472;100;39;0;39;1.000;3600000;0
4968;143301;511;85;31;1;30;.968;3600000;0
4969;36496;518;0;0;0;0;.00nan;0;0
4969;57993;512;0;0;0;0;.00nan;0;0
4969;86228;512;70;42;3;39;.929;3900000;0
4969;143330;518;55;24;3;21;.875;3900000;0
4970;7534;1481;46;26;4;22;.846;3600000;0
4970;18965;515;0;0;0;0;.00nan;0;0
4970;91403;515;71;19;1;18;.947;3600000;0
4970;143083;1481;0;0;0;0;.00nan;0;0
4971;8223;520;0;0;0;0;.00nan;0;0
4971;63107;1876;0;0;0;0;.00nan;0;0
4971;86394;1876;92;42;2;40;.952;3900000;0
4971;155474;520;61;25;2;23;.920;3900000;0
4972;53889;1475;0;0;0;0;.00nan;0;0
4972;64961;524;22;23;6;17;.739;3600000;0
4972;76951;524;0;0;0;0;.00nan;0;0
4972;143191;1475;98;54;3;51;.944;3600000;0
4973;32347;513;44;35;5;30;.857;3600000;0
4973;62279;514;90;35;2;33;.943;3600000;0
4973;63402;513;0;0;0;0;.00nan;0;0
4973;68627;514;0;0;0;0;.00nan;0;0
4974;169323;519;89;38;2;36;.947;3900000;0
4974;22413;519;0;0;0;0;.00nan;0;0
4974;57993;512;67;24;2;22;.917;3900000;0
4974;86228;512;0;0;0;0;.00nan;0;0
4975;8223;520;0;0;0;0;.00nan;0;0
4975;64961;516;0;0;0;0;.00nan;0;0
4975;80859;516;81;39;3;36;.923;3600000;0
4975;155474;520;39;34;6;28;.824;3600000;0
4976;1072;1472;0;0;0;0;.00nan;0;0
4976;53889;1475;81;39;2;37;.949;2485000;0
4976;64230;1472;61;13;1;12;.923;3600000;0
4976;143191;1475;27;16;4;12;.750;1115000;0
4977;179830;511;0;0;0;0;.00nan;0;0
4977;36496;518;0;0;0;0;.00nan;0;0
4977;143301;511;80;29;1;28;.966;3600000;0
4977;143330;518;98;45;2;43;.956;3575000;0
4978;7534;1481;0;0;0;0;.00nan;0;0
4978;62279;514;83;26;1;25;.962;3600000;0
4978;63107;514;0;0;0;0;.00nan;0;0
4978;143083;1481;89;53;3;50;.943;3542000;0
4979;4618;1876;0;0;0;0;.00nan;0;0
4979;6948;524;0;0;0;0;.00nan;0;0
4979;76951;524;57;32;4;28;.875;3600000;0
4979;86394;1876;91;31;1;30;.968;3600000;0
4980;18965;515;0;0;0;0;.00nan;0;0
4980;32347;513;73;23;1;22;.957;2914000;0
4980;63402;513;20;11;4;7;.636;686000;0
4980;91403;515;83;28;2;26;.929;3600000;0
4981;169323;519;76;29;2;27;.931;3600000;0
4981;22413;519;0;0;0;0;.00nan;0;0
4981;53889;1475;71;38;4;34;.895;3522000;0
4981;143191;1475;0;0;0;0;.00nan;0;0
4982;1072;1472;0;0;0;0;.00nan;0;0
4982;8223;520;0;0;0;0;.00nan;0;0
4982;64230;1472;63;31;3;28;.903;3534000;0
4982;155474;520;90;36;2;34;.944;3600000;0
4983;179830;511;0;0;0;0;.00nan;0;0
4983;64961;516;0;0;0;0;.00nan;0;0
4983;80859;516;100;36;0;36;1.000;3600000;0
4983;143301;511;80;33;2;31;.939;3598000;0
4984;32347;513;59;43;5;38;.884;3600000;0
4984;36496;518;79;30;2;28;.933;3600000;0
4984;63402;513;0;0;0;0;.00nan;0;0
4984;143330;518;0;0;0;0;.00nan;0;0
4985;6948;524;0;0;0;0;.00nan;0;0
4985;18965;515;0;0;0;0;.00nan;0;0
4985;76951;524;63;29;2;27;.931;3841000;0
4985;91403;515;65;26;3;23;.885;3841000;0
4986;4618;1876;0;0;0;0;.00nan;0;0
4986;7534;1481;64;36;4;32;.889;3600000;0
4986;86394;1876;47;18;3;15;.833;3600000;0
4986;143083;1481;0;0;0;0;.00nan;0;0
4987;57993;512;87;19;0;19;1.000;3600000;0
4987;62279;514;0;0;0;0;.00nan;0;0
4987;63107;514;59;37;4;33;.892;3600000;0
4987;86228;512;0;0;0;0;.00nan;0;0
4988;57993;512;84;28;1;27;.964;3706000;0
4988;64961;516;0;0;0;0;.00nan;0;0
4988;80859;516;72;29;2;27;.931;3706000;0
4988;86228;512;0;0;0;0;.00nan;0;0
4989;8223;520;90;29;1;28;.966;3600000;0
4989;36496;518;0;0;0;0;.00nan;0;0
4989;143330;518;87;31;2;29;.935;3600000;0
4989;155474;520;0;0;0;0;.00nan;0;0
4990;4618;1876;0;0;0;0;.00nan;0;0
4990;53889;1475;0;0;0;0;.00nan;0;0
4990;86394;1876;32;19;5;14;.737;3600000;0
4990;143191;1475;78;27;2;25;.926;3600000;0
4991;18965;515;0;0;0;0;.00nan;0;0
4991;62279;514;0;0;0;0;.00nan;0;0
4991;63107;514;68;25;2;23;.920;3600000;0
4991;91403;515;73;47;5;42;.894;3600000;0
4992;1072;1472;0;0;0;0;.00nan;0;0
4992;7534;1481;81;49;4;45;.918;3600000;0
4992;64230;1472;68;20;1;19;.950;3600000;0
4992;143083;1481;0;0;0;0;.00nan;0;0
4993;6948;524;77;39;3;36;.923;3900000;0
4993;169323;519;69;30;3;27;.900;3900000;0
4993;22413;519;0;0;0;0;.00nan;0;0
4993;76951;524;0;0;0;0;.00nan;0;0
4994;32347;513;0;0;0;0;.00nan;0;0
4994;179830;511;0;0;0;0;.00nan;0;0
4994;63402;513;95;42;2;40;.952;3900000;0
4994;143301;511;69;20;2;18;.900;3900000;0
4995;179830;511;0;0;0;0;.00nan;0;0
4995;57993;512;73;35;3;32;.914;3600000;0
4995;86228;512;0;0;0;0;.00nan;0;0
4995;143301;511;53;30;4;26;.867;3556000;0
4996;8223;520;0;0;0;0;.00nan;0;0
4996;16587;513;0;0;0;0;.00nan;0;0
4996;32347;513;67;35;3;32;.914;3600000;0
4996;155474;520;100;39;0;39;1.000;3600000;0
4997;53889;1475;0;0;0;0;.00nan;0;0
4997;64961;516;0;0;0;0;.00nan;0;0
4997;80859;516;70;26;3;23;.885;3600000;0
4997;143191;1475;67;36;5;31;.861;3545000;0
4998;18965;515;0;0;0;0;.00nan;0;0
4998;169323;519;95;23;0;23;1.000;3600000;0
4998;22413;519;0;0;0;0;.00nan;0;0
4998;91403;515;67;30;3;27;.900;3600000;0
4999;7534;1481;71;51;5;46;.902;3600000;0
4999;36496;518;0;0;0;0;.00nan;0;0
4999;143083;1481;0;0;0;0;.00nan;0;0
4999;143330;518;66;22;2;20;.909;3600000;0
5000;6948;524;0;0;0;0;.00nan;0;0
5000;63402;1472;70;36;3;33;.917;3600000;0
5000;64230;1472;0;0;0;0;.00nan;0;0
5000;76951;524;59;18;2;16;.889;3600000;0
5001;4618;1876;0;0;0;0;.00nan;0;0
5001;62279;514;0;0;0;0;.00nan;0;0
5001;63107;514;66;35;3;32;.914;3900000;0
5001;86394;1876;72;27;3;24;.889;3900000;0
5002;8223;520;0;0;0;0;.00nan;0;0
5002;57993;512;45;37;6;31;.838;3600000;0
5002;86228;512;0;0;0;0;.00nan;0;0
5002;155474;520;86;41;3;38;.927;3600000;0
5003;4618;1876;0;0;0;0;.00nan;0;0
5003;169323;519;71;21;1;20;.952;3600000;0
5003;22413;519;0;0;0;0;.00nan;0;0
5003;86394;1876;57;34;4;30;.882;3600000;0
5004;62279;514;0;0;0;0;.00nan;0;0
5004;63107;514;92;47;2;45;.957;3600000;0
5004;63402;1472;42;25;5;20;.800;3600000;0
5004;64230;1472;0;0;0;0;.00nan;0;0
5005;6948;524;0;0;0;0;.00nan;0;0
5005;179830;511;0;0;0;0;.00nan;0;0
5005;76951;524;79;24;1;23;.958;3563000;0
5005;143301;511;100;26;0;26;1.000;3600000;0
5006;7534;1481;100;41;0;41;1.000;3900000;0
5006;64961;516;0;0;0;0;.00nan;0;0
5006;80859;516;87;23;0;23;1.000;3900000;0
5006;143083;1481;0;0;0;0;.00nan;0;0
5007;18965;515;0;0;0;0;.00nan;0;0
5007;36496;518;0;0;0;0;.00nan;0;0
5007;91403;515;100;35;1;34;.971;3600000;0
5007;143330;518;68;33;3;30;.909;3518000;0
5008;16587;513;0;0;0;0;.00nan;0;0
5008;32347;513;79;22;1;21;.955;3600000;0
5008;53889;1475;0;0;0;0;.00nan;0;0
5008;143191;1475;47;49;7;42;.857;3600000;0
5009;16587;513;0;0;0;0;.00nan;0;0
5009;32347;513;92;37;2;35;.946;3600000;0
5009;57993;512;67;29;3;26;.897;3585000;0
5009;86228;512;0;0;0;0;.00nan;0;0
5010;179830;511;0;0;0;0;.00nan;0;0
5010;53889;1475;0;0;0;0;.00nan;0;0
5010;143191;1475;70;30;3;27;.900;3540000;0
5010;143301;511;89;31;2;29;.935;3600000;0
5011;18965;515;0;0;0;0;.00nan;0;0
5011;63402;1472;72;27;2;25;.926;3600000;0
5011;64230;1472;0;0;0;0;.00nan;0;0
5011;91403;515;62;28;3;25;.893;3570000;0
5012;7534;1481;100;47;2;45;.957;3600000;0
5012;8223;520;0;0;0;0;.00nan;0;0
5012;143083;1481;0;0;0;0;.00nan;0;0
5012;155474;520;39;22;5;17;.773;3600000;0
5013;4618;1876;70;37;3;34;.919;3900000;0
5013;64961;516;0;0;0;0;.00nan;0;0
5013;80859;516;68;33;3;30;.909;3900000;0
5013;86394;1876;0;0;0;0;.00nan;0;0
5014;6948;524;92;40;1;39;.975;3575000;0
5014;36496;518;0;0;0;0;.00nan;0;0
5014;76951;524;0;0;0;0;.00nan;0;0
5014;143330;518;100;32;0;32;1.000;3600000;0
5015;169323;519;61;33;3;30;.909;3600000;0
5015;22413;519;0;0;0;0;.00nan;0;0
5015;62279;514;0;0;0;0;.00nan;0;0
5015;63107;514;63;33;4;29;.879;3557000;0
5016;53889;1475;0;0;0;0;.00nan;0;0
5016;57993;512;75;25;2;23;.920;3900000;0
5016;86228;512;0;0;0;0;.00nan;0;0
5016;143191;1475;91;42;2;40;.952;3900000;0
5017;6948;524;0;0;0;0;.00nan;0;0
5017;8223;520;0;0;0;0;.00nan;0;0
5017;76951;524;52;29;3;26;.897;3600000;0
5017;155474;520;62;36;5;31;.861;3513000;0
5018;169323;519;70;38;4;34;.895;3600000;0
5018;22413;519;0;0;0;0;.00nan;0;0
5018;63402;1472;83;23;1;22;.957;3600000;0
5018;64230;1472;0;0;0;0;.00nan;0;0
5019;179830;511;0;0;0;0;.00nan;0;0
5019;62279;514;0;0;0;0;.00nan;0;0
5019;63107;514;85;39;3;36;.923;3580000;0
5019;143301;511;58;20;2;18;.900;3600000;0
5020;18965;515;90;38;2;36;.947;2962000;0
5020;64961;516;48;28;4;24;.857;3600000;0
5020;80859;516;0;0;0;0;.00nan;0;0
5020;91403;515;37;10;3;7;.700;580000;0
5021;4618;1876;0;0;0;0;.00nan;0;0
5021;36496;518;0;0;0;0;.00nan;0;0
5021;86394;1876;72;32;3;29;.906;3600000;0
5021;143330;518;48;32;5;27;.844;3580000;0
5022;7534;1481;99;46;1;45;.978;3600000;0
5022;16587;513;0;0;0;0;.00nan;0;0
5022;32347;513;71;28;2;26;.929;3570000;0
5022;143083;1481;0;0;0;0;.00nan;0;0
5023;8223;520;0;0;0;0;.00nan;0;0
5023;53889;1475;100;24;0;24;1.000;3600000;0
5023;143191;1475;0;0;0;0;.00nan;0;0
5023;155474;520;39;20;4;16;.800;3600000;0
5024;16587;513;0;0;0;0;.00nan;0;0
5024;169323;519;90;32;1;31;.969;3600000;0
5024;22413;519;0;0;0;0;.00nan;0;0
5024;32347;513;88;48;3;45;.938;3542000;0
5025;18965;515;60;29;4;25;.862;3563000;0
5025;179830;511;0;0;0;0;.00nan;0;0
5025;91403;515;0;0;0;0;.00nan;0;0
5025;143301;511;77;26;2;24;.923;3600000;0
5026;7534;1481;93;46;3;43;.935;3600000;0
5026;57993;512;66;25;2;23;.920;3600000;0
5026;86228;512;0;0;0;0;.00nan;0;0
5026;143083;1481;0;0;0;0;.00nan;0;0
5027;4618;1876;0;0;0;0;.00nan;0;0
5027;63402;1472;100;26;0;26;1.000;3600000;0
5027;64230;1472;0;0;0;0;.00nan;0;0
5027;86394;1876;71;29;2;27;.931;3550000;0
5028;6948;524;0;0;0;0;.00nan;0;0
5028;64961;516;0;0;0;0;.00nan;0;0
5028;76951;524;53;21;3;18;.857;3579000;0
5028;80859;516;88;29;1;28;.966;3600000;0
5029;36496;518;0;0;0;0;.00nan;0;0
5029;62279;514;0;0;0;0;.00nan;0;0
5029;63107;514;83;41;3;38;.927;3879000;0
5029;143330;518;76;29;2;27;.931;3879000;0
5031;8223;520;66;21;2;19;.905;3600000;0
5031;53889;1475;0;0;0;0;.00nan;0;0
5031;143301;1475;61;30;4;26;.867;3538000;0
5031;155474;520;0;0;0;0;.00nan;0;0
5033;177504;515;0;0;0;0;.00nan;0;0
5033;63107;1876;0;0;0;0;.00nan;0;0
5033;68565;515;78;40;4;36;.900;3547000;0
5033;86394;1876;75;35;3;32;.914;3600000;0
5035;1072;1472;0;0;0;0;.00nan;0;0
5035;7487;518;0;0;0;0;.00nan;0;0
5035;57993;518;76;37;3;34;.919;3543000;0
5035;64230;1472;75;31;2;29;.935;3600000;0
5037;16587;513;0;0;0;0;.00nan;0;0
5037;62279;514;81;23;1;22;.957;3600000;0
5037;63402;513;84;39;3;36;.923;3585000;0
5037;68627;514;0;0;0;0;.00nan;0;0
5039;4618;519;80;15;0;15;1.000;3600000;0
5039;22413;519;0;0;0;0;.00nan;0;0
5039;64961;524;0;0;0;0;.00nan;0;0
5039;76951;524;51;35;5;30;.857;3600000;0
5041;7534;1481;50;34;4;30;.882;3900000;0
5041;32347;1481;0;0;0;0;.00nan;0;0
5041;80859;511;0;0;0;0;.00nan;0;0
5041;88646;511;52;25;4;21;.840;3900000;0
5043;86228;512;100;36;0;36;1.000;3600000;0
5043;142911;512;0;0;0;0;.00nan;0;0
5043;143036;516;55;17;2;15;.882;3524000;0
5043;159851;516;0;0;0;0;.00nan;0;0
5045;62279;514;63;24;2;22;.917;3578000;0
5045;64961;524;75;25;1;24;.960;3600000;0
5045;68627;514;0;0;0;0;.00nan;0;0
5045;76951;524;0;0;0;0;.00nan;0;0
5047;7534;1481;0;0;0;0;.00nan;0;0
5047;8223;520;0;0;0;0;.00nan;0;0
5047;32347;1481;52;30;4;26;.867;3867000;0
5047;155474;520;69;31;3;28;.903;3867000;0
5049;4618;519;66;34;4;30;.882;3757000;0
5049;22413;519;0;0;0;0;.00nan;0;0
5049;86228;512;64;29;3;26;.897;3757000;0
5049;142911;512;0;0;0;0;.00nan;0;0
5051;1072;1472;0;0;0;0;.00nan;0;0
5051;177504;515;0;0;0;0;.00nan;0;0
5051;64230;1472;49;31;4;27;.871;3600000;0
5051;68565;515;100;30;0;30;1.000;3600000;0
5053;16587;513;0;0;0;0;.00nan;0;0
5053;63402;513;76;30;3;27;.900;3900000;0
5053;80859;511;0;0;0;0;.00nan;0;0
5053;88646;511;49;23;3;20;.870;3900000;0
5055;7487;518;0;0;0;0;.00nan;0;0
5055;57993;518;42;24;4;20;.833;3593000;0
5055;63107;1876;0;0;0;0;.00nan;0;0
5055;86394;1876;94;37;2;35;.946;3600000;0
5057;53889;1475;0;0;0;0;.00nan;0;0
5057;143036;516;60;27;4;23;.852;3600000;0
5057;143301;1475;84;32;2;30;.938;3600000;0
5057;159851;516;0;0;0;0;.00nan;0;0
5059;7487;518;52;26;3;23;.885;3600000;0
5059;7534;1481;40;34;5;29;.853;3564000;0
5059;32347;1481;0;0;0;0;.00nan;0;0
5059;57993;518;0;0;0;0;.00nan;0;0
5061;1072;1472;67;23;2;21;.913;3600000;0
5061;62279;514;0;0;0;0;.00nan;0;0
5061;64230;1472;0;0;0;0;.00nan;0;0
5061;68627;514;87;41;3;38;.927;3590000;0
5063;86228;512;55;9;1;8;.889;720000;0
5063;142911;512;8;16;6;10;.625;2880000;0
5063;143036;516;0;0;0;0;.00nan;0;0
5063;159851;516;73;22;2;20;.909;3600000;0
5065;53889;1475;54;33;4;29;.879;3600000;0
5065;80859;511;54;12;1;11;.917;3600000;0
5065;88646;511;0;0;0;0;.00nan;0;0
5065;143301;1475;0;0;0;0;.00nan;0;0
5067;4618;519;0;0;0;0;.00nan;0;0
5067;8223;520;64;13;1;12;.923;3600000;0
5067;22413;519;94;37;2;35;.946;3586000;0
5067;155474;520;0;0;0;0;.00nan;0;0
5069;177504;515;0;0;0;0;.00nan;0;0
5069;16587;513;96;45;3;42;.933;3566000;0
5069;63402;513;0;0;0;0;.00nan;0;0
5069;68565;515;65;22;2;20;.909;3600000;0
5071;63107;1876;91;34;1;33;.971;3600000;0
5071;64961;524;0;0;0;0;.00nan;0;0
5071;76951;524;72;28;2;26;.929;3577000;0
5071;86394;1876;0;0;0;0;.00nan;0;0
5073;62279;514;82;23;1;22;.957;3657000;0
5073;64961;524;92;40;2;38;.950;3657000;0
5073;68627;514;0;0;0;0;.00nan;0;0
5073;76951;524;0;0;0;0;.00nan;0;0
5075;8223;520;0;0;0;0;.00nan;0;0
5075;53889;1475;0;0;0;0;.00nan;0;0
5075;143301;1475;59;31;3;28;.903;3600000;0
5075;155474;520;78;23;1;22;.957;3600000;0
5077;177504;515;0;0;0;0;.00nan;0;0
5077;68565;515;52;28;4;24;.857;3534000;0
5077;86228;512;80;36;2;34;.944;3600000;0
5077;142911;512;0;0;0;0;.00nan;0;0
5079;7487;518;0;0;0;0;.00nan;0;0
5079;16587;513;0;0;0;0;.00nan;0;0
5079;57993;518;57;28;3;25;.893;3600000;0
5079;63402;513;58;33;4;29;.879;3550000;0
5081;7534;1481;0;0;0;0;.00nan;0;0
5081;32347;1481;73;23;1;22;.957;3600000;0
5081;63107;1876;0;0;0;0;.00nan;0;0
5081;86394;1876;59;25;3;22;.880;3524000;0
5083;80859;511;33;20;4;16;.800;3600000;0
5083;88646;511;0;0;0;0;.00nan;0;0
5083;143036;516;60;26;3;23;.885;3600000;0
5083;159851;516;0;0;0;0;.00nan;0;0
5085;1072;1472;0;0;0;0;.00nan;0;0
5085;4618;519;84;21;0;21;1.000;3600000;0
5085;22413;519;0;0;0;0;.00nan;0;0
5085;64230;1472;66;27;2;25;.926;3520000;0
5087;4618;519;0;0;0;0;.00nan;0;0
5087;7534;1481;56;29;4;25;.862;3594000;0
5087;22413;519;55;21;3;18;.857;3600000;0
5087;32347;1481;0;0;0;0;.00nan;0;0
5089;1072;1472;85;35;2;33;.943;3600000;0
5089;8223;520;30;15;4;11;.733;1109000;0
5089;64230;1472;0;0;0;0;.00nan;0;0
5089;155474;520;54;17;2;15;.882;2491000;0
5091;16587;513;100;29;0;29;1.000;3600000;0
5091;53889;1475;62;24;2;22;.917;3557000;0
5091;63402;513;0;0;0;0;.00nan;0;0
5091;143301;1475;0;0;0;0;.00nan;0;0
5093;7487;518;76;28;2;26;.929;3600000;0
5093;57993;518;0;0;0;0;.00nan;0;0
5093;80859;511;0;0;0;0;.00nan;0;0
5093;88646;511;57;31;4;27;.871;3592000;0
5095;63107;1876;76;36;3;33;.917;3525000;0
5095;86228;512;0;0;0;0;.00nan;0;0
5095;86394;1876;0;0;0;0;.00nan;0;0
5095;142911;512;77;29;2;27;.931;3600000;0
5097;62279;514;0;0;0;0;.00nan;0;0
5097;68627;514;67;24;2;22;.917;3552000;0
5097;143036;516;0;0;0;0;.00nan;0;0
5097;159851;516;95;25;0;25;1.000;3600000;0
5099;177504;515;78;26;2;24;.923;3600000;0
5099;64961;524;0;0;0;0;.00nan;0;0
5099;68565;515;0;0;0;0;.00nan;0;0
5099;76951;524;89;40;3;37;.925;3576000;0
5101;16587;513;73;40;4;36;.900;3600000;0
5101;63402;513;0;0;0;0;.00nan;0;0
5101;80859;511;0;0;0;0;.00nan;0;0
5101;88646;511;74;23;1;22;.957;3600000;0
5103;177504;515;0;0;0;0;.00nan;0;0
5103;68565;515;78;33;3;30;.909;3573000;0
5103;86228;512;66;23;2;21;.913;3600000;0
5103;142911;512;0;0;0;0;.00nan;0;0
5105;7487;518;0;0;0;0;.00nan;0;0
5105;7534;1481;0;0;0;0;.00nan;0;0
5105;32347;1481;97;43;1;42;.977;3600000;0
5105;57993;518;100;20;0;20;1.000;3600000;0
5107;63107;1876;100;43;3;40;.930;3600000;0
5107;86394;1876;0;0;0;0;.00nan;0;0
5107;143036;516;0;0;0;0;.00nan;0;0
5107;159851;516;25;19;5;14;.737;3526000;0
5109;1072;1472;33;25;5;20;.800;3600000;0
5109;53889;1475;0;0;0;0;.00nan;0;0
5109;64230;1472;0;0;0;0;.00nan;0;0
5109;143301;1475;74;29;2;27;.931;3600000;0
5111;4618;519;50;14;2;12;.857;3600000;0
5111;22413;519;0;0;0;0;.00nan;0;0
5111;62279;514;76;48;4;44;.917;3531000;0
5111;68627;514;0;0;0;0;.00nan;0;0
5113;8223;520;0;0;0;0;.00nan;0;0
5113;64961;524;0;0;0;0;.00nan;0;0
5113;76951;524;82;45;3;42;.933;3600000;0
5113;155474;520;45;28;4;24;.857;3600000;0
5115;7487;518;0;0;0;0;.00nan;0;0
5115;57993;518;63;18;1;17;.944;3600000;0
5115;143036;516;56;32;4;28;.875;3600000;0
5115;159851;516;0;0;0;0;.00nan;0;0
5117;8223;520;64;16;1;15;.938;3600000;0
5117;62279;514;0;0;0;0;.00nan;0;0
5117;68627;514;35;35;6;29;.829;3600000;0
5117;155474;520;0;0;0;0;.00nan;0;0
5119;53889;1475;80;60;6;54;.900;3600000;0
5119;80859;511;88;14;0;14;1.000;3600000;0
5119;88646;511;0;0;0;0;.00nan;0;0
5119;143301;1475;0;0;0;0;.00nan;0;0
5121;177504;515;77;22;1;21;.955;3600000;0
5121;68565;515;0;0;0;0;.00nan;0;0
5121;86228;512;0;0;0;0;.00nan;0;0
5121;142911;512;59;33;3;30;.909;3577000;0
5123;4618;519;0;0;0;0;.00nan;0;0
5123;22413;519;69;22;1;21;.955;3600000;0
5123;63107;1876;0;0;0;0;.00nan;0;0
5123;86394;1876;56;34;5;29;.853;3600000;0
5125;1072;1472;0;0;0;0;.00nan;0;0
5125;7534;1481;66;33;4;29;.879;3600000;0
5125;32347;1481;0;0;0;0;.00nan;0;0
5125;64230;1472;96;23;0;23;1.000;3600000;0
5127;16587;513;0;0;0;0;.00nan;0;0
5127;63402;513;52;32;4;28;.875;3560000;0
5127;64961;524;76;26;2;24;.923;3600000;0
5127;76951;524;0;0;0;0;.00nan;0;0
1020;4618;1876;0;0;0;0;.00nan;0;0
1020;8223;520;0;0;0;0;.00nan;0;0
1020;86394;1876;54;38;5;33;.868;3600000;0
1020;155474;520;83;29;1;28;.966;3600000;0
1021;16587;513;0;0;0;0;.00nan;0;0
1021;32347;513;86;33;2;31;.939;3600000;0
1021;62279;514;0;0;0;0;.00nan;0;0
1021;63107;514;66;26;3;23;.885;3547000;0
1022;6948;524;0;0;0;0;.00nan;0;0
1022;18965;515;0;0;0;0;.00nan;0;0
1022;76951;524;84;31;1;30;.968;3600000;0
1022;91403;515;80;31;2;29;.935;3599000;0
1023;169323;519;49;20;3;17;.850;3906000;0
1023;22413;519;0;0;0;0;.00nan;0;0
1023;57993;512;0;0;0;0;.00nan;0;0
1023;86228;512;65;25;2;23;.920;3906000;0
1024;4618;1876;0;0;0;0;.00nan;0;0
1024;8223;520;0;0;0;0;.00nan;0;0
1024;86394;1876;47;34;5;29;.853;3600000;0
1024;155474;520;100;30;0;30;1.000;3600000;0
1025;16587;513;58;9;1;8;.889;800000;0
1025;32347;513;7;22;7;15;.682;2800000;0
1025;62279;514;0;0;0;0;.00nan;0;0
1025;63107;514;69;33;3;30;.909;3600000;0
1026;6948;524;0;0;0;0;.00nan;0;0
1026;18965;515;0;0;0;0;.00nan;0;0
1026;76951;524;85;38;2;36;.947;3600000;0
1026;91403;515;35;28;6;22;.786;3600000;0
1027;169323;519;97;34;1;33;.971;3600000;0
1027;22413;519;0;0;0;0;.00nan;0;0
1027;57993;512;0;0;0;0;.00nan;0;0
1027;86228;512;71;45;4;41;.911;3600000;0
1028;4618;1876;0;0;0;0;.00nan;0;0
1028;8223;520;0;0;0;0;.00nan;0;0
1028;86394;1876;72;40;3;37;.925;3571000;0
1028;155474;520;55;19;2;17;.895;3600000;0
1029;16587;513;100;36;0;36;1.000;3600000;0
1029;32347;513;0;0;0;0;.00nan;0;0
1029;62279;514;0;0;0;0;.00nan;0;0
1029;63107;514;44;20;3;17;.850;3600000;0
1030;6948;524;46;7;1;6;.857;963000;0
1030;18965;515;0;0;0;0;.00nan;0;0
1030;76951;524;22;25;6;19;.760;2637000;0
1030;91403;515;69;38;4;34;.895;3600000;0
1031;169323;519;76;32;2;30;.938;3600000;0
1031;22413;519;0;0;0;0;.00nan;0;0
1031;57993;512;0;0;0;0;.00nan;0;0
1031;86228;512;62;30;3;27;.900;3600000;0
1195;16587;513;0;0;0;0;.00nan;0;0
1195;32347;513;71;34;4;30;.882;3564000;0
1195;62279;514;0;0;0;0;.00nan;0;0
1195;63107;514;66;29;3;26;.897;3600000;0
1196;6948;524;0;0;0;0;.00nan;0;0
1196;18965;515;0;0;0;0;.00nan;0;0
1196;76951;524;76;33;3;30;.909;3600000;0
1196;91403;515;45;40;6;34;.850;3600000;0
1197;169323;519;61;28;3;25;.893;3544000;0
1197;22413;519;0;0;0;0;.00nan;0;0
1197;57993;512;0;0;0;0;.00nan;0;0
1197;86228;512;69;28;2;26;.929;3600000;0
1317;16587;513;0;0;0;0;.00nan;0;0
1317;32347;513;59;15;2;13;.867;4338000;0
1317;62279;514;0;0;0;0;.00nan;0;0
1317;63107;514;82;40;3;37;.925;4338000;0
1318;169323;519;70;28;2;26;.929;3600000;0
1318;22413;519;0;0;0;0;.00nan;0;0
1318;57993;512;0;0;0;0;.00nan;0;0
1318;86228;512;67;40;4;36;.900;3600000;0
1406;16587;513;0;0;0;0;.00nan;0;0
1406;32347;513;49;36;5;31;.861;3551000;0
1406;179830;511;0;0;0;0;.00nan;0;0
1406;143301;511;46;24;4;20;.833;3600000;0
1407;169323;519;61;22;2;20;.909;3969000;0
1407;22413;519;0;0;0;0;.00nan;0;0
1407;36496;518;0;0;0;0;.00nan;0;0
1407;143330;518;67;31;3;28;.903;3969000;0
1408;8223;520;0;0;0;0;.00nan;0;0
1408;64961;516;0;0;0;0;.00nan;0;0
1408;80859;516;100;45;1;44;.978;3600000;0
1408;155474;520;42;18;3;15;.833;3587000;0
1409;6948;524;0;0;0;0;.00nan;0;0
1409;63402;1472;62;20;2;18;.900;3600000;0
1409;64230;1472;0;0;0;0;.00nan;0;0
1409;76951;524;58;33;3;30;.909;3556000;0
1410;16587;513;0;0;0;0;.00nan;0;0
1410;32347;513;88;43;3;40;.930;3600000;0
1410;179830;511;0;0;0;0;.00nan;0;0
1410;143301;511;68;21;1;20;.952;3600000;0
1411;169323;519;66;22;3;19;.864;3600000;0
1411;22413;519;0;0;0;0;.00nan;0;0
1411;36496;518;0;0;0;0;.00nan;0;0
1411;143330;518;28;28;6;22;.786;3600000;0
1412;8223;520;0;0;0;0;.00nan;0;0
1412;64961;516;0;0;0;0;.00nan;0;0
1412;80859;516;41;36;6;30;.833;3600000;0
1412;155474;520;73;24;1;23;.958;3600000;0
1413;6948;524;0;0;0;0;.00nan;0;0
1413;63402;1472;76;41;3;38;.927;4427000;0
1413;64230;1472;0;0;0;0;.00nan;0;0
1413;76951;524;100;47;2;45;.957;4427000;0
1414;16587;513;0;0;0;0;.00nan;0;0
1414;32347;513;100;53;3;50;.943;3600000;0
1414;179830;511;0;0;0;0;.00nan;0;0
1414;143301;511;30;17;4;13;.765;3552000;0
1415;169323;519;52;27;4;23;.852;3806000;0
1415;22413;519;0;0;0;0;.00nan;0;0
1415;36496;518;0;0;0;0;.00nan;0;0
1415;143330;518;72;33;3;30;.909;3806000;0
1416;8223;520;0;0;0;0;.00nan;0;0
1416;64961;516;0;0;0;0;.00nan;0;0
1416;80859;516;84;29;1;28;.966;3600000;0
1416;155474;520;77;31;2;29;.935;3600000;0
1417;6948;524;0;0;0;0;.00nan;0;0
1417;63402;1472;69;32;3;29;.906;3736000;0
1417;64230;1472;0;0;0;0;.00nan;0;0
1417;76951;524;69;39;4;35;.897;3736000;0
1418;16587;513;0;0;0;0;.00nan;0;0
1418;32347;513;47;38;6;32;.842;3600000;0
1418;179830;511;0;0;0;0;.00nan;0;0
1418;143301;511;56;11;1;10;.909;3600000;0
1419;169323;519;45;36;5;31;.861;3600000;0
1419;22413;519;0;0;0;0;.00nan;0;0
1419;36496;518;0;0;0;0;.00nan;0;0
1419;143330;518;90;27;1;26;.963;3600000;0
1420;8223;520;0;0;0;0;.00nan;0;0
1420;64961;516;0;0;0;0;.00nan;0;0
1420;80859;516;41;24;4;20;.833;3600000;0
1420;155474;520;68;26;2;24;.923;3600000;0
1421;6948;524;0;0;0;0;.00nan;0;0
1421;63402;1472;60;25;3;22;.880;3600000;0
1421;64230;1472;0;0;0;0;.00nan;0;0
1421;76951;524;100;19;0;19;1.000;3600000;0
1677;16587;513;0;0;0;0;.00nan;0;0
1677;32347;513;59;26;3;23;.885;3600000;0
1677;179830;511;0;0;0;0;.00nan;0;0
1677;143301;511;47;24;4;20;.833;3600000;0
1678;169323;519;54;23;3;20;.870;3724000;0
1678;22413;519;0;0;0;0;.00nan;0;0
1678;36496;518;0;0;0;0;.00nan;0;0
1678;143330;518;84;34;2;32;.941;3724000;0
1679;8223;520;56;10;1;9;.900;1332000;0
1679;64961;516;0;0;0;0;.00nan;0;0
1679;80859;516;68;29;3;26;.897;3600000;0
1679;155474;520;19;24;6;18;.750;2268000;0
1680;6948;524;0;0;0;0;.00nan;0;0
1680;63402;1472;92;36;1;35;.972;3600000;0
1680;64230;1472;0;0;0;0;.00nan;0;0
1680;76951;524;67;34;3;31;.912;3531000;0
1743;16587;513;0;0;0;0;.00nan;0;0
1743;32347;513;91;53;3;50;.943;4946000;0
1743;179830;511;0;0;0;0;.00nan;0;0
1743;143301;511;51;17;2;15;.882;4946000;0
1744;169323;519;90;33;1;32;.970;3600000;0
1744;22413;519;0;0;0;0;.00nan;0;0
1744;36496;518;0;0;0;0;.00nan;0;0
1744;143330;518;69;26;2;24;.923;3600000;0
1745;8223;520;76;30;3;27;.900;3600000;0
1745;64961;516;0;0;0;0;.00nan;0;0
1745;80859;516;56;30;4;26;.867;3577000;0
1745;155474;520;0;0;0;0;.00nan;0;0
1746;6948;524;0;0;0;0;.00nan;0;0
1746;63402;1472;65;16;1;15;.938;3600000;0
1746;64230;1472;0;0;0;0;.00nan;0;0
1746;76951;524;88;39;2;37;.949;3545000;0
1850;169323;519;78;45;3;42;.933;4295000;0
1850;22413;519;0;0;0;0;.00nan;0;0
1850;36496;518;0;0;0;0;.00nan;0;0
1850;143330;518;88;39;2;37;.949;4295000;0
1851;8223;520;61;26;3;23;.885;3531000;0
1851;64961;516;0;0;0;0;.00nan;0;0
1851;80859;516;73;22;1;21;.955;3600000;0
1851;155474;520;0;0;0;0;.00nan;0;0
1878;179830;511;0;0;0;0;.00nan;0;0
1878;64961;516;0;0;0;0;.00nan;0;0
1878;80859;516;77;36;3;33;.917;3600000;0
1878;143301;511;32;17;4;13;.765;3544000;0
1879;36496;518;0;0;0;0;.00nan;0;0
1879;63402;1472;81;26;1;25;.962;3548000;0
1879;64230;1472;0;0;0;0;.00nan;0;0
1879;143330;518;100;36;0;36;1.000;3600000;0
1880;179830;511;0;0;0;0;.00nan;0;0
1880;64961;516;0;0;0;0;.00nan;0;0
1880;80859;516;41;35;6;29;.829;3600000;0
1880;143301;511;74;22;1;21;.955;3600000;0
1881;36496;518;0;0;0;0;.00nan;0;0
1881;63402;1472;54;22;3;19;.864;3600000;0
1881;64230;1472;0;0;0;0;.00nan;0;0
1881;143330;518;38;34;6;28;.824;3600000;0
1882;179830;511;0;0;0;0;.00nan;0;0
1882;64961;516;0;0;0;0;.00nan;0;0
1882;80859;516;98;53;3;50;.943;3567000;0
1882;143301;511;69;26;2;24;.923;3600000;0
1883;36496;518;0;0;0;0;.00nan;0;0
1883;63402;1472;61;21;2;19;.905;3600000;0
1883;64230;1472;0;0;0;0;.00nan;0;0
1883;143330;518;81;45;3;42;.933;3589000;0
1884;179830;511;0;0;0;0;.00nan;0;0
1884;64961;516;0;0;0;0;.00nan;0;0
1884;80859;516;87;31;1;30;.968;3600000;0
1884;143301;511;45;13;2;11;.846;3600000;0
1885;36496;518;0;0;0;0;.00nan;0;0
1885;63402;1472;62;25;2;23;.920;3561000;0
1885;64230;1472;0;0;0;0;.00nan;0;0
1885;143330;518;100;42;1;41;.976;3600000;0
2072;179830;511;0;0;0;0;.00nan;0;0
2072;64961;516;0;0;0;0;.00nan;0;0
2072;80859;516;57;41;5;36;.878;3600000;0
2072;143301;511;99;28;1;27;.964;3600000;0
2073;36496;518;0;0;0;0;.00nan;0;0
2073;63402;1472;50;21;3;18;.857;3600000;0
2073;64230;1472;0;0;0;0;.00nan;0;0
2073;143330;518;51;38;5;33;.868;3600000;0
2135;179830;511;0;0;0;0;.00nan;0;0
2135;64961;516;0;0;0;0;.00nan;0;0
2135;80859;516;100;38;1;37;.974;3600000;0
2135;143301;511;67;26;2;24;.923;3544000;0
2136;36496;518;0;0;0;0;.00nan;0;0
2136;63402;1472;24;31;7;24;.774;3600000;0
2136;64230;1472;0;0;0;0;.00nan;0;0
2136;143330;518;100;44;0;44;1.000;3600000;0
2173;179830;511;0;0;0;0;.00nan;0;0
2173;64961;516;0;0;0;0;.00nan;0;0
2173;80859;516;35;31;6;25;.806;3600000;0
2173;143301;511;84;22;1;21;.955;3600000;0
2174;36496;518;0;0;0;0;.00nan;0;0
2174;63402;1472;63;23;3;20;.870;3545000;0
2174;64230;1472;0;0;0;0;.00nan;0;0
2174;143330;518;63;21;2;19;.905;3600000;0
2201;179830;511;0;0;0;0;.00nan;0;0
2201;36496;518;0;0;0;0;.00nan;0;0
2201;143301;511;59;16;2;14;.875;3600000;0
2201;143330;518;85;41;3;38;.927;3600000;0
2202;179830;511;0;0;0;0;.00nan;0;0
2202;36496;518;0;0;0;0;.00nan;0;0
2202;143301;511;64;24;3;21;.875;3600000;0
2202;143330;518;50;36;6;30;.833;3600000;0
2203;179830;511;0;0;0;0;.00nan;0;0
2203;36496;518;0;0;0;0;.00nan;0;0
2203;143301;511;61;17;1;16;.941;3600000;0
2203;143330;518;73;27;2;25;.926;3600000;0
2204;179830;511;0;0;0;0;.00nan;0;0
2204;36496;518;0;0;0;0;.00nan;0;0
2204;143301;511;42;32;5;27;.844;3600000;0
2204;143330;518;100;37;0;37;1.000;3600000;0
80;179830;511;0;0;0;0;.00nan;0;0
80;36496;518;0;0;0;0;.00nan;0;0
80;143301;511;79;29;2;27;.931;3600000;0
80;143330;518;61;32;3;29;.906;3561000;0
5128;2195;625;66;29;2;27;.931;3900000;0
5128;9611;647;96;49;2;47;.959;3900000;0
5128;80222;647;0;0;0;0;.00nan;0;0
5128;151728;625;0;0;0;0;.00nan;0;0
5129;6947;628;38;34;6;28;.824;3600000;0
5129;8942;639;0;0;0;0;.00nan;0;0
5129;72333;628;0;0;0;0;.00nan;0;0
5129;86485;639;68;21;1;20;.952;3600000;0
5130;40;636;0;0;0;0;.00nan;0;0
5130;73274;636;72;27;3;24;.889;3600000;0
5130;152478;1814;58;43;6;37;.860;3600000;0
5130;159912;1814;0;0;0;0;.00nan;0;0
5131;11107;637;0;0;0;0;.00nan;0;0
5131;18965;631;0;0;0;0;.00nan;0;0
5131;53861;637;64;38;4;34;.895;3553000;0
5131;77084;631;100;49;2;47;.959;3600000;0
5132;17371;642;68;21;2;19;.905;3600000;0
5132;169552;642;0;0;0;0;.00nan;0;0
5132;75313;1813;0;0;0;0;.00nan;0;0
5132;87603;1813;59;35;4;31;.886;3527000;0
5133;162979;627;60;16;1;15;.938;3600000;0
5133;20122;646;90;44;3;41;.932;3592000;0
5133;43064;646;0;0;0;0;.00nan;0;0
5133;145079;627;0;0;0;0;.00nan;0;0
5134;177631;641;0;0;0;0;.00nan;0;0
5134;8426;629;74;31;3;28;.903;3146000;0
5134;85644;629;27;7;3;4;.571;454000;0
5134;86180;641;86;31;2;29;.935;3600000;0
5135;162979;627;67;23;2;21;.913;3600000;0
5135;9611;647;0;0;0;0;.00nan;0;0
5135;80222;647;87;46;3;43;.935;3568000;0
5135;145079;627;0;0;0;0;.00nan;0;0
5136;40;636;0;0;0;0;.00nan;0;0
5136;11107;637;31;28;6;22;.786;3600000;0
5136;53861;637;0;0;0;0;.00nan;0;0
5136;73274;636;97;38;1;37;.974;3600000;0
5137;177631;641;0;0;0;0;.00nan;0;0
5137;18965;631;0;0;0;0;.00nan;0;0
5137;77084;631;67;27;2;25;.926;3600000;0
5137;86180;641;62;32;4;28;.875;3523000;0
5138;3821;625;59;39;4;35;.897;3600000;0
5138;8942;639;0;0;0;0;.00nan;0;0
5138;86485;639;92;32;1;31;.969;3600000;0
5138;151728;625;0;0;0;0;.00nan;0;0
5139;20122;646;0;0;0;0;.00nan;0;0
5139;43064;646;100;36;1;35;.972;3600000;0
5139;152478;1814;84;33;2;31;.939;3600000;0
5139;159912;1814;0;0;0;0;.00nan;0;0
5140;6947;628;87;29;1;28;.966;3600000;0
5140;17371;642;61;23;2;21;.913;3600000;0
5140;169552;642;0;0;0;0;.00nan;0;0
5140;72333;628;0;0;0;0;.00nan;0;0
5141;8426;629;34;37;7;30;.811;3600000;0
5141;75313;1813;81;32;1;31;.969;3600000;0
5141;85644;629;0;0;0;0;.00nan;0;0
5141;87603;1813;0;0;0;0;.00nan;0;0
5142;40;636;0;0;0;0;.00nan;0;0
5142;177631;641;0;0;0;0;.00nan;0;0
5142;73274;636;80;20;1;19;.950;3600000;0
5142;86180;641;76;46;5;41;.891;3600000;0
5143;162979;627;0;0;0;0;.00nan;0;0
5143;145079;627;57;23;3;20;.870;3600000;0
5143;152478;1814;65;54;7;47;.870;3600000;0
5143;159912;1814;0;0;0;0;.00nan;0;0
5144;8942;639;0;0;0;0;.00nan;0;0
5144;11107;637;0;0;0;0;.00nan;0;0
5144;53861;637;73;24;1;23;.958;3600000;0
5144;86485;639;85;41;2;39;.951;3561000;0
5145;6947;628;70;18;1;17;.944;3600000;0
5145;20122;646;0;0;0;0;.00nan;0;0
5145;43064;646;96;51;4;47;.922;3600000;0
5145;72333;628;0;0;0;0;.00nan;0;0
5146;8426;629;100;24;0;24;1.000;3600000;0
5146;18965;631;0;0;0;0;.00nan;0;0
5146;77084;631;86;34;2;32;.941;3548000;0
5146;85644;629;0;0;0;0;.00nan;0;0
5147;9611;647;0;0;0;0;.00nan;0;0
5147;17371;642;100;34;1;33;.971;3600000;0
5147;169552;642;0;0;0;0;.00nan;0;0
5147;80222;647;56;28;3;25;.893;3573000;0
5148;2195;625;100;31;0;31;1.000;3600000;0
5148;75313;1813;78;31;2;29;.935;3591000;0
5148;87603;1813;0;0;0;0;.00nan;0;0
5148;151728;625;0;0;0;0;.00nan;0;0
5149;162979;627;68;27;2;25;.926;3600000;0
5149;8942;639;0;0;0;0;.00nan;0;0
5149;86485;639;65;41;5;36;.878;3600000;0
5149;145079;627;0;0;0;0;.00nan;0;0
5150;11107;637;87;32;1;31;.969;3600000;0
5150;53861;637;0;0;0;0;.00nan;0;0
5150;75313;1813;0;0;0;0;.00nan;0;0
5150;87603;1813;88;36;2;34;.944;3600000;0
5151;177631;641;51;2;0;2;1.000;484000;0
5151;9611;647;0;0;0;0;.00nan;0;0
5151;80222;647;67;23;3;20;.870;3600000;0
5151;86180;641;68;33;5;28;.848;3034000;0
5152;6947;628;57;36;5;31;.861;3545000;0
5152;72333;628;0;0;0;0;.00nan;0;0
5152;152478;1814;64;33;4;29;.879;3600000;0
5152;159912;1814;0;0;0;0;.00nan;0;0
5153;2195;625;35;22;4;18;.818;3899000;0
5153;17371;642;85;53;4;49;.925;3900000;0
5153;169552;642;0;0;0;0;.00nan;0;0
5153;85441;625;0;0;0;0;.00nan;0;0
5154;18965;631;58;23;2;21;.913;3900000;0
5154;20122;646;0;0;0;0;.00nan;0;0
5154;43064;646;91;36;2;34;.944;3900000;0
5154;77084;631;0;0;0;0;.00nan;0;0
5155;40;636;0;0;0;0;.00nan;0;0
5155;8426;629;98;41;1;40;.976;3600000;0
5155;73274;636;65;30;3;27;.900;3520000;0
5155;85644;629;0;0;0;0;.00nan;0;0
5156;40;636;64;34;3;31;.912;3699000;0
5156;162979;627;57;35;4;31;.886;3699000;0
5156;73274;636;0;0;0;0;.00nan;0;0
5156;145079;627;0;0;0;0;.00nan;0;0
5157;17371;642;100;32;0;32;1.000;3600000;0
5157;169552;642;0;0;0;0;.00nan;0;0
5157;152478;1814;67;31;3;28;.903;3600000;0
5157;159912;1814;0;0;0;0;.00nan;0;0
5158;2195;625;73;34;3;31;.912;3900000;0
5158;11107;637;0;0;0;0;.00nan;0;0
5158;53861;637;52;19;3;16;.842;3900000;0
5158;151728;625;0;0;0;0;.00nan;0;0
5159;6947;628;65;33;3;30;.909;3600000;0
5159;18965;631;60;6;0;6;1.000;520000;0
5159;72333;628;0;0;0;0;.00nan;0;0
5159;77084;631;31;34;7;27;.794;3080000;0
5160;177631;641;0;0;0;0;.00nan;0;0
5160;75313;1813;90;33;1;32;.970;3600000;0
5160;86180;641;88;40;2;38;.950;3544000;0
5160;87603;1813;0;0;0;0;.00nan;0;0
5161;8942;639;0;0;0;0;.00nan;0;0
5161;20122;646;68;37;4;33;.892;3569000;0
5161;43064;646;0;0;0;0;.00nan;0;0
5161;86485;639;68;21;2;19;.905;3600000;0
5162;8426;629;53;33;4;29;.879;3600000;0
5162;9611;647;0;0;0;0;.00nan;0;0
5162;80222;647;100;26;1;25;.962;3600000;0
5162;85644;629;0;0;0;0;.00nan;0;0
5163;162979;627;60;15;2;13;.867;3600000;0
5163;17371;642;44;34;6;28;.824;3600000;0
5163;169552;642;0;0;0;0;.00nan;0;0
5163;145079;627;0;0;0;0;.00nan;0;0
5164;8426;629;99;54;3;51;.944;3900000;0
5164;11107;637;0;0;0;0;.00nan;0;0
5164;53861;637;48;23;3;20;.870;3900000;0
5164;85644;629;0;0;0;0;.00nan;0;0
5165;177631;641;0;0;0;0;.00nan;0;0
5165;20122;646;0;0;0;0;.00nan;0;0
5165;43064;646;70;31;3;28;.903;3600000;0
5165;86180;641;100;37;0;37;1.000;3600000;0
5166;8942;639;57;29;3;26;.897;3600000;0
5166;75313;1813;52;37;5;32;.865;3573000;0
5166;86485;639;0;0;0;0;.00nan;0;0
5166;87603;1813;0;0;0;0;.00nan;0;0
5167;2195;625;89;24;1;23;.958;3600000;0
5167;6947;628;73;43;4;39;.907;3600000;0
5167;72333;628;0;0;0;0;.00nan;0;0
5167;151728;625;0;0;0;0;.00nan;0;0
5168;18965;631;45;32;4;28;.875;3900000;0
5168;77084;631;0;0;0;0;.00nan;0;0
5168;152478;1814;94;43;4;39;.907;3900000;0
5168;159912;1814;0;0;0;0;.00nan;0;0
5169;40;636;0;0;0;0;.00nan;0;0
5169;9611;647;0;0;0;0;.00nan;0;0
5169;73274;636;26;19;5;14;.737;3600000;0
5169;80222;647;54;41;6;35;.854;3600000;0
5170;162979;627;0;0;0;0;.00nan;0;0
5170;8426;629;33;34;6;28;.824;3287000;0
5170;85644;629;53;4;0;4;1.000;313000;0
5170;145079;627;62;16;1;15;.938;3600000;0
5171;6947;628;80;25;1;24;.960;3600000;0
5171;177631;641;0;0;0;0;.00nan;0;0
5171;72333;628;0;0;0;0;.00nan;0;0
5171;86180;641;78;35;2;33;.943;3574000;0
5172;2195;625;76;23;2;21;.913;3600000;0
5172;18965;631;0;0;0;0;.00nan;0;0
5172;77084;631;81;39;3;36;.923;3600000;0
5172;151728;625;0;0;0;0;.00nan;0;0
5173;40;636;40;23;4;19;.826;3556000;0
5173;20122;646;70;26;2;24;.923;3600000;0
5173;43064;646;0;0;0;0;.00nan;0;0
5173;73274;636;0;0;0;0;.00nan;0;0
5174;8942;639;0;0;0;0;.00nan;0;0
5174;86485;639;70;24;2;22;.917;3600000;0
5174;152478;1814;62;51;6;45;.882;3600000;0
5174;159912;1814;0;0;0;0;.00nan;0;0
5175;11107;637;48;0;0;0;.00nan;295000;0
5175;17371;642;49;28;4;24;.857;3600000;0
5175;169552;642;0;0;0;0;.00nan;0;0
5175;53861;637;29;30;6;24;.800;3275000;0
5176;9611;647;0;0;0;0;.00nan;0;0
5176;75313;1813;57;3;0;3;1.000;263000;0
5176;80222;647;53;29;4;25;.862;3600000;0
5176;87603;1813;44;39;7;32;.821;3337000;0
5177;9611;647;51;2;0;2;1.000;426000;0
5177;80222;647;42;32;6;26;.813;3174000;0
5177;152478;1814;86;32;3;29;.906;3600000;0
5177;159912;1814;0;0;0;0;.00nan;0;0
5178;177631;641;0;0;0;0;.00nan;0;0
5178;11107;637;0;0;0;0;.00nan;0;0
5178;53861;637;64;27;3;24;.889;3600000;0
5178;86180;641;85;47;4;43;.915;3595000;0
5179;40;636;0;0;0;0;.00nan;0;0
5179;2195;625;53;23;3;20;.870;3544000;0
5179;73274;636;74;32;2;30;.938;3600000;0
5179;151728;625;0;0;0;0;.00nan;0;0
5180;162979;627;0;0;0;0;.00nan;0;0
5180;18965;631;0;0;0;0;.00nan;0;0
5180;77084;631;70;41;4;37;.902;3758000;0
5180;145079;627;63;36;5;31;.861;3758000;0
5181;8942;639;0;0;0;0;.00nan;0;0
5181;17371;642;100;35;1;34;.971;3600000;0
5181;169552;642;0;0;0;0;.00nan;0;0
5181;86485;639;55;25;3;22;.880;3531000;0
5182;20122;646;0;0;0;0;.00nan;0;0
5182;43064;646;83;43;3;40;.930;3600000;0
5182;75313;1813;79;33;2;31;.939;3600000;0
5182;87603;1813;0;0;0;0;.00nan;0;0
5183;6947;628;50;33;5;28;.848;3537000;0
5183;8426;629;0;0;0;0;.00nan;0;0
5183;72333;628;0;0;0;0;.00nan;0;0
5183;85644;629;74;33;3;30;.909;3600000;0
5184;162979;627;68;27;2;25;.926;3600000;0
5184;11107;637;70;19;1;18;.947;2483000;0
5184;53861;637;17;7;4;3;.429;1117000;0
5184;145079;627;0;0;0;0;.00nan;0;0
5185;177631;641;0;0;0;0;.00nan;0;0
5185;17371;642;62;23;2;21;.913;3600000;0
5185;169552;642;0;0;0;0;.00nan;0;0
5185;86180;641;63;38;5;33;.868;3600000;0
5186;6947;628;0;0;0;0;.00nan;0;0
5186;9611;647;0;0;0;0;.00nan;0;0
5186;72333;628;61;22;2;20;.909;3600000;0
5186;80222;647;66;38;4;34;.895;3526000;0
5187;40;636;0;0;0;0;.00nan;0;0
5187;73274;636;73;22;1;21;.955;3600000;0
5187;75313;1813;0;0;0;0;.00nan;0;0
5187;87603;1813;75;40;3;37;.925;3544000;0
5188;8942;639;0;0;0;0;.00nan;0;0
5188;18965;631;0;0;0;0;.00nan;0;0
5188;77084;631;72;30;3;27;.900;3557000;0
5188;86485;639;88;28;1;27;.964;3600000;0
5189;2195;625;89;32;1;31;.969;3600000;0
5189;151728;625;0;0;0;0;.00nan;0;0
5189;152478;1814;80;34;2;32;.941;3546000;0
5189;159912;1814;0;0;0;0;.00nan;0;0
5190;8426;629;58;26;3;23;.885;3544000;0
5190;20122;646;100;37;2;35;.946;3600000;0
5190;43064;646;0;0;0;0;.00nan;0;0
5190;85644;629;0;0;0;0;.00nan;0;0
5191;162979;627;25;9;3;6;.667;3900000;0
5191;177631;641;0;0;0;0;.00nan;0;0
5191;86180;641;90;44;3;41;.932;3900000;0
5191;145079;627;0;0;0;0;.00nan;0;0
5192;8426;629;71;48;5;43;.896;3600000;0
5192;8942;639;0;0;0;0;.00nan;0;0
5192;85644;629;0;0;0;0;.00nan;0;0
5192;86485;639;36;11;3;8;.727;3600000;0
5193;6947;628;71;33;3;30;.909;3600000;0
5193;72333;628;0;0;0;0;.00nan;0;0
5193;75313;1813;33;41;7;34;.829;3343000;0
5193;87603;1813;50;1;0;1;1.000;257000;0
5194;40;636;74;28;2;26;.929;3600000;0
5194;17371;642;56;27;4;23;.852;3567000;0
5194;169552;642;0;0;0;0;.00nan;0;0
5194;73274;636;0;0;0;0;.00nan;0;0
5195;11107;637;0;0;0;0;.00nan;0;0
5195;53861;637;59;30;3;27;.900;3700000;0
5195;152478;1814;61;36;4;32;.889;3700000;0
5195;159912;1814;0;0;0;0;.00nan;0;0
5196;9611;647;77;18;0;18;1.000;2412000;0
5196;18965;631;0;0;0;0;.00nan;0;0
5196;77084;631;67;35;3;32;.914;3600000;0
5196;80222;647;46;22;4;18;.818;1150000;0
5197;2195;625;40;22;5;17;.773;3600000;0
5197;20122;646;54;8;1;7;.875;889000;0
5197;43064;646;26;26;6;20;.769;2691000;0
5197;151728;625;0;0;0;0;.00nan;0;0
5198;162979;627;0;0;0;0;.00nan;0;0
5198;6947;628;63;34;5;29;.853;3569000;0
5198;72333;628;0;0;0;0;.00nan;0;0
5198;145079;627;62;39;4;35;.897;3600000;0
5199;11107;637;0;0;0;0;.00nan;0;0
5199;20122;646;31;17;4;13;.765;1170000;0
5199;43064;646;98;30;0;30;1.000;2430000;0
5199;53861;637;48;18;3;15;.833;3600000;0
5200;2195;625;55;24;2;22;.917;3571000;0
5200;177631;641;0;0;0;0;.00nan;0;0
5200;86180;641;100;29;0;29;1.000;3600000;0
5200;151728;625;0;0;0;0;.00nan;0;0
5201;8942;639;0;0;0;0;.00nan;0;0
5201;9611;647;0;0;0;0;.00nan;0;0
5201;80222;647;78;34;3;31;.912;3600000;0
5201;86485;639;47;26;5;21;.808;3525000;0
5202;40;636;0;0;0;0;.00nan;0;0
5202;18965;631;0;0;0;0;.00nan;0;0
5202;73274;636;95;20;0;20;1.000;3600000;0
5202;77084;631;57;36;4;32;.889;3600000;0
5203;75313;1813;0;0;0;0;.00nan;0;0
5203;87603;1813;69;23;2;21;.913;3583000;0
5203;152478;1814;82;27;1;26;.963;3600000;0
5203;159912;1814;0;0;0;0;.00nan;0;0
5204;8426;629;52;19;2;17;.895;3600000;0
5204;17371;642;49;34;5;29;.853;3600000;0
5204;169552;642;0;0;0;0;.00nan;0;0
5204;85644;629;0;0;0;0;.00nan;0;0
5205;177631;641;0;0;0;0;.00nan;0;0
5205;86180;641;75;28;2;26;.929;3600000;0
5205;152478;1814;55;33;4;29;.879;3600000;0
5205;159912;1814;0;0;0;0;.00nan;0;0
5206;162979;627;0;0;0;0;.00nan;0;0
5206;75313;1813;4;31;9;22;.710;3600000;0
5206;87603;1813;0;0;0;0;.00nan;0;0
5206;145079;627;61;21;2;19;.905;3600000;0
5207;6947;628;53;21;3;18;.857;3600000;0
5207;11107;637;0;0;0;0;.00nan;0;0
5207;53861;637;58;39;5;34;.872;3551000;0
5207;72333;628;0;0;0;0;.00nan;0;0
5208;40;636;0;0;0;0;.00nan;0;0
5208;8942;639;0;0;0;0;.00nan;0;0
5208;73274;636;85;57;4;53;.930;3871000;0
5208;86485;639;37;25;5;20;.800;3871000;0
5209;17371;642;24;20;5;15;.750;3600000;0
5209;18965;631;0;0;0;0;.00nan;0;0
5209;169552;642;0;0;0;0;.00nan;0;0
5209;77084;631;100;36;1;35;.972;3600000;0
5210;9611;647;0;0;0;0;.00nan;0;0
5210;20122;646;0;0;0;0;.00nan;0;0
5210;43064;646;64;48;5;43;.896;3600000;0
5210;80222;647;99;22;0;22;1.000;3600000;0
5211;2195;625;93;19;0;19;1.000;3600000;0
5211;8426;629;0;0;0;0;.00nan;0;0
5211;85644;629;87;38;2;36;.947;3593000;0
5211;151728;625;0;0;0;0;.00nan;0;0
5212;2195;625;53;34;5;29;.853;3600000;0
5212;162979;627;94;16;0;16;1.000;3600000;0
5212;85441;625;0;0;0;0;.00nan;0;0
5212;145079;627;0;0;0;0;.00nan;0;0
5213;177631;641;75;18;1;17;.944;3241000;0
5213;8942;639;86;28;1;27;.964;3600000;0
5213;86180;641;30;9;3;6;.667;359000;0
5213;86485;639;0;0;0;0;.00nan;0;0
5214;40;636;0;0;0;0;.00nan;0;0
5214;6947;628;88;32;1;31;.969;3600000;0
5214;72333;628;0;0;0;0;.00nan;0;0
5214;73274;636;60;44;6;38;.864;3600000;0
5215;8426;629;83;39;4;35;.897;3600000;0
5215;85644;629;0;0;0;0;.00nan;0;0
5215;152478;1814;0;0;0;0;.00nan;0;0
5215;159912;1814;48;33;5;28;.848;3586000;0
5216;9611;647;100;29;0;29;1.000;3600000;0
5216;11107;637;0;0;0;0;.00nan;0;0
5216;53861;637;78;27;1;26;.963;3546000;0
5216;80222;647;0;0;0;0;.00nan;0;0
5217;18965;631;0;0;0;0;.00nan;0;0
5217;75313;1813;0;0;0;0;.00nan;0;0
5217;77084;631;69;30;3;27;.900;3600000;0
5217;87603;1813;46;26;4;22;.846;3582000;0
5218;17371;642;22;27;6;21;.778;2663000;0
5218;20122;646;81;31;2;29;.935;3600000;0
5218;169552;642;53;10;1;9;.900;937000;0
5218;43064;646;0;0;0;0;.00nan;0;0
5219;40;636;0;0;0;0;.00nan;0;0
5219;11107;637;0;0;0;0;.00nan;0;0
5219;53861;637;73;25;1;24;.960;3600000;0
5219;73274;636;48;30;4;26;.867;3600000;0
5220;162979;627;64;22;2;20;.909;3600000;0
5220;145079;627;0;0;0;0;.00nan;0;0
5220;152478;1814;82;49;4;45;.918;3515000;0
5220;159912;1814;0;0;0;0;.00nan;0;0
5221;2195;625;76;29;2;27;.931;3600000;0
5221;18965;631;0;0;0;0;.00nan;0;0
5221;77084;631;41;38;6;32;.842;3600000;0
5221;151728;625;0;0;0;0;.00nan;0;0
5222;8942;639;0;0;0;0;.00nan;0;0
5222;20122;646;0;0;0;0;.00nan;0;0
5222;43064;646;92;60;4;56;.933;3600000;0
5222;86485;639;66;21;2;19;.905;3600000;0
5223;6947;628;35;18;4;14;.778;3530000;0
5223;177631;641;0;0;0;0;.00nan;0;0
5223;72333;628;0;0;0;0;.00nan;0;0
5223;86180;641;100;48;2;46;.958;3600000;0
5224;9611;647;0;0;0;0;.00nan;0;0
5224;17371;642;100;32;0;32;1.000;3600000;0
5224;169552;642;0;0;0;0;.00nan;0;0
5224;80222;647;67;47;5;42;.894;3600000;0
5225;8426;629;0;0;0;0;.00nan;0;0
5225;75313;1813;0;0;0;0;.00nan;0;0
5225;85644;629;96;50;3;47;.940;3600000;0
5225;87603;1813;33;38;6;32;.842;3600000;0
5226;162979;627;0;0;0;0;.00nan;0;0
5226;11107;637;0;0;0;0;.00nan;0;0
5226;53861;637;84;31;1;30;.968;3600000;0
5226;145079;627;52;24;3;21;.875;3567000;0
5227;2195;625;98;50;2;48;.960;3578000;0
5227;177631;641;0;0;0;0;.00nan;0;0
5227;85441;625;0;0;0;0;.00nan;0;0
5227;86180;641;99;33;1;32;.970;3600000;0
5228;8426;629;90;56;3;53;.946;3900000;0
5228;8942;639;0;0;0;0;.00nan;0;0
5228;85644;629;0;0;0;0;.00nan;0;0
5228;86485;639;54;25;3;22;.880;3900000;0
5229;40;636;61;23;2;21;.913;3600000;0
5229;17371;642;75;40;3;37;.925;3545000;0
5229;169552;642;0;0;0;0;.00nan;0;0
5229;73274;636;0;0;0;0;.00nan;0;0
5230;18965;631;0;0;0;0;.00nan;0;0
5230;77084;631;81;44;4;40;.909;3566000;0
5230;152478;1814;74;33;2;31;.939;3600000;0
5230;159912;1814;0;0;0;0;.00nan;0;0
5231;9611;647;0;0;0;0;.00nan;0;0
5231;75313;1813;57;27;3;24;.889;3520000;0
5231;80222;647;74;25;1;24;.960;3600000;0
5231;87603;1813;0;0;0;0;.00nan;0;0
5232;6947;628;58;15;2;13;.867;3600000;0
5232;20122;646;56;37;5;32;.865;3600000;0
5232;43064;646;0;0;0;0;.00nan;0;0
5232;72333;628;0;0;0;0;.00nan;0;0
5233;40;636;0;0;0;0;.00nan;0;0
5233;162979;627;90;22;0;22;1.000;3600000;0
5233;73274;636;41;33;5;28;.848;3600000;0
5233;145079;627;0;0;0;0;.00nan;0;0
5234;2195;625;88;55;4;51;.927;3900000;0
5234;11107;637;0;0;0;0;.00nan;0;0
5234;53861;637;66;37;4;33;.892;3900000;0
5234;85441;625;0;0;0;0;.00nan;0;0
5235;9611;647;0;0;0;0;.00nan;0;0
5235;80222;647;57;19;2;17;.895;3600000;0
5235;152478;1814;66;33;3;30;.909;3589000;0
5235;159912;1814;0;0;0;0;.00nan;0;0
5236;8942;639;0;0;0;0;.00nan;0;0
5236;75313;1813;83;31;1;30;.968;3600000;0
5236;86485;639;81;37;2;35;.946;3571000;0
5236;87603;1813;0;0;0;0;.00nan;0;0
5237;8426;629;81;18;1;17;.944;3600000;0
5237;20122;646;0;0;0;0;.00nan;0;0
5237;43064;646;34;31;6;25;.806;3600000;0
5237;85644;629;0;0;0;0;.00nan;0;0
5238;6947;628;69;21;1;20;.952;3600000;0
5238;18965;631;0;0;0;0;.00nan;0;0
5238;72333;628;0;0;0;0;.00nan;0;0
5238;77084;631;94;40;2;38;.950;3600000;0
5239;177631;641;0;0;0;0;.00nan;0;0
5239;17371;642;89;37;2;35;.946;3600000;0
5239;169552;642;0;0;0;0;.00nan;0;0
5239;86180;641;55;33;5;28;.848;3600000;0
5240;177631;641;0;0;0;0;.00nan;0;0
5240;11107;637;0;0;0;0;.00nan;0;0
5240;53861;637;69;22;1;21;.955;3600000;0
5240;86180;641;70;36;3;33;.917;3582000;0
5241;2195;625;80;33;2;31;.939;3600000;0
5241;162979;627;34;25;5;20;.800;3600000;0
5241;85441;625;0;0;0;0;.00nan;0;0
5241;145079;627;0;0;0;0;.00nan;0;0
5242;8942;639;0;0;0;0;.00nan;0;0
5242;17371;642;87;35;2;33;.943;3600000;0
5242;169552;642;0;0;0;0;.00nan;0;0
5242;86485;639;85;14;0;14;1.000;3600000;0
5243;40;636;0;0;0;0;.00nan;0;0
5243;6947;628;81;41;3;38;.927;3600000;0
5243;72333;628;0;0;0;0;.00nan;0;0
5243;73274;636;52;38;5;33;.868;3580000;0
5244;18965;631;0;0;0;0;.00nan;0;0
5244;75313;1813;0;0;0;0;.00nan;0;0
5244;77084;631;86;47;4;43;.915;3584000;0
5244;87603;1813;53;26;3;23;.885;3600000;0
5245;20122;646;57;32;4;28;.875;3600000;0
5245;43064;646;0;0;0;0;.00nan;0;0
5245;152478;1814;78;26;2;24;.923;3600000;0
5245;159912;1814;0;0;0;0;.00nan;0;0
5246;8426;629;93;40;2;38;.950;3727000;0
5246;9611;647;0;0;0;0;.00nan;0;0
5246;80222;647;49;20;3;17;.850;3727000;0
5246;85644;629;0;0;0;0;.00nan;0;0
5247;162979;627;0;0;0;0;.00nan;0;0
5247;8426;629;88;39;2;37;.949;3582000;0
5247;85644;629;0;0;0;0;.00nan;0;0
5247;145079;627;80;22;1;21;.955;3600000;0
5248;11107;637;0;0;0;0;.00nan;0;0
5248;53861;637;55;17;3;14;.824;3600000;0
5248;75313;1813;79;52;5;47;.904;3600000;0
5248;87603;1813;0;0;0;0;.00nan;0;0
5249;6947;628;67;29;3;26;.897;3792000;0
5249;8942;639;0;0;0;0;.00nan;0;0
5249;72333;628;0;0;0;0;.00nan;0;0
5249;86485;639;62;28;4;24;.857;3792000;0
5250;40;636;0;0;0;0;.00nan;0;0
5250;18965;631;0;0;0;0;.00nan;0;0
5250;73274;636;82;30;1;29;.967;3600000;0
5250;77084;631;97;51;3;48;.941;3600000;0
5251;177631;641;0;0;0;0;.00nan;0;0
5251;86180;641;80;34;2;32;.941;3570000;0
5251;152478;1814;83;28;1;27;.964;3600000;0
5251;159912;1814;0;0;0;0;.00nan;0;0
5252;2195;625;32;29;6;23;.793;3276000;0
5252;9611;647;44;34;6;28;.824;2898000;0
5252;80222;647;54;4;0;4;1.000;1002000;0
5252;85441;625;60;5;0;5;1.000;624000;0
5253;17371;642;52;24;3;21;.875;3552000;0
5253;20122;646;0;0;0;0;.00nan;0;0
5253;169552;642;0;0;0;0;.00nan;0;0
5253;43064;646;76;28;2;26;.929;3600000;0
5254;8942;639;0;0;0;0;.00nan;0;0
5254;11107;637;0;0;0;0;.00nan;0;0
5254;53861;637;46;30;4;26;.867;3586000;0
5254;86485;639;62;21;2;19;.905;3600000;0
5255;18965;631;0;0;0;0;.00nan;0;0
5255;20122;646;70;41;5;36;.878;3600000;0
5255;43064;646;0;0;0;0;.00nan;0;0
5255;77084;631;86;27;1;26;.963;3600000;0
5256;162979;627;75;28;2;26;.929;3900000;0
5256;177631;641;0;0;0;0;.00nan;0;0
5256;86180;641;82;32;2;30;.938;3900000;0
5256;145079;627;0;0;0;0;.00nan;0;0
5257;2195;625;0;0;0;0;.00nan;0;0
5257;85441;625;63;22;2;20;.909;3600000;0
5257;152478;1814;82;41;3;38;.927;3543000;0
5257;159912;1814;0;0;0;0;.00nan;0;0
5258;40;636;0;0;0;0;.00nan;0;0
5258;8426;629;41;38;6;32;.842;3600000;0
5258;73274;636;57;21;3;18;.857;3600000;0
5258;85644;629;0;0;0;0;.00nan;0;0
5259;6947;628;50;19;2;17;.895;3600000;0
5259;9611;647;64;44;5;39;.886;3600000;0
5259;72333;628;0;0;0;0;.00nan;0;0
5259;80222;647;0;0;0;0;.00nan;0;0
5260;17371;642;68;23;2;21;.913;3554000;0
5260;169552;642;0;0;0;0;.00nan;0;0
5260;75313;1813;97;39;1;38;.974;3600000;0
5260;87603;1813;0;0;0;0;.00nan;0;0
5261;8942;639;74;24;2;22;.917;3900000;0
5261;18965;631;0;0;0;0;.00nan;0;0
5261;77084;631;91;42;2;40;.952;3900000;0
5261;86485;639;0;0;0;0;.00nan;0;0
5262;40;636;0;0;0;0;.00nan;0;0
5262;177631;641;87;39;2;37;.949;3600000;0
5262;73274;636;22;25;6;19;.760;3600000;0
5262;86180;641;0;0;0;0;.00nan;0;0
5263;162979;627;100;29;0;29;1.000;3600000;0
5263;6947;628;0;0;0;0;.00nan;0;0
5263;72333;628;57;38;5;33;.868;3600000;0
5263;145079;627;0;0;0;0;.00nan;0;0
5264;75313;1813;56;36;4;32;.889;3600000;0
5264;87603;1813;0;0;0;0;.00nan;0;0
5264;152478;1814;63;27;3;24;.889;3600000;0
5264;159912;1814;0;0;0;0;.00nan;0;0
5265;11107;637;0;0;0;0;.00nan;0;0
5265;17371;642;60;27;3;24;.889;3599000;0
5265;169552;642;0;0;0;0;.00nan;0;0
5265;53861;637;79;23;1;22;.957;3600000;0
5266;9611;647;0;0;0;0;.00nan;0;0
5266;20122;646;61;15;1;14;.933;1045000;0
5266;43064;646;41;30;6;24;.800;2555000;0
5266;80222;647;57;24;3;21;.875;3600000;0
5267;2195;625;77;24;1;23;.958;3600000;0
5267;8426;629;77;33;3;30;.909;3600000;0
5267;85441;625;0;0;0;0;.00nan;0;0
5267;85644;629;0;0;0;0;.00nan;0;0
5268;6947;628;63;29;3;26;.897;3600000;0
5268;72333;628;0;0;0;0;.00nan;0;0
5268;152478;1814;26;8;3;5;.625;572000;0
5268;159912;1814;60;35;3;32;.914;3028000;0
5269;162979;627;77;35;3;32;.914;3900000;0
5269;-1;631;0;0;0;0;.00nan;0;0
5269;77084;631;55;28;3;25;.893;3900000;0
5269;145079;627;0;0;0;0;.00nan;0;0
5270;11107;637;0;0;0;0;.00nan;0;0
5270;53861;637;46;22;4;18;.818;3600000;0
5270;80222;647;42;30;5;25;.833;3600000;0
5270;151728;647;0;0;0;0;.00nan;0;0
5271;3821;1813;0;0;0;0;.00nan;0;0
5271;177631;641;0;0;0;0;.00nan;0;0
5271;75313;1813;97;56;2;54;.964;3558000;0
5271;86180;641;72;21;1;20;.952;3600000;0
5272;2195;625;73;33;3;30;.909;3600000;0
5272;8942;639;0;0;0;0;.00nan;0;0
5272;85441;625;0;0;0;0;.00nan;0;0
5272;86485;639;80;35;2;33;.943;3600000;0
5273;40;636;57;15;1;14;.933;3600000;0
5273;20122;646;72;31;3;28;.903;3526000;0
5273;63831;646;0;0;0;0;.00nan;0;0
5273;73274;636;0;0;0;0;.00nan;0;0
5274;8426;629;62;31;3;28;.903;3600000;0
5274;17371;642;78;12;0;12;1.000;3600000;0
5274;169552;642;0;0;0;0;.00nan;0;0
5274;85644;629;0;0;0;0;.00nan;0;0
5275;2195;625;40;23;4;19;.826;3578000;0
5275;6947;628;66;33;3;30;.909;3600000;0
5275;72333;628;0;0;0;0;.00nan;0;0
5275;85441;625;0;0;0;0;.00nan;0;0
5276;8942;639;0;0;0;0;.00nan;0;0
5276;86485;639;75;29;2;27;.931;3600000;0
5276;152478;1814;86;43;4;39;.907;3600000;0
5276;159912;1814;0;0;0;0;.00nan;0;0
5277;162979;627;79;29;2;27;.931;3900000;0
5277;9611;647;0;0;0;0;.00nan;0;0
5277;80222;647;70;32;2;30;.938;3900000;0
5277;145079;627;0;0;0;0;.00nan;0;0
5278;40;636;0;0;0;0;.00nan;0;0
5278;3821;1813;0;0;0;0;.00nan;0;0
5278;73274;636;73;18;1;17;.944;3600000;0
5278;75313;1813;88;62;4;58;.935;3570000;0
5279;11107;637;0;0;0;0;.00nan;0;0
5279;20122;646;0;0;0;0;.00nan;0;0
5279;43064;646;100;39;1;38;.974;3600000;0
5279;53861;637;27;15;4;11;.733;3600000;0
5280;177631;641;0;0;0;0;.00nan;0;0
5280;8426;629;62;35;4;31;.886;3600000;0
5280;85644;629;0;0;0;0;.00nan;0;0
5280;86180;641;87;25;1;24;.960;3600000;0
5281;17371;642;69;28;2;26;.929;3600000;0
5281;169552;642;0;0;0;0;.00nan;0;0
5281;-1;631;50;7;1;6;.857;760000;0
5281;77084;631;19;30;7;23;.767;2840000;0
5282;162979;627;68;18;1;17;.944;3600000;0
5282;20122;646;0;0;0;0;.00nan;0;0
5282;43064;646;86;45;3;42;.933;3600000;0
5282;145079;627;0;0;0;0;.00nan;0;0
5283;2195;625;68;22;2;20;.909;3600000;0
5283;75313;1813;24;24;6;18;.750;1290000;0
5283;85441;625;0;0;0;0;.00nan;0;0
5283;87603;1813;84;31;1;30;.968;2310000;0
5284;40;636;0;0;0;0;.00nan;0;0
5284;8942;639;49;17;3;14;.824;3900000;0
5284;73274;636;59;28;3;25;.893;3900000;0
5284;86485;639;0;0;0;0;.00nan;0;0
5285;6947;628;55;20;3;17;.850;3600000;0
5285;8426;629;42;35;6;29;.829;3101000;0
5285;72333;628;0;0;0;0;.00nan;0;0
5285;85644;629;37;7;2;5;.714;499000;0
5286;11107;637;0;0;0;0;.00nan;0;0
5286;-1;631;0;0;0;0;.00nan;0;0
5286;53861;637;40;27;4;23;.852;3900000;0
5286;77084;631;43;24;4;20;.833;3900000;0
5287;17371;642;57;29;4;25;.862;3566000;0
5287;169552;642;0;0;0;0;.00nan;0;0
5287;152478;1814;88;41;2;39;.951;3600000;0
5287;159912;1814;0;0;0;0;.00nan;0;0
5288;177631;641;0;0;0;0;.00nan;0;0
5288;9611;647;82;30;2;28;.933;3600000;0
5288;80222;647;0;0;0;0;.00nan;0;0
5288;86180;641;88;49;3;46;.939;3550000;0
5289;162979;627;85;28;3;25;.893;3900000;0
5289;8942;639;0;0;0;0;.00nan;0;0
5289;86485;639;69;30;3;27;.900;3900000;0
5289;145079;627;0;0;0;0;.00nan;0;0
5290;11107;637;58;33;4;29;.879;3548000;0
5290;53861;637;0;0;0;0;.00nan;0;0
5290;152478;1814;88;38;3;35;.921;3600000;0
5290;159912;1814;0;0;0;0;.00nan;0;0
5291;177631;641;0;0;0;0;.00nan;0;0
5291;20122;646;97;47;2;45;.957;3566000;0
5291;43064;646;0;0;0;0;.00nan;0;0
5291;86180;641;65;18;1;17;.944;3600000;0
5292;2195;625;75;23;1;22;.957;3600000;0
5292;17371;642;63;37;4;33;.892;3600000;0
5292;169552;642;0;0;0;0;.00nan;0;0
5292;85441;625;0;0;0;0;.00nan;0;0
5293;40;636;0;0;0;0;.00nan;0;0
5293;9611;647;0;0;0;0;.00nan;0;0
5293;73274;636;89;28;1;27;.964;3600000;0
5293;80222;647;78;41;4;37;.902;3600000;0
5294;6947;628;39;26;4;22;.846;3600000;0
5294;72333;628;0;0;0;0;.00nan;0;0
5294;75313;1813;91;33;1;32;.970;3600000;0
5294;87603;1813;0;0;0;0;.00nan;0;0
5295;8426;629;0;0;0;0;.00nan;0;0
5295;-1;631;0;0;0;0;.00nan;0;0
5295;77084;631;88;39;3;36;.923;3600000;0
5295;85644;629;37;20;4;16;.800;3576000;0
5296;6947;628;100;31;0;31;1.000;3600000;0
5296;17371;642;89;34;1;33;.971;3598000;0
5296;169552;642;0;0;0;0;.00nan;0;0
5296;72333;628;0;0;0;0;.00nan;0;0
5297;8426;629;77;29;2;27;.931;3600000;0
5297;11107;637;0;0;0;0;.00nan;0;0
5297;53861;637;69;34;4;30;.882;3514000;0
5297;85644;629;0;0;0;0;.00nan;0;0
5298;177631;641;60;7;0;7;1.000;821000;0
5298;8942;639;0;0;0;0;.00nan;0;0
5298;86180;641;28;28;6;22;.786;2779000;0
5298;86485;639;79;35;3;32;.914;3600000;0
5299;2195;625;0;0;0;0;.00nan;0;0
5299;20122;646;0;0;0;0;.00nan;0;0
5299;43064;646;65;46;5;41;.891;3600000;0
5299;85441;625;58;10;1;9;.900;3600000;0
5300;40;636;0;0;0;0;.00nan;0;0
5300;73274;636;96;34;2;32;.941;3600000;0
5300;152478;1814;0;0;0;0;.00nan;0;0
5300;159912;1814;59;29;3;26;.897;3594000;0
5301;9611;647;62;36;4;32;.889;3600000;0
5301;-1;631;0;0;0;0;.00nan;0;0
5301;77084;631;91;30;1;29;.967;3600000;0
5301;80222;647;0;0;0;0;.00nan;0;0
5302;162979;627;66;26;3;23;.885;3600000;0
5302;75313;1813;100;33;0;33;1.000;3600000;0
5302;87603;1813;0;0;0;0;.00nan;0;0
5302;145079;627;0;0;0;0;.00nan;0;0
5303;162979;627;0;0;0;0;.00nan;0;0
5303;17371;642;100;31;0;31;1.000;3600000;0
5303;169552;642;0;0;0;0;.00nan;0;0
5303;145079;627;58;30;3;27;.900;3600000;0
5304;8942;639;19;25;6;19;.760;2747000;0
5304;9611;647;0;0;0;0;.00nan;0;0
5304;80222;647;80;28;2;26;.929;3600000;0
5304;86485;639;52;4;0;4;1.000;853000;0
5305;6947;628;60;35;4;31;.886;3858000;0
5305;11107;637;0;0;0;0;.00nan;0;0
5305;53861;637;85;43;3;40;.930;3858000;0
5305;72333;628;0;0;0;0;.00nan;0;0
5306;40;636;0;0;0;0;.00nan;0;0
5306;2195;625;62;34;4;30;.882;3553000;0
5306;73274;636;70;35;3;32;.914;3600000;0
5306;85441;625;0;0;0;0;.00nan;0;0
5307;177631;641;0;0;0;0;.00nan;0;0
5307;-1;631;0;0;0;0;.00nan;0;0
5307;77084;631;100;26;0;26;1.000;3600000;0
5307;86180;641;71;32;3;29;.906;3600000;0
5308;20122;646;51;28;5;23;.821;3100000;0
5308;43064;646;52;3;0;3;1.000;488000;0
5308;75313;1813;68;30;3;27;.900;3600000;0
5308;87603;1813;0;0;0;0;.00nan;0;0
5309;8426;629;93;41;2;39;.951;3600000;0
5309;85644;629;0;0;0;0;.00nan;0;0
5309;152478;1814;51;41;6;35;.854;3600000;0
5309;159912;1814;0;0;0;0;.00nan;0;0
5310;6947;628;69;29;2;27;.931;3625000;0
5310;9611;647;0;0;0;0;.00nan;0;0
5310;72333;628;0;0;0;0;.00nan;0;0
5310;80222;647;56;22;3;19;.864;3621000;0
5311;2195;625;28;12;4;8;.667;861000;0
5311;162979;627;88;43;4;39;.907;3600000;0
5311;85441;625;60;20;1;19;.950;2697000;0
5311;145079;627;0;0;0;0;.00nan;0;0
5312;177631;641;0;0;0;0;.00nan;0;0
5312;11107;637;0;0;0;0;.00nan;0;0
5312;53861;637;92;23;0;23;1.000;3600000;0
5312;86180;641;72;35;3;32;.914;3600000;0
5313;-1;631;0;0;0;0;.00nan;0;0
5313;75313;1813;98;44;2;42;.955;3600000;0
5313;77084;631;38;22;4;18;.818;3600000;0
5313;87603;1813;0;0;0;0;.00nan;0;0
5314;8942;639;0;0;0;0;.00nan;0;0
5314;86485;639;60;32;4;28;.875;3600000;0
5314;152478;1814;28;30;6;24;.800;2171000;0
5314;159912;1814;68;14;0;14;1.000;1354000;0
5315;8426;629;78;29;2;27;.931;3600000;0
5315;17371;642;62;37;5;32;.865;3600000;0
5315;169552;642;0;0;0;0;.00nan;0;0
5315;85644;629;0;0;0;0;.00nan;0;0
5316;40;636;0;0;0;0;.00nan;0;0
5316;20122;646;0;0;0;0;.00nan;0;0
5316;43064;646;54;36;5;31;.861;3600000;0
5316;73274;636;71;15;1;14;.933;3600000;0
5317;177631;641;0;0;0;0;.00nan;0;0
5317;8426;629;71;37;4;33;.892;3566000;0
5317;85644;629;0;0;0;0;.00nan;0;0
5317;86180;641;84;34;2;32;.941;3600000;0
5318;2195;625;34;14;4;10;.714;3600000;0
5318;85441;625;0;0;0;0;.00nan;0;0
5318;152478;1814;40;38;6;32;.842;2973000;0
5318;159912;1814;38;10;2;8;.800;627000;0
5319;162979;627;100;27;0;27;1.000;3600000;0
5319;8942;639;0;0;0;0;.00nan;0;0
5319;86485;639;96;32;1;31;.969;3585000;0
5319;145079;627;0;0;0;0;.00nan;0;0
5320;40;636;97;54;3;51;.944;3543000;0
5320;11107;637;0;0;0;0;.00nan;0;0
5320;53861;637;64;27;2;25;.926;3600000;0
5320;73274;636;0;0;0;0;.00nan;0;0
5321;6947;628;70;26;2;24;.923;3600000;0
5321;-1;631;0;0;0;0;.00nan;0;0
5321;72333;628;0;0;0;0;.00nan;0;0
5321;77084;631;83;44;3;41;.932;3600000;0
5322;17371;642;0;0;0;0;.00nan;0;0
5322;169552;642;74;21;1;20;.952;3600000;0
5322;75313;1813;77;29;2;27;.931;3549000;0
5322;87603;1813;0;0;0;0;.00nan;0;0
5323;9611;647;0;0;0;0;.00nan;0;0
5323;20122;646;0;0;0;0;.00nan;0;0
5323;43064;646;100;39;1;38;.974;3600000;0
5323;80222;647;37;31;5;26;.839;3600000;0
5324;40;636;0;0;0;0;.00nan;0;0
5324;162979;627;56;27;3;24;.889;3569000;0
5324;73274;636;77;22;1;21;.955;3600000;0
5324;145079;627;0;0;0;0;.00nan;0;0
5325;177631;641;0;0;0;0;.00nan;0;0
5325;9611;647;0;0;0;0;.00nan;0;0
5325;80222;647;97;34;1;33;.971;3564000;0
5325;86180;641;100;27;0;27;1.000;3600000;0
5326;2195;625;23;4;3;1;.250;379000;0
5326;6947;628;53;21;3;18;.857;3600000;0
5326;72333;628;0;0;0;0;.00nan;0;0
5326;85441;625;71;41;4;37;.902;3221000;0
5327;8942;639;0;0;0;0;.00nan;0;0
5327;11107;637;0;0;0;0;.00nan;0;0
5327;53861;637;61;31;4;27;.871;3600000;0
5327;86485;639;76;30;3;27;.900;3600000;0
5328;17371;642;69;33;3;30;.909;3900000;0
5328;169552;642;0;0;0;0;.00nan;0;0
5328;-1;631;0;0;0;0;.00nan;0;0
5328;77084;631;97;39;3;36;.923;3900000;0
5329;75313;1813;0;0;0;0;.00nan;0;0
5329;87603;1813;81;37;3;34;.919;3576000;0
5329;152478;1814;77;22;1;21;.955;3600000;0
5329;159912;1814;0;0;0;0;.00nan;0;0
5330;8426;629;0;0;0;0;.00nan;0;0
5330;20122;646;0;0;0;0;.00nan;0;0
5330;43064;646;90;39;2;37;.949;3600000;0
5330;85644;629;86;41;3;38;.927;3569000;0
5331;11107;637;0;0;0;0;.00nan;0;0
5331;17371;642;63;39;4;35;.897;3600000;0
5331;169552;642;0;0;0;0;.00nan;0;0
5331;53861;637;87;32;1;31;.969;3600000;0
5332;8942;639;0;0;0;0;.00nan;0;0
5332;75313;1813;69;45;4;41;.911;3600000;0
5332;86485;639;71;18;1;17;.944;3600000;0
5332;87603;1813;0;0;0;0;.00nan;0;0
5333;6947;628;76;26;1;25;.962;3600000;0
5333;8426;629;90;39;2;37;.949;3600000;0
5333;72333;628;0;0;0;0;.00nan;0;0
5333;85644;629;0;0;0;0;.00nan;0;0
5334;40;636;0;0;0;0;.00nan;0;0
5334;2195;625;98;21;0;21;1.000;3600000;0
5334;73274;636;83;39;2;37;.949;3563000;0
5334;85441;625;0;0;0;0;.00nan;0;0
5335;162979;627;82;17;0;17;1.000;3600000;0
5335;-1;631;0;0;0;0;.00nan;0;0
5335;77084;631;60;34;4;30;.882;3600000;0
5335;145079;627;0;0;0;0;.00nan;0;0
5336;9611;647;0;0;0;0;.00nan;0;0
5336;80222;647;52;31;4;27;.871;3555000;0
5336;152478;1814;88;37;2;35;.946;3600000;0
5336;159912;1814;0;0;0;0;.00nan;0;0
5337;177631;641;0;0;0;0;.00nan;0;0
5337;20122;646;0;0;0;0;.00nan;0;0
5337;43064;646;34;30;6;24;.800;3600000;0
5337;86180;641;90;16;0;16;1.000;3600000;0
5338;162979;627;48;26;4;22;.846;3900000;0
5338;20122;646;0;0;0;0;.00nan;0;0
5338;43064;646;65;33;4;29;.879;3900000;0
5338;145079;627;0;0;0;0;.00nan;0;0
5339;2195;625;0;0;0;0;.00nan;0;0
5339;11107;637;0;0;0;0;.00nan;0;0
5339;53861;637;53;34;4;30;.882;3539000;0
5339;85441;625;65;21;2;19;.905;3600000;0
5340;8942;639;0;0;0;0;.00nan;0;0
5340;-1;631;51;3;0;3;1.000;241000;0
5340;77084;631;19;39;8;31;.795;3359000;0
5340;86485;639;89;31;2;29;.935;3600000;0
5341;177631;641;0;0;0;0;.00nan;0;0
5341;86180;641;69;35;4;31;.886;3600000;0
5341;152478;1814;100;34;0;34;1.000;3600000;0
5341;159912;1814;0;0;0;0;.00nan;0;0
5342;40;636;0;0;0;0;.00nan;0;0
5342;17371;642;89;31;1;30;.968;3615000;0
5342;169552;642;0;0;0;0;.00nan;0;0
5342;73274;636;61;19;2;17;.895;3615000;0
5343;8426;629;90;45;1;44;.978;3600000;0
5343;9611;647;52;20;3;17;.850;3588000;0
5343;80222;647;0;0;0;0;.00nan;0;0
5343;85644;629;0;0;0;0;.00nan;0;0
5344;6947;628;100;25;0;25;1.000;3600000;0
5344;72333;628;0;0;0;0;.00nan;0;0
5344;75313;1813;93;34;2;32;.941;3571000;0
5344;87603;1813;0;0;0;0;.00nan;0;0
5345;6947;628;90;19;0;19;1.000;3600000;0
5345;177631;641;0;0;0;0;.00nan;0;0
5345;72333;628;0;0;0;0;.00nan;0;0
5345;86180;641;34;36;7;29;.806;3600000;0
5346;40;636;0;0;0;0;.00nan;0;0
5346;8942;639;0;0;0;0;.00nan;0;0
5346;73274;636;77;39;3;36;.923;3631000;0
5346;86485;639;80;45;4;41;.911;3631000;0
5347;9611;647;45;11;2;9;.818;1381000;0
5347;-1;631;50;39;6;33;.846;3234000;0
5347;77084;631;46;3;1;2;.667;412000;0
5347;80222;647;29;27;6;21;.778;2258000;0
5348;2195;625;84;38;2;36;.947;3900000;0
5348;17371;642;68;25;2;23;.920;3900000;0
5348;169552;642;0;0;0;0;.00nan;0;0
5348;85441;625;0;0;0;0;.00nan;0;0
5349;11107;637;0;0;0;0;.00nan;0;0
5349;53861;637;68;33;3;30;.909;3544000;0
5349;75313;1813;0;0;0;0;.00nan;0;0
5349;87603;1813;94;46;2;44;.957;3600000;0
5350;20122;646;59;33;4;29;.879;3900000;0
5350;43064;646;0;0;0;0;.00nan;0;0
5350;152478;1814;68;28;4;24;.857;3900000;0
5350;159912;1814;0;0;0;0;.00nan;0;0
5351;162979;627;91;19;0;19;1.000;3600000;0
5351;8426;629;98;46;1;45;.978;3584000;0
5351;85644;629;0;0;0;0;.00nan;0;0
5351;145079;627;0;0;0;0;.00nan;0;0
5352;162979;627;100;32;0;32;1.000;3600000;0
5352;17371;642;45;29;5;24;.828;3600000;0
5352;169552;642;0;0;0;0;.00nan;0;0
5352;145079;627;0;0;0;0;.00nan;0;0
5353;11107;637;100;26;0;26;1.000;3600000;0
5353;20122;646;0;0;0;0;.00nan;0;0
5353;43064;646;89;63;5;58;.921;3600000;0
5353;53861;637;0;0;0;0;.00nan;0;0
5354;177631;641;0;0;0;0;.00nan;0;0
5354;-1;631;0;0;0;0;.00nan;0;0
5354;77084;631;80;24;1;23;.958;3900000;0
5354;86180;641;83;29;1;28;.966;3900000;0
5355;2195;625;56;27;3;24;.889;3524000;0
5355;9611;647;0;0;0;0;.00nan;0;0
5355;80222;647;100;46;1;45;.978;3600000;0
5355;85441;625;0;0;0;0;.00nan;0;0
5356;6947;628;48;24;4;20;.833;3722000;0
5356;8942;639;0;0;0;0;.00nan;0;0
5356;72333;628;0;0;0;0;.00nan;0;0
5356;86485;639;53;36;5;31;.861;3722000;0
5357;40;636;0;0;0;0;.00nan;0;0
5357;73274;636;62;16;1;15;.938;3600000;0
5357;152478;1814;68;32;3;29;.906;3535000;0
5357;159912;1814;0;0;0;0;.00nan;0;0
5358;8426;629;59;20;3;17;.850;3022000;0
5358;75313;1813;0;0;0;0;.00nan;0;0
5358;85644;629;27;7;3;4;.571;575000;0
5358;87603;1813;61;36;4;32;.889;3600000;0
5359;2195;625;54;24;3;21;.875;3534000;0
5359;8942;639;88;38;2;36;.947;3600000;0
5359;85441;625;0;0;0;0;.00nan;0;0
5359;86485;639;0;0;0;0;.00nan;0;0
5360;17371;642;78;40;4;36;.900;3600000;0
5360;169552;642;0;0;0;0;.00nan;0;0
5360;152478;1814;42;35;6;29;.829;3553000;0
5360;159912;1814;0;0;0;0;.00nan;0;0
5361;162979;627;83;35;4;31;.886;3900000;0
5361;9611;647;0;0;0;0;.00nan;0;0
5361;80222;647;54;25;4;21;.840;3900000;0
5361;145079;627;0;0;0;0;.00nan;0;0
5362;177631;641;0;0;0;0;.00nan;0;0
5362;75313;1813;0;0;0;0;.00nan;0;0
5362;86180;641;67;22;2;20;.909;3600000;0
5362;87603;1813;100;48;1;47;.979;3600000;0
5363;6947;628;39;20;4;16;.800;3572000;0
5363;20122;646;0;0;0;0;.00nan;0;0
5363;43064;646;86;41;3;38;.927;3600000;0
5363;72333;628;0;0;0;0;.00nan;0;0
5364;40;636;45;31;4;27;.871;3543000;0
5364;-1;631;0;0;0;0;.00nan;0;0
5364;73274;636;0;0;0;0;.00nan;0;0
5364;77084;631;75;37;3;34;.919;3600000;0
5365;8426;629;25;24;6;18;.750;3600000;0
5365;11107;637;80;36;3;33;.917;3600000;0
5365;53861;637;0;0;0;0;.00nan;0;0
5365;85644;629;0;0;0;0;.00nan;0;0
5366;8942;639;0;0;0;0;.00nan;0;0
5366;20122;646;0;0;0;0;.00nan;0;0
5366;43064;646;66;39;4;35;.897;3858000;0
5366;86485;639;37;26;5;21;.808;3858000;0
5367;2195;625;49;26;4;22;.846;3600000;0
5367;8426;629;73;45;6;39;.867;3271000;0
5367;85441;625;0;0;0;0;.00nan;0;0
5367;85644;629;42;5;1;4;.800;329000;0
5368;6947;628;0;0;0;0;.00nan;0;0
5368;11107;637;0;0;0;0;.00nan;0;0
5368;53861;637;59;36;5;31;.861;3900000;0
5368;72333;628;60;41;5;36;.878;3900000;0
5369;40;636;0;0;0;0;.00nan;0;0
5369;177631;641;63;12;0;12;1.000;1717000;0
5369;73274;636;80;29;2;27;.931;3600000;0
5369;86180;641;34;17;4;13;.765;1859000;0
5370;-1;631;0;0;0;0;.00nan;0;0
5370;77084;631;81;28;2;26;.929;3600000;0
5370;152478;1814;84;48;5;43;.896;3600000;0
5370;159912;1814;0;0;0;0;.00nan;0;0
5371;9611;647;0;0;0;0;.00nan;0;0
5371;17371;642;62;32;4;28;.875;3583000;0
5371;169552;642;0;0;0;0;.00nan;0;0
5371;80222;647;77;28;2;26;.929;3600000;0
5372;162979;627;54;24;4;20;.833;3600000;0
5372;75313;1813;0;0;0;0;.00nan;0;0
5372;87603;1813;82;63;7;56;.889;3600000;0
5372;145079;627;0;0;0;0;.00nan;0;0
5373;162979;627;76;26;1;25;.962;3600000;0
5373;11107;637;0;0;0;0;.00nan;0;0
5373;53861;637;89;19;0;19;1.000;3600000;0
5373;145079;627;0;0;0;0;.00nan;0;0
5374;177631;641;54;31;4;27;.871;3600000;0
5374;8942;639;0;0;0;0;.00nan;0;0
5374;86180;641;0;0;0;0;.00nan;0;0
5374;86485;639;91;30;1;29;.967;3600000;0
5375;6947;628;85;27;1;26;.963;3600000;0
5375;17371;642;53;40;6;34;.850;3600000;0
5375;169552;642;0;0;0;0;.00nan;0;0
5375;72333;628;0;0;0;0;.00nan;0;0
5376;2195;625;86;22;1;21;.955;3600000;0
5376;-1;631;0;0;0;0;.00nan;0;0
5376;77084;631;87;48;3;45;.938;3600000;0
5376;85441;625;0;0;0;0;.00nan;0;0
5377;40;636;0;0;0;0;.00nan;0;0
5377;9611;647;41;26;5;21;.808;3600000;0
5377;73274;636;82;36;3;33;.917;3600000;0
5377;80222;647;0;0;0;0;.00nan;0;0
5378;20122;646;73;26;2;24;.923;3600000;0
5378;43064;646;0;0;0;0;.00nan;0;0
5378;75313;1813;41;36;6;30;.833;3600000;0
5378;87603;1813;0;0;0;0;.00nan;0;0
5379;8426;629;100;26;0;26;1.000;3600000;0
5379;85644;629;0;0;0;0;.00nan;0;0
5379;152478;1814;98;41;1;40;.976;3600000;0
5379;159912;1814;0;0;0;0;.00nan;0;0
5380;40;636;0;0;0;0;.00nan;0;0
5380;6947;628;99;39;3;36;.923;3600000;0
5380;72333;628;0;0;0;0;.00nan;0;0
5380;73274;636;43;34;6;28;.824;3600000;0
5381;11107;637;0;0;0;0;.00nan;0;0
5381;-1;631;0;0;0;0;.00nan;0;0
5381;53861;637;61;32;4;28;.875;3600000;0
5381;77084;631;99;45;1;44;.978;3600000;0
5382;177631;641;0;0;0;0;.00nan;0;0
5382;17371;642;89;36;1;35;.972;3900000;0
5382;169552;642;0;0;0;0;.00nan;0;0
5382;86180;641;100;39;1;38;.974;3900000;0
5383;162979;627;89;28;1;27;.964;3600000;0
5383;145079;627;0;0;0;0;.00nan;0;0
5383;152478;1814;65;32;3;29;.906;3545000;0
5383;159912;1814;0;0;0;0;.00nan;0;0
5384;9611;647;0;0;0;0;.00nan;0;0
5384;75313;1813;0;0;0;0;.00nan;0;0
5384;80222;647;95;34;1;33;.971;3600000;0
5384;87603;1813;67;32;3;29;.906;3513000;0
5385;2195;625;70;17;1;16;.941;3600000;0
5385;20122;646;0;0;0;0;.00nan;0;0
5385;43064;646;72;44;4;40;.909;3600000;0
5385;85441;625;0;0;0;0;.00nan;0;0
5386;8426;629;64;29;3;26;.897;3600000;0
5386;8942;639;0;0;0;0;.00nan;0;0
5386;85644;629;0;0;0;0;.00nan;0;0
5386;86485;639;54;22;4;18;.818;3547000;0
5387;2195;625;72;26;2;24;.923;3600000;0
5387;177631;641;0;0;0;0;.00nan;0;0
5387;85441;625;0;0;0;0;.00nan;0;0
5387;86180;641;74;31;3;28;.903;3562000;0
5388;162979;627;31;28;6;22;.786;3600000;0
5388;6947;628;62;37;5;32;.865;3600000;0
5388;72333;628;0;0;0;0;.00nan;0;0
5388;145079;627;0;0;0;0;.00nan;0;0
5389;8426;629;45;39;6;33;.846;3528000;0
5389;-1;631;0;0;0;0;.00nan;0;0
5389;77084;631;80;44;4;40;.909;3600000;0
5389;85644;629;0;0;0;0;.00nan;0;0
5390;11107;637;0;0;0;0;.00nan;0;0
5390;53861;637;78;25;2;23;.920;3600000;0
5390;152478;1814;86;46;4;42;.913;3600000;0
5390;159912;1814;0;0;0;0;.00nan;0;0
5391;17371;642;61;19;2;17;.895;3600000;0
5391;20122;646;0;0;0;0;.00nan;0;0
5391;169552;642;0;0;0;0;.00nan;0;0
5391;43064;646;80;39;3;36;.923;3551000;0
5392;8942;639;0;0;0;0;.00nan;0;0
5392;9611;647;0;0;0;0;.00nan;0;0
5392;80222;647;55;28;4;24;.857;3619000;0
5392;86485;639;48;21;3;18;.857;3619000;0
5393;40;636;0;0;0;0;.00nan;0;0
5393;73274;636;66;24;2;22;.917;3600000;0
5393;75313;1813;0;0;0;0;.00nan;0;0
5393;87603;1813;60;43;5;38;.884;3600000;0
5394;9611;647;53;3;0;3;1.000;228000;0
5394;11107;637;42;24;5;19;.792;3350000;0
5394;53861;637;50;0;0;0;.00nan;250000;0
5394;80222;647;38;37;7;30;.811;3342000;0
5395;162979;627;0;0;0;0;.00nan;0;0
5395;177631;641;0;0;0;0;.00nan;0;0
5395;86180;641;94;40;2;38;.950;3669000;0
5395;145079;627;65;18;1;17;.944;3669000;0
5396;2195;625;45;21;4;17;.810;3600000;0
5396;75313;1813;0;0;0;0;.00nan;0;0
5396;85441;625;0;0;0;0;.00nan;0;0
5396;87603;1813;64;42;5;37;.881;3586000;0
5397;8942;639;0;0;0;0;.00nan;0;0
5397;17371;642;70;28;2;26;.929;3824000;0
5397;169552;642;0;0;0;0;.00nan;0;0
5397;86485;639;53;21;3;18;.857;3824000;0
5398;6947;628;70;26;2;24;.923;3600000;0
5398;72333;628;0;0;0;0;.00nan;0;0
5398;152478;1814;66;45;6;39;.867;3600000;0
5398;159912;1814;0;0;0;0;.00nan;0;0
5399;40;636;63;29;3;26;.897;3553000;0
5399;8426;629;100;40;1;39;.975;3600000;0
5399;73274;636;0;0;0;0;.00nan;0;0
5399;85644;629;0;0;0;0;.00nan;0;0
5400;20122;646;100;52;4;48;.923;3793000;0
5400;-1;631;0;0;0;0;.00nan;0;0
5400;43064;646;0;0;0;0;.00nan;0;0
5400;77084;631;56;34;5;29;.853;3793000;0
5401;2195;625;72;27;3;24;.889;3734000;0
5401;162979;627;100;46;2;44;.957;3734000;0
5401;85441;625;0;0;0;0;.00nan;0;0
5401;145079;627;0;0;0;0;.00nan;0;0
5402;40;636;0;0;0;0;.00nan;0;0
5402;8942;639;0;0;0;0;.00nan;0;0
5402;73274;636;91;51;4;47;.922;3585000;0
5402;86485;639;73;29;2;27;.931;3600000;0
5403;6947;628;94;19;0;19;1.000;3600000;0
5403;20122;646;0;0;0;0;.00nan;0;0
5403;43064;646;73;35;3;32;.914;3600000;0
5403;72333;628;0;0;0;0;.00nan;0;0
5404;-1;631;0;0;0;0;.00nan;0;0
5404;77084;631;60;28;3;25;.893;3600000;0
5404;152478;1814;63;37;5;32;.865;3542000;0
5404;159912;1814;0;0;0;0;.00nan;0;0
5405;177631;641;0;0;0;0;.00nan;0;0
5405;9611;647;83;23;1;22;.957;3576000;0
5405;80222;647;0;0;0;0;.00nan;0;0
5405;86180;641;93;19;0;19;1.000;3600000;0
5406;17371;642;79;24;1;23;.958;3600000;0
5406;169552;642;0;0;0;0;.00nan;0;0
5406;75313;1813;0;0;0;0;.00nan;0;0
5406;87603;1813;97;46;3;43;.935;3567000;0
5407;8426;629;0;0;0;0;.00nan;0;0
5407;11107;637;0;0;0;0;.00nan;0;0
5407;53861;637;74;22;2;20;.909;3600000;0
5407;85644;629;53;23;3;20;.870;3543000;0
5408;2195;625;86;17;0;17;1.000;3900000;0
5408;8426;629;97;45;0;45;1.000;3900000;0
5408;85441;625;0;0;0;0;.00nan;0;0
5408;85644;629;0;0;0;0;.00nan;0;0
5409;162979;627;68;19;1;18;.947;3600000;0
5409;145079;627;0;0;0;0;.00nan;0;0
5409;152478;1814;52;32;5;27;.844;3600000;0
5409;159912;1814;0;0;0;0;.00nan;0;0
5410;6947;628;83;34;2;32;.941;3600000;0
5410;11107;637;0;0;0;0;.00nan;0;0
5410;53861;637;63;29;3;26;.897;3594000;0
5410;72333;628;0;0;0;0;.00nan;0;0
5411;177631;641;0;0;0;0;.00nan;0;0
5411;75313;1813;0;0;0;0;.00nan;0;0
5411;86180;641;49;16;2;14;.875;3600000;0
5411;87603;1813;100;37;0;37;1.000;3600000;0
5412;8942;639;0;0;0;0;.00nan;0;0
5412;-1;631;78;22;1;21;.955;2087000;0
5412;77084;631;6;12;6;6;.500;1513000;0
5412;86485;639;84;33;2;31;.939;3600000;0
5413;9611;647;0;0;0;0;.00nan;0;0
5413;17371;642;72;37;3;34;.919;3524000;0
5413;169552;642;0;0;0;0;.00nan;0;0
5413;80222;647;74;24;1;23;.958;3600000;0
5414;40;636;0;0;0;0;.00nan;0;0
5414;20122;646;0;0;0;0;.00nan;0;0
5414;43064;646;82;44;4;40;.909;3900000;0
5414;73274;636;53;28;4;24;.857;3900000;0
5415;162979;627;69;35;3;32;.914;3900000;0
5415;9611;647;0;0;0;0;.00nan;0;0
5415;80222;647;93;46;3;43;.935;3900000;0
5415;145079;627;0;0;0;0;.00nan;0;0
5416;40;636;29;23;5;18;.783;3534000;0
5416;-1;631;0;0;0;0;.00nan;0;0
5416;73274;636;0;0;0;0;.00nan;0;0
5416;77084;631;63;28;3;25;.893;3600000;0
5417;2195;625;60;22;3;19;.864;3546000;0
5417;85441;625;0;0;0;0;.00nan;0;0
5417;152478;1814;100;69;2;67;.971;3600000;0
5417;159912;1814;0;0;0;0;.00nan;0;0
5418;8942;639;0;0;0;0;.00nan;0;0
5418;75313;1813;0;0;0;0;.00nan;0;0
5418;86485;639;96;22;0;22;1.000;3600000;0
5418;87603;1813;84;58;6;52;.897;3600000;0
5419;11107;637;0;0;0;0;.00nan;0;0
5419;20122;646;75;44;5;39;.886;3600000;0
5419;43064;646;0;0;0;0;.00nan;0;0
5419;53861;637;74;22;1;21;.955;3600000;0
5420;6947;628;71;28;2;26;.929;3554000;0
5420;8426;629;100;44;1;43;.977;3600000;0
5420;72333;628;0;0;0;0;.00nan;0;0
5420;85644;629;0;0;0;0;.00nan;0;0
5421;2195;625;100;30;0;30;1.000;3600000;0
5421;8942;639;0;0;0;0;.00nan;0;0
5421;85441;625;0;0;0;0;.00nan;0;0
5421;86485;639;75;48;5;43;.896;3600000;0
5422;177631;641;0;0;0;0;.00nan;0;0
5422;17371;642;68;29;3;26;.897;3633000;0
5422;169552;642;0;0;0;0;.00nan;0;0
5422;86180;641;82;32;2;30;.938;3633000;0
5423;8426;629;88;36;2;34;.944;3564000;0
5423;9611;647;0;0;0;0;.00nan;0;0
5423;80222;647;100;34;0;34;1.000;3600000;0
5423;85644;629;0;0;0;0;.00nan;0;0
5424;11107;637;61;22;2;20;.909;3556000;0
5424;17371;642;100;41;1;40;.976;3600000;0
5424;169552;642;0;0;0;0;.00nan;0;0
5424;53861;637;0;0;0;0;.00nan;0;0
5425;177631;641;0;0;0;0;.00nan;0;0
5425;86180;641;62;27;3;24;.889;3569000;0
5425;152478;1814;99;46;2;44;.957;3600000;0
5425;159912;1814;0;0;0;0;.00nan;0;0
5426;2195;625;66;19;2;17;.895;3600000;0
5426;20122;646;62;16;1;15;.938;763000;0
5426;43064;646;43;39;6;33;.846;2837000;0
5426;85441;625;0;0;0;0;.00nan;0;0
5427;162979;627;75;32;3;29;.906;3545000;0
5427;8942;639;0;0;0;0;.00nan;0;0
5427;86485;639;72;23;1;22;.957;3600000;0
5427;145079;627;0;0;0;0;.00nan;0;0
5428;40;636;0;0;0;0;.00nan;0;0
5428;73274;636;59;22;3;19;.864;3600000;0
5428;75313;1813;0;0;0;0;.00nan;0;0
5428;87603;1813;47;40;6;34;.850;3571000;0
5429;6947;628;53;42;5;37;.881;3513000;0
5429;-1;631;0;0;0;0;.00nan;0;0
5429;72333;628;0;0;0;0;.00nan;0;0
5429;77084;631;50;21;3;18;.857;3600000;0
5430;40;636;0;0;0;0;.00nan;0;0
5430;177631;641;0;0;0;0;.00nan;0;0
5430;73274;636;54;30;5;25;.833;3616000;0
5430;86180;641;62;29;4;25;.862;3616000;0
5431;9611;647;0;0;0;0;.00nan;0;0
5431;-1;631;0;0;0;0;.00nan;0;0
5431;77084;631;48;35;5;30;.857;3513000;0
5431;80222;647;93;42;3;39;.929;3600000;0
5432;6947;628;81;25;1;24;.960;3600000;0
5432;72333;628;0;0;0;0;.00nan;0;0
5432;152478;1814;98;42;2;40;.952;3600000;0
5432;159912;1814;0;0;0;0;.00nan;0;0
5433;11107;637;0;0;0;0;.00nan;0;0
5433;53861;637;43;28;5;23;.821;3541000;0
5433;75313;1813;92;48;4;44;.917;3600000;0
5433;87603;1813;0;0;0;0;.00nan;0;0
5434;17371;642;63;28;3;25;.893;3600000;0
5434;20122;646;65;33;4;29;.879;3582000;0
5434;169552;642;0;0;0;0;.00nan;0;0
5434;43064;646;0;0;0;0;.00nan;0;0
5435;162979;627;53;26;4;22;.846;3600000;0
5435;8426;629;46;37;5;32;.865;3564000;0
5435;85644;629;0;0;0;0;.00nan;0;0
5435;145079;627;0;0;0;0;.00nan;0;0
5436;17371;642;87;40;4;36;.900;3600000;0
5436;169552;642;0;0;0;0;.00nan;0;0
5436;152478;1814;75;40;5;35;.875;3594000;0
5436;159912;1814;0;0;0;0;.00nan;0;0
5437;8426;629;12;17;6;11;.647;3600000;0
5437;75313;1813;0;0;0;0;.00nan;0;0
5437;85644;629;0;0;0;0;.00nan;0;0
5437;87603;1813;99;46;1;45;.978;3600000;0
5438;8942;639;0;0;0;0;.00nan;0;0
5438;20122;646;0;0;0;0;.00nan;0;0
5438;43064;646;98;51;4;47;.922;3586000;0
5438;86485;639;61;18;2;16;.889;3600000;0
5439;162979;627;0;0;0;0;.00nan;0;0
5439;-1;631;0;0;0;0;.00nan;0;0
5439;77084;631;76;26;1;25;.962;3600000;0
5439;145079;627;53;32;4;28;.875;3600000;0
5440;2195;625;50;30;4;26;.867;3562000;0
5440;6947;628;74;29;2;27;.931;3600000;0
5440;72333;628;0;0;0;0;.00nan;0;0
5440;85441;625;0;0;0;0;.00nan;0;0
5441;9611;647;0;0;0;0;.00nan;0;0
5441;20122;646;0;0;0;0;.00nan;0;0
5441;43064;646;94;35;3;32;.914;3770000;0
5441;80222;647;91;37;2;35;.946;3770000;0
5442;177631;641;58;7;0;7;1.000;1024000;0
5442;8426;629;76;36;3;33;.917;3600000;0
5442;85644;629;0;0;0;0;.00nan;0;0
5442;86180;641;27;28;6;22;.786;2576000;0
5443;8942;639;72;29;2;27;.931;3900000;0
5443;11107;637;0;0;0;0;.00nan;0;0
5443;53861;637;75;30;2;28;.933;3900000;0
5443;86485;639;0;0;0;0;.00nan;0;0
5444;75313;1813;54;33;4;29;.879;3600000;0
5444;87603;1813;0;0;0;0;.00nan;0;0
5444;152478;1814;100;40;1;39;.975;3600000;0
5444;159912;1814;0;0;0;0;.00nan;0;0
5445;40;636;0;0;0;0;.00nan;0;0
5445;17371;642;71;33;3;30;.909;3557000;0
5445;169552;642;0;0;0;0;.00nan;0;0
5445;73274;636;75;21;1;20;.952;3600000;0
5446;2195;625;95;21;0;21;1.000;3600000;0
5446;9611;647;0;0;0;0;.00nan;0;0
5446;80222;647;85;53;5;48;.906;3600000;0
5446;85441;625;0;0;0;0;.00nan;0;0
5447;11107;637;0;0;0;0;.00nan;0;0
5447;53861;637;51;15;2;13;.867;3600000;0
5447;152478;1814;38;26;5;21;.808;1843000;0
5447;159912;1814;75;25;1;24;.960;1757000;0
5448;6947;628;85;25;1;24;.960;3600000;0
5448;8942;639;0;0;0;0;.00nan;0;0
5448;72333;628;0;0;0;0;.00nan;0;0
5448;86485;639;53;30;4;26;.867;3600000;0
5449;40;636;74;34;2;32;.941;3600000;0
5449;162979;627;92;22;0;22;1.000;3600000;0
5449;73274;636;0;0;0;0;.00nan;0;0
5449;145079;627;0;0;0;0;.00nan;0;0
5450;177631;641;0;0;0;0;.00nan;0;0
5450;-1;631;100;34;2;32;.941;3900000;0
5450;77084;631;0;0;0;0;.00nan;0;0
5450;86180;641;97;39;2;37;.949;3900000;0
5451;20122;646;0;0;0;0;.00nan;0;0
5451;43064;646;91;34;1;33;.971;3600000;0
5451;75313;1813;0;0;0;0;.00nan;0;0
5451;87603;1813;93;55;3;52;.945;3600000;0
5452;8426;629;79;25;1;24;.960;3600000;0
5452;17371;642;74;36;3;33;.917;3531000;0
5452;169552;642;0;0;0;0;.00nan;0;0
5452;85644;629;0;0;0;0;.00nan;0;0
5453;2195;625;79;41;3;38;.927;3900000;0
5453;-1;631;0;0;0;0;.00nan;0;0
5453;77084;631;100;48;3;45;.938;3900000;0
5453;85441;625;0;0;0;0;.00nan;0;0
5454;8942;639;0;0;0;0;.00nan;0;0
5454;17371;642;92;42;3;39;.929;3600000;0
5454;169552;642;0;0;0;0;.00nan;0;0
5454;86485;639;47;23;4;19;.826;3600000;0
5455;8426;629;100;32;0;32;1.000;3600000;0
5455;85644;629;0;0;0;0;.00nan;0;0
5455;152478;1814;97;44;3;41;.932;3600000;0
5455;159912;1814;0;0;0;0;.00nan;0;0
5456;162979;627;34;22;5;17;.773;3544000;0
5456;75313;1813;88;53;4;49;.925;3600000;0
5456;87603;1813;0;0;0;0;.00nan;0;0
5456;145079;627;0;0;0;0;.00nan;0;0
5457;2195;625;41;25;5;20;.800;3600000;0
5457;177631;641;51;43;6;37;.860;3574000;0
5457;85441;625;0;0;0;0;.00nan;0;0
5457;86180;641;0;0;0;0;.00nan;0;0
5458;40;636;0;0;0;0;.00nan;0;0
5458;11107;637;0;0;0;0;.00nan;0;0
5458;53861;637;55;43;6;37;.860;3600000;0
5458;73274;636;86;30;2;28;.933;3600000;0
5459;6947;628;87;29;1;28;.966;3600000;0
5459;9611;647;27;30;6;24;.800;2397000;0
5459;72333;628;0;0;0;0;.00nan;0;0
5459;80222;647;71;16;0;16;1.000;1203000;0
5460;20122;646;41;34;6;28;.824;2440000;0
5460;-1;631;0;0;0;0;.00nan;0;0
5460;43064;646;50;9;1;8;.889;1160000;0
5460;77084;631;75;31;2;29;.935;3600000;0
5461;162979;627;97;31;1;30;.968;3600000;0
5461;6947;628;56;26;3;23;.885;3600000;0
5461;72333;628;0;0;0;0;.00nan;0;0
5461;145079;627;0;0;0;0;.00nan;0;0
5462;11107;637;0;0;0;0;.00nan;0;0
5462;-1;631;0;0;0;0;.00nan;0;0
5462;53861;637;100;40;1;39;.975;3900000;0
5462;77084;631;96;36;1;35;.972;3900000;0
5463;2195;625;43;20;4;16;.800;2309000;0
5463;17371;642;65;28;4;24;.857;3600000;0
5463;169552;642;0;0;0;0;.00nan;0;0
5463;85441;625;55;12;1;11;.917;1291000;0
5464;8942;639;0;0;0;0;.00nan;0;0
5464;86485;639;67;20;2;18;.900;3600000;0
5464;152478;1814;98;54;3;51;.944;3563000;0
5464;159912;1814;0;0;0;0;.00nan;0;0
5465;9611;647;0;0;0;0;.00nan;0;0
5465;75313;1813;0;0;0;0;.00nan;0;0
5465;80222;647;81;39;3;36;.923;3568000;0
5465;87603;1813;100;42;2;40;.952;3600000;0
5466;177631;641;0;0;0;0;.00nan;0;0
5466;20122;646;0;0;0;0;.00nan;0;0
5466;43064;646;99;35;2;33;.943;3600000;0
5466;86180;641;74;30;3;27;.900;3555000;0
5467;40;636;0;0;0;0;.00nan;0;0
5467;8426;629;68;24;2;22;.917;3600000;0
5467;73274;636;76;40;3;37;.925;3555000;0
5467;85644;629;0;0;0;0;.00nan;0;0
5468;6947;628;56;22;2;20;.909;3572000;0
5468;177631;641;0;0;0;0;.00nan;0;0
5468;72333;628;0;0;0;0;.00nan;0;0
5468;86180;641;76;19;1;18;.947;3600000;0
5469;40;636;92;29;1;28;.966;3600000;0
5469;9611;647;0;0;0;0;.00nan;0;0
5469;73274;636;0;0;0;0;.00nan;0;0
5469;80222;647;69;20;2;18;.900;3600000;0
5470;162979;627;66;17;1;16;.941;3600000;0
5470;11107;637;0;0;0;0;.00nan;0;0
5470;53861;637;43;28;5;23;.821;3600000;0
5470;145079;627;0;0;0;0;.00nan;0;0
5471;162979;627;69;26;3;23;.885;3600000;0
5471;20122;646;0;0;0;0;.00nan;0;0
5471;43064;646;36;43;7;36;.837;3600000;0
5471;145079;627;0;0;0;0;.00nan;0;0
5472;177631;641;0;0;0;0;.00nan;0;0
5472;11107;637;0;0;0;0;.00nan;0;0
5472;53861;637;70;22;2;20;.909;3600000;0
5472;86180;641;57;36;5;31;.861;3600000;0
5473;40;636;0;0;0;0;.00nan;0;0
5473;6947;628;0;0;0;0;.00nan;0;0
5473;72333;628;83;25;1;24;.960;3600000;0
5473;73274;636;77;30;2;28;.933;3565000;0
5474;17371;642;78;40;3;37;.925;3600000;0
5474;169552;642;0;0;0;0;.00nan;0;0
5474;-1;631;0;0;0;0;.00nan;0;0
5474;77084;631;100;32;0;32;1.000;3600000;0
5475;9611;647;0;0;0;0;.00nan;0;0
5475;80222;647;70;36;4;32;.889;3684000;0
5475;152478;1814;0;0;0;0;.00nan;0;0
5475;159912;1814;46;31;5;26;.839;3631000;0
5476;2195;625;77;30;2;28;.933;3900000;0
5476;75313;1813;96;52;2;50;.962;3900000;0
5476;85441;625;0;0;0;0;.00nan;0;0
5476;87603;1813;0;0;0;0;.00nan;0;0
5477;8426;629;0;0;0;0;.00nan;0;0
5477;8942;639;0;0;0;0;.00nan;0;0
5477;85644;629;56;23;3;20;.870;3600000;0
5477;86485;639;26;29;6;23;.793;3600000;0
5478;2195;625;80;28;2;26;.929;3600000;0
5478;11107;637;0;0;0;0;.00nan;0;0
5478;53861;637;42;27;5;22;.815;3600000;0
5478;85441;625;0;0;0;0;.00nan;0;0
5479;162979;627;82;26;1;25;.962;3600000;0
5479;177631;641;0;0;0;0;.00nan;0;0
5479;86180;641;78;24;2;22;.917;3593000;0
5479;145079;627;0;0;0;0;.00nan;0;0
5480;6947;628;96;30;1;29;.967;3600000;0
5480;17371;642;80;42;3;39;.929;3589000;0
5480;169552;642;0;0;0;0;.00nan;0;0
5480;72333;628;0;0;0;0;.00nan;0;0
5481;40;636;0;0;0;0;.00nan;0;0
5481;73274;636;65;20;1;19;.950;3600000;0
5481;152478;1814;73;41;4;37;.902;3600000;0
5481;159912;1814;0;0;0;0;.00nan;0;0
5482;-1;631;0;0;0;0;.00nan;0;0
5482;75313;1813;0;0;0;0;.00nan;0;0
5482;77084;631;73;24;1;23;.958;3600000;0
5482;87603;1813;43;38;7;31;.816;3600000;0
5483;8942;639;71;14;0;14;1.000;1501000;0
5483;9611;647;0;0;0;0;.00nan;0;0
5483;80222;647;44;26;5;21;.808;3600000;0
5483;86485;639;15;20;6;14;.700;2087000;0
5484;8426;629;51;35;5;30;.857;3600000;0
5484;20122;646;0;0;0;0;.00nan;0;0
5484;43064;646;75;25;2;23;.920;3600000;0
5484;85644;629;0;0;0;0;.00nan;0;0
5485;40;636;0;0;0;0;.00nan;0;0
5485;2195;625;38;21;4;17;.810;3595000;0
5485;73274;636;94;41;2;39;.951;3600000;0
5485;85441;625;0;0;0;0;.00nan;0;0
5486;177631;641;0;0;0;0;.00nan;0;0
5486;8942;639;0;0;0;0;.00nan;0;0
5486;86180;641;66;29;3;26;.897;3900000;0
5486;86485;639;70;31;3;28;.903;3900000;0
5487;6947;628;83;37;2;35;.946;3543000;0
5487;72333;628;0;0;0;0;.00nan;0;0
5487;75313;1813;83;28;1;27;.964;3600000;0
5487;87603;1813;0;0;0;0;.00nan;0;0
5488;20122;646;0;0;0;0;.00nan;0;0
5488;43064;646;74;42;5;37;.881;3600000;0
5488;152478;1814;87;31;2;29;.935;3600000;0
5488;159912;1814;0;0;0;0;.00nan;0;0
5489;162979;627;54;23;3;20;.870;3600000;0
5489;17371;642;0;0;0;0;.00nan;0;0
5489;169552;642;59;40;6;34;.850;3600000;0
5489;145079;627;0;0;0;0;.00nan;0;0
5490;9611;647;0;0;0;0;.00nan;0;0
5490;11107;637;0;0;0;0;.00nan;0;0
5490;53861;637;77;31;2;29;.935;3600000;0
5490;80222;647;49;19;3;16;.842;3597000;0
5491;8426;629;88;39;3;36;.923;3563000;0
5491;-1;631;0;0;0;0;.00nan;0;0
5491;77084;631;66;21;2;19;.905;3600000;0
5491;85644;629;0;0;0;0;.00nan;0;0
5493;3821;625;0;0;0;0;.00nan;0;0
5493;9611;647;0;0;0;0;.00nan;0;0
5493;80222;647;72;46;5;41;.891;3600000;0
5493;151728;625;88;19;0;19;1.000;3600000;0
5495;162979;627;88;38;3;35;.921;3900000;0
5495;6947;628;63;22;3;19;.864;3900000;0
5495;72333;628;0;0;0;0;.00nan;0;0
5495;145079;627;0;0;0;0;.00nan;0;0
5497;8426;629;0;0;0;0;.00nan;0;0
5497;8942;639;0;0;0;0;.00nan;0;0
5497;85644;629;99;55;2;53;.964;3600000;0
5497;86485;639;42;16;3;13;.813;3554000;0
5499;177631;641;0;0;0;0;.00nan;0;0
5499;18965;631;53;26;4;22;.846;3600000;0
5499;77084;631;0;0;0;0;.00nan;0;0
5499;86180;641;58;39;5;34;.872;3585000;0
5501;17371;642;73;22;1;21;.955;3600000;0
5501;20122;646;0;0;0;0;.00nan;0;0
5501;169552;642;0;0;0;0;.00nan;0;0
5501;43064;646;77;39;3;36;.923;3600000;0
5503;11107;637;0;0;0;0;.00nan;0;0
5503;53861;637;66;28;2;26;.929;3600000;0
5503;75313;1813;66;29;3;26;.897;3594000;0
5503;87603;1813;0;0;0;0;.00nan;0;0
5505;40;636;0;0;0;0;.00nan;0;0
5505;73274;636;74;42;3;39;.929;3600000;0
5505;152478;1814;93;25;1;24;.960;3600000;0
5505;159912;1814;0;0;0;0;.00nan;0;0
5507;17371;642;0;0;0;0;.00nan;0;0
5507;18965;631;53;10;1;9;.900;802000;0
5507;169552;642;98;27;0;27;1.000;3600000;0
5507;77084;631;36;36;6;30;.833;2798000;0
5509;162979;627;0;0;0;0;.00nan;0;0
5509;9611;647;98;52;3;49;.942;3579000;0
5509;80222;647;0;0;0;0;.00nan;0;0
5509;145079;627;72;26;2;24;.923;3600000;0
5511;40;636;89;42;3;39;.929;3900000;0
5511;6947;628;0;0;0;0;.00nan;0;0
5511;72333;628;57;29;3;26;.897;3900000;0
5511;73274;636;0;0;0;0;.00nan;0;0
5513;75313;1813;0;0;0;0;.00nan;0;0
5513;87603;1813;93;50;4;46;.920;3751000;0
5513;152478;1814;0;0;0;0;.00nan;0;0
5513;159912;1814;66;36;3;33;.917;3751000;0
5515;3821;625;0;0;0;0;.00nan;0;0
5515;11107;637;34;47;8;39;.830;3198000;0
5515;53861;637;62;9;0;9;1.000;402000;0
5515;151728;625;73;26;2;24;.923;3600000;0
5517;177631;641;0;0;0;0;.00nan;0;0
5517;8942;639;34;23;5;18;.783;3600000;0
5517;86180;641;88;37;2;35;.946;3600000;0
5517;86485;639;0;0;0;0;.00nan;0;0
5519;8426;629;48;31;4;27;.871;3600000;0
5519;20122;646;100;29;0;29;1.000;3600000;0
5519;43064;646;0;0;0;0;.00nan;0;0
5519;85644;629;0;0;0;0;.00nan;0;0
5521;3821;625;27;31;7;24;.774;3600000;0
5521;18965;631;68;30;3;27;.900;3600000;0
5521;77084;631;0;0;0;0;.00nan;0;0
5521;151728;625;0;0;0;0;.00nan;0;0
5523;17371;642;0;0;0;0;.00nan;0;0
5523;20122;646;93;37;2;35;.946;3516000;0
5523;169552;642;91;21;0;21;1.000;3600000;0
5523;43064;646;0;0;0;0;.00nan;0;0
5525;40;636;0;0;0;0;.00nan;0;0
5525;11107;637;0;0;0;0;.00nan;0;0
5525;53861;637;55;38;5;33;.868;3600000;0
5525;73274;636;100;29;0;29;1.000;3600000;0
5527;162979;627;48;22;3;19;.864;3600000;0
5527;9611;647;0;0;0;0;.00nan;0;0
5527;80222;647;78;37;4;33;.892;3600000;0
5527;145079;627;0;0;0;0;.00nan;0;0
5529;75313;1813;43;3;1;2;.667;437000;0
5529;87603;1813;37;37;6;31;.838;3163000;0
5529;152478;1814;79;33;2;31;.939;3600000;0
5529;159912;1814;0;0;0;0;.00nan;0;0
5531;6947;628;56;31;3;28;.903;3600000;0
5531;8942;639;0;0;0;0;.00nan;0;0
5531;72333;628;0;0;0;0;.00nan;0;0
5531;86485;639;77;24;1;23;.958;3600000;0
5533;177631;641;0;0;0;0;.00nan;0;0
5533;8426;629;0;0;0;0;.00nan;0;0
5533;85644;629;29;20;5;15;.750;3528000;0
5533;86180;641;83;40;3;37;.925;3600000;0
5535;40;636;0;0;0;0;.00nan;0;0
5535;73274;636;76;16;1;15;.938;3600000;0
5535;75313;1813;98;49;2;47;.959;3599000;0
5535;87603;1813;0;0;0;0;.00nan;0;0
5537;177631;641;0;0;0;0;.00nan;0;0
5537;17371;642;67;28;3;25;.893;3527000;0
5537;169552;642;0;0;0;0;.00nan;0;0
5537;86180;641;80;26;1;25;.962;3600000;0
5539;18965;631;0;0;0;0;.00nan;0;0
5539;77084;631;58;35;4;31;.886;3591000;0
5539;152478;1814;0;0;0;0;.00nan;0;0
5539;159912;1814;62;25;3;22;.880;3600000;0
5541;11107;637;38;31;5;26;.839;3600000;0
5541;20122;646;0;0;0;0;.00nan;0;0
5541;43064;646;100;30;0;30;1.000;3600000;0
5541;53861;637;0;0;0;0;.00nan;0;0
5543;162979;627;0;0;0;0;.00nan;0;0
5543;9611;647;30;32;6;26;.813;3574000;0
5543;80222;647;0;0;0;0;.00nan;0;0
5543;145079;627;70;29;3;26;.897;3600000;0
5545;3821;625;0;0;0;0;.00nan;0;0
5545;8426;629;97;47;3;44;.936;3583000;0
5545;85644;629;0;0;0;0;.00nan;0;0
5545;151728;625;75;21;1;20;.952;3600000;0
5547;6947;628;0;0;0;0;.00nan;0;0
5547;8942;639;82;40;4;36;.900;3600000;0
5547;72333;628;68;20;1;19;.950;3600000;0
5547;86485;639;0;0;0;0;.00nan;0;0
5549;162979;627;39;24;4;20;.833;3600000;0
5549;9611;647;0;0;0;0;.00nan;0;0
5549;80222;647;31;28;6;22;.786;3553000;0
5549;145079;627;0;0;0;0;.00nan;0;0
5551;8942;639;0;0;0;0;.00nan;0;0
5551;86485;639;89;17;0;17;1.000;3600000;0
5551;152478;1814;41;37;6;31;.838;3600000;0
5551;159912;1814;0;0;0;0;.00nan;0;0
5553;6947;628;99;42;1;41;.976;3600000;0
5553;11107;637;0;0;0;0;.00nan;0;0
5553;53861;637;59;23;2;21;.913;3585000;0
5553;72333;628;0;0;0;0;.00nan;0;0
5555;177631;641;0;0;0;0;.00nan;0;0
5555;75313;1813;0;0;0;0;.00nan;0;0
5555;86180;641;69;26;2;24;.923;3546000;0
5555;87603;1813;80;22;1;21;.955;3600000;0
5557;18965;631;0;0;0;0;.00nan;0;0
5557;20122;646;0;0;0;0;.00nan;0;0
5557;43064;646;61;43;5;38;.884;3726000;0
5557;77084;631;28;29;6;23;.793;3726000;0
5559;3821;625;88;17;0;17;1.000;3600000;0
5559;8426;629;0;0;0;0;.00nan;0;0
5559;85644;629;90;39;3;36;.923;3600000;0
5559;151728;625;0;0;0;0;.00nan;0;0
5561;40;636;0;0;0;0;.00nan;0;0
5561;17371;642;49;27;4;23;.852;3619000;0
5561;169552;642;0;0;0;0;.00nan;0;0
5561;73274;636;79;31;3;28;.903;3619000;0
5563;40;636;72;23;1;22;.957;3600000;0
5563;8426;629;54;40;5;35;.875;3600000;0
5563;73274;636;0;0;0;0;.00nan;0;0
5563;85644;629;0;0;0;0;.00nan;0;0
5565;3821;625;63;11;1;10;.909;3600000;0
5565;18965;631;97;56;3;53;.946;3530000;0
5565;77084;631;0;0;0;0;.00nan;0;0
5565;151728;625;0;0;0;0;.00nan;0;0
5567;6947;628;0;0;0;0;.00nan;0;0
5567;72333;628;50;20;3;17;.850;3600000;0
5567;75313;1813;79;50;5;45;.900;3568000;0
5567;87603;1813;0;0;0;0;.00nan;0;0
5569;9611;647;73;26;2;24;.923;3600000;0
5569;20122;646;57;30;5;25;.833;3600000;0
5569;43064;646;0;0;0;0;.00nan;0;0
5569;80222;647;0;0;0;0;.00nan;0;0
5571;17371;642;0;0;0;0;.00nan;0;0
5571;169552;642;75;32;2;30;.938;3600000;0
5571;152478;1814;0;0;0;0;.00nan;0;0
5571;159912;1814;66;31;3;28;.903;3550000;0
5573;8942;639;0;0;0;0;.00nan;0;0
5573;11107;637;90;42;1;41;.976;3900000;0
5573;53861;637;0;0;0;0;.00nan;0;0
5573;86485;639;96;30;1;29;.967;3900000;0
5575;162979;627;0;0;0;0;.00nan;0;0
5575;177631;641;0;0;0;0;.00nan;0;0
5575;86180;641;64;24;3;21;.875;3531000;0
5575;145079;627;69;18;1;17;.944;3600000;0
5577;3821;625;0;0;0;0;.00nan;0;0
5577;151728;625;85;31;2;29;.935;3900000;0
5577;152478;1814;97;37;2;35;.946;3900000;0
5577;159912;1814;0;0;0;0;.00nan;0;0
5579;6947;628;100;31;0;31;1.000;3600000;0
5579;8426;629;0;0;0;0;.00nan;0;0
5579;72333;628;0;0;0;0;.00nan;0;0
5579;85644;629;73;40;3;37;.925;3600000;0
5581;177631;641;0;0;0;0;.00nan;0;0
5581;18965;631;11;27;7;20;.741;3600000;0
5581;77084;631;0;0;0;0;.00nan;0;0
5581;86180;641;37;12;3;9;.750;3600000;0
5583;40;636;0;0;0;0;.00nan;0;0
5583;8942;639;0;0;0;0;.00nan;0;0
5583;73274;636;70;41;5;36;.878;3600000;0
5583;86485;639;96;35;1;34;.971;3600000;0
5585;162979;627;61;32;3;29;.906;3591000;0
5585;17371;642;80;26;2;24;.923;3600000;0
5585;169552;642;0;0;0;0;.00nan;0;0
5585;145079;627;0;0;0;0;.00nan;0;0
5587;20122;646;0;0;0;0;.00nan;0;0
5587;43064;646;80;38;3;35;.921;3600000;0
5587;75313;1813;0;0;0;0;.00nan;0;0
5587;87603;1813;98;21;0;21;1.000;3600000;0
5589;9611;647;0;0;0;0;.00nan;0;0
5589;11107;637;0;0;0;0;.00nan;0;0
5589;53861;637;74;26;2;24;.923;3544000;0
5589;80222;647;100;50;1;49;.980;3600000;0
1198;8426;629;93;39;2;37;.949;3600000;0
1198;11107;637;0;0;0;0;.00nan;0;0
1198;53861;637;65;17;1;16;.941;3600000;0
1198;85644;629;0;0;0;0;.00nan;0;0
1199;9611;647;0;0;0;0;.00nan;0;0
1199;17371;642;81;32;2;30;.938;3600000;0
1199;169552;642;0;0;0;0;.00nan;0;0
1199;80222;647;82;30;3;27;.900;3567000;0
1200;8426;629;58;41;6;35;.854;3069000;0
1200;11107;637;0;0;0;0;.00nan;0;0
1200;53861;637;81;20;1;19;.950;3600000;0
1200;85644;629;51;2;0;2;1.000;531000;0
1201;9611;647;0;0;0;0;.00nan;0;0
1201;17371;642;53;25;3;22;.880;3600000;0
1201;169552;642;0;0;0;0;.00nan;0;0
1201;80222;647;58;29;4;25;.862;3561000;0
1341;162979;627;82;35;1;34;.971;3845000;0
1341;17371;642;86;34;2;32;.941;3845000;0
1341;169552;642;0;0;0;0;.00nan;0;0
1341;145079;627;0;0;0;0;.00nan;0;0
1342;8942;639;0;0;0;0;.00nan;0;0
1342;-1;631;0;0;0;0;.00nan;0;0
1342;77084;631;100;27;0;27;1.000;3600000;0
1342;86485;639;72;43;5;38;.884;3600000;0
1343;40;636;0;0;0;0;.00nan;0;0
1343;2195;625;67;22;2;20;.909;3600000;0
1343;73274;636;82;44;4;40;.909;3514000;0
1343;85441;625;0;0;0;0;.00nan;0;0
1344;6947;628;71;42;4;38;.905;3551000;0
1344;11107;637;0;0;0;0;.00nan;0;0
1344;53861;637;88;38;3;35;.921;3600000;0
1344;72333;628;0;0;0;0;.00nan;0;0
1345;162979;627;76;24;1;23;.958;3600000;0
1345;17371;642;66;52;6;46;.885;3600000;0
1345;169552;642;0;0;0;0;.00nan;0;0
1345;145079;627;0;0;0;0;.00nan;0;0
1346;8942;639;0;0;0;0;.00nan;0;0
1346;-1;631;0;0;0;0;.00nan;0;0
1346;77084;631;57;24;3;21;.875;3600000;0
1346;86485;639;57;40;6;34;.850;3600000;0
1347;40;636;0;0;0;0;.00nan;0;0
1347;2195;625;79;24;1;23;.958;3600000;0
1347;73274;636;90;36;2;34;.944;3574000;0
1347;85441;625;0;0;0;0;.00nan;0;0
1348;6947;628;71;29;2;27;.931;3553000;0
1348;11107;637;0;0;0;0;.00nan;0;0
1348;53861;637;78;24;1;23;.958;3600000;0
1348;72333;628;0;0;0;0;.00nan;0;0
1349;162979;627;68;22;2;20;.909;3600000;0
1349;17371;642;75;36;4;32;.889;3600000;0
1349;169552;642;0;0;0;0;.00nan;0;0
1349;145079;627;0;0;0;0;.00nan;0;0
1350;8942;639;0;0;0;0;.00nan;0;0
1350;-1;631;0;0;0;0;.00nan;0;0
1350;77084;631;85;32;2;30;.938;3636000;0
1350;86485;639;67;32;3;29;.906;3636000;0
1351;40;636;0;0;0;0;.00nan;0;0
1351;2195;625;78;29;2;27;.931;3600000;0
1351;73274;636;37;33;6;27;.818;3600000;0
1351;85441;625;0;0;0;0;.00nan;0;0
1352;6947;628;80;40;3;37;.925;3600000;0
1352;11107;637;60;7;0;7;1.000;951000;0
1352;53861;637;30;28;6;22;.786;2649000;0
1352;72333;628;0;0;0;0;.00nan;0;0
1353;162979;627;92;17;0;17;1.000;3600000;0
1353;17371;642;58;28;3;25;.893;3600000;0
1353;169552;642;0;0;0;0;.00nan;0;0
1353;145079;627;0;0;0;0;.00nan;0;0
1354;8942;639;0;0;0;0;.00nan;0;0
1354;-1;631;0;0;0;0;.00nan;0;0
1354;77084;631;63;21;2;19;.905;3572000;0
1354;86485;639;100;37;0;37;1.000;3600000;0
1355;40;636;0;0;0;0;.00nan;0;0
1355;2195;625;78;35;3;32;.914;3600000;0
1355;73274;636;36;31;5;26;.839;3536000;0
1355;85441;625;0;0;0;0;.00nan;0;0
1356;6947;628;53;36;4;32;.889;3600000;0
1356;11107;637;0;0;0;0;.00nan;0;0
1356;53861;637;83;16;0;16;1.000;3600000;0
1356;72333;628;0;0;0;0;.00nan;0;0
1639;8942;639;0;0;0;0;.00nan;0;0
1639;-1;631;0;0;0;0;.00nan;0;0
1639;77084;631;71;18;1;17;.944;3600000;0
1639;86485;639;67;39;4;35;.897;3600000;0
1640;6947;628;78;44;5;39;.886;3586000;0
1640;11107;637;0;0;0;0;.00nan;0;0
1640;53861;637;46;24;4;20;.833;3600000;0
1640;72333;628;0;0;0;0;.00nan;0;0
1691;162979;627;63;36;4;32;.889;4182000;0
1691;11107;637;0;0;0;0;.00nan;0;0
1691;53861;637;61;27;3;24;.889;4182000;0
1691;145079;627;0;0;0;0;.00nan;0;0
1692;2195;625;76;34;3;31;.912;3600000;0
1692;-1;631;51;10;1;9;.900;1391000;0
1692;77084;631;22;20;5;15;.750;2209000;0
1692;85441;625;0;0;0;0;.00nan;0;0
1693;162979;627;80;28;1;27;.964;3600000;0
1693;11107;637;0;0;0;0;.00nan;0;0
1693;53861;637;44;27;5;22;.815;3600000;0
1693;145079;627;0;0;0;0;.00nan;0;0
1694;2195;625;74;44;4;40;.909;3544000;0
1694;-1;631;0;0;0;0;.00nan;0;0
1694;77084;631;78;35;3;32;.914;3600000;0
1694;85441;625;0;0;0;0;.00nan;0;0
1695;162979;627;89;34;1;33;.971;3548000;0
1695;11107;637;0;0;0;0;.00nan;0;0
1695;53861;637;98;23;0;23;1.000;3600000;0
1695;145079;627;0;0;0;0;.00nan;0;0
1696;2195;625;100;32;0;32;1.000;3600000;0
1696;-1;631;0;0;0;0;.00nan;0;0
1696;77084;631;94;33;1;32;.970;3572000;0
1696;85441;625;0;0;0;0;.00nan;0;0
1697;162979;627;63;18;1;17;.944;3600000;0
1697;11107;637;0;0;0;0;.00nan;0;0
1697;53861;637;66;26;3;23;.885;3600000;0
1697;145079;627;0;0;0;0;.00nan;0;0
1698;2195;625;81;28;1;27;.964;3600000;0
1698;-1;631;0;0;0;0;.00nan;0;0
1698;77084;631;49;32;5;27;.844;3600000;0
1698;85441;625;0;0;0;0;.00nan;0;0
1949;162979;627;82;36;2;34;.944;3542000;0
1949;11107;637;0;0;0;0;.00nan;0;0
1949;53861;637;93;20;0;20;1.000;3600000;0
1949;145079;627;0;0;0;0;.00nan;0;0
1950;2195;625;87;50;4;46;.920;3600000;0
1950;-1;631;0;0;0;0;.00nan;0;0
1950;77084;631;30;29;6;23;.793;3548000;0
1950;85441;625;0;0;0;0;.00nan;0;0
2002;162979;627;67;52;6;46;.885;3600000;0
2002;11107;637;0;0;0;0;.00nan;0;0
2002;53861;637;71;24;2;22;.917;3600000;0
2002;145079;627;0;0;0;0;.00nan;0;0
2024;2195;625;76;42;3;39;.929;3600000;0
2024;11107;637;0;0;0;0;.00nan;0;0
2024;53861;637;100;27;0;27;1.000;3600000;0
2024;85441;625;0;0;0;0;.00nan;0;0
2025;2195;625;65;17;2;15;.882;3600000;0
2025;11107;637;0;0;0;0;.00nan;0;0
2025;53861;637;54;36;4;32;.889;3540000;0
2025;85441;625;0;0;0;0;.00nan;0;0
2026;2195;625;44;34;5;29;.853;3560000;0
2026;11107;637;0;0;0;0;.00nan;0;0
2026;53861;637;67;37;4;33;.892;3600000;0
2026;85441;625;0;0;0;0;.00nan;0;0
2027;2195;625;66;48;5;43;.896;3600000;0
2027;11107;637;0;0;0;0;.00nan;0;0
2027;53861;637;68;18;1;17;.944;3600000;0
2027;85441;625;0;0;0;0;.00nan;0;0
2231;2195;625;71;34;3;31;.912;3600000;0
2231;11107;637;0;0;0;0;.00nan;0;0
2231;53861;637;57;35;4;31;.886;3600000;0
2231;85441;625;0;0;0;0;.00nan;0;0
2305;2195;625;100;37;0;37;1.000;3600000;0
2305;11107;637;0;0;0;0;.00nan;0;0
2305;53861;637;65;23;2;21;.913;3516000;0
2305;85441;625;0;0;0;0;.00nan;0;0
2387;2195;625;92;61;3;58;.951;5267000;0
2387;11107;637;0;0;0;0;.00nan;0;0
2387;53861;637;91;38;2;36;.947;5269000;0
2387;85441;625;0;0;0;0;.00nan;0;0
5590;805;832;0;0;0;0;.00nan;0;0
5590;13373;832;89;44;3;41;.932;3900000;0
5590;85453;828;73;31;3;28;.903;3900000;0
5590;85900;828;0;0;0;0;.00nan;0;0
5591;8501;836;0;0;0;0;.00nan;0;0
5591;15538;834;0;0;0;0;.00nan;0;0
5591;30431;834;99;20;0;20;1.000;3600000;0
5591;68390;836;67;52;6;46;.885;3600000;0
5592;32588;847;53;29;4;25;.862;3522000;0
5592;54017;847;0;0;0;0;.00nan;0;0
5592;85453;828;86;31;1;30;.968;3600000;0
5592;85900;828;0;0;0;0;.00nan;0;0
5593;805;832;0;0;0;0;.00nan;0;0
5593;13373;832;66;34;3;31;.912;3588000;0
5593;32404;833;0;0;0;0;.00nan;0;0
5593;53867;833;74;23;1;22;.957;3600000;0
5594;6084;829;70;24;2;22;.917;3600000;0
5594;16454;829;0;0;0;0;.00nan;0;0
5594;34325;844;0;0;0;0;.00nan;0;0
5594;148041;844;60;40;4;36;.900;3600000;0
5595;5663;848;100;22;0;22;1.000;3600000;0
5595;165723;837;66;24;2;22;.917;3544000;0
5595;19322;848;0;0;0;0;.00nan;0;0
5595;180287;837;0;0;0;0;.00nan;0;0
5596;183545;842;0;0;0;0;.00nan;0;0
5596;23433;842;57;29;4;25;.862;3600000;0
5596;48141;831;0;0;0;0;.00nan;0;0
5596;78094;831;62;26;3;23;.885;3600000;0
5597;5565;839;81;38;3;35;.921;3900000;0
5597;16838;830;65;33;3;30;.909;3900000;0
5597;47791;830;0;0;0;0;.00nan;0;0
5597;78223;839;0;0;0;0;.00nan;0;0
5598;5565;839;0;0;0;0;.00nan;0;0
5598;32404;833;0;0;0;0;.00nan;0;0
5598;53867;833;58;29;4;25;.862;3600000;0
5598;78223;839;56;38;5;33;.868;3600000;0
5599;5663;848;91;30;1;29;.967;3600000;0
5599;183545;842;0;0;0;0;.00nan;0;0
5599;19322;848;0;0;0;0;.00nan;0;0
5599;23433;842;79;33;2;31;.939;3565000;0
5600;8501;836;0;0;0;0;.00nan;0;0
5600;48141;831;0;0;0;0;.00nan;0;0
5600;68390;836;100;61;2;59;.967;3900000;0
5600;78094;831;54;18;2;16;.889;3900000;0
5601;805;832;49;26;4;22;.846;3576000;0
5601;13373;832;0;0;0;0;.00nan;0;0
5601;165723;837;59;28;3;25;.893;3600000;0
5601;180287;837;0;0;0;0;.00nan;0;0
5602;6084;829;61;27;2;25;.926;3551000;0
5602;16454;829;0;0;0;0;.00nan;0;0
5602;85453;828;0;0;0;0;.00nan;0;0
5602;85900;828;77;23;1;22;.957;3600000;0
5603;16838;830;70;16;1;15;.938;3600000;0
5603;34325;844;0;0;0;0;.00nan;0;0
5603;47791;830;0;0;0;0;.00nan;0;0
5603;148041;844;80;47;4;43;.915;3600000;0
5604;15538;834;0;0;0;0;.00nan;0;0
5604;30431;834;71;21;1;20;.952;3600000;0
5604;32588;847;52;50;7;43;.860;3600000;0
5604;54017;847;0;0;0;0;.00nan;0;0
5605;805;832;0;0;0;0;.00nan;0;0
5605;8501;836;0;0;0;0;.00nan;0;0
5605;13373;832;100;32;1;31;.969;3900000;0
5605;68390;836;97;42;1;41;.976;3900000;0
5606;32588;847;73;36;3;33;.917;3586000;0
5606;48141;831;0;0;0;0;.00nan;0;0
5606;54017;847;0;0;0;0;.00nan;0;0
5606;78094;831;66;27;2;25;.926;3600000;0
5607;6084;829;0;0;0;0;.00nan;0;0
5607;16454;829;96;38;2;36;.947;3900000;0
5607;32404;833;0;0;0;0;.00nan;0;0
5607;53867;833;85;33;2;31;.939;3900000;0
5608;34325;844;26;8;3;5;.625;449000;0
5608;85453;828;99;28;0;28;1.000;3600000;0
5608;85900;828;0;0;0;0;.00nan;0;0
5608;148041;844;75;26;1;25;.962;3151000;0
5609;5565;839;0;0;0;0;.00nan;0;0
5609;165723;837;51;27;4;23;.852;3600000;0
5609;180287;837;0;0;0;0;.00nan;0;0
5609;78223;839;92;34;1;33;.971;3600000;0
5610;183545;842;0;0;0;0;.00nan;0;0
5610;15538;834;66;39;4;35;.897;3582000;0
5610;23433;842;69;29;2;27;.931;3600000;0
5610;30431;834;0;0;0;0;.00nan;0;0
5611;5663;848;77;43;4;39;.907;3714000;0
5611;16838;830;68;32;3;29;.906;3714000;0
5611;19322;848;0;0;0;0;.00nan;0;0
5611;47791;830;0;0;0;0;.00nan;0;0
5612;5565;839;61;28;3;25;.893;3562000;0
5612;5663;848;88;34;2;32;.941;3600000;0
5612;19322;848;0;0;0;0;.00nan;0;0
5612;78223;839;0;0;0;0;.00nan;0;0
5613;8501;836;0;0;0;0;.00nan;0;0
5613;183545;842;0;0;0;0;.00nan;0;0
5613;23433;842;81;25;2;23;.920;3559000;0
5613;68390;836;100;42;0;42;1.000;3600000;0
5614;6084;829;100;36;1;35;.972;3600000;0
5614;16454;829;0;0;0;0;.00nan;0;0
5614;32588;847;50;19;3;16;.842;3537000;0
5614;54017;847;0;0;0;0;.00nan;0;0
5615;15538;834;0;0;0;0;.00nan;0;0
5615;30431;834;43;26;5;21;.808;3600000;0
5615;32404;833;90;29;1;28;.966;3600000;0
5615;53867;833;0;0;0;0;.00nan;0;0
5616;48141;831;0;0;0;0;.00nan;0;0
5616;78094;831;76;38;4;34;.895;3586000;0
5616;85453;828;0;0;0;0;.00nan;0;0
5616;85900;828;63;33;3;30;.909;3600000;0
5617;805;832;0;0;0;0;.00nan;0;0
5617;13373;832;98;16;0;16;1.000;3600000;0
5617;34325;844;0;0;0;0;.00nan;0;0
5617;148041;844;67;40;4;36;.900;3600000;0
5618;5663;848;100;26;0;26;1.000;3600000;0
5618;19322;848;0;0;0;0;.00nan;0;0
5618;32404;833;0;0;0;0;.00nan;0;0
5618;53867;833;86;30;1;29;.967;3544000;0
5619;6084;829;0;0;0;0;.00nan;0;0
5619;8501;836;0;0;0;0;.00nan;0;0
5619;16454;829;59;22;2;20;.909;3544000;0
5619;68390;836;96;31;1;30;.968;3600000;0
5620;165723;837;63;33;3;30;.909;3600000;0
5620;180287;837;0;0;0;0;.00nan;0;0
5620;85453;828;62;38;4;34;.895;3541000;0
5620;85900;828;0;0;0;0;.00nan;0;0
5621;15538;834;0;0;0;0;.00nan;0;0
5621;30431;834;95;22;0;22;1.000;3600000;0
5621;48141;831;0;0;0;0;.00nan;0;0
5621;78094;831;51;32;4;28;.875;3600000;0
5622;5565;839;0;0;0;0;.00nan;0;0
5622;34325;844;64;38;3;35;.921;3575000;0
5622;78223;839;75;12;0;12;1.000;3600000;0
5622;148041;844;0;0;0;0;.00nan;0;0
5623;183545;842;0;0;0;0;.00nan;0;0
5623;23433;842;78;26;3;23;.885;3753000;0
5623;32588;847;0;0;0;0;.00nan;0;0
5623;54017;847;96;40;2;38;.950;3753000;0
5624;805;832;0;0;0;0;.00nan;0;0
5624;13373;832;65;43;5;38;.884;3857000;0
5624;16838;830;63;33;4;29;.879;3857000;0
5624;47791;830;0;0;0;0;.00nan;0;0
5625;165723;837;0;0;0;0;.00nan;0;0
5625;16838;830;0;0;0;0;.00nan;0;0
5625;180287;837;73;25;2;23;.920;3600000;0
5625;47791;830;64;46;5;41;.891;3600000;0
5626;8501;836;73;24;1;23;.958;1348000;0
5626;68390;836;28;22;5;17;.773;2252000;0
5626;85453;828;52;22;3;19;.864;3600000;0
5626;85900;828;0;0;0;0;.00nan;0;0
5627;16838;830;55;19;2;17;.895;3600000;0
5627;32588;847;68;33;3;30;.909;3556000;0
5627;47791;830;0;0;0;0;.00nan;0;0
5627;54017;847;0;0;0;0;.00nan;0;0
5628;32404;833;0;0;0;0;.00nan;0;0
5628;34325;844;0;0;0;0;.00nan;0;0
5628;53867;833;58;19;2;17;.895;3550000;0
5628;148041;844;91;39;1;38;.974;3600000;0
5629;5565;839;0;0;0;0;.00nan;0;0
5629;48141;831;0;0;0;0;.00nan;0;0
5629;78094;831;81;34;2;32;.941;3531000;0
5629;78223;839;90;22;0;22;1.000;3600000;0
5630;805;832;0;0;0;0;.00nan;0;0
5630;13373;832;49;22;4;18;.818;3600000;0
5630;13715;848;0;0;0;0;.00nan;0;0
5630;19322;848;53;34;5;29;.853;3575000;0
5631;6084;829;84;36;2;34;.944;3600000;0
5631;15538;834;0;0;0;0;.00nan;0;0
5631;16454;829;0;0;0;0;.00nan;0;0
5631;17074;834;64;23;3;20;.870;3555000;0
5632;183545;842;0;0;0;0;.00nan;0;0
5632;165723;837;76;23;1;22;.957;3600000;0
5632;23433;842;74;32;2;30;.938;3600000;0
5632;180287;837;0;0;0;0;.00nan;0;0
5633;16838;830;84;36;2;34;.944;3600000;0
5633;47791;830;0;0;0;0;.00nan;0;0
5633;85453;828;84;45;3;42;.933;3562000;0
5633;85900;828;0;0;0;0;.00nan;0;0
5634;5565;839;0;0;0;0;.00nan;0;0
5634;32588;847;87;47;4;43;.915;3600000;0
5634;54017;847;0;0;0;0;.00nan;0;0
5634;78223;839;52;19;3;16;.842;3600000;0
5635;5663;848;0;0;0;0;.00nan;0;0
5635;6084;829;61;38;5;33;.868;3600000;0
5635;16454;829;0;0;0;0;.00nan;0;0
5635;19322;848;67;18;2;16;.889;3600000;0
5636;805;832;0;0;0;0;.00nan;0;0
5636;183545;842;0;0;0;0;.00nan;0;0
5636;13373;832;28;34;7;27;.794;3600000;0
5636;23433;842;82;36;2;34;.944;3600000;0
5637;8501;836;46;7;1;6;.857;320000;0
5637;165723;837;54;31;4;27;.871;3600000;0
5637;180287;837;0;0;0;0;.00nan;0;0
5637;68390;836;60;47;6;41;.872;3280000;0
5638;15538;834;57;21;3;18;.857;3600000;0
5638;30431;834;0;0;0;0;.00nan;0;0
5638;34325;844;87;51;5;46;.902;3540000;0
5638;148041;844;0;0;0;0;.00nan;0;0
5639;16838;830;0;0;0;0;.00nan;0;0
5639;47791;830;96;48;2;46;.958;3600000;0
5639;48141;831;0;0;0;0;.00nan;0;0
5639;78094;831;85;14;0;14;1.000;3600000;0
5640;8501;836;59;37;4;33;.892;3600000;0
5640;32404;833;0;0;0;0;.00nan;0;0
5640;53867;833;80;12;0;12;1.000;3600000;0
5640;68390;836;0;0;0;0;.00nan;0;0
5641;5663;848;70;29;2;27;.931;3600000;0
5641;19322;848;0;0;0;0;.00nan;0;0
5641;32588;847;0;0;0;0;.00nan;0;0
5641;54017;847;60;27;3;24;.889;3600000;0
5642;165723;837;0;0;0;0;.00nan;0;0
5642;180287;837;60;36;4;32;.889;3600000;0
5642;48141;831;0;0;0;0;.00nan;0;0
5642;78094;831;90;32;1;31;.969;3600000;0
5643;805;832;28;24;6;18;.750;3600000;0
5643;6084;829;0;0;0;0;.00nan;0;0
5643;13373;832;0;0;0;0;.00nan;0;0
5643;16454;829;96;26;0;26;1.000;3600000;0
5644;5565;839;68;37;4;33;.892;3651000;0
5644;15538;834;0;0;0;0;.00nan;0;0
5644;30431;834;47;30;5;25;.833;3651000;0
5644;78223;839;0;0;0;0;.00nan;0;0
5645;32404;833;0;0;0;0;.00nan;0;0
5645;53867;833;53;25;4;21;.840;3600000;0
5645;85453;828;50;40;5;35;.875;3552000;0
5645;85900;828;0;0;0;0;.00nan;0;0
5646;183545;842;72;22;1;21;.955;3600000;0
5646;23433;842;0;0;0;0;.00nan;0;0
5646;34325;844;0;0;0;0;.00nan;0;0
5646;148041;844;66;34;4;30;.882;3600000;0
5647;5565;839;0;0;0;0;.00nan;0;0
5647;6084;829;0;0;0;0;.00nan;0;0
5647;16454;829;49;23;3;20;.870;3600000;0
5647;78223;839;80;19;1;18;.947;3600000;0
5648;5663;848;66;21;3;18;.857;3900000;0
5648;8501;836;0;0;0;0;.00nan;0;0
5648;19322;848;0;0;0;0;.00nan;0;0
5648;68390;836;99;49;3;46;.939;3900000;0
5649;32404;833;66;19;1;18;.947;3600000;0
5649;32588;847;0;0;0;0;.00nan;0;0
5649;53867;833;0;0;0;0;.00nan;0;0
5649;54017;847;68;23;2;21;.913;3600000;0
5650;805;832;0;0;0;0;.00nan;0;0
5650;13373;832;63;22;2;20;.909;3600000;0
5650;85453;828;0;0;0;0;.00nan;0;0
5650;85900;828;32;20;4;16;.800;3600000;0
5651;165723;837;57;33;4;29;.879;3569000;0
5651;15538;834;0;0;0;0;.00nan;0;0
5651;30431;834;80;40;3;37;.925;3600000;0
5651;180287;837;0;0;0;0;.00nan;0;0
5652;34325;844;39;16;3;13;.813;1190000;0
5652;48141;831;0;0;0;0;.00nan;0;0
5652;78094;831;77;22;1;21;.955;3600000;0
5652;148041;844;20;23;6;17;.739;2410000;0
5653;183545;842;0;0;0;0;.00nan;0;0
5653;16838;830;50;27;4;23;.852;3600000;0
5653;23433;842;94;24;0;24;1.000;3600000;0
5653;47791;830;0;0;0;0;.00nan;0;0
5654;805;832;0;0;0;0;.00nan;0;0
5654;5565;839;0;0;0;0;.00nan;0;0
5654;13373;832;100;27;0;27;1.000;3600000;0
5654;78223;839;71;23;1;22;.957;3584000;0
5655;8501;836;0;0;0;0;.00nan;0;0
5655;32588;847;89;16;0;16;1.000;3600000;0
5655;54017;847;0;0;0;0;.00nan;0;0
5655;68390;836;46;42;7;35;.833;3600000;0
5656;5663;848;94;23;0;23;1.000;3600000;0
5656;19322;848;0;0;0;0;.00nan;0;0
5656;48141;831;0;0;0;0;.00nan;0;0
5656;78094;831;51;35;4;31;.886;3600000;0
5657;6084;829;62;40;4;36;.900;3586000;0
5657;183545;842;0;0;0;0;.00nan;0;0
5657;16454;829;0;0;0;0;.00nan;0;0
5657;23433;842;63;19;2;17;.895;3600000;0
5658;15538;834;0;0;0;0;.00nan;0;0
5658;30431;834;53;32;5;27;.844;3544000;0
5658;85453;828;56;35;4;31;.886;3600000;0
5658;85900;828;0;0;0;0;.00nan;0;0
5659;165723;837;59;12;1;11;.917;3600000;0
5659;180287;837;0;0;0;0;.00nan;0;0
5659;34325;844;0;0;0;0;.00nan;0;0
5659;148041;844;75;45;4;41;.911;3600000;0
5660;165723;837;0;0;0;0;.00nan;0;0
5660;32404;833;60;8;0;8;1.000;380000;0
5660;180287;837;78;40;3;37;.925;3600000;0
5660;53867;833;50;32;4;28;.875;3205000;0
5661;6084;829;87;43;3;40;.930;3600000;0
5661;16454;829;0;0;0;0;.00nan;0;0
5661;48141;831;82;39;2;37;.949;3600000;0
5661;78094;831;0;0;0;0;.00nan;0;0
5662;805;832;0;0;0;0;.00nan;0;0
5662;13373;832;32;31;6;25;.806;3600000;0
5662;32588;847;100;29;0;29;1.000;3600000;0
5662;54017;847;0;0;0;0;.00nan;0;0
5663;15538;834;49;23;4;19;.826;3900000;0
5663;16838;830;61;35;4;31;.886;3900000;0
5663;30431;834;0;0;0;0;.00nan;0;0
5663;47791;830;0;0;0;0;.00nan;0;0
5664;5663;848;88;25;2;23;.920;3900000;0
5664;19322;848;0;0;0;0;.00nan;0;0
5664;34325;844;97;47;2;45;.957;3900000;0
5664;148041;844;0;0;0;0;.00nan;0;0
5665;183545;842;42;31;5;26;.839;3600000;0
5665;23433;842;0;0;0;0;.00nan;0;0
5665;85453;828;0;0;0;0;.00nan;0;0
5665;85900;828;81;27;2;25;.926;3600000;0
5666;16838;830;0;0;0;0;.00nan;0;0
5666;32404;833;83;35;2;33;.943;3549000;0
5666;47791;830;91;28;1;27;.964;3600000;0
5666;53867;833;0;0;0;0;.00nan;0;0
5667;5565;839;47;37;6;31;.838;3652000;0
5667;78223;839;0;0;0;0;.00nan;0;0
5667;85453;828;35;34;7;27;.794;3628000;0
5667;85900;828;0;0;0;0;.00nan;0;0
5668;5663;848;82;48;4;44;.917;3576000;0
5668;15538;834;0;0;0;0;.00nan;0;0
5668;19322;848;0;0;0;0;.00nan;0;0
5668;30431;834;78;26;2;24;.923;3600000;0
5669;805;832;0;0;0;0;.00nan;0;0
5669;13373;832;76;29;2;27;.931;3600000;0
5669;48141;831;45;18;3;15;.833;1605000;0
5669;78094;831;38;22;4;18;.818;1995000;0
5670;165723;837;82;31;2;29;.935;3600000;0
5670;32588;847;98;51;3;48;.941;3574000;0
5670;180287;837;0;0;0;0;.00nan;0;0
5670;54017;847;0;0;0;0;.00nan;0;0
5671;6084;829;61;38;5;33;.868;3575000;0
5671;16454;829;0;0;0;0;.00nan;0;0
5671;16838;830;63;26;3;23;.885;3600000;0
5671;47791;830;0;0;0;0;.00nan;0;0
5672;8501;836;0;0;0;0;.00nan;0;0
5672;16838;830;0;0;0;0;.00nan;0;0
5672;47791;830;97;37;1;36;.973;3600000;0
5672;68390;836;68;43;5;38;.884;3600000;0
5673;32588;847;0;0;0;0;.00nan;0;0
5673;34325;844;0;0;0;0;.00nan;0;0
5673;54017;847;74;27;2;25;.926;3900000;0
5673;148041;844;100;39;2;37;.949;3900000;0
5674;32404;833;0;0;0;0;.00nan;0;0
5674;48141;831;0;0;0;0;.00nan;0;0
5674;53867;833;59;30;3;27;.900;3900000;0
5674;78094;831;92;43;3;40;.930;3900000;0
5675;6084;829;0;0;0;0;.00nan;0;0
5675;165723;837;97;34;1;33;.971;3900000;0
5675;16454;829;82;30;1;29;.967;3900000;0
5675;180287;837;0;0;0;0;.00nan;0;0
5676;805;832;58;26;3;23;.885;3600000;0
5676;13373;832;0;0;0;0;.00nan;0;0
5676;15538;834;100;34;0;34;1.000;3600000;0
5676;30431;834;0;0;0;0;.00nan;0;0
5677;5565;839;0;0;0;0;.00nan;0;0
5677;183545;842;43;4;1;3;.750;415000;0
5677;23433;842;33;35;6;29;.829;3161000;0
5677;78223;839;67;42;5;37;.881;3600000;0
5678;183545;842;50;31;4;27;.871;3543000;0
5678;23433;842;0;0;0;0;.00nan;0;0
5678;32404;833;73;33;3;30;.909;3600000;0
5678;53867;833;0;0;0;0;.00nan;0;0
5679;8501;836;57;28;5;23;.821;3556000;0
5679;34325;844;62;34;4;30;.882;3600000;0
5679;68390;836;0;0;0;0;.00nan;0;0
5679;148041;844;0;0;0;0;.00nan;0;0
5680;6084;829;26;12;4;8;.667;980000;0
5680;16454;829;66;18;1;17;.944;2620000;0
5680;32588;847;88;35;1;34;.971;3600000;0
5680;54017;847;0;0;0;0;.00nan;0;0
5681;5565;839;53;36;5;31;.861;3600000;0
5681;16838;830;100;31;0;31;1.000;3600000;0
5681;47791;830;0;0;0;0;.00nan;0;0
5681;78223;839;0;0;0;0;.00nan;0;0
5682;5663;848;89;18;0;18;1.000;3600000;0
5682;165723;837;69;27;2;25;.926;3529000;0
5682;19322;848;0;0;0;0;.00nan;0;0
5682;180287;837;0;0;0;0;.00nan;0;0
5683;183545;842;0;0;0;0;.00nan;0;0
5683;23433;842;88;46;3;43;.935;3550000;0
5683;48141;831;79;30;2;28;.933;3600000;0
5683;78094;831;0;0;0;0;.00nan;0;0
5684;805;832;0;0;0;0;.00nan;0;0
5684;13373;832;97;37;1;36;.973;3600000;0
5684;32404;833;0;0;0;0;.00nan;0;0
5684;53867;833;93;39;2;37;.949;3600000;0
5685;8501;836;0;0;0;0;.00nan;0;0
5685;15538;834;0;0;0;0;.00nan;0;0
5685;30431;834;58;11;1;10;.909;3600000;0
5685;68390;836;96;34;2;32;.941;3553000;0
5686;6084;829;90;19;0;19;1.000;3600000;0
5686;16454;829;0;0;0;0;.00nan;0;0
5686;34325;844;0;0;0;0;.00nan;0;0
5686;148041;844;73;42;4;38;.905;3600000;0
5687;8501;836;97;53;3;50;.943;3573000;0
5687;48141;831;0;0;0;0;.00nan;0;0
5687;68390;836;0;0;0;0;.00nan;0;0
5687;78094;831;60;16;1;15;.938;3600000;0
5688;15538;834;0;0;0;0;.00nan;0;0
5688;30431;834;50;18;3;15;.833;3600000;0
5688;32588;847;50;35;5;30;.857;3600000;0
5688;54017;847;0;0;0;0;.00nan;0;0
5689;5565;839;0;0;0;0;.00nan;0;0
5689;32404;833;78;23;2;21;.913;3722000;0
5689;53867;833;0;0;0;0;.00nan;0;0
5689;78223;839;64;28;3;25;.893;3722000;0
5690;6084;829;73;39;4;35;.897;3600000;0
5690;16454;829;0;0;0;0;.00nan;0;0
5690;85453;828;82;27;1;26;.963;3600000;0
5690;85900;828;0;0;0;0;.00nan;0;0
5691;5663;848;88;37;3;34;.919;3900000;0
5691;183545;842;70;29;3;26;.897;3900000;0
5691;19322;848;0;0;0;0;.00nan;0;0
5691;23433;842;0;0;0;0;.00nan;0;0
5692;32588;847;75;28;2;26;.929;3600000;0
5692;54017;847;0;0;0;0;.00nan;0;0
5692;85453;828;0;0;0;0;.00nan;0;0
5692;85900;828;72;41;4;37;.902;3600000;0
5693;805;832;0;0;0;0;.00nan;0;0
5693;13373;832;77;32;2;30;.938;3572000;0
5693;165723;837;74;22;1;21;.955;3600000;0
5693;180287;837;0;0;0;0;.00nan;0;0
5694;16838;830;72;21;1;20;.952;3600000;0
5694;34325;844;0;0;0;0;.00nan;0;0
5694;47791;830;0;0;0;0;.00nan;0;0
5694;148041;844;98;51;3;48;.941;3543000;0
5695;5565;839;67;42;5;37;.881;3600000;0
5695;165723;837;80;31;2;29;.935;3600000;0
5695;180287;837;0;0;0;0;.00nan;0;0
5695;78223;839;0;0;0;0;.00nan;0;0
5696;5663;848;71;22;2;20;.909;3600000;0
5696;16838;830;62;31;3;28;.903;3600000;0
5696;19322;848;0;0;0;0;.00nan;0;0
5696;47791;830;0;0;0;0;.00nan;0;0
5697;6084;829;71;40;4;36;.900;3600000;0
5697;16454;829;0;0;0;0;.00nan;0;0
5697;32404;833;0;0;0;0;.00nan;0;0
5697;53867;833;64;18;1;17;.944;3600000;0
5698;32588;847;62;34;4;30;.882;3834000;0
5698;48141;831;0;0;0;0;.00nan;0;0
5698;54017;847;0;0;0;0;.00nan;0;0
5698;78094;831;64;29;3;26;.897;3834000;0
5699;805;832;0;0;0;0;.00nan;0;0
5699;8501;836;0;0;0;0;.00nan;0;0
5699;13373;832;66;29;4;25;.862;3600000;0
5699;68390;836;73;46;5;41;.891;3567000;0
5700;183545;842;0;0;0;0;.00nan;0;0
5700;15538;834;0;0;0;0;.00nan;0;0
5700;23433;842;48;30;4;26;.867;3552000;0
5700;30431;834;55;22;3;19;.864;3600000;0
5701;34325;844;69;49;4;45;.918;3571000;0
5701;85453;828;0;0;0;0;.00nan;0;0
5701;85900;828;66;19;2;17;.895;3600000;0
5701;148041;844;0;0;0;0;.00nan;0;0
5702;5565;839;98;40;3;37;.925;3550000;0
5702;5663;848;76;28;2;26;.929;3600000;0
5702;19322;848;0;0;0;0;.00nan;0;0
5702;78223;839;0;0;0;0;.00nan;0;0
5703;48141;831;0;0;0;0;.00nan;0;0
5703;78094;831;87;36;2;34;.944;3600000;0
5703;85453;828;0;0;0;0;.00nan;0;0
5703;85900;828;59;27;3;24;.889;3555000;0
5704;15538;834;62;25;3;22;.880;3900000;0
5704;30431;834;0;0;0;0;.00nan;0;0
5704;32404;833;0;0;0;0;.00nan;0;0
5704;53867;833;72;35;3;32;.914;3900000;0
5705;805;832;0;0;0;0;.00nan;0;0
5705;13373;832;38;30;5;25;.833;3513000;0
5705;34325;844;0;0;0;0;.00nan;0;0
5705;148041;844;80;40;3;37;.925;3600000;0
5706;8501;836;0;0;0;0;.00nan;0;0
5706;183545;842;0;0;0;0;.00nan;0;0
5706;23433;842;60;19;2;17;.895;3600000;0
5706;68390;836;76;55;6;49;.891;3600000;0
5707;165723;837;80;39;3;36;.923;3600000;0
5707;16838;830;100;22;0;22;1.000;3600000;0
5707;180287;837;0;0;0;0;.00nan;0;0
5707;47791;830;0;0;0;0;.00nan;0;0
5708;6084;829;48;19;3;16;.842;3600000;0
5708;8501;836;75;52;6;46;.885;3081000;0
5708;16454;829;0;0;0;0;.00nan;0;0
5708;68390;836;62;6;0;6;1.000;519000;0
5709;183545;842;100;43;0;43;1.000;3600000;0
5709;23433;842;0;0;0;0;.00nan;0;0
5709;32588;847;38;28;6;22;.786;3600000;0
5709;54017;847;0;0;0;0;.00nan;0;0
5710;5663;848;76;29;2;27;.931;3706000;0
5710;19322;848;0;0;0;0;.00nan;0;0
5710;32404;833;69;33;3;30;.909;3706000;0
5710;53867;833;0;0;0;0;.00nan;0;0
5711;15538;834;0;0;0;0;.00nan;0;0
5711;30431;834;39;23;5;18;.783;3600000;0
5711;48141;831;66;30;3;27;.900;3600000;0
5711;78094;831;0;0;0;0;.00nan;0;0
5712;805;832;100;36;0;36;1.000;3600000;0
5712;13373;832;0;0;0;0;.00nan;0;0
5712;16838;830;81;46;4;42;.913;3600000;0
5712;47791;830;0;0;0;0;.00nan;0;0
5713;165723;837;0;0;0;0;.00nan;0;0
5713;180287;837;72;28;2;26;.929;3600000;0
5713;85453;828;57;47;6;41;.872;3307000;0
5713;85900;828;50;1;0;1;1.000;293000;0
5714;5565;839;53;23;3;20;.870;3576000;0
5714;48141;831;0;0;0;0;.00nan;0;0
5714;78094;831;82;37;2;35;.946;3600000;0
5714;78223;839;0;0;0;0;.00nan;0;0
5715;805;832;0;0;0;0;.00nan;0;0
5715;5663;848;53;27;4;23;.852;3600000;0
5715;13373;832;53;34;6;28;.824;3593000;0
5715;19322;848;0;0;0;0;.00nan;0;0
5716;6084;829;0;0;0;0;.00nan;0;0
5716;15538;834;0;0;0;0;.00nan;0;0
5716;16454;829;83;41;3;38;.927;3600000;0
5716;30431;834;39;29;5;24;.828;3521000;0
5717;8501;836;0;0;0;0;.00nan;0;0
5717;68390;836;98;43;2;41;.953;3567000;0
5717;85453;828;0;0;0;0;.00nan;0;0
5717;85900;828;59;12;1;11;.917;3600000;0
5718;183545;842;72;37;3;34;.919;3600000;0
5718;165723;837;49;22;4;18;.818;3543000;0
5718;23433;842;0;0;0;0;.00nan;0;0
5718;180287;837;0;0;0;0;.00nan;0;0
5719;16838;830;41;22;4;18;.818;3569000;0
5719;32588;847;67;28;2;26;.929;3600000;0
5719;47791;830;0;0;0;0;.00nan;0;0
5719;54017;847;0;0;0;0;.00nan;0;0
5720;32404;833;0;0;0;0;.00nan;0;0
5720;34325;844;47;15;2;13;.867;1123000;0
5720;53867;833;65;23;2;21;.913;3600000;0
5720;148041;844;58;44;7;37;.841;2477000;0
5721;32404;833;52;26;3;23;.885;3600000;0
5721;53867;833;0;0;0;0;.00nan;0;0
5721;85453;828;77;33;2;31;.939;3600000;0
5721;85900;828;0;0;0;0;.00nan;0;0
5722;8501;836;0;0;0;0;.00nan;0;0
5722;165723;837;75;28;2;26;.929;3600000;0
5722;180287;837;0;0;0;0;.00nan;0;0
5722;68390;836;64;53;7;46;.868;3600000;0
5723;5565;839;54;30;4;26;.867;3566000;0
5723;32588;847;0;0;0;0;.00nan;0;0
5723;54017;847;81;37;3;34;.919;3600000;0
5723;78223;839;0;0;0;0;.00nan;0;0
5724;16838;830;45;36;6;30;.833;3600000;0
5724;47791;830;0;0;0;0;.00nan;0;0
5724;48141;831;75;27;2;25;.926;3600000;0
5724;78094;831;0;0;0;0;.00nan;0;0
5725;5663;848;49;30;4;26;.867;3600000;0
5725;6084;829;96;21;0;21;1.000;3600000;0
5725;16454;829;0;0;0;0;.00nan;0;0
5725;19322;848;0;0;0;0;.00nan;0;0
5726;15538;834;60;20;2;18;.900;3600000;0
5726;30431;834;0;0;0;0;.00nan;0;0
5726;34325;844;56;13;1;12;.923;591000;0
5726;148041;844;52;44;6;38;.864;3009000;0
5727;5565;839;0;0;0;0;.00nan;0;0
5727;15538;834;0;0;0;0;.00nan;0;0
5727;30431;834;81;24;1;23;.958;3600000;0
5727;78223;839;74;39;3;36;.923;3588000;0
5728;5663;848;0;0;0;0;.00nan;0;0
5728;19322;848;72;42;4;38;.905;3514000;0
5728;32588;847;100;50;2;48;.960;3600000;0
5728;54017;847;0;0;0;0;.00nan;0;0
5729;8501;836;91;52;4;48;.923;3540000;0
5729;32404;833;0;0;0;0;.00nan;0;0
5729;53867;833;58;22;3;19;.864;3600000;0
5729;68390;836;0;0;0;0;.00nan;0;0
5730;805;832;65;28;3;25;.893;3600000;0
5730;6084;829;51;25;4;21;.840;3536000;0
5730;13373;832;0;0;0;0;.00nan;0;0
5730;16454;829;0;0;0;0;.00nan;0;0
5731;165723;837;0;0;0;0;.00nan;0;0
5731;180287;837;77;25;1;24;.960;3600000;0
5731;48141;831;0;0;0;0;.00nan;0;0
5731;78094;831;62;35;4;31;.886;3600000;0
5732;183545;842;0;0;0;0;.00nan;0;0
5732;23433;842;76;20;1;19;.950;3600000;0
5732;34325;844;55;36;5;31;.861;3600000;0
5732;148041;844;0;0;0;0;.00nan;0;0
5733;16838;830;0;0;0;0;.00nan;0;0
5733;47791;830;39;31;6;25;.806;3559000;0
5733;85453;828;0;0;0;0;.00nan;0;0
5733;85900;828;57;29;4;25;.862;3600000;0
5734;805;832;0;0;0;0;.00nan;0;0
5734;183545;842;100;28;0;28;1.000;3600000;0
5734;13373;832;83;35;3;32;.914;3600000;0
5734;23433;842;0;0;0;0;.00nan;0;0
5735;8501;836;0;0;0;0;.00nan;0;0
5735;32588;847;53;19;3;16;.842;3900000;0
5735;54017;847;0;0;0;0;.00nan;0;0
5735;68390;836;84;44;3;41;.932;3900000;0
5736;5663;848;77;29;2;27;.931;3600000;0
5736;19322;848;0;0;0;0;.00nan;0;0
5736;48141;831;46;16;2;14;.875;1698000;0
5736;78094;831;25;21;5;16;.762;1902000;0
5737;805;832;0;0;0;0;.00nan;0;0
5737;5565;839;0;0;0;0;.00nan;0;0
5737;13373;832;69;40;5;35;.875;3600000;0
5737;78223;839;51;18;2;16;.889;3600000;0
5738;15538;834;0;0;0;0;.00nan;0;0
5738;30431;834;86;34;1;33;.971;3600000;0
5738;85453;828;48;23;3;20;.870;3575000;0
5738;85900;828;0;0;0;0;.00nan;0;0
5739;165723;837;72;18;1;17;.944;3600000;0
5739;180287;837;0;0;0;0;.00nan;0;0
5739;34325;844;71;47;4;43;.915;3600000;0
5739;148041;844;0;0;0;0;.00nan;0;0
5740;6084;829;9;19;7;12;.632;2884000;0
5740;183545;842;97;35;1;34;.971;3600000;0
5740;16454;829;54;17;2;15;.882;716000;0
5740;23433;842;0;0;0;0;.00nan;0;0
5741;5565;839;0;0;0;0;.00nan;0;0
5741;8501;836;0;0;0;0;.00nan;0;0
5741;68390;836;83;39;3;36;.923;3554000;0
5741;78223;839;91;26;1;25;.962;3600000;0
5742;5663;848;70;18;1;17;.944;3600000;0
5742;19322;848;0;0;0;0;.00nan;0;0
5742;34325;844;0;0;0;0;.00nan;0;0
5742;148041;844;59;38;5;33;.868;3600000;0
5743;6084;829;99;33;1;32;.970;3796000;0
5743;16454;829;0;0;0;0;.00nan;0;0
5743;48141;831;0;0;0;0;.00nan;0;0
5743;78094;831;78;32;2;30;.938;3796000;0
5744;183545;842;0;0;0;0;.00nan;0;0
5744;23433;842;56;26;2;24;.923;3543000;0
5744;85453;828;0;0;0;0;.00nan;0;0
5744;85900;828;84;31;1;30;.968;3600000;0
5745;165723;837;0;0;0;0;.00nan;0;0
5745;32404;833;0;0;0;0;.00nan;0;0
5745;180287;837;87;43;2;41;.953;3900000;0
5745;53867;833;85;34;2;32;.941;3900000;0
5746;15538;834;49;28;4;24;.857;2106000;0
5746;16838;830;74;29;2;27;.931;3600000;0
5746;30431;834;79;21;1;20;.952;1494000;0
5746;47791;830;0;0;0;0;.00nan;0;0
5747;805;832;0;0;0;0;.00nan;0;0
5747;13373;832;87;29;1;28;.966;3600000;0
5747;32588;847;56;30;4;26;.867;3600000;0
5747;54017;847;0;0;0;0;.00nan;0;0
5748;16838;830;74;36;3;33;.917;3900000;0
5748;32404;833;63;36;3;33;.917;3900000;0
5748;47791;830;0;0;0;0;.00nan;0;0
5748;53867;833;0;0;0;0;.00nan;0;0
5749;805;832;0;0;0;0;.00nan;0;0
5749;13373;832;70;21;1;20;.952;3900000;0
5749;85453;828;70;22;1;21;.955;3900000;0
5749;85900;828;0;0;0;0;.00nan;0;0
5750;6084;829;90;21;0;21;1.000;3600000;0
5750;165723;837;70;34;3;31;.912;3600000;0
5750;16454;829;0;0;0;0;.00nan;0;0
5750;180287;837;0;0;0;0;.00nan;0;0
5751;8501;836;0;0;0;0;.00nan;0;0
5751;34325;844;0;0;0;0;.00nan;0;0
5751;68390;836;71;26;2;24;.923;3563000;0
5751;148041;844;98;25;0;25;1.000;3600000;0
5752;165723;837;0;0;0;0;.00nan;0;0
5752;32588;847;47;33;5;28;.848;3679000;0
5752;180287;837;35;37;6;31;.838;3679000;0
5752;54017;847;0;0;0;0;.00nan;0;0
5753;805;832;0;0;0;0;.00nan;0;0
5753;13373;832;46;33;5;28;.848;3565000;0
5753;48141;831;60;21;3;18;.857;3600000;0
5753;78094;831;0;0;0;0;.00nan;0;0
5754;6084;829;29;34;7;27;.794;3600000;0
5754;13715;830;0;0;0;0;.00nan;0;0
5754;16454;829;0;0;0;0;.00nan;0;0
5754;16838;830;89;18;0;18;1.000;3600000;0
5755;15538;834;60;27;3;24;.889;3600000;0
5755;17074;834;0;0;0;0;.00nan;0;0
5755;19322;848;54;40;6;34;.850;3600000;0
5755;147901;848;0;0;0;0;.00nan;0;0
5756;183545;842;82;26;2;24;.923;3900000;0
5756;23433;842;0;0;0;0;.00nan;0;0
5756;32404;833;50;16;2;14;.875;3900000;0
5756;154162;833;0;0;0;0;.00nan;0;0
5757;5565;839;74;36;4;32;.889;3900000;0
5757;183545;842;0;0;0;0;.00nan;0;0
5757;23433;842;56;25;4;21;.840;3900000;0
5757;78223;839;0;0;0;0;.00nan;0;0
5758;19322;848;0;0;0;0;.00nan;0;0
5758;85453;828;47;34;5;29;.853;3600000;0
5758;85900;828;0;0;0;0;.00nan;0;0
5758;147901;848;66;21;1;20;.952;3600000;0
5759;32404;833;0;0;0;0;.00nan;0;0
5759;48141;831;0;0;0;0;.00nan;0;0
5759;78094;831;60;36;4;32;.889;3529000;0
5759;154162;833;73;29;2;27;.931;3600000;0
5760;805;832;76;33;3;30;.909;3900000;0
5760;13373;832;0;0;0;0;.00nan;0;0
5760;15538;834;0;0;0;0;.00nan;0;0
5760;17074;834;66;28;3;25;.893;3900000;0
5761;32588;847;0;0;0;0;.00nan;0;0
5761;34325;844;61;39;5;34;.872;3600000;0
5761;54017;847;66;20;2;18;.900;3600000;0
5761;148041;844;0;0;0;0;.00nan;0;0
5762;8501;836;0;0;0;0;.00nan;0;0
5762;13715;830;0;0;0;0;.00nan;0;0
5762;16838;830;61;20;2;18;.900;3600000;0
5762;68390;836;86;55;5;50;.909;3600000;0
5763;5565;839;0;0;0;0;.00nan;0;0
5763;78223;839;59;22;2;20;.909;3600000;0
5763;85453;828;0;0;0;0;.00nan;0;0
5763;85900;828;63;32;4;28;.875;3562000;0
5764;5663;848;38;23;5;18;.783;3541000;0
5764;8501;836;0;0;0;0;.00nan;0;0
5764;19322;848;0;0;0;0;.00nan;0;0
5764;68390;836;82;41;4;37;.902;3600000;0
5765;32404;833;0;0;0;0;.00nan;0;0
5765;32588;847;47;25;4;21;.840;3576000;0
5765;53867;833;92;43;3;40;.930;3600000;0
5765;54017;847;0;0;0;0;.00nan;0;0
5766;34325;844;97;44;2;42;.955;3564000;0
5766;48141;831;0;0;0;0;.00nan;0;0
5766;78094;831;61;17;1;16;.941;3600000;0
5766;148041;844;0;0;0;0;.00nan;0;0
5767;6084;829;91;37;1;36;.973;3600000;0
5767;16454;829;0;0;0;0;.00nan;0;0
5767;85453;828;68;40;4;36;.900;3600000;0
5767;85900;828;0;0;0;0;.00nan;0;0
5768;165723;837;77;42;4;38;.905;3578000;0
5768;15538;834;0;0;0;0;.00nan;0;0
5768;30431;834;100;36;2;34;.944;3600000;0
5768;180287;837;0;0;0;0;.00nan;0;0
5769;183545;842;0;0;0;0;.00nan;0;0
5769;16838;830;91;19;0;19;1.000;3600000;0
5769;23433;842;51;33;4;29;.879;3600000;0
5769;47791;830;0;0;0;0;.00nan;0;0
5770;5565;839;93;33;1;32;.970;3600000;0
5770;78223;839;0;0;0;0;.00nan;0;0
5770;85453;828;28;20;5;15;.750;2229000;0
5770;85900;828;30;19;4;15;.789;1371000;0
5771;5663;848;100;28;0;28;1.000;3600000;0
5771;16838;830;83;27;1;26;.963;3555000;0
5771;19322;848;0;0;0;0;.00nan;0;0
5771;47791;830;0;0;0;0;.00nan;0;0
5772;32404;833;0;0;0;0;.00nan;0;0
5772;32588;847;82;38;2;36;.947;3581000;0
5772;53867;833;97;23;0;23;1.000;3600000;0
5772;54017;847;0;0;0;0;.00nan;0;0
5773;8501;836;0;0;0;0;.00nan;0;0
5773;165723;837;49;14;2;12;.857;3900000;0
5773;180287;837;0;0;0;0;.00nan;0;0
5773;68390;836;100;45;2;43;.956;3900000;0
5774;805;832;0;0;0;0;.00nan;0;0
5774;13373;832;68;48;5;43;.896;3600000;0
5774;15538;834;0;0;0;0;.00nan;0;0
5774;30431;834;87;29;1;28;.966;3600000;0
5775;6084;829;69;20;2;18;.900;3653000;0
5775;16454;829;0;0;0;0;.00nan;0;0
5775;34325;844;0;0;0;0;.00nan;0;0
5775;148041;844;68;35;3;32;.914;3653000;0
5776;183545;842;86;26;1;25;.962;3600000;0
5776;23433;842;0;0;0;0;.00nan;0;0
5776;48141;831;0;0;0;0;.00nan;0;0
5776;78094;831;68;34;3;31;.912;3514000;0
5777;8501;836;78;49;4;45;.918;3900000;0
5777;183545;842;0;0;0;0;.00nan;0;0
5777;23433;842;62;34;4;30;.882;3900000;0
5777;68390;836;0;0;0;0;.00nan;0;0
5778;15538;834;41;13;3;10;.769;3600000;0
5778;30431;834;0;0;0;0;.00nan;0;0
5778;32588;847;49;1;0;1;1.000;250000;0
5778;54017;847;67;46;6;40;.870;3350000;0
5779;5565;839;0;0;0;0;.00nan;0;0
5779;48141;831;55;25;3;22;.880;3594000;0
5779;78094;831;0;0;0;0;.00nan;0;0
5779;78223;839;85;35;2;33;.943;3600000;0
5780;5663;848;90;34;1;33;.971;3900000;0
5780;6084;829;0;0;0;0;.00nan;0;0
5780;16454;829;100;41;1;40;.976;3900000;0
5780;19322;848;0;0;0;0;.00nan;0;0
5781;165723;837;0;0;0;0;.00nan;0;0
5781;180287;837;65;31;4;27;.871;3557000;0
5781;85453;828;0;0;0;0;.00nan;0;0
5781;85900;828;70;29;2;27;.931;3600000;0
5782;16838;830;54;10;1;9;.900;3576000;0
5782;34325;844;100;34;0;34;1.000;3600000;0
5782;47791;830;0;0;0;0;.00nan;0;0
5782;148041;844;0;0;0;0;.00nan;0;0
5783;805;832;0;0;0;0;.00nan;0;0
5783;13373;832;63;26;3;23;.885;3600000;0
5783;32404;833;0;0;0;0;.00nan;0;0
5783;53867;833;31;31;6;25;.806;3600000;0
5784;5565;839;61;21;3;18;.857;3600000;0
5784;8501;836;0;0;0;0;.00nan;0;0
5784;68390;836;72;47;5;42;.894;3600000;0
5784;78223;839;0;0;0;0;.00nan;0;0
5785;5663;848;52;33;4;29;.879;3600000;0
5785;19322;848;0;0;0;0;.00nan;0;0
5785;32588;847;80;39;3;36;.923;3600000;0
5785;54017;847;0;0;0;0;.00nan;0;0
5786;15538;834;0;0;0;0;.00nan;0;0
5786;30431;834;52;35;5;30;.857;3600000;0
5786;85453;828;89;38;2;36;.947;3600000;0
5786;85900;828;0;0;0;0;.00nan;0;0
5787;165723;837;100;37;0;37;1.000;3600000;0
5787;16838;830;40;41;7;34;.829;3600000;0
5787;180287;837;0;0;0;0;.00nan;0;0
5787;47791;830;0;0;0;0;.00nan;0;0
5788;34325;844;0;0;0;0;.00nan;0;0
5788;48141;831;0;0;0;0;.00nan;0;0
5788;78094;831;74;24;2;22;.917;3900000;0
5788;148041;844;97;46;2;44;.957;3900000;0
5789;8501;836;0;0;0;0;.00nan;0;0
5789;68390;836;75;49;5;44;.898;3600000;0
5789;85453;828;0;0;0;0;.00nan;0;0
5789;85900;828;43;9;2;7;.778;3600000;0
5790;183545;842;0;0;0;0;.00nan;0;0
5790;23433;842;74;38;3;35;.921;3600000;0
5790;32588;847;0;0;0;0;.00nan;0;0
5790;54017;847;91;34;1;33;.971;3600000;0
5791;32404;833;0;0;0;0;.00nan;0;0
5791;48141;831;67;21;1;20;.952;3600000;0
5791;53867;833;97;42;2;40;.952;3543000;0
5791;78094;831;0;0;0;0;.00nan;0;0
5792;805;832;0;0;0;0;.00nan;0;0
5792;5663;848;72;35;3;32;.914;3770000;0
5792;13373;832;52;25;4;21;.840;3770000;0
5792;19322;848;0;0;0;0;.00nan;0;0
5793;6084;829;57;19;3;16;.842;3600000;0
5793;165723;837;34;41;7;34;.829;3600000;0
5793;16454;829;0;0;0;0;.00nan;0;0
5793;180287;837;0;0;0;0;.00nan;0;0
5794;15538;834;78;10;0;10;1.000;3600000;0
5794;30431;834;0;0;0;0;.00nan;0;0
5794;34325;844;76;58;6;52;.897;3076000;0
5794;148041;844;43;12;2;10;.833;524000;0
5795;5565;839;0;0;0;0;.00nan;0;0
5795;16838;830;96;38;2;36;.947;3600000;0
5795;47791;830;0;0;0;0;.00nan;0;0
5795;78223;839;58;41;5;36;.878;3600000;0
5796;6084;829;47;30;4;26;.867;3564000;0
5796;16454;829;0;0;0;0;.00nan;0;0
5796;32404;833;66;27;3;24;.889;3600000;0
5796;53867;833;0;0;0;0;.00nan;0;0
5797;805;832;0;0;0;0;.00nan;0;0
5797;5565;839;64;15;1;14;.933;948000;0
5797;13373;832;69;34;4;30;.882;3600000;0
5797;78223;839;29;26;6;20;.769;2652000;0
5798;5663;848;79;36;3;33;.917;3600000;0
5798;15538;834;73;29;2;27;.931;3600000;0
5798;19322;848;0;0;0;0;.00nan;0;0
5798;30431;834;0;0;0;0;.00nan;0;0
5799;8501;836;0;0;0;0;.00nan;0;0
5799;32404;833;0;0;0;0;.00nan;0;0
5799;53867;833;95;23;0;23;1.000;3600000;0
5799;68390;836;97;52;1;51;.981;3597000;0
5800;16838;830;57;27;3;24;.889;3900000;0
5800;47791;830;0;0;0;0;.00nan;0;0
5800;85453;828;86;37;3;34;.919;3900000;0
5800;85900;828;0;0;0;0;.00nan;0;0
5801;165723;837;99;35;1;34;.971;3600000;0
5801;180287;837;0;0;0;0;.00nan;0;0
5801;48141;831;0;0;0;0;.00nan;0;0
5801;78094;831;88;30;2;28;.933;3564000;0
5802;32588;847;78;33;2;31;.939;3600000;0
5802;34325;844;0;0;0;0;.00nan;0;0
5802;54017;847;0;0;0;0;.00nan;0;0
5802;148041;844;66;34;3;31;.912;3600000;0
5803;6084;829;80;26;1;25;.962;3600000;0
5803;183545;842;49;31;4;27;.871;3600000;0
5803;16454;829;0;0;0;0;.00nan;0;0
5803;23433;842;0;0;0;0;.00nan;0;0
5804;8501;836;100;34;1;33;.971;3900000;0
5804;34325;844;97;42;1;41;.976;3900000;0
5804;68390;836;0;0;0;0;.00nan;0;0
5804;148041;844;0;0;0;0;.00nan;0;0
5805;5565;839;81;37;2;35;.946;3900000;0
5805;32588;847;60;19;2;17;.895;3900000;0
5805;54017;847;0;0;0;0;.00nan;0;0
5805;78223;839;0;0;0;0;.00nan;0;0
5806;5663;848;86;31;1;30;.968;3600000;0
5806;19322;848;0;0;0;0;.00nan;0;0
5806;32404;833;0;0;0;0;.00nan;0;0
5806;53867;833;60;34;5;29;.853;3600000;0
5807;805;832;0;0;0;0;.00nan;0;0
5807;13373;832;90;31;2;29;.935;3600000;0
5807;165723;837;31;21;5;16;.762;2082000;0
5807;180287;837;63;16;1;15;.938;1518000;0
5808;6084;829;77;47;4;43;.915;3600000;0
5808;16454;829;0;0;0;0;.00nan;0;0
5808;85453;828;95;25;0;25;1.000;3600000;0
5808;85900;828;0;0;0;0;.00nan;0;0
5809;15538;834;0;0;0;0;.00nan;0;0
5809;30431;834;49;25;4;21;.840;3600000;0
5809;48141;831;0;0;0;0;.00nan;0;0
5809;78094;831;99;27;0;27;1.000;3600000;0
5810;183545;842;49;1;0;1;1.000;323000;0
5810;16838;830;100;30;0;30;1.000;3600000;0
5810;23433;842;12;37;8;29;.784;3277000;0
5810;47791;830;0;0;0;0;.00nan;0;0
5811;5663;848;81;39;3;36;.923;3900000;0
5811;183545;842;68;34;3;31;.912;3900000;0
5811;19322;848;0;0;0;0;.00nan;0;0
5811;23433;842;0;0;0;0;.00nan;0;0
5812;32588;847;61;33;4;29;.879;3600000;0
5812;48141;831;0;0;0;0;.00nan;0;0
5812;54017;847;0;0;0;0;.00nan;0;0
5812;78094;831;22;20;5;15;.750;3577000;0
5813;6084;829;65;28;3;25;.893;3568000;0
5813;8501;836;0;0;0;0;.00nan;0;0
5813;16454;829;0;0;0;0;.00nan;0;0
5813;68390;836;95;42;2;40;.952;3600000;0
5814;5565;839;53;33;4;29;.879;3600000;0
5814;165723;837;100;50;3;47;.940;3600000;0
5814;180287;837;0;0;0;0;.00nan;0;0
5814;78223;839;0;0;0;0;.00nan;0;0
5815;15538;834;0;0;0;0;.00nan;0;0
5815;30431;834;52;26;3;23;.885;3600000;0
5815;32404;833;0;0;0;0;.00nan;0;0
5815;53867;833;100;30;0;30;1.000;3600000;0
5816;34325;844;68;57;6;51;.895;3600000;0
5816;85453;828;96;24;0;24;1.000;3600000;0
5816;85900;828;0;0;0;0;.00nan;0;0
5816;148041;844;0;0;0;0;.00nan;0;0
5817;805;832;0;0;0;0;.00nan;0;0
5817;13373;832;95;30;1;29;.967;3600000;0
5817;16838;830;77;30;2;28;.933;3569000;0
5817;47791;830;0;0;0;0;.00nan;0;0
5818;5565;839;0;0;0;0;.00nan;0;0
5818;34325;844;0;0;0;0;.00nan;0;0
5818;78223;839;61;25;2;23;.920;3671000;0
5818;148041;844;68;29;3;26;.897;3671000;0
5819;8501;836;0;0;0;0;.00nan;0;0
5819;16838;830;61;14;1;13;.929;3600000;0
5819;47791;830;0;0;0;0;.00nan;0;0
5819;68390;836;81;49;5;44;.898;3600000;0
5820;6084;829;89;35;2;33;.943;3543000;0
5820;16454;829;0;0;0;0;.00nan;0;0
5820;32588;847;84;27;1;26;.963;3600000;0
5820;54017;847;0;0;0;0;.00nan;0;0
5821;165723;837;68;33;4;29;.879;3551000;0
5821;32404;833;0;0;0;0;.00nan;0;0
5821;180287;837;0;0;0;0;.00nan;0;0
5821;53867;833;87;39;3;36;.923;3600000;0
5822;805;832;68;31;2;29;.935;3900000;0
5822;13373;832;0;0;0;0;.00nan;0;0
5822;48141;831;0;0;0;0;.00nan;0;0
5822;78094;831;95;35;2;33;.943;3900000;0
5823;5663;848;65;24;3;21;.875;3600000;0
5823;19322;848;0;0;0;0;.00nan;0;0
5823;85453;828;47;23;4;19;.826;3600000;0
5823;85900;828;0;0;0;0;.00nan;0;0
5824;183545;842;79;36;3;33;.917;3647000;0
5824;15538;834;0;0;0;0;.00nan;0;0
5824;23433;842;0;0;0;0;.00nan;0;0
5824;30431;834;71;26;2;24;.923;3647000;0
5825;165723;837;63;23;3;20;.870;3600000;0
5825;180287;837;0;0;0;0;.00nan;0;0
5825;34325;844;42;47;6;41;.872;3600000;0
5825;148041;844;0;0;0;0;.00nan;0;0
5826;183545;842;0;0;0;0;.00nan;0;0
5826;23433;842;78;33;1;32;.970;3600000;0
5826;32404;833;0;0;0;0;.00nan;0;0
5826;53867;833;56;27;3;24;.889;3527000;0
5827;5565;839;63;26;3;23;.885;3543000;0
5827;6084;829;99;42;1;41;.976;3600000;0
5827;16454;829;0;0;0;0;.00nan;0;0
5827;78223;839;0;0;0;0;.00nan;0;0
5828;16838;830;88;34;3;31;.912;3600000;0
5828;32588;847;70;37;4;33;.892;3600000;0
5828;47791;830;0;0;0;0;.00nan;0;0
5828;54017;847;0;0;0;0;.00nan;0;0
5829;5663;848;73;30;3;27;.900;3693000;0
5829;19322;848;0;0;0;0;.00nan;0;0
5829;48141;831;0;0;0;0;.00nan;0;0
5829;78094;831;67;30;2;28;.933;3693000;0
5830;805;832;0;0;0;0;.00nan;0;0
5830;13373;832;77;35;3;32;.914;3600000;0
5830;85453;828;38;30;6;24;.800;2830000;0
5830;85900;828;47;7;1;6;.857;770000;0
5831;8501;836;0;0;0;0;.00nan;0;0
5831;15538;834;0;0;0;0;.00nan;0;0
5831;30431;834;68;24;3;21;.875;3600000;0
5831;68390;836;71;47;5;42;.894;3600000;0
5832;5565;839;0;0;0;0;.00nan;0;0
5832;5663;848;58;29;3;26;.897;3568000;0
5832;19322;848;0;0;0;0;.00nan;0;0
5832;78223;839;100;40;1;39;.975;3600000;0
5833;32404;833;55;23;3;20;.870;3600000;0
5833;34325;844;58;8;0;8;1.000;737000;0
5833;53867;833;0;0;0;0;.00nan;0;0
5833;148041;844;41;36;6;30;.833;2863000;0
5834;805;832;72;30;2;28;.933;3900000;0
5834;6084;829;0;0;0;0;.00nan;0;0
5834;13373;832;0;0;0;0;.00nan;0;0
5834;16454;829;73;24;2;22;.917;3900000;0
5835;8501;836;0;0;0;0;.00nan;0;0
5835;32588;847;68;26;2;24;.923;3900000;0
5835;54017;847;0;0;0;0;.00nan;0;0
5835;68390;836;100;52;2;50;.962;3900000;0
5836;48141;831;0;0;0;0;.00nan;0;0
5836;78094;831;62;18;1;17;.944;3578000;0
5836;85453;828;100;36;0;36;1.000;3600000;0
5836;85900;828;0;0;0;0;.00nan;0;0
5837;183545;842;79;33;2;31;.939;3600000;0
5837;165723;837;86;32;1;31;.969;3600000;0
5837;23433;842;0;0;0;0;.00nan;0;0
5837;180287;837;0;0;0;0;.00nan;0;0
5838;15538;834;0;0;0;0;.00nan;0;0
5838;16838;830;66;36;4;32;.889;3600000;0
5838;30431;834;56;34;5;29;.853;3600000;0
5838;47791;830;0;0;0;0;.00nan;0;0
5839;5565;839;100;27;0;27;1.000;3600000;0
5839;15538;834;0;0;0;0;.00nan;0;0
5839;30431;834;97;30;1;29;.967;3592000;0
5839;78223;839;0;0;0;0;.00nan;0;0
5840;6084;829;68;37;3;34;.919;3547000;0
5840;16454;829;0;0;0;0;.00nan;0;0
5840;48141;831;63;20;2;18;.900;3600000;0
5840;78094;831;0;0;0;0;.00nan;0;0
5841;805;832;0;0;0;0;.00nan;0;0
5841;8501;836;0;0;0;0;.00nan;0;0
5841;13373;832;25;27;6;21;.778;3600000;0
5841;68390;836;99;51;3;48;.941;3600000;0
5842;32588;847;77;28;2;26;.929;3600000;0
5842;54017;847;0;0;0;0;.00nan;0;0
5842;85453;828;40;31;5;26;.839;3600000;0
5842;85900;828;0;0;0;0;.00nan;0;0
5843;5663;848;89;40;2;38;.950;3519000;0
5843;165723;837;98;24;0;24;1.000;3600000;0
5843;19322;848;0;0;0;0;.00nan;0;0
5843;180287;837;0;0;0;0;.00nan;0;0
5844;23433;842;97;29;0;29;1.000;3600000;0
5844;34325;844;45;34;5;29;.853;3600000;0
5844;54885;842;0;0;0;0;.00nan;0;0
5844;148041;844;0;0;0;0;.00nan;0;0
5845;16838;830;65;20;2;18;.900;3900000;0
5845;32404;833;0;0;0;0;.00nan;0;0
5845;47791;830;0;0;0;0;.00nan;0;0
5845;53867;833;89;34;2;32;.941;3900000;0
5846;8501;836;100;47;2;45;.957;3900000;0
5846;48141;831;0;0;0;0;.00nan;0;0
5846;68390;836;0;0;0;0;.00nan;0;0
5846;78094;831;68;22;2;20;.909;3900000;0
5847;805;832;0;0;0;0;.00nan;0;0
5847;13373;832;86;26;1;25;.962;3600000;0
5847;32588;847;78;38;2;36;.947;3600000;0
5847;54017;847;0;0;0;0;.00nan;0;0
5848;5663;848;59;23;3;20;.870;3534000;0
5848;19322;848;0;0;0;0;.00nan;0;0
5848;34325;844;0;0;0;0;.00nan;0;0
5848;148041;844;97;34;1;33;.971;3600000;0
5849;6084;829;98;42;1;41;.976;3900000;0
5849;16454;829;0;0;0;0;.00nan;0;0
5849;16838;830;96;39;1;38;.974;3900000;0
5849;47791;830;0;0;0;0;.00nan;0;0
5850;165723;837;68;29;3;26;.897;3595000;0
5850;15538;834;82;24;1;23;.958;3600000;0
5850;30431;834;0;0;0;0;.00nan;0;0
5850;180287;837;0;0;0;0;.00nan;0;0
5851;23433;842;96;34;1;33;.971;3600000;0
5851;54885;842;0;0;0;0;.00nan;0;0
5851;85453;828;57;22;2;20;.909;3567000;0
5851;85900;828;0;0;0;0;.00nan;0;0
5852;5663;848;65;12;1;11;.917;3600000;0
5852;8501;836;0;0;0;0;.00nan;0;0
5852;19322;848;0;0;0;0;.00nan;0;0
5852;68390;836;87;44;2;42;.955;3600000;0
5853;165723;837;80;31;2;29;.935;3600000;0
5853;32588;847;86;43;3;40;.930;3553000;0
5853;180287;837;0;0;0;0;.00nan;0;0
5853;54017;847;0;0;0;0;.00nan;0;0
5854;805;832;0;0;0;0;.00nan;0;0
5854;13373;832;59;14;2;12;.857;3600000;0
5854;34325;844;39;50;7;43;.860;3600000;0
5854;148041;844;0;0;0;0;.00nan;0;0
5855;6084;829;77;50;4;46;.920;3600000;0
5855;15538;834;0;0;0;0;.00nan;0;0
5855;16454;829;0;0;0;0;.00nan;0;0
5855;30431;834;72;22;1;21;.955;3600000;0
5856;5565;839;0;0;0;0;.00nan;0;0
5856;183545;842;0;0;0;0;.00nan;0;0
5856;23433;842;65;22;2;20;.909;3900000;0
5856;78223;839;89;39;2;37;.949;3900000;0
5857;5565;839;92;37;1;36;.973;3900000;0
5857;183545;842;0;0;0;0;.00nan;0;0
5857;23433;842;85;29;1;28;.966;3900000;0
5857;78223;839;0;0;0;0;.00nan;0;0
5858;5663;848;0;0;0;0;.00nan;0;0
5858;8501;836;0;0;0;0;.00nan;0;0
5858;19322;848;72;22;1;21;.955;3600000;0
5858;68390;836;85;35;3;32;.914;3600000;0
5859;165723;837;82;32;2;30;.938;3600000;0
5859;32588;847;0;0;0;0;.00nan;0;0
5859;180287;837;0;0;0;0;.00nan;0;0
5859;54017;847;72;42;4;38;.905;3516000;0
5860;805;832;0;0;0;0;.00nan;0;0
5860;13373;832;55;20;3;17;.850;3600000;0
5860;34325;844;0;0;0;0;.00nan;0;0
5860;148041;844;89;54;4;50;.926;3600000;0
5861;16838;830;0;0;0;0;.00nan;0;0
5861;47791;830;52;24;3;21;.875;3555000;0
5861;48141;831;0;0;0;0;.00nan;0;0
5861;78094;831;74;31;2;29;.935;3600000;0
5862;16838;830;81;29;2;27;.931;3600000;0
5862;47791;830;0;0;0;0;.00nan;0;0
5862;48141;831;81;36;3;33;.917;3584000;0
5862;78094;831;0;0;0;0;.00nan;0;0
5863;6084;829;30;10;3;7;.700;274000;0
5863;15538;834;0;0;0;0;.00nan;0;0
5863;16454;829;71;46;4;42;.913;3326000;0
5863;30431;834;59;17;2;15;.882;3600000;0
5864;5565;839;0;0;0;0;.00nan;0;0
5864;6084;829;0;0;0;0;.00nan;0;0
5864;16454;829;77;34;2;32;.941;3900000;0
5864;78223;839;69;23;2;21;.913;3900000;0
5865;32404;833;54;3;0;3;1.000;236000;0
5865;53867;833;51;41;6;35;.854;3364000;0
5865;85453;828;0;0;0;0;.00nan;0;0
5865;85900;828;74;30;3;27;.900;3600000;0
5866;165723;837;33;25;5;20;.800;3583000;0
5866;180287;837;0;0;0;0;.00nan;0;0
5866;34325;844;0;0;0;0;.00nan;0;0
5866;148041;844;100;53;3;50;.943;3600000;0
5867;8501;836;0;0;0;0;.00nan;0;0
5867;165723;837;100;30;0;30;1.000;3600000;0
5867;180287;837;0;0;0;0;.00nan;0;0
5867;68390;836;68;46;6;40;.870;3600000;0
5868;32404;833;0;0;0;0;.00nan;0;0
5868;32588;847;56;23;2;21;.913;3900000;0
5868;53867;833;88;36;2;34;.944;3900000;0
5868;54017;847;0;0;0;0;.00nan;0;0
5869;183545;842;0;0;0;0;.00nan;0;0
5869;23433;842;47;43;5;38;.884;3568000;0
5869;48141;831;0;0;0;0;.00nan;0;0
5869;78094;831;80;30;3;27;.900;3600000;0
5870;805;832;0;0;0;0;.00nan;0;0
5870;13373;832;68;29;3;26;.897;3795000;0
5870;15538;834;0;0;0;0;.00nan;0;0
5870;30431;834;57;31;4;27;.871;3795000;0
5871;6084;829;86;33;2;31;.939;3600000;0
5871;16454;829;0;0;0;0;.00nan;0;0
5871;34325;844;0;0;0;0;.00nan;0;0
5871;148041;844;60;29;3;26;.897;3544000;0
5872;5565;839;78;41;4;37;.902;3600000;0
5872;78223;839;0;0;0;0;.00nan;0;0
5872;85453;828;36;28;6;22;.786;2940000;0
5872;85900;828;58;3;0;3;1.000;660000;0
5873;5663;848;84;31;2;29;.935;3543000;0
5873;16838;830;84;25;1;24;.960;3600000;0
5873;19322;848;0;0;0;0;.00nan;0;0
5873;47791;830;0;0;0;0;.00nan;0;0
5874;5565;839;0;0;0;0;.00nan;0;0
5874;48141;831;69;25;3;22;.880;3600000;0
5874;78094;831;0;0;0;0;.00nan;0;0
5874;78223;839;51;27;4;23;.852;3600000;0
5875;805;832;0;0;0;0;.00nan;0;0
5875;13373;832;45;24;3;21;.875;3900000;0
5875;32404;833;98;52;3;49;.942;3900000;0
5875;53867;833;0;0;0;0;.00nan;0;0
5876;165723;837;66;30;3;27;.900;3900000;0
5876;180287;837;0;0;0;0;.00nan;0;0
5876;85453;828;0;0;0;0;.00nan;0;0
5876;85900;828;74;35;3;32;.914;3900000;0
5877;15538;834;72;21;1;20;.952;3600000;0
5877;30431;834;0;0;0;0;.00nan;0;0
5877;32588;847;0;0;0;0;.00nan;0;0
5877;54017;847;71;37;3;34;.919;3579000;0
5878;16838;830;0;0;0;0;.00nan;0;0
5878;34325;844;76;44;4;40;.909;3600000;0
5878;47791;830;70;22;1;21;.955;3600000;0
5878;148041;844;0;0;0;0;.00nan;0;0
5879;8501;836;0;0;0;0;.00nan;0;0
5879;183545;842;73;9;0;9;1.000;3600000;0
5879;23433;842;0;0;0;0;.00nan;0;0
5879;68390;836;97;50;3;47;.940;3600000;0
5880;5663;848;54;16;2;14;.875;3600000;0
5880;6084;829;79;40;4;36;.900;3534000;0
5880;16454;829;0;0;0;0;.00nan;0;0
5880;19322;848;0;0;0;0;.00nan;0;0
5881;5565;839;0;0;0;0;.00nan;0;0
5881;8501;836;0;0;0;0;.00nan;0;0
5881;68390;836;100;40;2;38;.950;3900000;0
5881;78223;839;66;18;2;16;.889;3900000;0
5882;5663;848;49;31;5;26;.839;3560000;0
5882;19322;848;0;0;0;0;.00nan;0;0
5882;32588;847;75;40;4;36;.900;3600000;0
5882;54017;847;0;0;0;0;.00nan;0;0
5883;34325;844;0;0;0;0;.00nan;0;0
5883;48141;831;0;0;0;0;.00nan;0;0
5883;78094;831;59;20;3;17;.850;3878000;0
5883;148041;844;91;42;3;39;.929;3900000;0
5884;805;832;0;0;0;0;.00nan;0;0
5884;183545;842;82;40;3;37;.925;3544000;0
5884;13373;832;71;26;2;24;.923;3600000;0
5884;23433;842;0;0;0;0;.00nan;0;0
5885;6084;829;80;27;1;26;.963;3600000;0
5885;16454;829;0;0;0;0;.00nan;0;0
5885;32404;833;0;0;0;0;.00nan;0;0
5885;53867;833;59;22;3;19;.864;3522000;0
5886;15538;834;0;0;0;0;.00nan;0;0
5886;30431;834;45;15;3;12;.800;3600000;0
5886;85453;828;77;46;4;42;.913;3573000;0
5886;85900;828;0;0;0;0;.00nan;0;0
5887;165723;837;56;41;6;35;.854;3600000;0
5887;16838;830;100;39;2;37;.949;3600000;0
5887;180287;837;0;0;0;0;.00nan;0;0
5887;47791;830;0;0;0;0;.00nan;0;0
5888;6084;829;78;32;3;29;.906;3600000;0
5888;8501;836;0;0;0;0;.00nan;0;0
5888;16454;829;0;0;0;0;.00nan;0;0
5888;68390;836;82;24;1;23;.958;3600000;0
5889;32588;847;81;33;1;32;.970;3600000;0
5889;48141;831;0;0;0;0;.00nan;0;0
5889;54017;847;0;0;0;0;.00nan;0;0
5889;78094;831;82;34;3;31;.912;3557000;0
5890;805;832;0;0;0;0;.00nan;0;0
5890;13373;832;84;34;2;32;.941;3566000;0
5890;16838;830;92;27;1;26;.963;3600000;0
5890;47791;830;0;0;0;0;.00nan;0;0
5891;5663;848;43;23;4;19;.826;3571000;0
5891;183545;842;0;0;0;0;.00nan;0;0
5891;19322;848;0;0;0;0;.00nan;0;0
5891;23433;842;72;29;3;26;.897;3600000;0
5892;5663;848;0;0;0;0;.00nan;0;0
5892;19322;848;76;27;2;25;.926;3600000;0
5892;85453;828;48;28;4;24;.857;3514000;0
5892;85900;828;0;0;0;0;.00nan;0;0
5893;805;832;0;0;0;0;.00nan;0;0
5893;13373;832;74;29;2;27;.931;3600000;0
5893;48141;831;81;37;3;34;.919;3571000;0
5893;78094;831;0;0;0;0;.00nan;0;0
5894;6084;829;0;0;0;0;.00nan;0;0
5894;16454;829;74;34;3;31;.912;3554000;0
5894;32588;847;81;30;2;28;.933;3600000;0
5894;54017;847;0;0;0;0;.00nan;0;0
5895;165723;837;73;39;4;35;.897;3600000;0
5895;32404;833;0;0;0;0;.00nan;0;0
5895;180287;837;0;0;0;0;.00nan;0;0
5895;53867;833;88;30;1;29;.967;3600000;0
5896;183545;842;68;40;4;36;.900;3600000;0
5896;15538;834;0;0;0;0;.00nan;0;0
5896;23433;842;0;0;0;0;.00nan;0;0
5896;30431;834;71;22;1;21;.955;3600000;0
5897;5565;839;80;24;1;23;.958;3600000;0
5897;34325;844;78;37;3;34;.919;3589000;0
5897;78223;839;0;0;0;0;.00nan;0;0
5897;148041;844;0;0;0;0;.00nan;0;0
5898;5565;839;0;0;0;0;.00nan;0;0
5898;165723;837;79;28;2;26;.929;3600000;0
5898;180287;837;0;0;0;0;.00nan;0;0
5898;78223;839;67;35;3;32;.914;3572000;0
5899;15538;834;81;13;0;13;1.000;3600000;0
5899;30431;834;0;0;0;0;.00nan;0;0
5899;32404;833;0;0;0;0;.00nan;0;0
5899;53867;833;62;47;6;41;.872;3600000;0
5900;8501;836;0;0;0;0;.00nan;0;0
5900;16838;830;76;25;1;24;.960;3600000;0
5900;47791;830;0;0;0;0;.00nan;0;0
5900;68390;836;82;41;3;38;.927;3575000;0
5901;5565;839;53;17;2;15;.882;3600000;0
5901;34325;844;0;0;0;0;.00nan;0;0
5901;78223;839;0;0;0;0;.00nan;0;0
5901;148041;844;98;55;3;52;.945;3577000;0
5902;183545;842;75;32;2;30;.938;3600000;0
5902;23433;842;0;0;0;0;.00nan;0;0
5902;32404;833;0;0;0;0;.00nan;0;0
5902;53867;833;61;35;4;31;.886;3600000;0
5903;5663;848;55;33;4;29;.879;3600000;0
5903;19322;848;0;0;0;0;.00nan;0;0
5903;85453;828;71;45;5;40;.889;3580000;0
5903;85900;828;0;0;0;0;.00nan;0;0
5904;32404;833;0;0;0;0;.00nan;0;0
5904;34325;844;100;48;0;48;1.000;3900000;0
5904;53867;833;73;16;0;16;1.000;3900000;0
5904;148041;844;0;0;0;0;.00nan;0;0
5905;805;832;0;0;0;0;.00nan;0;0
5905;13373;832;41;33;5;28;.848;3592000;0
5905;15538;842;61;29;3;26;.897;3600000;0
5905;23433;842;0;0;0;0;.00nan;0;0
5906;8501;836;58;48;6;42;.875;3296000;0
5906;68390;836;61;9;0;9;1.000;304000;0
5906;147901;834;82;16;0;16;1.000;3600000;0
5906;154162;834;0;0;0;0;.00nan;0;0
5907;5663;848;99;23;0;23;1.000;3600000;0
5907;19322;848;0;0;0;0;.00nan;0;0
5907;48141;831;0;0;0;0;.00nan;0;0
5907;78094;831;93;28;1;27;.964;3564000;0
5908;6084;829;52;22;4;18;.818;3600000;0
5908;16454;829;0;0;0;0;.00nan;0;0
5908;30431;839;28;6;3;3;.500;440000;0
5908;78223;839;66;28;3;25;.893;3083000;0
5909;16838;830;83;29;2;27;.931;3600000;0
5909;32588;847;90;48;3;45;.938;3569000;0
5909;47791;830;0;0;0;0;.00nan;0;0
5909;54017;847;0;0;0;0;.00nan;0;0
5910;5663;848;87;29;1;28;.966;3600000;0
5910;19322;848;0;0;0;0;.00nan;0;0
5910;30431;839;58;33;5;28;.848;3600000;0
5910;78223;839;0;0;0;0;.00nan;0;0
5911;8501;836;0;0;0;0;.00nan;0;0
5911;32588;847;0;0;0;0;.00nan;0;0
5911;54017;847;75;20;1;19;.950;3900000;0
5911;68390;836;97;42;1;41;.976;3900000;0
5912;48141;831;79;31;2;29;.935;3600000;0
5912;78094;831;0;0;0;0;.00nan;0;0
5912;85453;828;59;26;3;23;.885;3590000;0
5912;85900;828;0;0;0;0;.00nan;0;0
5913;805;832;66;22;2;20;.909;3551000;0
5913;6084;829;96;40;1;39;.975;3600000;0
5913;13373;832;0;0;0;0;.00nan;0;0
5913;16454;829;0;0;0;0;.00nan;0;0
5914;16838;830;45;30;5;25;.833;3600000;0
5914;47791;830;0;0;0;0;.00nan;0;0
5914;147901;834;77;25;1;24;.960;3600000;0
5914;154162;834;0;0;0;0;.00nan;0;0
5915;165723;837;60;38;4;34;.895;3593000;0
5915;15538;842;68;34;3;31;.912;3600000;0
5915;17074;837;0;0;0;0;.00nan;0;0
5915;23433;842;0;0;0;0;.00nan;0;0
5916;32404;833;0;0;0;0;.00nan;0;0
5916;53867;833;82;22;1;21;.955;3899000;0
5916;85453;828;77;33;2;31;.939;3899000;0
5916;85900;828;0;0;0;0;.00nan;0;0
5917;8501;836;0;0;0;0;.00nan;0;0
5917;30431;839;90;35;2;33;.943;3600000;0
5917;68390;836;81;39;3;36;.923;3600000;0
5917;78223;839;0;0;0;0;.00nan;0;0
5918;16838;830;72;29;3;26;.897;3600000;0
5918;30431;839;64;39;5;34;.872;3514000;0
5918;47791;830;0;0;0;0;.00nan;0;0
5918;78223;839;0;0;0;0;.00nan;0;0
5919;805;832;0;0;0;0;.00nan;0;0
5919;5663;848;69;30;3;27;.900;3518000;0
5919;13373;832;95;38;1;37;.974;3600000;0
5919;19322;848;0;0;0;0;.00nan;0;0
5920;32404;833;0;0;0;0;.00nan;0;0
5920;48141;831;0;0;0;0;.00nan;0;0
5920;53867;833;100;35;0;35;1.000;3600000;0
5920;78094;831;64;27;2;25;.926;3531000;0
5921;8501;836;0;0;0;0;.00nan;0;0
5921;68390;836;100;39;2;37;.949;3900000;0
5921;85453;828;71;29;2;27;.931;3900000;0
5921;85900;828;0;0;0;0;.00nan;0;0
5922;6084;829;93;33;1;32;.970;3560000;0
5922;165723;837;79;12;0;12;1.000;3600000;0
5922;16454;829;0;0;0;0;.00nan;0;0
5922;17074;837;0;0;0;0;.00nan;0;0
5923;15538;842;77;33;2;31;.939;3741000;0
5923;23433;842;0;0;0;0;.00nan;0;0
5923;32588;847;61;28;3;25;.893;3741000;0
5923;54017;847;0;0;0;0;.00nan;0;0
5924;8501;836;70;43;5;38;.884;3600000;0
5924;32404;833;0;0;0;0;.00nan;0;0
5924;53867;833;56;16;2;14;.875;3600000;0
5924;68390;836;0;0;0;0;.00nan;0;0
5925;32588;847;0;0;0;0;.00nan;0;0
5925;34325;844;66;37;4;33;.892;3518000;0
5925;54017;847;60;20;2;18;.900;3600000;0
5925;148041;844;0;0;0;0;.00nan;0;0
5926;165723;837;97;48;4;44;.917;3600000;0
5926;17074;837;0;0;0;0;.00nan;0;0
5926;48141;831;51;23;3;20;.870;3600000;0
5926;78094;831;0;0;0;0;.00nan;0;0
5927;805;832;0;0;0;0;.00nan;0;0
5927;13373;832;65;23;2;21;.913;3600000;0
5927;30431;839;29;30;6;24;.800;3204000;0
5927;78223;839;50;1;0;1;1.000;396000;0
5928;5663;848;63;42;5;37;.881;3600000;0
5928;19322;848;0;0;0;0;.00nan;0;0
5928;147901;834;69;15;1;14;.933;3600000;0
5928;154162;834;0;0;0;0;.00nan;0;0
5929;16838;830;55;28;4;24;.857;3588000;0
5929;47791;830;0;0;0;0;.00nan;0;0
5929;85453;828;94;39;3;36;.923;3600000;0
5929;85900;828;0;0;0;0;.00nan;0;0
5930;6084;829;100;39;1;38;.974;3900000;0
5930;15538;842;66;18;1;17;.944;3900000;0
5930;16454;829;0;0;0;0;.00nan;0;0
5930;23433;842;0;0;0;0;.00nan;0;0
5931;34325;844;0;0;0;0;.00nan;0;0
5931;147901;834;0;0;0;0;.00nan;0;0
5931;148041;844;100;51;1;50;.980;3600000;0
5931;154162;834;49;22;3;19;.864;3531000;0
5932;30431;839;76;28;2;26;.929;3900000;0
5932;32404;833;0;0;0;0;.00nan;0;0
5932;53867;833;71;23;2;21;.913;3900000;0
5932;78223;839;0;0;0;0;.00nan;0;0
5933;34325;844;0;0;0;0;.00nan;0;0
5933;85453;828;88;16;0;16;1.000;3600000;0
5933;85900;828;0;0;0;0;.00nan;0;0
5933;148041;844;88;45;3;42;.933;3600000;0
5934;30431;839;26;24;6;18;.750;2689000;0
5934;32588;847;62;19;1;18;.947;3600000;0
5934;54017;847;0;0;0;0;.00nan;0;0
5934;78223;839;51;8;1;7;.875;911000;0
5935;5663;848;0;0;0;0;.00nan;0;0
5935;19322;848;63;21;2;19;.905;3514000;0
5935;32404;833;0;0;0;0;.00nan;0;0
5935;53867;833;100;28;0;28;1.000;3600000;0
5936;48141;831;0;0;0;0;.00nan;0;0
5936;78094;831;85;32;1;31;.969;3549000;0
5936;147901;834;100;30;0;30;1.000;3600000;0
5936;154162;834;0;0;0;0;.00nan;0;0
5937;805;832;0;0;0;0;.00nan;0;0
5937;13373;832;56;35;5;30;.857;3561000;0
5937;165723;837;62;26;3;23;.885;3600000;0
5937;17074;837;0;0;0;0;.00nan;0;0
5938;8501;836;0;0;0;0;.00nan;0;0
5938;34325;844;57;21;3;18;.857;3900000;0
5938;68390;836;49;19;3;16;.842;3900000;0
5938;148041;844;0;0;0;0;.00nan;0;0
5939;15538;842;67;31;3;28;.903;3600000;0
5939;16838;830;52;34;5;29;.853;3527000;0
5939;23433;842;0;0;0;0;.00nan;0;0
5939;47791;830;0;0;0;0;.00nan;0;0
5940;805;832;0;0;0;0;.00nan;0;0
5940;8501;836;0;0;0;0;.00nan;0;0
5940;13373;832;58;19;2;17;.895;3600000;0
5940;68390;836;98;59;4;55;.932;3600000;0
5941;32588;847;56;24;3;21;.875;3600000;0
5941;54017;847;0;0;0;0;.00nan;0;0
5941;85453;828;100;36;0;36;1.000;3600000;0
5941;85900;828;0;0;0;0;.00nan;0;0
5942;5663;848;77;30;2;28;.933;3600000;0
5942;165723;837;60;40;5;35;.875;3600000;0
5942;17074;837;0;0;0;0;.00nan;0;0
5942;19322;848;0;0;0;0;.00nan;0;0
5943;16838;830;83;17;0;17;1.000;3600000;0
5943;32404;833;0;0;0;0;.00nan;0;0
5943;47791;830;0;0;0;0;.00nan;0;0
5943;53867;833;98;42;1;41;.976;3558000;0
5944;6084;829;51;32;4;28;.875;3600000;0
5944;16454;829;0;0;0;0;.00nan;0;0
5944;48141;831;0;0;0;0;.00nan;0;0
5944;78094;831;84;30;1;29;.967;3600000;0
5945;30431;839;94;36;1;35;.972;3600000;0
5945;78223;839;0;0;0;0;.00nan;0;0
5945;147901;834;60;25;2;23;.920;3600000;0
5945;154162;834;0;0;0;0;.00nan;0;0
5946;15538;842;57;13;1;12;.923;3600000;0
5946;23433;842;0;0;0;0;.00nan;0;0
5946;34325;844;0;0;0;0;.00nan;0;0
5946;148041;844;58;55;6;49;.891;3600000;0
5947;30431;839;49;37;5;32;.865;3582000;0
5947;32404;833;0;0;0;0;.00nan;0;0
5947;53867;833;59;26;3;23;.885;3600000;0
5947;78223;839;0;0;0;0;.00nan;0;0
5948;8501;836;0;0;0;0;.00nan;0;0
5948;48141;831;0;0;0;0;.00nan;0;0
5948;68390;836;78;34;2;32;.941;3545000;0
5948;78094;831;84;29;1;28;.966;3600000;0
5949;805;832;0;0;0;0;.00nan;0;0
5949;13373;832;76;33;3;30;.909;3718000;0
5949;32588;847;65;35;4;31;.886;3718000;0
5949;54017;847;0;0;0;0;.00nan;0;0
5950;15538;842;52;28;4;24;.857;3600000;0
5950;23433;842;0;0;0;0;.00nan;0;0
5950;85453;828;87;31;1;30;.968;3600000;0
5950;85900;828;0;0;0;0;.00nan;0;0
5951;165723;837;100;26;0;26;1.000;3600000;0
5951;17074;837;0;0;0;0;.00nan;0;0
5951;147901;834;77;34;3;31;.912;3600000;0
5951;154162;834;0;0;0;0;.00nan;0;0
5952;5663;848;57;10;1;9;.900;3600000;0
5952;19322;848;0;0;0;0;.00nan;0;0
5952;34325;844;31;38;7;31;.816;3600000;0
5952;148041;844;0;0;0;0;.00nan;0;0
5953;6084;829;72;33;3;30;.909;3555000;0
5953;16454;829;0;0;0;0;.00nan;0;0
5953;16838;830;83;32;2;30;.938;3600000;0
5953;47791;830;0;0;0;0;.00nan;0;0
5955;5565;839;0;0;0;0;.00nan;0;0
5955;34325;844;0;0;0;0;.00nan;0;0
5955;78223;839;86;28;1;27;.964;3600000;0
5955;148041;844;54;33;5;28;.848;3600000;0
5957;8501;836;87;41;3;38;.927;3148000;0
5957;68390;836;24;7;3;4;.571;452000;0
5957;85453;828;43;19;3;16;.842;3600000;0
5957;85900;828;0;0;0;0;.00nan;0;0
5959;13715;848;0;0;0;0;.00nan;0;0
5959;19322;848;60;35;4;31;.886;3600000;0
5959;32404;833;0;0;0;0;.00nan;0;0
5959;53867;833;87;22;0;22;1.000;3600000;0
5961;183545;842;0;0;0;0;.00nan;0;0
5961;16838;830;78;18;1;17;.944;3600000;0
5961;23433;842;39;39;7;32;.821;3600000;0
5961;47791;830;0;0;0;0;.00nan;0;0
5963;15538;834;58;23;3;20;.870;3557000;0
5963;17074;834;0;0;0;0;.00nan;0;0
5963;32588;847;97;45;2;43;.956;3600000;0
5963;54017;847;0;0;0;0;.00nan;0;0
5965;165723;837;92;44;2;42;.955;3651000;0
5965;180287;837;0;0;0;0;.00nan;0;0
5965;48141;831;0;0;0;0;.00nan;0;0
5965;78094;831;99;33;1;32;.970;3651000;0
5967;805;832;0;0;0;0;.00nan;0;0
5967;6084;829;56;27;3;24;.889;3569000;0
5967;13373;832;83;31;1;30;.968;3600000;0
5967;16454;829;0;0;0;0;.00nan;0;0
5969;15538;834;44;11;2;9;.818;647000;0
5969;16838;830;0;0;0;0;.00nan;0;0
5969;17074;834;25;31;6;25;.806;2953000;0
5969;47791;830;96;23;0;23;1.000;3600000;0
5971;805;832;91;30;1;29;.967;3600000;0
5971;13373;832;0;0;0;0;.00nan;0;0
5971;48141;831;50;30;4;26;.867;3600000;0
5971;78094;831;0;0;0;0;.00nan;0;0
5973;6084;829;0;0;0;0;.00nan;0;0
5973;183545;842;48;21;3;18;.857;3700000;0
5973;16454;829;74;37;4;33;.892;3671000;0
5973;23433;842;0;0;0;0;.00nan;0;0
5975;165723;837;0;0;0;0;.00nan;0;0
5975;180287;837;82;50;5;45;.900;3600000;0
5975;85453;828;0;0;0;0;.00nan;0;0
5975;85900;828;73;26;2;24;.923;3600000;0
5977;13715;848;84;25;1;24;.960;3600000;0
5977;19322;848;0;0;0;0;.00nan;0;0
5977;32404;833;0;0;0;0;.00nan;0;0
5977;53867;833;64;23;2;21;.913;3578000;0
5979;32588;847;0;0;0;0;.00nan;0;0
5979;34325;844;29;23;5;18;.783;1308000;0
5979;54017;847;53;9;1;8;.889;3600000;0
5979;148041;844;31;28;6;22;.786;2292000;0
5981;5565;839;69;22;1;21;.955;3900000;0
5981;8501;836;0;0;0;0;.00nan;0;0
5981;68390;836;99;39;1;38;.974;3900000;0
5981;78223;839;0;0;0;0;.00nan;0;0
5983;6084;829;75;30;3;27;.900;3600000;0
5983;165723;837;59;39;4;35;.897;3552000;0
5983;16454;829;0;0;0;0;.00nan;0;0
5983;180287;837;0;0;0;0;.00nan;0;0
5985;183545;842;0;0;0;0;.00nan;0;0
5985;16838;830;0;0;0;0;.00nan;0;0
5985;23433;842;19;29;7;22;.759;3600000;0
5985;47791;830;80;40;3;37;.925;3600000;0
5987;5565;839;0;0;0;0;.00nan;0;0
5987;32588;847;80;23;1;22;.957;3900000;0
5987;54017;847;0;0;0;0;.00nan;0;0
5987;78223;839;74;26;1;25;.962;3900000;0
5989;34325;844;75;58;6;52;.897;3600000;0
5989;85453;828;58;15;2;13;.867;3600000;0
5989;85900;828;0;0;0;0;.00nan;0;0
5989;148041;844;0;0;0;0;.00nan;0;0
5991;805;832;0;0;0;0;.00nan;0;0
5991;13373;832;59;34;4;30;.882;3600000;0
5991;15538;834;72;30;2;28;.933;3600000;0
5991;17074;834;0;0;0;0;.00nan;0;0
5993;8501;836;0;0;0;0;.00nan;0;0
5993;32404;833;0;0;0;0;.00nan;0;0
5993;53867;833;88;14;0;14;1.000;3600000;0
5993;68390;836;79;37;3;34;.919;3600000;0
5995;13715;848;0;0;0;0;.00nan;0;0
5995;19322;848;72;24;2;22;.917;3600000;0
5995;48141;831;0;0;0;0;.00nan;0;0
5995;78094;831;45;23;4;19;.826;3578000;0
5997;13715;848;87;34;2;32;.941;3600000;0
5997;19322;848;0;0;0;0;.00nan;0;0
5997;48141;831;61;34;5;29;.853;3600000;0
5997;78094;831;0;0;0;0;.00nan;0;0
5999;6084;829;0;0;0;0;.00nan;0;0
5999;165723;837;0;0;0;0;.00nan;0;0
5999;16454;829;96;36;1;35;.972;3900000;0
5999;180287;837;92;28;1;27;.964;3900000;0
6001;183545;842;69;19;1;18;.947;3712000;0
6001;23433;842;0;0;0;0;.00nan;0;0
6001;85453;828;0;0;0;0;.00nan;0;0
6001;85900;828;86;34;2;32;.941;3712000;0
6003;15538;834;0;0;0;0;.00nan;0;0
6003;17074;834;69;20;1;19;.950;3600000;0
6003;32588;847;0;0;0;0;.00nan;0;0
6003;54017;847;70;49;5;44;.898;3600000;0
6005;8501;836;22;5;3;2;.400;426000;0
6005;34325;844;0;0;0;0;.00nan;0;0
6005;68390;836;48;27;4;23;.852;3174000;0
6005;148041;844;100;35;0;35;1.000;3600000;0
6007;805;832;70;28;3;25;.893;3600000;0
6007;13373;832;0;0;0;0;.00nan;0;0
6007;32404;833;0;0;0;0;.00nan;0;0
6007;53867;833;58;38;4;34;.895;3563000;0
6009;5565;839;65;19;1;18;.947;3600000;0
6009;16838;830;78;42;3;39;.929;3555000;0
6009;47791;830;0;0;0;0;.00nan;0;0
6009;78223;839;0;0;0;0;.00nan;0;0
6011;183545;842;0;0;0;0;.00nan;0;0
6011;23433;842;83;42;3;39;.929;3600000;0
6011;48141;831;0;0;0;0;.00nan;0;0
6011;78094;831;57;19;2;17;.895;3600000;0
6013;5565;839;0;0;0;0;.00nan;0;0
6013;78223;839;58;32;4;28;.875;3600000;0
6013;85453;828;91;29;1;28;.966;3600000;0
6013;85900;828;0;0;0;0;.00nan;0;0
6015;165723;837;45;20;4;16;.800;3600000;0
6015;180287;837;0;0;0;0;.00nan;0;0
6015;34325;844;61;7;0;7;1.000;673000;0
6015;148041;844;49;43;6;37;.860;2912000;0
6017;6084;829;63;42;4;38;.905;3600000;0
6017;13715;848;0;0;0;0;.00nan;0;0
6017;16454;829;0;0;0;0;.00nan;0;0
6017;19322;848;67;26;2;24;.923;3600000;0
6019;16838;830;85;45;3;42;.933;3824000;0
6019;32404;833;0;0;0;0;.00nan;0;0
6019;47791;830;0;0;0;0;.00nan;0;0
6019;53867;833;47;23;4;19;.826;3824000;0
6021;805;832;0;0;0;0;.00nan;0;0
6021;13373;832;55;18;2;16;.889;3600000;0
6021;32588;847;84;50;3;47;.940;3579000;0
6021;54017;847;0;0;0;0;.00nan;0;0
6023;8501;836;0;0;0;0;.00nan;0;0
6023;15538;834;85;28;1;27;.964;3661000;0
6023;17074;834;0;0;0;0;.00nan;0;0
6023;68390;836;92;49;2;47;.959;3661000;0
6025;805;832;59;29;3;26;.897;3551000;0
6025;13373;832;0;0;0;0;.00nan;0;0
6025;48141;831;0;0;0;0;.00nan;0;0
6025;78094;831;84;29;1;28;.966;3600000;0
6027;6084;829;100;41;0;41;1.000;3600000;0
6027;16454;829;0;0;0;0;.00nan;0;0
6027;32588;847;50;29;4;25;.862;3600000;0
6027;54017;847;0;0;0;0;.00nan;0;0
6029;15538;834;0;0;0;0;.00nan;0;0
6029;16838;830;75;43;4;39;.907;3600000;0
6029;17074;834;64;18;1;17;.944;3600000;0
6029;47791;830;0;0;0;0;.00nan;0;0
6031;8501;836;0;0;0;0;.00nan;0;0
6031;183545;842;62;22;2;20;.909;3600000;0
6031;23433;842;0;0;0;0;.00nan;0;0
6031;68390;836;92;45;3;42;.933;3550000;0
6033;5565;839;77;31;3;28;.903;3600000;0
6033;165723;837;77;39;3;36;.923;3587000;0
6033;180287;837;0;0;0;0;.00nan;0;0
6033;78223;839;0;0;0;0;.00nan;0;0
6035;32404;833;0;0;0;0;.00nan;0;0
6035;34325;844;78;45;4;41;.911;3600000;0
6035;53867;833;70;19;1;18;.947;3600000;0
6035;148041;844;0;0;0;0;.00nan;0;0
6037;13715;848;0;0;0;0;.00nan;0;0
6037;19322;848;99;39;1;38;.974;3600000;0
6037;85453;828;39;46;7;39;.848;3600000;0
6037;85900;828;0;0;0;0;.00nan;0;0
6039;183545;842;0;0;0;0;.00nan;0;0
6039;23433;842;74;27;2;25;.926;3600000;0
6039;48141;831;73;21;1;20;.952;3600000;0
6039;78094;831;0;0;0;0;.00nan;0;0
6041;6084;829;89;41;2;39;.951;3600000;0
6041;15538;834;59;28;3;25;.893;3600000;0
6041;16454;829;0;0;0;0;.00nan;0;0
6041;17074;834;0;0;0;0;.00nan;0;0
6043;8501;836;75;39;3;36;.923;3558000;0
6043;34325;844;0;0;0;0;.00nan;0;0
6043;68390;836;0;0;0;0;.00nan;0;0
6043;148041;844;88;32;1;31;.969;3600000;0
6045;5565;839;0;0;0;0;.00nan;0;0
6045;165723;837;0;0;0;0;.00nan;0;0
6045;180287;837;70;31;3;28;.903;3574000;0
6045;78223;839;65;24;2;22;.917;3600000;0
6047;805;832;0;0;0;0;.00nan;0;0
6047;13373;832;22;26;6;20;.769;3600000;0
6047;32404;833;87;28;1;27;.964;3600000;0
6047;53867;833;0;0;0;0;.00nan;0;0
6049;16838;830;0;0;0;0;.00nan;0;0
6049;32588;847;0;0;0;0;.00nan;0;0
6049;47791;830;74;22;2;20;.909;3600000;0
6049;54017;847;64;39;4;35;.897;3559000;0
6051;13715;848;0;0;0;0;.00nan;0;0
6051;19322;848;68;24;2;22;.917;3600000;0
6051;85453;828;0;0;0;0;.00nan;0;0
6051;85900;828;79;37;3;34;.919;3576000;0
1056;805;832;0;0;0;0;.00nan;0;0
1056;13373;832;65;32;3;29;.906;3600000;0
1056;85453;828;71;41;4;37;.902;3600000;0
1056;85900;828;0;0;0;0;.00nan;0;0
1057;15538;842;86;38;4;34;.895;3568000;0
1057;23433;842;0;0;0;0;.00nan;0;0
1057;30431;839;69;29;2;27;.931;3600000;0
1057;78223;839;0;0;0;0;.00nan;0;0
1058;805;832;0;0;0;0;.00nan;0;0
1058;13373;832;71;27;1;26;.963;4343000;0
1058;85453;828;93;30;2;28;.933;4343000;0
1058;85900;828;0;0;0;0;.00nan;0;0
1059;15538;842;100;30;0;30;1.000;3600000;0
1059;23433;842;0;0;0;0;.00nan;0;0
1059;30431;839;47;27;4;23;.852;3600000;0
1059;78223;839;0;0;0;0;.00nan;0;0
1141;15538;842;36;29;6;23;.793;2764000;0
1141;23433;842;46;7;1;6;.857;836000;0
1141;30431;839;73;33;3;30;.909;3600000;0
1141;78223;839;0;0;0;0;.00nan;0;0
1243;30431;839;79;34;2;32;.941;3600000;0
1243;78223;839;0;0;0;0;.00nan;0;0
1243;85453;828;77;33;3;30;.909;3572000;0
1243;85900;828;0;0;0;0;.00nan;0;0
1244;30431;839;30;30;6;24;.800;2527000;0
1244;78223;839;42;4;1;3;.750;1073000;0
1244;85453;828;94;45;1;44;.978;3600000;0
1244;85900;828;0;0;0;0;.00nan;0;0
1422;30431;839;93;23;0;23;1.000;3600000;0
1422;78223;839;0;0;0;0;.00nan;0;0
1422;85453;828;86;27;1;26;.963;3581000;0
1422;85900;828;0;0;0;0;.00nan;0;0
1476;30431;839;90;51;4;47;.922;3552000;0
1476;78223;839;0;0;0;0;.00nan;0;0
1476;147901;834;52;16;3;13;.813;3600000;0
1476;154162;834;0;0;0;0;.00nan;0;0
1477;5663;848;78;41;3;38;.927;4125000;0
1477;165723;837;50;25;4;21;.840;4125000;0
1477;17074;837;0;0;0;0;.00nan;0;0
1477;19322;848;0;0;0;0;.00nan;0;0
1478;32404;833;0;0;0;0;.00nan;0;0
1478;48141;831;0;0;0;0;.00nan;0;0
1478;53867;833;57;39;5;34;.872;3600000;0
1478;78094;831;58;24;3;21;.875;3600000;0
1479;805;832;71;14;0;14;1.000;1898000;0
1479;13373;832;16;22;6;16;.727;1702000;0
1479;16838;830;73;27;2;25;.926;3600000;0
1479;47791;830;0;0;0;0;.00nan;0;0
1480;30431;839;77;46;4;42;.913;3586000;0
1480;78223;839;0;0;0;0;.00nan;0;0
1480;147901;834;62;25;2;23;.920;3600000;0
1480;154162;834;0;0;0;0;.00nan;0;0
1481;5663;848;58;29;4;25;.862;3600000;0
1481;165723;837;89;30;1;29;.967;3600000;0
1481;17074;837;0;0;0;0;.00nan;0;0
1481;19322;848;0;0;0;0;.00nan;0;0
1482;32404;833;0;0;0;0;.00nan;0;0
1482;48141;831;0;0;0;0;.00nan;0;0
1482;53867;833;86;28;2;26;.929;3600000;0
1482;78094;831;46;34;6;28;.824;3600000;0
1483;805;832;0;0;0;0;.00nan;0;0
1483;13373;832;57;35;5;30;.857;3600000;0
1483;16838;830;74;18;1;17;.944;3600000;0
1483;47791;830;0;0;0;0;.00nan;0;0
1484;30431;839;95;43;2;41;.953;3600000;0
1484;78223;839;0;0;0;0;.00nan;0;0
1484;147901;834;75;22;1;21;.955;3600000;0
1484;154162;834;0;0;0;0;.00nan;0;0
1485;5663;848;68;32;4;28;.875;3600000;0
1485;165723;837;100;22;0;22;1.000;3600000;0
1485;17074;837;0;0;0;0;.00nan;0;0
1485;19322;848;0;0;0;0;.00nan;0;0
1486;32404;833;0;0;0;0;.00nan;0;0
1486;48141;831;0;0;0;0;.00nan;0;0
1486;53867;833;68;29;3;26;.897;3600000;0
1486;78094;831;63;42;4;38;.905;3557000;0
1487;805;832;0;0;0;0;.00nan;0;0
1487;13373;832;86;35;2;33;.943;3600000;0
1487;16838;830;83;32;1;31;.969;3600000;0
1487;47791;830;0;0;0;0;.00nan;0;0
1488;30431;839;94;39;2;37;.949;3596000;0
1488;78223;839;0;0;0;0;.00nan;0;0
1488;147901;834;74;23;1;22;.957;3600000;0
1488;154162;834;0;0;0;0;.00nan;0;0
1489;5663;848;79;37;2;35;.946;3600000;0
1489;165723;837;57;32;4;28;.875;3513000;0
1489;17074;837;0;0;0;0;.00nan;0;0
1489;19322;848;0;0;0;0;.00nan;0;0
1490;32404;833;0;0;0;0;.00nan;0;0
1490;48141;831;0;0;0;0;.00nan;0;0
1490;53867;833;60;28;3;25;.893;3519000;0
1490;78094;831;68;21;1;20;.952;3600000;0
1491;805;832;0;0;0;0;.00nan;0;0
1491;13373;832;55;37;5;32;.865;3600000;0
1491;16838;830;44;19;3;16;.842;3600000;0
1491;47791;830;0;0;0;0;.00nan;0;0
1747;5663;848;70;39;4;35;.897;3552000;0
1747;165723;837;58;19;2;17;.895;3600000;0
1747;17074;837;0;0;0;0;.00nan;0;0
1747;19322;848;0;0;0;0;.00nan;0;0
1748;32404;833;0;0;0;0;.00nan;0;0
1748;48141;831;0;0;0;0;.00nan;0;0
1748;53867;833;55;31;4;27;.871;3537000;0
1748;78094;831;63;23;2;21;.913;3600000;0
1852;5663;848;72;46;4;42;.913;3600000;0
1852;165723;837;82;25;1;24;.960;3600000;0
1852;17074;837;0;0;0;0;.00nan;0;0
1852;19322;848;0;0;0;0;.00nan;0;0
1853;32404;833;0;0;0;0;.00nan;0;0
1853;48141;831;0;0;0;0;.00nan;0;0
1853;53867;833;84;37;3;34;.919;3600000;0
1853;78094;831;60;34;4;30;.882;3595000;0
1886;32404;833;0;0;0;0;.00nan;0;0
1886;48141;831;0;0;0;0;.00nan;0;0
1886;53867;833;94;35;2;33;.943;3557000;0
1886;78094;831;64;18;1;17;.944;3600000;0
1899;165723;837;30;13;4;9;.692;841000;0
1899;17074;837;82;37;2;35;.946;2759000;0
1899;147901;834;46;23;5;18;.783;3600000;0
1899;154162;834;0;0;0;0;.00nan;0;0
1900;16838;830;61;28;3;25;.893;3600000;0
1900;47791;830;0;0;0;0;.00nan;0;0
1900;48141;831;0;0;0;0;.00nan;0;0
1900;78094;831;87;37;2;35;.946;3600000;0
1901;165723;837;72;37;4;33;.892;3600000;0
1901;17074;837;0;0;0;0;.00nan;0;0
1901;147901;834;48;12;2;10;.833;3600000;0
1901;154162;834;0;0;0;0;.00nan;0;0
1902;16838;830;96;37;1;36;.973;3600000;0
1902;47791;830;0;0;0;0;.00nan;0;0
1902;48141;831;0;0;0;0;.00nan;0;0
1902;78094;831;44;33;6;27;.818;3600000;0
1903;165723;837;58;29;4;25;.862;2354000;0
1903;17074;837;28;17;4;13;.765;1246000;0
1903;147901;834;78;30;2;28;.933;3600000;0
1903;154162;834;0;0;0;0;.00nan;0;0
1904;16838;830;58;29;3;26;.897;3600000;0
1904;47791;830;0;0;0;0;.00nan;0;0
1904;48141;831;0;0;0;0;.00nan;0;0
1904;78094;831;86;14;0;14;1.000;3600000;0
1905;165723;837;85;43;3;40;.930;3585000;0
1905;17074;837;0;0;0;0;.00nan;0;0
1905;147901;834;72;23;1;22;.957;3600000;0
1905;154162;834;0;0;0;0;.00nan;0;0
1906;16838;830;98;45;1;44;.978;3600000;0
1906;47791;830;0;0;0;0;.00nan;0;0
1906;48141;831;0;0;0;0;.00nan;0;0
1906;78094;831;100;31;0;31;1.000;3600000;0
2137;16838;830;61;23;2;21;.913;3600000;0
2137;47791;830;0;0;0;0;.00nan;0;0
2137;48141;831;0;0;0;0;.00nan;0;0
2137;78094;831;87;39;3;36;.923;3569000;0
2175;16838;830;87;39;3;36;.923;3521000;0
2175;47791;830;0;0;0;0;.00nan;0;0
2175;48141;831;0;0;0;0;.00nan;0;0
2175;78094;831;97;37;1;36;.973;3600000;0
2205;48141;831;0;0;0;0;.00nan;0;0
2205;78094;831;84;34;2;32;.941;3600000;0
2205;147901;834;84;39;3;36;.923;3559000;0
2205;154162;834;0;0;0;0;.00nan;0;0
2206;48141;831;0;0;0;0;.00nan;0;0
2206;78094;831;92;46;2;44;.957;5051000;0
2206;147901;834;85;36;1;35;.972;5051000;0
2206;154162;834;0;0;0;0;.00nan;0;0
2207;48141;831;0;0;0;0;.00nan;0;0
2207;78094;831;66;28;2;26;.929;3600000;0
2207;147901;834;36;21;4;17;.810;3587000;0
2207;154162;834;0;0;0;0;.00nan;0;0
2208;48141;831;0;0;0;0;.00nan;0;0
2208;78094;831;87;39;2;37;.949;3600000;0
2208;147901;834;91;30;1;29;.967;3600000;0
2208;154162;834;0;0;0;0;.00nan;0;0
81;48141;831;0;0;0;0;.00nan;0;0
81;78094;831;75;42;4;38;.905;3600000;0
81;147901;834;61;23;2;21;.913;3600000;0
81;154162;834;0;0;0;0;.00nan;0;0
112;48141;831;0;0;0;0;.00nan;0;0
112;78094;831;74;29;2;27;.931;3600000;0
112;147901;834;38;25;5;20;.800;3600000;0
112;154162;834;0;0;0;0;.00nan;0;0
144;48141;831;0;0;0;0;.00nan;0;0
144;78094;831;68;27;2;25;.926;3600000;0
144;147901;834;74;24;1;23;.958;3600000;0
144;154162;834;0;0;0;0;.00nan;0;0
6052;190702;3737;47;26;4;22;.846;3803000;0
6052;44203;794;73;30;3;27;.900;3803000;0
6052;192030;3737;0;0;0;0;.00nan;0;0
6052;46334;794;0;0;0;0;.00nan;0;0
6053;8107;780;100;40;2;38;.950;3600000;0
6053;19346;796;23;36;8;28;.778;3600000;0
6053;192036;796;0;0;0;0;.00nan;0;0
6053;-1;780;0;0;0;0;.00nan;0;0
6054;165867;776;61;20;2;18;.900;3600000;0
6054;-1;776;0;0;0;0;.00nan;0;0
6054;67362;784;76;17;0;17;1.000;1577000;0
6054;86429;784;39;21;5;16;.762;2023000;0
6055;8487;783;74;35;3;32;.914;3600000;0
6055;34520;798;44;39;6;33;.846;3600000;0
6055;95405;798;0;0;0;0;.00nan;0;0
6055;146184;783;0;0;0;0;.00nan;0;0
6056;34986;777;0;0;0;0;.00nan;0;0
6056;36245;777;68;21;2;19;.905;3554000;0
6056;-1;778;0;0;0;0;.00nan;0;0
6056;54272;778;100;36;0;36;1.000;3600000;0
6057;183377;904;70;29;3;26;.897;3550000;0
6057;43730;2182;56;16;2;14;.875;3600000;0
6057;-1;904;0;0;0;0;.00nan;0;0
6057;66924;2182;0;0;0;0;.00nan;0;0
6058;19346;796;82;27;1;26;.963;3600000;0
6058;34520;798;77;38;3;35;.921;3521000;0
6058;192036;796;0;0;0;0;.00nan;0;0
6058;95405;798;0;0;0;0;.00nan;0;0
6059;165867;776;99;34;2;32;.941;3600000;0
6059;34986;777;0;0;0;0;.00nan;0;0
6059;36245;777;54;30;4;26;.867;3575000;0
6059;-1;776;0;0;0;0;.00nan;0;0
6060;183377;904;0;0;0;0;.00nan;0;0
6060;44203;794;97;32;2;30;.938;3900000;0
6060;-1;904;86;38;2;36;.947;3900000;0
6060;46334;794;0;0;0;0;.00nan;0;0
6061;8107;780;55;25;3;22;.880;3600000;0
6061;190702;3737;51;39;6;33;.846;3600000;0
6061;192030;3737;0;0;0;0;.00nan;0;0
6061;-1;780;0;0;0;0;.00nan;0;0
6062;-1;778;0;0;0;0;.00nan;0;0
6062;43730;2182;98;55;3;52;.945;3593000;0
6062;54272;778;73;23;2;21;.913;3600000;0
6062;66924;2182;0;0;0;0;.00nan;0;0
6063;8487;783;63;28;3;25;.893;3555000;0
6063;67362;784;0;0;0;0;.00nan;0;0
6063;86429;784;93;41;2;39;.951;3600000;0
6063;146184;783;0;0;0;0;.00nan;0;0
6064;183377;904;0;0;0;0;.00nan;0;0
6064;-1;778;0;0;0;0;.00nan;0;0
6064;-1;904;51;34;5;29;.853;3600000;0
6064;54272;778;92;30;1;29;.967;3600000;0
6065;34520;798;60;23;2;21;.913;3600000;0
6065;190702;3737;0;0;0;0;.00nan;0;0
6065;192030;3737;18;33;8;25;.758;3600000;0
6065;95405;798;0;0;0;0;.00nan;0;0
6066;8107;780;69;29;3;26;.897;3600000;0
6066;44203;794;63;37;4;33;.892;3588000;0
6066;-1;780;0;0;0;0;.00nan;0;0
6066;46334;794;0;0;0;0;.00nan;0;0
6067;19346;796;77;39;4;35;.897;3864000;0
6067;192036;796;0;0;0;0;.00nan;0;0
6067;67362;784;62;29;3;26;.897;3864000;0
6067;86429;784;0;0;0;0;.00nan;0;0
6068;8487;783;66;37;5;32;.865;3881000;0
6068;34986;777;68;35;4;31;.886;3881000;0
6068;36245;777;0;0;0;0;.00nan;0;0
6068;146184;783;0;0;0;0;.00nan;0;0
6069;165867;776;100;35;1;34;.971;3600000;0
6069;-1;776;0;0;0;0;.00nan;0;0
6069;43730;2182;46;29;4;25;.862;3600000;0
6069;66924;2182;0;0;0;0;.00nan;0;0
6070;19346;796;51;28;5;23;.821;3591000;0
6070;34986;777;0;0;0;0;.00nan;0;0
6070;36245;777;69;41;4;37;.902;3600000;0
6070;192036;796;0;0;0;0;.00nan;0;0
6071;183377;904;0;0;0;0;.00nan;0;0
6071;165867;776;56;19;2;17;.895;3600000;0
6071;-1;776;0;0;0;0;.00nan;0;0
6071;-1;904;82;48;3;45;.938;3543000;0
6072;-1;778;0;0;0;0;.00nan;0;0
6072;44203;794;0;0;0;0;.00nan;0;0
6072;46334;794;53;33;5;28;.848;3600000;0
6072;54272;778;53;27;3;24;.889;3600000;0
6073;190702;3737;68;39;4;35;.897;3568000;0
6073;192030;3737;0;0;0;0;.00nan;0;0
6073;67362;784;54;24;3;21;.875;3600000;0
6073;86429;784;0;0;0;0;.00nan;0;0
6074;8487;783;75;35;3;32;.914;3600000;0
6074;43730;2182;92;43;2;41;.953;3600000;0
6074;66924;2182;0;0;0;0;.00nan;0;0
6074;146184;783;0;0;0;0;.00nan;0;0
6075;8107;780;42;35;6;29;.829;3600000;0
6075;34520;798;0;0;0;0;.00nan;0;0
6075;-1;780;0;0;0;0;.00nan;0;0
6075;95405;798;95;35;1;34;.971;3600000;0
6076;165867;776;74;29;3;26;.897;3600000;0
6076;-1;778;0;0;0;0;.00nan;0;0
6076;-1;776;0;0;0;0;.00nan;0;0
6076;54272;778;77;58;6;52;.897;3600000;0
6077;8107;780;100;37;1;36;.973;3600000;0
6077;-1;780;0;0;0;0;.00nan;0;0
6077;67362;784;0;0;0;0;.00nan;0;0
6077;86429;784;72;33;3;30;.909;3515000;0
6078;8487;783;0;0;0;0;.00nan;0;0
6078;183377;904;23;22;5;17;.773;3556000;0
6078;-1;904;0;0;0;0;.00nan;0;0
6078;146184;783;63;35;4;31;.886;3600000;0
6079;34986;777;0;0;0;0;.00nan;0;0
6079;36245;777;79;18;0;18;1.000;3600000;0
6079;190702;3737;69;32;3;29;.906;3600000;0
6079;192030;3737;0;0;0;0;.00nan;0;0
6080;34520;798;0;0;0;0;.00nan;0;0
6080;44203;794;64;40;5;35;.875;3600000;0
6080;46334;794;0;0;0;0;.00nan;0;0
6080;95405;798;93;36;1;35;.972;3600000;0
6081;19346;796;78;25;1;24;.960;3600000;0
6081;43730;2182;0;0;0;0;.00nan;0;0
6081;192036;796;0;0;0;0;.00nan;0;0
6081;66924;2182;80;37;2;35;.946;3600000;0
6082;183377;904;0;0;0;0;.00nan;0;0
6082;19346;796;0;0;0;0;.00nan;0;0
6082;192036;796;23;21;5;16;.762;3519000;0
6082;-1;904;73;38;3;35;.921;3600000;0
6083;8107;780;0;0;0;0;.00nan;0;0
6083;34986;777;0;0;0;0;.00nan;0;0
6083;36245;777;77;33;3;30;.909;3600000;0
6083;-1;780;22;24;6;18;.750;3600000;0
6084;165867;776;67;23;2;21;.913;3769000;0
6084;-1;776;0;0;0;0;.00nan;0;0
6084;44203;794;0;0;0;0;.00nan;0;0
6084;46334;794;69;29;3;26;.897;3769000;0
6085;190702;3737;62;30;3;27;.900;3900000;0
6085;43730;2182;72;38;3;35;.921;3900000;0
6085;192030;3737;0;0;0;0;.00nan;0;0
6085;66924;2182;0;0;0;0;.00nan;0;0
6086;8487;783;54;29;4;25;.862;3547000;0
6086;-1;778;0;0;0;0;.00nan;0;0
6086;54272;778;79;42;3;39;.929;3600000;0
6086;146184;783;0;0;0;0;.00nan;0;0
6087;34520;798;74;36;4;32;.889;3518000;0
6087;67362;784;59;17;2;15;.882;3600000;0
6087;86429;784;0;0;0;0;.00nan;0;0
6087;95405;798;0;0;0;0;.00nan;0;0
6088;19346;796;56;17;2;15;.882;3600000;0
6088;-1;778;0;0;0;0;.00nan;0;0
6088;192036;796;0;0;0;0;.00nan;0;0
6088;54272;778;81;40;3;37;.925;3548000;0
6089;183377;904;98;47;1;46;.979;3600000;0
6089;190702;3737;0;0;0;0;.00nan;0;0
6089;192030;3737;68;20;2;18;.900;3573000;0
6089;-1;904;0;0;0;0;.00nan;0;0
6090;8107;780;67;27;2;25;.926;3600000;0
6090;43730;2182;61;29;4;25;.862;3561000;0
6090;-1;780;0;0;0;0;.00nan;0;0
6090;66924;2182;0;0;0;0;.00nan;0;0
6091;44203;794;79;29;1;28;.966;3600000;0
6091;46334;794;0;0;0;0;.00nan;0;0
6091;67362;784;0;0;0;0;.00nan;0;0
6091;86429;784;37;20;4;16;.800;3600000;0
6092;8487;783;67;39;4;35;.897;3690000;0
6092;165867;776;59;29;3;26;.897;3690000;0
6092;-1;776;0;0;0;0;.00nan;0;0
6092;146184;783;0;0;0;0;.00nan;0;0
6093;34520;798;100;43;0;43;1.000;3600000;0
6093;34986;777;77;32;2;30;.938;3600000;0
6093;36245;777;0;0;0;0;.00nan;0;0
6093;95405;798;0;0;0;0;.00nan;0;0
6094;8107;780;93;16;0;16;1.000;3600000;0
6094;183377;904;0;0;0;0;.00nan;0;0
6094;-1;904;79;42;3;39;.929;3600000;0
6094;-1;780;0;0;0;0;.00nan;0;0
6095;34986;777;0;0;0;0;.00nan;0;0
6095;36245;777;73;33;3;30;.909;3563000;0
6095;67362;784;0;0;0;0;.00nan;0;0
6095;86429;784;87;28;1;27;.964;3600000;0
6096;165867;776;54;29;4;25;.862;3571000;0
6096;19346;796;69;30;3;27;.900;3600000;0
6096;-1;776;0;0;0;0;.00nan;0;0
6096;192036;796;0;0;0;0;.00nan;0;0
6097;8487;783;54;28;4;24;.857;3600000;0
6097;44203;794;0;0;0;0;.00nan;0;0
6097;46334;794;91;32;1;31;.969;3600000;0
6097;146184;783;0;0;0;0;.00nan;0;0
6098;190702;3737;27;27;6;21;.778;3600000;0
6098;-1;778;0;0;0;0;.00nan;0;0
6098;192030;3737;0;0;0;0;.00nan;0;0
6098;54272;778;62;25;3;22;.880;3600000;0
6099;34520;798;78;20;1;19;.950;3600000;0
6099;43730;2182;49;31;4;27;.871;3600000;0
6099;66924;2182;0;0;0;0;.00nan;0;0
6099;95405;798;0;0;0;0;.00nan;0;0
6100;8107;780;46;43;7;36;.837;2743000;0
6100;-1;778;0;0;0;0;.00nan;0;0
6100;-1;780;46;5;1;4;.800;857000;0
6100;54272;778;92;40;2;38;.950;3600000;0
6101;8487;783;78;42;3;39;.929;3663000;0
6101;19346;796;69;33;4;29;.879;3663000;0
6101;192036;796;0;0;0;0;.00nan;0;0
6101;146184;783;0;0;0;0;.00nan;0;0
6102;165867;776;49;22;3;19;.864;3583000;0
6102;190702;3737;100;28;0;28;1.000;3600000;0
6102;-1;776;0;0;0;0;.00nan;0;0
6102;192030;3737;0;0;0;0;.00nan;0;0
6103;34986;777;0;0;0;0;.00nan;0;0
6103;36245;777;59;24;3;21;.875;3600000;0
6103;44203;794;95;25;0;25;1.000;3600000;0
6103;46334;794;0;0;0;0;.00nan;0;0
6104;183377;904;59;38;4;34;.895;3600000;0
6104;34520;798;0;0;0;0;.00nan;0;0
6104;-1;904;0;0;0;0;.00nan;0;0
6104;95405;798;100;28;1;27;.964;3600000;0
6105;43730;2182;0;0;0;0;.00nan;0;0
6105;66924;2182;41;39;6;33;.846;3600000;0
6105;67362;784;0;0;0;0;.00nan;0;0
6105;86429;784;73;28;1;27;.964;3600000;0
6106;8107;780;0;0;0;0;.00nan;0;0
6106;165867;776;89;29;1;28;.966;3600000;0
6106;-1;776;0;0;0;0;.00nan;0;0
6106;-1;780;59;35;4;31;.886;3600000;0
6107;183377;904;0;0;0;0;.00nan;0;0
6107;-1;904;78;37;4;33;.892;3600000;0
6107;67362;784;0;0;0;0;.00nan;0;0
6107;86429;784;77;24;1;23;.958;3600000;0
6108;19346;796;56;28;4;24;.857;3594000;0
6108;44203;794;78;39;3;36;.923;3600000;0
6108;192036;796;0;0;0;0;.00nan;0;0
6108;46334;794;0;0;0;0;.00nan;0;0
6109;8487;783;61;33;4;29;.879;3600000;0
6109;190702;3737;37;28;5;23;.821;3600000;0
6109;192030;3737;0;0;0;0;.00nan;0;0
6109;146184;783;0;0;0;0;.00nan;0;0
6110;34986;777;99;33;1;32;.970;3600000;0
6110;36245;777;0;0;0;0;.00nan;0;0
6110;43730;2182;52;43;6;37;.860;3198000;0
6110;66924;2182;53;3;0;3;1.000;402000;0
6111;34520;798;0;0;0;0;.00nan;0;0
6111;-1;778;0;0;0;0;.00nan;0;0
6111;54272;778;71;48;5;43;.896;3600000;0
6111;95405;798;32;32;6;26;.813;3563000;0
6112;19346;796;51;28;4;24;.857;3600000;0
6112;190702;3737;0;0;0;0;.00nan;0;0
6112;192030;3737;94;37;1;36;.973;3600000;0
6112;192036;796;0;0;0;0;.00nan;0;0
6113;-1;778;0;0;0;0;.00nan;0;0
6113;54272;778;97;34;1;33;.971;3869000;0
6113;67362;784;0;0;0;0;.00nan;0;0
6113;86429;784;82;34;2;32;.941;3869000;0
6114;43730;2182;90;39;2;37;.949;3600000;0
6114;44203;794;38;21;4;17;.810;3567000;0
6114;46334;794;0;0;0;0;.00nan;0;0
6114;66924;2182;0;0;0;0;.00nan;0;0
6115;165867;776;88;19;0;19;1.000;3600000;0
6115;34520;798;92;46;3;43;.935;3600000;0
6115;-1;776;0;0;0;0;.00nan;0;0
6115;95405;798;0;0;0;0;.00nan;0;0
6116;8107;780;54;37;5;32;.865;3566000;0
6116;8487;783;0;0;0;0;.00nan;0;0
6116;-1;780;0;0;0;0;.00nan;0;0
6116;146184;783;51;29;4;25;.862;3600000;0
6117;183377;904;53;39;5;34;.872;3600000;0
6117;34986;777;0;0;0;0;.00nan;0;0
6117;36245;777;64;17;1;16;.941;3600000;0
6117;-1;904;0;0;0;0;.00nan;0;0
6118;8107;780;98;46;2;44;.957;3565000;0
6118;19346;796;61;16;1;15;.938;3600000;0
6118;192036;796;0;0;0;0;.00nan;0;0
6118;-1;780;0;0;0;0;.00nan;0;0
6119;165867;776;79;29;2;27;.931;3600000;0
6119;-1;776;0;0;0;0;.00nan;0;0
6119;67362;784;0;0;0;0;.00nan;0;0
6119;86429;784;79;39;3;36;.923;3566000;0
6120;190702;3737;63;18;1;17;.944;3600000;0
6120;44203;794;100;37;0;37;1.000;3600000;0
6120;192030;3737;0;0;0;0;.00nan;0;0
6120;46334;794;0;0;0;0;.00nan;0;0
6121;34986;777;88;16;0;16;1.000;3600000;0
6121;36245;777;0;0;0;0;.00nan;0;0
6121;-1;778;0;0;0;0;.00nan;0;0
6121;54272;778;81;52;5;47;.904;3600000;0
6122;8487;783;39;28;5;23;.821;3600000;0
6122;34520;798;54;38;6;32;.842;3560000;0
6122;95405;798;0;0;0;0;.00nan;0;0
6122;146184;783;0;0;0;0;.00nan;0;0
6123;183377;904;0;0;0;0;.00nan;0;0
6123;43730;2182;75;35;3;32;.914;3640000;0
6123;-1;904;78;34;2;32;.941;3640000;0
6123;66924;2182;0;0;0;0;.00nan;0;0
6124;19346;796;79;29;1;28;.966;3600000;0
6124;34520;798;69;39;4;35;.897;3600000;0
6124;192036;796;0;0;0;0;.00nan;0;0
6124;95405;798;0;0;0;0;.00nan;0;0
6125;8107;780;0;0;0;0;.00nan;0;0
6125;190702;3737;76;36;4;32;.889;3900000;0
6125;192030;3737;0;0;0;0;.00nan;0;0
6125;-1;780;50;24;4;20;.833;3900000;0
6126;183377;904;82;25;0;25;1.000;3069000;0
6126;44203;794;98;21;0;21;1.000;3600000;0
6126;-1;904;22;5;3;2;.400;531000;0
6126;46334;794;0;0;0;0;.00nan;0;0
6127;8487;783;55;33;5;28;.848;3600000;0
6127;67362;784;73;21;1;20;.952;3600000;0
6127;86429;784;0;0;0;0;.00nan;0;0
6127;146184;783;0;0;0;0;.00nan;0;0
6128;165867;776;71;28;2;26;.929;3600000;0
6128;34986;777;66;33;4;29;.879;3600000;0
6128;36245;777;0;0;0;0;.00nan;0;0
6128;-1;776;0;0;0;0;.00nan;0;0
6129;-1;778;0;0;0;0;.00nan;0;0
6129;43730;2182;0;0;0;0;.00nan;0;0
6129;54272;778;51;28;4;24;.857;3564000;0
6129;66924;2182;74;34;3;31;.912;3600000;0
6130;19346;796;52;22;3;19;.864;3553000;0
6130;192036;796;0;0;0;0;.00nan;0;0
6130;67362;784;68;26;2;24;.923;3600000;0
6130;86429;784;0;0;0;0;.00nan;0;0
6131;165867;776;65;19;2;17;.895;3600000;0
6131;-1;776;0;0;0;0;.00nan;0;0
6131;43730;2182;57;33;4;29;.879;3541000;0
6131;66924;2182;0;0;0;0;.00nan;0;0
6132;8107;780;63;24;2;22;.917;3600000;0
6132;44203;794;81;38;3;35;.921;3556000;0
6132;-1;780;0;0;0;0;.00nan;0;0
6132;46334;794;0;0;0;0;.00nan;0;0
6133;34520;798;50;19;3;16;.842;3600000;0
6133;190702;3737;0;0;0;0;.00nan;0;0
6133;192030;3737;81;40;4;36;.900;3594000;0
6133;95405;798;0;0;0;0;.00nan;0;0
6134;183377;904;58;28;3;25;.893;3900000;0
6134;-1;778;0;0;0;0;.00nan;0;0
6134;-1;904;0;0;0;0;.00nan;0;0
6134;54272;778;94;41;3;38;.927;3900000;0
6135;8487;783;0;0;0;0;.00nan;0;0
6135;34986;777;0;0;0;0;.00nan;0;0
6135;36245;777;88;34;2;32;.941;3600000;0
6135;146184;783;64;30;3;27;.900;3584000;0
6136;-1;778;0;0;0;0;.00nan;0;0
6136;44203;794;97;28;1;27;.964;3785000;0
6136;46334;794;0;0;0;0;.00nan;0;0
6136;54272;778;85;36;2;34;.944;3785000;0
6137;8107;780;62;36;4;32;.889;3600000;0
6137;34520;798;68;27;3;24;.889;3600000;0
6137;-1;780;0;0;0;0;.00nan;0;0
6137;95405;798;0;0;0;0;.00nan;0;0
6138;190702;3737;75;24;1;23;.958;3600000;0
6138;192030;3737;0;0;0;0;.00nan;0;0
6138;67362;784;88;35;2;33;.943;3596000;0
6138;86429;784;0;0;0;0;.00nan;0;0
6139;183377;904;34;50;8;42;.840;2204000;0
6139;165867;776;70;24;2;22;.917;3600000;0
6139;-1;776;0;0;0;0;.00nan;0;0
6139;-1;904;72;28;2;26;.929;1396000;0
6140;19346;796;63;42;5;37;.881;3900000;0
6140;34986;777;34;23;5;18;.783;3900000;0
6140;36245;777;0;0;0;0;.00nan;0;0
6140;192036;796;0;0;0;0;.00nan;0;0
6141;8487;783;52;21;3;18;.857;3553000;0
6141;43730;2182;98;44;2;42;.955;3600000;0
6141;66924;2182;0;0;0;0;.00nan;0;0
6141;146184;783;0;0;0;0;.00nan;0;0
6142;19346;796;55;25;3;22;.880;3555000;0
6142;43730;2182;78;29;1;28;.966;3600000;0
6142;192036;796;0;0;0;0;.00nan;0;0
6142;66924;2182;0;0;0;0;.00nan;0;0
6143;8107;780;26;23;5;18;.783;3598000;0
6143;-1;780;0;0;0;0;.00nan;0;0
6143;67362;784;0;0;0;0;.00nan;0;0
6143;86429;784;58;34;4;30;.882;3600000;0
6144;165867;776;61;26;3;23;.885;3600000;0
6144;-1;778;0;0;0;0;.00nan;0;0
6144;-1;776;0;0;0;0;.00nan;0;0
6144;54272;778;71;45;5;40;.889;3518000;0
6145;34520;798;35;35;6;29;.829;3600000;0
6145;44203;794;99;38;2;36;.947;3600000;0
6145;46334;794;0;0;0;0;.00nan;0;0
6145;95405;798;0;0;0;0;.00nan;0;0
6146;8487;783;27;7;3;4;.571;504000;0
6146;183377;904;44;21;3;18;.857;1699000;0
6146;-1;904;28;30;6;24;.800;1901000;0
6146;146184;783;74;21;1;20;.952;3096000;0
6147;34986;777;0;0;0;0;.00nan;0;0
6147;36245;777;82;27;1;26;.963;3600000;0
6147;190702;3737;59;35;5;30;.857;3600000;0
6147;192030;3737;0;0;0;0;.00nan;0;0
6148;8487;783;89;19;0;19;1.000;3600000;0
6148;-1;778;0;0;0;0;.00nan;0;0
6148;54272;778;98;64;2;62;.969;3562000;0
6148;146184;783;0;0;0;0;.00nan;0;0
6149;183377;904;0;0;0;0;.00nan;0;0
6149;19346;796;0;0;0;0;.00nan;0;0
6149;192036;796;75;34;3;31;.912;3600000;0
6149;-1;904;78;41;4;37;.902;3581000;0
6150;34520;798;58;38;5;33;.868;3600000;0
6150;67362;784;67;22;2;20;.909;3600000;0
6150;86429;784;0;0;0;0;.00nan;0;0
6150;95405;798;0;0;0;0;.00nan;0;0
6151;165867;776;0;0;0;0;.00nan;0;0
6151;-1;776;41;17;3;14;.824;3600000;0
6151;44203;794;100;33;0;33;1.000;3600000;0
6151;46334;794;0;0;0;0;.00nan;0;0
6152;8107;780;49;28;4;24;.857;3600000;0
6152;34986;777;87;36;1;35;.972;3600000;0
6152;36245;777;0;0;0;0;.00nan;0;0
6152;-1;780;0;0;0;0;.00nan;0;0
6153;190702;3737;90;26;2;24;.923;3900000;0
6153;43730;2182;0;0;0;0;.00nan;0;0
6153;192030;3737;0;0;0;0;.00nan;0;0
6153;66924;2182;97;49;2;47;.959;3900000;0
6154;19346;796;58;28;3;25;.893;3900000;0
6154;-1;778;0;0;0;0;.00nan;0;0
6154;192036;796;0;0;0;0;.00nan;0;0
6154;54272;778;84;44;3;41;.932;3900000;0
6155;8107;780;51;28;4;24;.857;3600000;0
6155;43730;2182;0;0;0;0;.00nan;0;0
6155;-1;780;0;0;0;0;.00nan;0;0
6155;66924;2182;88;28;1;27;.964;3600000;0
6156;183377;904;47;42;6;36;.857;3600000;0
6156;190702;3737;0;0;0;0;.00nan;0;0
6156;192030;3737;74;21;2;19;.905;3600000;0
6156;-1;904;0;0;0;0;.00nan;0;0
6157;8487;783;62;33;4;29;.879;3600000;0
6157;165867;776;70;24;2;22;.917;3600000;0
6157;-1;776;0;0;0;0;.00nan;0;0
6157;146184;783;0;0;0;0;.00nan;0;0
6158;34520;798;63;31;4;27;.871;3600000;0
6158;34986;777;50;45;6;39;.867;2348000;0
6158;36245;777;40;9;2;7;.778;1252000;0
6158;95405;798;0;0;0;0;.00nan;0;0
6159;44203;794;64;35;4;31;.886;3600000;0
6159;46334;794;0;0;0;0;.00nan;0;0
6159;67362;784;77;23;1;22;.957;3600000;0
6159;86429;784;0;0;0;0;.00nan;0;0
6160;8107;780;0;0;0;0;.00nan;0;0
6160;183377;904;0;0;0;0;.00nan;0;0
6160;-1;904;56;28;4;24;.857;3900000;0
6160;-1;780;62;36;4;32;.889;3900000;0
6161;165867;776;100;22;0;22;1.000;3600000;0
6161;19346;796;65;43;5;38;.884;3600000;0
6161;-1;776;0;0;0;0;.00nan;0;0
6161;192036;796;0;0;0;0;.00nan;0;0
6162;190702;3737;78;25;2;23;.920;3588000;0
6162;-1;778;0;0;0;0;.00nan;0;0
6162;192030;3737;0;0;0;0;.00nan;0;0
6162;54272;778;91;30;1;29;.967;3600000;0
6163;8487;783;0;0;0;0;.00nan;0;0
6163;44203;794;72;26;2;24;.923;3900000;0
6163;46334;794;0;0;0;0;.00nan;0;0
6163;146184;783;81;31;2;29;.935;3900000;0
6164;34986;777;72;28;2;26;.929;3600000;0
6164;36245;777;0;0;0;0;.00nan;0;0
6164;67362;784;86;44;3;41;.932;3552000;0
6164;86429;784;0;0;0;0;.00nan;0;0
6165;34520;798;45;31;5;26;.839;3557000;0
6165;43730;2182;58;30;4;26;.867;3600000;0
6165;66924;2182;0;0;0;0;.00nan;0;0
6165;95405;798;0;0;0;0;.00nan;0;0
6166;8107;780;67;21;1;20;.952;3600000;0
6166;-1;778;0;0;0;0;.00nan;0;0
6166;-1;780;0;0;0;0;.00nan;0;0
6166;54272;778;86;48;4;44;.917;3600000;0
6167;190702;3737;14;22;6;16;.727;2299000;0
6167;-1;776;0;0;0;0;.00nan;0;0
6167;192030;3737;43;9;2;7;.778;1301000;0
6167;83199;776;95;27;1;26;.963;3600000;0
6168;8487;783;80;36;2;34;.944;3600000;0
6168;19346;796;59;21;3;18;.857;3573000;0
6168;192036;796;0;0;0;0;.00nan;0;0
6168;146184;783;0;0;0;0;.00nan;0;0
6169;34986;777;0;0;0;0;.00nan;0;0
6169;36245;777;72;33;4;29;.879;3900000;0
6169;44203;794;97;48;4;44;.917;3900000;0
6169;46334;794;0;0;0;0;.00nan;0;0
6170;43730;2182;0;0;0;0;.00nan;0;0
6170;66924;2182;82;41;2;39;.951;3554000;0
6170;67362;784;0;0;0;0;.00nan;0;0
6170;86429;784;83;18;0;18;1.000;3600000;0
6171;183377;904;60;25;3;22;.880;3600000;0
6171;34520;798;0;0;0;0;.00nan;0;0
6171;-1;904;0;0;0;0;.00nan;0;0
6171;95405;798;63;38;4;34;.895;3587000;0
6172;19346;796;57;21;2;19;.905;3600000;0
6172;44203;794;62;29;3;26;.897;3552000;0
6172;192036;796;0;0;0;0;.00nan;0;0
6172;46334;794;0;0;0;0;.00nan;0;0
6173;183377;904;0;0;0;0;.00nan;0;0
6173;-1;904;84;37;2;35;.946;3900000;0
6173;67362;784;0;0;0;0;.00nan;0;0
6173;86429;784;78;38;2;36;.947;3900000;0
6174;8107;780;0;0;0;0;.00nan;0;0
6174;165867;776;87;21;0;21;1.000;3890000;0
6174;-1;776;0;0;0;0;.00nan;0;0
6174;-1;780;92;40;1;39;.975;3890000;0
6175;34520;798;61;26;3;23;.885;3600000;0
6175;-1;778;0;0;0;0;.00nan;0;0
6175;54272;778;100;41;0;41;1.000;3600000;0
6175;95405;798;0;0;0;0;.00nan;0;0
6176;8487;783;53;27;3;24;.889;3559000;0
6176;190702;3737;77;29;2;27;.931;3600000;0
6176;192030;3737;0;0;0;0;.00nan;0;0
6176;146184;783;0;0;0;0;.00nan;0;0
6177;34986;777;0;0;0;0;.00nan;0;0
6177;36245;777;72;33;3;30;.909;3900000;0
6177;43730;2182;73;37;3;34;.919;3900000;0
6177;66924;2182;0;0;0;0;.00nan;0;0
6178;19346;796;29;16;4;12;.750;814000;0
6178;190702;3737;96;39;2;37;.949;3600000;0
6178;192030;3737;0;0;0;0;.00nan;0;0
6178;192036;796;58;23;2;21;.913;2786000;0
6179;8107;780;0;0;0;0;.00nan;0;0
6179;8487;783;87;18;0;18;1.000;3600000;0
6179;-1;780;59;28;3;25;.893;3600000;0
6179;146184;783;0;0;0;0;.00nan;0;0
6180;-1;778;0;0;0;0;.00nan;0;0
6180;54272;778;70;33;3;30;.909;3546000;0
6180;67362;784;0;0;0;0;.00nan;0;0
6180;86429;784;68;21;1;20;.952;3600000;0
6181;183377;904;0;0;0;0;.00nan;0;0
6181;34986;777;75;24;1;23;.958;3600000;0
6181;36245;777;0;0;0;0;.00nan;0;0
6181;-1;904;73;36;3;33;.917;3600000;0
6182;165867;776;77;38;3;35;.921;3550000;0
6182;34520;798;89;32;2;30;.938;3600000;0
6182;-1;776;0;0;0;0;.00nan;0;0
6182;95405;798;0;0;0;0;.00nan;0;0
6183;43730;2182;70;27;2;25;.926;3600000;0
6183;44203;794;76;36;4;32;.889;3562000;0
6183;46334;794;0;0;0;0;.00nan;0;0
6183;66924;2182;0;0;0;0;.00nan;0;0
6184;8107;780;67;25;3;22;.880;3846000;0
6184;19346;796;59;33;4;29;.879;3846000;0
6184;192036;796;0;0;0;0;.00nan;0;0
6184;-1;780;0;0;0;0;.00nan;0;0
6185;165867;776;73;34;3;31;.912;3600000;0
6185;-1;776;0;0;0;0;.00nan;0;0
6185;67362;784;86;45;4;41;.911;3600000;0
6185;86429;784;0;0;0;0;.00nan;0;0
6186;190702;3737;0;0;0;0;.00nan;0;0
6186;44203;794;67;25;2;23;.920;3554000;0
6186;192030;3737;92;36;1;35;.972;3600000;0
6186;46334;794;0;0;0;0;.00nan;0;0
6187;183377;904;96;32;1;31;.969;3900000;0
6187;43730;2182;75;28;1;27;.964;3900000;0
6187;-1;904;0;0;0;0;.00nan;0;0
6187;66924;2182;0;0;0;0;.00nan;0;0
6188;8487;783;67;41;4;37;.902;3600000;0
6188;34520;798;86;36;2;34;.944;3600000;0
6188;95405;798;0;0;0;0;.00nan;0;0
6188;146184;783;0;0;0;0;.00nan;0;0
6189;34986;777;0;0;0;0;.00nan;0;0
6189;36245;777;68;33;3;30;.909;3732000;0
6189;-1;778;0;0;0;0;.00nan;0;0
6189;54272;778;88;53;4;49;.925;3732000;0
6190;-1;778;0;0;0;0;.00nan;0;0
6190;43730;2182;56;24;3;21;.875;3600000;0
6190;54272;778;89;30;2;28;.933;3600000;0
6190;66924;2182;0;0;0;0;.00nan;0;0
6191;8107;780;57;32;4;28;.875;3600000;0
6191;190702;3737;98;23;0;23;1.000;3600000;0
6191;192030;3737;0;0;0;0;.00nan;0;0
6191;-1;780;0;0;0;0;.00nan;0;0
6192;183377;904;0;0;0;0;.00nan;0;0
6192;44203;794;98;36;1;35;.972;3900000;0
6192;-1;904;82;23;1;22;.957;3900000;0
6192;46334;794;0;0;0;0;.00nan;0;0
6193;165867;777;40;28;5;23;.821;3600000;0
6193;36245;777;0;0;0;0;.00nan;0;0
6193;-1;776;0;0;0;0;.00nan;0;0
6193;83199;776;62;20;2;18;.900;3600000;0
6194;8487;783;64;16;1;15;.938;3600000;0
6194;67362;784;0;0;0;0;.00nan;0;0
6194;86429;784;61;32;4;28;.875;3600000;0
6194;146184;783;0;0;0;0;.00nan;0;0
6195;19346;796;98;39;2;37;.949;3672000;0
6195;34520;798;84;41;3;38;.927;3705000;0
6195;192036;796;0;0;0;0;.00nan;0;0
6195;95405;798;0;0;0;0;.00nan;0;0
6196;8107;780;0;0;0;0;.00nan;0;0
6196;44203;794;97;28;1;27;.964;3900000;0
6196;-1;780;95;32;1;31;.969;3900000;0
6196;46334;794;0;0;0;0;.00nan;0;0
6197;19346;796;85;31;1;30;.968;3600000;0
6197;192036;796;0;0;0;0;.00nan;0;0
6197;67362;784;77;51;5;46;.902;3600000;0
6197;86429;784;0;0;0;0;.00nan;0;0
6198;183377;904;20;24;5;19;.792;3900000;0
6198;-1;778;0;0;0;0;.00nan;0;0
6198;-1;904;0;0;0;0;.00nan;0;0
6198;54272;778;51;32;5;27;.844;3900000;0
6199;8487;783;34;31;6;25;.806;2952000;0
6199;165867;777;70;27;2;25;.926;3600000;0
6199;36245;777;0;0;0;0;.00nan;0;0
6199;146184;783;57;7;1;6;.857;648000;0
6200;34520;798;65;21;2;19;.905;3743000;0
6200;190702;3737;82;41;3;38;.927;3743000;0
6200;192030;3737;0;0;0;0;.00nan;0;0
6200;95405;798;0;0;0;0;.00nan;0;0
6201;-1;776;0;0;0;0;.00nan;0;0
6201;43730;2182;38;12;3;9;.750;714000;0
6201;66924;2182;39;34;6;28;.824;2886000;0
6201;83199;776;68;25;3;22;.880;3600000;0
6202;8107;780;88;42;3;39;.929;3600000;0
6202;165867;777;60;32;4;28;.875;3575000;0
6202;36245;777;0;0;0;0;.00nan;0;0
6202;-1;780;0;0;0;0;.00nan;0;0
6203;19346;796;57;34;4;30;.882;3524000;0
6203;44203;794;86;34;2;32;.941;3600000;0
6203;192036;796;0;0;0;0;.00nan;0;0
6203;46334;794;0;0;0;0;.00nan;0;0
6204;183377;904;0;0;0;0;.00nan;0;0
6204;-1;904;60;36;4;32;.889;3600000;0
6204;67362;784;40;29;6;23;.793;3557000;0
6204;86429;784;0;0;0;0;.00nan;0;0
6205;8487;783;0;0;0;0;.00nan;0;0
6205;190702;3737;83;42;3;39;.929;3600000;0
6205;192030;3737;0;0;0;0;.00nan;0;0
6205;146184;783;22;27;6;21;.778;3600000;0
6206;34520;798;90;33;1;32;.970;3600000;0
6206;-1;776;0;0;0;0;.00nan;0;0
6206;83199;776;65;41;4;37;.902;3600000;0
6206;95405;798;0;0;0;0;.00nan;0;0
6207;-1;778;0;0;0;0;.00nan;0;0
6207;43730;2182;0;0;0;0;.00nan;0;0
6207;54272;778;59;28;3;25;.893;3587000;0
6207;66924;2182;89;42;2;40;.952;3600000;0
6208;190702;3737;0;0;0;0;.00nan;0;0
6208;-1;778;57;8;0;8;1.000;1101000;0
6208;192030;3737;75;41;4;37;.902;3600000;0
6208;54272;778;43;31;6;25;.806;2433000;0
6209;165867;777;84;37;3;34;.919;3900000;0
6209;19346;796;65;28;3;25;.893;3900000;0
6209;36245;777;0;0;0;0;.00nan;0;0
6209;192036;796;0;0;0;0;.00nan;0;0
6210;8107;780;62;22;2;20;.909;3600000;0
6210;44203;794;37;34;6;28;.824;3600000;0
6210;-1;780;0;0;0;0;.00nan;0;0
6210;46334;794;0;0;0;0;.00nan;0;0
6211;183377;904;0;0;0;0;.00nan;0;0
6211;-1;776;0;0;0;0;.00nan;0;0
6211;-1;904;94;52;3;49;.942;3600000;0
6211;83199;776;96;23;0;23;1.000;3600000;0
6212;8487;783;56;20;3;17;.850;3600000;0
6212;43730;2182;0;0;0;0;.00nan;0;0
6212;66924;2182;68;42;4;38;.905;3551000;0
6212;146184;783;0;0;0;0;.00nan;0;0
6213;34520;798;0;0;0;0;.00nan;0;0
6213;67362;784;48;7;1;6;.857;427000;0
6213;86429;784;38;26;5;21;.808;3173000;0
6213;95405;798;42;19;3;16;.842;3600000;0
6214;8107;780;57;36;5;31;.861;3600000;0
6214;19346;796;37;34;6;28;.824;3600000;0
6214;192036;796;0;0;0;0;.00nan;0;0
6214;-1;780;0;0;0;0;.00nan;0;0
6215;-1;776;0;0;0;0;.00nan;0;0
6215;67362;784;81;37;2;35;.946;3600000;0
6215;83199;776;80;39;3;36;.923;3546000;0
6215;86429;784;0;0;0;0;.00nan;0;0
6216;183377;904;32;19;4;15;.789;1200000;0
6216;34520;798;57;23;3;20;.870;3600000;0
6216;-1;904;56;32;5;27;.844;2400000;0
6216;95405;798;0;0;0;0;.00nan;0;0
6217;8487;783;64;33;4;29;.879;3599000;0
6217;-1;778;82;42;3;39;.929;3600000;0
6217;54272;778;0;0;0;0;.00nan;0;0
6217;146184;783;0;0;0;0;.00nan;0;0
6218;165867;777;60;22;3;19;.864;3600000;0
6218;36245;777;0;0;0;0;.00nan;0;0
6218;44203;794;75;39;4;35;.897;3573000;0
6218;46334;794;0;0;0;0;.00nan;0;0
6219;190702;3737;66;30;3;27;.900;3520000;0
6219;43730;2182;88;32;1;31;.969;3600000;0
6219;192030;3737;0;0;0;0;.00nan;0;0
6219;66924;2182;0;0;0;0;.00nan;0;0
6220;-1;778;0;0;0;0;.00nan;0;0
6220;43730;2182;92;32;1;31;.969;3900000;0
6220;54272;778;84;23;1;22;.957;3900000;0
6220;66924;2182;0;0;0;0;.00nan;0;0
6221;8487;783;1;25;8;17;.680;3600000;0
6221;190702;3737;0;0;0;0;.00nan;0;0
6221;192030;3737;58;40;5;35;.875;3600000;0
6221;146184;783;0;0;0;0;.00nan;0;0
6222;19346;796;69;26;2;24;.923;3600000;0
6222;44203;794;33;31;6;25;.806;3600000;0
6222;192036;796;0;0;0;0;.00nan;0;0
6222;46334;794;0;0;0;0;.00nan;0;0
6223;183377;904;0;0;0;0;.00nan;0;0
6223;-1;904;55;27;3;24;.889;3550000;0
6223;67362;784;0;0;0;0;.00nan;0;0
6223;86429;784;77;34;2;32;.941;3600000;0
6224;34520;798;33;40;7;33;.825;3165000;0
6224;-1;776;0;0;0;0;.00nan;0;0
6224;83199;776;83;25;1;24;.960;3600000;0
6224;95405;798;56;7;0;7;1.000;435000;0
6225;8107;780;43;29;5;24;.828;3900000;0
6225;165867;777;74;48;5;43;.896;3900000;0
6225;36245;777;0;0;0;0;.00nan;0;0
6225;-1;780;0;0;0;0;.00nan;0;0
6226;190702;3737;0;0;0;0;.00nan;0;0
6226;-1;778;0;0;0;0;.00nan;0;0
6226;192030;3737;67;34;3;31;.912;3546000;0
6226;54272;778;80;34;2;32;.941;3600000;0
6227;8107;780;91;17;0;17;1.000;3600000;0
6227;44203;794;81;36;4;32;.889;3600000;0
6227;-1;780;0;0;0;0;.00nan;0;0
6227;46334;794;0;0;0;0;.00nan;0;0
6228;183377;904;57;44;5;39;.886;3600000;0
6228;-1;776;0;0;0;0;.00nan;0;0
6228;-1;904;0;0;0;0;.00nan;0;0
6228;83199;776;63;23;2;21;.913;3600000;0
6229;34520;798;46;33;5;28;.848;3576000;0
6229;67362;784;70;34;3;31;.912;3600000;0
6229;86429;784;0;0;0;0;.00nan;0;0
6229;95405;798;0;0;0;0;.00nan;0;0
6230;165867;777;82;48;4;44;.917;3567000;0
6230;19346;796;74;26;2;24;.923;3600000;0
6230;36245;777;0;0;0;0;.00nan;0;0
6230;192036;796;0;0;0;0;.00nan;0;0
6231;8487;783;98;22;0;22;1.000;3600000;0
6231;43730;2182;0;0;0;0;.00nan;0;0
6231;66924;2182;66;35;3;32;.914;3600000;0
6231;146184;783;0;0;0;0;.00nan;0;0
6232;190702;3737;45;29;5;24;.828;3600000;0
6232;43730;2182;86;30;1;29;.967;3600000;0
6232;192030;3737;0;0;0;0;.00nan;0;0
6232;66924;2182;0;0;0;0;.00nan;0;0
6233;8107;780;61;40;5;35;.875;3600000;0
6233;19346;796;84;33;2;31;.939;3600000;0
6233;192036;796;0;0;0;0;.00nan;0;0
6233;-1;780;0;0;0;0;.00nan;0;0
6234;165867;777;28;20;5;15;.750;3568000;0
6234;36245;777;0;0;0;0;.00nan;0;0
6234;44203;794;0;0;0;0;.00nan;0;0
6234;46334;794;99;48;3;45;.938;3600000;0
6235;-1;776;0;0;0;0;.00nan;0;0
6235;67362;784;0;0;0;0;.00nan;0;0
6235;83199;776;82;26;1;25;.962;3600000;0
6235;86429;784;59;32;4;28;.875;3600000;0
6236;8487;783;39;35;6;29;.829;2699000;0
6236;-1;778;0;0;0;0;.00nan;0;0
6236;54272;778;100;34;1;33;.971;3600000;0
6236;146184;783;41;10;2;8;.800;901000;0
6237;183377;904;0;0;0;0;.00nan;0;0
6237;34520;798;70;24;2;22;.917;3600000;0
6237;-1;904;52;27;3;24;.889;3570000;0
6237;95405;798;0;0;0;0;.00nan;0;0
6238;165867;777;63;33;4;29;.879;3880000;0
6238;19346;796;79;36;3;33;.917;3880000;0
6238;36245;777;0;0;0;0;.00nan;0;0
6238;192036;796;0;0;0;0;.00nan;0;0
6239;8107;780;0;0;0;0;.00nan;0;0
6239;34520;798;95;31;1;30;.968;3600000;0
6239;-1;780;67;24;2;22;.917;3574000;0
6239;95405;798;0;0;0;0;.00nan;0;0
6240;190702;3737;0;0;0;0;.00nan;0;0
6240;192030;3737;76;27;1;26;.963;3600000;0
6240;67362;784;0;0;0;0;.00nan;0;0
6240;86429;784;71;37;3;34;.919;3549000;0
6241;183377;904;0;0;0;0;.00nan;0;0
6241;-1;776;0;0;0;0;.00nan;0;0
6241;-1;904;69;51;5;46;.902;3558000;0
6241;83199;776;33;21;4;17;.810;3600000;0
6242;8487;783;0;0;0;0;.00nan;0;0
6242;43730;2182;66;42;4;38;.905;3600000;0
6242;66924;2182;0;0;0;0;.00nan;0;0
6242;146184;783;83;19;0;19;1.000;3600000;0
6243;-1;778;0;0;0;0;.00nan;0;0
6243;44203;794;30;17;4;13;.765;3558000;0
6243;46334;794;0;0;0;0;.00nan;0;0
6243;54272;778;100;35;2;33;.943;3600000;0
6244;8107;780;85;30;1;29;.967;3600000;0
6244;-1;780;0;0;0;0;.00nan;0;0
6244;67362;784;65;21;2;19;.905;3546000;0
6244;86429;784;0;0;0;0;.00nan;0;0
6245;165867;777;59;21;2;19;.905;3600000;0
6245;36245;777;0;0;0;0;.00nan;0;0
6245;190702;3737;77;41;4;37;.902;3513000;0
6245;192030;3737;0;0;0;0;.00nan;0;0
6246;8487;783;50;26;4;22;.846;2276000;0
6246;183377;904;12;15;6;9;.600;1396000;0
6246;-1;904;61;17;1;16;.941;2204000;0
6246;146184;783;57;5;0;5;1.000;1324000;0
6247;-1;778;0;0;0;0;.00nan;0;0
6247;-1;776;0;0;0;0;.00nan;0;0
6247;54272;778;90;44;3;41;.932;3570000;0
6247;83199;776;63;23;2;21;.913;3600000;0
6248;34520;798;0;0;0;0;.00nan;0;0
6248;44203;794;89;35;2;33;.943;3600000;0
6248;46334;794;0;0;0;0;.00nan;0;0
6248;95405;798;55;23;3;20;.870;3573000;0
6249;19346;796;64;17;1;16;.941;3600000;0
6249;43730;2182;76;34;2;32;.941;3600000;0
6249;192036;796;0;0;0;0;.00nan;0;0
6249;66924;2182;0;0;0;0;.00nan;0;0
6250;190702;3737;100;28;0;28;1.000;3600000;0
6250;43730;2182;74;32;3;29;.906;3600000;0
6250;192030;3737;0;0;0;0;.00nan;0;0
6250;66924;2182;0;0;0;0;.00nan;0;0
6251;8107;780;71;36;4;32;.889;3600000;0
6251;165867;777;40;30;5;25;.833;3543000;0
6251;36245;777;0;0;0;0;.00nan;0;0
6251;-1;780;0;0;0;0;.00nan;0;0
6252;-1;776;0;0;0;0;.00nan;0;0
6252;44203;794;61;32;4;28;.875;3600000;0
6252;46334;794;0;0;0;0;.00nan;0;0
6252;83199;776;88;25;1;24;.960;3600000;0
6253;183377;904;0;0;0;0;.00nan;0;0
6253;19346;796;79;31;2;29;.935;3600000;0
6253;192036;796;0;0;0;0;.00nan;0;0
6253;-1;904;85;40;3;37;.925;3563000;0
6254;8487;783;100;39;0;39;1.000;3600000;0
6254;190711;778;0;0;0;0;.00nan;0;0
6254;54272;778;80;31;2;29;.935;3540000;0
6254;146184;783;0;0;0;0;.00nan;0;0
6255;34520;798;78;34;2;32;.941;3600000;0
6255;67362;784;97;45;3;42;.933;3600000;0
6255;86429;784;0;0;0;0;.00nan;0;0
6255;95405;798;0;0;0;0;.00nan;0;0
6256;44203;794;84;34;2;32;.941;3900000;0
6256;46334;794;0;0;0;0;.00nan;0;0
6256;67362;784;0;0;0;0;.00nan;0;0
6256;86429;784;61;19;2;17;.895;3900000;0
6257;8487;783;96;52;3;49;.942;3600000;0
6257;-1;776;0;0;0;0;.00nan;0;0
6257;83199;776;56;27;4;23;.852;3566000;0
6257;146184;783;0;0;0;0;.00nan;0;0
6258;183377;904;0;0;0;0;.00nan;0;0
6258;190702;3737;38;39;7;32;.821;3600000;0
6258;192030;3737;0;0;0;0;.00nan;0;0
6258;-1;904;51;25;3;22;.880;3600000;0
6259;19346;796;96;31;1;30;.968;3600000;0
6259;190711;778;0;0;0;0;.00nan;0;0
6259;192036;796;0;0;0;0;.00nan;0;0
6259;54272;778;43;29;5;24;.828;3600000;0
6260;165867;777;81;42;3;39;.929;3600000;0
6260;34520;798;75;44;4;40;.909;3561000;0
6260;36245;777;0;0;0;0;.00nan;0;0
6260;95405;798;0;0;0;0;.00nan;0;0
6261;8107;780;59;29;3;26;.897;3571000;0
6261;43730;2182;0;0;0;0;.00nan;0;0
6261;-1;780;0;0;0;0;.00nan;0;0
6261;66924;2182;69;23;1;22;.957;3600000;0
6262;190702;3737;0;0;0;0;.00nan;0;0
6262;190711;778;0;0;0;0;.00nan;0;0
6262;192030;3737;91;26;1;25;.962;3600000;0
6262;54272;778;48;23;3;20;.870;3551000;0
6263;19346;796;0;0;0;0;.00nan;0;0
6263;-1;776;0;0;0;0;.00nan;0;0
6263;192036;796;78;21;1;20;.952;3600000;0
6263;83199;776;28;30;6;24;.800;3600000;0
6264;8487;783;81;24;1;23;.958;3600000;0
6264;44203;794;41;29;5;24;.828;3600000;0
6264;46334;794;0;0;0;0;.00nan;0;0
6264;146184;783;0;0;0;0;.00nan;0;0
6265;8107;780;51;27;3;24;.889;3600000;0
6265;183377;904;92;35;1;34;.971;3600000;0
6265;-1;904;0;0;0;0;.00nan;0;0
6265;-1;780;0;0;0;0;.00nan;0;0
6266;165867;777;100;37;0;37;1.000;3600000;0
6266;36245;777;0;0;0;0;.00nan;0;0
6266;67362;784;52;28;4;24;.857;3600000;0
6266;86429;784;0;0;0;0;.00nan;0;0
6267;34520;798;99;33;1;32;.970;3600000;0
6267;43730;2182;60;25;3;22;.880;3542000;0
6267;66924;2182;0;0;0;0;.00nan;0;0
6267;95405;798;0;0;0;0;.00nan;0;0
6268;8107;780;0;0;0;0;.00nan;0;0
6268;-1;778;0;0;0;0;.00nan;0;0
6268;-1;780;64;31;3;28;.903;3600000;0
6268;54272;778;67;52;6;46;.885;3600000;0
6269;183377;904;0;0;0;0;.00nan;0;0
6269;34520;798;42;32;5;27;.844;3529000;0
6269;-1;904;57;29;3;26;.897;3600000;0
6269;95405;798;0;0;0;0;.00nan;0;0
6270;190702;3737;0;0;0;0;.00nan;0;0
6270;-1;776;34;18;4;14;.778;3726000;0
6270;192030;3737;71;34;3;31;.912;3726000;0
6270;83199;776;0;0;0;0;.00nan;0;0
6271;8487;783;45;30;4;26;.867;3551000;0
6271;19346;796;68;21;2;19;.905;3600000;0
6271;192036;796;0;0;0;0;.00nan;0;0
6271;146184;783;0;0;0;0;.00nan;0;0
6272;165867;777;98;24;0;24;1.000;3600000;0
6272;36245;777;0;0;0;0;.00nan;0;0
6272;44203;794;36;19;4;15;.789;2255000;0
6272;46334;794;66;15;0;15;1.000;1345000;0
6273;43730;2182;85;33;2;31;.939;3600000;0
6273;66924;2182;0;0;0;0;.00nan;0;0
6273;67362;784;0;0;0;0;.00nan;0;0
6273;86429;784;48;23;4;19;.826;3584000;0
6274;8107;780;61;29;3;26;.897;3600000;0
6274;-1;776;0;0;0;0;.00nan;0;0
6274;-1;780;0;0;0;0;.00nan;0;0
6274;83199;776;88;18;0;18;1.000;3600000;0
6275;19346;796;78;28;2;26;.929;3552000;0
6275;44203;794;95;32;1;31;.969;3600000;0
6275;192036;796;0;0;0;0;.00nan;0;0
6275;46334;794;0;0;0;0;.00nan;0;0
6276;8487;783;64;34;3;31;.912;3580000;0
6276;190702;3737;90;27;1;26;.963;3600000;0
6276;192030;3737;0;0;0;0;.00nan;0;0
6276;146184;783;0;0;0;0;.00nan;0;0
6277;183377;904;64;41;4;37;.902;3600000;0
6277;-1;904;0;0;0;0;.00nan;0;0
6277;67362;784;90;30;1;29;.967;3600000;0
6277;86429;784;0;0;0;0;.00nan;0;0
6278;165867;777;71;36;4;32;.889;3600000;0
6278;36245;777;0;0;0;0;.00nan;0;0
6278;43730;2182;80;45;5;40;.889;3545000;0
6278;66924;2182;0;0;0;0;.00nan;0;0
6279;34520;798;68;32;3;29;.906;3600000;0
6279;-1;778;0;0;0;0;.00nan;0;0
6279;54272;778;82;54;5;49;.907;3543000;0
6279;95405;798;0;0;0;0;.00nan;0;0
6280;-1;778;0;0;0;0;.00nan;0;0
6280;54272;778;89;37;2;35;.946;3600000;0
6280;67362;784;0;0;0;0;.00nan;0;0
6280;86429;784;38;25;5;20;.800;3600000;0
6281;19346;796;49;24;4;20;.833;3600000;0
6281;190702;3737;23;27;6;21;.778;2873000;0
6281;192030;3737;48;8;1;7;.875;727000;0
6281;192036;796;0;0;0;0;.00nan;0;0
6282;183377;904;67;43;4;39;.907;3568000;0
6282;165867;777;65;23;3;20;.870;3600000;0
6282;36245;777;0;0;0;0;.00nan;0;0
6282;-1;904;0;0;0;0;.00nan;0;0
6283;34520;798;38;37;6;31;.838;3600000;0
6283;-1;776;0;0;0;0;.00nan;0;0
6283;83199;776;69;21;1;20;.952;3600000;0
6283;95405;798;0;0;0;0;.00nan;0;0
6284;8107;780;70;38;4;34;.895;3600000;0
6284;8487;783;0;0;0;0;.00nan;0;0
6284;-1;780;0;0;0;0;.00nan;0;0
6284;146184;783;75;27;1;26;.963;3600000;0
6285;43730;2182;0;0;0;0;.00nan;0;0
6285;44203;794;90;32;1;31;.969;3600000;0
6285;46334;794;0;0;0;0;.00nan;0;0
6285;66924;2182;56;25;3;22;.880;3544000;0
6286;8107;780;97;42;2;40;.952;3900000;0
6286;19346;796;75;22;2;20;.909;3900000;0
6286;192036;796;0;0;0;0;.00nan;0;0
6286;-1;780;0;0;0;0;.00nan;0;0
6287;-1;776;0;0;0;0;.00nan;0;0
6287;67362;784;0;0;0;0;.00nan;0;0
6287;83199;776;46;29;4;25;.862;3900000;0
6287;86429;784;73;36;4;32;.889;3900000;0
6288;190702;3737;70;29;2;27;.931;3900000;0
6288;44203;794;85;36;2;34;.944;3900000;0
6288;192030;3737;0;0;0;0;.00nan;0;0
6288;46334;794;0;0;0;0;.00nan;0;0
6289;183377;904;0;0;0;0;.00nan;0;0
6289;43730;2182;50;25;4;21;.840;3579000;0
6289;-1;904;71;34;3;31;.912;3600000;0
6289;66924;2182;0;0;0;0;.00nan;0;0
6290;165867;777;51;19;3;16;.842;3614000;0
6290;36245;777;0;0;0;0;.00nan;0;0
6290;-1;778;0;0;0;0;.00nan;0;0
6290;54272;778;71;35;4;31;.886;3614000;0
6291;8487;783;91;41;2;39;.951;3600000;0
6291;34520;798;0;0;0;0;.00nan;0;0
6291;95405;798;46;35;5;30;.857;3600000;0
6291;146184;783;0;0;0;0;.00nan;0;0
6292;8107;780;61;25;2;23;.920;3600000;0
6292;190702;3737;0;0;0;0;.00nan;0;0
6292;192030;3737;71;38;3;35;.921;3538000;0
6292;-1;780;0;0;0;0;.00nan;0;0
6293;183377;904;59;35;4;31;.886;3582000;0
6293;44203;794;61;30;3;27;.900;3600000;0
6293;-1;904;0;0;0;0;.00nan;0;0
6293;46334;794;0;0;0;0;.00nan;0;0
6294;8487;783;94;34;1;33;.971;3600000;0
6294;67362;784;80;50;5;45;.900;3600000;0
6294;86429;784;0;0;0;0;.00nan;0;0
6294;146184;783;0;0;0;0;.00nan;0;0
6295;165867;777;0;0;0;0;.00nan;0;0
6295;36245;777;75;42;4;38;.905;3556000;0
6295;-1;776;0;0;0;0;.00nan;0;0
6295;83199;776;67;25;3;22;.880;3600000;0
6296;19346;796;72;19;1;18;.947;3614000;0
6296;34520;798;0;0;0;0;.00nan;0;0
6296;192036;796;0;0;0;0;.00nan;0;0
6296;95405;798;72;27;2;25;.926;3614000;0
6297;-1;778;0;0;0;0;.00nan;0;0
6297;43730;2182;23;12;4;8;.667;909000;0
6297;54272;778;59;32;4;28;.875;3600000;0
6297;66924;2182;57;31;4;27;.871;2691000;0
6298;19346;796;32;25;5;20;.800;3600000;0
6298;192036;796;0;0;0;0;.00nan;0;0
6298;67362;784;0;0;0;0;.00nan;0;0
6298;86429;784;39;37;7;30;.811;3550000;0
6299;-1;776;0;0;0;0;.00nan;0;0
6299;43730;2182;76;29;1;28;.966;3600000;0
6299;66924;2182;0;0;0;0;.00nan;0;0
6299;83199;776;91;18;0;18;1.000;3600000;0
6300;8107;780;75;14;0;14;1.000;3600000;0
6300;44203;794;89;35;2;33;.943;3600000;0
6300;-1;780;0;0;0;0;.00nan;0;0
6300;46334;794;0;0;0;0;.00nan;0;0
6301;183377;904;0;0;0;0;.00nan;0;0
6301;-1;778;0;0;0;0;.00nan;0;0
6301;-1;904;72;29;2;27;.931;3600000;0
6301;54272;778;75;36;3;33;.917;3600000;0
6302;8487;783;98;51;3;48;.941;3600000;0
6302;165867;777;45;25;4;21;.840;3544000;0
6302;36245;777;0;0;0;0;.00nan;0;0
6302;146184;783;0;0;0;0;.00nan;0;0
6303;34520;798;0;0;0;0;.00nan;0;0
6303;190702;3737;0;0;0;0;.00nan;0;0
6303;192030;3737;80;37;3;34;.919;3560000;0
6303;95405;798;94;34;2;32;.941;3600000;0
6304;-1;778;0;0;0;0;.00nan;0;0
6304;44203;794;97;36;1;35;.972;3600000;0
6304;46334;794;0;0;0;0;.00nan;0;0
6304;54272;778;60;38;5;33;.868;3600000;0
6305;183377;904;0;0;0;0;.00nan;0;0
6305;-1;776;0;0;0;0;.00nan;0;0
6305;-1;904;65;51;5;46;.902;3566000;0
6305;83199;776;53;28;4;24;.857;3600000;0
6306;190702;3737;72;45;4;41;.911;3592000;0
6306;192030;3737;0;0;0;0;.00nan;0;0
6306;67362;784;77;33;2;31;.939;3600000;0
6306;86429;784;0;0;0;0;.00nan;0;0
6307;165867;777;66;32;3;29;.906;3600000;0
6307;19346;796;48;30;5;25;.833;3571000;0
6307;36245;777;0;0;0;0;.00nan;0;0
6307;192036;796;0;0;0;0;.00nan;0;0
6308;8107;780;65;30;4;26;.867;3554000;0
6308;34520;798;72;35;3;32;.914;3600000;0
6308;-1;780;0;0;0;0;.00nan;0;0
6308;95405;798;0;0;0;0;.00nan;0;0
6309;8487;783;62;35;3;32;.914;3600000;0
6309;43730;2182;0;0;0;0;.00nan;0;0
6309;66924;2182;100;38;0;38;1.000;3600000;0
6309;146184;783;0;0;0;0;.00nan;0;0
6310;165867;777;76;26;2;24;.923;3600000;0
6310;36245;777;0;0;0;0;.00nan;0;0
6310;190702;3737;33;28;6;22;.786;2357000;0
6310;192030;3737;75;15;0;15;1.000;1243000;0
6311;19346;796;48;13;2;11;.846;3571000;0
6311;43730;2182;0;0;0;0;.00nan;0;0
6311;192036;796;0;0;0;0;.00nan;0;0
6311;66924;2182;100;30;0;30;1.000;3600000;0
6312;8107;780;0;0;0;0;.00nan;0;0
6312;-1;780;49;32;5;27;.844;3562000;0
6312;67362;784;0;0;0;0;.00nan;0;0
6312;86429;784;70;32;3;29;.906;3600000;0
6313;34520;798;50;22;3;19;.864;3600000;0
6313;44203;794;0;0;0;0;.00nan;0;0
6313;46334;794;98;35;1;34;.971;3600000;0
6313;95405;798;0;0;0;0;.00nan;0;0
6314;8487;783;43;26;5;21;.808;3600000;0
6314;183377;904;0;0;0;0;.00nan;0;0
6314;-1;904;79;22;1;21;.955;3600000;0
6314;146184;783;0;0;0;0;.00nan;0;0
6315;-1;778;0;0;0;0;.00nan;0;0
6315;-1;776;0;0;0;0;.00nan;0;0
6315;54272;778;73;45;5;40;.889;3600000;0
6315;83199;776;59;19;2;17;.895;3600000;0
6316;34520;798;81;29;2;27;.931;3600000;0
6316;67362;784;0;0;0;0;.00nan;0;0
6316;86429;784;54;33;4;29;.879;3542000;0
6316;95405;798;0;0;0;0;.00nan;0;0
6317;-1;776;0;0;0;0;.00nan;0;0
6317;44203;794;53;36;5;31;.861;3537000;0
6317;46334;794;0;0;0;0;.00nan;0;0
6317;83199;776;47;18;3;15;.833;3600000;0
6318;183377;904;60;38;4;34;.895;3546000;0
6318;19346;796;77;34;3;31;.912;3600000;0
6318;192036;796;0;0;0;0;.00nan;0;0
6318;-1;904;0;0;0;0;.00nan;0;0
6319;8487;783;80;24;1;23;.958;3600000;0
6319;-1;778;0;0;0;0;.00nan;0;0
6319;54272;778;69;28;2;26;.929;3579000;0
6319;146184;783;0;0;0;0;.00nan;0;0
6320;8107;780;71;30;2;28;.933;3600000;0
6320;165867;777;70;35;3;32;.914;3556000;0
6320;36245;777;0;0;0;0;.00nan;0;0
6320;-1;780;0;0;0;0;.00nan;0;0
6321;190702;3737;82;31;1;30;.968;3584000;0
6321;43730;2182;0;0;0;0;.00nan;0;0
6321;192030;3737;0;0;0;0;.00nan;0;0
6321;66924;2182;94;23;0;23;1.000;3600000;0
6322;19346;796;0;0;0;0;.00nan;0;0
6322;-1;778;0;0;0;0;.00nan;0;0
6322;192036;796;57;22;2;20;.909;3900000;0
6322;54272;778;98;53;2;51;.962;3900000;0
6323;44203;794;92;33;1;32;.970;3641000;0
6323;46334;794;0;0;0;0;.00nan;0;0
6323;67362;784;0;0;0;0;.00nan;0;0
6323;86429;784;96;21;0;21;1.000;3641000;0
6324;183377;904;0;0;0;0;.00nan;0;0
6324;190702;3737;0;0;0;0;.00nan;0;0
6324;192030;3737;49;33;4;29;.879;3600000;0
6324;-1;904;81;29;1;28;.966;3600000;0
6325;8487;783;0;0;0;0;.00nan;0;0
6325;-1;776;0;0;0;0;.00nan;0;0
6325;83199;776;65;27;3;24;.889;3667000;0
6325;146184;783;66;25;2;23;.920;3667000;0
6326;165867;777;71;31;3;28;.903;3900000;0
6326;34520;798;0;0;0;0;.00nan;0;0
6326;36245;777;0;0;0;0;.00nan;0;0
6326;95405;798;79;32;3;29;.906;3900000;0
6327;8107;780;61;22;2;20;.909;3582000;0
6327;43730;2182;0;0;0;0;.00nan;0;0
6327;-1;780;0;0;0;0;.00nan;0;0
6327;66924;2182;81;23;1;22;.957;3600000;0
6328;190702;3737;0;0;0;0;.00nan;0;0
6328;-1;778;80;29;1;28;.966;3600000;0
6328;192030;3737;74;36;2;34;.944;3544000;0
6328;54272;778;0;0;0;0;.00nan;0;0
6329;8487;776;0;0;0;0;.00nan;0;0
6329;19346;796;66;18;2;16;.889;3600000;0
6329;192036;796;0;0;0;0;.00nan;0;0
6329;83199;776;56;27;4;23;.852;3566000;0
6330;8107;780;64;26;3;23;.885;3549000;0
6330;183377;904;0;0;0;0;.00nan;0;0
6330;-1;904;93;32;1;31;.969;3600000;0
6330;-1;780;0;0;0;0;.00nan;0;0
6331;-1;783;52;39;5;34;.872;3600000;0
6331;44203;794;63;39;4;35;.897;3600000;0
6331;46334;794;0;0;0;0;.00nan;0;0
6331;146184;783;0;0;0;0;.00nan;0;0
6332;165867;777;0;0;0;0;.00nan;0;0
6332;66924;777;76;26;2;24;.923;3600000;0
6332;67362;784;0;0;0;0;.00nan;0;0
6332;86429;784;92;47;3;44;.936;3599000;0
6333;34520;798;65;20;2;18;.900;3717000;0
6333;43730;2182;70;29;3;26;.897;3717000;0
6333;64066;2182;0;0;0;0;.00nan;0;0
6333;95405;798;0;0;0;0;.00nan;0;0
6334;8107;780;0;0;0;0;.00nan;0;0
6334;-1;778;76;12;0;12;1.000;1326000;0
6334;-1;780;58;34;4;30;.882;3600000;0
6334;54272;778;39;29;5;24;.828;2242000;0
6335;43730;2182;38;39;6;33;.846;3029000;0
6335;64066;2182;54;4;0;4;1.000;871000;0
6335;67362;784;0;0;0;0;.00nan;0;0
6335;86429;784;38;27;6;21;.778;3900000;0
6336;165867;777;0;0;0;0;.00nan;0;0
6336;44203;794;45;37;6;31;.838;3600000;0
6336;46334;794;0;0;0;0;.00nan;0;0
6336;66924;777;67;26;3;23;.885;3600000;0
6337;8487;776;46;22;3;19;.864;3556000;0
6337;190702;3737;0;0;0;0;.00nan;0;0
6337;192030;3737;91;36;2;34;.944;3600000;0
6337;83199;776;0;0;0;0;.00nan;0;0
6338;183377;904;99;34;1;33;.971;3600000;0
6338;34520;798;72;32;3;29;.906;3515000;0
6338;-1;904;0;0;0;0;.00nan;0;0
6338;95405;798;0;0;0;0;.00nan;0;0
6339;19346;796;29;15;4;11;.733;3749000;0
6339;-1;783;0;0;0;0;.00nan;0;0
6339;192036;796;0;0;0;0;.00nan;0;0
6339;146184;783;79;52;5;47;.904;3749000;0
6340;183377;904;0;0;0;0;.00nan;0;0
6340;-1;904;78;32;2;30;.938;3600000;0
6340;67362;784;16;25;6;19;.760;3047000;0
6340;86429;784;51;8;1;7;.875;553000;0
6341;19346;796;63;27;3;24;.889;3546000;0
6341;44203;794;77;34;2;32;.941;3600000;0
6341;192036;796;0;0;0;0;.00nan;0;0
6341;46334;794;0;0;0;0;.00nan;0;0
6342;34520;798;0;0;0;0;.00nan;0;0
6342;-1;778;0;0;0;0;.00nan;0;0
6342;54272;778;75;41;4;37;.902;3900000;0
6342;95405;798;47;29;4;25;.862;3900000;0
6343;8107;780;76;49;5;44;.898;3600000;0
6343;8487;776;62;24;2;22;.917;3600000;0
6343;-1;780;0;0;0;0;.00nan;0;0
6343;83199;776;0;0;0;0;.00nan;0;0
6344;190702;3737;87;34;1;33;.971;3600000;0
6344;-1;783;0;0;0;0;.00nan;0;0
6344;192030;3737;0;0;0;0;.00nan;0;0
6344;146184;783;54;17;3;14;.824;3600000;0
6345;165867;777;0;0;0;0;.00nan;0;0
6345;43730;2182;94;49;4;45;.918;3600000;0
6345;64066;2182;0;0;0;0;.00nan;0;0
6345;66924;777;40;13;3;10;.769;3600000;0
6346;19346;796;46;25;4;21;.840;3600000;0
6346;190702;3737;12;18;6;12;.667;1681000;0
6346;192030;3737;75;22;1;21;.955;1919000;0
6346;192036;796;0;0;0;0;.00nan;0;0
6347;183377;904;43;27;4;23;.852;3581000;0
6347;165867;777;0;0;0;0;.00nan;0;0
6347;-1;904;0;0;0;0;.00nan;0;0
6347;66924;777;70;24;3;21;.875;3600000;0
6348;8107;780;78;34;2;32;.941;3600000;0
6348;-1;783;0;0;0;0;.00nan;0;0
6348;-1;780;0;0;0;0;.00nan;0;0
6348;146184;783;64;38;6;32;.842;3600000;0
6349;-1;778;0;0;0;0;.00nan;0;0
6349;54272;778;46;35;6;29;.829;3600000;0
6349;67362;784;74;24;1;23;.958;3600000;0
6349;86429;784;0;0;0;0;.00nan;0;0
6350;8487;776;67;33;3;30;.909;3600000;0
6350;34520;798;67;37;4;33;.892;3545000;0
6350;83199;776;0;0;0;0;.00nan;0;0
6350;95405;798;0;0;0;0;.00nan;0;0
6351;43730;2182;74;30;2;28;.933;3600000;0
6351;44203;794;53;35;5;30;.857;3600000;0
6351;46334;794;0;0;0;0;.00nan;0;0
6351;64066;2182;0;0;0;0;.00nan;0;0
6353;8487;783;64;32;3;29;.906;3535000;0
6353;67362;784;0;0;0;0;.00nan;0;0
6353;86429;784;90;33;1;32;.970;3600000;0
6353;146184;783;0;0;0;0;.00nan;0;0
6355;19346;796;73;34;3;31;.912;3600000;0
6355;34986;777;82;31;1;30;.968;2747000;0
6355;36245;777;31;16;4;12;.750;853000;0
6355;192036;796;0;0;0;0;.00nan;0;0
6357;8107;780;0;0;0;0;.00nan;0;0
6357;190702;3737;0;0;0;0;.00nan;0;0
6357;192030;3737;61;30;4;26;.867;3600000;0
6357;-1;780;75;21;1;20;.952;3600000;0
6359;-1;778;0;0;0;0;.00nan;0;0
6359;43730;2182;0;0;0;0;.00nan;0;0
6359;54272;778;95;29;1;28;.966;3600000;0
6359;66924;2182;73;37;3;34;.919;3600000;0
6361;165867;776;75;33;2;31;.939;3600000;0
6361;34520;798;72;43;4;39;.907;3600000;0
6361;-1;776;0;0;0;0;.00nan;0;0
6361;95405;798;0;0;0;0;.00nan;0;0
6363;183377;904;0;0;0;0;.00nan;0;0
6363;44203;794;91;24;0;24;1.000;3600000;0
6363;-1;904;31;38;7;31;.816;3600000;0
6363;46334;794;0;0;0;0;.00nan;0;0
6365;34520;798;65;37;4;33;.892;3900000;0
6365;43730;2182;0;0;0;0;.00nan;0;0
6365;66924;2182;59;34;4;30;.882;3900000;0
6365;95405;798;0;0;0;0;.00nan;0;0
6367;183377;904;91;63;4;59;.937;3600000;0
6367;19346;796;98;24;0;24;1.000;3600000;0
6367;192036;796;0;0;0;0;.00nan;0;0
6367;-1;904;0;0;0;0;.00nan;0;0
6369;8487;783;93;30;1;29;.967;3600000;0
6369;67362;784;0;0;0;0;.00nan;0;0
6369;86429;784;50;29;4;25;.862;3600000;0
6369;146184;783;0;0;0;0;.00nan;0;0
6371;8107;780;46;38;6;32;.842;3600000;0
6371;190702;3737;56;25;3;22;.880;3600000;0
6371;192030;3737;0;0;0;0;.00nan;0;0
6371;-1;780;0;0;0;0;.00nan;0;0
6373;165867;776;55;20;2;18;.900;3600000;0
6373;-1;776;0;0;0;0;.00nan;0;0
6373;44203;794;83;45;3;42;.933;3600000;0
6373;46334;794;0;0;0;0;.00nan;0;0
6375;34986;777;0;0;0;0;.00nan;0;0
6375;36245;777;73;37;4;33;.892;3570000;0
6375;-1;778;0;0;0;0;.00nan;0;0
6375;54272;778;84;40;3;37;.925;3600000;0
6377;34986;777;80;26;2;24;.923;3600000;0
6377;36245;777;0;0;0;0;.00nan;0;0
6377;44203;794;0;0;0;0;.00nan;0;0
6377;46334;794;74;38;4;34;.895;3583000;0
6379;19346;796;20;21;6;15;.714;3579000;0
6379;192036;796;0;0;0;0;.00nan;0;0
6379;67362;784;98;58;4;54;.931;3600000;0
6379;86429;784;0;0;0;0;.00nan;0;0
6381;8107;780;0;0;0;0;.00nan;0;0
6381;34520;798;0;0;0;0;.00nan;0;0
6381;-1;780;58;35;4;31;.886;3581000;0
6381;95405;798;70;30;3;27;.900;3600000;0
6383;183377;904;0;0;0;0;.00nan;0;0
6383;165867;776;0;0;0;0;.00nan;0;0
6383;-1;776;68;20;1;19;.950;3600000;0
6383;-1;904;75;44;4;40;.909;3600000;0
6385;8487;783;0;0;0;0;.00nan;0;0
6385;190702;3737;0;0;0;0;.00nan;0;0
6385;192030;3737;59;34;4;30;.882;3600000;0
6385;146184;783;75;22;1;21;.955;3600000;0
6387;-1;778;0;0;0;0;.00nan;0;0
6387;43730;2182;93;38;2;36;.947;3600000;0
6387;54272;778;73;33;3;30;.909;3561000;0
6387;66924;2182;0;0;0;0;.00nan;0;0
6389;8107;780;63;30;4;26;.867;3561000;0
6389;-1;778;0;0;0;0;.00nan;0;0
6389;-1;780;0;0;0;0;.00nan;0;0
6389;54272;778;54;23;3;20;.870;3600000;0
6391;8487;783;53;24;3;21;.875;3600000;0
6391;183377;904;43;45;8;37;.822;2888000;0
6391;-1;904;45;7;2;5;.714;712000;0
6391;146184;783;0;0;0;0;.00nan;0;0
6393;165867;776;95;32;1;31;.969;3600000;0
6393;19346;796;50;28;4;24;.857;3600000;0
6393;-1;776;0;0;0;0;.00nan;0;0
6393;192036;796;0;0;0;0;.00nan;0;0
6395;34986;777;0;0;0;0;.00nan;0;0
6395;36245;777;67;26;3;23;.885;3600000;0
6395;43730;2182;0;0;0;0;.00nan;0;0
6395;66924;2182;70;38;4;34;.895;3560000;0
6397;190702;3737;0;0;0;0;.00nan;0;0
6397;44203;794;95;40;1;39;.975;3900000;0
6397;192030;3737;91;19;1;18;.947;3900000;0
6397;46334;794;0;0;0;0;.00nan;0;0
6399;34520;798;62;22;2;20;.909;3567000;0
6399;67362;784;0;0;0;0;.00nan;0;0
6399;86429;784;100;28;0;28;1.000;3600000;0
6399;95405;798;0;0;0;0;.00nan;0;0
6401;190702;3737;51;34;5;29;.853;3600000;0
6401;192030;3737;0;0;0;0;.00nan;0;0
6401;67362;784;80;26;1;25;.962;3600000;0
6401;86429;784;0;0;0;0;.00nan;0;0
6403;183377;904;0;0;0;0;.00nan;0;0
6403;165867;776;49;12;2;10;.833;3600000;0
6403;-1;776;0;0;0;0;.00nan;0;0
6403;-1;904;75;44;4;40;.909;3600000;0
6405;19346;796;0;0;0;0;.00nan;0;0
6405;43730;2182;32;34;6;28;.824;2800000;0
6405;192036;796;54;26;3;23;.885;3600000;0
6405;66924;2182;52;8;1;7;.875;800000;0
6407;8107;780;0;0;0;0;.00nan;0;0
6407;8487;783;51;3;0;3;1.000;277000;0
6407;-1;780;94;37;1;36;.973;3600000;0
6407;146184;783;61;29;4;25;.862;3323000;0
6409;34520;798;0;0;0;0;.00nan;0;0
6409;-1;778;78;40;3;37;.925;3600000;0
6409;54272;778;0;0;0;0;.00nan;0;0
6409;95405;798;100;26;0;26;1.000;3600000;0
6411;34986;777;65;18;1;17;.944;3600000;0
6411;36245;777;0;0;0;0;.00nan;0;0
6411;44203;794;0;0;0;0;.00nan;0;0
6411;46334;794;82;37;3;34;.919;3600000;0
6413;34520;798;0;0;0;0;.00nan;0;0
6413;44203;794;89;28;1;27;.964;3562000;0
6413;46334;794;0;0;0;0;.00nan;0;0
6413;95405;798;91;19;0;19;1.000;3600000;0
6415;8487;783;70;35;3;32;.914;3857000;0
6415;190702;3737;0;0;0;0;.00nan;0;0
6415;192030;3737;65;35;4;31;.886;3857000;0
6415;146184;783;0;0;0;0;.00nan;0;0
6417;19346;796;56;29;3;26;.897;3600000;0
6417;34986;777;0;0;0;0;.00nan;0;0
6417;36245;777;74;39;4;35;.897;3567000;0
6417;192036;796;0;0;0;0;.00nan;0;0
6419;165867;776;52;25;3;22;.880;3568000;0
6419;-1;778;0;0;0;0;.00nan;0;0
6419;-1;776;0;0;0;0;.00nan;0;0
6419;54272;778;100;35;1;34;.971;3600000;0
6421;183377;904;61;50;5;45;.900;3600000;0
6421;43730;2182;0;0;0;0;.00nan;0;0
6421;-1;904;0;0;0;0;.00nan;0;0
6421;66924;2182;58;39;6;33;.846;3553000;0
6423;8107;780;0;0;0;0;.00nan;0;0
6423;-1;780;99;40;2;38;.950;3600000;0
6423;67362;784;0;0;0;0;.00nan;0;0
6423;86429;784;55;30;4;26;.867;3584000;0
6425;43730;2182;83;37;2;35;.946;3560000;0
6425;66924;2182;0;0;0;0;.00nan;0;0
6425;67362;784;76;22;1;21;.955;3600000;0
6425;86429;784;0;0;0;0;.00nan;0;0
6427;19346;796;0;0;0;0;.00nan;0;0
6427;34986;777;71;20;1;19;.950;3900000;0
6427;36245;777;0;0;0;0;.00nan;0;0
6427;192036;796;96;34;1;33;.971;3900000;0
6429;8487;783;0;0;0;0;.00nan;0;0
6429;34520;798;64;25;2;23;.920;3578000;0
6429;95405;798;0;0;0;0;.00nan;0;0
6429;146184;783;75;24;1;23;.958;3600000;0
6431;190702;3737;100;29;0;29;1.000;3600000;0
6431;44203;794;0;0;0;0;.00nan;0;0
6431;192030;3737;0;0;0;0;.00nan;0;0
6431;46334;794;50;20;3;17;.850;3600000;0
6433;8107;780;68;18;1;17;.944;3600000;0
6433;183377;904;0;0;0;0;.00nan;0;0
6433;-1;904;68;54;6;48;.889;3600000;0
6433;-1;780;0;0;0;0;.00nan;0;0
6435;165867;776;0;0;0;0;.00nan;0;0
6435;-1;778;0;0;0;0;.00nan;0;0
6435;-1;776;67;20;2;18;.900;3600000;0
6435;54272;778;45;31;5;26;.839;3600000;0
1032;8107;780;57;18;2;16;.889;3600000;0
1032;43730;2182;56;28;3;25;.893;3551000;0
1032;-1;780;0;0;0;0;.00nan;0;0
1032;64066;2182;0;0;0;0;.00nan;0;0
1033;-1;778;0;0;0;0;.00nan;0;0
1033;44203;794;100;25;0;25;1.000;3600000;0
1033;46334;794;0;0;0;0;.00nan;0;0
1033;54272;778;83;35;2;33;.943;3568000;0
1034;8107;780;55;23;3;20;.870;3600000;0
1034;43730;2182;70;42;4;38;.905;3553000;0
1034;-1;780;0;0;0;0;.00nan;0;0
1034;64066;2182;0;0;0;0;.00nan;0;0
1035;-1;778;0;0;0;0;.00nan;0;0
1035;44203;794;90;42;3;39;.929;4062000;0
1035;46334;794;0;0;0;0;.00nan;0;0
1035;54272;778;70;36;4;32;.889;4062000;0
1142;8487;776;78;15;0;15;1.000;3600000;0
1142;44203;794;78;41;5;36;.878;3600000;0
1142;46334;794;0;0;0;0;.00nan;0;0
1142;83199;776;0;0;0;0;.00nan;0;0
1143;19346;796;61;26;3;23;.885;4011000;0
1143;192036;796;0;0;0;0;.00nan;0;0
1143;67362;784;0;0;0;0;.00nan;0;0
1143;86429;784;76;31;2;29;.935;4011000;0
1144;34520;798;80;26;1;25;.962;3600000;0
1144;-1;783;0;0;0;0;.00nan;0;0
1144;95405;798;0;0;0;0;.00nan;0;0
1144;146184;783;63;24;3;21;.875;3518000;0
1145;8107;780;58;40;5;35;.875;3528000;0
1145;165867;777;0;0;0;0;.00nan;0;0
1145;-1;780;0;0;0;0;.00nan;0;0
1145;66924;777;70;29;3;26;.897;3600000;0
1146;8487;776;62;24;3;21;.875;4200000;0
1146;44203;794;96;50;3;47;.940;4200000;0
1146;46334;794;0;0;0;0;.00nan;0;0
1146;83199;776;0;0;0;0;.00nan;0;0
1147;19346;796;62;28;4;24;.857;3600000;0
1147;192036;796;0;0;0;0;.00nan;0;0
1147;67362;784;0;0;0;0;.00nan;0;0
1147;86429;784;83;30;1;29;.967;3600000;0
1148;34520;798;66;26;3;23;.885;3811000;0
1148;-1;783;0;0;0;0;.00nan;0;0
1148;95405;798;0;0;0;0;.00nan;0;0
1148;146184;783;88;46;4;42;.913;3811000;0
1149;8107;780;75;25;1;24;.960;3600000;0
1149;165867;777;73;26;2;24;.923;3600000;0
1149;-1;780;0;0;0;0;.00nan;0;0
1149;66924;777;0;0;0;0;.00nan;0;0
1150;8487;776;74;20;1;19;.950;3600000;0
1150;44203;794;27;28;6;22;.786;3281000;0
1150;46334;794;50;1;0;1;1.000;319000;0
1150;83199;776;0;0;0;0;.00nan;0;0
1151;19346;796;99;28;0;28;1.000;3600000;0
1151;192036;796;0;0;0;0;.00nan;0;0
1151;67362;784;0;0;0;0;.00nan;0;0
1151;86429;784;65;21;2;19;.905;3542000;0
1152;34520;798;96;40;2;38;.950;3659000;0
1152;-1;783;0;0;0;0;.00nan;0;0
1152;95405;798;0;0;0;0;.00nan;0;0
1152;146184;783;80;35;3;32;.914;3659000;0
1153;8107;780;77;32;2;30;.938;3600000;0
1153;165867;777;33;18;4;14;.778;3517000;0
1153;-1;780;0;0;0;0;.00nan;0;0
1153;66924;777;0;0;0;0;.00nan;0;0
1154;8487;776;69;18;2;16;.889;3600000;0
1154;44203;794;74;37;4;33;.892;3539000;0
1154;46334;794;0;0;0;0;.00nan;0;0
1154;83199;776;0;0;0;0;.00nan;0;0
1155;19346;796;79;26;1;25;.962;3600000;0
1155;192036;796;0;0;0;0;.00nan;0;0
1155;67362;784;0;0;0;0;.00nan;0;0
1155;86429;784;63;31;3;28;.903;3569000;0
1156;34520;798;74;33;3;30;.909;4089000;0
1156;-1;783;0;0;0;0;.00nan;0;0
1156;95405;798;0;0;0;0;.00nan;0;0
1156;146184;783;51;30;4;26;.867;4089000;0
1157;8107;780;82;26;1;25;.962;3600000;0
1157;165867;777;53;27;4;23;.852;3600000;0
1157;-1;780;0;0;0;0;.00nan;0;0
1157;66924;777;0;0;0;0;.00nan;0;0
1526;8487;776;97;22;0;22;1.000;3600000;0
1526;44203;794;77;32;2;30;.938;3533000;0
1526;46334;794;0;0;0;0;.00nan;0;0
1526;83199;776;0;0;0;0;.00nan;0;0
1527;19346;796;59;18;1;17;.944;3600000;0
1527;192036;796;0;0;0;0;.00nan;0;0
1527;67362;784;0;0;0;0;.00nan;0;0
1527;86429;784;71;31;2;29;.935;3545000;0
1528;8107;780;81;42;3;39;.929;4068000;0
1528;165867;777;63;35;4;31;.886;4076000;0
1528;-1;780;0;0;0;0;.00nan;0;0
1528;66924;777;0;0;0;0;.00nan;0;0
1575;19346;796;65;30;2;28;.933;3600000;0
1575;192036;796;0;0;0;0;.00nan;0;0
1575;67362;784;0;0;0;0;.00nan;0;0
1575;86429;784;64;37;4;33;.892;3548000;0
1610;8107;780;64;41;5;36;.878;3600000;0
1610;8487;776;75;22;1;21;.955;3600000;0
1610;-1;780;0;0;0;0;.00nan;0;0
1610;83199;776;0;0;0;0;.00nan;0;0
1611;19346;796;76;39;4;35;.897;3796000;0
1611;34520;798;85;40;3;37;.925;3796000;0
1611;192036;796;0;0;0;0;.00nan;0;0
1611;95405;798;0;0;0;0;.00nan;0;0
1612;8107;780;24;38;8;30;.789;2764000;0
1612;8487;776;69;20;1;19;.950;3600000;0
1612;-1;780;56;8;0;8;1.000;836000;0
1612;83199;776;0;0;0;0;.00nan;0;0
1613;19346;796;45;27;5;22;.815;3600000;0
1613;34520;798;34;37;7;30;.811;2623000;0
1613;192036;796;0;0;0;0;.00nan;0;0
1613;95405;798;55;6;0;6;1.000;974000;0
1614;8107;780;99;49;1;48;.980;3600000;0
1614;8487;776;64;26;3;23;.885;3557000;0
1614;-1;780;0;0;0;0;.00nan;0;0
1614;83199;776;0;0;0;0;.00nan;0;0
1615;19346;796;48;29;4;25;.862;3600000;0
1615;34520;798;0;0;0;0;.00nan;0;0
1615;192036;796;0;0;0;0;.00nan;0;0
1615;95405;798;69;18;1;17;.944;3600000;0
1616;8107;780;62;37;4;33;.892;3600000;0
1616;8487;776;100;27;0;27;1.000;3600000;0
1616;-1;780;0;0;0;0;.00nan;0;0
1616;83199;776;0;0;0;0;.00nan;0;0
1617;19346;796;98;27;0;27;1.000;3600000;0
1617;34520;798;0;0;0;0;.00nan;0;0
1617;192036;796;0;0;0;0;.00nan;0;0
1617;95405;798;74;38;3;35;.921;3600000;0
1893;8107;780;76;30;1;29;.967;3600000;0
1893;8487;776;46;19;3;16;.842;3536000;0
1893;-1;780;0;0;0;0;.00nan;0;0
1893;83199;776;0;0;0;0;.00nan;0;0
1894;19346;796;63;32;4;28;.875;3600000;0
1894;34520;798;0;0;0;0;.00nan;0;0
1894;192036;796;0;0;0;0;.00nan;0;0
1894;95405;798;45;34;5;29;.853;3569000;0
1917;8107;780;100;42;0;42;1.000;3600000;0
1917;8487;776;63;22;3;19;.864;3600000;0
1917;-1;780;0;0;0;0;.00nan;0;0
1917;83199;776;0;0;0;0;.00nan;0;0
1918;19346;796;80;22;1;21;.955;3600000;0
1918;34520;798;0;0;0;0;.00nan;0;0
1918;192036;796;0;0;0;0;.00nan;0;0
1918;95405;798;70;25;2;23;.920;3600000;0
1951;8107;780;70;27;3;24;.889;4200000;0
1951;8487;776;72;35;3;32;.914;4200000;0
1951;-1;780;0;0;0;0;.00nan;0;0
1951;83199;776;0;0;0;0;.00nan;0;0
1985;8107;780;71;45;4;41;.911;3592000;0
1985;19346;796;65;24;2;22;.917;3600000;0
1985;192036;796;0;0;0;0;.00nan;0;0
1985;-1;780;0;0;0;0;.00nan;0;0
1986;8107;780;70;36;3;33;.917;3600000;0
1986;19346;796;57;29;4;25;.862;3586000;0
1986;192036;796;0;0;0;0;.00nan;0;0
1986;-1;780;0;0;0;0;.00nan;0;0
1987;8107;780;47;33;5;28;.848;3600000;0
1987;19346;796;59;22;2;20;.909;3600000;0
1987;192036;796;0;0;0;0;.00nan;0;0
1987;-1;780;0;0;0;0;.00nan;0;0
1988;8107;780;100;45;1;44;.978;4200000;0
1988;19346;796;88;35;1;34;.971;4200000;0
1988;192036;796;0;0;0;0;.00nan;0;0
1988;-1;780;0;0;0;0;.00nan;0;0
2176;8107;780;48;24;4;20;.833;3600000;0
2176;19346;796;90;40;1;39;.975;3600000;0
2176;192036;796;0;0;0;0;.00nan;0;0
2176;-1;780;0;0;0;0;.00nan;0;0
2209;8107;780;39;38;6;32;.842;3155000;0
2209;19346;796;60;29;3;26;.897;3600000;0
2209;192036;796;0;0;0;0;.00nan;0;0
2209;-1;780;52;4;0;4;1.000;445000;0
6436;174017;552;0;0;0;0;.00nan;0;0
6436;24593;2626;98;54;3;51;.944;3600000;0
6436;81733;2626;0;0;0;0;.00nan;0;0
6436;85489;552;89;14;0;14;1.000;3600000;0
6437;10112;1423;36;21;4;17;.810;1159000;0
6437;174017;552;0;0;0;0;.00nan;0;0
6437;27517;1423;75;32;2;30;.938;2441000;0
6437;85489;552;59;13;1;12;.923;3600000;0
6438;9455;554;69;15;1;14;.933;3600000;0
6438;36115;555;89;32;2;30;.938;2678000;0
6438;37864;554;0;0;0;0;.00nan;0;0
6438;56316;555;37;20;4;16;.800;922000;0
6439;11851;560;92;50;5;45;.900;3600000;0
6439;65324;560;0;0;0;0;.00nan;0;0
6439;86686;558;71;22;2;20;.909;3600000;0
6439;161129;558;0;0;0;0;.00nan;0;0
6440;36115;555;0;0;0;0;.00nan;0;0
6440;43925;556;52;25;4;21;.840;3748000;0
6440;56316;555;81;46;3;43;.935;3748000;0
6440;80596;556;0;0;0;0;.00nan;0;0
6441;24593;2626;77;41;3;38;.927;3556000;0
6441;37424;553;0;0;0;0;.00nan;0;0
6441;70573;553;76;22;1;21;.955;3600000;0
6441;81733;2626;0;0;0;0;.00nan;0;0
6442;36115;555;0;0;0;0;.00nan;0;0
6442;43925;556;65;19;2;17;.895;3600000;0
6442;56316;555;92;48;3;45;.938;3583000;0
6442;80596;556;0;0;0;0;.00nan;0;0
6443;9455;554;52;10;1;9;.900;3600000;0
6443;10112;1423;95;59;4;55;.932;3600000;0
6443;27517;1423;0;0;0;0;.00nan;0;0
6443;37864;554;0;0;0;0;.00nan;0;0
6444;11851;560;97;70;5;65;.929;3600000;0
6444;174017;552;47;9;2;7;.778;3600000;0
6444;65324;560;0;0;0;0;.00nan;0;0
6444;85489;552;0;0;0;0;.00nan;0;0
6445;10112;1423;0;0;0;0;.00nan;0;0
6445;27517;1423;58;35;4;31;.886;3585000;0
6445;36115;555;0;0;0;0;.00nan;0;0
6445;56316;555;51;23;3;20;.870;3600000;0
6446;24593;2626;63;41;4;37;.902;3570000;0
6446;81733;2626;0;0;0;0;.00nan;0;0
6446;86686;558;47;12;2;10;.833;3600000;0
6446;161129;558;0;0;0;0;.00nan;0;0
6447;10112;1423;51;35;5;30;.857;3600000;0
6447;27517;1423;0;0;0;0;.00nan;0;0
6447;43264;561;8;16;6;10;.625;1809000;0
6447;46468;561;54;3;0;3;1.000;1735000;0
6448;3633;554;51;6;1;5;.833;3600000;0
6448;9455;554;0;0;0;0;.00nan;0;0
6448;11851;560;93;63;5;58;.921;3600000;0
6448;65324;560;0;0;0;0;.00nan;0;0
6449;11851;560;29;25;6;19;.760;3262000;0
6449;43264;561;57;40;5;35;.875;3600000;0
6449;46468;561;0;0;0;0;.00nan;0;0
6449;65324;560;48;5;1;4;.800;338000;0
6450;174017;552;0;0;0;0;.00nan;0;0
6450;24593;2626;76;48;4;44;.917;3600000;0
6450;81733;2626;0;0;0;0;.00nan;0;0
6450;85489;552;60;14;1;13;.929;3600000;0
6451;37424;553;0;0;0;0;.00nan;0;0
6451;43264;561;59;33;4;29;.879;3600000;0
6451;46468;561;0;0;0;0;.00nan;0;0
6451;70573;553;72;31;2;29;.935;3600000;0
6452;9455;554;0;0;0;0;.00nan;0;0
6452;37864;554;32;28;6;22;.786;3600000;0
6452;43925;556;28;28;6;22;.786;2733000;0
6452;80596;556;54;10;1;9;.900;833000;0
6453;3633;554;71;32;2;30;.938;3575000;0
6453;9455;554;0;0;0;0;.00nan;0;0
6453;86686;558;0;0;0;0;.00nan;0;0
6453;161129;558;86;35;1;34;.971;3600000;0
6454;174017;552;62;22;2;20;.909;3546000;0
6454;43925;556;100;34;1;33;.971;3600000;0
6454;80596;556;0;0;0;0;.00nan;0;0
6454;85489;552;0;0;0;0;.00nan;0;0
6455;11851;560;28;36;7;29;.806;3600000;0
6455;43925;556;54;16;2;14;.875;3600000;0
6455;65324;560;0;0;0;0;.00nan;0;0
6455;80596;556;0;0;0;0;.00nan;0;0
6456;174017;552;0;0;0;0;.00nan;0;0
6456;85489;552;69;26;2;24;.923;3550000;0
6456;86686;558;0;0;0;0;.00nan;0;0
6456;161129;558;86;31;1;30;.968;3600000;0
6457;11851;560;55;31;4;27;.871;3535000;0
6457;36115;555;0;0;0;0;.00nan;0;0
6457;56316;555;74;28;2;26;.929;3600000;0
6457;65324;560;0;0;0;0;.00nan;0;0
6458;24593;2626;72;31;3;28;.903;3600000;0
6458;43264;561;69;34;4;30;.882;3551000;0
6458;46468;561;0;0;0;0;.00nan;0;0
6458;81733;2626;0;0;0;0;.00nan;0;0
6459;10112;1423;96;49;3;46;.939;3582000;0
6459;27517;1423;0;0;0;0;.00nan;0;0
6459;37424;553;0;0;0;0;.00nan;0;0
6459;70573;553;60;16;2;14;.875;3600000;0
6460;3633;554;58;26;3;23;.885;3551000;0
6460;9455;554;0;0;0;0;.00nan;0;0
6460;43925;556;100;47;1;46;.979;3600000;0
6460;80596;556;0;0;0;0;.00nan;0;0
6461;11851;560;0;0;0;0;.00nan;0;0
6461;36115;555;90;39;2;37;.949;3600000;0
6461;56316;555;0;0;0;0;.00nan;0;0
6461;65324;560;89;42;3;39;.929;3549000;0
6462;174017;552;0;0;0;0;.00nan;0;0
6462;37424;553;0;0;0;0;.00nan;0;0
6462;70573;553;59;35;4;31;.886;3600000;0
6462;85489;552;45;20;3;17;.850;3600000;0
6463;3633;554;0;0;0;0;.00nan;0;0
6463;9455;554;71;20;2;18;.900;3600000;0
6463;37424;553;0;0;0;0;.00nan;0;0
6463;70573;553;76;39;3;36;.923;3600000;0
6464;36115;555;0;0;0;0;.00nan;0;0
6464;37424;553;0;0;0;0;.00nan;0;0
6464;56316;555;77;28;2;26;.929;3600000;0
6464;70573;553;63;30;3;27;.900;3564000;0
6465;43264;561;0;0;0;0;.00nan;0;0
6465;43925;556;0;0;0;0;.00nan;0;0
6465;46468;561;90;39;2;37;.949;3600000;0
6465;80596;556;44;17;3;14;.824;3544000;0
6466;10112;1423;89;48;4;44;.917;3600000;0
6466;27517;1423;0;0;0;0;.00nan;0;0
6466;86686;558;62;13;1;12;.923;3600000;0
6466;161129;558;0;0;0;0;.00nan;0;0
6467;43264;561;27;34;6;28;.824;3579000;0
6467;43925;556;41;27;5;22;.815;3600000;0
6467;46468;561;0;0;0;0;.00nan;0;0
6467;80596;556;0;0;0;0;.00nan;0;0
6468;174017;552;0;0;0;0;.00nan;0;0
6468;37424;553;0;0;0;0;.00nan;0;0
6468;70573;553;69;29;3;26;.897;3600000;0
6468;85489;552;81;19;1;18;.947;3600000;0
6469;10112;1423;0;0;0;0;.00nan;0;0
6469;27517;1423;63;40;4;36;.900;3585000;0
6469;86686;558;0;0;0;0;.00nan;0;0
6469;161129;558;82;35;2;33;.943;3600000;0
6470;3633;554;65;21;2;19;.905;3600000;0
6470;9455;554;0;0;0;0;.00nan;0;0
6470;86686;558;21;11;4;7;.636;633000;0
6470;161129;558;70;45;5;40;.889;2967000;0
6471;11851;560;44;42;6;36;.857;3347000;0
6471;43925;556;43;21;4;17;.810;3600000;0
6471;65324;560;44;4;1;3;.750;253000;0
6471;80596;556;0;0;0;0;.00nan;0;0
6472;24593;2626;100;26;0;26;1.000;3600000;0
6472;36115;555;0;0;0;0;.00nan;0;0
6472;56316;555;68;24;2;22;.917;3530000;0
6472;81733;2626;0;0;0;0;.00nan;0;0
6473;10112;1423;59;35;4;31;.886;3600000;0
6473;27517;1423;0;0;0;0;.00nan;0;0
6473;43264;561;0;0;0;0;.00nan;0;0
6473;46468;561;93;36;1;35;.972;3600000;0
6474;43925;556;73;35;3;32;.914;3600000;0
6474;45584;2626;0;0;0;0;.00nan;0;0
6474;80596;556;0;0;0;0;.00nan;0;0
6474;81733;2626;72;26;2;24;.923;3600000;0
6475;37424;553;69;29;3;26;.897;3748000;0
6475;70573;553;0;0;0;0;.00nan;0;0
6475;86686;558;85;32;2;30;.938;3748000;0
6475;161129;558;0;0;0;0;.00nan;0;0
6476;3633;554;50;14;2;12;.857;3600000;0
6476;9455;554;0;0;0;0;.00nan;0;0
6476;11851;560;47;47;7;40;.851;2218000;0
6476;65324;560;32;37;6;31;.838;1382000;0
6477;11851;560;73;60;6;54;.900;3143000;0
6477;174017;552;41;8;2;6;.750;3600000;0
6477;65324;560;59;7;0;7;1.000;457000;0
6477;85489;552;0;0;0;0;.00nan;0;0
6478;24593;2626;100;42;1;41;.976;3600000;0
6478;43925;556;62;23;2;21;.913;3565000;0
6478;80596;556;0;0;0;0;.00nan;0;0
6478;81733;2626;0;0;0;0;.00nan;0;0
6479;3633;554;65;21;3;18;.857;3571000;0
6479;9455;554;0;0;0;0;.00nan;0;0
6479;86686;558;0;0;0;0;.00nan;0;0
6479;161129;558;80;37;2;35;.946;3600000;0
6480;10112;1423;100;36;2;34;.944;3600000;0
6480;27517;1423;0;0;0;0;.00nan;0;0
6480;37424;553;0;0;0;0;.00nan;0;0
6480;70573;553;59;24;3;21;.875;3545000;0
6481;36115;555;0;0;0;0;.00nan;0;0
6481;43264;561;53;29;4;25;.862;3746000;0
6481;46468;561;0;0;0;0;.00nan;0;0
6481;56316;555;76;30;3;27;.900;3746000;0
6482;11851;560;87;38;2;36;.947;3600000;0
6482;36115;555;0;0;0;0;.00nan;0;0
6482;56316;555;60;24;3;21;.875;3595000;0
6482;65324;560;0;0;0;0;.00nan;0;0
6483;11851;560;89;38;3;35;.921;3600000;0
6483;43264;561;0;0;0;0;.00nan;0;0
6483;46468;561;86;30;2;28;.933;3600000;0
6483;65324;560;0;0;0;0;.00nan;0;0
6484;3633;554;64;20;2;18;.900;3600000;0
6484;9455;554;0;0;0;0;.00nan;0;0
6484;43925;556;98;47;3;44;.936;3584000;0
6484;80596;556;0;0;0;0;.00nan;0;0
6485;37424;553;44;4;1;3;.750;594000;0
6485;70573;553;33;27;5;22;.815;3006000;0
6485;86686;558;53;27;4;23;.852;3600000;0
6485;161129;558;0;0;0;0;.00nan;0;0
6486;3633;554;0;0;0;0;.00nan;0;0
6486;9455;554;87;21;1;20;.952;3600000;0
6486;37424;553;69;50;5;45;.900;3600000;0
6486;70573;553;0;0;0;0;.00nan;0;0
6487;10112;1423;0;0;0;0;.00nan;0;0
6487;27517;1423;85;33;1;32;.970;3600000;0
6487;43264;561;67;25;2;23;.920;3550000;0
6487;46468;561;0;0;0;0;.00nan;0;0
6488;174017;552;0;0;0;0;.00nan;0;0
6488;24593;2626;72;51;6;45;.882;3600000;0
6488;81733;2626;0;0;0;0;.00nan;0;0
6488;85489;552;56;17;1;16;.941;3600000;0
6489;10112;1423;93;45;2;43;.956;3600000;0
6489;27517;1423;0;0;0;0;.00nan;0;0
6489;86686;558;0;0;0;0;.00nan;0;0
6489;161129;558;59;13;1;12;.923;3600000;0
6490;24593;2626;100;45;1;44;.978;3777000;0
6490;37424;553;0;0;0;0;.00nan;0;0
6490;70573;553;59;23;2;21;.913;3777000;0
6490;81733;2626;0;0;0;0;.00nan;0;0
6491;10112;1423;53;25;4;21;.840;2045000;0
6491;27517;1423;47;20;3;17;.850;1555000;0
6491;43925;556;71;20;1;19;.950;3600000;0
6491;80596;556;0;0;0;0;.00nan;0;0
6492;174017;552;63;15;1;14;.933;3600000;0
6492;43264;561;0;0;0;0;.00nan;0;0
6492;46468;561;76;64;6;58;.906;3600000;0
6492;85489;552;0;0;0;0;.00nan;0;0
6493;24593;2626;78;54;6;48;.889;3600000;0
6493;37424;553;0;0;0;0;.00nan;0;0
6493;70573;553;53;15;2;13;.867;3600000;0
6493;81733;2626;0;0;0;0;.00nan;0;0
6494;10112;1423;52;39;5;34;.872;3600000;0
6494;27517;1423;0;0;0;0;.00nan;0;0
6494;43925;556;92;22;0;22;1.000;3600000;0
6494;80596;556;0;0;0;0;.00nan;0;0
6495;36115;555;0;0;0;0;.00nan;0;0
6495;43264;561;0;0;0;0;.00nan;0;0
6495;46468;561;61;26;3;23;.885;3600000;0
6495;56316;555;86;51;4;47;.922;3551000;0
6496;174017;552;0;0;0;0;.00nan;0;0
6496;85489;552;51;30;4;26;.867;3600000;0
6496;86686;558;87;31;1;30;.968;3600000;0
6496;161129;558;0;0;0;0;.00nan;0;0
6497;10112;1423;65;43;4;39;.907;3600000;0
6497;24593;2626;82;27;1;26;.963;3600000;0
6497;27517;1423;0;0;0;0;.00nan;0;0
6497;81733;2626;0;0;0;0;.00nan;0;0
6498;36115;555;58;12;1;11;.917;488000;0
6498;43925;556;97;20;0;20;1.000;3600000;0
6498;56316;555;35;39;7;32;.821;3112000;0
6498;80596;556;0;0;0;0;.00nan;0;0
6499;43264;561;41;4;1;3;.750;937000;0
6499;46468;561;24;27;6;21;.778;2663000;0
6499;86686;558;0;0;0;0;.00nan;0;0
6499;161129;558;76;28;2;26;.929;3600000;0
6500;24593;2626;98;49;3;46;.939;3584000;0
6500;43925;556;91;29;1;28;.966;3600000;0
6500;80596;556;0;0;0;0;.00nan;0;0
6500;81733;2626;0;0;0;0;.00nan;0;0
6501;36115;555;50;41;6;35;.854;2491000;0
6501;37424;553;0;0;0;0;.00nan;0;0
6501;56316;555;30;20;4;16;.800;1109000;0
6501;70573;553;63;12;1;11;.917;3600000;0
6502;11851;560;87;45;4;41;.911;3600000;0
6502;37424;553;67;29;3;26;.897;3600000;0
6502;65324;560;0;0;0;0;.00nan;0;0
6502;70573;553;0;0;0;0;.00nan;0;0
6503;36115;555;0;0;0;0;.00nan;0;0
6503;56316;555;79;51;5;46;.902;3600000;0
6503;86686;558;82;12;0;12;1.000;3600000;0
6503;161129;558;0;0;0;0;.00nan;0;0
6504;10112;1423;31;23;5;18;.783;2336000;0
6504;174017;552;0;0;0;0;.00nan;0;0
6504;27517;1423;69;20;1;19;.950;1264000;0
6504;85489;552;81;13;0;13;1.000;3600000;0
6505;3633;554;66;16;1;15;.938;3600000;0
6505;9455;554;0;0;0;0;.00nan;0;0
6505;43264;561;0;0;0;0;.00nan;0;0
6505;46468;561;97;55;2;53;.964;3575000;0
6506;43264;561;0;0;0;0;.00nan;0;0
6506;46468;561;64;28;2;26;.929;3600000;0
6506;86686;558;65;29;3;26;.897;3556000;0
6506;161129;558;0;0;0;0;.00nan;0;0
6507;3633;554;45;15;3;12;.800;3600000;0
6507;9455;554;0;0;0;0;.00nan;0;0
6507;11851;560;32;23;5;18;.783;1177000;0
6507;65324;560;57;39;5;34;.872;2423000;0
6508;174017;552;0;0;0;0;.00nan;0;0
6508;43925;556;50;36;5;31;.861;3600000;0
6508;80596;556;0;0;0;0;.00nan;0;0
6508;85489;552;71;16;1;15;.938;3600000;0
6509;24593;2626;29;8;3;5;.625;307000;0
6509;37424;553;0;0;0;0;.00nan;0;0
6509;70573;553;85;18;0;18;1.000;3600000;0
6509;81733;2626;66;40;4;36;.900;3293000;0
6510;36115;555;0;0;0;0;.00nan;0;0
6510;56316;555;82;50;3;47;.940;3600000;0
6510;86686;558;0;0;0;0;.00nan;0;0
6510;161129;558;97;25;0;25;1.000;3600000;0
6511;174017;552;62;14;1;13;.929;3600000;0
6511;43264;561;0;0;0;0;.00nan;0;0
6511;46468;561;97;59;2;57;.966;3566000;0
6511;85489;552;0;0;0;0;.00nan;0;0
6512;11851;560;52;28;4;24;.857;3600000;0
6512;24593;2626;81;30;2;28;.933;3600000;0
6512;65324;560;0;0;0;0;.00nan;0;0
6512;81733;2626;0;0;0;0;.00nan;0;0
6513;10112;1423;0;0;0;0;.00nan;0;0
6513;27517;1423;76;43;3;40;.930;3600000;0
6513;37424;553;0;0;0;0;.00nan;0;0
6513;70573;553;89;19;0;19;1.000;3600000;0
6514;3633;554;81;23;2;21;.913;3600000;0
6514;9455;554;0;0;0;0;.00nan;0;0
6514;43925;556;0;0;0;0;.00nan;0;0
6514;80596;556;60;37;4;33;.892;3600000;0
6515;3633;554;62;15;1;14;.933;3600000;0
6515;9455;554;0;0;0;0;.00nan;0;0
6515;43264;561;92;43;3;40;.930;3539000;0
6515;46468;561;0;0;0;0;.00nan;0;0
6516;24593;2626;90;35;1;34;.971;3600000;0
6516;43264;561;71;21;2;19;.905;2428000;0
6516;46468;561;23;11;4;7;.636;1172000;0
6516;81733;2626;0;0;0;0;.00nan;0;0
6517;11851;560;58;46;6;40;.870;2769000;0
6517;43925;556;61;17;2;15;.882;3600000;0
6517;65324;560;39;11;2;9;.818;831000;0
6517;80596;556;0;0;0;0;.00nan;0;0
6518;36115;555;0;0;0;0;.00nan;0;0
6518;37424;553;0;0;0;0;.00nan;0;0
6518;56316;555;71;41;4;37;.902;3600000;0
6518;70573;553;57;17;2;15;.882;3600000;0
6519;10112;1423;33;31;6;25;.806;1798000;0
6519;174017;552;0;0;0;0;.00nan;0;0
6519;27517;1423;36;25;5;20;.800;1802000;0
6519;85489;552;77;23;1;22;.957;3600000;0
6520;3633;554;54;11;1;10;.909;3600000;0
6520;9455;554;0;0;0;0;.00nan;0;0
6520;24593;2626;90;62;4;58;.935;3600000;0
6520;81733;2626;0;0;0;0;.00nan;0;0
6521;174017;552;79;43;4;39;.907;3555000;0
6521;37424;553;63;26;3;23;.885;3600000;0
6521;70573;553;0;0;0;0;.00nan;0;0
6521;85489;552;0;0;0;0;.00nan;0;0
6522;11851;560;57;53;7;46;.868;3600000;0
6522;65324;560;0;0;0;0;.00nan;0;0
6522;86686;558;0;0;0;0;.00nan;0;0
6522;161129;558;99;26;0;26;1.000;3600000;0
6523;36115;555;52;9;1;8;.889;675000;0
6523;43264;561;0;0;0;0;.00nan;0;0
6523;46468;561;65;23;2;21;.913;3600000;0
6523;56316;555;53;41;6;35;.854;2925000;0
6524;36115;555;0;0;0;0;.00nan;0;0
6524;43264;561;71;20;1;19;.950;3600000;0
6524;46468;561;0;0;0;0;.00nan;0;0
6524;56316;555;88;36;2;34;.944;3544000;0
6525;11851;560;73;36;3;33;.917;3600000;0
6525;43925;556;72;23;1;22;.957;3600000;0
6525;65324;560;0;0;0;0;.00nan;0;0
6525;80596;556;0;0;0;0;.00nan;0;0
6526;24593;2626;78;47;4;43;.915;3557000;0
6526;81733;2626;0;0;0;0;.00nan;0;0
6526;86686;558;67;26;2;24;.923;3600000;0
6526;161129;558;0;0;0;0;.00nan;0;0
6527;3633;554;57;11;1;10;.909;3600000;0
6527;9455;554;0;0;0;0;.00nan;0;0
6527;10112;1423;63;58;8;50;.862;3600000;0
6527;27517;1423;0;0;0;0;.00nan;0;0
6528;174017;552;0;0;0;0;.00nan;0;0
6528;37424;553;0;0;0;0;.00nan;0;0
6528;70573;553;86;28;1;27;.964;3600000;0
6528;85489;552;60;22;3;19;.864;3544000;0
6529;24593;2626;87;60;4;56;.933;3600000;0
6529;81733;2626;0;0;0;0;.00nan;0;0
6529;86686;558;0;0;0;0;.00nan;0;0
6529;161129;558;100;31;0;31;1.000;3600000;0
6530;174017;552;48;27;4;23;.852;3600000;0
6530;43925;556;45;4;1;3;.750;291000;0
6530;80596;556;53;37;5;32;.865;3304000;0
6530;85489;552;0;0;0;0;.00nan;0;0
6531;11851;560;57;37;4;33;.892;3547000;0
6531;37424;553;0;0;0;0;.00nan;0;0
6531;65324;560;0;0;0;0;.00nan;0;0
6531;70573;553;68;32;3;29;.906;3600000;0
6532;3633;554;52;13;2;11;.846;3600000;0
6532;9455;554;0;0;0;0;.00nan;0;0
6532;10112;1423;0;0;0;0;.00nan;0;0
6532;27517;1423;66;45;5;40;.889;3600000;0
6533;37424;553;0;0;0;0;.00nan;0;0
6533;43264;561;26;11;4;7;.636;698000;0
6533;46468;561;74;37;3;34;.919;2902000;0
6533;70573;553;84;19;0;19;1.000;3600000;0
6534;11851;560;85;35;2;33;.943;3600000;0
6534;65324;560;0;0;0;0;.00nan;0;0
6534;86686;558;45;27;4;23;.852;3576000;0
6534;161129;558;0;0;0;0;.00nan;0;0
6535;10112;1423;26;28;6;22;.786;3600000;0
6535;24593;2626;95;38;1;37;.974;3600000;0
6535;27517;1423;0;0;0;0;.00nan;0;0
6535;81733;2626;0;0;0;0;.00nan;0;0
6536;3633;554;80;9;0;9;1.000;3600000;0
6536;9455;554;0;0;0;0;.00nan;0;0
6536;36115;555;66;12;0;12;1.000;364000;0
6536;56316;555;53;46;6;40;.870;3236000;0
6537;37424;553;0;0;0;0;.00nan;0;0
6537;43264;561;65;49;6;43;.878;3569000;0
6537;46468;561;0;0;0;0;.00nan;0;0
6537;70573;553;36;18;4;14;.778;3600000;0
6538;43925;556;68;26;2;24;.923;3596000;0
6538;80596;556;0;0;0;0;.00nan;0;0
6538;86686;558;87;32;1;31;.969;3600000;0
6538;161129;558;0;0;0;0;.00nan;0;0
6539;10112;1423;0;0;0;0;.00nan;0;0
6539;24593;2626;79;37;3;34;.919;3900000;0
6539;27517;1423;88;37;3;34;.919;3900000;0
6539;81733;2626;0;0;0;0;.00nan;0;0
6540;3633;554;48;12;2;10;.833;3600000;0
6540;9455;554;0;0;0;0;.00nan;0;0
6540;36115;555;82;49;4;45;.918;3549000;0
6540;56316;555;0;0;0;0;.00nan;0;0
6541;11851;560;87;71;7;64;.901;3600000;0
6541;174017;552;0;0;0;0;.00nan;0;0
6541;65324;560;0;0;0;0;.00nan;0;0
6541;85489;552;45;10;2;8;.800;3600000;0
6542;11851;560;79;31;2;29;.935;3541000;0
6542;24593;2626;100;32;0;32;1.000;3600000;0
6542;65324;560;0;0;0;0;.00nan;0;0
6542;81733;2626;0;0;0;0;.00nan;0;0
6543;37424;553;0;0;0;0;.00nan;0;0
6543;43925;556;95;28;1;27;.964;3600000;0
6543;70573;553;71;27;2;25;.926;3577000;0
6543;80596;556;0;0;0;0;.00nan;0;0
6544;43264;561;98;50;3;47;.940;3581000;0
6544;46468;561;0;0;0;0;.00nan;0;0
6544;86686;558;0;0;0;0;.00nan;0;0
6544;161129;558;63;21;2;19;.905;3600000;0
6545;10112;1423;0;0;0;0;.00nan;0;0
6545;27517;1423;43;28;5;23;.821;3600000;0
6545;36115;555;0;0;0;0;.00nan;0;0
6545;56316;555;85;35;2;33;.943;3600000;0
6546;3633;554;81;32;2;30;.938;3600000;0
6546;9455;554;0;0;0;0;.00nan;0;0
6546;174017;552;0;0;0;0;.00nan;0;0
6546;85489;552;47;35;5;30;.857;3600000;0
6547;11851;560;90;18;0;18;1.000;3723000;0
6547;24593;2626;87;29;1;28;.966;3723000;0
6547;65324;560;0;0;0;0;.00nan;0;0
6547;81733;2626;0;0;0;0;.00nan;0;0
6548;37424;553;58;20;2;18;.900;2117000;0
6548;43925;556;0;0;0;0;.00nan;0;0
6548;70573;553;14;19;6;13;.684;1483000;0
6548;80596;556;74;37;4;33;.892;3600000;0
6549;10112;1423;58;17;2;15;.882;3600000;0
6549;27517;1423;0;0;0;0;.00nan;0;0
6549;36115;555;0;0;0;0;.00nan;0;0
6549;56316;555;33;31;6;25;.806;3600000;0
6550;3633;554;0;0;0;0;.00nan;0;0
6550;9455;554;41;25;5;20;.800;3600000;0
6550;174017;552;76;54;6;48;.889;3600000;0
6550;85489;552;0;0;0;0;.00nan;0;0
6551;43264;561;70;47;4;43;.915;3600000;0
6551;46468;561;0;0;0;0;.00nan;0;0
6551;86686;558;53;14;3;11;.786;3600000;0
6551;161129;558;0;0;0;0;.00nan;0;0
6552;43264;561;54;45;6;39;.867;3060000;0
6552;43925;556;53;16;3;13;.813;3600000;0
6552;46468;561;61;8;0;8;1.000;540000;0
6552;80596;556;0;0;0;0;.00nan;0;0
6553;3633;554;60;13;1;12;.923;3600000;0
6553;9455;554;0;0;0;0;.00nan;0;0
6553;24593;2626;48;47;7;40;.851;3600000;0
6553;81733;2626;0;0;0;0;.00nan;0;0
6554;37424;553;0;0;0;0;.00nan;0;0
6554;70573;553;51;45;6;39;.867;3600000;0
6554;86686;558;0;0;0;0;.00nan;0;0
6554;161129;558;72;35;3;32;.914;3600000;0
6555;10112;1423;0;0;0;0;.00nan;0;0
6555;11851;560;50;24;4;20;.833;3519000;0
6555;27517;1423;74;28;2;26;.929;3600000;0
6555;65324;560;0;0;0;0;.00nan;0;0
6556;174017;552;0;0;0;0;.00nan;0;0
6556;36115;555;0;0;0;0;.00nan;0;0
6556;56316;555;100;50;2;48;.960;3900000;0
6556;85489;552;74;23;2;21;.913;3900000;0
6557;10112;1423;88;47;2;45;.957;3600000;0
6557;11851;560;0;0;0;0;.00nan;0;0
6557;27517;1423;0;0;0;0;.00nan;0;0
6557;65324;560;79;26;1;25;.962;3600000;0
6558;43264;561;0;0;0;0;.00nan;0;0
6558;43925;556;0;0;0;0;.00nan;0;0
6558;46468;561;78;47;4;43;.915;3600000;0
6558;80596;556;87;15;0;15;1.000;3600000;0
6559;37424;553;79;33;2;31;.939;3600000;0
6559;70573;553;0;0;0;0;.00nan;0;0
6559;86686;558;83;48;5;43;.896;3600000;0
6559;161129;558;0;0;0;0;.00nan;0;0
6560;3633;554;71;13;1;12;.923;3600000;0
6560;9455;554;0;0;0;0;.00nan;0;0
6560;24593;2626;53;52;7;45;.865;2911000;0
6560;81733;2626;50;15;2;13;.867;689000;0
6561;174017;552;83;14;0;14;1.000;3600000;0
6561;36115;555;49;13;2;11;.846;499000;0
6561;56316;555;77;53;6;47;.887;3101000;0
6561;85489;552;0;0;0;0;.00nan;0;0
6562;43925;556;0;0;0;0;.00nan;0;0
6562;80596;556;70;26;2;24;.923;3600000;0
6562;86686;558;50;1;0;1;1.000;302000;0
6562;161129;558;61;36;5;31;.861;3298000;0
6563;174017;552;44;14;3;11;.786;3600000;0
6563;85489;552;0;0;0;0;.00nan;0;0
6563;86686;558;66;41;5;36;.878;3535000;0
6563;161129;558;0;0;0;0;.00nan;0;0
6564;37424;553;0;0;0;0;.00nan;0;0
6564;43264;561;46;26;4;22;.846;3900000;0
6564;46468;561;0;0;0;0;.00nan;0;0
6564;70573;553;48;31;4;27;.871;3900000;0
6565;24593;2626;98;58;3;55;.948;3600000;0
6565;43925;556;88;15;0;15;1.000;3600000;0
6565;80596;556;0;0;0;0;.00nan;0;0
6565;81733;2626;0;0;0;0;.00nan;0;0
6566;11851;560;69;35;3;32;.914;3600000;0
6566;36115;555;0;0;0;0;.00nan;0;0
6566;56316;555;72;42;4;38;.905;3600000;0
6566;65324;560;0;0;0;0;.00nan;0;0
6567;3633;554;59;14;2;12;.857;3600000;0
6567;9455;554;0;0;0;0;.00nan;0;0
6567;10112;1423;63;35;4;31;.886;1265000;0
6567;27517;1423;39;40;6;34;.850;2335000;0
6568;174017;552;0;0;0;0;.00nan;0;0
6568;85489;552;54;17;2;15;.882;3808000;0
6568;86686;558;0;0;0;0;.00nan;0;0
6568;161129;558;94;44;3;41;.932;3808000;0
6569;11851;560;0;0;0;0;.00nan;0;0
6569;43264;561;0;0;0;0;.00nan;0;0
6569;46468;561;61;24;2;22;.917;3600000;0
6569;65324;560;75;40;3;37;.925;3600000;0
6570;24593;2626;0;0;0;0;.00nan;0;0
6570;36115;555;0;0;0;0;.00nan;0;0
6570;56316;555;42;34;5;29;.853;3619000;0
6570;81733;2626;40;34;6;28;.824;3619000;0
6571;3633;554;68;15;1;14;.933;3600000;0
6571;9455;554;0;0;0;0;.00nan;0;0
6571;37424;553;41;19;3;16;.842;1192000;0
6571;70573;553;29;27;6;21;.778;2408000;0
6572;10112;1423;97;55;1;54;.982;3900000;0
6572;27517;1423;0;0;0;0;.00nan;0;0
6572;43925;556;85;26;1;25;.962;3900000;0
6572;80596;556;0;0;0;0;.00nan;0;0
6573;3633;554;63;16;1;15;.938;3600000;0
6573;9455;554;0;0;0;0;.00nan;0;0
6573;43264;561;81;49;4;45;.918;3600000;0
6573;46468;561;0;0;0;0;.00nan;0;0
6574;3633;554;73;24;3;21;.875;3529000;0
6574;9455;554;0;0;0;0;.00nan;0;0
6574;43264;561;0;0;0;0;.00nan;0;0
6574;46468;561;90;45;2;43;.956;3600000;0
6575;43925;556;100;39;1;38;.974;3600000;0
6575;80596;556;0;0;0;0;.00nan;0;0
6575;86686;558;48;42;7;35;.833;3600000;0
6575;161129;558;0;0;0;0;.00nan;0;0
6576;10112;1423;56;49;6;43;.878;3600000;0
6576;27517;1423;0;0;0;0;.00nan;0;0
6576;37424;553;0;0;0;0;.00nan;0;0
6576;70573;553;86;13;0;13;1.000;3600000;0
6577;174017;552;45;13;3;10;.769;3638000;0
6577;36115;555;0;0;0;0;.00nan;0;0
6577;56316;555;92;61;4;57;.934;3638000;0
6577;85489;552;0;0;0;0;.00nan;0;0
6578;24593;2626;90;44;3;41;.932;3600000;0
6578;37424;553;0;0;0;0;.00nan;0;0
6578;70573;553;29;21;5;16;.762;3514000;0
6578;81733;2626;0;0;0;0;.00nan;0;0
6579;10112;1423;0;0;0;0;.00nan;0;0
6579;27517;1423;76;27;2;25;.926;3600000;0
6579;36115;555;41;21;4;17;.810;1166000;0
6579;56316;555;17;20;6;14;.700;2434000;0
6580;174017;552;0;0;0;0;.00nan;0;0
6580;43925;556;91;47;3;44;.936;3576000;0
6580;80596;556;0;0;0;0;.00nan;0;0
6580;85489;552;59;14;1;13;.929;3600000;0
6581;11851;560;90;30;1;29;.967;3600000;0
6581;43925;556;64;17;2;15;.882;3556000;0
6581;65324;560;0;0;0;0;.00nan;0;0
6581;80596;556;0;0;0;0;.00nan;0;0
6582;174017;552;39;22;4;18;.818;3523000;0
6582;37424;553;0;0;0;0;.00nan;0;0
6582;70573;553;100;34;2;32;.941;3600000;0
6582;85489;552;0;0;0;0;.00nan;0;0
6583;10112;1423;64;46;5;41;.891;3600000;0
6583;27517;1423;0;0;0;0;.00nan;0;0
6583;86686;558;0;0;0;0;.00nan;0;0
6583;161129;558;60;20;2;18;.900;3600000;0
6584;24593;2626;71;30;2;28;.933;3600000;0
6584;36115;555;0;0;0;0;.00nan;0;0
6584;56316;555;51;35;4;31;.886;3541000;0
6584;81733;2626;0;0;0;0;.00nan;0;0
6585;3633;554;61;15;1;14;.933;3600000;0
6585;9455;554;0;0;0;0;.00nan;0;0
6585;43264;561;98;70;4;66;.943;3600000;0
6585;46468;561;0;0;0;0;.00nan;0;0
6586;24593;2626;100;31;0;31;1.000;3600000;0
6586;43264;561;0;0;0;0;.00nan;0;0
6586;46468;561;74;22;1;21;.955;3548000;0
6586;81733;2626;0;0;0;0;.00nan;0;0
6587;3633;554;64;32;4;28;.875;3764000;0
6587;9455;554;0;0;0;0;.00nan;0;0
6587;43925;556;0;0;0;0;.00nan;0;0
6587;80596;556;66;38;5;33;.868;3764000;0
6588;10112;1423;0;0;0;0;.00nan;0;0
6588;11851;560;0;0;0;0;.00nan;0;0
6588;27517;1423;84;37;2;35;.946;3900000;0
6588;65324;560;81;32;2;30;.938;3900000;0
6589;36115;555;56;37;5;32;.865;3600000;0
6589;56316;555;0;0;0;0;.00nan;0;0
6589;86686;558;63;21;2;19;.905;3600000;0
6589;161129;558;0;0;0;0;.00nan;0;0
6590;174017;552;0;0;0;0;.00nan;0;0
6590;37424;553;0;0;0;0;.00nan;0;0
6590;70573;553;63;18;2;16;.889;3600000;0
6590;85489;552;58;25;3;22;.880;3598000;0
6591;24593;2626;88;30;2;28;.933;3900000;0
6591;43264;561;46;14;2;12;.857;3900000;0
6591;46468;561;0;0;0;0;.00nan;0;0
6591;81733;2626;0;0;0;0;.00nan;0;0
6592;10112;1423;32;34;6;28;.824;3336000;0
6592;11851;560;92;33;2;31;.939;3600000;0
6592;27517;1423;43;3;1;2;.667;264000;0
6592;65324;560;0;0;0;0;.00nan;0;0
6593;37424;553;0;0;0;0;.00nan;0;0
6593;43925;556;53;31;4;27;.871;3600000;0
6593;70573;553;51;39;5;34;.872;3546000;0
6593;80596;556;0;0;0;0;.00nan;0;0
6594;36115;555;52;24;3;21;.875;2669000;0
6594;56316;555;16;15;5;10;.667;931000;0
6594;86686;558;0;0;0;0;.00nan;0;0
6594;161129;558;66;17;1;16;.941;3600000;0
6595;3633;554;78;32;2;30;.938;3600000;0
6595;9455;554;0;0;0;0;.00nan;0;0
6595;174017;552;59;42;5;37;.881;3600000;0
6595;85489;552;0;0;0;0;.00nan;0;0
6596;24593;2626;75;50;4;46;.920;3600000;0
6596;81733;2626;0;0;0;0;.00nan;0;0
6596;86686;558;94;24;0;24;1.000;3600000;0
6596;161129;558;0;0;0;0;.00nan;0;0
6597;11851;560;71;22;1;21;.955;1152000;0
6597;37424;553;49;17;2;15;.882;3600000;0
6597;65324;560;41;39;6;33;.846;2448000;0
6597;70573;553;0;0;0;0;.00nan;0;0
6598;10112;1423;0;0;0;0;.00nan;0;0
6598;27517;1423;66;30;3;27;.900;3600000;0
6598;43264;561;0;0;0;0;.00nan;0;0
6598;46468;561;57;22;2;20;.909;3600000;0
6599;3633;554;50;20;3;17;.850;3600000;0
6599;9455;554;0;0;0;0;.00nan;0;0
6599;36115;555;0;0;0;0;.00nan;0;0
6599;56316;555;84;69;5;64;.928;3600000;0
6600;174017;552;0;0;0;0;.00nan;0;0
6600;43925;556;46;38;6;32;.842;3182000;0
6600;80596;556;42;4;1;3;.750;418000;0
6600;85489;552;69;19;1;18;.947;3600000;0
6601;174017;552;56;24;3;21;.875;3600000;0
6601;85489;552;0;0;0;0;.00nan;0;0
6601;86686;558;21;42;9;33;.786;3600000;0
6601;161129;558;0;0;0;0;.00nan;0;0
6602;11851;560;61;39;4;35;.897;3547000;0
6602;43264;561;65;34;3;31;.912;3600000;0
6602;46468;561;0;0;0;0;.00nan;0;0
6602;65324;560;0;0;0;0;.00nan;0;0
6603;10112;1423;98;53;2;51;.962;3565000;0
6603;27517;1423;0;0;0;0;.00nan;0;0
6603;43925;556;59;14;1;13;.929;3600000;0
6603;80596;556;0;0;0;0;.00nan;0;0
6604;36115;555;0;0;0;0;.00nan;0;0
6604;37424;553;0;0;0;0;.00nan;0;0
6604;56316;555;100;54;2;52;.963;3600000;0
6604;70573;553;53;23;3;20;.870;3547000;0
6605;3633;554;52;23;3;20;.870;3600000;0
6605;9455;554;0;0;0;0;.00nan;0;0
6605;24593;2626;29;28;6;22;.786;1772000;0
6605;81733;2626;67;31;3;28;.903;1828000;0
6606;174017;552;0;0;0;0;.00nan;0;0
6606;85489;552;77;24;1;23;.958;3600000;0
6606;86686;558;60;9;0;9;1.000;1044000;0
6606;161129;558;45;34;6;28;.824;2556000;0
6607;11851;560;42;37;6;31;.838;3600000;0
6607;43264;561;0;0;0;0;.00nan;0;0
6607;46468;561;85;37;2;35;.946;3600000;0
6607;65324;560;0;0;0;0;.00nan;0;0
6608;3633;554;49;14;2;12;.857;3600000;0
6608;9455;554;0;0;0;0;.00nan;0;0
6608;24593;2626;74;40;3;37;.925;3547000;0
6608;81733;2626;0;0;0;0;.00nan;0;0
6609;36115;555;64;54;7;47;.870;3600000;0
6609;37424;553;0;0;0;0;.00nan;0;0
6609;56316;555;0;0;0;0;.00nan;0;0
6609;70573;553;54;21;3;18;.857;3600000;0
6610;11851;560;81;28;1;27;.964;3600000;0
6610;45584;2626;0;0;0;0;.00nan;0;0
6610;65324;560;0;0;0;0;.00nan;0;0
6610;81733;2626;57;24;3;21;.875;3535000;0
6611;3633;554;64;26;2;24;.923;3900000;0
6611;9455;554;0;0;0;0;.00nan;0;0
6611;37424;553;0;0;0;0;.00nan;0;0
6611;70573;553;96;50;2;48;.960;3900000;0
6612;43264;561;62;43;5;38;.884;3600000;0
6612;46468;561;0;0;0;0;.00nan;0;0
6612;86686;558;0;0;0;0;.00nan;0;0
6612;161129;558;81;27;1;26;.963;3600000;0
6613;10112;1423;92;42;2;40;.952;3600000;0
6613;27517;1423;0;0;0;0;.00nan;0;0
6613;43925;556;78;20;1;19;.950;3600000;0
6613;80596;556;0;0;0;0;.00nan;0;0
6614;174017;552;48;10;2;8;.800;3600000;0
6614;36115;555;98;49;3;46;.939;3051000;0
6614;56316;555;23;14;4;10;.714;549000;0
6614;85489;552;0;0;0;0;.00nan;0;0
6615;174017;552;0;0;0;0;.00nan;0;0
6615;45584;2626;88;63;5;58;.921;3600000;0
6615;81733;2626;0;0;0;0;.00nan;0;0
6615;85489;552;54;8;1;7;.875;3600000;0
6616;43264;561;0;0;0;0;.00nan;0;0
6616;43925;556;37;40;7;33;.825;3554000;0
6616;46468;561;38;37;6;31;.838;3600000;0
6616;80596;556;0;0;0;0;.00nan;0;0
6617;10112;1423;0;0;0;0;.00nan;0;0
6617;27517;1423;97;60;4;56;.933;3597000;0
6617;37424;553;0;0;0;0;.00nan;0;0
6617;70573;553;51;14;2;12;.857;3600000;0
6618;11851;560;89;37;2;35;.946;3600000;0
6618;36115;555;0;0;0;0;.00nan;0;0
6618;56316;555;49;30;5;25;.833;3600000;0
6618;65324;560;0;0;0;0;.00nan;0;0
6619;3633;554;0;0;0;0;.00nan;0;0
6619;9455;554;40;21;4;17;.810;3600000;0
6619;86686;558;37;15;3;12;.800;501000;0
6619;161129;558;67;43;5;38;.884;3099000;0
6620;11851;560;97;55;3;52;.945;3600000;0
6620;37424;553;0;0;0;0;.00nan;0;0
6620;65324;560;0;0;0;0;.00nan;0;0
6620;70573;553;100;22;0;22;1.000;3600000;0
6621;45584;2626;81;52;5;47;.904;3900000;0
6621;81733;2626;0;0;0;0;.00nan;0;0
6621;86686;558;0;0;0;0;.00nan;0;0
6621;161129;558;43;27;5;22;.815;3900000;0
6622;3633;554;100;25;0;25;1.000;3600000;0
6622;9455;554;0;0;0;0;.00nan;0;0
6622;43925;556;59;39;6;33;.846;3600000;0
6622;80596;556;0;0;0;0;.00nan;0;0
6623;10112;1423;60;33;4;29;.879;2396000;0
6623;174017;552;51;8;1;7;.875;3600000;0
6623;27517;1423;63;19;1;18;.947;1204000;0
6623;85489;552;0;0;0;0;.00nan;0;0
6624;45584;2626;0;0;0;0;.00nan;0;0
6624;81733;2626;88;53;4;49;.925;3561000;0
6624;86686;558;91;31;3;28;.903;3600000;0
6624;161129;558;0;0;0;0;.00nan;0;0
6625;10112;1423;56;25;3;22;.880;3900000;0
6625;27517;1423;0;0;0;0;.00nan;0;0
6625;45584;2626;74;40;3;37;.925;3900000;0
6625;81733;2626;0;0;0;0;.00nan;0;0
6626;11851;560;68;46;5;41;.891;3600000;0
6626;37424;553;0;0;0;0;.00nan;0;0
6626;65324;560;0;0;0;0;.00nan;0;0
6626;70573;553;63;14;1;13;.929;3600000;0
6627;36115;555;0;0;0;0;.00nan;0;0
6627;43925;556;44;17;3;14;.824;3568000;0
6627;56316;555;96;47;2;45;.957;3600000;0
6627;80596;556;0;0;0;0;.00nan;0;0
6628;3633;554;89;33;2;31;.939;3600000;0
6628;9455;554;0;0;0;0;.00nan;0;0
6628;174017;552;0;0;0;0;.00nan;0;0
6628;85489;552;56;34;4;30;.882;3513000;0
6629;36115;555;98;45;1;44;.978;3588000;0
6629;43264;561;75;9;0;9;1.000;3600000;0
6629;46468;561;0;0;0;0;.00nan;0;0
6629;56316;555;0;0;0;0;.00nan;0;0
6630;11851;560;0;0;0;0;.00nan;0;0
6630;43925;556;67;18;1;17;.944;3600000;0
6630;65324;560;51;39;5;34;.872;3600000;0
6630;80596;556;0;0;0;0;.00nan;0;0
6631;10112;1423;0;0;0;0;.00nan;0;0
6631;174017;552;44;15;3;12;.800;3600000;0
6631;27517;1423;43;33;5;28;.848;3600000;0
6631;85489;552;0;0;0;0;.00nan;0;0
6632;3633;554;58;29;3;26;.897;3764000;0
6632;9455;554;0;0;0;0;.00nan;0;0
6632;37424;553;0;0;0;0;.00nan;0;0
6632;70573;553;66;33;4;29;.879;3791000;0
6633;36115;555;0;0;0;0;.00nan;0;0
6633;37424;553;0;0;0;0;.00nan;0;0
6633;56316;555;100;54;3;51;.944;3600000;0
6633;70573;553;47;32;5;27;.844;3580000;0
6634;37424;553;0;0;0;0;.00nan;0;0
6634;43264;561;77;33;3;30;.909;3600000;0
6634;46468;561;0;0;0;0;.00nan;0;0
6634;70573;553;61;38;4;34;.895;3569000;0
6635;11851;560;83;53;6;47;.887;3560000;0
6635;174017;552;54;21;4;17;.810;3600000;0
6635;65324;560;0;0;0;0;.00nan;0;0
6635;85489;552;0;0;0;0;.00nan;0;0
6636;24593;2626;79;58;5;53;.914;3600000;0
6636;43925;556;66;20;2;18;.900;3600000;0
6636;80596;556;0;0;0;0;.00nan;0;0
6636;81733;2626;0;0;0;0;.00nan;0;0
6637;3633;554;47;19;3;16;.842;3700000;0
6637;9455;554;0;0;0;0;.00nan;0;0
6637;86686;558;71;39;4;35;.897;3700000;0
6637;161129;558;0;0;0;0;.00nan;0;0
6638;10112;1423;78;25;1;24;.960;3600000;0
6638;27517;1423;0;0;0;0;.00nan;0;0
6638;36115;555;77;29;2;27;.931;3564000;0
6638;56316;555;0;0;0;0;.00nan;0;0
6639;43925;556;0;0;0;0;.00nan;0;0
6639;80596;556;39;28;5;23;.821;3542000;0
6639;86686;558;0;0;0;0;.00nan;0;0
6639;161129;558;67;33;3;30;.909;3600000;0
6640;10112;1423;0;0;0;0;.00nan;0;0
6640;11851;560;59;36;4;32;.889;3600000;0
6640;27517;1423;61;40;5;35;.875;3600000;0
6640;65324;560;0;0;0;0;.00nan;0;0
6641;3633;554;79;23;1;22;.957;3600000;0
6641;9455;554;0;0;0;0;.00nan;0;0
6641;43264;561;0;0;0;0;.00nan;0;0
6641;46468;561;64;42;5;37;.881;3600000;0
6642;174017;552;0;0;0;0;.00nan;0;0
6642;24593;2626;69;41;4;37;.902;1994000;0
6642;81733;2626;61;25;2;23;.920;1606000;0
6642;85489;552;86;12;0;12;1.000;3600000;0
6643;24593;2626;73;37;4;33;.892;3592000;0
6643;43264;561;62;24;3;21;.875;3600000;0
6643;46468;561;0;0;0;0;.00nan;0;0
6643;81733;2626;0;0;0;0;.00nan;0;0
6644;10112;1423;0;0;0;0;.00nan;0;0
6644;11851;560;99;39;1;38;.974;3600000;0
6644;27517;1423;56;39;4;35;.897;3600000;0
6644;65324;560;0;0;0;0;.00nan;0;0
6645;37424;553;0;0;0;0;.00nan;0;0
6645;70573;553;63;26;3;23;.885;3600000;0
6645;86686;558;50;44;7;37;.841;3600000;0
6645;161129;558;0;0;0;0;.00nan;0;0
6646;36115;555;51;2;0;2;1.000;486000;0
6646;43925;556;86;24;1;23;.958;3600000;0
6646;56316;555;65;52;6;46;.885;3114000;0
6646;80596;556;0;0;0;0;.00nan;0;0
6647;24593;2626;99;42;1;41;.976;3600000;0
6647;43264;561;0;0;0;0;.00nan;0;0
6647;46468;561;84;37;2;35;.946;3543000;0
6647;81733;2626;0;0;0;0;.00nan;0;0
6648;37424;553;80;37;3;34;.919;3600000;0
6648;70573;553;0;0;0;0;.00nan;0;0
6648;86686;558;0;0;0;0;.00nan;0;0
6648;161129;558;33;36;6;30;.833;3600000;0
6649;3633;554;65;13;1;12;.923;3600000;0
6649;9455;554;0;0;0;0;.00nan;0;0
6649;11851;560;41;34;6;28;.824;2168000;0
6649;65324;560;36;24;5;19;.792;1432000;0
6650;174017;552;68;26;2;24;.923;3600000;0
6650;36115;555;85;36;3;33;.917;1381000;0
6650;56316;555;34;31;6;25;.806;2219000;0
6650;85489;552;0;0;0;0;.00nan;0;0
6651;174017;552;0;0;0;0;.00nan;0;0
6651;43925;556;83;33;2;31;.939;3600000;0
6651;80596;556;0;0;0;0;.00nan;0;0
6651;85489;552;58;26;3;23;.885;3600000;0
6652;3633;554;57;20;3;17;.850;3600000;0
6652;9455;554;0;0;0;0;.00nan;0;0
6652;10112;1423;0;0;0;0;.00nan;0;0
6652;27517;1423;89;49;4;45;.918;3600000;0
6653;11851;560;61;33;4;29;.879;3600000;0
6653;24593;2626;100;23;0;23;1.000;3600000;0
6653;65324;560;0;0;0;0;.00nan;0;0
6653;81733;2626;0;0;0;0;.00nan;0;0
6654;3633;554;36;24;5;19;.792;3600000;0
6654;9455;554;0;0;0;0;.00nan;0;0
6654;10112;1423;20;9;4;5;.556;603000;0
6654;27517;1423;74;44;4;40;.909;2997000;0
6655;3633;554;65;14;1;13;.929;3600000;0
6655;9455;554;0;0;0;0;.00nan;0;0
6655;11851;560;34;17;4;13;.765;871000;0
6655;65324;560;32;37;7;30;.811;2729000;0
6656;24593;2626;42;34;7;27;.794;2666000;0
6656;37424;553;0;0;0;0;.00nan;0;0
6656;70573;553;44;17;3;14;.824;3600000;0
6656;81733;2626;51;9;1;8;.889;934000;0
6657;36115;555;0;0;0;0;.00nan;0;0
6657;56316;555;78;41;3;38;.927;3900000;0
6657;86686;558;54;22;3;19;.864;3881000;0
6657;161129;558;0;0;0;0;.00nan;0;0
6658;174017;552;41;26;5;21;.808;3600000;0
6658;43264;561;33;35;6;29;.829;2625000;0
6658;46468;561;57;7;0;7;1.000;975000;0
6658;85489;552;0;0;0;0;.00nan;0;0
6659;24593;2626;94;42;2;40;.952;3716000;0
6659;43925;556;61;11;1;10;.909;3716000;0
6659;80596;556;0;0;0;0;.00nan;0;0
6659;81733;2626;0;0;0;0;.00nan;0;0
6660;11851;560;59;38;5;33;.868;3600000;0
6660;65324;560;0;0;0;0;.00nan;0;0
6660;86686;558;0;0;0;0;.00nan;0;0
6660;161129;558;75;23;2;21;.913;3600000;0
6661;10112;1423;0;0;0;0;.00nan;0;0
6661;27517;1423;38;22;4;18;.818;3600000;0
6661;36115;555;84;41;3;38;.927;3600000;0
6661;56316;555;0;0;0;0;.00nan;0;0
6662;174017;552;0;0;0;0;.00nan;0;0
6662;43264;561;0;0;0;0;.00nan;0;0
6662;46468;561;86;48;3;45;.938;3600000;0
6662;85489;552;63;19;2;17;.895;3600000;0
6663;3633;554;76;31;2;29;.935;3531000;0
6663;9455;554;0;0;0;0;.00nan;0;0
6663;37424;553;0;0;0;0;.00nan;0;0
6663;70573;553;100;38;0;38;1.000;3600000;0
6664;10112;1423;46;7;1;6;.857;524000;0
6664;27517;1423;56;43;6;37;.860;3076000;0
6664;43264;561;81;25;1;24;.960;3600000;0
6664;46468;561;0;0;0;0;.00nan;0;0
6665;37424;553;0;0;0;0;.00nan;0;0
6665;43925;556;26;43;8;35;.814;3234000;0
6665;70573;553;82;35;2;33;.943;3600000;0
6665;80596;556;50;1;0;1;1.000;366000;0
6666;24593;2626;59;35;4;31;.886;3600000;0
6666;36115;555;0;0;0;0;.00nan;0;0
6666;56316;555;38;35;6;29;.829;3554000;0
6666;81733;2626;0;0;0;0;.00nan;0;0
6667;10112;1423;99;35;1;34;.971;3600000;0
6667;27517;1423;0;0;0;0;.00nan;0;0
6667;43264;561;0;0;0;0;.00nan;0;0
6667;46468;561;80;31;3;28;.903;3519000;0
6668;11851;560;32;9;3;6;.667;271000;0
6668;37424;553;0;0;0;0;.00nan;0;0
6668;65324;560;48;37;6;31;.838;3329000;0
6668;70573;553;63;16;1;15;.938;3600000;0
6669;36115;555;86;47;3;44;.936;3600000;0
6669;56316;555;0;0;0;0;.00nan;0;0
6669;86686;558;40;19;4;15;.789;3551000;0
6669;161129;558;0;0;0;0;.00nan;0;0
6670;3633;554;70;25;3;22;.880;3820000;0
6670;9455;554;0;0;0;0;.00nan;0;0
6670;174017;552;0;0;0;0;.00nan;0;0
6670;85489;552;95;36;2;34;.944;3820000;0
6671;11851;560;100;44;2;42;.955;3600000;0
6671;65324;560;0;0;0;0;.00nan;0;0
6671;86686;558;0;0;0;0;.00nan;0;0
6671;161129;558;29;19;5;14;.737;3600000;0
6672;174017;552;41;24;5;19;.792;3900000;0
6672;24593;2626;98;57;5;52;.912;3900000;0
6672;81733;2626;0;0;0;0;.00nan;0;0
6672;85489;552;0;0;0;0;.00nan;0;0
6673;11851;560;97;46;1;45;.978;3900000;0
6673;174017;552;0;0;0;0;.00nan;0;0
6673;65324;560;0;0;0;0;.00nan;0;0
6673;85489;552;77;25;1;24;.960;3900000;0
6674;10112;1423;73;47;5;42;.894;3600000;0
6674;27517;1423;0;0;0;0;.00nan;0;0
6674;43925;556;72;20;2;18;.900;3600000;0
6674;80596;556;0;0;0;0;.00nan;0;0
6675;43925;556;37;31;5;26;.839;3580000;0
6675;80596;556;0;0;0;0;.00nan;0;0
6675;86686;558;80;38;3;35;.921;3600000;0
6675;161129;558;0;0;0;0;.00nan;0;0
6676;43264;561;54;29;4;25;.862;3600000;0
6676;43925;556;100;30;0;30;1.000;3600000;0
6676;46468;561;0;0;0;0;.00nan;0;0
6676;80596;556;0;0;0;0;.00nan;0;0
6677;10112;1423;28;29;6;23;.793;3092000;0
6677;27517;1423;62;6;0;6;1.000;508000;0
6677;86686;558;0;0;0;0;.00nan;0;0
6677;161129;558;70;29;2;27;.931;3600000;0
6678;24593;2626;76;31;2;29;.935;3600000;0
6678;36115;555;0;0;0;0;.00nan;0;0
6678;56316;555;57;25;3;22;.880;3543000;0
6678;81733;2626;0;0;0;0;.00nan;0;0
6679;3633;554;64;32;4;28;.875;3600000;0
6679;9455;554;0;0;0;0;.00nan;0;0
6679;174017;552;61;11;0;11;1.000;1233000;0
6679;85489;552;26;19;5;14;.737;2344000;0
6680;3633;554;62;17;1;16;.941;3600000;0
6680;9455;554;0;0;0;0;.00nan;0;0
6680;11851;560;72;41;5;36;.878;3600000;0
6680;65324;560;0;0;0;0;.00nan;0;0
6681;24593;2626;19;20;6;14;.700;1917000;0
6681;36115;555;78;34;2;32;.941;3600000;0
6681;56316;555;0;0;0;0;.00nan;0;0
6681;81733;2626;60;10;1;9;.900;1683000;0
6682;37424;553;0;0;0;0;.00nan;0;0
6682;43264;561;0;0;0;0;.00nan;0;0
6682;46468;561;56;36;5;31;.861;3600000;0
6682;70573;553;64;28;3;25;.893;3600000;0
6683;10112;1423;85;51;4;47;.922;2462000;0
6683;174017;552;66;14;1;13;.929;3600000;0
6683;27517;1423;32;20;4;16;.800;1138000;0
6683;85489;552;0;0;0;0;.00nan;0;0
6684;43925;556;83;26;1;25;.962;3900000;0
6684;80596;556;0;0;0;0;.00nan;0;0
6684;86686;558;96;48;1;47;.979;3900000;0
6684;161129;558;0;0;0;0;.00nan;0;0
6685;43264;561;28;28;6;22;.786;2290000;0
6685;46468;561;55;11;1;10;.909;1310000;0
6685;86686;558;0;0;0;0;.00nan;0;0
6685;161129;558;100;37;1;36;.973;3600000;0
6686;36115;555;0;0;0;0;.00nan;0;0
6686;43925;556;46;11;2;9;.818;3600000;0
6686;56316;555;75;48;4;44;.917;3569000;0
6686;80596;556;0;0;0;0;.00nan;0;0
6687;10112;1423;51;48;7;41;.854;3206000;0
6687;27517;1423;19;9;4;5;.556;394000;0
6687;37424;553;0;0;0;0;.00nan;0;0
6687;70573;553;61;12;1;11;.917;3600000;0
6688;3633;554;39;21;4;17;.810;3600000;0
6688;9455;554;0;0;0;0;.00nan;0;0
6688;24593;2626;48;43;6;37;.860;2661000;0
6688;81733;2626;73;16;0;16;1.000;905000;0
6689;11851;560;83;60;6;54;.900;3600000;0
6689;174017;552;96;18;0;18;1.000;3600000;0
6689;65324;560;0;0;0;0;.00nan;0;0
6689;85489;552;0;0;0;0;.00nan;0;0
6690;11851;560;0;0;0;0;.00nan;0;0
6690;43264;561;55;6;0;6;1.000;1344000;0
6690;46468;561;49;20;4;16;.800;2390000;0
6690;65324;560;64;40;5;35;.875;3734000;0
6691;10112;1423;0;0;0;0;.00nan;0;0
6691;24593;2626;90;36;2;34;.944;3900000;0
6691;27517;1423;92;39;2;37;.949;3900000;0
6691;81733;2626;0;0;0;0;.00nan;0;0
6692;174017;552;37;14;3;11;.786;3900000;0
6692;36115;555;100;64;3;61;.953;3900000;0
6692;56316;555;0;0;0;0;.00nan;0;0
6692;85489;552;0;0;0;0;.00nan;0;0
6693;3633;554;0;0;0;0;.00nan;0;0
6693;9455;554;45;24;5;19;.792;3900000;0
6693;86686;558;98;64;5;59;.922;3900000;0
6693;161129;558;0;0;0;0;.00nan;0;0
6694;11851;560;82;38;3;35;.921;3544000;0
6694;36115;555;0;0;0;0;.00nan;0;0
6694;56316;555;80;27;1;26;.963;3600000;0
6694;65324;560;0;0;0;0;.00nan;0;0
6695;174017;552;68;19;1;18;.947;3600000;0
6695;43264;561;57;43;5;38;.884;3600000;0
6695;46468;561;0;0;0;0;.00nan;0;0
6695;85489;552;0;0;0;0;.00nan;0;0
6696;174017;552;0;0;0;0;.00nan;0;0
6696;43264;561;0;0;0;0;.00nan;0;0
6696;46468;561;100;51;1;50;.980;3600000;0
6696;85489;552;30;17;4;13;.765;3600000;0
6697;11851;560;22;25;6;19;.760;2282000;0
6697;24593;2626;78;26;1;25;.962;3600000;0
6697;65324;560;65;11;0;11;1.000;1318000;0
6697;81733;2626;0;0;0;0;.00nan;0;0
6698;37424;553;0;0;0;0;.00nan;0;0
6698;43925;556;79;27;2;25;.926;3600000;0
6698;70573;553;57;34;4;30;.882;3568000;0
6698;80596;556;0;0;0;0;.00nan;0;0
6699;10112;1423;81;58;6;52;.897;3600000;0
6699;27517;1423;0;0;0;0;.00nan;0;0
6699;86686;558;66;23;2;21;.913;3600000;0
6699;161129;558;0;0;0;0;.00nan;0;0
6700;3633;554;56;11;1;10;.909;3600000;0
6700;9455;554;0;0;0;0;.00nan;0;0
6700;36115;555;0;0;0;0;.00nan;0;0
6700;56316;555;71;62;7;55;.887;3600000;0
6701;10112;1423;0;0;0;0;.00nan;0;0
6701;24593;2626;0;0;0;0;.00nan;0;0
6701;27517;1423;51;37;5;32;.865;3656000;0
6701;81733;2626;54;31;4;27;.871;3656000;0
6702;37424;553;68;33;3;30;.909;3600000;0
6702;43925;556;43;36;6;30;.833;3600000;0
6702;70573;553;0;0;0;0;.00nan;0;0
6702;80596;556;0;0;0;0;.00nan;0;0
6703;11851;560;65;40;4;36;.900;3564000;0
6703;65324;560;0;0;0;0;.00nan;0;0
6703;86686;558;75;34;3;31;.912;3600000;0
6703;161129;558;0;0;0;0;.00nan;0;0
6704;3633;554;0;0;0;0;.00nan;0;0
6704;9455;554;34;13;4;9;.692;3581000;0
6704;36115;555;99;62;3;59;.952;3600000;0
6704;56316;555;0;0;0;0;.00nan;0;0
6705;36115;555;0;0;0;0;.00nan;0;0
6705;43264;561;50;26;4;22;.846;3600000;0
6705;46468;561;0;0;0;0;.00nan;0;0
6705;56316;555;100;46;1;45;.978;3600000;0
6737;9455;554;39;11;3;8;.727;3900000;0
6737;10112;1423;0;0;0;0;.00nan;0;0
6737;27517;1423;95;59;3;56;.949;3900000;0
6737;37864;554;0;0;0;0;.00nan;0;0
6739;11851;560;89;57;5;52;.912;3600000;0
6739;174017;552;0;0;0;0;.00nan;0;0
6739;65324;560;0;0;0;0;.00nan;0;0
6739;85489;552;55;11;1;10;.909;3600000;0
6741;37424;553;0;0;0;0;.00nan;0;0
6741;43925;556;87;37;3;34;.919;3600000;0
6741;70573;553;37;20;4;16;.800;3565000;0
6741;80596;556;0;0;0;0;.00nan;0;0
6743;36115;555;0;0;0;0;.00nan;0;0
6743;43264;561;46;28;4;24;.857;3544000;0
6743;46468;561;0;0;0;0;.00nan;0;0
6743;56316;555;68;33;3;30;.909;3600000;0
6745;24593;2626;71;34;3;31;.912;3600000;0
6745;81733;2626;0;0;0;0;.00nan;0;0
6745;86686;558;45;37;5;32;.865;3555000;0
6745;161129;558;0;0;0;0;.00nan;0;0
6747;11851;560;69;24;2;22;.917;2564000;0
6747;174017;552;62;12;1;11;.917;3600000;0
6747;65324;560;48;25;4;21;.840;1036000;0
6747;85489;552;0;0;0;0;.00nan;0;0
6749;36115;555;70;43;5;38;.884;3548000;0
6749;56316;555;0;0;0;0;.00nan;0;0
6749;86686;558;0;0;0;0;.00nan;0;0
6749;161129;558;42;27;4;23;.852;3600000;0
6751;9455;554;0;0;0;0;.00nan;0;0
6751;10112;1423;77;45;4;41;.911;3582000;0
6751;27517;1423;0;0;0;0;.00nan;0;0
6751;37864;554;53;16;3;13;.813;3600000;0
6753;37424;553;59;19;2;17;.895;3600000;0
6753;43264;561;0;0;0;0;.00nan;0;0
6753;46468;561;78;48;4;44;.917;3572000;0
6753;70573;553;0;0;0;0;.00nan;0;0
6755;24593;2626;0;0;0;0;.00nan;0;0
6755;43925;556;0;0;0;0;.00nan;0;0
6755;80596;556;32;22;5;17;.773;3521000;0
6755;81733;2626;74;37;3;34;.919;3600000;0
2079;3633;554;55;13;1;12;.923;3600000;0
2079;9455;554;0;0;0;0;.00nan;0;0
2079;36115;555;47;8;1;7;.875;337000;0
2079;56316;555;65;51;6;45;.882;3263000;0
2080;174017;552;69;11;1;10;.909;3600000;0
2080;43264;561;73;50;5;45;.900;3600000;0
2080;46468;561;0;0;0;0;.00nan;0;0
2080;85489;552;0;0;0;0;.00nan;0;0
2081;24593;2626;96;59;3;56;.949;3600000;0
2081;81733;2626;0;0;0;0;.00nan;0;0
2081;86686;558;75;18;1;17;.944;3600000;0
2081;161129;558;0;0;0;0;.00nan;0;0
2082;37424;553;0;0;0;0;.00nan;0;0
2082;43925;556;79;29;2;27;.931;3600000;0
2082;70573;553;78;47;4;43;.915;3600000;0
2082;80596;556;0;0;0;0;.00nan;0;0
2083;3633;554;68;7;0;7;1.000;3600000;0
2083;9455;554;0;0;0;0;.00nan;0;0
2083;36115;555;0;0;0;0;.00nan;0;0
2083;56316;555;96;63;4;59;.937;3600000;0
2084;174017;552;0;0;0;0;.00nan;0;0
2084;43264;561;80;38;3;35;.921;3586000;0
2084;46468;561;0;0;0;0;.00nan;0;0
2084;85489;552;61;15;1;14;.933;3600000;0
2085;24593;2626;82;45;3;42;.933;3600000;0
2085;81733;2626;0;0;0;0;.00nan;0;0
2085;86686;558;100;21;0;21;1.000;3600000;0
2085;161129;558;0;0;0;0;.00nan;0;0
2086;37424;553;0;0;0;0;.00nan;0;0
2086;43925;556;92;34;2;32;.941;3600000;0
2086;70573;553;73;28;2;26;.929;3600000;0
2086;80596;556;0;0;0;0;.00nan;0;0
2210;3633;554;85;20;0;20;1.000;3600000;0
2210;9455;554;0;0;0;0;.00nan;0;0
2210;43925;556;63;39;6;33;.846;2727000;0
2210;80596;556;53;13;1;12;.923;873000;0
2211;174017;552;0;0;0;0;.00nan;0;0
2211;85489;552;89;25;1;24;.960;3600000;0
2211;86686;558;44;36;5;31;.861;3600000;0
2211;161129;558;0;0;0;0;.00nan;0;0
2306;3633;554;77;25;2;23;.920;3600000;0
2306;9455;554;0;0;0;0;.00nan;0;0
2306;174017;552;0;0;0;0;.00nan;0;0
2306;85489;552;81;49;5;44;.898;3600000;0
2307;43925;556;93;30;1;29;.967;3561000;0
2307;80596;556;0;0;0;0;.00nan;0;0
2307;86686;558;99;22;0;22;1.000;3600000;0
2307;161129;558;0;0;0;0;.00nan;0;0
6776;170728;1097;0;0;0;0;.00nan;0;0
6776;-1;4922;0;0;0;0;.00nan;0;0
6776;43928;1097;69;37;4;33;.892;3600000;0
6776;91742;4922;30;34;6;28;.824;3600000;0
6777;161535;157;0;0;0;0;.00nan;0;0
6777;164987;157;62;22;2;20;.909;3600000;0
6777;-1;149;0;0;0;0;.00nan;0;0
6777;141419;149;84;47;4;43;.915;3571000;0
6778;165380;72;0;0;0;0;.00nan;0;0
6778;181446;71;0;0;0;0;.00nan;0;0
6778;85228;72;81;37;2;35;.946;3582000;0
6778;85984;71;82;20;1;19;.950;3600000;0
6779;2410;81;43;33;5;28;.848;3514000;0
6779;180873;69;68;36;3;33;.917;3600000;0
6779;70213;81;0;0;0;0;.00nan;0;0
6779;79211;69;0;0;0;0;.00nan;0;0
6780;181123;4920;87;35;3;32;.914;3600000;0
6780;181269;85;0;0;0;0;.00nan;0;0
6780;78479;4920;0;0;0;0;.00nan;0;0
6780;152624;85;53;33;5;28;.848;3576000;0
6781;-1;1096;75;36;3;33;.917;3514000;0
6781;85555;76;87;29;1;28;.966;3600000;0
6781;91703;76;0;0;0;0;.00nan;0;0
6781;141978;1096;0;0;0;0;.00nan;0;0
6782;5559;4245;0;0;0;0;.00nan;0;0
6782;-1;4620;57;23;3;20;.870;3600000;0
6782;173961;4620;0;0;0;0;.00nan;0;0
6782;149858;4245;62;37;4;33;.892;3584000;0
6783;173874;158;0;0;0;0;.00nan;0;0
6783;178911;152;80;30;2;28;.933;3560000;0
6783;178950;152;0;0;0;0;.00nan;0;0
6783;181071;158;90;25;1;24;.960;3600000;0
6784;-1;1096;0;0;0;0;.00nan;0;0
6784;85349;82;65;18;1;17;.944;3600000;0
6784;86151;82;0;0;0;0;.00nan;0;0
6784;141978;1096;97;58;3;55;.948;3530000;0
6785;37942;1095;0;0;0;0;.00nan;0;0
6785;79141;1095;76;41;3;38;.927;3600000;0
6785;85132;4921;0;0;0;0;.00nan;0;0
6785;152418;4921;46;27;4;23;.852;3591000;0
6786;165380;72;0;0;0;0;.00nan;0;0
6786;181446;71;0;0;0;0;.00nan;0;0
6786;85228;72;59;32;3;29;.906;3565000;0
6786;85984;71;92;30;1;29;.967;3600000;0
6787;163784;77;0;0;0;0;.00nan;0;0
6787;85555;76;61;16;2;14;.875;3600000;0
6787;91703;76;0;0;0;0;.00nan;0;0
6787;161047;77;86;44;4;40;.909;3549000;0
6788;161535;157;72;29;3;26;.897;3600000;0
6788;164987;157;0;0;0;0;.00nan;0;0
6788;-1;149;10;25;7;18;.720;2211000;0
6788;141419;149;37;23;5;18;.783;1389000;0
6789;2410;81;40;31;5;26;.839;2215000;0
6789;180873;69;0;0;0;0;.00nan;0;0
6789;70213;81;50;8;1;7;.875;1385000;0
6789;79211;69;66;25;2;23;.920;3600000;0
6790;-1;74;0;0;0;0;.00nan;0;0
6790;170728;1097;0;0;0;0;.00nan;0;0
6790;180606;74;61;33;3;30;.909;3600000;0
6790;43928;1097;73;41;4;37;.902;3600000;0
6791;2495;73;67;33;3;30;.909;3546000;0
6791;13325;2564;0;0;0;0;.00nan;0;0
6791;166441;2564;79;28;1;27;.964;3600000;0
6791;149450;73;0;0;0;0;.00nan;0;0
6792;173874;158;84;31;2;29;.935;3600000;0
6792;178911;152;70;32;3;29;.906;3568000;0
6792;178950;152;0;0;0;0;.00nan;0;0
6792;181071;158;0;0;0;0;.00nan;0;0
6793;5559;4245;0;0;0;0;.00nan;0;0
6793;-1;4620;73;29;2;27;.931;3600000;0
6793;173961;4620;0;0;0;0;.00nan;0;0
6793;149858;4245;62;44;5;39;.886;3600000;0
6794;181123;4920;0;0;0;0;.00nan;0;0
6794;181269;85;53;30;4;26;.867;3578000;0
6794;78479;4920;65;28;3;25;.893;3600000;0
6794;152624;85;0;0;0;0;.00nan;0;0
6795;164913;75;0;0;0;0;.00nan;0;0
6795;173856;75;77;44;3;41;.932;3600000;0
6795;-1;4922;0;0;0;0;.00nan;0;0
6795;91742;4922;52;24;4;20;.833;3579000;0
6796;163989;80;63;27;3;24;.889;3600000;0
6796;-1;151;16;35;7;28;.800;2244000;0
6796;170612;80;0;0;0;0;.00nan;0;0
6796;85507;151;22;24;6;18;.750;1356000;0
6797;3;67;0;0;0;0;.00nan;0;0
6797;163195;67;26;34;7;27;.794;3600000;0
6797;-1;78;0;0;0;0;.00nan;0;0
6797;169154;78;78;28;2;26;.929;3600000;0
6798;181123;4920;91;36;2;34;.944;3600000;0
6798;181269;85;61;21;2;19;.905;1332000;0
6798;78479;4920;0;0;0;0;.00nan;0;0
6798;152624;85;23;25;6;19;.760;2268000;0
6799;163989;80;93;30;1;29;.967;3600000;0
6799;-1;151;49;2;0;2;1.000;495000;0
6799;170612;80;0;0;0;0;.00nan;0;0
6799;85507;151;47;36;6;30;.833;3105000;0
6800;-1;78;0;0;0;0;.00nan;0;0
6800;-1;4620;0;0;0;0;.00nan;0;0
6800;169154;78;83;30;2;28;.933;3544000;0
6800;173961;4620;100;41;1;40;.976;3600000;0
6801;173874;158;78;35;3;32;.914;3561000;0
6801;178911;152;0;0;0;0;.00nan;0;0
6801;178950;152;99;42;1;41;.976;3600000;0
6801;181071;158;0;0;0;0;.00nan;0;0
6802;13325;2564;90;28;0;28;1.000;3900000;0
6802;165380;72;0;0;0;0;.00nan;0;0
6802;166441;2564;0;0;0;0;.00nan;0;0
6802;85228;72;100;32;0;32;1.000;3900000;0
6803;-1;78;0;0;0;0;.00nan;0;0
6803;169154;78;67;26;2;24;.923;3600000;0
6803;85555;76;88;49;5;44;.898;3600000;0
6803;91703;76;0;0;0;0;.00nan;0;0
6804;164913;75;0;0;0;0;.00nan;0;0
6804;173856;75;62;43;5;38;.884;3600000;0
6804;181123;4920;71;25;2;23;.920;3600000;0
6804;78479;4920;0;0;0;0;.00nan;0;0
6805;2495;73;0;0;0;0;.00nan;0;0
6805;181446;71;0;0;0;0;.00nan;0;0
6805;85984;71;30;23;5;18;.783;3600000;0
6805;149450;73;90;40;2;38;.950;3600000;0
6806;163784;77;99;27;1;26;.963;3600000;0
6806;-1;1096;24;34;7;27;.794;2686000;0
6806;141978;1096;47;5;1;4;.800;914000;0
6806;161047;77;0;0;0;0;.00nan;0;0
6807;13325;2564;84;51;5;46;.902;3600000;0
6807;166441;2564;0;0;0;0;.00nan;0;0
6807;85132;4921;0;0;0;0;.00nan;0;0
6807;152418;4921;91;27;1;26;.963;3600000;0
6808;3;67;0;0;0;0;.00nan;0;0
6808;5559;4245;0;0;0;0;.00nan;0;0
6808;163195;67;87;30;1;29;.967;3600000;0
6808;149858;4245;87;38;2;36;.947;3547000;0
6809;-1;78;0;0;0;0;.00nan;0;0
6809;169154;78;35;22;5;17;.773;3600000;0
6809;85555;76;39;40;7;33;.825;3600000;0
6809;91703;76;0;0;0;0;.00nan;0;0
6810;2410;81;65;27;3;24;.889;3600000;0
6810;178911;152;61;35;4;31;.886;3569000;0
6810;178950;152;0;0;0;0;.00nan;0;0
6810;70213;81;0;0;0;0;.00nan;0;0
6811;161535;157;89;28;2;26;.929;3607000;0
6811;164987;157;0;0;0;0;.00nan;0;0
6811;-1;151;94;36;1;35;.972;3607000;0
6811;85507;151;0;0;0;0;.00nan;0;0
6812;173874;158;63;27;3;24;.889;3631000;0
6812;181071;158;0;0;0;0;.00nan;0;0
6812;37942;1095;0;0;0;0;.00nan;0;0
6812;79141;1095;68;39;4;35;.897;3631000;0
6813;3;67;60;36;4;32;.889;3600000;0
6813;5559;4245;66;32;3;29;.906;3600000;0
6813;163195;67;0;0;0;0;.00nan;0;0
6813;149858;4245;0;0;0;0;.00nan;0;0
6814;-1;149;77;42;4;38;.905;3600000;0
6814;85349;82;0;0;0;0;.00nan;0;0
6814;86151;82;86;15;0;15;1.000;3600000;0
6814;141419;149;0;0;0;0;.00nan;0;0
6815;-1;74;0;0;0;0;.00nan;0;0
6815;170728;1097;0;0;0;0;.00nan;0;0
6815;180606;74;100;27;0;27;1.000;3600000;0
6815;43928;1097;52;32;4;28;.875;3600000;0
6816;181446;71;30;10;3;7;.700;504000;0
6816;85132;4921;0;0;0;0;.00nan;0;0
6816;85984;71;50;22;3;19;.864;3091000;0
6816;152418;4921;58;31;4;27;.871;3600000;0
6817;13325;2564;45;21;3;18;.857;3585000;0
6817;165380;72;0;0;0;0;.00nan;0;0
6817;166441;2564;0;0;0;0;.00nan;0;0
6817;85228;72;83;28;2;26;.929;3600000;0
6818;164913;75;68;21;1;20;.952;2522000;0
6818;173856;75;38;20;4;16;.800;1078000;0
6818;181123;4920;0;0;0;0;.00nan;0;0
6818;78479;4920;100;19;0;19;1.000;3600000;0
6819;2410;81;0;0;0;0;.00nan;0;0
6819;178911;152;0;0;0;0;.00nan;0;0
6819;178950;152;74;47;6;41;.872;3600000;0
6819;70213;81;61;19;2;17;.895;3600000;0
6820;-1;4620;66;24;2;22;.917;3900000;0
6820;173961;4620;0;0;0;0;.00nan;0;0
6820;181269;85;0;0;0;0;.00nan;0;0
6820;152624;85;95;43;2;41;.953;3900000;0
6821;163989;80;0;0;0;0;.00nan;0;0
6821;170612;80;59;32;4;28;.875;3600000;0
6821;37942;1095;94;20;0;20;1.000;3600000;0
6821;79141;1095;0;0;0;0;.00nan;0;0
6822;161535;157;44;14;3;11;.786;3542000;0
6822;164987;157;0;0;0;0;.00nan;0;0
6822;-1;151;0;0;0;0;.00nan;0;0
6822;85507;151;90;34;1;33;.971;3600000;0
6823;173874;158;0;0;0;0;.00nan;0;0
6823;180873;69;54;42;5;37;.881;3600000;0
6823;181071;158;86;37;2;35;.946;3600000;0
6823;79211;69;0;0;0;0;.00nan;0;0
6824;-1;149;22;23;6;17;.739;2044000;0
6824;85349;82;0;0;0;0;.00nan;0;0
6824;86151;82;69;25;2;23;.920;3600000;0
6824;141419;149;39;14;3;11;.786;1556000;0
6825;164913;75;0;0;0;0;.00nan;0;0
6825;173856;75;97;52;3;49;.942;3600000;0
6825;181123;4920;100;26;0;26;1.000;3600000;0
6825;78479;4920;0;0;0;0;.00nan;0;0
6826;-1;78;0;0;0;0;.00nan;0;0
6826;169154;78;59;23;3;20;.870;3600000;0
6826;85555;76;70;43;4;39;.907;3543000;0
6826;91703;76;0;0;0;0;.00nan;0;0
6827;-1;74;0;0;0;0;.00nan;0;0
6827;-1;4922;0;0;0;0;.00nan;0;0
6827;180606;74;58;27;3;24;.889;3576000;0
6827;91742;4922;96;33;1;32;.970;3600000;0
6828;-1;4620;0;0;0;0;.00nan;0;0
6828;173961;4620;43;14;3;11;.786;3554000;0
6828;181269;85;90;42;2;40;.952;3600000;0
6828;152624;85;0;0;0;0;.00nan;0;0
6829;163989;80;71;33;3;30;.909;3600000;0
6829;170612;80;0;0;0;0;.00nan;0;0
6829;37942;1095;0;0;0;0;.00nan;0;0
6829;79141;1095;100;32;0;32;1.000;3600000;0
6830;173874;158;71;24;2;22;.917;3900000;0
6830;180873;69;0;0;0;0;.00nan;0;0
6830;181071;158;0;0;0;0;.00nan;0;0
6830;79211;69;92;41;2;39;.951;3900000;0
6831;2410;81;28;22;5;17;.773;3572000;0
6831;178911;152;86;50;4;46;.920;3600000;0
6831;178950;152;0;0;0;0;.00nan;0;0
6831;70213;81;0;0;0;0;.00nan;0;0
6832;163784;77;81;45;4;41;.911;3600000;0
6832;85349;82;0;0;0;0;.00nan;0;0
6832;86151;82;58;15;2;13;.867;3600000;0
6832;161047;77;0;0;0;0;.00nan;0;0
6833;170728;1097;0;0;0;0;.00nan;0;0
6833;-1;4922;65;10;0;10;1.000;924000;0
6833;43928;1097;51;16;3;13;.813;3600000;0
6833;91742;4922;40;34;6;28;.824;2676000;0
6834;161535;157;0;0;0;0;.00nan;0;0
6834;164987;157;57;27;4;23;.852;3600000;0
6834;173874;158;36;11;3;8;.727;908000;0
6834;181071;158;28;34;7;27;.794;2692000;0
6835;164913;75;0;0;0;0;.00nan;0;0
6835;-1;74;39;21;4;17;.810;3600000;0
6835;173856;75;35;28;5;23;.821;3600000;0
6835;180606;74;0;0;0;0;.00nan;0;0
6836;163989;80;59;19;2;17;.895;3600000;0
6836;-1;149;96;54;4;50;.926;3540000;0
6836;170612;80;0;0;0;0;.00nan;0;0
6836;141419;149;0;0;0;0;.00nan;0;0
6837;-1;74;0;0;0;0;.00nan;0;0
6837;180606;74;81;33;2;31;.939;3568000;0
6837;85349;82;0;0;0;0;.00nan;0;0
6837;86151;82;81;24;1;23;.958;3600000;0
6838;180873;69;0;0;0;0;.00nan;0;0
6838;37942;1095;0;0;0;0;.00nan;0;0
6838;79141;1095;80;32;2;30;.938;3900000;0
6838;79211;69;99;39;2;37;.949;3900000;0
6839;170728;1097;37;20;4;16;.800;3556000;0
6839;-1;4922;0;0;0;0;.00nan;0;0
6839;43928;1097;0;0;0;0;.00nan;0;0
6839;91742;4922;89;47;3;44;.936;3600000;0
6840;163784;77;85;45;3;42;.933;3559000;0
6840;-1;1096;91;33;1;32;.970;3600000;0
6840;141978;1096;0;0;0;0;.00nan;0;0
6840;161047;77;0;0;0;0;.00nan;0;0
6841;161535;157;68;32;3;29;.906;3900000;0
6841;164987;157;0;0;0;0;.00nan;0;0
6841;173874;158;87;44;3;41;.932;3900000;0
6841;181071;158;0;0;0;0;.00nan;0;0
6842;13325;2564;0;0;0;0;.00nan;0;0
6842;165380;72;0;0;0;0;.00nan;0;0
6842;166441;2564;64;22;2;20;.909;3600000;0
6842;85228;72;56;41;5;36;.878;3600000;0
6843;2410;81;74;23;1;22;.957;3600000;0
6843;178911;152;63;14;1;13;.929;1599000;0
6843;178950;152;20;20;6;14;.700;2001000;0
6843;70213;81;0;0;0;0;.00nan;0;0
6844;5559;4245;0;0;0;0;.00nan;0;0
6844;85555;76;84;36;2;34;.944;3600000;0
6844;91703;76;0;0;0;0;.00nan;0;0
6844;149858;4245;49;36;5;31;.861;3600000;0
6845;2495;73;0;0;0;0;.00nan;0;0
6845;181269;85;0;0;0;0;.00nan;0;0
6845;149450;73;60;39;5;34;.872;3766000;0
6845;152624;85;50;35;6;29;.829;3766000;0
6846;-1;4620;69;23;2;21;.913;3900000;0
6846;173961;4620;0;0;0;0;.00nan;0;0
6846;181123;4920;97;44;2;42;.955;3900000;0
6846;78479;4920;0;0;0;0;.00nan;0;0
6847;163989;80;0;0;0;0;.00nan;0;0
6847;-1;149;0;0;0;0;.00nan;0;0
6847;170612;80;97;46;3;43;.935;3566000;0
6847;141419;149;66;15;1;14;.933;3600000;0
6848;163195;67;62;8;0;8;1.000;434000;0
6848;-1;78;37;19;4;15;.789;3600000;0
6848;169154;78;0;0;0;0;.00nan;0;0
6848;38124;67;22;40;8;32;.800;3166000;0
6849;180873;69;69;35;3;32;.914;3584000;0
6849;37942;1095;63;23;2;21;.913;3600000;0
6849;79141;1095;0;0;0;0;.00nan;0;0
6849;79211;69;0;0;0;0;.00nan;0;0
6850;170728;1097;70;17;1;16;.941;2687000;0
6850;-1;4922;40;2;1;1;.500;273000;0
6850;43928;1097;22;9;4;5;.556;913000;0
6850;91742;4922;42;37;6;31;.838;3273000;0
6851;163784;77;0;0;0;0;.00nan;0;0
6851;-1;74;78;24;1;23;.958;3600000;0
6851;180606;74;0;0;0;0;.00nan;0;0
6851;161047;77;62;50;5;45;.900;3600000;0
6852;161535;157;0;0;0;0;.00nan;0;0
6852;164987;157;53;16;2;14;.875;3600000;0
6852;173874;158;0;0;0;0;.00nan;0;0
6852;181071;158;95;65;5;60;.923;3600000;0
6853;13325;2564;51;28;4;24;.857;3528000;0
6853;166441;2564;0;0;0;0;.00nan;0;0
6853;181446;71;0;0;0;0;.00nan;0;0
6853;85984;71;78;32;2;30;.938;3600000;0
6854;2410;81;0;0;0;0;.00nan;0;0
6854;178911;152;89;32;1;31;.969;3600000;0
6854;178950;152;0;0;0;0;.00nan;0;0
6854;70213;81;53;28;3;25;.893;3536000;0
6855;5559;4245;69;38;4;34;.895;3600000;0
6855;85555;76;0;0;0;0;.00nan;0;0
6855;91703;76;25;24;6;18;.750;3564000;0
6855;149858;4245;0;0;0;0;.00nan;0;0
6856;164913;75;39;33;6;27;.818;3600000;0
6856;173856;75;0;0;0;0;.00nan;0;0
6856;-1;1096;0;0;0;0;.00nan;0;0
6856;141978;1096;90;27;1;26;.963;3600000;0
6857;2495;73;0;0;0;0;.00nan;0;0
6857;165380;72;70;39;4;35;.897;3600000;0
6857;85228;72;0;0;0;0;.00nan;0;0
6857;149450;73;73;24;1;23;.958;3600000;0
6858;-1;4620;0;0;0;0;.00nan;0;0
6858;173961;4620;56;21;2;19;.905;3600000;0
6858;181123;4920;0;0;0;0;.00nan;0;0
6858;78479;4920;73;38;4;34;.895;3515000;0
6859;181269;85;45;25;4;21;.840;3600000;0
6859;85437;4921;100;31;0;31;1.000;3600000;0
6859;152418;4921;0;0;0;0;.00nan;0;0
6859;152624;85;0;0;0;0;.00nan;0;0
6860;163195;67;0;0;0;0;.00nan;0;0
6860;-1;78;97;39;2;37;.949;3358000;0
6860;169154;78;36;13;3;10;.769;497000;0
6860;38124;67;28;21;5;16;.762;3900000;0
6861;164913;75;0;0;0;0;.00nan;0;0
6861;173856;75;97;49;2;47;.959;3576000;0
6861;85349;82;0;0;0;0;.00nan;0;0
6861;86151;82;82;23;1;22;.957;3600000;0
6862;5559;4245;61;11;0;11;1.000;853000;0
6862;85555;76;86;26;2;24;.923;3600000;0
6862;91703;76;0;0;0;0;.00nan;0;0
6862;149858;4245;43;34;6;28;.824;2747000;0
6863;163784;77;78;29;2;27;.931;3600000;0
6863;-1;1096;74;30;3;27;.900;3570000;0
6863;141978;1096;0;0;0;0;.00nan;0;0
6863;161047;77;0;0;0;0;.00nan;0;0
6864;-1;4620;86;47;3;44;.936;3600000;0
6864;173961;4620;0;0;0;0;.00nan;0;0
6864;181123;4920;29;25;6;19;.760;2400000;0
6864;78479;4920;57;6;0;6;1.000;1200000;0
6865;2410;81;95;23;0;23;1.000;3600000;0
6865;163989;80;53;35;6;29;.829;3004000;0
6865;170612;80;58;6;0;6;1.000;596000;0
6865;70213;81;0;0;0;0;.00nan;0;0
6866;181269;85;0;0;0;0;.00nan;0;0
6866;85437;4921;64;25;3;22;.880;3900000;0
6866;152418;4921;0;0;0;0;.00nan;0;0
6866;152624;85;67;35;3;32;.914;3900000;0
6867;-1;149;63;35;4;31;.886;3584000;0
6867;178911;152;0;0;0;0;.00nan;0;0
6867;178950;152;75;27;2;25;.926;3600000;0
6867;141419;149;0;0;0;0;.00nan;0;0
6868;164913;75;0;0;0;0;.00nan;0;0
6868;173856;75;89;51;4;47;.922;3600000;0
6868;-1;4922;0;0;0;0;.00nan;0;0
6868;91742;4922;70;24;2;22;.917;3600000;0
6869;163195;67;0;0;0;0;.00nan;0;0
6869;-1;78;0;0;0;0;.00nan;0;0
6869;169154;78;74;39;4;35;.897;3600000;0
6869;38124;67;32;33;6;27;.818;3600000;0
6870;13325;2564;50;2;0;2;1.000;417000;0
6870;166441;2564;25;27;6;21;.778;3146000;0
6870;180873;69;0;0;0;0;.00nan;0;0
6870;79211;69;74;42;4;38;.905;3600000;0
6871;181269;85;38;9;2;7;.778;751000;0
6871;85555;76;78;25;1;24;.960;3600000;0
6871;91703;76;0;0;0;0;.00nan;0;0
6871;152624;85;47;26;5;21;.808;2849000;0
6872;-1;151;69;38;3;35;.921;3536000;0
6872;173874;158;70;14;1;13;.929;3600000;0
6872;181071;158;0;0;0;0;.00nan;0;0
6872;85507;151;0;0;0;0;.00nan;0;0
6873;13325;2564;74;22;1;21;.955;3600000;0
6873;166441;2564;0;0;0;0;.00nan;0;0
6873;180873;69;73;44;4;40;.909;3600000;0
6873;79211;69;0;0;0;0;.00nan;0;0
6874;-1;78;0;0;0;0;.00nan;0;0
6874;169154;78;72;28;3;25;.893;3600000;0
6874;181123;4920;78;39;4;35;.897;3586000;0
6874;78479;4920;0;0;0;0;.00nan;0;0
6875;2410;81;88;31;1;30;.968;3900000;0
6875;163989;80;89;34;1;33;.971;3900000;0
6875;170612;80;0;0;0;0;.00nan;0;0
6875;70213;81;0;0;0;0;.00nan;0;0
6876;163195;67;0;0;0;0;.00nan;0;0
6876;38124;67;47;31;5;26;.839;3600000;0
6876;85555;76;76;33;2;31;.939;3600000;0
6876;91703;76;0;0;0;0;.00nan;0;0
6877;-1;149;0;0;0;0;.00nan;0;0
6877;178911;152;71;30;2;28;.933;3600000;0
6877;178950;152;0;0;0;0;.00nan;0;0
6877;141419;149;87;34;1;33;.971;3600000;0
6878;2495;73;0;0;0;0;.00nan;0;0
6878;181446;71;67;30;5;25;.833;3900000;0
6878;85984;71;0;0;0;0;.00nan;0;0
6878;149450;73;58;37;5;32;.865;3900000;0
6879;163784;77;0;0;0;0;.00nan;0;0
6879;170728;1097;0;0;0;0;.00nan;0;0
6879;43928;1097;59;29;4;25;.862;3900000;0
6879;161047;77;49;35;4;31;.886;3900000;0
6880;165380;72;0;0;0;0;.00nan;0;0
6880;37942;1095;0;0;0;0;.00nan;0;0
6880;79141;1095;75;25;2;23;.920;3600000;0
6880;85228;72;61;25;3;22;.880;3558000;0
6881;5559;4245;0;0;0;0;.00nan;0;0
6881;-1;4620;77;30;2;28;.933;3542000;0
6881;173961;4620;0;0;0;0;.00nan;0;0
6881;149858;4245;100;42;1;41;.976;3600000;0
6882;-1;78;44;28;4;24;.857;3752000;0
6882;169154;78;0;0;0;0;.00nan;0;0
6882;181123;4920;0;0;0;0;.00nan;0;0
6882;78479;4920;88;43;3;40;.930;3752000;0
6883;2410;81;0;0;0;0;.00nan;0;0
6883;163989;80;0;0;0;0;.00nan;0;0
6883;170612;80;55;36;5;31;.861;3600000;0
6883;70213;81;86;35;2;33;.943;3600000;0
6884;-1;4922;0;0;0;0;.00nan;0;0
6884;-1;1096;61;37;5;32;.865;3600000;0
6884;91742;4922;65;38;4;34;.895;3600000;0
6884;141978;1096;0;0;0;0;.00nan;0;0
6885;164913;75;85;44;3;41;.932;3600000;0
6885;173856;75;0;0;0;0;.00nan;0;0
6885;85349;82;0;0;0;0;.00nan;0;0
6885;86151;82;8;18;6;12;.667;3600000;0
6886;-1;151;80;27;1;26;.963;2923000;0
6886;173874;158;0;0;0;0;.00nan;0;0
6886;181071;158;52;23;3;20;.870;3600000;0
6886;85507;151;26;11;4;7;.636;670000;0
6887;161535;157;84;30;2;28;.933;3900000;0
6887;164987;157;0;0;0;0;.00nan;0;0
6887;85437;4921;0;0;0;0;.00nan;0;0
6887;152418;4921;75;34;2;32;.941;3900000;0
6888;-1;149;88;50;3;47;.940;3566000;0
6888;178911;152;0;0;0;0;.00nan;0;0
6888;178950;152;79;29;2;27;.931;3600000;0
6888;141419;149;0;0;0;0;.00nan;0;0
6889;170728;1097;100;39;0;39;1.000;3600000;0
6889;43928;1097;0;0;0;0;.00nan;0;0
6889;85349;82;90;33;1;32;.970;3556000;0
6889;86151;82;0;0;0;0;.00nan;0;0
6890;165380;72;0;0;0;0;.00nan;0;0
6890;37942;1095;87;35;2;33;.943;3600000;0
6890;79141;1095;0;0;0;0;.00nan;0;0
6890;85228;72;46;19;3;16;.842;3566000;0
6891;163784;77;80;42;3;39;.929;3600000;0
6891;-1;74;49;1;0;1;1.000;654000;0
6891;180606;74;22;23;6;17;.739;2946000;0
6891;161047;77;0;0;0;0;.00nan;0;0
6892;13325;2564;63;24;2;22;.917;3900000;0
6892;166441;2564;0;0;0;0;.00nan;0;0
6892;180873;69;0;0;0;0;.00nan;0;0
6892;79211;69;100;39;2;37;.949;3900000;0
6893;5559;4245;84;37;2;35;.946;3561000;0
6893;163195;67;99;39;1;38;.974;3600000;0
6893;38124;67;0;0;0;0;.00nan;0;0
6893;149858;4245;0;0;0;0;.00nan;0;0
6894;-1;4922;0;0;0;0;.00nan;0;0
6894;-1;1096;0;0;0;0;.00nan;0;0
6894;91742;4922;35;31;6;25;.806;3600000;0
6894;141978;1096;84;47;3;44;.936;3600000;0
6895;2410;81;61;28;3;25;.893;3711000;0
6895;163989;80;84;33;2;31;.939;3711000;0
6895;170612;80;0;0;0;0;.00nan;0;0
6895;70213;81;0;0;0;0;.00nan;0;0
6896;181269;85;0;0;0;0;.00nan;0;0
6896;85555;76;0;0;0;0;.00nan;0;0
6896;91703;76;100;34;1;33;.971;3600000;0
6896;152624;85;81;36;2;34;.944;3545000;0
6897;2495;73;54;19;2;17;.895;3600000;0
6897;181446;71;0;0;0;0;.00nan;0;0
6897;85984;71;75;32;3;29;.906;3545000;0
6897;149450;73;0;0;0;0;.00nan;0;0
6898;-1;151;0;0;0;0;.00nan;0;0
6898;173874;158;58;16;2;14;.875;3600000;0
6898;181071;158;0;0;0;0;.00nan;0;0
6898;85507;151;56;38;4;34;.895;3524000;0
6899;161535;157;0;0;0;0;.00nan;0;0
6899;164987;157;83;30;2;28;.933;3600000;0
6899;85437;4921;73;34;3;31;.912;3585000;0
6899;152418;4921;0;0;0;0;.00nan;0;0
6900;163195;67;85;16;0;16;1.000;1331000;0
6900;-1;4620;32;17;4;13;.765;901000;0
6900;173961;4620;48;20;3;17;.850;2676000;0
6900;38124;67;38;35;6;29;.829;2269000;0
6901;-1;149;0;0;0;0;.00nan;0;0
6901;178911;152;72;36;3;33;.917;3595000;0
6901;178950;152;0;0;0;0;.00nan;0;0
6901;141419;149;82;31;2;29;.935;3600000;0
6902;170728;1097;100;56;2;54;.964;3900000;0
6902;43928;1097;0;0;0;0;.00nan;0;0
6902;85349;82;0;0;0;0;.00nan;0;0
6902;86151;82;60;16;2;14;.875;3900000;0
6903;163784;77;0;0;0;0;.00nan;0;0
6903;-1;74;55;28;3;25;.893;3600000;0
6903;180606;74;0;0;0;0;.00nan;0;0
6903;161047;77;64;39;4;35;.897;3600000;0
6904;-1;78;98;36;0;36;1.000;2520000;0
6904;169154;78;18;7;4;3;.429;1080000;0
6904;181123;4920;80;50;5;45;.900;3549000;0
6904;78479;4920;0;0;0;0;.00nan;0;0
6905;2495;73;0;0;0;0;.00nan;0;0
6905;181446;71;49;13;2;11;.846;3600000;0
6905;85984;71;0;0;0;0;.00nan;0;0
6905;149450;73;67;38;4;34;.895;3600000;0
6906;161535;157;44;37;6;31;.838;3343000;0
6906;164987;157;45;5;1;4;.800;257000;0
6906;85437;4921;0;0;0;0;.00nan;0;0
6906;152418;4921;87;41;3;38;.927;3600000;0
6907;163784;77;0;0;0;0;.00nan;0;0
6907;85349;82;0;0;0;0;.00nan;0;0
6907;86151;82;61;19;2;17;.895;3900000;0
6907;161047;77;97;48;2;46;.958;3900000;0
6908;181446;71;0;0;0;0;.00nan;0;0
6908;37942;1095;0;0;0;0;.00nan;0;0
6908;79141;1095;71;26;2;24;.923;3516000;0
6908;85984;71;100;28;0;28;1.000;3600000;0
6909;170728;1097;0;0;0;0;.00nan;0;0
6909;-1;4922;59;12;1;11;.917;728000;0
6909;43928;1097;54;37;5;32;.865;3600000;0
6909;91742;4922;35;35;6;29;.829;2838000;0
6910;161535;157;0;0;0;0;.00nan;0;0
6910;164987;157;61;14;1;13;.929;3600000;0
6910;-1;149;29;10;3;7;.700;194000;0
6910;141419;149;91;52;3;49;.942;3406000;0
6911;-1;151;0;0;0;0;.00nan;0;0
6911;180873;69;70;30;3;27;.900;3576000;0
6911;79211;69;0;0;0;0;.00nan;0;0
6911;85507;151;85;38;2;36;.947;3600000;0
6912;164913;75;77;35;2;33;.943;1759000;0
6912;-1;74;0;0;0;0;.00nan;0;0
6912;173856;75;19;21;6;15;.714;1841000;0
6912;180606;74;66;24;2;22;.917;3600000;0
6913;2495;73;0;0;0;0;.00nan;0;0
6913;85437;4921;0;0;0;0;.00nan;0;0
6913;149450;73;86;38;2;36;.947;3600000;0
6913;152418;4921;82;23;1;22;.957;3600000;0
6914;163784;77;0;0;0;0;.00nan;0;0
6914;-1;1096;75;23;1;22;.957;3600000;0
6914;141978;1096;0;0;0;0;.00nan;0;0
6914;161047;77;41;25;5;20;.800;3600000;0
6915;170728;1097;0;0;0;0;.00nan;0;0
6915;43928;1097;92;26;1;25;.962;3600000;0
6915;85349;82;0;0;0;0;.00nan;0;0
6915;86151;82;57;21;3;18;.857;3516000;0
6916;161535;157;69;26;3;23;.885;3562000;0
6916;164987;157;0;0;0;0;.00nan;0;0
6916;-1;149;0;0;0;0;.00nan;0;0
6916;141419;149;97;47;2;45;.957;3600000;0
6917;165380;72;0;0;0;0;.00nan;0;0
6917;85228;72;75;36;3;33;.917;3577000;0
6917;85437;4921;0;0;0;0;.00nan;0;0
6917;152418;4921;61;20;2;18;.900;3600000;0
6918;-1;151;0;0;0;0;.00nan;0;0
6918;180873;69;38;18;4;14;.778;3600000;0
6918;79211;69;0;0;0;0;.00nan;0;0
6918;85507;151;100;50;1;49;.980;3600000;0
6919;163784;77;97;45;2;43;.956;3600000;0
6919;-1;74;81;23;1;22;.957;3600000;0
6919;180606;74;0;0;0;0;.00nan;0;0
6919;161047;77;0;0;0;0;.00nan;0;0
6920;163195;67;78;33;1;32;.970;3900000;0
6920;38124;67;0;0;0;0;.00nan;0;0
6920;85555;76;81;25;1;24;.960;3900000;0
6920;91703;76;0;0;0;0;.00nan;0;0
6921;181123;4920;72;31;3;28;.903;3600000;0
6921;181269;85;0;0;0;0;.00nan;0;0
6921;78479;4920;0;0;0;0;.00nan;0;0
6921;152624;85;29;21;5;16;.762;3556000;0
6922;164913;75;41;26;5;21;.808;970000;0
6922;173856;75;65;30;3;27;.900;2630000;0
6922;-1;1096;0;0;0;0;.00nan;0;0
6922;141978;1096;74;32;3;29;.906;3600000;0
6923;2495;73;0;0;0;0;.00nan;0;0
6923;13325;2564;41;29;5;24;.828;3600000;0
6923;166441;2564;0;0;0;0;.00nan;0;0
6923;149450;73;91;46;2;44;.957;3600000;0
6924;5559;4245;0;0;0;0;.00nan;0;0
6924;-1;4620;64;40;4;36;.900;3549000;0
6924;173961;4620;0;0;0;0;.00nan;0;0
6924;149858;4245;72;29;2;27;.931;3600000;0
6925;163989;80;19;23;6;17;.739;2137000;0
6925;178911;152;30;29;6;23;.793;3600000;0
6925;178950;152;0;0;0;0;.00nan;0;0
6925;170612;80;61;13;1;12;.923;1463000;0
6926;2410;81;90;29;1;28;.966;3600000;0
6926;173874;158;68;40;4;36;.900;3600000;0
6926;181071;158;0;0;0;0;.00nan;0;0
6926;70213;81;0;0;0;0;.00nan;0;0
6927;-1;78;0;0;0;0;.00nan;0;0
6927;169154;78;47;27;4;23;.852;3600000;0
6927;37942;1095;0;0;0;0;.00nan;0;0
6927;79141;1095;84;41;3;38;.927;3600000;0
6928;170728;1097;99;40;1;39;.975;3600000;0
6928;43928;1097;0;0;0;0;.00nan;0;0
6928;85349;82;9;16;6;10;.625;2007000;0
6928;86151;82;52;11;1;10;.909;1593000;0
6929;2495;73;43;36;6;30;.833;3600000;0
6929;181446;71;0;0;0;0;.00nan;0;0
6929;85984;71;77;31;2;29;.935;3600000;0
6929;149450;73;0;0;0;0;.00nan;0;0
6930;161535;157;0;0;0;0;.00nan;0;0
6930;164987;157;81;30;2;28;.933;3600000;0
6930;-1;149;58;45;6;39;.867;3600000;0
6930;141419;149;0;0;0;0;.00nan;0;0
6931;13325;2564;56;4;0;4;1.000;830000;0
6931;165380;72;0;0;0;0;.00nan;0;0
6931;166441;2564;45;43;6;37;.860;2770000;0
6931;85228;72;71;26;2;24;.923;3600000;0
6932;-1;151;91;33;1;32;.970;3600000;0
6932;180873;69;25;6;3;3;.500;470000;0
6932;79211;69;58;35;3;32;.914;3130000;0
6932;85507;151;0;0;0;0;.00nan;0;0
6933;163784;77;0;0;0;0;.00nan;0;0
6933;-1;74;0;0;0;0;.00nan;0;0
6933;180606;74;84;15;0;15;1.000;3600000;0
6933;161047;77;98;54;3;51;.944;3600000;0
6934;181123;4920;0;0;0;0;.00nan;0;0
6934;181269;85;73;34;3;31;.912;3600000;0
6934;78479;4920;58;33;5;28;.848;3556000;0
6934;152624;85;0;0;0;0;.00nan;0;0
6935;-1;4922;0;0;0;0;.00nan;0;0
6935;-1;1096;65;37;4;33;.892;3799000;0
6935;91742;4922;66;35;3;32;.914;3799000;0
6935;141978;1096;0;0;0;0;.00nan;0;0
6936;5559;4245;67;55;7;48;.873;3600000;0
6936;-1;4620;0;0;0;0;.00nan;0;0
6936;173961;4620;62;22;2;20;.909;3600000;0
6936;149858;4245;0;0;0;0;.00nan;0;0
6937;163989;80;0;0;0;0;.00nan;0;0
6937;178911;152;0;0;0;0;.00nan;0;0
6937;178950;152;61;25;3;22;.880;3587000;0
6937;170612;80;75;32;2;30;.938;3600000;0
6938;2410;81;0;0;0;0;.00nan;0;0
6938;173874;158;0;0;0;0;.00nan;0;0
6938;181071;158;51;37;5;32;.865;3600000;0
6938;70213;81;83;15;0;15;1.000;3600000;0
6939;-1;78;65;27;3;24;.889;3600000;0
6939;169154;78;0;0;0;0;.00nan;0;0
6939;37942;1095;58;32;4;28;.875;3600000;0
6939;79141;1095;0;0;0;0;.00nan;0;0
6940;181446;71;52;36;5;31;.861;3900000;0
6940;85437;4921;75;43;5;38;.884;3900000;0
6940;85984;71;0;0;0;0;.00nan;0;0
6940;152418;4921;0;0;0;0;.00nan;0;0
6941;2495;73;0;0;0;0;.00nan;0;0
6941;165380;72;52;32;5;27;.844;3899000;0
6941;85228;72;0;0;0;0;.00nan;0;0
6941;149450;73;62;42;6;36;.857;3899000;0
6942;163195;67;0;0;0;0;.00nan;0;0
6942;38124;67;98;51;3;48;.941;3600000;0
6942;85555;76;100;36;0;36;1.000;3600000;0
6942;91703;76;0;0;0;0;.00nan;0;0
6943;164913;75;0;0;0;0;.00nan;0;0
6943;173856;75;100;38;0;38;1.000;3900000;0
6943;-1;4922;0;0;0;0;.00nan;0;0
6943;91742;4922;95;28;0;28;1.000;3900000;0
6944;2410;81;27;32;6;26;.813;3600000;0
6944;173874;158;81;32;2;30;.938;3600000;0
6944;181071;158;0;0;0;0;.00nan;0;0
6944;70213;81;0;0;0;0;.00nan;0;0
6945;5559;4245;0;0;0;0;.00nan;0;0
6945;-1;78;0;0;0;0;.00nan;0;0
6945;169154;78;100;31;0;31;1.000;3600000;0
6945;149858;4245;84;41;4;37;.902;3600000;0
6946;163195;67;100;51;3;48;.941;3600000;0
6946;181269;85;0;0;0;0;.00nan;0;0
6946;38124;67;0;0;0;0;.00nan;0;0
6946;152624;85;31;28;6;22;.786;3600000;0
6947;163784;77;0;0;0;0;.00nan;0;0
6947;85349;82;0;0;0;0;.00nan;0;0
6947;86151;82;78;21;1;20;.952;3600000;0
6947;161047;77;93;48;3;45;.938;3585000;0
6948;165380;72;0;0;0;0;.00nan;0;0
6948;37942;1095;79;25;1;24;.960;3600000;0
6948;79141;1095;0;0;0;0;.00nan;0;0
6948;85228;72;39;25;5;20;.800;3600000;0
6949;164913;75;0;0;0;0;.00nan;0;0
6949;-1;74;0;0;0;0;.00nan;0;0
6949;173856;75;81;48;4;44;.917;3570000;0
6949;180606;74;60;20;2;18;.900;3600000;0
6950;13325;2564;81;23;1;22;.957;3600000;0
6950;166441;2564;0;0;0;0;.00nan;0;0
6950;180873;69;0;0;0;0;.00nan;0;0
6950;79211;69;98;41;2;39;.951;3564000;0
6951;-1;4620;51;40;6;34;.850;3038000;0
6951;173961;4620;45;3;1;2;.667;562000;0
6951;85555;76;75;23;1;22;.957;3600000;0
6951;91703;76;0;0;0;0;.00nan;0;0
6952;-1;4922;0;0;0;0;.00nan;0;0
6952;-1;1096;0;0;0;0;.00nan;0;0
6952;91742;4922;89;41;2;39;.951;3600000;0
6952;141978;1096;56;41;5;36;.878;3600000;0
6953;161535;157;70;27;3;24;.889;3600000;0
6953;2410;81;0;0;0;0;.00nan;0;0
6953;164987;157;0;0;0;0;.00nan;0;0
6953;70213;81;30;30;6;24;.800;3600000;0
6954;163989;80;87;24;1;23;.958;3600000;0
6954;178911;152;60;27;2;25;.926;3588000;0
6954;178950;152;0;0;0;0;.00nan;0;0
6954;170612;80;0;0;0;0;.00nan;0;0
6955;-1;151;0;0;0;0;.00nan;0;0
6955;181123;4920;66;25;2;23;.920;3585000;0
6955;78479;4920;0;0;0;0;.00nan;0;0
6955;85507;151;96;28;0;28;1.000;3600000;0
6956;2495;73;0;0;0;0;.00nan;0;0
6956;85437;4921;0;0;0;0;.00nan;0;0
6956;149450;73;83;49;4;45;.918;3600000;0
6956;152418;4921;61;17;1;16;.941;3600000;0
6957;-1;149;0;0;0;0;.00nan;0;0
6957;173874;158;31;30;6;24;.800;3032000;0
6957;181071;158;62;8;0;8;1.000;568000;0
6957;141419;149;70;33;3;30;.909;3600000;0
6958;180873;69;75;49;4;45;.918;3537000;0
6958;181446;71;0;0;0;0;.00nan;0;0
6958;79211;69;0;0;0;0;.00nan;0;0
6958;85984;71;57;20;2;18;.900;3600000;0
6959;163195;67;0;0;0;0;.00nan;0;0
6959;-1;78;0;0;0;0;.00nan;0;0
6959;169154;78;70;30;3;27;.900;3600000;0
6959;38124;67;59;35;4;31;.886;3544000;0
6960;-1;1096;61;14;1;13;.929;988000;0
6960;85349;82;0;0;0;0;.00nan;0;0
6960;86151;82;90;19;0;19;1.000;3600000;0
6960;141978;1096;34;30;6;24;.800;2612000;0
6961;37942;1095;79;32;2;30;.938;3600000;0
6961;79141;1095;0;0;0;0;.00nan;0;0
6961;85437;4921;0;0;0;0;.00nan;0;0
6961;152418;4921;49;27;4;23;.852;3569000;0
6962;165380;72;0;0;0;0;.00nan;0;0
6962;181446;71;19;25;6;19;.760;3514000;0
6962;85228;72;49;28;4;24;.857;3600000;0
6962;85984;71;0;0;0;0;.00nan;0;0
6963;-1;74;85;29;1;28;.966;3600000;0
6963;170728;1097;30;38;7;31;.816;3214000;0
6963;180606;74;0;0;0;0;.00nan;0;0
6963;43928;1097;44;3;1;2;.667;386000;0
6964;173874;158;69;23;1;22;.957;3544000;0
6964;178911;152;100;35;0;35;1.000;3600000;0
6964;178950;152;0;0;0;0;.00nan;0;0
6964;181071;158;0;0;0;0;.00nan;0;0
6965;5559;4245;0;0;0;0;.00nan;0;0
6965;181269;85;0;0;0;0;.00nan;0;0
6965;149858;4245;64;35;4;31;.886;3600000;0
6965;152624;85;66;39;5;34;.872;3544000;0
6966;-1;4620;53;18;3;15;.833;3600000;0
6966;173961;4620;0;0;0;0;.00nan;0;0
6966;85555;76;73;41;4;37;.902;3581000;0
6966;91703;76;0;0;0;0;.00nan;0;0
6967;161535;157;69;16;1;15;.938;3600000;0
6967;2410;81;0;0;0;0;.00nan;0;0
6967;164987;157;0;0;0;0;.00nan;0;0
6967;70213;81;97;55;3;52;.945;3591000;0
6968;163784;77;79;23;1;22;.957;3600000;0
6968;164913;75;0;0;0;0;.00nan;0;0
6968;173856;75;45;39;6;33;.846;3600000;0
6968;161047;77;0;0;0;0;.00nan;0;0
6969;2495;73;64;41;5;36;.878;2776000;0
6969;13325;2564;81;25;1;24;.960;3600000;0
6969;166441;2564;0;0;0;0;.00nan;0;0
6969;149450;73;23;14;4;10;.714;824000;0
6970;163989;80;0;0;0;0;.00nan;0;0
6970;-1;149;0;0;0;0;.00nan;0;0
6970;170612;80;59;16;1;15;.938;3600000;0
6970;141419;149;81;40;2;38;.950;3580000;0
6971;-1;151;0;0;0;0;.00nan;0;0
6971;181123;4920;0;0;0;0;.00nan;0;0
6971;78479;4920;87;33;2;31;.939;3600000;0
6971;85507;151;37;23;4;19;.826;3547000;0
6972;163195;67;93;34;1;33;.971;3900000;0
6972;-1;78;92;23;1;22;.957;3900000;0
6972;169154;78;0;0;0;0;.00nan;0;0
6972;38124;67;0;0;0;0;.00nan;0;0
6973;163784;77;43;21;3;18;.857;1102000;0
6973;85349;82;0;0;0;0;.00nan;0;0
6973;86151;82;60;15;1;14;.933;3600000;0
6973;161047;77;44;38;6;32;.842;2498000;0
6974;2495;73;0;0;0;0;.00nan;0;0
6974;181446;71;0;0;0;0;.00nan;0;0
6974;85984;71;77;34;3;31;.912;3600000;0
6974;149450;73;98;55;4;51;.927;3600000;0
6975;-1;74;0;0;0;0;.00nan;0;0
6975;-1;1096;100;43;2;41;.953;3600000;0
6975;180606;74;52;21;3;18;.857;3600000;0
6975;141978;1096;0;0;0;0;.00nan;0;0
6976;13325;2564;88;28;1;27;.964;3600000;0
6976;166441;2564;0;0;0;0;.00nan;0;0
6976;37942;1095;0;0;0;0;.00nan;0;0
6976;79141;1095;37;29;6;23;.793;3600000;0
6977;173874;158;0;0;0;0;.00nan;0;0
6977;178911;152;41;38;6;32;.842;2775000;0
6977;178950;152;55;4;0;4;1.000;825000;0
6977;181071;158;63;26;3;23;.885;3600000;0
6978;5559;4245;74;42;4;38;.905;3600000;0
6978;181269;85;99;39;1;38;.974;3600000;0
6978;149858;4245;0;0;0;0;.00nan;0;0
6978;152624;85;0;0;0;0;.00nan;0;0
6979;-1;4620;0;0;0;0;.00nan;0;0
6979;173961;4620;100;32;0;32;1.000;3600000;0
6979;85555;76;0;0;0;0;.00nan;0;0
6979;91703;76;77;26;1;25;.962;3600000;0
6980;170728;1097;0;0;0;0;.00nan;0;0
6980;-1;4922;0;0;0;0;.00nan;0;0
6980;43928;1097;40;24;5;19;.792;3514000;0
6980;91742;4922;68;40;3;37;.925;3600000;0
6981;161535;157;0;0;0;0;.00nan;0;0
6981;2410;81;53;43;5;38;.884;3533000;0
6981;164987;157;80;38;3;35;.921;3600000;0
6981;70213;81;0;0;0;0;.00nan;0;0
6982;163989;80;48;37;5;32;.865;3856000;0
6982;-1;149;58;36;5;31;.861;3900000;0
6982;170612;80;0;0;0;0;.00nan;0;0
6982;141419;149;0;0;0;0;.00nan;0;0
6983;-1;151;60;39;5;34;.872;3569000;0
6983;181123;4920;61;34;4;30;.882;3600000;0
6983;78479;4920;0;0;0;0;.00nan;0;0
6983;85507;151;0;0;0;0;.00nan;0;0
6984;180873;69;39;9;2;7;.778;1359000;0
6984;79211;69;56;35;4;31;.886;2241000;0
6984;85437;4921;66;21;2;19;.905;3600000;0
6984;152418;4921;0;0;0;0;.00nan;0;0
6985;13325;2564;0;0;0;0;.00nan;0;0
6985;165380;72;0;0;0;0;.00nan;0;0
6985;166441;2564;58;23;3;20;.870;3600000;0
6985;85228;72;85;53;4;49;.925;3547000;0
6986;-1;4922;0;0;0;0;.00nan;0;0
6986;-1;1096;0;0;0;0;.00nan;0;0
6986;91742;4922;100;28;0;28;1.000;3600000;0
6986;141978;1096;67;41;4;37;.902;3600000;0
6987;163989;80;0;0;0;0;.00nan;0;0
6987;173874;158;65;35;4;31;.886;3600000;0
6987;170612;80;86;34;2;32;.941;3600000;0
6987;181071;158;0;0;0;0;.00nan;0;0
6988;180873;69;54;39;5;34;.872;3600000;0
6988;79211;69;0;0;0;0;.00nan;0;0
6988;85437;4921;0;0;0;0;.00nan;0;0
6988;152418;4921;76;22;1;21;.955;3600000;0
6989;163195;67;0;0;0;0;.00nan;0;0
6989;170728;1097;80;28;2;26;.929;3900000;0
6989;38124;67;87;36;2;34;.944;3900000;0
6989;43928;1097;0;0;0;0;.00nan;0;0
6990;161535;157;48;0;0;0;.00nan;253000;0
6990;164987;157;20;20;6;14;.700;3347000;0
6990;181123;4920;100;36;0;36;1.000;3600000;0
6990;78479;4920;0;0;0;0;.00nan;0;0
6991;165380;72;0;0;0;0;.00nan;0;0
6991;85228;72;59;36;4;32;.889;3600000;0
6991;85437;4921;0;0;0;0;.00nan;0;0
6991;152418;4921;99;37;1;36;.973;3600000;0
6992;-1;74;51;30;4;26;.867;3600000;0
6992;-1;4922;0;0;0;0;.00nan;0;0
6992;180606;74;0;0;0;0;.00nan;0;0
6992;91742;4922;59;35;5;30;.857;3592000;0
6993;164913;75;76;27;2;25;.926;1712000;0
6993;-1;4620;0;0;0;0;.00nan;0;0
6993;173856;75;30;25;5;20;.800;1888000;0
6993;173961;4620;70;8;0;8;1.000;3600000;0
6994;163989;80;56;26;4;22;.846;3600000;0
6994;173874;158;37;22;4;18;.818;1117000;0
6994;170612;80;0;0;0;0;.00nan;0;0
6994;181071;158;31;18;4;14;.778;2483000;0
6995;-1;78;0;0;0;0;.00nan;0;0
6995;169154;78;89;29;2;27;.931;3550000;0
6995;178911;152;72;22;1;21;.955;3600000;0
6995;178950;152;0;0;0;0;.00nan;0;0
6996;-1;4620;0;0;0;0;.00nan;0;0
6996;173961;4620;42;20;4;16;.800;3600000;0
6996;-1;1096;74;31;2;29;.935;3600000;0
6996;141978;1096;0;0;0;0;.00nan;0;0
6997;163195;67;0;0;0;0;.00nan;0;0
6997;170728;1097;70;29;3;26;.897;3538000;0
6997;38124;67;75;27;1;26;.963;3600000;0
6997;43928;1097;0;0;0;0;.00nan;0;0
6998;-1;151;0;0;0;0;.00nan;0;0
6998;-1;149;0;0;0;0;.00nan;0;0
6998;85507;151;100;42;1;41;.976;3600000;0
6998;141419;149;65;26;2;24;.923;3557000;0
6999;180873;69;61;5;0;5;1.000;534000;0
6999;37942;1095;70;28;2;26;.929;3600000;0
6999;79141;1095;0;0;0;0;.00nan;0;0
6999;79211;69;47;37;6;31;.838;3066000;0
7000;165380;72;0;0;0;0;.00nan;0;0
7000;181446;71;0;0;0;0;.00nan;0;0
7000;85228;72;84;33;2;31;.939;3600000;0
7000;85984;71;62;36;4;32;.889;3588000;0
7001;163784;77;0;0;0;0;.00nan;0;0
7001;85349;82;0;0;0;0;.00nan;0;0
7001;86151;82;67;39;4;35;.897;3600000;0
7001;161047;77;54;45;6;39;.867;3574000;0
7002;161535;157;100;17;0;17;1.000;3600000;0
7002;164987;157;0;0;0;0;.00nan;0;0
7002;181123;4920;81;38;3;35;.921;3600000;0
7002;78479;4920;0;0;0;0;.00nan;0;0
7003;5559;4245;0;0;0;0;.00nan;0;0
7003;178911;152;62;42;5;37;.881;3600000;0
7003;178950;152;0;0;0;0;.00nan;0;0
7003;149858;4245;74;27;2;25;.926;3600000;0
7004;-1;74;0;0;0;0;.00nan;0;0
7004;-1;4922;0;0;0;0;.00nan;0;0
7004;180606;74;100;31;0;31;1.000;3600000;0
7004;91742;4922;98;38;1;37;.974;3549000;0
7005;13325;2564;78;35;3;32;.914;3600000;0
7005;166441;2564;0;0;0;0;.00nan;0;0
7005;181269;85;66;13;1;12;.923;1334000;0
7005;152624;85;44;21;4;17;.810;2195000;0
7006;164913;75;53;9;1;8;.889;1286000;0
7006;173856;75;42;35;6;29;.829;2314000;0
7006;-1;1096;0;0;0;0;.00nan;0;0
7006;141978;1096;33;10;3;7;.700;3600000;0
7007;2495;73;0;0;0;0;.00nan;0;0
7007;85437;4921;53;3;0;3;1.000;273000;0
7007;149450;73;67;40;4;36;.900;3600000;0
7007;152418;4921;18;31;7;24;.774;3327000;0
7008;-1;78;0;0;0;0;.00nan;0;0
7008;169154;78;100;31;0;31;1.000;3600000;0
7008;85555;76;32;15;4;11;.733;1119000;0
7008;91703;76;59;29;3;26;.897;2481000;0
7009;163195;67;86;26;1;25;.962;3900000;0
7009;170728;1097;0;0;0;0;.00nan;0;0
7009;38124;67;0;0;0;0;.00nan;0;0
7009;43928;1097;97;32;1;31;.969;3900000;0
7010;-1;149;100;24;0;24;1.000;3600000;0
7010;173874;158;35;29;6;23;.793;3211000;0
7010;181071;158;43;3;1;2;.667;389000;0
7010;141419;149;0;0;0;0;.00nan;0;0
7011;-1;1096;74;22;1;21;.955;3600000;0
7011;85349;82;75;22;2;20;.909;3558000;0
7011;86151;82;0;0;0;0;.00nan;0;0
7011;141978;1096;0;0;0;0;.00nan;0;0
7012;181446;71;68;37;3;34;.919;3546000;0
7012;37942;1095;0;0;0;0;.00nan;0;0
7012;79141;1095;76;33;2;31;.939;3600000;0
7012;85984;71;0;0;0;0;.00nan;0;0
7013;163784;77;80;27;1;26;.963;3900000;0
7013;164913;75;0;0;0;0;.00nan;0;0
7013;173856;75;100;52;1;51;.981;3900000;0
7013;161047;77;0;0;0;0;.00nan;0;0
7014;161535;157;67;21;1;20;.952;3600000;0
7014;164987;157;0;0;0;0;.00nan;0;0
7014;181123;4920;0;0;0;0;.00nan;0;0
7014;78479;4920;43;33;5;28;.848;3600000;0
7015;165380;72;0;0;0;0;.00nan;0;0
7015;85228;72;99;46;1;45;.978;3600000;0
7015;85437;4921;77;28;2;26;.929;3568000;0
7015;152418;4921;0;0;0;0;.00nan;0;0
7016;-1;74;0;0;0;0;.00nan;0;0
7016;-1;4620;81;29;2;27;.931;3866000;0
7016;173961;4620;0;0;0;0;.00nan;0;0
7016;180606;74;92;40;3;37;.925;3866000;0
7017;5559;4245;23;25;6;19;.760;2968000;0
7017;178911;152;0;0;0;0;.00nan;0;0
7017;178950;152;66;40;4;36;.900;3600000;0
7017;149858;4245;60;8;0;8;1.000;558000;0
7018;13325;2564;21;3;3;0;.000;511000;0
7018;166441;2564;45;27;4;23;.852;3089000;0
7018;181269;85;76;30;2;28;.933;3600000;0
7018;152624;85;0;0;0;0;.00nan;0;0
7019;2495;73;0;0;0;0;.00nan;0;0
7019;180873;69;70;43;4;39;.907;3522000;0
7019;79211;69;0;0;0;0;.00nan;0;0
7019;149450;73;73;27;2;25;.926;3600000;0
7020;163989;80;83;29;2;27;.931;3600000;0
7020;-1;151;16;34;8;26;.765;2577000;0
7020;170612;80;0;0;0;0;.00nan;0;0
7020;85507;151;48;8;1;7;.875;1023000;0
7021;-1;78;0;0;0;0;.00nan;0;0
7021;169154;78;98;39;1;38;.974;3600000;0
7021;85555;76;89;37;3;34;.919;3567000;0
7021;91703;76;0;0;0;0;.00nan;0;0
7022;-1;4922;0;0;0;0;.00nan;0;0
7022;85349;82;0;0;0;0;.00nan;0;0
7022;86151;82;68;16;1;15;.938;3600000;0
7022;91742;4922;84;39;2;37;.949;3571000;0
7023;165380;72;0;0;0;0;.00nan;0;0
7023;181446;71;0;0;0;0;.00nan;0;0
7023;85228;72;95;43;2;41;.953;3642000;0
7023;85984;71;94;52;3;49;.942;3642000;0
7024;164913;75;85;61;6;55;.902;3600000;0
7024;-1;4620;0;0;0;0;.00nan;0;0
7024;173856;75;0;0;0;0;.00nan;0;0
7024;173961;4620;54;18;3;15;.833;3600000;0
7025;2495;73;0;0;0;0;.00nan;0;0
7025;180873;69;0;0;0;0;.00nan;0;0
7025;79211;69;68;41;5;36;.878;3600000;0
7025;149450;73;54;24;3;21;.875;3600000;0
7026;163989;80;0;0;0;0;.00nan;0;0
7026;-1;151;0;0;0;0;.00nan;0;0
7026;170612;80;71;24;2;22;.917;3600000;0
7026;85507;151;49;29;4;25;.862;3592000;0
7027;13325;2564;24;13;4;9;.692;1048000;0
7027;166441;2564;38;16;4;12;.750;2552000;0
7027;85437;4921;0;0;0;0;.00nan;0;0
7027;152418;4921;79;33;3;30;.909;3600000;0
7028;2410;81;0;0;0;0;.00nan;0;0
7028;173874;158;49;2;0;2;1.000;280000;0
7028;181071;158;55;34;5;29;.853;3289000;0
7028;70213;81;71;35;3;32;.914;3600000;0
7029;-1;74;0;0;0;0;.00nan;0;0
7029;-1;1096;0;0;0;0;.00nan;0;0
7029;180606;74;57;22;3;19;.864;3900000;0
7029;141978;1096;75;35;3;32;.914;3900000;0
7030;163195;67;39;23;4;19;.826;3600000;0
7030;181269;85;93;29;1;28;.966;3600000;0
7030;38124;67;0;0;0;0;.00nan;0;0
7030;152624;85;0;0;0;0;.00nan;0;0
7031;164913;75;53;8;1;7;.875;436000;0
7031;173856;75;50;44;6;38;.864;3164000;0
7031;170728;1097;61;14;1;13;.929;3600000;0
7031;43928;1097;0;0;0;0;.00nan;0;0
7032;163784;77;65;48;5;43;.896;3600000;0
7032;37942;1095;68;22;2;20;.909;3600000;0
7032;79141;1095;0;0;0;0;.00nan;0;0
7032;161047;77;0;0;0;0;.00nan;0;0
7033;161535;157;65;23;2;21;.913;3600000;0
7033;164987;157;0;0;0;0;.00nan;0;0
7033;178911;152;22;22;6;16;.727;1940000;0
7033;178950;152;73;15;0;15;1.000;1660000;0
7034;2495;73;0;0;0;0;.00nan;0;0
7034;13325;2564;57;27;3;24;.889;3761000;0
7034;166441;2564;0;0;0;0;.00nan;0;0
7034;149450;73;65;35;4;31;.886;3761000;0
7035;5559;4245;0;0;0;0;.00nan;0;0
7035;-1;4620;86;44;4;40;.909;3900000;0
7035;173961;4620;0;0;0;0;.00nan;0;0
7035;149858;4245;72;37;4;33;.892;3900000;0
7036;-1;151;0;0;0;0;.00nan;0;0
7036;-1;149;58;23;3;20;.870;3579000;0
7036;85507;151;64;23;2;21;.913;3600000;0
7036;141419;149;0;0;0;0;.00nan;0;0
7037;2410;81;50;35;5;30;.857;3600000;0
7037;173874;158;44;35;6;29;.829;3577000;0
7037;181071;158;0;0;0;0;.00nan;0;0
7037;70213;81;0;0;0;0;.00nan;0;0
7038;164913;75;0;0;0;0;.00nan;0;0
7038;173856;75;73;38;3;35;.921;3600000;0
7038;170728;1097;81;18;1;17;.944;3600000;0
7038;43928;1097;0;0;0;0;.00nan;0;0
7039;163989;80;71;28;2;26;.929;3600000;0
7039;170612;80;0;0;0;0;.00nan;0;0
7039;181446;71;0;0;0;0;.00nan;0;0
7039;85984;71;74;37;4;33;.892;3593000;0
7040;165380;72;0;0;0;0;.00nan;0;0
7040;85228;72;63;24;2;22;.917;3600000;0
7040;85437;4921;32;10;3;7;.700;476000;0
7040;152418;4921;74;21;0;21;1.000;3069000;0
7041;13325;2564;44;31;5;26;.839;3600000;0
7041;166441;2564;0;0;0;0;.00nan;0;0
7041;180873;69;45;5;1;4;.800;291000;0
7041;79211;69;26;32;6;26;.813;3236000;0
7042;161535;157;48;15;3;12;.800;3600000;0
7042;164987;157;0;0;0;0;.00nan;0;0
7042;178911;152;0;0;0;0;.00nan;0;0
7042;178950;152;62;37;4;33;.892;3546000;0
7043;5559;4245;62;26;3;23;.885;3556000;0
7043;181123;4920;73;29;2;27;.931;3600000;0
7043;78479;4920;0;0;0;0;.00nan;0;0
7043;149858;4245;0;0;0;0;.00nan;0;0
7044;-1;74;0;0;0;0;.00nan;0;0
7044;180606;74;56;24;3;21;.875;3583000;0
7044;85555;76;87;32;1;31;.969;3600000;0
7044;91703;76;0;0;0;0;.00nan;0;0
7045;163784;77;42;45;7;38;.844;3735000;0
7045;-1;4922;51;7;1;6;.857;641000;0
7045;91742;4922;48;30;5;25;.833;3138000;0
7045;161047;77;0;0;0;0;.00nan;0;0
7046;2410;81;0;0;0;0;.00nan;0;0
7046;173874;158;0;0;0;0;.00nan;0;0
7046;181071;158;78;32;2;30;.938;3586000;0
7046;70213;81;81;24;1;23;.958;3600000;0
7047;-1;4620;0;0;0;0;.00nan;0;0
7047;173961;4620;49;19;3;16;.842;3600000;0
7047;181269;85;0;0;0;0;.00nan;0;0
7047;152624;85;70;39;5;34;.872;3600000;0
7048;-1;1096;65;31;3;28;.903;3557000;0
7048;85349;82;0;0;0;0;.00nan;0;0
7048;86151;82;74;29;2;27;.931;3600000;0
7048;141978;1096;0;0;0;0;.00nan;0;0
7049;2495;73;0;0;0;0;.00nan;0;0
7049;37942;1095;0;0;0;0;.00nan;0;0
7049;79141;1095;36;30;5;25;.833;3600000;0
7049;149450;73;75;25;1;24;.960;3600000;0
7050;-1;151;0;0;0;0;.00nan;0;0
7050;-1;149;0;0;0;0;.00nan;0;0
7050;85507;151;74;43;3;40;.930;3553000;0
7050;141419;149;76;30;2;28;.933;3600000;0
7051;163195;67;82;34;3;31;.912;3900000;0
7051;-1;78;0;0;0;0;.00nan;0;0
7051;169154;78;78;34;3;31;.912;3869000;0
7051;38124;67;0;0;0;0;.00nan;0;0
7052;2495;73;78;28;1;27;.964;3600000;0
7052;37942;1095;49;35;5;30;.857;3600000;0
7052;57657;73;0;0;0;0;.00nan;0;0
7052;79141;1095;0;0;0;0;.00nan;0;0
7053;164913;75;77;41;4;37;.902;3566000;0
7053;173856;75;0;0;0;0;.00nan;0;0
7053;170728;1097;0;0;0;0;.00nan;0;0
7053;43928;1097;46;15;3;12;.800;3600000;0
7054;165380;72;0;0;0;0;.00nan;0;0
7054;181446;71;100;26;0;26;1.000;3600000;0
7054;85228;72;87;42;3;39;.929;3600000;0
7054;85984;71;0;0;0;0;.00nan;0;0
7055;13325;2564;0;0;0;0;.00nan;0;0
7055;166441;2564;61;53;6;47;.887;3600000;0
7055;180873;69;0;0;0;0;.00nan;0;0
7055;79211;69;90;34;2;32;.941;3600000;0
7056;161535;157;0;0;0;0;.00nan;0;0
7056;164987;157;49;24;4;20;.833;3600000;0
7056;178911;152;54;39;5;34;.872;3547000;0
7056;178950;152;0;0;0;0;.00nan;0;0
7057;5559;4245;0;0;0;0;.00nan;0;0
7057;181123;4920;0;0;0;0;.00nan;0;0
7057;149450;4920;80;37;3;34;.919;3520000;0
7057;149858;4245;76;24;1;23;.958;3600000;0
7058;-1;74;78;30;2;28;.933;3600000;0
7058;180606;74;0;0;0;0;.00nan;0;0
7058;85555;76;0;0;0;0;.00nan;0;0
7058;91703;76;76;35;3;32;.914;3600000;0
7059;-1;4922;0;0;0;0;.00nan;0;0
7059;85349;82;39;27;5;22;.815;3600000;0
7059;86151;82;0;0;0;0;.00nan;0;0
7059;91742;4922;77;22;1;21;.955;3600000;0
7060;2410;81;90;17;0;17;1.000;3600000;0
7060;173874;158;72;38;3;35;.921;3600000;0
7060;181071;158;0;0;0;0;.00nan;0;0
7060;70213;81;0;0;0;0;.00nan;0;0
7061;-1;4620;70;31;3;28;.903;3802000;0
7061;173961;4620;0;0;0;0;.00nan;0;0
7061;181269;85;72;43;4;39;.907;3802000;0
7061;152624;85;0;0;0;0;.00nan;0;0
7062;163784;77;77;31;2;29;.935;3600000;0
7062;-1;1096;50;22;3;19;.864;3551000;0
7062;141978;1096;0;0;0;0;.00nan;0;0
7062;161047;77;0;0;0;0;.00nan;0;0
7063;-1;151;62;37;4;33;.892;3555000;0
7063;-1;149;85;29;2;27;.931;3600000;0
7063;85507;151;0;0;0;0;.00nan;0;0
7063;141419;149;0;0;0;0;.00nan;0;0
7064;163989;80;0;0;0;0;.00nan;0;0
7064;170612;80;87;30;1;29;.967;3600000;0
7064;85437;4921;20;22;6;16;.727;2744000;0
7064;152418;4921;46;6;1;5;.833;856000;0
7065;163195;67;38;27;6;21;.778;2888000;0
7065;-1;78;62;23;3;20;.870;3600000;0
7065;169154;78;0;0;0;0;.00nan;0;0
7065;38124;67;62;7;0;7;1.000;712000;0
7066;180873;69;0;0;0;0;.00nan;0;0
7066;181446;71;0;0;0;0;.00nan;0;0
7066;79211;69;53;23;3;20;.870;3552000;0
7066;85984;71;88;33;2;31;.939;3600000;0
7067;163784;77;46;27;4;23;.852;3600000;0
7067;-1;1096;0;0;0;0;.00nan;0;0
7067;141978;1096;93;31;1;30;.968;3600000;0
7067;161047;77;0;0;0;0;.00nan;0;0
7068;13325;2564;67;51;6;45;.882;3600000;0
7068;166441;2564;0;0;0;0;.00nan;0;0
7068;37942;1095;0;0;0;0;.00nan;0;0
7068;79141;1095;100;31;0;31;1.000;3600000;0
7069;5559;4245;85;36;2;34;.944;3600000;0
7069;181123;4920;0;0;0;0;.00nan;0;0
7069;149450;4920;53;26;4;22;.846;3600000;0
7069;149858;4245;0;0;0;0;.00nan;0;0
7070;-1;4922;99;42;1;41;.976;3600000;0
7070;85349;82;0;0;0;0;.00nan;0;0
7070;86151;82;72;29;3;26;.897;3521000;0
7070;91742;4922;0;0;0;0;.00nan;0;0
7071;163989;80;51;38;6;32;.842;2935000;0
7071;170612;80;68;11;1;10;.909;714000;0
7071;85437;4921;24;26;6;20;.769;3306000;0
7071;152418;4921;50;0;0;0;.00nan;343000;0
7072;163195;67;67;37;3;34;.919;3600000;0
7072;181123;4920;0;0;0;0;.00nan;0;0
7072;38124;67;0;0;0;0;.00nan;0;0
7072;149450;4920;66;36;5;31;.861;3547000;0
7073;-1;151;0;0;0;0;.00nan;0;0
7073;37942;1095;0;0;0;0;.00nan;0;0
7073;79141;1095;80;33;3;30;.909;3777000;0
7073;85507;151;71;44;4;40;.909;3777000;0
7074;163784;77;57;31;4;27;.871;3600000;0
7074;85349;82;0;0;0;0;.00nan;0;0
7074;86151;82;73;20;1;19;.950;3600000;0
7074;161047;77;0;0;0;0;.00nan;0;0
7075;161535;157;38;25;5;20;.800;3546000;0
7075;2410;81;73;42;4;38;.905;3600000;0
7075;164987;157;0;0;0;0;.00nan;0;0
7075;70213;81;0;0;0;0;.00nan;0;0
7076;-1;149;0;0;0;0;.00nan;0;0
7076;178911;152;0;0;0;0;.00nan;0;0
7076;178950;152;63;30;3;27;.900;3600000;0
7076;141419;149;65;45;5;40;.889;3511000;0
7077;-1;4620;95;39;3;36;.923;3600000;0
7077;173961;4620;0;0;0;0;.00nan;0;0
7077;85555;76;90;61;4;57;.934;3560000;0
7077;91703;76;0;0;0;0;.00nan;0;0
7078;-1;74;0;0;0;0;.00nan;0;0
7078;-1;1096;66;39;5;34;.872;3614000;0
7078;180606;74;68;34;4;30;.882;3614000;0
7078;141978;1096;0;0;0;0;.00nan;0;0
7079;163195;67;69;31;3;28;.903;3900000;0
7079;181123;4920;0;0;0;0;.00nan;0;0
7079;38124;67;0;0;0;0;.00nan;0;0
7079;149450;4920;71;37;3;34;.919;3900000;0
7080;-1;74;67;29;2;27;.931;3600000;0
7080;180606;74;0;0;0;0;.00nan;0;0
7080;85349;82;0;0;0;0;.00nan;0;0
7080;86151;82;73;22;1;21;.955;3600000;0
7081;13325;2564;50;28;4;24;.857;3563000;0
7081;166441;2564;0;0;0;0;.00nan;0;0
7081;37942;1095;0;0;0;0;.00nan;0;0
7081;79141;1095;79;35;3;32;.914;3600000;0
7082;-1;151;0;0;0;0;.00nan;0;0
7082;181446;71;0;0;0;0;.00nan;0;0
7082;85507;151;94;55;4;51;.927;3670000;0
7082;85984;71;48;20;3;17;.850;3670000;0
7083;161535;157;63;32;3;29;.906;3600000;0
7083;2410;81;100;37;0;37;1.000;3600000;0
7083;164987;157;0;0;0;0;.00nan;0;0
7083;70213;81;0;0;0;0;.00nan;0;0
7084;2495;73;0;0;0;0;.00nan;0;0
7084;180873;69;0;0;0;0;.00nan;0;0
7084;57657;73;59;26;3;23;.885;3600000;0
7084;79211;69;59;31;4;27;.871;3570000;0
7085;-1;149;59;22;2;20;.909;3600000;0
7085;178911;152;78;23;1;22;.957;3600000;0
7085;178950;152;0;0;0;0;.00nan;0;0
7085;141419;149;0;0;0;0;.00nan;0;0
7086;170728;1097;0;0;0;0;.00nan;0;0
7086;-1;4922;0;0;0;0;.00nan;0;0
7086;43928;1097;78;29;2;27;.931;3900000;0
7086;91742;4922;95;56;2;54;.964;3900000;0
7087;-1;78;0;0;0;0;.00nan;0;0
7087;169154;78;67;30;3;27;.900;3610000;0
7087;181269;85;0;0;0;0;.00nan;0;0
7087;152624;85;80;43;4;39;.907;3645000;0
7088;163784;77;64;38;4;34;.895;3600000;0
7088;164913;75;0;0;0;0;.00nan;0;0
7088;173856;75;52;41;6;35;.854;3560000;0
7088;161047;77;0;0;0;0;.00nan;0;0
7089;-1;4620;0;0;0;0;.00nan;0;0
7089;173961;4620;49;20;3;17;.850;3703000;0
7089;85555;76;61;38;4;34;.895;3703000;0
7089;91703;76;0;0;0;0;.00nan;0;0
7090;165380;72;11;13;6;7;.538;895000;0
7090;85228;72;21;21;6;15;.714;2705000;0
7090;85437;4921;76;35;3;32;.914;3600000;0
7090;152418;4921;0;0;0;0;.00nan;0;0
7091;163195;67;42;3;1;2;.667;348000;0
7091;-1;78;0;0;0;0;.00nan;0;0
7091;169154;78;62;28;3;25;.893;3600000;0
7091;38124;67;56;42;6;36;.857;3252000;0
7092;163784;77;0;0;0;0;.00nan;0;0
7092;85349;82;52;15;2;13;.867;3600000;0
7092;86151;82;0;0;0;0;.00nan;0;0
7092;161047;77;64;48;6;42;.875;3600000;0
7093;170728;1097;55;14;2;12;.857;3600000;0
7093;-1;4922;0;0;0;0;.00nan;0;0
7093;43928;1097;0;0;0;0;.00nan;0;0
7093;91742;4922;65;56;7;49;.875;3600000;0
7094;-1;151;45;38;6;32;.842;2528000;0
7094;181446;71;35;16;4;12;.750;3600000;0
7094;85507;151;69;13;0;13;1.000;1029000;0
7094;85984;71;0;0;0;0;.00nan;0;0
7095;161535;157;0;0;0;0;.00nan;0;0
7095;2410;81;94;33;1;32;.970;3600000;0
7095;164987;157;59;21;2;19;.905;3568000;0
7095;70213;81;0;0;0;0;.00nan;0;0
7096;13325;2564;0;0;0;0;.00nan;0;0
7096;165380;72;77;29;2;27;.931;3886000;0
7096;166441;2564;69;29;3;26;.897;3886000;0
7096;85228;72;0;0;0;0;.00nan;0;0
7097;2495;73;0;0;0;0;.00nan;0;0
7097;180873;69;39;34;6;28;.824;3600000;0
7097;57657;73;77;28;1;27;.964;3600000;0
7097;79211;69;0;0;0;0;.00nan;0;0
7098;-1;74;0;0;0;0;.00nan;0;0
7098;-1;1096;65;34;4;30;.882;3538000;0
7098;180606;74;95;36;2;34;.944;3600000;0
7098;141978;1096;0;0;0;0;.00nan;0;0
7099;-1;149;0;0;0;0;.00nan;0;0
7099;178911;152;0;0;0;0;.00nan;0;0
7099;178950;152;75;28;2;26;.929;3600000;0
7099;141419;149;61;31;4;27;.871;3600000;0
7100;5559;4245;0;0;0;0;.00nan;0;0
7100;181123;4920;47;12;2;10;.833;1493000;0
7100;149450;4920;11;22;7;15;.682;2107000;0
7100;149858;4245;82;31;2;29;.935;3600000;0
7101;-1;4620;70;21;2;19;.905;3600000;0
7101;173961;4620;0;0;0;0;.00nan;0;0
7101;85555;76;0;0;0;0;.00nan;0;0
7101;91703;76;47;41;6;35;.854;3600000;0
7102;37942;1095;81;41;4;37;.902;3720000;0
7102;79141;1095;0;0;0;0;.00nan;0;0
7102;85437;4921;56;38;5;33;.868;3720000;0
7102;152418;4921;0;0;0;0;.00nan;0;0
7103;-1;151;66;33;2;31;.939;2437000;0
7103;181446;71;0;0;0;0;.00nan;0;0
7103;85507;151;27;18;5;13;.722;1163000;0
7103;85984;71;52;17;2;15;.882;3600000;0
7104;2495;73;0;0;0;0;.00nan;0;0
7104;180873;69;0;0;0;0;.00nan;0;0
7104;57657;73;60;22;2;20;.909;3600000;0
7104;79211;69;48;49;7;42;.857;3600000;0
7105;5559;4245;69;24;1;23;.958;3600000;0
7105;163195;67;69;40;4;36;.900;3600000;0
7105;38124;67;0;0;0;0;.00nan;0;0
7105;149858;4245;0;0;0;0;.00nan;0;0
7106;163784;77;54;44;6;38;.864;3600000;0
7106;-1;1096;0;0;0;0;.00nan;0;0
7106;141978;1096;76;18;1;17;.944;3600000;0
7106;161047;77;0;0;0;0;.00nan;0;0
7107;163989;80;76;31;2;29;.935;3806000;0
7107;173874;158;61;26;3;23;.885;3806000;0
7107;170612;80;0;0;0;0;.00nan;0;0
7107;181071;158;0;0;0;0;.00nan;0;0
7108;2410;81;79;22;1;21;.955;3600000;0
7108;-1;149;0;0;0;0;.00nan;0;0
7108;70213;81;0;0;0;0;.00nan;0;0
7108;141419;149;61;35;4;31;.886;3600000;0
7109;163784;77;0;0;0;0;.00nan;0;0
7109;85349;82;0;0;0;0;.00nan;0;0
7109;86151;82;87;23;1;22;.957;3836000;0
7109;161047;77;89;46;2;44;.957;3836000;0
7110;-1;74;0;0;0;0;.00nan;0;0
7110;170728;1097;0;0;0;0;.00nan;0;0
7110;180606;74;65;29;4;25;.862;3568000;0
7110;43928;1097;77;30;3;27;.900;3600000;0
7111;163989;80;55;28;4;24;.857;3567000;0
7111;178911;152;63;22;2;20;.909;3600000;0
7111;178950;152;0;0;0;0;.00nan;0;0
7111;170612;80;0;0;0;0;.00nan;0;0
7112;181269;85;59;19;2;17;.895;1845000;0
7112;85555;76;82;31;3;28;.903;3600000;0
7112;91703;76;0;0;0;0;.00nan;0;0
7112;152624;85;33;26;6;20;.769;1755000;0
7113;163195;67;78;41;4;37;.902;3563000;0
7113;-1;4620;0;0;0;0;.00nan;0;0
7113;173961;4620;59;26;3;23;.885;3600000;0
7113;38124;67;0;0;0;0;.00nan;0;0
7114;180873;69;0;0;0;0;.00nan;0;0
7114;181446;71;0;0;0;0;.00nan;0;0
7114;79211;69;70;38;3;35;.921;3900000;0
7114;85984;71;82;32;3;29;.906;3900000;0
7115;-1;4922;0;0;0;0;.00nan;0;0
7115;-1;1096;92;32;1;31;.969;3826000;0
7115;91742;4922;94;40;2;38;.950;3826000;0
7115;141978;1096;0;0;0;0;.00nan;0;0
7116;5559;4245;0;0;0;0;.00nan;0;0
7116;163195;67;96;46;4;42;.913;3538000;0
7116;38124;67;0;0;0;0;.00nan;0;0
7116;149858;4245;80;27;2;25;.926;3600000;0
7117;2410;81;68;31;3;28;.903;3600000;0
7117;-1;149;59;43;5;38;.884;3539000;0
7117;70213;81;0;0;0;0;.00nan;0;0
7117;141419;149;0;0;0;0;.00nan;0;0
7118;37942;1095;0;0;0;0;.00nan;0;0
7118;79141;1095;40;26;4;22;.846;3540000;0
7118;85437;4921;63;22;2;20;.909;3600000;0
7118;152418;4921;0;0;0;0;.00nan;0;0
7119;163784;77;84;41;2;39;.951;3800000;0
7119;-1;4922;66;29;3;26;.897;3800000;0
7119;91742;4922;0;0;0;0;.00nan;0;0
7119;161047;77;0;0;0;0;.00nan;0;0
7120;161535;157;83;23;2;21;.913;3600000;0
7120;164987;157;0;0;0;0;.00nan;0;0
7120;-1;151;0;0;0;0;.00nan;0;0
7120;85507;151;94;31;1;30;.968;3600000;0
7121;180873;69;77;35;2;33;.943;3600000;0
7121;181446;71;49;22;3;19;.864;3558000;0
7121;79211;69;0;0;0;0;.00nan;0;0
7121;85984;71;0;0;0;0;.00nan;0;0
7122;164913;75;0;0;0;0;.00nan;0;0
7122;-1;74;0;0;0;0;.00nan;0;0
7122;173856;75;78;48;5;43;.896;3558000;0
7122;180606;74;63;29;4;25;.862;3600000;0
7123;13325;2564;82;14;0;14;1.000;3600000;0
7123;165380;72;0;0;0;0;.00nan;0;0
7123;166441;2564;0;0;0;0;.00nan;0;0
7123;85228;72;78;45;4;41;.911;3600000;0
7124;181269;85;36;34;6;28;.824;3600000;0
7124;85555;76;95;22;0;22;1.000;3600000;0
7124;91703;76;0;0;0;0;.00nan;0;0
7124;152624;85;0;0;0;0;.00nan;0;0
7125;170728;1097;32;28;6;22;.786;3600000;0
7125;-1;1096;77;35;3;32;.914;3600000;0
7125;43928;1097;0;0;0;0;.00nan;0;0
7125;141978;1096;0;0;0;0;.00nan;0;0
7126;163989;80;0;0;0;0;.00nan;0;0
7126;178911;152;61;29;3;26;.897;3584000;0
7126;178950;152;0;0;0;0;.00nan;0;0
7126;170612;80;92;43;2;41;.953;3600000;0
7127;-1;78;0;0;0;0;.00nan;0;0
7127;-1;4620;72;42;4;38;.905;3600000;0
7127;169154;78;80;25;1;24;.960;3600000;0
7127;173961;4620;0;0;0;0;.00nan;0;0
7128;163195;67;0;0;0;0;.00nan;0;0
7128;-1;4620;0;0;0;0;.00nan;0;0
7128;173961;4620;56;38;5;33;.868;3535000;0
7128;38124;67;79;40;3;37;.925;3600000;0
7129;2410;81;100;28;0;28;1.000;3600000;0
7129;-1;149;0;0;0;0;.00nan;0;0
7129;70213;81;0;0;0;0;.00nan;0;0
7129;141419;149;86;35;2;33;.943;3526000;0
7130;-1;4922;0;0;0;0;.00nan;0;0
7130;85349;82;0;0;0;0;.00nan;0;0
7130;86151;82;70;18;1;17;.944;3600000;0
7130;91742;4922;70;43;4;39;.907;3600000;0
7131;163784;77;0;0;0;0;.00nan;0;0
7131;-1;1096;0;0;0;0;.00nan;0;0
7131;141978;1096;49;21;3;18;.857;3548000;0
7131;161047;77;92;38;2;36;.947;3600000;0
7132;180873;69;0;0;0;0;.00nan;0;0
7132;181446;71;0;0;0;0;.00nan;0;0
7132;79211;69;90;36;2;34;.944;3573000;0
7132;85984;71;73;16;1;15;.938;3600000;0
7133;13325;2564;55;25;3;22;.880;3855000;0
7133;165380;72;57;33;4;29;.879;3846000;0
7133;166441;2564;0;0;0;0;.00nan;0;0
7133;85228;72;0;0;0;0;.00nan;0;0
7134;181269;85;0;0;0;0;.00nan;0;0
7134;85555;76;81;33;2;31;.939;3550000;0
7134;91703;76;0;0;0;0;.00nan;0;0
7134;152624;85;100;44;1;43;.977;3600000;0
7135;164913;75;28;26;6;20;.769;2544000;0
7135;173856;75;57;15;2;13;.867;1056000;0
7135;170728;1097;0;0;0;0;.00nan;0;0
7135;43928;1097;78;20;1;19;.950;3600000;0
7136;2495;73;0;0;0;0;.00nan;0;0
7136;37942;1095;66;38;4;34;.895;3600000;0
7136;57657;73;47;35;6;29;.829;3524000;0
7136;79141;1095;0;0;0;0;.00nan;0;0
7137;161535;157;0;0;0;0;.00nan;0;0
7137;164987;157;88;30;1;29;.967;3600000;0
7137;-1;151;91;49;3;46;.939;3600000;0
7137;85507;151;0;0;0;0;.00nan;0;0
7138;163989;80;75;34;2;32;.941;3567000;0
7138;173874;158;0;0;0;0;.00nan;0;0
7138;170612;80;0;0;0;0;.00nan;0;0
7138;181071;158;65;18;1;17;.944;3600000;0
7139;5559;4245;48;41;6;35;.854;3600000;0
7139;-1;78;0;0;0;0;.00nan;0;0
7139;169154;78;72;13;1;12;.923;3600000;0
7139;149858;4245;0;0;0;0;.00nan;0;0
7140;165380;72;0;0;0;0;.00nan;0;0
7140;85228;72;77;36;4;32;.889;3600000;0
7140;85437;4921;70;48;5;43;.896;3593000;0
7140;152418;4921;0;0;0;0;.00nan;0;0
7141;13325;2564;78;47;4;43;.915;3585000;0
7141;166441;2564;0;0;0;0;.00nan;0;0
7141;181446;71;0;0;0;0;.00nan;0;0
7141;85984;71;63;19;2;17;.895;3600000;0
7142;2495;73;0;0;0;0;.00nan;0;0
7142;37942;1095;0;0;0;0;.00nan;0;0
7142;57657;73;93;43;3;40;.930;3600000;0
7142;79141;1095;56;29;4;25;.862;3567000;0
7143;-1;4620;33;33;6;27;.818;3900000;0
7143;173961;4620;0;0;0;0;.00nan;0;0
7143;181123;4920;84;38;3;35;.921;3373000;0
7143;149450;4920;26;5;3;2;.400;488000;0
7144;5559;4245;52;7;1;6;.857;555000;0
7144;-1;78;0;0;0;0;.00nan;0;0
7144;169154;78;68;38;4;34;.895;3600000;0
7144;149858;4245;58;46;6;40;.870;3045000;0
7145;-1;74;45;14;2;12;.857;3117000;0
7145;180606;74;27;4;3;1;.250;479000;0
7145;37942;1095;66;31;4;27;.871;3600000;0
7145;79141;1095;0;0;0;0;.00nan;0;0
7146;163784;77;97;46;3;43;.935;3600000;0
7146;170728;1097;74;12;0;12;1.000;3600000;0
7146;43928;1097;0;0;0;0;.00nan;0;0
7146;161047;77;0;0;0;0;.00nan;0;0
7147;164913;75;0;0;0;0;.00nan;0;0
7147;173856;75;100;41;0;41;1.000;3600000;0
7147;-1;4922;0;0;0;0;.00nan;0;0
7147;91742;4922;45;21;4;17;.810;3600000;0
7148;161535;157;49;31;5;26;.839;3513000;0
7148;164987;157;0;0;0;0;.00nan;0;0
7148;-1;149;0;0;0;0;.00nan;0;0
7148;141419;149;75;36;3;33;.917;3600000;0
7149;-1;1096;18;22;6;16;.727;2160000;0
7149;85349;82;0;0;0;0;.00nan;0;0
7149;86151;82;62;34;4;30;.882;3600000;0
7149;141978;1096;53;10;1;9;.900;1440000;0
7150;163784;77;0;0;0;0;.00nan;0;0
7150;170728;1097;0;0;0;0;.00nan;0;0
7150;43928;1097;68;21;1;20;.952;3600000;0
7150;161047;77;100;44;0;44;1.000;3600000;0
7151;181446;71;0;0;0;0;.00nan;0;0
7151;85555;76;84;27;1;26;.963;3600000;0
7151;85984;71;70;46;5;41;.891;3600000;0
7151;91703;76;0;0;0;0;.00nan;0;0
7152;165380;72;0;0;0;0;.00nan;0;0
7152;-1;74;0;0;0;0;.00nan;0;0
7152;180606;74;70;27;2;25;.926;3600000;0
7152;85228;72;76;41;4;37;.902;3594000;0
7153;2495;73;0;0;0;0;.00nan;0;0
7153;13325;2564;0;0;0;0;.00nan;0;0
7153;166441;2564;89;55;5;50;.909;3600000;0
7153;57657;73;65;22;2;20;.909;3600000;0
7154;5559;4245;0;0;0;0;.00nan;0;0
7154;163195;67;100;40;2;38;.950;3600000;0
7154;38124;67;0;0;0;0;.00nan;0;0
7154;149858;4245;80;34;3;31;.912;3600000;0
7155;164913;75;0;0;0;0;.00nan;0;0
7155;173856;75;65;43;5;38;.884;3600000;0
7155;-1;4922;74;23;1;22;.957;3600000;0
7155;91742;4922;0;0;0;0;.00nan;0;0
7156;2410;81;79;34;2;32;.941;3600000;0
7156;180873;69;60;14;1;13;.929;1108000;0
7156;70213;81;0;0;0;0;.00nan;0;0
7156;79211;69;38;36;6;30;.833;2492000;0
7157;-1;78;0;0;0;0;.00nan;0;0
7157;169154;78;49;22;3;19;.864;3563000;0
7157;181269;85;0;0;0;0;.00nan;0;0
7157;152624;85;92;37;2;35;.946;3600000;0
7158;-1;4620;0;0;0;0;.00nan;0;0
7158;173961;4620;69;36;3;33;.917;3900000;0
7158;181123;4920;0;0;0;0;.00nan;0;0
7158;149450;4920;75;37;3;34;.919;3900000;0
7159;163989;80;97;49;3;46;.939;3900000;0
7159;-1;151;0;0;0;0;.00nan;0;0
7159;170612;80;0;0;0;0;.00nan;0;0
7159;85507;151;76;30;3;27;.900;3900000;0
7160;173874;158;80;29;2;27;.931;3600000;0
7160;178911;152;0;0;0;0;.00nan;0;0
7160;178950;152;45;27;4;23;.852;3582000;0
7160;181071;158;0;0;0;0;.00nan;0;0
7161;163195;67;0;0;0;0;.00nan;0;0
7161;181123;4920;0;0;0;0;.00nan;0;0
7161;38124;67;82;35;2;33;.943;3900000;0
7161;149450;4920;71;30;2;28;.933;3900000;0
7162;161535;157;0;0;0;0;.00nan;0;0
7162;164987;157;45;14;3;11;.786;3544000;0
7162;-1;149;90;34;2;32;.941;3600000;0
7162;141419;149;0;0;0;0;.00nan;0;0
7163;-1;1096;66;36;4;32;.889;3600000;0
7163;85349;82;0;0;0;0;.00nan;0;0
7163;86151;82;93;29;1;28;.966;3600000;0
7163;141978;1096;0;0;0;0;.00nan;0;0
7164;165380;72;90;37;2;35;.946;3600000;0
7164;181446;71;62;31;3;28;.903;3557000;0
7164;85228;72;0;0;0;0;.00nan;0;0
7164;85984;71;0;0;0;0;.00nan;0;0
7165;5559;4245;0;0;0;0;.00nan;0;0
7165;-1;4620;78;26;2;24;.923;3600000;0
7165;173961;4620;0;0;0;0;.00nan;0;0
7165;149858;4245;67;33;4;29;.879;3558000;0
7166;2410;81;0;0;0;0;.00nan;0;0
7166;180873;69;88;41;2;39;.951;3900000;0
7166;70213;81;69;24;2;22;.917;3900000;0
7166;79211;69;0;0;0;0;.00nan;0;0
7167;-1;78;0;0;0;0;.00nan;0;0
7167;169154;78;77;31;2;29;.935;3900000;0
7167;181269;85;85;37;2;35;.946;3900000;0
7167;152624;85;0;0;0;0;.00nan;0;0
7168;164913;75;68;31;3;28;.903;3600000;0
7168;173856;75;0;0;0;0;.00nan;0;0
7168;-1;4922;0;0;0;0;.00nan;0;0
7168;91742;4922;49;30;4;26;.867;3573000;0
7169;2495;73;65;32;3;29;.906;3900000;0
7169;37942;1095;0;0;0;0;.00nan;0;0
7169;57657;73;0;0;0;0;.00nan;0;0
7169;79141;1095;69;35;3;32;.914;3900000;0
7170;163989;80;0;0;0;0;.00nan;0;0
7170;-1;151;48;39;5;34;.872;3565000;0
7170;170612;80;60;29;3;26;.897;3600000;0
7170;85507;151;0;0;0;0;.00nan;0;0
7171;85437;4921;77;34;3;31;.912;3566000;0
7171;85555;76;78;25;1;24;.960;3600000;0
7171;91703;76;0;0;0;0;.00nan;0;0
7171;152418;4921;0;0;0;0;.00nan;0;0
7172;173874;158;0;0;0;0;.00nan;0;0
7172;178911;152;88;38;2;36;.947;3600000;0
7172;178950;152;0;0;0;0;.00nan;0;0
7172;181071;158;47;20;3;17;.850;3573000;0
7173;163195;67;82;31;2;29;.935;3600000;0
7173;181123;4920;0;0;0;0;.00nan;0;0
7173;38124;67;0;0;0;0;.00nan;0;0
7173;149450;4920;38;33;6;27;.818;3600000;0
7174;161535;157;52;24;3;21;.875;3600000;0
7174;164987;157;0;0;0;0;.00nan;0;0
7174;-1;149;0;0;0;0;.00nan;0;0
7174;141419;149;64;39;4;35;.897;3560000;0
7175;-1;74;55;6;0;6;1.000;516000;0
7175;180606;74;36;27;6;21;.778;3084000;0
7175;37942;1095;95;40;2;38;.950;3600000;0
7175;79141;1095;0;0;0;0;.00nan;0;0
7176;2495;73;0;0;0;0;.00nan;0;0
7176;181446;71;0;0;0;0;.00nan;0;0
7176;57657;73;89;28;1;27;.964;3900000;0
7176;85984;71;97;37;1;36;.973;3900000;0
7177;163784;77;0;0;0;0;.00nan;0;0
7177;170728;1097;58;29;4;25;.862;3900000;0
7177;43928;1097;0;0;0;0;.00nan;0;0
7177;161047;77;50;34;4;30;.882;3900000;0
7178;13325;2564;99;31;1;30;.968;3600000;0
7178;165380;72;53;3;0;3;1.000;286000;0
7178;166441;2564;0;0;0;0;.00nan;0;0
7178;85228;72;43;39;7;32;.821;3314000;0
7179;173874;158;85;41;3;38;.927;3600000;0
7179;178911;152;0;0;0;0;.00nan;0;0
7179;178950;152;58;31;4;27;.871;3557000;0
7179;181071;158;0;0;0;0;.00nan;0;0
7180;2410;81;92;30;1;29;.967;3600000;0
7180;180873;69;0;0;0;0;.00nan;0;0
7180;70213;81;0;0;0;0;.00nan;0;0
7180;79211;69;78;49;4;45;.918;3600000;0
7181;-1;78;0;0;0;0;.00nan;0;0
7181;169154;78;60;19;2;17;.895;3900000;0
7181;181269;85;0;0;0;0;.00nan;0;0
7181;152624;85;75;35;2;33;.943;3900000;0
7182;-1;1096;0;0;0;0;.00nan;0;0
7182;85349;82;54;23;3;20;.870;3705000;0
7182;86151;82;0;0;0;0;.00nan;0;0
7182;141978;1096;67;38;4;34;.895;3705000;0
7183;163989;80;63;40;4;36;.900;3884000;0
7183;-1;151;0;0;0;0;.00nan;0;0
7183;170612;80;0;0;0;0;.00nan;0;0
7183;85507;151;85;40;3;37;.925;3884000;0
7184;85437;4921;73;26;3;23;.885;3600000;0
7184;85555;76;0;0;0;0;.00nan;0;0
7184;91703;76;38;19;4;15;.789;3600000;0
7184;152418;4921;0;0;0;0;.00nan;0;0
7185;163989;80;51;29;5;24;.828;3600000;0
7185;-1;149;100;49;1;48;.980;3600000;0
7185;170612;80;0;0;0;0;.00nan;0;0
7185;141419;149;0;0;0;0;.00nan;0;0
7186;170728;1097;0;0;0;0;.00nan;0;0
7186;43928;1097;54;32;4;28;.875;3596000;0
7186;85349;82;0;0;0;0;.00nan;0;0
7186;86151;82;66;27;3;24;.889;3600000;0
7187;161535;157;60;18;2;16;.889;3600000;0
7187;164987;157;0;0;0;0;.00nan;0;0
7187;181269;85;54;33;4;29;.879;3586000;0
7187;152624;85;0;0;0;0;.00nan;0;0
7188;-1;74;98;24;0;24;1.000;3600000;0
7188;-1;4922;0;0;0;0;.00nan;0;0
7188;180606;74;0;0;0;0;.00nan;0;0
7188;91742;4922;80;36;3;33;.917;3600000;0
7189;13325;2564;41;15;3;12;.800;3600000;0
7189;166441;2564;0;0;0;0;.00nan;0;0
7189;181446;71;0;0;0;0;.00nan;0;0
7189;85984;71;49;34;4;30;.882;3600000;0
7190;163195;67;94;38;3;35;.921;3565000;0
7190;-1;4620;0;0;0;0;.00nan;0;0
7190;173961;4620;67;24;2;22;.917;3600000;0
7190;38124;67;0;0;0;0;.00nan;0;0
7191;5559;4245;0;0;0;0;.00nan;0;0
7191;163195;67;99;37;2;35;.946;3600000;0
7191;38124;67;0;0;0;0;.00nan;0;0
7191;149858;4245;50;33;5;28;.848;3600000;0
7192;170728;1097;72;26;1;25;.962;3600000;0
7192;43928;1097;0;0;0;0;.00nan;0;0
7192;85349;82;0;0;0;0;.00nan;0;0
7192;86151;82;71;32;3;29;.906;3571000;0
7193;163784;77;47;21;3;18;.857;3900000;0
7193;164913;75;0;0;0;0;.00nan;0;0
7193;173856;75;64;33;3;30;.909;3900000;0
7193;161047;77;0;0;0;0;.00nan;0;0
7194;164987;157;44;13;2;11;.846;3600000;0
7194;19708;157;0;0;0;0;.00nan;0;0
7194;181269;85;0;0;0;0;.00nan;0;0
7194;152624;85;63;40;5;35;.875;3600000;0
7195;-1;74;47;34;5;29;.853;3542000;0
7195;-1;1096;79;42;4;38;.905;3600000;0
7195;180606;74;0;0;0;0;.00nan;0;0
7195;141978;1096;0;0;0;0;.00nan;0;0
7196;13325;2564;0;0;0;0;.00nan;0;0
7196;166441;2564;100;30;0;30;1.000;3600000;0
7196;37942;1095;0;0;0;0;.00nan;0;0
7196;79141;1095;84;42;3;39;.929;3600000;0
7197;-1;151;0;0;0;0;.00nan;0;0
7197;181123;4920;0;0;0;0;.00nan;0;0
7197;85507;151;52;34;5;29;.853;3534000;0
7197;149450;4920;81;38;3;35;.921;3600000;0
7198;165380;72;0;0;0;0;.00nan;0;0
7198;85228;72;73;50;6;44;.880;3600000;0
7198;85555;76;64;29;3;26;.897;3600000;0
7198;91703;76;0;0;0;0;.00nan;0;0
7199;-1;4922;0;0;0;0;.00nan;0;0
7199;85437;4921;48;33;5;28;.848;3873000;0
7199;91742;4922;41;35;6;29;.829;3873000;0
7199;152418;4921;0;0;0;0;.00nan;0;0
7200;2495;73;0;0;0;0;.00nan;0;0
7200;181446;71;27;28;6;22;.786;3600000;0
7200;57657;73;89;37;2;35;.946;3600000;0
7200;85984;71;0;0;0;0;.00nan;0;0
7201;2410;81;76;21;1;20;.952;3600000;0
7201;163989;80;66;42;5;37;.881;3600000;0
7201;170612;80;0;0;0;0;.00nan;0;0
7201;70213;81;0;0;0;0;.00nan;0;0
7202;-1;149;80;12;0;12;1.000;3600000;0
7202;173874;158;87;39;2;37;.949;3518000;0
7202;181071;158;0;0;0;0;.00nan;0;0
7202;141419;149;0;0;0;0;.00nan;0;0
7203;-1;78;56;34;3;31;.912;3558000;0
7203;-1;4620;85;36;2;34;.944;3600000;0
7203;169154;78;0;0;0;0;.00nan;0;0
7203;173961;4620;0;0;0;0;.00nan;0;0
7204;2495;73;82;30;1;29;.967;3600000;0
7204;37942;1095;94;45;2;43;.956;3568000;0
7204;57657;73;0;0;0;0;.00nan;0;0
7204;79141;1095;0;0;0;0;.00nan;0;0
7205;180873;69;43;33;6;27;.818;3713000;0
7205;181446;71;0;0;0;0;.00nan;0;0
7205;79211;69;0;0;0;0;.00nan;0;0
7205;85984;71;39;39;7;32;.821;3713000;0
7206;163784;77;0;0;0;0;.00nan;0;0
7206;170728;1097;0;0;0;0;.00nan;0;0
7206;43928;1097;88;31;2;29;.935;3600000;0
7206;161047;77;79;43;4;39;.907;3600000;0
7207;164987;157;0;0;0;0;.00nan;0;0
7207;19708;157;73;32;2;30;.938;3835000;0
7207;181269;85;90;44;3;41;.932;3835000;0
7207;152624;85;0;0;0;0;.00nan;0;0
7208;5559;4245;48;27;4;23;.852;3522000;0
7208;163195;67;0;0;0;0;.00nan;0;0
7208;38124;67;81;30;2;28;.933;3600000;0
7208;149858;4245;0;0;0;0;.00nan;0;0
7209;-1;151;52;57;9;48;.842;3600000;0
7209;181123;4920;0;0;0;0;.00nan;0;0
7209;85507;151;0;0;0;0;.00nan;0;0
7209;149450;4920;69;17;1;16;.941;3600000;0
7210;165380;72;76;32;3;29;.906;3744000;0
7210;85228;72;0;0;0;0;.00nan;0;0
7210;85555;76;85;35;2;33;.943;3744000;0
7210;91703;76;0;0;0;0;.00nan;0;0
7211;-1;4922;78;46;4;42;.913;3600000;0
7211;85437;4921;0;0;0;0;.00nan;0;0
7211;91742;4922;0;0;0;0;.00nan;0;0
7211;152418;4921;82;22;1;21;.955;3600000;0
7212;-1;74;61;36;5;31;.861;3676000;0
7212;-1;1096;0;0;0;0;.00nan;0;0
7212;180606;74;0;0;0;0;.00nan;0;0
7212;141978;1096;51;41;6;35;.854;3676000;0
7213;164913;75;87;49;4;45;.918;3600000;0
7213;173856;75;0;0;0;0;.00nan;0;0
7213;85349;82;0;0;0;0;.00nan;0;0
7213;86151;82;87;15;0;15;1.000;3600000;0
7214;2410;81;67;22;2;20;.909;3600000;0
7214;163989;80;0;0;0;0;.00nan;0;0
7214;170612;80;47;35;5;30;.857;3600000;0
7214;70213;81;0;0;0;0;.00nan;0;0
7215;-1;149;69;44;4;40;.909;3582000;0
7215;173874;158;0;0;0;0;.00nan;0;0
7215;181071;158;66;22;2;20;.909;3600000;0
7215;141419;149;0;0;0;0;.00nan;0;0
7216;-1;78;0;0;0;0;.00nan;0;0
7216;-1;4620;0;0;0;0;.00nan;0;0
7216;169154;78;65;27;3;24;.889;3593000;0
7216;173961;4620;84;32;1;31;.969;3600000;0
7217;163195;67;91;42;2;40;.952;3600000;0
7217;-1;4620;25;13;4;9;.692;2345000;0
7217;173961;4620;53;11;1;10;.909;1255000;0
7217;38124;67;0;0;0;0;.00nan;0;0
7218;-1;74;43;38;6;32;.842;3600000;0
7218;180606;74;0;0;0;0;.00nan;0;0
7218;85349;82;0;0;0;0;.00nan;0;0
7218;86151;82;99;42;2;40;.952;3600000;0
7219;180873;69;88;45;3;42;.933;3600000;0
7219;181446;71;15;14;5;9;.643;991000;0
7219;79211;69;0;0;0;0;.00nan;0;0
7219;85984;71;51;28;3;25;.893;2609000;0
7220;5559;4245;0;0;0;0;.00nan;0;0
7220;-1;78;0;0;0;0;.00nan;0;0
7220;169154;78;75;29;2;27;.931;3600000;0
7220;149858;4245;77;43;4;39;.907;3585000;0
7221;-1;151;0;0;0;0;.00nan;0;0
7221;181123;4920;0;0;0;0;.00nan;0;0
7221;85507;151;76;41;4;37;.902;3654000;0
7221;149450;4920;64;25;3;22;.880;3638000;0
7222;165380;72;0;0;0;0;.00nan;0;0
7222;85228;72;75;44;4;40;.909;3600000;0
7222;85555;76;0;0;0;0;.00nan;0;0
7222;91703;76;84;33;2;31;.939;3600000;0
7223;-1;4922;0;0;0;0;.00nan;0;0
7223;85437;4921;59;22;2;20;.909;3600000;0
7223;91742;4922;70;32;3;29;.906;3537000;0
7223;152418;4921;0;0;0;0;.00nan;0;0
7224;163784;77;54;22;3;19;.864;3571000;0
7224;164913;75;0;0;0;0;.00nan;0;0
7224;173856;75;93;29;1;28;.966;3600000;0
7224;161047;77;0;0;0;0;.00nan;0;0
7225;2495;73;0;0;0;0;.00nan;0;0
7225;37942;1095;0;0;0;0;.00nan;0;0
7225;57657;73;67;33;3;30;.909;3600000;0
7225;79141;1095;50;26;4;22;.846;3586000;0
7226;2410;81;92;21;0;21;1.000;3600000;0
7226;163989;80;70;38;4;34;.895;3600000;0
7226;170612;80;0;0;0;0;.00nan;0;0
7226;70213;81;0;0;0;0;.00nan;0;0
7227;-1;149;0;0;0;0;.00nan;0;0
7227;173874;158;99;26;0;26;1.000;3600000;0
7227;181071;158;0;0;0;0;.00nan;0;0
7227;141419;149;75;38;3;35;.921;3600000;0
7228;-1;151;0;0;0;0;.00nan;0;0
7228;-1;149;100;32;0;32;1.000;3600000;0
7228;85507;151;66;28;3;25;.893;3600000;0
7228;141419;149;0;0;0;0;.00nan;0;0
7229;170728;1097;75;29;2;27;.931;3600000;0
7229;-1;1096;0;0;0;0;.00nan;0;0
7229;43928;1097;0;0;0;0;.00nan;0;0
7229;141978;1096;65;38;4;34;.895;3588000;0
7230;163784;77;0;0;0;0;.00nan;0;0
7230;-1;4922;0;0;0;0;.00nan;0;0
7230;91742;4922;73;19;1;18;.947;3600000;0
7230;161047;77;77;33;2;31;.939;3569000;0
7231;164987;157;0;0;0;0;.00nan;0;0
7231;19708;157;39;23;4;19;.826;3558000;0
7231;178911;152;90;42;3;39;.929;3600000;0
7231;178950;152;0;0;0;0;.00nan;0;0
7232;2495;73;0;0;0;0;.00nan;0;0
7232;165380;72;0;0;0;0;.00nan;0;0
7232;57657;73;59;42;5;37;.881;3592000;0
7232;85228;72;72;31;3;28;.903;3600000;0
7233;5559;4245;0;0;0;0;.00nan;0;0
7233;-1;4620;52;25;4;21;.840;3600000;0
7233;173961;4620;0;0;0;0;.00nan;0;0
7233;149858;4245;69;43;5;38;.884;3562000;0
7234;2410;81;26;12;4;8;.667;1125000;0
7234;181446;71;0;0;0;0;.00nan;0;0
7234;70213;81;43;18;3;15;.833;2475000;0
7234;85984;71;66;26;2;24;.923;3600000;0
7235;163195;67;72;31;3;28;.903;3582000;0
7235;181123;4920;0;0;0;0;.00nan;0;0
7235;38124;67;0;0;0;0;.00nan;0;0
7235;149450;4920;76;24;1;23;.958;3600000;0
7236;-1;151;0;0;0;0;.00nan;0;0
7236;-1;149;35;35;6;29;.829;3600000;0
7236;85507;151;63;32;3;29;.906;3600000;0
7236;141419;149;0;0;0;0;.00nan;0;0
7237;170728;1097;0;0;0;0;.00nan;0;0
7237;-1;1096;29;36;7;29;.806;3600000;0
7237;43928;1097;85;31;2;29;.935;3600000;0
7237;141978;1096;0;0;0;0;.00nan;0;0
7238;163784;77;0;0;0;0;.00nan;0;0
7238;-1;4922;0;0;0;0;.00nan;0;0
7238;91742;4922;80;37;2;35;.946;3777000;0
7238;161047;77;58;24;3;21;.875;3763000;0
7239;164987;157;0;0;0;0;.00nan;0;0
7239;19708;157;78;21;1;20;.952;3600000;0
7239;178911;152;54;40;5;35;.875;3600000;0
7239;178950;152;0;0;0;0;.00nan;0;0
7240;164913;75;0;0;0;0;.00nan;0;0
7240;-1;74;50;13;2;11;.846;3545000;0
7240;173856;75;94;39;1;38;.974;3600000;0
7240;180606;74;0;0;0;0;.00nan;0;0
7241;2495;73;53;4;0;4;1.000;709000;0
7241;13325;2564;0;0;0;0;.00nan;0;0
7241;166441;2564;77;30;2;28;.933;3600000;0
7241;57657;73;42;33;6;27;.818;2891000;0
7242;2410;81;27;19;5;14;.737;3600000;0
7242;181446;71;41;19;4;15;.789;1370000;0
7242;70213;81;0;0;0;0;.00nan;0;0
7242;85984;71;46;21;4;17;.810;2230000;0
7243;5559;4245;0;0;0;0;.00nan;0;0
7243;181269;85;0;0;0;0;.00nan;0;0
7243;149858;4245;77;23;1;22;.957;3600000;0
7243;152624;85;60;31;4;27;.871;3600000;0
7244;-1;4620;57;17;2;15;.882;2790000;0
7244;173961;4620;21;13;4;9;.692;786000;0
7244;85349;82;0;0;0;0;.00nan;0;0
7244;86151;82;53;33;5;28;.848;3600000;0
7245;163989;80;51;29;4;25;.862;3600000;0
7245;170612;80;0;0;0;0;.00nan;0;0
7245;180873;69;44;32;5;27;.844;3600000;0
7245;79211;69;0;0;0;0;.00nan;0;0
7246;165380;72;0;0;0;0;.00nan;0;0
7246;85228;72;68;35;4;31;.886;3555000;0
7246;85437;4921;0;0;0;0;.00nan;0;0
7246;152418;4921;60;30;3;27;.900;3600000;0
7247;173874;158;50;40;5;35;.875;3900000;0
7247;181071;158;0;0;0;0;.00nan;0;0
7247;37942;1095;0;0;0;0;.00nan;0;0
7247;79141;1095;62;44;5;39;.886;3900000;0
7248;-1;78;0;0;0;0;.00nan;0;0
7248;169154;78;85;29;1;28;.966;3600000;0
7248;85555;76;59;34;5;29;.853;3600000;0
7248;91703;76;0;0;0;0;.00nan;0;0
7249;-1;151;43;30;5;25;.833;3600000;0
7249;-1;149;50;1;0;1;1.000;512000;0
7249;85507;151;0;0;0;0;.00nan;0;0
7249;141419;149;37;30;6;24;.800;3070000;0
7250;170728;1097;64;43;5;38;.884;3600000;0
7250;-1;1096;0;0;0;0;.00nan;0;0
7250;43928;1097;0;0;0;0;.00nan;0;0
7250;141978;1096;92;33;2;31;.939;3600000;0
7251;164987;157;0;0;0;0;.00nan;0;0
7251;19708;157;56;37;5;32;.865;3900000;0
7251;178911;152;0;0;0;0;.00nan;0;0
7251;178950;152;65;45;5;40;.889;3900000;0
7252;163784;77;83;42;3;39;.929;3600000;0
7252;-1;74;87;22;0;22;1.000;3600000;0
7252;180606;74;0;0;0;0;.00nan;0;0
7252;161047;77;0;0;0;0;.00nan;0;0
7253;163195;67;60;43;5;38;.884;3600000;0
7253;181123;4920;0;0;0;0;.00nan;0;0
7253;38124;67;0;0;0;0;.00nan;0;0
7253;149450;4920;58;20;2;18;.900;3600000;0
7254;2410;81;0;0;0;0;.00nan;0;0
7254;181446;71;49;7;1;6;.857;494000;0
7254;70213;81;76;24;2;22;.917;3600000;0
7254;85984;71;53;51;7;44;.863;3106000;0
7255;5559;4245;35;10;3;7;.700;412000;0
7255;181269;85;72;25;3;22;.880;3600000;0
7255;149858;4245;76;24;1;23;.958;3165000;0
7255;152624;85;0;0;0;0;.00nan;0;0
7256;164913;75;22;4;3;1;.250;435000;0
7256;173856;75;29;19;4;15;.789;3165000;0
7256;-1;4922;83;40;4;36;.900;3600000;0
7256;91742;4922;0;0;0;0;.00nan;0;0
7257;2495;73;98;44;2;42;.955;3600000;0
7257;13325;2564;39;29;5;24;.828;3600000;0
7257;166441;2564;0;0;0;0;.00nan;0;0
7257;57657;73;0;0;0;0;.00nan;0;0
7258;-1;4620;0;0;0;0;.00nan;0;0
7258;173961;4620;88;37;2;35;.946;3600000;0
7258;85349;82;37;21;4;17;.810;3525000;0
7258;86151;82;0;0;0;0;.00nan;0;0
7259;163989;80;0;0;0;0;.00nan;0;0
7259;170612;80;78;32;2;30;.938;3600000;0
7259;180873;69;43;22;3;19;.864;3600000;0
7259;79211;69;0;0;0;0;.00nan;0;0
7260;165380;72;64;40;5;35;.875;3565000;0
7260;85228;72;0;0;0;0;.00nan;0;0
7260;85437;4921;53;23;4;19;.826;3600000;0
7260;152418;4921;0;0;0;0;.00nan;0;0
7261;173874;158;0;0;0;0;.00nan;0;0
7261;181071;158;63;32;3;29;.906;3600000;0
7261;37942;1095;68;38;4;34;.895;3551000;0
7261;79141;1095;0;0;0;0;.00nan;0;0
7262;-1;78;0;0;0;0;.00nan;0;0
7262;169154;78;98;23;0;23;1.000;3600000;0
7262;85555;76;75;30;2;28;.933;3539000;0
7262;91703;76;0;0;0;0;.00nan;0;0
7263;163195;67;0;0;0;0;.00nan;0;0
7263;181123;4920;79;21;1;20;.952;3155000;0
7263;38124;67;61;23;2;21;.913;3600000;0
7263;149450;4920;26;8;3;5;.625;404000;0
7264;164913;75;75;41;4;37;.902;3600000;0
7264;-1;74;32;24;5;19;.792;3539000;0
7264;173856;75;0;0;0;0;.00nan;0;0
7264;180606;74;0;0;0;0;.00nan;0;0
7265;2495;73;0;0;0;0;.00nan;0;0
7265;165380;72;0;0;0;0;.00nan;0;0
7265;57657;73;50;28;4;24;.857;3559000;0
7265;85228;72;70;30;2;28;.933;3600000;0
7266;13325;2564;0;0;0;0;.00nan;0;0
7266;166441;2564;94;41;2;39;.951;3900000;0
7266;85437;4921;0;0;0;0;.00nan;0;0
7266;152418;4921;68;26;2;24;.923;3900000;0
7267;-1;151;0;0;0;0;.00nan;0;0
7267;173874;158;83;14;0;14;1.000;3600000;0
7267;181071;158;0;0;0;0;.00nan;0;0
7267;85507;151;93;44;3;41;.932;3600000;0
7268;-1;78;0;0;0;0;.00nan;0;0
7268;169154;78;45;38;6;32;.842;3600000;0
7268;85555;76;0;0;0;0;.00nan;0;0
7268;91703;76;66;25;3;22;.880;3600000;0
7269;163989;80;94;38;2;36;.947;3600000;0
7269;-1;149;52;35;5;30;.857;3600000;0
7269;170612;80;0;0;0;0;.00nan;0;0
7269;141419;149;0;0;0;0;.00nan;0;0
7270;180873;69;90;34;1;33;.971;3600000;0
7270;37942;1095;0;0;0;0;.00nan;0;0
7270;79141;1095;71;28;2;26;.929;3550000;0
7270;79211;69;0;0;0;0;.00nan;0;0
7271;5559;4245;0;0;0;0;.00nan;0;0
7271;181269;85;0;0;0;0;.00nan;0;0
7271;149858;4245;98;36;1;35;.972;3600000;0
7271;152624;85;29;14;4;10;.714;3600000;0
7272;-1;74;61;30;4;26;.867;3593000;0
7272;180606;74;0;0;0;0;.00nan;0;0
7272;85349;82;0;0;0;0;.00nan;0;0
7272;86151;82;70;27;3;24;.889;3600000;0
7273;2495;73;0;0;0;0;.00nan;0;0
7273;37942;1095;0;0;0;0;.00nan;0;0
7273;57657;73;56;28;4;24;.857;3600000;0
7273;79141;1095;99;31;1;30;.968;3600000;0
7274;-1;78;33;23;5;18;.783;3143000;0
7274;169154;78;22;11;4;7;.636;457000;0
7274;181446;71;0;0;0;0;.00nan;0;0
7274;85984;71;59;28;3;25;.893;3600000;0
7275;13325;2564;87;39;2;37;.949;3600000;0
7275;165380;72;0;0;0;0;.00nan;0;0
7275;166441;2564;0;0;0;0;.00nan;0;0
7275;85228;72;74;35;3;32;.914;3571000;0
7276;180873;69;64;29;3;26;.897;3600000;0
7276;79211;69;0;0;0;0;.00nan;0;0
7276;85437;4921;0;0;0;0;.00nan;0;0
7276;152418;4921;42;30;5;25;.833;3566000;0
7277;-1;151;0;0;0;0;.00nan;0;0
7277;178911;152;53;17;2;15;.882;3600000;0
7277;178950;152;0;0;0;0;.00nan;0;0
7277;85507;151;71;43;4;39;.907;3518000;0
7278;5559;4245;0;0;0;0;.00nan;0;0
7278;181269;85;22;24;6;18;.750;2739000;0
7278;149858;4245;74;37;3;34;.919;3600000;0
7278;152624;85;51;9;1;8;.889;861000;0
7279;181123;4920;0;0;0;0;.00nan;0;0
7279;85555;76;62;21;2;19;.905;3577000;0
7279;91703;76;0;0;0;0;.00nan;0;0
7279;149450;4920;99;38;1;37;.974;3600000;0
7280;170728;1097;0;0;0;0;.00nan;0;0
7280;-1;4922;0;0;0;0;.00nan;0;0
7280;43928;1097;35;26;5;21;.808;3558000;0
7280;91742;4922;90;42;4;38;.905;3600000;0
7281;2410;81;98;33;1;32;.970;3600000;0
7281;164987;157;0;0;0;0;.00nan;0;0
7281;19708;157;68;33;3;30;.909;3531000;0
7281;70213;81;0;0;0;0;.00nan;0;0
7282;163784;77;58;20;2;18;.900;3600000;0
7282;164913;75;64;9;0;9;1.000;1334000;0
7282;173856;75;23;25;6;19;.760;2266000;0
7282;161047;77;0;0;0;0;.00nan;0;0
7283;163195;67;81;33;2;31;.939;3600000;0
7283;-1;4620;79;27;1;26;.963;3600000;0
7283;173961;4620;0;0;0;0;.00nan;0;0
7283;38124;67;0;0;0;0;.00nan;0;0
7284;163989;80;83;23;1;22;.957;3600000;0
7284;173874;158;42;26;4;22;.846;3600000;0
7284;170612;80;0;0;0;0;.00nan;0;0
7284;181071;158;0;0;0;0;.00nan;0;0
7285;164913;75;0;0;0;0;.00nan;0;0
7285;173856;75;90;43;3;40;.930;3617000;0
7285;85349;82;28;13;4;9;.692;3617000;0
7285;86151;82;0;0;0;0;.00nan;0;0
7286;-1;78;0;0;0;0;.00nan;0;0
7286;169154;78;66;25;3;22;.880;3547000;0
7286;181446;71;99;47;2;45;.957;3600000;0
7286;85984;71;0;0;0;0;.00nan;0;0
7287;163784;77;0;0;0;0;.00nan;0;0
7287;-1;74;84;31;2;29;.935;3600000;0
7287;180606;74;0;0;0;0;.00nan;0;0
7287;161047;77;66;29;3;26;.897;3569000;0
7288;2495;73;48;30;4;26;.867;3569000;0
7288;165380;72;97;43;2;41;.953;3600000;0
7288;57657;73;0;0;0;0;.00nan;0;0
7288;85228;72;0;0;0;0;.00nan;0;0
7289;180873;69;83;49;4;45;.918;3600000;0
7289;79211;69;0;0;0;0;.00nan;0;0
7289;85437;4921;82;25;1;24;.960;3600000;0
7289;152418;4921;0;0;0;0;.00nan;0;0
7290;13325;2564;0;0;0;0;.00nan;0;0
7290;166441;2564;42;24;3;21;.875;3600000;0
7290;37942;1095;71;26;2;24;.923;3600000;0
7290;79141;1095;0;0;0;0;.00nan;0;0
7291;-1;151;68;32;2;30;.938;3555000;0
7291;178911;152;0;0;0;0;.00nan;0;0
7291;178950;152;100;21;0;21;1.000;3600000;0
7291;85507;151;0;0;0;0;.00nan;0;0
7292;5559;4245;51;23;3;20;.870;3600000;0
7292;181269;85;0;0;0;0;.00nan;0;0
7292;149858;4245;0;0;0;0;.00nan;0;0
7292;152624;85;71;22;2;20;.909;3600000;0
7293;181123;4920;0;0;0;0;.00nan;0;0
7293;85555;76;0;0;0;0;.00nan;0;0
7293;91703;76;88;34;2;32;.941;3716000;0
7293;149450;4920;84;42;3;39;.929;3716000;0
7294;2410;81;0;0;0;0;.00nan;0;0
7294;164987;157;0;0;0;0;.00nan;0;0
7294;19708;157;43;24;4;20;.833;3586000;0
7294;70213;81;76;28;2;26;.929;3600000;0
7295;170728;1097;94;37;2;35;.946;3667000;0
7295;-1;1096;84;26;1;25;.962;3667000;0
7295;43928;1097;0;0;0;0;.00nan;0;0
7295;141978;1096;0;0;0;0;.00nan;0;0
7296;163195;67;0;0;0;0;.00nan;0;0
7296;-1;4620;0;0;0;0;.00nan;0;0
7296;173961;4620;66;24;2;22;.917;3600000;0
7296;38124;67;79;36;3;33;.917;3600000;0
7297;-1;78;0;0;0;0;.00nan;0;0
7297;169154;78;62;14;1;13;.929;3600000;0
7297;181446;71;0;0;0;0;.00nan;0;0
7297;85984;71;39;35;6;29;.829;3600000;0
7298;163784;77;80;28;2;26;.929;3600000;0
7298;-1;74;33;23;5;18;.783;3600000;0
7298;180606;74;0;0;0;0;.00nan;0;0
7298;161047;77;0;0;0;0;.00nan;0;0
7299;5559;4245;0;0;0;0;.00nan;0;0
7299;181269;85;69;24;2;22;.917;3600000;0
7299;149858;4245;47;26;4;22;.846;3546000;0
7299;152624;85;0;0;0;0;.00nan;0;0
7300;181123;4920;85;30;2;28;.933;3600000;0
7300;85555;76;50;27;4;23;.852;3552000;0
7300;91703;76;0;0;0;0;.00nan;0;0
7300;149450;4920;0;0;0;0;.00nan;0;0
7301;170728;1097;0;0;0;0;.00nan;0;0
7301;-1;1096;0;0;0;0;.00nan;0;0
7301;43928;1097;71;31;3;28;.903;3600000;0
7301;141978;1096;39;30;5;25;.833;3600000;0
7302;164913;75;77;45;3;42;.933;3574000;0
7302;173856;75;0;0;0;0;.00nan;0;0
7302;-1;4922;0;0;0;0;.00nan;0;0
7302;91742;4922;86;29;1;28;.966;3600000;0
7303;180873;69;52;42;6;36;.857;3557000;0
7303;37942;1095;0;0;0;0;.00nan;0;0
7303;79141;1095;64;31;4;27;.871;3600000;0
7303;79211;69;0;0;0;0;.00nan;0;0
7304;170728;1097;0;0;0;0;.00nan;0;0
7304;43928;1097;49;37;5;32;.865;3582000;0
7304;85349;82;0;0;0;0;.00nan;0;0
7304;86151;82;84;29;3;26;.897;3600000;0
7305;-1;149;60;17;2;15;.882;3600000;0
7305;178911;152;0;0;0;0;.00nan;0;0
7305;178950;152;58;29;3;26;.897;3591000;0
7305;141419;149;0;0;0;0;.00nan;0;0
7306;181123;4920;0;0;0;0;.00nan;0;0
7306;85555;76;92;39;2;37;.949;3600000;0
7306;91703;76;0;0;0;0;.00nan;0;0
7306;149450;4920;67;47;5;42;.894;3600000;0
7307;181269;85;0;0;0;0;.00nan;0;0
7307;85437;4921;0;0;0;0;.00nan;0;0
7307;152418;4921;49;36;5;31;.861;3600000;0
7307;152624;85;57;38;6;32;.842;3567000;0
7308;2410;81;41;31;6;25;.806;3570000;0
7308;-1;151;0;0;0;0;.00nan;0;0
7308;70213;81;0;0;0;0;.00nan;0;0
7308;85507;151;92;56;5;51;.911;3600000;0
7309;-1;4922;0;0;0;0;.00nan;0;0
7309;-1;1096;89;39;3;36;.923;3545000;0
7309;91742;4922;62;24;2;22;.917;3600000;0
7309;141978;1096;0;0;0;0;.00nan;0;0
7310;163195;67;72;30;3;27;.900;3900000;0
7310;181123;4920;0;0;0;0;.00nan;0;0
7310;38124;67;0;0;0;0;.00nan;0;0
7310;149450;4920;95;43;3;40;.930;3900000;0
7311;2495;73;0;0;0;0;.00nan;0;0
7311;37942;1095;0;0;0;0;.00nan;0;0
7311;57657;73;77;41;4;37;.902;3840000;0
7311;79141;1095;70;27;3;24;.889;3874000;0
7312;163784;77;93;33;1;32;.970;3600000;0
7312;170728;1097;0;0;0;0;.00nan;0;0
7312;43928;1097;54;35;5;30;.857;3600000;0
7312;161047;77;0;0;0;0;.00nan;0;0
7313;165380;72;0;0;0;0;.00nan;0;0
7313;180873;69;61;42;5;37;.881;3576000;0
7313;79211;69;0;0;0;0;.00nan;0;0
7313;85228;72;44;20;3;17;.850;3600000;0
7314;13325;2564;70;30;3;27;.900;3548000;0
7314;166441;2564;0;0;0;0;.00nan;0;0
7314;181446;71;0;0;0;0;.00nan;0;0
7314;85984;71;99;43;1;42;.977;3600000;0
7315;-1;149;84;39;4;35;.897;3574000;0
7315;178911;152;67;21;2;19;.905;3600000;0
7315;178950;152;0;0;0;0;.00nan;0;0
7315;141419;149;0;0;0;0;.00nan;0;0
7316;-1;4922;0;0;0;0;.00nan;0;0
7316;85349;82;0;0;0;0;.00nan;0;0
7316;86151;82;77;24;2;22;.917;3600000;0
7316;91742;4922;66;32;3;29;.906;3542000;0
7317;181269;85;0;0;0;0;.00nan;0;0
7317;85437;4921;76;28;2;26;.929;3600000;0
7317;152418;4921;0;0;0;0;.00nan;0;0
7317;152624;85;75;40;3;37;.925;3574000;0
7318;-1;74;64;26;2;24;.923;3600000;0
7318;-1;1096;0;0;0;0;.00nan;0;0
7318;180606;74;0;0;0;0;.00nan;0;0
7318;141978;1096;74;38;3;35;.921;3555000;0
7319;164913;75;52;16;2;14;.875;952000;0
7319;173856;75;43;33;6;27;.818;2648000;0
7319;173874;158;46;34;5;29;.853;3600000;0
7319;181071;158;0;0;0;0;.00nan;0;0
7320;5559;4245;0;0;0;0;.00nan;0;0
7320;-1;4620;70;37;4;33;.892;3668000;0
7320;173961;4620;0;0;0;0;.00nan;0;0
7320;149858;4245;71;31;3;28;.903;3668000;0
7321;163989;80;79;29;1;28;.966;3900000;0
7321;164987;157;0;0;0;0;.00nan;0;0
7321;19708;157;99;33;1;32;.970;3900000;0
7321;170612;80;0;0;0;0;.00nan;0;0
7322;2410;81;43;25;4;21;.840;2163000;0
7322;-1;151;0;0;0;0;.00nan;0;0
7322;70213;81;54;4;0;4;1.000;1379000;0
7322;85507;151;75;37;3;34;.919;3600000;0
7323;-1;78;78;28;1;27;.964;3600000;0
7323;169154;78;0;0;0;0;.00nan;0;0
7323;85555;76;70;29;3;26;.897;3576000;0
7323;91703;76;0;0;0;0;.00nan;0;0
7324;163195;67;0;0;0;0;.00nan;0;0
7324;-1;4620;0;0;0;0;.00nan;0;0
7324;173961;4620;57;21;2;19;.905;3883000;0
7324;38124;67;88;49;3;46;.939;3883000;0
7325;181446;71;69;46;5;41;.891;3600000;0
7325;37942;1095;75;31;2;29;.935;3600000;0
7325;79141;1095;0;0;0;0;.00nan;0;0
7325;85984;71;0;0;0;0;.00nan;0;0
7326;163784;77;0;0;0;0;.00nan;0;0
7326;170728;1097;89;28;1;27;.964;3600000;0
7326;43928;1097;0;0;0;0;.00nan;0;0
7326;161047;77;100;36;0;36;1.000;3600000;0
7327;165380;72;63;21;2;19;.905;3600000;0
7327;180873;69;0;0;0;0;.00nan;0;0
7327;79211;69;75;36;3;33;.917;3545000;0
7327;85228;72;0;0;0;0;.00nan;0;0
7328;-1;149;0;0;0;0;.00nan;0;0
7328;178911;152;0;0;0;0;.00nan;0;0
7328;178950;152;99;48;2;46;.958;3600000;0
7328;141419;149;66;26;3;23;.885;3600000;0
7329;5559;4245;38;18;4;14;.778;3600000;0
7329;181123;4920;57;34;5;29;.853;3549000;0
7329;149450;4920;0;0;0;0;.00nan;0;0
7329;149858;4245;0;0;0;0;.00nan;0;0
7330;-1;4922;98;37;1;36;.973;2398000;0
7330;85349;82;54;21;3;18;.857;3600000;0
7330;86151;82;0;0;0;0;.00nan;0;0
7330;91742;4922;30;17;4;13;.765;1187000;0
7331;181269;85;91;27;1;26;.963;3600000;0
7331;85437;4921;0;0;0;0;.00nan;0;0
7331;152418;4921;68;25;2;23;.920;3547000;0
7331;152624;85;0;0;0;0;.00nan;0;0
7332;-1;74;65;33;4;29;.879;3600000;0
7332;-1;1096;43;33;6;27;.818;3303000;0
7332;180606;74;0;0;0;0;.00nan;0;0
7332;141978;1096;52;3;0;3;1.000;280000;0
7333;164913;75;53;30;4;26;.867;3569000;0
7333;173856;75;0;0;0;0;.00nan;0;0
7333;173874;158;0;0;0;0;.00nan;0;0
7333;181071;158;63;29;3;26;.897;3600000;0
7334;2495;73;91;38;3;35;.921;3611000;0
7334;13325;2564;0;0;0;0;.00nan;0;0
7334;166441;2564;42;28;4;24;.857;3611000;0
7334;57657;73;0;0;0;0;.00nan;0;0
7335;163989;80;49;1;0;1;1.000;418000;0
7335;164987;157;0;0;0;0;.00nan;0;0
7335;19708;157;62;29;3;26;.897;3600000;0
7335;170612;80;17;22;6;16;.727;3182000;0
7336;2410;81;61;13;1;12;.923;3600000;0
7336;-1;151;70;50;5;45;.900;3600000;0
7336;70213;81;0;0;0;0;.00nan;0;0
7336;85507;151;0;0;0;0;.00nan;0;0
7337;-1;78;0;0;0;0;.00nan;0;0
7337;169154;78;41;30;5;25;.833;3600000;0
7337;85555;76;0;0;0;0;.00nan;0;0
7337;91703;76;87;36;2;34;.944;3600000;0
7338;163195;67;79;42;3;39;.929;3719000;0
7338;38124;67;0;0;0;0;.00nan;0;0
7338;85555;76;68;26;2;24;.923;3719000;0
7338;91703;76;0;0;0;0;.00nan;0;0
7339;13325;2564;71;30;3;27;.900;3554000;0
7339;165380;72;0;0;0;0;.00nan;0;0
7339;166441;2564;0;0;0;0;.00nan;0;0
7339;85228;72;96;41;2;39;.951;3600000;0
7340;5559;4245;0;0;0;0;.00nan;0;0
7340;181123;4920;0;0;0;0;.00nan;0;0
7340;149450;4920;54;30;3;27;.900;3900000;0
7340;149858;4245;67;35;3;32;.914;3900000;0
7341;164913;75;0;0;0;0;.00nan;0;0
7341;173856;75;69;31;2;29;.935;3600000;0
7341;173874;158;67;35;3;32;.914;3568000;0
7341;181071;158;0;0;0;0;.00nan;0;0
7342;2495;73;0;0;0;0;.00nan;0;0
7342;37942;1095;0;0;0;0;.00nan;0;0
7342;57657;73;84;35;2;33;.943;3600000;0
7342;79141;1095;76;29;1;28;.966;3600000;0
7343;163989;80;70;50;6;44;.880;3084000;0
7343;164987;157;0;0;0;0;.00nan;0;0
7343;19708;157;46;25;4;21;.840;3600000;0
7343;170612;80;48;7;1;6;.857;516000;0
7344;-1;78;84;35;2;33;.943;3600000;0
7344;-1;4620;61;24;3;21;.875;3564000;0
7344;169154;78;0;0;0;0;.00nan;0;0
7344;173961;4620;0;0;0;0;.00nan;0;0
7345;-1;151;79;38;3;35;.921;3600000;0
7345;178911;152;65;24;2;22;.917;3600000;0
7345;178950;152;0;0;0;0;.00nan;0;0
7345;85507;151;0;0;0;0;.00nan;0;0
7346;37942;1095;0;0;0;0;.00nan;0;0
7346;79141;1095;79;37;3;34;.919;3600000;0
7346;85437;4921;0;0;0;0;.00nan;0;0
7346;152418;4921;72;40;4;36;.900;3585000;0
7347;164987;157;0;0;0;0;.00nan;0;0
7347;-1;149;37;29;6;23;.793;2763000;0
7347;19708;157;73;24;2;22;.917;3600000;0
7347;141419;149;49;7;1;6;.857;837000;0
7348;-1;74;100;44;0;44;1.000;3600000;0
7348;170728;1097;0;0;0;0;.00nan;0;0
7348;180606;74;0;0;0;0;.00nan;0;0
7348;43928;1097;76;32;2;30;.938;3568000;0
7349;163195;67;82;38;3;35;.921;3600000;0
7349;181269;85;57;36;4;32;.889;3562000;0
7349;38124;67;0;0;0;0;.00nan;0;0
7349;152624;85;0;0;0;0;.00nan;0;0
7350;181446;71;0;0;0;0;.00nan;0;0
7350;37942;1095;0;0;0;0;.00nan;0;0
7350;79141;1095;80;34;2;32;.941;3593000;0
7350;85984;71;81;25;1;24;.960;3600000;0
7351;163784;77;0;0;0;0;.00nan;0;0
7351;164913;75;0;0;0;0;.00nan;0;0
7351;173856;75;96;41;1;40;.976;3900000;0
7351;161047;77;97;32;1;31;.969;3900000;0
7352;164987;157;0;0;0;0;.00nan;0;0
7352;-1;149;47;22;4;18;.818;1170000;0
7352;19708;157;78;30;2;28;.933;3600000;0
7352;141419;149;48;22;3;19;.864;2430000;0
7353;-1;74;77;38;3;35;.921;3900000;0
7353;180606;74;0;0;0;0;.00nan;0;0
7353;85349;82;0;0;0;0;.00nan;0;0
7353;86151;82;59;26;3;23;.885;3900000;0
7354;13325;2564;61;27;3;24;.889;3600000;0
7354;166441;2564;0;0;0;0;.00nan;0;0
7354;180873;69;69;38;4;34;.895;3600000;0
7354;79211;69;0;0;0;0;.00nan;0;0
7355;2410;81;59;33;4;29;.879;3600000;0
7355;5559;4245;0;0;0;0;.00nan;0;0
7355;70213;81;0;0;0;0;.00nan;0;0
7355;149858;4245;94;35;1;34;.971;3600000;0
7356;165380;72;0;0;0;0;.00nan;0;0
7356;181123;4920;71;26;2;24;.923;3600000;0
7356;85228;72;69;42;4;38;.905;3600000;0
7356;149450;4920;0;0;0;0;.00nan;0;0
7357;170728;1097;0;0;0;0;.00nan;0;0
7357;-1;1096;0;0;0;0;.00nan;0;0
7357;43928;1097;100;41;1;40;.976;3600000;0
7357;141978;1096;78;44;3;41;.932;3542000;0
7358;57657;73;40;36;6;30;.833;2818000;0
7358;85555;76;43;22;4;18;.818;3600000;0
7358;86472;73;65;14;1;13;.929;782000;0
7358;91703;76;0;0;0;0;.00nan;0;0
7359;-1;78;0;0;0;0;.00nan;0;0
7359;-1;4620;94;22;0;22;1.000;3600000;0
7359;169154;78;65;37;4;33;.892;3600000;0
7359;173961;4620;0;0;0;0;.00nan;0;0
7360;163989;80;69;23;1;22;.957;3600000;0
7360;-1;151;80;28;2;26;.929;3546000;0
7360;170612;80;0;0;0;0;.00nan;0;0
7360;85507;151;0;0;0;0;.00nan;0;0
7361;-1;4922;0;0;0;0;.00nan;0;0
7361;85437;4921;82;27;1;26;.963;3600000;0
7361;91742;4922;98;61;5;56;.918;3600000;0
7361;152418;4921;0;0;0;0;.00nan;0;0
7362;173874;158;66;26;3;23;.885;3600000;0
7362;178911;152;67;39;4;35;.897;3564000;0
7362;178950;152;0;0;0;0;.00nan;0;0
7362;181071;158;0;0;0;0;.00nan;0;0
7363;164913;75;68;60;7;53;.883;3600000;0
7363;173856;75;0;0;0;0;.00nan;0;0
7363;85349;82;61;13;1;12;.923;3600000;0
7363;86151;82;0;0;0;0;.00nan;0;0
7364;181446;71;96;29;1;28;.966;3600000;0
7364;37942;1095;40;26;4;22;.846;3600000;0
7364;79141;1095;0;0;0;0;.00nan;0;0
7364;85984;71;0;0;0;0;.00nan;0;0
7365;163784;77;0;0;0;0;.00nan;0;0
7365;-1;74;0;0;0;0;.00nan;0;0
7365;180606;74;30;22;5;17;.773;3545000;0
7365;161047;77;49;33;4;29;.879;3600000;0
7366;164987;157;0;0;0;0;.00nan;0;0
7366;-1;149;30;15;4;11;.733;914000;0
7366;19708;157;89;31;2;29;.935;3600000;0
7366;141419;149;81;24;1;23;.958;2686000;0
7367;13325;2564;0;0;0;0;.00nan;0;0
7367;166441;2564;54;28;4;24;.857;3600000;0
7367;180873;69;0;0;0;0;.00nan;0;0
7367;79211;69;84;51;5;46;.902;3565000;0
7368;173874;158;0;0;0;0;.00nan;0;0
7368;178911;152;0;0;0;0;.00nan;0;0
7368;178950;152;57;32;4;28;.875;3632000;0
7368;181071;158;32;23;5;18;.783;3632000;0
7369;2410;81;0;0;0;0;.00nan;0;0
7369;5559;4245;75;26;2;24;.923;3600000;0
7369;70213;81;44;18;3;15;.833;3554000;0
7369;149858;4245;0;0;0;0;.00nan;0;0
7370;165380;72;55;33;4;29;.879;3543000;0
7370;181123;4920;0;0;0;0;.00nan;0;0
7370;85228;72;0;0;0;0;.00nan;0;0
7370;149450;4920;75;33;3;30;.909;3600000;0
7371;163195;67;0;0;0;0;.00nan;0;0
7371;181269;85;0;0;0;0;.00nan;0;0
7371;38124;67;60;38;5;33;.868;3525000;0
7371;152624;85;67;31;3;28;.903;3600000;0
7372;170728;1097;42;22;4;18;.818;3900000;0
7372;-1;1096;62;33;4;29;.879;3900000;0
7372;43928;1097;0;0;0;0;.00nan;0;0
7372;141978;1096;0;0;0;0;.00nan;0;0
7373;57657;73;53;38;5;33;.868;3600000;0
7373;85555;76;0;0;0;0;.00nan;0;0
7373;86472;73;0;0;0;0;.00nan;0;0
7373;91703;76;76;21;1;20;.952;3600000;0
7374;-1;78;78;29;2;27;.931;3600000;0
7374;-1;4620;74;33;3;30;.909;3543000;0
7374;169154;78;0;0;0;0;.00nan;0;0
7374;173961;4620;0;0;0;0;.00nan;0;0
7375;163989;80;0;0;0;0;.00nan;0;0
7375;-1;151;0;0;0;0;.00nan;0;0
7375;170612;80;91;32;1;31;.969;3600000;0
7375;85507;151;98;47;2;45;.957;3600000;0
7376;-1;4922;0;0;0;0;.00nan;0;0
7376;85437;4921;54;24;4;20;.833;3900000;0
7376;91742;4922;76;44;4;40;.909;3900000;0
7376;152418;4921;0;0;0;0;.00nan;0;0
7377;164913;75;0;0;0;0;.00nan;0;0
7377;173856;75;78;37;3;34;.919;3600000;0
7377;85349;82;0;0;0;0;.00nan;0;0
7377;86151;82;73;18;1;17;.944;3600000;0
7378;13325;2564;53;22;3;19;.864;3600000;0
7378;166441;2564;0;0;0;0;.00nan;0;0
7378;181446;71;0;0;0;0;.00nan;0;0
7378;85984;71;87;46;4;42;.913;3600000;0
7379;163784;77;0;0;0;0;.00nan;0;0
7379;-1;1096;0;0;0;0;.00nan;0;0
7379;141978;1096;58;35;5;30;.857;3600000;0
7379;161047;77;83;41;2;39;.951;3600000;0
7380;2410;81;54;30;4;26;.867;3575000;0
7380;5559;4245;0;0;0;0;.00nan;0;0
7380;70213;81;0;0;0;0;.00nan;0;0
7380;149858;4245;69;39;3;36;.923;3600000;0
7381;165380;72;0;0;0;0;.00nan;0;0
7381;181123;4920;49;29;4;25;.862;3874000;0
7381;85228;72;96;54;4;50;.926;3900000;0
7381;149450;4920;0;0;0;0;.00nan;0;0
7382;163195;67;100;39;2;37;.949;3600000;0
7382;181269;85;57;28;3;25;.893;3575000;0
7382;38124;67;0;0;0;0;.00nan;0;0
7382;152624;85;0;0;0;0;.00nan;0;0
7383;57657;73;0;0;0;0;.00nan;0;0
7383;85555;76;38;37;6;31;.838;3600000;0
7383;86472;73;100;40;1;39;.975;3600000;0
7383;91703;76;0;0;0;0;.00nan;0;0
7384;163989;80;93;45;2;43;.956;3600000;0
7384;-1;151;37;29;5;24;.828;2081000;0
7384;170612;80;0;0;0;0;.00nan;0;0
7384;85507;151;66;13;0;13;1.000;1519000;0
7385;-1;4922;0;0;0;0;.00nan;0;0
7385;85437;4921;93;41;2;39;.951;3900000;0
7385;91742;4922;82;35;2;33;.943;3900000;0
7385;152418;4921;0;0;0;0;.00nan;0;0
7386;173874;158;50;30;4;26;.867;3528000;0
7386;178911;152;78;32;2;30;.938;3600000;0
7386;178950;152;0;0;0;0;.00nan;0;0
7386;181071;158;0;0;0;0;.00nan;0;0
7387;181269;85;68;43;4;39;.907;3600000;0
7387;85437;4921;29;18;4;14;.778;821000;0
7387;152418;4921;54;26;3;23;.885;2779000;0
7387;152624;85;0;0;0;0;.00nan;0;0
7388;163989;80;83;39;4;35;.897;3551000;0
7388;-1;149;0;0;0;0;.00nan;0;0
7388;170612;80;0;0;0;0;.00nan;0;0
7388;141419;149;65;31;3;28;.903;3600000;0
7389;163195;67;85;35;2;33;.943;3900000;0
7389;170728;1097;0;0;0;0;.00nan;0;0
7389;38124;67;0;0;0;0;.00nan;0;0
7389;43928;1097;83;32;2;30;.938;3900000;0
7390;13325;2564;65;44;5;39;.886;3600000;0
7390;166441;2564;0;0;0;0;.00nan;0;0
7390;180873;69;0;0;0;0;.00nan;0;0
7390;79211;69;82;30;2;28;.933;3600000;0
7391;-1;74;79;27;1;26;.963;3600000;0
7391;-1;4922;0;0;0;0;.00nan;0;0
7391;180606;74;0;0;0;0;.00nan;0;0
7391;91742;4922;56;40;5;35;.875;3600000;0
7392;178911;152;66;34;3;31;.912;3600000;0
7392;178950;152;0;0;0;0;.00nan;0;0
7392;181446;71;0;0;0;0;.00nan;0;0
7392;85984;71;72;27;2;25;.926;3600000;0
7393;165380;72;0;0;0;0;.00nan;0;0
7393;85228;72;96;40;2;38;.950;3531000;0
7393;85349;82;0;0;0;0;.00nan;0;0
7393;86151;82;98;21;0;21;1.000;3600000;0
7394;163784;77;0;0;0;0;.00nan;0;0
7394;181123;4920;0;0;0;0;.00nan;0;0
7394;149450;4920;69;24;2;22;.917;3600000;0
7394;161047;77;82;47;4;43;.915;3600000;0
7395;164913;75;0;0;0;0;.00nan;0;0
7395;173856;75;68;40;4;36;.900;3551000;0
7395;-1;1096;0;0;0;0;.00nan;0;0
7395;141978;1096;56;26;3;23;.885;3600000;0
7396;173874;158;58;34;4;30;.882;3600000;0
7396;181071;158;0;0;0;0;.00nan;0;0
7396;181446;71;72;37;3;34;.919;3600000;0
7396;85984;71;0;0;0;0;.00nan;0;0
7397;163989;80;51;35;5;30;.857;3586000;0
7397;-1;149;65;39;4;35;.897;3600000;0
7397;170612;80;0;0;0;0;.00nan;0;0
7397;141419;149;0;0;0;0;.00nan;0;0
7398;163195;67;79;42;4;38;.905;3600000;0
7398;170728;1097;70;18;1;17;.944;3600000;0
7398;38124;67;0;0;0;0;.00nan;0;0
7398;43928;1097;0;0;0;0;.00nan;0;0
7399;165380;72;0;0;0;0;.00nan;0;0
7399;85228;72;68;45;5;40;.889;3600000;0
7399;85349;82;0;0;0;0;.00nan;0;0
7399;86151;82;75;24;2;22;.917;3600000;0
7400;180873;69;76;49;5;44;.898;3600000;0
7400;37942;1095;0;0;0;0;.00nan;0;0
7400;79141;1095;52;20;3;17;.850;3600000;0
7400;79211;69;0;0;0;0;.00nan;0;0
7401;163784;77;0;0;0;0;.00nan;0;0
7401;181123;4920;78;38;3;35;.921;3544000;0
7401;149450;4920;0;0;0;0;.00nan;0;0
7401;161047;77;74;30;2;28;.933;3600000;0
7402;-1;4620;67;31;4;27;.871;3529000;0
7402;173961;4620;0;0;0;0;.00nan;0;0
7402;85555;76;91;40;2;38;.950;3600000;0
7402;91703;76;0;0;0;0;.00nan;0;0
7403;-1;74;39;29;6;23;.793;3517000;0
7403;-1;4922;0;0;0;0;.00nan;0;0
7403;180606;74;0;0;0;0;.00nan;0;0
7403;91742;4922;92;49;4;45;.918;3600000;0
7404;2410;81;96;36;1;35;.972;3600000;0
7404;178911;152;34;31;6;25;.806;3600000;0
7404;178950;152;0;0;0;0;.00nan;0;0
7404;70213;81;0;0;0;0;.00nan;0;0
7405;164913;75;98;39;2;37;.949;3593000;0
7405;173856;75;0;0;0;0;.00nan;0;0
7405;-1;1096;61;13;1;12;.923;3600000;0
7405;141978;1096;0;0;0;0;.00nan;0;0
7406;13325;2564;46;39;7;32;.821;2804000;0
7406;166441;2564;77;16;1;15;.938;796000;0
7406;57657;73;78;39;3;36;.923;3600000;0
7406;86472;73;0;0;0;0;.00nan;0;0
7407;164987;157;0;0;0;0;.00nan;0;0
7407;-1;151;0;0;0;0;.00nan;0;0
7407;19708;157;77;24;1;23;.958;3600000;0
7407;85507;151;86;39;2;37;.949;3600000;0
7408;181269;85;70;57;7;50;.877;3600000;0
7408;85437;4921;0;0;0;0;.00nan;0;0
7408;152418;4921;71;25;2;23;.920;3600000;0
7408;152624;85;0;0;0;0;.00nan;0;0
7409;5559;4245;0;0;0;0;.00nan;0;0
7409;-1;78;0;0;0;0;.00nan;0;0
7409;169154;78;67;30;3;27;.900;3566000;0
7409;149858;4245;91;39;2;37;.949;3600000;0
7410;163989;80;0;0;0;0;.00nan;0;0
7410;-1;149;0;0;0;0;.00nan;0;0
7410;170612;80;89;42;3;39;.929;3545000;0
7410;141419;149;66;22;2;20;.909;3600000;0
7411;163195;67;99;42;2;40;.952;3600000;0
7411;170728;1097;0;0;0;0;.00nan;0;0
7411;38124;67;0;0;0;0;.00nan;0;0
7411;43928;1097;70;38;4;34;.895;3562000;0
7412;164987;157;0;0;0;0;.00nan;0;0
7412;-1;151;24;7;3;4;.571;465000;0
7412;19708;157;62;22;2;20;.909;3600000;0
7412;85507;151;89;43;3;40;.930;3135000;0
7413;165380;72;70;56;6;50;.893;3600000;0
7413;85228;72;0;0;0;0;.00nan;0;0
7413;85349;82;45;10;2;8;.800;3600000;0
7413;86151;82;0;0;0;0;.00nan;0;0
7414;180873;69;56;5;0;5;1.000;370000;0
7414;37942;1095;83;29;1;28;.966;3600000;0
7414;79141;1095;0;0;0;0;.00nan;0;0
7414;79211;69;25;25;6;19;.760;3230000;0
7415;-1;74;0;0;0;0;.00nan;0;0
7415;-1;4922;0;0;0;0;.00nan;0;0
7415;180606;74;60;27;3;24;.889;3600000;0
7415;91742;4922;99;43;2;41;.953;3600000;0
7416;13325;2564;0;0;0;0;.00nan;0;0
7416;166441;2564;74;45;3;42;.933;3563000;0
7416;57657;73;0;0;0;0;.00nan;0;0
7416;86472;73;72;24;2;22;.917;3600000;0
7417;163784;77;0;0;0;0;.00nan;0;0
7417;181123;4920;0;0;0;0;.00nan;0;0
7417;149450;4920;71;29;2;27;.931;3600000;0
7417;161047;77;50;25;4;21;.840;3574000;0
7418;-1;4620;0;0;0;0;.00nan;0;0
7418;173961;4620;44;26;4;22;.846;3600000;0
7418;85555;76;0;0;0;0;.00nan;0;0
7418;91703;76;29;32;6;26;.813;3514000;0
7419;2410;81;0;0;0;0;.00nan;0;0
7419;178911;152;0;0;0;0;.00nan;0;0
7419;178950;152;87;43;3;40;.930;3600000;0
7419;70213;81;94;22;0;22;1.000;3600000;0
7420;164913;75;0;0;0;0;.00nan;0;0
7420;173856;75;77;43;3;40;.930;3600000;0
7420;-1;1096;0;0;0;0;.00nan;0;0
7420;141978;1096;67;38;4;34;.895;3556000;0
7421;181269;85;0;0;0;0;.00nan;0;0
7421;85437;4921;40;27;5;22;.815;3600000;0
7421;152418;4921;0;0;0;0;.00nan;0;0
7421;152624;85;84;30;2;28;.933;3600000;0
7422;173874;158;0;0;0;0;.00nan;0;0
7422;181071;158;57;27;4;23;.852;3600000;0
7422;181446;71;0;0;0;0;.00nan;0;0
7422;85984;71;42;31;5;26;.839;3589000;0
7423;5559;4245;84;38;4;34;.895;3600000;0
7423;-1;78;31;25;5;20;.800;3547000;0
7423;169154;78;0;0;0;0;.00nan;0;0
7423;149858;4245;0;0;0;0;.00nan;0;0
7424;164913;75;0;0;0;0;.00nan;0;0
7424;173856;75;83;41;3;38;.927;3600000;0
7424;85349;82;0;0;0;0;.00nan;0;0
7424;86151;82;70;20;1;19;.950;3600000;0
7425;-1;149;0;0;0;0;.00nan;0;0
7425;173874;158;66;36;4;32;.889;3600000;0
7425;181071;158;0;0;0;0;.00nan;0;0
7425;141419;149;33;27;5;22;.815;3560000;0
7426;165380;72;45;3;1;2;.667;511000;0
7426;180873;69;60;43;6;37;.860;3679000;0
7426;44189;72;19;22;6;16;.727;3168000;0
7426;79211;69;0;0;0;0;.00nan;0;0
7427;2410;81;0;0;0;0;.00nan;0;0
7427;164987;157;0;0;0;0;.00nan;0;0
7427;19708;157;79;28;2;26;.929;3600000;0
7427;70213;81;39;25;4;21;.840;3513000;0
7428;163989;80;100;44;0;44;1.000;3600000;0
7428;178911;152;56;30;4;26;.867;3600000;0
7428;178950;152;0;0;0;0;.00nan;0;0
7428;170612;80;0;0;0;0;.00nan;0;0
7429;163195;67;49;33;5;28;.848;3600000;0
7429;181269;85;26;21;6;15;.714;1986000;0
7429;38124;67;0;0;0;0;.00nan;0;0
7429;152624;85;52;17;3;14;.824;1614000;0
7430;-1;1096;0;0;0;0;.00nan;0;0
7430;85349;82;0;0;0;0;.00nan;0;0
7430;86151;82;86;28;1;27;.964;3600000;0
7430;141978;1096;75;39;3;36;.923;3527000;0
7431;37942;1095;0;0;0;0;.00nan;0;0
7431;57657;73;0;0;0;0;.00nan;0;0
7431;79141;1095;43;33;5;28;.848;3588000;0
7431;86472;73;75;41;4;37;.902;3600000;0
7432;163784;77;0;0;0;0;.00nan;0;0
7432;164913;75;0;0;0;0;.00nan;0;0
7432;173856;75;47;23;3;20;.870;3895000;0
7432;161047;77;54;19;3;16;.842;3900000;0
7433;165380;72;44;2;1;1;.500;261000;0
7433;180873;69;45;35;6;29;.829;2441000;0
7433;44189;72;13;24;7;17;.708;3352000;0
7433;79211;69;62;13;1;12;.923;1172000;0
7434;-1;74;82;45;4;41;.911;3740000;0
7434;170728;1097;87;36;3;33;.917;3740000;0
7434;180606;74;0;0;0;0;.00nan;0;0
7434;43928;1097;0;0;0;0;.00nan;0;0
7435;13325;2564;19;15;5;10;.667;1723000;0
7435;166441;2564;88;30;1;29;.967;1877000;0
7435;181446;71;0;0;0;0;.00nan;0;0
7435;85984;71;79;26;1;25;.962;3600000;0
7436;5559;4245;0;0;0;0;.00nan;0;0
7436;85555;76;27;24;6;18;.750;2350000;0
7436;91703;76;41;4;1;3;.750;1198000;0
7436;149858;4245;66;50;5;45;.900;3600000;0
7437;-1;78;0;0;0;0;.00nan;0;0
7437;169154;78;47;19;3;16;.842;3551000;0
7437;-1;4922;0;0;0;0;.00nan;0;0
7437;91742;4922;87;38;2;36;.947;3600000;0
7438;2410;81;93;16;0;16;1.000;3600000;0
7438;164987;157;0;0;0;0;.00nan;0;0
7438;19708;157;61;20;2;18;.900;3587000;0
7438;70213;81;0;0;0;0;.00nan;0;0
7439;163989;80;65;27;3;24;.889;3900000;0
7439;-1;149;76;32;3;29;.906;3900000;0
7439;170612;80;0;0;0;0;.00nan;0;0
7439;141419;149;0;0;0;0;.00nan;0;0
7440;-1;151;0;0;0;0;.00nan;0;0
7440;85437;4921;82;29;2;27;.931;3600000;0
7440;85507;151;80;44;4;40;.909;3563000;0
7440;152418;4921;0;0;0;0;.00nan;0;0
7441;173874;158;88;43;2;41;.953;3577000;0
7441;178911;152;0;0;0;0;.00nan;0;0
7441;178950;152;90;31;1;30;.968;3600000;0
7441;181071;158;0;0;0;0;.00nan;0;0
7442;163195;67;53;50;6;44;.880;3600000;0
7442;-1;4620;100;26;0;26;1.000;3600000;0
7442;173961;4620;0;0;0;0;.00nan;0;0
7442;38124;67;0;0;0;0;.00nan;0;0
7443;163989;80;0;0;0;0;.00nan;0;0
7443;-1;149;0;0;0;0;.00nan;0;0
7443;170612;80;77;22;1;21;.955;3600000;0
7443;141419;149;86;43;3;40;.930;3548000;0
7444;181446;71;69;26;2;24;.923;3552000;0
7444;37942;1095;91;30;1;29;.967;3600000;0
7444;79141;1095;0;0;0;0;.00nan;0;0
7444;85984;71;0;0;0;0;.00nan;0;0
7445;163784;77;89;45;3;42;.933;3900000;0
7445;85349;82;49;19;3;16;.842;3900000;0
7445;86151;82;0;0;0;0;.00nan;0;0
7445;161047;77;0;0;0;0;.00nan;0;0
7446;165380;72;0;0;0;0;.00nan;0;0
7446;180873;69;55;11;1;10;.909;1142000;0
7446;44189;72;75;42;4;38;.905;3600000;0
7446;79211;69;41;27;5;22;.815;2373000;0
7447;-1;74;68;23;2;21;.913;3600000;0
7447;-1;1096;0;0;0;0;.00nan;0;0
7447;180606;74;0;0;0;0;.00nan;0;0
7447;141978;1096;62;42;4;38;.905;3570000;0
7448;13325;2564;0;0;0;0;.00nan;0;0
7448;166441;2564;100;33;0;33;1.000;3600000;0
7448;57657;73;29;9;3;6;.667;930000;0
7448;86472;73;40;33;6;27;.818;2670000;0
7449;173874;158;0;0;0;0;.00nan;0;0
7449;178911;152;43;25;4;21;.840;3583000;0
7449;178950;152;0;0;0;0;.00nan;0;0
7449;181071;158;99;39;2;37;.949;3600000;0
7450;5559;4245;0;0;0;0;.00nan;0;0
7450;85555;76;0;0;0;0;.00nan;0;0
7450;91703;76;65;27;3;24;.889;3543000;0
7450;149858;4245;68;23;2;21;.913;3600000;0
7451;-1;78;53;14;2;12;.857;3899000;0
7451;169154;78;0;0;0;0;.00nan;0;0
7451;-1;4922;88;47;2;45;.957;3900000;0
7451;91742;4922;0;0;0;0;.00nan;0;0
7452;2410;81;36;29;5;24;.828;2966000;0
7452;164987;157;54;20;3;17;.850;3600000;0
7452;19708;157;0;0;0;0;.00nan;0;0
7452;70213;81;22;11;4;7;.636;634000;0
7453;181123;4920;0;0;0;0;.00nan;0;0
7453;181269;85;100;40;0;40;1.000;3600000;0
7453;149450;4920;22;16;5;11;.688;3600000;0
7453;152624;85;0;0;0;0;.00nan;0;0
7454;164913;75;20;32;7;25;.781;3178000;0
7454;173856;75;53;3;0;3;1.000;422000;0
7454;170728;1097;0;0;0;0;.00nan;0;0
7454;43928;1097;52;31;4;27;.871;3600000;0
7455;-1;151;88;52;4;48;.923;3600000;0
7455;85437;4921;0;0;0;0;.00nan;0;0
7455;85507;151;0;0;0;0;.00nan;0;0
7455;152418;4921;88;21;0;21;1.000;3600000;0
7456;163784;77;0;0;0;0;.00nan;0;0
7456;85349;82;0;0;0;0;.00nan;0;0
7456;86151;82;46;12;3;9;.750;3600000;0
7456;161047;77;76;58;6;52;.897;3600000;0
7457;181446;71;0;0;0;0;.00nan;0;0
7457;37942;1095;0;0;0;0;.00nan;0;0
7457;79141;1095;100;23;0;23;1.000;3600000;0
7457;85984;71;60;31;3;28;.903;3600000;0
7458;-1;74;0;0;0;0;.00nan;0;0
7458;-1;1096;0;0;0;0;.00nan;0;0
7458;180606;74;61;35;4;31;.886;3600000;0
7458;141978;1096;81;32;3;29;.906;3600000;0
7459;5559;4245;0;0;0;0;.00nan;0;0
7459;85555;76;58;35;4;31;.886;3550000;0
7459;91703;76;0;0;0;0;.00nan;0;0
7459;149858;4245;96;43;2;41;.953;3600000;0
7460;-1;78;0;0;0;0;.00nan;0;0
7460;169154;78;63;27;3;24;.889;3600000;0
7460;-1;4922;0;0;0;0;.00nan;0;0
7460;91742;4922;73;40;4;36;.900;3554000;0
7461;164913;75;0;0;0;0;.00nan;0;0
7461;173856;75;83;24;1;23;.958;3600000;0
7461;170728;1097;19;28;7;21;.750;2745000;0
7461;43928;1097;52;3;0;3;1.000;855000;0
7462;163989;80;50;29;5;24;.828;3600000;0
7462;173874;158;90;53;2;51;.962;3600000;0
7462;170612;80;0;0;0;0;.00nan;0;0
7462;181071;158;0;0;0;0;.00nan;0;0
7463;181123;4920;0;0;0;0;.00nan;0;0
7463;181269;85;42;24;4;20;.833;3600000;0
7463;149450;4920;26;25;6;19;.760;3568000;0
7463;152624;85;0;0;0;0;.00nan;0;0
7464;-1;151;37;14;3;11;.786;1082000;0
7464;85437;4921;0;0;0;0;.00nan;0;0
7464;85507;151;39;32;6;26;.813;2518000;0
7464;152418;4921;58;21;2;19;.905;3600000;0
7465;-1;78;0;0;0;0;.00nan;0;0
7465;169154;78;74;32;3;29;.906;3600000;0
7465;170728;1097;49;7;1;6;.857;733000;0
7465;43928;1097;41;28;5;23;.821;2867000;0
7466;173874;158;21;20;6;14;.700;1489000;0
7466;180873;69;75;33;3;30;.909;3600000;0
7466;181071;158;60;19;2;17;.895;2111000;0
7466;79211;69;0;0;0;0;.00nan;0;0
7467;5559;4245;81;32;2;30;.938;2405000;0
7467;13325;2564;0;0;0;0;.00nan;0;0
7467;166441;2564;64;22;2;20;.909;3600000;0
7467;149858;4245;23;16;4;12;.750;1195000;0
7468;181123;4920;0;0;0;0;.00nan;0;0
7468;181269;85;62;41;4;37;.902;3600000;0
7468;149450;4920;93;31;1;30;.968;3600000;0
7468;152624;85;0;0;0;0;.00nan;0;0
7469;164913;75;0;0;0;0;.00nan;0;0
7469;173856;75;56;29;3;26;.897;3562000;0
7469;85349;82;0;0;0;0;.00nan;0;0
7469;86151;82;61;22;2;20;.909;3600000;0
7470;2410;81;63;23;2;21;.913;3600000;0
7470;163784;77;0;0;0;0;.00nan;0;0
7470;70213;81;0;0;0;0;.00nan;0;0
7470;161047;77;50;34;5;29;.853;3600000;0
7471;163195;67;65;30;3;27;.900;3570000;0
7471;181269;85;99;35;1;34;.971;3600000;0
7471;38124;67;0;0;0;0;.00nan;0;0
7471;152624;85;0;0;0;0;.00nan;0;0
7472;180873;69;52;40;7;33;.825;3600000;0
7472;37942;1095;0;0;0;0;.00nan;0;0
7472;79141;1095;84;39;3;36;.923;3600000;0
7472;79211;69;0;0;0;0;.00nan;0;0
7473;-1;78;0;0;0;0;.00nan;0;0
7473;170728;1097;0;0;0;0;.00nan;0;0
7473;43928;1097;56;22;3;19;.864;3600000;0
7473;86344;78;42;37;6;31;.838;3600000;0
7474;5559;72;86;48;2;46;.958;3600000;0
7474;173874;158;88;33;3;30;.909;3600000;0
7474;181071;158;0;0;0;0;.00nan;0;0
7474;44189;72;0;0;0;0;.00nan;0;0
7475;-1;151;0;0;0;0;.00nan;0;0
7475;178911;152;52;3;0;3;1.000;699000;0
7475;178950;152;8;21;7;14;.667;2901000;0
7475;85507;151;64;48;6;42;.875;3600000;0
7476;164913;75;0;0;0;0;.00nan;0;0
7476;173856;75;61;44;5;39;.886;3600000;0
7476;85555;76;72;25;2;23;.920;3600000;0
7476;91703;76;0;0;0;0;.00nan;0;0
7477;-1;74;89;35;1;34;.971;3600000;0
7477;-1;4922;0;0;0;0;.00nan;0;0
7477;180606;74;0;0;0;0;.00nan;0;0
7477;91742;4922;39;26;5;21;.808;3600000;0
7478;-1;1096;0;0;0;0;.00nan;0;0
7478;85349;82;0;0;0;0;.00nan;0;0
7478;86151;82;100;22;0;22;1.000;3600000;0
7478;141978;1096;54;49;6;43;.878;3600000;0
7479;175658;4245;0;0;0;0;.00nan;0;0
7479;57657;73;64;30;3;27;.900;3600000;0
7479;86472;73;0;0;0;0;.00nan;0;0
7479;149858;4245;46;32;5;27;.844;3600000;0
7480;-1;4620;71;35;3;32;.914;3600000;0
7480;173961;4620;0;0;0;0;.00nan;0;0
7480;181123;4920;0;0;0;0;.00nan;0;0
7480;149450;4920;62;34;4;30;.882;3551000;0
7481;163989;80;100;48;2;46;.958;3600000;0
7481;164987;157;0;0;0;0;.00nan;0;0
7481;19708;157;56;24;3;21;.875;3595000;0
7481;170612;80;0;0;0;0;.00nan;0;0
7482;181446;71;66;50;5;45;.900;3600000;0
7482;85437;4921;74;31;2;29;.935;3600000;0
7482;85984;71;0;0;0;0;.00nan;0;0
7482;152418;4921;0;0;0;0;.00nan;0;0
7483;163195;67;0;0;0;0;.00nan;0;0
7483;181269;85;0;0;0;0;.00nan;0;0
7483;38124;67;62;27;3;24;.889;3900000;0
7483;152624;85;82;42;3;39;.929;3900000;0
7484;180873;69;0;0;0;0;.00nan;0;0
7484;37942;1095;86;29;1;28;.966;3600000;0
7484;79141;1095;0;0;0;0;.00nan;0;0
7484;79211;69;67;38;4;34;.895;3600000;0
7485;-1;78;0;0;0;0;.00nan;0;0
7485;170728;1097;79;39;3;36;.923;3600000;0
7485;43928;1097;0;0;0;0;.00nan;0;0
7485;86344;78;71;39;4;35;.897;3548000;0
7486;2410;81;97;19;0;19;1.000;3600000;0
7486;163784;77;60;60;7;53;.883;3600000;0
7486;70213;81;0;0;0;0;.00nan;0;0
7486;161047;77;0;0;0;0;.00nan;0;0
7487;5559;72;0;0;0;0;.00nan;0;0
7487;173874;158;0;0;0;0;.00nan;0;0
7487;181071;158;51;32;4;28;.875;3600000;0
7487;44189;72;85;28;1;27;.964;3600000;0
7488;-1;151;0;0;0;0;.00nan;0;0
7488;178911;152;75;21;1;20;.952;3600000;0
7488;178950;152;0;0;0;0;.00nan;0;0
7488;85507;151;85;32;2;30;.938;3600000;0
7489;164913;75;0;0;0;0;.00nan;0;0
7489;173856;75;73;48;4;44;.917;3536000;0
7489;85555;76;0;0;0;0;.00nan;0;0
7489;91703;76;48;14;2;12;.857;3600000;0
7490;-1;4922;0;0;0;0;.00nan;0;0
7490;85349;82;0;0;0;0;.00nan;0;0
7490;86151;82;80;29;2;27;.931;3585000;0
7490;91742;4922;96;38;1;37;.974;3600000;0
7491;-1;74;0;0;0;0;.00nan;0;0
7491;-1;1096;0;0;0;0;.00nan;0;0
7491;180606;74;74;25;2;23;.920;3600000;0
7491;141978;1096;82;41;3;38;.927;3576000;0
7492;175658;4245;0;0;0;0;.00nan;0;0
7492;57657;73;0;0;0;0;.00nan;0;0
7492;86472;73;57;31;3;28;.903;3600000;0
7492;149858;4245;32;33;6;27;.818;3600000;0
7493;-1;4620;63;34;4;30;.882;3735000;0
7493;173961;4620;0;0;0;0;.00nan;0;0
7493;181123;4920;59;41;5;36;.878;3735000;0
7493;149450;4920;0;0;0;0;.00nan;0;0
7494;163989;80;0;0;0;0;.00nan;0;0
7494;164987;157;36;22;4;18;.818;3564000;0
7494;19708;157;0;0;0;0;.00nan;0;0
7494;170612;80;73;33;3;30;.909;3600000;0
7495;13325;2564;28;7;3;4;.571;380000;0
7495;166441;2564;56;25;3;22;.880;3220000;0
7495;85437;4921;0;0;0;0;.00nan;0;0
7495;152418;4921;78;28;2;26;.929;3600000;0
7496;175658;4245;0;0;0;0;.00nan;0;0
7496;37942;1095;0;0;0;0;.00nan;0;0
7496;79141;1095;96;45;2;43;.956;3885000;0
7496;149858;4245;71;29;3;26;.897;3885000;0
7497;2410;81;88;19;0;19;1.000;3600000;0
7497;163784;77;0;0;0;0;.00nan;0;0
7497;70213;81;0;0;0;0;.00nan;0;0
7497;161047;77;74;41;3;38;.927;3600000;0
7498;-1;151;39;35;6;29;.829;2868000;0
7498;178911;152;0;0;0;0;.00nan;0;0
7498;178950;152;98;29;1;28;.966;3600000;0
7498;85507;151;51;2;0;2;1.000;732000;0
7499;-1;4922;0;0;0;0;.00nan;0;0
7499;85349;82;73;27;3;24;.889;3806000;0
7499;86151;82;0;0;0;0;.00nan;0;0
7499;91742;4922;88;50;4;46;.920;3806000;0
7500;181446;71;67;35;4;31;.886;3600000;0
7500;57657;73;67;41;5;36;.878;3575000;0
7500;85984;71;0;0;0;0;.00nan;0;0
7500;86472;73;0;0;0;0;.00nan;0;0
7501;163989;80;54;42;7;35;.833;3096000;0
7501;164987;157;0;0;0;0;.00nan;0;0
7501;19708;157;60;26;3;23;.885;3600000;0
7501;170612;80;43;3;1;2;.667;504000;0
7502;13325;2564;100;45;2;43;.956;3900000;0
7502;166441;2564;0;0;0;0;.00nan;0;0
7502;85437;4921;69;27;2;25;.926;3900000;0
7502;152418;4921;0;0;0;0;.00nan;0;0
7503;-1;74;0;0;0;0;.00nan;0;0
7503;58100;74;97;50;2;48;.960;3900000;0
7503;85349;82;0;0;0;0;.00nan;0;0
7503;86151;82;81;30;2;28;.933;3900000;0
7504;5559;72;0;0;0;0;.00nan;0;0
7504;37942;1095;0;0;0;0;.00nan;0;0
7504;44189;72;75;48;5;43;.896;3712000;0
7504;79141;1095;62;32;4;28;.875;3719000;0
7505;164987;157;0;0;0;0;.00nan;0;0
7505;-1;151;0;0;0;0;.00nan;0;0
7505;19708;157;71;19;2;17;.895;3600000;0
7505;85507;151;55;47;6;41;.872;3600000;0
7506;163195;67;45;44;7;37;.841;2595000;0
7506;38124;67;53;9;1;8;.889;1005000;0
7506;85555;76;100;34;0;34;1.000;3600000;0
7506;91703;76;0;0;0;0;.00nan;0;0
7507;2410;81;68;35;4;31;.886;3900000;0
7507;-1;1096;0;0;0;0;.00nan;0;0
7507;70213;81;0;0;0;0;.00nan;0;0
7507;141978;1096;81;45;4;41;.911;3900000;0
7508;181269;85;91;45;3;42;.933;3551000;0
7508;85437;4921;0;0;0;0;.00nan;0;0
7508;152418;4921;77;24;2;22;.917;3600000;0
7508;152624;85;0;0;0;0;.00nan;0;0
7509;163989;80;77;45;4;41;.911;3831000;0
7509;-1;149;0;0;0;0;.00nan;0;0
7509;170612;80;0;0;0;0;.00nan;0;0
7509;141419;149;84;46;3;43;.935;3831000;0
7510;37942;1095;86;38;2;36;.947;3900000;0
7510;79141;1095;0;0;0;0;.00nan;0;0
7510;85437;4921;82;37;2;35;.946;3900000;0
7510;152418;4921;0;0;0;0;.00nan;0;0
7511;164987;157;68;30;3;27;.900;3600000;0
7511;-1;151;0;0;0;0;.00nan;0;0
7511;19708;157;0;0;0;0;.00nan;0;0
7511;85507;151;77;43;4;39;.907;3571000;0
7512;5559;72;43;35;6;29;.829;3214000;0
7512;180873;69;0;0;0;0;.00nan;0;0
7512;44189;72;48;0;0;0;.00nan;372000;0
7512;79211;69;46;32;5;27;.844;3600000;0
7513;173874;158;34;21;4;17;.810;3900000;0
7513;178911;152;0;0;0;0;.00nan;0;0
7513;178950;152;74;34;4;30;.882;3900000;0
7513;181071;158;0;0;0;0;.00nan;0;0
7514;13325;2564;98;25;0;25;1.000;3600000;0
7514;166441;2564;0;0;0;0;.00nan;0;0
7514;181123;4920;0;0;0;0;.00nan;0;0
7514;149450;4920;88;49;4;45;.918;3600000;0
7515;175658;4245;51;15;2;13;.867;2530000;0
7515;85555;76;99;34;1;33;.971;3600000;0
7515;91703;76;0;0;0;0;.00nan;0;0
7515;149858;4245;51;19;4;15;.789;1070000;0
7516;170728;1097;56;24;3;21;.875;3600000;0
7516;-1;4922;0;0;0;0;.00nan;0;0
7516;43928;1097;0;0;0;0;.00nan;0;0
7516;91742;4922;81;40;4;36;.900;3554000;0
7517;2410;81;81;31;1;30;.968;3600000;0
7517;-1;1096;0;0;0;0;.00nan;0;0
7517;70213;81;0;0;0;0;.00nan;0;0
7517;141978;1096;92;47;2;45;.957;3548000;0
7518;163195;67;68;23;2;21;.913;3600000;0
7518;181269;85;77;38;4;34;.895;3566000;0
7518;38124;67;0;0;0;0;.00nan;0;0
7518;152624;85;0;0;0;0;.00nan;0;0
7519;164913;75;0;0;0;0;.00nan;0;0
7519;-1;74;0;0;0;0;.00nan;0;0
7519;173856;75;95;38;2;36;.947;3600000;0
7519;58100;74;78;23;1;22;.957;3600000;0
7520;181446;71;59;22;2;20;.909;3561000;0
7520;57657;73;81;27;1;26;.963;3600000;0
7520;85984;71;0;0;0;0;.00nan;0;0
7520;86472;73;0;0;0;0;.00nan;0;0
7521;163784;77;0;0;0;0;.00nan;0;0
7521;85349;82;0;0;0;0;.00nan;0;0
7521;86151;82;95;20;0;20;1.000;3600000;0
7521;161047;77;75;54;5;49;.907;3600000;0
7522;5559;72;0;0;0;0;.00nan;0;0
7522;37942;1095;0;0;0;0;.00nan;0;0
7522;44189;72;67;30;3;27;.900;3600000;0
7522;79141;1095;45;35;6;29;.829;3600000;0
7523;181446;71;27;26;6;20;.769;3102000;0
7523;85437;4921;0;0;0;0;.00nan;0;0
7523;85984;71;53;3;0;3;1.000;416000;0
7523;152418;4921;69;41;4;37;.902;3600000;0
7524;164987;157;0;0;0;0;.00nan;0;0
7524;-1;151;31;11;3;8;.727;460000;0
7524;19708;157;80;11;0;11;1.000;3600000;0
7524;85507;151;56;42;5;37;.881;3140000;0
7525;-1;74;54;4;0;4;1.000;234000;0
7525;-1;4922;67;39;4;35;.897;3600000;0
7525;58100;74;41;28;6;22;.786;3310000;0
7525;91742;4922;0;0;0;0;.00nan;0;0
7526;13325;2564;0;0;0;0;.00nan;0;0
7526;166441;2564;77;28;2;26;.929;3600000;0
7526;181123;4920;75;37;3;34;.919;3600000;0
7526;149450;4920;0;0;0;0;.00nan;0;0
7527;175658;4245;60;10;0;10;1.000;661000;0
7527;85555;76;63;5;0;5;1.000;1200000;0
7527;91703;76;31;29;6;23;.793;2700000;0
7527;149858;4245;33;26;6;20;.769;3239000;0
7528;2410;81;0;0;0;0;.00nan;0;0
7528;-1;1096;81;35;3;32;.914;3600000;0
7528;70213;81;61;37;4;33;.892;3600000;0
7528;141978;1096;0;0;0;0;.00nan;0;0
7529;163195;67;69;25;3;22;.880;3900000;0
7529;181269;85;0;0;0;0;.00nan;0;0
7529;38124;67;0;0;0;0;.00nan;0;0
7529;152624;85;60;32;3;29;.906;3900000;0
7530;164913;75;49;39;5;34;.872;3530000;0
7530;173856;75;0;0;0;0;.00nan;0;0
7530;170728;1097;0;0;0;0;.00nan;0;0
7530;43928;1097;56;26;3;23;.885;3600000;0
7531;180873;69;60;44;6;38;.864;3600000;0
7531;57657;73;0;0;0;0;.00nan;0;0
7531;79211;69;0;0;0;0;.00nan;0;0
7531;86472;73;64;24;3;21;.875;3600000;0
7532;163989;80;0;0;0;0;.00nan;0;0
7532;178911;152;47;37;5;32;.865;3600000;0
7532;178950;152;0;0;0;0;.00nan;0;0
7532;170612;80;92;30;1;29;.967;3600000;0
7533;-1;149;89;40;3;37;.925;3587000;0
7533;173874;158;0;0;0;0;.00nan;0;0
7533;181071;158;79;22;1;21;.955;3600000;0
7533;141419;149;0;0;0;0;.00nan;0;0
7534;-1;78;0;0;0;0;.00nan;0;0
7534;-1;4620;75;32;2;30;.938;3600000;0
7534;173961;4620;0;0;0;0;.00nan;0;0
7534;86344;78;65;40;5;35;.875;3600000;0
7535;-1;149;0;0;0;0;.00nan;0;0
7535;173874;158;91;50;3;47;.940;3600000;0
7535;181071;158;0;0;0;0;.00nan;0;0
7535;141419;149;84;14;0;14;1.000;3600000;0
7536;163784;77;100;55;2;53;.964;3900000;0
7536;85349;82;0;0;0;0;.00nan;0;0
7536;86151;82;75;30;2;28;.933;3900000;0
7536;161047;77;0;0;0;0;.00nan;0;0
7537;5559;72;89;36;3;33;.917;3562000;0
7537;181446;71;0;0;0;0;.00nan;0;0
7537;44189;72;0;0;0;0;.00nan;0;0
7537;85984;71;75;32;2;30;.938;3600000;0
7538;-1;74;0;0;0;0;.00nan;0;0
7538;-1;4922;0;0;0;0;.00nan;0;0
7538;58100;74;48;22;3;19;.864;3600000;0
7538;91742;4922;91;44;4;40;.909;3579000;0
7539;13325;2564;72;32;3;29;.906;3600000;0
7539;166441;2564;0;0;0;0;.00nan;0;0
7539;181123;4920;73;14;0;14;1.000;1320000;0
7539;149450;4920;43;28;5;23;.821;2280000;0
7540;164913;75;0;0;0;0;.00nan;0;0
7540;173856;75;77;49;4;45;.918;3550000;0
7540;170728;1097;61;26;3;23;.885;3600000;0
7540;43928;1097;0;0;0;0;.00nan;0;0
7541;180873;69;0;0;0;0;.00nan;0;0
7541;57657;73;79;45;5;40;.889;3900000;0
7541;79211;69;56;37;5;32;.865;3895000;0
7541;86472;73;0;0;0;0;.00nan;0;0
7542;163989;80;74;29;2;27;.931;3600000;0
7542;178911;152;0;0;0;0;.00nan;0;0
7542;178950;152;55;25;3;22;.880;3586000;0
7542;170612;80;0;0;0;0;.00nan;0;0
7543;37942;1095;70;18;1;17;.944;3600000;0
7543;79141;1095;0;0;0;0;.00nan;0;0
7543;85437;4921;82;53;5;48;.906;3600000;0
7543;152418;4921;0;0;0;0;.00nan;0;0
7544;-1;78;0;0;0;0;.00nan;0;0
7544;-1;4620;0;0;0;0;.00nan;0;0
7544;173961;4620;64;29;3;26;.897;3900000;0
7544;86344;78;64;31;3;28;.903;3900000;0
7545;-1;78;0;0;0;0;.00nan;0;0
7545;175658;4245;0;0;0;0;.00nan;0;0
7545;86344;78;67;27;2;25;.926;3600000;0
7545;149858;4245;36;28;5;23;.821;3600000;0
7546;-1;74;0;0;0;0;.00nan;0;0
7546;170728;1097;0;0;0;0;.00nan;0;0
7546;43928;1097;50;31;4;27;.871;3578000;0
7546;58100;74;77;28;2;26;.929;3600000;0
7547;164987;85;0;0;0;0;.00nan;0;0
7547;85555;76;55;28;4;24;.857;3553000;0
7547;86862;85;78;34;3;31;.912;3600000;0
7547;91703;76;0;0;0;0;.00nan;0;0
7548;163195;67;91;43;1;42;.977;3600000;0
7548;-1;4620;0;0;0;0;.00nan;0;0
7548;173961;4620;50;23;3;20;.870;3561000;0
7548;38124;67;0;0;0;0;.00nan;0;0
7549;163989;80;50;25;3;22;.880;3589000;0
7549;173874;158;0;0;0;0;.00nan;0;0
7549;170612;80;0;0;0;0;.00nan;0;0
7549;181071;158;80;36;2;34;.944;3600000;0
7550;-1;149;0;0;0;0;.00nan;0;0
7550;178911;152;0;0;0;0;.00nan;0;0
7550;178950;152;100;37;1;36;.973;3600000;0
7550;141419;149;73;30;2;28;.933;3542000;0
7551;170728;1097;0;0;0;0;.00nan;0;0
7551;-1;4922;0;0;0;0;.00nan;0;0
7551;43928;1097;68;27;3;24;.889;3900000;0
7551;91742;4922;83;42;3;39;.929;3900000;0
7552;181446;71;40;27;5;22;.815;3512000;0
7552;78479;71;0;0;0;0;.00nan;0;0
7552;85437;4921;0;0;0;0;.00nan;0;0
7552;152418;4921;97;47;3;44;.936;3600000;0
7553;5559;72;0;0;0;0;.00nan;0;0
7553;13325;2564;71;34;3;31;.912;3600000;0
7553;166441;2564;0;0;0;0;.00nan;0;0
7553;44189;72;52;29;4;25;.862;3600000;0
7554;163195;67;49;34;5;29;.853;3600000;0
7554;175658;4245;78;36;4;32;.889;3600000;0
7554;38124;67;0;0;0;0;.00nan;0;0
7554;57998;4245;0;0;0;0;.00nan;0;0
7555;19708;157;76;36;3;33;.917;3600000;0
7555;181123;4920;0;0;0;0;.00nan;0;0
7555;60123;157;0;0;0;0;.00nan;0;0
7555;149450;4920;100;29;0;29;1.000;3600000;0
7556;164987;85;90;30;1;29;.967;3600000;0
7556;85555;76;65;28;3;25;.893;3600000;0
7556;86862;85;0;0;0;0;.00nan;0;0
7556;91703;76;0;0;0;0;.00nan;0;0
7557;163784;77;71;43;4;39;.907;3600000;0
7557;-1;1096;0;0;0;0;.00nan;0;0
7557;141978;1096;91;29;1;28;.966;3600000;0
7557;161047;77;0;0;0;0;.00nan;0;0
7558;164913;75;0;0;0;0;.00nan;0;0
7558;173856;75;76;45;4;41;.911;3600000;0
7558;85349;82;0;0;0;0;.00nan;0;0
7558;86151;82;58;13;1;12;.923;3600000;0
7559;37942;1095;0;0;0;0;.00nan;0;0
7559;57657;73;82;27;1;26;.963;3600000;0
7559;79141;1095;59;37;5;32;.865;3600000;0
7559;86472;73;0;0;0;0;.00nan;0;0
7560;-1;78;0;0;0;0;.00nan;0;0
7560;-1;4620;87;34;2;32;.941;3900000;0
7560;173961;4620;0;0;0;0;.00nan;0;0
7560;86344;78;80;30;2;28;.933;3900000;0
7561;2410;81;67;29;2;27;.931;3600000;0
7561;-1;151;0;0;0;0;.00nan;0;0
7561;70213;81;0;0;0;0;.00nan;0;0
7561;85507;151;58;40;4;36;.900;3513000;0
7562;173874;158;73;25;2;23;.920;3600000;0
7562;180873;69;42;21;4;17;.810;1078000;0
7562;181071;158;0;0;0;0;.00nan;0;0
7562;79211;69;93;24;0;24;1.000;2435000;0
7563;163195;67;86;32;2;30;.938;3900000;0
7563;175658;4245;0;0;0;0;.00nan;0;0
7563;38124;67;0;0;0;0;.00nan;0;0
7563;57998;4245;80;32;2;30;.938;3900000;0
7564;-1;149;78;32;2;30;.938;3546000;0
7564;178911;152;100;43;1;42;.977;3600000;0
7564;178950;152;0;0;0;0;.00nan;0;0
7564;64722;149;0;0;0;0;.00nan;0;0
7565;170728;1097;68;25;2;23;.920;3600000;0
7565;-1;4922;67;36;4;32;.889;3528000;0
7565;43928;1097;0;0;0;0;.00nan;0;0
7565;91742;4922;0;0;0;0;.00nan;0;0
7566;181446;71;0;0;0;0;.00nan;0;0
7566;78479;71;84;43;3;40;.930;3560000;0
7566;85437;4921;82;31;1;30;.968;3600000;0
7566;152418;4921;0;0;0;0;.00nan;0;0
7567;19708;157;0;0;0;0;.00nan;0;0
7567;181123;4920;0;0;0;0;.00nan;0;0
7567;60123;157;69;20;2;18;.900;3555000;0
7567;149450;4920;93;37;1;36;.973;3600000;0
7568;164987;85;45;43;6;37;.860;3586000;0
7568;85555;76;0;0;0;0;.00nan;0;0
7568;86862;85;0;0;0;0;.00nan;0;0
7568;91703;76;57;28;4;24;.857;3600000;0
7569;164913;75;67;38;4;34;.895;3564000;0
7569;173856;75;0;0;0;0;.00nan;0;0
7569;-1;1096;76;33;3;30;.909;3600000;0
7569;141978;1096;0;0;0;0;.00nan;0;0
7570;13325;2564;76;22;1;21;.955;2687000;0
7570;166441;2564;20;9;4;5;.556;913000;0
7570;57657;73;0;0;0;0;.00nan;0;0
7570;86472;73;66;23;2;21;.913;3600000;0
7571;-1;78;0;0;0;0;.00nan;0;0
7571;-1;4620;0;0;0;0;.00nan;0;0
7571;173961;4620;100;38;0;38;1.000;3600000;0
7571;86344;78;65;33;3;30;.909;3600000;0
7572;2410;81;63;21;2;19;.905;1552000;0
7572;-1;151;0;0;0;0;.00nan;0;0
7572;70213;81;35;28;6;22;.786;2048000;0
7572;85507;151;84;39;3;36;.923;3600000;0
7573;173874;158;0;0;0;0;.00nan;0;0
7573;180873;69;64;43;5;38;.884;3600000;0
7573;181071;158;86;29;2;27;.931;3600000;0
7573;79211;69;0;0;0;0;.00nan;0;0
7574;163989;80;62;40;4;36;.900;3544000;0
7574;-1;149;0;0;0;0;.00nan;0;0
7574;170612;80;0;0;0;0;.00nan;0;0
7574;64722;149;52;23;3;20;.870;3600000;0
7575;164913;75;0;0;0;0;.00nan;0;0
7575;173856;75;67;55;7;48;.873;3600000;0
7575;85349;82;0;0;0;0;.00nan;0;0
7575;86151;82;74;18;1;17;.944;3600000;0
7576;5559;72;0;0;0;0;.00nan;0;0
7576;181446;71;0;0;0;0;.00nan;0;0
7576;64811;72;46;33;5;28;.848;3600000;0
7576;78479;71;62;35;4;31;.886;3600000;0
7577;13325;2564;41;18;3;15;.833;1433000;0
7577;166441;2564;5;14;6;8;.571;2167000;0
7577;57657;73;53;29;4;25;.862;3600000;0
7577;86472;73;0;0;0;0;.00nan;0;0
7578;19708;157;72;27;2;25;.926;3900000;0
7578;181123;4920;89;43;2;41;.953;3900000;0
7578;60123;157;0;0;0;0;.00nan;0;0
7578;149450;4920;0;0;0;0;.00nan;0;0
7579;-1;74;0;0;0;0;.00nan;0;0
7579;-1;4922;0;0;0;0;.00nan;0;0
7579;58100;74;56;12;1;11;.917;3600000;0
7579;91742;4922;77;66;8;58;.879;3600000;0
7580;173874;158;87;39;3;36;.923;3600000;0
7580;178911;152;0;0;0;0;.00nan;0;0
7580;178950;152;45;22;4;18;.818;3544000;0
7580;181071;158;0;0;0;0;.00nan;0;0
7581;2410;81;59;22;3;19;.864;3600000;0
7581;-1;151;15;13;5;8;.615;1214000;0
7581;70213;81;0;0;0;0;.00nan;0;0
7581;85507;151;26;31;6;25;.806;2386000;0
7582;180873;69;0;0;0;0;.00nan;0;0
7582;79211;69;54;50;6;44;.880;3600000;0
7582;85437;4921;87;26;1;25;.962;3600000;0
7582;152418;4921;0;0;0;0;.00nan;0;0
7583;164913;75;0;0;0;0;.00nan;0;0
7583;173856;75;50;32;4;28;.875;3900000;0
7583;57657;73;55;35;4;31;.886;2384000;0
7583;86472;73;61;11;0;11;1.000;1516000;0
7584;-1;4620;0;0;0;0;.00nan;0;0
7584;19708;157;39;21;4;17;.810;998000;0
7584;173961;4620;48;32;5;27;.844;3578000;0
7584;60123;157;82;19;0;19;1.000;2602000;0
7585;163989;80;58;20;2;18;.900;3600000;0
7585;173874;158;78;35;3;32;.914;3446000;0
7585;170612;80;0;0;0;0;.00nan;0;0
7585;181071;158;22;5;3;2;.400;154000;0
7586;164987;85;98;52;4;48;.923;3600000;0
7586;-1;78;0;0;0;0;.00nan;0;0
7586;86344;78;61;27;3;24;.889;3600000;0
7586;86862;85;0;0;0;0;.00nan;0;0
7587;181446;71;0;0;0;0;.00nan;0;0
7587;78479;71;38;23;4;19;.826;3600000;0
7587;79141;1095;0;0;0;0;.00nan;0;0
7587;149858;1095;68;31;3;28;.903;3600000;0
7588;163784;77;79;46;3;43;.935;3600000;0
7588;57657;73;0;0;0;0;.00nan;0;0
7588;86472;73;56;37;5;32;.865;3599000;0
7588;161047;77;0;0;0;0;.00nan;0;0
7589;5559;72;0;0;0;0;.00nan;0;0
7589;163989;80;93;37;2;35;.946;3600000;0
7589;170612;80;0;0;0;0;.00nan;0;0
7589;64811;72;87;27;1;26;.963;3600000;0
7590;180873;69;50;22;3;19;.864;3900000;0
7590;79211;69;0;0;0;0;.00nan;0;0
7590;85437;4921;0;0;0;0;.00nan;0;0
7590;152418;4921;60;27;3;24;.889;3900000;0
7591;-1;74;0;0;0;0;.00nan;0;0
7591;170728;1097;0;0;0;0;.00nan;0;0
7591;43928;1097;52;26;4;22;.846;3900000;0
7591;58100;74;61;38;4;34;.895;3900000;0
7592;13325;2564;99;37;1;36;.973;3600000;0
7592;166441;2564;0;0;0;0;.00nan;0;0
7592;-1;149;0;0;0;0;.00nan;0;0
7592;64722;149;56;31;4;27;.871;3600000;0
7593;2410;81;86;29;2;27;.931;3580000;0
7593;178911;152;76;26;1;25;.962;3600000;0
7593;178950;152;0;0;0;0;.00nan;0;0
7593;70213;81;0;0;0;0;.00nan;0;0
7594;163195;67;70;29;3;26;.897;3900000;0
7594;175658;4245;0;0;0;0;.00nan;0;0
7594;38124;67;0;0;0;0;.00nan;0;0
7594;57998;4245;85;36;3;33;.917;3900000;0
7595;-1;1096;43;23;4;19;.826;2462000;0
7595;85349;82;0;0;0;0;.00nan;0;0
7595;86151;82;70;20;1;19;.950;3600000;0
7595;141978;1096;26;11;4;7;.636;1138000;0
7596;164913;75;0;0;0;0;.00nan;0;0
7596;173856;75;27;21;5;16;.762;3553000;0
7596;-1;4922;0;0;0;0;.00nan;0;0
7596;91742;4922;57;32;4;28;.875;3600000;0
7597;-1;4620;84;26;1;25;.962;3600000;0
7597;19708;157;58;33;4;29;.879;3600000;0
7597;173961;4620;0;0;0;0;.00nan;0;0
7597;60123;157;0;0;0;0;.00nan;0;0
7598;-1;151;0;0;0;0;.00nan;0;0
7598;85507;151;75;46;5;41;.891;3600000;0
7598;85555;76;71;27;2;25;.926;3600000;0
7598;91703;76;0;0;0;0;.00nan;0;0
7599;164987;85;0;0;0;0;.00nan;0;0
7599;-1;78;0;0;0;0;.00nan;0;0
7599;86344;78;95;29;1;28;.966;3600000;0
7599;86862;85;78;35;2;33;.943;3552000;0
7600;181446;71;0;0;0;0;.00nan;0;0
7600;78479;71;57;25;3;22;.880;3663000;0
7600;79141;1095;0;0;0;0;.00nan;0;0
7600;149858;1095;57;35;4;31;.886;3663000;0
7601;163784;77;0;0;0;0;.00nan;0;0
7601;57657;73;33;26;6;20;.769;3530000;0
7601;86472;73;0;0;0;0;.00nan;0;0
7601;161047;77;69;30;3;27;.900;3600000;0
7602;5559;72;0;0;0;0;.00nan;0;0
7602;163989;80;0;0;0;0;.00nan;0;0
7602;170612;80;62;19;2;17;.895;3571000;0
7602;64811;72;100;44;1;43;.977;3600000;0
7603;180873;69;0;0;0;0;.00nan;0;0
7603;79211;69;60;23;3;20;.870;3568000;0
7603;85437;4921;68;24;2;22;.917;3600000;0
7603;152418;4921;0;0;0;0;.00nan;0;0
7604;164913;75;46;31;5;26;.839;2769000;0
7604;-1;74;0;0;0;0;.00nan;0;0
7604;173856;75;53;4;0;4;1.000;831000;0
7604;58100;74;72;25;1;24;.960;3600000;0
7605;13325;2564;0;0;0;0;.00nan;0;0
7605;166441;2564;92;27;1;26;.963;3600000;0
7605;-1;149;0;0;0;0;.00nan;0;0
7605;64722;149;44;25;4;21;.840;3600000;0
7606;2410;81;57;28;3;25;.893;3578000;0
7606;178911;152;0;0;0;0;.00nan;0;0
7606;178950;152;89;34;1;33;.971;3600000;0
7606;70213;81;0;0;0;0;.00nan;0;0
7607;164987;85;84;38;3;35;.921;3600000;0
7607;175658;4245;0;0;0;0;.00nan;0;0
7607;57998;4245;51;35;5;30;.857;3591000;0
7607;86862;85;0;0;0;0;.00nan;0;0
7608;170728;1097;17;22;6;16;.727;3600000;0
7608;-1;4922;84;56;2;54;.964;3600000;0
7608;43928;1097;0;0;0;0;.00nan;0;0
7608;91742;4922;0;0;0;0;.00nan;0;0
7609;-1;1096;0;0;0;0;.00nan;0;0
7609;85349;82;33;22;4;18;.818;3900000;0
7609;86151;82;0;0;0;0;.00nan;0;0
7609;141978;1096;80;47;4;43;.915;3900000;0
7610;-1;4620;0;0;0;0;.00nan;0;0
7610;19708;157;0;0;0;0;.00nan;0;0
7610;173961;4620;49;35;5;30;.857;3600000;0
7610;60123;157;70;26;2;24;.923;3600000;0
7611;-1;151;62;28;3;25;.893;3600000;0
7611;85507;151;0;0;0;0;.00nan;0;0
7611;85555;76;0;0;0;0;.00nan;0;0
7611;91703;76;49;24;4;20;.833;3541000;0
7612;163195;67;82;35;3;32;.914;3900000;0
7612;-1;78;0;0;0;0;.00nan;0;0
7612;38124;67;0;0;0;0;.00nan;0;0
7612;86344;78;66;34;3;31;.912;3900000;0
7613;57657;73;0;0;0;0;.00nan;0;0
7613;85349;82;0;0;0;0;.00nan;0;0
7613;86151;82;63;26;2;24;.923;3600000;0
7613;86472;73;75;38;3;35;.921;3541000;0
7614;5559;72;0;0;0;0;.00nan;0;0
7614;64811;72;100;46;3;43;.935;3600000;0
7614;79141;1095;41;2;1;1;.500;246000;0
7614;149858;1095;56;37;5;32;.865;3354000;0
7615;163784;77;78;30;1;29;.967;3900000;0
7615;-1;74;0;0;0;0;.00nan;0;0
7615;58100;74;89;28;1;27;.964;3900000;0
7615;161047;77;0;0;0;0;.00nan;0;0
7616;13325;2564;64;44;5;39;.886;3541000;0
7616;166441;2564;0;0;0;0;.00nan;0;0
7616;-1;149;0;0;0;0;.00nan;0;0
7616;64722;149;76;39;3;36;.923;3600000;0
7617;164987;85;0;0;0;0;.00nan;0;0
7617;175658;4245;23;27;6;21;.778;2480000;0
7617;57998;4245;57;7;0;7;1.000;1120000;0
7617;86862;85;77;31;2;29;.935;3600000;0
7618;170728;1097;0;0;0;0;.00nan;0;0
7618;-1;4922;0;0;0;0;.00nan;0;0
7618;43928;1097;74;39;4;35;.897;3900000;0
7618;91742;4922;100;51;4;47;.922;3900000;0
7619;164913;75;0;0;0;0;.00nan;0;0
7619;173856;75;95;37;1;36;.973;3600000;0
7619;-1;1096;48;21;3;18;.857;3519000;0
7619;141978;1096;0;0;0;0;.00nan;0;0
7620;-1;151;0;0;0;0;.00nan;0;0
7620;85507;151;93;45;3;42;.933;3600000;0
7620;85555;76;37;22;4;18;.818;3573000;0
7620;91703;76;0;0;0;0;.00nan;0;0
7621;5559;72;0;0;0;0;.00nan;0;0
7621;64811;72;76;39;4;35;.897;3568000;0
7621;85437;4921;0;0;0;0;.00nan;0;0
7621;152418;4921;90;37;3;34;.919;3600000;0
7622;163195;67;63;38;5;33;.868;3600000;0
7622;-1;78;0;0;0;0;.00nan;0;0
7622;38124;67;0;0;0;0;.00nan;0;0
7622;86344;78;41;39;6;33;.846;3577000;0
7623;-1;149;0;0;0;0;.00nan;0;0
7623;178911;152;72;33;2;31;.939;3900000;0
7623;178950;152;0;0;0;0;.00nan;0;0
7623;64722;149;95;47;2;45;.957;3900000;0
7624;57657;73;94;48;3;45;.938;3787000;0
7624;79141;1095;0;0;0;0;.00nan;0;0
7624;86472;73;0;0;0;0;.00nan;0;0
7624;149858;1095;81;36;2;34;.944;3787000;0
7625;170728;1097;0;0;0;0;.00nan;0;0
7625;-1;1096;0;0;0;0;.00nan;0;0
7625;43928;1097;65;34;3;31;.912;3600000;0
7625;141978;1096;62;24;2;22;.917;3600000;0
7626;13325;2564;93;37;2;35;.946;3600000;0
7626;166441;2564;0;0;0;0;.00nan;0;0
7626;181446;71;0;0;0;0;.00nan;0;0
7626;78479;71;69;16;1;15;.938;3600000;0
7627;163989;80;84;40;2;38;.950;3900000;0
7627;19708;157;0;0;0;0;.00nan;0;0
7627;170612;80;0;0;0;0;.00nan;0;0
7627;60123;157;74;28;2;26;.929;3900000;0
7628;-1;74;0;0;0;0;.00nan;0;0
7628;-1;4620;64;25;3;22;.880;3600000;0
7628;173961;4620;0;0;0;0;.00nan;0;0
7628;58100;74;73;41;4;37;.902;3554000;0
7629;163195;67;53;33;4;29;.879;3600000;0
7629;38124;67;0;0;0;0;.00nan;0;0
7629;85555;76;79;30;2;28;.933;3600000;0
7629;91703;76;0;0;0;0;.00nan;0;0
7630;-1;149;0;0;0;0;.00nan;0;0
7630;178911;152;98;47;2;45;.957;3564000;0
7630;178950;152;0;0;0;0;.00nan;0;0
7630;64722;149;100;25;0;25;1.000;3600000;0
7631;-1;4620;68;30;3;27;.900;3600000;0
7631;173961;4620;0;0;0;0;.00nan;0;0
7631;85349;82;0;0;0;0;.00nan;0;0
7631;86151;82;73;35;4;31;.886;3545000;0
7632;170728;1097;47;24;4;20;.833;1094000;0
7632;-1;1096;57;29;4;25;.862;3600000;0
7632;43928;1097;94;33;1;32;.970;2496000;0
7632;141978;1096;0;0;0;0;.00nan;0;0
7633;163989;80;76;45;4;41;.911;3600000;0
7633;19708;157;0;0;0;0;.00nan;0;0
7633;170612;80;0;0;0;0;.00nan;0;0
7633;60123;157;91;26;1;25;.962;3600000;0
7634;5559;72;37;32;6;26;.813;3600000;0
7634;64811;72;0;0;0;0;.00nan;0;0
7634;79141;1095;0;0;0;0;.00nan;0;0
7634;149858;1095;50;26;4;22;.846;3600000;0
7635;173874;158;61;25;3;22;.880;3600000;0
7635;180873;69;100;30;0;30;1.000;3600000;0
7635;181071;158;0;0;0;0;.00nan;0;0
7635;79211;69;0;0;0;0;.00nan;0;0
7636;163784;77;76;33;3;30;.909;3576000;0
7636;-1;74;0;0;0;0;.00nan;0;0
7636;58100;74;88;30;1;29;.967;3600000;0
7636;161047;77;0;0;0;0;.00nan;0;0
7637;175658;4245;0;0;0;0;.00nan;0;0
7637;181123;4920;0;0;0;0;.00nan;0;0
7637;57998;4245;82;50;4;46;.920;3600000;0
7637;149450;4920;90;22;0;22;1.000;3600000;0
7638;2410;81;79;15;1;14;.933;3600000;0
7638;-1;151;0;0;0;0;.00nan;0;0
7638;70213;81;0;0;0;0;.00nan;0;0
7638;85507;151;24;43;8;35;.814;3600000;0
7639;164987;85;32;41;8;33;.805;3600000;0
7639;-1;78;0;0;0;0;.00nan;0;0
7639;86344;78;81;32;1;31;.969;3600000;0
7639;86862;85;0;0;0;0;.00nan;0;0
7640;164913;75;0;0;0;0;.00nan;0;0
7640;173856;75;63;15;1;14;.933;3600000;0
7640;-1;4922;0;0;0;0;.00nan;0;0
7640;91742;4922;80;36;3;33;.917;3596000;0
7641;181446;71;0;0;0;0;.00nan;0;0
7641;57657;73;45;31;5;26;.839;3600000;0
7641;78479;71;72;22;1;21;.955;3600000;0
7641;86472;73;0;0;0;0;.00nan;0;0
7642;13325;2564;100;43;2;41;.953;3619000;0
7642;166441;2564;0;0;0;0;.00nan;0;0
7642;85437;4921;60;21;3;18;.857;3619000;0
7642;152418;4921;0;0;0;0;.00nan;0;0
7643;163195;67;0;0;0;0;.00nan;0;0
7643;38124;67;60;30;3;27;.900;3600000;0
7643;85555;76;0;0;0;0;.00nan;0;0
7643;91703;76;84;34;2;32;.941;3600000;0
7644;-1;149;0;0;0;0;.00nan;0;0
7644;178911;152;0;0;0;0;.00nan;0;0
7644;178950;152;78;27;2;25;.926;3600000;0
7644;64722;149;74;37;3;34;.919;3600000;0
7645;-1;4922;95;52;4;48;.923;3563000;0
7645;85349;82;69;29;2;27;.931;3600000;0
7645;86151;82;0;0;0;0;.00nan;0;0
7645;91742;4922;0;0;0;0;.00nan;0;0
7646;13325;2564;0;0;0;0;.00nan;0;0
7646;166441;2564;92;37;2;35;.946;3600000;0
7646;79141;1095;0;0;0;0;.00nan;0;0
7646;149858;1095;80;28;1;27;.964;3600000;0
7647;170728;1097;72;34;3;31;.912;3572000;0
7647;-1;1096;0;0;0;0;.00nan;0;0
7647;43928;1097;0;0;0;0;.00nan;0;0
7647;141978;1096;80;39;2;37;.949;3600000;0
7648;163989;80;41;3;1;2;.667;305000;0
7648;19708;157;0;0;0;0;.00nan;0;0
7648;170612;80;29;35;6;29;.829;3295000;0
7648;60123;157;44;22;3;19;.864;3600000;0
7649;5559;72;39;1;1;0;.000;247000;0
7649;57657;73;45;20;4;16;.800;3600000;0
7649;64811;72;44;30;6;24;.800;3353000;0
7649;86472;73;0;0;0;0;.00nan;0;0
7650;173874;158;0;0;0;0;.00nan;0;0
7650;180873;69;100;36;1;35;.972;3600000;0
7650;181071;158;53;25;3;22;.880;3560000;0
7650;79211;69;0;0;0;0;.00nan;0;0
7651;163784;77;91;46;2;44;.957;3600000;0
7651;-1;74;0;0;0;0;.00nan;0;0
7651;58100;74;60;25;3;22;.880;3600000;0
7651;161047;77;0;0;0;0;.00nan;0;0
7652;175658;4245;48;43;6;37;.860;2313000;0
7652;181123;4920;0;0;0;0;.00nan;0;0
7652;57998;4245;37;12;3;9;.750;1287000;0
7652;149450;4920;78;23;1;22;.957;3600000;0
7653;2410;81;0;0;0;0;.00nan;0;0
7653;-1;151;0;0;0;0;.00nan;0;0
7653;70213;81;37;26;5;21;.808;3536000;0
7653;85507;151;75;36;4;32;.889;3600000;0
7654;164987;85;0;0;0;0;.00nan;0;0
7654;-1;78;0;0;0;0;.00nan;0;0
7654;86344;78;66;26;3;23;.885;3875000;0
7654;86862;85;72;37;4;33;.892;3875000;0
7655;164913;75;32;32;6;26;.813;2706000;0
7655;-1;4620;0;0;0;0;.00nan;0;0
7655;173856;75;66;12;1;11;.917;894000;0
7655;173961;4620;68;36;4;32;.889;3600000;0
7656;181446;71;0;0;0;0;.00nan;0;0
7656;78479;71;59;28;4;24;.857;3516000;0
7656;85437;4921;0;0;0;0;.00nan;0;0
7656;152418;4921;92;40;2;38;.950;3600000;0
7657;163195;67;62;22;2;20;.909;3600000;0
7657;38124;67;0;0;0;0;.00nan;0;0
7657;85555;76;59;35;4;31;.886;3600000;0
7657;91703;76;0;0;0;0;.00nan;0;0
7658;5559;72;100;32;1;31;.969;3600000;0
7658;13325;2564;64;37;5;32;.865;3600000;0
7658;166441;2564;0;0;0;0;.00nan;0;0
7658;64811;72;0;0;0;0;.00nan;0;0
7659;173874;158;92;28;1;27;.964;3600000;0
7659;180873;69;0;0;0;0;.00nan;0;0
7659;181071;158;0;0;0;0;.00nan;0;0
7659;79211;69;43;33;5;28;.848;3600000;0
7660;175658;4245;0;0;0;0;.00nan;0;0
7660;181123;4920;88;32;1;31;.969;3600000;0
7660;57998;4245;59;41;7;34;.829;3600000;0
7660;149450;4920;0;0;0;0;.00nan;0;0
7661;2410;81;100;21;0;21;1.000;3600000;0
7661;-1;151;0;0;0;0;.00nan;0;0
7661;70213;81;0;0;0;0;.00nan;0;0
7661;85507;151;97;47;3;44;.936;3600000;0
7662;164987;85;76;39;3;36;.923;3600000;0
7662;-1;78;0;0;0;0;.00nan;0;0
7662;86344;78;27;27;6;21;.778;3600000;0
7662;86862;85;0;0;0;0;.00nan;0;0
7663;164913;75;0;0;0;0;.00nan;0;0
7663;-1;4620;57;22;2;20;.909;3600000;0
7663;173856;75;96;50;3;47;.940;3573000;0
7663;173961;4620;0;0;0;0;.00nan;0;0
7664;79141;1095;0;0;0;0;.00nan;0;0
7664;85437;4921;53;26;3;23;.885;3600000;0
7664;149858;1095;46;40;6;34;.850;3600000;0
7664;152418;4921;0;0;0;0;.00nan;0;0
7665;5559;72;0;0;0;0;.00nan;0;0
7665;57657;73;24;30;7;23;.767;3566000;0
7665;64811;72;45;33;5;28;.848;3600000;0
7665;86472;73;0;0;0;0;.00nan;0;0
7666;178911;152;61;20;2;18;.900;3600000;0
7666;178950;152;0;0;0;0;.00nan;0;0
7666;180873;69;0;0;0;0;.00nan;0;0
7666;79211;69;86;46;4;42;.913;3526000;0
7667;2410;81;65;30;3;27;.900;3600000;0
7667;-1;149;0;0;0;0;.00nan;0;0
7667;64722;149;48;26;4;22;.846;3553000;0
7667;70213;81;0;0;0;0;.00nan;0;0
7668;164987;85;0;0;0;0;.00nan;0;0
7668;-1;4620;0;0;0;0;.00nan;0;0
7668;173961;4620;43;27;4;23;.852;3563000;0
7668;86862;85;90;49;3;46;.939;3600000;0
7669;-1;151;42;38;6;32;.842;3600000;0
7669;19708;157;0;0;0;0;.00nan;0;0
7669;60123;157;81;16;0;16;1.000;3600000;0
7669;85507;151;0;0;0;0;.00nan;0;0
7670;-1;78;86;47;3;44;.936;3900000;0
7670;181123;4920;0;0;0;0;.00nan;0;0
7670;86344;78;0;0;0;0;.00nan;0;0
7670;149450;4920;86;42;3;39;.929;3900000;0
7671;163784;77;95;37;1;36;.973;3763000;0
7671;-1;1096;0;0;0;0;.00nan;0;0
7671;141978;1096;90;35;2;33;.943;3763000;0
7671;161047;77;0;0;0;0;.00nan;0;0
7672;-1;74;0;0;0;0;.00nan;0;0
7672;-1;4922;0;0;0;0;.00nan;0;0
7672;58100;74;60;20;2;18;.900;3900000;0
7672;91742;4922;93;55;2;53;.964;3900000;0
7673;163195;67;68;21;2;19;.905;3562000;0
7673;164987;85;88;28;1;27;.964;3600000;0
7673;38124;67;0;0;0;0;.00nan;0;0
7673;86862;85;0;0;0;0;.00nan;0;0
7674;-1;74;0;0;0;0;.00nan;0;0
7674;170728;1097;0;0;0;0;.00nan;0;0
7674;43928;1097;82;28;2;26;.929;3709000;0
7674;58100;74;92;51;3;48;.941;3709000;0
7675;5559;72;0;0;0;0;.00nan;0;0
7675;181446;71;0;0;0;0;.00nan;0;0
7675;64811;72;100;48;1;47;.979;3600000;0
7675;78479;71;63;22;2;20;.909;3548000;0
7676;163784;77;68;41;4;37;.902;3557000;0
7676;164913;75;0;0;0;0;.00nan;0;0
7676;173856;75;70;27;2;25;.926;3600000;0
7676;161047;77;0;0;0;0;.00nan;0;0
7677;13325;2564;85;46;4;42;.913;3900000;0
7677;166441;2564;0;0;0;0;.00nan;0;0
7677;79141;1095;0;0;0;0;.00nan;0;0
7677;149858;1095;64;35;4;31;.886;3896000;0
7678;178911;152;56;26;3;23;.885;3600000;0
7678;178950;152;0;0;0;0;.00nan;0;0
7678;180873;69;48;34;5;29;.853;3542000;0
7678;79211;69;0;0;0;0;.00nan;0;0
7679;85349;82;0;0;0;0;.00nan;0;0
7679;85555;76;74;42;4;38;.905;3600000;0
7679;86151;82;85;14;0;14;1.000;3600000;0
7679;91703;76;0;0;0;0;.00nan;0;0
7680;2410;81;81;31;2;29;.935;3558000;0
7680;-1;149;0;0;0;0;.00nan;0;0
7680;64722;149;100;37;1;36;.973;3600000;0
7680;70213;81;0;0;0;0;.00nan;0;0
7681;-1;4922;88;45;4;41;.911;3577000;0
7681;-1;1096;71;26;2;24;.923;3600000;0
7681;91742;4922;0;0;0;0;.00nan;0;0
7681;141978;1096;0;0;0;0;.00nan;0;0
7682;57657;73;0;0;0;0;.00nan;0;0
7682;85437;4921;0;0;0;0;.00nan;0;0
7682;86472;73;74;36;3;33;.917;3820000;0
7682;152418;4921;57;31;4;27;.871;3827000;0
7683;-1;4620;55;25;3;22;.880;3600000;0
7683;173961;4620;0;0;0;0;.00nan;0;0
7683;175658;4245;0;0;0;0;.00nan;0;0
7683;57998;4245;68;44;5;39;.886;3580000;0
7684;163989;80;60;22;2;20;.909;3600000;0
7684;173874;158;85;42;3;39;.929;3562000;0
7684;170612;80;0;0;0;0;.00nan;0;0
7684;181071;158;0;0;0;0;.00nan;0;0
7685;-1;151;0;0;0;0;.00nan;0;0
7685;19708;157;0;0;0;0;.00nan;0;0
7685;60123;157;78;36;2;34;.944;3600000;0
7685;85507;151;65;42;5;37;.881;3600000;0
7686;-1;78;0;0;0;0;.00nan;0;0
7686;181123;4920;0;0;0;0;.00nan;0;0
7686;86344;78;86;30;1;29;.967;3600000;0
7686;149450;4920;59;29;4;25;.862;3600000;0
7687;163195;67;58;12;2;10;.833;3900000;0
7687;164987;85;0;0;0;0;.00nan;0;0
7687;38124;67;0;0;0;0;.00nan;0;0
7687;86862;85;98;53;2;51;.962;3900000;0
7688;79141;1095;0;0;0;0;.00nan;0;0
7688;85437;4921;47;31;5;26;.839;3600000;0
7688;149858;1095;91;44;3;41;.932;3600000;0
7688;152418;4921;0;0;0;0;.00nan;0;0
7689;-1;74;0;0;0;0;.00nan;0;0
7689;170728;1097;67;16;1;15;.938;3600000;0
7689;43928;1097;0;0;0;0;.00nan;0;0
7689;58100;74;75;37;2;35;.946;3543000;0
7690;13325;2564;0;0;0;0;.00nan;0;0
7690;166441;2564;92;46;3;43;.935;3867000;0
7690;181446;71;0;0;0;0;.00nan;0;0
7690;78479;71;82;27;2;25;.926;3867000;0
7691;178911;152;0;0;0;0;.00nan;0;0
7691;178950;152;79;35;3;32;.914;3600000;0
7691;180873;69;0;0;0;0;.00nan;0;0
7691;79211;69;58;38;5;33;.868;3546000;0
7692;85349;82;0;0;0;0;.00nan;0;0
7692;85555;76;0;0;0;0;.00nan;0;0
7692;86151;82;88;33;2;31;.939;3600000;0
7692;91703;76;66;38;5;33;.868;3600000;0
7693;-1;4922;0;0;0;0;.00nan;0;0
7693;-1;1096;0;0;0;0;.00nan;0;0
7693;91742;4922;80;32;2;30;.938;3561000;0
7693;141978;1096;84;30;1;29;.967;3600000;0
7694;2410;81;0;0;0;0;.00nan;0;0
7694;-1;149;0;0;0;0;.00nan;0;0
7694;64722;149;75;39;4;35;.897;3600000;0
7694;70213;81;79;30;1;29;.967;3600000;0
7695;163784;77;38;35;6;29;.829;3257000;0
7695;164913;75;61;24;2;22;.917;3600000;0
7695;173856;75;0;0;0;0;.00nan;0;0
7695;161047;77;52;4;0;4;1.000;343000;0
7696;5559;72;31;37;7;30;.811;3599000;0
7696;57657;73;45;31;5;26;.839;3600000;0
7696;64811;72;0;0;0;0;.00nan;0;0
7696;86472;73;0;0;0;0;.00nan;0;0
7697;-1;4620;0;0;0;0;.00nan;0;0
7697;173961;4620;43;21;4;17;.810;3600000;0
7697;175658;4245;63;51;6;45;.882;2843000;0
7697;57998;4245;56;6;0;6;1.000;704000;0
7698;-1;151;0;0;0;0;.00nan;0;0
7698;19708;157;0;0;0;0;.00nan;0;0
7698;60123;157;72;28;2;26;.929;3600000;0
7698;85507;151;53;47;6;41;.872;3600000;0
7699;163989;80;0;0;0;0;.00nan;0;0
7699;173874;158;0;0;0;0;.00nan;0;0
7699;170612;80;49;26;4;22;.846;3539000;0
7699;181071;158;69;29;2;27;.931;3600000;0
7700;-1;78;0;0;0;0;.00nan;0;0
7700;181123;4920;0;0;0;0;.00nan;0;0
7700;86344;78;46;26;4;22;.846;3600000;0
7700;149450;4920;84;33;2;31;.939;3600000;0
7701;13325;2564;64;39;4;35;.897;3900000;0
7701;166441;2564;0;0;0;0;.00nan;0;0
7701;79141;1095;0;0;0;0;.00nan;0;0
7701;149858;1095;62;35;4;31;.886;3900000;0
7702;2410;81;73;35;2;33;.943;3900000;0
7702;19708;157;0;0;0;0;.00nan;0;0
7702;60123;157;83;38;2;36;.947;3900000;0
7702;70213;81;0;0;0;0;.00nan;0;0
7703;5559;72;0;0;0;0;.00nan;0;0
7703;64811;72;59;27;3;24;.889;3600000;0
7703;85437;4921;0;0;0;0;.00nan;0;0
7703;152418;4921;52;31;4;27;.871;3554000;0
7704;180873;69;84;29;1;28;.966;3600000;0
7704;57657;73;77;31;2;29;.935;3549000;0
7704;79211;69;0;0;0;0;.00nan;0;0
7704;86472;73;0;0;0;0;.00nan;0;0
7705;164987;85;45;25;4;21;.840;3600000;0
7705;85555;76;76;26;1;25;.962;3600000;0
7705;86862;85;0;0;0;0;.00nan;0;0
7705;91703;76;0;0;0;0;.00nan;0;0
7706;-1;4620;42;28;5;23;.821;3600000;0
7706;173961;4620;0;0;0;0;.00nan;0;0
7706;175658;4245;48;0;0;0;.00nan;204000;0
7706;57998;4245;40;34;6;28;.824;3343000;0
7707;-1;151;0;0;0;0;.00nan;0;0
7707;178911;152;63;21;2;19;.905;3600000;0
7707;178950;152;0;0;0;0;.00nan;0;0
7707;85507;151;72;39;3;36;.923;3600000;0
7708;-1;149;0;0;0;0;.00nan;0;0
7708;173874;158;68;36;4;32;.889;3578000;0
7708;181071;158;0;0;0;0;.00nan;0;0
7708;64722;149;58;27;3;24;.889;3600000;0
7709;170728;1097;0;0;0;0;.00nan;0;0
7709;43928;1097;78;37;3;34;.919;3600000;0
7709;85349;82;0;0;0;0;.00nan;0;0
7709;86151;82;89;46;4;42;.913;3600000;0
7710;164913;75;53;3;0;3;1.000;382000;0
7710;173856;75;40;38;6;32;.842;3218000;0
7710;-1;1096;0;0;0;0;.00nan;0;0
7710;141978;1096;79;26;1;25;.962;3600000;0
7711;163195;67;50;24;4;20;.833;3566000;0
7711;-1;149;0;0;0;0;.00nan;0;0
7711;38124;67;0;0;0;0;.00nan;0;0
7711;64722;149;75;29;2;27;.931;3600000;0
7712;170728;1097;71;34;3;31;.912;3547000;0
7712;43928;1097;0;0;0;0;.00nan;0;0
7712;85349;82;67;26;2;24;.923;3600000;0
7712;86151;82;0;0;0;0;.00nan;0;0
7713;13325;2564;92;51;4;47;.922;3600000;0
7713;166441;2564;0;0;0;0;.00nan;0;0
7713;79141;1095;0;0;0;0;.00nan;0;0
7713;149858;1095;40;29;5;24;.828;3562000;0
7714;2410;81;20;11;4;7;.636;974000;0
7714;19708;157;33;19;5;14;.737;3388000;0
7714;60123;157;31;8;3;5;.625;212000;0
7714;70213;81;37;24;5;19;.792;2626000;0
7715;180873;69;0;0;0;0;.00nan;0;0
7715;57657;73;98;38;1;37;.974;3600000;0
7715;79211;69;76;38;3;35;.921;3587000;0
7715;86472;73;0;0;0;0;.00nan;0;0
7716;-1;78;67;33;3;30;.909;3544000;0
7716;175658;4245;0;0;0;0;.00nan;0;0
7716;57998;4245;84;37;2;35;.946;3600000;0
7716;86344;78;0;0;0;0;.00nan;0;0
7717;-1;4620;33;21;5;16;.762;3591000;0
7717;173961;4620;0;0;0;0;.00nan;0;0
7717;181123;4920;0;0;0;0;.00nan;0;0
7717;149450;4920;61;31;4;27;.871;3600000;0
7718;164987;85;0;0;0;0;.00nan;0;0
7718;85555;76;50;32;5;27;.844;3562000;0
7718;86862;85;83;45;3;42;.933;3600000;0
7718;91703;76;0;0;0;0;.00nan;0;0
7719;163784;77;35;35;6;29;.829;3600000;0
7719;-1;4922;0;0;0;0;.00nan;0;0
7719;91742;4922;91;51;4;47;.922;3600000;0
7719;161047;77;0;0;0;0;.00nan;0;0
7720;164913;75;69;30;3;27;.900;3789000;0
7720;173856;75;0;0;0;0;.00nan;0;0
7720;-1;1096;72;28;2;26;.929;3789000;0
7720;141978;1096;0;0;0;0;.00nan;0;0
7721;163989;80;79;30;2;28;.933;3600000;0
7721;173874;158;0;0;0;0;.00nan;0;0
7721;170612;80;0;0;0;0;.00nan;0;0
7721;181071;158;48;30;4;26;.867;3600000;0
7722;-1;151;87;36;3;33;.917;3600000;0
7722;178911;152;20;18;5;13;.722;3517000;0
7722;178950;152;0;0;0;0;.00nan;0;0
7722;85507;151;0;0;0;0;.00nan;0;0
7723;181446;71;0;0;0;0;.00nan;0;0
7723;78479;71;83;39;4;35;.897;3600000;0
7723;85437;4921;91;18;0;18;1.000;3600000;0
7723;152418;4921;0;0;0;0;.00nan;0;0
7724;163195;67;100;34;1;33;.971;3600000;0
7724;-1;149;0;0;0;0;.00nan;0;0
7724;38124;67;0;0;0;0;.00nan;0;0
7724;64722;149;50;40;6;34;.850;3600000;0
7725;5559;72;0;0;0;0;.00nan;0;0
7725;181446;71;0;0;0;0;.00nan;0;0
7725;64811;72;68;43;5;38;.884;3600000;0
7725;78479;71;94;36;2;34;.944;3600000;0
7726;2410;81;100;58;3;55;.948;3900000;0
7726;19708;157;0;0;0;0;.00nan;0;0
7726;60123;157;61;22;3;19;.864;3900000;0
7726;70213;81;0;0;0;0;.00nan;0;0
7727;180873;69;86;37;3;34;.919;3747000;0
7727;57657;73;0;0;0;0;.00nan;0;0
7727;79211;69;0;0;0;0;.00nan;0;0
7727;86472;73;83;28;2;26;.929;3747000;0
7728;13325;2564;69;29;2;27;.931;3600000;0
7728;166441;2564;0;0;0;0;.00nan;0;0
7728;79141;1095;55;16;1;15;.938;956000;0
7728;149858;1095;27;21;6;15;.714;2644000;0
7729;-1;4620;0;0;0;0;.00nan;0;0
7729;173961;4620;63;22;2;20;.909;3600000;0
7729;181123;4920;0;0;0;0;.00nan;0;0
7729;149450;4920;51;30;5;25;.833;3600000;0
7730;164987;85;85;37;2;35;.946;3900000;0
7730;85555;76;0;0;0;0;.00nan;0;0
7730;86862;85;0;0;0;0;.00nan;0;0
7730;91703;76;92;33;2;31;.939;3900000;0
7731;163784;77;81;42;3;39;.929;3600000;0
7731;-1;4922;100;39;0;39;1.000;3600000;0
7731;91742;4922;0;0;0;0;.00nan;0;0
7731;161047;77;0;0;0;0;.00nan;0;0
7732;170728;1097;0;0;0;0;.00nan;0;0
7732;-1;1096;0;0;0;0;.00nan;0;0
7732;43928;1097;67;23;2;21;.913;3546000;0
7732;141978;1096;91;30;1;29;.967;3600000;0
7733;164913;75;0;0;0;0;.00nan;0;0
7733;-1;74;0;0;0;0;.00nan;0;0
7733;173856;75;42;28;5;23;.821;3548000;0
7733;58100;74;40;23;4;19;.826;3600000;0
7734;-1;151;0;0;0;0;.00nan;0;0
7734;178911;152;0;0;0;0;.00nan;0;0
7734;178950;152;85;40;3;37;.925;3600000;0
7734;85507;151;85;45;4;41;.911;3581000;0
7735;163989;80;0;0;0;0;.00nan;0;0
7735;173874;158;20;23;6;17;.739;3520000;0
7735;170612;80;53;26;4;22;.846;3600000;0
7735;181071;158;0;0;0;0;.00nan;0;0
7736;-1;78;0;0;0;0;.00nan;0;0
7736;175658;4245;28;6;3;3;.500;335000;0
7736;57998;4245;79;35;2;33;.943;3208000;0
7736;86344;78;55;31;4;27;.871;3600000;0
7737;163195;67;100;34;2;32;.941;3600000;0
7737;-1;149;0;0;0;0;.00nan;0;0
7737;38124;67;0;0;0;0;.00nan;0;0
7737;64722;149;42;24;4;20;.833;3575000;0
7738;-1;74;0;0;0;0;.00nan;0;0
7738;58100;74;75;41;4;37;.902;3579000;0
7738;85349;82;0;0;0;0;.00nan;0;0
7738;86151;82;55;23;3;20;.870;3600000;0
7739;13325;2564;0;0;0;0;.00nan;0;0
7739;166441;2564;79;38;2;36;.947;3900000;0
7739;181446;71;0;0;0;0;.00nan;0;0
7739;78479;71;68;23;2;21;.913;3900000;0
7740;-1;4620;79;34;2;32;.941;3573000;0
7740;173961;4620;0;0;0;0;.00nan;0;0
7740;181123;4920;0;0;0;0;.00nan;0;0
7740;149450;4920;80;22;1;21;.955;3600000;0
7741;163784;77;61;37;4;33;.892;3592000;0
7741;-1;4922;0;0;0;0;.00nan;0;0
7741;91742;4922;67;24;2;22;.917;3600000;0
7741;161047;77;0;0;0;0;.00nan;0;0
7742;5559;72;60;54;8;46;.852;3600000;0
7742;64811;72;0;0;0;0;.00nan;0;0
7742;85437;4921;70;29;3;26;.897;3600000;0
7742;152418;4921;0;0;0;0;.00nan;0;0
7743;163989;80;51;33;5;28;.848;3600000;0
7743;173874;158;0;0;0;0;.00nan;0;0
7743;170612;80;0;0;0;0;.00nan;0;0
7743;181071;158;99;43;1;42;.977;3600000;0
7744;-1;78;62;33;4;29;.879;3899000;0
7744;175658;4245;67;45;4;41;.911;3900000;0
7744;57998;4245;0;0;0;0;.00nan;0;0
7744;86344;78;0;0;0;0;.00nan;0;0
7745;178911;152;99;36;1;35;.972;3788000;0
7745;178950;152;0;0;0;0;.00nan;0;0
7745;79141;1095;0;0;0;0;.00nan;0;0
7745;149858;1095;70;24;2;22;.917;3788000;0
7746;-1;74;0;0;0;0;.00nan;0;0
7746;170728;1097;0;0;0;0;.00nan;0;0
7746;43928;1097;67;31;3;28;.903;3600000;0
7746;58100;74;71;47;5;42;.894;3568000;0
7747;13325;2564;78;45;4;41;.911;3600000;0
7747;166441;2564;0;0;0;0;.00nan;0;0
7747;180873;69;53;3;0;3;1.000;380000;0
7747;79211;69;28;27;7;20;.741;3220000;0
7748;178911;152;0;0;0;0;.00nan;0;0
7748;178950;152;84;25;1;24;.960;3600000;0
7748;79141;1095;0;0;0;0;.00nan;0;0
7748;149858;1095;84;36;2;34;.944;3600000;0
7749;181123;4920;0;0;0;0;.00nan;0;0
7749;85555;76;0;0;0;0;.00nan;0;0
7749;91703;76;68;35;4;31;.886;3553000;0
7749;149450;4920;90;36;2;34;.944;3600000;0
7750;2410;81;100;37;1;36;.973;3600000;0
7750;173874;158;75;37;3;34;.919;3583000;0
7750;181071;158;0;0;0;0;.00nan;0;0
7750;70213;81;0;0;0;0;.00nan;0;0
7751;164913;75;0;0;0;0;.00nan;0;0
7751;173856;75;73;31;3;28;.903;3880000;0
7751;170728;1097;51;33;4;29;.879;3880000;0
7751;43928;1097;0;0;0;0;.00nan;0;0
7752;5559;72;0;0;0;0;.00nan;0;0
7752;181446;71;0;0;0;0;.00nan;0;0
7752;64811;72;85;48;4;44;.917;3782000;0
7752;78479;71;64;35;3;32;.914;3782000;0
7753;163784;77;0;0;0;0;.00nan;0;0
7753;85349;82;0;0;0;0;.00nan;0;0
7753;86151;82;89;15;0;15;1.000;3600000;0
7753;161047;77;64;42;4;38;.905;3600000;0
7754;-1;151;0;0;0;0;.00nan;0;0
7754;19708;157;0;0;0;0;.00nan;0;0
7754;60123;157;62;20;3;17;.850;3600000;0
7754;85507;151;90;55;4;51;.927;3600000;0
7755;13325;2564;87;34;2;32;.941;3600000;0
7755;166441;2564;0;0;0;0;.00nan;0;0
7755;180873;69;51;30;4;26;.867;3562000;0
7755;79211;69;0;0;0;0;.00nan;0;0
7756;-1;74;0;0;0;0;.00nan;0;0
7756;-1;1096;0;0;0;0;.00nan;0;0
7756;58100;74;69;27;2;25;.926;3600000;0
7756;141978;1096;77;32;3;29;.906;3600000;0
7757;163195;67;89;47;4;43;.915;3600000;0
7757;175658;4245;0;0;0;0;.00nan;0;0
7757;38124;67;0;0;0;0;.00nan;0;0
7757;57998;4245;95;33;1;32;.970;3600000;0
7758;2410;81;100;35;1;34;.971;3600000;0
7758;173874;158;0;0;0;0;.00nan;0;0
7758;181071;158;66;25;2;23;.920;3566000;0
7758;70213;81;0;0;0;0;.00nan;0;0
7759;164987;85;0;0;0;0;.00nan;0;0
7759;-1;4922;0;0;0;0;.00nan;0;0
7759;86862;85;81;37;3;34;.919;3600000;0
7759;91742;4922;83;44;4;40;.909;3600000;0
7760;-1;78;0;0;0;0;.00nan;0;0
7760;-1;4620;61;31;3;28;.903;3600000;0
7760;173961;4620;0;0;0;0;.00nan;0;0
7760;86344;78;62;30;4;26;.867;3555000;0
7761;163989;80;15;19;6;13;.684;3600000;0
7761;-1;149;0;0;0;0;.00nan;0;0
7761;170612;80;0;0;0;0;.00nan;0;0
7761;64722;149;93;47;2;45;.957;3600000;0
7762;57657;73;86;46;3;43;.935;3597000;0
7762;85437;4921;0;0;0;0;.00nan;0;0
7762;86472;73;0;0;0;0;.00nan;0;0
7762;152418;4921;59;19;2;17;.895;3600000;0
7763;163195;67;0;0;0;0;.00nan;0;0
7763;175658;4245;73;38;3;35;.921;3900000;0
7763;38124;67;54;29;3;26;.897;3900000;0
7763;57998;4245;0;0;0;0;.00nan;0;0
7764;163989;80;61;4;0;4;1.000;651000;0
7764;-1;149;0;0;0;0;.00nan;0;0
7764;170612;80;47;43;7;36;.837;2949000;0
7764;64722;149;81;35;2;33;.943;3600000;0
7765;164913;75;27;26;6;20;.769;2730000;0
7765;173856;75;52;10;1;9;.900;850000;0
7765;170728;1097;0;0;0;0;.00nan;0;0
7765;43928;1097;53;34;5;29;.853;3600000;0
7766;-1;151;100;61;2;59;.967;3900000;0
7766;19708;157;0;0;0;0;.00nan;0;0
7766;60123;157;75;22;2;20;.909;3900000;0
7766;85507;151;0;0;0;0;.00nan;0;0
7767;5559;72;74;25;2;23;.920;3600000;0
7767;13325;2564;71;40;4;36;.900;3557000;0
7767;166441;2564;0;0;0;0;.00nan;0;0
7767;64811;72;0;0;0;0;.00nan;0;0
7768;178911;152;43;40;6;34;.850;3571000;0
7768;178950;152;0;0;0;0;.00nan;0;0
7768;180873;69;0;0;0;0;.00nan;0;0
7768;79211;69;64;34;4;30;.882;3600000;0
7769;-1;74;0;0;0;0;.00nan;0;0
7769;58100;74;85;26;1;25;.962;3600000;0
7769;85349;82;0;0;0;0;.00nan;0;0
7769;86151;82;77;30;2;28;.933;3600000;0
7770;181123;4920;0;0;0;0;.00nan;0;0
7770;85555;76;0;0;0;0;.00nan;0;0
7770;91703;76;74;22;1;21;.955;3686000;0
7770;149450;4920;100;44;0;44;1.000;3686000;0
7771;2410;81;0;0;0;0;.00nan;0;0
7771;173874;158;26;38;8;30;.789;3600000;0
7771;181071;158;0;0;0;0;.00nan;0;0
7771;70213;81;42;25;5;20;.800;3600000;0
7772;164987;85;100;23;0;23;1.000;3600000;0
7772;-1;4922;58;41;6;35;.854;3600000;0
7772;86862;85;0;0;0;0;.00nan;0;0
7772;91742;4922;0;0;0;0;.00nan;0;0
7773;163784;77;68;49;6;43;.878;3553000;0
7773;-1;1096;37;20;4;16;.800;3600000;0
7773;141978;1096;0;0;0;0;.00nan;0;0
7773;161047;77;0;0;0;0;.00nan;0;0
7774;181446;71;0;0;0;0;.00nan;0;0
7774;57657;73;0;0;0;0;.00nan;0;0
7774;78479;71;49;17;3;14;.824;3600000;0
7774;86472;73;64;38;4;34;.895;3600000;0
7775;-1;78;45;25;4;21;.840;3873000;0
7775;-1;4620;0;0;0;0;.00nan;0;0
7775;173961;4620;75;40;4;36;.900;3900000;0
7775;86344;78;0;0;0;0;.00nan;0;0
7776;79141;1095;0;0;0;0;.00nan;0;0
7776;85437;4921;86;34;2;32;.941;3557000;0
7776;149858;1095;80;31;1;30;.968;3600000;0
7776;152418;4921;0;0;0;0;.00nan;0;0
7777;163195;67;56;35;4;31;.886;3521000;0
7777;175658;4245;0;0;0;0;.00nan;0;0
7777;38124;67;0;0;0;0;.00nan;0;0
7777;57998;4245;66;22;2;20;.909;3600000;0
7778;163989;80;67;34;3;31;.912;3600000;0
7778;-1;149;0;0;0;0;.00nan;0;0
7778;170612;80;0;0;0;0;.00nan;0;0
7778;64722;149;49;33;5;28;.848;3583000;0
7779;181446;71;0;0;0;0;.00nan;0;0
7779;57657;73;58;44;5;39;.886;3554000;0
7779;78479;71;57;23;3;20;.870;3600000;0
7779;86472;73;0;0;0;0;.00nan;0;0
7780;163784;77;0;0;0;0;.00nan;0;0
7780;-1;1096;0;0;0;0;.00nan;0;0
7780;141978;1096;65;28;3;25;.893;3834000;0
7780;161047;77;89;36;2;34;.944;3834000;0
7781;-1;74;0;0;0;0;.00nan;0;0
7781;58100;74;57;41;6;35;.854;3600000;0
7781;85349;82;68;28;2;26;.929;3600000;0
7781;86151;82;0;0;0;0;.00nan;0;0
7782;181123;4920;0;0;0;0;.00nan;0;0
7782;85555;76;0;0;0;0;.00nan;0;0
7782;91703;76;46;28;4;24;.857;3538000;0
7782;149450;4920;78;29;2;27;.931;3600000;0
7783;-1;78;50;1;0;1;1.000;834000;0
7783;-1;4620;90;38;3;35;.921;3600000;0
7783;173961;4620;0;0;0;0;.00nan;0;0
7783;86344;78;35;35;6;29;.829;2766000;0
7785;163784;77;0;0;0;0;.00nan;0;0
7785;-1;1096;58;33;4;29;.879;3575000;0
7785;141978;1096;0;0;0;0;.00nan;0;0
7785;161047;77;52;24;3;21;.875;3600000;0
7787;37942;1095;0;0;0;0;.00nan;0;0
7787;79141;1095;85;47;4;43;.915;3555000;0
7787;85555;76;96;44;3;41;.932;3600000;0
7787;91703;76;0;0;0;0;.00nan;0;0
7789;163989;80;75;36;4;32;.889;3545000;0
7789;-1;151;0;0;0;0;.00nan;0;0
7789;170612;80;0;0;0;0;.00nan;0;0
7789;85507;151;91;44;3;41;.932;3600000;0
7791;3;67;0;0;0;0;.00nan;0;0
7791;163195;67;54;36;5;31;.861;3600000;0
7791;-1;78;100;30;0;30;1.000;3600000;0
7791;169154;78;0;0;0;0;.00nan;0;0
7793;161535;157;57;23;3;20;.870;3600000;0
7793;164987;157;0;0;0;0;.00nan;0;0
7793;13325;2564;56;29;4;25;.862;3549000;0
7793;166441;2564;0;0;0;0;.00nan;0;0
7795;5559;4245;0;0;0;0;.00nan;0;0
7795;180873;69;0;0;0;0;.00nan;0;0
7795;79211;69;96;35;1;34;.971;3600000;0
7795;149858;4245;60;28;3;25;.893;3515000;0
7797;164913;75;0;0;0;0;.00nan;0;0
7797;173856;75;88;44;4;40;.909;3600000;0
7797;178911;152;0;0;0;0;.00nan;0;0
7797;178950;152;68;26;2;24;.923;3600000;0
7799;-1;74;56;30;3;27;.900;3600000;0
7799;-1;149;24;7;3;4;.571;203000;0
7799;180606;74;0;0;0;0;.00nan;0;0
7799;141419;149;66;19;1;18;.947;3397000;0
7801;2495;73;0;0;0;0;.00nan;0;0
7801;-1;4922;0;0;0;0;.00nan;0;0
7801;91742;4922;79;34;2;32;.941;3537000;0
7801;149450;73;100;34;0;34;1.000;3600000;0
7803;2410;81;68;26;3;23;.885;3600000;0
7803;170728;1097;48;31;6;25;.806;3600000;0
7803;43928;1097;0;0;0;0;.00nan;0;0
7803;70213;81;0;0;0;0;.00nan;0;0
7805;181123;4920;0;0;0;0;.00nan;0;0
7805;78479;4920;76;27;2;25;.926;3600000;0
7805;85132;4921;0;0;0;0;.00nan;0;0
7805;152418;4921;64;37;4;33;.892;3596000;0
7807;173874;158;55;41;6;35;.854;3600000;0
7807;181071;158;0;0;0;0;.00nan;0;0
7807;85349;82;0;0;0;0;.00nan;0;0
7807;86151;82;58;12;1;11;.917;3600000;0
7809;-1;4620;78;48;4;44;.917;3600000;0
7809;173961;4620;0;0;0;0;.00nan;0;0
7809;181446;71;0;0;0;0;.00nan;0;0
7809;85984;71;87;27;1;26;.963;3600000;0
7811;165380;72;0;0;0;0;.00nan;0;0
7811;181269;85;0;0;0;0;.00nan;0;0
7811;85228;72;74;40;4;36;.900;3547000;0
7811;152624;85;61;26;2;24;.923;3600000;0
2232;163195;67;71;40;4;36;.900;3600000;0
2232;-1;4620;70;18;1;17;.944;3600000;0
2232;173961;4620;0;0;0;0;.00nan;0;0
2232;38124;67;0;0;0;0;.00nan;0;0
2233;-1;78;0;0;0;0;.00nan;0;0
2233;181123;4920;0;0;0;0;.00nan;0;0
2233;86344;78;57;33;4;29;.879;3600000;0
2233;149450;4920;36;37;7;30;.811;3600000;0
2234;85349;82;0;0;0;0;.00nan;0;0
2234;85555;76;85;45;3;42;.933;3525000;0
2234;86151;82;78;22;1;21;.955;3600000;0
2234;91703;76;0;0;0;0;.00nan;0;0
2235;-1;74;0;0;0;0;.00nan;0;0
2235;170728;1097;0;0;0;0;.00nan;0;0
2235;43928;1097;86;28;2;26;.929;4369000;0
2235;58100;74;84;38;3;35;.921;4369000;0
2236;181446;71;83;26;1;25;.962;2056000;0
2236;78479;71;14;17;5;12;.706;1544000;0
2236;85437;4921;0;0;0;0;.00nan;0;0
2236;152418;4921;54;24;3;21;.875;3600000;0
2237;57657;73;59;35;4;31;.886;3600000;0
2237;79141;1095;0;0;0;0;.00nan;0;0
2237;86472;73;0;0;0;0;.00nan;0;0
2237;149858;1095;87;28;1;27;.964;3600000;0
2238;163989;80;43;28;5;23;.821;3600000;0
2238;19708;157;0;0;0;0;.00nan;0;0
2238;170612;80;0;0;0;0;.00nan;0;0
2238;60123;157;79;22;1;21;.955;3600000;0
2239;2410;81;83;35;2;33;.943;3600000;0
2239;178911;152;67;28;3;25;.893;3595000;0
2239;178950;152;0;0;0;0;.00nan;0;0
2239;70213;81;0;0;0;0;.00nan;0;0
2240;163195;67;59;35;4;31;.886;3577000;0
2240;-1;4620;54;22;3;19;.864;3600000;0
2240;173961;4620;0;0;0;0;.00nan;0;0
2240;38124;67;0;0;0;0;.00nan;0;0
2241;-1;78;0;0;0;0;.00nan;0;0
2241;181123;4920;0;0;0;0;.00nan;0;0
2241;86344;78;53;23;3;20;.870;3564000;0
2241;149450;4920;75;33;2;31;.939;3600000;0
2242;85349;82;0;0;0;0;.00nan;0;0
2242;85555;76;41;30;5;25;.833;3600000;0
2242;86151;82;84;24;1;23;.958;3600000;0
2242;91703;76;0;0;0;0;.00nan;0;0
2243;-1;74;0;0;0;0;.00nan;0;0
2243;170728;1097;0;0;0;0;.00nan;0;0
2243;43928;1097;68;19;1;18;.947;3600000;0
2243;58100;74;90;47;2;45;.957;3587000;0
2244;181446;71;37;5;2;3;.600;737000;0
2244;78479;71;39;29;6;23;.793;2863000;0
2244;85437;4921;63;23;3;20;.870;3600000;0
2244;152418;4921;0;0;0;0;.00nan;0;0
2245;57657;73;37;34;6;28;.824;3581000;0
2245;79141;1095;0;0;0;0;.00nan;0;0
2245;86472;73;0;0;0;0;.00nan;0;0
2245;149858;1095;76;41;4;37;.902;3600000;0
2246;163989;80;25;33;7;26;.788;3600000;0
2246;19708;157;0;0;0;0;.00nan;0;0
2246;170612;80;0;0;0;0;.00nan;0;0
2246;60123;157;71;14;1;13;.929;3600000;0
2247;2410;81;47;21;3;18;.857;3583000;0
2247;178911;152;79;34;2;32;.941;3600000;0
2247;178950;152;0;0;0;0;.00nan;0;0
2247;70213;81;0;0;0;0;.00nan;0;0
2248;163195;67;69;26;3;23;.885;3600000;0
2248;-1;4620;42;31;5;26;.839;3600000;0
2248;173961;4620;0;0;0;0;.00nan;0;0
2248;38124;67;0;0;0;0;.00nan;0;0
2249;-1;78;0;0;0;0;.00nan;0;0
2249;181123;4920;23;17;5;12;.706;1257000;0
2249;86344;78;53;30;4;26;.867;3600000;0
2249;149450;4920;53;29;4;25;.862;2343000;0
2250;85349;82;0;0;0;0;.00nan;0;0
2250;85555;76;100;35;1;34;.971;3600000;0
2250;86151;82;59;29;4;25;.862;3600000;0
2250;91703;76;0;0;0;0;.00nan;0;0
2251;-1;74;0;0;0;0;.00nan;0;0
2251;170728;1097;0;0;0;0;.00nan;0;0
2251;43928;1097;94;44;2;42;.955;3680000;0
2251;58100;74;59;24;3;21;.875;3680000;0
2252;181446;71;0;0;0;0;.00nan;0;0
2252;78479;71;77;37;3;34;.919;3528000;0
2252;85437;4921;91;28;1;27;.964;3600000;0
2252;152418;4921;0;0;0;0;.00nan;0;0
2253;57657;73;57;23;3;20;.870;3600000;0
2253;79141;1095;0;0;0;0;.00nan;0;0
2253;86472;73;0;0;0;0;.00nan;0;0
2253;149858;1095;68;44;5;39;.886;3586000;0
2254;163989;80;92;38;1;37;.974;3600000;0
2254;19708;157;0;0;0;0;.00nan;0;0
2254;170612;80;0;0;0;0;.00nan;0;0
2254;60123;157;44;25;4;21;.840;3600000;0
2255;2410;81;68;40;4;36;.900;3575000;0
2255;178911;152;90;53;2;51;.962;3600000;0
2255;178950;152;0;0;0;0;.00nan;0;0
2255;70213;81;0;0;0;0;.00nan;0;0
2256;163195;67;65;29;3;26;.897;3600000;0
2256;-1;4620;66;38;4;34;.895;3579000;0
2256;173961;4620;0;0;0;0;.00nan;0;0
2256;38124;67;0;0;0;0;.00nan;0;0
2257;-1;78;0;0;0;0;.00nan;0;0
2257;181123;4920;0;0;0;0;.00nan;0;0
2257;86344;78;35;25;5;20;.800;3845000;0
2257;149450;4920;80;46;4;42;.913;3845000;0
2258;85349;82;41;17;3;14;.824;1962000;0
2258;85555;76;58;43;5;38;.884;3600000;0
2258;86151;82;13;16;6;10;.625;1638000;0
2258;91703;76;0;0;0;0;.00nan;0;0
2259;-1;74;0;0;0;0;.00nan;0;0
2259;170728;1097;0;0;0;0;.00nan;0;0
2259;43928;1097;57;27;3;24;.889;3600000;0
2259;58100;74;79;32;2;30;.938;3600000;0
2260;181446;71;0;0;0;0;.00nan;0;0
2260;78479;71;71;31;2;29;.935;3697000;0
2260;85437;4921;99;38;1;37;.974;3697000;0
2260;152418;4921;0;0;0;0;.00nan;0;0
2261;57657;73;40;30;5;25;.833;3532000;0
2261;79141;1095;0;0;0;0;.00nan;0;0
2261;86472;73;0;0;0;0;.00nan;0;0
2261;149858;1095;81;31;3;28;.903;3600000;0
2262;163989;80;75;36;3;33;.917;4012000;0
2262;19708;157;0;0;0;0;.00nan;0;0
2262;170612;80;0;0;0;0;.00nan;0;0
2262;60123;157;77;24;2;22;.917;4012000;0
2263;2410;81;84;29;1;28;.966;3600000;0
2263;178911;152;65;38;4;34;.895;3600000;0
2263;178950;152;0;0;0;0;.00nan;0;0
2263;70213;81;0;0;0;0;.00nan;0;0
98;163195;67;64;28;3;25;.893;3573000;0
98;-1;4620;100;37;1;36;.973;3600000;0
98;173961;4620;0;0;0;0;.00nan;0;0
98;38124;67;0;0;0;0;.00nan;0;0
99;-1;78;0;0;0;0;.00nan;0;0
99;181123;4920;0;0;0;0;.00nan;0;0
99;86344;78;64;37;4;33;.892;4352000;0
99;149450;4920;79;42;3;39;.929;4354000;0
100;85349;82;57;26;3;23;.885;3600000;0
100;85555;76;22;24;7;17;.708;3600000;0
100;86151;82;0;0;0;0;.00nan;0;0
100;91703;76;0;0;0;0;.00nan;0;0
101;-1;74;0;0;0;0;.00nan;0;0
101;170728;1097;0;0;0;0;.00nan;0;0
101;43928;1097;55;17;2;15;.882;3600000;0
101;58100;74;66;44;5;39;.886;3600000;0
102;57657;73;77;34;2;32;.941;3600000;0
102;79141;1095;0;0;0;0;.00nan;0;0
102;86472;73;0;0;0;0;.00nan;0;0
102;149858;1095;67;31;3;28;.903;3547000;0
103;163989;80;93;50;3;47;.940;4875000;0
103;19708;157;0;0;0;0;.00nan;0;0
103;170612;80;0;0;0;0;.00nan;0;0
103;60123;157;83;42;2;40;.952;4875000;0
104;2410;81;57;27;3;24;.889;3546000;0
104;178911;152;80;33;2;31;.939;3600000;0
104;178950;152;0;0;0;0;.00nan;0;0
104;70213;81;0;0;0;0;.00nan;0;0
115;163195;67;65;22;2;20;.909;3600000;0
115;-1;4620;87;37;3;34;.919;3568000;0
115;173961;4620;0;0;0;0;.00nan;0;0
115;38124;67;0;0;0;0;.00nan;0;0
116;-1;78;0;0;0;0;.00nan;0;0
116;181123;4920;0;0;0;0;.00nan;0;0
116;86344;78;75;27;2;25;.926;3600000;0
116;149450;4920;47;30;5;25;.833;3600000;0
117;85349;82;53;24;3;21;.875;3600000;0
117;85555;76;69;39;5;34;.872;3585000;0
117;86151;82;0;0;0;0;.00nan;0;0
117;91703;76;0;0;0;0;.00nan;0;0
118;57657;73;71;35;3;32;.914;3514000;0
118;79141;1095;0;0;0;0;.00nan;0;0
118;86472;73;0;0;0;0;.00nan;0;0
118;149858;1095;85;28;1;27;.964;3600000;0
119;2410;81;60;26;3;23;.885;3728000;0
119;178911;152;77;41;4;37;.902;3728000;0
119;178950;152;0;0;0;0;.00nan;0;0
119;70213;81;0;0;0;0;.00nan;0;0
152;163195;67;60;35;4;31;.886;3600000;0
152;-1;4620;72;25;2;23;.920;3600000;0
152;173961;4620;0;0;0;0;.00nan;0;0
152;38124;67;0;0;0;0;.00nan;0;0
153;-1;78;0;0;0;0;.00nan;0;0
153;181123;4920;0;0;0;0;.00nan;0;0
153;86344;78;92;30;1;29;.967;3600000;0
153;149450;4920;70;47;5;42;.894;3600000;0
154;2410;81;75;38;3;35;.921;3600000;0
154;178911;152;68;41;4;37;.902;3582000;0
154;178950;152;0;0;0;0;.00nan;0;0
154;70213;81;0;0;0;0;.00nan;0;0
170;-1;78;0;0;0;0;.00nan;0;0
170;-1;4620;67;34;4;30;.882;3599000;0
170;173961;4620;0;0;0;0;.00nan;0;0
170;86344;78;64;32;3;29;.906;3600000;0
171;170728;1097;0;0;0;0;.00nan;0;0
171;43928;1097;63;54;7;47;.870;3631000;0
171;85349;82;24;24;6;18;.750;3631000;0
171;86151;82;0;0;0;0;.00nan;0;0
172;79141;1095;0;0;0;0;.00nan;0;0
172;85437;4921;90;35;2;33;.943;3600000;0
172;149858;1095;58;29;3;26;.897;3588000;0
172;152418;4921;0;0;0;0;.00nan;0;0
173;2410;81;87;32;2;30;.938;3600000;0
173;19708;157;0;0;0;0;.00nan;0;0
173;60123;157;44;23;3;20;.870;3565000;0
173;70213;81;0;0;0;0;.00nan;0;0
174;-1;78;0;0;0;0;.00nan;0;0
174;-1;4620;84;33;2;31;.939;3586000;0
174;173961;4620;0;0;0;0;.00nan;0;0
174;86344;78;84;24;1;23;.958;3600000;0
175;170728;1097;0;0;0;0;.00nan;0;0
175;43928;1097;77;30;2;28;.933;3600000;0
175;85349;82;54;32;4;28;.875;3513000;0
175;86151;82;0;0;0;0;.00nan;0;0
176;79141;1095;0;0;0;0;.00nan;0;0
176;85437;4921;92;37;1;36;.973;3600000;0
176;149858;1095;74;32;3;29;.906;3600000;0
176;152418;4921;0;0;0;0;.00nan;0;0
177;2410;81;57;43;6;37;.860;3562000;0
177;19708;157;0;0;0;0;.00nan;0;0
177;60123;157;51;27;4;23;.852;3600000;0
177;70213;81;0;0;0;0;.00nan;0;0
178;-1;78;0;0;0;0;.00nan;0;0
178;-1;4620;55;37;5;32;.865;3600000;0
178;173961;4620;0;0;0;0;.00nan;0;0
178;86344;78;57;21;2;19;.905;3600000;0
179;170728;1097;0;0;0;0;.00nan;0;0
179;43928;1097;73;33;2;31;.939;3575000;0
179;85349;82;100;34;0;34;1.000;3600000;0
179;86151;82;0;0;0;0;.00nan;0;0
180;79141;1095;0;0;0;0;.00nan;0;0
180;85437;4921;39;22;4;18;.818;3534000;0
180;149858;1095;81;41;3;38;.927;3600000;0
180;152418;4921;0;0;0;0;.00nan;0;0
181;2410;81;100;39;1;38;.974;3600000;0
181;19708;157;0;0;0;0;.00nan;0;0
181;60123;157;77;26;2;24;.923;3586000;0
181;70213;81;0;0;0;0;.00nan;0;0
182;-1;78;52;2;0;2;1.000;818000;0
182;-1;4620;24;10;4;6;.600;565000;0
182;173961;4620;84;24;1;23;.958;3035000;0
182;86344;78;37;34;6;28;.824;2731000;0
183;170728;1097;0;0;0;0;.00nan;0;0
183;43928;1097;89;19;0;19;1.000;3600000;0
183;85349;82;64;31;4;27;.871;3600000;0
183;86151;82;0;0;0;0;.00nan;0;0
184;79141;1095;0;0;0;0;.00nan;0;0
184;85437;4921;73;28;2;26;.929;3600000;0
184;149858;1095;85;46;4;42;.913;3570000;0
184;152418;4921;0;0;0;0;.00nan;0;0
185;2410;81;50;31;5;26;.839;3600000;0
185;19708;157;0;0;0;0;.00nan;0;0
185;60123;157;75;30;2;28;.933;3600000;0
185;70213;81;0;0;0;0;.00nan;0;0
336;-1;78;0;0;0;0;.00nan;0;0
336;-1;4620;0;0;0;0;.00nan;0;0
336;173961;4620;88;51;4;47;.922;3579000;0
336;86344;78;82;32;2;30;.938;3600000;0
337;170728;1097;0;0;0;0;.00nan;0;0
337;43928;1097;70;22;2;20;.909;3600000;0
337;85349;82;78;37;4;33;.892;3547000;0
337;86151;82;0;0;0;0;.00nan;0;0
338;79141;1095;0;0;0;0;.00nan;0;0
338;85437;4921;71;24;1;23;.958;3600000;0
338;149858;1095;79;44;4;40;.909;3600000;0
338;152418;4921;0;0;0;0;.00nan;0;0
339;2410;81;91;48;3;45;.938;3600000;0
339;19708;157;0;0;0;0;.00nan;0;0
339;60123;157;69;19;1;18;.947;3600000;0
339;70213;81;0;0;0;0;.00nan;0;0
366;170728;1097;0;0;0;0;.00nan;0;0
366;43928;1097;78;35;3;32;.914;3678000;0
366;85349;82;78;30;2;28;.933;3678000;0
366;86151;82;0;0;0;0;.00nan;0;0
367;2410;81;77;41;4;37;.902;3584000;0
367;19708;157;0;0;0;0;.00nan;0;0
367;60123;157;54;28;3;25;.893;3600000;0
367;70213;81;0;0;0;0;.00nan;0;0
370;170728;1097;0;0;0;0;.00nan;0;0
370;43928;1097;80;34;2;32;.941;3600000;0
370;85349;82;47;30;5;25;.833;3600000;0
370;86151;82;0;0;0;0;.00nan;0;0
388;-1;78;0;0;0;0;.00nan;0;0
388;170728;1097;0;0;0;0;.00nan;0;0
388;43928;1097;70;33;4;29;.879;3533000;0
388;86344;78;91;35;2;33;.943;3600000;0
389;19708;157;0;0;0;0;.00nan;0;0
389;60123;157;83;17;0;17;1.000;3600000;0
389;85437;4921;40;33;5;28;.848;3600000;0
389;152418;4921;0;0;0;0;.00nan;0;0
390;-1;78;0;0;0;0;.00nan;0;0
390;170728;1097;0;0;0;0;.00nan;0;0
390;43928;1097;51;33;5;28;.848;3578000;0
390;86344;78;84;32;3;29;.906;3600000;0
391;19708;157;0;0;0;0;.00nan;0;0
391;60123;157;69;30;3;27;.900;4179000;0
391;85437;4921;100;41;2;39;.951;4179000;0
391;152418;4921;0;0;0;0;.00nan;0;0
392;-1;78;0;0;0;0;.00nan;0;0
392;170728;1097;0;0;0;0;.00nan;0;0
392;43928;1097;83;43;4;39;.907;3600000;0
392;86344;78;76;25;1;24;.960;3600000;0
393;19708;157;0;0;0;0;.00nan;0;0
393;60123;157;71;19;1;18;.947;3600000;0
393;85437;4921;97;50;3;47;.940;3560000;0
393;152418;4921;0;0;0;0;.00nan;0;0
394;-1;78;0;0;0;0;.00nan;0;0
394;170728;1097;0;0;0;0;.00nan;0;0
394;43928;1097;81;40;4;36;.900;3547000;0
394;86344;78;65;31;3;28;.903;3600000;0
395;19708;157;0;0;0;0;.00nan;0;0
395;60123;157;96;36;2;34;.944;3600000;0
395;85437;4921;26;5;3;2;.400;362000;0
395;152418;4921;75;29;2;27;.931;3238000;0
426;19708;157;0;0;0;0;.00nan;0;0
426;60123;157;94;61;5;56;.918;4978000;0
426;85437;4921;74;42;4;38;.905;4978000;0
426;152418;4921;0;0;0;0;.00nan;0;0
428;19708;157;0;0;0;0;.00nan;0;0
428;60123;157;73;33;3;30;.909;3600000;0
428;85437;4921;80;41;4;37;.902;3600000;0
428;152418;4921;0;0;0;0;.00nan;0;0
433;-1;78;70;27;2;25;.926;3026000;0
433;19708;157;0;0;0;0;.00nan;0;0
433;60123;157;57;34;4;30;.882;3600000;0
433;86344;78;20;9;4;5;.556;515000;0
434;-1;78;0;0;0;0;.00nan;0;0
434;19708;157;0;0;0;0;.00nan;0;0
434;60123;157;100;27;0;27;1.000;3600000;0
434;86344;78;52;30;4;26;.867;3600000;0
435;-1;78;0;0;0;0;.00nan;0;0
435;19708;157;0;0;0;0;.00nan;0;0
435;60123;157;75;41;4;37;.902;3600000;0
435;86344;78;49;34;5;29;.853;3580000;0
436;-1;78;0;0;0;0;.00nan;0;0
436;19708;157;68;13;1;12;.923;1537000;0
436;60123;157;21;21;6;15;.714;2063000;0
436;86344;78;96;36;1;35;.972;3600000;0
450;-1;78;56;19;2;17;.895;1449000;0
450;19708;157;68;30;3;27;.900;3600000;0
450;60123;157;0;0;0;0;.00nan;0;0
450;86344;78;14;27;7;20;.741;2151000;0
7812;187537;117;36;27;5;22;.815;3600000;0
7812;188888;116;0;0;0;0;.00nan;0;0
7812;184533;117;0;0;0;0;.00nan;0;0
7812;185812;116;80;39;2;37;.949;3600000;0
7813;189008;108;7;22;7;15;.682;2761000;0
7813;196372;108;66;12;0;12;1.000;839000;0
7813;-1;110;0;0;0;0;.00nan;0;0
7813;186527;110;97;29;1;28;.966;3600000;0
7814;188918;112;0;0;0;0;.00nan;0;0
7814;189008;108;0;0;0;0;.00nan;0;0
7814;196372;108;46;27;4;23;.852;3600000;0
7814;202246;112;31;27;6;21;.778;3537000;0
7815;187550;111;0;0;0;0;.00nan;0;0
7815;-1;110;0;0;0;0;.00nan;0;0
7815;-1;111;72;33;3;30;.909;3538000;0
7815;186527;110;86;36;1;35;.972;3600000;0
7816;192776;119;27;36;7;29;.806;3160000;0
7816;195017;119;55;3;0;3;1.000;440000;0
7816;186450;115;0;0;0;0;.00nan;0;0
7816;191698;115;28;17;5;12;.706;3600000;0
7817;187537;117;25;5;3;2;.400;512000;0
7817;188888;116;56;32;4;28;.875;3900000;0
7817;184533;117;94;37;1;36;.973;3388000;0
7817;185812;116;0;0;0;0;.00nan;0;0
7818;183693;127;56;32;4;28;.875;3600000;0
7818;184932;122;0;0;0;0;.00nan;0;0
7818;186520;122;50;19;3;16;.842;3600000;0
7818;186580;127;0;0;0;0;.00nan;0;0
7819;-1;113;0;0;0;0;.00nan;0;0
7819;186572;121;89;18;0;18;1.000;3600000;0
7819;191709;113;76;31;3;28;.903;3600000;0
7819;192645;121;0;0;0;0;.00nan;0;0
7820;182305;109;43;40;6;34;.850;3164000;0
7820;187699;114;43;29;5;24;.828;3600000;0
7820;183775;114;0;0;0;0;.00nan;0;0
7820;197038;109;44;4;1;3;.750;436000;0
7821;195089;124;0;0;0;0;.00nan;0;0
7821;-1;124;39;32;5;27;.844;3600000;0
7821;185775;123;53;32;4;28;.875;3600000;0
7821;191125;123;0;0;0;0;.00nan;0;0
7822;183698;126;0;0;0;0;.00nan;0;0
7822;179350;125;50;33;5;28;.848;3600000;0
7822;180731;126;28;28;6;22;.786;3543000;0
7822;191813;125;0;0;0;0;.00nan;0;0
7823;183755;120;64;29;3;26;.897;3600000;0
7823;189734;120;0;0;0;0;.00nan;0;0
7823;184563;118;42;34;5;29;.853;3532000;0
7823;191026;118;0;0;0;0;.00nan;0;0
7824;-1;113;0;0;0;0;.00nan;0;0
7824;186572;121;31;27;6;21;.778;2605000;0
7824;191709;113;55;33;4;29;.879;3600000;0
7824;192645;121;68;16;0;16;1.000;936000;0
7825;179350;125;77;44;4;40;.909;3600000;0
7825;184932;122;60;9;0;9;1.000;950000;0
7825;186520;122;44;37;6;31;.838;2638000;0
7825;191813;125;0;0;0;0;.00nan;0;0
7826;192776;119;70;26;2;24;.923;3600000;0
7826;195017;119;0;0;0;0;.00nan;0;0
7826;186450;115;56;26;3;23;.885;3585000;0
7826;191698;115;0;0;0;0;.00nan;0;0
7827;188888;116;25;30;7;23;.767;3560000;0
7827;183755;120;35;31;6;25;.806;3600000;0
7827;189734;120;0;0;0;0;.00nan;0;0
7827;185812;116;0;0;0;0;.00nan;0;0
7828;195089;124;73;20;1;19;.950;3600000;0
7828;184563;118;37;29;5;24;.828;1932000;0
7828;-1;124;0;0;0;0;.00nan;0;0
7828;191026;118;48;19;3;16;.842;1668000;0
7829;183693;127;90;38;3;35;.921;3600000;0
7829;185775;123;38;31;5;26;.839;3536000;0
7829;186580;127;0;0;0;0;.00nan;0;0
7829;191125;123;0;0;0;0;.00nan;0;0
7830;182305;109;0;0;0;0;.00nan;0;0
7830;183698;126;0;0;0;0;.00nan;0;0
7830;180731;126;54;29;4;25;.862;3900000;0
7830;197038;109;59;28;3;25;.893;3900000;0
7831;187537;117;85;42;4;38;.905;3900000;0
7831;187699;114;0;0;0;0;.00nan;0;0
7831;183775;114;53;26;4;22;.846;3900000;0
7831;184533;117;0;0;0;0;.00nan;0;0
7832;188918;112;0;0;0;0;.00nan;0;0
7832;189008;108;21;17;5;12;.706;1893000;0
7832;196372;108;67;15;0;15;1.000;1707000;0
7832;202246;112;91;18;0;18;1.000;3600000;0
7833;184932;122;0;0;0;0;.00nan;0;0
7833;185775;123;0;0;0;0;.00nan;0;0
7833;186520;122;27;30;6;24;.800;3600000;0
7833;191125;123;60;20;2;18;.900;3600000;0
7834;183698;126;0;0;0;0;.00nan;0;0
7834;180731;126;87;29;1;28;.966;3600000;0
7834;186572;121;0;0;0;0;.00nan;0;0
7834;192645;121;45;17;3;14;.824;3600000;0
7835;-1;113;57;11;1;10;.909;454000;0
7835;186450;115;66;26;2;24;.923;3600000;0
7835;191698;115;0;0;0;0;.00nan;0;0
7835;191709;113;31;31;6;25;.806;3146000;0
7836;187699;114;0;0;0;0;.00nan;0;0
7836;183775;114;83;38;4;34;.895;3900000;0
7836;-1;110;0;0;0;0;.00nan;0;0
7836;186527;110;62;32;4;28;.875;3900000;0
7837;187537;117;50;31;4;27;.871;3600000;0
7837;195089;124;0;0;0;0;.00nan;0;0
7837;184533;117;0;0;0;0;.00nan;0;0
7837;-1;124;80;29;1;28;.966;3600000;0
7838;187699;114;0;0;0;0;.00nan;0;0
7838;183775;114;51;35;6;29;.829;3900000;0
7838;189008;108;46;44;6;38;.864;3900000;0
7838;196372;108;0;0;0;0;.00nan;0;0
7839;183755;120;54;42;6;36;.857;3308000;0
7839;189734;120;32;3;2;1;.333;292000;0
7839;184932;122;70;26;2;24;.923;3600000;0
7839;186520;122;0;0;0;0;.00nan;0;0
7840;187537;117;0;0;0;0;.00nan;0;0
7840;184533;117;42;33;5;28;.848;3513000;0
7840;186572;121;59;30;3;27;.900;3600000;0
7840;192645;121;0;0;0;0;.00nan;0;0
7841;183698;126;0;0;0;0;.00nan;0;0
7841;180731;126;100;27;0;27;1.000;3600000;0
7841;185775;123;47;25;4;21;.840;3600000;0
7841;191125;123;0;0;0;0;.00nan;0;0
7842;192776;119;45;25;4;21;.840;3600000;0
7842;195017;119;0;0;0;0;.00nan;0;0
7842;184563;118;0;0;0;0;.00nan;0;0
7842;191026;118;28;29;6;23;.793;3571000;0
7843;188918;112;0;0;0;0;.00nan;0;0
7843;202246;112;43;37;6;31;.838;3600000;0
7843;186450;115;55;13;2;11;.846;3600000;0
7843;191698;115;0;0;0;0;.00nan;0;0
7844;187550;111;0;0;0;0;.00nan;0;0
7844;187699;114;63;19;1;18;.947;3600000;0
7844;183775;114;0;0;0;0;.00nan;0;0
7844;-1;111;59;22;3;19;.864;3535000;0
7845;195089;124;39;26;5;21;.808;3900000;0
7845;-1;124;0;0;0;0;.00nan;0;0
7845;185775;123;0;0;0;0;.00nan;0;0
7845;191125;123;65;45;4;41;.911;3900000;0
7846;182305;109;0;0;0;0;.00nan;0;0
7846;188918;112;54;25;3;22;.880;3600000;0
7846;202246;112;0;0;0;0;.00nan;0;0
7846;197038;109;53;32;5;27;.844;3561000;0
7847;183698;126;0;0;0;0;.00nan;0;0
7847;179350;125;51;42;6;36;.857;3900000;0
7847;180731;126;24;24;6;18;.750;3900000;0
7847;191813;125;0;0;0;0;.00nan;0;0
7848;192776;119;0;0;0;0;.00nan;0;0
7848;183755;120;0;0;0;0;.00nan;0;0
7848;195017;119;43;23;4;19;.826;3600000;0
7848;189734;120;20;34;7;27;.794;3600000;0
7849;184563;118;88;48;3;45;.938;3554000;0
7849;191026;118;0;0;0;0;.00nan;0;0
7849;186572;121;0;0;0;0;.00nan;0;0
7849;192645;121;64;14;1;13;.929;3600000;0
7850;183693;127;0;0;0;0;.00nan;0;0
7850;184932;122;0;0;0;0;.00nan;0;0
7850;186520;122;81;33;2;31;.939;3552000;0
7850;186580;127;86;27;1;26;.963;3600000;0
7851;188888;116;53;34;5;29;.853;3600000;0
7851;-1;113;0;0;0;0;.00nan;0;0
7851;185812;116;0;0;0;0;.00nan;0;0
7851;191709;113;57;43;6;37;.860;3565000;0
7852;187550;111;68;21;2;19;.905;3600000;0
7852;189008;108;67;34;4;30;.882;3527000;0
7852;196372;108;0;0;0;0;.00nan;0;0
7852;-1;111;0;0;0;0;.00nan;0;0
7853;182305;109;50;30;4;26;.867;3578000;0
7853;186450;115;0;0;0;0;.00nan;0;0
7853;197038;109;0;0;0;0;.00nan;0;0
7853;191698;115;52;22;3;19;.864;3600000;0
7854;187537;117;91;25;1;24;.960;3600000;0
7854;183755;120;80;42;4;38;.905;3600000;0
7854;189734;120;0;0;0;0;.00nan;0;0
7854;184533;117;0;0;0;0;.00nan;0;0
7855;183698;126;0;0;0;0;.00nan;0;0
7855;195089;124;0;0;0;0;.00nan;0;0
7855;180731;126;95;38;2;36;.947;3900000;0
7855;-1;124;75;35;2;33;.943;3900000;0
7856;183693;127;73;35;3;32;.914;3600000;0
7856;179350;125;62;33;4;29;.879;3585000;0
7856;186580;127;0;0;0;0;.00nan;0;0
7856;191813;125;0;0;0;0;.00nan;0;0
7857;187537;117;63;26;3;23;.885;3897000;0
7857;187550;111;0;0;0;0;.00nan;0;0
7857;184533;117;0;0;0;0;.00nan;0;0
7857;-1;111;79;43;3;40;.930;3900000;0
7858;192776;119;75;30;2;28;.933;3600000;0
7858;195017;119;0;0;0;0;.00nan;0;0
7858;-1;113;70;35;4;31;.886;3547000;0
7858;191709;113;0;0;0;0;.00nan;0;0
7859;-1;110;48;34;4;30;.882;3600000;0
7859;186527;110;0;0;0;0;.00nan;0;0
7859;186572;121;51;19;3;16;.842;3600000;0
7859;192645;121;0;0;0;0;.00nan;0;0
7860;189008;108;0;0;0;0;.00nan;0;0
7860;195089;124;65;33;3;30;.909;3600000;0
7860;196372;108;51;29;4;25;.862;3597000;0
7860;-1;124;0;0;0;0;.00nan;0;0
7861;182305;109;76;31;3;28;.903;3600000;0
7861;-1;110;65;7;0;7;1.000;591000;0
7861;186527;110;36;40;7;33;.825;3009000;0
7861;197038;109;0;0;0;0;.00nan;0;0
7862;188888;116;40;23;4;19;.826;3600000;0
7862;184932;122;0;0;0;0;.00nan;0;0
7862;185812;116;0;0;0;0;.00nan;0;0
7862;186520;122;60;40;5;35;.875;3577000;0
7863;189008;108;35;31;6;25;.806;3248000;0
7863;196372;108;51;2;0;2;1.000;352000;0
7863;186572;121;0;0;0;0;.00nan;0;0
7863;192645;121;73;23;1;22;.957;3600000;0
7864;187699;114;0;0;0;0;.00nan;0;0
7864;183755;120;75;29;2;27;.931;3600000;0
7864;183775;114;64;36;3;33;.917;3584000;0
7864;189734;120;0;0;0;0;.00nan;0;0
7865;179350;125;76;22;1;21;.955;3600000;0
7865;185775;123;77;38;3;35;.921;3537000;0
7865;191125;123;0;0;0;0;.00nan;0;0
7865;191813;125;0;0;0;0;.00nan;0;0
7866;187550;111;78;23;1;22;.957;3600000;0
7866;183698;126;0;0;0;0;.00nan;0;0
7866;180731;126;78;38;3;35;.921;3600000;0
7866;-1;111;0;0;0;0;.00nan;0;0
7867;184563;118;0;0;0;0;.00nan;0;0
7867;191026;118;63;43;4;39;.907;3900000;0
7867;186450;115;53;29;4;25;.862;3900000;0
7867;191698;115;0;0;0;0;.00nan;0;0
7868;183693;127;60;19;2;17;.895;3695000;0
7868;188918;112;0;0;0;0;.00nan;0;0
7868;202246;112;92;45;3;42;.933;3695000;0
7868;186580;127;0;0;0;0;.00nan;0;0
7869;183693;127;0;0;0;0;.00nan;0;0
7869;186450;115;0;0;0;0;.00nan;0;0
7869;186580;127;54;48;6;42;.875;3600000;0
7869;191698;115;82;27;1;26;.963;3600000;0
7870;189008;108;0;0;0;0;.00nan;0;0
7870;196372;108;47;25;4;21;.840;3600000;0
7870;-1;113;0;0;0;0;.00nan;0;0
7870;191709;113;55;35;5;30;.857;3557000;0
7871;184563;118;75;31;2;29;.935;3556000;0
7871;179350;125;0;0;0;0;.00nan;0;0
7871;191026;118;0;0;0;0;.00nan;0;0
7871;191813;125;93;31;1;30;.968;3600000;0
7872;192776;119;61;38;5;33;.868;3644000;0
7872;195017;119;0;0;0;0;.00nan;0;0
7872;195089;124;0;0;0;0;.00nan;0;0
7872;-1;124;47;25;4;21;.840;3644000;0
7873;182305;109;0;0;0;0;.00nan;0;0
7873;-1;110;100;42;2;40;.952;3600000;0
7873;186527;110;0;0;0;0;.00nan;0;0
7873;197038;109;24;28;6;22;.786;3600000;0
7874;185775;123;0;0;0;0;.00nan;0;0
7874;186572;121;61;27;3;24;.889;3544000;0
7874;191125;123;77;32;2;30;.938;3600000;0
7874;192645;121;0;0;0;0;.00nan;0;0
7875;183698;126;73;26;2;24;.923;3600000;0
7875;183755;120;0;0;0;0;.00nan;0;0
7875;189734;120;58;42;6;36;.857;3600000;0
7875;180731;126;0;0;0;0;.00nan;0;0
7876;188888;116;0;0;0;0;.00nan;0;0
7876;188918;112;60;40;5;35;.875;3600000;0
7876;202246;112;0;0;0;0;.00nan;0;0
7876;185812;116;67;26;2;24;.923;3600000;0
7877;195089;124;61;27;3;24;.889;3600000;0
7877;184932;122;43;29;5;24;.828;3586000;0
7877;-1;124;0;0;0;0;.00nan;0;0
7877;186520;122;0;0;0;0;.00nan;0;0
7878;187550;111;0;0;0;0;.00nan;0;0
7878;187699;114;56;26;3;23;.885;3600000;0
7878;183775;114;0;0;0;0;.00nan;0;0
7878;-1;111;63;36;4;32;.889;3577000;0
7879;192776;119;0;0;0;0;.00nan;0;0
7879;195017;119;67;34;3;31;.912;3572000;0
7879;186450;115;92;29;1;28;.966;3600000;0
7879;191698;115;0;0;0;0;.00nan;0;0
7880;187537;117;30;17;4;13;.765;3522000;0
7880;188918;112;0;0;0;0;.00nan;0;0
7880;184533;117;0;0;0;0;.00nan;0;0
7880;202246;112;89;34;2;32;.941;3600000;0
7881;182305;109;18;21;6;15;.714;2422000;0
7881;186572;121;58;40;4;36;.900;3600000;0
7881;197038;109;56;4;0;4;1.000;1145000;0
7881;192645;121;0;0;0;0;.00nan;0;0
7882;184932;122;0;0;0;0;.00nan;0;0
7882;-1;113;0;0;0;0;.00nan;0;0
7882;186520;122;67;35;3;32;.914;3900000;0
7882;191709;113;75;40;3;37;.925;3900000;0
7883;187699;114;44;22;4;18;.818;2538000;0
7883;183775;114;19;22;6;16;.727;1062000;0
7883;186450;115;39;27;6;21;.778;3600000;0
7883;191698;115;0;0;0;0;.00nan;0;0
7884;183698;126;49;4;1;3;.750;468000;0
7884;180731;126;41;28;6;22;.786;3132000;0
7884;-1;110;0;0;0;0;.00nan;0;0
7884;186527;110;78;25;1;24;.960;3600000;0
7885;188888;116;18;10;4;6;.600;774000;0
7885;179350;125;46;34;5;29;.853;3600000;0
7885;185812;116;58;21;2;19;.905;2784000;0
7885;191813;125;0;0;0;0;.00nan;0;0
7886;187537;117;78;30;2;28;.933;3600000;0
7886;184533;117;0;0;0;0;.00nan;0;0
7886;186450;115;0;0;0;0;.00nan;0;0
7886;191698;115;54;33;4;29;.879;3515000;0
7887;183698;126;0;0;0;0;.00nan;0;0
7887;189008;108;54;29;4;25;.862;3600000;0
7887;180731;126;100;42;1;41;.976;3600000;0
7887;196372;108;0;0;0;0;.00nan;0;0
7888;187550;111;0;0;0;0;.00nan;0;0
7888;-1;110;12;20;6;14;.700;2084000;0
7888;-1;111;54;35;5;30;.857;3600000;0
7888;186527;110;33;12;3;9;.750;1516000;0
7889;-1;113;0;0;0;0;.00nan;0;0
7889;185775;123;39;32;5;27;.844;3900000;0
7889;191125;123;0;0;0;0;.00nan;0;0
7889;191709;113;21;25;5;20;.800;3900000;0
7890;183755;120;41;22;3;19;.864;3600000;0
7890;189734;120;0;0;0;0;.00nan;0;0
7890;184932;122;0;0;0;0;.00nan;0;0
7890;186520;122;100;40;0;40;1.000;3600000;0
7891;192776;119;57;42;4;38;.905;3600000;0
7891;195017;119;0;0;0;0;.00nan;0;0
7891;186572;121;69;19;2;17;.895;3600000;0
7891;192645;121;0;0;0;0;.00nan;0;0
7892;187699;114;64;44;5;39;.886;3588000;0
7892;183775;114;0;0;0;0;.00nan;0;0
7892;179350;125;0;0;0;0;.00nan;0;0
7892;191813;125;65;32;4;28;.875;3600000;0
7893;188888;116;54;31;5;26;.839;3600000;0
7893;184563;118;0;0;0;0;.00nan;0;0
7893;185812;116;0;0;0;0;.00nan;0;0
7893;191026;118;67;27;2;25;.926;3600000;0
7894;182305;109;58;20;2;18;.900;3830000;0
7894;188918;112;0;0;0;0;.00nan;0;0
7894;202246;112;94;49;3;46;.939;3830000;0
7894;197038;109;0;0;0;0;.00nan;0;0
7895;184932;122;0;0;0;0;.00nan;0;0
7895;186450;115;52;27;4;23;.852;3545000;0
7895;186520;122;57;28;3;25;.893;3600000;0
7895;191698;115;0;0;0;0;.00nan;0;0
7896;192776;119;0;0;0;0;.00nan;0;0
7896;195017;119;89;44;2;42;.955;3599000;0
7896;185775;123;0;0;0;0;.00nan;0;0
7896;191125;123;76;19;1;18;.947;3600000;0
7897;189008;108;0;0;0;0;.00nan;0;0
7897;184563;118;69;37;3;34;.919;3900000;0
7897;196372;108;56;23;3;20;.870;3900000;0
7897;191026;118;0;0;0;0;.00nan;0;0
7898;182305;109;0;0;0;0;.00nan;0;0
7898;183755;120;0;0;0;0;.00nan;0;0
7898;189734;120;54;31;4;27;.871;3900000;0
7898;197038;109;60;39;4;35;.897;3900000;0
7899;188918;112;47;36;5;31;.861;3543000;0
7899;202246;112;0;0;0;0;.00nan;0;0
7899;-1;110;56;27;4;23;.852;3600000;0
7899;186527;110;0;0;0;0;.00nan;0;0
7900;183693;127;54;24;3;21;.875;3713000;0
7900;195089;124;68;29;2;27;.931;3713000;0
7900;-1;124;0;0;0;0;.00nan;0;0
7900;186580;127;0;0;0;0;.00nan;0;0
7901;187699;114;0;0;0;0;.00nan;0;0
7901;188888;116;0;0;0;0;.00nan;0;0
7901;183775;114;66;43;5;38;.884;3600000;0
7901;185812;116;72;24;2;22;.917;3600000;0
7902;187550;111;95;33;1;32;.970;3900000;0
7902;183698;126;0;0;0;0;.00nan;0;0
7902;180731;126;86;26;1;25;.962;3900000;0
7902;-1;111;0;0;0;0;.00nan;0;0
7903;187537;117;16;6;4;2;.333;818000;0
7903;184533;117;80;24;1;23;.958;3082000;0
7903;179350;125;63;42;5;37;.881;3900000;0
7903;191813;125;0;0;0;0;.00nan;0;0
7904;183755;120;85;43;3;40;.930;3600000;0
7904;189008;108;55;40;5;35;.875;3600000;0
7904;189734;120;0;0;0;0;.00nan;0;0
7904;196372;108;0;0;0;0;.00nan;0;0
7905;192776;119;45;22;3;19;.864;3600000;0
7905;195017;119;0;0;0;0;.00nan;0;0
7905;-1;113;0;0;0;0;.00nan;0;0
7905;191709;113;55;34;4;30;.882;3565000;0
7906;183693;127;0;0;0;0;.00nan;0;0
7906;186572;121;71;29;2;27;.931;3600000;0
7906;186580;127;76;41;3;38;.927;3555000;0
7906;192645;121;0;0;0;0;.00nan;0;0
7907;188918;112;0;0;0;0;.00nan;0;0
7907;184563;118;0;0;0;0;.00nan;0;0
7907;202246;112;78;33;2;31;.939;3900000;0
7907;191026;118;76;35;2;33;.943;3900000;0
7908;184932;122;16;10;5;5;.500;673000;0
7908;185775;123;57;23;3;20;.870;3600000;0
7908;186520;122;78;31;2;29;.935;2927000;0
7908;191125;123;0;0;0;0;.00nan;0;0
7909;183698;126;0;0;0;0;.00nan;0;0
7909;179350;125;85;34;2;32;.941;3600000;0
7909;180731;126;76;43;6;37;.860;3600000;0
7909;191813;125;0;0;0;0;.00nan;0;0
7910;192776;119;40;34;5;29;.853;3579000;0
7910;188888;116;60;24;3;21;.875;3600000;0
7910;195017;119;0;0;0;0;.00nan;0;0
7910;185812;116;0;0;0;0;.00nan;0;0
7911;187537;117;79;30;2;28;.933;3600000;0
7911;184533;117;0;0;0;0;.00nan;0;0
7911;184563;118;43;18;3;15;.833;3548000;0
7911;191026;118;0;0;0;0;.00nan;0;0
7912;187550;111;77;34;3;31;.912;3600000;0
7912;195089;124;49;24;4;20;.833;3600000;0
7912;-1;111;0;0;0;0;.00nan;0;0
7912;-1;124;0;0;0;0;.00nan;0;0
7913;182305;109;40;28;5;23;.821;3552000;0
7913;187537;117;0;0;0;0;.00nan;0;0
7913;184533;117;95;54;4;50;.926;3600000;0
7913;197038;109;0;0;0;0;.00nan;0;0
7914;188918;112;0;0;0;0;.00nan;0;0
7914;189008;108;78;21;1;20;.952;3600000;0
7914;196372;108;0;0;0;0;.00nan;0;0
7914;202246;112;47;35;5;30;.857;3600000;0
7915;188888;116;80;47;5;42;.894;3600000;0
7915;185812;116;0;0;0;0;.00nan;0;0
7915;186450;115;74;24;1;23;.958;3600000;0
7915;191698;115;0;0;0;0;.00nan;0;0
7916;-1;110;0;0;0;0;.00nan;0;0
7916;-1;113;0;0;0;0;.00nan;0;0
7916;186527;110;77;34;2;32;.941;3600000;0
7916;191709;113;53;33;4;29;.879;3555000;0
7917;192776;119;0;0;0;0;.00nan;0;0
7917;195017;119;100;43;2;41;.953;3900000;0
7917;184932;122;0;0;0;0;.00nan;0;0
7917;186520;122;47;15;2;13;.867;3900000;0
7918;187550;111;0;0;0;0;.00nan;0;0
7918;-1;111;68;39;4;35;.897;3586000;0
7918;186572;121;75;27;3;24;.889;3600000;0
7918;192645;121;0;0;0;0;.00nan;0;0
7919;187699;114;62;29;3;26;.897;3900000;0
7919;183775;114;0;0;0;0;.00nan;0;0
7919;184563;118;0;0;0;0;.00nan;0;0
7919;191026;118;79;36;3;33;.917;3900000;0
7920;195089;124;0;0;0;0;.00nan;0;0
7920;-1;124;65;36;3;33;.917;3900000;0
7920;185775;123;0;0;0;0;.00nan;0;0
7920;191125;123;69;33;3;30;.909;3900000;0
7921;183693;127;57;29;4;25;.862;3600000;0
7921;183698;126;0;0;0;0;.00nan;0;0
7921;180731;126;44;32;6;26;.813;3532000;0
7921;186580;127;0;0;0;0;.00nan;0;0
7922;189008;108;0;0;0;0;.00nan;0;0
7922;196372;108;98;52;2;50;.962;3563000;0
7922;186450;115;0;0;0;0;.00nan;0;0
7922;191698;115;65;20;1;19;.950;3600000;0
7923;183755;120;77;30;2;28;.933;3572000;0
7923;189734;120;0;0;0;0;.00nan;0;0
7923;184932;122;74;24;1;23;.958;3600000;0
7923;186520;122;0;0;0;0;.00nan;0;0
7924;183698;126;0;0;0;0;.00nan;0;0
7924;179350;125;59;31;4;27;.871;3692000;0
7924;180731;126;73;35;3;32;.914;3692000;0
7924;191813;125;0;0;0;0;.00nan;0;0
7925;192776;119;85;33;2;31;.939;3600000;0
7925;195017;119;0;0;0;0;.00nan;0;0
7925;-1;110;47;25;4;21;.840;3576000;0
7925;186527;110;0;0;0;0;.00nan;0;0
7926;195089;124;43;25;5;20;.800;3600000;0
7926;-1;124;0;0;0;0;.00nan;0;0
7926;-1;113;87;36;2;34;.944;3600000;0
7926;191709;113;0;0;0;0;.00nan;0;0
7927;183693;127;0;0;0;0;.00nan;0;0
7927;185775;123;77;38;3;35;.921;3596000;0
7927;186580;127;79;31;2;29;.935;3600000;0
7927;191125;123;0;0;0;0;.00nan;0;0
7928;182305;109;46;17;2;15;.882;3600000;0
7928;188888;116;0;0;0;0;.00nan;0;0
7928;185812;116;58;28;3;25;.893;3569000;0
7928;197038;109;0;0;0;0;.00nan;0;0
7929;187537;117;99;22;0;22;1.000;3600000;0
7929;187699;114;0;0;0;0;.00nan;0;0
7929;183775;114;41;36;5;31;.861;3600000;0
7929;184533;117;0;0;0;0;.00nan;0;0
7930;187550;111;60;24;2;22;.917;3575000;0
7930;184563;118;79;23;1;22;.957;3600000;0
7930;-1;111;0;0;0;0;.00nan;0;0
7930;191026;118;0;0;0;0;.00nan;0;0
7931;-1;113;0;0;0;0;.00nan;0;0
7931;185775;123;0;0;0;0;.00nan;0;0
7931;191125;123;76;38;3;35;.921;3567000;0
7931;191709;113;69;26;2;24;.923;3600000;0
7932;183693;127;51;21;3;18;.857;3600000;0
7932;179350;125;0;0;0;0;.00nan;0;0
7932;186580;127;0;0;0;0;.00nan;0;0
7932;191813;125;46;26;4;22;.846;3600000;0
7933;188918;112;73;34;3;31;.912;3718000;0
7933;183755;120;0;0;0;0;.00nan;0;0
7933;189734;120;49;29;4;25;.862;3718000;0
7933;202246;112;0;0;0;0;.00nan;0;0
7934;182305;109;0;0;0;0;.00nan;0;0
7934;184563;118;0;0;0;0;.00nan;0;0
7934;191026;118;87;49;3;46;.939;3572000;0
7934;197038;109;60;17;1;16;.941;3600000;0
7935;183755;120;65;34;4;30;.882;3600000;0
7935;189734;120;0;0;0;0;.00nan;0;0
7935;179350;125;16;37;8;29;.784;3600000;0
7935;191813;125;0;0;0;0;.00nan;0;0
7936;187537;117;33;18;4;14;.778;1981000;0
7936;187699;114;0;0;0;0;.00nan;0;0
7936;183775;114;100;19;0;19;1.000;3600000;0
7936;184533;117;55;18;2;16;.889;1619000;0
7937;188918;112;0;0;0;0;.00nan;0;0
7937;202246;112;76;45;3;42;.933;3587000;0
7937;-1;110;0;0;0;0;.00nan;0;0
7937;186527;110;65;19;1;18;.947;3600000;0
7938;195089;124;86;45;3;42;.933;3600000;0
7938;184932;122;0;0;0;0;.00nan;0;0
7938;-1;124;0;0;0;0;.00nan;0;0
7938;186520;122;44;33;6;27;.818;3588000;0
7939;192776;119;51;2;0;2;1.000;532000;0
7939;183693;127;87;36;2;34;.944;3600000;0
7939;195017;119;35;42;7;35;.833;3068000;0
7939;186580;127;0;0;0;0;.00nan;0;0
7940;188888;116;80;28;2;26;.929;3600000;0
7940;189008;108;61;38;4;34;.895;3573000;0
7940;196372;108;0;0;0;0;.00nan;0;0
7940;185812;116;0;0;0;0;.00nan;0;0
7941;187550;111;0;0;0;0;.00nan;0;0
7941;184563;118;15;19;6;13;.684;1828000;0
7941;-1;111;67;28;3;25;.893;3600000;0
7941;191026;118;33;12;3;9;.750;1772000;0
7942;192776;119;10;24;7;17;.708;3600000;0
7942;195017;119;0;0;0;0;.00nan;0;0
7942;179350;125;73;39;4;35;.897;3600000;0
7942;191813;125;0;0;0;0;.00nan;0;0
7943;187537;117;88;29;2;27;.931;3600000;0
7943;184533;117;0;0;0;0;.00nan;0;0
7943;184932;122;32;8;3;5;.625;429000;0
7943;186520;122;76;28;2;26;.929;3171000;0
7944;182305;109;47;25;4;21;.840;3600000;0
7944;186572;121;43;33;6;27;.818;3261000;0
7944;197038;109;0;0;0;0;.00nan;0;0
7944;192645;121;55;2;0;2;1.000;252000;0
7945;187699;114;46;6;1;5;.833;1475000;0
7945;183775;114;32;34;7;27;.794;2125000;0
7945;-1;113;0;0;0;0;.00nan;0;0
7945;191709;113;61;21;3;18;.857;3600000;0
7946;183755;120;83;38;2;36;.947;3600000;0
7946;189734;120;0;0;0;0;.00nan;0;0
7946;185775;123;77;24;1;23;.958;3600000;0
7946;191125;123;0;0;0;0;.00nan;0;0
7947;183693;127;54;14;1;13;.929;1538000;0
7947;186450;115;35;9;3;6;.667;490000;0
7947;186580;127;9;23;7;16;.696;2062000;0
7947;191698;115;75;16;0;16;1.000;3110000;0
7948;188918;112;61;56;7;49;.875;3523000;0
7948;202246;112;0;0;0;0;.00nan;0;0
7948;-1;110;29;16;5;11;.688;2249000;0
7948;186527;110;58;5;0;5;1.000;1351000;0
7949;189008;108;0;0;0;0;.00nan;0;0
7949;184563;118;0;0;0;0;.00nan;0;0
7949;196372;108;55;24;3;21;.875;3900000;0
7949;191026;118;66;33;3;30;.909;3900000;0
7950;187537;117;65;15;1;14;.933;1781000;0
7950;184533;117;4;19;7;12;.632;1819000;0
7950;-1;113;62;29;3;26;.897;3600000;0
7950;191709;113;0;0;0;0;.00nan;0;0
7951;179350;125;0;0;0;0;.00nan;0;0
7951;186450;115;33;28;5;23;.821;3900000;0
7951;191698;115;0;0;0;0;.00nan;0;0
7951;191813;125;63;39;5;34;.872;3900000;0
7952;183755;120;0;0;0;0;.00nan;0;0
7952;189734;120;58;34;4;30;.882;3544000;0
7952;186572;121;0;0;0;0;.00nan;0;0
7952;192645;121;77;39;3;36;.923;3600000;0
7953;183698;126;0;0;0;0;.00nan;0;0
7953;195089;124;75;39;4;35;.897;3882000;0
7953;180731;126;61;34;4;30;.882;3900000;0
7953;-1;124;0;0;0;0;.00nan;0;0
7954;187550;111;73;43;4;39;.907;3513000;0
7954;188888;116;61;19;2;17;.895;3600000;0
7954;-1;111;0;0;0;0;.00nan;0;0
7954;185812;116;0;0;0;0;.00nan;0;0
7955;192776;119;48;35;5;30;.857;3600000;0
7955;195017;119;0;0;0;0;.00nan;0;0
7955;185775;123;0;0;0;0;.00nan;0;0
7955;191125;123;59;20;2;18;.900;3600000;0
7956;183698;126;60;32;4;28;.875;3521000;0
7956;195089;124;0;0;0;0;.00nan;0;0
7956;180731;126;0;0;0;0;.00nan;0;0
7956;-1;124;70;16;2;14;.875;3600000;0
7957;184932;122;48;34;5;29;.853;3600000;0
7957;186520;122;0;0;0;0;.00nan;0;0
7957;186572;121;90;27;1;26;.963;3600000;0
7957;192645;121;0;0;0;0;.00nan;0;0
7958;182305;109;51;19;3;16;.842;3566000;0
7958;188918;112;0;0;0;0;.00nan;0;0
7958;202246;112;90;47;2;45;.957;3600000;0
7958;197038;109;0;0;0;0;.00nan;0;0
7959;183693;127;34;19;4;15;.789;1071000;0
7959;185775;123;46;26;4;22;.846;3600000;0
7959;186580;127;46;19;3;16;.842;2529000;0
7959;191125;123;0;0;0;0;.00nan;0;0
7960;183755;120;54;17;2;15;.882;3600000;0
7960;189734;120;0;0;0;0;.00nan;0;0
7960;184932;122;0;0;0;0;.00nan;0;0
7960;186520;122;89;48;3;45;.938;3584000;0
7961;183693;127;55;37;5;32;.865;3600000;0
7961;179350;125;64;21;2;19;.905;3600000;0
7961;186580;127;0;0;0;0;.00nan;0;0
7961;191813;125;0;0;0;0;.00nan;0;0
7962;188888;116;56;18;2;16;.889;3600000;0
7962;189008;108;66;41;5;36;.878;3600000;0
7962;196372;108;0;0;0;0;.00nan;0;0
7962;185812;116;0;0;0;0;.00nan;0;0
7963;187537;117;62;32;4;28;.875;3540000;0
7963;183698;126;0;0;0;0;.00nan;0;0
7963;184533;117;0;0;0;0;.00nan;0;0
7963;180731;126;88;33;2;31;.939;3600000;0
7964;187699;114;0;0;0;0;.00nan;0;0
7964;183775;114;70;35;3;32;.914;3560000;0
7964;-1;113;0;0;0;0;.00nan;0;0
7964;191709;113;78;27;1;26;.963;3600000;0
7965;-1;110;0;0;0;0;.00nan;0;0
7965;185775;123;0;0;0;0;.00nan;0;0
7965;186527;110;53;37;5;32;.865;3900000;0
7965;191125;123;57;37;5;32;.865;3900000;0
7966;195089;124;51;34;5;29;.853;3600000;0
7966;-1;124;0;0;0;0;.00nan;0;0
7966;186572;121;76;33;2;31;.939;3600000;0
7966;192645;121;0;0;0;0;.00nan;0;0
7967;182305;109;0;0;0;0;.00nan;0;0
7967;-1;113;44;40;7;33;.825;3597000;0
7967;197038;109;52;30;4;26;.867;3600000;0
7967;191709;113;0;0;0;0;.00nan;0;0
7968;189008;108;0;0;0;0;.00nan;0;0
7968;196372;108;59;25;3;22;.880;3600000;0
7968;185775;123;54;30;4;26;.867;3542000;0
7968;191125;123;0;0;0;0;.00nan;0;0
7969;187550;111;0;0;0;0;.00nan;0;0
7969;188918;112;0;0;0;0;.00nan;0;0
7969;202246;112;94;38;1;37;.974;3600000;0
7969;-1;111;90;39;2;37;.949;3586000;0
7970;188888;116;0;0;0;0;.00nan;0;0
7970;183693;115;0;0;0;0;.00nan;0;0
7970;185812;116;69;39;4;35;.897;3600000;0
7970;186450;115;64;28;3;25;.893;3600000;0
7971;192776;119;0;0;0;0;.00nan;0;0
7971;187699;114;82;33;1;32;.970;3900000;0
7971;183775;114;0;0;0;0;.00nan;0;0
7971;195017;119;86;30;1;29;.967;3900000;0
7972;184932;122;69;30;3;27;.900;3600000;0
7972;-1;110;55;36;5;31;.861;3525000;0
7972;186520;122;0;0;0;0;.00nan;0;0
7972;186527;110;0;0;0;0;.00nan;0;0
7973;183755;120;83;42;4;38;.905;3600000;0
7973;189734;120;0;0;0;0;.00nan;0;0
7973;186572;121;0;0;0;0;.00nan;0;0
7973;192645;121;80;27;1;26;.963;3600000;0
7974;184563;118;26;5;3;2;.400;284000;0
7974;179350;125;73;33;3;30;.909;3600000;0
7974;191026;118;24;20;5;15;.750;3316000;0
7974;191813;125;0;0;0;0;.00nan;0;0
7975;182305;109;72;24;1;23;.958;3600000;0
7975;187699;114;22;27;6;21;.778;1837000;0
7975;183775;114;12;20;6;14;.700;1763000;0
7975;197038;109;0;0;0;0;.00nan;0;0
7976;183698;126;0;0;0;0;.00nan;0;0
7976;180731;126;44;22;4;18;.818;3600000;0
7976;-1;113;0;0;0;0;.00nan;0;0
7976;191709;113;99;51;1;50;.980;3600000;0
7977;192776;119;69;38;4;34;.895;3900000;0
7977;195017;119;0;0;0;0;.00nan;0;0
7977;179350;125;0;0;0;0;.00nan;0;0
7977;191813;125;52;28;4;24;.857;3900000;0
7978;183693;115;90;48;3;45;.938;3600000;0
7978;183755;120;74;15;0;15;1.000;1294000;0
7978;189734;120;18;26;6;20;.769;2306000;0
7978;186450;115;0;0;0;0;.00nan;0;0
7979;184563;118;83;42;2;40;.952;3900000;0
7979;191026;118;0;0;0;0;.00nan;0;0
7979;186572;121;78;27;2;25;.926;3900000;0
7979;192645;121;0;0;0;0;.00nan;0;0
7980;187550;111;84;38;3;35;.921;3580000;0
7980;188918;112;70;34;2;32;.941;3600000;0
7980;202246;112;0;0;0;0;.00nan;0;0
7980;-1;111;0;0;0;0;.00nan;0;0
7981;195089;124;73;22;1;21;.955;3600000;0
7981;-1;124;0;0;0;0;.00nan;0;0
7981;186580;127;67;37;4;33;.892;3600000;0
7981;191171;127;0;0;0;0;.00nan;0;0
7982;187537;117;73;26;2;24;.923;3600000;0
7982;188888;116;63;38;4;34;.895;3579000;0
7982;184533;117;0;0;0;0;.00nan;0;0
7982;185812;116;0;0;0;0;.00nan;0;0
7983;187550;111;45;5;1;4;.800;262000;0
7983;-1;111;57;48;7;41;.854;3338000;0
7983;185775;123;0;0;0;0;.00nan;0;0
7983;191125;123;57;33;4;29;.879;3600000;0
7984;183698;126;73;33;2;31;.939;3600000;0
7984;184932;122;0;0;0;0;.00nan;0;0
7984;180731;126;0;0;0;0;.00nan;0;0
7984;186520;122;32;20;5;15;.750;3600000;0
7985;182305;109;30;10;3;7;.700;642000;0
7985;-1;110;0;0;0;0;.00nan;0;0
7985;186527;110;65;28;3;25;.893;3600000;0
7985;197038;109;55;42;5;37;.881;2958000;0
7986;195089;124;0;0;0;0;.00nan;0;0
7986;-1;124;32;36;7;29;.806;3600000;0
7986;186580;127;0;0;0;0;.00nan;0;0
7986;191171;127;70;24;1;23;.958;3600000;0
7987;188918;112;0;0;0;0;.00nan;0;0
7987;189008;108;99;23;0;23;1.000;3600000;0
7987;196372;108;0;0;0;0;.00nan;0;0
7987;202246;112;88;39;2;37;.949;3556000;0
7988;187550;111;30;31;6;25;.806;3256000;0
7988;189008;108;40;31;5;26;.839;3600000;0
7988;196372;108;0;0;0;0;.00nan;0;0
7988;-1;111;48;0;0;0;.00nan;285000;0
7989;184563;118;0;0;0;0;.00nan;0;0
7989;191026;118;72;46;5;41;.891;3600000;0
7989;186572;121;100;24;0;24;1.000;3600000;0
7989;192645;121;0;0;0;0;.00nan;0;0
7990;182305;109;50;27;4;23;.852;3600000;0
7990;185775;123;16;20;6;14;.700;1780000;0
7990;191125;123;62;8;0;8;1.000;1779000;0
7990;197038;109;0;0;0;0;.00nan;0;0
7991;187699;114;68;21;2;19;.905;3600000;0
7991;183698;126;0;0;0;0;.00nan;0;0
7991;183775;114;0;0;0;0;.00nan;0;0
7991;180731;126;84;41;3;38;.927;3576000;0
7992;187537;117;58;26;3;23;.885;3600000;0
7992;184533;117;0;0;0;0;.00nan;0;0
7992;-1;110;47;24;4;20;.833;3600000;0
7992;186527;110;0;0;0;0;.00nan;0;0
7993;188888;116;48;29;4;25;.862;3553000;0
7993;-1;113;0;0;0;0;.00nan;0;0
7993;185812;116;0;0;0;0;.00nan;0;0
7993;191709;113;93;35;3;32;.914;3600000;0
7994;183755;120;30;26;6;20;.769;3578000;0
7994;195089;124;83;51;4;47;.922;3600000;0
7994;189734;120;0;0;0;0;.00nan;0;0
7994;-1;124;0;0;0;0;.00nan;0;0
7995;183693;115;0;0;0;0;.00nan;0;0
7995;189008;108;0;0;0;0;.00nan;0;0
7995;196372;108;76;37;3;34;.919;3600000;0
7995;186450;115;29;21;5;16;.762;3536000;0
7996;182305;109;73;29;2;27;.931;3600000;0
7996;187550;111;0;0;0;0;.00nan;0;0
7996;-1;111;61;34;4;30;.882;3537000;0
7996;197038;109;0;0;0;0;.00nan;0;0
7997;192776;119;17;23;6;17;.739;3217000;0
7997;195017;119;42;3;1;2;.667;383000;0
7997;186580;127;84;37;3;34;.919;3600000;0
7997;191171;127;0;0;0;0;.00nan;0;0
7998;195089;124;0;0;0;0;.00nan;0;0
7998;184932;122;0;0;0;0;.00nan;0;0
7998;-1;124;58;26;3;23;.885;3600000;0
7998;186520;122;51;33;4;29;.879;3600000;0
7999;179350;125;88;53;4;49;.925;3600000;0
7999;186572;121;46;29;5;24;.828;3557000;0
7999;191813;125;0;0;0;0;.00nan;0;0
7999;192645;121;0;0;0;0;.00nan;0;0
8000;187699;114;0;0;0;0;.00nan;0;0
8000;183775;114;59;25;3;22;.880;3600000;0
8000;-1;110;50;2;0;2;1.000;429000;0
8000;186527;110;29;34;6;28;.824;3171000;0
8001;183755;120;0;0;0;0;.00nan;0;0
8001;189734;120;50;41;6;35;.854;3547000;0
8001;185775;123;26;14;4;10;.714;3600000;0
8001;191125;123;0;0;0;0;.00nan;0;0
8002;187537;117;0;0;0;0;.00nan;0;0
8002;183698;126;0;0;0;0;.00nan;0;0
8002;184533;117;49;49;7;42;.857;3600000;0
8002;180731;126;80;25;1;24;.960;3600000;0
8003;184563;118;0;0;0;0;.00nan;0;0
8003;-1;113;0;0;0;0;.00nan;0;0
8003;191026;118;67;28;3;25;.893;3570000;0
8003;191709;113;70;26;2;24;.923;3600000;0
8004;187550;111;63;28;3;25;.893;3600000;0
8004;183693;115;64;24;2;22;.917;3600000;0
8004;-1;111;0;0;0;0;.00nan;0;0
8004;186450;115;0;0;0;0;.00nan;0;0
8005;182305;109;0;0;0;0;.00nan;0;0
8005;189008;108;41;35;6;29;.829;3544000;0
8005;196372;108;0;0;0;0;.00nan;0;0
8005;197038;109;72;46;5;41;.891;3600000;0
8006;-1;113;44;26;4;22;.846;3600000;0
8006;186580;127;0;0;0;0;.00nan;0;0
8006;191171;127;83;43;2;41;.953;3600000;0
8006;191709;113;0;0;0;0;.00nan;0;0
8007;183755;120;47;29;4;25;.862;3600000;0
8007;189734;120;0;0;0;0;.00nan;0;0
8007;179350;125;0;0;0;0;.00nan;0;0
8007;191813;125;22;19;5;14;.737;3578000;0
8008;192776;119;0;0;0;0;.00nan;0;0
8008;195017;119;83;36;2;34;.944;3555000;0
8008;186572;121;0;0;0;0;.00nan;0;0
8008;192645;121;77;21;1;20;.952;3600000;0
8009;195089;124;50;32;5;27;.844;3576000;0
8009;184932;122;28;9;3;6;.667;458000;0
8009;-1;124;0;0;0;0;.00nan;0;0
8009;186520;122;81;19;0;19;1.000;3142000;0
8010;188888;116;0;0;0;0;.00nan;0;0
8010;184563;118;49;40;5;35;.875;3600000;0
8010;185812;116;77;22;1;21;.955;3600000;0
8010;191026;118;0;0;0;0;.00nan;0;0
8011;187537;117;54;29;4;25;.862;3558000;0
8011;187699;114;61;26;3;23;.885;3600000;0
8011;183775;114;0;0;0;0;.00nan;0;0
8011;184533;117;0;0;0;0;.00nan;0;0
8012;188918;112;0;0;0;0;.00nan;0;0
8012;202246;112;81;36;4;32;.889;3600000;0
8012;-1;110;84;29;1;28;.966;3600000;0
8012;186527;110;0;0;0;0;.00nan;0;0
8013;179350;125;59;44;5;39;.886;3600000;0
8013;185775;123;0;0;0;0;.00nan;0;0
8013;191125;123;86;15;0;15;1.000;3600000;0
8013;191813;125;0;0;0;0;.00nan;0;0
8014;192776;119;89;50;4;46;.920;3600000;0
8014;195017;119;0;0;0;0;.00nan;0;0
8014;184932;122;49;21;3;18;.857;3600000;0
8014;186520;122;0;0;0;0;.00nan;0;0
8015;179350;125;81;28;2;26;.929;3600000;0
8015;186580;127;0;0;0;0;.00nan;0;0
8015;191171;127;43;37;6;31;.838;3600000;0
8015;191813;125;0;0;0;0;.00nan;0;0
8016;188888;116;0;0;0;0;.00nan;0;0
8016;183755;120;64;40;4;36;.900;3531000;0
8016;189734;120;0;0;0;0;.00nan;0;0
8016;185812;116;75;24;2;22;.917;3600000;0
8017;187537;117;83;46;4;42;.913;2345000;0
8017;184533;117;70;13;0;13;1.000;1255000;0
8017;186572;121;75;19;1;18;.947;3600000;0
8017;192645;121;0;0;0;0;.00nan;0;0
8018;182305;109;97;36;2;34;.944;3900000;0
8018;-1;113;0;0;0;0;.00nan;0;0
8018;197038;109;0;0;0;0;.00nan;0;0
8018;191709;113;76;24;2;22;.917;3900000;0
8019;192776;119;52;28;4;24;.857;3555000;0
8019;183698;126;0;0;0;0;.00nan;0;0
8019;195017;119;0;0;0;0;.00nan;0;0
8019;180731;126;93;37;2;35;.946;3600000;0
8020;195089;124;92;35;2;33;.943;3600000;0
8020;-1;110;0;0;0;0;.00nan;0;0
8020;-1;124;0;0;0;0;.00nan;0;0
8020;186527;110;50;24;3;21;.875;3572000;0
8021;182305;109;70;13;0;13;1.000;943000;0
8021;183698;126;83;40;3;37;.925;3600000;0
8021;180731;126;0;0;0;0;.00nan;0;0
8021;197038;109;16;22;6;16;.727;2657000;0
8022;189008;108;0;0;0;0;.00nan;0;0
8022;195089;124;0;0;0;0;.00nan;0;0
8022;196372;108;45;37;5;32;.865;3600000;0
8022;-1;124;73;31;3;28;.903;3600000;0
8023;183693;115;0;0;0;0;.00nan;0;0
8023;-1;110;0;0;0;0;.00nan;0;0
8023;186450;115;77;23;1;22;.957;3600000;0
8023;186527;110;18;41;9;32;.780;3600000;0
8024;183755;120;0;0;0;0;.00nan;0;0
8024;189734;120;95;36;1;35;.972;3543000;0
8024;184932;122;0;0;0;0;.00nan;0;0
8024;186520;122;100;32;0;32;1.000;3600000;0
8025;187699;114;0;0;0;0;.00nan;0;0
8025;183775;114;76;46;4;42;.913;3760000;0
8025;186572;121;0;0;0;0;.00nan;0;0
8025;192645;121;61;25;3;22;.880;3760000;0
8026;187537;117;90;30;1;29;.967;3600000;0
8026;184533;117;0;0;0;0;.00nan;0;0
8026;184563;118;48;30;4;26;.867;3600000;0
8026;191026;118;0;0;0;0;.00nan;0;0
8027;187550;111;0;0;0;0;.00nan;0;0
8027;188918;112;0;0;0;0;.00nan;0;0
8027;202246;112;39;34;6;28;.824;3608000;0
8027;-1;111;33;26;5;21;.808;3608000;0
8028;187550;111;0;0;0;0;.00nan;0;0
8028;188918;112;74;48;5;43;.896;3600000;0
8028;202246;112;0;0;0;0;.00nan;0;0
8028;-1;111;84;30;2;28;.933;3600000;0
8029;184563;118;0;0;0;0;.00nan;0;0
8029;184932;122;0;0;0;0;.00nan;0;0
8029;191026;118;77;48;5;43;.896;3600000;0
8029;186520;122;56;17;2;15;.882;3600000;0
8030;179350;125;0;0;0;0;.00nan;0;0
8030;-1;113;0;0;0;0;.00nan;0;0
8030;191709;113;100;32;0;32;1.000;3600000;0
8030;191813;125;73;39;3;36;.923;3600000;0
8031;192776;119;0;0;0;0;.00nan;0;0
8031;183693;115;67;23;2;21;.913;3600000;0
8031;195017;119;60;32;3;29;.906;3544000;0
8031;186450;115;0;0;0;0;.00nan;0;0
8032;187537;117;0;0;0;0;.00nan;0;0
8032;183755;120;76;43;4;39;.907;3600000;0
8032;189734;120;0;0;0;0;.00nan;0;0
8032;184533;117;39;29;5;24;.828;3548000;0
8033;185775;123;49;34;5;29;.853;3600000;0
8033;186580;127;99;49;2;47;.959;3600000;0
8033;191125;123;0;0;0;0;.00nan;0;0
8033;191171;127;0;0;0;0;.00nan;0;0
8034;188888;116;0;0;0;0;.00nan;0;0
8034;185812;116;67;32;3;29;.906;3600000;0
8034;186572;121;29;24;6;18;.750;2745000;0
8034;192645;121;56;5;0;5;1.000;855000;0
8035;182305;109;0;0;0;0;.00nan;0;0
8035;189008;108;0;0;0;0;.00nan;0;0
8035;196372;108;29;29;6;23;.793;3600000;0
8035;197038;109;58;25;3;22;.880;3600000;0
8036;187550;111;72;24;1;23;.958;3600000;0
8036;195089;124;56;28;3;25;.893;3513000;0
8036;-1;111;0;0;0;0;.00nan;0;0
8036;-1;124;0;0;0;0;.00nan;0;0
8037;184563;118;72;53;5;48;.906;3525000;0
8037;185775;123;0;0;0;0;.00nan;0;0
8037;191026;118;0;0;0;0;.00nan;0;0
8037;191125;123;41;13;3;10;.769;3600000;0
8038;183693;115;0;0;0;0;.00nan;0;0
8038;183698;126;0;0;0;0;.00nan;0;0
8038;180731;126;36;28;6;22;.786;3551000;0
8038;186450;115;38;26;5;21;.808;3600000;0
8039;179350;125;22;11;4;7;.636;996000;0
8039;184932;122;81;31;1;30;.968;3600000;0
8039;186520;122;0;0;0;0;.00nan;0;0
8039;191813;125;31;27;6;21;.778;2604000;0
8040;-1;113;0;0;0;0;.00nan;0;0
8040;186580;127;0;0;0;0;.00nan;0;0
8040;191171;127;100;41;0;41;1.000;3600000;0
8040;191709;113;48;18;3;15;.833;3600000;0
8041;187699;114;0;0;0;0;.00nan;0;0
8041;188918;112;0;0;0;0;.00nan;0;0
8041;183775;114;75;35;4;31;.886;3900000;0
8041;202246;112;76;40;4;36;.900;3900000;0
8042;187699;114;100;30;0;30;1.000;3600000;0
8042;183775;114;0;0;0;0;.00nan;0;0
8042;-1;110;81;30;2;28;.933;3540000;0
8042;186527;110;0;0;0;0;.00nan;0;0
8043;187550;111;0;0;0;0;.00nan;0;0
8043;189008;108;0;0;0;0;.00nan;0;0
8043;196372;108;65;35;4;31;.886;3704000;0
8043;-1;111;70;31;3;28;.903;3704000;0
8044;183693;115;69;23;2;21;.913;3600000;0
8044;184563;118;0;0;0;0;.00nan;0;0
8044;191026;118;76;47;4;43;.915;3525000;0
8044;186450;115;0;0;0;0;.00nan;0;0
8045;182305;109;27;32;6;26;.813;3600000;0
8045;-1;113;0;0;0;0;.00nan;0;0
8045;197038;109;0;0;0;0;.00nan;0;0
8045;191709;113;38;28;5;23;.821;3600000;0
8046;192776;119;78;29;2;27;.931;3600000;0
8046;195017;119;0;0;0;0;.00nan;0;0
8046;184932;122;0;0;0;0;.00nan;0;0
8046;186520;122;52;27;4;23;.852;3589000;0
8047;183698;126;0;0;0;0;.00nan;0;0
8047;180731;126;84;35;2;33;.943;3600000;0
8047;186580;127;0;0;0;0;.00nan;0;0
8047;191171;127;71;40;4;36;.900;3543000;0
8048;188888;116;0;0;0;0;.00nan;0;0
8048;195089;124;100;35;1;34;.971;3600000;0
8048;-1;124;0;0;0;0;.00nan;0;0
8048;185812;116;55;28;3;25;.893;3593000;0
8049;179350;125;55;29;4;25;.862;3600000;0
8049;-1;110;0;0;0;0;.00nan;0;0
8049;186527;110;40;32;6;26;.813;3519000;0
8049;191813;125;0;0;0;0;.00nan;0;0
8050;187537;117;66;49;5;44;.898;3567000;0
8050;189008;108;0;0;0;0;.00nan;0;0
8050;184533;117;0;0;0;0;.00nan;0;0
8050;196372;108;46;29;4;25;.862;3600000;0
8051;184932;122;0;0;0;0;.00nan;0;0
8051;-1;113;0;0;0;0;.00nan;0;0
8051;186520;122;100;40;2;38;.950;3600000;0
8051;191709;113;53;27;3;24;.889;3580000;0
8052;183693;115;91;36;1;35;.972;3600000;0
8052;186450;115;0;0;0;0;.00nan;0;0
8052;186572;121;0;0;0;0;.00nan;0;0
8052;192645;121;78;34;2;32;.941;3580000;0
8053;187699;114;29;26;6;20;.769;2508000;0
8053;188888;116;17;23;6;17;.739;2834000;0
8053;183775;114;74;13;0;13;1.000;1392000;0
8053;185812;116;54;9;0;9;1.000;1066000;0
8054;182305;109;49;36;5;31;.861;3600000;0
8054;185775;123;100;26;0;26;1.000;3600000;0
8054;191125;123;0;0;0;0;.00nan;0;0
8054;197038;109;0;0;0;0;.00nan;0;0
8055;183698;126;50;9;1;8;.889;871000;0
8055;180731;126;58;38;5;33;.868;3029000;0
8055;186580;127;33;15;4;11;.733;1182000;0
8055;191171;127;50;16;2;14;.875;2713000;0
8056;195089;124;0;0;0;0;.00nan;0;0
8056;184563;118;91;29;1;28;.966;3600000;0
8056;-1;124;51;31;4;27;.871;3600000;0
8056;191026;118;0;0;0;0;.00nan;0;0
8057;187550;111;82;30;1;29;.967;3600000;0
8057;179350;125;63;32;3;29;.906;3525000;0
8057;-1;111;0;0;0;0;.00nan;0;0
8057;191813;125;0;0;0;0;.00nan;0;0
8058;182305;109;0;0;0;0;.00nan;0;0
8058;188918;112;0;0;0;0;.00nan;0;0
8058;202246;112;46;36;6;30;.833;3555000;0
8058;197038;109;56;32;4;28;.875;3600000;0
8059;192776;119;29;9;3;6;.667;320000;0
8059;183755;120;94;32;1;31;.969;3600000;0
8059;195017;119;46;34;5;29;.853;3280000;0
8059;189734;120;0;0;0;0;.00nan;0;0
8060;187537;117;0;0;0;0;.00nan;0;0
8060;184533;117;29;37;7;30;.811;3600000;0
8060;-1;110;0;0;0;0;.00nan;0;0
8060;186527;110;70;31;2;29;.935;3600000;0
8061;186572;121;48;19;3;16;.842;3600000;0
8061;186580;127;50;48;7;41;.854;3600000;0
8061;191171;127;0;0;0;0;.00nan;0;0
8061;192645;121;0;0;0;0;.00nan;0;0
8062;188888;116;0;0;0;0;.00nan;0;0
8062;183698;126;0;0;0;0;.00nan;0;0
8062;180731;126;63;29;4;25;.862;3600000;0
8062;185812;116;74;25;1;24;.960;3600000;0
8063;189008;108;0;0;0;0;.00nan;0;0
8063;179350;125;0;0;0;0;.00nan;0;0
8063;196372;108;67;26;2;24;.923;3567000;0
8063;191813;125;100;30;0;30;1.000;3600000;0
8064;187537;117;83;41;3;38;.927;3900000;0
8064;187550;111;0;0;0;0;.00nan;0;0
8064;184533;117;0;0;0;0;.00nan;0;0
8064;-1;111;64;27;3;24;.889;3900000;0
8065;187699;114;0;0;0;0;.00nan;0;0
8065;183693;115;0;0;0;0;.00nan;0;0
8065;183775;114;82;40;3;37;.925;3584000;0
8065;186450;115;69;18;1;17;.944;3600000;0
8066;-1;110;88;37;2;35;.946;3600000;0
8066;-1;113;51;27;3;24;.889;3544000;0
8066;186527;110;0;0;0;0;.00nan;0;0
8066;191709;113;0;0;0;0;.00nan;0;0
8067;188918;112;28;32;7;25;.781;2990000;0
8067;184563;118;0;0;0;0;.00nan;0;0
8067;202246;112;46;7;1;6;.857;610000;0
8067;191026;118;50;34;5;29;.853;3600000;0
8068;192776;119;22;12;4;8;.667;947000;0
8068;183755;120;52;36;6;30;.833;3600000;0
8068;195017;119;53;24;3;21;.875;2623000;0
8068;189734;120;0;0;0;0;.00nan;0;0
8069;184932;122;0;0;0;0;.00nan;0;0
8069;185775;123;13;5;4;1;.200;754000;0
8069;186520;122;97;40;3;37;.925;3600000;0
8069;191125;123;62;22;2;20;.909;2846000;0
8070;184563;118;39;19;3;16;.842;3591000;0
8070;184932;122;0;0;0;0;.00nan;0;0
8070;191026;118;0;0;0;0;.00nan;0;0
8070;186520;122;61;20;2;18;.900;3600000;0
8071;185775;123;0;0;0;0;.00nan;0;0
8071;186572;121;82;39;3;36;.923;3600000;0
8071;191125;123;69;26;2;24;.923;3600000;0
8071;192645;121;0;0;0;0;.00nan;0;0
8072;187550;111;57;19;2;17;.895;3600000;0
8072;188918;112;0;0;0;0;.00nan;0;0
8072;202246;112;55;40;6;34;.850;3600000;0
8072;-1;111;0;0;0;0;.00nan;0;0
8073;187699;114;0;0;0;0;.00nan;0;0
8073;183698;126;0;0;0;0;.00nan;0;0
8073;183775;114;99;49;2;47;.959;3600000;0
8073;180731;126;64;24;3;21;.875;3545000;0
8074;188888;116;64;36;3;33;.917;3545000;0
8074;185775;123;100;39;2;37;.949;3600000;0
8074;185812;116;0;0;0;0;.00nan;0;0
8074;191125;123;0;0;0;0;.00nan;0;0
8075;187537;117;100;31;0;31;1.000;3600000;0
8075;189008;108;0;0;0;0;.00nan;0;0
8075;184533;117;0;0;0;0;.00nan;0;0
8075;196372;108;42;17;3;14;.824;3600000;0
8076;192776;119;85;31;1;30;.968;3600000;0
8076;195017;119;0;0;0;0;.00nan;0;0
8076;-1;113;0;0;0;0;.00nan;0;0
8076;191709;113;68;35;3;32;.914;3517000;0
8077;182305;109;58;20;2;18;.900;3628000;0
8077;-1;110;0;0;0;0;.00nan;0;0
8077;186527;110;68;22;1;21;.955;3628000;0
8077;197038;109;0;0;0;0;.00nan;0;0
8078;188888;116;0;0;0;0;.00nan;0;0
8078;195089;124;97;41;2;39;.951;3900000;0
8078;-1;124;0;0;0;0;.00nan;0;0
8078;185812;116;82;32;2;30;.938;3900000;0
8079;187550;111;0;0;0;0;.00nan;0;0
8079;-1;110;43;29;4;25;.862;3900000;0
8079;-1;111;66;33;4;29;.879;3900000;0
8079;186527;110;0;0;0;0;.00nan;0;0
8080;187537;117;56;37;4;33;.892;3564000;0
8080;183693;115;60;20;2;18;.900;3600000;0
8080;184533;117;0;0;0;0;.00nan;0;0
8080;186450;115;0;0;0;0;.00nan;0;0
8081;182305;109;0;0;0;0;.00nan;0;0
8081;184932;122;0;0;0;0;.00nan;0;0
8081;186520;122;58;31;4;27;.871;3590000;0
8081;197038;109;73;31;2;29;.935;3600000;0
8082;186572;121;0;0;0;0;.00nan;0;0
8082;186580;127;67;34;4;30;.882;3600000;0
8082;191171;127;0;0;0;0;.00nan;0;0
8082;192645;121;44;34;5;29;.853;3566000;0
8083;187699;114;0;0;0;0;.00nan;0;0
8083;183775;114;84;31;2;29;.935;3900000;0
8083;-1;113;0;0;0;0;.00nan;0;0
8083;191709;113;73;29;2;27;.931;3900000;0
8084;183698;126;0;0;0;0;.00nan;0;0
8084;189008;108;61;33;4;29;.879;2433000;0
8084;180731;126;61;24;2;22;.917;3600000;0
8084;196372;108;36;21;4;17;.810;1167000;0
8085;183755;120;43;15;3;12;.800;3900000;0
8085;189734;120;0;0;0;0;.00nan;0;0
8085;184563;118;0;0;0;0;.00nan;0;0
8085;191026;118;100;53;3;50;.943;3900000;0
8086;182305;109;83;40;3;37;.925;3900000;0
8086;184932;122;78;38;3;35;.921;3900000;0
8086;186520;122;0;0;0;0;.00nan;0;0
8086;197038;109;0;0;0;0;.00nan;0;0
8087;179350;125;0;0;0;0;.00nan;0;0
8087;186580;127;75;15;0;15;1.000;1229000;0
8087;191171;127;37;27;5;22;.815;2316000;0
8087;191813;125;65;35;3;32;.914;3600000;0
8088;192776;119;88;33;1;32;.970;3600000;0
8088;195017;119;0;0;0;0;.00nan;0;0
8088;184563;118;45;34;6;28;.824;3600000;0
8088;191026;118;0;0;0;0;.00nan;0;0
8089;183755;120;46;34;5;29;.853;3600000;0
8089;189734;120;0;0;0;0;.00nan;0;0
8089;185775;123;0;0;0;0;.00nan;0;0
8089;191125;123;66;24;2;22;.917;3600000;0
8090;188918;112;35;38;6;32;.842;3594000;0
8090;195089;124;44;24;4;20;.833;3600000;0
8090;202246;112;0;0;0;0;.00nan;0;0
8090;-1;124;0;0;0;0;.00nan;0;0
8091;188888;116;75;40;4;36;.900;3715000;0
8091;183693;115;0;0;0;0;.00nan;0;0
8091;185812;116;0;0;0;0;.00nan;0;0
8091;186450;115;51;24;3;21;.875;3715000;0
8092;187550;111;65;34;3;31;.912;3600000;0
8092;-1;110;0;0;0;0;.00nan;0;0
8092;-1;111;0;0;0;0;.00nan;0;0
8092;186527;110;39;34;6;28;.824;3600000;0
8093;187699;114;0;0;0;0;.00nan;0;0
8093;183775;114;98;36;1;35;.972;3548000;0
8093;189008;108;0;0;0;0;.00nan;0;0
8093;196372;108;100;26;0;26;1.000;3600000;0
8094;188918;112;0;0;0;0;.00nan;0;0
8094;202246;112;44;36;5;31;.861;3900000;0
8094;185775;123;75;44;5;39;.886;3900000;0
8094;191125;123;0;0;0;0;.00nan;0;0
8095;183698;126;0;0;0;0;.00nan;0;0
8095;180731;126;77;43;3;40;.930;3600000;0
8095;186572;121;79;25;2;23;.920;3600000;0
8095;192645;121;0;0;0;0;.00nan;0;0
8096;183693;115;100;26;0;26;1.000;3600000;0
8096;-1;113;0;0;0;0;.00nan;0;0
8096;186450;115;0;0;0;0;.00nan;0;0
8096;191709;113;35;26;5;21;.808;3600000;0
8097;184563;118;0;0;0;0;.00nan;0;0
8097;184932;122;0;0;0;0;.00nan;0;0
8097;191026;118;71;50;5;45;.900;3600000;0
8097;186520;122;53;22;4;18;.818;3600000;0
8098;195089;124;0;0;0;0;.00nan;0;0
8098;179350;125;77;30;2;28;.933;3600000;0
8098;-1;124;55;31;4;27;.871;3545000;0
8098;191813;125;0;0;0;0;.00nan;0;0
8099;187537;117;38;30;6;24;.800;3600000;0
8099;183698;126;0;0;0;0;.00nan;0;0
8099;184533;117;0;0;0;0;.00nan;0;0
8099;180731;126;87;29;1;28;.966;3600000;0
8100;183755;120;70;37;3;34;.919;3749000;0
8100;189734;120;0;0;0;0;.00nan;0;0
8100;184563;118;63;38;4;34;.895;3756000;0
8100;191026;118;0;0;0;0;.00nan;0;0
8101;183693;115;59;23;3;20;.870;3600000;0
8101;188918;112;88;50;4;46;.920;3600000;0
8101;202246;112;0;0;0;0;.00nan;0;0
8101;186450;115;0;0;0;0;.00nan;0;0
8102;187550;111;0;0;0;0;.00nan;0;0
8102;-1;111;74;26;1;25;.962;3600000;0
8102;-1;113;0;0;0;0;.00nan;0;0
8102;191709;113;75;41;4;37;.902;3600000;0
8103;189008;108;0;0;0;0;.00nan;0;0
8103;196372;108;84;28;1;27;.964;3600000;0
8103;-1;110;0;0;0;0;.00nan;0;0
8103;186527;110;66;37;4;33;.892;3600000;0
8104;195089;124;91;41;2;39;.951;3600000;0
8104;-1;124;0;0;0;0;.00nan;0;0
8104;186572;121;45;21;3;18;.857;3560000;0
8104;192645;121;0;0;0;0;.00nan;0;0
8105;179350;125;79;34;3;31;.912;3512000;0
8105;186580;127;88;29;1;28;.966;3600000;0
8105;191171;127;0;0;0;0;.00nan;0;0
8105;191813;125;0;0;0;0;.00nan;0;0
8106;182305;109;82;28;1;27;.964;3600000;0
8106;188888;116;58;26;3;23;.885;3600000;0
8106;185812;116;0;0;0;0;.00nan;0;0
8106;197038;109;0;0;0;0;.00nan;0;0
8107;189008;108;32;9;3;6;.667;489000;0
8107;196372;108;92;35;1;34;.971;3228000;0
8107;-1;113;0;0;0;0;.00nan;0;0
8107;191709;113;64;27;3;24;.889;3717000;0
8108;183693;115;73;19;1;18;.947;3600000;0
8108;188918;112;87;44;3;41;.932;3515000;0
8108;202246;112;0;0;0;0;.00nan;0;0
8108;186450;115;0;0;0;0;.00nan;0;0
8109;187699;114;0;0;0;0;.00nan;0;0
8109;183775;114;64;33;4;29;.879;3600000;0
8109;179350;125;48;0;0;0;.00nan;163000;0
8109;191813;125;35;29;6;23;.793;3358000;0
8110;192776;119;0;0;0;0;.00nan;0;0
8110;187537;117;26;6;3;3;.500;531000;0
8110;195017;119;73;22;1;21;.955;3600000;0
8110;184533;117;69;34;3;31;.912;3069000;0
8111;183698;126;0;0;0;0;.00nan;0;0
8111;184932;122;0;0;0;0;.00nan;0;0
8111;180731;126;86;35;2;33;.943;3573000;0
8111;186520;122;94;36;1;35;.972;3600000;0
8112;183755;120;76;30;3;27;.900;3600000;0
8112;189734;120;0;0;0;0;.00nan;0;0
8112;186572;121;0;0;0;0;.00nan;0;0
8112;192645;121;59;35;4;31;.886;3587000;0
8113;185775;123;0;0;0;0;.00nan;0;0
8113;186580;127;0;0;0;0;.00nan;0;0
8113;191125;123;81;27;2;25;.926;3600000;0
8113;191171;127;28;36;6;30;.833;3600000;0
8114;184563;118;0;0;0;0;.00nan;0;0
8114;-1;110;48;18;2;16;.889;3600000;0
8114;191026;118;67;48;5;43;.896;3600000;0
8114;186527;110;0;0;0;0;.00nan;0;0
8115;183698;126;59;8;0;8;1.000;1228000;0
8115;184563;118;74;37;3;34;.919;3600000;0
8115;180731;126;22;23;6;17;.739;2372000;0
8115;191026;118;0;0;0;0;.00nan;0;0
8116;187537;117;69;44;5;39;.886;3600000;0
8116;184533;117;0;0;0;0;.00nan;0;0
8116;-1;113;68;29;2;27;.931;3600000;0
8116;191709;113;0;0;0;0;.00nan;0;0
8117;179350;125;70;44;4;40;.909;3600000;0
8117;185775;123;88;29;1;28;.966;3600000;0
8117;191125;123;0;0;0;0;.00nan;0;0
8117;191813;125;0;0;0;0;.00nan;0;0
8118;192776;119;73;24;1;23;.958;3600000;0
8118;187550;111;0;0;0;0;.00nan;0;0
8118;195017;119;0;0;0;0;.00nan;0;0
8118;-1;111;70;25;2;23;.920;3593000;0
8119;183755;120;0;0;0;0;.00nan;0;0
8119;195089;124;32;11;3;8;.727;483000;0
8119;189734;120;57;38;5;33;.868;3600000;0
8119;-1;124;68;33;3;30;.909;3110000;0
8120;187699;114;83;46;3;43;.935;3900000;0
8120;183775;114;0;0;0;0;.00nan;0;0
8120;186580;127;46;21;3;18;.857;3900000;0
8120;191171;127;0;0;0;0;.00nan;0;0
8121;188888;116;0;0;0;0;.00nan;0;0
8121;184932;122;62;24;2;22;.917;3563000;0
8121;185812;116;58;18;1;17;.944;3600000;0
8121;186520;122;0;0;0;0;.00nan;0;0
8122;182305;109;0;0;0;0;.00nan;0;0
8122;189008;108;50;41;6;35;.854;2615000;0
8122;196372;108;63;6;0;6;1.000;985000;0
8122;197038;109;57;23;3;20;.870;3600000;0
8123;187550;111;59;28;3;25;.893;3600000;0
8123;183693;115;44;26;4;22;.846;3545000;0
8123;-1;111;0;0;0;0;.00nan;0;0
8123;186450;115;0;0;0;0;.00nan;0;0
8124;187699;114;63;12;0;12;1.000;731000;0
8124;183775;114;44;46;7;39;.848;2869000;0
8124;186572;121;64;19;2;17;.895;3600000;0
8124;192645;121;0;0;0;0;.00nan;0;0
8125;188918;112;0;0;0;0;.00nan;0;0
8125;202246;112;42;38;6;32;.842;3600000;0
8125;-1;110;0;0;0;0;.00nan;0;0
8125;186527;110;30;36;7;29;.806;3554000;0
8126;189008;108;0;0;0;0;.00nan;0;0
8126;196372;108;65;20;2;18;.900;3550000;0
8126;-1;110;0;0;0;0;.00nan;0;0
8126;186527;110;91;34;1;33;.971;3600000;0
8127;187699;114;0;0;0;0;.00nan;0;0
8127;188888;116;65;28;3;25;.893;3524000;0
8127;183775;114;99;45;1;44;.978;3600000;0
8127;185812;116;0;0;0;0;.00nan;0;0
8128;183693;115;84;29;1;28;.966;3600000;0
8128;195089;124;92;42;2;40;.952;3600000;0
8128;-1;124;0;0;0;0;.00nan;0;0
8128;186450;115;0;0;0;0;.00nan;0;0
8129;187550;111;0;0;0;0;.00nan;0;0
8129;184533;117;54;21;3;18;.857;3600000;0
8129;184592;117;0;0;0;0;.00nan;0;0
8129;-1;111;40;29;5;24;.828;3600000;0
8130;192776;119;64;27;3;24;.889;3557000;0
8130;195017;119;0;0;0;0;.00nan;0;0
8130;184563;118;0;0;0;0;.00nan;0;0
8130;191026;118;97;31;1;30;.968;3600000;0
8131;183755;120;72;30;2;28;.933;3545000;0
8131;189734;120;0;0;0;0;.00nan;0;0
8131;-1;113;0;0;0;0;.00nan;0;0
8131;191709;113;100;26;0;26;1.000;3600000;0
8132;182305;109;0;0;0;0;.00nan;0;0
8132;188918;112;59;24;3;21;.875;3600000;0
8132;202246;112;0;0;0;0;.00nan;0;0
8132;197038;109;50;33;4;29;.879;3544000;0
8133;185775;123;0;0;0;0;.00nan;0;0
8133;186572;121;0;0;0;0;.00nan;0;0
8133;191125;123;73;26;2;24;.923;3600000;0
8133;192645;121;57;28;3;25;.893;3570000;0
8134;183698;126;0;0;0;0;.00nan;0;0
8134;180731;126;53;34;5;29;.853;3600000;0
8134;186580;127;0;0;0;0;.00nan;0;0
8134;191171;127;75;25;1;24;.960;3600000;0
8135;183693;115;0;0;0;0;.00nan;0;0
8135;-1;110;96;39;2;37;.949;3600000;0
8135;186450;115;53;24;4;20;.833;3514000;0
8135;186527;110;0;0;0;0;.00nan;0;0
8136;179350;125;61;39;4;35;.897;3754000;0
8136;184932;122;0;0;0;0;.00nan;0;0
8136;186520;122;71;47;5;42;.894;3725000;0
8136;191813;125;0;0;0;0;.00nan;0;0
8137;185775;123;55;32;4;28;.875;3582000;0
8137;186572;121;66;27;3;24;.889;3600000;0
8137;191125;123;0;0;0;0;.00nan;0;0
8137;192645;121;0;0;0;0;.00nan;0;0
8138;187699;114;74;24;2;22;.917;3600000;0
8138;183775;114;0;0;0;0;.00nan;0;0
8138;184533;117;0;0;0;0;.00nan;0;0
8138;184592;117;86;43;3;40;.930;3561000;0
8139;187550;111;32;26;5;21;.808;3582000;0
8139;189008;108;75;41;4;37;.902;3600000;0
8139;196372;108;0;0;0;0;.00nan;0;0
8139;-1;111;0;0;0;0;.00nan;0;0
8140;182305;109;43;21;4;17;.810;916000;0
8140;188888;116;85;22;1;21;.955;3600000;0
8140;185812;116;0;0;0;0;.00nan;0;0
8140;197038;109;50;23;4;19;.826;2684000;0
8141;184563;118;62;39;5;34;.872;3600000;0
8141;179350;125;0;0;0;0;.00nan;0;0
8141;191026;118;0;0;0;0;.00nan;0;0
8141;191813;125;72;23;1;22;.957;3600000;0
8142;192776;119;57;37;4;33;.892;3600000;0
8142;195017;119;0;0;0;0;.00nan;0;0
8142;-1;113;0;0;0;0;.00nan;0;0
8142;191709;113;100;27;0;27;1.000;3600000;0
8143;183755;120;42;31;5;26;.839;3564000;0
8143;189734;120;0;0;0;0;.00nan;0;0
8143;184932;122;71;40;3;37;.925;3600000;0
8143;186520;122;0;0;0;0;.00nan;0;0
8144;195089;124;87;33;2;31;.939;3600000;0
8144;-1;124;0;0;0;0;.00nan;0;0
8144;186580;127;25;12;4;8;.667;825000;0
8144;191171;127;64;19;1;18;.947;2775000;0
8145;187699;114;0;0;0;0;.00nan;0;0
8145;183698;126;0;0;0;0;.00nan;0;0
8145;183775;114;53;30;5;25;.833;3600000;0
8145;180731;126;76;21;1;20;.952;3600000;0
8146;188918;112;14;17;6;11;.647;2037000;0
8146;184533;117;75;24;1;23;.958;3600000;0
8146;184592;117;0;0;0;0;.00nan;0;0
8146;202246;112;49;19;3;16;.842;1563000;0
8147;183693;115;28;11;4;7;.636;901000;0
8147;-1;110;0;0;0;0;.00nan;0;0
8147;186450;115;43;12;2;10;.833;2699000;0
8147;186527;110;60;25;3;22;.880;3600000;0
8148;195089;124;0;0;0;0;.00nan;0;0
8148;-1;124;62;36;4;32;.889;3600000;0
8148;185775;123;43;5;1;4;.800;340000;0
8148;191125;123;26;27;6;21;.778;3260000;0
8149;183698;126;85;24;1;23;.958;3600000;0
8149;180731;126;0;0;0;0;.00nan;0;0
8149;186580;127;47;36;5;31;.861;3600000;0
8149;191171;127;0;0;0;0;.00nan;0;0
8150;182305;109;74;32;2;30;.938;3562000;0
8150;192776;119;0;0;0;0;.00nan;0;0
8150;195017;119;85;20;1;19;.950;3600000;0
8150;197038;109;0;0;0;0;.00nan;0;0
8151;179350;125;89;42;2;40;.952;3577000;0
8151;186572;121;0;0;0;0;.00nan;0;0
8151;191813;125;0;0;0;0;.00nan;0;0
8151;192645;121;85;19;0;19;1.000;3600000;0
8152;184563;118;0;0;0;0;.00nan;0;0
8152;-1;113;0;0;0;0;.00nan;0;0
8152;191026;118;72;47;5;42;.894;3803000;0
8152;191709;113;43;20;4;16;.800;3803000;0
8153;188888;116;0;0;0;0;.00nan;0;0
8153;183755;120;17;24;6;18;.750;3600000;0
8153;189734;120;0;0;0;0;.00nan;0;0
8153;185812;116;65;30;3;27;.900;3600000;0
8154;188918;112;45;29;5;24;.828;3600000;0
8154;184932;122;0;0;0;0;.00nan;0;0
8154;202246;112;0;0;0;0;.00nan;0;0
8154;186520;122;93;39;2;37;.949;3600000;0
8155;187550;111;31;4;2;2;.500;890000;0
8155;189008;108;0;0;0;0;.00nan;0;0
8155;196372;108;92;43;2;41;.953;3600000;0
8155;-1;111;25;27;6;21;.778;2710000;0
8156;192776;119;43;34;6;28;.824;3600000;0
8156;195017;119;0;0;0;0;.00nan;0;0
8156;186572;121;0;0;0;0;.00nan;0;0
8156;192645;121;49;31;5;26;.839;3600000;0
8157;183698;126;0;0;0;0;.00nan;0;0
8157;188918;112;23;27;6;21;.778;2683000;0
8157;180731;126;100;39;1;38;.974;3600000;0
8157;202246;112;42;11;2;9;.818;917000;0
8158;-1;110;0;0;0;0;.00nan;0;0
8158;185775;123;81;26;1;25;.962;3600000;0
8158;186527;110;88;37;2;35;.946;3600000;0
8158;191125;123;0;0;0;0;.00nan;0;0
8159;195089;124;47;25;3;22;.880;3554000;0
8159;179350;125;92;36;2;34;.944;3600000;0
8159;-1;124;0;0;0;0;.00nan;0;0
8159;191813;125;0;0;0;0;.00nan;0;0
8160;188888;116;53;16;2;14;.875;3600000;0
8160;185775;123;0;0;0;0;.00nan;0;0
8160;185812;116;0;0;0;0;.00nan;0;0
8160;191125;123;61;40;5;35;.875;3600000;0
8161;182305;109;56;28;3;25;.893;3600000;0
8161;184533;117;92;33;1;32;.970;3600000;0
8161;184592;117;0;0;0;0;.00nan;0;0
8161;197038;109;0;0;0;0;.00nan;0;0
8162;192776;119;0;0;0;0;.00nan;0;0
8162;183755;120;0;0;0;0;.00nan;0;0
8162;195017;119;82;41;2;39;.951;3900000;0
8162;189734;120;86;32;2;30;.938;3900000;0
8163;184932;122;0;0;0;0;.00nan;0;0
8163;186520;122;46;31;5;26;.839;3600000;0
8163;186580;127;0;0;0;0;.00nan;0;0
8163;191171;127;60;31;3;28;.903;3600000;0
8164;183693;115;71;36;3;33;.917;3600000;0
8164;189008;108;0;0;0;0;.00nan;0;0
8164;196372;108;100;37;0;37;1.000;3600000;0
8164;186450;115;0;0;0;0;.00nan;0;0
8165;187550;111;56;37;4;33;.892;3600000;0
8165;184533;117;0;0;0;0;.00nan;0;0
8165;184592;117;77;24;1;23;.958;3600000;0
8165;-1;111;0;0;0;0;.00nan;0;0
8166;183755;120;23;15;4;11;.733;2399000;0
8166;189734;120;46;7;1;6;.857;1201000;0
8166;-1;113;0;0;0;0;.00nan;0;0
8166;191709;113;100;40;0;40;1.000;3600000;0
8167;179350;125;71;29;3;26;.897;3544000;0
8167;-1;110;0;0;0;0;.00nan;0;0
8167;186527;110;100;41;2;39;.951;3600000;0
8167;191813;125;0;0;0;0;.00nan;0;0
8168;188888;116;0;0;0;0;.00nan;0;0
8168;185812;116;65;37;4;33;.892;3600000;0
8168;186572;121;0;0;0;0;.00nan;0;0
8168;192645;121;54;36;5;31;.861;3567000;0
8169;182305;109;56;28;3;25;.893;2815000;0
8169;187699;114;0;0;0;0;.00nan;0;0
8169;183775;114;72;23;1;22;.957;3600000;0
8169;197038;109;43;22;4;18;.818;785000;0
8170;183698;126;0;0;0;0;.00nan;0;0
8170;184563;118;85;34;2;32;.941;3600000;0
8170;180731;126;48;25;4;21;.840;3554000;0
8170;191026;118;0;0;0;0;.00nan;0;0
8171;187550;111;0;0;0;0;.00nan;0;0
8171;189008;108;0;0;0;0;.00nan;0;0
8171;196372;108;52;32;5;27;.844;3600000;0
8171;-1;111;75;25;1;24;.960;3600000;0
8172;183693;115;0;0;0;0;.00nan;0;0
8172;186450;115;89;24;1;23;.958;3600000;0
8172;186572;121;19;9;4;5;.556;714000;0
8172;192645;121;67;27;2;25;.926;2886000;0
8173;188918;112;65;39;5;34;.872;3732000;0
8173;179350;125;57;33;4;29;.879;3732000;0
8173;202246;112;0;0;0;0;.00nan;0;0
8173;191813;125;0;0;0;0;.00nan;0;0
8174;192776;119;21;25;6;19;.760;1598000;0
8174;195017;119;60;15;1;14;.933;2002000;0
8174;195089;124;90;28;1;27;.964;3600000;0
8174;-1;124;0;0;0;0;.00nan;0;0
8175;183755;120;77;28;2;26;.929;3600000;0
8175;189734;120;0;0;0;0;.00nan;0;0
8175;184563;118;0;0;0;0;.00nan;0;0
8175;191026;118;41;40;7;33;.825;3600000;0
8176;187699;114;87;32;2;30;.938;3900000;0
8176;183775;114;0;0;0;0;.00nan;0;0
8176;184932;122;0;0;0;0;.00nan;0;0
8176;186520;122;95;43;2;41;.953;3900000;0
8177;-1;110;77;30;2;28;.933;3600000;0
8177;186527;110;0;0;0;0;.00nan;0;0
8177;186580;127;37;29;5;24;.828;3600000;0
8177;191171;127;0;0;0;0;.00nan;0;0
8178;188888;116;63;27;3;24;.889;3541000;0
8178;183698;126;65;20;2;18;.900;3600000;0
8178;180731;126;0;0;0;0;.00nan;0;0
8178;185812;116;0;0;0;0;.00nan;0;0
8179;182305;109;0;0;0;0;.00nan;0;0
8179;183693;115;69;28;3;25;.893;3543000;0
8179;186450;115;0;0;0;0;.00nan;0;0
8179;197038;109;100;41;1;40;.976;3600000;0
8180;184533;117;45;18;3;15;.833;3600000;0
8180;184592;117;0;0;0;0;.00nan;0;0
8180;184932;122;0;0;0;0;.00nan;0;0
8180;186520;122;63;28;3;25;.893;3578000;0
8181;195089;124;39;1;1;0;.000;562000;0
8181;-1;124;40;37;6;31;.838;3038000;0
8181;-1;113;0;0;0;0;.00nan;0;0
8181;191709;113;72;30;3;27;.900;3600000;0
8182;184563;118;82;51;6;45;.882;3600000;0
8182;185775;123;50;14;2;12;.857;3600000;0
8182;191026;118;0;0;0;0;.00nan;0;0
8182;191125;123;0;0;0;0;.00nan;0;0
8183;188918;112;0;0;0;0;.00nan;0;0
8183;202246;112;47;39;5;34;.872;3600000;0
8183;186580;127;0;0;0;0;.00nan;0;0
8183;191171;127;65;21;2;19;.905;3600000;0
8184;183755;120;49;32;5;27;.844;3600000;0
8184;189734;120;0;0;0;0;.00nan;0;0
8184;179350;125;42;23;4;19;.826;3600000;0
8184;191813;125;0;0;0;0;.00nan;0;0
8185;192776;119;23;24;6;18;.750;2372000;0
8185;188888;116;0;0;0;0;.00nan;0;0
8185;195017;119;27;18;4;14;.778;1228000;0
8185;185812;116;64;26;3;23;.885;3600000;0
8186;187699;114;0;0;0;0;.00nan;0;0
8186;183693;115;89;27;1;26;.963;3600000;0
8186;183775;114;55;36;4;32;.889;3600000;0
8186;186450;115;0;0;0;0;.00nan;0;0
8187;185775;123;0;0;0;0;.00nan;0;0
8187;186572;121;0;0;0;0;.00nan;0;0
8187;191125;123;59;37;5;32;.865;3571000;0
8187;192645;121;51;35;5;30;.857;3600000;0
8188;195089;124;81;40;3;37;.925;3658000;0
8188;-1;124;0;0;0;0;.00nan;0;0
8188;186580;127;58;35;4;31;.886;3658000;0
8188;191171;127;0;0;0;0;.00nan;0;0
8189;187537;117;84;30;1;29;.967;3600000;0
8189;183693;115;0;0;0;0;.00nan;0;0
8189;184533;117;0;0;0;0;.00nan;0;0
8189;186450;115;36;35;5;30;.857;3600000;0
8190;188888;116;80;34;3;31;.912;3731000;0
8190;-1;113;0;0;0;0;.00nan;0;0
8190;185812;116;0;0;0;0;.00nan;0;0
8190;191709;113;75;31;2;29;.935;3731000;0
8191;189008;108;0;0;0;0;.00nan;0;0
8191;196372;108;78;30;2;28;.933;3600000;0
8191;-1;110;0;0;0;0;.00nan;0;0
8191;186527;110;72;31;3;28;.903;3564000;0
8192;182305;109;64;30;3;27;.900;3600000;0
8192;187550;111;0;0;0;0;.00nan;0;0
8192;-1;111;55;35;4;31;.886;3591000;0
8192;197038;109;0;0;0;0;.00nan;0;0
8193;188918;112;71;30;3;27;.900;3550000;0
8193;189008;108;61;24;2;22;.917;3600000;0
8193;196372;108;0;0;0;0;.00nan;0;0
8193;202246;112;0;0;0;0;.00nan;0;0
8194;179350;125;75;45;5;40;.889;3600000;0
8194;-1;113;0;0;0;0;.00nan;0;0
8194;191709;113;57;13;1;12;.923;3600000;0
8194;191813;125;0;0;0;0;.00nan;0;0
8195;192776;119;83;53;5;48;.906;3550000;0
8195;195017;119;0;0;0;0;.00nan;0;0
8195;184932;122;0;0;0;0;.00nan;0;0
8195;186520;122;51;18;3;15;.833;3600000;0
8196;186572;121;49;32;6;26;.813;3900000;0
8196;186580;127;0;0;0;0;.00nan;0;0
8196;191171;127;57;54;6;48;.889;3900000;0
8196;192645;121;0;0;0;0;.00nan;0;0
8197;187699;114;0;0;0;0;.00nan;0;0
8197;183775;114;72;37;4;33;.892;3900000;0
8197;185775;123;62;32;4;28;.875;3900000;0
8197;191125;123;0;0;0;0;.00nan;0;0
8198;183698;126;0;0;0;0;.00nan;0;0
8198;184563;118;95;29;1;28;.966;3900000;0
8198;180731;126;71;22;1;21;.955;3900000;0
8198;191026;118;0;0;0;0;.00nan;0;0
8199;187550;111;61;40;5;35;.875;3600000;0
8199;183755;120;90;35;2;33;.943;3600000;0
8199;189734;120;0;0;0;0;.00nan;0;0
8199;-1;111;0;0;0;0;.00nan;0;0
8200;192776;119;0;0;0;0;.00nan;0;0
8200;195017;119;45;18;3;15;.833;3600000;0
8200;179350;125;33;27;6;21;.778;3600000;0
8200;191813;125;0;0;0;0;.00nan;0;0
8201;188918;112;0;0;0;0;.00nan;0;0
8201;202246;112;28;43;8;35;.814;3600000;0
8201;-1;110;42;34;6;28;.824;3600000;0
8201;186527;110;0;0;0;0;.00nan;0;0
8202;187699;114;16;21;6;15;.714;2521000;0
8202;183775;114;56;5;0;5;1.000;1079000;0
8202;195089;124;82;26;2;24;.923;3600000;0
8202;-1;124;0;0;0;0;.00nan;0;0
8203;184563;118;0;0;0;0;.00nan;0;0
8203;191026;118;97;49;2;47;.959;3600000;0
8203;186580;127;61;12;1;11;.917;3600000;0
8203;191171;127;0;0;0;0;.00nan;0;0
8204;187537;117;60;36;4;32;.889;3544000;0
8204;183698;126;63;23;2;21;.913;3600000;0
8204;184533;117;0;0;0;0;.00nan;0;0
8204;180731;126;0;0;0;0;.00nan;0;0
8205;182305;109;0;0;0;0;.00nan;0;0
8205;188888;116;0;0;0;0;.00nan;0;0
8205;185812;116;93;42;2;40;.952;3600000;0
8205;197038;109;28;31;6;25;.806;3600000;0
8206;183693;115;100;38;1;37;.974;3600000;0
8206;185775;123;0;0;0;0;.00nan;0;0
8206;186450;115;0;0;0;0;.00nan;0;0
8206;191125;123;29;37;8;29;.784;3600000;0
8207;187550;111;0;0;0;0;.00nan;0;0
8207;184932;122;0;0;0;0;.00nan;0;0
8207;-1;111;77;46;5;41;.891;3547000;0
8207;186520;122;55;26;4;22;.846;3600000;0
8208;183755;120;0;0;0;0;.00nan;0;0
8208;189734;120;63;47;6;41;.872;3600000;0
8208;186572;121;0;0;0;0;.00nan;0;0
8208;192645;121;71;33;3;30;.909;3600000;0
8209;188918;112;78;35;2;33;.943;3600000;0
8209;189008;108;0;0;0;0;.00nan;0;0
8209;196372;108;54;33;4;29;.879;3550000;0
8209;202246;112;0;0;0;0;.00nan;0;0
8210;192776;119;66;20;1;19;.950;3600000;0
8210;195017;119;0;0;0;0;.00nan;0;0
8210;185775;123;48;34;5;29;.853;3600000;0
8210;191125;123;0;0;0;0;.00nan;0;0
8211;184563;118;89;34;1;33;.971;3600000;0
8211;184932;122;0;0;0;0;.00nan;0;0
8211;191026;118;0;0;0;0;.00nan;0;0
8211;186520;122;48;37;6;31;.838;3600000;0
8212;182305;109;72;36;3;33;.917;3600000;0
8212;188918;112;0;0;0;0;.00nan;0;0
8212;202246;112;30;40;8;32;.800;3600000;0
8212;197038;109;0;0;0;0;.00nan;0;0
8213;187699;114;61;7;0;7;1.000;1584000;0
8213;188888;116;0;0;0;0;.00nan;0;0
8213;183775;114;36;30;6;24;.800;1938000;0
8213;185812;116;44;24;4;20;.833;3600000;0
8214;192776;119;55;28;3;25;.893;3600000;0
8214;187537;117;87;33;2;31;.939;3600000;0
8214;195017;119;0;0;0;0;.00nan;0;0
8214;184533;117;0;0;0;0;.00nan;0;0
8215;183693;115;62;31;4;27;.871;3600000;0
8215;-1;113;0;0;0;0;.00nan;0;0
8215;186450;115;0;0;0;0;.00nan;0;0
8215;191709;113;91;28;1;27;.964;3600000;0
8216;183755;120;85;33;2;31;.939;3600000;0
8216;189734;120;0;0;0;0;.00nan;0;0
8216;-1;110;0;0;0;0;.00nan;0;0
8216;186527;110;59;33;3;30;.909;3575000;0
8217;183698;126;0;0;0;0;.00nan;0;0
8217;195089;124;74;40;3;37;.925;3600000;0
8217;180731;126;52;30;4;26;.867;3557000;0
8217;-1;124;0;0;0;0;.00nan;0;0
8218;183755;120;0;0;0;0;.00nan;0;0
8218;189008;108;0;0;0;0;.00nan;0;0
8218;189734;120;39;25;4;21;.840;3580000;0
8218;196372;108;71;34;3;31;.912;3600000;0
8219;187550;111;22;10;4;6;.600;1026000;0
8219;-1;111;54;15;2;13;.867;2574000;0
8219;186580;127;20;25;7;18;.720;3269000;0
8219;191171;127;39;1;1;0;.000;316000;0
8220;187537;117;0;0;0;0;.00nan;0;0
8220;183693;115;0;0;0;0;.00nan;0;0
8220;184533;117;79;35;2;33;.943;3600000;0
8220;186450;115;37;27;5;22;.815;3572000;0
8221;184932;122;0;0;0;0;.00nan;0;0
8221;186520;122;73;39;4;35;.897;3600000;0
8221;186572;121;0;0;0;0;.00nan;0;0
8221;192645;121;39;36;6;30;.833;3514000;0
8222;192776;119;69;15;0;15;1.000;1484000;0
8222;187699;114;57;32;4;28;.875;3600000;0
8222;183775;114;0;0;0;0;.00nan;0;0
8222;195017;119;4;15;6;9;.600;2116000;0
8223;183698;126;0;0;0;0;.00nan;0;0
8223;180731;126;100;42;0;42;1.000;3600000;0
8223;185775;123;0;0;0;0;.00nan;0;0
8223;191125;123;57;32;4;28;.875;3600000;0
8224;184563;118;0;0;0;0;.00nan;0;0
8224;179350;125;45;24;4;20;.833;3671000;0
8224;191026;118;62;39;5;34;.872;3671000;0
8224;191813;125;0;0;0;0;.00nan;0;0
8225;188918;112;80;32;1;31;.969;3600000;0
8225;202246;112;0;0;0;0;.00nan;0;0
8225;-1;110;83;41;2;39;.951;3600000;0
8225;186527;110;0;0;0;0;.00nan;0;0
8226;182305;109;0;0;0;0;.00nan;0;0
8226;195089;124;28;30;6;24;.800;2995000;0
8226;-1;124;59;9;0;9;1.000;542000;0
8226;197038;109;50;25;4;21;.840;3600000;0
8227;184932;122;0;0;0;0;.00nan;0;0
8227;186520;122;68;36;4;32;.889;3600000;0
8227;186572;121;35;31;5;26;.839;3566000;0
8227;192645;121;0;0;0;0;.00nan;0;0
8228;179350;125;39;18;4;14;.778;1545000;0
8228;185775;123;70;24;2;22;.917;3600000;0
8228;191125;123;0;0;0;0;.00nan;0;0
8228;191813;125;17;28;6;22;.786;2055000;0
8229;-1;110;0;0;0;0;.00nan;0;0
8229;186527;110;78;37;3;34;.919;3600000;0
8229;186580;127;0;0;0;0;.00nan;0;0
8229;191171;127;47;27;4;23;.852;3545000;0
8230;188888;116;0;0;0;0;.00nan;0;0
8230;-1;113;0;0;0;0;.00nan;0;0
8230;185812;116;76;28;2;26;.929;3600000;0
8230;191709;113;59;29;4;25;.862;3558000;0
8231;189008;108;0;0;0;0;.00nan;0;0
8231;196372;108;37;23;4;19;.826;3565000;0
8231;186580;127;78;29;2;27;.931;3600000;0
8231;191171;127;0;0;0;0;.00nan;0;0
8232;187550;111;0;0;0;0;.00nan;0;0
8232;183755;120;46;30;4;26;.867;3600000;0
8232;189734;120;0;0;0;0;.00nan;0;0
8232;-1;111;57;38;5;33;.868;3591000;0
8233;182305;109;39;31;5;26;.839;3600000;0
8233;183693;115;75;24;2;22;.917;3600000;0
8233;186450;115;0;0;0;0;.00nan;0;0
8233;197038;109;0;0;0;0;.00nan;0;0
8234;187537;117;76;29;2;27;.931;3600000;0
8234;184533;117;0;0;0;0;.00nan;0;0
8234;-1;113;0;0;0;0;.00nan;0;0
8234;191709;113;51;36;6;30;.833;3600000;0
8235;187699;114;49;1;0;1;1.000;295000;0
8235;188888;116;55;15;2;13;.867;3600000;0
8235;183775;114;60;50;6;44;.880;3305000;0
8235;185812;116;0;0;0;0;.00nan;0;0
8236;192776;119;100;41;1;40;.976;3600000;0
8236;183698;126;0;0;0;0;.00nan;0;0
8236;195017;119;0;0;0;0;.00nan;0;0
8236;180731;126;44;29;5;24;.828;3600000;0
8237;188918;112;59;3;0;3;1.000;588000;0
8237;195089;124;0;0;0;0;.00nan;0;0
8237;202246;112;59;47;6;41;.872;3312000;0
8237;-1;124;32;38;6;32;.842;3900000;0
8238;188888;116;0;0;0;0;.00nan;0;0
8238;183755;120;56;24;3;21;.875;3600000;0
8238;189734;120;0;0;0;0;.00nan;0;0
8238;185812;116;56;31;4;27;.871;3578000;0
8239;187537;117;87;28;1;27;.964;3600000;0
8239;187699;114;0;0;0;0;.00nan;0;0
8239;183775;114;64;31;3;28;.903;3600000;0
8239;184533;117;0;0;0;0;.00nan;0;0
8240;182305;109;65;32;4;28;.875;3600000;0
8240;-1;113;0;0;0;0;.00nan;0;0
8240;197038;109;0;0;0;0;.00nan;0;0
8240;191709;113;100;28;0;28;1.000;3600000;0
8241;187550;111;0;0;0;0;.00nan;0;0
8241;-1;110;0;0;0;0;.00nan;0;0
8241;-1;111;77;32;2;30;.938;3600000;0
8241;186527;110;77;35;3;32;.914;3532000;0
8242;195089;124;75;36;3;33;.917;3584000;0
8242;-1;124;0;0;0;0;.00nan;0;0
8242;186580;127;0;0;0;0;.00nan;0;0
8242;191171;127;61;25;2;23;.920;3600000;0
8243;189008;108;0;0;0;0;.00nan;0;0
8243;196372;108;67;35;4;31;.886;3613000;0
8243;-1;113;0;0;0;0;.00nan;0;0
8243;191709;113;75;35;3;32;.914;3613000;0
8244;183693;115;0;0;0;0;.00nan;0;0
8244;179350;125;35;42;7;35;.833;3600000;0
8244;186450;115;64;22;2;20;.909;3600000;0
8244;191813;125;0;0;0;0;.00nan;0;0
8245;-1;110;82;34;2;32;.941;3569000;0
8245;186527;110;0;0;0;0;.00nan;0;0
8245;186572;121;0;0;0;0;.00nan;0;0
8245;192645;121;58;14;1;13;.929;3600000;0
8246;187537;117;0;0;0;0;.00nan;0;0
8246;187699;114;66;36;4;32;.889;3669000;0
8246;183775;114;0;0;0;0;.00nan;0;0
8246;184533;117;57;25;3;22;.880;3669000;0
8247;183698;126;0;0;0;0;.00nan;0;0
8247;184932;122;0;0;0;0;.00nan;0;0
8247;180731;126;93;36;1;35;.972;3767000;0
8247;186520;122;84;29;2;27;.931;3767000;0
8248;184563;118;80;24;1;23;.958;3600000;0
8248;185775;123;67;31;3;28;.903;3537000;0
8248;191026;118;0;0;0;0;.00nan;0;0
8248;191125;123;0;0;0;0;.00nan;0;0
8249;192776;119;77;38;3;35;.921;3543000;0
8249;188918;112;76;24;1;23;.958;3600000;0
8249;195017;119;0;0;0;0;.00nan;0;0
8249;202246;112;0;0;0;0;.00nan;0;0
8250;187550;111;52;25;4;21;.840;3574000;0
8250;-1;111;0;0;0;0;.00nan;0;0
8250;-1;113;0;0;0;0;.00nan;0;0
8250;191709;113;83;40;3;37;.925;3600000;0
8251;182305;109;0;0;0;0;.00nan;0;0
8251;189008;108;97;38;0;38;1.000;2558000;0
8251;196372;108;34;18;4;14;.778;1022000;0
8251;197038;109;86;34;2;32;.941;3600000;0
8252;192776;119;42;17;3;14;.824;2540000;0
8252;195017;119;20;12;4;8;.667;1024000;0
8252;186572;121;30;21;5;16;.762;3600000;0
8252;192645;121;0;0;0;0;.00nan;0;0
8253;183755;120;0;0;0;0;.00nan;0;0
8253;189734;120;47;32;5;27;.844;3600000;0
8253;179350;125;59;33;4;29;.879;3600000;0
8253;191813;125;0;0;0;0;.00nan;0;0
8254;195089;124;47;28;4;24;.857;3600000;0
8254;-1;110;0;0;0;0;.00nan;0;0
8254;-1;124;0;0;0;0;.00nan;0;0
8254;186527;110;59;43;5;38;.884;3579000;0
8255;184932;122;0;0;0;0;.00nan;0;0
8255;186520;122;61;31;4;27;.871;3600000;0
8255;186580;127;24;28;6;22;.786;3549000;0
8255;191171;127;0;0;0;0;.00nan;0;0
8256;188888;116;71;24;2;22;.917;3600000;0
8256;188918;112;0;0;0;0;.00nan;0;0
8256;202246;112;67;37;4;33;.892;3573000;0
8256;185812;116;0;0;0;0;.00nan;0;0
8257;182305;109;59;39;4;35;.897;3570000;0
8257;183693;115;0;0;0;0;.00nan;0;0
8257;186450;115;59;26;3;23;.885;3600000;0
8257;197038;109;0;0;0;0;.00nan;0;0
8258;187537;117;64;42;6;36;.857;3514000;0
8258;188888;116;0;0;0;0;.00nan;0;0
8258;184533;117;0;0;0;0;.00nan;0;0
8258;185812;116;55;31;4;27;.871;3600000;0
8259;183755;120;63;23;2;21;.913;3600000;0
8259;189734;120;0;0;0;0;.00nan;0;0
8259;184563;118;0;0;0;0;.00nan;0;0
8259;191026;118;78;43;4;39;.907;3524000;0
8260;183698;126;0;0;0;0;.00nan;0;0
8260;180731;126;86;44;3;41;.932;3600000;0
8260;185775;123;99;22;0;22;1.000;3600000;0
8260;191125;123;0;0;0;0;.00nan;0;0
8261;195089;124;0;0;0;0;.00nan;0;0
8261;-1;124;72;35;4;31;.886;3543000;0
8261;186580;127;0;0;0;0;.00nan;0;0
8261;191171;127;73;28;2;26;.929;3600000;0
8262;187550;111;0;0;0;0;.00nan;0;0
8262;188918;112;81;40;3;37;.925;3600000;0
8262;202246;112;0;0;0;0;.00nan;0;0
8262;-1;111;54;29;4;25;.862;3576000;0
8263;184932;122;94;47;3;44;.936;3833000;0
8263;186520;122;0;0;0;0;.00nan;0;0
8263;186572;121;0;0;0;0;.00nan;0;0
8263;192645;121;67;28;2;26;.929;3833000;0
8264;188888;116;0;0;0;0;.00nan;0;0
8264;183755;120;100;37;0;37;1.000;3600000;0
8264;189734;120;0;0;0;0;.00nan;0;0
8264;185812;116;46;32;5;27;.844;3600000;0
8265;183698;126;0;0;0;0;.00nan;0;0
8265;180731;126;84;41;4;37;.902;3514000;0
8265;186580;127;72;25;2;23;.920;3600000;0
8265;191171;127;0;0;0;0;.00nan;0;0
8266;192776;119;40;22;4;18;.818;3548000;0
8266;195017;119;0;0;0;0;.00nan;0;0
8266;184563;118;82;44;3;41;.932;3600000;0
8266;191026;118;0;0;0;0;.00nan;0;0
8267;187537;117;20;31;7;24;.774;2929000;0
8267;183693;115;63;19;2;17;.895;3600000;0
8267;184533;117;56;4;0;4;1.000;671000;0
8267;186450;115;0;0;0;0;.00nan;0;0
8268;187699;114;42;40;6;34;.850;3600000;0
8268;183775;114;0;0;0;0;.00nan;0;0
8268;-1;113;0;0;0;0;.00nan;0;0
8268;191709;113;42;25;5;20;.800;3600000;0
8269;188918;112;53;3;0;3;1.000;483000;0
8269;202246;112;38;33;6;27;.818;3117000;0
8269;-1;110;0;0;0;0;.00nan;0;0
8269;186527;110;65;25;3;22;.880;3600000;0
8270;195089;124;84;44;3;41;.932;3662000;0
8270;-1;124;0;0;0;0;.00nan;0;0
8270;185775;123;60;27;4;23;.852;3662000;0
8270;191125;123;0;0;0;0;.00nan;0;0
8271;182305;109;0;0;0;0;.00nan;0;0
8271;187699;114;0;0;0;0;.00nan;0;0
8271;183775;114;41;28;5;23;.821;3600000;0
8271;197038;109;95;19;0;19;1.000;3600000;0
8272;188918;112;60;26;3;23;.885;3615000;0
8272;189008;108;78;31;2;29;.935;3615000;0
8272;196372;108;0;0;0;0;.00nan;0;0
8272;202246;112;0;0;0;0;.00nan;0;0
8273;188888;116;43;25;4;21;.840;3600000;0
8273;179350;125;95;25;0;25;1.000;3600000;0
8273;185812;116;0;0;0;0;.00nan;0;0
8273;191813;125;0;0;0;0;.00nan;0;0
8274;184563;118;29;25;5;20;.800;2147000;0
8274;184932;122;0;0;0;0;.00nan;0;0
8274;191026;118;30;12;4;8;.667;1453000;0
8274;186520;122;69;20;1;19;.950;3600000;0
8275;192776;119;0;0;0;0;.00nan;0;0
8275;195017;119;62;32;3;29;.906;3564000;0
8275;186572;121;0;0;0;0;.00nan;0;0
8275;192645;121;80;31;2;29;.935;3600000;0
8276;187550;111;0;0;0;0;.00nan;0;0
8276;-1;111;89;31;1;30;.968;3600000;0
8276;185775;123;0;0;0;0;.00nan;0;0
8276;191125;123;60;32;3;29;.906;3600000;0
8277;183693;115;0;0;0;0;.00nan;0;0
8277;183698;126;0;0;0;0;.00nan;0;0
8277;180731;126;67;47;5;42;.894;3578000;0
8277;186450;115;59;34;4;30;.882;3600000;0
8278;182305;109;0;0;0;0;.00nan;0;0
8278;187537;117;71;20;1;19;.950;3900000;0
8278;184533;117;0;0;0;0;.00nan;0;0
8278;197038;109;88;30;1;29;.967;3900000;0
8279;187550;111;55;27;4;23;.852;3600000;0
8279;179350;125;40;33;6;27;.818;3514000;0
8279;-1;111;0;0;0;0;.00nan;0;0
8279;191813;125;0;0;0;0;.00nan;0;0
8280;192776;119;49;28;4;24;.857;3550000;0
8280;195017;119;0;0;0;0;.00nan;0;0
8280;184932;122;55;24;3;21;.875;3600000;0
8280;186520;122;0;0;0;0;.00nan;0;0
8281;183755;120;45;42;6;36;.857;3600000;0
8281;189734;120;0;0;0;0;.00nan;0;0
8281;186572;121;0;0;0;0;.00nan;0;0
8281;192645;121;69;24;2;22;.917;3600000;0
8282;-1;110;0;0;0;0;.00nan;0;0
8282;-1;113;0;0;0;0;.00nan;0;0
8282;186527;110;99;41;2;39;.951;3600000;0
8282;191709;113;63;34;4;30;.882;3530000;0
8283;188888;116;0;0;0;0;.00nan;0;0
8283;185812;116;77;36;3;33;.917;3596000;0
8283;186580;127;0;0;0;0;.00nan;0;0
8283;191171;127;67;28;2;26;.929;3600000;0
8284;189008;108;0;0;0;0;.00nan;0;0
8284;196372;108;34;27;5;22;.815;3545000;0
8284;-1;110;51;27;4;23;.852;3600000;0
8284;186527;110;0;0;0;0;.00nan;0;0
8285;187699;114;60;42;5;37;.881;3600000;0
8285;183693;115;100;28;0;28;1.000;3600000;0
8285;183775;114;0;0;0;0;.00nan;0;0
8285;186450;115;0;0;0;0;.00nan;0;0
8286;187537;117;0;0;0;0;.00nan;0;0
8286;184533;117;47;34;5;29;.853;3543000;0
8286;-1;113;62;33;4;29;.879;3600000;0
8286;191709;113;0;0;0;0;.00nan;0;0
8287;184563;118;97;52;3;49;.942;3555000;0
8287;191026;118;0;0;0;0;.00nan;0;0
8287;186572;121;82;34;2;32;.941;3600000;0
8287;192645;121;0;0;0;0;.00nan;0;0
8288;187550;111;0;0;0;0;.00nan;0;0
8288;-1;111;93;34;1;33;.971;3600000;0
8288;186580;127;70;25;2;23;.920;3555000;0
8288;191171;127;0;0;0;0;.00nan;0;0
8289;182305;109;28;26;6;20;.769;2754000;0
8289;188918;112;0;0;0;0;.00nan;0;0
8289;202246;112;64;36;3;33;.917;3600000;0
8289;197038;109;55;4;0;4;1.000;846000;0
8290;195089;124;72;37;3;34;.919;3562000;0
8290;-1;124;0;0;0;0;.00nan;0;0
8290;185775;123;80;30;2;28;.933;3600000;0
8290;191125;123;0;0;0;0;.00nan;0;0
8291;188918;112;54;33;4;29;.879;3576000;0
8291;189008;108;84;34;2;32;.941;3600000;0
8291;196372;108;0;0;0;0;.00nan;0;0
8291;202246;112;0;0;0;0;.00nan;0;0
8292;179350;125;64;32;3;29;.906;3600000;0
8292;186572;121;81;22;0;22;1.000;2643000;0
8292;191813;125;0;0;0;0;.00nan;0;0
8292;192645;121;29;15;4;11;.733;957000;0
8293;183755;120;44;34;5;29;.853;3600000;0
8293;189734;120;0;0;0;0;.00nan;0;0
8293;185775;123;62;19;2;17;.895;3600000;0
8293;191125;123;0;0;0;0;.00nan;0;0
8294;187699;114;0;0;0;0;.00nan;0;0
8294;183698;126;0;0;0;0;.00nan;0;0
8294;183775;114;56;46;6;40;.870;3600000;0
8294;180731;126;87;28;1;27;.964;3600000;0
8295;187537;117;46;36;6;30;.833;3819000;0
8295;184533;117;0;0;0;0;.00nan;0;0
8295;-1;113;0;0;0;0;.00nan;0;0
8295;191709;113;68;40;5;35;.875;3819000;0
8296;183693;115;17;8;4;4;.500;988000;0
8296;-1;110;0;0;0;0;.00nan;0;0
8296;186450;115;74;21;1;20;.952;2612000;0
8296;186527;110;70;39;4;35;.897;3600000;0
8297;192776;119;77;29;1;28;.966;3600000;0
8297;195017;119;0;0;0;0;.00nan;0;0
8297;195089;124;63;30;2;28;.933;3565000;0
8297;-1;124;0;0;0;0;.00nan;0;0
8298;189008;108;0;0;0;0;.00nan;0;0
8298;184932;122;0;0;0;0;.00nan;0;0
8298;196372;108;61;29;3;26;.897;3600000;0
8298;186520;122;31;34;6;28;.824;3600000;0
8299;187550;111;0;0;0;0;.00nan;0;0
8299;-1;110;56;29;4;25;.862;3567000;0
8299;-1;111;60;28;3;25;.893;3600000;0
8299;186527;110;0;0;0;0;.00nan;0;0
8300;188888;116;37;40;7;33;.825;3600000;0
8300;183693;115;80;25;1;24;.960;3600000;0
8300;185812;116;0;0;0;0;.00nan;0;0
8300;186450;115;0;0;0;0;.00nan;0;0
8301;195089;124;0;0;0;0;.00nan;0;0
8301;-1;124;58;29;4;25;.862;3600000;0
8301;186572;121;0;0;0;0;.00nan;0;0
8301;192645;121;87;21;1;20;.952;3600000;0
8302;187699;114;80;37;3;34;.919;3600000;0
8302;183775;114;0;0;0;0;.00nan;0;0
8302;-1;113;27;25;6;19;.760;2727000;0
8302;191709;113;45;9;2;7;.778;873000;0
8303;192776;119;0;0;0;0;.00nan;0;0
8303;195017;119;49;38;5;33;.868;3600000;0
8303;185775;123;0;0;0;0;.00nan;0;0
8303;191125;123;87;24;1;23;.958;3600000;0
8304;183755;120;27;30;6;24;.800;3600000;0
8304;189734;120;0;0;0;0;.00nan;0;0
8304;186580;127;49;1;0;1;1.000;245000;0
8304;191171;127;24;36;7;29;.806;3318000;0
8305;182305;109;0;0;0;0;.00nan;0;0
8305;184563;118;0;0;0;0;.00nan;0;0
8305;191026;118;73;42;4;38;.905;3600000;0
8305;197038;109;72;33;3;30;.909;3600000;0
8306;188918;112;27;15;4;11;.733;1108000;0
8306;179350;125;73;34;3;31;.912;3600000;0
8306;202246;112;48;31;5;26;.839;2492000;0
8306;191813;125;0;0;0;0;.00nan;0;0
8307;187550;111;49;28;4;24;.857;3900000;0
8307;184932;122;59;31;4;27;.871;3900000;0
8307;-1;111;0;0;0;0;.00nan;0;0
8307;186520;122;0;0;0;0;.00nan;0;0
8308;182305;109;64;26;2;24;.923;3600000;0
8308;179350;125;41;47;8;39;.830;3600000;0
8308;197038;109;0;0;0;0;.00nan;0;0
8308;191813;125;0;0;0;0;.00nan;0;0
8309;184563;118;69;45;5;40;.889;3576000;0
8309;185775;123;44;17;3;14;.824;3600000;0
8309;191026;118;0;0;0;0;.00nan;0;0
8309;191125;123;0;0;0;0;.00nan;0;0
8310;183755;120;0;0;0;0;.00nan;0;0
8310;195089;124;46;29;5;24;.828;3600000;0
8310;189734;120;83;34;2;32;.941;3600000;0
8310;-1;124;0;0;0;0;.00nan;0;0
8311;192776;119;63;28;4;24;.857;3557000;0
8311;195017;119;0;0;0;0;.00nan;0;0
8311;186580;127;57;25;3;22;.880;3600000;0
8311;191171;127;0;0;0;0;.00nan;0;0
8312;183698;126;36;19;4;15;.789;2643000;0
8312;180731;126;23;9;4;5;.556;957000;0
8312;-1;113;0;0;0;0;.00nan;0;0
8312;191709;113;58;35;4;31;.886;3600000;0
8313;188888;116;0;0;0;0;.00nan;0;0
8313;189008;108;20;12;4;8;.667;1080000;0
8313;196372;108;46;19;4;15;.789;2520000;0
8313;185812;116;45;18;3;15;.833;3600000;0
8314;182305;109;54;16;2;14;.875;1605000;0
8314;-1;110;0;0;0;0;.00nan;0;0
8314;186527;110;70;33;2;31;.939;3600000;0
8314;197038;109;19;21;6;15;.714;1995000;0
8315;187699;114;0;0;0;0;.00nan;0;0
8315;183693;115;92;29;1;28;.966;3600000;0
8315;183775;114;74;39;4;35;.897;3600000;0
8315;186450;115;0;0;0;0;.00nan;0;0
8316;188918;112;59;39;4;35;.897;3600000;0
8316;202246;112;0;0;0;0;.00nan;0;0
8316;186572;121;0;0;0;0;.00nan;0;0
8316;192645;121;38;29;5;24;.828;3552000;0
8317;183698;126;0;0;0;0;.00nan;0;0
8317;180731;126;44;19;4;15;.789;3543000;0
8317;186580;127;0;0;0;0;.00nan;0;0
8317;191171;127;58;33;3;30;.909;3600000;0
8318;187537;117;86;24;1;23;.958;3600000;0
8318;189008;108;49;36;5;31;.861;3600000;0
8318;184533;117;0;0;0;0;.00nan;0;0
8318;196372;108;0;0;0;0;.00nan;0;0
8319;184563;118;0;0;0;0;.00nan;0;0
8319;184932;122;0;0;0;0;.00nan;0;0
8319;191026;118;59;30;4;26;.867;3600000;0
8319;186520;122;64;17;1;16;.941;3600000;0
8320;188918;112;0;0;0;0;.00nan;0;0
8320;183755;120;85;31;2;29;.935;3600000;0
8320;189734;120;0;0;0;0;.00nan;0;0
8320;202246;112;68;40;4;36;.900;3567000;0
8321;187550;111;0;0;0;0;.00nan;0;0
8321;189008;108;69;34;3;31;.912;3600000;0
8321;196372;108;0;0;0;0;.00nan;0;0
8321;-1;111;71;27;2;25;.926;3600000;0
8322;179350;125;52;31;4;27;.871;3594000;0
8322;185775;123;71;37;3;34;.919;3600000;0
8322;191125;123;0;0;0;0;.00nan;0;0
8322;191813;125;0;0;0;0;.00nan;0;0
8323;192776;119;74;38;3;35;.921;3600000;0
8323;195017;119;0;0;0;0;.00nan;0;0
8323;-1;113;0;0;0;0;.00nan;0;0
8323;191709;113;77;12;0;12;1.000;3600000;0
8324;182305;109;42;27;4;23;.852;2005000;0
8324;195089;124;0;0;0;0;.00nan;0;0
8324;-1;124;75;33;2;31;.939;3600000;0
8324;197038;109;69;20;1;19;.950;1595000;0
8325;187699;114;0;0;0;0;.00nan;0;0
8325;183698;126;0;0;0;0;.00nan;0;0
8325;183775;114;70;40;4;36;.900;3600000;0
8325;180731;126;100;32;0;32;1.000;3600000;0
8326;188888;116;63;31;3;28;.903;3600000;0
8326;185812;116;0;0;0;0;.00nan;0;0
8326;186580;127;50;2;0;2;1.000;285000;0
8326;191171;127;22;21;5;16;.762;3250000;0
8327;184563;118;78;26;2;24;.923;3566000;0
8327;-1;110;0;0;0;0;.00nan;0;0
8327;191026;118;0;0;0;0;.00nan;0;0
8327;186527;110;87;29;1;28;.966;3600000;0
8328;182305;109;76;39;3;36;.923;3900000;0
8328;183755;120;78;36;3;33;.917;3900000;0
8328;189734;120;0;0;0;0;.00nan;0;0
8328;197038;109;0;0;0;0;.00nan;0;0
8329;189008;108;0;0;0;0;.00nan;0;0
8329;196372;108;88;41;2;39;.951;3600000;0
8329;-1;110;83;26;1;25;.962;3600000;0
8329;186527;110;0;0;0;0;.00nan;0;0
8330;187537;117;41;26;4;22;.846;3513000;0
8330;187550;111;0;0;0;0;.00nan;0;0
8330;184533;117;0;0;0;0;.00nan;0;0
8330;-1;111;71;23;2;21;.913;3600000;0
8331;188918;112;41;30;5;25;.833;1806000;0
8331;202246;112;46;22;4;18;.818;1794000;0
8331;-1;113;0;0;0;0;.00nan;0;0
8331;191709;113;70;23;2;21;.913;3600000;0
8332;183693;115;44;20;4;16;.800;3600000;0
8332;184932;122;0;0;0;0;.00nan;0;0
8332;186450;115;0;0;0;0;.00nan;0;0
8332;186520;122;56;34;5;29;.853;3600000;0
8333;183698;126;0;0;0;0;.00nan;0;0
8333;180731;126;86;42;3;39;.929;3895000;0
8333;186572;121;0;0;0;0;.00nan;0;0
8333;192645;121;61;30;3;27;.900;3900000;0
8334;187699;114;73;23;2;21;.913;3545000;0
8334;183775;114;0;0;0;0;.00nan;0;0
8334;186580;127;99;27;0;27;1.000;3600000;0
8334;191171;127;0;0;0;0;.00nan;0;0
8335;179350;125;82;39;3;36;.923;3600000;0
8335;185775;123;59;31;4;27;.871;3586000;0
8335;191125;123;0;0;0;0;.00nan;0;0
8335;191813;125;0;0;0;0;.00nan;0;0
8336;192776;119;0;0;0;0;.00nan;0;0
8336;195017;119;75;27;2;25;.926;3600000;0
8336;184563;118;0;0;0;0;.00nan;0;0
8336;191026;118;79;47;4;43;.915;3549000;0
8337;183693;115;0;0;0;0;.00nan;0;0
8337;189008;108;90;35;2;33;.943;3900000;0
8337;196372;108;0;0;0;0;.00nan;0;0
8337;186450;115;83;28;2;26;.929;3900000;0
8338;195089;124;70;29;2;27;.931;3600000;0
8338;179350;125;0;0;0;0;.00nan;0;0
8338;-1;124;0;0;0;0;.00nan;0;0
8338;191813;125;59;41;5;36;.878;3600000;0
8339;192776;119;58;27;3;24;.889;3600000;0
8339;188918;112;53;3;0;3;1.000;369000;0
8339;195017;119;0;0;0;0;.00nan;0;0
8339;202246;112;27;23;6;17;.739;3231000;0
8340;183755;120;42;9;2;7;.778;561000;0
8340;189734;120;38;35;6;29;.829;3039000;0
8340;186572;121;45;17;3;14;.824;3600000;0
8340;192645;121;0;0;0;0;.00nan;0;0
8341;187550;111;0;0;0;0;.00nan;0;0
8341;188888;116;0;0;0;0;.00nan;0;0
8341;-1;111;47;33;5;28;.848;3600000;0
8341;185812;116;77;37;3;34;.919;3600000;0
8342;187537;117;48;25;4;21;.840;3538000;0
8342;184533;117;0;0;0;0;.00nan;0;0
8342;186580;127;60;21;2;19;.905;3600000;0
8342;191171;127;0;0;0;0;.00nan;0;0
8343;182305;109;0;0;0;0;.00nan;0;0
8343;-1;113;50;2;0;2;1.000;490000;0
8343;197038;109;83;44;4;40;.909;3600000;0
8343;191709;113;16;22;6;16;.727;3110000;0
8344;187699;114;0;0;0;0;.00nan;0;0
8344;183775;114;33;32;6;26;.813;3600000;0
8344;184932;122;0;0;0;0;.00nan;0;0
8344;186520;122;63;25;2;23;.920;3600000;0
8345;183698;126;0;0;0;0;.00nan;0;0
8345;195089;124;0;0;0;0;.00nan;0;0
8345;180731;126;43;38;7;31;.816;3600000;0
8345;-1;124;44;36;6;30;.833;3600000;0
8346;182305;109;58;30;4;26;.867;3600000;0
8346;192776;119;73;29;2;27;.931;3600000;0
8346;195017;119;0;0;0;0;.00nan;0;0
8346;197038;109;0;0;0;0;.00nan;0;0
8347;188888;116;100;21;0;21;1.000;3600000;0
8347;189008;108;0;0;0;0;.00nan;0;0
8347;196372;108;65;31;2;29;.935;3566000;0
8347;185812;116;0;0;0;0;.00nan;0;0
8348;187537;117;0;0;0;0;.00nan;0;0
8348;187550;111;77;37;3;34;.919;3600000;0
8348;184533;117;30;21;5;16;.762;3590000;0
8348;-1;111;0;0;0;0;.00nan;0;0
8349;183693;115;22;28;6;22;.786;3600000;0
8349;183755;120;67;37;3;34;.919;3600000;0
8349;189734;120;0;0;0;0;.00nan;0;0
8349;186450;115;0;0;0;0;.00nan;0;0
8350;187699;114;71;33;3;30;.909;3600000;0
8350;183775;114;0;0;0;0;.00nan;0;0
8350;184563;118;62;31;4;27;.871;3589000;0
8350;191026;118;0;0;0;0;.00nan;0;0
8351;195089;124;16;20;6;14;.700;1200000;0
8351;-1;124;90;40;2;38;.950;2400000;0
8351;186572;121;0;0;0;0;.00nan;0;0
8351;192645;121;60;15;1;14;.933;3600000;0
8352;188918;112;89;41;3;38;.927;3600000;0
8352;202246;112;0;0;0;0;.00nan;0;0
8352;-1;113;0;0;0;0;.00nan;0;0
8352;191709;113;38;26;5;21;.808;3596000;0
8353;184932;122;48;22;3;19;.864;3600000;0
8353;-1;110;0;0;0;0;.00nan;0;0
8353;186520;122;0;0;0;0;.00nan;0;0
8353;186527;110;60;38;5;33;.868;3535000;0
8354;183698;126;57;29;3;26;.897;3070000;0
8354;180731;126;29;8;3;5;.625;530000;0
8354;185775;123;0;0;0;0;.00nan;0;0
8354;191125;123;86;19;0;19;1.000;3600000;0
8355;188888;116;60;28;3;25;.893;3900000;0
8355;183755;120;66;31;3;28;.903;3900000;0
8355;189734;120;0;0;0;0;.00nan;0;0
8355;185812;116;0;0;0;0;.00nan;0;0
8356;179350;125;47;27;4;23;.852;3556000;0
8356;186580;127;0;0;0;0;.00nan;0;0
8356;191171;127;69;32;3;29;.906;3600000;0
8356;191813;125;0;0;0;0;.00nan;0;0
8357;189008;108;0;0;0;0;.00nan;0;0
8357;196372;108;89;41;2;39;.951;3600000;0
8357;186572;121;41;29;5;24;.828;3600000;0
8357;192645;121;0;0;0;0;.00nan;0;0
8358;187550;111;0;0;0;0;.00nan;0;0
8358;188918;112;0;0;0;0;.00nan;0;0
8358;202246;112;46;32;5;27;.844;3600000;0
8358;-1;111;83;35;3;32;.914;3600000;0
8359;183693;115;55;37;5;32;.865;3600000;0
8359;-1;113;0;0;0;0;.00nan;0;0
8359;186450;115;0;0;0;0;.00nan;0;0
8359;191709;113;85;31;2;29;.935;3600000;0
8360;182305;109;64;35;4;31;.886;3558000;0
8360;179350;125;88;35;2;33;.943;3600000;0
8360;197038;109;0;0;0;0;.00nan;0;0
8360;191813;125;0;0;0;0;.00nan;0;0
8361;184932;122;0;0;0;0;.00nan;0;0
8361;185775;123;0;0;0;0;.00nan;0;0
8361;186520;122;26;23;6;17;.739;3600000;0
8361;191125;123;63;24;2;22;.917;3600000;0
8362;187699;114;57;38;5;33;.868;3600000;0
8362;183775;114;0;0;0;0;.00nan;0;0
8362;-1;110;0;0;0;0;.00nan;0;0
8362;186527;110;72;33;3;30;.909;3600000;0
8363;187537;117;54;18;2;16;.889;3545000;0
8363;184533;117;0;0;0;0;.00nan;0;0
8363;186580;127;95;37;1;36;.973;3600000;0
8363;191171;127;0;0;0;0;.00nan;0;0
8364;195089;124;0;0;0;0;.00nan;0;0
8364;184563;118;78;31;2;29;.935;3600000;0
8364;-1;124;63;35;3;32;.914;3551000;0
8364;191026;118;0;0;0;0;.00nan;0;0
8365;187550;111;47;25;4;21;.840;1177000;0
8365;-1;111;72;21;1;20;.952;2681000;0
8365;186572;121;0;0;0;0;.00nan;0;0
8365;192645;121;15;22;6;16;.727;3858000;0
8366;189008;108;78;30;2;28;.933;3600000;0
8366;196372;108;0;0;0;0;.00nan;0;0
8366;-1;113;45;24;4;20;.833;3534000;0
8366;191709;113;0;0;0;0;.00nan;0;0
8367;187537;117;0;0;0;0;.00nan;0;0
8367;184533;117;57;30;4;26;.867;3600000;0
8367;179350;125;21;23;6;17;.739;2076000;0
8367;191813;125;52;14;1;13;.929;1524000;0
8368;192776;119;55;23;3;20;.870;3600000;0
8368;195017;119;0;0;0;0;.00nan;0;0
8368;184563;118;0;0;0;0;.00nan;0;0
8368;191026;118;66;36;4;32;.889;3560000;0
8369;183755;120;97;49;3;46;.939;3600000;0
8369;195089;124;37;30;5;25;.833;3600000;0
8369;189734;120;0;0;0;0;.00nan;0;0
8369;-1;124;0;0;0;0;.00nan;0;0
8370;182305;109;0;0;0;0;.00nan;0;0
8370;186580;127;0;0;0;0;.00nan;0;0
8370;191171;127;47;36;5;31;.861;3705000;0
8370;197038;109;66;35;4;31;.886;3705000;0
8371;183698;126;0;0;0;0;.00nan;0;0
8371;180731;126;64;31;4;27;.871;3600000;0
8371;-1;110;76;33;2;31;.939;3600000;0
8371;186527;110;0;0;0;0;.00nan;0;0
8372;188888;116;84;26;1;25;.962;2714000;0
8372;183693;115;0;0;0;0;.00nan;0;0
8372;185812;116;26;14;4;10;.714;886000;0
8372;186450;115;69;35;4;31;.886;3600000;0
8373;187537;117;28;15;4;11;.733;1128000;0
8373;184533;117;79;25;1;24;.960;2472000;0
8373;185775;123;63;21;2;19;.905;3600000;0
8373;191125;123;0;0;0;0;.00nan;0;0
8374;183698;126;60;30;4;26;.867;3600000;0
8374;184932;122;0;0;0;0;.00nan;0;0
8374;180731;126;0;0;0;0;.00nan;0;0
8374;186520;122;78;20;1;19;.950;3600000;0
8375;187699;114;51;3;0;3;1.000;296000;0
8375;183693;115;61;39;6;33;.846;3600000;0
8375;183775;114;35;36;7;29;.806;3271000;0
8375;186450;115;0;0;0;0;.00nan;0;0
8376;192776;119;0;0;0;0;.00nan;0;0
8376;189008;108;52;20;2;18;.900;2564000;0
8376;195017;119;77;32;3;29;.906;3600000;0
8376;196372;108;23;12;4;8;.667;1036000;0
8377;188888;116;0;0;0;0;.00nan;0;0
8377;188918;112;44;30;5;25;.833;3554000;0
8377;202246;112;0;0;0;0;.00nan;0;0
8377;185812;116;50;28;4;24;.857;3600000;0
8378;188918;112;0;0;0;0;.00nan;0;0
8378;202246;112;65;36;4;32;.889;3555000;0
8378;186572;121;60;18;2;16;.889;3600000;0
8378;192645;121;0;0;0;0;.00nan;0;0
8379;187699;114;75;39;4;35;.897;3562000;0
8379;188888;116;62;23;2;21;.913;3600000;0
8379;183775;114;0;0;0;0;.00nan;0;0
8379;185812;116;0;0;0;0;.00nan;0;0
8380;187537;117;60;39;4;35;.897;3529000;0
8380;184533;117;0;0;0;0;.00nan;0;0
8380;185775;123;61;25;2;23;.920;3600000;0
8380;191125;123;0;0;0;0;.00nan;0;0
8381;187550;111;0;0;0;0;.00nan;0;0
8381;-1;111;92;46;3;43;.935;3766000;0
8381;-1;113;0;0;0;0;.00nan;0;0
8381;191709;113;73;31;2;29;.935;3766000;0
8382;192776;119;64;31;3;28;.903;3641000;0
8382;195017;119;0;0;0;0;.00nan;0;0
8382;-1;110;0;0;0;0;.00nan;0;0
8382;186527;110;66;27;4;23;.852;3641000;0
8383;195089;124;99;40;1;39;.975;3600000;0
8383;179350;125;66;27;3;24;.889;3600000;0
8383;-1;124;0;0;0;0;.00nan;0;0
8383;191813;125;0;0;0;0;.00nan;0;0
8384;182305;109;57;34;4;30;.882;3900000;0
8384;186580;127;54;34;4;30;.882;3900000;0
8384;191171;127;0;0;0;0;.00nan;0;0
8384;197038;109;0;0;0;0;.00nan;0;0
8385;192776;119;10;10;5;5;.500;1899000;0
8385;189008;108;0;0;0;0;.00nan;0;0
8385;195017;119;1;17;7;10;.588;1701000;0
8385;196372;108;51;36;5;31;.861;3600000;0
8386;187550;111;0;0;0;0;.00nan;0;0
8386;183693;115;63;21;2;19;.905;3600000;0
8386;-1;111;51;36;5;31;.861;3600000;0
8386;186450;115;0;0;0;0;.00nan;0;0
8387;195089;124;0;0;0;0;.00nan;0;0
8387;179350;125;0;0;0;0;.00nan;0;0
8387;-1;124;44;22;4;18;.818;3600000;0
8387;191813;125;57;35;5;30;.857;3600000;0
8388;184932;122;0;0;0;0;.00nan;0;0
8388;186520;122;38;36;7;29;.806;3600000;0
8388;186572;121;65;30;3;27;.900;3600000;0
8388;192645;121;0;0;0;0;.00nan;0;0
8389;187699;114;61;37;4;33;.892;3600000;0
8389;183775;114;0;0;0;0;.00nan;0;0
8389;185775;123;0;0;0;0;.00nan;0;0
8389;191125;123;86;28;1;27;.964;3600000;0
8390;183698;126;0;0;0;0;.00nan;0;0
8390;188918;112;0;0;0;0;.00nan;0;0
8390;180731;126;75;37;4;33;.892;3900000;0
8390;202246;112;46;26;4;22;.846;3900000;0
8391;183755;120;54;23;3;20;.870;3600000;0
8391;189734;120;0;0;0;0;.00nan;0;0
8391;184563;118;34;41;7;34;.829;3600000;0
8391;191026;118;0;0;0;0;.00nan;0;0
8392;182305;109;0;0;0;0;.00nan;0;0
8392;189008;108;54;31;4;27;.871;3600000;0
8392;196372;108;0;0;0;0;.00nan;0;0
8392;197038;109;93;20;0;20;1.000;3600000;0
8393;179350;125;100;48;2;46;.958;3600000;0
8393;186572;121;41;4;1;3;.750;411000;0
8393;191813;125;0;0;0;0;.00nan;0;0
8393;192645;121;29;33;6;27;.818;3189000;0
8394;183755;120;0;0;0;0;.00nan;0;0
8394;189734;120;59;19;2;17;.895;3600000;0
8394;186580;127;0;0;0;0;.00nan;0;0
8394;191171;127;37;49;8;41;.837;3600000;0
8395;187699;114;0;0;0;0;.00nan;0;0
8395;188918;112;61;41;5;36;.878;3561000;0
8395;183775;114;58;31;4;27;.871;3600000;0
8395;202246;112;0;0;0;0;.00nan;0;0
8396;188888;116;57;26;3;23;.885;3600000;0
8396;-1;113;62;11;0;11;1.000;1050000;0
8396;185812;116;0;0;0;0;.00nan;0;0
8396;191709;113;2;17;7;10;.588;2550000;0
8397;192776;119;58;28;4;24;.857;3900000;0
8397;187550;111;0;0;0;0;.00nan;0;0
8397;195017;119;0;0;0;0;.00nan;0;0
8397;-1;111;62;35;4;31;.886;3900000;0
8398;187537;117;100;45;1;44;.978;3636000;0
8398;184533;117;0;0;0;0;.00nan;0;0
8398;-1;113;67;22;2;20;.909;3636000;0
8398;191709;113;0;0;0;0;.00nan;0;0
8399;184563;118;48;38;6;32;.842;3592000;0
8399;191026;118;0;0;0;0;.00nan;0;0
8399;186580;127;52;36;5;31;.861;3328000;0
8399;191171;127;57;4;0;4;1.000;272000;0
8400;189008;108;40;3;1;2;.667;914000;0
8400;184932;122;0;0;0;0;.00nan;0;0
8400;196372;108;15;27;7;20;.741;2686000;0
8400;186520;122;77;38;4;34;.895;3600000;0
8401;183698;126;0;0;0;0;.00nan;0;0
8401;180731;126;64;40;5;35;.875;3600000;0
8401;185775;123;29;30;6;24;.800;3202000;0
8401;191125;123;50;1;0;1;1.000;398000;0
8402;183693;115;79;23;2;21;.913;3600000;0
8402;195089;124;39;32;6;26;.813;3600000;0
8402;-1;124;0;0;0;0;.00nan;0;0
8402;186450;115;0;0;0;0;.00nan;0;0
8403;183755;120;100;28;0;28;1.000;3600000;0
8403;189734;120;0;0;0;0;.00nan;0;0
8403;-1;110;0;0;0;0;.00nan;0;0
8403;186527;110;42;35;6;29;.829;3600000;0
8404;187550;111;0;0;0;0;.00nan;0;0
8404;188918;112;0;0;0;0;.00nan;0;0
8404;202246;112;72;24;1;23;.958;3600000;0
8404;-1;111;55;37;5;32;.865;3600000;0
8405;188888;116;75;24;1;23;.958;3600000;0
8405;-1;110;0;0;0;0;.00nan;0;0
8405;185812;116;0;0;0;0;.00nan;0;0
8405;186527;110;72;38;3;35;.921;3527000;0
8406;182305;109;53;10;1;9;.900;1352000;0
8406;183693;115;82;14;0;14;1.000;3600000;0
8406;186450;115;0;0;0;0;.00nan;0;0
8406;197038;109;24;19;5;14;.737;2248000;0
8407;184563;118;37;16;3;13;.813;2429000;0
8407;191026;118;28;13;4;9;.692;1171000;0
8407;186572;121;63;26;3;23;.885;3600000;0
8407;192645;121;0;0;0;0;.00nan;0;0
8408;179350;125;58;39;5;34;.872;3561000;0
8408;186580;127;0;0;0;0;.00nan;0;0
8408;191171;127;62;28;3;25;.893;3600000;0
8408;191813;125;0;0;0;0;.00nan;0;0
8409;183755;120;30;35;6;29;.829;3600000;0
8409;189734;120;0;0;0;0;.00nan;0;0
8409;184932;122;0;0;0;0;.00nan;0;0
8409;186520;122;75;32;2;30;.938;3600000;0
8410;187699;114;58;7;0;7;1.000;995000;0
8410;183698;126;0;0;0;0;.00nan;0;0
8410;183775;114;24;24;6;18;.750;2605000;0
8410;180731;126;93;36;2;34;.944;3600000;0
8411;188888;116;74;42;4;38;.905;3562000;0
8411;183693;115;61;22;3;19;.864;3600000;0
8411;185812;116;0;0;0;0;.00nan;0;0
8411;186450;115;0;0;0;0;.00nan;0;0
8412;187537;117;79;22;1;21;.955;3600000;0
8412;195089;124;0;0;0;0;.00nan;0;0
8412;184533;117;0;0;0;0;.00nan;0;0
8412;-1;124;54;27;3;24;.889;3600000;0
8413;187550;111;0;0;0;0;.00nan;0;0
8413;-1;110;0;0;0;0;.00nan;0;0
8413;-1;111;78;40;3;37;.925;3550000;0
8413;186527;110;85;38;2;36;.947;3600000;0
8414;182305;109;76;32;2;30;.938;3600000;0
8414;188918;112;0;0;0;0;.00nan;0;0
8414;202246;112;46;37;6;31;.838;3600000;0
8414;197038;109;0;0;0;0;.00nan;0;0
8415;187550;111;64;34;3;31;.912;3600000;0
8415;-1;111;0;0;0;0;.00nan;0;0
8415;-1;113;0;0;0;0;.00nan;0;0
8415;191709;113;45;27;4;23;.852;3558000;0
8416;179350;125;100;24;0;24;1.000;3600000;0
8416;184932;122;0;0;0;0;.00nan;0;0
8416;186520;122;68;20;1;19;.950;3572000;0
8416;191813;125;0;0;0;0;.00nan;0;0
8417;185775;123;0;0;0;0;.00nan;0;0
8417;186572;121;0;0;0;0;.00nan;0;0
8417;191125;123;54;26;3;23;.885;3545000;0
8417;192645;121;86;32;1;31;.969;3600000;0
8418;187699;114;70;27;2;25;.926;3600000;0
8418;183775;114;0;0;0;0;.00nan;0;0
8418;195089;124;67;42;5;37;.881;3600000;0
8418;-1;124;0;0;0;0;.00nan;0;0
8419;189008;108;0;0;0;0;.00nan;0;0
8419;196372;108;58;25;3;22;.880;3546000;0
8419;186580;127;89;31;2;29;.935;3600000;0
8419;191171;127;0;0;0;0;.00nan;0;0
8420;183698;126;0;0;0;0;.00nan;0;0
8420;184563;118;100;54;2;52;.963;3700000;0
8420;180731;126;40;14;3;11;.786;3700000;0
8420;191026;118;0;0;0;0;.00nan;0;0
8421;184932;122;0;0;0;0;.00nan;0;0
8421;186520;122;61;43;4;39;.907;3565000;0
8421;186572;121;60;19;2;17;.895;3600000;0
8421;192645;121;0;0;0;0;.00nan;0;0
8422;189008;108;22;25;6;19;.760;2641000;0
8422;179350;125;96;27;1;26;.963;3600000;0
8422;196372;108;65;10;0;10;1.000;959000;0
8422;191813;125;0;0;0;0;.00nan;0;0
8423;192776;119;69;50;5;45;.900;3539000;0
8423;183755;120;83;35;3;32;.914;3600000;0
8423;195017;119;0;0;0;0;.00nan;0;0
8423;189734;120;0;0;0;0;.00nan;0;0
8424;-1;110;0;0;0;0;.00nan;0;0
8424;-1;113;62;27;3;24;.889;3600000;0
8424;186527;110;66;47;6;41;.872;3600000;0
8424;191709;113;0;0;0;0;.00nan;0;0
8425;184563;118;45;25;4;21;.840;2992000;0
8425;191026;118;19;10;4;6;.600;608000;0
8425;186580;127;0;0;0;0;.00nan;0;0
8425;191171;127;46;21;3;18;.857;3600000;0
8426;183698;126;5;13;6;7;.538;1569000;0
8426;195089;124;0;0;0;0;.00nan;0;0
8426;180731;126;45;24;4;20;.833;2031000;0
8426;-1;124;36;36;6;30;.833;3600000;0
8427;187537;117;75;40;4;36;.900;3600000;0
8427;188888;116;0;0;0;0;.00nan;0;0
8427;184533;117;0;0;0;0;.00nan;0;0
8427;185812;116;95;29;1;28;.966;3600000;0
8428;187550;111;0;0;0;0;.00nan;0;0
8428;183693;115;75;26;2;24;.923;3600000;0
8428;-1;111;73;35;4;31;.886;3580000;0
8428;186450;115;0;0;0;0;.00nan;0;0
8429;187537;117;0;0;0;0;.00nan;0;0
8429;187699;114;57;5;0;5;1.000;715000;0
8429;183775;114;20;30;7;23;.767;2885000;0
8429;184533;117;77;32;4;28;.875;3600000;0
8430;189008;108;0;0;0;0;.00nan;0;0
8430;196372;108;76;47;4;43;.915;3585000;0
8430;185775;123;56;14;2;12;.857;3600000;0
8430;191125;123;0;0;0;0;.00nan;0;0
8431;182305;109;87;21;0;21;1.000;3600000;0
8431;-1;110;93;35;2;33;.943;3595000;0
8431;186527;110;0;0;0;0;.00nan;0;0
8431;197038;109;0;0;0;0;.00nan;0;0
8432;192776;119;0;0;0;0;.00nan;0;0
8432;183755;120;0;0;0;0;.00nan;0;0
8432;195017;119;51;38;5;33;.868;3900000;0
8432;189734;120;36;26;5;21;.808;3898000;0
8433;188888;116;52;26;3;23;.885;3900000;0
8433;188918;112;62;31;3;28;.903;3900000;0
8433;202246;112;0;0;0;0;.00nan;0;0
8433;185812;116;0;0;0;0;.00nan;0;0
8434;187550;111;0;0;0;0;.00nan;0;0
8434;188888;116;66;22;2;20;.909;3600000;0
8434;-1;111;51;31;4;27;.871;3516000;0
8434;185812;116;0;0;0;0;.00nan;0;0
8435;183693;115;77;18;1;17;.944;3600000;0
8435;188918;112;49;45;6;39;.867;3600000;0
8435;202246;112;0;0;0;0;.00nan;0;0
8435;186450;115;0;0;0;0;.00nan;0;0
8436;183698;126;0;0;0;0;.00nan;0;0
8436;179350;125;81;34;2;32;.941;3600000;0
8436;180731;126;51;23;4;19;.826;3514000;0
8436;191813;125;0;0;0;0;.00nan;0;0
8437;192776;119;55;46;6;40;.870;3257000;0
8437;195017;119;50;10;1;9;.900;343000;0
8437;186572;121;70;9;0;9;1.000;1768000;0
8437;192645;121;32;13;4;9;.692;1832000;0
8438;189008;108;67;39;4;35;.897;2997000;0
8438;196372;108;29;10;3;7;.700;603000;0
8438;-1;110;0;0;0;0;.00nan;0;0
8438;186527;110;57;25;3;22;.880;3600000;0
8439;183693;115;41;23;4;19;.826;3596000;0
8439;185775;123;66;32;3;29;.906;3600000;0
8439;186450;115;0;0;0;0;.00nan;0;0
8439;191125;123;0;0;0;0;.00nan;0;0
8440;187550;111;0;0;0;0;.00nan;0;0
8440;188888;116;0;0;0;0;.00nan;0;0
8440;-1;111;98;44;2;42;.955;3900000;0
8440;185812;116;56;20;2;18;.900;3900000;0
8441;182305;109;71;40;3;37;.925;3600000;0
8441;187537;117;56;39;6;33;.846;3600000;0
8441;184533;117;0;0;0;0;.00nan;0;0
8441;197038;109;0;0;0;0;.00nan;0;0
8442;192776;119;50;40;6;34;.850;3259000;0
8442;195017;119;58;3;0;3;1.000;341000;0
8442;-1;113;0;0;0;0;.00nan;0;0
8442;191709;113;63;25;2;23;.920;3600000;0
8443;195089;124;87;36;2;34;.944;3600000;0
8443;184563;118;72;43;4;39;.907;3558000;0
8443;-1;124;0;0;0;0;.00nan;0;0
8443;191026;118;0;0;0;0;.00nan;0;0
8444;189008;108;85;41;2;39;.951;3600000;0
8444;196372;108;0;0;0;0;.00nan;0;0
8444;-1;110;0;0;0;0;.00nan;0;0
8444;186527;110;65;31;3;28;.903;3600000;0
8445;183693;115;50;7;1;6;.857;1572000;0
8445;-1;113;78;25;2;23;.920;3600000;0
8445;186450;115;16;27;6;21;.778;2028000;0
8445;191709;113;0;0;0;0;.00nan;0;0
8446;183755;120;80;42;4;38;.905;3568000;0
8446;189734;120;0;0;0;0;.00nan;0;0
8446;184932;122;0;0;0;0;.00nan;0;0
8446;186520;122;53;18;3;15;.833;3600000;0
8447;183698;126;0;0;0;0;.00nan;0;0
8447;180731;126;71;39;4;35;.897;3600000;0
8447;186572;121;42;32;5;27;.844;3550000;0
8447;192645;121;0;0;0;0;.00nan;0;0
8448;187699;114;75;63;7;56;.889;3600000;0
8448;188918;112;0;0;0;0;.00nan;0;0
8448;183775;114;0;0;0;0;.00nan;0;0
8448;202246;112;68;30;2;28;.933;3600000;0
8449;179350;125;88;40;3;37;.925;3900000;0
8449;185775;123;0;0;0;0;.00nan;0;0
8449;191125;123;61;27;3;24;.889;3900000;0
8449;191813;125;0;0;0;0;.00nan;0;0
8450;184563;118;99;33;0;33;1.000;3547000;0
8450;191026;118;18;6;4;2;.333;353000;0
8450;186580;127;49;31;4;27;.871;3900000;0
8450;191171;127;0;0;0;0;.00nan;0;0
8451;182305;109;49;21;3;18;.857;3562000;0
8451;187550;111;0;0;0;0;.00nan;0;0
8451;-1;111;78;32;2;30;.938;3600000;0
8451;197038;109;0;0;0;0;.00nan;0;0
8452;195089;124;0;0;0;0;.00nan;0;0
8452;179350;125;62;46;6;40;.870;3600000;0
8452;-1;124;92;21;0;21;1.000;3600000;0
8452;191813;125;0;0;0;0;.00nan;0;0
8453;192776;119;0;0;0;0;.00nan;0;0
8453;195017;119;50;23;3;20;.870;3600000;0
8453;186580;127;0;0;0;0;.00nan;0;0
8453;191171;127;39;30;5;25;.833;3569000;0
8454;183698;126;0;0;0;0;.00nan;0;0
8454;183755;120;0;0;0;0;.00nan;0;0
8454;189734;120;40;35;6;29;.829;3659000;0
8454;180731;126;49;35;5;30;.857;3659000;0
8455;187537;117;68;26;3;23;.885;3600000;0
8455;184533;117;0;0;0;0;.00nan;0;0
8455;-1;110;27;9;3;6;.667;497000;0
8455;186527;110;87;32;1;31;.969;3051000;0
8456;187699;114;0;0;0;0;.00nan;0;0
8456;188888;116;60;17;1;16;.941;3600000;0
8456;183775;114;79;44;5;39;.886;3600000;0
8456;185812;116;0;0;0;0;.00nan;0;0
8457;182305;109;0;0;0;0;.00nan;0;0
8457;183693;115;73;28;3;25;.893;3600000;0
8457;186450;115;0;0;0;0;.00nan;0;0
8457;197038;109;95;39;2;37;.949;3600000;0
8458;187537;117;88;25;1;24;.960;3600000;0
8458;189008;108;0;0;0;0;.00nan;0;0
8458;184533;117;0;0;0;0;.00nan;0;0
8458;196372;108;97;49;3;46;.939;3600000;0
8459;188888;116;0;0;0;0;.00nan;0;0
8459;-1;113;0;0;0;0;.00nan;0;0
8459;185812;116;87;41;2;39;.951;3600000;0
8459;191709;113;73;26;1;25;.962;3600000;0
8460;184563;118;67;41;4;37;.902;3600000;0
8460;184932;122;0;0;0;0;.00nan;0;0
8460;191026;118;0;0;0;0;.00nan;0;0
8460;186520;122;73;20;1;19;.950;3600000;0
8461;187699;114;97;48;3;45;.938;3600000;0
8461;183755;120;77;26;2;24;.923;3600000;0
8461;183775;114;0;0;0;0;.00nan;0;0
8461;189734;120;0;0;0;0;.00nan;0;0
8462;195089;124;0;0;0;0;.00nan;0;0
8462;-1;124;79;38;4;34;.895;3863000;0
8462;186572;121;0;0;0;0;.00nan;0;0
8462;192645;121;62;28;3;25;.893;3863000;0
8463;188918;112;58;39;5;34;.872;3555000;0
8463;202246;112;0;0;0;0;.00nan;0;0
8463;185775;123;28;15;4;11;.733;3600000;0
8463;191125;123;0;0;0;0;.00nan;0;0
8464;184563;118;53;42;5;37;.881;3536000;0
8464;184932;122;0;0;0;0;.00nan;0;0
8464;191026;118;0;0;0;0;.00nan;0;0
8464;186520;122;51;18;3;15;.833;3600000;0
8465;182305;109;83;33;2;31;.939;3900000;0
8465;-1;113;0;0;0;0;.00nan;0;0
8465;197038;109;0;0;0;0;.00nan;0;0
8465;191709;113;65;21;2;19;.905;3900000;0
8466;187537;117;75;34;3;31;.912;3600000;0
8466;188888;116;33;27;5;22;.815;3569000;0
8466;184533;117;0;0;0;0;.00nan;0;0
8466;185812;116;0;0;0;0;.00nan;0;0
8467;192776;119;31;27;5;22;.815;3529000;0
8467;195017;119;0;0;0;0;.00nan;0;0
8467;179350;125;65;29;4;25;.862;3600000;0
8467;191813;125;0;0;0;0;.00nan;0;0
8468;183698;126;0;0;0;0;.00nan;0;0
8468;180731;126;91;34;2;32;.941;3600000;0
8468;185775;123;82;33;1;32;.970;3600000;0
8468;191125;123;0;0;0;0;.00nan;0;0
8469;183693;115;34;27;5;22;.815;3525000;0
8469;-1;113;79;36;3;33;.917;3600000;0
8469;186450;115;0;0;0;0;.00nan;0;0
8469;191709;113;0;0;0;0;.00nan;0;0
8470;183755;120;66;25;2;23;.920;3600000;0
8470;189734;120;0;0;0;0;.00nan;0;0
8470;184563;118;0;0;0;0;.00nan;0;0
8470;191026;118;44;39;6;33;.846;3600000;0
8471;187550;111;0;0;0;0;.00nan;0;0
8471;-1;110;0;0;0;0;.00nan;0;0
8471;-1;111;80;26;2;24;.923;3600000;0
8471;186527;110;37;24;4;20;.833;3600000;0
8472;192776;119;0;0;0;0;.00nan;0;0
8472;195017;119;55;40;5;35;.875;3600000;0
8472;195089;124;73;30;2;28;.933;3600000;0
8472;-1;124;0;0;0;0;.00nan;0;0
8473;187550;111;42;30;5;25;.833;3600000;0
8473;189008;108;53;25;4;21;.840;3600000;0
8473;196372;108;0;0;0;0;.00nan;0;0
8473;-1;111;0;0;0;0;.00nan;0;0
8474;187537;117;84;50;5;45;.900;3600000;0
8474;183693;115;86;15;0;15;1.000;3600000;0
8474;184533;117;0;0;0;0;.00nan;0;0
8474;186450;115;0;0;0;0;.00nan;0;0
8475;188918;112;0;0;0;0;.00nan;0;0
8475;184932;122;42;20;4;16;.800;3600000;0
8475;202246;112;50;37;5;32;.865;3548000;0
8475;186520;122;0;0;0;0;.00nan;0;0
8476;195089;124;0;0;0;0;.00nan;0;0
8476;-1;124;82;48;4;44;.917;3894000;0
8476;186572;121;48;24;5;19;.792;3894000;0
8476;192645;121;0;0;0;0;.00nan;0;0
8477;187699;114;56;28;4;24;.857;3600000;0
8477;188888;116;49;34;5;29;.853;3591000;0
8477;183775;114;0;0;0;0;.00nan;0;0
8477;185812;116;0;0;0;0;.00nan;0;0
8478;185775;123;0;0;0;0;.00nan;0;0
8478;186580;127;19;9;4;5;.556;461000;0
8478;191125;123;58;30;5;25;.833;3600000;0
8478;191171;127;8;30;9;21;.700;3139000;0
8479;183698;126;0;0;0;0;.00nan;0;0
8479;179350;125;71;15;1;14;.933;3600000;0
8479;180731;126;64;29;3;26;.897;3588000;0
8479;191813;125;0;0;0;0;.00nan;0;0
8480;183755;120;82;28;2;26;.929;3820000;0
8480;189734;120;0;0;0;0;.00nan;0;0
8480;184563;118;92;46;3;43;.935;3784000;0
8480;191026;118;0;0;0;0;.00nan;0;0
8481;182305;109;47;24;4;20;.833;3600000;0
8481;189008;108;24;15;4;11;.733;1065000;0
8481;196372;108;17;28;7;21;.750;2535000;0
8481;197038;109;0;0;0;0;.00nan;0;0
8482;187699;114;0;0;0;0;.00nan;0;0
8482;183775;114;48;38;6;32;.842;3600000;0
8482;-1;113;0;0;0;0;.00nan;0;0
8482;191709;113;94;37;2;35;.946;3600000;0
8483;179350;125;54;4;0;4;1.000;395000;0
8483;185775;123;67;20;1;19;.950;3600000;0
8483;191125;123;0;0;0;0;.00nan;0;0
8483;191813;125;62;40;4;36;.900;3205000;0
8484;192776;119;76;23;1;22;.957;3600000;0
8484;195017;119;0;0;0;0;.00nan;0;0
8484;184932;122;0;0;0;0;.00nan;0;0
8484;186520;122;61;23;2;21;.913;3557000;0
8485;195089;124;39;36;6;30;.833;3024000;0
8485;-1;124;56;9;1;8;.889;576000;0
8485;186580;127;100;38;0;38;1.000;3600000;0
8485;191171;127;0;0;0;0;.00nan;0;0
8486;188888;116;0;0;0;0;.00nan;0;0
8486;-1;110;0;0;0;0;.00nan;0;0
8486;185812;116;51;35;5;30;.857;3600000;0
8486;186527;110;96;22;0;22;1.000;3600000;0
8487;182305;109;0;0;0;0;.00nan;0;0
8487;187550;111;0;0;0;0;.00nan;0;0
8487;-1;111;64;31;3;28;.903;3568000;0
8487;197038;109;61;27;2;25;.926;3600000;0
8488;187537;117;73;25;2;23;.920;3600000;0
8488;184533;117;0;0;0;0;.00nan;0;0
8488;-1;110;0;0;0;0;.00nan;0;0
8488;186527;110;21;37;7;30;.811;3600000;0
8489;183698;126;0;0;0;0;.00nan;0;0
8489;180731;126;70;29;3;26;.897;3900000;0
8489;186580;127;61;30;3;27;.900;3900000;0
8489;191171;127;0;0;0;0;.00nan;0;0
8490;184563;118;0;0;0;0;.00nan;0;0
8490;191026;118;83;41;3;38;.927;3551000;0
8490;186572;121;0;0;0;0;.00nan;0;0
8490;192645;121;53;17;2;15;.882;3600000;0
8491;187699;114;38;31;6;25;.806;3600000;0
8491;188918;112;0;0;0;0;.00nan;0;0
8491;183775;114;0;0;0;0;.00nan;0;0
8491;202246;112;87;52;5;47;.904;3600000;0
8493;179350;125;65;28;3;25;.893;3900000;0
8493;185775;123;46;21;3;18;.857;3900000;0
8493;191125;123;0;0;0;0;.00nan;0;0
8493;191813;125;0;0;0;0;.00nan;0;0
8495;183693;127;85;29;2;27;.931;3900000;0
8495;189008;108;0;0;0;0;.00nan;0;0
8495;196372;108;72;29;2;27;.931;3900000;0
8495;186580;127;0;0;0;0;.00nan;0;0
8497;183698;126;0;0;0;0;.00nan;0;0
8497;184563;118;97;25;0;25;1.000;3600000;0
8497;180731;126;31;31;6;25;.806;3600000;0
8497;191026;118;0;0;0;0;.00nan;0;0
8499;187537;117;20;24;6;18;.750;2301000;0
8499;195089;124;0;0;0;0;.00nan;0;0
8499;184533;117;60;14;1;13;.929;1291000;0
8499;-1;124;48;29;5;24;.828;3600000;0
8501;184932;122;0;0;0;0;.00nan;0;0
8501;-1;113;0;0;0;0;.00nan;0;0
8501;186520;122;59;34;4;30;.882;3600000;0
8501;191709;113;28;24;5;19;.792;3569000;0
8503;188888;116;38;37;6;31;.838;3600000;0
8503;-1;110;0;0;0;0;.00nan;0;0
8503;185812;116;0;0;0;0;.00nan;0;0
8503;186527;110;56;28;3;25;.893;3600000;0
8505;192776;119;79;26;1;25;.962;3600000;0
8505;188918;112;0;0;0;0;.00nan;0;0
8505;195017;119;0;0;0;0;.00nan;0;0
8505;202246;112;42;29;5;24;.828;3600000;0
8507;182305;109;0;0;0;0;.00nan;0;0
8507;183755;120;29;28;6;22;.786;3600000;0
8507;189734;120;0;0;0;0;.00nan;0;0
8507;197038;109;89;22;1;21;.955;3600000;0
8509;187699;114;53;10;1;9;.900;1083000;0
8509;183775;114;31;30;6;24;.800;2517000;0
8509;186572;121;61;24;3;21;.875;3600000;0
8509;192645;121;0;0;0;0;.00nan;0;0
8511;187550;111;39;28;5;23;.821;3567000;0
8511;-1;111;0;0;0;0;.00nan;0;0
8511;186450;115;60;30;4;26;.867;3600000;0
8511;191698;115;0;0;0;0;.00nan;0;0
8513;195089;124;45;26;4;22;.846;3572000;0
8513;-1;124;0;0;0;0;.00nan;0;0
8513;185775;123;0;0;0;0;.00nan;0;0
8513;191125;123;53;25;3;22;.880;3600000;0
8515;182305;109;76;32;2;30;.938;3600000;0
8515;183755;120;0;0;0;0;.00nan;0;0
8515;189734;120;60;24;3;21;.875;3583000;0
8515;197038;109;0;0;0;0;.00nan;0;0
8517;183693;127;0;0;0;0;.00nan;0;0
8517;186450;115;0;0;0;0;.00nan;0;0
8517;186580;127;58;18;2;16;.889;3600000;0
8517;191698;115;56;46;5;41;.891;3600000;0
8519;179350;125;0;0;0;0;.00nan;0;0
8519;184932;122;61;22;2;20;.909;3528000;0
8519;186520;122;0;0;0;0;.00nan;0;0
8519;191813;125;100;35;0;35;1.000;3600000;0
8521;189008;108;32;17;4;13;.765;1309000;0
8521;196372;108;35;30;6;24;.800;2291000;0
8521;186572;121;0;0;0;0;.00nan;0;0
8521;192645;121;50;20;4;16;.800;3600000;0
8523;187550;111;0;0;0;0;.00nan;0;0
8523;-1;111;42;33;5;28;.848;3600000;0
8523;-1;113;46;37;6;31;.838;3600000;0
8523;191709;113;0;0;0;0;.00nan;0;0
8525;187699;114;91;28;1;27;.964;3600000;0
8525;183775;114;0;0;0;0;.00nan;0;0
8525;184563;118;90;42;2;40;.952;3600000;0
8525;191026;118;0;0;0;0;.00nan;0;0
8527;192776;119;0;0;0;0;.00nan;0;0
8527;195017;119;32;31;6;25;.806;3796000;0
8527;-1;110;43;29;5;24;.828;3796000;0
8527;186527;110;0;0;0;0;.00nan;0;0
8529;183698;126;42;19;4;15;.789;3629000;0
8529;188918;112;86;43;3;40;.930;3629000;0
8529;180731;126;0;0;0;0;.00nan;0;0
8529;202246;112;0;0;0;0;.00nan;0;0
8531;187537;117;34;26;5;21;.808;3548000;0
8531;188888;116;0;0;0;0;.00nan;0;0
8531;184533;117;0;0;0;0;.00nan;0;0
8531;185812;116;60;32;4;28;.875;3600000;0
8533;183698;126;0;0;0;0;.00nan;0;0
8533;180731;126;70;31;3;28;.903;3609000;0
8533;-1;110;0;0;0;0;.00nan;0;0
8533;186527;110;69;36;4;32;.889;3609000;0
8535;187699;114;0;0;0;0;.00nan;0;0
8535;183755;120;70;29;3;26;.897;3600000;0
8535;183775;114;59;30;4;26;.867;3550000;0
8535;189734;120;0;0;0;0;.00nan;0;0
8537;189008;108;61;4;0;4;1.000;725000;0
8537;196372;108;20;29;6;23;.793;2875000;0
8537;185775;123;70;32;3;29;.906;3600000;0
8537;191125;123;0;0;0;0;.00nan;0;0
8539;187550;111;0;0;0;0;.00nan;0;0
8539;-1;111;46;27;4;23;.852;3600000;0
8539;186572;121;58;21;3;18;.857;3600000;0
8539;192645;121;0;0;0;0;.00nan;0;0
8541;183693;127;38;31;5;26;.839;3579000;0
8541;-1;113;0;0;0;0;.00nan;0;0
8541;186580;127;0;0;0;0;.00nan;0;0
8541;191709;113;39;20;4;16;.800;3600000;0
8543;182305;109;23;18;5;13;.722;1994000;0
8543;186450;115;45;23;4;19;.826;3600000;0
8543;197038;109;30;12;3;9;.750;1606000;0
8543;191698;115;0;0;0;0;.00nan;0;0
8545;192776;119;29;22;5;17;.773;3547000;0
8545;188918;112;0;0;0;0;.00nan;0;0
8545;195017;119;0;0;0;0;.00nan;0;0
8545;202246;112;76;37;3;34;.919;3600000;0
8547;184563;118;11;22;7;15;.682;2405000;0
8547;179350;125;0;0;0;0;.00nan;0;0
8547;191026;118;35;19;4;15;.789;1195000;0
8547;191813;125;57;21;2;19;.905;3600000;0
8549;187537;117;61;42;4;38;.905;3566000;0
8549;188888;116;59;22;2;20;.909;3600000;0
8549;184533;117;0;0;0;0;.00nan;0;0
8549;185812;116;0;0;0;0;.00nan;0;0
8551;195089;124;0;0;0;0;.00nan;0;0
8551;184932;122;0;0;0;0;.00nan;0;0
8551;-1;124;53;20;3;17;.850;3600000;0
8551;186520;122;61;40;4;36;.900;3581000;0
8553;188918;112;68;31;3;28;.903;3600000;0
8553;184932;122;56;30;4;26;.867;3568000;0
8553;202246;112;0;0;0;0;.00nan;0;0
8553;186520;122;0;0;0;0;.00nan;0;0
8555;187537;117;0;0;0;0;.00nan;0;0
8555;195089;124;37;33;5;28;.848;3588000;0
8555;184533;117;75;36;3;33;.917;3600000;0
8555;-1;124;0;0;0;0;.00nan;0;0
8557;179350;125;39;35;6;29;.829;3600000;0
8557;186450;115;0;0;0;0;.00nan;0;0
8557;191698;115;82;31;1;30;.968;3600000;0
8557;191813;125;0;0;0;0;.00nan;0;0
8559;187550;111;25;30;7;23;.767;3211000;0
8559;183698;126;67;23;2;21;.913;3600000;0
8559;180731;126;0;0;0;0;.00nan;0;0
8559;-1;111;50;2;0;2;1.000;389000;0
8561;189008;108;99;38;1;37;.974;3600000;0
8561;196372;108;0;0;0;0;.00nan;0;0
8561;-1;110;21;8;4;4;.500;822000;0
8561;186527;110;78;19;0;19;1.000;2778000;0
8563;183755;120;0;0;0;0;.00nan;0;0
8563;189734;120;73;26;1;25;.962;3600000;0
8563;184563;118;0;0;0;0;.00nan;0;0
8563;191026;118;58;31;4;27;.871;3600000;0
8565;187699;114;62;44;5;39;.886;3600000;0
8565;183775;114;0;0;0;0;.00nan;0;0
8565;186572;121;0;0;0;0;.00nan;0;0
8565;192645;121;68;23;2;21;.913;3600000;0
8567;182305;109;59;24;2;22;.917;3600000;0
8567;192776;119;87;34;1;33;.971;3004000;0
8567;195017;119;27;8;3;5;.625;596000;0
8567;197038;109;0;0;0;0;.00nan;0;0
8569;183693;127;0;0;0;0;.00nan;0;0
8569;-1;113;18;20;6;14;.700;2526000;0
8569;186580;127;85;31;1;30;.968;3600000;0
8569;191709;113;58;10;1;9;.900;1074000;0
8571;188888;116;0;0;0;0;.00nan;0;0
8571;185775;123;0;0;0;0;.00nan;0;0
8571;185812;116;82;44;3;41;.932;3600000;0
8571;191125;123;89;20;0;20;1.000;3600000;0
8573;187550;111;46;28;5;23;.821;3581000;0
8573;188888;116;54;28;4;24;.857;3600000;0
8573;-1;111;0;0;0;0;.00nan;0;0
8573;185812;116;0;0;0;0;.00nan;0;0
8575;179350;125;65;33;3;30;.909;3512000;0
8575;186572;121;64;15;1;14;.933;3600000;0
8575;191813;125;0;0;0;0;.00nan;0;0
8575;192645;121;0;0;0;0;.00nan;0;0
8577;187699;114;0;0;0;0;.00nan;0;0
8577;183775;114;93;47;2;45;.957;3600000;0
8577;-1;113;0;0;0;0;.00nan;0;0
8577;191709;113;55;28;3;25;.893;3545000;0
8579;187537;117;32;17;4;13;.765;3600000;0
8579;195089;124;0;0;0;0;.00nan;0;0
8579;184533;117;0;0;0;0;.00nan;0;0
8579;-1;124;78;28;1;27;.964;3600000;0
8581;192776;119;0;0;0;0;.00nan;0;0
8581;195017;119;45;27;4;23;.852;3600000;0
8581;186450;115;45;13;3;10;.769;3600000;0
8581;191698;115;0;0;0;0;.00nan;0;0
8583;183755;120;49;34;5;29;.853;3600000;0
8583;189734;120;0;0;0;0;.00nan;0;0
8583;185775;123;0;0;0;0;.00nan;0;0
8583;191125;123;50;26;4;22;.846;3600000;0
8585;182305;109;0;0;0;0;.00nan;0;0
8585;-1;110;94;32;1;31;.969;3600000;0
8585;186527;110;0;0;0;0;.00nan;0;0
8585;197038;109;80;35;2;33;.943;3547000;0
8587;183698;126;0;0;0;0;.00nan;0;0
8587;189008;108;79;27;1;26;.963;3600000;0
8587;180731;126;57;21;3;18;.857;3590000;0
8587;196372;108;0;0;0;0;.00nan;0;0
8589;183693;127;93;50;3;47;.940;3900000;0
8589;184932;122;0;0;0;0;.00nan;0;0
8589;186520;122;65;27;3;24;.889;3900000;0
8589;186580;127;0;0;0;0;.00nan;0;0
8591;188918;112;0;0;0;0;.00nan;0;0
8591;184563;118;49;24;3;21;.875;3600000;0
8591;202246;112;91;39;2;37;.949;3600000;0
8591;191026;118;0;0;0;0;.00nan;0;0
8593;183698;126;40;25;5;20;.800;1752000;0
8593;180731;126;32;10;3;7;.700;1848000;0
8593;-1;113;66;32;3;29;.906;3600000;0
8593;191709;113;0;0;0;0;.00nan;0;0
8595;188888;116;0;0;0;0;.00nan;0;0
8595;179350;125;0;0;0;0;.00nan;0;0
8595;185812;116;52;25;4;21;.840;3600000;0
8595;191813;125;92;36;1;35;.972;3600000;0
8597;187550;111;0;0;0;0;.00nan;0;0
8597;188918;112;87;44;3;41;.932;3624000;0
8597;202246;112;0;0;0;0;.00nan;0;0
8597;-1;111;43;18;4;14;.778;3624000;0
8599;192776;119;63;34;4;30;.882;3575000;0
8599;195017;119;0;0;0;0;.00nan;0;0
8599;186450;115;0;0;0;0;.00nan;0;0
8599;191698;115;82;28;3;25;.893;3600000;0
8601;189008;108;0;0;0;0;.00nan;0;0
8601;184563;118;0;0;0;0;.00nan;0;0
8601;196372;108;59;20;2;18;.900;3600000;0
8601;191026;118;45;30;5;25;.833;3600000;0
8603;182305;109;82;26;1;25;.962;3600000;0
8603;184932;122;54;24;3;21;.875;3537000;0
8603;186520;122;0;0;0;0;.00nan;0;0
8603;197038;109;0;0;0;0;.00nan;0;0
8605;187699;114;64;35;4;31;.886;3900000;0
8605;183755;120;0;0;0;0;.00nan;0;0
8605;183775;114;0;0;0;0;.00nan;0;0
8605;189734;120;46;28;4;24;.857;3900000;0
8607;183693;127;0;0;0;0;.00nan;0;0
8607;195089;124;13;23;6;17;.739;2913000;0
8607;-1;124;53;4;0;4;1.000;687000;0
8607;186580;127;65;26;3;23;.885;3600000;0
8609;187537;117;0;0;0;0;.00nan;0;0
8609;184533;117;29;30;6;24;.800;3600000;0
8609;186572;121;0;0;0;0;.00nan;0;0
8609;192645;121;65;25;2;23;.920;3600000;0
8611;-1;110;0;0;0;0;.00nan;0;0
8611;185775;123;40;23;4;19;.826;3600000;0
8611;186527;110;49;35;5;30;.857;3600000;0
8611;191125;123;0;0;0;0;.00nan;0;0
8613;183755;120;47;30;4;26;.867;3744000;0
8613;189734;120;0;0;0;0;.00nan;0;0
8613;184932;122;0;0;0;0;.00nan;0;0
8613;186520;122;44;33;5;28;.848;3744000;0
8615;187550;111;36;29;6;23;.793;3114000;0
8615;-1;111;55;4;0;4;1.000;451000;0
8615;-1;113;0;0;0;0;.00nan;0;0
8615;191709;113;34;23;5;18;.783;3600000;0
8617;187537;117;76;22;1;21;.955;3600000;0
8617;183698;126;0;0;0;0;.00nan;0;0
8617;184533;117;0;0;0;0;.00nan;0;0
8617;180731;126;97;51;4;47;.922;3600000;0
8619;188888;116;93;26;1;25;.962;3600000;0
8619;185775;123;0;0;0;0;.00nan;0;0
8619;185812;116;0;0;0;0;.00nan;0;0
8619;191125;123;43;40;6;34;.850;3600000;0
8621;187699;114;0;0;0;0;.00nan;0;0
8621;183775;114;73;45;5;40;.889;3593000;0
8621;-1;110;49;20;3;17;.850;3600000;0
8621;186527;110;0;0;0;0;.00nan;0;0
8623;188918;112;0;0;0;0;.00nan;0;0
8623;184563;118;72;29;3;26;.897;3600000;0
8623;202246;112;22;33;7;26;.788;3600000;0
8623;191026;118;0;0;0;0;.00nan;0;0
8625;192776;119;64;40;4;36;.900;3600000;0
8625;183693;127;73;21;1;20;.952;3600000;0
8625;195017;119;0;0;0;0;.00nan;0;0
8625;186580;127;0;0;0;0;.00nan;0;0
8627;195089;124;76;27;2;25;.926;3600000;0
8627;179350;125;59;45;5;40;.889;3600000;0
8627;-1;124;0;0;0;0;.00nan;0;0
8627;191813;125;0;0;0;0;.00nan;0;0
8629;182305;109;46;21;4;17;.810;1736000;0
8629;186572;121;16;19;6;13;.684;3112000;0
8629;197038;109;67;25;2;23;.920;2164000;0
8629;192645;121;58;3;0;3;1.000;788000;0
8631;189008;108;86;38;2;36;.947;3559000;0
8631;196372;108;0;0;0;0;.00nan;0;0
8631;186450;115;85;29;1;28;.966;3600000;0
8631;191698;115;0;0;0;0;.00nan;0;0
1749;187699;114;0;0;0;0;.00nan;0;0
1749;183693;115;76;22;2;20;.909;3600000;0
1749;183775;114;80;53;5;48;.906;3600000;0
1749;186450;115;0;0;0;0;.00nan;0;0
1750;182305;109;0;0;0;0;.00nan;0;0
1750;187550;111;0;0;0;0;.00nan;0;0
1750;-1;111;59;23;3;20;.870;3600000;0
1750;197038;109;52;39;6;33;.846;3600000;0
1751;-1;110;88;21;0;21;1.000;1771000;0
1751;-1;113;0;0;0;0;.00nan;0;0
1751;186527;110;5;32;8;24;.750;1829000;0
1751;191709;113;57;24;2;22;.917;3600000;0
1752;187537;117;100;43;2;41;.953;3600000;0
1752;188888;116;50;24;4;20;.833;3542000;0
1752;184533;117;0;0;0;0;.00nan;0;0
1752;185812;116;0;0;0;0;.00nan;0;0
1753;183698;126;0;0;0;0;.00nan;0;0
1753;180731;126;99;52;2;50;.962;3600000;0
1753;186572;121;59;29;3;26;.897;3564000;0
1753;192645;121;0;0;0;0;.00nan;0;0
1754;195089;124;0;0;0;0;.00nan;0;0
1754;-1;124;63;39;5;34;.872;3600000;0
1754;185775;123;70;21;1;20;.952;3600000;0
1754;191125;123;0;0;0;0;.00nan;0;0
1755;183755;120;49;33;5;28;.848;3600000;0
1755;189734;120;0;0;0;0;.00nan;0;0
1755;184932;122;0;0;0;0;.00nan;0;0
1755;186520;122;78;19;1;18;.947;3600000;0
1756;179350;125;79;57;5;52;.912;3686000;0
1756;186580;127;70;34;4;30;.882;3686000;0
1756;191171;127;0;0;0;0;.00nan;0;0
1756;191813;125;0;0;0;0;.00nan;0;0
1757;187699;114;0;0;0;0;.00nan;0;0
1757;183693;115;75;25;2;23;.920;3600000;0
1757;183775;114;41;36;6;30;.833;3600000;0
1757;186450;115;0;0;0;0;.00nan;0;0
1758;182305;109;0;0;0;0;.00nan;0;0
1758;187550;111;0;0;0;0;.00nan;0;0
1758;-1;111;72;27;2;25;.926;3600000;0
1758;197038;109;63;30;3;27;.900;3581000;0
1759;-1;110;0;0;0;0;.00nan;0;0
1759;-1;113;0;0;0;0;.00nan;0;0
1759;186527;110;72;28;2;26;.929;3600000;0
1759;191709;113;64;30;3;27;.900;3549000;0
1760;187537;117;97;51;3;48;.941;3600000;0
1760;188888;116;71;24;2;22;.917;3600000;0
1760;184533;117;0;0;0;0;.00nan;0;0
1760;185812;116;0;0;0;0;.00nan;0;0
1761;183698;126;0;0;0;0;.00nan;0;0
1761;180731;126;96;35;2;33;.943;3600000;0
1761;186572;121;23;28;6;22;.786;3303000;0
1761;192645;121;39;1;1;0;.000;297000;0
1762;195089;124;51;16;2;14;.875;1337000;0
1762;-1;124;57;44;6;38;.864;2263000;0
1762;185775;123;88;24;1;23;.958;3600000;0
1762;191125;123;0;0;0;0;.00nan;0;0
1763;183755;120;62;29;3;26;.897;3555000;0
1763;189734;120;0;0;0;0;.00nan;0;0
1763;184932;122;0;0;0;0;.00nan;0;0
1763;186520;122;94;36;1;35;.972;3600000;0
1764;179350;125;96;37;1;36;.973;3600000;0
1764;186580;127;52;17;2;15;.882;3587000;0
1764;191171;127;0;0;0;0;.00nan;0;0
1764;191813;125;0;0;0;0;.00nan;0;0
1765;187699;114;0;0;0;0;.00nan;0;0
1765;183693;115;59;31;5;26;.839;4044000;0
1765;183775;114;54;30;4;26;.867;4041000;0
1765;186450;115;0;0;0;0;.00nan;0;0
1766;182305;109;0;0;0;0;.00nan;0;0
1766;187550;111;0;0;0;0;.00nan;0;0
1766;-1;111;36;27;5;22;.815;3573000;0
1766;197038;109;93;44;3;41;.932;3600000;0
1767;-1;110;0;0;0;0;.00nan;0;0
1767;-1;113;0;0;0;0;.00nan;0;0
1767;186527;110;75;44;4;40;.909;3933000;0
1767;191709;113;66;34;3;31;.912;3933000;0
1768;187537;117;83;31;1;30;.968;3600000;0
1768;188888;116;64;30;4;26;.867;3600000;0
1768;184533;117;0;0;0;0;.00nan;0;0
1768;185812;116;0;0;0;0;.00nan;0;0
1769;183698;126;0;0;0;0;.00nan;0;0
1769;180731;126;54;38;5;33;.868;3956000;0
1769;186572;121;72;45;6;39;.867;3956000;0
1769;192645;121;0;0;0;0;.00nan;0;0
1770;195089;124;52;28;4;24;.857;2608000;0
1770;-1;124;31;19;4;15;.789;992000;0
1770;185775;123;34;26;5;21;.808;3600000;0
1770;191125;123;0;0;0;0;.00nan;0;0
1771;183755;120;80;48;4;44;.917;3600000;0
1771;189734;120;0;0;0;0;.00nan;0;0
1771;184932;122;0;0;0;0;.00nan;0;0
1771;186520;122;57;24;3;21;.875;3600000;0
1772;179350;125;68;30;3;27;.900;3600000;0
1772;186580;127;45;23;4;19;.826;3600000;0
1772;191171;127;0;0;0;0;.00nan;0;0
1772;191813;125;0;0;0;0;.00nan;0;0
1773;187699;114;0;0;0;0;.00nan;0;0
1773;183693;115;69;26;2;24;.923;3600000;0
1773;183775;114;100;47;1;46;.979;3600000;0
1773;186450;115;0;0;0;0;.00nan;0;0
1774;182305;109;0;0;0;0;.00nan;0;0
1774;187550;111;0;0;0;0;.00nan;0;0
1774;-1;111;75;38;5;33;.868;3554000;0
1774;197038;109;71;30;3;27;.900;3600000;0
1775;-1;110;0;0;0;0;.00nan;0;0
1775;-1;113;0;0;0;0;.00nan;0;0
1775;186527;110;92;42;3;39;.929;3600000;0
1775;191709;113;53;26;4;22;.846;3558000;0
1776;187537;117;78;44;4;40;.909;4016000;0
1776;188888;116;55;29;3;26;.897;4022000;0
1776;184533;117;0;0;0;0;.00nan;0;0
1776;185812;116;0;0;0;0;.00nan;0;0
1777;183698;126;0;0;0;0;.00nan;0;0
1777;180731;126;69;37;4;33;.892;3600000;0
1777;186572;121;72;27;2;25;.926;3600000;0
1777;192645;121;0;0;0;0;.00nan;0;0
1778;195089;124;0;0;0;0;.00nan;0;0
1778;-1;124;45;34;5;29;.853;4427000;0
1778;185775;123;41;34;6;28;.824;4427000;0
1778;191125;123;0;0;0;0;.00nan;0;0
1779;183755;120;94;41;1;40;.976;3600000;0
1779;189734;120;0;0;0;0;.00nan;0;0
1779;184932;122;0;0;0;0;.00nan;0;0
1779;186520;122;24;33;7;26;.788;3600000;0
1780;179350;125;65;35;4;31;.886;3600000;0
1780;186580;127;45;32;6;26;.813;3172000;0
1780;191171;127;58;6;0;6;1.000;428000;0
1780;191813;125;0;0;0;0;.00nan;0;0
1952;187699;114;0;0;0;0;.00nan;0;0
1952;183693;115;57;21;3;18;.857;3600000;0
1952;183775;114;63;40;5;35;.875;3513000;0
1952;186450;115;0;0;0;0;.00nan;0;0
1953;182305;109;0;0;0;0;.00nan;0;0
1953;187550;111;0;0;0;0;.00nan;0;0
1953;-1;111;73;45;4;41;.911;3600000;0
1953;197038;109;47;18;3;15;.833;3600000;0
1954;-1;110;0;0;0;0;.00nan;0;0
1954;-1;113;0;0;0;0;.00nan;0;0
1954;186527;110;59;45;5;40;.889;4390000;0
1954;191709;113;63;46;4;42;.913;4390000;0
1955;187537;117;56;47;7;40;.851;3600000;0
1955;188888;116;60;19;2;17;.895;3600000;0
1955;184533;117;0;0;0;0;.00nan;0;0
1955;185812;116;0;0;0;0;.00nan;0;0
1956;183698;126;0;0;0;0;.00nan;0;0
1956;180731;126;72;31;3;28;.903;3600000;0
1956;186572;121;75;45;5;40;.889;3600000;0
1956;192645;121;0;0;0;0;.00nan;0;0
1957;195089;124;52;3;0;3;1.000;317000;0
1957;-1;124;59;55;7;48;.873;3266000;0
1957;185775;123;35;17;4;13;.765;2246000;0
1957;191125;123;45;5;1;4;.800;1354000;0
1958;183755;120;49;38;6;32;.842;3600000;0
1958;189734;120;0;0;0;0;.00nan;0;0
1958;184932;122;0;0;0;0;.00nan;0;0
1958;186520;122;100;17;0;17;1.000;3600000;0
1959;179350;125;92;31;1;30;.968;3663000;0
1959;186580;127;0;0;0;0;.00nan;0;0
1959;191171;127;66;28;2;26;.929;3663000;0
1959;191813;125;0;0;0;0;.00nan;0;0
2003;187699;114;0;0;0;0;.00nan;0;0
2003;183693;115;76;20;1;19;.950;3600000;0
2003;183775;114;52;33;5;28;.848;3600000;0
2003;186450;115;0;0;0;0;.00nan;0;0
2004;182305;109;0;0;0;0;.00nan;0;0
2004;187550;111;0;0;0;0;.00nan;0;0
2004;-1;111;99;39;1;38;.974;3600000;0
2004;197038;109;40;27;4;23;.852;3600000;0
2005;-1;110;0;0;0;0;.00nan;0;0
2005;-1;113;0;0;0;0;.00nan;0;0
2005;186527;110;39;25;4;21;.840;3539000;0
2005;191709;113;65;26;2;24;.923;3600000;0
2006;187537;117;87;34;2;32;.941;3600000;0
2006;188888;116;52;30;4;26;.867;3527000;0
2006;184533;117;0;0;0;0;.00nan;0;0
2006;185812;116;0;0;0;0;.00nan;0;0
2054;182305;109;0;0;0;0;.00nan;0;0
2054;187550;111;0;0;0;0;.00nan;0;0
2054;-1;111;69;30;3;27;.900;3600000;0
2054;197038;109;71;35;4;31;.886;3600000;0
2055;187537;117;27;42;8;34;.810;3600000;0
2055;188888;116;78;23;1;22;.957;3600000;0
2055;184533;117;0;0;0;0;.00nan;0;0
2055;185812;116;0;0;0;0;.00nan;0;0
2087;187550;111;0;0;0;0;.00nan;0;0
2087;183693;115;60;28;3;25;.893;3600000;0
2087;-1;111;76;45;4;41;.911;3554000;0
2087;186450;115;0;0;0;0;.00nan;0;0
2088;188888;116;94;35;1;34;.971;3600000;0
2088;-1;113;0;0;0;0;.00nan;0;0
2088;185812;116;0;0;0;0;.00nan;0;0
2088;191709;113;53;29;4;25;.862;3600000;0
2089;183698;126;0;0;0;0;.00nan;0;0
2089;180731;126;56;28;3;25;.893;3543000;0
2089;185775;123;0;0;0;0;.00nan;0;0
2089;191125;123;71;27;2;25;.926;3600000;0
2090;179350;125;64;21;2;19;.905;3600000;0
2090;184932;122;0;0;0;0;.00nan;0;0
2090;186520;122;75;47;5;42;.894;3600000;0
2090;191813;125;0;0;0;0;.00nan;0;0
2091;187550;111;0;0;0;0;.00nan;0;0
2091;183693;115;88;29;1;28;.966;3600000;0
2091;-1;111;72;39;3;36;.923;3600000;0
2091;186450;115;0;0;0;0;.00nan;0;0
2092;188888;116;68;27;3;24;.889;3600000;0
2092;-1;113;0;0;0;0;.00nan;0;0
2092;185812;116;0;0;0;0;.00nan;0;0
2092;191709;113;55;28;4;24;.857;3560000;0
2093;183698;126;0;0;0;0;.00nan;0;0
2093;180731;126;69;41;5;36;.878;3600000;0
2093;185775;123;28;20;5;15;.750;3175000;0
2093;191125;123;31;10;3;7;.700;425000;0
2094;179350;125;55;31;5;26;.839;3600000;0
2094;184932;122;0;0;0;0;.00nan;0;0
2094;186520;122;83;28;1;27;.964;3600000;0
2094;191813;125;0;0;0;0;.00nan;0;0
2095;187550;111;0;0;0;0;.00nan;0;0
2095;183693;115;91;17;0;17;1.000;3600000;0
2095;-1;111;53;30;4;26;.867;3600000;0
2095;186450;115;0;0;0;0;.00nan;0;0
2096;188888;116;82;35;2;33;.943;3750000;0
2096;-1;113;0;0;0;0;.00nan;0;0
2096;185812;116;0;0;0;0;.00nan;0;0
2096;191709;113;78;35;3;32;.914;3750000;0
2097;183698;126;59;8;0;8;1.000;504000;0
2097;180731;126;40;34;6;28;.824;3070000;0
2097;185775;123;30;24;5;19;.792;3600000;0
2097;191125;123;0;0;0;0;.00nan;0;0
2098;179350;125;58;23;2;21;.913;3600000;0
2098;184932;122;0;0;0;0;.00nan;0;0
2098;186520;122;73;29;3;26;.897;3582000;0
2098;191813;125;0;0;0;0;.00nan;0;0
2099;187550;111;0;0;0;0;.00nan;0;0
2099;183693;115;61;22;2;20;.909;3600000;0
2099;-1;111;97;47;3;44;.936;3572000;0
2099;186450;115;0;0;0;0;.00nan;0;0
2100;188888;116;67;44;5;39;.886;4097000;0
2100;-1;113;0;0;0;0;.00nan;0;0
2100;185812;116;0;0;0;0;.00nan;0;0
2100;191709;113;27;26;6;20;.769;4097000;0
2101;183698;126;0;0;0;0;.00nan;0;0
2101;180731;126;45;33;6;27;.818;3600000;0
2101;185775;123;63;25;3;22;.880;3600000;0
2101;191125;123;0;0;0;0;.00nan;0;0
2102;179350;125;56;31;4;27;.871;3600000;0
2102;184932;122;0;0;0;0;.00nan;0;0
2102;186520;122;49;39;6;33;.846;3547000;0
2102;191813;125;0;0;0;0;.00nan;0;0
2325;183698;126;0;0;0;0;.00nan;0;0
2325;180731;126;47;46;7;39;.848;3600000;0
2325;185775;123;55;19;2;17;.895;3600000;0
2325;191125;123;0;0;0;0;.00nan;0;0
2326;179350;125;57;32;4;28;.875;3576000;0
2326;184932;122;0;0;0;0;.00nan;0;0
2326;186520;122;95;33;2;31;.939;3600000;0
2326;191813;125;0;0;0;0;.00nan;0;0
0;179350;125;66;27;3;24;.889;3600000;0
0;184932;122;56;4;0;4;1.000;731000;0
0;186520;122;33;28;6;22;.786;2869000;0
0;191813;125;0;0;0;0;.00nan;0;0
55;188888;116;96;49;3;46;.939;3600000;0
55;183693;115;50;18;2;16;.889;3600000;0
55;185812;116;0;0;0;0;.00nan;0;0
55;186450;115;0;0;0;0;.00nan;0;0
56;179350;125;78;28;2;26;.929;3727000;0
56;185775;123;90;28;1;27;.964;3727000;0
56;191125;123;0;0;0;0;.00nan;0;0
56;191813;125;0;0;0;0;.00nan;0;0
57;188888;116;86;26;1;25;.962;3600000;0
57;183693;115;79;26;2;24;.923;3544000;0
57;185812;116;0;0;0;0;.00nan;0;0
57;186450;115;0;0;0;0;.00nan;0;0
58;179350;125;66;36;3;33;.917;3600000;0
58;185775;123;70;30;2;28;.933;3600000;0
58;191125;123;0;0;0;0;.00nan;0;0
58;191813;125;0;0;0;0;.00nan;0;0
59;188888;116;42;31;5;26;.839;3584000;0
59;183693;115;90;47;4;43;.915;3600000;0
59;185812;116;0;0;0;0;.00nan;0;0
59;186450;115;0;0;0;0;.00nan;0;0
60;179350;125;71;38;3;35;.921;3875000;0
60;185775;123;66;38;4;34;.895;3875000;0
60;191125;123;0;0;0;0;.00nan;0;0
60;191813;125;0;0;0;0;.00nan;0;0
61;188888;116;67;43;5;38;.884;3532000;0
61;183693;115;54;26;3;23;.885;3600000;0
61;185812;116;0;0;0;0;.00nan;0;0
61;186450;115;0;0;0;0;.00nan;0;0
62;179350;125;44;34;5;29;.853;3536000;0
62;185775;123;41;22;4;18;.818;3600000;0
62;191125;123;0;0;0;0;.00nan;0;0
62;191813;125;0;0;0;0;.00nan;0;0
196;188888;116;86;47;4;43;.915;3542000;0
196;183693;115;81;32;3;29;.906;3600000;0
196;185812;116;0;0;0;0;.00nan;0;0
196;186450;115;0;0;0;0;.00nan;0;0
197;179350;125;90;29;1;28;.966;3600000;0
197;185775;123;58;30;3;27;.900;3518000;0
197;191125;123;0;0;0;0;.00nan;0;0
197;191813;125;0;0;0;0;.00nan;0;0
211;179350;125;100;26;0;26;1.000;3600000;0
211;185775;123;76;27;1;26;.963;3589000;0
211;191125;123;0;0;0;0;.00nan;0;0
211;191813;125;0;0;0;0;.00nan;0;0
248;179350;125;54;36;5;31;.861;4432000;0
248;185775;123;47;30;4;26;.867;4432000;0
248;191125;123;0;0;0;0;.00nan;0;0
248;191813;125;0;0;0;0;.00nan;0;0
327;183693;115;75;32;3;29;.906;3600000;0
327;185775;123;56;39;5;34;.872;3550000;0
327;186450;115;0;0;0;0;.00nan;0;0
327;191125;123;0;0;0;0;.00nan;0;0
328;183693;115;70;21;2;19;.905;3588000;0
328;185775;123;99;37;1;36;.973;3600000;0
328;186450;115;0;0;0;0;.00nan;0;0
328;191125;123;0;0;0;0;.00nan;0;0
329;183693;115;92;45;3;42;.933;3747000;0
329;185775;123;71;28;2;26;.929;3747000;0
329;186450;115;0;0;0;0;.00nan;0;0
329;191125;123;0;0;0;0;.00nan;0;0
330;183693;115;39;31;6;25;.806;2672000;0
330;185775;123;67;33;3;30;.909;3600000;0
330;186450;115;41;9;2;7;.778;928000;0
330;191125;123;0;0;0;0;.00nan;0;0
396;183693;115;0;0;0;0;.00nan;0;0
396;185775;123;97;46;3;43;.935;3600000;0
396;186450;115;60;19;2;17;.895;3600000;0
396;191125;123;0;0;0;0;.00nan;0;0
404;183693;115;0;0;0;0;.00nan;0;0
404;185775;123;58;41;5;36;.878;3600000;0
404;186450;115;83;25;1;24;.960;3600000;0
404;191125;123;0;0;0;0;.00nan;0;0
411;183693;115;0;0;0;0;.00nan;0;0
411;185775;123;66;38;4;34;.895;3600000;0
411;186450;115;17;27;7;20;.741;3600000;0
411;191125;123;0;0;0;0;.00nan;0;0
8632;189359;87;0;0;0;0;.00nan;0;0
8632;184081;88;48;40;5;35;.875;3600000;0
8632;-1;87;75;27;2;25;.926;3600000;0
8632;191318;88;0;0;0;0;.00nan;0;0
8633;183633;91;55;33;4;29;.879;3580000;0
8633;189433;91;0;0;0;0;.00nan;0;0
8633;184225;93;0;0;0;0;.00nan;0;0
8633;-1;93;80;37;3;34;.919;3600000;0
8634;189576;97;98;52;2;50;.962;3569000;0
8634;184437;96;83;20;1;19;.950;3600000;0
8634;184770;96;0;0;0;0;.00nan;0;0
8634;191331;97;0;0;0;0;.00nan;0;0
8635;194502;86;60;19;2;17;.895;3600000;0
8635;189628;89;54;39;4;35;.897;3600000;0
8635;195330;89;0;0;0;0;.00nan;0;0
8635;-1;86;0;0;0;0;.00nan;0;0
8636;192739;92;0;0;0;0;.00nan;0;0
8636;189644;95;57;23;2;21;.913;3900000;0
8636;195346;95;0;0;0;0;.00nan;0;0
8636;190106;92;86;40;2;38;.950;3900000;0
8637;182266;105;0;0;0;0;.00nan;0;0
8637;189639;105;96;35;1;34;.971;3600000;0
8637;189978;101;0;0;0;0;.00nan;0;0
8637;187096;101;52;15;2;13;.867;3577000;0
8638;192733;99;57;23;2;21;.913;3600000;0
8638;194531;99;0;0;0;0;.00nan;0;0
8638;185220;104;59;51;7;44;.863;3333000;0
8638;191255;104;43;5;1;4;.800;267000;0
8639;178384;103;69;37;3;34;.919;3600000;0
8639;189581;107;0;0;0;0;.00nan;0;0
8639;196473;103;0;0;0;0;.00nan;0;0
8639;187391;107;98;43;1;42;.977;3600000;0
8640;194632;102;43;11;2;9;.818;1763000;0
8640;189573;102;29;22;5;17;.773;1837000;0
8640;184310;98;0;0;0;0;.00nan;0;0
8640;186029;98;62;33;3;30;.909;3600000;0
8641;183633;91;82;27;1;26;.963;3600000;0
8641;189433;91;0;0;0;0;.00nan;0;0
8641;184225;93;0;0;0;0;.00nan;0;0
8641;-1;93;100;32;0;32;1.000;3600000;0
8642;184081;88;42;35;5;30;.857;3579000;0
8642;189628;89;70;36;4;32;.889;3600000;0
8642;195330;89;0;0;0;0;.00nan;0;0
8642;191318;88;0;0;0;0;.00nan;0;0
8643;192733;99;71;31;2;29;.935;3600000;0
8643;194531;99;0;0;0;0;.00nan;0;0
8643;185220;104;30;27;6;21;.778;3600000;0
8643;191255;104;0;0;0;0;.00nan;0;0
8644;189359;87;52;22;3;19;.864;3524000;0
8644;184158;90;100;43;1;42;.977;3600000;0
8644;-1;90;0;0;0;0;.00nan;0;0
8644;-1;87;0;0;0;0;.00nan;0;0
8645;189576;97;0;0;0;0;.00nan;0;0
8645;184437;96;100;34;0;34;1.000;3600000;0
8645;184770;96;0;0;0;0;.00nan;0;0
8645;191331;97;90;25;1;24;.960;3600000;0
8646;178384;103;72;27;3;24;.889;3600000;0
8646;184229;106;67;39;4;35;.897;3551000;0
8646;184866;106;0;0;0;0;.00nan;0;0
8646;196473;103;0;0;0;0;.00nan;0;0
8647;192739;92;0;0;0;0;.00nan;0;0
8647;189644;95;68;33;3;30;.909;3573000;0
8647;195346;95;0;0;0;0;.00nan;0;0
8647;190106;92;92;36;1;35;.972;3600000;0
8648;194632;102;48;26;4;22;.846;3600000;0
8648;189573;102;0;0;0;0;.00nan;0;0
8648;185240;94;0;0;0;0;.00nan;0;0
8648;196525;94;53;39;6;33;.846;3552000;0
8649;189333;100;0;0;0;0;.00nan;0;0
8649;189581;107;99;35;1;34;.971;3600000;0
8649;184398;100;53;20;3;17;.850;3553000;0
8649;187391;107;0;0;0;0;.00nan;0;0
8650;194502;86;62;26;3;23;.885;3600000;0
8650;184158;90;57;31;4;27;.871;3578000;0
8650;-1;90;0;0;0;0;.00nan;0;0
8650;-1;86;0;0;0;0;.00nan;0;0
8651;182266;105;0;0;0;0;.00nan;0;0
8651;189639;105;57;26;3;23;.885;3600000;0
8651;185240;94;0;0;0;0;.00nan;0;0
8651;196525;94;54;28;4;24;.857;3563000;0
8652;194502;86;64;30;3;27;.900;3600000;0
8652;184081;88;69;37;4;33;.892;3571000;0
8652;-1;86;0;0;0;0;.00nan;0;0
8652;191318;88;0;0;0;0;.00nan;0;0
8653;189359;87;50;14;2;12;.857;3600000;0
8653;189628;89;54;33;4;29;.879;3600000;0
8653;195330;89;0;0;0;0;.00nan;0;0
8653;-1;87;0;0;0;0;.00nan;0;0
8654;184081;88;65;43;5;38;.884;3553000;0
8654;189628;89;0;0;0;0;.00nan;0;0
8654;195330;89;64;38;4;34;.895;3600000;0
8654;191318;88;0;0;0;0;.00nan;0;0
8655;194502;86;88;34;1;33;.971;3600000;0
8655;189359;87;44;32;5;27;.844;3600000;0
8655;-1;87;0;0;0;0;.00nan;0;0
8655;-1;86;0;0;0;0;.00nan;0;0
8656;183633;91;0;0;0;0;.00nan;0;0
8656;189433;91;65;36;4;32;.889;3600000;0
8656;189644;95;88;28;1;27;.964;3600000;0
8656;195346;95;0;0;0;0;.00nan;0;0
8657;184225;93;0;0;0;0;.00nan;0;0
8657;184437;96;56;28;3;25;.893;3565000;0
8657;184770;96;0;0;0;0;.00nan;0;0
8657;-1;93;92;40;2;38;.950;3600000;0
8658;192739;92;0;0;0;0;.00nan;0;0
8658;189576;97;0;0;0;0;.00nan;0;0
8658;190106;92;47;32;4;28;.875;3642000;0
8658;191331;97;55;37;5;32;.865;3642000;0
8659;184310;98;73;36;3;33;.917;3600000;0
8659;189978;101;50;34;5;29;.853;2547000;0
8659;186029;98;0;0;0;0;.00nan;0;0
8659;187096;101;34;18;4;14;.778;1053000;0
8660;178384;103;70;26;2;24;.923;3900000;0
8660;185240;94;76;32;2;30;.938;3900000;0
8660;196473;103;0;0;0;0;.00nan;0;0
8660;196525;94;0;0;0;0;.00nan;0;0
8661;192733;99;36;36;6;30;.833;3600000;0
8661;194531;99;0;0;0;0;.00nan;0;0
8661;194632;102;66;26;2;24;.923;3600000;0
8661;189573;102;0;0;0;0;.00nan;0;0
8662;184081;88;0;0;0;0;.00nan;0;0
8662;184437;96;0;0;0;0;.00nan;0;0
8662;184770;96;64;16;1;15;.938;3600000;0
8662;191318;88;83;37;2;35;.946;3600000;0
8663;183633;91;60;18;2;16;.889;3600000;0
8663;189433;91;0;0;0;0;.00nan;0;0
8663;184158;90;29;17;4;13;.765;1788000;0
8663;-1;90;55;13;1;12;.923;1812000;0
8664;189359;87;0;0;0;0;.00nan;0;0
8664;189628;89;41;35;6;29;.829;3600000;0
8664;195330;89;0;0;0;0;.00nan;0;0
8664;-1;87;58;23;2;21;.913;3600000;0
8665;184229;106;31;22;6;16;.727;1423000;0
8665;189581;107;51;13;2;11;.846;3600000;0
8665;184866;106;52;26;3;23;.885;2177000;0
8665;187391;107;0;0;0;0;.00nan;0;0
8666;182266;105;71;28;3;25;.893;3600000;0
8666;189639;105;0;0;0;0;.00nan;0;0
8666;185220;104;41;36;6;30;.833;2745000;0
8666;191255;104;28;11;4;7;.636;855000;0
8667;189978;101;0;0;0;0;.00nan;0;0
8667;185240;94;0;0;0;0;.00nan;0;0
8667;196525;94;26;21;5;16;.762;3538000;0
8667;187096;101;78;37;3;34;.919;3600000;0
8668;192733;99;0;0;0;0;.00nan;0;0
8668;194531;99;69;31;4;27;.871;3900000;0
8668;194632;102;47;23;4;19;.826;3900000;0
8668;189573;102;0;0;0;0;.00nan;0;0
8669;178384;103;57;28;3;25;.893;3600000;0
8669;189333;100;0;0;0;0;.00nan;0;0
8669;184398;100;66;24;2;22;.917;3600000;0
8669;196473;103;0;0;0;0;.00nan;0;0
8670;184158;90;59;33;4;29;.879;3600000;0
8670;184225;93;56;34;5;29;.853;3600000;0
8670;-1;90;0;0;0;0;.00nan;0;0
8670;-1;93;0;0;0;0;.00nan;0;0
8671;192739;92;0;0;0;0;.00nan;0;0
8671;189576;97;0;0;0;0;.00nan;0;0
8671;190106;92;50;33;5;28;.848;3637000;0
8671;191331;97;58;30;4;26;.867;3637000;0
8672;178384;103;0;0;0;0;.00nan;0;0
8672;184310;98;70;23;1;22;.957;3600000;0
8672;196473;103;55;27;3;24;.889;3562000;0
8672;186029;98;0;0;0;0;.00nan;0;0
8673;192739;92;0;0;0;0;.00nan;0;0
8673;194502;86;0;0;0;0;.00nan;0;0
8673;190106;92;37;28;5;23;.821;3600000;0
8673;-1;86;75;20;1;19;.950;3600000;0
8674;192733;99;45;34;5;29;.853;3523000;0
8674;194531;99;0;0;0;0;.00nan;0;0
8674;189333;100;0;0;0;0;.00nan;0;0
8674;184398;100;77;30;3;27;.900;3600000;0
8675;184081;88;81;30;2;28;.933;3600000;0
8675;184437;96;51;25;3;22;.880;3547000;0
8675;184770;96;0;0;0;0;.00nan;0;0
8675;191318;88;0;0;0;0;.00nan;0;0
8676;183633;91;60;36;4;32;.889;3900000;0
8676;189359;87;51;32;4;28;.875;3900000;0
8676;189433;91;0;0;0;0;.00nan;0;0
8676;-1;87;0;0;0;0;.00nan;0;0
8677;192739;92;62;53;6;47;.887;3600000;0
8677;184158;90;60;24;3;21;.875;3600000;0
8677;190106;92;0;0;0;0;.00nan;0;0
8677;-1;90;0;0;0;0;.00nan;0;0
8678;192733;99;69;33;3;30;.909;3600000;0
8678;194531;99;0;0;0;0;.00nan;0;0
8678;189333;100;70;42;4;38;.905;3566000;0
8678;184398;100;0;0;0;0;.00nan;0;0
8679;189576;97;83;28;1;27;.964;3556000;0
8679;189628;89;100;23;0;23;1.000;3600000;0
8679;195330;89;0;0;0;0;.00nan;0;0
8679;191331;97;0;0;0;0;.00nan;0;0
8680;194502;86;99;25;0;25;1.000;3600000;0
8680;189644;95;71;41;5;36;.878;3600000;0
8680;195346;95;0;0;0;0;.00nan;0;0
8680;-1;86;0;0;0;0;.00nan;0;0
8681;183633;91;41;37;7;30;.811;3784000;0
8681;189433;91;0;0;0;0;.00nan;0;0
8681;184437;96;52;1;0;1;1.000;567000;0
8681;184770;96;27;27;6;21;.778;3216000;0
8682;194632;102;53;24;3;21;.875;3600000;0
8682;189573;102;0;0;0;0;.00nan;0;0
8682;189978;101;0;0;0;0;.00nan;0;0
8682;187096;101;50;32;5;27;.844;3525000;0
8683;189581;107;49;43;6;37;.860;3600000;0
8683;185240;94;0;0;0;0;.00nan;0;0
8683;196525;94;79;32;2;30;.938;3600000;0
8683;187391;107;0;0;0;0;.00nan;0;0
8684;192733;99;74;30;2;28;.933;3600000;0
8684;178384;103;61;30;3;27;.900;3591000;0
8684;194531;99;0;0;0;0;.00nan;0;0
8684;196473;103;0;0;0;0;.00nan;0;0
8685;182266;105;0;0;0;0;.00nan;0;0
8685;184229;106;48;40;6;34;.850;3574000;0
8685;189639;105;57;31;4;27;.871;3600000;0
8685;184866;106;0;0;0;0;.00nan;0;0
8686;184081;88;91;30;2;28;.933;3568000;0
8686;184225;93;0;0;0;0;.00nan;0;0
8686;-1;93;68;23;2;21;.913;3600000;0
8686;191318;88;0;0;0;0;.00nan;0;0
8687;183633;91;0;0;0;0;.00nan;0;0
8687;189433;91;33;25;5;20;.800;3600000;0
8687;189628;89;61;33;4;29;.879;3600000;0
8687;195330;89;0;0;0;0;.00nan;0;0
8688;189581;107;0;0;0;0;.00nan;0;0
8688;184310;98;18;14;5;9;.643;1159000;0
8688;186029;98;60;21;2;19;.905;2441000;0
8688;187391;107;84;37;2;35;.946;3600000;0
8689;192733;99;0;0;0;0;.00nan;0;0
8689;178384;103;85;28;1;27;.964;3600000;0
8689;194531;99;70;23;2;21;.913;3566000;0
8689;196473;103;0;0;0;0;.00nan;0;0
8690;189576;97;0;0;0;0;.00nan;0;0
8690;189644;95;0;0;0;0;.00nan;0;0
8690;195346;95;99;22;0;22;1.000;3600000;0
8690;191331;97;46;38;5;33;.868;3600000;0
8691;189359;87;75;39;3;36;.923;3900000;0
8691;184158;90;66;35;3;32;.914;3900000;0
8691;-1;90;0;0;0;0;.00nan;0;0
8691;-1;87;0;0;0;0;.00nan;0;0
8692;192739;92;0;0;0;0;.00nan;0;0
8692;194502;86;59;40;5;35;.875;3600000;0
8692;190106;92;66;24;2;22;.917;3600000;0
8692;-1;86;0;0;0;0;.00nan;0;0
8693;185220;104;0;0;0;0;.00nan;0;0
8693;185240;94;95;26;0;26;1.000;3600000;0
8693;196525;94;0;0;0;0;.00nan;0;0
8693;191255;104;77;36;4;32;.889;3600000;0
8694;182266;105;0;0;0;0;.00nan;0;0
8694;189333;100;0;0;0;0;.00nan;0;0
8694;189639;105;72;56;6;50;.893;3600000;0
8694;184398;100;55;19;2;17;.895;3600000;0
8695;178384;103;93;26;1;25;.962;3600000;0
8695;189978;101;0;0;0;0;.00nan;0;0
8695;196473;103;0;0;0;0;.00nan;0;0
8695;187096;101;52;37;5;32;.865;3600000;0
8696;194632;102;74;22;1;21;.955;3600000;0
8696;189333;100;91;42;2;40;.952;3576000;0
8696;189573;102;0;0;0;0;.00nan;0;0
8696;184398;100;0;0;0;0;.00nan;0;0
8697;192739;92;30;38;7;31;.816;3141000;0
8697;189576;97;55;27;4;23;.852;3600000;0
8697;190106;92;54;4;0;4;1.000;459000;0
8697;191331;97;0;0;0;0;.00nan;0;0
8698;184225;93;0;0;0;0;.00nan;0;0
8698;189628;89;86;39;2;37;.949;3742000;0
8698;195330;89;0;0;0;0;.00nan;0;0
8698;-1;93;74;37;3;34;.919;3797000;0
8699;184081;88;69;35;4;31;.886;3582000;0
8699;189576;97;0;0;0;0;.00nan;0;0
8699;191318;88;0;0;0;0;.00nan;0;0
8699;191331;97;80;33;3;30;.909;3600000;0
8700;189359;87;58;34;5;29;.853;3646000;0
8700;184225;93;49;26;4;22;.846;3646000;0
8700;-1;93;0;0;0;0;.00nan;0;0
8700;-1;87;0;0;0;0;.00nan;0;0
8701;192733;99;97;37;1;36;.973;3600000;0
8701;194531;99;0;0;0;0;.00nan;0;0
8701;184437;96;73;33;3;30;.909;3561000;0
8701;184770;96;0;0;0;0;.00nan;0;0
8702;182266;105;0;0;0;0;.00nan;0;0
8702;189639;105;81;28;2;26;.929;3600000;0
8702;189978;101;0;0;0;0;.00nan;0;0
8702;187096;101;55;24;3;21;.875;3600000;0
8703;189576;97;0;0;0;0;.00nan;0;0
8703;189628;89;60;24;3;21;.875;3600000;0
8703;195330;89;0;0;0;0;.00nan;0;0
8703;191331;97;100;33;0;33;1.000;3600000;0
8704;194502;86;91;29;1;28;.966;3600000;0
8704;184225;93;0;0;0;0;.00nan;0;0
8704;-1;93;81;30;2;28;.933;3555000;0
8704;-1;86;0;0;0;0;.00nan;0;0
8705;189359;87;0;0;0;0;.00nan;0;0
8705;189644;95;0;0;0;0;.00nan;0;0
8705;195346;95;68;37;4;33;.892;3600000;0
8705;-1;87;54;39;5;34;.872;3547000;0
8706;189581;107;69;33;3;30;.909;3600000;0
8706;189978;101;0;0;0;0;.00nan;0;0
8706;187096;101;76;46;4;42;.913;3600000;0
8706;187391;107;0;0;0;0;.00nan;0;0
8707;184310;98;0;0;0;0;.00nan;0;0
8707;184437;96;54;34;3;31;.912;3900000;0
8707;184770;96;0;0;0;0;.00nan;0;0
8707;186029;98;60;31;3;28;.903;3900000;0
8708;192733;99;75;35;3;32;.914;3557000;0
8708;194531;99;0;0;0;0;.00nan;0;0
8708;189333;100;0;0;0;0;.00nan;0;0
8708;184398;100;79;34;2;32;.941;3600000;0
8709;178384;103;84;16;0;16;1.000;3600000;0
8709;184229;106;0;0;0;0;.00nan;0;0
8709;184866;106;93;47;3;44;.936;3600000;0
8709;196473;103;0;0;0;0;.00nan;0;0
8710;184081;88;86;29;1;28;.966;3600000;0
8710;185220;104;74;30;2;28;.933;3592000;0
8710;191255;104;0;0;0;0;.00nan;0;0
8710;191318;88;0;0;0;0;.00nan;0;0
8711;194632;102;0;0;0;0;.00nan;0;0
8711;189573;102;69;30;2;28;.933;3600000;0
8711;185240;94;46;30;5;25;.833;3600000;0
8711;196525;94;0;0;0;0;.00nan;0;0
8712;194502;86;0;0;0;0;.00nan;0;0
8712;189628;89;0;0;0;0;.00nan;0;0
8712;195330;89;60;37;4;33;.892;3545000;0
8712;-1;86;73;35;2;33;.943;3600000;0
8713;189359;87;64;27;3;24;.889;3900000;0
8713;189576;97;0;0;0;0;.00nan;0;0
8713;-1;87;0;0;0;0;.00nan;0;0
8713;191331;97;76;37;3;34;.919;3900000;0
8714;184158;90;59;16;1;15;.938;3600000;0
8714;184225;93;88;29;2;27;.931;3576000;0
8714;-1;90;0;0;0;0;.00nan;0;0
8714;-1;93;0;0;0;0;.00nan;0;0
8715;182266;105;0;0;0;0;.00nan;0;0
8715;184081;88;0;0;0;0;.00nan;0;0
8715;189639;105;47;25;4;21;.840;3514000;0
8715;191318;88;87;35;2;33;.943;3600000;0
8716;189978;101;40;2;1;1;.500;370000;0
8716;185220;104;0;0;0;0;.00nan;0;0
8716;187096;101;23;24;5;19;.792;3173000;0
8716;191255;104;64;41;5;36;.878;3600000;0
8717;194632;102;100;29;0;29;1.000;3600000;0
8717;189573;102;0;0;0;0;.00nan;0;0
8717;184437;96;0;0;0;0;.00nan;0;0
8717;184770;96;97;38;1;37;.974;3569000;0
8718;183633;91;82;35;2;33;.943;3538000;0
8718;189333;100;97;23;0;23;1.000;3600000;0
8718;189433;91;0;0;0;0;.00nan;0;0
8718;184398;100;0;0;0;0;.00nan;0;0
8719;192739;92;0;0;0;0;.00nan;0;0
8719;189644;95;73;43;3;40;.930;3600000;0
8719;195346;95;0;0;0;0;.00nan;0;0
8719;190106;92;87;32;2;30;.938;3600000;0
8720;189581;107;0;0;0;0;.00nan;0;0
8720;185220;104;37;26;5;21;.808;2004000;0
8720;187391;107;58;18;2;16;.889;3600000;0
8720;191255;104;32;12;3;9;.750;1596000;0
8721;194502;86;76;38;3;35;.921;3600000;0
8721;184158;90;0;0;0;0;.00nan;0;0
8721;-1;90;100;25;0;25;1.000;3600000;0
8721;-1;86;0;0;0;0;.00nan;0;0
8722;189359;87;52;22;3;19;.864;3554000;0
8722;189628;89;100;43;2;41;.953;3600000;0
8722;195330;89;0;0;0;0;.00nan;0;0
8722;-1;87;0;0;0;0;.00nan;0;0
8723;192739;92;100;36;1;35;.972;3600000;0
8723;189644;95;0;0;0;0;.00nan;0;0
8723;195346;95;95;43;2;41;.953;3577000;0
8723;190106;92;0;0;0;0;.00nan;0;0
8724;184437;96;37;32;6;26;.813;3089000;0
8724;189978;101;91;31;1;30;.968;3600000;0
8724;184770;96;60;8;0;8;1.000;511000;0
8724;187096;101;0;0;0;0;.00nan;0;0
8725;184081;88;71;20;1;19;.950;3600000;0
8725;184229;106;84;28;2;26;.929;3565000;0
8725;184866;106;0;0;0;0;.00nan;0;0
8725;191318;88;0;0;0;0;.00nan;0;0
8726;183633;91;80;33;2;31;.939;3844000;0
8726;194632;102;61;28;3;25;.893;3844000;0
8726;189433;91;0;0;0;0;.00nan;0;0
8726;189573;102;0;0;0;0;.00nan;0;0
8727;184225;93;0;0;0;0;.00nan;0;0
8727;189576;97;0;0;0;0;.00nan;0;0
8727;-1;93;76;36;3;33;.917;3600000;0
8727;191331;97;52;28;4;24;.857;3600000;0
8728;184081;88;95;40;2;38;.950;3600000;0
8728;189581;107;32;16;4;12;.750;3553000;0
8728;187391;107;0;0;0;0;.00nan;0;0
8728;191318;88;0;0;0;0;.00nan;0;0
8729;183633;91;0;0;0;0;.00nan;0;0
8729;189433;91;92;41;1;40;.976;3600000;0
8729;184310;98;51;32;4;28;.875;3600000;0
8729;186029;98;0;0;0;0;.00nan;0;0
8730;189333;100;49;36;6;30;.833;3900000;0
8730;184398;100;0;0;0;0;.00nan;0;0
8730;184437;96;69;28;3;25;.893;3388000;0
8730;184770;96;38;8;3;5;.625;512000;0
8731;178384;103;59;26;3;23;.885;3600000;0
8731;185220;104;75;46;5;41;.891;3540000;0
8731;196473;103;0;0;0;0;.00nan;0;0
8731;191255;104;0;0;0;0;.00nan;0;0
8732;192739;92;0;0;0;0;.00nan;0;0
8732;184158;90;0;0;0;0;.00nan;0;0
8732;190106;92;60;46;6;40;.870;3745000;0
8732;-1;90;44;31;5;26;.839;3745000;0
8733;184225;93;0;0;0;0;.00nan;0;0
8733;184229;106;55;29;4;25;.862;3600000;0
8733;184866;106;0;0;0;0;.00nan;0;0
8733;-1;93;91;29;2;27;.931;3600000;0
8734;189576;97;38;7;2;5;.714;568000;0
8734;189644;95;0;0;0;0;.00nan;0;0
8734;195346;95;29;28;6;22;.786;3600000;0
8734;191331;97;6;24;7;17;.708;3032000;0
8735;194502;86;65;20;1;19;.950;3600000;0
8735;189359;87;74;36;2;34;.944;3600000;0
8735;-1;87;0;0;0;0;.00nan;0;0
8735;-1;86;0;0;0;0;.00nan;0;0
8736;183633;91;53;37;5;32;.865;3600000;0
8736;189433;91;0;0;0;0;.00nan;0;0
8736;189978;101;47;8;1;7;.875;875000;0
8736;187096;101;24;28;6;22;.786;2647000;0
8737;178384;103;82;43;3;40;.930;3594000;0
8737;184310;98;73;28;2;26;.929;3600000;0
8737;196473;103;0;0;0;0;.00nan;0;0
8737;186029;98;0;0;0;0;.00nan;0;0
8738;189333;100;0;0;0;0;.00nan;0;0
8738;184398;100;65;20;2;18;.900;3600000;0
8738;185220;104;51;3;0;3;1.000;252000;0
8738;191255;104;59;51;6;45;.882;3348000;0
8739;184081;88;68;36;3;33;.917;3600000;0
8739;185240;94;0;0;0;0;.00nan;0;0
8739;196525;94;66;19;2;17;.895;3600000;0
8739;191318;88;0;0;0;0;.00nan;0;0
8740;182266;105;0;0;0;0;.00nan;0;0
8740;194632;102;69;25;2;23;.920;3600000;0
8740;189573;102;0;0;0;0;.00nan;0;0
8740;189639;105;58;39;5;34;.872;3600000;0
8741;194502;86;0;0;0;0;.00nan;0;0
8741;189628;89;72;52;5;47;.904;3513000;0
8741;195330;89;0;0;0;0;.00nan;0;0
8741;-1;86;42;17;3;14;.824;3600000;0
8742;192733;99;33;32;6;26;.813;3545000;0
8742;194531;99;0;0;0;0;.00nan;0;0
8742;189978;101;49;30;5;25;.833;3600000;0
8742;187096;101;0;0;0;0;.00nan;0;0
8743;184158;90;80;31;1;30;.968;3600000;0
8743;189644;95;76;28;2;26;.929;3552000;0
8743;195346;95;0;0;0;0;.00nan;0;0
8743;-1;90;0;0;0;0;.00nan;0;0
8744;178384;103;0;0;0;0;.00nan;0;0
8744;184081;88;82;29;2;27;.931;3789000;0
8744;196473;103;54;29;3;26;.897;3789000;0
8744;191318;88;0;0;0;0;.00nan;0;0
8745;189581;107;0;0;0;0;.00nan;0;0
8745;185240;94;54;39;4;35;.897;3600000;0
8745;196525;94;0;0;0;0;.00nan;0;0
8745;187391;107;73;25;1;24;.960;3600000;0
8746;182266;105;0;0;0;0;.00nan;0;0
8746;194632;102;0;0;0;0;.00nan;0;0
8746;189573;102;58;23;2;21;.913;3600000;0
8746;189639;105;55;38;4;34;.895;3567000;0
8747;189333;100;63;26;2;24;.923;3600000;0
8747;184310;98;0;0;0;0;.00nan;0;0
8747;184398;100;0;0;0;0;.00nan;0;0
8747;186029;98;58;32;4;28;.875;3596000;0
8748;184225;93;88;27;1;26;.963;3575000;0
8748;189576;97;100;40;0;40;1.000;3600000;0
8748;-1;93;0;0;0;0;.00nan;0;0
8748;191331;97;0;0;0;0;.00nan;0;0
8749;189359;87;69;34;3;31;.912;3600000;0
8749;184437;96;100;31;0;31;1.000;3600000;0
8749;184770;96;0;0;0;0;.00nan;0;0
8749;-1;87;0;0;0;0;.00nan;0;0
8750;192739;92;0;0;0;0;.00nan;0;0
8750;184229;106;0;0;0;0;.00nan;0;0
8750;190106;92;46;23;3;20;.870;3600000;0
8750;184866;106;57;33;4;29;.879;3553000;0
8751;182266;105;83;28;1;27;.964;3600000;0
8751;184310;98;36;28;5;23;.821;3600000;0
8751;189639;105;0;0;0;0;.00nan;0;0
8751;186029;98;0;0;0;0;.00nan;0;0
8752;185220;104;65;26;2;24;.923;3600000;0
8752;185240;94;0;0;0;0;.00nan;0;0
8752;196525;94;63;32;3;29;.906;3574000;0
8752;191255;104;0;0;0;0;.00nan;0;0
8753;192733;99;0;0;0;0;.00nan;0;0
8753;183633;91;57;26;4;22;.846;3822000;0
8753;194531;99;65;29;3;26;.897;3846000;0
8753;189433;91;0;0;0;0;.00nan;0;0
8754;184229;106;0;0;0;0;.00nan;0;0
8754;189644;95;0;0;0;0;.00nan;0;0
8754;195346;95;95;36;1;35;.972;3600000;0
8754;184866;106;66;47;5;42;.894;3600000;0
8755;184158;90;24;5;3;2;.400;601000;0
8755;189628;89;57;37;5;32;.865;3600000;0
8755;195330;89;0;0;0;0;.00nan;0;0
8755;-1;90;37;12;3;9;.750;2943000;0
8756;178384;103;44;35;6;29;.829;3600000;0
8756;189978;101;0;0;0;0;.00nan;0;0
8756;196473;103;0;0;0;0;.00nan;0;0
8756;187096;101;93;28;1;27;.964;3600000;0
8757;184229;106;65;22;2;20;.909;3600000;0
8757;189576;97;68;32;3;29;.906;3550000;0
8757;184866;106;0;0;0;0;.00nan;0;0
8757;191331;97;0;0;0;0;.00nan;0;0
8758;194502;86;70;37;4;33;.892;3600000;0
8758;184437;96;47;35;6;29;.829;3576000;0
8758;184770;96;0;0;0;0;.00nan;0;0
8758;-1;86;0;0;0;0;.00nan;0;0
8759;194632;102;74;42;4;38;.905;3765000;0
8759;189333;100;0;0;0;0;.00nan;0;0
8759;189573;102;0;0;0;0;.00nan;0;0
8759;184398;100;47;31;5;26;.839;3765000;0
8760;185220;104;65;34;3;31;.912;3600000;0
8760;185240;94;87;24;1;23;.958;3600000;0
8760;196525;94;0;0;0;0;.00nan;0;0
8760;191255;104;0;0;0;0;.00nan;0;0
8761;184081;88;93;43;3;40;.930;3900000;0
8761;189628;89;46;26;3;23;.885;3900000;0
8761;195330;89;0;0;0;0;.00nan;0;0
8761;191318;88;0;0;0;0;.00nan;0;0
8762;184225;93;0;0;0;0;.00nan;0;0
8762;189576;97;66;37;4;33;.892;3559000;0
8762;-1;93;67;23;2;21;.913;3600000;0
8762;191331;97;0;0;0;0;.00nan;0;0
8763;192739;92;52;4;0;4;1.000;493000;0
8763;183633;91;53;30;4;26;.867;3600000;0
8763;189433;91;0;0;0;0;.00nan;0;0
8763;190106;92;68;50;6;44;.880;3054000;0
8764;189581;107;0;0;0;0;.00nan;0;0
8764;189644;95;100;27;0;27;1.000;3600000;0
8764;195346;95;0;0;0;0;.00nan;0;0
8764;187391;107;76;28;2;26;.929;3528000;0
8765;189359;87;0;0;0;0;.00nan;0;0
8765;184158;90;65;25;2;23;.920;3588000;0
8765;-1;90;0;0;0;0;.00nan;0;0
8765;-1;87;100;40;1;39;.975;3600000;0
8766;184229;106;0;0;0;0;.00nan;0;0
8766;184437;96;100;35;0;35;1.000;3600000;0
8766;184770;96;0;0;0;0;.00nan;0;0
8766;184866;106;64;49;6;43;.878;3600000;0
8767;189978;101;0;0;0;0;.00nan;0;0
8767;185220;104;0;0;0;0;.00nan;0;0
8767;187096;101;82;24;1;23;.958;3600000;0
8767;191255;104;62;49;5;44;.898;3600000;0
8768;194632;102;90;33;1;32;.970;3600000;0
8768;189573;102;0;0;0;0;.00nan;0;0
8768;184310;98;0;0;0;0;.00nan;0;0
8768;186029;98;51;28;4;24;.857;3600000;0
8769;182266;105;0;0;0;0;.00nan;0;0
8769;189333;100;61;24;2;22;.917;3600000;0
8769;189639;105;92;49;3;46;.939;3541000;0
8769;184398;100;0;0;0;0;.00nan;0;0
8770;178384;103;69;35;3;32;.914;3569000;0
8770;185240;94;0;0;0;0;.00nan;0;0
8770;196473;103;0;0;0;0;.00nan;0;0
8770;196525;94;95;32;1;31;.969;3600000;0
8771;184081;88;86;41;2;39;.951;3631000;0
8771;184158;90;0;0;0;0;.00nan;0;0
8771;-1;90;44;16;3;13;.813;3630000;0
8771;191318;88;0;0;0;0;.00nan;0;0
8772;184225;93;74;32;2;30;.938;3900000;0
8772;189644;95;86;34;2;32;.941;3900000;0
8772;195346;95;0;0;0;0;.00nan;0;0
8772;-1;93;0;0;0;0;.00nan;0;0
8773;189978;101;76;25;1;24;.960;3600000;0
8773;185220;104;65;39;4;35;.897;3600000;0
8773;187096;101;0;0;0;0;.00nan;0;0
8773;191255;104;0;0;0;0;.00nan;0;0
8774;183633;91;0;0;0;0;.00nan;0;0
8774;189433;91;70;18;1;17;.944;3600000;0
8774;184229;106;62;51;6;45;.882;3600000;0
8774;184866;106;0;0;0;0;.00nan;0;0
8775;192733;99;47;31;4;27;.871;3578000;0
8775;194531;99;0;0;0;0;.00nan;0;0
8775;189628;89;66;33;3;30;.909;3600000;0
8775;195330;89;0;0;0;0;.00nan;0;0
8776;194502;86;50;19;3;16;.842;3600000;0
8776;184437;96;86;36;2;34;.944;3600000;0
8776;184770;96;0;0;0;0;.00nan;0;0
8776;-1;86;0;0;0;0;.00nan;0;0
8777;178384;103;83;27;1;26;.963;3600000;0
8777;189333;100;0;0;0;0;.00nan;0;0
8777;184398;100;66;30;3;27;.900;3600000;0
8777;196473;103;0;0;0;0;.00nan;0;0
8778;192739;92;70;37;4;33;.892;3550000;0
8778;189581;107;0;0;0;0;.00nan;0;0
8778;190106;92;0;0;0;0;.00nan;0;0
8778;187391;107;74;28;2;26;.929;3600000;0
8779;182266;105;0;0;0;0;.00nan;0;0
8779;189639;105;100;27;0;27;1.000;3600000;0
8779;185240;94;62;44;5;39;.886;3600000;0
8779;196525;94;0;0;0;0;.00nan;0;0
8780;194632;102;0;0;0;0;.00nan;0;0
8780;189573;102;70;26;2;24;.923;3600000;0
8780;184310;98;82;50;3;47;.940;3600000;0
8780;186029;98;0;0;0;0;.00nan;0;0
8781;194502;86;60;18;2;16;.889;3600000;0
8781;189628;89;0;0;0;0;.00nan;0;0
8781;195330;89;54;35;5;30;.857;3600000;0
8781;-1;86;0;0;0;0;.00nan;0;0
8782;192733;99;0;0;0;0;.00nan;0;0
8782;194531;99;60;38;5;33;.868;3600000;0
8782;189359;87;68;25;2;23;.920;3600000;0
8782;-1;87;0;0;0;0;.00nan;0;0
8783;184310;98;0;0;0;0;.00nan;0;0
8783;189978;101;0;0;0;0;.00nan;0;0
8783;186029;98;37;31;6;25;.806;3600000;0
8783;187096;101;80;28;2;26;.929;3600000;0
8784;184225;93;0;0;0;0;.00nan;0;0
8784;189581;107;0;0;0;0;.00nan;0;0
8784;-1;93;55;11;1;10;.909;3600000;0
8784;187391;107;92;43;2;41;.953;3560000;0
8785;192733;99;66;25;2;23;.920;3851000;0
8785;194531;99;0;0;0;0;.00nan;0;0
8785;184081;88;84;39;3;36;.923;3851000;0
8785;191318;88;0;0;0;0;.00nan;0;0
8786;189576;97;49;22;3;19;.864;3600000;0
8786;185240;94;57;23;2;21;.913;3146000;0
8786;196525;94;24;5;3;2;.400;368000;0
8786;191331;97;0;0;0;0;.00nan;0;0
8787;183633;91;63;23;2;21;.913;3600000;0
8787;189433;91;0;0;0;0;.00nan;0;0
8787;189581;107;0;0;0;0;.00nan;0;0
8787;187391;107;74;31;3;28;.903;3585000;0
8788;194502;86;86;29;1;28;.966;3600000;0
8788;189359;87;0;0;0;0;.00nan;0;0
8788;-1;87;57;40;5;35;.875;3600000;0
8788;-1;86;0;0;0;0;.00nan;0;0
8789;184310;98;0;0;0;0;.00nan;0;0
8789;185220;104;76;43;3;40;.930;3551000;0
8789;186029;98;60;13;1;12;.923;3600000;0
8789;191255;104;0;0;0;0;.00nan;0;0
8790;194502;86;96;34;1;33;.971;3900000;0
8790;184158;90;82;24;1;23;.958;3900000;0
8790;-1;90;0;0;0;0;.00nan;0;0
8790;-1;86;0;0;0;0;.00nan;0;0
8791;184225;93;0;0;0;0;.00nan;0;0
8791;-1;93;58;36;5;31;.861;3600000;0
8791;185240;94;79;47;4;43;.915;3600000;0
8791;196525;94;0;0;0;0;.00nan;0;0
8792;183633;91;59;17;2;15;.882;3600000;0
8792;189433;91;0;0;0;0;.00nan;0;0
8792;189576;97;44;26;4;22;.846;2392000;0
8792;191331;97;56;13;1;12;.923;1208000;0
8793;189359;87;71;24;3;21;.875;3600000;0
8793;184081;88;59;47;6;41;.872;3600000;0
8793;196495;87;0;0;0;0;.00nan;0;0
8793;191318;88;0;0;0;0;.00nan;0;0
8794;192733;99;91;37;2;35;.946;3543000;0
8794;194531;99;0;0;0;0;.00nan;0;0
8794;184158;90;0;0;0;0;.00nan;0;0
8794;-1;90;89;31;1;30;.968;3600000;0
8795;189581;107;0;0;0;0;.00nan;0;0
8795;184437;96;62;28;3;25;.893;3767000;0
8795;184770;96;0;0;0;0;.00nan;0;0
8795;187391;107;91;34;2;32;.941;3767000;0
8796;192739;92;0;0;0;0;.00nan;0;0
8796;189628;89;39;20;4;16;.800;3556000;0
8796;195330;89;0;0;0;0;.00nan;0;0
8796;190106;92;88;35;2;33;.943;3600000;0
8797;189644;95;59;33;4;29;.879;3600000;0
8797;195346;95;0;0;0;0;.00nan;0;0
8797;189978;101;0;0;0;0;.00nan;0;0
8797;187096;101;89;30;1;29;.967;3600000;0
8798;178384;103;86;30;2;28;.933;3600000;0
8798;184310;98;31;25;5;20;.800;3600000;0
8798;196473;103;0;0;0;0;.00nan;0;0
8798;186029;98;0;0;0;0;.00nan;0;0
8799;194632;102;80;33;3;30;.909;3600000;0
8799;189333;100;0;0;0;0;.00nan;0;0
8799;189573;102;0;0;0;0;.00nan;0;0
8799;184398;100;46;26;4;22;.846;3590000;0
8800;182266;105;0;0;0;0;.00nan;0;0
8800;184229;106;0;0;0;0;.00nan;0;0
8800;189639;105;72;30;3;27;.900;3568000;0
8800;184866;106;93;32;2;30;.938;3600000;0
8801;189576;97;0;0;0;0;.00nan;0;0
8801;189581;107;53;24;3;21;.875;3600000;0
8801;187391;107;0;0;0;0;.00nan;0;0
8801;191331;97;60;27;2;25;.926;3600000;0
8802;183633;91;0;0;0;0;.00nan;0;0
8802;189433;91;24;17;5;12;.706;3600000;0
8802;185240;94;0;0;0;0;.00nan;0;0
8802;196525;94;84;24;1;23;.958;3600000;0
8803;192733;99;0;0;0;0;.00nan;0;0
8803;194502;86;66;29;3;26;.897;3580000;0
8803;194531;99;93;34;2;32;.941;3600000;0
8803;-1;86;0;0;0;0;.00nan;0;0
8804;178384;103;0;0;0;0;.00nan;0;0
8804;194632;102;54;16;2;14;.875;3600000;0
8804;189573;102;0;0;0;0;.00nan;0;0
8804;196473;103;51;46;6;40;.870;3600000;0
8805;182266;105;86;24;1;23;.958;3600000;0
8805;189639;105;0;0;0;0;.00nan;0;0
8805;185220;104;47;14;2;12;.857;1359000;0
8805;191255;104;28;25;5;20;.800;2241000;0
8806;184310;98;0;0;0;0;.00nan;0;0
8806;189978;101;46;34;5;29;.853;3581000;0
8806;186029;98;70;34;3;31;.912;3600000;0
8806;187096;101;0;0;0;0;.00nan;0;0
8807;189333;100;77;21;1;20;.952;3600000;0
8807;189644;95;0;0;0;0;.00nan;0;0
8807;184398;100;0;0;0;0;.00nan;0;0
8807;195346;95;58;37;4;33;.892;3600000;0
8808;189359;87;0;0;0;0;.00nan;0;0
8808;184158;90;64;36;3;33;.917;3554000;0
8808;-1;90;0;0;0;0;.00nan;0;0
8808;196495;87;77;29;2;27;.931;3600000;0
8809;184437;96;0;0;0;0;.00nan;0;0
8809;184770;96;86;35;2;33;.943;3600000;0
8809;185240;94;63;30;3;27;.900;3600000;0
8809;196525;94;0;0;0;0;.00nan;0;0
8810;184225;93;32;25;5;20;.800;3515000;0
8810;189628;89;83;43;3;40;.930;3600000;0
8810;195330;89;0;0;0;0;.00nan;0;0
8810;-1;93;0;0;0;0;.00nan;0;0
8811;192739;92;0;0;0;0;.00nan;0;0
8811;183633;91;52;38;5;33;.868;3686000;0
8811;189433;91;0;0;0;0;.00nan;0;0
8811;190106;92;62;35;4;31;.886;3686000;0
8812;189333;100;0;0;0;0;.00nan;0;0
8812;184398;100;46;25;4;21;.840;3900000;0
8812;185220;104;86;47;4;43;.915;3900000;0
8812;191255;104;0;0;0;0;.00nan;0;0
8813;194632;102;42;25;5;20;.800;3600000;0
8813;189573;102;0;0;0;0;.00nan;0;0
8813;189644;95;72;23;1;22;.957;3600000;0
8813;195346;95;0;0;0;0;.00nan;0;0
8814;189359;87;77;23;2;21;.913;3600000;0
8814;184158;90;38;43;7;36;.837;3600000;0
8814;-1;90;0;0;0;0;.00nan;0;0
8814;196495;87;0;0;0;0;.00nan;0;0
8815;178384;103;77;42;4;38;.905;3600000;0
8815;184437;96;72;20;1;19;.950;3600000;0
8815;184770;96;0;0;0;0;.00nan;0;0
8815;196473;103;0;0;0;0;.00nan;0;0
8816;194502;86;55;31;4;27;.871;3600000;0
8816;189576;97;20;11;4;7;.636;380000;0
8816;-1;86;0;0;0;0;.00nan;0;0
8816;191331;97;81;36;2;34;.944;3199000;0
8817;189581;107;0;0;0;0;.00nan;0;0
8817;189978;101;0;0;0;0;.00nan;0;0
8817;187096;101;55;27;3;24;.889;3670000;0
8817;187391;107;79;35;2;33;.943;3670000;0
8818;184310;98;0;0;0;0;.00nan;0;0
8818;189644;95;0;0;0;0;.00nan;0;0
8818;195346;95;87;33;2;31;.939;3900000;0
8818;186029;98;81;31;2;29;.935;3900000;0
8819;184081;88;35;34;6;28;.824;3252000;0
8819;189628;89;62;22;2;20;.909;3600000;0
8819;195330;89;0;0;0;0;.00nan;0;0
8819;191318;88;52;3;0;3;1.000;348000;0
8820;183633;91;67;29;3;26;.897;3558000;0
8820;189433;91;0;0;0;0;.00nan;0;0
8820;189628;89;0;0;0;0;.00nan;0;0
8820;195330;89;78;33;2;31;.939;3600000;0
8821;184158;90;57;23;2;21;.913;3600000;0
8821;184437;96;68;38;4;34;.895;3575000;0
8821;184770;96;0;0;0;0;.00nan;0;0
8821;-1;90;0;0;0;0;.00nan;0;0
8822;192739;92;0;0;0;0;.00nan;0;0
8822;184225;93;0;0;0;0;.00nan;0;0
8822;190106;92;33;24;5;19;.792;3531000;0
8822;-1;93;61;29;3;26;.897;3600000;0
8823;178384;103;48;26;4;22;.846;3600000;0
8823;189576;97;0;0;0;0;.00nan;0;0
8823;196473;103;0;0;0;0;.00nan;0;0
8823;191331;97;76;53;5;48;.906;3600000;0
8824;192733;99;69;33;3;30;.909;3600000;0
8824;194531;99;0;0;0;0;.00nan;0;0
8824;189644;95;94;24;0;24;1.000;3600000;0
8824;195346;95;0;0;0;0;.00nan;0;0
8825;189581;107;56;4;0;4;1.000;383000;0
8825;184310;98;0;0;0;0;.00nan;0;0
8825;186029;98;52;21;3;18;.857;3600000;0
8825;187391;107;50;41;6;35;.854;3217000;0
8826;182266;105;0;0;0;0;.00nan;0;0
8826;194502;86;69;28;3;25;.893;3600000;0
8826;189639;105;76;25;1;24;.960;3600000;0
8826;-1;86;0;0;0;0;.00nan;0;0
8827;189978;101;0;0;0;0;.00nan;0;0
8827;185220;104;45;45;7;38;.844;3600000;0
8827;187096;101;61;23;2;21;.913;3600000;0
8827;191255;104;0;0;0;0;.00nan;0;0
8828;189333;100;0;0;0;0;.00nan;0;0
8828;184398;100;31;28;6;22;.786;3561000;0
8828;185240;94;0;0;0;0;.00nan;0;0
8828;196525;94;70;37;4;33;.892;3600000;0
8829;194632;102;90;17;0;17;1.000;3600000;0
8829;184229;106;0;0;0;0;.00nan;0;0
8829;189573;102;0;0;0;0;.00nan;0;0
8829;184866;106;61;31;4;27;.871;3600000;0
8830;189359;87;67;22;2;20;.909;3600000;0
8830;184081;88;63;34;4;30;.882;3516000;0
8830;196495;87;0;0;0;0;.00nan;0;0
8830;191318;88;0;0;0;0;.00nan;0;0
8831;183633;91;0;0;0;0;.00nan;0;0
8831;178384;103;67;30;3;27;.900;3519000;0
8831;189433;91;78;23;1;22;.957;3600000;0
8831;196473;103;0;0;0;0;.00nan;0;0
8832;192739;92;60;32;4;28;.875;3600000;0
8832;184225;93;26;17;5;12;.706;1840000;0
8832;190106;92;0;0;0;0;.00nan;0;0
8832;-1;93;79;18;1;17;.944;1760000;0
8833;194632;102;42;35;6;29;.829;3581000;0
8833;184229;106;72;49;5;44;.898;3600000;0
8833;189573;102;0;0;0;0;.00nan;0;0
8833;184866;106;0;0;0;0;.00nan;0;0
8834;182266;105;65;24;2;22;.917;3600000;0
8834;189639;105;0;0;0;0;.00nan;0;0
8834;189978;101;57;40;5;35;.875;3600000;0
8834;187096;101;0;0;0;0;.00nan;0;0
8835;194502;86;32;27;6;21;.778;3554000;0
8835;185220;104;0;0;0;0;.00nan;0;0
8835;-1;86;0;0;0;0;.00nan;0;0
8835;191255;104;63;41;5;36;.878;3600000;0
8836;184310;98;93;52;3;49;.942;3853000;0
8836;185240;94;62;39;4;35;.897;3853000;0
8836;196525;94;0;0;0;0;.00nan;0;0
8836;186029;98;0;0;0;0;.00nan;0;0
8837;189359;87;0;0;0;0;.00nan;0;0
8837;184081;88;0;0;0;0;.00nan;0;0
8837;196495;87;54;17;2;15;.882;3600000;0
8837;191318;88;75;36;3;33;.917;3553000;0
8838;194632;102;0;0;0;0;.00nan;0;0
8838;189333;100;0;0;0;0;.00nan;0;0
8838;189573;102;59;31;4;27;.871;3546000;0
8838;184398;100;71;30;3;27;.900;3600000;0
8839;184158;90;84;25;1;24;.960;3545000;0
8839;189628;89;99;20;0;20;1.000;3600000;0
8839;195330;89;0;0;0;0;.00nan;0;0
8839;-1;90;0;0;0;0;.00nan;0;0
8840;183633;91;65;28;3;25;.893;3555000;0
8840;189433;91;0;0;0;0;.00nan;0;0
8840;184437;96;0;0;0;0;.00nan;0;0
8840;184770;96;100;39;1;38;.974;3600000;0
8841;192733;99;72;51;6;45;.882;3600000;0
8841;194531;99;0;0;0;0;.00nan;0;0
8841;184310;98;0;0;0;0;.00nan;0;0
8841;186029;98;71;25;2;23;.920;3600000;0
8842;194502;86;65;25;3;22;.880;3900000;0
8842;184229;106;0;0;0;0;.00nan;0;0
8842;184866;106;86;39;3;36;.923;3900000;0
8842;-1;86;0;0;0;0;.00nan;0;0
8843;194632;102;84;30;2;28;.933;3600000;0
8843;189333;100;48;21;3;18;.857;3565000;0
8843;189573;102;0;0;0;0;.00nan;0;0
8843;184398;100;0;0;0;0;.00nan;0;0
8844;192739;92;0;0;0;0;.00nan;0;0
8844;189359;87;63;22;2;20;.909;3600000;0
8844;190106;92;82;62;3;59;.952;3600000;0
8844;196495;87;0;0;0;0;.00nan;0;0
8845;178384;103;64;13;1;12;.923;3600000;0
8845;185220;104;53;29;3;26;.897;2818000;0
8845;196473;103;0;0;0;0;.00nan;0;0
8845;191255;104;28;13;4;9;.692;782000;0
8846;192733;99;0;0;0;0;.00nan;0;0
8846;194531;99;81;33;3;30;.909;3600000;0
8846;184310;98;43;38;6;32;.842;3600000;0
8846;186029;98;0;0;0;0;.00nan;0;0
8847;194502;86;48;29;4;25;.862;3760000;0
8847;185240;94;0;0;0;0;.00nan;0;0
8847;196525;94;61;33;3;30;.909;3760000;0
8847;-1;86;0;0;0;0;.00nan;0;0
8848;192739;92;0;0;0;0;.00nan;0;0
8848;184081;88;55;24;3;21;.875;3830000;0
8848;190106;92;64;34;4;30;.882;3830000;0
8848;191318;88;0;0;0;0;.00nan;0;0
8849;184158;90;48;31;5;26;.839;3523000;0
8849;189628;89;60;28;3;25;.893;3600000;0
8849;195330;89;0;0;0;0;.00nan;0;0
8849;-1;90;0;0;0;0;.00nan;0;0
8850;189359;87;0;0;0;0;.00nan;0;0
8850;184437;96;67;38;4;34;.895;3600000;0
8850;184770;96;0;0;0;0;.00nan;0;0
8850;196495;87;94;31;1;30;.968;3600000;0
8851;184225;93;0;0;0;0;.00nan;0;0
8851;189644;95;61;39;4;35;.897;3600000;0
8851;195346;95;0;0;0;0;.00nan;0;0
8851;-1;93;99;39;1;38;.974;3600000;0
8852;194502;86;82;28;2;26;.929;3600000;0
8852;189581;107;0;0;0;0;.00nan;0;0
8852;187391;107;51;25;3;22;.880;3580000;0
8852;-1;86;0;0;0;0;.00nan;0;0
8853;192733;99;76;31;2;29;.935;3877000;0
8853;194531;99;0;0;0;0;.00nan;0;0
8853;184310;98;79;31;2;29;.935;3900000;0
8853;186029;98;0;0;0;0;.00nan;0;0
8854;178384;103;74;20;1;19;.950;3600000;0
8854;185220;104;84;60;5;55;.917;3600000;0
8854;196473;103;0;0;0;0;.00nan;0;0
8854;191255;104;0;0;0;0;.00nan;0;0
8855;184229;106;48;40;5;35;.875;3900000;0
8855;184866;106;0;0;0;0;.00nan;0;0
8855;185240;94;0;0;0;0;.00nan;0;0
8855;196525;94;41;27;5;22;.815;3900000;0
8856;194632;102;89;30;1;29;.967;3600000;0
8856;189573;102;0;0;0;0;.00nan;0;0
8856;189576;97;0;0;0;0;.00nan;0;0
8856;191331;97;46;30;4;26;.867;3600000;0
8857;183633;91;58;31;4;27;.871;3600000;0
8857;184081;88;0;0;0;0;.00nan;0;0
8857;189433;91;0;0;0;0;.00nan;0;0
8857;191318;88;40;41;7;34;.829;3600000;0
8858;184158;90;0;0;0;0;.00nan;0;0
8858;184437;96;0;0;0;0;.00nan;0;0
8858;184770;96;88;20;0;20;1.000;3600000;0
8858;-1;90;66;28;2;26;.929;3517000;0
8859;184225;93;39;29;5;24;.828;3544000;0
8859;189644;95;0;0;0;0;.00nan;0;0
8859;195346;95;41;22;4;18;.818;3600000;0
8859;-1;93;0;0;0;0;.00nan;0;0
8860;184229;106;0;0;0;0;.00nan;0;0
8860;184866;106;90;34;1;33;.971;3575000;0
8860;185240;94;87;15;0;15;1.000;3600000;0
8860;196525;94;0;0;0;0;.00nan;0;0
8861;182266;105;0;0;0;0;.00nan;0;0
8861;178384;103;0;0;0;0;.00nan;0;0
8861;189639;105;43;37;6;31;.838;3600000;0
8861;196473;103;96;31;1;30;.968;3600000;0
8862;192739;92;29;20;5;15;.750;3600000;0
8862;189628;89;76;36;3;33;.917;3600000;0
8862;195330;89;0;0;0;0;.00nan;0;0
8862;190106;92;0;0;0;0;.00nan;0;0
8863;189576;97;43;36;5;31;.861;3558000;0
8863;184310;98;0;0;0;0;.00nan;0;0
8863;186029;98;53;32;4;28;.875;3600000;0
8863;191331;97;0;0;0;0;.00nan;0;0
8864;192733;99;0;0;0;0;.00nan;0;0
8864;194531;99;83;38;3;35;.921;3600000;0
8864;189333;100;0;0;0;0;.00nan;0;0
8864;184398;100;48;28;4;24;.857;3544000;0
8865;178384;103;68;27;3;24;.889;3900000;0
8865;194502;86;80;36;3;33;.917;3900000;0
8865;196473;103;0;0;0;0;.00nan;0;0
8865;-1;86;0;0;0;0;.00nan;0;0
8866;189581;107;0;0;0;0;.00nan;0;0
8866;185240;94;0;0;0;0;.00nan;0;0
8866;196525;94;55;31;4;27;.871;3600000;0
8866;187391;107;80;36;2;34;.944;3600000;0
8867;182266;105;63;37;4;33;.892;3559000;0
8867;189639;105;0;0;0;0;.00nan;0;0
8867;189978;101;0;0;0;0;.00nan;0;0
8867;187096;101;77;30;2;28;.933;3600000;0
8868;178384;103;85;50;3;47;.940;3600000;0
8868;184158;90;33;25;5;20;.800;3600000;0
8868;-1;90;0;0;0;0;.00nan;0;0
8868;196473;103;0;0;0;0;.00nan;0;0
8869;189333;100;0;0;0;0;.00nan;0;0
8869;189576;97;0;0;0;0;.00nan;0;0
8869;184398;100;92;31;1;30;.968;3600000;0
8869;191331;97;88;46;3;43;.935;3542000;0
8870;184229;106;88;28;1;27;.964;3586000;0
8870;184866;106;0;0;0;0;.00nan;0;0
8870;185220;104;0;0;0;0;.00nan;0;0
8870;191255;104;94;25;0;25;1.000;3600000;0
8871;184158;90;0;0;0;0;.00nan;0;0
8871;-1;90;30;27;5;22;.815;3600000;0
8871;185240;94;49;31;4;27;.871;3600000;0
8871;196525;94;0;0;0;0;.00nan;0;0
8872;183633;91;0;0;0;0;.00nan;0;0
8872;189359;87;0;0;0;0;.00nan;0;0
8872;189433;91;73;39;3;36;.923;3600000;0
8872;196495;87;49;33;5;28;.848;3563000;0
8873;192739;92;0;0;0;0;.00nan;0;0
8873;184081;88;60;35;4;31;.886;3528000;0
8873;190106;92;83;34;2;32;.941;3600000;0
8873;191318;88;0;0;0;0;.00nan;0;0
8874;189576;97;68;25;2;23;.920;3600000;0
8874;189978;101;0;0;0;0;.00nan;0;0
8874;187096;101;70;32;3;29;.906;3541000;0
8874;191331;97;0;0;0;0;.00nan;0;0
8875;194632;102;86;39;2;37;.949;3600000;0
8875;189573;102;0;0;0;0;.00nan;0;0
8875;189581;107;53;33;4;29;.879;3546000;0
8875;187391;107;0;0;0;0;.00nan;0;0
8876;189333;100;85;16;0;16;1.000;3600000;0
8876;184229;106;0;0;0;0;.00nan;0;0
8876;184398;100;0;0;0;0;.00nan;0;0
8876;184866;106;84;44;3;41;.932;3600000;0
8877;182266;105;0;0;0;0;.00nan;0;0
8877;184310;98;12;16;6;10;.625;924000;0
8877;189639;105;43;26;5;21;.808;3600000;0
8877;186029;98;34;36;6;30;.833;2676000;0
8878;189628;89;82;33;1;32;.970;3600000;0
8878;184437;96;0;0;0;0;.00nan;0;0
8878;195330;89;0;0;0;0;.00nan;0;0
8878;184770;96;41;26;4;22;.846;3600000;0
8879;184081;88;90;38;1;37;.974;3600000;0
8879;189644;95;47;20;3;17;.850;3595000;0
8879;195346;95;0;0;0;0;.00nan;0;0
8879;191318;88;0;0;0;0;.00nan;0;0
8880;192739;92;43;16;2;14;.875;1358000;0
8880;189359;87;0;0;0;0;.00nan;0;0
8880;190106;92;52;45;6;39;.867;2242000;0
8880;196495;87;65;24;2;22;.917;3600000;0
8881;184310;98;0;0;0;0;.00nan;0;0
8881;189978;101;87;37;2;35;.946;3600000;0
8881;186029;98;41;22;4;18;.818;3599000;0
8881;187096;101;0;0;0;0;.00nan;0;0
8882;192733;99;45;15;3;12;.800;3600000;0
8882;194531;99;0;0;0;0;.00nan;0;0
8882;189576;97;0;0;0;0;.00nan;0;0
8882;191331;97;100;39;0;39;1.000;3600000;0
8883;182266;105;53;22;3;19;.864;3073000;0
8883;178384;103;80;35;2;33;.943;3600000;0
8883;189639;105;28;11;3;8;.727;527000;0
8883;196473;103;0;0;0;0;.00nan;0;0
8884;184158;90;84;18;0;18;1.000;3600000;0
8884;184229;106;82;39;3;36;.923;3600000;0
8884;184866;106;0;0;0;0;.00nan;0;0
8884;-1;90;0;0;0;0;.00nan;0;0
8885;194632;102;70;17;2;15;.882;3600000;0
8885;189573;102;0;0;0;0;.00nan;0;0
8885;185220;104;0;0;0;0;.00nan;0;0
8885;191255;104;89;50;3;47;.940;3583000;0
8886;189581;107;0;0;0;0;.00nan;0;0
8886;185240;94;68;10;0;10;1.000;611000;0
8886;196525;94;33;36;6;30;.833;2962000;0
8886;187391;107;32;25;5;20;.800;3600000;0
8887;194502;86;64;15;1;14;.933;3600000;0
8887;189628;89;31;19;5;14;.737;1523000;0
8887;195330;89;40;40;7;33;.825;2077000;0
8887;-1;86;0;0;0;0;.00nan;0;0
8888;192739;92;0;0;0;0;.00nan;0;0
8888;184225;93;0;0;0;0;.00nan;0;0
8888;190106;92;42;40;7;33;.825;3600000;0
8888;-1;93;93;30;1;29;.967;3600000;0
8889;189978;101;0;0;0;0;.00nan;0;0
8889;185240;94;98;35;2;33;.943;3599000;0
8889;196525;94;0;0;0;0;.00nan;0;0
8889;187096;101;70;19;1;18;.947;3600000;0
8890;183633;91;82;38;2;36;.947;3600000;0
8890;184081;88;78;41;4;37;.902;3591000;0
8890;189433;91;0;0;0;0;.00nan;0;0
8890;191318;88;0;0;0;0;.00nan;0;0
8891;184158;90;60;35;4;31;.886;3600000;0
8891;189581;107;90;32;1;31;.969;3600000;0
8891;-1;90;0;0;0;0;.00nan;0;0
8891;187391;107;0;0;0;0;.00nan;0;0
8892;189359;87;0;0;0;0;.00nan;0;0
8892;189644;95;29;32;7;25;.781;3600000;0
8892;195346;95;0;0;0;0;.00nan;0;0
8892;196495;87;70;18;1;17;.944;3600000;0
8893;182266;105;0;0;0;0;.00nan;0;0
8893;194632;102;73;21;1;20;.952;3677000;0
8893;189573;102;0;0;0;0;.00nan;0;0
8893;189639;105;86;42;2;40;.952;3677000;0
8894;184310;98;69;29;3;26;.897;3900000;0
8894;185220;104;87;45;3;42;.933;3900000;0
8894;186029;98;0;0;0;0;.00nan;0;0
8894;191255;104;0;0;0;0;.00nan;0;0
8895;189333;100;58;27;3;24;.889;3600000;0
8895;184229;106;80;44;4;40;.909;3548000;0
8895;184398;100;0;0;0;0;.00nan;0;0
8895;184866;106;0;0;0;0;.00nan;0;0
8896;194502;86;0;0;0;0;.00nan;0;0
8896;184081;88;0;0;0;0;.00nan;0;0
8896;-1;86;77;33;3;30;.909;3582000;0
8896;191318;88;77;31;2;29;.935;3600000;0
8897;182266;105;0;0;0;0;.00nan;0;0
8897;189581;107;0;0;0;0;.00nan;0;0
8897;189639;105;70;31;3;28;.903;3600000;0
8897;187391;107;67;25;2;23;.920;3600000;0
8898;192733;99;54;16;2;14;.875;3600000;0
8898;194531;99;0;0;0;0;.00nan;0;0
8898;185240;94;90;30;1;29;.967;3148000;0
8898;196525;94;25;12;4;8;.667;452000;0
8899;189628;89;0;0;0;0;.00nan;0;0
8899;184437;96;49;30;5;25;.833;3591000;0
8899;195330;89;72;42;3;39;.929;3600000;0
8899;184770;96;0;0;0;0;.00nan;0;0
8900;184225;93;0;0;0;0;.00nan;0;0
8900;189644;95;69;18;1;17;.944;3600000;0
8900;195346;95;0;0;0;0;.00nan;0;0
8900;-1;93;41;34;5;29;.853;3600000;0
8901;192733;99;0;0;0;0;.00nan;0;0
8901;194531;99;76;26;1;25;.962;3600000;0
8901;185240;94;50;1;0;1;1.000;544000;0
8901;196525;94;36;30;6;24;.800;3056000;0
8902;184158;90;67;22;2;20;.909;3600000;0
8902;-1;90;0;0;0;0;.00nan;0;0
8902;185220;104;85;44;3;41;.932;3600000;0
8902;191255;104;0;0;0;0;.00nan;0;0
8903;194632;102;47;23;4;19;.826;3600000;0
8903;189573;102;0;0;0;0;.00nan;0;0
8903;189978;101;31;35;6;29;.829;3145000;0
8903;187096;101;43;5;1;4;.800;455000;0
8904;183633;91;70;34;2;32;.941;3900000;0
8904;189433;91;0;0;0;0;.00nan;0;0
8904;184437;96;0;0;0;0;.00nan;0;0
8904;184770;96;62;24;2;22;.917;3900000;0
8905;184225;93;51;26;4;22;.846;3600000;0
8905;189576;97;0;0;0;0;.00nan;0;0
8905;-1;93;0;0;0;0;.00nan;0;0
8905;191331;97;96;33;1;32;.970;3600000;0
8906;178384;103;100;29;0;29;1.000;3600000;0
8906;189333;100;0;0;0;0;.00nan;0;0
8906;184398;100;73;32;3;29;.906;3600000;0
8906;196473;103;0;0;0;0;.00nan;0;0
8907;182266;105;0;0;0;0;.00nan;0;0
8907;184158;90;60;30;3;27;.900;3545000;0
8907;189639;105;73;28;2;26;.929;3600000;0
8907;-1;90;0;0;0;0;.00nan;0;0
8908;194632;102;0;0;0;0;.00nan;0;0
8908;189573;102;47;21;4;17;.810;3600000;0
8908;189978;101;47;13;2;11;.846;439000;0
8908;187096;101;36;32;6;26;.813;3161000;0
8909;189359;87;0;0;0;0;.00nan;0;0
8909;184081;88;21;31;7;24;.774;2097000;0
8909;196495;87;83;31;2;29;.935;3600000;0
8909;191318;88;56;14;1;13;.929;1503000;0
8910;194502;86;67;17;1;16;.941;3600000;0
8910;184437;96;66;45;5;40;.889;3600000;0
8910;184770;96;0;0;0;0;.00nan;0;0
8910;-1;86;0;0;0;0;.00nan;0;0
8911;184158;90;100;44;2;42;.955;3900000;0
8911;189576;97;55;19;2;17;.895;3900000;0
8911;-1;90;0;0;0;0;.00nan;0;0
8911;191331;97;0;0;0;0;.00nan;0;0
8912;183633;91;0;0;0;0;.00nan;0;0
8912;189433;91;74;39;4;35;.897;3581000;0
8912;184225;93;0;0;0;0;.00nan;0;0
8912;-1;93;72;31;3;28;.903;3600000;0
8913;189628;89;76;25;1;24;.960;3600000;0
8913;189644;95;44;22;3;19;.864;3600000;0
8913;195330;89;0;0;0;0;.00nan;0;0
8913;195346;95;0;0;0;0;.00nan;0;0
8914;192739;92;0;0;0;0;.00nan;0;0
8914;190106;92;72;29;2;27;.931;3600000;0
8914;185240;94;0;0;0;0;.00nan;0;0
8914;196525;94;25;29;6;23;.793;3600000;0
8915;194632;102;49;21;3;18;.857;3600000;0
8915;189573;102;0;0;0;0;.00nan;0;0
8915;189978;101;0;0;0;0;.00nan;0;0
8915;187096;101;58;40;5;35;.875;3575000;0
8916;178384;103;83;35;2;33;.943;3615000;0
8916;189581;107;0;0;0;0;.00nan;0;0
8916;196473;103;0;0;0;0;.00nan;0;0
8916;187391;107;78;32;3;29;.906;3615000;0
8917;189333;100;33;23;4;19;.826;3513000;0
8917;184310;98;69;24;2;22;.917;3600000;0
8917;184398;100;0;0;0;0;.00nan;0;0
8917;186029;98;0;0;0;0;.00nan;0;0
8918;192733;99;0;0;0;0;.00nan;0;0
8918;194531;99;59;20;2;18;.900;3600000;0
8918;185220;104;0;0;0;0;.00nan;0;0
8918;191255;104;79;39;3;36;.923;3551000;0
8919;189359;87;0;0;0;0;.00nan;0;0
8919;184437;96;73;16;0;16;1.000;936000;0
8919;184770;96;31;26;6;20;.769;2664000;0
8919;196495;87;48;24;4;20;.833;3600000;0
8920;183633;91;86;31;1;30;.968;3900000;0
8920;194502;86;0;0;0;0;.00nan;0;0
8920;189433;91;0;0;0;0;.00nan;0;0
8920;-1;86;85;29;1;28;.966;3900000;0
8921;178384;103;57;33;4;29;.879;3535000;0
8921;189581;107;93;40;2;38;.950;3600000;0
8921;196473;103;0;0;0;0;.00nan;0;0
8921;187391;107;0;0;0;0;.00nan;0;0
8922;189644;95;0;0;0;0;.00nan;0;0
8922;195346;95;39;21;4;17;.810;3875000;0
8922;185240;94;75;43;4;39;.907;3900000;0
8922;196525;94;0;0;0;0;.00nan;0;0
8923;189333;100;0;0;0;0;.00nan;0;0
8923;184229;106;0;0;0;0;.00nan;0;0
8923;184398;100;92;25;0;25;1.000;3600000;0
8923;184866;106;73;49;5;44;.898;3600000;0
8924;182266;105;0;0;0;0;.00nan;0;0
8924;192733;99;50;29;4;25;.862;3547000;0
8924;194531;99;0;0;0;0;.00nan;0;0
8924;189639;105;71;31;2;29;.935;3600000;0
8925;184310;98;0;0;0;0;.00nan;0;0
8925;185220;104;76;35;3;32;.914;3900000;0
8925;186029;98;37;24;3;21;.875;3900000;0
8925;191255;104;0;0;0;0;.00nan;0;0
8926;194632;102;57;28;3;25;.893;3600000;0
8926;189573;102;0;0;0;0;.00nan;0;0
8926;189978;101;0;0;0;0;.00nan;0;0
8926;187096;101;42;25;5;20;.800;3538000;0
8927;194502;86;57;33;4;29;.879;3600000;0
8927;184225;93;0;0;0;0;.00nan;0;0
8927;-1;93;66;32;3;29;.906;3600000;0
8927;-1;86;0;0;0;0;.00nan;0;0
8928;192739;92;53;36;5;31;.861;3583000;0
8928;189628;89;62;26;3;23;.885;3600000;0
8928;195330;89;0;0;0;0;.00nan;0;0
8928;190106;92;0;0;0;0;.00nan;0;0
8929;178384;103;68;26;3;23;.885;3600000;0
8929;185220;104;56;37;4;33;.892;3549000;0
8929;196473;103;0;0;0;0;.00nan;0;0
8929;191255;104;0;0;0;0;.00nan;0;0
8930;192733;99;0;0;0;0;.00nan;0;0
8930;194531;99;84;36;3;33;.917;3600000;0
8930;189581;107;56;2;0;2;1.000;540000;0
8930;187391;107;23;27;6;21;.778;3060000;0
8931;182266;105;62;16;1;15;.938;1313000;0
8931;184310;98;44;27;4;23;.852;3600000;0
8931;189639;105;16;28;7;21;.750;2287000;0
8931;186029;98;0;0;0;0;.00nan;0;0
8932;184081;88;75;46;5;41;.891;3600000;0
8932;189644;95;58;21;2;19;.905;3600000;0
8932;195346;95;0;0;0;0;.00nan;0;0
8932;191318;88;0;0;0;0;.00nan;0;0
8933;194632;102;45;16;3;13;.813;3600000;0
8933;184229;106;49;35;5;30;.857;2130000;0
8933;189573;102;0;0;0;0;.00nan;0;0
8933;184866;106;59;16;1;15;.938;1470000;0
8934;189628;89;70;29;3;26;.897;3564000;0
8934;189644;95;0;0;0;0;.00nan;0;0
8934;195330;89;0;0;0;0;.00nan;0;0
8934;195346;95;87;29;1;28;.966;3600000;0
8935;184225;93;0;0;0;0;.00nan;0;0
8935;184437;96;33;31;6;25;.806;3600000;0
8935;184770;96;0;0;0;0;.00nan;0;0
8935;-1;93;69;31;3;28;.903;3600000;0
8936;184081;88;73;36;3;33;.917;3600000;0
8936;189628;89;65;37;4;33;.892;3600000;0
8936;195330;89;0;0;0;0;.00nan;0;0
8936;191318;88;0;0;0;0;.00nan;0;0
8937;194502;86;49;30;4;26;.867;3600000;0
8937;184225;93;0;0;0;0;.00nan;0;0
8937;-1;93;91;49;3;46;.939;3600000;0
8937;-1;86;0;0;0;0;.00nan;0;0
8938;189359;87;0;0;0;0;.00nan;0;0
8938;189978;101;0;0;0;0;.00nan;0;0
8938;196495;87;55;28;4;24;.857;3553000;0
8938;187096;101;71;33;3;30;.909;3600000;0
8939;184158;90;36;15;3;12;.800;3521000;0
8939;189644;95;87;28;1;27;.964;3600000;0
8939;195346;95;0;0;0;0;.00nan;0;0
8939;-1;90;0;0;0;0;.00nan;0;0
8940;189576;97;0;0;0;0;.00nan;0;0
8940;184437;96;47;29;5;24;.828;3600000;0
8940;184770;96;0;0;0;0;.00nan;0;0
8940;191331;97;61;33;4;29;.879;3600000;0
8941;192739;92;0;0;0;0;.00nan;0;0
8941;183633;91;93;18;0;18;1.000;3600000;0
8941;189433;91;0;0;0;0;.00nan;0;0
8941;190106;92;56;44;6;38;.864;3600000;0
8942;182266;105;0;0;0;0;.00nan;0;0
8942;189581;107;0;0;0;0;.00nan;0;0
8942;189639;105;57;30;4;26;.867;3667000;0
8942;187391;107;83;38;3;35;.921;3633000;0
8943;192733;99;52;31;4;27;.871;3600000;0
8943;194531;99;0;0;0;0;.00nan;0;0
8943;194632;102;32;20;5;15;.750;3594000;0
8943;189573;102;0;0;0;0;.00nan;0;0
8944;184229;106;0;0;0;0;.00nan;0;0
8944;184866;106;73;22;2;20;.909;3600000;0
8944;185220;104;54;39;5;34;.872;3600000;0
8944;191255;104;0;0;0;0;.00nan;0;0
8945;184310;98;0;0;0;0;.00nan;0;0
8945;185240;94;0;0;0;0;.00nan;0;0
8945;196525;94;71;33;3;30;.909;3600000;0
8945;186029;98;78;51;5;46;.902;3535000;0
8946;184081;88;95;34;2;32;.941;3600000;0
8946;189978;101;15;28;7;21;.750;3600000;0
8946;187096;101;0;0;0;0;.00nan;0;0
8946;191318;88;0;0;0;0;.00nan;0;0
8947;184158;90;39;24;4;20;.833;3633000;0
8947;189628;89;0;0;0;0;.00nan;0;0
8947;195330;89;77;46;5;41;.891;3633000;0
8947;-1;90;0;0;0;0;.00nan;0;0
8948;194502;86;0;0;0;0;.00nan;0;0
8948;189644;95;0;0;0;0;.00nan;0;0
8948;195346;95;56;32;5;27;.844;3600000;0
8948;-1;86;63;25;2;23;.920;3600000;0
8949;189333;100;0;0;0;0;.00nan;0;0
8949;189359;87;52;12;1;11;.917;1763000;0
8949;184398;100;34;22;5;17;.773;3600000;0
8949;196495;87;24;27;6;21;.778;1819000;0
8950;189576;97;26;28;6;22;.786;2136000;0
8950;184437;96;0;0;0;0;.00nan;0;0
8950;184770;96;78;21;1;20;.952;3600000;0
8950;191331;97;66;11;0;11;1.000;1464000;0
8951;184229;106;48;52;8;44;.846;3600000;0
8951;189581;107;75;23;1;22;.957;3600000;0
8951;184866;106;0;0;0;0;.00nan;0;0
8951;187391;107;0;0;0;0;.00nan;0;0
8952;192733;99;97;33;0;33;1.000;3359000;0
8952;194531;99;29;9;3;6;.667;241000;0
8952;194632;102;0;0;0;0;.00nan;0;0
8952;189573;102;96;23;0;23;1.000;3600000;0
8953;192739;92;66;39;4;35;.897;3600000;0
8953;183633;91;95;28;1;27;.964;3600000;0
8953;189433;91;0;0;0;0;.00nan;0;0
8953;190106;92;0;0;0;0;.00nan;0;0
8954;178384;103;37;34;6;28;.824;3600000;0
8954;185220;104;0;0;0;0;.00nan;0;0
8954;196473;103;0;0;0;0;.00nan;0;0
8954;191255;104;72;36;3;33;.917;3600000;0
8955;184310;98;43;25;4;21;.840;3900000;0
8955;185240;94;75;43;4;39;.907;3900000;0
8955;196525;94;0;0;0;0;.00nan;0;0
8955;186029;98;0;0;0;0;.00nan;0;0
8956;184158;90;26;30;7;23;.767;3600000;0
8956;184225;93;0;0;0;0;.00nan;0;0
8956;-1;90;0;0;0;0;.00nan;0;0
8956;-1;93;68;29;3;26;.897;3600000;0
8957;189581;107;0;0;0;0;.00nan;0;0
8957;185240;94;0;0;0;0;.00nan;0;0
8957;196525;94;83;41;3;38;.927;3600000;0
8957;187391;107;51;31;5;26;.839;3583000;0
8958;182266;105;39;37;6;31;.838;3593000;0
8958;178384;103;44;30;5;25;.833;3600000;0
8958;189639;105;0;0;0;0;.00nan;0;0
8958;196473;103;0;0;0;0;.00nan;0;0
8959;189333;100;0;0;0;0;.00nan;0;0
8959;189628;89;65;49;5;44;.898;3600000;0
8959;184398;100;85;37;2;35;.946;3600000;0
8959;195330;89;0;0;0;0;.00nan;0;0
8960;194502;86;44;27;4;23;.852;3900000;0
8960;189978;101;0;0;0;0;.00nan;0;0
8960;187096;101;45;28;4;24;.857;3900000;0
8960;-1;86;0;0;0;0;.00nan;0;0
8961;189333;100;20;31;7;24;.774;3286000;0
8961;184081;88;59;44;6;38;.864;3600000;0
8961;184398;100;51;2;0;2;1.000;268000;0
8961;191318;88;0;0;0;0;.00nan;0;0
8962;184158;90;88;28;1;27;.964;3600000;0
8962;189978;101;55;22;2;20;.909;3571000;0
8962;-1;90;0;0;0;0;.00nan;0;0
8962;187096;101;0;0;0;0;.00nan;0;0
8963;184225;93;71;35;3;32;.914;3600000;0
8963;189644;95;49;26;4;22;.846;3537000;0
8963;195346;95;0;0;0;0;.00nan;0;0
8963;-1;93;0;0;0;0;.00nan;0;0
8964;183633;91;90;17;0;17;1.000;3600000;0
8964;189433;91;0;0;0;0;.00nan;0;0
8964;189576;97;0;0;0;0;.00nan;0;0
8964;191331;97;84;36;2;34;.944;3538000;0
8965;178384;103;58;26;3;23;.885;3900000;0
8965;189581;107;0;0;0;0;.00nan;0;0
8965;196473;103;0;0;0;0;.00nan;0;0
8965;187391;107;69;34;3;31;.912;3900000;0
8966;182266;105;0;0;0;0;.00nan;0;0
8966;184229;106;0;0;0;0;.00nan;0;0
8966;189639;105;35;27;5;22;.815;3561000;0
8966;184866;106;54;36;4;32;.889;3600000;0
8967;192733;99;73;31;3;28;.903;3600000;0
8967;194531;99;0;0;0;0;.00nan;0;0
8967;185240;94;0;0;0;0;.00nan;0;0
8967;196525;94;54;40;5;35;.875;3600000;0
8968;189644;95;0;0;0;0;.00nan;0;0
8968;184437;96;71;24;2;22;.917;3600000;0
8968;195346;95;54;25;3;22;.880;3555000;0
8968;184770;96;0;0;0;0;.00nan;0;0
8969;189628;89;45;29;4;25;.862;3737000;0
8969;195330;89;0;0;0;0;.00nan;0;0
8969;189978;101;0;0;0;0;.00nan;0;0
8969;187096;101;73;40;5;35;.875;3737000;0
8970;194502;86;79;29;2;27;.931;3600000;0
8970;189333;100;0;0;0;0;.00nan;0;0
8970;184398;100;61;31;3;28;.903;3600000;0
8970;-1;86;0;0;0;0;.00nan;0;0
8971;183633;91;38;42;7;35;.833;3600000;0
8971;189433;91;0;0;0;0;.00nan;0;0
8971;184225;93;0;0;0;0;.00nan;0;0
8971;-1;93;92;19;0;19;1.000;3600000;0
8972;189359;87;0;0;0;0;.00nan;0;0
8972;189576;97;38;40;6;34;.850;3295000;0
8972;196495;87;77;28;1;27;.964;3600000;0
8972;191331;97;30;2;2;0;.000;305000;0
8973;192739;92;0;0;0;0;.00nan;0;0
8973;184437;96;0;0;0;0;.00nan;0;0
8973;184770;96;55;34;4;30;.882;3600000;0
8973;190106;92;70;49;6;43;.878;3526000;0
8974;192733;99;88;37;2;35;.946;3600000;0
8974;178384;103;40;25;4;21;.840;3561000;0
8974;194531;99;0;0;0;0;.00nan;0;0
8974;196473;103;0;0;0;0;.00nan;0;0
8975;184229;106;98;47;3;44;.936;3600000;0
8975;184310;98;0;0;0;0;.00nan;0;0
8975;184866;106;0;0;0;0;.00nan;0;0
8975;186029;98;49;28;4;24;.857;3563000;0
8976;182266;105;0;0;0;0;.00nan;0;0
8976;189581;107;0;0;0;0;.00nan;0;0
8976;189639;105;80;31;2;29;.935;3676000;0
8976;187391;107;63;28;3;25;.893;3676000;0
8977;194632;102;63;20;2;18;.900;3600000;0
8977;189573;102;0;0;0;0;.00nan;0;0
8977;185220;104;98;52;3;49;.942;3544000;0
8977;191255;104;0;0;0;0;.00nan;0;0
8978;184081;88;78;31;2;29;.935;3900000;0
8978;189628;89;0;0;0;0;.00nan;0;0
8978;195330;89;64;25;2;23;.920;3900000;0
8978;191318;88;0;0;0;0;.00nan;0;0
8979;189333;100;55;36;5;31;.861;3544000;0
8979;184158;90;49;31;4;27;.871;3600000;0
8979;184398;100;0;0;0;0;.00nan;0;0
8979;-1;90;0;0;0;0;.00nan;0;0
8980;183633;91;0;0;0;0;.00nan;0;0
8980;189433;91;81;33;2;31;.939;3600000;0
8980;189576;97;51;3;0;3;1.000;320000;0
8980;191331;97;53;41;6;35;.854;3280000;0
8981;182266;105;0;0;0;0;.00nan;0;0
8981;189581;107;74;39;3;36;.923;3600000;0
8981;189639;105;45;29;5;24;.828;3577000;0
8981;187391;107;0;0;0;0;.00nan;0;0
8982;189359;87;0;0;0;0;.00nan;0;0
8982;189644;95;58;19;2;17;.895;3600000;0
8982;195346;95;0;0;0;0;.00nan;0;0
8982;196495;87;69;40;5;35;.875;3600000;0
8983;184229;106;0;0;0;0;.00nan;0;0
8983;184866;106;99;49;2;47;.959;3600000;0
8983;185240;94;68;28;3;25;.893;3553000;0
8983;196525;94;0;0;0;0;.00nan;0;0
8984;194632;102;0;0;0;0;.00nan;0;0
8984;189573;102;46;18;3;15;.833;3600000;0
8984;185220;104;63;43;5;38;.884;3600000;0
8984;191255;104;0;0;0;0;.00nan;0;0
8985;192733;99;64;11;0;11;1.000;1507000;0
8985;194531;99;25;25;6;19;.760;2093000;0
8985;184310;98;76;35;3;32;.914;3600000;0
8985;186029;98;0;0;0;0;.00nan;0;0
8986;184225;93;0;0;0;0;.00nan;0;0
8986;184437;96;82;34;2;32;.941;3600000;0
8986;184770;96;0;0;0;0;.00nan;0;0
8986;-1;93;51;30;4;26;.867;3544000;0
8987;192739;92;0;0;0;0;.00nan;0;0
8987;189359;87;0;0;0;0;.00nan;0;0
8987;190106;92;80;35;2;33;.943;3600000;0
8987;196495;87;29;23;5;18;.783;3600000;0
8988;178384;103;49;34;5;29;.853;3600000;0
8988;185240;94;0;0;0;0;.00nan;0;0
8988;196473;103;0;0;0;0;.00nan;0;0
8988;196525;94;75;32;2;30;.938;3600000;0
8989;184229;106;70;42;4;38;.905;3600000;0
8989;184310;98;0;0;0;0;.00nan;0;0
8989;184866;106;0;0;0;0;.00nan;0;0
8989;186029;98;72;24;1;23;.958;3600000;0
8990;189359;87;0;0;0;0;.00nan;0;0
8990;184081;88;64;37;5;32;.865;3900000;0
8990;196495;87;45;40;5;35;.875;3900000;0
8990;191318;88;0;0;0;0;.00nan;0;0
8991;194502;86;68;18;1;17;.944;3600000;0
8991;184158;90;0;0;0;0;.00nan;0;0
8991;-1;90;67;27;2;25;.926;3548000;0
8991;-1;86;0;0;0;0;.00nan;0;0
8992;189576;97;0;0;0;0;.00nan;0;0
8992;184437;96;0;0;0;0;.00nan;0;0
8992;184770;96;64;47;4;43;.915;3600000;0
8992;191331;97;66;33;3;30;.909;3600000;0
8993;183633;91;19;23;6;17;.739;3263000;0
8993;189433;91;48;0;0;0;.00nan;337000;0
8993;189644;95;87;36;1;35;.972;3600000;0
8993;195346;95;0;0;0;0;.00nan;0;0
8994;189333;100;0;0;0;0;.00nan;0;0
8994;184398;100;100;26;0;26;1.000;3600000;0
8994;189978;101;0;0;0;0;.00nan;0;0
8994;187096;101;90;52;4;48;.923;3600000;0
8995;192733;99;41;16;3;13;.813;3532000;0
8995;192739;92;0;0;0;0;.00nan;0;0
8995;194531;99;0;0;0;0;.00nan;0;0
8995;190106;92;99;44;1;43;.977;3600000;0
8996;194632;102;56;25;3;22;.880;3600000;0
8996;189573;102;0;0;0;0;.00nan;0;0
8996;184310;98;0;0;0;0;.00nan;0;0
8996;186029;98;51;36;5;31;.861;3528000;0
8997;182266;105;0;0;0;0;.00nan;0;0
8997;178384;103;65;38;4;34;.895;3900000;0
8997;189639;105;57;31;4;27;.871;3900000;0
8997;196473;103;0;0;0;0;.00nan;0;0
8998;189439;107;73;30;2;28;.933;3600000;0
8998;189581;107;0;0;0;0;.00nan;0;0
8998;185220;104;68;45;5;40;.889;3600000;0
8998;191255;104;0;0;0;0;.00nan;0;0
8999;178384;103;0;0;0;0;.00nan;0;0
8999;194632;102;0;0;0;0;.00nan;0;0
8999;189573;102;55;22;3;19;.864;3600000;0
8999;196473;103;31;34;7;27;.794;3600000;0
9000;189439;107;0;0;0;0;.00nan;0;0
9000;184229;106;0;0;0;0;.00nan;0;0
9000;189581;107;70;34;3;31;.912;3600000;0
9000;184866;106;74;42;5;37;.881;3561000;0
9001;192733;99;0;0;0;0;.00nan;0;0
9001;194531;99;75;35;3;32;.914;3600000;0
9001;184225;93;0;0;0;0;.00nan;0;0
9001;-1;93;72;49;5;44;.898;3560000;0
9002;184081;88;86;41;3;38;.927;3600000;0
9002;184158;90;96;17;0;17;1.000;3600000;0
9002;-1;90;0;0;0;0;.00nan;0;0
9002;191318;88;0;0;0;0;.00nan;0;0
9003;189359;87;0;0;0;0;.00nan;0;0
9003;189628;89;47;38;5;33;.868;3558000;0
9003;195330;89;0;0;0;0;.00nan;0;0
9003;196495;87;66;40;4;36;.900;3600000;0
9004;189576;97;53;42;5;37;.881;3600000;0
9004;189644;95;64;19;1;18;.947;3600000;0
9004;195346;95;0;0;0;0;.00nan;0;0
9004;191331;97;0;0;0;0;.00nan;0;0
9005;183633;91;70;33;3;30;.909;3593000;0
9005;189433;91;0;0;0;0;.00nan;0;0
9005;184437;96;83;30;1;29;.967;3600000;0
9005;184770;96;0;0;0;0;.00nan;0;0
9006;192739;92;42;42;6;36;.857;2720000;0
9006;184310;98;70;33;3;30;.909;3600000;0
9006;190106;92;27;15;4;11;.733;880000;0
9006;186029;98;0;0;0;0;.00nan;0;0
9007;189333;100;0;0;0;0;.00nan;0;0
9007;184398;100;82;40;3;37;.925;3568000;0
9007;189978;101;0;0;0;0;.00nan;0;0
9007;187096;101;83;37;2;35;.946;3600000;0
9008;194502;86;70;34;3;31;.912;3900000;0
9008;189628;89;0;0;0;0;.00nan;0;0
9008;195330;89;79;36;3;33;.917;3900000;0
9008;-1;86;0;0;0;0;.00nan;0;0
9009;189359;87;71;31;3;28;.903;3600000;0
9009;184081;88;26;6;3;3;.500;530000;0
9009;196495;87;0;0;0;0;.00nan;0;0
9009;191318;88;45;29;5;24;.828;3070000;0
9010;189644;95;0;0;0;0;.00nan;0;0
9010;184437;96;0;0;0;0;.00nan;0;0
9010;195346;95;74;25;2;23;.920;3600000;0
9010;184770;96;43;36;5;31;.861;3600000;0
9011;192733;99;100;31;0;31;1.000;3600000;0
9011;194531;99;0;0;0;0;.00nan;0;0
9011;189978;101;48;27;4;23;.852;3600000;0
9011;187096;101;0;0;0;0;.00nan;0;0
9012;183633;91;0;0;0;0;.00nan;0;0
9012;189433;91;53;23;3;20;.870;3600000;0
9012;189576;97;0;0;0;0;.00nan;0;0
9012;191331;97;69;45;4;41;.911;3547000;0
9013;184229;106;83;54;5;49;.907;3600000;0
9013;184866;106;0;0;0;0;.00nan;0;0
9013;185240;94;48;16;3;13;.813;3600000;0
9013;196525;94;0;0;0;0;.00nan;0;0
9014;182266;105;0;0;0;0;.00nan;0;0
9014;189639;105;55;24;3;21;.875;3587000;0
9014;185220;104;100;54;1;53;.981;3600000;0
9014;191255;104;0;0;0;0;.00nan;0;0
9015;192739;92;60;8;0;8;1.000;383000;0
9015;194632;102;62;15;1;14;.933;3600000;0
9015;189573;102;0;0;0;0;.00nan;0;0
9015;190106;92;81;59;6;53;.898;3217000;0
9016;189333;100;67;34;4;30;.882;3600000;0
9016;184225;93;0;0;0;0;.00nan;0;0
9016;184398;100;0;0;0;0;.00nan;0;0
9016;-1;93;34;25;5;20;.800;3585000;0
9017;178384;103;52;27;4;23;.852;3596000;0
9017;184229;106;0;0;0;0;.00nan;0;0
9017;184866;106;84;32;3;29;.906;3600000;0
9017;196473;103;0;0;0;0;.00nan;0;0
9018;189439;107;65;30;4;26;.867;3600000;0
9018;189581;107;0;0;0;0;.00nan;0;0
9018;184310;98;0;0;0;0;.00nan;0;0
9018;186029;98;45;35;5;30;.857;3583000;0
9019;182266;105;0;0;0;0;.00nan;0;0
9019;189639;105;74;26;2;24;.923;3600000;0
9019;185220;104;0;0;0;0;.00nan;0;0
9019;191255;104;51;47;6;41;.872;3600000;0
9020;189359;87;0;0;0;0;.00nan;0;0
9020;189628;89;78;54;5;49;.907;3669000;0
9020;195330;89;0;0;0;0;.00nan;0;0
9020;196495;87;56;27;4;23;.852;3669000;0
9021;184081;88;79;47;4;43;.915;3600000;0
9021;184158;90;59;18;2;16;.889;3600000;0
9021;-1;90;0;0;0;0;.00nan;0;0
9021;191318;88;0;0;0;0;.00nan;0;0
9022;194632;102;44;25;4;21;.840;3600000;0
9022;184225;93;100;34;0;34;1.000;3600000;0
9022;189573;102;0;0;0;0;.00nan;0;0
9022;-1;93;0;0;0;0;.00nan;0;0
9023;192739;92;0;0;0;0;.00nan;0;0
9023;190106;92;70;45;4;41;.911;3600000;0
9023;185240;94;0;0;0;0;.00nan;0;0
9023;196525;94;54;21;3;18;.857;3600000;0
9024;183633;91;66;23;2;21;.913;3600000;0
9024;189433;91;0;0;0;0;.00nan;0;0
9024;189644;95;24;26;6;20;.769;2475000;0
9024;195346;95;53;10;1;9;.900;1125000;0
9025;189576;97;76;40;4;36;.900;3600000;0
9025;184437;96;79;20;1;19;.950;3600000;0
9025;184770;96;0;0;0;0;.00nan;0;0
9025;191331;97;0;0;0;0;.00nan;0;0
9026;192733;99;99;44;2;42;.955;3600000;0
9026;178384;103;55;28;3;25;.893;3560000;0
9026;194531;99;0;0;0;0;.00nan;0;0
9026;196473;103;0;0;0;0;.00nan;0;0
9027;192739;92;0;0;0;0;.00nan;0;0
9027;189978;101;0;0;0;0;.00nan;0;0
9027;190106;92;91;34;1;33;.971;3600000;0
9027;187096;101;55;26;3;23;.885;3577000;0
9028;184225;93;87;34;1;33;.971;3598000;0
9028;184310;98;0;0;0;0;.00nan;0;0
9028;-1;93;0;0;0;0;.00nan;0;0
9028;186029;98;100;29;0;29;1.000;3600000;0
9029;194502;86;41;29;5;24;.828;3600000;0
9029;189628;89;41;34;6;28;.824;2768000;0
9029;195330;89;59;4;0;4;1.000;832000;0
9029;-1;86;0;0;0;0;.00nan;0;0
9030;189359;87;0;0;0;0;.00nan;0;0
9030;184158;90;58;28;3;25;.893;3600000;0
9030;-1;90;0;0;0;0;.00nan;0;0
9030;196495;87;80;26;1;25;.962;3600000;0
9031;182266;105;0;0;0;0;.00nan;0;0
9031;189639;105;69;27;2;25;.926;3588000;0
9031;184437;96;95;29;1;28;.966;3600000;0
9031;184770;96;0;0;0;0;.00nan;0;0
9032;189576;97;65;18;1;17;.944;3600000;0
9032;185220;104;31;9;3;6;.667;343000;0
9032;191255;104;66;33;3;30;.909;3257000;0
9032;191331;97;0;0;0;0;.00nan;0;0
9033;183633;91;62;21;2;19;.905;3600000;0
9033;189433;91;0;0;0;0;.00nan;0;0
9033;189644;95;72;37;3;34;.919;3552000;0
9033;195346;95;0;0;0;0;.00nan;0;0
9034;184225;93;0;0;0;0;.00nan;0;0
9034;189978;101;0;0;0;0;.00nan;0;0
9034;-1;93;47;32;5;27;.844;3600000;0
9034;187096;101;50;27;4;23;.852;3600000;0
9035;189439;107;55;17;2;15;.882;3600000;0
9035;189581;107;0;0;0;0;.00nan;0;0
9035;185240;94;38;33;6;27;.818;3182000;0
9035;196525;94;41;2;1;1;.500;418000;0
9036;192739;92;0;0;0;0;.00nan;0;0
9036;189333;100;0;0;0;0;.00nan;0;0
9036;184398;100;86;22;1;21;.955;3600000;0
9036;190106;92;75;46;4;42;.913;3600000;0
9037;192733;99;51;38;6;32;.842;2630000;0
9037;194531;99;51;23;3;20;.870;970000;0
9037;184229;106;83;27;2;25;.926;3600000;0
9037;184866;106;0;0;0;0;.00nan;0;0
9038;184081;88;0;0;0;0;.00nan;0;0
9038;184310;98;0;0;0;0;.00nan;0;0
9038;186029;98;53;34;5;29;.853;3541000;0
9038;191318;88;48;30;4;26;.867;3600000;0
9039;194502;86;0;0;0;0;.00nan;0;0
9039;184158;90;0;0;0;0;.00nan;0;0
9039;-1;90;63;38;4;34;.895;3600000;0
9039;-1;86;36;26;5;21;.808;3594000;0
9040;194632;102;93;37;1;36;.973;3600000;0
9040;189359;87;0;0;0;0;.00nan;0;0
9040;189573;102;0;0;0;0;.00nan;0;0
9040;196495;87;97;43;2;41;.953;3554000;0
9041;189628;89;0;0;0;0;.00nan;0;0
9041;184437;96;0;0;0;0;.00nan;0;0
9041;195330;89;69;34;2;32;.941;3600000;0
9041;184770;96;63;31;3;28;.903;3570000;0
9042;183633;91;0;0;0;0;.00nan;0;0
9042;189433;91;99;39;1;38;.974;3900000;0
9042;185220;104;86;31;1;30;.968;3900000;0
9042;191255;104;0;0;0;0;.00nan;0;0
9043;192733;99;0;0;0;0;.00nan;0;0
9043;194531;99;71;31;3;28;.903;3600000;0
9043;189439;107;0;0;0;0;.00nan;0;0
9043;189581;107;72;26;2;24;.923;3600000;0
9044;178384;103;80;41;3;38;.927;3600000;0
9044;189333;100;39;29;6;23;.793;2787000;0
9044;184398;100;54;7;0;7;1.000;813000;0
9044;196473;103;0;0;0;0;.00nan;0;0
9045;184229;106;0;0;0;0;.00nan;0;0
9045;184866;106;57;28;4;24;.857;3548000;0
9045;185240;94;0;0;0;0;.00nan;0;0
9045;196525;94;96;39;3;36;.923;3600000;0
9046;192739;92;85;31;1;30;.968;3600000;0
9046;184225;93;67;31;3;28;.903;3560000;0
9046;190106;92;0;0;0;0;.00nan;0;0
9046;-1;93;0;0;0;0;.00nan;0;0
9047;182266;105;0;0;0;0;.00nan;0;0
9047;183633;91;28;32;6;26;.813;2647000;0
9047;189433;91;46;8;1;7;.875;953000;0
9047;189639;105;61;34;4;30;.882;3600000;0
9048;192733;99;47;28;4;24;.857;3600000;0
9048;194531;99;0;0;0;0;.00nan;0;0
9048;185240;94;66;38;3;35;.921;3600000;0
9048;196525;94;0;0;0;0;.00nan;0;0
9049;194632;102;51;16;2;14;.875;3563000;0
9049;184081;88;92;51;1;50;.980;3600000;0
9049;189573;102;0;0;0;0;.00nan;0;0
9049;191318;88;0;0;0;0;.00nan;0;0
9050;194502;86;50;27;4;23;.852;3575000;0
9050;184310;98;0;0;0;0;.00nan;0;0
9050;186029;98;70;35;3;32;.914;3600000;0
9050;-1;86;0;0;0;0;.00nan;0;0
9051;182266;105;26;23;5;18;.783;3591000;0
9051;189576;97;0;0;0;0;.00nan;0;0
9051;189639;105;0;0;0;0;.00nan;0;0
9051;191331;97;53;29;4;25;.862;3600000;0
9052;184437;96;80;29;2;27;.931;3600000;0
9052;184770;96;0;0;0;0;.00nan;0;0
9052;185220;104;28;28;6;22;.786;1782000;0
9052;191255;104;46;28;4;24;.857;1818000;0
9053;194632;102;0;0;0;0;.00nan;0;0
9053;189573;102;36;23;4;19;.826;3900000;0
9053;189628;89;66;42;4;38;.905;3900000;0
9053;186155;89;0;0;0;0;.00nan;0;0
9054;184158;90;58;32;4;28;.875;3541000;0
9054;184310;98;46;20;3;17;.850;3600000;0
9054;-1;90;0;0;0;0;.00nan;0;0
9054;186029;98;0;0;0;0;.00nan;0;0
9055;182266;105;0;0;0;0;.00nan;0;0
9055;189639;105;79;25;1;24;.960;3600000;0
9055;189644;95;0;0;0;0;.00nan;0;0
9055;195346;95;47;48;8;40;.833;3600000;0
9056;189333;100;0;0;0;0;.00nan;0;0
9056;184229;106;49;34;5;29;.853;3600000;0
9056;184398;100;63;22;2;20;.909;3600000;0
9056;184866;106;0;0;0;0;.00nan;0;0
9057;192739;92;0;0;0;0;.00nan;0;0
9057;190106;92;63;19;2;17;.895;3600000;0
9057;185220;104;76;39;3;36;.923;3600000;0
9057;191255;104;0;0;0;0;.00nan;0;0
9058;182266;105;0;0;0;0;.00nan;0;0
9058;184225;93;0;0;0;0;.00nan;0;0
9058;189639;105;74;22;1;21;.955;3600000;0
9058;-1;93;75;35;4;31;.886;3600000;0
9059;184081;88;87;25;1;24;.960;3600000;0
9059;184437;96;60;32;3;29;.906;3560000;0
9059;184770;96;0;0;0;0;.00nan;0;0
9059;191318;88;0;0;0;0;.00nan;0;0
9060;194502;86;75;27;2;25;.926;3600000;0
9060;194632;102;73;38;3;35;.921;3592000;0
9060;189573;102;0;0;0;0;.00nan;0;0
9060;-1;86;0;0;0;0;.00nan;0;0
9061;189359;87;0;0;0;0;.00nan;0;0
9061;184310;98;0;0;0;0;.00nan;0;0
9061;196495;87;64;27;3;24;.889;3582000;0
9061;186029;98;89;30;2;28;.933;3600000;0
9062;183633;91;69;25;2;23;.920;3600000;0
9062;189433;91;0;0;0;0;.00nan;0;0
9062;189576;97;74;40;3;37;.925;3547000;0
9062;191331;97;0;0;0;0;.00nan;0;0
9063;189644;95;58;16;2;14;.875;3600000;0
9063;195346;95;0;0;0;0;.00nan;0;0
9063;185220;104;51;12;1;11;.917;1038000;0
9063;191255;104;32;34;6;28;.824;2562000;0
9064;189978;101;0;0;0;0;.00nan;0;0
9064;185240;94;0;0;0;0;.00nan;0;0
9064;196525;94;50;41;6;35;.854;3600000;0
9064;187096;101;53;19;2;17;.895;3600000;0
9065;192733;99;65;40;4;36;.900;3831000;0
9065;194531;99;0;0;0;0;.00nan;0;0
9065;189333;100;0;0;0;0;.00nan;0;0
9065;184398;100;54;31;5;26;.839;3831000;0
9066;184229;106;52;18;3;15;.833;1499000;0
9066;189581;107;48;38;6;32;.842;3600000;0
9066;184866;106;34;23;5;18;.783;2040000;0
9066;187391;107;0;0;0;0;.00nan;0;0
9067;189628;89;57;40;5;35;.875;3600000;0
9067;184310;98;86;33;1;32;.970;3600000;0
9067;186029;98;0;0;0;0;.00nan;0;0
9067;186155;89;0;0;0;0;.00nan;0;0
9068;194502;86;0;0;0;0;.00nan;0;0
9068;189359;87;72;33;2;31;.939;3600000;0
9068;196495;87;0;0;0;0;.00nan;0;0
9068;-1;86;46;28;4;24;.857;3549000;0
9069;194632;102;0;0;0;0;.00nan;0;0
9069;184158;90;53;22;3;19;.864;3600000;0
9069;189573;102;40;32;5;27;.844;3597000;0
9069;-1;90;0;0;0;0;.00nan;0;0
9070;183633;91;0;0;0;0;.00nan;0;0
9070;189433;91;87;29;1;28;.966;3600000;0
9070;189576;97;0;0;0;0;.00nan;0;0
9070;191331;97;69;30;2;28;.933;3569000;0
9071;184229;106;27;36;7;29;.806;3144000;0
9071;189581;107;0;0;0;0;.00nan;0;0
9071;184866;106;52;2;0;2;1.000;456000;0
9071;187391;107;81;41;3;38;.927;3600000;0
9072;192733;99;0;0;0;0;.00nan;0;0
9072;194531;99;92;34;2;32;.941;3600000;0
9072;189333;100;42;41;5;36;.878;3600000;0
9072;184398;100;0;0;0;0;.00nan;0;0
9073;192739;92;0;0;0;0;.00nan;0;0
9073;189644;95;0;0;0;0;.00nan;0;0
9073;195346;95;78;24;2;22;.917;3600000;0
9073;190106;92;91;38;1;37;.974;3600000;0
9074;189978;101;68;24;1;23;.958;3900000;0
9074;185240;94;100;43;1;42;.977;3900000;0
9074;196525;94;0;0;0;0;.00nan;0;0
9074;187096;101;0;0;0;0;.00nan;0;0
9075;194502;86;100;23;0;23;1.000;3600000;0
9075;184081;88;28;31;6;25;.806;3306000;0
9075;-1;86;0;0;0;0;.00nan;0;0
9075;191318;88;48;0;0;0;.00nan;294000;0
9076;184225;93;0;0;0;0;.00nan;0;0
9076;-1;93;62;15;1;14;.933;3600000;0
9076;185220;104;45;24;4;20;.833;3600000;0
9076;191255;104;0;0;0;0;.00nan;0;0
9077;189359;87;0;0;0;0;.00nan;0;0
9077;184158;90;57;7;0;7;1.000;1116000;0
9077;-1;90;14;24;6;18;.750;2484000;0
9077;196495;87;81;36;2;34;.944;3600000;0
9078;182266;105;0;0;0;0;.00nan;0;0
9078;192739;92;9;24;7;17;.708;2755000;0
9078;189639;105;100;35;3;32;.914;3600000;0
9078;190106;92;80;16;0;16;1.000;845000;0
9079;178384;103;88;23;1;22;.957;3600000;0
9079;184861;103;0;0;0;0;.00nan;0;0
9079;185240;94;0;0;0;0;.00nan;0;0
9079;196525;94;76;33;2;31;.939;3555000;0
9080;189581;107;67;36;4;32;.889;3579000;0
9080;189978;101;0;0;0;0;.00nan;0;0
9080;187096;101;90;41;2;39;.951;3600000;0
9080;187391;107;0;0;0;0;.00nan;0;0
9081;183633;91;100;46;1;45;.978;3600000;0
9081;189433;91;0;0;0;0;.00nan;0;0
9081;184437;96;48;28;5;23;.821;3600000;0
9081;184770;96;0;0;0;0;.00nan;0;0
9082;178384;103;36;33;6;27;.818;3600000;0
9082;189978;101;60;24;3;21;.875;3600000;0
9082;184861;103;0;0;0;0;.00nan;0;0
9082;187096;101;0;0;0;0;.00nan;0;0
9083;189576;97;98;45;1;44;.978;3600000;0
9083;189628;89;100;22;0;22;1.000;3600000;0
9083;186155;89;0;0;0;0;.00nan;0;0
9083;191331;97;0;0;0;0;.00nan;0;0
9084;184158;90;95;21;0;21;1.000;3600000;0
9084;189644;95;89;42;1;41;.976;3556000;0
9084;195346;95;0;0;0;0;.00nan;0;0
9084;-1;90;0;0;0;0;.00nan;0;0
9085;189333;100;0;0;0;0;.00nan;0;0
9085;189581;107;0;0;0;0;.00nan;0;0
9085;184398;100;56;26;3;23;.885;3600000;0
9085;187391;107;83;39;4;35;.897;3600000;0
9086;189359;87;58;29;4;25;.862;3600000;0
9086;189576;97;0;0;0;0;.00nan;0;0
9086;196495;87;0;0;0;0;.00nan;0;0
9086;191331;97;29;48;8;40;.833;3600000;0
9087;189628;89;56;22;3;19;.864;3600000;0
9087;184437;96;0;0;0;0;.00nan;0;0
9087;184770;96;52;31;4;27;.871;3558000;0
9087;186155;89;0;0;0;0;.00nan;0;0
9088;184158;90;67;19;2;17;.895;3600000;0
9088;184225;93;0;0;0;0;.00nan;0;0
9088;-1;90;0;0;0;0;.00nan;0;0
9088;-1;93;51;33;4;29;.879;3600000;0
9089;183633;91;76;29;2;27;.931;3521000;0
9089;189433;91;0;0;0;0;.00nan;0;0
9089;189644;95;100;37;0;37;1.000;3600000;0
9089;195346;95;0;0;0;0;.00nan;0;0
9090;192733;99;80;23;1;22;.957;3600000;0
9090;194531;99;0;0;0;0;.00nan;0;0
9090;189581;107;0;0;0;0;.00nan;0;0
9090;187391;107;44;40;7;33;.825;3600000;0
9091;192739;92;0;0;0;0;.00nan;0;0
9091;194502;86;74;24;1;23;.958;3600000;0
9091;190106;92;66;38;4;34;.895;3600000;0
9091;-1;86;0;0;0;0;.00nan;0;0
9092;189333;100;0;0;0;0;.00nan;0;0
9092;184310;98;0;0;0;0;.00nan;0;0
9092;184398;100;78;32;1;31;.969;3600000;0
9092;186029;98;62;22;2;20;.909;3600000;0
9093;182266;105;0;0;0;0;.00nan;0;0
9093;189639;105;85;28;1;27;.964;3600000;0
9093;185240;94;52;40;5;35;.875;3600000;0
9093;196525;94;0;0;0;0;.00nan;0;0
9094;184229;106;40;31;5;26;.839;3600000;0
9094;184866;106;0;0;0;0;.00nan;0;0
9094;185220;104;20;23;6;17;.739;1731000;0
9094;191255;104;29;20;5;15;.750;1869000;0
9095;194632;102;61;35;4;31;.886;3600000;0
9095;189573;102;0;0;0;0;.00nan;0;0
9095;189978;101;54;4;0;4;1.000;791000;0
9095;187096;101;39;34;6;28;.824;2809000;0
9096;184081;88;83;36;3;33;.917;3600000;0
9096;189576;97;57;30;4;26;.867;3543000;0
9096;191318;88;0;0;0;0;.00nan;0;0
9096;191331;97;0;0;0;0;.00nan;0;0
9097;189628;89;0;0;0;0;.00nan;0;0
9097;184437;96;39;21;4;17;.810;3600000;0
9097;184770;96;0;0;0;0;.00nan;0;0
9097;186155;89;88;27;1;26;.963;3600000;0
9098;183633;91;0;0;0;0;.00nan;0;0
9098;189359;87;48;10;1;9;.900;952000;0
9098;189433;91;82;37;3;34;.919;3600000;0
9098;196495;87;24;28;6;22;.786;2648000;0
9099;192733;99;0;0;0;0;.00nan;0;0
9099;194531;99;72;23;1;22;.957;3600000;0
9099;189581;107;97;43;2;41;.953;3600000;0
9099;187391;107;0;0;0;0;.00nan;0;0
9100;194502;86;0;0;0;0;.00nan;0;0
9100;189644;95;86;39;1;38;.974;3600000;0
9100;195346;95;0;0;0;0;.00nan;0;0
9100;-1;86;54;31;4;27;.871;3600000;0
9101;182266;105;68;29;4;25;.862;3742000;0
9101;178384;103;48;36;5;31;.861;3742000;0
9101;189639;105;0;0;0;0;.00nan;0;0
9101;184861;103;0;0;0;0;.00nan;0;0
9102;184229;106;0;0;0;0;.00nan;0;0
9102;184866;106;48;28;4;24;.857;3575000;0
9102;185220;104;79;37;3;34;.919;3600000;0
9102;191255;104;0;0;0;0;.00nan;0;0
9103;189333;100;47;31;4;27;.871;3544000;0
9103;184310;98;78;40;3;37;.925;3600000;0
9103;184398;100;0;0;0;0;.00nan;0;0
9103;186029;98;0;0;0;0;.00nan;0;0
9104;183633;91;57;26;3;23;.885;3567000;0
9104;184081;88;0;0;0;0;.00nan;0;0
9104;189433;91;0;0;0;0;.00nan;0;0
9104;191318;88;87;33;2;31;.939;3600000;0
9105;194502;86;23;10;4;6;.600;783000;0
9105;184225;93;86;33;1;32;.970;3600000;0
9105;-1;93;0;0;0;0;.00nan;0;0
9105;-1;86;13;17;6;11;.647;2817000;0
9106;192739;92;0;0;0;0;.00nan;0;0
9106;184158;90;100;35;1;34;.971;3600000;0
9106;190106;92;68;33;3;30;.909;3568000;0
9106;-1;90;0;0;0;0;.00nan;0;0
9107;194632;102;0;0;0;0;.00nan;0;0
9107;189573;102;72;21;1;20;.952;3600000;0
9107;189978;101;56;30;4;26;.867;3600000;0
9107;187096;101;0;0;0;0;.00nan;0;0
9108;185220;104;0;0;0;0;.00nan;0;0
9108;185240;94;100;27;0;27;1.000;3600000;0
9108;196525;94;0;0;0;0;.00nan;0;0
9108;191255;104;38;34;6;28;.824;3600000;0
9109;178384;103;45;23;4;19;.826;3576000;0
9109;184229;106;94;39;3;36;.923;3600000;0
9109;184861;103;0;0;0;0;.00nan;0;0
9109;184866;106;0;0;0;0;.00nan;0;0
9110;178384;103;45;17;3;14;.824;3600000;0
9110;184861;103;0;0;0;0;.00nan;0;0
9110;185220;104;63;47;5;42;.894;3554000;0
9110;191255;104;0;0;0;0;.00nan;0;0
9111;189333;100;0;0;0;0;.00nan;0;0
9111;184398;100;72;21;1;20;.952;3900000;0
9111;185240;94;92;40;1;39;.975;3900000;0
9111;196525;94;0;0;0;0;.00nan;0;0
9112;183633;91;52;33;5;28;.848;3600000;0
9112;189433;91;0;0;0;0;.00nan;0;0
9112;189628;89;32;33;6;27;.818;3583000;0
9112;186155;89;0;0;0;0;.00nan;0;0
9113;194502;86;72;37;3;34;.919;3600000;0
9113;184158;90;53;37;6;31;.838;3600000;0
9113;-1;90;0;0;0;0;.00nan;0;0
9113;-1;86;0;0;0;0;.00nan;0;0
9114;184081;88;42;24;5;19;.792;2297000;0
9114;184225;93;0;0;0;0;.00nan;0;0
9114;-1;93;69;24;2;22;.917;3600000;0
9114;191318;88;30;9;3;6;.667;1303000;0
9115;189359;87;0;0;0;0;.00nan;0;0
9115;189576;97;0;0;0;0;.00nan;0;0
9115;196495;87;45;24;5;19;.792;3817000;0
9115;191331;97;85;46;4;42;.913;3817000;0
9116;192739;92;0;0;0;0;.00nan;0;0
9116;189644;95;50;23;3;20;.870;3534000;0
9116;195346;95;0;0;0;0;.00nan;0;0
9116;190106;92;91;41;2;39;.951;3600000;0
9117;178384;103;58;14;1;13;.929;3600000;0
9117;184229;106;68;40;4;36;.900;3600000;0
9117;184861;103;0;0;0;0;.00nan;0;0
9117;184866;106;0;0;0;0;.00nan;0;0
9118;194632;102;77;28;2;26;.929;3900000;0
9118;189573;102;0;0;0;0;.00nan;0;0
9118;184310;98;0;0;0;0;.00nan;0;0
9118;186029;98;74;31;2;29;.935;3900000;0
9119;189333;100;0;0;0;0;.00nan;0;0
9119;184398;100;62;37;4;33;.892;3587000;0
9119;189978;101;0;0;0;0;.00nan;0;0
9119;187096;101;70;30;3;27;.900;3600000;0
9120;182266;105;0;0;0;0;.00nan;0;0
9120;192733;99;62;28;3;25;.893;3600000;0
9120;194531;99;0;0;0;0;.00nan;0;0
9120;189639;105;77;44;5;39;.886;3579000;0
9121;189581;107;60;23;2;21;.913;3600000;0
9121;185220;104;67;44;5;39;.886;3600000;0
9121;187391;107;0;0;0;0;.00nan;0;0
9121;191255;104;0;0;0;0;.00nan;0;0
9122;194502;86;45;24;4;20;.833;3600000;0
9122;184158;90;0;0;0;0;.00nan;0;0
9122;-1;90;36;24;5;19;.792;3600000;0
9122;-1;86;0;0;0;0;.00nan;0;0
9123;189333;100;79;27;1;26;.963;3600000;0
9123;184398;100;0;0;0;0;.00nan;0;0
9123;189978;101;80;35;3;32;.914;3543000;0
9123;187096;101;0;0;0;0;.00nan;0;0
9124;183633;91;50;1;0;1;1.000;354000;0
9124;189433;91;21;26;7;19;.731;3246000;0
9124;189628;89;0;0;0;0;.00nan;0;0
9124;186155;89;100;28;0;28;1.000;3600000;0
9125;184081;88;45;32;5;27;.844;3600000;0
9125;189644;95;0;0;0;0;.00nan;0;0
9125;195346;95;63;18;2;16;.889;3600000;0
9125;191318;88;0;0;0;0;.00nan;0;0
9126;184229;106;0;0;0;0;.00nan;0;0
9126;184866;106;82;48;5;43;.896;3600000;0
9126;185240;94;0;0;0;0;.00nan;0;0
9126;196525;94;67;37;4;33;.892;3600000;0
9127;182266;105;13;33;8;25;.758;3600000;0
9127;189581;107;0;0;0;0;.00nan;0;0
9127;189639;105;0;0;0;0;.00nan;0;0
9127;187391;107;85;32;1;31;.969;3600000;0
9128;192733;99;0;0;0;0;.00nan;0;0
9128;194531;99;53;27;3;24;.889;3544000;0
9128;185220;104;0;0;0;0;.00nan;0;0
9128;191255;104;100;47;2;45;.957;3600000;0
9129;194632;102;0;0;0;0;.00nan;0;0
9129;189573;102;43;21;4;17;.810;3600000;0
9129;184310;98;54;44;6;38;.864;3573000;0
9129;186029;98;0;0;0;0;.00nan;0;0
9130;189359;87;42;30;5;25;.833;3600000;0
9130;184225;93;100;36;0;36;1.000;3600000;0
9130;-1;93;0;0;0;0;.00nan;0;0
9130;196495;87;0;0;0;0;.00nan;0;0
9131;184158;90;58;34;4;30;.882;3600000;0
9131;184437;96;80;17;0;17;1.000;3600000;0
9131;184770;96;0;0;0;0;.00nan;0;0
9131;-1;90;0;0;0;0;.00nan;0;0
9132;192739;92;0;0;0;0;.00nan;0;0
9132;184081;88;0;0;0;0;.00nan;0;0
9132;190106;92;76;37;3;34;.919;3577000;0
9132;191318;88;99;49;2;47;.959;3600000;0
9133;194632;102;63;26;3;23;.885;3600000;0
9133;189573;102;0;0;0;0;.00nan;0;0
9133;184310;98;0;0;0;0;.00nan;0;0
9133;186029;98;71;47;5;42;.894;3575000;0
9134;192733;99;88;38;3;35;.921;3600000;0
9134;178384;103;62;32;4;28;.875;3579000;0
9134;194531;99;0;0;0;0;.00nan;0;0
9134;184861;103;0;0;0;0;.00nan;0;0
9135;192739;92;0;0;0;0;.00nan;0;0
9135;189576;97;62;27;3;24;.889;3900000;0
9135;190106;92;71;31;3;28;.903;3900000;0
9135;191331;97;0;0;0;0;.00nan;0;0
9136;192733;99;0;0;0;0;.00nan;0;0
9136;194531;99;57;36;4;32;.889;3578000;0
9136;184229;106;77;34;2;32;.941;3600000;0
9136;184866;106;0;0;0;0;.00nan;0;0
9137;182266;105;0;0;0;0;.00nan;0;0
9137;189639;105;88;26;1;25;.962;3600000;0
9137;185240;94;32;24;5;19;.792;3600000;0
9137;196525;94;0;0;0;0;.00nan;0;0
9138;194502;86;72;45;4;41;.911;3600000;0
9138;189644;95;39;37;6;31;.838;3600000;0
9138;195346;95;0;0;0;0;.00nan;0;0
9138;-1;86;0;0;0;0;.00nan;0;0
9139;189359;87;0;0;0;0;.00nan;0;0
9139;184158;90;83;47;4;43;.915;3600000;0
9139;-1;90;0;0;0;0;.00nan;0;0
9139;196495;87;100;29;0;29;1.000;3600000;0
9140;189576;97;0;0;0;0;.00nan;0;0
9140;184437;96;79;32;2;30;.938;3600000;0
9140;184770;96;0;0;0;0;.00nan;0;0
9140;191331;97;76;29;2;27;.931;3575000;0
9141;185220;104;0;0;0;0;.00nan;0;0
9141;185240;94;0;0;0;0;.00nan;0;0
9141;196525;94;74;29;3;26;.897;3600000;0
9141;191255;104;53;34;6;28;.824;3600000;0
9142;189333;100;0;0;0;0;.00nan;0;0
9142;189581;107;100;27;0;27;1.000;3600000;0
9142;184398;100;85;31;1;30;.968;3577000;0
9142;187391;107;0;0;0;0;.00nan;0;0
9143;184081;88;78;41;3;38;.927;3582000;0
9143;189644;95;71;16;1;15;.938;3600000;0
9143;195346;95;0;0;0;0;.00nan;0;0
9143;191318;88;0;0;0;0;.00nan;0;0
9144;194502;86;69;18;2;16;.889;3600000;0
9144;189628;89;0;0;0;0;.00nan;0;0
9144;186155;89;75;32;3;29;.906;3600000;0
9144;-1;86;0;0;0;0;.00nan;0;0
9145;189359;87;0;0;0;0;.00nan;0;0
9145;184437;96;42;24;5;19;.792;3564000;0
9145;184770;96;0;0;0;0;.00nan;0;0
9145;196495;87;77;42;4;38;.905;3600000;0
9146;183633;91;80;29;2;27;.931;3580000;0
9146;189433;91;0;0;0;0;.00nan;0;0
9146;184158;90;98;32;1;31;.969;3600000;0
9146;-1;90;0;0;0;0;.00nan;0;0
9147;192739;92;0;0;0;0;.00nan;0;0
9147;184225;93;64;37;4;33;.892;3594000;0
9147;190106;92;89;40;2;38;.950;3600000;0
9147;-1;93;0;0;0;0;.00nan;0;0
9148;178384;103;65;32;3;29;.906;3541000;0
9148;189978;101;0;0;0;0;.00nan;0;0
9148;184861;103;0;0;0;0;.00nan;0;0
9148;187096;101;78;24;1;23;.958;3600000;0
9149;189333;100;61;29;3;26;.897;3600000;0
9149;189581;107;48;40;6;34;.850;3134000;0
9149;184398;100;0;0;0;0;.00nan;0;0
9149;187391;107;49;1;0;1;1.000;466000;0
9150;192733;99;100;28;0;28;1.000;3600000;0
9150;194531;99;0;0;0;0;.00nan;0;0
9150;184310;98;0;0;0;0;.00nan;0;0
9150;186029;98;70;31;3;28;.903;3600000;0
9151;182266;105;0;0;0;0;.00nan;0;0
9151;189639;105;80;24;1;23;.958;3600000;0
9151;185240;94;62;39;5;34;.872;3600000;0
9151;196525;94;0;0;0;0;.00nan;0;0
9152;194632;102;32;18;4;14;.778;3549000;0
9152;184229;106;0;0;0;0;.00nan;0;0
9152;189573;102;0;0;0;0;.00nan;0;0
9152;184866;106;98;47;3;44;.936;3600000;0
9153;184225;93;0;0;0;0;.00nan;0;0
9153;189576;97;53;33;5;28;.848;3600000;0
9153;-1;93;89;35;2;33;.943;3600000;0
9153;191331;97;0;0;0;0;.00nan;0;0
9154;189628;89;89;37;3;34;.919;3900000;0
9154;189644;95;0;0;0;0;.00nan;0;0
9154;195346;95;59;29;3;26;.897;3900000;0
9154;186155;89;0;0;0;0;.00nan;0;0
9155;183633;91;0;0;0;0;.00nan;0;0
9155;194502;86;0;0;0;0;.00nan;0;0
9155;189433;91;36;27;5;22;.815;3600000;0
9155;-1;86;74;18;1;17;.944;3600000;0
9156;184081;88;52;12;2;10;.833;1662000;0
9156;184437;96;0;0;0;0;.00nan;0;0
9156;184770;96;74;28;2;26;.929;3600000;0
9156;191318;88;52;33;6;27;.818;1938000;0
9157;184229;106;96;25;0;25;1.000;3600000;0
9157;189581;107;0;0;0;0;.00nan;0;0
9157;184866;106;0;0;0;0;.00nan;0;0
9157;187391;107;53;27;4;23;.852;3600000;0
9158;182266;105;0;0;0;0;.00nan;0;0
9158;189639;105;28;20;5;15;.750;3552000;0
9158;185220;104;0;0;0;0;.00nan;0;0
9158;191255;104;84;39;3;36;.923;3600000;0
9159;184310;98;70;22;1;21;.955;3600000;0
9159;185240;94;0;0;0;0;.00nan;0;0
9159;196525;94;85;40;2;38;.950;3554000;0
9159;186029;98;0;0;0;0;.00nan;0;0
9160;192733;99;80;37;3;34;.919;3600000;0
9160;194531;99;0;0;0;0;.00nan;0;0
9160;189978;101;0;0;0;0;.00nan;0;0
9160;187096;101;67;21;1;20;.952;3600000;0
9161;189359;87;54;18;3;15;.833;3600000;0
9161;189644;95;72;50;5;45;.900;3511000;0
9161;195346;95;0;0;0;0;.00nan;0;0
9161;196495;87;0;0;0;0;.00nan;0;0
9162;184081;88;59;25;3;22;.880;3600000;0
9162;184158;90;67;38;4;34;.895;3573000;0
9162;-1;90;0;0;0;0;.00nan;0;0
9162;191318;88;0;0;0;0;.00nan;0;0
9163;192739;92;0;0;0;0;.00nan;0;0
9163;184225;93;84;24;1;23;.958;3600000;0
9163;190106;92;66;23;2;21;.913;3600000;0
9163;-1;93;0;0;0;0;.00nan;0;0
9164;178384;103;24;13;4;9;.692;1082000;0
9164;184861;103;87;23;1;22;.957;2518000;0
9164;185240;94;92;40;2;38;.950;3600000;0
9164;196525;94;0;0;0;0;.00nan;0;0
9165;189581;107;49;13;2;11;.846;3600000;0
9165;185220;104;62;42;6;36;.857;3600000;0
9165;187391;107;0;0;0;0;.00nan;0;0
9165;191255;104;0;0;0;0;.00nan;0;0
9166;194632;102;46;18;4;14;.778;3600000;0
9166;184229;106;94;59;5;54;.915;3578000;0
9166;189573;102;0;0;0;0;.00nan;0;0
9166;184866;106;0;0;0;0;.00nan;0;0
9167;182266;105;91;46;3;43;.935;3600000;0
9167;189333;100;0;0;0;0;.00nan;0;0
9167;189639;105;0;0;0;0;.00nan;0;0
9167;184398;100;84;27;1;26;.963;3600000;0
9168;192739;92;0;0;0;0;.00nan;0;0
9168;189628;89;45;34;6;28;.824;3342000;0
9168;190106;92;65;20;2;18;.900;3600000;0
9168;186155;89;50;1;0;1;1.000;258000;0
9169;184158;90;58;32;4;28;.875;3555000;0
9169;189576;97;0;0;0;0;.00nan;0;0
9169;-1;90;0;0;0;0;.00nan;0;0
9169;191331;97;91;45;3;42;.933;3600000;0
9170;189644;95;54;35;4;31;.886;3600000;0
9170;184437;96;73;13;0;13;1.000;3600000;0
9170;195346;95;0;0;0;0;.00nan;0;0
9170;184770;96;0;0;0;0;.00nan;0;0
9171;183633;91;77;27;2;25;.926;3600000;0
9171;189359;87;0;0;0;0;.00nan;0;0
9171;189433;91;0;0;0;0;.00nan;0;0
9171;196495;87;76;33;3;30;.909;3600000;0
9172;192739;92;68;35;4;31;.886;3600000;0
9172;184081;88;43;33;6;27;.818;3564000;0
9172;190106;92;0;0;0;0;.00nan;0;0
9172;191318;88;0;0;0;0;.00nan;0;0
9173;189359;87;85;26;1;25;.962;3600000;0
9173;184225;93;0;0;0;0;.00nan;0;0
9173;-1;93;56;31;3;28;.903;3600000;0
9173;196495;87;0;0;0;0;.00nan;0;0
9174;178384;103;66;24;2;22;.917;3600000;0
9174;184861;103;0;0;0;0;.00nan;0;0
9174;185220;104;80;47;4;43;.915;3543000;0
9174;191255;104;0;0;0;0;.00nan;0;0
9175;184229;106;47;5;1;4;.800;1206000;0
9175;189978;101;0;0;0;0;.00nan;0;0
9175;184866;106;44;33;5;28;.848;2394000;0
9175;187096;101;88;15;0;15;1.000;3600000;0
9176;194502;86;71;16;1;15;.938;3600000;0
9176;189576;97;68;40;5;35;.875;3600000;0
9176;-1;86;0;0;0;0;.00nan;0;0
9176;191331;97;0;0;0;0;.00nan;0;0
9177;194632;102;66;29;3;26;.897;3600000;0
9177;189333;100;0;0;0;0;.00nan;0;0
9177;189573;102;0;0;0;0;.00nan;0;0
9177;184398;100;55;31;4;27;.871;3600000;0
9178;184081;88;42;18;3;15;.833;3544000;0
9178;189576;97;0;0;0;0;.00nan;0;0
9178;191318;88;0;0;0;0;.00nan;0;0
9178;191331;97;59;21;2;19;.905;3600000;0
9179;194502;86;66;27;3;24;.889;3900000;0
9179;184158;90;61;28;3;25;.893;3900000;0
9179;-1;90;0;0;0;0;.00nan;0;0
9179;-1;86;0;0;0;0;.00nan;0;0
9180;192739;92;0;0;0;0;.00nan;0;0
9180;184437;96;74;28;2;26;.929;3600000;0
9180;184770;96;0;0;0;0;.00nan;0;0
9180;190106;92;84;51;4;47;.922;3582000;0
9181;183633;91;80;25;2;23;.920;3600000;0
9181;189433;91;0;0;0;0;.00nan;0;0
9181;184225;93;31;39;6;33;.846;2976000;0
9181;-1;93;47;7;1;6;.857;624000;0
9182;189628;89;39;38;6;32;.842;3600000;0
9182;189644;95;89;31;2;29;.935;3600000;0
9182;195346;95;0;0;0;0;.00nan;0;0
9182;186155;89;0;0;0;0;.00nan;0;0
9183;189333;100;82;30;1;29;.967;3600000;0
9183;184398;100;0;0;0;0;.00nan;0;0
9183;189978;101;0;0;0;0;.00nan;0;0
9183;187096;101;61;22;3;19;.864;3524000;0
9184;192733;99;92;47;3;44;.936;3600000;0
9184;194531;99;0;0;0;0;.00nan;0;0
9184;194632;102;50;25;4;21;.840;3555000;0
9184;189573;102;0;0;0;0;.00nan;0;0
9185;178384;103;72;25;2;23;.920;3600000;0
9185;184861;103;0;0;0;0;.00nan;0;0
9185;185240;94;0;0;0;0;.00nan;0;0
9185;196525;94;53;41;7;34;.829;3600000;0
9186;184229;106;97;48;2;46;.958;3600000;0
9186;184310;98;0;0;0;0;.00nan;0;0
9186;184866;106;0;0;0;0;.00nan;0;0
9186;186029;98;74;23;1;22;.957;3600000;0
9187;182266;105;0;0;0;0;.00nan;0;0
9187;189639;105;50;26;4;22;.846;3600000;0
9187;185220;104;48;13;2;11;.846;846000;0
9187;191255;104;32;38;7;31;.816;2754000;0
9188;184225;93;0;0;0;0;.00nan;0;0
9188;189628;89;0;0;0;0;.00nan;0;0
9188;-1;93;34;29;6;23;.793;3877000;0
9188;186155;89;54;37;5;32;.865;3877000;0
9189;194502;86;92;30;1;29;.967;3900000;0
9189;184081;88;92;32;1;31;.969;3900000;0
9189;-1;86;0;0;0;0;.00nan;0;0
9189;191318;88;0;0;0;0;.00nan;0;0
9190;192739;92;26;6;3;3;.500;407000;0
9190;189359;87;0;0;0;0;.00nan;0;0
9190;190106;92;76;30;2;28;.933;3193000;0
9190;196495;87;59;19;2;17;.895;3600000;0
9191;184158;90;78;40;3;37;.925;3600000;0
9191;184437;96;48;0;0;0;.00nan;659000;0
9191;184770;96;26;29;7;22;.759;2941000;0
9191;-1;90;0;0;0;0;.00nan;0;0
9192;183633;91;0;0;0;0;.00nan;0;0
9192;189433;91;52;28;4;24;.857;3541000;0
9192;189644;95;0;0;0;0;.00nan;0;0
9192;195346;95;80;28;2;26;.929;3600000;0
9193;184229;106;0;0;0;0;.00nan;0;0
9193;189581;107;0;0;0;0;.00nan;0;0
9193;184866;106;79;42;4;38;.905;3582000;0
9193;187391;107;60;20;2;18;.900;3600000;0
9194;192733;99;0;0;0;0;.00nan;0;0
9194;194531;99;58;33;4;29;.879;3600000;0
9194;194632;102;0;0;0;0;.00nan;0;0
9194;189573;102;43;20;3;17;.850;3600000;0
9195;182266;105;0;0;0;0;.00nan;0;0
9195;189639;105;67;31;3;28;.903;3600000;0
9195;185240;94;29;23;5;18;.783;3588000;0
9195;196525;94;0;0;0;0;.00nan;0;0
9196;178384;103;0;0;0;0;.00nan;0;0
9196;184310;98;78;29;1;28;.966;3600000;0
9196;184861;103;92;44;2;42;.955;3569000;0
9196;186029;98;0;0;0;0;.00nan;0;0
9197;189333;100;0;0;0;0;.00nan;0;0
9197;184398;100;65;27;2;25;.926;3600000;0
9197;189978;101;43;47;7;40;.851;3600000;0
9197;187096;101;0;0;0;0;.00nan;0;0
9198;183633;91;74;35;2;33;.943;3600000;0
9198;189359;87;0;0;0;0;.00nan;0;0
9198;189433;91;0;0;0;0;.00nan;0;0
9198;196495;87;52;35;5;30;.857;3600000;0
9199;184225;93;0;0;0;0;.00nan;0;0
9199;189644;95;35;30;6;24;.800;3600000;0
9199;195346;95;0;0;0;0;.00nan;0;0
9199;-1;93;99;43;3;40;.930;3600000;0
9200;189581;107;64;27;3;24;.889;3600000;0
9200;185240;94;0;0;0;0;.00nan;0;0
9200;196525;94;54;49;6;43;.878;3600000;0
9200;187391;107;0;0;0;0;.00nan;0;0
9201;182266;105;0;0;0;0;.00nan;0;0
9201;189333;100;0;0;0;0;.00nan;0;0
9201;189639;105;82;43;3;40;.930;3600000;0
9201;184398;100;97;21;0;21;1.000;3600000;0
9202;184229;106;54;22;3;19;.864;3600000;0
9202;184866;106;0;0;0;0;.00nan;0;0
9202;185220;104;48;21;4;17;.810;3569000;0
9202;191255;104;0;0;0;0;.00nan;0;0
9203;189576;97;89;41;2;39;.951;3600000;0
9203;184437;96;32;27;6;21;.778;3600000;0
9203;184770;96;0;0;0;0;.00nan;0;0
9203;191331;97;0;0;0;0;.00nan;0;0
9204;178384;103;68;17;1;16;.941;3600000;0
9204;184229;106;0;0;0;0;.00nan;0;0
9204;184861;103;0;0;0;0;.00nan;0;0
9204;184866;106;70;28;2;26;.929;3577000;0
9205;194632;102;50;26;4;22;.846;3600000;0
9205;189573;102;0;0;0;0;.00nan;0;0
9205;184310;98;0;0;0;0;.00nan;0;0
9205;186029;98;61;40;5;35;.875;3600000;0
9206;184081;88;44;30;5;25;.833;3600000;0
9206;189628;89;71;31;2;29;.935;3600000;0
9206;186155;89;0;0;0;0;.00nan;0;0
9206;191318;88;0;0;0;0;.00nan;0;0
9207;184081;88;100;46;2;44;.957;3900000;0
9207;184225;93;0;0;0;0;.00nan;0;0
9207;-1;93;67;25;2;23;.920;3900000;0
9207;191318;88;0;0;0;0;.00nan;0;0
9208;189359;87;0;0;0;0;.00nan;0;0
9208;184437;96;84;45;4;41;.911;3600000;0
9208;184770;96;0;0;0;0;.00nan;0;0
9208;196495;87;88;28;1;27;.964;3600000;0
9209;184158;90;70;26;2;24;.923;3600000;0
9209;189576;97;0;0;0;0;.00nan;0;0
9209;-1;90;0;0;0;0;.00nan;0;0
9209;191331;97;76;45;4;41;.911;3520000;0
9210;183633;91;85;43;2;41;.953;3600000;0
9210;194502;86;55;34;4;30;.882;3551000;0
9210;189433;91;0;0;0;0;.00nan;0;0
9210;-1;86;0;0;0;0;.00nan;0;0
9211;192739;92;0;0;0;0;.00nan;0;0
9211;189644;95;43;17;3;14;.824;3513000;0
9211;195346;95;0;0;0;0;.00nan;0;0
9211;190106;92;90;36;1;35;.972;3600000;0
9212;192733;99;64;21;2;19;.905;3600000;0
9212;194531;99;0;0;0;0;.00nan;0;0
9212;189978;101;58;6;0;6;1.000;465000;0
9212;187096;101;47;38;6;32;.842;3135000;0
9213;178384;103;88;22;1;21;.955;3600000;0
9213;184861;103;0;0;0;0;.00nan;0;0
9213;185240;94;63;42;5;37;.881;3600000;0
9213;196525;94;0;0;0;0;.00nan;0;0
9214;189581;107;0;0;0;0;.00nan;0;0
9214;184310;98;0;0;0;0;.00nan;0;0
9214;186029;98;69;28;2;26;.929;3600000;0
9214;187391;107;76;40;3;37;.925;3553000;0
9215;182266;105;0;0;0;0;.00nan;0;0
9215;189639;105;74;25;2;23;.920;3600000;0
9215;185220;104;52;36;5;31;.861;3600000;0
9215;191255;104;0;0;0;0;.00nan;0;0
9216;194632;102;32;31;6;25;.806;3600000;0
9216;189333;100;0;0;0;0;.00nan;0;0
9216;189573;102;0;0;0;0;.00nan;0;0
9216;184398;100;85;30;1;29;.967;3600000;0
9217;194502;86;54;33;5;28;.848;3568000;0
9217;189576;97;41;21;4;17;.810;3600000;0
9217;-1;86;0;0;0;0;.00nan;0;0
9217;191331;97;0;0;0;0;.00nan;0;0
9218;184225;93;69;27;2;25;.926;3600000;0
9218;189628;89;0;0;0;0;.00nan;0;0
9218;-1;93;0;0;0;0;.00nan;0;0
9218;186155;89;58;33;4;29;.879;3567000;0
9219;189359;87;73;25;1;24;.960;3600000;0
9219;184437;96;0;0;0;0;.00nan;0;0
9219;184770;96;46;35;5;30;.857;3600000;0
9219;196495;87;0;0;0;0;.00nan;0;0
9220;192733;99;83;32;2;30;.938;3600000;0
9220;194531;99;0;0;0;0;.00nan;0;0
9220;189978;101;66;41;4;37;.902;3516000;0
9220;187096;101;0;0;0;0;.00nan;0;0
9221;183633;91;0;0;0;0;.00nan;0;0
9221;189433;91;65;32;3;29;.906;3900000;0
9221;184158;90;45;16;3;13;.813;3848000;0
9221;-1;90;0;0;0;0;.00nan;0;0
9222;189581;107;64;35;4;31;.886;3690000;0
9222;184310;98;53;23;3;20;.870;3690000;0
9222;186029;98;0;0;0;0;.00nan;0;0
9222;187391;107;0;0;0;0;.00nan;0;0
9223;192739;92;40;39;6;33;.846;3600000;0
9223;189644;95;0;0;0;0;.00nan;0;0
9223;195346;95;92;18;0;18;1.000;3600000;0
9223;190106;92;0;0;0;0;.00nan;0;0
9224;182266;105;88;17;0;17;1.000;3600000;0
9224;189639;105;0;0;0;0;.00nan;0;0
9224;185220;104;64;9;0;9;1.000;562000;0
9224;191255;104;28;38;7;31;.816;3038000;0
9225;184229;106;86;29;2;27;.931;3600000;0
9225;184866;106;0;0;0;0;.00nan;0;0
9225;185240;94;52;2;0;2;1.000;431000;0
9225;196525;94;30;26;6;20;.769;3169000;0
9226;194632;102;0;0;0;0;.00nan;0;0
9226;189333;100;25;32;7;25;.781;3600000;0
9226;189573;102;78;22;1;21;.955;3600000;0
9226;184398;100;0;0;0;0;.00nan;0;0
9227;189581;107;0;0;0;0;.00nan;0;0
9227;185240;94;54;14;2;12;.857;1596000;0
9227;196525;94;42;34;6;28;.824;2004000;0
9227;187391;107;71;16;1;15;.938;3600000;0
9228;184081;88;45;34;5;29;.853;3600000;0
9228;184158;90;52;18;3;15;.833;3600000;0
9228;-1;90;0;0;0;0;.00nan;0;0
9228;191318;88;0;0;0;0;.00nan;0;0
9229;189359;87;0;0;0;0;.00nan;0;0
9229;184225;93;0;0;0;0;.00nan;0;0
9229;-1;93;42;29;5;24;.828;3600000;0
9229;196495;87;90;29;1;28;.966;3600000;0
9230;189576;97;0;0;0;0;.00nan;0;0
9230;189644;95;0;0;0;0;.00nan;0;0
9230;195346;95;45;28;5;23;.821;3600000;0
9230;191331;97;55;30;4;26;.867;3600000;0
9231;192739;92;0;0;0;0;.00nan;0;0
9231;183633;91;52;22;3;19;.864;3564000;0
9231;189433;91;0;0;0;0;.00nan;0;0
9231;190106;92;99;38;1;37;.974;3600000;0
9232;194632;102;63;30;3;27;.900;3550000;0
9232;189573;102;0;0;0;0;.00nan;0;0
9232;189978;101;0;0;0;0;.00nan;0;0
9232;187096;101;68;26;2;24;.923;3600000;0
9233;182266;105;65;33;3;30;.909;3600000;0
9233;184310;98;0;0;0;0;.00nan;0;0
9233;189639;105;0;0;0;0;.00nan;0;0
9233;186029;98;42;34;5;29;.853;3578000;0
9234;189333;100;0;0;0;0;.00nan;0;0
9234;184398;100;78;25;1;24;.960;3600000;0
9234;185220;104;0;0;0;0;.00nan;0;0
9234;191255;104;54;37;5;32;.865;3600000;0
9235;192733;99;53;18;3;15;.833;3600000;0
9235;194531;99;0;0;0;0;.00nan;0;0
9235;184229;106;43;25;4;21;.840;1188000;0
9235;184866;106;25;29;7;22;.759;2412000;0
9236;189628;89;0;0;0;0;.00nan;0;0
9236;184437;96;100;25;0;25;1.000;3600000;0
9236;184770;96;0;0;0;0;.00nan;0;0
9236;186155;89;53;50;6;44;.880;3600000;0
9237;182266;105;0;0;0;0;.00nan;0;0
9237;178384;103;46;32;5;27;.844;3549000;0
9237;189639;105;75;40;4;36;.900;3600000;0
9237;184861;103;0;0;0;0;.00nan;0;0
9238;192733;99;0;0;0;0;.00nan;0;0
9238;194531;99;46;28;4;24;.857;3900000;0
9238;184229;106;79;49;4;45;.918;3881000;0
9238;184866;106;0;0;0;0;.00nan;0;0
9239;192739;92;0;0;0;0;.00nan;0;0
9239;184225;93;61;37;4;33;.892;3570000;0
9239;190106;92;91;39;3;36;.923;3600000;0
9239;-1;93;0;0;0;0;.00nan;0;0
9240;189576;97;0;0;0;0;.00nan;0;0
9240;189628;89;0;0;0;0;.00nan;0;0
9240;186155;89;81;32;2;30;.938;3600000;0
9240;191331;97;62;33;4;29;.879;3523000;0
9241;194502;86;40;13;3;10;.769;3600000;0
9241;184081;88;55;39;5;34;.872;3600000;0
9241;-1;86;0;0;0;0;.00nan;0;0
9241;191318;88;0;0;0;0;.00nan;0;0
9242;184081;88;71;37;4;33;.892;3582000;0
9242;184158;90;59;28;3;25;.893;3600000;0
9242;-1;90;0;0;0;0;.00nan;0;0
9242;191318;88;0;0;0;0;.00nan;0;0
9243;183633;91;21;11;4;7;.636;956000;0
9243;189433;91;74;17;1;16;.941;2644000;0
9243;184437;96;47;26;4;22;.846;3600000;0
9243;184770;96;0;0;0;0;.00nan;0;0
9244;178384;103;61;32;5;27;.844;3900000;0
9244;184225;93;0;0;0;0;.00nan;0;0
9244;184861;103;0;0;0;0;.00nan;0;0
9244;-1;93;76;49;5;44;.898;3900000;0
9245;192739;92;0;0;0;0;.00nan;0;0
9245;189576;97;0;0;0;0;.00nan;0;0
9245;190106;92;93;31;1;30;.968;3600000;0
9245;191331;97;43;22;3;19;.864;3555000;0
9246;192733;99;69;34;2;32;.941;3543000;0
9246;194531;99;0;0;0;0;.00nan;0;0
9246;189978;101;0;0;0;0;.00nan;0;0
9246;187096;101;99;39;1;38;.974;3600000;0
9247;189333;100;62;23;2;21;.913;3600000;0
9247;184310;98;0;0;0;0;.00nan;0;0
9247;184398;100;0;0;0;0;.00nan;0;0
9247;186029;98;83;30;1;29;.967;3600000;0
9248;182266;105;51;31;4;27;.871;3195000;0
9248;189359;87;0;0;0;0;.00nan;0;0
9248;189639;105;26;6;3;3;.500;345000;0
9248;196495;87;47;33;5;28;.848;3600000;0
9249;189628;89;0;0;0;0;.00nan;0;0
9249;185220;104;0;0;0;0;.00nan;0;0
9249;186155;89;76;23;1;22;.957;3600000;0
9249;191255;104;54;27;4;23;.852;3600000;0
9250;194632;102;56;28;3;25;.893;3558000;0
9250;189573;102;0;0;0;0;.00nan;0;0
9250;189581;107;87;35;2;33;.943;3600000;0
9250;187391;107;0;0;0;0;.00nan;0;0
9251;194502;86;50;18;3;15;.833;3600000;0
9251;184081;88;37;35;6;29;.829;2327000;0
9251;-1;86;0;0;0;0;.00nan;0;0
9251;191318;88;72;17;0;17;1.000;1273000;0
9252;183633;91;65;34;4;30;.882;3600000;0
9252;189433;91;0;0;0;0;.00nan;0;0
9252;184437;96;72;21;1;20;.952;3600000;0
9252;184770;96;0;0;0;0;.00nan;0;0
9253;178384;103;0;0;0;0;.00nan;0;0
9253;189644;95;65;31;3;28;.903;3746000;0
9253;195346;95;0;0;0;0;.00nan;0;0
9253;184861;103;72;39;4;35;.897;3746000;0
9254;184229;106;0;0;0;0;.00nan;0;0
9254;184866;106;38;28;5;23;.821;3545000;0
9254;185240;94;0;0;0;0;.00nan;0;0
9254;196525;94;88;39;3;36;.923;3600000;0
9255;182266;105;0;0;0;0;.00nan;0;0
9255;189628;89;65;37;4;33;.892;3600000;0
9255;189639;105;77;25;1;24;.960;3600000;0
9255;186155;89;0;0;0;0;.00nan;0;0
9256;189359;87;42;23;4;19;.826;3600000;0
9256;185220;104;97;41;1;40;.976;3600000;0
9256;196495;87;0;0;0;0;.00nan;0;0
9256;191255;104;0;0;0;0;.00nan;0;0
9257;194632;102;0;0;0;0;.00nan;0;0
9257;189573;102;73;24;1;23;.958;3600000;0
9257;189581;107;0;0;0;0;.00nan;0;0
9257;187391;107;65;36;4;32;.889;3600000;0
9258;184310;98;47;35;5;30;.857;3545000;0
9258;189978;101;75;36;3;33;.917;3600000;0
9258;186029;98;0;0;0;0;.00nan;0;0
9258;187096;101;0;0;0;0;.00nan;0;0
9259;192733;99;64;34;3;31;.912;3600000;0
9259;194531;99;0;0;0;0;.00nan;0;0
9259;189333;100;0;0;0;0;.00nan;0;0
9259;184398;100;61;25;2;23;.920;3600000;0
9260;184225;93;78;35;2;33;.943;3900000;0
9260;189576;97;0;0;0;0;.00nan;0;0
9260;-1;93;0;0;0;0;.00nan;0;0
9260;191331;97;82;32;2;30;.938;3900000;0
9261;192739;92;0;0;0;0;.00nan;0;0
9261;178384;103;68;23;2;21;.913;3600000;0
9261;190106;92;47;40;6;34;.850;3600000;0
9261;184861;103;0;0;0;0;.00nan;0;0
9262;184229;106;76;39;3;36;.923;3570000;0
9262;189978;101;0;0;0;0;.00nan;0;0
9262;184866;106;0;0;0;0;.00nan;0;0
9262;187096;101;80;30;2;28;.933;3600000;0
9263;184158;90;62;23;3;20;.870;3548000;0
9263;189644;95;93;45;2;43;.956;3600000;0
9263;195346;95;0;0;0;0;.00nan;0;0
9263;-1;90;0;0;0;0;.00nan;0;0
9264;189359;87;0;0;0;0;.00nan;0;0
9264;184229;106;44;45;7;38;.844;3516000;0
9264;184866;106;0;0;0;0;.00nan;0;0
9264;196495;87;36;23;5;18;.783;3600000;0
9265;192739;92;0;0;0;0;.00nan;0;0
9265;184225;93;75;30;3;27;.900;3600000;0
9265;190106;92;47;28;4;24;.857;3567000;0
9265;-1;93;0;0;0;0;.00nan;0;0
9266;194502;86;79;30;1;29;.967;3600000;0
9266;189644;95;15;26;7;19;.731;2921000;0
9266;195346;95;44;4;1;3;.750;679000;0
9266;-1;86;0;0;0;0;.00nan;0;0
9267;178384;103;87;34;2;32;.941;3600000;0
9267;189359;87;15;21;6;15;.714;2857000;0
9267;184861;103;0;0;0;0;.00nan;0;0
9267;196495;87;37;6;2;4;.667;743000;0
9268;182266;105;0;0;0;0;.00nan;0;0
9268;189639;105;75;32;2;30;.938;3600000;0
9268;189978;101;0;0;0;0;.00nan;0;0
9268;187096;101;51;29;4;25;.862;3515000;0
9269;189581;107;44;18;3;15;.833;3585000;0
9269;189628;89;0;0;0;0;.00nan;0;0
9269;186155;89;84;40;2;38;.950;3600000;0
9269;187391;107;0;0;0;0;.00nan;0;0
9270;194502;86;68;27;2;25;.926;3600000;0
9270;184081;88;0;0;0;0;.00nan;0;0
9270;-1;86;0;0;0;0;.00nan;0;0
9270;191318;88;65;42;4;38;.905;3521000;0
9271;184158;90;78;22;1;21;.955;3600000;0
9271;189576;97;73;39;4;35;.897;3600000;0
9271;-1;90;0;0;0;0;.00nan;0;0
9271;191331;97;0;0;0;0;.00nan;0;0
9272;192739;92;0;0;0;0;.00nan;0;0
9272;183633;91;55;23;2;21;.913;3551000;0
9272;189433;91;0;0;0;0;.00nan;0;0
9272;190106;92;99;42;1;41;.976;3600000;0
9273;189644;95;0;0;0;0;.00nan;0;0
9273;184437;96;95;34;1;33;.971;3600000;0
9273;195346;95;37;21;4;17;.810;3600000;0
9273;184770;96;0;0;0;0;.00nan;0;0
9274;184229;106;60;56;6;50;.893;3600000;0
9274;189978;101;74;9;0;9;1.000;3600000;0
9274;184866;106;0;0;0;0;.00nan;0;0
9274;187096;101;0;0;0;0;.00nan;0;0
9275;189359;87;0;0;0;0;.00nan;0;0
9275;189581;107;87;37;2;35;.946;3600000;0
9275;196495;87;89;52;4;48;.923;3526000;0
9275;187391;107;0;0;0;0;.00nan;0;0
9276;182266;105;0;0;0;0;.00nan;0;0
9276;192733;99;57;29;3;26;.897;3600000;0
9276;194531;99;0;0;0;0;.00nan;0;0
9276;189639;105;57;32;4;28;.875;3578000;0
9277;189333;100;0;0;0;0;.00nan;0;0
9277;184310;98;0;0;0;0;.00nan;0;0
9277;184398;100;47;32;5;27;.844;3600000;0
9277;186029;98;95;37;1;36;.973;3600000;0
9278;194632;102;68;16;1;15;.938;3600000;0
9278;189573;102;0;0;0;0;.00nan;0;0
9278;185220;104;35;33;6;27;.818;2248000;0
9278;191255;104;74;18;1;17;.944;1352000;0
9279;189628;89;0;0;0;0;.00nan;0;0
9279;185240;94;72;35;2;33;.943;3596000;0
9279;196525;94;0;0;0;0;.00nan;0;0
9279;186155;89;81;28;1;27;.964;3600000;0
9280;184081;88;76;35;4;31;.886;3600000;0
9280;184158;90;0;0;0;0;.00nan;0;0
9280;-1;90;97;19;0;19;1.000;3600000;0
9280;191318;88;0;0;0;0;.00nan;0;0
9281;194502;86;0;0;0;0;.00nan;0;0
9281;189576;97;0;0;0;0;.00nan;0;0
9281;-1;86;25;21;5;16;.762;3562000;0
9281;191331;97;60;36;4;32;.889;3600000;0
9282;194899;101;0;0;0;0;.00nan;0;0
9282;184310;98;61;16;1;15;.938;3600000;0
9282;186029;98;0;0;0;0;.00nan;0;0
9282;187096;101;76;31;2;29;.935;3579000;0
9283;194632;102;0;0;0;0;.00nan;0;0
9283;189573;102;58;28;3;25;.893;3567000;0
9283;189581;107;0;0;0;0;.00nan;0;0
9283;187391;107;99;40;1;39;.975;3600000;0
9284;182266;105;36;33;6;27;.818;2989000;0
9284;192733;99;70;22;1;21;.955;3600000;0
9284;194531;99;0;0;0;0;.00nan;0;0
9284;189639;105;48;14;3;11;.786;611000;0
9285;184225;93;0;0;0;0;.00nan;0;0
9285;189644;95;59;27;3;24;.889;3600000;0
9285;195346;95;0;0;0;0;.00nan;0;0
9285;-1;93;16;30;8;22;.733;3600000;0
9286;192739;92;39;31;5;26;.839;3597000;0
9286;184437;96;61;28;3;25;.893;3600000;0
9286;184770;96;0;0;0;0;.00nan;0;0
9286;190106;92;0;0;0;0;.00nan;0;0
9287;184229;106;0;0;0;0;.00nan;0;0
9287;189628;89;64;27;3;24;.889;3560000;0
9287;184866;106;93;39;1;38;.974;3600000;0
9287;186155;89;0;0;0;0;.00nan;0;0
9288;189333;100;0;0;0;0;.00nan;0;0
9288;184398;100;100;29;1;28;.966;3600000;0
9288;185220;104;0;0;0;0;.00nan;0;0
9288;191255;104;68;36;4;32;.889;3600000;0
9289;189359;87;90;32;1;31;.969;3600000;0
9289;185240;94;0;0;0;0;.00nan;0;0
9289;196495;87;0;0;0;0;.00nan;0;0
9289;196525;94;52;18;2;16;.889;3583000;0
9290;183633;91;39;10;2;8;.800;621000;0
9290;189433;91;17;25;6;19;.760;2979000;0
9290;184225;93;83;36;4;32;.889;3600000;0
9290;-1;93;0;0;0;0;.00nan;0;0
9291;178384;103;100;23;0;23;1.000;3600000;0
9291;189628;89;55;17;2;15;.882;1450000;0
9291;184861;103;0;0;0;0;.00nan;0;0
9291;186155;89;43;24;4;20;.833;2150000;0
9292;184229;106;99;39;2;37;.949;3600000;0
9292;184310;98;0;0;0;0;.00nan;0;0
9292;184866;106;0;0;0;0;.00nan;0;0
9292;186029;98;42;22;4;18;.818;3540000;0
9293;183633;91;65;21;1;20;.952;3600000;0
9293;184081;88;50;36;5;31;.861;3600000;0
9293;189433;91;0;0;0;0;.00nan;0;0
9293;191318;88;0;0;0;0;.00nan;0;0
9294;182266;105;0;0;0;0;.00nan;0;0
9294;194632;102;55;22;3;19;.864;3600000;0
9294;189573;102;0;0;0;0;.00nan;0;0
9294;189639;105;74;44;4;40;.909;3592000;0
9295;192739;92;0;0;0;0;.00nan;0;0
9295;184437;96;88;34;2;32;.941;3600000;0
9295;184770;96;0;0;0;0;.00nan;0;0
9295;190106;92;79;37;3;34;.919;3556000;0
9296;184081;88;59;31;4;27;.871;3555000;0
9296;184225;93;0;0;0;0;.00nan;0;0
9296;-1;93;82;29;2;27;.931;3600000;0
9296;191318;88;0;0;0;0;.00nan;0;0
9297;183633;91;0;0;0;0;.00nan;0;0
9297;189433;91;80;23;1;22;.957;3600000;0
9297;189576;97;83;34;2;32;.941;3555000;0
9297;191331;97;0;0;0;0;.00nan;0;0
9298;194899;101;0;0;0;0;.00nan;0;0
9298;189581;107;0;0;0;0;.00nan;0;0
9298;187096;101;29;27;6;21;.778;3532000;0
9298;187391;107;61;28;4;24;.857;3600000;0
9299;189333;100;0;0;0;0;.00nan;0;0
9299;184398;100;53;18;2;16;.889;3790000;0
9299;185220;104;0;0;0;0;.00nan;0;0
9299;191255;104;83;37;3;34;.919;3790000;0
9300;189359;87;0;0;0;0;.00nan;0;0
9300;189628;89;82;37;2;35;.946;3588000;0
9300;196495;87;90;20;0;20;1.000;3600000;0
9300;186155;89;0;0;0;0;.00nan;0;0
9301;192739;92;0;0;0;0;.00nan;0;0
9301;194502;86;72;23;1;22;.957;3600000;0
9301;190106;92;77;34;2;32;.941;3600000;0
9301;-1;86;0;0;0;0;.00nan;0;0
9302;183633;91;100;25;0;25;1.000;3600000;0
9302;189433;91;0;0;0;0;.00nan;0;0
9302;184158;90;0;0;0;0;.00nan;0;0
9302;-1;90;88;34;1;33;.971;3598000;0
9303;184225;93;56;29;3;26;.897;3544000;0
9303;189644;95;83;33;2;31;.939;3600000;0
9303;195346;95;0;0;0;0;.00nan;0;0
9303;-1;93;0;0;0;0;.00nan;0;0
9304;184081;88;84;43;3;40;.930;3600000;0
9304;189576;97;55;35;4;31;.886;3546000;0
9304;191318;88;0;0;0;0;.00nan;0;0
9304;191331;97;0;0;0;0;.00nan;0;0
9305;192733;99;78;30;2;28;.933;3600000;0
9305;194531;99;0;0;0;0;.00nan;0;0
9305;184310;98;0;0;0;0;.00nan;0;0
9305;186029;98;89;38;3;35;.921;3600000;0
9306;189333;100;72;33;3;30;.909;3744000;0
9306;194899;101;0;0;0;0;.00nan;0;0
9306;184398;100;0;0;0;0;.00nan;0;0
9306;187096;101;91;40;2;38;.950;3744000;0
9307;182266;105;0;0;0;0;.00nan;0;0
9307;184229;106;63;47;5;42;.894;3575000;0
9307;189639;105;57;29;4;25;.862;3600000;0
9307;184866;106;0;0;0;0;.00nan;0;0
9308;178384;103;66;28;3;25;.893;3797000;0
9308;184861;103;0;0;0;0;.00nan;0;0
9308;185220;104;0;0;0;0;.00nan;0;0
9308;191255;104;51;27;4;23;.852;3797000;0
9309;194632;102;79;31;2;29;.935;3600000;0
9309;189573;102;0;0;0;0;.00nan;0;0
9309;185240;94;42;28;5;23;.821;3600000;0
9309;196525;94;0;0;0;0;.00nan;0;0
9310;189576;97;46;7;1;6;.857;987000;0
9310;189628;89;0;0;0;0;.00nan;0;0
9310;186155;89;82;25;1;24;.960;3600000;0
9310;191331;97;30;32;6;26;.813;2613000;0
9311;183633;91;69;38;4;34;.895;3538000;0
9311;194502;86;0;0;0;0;.00nan;0;0
9311;189433;91;0;0;0;0;.00nan;0;0
9311;-1;86;68;24;2;22;.917;3600000;0
9312;192739;92;67;27;3;24;.889;3612000;0
9312;184158;90;74;27;2;25;.926;3612000;0
9312;190106;92;0;0;0;0;.00nan;0;0
9312;-1;90;0;0;0;0;.00nan;0;0
9313;184081;88;75;34;2;32;.941;3565000;0
9313;184437;96;0;0;0;0;.00nan;0;0
9313;184770;96;64;22;1;21;.955;3600000;0
9313;191318;88;0;0;0;0;.00nan;0;0
9314;189333;100;0;0;0;0;.00nan;0;0
9314;194899;101;70;37;4;33;.892;3600000;0
9314;184398;100;93;19;0;19;1.000;3600000;0
9314;187096;101;0;0;0;0;.00nan;0;0
9315;178384;103;36;31;6;25;.806;3600000;0
9315;189581;107;0;0;0;0;.00nan;0;0
9315;184861;103;0;0;0;0;.00nan;0;0
9315;187391;107;59;19;2;17;.895;3600000;0
9316;192733;99;25;9;4;5;.556;807000;0
9316;194531;99;67;24;2;22;.917;2707000;0
9316;184310;98;65;41;4;37;.902;3600000;0
9316;186029;98;0;0;0;0;.00nan;0;0
9317;184225;93;0;0;0;0;.00nan;0;0
9317;189644;95;0;0;0;0;.00nan;0;0
9317;195346;95;51;21;3;18;.857;3600000;0
9317;-1;93;49;35;5;30;.857;3600000;0
9318;182266;105;0;0;0;0;.00nan;0;0
9318;184229;106;0;0;0;0;.00nan;0;0
9318;189639;105;85;31;2;29;.935;3600000;0
9318;184866;106;86;45;3;42;.933;3552000;0
9319;194632;102;0;0;0;0;.00nan;0;0
9319;189573;102;77;27;1;26;.963;3600000;0
9319;185240;94;0;0;0;0;.00nan;0;0
9319;196525;94;34;33;6;27;.818;3600000;0
9320;184229;106;62;36;4;32;.889;3598000;0
9320;184866;106;0;0;0;0;.00nan;0;0
9320;185220;104;85;30;2;28;.933;3600000;0
9320;191255;104;0;0;0;0;.00nan;0;0
9321;194502;86;89;38;3;35;.921;3600000;0
9321;184437;96;22;33;8;25;.758;3600000;0
9321;184770;96;0;0;0;0;.00nan;0;0
9321;-1;86;0;0;0;0;.00nan;0;0
9322;184081;88;85;54;4;50;.926;3582000;0
9322;184158;90;61;25;2;23;.920;3600000;0
9322;-1;90;0;0;0;0;.00nan;0;0
9322;191318;88;0;0;0;0;.00nan;0;0
9323;184310;98;0;0;0;0;.00nan;0;0
9323;185220;104;45;45;7;38;.844;3600000;0
9323;186029;98;60;34;4;30;.882;3600000;0
9323;191255;104;0;0;0;0;.00nan;0;0
9324;182266;105;0;0;0;0;.00nan;0;0
9324;189581;107;0;0;0;0;.00nan;0;0
9324;189639;105;53;37;5;32;.865;3600000;0
9324;187391;107;59;44;6;38;.864;3580000;0
9325;192739;92;0;0;0;0;.00nan;0;0
9325;189576;97;30;12;4;8;.667;1109000;0
9325;190106;92;80;25;1;24;.960;3600000;0
9325;191331;97;57;21;2;19;.905;2491000;0
9326;192733;99;83;35;2;33;.943;3600000;0
9326;194531;99;0;0;0;0;.00nan;0;0
9326;189333;100;0;0;0;0;.00nan;0;0
9326;184398;100;29;22;5;17;.773;3600000;0
9327;189576;97;0;0;0;0;.00nan;0;0
9327;189644;95;56;31;4;27;.871;3600000;0
9327;195346;95;0;0;0;0;.00nan;0;0
9327;191331;97;55;34;5;29;.853;3562000;0
9328;194502;86;64;28;2;26;.929;3900000;0
9328;189359;87;0;0;0;0;.00nan;0;0
9328;196495;87;82;32;2;30;.938;3900000;0
9328;-1;86;0;0;0;0;.00nan;0;0
9329;184158;90;79;26;1;25;.962;3900000;0
9329;189628;89;83;32;1;31;.969;3900000;0
9329;-1;90;0;0;0;0;.00nan;0;0
9329;186155;89;0;0;0;0;.00nan;0;0
9330;183633;91;55;27;3;24;.889;3600000;0
9330;189433;91;0;0;0;0;.00nan;0;0
9330;184437;96;37;29;5;24;.828;3526000;0
9330;184770;96;0;0;0;0;.00nan;0;0
9331;192739;92;0;0;0;0;.00nan;0;0
9331;184225;93;77;46;3;43;.935;3900000;0
9331;190106;92;57;22;3;19;.864;3900000;0
9331;-1;93;0;0;0;0;.00nan;0;0
9332;189581;107;43;25;4;21;.840;3748000;0
9332;185220;104;0;0;0;0;.00nan;0;0
9332;187391;107;0;0;0;0;.00nan;0;0
9332;191255;104;85;61;5;56;.918;3761000;0
9333;182266;105;76;21;1;20;.952;2431000;0
9333;178384;103;49;46;7;39;.848;2556000;0
9333;189639;105;36;17;4;13;.765;1169000;0
9333;184861;103;49;4;1;3;.750;1044000;0
9334;194899;101;0;0;0;0;.00nan;0;0
9334;184310;98;0;0;0;0;.00nan;0;0
9334;186029;98;64;36;4;32;.889;3870000;0
9334;187096;101;80;44;4;40;.909;3900000;0
9335;189333;100;0;0;0;0;.00nan;0;0
9335;184398;100;53;21;3;18;.857;3570000;0
9335;185240;94;0;0;0;0;.00nan;0;0
9335;196525;94;98;43;2;41;.953;3600000;0
9336;192733;99;74;40;3;37;.925;3600000;0
9336;194531;99;0;0;0;0;.00nan;0;0
9336;194632;102;22;27;6;21;.778;3183000;0
9336;189573;102;49;1;0;1;1.000;417000;0
9337;194502;86;0;0;0;0;.00nan;0;0
9337;184081;88;100;35;1;34;.971;3600000;0
9337;-1;86;52;25;3;22;.880;3513000;0
9337;191318;88;0;0;0;0;.00nan;0;0
9338;194899;101;34;21;4;17;.810;3547000;0
9338;184310;98;96;46;3;43;.935;3600000;0
9338;186029;98;0;0;0;0;.00nan;0;0
9338;187096;101;0;0;0;0;.00nan;0;0
9339;183633;91;0;0;0;0;.00nan;0;0
9339;189433;91;63;27;3;24;.889;3900000;0
9339;184437;96;0;0;0;0;.00nan;0;0
9339;184770;96;63;27;3;24;.889;3900000;0
9340;184158;90;0;0;0;0;.00nan;0;0
9340;189628;89;0;0;0;0;.00nan;0;0
9340;-1;90;69;25;2;23;.920;3620000;0
9340;186155;89;90;47;3;44;.936;3635000;0
9341;189576;97;75;39;3;36;.923;3900000;0
9341;189644;95;0;0;0;0;.00nan;0;0
9341;195346;95;61;27;3;24;.889;3900000;0
9341;191331;97;0;0;0;0;.00nan;0;0
9342;178384;103;25;26;6;20;.769;3345000;0
9342;189581;107;0;0;0;0;.00nan;0;0
9342;184861;103;59;6;0;6;1.000;255000;0
9342;187391;107;100;46;2;44;.957;3600000;0
9343;182266;105;0;0;0;0;.00nan;0;0
9343;189639;105;62;30;3;27;.900;3593000;0
9343;185220;104;79;32;2;30;.938;3600000;0
9343;191255;104;0;0;0;0;.00nan;0;0
9344;192733;99;57;27;3;24;.889;3525000;0
9344;194531;99;0;0;0;0;.00nan;0;0
9344;194632;102;0;0;0;0;.00nan;0;0
9344;189573;102;84;31;1;30;.968;3600000;0
9345;189333;100;74;24;1;23;.958;3600000;0
9345;184398;100;0;0;0;0;.00nan;0;0
9345;185240;94;38;37;7;30;.811;3013000;0
9345;196525;94;48;0;0;0;.00nan;587000;0
9346;184225;93;45;32;5;27;.844;3600000;0
9346;189576;97;0;0;0;0;.00nan;0;0
9346;-1;93;0;0;0;0;.00nan;0;0
9346;191331;97;92;38;2;36;.947;3600000;0
9347;189359;87;37;24;5;19;.792;3162000;0
9347;189628;89;28;27;6;21;.778;2165000;0
9347;196495;87;56;3;0;3;1.000;438000;0
9347;186155;89;35;13;3;10;.769;1435000;0
9348;192733;99;70;35;3;32;.914;3547000;0
9348;194531;99;0;0;0;0;.00nan;0;0
9348;184310;98;0;0;0;0;.00nan;0;0
9348;186029;98;62;23;2;21;.913;3600000;0
9349;192739;92;63;17;1;16;.941;2441000;0
9349;184437;96;16;28;7;21;.750;3263000;0
9349;184770;96;53;3;0;3;1.000;337000;0
9349;190106;92;47;23;4;19;.826;1159000;0
9350;184229;106;0;0;0;0;.00nan;0;0
9350;189581;107;33;40;7;33;.825;3600000;0
9350;184866;106;64;25;3;22;.880;3600000;0
9350;187391;107;0;0;0;0;.00nan;0;0
9351;182266;105;30;24;6;18;.750;2157000;0
9351;178384;103;70;26;2;24;.923;3600000;0
9351;189639;105;62;9;0;9;1.000;1443000;0
9351;184861;103;0;0;0;0;.00nan;0;0
9352;194899;101;0;0;0;0;.00nan;0;0
9352;184229;106;0;0;0;0;.00nan;0;0
9352;184866;106;66;40;4;36;.900;3900000;0
9352;187096;101;67;37;4;33;.892;3900000;0
9353;194502;86;59;33;3;30;.909;3600000;0
9353;189359;87;0;0;0;0;.00nan;0;0
9353;196495;87;74;41;4;37;.902;3544000;0
9353;-1;86;0;0;0;0;.00nan;0;0
9354;184158;90;66;31;3;28;.903;3572000;0
9354;184225;93;0;0;0;0;.00nan;0;0
9354;-1;90;0;0;0;0;.00nan;0;0
9354;-1;93;87;34;2;32;.941;3600000;0
9355;189644;95;70;25;2;23;.920;3543000;0
9355;184437;96;100;34;0;34;1.000;3600000;0
9355;195346;95;0;0;0;0;.00nan;0;0
9355;184770;96;0;0;0;0;.00nan;0;0
9356;178384;103;84;34;3;31;.912;3600000;0
9356;194632;102;57;27;4;23;.852;3543000;0
9356;189573;102;0;0;0;0;.00nan;0;0
9356;184861;103;0;0;0;0;.00nan;0;0
9357;184081;88;52;45;6;39;.867;3600000;0
9357;189628;89;65;24;2;22;.917;3600000;0
9357;186155;89;0;0;0;0;.00nan;0;0
9357;191318;88;0;0;0;0;.00nan;0;0
9358;183633;91;88;38;2;36;.947;3600000;0
9358;189433;91;0;0;0;0;.00nan;0;0
9358;189576;97;72;38;3;35;.921;3600000;0
9358;191331;97;0;0;0;0;.00nan;0;0
9359;194502;86;79;29;2;27;.931;3600000;0
9359;184158;90;80;39;3;36;.923;3573000;0
9359;-1;90;0;0;0;0;.00nan;0;0
9359;-1;86;0;0;0;0;.00nan;0;0
9360;189359;87;0;0;0;0;.00nan;0;0
9360;184081;88;65;33;4;29;.879;3579000;0
9360;196495;87;48;22;3;19;.864;3600000;0
9360;191318;88;0;0;0;0;.00nan;0;0
9361;184225;93;73;19;1;18;.947;3600000;0
9361;184437;96;85;46;3;43;.935;3600000;0
9361;184770;96;0;0;0;0;.00nan;0;0
9361;-1;93;0;0;0;0;.00nan;0;0
9362;192733;99;79;28;1;27;.964;3600000;0
9362;194531;99;0;0;0;0;.00nan;0;0
9362;194899;101;0;0;0;0;.00nan;0;0
9362;187096;101;48;34;4;30;.882;3600000;0
9363;189333;100;0;0;0;0;.00nan;0;0
9363;184310;98;45;30;5;25;.833;3545000;0
9363;184398;100;48;17;3;14;.824;3600000;0
9363;186029;98;0;0;0;0;.00nan;0;0
9364;182266;105;0;0;0;0;.00nan;0;0
9364;184229;106;0;0;0;0;.00nan;0;0
9364;189639;105;66;25;2;23;.920;3600000;0
9364;184866;106;71;45;4;41;.911;3513000;0
9365;189581;107;0;0;0;0;.00nan;0;0
9365;185220;104;0;0;0;0;.00nan;0;0
9365;187391;107;54;23;3;20;.870;3600000;0
9365;191255;104;52;36;5;31;.861;3514000;0
9366;178384;103;72;36;4;32;.889;3600000;0
9366;194632;102;86;26;1;25;.962;3600000;0
9366;189573;102;0;0;0;0;.00nan;0;0
9366;184861;103;0;0;0;0;.00nan;0;0
9367;183633;91;0;0;0;0;.00nan;0;0
9367;189433;91;71;22;2;20;.909;3600000;0
9367;189576;97;47;6;1;5;.833;904000;0
9367;191331;97;35;36;6;30;.833;2696000;0
9368;189359;87;35;32;6;26;.813;3524000;0
9368;189628;89;46;31;5;26;.839;3600000;0
9368;196495;87;0;0;0;0;.00nan;0;0
9368;186155;89;0;0;0;0;.00nan;0;0
9369;184229;106;47;39;6;33;.846;3600000;0
9369;189581;107;79;27;2;25;.926;3600000;0
9369;184866;106;0;0;0;0;.00nan;0;0
9369;187391;107;0;0;0;0;.00nan;0;0
9370;192733;99;64;28;3;25;.893;3900000;0
9370;194531;99;0;0;0;0;.00nan;0;0
9370;194899;101;68;39;3;36;.923;3900000;0
9370;187096;101;0;0;0;0;.00nan;0;0
9371;192739;92;0;0;0;0;.00nan;0;0
9371;189644;95;57;33;4;29;.879;3600000;0
9371;195346;95;0;0;0;0;.00nan;0;0
9371;190106;92;62;46;6;40;.870;3520000;0
9372;194502;86;0;0;0;0;.00nan;0;0
9372;184158;90;0;0;0;0;.00nan;0;0
9372;-1;90;44;27;4;23;.852;3600000;0
9372;-1;86;37;26;5;21;.808;3569000;0
9373;182266;105;0;0;0;0;.00nan;0;0
9373;189639;105;77;22;1;21;.955;3600000;0
9373;185220;104;77;48;5;43;.896;3600000;0
9373;191255;104;0;0;0;0;.00nan;0;0
9374;178384;103;78;25;2;23;.920;3600000;0
9374;184861;103;0;0;0;0;.00nan;0;0
9374;185240;94;0;0;0;0;.00nan;0;0
9374;196525;94;65;32;3;29;.906;3600000;0
9375;189333;100;49;28;4;24;.857;3600000;0
9375;184310;98;0;0;0;0;.00nan;0;0
9375;184398;100;0;0;0;0;.00nan;0;0
9375;186029;98;85;36;2;34;.944;3600000;0
9376;184225;93;0;0;0;0;.00nan;0;0
9376;184437;96;58;41;6;35;.854;3684000;0
9376;184770;96;0;0;0;0;.00nan;0;0
9376;-1;93;77;45;5;40;.889;3673000;0
9377;192739;92;47;40;6;34;.850;3600000;0
9377;189644;95;0;0;0;0;.00nan;0;0
9377;195346;95;72;20;1;19;.950;3600000;0
9377;190106;92;0;0;0;0;.00nan;0;0
9378;185220;104;0;0;0;0;.00nan;0;0
9378;185240;94;70;18;1;17;.944;3600000;0
9378;196525;94;0;0;0;0;.00nan;0;0
9378;191255;104;62;41;5;36;.878;3600000;0
9379;184229;106;0;0;0;0;.00nan;0;0
9379;189581;107;0;0;0;0;.00nan;0;0
9379;184866;106;79;40;3;37;.925;3580000;0
9379;187391;107;80;29;2;27;.931;3600000;0
9381;194502;86;70;25;2;23;.920;3600000;0
9381;184310;98;57;26;3;23;.885;3551000;0
9381;186029;98;0;0;0;0;.00nan;0;0
9381;-1;86;0;0;0;0;.00nan;0;0
9383;178384;103;85;41;3;38;.927;3600000;0
9383;189628;89;0;0;0;0;.00nan;0;0
9383;195330;89;46;23;4;19;.826;3546000;0
9383;196473;103;0;0;0;0;.00nan;0;0
9385;194632;102;63;38;4;34;.895;3600000;0
9385;189573;102;0;0;0;0;.00nan;0;0
9385;184437;96;94;23;0;23;1.000;3600000;0
9385;184770;96;0;0;0;0;.00nan;0;0
9387;189359;87;96;23;0;23;1.000;3600000;0
9387;184081;88;36;33;5;28;.848;3600000;0
9387;-1;87;0;0;0;0;.00nan;0;0
9387;191318;88;0;0;0;0;.00nan;0;0
9389;189333;100;0;0;0;0;.00nan;0;0
9389;189576;97;87;40;3;37;.925;3600000;0
9389;184398;100;43;33;5;28;.848;3525000;0
9389;191331;97;0;0;0;0;.00nan;0;0
9391;192733;99;72;25;1;24;.960;3600000;0
9391;194531;99;0;0;0;0;.00nan;0;0
9391;185240;94;26;13;4;9;.692;522000;0
9391;196525;94;46;38;6;32;.842;3078000;0
9393;184158;90;25;6;3;3;.500;572000;0
9393;-1;90;74;25;3;22;.880;3028000;0
9393;185220;104;0;0;0;0;.00nan;0;0
9393;191255;104;100;47;2;45;.957;3600000;0
9395;182266;105;0;0;0;0;.00nan;0;0
9395;189581;107;78;29;2;27;.931;3874000;0
9395;189639;105;44;17;3;14;.824;3874000;0
9395;187391;107;0;0;0;0;.00nan;0;0
9397;183633;91;57;29;4;25;.862;3613000;0
9397;189433;91;0;0;0;0;.00nan;0;0
9397;189644;95;65;27;3;24;.889;3612000;0
9397;195346;95;0;0;0;0;.00nan;0;0
9399;184225;93;0;0;0;0;.00nan;0;0
9399;184229;106;62;35;3;32;.914;3874000;0
9399;184866;106;0;0;0;0;.00nan;0;0
9399;-1;93;56;27;3;24;.889;3900000;0
9401;192739;92;0;0;0;0;.00nan;0;0
9401;189978;101;0;0;0;0;.00nan;0;0
9401;190106;92;48;27;4;23;.852;3550000;0
9401;187096;101;66;25;3;22;.880;3600000;0
9403;189628;89;72;28;2;26;.929;3580000;0
9403;184310;98;97;34;1;33;.971;3600000;0
9403;195330;89;0;0;0;0;.00nan;0;0
9403;186029;98;0;0;0;0;.00nan;0;0
9405;178384;103;92;30;1;29;.967;3600000;0
9405;189644;95;58;41;5;36;.878;3600000;0
9405;195346;95;0;0;0;0;.00nan;0;0
9405;196473;103;0;0;0;0;.00nan;0;0
9407;185220;104;44;41;6;35;.854;3600000;0
9407;185240;94;0;0;0;0;.00nan;0;0
9407;196525;94;63;20;2;18;.900;3600000;0
9407;191255;104;0;0;0;0;.00nan;0;0
9409;192739;92;0;0;0;0;.00nan;0;0
9409;189333;100;55;21;2;19;.905;3600000;0
9409;184398;100;0;0;0;0;.00nan;0;0
9409;190106;92;89;44;3;41;.932;3572000;0
9411;184225;93;39;21;4;17;.810;2795000;0
9411;189581;107;0;0;0;0;.00nan;0;0
9411;-1;93;27;12;4;8;.667;805000;0
9411;187391;107;47;33;5;28;.848;3600000;0
9413;184081;88;78;37;2;35;.946;3590000;0
9413;189978;101;0;0;0;0;.00nan;0;0
9413;187096;101;61;14;1;13;.929;3600000;0
9413;191318;88;0;0;0;0;.00nan;0;0
9415;182266;105;0;0;0;0;.00nan;0;0
9415;189576;97;62;31;4;27;.871;3600000;0
9415;189639;105;85;23;1;22;.957;3600000;0
9415;191331;97;0;0;0;0;.00nan;0;0
9417;192733;99;66;17;1;16;.941;3154000;0
9417;194502;86;51;36;5;31;.861;3600000;0
9417;194531;99;24;4;3;1;.250;446000;0
9417;-1;86;0;0;0;0;.00nan;0;0
9419;194632;102;53;27;4;23;.852;3600000;0
9419;189573;102;0;0;0;0;.00nan;0;0
9419;184437;96;64;24;2;22;.917;3600000;0
9419;184770;96;0;0;0;0;.00nan;0;0
9421;184158;90;87;20;0;20;1.000;3600000;0
9421;184229;106;63;46;6;40;.870;3155000;0
9421;184866;106;51;3;0;3;1.000;445000;0
9421;-1;90;0;0;0;0;.00nan;0;0
9423;183633;91;73;27;1;26;.963;3600000;0
9423;189359;87;68;32;2;30;.938;3600000;0
9423;189433;91;0;0;0;0;.00nan;0;0
9423;-1;87;0;0;0;0;.00nan;0;0
9425;189333;100;0;0;0;0;.00nan;0;0
9425;184398;100;68;18;1;17;.944;3600000;0
9425;185240;94;29;27;5;22;.815;2222000;0
9425;196525;94;55;12;1;11;.917;1378000;0
9427;189628;89;0;0;0;0;.00nan;0;0
9427;189644;95;0;0;0;0;.00nan;0;0
9427;195330;89;60;30;5;25;.833;3600000;0
9427;195346;95;77;26;1;25;.962;3600000;0
9429;184081;88;0;0;0;0;.00nan;0;0
9429;184310;98;0;0;0;0;.00nan;0;0
9429;186029;98;58;19;2;17;.895;3600000;0
9429;191318;88;72;35;3;32;.914;3572000;0
9431;189576;97;0;0;0;0;.00nan;0;0
9431;185220;104;0;0;0;0;.00nan;0;0
9431;191255;104;47;31;4;27;.871;3600000;0
9431;191331;97;74;22;1;21;.955;3600000;0
9433;194502;86;0;0;0;0;.00nan;0;0
9433;184437;96;0;0;0;0;.00nan;0;0
9433;184770;96;72;27;1;26;.963;3600000;0
9433;-1;86;59;27;3;24;.889;3600000;0
9435;192733;99;0;0;0;0;.00nan;0;0
9435;194531;99;95;42;3;39;.929;3543000;0
9435;189359;87;0;0;0;0;.00nan;0;0
9435;-1;87;80;32;2;30;.938;3600000;0
9437;184158;90;63;26;3;23;.885;3600000;0
9437;184225;93;0;0;0;0;.00nan;0;0
9437;-1;90;0;0;0;0;.00nan;0;0
9437;-1;93;50;43;6;37;.860;3600000;0
9439;192739;92;28;34;6;28;.824;3600000;0
9439;183633;91;0;0;0;0;.00nan;0;0
9439;189433;91;72;28;3;25;.893;3600000;0
9439;190106;92;0;0;0;0;.00nan;0;0
9441;182266;105;65;31;3;28;.903;3600000;0
9441;184229;106;0;0;0;0;.00nan;0;0
9441;189639;105;0;0;0;0;.00nan;0;0
9441;184866;106;27;23;5;18;.783;3575000;0
9443;189581;107;70;25;2;23;.920;3600000;0
9443;189978;101;46;46;8;38;.826;3600000;0
9443;187096;101;0;0;0;0;.00nan;0;0
9443;187391;107;0;0;0;0;.00nan;0;0
9445;178384;103;0;0;0;0;.00nan;0;0
9445;194632;102;0;0;0;0;.00nan;0;0
9445;189573;102;24;26;6;20;.769;3600000;0
9445;196473;103;91;24;1;23;.958;3600000;0
9447;189576;97;0;0;0;0;.00nan;0;0
9447;185240;94;93;19;0;19;1.000;3600000;0
9447;196525;94;0;0;0;0;.00nan;0;0
9447;191331;97;63;39;4;35;.897;3600000;0
9449;182266;105;0;0;0;0;.00nan;0;0
9449;178384;103;99;35;1;34;.971;3600000;0
9449;189639;105;55;29;4;25;.862;3600000;0
9449;196473;103;0;0;0;0;.00nan;0;0
9451;194502;86;76;43;5;38;.884;3600000;0
9451;184310;98;67;33;3;30;.909;3600000;0
9451;186029;98;0;0;0;0;.00nan;0;0
9451;-1;86;0;0;0;0;.00nan;0;0
9453;194632;102;37;19;4;15;.789;3600000;0
9453;189573;102;0;0;0;0;.00nan;0;0
9453;185220;104;64;43;5;38;.884;3556000;0
9453;191255;104;0;0;0;0;.00nan;0;0
9455;189359;87;0;0;0;0;.00nan;0;0
9455;184229;106;71;34;2;32;.941;3600000;0
9455;184866;106;0;0;0;0;.00nan;0;0
9455;-1;87;60;28;3;25;.893;3583000;0
9457;192739;92;91;34;1;33;.971;3600000;0
9457;184158;90;39;24;5;19;.792;3600000;0
9457;190106;92;0;0;0;0;.00nan;0;0
9457;-1;90;0;0;0;0;.00nan;0;0
9459;189333;100;80;28;2;26;.929;3600000;0
9459;184398;100;0;0;0;0;.00nan;0;0
9459;184437;96;76;32;3;29;.906;3600000;0
9459;184770;96;0;0;0;0;.00nan;0;0
9461;184081;88;94;43;2;41;.953;3600000;0
9461;184225;93;49;25;4;21;.840;3531000;0
9461;-1;93;0;0;0;0;.00nan;0;0
9461;191318;88;0;0;0;0;.00nan;0;0
9463;192733;99;0;0;0;0;.00nan;0;0
9463;194531;99;61;29;3;26;.897;3600000;0
9463;189628;89;49;36;5;31;.861;3574000;0
9463;195330;89;0;0;0;0;.00nan;0;0
9465;189644;95;87;34;1;33;.971;3600000;0
9465;195346;95;0;0;0;0;.00nan;0;0
9465;189978;101;0;0;0;0;.00nan;0;0
9465;187096;101;71;30;2;28;.933;3573000;0
9467;183633;91;30;8;3;5;.625;503000;0
9467;189433;91;68;36;4;32;.889;3097000;0
9467;189581;107;0;0;0;0;.00nan;0;0
9467;187391;107;75;22;1;21;.955;3600000;0
9469;183633;91;46;23;3;20;.870;3600000;0
9469;189433;91;0;0;0;0;.00nan;0;0
9469;184229;106;0;0;0;0;.00nan;0;0
9469;184866;106;49;29;5;24;.828;3600000;0
9471;194632;102;0;0;0;0;.00nan;0;0
9471;189573;102;55;22;3;19;.864;3567000;0
9471;189581;107;77;37;2;35;.946;3600000;0
9471;187391;107;0;0;0;0;.00nan;0;0
9473;192733;99;80;27;1;26;.963;3600000;0
9473;194531;99;0;0;0;0;.00nan;0;0
9473;189628;89;0;0;0;0;.00nan;0;0
9473;195330;89;75;35;3;32;.914;3600000;0
9475;189576;97;65;31;3;28;.903;3600000;0
9475;185240;94;46;30;5;25;.833;3597000;0
9475;196525;94;0;0;0;0;.00nan;0;0
9475;191331;97;0;0;0;0;.00nan;0;0
9477;182266;105;43;26;4;22;.846;3561000;0
9477;184310;98;0;0;0;0;.00nan;0;0
9477;189639;105;0;0;0;0;.00nan;0;0
9477;186029;98;58;26;3;23;.885;3600000;0
9479;184158;90;0;0;0;0;.00nan;0;0
9479;184225;93;0;0;0;0;.00nan;0;0
9479;-1;90;72;25;2;23;.920;3600000;0
9479;-1;93;68;43;6;37;.860;3600000;0
9481;178384;103;0;0;0;0;.00nan;0;0
9481;189333;100;0;0;0;0;.00nan;0;0
9481;184398;100;81;28;1;27;.964;3600000;0
9481;196473;103;32;25;4;21;.840;3600000;0
9483;189359;87;77;32;1;31;.969;3600000;0
9483;185220;104;31;9;3;6;.667;615000;0
9483;-1;87;0;0;0;0;.00nan;0;0
9483;191255;104;39;28;6;22;.786;2985000;0
9485;184081;88;0;0;0;0;.00nan;0;0
9485;189978;101;76;26;1;25;.962;3600000;0
9485;187096;101;0;0;0;0;.00nan;0;0
9485;191318;88;55;41;4;37;.902;3600000;0
9487;192739;92;0;0;0;0;.00nan;0;0
9487;194502;86;0;0;0;0;.00nan;0;0
9487;190106;92;94;46;1;45;.978;3594000;0
9487;-1;86;100;26;0;26;1.000;3600000;0
9489;189644;95;0;0;0;0;.00nan;0;0
9489;184437;96;0;0;0;0;.00nan;0;0
9489;195346;95;28;24;5;19;.792;3600000;0
9489;184770;96;76;37;4;33;.892;3600000;0
9491;189333;100;71;23;1;22;.957;3600000;0
9491;184398;100;0;0;0;0;.00nan;0;0
9491;189978;101;0;0;0;0;.00nan;0;0
9491;187096;101;8;36;10;26;.722;3600000;0
9493;192739;92;0;0;0;0;.00nan;0;0
9493;189581;107;0;0;0;0;.00nan;0;0
9493;190106;92;63;37;4;33;.892;3600000;0
9493;187391;107;54;21;3;18;.857;3600000;0
9495;192733;99;0;0;0;0;.00nan;0;0
9495;194531;99;66;40;4;36;.900;3879000;0
9495;184081;88;44;21;4;17;.810;3900000;0
9495;191318;88;0;0;0;0;.00nan;0;0
9497;182266;105;0;0;0;0;.00nan;0;0
9497;189576;97;0;0;0;0;.00nan;0;0
9497;189639;105;60;35;4;31;.886;3557000;0
9497;191331;97;73;27;2;25;.926;3600000;0
9499;184158;90;68;21;1;20;.952;3600000;0
9499;-1;90;0;0;0;0;.00nan;0;0
9499;185240;94;31;9;3;6;.667;598000;0
9499;196525;94;20;26;6;20;.769;3002000;0
9501;184225;93;70;35;4;31;.886;3600000;0
9501;189644;95;79;34;3;31;.912;3600000;0
9501;195346;95;0;0;0;0;.00nan;0;0
9501;-1;93;0;0;0;0;.00nan;0;0
9503;194632;102;26;27;6;21;.778;3600000;0
9503;189573;102;0;0;0;0;.00nan;0;0
9503;184310;98;22;14;5;9;.643;1975000;0
9503;186029;98;54;17;2;15;.882;1625000;0
9505;189628;89;75;33;3;30;.909;3600000;0
9505;195330;89;0;0;0;0;.00nan;0;0
9505;185220;104;79;28;2;26;.929;3600000;0
9505;191255;104;0;0;0;0;.00nan;0;0
9507;183633;91;0;0;0;0;.00nan;0;0
9507;189433;91;71;26;2;24;.923;3600000;0
9507;184229;106;64;34;3;31;.912;3567000;0
9507;184866;106;0;0;0;0;.00nan;0;0
9509;194502;86;0;0;0;0;.00nan;0;0
9509;189359;87;0;0;0;0;.00nan;0;0
9509;-1;87;36;33;5;28;.848;3600000;0
9509;-1;86;90;31;2;29;.935;3600000;0
9511;178384;103;63;19;2;17;.895;3900000;0
9511;184437;96;87;42;2;40;.952;3900000;0
9511;184770;96;0;0;0;0;.00nan;0;0
9511;196473;103;0;0;0;0;.00nan;0;0
9513;183633;91;75;33;3;30;.909;3556000;0
9513;189433;91;0;0;0;0;.00nan;0;0
9513;189628;89;0;0;0;0;.00nan;0;0
9513;195330;89;76;24;1;23;.958;3600000;0
9515;194632;102;0;0;0;0;.00nan;0;0
9515;189573;102;84;15;0;15;1.000;3600000;0
9515;184310;98;23;13;4;9;.692;1006000;0
9515;186029;98;97;32;0;32;1.000;2594000;0
9517;178384;103;0;0;0;0;.00nan;0;0
9517;185220;104;0;0;0;0;.00nan;0;0
9517;196473;103;45;34;5;29;.853;3566000;0
9517;191255;104;70;26;3;23;.885;3600000;0
9519;184158;90;0;0;0;0;.00nan;0;0
9519;184225;93;72;29;2;27;.931;2607000;0
9519;-1;90;60;24;2;22;.917;3600000;0
9519;-1;93;44;17;4;13;.765;993000;0
9521;189333;100;0;0;0;0;.00nan;0;0
9521;189581;107;72;26;2;24;.923;3543000;0
9521;184398;100;100;33;0;33;1.000;3600000;0
9521;187391;107;0;0;0;0;.00nan;0;0
9523;189359;87;69;16;1;15;.938;3600000;0
9523;184081;88;0;0;0;0;.00nan;0;0
9523;-1;87;0;0;0;0;.00nan;0;0
9523;191318;88;67;44;4;40;.909;3600000;0
9525;184437;96;0;0;0;0;.00nan;0;0
9525;184770;96;64;28;3;25;.893;3585000;0
9525;185240;94;85;35;2;33;.943;3600000;0
9525;196525;94;0;0;0;0;.00nan;0;0
9527;194502;86;65;23;2;21;.913;3600000;0
9527;189644;95;0;0;0;0;.00nan;0;0
9527;195346;95;46;33;5;28;.848;3600000;0
9527;-1;86;0;0;0;0;.00nan;0;0
9529;182266;105;68;22;2;20;.909;3600000;0
9529;189576;97;39;38;6;32;.842;3600000;0
9529;189639;105;0;0;0;0;.00nan;0;0
9529;191331;97;0;0;0;0;.00nan;0;0
9531;192733;99;87;30;1;29;.967;3600000;0
9531;194531;99;0;0;0;0;.00nan;0;0
9531;189978;101;29;30;6;24;.800;3600000;0
9531;187096;101;0;0;0;0;.00nan;0;0
9533;192739;92;77;28;2;26;.929;3553000;0
9533;184229;106;0;0;0;0;.00nan;0;0
9533;190106;92;0;0;0;0;.00nan;0;0
9533;184866;106;87;28;1;27;.964;3600000;0
1781;194502;86;60;29;3;26;.897;3600000;0
1781;184437;96;19;26;7;19;.731;3213000;0
1781;184770;96;44;5;1;4;.800;387000;0
1781;-1;86;0;0;0;0;.00nan;0;0
1782;189359;87;0;0;0;0;.00nan;0;0
1782;189628;89;80;45;3;42;.933;3600000;0
1782;196495;87;90;15;0;15;1.000;3600000;0
1782;186155;89;0;0;0;0;.00nan;0;0
1783;183633;91;78;28;1;27;.964;3600000;0
1783;189433;91;0;0;0;0;.00nan;0;0
1783;184158;90;35;25;6;19;.760;3600000;0
1783;-1;90;0;0;0;0;.00nan;0;0
1784;184225;93;0;0;0;0;.00nan;0;0
1784;189644;95;75;45;4;41;.911;3571000;0
1784;195346;95;0;0;0;0;.00nan;0;0
1784;-1;93;68;33;3;30;.909;3600000;0
1785;194632;102;79;40;3;37;.925;3574000;0
1785;194899;101;0;0;0;0;.00nan;0;0
1785;189573;102;0;0;0;0;.00nan;0;0
1785;187096;101;66;23;2;21;.913;3600000;0
1786;192733;99;69;25;2;23;.920;3600000;0
1786;194531;99;0;0;0;0;.00nan;0;0
1786;184310;98;74;34;2;32;.941;2822000;0
1786;186029;98;25;11;4;7;.636;778000;0
1787;189333;100;0;0;0;0;.00nan;0;0
1787;189581;107;0;0;0;0;.00nan;0;0
1787;184398;100;49;22;3;19;.864;3929000;0
1787;187391;107;74;43;4;39;.907;3929000;0
1788;182266;105;0;0;0;0;.00nan;0;0
1788;178384;103;83;30;2;28;.933;3600000;0
1788;189639;105;54;31;4;27;.871;3581000;0
1788;184861;103;0;0;0;0;.00nan;0;0
1789;194502;86;46;42;6;36;.857;3334000;0
1789;184437;96;81;34;3;31;.912;3600000;0
1789;184770;96;0;0;0;0;.00nan;0;0
1789;-1;86;42;3;1;2;.667;266000;0
1790;189359;87;0;0;0;0;.00nan;0;0
1790;189628;89;100;47;2;45;.957;3600000;0
1790;196495;87;48;27;5;22;.815;3600000;0
1790;186155;89;0;0;0;0;.00nan;0;0
1791;183633;91;64;41;4;37;.902;3600000;0
1791;189433;91;0;0;0;0;.00nan;0;0
1791;184158;90;88;32;1;31;.969;3600000;0
1791;-1;90;0;0;0;0;.00nan;0;0
1792;184225;93;0;0;0;0;.00nan;0;0
1792;189644;95;76;21;1;20;.952;3600000;0
1792;195346;95;0;0;0;0;.00nan;0;0
1792;-1;93;55;32;4;28;.875;3600000;0
1793;194632;102;76;25;3;22;.880;3574000;0
1793;194899;101;0;0;0;0;.00nan;0;0
1793;189573;102;0;0;0;0;.00nan;0;0
1793;187096;101;96;44;2;42;.955;3600000;0
1794;192733;99;66;23;2;21;.913;3600000;0
1794;194531;99;0;0;0;0;.00nan;0;0
1794;184310;98;0;0;0;0;.00nan;0;0
1794;186029;98;53;23;3;20;.870;3526000;0
1795;189333;100;0;0;0;0;.00nan;0;0
1795;189581;107;0;0;0;0;.00nan;0;0
1795;184398;100;75;26;1;25;.962;3600000;0
1795;187391;107;49;39;6;33;.846;3600000;0
1796;182266;105;0;0;0;0;.00nan;0;0
1796;178384;103;47;36;5;31;.861;4321000;0
1796;189639;105;68;36;4;32;.889;4321000;0
1796;184861;103;0;0;0;0;.00nan;0;0
1797;194502;86;71;40;4;36;.900;3600000;0
1797;184437;96;35;26;5;21;.808;3584000;0
1797;184770;96;0;0;0;0;.00nan;0;0
1797;-1;86;0;0;0;0;.00nan;0;0
1798;189359;87;0;0;0;0;.00nan;0;0
1798;189628;89;56;34;4;30;.882;3713000;0
1798;196495;87;49;29;5;24;.828;3713000;0
1798;186155;89;0;0;0;0;.00nan;0;0
1799;183633;91;53;33;4;29;.879;3514000;0
1799;189433;91;0;0;0;0;.00nan;0;0
1799;184158;90;85;36;2;34;.944;3600000;0
1799;-1;90;0;0;0;0;.00nan;0;0
1800;184225;93;0;0;0;0;.00nan;0;0
1800;189644;95;9;32;8;24;.750;3600000;0
1800;195346;95;0;0;0;0;.00nan;0;0
1800;-1;93;56;30;4;26;.867;3600000;0
1801;194632;102;81;27;1;26;.963;3600000;0
1801;194899;101;0;0;0;0;.00nan;0;0
1801;189573;102;0;0;0;0;.00nan;0;0
1801;187096;101;60;28;3;25;.893;3555000;0
1802;192733;99;89;34;1;33;.971;3790000;0
1802;194531;99;0;0;0;0;.00nan;0;0
1802;184310;98;0;0;0;0;.00nan;0;0
1802;186029;98;79;29;2;27;.931;3790000;0
1803;189333;100;0;0;0;0;.00nan;0;0
1803;189581;107;0;0;0;0;.00nan;0;0
1803;184398;100;55;23;2;21;.913;3600000;0
1803;187391;107;50;42;5;37;.881;3600000;0
1804;182266;105;0;0;0;0;.00nan;0;0
1804;178384;103;64;27;3;24;.889;3854000;0
1804;189639;105;86;40;2;38;.950;3854000;0
1804;184861;103;0;0;0;0;.00nan;0;0
1805;194502;86;44;30;5;25;.833;3600000;0
1805;184437;96;90;21;0;21;1.000;3600000;0
1805;184770;96;0;0;0;0;.00nan;0;0
1805;-1;86;0;0;0;0;.00nan;0;0
1806;189359;87;0;0;0;0;.00nan;0;0
1806;189628;89;100;50;2;48;.960;3600000;0
1806;196495;87;46;21;3;18;.857;3545000;0
1806;186155;89;0;0;0;0;.00nan;0;0
1807;183633;91;48;30;5;25;.833;3558000;0
1807;189433;91;0;0;0;0;.00nan;0;0
1807;184158;90;56;26;3;23;.885;3600000;0
1807;-1;90;0;0;0;0;.00nan;0;0
1808;184225;93;0;0;0;0;.00nan;0;0
1808;189644;95;100;39;1;38;.974;3600000;0
1808;195346;95;0;0;0;0;.00nan;0;0
1808;-1;93;62;27;3;24;.889;3527000;0
1809;194632;102;48;22;4;18;.818;3634000;0
1809;194899;101;0;0;0;0;.00nan;0;0
1809;189573;102;0;0;0;0;.00nan;0;0
1809;187096;101;90;45;3;42;.933;3634000;0
1810;192733;99;73;34;3;31;.912;3600000;0
1810;194531;99;0;0;0;0;.00nan;0;0
1810;184310;98;0;0;0;0;.00nan;0;0
1810;186029;98;81;15;0;15;1.000;3600000;0
1811;189333;100;0;0;0;0;.00nan;0;0
1811;189581;107;0;0;0;0;.00nan;0;0
1811;184398;100;62;19;2;17;.895;3600000;0
1811;187391;107;54;22;4;18;.818;3513000;0
1812;182266;105;52;21;3;18;.857;2550000;0
1812;178384;103;82;29;1;28;.966;3600000;0
1812;189639;105;28;14;4;10;.714;1050000;0
1812;184861;103;0;0;0;0;.00nan;0;0
1960;194502;86;63;40;5;35;.875;3600000;0
1960;184437;96;36;33;6;27;.818;3554000;0
1960;184770;96;0;0;0;0;.00nan;0;0
1960;-1;86;0;0;0;0;.00nan;0;0
1961;189359;87;0;0;0;0;.00nan;0;0
1961;189628;89;77;38;3;35;.921;3600000;0
1961;196495;87;58;33;4;29;.879;3552000;0
1961;186155;89;0;0;0;0;.00nan;0;0
1962;183633;91;65;26;3;23;.885;3600000;0
1962;189433;91;0;0;0;0;.00nan;0;0
1962;184158;90;35;26;5;21;.808;3552000;0
1962;-1;90;0;0;0;0;.00nan;0;0
1963;184225;93;0;0;0;0;.00nan;0;0
1963;189644;95;66;45;4;41;.911;4631000;0
1963;195346;95;0;0;0;0;.00nan;0;0
1963;-1;93;69;41;3;38;.927;4631000;0
1964;194632;102;90;27;1;26;.963;3813000;0
1964;194899;101;0;0;0;0;.00nan;0;0
1964;189573;102;0;0;0;0;.00nan;0;0
1964;187096;101;94;49;2;47;.959;3813000;0
1965;192733;99;75;21;1;20;.952;3600000;0
1965;194531;99;0;0;0;0;.00nan;0;0
1965;184310;98;54;4;0;4;1.000;430000;0
1965;186029;98;52;34;6;28;.824;3170000;0
1966;182266;105;75;31;3;28;.903;3600000;0
1966;178384;103;34;30;6;24;.800;3318000;0
1966;189639;105;0;0;0;0;.00nan;0;0
1966;184861;103;55;3;0;3;1.000;282000;0
2007;194502;86;35;27;5;22;.815;3567000;0
2007;184437;96;74;36;4;32;.889;3600000;0
2007;184770;96;0;0;0;0;.00nan;0;0
2007;-1;86;0;0;0;0;.00nan;0;0
2008;183633;91;63;29;3;26;.897;3569000;0
2008;189433;91;0;0;0;0;.00nan;0;0
2008;184158;90;84;26;1;25;.962;3600000;0
2008;-1;90;0;0;0;0;.00nan;0;0
2009;184225;93;0;0;0;0;.00nan;0;0
2009;189644;95;70;35;3;32;.914;3600000;0
2009;195346;95;0;0;0;0;.00nan;0;0
2009;-1;93;43;32;5;27;.844;3543000;0
2010;194632;102;26;14;4;10;.714;3600000;0
2010;194899;101;0;0;0;0;.00nan;0;0
2010;189573;102;0;0;0;0;.00nan;0;0
2010;187096;101;50;36;5;31;.861;3600000;0
2011;182266;105;61;20;2;18;.900;4029000;0
2011;178384;103;97;38;1;37;.974;4029000;0
2011;189639;105;0;0;0;0;.00nan;0;0
2011;184861;103;0;0;0;0;.00nan;0;0
2056;194502;86;61;15;2;13;.867;3600000;0
2056;184437;96;45;35;5;30;.857;3600000;0
2056;184770;96;0;0;0;0;.00nan;0;0
2056;-1;86;0;0;0;0;.00nan;0;0
2057;184225;93;0;0;0;0;.00nan;0;0
2057;189644;95;99;40;1;39;.975;3600000;0
2057;195346;95;0;0;0;0;.00nan;0;0
2057;-1;93;55;40;5;35;.875;3600000;0
2058;194632;102;70;23;2;21;.913;3754000;0
2058;194899;101;0;0;0;0;.00nan;0;0
2058;189573;102;0;0;0;0;.00nan;0;0
2058;187096;101;71;37;3;34;.919;3754000;0
2059;182266;105;77;27;2;25;.926;3600000;0
2059;178384;103;69;35;3;32;.914;3566000;0
2059;189639;105;0;0;0;0;.00nan;0;0
2059;184861;103;0;0;0;0;.00nan;0;0
2103;194502;86;45;26;4;22;.846;3581000;0
2103;189628;89;80;36;2;34;.944;3600000;0
2103;186155;89;0;0;0;0;.00nan;0;0
2103;-1;86;0;0;0;0;.00nan;0;0
2104;184158;90;71;19;1;18;.947;3600000;0
2104;189644;95;70;32;2;30;.938;3567000;0
2104;195346;95;0;0;0;0;.00nan;0;0
2104;-1;90;0;0;0;0;.00nan;0;0
2105;192733;99;85;41;2;39;.951;3524000;0
2105;194531;99;0;0;0;0;.00nan;0;0
2105;194632;102;100;24;0;24;1.000;3600000;0
2105;189573;102;0;0;0;0;.00nan;0;0
2106;182266;105;0;0;0;0;.00nan;0;0
2106;189333;100;0;0;0;0;.00nan;0;0
2106;189639;105;58;35;4;31;.886;3550000;0
2106;184398;100;59;30;3;27;.900;3600000;0
2107;194502;86;60;28;4;24;.857;3600000;0
2107;189628;89;51;42;6;36;.857;3561000;0
2107;186155;89;0;0;0;0;.00nan;0;0
2107;-1;86;0;0;0;0;.00nan;0;0
2108;184158;90;89;27;1;26;.963;3600000;0
2108;189644;95;79;40;3;37;.925;3587000;0
2108;195346;95;0;0;0;0;.00nan;0;0
2108;-1;90;0;0;0;0;.00nan;0;0
2109;192733;99;53;44;7;37;.841;3600000;0
2109;194531;99;0;0;0;0;.00nan;0;0
2109;194632;102;78;21;1;20;.952;3600000;0
2109;189573;102;0;0;0;0;.00nan;0;0
2110;182266;105;0;0;0;0;.00nan;0;0
2110;189333;100;0;0;0;0;.00nan;0;0
2110;189639;105;75;39;2;37;.949;4208000;0
2110;184398;100;79;44;3;41;.932;4208000;0
2111;194502;86;44;27;4;23;.852;3591000;0
2111;189628;89;88;37;3;34;.919;3600000;0
2111;186155;89;0;0;0;0;.00nan;0;0
2111;-1;86;0;0;0;0;.00nan;0;0
2112;184158;90;71;23;1;22;.957;3600000;0
2112;189644;95;41;32;6;26;.813;3600000;0
2112;195346;95;0;0;0;0;.00nan;0;0
2112;-1;90;0;0;0;0;.00nan;0;0
2113;192733;99;35;11;3;8;.727;559000;0
2113;194531;99;92;26;0;26;1.000;2996000;0
2113;194632;102;78;30;2;28;.933;3600000;0
2113;189573;102;0;0;0;0;.00nan;0;0
2114;182266;105;0;0;0;0;.00nan;0;0
2114;189333;100;0;0;0;0;.00nan;0;0
2114;189639;105;69;25;3;22;.880;3600000;0
2114;184398;100;94;38;2;36;.947;3600000;0
2115;194502;86;33;14;4;10;.714;2070000;0
2115;189628;89;63;44;5;39;.886;3769000;0
2115;186155;89;0;0;0;0;.00nan;0;0
2115;-1;86;70;11;0;11;1.000;1699000;0
2116;184158;90;100;23;0;23;1.000;3600000;0
2116;189644;95;28;37;7;30;.811;3600000;0
2116;195346;95;0;0;0;0;.00nan;0;0
2116;-1;90;0;0;0;0;.00nan;0;0
2117;192733;99;72;26;2;24;.923;3600000;0
2117;194531;99;0;0;0;0;.00nan;0;0
2117;194632;102;68;31;3;28;.903;3600000;0
2117;189573;102;0;0;0;0;.00nan;0;0
2118;182266;105;0;0;0;0;.00nan;0;0
2118;189333;100;0;0;0;0;.00nan;0;0
2118;189639;105;83;49;4;45;.918;3600000;0
2118;184398;100;85;28;1;27;.964;3600000;0
2327;194502;86;67;18;1;17;.944;3600000;0
2327;189628;89;46;32;5;27;.844;3600000;0
2327;186155;89;0;0;0;0;.00nan;0;0
2327;-1;86;0;0;0;0;.00nan;0;0
2328;192733;99;44;35;5;30;.857;3234000;0
2328;194531;99;50;1;0;1;1.000;313000;0
2328;194632;102;58;25;3;22;.880;3600000;0
2328;189573;102;0;0;0;0;.00nan;0;0
2329;182266;105;0;0;0;0;.00nan;0;0
2329;189333;100;0;0;0;0;.00nan;0;0
2329;189639;105;58;25;3;22;.880;3600000;0
2329;184398;100;67;48;5;43;.896;3600000;0
1;194502;86;62;34;4;30;.882;3561000;0
1;189628;89;57;27;3;24;.889;3600000;0
1;186155;89;0;0;0;0;.00nan;0;0
1;-1;86;0;0;0;0;.00nan;0;0
2;182266;105;0;0;0;0;.00nan;0;0
2;189333;100;0;0;0;0;.00nan;0;0
2;189639;105;80;38;3;35;.921;3573000;0
2;184398;100;77;24;1;23;.958;3600000;0
63;194502;86;56;14;1;13;.929;3600000;0
63;189628;89;64;36;3;33;.917;3600000;0
63;186155;89;0;0;0;0;.00nan;0;0
63;-1;86;0;0;0;0;.00nan;0;0
82;194502;86;65;25;3;22;.880;3544000;0
82;184158;90;79;27;2;25;.926;3600000;0
82;-1;90;0;0;0;0;.00nan;0;0
82;-1;86;0;0;0;0;.00nan;0;0
83;194632;102;74;32;3;29;.906;3600000;0
83;189333;100;60;34;4;30;.882;3069000;0
83;189573;102;0;0;0;0;.00nan;0;0
83;184398;100;37;12;3;9;.750;531000;0
84;194502;86;67;28;2;26;.929;3679000;0
84;184158;90;78;38;3;35;.921;3679000;0
84;-1;90;0;0;0;0;.00nan;0;0
84;-1;86;0;0;0;0;.00nan;0;0
85;194632;102;72;22;1;21;.955;3600000;0
85;189333;100;0;0;0;0;.00nan;0;0
85;189573;102;0;0;0;0;.00nan;0;0
85;184398;100;67;44;5;39;.886;3600000;0
86;194502;86;84;34;2;32;.941;3530000;0
86;184158;90;100;32;0;32;1.000;3600000;0
86;-1;90;0;0;0;0;.00nan;0;0
86;-1;86;0;0;0;0;.00nan;0;0
87;194632;102;46;20;3;17;.850;3592000;0
87;189333;100;0;0;0;0;.00nan;0;0
87;189573;102;0;0;0;0;.00nan;0;0
87;184398;100;76;28;2;26;.929;3600000;0
88;194502;86;57;32;4;28;.875;3546000;0
88;184158;90;62;27;3;24;.889;3600000;0
88;-1;90;0;0;0;0;.00nan;0;0
88;-1;86;0;0;0;0;.00nan;0;0
89;194632;102;59;23;2;21;.913;3554000;0
89;189333;100;0;0;0;0;.00nan;0;0
89;189573;102;0;0;0;0;.00nan;0;0
89;184398;100;100;24;0;24;1.000;3600000;0
202;194502;86;98;26;0;26;1.000;3600000;0
202;184158;90;77;42;5;37;.881;3600000;0
202;-1;90;0;0;0;0;.00nan;0;0
202;-1;86;0;0;0;0;.00nan;0;0
203;194632;102;55;31;4;27;.871;3600000;0
203;189333;100;0;0;0;0;.00nan;0;0
203;189573;102;0;0;0;0;.00nan;0;0
203;184398;100;78;24;1;23;.958;3600000;0
218;194502;86;76;22;1;21;.955;3600000;0
218;184158;90;54;28;4;24;.857;3600000;0
218;-1;90;0;0;0;0;.00nan;0;0
218;-1;86;0;0;0;0;.00nan;0;0
219;194632;102;77;19;1;18;.947;3600000;0
219;189333;100;0;0;0;0;.00nan;0;0
219;189573;102;0;0;0;0;.00nan;0;0
219;184398;100;82;39;2;37;.949;3554000;0
305;194502;86;92;38;2;36;.947;3600000;0
305;184158;90;86;46;4;42;.913;3588000;0
305;-1;90;0;0;0;0;.00nan;0;0
305;-1;86;0;0;0;0;.00nan;0;0
306;194632;102;68;20;1;19;.950;3600000;0
306;189333;100;0;0;0;0;.00nan;0;0
306;189573;102;0;0;0;0;.00nan;0;0
306;184398;100;51;26;4;22;.846;3600000;0
331;194502;86;77;32;2;30;.938;3600000;0
331;194632;102;39;21;4;17;.810;3525000;0
331;189573;102;0;0;0;0;.00nan;0;0
331;-1;86;0;0;0;0;.00nan;0;0
332;194502;86;27;7;3;4;.571;425000;0
332;194632;102;60;35;4;31;.886;3600000;0
332;189573;102;0;0;0;0;.00nan;0;0
332;-1;86;44;18;3;15;.833;3136000;0
333;194502;86;0;0;0;0;.00nan;0;0
333;194632;102;78;21;1;20;.952;3600000;0
333;189573;102;0;0;0;0;.00nan;0;0
333;-1;86;57;29;4;25;.862;3600000;0
334;194502;86;0;0;0;0;.00nan;0;0
334;194632;102;65;22;2;20;.909;3600000;0
334;189573;102;0;0;0;0;.00nan;0;0
334;-1;86;50;30;4;26;.867;3551000;0
397;194502;86;0;0;0;0;.00nan;0;0
397;194632;102;95;34;2;32;.941;3600000;0
397;189573;102;0;0;0;0;.00nan;0;0
397;-1;86;35;28;5;23;.821;3600000;0
9534;177156;142;0;0;0;0;.00nan;0;0
9534;183859;142;56;46;6;40;.870;3600000;0
9534;196445;140;0;0;0;0;.00nan;0;0
9534;196812;140;92;21;0;21;1.000;3600000;0
9535;182339;139;0;0;0;0;.00nan;0;0
9535;178789;139;88;37;2;35;.946;3600000;0
9535;189944;144;31;10;3;7;.700;543000;0
9535;184738;144;67;31;3;28;.903;3057000;0
9536;-1;143;67;18;1;17;.944;3600000;0
9536;191218;143;0;0;0;0;.00nan;0;0
9536;191574;141;73;44;4;40;.909;3600000;0
9536;197756;141;0;0;0;0;.00nan;0;0
9537;183870;138;50;32;4;28;.875;3600000;0
9537;202059;133;0;0;0;0;.00nan;0;0
9537;192499;133;22;21;6;15;.714;3564000;0
9537;-1;138;0;0;0;0;.00nan;0;0
9538;182395;131;0;0;0;0;.00nan;0;0
9538;183905;129;0;0;0;0;.00nan;0;0
9538;189264;129;66;22;2;20;.909;3600000;0
9538;-1;131;73;32;3;29;.906;3557000;0
9539;184049;130;0;0;0;0;.00nan;0;0
9539;-1;132;50;33;5;28;.848;3587000;0
9539;196809;132;0;0;0;0;.00nan;0;0
9539;197759;130;72;36;3;33;.917;3600000;0
9540;187632;134;0;0;0;0;.00nan;0;0
9540;183730;134;68;39;4;35;.897;3600000;0
9540;183904;137;31;16;4;12;.750;1128000;0
9540;-1;137;70;24;1;23;.958;2472000;0
9541;187632;134;0;0;0;0;.00nan;0;0
9541;187657;136;0;0;0;0;.00nan;0;0
9541;183730;134;19;29;7;22;.759;3600000;0
9541;-1;136;57;25;3;22;.880;3600000;0
9542;194393;1340;60;13;1;12;.923;424000;0
9542;183934;128;0;0;0;0;.00nan;0;0
9542;-1;128;48;28;4;24;.857;3600000;0
9542;191571;1340;60;49;6;43;.878;3176000;0
9543;187578;135;93;45;2;43;.956;3600000;0
9543;183844;135;0;0;0;0;.00nan;0;0
9543;184049;130;74;21;1;20;.952;3600000;0
9543;197759;130;0;0;0;0;.00nan;0;0
9544;182339;139;0;0;0;0;.00nan;0;0
9544;178789;139;80;44;3;41;.932;3567000;0
9544;189944;144;60;26;3;23;.885;3600000;0
9544;184738;144;0;0;0;0;.00nan;0;0
9545;-1;143;52;3;0;3;1.000;757000;0
9545;191218;143;19;27;7;20;.741;2843000;0
9545;191574;141;48;28;4;24;.857;3600000;0
9545;197756;141;0;0;0;0;.00nan;0;0
9546;177156;142;0;0;0;0;.00nan;0;0
9546;183859;142;55;27;3;24;.889;3552000;0
9546;196445;140;0;0;0;0;.00nan;0;0
9546;196812;140;84;40;2;38;.950;3600000;0
9547;187657;136;31;23;5;18;.783;3560000;0
9547;202059;133;0;0;0;0;.00nan;0;0
9547;-1;136;0;0;0;0;.00nan;0;0
9547;192499;133;71;28;3;25;.893;3600000;0
9548;187578;135;0;0;0;0;.00nan;0;0
9548;183844;135;94;49;3;46;.939;3588000;0
9548;-1;132;79;27;1;26;.963;3600000;0
9548;196809;132;0;0;0;0;.00nan;0;0
9549;194393;1340;0;0;0;0;.00nan;0;0
9549;183934;128;0;0;0;0;.00nan;0;0
9549;-1;128;77;23;1;22;.957;3600000;0
9549;191571;1340;65;39;4;35;.897;3600000;0
9550;183904;137;73;35;4;31;.886;3600000;0
9550;183905;129;56;32;5;27;.844;3530000;0
9550;189264;129;0;0;0;0;.00nan;0;0
9550;-1;137;0;0;0;0;.00nan;0;0
9551;182395;131;0;0;0;0;.00nan;0;0
9551;183870;138;0;0;0;0;.00nan;0;0
9551;-1;131;99;46;1;45;.978;3600000;0
9551;-1;138;28;27;6;21;.778;3600000;0
9552;182339;139;0;0;0;0;.00nan;0;0
9552;177156;142;0;0;0;0;.00nan;0;0
9552;183859;142;61;30;3;27;.900;3600000;0
9552;178789;139;79;48;4;44;.917;3550000;0
9553;189944;144;100;46;2;44;.957;3600000;0
9553;184738;144;0;0;0;0;.00nan;0;0
9553;191574;141;41;20;4;16;.800;3531000;0
9553;197756;141;0;0;0;0;.00nan;0;0
9554;187632;134;0;0;0;0;.00nan;0;0
9554;183730;134;48;27;4;23;.852;3900000;0
9554;202059;133;0;0;0;0;.00nan;0;0
9554;192499;133;61;44;4;40;.909;3900000;0
9555;194393;1340;63;34;4;30;.882;3716000;0
9555;183905;129;43;24;5;19;.792;3716000;0
9555;189264;129;0;0;0;0;.00nan;0;0
9555;191571;1340;0;0;0;0;.00nan;0;0
9556;187578;135;53;8;1;7;.875;676000;0
9556;183844;135;48;39;6;33;.846;2924000;0
9556;183934;128;94;26;1;25;.962;3600000;0
9556;-1;128;0;0;0;0;.00nan;0;0
9557;183870;138;47;23;3;20;.870;3806000;0
9557;183904;137;64;41;4;37;.902;3778000;0
9557;-1;137;0;0;0;0;.00nan;0;0
9557;-1;138;0;0;0;0;.00nan;0;0
9558;182395;131;0;0;0;0;.00nan;0;0
9558;184049;130;55;26;3;23;.885;3600000;0
9558;-1;131;83;56;5;51;.911;3593000;0
9558;197759;130;0;0;0;0;.00nan;0;0
9559;187657;136;0;0;0;0;.00nan;0;0
9559;-1;132;0;0;0;0;.00nan;0;0
9559;196809;132;25;21;5;16;.762;3551000;0
9559;-1;136;76;42;4;38;.905;3600000;0
9560;187632;134;81;30;2;28;.933;3600000;0
9560;183730;134;0;0;0;0;.00nan;0;0
9560;202059;133;38;15;3;12;.800;1111000;0
9560;192499;133;32;29;6;23;.793;2489000;0
9561;183905;129;45;46;6;40;.870;3579000;0
9561;183934;128;0;0;0;0;.00nan;0;0
9561;189264;129;0;0;0;0;.00nan;0;0
9561;-1;128;51;23;4;19;.826;3600000;0
9562;189944;144;0;0;0;0;.00nan;0;0
9562;184738;144;77;51;4;47;.922;3600000;0
9562;-1;143;0;0;0;0;.00nan;0;0
9562;191218;143;44;20;5;15;.750;3548000;0
9563;196445;140;0;0;0;0;.00nan;0;0
9563;196812;140;58;22;2;20;.909;3600000;0
9563;191574;141;63;44;5;39;.886;3600000;0
9563;197756;141;0;0;0;0;.00nan;0;0
9564;182339;139;98;47;3;44;.936;3567000;0
9564;177156;142;80;33;2;31;.939;3600000;0
9564;183859;142;0;0;0;0;.00nan;0;0
9564;178789;139;0;0;0;0;.00nan;0;0
9565;187578;135;74;24;2;22;.917;3113000;0
9565;194393;1340;0;0;0;0;.00nan;0;0
9565;183844;135;29;8;3;5;.625;467000;0
9565;191571;1340;52;29;4;25;.862;3600000;0
9566;196445;140;91;31;1;30;.968;3600000;0
9566;-1;143;56;37;5;32;.865;3600000;0
9566;196812;140;0;0;0;0;.00nan;0;0
9566;191218;143;0;0;0;0;.00nan;0;0
9567;182395;131;0;0;0;0;.00nan;0;0
9567;184049;130;55;20;3;17;.850;3600000;0
9567;-1;131;76;56;6;50;.893;3600000;0
9567;197759;130;0;0;0;0;.00nan;0;0
9568;187657;136;100;36;0;36;1.000;3600000;0
9568;183904;137;60;39;5;34;.872;3600000;0
9568;-1;136;0;0;0;0;.00nan;0;0
9568;-1;137;0;0;0;0;.00nan;0;0
9569;183870;138;0;0;0;0;.00nan;0;0
9569;-1;132;58;19;2;17;.895;3600000;0
9569;196809;132;0;0;0;0;.00nan;0;0
9569;-1;138;56;31;4;27;.871;3600000;0
9570;196445;140;0;0;0;0;.00nan;0;0
9570;196812;140;77;29;2;27;.931;3600000;0
9570;191574;141;29;15;4;11;.733;968000;0
9570;197756;141;50;7;1;6;.857;2632000;0
9571;182339;139;100;45;2;43;.956;3600000;0
9571;178789;139;0;0;0;0;.00nan;0;0
9571;-1;143;0;0;0;0;.00nan;0;0
9571;191218;143;45;26;4;22;.846;3560000;0
9572;202059;133;67;37;4;33;.892;2192000;0
9572;-1;132;50;13;2;11;.846;3600000;0
9572;196809;132;0;0;0;0;.00nan;0;0
9572;192499;133;35;16;4;12;.750;1408000;0
9573;182395;131;0;0;0;0;.00nan;0;0
9573;194393;1340;0;0;0;0;.00nan;0;0
9573;-1;131;22;26;6;20;.769;3600000;0
9573;191571;1340;90;20;0;20;1.000;3600000;0
9574;187632;134;0;0;0;0;.00nan;0;0
9574;183730;134;49;21;3;18;.857;3600000;0
9574;183904;137;56;31;4;27;.871;3574000;0
9574;-1;137;0;0;0;0;.00nan;0;0
9575;183870;138;0;0;0;0;.00nan;0;0
9575;189944;144;53;29;5;24;.828;3600000;0
9575;184738;144;0;0;0;0;.00nan;0;0
9575;-1;138;91;35;2;33;.943;3600000;0
9576;194393;1340;0;0;0;0;.00nan;0;0
9576;183905;129;0;0;0;0;.00nan;0;0
9576;189264;129;67;23;1;22;.957;3600000;0
9576;191571;1340;62;30;4;26;.867;3600000;0
9577;177156;142;0;0;0;0;.00nan;0;0
9577;183859;142;48;27;4;23;.852;3600000;0
9577;196445;140;0;0;0;0;.00nan;0;0
9577;196812;140;75;28;1;27;.964;3600000;0
9578;182339;139;56;13;1;12;.923;1372000;0
9578;178789;139;37;23;4;19;.826;2198000;0
9578;-1;132;0;0;0;0;.00nan;0;0
9578;196809;132;54;28;3;25;.893;3600000;0
9579;183870;138;51;29;5;24;.828;3590000;0
9579;-1;143;72;24;3;21;.875;3600000;0
9579;191218;143;0;0;0;0;.00nan;0;0
9579;-1;138;0;0;0;0;.00nan;0;0
9580;187657;136;39;35;6;29;.829;3587000;0
9580;183934;128;0;0;0;0;.00nan;0;0
9580;-1;128;44;31;5;26;.839;3600000;0
9580;-1;136;0;0;0;0;.00nan;0;0
9581;187632;134;0;0;0;0;.00nan;0;0
9581;183730;134;47;21;3;18;.857;3590000;0
9581;191574;141;81;32;2;30;.938;3600000;0
9581;197756;141;0;0;0;0;.00nan;0;0
9582;184049;130;49;30;4;26;.867;3600000;0
9582;202059;133;57;7;0;7;1.000;744000;0
9582;192499;133;44;38;7;31;.816;2856000;0
9582;197759;130;0;0;0;0;.00nan;0;0
9583;187578;135;28;35;6;29;.829;3600000;0
9583;183844;135;0;0;0;0;.00nan;0;0
9583;183904;137;84;23;1;22;.957;3600000;0
9583;-1;137;0;0;0;0;.00nan;0;0
9584;182395;131;0;0;0;0;.00nan;0;0
9584;183905;129;100;35;0;35;1.000;3600000;0
9584;189264;129;0;0;0;0;.00nan;0;0
9584;-1;131;63;31;3;28;.903;3600000;0
9585;187657;136;0;0;0;0;.00nan;0;0
9585;183934;128;46;33;5;28;.848;3707000;0
9585;-1;128;0;0;0;0;.00nan;0;0
9585;-1;136;28;29;6;23;.793;3707000;0
9586;183904;137;0;0;0;0;.00nan;0;0
9586;-1;137;59;35;5;30;.857;3572000;0
9586;191574;141;74;27;3;24;.889;3600000;0
9586;197756;141;0;0;0;0;.00nan;0;0
9587;187578;135;0;0;0;0;.00nan;0;0
9587;194393;1340;0;0;0;0;.00nan;0;0
9587;183844;135;82;30;2;28;.933;3600000;0
9587;191571;1340;29;37;7;30;.811;3600000;0
9588;-1;132;22;25;6;19;.760;2085000;0
9588;-1;143;0;0;0;0;.00nan;0;0
9588;196809;132;51;9;1;8;.889;1515000;0
9588;191218;143;46;26;4;22;.846;3600000;0
9589;177156;142;52;35;5;30;.857;3600000;0
9589;183859;142;0;0;0;0;.00nan;0;0
9589;189944;144;46;29;5;24;.828;2338000;0
9589;184738;144;36;11;3;8;.727;1262000;0
9590;196445;140;0;0;0;0;.00nan;0;0
9590;202059;133;0;0;0;0;.00nan;0;0
9590;196812;140;86;23;0;23;1.000;3600000;0
9590;192499;133;65;48;6;42;.875;3600000;0
9591;182339;139;62;42;5;37;.881;3600000;0
9591;183870;138;0;0;0;0;.00nan;0;0
9591;178789;139;0;0;0;0;.00nan;0;0
9591;-1;138;53;28;4;24;.857;3600000;0
9592;182395;131;99;58;3;55;.948;3600000;0
9592;187632;134;0;0;0;0;.00nan;0;0
9592;183730;134;13;36;8;28;.778;3600000;0
9592;-1;131;0;0;0;0;.00nan;0;0
9593;183905;129;96;64;3;61;.953;3900000;0
9593;189264;129;0;0;0;0;.00nan;0;0
9593;184049;130;68;32;3;29;.906;3900000;0
9593;197759;130;0;0;0;0;.00nan;0;0
9594;189944;144;0;0;0;0;.00nan;0;0
9594;184738;144;85;39;2;37;.949;3600000;0
9594;-1;132;38;32;5;27;.844;3600000;0
9594;196809;132;0;0;0;0;.00nan;0;0
9595;202059;133;90;45;3;42;.933;3600000;0
9595;191574;141;47;30;5;25;.833;3581000;0
9595;192499;133;0;0;0;0;.00nan;0;0
9595;197756;141;0;0;0;0;.00nan;0;0
9596;182395;131;0;0;0;0;.00nan;0;0
9596;187632;134;82;14;0;14;1.000;3600000;0
9596;183730;134;0;0;0;0;.00nan;0;0
9596;-1;131;98;39;1;38;.974;3600000;0
9597;194393;1340;0;0;0;0;.00nan;0;0
9597;183934;128;0;0;0;0;.00nan;0;0
9597;-1;128;95;26;0;26;1.000;3600000;0
9597;191571;1340;58;34;4;30;.882;3600000;0
9598;187578;135;0;0;0;0;.00nan;0;0
9598;183844;135;83;44;4;40;.909;3900000;0
9598;184049;130;63;32;4;28;.875;3900000;0
9598;197759;130;0;0;0;0;.00nan;0;0
9599;183905;129;100;35;0;35;1.000;3600000;0
9599;189264;129;0;0;0;0;.00nan;0;0
9599;189944;144;45;30;5;25;.833;3600000;0
9599;184738;144;0;0;0;0;.00nan;0;0
9600;187632;134;80;26;1;25;.962;3600000;0
9600;183730;134;0;0;0;0;.00nan;0;0
9600;-1;143;42;30;5;25;.833;3600000;0
9600;191218;143;0;0;0;0;.00nan;0;0
9601;182339;139;38;21;4;17;.810;2445000;0
9601;182395;131;0;0;0;0;.00nan;0;0
9601;178789;139;32;14;4;10;.714;1155000;0
9601;-1;131;58;32;4;28;.875;3600000;0
9602;177156;142;0;0;0;0;.00nan;0;0
9602;183859;142;78;35;3;32;.914;3600000;0
9602;-1;132;0;0;0;0;.00nan;0;0
9602;196809;132;34;21;4;17;.810;3600000;0
9603;187657;136;0;0;0;0;.00nan;0;0
9603;184049;130;0;0;0;0;.00nan;0;0
9603;-1;136;100;40;1;39;.975;3600000;0
9603;197759;130;63;25;2;23;.920;3545000;0
9604;183905;129;60;23;3;20;.870;3635000;0
9604;189264;129;0;0;0;0;.00nan;0;0
9604;191574;141;0;0;0;0;.00nan;0;0
9604;197756;141;53;32;4;28;.875;3635000;0
9605;196445;140;0;0;0;0;.00nan;0;0
9605;202059;133;97;31;1;30;.968;3600000;0
9605;196812;140;45;28;4;24;.857;3600000;0
9605;192499;133;0;0;0;0;.00nan;0;0
9606;187578;135;35;33;6;27;.818;2771000;0
9606;187657;136;65;27;2;25;.926;3600000;0
9606;183844;135;47;7;1;6;.857;829000;0
9606;-1;136;0;0;0;0;.00nan;0;0
9607;182395;131;66;33;3;30;.909;3600000;0
9607;183870;138;0;0;0;0;.00nan;0;0
9607;-1;131;0;0;0;0;.00nan;0;0
9607;-1;138;94;24;0;24;1.000;3600000;0
9608;183904;137;100;42;1;41;.976;3600000;0
9608;-1;143;0;0;0;0;.00nan;0;0
9608;191218;143;53;18;2;16;.889;3550000;0
9608;-1;137;0;0;0;0;.00nan;0;0
9609;183905;129;73;33;2;31;.939;2574000;0
9609;189264;129;27;16;4;12;.750;1026000;0
9609;196445;140;60;19;2;17;.895;3600000;0
9609;196812;140;0;0;0;0;.00nan;0;0
9610;177156;142;74;41;3;38;.927;3115000;0
9610;183859;142;29;8;3;5;.625;443000;0
9610;183934;128;0;0;0;0;.00nan;0;0
9610;-1;128;46;27;4;23;.852;3600000;0
9611;187632;134;0;0;0;0;.00nan;0;0
9611;183730;134;51;34;5;29;.853;3556000;0
9611;184049;130;77;39;3;36;.923;3600000;0
9611;197759;130;0;0;0;0;.00nan;0;0
9612;189944;144;66;31;4;27;.871;3600000;0
9612;184738;144;0;0;0;0;.00nan;0;0
9612;191574;141;92;46;2;44;.957;3600000;0
9612;197756;141;0;0;0;0;.00nan;0;0
9613;182339;139;0;0;0;0;.00nan;0;0
9613;194393;1340;44;26;4;22;.846;3536000;0
9613;178789;139;63;28;2;26;.929;3600000;0
9613;191571;1340;0;0;0;0;.00nan;0;0
9614;187657;136;0;0;0;0;.00nan;0;0
9614;183904;137;21;25;6;19;.760;2681000;0
9614;-1;136;65;25;2;23;.920;3600000;0
9614;-1;137;49;8;1;7;.875;919000;0
9615;202059;133;0;0;0;0;.00nan;0;0
9615;-1;143;60;25;2;23;.920;3529000;0
9615;191218;143;0;0;0;0;.00nan;0;0
9615;192499;133;100;24;0;24;1.000;3600000;0
9616;182339;139;28;7;3;4;.571;516000;0
9616;183934;128;38;18;4;14;.778;3600000;0
9616;178789;139;70;48;4;44;.917;3084000;0
9616;-1;128;0;0;0;0;.00nan;0;0
9617;182395;131;0;0;0;0;.00nan;0;0
9617;-1;131;70;47;5;42;.894;3600000;0
9617;-1;132;96;23;0;23;1.000;3600000;0
9617;196809;132;0;0;0;0;.00nan;0;0
9618;187578;135;70;43;4;39;.907;3580000;0
9618;183844;135;0;0;0;0;.00nan;0;0
9618;184049;130;0;0;0;0;.00nan;0;0
9618;197759;130;68;32;3;29;.906;3600000;0
9619;189944;144;0;0;0;0;.00nan;0;0
9619;184738;144;59;26;3;23;.885;3600000;0
9619;196445;140;0;0;0;0;.00nan;0;0
9619;196812;140;73;37;4;33;.892;3570000;0
9620;177156;142;0;0;0;0;.00nan;0;0
9620;194393;1340;55;16;2;14;.875;2729000;0
9620;183859;142;69;24;2;22;.917;3600000;0
9620;191571;1340;27;15;4;11;.733;871000;0
9621;187632;134;30;17;5;12;.706;3564000;0
9621;183730;134;0;0;0;0;.00nan;0;0
9621;183870;138;0;0;0;0;.00nan;0;0
9621;-1;138;85;48;4;44;.917;3600000;0
9622;187657;136;61;26;3;23;.885;3600000;0
9622;-1;132;0;0;0;0;.00nan;0;0
9622;196809;132;51;31;5;26;.839;3542000;0
9622;-1;136;0;0;0;0;.00nan;0;0
9623;182395;131;0;0;0;0;.00nan;0;0
9623;187578;135;0;0;0;0;.00nan;0;0
9623;183844;135;90;34;2;32;.941;3600000;0
9623;-1;131;73;37;3;34;.919;3568000;0
9624;182339;139;80;28;1;27;.964;3600000;0
9624;178789;139;0;0;0;0;.00nan;0;0
9624;196445;140;0;0;0;0;.00nan;0;0
9624;196812;140;42;29;5;24;.828;3600000;0
9625;194393;1340;50;2;0;2;1.000;371000;0
9625;191571;1340;35;29;6;23;.793;3229000;0
9625;191574;141;92;34;1;33;.971;3600000;0
9625;197756;141;0;0;0;0;.00nan;0;0
9626;183870;138;56;6;0;6;1.000;321000;0
9626;183905;129;61;23;2;21;.913;3600000;0
9626;189264;129;0;0;0;0;.00nan;0;0
9626;-1;138;34;32;6;26;.813;3279000;0
9627;183904;137;44;31;6;25;.806;3600000;0
9627;202059;133;0;0;0;0;.00nan;0;0
9627;-1;137;0;0;0;0;.00nan;0;0
9627;192499;133;51;23;3;20;.870;3600000;0
9628;182339;139;0;0;0;0;.00nan;0;0
9628;183934;128;0;0;0;0;.00nan;0;0
9628;178789;139;100;48;2;46;.958;3900000;0
9628;-1;128;66;26;2;24;.923;3900000;0
9629;194393;1340;0;0;0;0;.00nan;0;0
9629;-1;143;82;13;0;13;1.000;3600000;0
9629;191218;143;0;0;0;0;.00nan;0;0
9629;191571;1340;66;39;4;35;.897;3600000;0
9630;187657;136;0;0;0;0;.00nan;0;0
9630;202059;133;84;46;3;43;.935;3589000;0
9630;-1;136;64;17;2;15;.882;3600000;0
9630;192499;133;0;0;0;0;.00nan;0;0
9631;187578;135;79;37;4;33;.892;3515000;0
9631;187632;134;0;0;0;0;.00nan;0;0
9631;183730;134;64;19;2;17;.895;3600000;0
9631;183844;135;0;0;0;0;.00nan;0;0
9632;182395;131;0;0;0;0;.00nan;0;0
9632;184049;130;85;16;0;16;1.000;3600000;0
9632;-1;131;97;71;4;67;.944;3600000;0
9632;197759;130;0;0;0;0;.00nan;0;0
9633;183905;129;0;0;0;0;.00nan;0;0
9633;189264;129;54;47;6;41;.872;3600000;0
9633;-1;132;30;7;3;4;.571;409000;0
9633;196809;132;61;24;2;22;.917;3191000;0
9634;196445;140;0;0;0;0;.00nan;0;0
9634;196812;140;42;29;4;25;.862;3567000;0
9634;191574;141;80;33;2;31;.939;3600000;0
9634;197756;141;0;0;0;0;.00nan;0;0
9635;187657;136;71;34;4;30;.882;3600000;0
9635;183870;138;45;5;1;4;.800;357000;0
9635;-1;136;0;0;0;0;.00nan;0;0
9635;-1;138;65;49;6;43;.878;3243000;0
9636;187578;135;0;0;0;0;.00nan;0;0
9636;183844;135;68;37;4;33;.892;3600000;0
9636;183904;137;73;19;1;18;.947;3600000;0
9636;-1;137;0;0;0;0;.00nan;0;0
9637;183934;128;52;45;6;39;.867;2788000;0
9637;-1;128;33;5;2;3;.600;812000;0
9637;-1;143;54;29;4;25;.862;3600000;0
9637;191218;143;0;0;0;0;.00nan;0;0
9638;177156;142;67;38;4;34;.895;3600000;0
9638;183859;142;0;0;0;0;.00nan;0;0
9638;189944;144;51;28;5;23;.821;2128000;0
9638;184738;144;47;8;1;7;.875;1393000;0
9639;182339;139;0;0;0;0;.00nan;0;0
9639;194393;1340;0;0;0;0;.00nan;0;0
9639;178789;139;79;35;2;33;.943;3600000;0
9639;191571;1340;29;31;6;25;.806;3600000;0
9640;177156;142;0;0;0;0;.00nan;0;0
9640;183859;142;94;45;2;43;.956;3857000;0
9640;196445;140;88;40;2;38;.950;3900000;0
9640;196812;140;0;0;0;0;.00nan;0;0
9641;182395;131;0;0;0;0;.00nan;0;0
9641;-1;131;91;52;3;49;.942;3600000;0
9641;-1;132;55;30;4;26;.867;3556000;0
9641;196809;132;0;0;0;0;.00nan;0;0
9642;183934;128;0;0;0;0;.00nan;0;0
9642;189944;144;48;0;0;0;.00nan;597000;0
9642;184738;144;73;45;5;40;.889;3003000;0
9642;-1;128;73;26;2;24;.923;3600000;0
9643;187632;134;0;0;0;0;.00nan;0;0
9643;183730;134;78;26;1;25;.962;3600000;0
9643;183904;137;54;27;4;23;.852;3600000;0
9643;-1;137;0;0;0;0;.00nan;0;0
9644;183905;129;45;39;6;33;.846;3345000;0
9644;189264;129;43;3;1;2;.667;255000;0
9644;184049;130;71;37;3;34;.919;3600000;0
9644;197759;130;0;0;0;0;.00nan;0;0
9645;183870;138;67;28;3;25;.893;3900000;0
9645;202059;133;0;0;0;0;.00nan;0;0
9645;192499;133;78;33;3;30;.909;3900000;0
9645;-1;138;0;0;0;0;.00nan;0;0
9646;189944;144;84;23;1;22;.957;3600000;0
9646;184738;144;0;0;0;0;.00nan;0;0
9646;-1;143;58;21;3;18;.857;3572000;0
9646;191218;143;0;0;0;0;.00nan;0;0
9647;187632;134;0;0;0;0;.00nan;0;0
9647;183730;134;28;15;4;11;.733;3600000;0
9647;183870;138;0;0;0;0;.00nan;0;0
9647;-1;138;98;35;1;34;.971;3600000;0
9648;183904;137;95;38;2;36;.947;3549000;0
9648;202059;133;100;24;0;24;1.000;3600000;0
9648;-1;137;0;0;0;0;.00nan;0;0
9648;192499;133;0;0;0;0;.00nan;0;0
9649;177156;142;89;33;1;32;.970;3600000;0
9649;183859;142;0;0;0;0;.00nan;0;0
9649;191574;141;78;30;2;28;.933;3600000;0
9649;197756;141;0;0;0;0;.00nan;0;0
9650;182339;139;0;0;0;0;.00nan;0;0
9650;183905;129;98;35;1;34;.971;3600000;0
9650;189264;129;0;0;0;0;.00nan;0;0
9650;178789;139;52;35;5;30;.857;3600000;0
9651;177156;142;0;0;0;0;.00nan;0;0
9651;183859;142;86;29;1;28;.966;3600000;0
9651;189944;144;61;28;3;25;.893;3600000;0
9651;184738;144;0;0;0;0;.00nan;0;0
9652;187657;136;88;39;3;36;.923;3900000;0
9652;196445;140;0;0;0;0;.00nan;0;0
9652;196812;140;64;29;3;26;.897;3900000;0
9652;-1;136;0;0;0;0;.00nan;0;0
9653;-1;143;71;25;2;23;.920;3600000;0
9653;191218;143;0;0;0;0;.00nan;0;0
9653;191574;141;52;9;1;8;.889;1501000;0
9653;197756;141;16;25;6;19;.760;2099000;0
9654;187632;134;0;0;0;0;.00nan;0;0
9654;183730;134;57;28;3;25;.893;3600000;0
9654;202059;133;58;32;4;28;.875;3574000;0
9654;192499;133;0;0;0;0;.00nan;0;0
9655;182395;131;74;30;2;28;.933;2523000;0
9655;194393;1340;66;28;3;25;.893;3600000;0
9655;-1;131;19;9;4;5;.556;1077000;0
9655;191571;1340;0;0;0;0;.00nan;0;0
9656;187578;135;0;0;0;0;.00nan;0;0
9656;183844;135;43;31;5;26;.839;3568000;0
9656;183870;138;0;0;0;0;.00nan;0;0
9656;-1;138;67;29;3;26;.897;3600000;0
9657;182339;139;90;59;4;55;.932;3600000;0
9657;184049;130;76;18;1;17;.944;3600000;0
9657;178789;139;0;0;0;0;.00nan;0;0
9657;197759;130;0;0;0;0;.00nan;0;0
9658;183904;137;69;39;4;35;.897;3559000;0
9658;-1;132;0;0;0;0;.00nan;0;0
9658;196809;132;75;32;3;29;.906;3600000;0
9658;-1;137;0;0;0;0;.00nan;0;0
9659;196445;140;95;44;3;41;.932;3600000;0
9659;-1;143;0;0;0;0;.00nan;0;0
9659;196812;140;0;0;0;0;.00nan;0;0
9659;191218;143;56;37;4;33;.892;3600000;0
9660;187632;134;40;17;4;13;.765;3600000;0
9660;183730;134;0;0;0;0;.00nan;0;0
9660;202059;133;0;0;0;0;.00nan;0;0
9660;192499;133;24;40;8;32;.800;3600000;0
9661;182395;131;55;6;0;6;1.000;347000;0
9661;183934;128;44;17;3;14;.824;3600000;0
9661;-1;131;43;39;7;32;.821;3253000;0
9661;-1;128;0;0;0;0;.00nan;0;0
9662;182339;139;0;0;0;0;.00nan;0;0
9662;178789;139;92;35;1;34;.971;3600000;0
9662;-1;132;55;18;2;16;.889;3563000;0
9662;196809;132;0;0;0;0;.00nan;0;0
9663;187578;135;68;18;1;17;.944;3600000;0
9663;183844;135;0;0;0;0;.00nan;0;0
9663;183870;138;36;34;6;28;.824;3109000;0
9663;-1;138;53;5;0;5;1.000;491000;0
9664;183904;137;59;43;6;37;.860;3311000;0
9664;184049;130;0;0;0;0;.00nan;0;0
9664;-1;137;41;4;1;3;.750;289000;0
9664;197759;130;67;21;2;19;.905;3600000;0
9665;187657;136;0;0;0;0;.00nan;0;0
9665;189944;144;0;0;0;0;.00nan;0;0
9665;184738;144;68;39;4;35;.897;3564000;0
9665;-1;136;57;24;3;21;.875;3600000;0
9666;194393;1340;0;0;0;0;.00nan;0;0
9666;183905;129;99;46;2;44;.957;3600000;0
9666;189264;129;0;0;0;0;.00nan;0;0
9666;191571;1340;24;29;6;23;.793;3600000;0
9667;177156;142;0;0;0;0;.00nan;0;0
9667;187657;136;65;34;3;31;.912;3547000;0
9667;183859;142;68;27;2;25;.926;3600000;0
9667;-1;136;0;0;0;0;.00nan;0;0
9668;183905;129;0;0;0;0;.00nan;0;0
9668;183934;128;0;0;0;0;.00nan;0;0
9668;189264;129;72;52;5;47;.904;3600000;0
9668;-1;128;64;18;1;17;.944;3600000;0
9669;196445;140;0;0;0;0;.00nan;0;0
9669;-1;143;71;17;1;16;.941;3600000;0
9669;196812;140;58;38;4;34;.895;3600000;0
9669;191218;143;0;0;0;0;.00nan;0;0
9670;182395;131;0;0;0;0;.00nan;0;0
9670;-1;131;52;45;6;39;.867;3600000;0
9670;191574;141;100;31;1;30;.968;3600000;0
9670;197756;141;0;0;0;0;.00nan;0;0
9671;183934;128;0;0;0;0;.00nan;0;0
9671;189944;144;0;0;0;0;.00nan;0;0
9671;184738;144;31;47;8;39;.830;3600000;0
9671;-1;128;60;28;3;25;.893;3600000;0
9672;187578;135;79;32;2;30;.938;3557000;0
9672;187632;134;0;0;0;0;.00nan;0;0
9672;183730;134;65;18;1;17;.944;3600000;0
9672;183844;135;0;0;0;0;.00nan;0;0
9673;183904;137;0;0;0;0;.00nan;0;0
9673;-1;132;62;33;3;30;.909;3643000;0
9673;196809;132;0;0;0;0;.00nan;0;0
9673;-1;137;87;54;4;50;.926;3643000;0
9674;182339;139;63;25;2;23;.920;1871000;0
9674;184049;130;70;24;2;22;.917;3600000;0
9674;178789;139;22;27;7;20;.741;1729000;0
9674;197759;130;0;0;0;0;.00nan;0;0
9675;194393;1340;36;29;5;24;.828;3600000;0
9675;189944;144;88;37;2;35;.946;3600000;0
9675;184738;144;0;0;0;0;.00nan;0;0
9675;191571;1340;0;0;0;0;.00nan;0;0
9676;202059;133;65;47;5;42;.894;3877000;0
9676;-1;143;37;24;5;19;.792;3900000;0
9676;191218;143;0;0;0;0;.00nan;0;0
9676;192499;133;0;0;0;0;.00nan;0;0
9677;177156;142;36;26;5;21;.808;3600000;0
9677;183859;142;0;0;0;0;.00nan;0;0
9677;196445;140;98;38;2;36;.947;3600000;0
9677;196812;140;0;0;0;0;.00nan;0;0
9678;187578;135;0;0;0;0;.00nan;0;0
9678;187657;136;65;22;2;20;.909;3600000;0
9678;183844;135;64;46;5;41;.891;3600000;0
9678;-1;136;0;0;0;0;.00nan;0;0
9679;194393;1340;54;4;0;4;1.000;654000;0
9679;191571;1340;22;29;7;22;.759;2916000;0
9679;191574;141;55;31;5;26;.839;3600000;0
9679;197756;141;0;0;0;0;.00nan;0;0
9680;183718;138;49;7;1;6;.857;544000;0
9680;183870;138;28;30;6;24;.800;3056000;0
9680;183905;129;77;21;1;20;.952;3600000;0
9680;189264;129;0;0;0;0;.00nan;0;0
9681;187632;134;79;33;2;31;.939;3600000;0
9681;183730;134;0;0;0;0;.00nan;0;0
9681;-1;132;0;0;0;0;.00nan;0;0
9681;196809;132;52;31;4;27;.871;3586000;0
9682;177156;142;0;0;0;0;.00nan;0;0
9682;183859;142;70;29;3;26;.897;3544000;0
9682;196445;140;0;0;0;0;.00nan;0;0
9682;196812;140;82;35;2;33;.943;3600000;0
9683;183718;138;24;6;3;3;.500;466000;0
9683;183870;138;89;40;3;37;.925;3134000;0
9683;183904;137;75;29;2;27;.931;3600000;0
9683;-1;137;0;0;0;0;.00nan;0;0
9684;182395;131;0;0;0;0;.00nan;0;0
9684;-1;131;73;38;4;34;.895;3600000;0
9684;189944;144;53;9;1;8;.889;747000;0
9684;184738;144;30;25;5;20;.800;2853000;0
9685;183934;128;0;0;0;0;.00nan;0;0
9685;-1;128;100;28;0;28;1.000;3600000;0
9685;191574;141;0;0;0;0;.00nan;0;0
9685;197756;141;55;34;4;30;.882;3600000;0
9686;187632;134;0;0;0;0;.00nan;0;0
9686;183730;134;52;19;3;16;.842;3600000;0
9686;-1;132;68;40;5;35;.875;3600000;0
9686;196809;132;0;0;0;0;.00nan;0;0
9687;187578;135;79;37;3;34;.919;3600000;0
9687;183844;135;0;0;0;0;.00nan;0;0
9687;183905;129;0;0;0;0;.00nan;0;0
9687;189264;129;100;35;0;35;1.000;3600000;0
9688;184049;130;71;25;2;23;.920;3600000;0
9688;-1;143;0;0;0;0;.00nan;0;0
9688;191218;143;85;47;3;44;.936;3600000;0
9688;197759;130;0;0;0;0;.00nan;0;0
9689;182339;139;0;0;0;0;.00nan;0;0
9689;178789;139;53;36;5;31;.861;3600000;0
9689;202059;133;0;0;0;0;.00nan;0;0
9689;192499;133;52;15;2;13;.867;3600000;0
9690;177156;142;59;22;2;20;.909;3600000;0
9690;183859;142;0;0;0;0;.00nan;0;0
9690;184049;130;0;0;0;0;.00nan;0;0
9690;197759;130;57;37;5;32;.865;3600000;0
9691;187657;136;0;0;0;0;.00nan;0;0
9691;183904;137;57;38;5;33;.868;3900000;0
9691;-1;136;61;35;5;30;.857;3900000;0
9691;-1;137;0;0;0;0;.00nan;0;0
9692;187657;136;0;0;0;0;.00nan;0;0
9692;194393;1340;55;38;5;33;.868;3306000;0
9692;-1;136;81;37;3;34;.919;3600000;0
9692;191571;1340;49;2;0;2;1.000;241000;0
9693;187632;134;0;0;0;0;.00nan;0;0
9693;183730;134;50;26;4;22;.846;3600000;0
9693;183904;137;33;31;7;24;.774;2027000;0
9693;-1;137;29;21;5;16;.762;1573000;0
9694;183905;129;0;0;0;0;.00nan;0;0
9694;189264;129;68;32;3;29;.906;3900000;0
9694;202059;133;73;34;3;31;.912;3900000;0
9694;192499;133;0;0;0;0;.00nan;0;0
9695;189944;144;35;27;5;22;.815;3578000;0
9695;184738;144;0;0;0;0;.00nan;0;0
9695;191574;141;65;32;3;29;.906;3600000;0
9695;197756;141;0;0;0;0;.00nan;0;0
9696;182339;139;58;36;4;32;.889;3900000;0
9696;187578;135;0;0;0;0;.00nan;0;0
9696;183844;135;57;30;4;26;.867;3900000;0
9696;178789;139;0;0;0;0;.00nan;0;0
9697;177156;142;0;0;0;0;.00nan;0;0
9697;183859;142;62;21;2;19;.905;3600000;0
9697;-1;143;68;10;0;10;1.000;1606000;0
9697;191218;143;19;25;6;19;.760;1994000;0
9698;194393;1340;0;0;0;0;.00nan;0;0
9698;202059;133;0;0;0;0;.00nan;0;0
9698;191571;1340;49;34;5;29;.853;3600000;0
9698;192499;133;61;20;2;18;.900;3600000;0
9699;182395;131;92;38;1;37;.974;2852000;0
9699;187657;136;65;18;1;17;.944;3600000;0
9699;-1;131;16;8;4;4;.500;748000;0
9699;-1;136;0;0;0;0;.00nan;0;0
9700;187632;134;0;0;0;0;.00nan;0;0
9700;183730;134;88;32;1;31;.969;3600000;0
9700;183905;129;98;53;3;50;.943;3521000;0
9700;189264;129;0;0;0;0;.00nan;0;0
9701;183718;138;0;0;0;0;.00nan;0;0
9701;183870;138;60;29;4;25;.862;3600000;0
9701;184049;130;94;30;1;29;.967;3600000;0
9701;197759;130;0;0;0;0;.00nan;0;0
9702;183904;137;99;41;2;39;.951;3600000;0
9702;183934;128;0;0;0;0;.00nan;0;0
9702;-1;128;38;26;4;22;.846;3579000;0
9702;-1;137;0;0;0;0;.00nan;0;0
9703;196445;140;0;0;0;0;.00nan;0;0
9703;-1;132;0;0;0;0;.00nan;0;0
9703;196809;132;43;38;6;32;.842;3563000;0
9703;196812;140;54;26;4;22;.846;3600000;0
9704;183904;137;0;0;0;0;.00nan;0;0
9704;183934;128;72;31;3;28;.903;3600000;0
9704;-1;128;0;0;0;0;.00nan;0;0
9704;-1;137;92;47;4;43;.915;3564000;0
9705;194393;1340;62;37;4;33;.892;3600000;0
9705;202059;133;0;0;0;0;.00nan;0;0
9705;191571;1340;0;0;0;0;.00nan;0;0
9705;192499;133;77;20;1;19;.950;3600000;0
9706;182395;131;0;0;0;0;.00nan;0;0
9706;187657;136;0;0;0;0;.00nan;0;0
9706;-1;131;85;33;1;32;.970;3600000;0
9706;-1;136;71;28;2;26;.929;3600000;0
9707;183718;138;40;12;3;9;.750;536000;0
9707;183870;138;97;47;2;45;.957;3064000;0
9707;196445;140;62;20;2;18;.900;3600000;0
9707;196812;140;0;0;0;0;.00nan;0;0
9708;183905;129;0;0;0;0;.00nan;0;0
9708;189264;129;41;26;4;22;.846;3577000;0
9708;-1;132;66;29;3;26;.897;3600000;0
9708;196809;132;0;0;0;0;.00nan;0;0
9709;187578;135;43;38;6;32;.842;3532000;0
9709;183844;135;0;0;0;0;.00nan;0;0
9709;-1;143;49;29;4;25;.862;3600000;0
9709;191218;143;0;0;0;0;.00nan;0;0
9710;182339;139;0;0;0;0;.00nan;0;0
9710;178789;139;75;30;2;28;.933;3600000;0
9710;-1;143;0;0;0;0;.00nan;0;0
9710;191218;143;53;23;3;20;.870;3556000;0
9711;177156;142;89;17;0;17;1.000;3600000;0
9711;183859;142;0;0;0;0;.00nan;0;0
9711;191574;141;92;34;2;32;.941;3600000;0
9711;197756;141;0;0;0;0;.00nan;0;0
9712;182395;131;78;32;2;30;.938;3528000;0
9712;-1;131;0;0;0;0;.00nan;0;0
9712;-1;132;0;0;0;0;.00nan;0;0
9712;196809;132;95;20;0;20;1.000;3600000;0
9713;184049;130;74;31;3;28;.903;3600000;0
9713;196445;140;0;0;0;0;.00nan;0;0
9713;196812;140;37;32;6;26;.813;3600000;0
9713;197759;130;0;0;0;0;.00nan;0;0
9714;187578;135;0;0;0;0;.00nan;0;0
9714;183844;135;57;46;6;40;.870;3600000;0
9714;189944;144;0;0;0;0;.00nan;0;0
9714;184738;144;51;24;3;21;.875;3600000;0
9715;187632;134;0;0;0;0;.00nan;0;0
9715;183730;134;68;29;2;27;.931;3600000;0
9715;183934;128;56;4;0;4;1.000;780000;0
9715;-1;128;28;29;6;23;.793;2820000;0
9716;182339;139;82;39;3;36;.923;3600000;0
9716;177156;142;0;0;0;0;.00nan;0;0
9716;183859;142;59;35;4;31;.886;3560000;0
9716;178789;139;0;0;0;0;.00nan;0;0
9717;182339;139;0;0;0;0;.00nan;0;0
9717;178789;139;72;44;4;40;.909;3600000;0
9717;191574;141;71;21;2;19;.905;3600000;0
9717;197756;141;0;0;0;0;.00nan;0;0
9718;189944;144;0;0;0;0;.00nan;0;0
9718;184738;144;61;29;3;26;.897;3600000;0
9718;196445;140;0;0;0;0;.00nan;0;0
9718;196812;140;42;33;5;28;.848;3600000;0
9719;177156;142;0;0;0;0;.00nan;0;0
9719;187632;134;54;28;3;25;.893;3585000;0
9719;183730;134;0;0;0;0;.00nan;0;0
9719;183859;142;93;35;1;34;.971;3600000;0
9720;184049;130;67;20;1;19;.950;3600000;0
9720;202059;133;64;36;4;32;.889;3600000;0
9720;192499;133;0;0;0;0;.00nan;0;0
9720;197759;130;0;0;0;0;.00nan;0;0
9721;182395;131;0;0;0;0;.00nan;0;0
9721;183904;137;83;29;1;28;.966;3600000;0
9721;-1;131;49;29;4;25;.862;3600000;0
9721;-1;137;0;0;0;0;.00nan;0;0
9722;-1;143;36;34;6;28;.824;3710000;0
9722;191218;143;0;0;0;0;.00nan;0;0
9722;191574;141;45;34;5;29;.853;3710000;0
9722;197756;141;0;0;0;0;.00nan;0;0
9723;187657;136;95;42;3;39;.929;3600000;0
9723;184049;130;39;10;2;8;.800;1005000;0
9723;-1;136;0;0;0;0;.00nan;0;0
9723;197759;130;17;20;6;14;.700;2595000;0
9724;194393;1340;0;0;0;0;.00nan;0;0
9724;183905;129;73;32;3;29;.906;3600000;0
9724;189264;129;0;0;0;0;.00nan;0;0
9724;191571;1340;35;34;6;28;.824;3600000;0
9725;183934;128;0;0;0;0;.00nan;0;0
9725;-1;128;61;32;3;29;.906;3600000;0
9725;-1;132;0;0;0;0;.00nan;0;0
9725;196809;132;55;35;4;31;.886;3577000;0
9726;187578;135;0;0;0;0;.00nan;0;0
9726;183844;135;40;31;5;26;.839;3900000;0
9726;183870;138;0;0;0;0;.00nan;0;0
9726;-1;138;58;40;5;35;.875;3900000;0
9727;177156;142;18;20;6;14;.700;2506000;0
9727;183859;142;55;12;1;11;.917;1394000;0
9727;183904;137;81;16;0;16;1.000;2233000;0
9727;-1;137;3;19;7;12;.632;1667000;0
9728;182395;131;0;0;0;0;.00nan;0;0
9728;187632;134;0;0;0;0;.00nan;0;0
9728;183730;134;64;16;1;15;.938;3600000;0
9728;-1;131;86;42;4;38;.905;3600000;0
9729;183905;129;0;0;0;0;.00nan;0;0
9729;183934;128;89;17;0;17;1.000;3600000;0
9729;189264;129;90;49;2;47;.959;3583000;0
9729;-1;128;0;0;0;0;.00nan;0;0
9730;187578;135;99;49;1;48;.980;3600000;0
9730;183844;135;0;0;0;0;.00nan;0;0
9730;183870;138;46;18;3;15;.833;3551000;0
9730;-1;138;0;0;0;0;.00nan;0;0
9731;187657;136;56;5;0;5;1.000;1379000;0
9731;184049;130;91;45;3;42;.933;3600000;0
9731;-1;136;19;26;6;20;.769;2221000;0
9731;197759;130;0;0;0;0;.00nan;0;0
9732;196445;140;0;0;0;0;.00nan;0;0
9732;-1;143;0;0;0;0;.00nan;0;0
9732;196812;140;39;33;5;28;.848;3600000;0
9732;191218;143;73;33;2;31;.939;3600000;0
9733;182339;139;14;18;6;12;.667;1888000;0
9733;178789;139;26;25;6;19;.760;1712000;0
9733;189944;144;100;46;2;44;.957;3600000;0
9733;184738;144;0;0;0;0;.00nan;0;0
9734;182339;139;0;0;0;0;.00nan;0;0
9734;178789;139;44;32;4;28;.875;3600000;0
9734;191574;141;54;23;3;20;.870;3600000;0
9734;197756;141;0;0;0;0;.00nan;0;0
9735;177156;142;0;0;0;0;.00nan;0;0
9735;183859;142;62;39;5;34;.872;3600000;0
9735;202059;133;0;0;0;0;.00nan;0;0
9735;192499;133;48;25;4;21;.840;3600000;0
9736;182395;131;19;23;6;17;.739;2642000;0
9736;187632;134;86;31;1;30;.968;3600000;0
9736;183730;134;0;0;0;0;.00nan;0;0
9736;-1;131;46;6;1;5;.833;958000;0
9737;194393;1340;0;0;0;0;.00nan;0;0
9737;-1;132;94;21;0;21;1.000;3600000;0
9737;196809;132;0;0;0;0;.00nan;0;0
9737;191571;1340;75;28;1;27;.964;3585000;0
9738;187657;136;0;0;0;0;.00nan;0;0
9738;183905;129;73;48;5;43;.896;3600000;0
9738;189264;129;0;0;0;0;.00nan;0;0
9738;-1;136;100;28;0;28;1.000;3600000;0
9739;187632;134;0;0;0;0;.00nan;0;0
9739;183730;134;72;22;1;21;.955;3600000;0
9739;191574;141;72;39;4;35;.897;3600000;0
9739;197756;141;0;0;0;0;.00nan;0;0
9740;183934;128;52;33;4;29;.879;3544000;0
9740;202059;133;93;39;3;36;.923;3600000;0
9740;-1;128;0;0;0;0;.00nan;0;0
9740;192499;133;0;0;0;0;.00nan;0;0
9741;189944;144;85;39;3;36;.923;3600000;0
9741;184738;144;0;0;0;0;.00nan;0;0
9741;191574;141;0;0;0;0;.00nan;0;0
9741;197756;141;98;24;0;24;1.000;3600000;0
9742;187632;134;44;35;5;30;.857;3600000;0
9742;183730;134;0;0;0;0;.00nan;0;0
9742;-1;143;55;31;4;27;.871;3600000;0
9742;191218;143;0;0;0;0;.00nan;0;0
9743;187657;136;0;0;0;0;.00nan;0;0
9743;183904;137;89;37;2;35;.946;3600000;0
9743;-1;136;64;36;4;32;.889;3515000;0
9743;-1;137;0;0;0;0;.00nan;0;0
9744;182395;131;0;0;0;0;.00nan;0;0
9744;184049;130;83;26;1;25;.962;3600000;0
9744;-1;131;58;31;3;28;.903;3572000;0
9744;197759;130;0;0;0;0;.00nan;0;0
9745;183905;129;0;0;0;0;.00nan;0;0
9745;189264;129;44;32;5;27;.844;3579000;0
9745;-1;132;55;30;4;26;.867;3600000;0
9745;196809;132;0;0;0;0;.00nan;0;0
9746;194393;1340;69;22;1;21;.955;2576000;0
9746;189944;144;0;0;0;0;.00nan;0;0
9746;184738;144;72;27;2;25;.926;3600000;0
9746;191571;1340;31;19;4;15;.789;1024000;0
9747;183934;128;0;0;0;0;.00nan;0;0
9747;196445;140;0;0;0;0;.00nan;0;0
9747;-1;128;58;19;2;17;.895;3600000;0
9747;196812;140;81;62;5;57;.919;3600000;0
9748;182339;139;44;37;6;31;.838;3550000;0
9748;178789;139;0;0;0;0;.00nan;0;0
9748;-1;143;0;0;0;0;.00nan;0;0
9748;191218;143;59;36;4;32;.889;3600000;0
9749;182395;131;64;38;5;33;.868;3516000;0
9749;183870;138;0;0;0;0;.00nan;0;0
9749;-1;131;0;0;0;0;.00nan;0;0
9749;-1;138;66;29;3;26;.897;3600000;0
9750;187578;135;0;0;0;0;.00nan;0;0
9750;183844;135;100;43;0;43;1.000;3600000;0
9750;202059;133;0;0;0;0;.00nan;0;0
9750;192499;133;69;24;2;22;.917;3523000;0
9751;183904;137;88;38;3;35;.921;3600000;0
9751;-1;132;0;0;0;0;.00nan;0;0
9751;196809;132;40;30;5;25;.833;3514000;0
9751;-1;137;0;0;0;0;.00nan;0;0
9752;183870;138;9;17;6;11;.647;1138000;0
9752;184049;130;71;27;2;25;.926;3600000;0
9752;197759;130;0;0;0;0;.00nan;0;0
9752;-1;138;40;20;4;16;.800;2462000;0
9753;182339;139;0;0;0;0;.00nan;0;0
9753;187632;134;0;0;0;0;.00nan;0;0
9753;183730;134;72;27;2;25;.926;3600000;0
9753;178789;139;60;40;4;36;.900;3581000;0
9754;183934;128;69;33;3;30;.909;3600000;0
9754;-1;128;0;0;0;0;.00nan;0;0
9754;191574;141;34;9;3;6;.667;404000;0
9754;197756;141;87;37;2;35;.946;3142000;0
9755;177156;142;0;0;0;0;.00nan;0;0
9755;194393;1340;0;0;0;0;.00nan;0;0
9755;183859;142;65;17;1;16;.941;3600000;0
9755;191571;1340;50;36;5;31;.861;3600000;0
9756;194393;1340;52;29;5;24;.828;3568000;0
9756;196445;140;73;33;3;30;.909;3600000;0
9756;196812;140;0;0;0;0;.00nan;0;0
9756;191571;1340;0;0;0;0;.00nan;0;0
9757;177156;142;69;29;2;27;.931;3600000;0
9757;183859;142;0;0;0;0;.00nan;0;0
9757;183934;128;0;0;0;0;.00nan;0;0
9757;-1;128;82;46;3;43;.935;3600000;0
9758;184049;130;72;29;3;26;.897;3900000;0
9758;-1;132;88;48;3;45;.938;3900000;0
9758;196809;132;0;0;0;0;.00nan;0;0
9758;197759;130;0;0;0;0;.00nan;0;0
9759;189944;144;78;24;1;23;.958;3600000;0
9759;184738;144;0;0;0;0;.00nan;0;0
9759;-1;143;0;0;0;0;.00nan;0;0
9759;191218;143;41;31;5;26;.839;3600000;0
9760;183904;137;100;32;0;32;1.000;3600000;0
9760;202059;133;43;34;6;28;.824;2425000;0
9760;-1;137;0;0;0;0;.00nan;0;0
9760;192499;133;56;4;0;4;1.000;1175000;0
9761;187578;135;0;0;0;0;.00nan;0;0
9761;183844;135;52;39;6;33;.846;3600000;0
9761;183905;129;61;22;2;20;.909;3600000;0
9761;189264;129;0;0;0;0;.00nan;0;0
9762;187657;136;43;29;5;24;.828;3600000;0
9762;183870;138;35;40;7;33;.825;2833000;0
9762;-1;136;0;0;0;0;.00nan;0;0
9762;-1;138;49;8;2;6;.750;767000;0
9763;182339;139;67;30;3;27;.900;3542000;0
9763;178789;139;0;0;0;0;.00nan;0;0
9763;196445;140;0;0;0;0;.00nan;0;0
9763;196812;140;89;31;1;30;.968;3600000;0
9764;183904;137;73;26;2;24;.923;3600000;0
9764;202059;133;0;0;0;0;.00nan;0;0
9764;-1;137;0;0;0;0;.00nan;0;0
9764;192499;133;26;31;7;24;.774;3600000;0
9765;-1;132;83;42;3;39;.929;3600000;0
9765;-1;143;60;31;4;27;.871;3544000;0
9765;196809;132;0;0;0;0;.00nan;0;0
9765;191218;143;0;0;0;0;.00nan;0;0
9766;177156;142;0;0;0;0;.00nan;0;0
9766;183859;142;66;38;4;34;.895;3592000;0
9766;189944;144;88;34;2;32;.941;3600000;0
9766;184738;144;0;0;0;0;.00nan;0;0
9767;187578;135;0;0;0;0;.00nan;0;0
9767;183844;135;66;36;5;31;.861;3600000;0
9767;183870;138;0;0;0;0;.00nan;0;0
9767;-1;138;25;27;6;21;.778;3549000;0
9768;182395;131;0;0;0;0;.00nan;0;0
9768;183905;129;68;21;2;19;.905;3600000;0
9768;189264;129;0;0;0;0;.00nan;0;0
9768;-1;131;52;40;6;34;.850;3600000;0
9769;184049;130;100;27;0;27;1.000;3600000;0
9769;191574;141;98;42;1;41;.976;3600000;0
9769;197756;141;0;0;0;0;.00nan;0;0
9769;197759;130;0;0;0;0;.00nan;0;0
9770;183904;137;71;36;3;33;.917;3900000;0
9770;196445;140;74;31;3;28;.903;3900000;0
9770;196812;140;0;0;0;0;.00nan;0;0
9770;-1;137;0;0;0;0;.00nan;0;0
9771;187632;134;0;0;0;0;.00nan;0;0
9771;183730;134;70;27;2;25;.926;3600000;0
9771;-1;132;75;35;3;32;.914;3555000;0
9771;196809;132;0;0;0;0;.00nan;0;0
9772;182395;131;83;41;3;38;.927;3600000;0
9772;-1;131;0;0;0;0;.00nan;0;0
9772;202059;133;94;20;0;20;1.000;3600000;0
9772;192499;133;0;0;0;0;.00nan;0;0
9773;183934;128;0;0;0;0;.00nan;0;0
9773;-1;128;93;32;1;31;.969;3900000;0
9773;-1;143;88;36;1;35;.972;3900000;0
9773;191218;143;0;0;0;0;.00nan;0;0
9774;187578;135;60;36;4;32;.889;3550000;0
9774;183844;135;0;0;0;0;.00nan;0;0
9774;191574;141;0;0;0;0;.00nan;0;0
9774;197756;141;68;23;2;21;.913;3600000;0
9775;183905;129;0;0;0;0;.00nan;0;0
9775;189264;129;40;49;8;41;.837;3600000;0
9775;184049;130;24;17;5;12;.706;1889000;0
9775;197759;130;43;7;2;5;.714;1711000;0
9776;187657;136;87;33;2;31;.939;3600000;0
9776;-1;136;0;0;0;0;.00nan;0;0
9776;191574;141;61;30;3;27;.900;3556000;0
9776;197756;141;0;0;0;0;.00nan;0;0
9777;187632;134;69;24;2;22;.917;3600000;0
9777;183730;134;0;0;0;0;.00nan;0;0
9777;-1;132;0;0;0;0;.00nan;0;0
9777;196809;132;52;22;3;19;.864;3544000;0
9778;182395;131;80;22;1;21;.955;2425000;0
9778;-1;131;37;18;4;14;.778;1175000;0
9778;202059;133;0;0;0;0;.00nan;0;0
9778;192499;133;59;18;2;16;.889;3600000;0
9779;183870;138;0;0;0;0;.00nan;0;0
9779;183934;128;0;0;0;0;.00nan;0;0
9779;-1;128;86;30;2;28;.933;3600000;0
9779;-1;138;62;33;3;30;.909;3600000;0
9780;187578;135;77;19;0;19;1.000;1888000;0
9780;183844;135;13;27;7;20;.741;1712000;0
9780;184049;130;66;28;3;25;.893;3600000;0
9780;197759;130;0;0;0;0;.00nan;0;0
9781;183904;137;19;36;8;28;.778;3600000;0
9781;189944;144;74;28;2;26;.929;3600000;0
9781;184738;144;0;0;0;0;.00nan;0;0
9781;-1;137;0;0;0;0;.00nan;0;0
9782;182339;139;0;0;0;0;.00nan;0;0
9782;177156;142;0;0;0;0;.00nan;0;0
9782;183859;142;74;37;4;33;.892;3828000;0
9782;178789;139;79;39;3;36;.923;3828000;0
9783;194393;1340;0;0;0;0;.00nan;0;0
9783;-1;143;0;0;0;0;.00nan;0;0
9783;191218;143;84;34;1;33;.971;3600000;0
9783;191571;1340;53;33;4;29;.879;3600000;0
9784;182339;139;77;43;3;40;.930;3559000;0
9784;178789;139;0;0;0;0;.00nan;0;0
9784;196445;140;0;0;0;0;.00nan;0;0
9784;196812;140;61;21;1;20;.952;3600000;0
9785;177156;142;51;34;4;30;.882;3600000;0
9785;183859;142;0;0;0;0;.00nan;0;0
9785;183904;137;69;29;3;26;.897;3197000;0
9785;-1;137;31;9;3;6;.667;332000;0
9786;194393;1340;63;26;3;23;.885;3600000;0
9786;183870;138;47;35;5;30;.857;3540000;0
9786;191571;1340;0;0;0;0;.00nan;0;0
9786;-1;138;0;0;0;0;.00nan;0;0
9787;187657;136;0;0;0;0;.00nan;0;0
9787;183905;129;96;36;2;34;.944;3600000;0
9787;189264;129;0;0;0;0;.00nan;0;0
9787;-1;136;56;41;6;35;.854;3600000;0
9788;182339;139;0;0;0;0;.00nan;0;0
9788;178789;139;50;27;3;24;.889;3900000;0
9788;191574;141;58;21;3;18;.857;3900000;0
9788;197756;141;0;0;0;0;.00nan;0;0
9789;177156;142;0;0;0;0;.00nan;0;0
9789;183859;142;34;24;5;19;.792;3900000;0
9789;183905;129;85;48;5;43;.896;3900000;0
9789;189264;129;0;0;0;0;.00nan;0;0
9790;187657;136;71;32;3;29;.906;3600000;0
9790;196445;140;0;0;0;0;.00nan;0;0
9790;196812;140;40;39;6;33;.846;3600000;0
9790;-1;136;0;0;0;0;.00nan;0;0
9791;183870;138;0;0;0;0;.00nan;0;0
9791;183934;128;0;0;0;0;.00nan;0;0
9791;-1;128;86;26;1;25;.962;3600000;0
9791;-1;138;97;54;3;51;.944;3588000;0
9792;183905;129;0;0;0;0;.00nan;0;0
9792;189264;129;73;35;3;32;.914;3552000;0
9792;-1;143;66;19;2;17;.895;3600000;0
9792;191218;143;0;0;0;0;.00nan;0;0
9793;182395;131;0;0;0;0;.00nan;0;0
9793;-1;131;49;45;7;38;.844;3600000;0
9793;191574;141;68;18;1;17;.944;3600000;0
9793;197756;141;0;0;0;0;.00nan;0;0
9794;187578;135;0;0;0;0;.00nan;0;0
9794;183844;135;43;30;5;25;.833;3600000;0
9794;202059;133;76;21;2;19;.905;3600000;0
9794;192499;133;0;0;0;0;.00nan;0;0
9795;184049;130;83;25;1;24;.960;3600000;0
9795;189944;144;66;46;6;40;.870;3600000;0
9795;184738;144;0;0;0;0;.00nan;0;0
9795;197759;130;0;0;0;0;.00nan;0;0
9796;182395;131;0;0;0;0;.00nan;0;0
9796;-1;131;48;45;7;38;.844;3600000;0
9796;-1;143;0;0;0;0;.00nan;0;0
9796;191218;143;54;22;3;19;.864;3600000;0
9797;177156;142;0;0;0;0;.00nan;0;0
9797;183859;142;36;32;6;26;.813;3600000;0
9797;191574;141;0;0;0;0;.00nan;0;0
9797;197756;141;99;46;1;45;.978;3600000;0
9798;187657;136;0;0;0;0;.00nan;0;0
9798;189944;144;57;11;1;10;.909;713000;0
9798;184738;144;26;38;7;31;.816;2887000;0
9798;-1;136;65;18;2;16;.889;3600000;0
9799;187632;134;0;0;0;0;.00nan;0;0
9799;183730;134;62;27;2;25;.926;3600000;0
9799;196445;140;0;0;0;0;.00nan;0;0
9799;196812;140;75;35;3;32;.914;3600000;0
9800;183934;128;0;0;0;0;.00nan;0;0
9800;184049;130;88;37;2;35;.946;3600000;0
9800;-1;128;22;18;5;13;.722;3600000;0
9800;197759;130;0;0;0;0;.00nan;0;0
9801;194393;1340;0;0;0;0;.00nan;0;0
9801;-1;132;77;27;2;25;.926;3600000;0
9801;196809;132;0;0;0;0;.00nan;0;0
9801;191571;1340;88;51;3;48;.941;3566000;0
9802;183904;137;82;32;1;31;.969;3900000;0
9802;196445;140;89;29;1;28;.966;3900000;0
9802;196812;140;0;0;0;0;.00nan;0;0
9802;-1;137;0;0;0;0;.00nan;0;0
9803;187657;136;69;31;3;28;.903;3600000;0
9803;202059;133;0;0;0;0;.00nan;0;0
9803;-1;136;0;0;0;0;.00nan;0;0
9803;192499;133;44;27;4;23;.852;3555000;0
9804;183934;128;0;0;0;0;.00nan;0;0
9804;-1;128;79;25;1;24;.960;3600000;0
9804;-1;132;0;0;0;0;.00nan;0;0
9804;196809;132;66;34;2;32;.941;3600000;0
9805;187578;135;50;37;5;32;.865;3574000;0
9805;183844;135;0;0;0;0;.00nan;0;0
9805;189944;144;54;31;4;27;.871;3600000;0
9805;184738;144;0;0;0;0;.00nan;0;0
9806;194393;1340;81;41;3;38;.927;3600000;0
9806;183870;138;0;0;0;0;.00nan;0;0
9806;191571;1340;0;0;0;0;.00nan;0;0
9806;-1;138;51;28;4;24;.857;3583000;0
9807;182339;139;97;47;2;45;.957;3574000;0
9807;183905;129;100;30;0;30;1.000;3600000;0
9807;189264;129;0;0;0;0;.00nan;0;0
9807;178789;139;0;0;0;0;.00nan;0;0
9808;177156;142;74;30;3;27;.900;3600000;0
9808;183859;142;0;0;0;0;.00nan;0;0
9808;-1;143;40;30;5;25;.833;3559000;0
9808;191218;143;0;0;0;0;.00nan;0;0
9809;182339;139;0;0;0;0;.00nan;0;0
9809;182395;131;0;0;0;0;.00nan;0;0
9809;178789;139;73;19;1;18;.947;3600000;0
9809;-1;131;75;41;3;38;.927;3555000;0
9810;183870;138;69;40;3;37;.925;3600000;0
9810;184049;130;86;17;0;17;1.000;3600000;0
9810;197759;130;0;0;0;0;.00nan;0;0
9810;-1;138;0;0;0;0;.00nan;0;0
9811;187632;134;0;0;0;0;.00nan;0;0
9811;183730;134;54;17;2;15;.882;3600000;0
9811;183904;137;0;0;0;0;.00nan;0;0
9811;-1;137;45;43;7;36;.837;3600000;0
9812;187578;135;0;0;0;0;.00nan;0;0
9812;194393;1340;0;0;0;0;.00nan;0;0
9812;183844;135;92;31;2;29;.935;3600000;0
9812;191571;1340;43;27;4;23;.852;3513000;0
9813;196445;140;0;0;0;0;.00nan;0;0
9813;-1;143;84;36;2;34;.944;3600000;0
9813;196812;140;58;31;3;28;.903;3593000;0
9813;191218;143;0;0;0;0;.00nan;0;0
9814;194393;1340;0;0;0;0;.00nan;0;0
9814;183934;128;0;0;0;0;.00nan;0;0
9814;-1;128;29;26;6;20;.769;3549000;0
9814;191571;1340;62;45;5;40;.889;3600000;0
9815;187578;135;63;25;3;22;.880;3585000;0
9815;183844;135;0;0;0;0;.00nan;0;0
9815;202059;133;0;0;0;0;.00nan;0;0
9815;192499;133;74;30;2;28;.933;3600000;0
9816;187657;136;0;0;0;0;.00nan;0;0
9816;183904;137;87;45;3;42;.933;3600000;0
9816;-1;136;88;41;4;37;.902;3583000;0
9816;-1;137;0;0;0;0;.00nan;0;0
9817;189944;144;66;33;4;29;.879;3600000;0
9817;184738;144;0;0;0;0;.00nan;0;0
9817;196445;140;54;4;0;4;1.000;281000;0
9817;196812;140;44;32;5;27;.844;3273000;0
9818;177156;142;0;0;0;0;.00nan;0;0
9818;183859;142;49;25;4;21;.840;3554000;0
9818;-1;143;0;0;0;0;.00nan;0;0
9818;191218;143;51;27;3;24;.889;3600000;0
9819;182339;139;30;33;6;27;.818;2429000;0
9819;178789;139;57;12;1;11;.917;1128000;0
9819;191574;141;26;25;6;19;.760;3600000;0
9819;197756;141;0;0;0;0;.00nan;0;0
9820;187632;134;0;0;0;0;.00nan;0;0
9820;187657;136;0;0;0;0;.00nan;0;0
9820;183730;134;95;41;2;39;.951;3900000;0
9820;-1;136;99;43;2;41;.953;3860000;0
9821;194393;1340;78;38;3;35;.921;3589000;0
9821;184049;130;95;36;2;34;.944;3600000;0
9821;191571;1340;0;0;0;0;.00nan;0;0
9821;197759;130;0;0;0;0;.00nan;0;0
9822;182395;131;0;0;0;0;.00nan;0;0
9822;183904;137;65;20;2;18;.900;3900000;0
9822;-1;131;86;37;2;35;.946;3900000;0
9822;-1;137;0;0;0;0;.00nan;0;0
9823;183934;128;0;0;0;0;.00nan;0;0
9823;-1;128;48;34;5;29;.853;3600000;0
9823;-1;132;26;13;4;9;.692;1094000;0
9823;196809;132;57;34;4;30;.882;2506000;0
9824;183905;129;80;31;1;30;.968;3600000;0
9824;189264;129;0;0;0;0;.00nan;0;0
9824;202059;133;72;38;3;35;.921;3563000;0
9824;192499;133;0;0;0;0;.00nan;0;0
9825;187578;135;0;0;0;0;.00nan;0;0
9825;183844;135;62;32;3;29;.906;3586000;0
9825;183870;138;0;0;0;0;.00nan;0;0
9825;-1;138;83;33;2;31;.939;3600000;0
9826;187632;134;62;31;4;27;.871;3600000;0
9826;187657;136;16;22;6;16;.727;2366000;0
9826;183730;134;0;0;0;0;.00nan;0;0
9826;-1;136;35;18;4;14;.778;1234000;0
9827;182395;131;62;34;3;31;.912;3600000;0
9827;187578;135;78;29;2;27;.931;3600000;0
9827;183844;135;0;0;0;0;.00nan;0;0
9827;-1;131;0;0;0;0;.00nan;0;0
9828;183934;128;64;38;5;33;.868;3900000;0
9828;184049;130;39;26;5;21;.808;3900000;0
9828;-1;128;0;0;0;0;.00nan;0;0
9828;197759;130;0;0;0;0;.00nan;0;0
9829;183904;137;32;35;6;29;.829;3600000;0
9829;183905;129;0;0;0;0;.00nan;0;0
9829;189264;129;59;28;3;25;.893;3600000;0
9829;-1;137;0;0;0;0;.00nan;0;0
9830;183870;138;77;30;1;29;.967;3600000;0
9830;202059;133;0;0;0;0;.00nan;0;0
9830;192499;133;55;33;4;29;.879;3600000;0
9830;-1;138;0;0;0;0;.00nan;0;0
9831;182339;139;0;0;0;0;.00nan;0;0
9831;178789;139;47;32;5;27;.844;3615000;0
9831;189944;144;0;0;0;0;.00nan;0;0
9831;184738;144;49;38;6;32;.842;3615000;0
9832;196445;140;72;34;2;32;.941;3600000;0
9832;196812;140;0;0;0;0;.00nan;0;0
9832;191574;141;39;10;2;8;.800;487000;0
9832;197756;141;29;30;6;24;.800;3113000;0
9833;177156;142;100;31;0;31;1.000;3600000;0
9833;183859;142;0;0;0;0;.00nan;0;0
9833;-1;143;50;24;4;20;.833;3600000;0
9833;191218;143;0;0;0;0;.00nan;0;0
9834;194393;1340;0;0;0;0;.00nan;0;0
9834;-1;132;88;38;1;37;.974;3600000;0
9834;196809;132;0;0;0;0;.00nan;0;0
9834;191571;1340;64;22;2;20;.909;3600000;0
9835;183885;144;0;0;0;0;.00nan;0;0
9835;184738;144;78;31;3;28;.903;3600000;0
9835;196445;140;0;0;0;0;.00nan;0;0
9835;196812;140;64;38;4;34;.895;3579000;0
9836;182339;139;92;34;2;32;.941;3803000;0
9836;177156;142;58;15;1;14;.933;3803000;0
9836;183859;142;0;0;0;0;.00nan;0;0
9836;178789;139;0;0;0;0;.00nan;0;0
9837;-1;143;0;0;0;0;.00nan;0;0
9837;191218;143;57;32;4;28;.875;3600000;0
9837;191574;141;21;37;8;29;.784;3600000;0
9837;197756;141;0;0;0;0;.00nan;0;0
9838;187657;136;0;0;0;0;.00nan;0;0
9838;200436;130;0;0;0;0;.00nan;0;0
9838;-1;136;54;16;1;15;.938;3600000;0
9838;197759;130;74;56;5;51;.911;3600000;0
9839;183870;138;0;0;0;0;.00nan;0;0
9839;202059;133;52;21;3;18;.857;3600000;0
9839;192499;133;0;0;0;0;.00nan;0;0
9839;-1;138;47;41;6;35;.854;3574000;0
9840;182395;131;0;0;0;0;.00nan;0;0
9840;194393;1340;0;0;0;0;.00nan;0;0
9840;-1;131;76;36;3;33;.917;3600000;0
9840;191571;1340;51;24;4;20;.833;3547000;0
9841;187578;135;0;0;0;0;.00nan;0;0
9841;187632;134;0;0;0;0;.00nan;0;0
9841;183730;134;47;19;3;16;.842;3600000;0
9841;183844;135;87;52;4;48;.923;3546000;0
9842;183904;137;76;26;1;25;.962;3600000;0
9842;183905;129;26;24;6;18;.750;2959000;0
9842;189264;129;60;7;0;7;1.000;641000;0
9842;-1;137;0;0;0;0;.00nan;0;0
9843;196445;140;32;31;6;25;.806;3565000;0
9843;196812;140;0;0;0;0;.00nan;0;0
9843;191574;141;0;0;0;0;.00nan;0;0
9843;197756;141;65;36;5;31;.861;3600000;0
9844;182395;131;0;0;0;0;.00nan;0;0
9844;187578;135;45;31;4;27;.871;3572000;0
9844;183844;135;0;0;0;0;.00nan;0;0
9844;-1;131;73;30;2;28;.933;3600000;0
9845;182339;139;0;0;0;0;.00nan;0;0
9845;178789;139;48;39;6;33;.846;3600000;0
9845;-1;143;74;26;2;24;.923;3600000;0
9845;191218;143;0;0;0;0;.00nan;0;0
9846;187632;134;0;0;0;0;.00nan;0;0
9846;183730;134;57;20;2;18;.900;3600000;0
9846;183904;137;83;51;5;46;.902;3600000;0
9846;-1;137;0;0;0;0;.00nan;0;0
9847;187657;136;58;26;3;23;.885;3600000;0
9847;202059;133;0;0;0;0;.00nan;0;0
9847;-1;136;0;0;0;0;.00nan;0;0
9847;192499;133;58;40;5;35;.875;3556000;0
9848;194393;1340;0;0;0;0;.00nan;0;0
9848;183934;128;0;0;0;0;.00nan;0;0
9848;-1;128;72;29;2;27;.931;3600000;0
9848;191571;1340;91;44;3;41;.932;3566000;0
9849;183905;129;92;63;4;59;.937;3600000;0
9849;189264;129;0;0;0;0;.00nan;0;0
9849;-1;132;53;28;5;23;.821;3555000;0
9849;196809;132;0;0;0;0;.00nan;0;0
9850;183870;138;0;0;0;0;.00nan;0;0
9850;200436;130;82;35;2;33;.943;3550000;0
9850;197759;130;0;0;0;0;.00nan;0;0
9850;-1;138;91;35;1;34;.971;3600000;0
9851;177156;142;0;0;0;0;.00nan;0;0
9851;183859;142;35;24;5;19;.792;3591000;0
9851;183885;144;0;0;0;0;.00nan;0;0
9851;184738;144;55;36;4;32;.889;3600000;0
9852;182339;139;49;53;8;45;.849;3600000;0
9852;178789;139;0;0;0;0;.00nan;0;0
9852;-1;143;0;0;0;0;.00nan;0;0
9852;191218;143;60;27;3;24;.889;3600000;0
9853;177156;142;41;18;4;14;.778;3600000;0
9853;183859;142;0;0;0;0;.00nan;0;0
9853;196445;140;59;7;0;7;1.000;536000;0
9853;196812;140;51;47;7;40;.851;3064000;0
9854;187657;136;0;0;0;0;.00nan;0;0
9854;202059;133;37;36;6;30;.833;3600000;0
9854;-1;136;71;32;3;29;.906;3600000;0
9854;192499;133;0;0;0;0;.00nan;0;0
9855;187632;134;0;0;0;0;.00nan;0;0
9855;183730;134;43;26;4;22;.846;3600000;0
9855;183904;137;51;36;5;31;.861;3548000;0
9855;-1;137;0;0;0;0;.00nan;0;0
9856;194393;1340;62;35;4;31;.886;3556000;0
9856;183934;128;0;0;0;0;.00nan;0;0
9856;-1;128;69;28;3;25;.893;3600000;0
9856;191571;1340;0;0;0;0;.00nan;0;0
9857;187578;135;0;0;0;0;.00nan;0;0
9857;183844;135;75;37;3;34;.919;3600000;0
9857;183905;129;0;0;0;0;.00nan;0;0
9857;189264;129;95;24;0;24;1.000;3600000;0
9858;182395;131;0;0;0;0;.00nan;0;0
9858;183870;138;65;27;2;25;.926;3600000;0
9858;-1;131;67;39;4;35;.897;3600000;0
9858;-1;138;0;0;0;0;.00nan;0;0
9859;200436;130;0;0;0;0;.00nan;0;0
9859;-1;132;0;0;0;0;.00nan;0;0
9859;196809;132;65;40;4;36;.900;3593000;0
9859;197759;130;37;31;5;26;.839;3600000;0
9860;183885;144;64;30;3;27;.900;3600000;0
9860;184738;144;0;0;0;0;.00nan;0;0
9860;191574;141;74;30;2;28;.933;3600000;0
9860;197756;141;0;0;0;0;.00nan;0;0
9861;196445;140;67;43;5;38;.884;3600000;0
9861;-1;143;72;28;2;26;.929;3600000;0
9861;196812;140;0;0;0;0;.00nan;0;0
9861;191218;143;0;0;0;0;.00nan;0;0
9862;182395;131;0;0;0;0;.00nan;0;0
9862;183870;138;0;0;0;0;.00nan;0;0
9862;-1;131;64;32;3;29;.906;3900000;0
9862;-1;138;67;27;3;24;.889;3900000;0
9863;183934;128;0;0;0;0;.00nan;0;0
9863;-1;128;93;31;1;30;.968;3600000;0
9863;-1;132;0;0;0;0;.00nan;0;0
9863;196809;132;85;40;3;37;.925;3557000;0
9864;187657;136;59;3;0;3;1.000;878000;0
9864;183905;129;0;0;0;0;.00nan;0;0
9864;189264;129;41;38;6;32;.842;3900000;0
9864;-1;136;28;22;6;16;.727;3022000;0
9865;183904;137;84;36;2;34;.944;3600000;0
9865;202059;133;0;0;0;0;.00nan;0;0
9865;-1;137;0;0;0;0;.00nan;0;0
9865;192499;133;55;26;3;23;.885;3577000;0
9866;177156;142;32;20;4;16;.800;3580000;0
9866;183859;142;0;0;0;0;.00nan;0;0
9866;191574;141;93;36;2;34;.944;3600000;0
9866;197756;141;0;0;0;0;.00nan;0;0
9867;187632;134;50;2;0;2;1.000;947000;0
9867;183730;134;12;16;6;10;.625;2653000;0
9867;200436;130;0;0;0;0;.00nan;0;0
9867;197759;130;93;43;3;40;.930;3600000;0
9868;182339;139;0;0;0;0;.00nan;0;0
9868;187578;135;74;19;0;19;1.000;1831000;0
9868;183844;135;16;27;7;20;.741;1769000;0
9868;178789;139;74;31;2;29;.935;3600000;0
9869;177156;142;0;0;0;0;.00nan;0;0
9869;183859;142;81;40;3;37;.925;3900000;0
9869;191574;141;0;0;0;0;.00nan;0;0
9869;197756;141;65;33;3;30;.909;3900000;0
9870;182339;139;56;31;4;27;.871;3600000;0
9870;187657;136;0;0;0;0;.00nan;0;0
9870;178789;139;0;0;0;0;.00nan;0;0
9870;-1;136;83;26;1;25;.962;3600000;0
9871;194393;1340;0;0;0;0;.00nan;0;0
9871;-1;132;37;30;5;25;.833;3600000;0
9871;196809;132;0;0;0;0;.00nan;0;0
9871;191571;1340;69;21;1;20;.952;3600000;0
9872;182395;131;0;0;0;0;.00nan;0;0
9872;183934;128;52;19;3;16;.842;3600000;0
9872;-1;131;55;39;5;34;.872;3565000;0
9872;-1;128;0;0;0;0;.00nan;0;0
9873;187578;135;61;19;2;17;.895;3600000;0
9873;183844;135;0;0;0;0;.00nan;0;0
9873;196445;140;0;0;0;0;.00nan;0;0
9873;196812;140;74;41;3;38;.927;3596000;0
9874;183870;138;81;32;1;31;.969;3562000;0
9874;183905;129;100;31;0;31;1.000;3600000;0
9874;189264;129;0;0;0;0;.00nan;0;0
9874;-1;138;0;0;0;0;.00nan;0;0
9875;183904;137;84;29;2;27;.931;3600000;0
9875;200436;130;31;35;6;29;.829;3600000;0
9875;-1;137;0;0;0;0;.00nan;0;0
9875;197759;130;0;0;0;0;.00nan;0;0
9876;187632;134;0;0;0;0;.00nan;0;0
9876;183730;134;72;28;3;25;.893;3751000;0
9876;202059;133;83;33;2;31;.939;3751000;0
9876;192499;133;0;0;0;0;.00nan;0;0
9877;183934;128;0;0;0;0;.00nan;0;0
9877;-1;128;62;27;3;24;.889;3900000;0
9877;-1;132;0;0;0;0;.00nan;0;0
9877;196809;132;62;32;3;29;.906;3900000;0
9878;182339;139;0;0;0;0;.00nan;0;0
9878;183870;138;0;0;0;0;.00nan;0;0
9878;178789;139;50;36;5;31;.861;3600000;0
9878;-1;138;71;26;2;24;.923;3600000;0
9879;183905;129;59;32;3;29;.906;3600000;0
9879;189264;129;0;0;0;0;.00nan;0;0
9879;196445;140;26;42;8;34;.810;3118000;0
9879;196812;140;55;6;0;6;1.000;482000;0
9880;183885;144;44;3;1;2;.667;273000;0
9880;184738;144;68;47;6;41;.872;3327000;0
9880;-1;143;80;30;2;28;.933;3600000;0
9880;191218;143;0;0;0;0;.00nan;0;0
9881;182395;131;32;30;6;24;.800;3600000;0
9881;194393;1340;0;0;0;0;.00nan;0;0
9881;-1;131;0;0;0;0;.00nan;0;0
9881;191571;1340;92;20;0;20;1.000;3600000;0
9882;-1;143;59;11;1;10;.909;1051000;0
9882;191218;143;52;36;6;30;.833;2549000;0
9882;191574;141;61;30;4;26;.867;3600000;0
9882;197756;141;0;0;0;0;.00nan;0;0
9883;177156;142;0;0;0;0;.00nan;0;0
9883;183859;142;95;35;2;33;.943;3600000;0
9883;183885;144;85;40;3;37;.925;3561000;0
9883;184738;144;0;0;0;0;.00nan;0;0
9884;187578;135;97;42;2;40;.952;3900000;0
9884;187657;136;0;0;0;0;.00nan;0;0
9884;183844;135;0;0;0;0;.00nan;0;0
9884;-1;136;74;26;2;24;.923;3900000;0
9885;187632;134;40;31;5;26;.839;3600000;0
9885;183730;134;0;0;0;0;.00nan;0;0
9885;202059;133;0;0;0;0;.00nan;0;0
9885;192499;133;47;48;7;41;.854;3600000;0
9886;183904;137;81;27;1;26;.963;3600000;0
9886;200436;130;0;0;0;0;.00nan;0;0
9886;-1;137;0;0;0;0;.00nan;0;0
9886;197759;130;63;24;2;22;.917;3546000;0
9887;194393;1340;0;0;0;0;.00nan;0;0
9887;183934;128;0;0;0;0;.00nan;0;0
9887;-1;128;50;30;5;25;.833;3600000;0
9887;191571;1340;94;23;0;23;1.000;3600000;0
9888;189944;144;0;0;0;0;.00nan;0;0
9888;184738;144;59;31;3;28;.903;3600000;0
9888;196445;140;0;0;0;0;.00nan;0;0
9888;196812;140;46;22;4;18;.818;3580000;0
9889;182395;131;0;0;0;0;.00nan;0;0
9889;-1;131;60;38;4;34;.895;3600000;0
9889;-1;132;34;26;5;21;.808;3549000;0
9889;196809;132;0;0;0;0;.00nan;0;0
9890;182339;139;0;0;0;0;.00nan;0;0
9890;187657;136;0;0;0;0;.00nan;0;0
9890;178789;139;60;36;4;32;.889;3559000;0
9890;-1;136;84;32;2;30;.938;3600000;0
9891;183870;138;51;7;1;6;.857;545000;0
9891;191574;141;29;20;5;15;.750;3600000;0
9891;197756;141;0;0;0;0;.00nan;0;0
9891;-1;138;74;41;6;35;.854;2991000;0
9892;177156;142;0;0;0;0;.00nan;0;0
9892;183859;142;75;35;3;32;.914;3600000;0
9892;202059;133;36;35;6;29;.829;3600000;0
9892;192499;133;0;0;0;0;.00nan;0;0
9893;183870;138;51;42;6;36;.857;3550000;0
9893;196445;140;52;27;4;23;.852;3600000;0
9893;196812;140;0;0;0;0;.00nan;0;0
9893;-1;138;0;0;0;0;.00nan;0;0
9894;202059;133;0;0;0;0;.00nan;0;0
9894;191574;141;0;0;0;0;.00nan;0;0
9894;192499;133;57;36;4;32;.889;3600000;0
9894;197756;141;98;32;1;31;.969;3600000;0
9895;182395;131;72;20;1;19;.950;1385000;0
9895;183934;128;0;0;0;0;.00nan;0;0
9895;-1;131;58;44;6;38;.864;2215000;0
9895;-1;128;58;12;1;11;.917;3600000;0
9896;183905;129;0;0;0;0;.00nan;0;0
9896;189264;129;91;40;1;39;.975;3600000;0
9896;-1;132;53;4;0;4;1.000;303000;0
9896;196809;132;26;36;7;29;.806;3297000;0
9897;187578;135;44;6;1;5;.833;261000;0
9897;183844;135;64;47;6;41;.872;3339000;0
9897;184049;130;64;24;2;22;.917;3600000;0
9897;197759;130;0;0;0;0;.00nan;0;0
9898;194393;1340;0;0;0;0;.00nan;0;0
9898;183904;137;91;34;1;33;.971;3600000;0
9898;-1;137;0;0;0;0;.00nan;0;0
9898;191571;1340;63;33;3;30;.909;3536000;0
9899;183904;137;0;0;0;0;.00nan;0;0
9899;-1;132;76;30;2;28;.933;3600000;0
9899;196809;132;0;0;0;0;.00nan;0;0
9899;-1;137;76;46;4;42;.913;3600000;0
9900;187632;134;0;0;0;0;.00nan;0;0
9900;183730;134;60;32;4;28;.875;3900000;0
9900;194393;1340;0;0;0;0;.00nan;0;0
9900;191571;1340;55;30;4;26;.867;3900000;0
9901;183905;129;37;32;6;26;.813;2637000;0
9901;183934;128;66;23;2;21;.913;3600000;0
9901;189264;129;45;18;3;15;.833;963000;0
9901;-1;128;0;0;0;0;.00nan;0;0
9902;189944;144;0;0;0;0;.00nan;0;0
9902;184738;144;78;32;2;30;.938;3600000;0
9902;202059;133;72;36;3;33;.917;3569000;0
9902;192499;133;0;0;0;0;.00nan;0;0
9903;187657;136;0;0;0;0;.00nan;0;0
9903;-1;143;67;25;2;23;.920;3900000;0
9903;191218;143;0;0;0;0;.00nan;0;0
9903;-1;136;95;38;2;36;.947;3900000;0
9904;177156;142;49;27;4;23;.852;3900000;0
9904;183859;142;0;0;0;0;.00nan;0;0
9904;183870;138;0;0;0;0;.00nan;0;0
9904;-1;138;93;51;4;47;.922;3900000;0
9905;182339;139;0;0;0;0;.00nan;0;0
9905;178789;139;63;35;4;31;.886;3600000;0
9905;196445;140;0;0;0;0;.00nan;0;0
9905;196812;140;90;23;0;23;1.000;3600000;0
9906;187657;136;73;27;2;25;.926;3600000;0
9906;-1;136;0;0;0;0;.00nan;0;0
9906;191574;141;73;38;4;34;.895;3600000;0
9906;197756;141;0;0;0;0;.00nan;0;0
9907;183905;129;50;8;1;7;.875;1075000;0
9907;189264;129;60;43;6;37;.860;2525000;0
9907;184049;130;74;28;2;26;.929;3600000;0
9907;197759;130;0;0;0;0;.00nan;0;0
9908;189944;144;52;37;5;32;.865;3600000;0
9908;184738;144;0;0;0;0;.00nan;0;0
9908;-1;143;0;0;0;0;.00nan;0;0
9908;191218;143;74;36;3;33;.917;3600000;0
9909;187632;134;39;22;4;18;.818;3600000;0
9909;183730;134;0;0;0;0;.00nan;0;0
9909;194393;1340;53;4;0;4;1.000;426000;0
9909;191571;1340;37;33;6;27;.818;3146000;0
9910;182395;131;0;0;0;0;.00nan;0;0
9910;187578;135;88;39;2;37;.949;3637000;0
9910;183844;135;0;0;0;0;.00nan;0;0
9910;-1;131;67;33;3;30;.909;3637000;0
9911;177156;142;0;0;0;0;.00nan;0;0
9911;183859;142;100;46;2;44;.957;3600000;0
9911;191574;141;64;36;4;32;.889;3579000;0
9911;197756;141;0;0;0;0;.00nan;0;0
9912;189944;144;0;0;0;0;.00nan;0;0
9912;184738;144;62;46;6;40;.870;3600000;0
9912;-1;132;0;0;0;0;.00nan;0;0
9912;196809;132;52;17;2;15;.882;3600000;0
9913;182339;139;0;0;0;0;.00nan;0;0
9913;183904;137;78;35;3;32;.914;3823000;0
9913;178789;139;83;45;4;41;.911;3823000;0
9913;-1;137;0;0;0;0;.00nan;0;0
9914;196445;140;43;3;1;2;.667;349000;0
9914;-1;143;66;22;2;20;.909;3600000;0
9914;196812;140;47;44;6;38;.864;3251000;0
9914;191218;143;0;0;0;0;.00nan;0;0
9915;177156;142;86;14;0;14;1.000;3600000;0
9915;187578;135;67;42;4;38;.905;3600000;0
9915;183844;135;0;0;0;0;.00nan;0;0
9915;183859;142;0;0;0;0;.00nan;0;0
9916;187632;134;0;0;0;0;.00nan;0;0
9916;183730;134;76;24;1;23;.958;3600000;0
9916;194393;1340;66;33;4;29;.879;3600000;0
9916;191571;1340;0;0;0;0;.00nan;0;0
9917;183870;138;0;0;0;0;.00nan;0;0
9917;189944;144;65;29;3;26;.897;3791000;0
9917;184738;144;0;0;0;0;.00nan;0;0
9917;-1;138;72;36;4;32;.889;3791000;0
9918;182395;131;0;0;0;0;.00nan;0;0
9918;184049;130;49;22;3;19;.864;3600000;0
9918;-1;131;67;40;4;36;.900;3595000;0
9918;197759;130;0;0;0;0;.00nan;0;0
9919;187578;135;0;0;0;0;.00nan;0;0
9919;183844;135;89;36;2;34;.944;3600000;0
9919;191574;141;73;31;3;28;.903;3600000;0
9919;197756;141;0;0;0;0;.00nan;0;0
9920;183905;129;63;39;4;35;.897;3600000;0
9920;189264;129;0;0;0;0;.00nan;0;0
9920;202059;133;0;0;0;0;.00nan;0;0
9920;192499;133;27;23;5;18;.783;3600000;0
9921;187632;134;33;30;6;24;.800;2050000;0
9921;183730;134;42;10;2;8;.800;1550000;0
9921;183934;128;0;0;0;0;.00nan;0;0
9921;-1;128;45;17;3;14;.824;3600000;0
9922;187657;136;0;0;0;0;.00nan;0;0
9922;-1;132;0;0;0;0;.00nan;0;0
9922;196809;132;48;33;5;28;.848;3881000;0
9922;-1;136;27;25;6;19;.760;3881000;0
9923;189944;144;61;11;1;10;.909;1141000;0
9923;184738;144;35;31;6;25;.806;2459000;0
9923;202059;133;67;29;2;27;.931;3600000;0
9923;192499;133;0;0;0;0;.00nan;0;0
9924;182395;131;64;38;4;34;.895;3575000;0
9924;194393;1340;0;0;0;0;.00nan;0;0
9924;-1;131;0;0;0;0;.00nan;0;0
9924;191571;1340;54;20;2;18;.900;3600000;0
9925;187632;134;37;36;6;30;.833;3182000;0
9925;183730;134;57;7;0;7;1.000;418000;0
9925;183934;128;65;32;3;29;.906;3600000;0
9925;-1;128;0;0;0;0;.00nan;0;0
9926;183870;138;40;41;7;34;.829;3600000;0
9926;184049;130;100;32;0;32;1.000;3600000;0
9926;197759;130;0;0;0;0;.00nan;0;0
9926;-1;138;0;0;0;0;.00nan;0;0
9927;187578;135;29;27;6;21;.778;2233000;0
9927;183844;135;52;15;2;13;.867;1367000;0
9927;196445;140;0;0;0;0;.00nan;0;0
9927;196812;140;43;29;5;24;.828;3600000;0
9928;182339;139;66;41;5;36;.878;3600000;0
9928;177156;142;69;26;2;24;.923;3600000;0
9928;183859;142;0;0;0;0;.00nan;0;0
9928;178789;139;0;0;0;0;.00nan;0;0
9929;183904;137;52;31;4;27;.871;3600000;0
9929;-1;143;92;29;1;28;.966;3600000;0
9929;191218;143;0;0;0;0;.00nan;0;0
9929;-1;137;0;0;0;0;.00nan;0;0
9930;182339;139;0;0;0;0;.00nan;0;0
9930;178789;139;62;30;3;27;.900;3600000;0
9930;-1;143;0;0;0;0;.00nan;0;0
9930;191218;143;72;32;2;30;.938;3600000;0
9931;183904;137;0;0;0;0;.00nan;0;0
9931;-1;137;72;42;4;38;.905;3600000;0
9931;191574;141;53;24;3;21;.875;3600000;0
9931;197756;141;0;0;0;0;.00nan;0;0
9932;187657;136;83;28;2;26;.929;3600000;0
9932;183905;129;65;40;4;36;.900;3521000;0
9932;189264;129;0;0;0;0;.00nan;0;0
9932;-1;136;0;0;0;0;.00nan;0;0
9933;182395;131;0;0;0;0;.00nan;0;0
9933;-1;131;69;42;4;38;.905;3600000;0
9933;-1;132;60;15;1;14;.933;3600000;0
9933;196809;132;0;0;0;0;.00nan;0;0
9934;194393;1340;0;0;0;0;.00nan;0;0
9934;184049;130;76;22;1;21;.955;3600000;0
9934;191571;1340;73;39;3;36;.923;3521000;0
9934;197759;130;0;0;0;0;.00nan;0;0
9935;184049;130;47;32;5;27;.844;3620000;0
9935;196445;140;0;0;0;0;.00nan;0;0
9935;196812;140;33;32;6;26;.813;3624000;0
9935;197759;130;0;0;0;0;.00nan;0;0
9936;182339;139;0;0;0;0;.00nan;0;0
9936;178789;139;39;29;5;24;.828;3538000;0
9936;189944;144;68;32;3;29;.906;3600000;0
9936;184738;144;0;0;0;0;.00nan;0;0
9937;-1;143;74;19;1;18;.947;3900000;0
9937;191218;143;0;0;0;0;.00nan;0;0
9937;191574;141;84;35;1;34;.971;3900000;0
9937;197756;141;0;0;0;0;.00nan;0;0
9938;187632;134;0;0;0;0;.00nan;0;0
9938;183730;134;87;34;2;32;.941;3600000;0
9938;183904;137;47;27;4;23;.852;3552000;0
9938;-1;137;0;0;0;0;.00nan;0;0
9939;182395;131;59;19;1;18;.947;1461000;0
9939;183905;129;73;26;2;24;.923;3600000;0
9939;189264;129;0;0;0;0;.00nan;0;0
9939;-1;131;32;22;5;17;.773;2139000;0
9940;183934;128;0;0;0;0;.00nan;0;0
9940;202059;133;0;0;0;0;.00nan;0;0
9940;-1;128;67;34;4;30;.882;3600000;0
9940;192499;133;77;35;3;32;.914;3600000;0
9941;177156;142;0;0;0;0;.00nan;0;0
9941;187578;135;58;38;5;33;.868;3600000;0
9941;183844;135;0;0;0;0;.00nan;0;0
9941;183859;142;54;12;2;10;.833;3600000;0
9942;183870;138;67;37;4;33;.892;3544000;0
9942;-1;132;0;0;0;0;.00nan;0;0
9942;196809;132;60;23;2;21;.913;3600000;0
9942;-1;138;0;0;0;0;.00nan;0;0
9943;187632;134;20;34;7;27;.794;3600000;0
9943;187657;136;52;29;4;25;.862;3600000;0
9943;183730;134;0;0;0;0;.00nan;0;0
9943;-1;136;0;0;0;0;.00nan;0;0
9944;187578;135;0;0;0;0;.00nan;0;0
9944;183844;135;74;46;4;42;.913;3900000;0
9944;-1;132;43;29;4;25;.862;3900000;0
9944;196809;132;0;0;0;0;.00nan;0;0
9945;177156;142;57;32;4;28;.875;3600000;0
9945;183859;142;0;0;0;0;.00nan;0;0
9945;183870;138;0;0;0;0;.00nan;0;0
9945;-1;138;52;32;5;27;.844;3576000;0
9946;184049;130;26;25;6;19;.760;2408000;0
9946;191574;141;0;0;0;0;.00nan;0;0
9946;197756;141;50;40;6;34;.850;3600000;0
9946;197759;130;54;9;1;8;.889;1192000;0
9947;194393;1340;0;0;0;0;.00nan;0;0
9947;202059;133;38;18;4;14;.778;3816000;0
9947;191571;1340;72;35;3;32;.914;3807000;0
9947;192499;133;0;0;0;0;.00nan;0;0
9948;196445;140;76;24;1;23;.958;3600000;0
9948;196812;140;0;0;0;0;.00nan;0;0
9948;191574;141;78;47;5;42;.894;3600000;0
9948;197756;141;0;0;0;0;.00nan;0;0
9949;182339;139;0;0;0;0;.00nan;0;0
9949;178789;139;81;33;2;31;.939;3600000;0
9949;-1;143;75;34;3;31;.912;3600000;0
9949;191218;143;0;0;0;0;.00nan;0;0
9950;177156;142;0;0;0;0;.00nan;0;0
9950;182395;131;0;0;0;0;.00nan;0;0
9950;183859;142;25;23;6;17;.739;3900000;0
9950;-1;131;87;60;6;54;.900;3900000;0
9951;183934;128;0;0;0;0;.00nan;0;0
9951;202059;133;0;0;0;0;.00nan;0;0
9951;-1;128;73;25;3;22;.880;3600000;0
9951;192499;133;78;45;4;41;.911;3557000;0
9952;184049;130;74;27;2;25;.926;3677000;0
9952;189944;144;0;0;0;0;.00nan;0;0
9952;184738;144;89;44;3;41;.932;3677000;0
9952;197759;130;0;0;0;0;.00nan;0;0
9953;187657;136;0;0;0;0;.00nan;0;0
9953;183904;137;38;33;6;27;.818;2830000;0
9953;-1;136;89;46;4;42;.913;3600000;0
9953;-1;137;35;6;2;4;.667;770000;0
9954;187578;135;77;38;3;35;.921;3569000;0
9954;194393;1340;0;0;0;0;.00nan;0;0
9954;183844;135;0;0;0;0;.00nan;0;0
9954;191571;1340;86;27;1;26;.963;3600000;0
9955;182395;131;0;0;0;0;.00nan;0;0
9955;187657;136;0;0;0;0;.00nan;0;0
9955;-1;131;73;37;3;34;.919;3600000;0
9955;-1;136;58;36;5;31;.861;3570000;0
9956;187578;135;51;11;1;10;.909;585000;0
9956;183844;135;54;45;6;39;.867;3015000;0
9956;183934;128;0;0;0;0;.00nan;0;0
9956;-1;128;57;20;2;18;.900;3600000;0
9957;194393;1340;0;0;0;0;.00nan;0;0
9957;-1;132;0;0;0;0;.00nan;0;0
9957;196809;132;75;26;2;24;.923;3600000;0
9957;191571;1340;49;33;5;28;.848;3600000;0
9958;187632;134;0;0;0;0;.00nan;0;0
9958;183730;134;24;40;7;33;.825;3600000;0
9958;183905;129;72;24;2;22;.917;3600000;0
9958;189264;129;0;0;0;0;.00nan;0;0
9959;183870;138;0;0;0;0;.00nan;0;0
9959;-1;143;53;28;3;25;.893;3586000;0
9959;191218;143;0;0;0;0;.00nan;0;0
9959;-1;138;88;33;2;31;.939;3600000;0
9960;182395;131;0;0;0;0;.00nan;0;0
9960;183904;137;0;0;0;0;.00nan;0;0
9960;-1;131;100;38;1;37;.974;3600000;0
9960;-1;137;57;20;2;18;.900;3543000;0
9961;177156;142;0;0;0;0;.00nan;0;0
9961;183859;142;52;23;3;20;.870;3600000;0
9961;196445;140;0;0;0;0;.00nan;0;0
9961;196812;140;49;28;4;24;.857;3570000;0
9962;182339;139;84;31;1;30;.968;3600000;0
9962;178789;139;0;0;0;0;.00nan;0;0
9962;191574;141;74;35;3;32;.914;3566000;0
9962;197756;141;0;0;0;0;.00nan;0;0
9963;187632;134;74;41;5;36;.878;3723000;0
9963;187657;136;79;42;4;38;.905;3723000;0
9963;183730;134;0;0;0;0;.00nan;0;0
9963;-1;136;0;0;0;0;.00nan;0;0
9964;183905;129;0;0;0;0;.00nan;0;0
9964;189264;129;67;18;1;17;.944;3600000;0
9964;-1;143;0;0;0;0;.00nan;0;0
9964;191218;143;56;39;5;34;.872;3600000;0
9965;194393;1340;0;0;0;0;.00nan;0;0
9965;183870;138;65;33;4;29;.879;3600000;0
9965;191571;1340;48;29;5;24;.828;3554000;0
9965;-1;138;0;0;0;0;.00nan;0;0
9966;183934;128;0;0;0;0;.00nan;0;0
9966;184049;130;85;35;2;33;.943;3600000;0
9966;-1;128;72;37;4;33;.892;3515000;0
9966;197759;130;0;0;0;0;.00nan;0;0
9967;187632;134;0;0;0;0;.00nan;0;0
9967;187657;136;0;0;0;0;.00nan;0;0
9967;183730;134;42;22;4;18;.818;3600000;0
9967;-1;136;77;33;3;30;.909;3600000;0
9968;182395;131;0;0;0;0;.00nan;0;0
9968;183934;128;36;29;5;24;.828;3600000;0
9968;-1;131;46;47;7;40;.851;3569000;0
9968;-1;128;0;0;0;0;.00nan;0;0
9969;202059;133;76;47;5;42;.894;3600000;0
9969;-1;132;70;25;2;23;.920;3600000;0
9969;196809;132;0;0;0;0;.00nan;0;0
9969;192499;133;0;0;0;0;.00nan;0;0
9970;187578;135;74;46;4;42;.913;3600000;0
9970;183844;135;0;0;0;0;.00nan;0;0
9970;-1;143;60;15;1;14;.933;3600000;0
9970;191218;143;0;0;0;0;.00nan;0;0
9971;189944;144;49;33;5;28;.848;1829000;0
9971;184738;144;12;13;5;8;.615;1771000;0
9971;196445;140;50;0;0;0;.00nan;393000;0
9971;196812;140;25;33;7;26;.788;3207000;0
9972;182339;139;35;21;4;17;.810;1673000;0
9972;178789;139;13;20;6;14;.700;1927000;0
9972;191574;141;0;0;0;0;.00nan;0;0
9972;197756;141;74;37;3;34;.919;3600000;0
9973;202059;133;0;0;0;0;.00nan;0;0
9973;-1;132;0;0;0;0;.00nan;0;0
9973;196809;132;25;32;7;25;.781;3600000;0
9973;192499;133;73;42;4;38;.905;3600000;0
9974;194393;1340;0;0;0;0;.00nan;0;0
9974;184049;130;100;35;0;35;1.000;3600000;0
9974;191571;1340;79;35;3;32;.914;3600000;0
9974;197759;130;0;0;0;0;.00nan;0;0
9975;177156;142;0;0;0;0;.00nan;0;0
9975;183859;142;100;24;0;24;1.000;3600000;0
9975;189944;144;86;51;4;47;.922;3600000;0
9975;184738;144;0;0;0;0;.00nan;0;0
9976;187578;135;0;0;0;0;.00nan;0;0
9976;183844;135;75;51;5;46;.902;3600000;0
9976;183904;137;77;30;2;28;.933;3600000;0
9976;-1;137;0;0;0;0;.00nan;0;0
9977;183870;138;0;0;0;0;.00nan;0;0
9977;183905;129;16;17;6;11;.647;2617000;0
9977;189264;129;35;13;3;10;.769;983000;0
9977;-1;138;42;35;6;29;.829;3600000;0
9978;182395;131;45;28;4;24;.857;1280000;0
9978;-1;131;33;26;5;21;.808;2320000;0
9978;196445;140;0;0;0;0;.00nan;0;0
9978;196812;140;42;21;4;17;.810;3600000;0
9979;187632;134;0;0;0;0;.00nan;0;0
9979;183730;134;85;23;1;22;.957;3900000;0
9979;189944;144;97;38;1;37;.974;3900000;0
9979;184738;144;0;0;0;0;.00nan;0;0
9980;182339;139;0;0;0;0;.00nan;0;0
9980;178789;139;83;34;2;32;.941;3600000;0
9980;202059;133;61;28;3;25;.893;3569000;0
9980;192499;133;0;0;0;0;.00nan;0;0
9981;177156;142;0;0;0;0;.00nan;0;0
9981;183859;142;98;40;2;38;.950;3600000;0
9981;-1;143;58;21;3;18;.857;3577000;0
9981;191218;143;0;0;0;0;.00nan;0;0
9982;194393;1340;0;0;0;0;.00nan;0;0
9982;196445;140;0;0;0;0;.00nan;0;0
9982;196812;140;56;29;4;25;.862;3600000;0
9982;191571;1340;100;33;0;33;1.000;3600000;0
9983;183870;138;0;0;0;0;.00nan;0;0
9983;-1;132;0;0;0;0;.00nan;0;0
9983;196809;132;50;25;3;22;.880;3600000;0
9983;-1;138;48;35;5;30;.857;3540000;0
9984;177156;142;64;24;2;22;.917;3515000;0
9984;183859;142;0;0;0;0;.00nan;0;0
9984;191574;141;100;30;0;30;1.000;3600000;0
9984;197756;141;0;0;0;0;.00nan;0;0
9985;182339;139;49;44;6;38;.864;3600000;0
9985;187632;134;0;0;0;0;.00nan;0;0
9985;183730;134;69;27;2;25;.926;3600000;0
9985;178789;139;0;0;0;0;.00nan;0;0
9986;182395;131;0;0;0;0;.00nan;0;0
9986;-1;131;63;41;5;36;.878;3600000;0
9986;202059;133;0;0;0;0;.00nan;0;0
9986;192499;133;81;22;1;21;.955;3600000;0
9987;183934;128;0;0;0;0;.00nan;0;0
9987;196445;140;21;25;6;19;.760;1840000;0
9987;-1;128;44;17;3;14;.824;3600000;0
9987;196812;140;71;15;0;15;1.000;1760000;0
9988;187578;135;98;41;2;39;.951;3600000;0
9988;183844;135;0;0;0;0;.00nan;0;0
9988;183905;129;75;23;1;22;.957;3600000;0
9988;189264;129;0;0;0;0;.00nan;0;0
9989;187657;136;70;26;2;24;.923;3600000;0
9989;184049;130;58;36;4;32;.889;3600000;0
9989;-1;136;0;0;0;0;.00nan;0;0
9989;197759;130;0;0;0;0;.00nan;0;0
9990;183904;137;78;49;5;44;.898;3843000;0
9990;189944;144;61;31;4;27;.871;3843000;0
9990;184738;144;0;0;0;0;.00nan;0;0
9990;-1;137;0;0;0;0;.00nan;0;0
9991;182339;139;0;0;0;0;.00nan;0;0
9991;183904;137;0;0;0;0;.00nan;0;0
9991;178789;139;87;40;2;38;.950;3900000;0
9991;-1;137;77;32;2;30;.938;3900000;0
9992;182395;131;0;0;0;0;.00nan;0;0
9992;-1;131;69;56;6;50;.893;3600000;0
9992;202059;133;67;14;1;13;.929;3600000;0
9992;192499;133;0;0;0;0;.00nan;0;0
9993;183870;138;0;0;0;0;.00nan;0;0
9993;183934;128;58;30;3;27;.900;3600000;0
9993;-1;128;0;0;0;0;.00nan;0;0
9993;-1;138;100;45;2;43;.956;3600000;0
9994;184049;130;0;0;0;0;.00nan;0;0
9994;-1;132;66;34;3;31;.912;3600000;0
9994;196809;132;0;0;0;0;.00nan;0;0
9994;197759;130;41;31;5;26;.839;3514000;0
9995;183905;129;0;0;0;0;.00nan;0;0
9995;189264;129;73;26;2;24;.923;3600000;0
9995;189944;144;0;0;0;0;.00nan;0;0
9995;184738;144;59;40;6;34;.850;3600000;0
9996;-1;143;49;38;6;32;.842;3600000;0
9996;191218;143;0;0;0;0;.00nan;0;0
9996;191574;141;92;42;2;40;.952;3600000;0
9996;197756;141;0;0;0;0;.00nan;0;0
9997;187578;135;0;0;0;0;.00nan;0;0
9997;187657;136;0;0;0;0;.00nan;0;0
9997;183844;135;91;43;3;40;.930;3600000;0
9997;-1;136;94;18;0;18;1.000;3600000;0
9998;194393;1340;0;0;0;0;.00nan;0;0
9998;183870;138;45;37;6;31;.838;3560000;0
9998;191571;1340;51;36;5;31;.861;3600000;0
9998;-1;138;0;0;0;0;.00nan;0;0
9999;187657;136;0;0;0;0;.00nan;0;0
9999;183904;137;97;43;3;40;.930;3600000;0
9999;-1;136;82;27;2;25;.926;3600000;0
9999;-1;137;0;0;0;0;.00nan;0;0
10000;182339;139;59;19;2;17;.895;3600000;0
10000;178789;139;0;0;0;0;.00nan;0;0
10000;189944;144;46;25;4;21;.840;3570000;0
10000;184738;144;0;0;0;0;.00nan;0;0
10001;177156;142;0;0;0;0;.00nan;0;0
10001;183859;142;84;30;1;29;.967;3600000;0
10001;-1;132;73;38;3;35;.921;3529000;0
10001;196809;132;0;0;0;0;.00nan;0;0
10002;183905;129;81;44;4;40;.909;3600000;0
10002;183934;128;0;0;0;0;.00nan;0;0
10002;189264;129;0;0;0;0;.00nan;0;0
10002;-1;128;100;40;1;39;.975;3600000;0
10003;184049;130;33;23;5;18;.783;3158000;0
10003;202059;133;51;2;0;2;1.000;569000;0
10003;192499;133;49;36;6;30;.833;2980000;0
10003;197759;130;51;1;0;1;1.000;442000;0
10004;187578;135;95;40;2;38;.950;3516000;0
10004;183844;135;0;0;0;0;.00nan;0;0
10004;183904;137;100;33;0;33;1.000;3600000;0
10004;-1;137;0;0;0;0;.00nan;0;0
10005;182395;131;72;19;1;18;.947;1388000;0
10005;-1;131;40;29;6;23;.793;2212000;0
10005;189944;144;64;31;3;28;.903;3600000;0
10005;184738;144;0;0;0;0;.00nan;0;0
10006;196445;140;0;0;0;0;.00nan;0;0
10006;-1;132;0;0;0;0;.00nan;0;0
10006;196809;132;63;33;3;30;.909;3581000;0
10006;196812;140;89;33;1;32;.970;3600000;0
10007;182339;139;0;0;0;0;.00nan;0;0
10007;178789;139;65;20;1;19;.950;3600000;0
10007;-1;143;39;35;6;29;.829;3600000;0
10007;191218;143;0;0;0;0;.00nan;0;0
10008;187578;135;0;0;0;0;.00nan;0;0
10008;187632;134;0;0;0;0;.00nan;0;0
10008;183730;134;61;13;1;12;.923;3600000;0
10008;183844;135;98;48;2;46;.958;3560000;0
10009;187657;136;51;35;5;30;.857;3600000;0
10009;194393;1340;0;0;0;0;.00nan;0;0
10009;-1;136;0;0;0;0;.00nan;0;0
10009;191571;1340;92;34;1;33;.971;3600000;0
10010;183870;138;0;0;0;0;.00nan;0;0
10010;183934;128;75;32;3;29;.906;3600000;0
10010;-1;128;0;0;0;0;.00nan;0;0
10010;-1;138;98;50;4;46;.920;3600000;0
10011;183905;129;60;7;0;7;1.000;657000;0
10011;189264;129;62;40;5;35;.875;2932000;0
10011;184049;130;0;0;0;0;.00nan;0;0
10011;197759;130;42;24;4;20;.833;3600000;0
10012;183904;137;50;29;4;25;.862;3567000;0
10012;202059;133;76;34;3;31;.912;3600000;0
10012;-1;137;0;0;0;0;.00nan;0;0
10012;192499;133;0;0;0;0;.00nan;0;0
10013;-1;132;66;41;5;36;.878;3600000;0
10013;196809;132;0;0;0;0;.00nan;0;0
10013;191574;141;86;29;1;28;.966;3600000;0
10013;197756;141;0;0;0;0;.00nan;0;0
10014;177156;142;0;0;0;0;.00nan;0;0
10014;182395;131;0;0;0;0;.00nan;0;0
10014;183859;142;66;22;2;20;.909;3600000;0
10014;-1;131;79;46;4;42;.913;3529000;0
10015;187657;136;0;0;0;0;.00nan;0;0
10015;194393;1340;89;45;3;42;.933;3600000;0
10015;-1;136;98;26;0;26;1.000;3600000;0
10015;191571;1340;0;0;0;0;.00nan;0;0
10016;182395;131;60;42;5;37;.881;3600000;0
10016;-1;131;0;0;0;0;.00nan;0;0
10016;196445;140;0;0;0;0;.00nan;0;0
10016;196812;140;91;21;0;21;1.000;3600000;0
10017;189944;144;79;46;4;42;.913;3600000;0
10017;184738;144;0;0;0;0;.00nan;0;0
10017;-1;143;31;34;6;28;.824;3523000;0
10017;191218;143;0;0;0;0;.00nan;0;0
10018;184049;130;27;30;6;24;.800;3600000;0
10018;202059;133;0;0;0;0;.00nan;0;0
10018;192499;133;93;41;2;39;.951;3600000;0
10018;197759;130;0;0;0;0;.00nan;0;0
10019;187657;136;0;0;0;0;.00nan;0;0
10019;183934;128;0;0;0;0;.00nan;0;0
10019;-1;128;39;20;4;16;.800;3540000;0
10019;-1;136;90;41;2;39;.951;3600000;0
10020;187578;135;73;37;3;34;.919;3600000;0
10020;183844;135;0;0;0;0;.00nan;0;0
10020;183905;129;42;33;6;27;.818;3600000;0
10020;189264;129;0;0;0;0;.00nan;0;0
10021;187632;134;0;0;0;0;.00nan;0;0
10021;183730;134;37;21;4;17;.810;3600000;0
10021;183870;138;0;0;0;0;.00nan;0;0
10021;-1;138;100;55;0;55;1.000;3600000;0
10022;189944;144;0;0;0;0;.00nan;0;0
10022;184738;144;61;34;3;31;.912;3553000;0
10022;-1;143;0;0;0;0;.00nan;0;0
10022;191218;143;76;21;1;20;.952;3600000;0
10023;196445;140;43;10;2;8;.800;1471000;0
10023;196812;140;46;28;4;24;.857;2129000;0
10023;191574;141;64;24;2;22;.917;3600000;0
10023;197756;141;0;0;0;0;.00nan;0;0
10024;182339;139;100;30;0;30;1.000;3600000;0
10024;177156;142;46;28;4;24;.857;3600000;0
10024;183859;142;0;0;0;0;.00nan;0;0
10024;178789;139;0;0;0;0;.00nan;0;0
10025;189944;144;77;33;2;31;.939;3600000;0
10025;184738;144;0;0;0;0;.00nan;0;0
10025;196445;140;0;0;0;0;.00nan;0;0
10025;196812;140;69;27;3;24;.889;3600000;0
10026;187632;134;0;0;0;0;.00nan;0;0
10026;183730;134;75;24;2;22;.917;3900000;0
10026;183870;138;0;0;0;0;.00nan;0;0
10026;-1;138;95;41;2;39;.951;3900000;0
10027;182395;131;60;31;3;28;.903;3600000;0
10027;-1;131;0;0;0;0;.00nan;0;0
10027;-1;132;43;30;5;25;.833;3522000;0
10027;196809;132;0;0;0;0;.00nan;0;0
10028;194393;1340;0;0;0;0;.00nan;0;0
10028;183934;128;0;0;0;0;.00nan;0;0
10028;-1;128;78;26;2;24;.923;3600000;0
10028;191571;1340;57;30;4;26;.867;3598000;0
10029;184049;130;100;45;0;45;1.000;3600000;0
10029;-1;143;80;30;2;28;.933;3565000;0
10029;191218;143;0;0;0;0;.00nan;0;0
10029;197759;130;0;0;0;0;.00nan;0;0
10030;183904;137;0;0;0;0;.00nan;0;0
10030;202059;133;97;34;1;33;.971;3900000;0
10030;-1;137;85;35;1;34;.971;3900000;0
10030;192499;133;0;0;0;0;.00nan;0;0
10031;177156;142;0;0;0;0;.00nan;0;0
10031;187657;136;75;28;2;26;.929;3600000;0
10031;183859;142;68;35;4;31;.886;3534000;0
10031;-1;136;0;0;0;0;.00nan;0;0
10032;182395;131;51;11;1;10;.909;892000;0
10032;-1;131;24;29;6;23;.793;2621000;0
10032;-1;143;0;0;0;0;.00nan;0;0
10032;191218;143;35;23;5;18;.783;3600000;0
10033;187578;135;0;0;0;0;.00nan;0;0
10033;183844;135;100;39;0;39;1.000;3600000;0
10033;183905;129;45;24;4;20;.833;3600000;0
10033;189264;129;0;0;0;0;.00nan;0;0
10034;183870;138;41;29;5;24;.828;3600000;0
10034;183904;137;68;24;2;22;.917;3600000;0
10034;-1;137;0;0;0;0;.00nan;0;0
10034;-1;138;0;0;0;0;.00nan;0;0
10035;187632;134;67;37;4;33;.892;3900000;0
10035;183730;134;0;0;0;0;.00nan;0;0
10035;202059;133;0;0;0;0;.00nan;0;0
10035;192499;133;62;37;4;33;.892;3900000;0
10036;194393;1340;0;0;0;0;.00nan;0;0
10036;-1;132;0;0;0;0;.00nan;0;0
10036;196809;132;56;20;2;18;.900;3600000;0
10036;191571;1340;47;19;3;16;.842;3575000;0
10037;177156;142;74;43;4;39;.907;3600000;0
10037;183859;142;0;0;0;0;.00nan;0;0
10037;183905;129;0;0;0;0;.00nan;0;0
10037;189264;129;57;44;6;38;.864;3546000;0
10038;183934;128;0;0;0;0;.00nan;0;0
10038;184049;130;52;35;5;30;.857;3583000;0
10038;-1;128;66;30;3;27;.900;3600000;0
10038;197759;130;0;0;0;0;.00nan;0;0
10039;189944;144;0;0;0;0;.00nan;0;0
10039;184738;144;26;29;6;23;.793;3600000;0
10039;191574;141;32;32;6;26;.813;3129000;0
10039;197756;141;44;4;1;3;.750;471000;0
10040;182339;139;67;37;3;34;.919;3653000;0
10040;178789;139;0;0;0;0;.00nan;0;0
10040;196445;140;0;0;0;0;.00nan;0;0
10040;196812;140;50;25;4;21;.840;3653000;0
10041;182339;139;0;0;0;0;.00nan;0;0
10041;178789;139;88;43;3;40;.930;3600000;0
10041;196445;140;69;33;4;29;.879;3565000;0
10041;196812;140;0;0;0;0;.00nan;0;0
10042;189944;144;27;15;4;11;.733;2362000;0
10042;184738;144;65;15;1;14;.933;1268000;0
10042;191574;141;0;0;0;0;.00nan;0;0
10042;197756;141;60;29;4;25;.862;3630000;0
10043;187657;136;0;0;0;0;.00nan;0;0
10043;-1;143;67;42;4;38;.905;3564000;0
10043;191218;143;0;0;0;0;.00nan;0;0
10043;-1;136;45;18;3;15;.833;3600000;0
10044;183934;128;32;24;5;19;.792;3570000;0
10044;-1;128;0;0;0;0;.00nan;0;0
10044;-1;132;68;29;3;26;.897;3600000;0
10044;196809;132;0;0;0;0;.00nan;0;0
10045;177156;142;0;0;0;0;.00nan;0;0
10045;183859;142;55;42;6;36;.857;3900000;0
10045;184049;130;0;0;0;0;.00nan;0;0
10045;197759;130;47;38;6;32;.842;3900000;0
10046;187632;134;0;0;0;0;.00nan;0;0
10046;183730;134;76;29;3;26;.897;3600000;0
10046;202059;133;36;17;4;13;.765;1848000;0
10046;192499;133;13;28;7;21;.750;1752000;0
10047;187578;135;0;0;0;0;.00nan;0;0
10047;183844;135;59;42;6;36;.857;3536000;0
10047;183870;138;0;0;0;0;.00nan;0;0
10047;-1;138;54;29;4;25;.862;3600000;0
10048;194393;1340;68;18;1;17;.944;3600000;0
10048;183905;129;62;32;3;29;.906;3553000;0
10048;189264;129;0;0;0;0;.00nan;0;0
10048;191571;1340;0;0;0;0;.00nan;0;0
10049;182339;139;0;0;0;0;.00nan;0;0
10049;178789;139;68;35;4;31;.886;3600000;0
10049;-1;143;29;28;6;22;.786;3546000;0
10049;191218;143;0;0;0;0;.00nan;0;0
10050;182395;131;78;37;2;35;.946;3600000;0
10050;183904;137;86;30;1;29;.967;3600000;0
10050;-1;131;0;0;0;0;.00nan;0;0
10050;-1;137;0;0;0;0;.00nan;0;0
10051;-1;132;45;40;6;34;.850;3305000;0
10051;196809;132;48;0;0;0;.00nan;295000;0
10051;191574;141;61;24;3;21;.875;3600000;0
10051;197756;141;0;0;0;0;.00nan;0;0
10052;187657;136;53;24;3;21;.875;3900000;0
10052;183870;138;0;0;0;0;.00nan;0;0
10052;-1;136;0;0;0;0;.00nan;0;0
10052;-1;138;65;34;3;31;.912;3900000;0
10053;187632;134;0;0;0;0;.00nan;0;0
10053;183730;134;98;23;0;23;1.000;3600000;0
10053;189944;144;91;45;2;43;.956;3531000;0
10053;184738;144;0;0;0;0;.00nan;0;0
10054;196445;140;0;0;0;0;.00nan;0;0
10054;-1;143;0;0;0;0;.00nan;0;0
10054;196812;140;58;34;4;30;.882;3572000;0
10054;191218;143;78;33;2;31;.939;3600000;0
10055;187578;135;98;50;3;47;.940;3600000;0
10055;183844;135;0;0;0;0;.00nan;0;0
10055;183934;128;0;0;0;0;.00nan;0;0
10055;-1;128;97;26;0;26;1.000;3600000;0
10056;177156;142;0;0;0;0;.00nan;0;0
10056;187632;134;0;0;0;0;.00nan;0;0
10056;183730;134;53;25;3;22;.880;3719000;0
10056;183859;142;45;25;4;21;.840;3719000;0
10057;194393;1340;0;0;0;0;.00nan;0;0
10057;183904;137;94;22;0;22;1.000;3600000;0
10057;-1;137;0;0;0;0;.00nan;0;0
10057;191571;1340;78;33;2;31;.939;3514000;0
10058;182395;131;0;0;0;0;.00nan;0;0
10058;183934;128;0;0;0;0;.00nan;0;0
10058;-1;131;100;64;3;61;.953;3600000;0
10058;-1;128;37;14;4;10;.714;3552000;0
10059;187578;135;0;0;0;0;.00nan;0;0
10059;183844;135;82;43;4;39;.907;3900000;0
10059;184049;130;63;31;4;27;.871;3900000;0
10059;197759;130;0;0;0;0;.00nan;0;0
10060;183905;129;37;29;5;24;.828;3547000;0
10060;189264;129;0;0;0;0;.00nan;0;0
10060;191574;141;66;32;3;29;.906;3600000;0
10060;197756;141;0;0;0;0;.00nan;0;0
10061;183870;138;0;0;0;0;.00nan;0;0
10061;-1;132;0;0;0;0;.00nan;0;0
10061;196809;132;82;40;3;37;.925;3586000;0
10061;-1;138;68;24;2;22;.917;3600000;0
10062;187632;134;0;0;0;0;.00nan;0;0
10062;183730;134;68;34;3;31;.912;3553000;0
10062;196445;140;67;24;2;22;.917;3600000;0
10062;196812;140;0;0;0;0;.00nan;0;0
10063;187657;136;0;0;0;0;.00nan;0;0
10063;202059;133;96;41;2;39;.951;3600000;0
10063;-1;136;100;32;1;31;.969;3600000;0
10063;192499;133;0;0;0;0;.00nan;0;0
10064;182395;131;66;52;6;46;.885;3600000;0
10064;-1;131;0;0;0;0;.00nan;0;0
10064;-1;132;57;22;3;19;.864;3600000;0
10064;196809;132;0;0;0;0;.00nan;0;0
10065;183870;138;53;38;5;33;.868;3596000;0
10065;191574;141;0;0;0;0;.00nan;0;0
10065;197756;141;47;26;4;22;.846;3600000;0
10065;-1;138;0;0;0;0;.00nan;0;0
10066;182339;139;0;0;0;0;.00nan;0;0
10066;178789;139;55;23;3;20;.870;3900000;0
10066;189944;144;69;33;3;30;.909;3876000;0
10066;184738;144;0;0;0;0;.00nan;0;0
10067;177156;142;78;32;2;30;.938;3600000;0
10067;183859;142;0;0;0;0;.00nan;0;0
10067;-1;143;52;32;5;27;.844;3600000;0
10067;191218;143;0;0;0;0;.00nan;0;0
10068;194393;1340;90;30;1;29;.967;3600000;0
10068;183904;137;13;22;7;15;.682;3600000;0
10068;-1;137;0;0;0;0;.00nan;0;0
10068;191571;1340;0;0;0;0;.00nan;0;0
10069;182339;139;0;0;0;0;.00nan;0;0
10069;178789;139;79;45;4;41;.911;3565000;0
10069;196445;140;0;0;0;0;.00nan;0;0
10069;196812;140;48;22;3;19;.864;3600000;0
10070;187578;135;0;0;0;0;.00nan;0;0
10070;183844;135;91;40;3;37;.925;3600000;0
10070;202059;133;0;0;0;0;.00nan;0;0
10070;192499;133;78;35;2;33;.943;3600000;0
10071;183904;137;60;9;0;9;1.000;446000;0
10071;183934;128;0;0;0;0;.00nan;0;0
10071;-1;128;48;14;2;12;.857;3600000;0
10071;-1;137;44;53;8;45;.849;3154000;0
10072;183905;129;0;0;0;0;.00nan;0;0
10072;189264;129;57;36;4;32;.889;3537000;0
10072;184049;130;68;23;2;21;.913;3600000;0
10072;197759;130;0;0;0;0;.00nan;0;0
10073;177156;142;0;0;0;0;.00nan;0;0
10073;183859;142;91;43;2;41;.953;3600000;0
10073;189944;144;37;11;3;8;.727;524000;0
10073;184738;144;84;32;1;31;.969;3027000;0
10074;182339;139;72;31;2;29;.935;3600000;0
10074;178789;139;0;0;0;0;.00nan;0;0
10074;191574;141;49;38;5;33;.868;3600000;0
10074;197756;141;0;0;0;0;.00nan;0;0
10075;187657;136;0;0;0;0;.00nan;0;0
10075;183870;138;98;52;3;49;.942;3572000;0
10075;-1;136;68;19;1;18;.947;3600000;0
10075;-1;138;0;0;0;0;.00nan;0;0
10076;187632;134;51;36;5;31;.861;3572000;0
10076;183730;134;0;0;0;0;.00nan;0;0
10076;183905;129;57;34;4;30;.882;3600000;0
10076;189264;129;0;0;0;0;.00nan;0;0
10077;194393;1340;0;0;0;0;.00nan;0;0
10077;183934;128;0;0;0;0;.00nan;0;0
10077;-1;128;86;24;1;23;.958;3600000;0
10077;191571;1340;56;45;6;39;.867;3600000;0
10078;184049;130;65;29;3;26;.897;3739000;0
10078;-1;132;0;0;0;0;.00nan;0;0
10078;196809;132;65;38;4;34;.895;3739000;0
10078;197759;130;0;0;0;0;.00nan;0;0
10079;182339;139;0;0;0;0;.00nan;0;0
10079;177156;142;0;0;0;0;.00nan;0;0
10079;183859;142;65;36;4;32;.889;3707000;0
10079;178789;139;56;37;5;32;.865;3707000;0
10080;196445;140;32;32;6;26;.813;2603000;0
10080;-1;143;0;0;0;0;.00nan;0;0
10080;196812;140;12;11;5;6;.545;997000;0
10080;191218;143;48;32;4;28;.875;3600000;0
10081;182395;131;0;0;0;0;.00nan;0;0
10081;187657;136;38;14;3;11;.786;3600000;0
10081;-1;131;84;50;4;46;.920;3581000;0
10081;-1;136;0;0;0;0;.00nan;0;0
10082;202059;133;66;25;3;22;.880;3600000;0
10082;-1;132;0;0;0;0;.00nan;0;0
10082;196809;132;68;40;4;36;.900;3545000;0
10082;192499;133;0;0;0;0;.00nan;0;0
10083;183934;128;66;26;2;24;.923;2488000;0
10083;184049;130;72;32;3;29;.906;3600000;0
10083;-1;128;36;18;4;14;.778;1112000;0
10083;197759;130;0;0;0;0;.00nan;0;0
10084;183870;138;0;0;0;0;.00nan;0;0
10084;183905;129;51;10;1;9;.900;1361000;0
10084;189264;129;51;36;5;31;.861;2239000;0
10084;-1;138;70;35;4;31;.886;3600000;0
10085;182395;131;54;41;6;35;.854;2392000;0
10085;187657;136;0;0;0;0;.00nan;0;0
10085;-1;131;42;15;3;12;.800;1208000;0
10085;-1;136;94;31;1;30;.968;3600000;0
10086;187632;134;0;0;0;0;.00nan;0;0
10086;183730;134;68;33;4;29;.879;3707000;0
10086;183904;137;81;47;5;42;.894;3707000;0
10086;-1;137;0;0;0;0;.00nan;0;0
10087;202059;133;0;0;0;0;.00nan;0;0
10087;-1;132;18;7;4;3;.429;1150000;0
10087;196809;132;66;30;2;28;.933;2450000;0
10087;192499;133;76;34;3;31;.912;3600000;0
10088;187578;135;0;0;0;0;.00nan;0;0
10088;183844;135;81;64;3;61;.953;3600000;0
10088;183934;128;0;0;0;0;.00nan;0;0
10088;-1;128;47;15;2;13;.867;3600000;0
10089;182339;139;0;0;0;0;.00nan;0;0
10089;177156;142;91;36;1;35;.972;3600000;0
10089;183859;142;0;0;0;0;.00nan;0;0
10089;178789;139;82;30;2;28;.933;3547000;0
10090;189944;144;53;44;7;37;.841;3600000;0
10090;184738;144;0;0;0;0;.00nan;0;0
10090;191574;141;46;25;4;21;.840;3600000;0
10090;197756;141;0;0;0;0;.00nan;0;0
10091;194393;1340;0;0;0;0;.00nan;0;0
10091;184049;130;42;27;5;22;.815;3600000;0
10091;191571;1340;100;38;1;37;.974;3600000;0
10091;197759;130;0;0;0;0;.00nan;0;0
10092;196445;140;0;0;0;0;.00nan;0;0
10092;196812;140;62;25;3;22;.880;3600000;0
10092;191574;141;0;0;0;0;.00nan;0;0
10092;197756;141;71;38;4;34;.895;3578000;0
10093;189944;144;86;39;2;37;.949;3900000;0
10093;184738;144;0;0;0;0;.00nan;0;0
10093;-1;143;0;0;0;0;.00nan;0;0
10093;191218;143;85;36;2;34;.944;3900000;0
10094;187632;134;65;30;3;27;.900;3600000;0
10094;183730;134;0;0;0;0;.00nan;0;0
10094;183904;137;74;52;6;46;.885;3600000;0
10094;-1;137;0;0;0;0;.00nan;0;0
10095;187578;135;25;6;3;3;.500;452000;0
10095;194393;1340;81;30;1;29;.967;3600000;0
10095;183844;135;47;21;3;18;.857;3148000;0
10095;191571;1340;0;0;0;0;.00nan;0;0
10096;183870;138;0;0;0;0;.00nan;0;0
10096;183905;129;73;32;3;29;.906;3526000;0
10096;189264;129;0;0;0;0;.00nan;0;0
10096;-1;138;93;31;1;30;.968;3600000;0
10097;187632;134;0;0;0;0;.00nan;0;0
10097;187657;136;94;33;2;31;.939;3600000;0
10097;183730;134;58;33;4;29;.879;3522000;0
10097;-1;136;0;0;0;0;.00nan;0;0
10098;183904;137;33;30;6;24;.800;2805000;0
10098;202059;133;87;35;2;33;.943;3600000;0
10098;-1;137;49;6;1;5;.833;795000;0
10098;192499;133;0;0;0;0;.00nan;0;0
10099;183905;129;0;0;0;0;.00nan;0;0
10099;183934;128;0;0;0;0;.00nan;0;0
10099;189264;129;50;30;4;26;.867;3600000;0
10099;-1;128;100;25;0;25;1.000;3600000;0
10100;194393;1340;0;0;0;0;.00nan;0;0
10100;183870;138;0;0;0;0;.00nan;0;0
10100;191571;1340;49;27;4;23;.852;3545000;0
10100;-1;138;84;37;2;35;.946;3600000;0
10101;182339;139;0;0;0;0;.00nan;0;0
10101;178789;139;95;34;2;32;.941;3600000;0
10101;189944;144;94;55;4;51;.927;3570000;0
10101;184738;144;0;0;0;0;.00nan;0;0
10102;-1;143;0;0;0;0;.00nan;0;0
10102;191218;143;71;25;1;24;.960;3600000;0
10102;191574;141;39;32;6;26;.813;3600000;0
10102;197756;141;0;0;0;0;.00nan;0;0
10103;177156;142;0;0;0;0;.00nan;0;0
10103;183859;142;76;43;4;39;.907;3600000;0
10103;196445;140;0;0;0;0;.00nan;0;0
10103;196812;140;94;21;0;21;1.000;3600000;0
10104;187578;135;0;0;0;0;.00nan;0;0
10104;194393;1340;64;27;3;24;.889;3581000;0
10104;183844;135;97;39;2;37;.949;3600000;0
10104;191571;1340;0;0;0;0;.00nan;0;0
10105;183870;138;80;37;3;34;.919;3600000;0
10105;184049;130;100;26;0;26;1.000;3600000;0
10105;197759;130;0;0;0;0;.00nan;0;0
10105;-1;138;0;0;0;0;.00nan;0;0
10106;187578;135;98;55;2;53;.964;3548000;0
10106;183844;135;0;0;0;0;.00nan;0;0
10106;183934;128;0;0;0;0;.00nan;0;0
10106;-1;128;61;13;1;12;.923;3600000;0
10107;184049;130;41;20;4;16;.800;3600000;0
10107;202059;133;0;0;0;0;.00nan;0;0
10107;192499;133;66;42;5;37;.881;3569000;0
10107;197759;130;0;0;0;0;.00nan;0;0
10108;187657;136;0;0;0;0;.00nan;0;0
10108;183904;137;99;46;2;44;.957;3600000;0
10108;-1;136;72;32;3;29;.906;3587000;0
10108;-1;137;0;0;0;0;.00nan;0;0
10109;183905;129;51;30;4;26;.867;3822000;0
10109;189264;129;0;0;0;0;.00nan;0;0
10109;-1;132;0;0;0;0;.00nan;0;0
10109;196809;132;58;35;5;30;.857;3822000;0
10110;182339;139;0;0;0;0;.00nan;0;0
10110;178789;139;74;42;5;37;.881;3854000;0
10110;196445;140;53;41;6;35;.854;3854000;0
10110;196812;140;0;0;0;0;.00nan;0;0
10111;187632;134;80;33;2;31;.939;3297000;0
10111;187657;136;54;35;5;30;.857;3900000;0
10111;183730;134;25;8;3;5;.625;603000;0
10111;-1;136;0;0;0;0;.00nan;0;0
10112;182395;131;0;0;0;0;.00nan;0;0
10112;194393;1340;0;0;0;0;.00nan;0;0
10112;-1;131;44;30;4;26;.867;3586000;0
10112;191571;1340;68;29;3;26;.897;3600000;0
10113;183934;128;0;0;0;0;.00nan;0;0
10113;-1;128;45;26;4;22;.846;3600000;0
10113;-1;132;44;41;7;34;.829;3600000;0
10113;196809;132;0;0;0;0;.00nan;0;0
10114;183905;129;0;0;0;0;.00nan;0;0
10114;189264;129;75;42;4;38;.905;3551000;0
10114;202059;133;74;26;2;24;.923;3600000;0
10114;192499;133;0;0;0;0;.00nan;0;0
10115;189944;144;100;51;2;49;.961;3900000;0
10115;184738;144;0;0;0;0;.00nan;0;0
10115;-1;143;0;0;0;0;.00nan;0;0
10115;191218;143;57;22;2;20;.909;3900000;0
10116;177156;142;81;30;1;29;.967;3600000;0
10116;183859;142;0;0;0;0;.00nan;0;0
10116;191574;141;61;25;3;22;.880;3541000;0
10116;197756;141;0;0;0;0;.00nan;0;0
10117;177156;142;0;0;0;0;.00nan;0;0
10117;183859;142;86;30;1;29;.967;3600000;0
10117;191574;141;0;0;0;0;.00nan;0;0
10117;197756;141;53;43;6;37;.860;3600000;0
10118;182395;131;73;31;2;29;.935;3600000;0
10118;187578;135;0;0;0;0;.00nan;0;0
10118;183844;135;57;33;5;28;.848;3600000;0
10118;-1;131;0;0;0;0;.00nan;0;0
10119;187632;134;40;14;3;11;.786;1563000;0
10119;183730;134;44;30;6;24;.800;2037000;0
10119;184049;130;78;25;1;24;.960;3600000;0
10119;197759;130;0;0;0;0;.00nan;0;0
10120;182339;139;0;0;0;0;.00nan;0;0
10120;178789;139;59;36;5;31;.861;3729000;0
10120;189944;144;0;0;0;0;.00nan;0;0
10120;184738;144;64;39;4;35;.897;3728000;0
10121;183870;138;0;0;0;0;.00nan;0;0
10121;183904;137;51;25;4;21;.840;3600000;0
10121;-1;137;0;0;0;0;.00nan;0;0
10121;-1;138;100;27;0;27;1.000;3600000;0
10122;183905;129;17;30;7;23;.767;2141000;0
10122;189264;129;46;20;4;16;.800;1459000;0
10122;184049;130;43;42;7;35;.833;3600000;0
10122;197759;130;0;0;0;0;.00nan;0;0
10123;196445;140;39;21;4;17;.810;1979000;0
10123;196812;140;18;16;5;11;.688;1621000;0
10123;191574;141;53;28;4;24;.857;3600000;0
10123;197756;141;0;0;0;0;.00nan;0;0
10124;177156;142;0;0;0;0;.00nan;0;0
10124;183859;142;79;33;2;31;.939;3543000;0
10124;189944;144;74;24;1;23;.958;3600000;0
10124;184738;144;0;0;0;0;.00nan;0;0
10125;187657;136;0;0;0;0;.00nan;0;0
10125;-1;132;0;0;0;0;.00nan;0;0
10125;196809;132;60;29;3;26;.897;3900000;0
10125;-1;136;69;30;3;27;.900;3900000;0
10126;194393;1340;0;0;0;0;.00nan;0;0
10126;183934;128;0;0;0;0;.00nan;0;0
10126;-1;128;31;19;4;15;.789;3567000;0
10126;191571;1340;88;46;3;43;.935;3600000;0
10127;187578;135;53;13;1;12;.923;1290000;0
10127;183844;135;40;30;6;24;.800;2310000;0
10127;183870;138;0;0;0;0;.00nan;0;0
10127;-1;138;62;24;2;22;.917;3600000;0
10128;187578;135;0;0;0;0;.00nan;0;0
10128;183844;135;70;44;5;39;.886;3588000;0
10128;-1;132;48;22;3;19;.864;3600000;0
10128;196809;132;0;0;0;0;.00nan;0;0
10129;189944;144;53;35;5;30;.857;2985000;0
10129;184738;144;16;7;4;3;.429;615000;0
10129;196445;140;0;0;0;0;.00nan;0;0
10129;196812;140;47;29;4;25;.862;3600000;0
10130;177156;142;80;35;3;32;.914;3900000;0
10130;183859;142;0;0;0;0;.00nan;0;0
10130;-1;143;0;0;0;0;.00nan;0;0
10130;191218;143;65;36;3;33;.917;3900000;0
10131;182339;139;97;32;0;32;1.000;3210000;0
10131;178789;139;24;5;3;2;.400;356000;0
10131;191574;141;80;37;2;35;.946;3600000;0
10131;197756;141;0;0;0;0;.00nan;0;0
10132;187632;134;65;34;3;31;.912;3544000;0
10132;183730;134;0;0;0;0;.00nan;0;0
10132;184049;130;66;27;2;25;.926;3600000;0
10132;197759;130;0;0;0;0;.00nan;0;0
10133;187657;136;0;0;0;0;.00nan;0;0
10133;202059;133;0;0;0;0;.00nan;0;0
10133;-1;136;72;32;3;29;.906;3575000;0
10133;192499;133;80;31;2;29;.935;3600000;0
10134;194393;1340;0;0;0;0;.00nan;0;0
10134;183870;138;0;0;0;0;.00nan;0;0
10134;191571;1340;74;29;2;27;.931;3600000;0
10134;-1;138;100;31;0;31;1.000;3600000;0
10135;182395;131;0;0;0;0;.00nan;0;0
10135;183934;128;0;0;0;0;.00nan;0;0
10135;-1;131;76;47;5;42;.894;3600000;0
10135;-1;128;67;19;1;18;.947;3600000;0
10136;183904;137;52;21;3;18;.857;3532000;0
10136;183905;129;81;27;2;25;.926;3600000;0
10136;189264;129;0;0;0;0;.00nan;0;0
10136;-1;137;0;0;0;0;.00nan;0;0
10137;189944;144;73;38;3;35;.921;3561000;0
10137;184738;144;0;0;0;0;.00nan;0;0
10137;196445;140;75;26;1;25;.962;3600000;0
10137;196812;140;0;0;0;0;.00nan;0;0
10138;182339;139;0;0;0;0;.00nan;0;0
10138;178789;139;64;43;5;38;.884;3599000;0
10138;191574;141;0;0;0;0;.00nan;0;0
10138;197756;141;100;53;3;50;.943;3600000;0
10139;177156;142;0;0;0;0;.00nan;0;0
10139;183859;142;72;36;3;33;.917;3600000;0
10139;-1;143;77;29;2;27;.931;3600000;0
10139;191218;143;0;0;0;0;.00nan;0;0
10140;187657;136;51;29;4;25;.862;3600000;0
10140;202059;133;19;22;6;16;.727;2114000;0
10140;-1;136;0;0;0;0;.00nan;0;0
10140;192499;133;34;20;4;16;.800;1486000;0
10141;183904;137;0;0;0;0;.00nan;0;0
10141;184049;130;31;34;6;28;.824;3178000;0
10141;-1;137;60;33;4;29;.879;3600000;0
10141;197759;130;41;2;1;1;.500;422000;0
10142;187632;134;0;0;0;0;.00nan;0;0
10142;183730;134;90;34;1;33;.971;3600000;0
10142;183905;129;0;0;0;0;.00nan;0;0
10142;189264;129;57;28;4;24;.857;3600000;0
10143;182395;131;69;42;5;37;.881;3900000;0
10143;194393;1340;70;48;5;43;.896;3900000;0
10143;-1;131;0;0;0;0;.00nan;0;0
10143;191571;1340;0;0;0;0;.00nan;0;0
10144;183870;138;0;0;0;0;.00nan;0;0
10144;183934;128;0;0;0;0;.00nan;0;0
10144;-1;128;50;25;4;21;.840;3600000;0
10144;-1;138;80;52;5;47;.904;3544000;0
10145;187578;135;0;0;0;0;.00nan;0;0
10145;183844;135;38;38;6;32;.842;3600000;0
10145;-1;132;0;0;0;0;.00nan;0;0
10145;196809;132;42;31;5;26;.839;3600000;0
10147;182339;139;0;0;0;0;.00nan;0;0
10147;183934;128;0;0;0;0;.00nan;0;0
10147;178789;139;19;29;7;22;.759;3600000;0
10147;-1;128;69;21;2;19;.905;3600000;0
10149;177156;142;0;0;0;0;.00nan;0;0
10149;183859;142;78;28;2;26;.929;3600000;0
10149;-1;143;62;39;4;35;.897;3551000;0
10149;191218;143;0;0;0;0;.00nan;0;0
10151;187578;135;83;41;3;38;.927;3600000;0
10151;183844;135;0;0;0;0;.00nan;0;0
10151;184049;130;82;13;0;13;1.000;3600000;0
10151;197759;130;0;0;0;0;.00nan;0;0
10153;194393;1340;0;0;0;0;.00nan;0;0
10153;191571;1340;68;40;3;37;.925;3900000;0
10153;191574;141;47;21;3;18;.857;3900000;0
10153;197756;141;0;0;0;0;.00nan;0;0
10155;183904;137;89;19;0;19;1.000;3600000;0
10155;202059;133;0;0;0;0;.00nan;0;0
10155;-1;137;0;0;0;0;.00nan;0;0
10155;192499;133;92;45;2;43;.956;3600000;0
10157;182395;131;27;37;7;30;.811;1991000;0
10157;187632;134;0;0;0;0;.00nan;0;0
10157;183730;134;70;18;1;17;.944;3600000;0
10157;-1;131;22;23;6;17;.739;1609000;0
10159;187657;136;0;0;0;0;.00nan;0;0
10159;189944;144;73;27;2;25;.926;3600000;0
10159;184738;144;0;0;0;0;.00nan;0;0
10159;-1;136;61;29;4;25;.862;3523000;0
10161;183870;138;52;18;2;16;.889;2355000;0
10161;-1;132;0;0;0;0;.00nan;0;0
10161;196809;132;55;33;4;29;.879;3600000;0
10161;-1;138;33;19;4;15;.789;1200000;0
10163;183905;129;43;33;5;28;.848;3600000;0
10163;189264;129;0;0;0;0;.00nan;0;0
10163;196445;140;0;0;0;0;.00nan;0;0
10163;196812;140;64;12;1;11;.917;3600000;0
10165;182339;139;87;36;2;34;.944;3600000;0
10165;187632;134;0;0;0;0;.00nan;0;0
10165;183730;134;40;17;3;14;.824;3600000;0
10165;178789;139;0;0;0;0;.00nan;0;0
10167;187657;136;52;22;3;19;.864;3554000;0
10167;196445;140;0;0;0;0;.00nan;0;0
10167;196812;140;98;39;2;37;.949;3600000;0
10167;-1;136;0;0;0;0;.00nan;0;0
10169;184049;130;63;19;2;17;.895;3600000;0
10169;202059;133;0;0;0;0;.00nan;0;0
10169;192499;133;58;34;4;30;.882;3572000;0
10169;197759;130;0;0;0;0;.00nan;0;0
10171;182395;131;55;31;4;27;.871;3181000;0
10171;183870;138;47;24;4;20;.833;3900000;0
10171;-1;131;49;4;0;4;1.000;719000;0
10171;-1;138;0;0;0;0;.00nan;0;0
10173;187578;135;54;25;4;21;.840;3600000;0
10173;183844;135;0;0;0;0;.00nan;0;0
10173;-1;132;71;34;3;31;.912;3600000;0
10173;196809;132;0;0;0;0;.00nan;0;0
10175;194393;1340;0;0;0;0;.00nan;0;0
10175;191571;1340;70;50;4;46;.920;3600000;0
10175;191574;141;60;23;3;20;.870;3600000;0
10175;197756;141;0;0;0;0;.00nan;0;0
10177;183904;137;69;44;5;39;.886;3600000;0
10177;183934;128;0;0;0;0;.00nan;0;0
10177;-1;128;78;11;0;11;1.000;3600000;0
10177;-1;137;0;0;0;0;.00nan;0;0
10179;183905;129;0;0;0;0;.00nan;0;0
10179;189264;129;52;26;3;23;.885;3600000;0
10179;189944;144;89;20;0;20;1.000;3600000;0
10179;184738;144;0;0;0;0;.00nan;0;0
10181;177156;142;0;0;0;0;.00nan;0;0
10181;183859;142;24;34;7;27;.794;3600000;0
10181;-1;143;78;24;1;23;.958;3600000;0
10181;191218;143;0;0;0;0;.00nan;0;0
10183;-1;132;0;0;0;0;.00nan;0;0
10183;-1;143;0;0;0;0;.00nan;0;0
10183;196809;132;56;37;4;33;.892;3600000;0
10183;191218;143;70;29;3;26;.897;3600000;0
10185;182395;131;0;0;0;0;.00nan;0;0
10185;183934;128;0;0;0;0;.00nan;0;0
10185;-1;131;45;43;6;37;.860;3600000;0
10185;-1;128;63;13;1;12;.923;3600000;0
10187;177156;142;97;50;3;47;.940;3600000;0
10187;183859;142;0;0;0;0;.00nan;0;0
10187;183904;137;0;0;0;0;.00nan;0;0
10187;-1;137;69;25;2;23;.920;3600000;0
10189;187578;135;0;0;0;0;.00nan;0;0
10189;183844;135;83;29;1;28;.966;3900000;0
10189;183870;138;0;0;0;0;.00nan;0;0
10189;-1;138;82;29;1;28;.966;3900000;0
10191;194393;1340;67;26;2;24;.923;3600000;0
10191;191571;1340;0;0;0;0;.00nan;0;0
10191;191574;141;0;0;0;0;.00nan;0;0
10191;197756;141;71;39;3;36;.923;3596000;0
10193;182339;139;58;23;2;21;.913;2669000;0
10193;178789;139;28;14;4;10;.714;931000;0
10193;202059;133;75;18;1;17;.944;3600000;0
10193;192499;133;0;0;0;0;.00nan;0;0
10195;187657;136;0;0;0;0;.00nan;0;0
10195;196445;140;86;31;1;30;.968;3600000;0
10195;196812;140;0;0;0;0;.00nan;0;0
10195;-1;136;31;20;4;16;.800;3600000;0
10197;187632;134;38;22;4;18;.818;3561000;0
10197;183730;134;0;0;0;0;.00nan;0;0
10197;189944;144;76;28;2;26;.929;3600000;0
10197;184738;144;0;0;0;0;.00nan;0;0
10199;183905;129;99;24;0;24;1.000;3600000;0
10199;189264;129;0;0;0;0;.00nan;0;0
10199;184049;130;0;0;0;0;.00nan;0;0
10199;197759;130;78;27;1;26;.963;3550000;0
10201;187578;135;87;35;1;34;.971;3600000;0
10201;183844;135;0;0;0;0;.00nan;0;0
10201;183904;137;72;24;2;22;.917;3555000;0
10201;-1;137;0;0;0;0;.00nan;0;0
10203;184049;130;41;37;6;31;.838;3523000;0
10203;189944;144;0;0;0;0;.00nan;0;0
10203;184738;144;50;22;4;18;.818;3600000;0
10203;197759;130;0;0;0;0;.00nan;0;0
10205;177156;142;22;27;6;21;.778;2254000;0
10205;183859;142;35;4;2;2;.500;1346000;0
10205;-1;132;100;46;2;44;.957;3600000;0
10205;196809;132;0;0;0;0;.00nan;0;0
10207;182395;131;0;0;0;0;.00nan;0;0
10207;-1;131;69;35;3;32;.914;3741000;0
10207;191574;141;74;34;2;32;.941;3741000;0
10207;197756;141;0;0;0;0;.00nan;0;0
10209;194393;1340;0;0;0;0;.00nan;0;0
10209;196445;140;0;0;0;0;.00nan;0;0
10209;196812;140;71;21;2;19;.905;3600000;0
10209;191571;1340;63;45;5;40;.889;3600000;0
10211;183934;128;33;30;6;24;.800;3600000;0
10211;-1;128;0;0;0;0;.00nan;0;0
10211;-1;143;97;38;1;37;.974;3600000;0
10211;191218;143;0;0;0;0;.00nan;0;0
10213;187632;134;0;0;0;0;.00nan;0;0
10213;187657;136;53;5;0;5;1.000;451000;0
10213;183730;134;60;22;3;19;.864;3600000;0
10213;-1;136;34;37;6;31;.838;3149000;0
10215;183870;138;0;0;0;0;.00nan;0;0
10215;202059;133;0;0;0;0;.00nan;0;0
10215;192499;133;63;33;4;29;.879;3900000;0
10215;-1;138;61;38;4;34;.895;3900000;0
10217;182339;139;0;0;0;0;.00nan;0;0
10217;183905;129;63;28;2;26;.929;3600000;0
10217;189264;129;0;0;0;0;.00nan;0;0
10217;178789;139;48;29;4;25;.862;3536000;0
10219;194393;1340;40;26;4;22;.846;2263000;0
10219;196445;140;82;26;1;25;.962;3600000;0
10219;196812;140;0;0;0;0;.00nan;0;0
10219;191571;1340;56;14;1;13;.929;1337000;0
10221;183904;137;0;0;0;0;.00nan;0;0
10221;-1;132;0;0;0;0;.00nan;0;0
10221;196809;132;38;32;5;27;.844;3600000;0
10221;-1;137;66;25;2;23;.920;3600000;0
10223;187578;135;0;0;0;0;.00nan;0;0
10223;183844;135;62;29;3;26;.897;3600000;0
10223;184049;130;0;0;0;0;.00nan;0;0
10223;197759;130;82;22;1;21;.955;3600000;0
10225;183870;138;31;34;6;28;.824;2942000;0
10225;191574;141;0;0;0;0;.00nan;0;0
10225;197756;141;44;12;2;10;.833;3600000;0
10225;-1;138;24;6;3;3;.500;658000;0
10227;182339;139;49;25;3;22;.880;3519000;0
10227;178789;139;0;0;0;0;.00nan;0;0
10227;202059;133;92;28;1;27;.964;3600000;0
10227;192499;133;0;0;0;0;.00nan;0;0
10229;177156;142;0;0;0;0;.00nan;0;0
10229;182395;131;55;37;4;33;.892;3566000;0
10229;183859;142;50;22;3;19;.864;3600000;0
10229;-1;131;0;0;0;0;.00nan;0;0
10231;187632;134;24;25;6;19;.760;3069000;0
10231;183730;134;44;4;1;3;.750;531000;0
10231;183934;128;0;0;0;0;.00nan;0;0
10231;-1;128;44;18;3;15;.833;3600000;0
10233;183905;129;0;0;0;0;.00nan;0;0
10233;189264;129;86;38;2;36;.947;3600000;0
10233;-1;143;0;0;0;0;.00nan;0;0
10233;191218;143;30;24;5;19;.792;3600000;0
10235;187657;136;64;27;2;25;.926;3600000;0
10235;189944;144;26;30;6;24;.800;2367000;0
10235;184738;144;70;22;1;21;.955;1233000;0
10235;-1;136;0;0;0;0;.00nan;0;0
10237;187578;135;98;43;2;41;.953;3589000;0
10237;187657;136;0;0;0;0;.00nan;0;0
10237;183844;135;0;0;0;0;.00nan;0;0
10237;-1;136;67;17;1;16;.941;3600000;0
10239;182395;131;0;0;0;0;.00nan;0;0
10239;187632;134;0;0;0;0;.00nan;0;0
10239;183730;134;54;19;2;17;.895;3579000;0
10239;-1;131;100;45;1;44;.978;3600000;0
10241;177156;142;0;0;0;0;.00nan;0;0
10241;183859;142;64;24;3;21;.875;3600000;0
10241;183904;137;59;37;4;33;.892;3545000;0
10241;-1;137;0;0;0;0;.00nan;0;0
10243;183870;138;0;0;0;0;.00nan;0;0
10243;196445;140;0;0;0;0;.00nan;0;0
10243;196812;140;58;26;3;23;.885;3600000;0
10243;-1;138;54;32;4;28;.875;3557000;0
10245;-1;132;51;24;3;21;.875;3788000;0
10245;196809;132;0;0;0;0;.00nan;0;0
10245;191574;141;90;44;2;42;.955;3788000;0
10245;197756;141;0;0;0;0;.00nan;0;0
10247;182339;139;44;44;7;37;.841;3600000;0
10247;184049;130;88;25;1;24;.960;3600000;0
10247;178789;139;0;0;0;0;.00nan;0;0
10247;197759;130;0;0;0;0;.00nan;0;0
10249;194393;1340;0;0;0;0;.00nan;0;0
10249;183934;128;0;0;0;0;.00nan;0;0
10249;-1;128;77;29;2;27;.931;3600000;0
10249;191571;1340;91;52;3;49;.942;3600000;0
10251;183905;129;72;43;4;39;.907;3544000;0
10251;189264;129;0;0;0;0;.00nan;0;0
10251;-1;143;53;24;3;21;.875;3600000;0
10251;191218;143;0;0;0;0;.00nan;0;0
10253;189944;144;0;0;0;0;.00nan;0;0
10253;184738;144;65;21;2;19;.905;3600000;0
10253;202059;133;0;0;0;0;.00nan;0;0
10253;192499;133;85;46;3;43;.935;3600000;0
10255;184049;130;0;0;0;0;.00nan;0;0
10255;202059;133;86;48;3;45;.938;3600000;0
10255;192499;133;0;0;0;0;.00nan;0;0
10255;197759;130;100;26;0;26;1.000;3600000;0
10257;187657;136;61;41;5;36;.878;3900000;0
10257;-1;143;0;0;0;0;.00nan;0;0
10257;191218;143;32;27;5;22;.815;3900000;0
10257;-1;136;0;0;0;0;.00nan;0;0
10259;182395;131;50;31;5;26;.839;3600000;0
10259;187632;134;85;29;1;28;.966;3600000;0
10259;183730;134;0;0;0;0;.00nan;0;0
10259;-1;131;0;0;0;0;.00nan;0;0
10261;187578;135;0;0;0;0;.00nan;0;0
10261;183844;135;71;36;4;32;.889;3600000;0
10261;183905;129;0;0;0;0;.00nan;0;0
10261;189264;129;94;19;0;19;1.000;3600000;0
10263;183870;138;37;32;6;26;.813;3600000;0
10263;-1;132;0;0;0;0;.00nan;0;0
10263;196809;132;72;26;3;23;.885;3600000;0
10263;-1;138;0;0;0;0;.00nan;0;0
10265;177156;142;49;13;2;11;.846;3600000;0
10265;194393;1340;71;38;4;34;.895;3600000;0
10265;183859;142;0;0;0;0;.00nan;0;0
10265;191571;1340;0;0;0;0;.00nan;0;0
10267;183904;137;73;30;3;27;.900;1329000;0
10267;-1;137;48;25;4;21;.840;2271000;0
10267;191574;141;0;0;0;0;.00nan;0;0
10267;197756;141;82;28;1;27;.964;3600000;0
10269;183934;128;54;14;2;12;.857;3600000;0
10269;189944;144;69;46;5;41;.891;3600000;0
10269;184738;144;0;0;0;0;.00nan;0;0
10269;-1;128;0;0;0;0;.00nan;0;0
10271;182339;139;0;0;0;0;.00nan;0;0
10271;178789;139;77;33;2;31;.939;3552000;0
10271;196445;140;73;16;1;15;.938;3600000;0
10271;196812;140;0;0;0;0;.00nan;0;0
1699;187657;136;0;0;0;0;.00nan;0;0
1699;194393;1340;0;0;0;0;.00nan;0;0
1699;-1;136;59;20;2;18;.900;3600000;0
1699;191571;1340;78;41;4;37;.902;3514000;0
1700;182339;139;0;0;0;0;.00nan;0;0
1700;184049;130;75;27;2;25;.926;3991000;0
1700;178789;139;100;45;1;44;.978;3991000;0
1700;197759;130;0;0;0;0;.00nan;0;0
1701;177156;142;0;0;0;0;.00nan;0;0
1701;183859;142;67;37;4;33;.892;4152000;0
1701;183870;138;0;0;0;0;.00nan;0;0
1701;-1;138;84;60;5;55;.917;4152000;0
1702;183904;137;100;69;3;66;.957;5975000;0
1702;183934;128;0;0;0;0;.00nan;0;0
1702;-1;128;57;41;4;37;.902;5985000;0
1702;-1;137;0;0;0;0;.00nan;0;0
1703;187632;134;0;0;0;0;.00nan;0;0
1703;183730;134;62;27;3;24;.889;3600000;0
1703;189944;144;49;36;6;30;.833;3571000;0
1703;184738;144;0;0;0;0;.00nan;0;0
1704;-1;132;93;54;3;51;.944;5858000;0
1704;196809;132;0;0;0;0;.00nan;0;0
1704;191574;141;74;58;4;54;.931;5858000;0
1704;197756;141;0;0;0;0;.00nan;0;0
1705;183905;129;33;30;6;24;.800;2715000;0
1705;189264;129;51;8;1;7;.875;885000;0
1705;-1;143;57;22;2;20;.909;3600000;0
1705;191218;143;0;0;0;0;.00nan;0;0
1706;196445;140;55;5;0;5;1.000;943000;0
1706;202059;133;0;0;0;0;.00nan;0;0
1706;196812;140;8;17;6;11;.647;2657000;0
1706;192499;133;100;26;0;26;1.000;3600000;0
1707;187657;136;0;0;0;0;.00nan;0;0
1707;194393;1340;0;0;0;0;.00nan;0;0
1707;-1;136;73;19;1;18;.947;3600000;0
1707;191571;1340;78;32;3;29;.906;3582000;0
1708;182339;139;71;30;3;27;.900;3048000;0
1708;184049;130;75;30;2;28;.933;3600000;0
1708;178789;139;34;11;3;8;.727;552000;0
1708;197759;130;0;0;0;0;.00nan;0;0
1709;177156;142;0;0;0;0;.00nan;0;0
1709;183859;142;80;46;5;41;.891;3941000;0
1709;183870;138;0;0;0;0;.00nan;0;0
1709;-1;138;49;38;6;32;.842;3941000;0
1710;183904;137;27;26;7;19;.731;2521000;0
1710;183934;128;0;0;0;0;.00nan;0;0
1710;-1;128;80;15;0;15;1.000;3600000;0
1710;-1;137;28;14;4;10;.714;1079000;0
1711;187632;134;0;0;0;0;.00nan;0;0
1711;183730;134;59;26;3;23;.885;3600000;0
1711;189944;144;100;42;0;42;1.000;3600000;0
1711;184738;144;0;0;0;0;.00nan;0;0
1712;-1;132;77;30;2;28;.933;3600000;0
1712;196809;132;0;0;0;0;.00nan;0;0
1712;191574;141;50;27;4;23;.852;3563000;0
1712;197756;141;0;0;0;0;.00nan;0;0
1713;183905;129;39;33;6;27;.818;3279000;0
1713;189264;129;51;2;0;2;1.000;321000;0
1713;-1;143;81;26;1;25;.962;3600000;0
1713;191218;143;0;0;0;0;.00nan;0;0
1714;196445;140;0;0;0;0;.00nan;0;0
1714;202059;133;0;0;0;0;.00nan;0;0
1714;196812;140;57;38;4;34;.895;3600000;0
1714;192499;133;100;36;1;35;.972;3600000;0
1715;187657;136;0;0;0;0;.00nan;0;0
1715;194393;1340;51;2;0;2;1.000;627000;0
1715;-1;136;66;33;3;30;.909;3600000;0
1715;191571;1340;45;37;6;31;.838;2973000;0
1716;182339;139;0;0;0;0;.00nan;0;0
1716;184049;130;66;15;1;14;.933;3600000;0
1716;178789;139;80;43;4;39;.907;3600000;0
1716;197759;130;0;0;0;0;.00nan;0;0
1717;177156;142;0;0;0;0;.00nan;0;0
1717;183859;142;74;24;1;23;.958;3600000;0
1717;183870;138;0;0;0;0;.00nan;0;0
1717;-1;138;90;38;3;35;.921;3515000;0
1718;183904;137;35;32;6;26;.813;2830000;0
1718;183934;128;0;0;0;0;.00nan;0;0
1718;-1;128;38;27;5;22;.815;3600000;0
1718;-1;137;37;7;2;5;.714;770000;0
1719;187632;134;0;0;0;0;.00nan;0;0
1719;183730;134;82;22;1;21;.955;3600000;0
1719;189944;144;68;35;4;31;.886;3600000;0
1719;184738;144;0;0;0;0;.00nan;0;0
1720;-1;132;79;38;3;35;.921;3551000;0
1720;196809;132;0;0;0;0;.00nan;0;0
1720;191574;141;89;35;2;33;.943;3600000;0
1720;197756;141;0;0;0;0;.00nan;0;0
1721;183905;129;84;37;3;34;.919;3536000;0
1721;189264;129;0;0;0;0;.00nan;0;0
1721;-1;143;71;21;1;20;.952;3600000;0
1721;191218;143;0;0;0;0;.00nan;0;0
1722;196445;140;0;0;0;0;.00nan;0;0
1722;202059;133;0;0;0;0;.00nan;0;0
1722;196812;140;71;35;4;31;.886;3934000;0
1722;192499;133;43;29;5;24;.828;3934000;0
1723;187657;136;0;0;0;0;.00nan;0;0
1723;194393;1340;0;0;0;0;.00nan;0;0
1723;-1;136;74;22;1;21;.955;3600000;0
1723;191571;1340;85;52;4;48;.923;3600000;0
1724;182339;139;0;0;0;0;.00nan;0;0
1724;184049;130;48;24;4;20;.833;3619000;0
1724;178789;139;49;30;5;25;.833;3619000;0
1724;197759;130;0;0;0;0;.00nan;0;0
1725;177156;142;0;0;0;0;.00nan;0;0
1725;183859;142;62;21;2;19;.905;3600000;0
1725;183870;138;0;0;0;0;.00nan;0;0
1725;-1;138;67;43;5;38;.884;3600000;0
1726;183904;137;76;33;2;31;.939;3600000;0
1726;183934;128;0;0;0;0;.00nan;0;0
1726;-1;128;65;24;3;21;.875;3600000;0
1726;-1;137;0;0;0;0;.00nan;0;0
1727;187632;134;0;0;0;0;.00nan;0;0
1727;183730;134;60;19;2;17;.895;3600000;0
1727;189944;144;38;31;6;25;.806;3600000;0
1727;184738;144;0;0;0;0;.00nan;0;0
1728;-1;132;80;40;3;37;.925;3581000;0
1728;196809;132;0;0;0;0;.00nan;0;0
1728;191574;141;68;23;2;21;.913;3600000;0
1728;197756;141;0;0;0;0;.00nan;0;0
1729;183905;129;54;25;3;22;.880;3562000;0
1729;189264;129;0;0;0;0;.00nan;0;0
1729;-1;143;78;33;2;31;.939;3600000;0
1729;191218;143;0;0;0;0;.00nan;0;0
1730;196445;140;51;4;0;4;1.000;715000;0
1730;202059;133;0;0;0;0;.00nan;0;0
1730;196812;140;15;24;7;17;.708;2885000;0
1730;192499;133;29;23;5;18;.783;3600000;0
1928;182339;139;65;24;2;22;.917;1207000;0
1928;184049;130;100;20;0;20;1.000;3600000;0
1928;178789;139;31;27;6;21;.778;2393000;0
1928;197759;130;0;0;0;0;.00nan;0;0
1929;183904;137;95;50;3;47;.940;3600000;0
1929;183934;128;0;0;0;0;.00nan;0;0
1929;-1;128;45;26;4;22;.846;3578000;0
1929;-1;137;0;0;0;0;.00nan;0;0
1930;187632;134;0;0;0;0;.00nan;0;0
1930;183730;134;59;18;2;16;.889;3600000;0
1930;189944;144;55;45;6;39;.867;3600000;0
1930;184738;144;0;0;0;0;.00nan;0;0
1931;-1;132;69;30;3;27;.900;3600000;0
1931;196809;132;0;0;0;0;.00nan;0;0
1931;191574;141;18;28;7;21;.750;3288000;0
1931;197756;141;34;5;2;3;.600;312000;0
1932;196445;140;62;43;5;38;.884;4934000;0
1932;202059;133;50;15;1;14;.933;1865000;0
1932;196812;140;0;0;0;0;.00nan;0;0
1932;192499;133;43;26;5;21;.808;3069000;0
1989;183904;137;87;47;3;44;.936;5677000;0
1989;183934;128;0;0;0;0;.00nan;0;0
1989;-1;128;68;61;4;57;.934;5677000;0
1989;-1;137;0;0;0;0;.00nan;0;0
1990;-1;132;72;37;4;33;.892;3600000;0
1990;196809;132;0;0;0;0;.00nan;0;0
1990;191574;141;51;30;5;25;.833;3563000;0
1990;197756;141;0;0;0;0;.00nan;0;0
1991;196445;140;69;37;3;34;.919;3573000;0
1991;202059;133;88;27;2;25;.926;3600000;0
1991;196812;140;0;0;0;0;.00nan;0;0
1991;192499;133;0;0;0;0;.00nan;0;0
2028;187657;136;0;0;0;0;.00nan;0;0
2028;183904;137;78;50;5;45;.900;3600000;0
2028;-1;136;56;18;2;16;.889;3600000;0
2028;-1;137;0;0;0;0;.00nan;0;0
2029;177156;142;0;0;0;0;.00nan;0;0
2029;183859;142;54;32;4;28;.875;3600000;0
2029;202059;133;43;41;7;34;.829;3600000;0
2029;192499;133;0;0;0;0;.00nan;0;0
2030;187632;134;0;0;0;0;.00nan;0;0
2030;183730;134;60;28;3;25;.893;3600000;0
2030;-1;143;57;40;5;35;.875;3523000;0
2030;191218;143;0;0;0;0;.00nan;0;0
2031;184049;130;42;31;5;26;.839;3600000;0
2031;-1;132;100;45;2;43;.956;3600000;0
2031;196809;132;0;0;0;0;.00nan;0;0
2031;197759;130;0;0;0;0;.00nan;0;0
2032;187657;136;0;0;0;0;.00nan;0;0
2032;183904;137;76;32;2;30;.938;3588000;0
2032;-1;136;72;22;1;21;.955;3600000;0
2032;-1;137;0;0;0;0;.00nan;0;0
2033;177156;142;0;0;0;0;.00nan;0;0
2033;183859;142;100;36;1;35;.972;3600000;0
2033;202059;133;64;25;4;21;.840;3600000;0
2033;192499;133;0;0;0;0;.00nan;0;0
2034;187632;134;0;0;0;0;.00nan;0;0
2034;183730;134;57;28;3;25;.893;4230000;0
2034;-1;143;73;37;4;33;.892;4230000;0
2034;191218;143;0;0;0;0;.00nan;0;0
2035;184049;130;100;29;0;29;1.000;3600000;0
2035;-1;132;46;46;7;39;.848;3600000;0
2035;196809;132;0;0;0;0;.00nan;0;0
2035;197759;130;0;0;0;0;.00nan;0;0
2036;187657;136;0;0;0;0;.00nan;0;0
2036;183904;137;38;34;6;28;.824;2914000;0
2036;-1;136;35;17;4;13;.765;3600000;0
2036;-1;137;47;7;1;6;.857;686000;0
2037;177156;142;0;0;0;0;.00nan;0;0
2037;183859;142;60;38;4;34;.895;3600000;0
2037;202059;133;47;13;2;11;.846;3600000;0
2037;192499;133;0;0;0;0;.00nan;0;0
2038;187632;134;0;0;0;0;.00nan;0;0
2038;183730;134;82;31;2;29;.935;3600000;0
2038;-1;143;38;21;4;17;.810;3524000;0
2038;191218;143;0;0;0;0;.00nan;0;0
2039;184049;130;24;19;5;14;.737;3586000;0
2039;-1;132;76;43;4;39;.907;3600000;0
2039;196809;132;0;0;0;0;.00nan;0;0
2039;197759;130;0;0;0;0;.00nan;0;0
2040;187657;136;0;0;0;0;.00nan;0;0
2040;183904;137;56;44;6;38;.864;3600000;0
2040;-1;136;48;18;3;15;.833;3600000;0
2040;-1;137;0;0;0;0;.00nan;0;0
2041;177156;142;0;0;0;0;.00nan;0;0
2041;183859;142;96;20;0;20;1.000;3600000;0
2041;202059;133;0;0;0;0;.00nan;0;0
2041;192499;133;92;43;2;41;.953;3538000;0
2042;187632;134;59;15;1;14;.933;1397000;0
2042;183730;134;26;28;6;22;.786;2203000;0
2042;-1;143;39;16;3;13;.813;3600000;0
2042;191218;143;0;0;0;0;.00nan;0;0
2043;184049;130;57;24;3;21;.875;3530000;0
2043;-1;132;91;41;2;39;.951;3600000;0
2043;196809;132;0;0;0;0;.00nan;0;0
2043;197759;130;0;0;0;0;.00nan;0;0
2264;177156;142;0;0;0;0;.00nan;0;0
2264;183859;142;65;25;3;22;.880;3513000;0
2264;202059;133;0;0;0;0;.00nan;0;0
2264;192499;133;100;36;1;35;.972;3600000;0
2265;187632;134;0;0;0;0;.00nan;0;0
2265;183730;134;84;29;2;27;.931;3600000;0
2265;-1;143;26;31;6;25;.806;3600000;0
2265;191218;143;0;0;0;0;.00nan;0;0
2266;184049;130;74;22;1;21;.955;3600000;0
2266;-1;132;68;38;5;33;.868;3600000;0
2266;196809;132;0;0;0;0;.00nan;0;0
2266;197759;130;0;0;0;0;.00nan;0;0
2308;177156;142;0;0;0;0;.00nan;0;0
2308;183859;142;50;34;5;29;.853;3600000;0
2308;202059;133;0;0;0;0;.00nan;0;0
2308;192499;133;72;30;2;28;.933;3600000;0
2309;184049;130;62;26;3;23;.885;3553000;0
2309;-1;132;89;32;2;30;.938;3600000;0
2309;196809;132;0;0;0;0;.00nan;0;0
2309;197759;130;0;0;0;0;.00nan;0;0
2388;177156;142;0;0;0;0;.00nan;0;0
2388;183859;142;73;24;3;21;.875;3600000;0
2388;202059;133;0;0;0;0;.00nan;0;0
2388;192499;133;100;27;0;27;1.000;3600000;0
29;187657;136;0;0;0;0;.00nan;0;0
29;-1;132;29;23;6;17;.739;2149000;0
29;196809;132;46;12;2;10;.833;1451000;0
29;-1;136;65;32;3;29;.906;3600000;0
30;187632;134;0;0;0;0;.00nan;0;0
30;183730;134;72;20;1;19;.950;3600000;0
30;202059;133;0;0;0;0;.00nan;0;0
30;192499;133;32;29;6;23;.793;3600000;0
31;187657;136;0;0;0;0;.00nan;0;0
31;-1;132;59;39;4;35;.897;3600000;0
31;196809;132;0;0;0;0;.00nan;0;0
31;-1;136;30;34;7;27;.794;3600000;0
32;187632;134;0;0;0;0;.00nan;0;0
32;183730;134;89;35;2;33;.943;3600000;0
32;202059;133;0;0;0;0;.00nan;0;0
32;192499;133;64;30;3;27;.900;3567000;0
33;187657;136;0;0;0;0;.00nan;0;0
33;-1;132;64;27;2;25;.926;3600000;0
33;196809;132;0;0;0;0;.00nan;0;0
33;-1;136;78;33;3;30;.909;3544000;0
34;187632;134;0;0;0;0;.00nan;0;0
34;183730;134;31;24;5;19;.792;3600000;0
34;202059;133;0;0;0;0;.00nan;0;0
34;192499;133;79;28;2;26;.929;3600000;0
35;187657;136;0;0;0;0;.00nan;0;0
35;-1;132;10;37;9;28;.757;3600000;0
35;196809;132;0;0;0;0;.00nan;0;0
35;-1;136;89;30;2;28;.933;3600000;0
36;187632;134;0;0;0;0;.00nan;0;0
36;183730;134;80;26;1;25;.962;3600000;0
36;202059;133;0;0;0;0;.00nan;0;0
36;192499;133;79;34;2;32;.941;3600000;0
186;187657;136;0;0;0;0;.00nan;0;0
186;-1;132;39;34;6;28;.824;3600000;0
186;196809;132;0;0;0;0;.00nan;0;0
186;-1;136;81;24;1;23;.958;3600000;0
187;187632;134;0;0;0;0;.00nan;0;0
187;183730;134;41;24;5;19;.792;3600000;0
187;202059;133;58;5;0;5;1.000;575000;0
187;192499;133;20;22;6;16;.727;3002000;0
204;187657;136;0;0;0;0;.00nan;0;0
204;-1;132;54;32;5;27;.844;3600000;0
204;196809;132;0;0;0;0;.00nan;0;0
204;-1;136;86;35;2;33;.943;3600000;0
212;187632;134;0;0;0;0;.00nan;0;0
212;187657;136;0;0;0;0;.00nan;0;0
212;183730;134;62;21;2;19;.905;3600000;0
212;-1;136;79;49;5;44;.898;3600000;0
213;187632;134;0;0;0;0;.00nan;0;0
213;187657;136;0;0;0;0;.00nan;0;0
213;183730;134;49;35;5;30;.857;3533000;0
213;-1;136;82;36;3;33;.917;3600000;0
214;187632;134;0;0;0;0;.00nan;0;0
214;187657;136;0;0;0;0;.00nan;0;0
214;183730;134;44;19;3;16;.842;3623000;0
214;-1;136;78;40;4;36;.900;3586000;0
215;187632;134;0;0;0;0;.00nan;0;0
215;187657;136;0;0;0;0;.00nan;0;0
215;183730;134;86;34;2;32;.941;4258000;0
215;-1;136;97;37;1;36;.973;4258000;0
368;187632;134;0;0;0;0;.00nan;0;0
368;187657;136;0;0;0;0;.00nan;0;0
368;183730;134;85;34;2;32;.941;3600000;0
368;-1;136;68;36;3;33;.917;3600000;0
371;187632;134;0;0;0;0;.00nan;0;0
371;187657;136;0;0;0;0;.00nan;0;0
371;183730;134;98;57;1;56;.982;5049000;0
371;-1;136;69;32;2;30;.938;5049000;0
10291;171835;4960;30;15;4;11;.733;1059000;0
10291;187660;4960;63;15;1;14;.933;2541000;0
10291;184610;222;0;0;0;0;.00nan;0;0
10291;-1;222;55;37;6;31;.838;3557000;0
10311;170141;200;0;0;0;0;.00nan;0;0
10311;175370;199;0;0;0;0;.00nan;0;0
10311;187295;200;84;60;5;55;.917;3600000;0
10311;161006;199;74;20;1;19;.950;3600000;0
10327;-1;221;87;34;1;33;.971;3900000;0
10327;175436;229;0;0;0;0;.00nan;0;0
10327;176860;229;80;21;1;20;.952;3900000;0
10327;187362;221;0;0;0;0;.00nan;0;0
10312;183860;4959;0;0;0;0;.00nan;0;0
10312;170114;4959;77;26;2;24;.923;3900000;0
10312;171660;209;66;27;2;25;.926;3900000;0
10312;186205;209;0;0;0;0;.00nan;0;0
10306;166762;213;0;0;0;0;.00nan;0;0
10306;-1;4949;81;20;1;19;.950;3600000;0
10306;168912;4949;0;0;0;0;.00nan;0;0
10306;180575;213;84;34;2;32;.941;3567000;0
10297;166545;193;57;18;3;15;.833;3746000;0
10297;173770;193;0;0;0;0;.00nan;0;0
10297;170351;194;89;45;2;43;.956;3746000;0
10297;-1;194;0;0;0;0;.00nan;0;0
10293;166695;218;0;0;0;0;.00nan;0;0
10293;-1;218;55;33;4;29;.879;3575000;0
10293;179679;212;67;24;2;22;.917;3600000;0
10293;186641;212;0;0;0;0;.00nan;0;0
10296;173916;230;0;0;0;0;.00nan;0;0
10296;175423;223;0;0;0;0;.00nan;0;0
10296;-1;223;89;42;2;40;.952;3568000;0
10296;186495;230;100;21;0;21;1.000;3600000;0
10295;-1;203;0;0;0;0;.00nan;0;0
10295;-1;207;68;55;6;49;.891;3600000;0
10295;191078;203;45;17;3;14;.824;3600000;0
10295;-1;207;0;0;0;0;.00nan;0;0
10329;187628;191;84;16;0;16;1.000;3600000;0
10329;169096;190;65;53;6;47;.887;3600000;0
10329;184788;190;0;0;0;0;.00nan;0;0
10329;185960;191;0;0;0;0;.00nan;0;0
10333;189081;187;0;0;0;0;.00nan;0;0
10333;-1;196;0;0;0;0;.00nan;0;0
10333;184648;196;72;45;4;41;.911;3564000;0
10333;-1;187;62;21;2;19;.905;3600000;0
10372;-1;211;25;6;3;3;.500;467000;0
10372;175723;180;0;0;0;0;.00nan;0;0
10372;179646;211;39;22;4;18;.818;3133000;0
10372;176938;180;71;25;2;23;.920;3600000;0
10438;168954;228;98;43;1;42;.977;3900000;0
10438;170144;227;73;28;1;27;.964;3900000;0
10438;170300;228;0;0;0;0;.00nan;0;0
10438;-1;227;0;0;0;0;.00nan;0;0
10440;-1;210;0;0;0;0;.00nan;0;0
10440;180762;1505;71;25;2;23;.920;3549000;0
10440;186549;1505;0;0;0;0;.00nan;0;0
10440;192461;210;64;15;1;14;.933;3600000;0
11589;171970;217;63;31;3;28;.903;3600000;0
11589;171654;217;0;0;0;0;.00nan;0;0
11589;176770;219;67;27;2;25;.926;3600000;0
11589;181102;219;0;0;0;0;.00nan;0;0
10359;189885;225;69;32;3;29;.906;3900000;0
10359;179406;232;90;45;3;42;.933;3900000;0
10359;179434;232;0;0;0;0;.00nan;0;0
10359;184785;225;0;0;0;0;.00nan;0;0
10335;-1;1371;0;0;0;0;.00nan;0;0
10335;190125;184;0;0;0;0;.00nan;0;0
10335;179668;184;80;22;1;21;.955;3549000;0
10335;192688;1371;100;30;0;30;1.000;3600000;0
10351;-1;197;91;35;1;34;.971;3600000;0
10351;170189;197;0;0;0;0;.00nan;0;0
10351;174153;188;0;0;0;0;.00nan;0;0
10351;-1;188;64;34;3;31;.912;3532000;0
10339;177248;201;49;31;5;26;.839;3600000;0
10339;169166;226;58;19;2;17;.895;3600000;0
10339;185743;201;0;0;0;0;.00nan;0;0
10339;192629;226;0;0;0;0;.00nan;0;0
10694;170963;185;82;27;1;26;.963;3547000;0
10694;171730;220;0;0;0;0;.00nan;0;0
10694;180110;185;0;0;0;0;.00nan;0;0
10694;187443;220;100;38;0;38;1.000;3600000;0
10272;174209;178;0;0;0;0;.00nan;0;0
10272;175328;183;0;0;0;0;.00nan;0;0
10272;176963;178;100;51;2;49;.961;3900000;0
10272;182089;183;84;44;2;42;.955;3900000;0
10276;168117;192;59;19;3;16;.842;3600000;0
10276;168966;189;0;0;0;0;.00nan;0;0
10276;175900;192;0;0;0;0;.00nan;0;0
10276;176915;189;69;45;5;40;.889;3574000;0
10280;171819;177;0;0;0;0;.00nan;0;0
10280;170076;179;0;0;0;0;.00nan;0;0
10280;174147;179;65;26;3;23;.885;3600000;0
10280;179602;177;67;39;4;35;.897;3600000;0
10287;182454;4864;87;38;3;35;.921;3600000;0
10287;183737;4864;0;0;0;0;.00nan;0;0
10287;171405;2620;0;0;0;0;.00nan;0;0
10287;176921;2620;53;45;6;39;.867;3600000;0
10282;167404;215;62;37;4;33;.892;3611000;0
10282;168907;186;0;0;0;0;.00nan;0;0
10282;169226;186;42;29;5;24;.828;3634000;0
10282;161046;215;0;0;0;0;.00nan;0;0
10289;168995;205;85;56;5;51;.911;3600000;0
10289;174334;208;18;23;6;17;.739;3562000;0
10289;179702;208;0;0;0;0;.00nan;0;0
10289;-1;205;0;0;0;0;.00nan;0;0
10278;171615;181;78;32;2;30;.938;3600000;0
10278;175842;214;0;0;0;0;.00nan;0;0
10278;-1;181;0;0;0;0;.00nan;0;0
10278;-1;214;47;24;4;20;.833;3569000;0
10307;173340;231;0;0;0;0;.00nan;0;0
10307;173916;230;0;0;0;0;.00nan;0;0
10307;185034;231;55;20;2;18;.900;3600000;0
10307;186495;230;73;53;5;48;.906;3600000;0
10308;168907;186;0;0;0;0;.00nan;0;0
10308;169226;186;71;42;4;38;.905;3900000;0
10308;179679;212;0;0;0;0;.00nan;0;0
10308;186641;212;59;35;4;31;.886;3900000;0
10277;168995;205;20;17;5;12;.706;2400000;0
10277;175364;206;58;34;4;30;.882;3600000;0
10277;175371;206;0;0;0;0;.00nan;0;0
10277;-1;205;28;14;4;10;.714;1200000;0
10274;166762;213;74;49;4;45;.918;3600000;0
10274;175328;183;0;0;0;0;.00nan;0;0
10274;180575;213;0;0;0;0;.00nan;0;0
10274;182089;183;50;33;5;28;.848;3545000;0
10320;171819;177;0;0;0;0;.00nan;0;0
10320;174209;178;0;0;0;0;.00nan;0;0
10320;179602;177;79;26;2;24;.923;3598000;0
10320;176963;178;100;37;1;36;.973;3600000;0
10316;-1;197;62;42;5;37;.881;3600000;0
10316;170189;197;0;0;0;0;.00nan;0;0
10316;170351;194;78;27;1;26;.963;3600000;0
10316;-1;194;0;0;0;0;.00nan;0;0
10305;-1;203;62;28;3;25;.893;3530000;0
10305;-1;203;0;0;0;0;.00nan;0;0
10305;182049;204;99;39;1;38;.974;3600000;0
10305;141765;204;0;0;0;0;.00nan;0;0
10405;170144;227;83;12;0;12;1.000;3600000;0
10405;-1;227;0;0;0;0;.00nan;0;0
10405;189885;225;50;39;6;33;.846;2498000;0
10405;184785;225;50;21;2;19;.905;1102000;0
10301;168117;192;43;22;4;18;.818;3600000;0
10301;170202;195;0;0;0;0;.00nan;0;0
10301;175900;192;0;0;0;0;.00nan;0;0
10301;176200;195;81;49;5;44;.898;3584000;0
11674;-1;221;0;0;0;0;.00nan;0;0
11674;179406;232;52;41;6;35;.854;3545000;0
11674;179434;232;0;0;0;0;.00nan;0;0
11674;187362;221;57;32;4;28;.875;3600000;0
10361;170076;179;74;33;3;30;.909;3600000;0
10361;174147;179;0;0;0;0;.00nan;0;0
10361;187232;216;0;0;0;0;.00nan;0;0
10361;187240;216;51;31;4;27;.871;3566000;0
10382;173900;182;0;0;0;0;.00nan;0;0
10382;190125;184;70;31;2;29;.935;3900000;0
10382;179668;184;0;0;0;0;.00nan;0;0
10382;182116;182;69;28;2;26;.929;3900000;0
10388;175723;180;0;0;0;0;.00nan;0;0
10388;176770;219;58;24;3;21;.875;3600000;0
10388;176938;180;53;36;6;30;.833;3600000;0
10388;181102;219;0;0;0;0;.00nan;0;0
10340;170141;200;0;0;0;0;.00nan;0;0
10340;-1;207;80;23;1;22;.957;3600000;0
10340;187295;200;87;36;2;34;.944;3592000;0
10340;-1;207;0;0;0;0;.00nan;0;0
10338;183860;4959;0;0;0;0;.00nan;0;0
10338;170114;4959;63;38;4;34;.895;3819000;0
10338;171660;209;48;34;5;29;.853;3808000;0
10338;186205;209;0;0;0;0;.00nan;0;0
10324;182454;4864;0;0;0;0;.00nan;0;0
10324;183737;4864;89;27;1;26;.963;3600000;0
10324;166451;176;0;0;0;0;.00nan;0;0
10324;171662;176;86;33;2;31;.939;3600000;0
10319;168954;228;70;29;2;27;.931;3552000;0
10319;170300;228;0;0;0;0;.00nan;0;0
10319;175423;223;94;23;0;23;1.000;3600000;0
10319;-1;223;0;0;0;0;.00nan;0;0
10326;184610;222;53;17;2;15;.882;3600000;0
10326;175436;229;0;0;0;0;.00nan;0;0
10326;176860;229;87;49;3;46;.939;3569000;0
10326;-1;222;0;0;0;0;.00nan;0;0
10423;177248;201;0;0;0;0;.00nan;0;0
10423;182049;204;63;29;3;26;.897;3600000;0
10423;185743;201;80;27;2;25;.926;3600000;0
10423;141765;204;0;0;0;0;.00nan;0;0
10341;173823;198;52;18;3;15;.833;3900000;0
10341;174153;188;97;39;0;39;1.000;3401000;0
10341;-1;188;26;6;3;3;.500;499000;0
10341;181431;198;0;0;0;0;.00nan;0;0
10285;168966;189;0;0;0;0;.00nan;0;0
10285;-1;196;0;0;0;0;.00nan;0;0
10285;184648;196;71;33;2;31;.939;3582000;0
10285;176915;189;89;20;0;20;1.000;3600000;0
10310;166695;218;0;0;0;0;.00nan;0;0
10310;171970;217;59;38;4;34;.895;3600000;0
10310;171654;217;0;0;0;0;.00nan;0;0
10310;-1;218;91;30;1;29;.967;3600000;0
10411;187628;191;0;0;0;0;.00nan;0;0
10411;189081;187;0;0;0;0;.00nan;0;0
10411;-1;187;69;41;4;37;.902;3600000;0
10411;185960;191;71;33;3;30;.909;3600000;0
10275;171615;181;62;37;4;33;.892;3569000;0
10275;-1;1371;0;0;0;0;.00nan;0;0
10275;-1;181;0;0;0;0;.00nan;0;0
10275;192688;1371;93;50;3;47;.940;3600000;0
10288;173340;231;100;25;0;25;1.000;3600000;0
10288;184175;224;63;45;5;40;.889;3600000;0
10288;-1;224;0;0;0;0;.00nan;0;0
10288;185034;231;0;0;0;0;.00nan;0;0
10407;167404;215;0;0;0;0;.00nan;0;0
10407;-1;211;100;36;0;36;1.000;3600000;0
10407;179646;211;0;0;0;0;.00nan;0;0
10407;161046;215;78;29;2;27;.931;3530000;0
10303;173900;182;0;0;0;0;.00nan;0;0
10303;175842;214;0;0;0;0;.00nan;0;0
10303;182116;182;96;38;2;36;.947;3888000;0
10303;-1;214;62;32;3;29;.906;3888000;0
10315;175364;206;51;35;5;30;.857;3600000;0
10315;175370;199;84;25;1;24;.960;3600000;0
10315;175371;206;0;0;0;0;.00nan;0;0
10315;161006;199;0;0;0;0;.00nan;0;0
10394;169166;226;61;16;1;15;.938;3600000;0
10394;-1;202;98;45;2;43;.956;3585000;0
10394;180623;202;0;0;0;0;.00nan;0;0
10394;192629;226;0;0;0;0;.00nan;0;0
11127;-1;4949;68;34;3;31;.912;3600000;0
11127;168912;4949;0;0;0;0;.00nan;0;0
11127;-1;210;0;0;0;0;.00nan;0;0
11127;192461;210;68;36;4;32;.889;3600000;0
10932;170963;185;54;16;2;14;.875;3600000;0
10932;171730;220;81;52;3;49;.942;3550000;0
10932;180110;185;0;0;0;0;.00nan;0;0
10932;187443;220;0;0;0;0;.00nan;0;0
10343;-1;197;66;48;5;43;.896;3600000;0
10343;173823;198;61;9;1;8;.889;3600000;0
10343;170189;197;0;0;0;0;.00nan;0;0
10343;181431;198;0;0;0;0;.00nan;0;0
10354;180762;1505;56;41;5;36;.878;3550000;0
10354;186549;1505;0;0;0;0;.00nan;0;0
10354;187232;216;0;0;0;0;.00nan;0;0
10354;187240;216;30;17;4;13;.765;3600000;0
10746;177248;201;0;0;0;0;.00nan;0;0
10746;175370;199;50;17;3;14;.824;3600000;0
10746;185743;201;53;54;7;47;.870;3600000;0
10746;161006;199;0;0;0;0;.00nan;0;0
11586;168117;192;0;0;0;0;.00nan;0;0
11586;170351;194;69;47;4;43;.915;3600000;0
11586;-1;194;0;0;0;0;.00nan;0;0
11586;175900;192;54;11;1;10;.909;3600000;0
10702;170144;227;35;23;5;18;.783;3600000;0
10702;-1;227;0;0;0;0;.00nan;0;0
10702;179406;232;88;56;3;53;.946;3600000;0
10702;179434;232;0;0;0;0;.00nan;0;0
10381;187628;191;0;0;0;0;.00nan;0;0
10381;168966;189;0;0;0;0;.00nan;0;0
10381;176915;189;66;53;6;47;.887;3600000;0
10381;185960;191;41;15;3;12;.800;3600000;0
10348;168954;228;50;2;0;2;1.000;671000;0
10348;170300;228;36;29;6;23;.793;2929000;0
10348;175436;229;91;43;3;40;.930;3600000;0
10348;176860;229;0;0;0;0;.00nan;0;0
11623;174209;178;0;0;0;0;.00nan;0;0
11623;-1;210;64;21;3;18;.857;3900000;0
11623;176963;178;84;44;3;41;.932;3853000;0
11623;192461;210;0;0;0;0;.00nan;0;0
10360;170202;195;0;0;0;0;.00nan;0;0
10360;-1;196;69;48;5;43;.896;3872000;0
10360;184648;196;0;0;0;0;.00nan;0;0
10360;176200;195;27;17;4;13;.765;3872000;0
10273;184175;224;50;14;3;11;.786;3892000;0
10273;-1;224;0;0;0;0;.00nan;0;0
10273;175423;223;97;49;3;46;.939;3900000;0
10273;-1;223;0;0;0;0;.00nan;0;0
10345;166451;176;92;37;2;35;.946;3600000;0
10345;183860;4959;73;32;3;29;.906;3544000;0
10345;170114;4959;0;0;0;0;.00nan;0;0
10345;171662;176;0;0;0;0;.00nan;0;0
10356;167404;215;0;0;0;0;.00nan;0;0
10356;168907;186;70;29;2;27;.931;3600000;0
10356;169226;186;0;0;0;0;.00nan;0;0
10356;161046;215;77;39;3;36;.923;3546000;0
10281;-1;203;0;0;0;0;.00nan;0;0
10281;174334;208;99;27;0;27;1.000;3600000;0
10281;179702;208;0;0;0;0;.00nan;0;0
10281;-1;203;73;39;3;36;.923;3600000;0
10314;166695;218;0;0;0;0;.00nan;0;0
10314;-1;218;62;43;5;38;.884;3600000;0
10314;176770;219;63;24;2;22;.917;3600000;0
10314;181102;219;0;0;0;0;.00nan;0;0
10317;171835;4960;26;19;5;14;.737;3600000;0
10317;187660;4960;0;0;0;0;.00nan;0;0
10317;173916;230;0;0;0;0;.00nan;0;0
10317;186495;230;100;45;1;44;.978;3600000;0
10417;166545;193;0;0;0;0;.00nan;0;0
10417;169096;190;56;36;4;32;.889;3657000;0
10417;173770;193;54;21;3;18;.857;3657000;0
10417;184788;190;0;0;0;0;.00nan;0;0
10300;171615;181;0;0;0;0;.00nan;0;0
10300;190125;184;68;38;3;35;.921;3850000;0
10300;179668;184;0;0;0;0;.00nan;0;0
10300;-1;181;74;33;2;31;.939;3850000;0
10304;168995;205;90;29;1;28;.966;3600000;0
10304;-1;202;78;38;2;36;.947;3550000;0
10304;180623;202;0;0;0;0;.00nan;0;0
10304;-1;205;0;0;0;0;.00nan;0;0
10322;166762;213;95;30;1;29;.967;3900000;0
10322;175328;183;97;36;1;35;.972;3900000;0
10322;180575;213;0;0;0;0;.00nan;0;0
10322;182089;183;0;0;0;0;.00nan;0;0
10279;171970;217;0;0;0;0;.00nan;0;0
10279;-1;211;86;30;1;29;.967;3600000;0
10279;171654;217;84;42;4;38;.905;3600000;0
10279;179646;211;0;0;0;0;.00nan;0;0
10366;171405;2620;0;0;0;0;.00nan;0;0
10366;171660;209;0;0;0;0;.00nan;0;0
10366;176921;2620;86;34;2;32;.941;3600000;0
10366;186205;209;50;36;5;31;.861;3600000;0
10283;-1;221;81;33;1;32;.970;3600000;0
10283;184610;222;0;0;0;0;.00nan;0;0
10283;-1;222;54;39;4;35;.897;3600000;0
10283;187362;221;0;0;0;0;.00nan;0;0
10429;171835;4960;72;18;1;17;.944;3600000;0
10429;187660;4960;0;0;0;0;.00nan;0;0
10429;189885;225;77;44;3;41;.932;3570000;0
10429;184785;225;0;0;0;0;.00nan;0;0
10437;173900;182;0;0;0;0;.00nan;0;0
10437;171730;220;48;21;3;18;.857;3600000;0
10437;182116;182;71;43;4;39;.907;3551000;0
10437;187443;220;0;0;0;0;.00nan;0;0
10416;-1;4949;0;0;0;0;.00nan;0;0
10416;168912;4949;90;35;1;34;.971;3900000;0
10416;187232;216;92;33;1;32;.970;3900000;0
10416;187240;216;0;0;0;0;.00nan;0;0
10286;171819;177;0;0;0;0;.00nan;0;0
10286;170076;179;64;25;2;23;.920;3600000;0
10286;174147;179;0;0;0;0;.00nan;0;0
10286;179602;177;73;34;3;31;.912;3594000;0
10294;170202;195;76;18;1;17;.944;3600000;0
10294;170351;194;0;0;0;0;.00nan;0;0
10294;-1;194;93;51;4;47;.922;3600000;0
10294;176200;195;0;0;0;0;.00nan;0;0
11113;175723;180;0;0;0;0;.00nan;0;0
11113;176938;180;87;38;3;35;.921;3600000;0
11113;179679;212;0;0;0;0;.00nan;0;0
11113;186641;212;100;28;0;28;1.000;3600000;0
10349;-1;1371;0;0;0;0;.00nan;0;0
10349;175842;214;81;38;3;35;.921;3546000;0
10349;-1;214;0;0;0;0;.00nan;0;0
10349;192688;1371;77;29;2;27;.931;3600000;0
10350;189081;187;0;0;0;0;.00nan;0;0
10350;174153;188;0;0;0;0;.00nan;0;0
10350;-1;188;61;38;4;34;.895;3687000;0
10350;-1;187;69;33;3;30;.909;3687000;0
10323;168117;192;60;17;2;15;.882;3600000;0
10323;169096;190;0;0;0;0;.00nan;0;0
10323;175900;192;0;0;0;0;.00nan;0;0
10323;184788;190;60;46;6;40;.870;3600000;0
10391;169166;226;0;0;0;0;.00nan;0;0
10391;170141;200;0;0;0;0;.00nan;0;0
10391;187295;200;92;48;3;45;.938;3568000;0
10391;192629;226;76;31;2;29;.935;3600000;0
11629;-1;203;0;0;0;0;.00nan;0;0
11629;-1;203;70;31;3;28;.903;3900000;0
11629;182049;204;0;0;0;0;.00nan;0;0
11629;141765;204;67;31;3;28;.903;3900000;0
10450;175364;206;52;36;4;32;.889;3600000;0
10450;175371;206;0;0;0;0;.00nan;0;0
10450;-1;207;0;0;0;0;.00nan;0;0
10450;-1;207;83;26;1;25;.962;3600000;0
10373;176770;219;63;36;4;32;.889;3776000;0
10373;179679;212;0;0;0;0;.00nan;0;0
10373;181102;219;0;0;0;0;.00nan;0;0
10373;186641;212;54;31;5;26;.839;3776000;0
10434;174209;178;0;0;0;0;.00nan;0;0
10434;176963;178;97;54;3;51;.944;3571000;0
10434;180762;1505;0;0;0;0;.00nan;0;0
10434;186549;1505;82;22;1;21;.955;3600000;0
10290;173340;231;40;17;3;14;.824;3600000;0
10290;184175;224;0;0;0;0;.00nan;0;0
10290;-1;224;58;46;6;40;.870;3600000;0
10290;185034;231;0;0;0;0;.00nan;0;0
11056;166545;193;0;0;0;0;.00nan;0;0
11056;173770;193;74;33;3;30;.909;3600000;0
11056;173823;198;40;45;7;38;.844;3600000;0
11056;181431;198;0;0;0;0;.00nan;0;0
10302;182454;4864;0;0;0;0;.00nan;0;0
10302;183737;4864;71;21;1;20;.952;3550000;0
10302;171405;2620;0;0;0;0;.00nan;0;0
10302;176921;2620;100;34;0;34;1.000;3600000;0
11642;175364;206;73;33;3;30;.909;3579000;0
11642;175371;206;0;0;0;0;.00nan;0;0
11642;-1;207;70;22;2;20;.909;3600000;0
11642;-1;207;0;0;0;0;.00nan;0;0
11540;177248;201;0;0;0;0;.00nan;0;0
11540;168995;205;99;45;2;43;.956;3900000;0
11540;-1;205;0;0;0;0;.00nan;0;0
11540;185743;201;66;24;2;22;.917;3900000;0
11663;168966;189;0;0;0;0;.00nan;0;0
11663;-1;196;0;0;0;0;.00nan;0;0
11663;184648;196;78;35;3;32;.914;3600000;0
11663;176915;189;56;28;4;24;.857;3587000;0
11661;173916;230;0;0;0;0;.00nan;0;0
11661;175423;223;75;48;5;43;.896;3600000;0
11661;-1;223;0;0;0;0;.00nan;0;0
11661;186495;230;71;23;1;22;.957;3600000;0
11645;166451;176;47;35;6;29;.829;3600000;0
11645;171660;209;82;38;2;36;.947;3600000;0
11645;171662;176;0;0;0;0;.00nan;0;0
11645;186205;209;0;0;0;0;.00nan;0;0
10527;-1;221;0;0;0;0;.00nan;0;0
10527;179406;232;34;29;6;23;.793;2465000;0
10527;179434;232;58;9;0;9;1.000;1135000;0
10527;187362;221;72;28;2;26;.929;3600000;0
10298;-1;202;93;36;2;34;.944;3900000;0
10298;174334;208;70;26;2;24;.923;3900000;0
10298;179702;208;0;0;0;0;.00nan;0;0
10298;180623;202;0;0;0;0;.00nan;0;0
11550;166695;218;0;0;0;0;.00nan;0;0
11550;168907;186;0;0;0;0;.00nan;0;0
11550;169226;186;52;25;3;22;.880;3900000;0
11550;-1;218;77;38;3;35;.921;3900000;0
11579;170141;200;0;0;0;0;.00nan;0;0
11579;175370;199;77;20;1;19;.950;3600000;0
11579;187295;200;84;61;5;56;.918;3600000;0
11579;161006;199;0;0;0;0;.00nan;0;0
11573;170963;185;0;0;0;0;.00nan;0;0
11573;171730;220;84;40;3;37;.925;3600000;0
11573;180110;185;40;27;5;22;.815;3537000;0
11573;187443;220;0;0;0;0;.00nan;0;0
10321;173340;231;0;0;0;0;.00nan;0;0
10321;184175;224;88;51;3;48;.941;3600000;0
10321;-1;224;0;0;0;0;.00nan;0;0
10321;185034;231;87;17;0;17;1.000;3600000;0
10299;174334;208;33;15;4;11;.733;3577000;0
10299;179702;208;0;0;0;0;.00nan;0;0
10299;182049;204;77;34;3;31;.912;3600000;0
10299;141765;204;0;0;0;0;.00nan;0;0
10400;171819;177;0;0;0;0;.00nan;0;0
10400;-1;4949;72;27;2;25;.926;3545000;0
10400;168912;4949;0;0;0;0;.00nan;0;0
10400;179602;177;86;29;1;28;.966;3600000;0
10325;171615;181;11;24;7;17;.708;3600000;0
10325;-1;1371;56;31;4;27;.871;3600000;0
10325;-1;181;0;0;0;0;.00nan;0;0
10325;192688;1371;0;0;0;0;.00nan;0;0
11638;171835;4960;0;0;0;0;.00nan;0;0
11638;187660;4960;52;19;2;17;.895;3600000;0
11638;189885;225;0;0;0;0;.00nan;0;0
11638;184785;225;38;31;6;25;.806;3600000;0
10515;173900;182;0;0;0;0;.00nan;0;0
10515;175842;214;0;0;0;0;.00nan;0;0
10515;182116;182;64;28;3;25;.893;3541000;0
10515;-1;214;91;48;2;46;.958;3600000;0
10476;168954;228;35;11;3;8;.727;601000;0
10476;170300;228;67;26;2;24;.923;2999000;0
10476;173916;230;0;0;0;0;.00nan;0;0
10476;186495;230;66;19;1;18;.947;3600000;0
10482;170076;179;69;25;2;23;.920;3600000;0
10482;174147;179;0;0;0;0;.00nan;0;0
10482;187232;216;0;0;0;0;.00nan;0;0
10482;187240;216;66;30;3;27;.900;3565000;0
10368;179406;232;0;0;0;0;.00nan;0;0
10368;175436;229;0;0;0;0;.00nan;0;0
10368;179434;232;65;28;3;25;.893;3600000;0
10368;176860;229;88;30;2;28;.933;3600000;0
11590;-1;197;75;33;2;31;.939;3528000;0
11590;169096;190;97;25;0;25;1.000;3600000;0
11590;170189;197;0;0;0;0;.00nan;0;0
11590;184788;190;0;0;0;0;.00nan;0;0
10376;168117;192;55;12;2;10;.833;3600000;0
10376;174153;188;0;0;0;0;.00nan;0;0
10376;-1;188;84;57;5;52;.912;3600000;0
10376;175900;192;0;0;0;0;.00nan;0;0
10346;166451;176;77;31;2;29;.935;3600000;0
10346;183860;4959;0;0;0;0;.00nan;0;0
10346;170114;4959;54;24;3;21;.875;3600000;0
10346;171662;176;0;0;0;0;.00nan;0;0
10383;168907;186;94;25;0;25;1.000;3600000;0
10383;169226;186;0;0;0;0;.00nan;0;0
10383;175723;180;0;0;0;0;.00nan;0;0
10383;176938;180;83;33;2;31;.939;3582000;0
10292;171970;217;63;24;2;22;.917;3543000;0
10292;167404;215;0;0;0;0;.00nan;0;0
10292;171654;217;0;0;0;0;.00nan;0;0
10292;161046;215;79;28;1;27;.964;3600000;0
10379;169166;226;77;13;0;13;1.000;3600000;0
10379;-1;203;0;0;0;0;.00nan;0;0
10379;-1;203;82;43;3;40;.930;3600000;0
10379;192629;226;0;0;0;0;.00nan;0;0
10467;170963;185;92;43;3;40;.930;3881000;0
10467;190125;184;71;28;2;26;.929;3881000;0
10467;179668;184;0;0;0;0;.00nan;0;0
10467;180110;185;0;0;0;0;.00nan;0;0
10492;-1;197;53;36;4;32;.889;3600000;0
10492;170189;197;0;0;0;0;.00nan;0;0
10492;-1;196;0;0;0;0;.00nan;0;0
10492;184648;196;84;29;1;28;.966;3600000;0
10463;174209;178;0;0;0;0;.00nan;0;0
10463;176963;178;72;38;4;34;.895;3600000;0
10463;187232;216;48;20;3;17;.850;3600000;0
10463;187240;216;0;0;0;0;.00nan;0;0
10412;175723;180;34;29;5;24;.828;3600000;0
10412;176770;219;63;23;2;21;.913;3600000;0
10412;176938;180;0;0;0;0;.00nan;0;0
10412;181102;219;0;0;0;0;.00nan;0;0
10422;173900;182;0;0;0;0;.00nan;0;0
10422;-1;1371;0;0;0;0;.00nan;0;0
10422;182116;182;68;28;3;25;.893;3673000;0
10422;192688;1371;97;39;2;37;.949;3673000;0
10415;184610;222;0;0;0;0;.00nan;0;0
10415;175423;223;0;0;0;0;.00nan;0;0
10415;-1;223;83;39;3;36;.923;3600000;0
10415;-1;222;60;22;2;20;.909;3600000;0
11514;-1;4949;0;0;0;0;.00nan;0;0
11514;168912;4949;65;43;5;38;.884;3600000;0
11514;-1;210;0;0;0;0;.00nan;0;0
11514;192461;210;80;25;1;24;.960;3600000;0
10425;170141;200;0;0;0;0;.00nan;0;0
10425;-1;203;59;31;3;28;.903;3600000;0
10425;-1;203;0;0;0;0;.00nan;0;0
10425;187295;200;90;40;1;39;.975;3600000;0
10565;171405;2620;0;0;0;0;.00nan;0;0
10565;171660;209;67;33;4;29;.879;3900000;0
10565;176921;2620;89;47;4;43;.915;3900000;0
10565;186205;209;0;0;0;0;.00nan;0;0
10647;168954;228;75;37;2;35;.946;3590000;0
10647;170144;227;79;22;1;21;.955;3600000;0
10647;170300;228;0;0;0;0;.00nan;0;0
10647;-1;227;0;0;0;0;.00nan;0;0
10342;187628;191;0;0;0;0;.00nan;0;0
10342;168117;192;0;0;0;0;.00nan;0;0
10342;175900;192;50;23;4;19;.826;3576000;0
10342;185960;191;72;35;3;32;.914;3600000;0
10367;175364;206;77;27;1;26;.963;3600000;0
10367;175371;206;0;0;0;0;.00nan;0;0
10367;-1;207;56;21;2;19;.905;3546000;0
10367;-1;207;0;0;0;0;.00nan;0;0
10363;171835;4960;61;12;1;11;.917;3600000;0
10363;187660;4960;0;0;0;0;.00nan;0;0
10363;175436;229;0;0;0;0;.00nan;0;0
10363;176860;229;93;48;3;45;.938;3546000;0
10387;166545;193;77;36;3;33;.917;3900000;0
10387;173770;193;0;0;0;0;.00nan;0;0
10387;170202;195;0;0;0;0;.00nan;0;0
10387;176200;195;62;28;3;25;.893;3900000;0
10362;168995;205;0;0;0;0;.00nan;0;0
10362;182049;204;0;0;0;0;.00nan;0;0
10362;-1;205;53;24;3;21;.875;3600000;0
10362;141765;204;67;34;4;30;.882;3575000;0
10318;169096;190;100;37;0;37;1.000;3600000;0
10318;170351;194;55;24;3;21;.875;3600000;0
10318;-1;194;0;0;0;0;.00nan;0;0
10318;184788;190;0;0;0;0;.00nan;0;0
10378;166762;213;82;29;2;27;.931;3600000;0
10378;175328;183;0;0;0;0;.00nan;0;0
10378;180575;213;0;0;0;0;.00nan;0;0
10378;182089;183;61;41;5;36;.878;3600000;0
10371;166695;218;0;0;0;0;.00nan;0;0
10371;-1;211;63;23;2;21;.913;3600000;0
10371;-1;218;83;53;4;49;.925;3521000;0
10371;179646;211;0;0;0;0;.00nan;0;0
10403;-1;202;68;30;2;28;.933;3900000;0
10403;175370;199;0;0;0;0;.00nan;0;0
10403;180623;202;0;0;0;0;.00nan;0;0
10403;161006;199;69;25;2;23;.920;3900000;0
10402;171970;217;0;0;0;0;.00nan;0;0
10402;171654;217;65;33;4;29;.879;3600000;0
10402;179679;212;46;16;3;13;.813;3600000;0
10402;186641;212;0;0;0;0;.00nan;0;0
10369;189081;187;52;28;3;25;.893;3570000;0
10369;168966;189;0;0;0;0;.00nan;0;0
10369;176915;189;98;42;1;41;.976;3600000;0
10369;-1;187;0;0;0;0;.00nan;0;0
10344;182454;4864;0;0;0;0;.00nan;0;0
10344;183737;4864;76;39;3;36;.923;3564000;0
10344;183860;4959;62;21;2;19;.905;3600000;0
10344;170114;4959;0;0;0;0;.00nan;0;0
10432;170076;179;0;0;0;0;.00nan;0;0
10432;174147;179;59;13;1;12;.923;3600000;0
10432;174209;178;0;0;0;0;.00nan;0;0
10432;176963;178;92;37;2;35;.946;3571000;0
10542;175842;214;97;41;1;40;.976;3584000;0
10542;190125;184;0;0;0;0;.00nan;0;0
10542;179668;184;98;21;0;21;1.000;3600000;0
10542;-1;214;0;0;0;0;.00nan;0;0
11675;173916;230;0;0;0;0;.00nan;0;0
11675;179406;232;24;24;6;18;.750;2685000;0
11675;179434;232;28;12;4;8;.667;915000;0
11675;186495;230;55;8;1;7;.875;3600000;0
10353;187628;191;81;32;2;30;.938;3600000;0
10353;173823;198;39;11;3;8;.727;225000;0
10353;181431;198;77;30;2;28;.933;3375000;0
10353;185960;191;0;0;0;0;.00nan;0;0
10347;168995;205;76;43;3;40;.930;3577000;0
10347;169166;226;73;20;1;19;.950;3600000;0
10347;-1;205;0;0;0;0;.00nan;0;0
10347;192629;226;0;0;0;0;.00nan;0;0
10446;177248;201;62;31;4;27;.871;3600000;0
10446;175370;199;42;28;5;23;.821;3600000;0
10446;185743;201;0;0;0;0;.00nan;0;0
10446;161006;199;0;0;0;0;.00nan;0;0
10332;184175;224;71;33;3;30;.909;3900000;0
10332;-1;224;0;0;0;0;.00nan;0;0
10332;189885;225;56;28;3;25;.893;3900000;0
10332;184785;225;0;0;0;0;.00nan;0;0
10414;-1;211;0;0;0;0;.00nan;0;0
10414;168907;186;0;0;0;0;.00nan;0;0
10414;169226;186;86;25;1;24;.960;3600000;0
10414;179646;211;37;31;5;26;.839;3600000;0
10313;170963;185;0;0;0;0;.00nan;0;0
10313;171615;181;0;0;0;0;.00nan;0;0
10313;180110;185;41;26;5;21;.808;3600000;0
10313;-1;181;98;42;1;41;.976;3600000;0
10499;166451;176;0;0;0;0;.00nan;0;0
10499;171660;209;0;0;0;0;.00nan;0;0
10499;171662;176;73;36;3;33;.917;3541000;0
10499;186205;209;93;35;1;34;.971;3600000;0
10409;166695;218;0;0;0;0;.00nan;0;0
10409;167404;215;0;0;0;0;.00nan;0;0
10409;-1;218;86;43;3;40;.930;3600000;0
10409;161046;215;48;25;4;21;.840;3555000;0
10564;-1;1371;0;0;0;0;.00nan;0;0
10564;175842;214;0;0;0;0;.00nan;0;0
10564;-1;214;44;33;5;28;.848;3600000;0
10564;192688;1371;70;24;2;22;.917;3600000;0
10377;182454;4864;0;0;0;0;.00nan;0;0
10377;183737;4864;77;37;3;34;.919;3600000;0
10377;183860;4959;0;0;0;0;.00nan;0;0
10377;170114;4959;51;23;4;19;.826;3600000;0
10337;173916;230;53;29;4;25;.862;3600000;0
10337;-1;221;27;29;6;23;.793;3600000;0
10337;186495;230;0;0;0;0;.00nan;0;0
10337;187362;221;0;0;0;0;.00nan;0;0
10461;166545;193;38;21;4;17;.810;3600000;0
10461;173770;193;0;0;0;0;.00nan;0;0
10461;-1;196;46;27;5;22;.815;1854000;0
10461;184648;196;69;34;2;32;.941;1746000;0
10352;171615;181;87;35;1;34;.971;3568000;0
10352;171730;220;0;0;0;0;.00nan;0;0
10352;-1;181;0;0;0;0;.00nan;0;0
10352;187443;220;94;22;0;22;1.000;3600000;0
10413;170202;195;0;0;0;0;.00nan;0;0
10413;170351;194;92;54;3;51;.944;3802000;0
10413;-1;194;0;0;0;0;.00nan;0;0
10413;176200;195;68;23;2;21;.913;3802000;0
11516;171819;177;0;0;0;0;.00nan;0;0
11516;179602;177;92;22;0;22;1.000;3600000;0
11516;187232;216;0;0;0;0;.00nan;0;0
11516;187240;216;80;29;2;27;.931;3600000;0
10365;168117;192;0;0;0;0;.00nan;0;0
10365;174153;188;0;0;0;0;.00nan;0;0
10365;-1;188;63;37;4;33;.892;3702000;0
10365;175900;192;64;24;3;21;.875;3702000;0
10399;184610;222;70;17;1;16;.941;2440000;0
10399;175423;223;83;33;2;31;.939;3600000;0
10399;-1;223;0;0;0;0;.00nan;0;0
10399;-1;222;41;19;4;15;.789;1160000;0
10385;170144;227;0;0;0;0;.00nan;0;0
10385;-1;227;42;17;3;14;.824;3600000;0
10385;175436;229;0;0;0;0;.00nan;0;0
10385;176860;229;65;41;5;36;.878;3551000;0
10427;175723;180;0;0;0;0;.00nan;0;0
10427;176938;180;74;37;2;35;.946;3900000;0
10427;179679;212;0;0;0;0;.00nan;0;0
10427;186641;212;80;32;2;30;.938;3900000;0
10334;-1;203;0;0;0;0;.00nan;0;0
10334;-1;203;63;25;2;23;.920;3600000;0
10334;182049;204;88;48;3;45;.938;3588000;0
10334;141765;204;0;0;0;0;.00nan;0;0
10328;170141;200;0;0;0;0;.00nan;0;0
10328;174334;208;80;9;0;9;1.000;3600000;0
10328;179702;208;0;0;0;0;.00nan;0;0
10328;187295;200;87;57;3;54;.947;3600000;0
10853;-1;202;0;0;0;0;.00nan;0;0
10853;175364;206;84;47;3;44;.936;3900000;0
10853;175371;206;0;0;0;0;.00nan;0;0
10853;180623;202;58;28;3;25;.893;3900000;0
10471;189081;187;0;0;0;0;.00nan;0;0
10471;169096;190;90;40;3;37;.925;3580000;0
10471;184788;190;0;0;0;0;.00nan;0;0
10471;-1;187;77;20;1;19;.950;3600000;0
10392;166762;213;95;48;2;46;.958;3600000;0
10392;180575;213;0;0;0;0;.00nan;0;0
10392;180762;1505;25;26;6;20;.769;3600000;0
10392;186549;1505;0;0;0;0;.00nan;0;0
10330;-1;197;69;48;6;42;.875;3049000;0
10330;168966;189;0;0;0;0;.00nan;0;0
10330;170189;197;52;4;0;4;1.000;551000;0
10330;176915;189;86;33;2;31;.939;3600000;0
10390;170076;179;78;11;0;11;1.000;3600000;0
10390;174147;179;0;0;0;0;.00nan;0;0
10390;175328;183;83;58;5;53;.914;3600000;0
10390;182089;183;0;0;0;0;.00nan;0;0
11609;183860;4959;28;26;5;21;.808;2177000;0
11609;170114;4959;60;13;1;12;.923;1423000;0
11609;171660;209;0;0;0;0;.00nan;0;0
11609;186205;209;79;30;2;28;.933;3600000;0
10456;189081;187;26;21;5;16;.762;3600000;0
10456;168966;189;94;63;2;61;.968;3600000;0
10456;176915;189;0;0;0;0;.00nan;0;0
10456;-1;187;0;0;0;0;.00nan;0;0
10374;169096;190;0;0;0;0;.00nan;0;0
10374;170351;194;0;0;0;0;.00nan;0;0
10374;-1;194;67;44;4;40;.909;3600000;0
10374;184788;190;73;23;1;22;.957;3600000;0
11614;-1;221;0;0;0;0;.00nan;0;0
11614;175436;229;55;50;6;44;.880;3279000;0
11614;176860;229;52;4;0;4;1.000;321000;0
11614;187362;221;85;31;2;29;.935;3600000;0
10469;173900;182;0;0;0;0;.00nan;0;0
10469;170963;185;57;30;3;27;.900;3600000;0
10469;180110;185;0;0;0;0;.00nan;0;0
10469;182116;182;61;35;4;31;.886;3565000;0
10481;179406;232;100;29;0;29;1.000;3600000;0
10481;175423;223;0;0;0;0;.00nan;0;0
10481;179434;232;0;0;0;0;.00nan;0;0
10481;-1;223;68;27;2;25;.926;3544000;0
11567;168995;205;40;11;3;8;.727;3600000;0
11567;175364;206;100;56;0;56;1.000;3600000;0
11567;175371;206;0;0;0;0;.00nan;0;0
11567;-1;205;0;0;0;0;.00nan;0;0
10364;177248;201;0;0;0;0;.00nan;0;0
10364;174334;208;72;27;1;26;.963;3900000;0
10364;179702;208;0;0;0;0;.00nan;0;0
10364;185743;201;100;43;1;42;.977;3900000;0
10355;187628;191;0;0;0;0;.00nan;0;0
10355;-1;197;0;0;0;0;.00nan;0;0
10355;170189;197;94;62;5;57;.919;3600000;0
10355;185960;191;79;10;0;10;1.000;3600000;0
10449;171819;177;0;0;0;0;.00nan;0;0
10449;179602;177;79;27;2;25;.926;3600000;0
10449;187232;216;47;31;4;27;.871;3573000;0
10449;187240;216;0;0;0;0;.00nan;0;0
10331;184175;224;0;0;0;0;.00nan;0;0
10331;-1;224;76;24;1;23;.958;3900000;0
10331;189885;225;95;37;1;36;.973;3900000;0
10331;184785;225;0;0;0;0;.00nan;0;0
10444;166451;176;69;37;4;33;.892;3600000;0
10444;171405;2620;0;0;0;0;.00nan;0;0
10444;171662;176;0;0;0;0;.00nan;0;0
10444;176921;2620;99;23;0;23;1.000;3600000;0
10336;173340;231;0;0;0;0;.00nan;0;0
10336;168954;228;27;31;7;24;.774;2534000;0
10336;170300;228;54;16;2;14;.875;1066000;0
10336;185034;231;89;18;0;18;1.000;3600000;0
10610;171835;4960;46;26;4;22;.846;3600000;0
10610;187660;4960;0;0;0;0;.00nan;0;0
10610;170144;227;61;30;3;27;.900;3600000;0
10610;-1;227;0;0;0;0;.00nan;0;0
10426;-1;211;97;48;2;46;.958;3900000;0
10426;179646;211;0;0;0;0;.00nan;0;0
10426;179679;212;70;25;2;23;.920;3900000;0
10426;186641;212;0;0;0;0;.00nan;0;0
10419;171970;217;85;32;1;31;.969;3600000;0
10419;167404;215;42;25;4;21;.840;3600000;0
10419;171654;217;0;0;0;0;.00nan;0;0
10419;161046;215;0;0;0;0;.00nan;0;0
10453;170141;200;66;44;5;39;.886;3600000;0
10453;-1;207;55;19;2;17;.895;3600000;0
10453;187295;200;0;0;0;0;.00nan;0;0
10453;-1;207;0;0;0;0;.00nan;0;0
10284;169166;226;54;43;6;37;.860;3600000;0
10284;175370;199;0;0;0;0;.00nan;0;0
10284;192629;226;0;0;0;0;.00nan;0;0
10284;161006;199;59;29;3;26;.897;3600000;0
10448;174209;178;0;0;0;0;.00nan;0;0
10448;-1;210;77;12;0;12;1.000;3600000;0
10448;176963;178;97;59;1;58;.983;3570000;0
10448;192461;210;0;0;0;0;.00nan;0;0
10493;168907;186;0;0;0;0;.00nan;0;0
10493;169226;186;100;25;0;25;1.000;3600000;0
10493;176770;219;58;29;3;26;.897;3600000;0
10493;181102;219;0;0;0;0;.00nan;0;0
10309;-1;4949;52;28;4;24;.857;3600000;0
10309;168912;4949;0;0;0;0;.00nan;0;0
10309;180762;1505;0;0;0;0;.00nan;0;0
10309;186549;1505;95;33;1;32;.970;3600000;0
10395;-1;4949;0;0;0;0;.00nan;0;0
10395;168912;4949;79;21;1;20;.952;3600000;0
10395;175328;183;0;0;0;0;.00nan;0;0
10395;182089;183;89;48;4;44;.917;3600000;0
10375;166545;193;97;22;0;22;1.000;3600000;0
10375;173770;193;0;0;0;0;.00nan;0;0
10375;174153;188;94;39;3;36;.923;3600000;0
10375;-1;188;0;0;0;0;.00nan;0;0
11583;169166;226;0;0;0;0;.00nan;0;0
11583;-1;203;0;0;0;0;.00nan;0;0
11583;-1;203;62;27;3;24;.889;3900000;0
11583;192629;226;70;31;3;28;.903;3900000;0
10408;173340;231;0;0;0;0;.00nan;0;0
10408;179406;232;74;44;4;40;.909;3600000;0
10408;179434;232;0;0;0;0;.00nan;0;0
10408;185034;231;52;23;3;20;.870;3600000;0
10540;166695;218;0;0;0;0;.00nan;0;0
10540;-1;218;73;25;2;23;.920;3600000;0
10540;176770;219;0;0;0;0;.00nan;0;0
10540;181102;219;59;28;3;25;.893;3569000;0
11662;-1;211;0;0;0;0;.00nan;0;0
11662;168907;186;0;0;0;0;.00nan;0;0
11662;169226;186;82;36;2;34;.944;3900000;0
11662;179646;211;70;31;2;29;.935;3900000;0
10370;171615;181;0;0;0;0;.00nan;0;0
10370;190125;184;0;0;0;0;.00nan;0;0
10370;179668;184;64;33;4;29;.879;3600000;0
10370;-1;181;100;42;2;40;.952;3600000;0
10510;168995;205;0;0;0;0;.00nan;0;0
10510;-1;207;0;0;0;0;.00nan;0;0
10510;-1;205;58;26;3;23;.885;3553000;0
10510;-1;207;73;23;1;22;.957;3600000;0
10766;166762;213;47;22;4;18;.818;941000;0
10766;-1;210;0;0;0;0;.00nan;0;0
10766;180575;213;72;27;2;25;.926;2659000;0
10766;192461;210;80;26;1;25;.962;3600000;0
10428;171835;4960;48;14;2;12;.857;3600000;0
10428;187660;4960;0;0;0;0;.00nan;0;0
10428;173916;230;0;0;0;0;.00nan;0;0
10428;186495;230;73;48;5;43;.896;3600000;0
11489;171730;220;48;13;2;11;.846;3600000;0
11489;175842;214;26;27;6;21;.778;2298000;0
11489;187443;220;0;0;0;0;.00nan;0;0
11489;-1;214;46;18;3;15;.833;1302000;0
10459;170202;195;0;0;0;0;.00nan;0;0
10459;-1;196;100;48;2;46;.958;3600000;0
10459;184648;196;0;0;0;0;.00nan;0;0
10459;176200;195;48;19;3;16;.842;3558000;0
10380;189885;225;0;0;0;0;.00nan;0;0
10380;184610;222;0;0;0;0;.00nan;0;0
10380;184785;225;98;61;2;59;.967;3600000;0
10380;-1;222;72;7;0;7;1.000;3600000;0
10384;182454;4864;0;0;0;0;.00nan;0;0
10384;183737;4864;71;21;1;20;.952;3600000;0
10384;171405;2620;0;0;0;0;.00nan;0;0
10384;176921;2620;78;33;2;31;.939;3600000;0
11509;173900;182;78;46;4;42;.913;3569000;0
11509;-1;1371;61;29;3;26;.897;3600000;0
11509;182116;182;0;0;0;0;.00nan;0;0
11509;192688;1371;0;0;0;0;.00nan;0;0
10595;177248;201;100;29;0;29;1.000;3600000;0
10595;-1;202;56;28;3;25;.893;3600000;0
10595;180623;202;0;0;0;0;.00nan;0;0
10595;185743;201;0;0;0;0;.00nan;0;0
11587;182454;4864;82;22;1;21;.955;3600000;0
11587;183737;4864;0;0;0;0;.00nan;0;0
11587;171660;209;58;26;2;24;.923;3565000;0
11587;186205;209;0;0;0;0;.00nan;0;0
10396;171819;177;0;0;0;0;.00nan;0;0
10396;179602;177;63;43;5;38;.884;3600000;0
10396;180762;1505;54;18;2;16;.889;3600000;0
10396;186549;1505;0;0;0;0;.00nan;0;0
10732;168954;228;61;43;5;38;.884;3600000;0
10732;170300;228;0;0;0;0;.00nan;0;0
10732;184610;222;0;0;0;0;.00nan;0;0
10732;-1;222;55;20;2;18;.900;3600000;0
11639;170141;200;0;0;0;0;.00nan;0;0
11639;175364;206;84;40;2;38;.950;3900000;0
11639;175371;206;0;0;0;0;.00nan;0;0
11639;187295;200;67;26;2;24;.923;3900000;0
11290;189081;187;0;0;0;0;.00nan;0;0
11290;173823;198;59;27;3;24;.889;3600000;0
11290;-1;187;36;36;6;30;.833;3600000;0
11290;181431;198;0;0;0;0;.00nan;0;0
11542;168117;192;56;16;2;14;.875;3600000;0
11542;-1;196;0;0;0;0;.00nan;0;0
11542;184648;196;79;47;3;44;.936;3582000;0
11542;175900;192;0;0;0;0;.00nan;0;0
10578;173900;182;0;0;0;0;.00nan;0;0
10578;190125;184;72;29;2;27;.931;3600000;0
10578;179668;184;0;0;0;0;.00nan;0;0
10578;182116;182;44;26;4;22;.846;3570000;0
10358;171615;181;45;39;6;33;.846;3600000;0
10358;171730;220;0;0;0;0;.00nan;0;0
10358;-1;181;0;0;0;0;.00nan;0;0
10358;187443;220;84;37;3;34;.919;3600000;0
10640;171835;4960;45;23;4;19;.826;3600000;0
10640;187660;4960;0;0;0;0;.00nan;0;0
10640;170144;227;8;15;6;9;.600;1471000;0
10640;-1;227;43;18;3;15;.833;2129000;0
10782;170076;179;80;26;1;25;.962;3852000;0
10782;174147;179;0;0;0;0;.00nan;0;0
10782;187232;216;0;0;0;0;.00nan;0;0
10782;187240;216;90;41;2;39;.951;3852000;0
10580;170963;185;80;25;1;24;.960;3600000;0
10580;175842;214;0;0;0;0;.00nan;0;0
10580;180110;185;0;0;0;0;.00nan;0;0
10580;-1;214;97;55;3;52;.945;3539000;0
11473;166451;176;0;0;0;0;.00nan;0;0
11473;171405;2620;0;0;0;0;.00nan;0;0
11473;171662;176;100;40;0;40;1.000;3600000;0
11473;176921;2620;32;24;5;19;.792;3600000;0
10404;187628;191;0;0;0;0;.00nan;0;0
10404;170351;194;40;34;6;28;.824;3600000;0
10404;-1;194;0;0;0;0;.00nan;0;0
10404;185960;191;62;14;1;13;.929;3600000;0
10443;174334;208;26;23;6;17;.739;3600000;0
10443;175370;199;80;31;2;29;.935;3600000;0
10443;179702;208;0;0;0;0;.00nan;0;0
10443;161006;199;0;0;0;0;.00nan;0;0
10433;169166;226;66;24;2;22;.917;3600000;0
10433;182049;204;75;39;4;35;.897;3514000;0
10433;192629;226;0;0;0;0;.00nan;0;0
10433;141765;204;0;0;0;0;.00nan;0;0
10473;171819;177;44;35;6;29;.829;3177000;0
10473;179602;177;61;5;0;5;1.000;423000;0
10473;180762;1505;0;0;0;0;.00nan;0;0
10473;186549;1505;62;27;3;24;.889;3600000;0
10468;167404;215;0;0;0;0;.00nan;0;0
10468;175723;180;0;0;0;0;.00nan;0;0
10468;176938;180;79;36;3;33;.917;3600000;0
10468;161046;215;72;24;1;23;.958;3600000;0
10442;171970;217;92;40;3;37;.925;3600000;0
10442;171654;217;0;0;0;0;.00nan;0;0
10442;176770;219;89;18;0;18;1.000;3600000;0
10442;181102;219;0;0;0;0;.00nan;0;0
10420;169096;190;98;47;2;45;.957;3900000;0
10420;170202;195;0;0;0;0;.00nan;0;0
10420;184788;190;0;0;0;0;.00nan;0;0
10420;176200;195;66;21;2;19;.905;3900000;0
10441;-1;202;65;31;3;28;.903;3600000;0
10441;-1;203;0;0;0;0;.00nan;0;0
10441;-1;203;41;22;4;18;.818;3564000;0
10441;180623;202;0;0;0;0;.00nan;0;0
10424;173340;231;57;21;2;19;.905;3600000;0
10424;173916;230;0;0;0;0;.00nan;0;0
10424;185034;231;0;0;0;0;.00nan;0;0
10424;186495;230;75;40;3;37;.925;3565000;0
10393;183860;4959;0;0;0;0;.00nan;0;0
10393;170114;4959;68;25;2;23;.920;3600000;0
10393;171660;209;0;0;0;0;.00nan;0;0
10393;186205;209;72;34;3;31;.912;3552000;0
10410;166762;213;74;37;3;34;.919;3600000;0
10410;-1;4949;46;34;5;29;.853;3563000;0
10410;168912;4949;0;0;0;0;.00nan;0;0
10410;180575;213;0;0;0;0;.00nan;0;0
10431;169166;226;0;0;0;0;.00nan;0;0
10431;175370;199;0;0;0;0;.00nan;0;0
10431;192629;226;36;23;4;19;.826;3862000;0
10431;161006;199;70;41;4;37;.902;3900000;0
10687;171835;4960;0;0;0;0;.00nan;0;0
10687;187660;4960;45;28;4;24;.857;3577000;0
10687;-1;221;73;41;3;38;.927;3600000;0
10687;187362;221;0;0;0;0;.00nan;0;0
10454;184175;224;41;15;3;12;.800;507000;0
10454;-1;224;64;34;4;30;.882;3093000;0
10454;175436;229;0;0;0;0;.00nan;0;0
10454;176860;229;100;27;0;27;1.000;3600000;0
10537;173916;230;66;34;4;30;.882;3581000;0
10537;184610;222;0;0;0;0;.00nan;0;0
10537;-1;222;71;26;2;24;.923;3600000;0
10537;186495;230;0;0;0;0;.00nan;0;0
10560;166762;213;96;36;1;35;.972;3024000;0
10560;170076;179;0;0;0;0;.00nan;0;0
10560;174147;179;38;23;4;19;.826;3600000;0
10560;180575;213;24;11;4;7;.636;570000;0
10386;182454;4864;0;0;0;0;.00nan;0;0
10386;183737;4864;82;27;1;26;.963;3600000;0
10386;183860;4959;77;30;2;28;.933;3554000;0
10386;170114;4959;0;0;0;0;.00nan;0;0
10477;170141;200;0;0;0;0;.00nan;0;0
10477;175364;206;96;41;2;39;.951;3600000;0
10477;175371;206;0;0;0;0;.00nan;0;0
10477;187295;200;68;40;4;36;.900;3539000;0
10588;168995;205;69;34;4;30;.882;3600000;0
10588;-1;207;23;29;6;23;.793;3573000;0
10588;-1;205;0;0;0;0;.00nan;0;0
10588;-1;207;0;0;0;0;.00nan;0;0
10439;171970;217;0;0;0;0;.00nan;0;0
10439;171654;217;80;31;2;29;.935;3893000;0
10439;179679;212;0;0;0;0;.00nan;0;0
10439;186641;212;73;27;3;24;.889;3893000;0
10591;170963;185;0;0;0;0;.00nan;0;0
10591;-1;1371;0;0;0;0;.00nan;0;0
10591;180110;185;78;33;3;30;.909;3600000;0
10591;192688;1371;100;29;0;29;1.000;3600000;0
10611;171730;220;72;25;2;23;.920;3900000;0
10611;190125;184;77;36;2;34;.944;3900000;0
10611;179668;184;0;0;0;0;.00nan;0;0
10611;187443;220;0;0;0;0;.00nan;0;0
10430;187628;191;76;33;3;30;.909;3511000;0
10430;174153;188;0;0;0;0;.00nan;0;0
10430;-1;188;83;30;1;29;.967;3600000;0
10430;185960;191;0;0;0;0;.00nan;0;0
10489;189081;187;0;0;0;0;.00nan;0;0
10489;-1;196;75;44;4;40;.909;3546000;0
10489;184648;196;0;0;0;0;.00nan;0;0
10489;-1;187;44;18;3;15;.833;3600000;0
10357;171615;181;0;0;0;0;.00nan;0;0
10357;175842;214;80;40;3;37;.925;3649000;0
10357;-1;181;63;23;2;21;.913;3665000;0
10357;-1;214;0;0;0;0;.00nan;0;0
10398;-1;4949;0;0;0;0;.00nan;0;0
10398;168912;4949;61;26;3;23;.885;3582000;0
10398;175328;183;70;32;2;30;.938;3600000;0
10398;182089;183;0;0;0;0;.00nan;0;0
10490;166695;218;58;5;0;5;1.000;900000;0
10490;-1;218;42;35;6;29;.829;2700000;0
10490;175723;180;0;0;0;0;.00nan;0;0
10490;176938;180;71;30;3;27;.900;3600000;0
10496;168907;186;0;0;0;0;.00nan;0;0
10496;169226;186;79;23;1;22;.957;3600000;0
10496;176770;219;68;24;2;22;.917;3600000;0
10496;181102;219;0;0;0;0;.00nan;0;0
11591;-1;210;84;28;1;27;.964;3900000;0
11591;187232;216;98;37;1;36;.973;3900000;0
11591;187240;216;0;0;0;0;.00nan;0;0
11591;192461;210;0;0;0;0;.00nan;0;0
10472;166545;193;63;25;3;22;.880;3622000;0
10472;168966;189;0;0;0;0;.00nan;0;0
10472;173770;193;0;0;0;0;.00nan;0;0
10472;176915;189;94;40;2;38;.950;3622000;0
10397;189885;225;48;32;4;28;.875;3579000;0
10397;175423;223;93;32;2;30;.938;3600000;0
10397;184785;225;0;0;0;0;.00nan;0;0
10397;-1;223;0;0;0;0;.00nan;0;0
10487;173823;198;0;0;0;0;.00nan;0;0
10487;170202;195;0;0;0;0;.00nan;0;0
10487;176200;195;65;26;3;23;.885;3538000;0
10487;181431;198;86;27;1;26;.963;3600000;0
10421;174334;208;70;17;1;16;.941;3600000;0
10421;179702;208;0;0;0;0;.00nan;0;0
10421;182049;204;0;0;0;0;.00nan;0;0
10421;141765;204;88;43;3;40;.930;3598000;0
10389;168117;192;56;18;3;15;.833;3600000;0
10389;-1;197;70;53;6;47;.887;3600000;0
10389;170189;197;0;0;0;0;.00nan;0;0
10389;175900;192;0;0;0;0;.00nan;0;0
10435;174209;178;0;0;0;0;.00nan;0;0
10435;175328;183;0;0;0;0;.00nan;0;0
10435;176963;178;54;22;3;19;.864;3600000;0
10435;182089;183;76;56;6;50;.893;3600000;0
10511;168966;189;0;0;0;0;.00nan;0;0
10511;174153;188;0;0;0;0;.00nan;0;0
10511;-1;188;89;19;0;19;1.000;3600000;0
10511;176915;189;79;33;2;31;.939;3599000;0
10500;170141;200;67;29;2;27;.931;2040000;0
10500;-1;202;0;0;0;0;.00nan;0;0
10500;180623;202;100;25;0;25;1.000;3600000;0
10500;187295;200;35;23;5;18;.783;1560000;0
10418;182454;4864;50;31;4;27;.871;3564000;0
10418;183737;4864;0;0;0;0;.00nan;0;0
10418;171660;209;68;29;3;26;.897;3600000;0
10418;186205;209;0;0;0;0;.00nan;0;0
10507;166545;193;0;0;0;0;.00nan;0;0
10507;-1;197;0;0;0;0;.00nan;0;0
10507;173770;193;57;14;2;12;.857;3600000;0
10507;170189;197;79;58;5;53;.914;3600000;0
11520;173900;182;0;0;0;0;.00nan;0;0
11520;-1;1371;0;0;0;0;.00nan;0;0
11520;182116;182;87;31;1;30;.968;3600000;0
11520;192688;1371;69;32;3;29;.906;3513000;0
10470;173340;231;0;0;0;0;.00nan;0;0
10470;175436;229;0;0;0;0;.00nan;0;0
10470;176860;229;59;50;6;44;.880;3600000;0
10470;185034;231;62;18;2;16;.889;3600000;0
11561;166762;213;90;48;3;45;.938;3600000;0
11561;170076;179;100;23;0;23;1.000;3600000;0
11561;174147;179;0;0;0;0;.00nan;0;0
11561;180575;213;0;0;0;0;.00nan;0;0
10406;166451;176;93;44;3;41;.932;3600000;0
10406;183860;4959;0;0;0;0;.00nan;0;0
10406;170114;4959;100;26;0;26;1.000;3600000;0
10406;171662;176;0;0;0;0;.00nan;0;0
10458;187628;191;0;0;0;0;.00nan;0;0
10458;170202;195;61;8;0;8;1.000;1556000;0
10458;176200;195;43;36;6;30;.833;2044000;0
10458;185960;191;51;25;3;22;.880;3600000;0
10632;171835;4960;65;23;2;21;.913;3600000;0
10632;187660;4960;0;0;0;0;.00nan;0;0
10632;175423;223;0;0;0;0;.00nan;0;0
10632;-1;223;98;50;3;47;.940;3566000;0
10401;168117;192;69;20;1;19;.950;3600000;0
10401;170351;194;48;34;5;29;.853;3600000;0
10401;-1;194;0;0;0;0;.00nan;0;0
10401;175900;192;0;0;0;0;.00nan;0;0
10658;175364;206;99;39;1;38;.974;3600000;0
10658;175370;199;31;31;6;25;.806;3600000;0
10658;175371;206;0;0;0;0;.00nan;0;0
10658;161006;199;0;0;0;0;.00nan;0;0
11568;-1;211;70;48;5;43;.896;3597000;0
11568;176770;219;42;22;4;18;.818;3600000;0
11568;179646;211;0;0;0;0;.00nan;0;0
11568;181102;219;0;0;0;0;.00nan;0;0
10452;169166;226;51;16;2;14;.875;3666000;0
10452;-1;207;94;49;3;46;.939;3666000;0
10452;-1;207;0;0;0;0;.00nan;0;0
10452;192629;226;0;0;0;0;.00nan;0;0
10436;-1;203;0;0;0;0;.00nan;0;0
10436;174334;208;64;42;5;37;.881;3896000;0
10436;179702;208;0;0;0;0;.00nan;0;0
10436;-1;203;59;42;5;37;.881;3900000;0
11673;171730;220;58;16;1;15;.938;2361000;0
11673;190125;184;65;31;3;28;.903;3600000;0
11673;179668;184;0;0;0;0;.00nan;0;0
11673;187443;220;39;19;4;15;.789;1154000;0
11433;189081;187;59;5;0;5;1.000;1223000;0
11433;-1;196;43;12;2;10;.833;1417000;0
11433;184648;196;58;35;5;30;.857;2126000;0
11433;-1;187;23;14;5;9;.643;2377000;0
10451;168995;205;32;27;5;22;.815;3600000;0
10451;182049;204;81;27;1;26;.963;3600000;0
10451;-1;205;0;0;0;0;.00nan;0;0
10451;141765;204;0;0;0;0;.00nan;0;0
10494;173900;182;0;0;0;0;.00nan;0;0
10494;171615;181;48;27;4;23;.852;3600000;0
10494;182116;182;46;30;5;25;.833;3547000;0
10494;-1;181;0;0;0;0;.00nan;0;0
10512;184175;224;32;28;6;22;.786;2246000;0
10512;-1;224;64;14;0;14;1.000;1354000;0
10512;184610;222;0;0;0;0;.00nan;0;0
10512;-1;222;48;20;3;17;.850;3600000;0
10479;174209;178;76;38;3;35;.921;3567000;0
10479;176963;178;0;0;0;0;.00nan;0;0
10479;180762;1505;75;27;2;25;.926;3600000;0
10479;186549;1505;0;0;0;0;.00nan;0;0
10478;166695;218;0;0;0;0;.00nan;0;0
10478;171970;217;80;45;3;42;.933;3574000;0
10478;171654;217;0;0;0;0;.00nan;0;0
10478;-1;218;68;24;2;22;.917;3600000;0
10526;167404;215;0;0;0;0;.00nan;0;0
10526;179679;212;77;34;2;32;.941;3600000;0
10526;186641;212;0;0;0;0;.00nan;0;0
10526;161046;215;56;35;4;31;.886;3555000;0
10518;-1;221;83;26;1;25;.962;3600000;0
10518;189885;225;76;43;3;40;.930;3600000;0
10518;184785;225;0;0;0;0;.00nan;0;0
10518;187362;221;0;0;0;0;.00nan;0;0
10513;-1;210;0;0;0;0;.00nan;0;0
10513;187232;216;0;0;0;0;.00nan;0;0
10513;187240;216;75;39;3;36;.923;3600000;0
10513;192461;210;63;18;2;16;.889;3600000;0
10529;173340;231;86;34;1;33;.971;3600000;0
10529;170144;227;55;32;4;28;.875;3600000;0
10529;-1;227;0;0;0;0;.00nan;0;0
10529;185034;231;0;0;0;0;.00nan;0;0
10498;169096;190;53;44;6;38;.864;3600000;0
10498;173823;198;44;17;3;14;.824;3600000;0
10498;184788;190;0;0;0;0;.00nan;0;0
10498;181431;198;0;0;0;0;.00nan;0;0
10532;170963;185;66;25;2;23;.920;3662000;0
10532;175842;214;0;0;0;0;.00nan;0;0
10532;180110;185;0;0;0;0;.00nan;0;0
10532;-1;214;75;41;3;38;.927;3662000;0
10495;168954;228;69;39;4;35;.897;3600000;0
10495;170300;228;0;0;0;0;.00nan;0;0
10495;173916;230;0;0;0;0;.00nan;0;0
10495;186495;230;87;30;1;29;.967;3600000;0
10536;171405;2620;0;0;0;0;.00nan;0;0
10536;171660;209;0;0;0;0;.00nan;0;0
10536;176921;2620;82;36;3;33;.917;3900000;0
10536;186205;209;68;33;3;30;.909;3900000;0
10714;-1;221;0;0;0;0;.00nan;0;0
10714;179406;232;78;28;2;26;.929;3600000;0
10714;179434;232;0;0;0;0;.00nan;0;0
10714;187362;221;62;27;3;24;.889;3543000;0
10571;170144;227;0;0;0;0;.00nan;0;0
10571;-1;227;72;21;1;20;.952;3600000;0
10571;175423;223;64;35;4;31;.886;3600000;0
10571;-1;223;0;0;0;0;.00nan;0;0
10508;168954;228;0;0;0;0;.00nan;0;0
10508;184175;224;97;48;2;46;.958;3585000;0
10508;170300;228;63;20;1;19;.950;3600000;0
10508;-1;224;0;0;0;0;.00nan;0;0
10587;-1;202;0;0;0;0;.00nan;0;0
10587;-1;203;41;36;5;31;.861;3600000;0
10587;-1;203;0;0;0;0;.00nan;0;0
10587;180623;202;100;30;0;30;1.000;3600000;0
10601;166545;193;100;29;0;29;1.000;3600000;0
10601;189081;187;0;0;0;0;.00nan;0;0
10601;173770;193;0;0;0;0;.00nan;0;0
10601;-1;187;54;28;3;25;.893;3600000;0
10586;182454;4864;0;0;0;0;.00nan;0;0
10586;183737;4864;87;42;3;39;.929;3600000;0
10586;171405;2620;0;0;0;0;.00nan;0;0
10586;176921;2620;50;34;4;30;.882;3560000;0
11627;166451;176;0;0;0;0;.00nan;0;0
11627;183860;4959;0;0;0;0;.00nan;0;0
11627;170114;4959;49;27;4;23;.852;3600000;0
11627;171662;176;100;30;0;30;1.000;3600000;0
10528;-1;210;44;25;4;21;.840;3600000;0
10528;175328;183;32;28;5;23;.821;3578000;0
10528;182089;183;0;0;0;0;.00nan;0;0
10528;192461;210;0;0;0;0;.00nan;0;0
10505;173823;198;0;0;0;0;.00nan;0;0
10505;174153;188;0;0;0;0;.00nan;0;0
10505;-1;188;70;38;5;33;.868;3588000;0
10505;181431;198;66;32;4;28;.875;3600000;0
10445;168117;192;0;0;0;0;.00nan;0;0
10445;-1;197;70;51;5;46;.902;3600000;0
10445;170189;197;0;0;0;0;.00nan;0;0
10445;175900;192;88;12;0;12;1.000;3600000;0
10653;171730;220;75;35;3;32;.914;3600000;0
10653;190125;184;0;0;0;0;.00nan;0;0
10653;179668;184;49;31;4;27;.871;3549000;0
10653;187443;220;0;0;0;0;.00nan;0;0
10474;189885;225;0;0;0;0;.00nan;0;0
10474;175436;229;0;0;0;0;.00nan;0;0
10474;184785;225;66;35;4;31;.886;3600000;0
10474;176860;229;95;34;1;33;.971;3600000;0
10554;167404;215;78;45;4;41;.911;3600000;0
10554;168907;186;0;0;0;0;.00nan;0;0
10554;169226;186;38;27;5;22;.815;3573000;0
10554;161046;215;0;0;0;0;.00nan;0;0
10486;168995;205;0;0;0;0;.00nan;0;0
10486;170141;200;0;0;0;0;.00nan;0;0
10486;-1;205;57;28;2;26;.929;3600000;0
10486;187295;200;88;27;1;26;.963;3600000;0
10769;169096;190;0;0;0;0;.00nan;0;0
10769;-1;196;31;15;4;11;.733;1108000;0
10769;184648;196;72;29;2;27;.931;2492000;0
10769;184788;190;81;30;1;29;.967;3600000;0
10770;175364;206;0;0;0;0;.00nan;0;0
10770;175371;206;41;38;6;32;.842;3733000;0
10770;-1;207;0;0;0;0;.00nan;0;0
10770;-1;207;29;20;5;15;.750;3734000;0
11546;169166;226;73;28;3;25;.893;3600000;0
11546;174334;208;62;36;4;32;.889;3542000;0
11546;179702;208;0;0;0;0;.00nan;0;0
11546;192629;226;0;0;0;0;.00nan;0;0
11549;-1;1371;75;20;1;19;.950;3600000;0
11549;175842;214;74;41;4;37;.902;3600000;0
11549;-1;214;0;0;0;0;.00nan;0;0
11549;192688;1371;0;0;0;0;.00nan;0;0
10464;168966;189;0;0;0;0;.00nan;0;0
10464;170351;194;0;0;0;0;.00nan;0;0
10464;-1;194;53;36;5;31;.861;3600000;0
10464;176915;189;72;19;1;18;.947;3600000;0
10533;-1;4949;61;17;1;16;.941;3600000;0
10533;168912;4949;0;0;0;0;.00nan;0;0
10533;187232;216;0;0;0;0;.00nan;0;0
10533;187240;216;100;31;0;31;1.000;3600000;0
11208;-1;211;53;21;3;18;.857;3649000;0
11208;168907;186;77;34;2;32;.941;3649000;0
11208;169226;186;0;0;0;0;.00nan;0;0
11208;179646;211;0;0;0;0;.00nan;0;0
10447;176770;219;79;37;3;34;.919;3600000;0
10447;179679;212;0;0;0;0;.00nan;0;0
10447;181102;219;0;0;0;0;.00nan;0;0
10447;186641;212;86;20;0;20;1.000;3600000;0
10655;166762;213;70;24;2;22;.917;3519000;0
10655;174209;178;0;0;0;0;.00nan;0;0
10655;176963;178;100;29;0;29;1.000;3600000;0
10655;180575;213;0;0;0;0;.00nan;0;0
10771;173900;182;0;0;0;0;.00nan;0;0
10771;-1;1371;0;0;0;0;.00nan;0;0
10771;182116;182;100;26;0;26;1.000;3600000;0
10771;192688;1371;73;33;3;30;.909;3600000;0
11656;177248;201;0;0;0;0;.00nan;0;0
11656;-1;202;0;0;0;0;.00nan;0;0
11656;180623;202;79;31;2;29;.935;3587000;0
11656;185743;201;100;23;0;23;1.000;3600000;0
10965;171819;177;0;0;0;0;.00nan;0;0
10965;-1;210;0;0;0;0;.00nan;0;0
10965;179602;177;55;35;5;30;.857;3600000;0
10965;192461;210;71;27;2;25;.926;3600000;0
11667;-1;203;0;0;0;0;.00nan;0;0
11667;175370;199;84;29;1;28;.966;3600000;0
11667;-1;203;97;54;2;52;.963;3599000;0
11667;161006;199;0;0;0;0;.00nan;0;0
10669;166451;176;0;0;0;0;.00nan;0;0
10669;171405;2620;0;0;0;0;.00nan;0;0
10669;171662;176;89;52;4;48;.923;3600000;0
10669;176921;2620;98;24;0;24;1.000;3600000;0
10483;170076;179;65;37;4;33;.892;3600000;0
10483;174147;179;0;0;0;0;.00nan;0;0
10483;180762;1505;0;0;0;0;.00nan;0;0
10483;186549;1505;96;34;1;33;.971;3600000;0
10776;-1;197;100;48;3;45;.938;3900000;0
10776;168966;189;0;0;0;0;.00nan;0;0
10776;170189;197;0;0;0;0;.00nan;0;0
10776;176915;189;42;18;3;15;.833;3900000;0
10517;168954;228;77;31;2;29;.935;3600000;0
10517;170300;228;0;0;0;0;.00nan;0;0
10517;184610;222;0;0;0;0;.00nan;0;0
10517;-1;222;82;32;3;29;.906;3591000;0
11593;168117;192;0;0;0;0;.00nan;0;0
11593;173823;198;54;26;3;23;.885;3561000;0
11593;175900;192;67;17;1;16;.941;3600000;0
11593;181431;198;0;0;0;0;.00nan;0;0
11594;173340;231;66;27;2;25;.926;3600000;0
11594;170144;227;86;28;1;27;.964;3600000;0
11594;-1;227;0;0;0;0;.00nan;0;0
11594;185034;231;0;0;0;0;.00nan;0;0
10501;166695;218;41;25;5;20;.800;3572000;0
10501;-1;218;0;0;0;0;.00nan;0;0
10501;175723;180;0;0;0;0;.00nan;0;0
10501;176938;180;68;29;3;26;.897;3600000;0
11625;189081;187;77;26;2;24;.923;3600000;0
11625;170351;194;70;30;3;27;.900;3566000;0
11625;-1;194;0;0;0;0;.00nan;0;0
11625;-1;187;0;0;0;0;.00nan;0;0
11634;166545;193;78;36;3;33;.917;3572000;0
11634;173770;193;0;0;0;0;.00nan;0;0
11634;173823;198;0;0;0;0;.00nan;0;0
11634;181431;198;81;24;1;23;.958;3600000;0
10520;168995;205;62;20;2;18;.900;3600000;0
10520;175364;206;82;47;3;44;.936;3543000;0
10520;175371;206;0;0;0;0;.00nan;0;0
10520;-1;205;0;0;0;0;.00nan;0;0
11366;168966;189;59;45;6;39;.867;3326000;0
11366;170202;195;0;0;0;0;.00nan;0;0
11366;176200;195;89;27;1;26;.963;3600000;0
11366;176915;189;51;2;0;2;1.000;274000;0
10559;167404;215;0;0;0;0;.00nan;0;0
10559;-1;211;88;33;1;32;.970;3579000;0
10559;179646;211;0;0;0;0;.00nan;0;0
10559;161046;215;100;33;0;33;1.000;3600000;0
11676;169166;226;60;29;3;26;.897;3587000;0
11676;175370;199;0;0;0;0;.00nan;0;0
11676;192629;226;0;0;0;0;.00nan;0;0
11676;161006;199;76;31;2;29;.935;3600000;0
10488;171970;217;81;39;2;37;.949;3563000;0
10488;168907;186;0;0;0;0;.00nan;0;0
10488;169226;186;100;27;0;27;1.000;3600000;0
10488;171654;217;0;0;0;0;.00nan;0;0
10671;174209;178;0;0;0;0;.00nan;0;0
10671;176963;178;69;29;2;27;.931;3600000;0
10671;187232;216;0;0;0;0;.00nan;0;0
10671;187240;216;39;18;4;14;.778;3542000;0
10541;184175;224;96;50;2;48;.960;3900000;0
10541;-1;224;0;0;0;0;.00nan;0;0
10541;-1;221;82;34;2;32;.941;3900000;0
10541;187362;221;0;0;0;0;.00nan;0;0
10677;171730;220;68;26;3;23;.885;3560000;0
10677;-1;1371;100;52;2;50;.962;3600000;0
10677;187443;220;0;0;0;0;.00nan;0;0
10677;192688;1371;0;0;0;0;.00nan;0;0
10616;170144;227;0;0;0;0;.00nan;0;0
10616;173916;230;0;0;0;0;.00nan;0;0
10616;-1;227;49;31;4;27;.871;3563000;0
10616;186495;230;87;33;2;31;.939;3600000;0
10667;-1;202;65;41;4;37;.902;3900000;0
10667;-1;203;68;47;4;43;.915;3900000;0
10667;-1;203;0;0;0;0;.00nan;0;0
10667;180623;202;0;0;0;0;.00nan;0;0
10535;176770;219;42;33;5;28;.848;3600000;0
10535;179679;212;0;0;0;0;.00nan;0;0
10535;181102;219;0;0;0;0;.00nan;0;0
10535;186641;212;95;22;0;22;1.000;3600000;0
10504;182454;4864;46;32;5;27;.844;3582000;0
10504;183737;4864;0;0;0;0;.00nan;0;0
10504;171660;209;77;35;3;32;.914;3600000;0
10504;186205;209;0;0;0;0;.00nan;0;0
10593;189885;225;79;38;3;35;.921;3900000;0
10593;175436;229;0;0;0;0;.00nan;0;0
10593;184785;225;0;0;0;0;.00nan;0;0
10593;176860;229;59;28;3;25;.893;3900000;0
10525;177248;201;0;0;0;0;.00nan;0;0
10525;170141;200;0;0;0;0;.00nan;0;0
10525;185743;201;53;29;4;25;.862;3565000;0
10525;187295;200;77;27;2;25;.926;3600000;0
10708;170076;179;0;0;0;0;.00nan;0;0
10708;174147;179;62;30;3;27;.900;3600000;0
10708;175328;183;0;0;0;0;.00nan;0;0
10708;182089;183;57;51;6;45;.882;3600000;0
10503;166451;176;58;32;4;28;.875;3688000;0
10503;183860;4959;0;0;0;0;.00nan;0;0
10503;170114;4959;59;41;5;36;.878;3688000;0
10503;171662;176;0;0;0;0;.00nan;0;0
10712;173900;182;0;0;0;0;.00nan;0;0
10712;170963;185;59;23;3;20;.870;3583000;0
10712;180110;185;0;0;0;0;.00nan;0;0
10712;182116;182;99;38;1;37;.974;3600000;0
10621;173916;230;32;17;4;13;.765;3900000;0
10621;175423;223;0;0;0;0;.00nan;0;0
10621;-1;223;63;38;4;34;.895;3900000;0
10621;186495;230;0;0;0;0;.00nan;0;0
10491;174334;208;72;18;1;17;.944;3600000;0
10491;179702;208;0;0;0;0;.00nan;0;0
10491;-1;207;69;37;3;34;.919;3587000;0
10491;-1;207;0;0;0;0;.00nan;0;0
10656;171819;177;0;0;0;0;.00nan;0;0
10656;-1;4949;0;0;0;0;.00nan;0;0
10656;168912;4949;29;19;5;14;.737;3600000;0
10656;179602;177;68;49;6;43;.878;3515000;0
10638;168995;205;45;5;1;4;.800;524000;0
10638;175364;206;77;31;2;29;.935;3600000;0
10638;175371;206;0;0;0;0;.00nan;0;0
10638;-1;205;40;41;6;35;.854;3076000;0
10546;-1;197;99;38;1;37;.974;3600000;0
10546;170189;197;0;0;0;0;.00nan;0;0
10546;170351;194;76;29;2;27;.931;3588000;0
10546;-1;194;0;0;0;0;.00nan;0;0
10531;177248;201;56;24;3;21;.875;3600000;0
10531;170141;200;100;36;0;36;1.000;3600000;0
10531;185743;201;0;0;0;0;.00nan;0;0
10531;187295;200;0;0;0;0;.00nan;0;0
10460;187628;191;0;0;0;0;.00nan;0;0
10460;170202;195;100;32;0;32;1.000;3600000;0
10460;176200;195;0;0;0;0;.00nan;0;0
10460;185960;191;47;27;4;23;.852;3600000;0
10485;171970;217;0;0;0;0;.00nan;0;0
10485;168907;186;0;0;0;0;.00nan;0;0
10485;169226;186;84;40;3;37;.925;3900000;0
10485;171654;217;57;33;3;30;.909;3895000;0
10570;-1;210;70;39;3;36;.923;3595000;0
10570;180762;1505;65;22;2;20;.909;3600000;0
10570;186549;1505;0;0;0;0;.00nan;0;0
10570;192461;210;0;0;0;0;.00nan;0;0
10462;166545;193;0;0;0;0;.00nan;0;0
10462;168117;192;0;0;0;0;.00nan;0;0
10462;173770;193;57;26;3;23;.885;3587000;0
10462;175900;192;88;29;2;27;.931;3600000;0
10549;174153;188;0;0;0;0;.00nan;0;0
10549;-1;196;0;0;0;0;.00nan;0;0
10549;-1;188;57;15;2;13;.867;3600000;0
10549;184648;196;77;55;6;49;.891;3600000;0
10563;173340;231;61;20;2;18;.900;3634000;0
10563;-1;221;0;0;0;0;.00nan;0;0
10563;185034;231;0;0;0;0;.00nan;0;0
10563;187362;221;94;47;3;44;.936;3634000;0
10551;167404;215;0;0;0;0;.00nan;0;0
10551;179679;212;0;0;0;0;.00nan;0;0
10551;186641;212;94;20;0;20;1.000;3600000;0
10551;161046;215;78;44;3;41;.932;3600000;0
10538;184175;224;0;0;0;0;.00nan;0;0
10538;-1;224;35;35;6;29;.829;3600000;0
10538;184610;222;55;18;2;16;.889;3600000;0
10538;-1;222;0;0;0;0;.00nan;0;0
10475;183860;4959;51;14;2;12;.857;3600000;0
10475;170114;4959;0;0;0;0;.00nan;0;0
10475;171660;209;0;0;0;0;.00nan;0;0
10475;186205;209;64;31;3;28;.903;3574000;0
10455;-1;202;53;39;5;34;.872;3600000;0
10455;180623;202;0;0;0;0;.00nan;0;0
10455;182049;204;68;23;2;21;.913;3600000;0
10455;141765;204;0;0;0;0;.00nan;0;0
10690;171730;220;0;0;0;0;.00nan;0;0
10690;190125;184;68;19;1;18;.947;3600000;0
10690;179668;184;0;0;0;0;.00nan;0;0
10690;187443;220;91;41;3;38;.927;3600000;0
10598;168954;228;55;37;5;32;.865;3600000;0
10598;170300;228;0;0;0;0;.00nan;0;0
10598;179406;232;82;24;1;23;.958;3600000;0
10598;179434;232;0;0;0;0;.00nan;0;0
10519;173900;182;0;0;0;0;.00nan;0;0
10519;171615;181;69;22;1;21;.955;3546000;0
10519;182116;182;100;21;0;21;1.000;3600000;0
10519;-1;181;0;0;0;0;.00nan;0;0
11223;189081;187;0;0;0;0;.00nan;0;0
11223;169096;190;100;48;2;46;.958;3900000;0
11223;184788;190;0;0;0;0;.00nan;0;0
11223;-1;187;46;19;2;17;.895;3900000;0
10516;166695;218;0;0;0;0;.00nan;0;0
10516;-1;218;98;48;3;45;.938;3542000;0
10516;175723;180;0;0;0;0;.00nan;0;0
10516;176938;180;100;38;2;36;.947;3600000;0
11635;166762;213;0;0;0;0;.00nan;0;0
11635;174209;178;68;30;3;27;.900;2656000;0
11635;176963;178;47;18;4;14;.778;944000;0
11635;180575;213;49;27;5;22;.815;3600000;0
10590;189885;225;0;0;0;0;.00nan;0;0
10590;175436;229;0;0;0;0;.00nan;0;0
10590;184785;225;95;37;1;36;.973;3600000;0
10590;176860;229;74;32;2;30;.938;3582000;0
10545;187628;191;55;11;1;10;.909;3600000;0
10545;170351;194;0;0;0;0;.00nan;0;0
10545;-1;194;97;54;2;52;.963;3592000;0
10545;185960;191;0;0;0;0;.00nan;0;0
10613;170963;185;30;31;6;25;.806;3600000;0
10613;190125;184;0;0;0;0;.00nan;0;0
10613;179668;184;75;30;2;28;.933;3600000;0
10613;180110;185;0;0;0;0;.00nan;0;0
10648;173823;198;100;23;0;23;1.000;3600000;0
10648;-1;196;88;44;4;40;.909;3600000;0
10648;184648;196;0;0;0;0;.00nan;0;0
10648;181431;198;0;0;0;0;.00nan;0;0
10530;171615;181;0;0;0;0;.00nan;0;0
10530;175842;214;0;0;0;0;.00nan;0;0
10530;-1;181;77;23;1;22;.957;3600000;0
10530;-1;214;61;38;4;34;.895;3600000;0
11584;170076;179;69;18;1;17;.944;3600000;0
11584;174147;179;0;0;0;0;.00nan;0;0
11584;175328;183;74;54;5;49;.907;3600000;0
11584;182089;183;0;0;0;0;.00nan;0;0
10509;166695;218;0;0;0;0;.00nan;0;0
10509;-1;211;70;23;1;22;.957;3600000;0
10509;-1;218;93;41;2;39;.951;3545000;0
10509;179646;211;0;0;0;0;.00nan;0;0
11613;171819;177;0;0;0;0;.00nan;0;0
11613;179602;177;97;26;0;26;1.000;3600000;0
11613;187232;216;0;0;0;0;.00nan;0;0
11613;187240;216;59;31;3;28;.903;3600000;0
10665;171835;4960;70;21;1;20;.952;3600000;0
10665;187660;4960;0;0;0;0;.00nan;0;0
10665;175423;223;92;51;4;47;.922;3600000;0
10665;-1;223;0;0;0;0;.00nan;0;0
10768;170144;227;71;24;2;22;.917;3600000;0
10768;-1;227;0;0;0;0;.00nan;0;0
10768;179406;232;0;0;0;0;.00nan;0;0
10768;179434;232;98;54;3;51;.944;3543000;0
10654;-1;203;69;20;1;19;.950;3600000;0
10654;175364;206;67;50;5;45;.900;3600000;0
10654;175371;206;0;0;0;0;.00nan;0;0
10654;-1;203;0;0;0;0;.00nan;0;0
11535;171730;220;0;0;0;0;.00nan;0;0
11535;-1;1371;0;0;0;0;.00nan;0;0
11535;187443;220;73;28;2;26;.929;3551000;0
11535;192688;1371;72;22;1;21;.955;3600000;0
11604;175723;180;0;0;0;0;.00nan;0;0
11604;176938;180;97;32;1;31;.969;3600000;0
11604;179679;212;0;0;0;0;.00nan;0;0
11604;186641;212;60;24;2;22;.917;3573000;0
10561;166762;213;97;46;2;44;.957;3565000;0
10561;180575;213;0;0;0;0;.00nan;0;0
10561;180762;1505;88;18;0;18;1.000;3600000;0
10561;186549;1505;0;0;0;0;.00nan;0;0
10562;170141;200;91;59;6;53;.898;3600000;0
10562;175370;199;41;18;3;15;.833;3600000;0
10562;187295;200;0;0;0;0;.00nan;0;0
10562;161006;199;0;0;0;0;.00nan;0;0
10618;189081;187;0;0;0;0;.00nan;0;0
10618;-1;197;94;61;2;59;.967;3636000;0
10618;170189;197;0;0;0;0;.00nan;0;0
10618;-1;187;80;26;1;25;.962;3636000;0
10552;-1;4949;71;32;3;29;.906;3600000;0
10552;168912;4949;0;0;0;0;.00nan;0;0
10552;170076;179;0;0;0;0;.00nan;0;0
10552;174147;179;63;36;4;32;.889;3558000;0
10556;166451;176;100;43;1;42;.977;3600000;0
10556;171660;209;67;36;3;33;.917;3526000;0
10556;171662;176;0;0;0;0;.00nan;0;0
10556;186205;209;0;0;0;0;.00nan;0;0
10575;173340;231;48;17;3;14;.824;3600000;0
10575;-1;221;86;40;2;38;.950;3600000;0
10575;185034;231;0;0;0;0;.00nan;0;0
10575;187362;221;0;0;0;0;.00nan;0;0
10633;173900;182;0;0;0;0;.00nan;0;0
10633;175842;214;35;33;6;27;.818;3600000;0
10633;182116;182;87;29;1;28;.966;3600000;0
10633;-1;214;0;0;0;0;.00nan;0;0
10544;170202;195;77;22;1;21;.955;3600000;0
10544;174153;188;0;0;0;0;.00nan;0;0
10544;-1;188;88;43;3;40;.930;3600000;0
10544;176200;195;0;0;0;0;.00nan;0;0
10557;171835;4960;0;0;0;0;.00nan;0;0
10557;187660;4960;56;29;3;26;.897;3900000;0
10557;184610;222;0;0;0;0;.00nan;0;0
10557;-1;222;93;46;3;43;.935;3900000;0
10465;168117;192;87;14;0;14;1.000;3600000;0
10465;168966;189;0;0;0;0;.00nan;0;0
10465;175900;192;0;0;0;0;.00nan;0;0
10465;176915;189;85;54;4;50;.926;3600000;0
10466;169166;226;71;25;1;24;.960;3600000;0
10466;174334;208;70;37;3;34;.919;3600000;0
10466;179702;208;0;0;0;0;.00nan;0;0
10466;192629;226;0;0;0;0;.00nan;0;0
10523;168954;228;86;30;2;28;.933;3900000;0
10523;170300;228;0;0;0;0;.00nan;0;0
10523;175436;229;0;0;0;0;.00nan;0;0
10523;176860;229;66;25;2;23;.920;3900000;0
10484;171970;217;81;42;3;39;.929;3600000;0
10484;171654;217;0;0;0;0;.00nan;0;0
10484;176770;219;100;25;0;25;1.000;3600000;0
10484;181102;219;0;0;0;0;.00nan;0;0
10604;182454;4864;0;0;0;0;.00nan;0;0
10604;183737;4864;60;25;3;22;.880;3900000;0
10604;171405;2620;0;0;0;0;.00nan;0;0
10604;176921;2620;75;35;3;32;.914;3900000;0
10605;166545;193;74;33;3;30;.909;3575000;0
10605;173770;193;0;0;0;0;.00nan;0;0
10605;173823;198;57;18;2;16;.889;3600000;0
10605;181431;198;0;0;0;0;.00nan;0;0
10574;180762;1505;76;30;1;29;.967;3600000;0
10574;186549;1505;0;0;0;0;.00nan;0;0
10574;187232;216;43;28;5;23;.821;3600000;0
10574;187240;216;0;0;0;0;.00nan;0;0
10875;166695;218;0;0;0;0;.00nan;0;0
10875;-1;218;75;41;4;37;.902;3600000;0
10875;176770;219;95;24;0;24;1.000;3600000;0
10875;181102;219;0;0;0;0;.00nan;0;0
10567;187628;191;0;0;0;0;.00nan;0;0
10567;174153;188;76;50;5;45;.900;3783000;0
10567;-1;188;0;0;0;0;.00nan;0;0
10567;185960;191;49;30;4;26;.867;3783000;0
10699;174209;178;0;0;0;0;.00nan;0;0
10699;175328;183;0;0;0;0;.00nan;0;0
10699;176963;178;62;35;4;31;.886;3900000;0
10699;182089;183;52;36;4;32;.889;3900000;0
10457;169166;226;0;0;0;0;.00nan;0;0
10457;182049;204;53;41;5;36;.878;3582000;0
10457;192629;226;61;28;3;25;.893;3600000;0
10457;141765;204;0;0;0;0;.00nan;0;0
10480;-1;202;100;30;0;30;1.000;3600000;0
10480;174334;208;67;40;4;36;.900;3600000;0
10480;179702;208;0;0;0;0;.00nan;0;0
10480;180623;202;0;0;0;0;.00nan;0;0
10522;182454;4864;61;19;2;17;.895;3600000;0
10522;183737;4864;0;0;0;0;.00nan;0;0
10522;183860;4959;0;0;0;0;.00nan;0;0
10522;170114;4959;63;42;4;38;.905;3600000;0
10720;173916;230;0;0;0;0;.00nan;0;0
10720;189885;225;73;50;4;46;.920;3600000;0
10720;184785;225;0;0;0;0;.00nan;0;0
10720;186495;230;52;20;3;17;.850;3600000;0
10524;168966;189;0;0;0;0;.00nan;0;0
10524;170202;195;0;0;0;0;.00nan;0;0
10524;176200;195;51;8;1;7;.875;3600000;0
10524;176915;189;61;36;4;32;.889;3600000;0
10548;171615;181;0;0;0;0;.00nan;0;0
10548;171730;220;58;37;5;32;.865;3600000;0
10548;-1;181;89;26;1;25;.962;3600000;0
10548;187443;220;0;0;0;0;.00nan;0;0
10723;177248;201;0;0;0;0;.00nan;0;0
10723;-1;203;0;0;0;0;.00nan;0;0
10723;-1;203;91;46;2;44;.957;3600000;0
10723;185743;201;52;20;3;17;.850;3549000;0
10555;-1;197;35;30;6;24;.800;2506000;0
10555;169096;190;80;12;0;12;1.000;3600000;0
10555;170189;197;43;12;2;10;.833;1094000;0
10555;184788;190;0;0;0;0;.00nan;0;0
10676;166451;176;0;0;0;0;.00nan;0;0
10676;171405;2620;0;0;0;0;.00nan;0;0
10676;171662;176;78;43;4;39;.907;3600000;0
10676;176921;2620;98;31;1;30;.968;3600000;0
10585;167404;215;0;0;0;0;.00nan;0;0
10585;179679;212;43;34;5;29;.853;3600000;0
10585;186641;212;0;0;0;0;.00nan;0;0
10585;161046;215;100;34;0;34;1.000;3600000;0
10657;168954;228;0;0;0;0;.00nan;0;0
10657;170300;228;100;34;0;34;1.000;3600000;0
10657;179406;232;77;27;2;25;.926;3568000;0
10657;179434;232;0;0;0;0;.00nan;0;0
10622;166545;193;0;0;0;0;.00nan;0;0
10622;173770;193;84;14;0;14;1.000;3600000;0
10622;170351;194;24;43;8;35;.814;3193000;0
10622;-1;194;50;1;0;1;1.000;407000;0
10928;-1;211;79;38;3;35;.921;3600000;0
10928;168907;186;35;13;3;10;.769;1228000;0
10928;169226;186;36;21;4;17;.810;2372000;0
10928;179646;211;0;0;0;0;.00nan;0;0
10628;170144;227;0;0;0;0;.00nan;0;0
10628;-1;227;83;30;1;29;.967;3600000;0
10628;184610;222;60;37;4;33;.892;3600000;0
10628;-1;222;0;0;0;0;.00nan;0;0
11659;-1;202;65;29;3;26;.897;3593000;0
11659;175364;206;79;31;2;29;.935;3600000;0
11659;175371;206;0;0;0;0;.00nan;0;0
11659;180623;202;0;0;0;0;.00nan;0;0
10521;168117;192;52;31;5;26;.839;3544000;0
10521;189081;187;0;0;0;0;.00nan;0;0
10521;175900;192;0;0;0;0;.00nan;0;0
10521;-1;187;48;27;4;23;.852;3600000;0
10810;168995;205;87;46;2;44;.957;3600000;0
10810;175370;199;55;23;3;20;.870;3546000;0
10810;-1;205;0;0;0;0;.00nan;0;0
10810;161006;199;0;0;0;0;.00nan;0;0
10543;166695;218;0;0;0;0;.00nan;0;0
10543;-1;218;96;30;1;29;.967;3900000;0
10543;175723;180;0;0;0;0;.00nan;0;0
10543;176938;180;92;30;1;29;.967;3900000;0
10581;171835;4960;100;39;0;39;1.000;3600000;0
10581;187660;4960;0;0;0;0;.00nan;0;0
10581;173340;231;0;0;0;0;.00nan;0;0
10581;185034;231;29;22;5;17;.773;3600000;0
11668;171970;217;74;33;3;30;.909;3518000;0
11668;168907;186;0;0;0;0;.00nan;0;0
11668;169226;186;74;22;1;21;.955;3600000;0
11668;171654;217;0;0;0;0;.00nan;0;0
10636;184175;224;88;44;3;41;.932;3536000;0
10636;-1;224;0;0;0;0;.00nan;0;0
10636;175423;223;0;0;0;0;.00nan;0;0
10636;-1;223;75;25;1;24;.960;3600000;0
11305;170141;200;0;0;0;0;.00nan;0;0
11305;-1;207;55;19;2;17;.895;3600000;0
11305;187295;200;74;39;3;36;.923;3600000;0
11305;-1;207;0;0;0;0;.00nan;0;0
10534;166762;213;83;17;1;16;.941;3600000;0
10534;175328;183;42;40;5;35;.875;3600000;0
10534;180575;213;0;0;0;0;.00nan;0;0
10534;182089;183;0;0;0;0;.00nan;0;0
10607;171819;177;0;0;0;0;.00nan;0;0
10607;-1;4949;0;0;0;0;.00nan;0;0
10607;168912;4949;66;27;3;24;.889;3900000;0
10607;179602;177;73;34;3;31;.912;3900000;0
10705;-1;1371;62;28;3;25;.893;3551000;0
10705;190125;184;80;34;2;32;.941;3600000;0
10705;179668;184;0;0;0;0;.00nan;0;0
10705;192688;1371;0;0;0;0;.00nan;0;0
10642;170963;185;0;0;0;0;.00nan;0;0
10642;175842;214;0;0;0;0;.00nan;0;0
10642;180110;185;84;30;1;29;.967;3600000;0
10642;-1;214;62;46;5;41;.891;3600000;0
10718;170076;179;86;34;2;32;.941;3633000;0
10718;174147;179;0;0;0;0;.00nan;0;0
10718;187232;216;0;0;0;0;.00nan;0;0
10718;187240;216;89;29;1;28;.966;3633000;0
11164;175370;199;0;0;0;0;.00nan;0;0
11164;-1;207;0;0;0;0;.00nan;0;0
11164;-1;207;63;29;3;26;.897;3600000;0
11164;161006;199;100;35;0;35;1.000;3600000;0
11626;171405;2620;0;0;0;0;.00nan;0;0
11626;171660;209;34;23;5;18;.783;3600000;0
11626;176921;2620;67;23;2;21;.913;3600000;0
11626;186205;209;0;0;0;0;.00nan;0;0
10569;168966;189;0;0;0;0;.00nan;0;0
10569;173823;198;65;15;1;14;.933;3600000;0
10569;176915;189;96;46;3;43;.935;3600000;0
10569;181431;198;0;0;0;0;.00nan;0;0
11648;182454;4864;0;0;0;0;.00nan;0;0
11648;183737;4864;77;24;1;23;.958;3600000;0
11648;166451;176;51;32;4;28;.875;3600000;0
11648;171662;176;0;0;0;0;.00nan;0;0
10781;171819;177;0;0;0;0;.00nan;0;0
10781;174209;178;0;0;0;0;.00nan;0;0
10781;179602;177;99;39;1;38;.974;3600000;0
10781;176963;178;75;28;2;26;.929;3568000;0
10502;169166;226;91;34;1;33;.971;3600000;0
10502;182049;204;18;8;4;4;.500;845000;0
10502;192629;226;0;0;0;0;.00nan;0;0
10502;141765;204;73;25;1;24;.960;2755000;0
10608;175723;180;0;0;0;0;.00nan;0;0
10608;176770;219;85;38;2;36;.947;3600000;0
10608;176938;180;57;29;3;26;.897;3564000;0
10608;181102;219;0;0;0;0;.00nan;0;0
11615;170144;227;60;19;3;16;.842;3600000;0
11615;-1;227;0;0;0;0;.00nan;0;0
11615;175436;229;0;0;0;0;.00nan;0;0
11615;176860;229;66;44;5;39;.886;3571000;0
11677;184175;224;0;0;0;0;.00nan;0;0
11677;-1;224;52;36;4;32;.889;3600000;0
11677;184610;222;0;0;0;0;.00nan;0;0
11677;-1;222;98;21;0;21;1.000;3600000;0
10876;166762;213;0;0;0;0;.00nan;0;0
10876;-1;210;0;0;0;0;.00nan;0;0
10876;180575;213;60;41;5;36;.878;3600000;0
10876;192461;210;71;19;1;18;.947;3600000;0
11652;182454;4864;82;36;2;34;.944;3600000;0
11652;183737;4864;0;0;0;0;.00nan;0;0
11652;183860;4959;0;0;0;0;.00nan;0;0
11652;170114;4959;90;21;1;20;.952;3600000;0
10629;-1;4949;55;37;5;32;.865;2212000;0
10629;168912;4949;70;11;0;11;1.000;1388000;0
10629;180762;1505;71;26;2;24;.923;3600000;0
10629;186549;1505;0;0;0;0;.00nan;0;0
10713;-1;1371;0;0;0;0;.00nan;0;0
10713;190125;184;66;30;3;27;.900;3600000;0
10713;179668;184;0;0;0;0;.00nan;0;0
10713;192688;1371;80;46;4;42;.913;3568000;0
10727;173916;230;0;0;0;0;.00nan;0;0
10727;-1;221;27;37;7;30;.811;3600000;0
10727;186495;230;94;18;0;18;1.000;3600000;0
10727;187362;221;0;0;0;0;.00nan;0;0
10514;-1;203;100;33;0;33;1.000;3600000;0
10514;174334;208;66;25;2;23;.920;3526000;0
10514;179702;208;0;0;0;0;.00nan;0;0
10514;-1;203;0;0;0;0;.00nan;0;0
10662;166545;193;0;0;0;0;.00nan;0;0
10662;189081;187;90;33;1;32;.970;3900000;0
10662;173770;193;100;40;1;39;.975;3900000;0
10662;-1;187;0;0;0;0;.00nan;0;0
10675;173340;231;0;0;0;0;.00nan;0;0
10675;175423;223;95;52;3;49;.942;3600000;0
10675;185034;231;82;14;0;14;1.000;3600000;0
10675;-1;223;0;0;0;0;.00nan;0;0
10684;171835;4960;72;26;2;24;.923;3600000;0
10684;187660;4960;0;0;0;0;.00nan;0;0
10684;189885;225;69;44;4;40;.909;3527000;0
10684;184785;225;0;0;0;0;.00nan;0;0
10615;166695;218;0;0;0;0;.00nan;0;0
10615;-1;218;83;26;1;25;.962;3600000;0
10615;179679;212;0;0;0;0;.00nan;0;0
10615;186641;212;82;28;2;26;.929;3600000;0
11671;-1;202;60;29;3;26;.897;3578000;0
11671;175364;206;75;30;2;28;.933;3600000;0
11671;175371;206;0;0;0;0;.00nan;0;0
11671;180623;202;0;0;0;0;.00nan;0;0
10584;173900;182;0;0;0;0;.00nan;0;0
10584;171615;181;27;8;3;5;.625;973000;0
10584;182116;182;100;32;1;31;.969;3600000;0
10584;-1;181;26;29;6;23;.793;2627000;0
10597;169096;190;59;38;4;34;.895;3600000;0
10597;170202;195;0;0;0;0;.00nan;0;0
10597;184788;190;0;0;0;0;.00nan;0;0
10597;176200;195;83;14;0;14;1.000;3600000;0
10576;187628;191;0;0;0;0;.00nan;0;0
10576;-1;197;92;66;3;63;.955;3720000;0
10576;170189;197;0;0;0;0;.00nan;0;0
10576;185960;191;40;9;2;7;.778;3720000;0
10706;177248;201;0;0;0;0;.00nan;0;0
10706;169166;226;0;0;0;0;.00nan;0;0
10706;185743;201;100;27;0;27;1.000;3600000;0
10706;192629;226;83;42;3;39;.929;3600000;0
10698;170963;185;81;27;1;26;.963;3577000;0
10698;175842;214;100;33;0;33;1.000;3600000;0
10698;180110;185;0;0;0;0;.00nan;0;0
10698;-1;214;0;0;0;0;.00nan;0;0
10641;170144;227;59;28;3;25;.893;3544000;0
10641;-1;227;0;0;0;0;.00nan;0;0
10641;184610;222;0;0;0;0;.00nan;0;0
10641;-1;222;62;22;2;20;.909;3600000;0
10600;173340;231;0;0;0;0;.00nan;0;0
10600;179406;232;78;35;2;33;.943;3600000;0
10600;179434;232;0;0;0;0;.00nan;0;0
10600;185034;231;79;25;1;24;.960;3600000;0
10696;171835;4960;0;0;0;0;.00nan;0;0
10696;187660;4960;92;15;0;15;1.000;3600000;0
10696;175436;229;0;0;0;0;.00nan;0;0
10696;176860;229;69;50;5;45;.900;3600000;0
10873;170076;179;97;32;1;31;.969;3600000;0
10873;174147;179;0;0;0;0;.00nan;0;0
10873;174209;178;0;0;0;0;.00nan;0;0
10873;176963;178;91;43;4;39;.907;3600000;0
10612;169096;190;0;0;0;0;.00nan;0;0
10612;174153;188;0;0;0;0;.00nan;0;0
10612;-1;188;60;39;4;35;.897;3512000;0
10612;184788;190;79;32;2;30;.938;3600000;0
10644;167404;215;64;19;1;18;.947;2416000;0
10644;179679;212;68;38;4;34;.895;3600000;0
10644;186641;212;0;0;0;0;.00nan;0;0
10644;161046;215;19;9;4;5;.556;1135000;0
10609;-1;211;57;30;4;26;.867;3600000;0
10609;176770;219;83;34;3;31;.912;3600000;0
10609;179646;211;0;0;0;0;.00nan;0;0
10609;181102;219;0;0;0;0;.00nan;0;0
10635;-1;197;72;39;3;36;.923;3562000;0
10635;170189;197;0;0;0;0;.00nan;0;0
10635;-1;196;0;0;0;0;.00nan;0;0
10635;184648;196;92;29;1;28;.966;3600000;0
10683;-1;203;65;27;2;25;.926;3600000;0
10683;175364;206;39;23;4;19;.826;2254000;0
10683;175371;206;57;13;2;11;.846;1346000;0
10683;-1;203;0;0;0;0;.00nan;0;0
10497;168995;205;100;35;0;35;1.000;3600000;0
10497;174334;208;0;0;0;0;.00nan;0;0
10497;179702;208;62;30;4;26;.867;3600000;0
10497;-1;205;0;0;0;0;.00nan;0;0
10673;-1;202;0;0;0;0;.00nan;0;0
10673;175370;199;0;0;0;0;.00nan;0;0
10673;180623;202;82;39;3;36;.923;3513000;0
10673;161006;199;83;26;1;25;.962;3600000;0
10748;171730;220;53;4;0;4;1.000;745000;0
10748;-1;1371;92;27;1;26;.963;3600000;0
10748;187443;220;33;24;5;19;.792;2855000;0
10748;192688;1371;0;0;0;0;.00nan;0;0
10747;-1;4949;87;38;2;36;.947;3900000;0
10747;168912;4949;0;0;0;0;.00nan;0;0
10747;187232;216;54;19;2;17;.895;3900000;0
10747;187240;216;0;0;0;0;.00nan;0;0
10547;171970;217;69;38;3;35;.921;3600000;0
10547;171654;217;0;0;0;0;.00nan;0;0
10547;175723;180;0;0;0;0;.00nan;0;0
10547;176938;180;35;33;6;27;.818;3600000;0
10568;168117;192;0;0;0;0;.00nan;0;0
10568;173823;198;83;39;3;36;.923;3600000;0
10568;175900;192;36;23;4;19;.826;3589000;0
10568;181431;198;0;0;0;0;.00nan;0;0
10614;-1;207;100;24;0;24;1.000;3628000;0
10614;182049;204;94;36;1;35;.972;3628000;0
10614;-1;207;0;0;0;0;.00nan;0;0
10614;141765;204;0;0;0;0;.00nan;0;0
10819;170963;185;0;0;0;0;.00nan;0;0
10819;190125;184;47;14;2;12;.857;2444000;0
10819;179668;184;14;6;4;2;.333;1105000;0
10819;180110;185;39;30;5;25;.833;3600000;0
10664;184175;224;0;0;0;0;.00nan;0;0
10664;-1;224;82;40;3;37;.925;3596000;0
10664;175423;223;0;0;0;0;.00nan;0;0
10664;-1;223;71;29;2;27;.931;3600000;0
10589;-1;221;0;0;0;0;.00nan;0;0
10589;189885;225;0;0;0;0;.00nan;0;0
10589;184785;225;88;29;1;28;.966;3600000;0
10589;187362;221;47;18;3;15;.833;3576000;0
10661;171819;177;0;0;0;0;.00nan;0;0
10661;166762;213;100;38;0;38;1.000;3600000;0
10661;179602;177;77;30;2;28;.933;3573000;0
10661;180575;213;0;0;0;0;.00nan;0;0
10820;-1;210;0;0;0;0;.00nan;0;0
10820;175328;183;0;0;0;0;.00nan;0;0
10820;182089;183;57;39;5;34;.872;3600000;0
10820;192461;210;74;28;2;26;.929;3600000;0
10625;166545;193;70;21;1;20;.952;3600000;0
10625;168966;189;34;34;6;28;.824;3280000;0
10625;173770;193;0;0;0;0;.00nan;0;0
10625;176915;189;57;6;0;6;1.000;320000;0
10553;183860;4959;88;26;1;25;.962;3600000;0
10553;170114;4959;0;0;0;0;.00nan;0;0
10553;171405;2620;0;0;0;0;.00nan;0;0
10553;176921;2620;60;27;3;24;.889;3521000;0
10572;166451;176;0;0;0;0;.00nan;0;0
10572;171660;209;47;22;4;18;.818;3514000;0
10572;171662;176;95;38;2;36;.947;3600000;0
10572;186205;209;0;0;0;0;.00nan;0;0
10660;171615;181;80;26;1;25;.962;3600000;0
10660;175842;214;0;0;0;0;.00nan;0;0
10660;-1;181;0;0;0;0;.00nan;0;0
10660;-1;214;54;34;5;29;.853;3600000;0
10666;168995;205;66;19;1;18;.947;3600000;0
10666;170141;200;0;0;0;0;.00nan;0;0
10666;-1;205;0;0;0;0;.00nan;0;0
10666;187295;200;90;40;2;38;.950;3576000;0
10573;170202;195;0;0;0;0;.00nan;0;0
10573;174153;188;74;28;2;26;.929;3600000;0
10573;-1;188;0;0;0;0;.00nan;0;0
10573;176200;195;35;20;4;16;.800;3519000;0
10634;171405;2620;69;41;4;37;.902;3600000;0
10634;171660;209;0;0;0;0;.00nan;0;0
10634;176921;2620;0;0;0;0;.00nan;0;0
10634;186205;209;94;30;1;29;.967;3600000;0
11022;168954;228;0;0;0;0;.00nan;0;0
11022;170144;227;0;0;0;0;.00nan;0;0
11022;170300;228;42;41;6;35;.854;3600000;0
11022;-1;227;92;29;1;28;.966;3600000;0
10623;171819;177;0;0;0;0;.00nan;0;0
10623;179602;177;52;46;6;40;.870;3600000;0
10623;180762;1505;0;0;0;0;.00nan;0;0
10623;186549;1505;50;23;3;20;.870;3600000;0
11501;189081;187;0;0;0;0;.00nan;0;0
11501;-1;196;70;36;3;33;.917;3760000;0
11501;184648;196;0;0;0;0;.00nan;0;0
11501;-1;187;87;38;2;36;.947;3760000;0
10637;166695;218;0;0;0;0;.00nan;0;0
10637;-1;218;49;28;4;24;.857;3586000;0
10637;176770;219;0;0;0;0;.00nan;0;0
10637;181102;219;57;27;3;24;.889;3600000;0
10506;171970;217;50;0;0;0;.00nan;265000;0
10506;167404;215;0;0;0;0;.00nan;0;0
10506;171654;217;54;37;5;32;.865;3335000;0
10506;161046;215;50;40;6;34;.850;3600000;0
10725;184610;222;75;29;1;28;.966;3600000;0
10725;179406;232;87;36;2;34;.944;3583000;0
10725;179434;232;0;0;0;0;.00nan;0;0
10725;-1;222;0;0;0;0;.00nan;0;0
10772;-1;4949;0;0;0;0;.00nan;0;0
10772;168912;4949;75;10;0;10;1.000;3600000;0
10772;174209;178;0;0;0;0;.00nan;0;0
10772;176963;178;49;43;6;37;.860;3600000;0
10916;166762;213;57;37;5;32;.865;3600000;0
10916;-1;210;46;14;2;12;.857;3600000;0
10916;180575;213;0;0;0;0;.00nan;0;0
10916;192461;210;0;0;0;0;.00nan;0;0
10865;184175;224;68;61;7;54;.885;3600000;0
10865;173916;230;0;0;0;0;.00nan;0;0
10865;-1;224;0;0;0;0;.00nan;0;0
10865;186495;230;54;10;1;9;.900;3600000;0
10765;177248;201;67;34;3;31;.912;3600000;0
10765;175370;199;0;0;0;0;.00nan;0;0
10765;185743;201;0;0;0;0;.00nan;0;0
10765;161006;199;66;20;2;18;.900;3600000;0
10550;182454;4864;80;31;2;29;.935;3600000;0
10550;183737;4864;0;0;0;0;.00nan;0;0
10550;183860;4959;0;0;0;0;.00nan;0;0
10550;170114;4959;54;22;3;19;.864;3545000;0
10681;171730;220;49;20;3;17;.850;3600000;0
10681;175842;214;71;43;4;39;.907;3600000;0
10681;187443;220;0;0;0;0;.00nan;0;0
10681;-1;214;0;0;0;0;.00nan;0;0
10739;-1;211;0;0;0;0;.00nan;0;0
10739;179646;211;67;20;1;19;.950;3600000;0
10739;179679;212;0;0;0;0;.00nan;0;0
10739;186641;212;76;28;2;26;.929;3593000;0
10594;168117;192;99;34;1;33;.971;3600000;0
10594;170351;194;33;30;6;24;.800;2256000;0
10594;-1;194;46;10;2;8;.800;1344000;0
10594;175900;192;0;0;0;0;.00nan;0;0
11108;189081;187;81;15;0;15;1.000;3600000;0
11108;-1;197;89;56;5;51;.911;3600000;0
11108;170189;197;0;0;0;0;.00nan;0;0
11108;-1;187;0;0;0;0;.00nan;0;0
10688;168907;186;0;0;0;0;.00nan;0;0
10688;169226;186;65;22;2;20;.909;3600000;0
10688;175723;180;0;0;0;0;.00nan;0;0
10688;176938;180;42;32;5;27;.844;3600000;0
10596;187628;191;0;0;0;0;.00nan;0;0
10596;169096;190;23;4;3;1;.250;482000;0
10596;184788;190;55;41;6;35;.854;3118000;0
10596;185960;191;45;16;3;13;.813;3600000;0
10602;-1;207;81;28;1;27;.964;3600000;0
10602;182049;204;80;30;2;28;.933;3600000;0
10602;-1;207;0;0;0;0;.00nan;0;0
10602;141765;204;0;0;0;0;.00nan;0;0
11197;169166;226;63;10;1;9;.900;3600000;0
11197;175364;206;68;55;6;49;.891;3600000;0
11197;175371;206;0;0;0;0;.00nan;0;0
11197;192629;226;0;0;0;0;.00nan;0;0
10828;173900;182;0;0;0;0;.00nan;0;0
10828;170963;185;69;35;3;32;.914;3600000;0
10828;180110;185;0;0;0;0;.00nan;0;0
10828;182116;182;100;20;0;20;1.000;3600000;0
10649;173340;231;0;0;0;0;.00nan;0;0
10649;175436;229;0;0;0;0;.00nan;0;0
10649;176860;229;79;42;3;39;.929;3600000;0
10649;185034;231;43;31;5;26;.839;3514000;0
10539;-1;203;96;39;1;38;.974;3600000;0
10539;174334;208;61;37;4;33;.892;3600000;0
10539;179702;208;0;0;0;0;.00nan;0;0
10539;-1;203;0;0;0;0;.00nan;0;0
10752;175328;183;66;43;5;38;.884;3600000;0
10752;182089;183;0;0;0;0;.00nan;0;0
10752;187232;216;0;0;0;0;.00nan;0;0
10752;187240;216;68;25;2;23;.920;3600000;0
10659;168966;189;0;0;0;0;.00nan;0;0
10659;173823;198;79;24;1;23;.958;3600000;0
10659;176915;189;96;40;2;38;.950;3600000;0
10659;181431;198;0;0;0;0;.00nan;0;0
10804;-1;202;98;33;1;32;.970;3600000;0
10804;-1;207;0;0;0;0;.00nan;0;0
10804;180623;202;0;0;0;0;.00nan;0;0
10804;-1;207;45;21;4;17;.810;3600000;0
10670;174153;188;0;0;0;0;.00nan;0;0
10670;-1;196;0;0;0;0;.00nan;0;0
10670;-1;188;74;32;4;28;.875;3600000;0
10670;184648;196;95;38;1;37;.974;3600000;0
10936;170076;179;74;25;2;23;.920;3600000;0
10936;174147;179;0;0;0;0;.00nan;0;0
10936;-1;210;0;0;0;0;.00nan;0;0
10936;192461;210;54;33;5;28;.848;3600000;0
10646;180762;1505;83;14;0;14;1.000;3600000;0
10646;186549;1505;0;0;0;0;.00nan;0;0
10646;187232;216;68;31;3;28;.903;3600000;0
10646;187240;216;0;0;0;0;.00nan;0;0
10668;-1;221;73;27;2;25;.926;3900000;0
10668;189885;225;76;36;2;34;.944;3900000;0
10668;184785;225;0;0;0;0;.00nan;0;0
10668;187362;221;0;0;0;0;.00nan;0;0
10630;168966;189;75;37;3;34;.919;3582000;0
10630;170351;194;0;0;0;0;.00nan;0;0
10630;-1;194;73;23;2;21;.913;3600000;0
10630;176915;189;0;0;0;0;.00nan;0;0
10704;171819;177;0;0;0;0;.00nan;0;0
10704;175328;183;0;0;0;0;.00nan;0;0
10704;179602;177;53;14;2;12;.857;3600000;0
10704;182089;183;94;50;3;47;.940;3594000;0
10579;166695;218;0;0;0;0;.00nan;0;0
10579;-1;218;62;24;2;22;.917;3582000;0
10579;175723;180;88;31;1;30;.968;3600000;0
10579;176938;180;0;0;0;0;.00nan;0;0
11564;170963;185;0;0;0;0;.00nan;0;0
11564;175842;214;0;0;0;0;.00nan;0;0
11564;180110;185;91;16;0;16;1.000;3600000;0
11564;-1;214;98;39;1;38;.974;3545000;0
10818;171730;220;0;0;0;0;.00nan;0;0
10818;190125;184;73;39;4;35;.897;3600000;0
10818;179668;184;0;0;0;0;.00nan;0;0
10818;187443;220;38;29;5;24;.828;3551000;0
10566;171615;181;0;0;0;0;.00nan;0;0
10566;-1;1371;0;0;0;0;.00nan;0;0
10566;-1;181;71;27;2;25;.926;3900000;0
10566;192688;1371;72;28;2;26;.929;3888000;0
10577;166451;176;70;42;4;38;.905;3600000;0
10577;183860;4959;50;31;5;26;.839;3572000;0
10577;170114;4959;0;0;0;0;.00nan;0;0
10577;171662;176;0;0;0;0;.00nan;0;0
10606;179406;232;92;35;1;34;.971;3600000;0
10606;175436;229;35;32;5;27;.844;3600000;0
10606;179434;232;0;0;0;0;.00nan;0;0
10606;176860;229;0;0;0;0;.00nan;0;0
10711;171835;4960;0;0;0;0;.00nan;0;0
10711;187660;4960;62;15;1;14;.933;3600000;0
10711;184175;224;61;7;0;7;1.000;284000;0
10711;-1;224;46;42;6;36;.857;3316000;0
10707;170141;200;0;0;0;0;.00nan;0;0
10707;175370;199;49;22;3;19;.864;3547000;0
10707;187295;200;100;45;1;44;.978;3600000;0
10707;161006;199;0;0;0;0;.00nan;0;0
10729;168954;228;85;32;2;30;.938;3600000;0
10729;170300;228;0;0;0;0;.00nan;0;0
10729;175423;223;56;39;6;33;.846;3600000;0
10729;-1;223;0;0;0;0;.00nan;0;0
11649;176770;219;56;20;2;18;.900;3600000;0
11649;179679;212;62;34;4;30;.882;3561000;0
11649;181102;219;0;0;0;0;.00nan;0;0
11649;186641;212;0;0;0;0;.00nan;0;0
10619;170141;200;88;35;2;33;.943;3624000;0
10619;182049;204;87;32;1;31;.969;3624000;0
10619;187295;200;0;0;0;0;.00nan;0;0
10619;141765;204;0;0;0;0;.00nan;0;0
11092;166762;213;23;5;3;2;.400;436000;0
11092;174209;178;0;0;0;0;.00nan;0;0
11092;176963;178;82;29;1;28;.966;3600000;0
11092;180575;213;69;27;2;25;.926;3164000;0
10592;173823;198;0;0;0;0;.00nan;0;0
10592;170202;195;0;0;0;0;.00nan;0;0
10592;176200;195;65;26;2;24;.923;3834000;0
10592;181431;198;62;26;3;23;.885;3834000;0
10627;167404;215;64;28;3;25;.893;3900000;0
10627;-1;211;63;33;3;30;.909;3900000;0
10627;179646;211;0;0;0;0;.00nan;0;0
10627;161046;215;0;0;0;0;.00nan;0;0
11596;170076;179;99;37;1;36;.973;3600000;0
11596;174147;179;0;0;0;0;.00nan;0;0
11596;180762;1505;57;22;2;20;.909;3600000;0
11596;186549;1505;0;0;0;0;.00nan;0;0
10777;177248;201;0;0;0;0;.00nan;0;0
10777;-1;202;0;0;0;0;.00nan;0;0
10777;180623;202;48;25;4;21;.840;3600000;0
10777;185743;201;87;42;3;39;.929;3600000;0
11412;-1;197;0;0;0;0;.00nan;0;0
11412;169096;190;49;18;3;15;.833;3585000;0
11412;170189;197;92;44;1;43;.977;3600000;0
11412;184788;190;0;0;0;0;.00nan;0;0
10703;168954;228;0;0;0;0;.00nan;0;0
10703;170300;228;31;30;6;24;.800;3537000;0
10703;175423;223;0;0;0;0;.00nan;0;0
10703;-1;223;56;26;4;22;.846;3600000;0
10726;166451;176;0;0;0;0;.00nan;0;0
10726;171405;2620;0;0;0;0;.00nan;0;0
10726;171662;176;67;41;4;37;.902;3600000;0
10726;176921;2620;87;31;1;30;.968;3600000;0
10764;171970;217;47;30;5;25;.833;3600000;0
10764;168907;186;0;0;0;0;.00nan;0;0
10764;169226;186;100;34;0;34;1.000;3600000;0
10764;171654;217;0;0;0;0;.00nan;0;0
10603;187628;191;0;0;0;0;.00nan;0;0
10603;168117;192;0;0;0;0;.00nan;0;0
10603;175900;192;71;28;2;26;.929;3600000;0
10603;185960;191;88;49;3;46;.939;3600000;0
11403;168907;186;0;0;0;0;.00nan;0;0
11403;169226;186;55;29;3;26;.897;3900000;0
11403;176770;219;61;29;3;26;.897;3900000;0
11403;181102;219;0;0;0;0;.00nan;0;0
11664;189081;187;56;30;4;26;.867;3594000;0
11664;173823;198;73;28;2;26;.929;3600000;0
11664;-1;187;0;0;0;0;.00nan;0;0
11664;181431;198;0;0;0;0;.00nan;0;0
11610;-1;4949;0;0;0;0;.00nan;0;0
11610;168912;4949;54;29;4;25;.862;3543000;0
11610;-1;210;65;24;3;21;.875;3600000;0
11610;192461;210;0;0;0;0;.00nan;0;0
11057;168995;205;76;24;1;23;.958;3600000;0
11057;175364;206;0;0;0;0;.00nan;0;0
11057;175371;206;55;33;4;29;.879;3600000;0
11057;-1;205;0;0;0;0;.00nan;0;0
10786;170144;227;51;28;4;24;.857;3900000;0
10786;173916;230;0;0;0;0;.00nan;0;0
10786;-1;227;0;0;0;0;.00nan;0;0
10786;186495;230;69;30;4;26;.867;3900000;0
10652;166545;193;63;21;2;19;.905;3600000;0
10652;173770;193;0;0;0;0;.00nan;0;0
10652;170351;194;0;0;0;0;.00nan;0;0
10652;-1;194;76;41;3;38;.927;3600000;0
10829;182454;4864;61;21;2;19;.905;3597000;0
10829;183737;4864;0;0;0;0;.00nan;0;0
10829;171660;209;80;24;1;23;.958;3600000;0
10829;186205;209;0;0;0;0;.00nan;0;0
10740;167404;215;0;0;0;0;.00nan;0;0
10740;-1;211;93;31;1;30;.968;3600000;0
10740;179646;211;0;0;0;0;.00nan;0;0
10740;161046;215;81;33;2;31;.939;3559000;0
10981;168954;228;52;17;2;15;.882;3774000;0
10981;170300;228;0;0;0;0;.00nan;0;0
10981;189885;225;78;35;3;32;.914;3774000;0
10981;184785;225;0;0;0;0;.00nan;0;0
10758;184610;222;0;0;0;0;.00nan;0;0
10758;175436;229;72;29;2;27;.931;2509000;0
10758;176860;229;44;24;4;20;.833;1091000;0
10758;-1;222;88;20;0;20;1.000;3600000;0
10821;171819;177;0;0;0;0;.00nan;0;0
10821;174209;178;0;0;0;0;.00nan;0;0
10821;179602;177;33;28;5;23;.821;3513000;0
10821;176963;178;74;30;3;27;.900;3600000;0
10852;170351;194;48;35;5;30;.857;3600000;0
10852;-1;196;0;0;0;0;.00nan;0;0
10852;-1;194;0;0;0;0;.00nan;0;0
10852;184648;196;72;25;2;23;.920;3600000;0
10558;177248;201;0;0;0;0;.00nan;0;0
10558;174334;208;71;20;1;19;.950;3600000;0
10558;179702;208;0;0;0;0;.00nan;0;0
10558;185743;201;83;44;4;40;.909;3600000;0
10743;-1;221;0;0;0;0;.00nan;0;0
10743;175423;223;75;33;2;31;.939;3584000;0
10743;-1;223;0;0;0;0;.00nan;0;0
10743;187362;221;75;24;1;23;.958;3600000;0
10738;171835;4960;100;25;0;25;1.000;3600000;0
10738;187660;4960;0;0;0;0;.00nan;0;0
10738;179406;232;54;32;4;28;.875;3600000;0
10738;179434;232;0;0;0;0;.00nan;0;0
10724;170963;185;0;0;0;0;.00nan;0;0
10724;175842;214;59;39;5;34;.872;3572000;0
10724;180110;185;48;27;4;23;.852;3600000;0
10724;-1;214;0;0;0;0;.00nan;0;0
11104;-1;202;100;28;0;28;1.000;3600000;0
11104;175364;206;68;24;2;22;.917;3522000;0
11104;175371;206;0;0;0;0;.00nan;0;0
11104;180623;202;0;0;0;0;.00nan;0;0
10888;184175;224;93;34;1;33;.971;3600000;0
10888;170144;227;0;0;0;0;.00nan;0;0
10888;-1;224;0;0;0;0;.00nan;0;0
10888;-1;227;64;28;2;26;.929;3583000;0
10626;168117;192;86;16;0;16;1.000;3600000;0
10626;169096;190;65;34;4;30;.882;3600000;0
10626;175900;192;0;0;0;0;.00nan;0;0
10626;184788;190;0;0;0;0;.00nan;0;0
10755;175723;180;0;0;0;0;.00nan;0;0
10755;176938;180;43;23;4;19;.826;3600000;0
10755;179679;212;0;0;0;0;.00nan;0;0
10755;186641;212;97;35;1;34;.971;3600000;0
10682;180762;1505;0;0;0;0;.00nan;0;0
10682;186549;1505;81;25;1;24;.960;3600000;0
10682;187232;216;61;11;1;10;.909;1216000;0
10682;187240;216;38;28;5;23;.821;2384000;0
10685;170141;200;0;0;0;0;.00nan;0;0
10685;182049;204;86;26;2;24;.923;3550000;0
10685;187295;200;100;44;1;43;.977;3600000;0
10685;141765;204;0;0;0;0;.00nan;0;0
10583;166451;176;58;46;5;41;.891;3257000;0
10583;183860;4959;0;0;0;0;.00nan;0;0
10583;170114;4959;46;12;2;10;.833;3600000;0
10583;171662;176;49;1;0;1;1.000;343000;0
10737;168966;189;0;0;0;0;.00nan;0;0
10737;174153;188;0;0;0;0;.00nan;0;0
10737;-1;188;77;29;1;28;.966;3900000;0
10737;176915;189;97;36;1;35;.972;3900000;0
10599;189081;187;0;0;0;0;.00nan;0;0
10599;170202;195;0;0;0;0;.00nan;0;0
10599;176200;195;88;30;1;29;.967;3600000;0
10599;-1;187;65;24;2;22;.917;3600000;0
10938;171970;217;70;25;2;23;.920;3600000;0
10938;171654;217;0;0;0;0;.00nan;0;0
10938;176770;219;54;3;0;3;1.000;794000;0
10938;181102;219;20;21;6;15;.714;2806000;0
10856;173900;182;0;0;0;0;.00nan;0;0
10856;-1;1371;0;0;0;0;.00nan;0;0
10856;182116;182;63;38;4;34;.895;3600000;0
10856;192688;1371;83;25;1;24;.960;3600000;0
10831;-1;210;0;0;0;0;.00nan;0;0
10831;175328;183;0;0;0;0;.00nan;0;0
10831;182089;183;77;38;3;35;.921;3583000;0
10831;192461;210;71;18;1;17;.944;3600000;0
11131;169166;226;50;29;4;25;.862;3600000;0
11131;175370;199;0;0;0;0;.00nan;0;0
11131;192629;226;0;0;0;0;.00nan;0;0
11131;161006;199;23;19;5;14;.737;3600000;0
10860;177248;201;82;36;2;34;.944;3567000;0
10860;-1;207;92;23;0;23;1.000;3600000;0
10860;185743;201;0;0;0;0;.00nan;0;0
10860;-1;207;0;0;0;0;.00nan;0;0
11150;170076;179;48;24;3;21;.875;3600000;0
11150;174147;179;0;0;0;0;.00nan;0;0
11150;174209;178;0;0;0;0;.00nan;0;0
11150;176963;178;74;52;6;46;.885;3600000;0
10678;187628;191;46;6;1;5;.833;3600000;0
10678;-1;197;88;58;3;55;.948;3525000;0
10678;170189;197;0;0;0;0;.00nan;0;0
10678;185960;191;0;0;0;0;.00nan;0;0
10689;168966;189;0;0;0;0;.00nan;0;0
10689;174153;188;54;37;5;32;.865;3600000;0
10689;-1;188;0;0;0;0;.00nan;0;0
10689;176915;189;56;21;2;19;.905;3600000;0
10709;168995;205;66;29;3;26;.897;3900000;0
10709;-1;203;0;0;0;0;.00nan;0;0
10709;-1;203;66;39;3;36;.923;3900000;0
10709;-1;205;0;0;0;0;.00nan;0;0
10780;-1;211;0;0;0;0;.00nan;0;0
10780;179646;211;79;44;3;41;.932;3600000;0
10780;179679;212;64;24;2;22;.917;3600000;0
10780;186641;212;0;0;0;0;.00nan;0;0
10680;166762;213;0;0;0;0;.00nan;0;0
10680;180575;213;44;46;7;39;.848;3600000;0
10680;180762;1505;63;19;1;18;.947;3600000;0
10680;186549;1505;0;0;0;0;.00nan;0;0
10744;166451;176;0;0;0;0;.00nan;0;0
10744;171405;2620;0;0;0;0;.00nan;0;0
10744;171662;176;67;37;4;33;.892;3545000;0
10744;176921;2620;55;22;3;19;.864;3600000;0
10756;171730;220;43;31;5;26;.839;3545000;0
10756;175842;214;0;0;0;0;.00nan;0;0
10756;187443;220;0;0;0;0;.00nan;0;0
10756;-1;214;69;42;4;38;.905;3600000;0
10715;173340;231;0;0;0;0;.00nan;0;0
10715;173916;230;0;0;0;0;.00nan;0;0
10715;185034;231;77;37;3;34;.919;3595000;0
10715;186495;230;80;28;2;26;.929;3600000;0
10663;171615;181;67;37;4;33;.892;3600000;0
10663;190125;184;48;23;3;20;.870;3600000;0
10663;179668;184;0;0;0;0;.00nan;0;0
10663;-1;181;0;0;0;0;.00nan;0;0
10774;183860;4959;56;28;3;25;.893;3843000;0
10774;170114;4959;0;0;0;0;.00nan;0;0
10774;171660;209;90;39;2;37;.949;3822000;0
10774;186205;209;0;0;0;0;.00nan;0;0
10778;184610;222;0;0;0;0;.00nan;0;0
10778;179406;232;50;36;5;31;.861;3600000;0
10778;179434;232;0;0;0;0;.00nan;0;0
10778;-1;222;73;29;2;27;.931;3600000;0
10643;166695;218;0;0;0;0;.00nan;0;0
10643;167404;215;89;34;1;33;.971;3563000;0
10643;-1;218;88;19;0;19;1.000;3600000;0
10643;161046;215;0;0;0;0;.00nan;0;0
10582;170141;200;73;46;5;41;.891;3600000;0
10582;174334;208;65;20;2;18;.900;3600000;0
10582;179702;208;0;0;0;0;.00nan;0;0
10582;187295;200;0;0;0;0;.00nan;0;0
10793;171835;4960;60;17;1;16;.941;3600000;0
10793;187660;4960;0;0;0;0;.00nan;0;0
10793;189885;225;0;0;0;0;.00nan;0;0
10793;184785;225;98;65;3;62;.954;3561000;0
10620;166545;193;86;28;1;27;.964;3900000;0
10620;173770;193;0;0;0;0;.00nan;0;0
10620;170202;195;71;27;1;26;.963;3900000;0
10620;176200;195;0;0;0;0;.00nan;0;0
10773;169096;190;88;48;3;45;.938;3600000;0
10773;173823;198;65;25;2;23;.920;3600000;0
10773;184788;190;0;0;0;0;.00nan;0;0
10773;181431;198;0;0;0;0;.00nan;0;0
11651;-1;202;70;44;4;40;.909;3565000;0
11651;-1;203;74;31;2;29;.935;3600000;0
11651;-1;203;0;0;0;0;.00nan;0;0
11651;180623;202;0;0;0;0;.00nan;0;0
10754;168954;228;66;39;5;34;.872;3600000;0
10754;170300;228;0;0;0;0;.00nan;0;0
10754;-1;221;62;24;2;22;.917;3600000;0
10754;187362;221;0;0;0;0;.00nan;0;0
10757;166695;218;0;0;0;0;.00nan;0;0
10757;171970;217;71;43;4;39;.907;3600000;0
10757;171654;217;0;0;0;0;.00nan;0;0
10757;-1;218;48;34;5;29;.853;3532000;0
10763;173916;230;0;0;0;0;.00nan;0;0
10763;175436;229;0;0;0;0;.00nan;0;0
10763;176860;229;91;38;2;36;.947;3600000;0
10763;186495;230;57;30;4;26;.867;3580000;0
10855;168907;186;0;0;0;0;.00nan;0;0
10855;169226;186;69;18;1;17;.944;3600000;0
10855;175723;180;0;0;0;0;.00nan;0;0
10855;176938;180;90;38;2;36;.947;3581000;0
10749;187628;191;0;0;0;0;.00nan;0;0
10749;-1;196;42;3;1;2;.667;650000;0
10749;184648;196;26;31;6;25;.806;2950000;0
10749;185960;191;100;23;0;23;1.000;3600000;0
10631;166545;193;0;0;0;0;.00nan;0;0
10631;168117;192;65;45;5;40;.889;3525000;0
10631;173770;193;56;22;3;19;.864;3600000;0
10631;175900;192;0;0;0;0;.00nan;0;0
10779;171730;220;0;0;0;0;.00nan;0;0
10779;-1;1371;41;17;3;14;.824;3561000;0
10779;187443;220;82;27;1;26;.963;3600000;0
10779;192688;1371;0;0;0;0;.00nan;0;0
10691;171615;181;69;20;1;19;.950;3600000;0
10691;190125;184;63;35;3;32;.914;3599000;0
10691;179668;184;0;0;0;0;.00nan;0;0
10691;-1;181;0;0;0;0;.00nan;0;0
10915;175370;199;76;32;3;29;.906;3537000;0
10915;-1;207;79;27;1;26;.963;3600000;0
10915;-1;207;0;0;0;0;.00nan;0;0
10915;161006;199;0;0;0;0;.00nan;0;0
10710;184610;222;0;0;0;0;.00nan;0;0
10710;175423;223;58;37;4;33;.892;3600000;0
10710;-1;223;0;0;0;0;.00nan;0;0
10710;-1;222;63;18;1;17;.944;3600000;0
10750;166451;176;38;36;6;30;.833;3018000;0
10750;171660;209;44;15;3;12;.800;3600000;0
10750;171662;176;46;6;1;5;.833;582000;0
10750;186205;209;0;0;0;0;.00nan;0;0
10883;175328;183;92;57;3;54;.947;3511000;0
10883;182089;183;0;0;0;0;.00nan;0;0
10883;187232;216;0;0;0;0;.00nan;0;0
10883;187240;216;67;19;1;18;.947;3600000;0
11001;173900;182;0;0;0;0;.00nan;0;0
11001;170963;185;51;23;3;20;.870;3600000;0
11001;180110;185;0;0;0;0;.00nan;0;0
11001;182116;182;54;31;4;27;.871;3562000;0
10950;166762;213;100;38;1;37;.974;3600000;0
10950;-1;210;60;21;2;19;.905;3551000;0
10950;180575;213;0;0;0;0;.00nan;0;0
10950;192461;210;0;0;0;0;.00nan;0;0
10751;-1;197;91;42;2;40;.952;3600000;0
10751;170189;197;0;0;0;0;.00nan;0;0
10751;170351;194;0;0;0;0;.00nan;0;0
10751;-1;194;95;35;1;34;.971;3600000;0
10760;182454;4864;0;0;0;0;.00nan;0;0
10760;183737;4864;66;17;1;16;.941;3600000;0
10760;171405;2620;0;0;0;0;.00nan;0;0
10760;176921;2620;74;38;3;35;.921;3600000;0
11125;170076;179;53;15;2;13;.867;3576000;0
11125;174147;179;0;0;0;0;.00nan;0;0
11125;174209;178;0;0;0;0;.00nan;0;0
11125;176963;178;98;50;1;49;.980;3600000;0
10796;171835;4960;47;22;4;18;.818;3900000;0
10796;187660;4960;0;0;0;0;.00nan;0;0
10796;184175;224;0;0;0;0;.00nan;0;0
10796;-1;224;69;47;4;43;.915;3900000;0
10801;168907;186;66;43;4;39;.907;3562000;0
10801;169226;186;0;0;0;0;.00nan;0;0
10801;179679;212;0;0;0;0;.00nan;0;0
10801;186641;212;85;26;2;24;.923;3600000;0
11640;170141;200;60;7;0;7;1.000;1588000;0
11640;174334;208;58;15;2;13;.867;3600000;0
11640;179702;208;0;0;0;0;.00nan;0;0
11640;187295;200;46;32;5;27;.844;2012000;0
10674;-1;4949;69;32;2;30;.938;3900000;0
10674;168912;4949;0;0;0;0;.00nan;0;0
10674;180762;1505;0;0;0;0;.00nan;0;0
10674;186549;1505;64;23;2;21;.913;3900000;0
10650;-1;202;59;28;3;25;.893;3131000;0
10650;180623;202;27;7;3;4;.571;469000;0
10650;182049;204;86;37;2;35;.946;3600000;0
10650;141765;204;0;0;0;0;.00nan;0;0
10789;173340;231;0;0;0;0;.00nan;0;0
10789;175436;229;91;50;3;47;.940;3600000;0
10789;176860;229;0;0;0;0;.00nan;0;0
10789;185034;231;86;17;0;17;1.000;3600000;0
11666;174209;178;0;0;0;0;.00nan;0;0
11666;176963;178;98;71;2;69;.972;3600000;0
11666;180762;1505;52;8;1;7;.875;3600000;0
11666;186549;1505;0;0;0;0;.00nan;0;0
10719;168995;205;70;19;1;18;.947;3600000;0
10719;-1;203;0;0;0;0;.00nan;0;0
10719;-1;203;94;48;2;46;.958;3553000;0
10719;-1;205;0;0;0;0;.00nan;0;0
11670;170963;185;0;0;0;0;.00nan;0;0
11670;-1;1371;0;0;0;0;.00nan;0;0
11670;180110;185;89;40;2;38;.950;3900000;0
11670;192688;1371;86;26;2;24;.923;3900000;0
10905;170076;179;57;29;3;26;.897;3600000;0
10905;174147;179;0;0;0;0;.00nan;0;0
10905;175328;183;0;0;0;0;.00nan;0;0
10905;182089;183;75;48;4;44;.917;3600000;0
10692;171615;181;0;0;0;0;.00nan;0;0
10692;171730;220;100;28;0;28;1.000;3600000;0
10692;-1;181;79;38;3;35;.921;3600000;0
10692;187443;220;0;0;0;0;.00nan;0;0
10693;168117;192;84;32;2;30;.938;3900000;0
10693;173823;198;71;23;2;21;.913;3900000;0
10693;175900;192;0;0;0;0;.00nan;0;0
10693;181431;198;0;0;0;0;.00nan;0;0
10716;171819;177;0;0;0;0;.00nan;0;0
10716;-1;4949;0;0;0;0;.00nan;0;0
10716;168912;4949;84;35;2;33;.943;3900000;0
10716;179602;177;91;47;2;45;.957;3900000;0
10701;175842;214;0;0;0;0;.00nan;0;0
10701;190125;184;0;0;0;0;.00nan;0;0
10701;179668;184;79;14;0;14;1.000;3600000;0
10701;-1;214;90;49;3;46;.939;3600000;0
10862;171970;217;50;21;2;19;.905;3600000;0
10862;171654;217;0;0;0;0;.00nan;0;0
10862;175723;180;0;0;0;0;.00nan;0;0
10862;176938;180;58;27;3;24;.889;3548000;0
10812;170144;227;59;19;2;17;.895;3600000;0
10812;-1;227;0;0;0;0;.00nan;0;0
10812;175423;223;0;0;0;0;.00nan;0;0
10812;-1;223;62;46;5;41;.891;3600000;0
10759;166762;213;71;47;5;42;.894;3898000;0
10759;180575;213;0;0;0;0;.00nan;0;0
10759;187232;216;45;24;4;20;.833;3898000;0
10759;187240;216;0;0;0;0;.00nan;0;0
10639;166545;193;72;39;4;35;.897;3600000;0
10639;173770;193;0;0;0;0;.00nan;0;0
10639;170202;195;0;0;0;0;.00nan;0;0
10639;176200;195;99;37;1;36;.973;3600000;0
10857;184175;224;72;43;4;39;.907;3579000;0
10857;-1;224;0;0;0;0;.00nan;0;0
10857;179406;232;78;28;2;26;.929;3600000;0
10857;179434;232;0;0;0;0;.00nan;0;0
10617;169166;226;65;32;3;29;.906;3900000;0
10617;174334;208;79;43;3;40;.930;3900000;0
10617;179702;208;0;0;0;0;.00nan;0;0
10617;192629;226;0;0;0;0;.00nan;0;0
10735;173916;230;0;0;0;0;.00nan;0;0
10735;189885;225;88;54;4;50;.926;3537000;0
10735;184785;225;0;0;0;0;.00nan;0;0
10735;186495;230;51;16;2;14;.875;3600000;0
11328;175364;206;67;39;4;35;.897;3600000;0
11328;175370;199;56;19;3;16;.842;3600000;0
11328;175371;206;0;0;0;0;.00nan;0;0
11328;161006;199;0;0;0;0;.00nan;0;0
10902;173340;231;0;0;0;0;.00nan;0;0
10902;168954;228;78;38;2;36;.947;3868000;0
10902;170300;228;0;0;0;0;.00nan;0;0
10902;185034;231;74;36;3;33;.917;3868000;0
10791;-1;211;62;36;4;32;.889;3551000;0
10791;176770;219;70;31;3;28;.903;3600000;0
10791;179646;211;0;0;0;0;.00nan;0;0
10791;181102;219;0;0;0;0;.00nan;0;0
11637;168954;228;61;24;2;22;.917;3600000;0
11637;170300;228;0;0;0;0;.00nan;0;0
11637;175436;229;0;0;0;0;.00nan;0;0
11637;176860;229;95;31;1;30;.968;3600000;0
10991;170144;227;0;0;0;0;.00nan;0;0
10991;-1;221;0;0;0;0;.00nan;0;0
10991;-1;227;64;22;2;20;.909;3600000;0
10991;187362;221;60;46;5;41;.891;3600000;0
10792;166695;218;0;0;0;0;.00nan;0;0
10792;168907;186;0;0;0;0;.00nan;0;0
10792;169226;186;48;36;5;31;.861;3600000;0
10792;-1;218;93;31;1;30;.968;3600000;0
11024;170202;195;59;20;2;18;.900;3600000;0
11024;174153;188;0;0;0;0;.00nan;0;0
11024;-1;188;56;31;4;27;.871;3559000;0
11024;176200;195;0;0;0;0;.00nan;0;0
10745;167404;215;0;0;0;0;.00nan;0;0
10745;176770;219;74;29;2;27;.931;3600000;0
10745;181102;219;0;0;0;0;.00nan;0;0
10745;161046;215;58;36;4;32;.889;3600000;0
10722;168995;205;0;0;0;0;.00nan;0;0
10722;182049;204;100;29;0;29;1.000;3600000;0
10722;-1;205;61;23;2;21;.913;3600000;0
10722;141765;204;0;0;0;0;.00nan;0;0
10908;187628;191;0;0;0;0;.00nan;0;0
10908;189081;187;0;0;0;0;.00nan;0;0
10908;-1;187;46;19;3;16;.842;3583000;0
10908;185960;191;96;42;2;40;.952;3600000;0
11028;182454;4864;72;27;2;25;.926;3600000;0
11028;183737;4864;0;0;0;0;.00nan;0;0
11028;183860;4959;0;0;0;0;.00nan;0;0
11028;170114;4959;64;35;3;32;.914;3592000;0
10775;168966;189;0;0;0;0;.00nan;0;0
10775;173823;198;0;0;0;0;.00nan;0;0
10775;176915;189;81;51;4;47;.922;3600000;0
10775;181431;198;99;33;1;32;.970;3600000;0
11034;173900;182;0;0;0;0;.00nan;0;0
11034;-1;1371;68;28;2;26;.929;3600000;0
11034;182116;182;90;19;0;19;1.000;3600000;0
11034;192688;1371;0;0;0;0;.00nan;0;0
10806;170141;200;0;0;0;0;.00nan;0;0
10806;-1;202;91;30;1;29;.967;3600000;0
10806;180623;202;0;0;0;0;.00nan;0;0
10806;187295;200;97;42;2;40;.952;3597000;0
10815;171405;2620;0;0;0;0;.00nan;0;0
10815;171660;209;0;0;0;0;.00nan;0;0
10815;176921;2620;70;26;2;24;.923;3600000;0
10815;186205;209;79;43;3;40;.930;3568000;0
10728;171819;177;0;0;0;0;.00nan;0;0
10728;-1;4949;99;37;1;36;.973;3600000;0
10728;168912;4949;0;0;0;0;.00nan;0;0
10728;179602;177;33;29;5;24;.828;3600000;0
11133;189081;187;69;22;1;21;.955;3600000;0
11133;-1;197;76;36;3;33;.917;3540000;0
11133;170189;197;0;0;0;0;.00nan;0;0
11133;-1;187;0;0;0;0;.00nan;0;0
10861;170351;194;0;0;0;0;.00nan;0;0
10861;-1;196;0;0;0;0;.00nan;0;0
10861;-1;194;56;31;4;27;.871;3600000;0
10861;184648;196;91;39;2;37;.949;3600000;0
10753;169096;190;73;34;4;30;.882;3900000;0
10753;174153;188;47;25;4;21;.840;3900000;0
10753;-1;188;0;0;0;0;.00nan;0;0
10753;184788;190;0;0;0;0;.00nan;0;0
10788;177248;201;0;0;0;0;.00nan;0;0
10788;-1;203;0;0;0;0;.00nan;0;0
10788;-1;203;54;24;3;21;.875;3900000;0
10788;185743;201;71;41;3;38;.927;3900000;0
10951;169166;226;73;23;2;21;.913;3600000;0
10951;-1;207;69;42;4;38;.905;3590000;0
10951;-1;207;0;0;0;0;.00nan;0;0
10951;192629;226;0;0;0;0;.00nan;0;0
11660;170076;179;94;42;3;39;.929;3600000;0
11660;174147;179;0;0;0;0;.00nan;0;0
11660;-1;210;0;0;0;0;.00nan;0;0
11660;192461;210;76;43;4;39;.907;3545000;0
10672;166545;193;59;26;3;23;.885;3519000;0
10672;187628;191;76;25;1;24;.960;3600000;0
10672;173770;193;0;0;0;0;.00nan;0;0
10672;185960;191;0;0;0;0;.00nan;0;0
10914;168954;228;77;28;2;26;.929;3782000;0
10914;184175;224;87;25;1;24;.960;3782000;0
10914;170300;228;0;0;0;0;.00nan;0;0
10914;-1;224;0;0;0;0;.00nan;0;0
10797;167404;215;0;0;0;0;.00nan;0;0
10797;168907;186;0;0;0;0;.00nan;0;0
10797;169226;186;81;30;2;28;.933;3548000;0
10797;161046;215;86;29;1;28;.966;3600000;0
10878;173900;182;0;0;0;0;.00nan;0;0
10878;171730;220;25;6;3;3;.500;410000;0
10878;182116;182;100;36;0;36;1.000;3600000;0
10878;187443;220;79;35;3;32;.914;3190000;0
10645;170202;195;0;0;0;0;.00nan;0;0
10645;-1;196;99;44;1;43;.977;3600000;0
10645;184648;196;0;0;0;0;.00nan;0;0
10645;176200;195;51;13;2;11;.846;3567000;0
10851;189885;225;68;30;3;27;.900;3567000;0
10851;175423;223;80;33;1;32;.970;3600000;0
10851;184785;225;0;0;0;0;.00nan;0;0
10851;-1;223;0;0;0;0;.00nan;0;0
10884;177248;201;81;16;0;16;1.000;3600000;0
10884;170141;200;0;0;0;0;.00nan;0;0
10884;185743;201;0;0;0;0;.00nan;0;0
10884;187295;200;81;45;4;41;.911;3600000;0
10960;-1;210;60;15;1;14;.933;3600000;0
10960;175328;183;0;0;0;0;.00nan;0;0
10960;182089;183;95;60;5;55;.917;3600000;0
10960;192461;210;0;0;0;0;.00nan;0;0
10841;166695;218;0;0;0;0;.00nan;0;0
10841;-1;211;62;26;2;24;.923;3545000;0
10841;-1;218;86;27;1;26;.963;3600000;0
10841;179646;211;0;0;0;0;.00nan;0;0
10802;171835;4960;33;22;4;18;.818;3600000;0
10802;187660;4960;0;0;0;0;.00nan;0;0
10802;-1;221;0;0;0;0;.00nan;0;0
10802;187362;221;100;36;1;35;.972;3600000;0
10834;173340;231;0;0;0;0;.00nan;0;0
10834;184610;222;0;0;0;0;.00nan;0;0
10834;185034;231;66;21;1;20;.952;3900000;0
10834;-1;222;95;65;1;64;.985;3900000;0
10686;174334;208;77;15;1;14;.933;3600000;0
10686;175364;206;73;46;4;42;.913;3600000;0
10686;175371;206;0;0;0;0;.00nan;0;0
10686;179702;208;0;0;0;0;.00nan;0;0
10891;182454;4864;0;0;0;0;.00nan;0;0
10891;183737;4864;73;19;1;18;.947;3600000;0
10891;171660;209;24;38;7;31;.816;3600000;0
10891;186205;209;0;0;0;0;.00nan;0;0
10911;-1;202;80;31;3;28;.903;3600000;0
10911;-1;203;71;41;4;37;.902;3542000;0
10911;-1;203;0;0;0;0;.00nan;0;0
10911;180623;202;0;0;0;0;.00nan;0;0
10807;169096;190;0;0;0;0;.00nan;0;0
10807;173823;198;48;17;3;14;.824;3600000;0
10807;184788;190;77;51;5;46;.902;3558000;0
10807;181431;198;0;0;0;0;.00nan;0;0
11103;170076;179;0;0;0;0;.00nan;0;0
11103;174147;179;85;42;2;40;.952;3900000;0
11103;187232;216;0;0;0;0;.00nan;0;0
11103;187240;216;94;42;2;40;.952;3900000;0
10767;-1;1371;0;0;0;0;.00nan;0;0
10767;190125;184;0;0;0;0;.00nan;0;0
10767;179668;184;51;28;5;23;.821;3600000;0
10767;192688;1371;78;36;2;34;.944;3600000;0
11264;170144;227;33;18;4;14;.778;3600000;0
11264;-1;221;66;50;5;45;.900;3581000;0
11264;-1;227;0;0;0;0;.00nan;0;0
11264;187362;221;0;0;0;0;.00nan;0;0
10742;175842;214;73;34;3;31;.912;3900000;0
10742;190125;184;51;20;3;17;.850;3900000;0
10742;179668;184;0;0;0;0;.00nan;0;0
10742;-1;214;0;0;0;0;.00nan;0;0
10956;-1;197;77;41;3;38;.927;3594000;0
10956;173823;198;63;21;2;19;.905;3600000;0
10956;170189;197;0;0;0;0;.00nan;0;0
10956;181431;198;0;0;0;0;.00nan;0;0
10835;189885;225;0;0;0;0;.00nan;0;0
10835;175436;229;0;0;0;0;.00nan;0;0
10835;184785;225;62;29;3;26;.897;3900000;0
10835;176860;229;79;34;3;31;.912;3900000;0
10624;174334;208;9;18;6;12;.667;2947000;0
10624;175364;206;94;44;2;42;.955;3600000;0
10624;175371;206;0;0;0;0;.00nan;0;0
10624;179702;208;49;1;0;1;1.000;653000;0
10816;168995;205;66;15;1;14;.933;3600000;0
10816;-1;202;0;0;0;0;.00nan;0;0
10816;180623;202;48;28;4;24;.857;3600000;0
10816;-1;205;0;0;0;0;.00nan;0;0
10783;171819;177;0;0;0;0;.00nan;0;0
10783;174209;178;0;0;0;0;.00nan;0;0
10783;179602;177;80;27;1;26;.963;3600000;0
10783;176963;178;59;21;2;19;.905;3558000;0
10784;166451;176;98;48;2;46;.958;3900000;0
10784;171405;2620;0;0;0;0;.00nan;0;0
10784;171662;176;0;0;0;0;.00nan;0;0
10784;176921;2620;69;20;2;18;.900;3900000;0
10651;168966;189;0;0;0;0;.00nan;0;0
10651;170202;195;0;0;0;0;.00nan;0;0
10651;176200;195;100;21;0;21;1.000;3600000;0
10651;176915;189;74;40;4;36;.900;3600000;0
10736;170141;200;76;45;4;41;.911;3579000;0
10736;182049;204;56;16;2;14;.875;3600000;0
10736;187295;200;0;0;0;0;.00nan;0;0
10736;141765;204;0;0;0;0;.00nan;0;0
10848;168907;186;93;36;1;35;.972;3600000;0
10848;169226;186;0;0;0;0;.00nan;0;0
10848;175723;180;51;2;0;2;1.000;450000;0
10848;176938;180;39;32;6;26;.813;3150000;0
11039;170963;185;56;25;3;22;.880;3680000;0
11039;-1;1371;91;45;2;43;.956;3680000;0
11039;180110;185;0;0;0;0;.00nan;0;0
11039;192688;1371;0;0;0;0;.00nan;0;0
10808;-1;211;57;27;3;24;.889;1822000;0
10808;176770;219;70;20;1;19;.950;3600000;0
10808;179646;211;38;33;6;27;.818;1778000;0
10808;181102;219;0;0;0;0;.00nan;0;0
10880;166695;218;0;0;0;0;.00nan;0;0
10880;-1;218;69;43;4;39;.907;3900000;0
10880;179679;212;0;0;0;0;.00nan;0;0
10880;186641;212;62;32;4;28;.875;3900000;0
10830;-1;4949;69;23;2;21;.913;3600000;0
10830;168912;4949;0;0;0;0;.00nan;0;0
10830;175328;183;80;42;3;39;.929;3587000;0
10830;182089;183;0;0;0;0;.00nan;0;0
10730;166762;213;0;0;0;0;.00nan;0;0
10730;180575;213;98;52;3;49;.942;3580000;0
10730;180762;1505;70;19;1;18;.947;3600000;0
10730;186549;1505;0;0;0;0;.00nan;0;0
10731;173900;182;0;0;0;0;.00nan;0;0
10731;171615;181;0;0;0;0;.00nan;0;0
10731;182116;182;57;27;3;24;.889;3771000;0
10731;-1;181;89;36;2;34;.944;3771000;0
10917;173340;231;52;16;2;14;.875;3600000;0
10917;168954;228;0;0;0;0;.00nan;0;0
10917;170300;228;70;52;6;46;.885;3600000;0
10917;185034;231;0;0;0;0;.00nan;0;0
10803;170351;194;0;0;0;0;.00nan;0;0
10803;174153;188;40;16;3;13;.813;3600000;0
10803;-1;194;61;30;4;26;.867;3600000;0
10803;-1;188;0;0;0;0;.00nan;0;0
10874;184175;224;55;6;0;6;1.000;725000;0
10874;-1;224;45;31;6;25;.806;2875000;0
10874;179406;232;67;33;3;30;.909;3600000;0
10874;179434;232;0;0;0;0;.00nan;0;0
10881;183860;4959;0;0;0;0;.00nan;0;0
10881;170114;4959;85;15;0;15;1.000;3600000;0
10881;171660;209;0;0;0;0;.00nan;0;0
10881;186205;209;98;43;1;42;.977;3600000;0
10805;171835;4960;0;0;0;0;.00nan;0;0
10805;187660;4960;55;17;2;15;.882;3600000;0
10805;175423;223;0;0;0;0;.00nan;0;0
10805;-1;223;61;47;5;42;.894;3600000;0
11015;166762;213;42;33;5;28;.848;3600000;0
11015;-1;210;0;0;0;0;.00nan;0;0
11015;180575;213;0;0;0;0;.00nan;0;0
11015;192461;210;82;28;1;27;.964;3600000;0
10920;177248;201;0;0;0;0;.00nan;0;0
10920;-1;207;45;31;5;26;.839;3551000;0
10920;185743;201;65;30;3;27;.900;3600000;0
10920;-1;207;0;0;0;0;.00nan;0;0
10800;171970;217;65;39;5;34;.872;3533000;0
10800;167404;215;0;0;0;0;.00nan;0;0
10800;171654;217;0;0;0;0;.00nan;0;0
10800;161046;215;62;23;3;20;.870;3600000;0
10887;184610;222;0;0;0;0;.00nan;0;0
10887;179406;232;0;0;0;0;.00nan;0;0
10887;179434;232;96;39;1;38;.974;3600000;0
10887;-1;222;61;18;2;16;.889;3600000;0
10721;171819;177;0;0;0;0;.00nan;0;0
10721;179602;177;74;52;5;47;.904;3900000;0
10721;180762;1505;0;0;0;0;.00nan;0;0
10721;186549;1505;38;25;5;20;.800;3900000;0
10869;189081;187;0;0;0;0;.00nan;0;0
10869;170351;194;53;38;6;32;.842;2352000;0
10869;-1;194;41;14;3;11;.786;1248000;0
10869;-1;187;63;23;2;21;.913;3600000;0
10838;166451;176;0;0;0;0;.00nan;0;0
10838;171405;2620;78;22;1;21;.955;3900000;0
10838;171662;176;89;35;1;34;.971;3900000;0
10838;176921;2620;0;0;0;0;.00nan;0;0
10892;173916;230;0;0;0;0;.00nan;0;0
10892;175436;229;98;40;1;39;.975;3600000;0
10892;176860;229;0;0;0;0;.00nan;0;0
10892;186495;230;21;23;6;17;.739;3600000;0
10809;169166;226;26;34;7;27;.794;2871000;0
10809;-1;203;0;0;0;0;.00nan;0;0
10809;-1;203;90;35;1;34;.971;3600000;0
10809;192629;226;51;3;0;3;1.000;729000;0
10787;168995;205;0;0;0;0;.00nan;0;0
10787;182049;204;0;0;0;0;.00nan;0;0
10787;-1;205;70;29;3;26;.897;3900000;0
10787;141765;204;67;31;3;28;.903;3900000;0
10974;168907;186;0;0;0;0;.00nan;0;0
10974;169226;186;57;17;2;15;.882;3600000;0
10974;179679;212;55;24;3;21;.875;3573000;0
10974;186641;212;0;0;0;0;.00nan;0;0
11025;173916;230;0;0;0;0;.00nan;0;0
11025;175423;223;74;42;4;38;.905;3600000;0
11025;-1;223;0;0;0;0;.00nan;0;0
11025;186495;230;67;19;1;18;.947;3600000;0
10890;173900;182;0;0;0;0;.00nan;0;0
10890;171730;220;0;0;0;0;.00nan;0;0
10890;182116;182;57;27;3;24;.889;3598000;0
10890;187443;220;90;30;1;29;.967;3600000;0
10900;-1;4949;0;0;0;0;.00nan;0;0
10900;168912;4949;68;30;3;27;.900;3600000;0
10900;174209;178;0;0;0;0;.00nan;0;0
10900;176963;178;66;32;4;28;.875;3578000;0
10966;177248;201;76;38;3;35;.921;3600000;0
10966;169166;226;0;0;0;0;.00nan;0;0
10966;185743;201;0;0;0;0;.00nan;0;0
10966;192629;226;69;19;1;18;.947;3600000;0
10695;168117;192;58;17;2;15;.882;3600000;0
10695;170202;195;0;0;0;0;.00nan;0;0
10695;175900;192;0;0;0;0;.00nan;0;0
10695;176200;195;56;31;4;27;.871;3547000;0
10866;-1;211;68;47;5;42;.894;3600000;0
10866;175723;180;0;0;0;0;.00nan;0;0
10866;179646;211;0;0;0;0;.00nan;0;0
10866;176938;180;100;22;0;22;1.000;3600000;0
10741;175842;214;0;0;0;0;.00nan;0;0
10741;190125;184;69;25;2;23;.920;3600000;0
10741;179668;184;0;0;0;0;.00nan;0;0
10741;-1;214;65;35;4;31;.886;3600000;0
10734;170963;185;58;15;1;14;.933;3600000;0
10734;171615;181;70;34;3;31;.912;3561000;0
10734;180110;185;0;0;0;0;.00nan;0;0
10734;-1;181;0;0;0;0;.00nan;0;0
11084;-1;210;82;34;2;32;.941;3600000;0
11084;187232;216;0;0;0;0;.00nan;0;0
11084;187240;216;58;30;3;27;.900;3548000;0
11084;192461;210;0;0;0;0;.00nan;0;0
10817;168966;189;0;0;0;0;.00nan;0;0
10817;-1;196;0;0;0;0;.00nan;0;0
10817;184648;196;82;41;3;38;.927;3900000;0
10817;176915;189;70;29;3;26;.897;3900000;0
10845;166695;218;0;0;0;0;.00nan;0;0
10845;-1;218;93;38;2;36;.947;3541000;0
10845;176770;219;100;29;1;28;.966;3600000;0
10845;181102;219;0;0;0;0;.00nan;0;0
11454;168954;228;63;45;6;39;.867;2797000;0
11454;170144;227;62;25;2;23;.920;3600000;0
11454;170300;228;64;12;0;12;1.000;803000;0
11454;-1;227;0;0;0;0;.00nan;0;0
11179;187628;191;0;0;0;0;.00nan;0;0
11179;-1;197;87;47;2;45;.957;3900000;0
11179;170189;197;0;0;0;0;.00nan;0;0
11179;185960;191;62;22;2;20;.909;3900000;0
10872;171835;4960;58;41;6;35;.854;2988000;0
10872;187660;4960;50;1;0;1;1.000;612000;0
10872;173340;231;0;0;0;0;.00nan;0;0
10872;185034;231;61;16;2;14;.875;3600000;0
10799;166545;193;0;0;0;0;.00nan;0;0
10799;169096;190;52;32;4;28;.875;3600000;0
10799;173770;193;57;25;3;22;.880;3600000;0
10799;184788;190;0;0;0;0;.00nan;0;0
10733;168117;192;0;0;0;0;.00nan;0;0
10733;168966;189;84;51;4;47;.922;3735000;0
10733;175900;192;55;22;3;19;.864;3707000;0
10733;176915;189;0;0;0;0;.00nan;0;0
11019;170144;227;0;0;0;0;.00nan;0;0
11019;-1;227;65;19;2;17;.895;3600000;0
11019;179406;232;61;49;6;43;.878;3600000;0
11019;179434;232;0;0;0;0;.00nan;0;0
10679;174334;208;78;19;1;18;.947;3600000;0
10679;175364;206;58;37;4;33;.892;3600000;0
10679;175371;206;0;0;0;0;.00nan;0;0
10679;179702;208;0;0;0;0;.00nan;0;0
10957;174209;178;41;4;1;3;.750;248000;0
10957;176963;178;55;39;5;34;.872;3352000;0
10957;187232;216;86;30;2;28;.933;3600000;0
10957;187240;216;0;0;0;0;.00nan;0;0
10949;-1;203;0;0;0;0;.00nan;0;0
10949;-1;203;53;34;5;29;.853;3600000;0
10949;-1;207;0;0;0;0;.00nan;0;0
10949;-1;207;94;45;1;44;.978;3600000;0
10795;-1;4949;100;48;1;47;.979;3600000;0
10795;168912;4949;0;0;0;0;.00nan;0;0
10795;180762;1505;90;41;2;39;.951;3573000;0
10795;186549;1505;0;0;0;0;.00nan;0;0
10867;173823;198;57;15;2;13;.867;3600000;0
10867;-1;196;64;40;4;36;.900;3533000;0
10867;184648;196;0;0;0;0;.00nan;0;0
10867;181431;198;0;0;0;0;.00nan;0;0
10842;171819;177;0;0;0;0;.00nan;0;0
10842;175328;183;0;0;0;0;.00nan;0;0
10842;179602;177;46;33;5;28;.848;3600000;0
10842;182089;183;71;24;2;22;.917;3600000;0
10790;175370;199;0;0;0;0;.00nan;0;0
10790;182049;204;68;34;4;30;.882;3600000;0
10790;141765;204;0;0;0;0;.00nan;0;0
10790;161006;199;32;21;5;16;.762;3547000;0
10824;170351;194;0;0;0;0;.00nan;0;0
10824;174153;188;0;0;0;0;.00nan;0;0
10824;-1;194;76;34;3;31;.912;3860000;0
10824;-1;188;83;29;2;27;.931;3860000;0
10836;182454;4864;0;0;0;0;.00nan;0;0
10836;183737;4864;100;24;0;24;1.000;3600000;0
10836;166451;176;91;34;1;33;.971;3576000;0
10836;171662;176;0;0;0;0;.00nan;0;0
10903;175723;180;0;0;0;0;.00nan;0;0
10903;176770;219;0;0;0;0;.00nan;0;0
10903;176938;180;79;33;2;31;.939;3576000;0
10903;181102;219;80;20;1;19;.950;3600000;0
10832;171730;220;67;33;3;30;.909;3572000;0
10832;175842;214;73;32;2;30;.938;3600000;0
10832;187443;220;0;0;0;0;.00nan;0;0
10832;-1;214;0;0;0;0;.00nan;0;0
10963;189885;225;84;35;2;33;.943;3600000;0
10963;184610;222;0;0;0;0;.00nan;0;0
10963;184785;225;0;0;0;0;.00nan;0;0
10963;-1;222;54;23;3;20;.870;3543000;0
10833;171970;217;58;35;5;30;.857;3600000;0
10833;167404;215;75;40;3;37;.925;3308000;0
10833;171654;217;0;0;0;0;.00nan;0;0
10833;161046;215;29;8;3;5;.625;292000;0
10895;184175;224;0;0;0;0;.00nan;0;0
10895;-1;224;55;27;4;23;.852;3600000;0
10895;175436;229;0;0;0;0;.00nan;0;0
10895;176860;229;95;34;1;33;.971;3600000;0
10933;171970;217;0;0;0;0;.00nan;0;0
10933;171654;217;100;31;0;31;1.000;3600000;0
10933;179679;212;0;0;0;0;.00nan;0;0
10933;186641;212;64;27;3;24;.889;3600000;0
11672;177248;201;0;0;0;0;.00nan;0;0
11672;174334;208;29;29;6;23;.793;3600000;0
11672;179702;208;0;0;0;0;.00nan;0;0
11672;185743;201;80;32;2;30;.938;3600000;0
11560;169166;226;52;29;4;25;.862;3716000;0
11560;175370;199;96;51;3;48;.941;3716000;0
11560;192629;226;0;0;0;0;.00nan;0;0
11560;161006;199;0;0;0;0;.00nan;0;0
10877;166545;193;91;37;2;35;.946;3900000;0
10877;169096;190;89;40;2;38;.950;3900000;0
10877;173770;193;0;0;0;0;.00nan;0;0
10877;184788;190;0;0;0;0;.00nan;0;0
10904;168995;205;63;25;2;23;.920;3900000;0
10904;170141;200;0;0;0;0;.00nan;0;0
10904;-1;205;0;0;0;0;.00nan;0;0
10904;187295;200;98;46;2;44;.957;3900000;0
11135;187628;191;38;21;4;17;.810;3706000;0
11135;189081;187;54;40;5;35;.875;3706000;0
11135;-1;187;0;0;0;0;.00nan;0;0
11135;185960;191;0;0;0;0;.00nan;0;0
10762;171615;181;0;0;0;0;.00nan;0;0
10762;-1;1371;0;0;0;0;.00nan;0;0
10762;-1;181;100;30;0;30;1.000;3600000;0
10762;192688;1371;97;41;1;40;.976;3600000;0
10839;183860;4959;0;0;0;0;.00nan;0;0
10839;170114;4959;78;23;1;22;.957;3600000;0
10839;171405;2620;0;0;0;0;.00nan;0;0
10839;176921;2620;68;25;2;23;.920;3587000;0
11145;173916;230;0;0;0;0;.00nan;0;0
11145;-1;221;76;39;3;36;.923;3600000;0
11145;186495;230;70;20;2;18;.900;3600000;0
11145;187362;221;0;0;0;0;.00nan;0;0
10964;-1;202;38;25;5;20;.800;3600000;0
10964;-1;207;92;25;0;25;1.000;3600000;0
10964;180623;202;0;0;0;0;.00nan;0;0
10964;-1;207;0;0;0;0;.00nan;0;0
10798;168117;192;19;9;4;5;.556;2219000;0
10798;174153;188;81;49;4;45;.918;3600000;0
10798;-1;188;0;0;0;0;.00nan;0;0
10798;175900;192;56;11;1;10;.909;1381000;0
10882;183860;4959;28;17;4;13;.765;1139000;0
10882;170114;4959;77;25;2;23;.920;2461000;0
10882;171660;209;82;29;3;26;.897;3600000;0
10882;186205;209;0;0;0;0;.00nan;0;0
11248;166762;213;66;40;4;36;.900;3600000;0
11248;170076;179;89;29;1;28;.966;3600000;0
11248;174147;179;0;0;0;0;.00nan;0;0
11248;180575;213;0;0;0;0;.00nan;0;0
11599;173900;182;0;0;0;0;.00nan;0;0
11599;175842;214;0;0;0;0;.00nan;0;0
11599;182116;182;57;33;4;29;.879;3598000;0
11599;-1;214;99;35;2;33;.943;3600000;0
10868;173823;198;62;21;3;18;.857;3600000;0
10868;-1;196;0;0;0;0;.00nan;0;0
10868;184648;196;73;36;4;32;.889;3552000;0
10868;181431;198;0;0;0;0;.00nan;0;0
10823;175364;206;67;28;3;25;.893;3600000;0
10823;175371;206;0;0;0;0;.00nan;0;0
10823;182049;204;74;38;5;33;.868;3600000;0
10823;141765;204;0;0;0;0;.00nan;0;0
10849;170141;200;0;0;0;0;.00nan;0;0
10849;174334;208;57;20;2;18;.900;3600000;0
10849;179702;208;0;0;0;0;.00nan;0;0
10849;187295;200;50;39;5;34;.872;3600000;0
10978;184175;224;70;18;1;17;.944;3600000;0
10978;-1;224;0;0;0;0;.00nan;0;0
10978;-1;221;63;30;3;27;.900;3600000;0
10978;187362;221;0;0;0;0;.00nan;0;0
10953;171730;220;0;0;0;0;.00nan;0;0
10953;-1;1371;0;0;0;0;.00nan;0;0
10953;187443;220;68;31;3;28;.903;3590000;0
10953;192688;1371;84;27;2;25;.926;3600000;0
10970;177248;201;95;40;1;39;.975;3900000;0
10970;-1;202;86;36;1;35;.972;3900000;0
10970;180623;202;0;0;0;0;.00nan;0;0
10970;185743;201;0;0;0;0;.00nan;0;0
10894;187628;191;0;0;0;0;.00nan;0;0
10894;168966;189;0;0;0;0;.00nan;0;0
10894;176915;189;65;36;5;31;.861;3600000;0
10894;185960;191;74;24;1;23;.958;3600000;0
11209;166695;218;0;0;0;0;.00nan;0;0
11209;-1;218;86;28;2;26;.929;3686000;0
11209;179679;212;0;0;0;0;.00nan;0;0
11209;186641;212;86;27;1;26;.963;3686000;0
10986;170076;179;65;15;1;14;.933;3600000;0
10986;174147;179;0;0;0;0;.00nan;0;0
10986;175328;183;0;0;0;0;.00nan;0;0
10986;182089;183;81;41;2;39;.951;3569000;0
10934;166762;213;87;45;3;42;.933;3566000;0
10934;-1;4949;0;0;0;0;.00nan;0;0
10934;168912;4949;71;28;2;26;.929;3600000;0
10934;180575;213;0;0;0;0;.00nan;0;0
10814;175423;223;90;35;1;34;.971;3626000;0
10814;175436;229;0;0;0;0;.00nan;0;0
10814;176860;229;93;31;2;29;.935;3626000;0
10814;-1;223;0;0;0;0;.00nan;0;0
10929;173340;231;0;0;0;0;.00nan;0;0
10929;184610;222;0;0;0;0;.00nan;0;0
10929;185034;231;71;21;1;20;.952;3600000;0
10929;-1;222;80;36;2;34;.944;3600000;0
10854;182454;4864;0;0;0;0;.00nan;0;0
10854;183737;4864;74;27;2;25;.926;3530000;0
10854;166451;176;0;0;0;0;.00nan;0;0
10854;171662;176;100;40;0;40;1.000;3600000;0
10697;187628;191;64;40;4;36;.900;3600000;0
10697;170202;195;0;0;0;0;.00nan;0;0
10697;176200;195;92;18;0;18;1.000;3600000;0
10697;185960;191;0;0;0;0;.00nan;0;0
10846;166695;218;0;0;0;0;.00nan;0;0
10846;167404;215;0;0;0;0;.00nan;0;0
10846;-1;218;83;38;3;35;.921;3900000;0
10846;161046;215;83;37;3;34;.919;3900000;0
10858;168907;186;0;0;0;0;.00nan;0;0
10858;169226;186;48;23;3;20;.870;3600000;0
10858;175723;180;0;0;0;0;.00nan;0;0
10858;176938;180;100;30;0;30;1.000;3600000;0
10850;171405;2620;0;0;0;0;.00nan;0;0
10850;171660;209;90;32;1;31;.969;3600000;0
10850;176921;2620;55;21;3;18;.857;3594000;0
10850;186205;209;0;0;0;0;.00nan;0;0
10879;171615;181;51;25;4;21;.840;3600000;0
10879;190125;184;42;29;5;24;.828;3588000;0
10879;179668;184;0;0;0;0;.00nan;0;0
10879;-1;181;0;0;0;0;.00nan;0;0
11304;176770;219;79;31;2;29;.935;3600000;0
11304;179679;212;98;51;3;48;.941;3587000;0
11304;181102;219;0;0;0;0;.00nan;0;0
11304;186641;212;0;0;0;0;.00nan;0;0
10825;169096;190;0;0;0;0;.00nan;0;0
10825;174153;188;0;0;0;0;.00nan;0;0
10825;-1;188;55;26;3;23;.885;3562000;0
10825;184788;190;90;43;2;41;.953;3600000;0
10813;180762;1505;66;25;2;23;.920;3600000;0
10813;186549;1505;0;0;0;0;.00nan;0;0
10813;187232;216;0;0;0;0;.00nan;0;0
10813;187240;216;53;27;4;23;.852;3580000;0
10870;168117;192;56;24;3;21;.875;3600000;0
10870;189081;187;0;0;0;0;.00nan;0;0
10870;175900;192;0;0;0;0;.00nan;0;0
10870;-1;187;32;39;7;32;.821;3600000;0
10871;171819;177;0;0;0;0;.00nan;0;0
10871;174209;178;0;0;0;0;.00nan;0;0
10871;179602;177;71;22;1;21;.955;3600000;0
10871;176963;178;89;46;4;42;.913;3600000;0
11107;173900;182;0;0;0;0;.00nan;0;0
11107;170963;185;100;20;0;20;1.000;3600000;0
11107;180110;185;0;0;0;0;.00nan;0;0
11107;182116;182;98;32;1;31;.969;3574000;0
10847;168966;189;0;0;0;0;.00nan;0;0
10847;170351;194;0;0;0;0;.00nan;0;0
10847;-1;194;55;36;5;31;.861;3558000;0
10847;176915;189;51;29;4;25;.862;3600000;0
11030;-1;221;0;0;0;0;.00nan;0;0
11030;175423;223;0;0;0;0;.00nan;0;0
11030;-1;223;57;40;5;35;.875;3900000;0
11030;187362;221;49;30;5;25;.833;3900000;0
10717;174334;208;0;0;0;0;.00nan;0;0
10717;179702;208;80;27;1;26;.963;3600000;0
10717;-1;207;43;23;4;19;.826;3600000;0
10717;-1;207;0;0;0;0;.00nan;0;0
10930;166545;193;34;30;6;24;.800;2030000;0
10930;-1;197;78;41;4;37;.902;3600000;0
10930;173770;193;57;7;0;7;1.000;1496000;0
10930;170189;197;0;0;0;0;.00nan;0;0
10921;173340;231;42;15;3;12;.800;3552000;0
10921;189885;225;80;39;2;37;.949;3600000;0
10921;184785;225;0;0;0;0;.00nan;0;0
10921;185034;231;0;0;0;0;.00nan;0;0
10944;171730;220;71;34;3;31;.912;3600000;0
10944;175842;214;38;17;4;13;.765;1298000;0
10944;187443;220;0;0;0;0;.00nan;0;0
10944;-1;214;15;19;6;13;.684;2302000;0
10952;184175;224;0;0;0;0;.00nan;0;0
10952;173916;230;0;0;0;0;.00nan;0;0
10952;-1;224;74;42;3;39;.929;3541000;0
10952;186495;230;63;14;1;13;.929;3600000;0
10943;171970;217;0;0;0;0;.00nan;0;0
10943;-1;211;65;36;4;32;.889;3600000;0
10943;171654;217;77;23;1;22;.957;3600000;0
10943;179646;211;0;0;0;0;.00nan;0;0
10984;-1;210;0;0;0;0;.00nan;0;0
10984;175328;183;98;58;2;56;.966;3600000;0
10984;182089;183;0;0;0;0;.00nan;0;0
10984;192461;210;80;24;1;23;.958;3600000;0
10972;171835;4960;71;19;1;18;.947;3600000;0
10972;187660;4960;0;0;0;0;.00nan;0;0
10972;179406;232;88;45;3;42;.933;3522000;0
10972;179434;232;0;0;0;0;.00nan;0;0
10937;168995;205;22;5;3;2;.400;483000;0
10937;175370;199;100;43;1;42;.977;3600000;0
10937;-1;205;34;17;4;13;.765;3117000;0
10937;161006;199;0;0;0;0;.00nan;0;0
10931;182454;4864;21;25;6;19;.760;3312000;0
10931;183737;4864;48;0;0;0;.00nan;217000;0
10931;166451;176;63;38;4;34;.895;3600000;0
10931;171662;176;0;0;0;0;.00nan;0;0
11021;177248;201;50;1;0;1;1.000;328000;0
11021;-1;203;100;21;0;21;1.000;3600000;0
11021;-1;203;0;0;0;0;.00nan;0;0
11021;185743;201;48;38;6;32;.842;3272000;0
11265;168954;228;16;20;6;14;.700;2492000;0
11265;170300;228;46;5;1;4;.800;1108000;0
11265;189885;225;77;41;2;39;.951;3600000;0
11265;184785;225;0;0;0;0;.00nan;0;0
10700;189081;187;76;27;2;25;.926;3600000;0
10700;170202;195;46;26;4;22;.846;3575000;0
10700;176200;195;0;0;0;0;.00nan;0;0
10700;-1;187;0;0;0;0;.00nan;0;0
11059;183860;4959;0;0;0;0;.00nan;0;0
11059;170114;4959;71;51;5;46;.902;3600000;0
11059;171660;209;0;0;0;0;.00nan;0;0
11059;186205;209;100;35;0;35;1.000;3600000;0
11370;166762;213;0;0;0;0;.00nan;0;0
11370;170076;179;33;22;5;17;.773;3565000;0
11370;174147;179;0;0;0;0;.00nan;0;0
11370;180575;213;83;52;4;48;.923;3600000;0
10912;167404;215;88;29;1;28;.966;3600000;0
10912;175723;180;0;0;0;0;.00nan;0;0
10912;176938;180;75;36;3;33;.917;3521000;0
10912;161046;215;0;0;0;0;.00nan;0;0
10997;184175;224;0;0;0;0;.00nan;0;0
10997;170144;227;90;22;0;22;1.000;3600000;0
10997;-1;224;86;43;3;40;.930;3600000;0
10997;-1;227;0;0;0;0;.00nan;0;0
10827;-1;203;45;20;3;17;.850;3600000;0
10827;175364;206;31;6;3;3;.500;486000;0
10827;175371;206;62;24;2;22;.917;3114000;0
10827;-1;203;0;0;0;0;.00nan;0;0
11082;187628;191;0;0;0;0;.00nan;0;0
11082;174153;188;87;50;4;46;.920;3600000;0
11082;-1;188;0;0;0;0;.00nan;0;0
11082;185960;191;50;18;3;15;.833;3600000;0
11619;169166;226;83;27;1;26;.963;3600000;0
11619;175370;199;33;30;6;24;.800;3600000;0
11619;192629;226;0;0;0;0;.00nan;0;0
11619;161006;199;0;0;0;0;.00nan;0;0
10946;173340;231;0;0;0;0;.00nan;0;0
10946;179406;232;47;34;5;29;.853;3600000;0
10946;179434;232;0;0;0;0;.00nan;0;0
10946;185034;231;79;31;2;29;.935;3600000;0
10761;177248;201;72;28;2;26;.929;3600000;0
10761;174334;208;62;14;1;13;.929;3600000;0
10761;179702;208;0;0;0;0;.00nan;0;0
10761;185743;201;0;0;0;0;.00nan;0;0
11075;-1;210;0;0;0;0;.00nan;0;0
11075;175328;183;39;35;6;29;.829;1772000;0
11075;182089;183;31;31;6;25;.806;1828000;0
11075;192461;210;52;15;2;13;.867;3600000;0
10955;168966;189;76;27;1;26;.963;3600000;0
10955;170351;194;24;31;7;24;.774;3600000;0
10955;-1;194;0;0;0;0;.00nan;0;0
10955;176915;189;0;0;0;0;.00nan;0;0
10958;173900;182;0;0;0;0;.00nan;0;0
10958;171730;220;35;35;6;29;.829;3600000;0
10958;182116;182;95;30;1;29;.967;3600000;0
10958;187443;220;0;0;0;0;.00nan;0;0
10826;170963;185;69;26;2;24;.923;3600000;0
10826;171615;181;0;0;0;0;.00nan;0;0
10826;180110;185;0;0;0;0;.00nan;0;0
10826;-1;181;60;39;5;34;.872;3600000;0
10940;175842;214;84;49;4;45;.918;3600000;0
10940;190125;184;63;23;2;21;.913;3600000;0
10940;179668;184;0;0;0;0;.00nan;0;0
10940;-1;214;0;0;0;0;.00nan;0;0
11411;168954;228;0;0;0;0;.00nan;0;0
11411;170300;228;67;36;3;33;.917;3590000;0
11411;173916;230;0;0;0;0;.00nan;0;0
11411;186495;230;100;37;1;36;.973;3600000;0
10927;-1;197;59;41;5;36;.878;3588000;0
10927;169096;190;61;28;3;25;.893;3600000;0
10927;170189;197;0;0;0;0;.00nan;0;0
10927;184788;190;0;0;0;0;.00nan;0;0
10913;166451;176;61;13;0;13;1.000;593000;0
10913;171405;2620;0;0;0;0;.00nan;0;0
10913;171662;176;36;31;6;25;.806;3007000;0
10913;176921;2620;45;31;5;26;.839;3600000;0
11043;174209;178;0;0;0;0;.00nan;0;0
11043;176963;178;94;52;4;48;.923;3511000;0
11043;187232;216;0;0;0;0;.00nan;0;0
11043;187240;216;65;21;2;19;.905;3600000;0
11337;176770;219;84;29;1;28;.966;3600000;0
11337;179679;212;0;0;0;0;.00nan;0;0
11337;181102;219;0;0;0;0;.00nan;0;0
11337;186641;212;61;26;3;23;.885;3600000;0
10886;171819;177;0;0;0;0;.00nan;0;0
10886;179602;177;56;47;7;40;.851;3600000;0
10886;180762;1505;79;23;1;22;.957;3600000;0
10886;186549;1505;0;0;0;0;.00nan;0;0
10907;170141;200;0;0;0;0;.00nan;0;0
10907;-1;202;51;24;3;21;.875;3600000;0
10907;180623;202;0;0;0;0;.00nan;0;0
10907;187295;200;67;43;5;38;.884;3590000;0
10863;166545;193;46;20;3;17;.850;3600000;0
10863;168117;192;29;13;4;9;.692;1107000;0
10863;173770;193;0;0;0;0;.00nan;0;0
10863;175900;192;58;28;3;25;.893;2493000;0
10909;166695;218;0;0;0;0;.00nan;0;0
10909;171970;217;68;36;4;32;.889;3629000;0
10909;171654;217;0;0;0;0;.00nan;0;0
10909;-1;218;60;23;3;20;.870;3629000;0
10975;-1;211;88;39;2;37;.949;3600000;0
10975;168907;186;68;24;1;23;.958;3600000;0
10975;169226;186;0;0;0;0;.00nan;0;0
10975;179646;211;0;0;0;0;.00nan;0;0
10794;-1;207;77;32;2;30;.938;3600000;0
10794;182049;204;57;26;4;22;.846;3514000;0
10794;-1;207;0;0;0;0;.00nan;0;0
10794;141765;204;0;0;0;0;.00nan;0;0
10923;170141;200;74;60;7;53;.883;3600000;0
10923;175370;199;0;0;0;0;.00nan;0;0
10923;187295;200;0;0;0;0;.00nan;0;0
10923;161006;199;46;11;2;9;.818;3600000;0
11128;166762;213;98;51;3;48;.941;3555000;0
11128;-1;210;66;17;1;16;.941;3600000;0
11128;180575;213;0;0;0;0;.00nan;0;0
11128;192461;210;0;0;0;0;.00nan;0;0
10985;-1;202;0;0;0;0;.00nan;0;0
10985;-1;207;0;0;0;0;.00nan;0;0
10985;180623;202;54;27;4;23;.852;3900000;0
10985;-1;207;65;37;4;33;.892;3900000;0
10785;175364;206;66;15;1;14;.933;3703000;0
10785;175371;206;0;0;0;0;.00nan;0;0
10785;182049;204;72;27;2;25;.926;3703000;0
10785;141765;204;0;0;0;0;.00nan;0;0
10910;171819;177;0;0;0;0;.00nan;0;0
10910;-1;4949;63;31;3;28;.903;3600000;0
10910;168912;4949;0;0;0;0;.00nan;0;0
10910;179602;177;90;21;0;21;1.000;3600000;0
10811;173823;198;58;26;3;23;.885;3821000;0
10811;170202;195;0;0;0;0;.00nan;0;0
10811;176200;195;56;31;4;27;.871;3821000;0
10811;181431;198;0;0;0;0;.00nan;0;0
10926;173916;230;0;0;0;0;.00nan;0;0
10926;175436;229;0;0;0;0;.00nan;0;0
10926;176860;229;75;44;4;40;.909;3577000;0
10926;186495;230;76;30;2;28;.933;3600000;0
10941;-1;1371;43;24;4;20;.833;3600000;0
10941;190125;184;0;0;0;0;.00nan;0;0
10941;179668;184;96;36;1;35;.972;3600000;0
10941;192688;1371;0;0;0;0;.00nan;0;0
11027;189081;187;0;0;0;0;.00nan;0;0
11027;168966;189;29;26;6;20;.769;2127000;0
11027;176915;189;48;29;4;25;.862;1473000;0
11027;-1;187;79;13;0;13;1.000;3600000;0
10942;170963;185;0;0;0;0;.00nan;0;0
10942;171615;181;66;31;3;28;.903;3600000;0
10942;180110;185;33;24;5;19;.792;3600000;0
10942;-1;181;0;0;0;0;.00nan;0;0
10822;168117;192;47;12;2;10;.833;3749000;0
10822;-1;196;0;0;0;0;.00nan;0;0
10822;184648;196;92;46;3;43;.935;3749000;0
10822;175900;192;0;0;0;0;.00nan;0;0
10939;171835;4960;97;22;0;22;1.000;3600000;0
10939;187660;4960;0;0;0;0;.00nan;0;0
10939;179406;232;24;17;5;12;.706;1025000;0
10939;179434;232;57;34;4;30;.882;2575000;0
11011;182454;4864;0;0;0;0;.00nan;0;0
11011;183737;4864;62;24;2;22;.917;3600000;0
11011;171405;2620;75;22;1;21;.955;3600000;0
11011;176921;2620;0;0;0;0;.00nan;0;0
10843;-1;197;70;43;5;38;.884;3633000;0
10843;170189;197;0;0;0;0;.00nan;0;0
10843;174153;188;0;0;0;0;.00nan;0;0
10843;-1;188;47;28;4;24;.857;3633000;0
11042;189885;225;75;48;5;43;.896;3580000;0
11042;184610;222;49;22;3;19;.864;3600000;0
11042;184785;225;0;0;0;0;.00nan;0;0
11042;-1;222;0;0;0;0;.00nan;0;0
11052;168995;205;63;43;5;38;.884;3560000;0
11052;-1;203;0;0;0;0;.00nan;0;0
11052;-1;203;82;42;3;39;.929;3600000;0
11052;-1;205;0;0;0;0;.00nan;0;0
11187;174209;178;0;0;0;0;.00nan;0;0
11187;176963;178;92;50;3;47;.940;3900000;0
11187;187232;216;67;31;3;28;.903;3900000;0
11187;187240;216;0;0;0;0;.00nan;0;0
11185;168954;228;44;30;5;25;.833;3600000;0
11185;170300;228;0;0;0;0;.00nan;0;0
11185;175423;223;89;38;1;37;.974;3600000;0
11185;-1;223;0;0;0;0;.00nan;0;0
11167;168995;205;0;0;0;0;.00nan;0;0
11167;169166;226;80;34;2;32;.941;3590000;0
11167;-1;205;83;27;1;26;.963;3600000;0
11167;192629;226;0;0;0;0;.00nan;0;0
11130;170144;227;65;26;2;24;.923;3557000;0
11130;-1;221;0;0;0;0;.00nan;0;0
11130;-1;227;0;0;0;0;.00nan;0;0
11130;187362;221;100;40;1;39;.975;3600000;0
10976;183860;4959;0;0;0;0;.00nan;0;0
10976;170114;4959;59;32;4;28;.875;3563000;0
10976;171660;209;0;0;0;0;.00nan;0;0
10976;186205;209;73;29;2;27;.931;3600000;0
11041;-1;1371;0;0;0;0;.00nan;0;0
11041;175842;214;54;35;5;30;.857;3600000;0
11041;-1;214;0;0;0;0;.00nan;0;0
11041;192688;1371;65;14;1;13;.929;3600000;0
10899;166545;193;61;14;1;13;.929;3600000;0
10899;173770;193;0;0;0;0;.00nan;0;0
10899;-1;196;74;37;3;34;.919;3556000;0
10899;184648;196;0;0;0;0;.00nan;0;0
10893;-1;4949;51;21;3;18;.857;1982000;0
10893;168912;4949;6;27;8;19;.704;1618000;0
10893;180762;1505;0;0;0;0;.00nan;0;0
10893;186549;1505;79;36;3;33;.917;3600000;0
10947;-1;211;84;37;2;35;.946;3600000;0
10947;175723;180;0;0;0;0;.00nan;0;0
10947;179646;211;0;0;0;0;.00nan;0;0
10947;176938;180;51;25;4;21;.840;3541000;0
10996;168907;186;0;0;0;0;.00nan;0;0
10996;169226;186;70;34;4;30;.882;3572000;0
10996;176770;219;68;26;3;23;.885;3600000;0
10996;181102;219;0;0;0;0;.00nan;0;0
10983;171970;217;66;36;3;33;.917;3600000;0
10983;167404;215;0;0;0;0;.00nan;0;0
10983;171654;217;0;0;0;0;.00nan;0;0
10983;161046;215;46;22;4;18;.818;3569000;0
10977;169096;190;42;34;5;29;.853;3600000;0
10977;173823;198;0;0;0;0;.00nan;0;0
10977;184788;190;0;0;0;0;.00nan;0;0
10977;181431;198;55;17;2;15;.882;3600000;0
10896;184610;222;0;0;0;0;.00nan;0;0
10896;175436;229;0;0;0;0;.00nan;0;0
10896;176860;229;69;49;5;44;.898;3600000;0
10896;-1;222;84;13;0;13;1.000;3600000;0
11620;170963;185;62;29;3;26;.897;3600000;0
11620;190125;184;59;29;4;25;.862;3548000;0
11620;179668;184;0;0;0;0;.00nan;0;0
11620;180110;185;0;0;0;0;.00nan;0;0
11171;183860;4959;100;31;0;31;1.000;3600000;0
11171;170114;4959;0;0;0;0;.00nan;0;0
11171;171405;2620;0;0;0;0;.00nan;0;0
11171;176921;2620;88;32;1;31;.969;3600000;0
11194;171835;4960;91;29;1;28;.966;3600000;0
11194;187660;4960;0;0;0;0;.00nan;0;0
11194;170144;227;0;0;0;0;.00nan;0;0
11194;-1;227;93;39;2;37;.949;3572000;0
10889;174334;208;66;17;1;16;.941;3600000;0
10889;179702;208;0;0;0;0;.00nan;0;0
10889;-1;207;82;40;3;37;.925;3595000;0
10889;-1;207;0;0;0;0;.00nan;0;0
10844;177248;201;0;0;0;0;.00nan;0;0
10844;182049;204;68;28;3;25;.893;3553000;0
10844;185743;201;79;30;2;28;.933;3600000;0
10844;141765;204;0;0;0;0;.00nan;0;0
11000;170141;200;0;0;0;0;.00nan;0;0
11000;175364;206;0;0;0;0;.00nan;0;0
11000;175371;206;92;37;1;36;.973;3799000;0
11000;187295;200;80;30;2;28;.933;3799000;0
11071;171730;220;99;30;1;29;.967;3600000;0
11071;175842;214;31;12;3;9;.750;790000;0
11071;187443;220;0;0;0;0;.00nan;0;0
11071;-1;214;7;28;8;20;.714;2810000;0
10979;166695;218;91;47;3;44;.936;3543000;0
10979;-1;211;87;35;2;33;.943;3600000;0
10979;-1;218;0;0;0;0;.00nan;0;0
10979;179646;211;0;0;0;0;.00nan;0;0
10980;173900;182;0;0;0;0;.00nan;0;0
10980;171615;181;0;0;0;0;.00nan;0;0
10980;182116;182;100;35;0;35;1.000;3600000;0
10980;-1;181;58;28;3;25;.893;3600000;0
10990;187628;191;0;0;0;0;.00nan;0;0
10990;170351;194;0;0;0;0;.00nan;0;0
10990;-1;194;71;38;3;35;.921;3597000;0
10990;185960;191;78;24;1;23;.958;3600000;0
11078;173340;231;0;0;0;0;.00nan;0;0
11078;175423;223;73;44;4;40;.909;3600000;0
11078;185034;231;93;23;0;23;1.000;3600000;0
11078;-1;223;0;0;0;0;.00nan;0;0
11009;166545;193;57;14;1;13;.929;3600000;0
11009;173770;193;0;0;0;0;.00nan;0;0
11009;174153;188;89;25;0;25;1.000;1007000;0
11009;-1;188;45;33;6;27;.818;2593000;0
10922;-1;4949;52;20;3;17;.850;3600000;0
10922;168912;4949;0;0;0;0;.00nan;0;0
10922;174209;178;0;0;0;0;.00nan;0;0
10922;176963;178;61;39;4;35;.897;3600000;0
11046;169166;226;85;36;2;34;.944;3900000;0
11046;-1;203;0;0;0;0;.00nan;0;0
11046;-1;203;61;24;2;22;.917;3900000;0
11046;192629;226;0;0;0;0;.00nan;0;0
10989;171660;209;70;19;2;17;.895;3600000;0
10989;171662;176;70;39;4;35;.897;3577000;0
10989;176932;176;0;0;0;0;.00nan;0;0
10989;186205;209;0;0;0;0;.00nan;0;0
11326;168954;228;99;21;0;21;1.000;3600000;0
11326;170300;228;0;0;0;0;.00nan;0;0
11326;-1;221;0;0;0;0;.00nan;0;0
11326;187362;221;86;35;3;32;.914;3600000;0
11199;187628;191;87;38;2;36;.947;3831000;0
11199;173823;198;98;42;1;41;.976;3831000;0
11199;181431;198;0;0;0;0;.00nan;0;0
11199;185960;191;0;0;0;0;.00nan;0;0
11445;171835;4960;21;25;6;19;.760;3600000;0
11445;187660;4960;0;0;0;0;.00nan;0;0
11445;170144;227;86;43;2;41;.953;3600000;0
11445;-1;227;0;0;0;0;.00nan;0;0
11048;175723;180;0;0;0;0;.00nan;0;0
11048;176770;219;70;32;2;30;.938;3900000;0
11048;176938;180;97;40;2;38;.950;3900000;0
11048;181102;219;0;0;0;0;.00nan;0;0
11072;183860;4959;75;35;3;32;.914;3600000;0
11072;170114;4959;0;0;0;0;.00nan;0;0
11072;171405;2620;0;0;0;0;.00nan;0;0
11072;176921;2620;91;17;0;17;1.000;3600000;0
11257;-1;210;0;0;0;0;.00nan;0;0
11257;187232;216;0;0;0;0;.00nan;0;0
11257;187240;216;100;32;0;32;1.000;3600000;0
11257;192461;210;45;30;5;25;.833;3600000;0
11003;171970;217;62;27;3;24;.889;3553000;0
11003;171654;217;0;0;0;0;.00nan;0;0
11003;179679;212;72;28;2;26;.929;3600000;0
11003;186641;212;0;0;0;0;.00nan;0;0
11005;167404;215;0;0;0;0;.00nan;0;0
11005;-1;211;0;0;0;0;.00nan;0;0
11005;179646;211;65;35;3;32;.914;3600000;0
11005;161046;215;62;39;4;35;.897;3576000;0
11002;173340;231;0;0;0;0;.00nan;0;0
11002;184610;222;0;0;0;0;.00nan;0;0
11002;185034;231;64;34;4;30;.882;3574000;0
11002;-1;222;56;24;3;21;.875;3600000;0
11014;169096;190;0;0;0;0;.00nan;0;0
11014;-1;196;0;0;0;0;.00nan;0;0
11014;184648;196;67;29;2;27;.931;3600000;0
11014;184788;190;51;26;3;23;.885;3600000;0
11023;166695;218;0;0;0;0;.00nan;0;0
11023;168907;186;0;0;0;0;.00nan;0;0
11023;169226;186;76;26;2;24;.923;3600000;0
11023;-1;218;80;49;4;45;.918;3600000;0
11070;173900;182;0;0;0;0;.00nan;0;0
11070;175842;214;91;39;3;36;.923;3689000;0
11070;182116;182;70;24;2;22;.917;3689000;0
11070;-1;214;0;0;0;0;.00nan;0;0
10995;171615;181;52;31;4;27;.871;3545000;0
10995;190125;184;78;27;2;25;.926;3600000;0
10995;179668;184;0;0;0;0;.00nan;0;0
10995;-1;181;0;0;0;0;.00nan;0;0
10962;175423;223;0;0;0;0;.00nan;0;0
10962;175436;229;0;0;0;0;.00nan;0;0
10962;176860;229;55;31;4;27;.871;3579000;0
10962;-1;223;93;34;2;32;.941;3600000;0
10954;174334;208;67;35;3;32;.914;3574000;0
10954;175370;199;86;28;1;27;.964;3600000;0
10954;179702;208;0;0;0;0;.00nan;0;0
10954;161006;199;0;0;0;0;.00nan;0;0
11110;169166;226;0;0;0;0;.00nan;0;0
11110;-1;202;64;32;3;29;.906;3600000;0
11110;180623;202;0;0;0;0;.00nan;0;0
11110;192629;226;100;24;0;24;1.000;3600000;0
10961;-1;197;58;36;4;32;.889;3591000;0
10961;170189;197;0;0;0;0;.00nan;0;0
10961;174153;188;84;33;2;31;.939;3600000;0
10961;-1;188;0;0;0;0;.00nan;0;0
10948;170963;185;100;27;0;27;1.000;3600000;0
10948;171730;220;0;0;0;0;.00nan;0;0
10948;180110;185;0;0;0;0;.00nan;0;0
10948;187443;220;64;36;4;32;.889;3600000;0
10925;170141;200;23;13;4;9;.692;951000;0
10925;-1;203;86;33;2;31;.939;3600000;0
10925;-1;203;0;0;0;0;.00nan;0;0
10925;187295;200;56;27;4;23;.852;2649000;0
10901;166545;193;0;0;0;0;.00nan;0;0
10901;189081;187;0;0;0;0;.00nan;0;0
10901;173770;193;61;30;4;26;.867;3600000;0
10901;-1;187;38;27;5;22;.815;3543000;0
11090;184175;224;88;47;3;44;.936;3600000;0
11090;173916;230;0;0;0;0;.00nan;0;0
11090;-1;224;0;0;0;0;.00nan;0;0
11090;186495;230;90;20;0;20;1.000;3600000;0
10864;168995;205;85;18;0;18;1.000;3600000;0
10864;182049;204;57;41;6;35;.854;3600000;0
10864;-1;205;0;0;0;0;.00nan;0;0
10864;141765;204;0;0;0;0;.00nan;0;0
10898;170076;179;0;0;0;0;.00nan;0;0
10898;174147;179;59;35;4;31;.886;3600000;0
10898;180762;1505;50;22;3;19;.864;3600000;0
10898;186549;1505;0;0;0;0;.00nan;0;0
10982;166762;213;89;28;2;26;.929;3811000;0
10982;-1;4949;0;0;0;0;.00nan;0;0
10982;168912;4949;83;35;3;32;.914;3811000;0
10982;180575;213;0;0;0;0;.00nan;0;0
10837;168117;192;0;0;0;0;.00nan;0;0
10837;170202;195;0;0;0;0;.00nan;0;0
10837;175900;192;81;28;2;26;.929;3648000;0
10837;176200;195;65;24;3;21;.875;3648000;0
10973;171819;177;0;0;0;0;.00nan;0;0
10973;175328;183;0;0;0;0;.00nan;0;0
10973;179602;177;67;25;3;22;.880;3600000;0
10973;182089;183;94;48;4;44;.917;3600000;0
10969;189885;225;88;42;2;40;.952;3600000;0
10969;179406;232;60;38;4;34;.895;3546000;0
10969;179434;232;0;0;0;0;.00nan;0;0
10969;184785;225;0;0;0;0;.00nan;0;0
11004;177248;201;0;0;0;0;.00nan;0;0
11004;175364;206;84;33;2;31;.939;3600000;0
11004;175371;206;0;0;0;0;.00nan;0;0
11004;185743;201;53;26;4;22;.846;3588000;0
11526;183860;4959;0;0;0;0;.00nan;0;0
11526;170114;4959;67;18;1;17;.944;3900000;0
11526;171405;2620;0;0;0;0;.00nan;0;0
11526;176921;2620;88;38;1;37;.974;3900000;0
11158;171970;217;0;0;0;0;.00nan;0;0
11158;168907;186;87;35;3;32;.914;3600000;0
11158;169226;186;0;0;0;0;.00nan;0;0
11158;171654;217;42;22;4;18;.818;3593000;0
10967;170963;185;66;25;2;23;.920;3600000;0
10967;190125;184;0;0;0;0;.00nan;0;0
10967;179668;184;62;38;4;34;.895;3589000;0
10967;180110;185;0;0;0;0;.00nan;0;0
10897;168117;192;91;29;1;28;.966;3600000;0
10897;169096;190;88;55;5;50;.909;3600000;0
10897;175900;192;0;0;0;0;.00nan;0;0
10897;184788;190;0;0;0;0;.00nan;0;0
11440;171835;4960;82;22;1;21;.955;3600000;0
11440;187660;4960;0;0;0;0;.00nan;0;0
11440;168954;228;62;48;5;43;.896;3600000;0
11440;170300;228;0;0;0;0;.00nan;0;0
10885;174334;208;30;18;4;14;.778;3542000;0
10885;179702;208;0;0;0;0;.00nan;0;0
10885;-1;207;76;34;3;31;.912;3600000;0
10885;-1;207;0;0;0;0;.00nan;0;0
11055;-1;4949;68;29;2;27;.931;3600000;0
11055;168912;4949;0;0;0;0;.00nan;0;0
11055;187232;216;0;0;0;0;.00nan;0;0
11055;187240;216;57;31;5;26;.839;3600000;0
11054;182454;4864;0;0;0;0;.00nan;0;0
11054;183737;4864;83;21;1;20;.952;3600000;0
11054;171660;209;0;0;0;0;.00nan;0;0
11054;186205;209;80;32;2;30;.938;3600000;0
11219;168995;205;80;41;4;37;.902;3545000;0
11219;169166;226;0;0;0;0;.00nan;0;0
11219;-1;205;0;0;0;0;.00nan;0;0
11219;192629;226;58;26;3;23;.885;3600000;0
11066;184175;224;0;0;0;0;.00nan;0;0
11066;173916;230;0;0;0;0;.00nan;0;0
11066;-1;224;82;34;2;32;.941;3600000;0
11066;186495;230;82;43;3;40;.930;3551000;0
11065;170141;200;58;13;1;12;.923;1404000;0
11065;175370;199;0;0;0;0;.00nan;0;0
11065;187295;200;58;38;4;34;.895;2196000;0
11065;161006;199;64;15;1;14;.933;3600000;0
10840;-1;197;98;45;2;43;.956;3521000;0
10840;170189;197;0;0;0;0;.00nan;0;0
10840;170202;195;0;0;0;0;.00nan;0;0
10840;176200;195;84;16;0;16;1.000;3600000;0
11026;-1;211;83;42;3;39;.929;3900000;0
11026;176770;219;0;0;0;0;.00nan;0;0
11026;179646;211;0;0;0;0;.00nan;0;0
11026;181102;219;57;27;3;24;.889;3900000;0
11006;173823;198;48;32;5;27;.844;3600000;0
11006;174153;188;0;0;0;0;.00nan;0;0
11006;-1;188;78;32;3;29;.906;3600000;0
11006;181431;198;0;0;0;0;.00nan;0;0
11069;170351;194;72;22;2;20;.909;3600000;0
11069;-1;196;0;0;0;0;.00nan;0;0
11069;-1;194;0;0;0;0;.00nan;0;0
11069;184648;196;58;35;4;31;.886;3559000;0
11008;187628;191;0;0;0;0;.00nan;0;0
11008;168966;189;0;0;0;0;.00nan;0;0
11008;176915;189;99;38;1;37;.974;3600000;0
11008;185960;191;47;21;3;18;.857;3541000;0
11031;184610;222;0;0;0;0;.00nan;0;0
11031;175436;229;0;0;0;0;.00nan;0;0
11031;176860;229;90;39;2;37;.949;3600000;0
11031;-1;222;66;29;3;26;.897;3561000;0
10971;171819;177;0;0;0;0;.00nan;0;0
10971;175328;183;74;34;3;31;.912;3545000;0
10971;179602;177;81;26;1;25;.962;3600000;0
10971;182089;183;0;0;0;0;.00nan;0;0
11076;173340;231;0;0;0;0;.00nan;0;0
11076;175423;223;84;41;3;38;.927;3600000;0
11076;185034;231;60;19;2;17;.895;3600000;0
11076;-1;223;0;0;0;0;.00nan;0;0
10994;189885;225;71;39;4;35;.897;3600000;0
10994;179406;232;100;26;0;26;1.000;3600000;0
10994;179434;232;0;0;0;0;.00nan;0;0
10994;184785;225;0;0;0;0;.00nan;0;0
11085;166545;193;69;40;4;36;.900;3900000;0
11085;189081;187;0;0;0;0;.00nan;0;0
11085;173770;193;0;0;0;0;.00nan;0;0
11085;-1;187;59;40;4;36;.900;3900000;0
11616;-1;1371;0;0;0;0;.00nan;0;0
11616;175842;214;0;0;0;0;.00nan;0;0
11616;-1;214;65;41;4;37;.902;3600000;0
11616;192688;1371;85;23;1;22;.957;3600000;0
10918;-1;210;0;0;0;0;.00nan;0;0
10918;180762;1505;38;36;6;30;.833;3600000;0
10918;186549;1505;0;0;0;0;.00nan;0;0
10918;192461;210;70;20;1;19;.950;3600000;0
10924;177248;201;89;26;1;25;.962;3600000;0
10924;182049;204;56;20;2;18;.900;3541000;0
10924;185743;201;0;0;0;0;.00nan;0;0
10924;141765;204;0;0;0;0;.00nan;0;0
11016;167404;215;0;0;0;0;.00nan;0;0
11016;179679;212;0;0;0;0;.00nan;0;0
11016;186641;212;75;29;2;27;.931;3600000;0
11016;161046;215;76;36;3;33;.917;3575000;0
10987;171615;181;0;0;0;0;.00nan;0;0
10987;175842;214;56;30;4;26;.867;3575000;0
10987;-1;181;76;25;2;23;.920;3600000;0
10987;-1;214;0;0;0;0;.00nan;0;0
11063;182454;4864;98;37;1;36;.973;3600000;0
11063;183737;4864;0;0;0;0;.00nan;0;0
11063;171662;176;74;42;5;37;.881;3600000;0
11063;176932;176;0;0;0;0;.00nan;0;0
11193;170076;179;0;0;0;0;.00nan;0;0
11193;174147;179;100;35;1;34;.971;3600000;0
11193;174209;178;0;0;0;0;.00nan;0;0
11193;176963;178;81;38;3;35;.921;3600000;0
11058;-1;221;0;0;0;0;.00nan;0;0
11058;184610;222;63;18;1;17;.944;3600000;0
11058;-1;222;0;0;0;0;.00nan;0;0
11058;187362;221;67;32;3;29;.906;3537000;0
10859;169096;190;0;0;0;0;.00nan;0;0
10859;170202;195;0;0;0;0;.00nan;0;0
10859;184788;190;84;53;3;50;.943;3523000;0
10859;176200;195;82;20;1;19;.950;3600000;0
11276;166762;213;67;37;3;34;.919;3530000;0
11276;180575;213;0;0;0;0;.00nan;0;0
11276;187232;216;68;23;2;21;.913;3600000;0
11276;187240;216;0;0;0;0;.00nan;0;0
11047;175723;180;0;0;0;0;.00nan;0;0
11047;176938;180;54;29;4;25;.862;3600000;0
11047;179679;212;46;37;5;32;.865;3576000;0
11047;186641;212;0;0;0;0;.00nan;0;0
11212;173823;198;0;0;0;0;.00nan;0;0
11212;170351;194;0;0;0;0;.00nan;0;0
11212;-1;194;76;59;6;53;.898;3600000;0
11212;181431;198;72;23;2;21;.913;3600000;0
10993;-1;203;57;20;2;18;.900;3600000;0
10993;-1;203;0;0;0;0;.00nan;0;0
10993;-1;207;0;0;0;0;.00nan;0;0
10993;-1;207;89;55;3;52;.945;3543000;0
11359;168995;205;0;0;0;0;.00nan;0;0
11359;175364;206;77;39;5;34;.872;3539000;0
11359;175371;206;0;0;0;0;.00nan;0;0
11359;-1;205;54;25;3;22;.880;3600000;0
11086;173916;230;0;0;0;0;.00nan;0;0
11086;175436;229;0;0;0;0;.00nan;0;0
11086;176860;229;81;33;2;31;.939;3600000;0
11086;186495;230;63;37;3;34;.919;3562000;0
11089;168907;186;0;0;0;0;.00nan;0;0
11089;169226;186;80;30;2;28;.933;3600000;0
11089;176770;219;58;37;4;33;.892;3573000;0
11089;181102;219;0;0;0;0;.00nan;0;0
11083;173900;182;0;0;0;0;.00nan;0;0
11083;190125;184;63;40;4;36;.900;3589000;0
11083;179668;184;0;0;0;0;.00nan;0;0
11083;182116;182;78;36;3;33;.917;3600000;0
11111;183860;4959;74;34;2;32;.941;3900000;0
11111;170114;4959;0;0;0;0;.00nan;0;0
11111;171660;209;61;22;2;20;.909;3900000;0
11111;186205;209;0;0;0;0;.00nan;0;0
11144;-1;202;80;30;2;28;.933;3550000;0
11144;175370;199;72;21;1;20;.952;3600000;0
11144;180623;202;0;0;0;0;.00nan;0;0
11144;161006;199;0;0;0;0;.00nan;0;0
11478;171835;4960;36;15;3;12;.800;3586000;0
11478;187660;4960;0;0;0;0;.00nan;0;0
11478;-1;221;96;51;1;50;.980;3600000;0
11478;187362;221;0;0;0;0;.00nan;0;0
11203;171970;217;87;26;1;25;.962;3900000;0
11203;171654;217;0;0;0;0;.00nan;0;0
11203;175723;180;0;0;0;0;.00nan;0;0
11203;176938;180;78;28;1;27;.964;3900000;0
11074;166695;218;0;0;0;0;.00nan;0;0
11074;167404;215;50;43;5;38;.884;3600000;0
11074;-1;218;78;24;1;23;.958;3600000;0
11074;161046;215;0;0;0;0;.00nan;0;0
11038;184175;224;0;0;0;0;.00nan;0;0
11038;-1;224;58;29;3;26;.897;3600000;0
11038;179406;232;56;36;4;32;.889;3569000;0
11038;179434;232;0;0;0;0;.00nan;0;0
11018;168117;192;46;19;3;16;.842;3586000;0
11018;189081;187;84;36;2;34;.944;3600000;0
11018;175900;192;0;0;0;0;.00nan;0;0
11018;-1;187;0;0;0;0;.00nan;0;0
11395;174209;178;53;9;1;8;.889;1408000;0
11395;-1;210;0;0;0;0;.00nan;0;0
11395;176963;178;40;30;5;25;.833;2192000;0
11395;192461;210;50;18;2;16;.889;3600000;0
10919;175328;183;0;0;0;0;.00nan;0;0
10919;180762;1505;34;10;3;7;.700;3600000;0
10919;182089;183;67;51;5;46;.902;3600000;0
10919;186549;1505;0;0;0;0;.00nan;0;0
10992;171819;177;0;0;0;0;.00nan;0;0
10992;170076;179;18;23;6;17;.739;3223000;0
10992;174147;179;52;9;1;8;.889;377000;0
10992;179602;177;68;30;3;27;.900;3600000;0
11174;183860;4959;0;0;0;0;.00nan;0;0
11174;170114;4959;56;23;3;20;.870;3600000;0
11174;171405;2620;0;0;0;0;.00nan;0;0
11174;176921;2620;39;31;7;24;.774;3600000;0
11126;-1;197;0;0;0;0;.00nan;0;0
11126;170189;197;48;30;4;26;.867;3577000;0
11126;-1;196;0;0;0;0;.00nan;0;0
11126;184648;196;68;28;2;26;.929;3600000;0
11181;170144;227;83;12;0;12;1.000;3600000;0
11181;-1;227;0;0;0;0;.00nan;0;0
11181;189885;225;94;64;5;59;.922;3600000;0
11181;184785;225;0;0;0;0;.00nan;0;0
11102;182454;4864;0;0;0;0;.00nan;0;0
11102;183737;4864;100;30;0;30;1.000;3600000;0
11102;171662;176;50;32;4;28;.875;3600000;0
11102;176932;176;0;0;0;0;.00nan;0;0
11044;170963;185;74;36;3;33;.917;3600000;0
11044;171730;220;0;0;0;0;.00nan;0;0
11044;180110;185;0;0;0;0;.00nan;0;0
11044;187443;220;47;30;4;26;.867;3552000;0
11222;175842;214;0;0;0;0;.00nan;0;0
11222;190125;184;87;29;1;28;.966;3600000;0
11222;179668;184;0;0;0;0;.00nan;0;0
11222;-1;214;74;39;3;36;.923;3581000;0
11017;-1;197;29;26;6;20;.769;2348000;0
11017;170189;197;58;7;0;7;1.000;1252000;0
11017;174153;188;0;0;0;0;.00nan;0;0
11017;-1;188;78;25;1;24;.960;3600000;0
11020;177248;201;0;0;0;0;.00nan;0;0
11020;-1;207;63;28;3;25;.893;3549000;0
11020;185743;201;78;28;1;27;.964;3600000;0
11020;-1;207;0;0;0;0;.00nan;0;0
11309;170076;179;0;0;0;0;.00nan;0;0
11309;174147;179;46;31;4;27;.871;3600000;0
11309;-1;210;50;32;5;27;.844;3581000;0
11309;192461;210;0;0;0;0;.00nan;0;0
11215;184175;224;66;29;3;26;.897;3600000;0
11215;-1;224;0;0;0;0;.00nan;0;0
11215;175423;223;0;0;0;0;.00nan;0;0
11215;-1;223;70;25;2;23;.920;3600000;0
10999;168117;192;24;25;6;19;.760;3626000;0
10999;169096;190;0;0;0;0;.00nan;0;0
10999;175900;192;0;0;0;0;.00nan;0;0
10999;184788;190;47;34;5;29;.853;3626000;0
11136;166695;218;0;0;0;0;.00nan;0;0
11136;171970;217;67;31;3;28;.903;3600000;0
11136;171654;217;0;0;0;0;.00nan;0;0
11136;-1;218;86;32;2;30;.938;3600000;0
11325;168995;205;57;29;4;25;.862;3600000;0
11325;170141;200;0;0;0;0;.00nan;0;0
11325;-1;205;0;0;0;0;.00nan;0;0
11325;187295;200;62;40;5;35;.875;3598000;0
11142;-1;211;72;28;3;25;.893;3546000;0
11142;179646;211;0;0;0;0;.00nan;0;0
11142;179679;212;0;0;0;0;.00nan;0;0
11142;186641;212;89;34;2;32;.941;3600000;0
11013;173900;182;0;0;0;0;.00nan;0;0
11013;171615;181;97;40;1;39;.975;3900000;0
11013;182116;182;76;28;1;27;.964;3900000;0
11013;-1;181;0;0;0;0;.00nan;0;0
11138;167404;215;54;6;0;6;1.000;374000;0
11138;175723;180;77;24;2;22;.917;3600000;0
11138;176938;180;0;0;0;0;.00nan;0;0
11138;161046;215;45;45;7;38;.844;3226000;0
10945;174209;178;0;0;0;0;.00nan;0;0
10945;176963;178;88;52;4;48;.923;3588000;0
10945;180762;1505;0;0;0;0;.00nan;0;0
10945;186549;1505;64;29;3;26;.897;3600000;0
10959;-1;203;0;0;0;0;.00nan;0;0
10959;-1;203;62;22;2;20;.909;3900000;0
10959;182049;204;0;0;0;0;.00nan;0;0
10959;141765;204;76;25;2;23;.920;3900000;0
11040;171819;177;0;0;0;0;.00nan;0;0
11040;166762;213;70;42;4;38;.905;3900000;0
11040;179602;177;54;31;4;27;.871;3900000;0
11040;180575;213;0;0;0;0;.00nan;0;0
11062;179406;232;66;36;4;32;.889;3600000;0
11062;175436;229;0;0;0;0;.00nan;0;0
11062;179434;232;0;0;0;0;.00nan;0;0
11062;176860;229;93;31;1;30;.968;3600000;0
11468;168907;186;0;0;0;0;.00nan;0;0
11468;169226;186;47;20;3;17;.850;3543000;0
11468;176770;219;77;32;2;30;.938;3600000;0
11468;181102;219;0;0;0;0;.00nan;0;0
11091;171835;4960;88;36;1;35;.972;3589000;0
11091;187660;4960;0;0;0;0;.00nan;0;0
11091;184610;222;0;0;0;0;.00nan;0;0
11091;-1;222;100;32;0;32;1.000;3600000;0
11081;175328;183;0;0;0;0;.00nan;0;0
11081;182089;183;64;53;6;47;.887;3600000;0
11081;187232;216;0;0;0;0;.00nan;0;0
11081;187240;216;84;26;1;25;.962;3600000;0
11010;-1;202;64;32;3;29;.906;3562000;0
11010;174334;208;91;37;2;35;.946;3600000;0
11010;179702;208;0;0;0;0;.00nan;0;0
11010;180623;202;0;0;0;0;.00nan;0;0
11441;187628;191;0;0;0;0;.00nan;0;0
11441;168966;189;0;0;0;0;.00nan;0;0
11441;176915;189;90;63;3;60;.952;3546000;0
11441;185960;191;63;21;2;19;.905;3600000;0
10906;170202;195;0;0;0;0;.00nan;0;0
10906;-1;196;61;45;5;40;.889;3600000;0
10906;184648;196;0;0;0;0;.00nan;0;0
10906;176200;195;35;15;4;11;.733;3600000;0
11049;170963;185;57;31;4;27;.871;3900000;0
11049;190125;184;0;0;0;0;.00nan;0;0
11049;179668;184;87;43;4;39;.907;3900000;0
11049;180110;185;0;0;0;0;.00nan;0;0
11077;173340;231;0;0;0;0;.00nan;0;0
11077;184175;224;0;0;0;0;.00nan;0;0
11077;-1;224;91;49;3;46;.939;3600000;0
11077;185034;231;78;23;1;22;.957;3600000;0
11282;166545;193;63;25;2;23;.920;3543000;0
11282;187628;191;100;33;0;33;1.000;3600000;0
11282;173770;193;0;0;0;0;.00nan;0;0
11282;185960;191;0;0;0;0;.00nan;0;0
10935;189081;187;0;0;0;0;.00nan;0;0
10935;170202;195;35;31;6;25;.806;3572000;0
10935;176200;195;0;0;0;0;.00nan;0;0
10935;-1;187;72;45;5;40;.889;3600000;0
11320;170144;227;84;12;0;12;1.000;3600000;0
11320;-1;227;0;0;0;0;.00nan;0;0
11320;175423;223;28;9;3;6;.667;462000;0
11320;-1;223;49;38;5;33;.868;3138000;0
11118;171835;4960;0;0;0;0;.00nan;0;0
11118;187660;4960;68;19;1;18;.947;3600000;0
11118;175436;229;0;0;0;0;.00nan;0;0
11118;176860;229;66;39;5;34;.872;3600000;0
11036;168117;192;0;0;0;0;.00nan;0;0
11036;168966;189;0;0;0;0;.00nan;0;0
11036;175900;192;75;21;1;20;.952;3600000;0
11036;176915;189;98;50;2;48;.960;3545000;0
11093;-1;202;83;43;3;40;.930;3600000;0
11093;174334;208;0;0;0;0;.00nan;0;0
11093;179702;208;90;20;0;20;1.000;3600000;0
11093;180623;202;0;0;0;0;.00nan;0;0
11119;167404;215;0;0;0;0;.00nan;0;0
11119;176770;219;56;24;3;21;.875;3600000;0
11119;181102;219;0;0;0;0;.00nan;0;0
11119;161046;215;97;60;4;56;.933;3600000;0
11067;171970;217;0;0;0;0;.00nan;0;0
11067;-1;211;0;0;0;0;.00nan;0;0
11067;171654;217;49;21;3;18;.857;3579000;0
11067;179646;211;81;32;2;30;.938;3600000;0
11037;173900;182;34;23;5;18;.783;3710000;0
11037;171615;181;0;0;0;0;.00nan;0;0
11037;182116;182;0;0;0;0;.00nan;0;0
11037;-1;181;38;21;4;17;.810;3710000;0
11123;-1;221;0;0;0;0;.00nan;0;0
11123;184610;222;0;0;0;0;.00nan;0;0
11123;-1;222;81;39;3;36;.923;3900000;0
11123;187362;221;73;39;3;36;.923;3900000;0
11373;166762;213;0;0;0;0;.00nan;0;0
11373;180575;213;39;30;5;25;.833;3600000;0
11373;187232;216;67;16;1;15;.938;3600000;0
11373;187240;216;0;0;0;0;.00nan;0;0
11121;-1;203;51;20;3;17;.850;3600000;0
11121;175364;206;47;36;5;31;.861;3565000;0
11121;175371;206;0;0;0;0;.00nan;0;0
11121;-1;203;0;0;0;0;.00nan;0;0
11061;169096;190;69;17;1;16;.941;3600000;0
11061;170351;194;41;27;4;23;.852;3600000;0
11061;-1;194;0;0;0;0;.00nan;0;0
11061;184788;190;0;0;0;0;.00nan;0;0
11035;-1;4949;90;21;0;21;1.000;3600000;0
11035;168912;4949;0;0;0;0;.00nan;0;0
11035;175328;183;59;51;6;45;.882;3600000;0
11035;182089;183;0;0;0;0;.00nan;0;0
11060;168954;228;63;23;2;21;.913;3600000;0
11060;170300;228;0;0;0;0;.00nan;0;0
11060;179406;232;0;0;0;0;.00nan;0;0
11060;179434;232;77;22;1;21;.955;3600000;0
11068;171819;177;71;17;1;16;.941;3600000;0
11068;174209;178;0;0;0;0;.00nan;0;0
11068;179602;177;0;0;0;0;.00nan;0;0
11068;176963;178;80;43;3;40;.930;3561000;0
10998;170141;200;27;7;3;4;.571;552000;0
10998;182049;204;72;37;4;33;.892;3600000;0
10998;187295;200;69;26;2;24;.923;3034000;0
10998;141765;204;0;0;0;0;.00nan;0;0
11147;166695;218;71;34;3;31;.912;3547000;0
11147;168907;186;64;24;2;22;.917;3600000;0
11147;169226;186;0;0;0;0;.00nan;0;0
11147;-1;218;0;0;0;0;.00nan;0;0
11217;175723;180;0;0;0;0;.00nan;0;0
11217;176938;180;55;38;5;33;.868;3600000;0
11217;179679;212;100;28;0;28;1.000;3600000;0
11217;186641;212;0;0;0;0;.00nan;0;0
11033;169166;226;52;30;4;26;.867;3900000;0
11033;-1;207;0;0;0;0;.00nan;0;0
11033;-1;207;79;45;4;41;.911;3900000;0
11033;192629;226;0;0;0;0;.00nan;0;0
11094;182454;4864;0;0;0;0;.00nan;0;0
11094;183737;4864;61;33;3;30;.909;3600000;0
11094;171662;176;0;0;0;0;.00nan;0;0
11094;176932;176;100;33;0;33;1.000;3600000;0
11032;-1;210;0;0;0;0;.00nan;0;0
11032;180762;1505;63;40;4;36;.900;3600000;0
11032;186549;1505;0;0;0;0;.00nan;0;0
11032;192461;210;40;36;6;30;.833;3514000;0
11202;-1;1371;0;0;0;0;.00nan;0;0
11202;175842;214;41;18;4;14;.778;1173000;0
11202;-1;214;45;20;3;17;.850;2427000;0
11202;192688;1371;75;22;1;21;.955;3600000;0
11582;168995;205;89;30;1;29;.967;3878000;0
11582;175370;199;66;23;2;21;.913;3878000;0
11582;-1;205;0;0;0;0;.00nan;0;0
11582;161006;199;0;0;0;0;.00nan;0;0
11152;-1;197;92;77;7;70;.909;3600000;0
11152;173823;198;57;18;2;16;.889;3600000;0
11152;170189;197;0;0;0;0;.00nan;0;0
11152;181431;198;0;0;0;0;.00nan;0;0
11105;182454;4864;75;32;2;30;.938;3549000;0
11105;183737;4864;0;0;0;0;.00nan;0;0
11105;171405;2620;0;0;0;0;.00nan;0;0
11105;176921;2620;77;28;1;27;.964;3600000;0
11678;-1;4949;42;37;6;31;.838;3600000;0
11678;168912;4949;0;0;0;0;.00nan;0;0
11678;170076;179;65;15;1;14;.933;2589000;0
11678;174147;179;29;12;4;8;.667;1011000;0
11098;173340;231;92;24;0;24;1.000;3600000;0
11098;189885;225;0;0;0;0;.00nan;0;0
11098;184785;225;97;53;3;50;.943;3600000;0
11098;185034;231;0;0;0;0;.00nan;0;0
11116;-1;203;0;0;0;0;.00nan;0;0
11116;175370;199;0;0;0;0;.00nan;0;0
11116;-1;203;74;49;4;45;.918;3553000;0
11116;161006;199;54;22;3;19;.864;3600000;0
11100;170963;185;70;25;2;23;.920;3600000;0
11100;171730;220;0;0;0;0;.00nan;0;0
11100;180110;185;0;0;0;0;.00nan;0;0
11100;187443;220;56;40;5;35;.875;3600000;0
11191;168995;205;0;0;0;0;.00nan;0;0
11191;-1;202;89;31;2;29;.935;3600000;0
11191;180623;202;0;0;0;0;.00nan;0;0
11191;-1;205;78;33;3;30;.909;3558000;0
11190;-1;221;71;26;2;24;.923;3600000;0
11190;189885;225;83;45;3;42;.933;3600000;0
11190;184785;225;0;0;0;0;.00nan;0;0
11190;187362;221;0;0;0;0;.00nan;0;0
11237;170141;200;0;0;0;0;.00nan;0;0
11237;-1;207;59;24;3;21;.875;3600000;0
11237;187295;200;46;34;5;29;.853;3570000;0
11237;-1;207;0;0;0;0;.00nan;0;0
11045;170076;179;0;0;0;0;.00nan;0;0
11045;174147;179;45;35;5;30;.857;3600000;0
11045;180762;1505;72;30;2;28;.933;3600000;0
11045;186549;1505;0;0;0;0;.00nan;0;0
11354;166545;193;80;14;0;14;1.000;3600000;0
11354;168966;189;55;35;4;31;.886;2610000;0
11354;173770;193;0;0;0;0;.00nan;0;0
11354;176915;189;24;13;4;9;.692;990000;0
11159;173823;198;0;0;0;0;.00nan;0;0
11159;-1;196;0;0;0;0;.00nan;0;0
11159;184648;196;90;41;2;39;.951;3541000;0
11159;181431;198;92;20;0;20;1.000;3600000;0
11213;168907;186;0;0;0;0;.00nan;0;0
11213;169226;186;60;23;2;21;.913;3600000;0
11213;175723;180;0;0;0;0;.00nan;0;0
11213;176938;180;88;28;1;27;.964;3600000;0
11007;171615;181;72;25;1;24;.960;3600000;0
11007;-1;1371;0;0;0;0;.00nan;0;0
11007;-1;181;0;0;0;0;.00nan;0;0
11007;192688;1371;59;27;3;24;.889;3544000;0
11106;174209;178;0;0;0;0;.00nan;0;0
11106;175328;183;0;0;0;0;.00nan;0;0
11106;176963;178;48;24;4;20;.833;3600000;0
11106;182089;183;52;35;5;30;.857;3600000;0
11140;171405;2620;41;4;1;3;.750;919000;0
11140;171662;176;0;0;0;0;.00nan;0;0
11140;176921;2620;22;28;6;22;.786;2681000;0
11140;176932;176;78;33;3;30;.909;3600000;0
11239;189081;187;90;22;0;22;1.000;3600000;0
11239;174153;188;0;0;0;0;.00nan;0;0
11239;-1;188;86;39;2;37;.949;3552000;0
11239;-1;187;0;0;0;0;.00nan;0;0
11112;171970;217;54;25;3;22;.880;3900000;0
11112;171654;217;0;0;0;0;.00nan;0;0
11112;179679;212;67;29;3;26;.897;3900000;0
11112;186641;212;0;0;0;0;.00nan;0;0
11101;166695;218;0;0;0;0;.00nan;0;0
11101;-1;211;73;32;3;29;.906;3900000;0
11101;-1;218;55;30;3;27;.900;3900000;0
11101;179646;211;0;0;0;0;.00nan;0;0
11162;173916;230;0;0;0;0;.00nan;0;0
11162;184610;222;0;0;0;0;.00nan;0;0
11162;-1;222;56;30;4;26;.867;3600000;0
11162;186495;230;69;29;3;26;.897;3600000;0
10968;170202;195;0;0;0;0;.00nan;0;0
10968;170351;194;0;0;0;0;.00nan;0;0
10968;-1;194;96;39;1;38;.974;3900000;0
10968;176200;195;87;26;1;25;.962;3900000;0
11053;-1;221;0;0;0;0;.00nan;0;0
11053;179406;232;69;36;4;32;.889;3900000;0
11053;179434;232;0;0;0;0;.00nan;0;0
11053;187362;221;63;36;4;32;.889;3900000;0
11029;175364;206;99;35;1;34;.971;3600000;0
11029;175371;206;0;0;0;0;.00nan;0;0
11029;182049;204;59;22;2;20;.909;3545000;0
11029;141765;204;0;0;0;0;.00nan;0;0
11141;171819;177;0;0;0;0;.00nan;0;0
11141;166762;213;58;28;3;25;.893;3549000;0
11141;179602;177;99;28;1;27;.964;3600000;0
11141;180575;213;0;0;0;0;.00nan;0;0
11124;182454;4864;0;0;0;0;.00nan;0;0
11124;183737;4864;66;42;5;37;.881;3600000;0
11124;171660;209;99;39;1;38;.974;3600000;0
11124;186205;209;0;0;0;0;.00nan;0;0
11253;171835;4960;59;27;3;24;.889;3900000;0
11253;187660;4960;0;0;0;0;.00nan;0;0
11253;173916;230;0;0;0;0;.00nan;0;0
11253;186495;230;96;40;3;37;.925;3900000;0
11122;170144;227;75;25;1;24;.960;3600000;0
11122;-1;227;0;0;0;0;.00nan;0;0
11122;175436;229;0;0;0;0;.00nan;0;0
11122;176860;229;76;46;5;41;.891;3600000;0
11079;177248;201;54;12;1;11;.917;905000;0
11079;169166;226;67;20;1;19;.950;3600000;0
11079;185743;201;34;29;6;23;.793;2695000;0
11079;192629;226;0;0;0;0;.00nan;0;0
11161;187628;191;0;0;0;0;.00nan;0;0
11161;-1;196;27;8;3;5;.625;569000;0
11161;184648;196;86;44;2;42;.955;3031000;0
11161;185960;191;65;26;2;24;.923;3600000;0
11109;-1;4949;0;0;0;0;.00nan;0;0
11109;168912;4949;70;34;4;30;.882;3600000;0
11109;187232;216;0;0;0;0;.00nan;0;0
11109;187240;216;100;19;0;19;1.000;3600000;0
11252;171730;220;64;34;4;30;.882;3559000;0
11252;190125;184;77;42;3;39;.929;3600000;0
11252;179668;184;0;0;0;0;.00nan;0;0
11252;187443;220;0;0;0;0;.00nan;0;0
11249;-1;207;71;30;3;27;.900;3556000;0
11249;182049;204;0;0;0;0;.00nan;0;0
11249;-1;207;0;0;0;0;.00nan;0;0
11249;141765;204;100;48;2;46;.958;3600000;0
11244;189885;225;95;37;0;37;1.000;3900000;0
11244;175423;223;100;32;0;32;1.000;3900000;0
11244;184785;225;0;0;0;0;.00nan;0;0
11244;-1;223;0;0;0;0;.00nan;0;0
11095;177248;201;36;25;5;20;.800;3578000;0
11095;175364;206;0;0;0;0;.00nan;0;0
11095;175371;206;42;23;4;19;.826;3600000;0
11095;185743;201;0;0;0;0;.00nan;0;0
11151;168117;192;0;0;0;0;.00nan;0;0
11151;174153;188;0;0;0;0;.00nan;0;0
11151;-1;188;80;32;2;30;.938;3593000;0
11151;175900;192;87;27;1;26;.963;3600000;0
11155;167404;215;0;0;0;0;.00nan;0;0
11155;176770;219;86;15;0;15;1.000;3600000;0
11155;181102;219;0;0;0;0;.00nan;0;0
11155;161046;215;54;38;5;33;.868;3600000;0
11148;166545;193;58;18;2;16;.889;3741000;0
11148;169096;190;0;0;0;0;.00nan;0;0
11148;173770;193;0;0;0;0;.00nan;0;0
11148;184788;190;68;36;3;33;.917;3741000;0
11216;170963;185;0;0;0;0;.00nan;0;0
11216;-1;1371;0;0;0;0;.00nan;0;0
11216;180110;185;70;22;2;20;.909;3600000;0
11216;192688;1371;57;25;3;22;.880;3557000;0
11172;173340;231;87;26;1;25;.962;3600000;0
11172;168954;228;73;45;4;41;.911;3600000;0
11172;170300;228;0;0;0;0;.00nan;0;0
11172;185034;231;0;0;0;0;.00nan;0;0
11349;184175;224;69;43;4;39;.907;3680000;0
11349;170144;227;47;22;3;19;.864;3680000;0
11349;-1;224;0;0;0;0;.00nan;0;0
11349;-1;227;0;0;0;0;.00nan;0;0
11369;183860;4959;0;0;0;0;.00nan;0;0
11369;170114;4959;33;41;7;34;.829;3600000;0
11369;171662;176;74;33;2;31;.939;3600000;0
11369;176932;176;0;0;0;0;.00nan;0;0
11178;189081;187;66;31;3;28;.903;3600000;0
11178;170351;194;59;39;4;35;.897;3580000;0
11178;-1;194;0;0;0;0;.00nan;0;0
11178;-1;187;0;0;0;0;.00nan;0;0
11073;173900;182;0;0;0;0;.00nan;0;0
11073;175842;214;0;0;0;0;.00nan;0;0
11073;182116;182;74;18;1;17;.944;3600000;0
11073;-1;214;72;33;3;30;.909;3600000;0
11180;171405;2620;0;0;0;0;.00nan;0;0
11180;171660;209;0;0;0;0;.00nan;0;0
11180;176921;2620;41;29;5;24;.828;3600000;0
11180;186205;209;81;21;1;20;.952;3600000;0
10988;169166;226;0;0;0;0;.00nan;0;0
10988;174334;208;0;0;0;0;.00nan;0;0
10988;179702;208;75;30;3;27;.900;3600000;0
10988;192629;226;55;38;6;32;.842;3600000;0
11154;-1;4949;65;42;4;38;.905;3520000;0
11154;168912;4949;0;0;0;0;.00nan;0;0
11154;170076;179;66;25;2;23;.920;3600000;0
11154;174147;179;0;0;0;0;.00nan;0;0
11201;-1;197;100;53;3;50;.943;3900000;0
11201;173823;198;0;0;0;0;.00nan;0;0
11201;170189;197;0;0;0;0;.00nan;0;0
11201;181431;198;51;18;3;15;.833;3900000;0
11347;173916;230;0;0;0;0;.00nan;0;0
11347;179406;232;72;43;4;39;.907;3600000;0
11347;179434;232;0;0;0;0;.00nan;0;0
11347;186495;230;75;21;1;20;.952;3600000;0
11137;177248;201;0;0;0;0;.00nan;0;0
11137;168995;205;50;22;3;19;.864;3544000;0
11137;-1;205;0;0;0;0;.00nan;0;0
11137;185743;201;81;27;1;26;.963;3600000;0
11338;184175;224;0;0;0;0;.00nan;0;0
11338;-1;224;56;34;4;30;.882;3900000;0
11338;-1;221;66;30;4;26;.867;3900000;0
11338;187362;221;0;0;0;0;.00nan;0;0
11293;174153;188;57;28;3;25;.893;3556000;0
11293;-1;196;0;0;0;0;.00nan;0;0
11293;-1;188;0;0;0;0;.00nan;0;0
11293;184648;196;87;33;2;31;.939;3600000;0
11099;170963;185;82;26;1;25;.962;3900000;0
11099;171615;181;0;0;0;0;.00nan;0;0
11099;180110;185;0;0;0;0;.00nan;0;0
11099;-1;181;95;38;1;37;.974;3899000;0
11227;174334;208;62;17;1;16;.941;3544000;0
11227;179702;208;0;0;0;0;.00nan;0;0
11227;-1;207;0;0;0;0;.00nan;0;0
11227;-1;207;100;28;0;28;1.000;3600000;0
11308;171970;217;58;28;4;24;.857;3600000;0
11308;-1;211;21;20;6;14;.700;1392000;0
11308;171654;217;0;0;0;0;.00nan;0;0
11308;179646;211;48;21;3;18;.857;2208000;0
11539;166695;218;0;0;0;0;.00nan;0;0
11539;-1;218;71;27;3;24;.889;3600000;0
11539;175723;180;0;0;0;0;.00nan;0;0
11539;176938;180;47;35;6;29;.829;3600000;0
11387;166545;193;65;42;5;37;.881;3600000;0
11387;187628;191;0;0;0;0;.00nan;0;0
11387;173770;193;0;0;0;0;.00nan;0;0
11387;185960;191;85;39;2;37;.949;3600000;0
11280;171730;220;73;42;4;38;.905;3600000;0
11280;-1;1371;0;0;0;0;.00nan;0;0
11280;187443;220;0;0;0;0;.00nan;0;0
11280;192688;1371;68;26;2;24;.923;3600000;0
11292;170141;200;0;0;0;0;.00nan;0;0
11292;175364;206;87;27;1;26;.963;3600000;0
11292;175371;206;0;0;0;0;.00nan;0;0
11292;187295;200;44;24;4;20;.833;3600000;0
11064;175328;183;0;0;0;0;.00nan;0;0
11064;180762;1505;52;23;3;20;.870;3600000;0
11064;182089;183;63;39;4;35;.897;3584000;0
11064;186549;1505;0;0;0;0;.00nan;0;0
11284;168954;228;74;30;2;28;.933;3559000;0
11284;170300;228;0;0;0;0;.00nan;0;0
11284;189885;225;79;25;1;24;.960;3600000;0
11284;184785;225;0;0;0;0;.00nan;0;0
11188;171405;2620;0;0;0;0;.00nan;0;0
11188;171662;176;93;34;2;32;.941;3900000;0
11188;176921;2620;95;34;2;32;.941;3900000;0
11188;176932;176;0;0;0;0;.00nan;0;0
11446;171835;4960;70;23;2;21;.913;3600000;0
11446;187660;4960;0;0;0;0;.00nan;0;0
11446;175436;229;0;0;0;0;.00nan;0;0
11446;176860;229;65;29;3;26;.897;3550000;0
11192;171819;177;0;0;0;0;.00nan;0;0
11192;-1;210;0;0;0;0;.00nan;0;0
11192;179602;177;62;38;5;33;.868;3598000;0
11192;192461;210;39;13;3;10;.769;3600000;0
11153;182454;4864;0;0;0;0;.00nan;0;0
11153;183737;4864;70;33;4;29;.879;3514000;0
11153;183860;4959;0;0;0;0;.00nan;0;0
11153;170114;4959;99;45;2;43;.956;3600000;0
11312;166762;213;60;34;4;30;.882;3679000;0
11312;-1;4949;51;34;5;29;.853;3679000;0
11312;168912;4949;0;0;0;0;.00nan;0;0
11312;180575;213;0;0;0;0;.00nan;0;0
11175;173916;230;0;0;0;0;.00nan;0;0
11175;184610;222;0;0;0;0;.00nan;0;0
11175;-1;222;100;32;0;32;1.000;3600000;0
11175;186495;230;42;26;4;22;.846;3600000;0
11198;187628;191;75;9;0;9;1.000;3600000;0
11198;-1;196;0;0;0;0;.00nan;0;0
11198;184648;196;70;52;6;46;.885;3600000;0
11198;185960;191;0;0;0;0;.00nan;0;0
11163;180762;1505;0;0;0;0;.00nan;0;0
11163;186549;1505;96;21;0;21;1.000;3600000;0
11163;187232;216;0;0;0;0;.00nan;0;0
11163;187240;216;70;33;2;31;.939;3564000;0
11087;179406;232;65;28;3;25;.893;3899000;0
11087;175423;223;81;37;3;34;.919;3900000;0
11087;179434;232;0;0;0;0;.00nan;0;0
11087;-1;223;0;0;0;0;.00nan;0;0
11205;171970;217;0;0;0;0;.00nan;0;0
11205;171654;217;56;39;5;34;.872;3600000;0
11205;176770;219;97;23;0;23;1.000;3600000;0
11205;181102;219;0;0;0;0;.00nan;0;0
11097;175370;199;75;27;2;25;.926;3600000;0
11097;182049;204;42;43;6;37;.860;3600000;0
11097;141765;204;0;0;0;0;.00nan;0;0
11097;161006;199;0;0;0;0;.00nan;0;0
11166;167404;215;0;0;0;0;.00nan;0;0
11166;168907;186;0;0;0;0;.00nan;0;0
11166;169226;186;93;41;2;39;.951;3600000;0
11166;161046;215;72;33;3;30;.909;3600000;0
11184;168117;192;28;24;5;19;.792;3600000;0
11184;173823;198;86;34;2;32;.941;3600000;0
11184;175900;192;0;0;0;0;.00nan;0;0
11184;181431;198;0;0;0;0;.00nan;0;0
11218;173340;231;0;0;0;0;.00nan;0;0
11218;189885;225;0;0;0;0;.00nan;0;0
11218;184785;225;88;51;3;48;.941;3573000;0
11218;185034;231;47;11;2;9;.818;3600000;0
11129;182454;4864;55;24;3;21;.875;3560000;0
11129;183737;4864;0;0;0;0;.00nan;0;0
11129;171405;2620;0;0;0;0;.00nan;0;0
11129;176921;2620;58;20;2;18;.900;3600000;0
11232;169166;226;72;32;3;29;.906;3900000;0
11232;175364;206;0;0;0;0;.00nan;0;0
11232;175371;206;73;40;3;37;.925;3900000;0
11232;192629;226;0;0;0;0;.00nan;0;0
11080;171819;177;0;0;0;0;.00nan;0;0
11080;170076;179;84;26;1;25;.962;3600000;0
11080;174147;179;0;0;0;0;.00nan;0;0
11080;179602;177;68;35;3;32;.914;3572000;0
11050;170963;185;80;36;3;33;.917;3600000;0
11050;171615;181;35;18;4;14;.778;2234000;0
11050;180110;185;0;0;0;0;.00nan;0;0
11050;-1;181;49;1;0;1;1.000;1313000;0
11134;-1;210;29;26;5;21;.808;3600000;0
11134;175328;183;93;38;1;37;.974;3600000;0
11134;182089;183;0;0;0;0;.00nan;0;0
11134;192461;210;0;0;0;0;.00nan;0;0
11160;168954;228;0;0;0;0;.00nan;0;0
11160;170300;228;89;39;2;37;.949;3600000;0
11160;175436;229;0;0;0;0;.00nan;0;0
11160;176860;229;56;23;3;20;.870;3549000;0
11275;173900;182;0;0;0;0;.00nan;0;0
11275;171730;220;0;0;0;0;.00nan;0;0
11275;182116;182;77;31;2;29;.935;3600000;0
11275;187443;220;66;38;4;34;.895;3600000;0
11270;166545;193;0;0;0;0;.00nan;0;0
11270;173770;193;70;24;3;21;.875;3600000;0
11270;170351;194;0;0;0;0;.00nan;0;0
11270;-1;194;63;43;5;38;.884;3514000;0
11012;-1;197;80;61;6;55;.902;3561000;0
11012;170189;197;0;0;0;0;.00nan;0;0
11012;170202;195;0;0;0;0;.00nan;0;0
11012;176200;195;33;17;4;13;.765;3600000;0
11224;-1;211;62;32;3;29;.906;3512000;0
11224;175723;180;0;0;0;0;.00nan;0;0
11224;179646;211;0;0;0;0;.00nan;0;0
11224;176938;180;94;32;1;31;.969;3600000;0
11260;168995;205;0;0;0;0;.00nan;0;0
11260;-1;207;0;0;0;0;.00nan;0;0
11260;-1;205;69;28;2;26;.929;3584000;0
11260;-1;207;72;23;1;22;.957;3600000;0
11301;168966;189;0;0;0;0;.00nan;0;0
11301;169096;190;0;0;0;0;.00nan;0;0
11301;184788;190;77;34;2;32;.941;3513000;0
11301;176915;189;100;30;0;30;1.000;3600000;0
11221;-1;1371;99;41;1;40;.976;3600000;0
11221;175842;214;70;23;2;21;.913;3590000;0
11221;-1;214;0;0;0;0;.00nan;0;0
11221;192688;1371;0;0;0;0;.00nan;0;0
11261;-1;202;96;38;2;36;.947;3900000;0
11261;-1;203;97;45;2;43;.956;3900000;0
11261;-1;203;0;0;0;0;.00nan;0;0
11261;180623;202;0;0;0;0;.00nan;0;0
11177;167404;215;0;0;0;0;.00nan;0;0
11177;176770;219;73;21;1;20;.952;3600000;0
11177;181102;219;0;0;0;0;.00nan;0;0
11177;161046;215;64;33;3;30;.909;3600000;0
11327;189081;187;0;0;0;0;.00nan;0;0
11327;173823;198;0;0;0;0;.00nan;0;0
11327;-1;187;100;41;1;40;.976;3600000;0
11327;181431;198;58;27;3;24;.889;3519000;0
11114;174334;208;100;24;0;24;1.000;3600000;0
11114;179702;208;0;0;0;0;.00nan;0;0
11114;182049;204;0;0;0;0;.00nan;0;0
11114;141765;204;64;34;4;30;.882;3600000;0
11096;170144;227;65;14;1;13;.929;3600000;0
11096;-1;227;0;0;0;0;.00nan;0;0
11096;179406;232;0;0;0;0;.00nan;0;0
11096;179434;232;71;44;4;40;.909;3600000;0
11120;177248;201;0;0;0;0;.00nan;0;0
11120;168995;205;56;31;4;27;.871;3600000;0
11120;-1;205;0;0;0;0;.00nan;0;0
11120;185743;201;56;39;5;34;.872;3557000;0
11183;170351;194;76;11;0;11;1.000;3600000;0
11183;-1;196;0;0;0;0;.00nan;0;0
11183;-1;194;0;0;0;0;.00nan;0;0
11183;184648;196;90;39;1;38;.974;3600000;0
11404;166762;213;92;30;1;29;.967;3600000;0
11404;180575;213;0;0;0;0;.00nan;0;0
11404;187232;216;0;0;0;0;.00nan;0;0
11404;187240;216;42;31;5;26;.839;3600000;0
11272;-1;197;98;59;4;55;.932;3600000;0
11272;168966;189;0;0;0;0;.00nan;0;0
11272;170189;197;0;0;0;0;.00nan;0;0
11272;176915;189;76;21;1;20;.952;3600000;0
11051;168117;192;0;0;0;0;.00nan;0;0
11051;170202;195;0;0;0;0;.00nan;0;0
11051;175900;192;79;33;2;31;.939;3742000;0
11051;176200;195;92;31;1;30;.968;3742000;0
11374;173900;182;0;0;0;0;.00nan;0;0
11374;190125;184;79;30;2;28;.933;3600000;0
11374;179668;184;0;0;0;0;.00nan;0;0
11374;182116;182;73;36;3;33;.917;3600000;0
11132;171615;181;0;0;0;0;.00nan;0;0
11132;175842;214;0;0;0;0;.00nan;0;0
11132;-1;181;38;24;4;20;.833;3515000;0
11132;-1;214;63;26;2;24;.923;3600000;0
11262;168907;186;0;0;0;0;.00nan;0;0
11262;169226;186;73;27;3;24;.889;3547000;0
11262;179679;212;0;0;0;0;.00nan;0;0
11262;186641;212;88;25;1;24;.960;3600000;0
11291;189081;187;88;30;1;29;.967;3600000;0
11291;174153;188;0;0;0;0;.00nan;0;0
11291;-1;188;53;19;3;16;.842;3548000;0
11291;-1;187;0;0;0;0;.00nan;0;0
11298;171660;209;95;24;0;24;1.000;3600000;0
11298;171662;176;61;30;3;27;.900;3600000;0
11298;176932;176;0;0;0;0;.00nan;0;0
11298;186205;209;0;0;0;0;.00nan;0;0
11168;170144;227;0;0;0;0;.00nan;0;0
11168;-1;227;56;29;4;25;.862;3647000;0
11168;175436;229;0;0;0;0;.00nan;0;0
11168;176860;229;87;45;3;42;.933;3647000;0
11296;-1;203;0;0;0;0;.00nan;0;0
11296;175370;199;0;0;0;0;.00nan;0;0
11296;-1;203;78;28;2;26;.929;3600000;0
11296;161006;199;55;25;3;22;.880;3600000;0
11297;166695;218;0;0;0;0;.00nan;0;0
11297;171970;217;57;31;5;26;.839;3600000;0
11297;171654;217;0;0;0;0;.00nan;0;0
11297;-1;218;84;27;2;25;.926;3600000;0
11229;170963;185;90;33;2;31;.939;3900000;0
11229;-1;1371;0;0;0;0;.00nan;0;0
11229;180110;185;0;0;0;0;.00nan;0;0
11229;192688;1371;78;31;2;29;.935;3900000;0
11189;182454;4864;0;0;0;0;.00nan;0;0
11189;183737;4864;57;35;5;30;.857;3562000;0
11189;183860;4959;0;0;0;0;.00nan;0;0
11189;170114;4959;74;37;4;33;.892;3600000;0
11231;-1;4949;60;30;4;26;.867;3600000;0
11231;168912;4949;0;0;0;0;.00nan;0;0
11231;-1;210;0;0;0;0;.00nan;0;0
11231;192461;210;100;33;1;32;.970;3600000;0
11285;169166;226;86;30;1;29;.967;3600000;0
11285;-1;207;47;34;5;29;.853;3600000;0
11285;-1;207;0;0;0;0;.00nan;0;0
11285;192629;226;0;0;0;0;.00nan;0;0
11289;173340;231;0;0;0;0;.00nan;0;0
11289;173916;230;52;8;1;7;.875;871000;0
11289;185034;231;69;29;3;26;.897;3600000;0
11289;186495;230;43;26;6;20;.769;2729000;0
11306;170141;200;0;0;0;0;.00nan;0;0
11306;-1;202;100;26;0;26;1.000;3822000;0
11306;180623;202;0;0;0;0;.00nan;0;0
11306;187295;200;92;34;1;33;.971;3822000;0
11156;171819;177;0;0;0;0;.00nan;0;0
11156;174209;178;0;0;0;0;.00nan;0;0
11156;179602;177;58;31;4;27;.871;3549000;0
11156;176963;178;92;41;2;39;.951;3600000;0
11364;166695;218;0;0;0;0;.00nan;0;0
11364;-1;218;100;48;1;47;.979;3600000;0
11364;176770;219;61;28;3;25;.893;3515000;0
11364;181102;219;0;0;0;0;.00nan;0;0
11362;168966;189;57;26;3;23;.885;3592000;0
11362;169096;190;0;0;0;0;.00nan;0;0
11362;184788;190;73;26;2;24;.923;3600000;0
11362;176915;189;0;0;0;0;.00nan;0;0
11146;187628;191;0;0;0;0;.00nan;0;0
11146;170202;195;75;44;4;40;.909;3600000;0
11146;176200;195;0;0;0;0;.00nan;0;0
11146;185960;191;72;31;2;29;.935;3600000;0
11431;-1;202;47;40;6;34;.850;3150000;0
11431;175370;199;52;20;3;17;.850;3600000;0
11431;180623;202;52;3;0;3;1.000;450000;0
11431;161006;199;0;0;0;0;.00nan;0;0
11088;177248;201;43;21;3;18;.857;3546000;0
11088;182049;204;85;26;1;25;.962;3600000;0
11088;185743;201;0;0;0;0;.00nan;0;0
11088;141765;204;0;0;0;0;.00nan;0;0
11415;-1;4949;0;0;0;0;.00nan;0;0
11415;168912;4949;87;33;1;32;.970;3900000;0
11415;170076;179;0;0;0;0;.00nan;0;0
11415;174147;179;88;35;1;34;.971;3900000;0
11139;166762;213;0;0;0;0;.00nan;0;0
11139;175328;183;0;0;0;0;.00nan;0;0
11139;180575;213;100;33;0;33;1.000;3600000;0
11139;182089;183;40;23;4;19;.826;3600000;0
11406;166545;193;0;0;0;0;.00nan;0;0
11406;173770;193;34;20;4;16;.800;3600000;0
11406;174153;188;85;55;5;50;.909;3600000;0
11406;-1;188;0;0;0;0;.00nan;0;0
11390;171660;209;100;38;0;38;1.000;3600000;0
11390;171662;176;0;0;0;0;.00nan;0;0
11390;176932;176;63;47;6;41;.872;3600000;0
11390;186205;209;0;0;0;0;.00nan;0;0
11410;173916;230;61;23;2;21;.913;3600000;0
11410;189885;225;93;56;4;52;.929;3600000;0
11410;184785;225;0;0;0;0;.00nan;0;0
11410;186495;230;0;0;0;0;.00nan;0;0
11173;184610;222;0;0;0;0;.00nan;0;0
11173;179406;232;91;39;3;36;.923;3600000;0
11173;179434;232;0;0;0;0;.00nan;0;0
11173;-1;222;76;33;2;31;.939;3600000;0
11268;171835;4960;56;13;1;12;.923;3600000;0
11268;187660;4960;0;0;0;0;.00nan;0;0
11268;184175;224;93;57;4;53;.930;3600000;0
11268;-1;224;0;0;0;0;.00nan;0;0
11182;174209;178;0;0;0;0;.00nan;0;0
11182;176963;178;78;43;4;39;.907;3600000;0
11182;180762;1505;0;0;0;0;.00nan;0;0
11182;186549;1505;73;23;2;21;.913;3600000;0
11250;-1;221;41;9;2;7;.778;1555000;0
11250;175423;223;0;0;0;0;.00nan;0;0
11250;-1;223;52;31;5;26;.839;3600000;0
11250;187362;221;28;30;7;23;.767;2045000;0
11220;183860;4959;63;20;2;18;.900;3600000;0
11220;170114;4959;0;0;0;0;.00nan;0;0
11220;171405;2620;0;0;0;0;.00nan;0;0
11220;176921;2620;64;38;5;33;.868;3576000;0
11310;-1;211;76;42;3;39;.929;3759000;0
11310;168907;186;66;23;2;21;.913;3759000;0
11310;169226;186;0;0;0;0;.00nan;0;0
11310;179646;211;0;0;0;0;.00nan;0;0
11234;173823;198;100;21;0;21;1.000;3600000;0
11234;170351;194;81;54;4;50;.926;3600000;0
11234;-1;194;0;0;0;0;.00nan;0;0
11234;181431;198;0;0;0;0;.00nan;0;0
11211;-1;221;0;0;0;0;.00nan;0;0
11211;184610;222;30;25;6;19;.760;2673000;0
11211;-1;222;27;8;3;5;.625;927000;0
11211;187362;221;80;45;4;41;.911;3600000;0
11383;168954;228;73;22;1;21;.955;3547000;0
11383;184175;224;0;0;0;0;.00nan;0;0
11383;170300;228;0;0;0;0;.00nan;0;0
11383;-1;224;98;30;0;30;1.000;3600000;0
11214;168117;192;63;17;1;16;.941;3600000;0
11214;-1;197;49;46;6;40;.870;3600000;0
11214;170189;197;0;0;0;0;.00nan;0;0
11214;175900;192;0;0;0;0;.00nan;0;0
11200;167404;215;56;39;4;35;.897;3519000;0
11200;175723;180;0;0;0;0;.00nan;0;0
11200;176938;180;95;35;2;33;.943;3600000;0
11200;161046;215;0;0;0;0;.00nan;0;0
11317;170141;200;0;0;0;0;.00nan;0;0
11317;-1;203;77;27;2;25;.926;3600000;0
11317;-1;203;0;0;0;0;.00nan;0;0
11317;187295;200;59;60;7;53;.883;3600000;0
11233;173900;182;0;0;0;0;.00nan;0;0
11233;190125;184;55;29;3;26;.897;3600000;0
11233;179668;184;0;0;0;0;.00nan;0;0
11233;182116;182;99;34;1;33;.971;3600000;0
11263;171835;4960;0;0;0;0;.00nan;0;0
11263;187660;4960;78;45;4;41;.911;3600000;0
11263;173340;231;0;0;0;0;.00nan;0;0
11263;185034;231;40;34;5;29;.853;3548000;0
11355;171730;220;100;29;0;29;1.000;3600000;0
11355;175842;214;57;34;4;30;.882;3600000;0
11355;187443;220;0;0;0;0;.00nan;0;0
11355;-1;214;0;0;0;0;.00nan;0;0
11274;189081;187;0;0;0;0;.00nan;0;0
11274;169096;190;77;36;2;34;.944;3543000;0
11274;184788;190;0;0;0;0;.00nan;0;0
11274;-1;187;82;28;1;27;.964;3600000;0
11196;170076;179;88;36;2;34;.944;3544000;0
11196;174147;179;0;0;0;0;.00nan;0;0
11196;174209;178;0;0;0;0;.00nan;0;0
11196;176963;178;77;27;1;26;.963;3600000;0
11375;169166;226;77;29;2;27;.931;3534000;0
11375;174334;208;100;26;0;26;1.000;3600000;0
11375;179702;208;0;0;0;0;.00nan;0;0
11375;192629;226;0;0;0;0;.00nan;0;0
11333;166762;213;0;0;0;0;.00nan;0;0
11333;174209;178;0;0;0;0;.00nan;0;0
11333;176963;178;53;28;4;24;.857;3695000;0
11333;180575;213;70;31;3;28;.903;3695000;0
11287;170963;185;81;38;3;35;.921;3548000;0
11287;190125;184;0;0;0;0;.00nan;0;0
11287;179668;184;70;27;2;25;.926;3600000;0
11287;180110;185;0;0;0;0;.00nan;0;0
11427;168954;228;0;0;0;0;.00nan;0;0
11427;170300;228;58;36;4;32;.889;3581000;0
11427;173916;230;0;0;0;0;.00nan;0;0
11427;186495;230;60;19;2;17;.895;3600000;0
11281;166545;193;41;18;3;15;.833;3600000;0
11281;-1;197;93;42;2;40;.952;3600000;0
11281;173770;193;0;0;0;0;.00nan;0;0
11281;170189;197;0;0;0;0;.00nan;0;0
11524;171660;209;70;27;2;25;.926;3600000;0
11524;171662;176;76;39;4;35;.897;3580000;0
11524;176932;176;0;0;0;0;.00nan;0;0
11524;186205;209;0;0;0;0;.00nan;0;0
11391;187628;191;0;0;0;0;.00nan;0;0
11391;169096;190;0;0;0;0;.00nan;0;0
11391;184788;190;74;37;3;34;.919;3600000;0
11391;185960;191;86;16;0;16;1.000;3600000;0
11300;175370;199;60;35;5;30;.857;3600000;0
11300;-1;207;43;36;6;30;.833;3590000;0
11300;-1;207;0;0;0;0;.00nan;0;0
11300;161006;199;0;0;0;0;.00nan;0;0
11277;189885;225;57;37;4;33;.892;3600000;0
11277;179406;232;96;23;0;23;1.000;3600000;0
11277;179434;232;0;0;0;0;.00nan;0;0
11277;184785;225;0;0;0;0;.00nan;0;0
11149;171615;181;91;35;2;33;.943;3600000;0
11149;-1;1371;0;0;0;0;.00nan;0;0
11149;-1;181;0;0;0;0;.00nan;0;0
11149;192688;1371;55;32;5;27;.844;3600000;0
11394;168966;189;0;0;0;0;.00nan;0;0
11394;174153;188;0;0;0;0;.00nan;0;0
11394;-1;188;77;41;3;38;.927;3527000;0
11394;176915;189;75;23;1;22;.957;3600000;0
11117;-1;203;0;0;0;0;.00nan;0;0
11117;-1;203;49;20;3;17;.850;3600000;0
11117;182049;204;88;39;2;37;.949;3600000;0
11117;141765;204;0;0;0;0;.00nan;0;0
11479;184175;224;62;54;7;47;.870;3600000;0
11479;170144;227;69;24;2;22;.917;3600000;0
11479;-1;224;0;0;0;0;.00nan;0;0
11479;-1;227;0;0;0;0;.00nan;0;0
11170;166695;218;0;0;0;0;.00nan;0;0
11170;167404;215;0;0;0;0;.00nan;0;0
11170;-1;218;51;22;3;19;.864;3685000;0
11170;161046;215;64;33;4;29;.879;3655000;0
11176;177248;201;0;0;0;0;.00nan;0;0
11176;175364;206;99;42;1;41;.976;3600000;0
11176;175371;206;0;0;0;0;.00nan;0;0
11176;185743;201;71;26;2;24;.923;3553000;0
11503;171835;4960;58;25;3;22;.880;3600000;0
11503;187660;4960;0;0;0;0;.00nan;0;0
11503;175423;223;76;46;4;42;.913;3600000;0
11503;-1;223;0;0;0;0;.00nan;0;0
11206;171819;177;0;0;0;0;.00nan;0;0
11206;166762;213;59;31;4;27;.871;3600000;0
11206;179602;177;96;27;0;27;1.000;3600000;0
11206;180575;213;0;0;0;0;.00nan;0;0
11246;-1;221;0;0;0;0;.00nan;0;0
11246;175436;229;0;0;0;0;.00nan;0;0
11246;176860;229;75;35;4;31;.886;3554000;0
11246;187362;221;75;32;2;30;.938;3600000;0
11303;168966;189;0;0;0;0;.00nan;0;0
11303;-1;196;0;0;0;0;.00nan;0;0
11303;184648;196;84;40;3;37;.925;3566000;0
11303;176915;189;76;29;2;27;.931;3600000;0
11350;184175;224;0;0;0;0;.00nan;0;0
11350;-1;224;91;53;3;50;.943;3600000;0
11350;179406;232;86;17;0;17;1.000;3600000;0
11350;179434;232;0;0;0;0;.00nan;0;0
11169;170076;179;72;19;1;18;.947;3600000;0
11169;174147;179;0;0;0;0;.00nan;0;0
11169;175328;183;0;0;0;0;.00nan;0;0
11169;182089;183;91;55;3;52;.945;3516000;0
11143;-1;203;92;22;0;22;1.000;3600000;0
11143;-1;203;0;0;0;0;.00nan;0;0
11143;182049;204;0;0;0;0;.00nan;0;0
11143;141765;204;60;26;2;24;.923;3547000;0
11195;173823;198;63;36;4;32;.889;3900000;0
11195;170202;195;0;0;0;0;.00nan;0;0
11195;176200;195;46;27;4;23;.852;3900000;0
11195;181431;198;0;0;0;0;.00nan;0;0
11204;182454;4864;0;0;0;0;.00nan;0;0
11204;183737;4864;95;19;0;19;1.000;3600000;0
11204;183860;4959;0;0;0;0;.00nan;0;0
11204;170114;4959;95;30;1;29;.967;3563000;0
11286;168995;205;89;35;1;34;.971;3600000;0
11286;169166;226;65;27;3;24;.889;3521000;0
11286;-1;205;0;0;0;0;.00nan;0;0
11286;192629;226;0;0;0;0;.00nan;0;0
11251;170144;227;57;31;4;27;.871;3600000;0
11251;-1;227;0;0;0;0;.00nan;0;0
11251;184610;222;50;5;1;4;.800;865000;0
11251;-1;222;31;32;7;25;.781;2735000;0
11207;-1;210;0;0;0;0;.00nan;0;0
11207;180762;1505;62;30;3;27;.900;3570000;0
11207;186549;1505;0;0;0;0;.00nan;0;0
11207;192461;210;71;23;1;22;.957;3600000;0
11230;170963;185;64;35;4;31;.886;3571000;0
11230;175842;214;0;0;0;0;.00nan;0;0
11230;180110;185;0;0;0;0;.00nan;0;0
11230;-1;214;67;32;3;29;.906;3600000;0
11210;177248;201;80;46;4;42;.913;3600000;0
11210;-1;207;0;0;0;0;.00nan;0;0
11210;185743;201;0;0;0;0;.00nan;0;0
11210;-1;207;70;19;1;18;.947;3600000;0
11392;173900;182;0;0;0;0;.00nan;0;0
11392;171730;220;62;32;4;28;.875;3600000;0
11392;182116;182;47;30;5;25;.833;3549000;0
11392;187443;220;0;0;0;0;.00nan;0;0
11385;173340;231;0;0;0;0;.00nan;0;0
11385;189885;225;0;0;0;0;.00nan;0;0
11385;184785;225;99;60;3;57;.950;3600000;0
11385;185034;231;49;25;4;21;.840;3555000;0
11421;166545;193;0;0;0;0;.00nan;0;0
11421;173770;193;91;19;0;19;1.000;3600000;0
11421;174153;188;63;43;5;38;.884;3600000;0
11421;-1;188;0;0;0;0;.00nan;0;0
11382;-1;211;55;28;3;25;.893;3572000;0
11382;179646;211;0;0;0;0;.00nan;0;0
11382;179679;212;78;29;2;27;.931;3600000;0
11382;186641;212;0;0;0;0;.00nan;0;0
11492;175723;180;0;0;0;0;.00nan;0;0
11492;176770;219;65;35;4;31;.886;3600000;0
11492;176938;180;51;22;3;19;.864;3600000;0
11492;181102;219;0;0;0;0;.00nan;0;0
11242;171970;217;56;42;5;37;.881;3600000;0
11242;167404;215;91;32;2;30;.938;3600000;0
11242;171654;217;0;0;0;0;.00nan;0;0
11242;161046;215;0;0;0;0;.00nan;0;0
11426;174334;208;77;31;3;28;.903;3600000;0
11426;175370;199;0;0;0;0;.00nan;0;0
11426;179702;208;0;0;0;0;.00nan;0;0
11426;161006;199;48;35;5;30;.857;3600000;0
11334;187628;191;79;33;2;31;.939;3900000;0
11334;170351;194;0;0;0;0;.00nan;0;0
11334;-1;194;95;45;2;43;.956;3900000;0
11334;185960;191;0;0;0;0;.00nan;0;0
11235;171405;2620;0;0;0;0;.00nan;0;0
11235;171660;209;0;0;0;0;.00nan;0;0
11235;176921;2620;69;24;1;23;.958;3600000;0
11235;186205;209;78;37;2;35;.946;3555000;0
11186;171615;181;0;0;0;0;.00nan;0;0
11186;-1;1371;100;35;1;34;.971;3600000;0
11186;-1;181;61;42;6;36;.857;3600000;0
11186;192688;1371;0;0;0;0;.00nan;0;0
11240;-1;197;0;0;0;0;.00nan;0;0
11240;170189;197;75;34;2;32;.941;3546000;0
11240;170202;195;62;13;1;12;.923;3600000;0
11240;176200;195;0;0;0;0;.00nan;0;0
11256;171835;4960;62;18;1;17;.944;3600000;0
11256;187660;4960;0;0;0;0;.00nan;0;0
11256;184610;222;0;0;0;0;.00nan;0;0
11256;-1;222;85;53;2;51;.962;3557000;0
11471;180762;1505;0;0;0;0;.00nan;0;0
11471;186549;1505;83;38;2;36;.947;3600000;0
11471;187232;216;59;30;4;26;.867;3517000;0
11471;187240;216;0;0;0;0;.00nan;0;0
11357;166695;218;43;19;3;16;.842;1810000;0
11357;168907;186;0;0;0;0;.00nan;0;0
11357;169226;186;80;22;1;21;.955;3600000;0
11357;-1;218;25;26;6;20;.769;1790000;0
11482;171730;220;0;0;0;0;.00nan;0;0
11482;175842;214;0;0;0;0;.00nan;0;0
11482;187443;220;77;24;1;23;.958;3600000;0
11482;-1;214;85;37;2;35;.946;3567000;0
11225;183860;4959;57;38;5;33;.868;3600000;0
11225;170114;4959;0;0;0;0;.00nan;0;0
11225;171405;2620;0;0;0;0;.00nan;0;0
11225;176921;2620;75;23;1;22;.957;3600000;0
11157;-1;4949;0;0;0;0;.00nan;0;0
11157;168912;4949;52;16;2;14;.875;3600000;0
11157;175328;183;50;37;6;31;.838;3600000;0
11157;182089;183;0;0;0;0;.00nan;0;0
11444;168995;205;64;23;1;22;.957;3900000;0
11444;174334;208;81;25;1;24;.960;3900000;0
11444;179702;208;0;0;0;0;.00nan;0;0
11444;-1;205;0;0;0;0;.00nan;0;0
11592;187628;191;0;0;0;0;.00nan;0;0
11592;189081;187;95;46;2;44;.957;3600000;0
11592;-1;187;0;0;0;0;.00nan;0;0
11592;185960;191;68;31;3;28;.903;3545000;0
11314;171970;217;0;0;0;0;.00nan;0;0
11314;171654;217;79;36;2;34;.944;3600000;0
11314;175723;180;0;0;0;0;.00nan;0;0
11314;176938;180;58;33;4;29;.879;3585000;0
11278;-1;221;62;23;2;21;.913;3600000;0
11278;175436;229;0;0;0;0;.00nan;0;0
11278;176860;229;73;44;4;40;.909;3548000;0
11278;187362;221;0;0;0;0;.00nan;0;0
11313;169096;190;0;0;0;0;.00nan;0;0
11313;-1;196;0;0;0;0;.00nan;0;0
11313;184648;196;100;29;0;29;1.000;3600000;0
11313;184788;190;71;27;1;26;.963;3552000;0
11439;166695;218;0;0;0;0;.00nan;0;0
11439;-1;211;100;36;0;36;1.000;3600000;0
11439;-1;218;66;26;2;24;.923;3556000;0
11439;179646;211;0;0;0;0;.00nan;0;0
11279;173823;198;66;31;3;28;.903;3600000;0
11279;170351;194;0;0;0;0;.00nan;0;0
11279;-1;194;61;47;5;42;.894;3572000;0
11279;181431;198;0;0;0;0;.00nan;0;0
11510;171835;4960;0;0;0;0;.00nan;0;0
11510;187660;4960;52;32;5;27;.844;3600000;0
11510;173340;231;0;0;0;0;.00nan;0;0
11510;185034;231;86;30;1;29;.967;3600000;0
11266;177248;201;0;0;0;0;.00nan;0;0
11266;170141;200;0;0;0;0;.00nan;0;0
11266;185743;201;70;36;4;32;.889;3598000;0
11266;187295;200;61;29;3;26;.897;3600000;0
11657;168954;228;51;20;3;17;.850;3875000;0
11657;170300;228;0;0;0;0;.00nan;0;0
11657;189885;225;100;52;2;50;.962;3875000;0
11657;184785;225;0;0;0;0;.00nan;0;0
11316;168907;186;66;38;4;34;.895;3586000;0
11316;169226;186;0;0;0;0;.00nan;0;0
11316;179679;212;0;0;0;0;.00nan;0;0
11316;186641;212;77;38;3;35;.921;3600000;0
11245;171819;177;79;45;3;42;.933;3027000;0
11245;-1;210;0;0;0;0;.00nan;0;0
11245;179602;177;33;6;3;3;.500;573000;0
11245;192461;210;98;20;0;20;1.000;3600000;0
11408;170076;179;0;0;0;0;.00nan;0;0
11408;174147;179;79;26;1;25;.962;3600000;0
11408;174209;178;0;0;0;0;.00nan;0;0
11408;176963;178;91;46;4;42;.913;3600000;0
11238;167404;215;0;0;0;0;.00nan;0;0
11238;176770;219;60;20;2;18;.900;3600000;0
11238;181102;219;0;0;0;0;.00nan;0;0
11238;161046;215;66;28;3;25;.893;3600000;0
11115;169166;226;74;27;2;25;.926;3800000;0
11115;182049;204;78;36;3;33;.917;3800000;0
11115;192629;226;0;0;0;0;.00nan;0;0
11115;141765;204;0;0;0;0;.00nan;0;0
11254;-1;1371;0;0;0;0;.00nan;0;0
11254;190125;184;0;0;0;0;.00nan;0;0
11254;179668;184;68;35;3;32;.914;3544000;0
11254;192688;1371;81;31;2;29;.935;3600000;0
11343;175364;206;69;33;3;30;.909;3587000;0
11343;175371;206;0;0;0;0;.00nan;0;0
11343;-1;207;73;21;1;20;.952;3600000;0
11343;-1;207;0;0;0;0;.00nan;0;0
11378;179406;232;83;26;1;25;.962;3900000;0
11378;175423;223;97;48;1;47;.979;3900000;0
11378;179434;232;0;0;0;0;.00nan;0;0
11378;-1;223;0;0;0;0;.00nan;0;0
11429;173900;182;0;0;0;0;.00nan;0;0
11429;170963;185;86;47;4;43;.915;3600000;0
11429;180110;185;0;0;0;0;.00nan;0;0
11429;182116;182;38;31;6;25;.806;3537000;0
11267;182454;4864;0;0;0;0;.00nan;0;0
11267;183737;4864;71;33;3;30;.909;3600000;0
11267;171662;176;75;27;2;25;.926;3600000;0
11267;176932;176;0;0;0;0;.00nan;0;0
11388;168117;192;0;0;0;0;.00nan;0;0
11388;-1;197;22;10;4;6;.600;413000;0
11388;170189;197;86;53;4;49;.925;3187000;0
11388;175900;192;77;8;0;8;1.000;3600000;0
11311;171615;181;81;24;1;23;.958;3600000;0
11311;190125;184;60;35;3;32;.914;3552000;0
11311;179668;184;0;0;0;0;.00nan;0;0
11311;-1;181;0;0;0;0;.00nan;0;0
11324;171970;217;96;41;2;39;.951;3600000;0
11324;171654;217;0;0;0;0;.00nan;0;0
11324;176770;219;0;0;0;0;.00nan;0;0
11324;181102;219;52;23;3;20;.870;3600000;0
11236;168117;192;0;0;0;0;.00nan;0;0
11236;-1;196;0;0;0;0;.00nan;0;0
11236;184648;196;70;39;4;35;.897;3600000;0
11236;175900;192;79;23;1;22;.957;3600000;0
11315;184610;222;0;0;0;0;.00nan;0;0
11315;175423;223;0;0;0;0;.00nan;0;0
11315;-1;223;94;57;3;54;.947;3600000;0
11315;-1;222;85;16;0;16;1.000;3600000;0
11460;189081;187;0;0;0;0;.00nan;0;0
11460;174153;188;0;0;0;0;.00nan;0;0
11460;-1;188;57;36;4;32;.889;3593000;0
11460;-1;187;76;33;2;31;.939;3600000;0
11352;169096;190;48;20;3;17;.850;3900000;0
11352;170351;194;71;28;3;25;.893;3900000;0
11352;-1;194;0;0;0;0;.00nan;0;0
11352;184788;190;0;0;0;0;.00nan;0;0
11498;170141;200;0;0;0;0;.00nan;0;0
11498;-1;203;50;19;3;16;.842;3600000;0
11498;-1;203;0;0;0;0;.00nan;0;0
11498;187295;200;79;43;4;39;.907;3600000;0
11165;175328;183;0;0;0;0;.00nan;0;0
11165;180762;1505;58;18;2;16;.889;3600000;0
11165;182089;183;87;66;3;63;.955;3543000;0
11165;186549;1505;0;0;0;0;.00nan;0;0
11459;166545;193;0;0;0;0;.00nan;0;0
11459;173770;193;42;36;5;31;.861;3900000;0
11459;173823;198;25;4;3;1;.250;306000;0
11459;181431;198;96;44;2;42;.955;3594000;0
11273;168966;189;0;0;0;0;.00nan;0;0
11273;170202;195;52;3;0;3;1.000;259000;0
11273;176200;195;27;21;5;16;.762;3290000;0
11273;176915;189;78;48;4;44;.917;3600000;0
11417;-1;211;71;39;4;35;.897;3519000;0
11417;175723;180;0;0;0;0;.00nan;0;0
11417;179646;211;0;0;0;0;.00nan;0;0
11417;176938;180;95;40;2;38;.950;3600000;0
11353;174209;178;0;0;0;0;.00nan;0;0
11353;-1;210;0;0;0;0;.00nan;0;0
11353;176963;178;100;35;0;35;1.000;3600000;0
11353;192461;210;87;30;1;29;.967;3600000;0
11420;170144;227;80;13;0;13;1.000;3600000;0
11420;-1;227;0;0;0;0;.00nan;0;0
11420;189885;225;57;7;0;7;1.000;300000;0
11420;184785;225;60;53;6;47;.887;3300000;0
11600;168995;205;0;0;0;0;.00nan;0;0
11600;175370;199;66;32;3;29;.906;3711000;0
11600;-1;205;89;39;2;37;.949;3711000;0
11600;161006;199;0;0;0;0;.00nan;0;0
11269;171405;2620;0;0;0;0;.00nan;0;0
11269;171660;209;0;0;0;0;.00nan;0;0
11269;176921;2620;90;42;2;40;.952;3813000;0
11269;186205;209;49;19;3;16;.842;3813000;0
11608;168954;228;0;0;0;0;.00nan;0;0
11608;184175;224;31;18;4;14;.778;3544000;0
11608;170300;228;68;26;3;23;.885;3600000;0
11608;-1;224;0;0;0;0;.00nan;0;0
11452;169166;226;57;21;2;19;.905;3600000;0
11452;-1;202;86;38;3;35;.921;3600000;0
11452;180623;202;0;0;0;0;.00nan;0;0
11452;192629;226;0;0;0;0;.00nan;0;0
11329;171819;177;0;0;0;0;.00nan;0;0
11329;166762;213;69;37;4;33;.892;3600000;0
11329;179602;177;61;9;1;8;.889;3600000;0
11329;180575;213;0;0;0;0;.00nan;0;0
11555;173900;182;43;27;4;23;.852;3670000;0
11555;171730;220;74;29;3;26;.897;3670000;0
11555;182116;182;0;0;0;0;.00nan;0;0
11555;187443;220;0;0;0;0;.00nan;0;0
11302;173340;231;68;26;2;24;.923;3600000;0
11302;-1;221;0;0;0;0;.00nan;0;0
11302;185034;231;0;0;0;0;.00nan;0;0
11302;187362;221;91;52;3;49;.942;3571000;0
11474;-1;4949;96;32;1;31;.969;3600000;0
11474;168912;4949;0;0;0;0;.00nan;0;0
11474;170076;179;74;21;2;19;.905;3550000;0
11474;174147;179;0;0;0;0;.00nan;0;0
11405;174334;208;53;17;3;14;.824;3600000;0
11405;175364;206;48;18;3;15;.833;2473000;0
11405;175371;206;24;12;4;8;.667;1127000;0
11405;179702;208;0;0;0;0;.00nan;0;0
11342;182454;4864;69;33;3;30;.909;3600000;0
11342;183737;4864;0;0;0;0;.00nan;0;0
11342;171662;176;0;0;0;0;.00nan;0;0
11342;176932;176;64;32;4;28;.875;3558000;0
11483;175423;223;53;27;5;22;.815;3600000;0
11483;175436;229;0;0;0;0;.00nan;0;0
11483;176860;229;79;22;1;21;.955;3600000;0
11483;-1;223;0;0;0;0;.00nan;0;0
11480;173916;230;48;12;2;10;.833;3600000;0
11480;179406;232;19;25;6;19;.760;1665000;0
11480;179434;232;71;27;2;25;.926;1935000;0
11480;181338;230;0;0;0;0;.00nan;0;0
11484;189081;187;22;27;6;21;.778;1994000;0
11484;170202;195;0;0;0;0;.00nan;0;0
11484;176200;195;72;28;2;26;.929;3600000;0
11484;-1;187;69;21;1;20;.952;1606000;0
11541;173823;198;89;36;2;34;.944;3600000;0
11541;174153;188;0;0;0;0;.00nan;0;0
11541;-1;188;58;30;3;27;.900;3580000;0
11541;181431;198;0;0;0;0;.00nan;0;0
11255;168995;205;78;18;1;17;.944;3600000;0
11255;182049;204;95;42;2;40;.952;3547000;0
11255;-1;205;0;0;0;0;.00nan;0;0
11255;141765;204;0;0;0;0;.00nan;0;0
11283;183860;4959;0;0;0;0;.00nan;0;0
11283;170114;4959;93;36;2;34;.944;3600000;0
11283;171405;2620;0;0;0;0;.00nan;0;0
11283;176921;2620;62;28;3;25;.893;3581000;0
11321;171730;220;89;29;1;28;.966;3600000;0
11321;-1;1371;45;5;1;4;.800;981000;0
11321;187443;220;0;0;0;0;.00nan;0;0
11321;192688;1371;37;26;6;20;.769;2619000;0
11247;171819;177;0;0;0;0;.00nan;0;0
11247;175328;183;0;0;0;0;.00nan;0;0
11247;179602;177;68;39;5;34;.872;3574000;0
11247;182089;183;95;42;3;39;.929;3600000;0
11243;167404;215;0;0;0;0;.00nan;0;0
11243;175723;180;0;0;0;0;.00nan;0;0
11243;176938;180;59;19;2;17;.895;3624000;0
11243;161046;215;74;34;3;31;.912;3624000;0
11319;-1;197;63;32;4;28;.875;3780000;0
11319;170189;197;0;0;0;0;.00nan;0;0
11319;170351;194;0;0;0;0;.00nan;0;0
11319;-1;194;61;24;3;21;.875;3780000;0
11271;177248;201;0;0;0;0;.00nan;0;0
11271;170141;200;0;0;0;0;.00nan;0;0
11271;179499;201;78;11;0;11;1.000;3600000;0
11271;187295;200;93;46;3;43;.935;3600000;0
11228;-1;4949;70;24;2;22;.917;3600000;0
11228;168912;4949;0;0;0;0;.00nan;0;0
11228;180762;1505;0;0;0;0;.00nan;0;0
11228;186549;1505;65;31;3;28;.903;3547000;0
11358;170963;185;65;20;2;18;.900;3585000;0
11358;190125;184;0;0;0;0;.00nan;0;0
11358;179668;184;91;41;1;40;.976;3600000;0
11358;180110;185;0;0;0;0;.00nan;0;0
11399;187628;191;0;0;0;0;.00nan;0;0
11399;169096;190;0;0;0;0;.00nan;0;0
11399;184788;190;86;42;2;40;.952;3600000;0
11399;185960;191;100;27;0;27;1.000;3600000;0
11467;166545;193;58;19;2;17;.895;3600000;0
11467;168966;189;0;0;0;0;.00nan;0;0
11467;173770;193;0;0;0;0;.00nan;0;0
11467;176915;189;88;42;3;39;.929;3600000;0
11396;170076;179;98;43;2;41;.953;3900000;0
11396;174147;179;0;0;0;0;.00nan;0;0
11396;-1;210;84;35;2;33;.943;3900000;0
11396;192461;210;0;0;0;0;.00nan;0;0
11402;166695;218;0;0;0;0;.00nan;0;0
11402;-1;218;68;37;4;33;.892;3567000;0
11402;176770;219;58;18;2;16;.889;3600000;0
11402;181102;219;0;0;0;0;.00nan;0;0
11339;183686;231;0;0;0;0;.00nan;0;0
11339;173340;231;49;40;6;34;.850;3600000;0
11339;170144;227;72;18;1;17;.944;3600000;0
11339;-1;227;0;0;0;0;.00nan;0;0
11418;169166;226;100;29;0;29;1.000;3600000;0
11418;175364;206;83;40;4;36;.900;3600000;0
11418;175371;206;0;0;0;0;.00nan;0;0
11418;192629;226;0;0;0;0;.00nan;0;0
11466;168954;228;41;39;6;33;.846;3249000;0
11466;170300;228;49;8;1;7;.875;351000;0
11466;184610;222;0;0;0;0;.00nan;0;0
11466;-1;222;61;22;2;20;.909;3600000;0
11398;171660;209;76;45;5;40;.889;3600000;0
11398;171662;176;71;27;2;25;.926;3600000;0
11398;176932;176;0;0;0;0;.00nan;0;0
11398;186205;209;0;0;0;0;.00nan;0;0
11380;184175;224;0;0;0;0;.00nan;0;0
11380;-1;224;98;43;2;41;.953;3600000;0
11380;-1;221;0;0;0;0;.00nan;0;0
11380;187362;221;60;29;3;26;.897;3557000;0
11356;173900;182;0;0;0;0;.00nan;0;0
11356;171615;181;0;0;0;0;.00nan;0;0
11356;182116;182;84;29;1;28;.966;3600000;0
11356;-1;181;66;33;2;31;.939;3600000;0
11453;174334;208;67;28;3;25;.893;3900000;0
11453;179702;208;0;0;0;0;.00nan;0;0
11453;-1;207;97;47;3;44;.936;3900000;0
11453;-1;207;0;0;0;0;.00nan;0;0
11384;171970;217;83;36;2;34;.944;3600000;0
11384;171654;217;0;0;0;0;.00nan;0;0
11384;179679;212;77;40;3;37;.925;3586000;0
11384;186641;212;0;0;0;0;.00nan;0;0
11241;173900;182;0;0;0;0;.00nan;0;0
11241;170963;185;91;36;2;34;.944;3600000;0
11241;180110;185;0;0;0;0;.00nan;0;0
11241;182116;182;70;33;3;30;.909;3553000;0
11617;189081;187;0;0;0;0;.00nan;0;0
11617;168966;189;0;0;0;0;.00nan;0;0
11617;176915;189;75;39;4;35;.897;3517000;0
11617;-1;187;67;32;2;30;.938;3600000;0
11377;-1;197;0;0;0;0;.00nan;0;0
11377;170189;197;77;38;4;34;.895;3562000;0
11377;-1;196;0;0;0;0;.00nan;0;0
11377;184648;196;60;21;2;19;.905;3600000;0
11425;166762;213;36;29;6;23;.793;2398000;0
11425;180575;213;64;17;1;16;.941;1202000;0
11425;187232;216;0;0;0;0;.00nan;0;0
11425;187240;216;76;30;2;28;.933;3600000;0
11611;189885;225;81;31;2;29;.935;3600000;0
11611;175423;223;0;0;0;0;.00nan;0;0
11611;184785;225;0;0;0;0;.00nan;0;0
11611;-1;223;31;22;4;18;.818;3514000;0
11515;173916;230;0;0;0;0;.00nan;0;0
11515;-1;221;67;48;6;42;.875;2848000;0
11515;181338;230;48;26;4;22;.846;3600000;0
11515;187362;221;59;7;0;7;1.000;722000;0
11346;171730;220;0;0;0;0;.00nan;0;0
11346;190125;184;24;11;4;7;.636;1072000;0
11346;179668;184;74;15;0;15;1.000;2528000;0
11346;187443;220;100;23;0;23;1.000;3600000;0
11345;177248;201;97;26;0;26;1.000;3600000;0
11345;175370;199;60;28;3;25;.893;3600000;0
11345;179499;201;0;0;0;0;.00nan;0;0
11345;161006;199;0;0;0;0;.00nan;0;0
11464;169166;226;59;30;3;27;.900;3600000;0
11464;170141;200;87;52;5;47;.904;3590000;0
11464;187295;200;0;0;0;0;.00nan;0;0
11464;192629;226;0;0;0;0;.00nan;0;0
11423;171835;4960;25;21;5;16;.762;3600000;0
11423;187660;4960;0;0;0;0;.00nan;0;0
11423;184175;224;99;46;1;45;.978;3600000;0
11423;-1;224;0;0;0;0;.00nan;0;0
11603;170144;227;75;30;2;28;.933;3600000;0
11603;-1;227;0;0;0;0;.00nan;0;0
11603;189885;225;0;0;0;0;.00nan;0;0
11603;184785;225;79;36;3;33;.917;3597000;0
11527;169096;190;100;34;0;34;1.000;3600000;0
11527;170202;195;0;0;0;0;.00nan;0;0
11527;184788;190;0;0;0;0;.00nan;0;0
11527;176200;195;43;9;2;7;.778;3515000;0
11288;-1;202;44;38;6;32;.842;3600000;0
11288;180623;202;0;0;0;0;.00nan;0;0
11288;182049;204;87;31;1;30;.968;3600000;0
11288;141765;204;0;0;0;0;.00nan;0;0
11307;168995;205;46;26;4;22;.846;3600000;0
11307;-1;207;0;0;0;0;.00nan;0;0
11307;-1;205;0;0;0;0;.00nan;0;0
11307;-1;207;37;32;5;27;.844;3545000;0
11432;182454;4864;0;0;0;0;.00nan;0;0
11432;183737;4864;89;47;3;44;.936;3600000;0
11432;171660;209;0;0;0;0;.00nan;0;0
11432;186205;209;72;21;1;20;.952;3600000;0
11449;-1;211;60;39;4;35;.897;3544000;0
11449;175723;180;0;0;0;0;.00nan;0;0
11449;179646;211;0;0;0;0;.00nan;0;0
11449;176938;180;67;29;3;26;.897;3600000;0
11530;187628;191;0;0;0;0;.00nan;0;0
11530;173823;198;68;49;5;44;.898;3600000;0
11530;181431;198;0;0;0;0;.00nan;0;0
11530;185960;191;69;19;2;17;.895;3600000;0
11318;166545;193;39;12;3;9;.750;3900000;0
11318;173770;193;0;0;0;0;.00nan;0;0
11318;-1;196;0;0;0;0;.00nan;0;0
11318;184648;196;95;50;3;47;.940;3900000;0
11336;183860;4959;0;0;0;0;.00nan;0;0
11336;170114;4959;72;22;2;20;.909;3600000;0
11336;171405;2620;56;15;1;14;.933;1027000;0
11336;176921;2620;22;29;6;23;.793;2573000;0
11226;175328;183;49;47;7;40;.851;3600000;0
11226;182089;183;0;0;0;0;.00nan;0;0
11226;187232;216;89;19;0;19;1.000;3600000;0
11226;187240;216;0;0;0;0;.00nan;0;0
11491;166695;218;0;0;0;0;.00nan;0;0
11491;-1;218;91;35;2;33;.943;3900000;0
11491;176770;219;49;18;2;16;.889;3900000;0
11491;181102;219;0;0;0;0;.00nan;0;0
11368;179406;232;76;25;1;24;.960;3600000;0
11368;175436;229;0;0;0;0;.00nan;0;0
11368;179434;232;0;0;0;0;.00nan;0;0
11368;176860;229;84;39;3;36;.923;3557000;0
11323;-1;4949;83;23;1;22;.957;3600000;0
11323;168912;4949;0;0;0;0;.00nan;0;0
11323;174209;178;66;12;1;11;.917;1705000;0
11323;176963;178;30;38;7;31;.816;1895000;0
11365;170351;194;74;35;3;32;.914;3900000;0
11365;174153;188;79;31;3;28;.903;3900000;0
11365;-1;194;0;0;0;0;.00nan;0;0
11365;-1;188;0;0;0;0;.00nan;0;0
11258;167404;215;0;0;0;0;.00nan;0;0
11258;179679;212;69;17;1;16;.941;3600000;0
11258;186641;212;0;0;0;0;.00nan;0;0
11258;161046;215;78;49;4;45;.918;3600000;0
11330;183686;231;0;0;0;0;.00nan;0;0
11330;173340;231;90;20;0;20;1.000;3600000;0
11330;184610;222;0;0;0;0;.00nan;0;0
11330;-1;222;59;36;4;32;.889;3600000;0
11505;171615;181;84;39;3;36;.923;3600000;0
11505;-1;1371;100;28;0;28;1.000;3600000;0
11505;-1;181;0;0;0;0;.00nan;0;0
11505;192688;1371;0;0;0;0;.00nan;0;0
11340;171819;177;0;0;0;0;.00nan;0;0
11340;170076;179;81;25;1;24;.960;3600000;0
11340;174147;179;0;0;0;0;.00nan;0;0
11340;179602;177;92;40;2;38;.950;3573000;0
11341;171970;217;49;48;7;41;.854;3600000;0
11341;168907;186;0;0;0;0;.00nan;0;0
11341;169226;186;83;24;1;23;.958;3600000;0
11341;171654;217;0;0;0;0;.00nan;0;0
11397;166762;213;0;0;0;0;.00nan;0;0
11397;-1;210;0;0;0;0;.00nan;0;0
11397;180575;213;63;48;6;42;.875;3600000;0
11397;192461;210;62;13;1;12;.923;3600000;0
11450;168117;192;0;0;0;0;.00nan;0;0
11450;170351;194;91;45;1;44;.978;3600000;0
11450;-1;194;0;0;0;0;.00nan;0;0
11450;175900;192;68;17;2;15;.882;3544000;0
11332;173916;230;100;29;0;29;1.000;3600000;0
11332;184610;222;64;21;1;20;.952;3556000;0
11332;181338;230;0;0;0;0;.00nan;0;0
11332;-1;222;0;0;0;0;.00nan;0;0
11451;170144;227;48;23;3;20;.870;3600000;0
11451;-1;227;0;0;0;0;.00nan;0;0
11451;175423;223;100;43;2;41;.953;3600000;0
11451;-1;223;0;0;0;0;.00nan;0;0
11401;173900;182;0;0;0;0;.00nan;0;0
11401;190125;184;58;30;3;27;.900;3600000;0
11401;179668;184;0;0;0;0;.00nan;0;0
11401;182116;182;98;38;2;36;.947;3600000;0
11437;183860;4959;43;33;5;28;.848;3600000;0
11437;170114;4959;0;0;0;0;.00nan;0;0
11437;171662;176;99;41;2;39;.951;3600000;0
11437;176932;176;0;0;0;0;.00nan;0;0
11371;170963;185;0;0;0;0;.00nan;0;0
11371;-1;1371;42;39;6;33;.846;2852000;0
11371;180110;185;79;29;1;28;.966;3600000;0
11371;192688;1371;48;8;1;7;.875;748000;0
11581;171835;4960;0;0;0;0;.00nan;0;0
11581;187660;4960;77;29;1;28;.966;3600000;0
11581;-1;221;73;55;5;50;.909;3600000;0
11581;187362;221;0;0;0;0;.00nan;0;0
11393;170202;195;60;16;1;15;.938;3600000;0
11393;174153;188;0;0;0;0;.00nan;0;0
11393;-1;188;72;33;3;30;.909;3523000;0
11393;176200;195;0;0;0;0;.00nan;0;0
11554;-1;211;0;0;0;0;.00nan;0;0
11554;176770;219;69;15;0;15;1.000;3900000;0
11554;179646;211;100;31;0;31;1.000;3900000;0
11554;181102;219;0;0;0;0;.00nan;0;0
11294;171970;217;0;0;0;0;.00nan;0;0
11294;167404;215;86;29;1;28;.966;3575000;0
11294;171654;217;100;44;0;44;1.000;3600000;0
11294;161046;215;0;0;0;0;.00nan;0;0
11299;182454;4864;67;26;2;24;.923;3600000;0
11299;183737;4864;0;0;0;0;.00nan;0;0
11299;171405;2620;0;0;0;0;.00nan;0;0
11299;176921;2620;54;37;5;32;.865;3600000;0
11430;168954;228;72;22;2;20;.909;3900000;0
11430;170300;228;0;0;0;0;.00nan;0;0
11430;179406;232;88;32;2;30;.938;3900000;0
11430;179434;232;0;0;0;0;.00nan;0;0
11295;175328;183;0;0;0;0;.00nan;0;0
11295;180762;1505;56;19;3;16;.842;3600000;0
11295;182089;183;70;57;7;50;.877;3600000;0
11295;186549;1505;0;0;0;0;.00nan;0;0
11331;175370;199;0;0;0;0;.00nan;0;0
11331;182049;204;0;0;0;0;.00nan;0;0
11331;141765;204;73;36;3;33;.917;3526000;0
11331;161006;199;80;26;1;25;.962;3600000;0
11472;169166;226;46;18;3;15;.833;3600000;0
11472;170141;200;0;0;0;0;.00nan;0;0
11472;187295;200;83;53;5;48;.906;3554000;0
11472;192629;226;0;0;0;0;.00nan;0;0
11531;168966;189;0;0;0;0;.00nan;0;0
11531;169096;190;95;42;1;41;.976;3600000;0
11531;184788;190;0;0;0;0;.00nan;0;0
11531;176915;189;62;33;3;30;.909;3580000;0
11389;175370;199;49;32;5;27;.844;3600000;0
11389;-1;207;0;0;0;0;.00nan;0;0
11389;-1;207;75;22;1;21;.955;3600000;0
11389;161006;199;0;0;0;0;.00nan;0;0
11351;183686;231;0;0;0;0;.00nan;0;0
11351;173340;231;81;13;0;13;1.000;3600000;0
11351;175436;229;0;0;0;0;.00nan;0;0
11351;176860;229;98;52;3;49;.942;3600000;0
11525;-1;4949;65;29;3;26;.897;3900000;0
11525;168912;4949;0;0;0;0;.00nan;0;0
11525;174209;178;0;0;0;0;.00nan;0;0
11525;176963;178;69;35;3;32;.914;3900000;0
11344;171819;177;0;0;0;0;.00nan;0;0
11344;-1;210;0;0;0;0;.00nan;0;0
11344;179602;177;73;31;3;28;.903;3600000;0
11344;192461;210;11;21;6;15;.714;3600000;0
11436;177248;201;66;20;1;19;.950;3600000;0
11436;-1;202;73;29;2;27;.931;3570000;0
11436;179499;201;0;0;0;0;.00nan;0;0
11436;180623;202;0;0;0;0;.00nan;0;0
11523;168907;186;0;0;0;0;.00nan;0;0
11523;169226;186;47;21;3;18;.857;3542000;0
11523;175723;180;0;0;0;0;.00nan;0;0
11523;176938;180;91;39;2;37;.949;3600000;0
11578;170076;179;54;36;5;31;.861;3600000;0
11578;174147;179;0;0;0;0;.00nan;0;0
11578;180762;1505;0;0;0;0;.00nan;0;0
11578;186549;1505;81;39;3;36;.923;3600000;0
11448;184175;224;68;30;3;27;.900;3900000;0
11448;-1;224;0;0;0;0;.00nan;0;0
11448;189885;225;89;42;3;39;.929;3900000;0
11448;184785;225;0;0;0;0;.00nan;0;0
11536;187628;191;0;0;0;0;.00nan;0;0
11536;173823;198;0;0;0;0;.00nan;0;0
11536;181431;198;55;26;3;23;.885;3900000;0
11536;185960;191;74;30;3;27;.900;3900000;0
11455;189081;187;0;0;0;0;.00nan;0;0
11455;-1;197;100;34;1;33;.971;3600000;0
11455;170189;197;0;0;0;0;.00nan;0;0
11455;-1;187;80;34;2;32;.941;3553000;0
11361;168117;192;35;15;4;11;.733;3545000;0
11361;-1;196;0;0;0;0;.00nan;0;0
11361;184648;196;86;43;3;40;.930;3600000;0
11361;175900;192;0;0;0;0;.00nan;0;0
11481;166762;213;100;46;2;44;.957;3600000;0
11481;180575;213;0;0;0;0;.00nan;0;0
11481;187232;216;57;27;3;24;.889;3572000;0
11481;187240;216;0;0;0;0;.00nan;0;0
11519;182454;4864;0;0;0;0;.00nan;0;0
11519;183737;4864;68;33;3;30;.909;3550000;0
11519;171660;209;71;24;2;22;.917;3600000;0
11519;186205;209;0;0;0;0;.00nan;0;0
11595;171835;4960;35;19;4;15;.789;3591000;0
11595;187660;4960;0;0;0;0;.00nan;0;0
11595;168954;228;74;37;3;34;.919;3600000;0
11595;170300;228;0;0;0;0;.00nan;0;0
11475;168995;205;78;24;2;22;.917;3600000;0
11475;-1;202;0;0;0;0;.00nan;0;0
11475;180623;202;47;39;6;33;.846;3600000;0
11475;-1;205;0;0;0;0;.00nan;0;0
11376;171615;181;67;19;2;17;.895;3600000;0
11376;171730;220;0;0;0;0;.00nan;0;0
11376;-1;181;0;0;0;0;.00nan;0;0
11376;187443;220;74;35;3;32;.914;3563000;0
11434;166695;218;0;0;0;0;.00nan;0;0
11434;168907;186;86;38;3;35;.921;3891000;0
11434;169226;186;0;0;0;0;.00nan;0;0
11434;-1;218;89;44;3;41;.932;3900000;0
11462;-1;211;60;8;0;8;1.000;1583000;0
11462;179646;211;26;23;6;17;.739;2017000;0
11462;179679;212;40;25;4;21;.840;3600000;0
11462;186641;212;0;0;0;0;.00nan;0;0
11461;183860;4959;0;0;0;0;.00nan;0;0
11461;170114;4959;63;20;2;18;.900;3555000;0
11461;171662;176;0;0;0;0;.00nan;0;0
11461;176932;176;92;37;1;36;.973;3600000;0
11363;170144;227;0;0;0;0;.00nan;0;0
11363;-1;227;71;39;4;35;.897;3600000;0
11363;184610;222;0;0;0;0;.00nan;0;0
11363;-1;222;81;14;0;14;1.000;3600000;0
11632;-1;221;0;0;0;0;.00nan;0;0
11632;175423;223;92;44;3;41;.932;3600000;0
11632;-1;223;0;0;0;0;.00nan;0;0
11632;187362;221;53;31;4;27;.871;3545000;0
11465;187628;191;67;17;1;16;.941;3600000;0
11465;174153;188;0;0;0;0;.00nan;0;0
11465;-1;188;93;50;3;47;.940;3545000;0
11465;185960;191;0;0;0;0;.00nan;0;0
11413;174334;208;56;18;3;15;.833;3542000;0
11413;179702;208;0;0;0;0;.00nan;0;0
11413;182049;204;82;36;2;34;.944;3600000;0
11413;141765;204;0;0;0;0;.00nan;0;0
11335;167404;215;0;0;0;0;.00nan;0;0
11335;175723;180;47;19;3;16;.842;3600000;0
11335;176938;180;0;0;0;0;.00nan;0;0
11335;161046;215;100;39;0;39;1.000;3600000;0
11565;175364;206;63;28;3;25;.893;3588000;0
11565;175370;199;63;15;1;14;.933;3600000;0
11565;175371;206;0;0;0;0;.00nan;0;0
11565;161006;199;0;0;0;0;.00nan;0;0
11381;171819;177;37;24;4;20;.833;1433000;0
11381;-1;210;55;30;4;26;.867;3600000;0
11381;179602;177;34;32;6;26;.813;2167000;0
11381;192461;210;0;0;0;0;.00nan;0;0
11348;175328;183;0;0;0;0;.00nan;0;0
11348;180762;1505;68;22;2;20;.909;3600000;0
11348;182089;183;51;42;5;37;.881;3600000;0
11348;186549;1505;0;0;0;0;.00nan;0;0
11553;168117;192;0;0;0;0;.00nan;0;0
11553;189081;187;79;32;2;30;.938;3600000;0
11553;175900;192;50;28;4;24;.857;3524000;0
11553;-1;187;0;0;0;0;.00nan;0;0
11447;175842;214;74;49;5;44;.898;3600000;0
11447;190125;184;72;27;1;26;.963;3600000;0
11447;179668;184;0;0;0;0;.00nan;0;0
11447;-1;214;0;0;0;0;.00nan;0;0
11559;184175;224;0;0;0;0;.00nan;0;0
11559;-1;224;85;34;1;33;.971;3600000;0
11559;175436;229;0;0;0;0;.00nan;0;0
11559;176860;229;82;29;2;27;.931;3546000;0
11488;-1;197;100;43;2;41;.953;3900000;0
11488;170189;197;0;0;0;0;.00nan;0;0
11488;170202;195;0;0;0;0;.00nan;0;0
11488;176200;195;86;31;2;29;.935;3900000;0
11513;166762;213;90;35;1;34;.971;2853000;0
11513;180575;213;23;10;4;6;.600;747000;0
11513;180762;1505;0;0;0;0;.00nan;0;0
11513;186549;1505;99;24;0;24;1.000;3600000;0
11400;184175;224;93;21;0;21;1.000;3600000;0
11400;-1;224;0;0;0;0;.00nan;0;0
11400;184610;222;0;0;0;0;.00nan;0;0
11400;-1;222;45;24;4;20;.833;3600000;0
11407;173900;182;48;7;1;6;.857;1381000;0
11407;-1;1371;77;19;1;18;.947;3600000;0
11407;182116;182;42;19;4;15;.789;2219000;0
11407;192688;1371;0;0;0;0;.00nan;0;0
11372;173823;198;54;32;4;28;.875;3600000;0
11372;170351;194;0;0;0;0;.00nan;0;0
11372;-1;194;100;41;1;40;.976;3600000;0
11372;181431;198;0;0;0;0;.00nan;0;0
11379;175370;199;0;0;0;0;.00nan;0;0
11379;182049;204;100;43;1;42;.977;3900000;0
11379;141765;204;0;0;0;0;.00nan;0;0
11379;161006;199;74;21;1;20;.952;3900000;0
11486;171835;4960;72;28;2;26;.929;3900000;0
11486;187660;4960;0;0;0;0;.00nan;0;0
11486;179406;232;76;35;2;33;.943;3900000;0
11486;179434;232;0;0;0;0;.00nan;0;0
11435;182454;4864;0;0;0;0;.00nan;0;0
11435;183737;4864;81;20;1;19;.950;3600000;0
11435;183860;4959;80;37;4;33;.892;3600000;0
11435;170114;4959;0;0;0;0;.00nan;0;0
11419;187628;191;0;0;0;0;.00nan;0;0
11419;-1;196;57;32;4;28;.875;2502000;0
11419;184648;196;33;22;5;17;.773;1098000;0
11419;185960;191;83;18;0;18;1.000;3600000;0
11259;177248;201;60;25;3;22;.880;3600000;0
11259;168995;205;100;32;0;32;1.000;3600000;0
11259;179499;201;0;0;0;0;.00nan;0;0
11259;-1;205;0;0;0;0;.00nan;0;0
11493;169166;226;77;35;3;32;.914;3584000;0
11493;174334;208;93;39;2;37;.949;3600000;0
11493;179702;208;0;0;0;0;.00nan;0;0
11493;192629;226;0;0;0;0;.00nan;0;0
11633;189081;187;0;0;0;0;.00nan;0;0
11633;169096;190;0;0;0;0;.00nan;0;0
11633;184788;190;60;30;3;27;.900;3600000;0
11633;-1;187;36;19;4;15;.789;3582000;0
11643;168954;228;0;0;0;0;.00nan;0;0
11643;170300;228;88;28;1;27;.964;3600000;0
11643;-1;221;56;40;5;35;.875;3600000;0
11643;187362;221;0;0;0;0;.00nan;0;0
11409;171405;2620;0;0;0;0;.00nan;0;0
11409;171660;209;0;0;0;0;.00nan;0;0
11409;176921;2620;88;39;2;37;.949;3587000;0
11409;186205;209;72;16;1;15;.938;3600000;0
11500;168907;186;0;0;0;0;.00nan;0;0
11500;169226;186;66;15;1;14;.933;3600000;0
11500;175723;180;0;0;0;0;.00nan;0;0
11500;176938;180;82;34;2;32;.941;3600000;0
11416;174209;178;70;28;2;26;.929;3900000;0
11416;-1;210;0;0;0;0;.00nan;0;0
11416;176963;178;0;0;0;0;.00nan;0;0
11416;192461;210;72;22;2;20;.909;3900000;0
11367;171615;181;56;34;4;30;.882;3600000;0
11367;171730;220;69;20;1;19;.950;3600000;0
11367;-1;181;0;0;0;0;.00nan;0;0
11367;187443;220;0;0;0;0;.00nan;0;0
11322;170076;179;76;23;1;22;.957;3600000;0
11322;174147;179;0;0;0;0;.00nan;0;0
11322;175328;183;45;40;6;34;.850;3600000;0
11322;182089;183;0;0;0;0;.00nan;0;0
11534;170144;227;65;37;4;33;.892;3582000;0
11534;173916;230;61;24;2;22;.917;3600000;0
11534;-1;227;0;0;0;0;.00nan;0;0
11534;181338;230;0;0;0;0;.00nan;0;0
11360;171819;177;0;0;0;0;.00nan;0;0
11360;179602;177;64;43;5;38;.884;3600000;0
11360;187232;216;0;0;0;0;.00nan;0;0
11360;187240;216;86;26;1;25;.962;3600000;0
11572;183686;231;0;0;0;0;.00nan;0;0
11572;173340;231;42;22;4;18;.818;3900000;0
11572;175423;223;0;0;0;0;.00nan;0;0
11572;-1;223;77;46;4;42;.913;3900000;0
11442;171970;217;0;0;0;0;.00nan;0;0
11442;-1;211;62;28;3;25;.893;3600000;0
11442;171654;217;58;38;4;34;.895;3555000;0
11442;179646;211;0;0;0;0;.00nan;0;0
11574;166545;193;70;30;3;27;.900;3900000;0
11574;168117;192;82;40;3;37;.925;3900000;0
11574;173770;193;0;0;0;0;.00nan;0;0
11574;175900;192;0;0;0;0;.00nan;0;0
11457;-1;203;0;0;0;0;.00nan;0;0
11457;-1;203;31;27;5;22;.815;3541000;0
11457;-1;207;0;0;0;0;.00nan;0;0
11457;-1;207;56;30;4;26;.867;3600000;0
11428;173900;182;0;0;0;0;.00nan;0;0
11428;190125;184;0;0;0;0;.00nan;0;0
11428;179668;184;64;43;4;39;.907;3597000;0
11428;182116;182;79;31;3;28;.903;3600000;0
11624;168966;189;0;0;0;0;.00nan;0;0
11624;169096;190;66;38;5;33;.868;3882000;0
11624;184788;190;0;0;0;0;.00nan;0;0
11624;176915;189;59;27;4;23;.852;3882000;0
11636;-1;202;100;36;0;36;1.000;3600000;0
11636;-1;207;79;25;2;23;.920;3538000;0
11636;180623;202;0;0;0;0;.00nan;0;0
11636;-1;207;0;0;0;0;.00nan;0;0
11438;174153;188;0;0;0;0;.00nan;0;0
11438;-1;196;76;55;6;49;.891;3287000;0
11438;-1;188;60;11;1;10;.909;3600000;0
11438;184648;196;55;3;0;3;1.000;313000;0
11538;-1;211;72;16;0;16;1.000;884000;0
11538;179646;211;43;50;8;42;.840;2716000;0
11538;179679;212;0;0;0;0;.00nan;0;0
11538;186641;212;33;25;5;20;.800;3600000;0
11414;168954;228;64;41;5;36;.878;3600000;0
11414;170300;228;0;0;0;0;.00nan;0;0
11414;184610;222;60;15;2;13;.867;3600000;0
11414;-1;222;0;0;0;0;.00nan;0;0
11463;177248;201;67;16;1;15;.938;3600000;0
11463;175364;206;83;35;2;33;.943;3543000;0
11463;175371;206;0;0;0;0;.00nan;0;0
11463;179499;201;0;0;0;0;.00nan;0;0
11506;168995;205;59;43;4;39;.907;3521000;0
11506;174334;208;86;31;2;29;.935;3600000;0
11506;179702;208;0;0;0;0;.00nan;0;0
11506;-1;205;0;0;0;0;.00nan;0;0
11508;170202;195;0;0;0;0;.00nan;0;0
11508;170351;194;92;52;2;50;.962;3810000;0
11508;-1;194;0;0;0;0;.00nan;0;0
11508;176200;195;68;18;1;17;.944;3810000;0
11528;182454;4864;0;0;0;0;.00nan;0;0
11528;183737;4864;81;32;2;30;.938;3600000;0
11528;171405;2620;0;0;0;0;.00nan;0;0
11528;176921;2620;80;53;5;48;.906;3600000;0
11552;171835;4960;79;33;2;31;.939;3600000;0
11552;187660;4960;0;0;0;0;.00nan;0;0
11552;173916;230;0;0;0;0;.00nan;0;0
11552;181338;230;56;30;3;27;.900;3565000;0
11558;183686;231;70;28;2;26;.929;3600000;0
11558;173340;231;0;0;0;0;.00nan;0;0
11558;-1;221;88;41;3;38;.927;3600000;0
11558;187362;221;0;0;0;0;.00nan;0;0
11532;189081;187;0;0;0;0;.00nan;0;0
11532;173823;198;64;29;3;26;.897;3589000;0
11532;-1;187;99;38;1;37;.974;3600000;0
11532;181431;198;0;0;0;0;.00nan;0;0
11386;175328;183;48;40;5;35;.875;3600000;0
11386;182089;183;0;0;0;0;.00nan;0;0
11386;187232;216;0;0;0;0;.00nan;0;0
11386;187240;216;87;29;1;28;.966;3600000;0
11569;-1;4949;50;22;3;19;.864;3600000;0
11569;168912;4949;0;0;0;0;.00nan;0;0
11569;180762;1505;0;0;0;0;.00nan;0;0
11569;186549;1505;52;35;5;30;.857;3600000;0
11502;166545;193;78;25;1;24;.960;3600000;0
11502;-1;197;97;54;3;51;.944;3567000;0
11502;173770;193;0;0;0;0;.00nan;0;0
11502;170189;197;0;0;0;0;.00nan;0;0
11422;170963;185;52;21;3;18;.857;3593000;0
11422;171615;181;0;0;0;0;.00nan;0;0
11422;180110;185;0;0;0;0;.00nan;0;0
11422;-1;181;86;34;2;32;.941;3600000;0
11585;171970;217;54;21;3;18;.857;3600000;0
11585;171654;217;0;0;0;0;.00nan;0;0
11585;175723;180;0;0;0;0;.00nan;0;0
11585;176938;180;76;46;4;42;.913;3564000;0
11424;171730;220;54;27;4;23;.852;3582000;0
11424;-1;1371;60;28;3;25;.893;3600000;0
11424;187443;220;0;0;0;0;.00nan;0;0
11424;192688;1371;0;0;0;0;.00nan;0;0
11443;166695;218;0;0;0;0;.00nan;0;0
11443;167404;215;0;0;0;0;.00nan;0;0
11443;-1;218;76;29;3;26;.897;3600000;0
11443;161046;215;82;24;1;23;.958;3600000;0
11601;171819;177;0;0;0;0;.00nan;0;0
11601;-1;4949;82;34;2;32;.941;3570000;0
11601;168912;4949;0;0;0;0;.00nan;0;0
11601;179602;177;64;15;1;14;.933;3600000;0
11494;166762;213;83;39;4;35;.897;3900000;0
11494;180575;213;0;0;0;0;.00nan;0;0
11494;187232;216;78;48;4;44;.917;3890000;0
11494;187240;216;0;0;0;0;.00nan;0;0
11563;166545;193;0;0;0;0;.00nan;0;0
11563;173770;193;70;21;1;20;.952;3600000;0
11563;170202;195;60;28;3;25;.893;3592000;0
11563;176200;195;0;0;0;0;.00nan;0;0
11641;175423;223;62;29;3;26;.897;3549000;0
11641;175436;229;0;0;0;0;.00nan;0;0
11641;176860;229;73;31;2;29;.935;3600000;0
11641;-1;223;0;0;0;0;.00nan;0;0
11551;166695;218;78;31;2;29;.935;3600000;0
11551;-1;218;0;0;0;0;.00nan;0;0
11551;179679;212;0;0;0;0;.00nan;0;0
11551;186641;212;72;31;3;28;.903;3550000;0
11580;-1;197;0;0;0;0;.00nan;0;0
11580;168966;189;0;0;0;0;.00nan;0;0
11580;170189;197;85;48;3;45;.938;3900000;0
11580;176915;189;66;42;3;39;.929;3900000;0
11470;170963;185;0;0;0;0;.00nan;0;0
11470;171730;220;0;0;0;0;.00nan;0;0
11470;180110;185;89;15;0;15;1.000;3600000;0
11470;187443;220;76;27;1;26;.963;3565000;0
11679;183686;231;0;0;0;0;.00nan;0;0
11679;173340;231;65;15;1;14;.933;3600000;0
11679;179406;232;90;57;2;55;.965;3600000;0
11679;179434;232;0;0;0;0;.00nan;0;0
11499;177248;201;0;0;0;0;.00nan;0;0
11499;-1;203;63;25;3;22;.880;3600000;0
11499;-1;203;0;0;0;0;.00nan;0;0
11499;185743;201;72;38;4;34;.895;3600000;0
11621;171835;4960;0;0;0;0;.00nan;0;0
11621;187660;4960;63;26;3;23;.885;3535000;0
11621;168954;228;0;0;0;0;.00nan;0;0
11621;170300;228;88;31;1;30;.968;3600000;0
11646;169166;226;99;34;1;33;.971;3600000;0
11646;-1;202;80;42;3;39;.929;3560000;0
11646;180623;202;0;0;0;0;.00nan;0;0
11646;192629;226;0;0;0;0;.00nan;0;0
11511;170076;179;87;32;1;31;.969;3600000;0
11511;174147;179;0;0;0;0;.00nan;0;0
11511;-1;210;0;0;0;0;.00nan;0;0
11511;192461;210;72;33;3;30;.909;3600000;0
11490;173900;182;0;0;0;0;.00nan;0;0
11490;190125;184;24;25;6;19;.760;2882000;0
11490;179668;184;53;10;1;9;.900;718000;0
11490;182116;182;66;31;3;28;.903;3600000;0
11605;171615;181;75;28;2;26;.929;3600000;0
11605;175842;214;0;0;0;0;.00nan;0;0
11605;-1;181;0;0;0;0;.00nan;0;0
11605;-1;214;73;39;3;36;.923;3560000;0
11618;184175;224;62;30;3;27;.900;3600000;0
11618;-1;224;0;0;0;0;.00nan;0;0
11618;189885;225;79;31;2;29;.935;3600000;0
11618;184785;225;0;0;0;0;.00nan;0;0
11456;167404;215;0;0;0;0;.00nan;0;0
11456;168907;186;0;0;0;0;.00nan;0;0
11456;169226;186;81;23;2;21;.913;3600000;0
11456;161046;215;77;36;3;33;.917;3600000;0
11533;170351;194;0;0;0;0;.00nan;0;0
11533;174153;188;0;0;0;0;.00nan;0;0
11533;-1;194;73;27;3;24;.889;3600000;0
11533;-1;188;49;33;4;29;.879;3560000;0
11521;182454;4864;45;37;6;31;.838;3600000;0
11521;183737;4864;0;0;0;0;.00nan;0;0
11521;171660;209;59;28;3;25;.893;3600000;0
11521;186205;209;0;0;0;0;.00nan;0;0
11562;171970;217;76;27;2;25;.926;3600000;0
11562;-1;211;25;31;7;24;.774;2227000;0
11562;171654;217;0;0;0;0;.00nan;0;0
11562;179646;211;74;18;0;18;1.000;1373000;0
11469;183860;4959;0;0;0;0;.00nan;0;0
11469;170114;4959;75;18;1;17;.944;3600000;0
11469;171662;176;70;40;4;36;.900;3600000;0
11469;176932;176;0;0;0;0;.00nan;0;0
11458;187628;191;0;0;0;0;.00nan;0;0
11458;168117;192;0;0;0;0;.00nan;0;0
11458;175900;192;89;47;4;43;.915;3536000;0
11458;185960;191;79;29;2;27;.931;3600000;0
11497;175364;206;99;42;1;41;.976;3600000;0
11497;175371;206;0;0;0;0;.00nan;0;0
11497;182049;204;77;25;3;22;.880;3553000;0
11497;141765;204;0;0;0;0;.00nan;0;0
11495;168907;186;45;15;3;12;.800;3600000;0
11495;169226;186;0;0;0;0;.00nan;0;0
11495;179679;212;65;35;4;31;.886;3549000;0
11495;186641;212;0;0;0;0;.00nan;0;0
11644;168966;189;0;0;0;0;.00nan;0;0
11644;173823;198;70;19;1;18;.947;3600000;0
11644;176915;189;81;42;3;39;.929;3581000;0
11644;181431;198;0;0;0;0;.00nan;0;0
11545;170144;227;62;27;3;24;.889;3560000;0
11545;173916;230;83;29;1;28;.966;3600000;0
11545;-1;227;0;0;0;0;.00nan;0;0
11545;181338;230;0;0;0;0;.00nan;0;0
11566;-1;203;0;0;0;0;.00nan;0;0
11566;175370;199;86;34;2;32;.941;3600000;0
11566;-1;203;63;30;3;27;.900;3579000;0
11566;161006;199;0;0;0;0;.00nan;0;0
11543;169096;190;0;0;0;0;.00nan;0;0
11543;-1;196;0;0;0;0;.00nan;0;0
11543;184648;196;93;38;2;36;.947;3664000;0
11543;184788;190;59;24;3;21;.875;3664000;0
11576;171660;209;0;0;0;0;.00nan;0;0
11576;171662;176;0;0;0;0;.00nan;0;0
11576;176932;176;91;33;1;32;.970;3600000;0
11576;186205;209;67;40;4;36;.900;3600000;0
11496;166762;213;0;0;0;0;.00nan;0;0
11496;170076;179;83;39;3;36;.923;3600000;0
11496;174147;179;0;0;0;0;.00nan;0;0
11496;180575;213;61;33;4;29;.879;3597000;0
11476;170963;185;0;0;0;0;.00nan;0;0
11476;-1;1371;99;39;1;38;.974;3600000;0
11476;180110;185;60;19;2;17;.895;3591000;0
11476;192688;1371;0;0;0;0;.00nan;0;0
11518;169166;226;0;0;0;0;.00nan;0;0
11518;170141;200;0;0;0;0;.00nan;0;0
11518;187295;200;34;35;7;28;.800;3600000;0
11518;192629;226;54;18;3;15;.833;3600000;0
11588;166545;193;82;36;2;34;.944;3600000;0
11588;187628;191;78;34;3;31;.912;3552000;0
11588;173770;193;0;0;0;0;.00nan;0;0
11588;185960;191;0;0;0;0;.00nan;0;0
11653;184175;224;48;38;5;33;.868;3600000;0
11653;-1;224;0;0;0;0;.00nan;0;0
11653;175436;229;0;0;0;0;.00nan;0;0
11653;176860;229;83;42;2;40;.952;3600000;0
11655;168954;228;0;0;0;0;.00nan;0;0
11655;170300;228;80;26;1;25;.962;3600000;0
11655;-1;221;0;0;0;0;.00nan;0;0
11655;187362;221;83;36;3;33;.917;3569000;0
11485;170963;185;73;25;2;23;.920;3900000;0
11485;175842;214;95;49;2;47;.959;3900000;0
11485;180110;185;0;0;0;0;.00nan;0;0
11485;-1;214;0;0;0;0;.00nan;0;0
11654;179406;232;84;44;3;41;.932;3599000;0
11654;175423;223;81;26;1;25;.962;3600000;0
11654;179434;232;0;0;0;0;.00nan;0;0
11654;-1;223;0;0;0;0;.00nan;0;0
11669;166695;218;0;0;0;0;.00nan;0;0
11669;-1;218;59;36;5;31;.861;3600000;0
11669;179679;212;82;22;1;21;.955;3600000;0
11669;186641;212;0;0;0;0;.00nan;0;0
11544;-1;4949;98;44;2;42;.955;3562000;0
11544;168912;4949;0;0;0;0;.00nan;0;0
11544;-1;210;84;16;0;16;1.000;3600000;0
11544;192461;210;0;0;0;0;.00nan;0;0
11658;166762;213;47;28;4;24;.857;3583000;0
11658;174209;178;0;0;0;0;.00nan;0;0
11658;176963;178;71;23;2;21;.913;3600000;0
11658;180575;213;0;0;0;0;.00nan;0;0
11477;167404;215;0;0;0;0;.00nan;0;0
11477;-1;211;39;25;5;20;.800;3523000;0
11477;179646;211;0;0;0;0;.00nan;0;0
11477;161046;215;76;41;3;38;.927;3600000;0
11607;175364;206;87;25;1;24;.960;3600000;0
11607;175371;206;0;0;0;0;.00nan;0;0
11607;-1;207;0;0;0;0;.00nan;0;0
11607;-1;207;61;31;3;28;.903;3514000;0
11522;171819;177;0;0;0;0;.00nan;0;0
11522;179602;177;83;34;3;31;.912;3600000;0
11522;187232;216;0;0;0;0;.00nan;0;0
11522;187240;216;53;26;4;22;.846;3600000;0
11597;183686;231;0;0;0;0;.00nan;0;0
11597;173340;231;37;35;6;29;.829;3600000;0
11597;170144;227;0;0;0;0;.00nan;0;0
11597;-1;227;75;28;2;26;.929;3600000;0
11612;177248;201;60;30;3;27;.900;3600000;0
11612;170141;200;67;48;5;43;.896;3572000;0
11612;185743;201;0;0;0;0;.00nan;0;0
11612;187295;200;0;0;0;0;.00nan;0;0
11631;173916;230;60;28;2;26;.929;3900000;0
11631;189885;225;95;42;2;40;.952;3900000;0
11631;184785;225;0;0;0;0;.00nan;0;0
11631;181338;230;0;0;0;0;.00nan;0;0
11570;171615;181;80;34;3;31;.912;3553000;0
11570;171730;220;100;40;2;38;.950;3600000;0
11570;-1;181;0;0;0;0;.00nan;0;0
11570;187443;220;0;0;0;0;.00nan;0;0
11556;-1;202;93;40;3;37;.925;3900000;0
11556;180623;202;0;0;0;0;.00nan;0;0
11556;182049;204;46;24;3;21;.875;3900000;0
11556;141765;204;0;0;0;0;.00nan;0;0
11571;182454;4864;0;0;0;0;.00nan;0;0
11571;183737;4864;71;25;2;23;.920;3600000;0
11571;171660;209;75;39;3;36;.923;3545000;0
11571;186205;209;0;0;0;0;.00nan;0;0
11602;168995;205;48;29;5;24;.828;3572000;0
11602;-1;203;0;0;0;0;.00nan;0;0
11602;-1;203;59;24;3;21;.875;3600000;0
11602;-1;205;0;0;0;0;.00nan;0;0
11622;173900;182;0;0;0;0;.00nan;0;0
11622;175842;214;0;0;0;0;.00nan;0;0
11622;182116;182;98;23;0;23;1.000;3600000;0
11622;-1;214;88;38;2;36;.947;3556000;0
11512;167404;215;45;27;4;23;.852;3600000;0
11512;176770;219;72;28;3;25;.893;3600000;0
11512;181102;219;0;0;0;0;.00nan;0;0
11512;161046;215;0;0;0;0;.00nan;0;0
11606;189885;225;57;11;1;10;.909;687000;0
11606;184610;222;0;0;0;0;.00nan;0;0
11606;184785;225;53;40;6;34;.850;2913000;0
11606;-1;222;84;29;2;27;.931;3600000;0
11504;174209;178;0;0;0;0;.00nan;0;0
11504;175328;183;0;0;0;0;.00nan;0;0
11504;176963;178;85;34;2;32;.941;3600000;0
11504;182089;183;92;37;1;36;.973;3600000;0
11537;169166;226;78;10;0;10;1.000;3600000;0
11537;175364;206;0;0;0;0;.00nan;0;0
11537;175371;206;84;57;5;52;.912;3600000;0
11537;192629;226;0;0;0;0;.00nan;0;0
11628;183860;4959;0;0;0;0;.00nan;0;0
11628;170114;4959;76;35;2;33;.943;3732000;0
11628;171405;2620;0;0;0;0;.00nan;0;0
11628;176921;2620;76;33;3;30;.909;3732000;0
11507;-1;210;93;30;1;29;.967;3600000;0
11507;187232;216;54;32;4;28;.875;3600000;0
11507;187240;216;0;0;0;0;.00nan;0;0
11507;192461;210;0;0;0;0;.00nan;0;0
11547;170144;227;67;24;2;22;.917;3600000;0
11547;-1;221;62;46;6;40;.870;3118000;0
11547;-1;227;0;0;0;0;.00nan;0;0
11547;187362;221;56;2;0;2;1.000;482000;0
11577;174334;208;57;22;3;19;.864;3900000;0
11577;175370;199;56;26;3;23;.885;3900000;0
11577;179702;208;0;0;0;0;.00nan;0;0
11577;161006;199;0;0;0;0;.00nan;0;0
11598;-1;211;0;0;0;0;.00nan;0;0
11598;179646;211;52;38;5;33;.868;3600000;0
11598;179679;212;0;0;0;0;.00nan;0;0
11598;186641;212;85;36;2;34;.944;3600000;0
11557;169096;190;86;38;2;36;.947;3900000;0
11557;174153;188;95;41;2;39;.951;3900000;0
11557;-1;188;0;0;0;0;.00nan;0;0
11557;184788;190;0;0;0;0;.00nan;0;0
11647;166545;193;0;0;0;0;.00nan;0;0
11647;173770;193;57;17;2;15;.882;3600000;0
11647;-1;196;0;0;0;0;.00nan;0;0
11647;184648;196;77;49;6;43;.878;3600000;0
11575;173916;230;0;0;0;0;.00nan;0;0
11575;179406;232;57;37;5;32;.865;3600000;0
11575;179434;232;0;0;0;0;.00nan;0;0
11575;181338;230;56;16;2;14;.875;3600000;0
11487;-1;1371;0;0;0;0;.00nan;0;0
11487;190125;184;63;29;3;26;.897;3900000;0
11487;179668;184;0;0;0;0;.00nan;0;0
11487;192688;1371;80;43;3;40;.930;3900000;0
11650;189081;187;39;21;4;17;.810;3600000;0
11650;170351;194;49;46;6;40;.870;3595000;0
11650;-1;194;0;0;0;0;.00nan;0;0
11650;-1;187;0;0;0;0;.00nan;0;0
11517;177248;201;0;0;0;0;.00nan;0;0
11517;-1;202;0;0;0;0;.00nan;0;0
11517;180623;202;33;26;5;21;.808;3900000;0
11517;185743;201;74;48;5;43;.896;3900000;0
11665;171970;217;56;32;3;29;.906;3600000;0
11665;171654;217;0;0;0;0;.00nan;0;0
11665;175723;180;0;0;0;0;.00nan;0;0
11665;176938;180;71;27;2;25;.926;3600000;0
11548;187628;191;0;0;0;0;.00nan;0;0
11548;168117;192;0;0;0;0;.00nan;0;0
11548;175900;192;70;28;2;26;.929;3600000;0
11548;185960;191;80;40;3;37;.925;3564000;0
11529;182454;4864;67;33;3;30;.909;3552000;0
11529;183737;4864;0;0;0;0;.00nan;0;0
11529;171662;176;76;27;2;25;.926;3600000;0
11529;176932;176;0;0;0;0;.00nan;0;0
11630;171835;4960;57;21;2;19;.905;3600000;0
11630;187660;4960;0;0;0;0;.00nan;0;0
11630;168954;228;27;33;7;26;.788;2245000;0
11630;170300;228;60;15;1;14;.933;1355000;0
11681;-1;197;55;39;4;35;.897;3548000;0
11681;170189;197;0;0;0;0;.00nan;0;0
11681;176770;219;47;18;3;15;.833;3600000;0
11681;181102;219;0;0;0;0;.00nan;0;0
11683;171405;2620;0;0;0;0;.00nan;0;0
11683;171660;209;0;0;0;0;.00nan;0;0
11683;176921;2620;48;34;5;29;.853;3547000;0
11683;186205;209;39;16;3;13;.813;3600000;0
11685;183860;4959;0;0;0;0;.00nan;0;0
11685;170114;4959;77;33;2;31;.939;3600000;0
11685;171730;220;0;0;0;0;.00nan;0;0
11685;187443;220;77;37;3;34;.919;3561000;0
11687;-1;1371;0;0;0;0;.00nan;0;0
11687;190125;184;55;28;3;25;.893;3556000;0
11687;179668;184;0;0;0;0;.00nan;0;0
11687;192688;1371;80;34;2;32;.941;3600000;0
11689;170144;227;69;30;3;27;.900;3600000;0
11689;-1;221;76;34;3;31;.912;2712000;0
11689;-1;227;0;0;0;0;.00nan;0;0
11689;187362;221;31;23;5;18;.783;888000;0
11691;168995;205;84;31;1;30;.968;3900000;0
11691;-1;202;75;23;1;22;.957;3900000;0
11691;180623;202;0;0;0;0;.00nan;0;0
11691;-1;205;0;0;0;0;.00nan;0;0
11693;171835;4960;55;14;2;12;.857;3600000;0
11693;187660;4960;0;0;0;0;.00nan;0;0
11693;173900;182;0;0;0;0;.00nan;0;0
11693;182116;182;95;55;3;52;.945;3600000;0
11695;177248;201;52;11;1;10;.909;598000;0
11695;168966;189;0;0;0;0;.00nan;0;0
11695;176915;189;51;20;3;17;.850;3600000;0
11695;185743;201;54;48;6;42;.875;3002000;0
11697;166451;176;0;0;0;0;.00nan;0;0
11697;171662;176;42;26;4;22;.846;3600000;0
11697;-1;210;0;0;0;0;.00nan;0;0
11697;192461;210;93;31;1;30;.968;3600000;0
11699;171819;177;0;0;0;0;.00nan;0;0
11699;173823;198;63;26;3;23;.885;3900000;0
11699;179602;177;83;40;3;37;.925;3900000;0
11699;181431;198;0;0;0;0;.00nan;0;0
11701;171615;181;48;31;4;27;.871;3600000;0
11701;175842;214;0;0;0;0;.00nan;0;0
11701;-1;214;100;39;1;38;.974;3600000;0
11701;192552;181;0;0;0;0;.00nan;0;0
11703;189885;225;34;25;5;20;.800;3600000;0
11703;175364;206;64;24;3;21;.875;3600000;0
11703;175371;206;0;0;0;0;.00nan;0;0
11703;184785;225;0;0;0;0;.00nan;0;0
11705;168117;192;0;0;0;0;.00nan;0;0
11705;184175;224;80;36;2;34;.944;3527000;0
11705;175354;224;0;0;0;0;.00nan;0;0
11705;175900;192;70;21;1;20;.952;3600000;0
11707;175436;229;0;0;0;0;.00nan;0;0
11707;175723;180;53;3;0;3;1.000;1022000;0
11707;176860;229;69;21;1;20;.952;3600000;0
11707;176938;180;20;23;6;17;.739;2578000;0
11709;184610;222;83;29;1;28;.966;3600000;0
11709;184712;200;0;0;0;0;.00nan;0;0
11709;-1;222;0;0;0;0;.00nan;0;0
11709;187295;200;96;50;3;47;.940;3533000;0
11711;166695;218;0;0;0;0;.00nan;0;0
11711;-1;203;0;0;0;0;.00nan;0;0
11711;-1;218;79;41;4;37;.902;3600000;0
11711;191078;203;45;47;6;41;.872;3564000;0
11713;168907;186;0;0;0;0;.00nan;0;0
11713;169226;186;49;29;4;25;.862;3600000;0
11713;175423;223;0;0;0;0;.00nan;0;0
11713;-1;223;52;38;5;33;.868;3595000;0
11715;173916;230;0;0;0;0;.00nan;0;0
11715;-1;207;95;36;1;35;.972;3900000;0
11715;186495;230;89;35;1;34;.971;3900000;0
11715;-1;207;0;0;0;0;.00nan;0;0
11717;169166;226;39;37;6;31;.838;3600000;0
11717;170963;185;92;23;0;23;1.000;3600000;0
11717;180110;185;0;0;0;0;.00nan;0;0
11717;192629;226;0;0;0;0;.00nan;0;0
11719;171970;217;83;26;2;24;.923;3600000;0
11719;170351;194;78;43;4;39;.907;3550000;0
11719;171654;217;0;0;0;0;.00nan;0;0
11719;-1;194;0;0;0;0;.00nan;0;0
11721;-1;211;80;51;5;46;.902;3563000;0
11721;179646;211;0;0;0;0;.00nan;0;0
11721;180762;1505;0;0;0;0;.00nan;0;0
11721;186549;1505;43;24;4;20;.833;3600000;0
11723;166545;193;0;0;0;0;.00nan;0;0
11723;168954;228;0;0;0;0;.00nan;0;0
11723;173770;193;36;26;5;21;.808;3600000;0
11723;170300;228;100;42;1;41;.976;3600000;0
11725;170076;179;62;44;5;39;.886;3554000;0
11725;170202;195;0;0;0;0;.00nan;0;0
11725;174147;179;0;0;0;0;.00nan;0;0
11725;176200;195;70;32;3;29;.906;3600000;0
11727;189081;187;0;0;0;0;.00nan;0;0
11727;179679;212;0;0;0;0;.00nan;0;0
11727;-1;187;64;31;3;28;.903;3600000;0
11727;186641;212;40;28;4;24;.857;3600000;0
11729;166762;213;58;14;1;13;.929;3600000;0
11729;174209;178;0;0;0;0;.00nan;0;0
11729;176963;178;89;50;3;47;.940;3600000;0
11729;180575;213;0;0;0;0;.00nan;0;0
11731;187628;191;0;0;0;0;.00nan;0;0
11731;179406;232;89;38;2;36;.947;3600000;0
11731;179434;232;0;0;0;0;.00nan;0;0
11731;185960;191;67;19;1;18;.947;3600000;0
11733;-1;4949;78;33;2;31;.939;3600000;0
11733;168912;4949;0;0;0;0;.00nan;0;0
11733;174334;208;56;26;3;23;.885;3554000;0
11733;179702;208;0;0;0;0;.00nan;0;0
11735;174153;188;0;0;0;0;.00nan;0;0
11735;-1;188;63;36;4;32;.889;3547000;0
11735;187232;216;0;0;0;0;.00nan;0;0
11735;187240;216;63;20;2;18;.900;3600000;0
11737;175328;183;0;0;0;0;.00nan;0;0
11737;175370;199;73;22;1;21;.955;3900000;0
11737;182089;183;100;51;1;50;.980;3900000;0
11737;161006;199;0;0;0;0;.00nan;0;0
11739;173340;231;0;0;0;0;.00nan;0;0
11739;169096;190;90;38;2;36;.947;3600000;0
11739;184788;190;0;0;0;0;.00nan;0;0
11739;185034;231;70;30;3;27;.900;3575000;0
11741;182454;4864;67;23;2;21;.913;3600000;0
11741;167404;215;0;0;0;0;.00nan;0;0
11741;183737;4864;0;0;0;0;.00nan;0;0
11741;161046;215;68;27;3;24;.889;3600000;0
11743;-1;196;0;0;0;0;.00nan;0;0
11743;184648;196;29;22;5;17;.773;3600000;0
11743;182049;204;91;31;1;30;.968;3600000;0
11743;141765;204;0;0;0;0;.00nan;0;0
11745;-1;202;65;31;3;28;.903;3847000;0
11745;176770;219;34;12;3;9;.750;563000;0
11745;180623;202;0;0;0;0;.00nan;0;0
11745;181102;219;81;29;1;28;.966;3284000;0
11747;170351;194;86;48;2;46;.958;3600000;0
11747;179406;232;71;36;3;33;.917;3557000;0
11747;179434;232;0;0;0;0;.00nan;0;0
11747;-1;194;0;0;0;0;.00nan;0;0
11749;168954;228;0;0;0;0;.00nan;0;0
11749;170300;228;39;37;6;31;.838;3600000;0
11749;187232;216;100;26;0;26;1.000;3600000;0
11749;187240;216;0;0;0;0;.00nan;0;0
11751;183860;4959;0;0;0;0;.00nan;0;0
11751;170114;4959;76;32;2;30;.938;3600000;0
11751;174209;178;0;0;0;0;.00nan;0;0
11751;176963;178;52;26;4;22;.846;3539000;0
11753;173823;198;0;0;0;0;.00nan;0;0
11753;171730;220;67;40;4;36;.900;3599000;0
11753;181431;198;39;15;3;12;.800;3600000;0
11753;187443;220;0;0;0;0;.00nan;0;0
11755;166695;218;0;0;0;0;.00nan;0;0
11755;173900;182;72;19;0;19;1.000;1462000;0
11755;-1;218;40;25;5;20;.800;3600000;0
11755;182116;182;38;33;6;27;.818;2082000;0
11757;189081;187;60;19;2;17;.895;3900000;0
11757;175328;183;95;47;2;45;.957;3900000;0
11757;-1;187;0;0;0;0;.00nan;0;0
11757;182089;183;0;0;0;0;.00nan;0;0
11759;173340;231;0;0;0;0;.00nan;0;0
11759;168966;189;0;0;0;0;.00nan;0;0
11759;176915;189;92;48;3;45;.938;3592000;0
11759;185034;231;62;21;2;19;.905;3600000;0
11761;184175;224;0;0;0;0;.00nan;0;0
11761;-1;203;76;36;4;32;.889;3577000;0
11761;175354;224;64;29;3;26;.897;3600000;0
11761;191078;203;0;0;0;0;.00nan;0;0
11763;169166;226;79;13;0;13;1.000;3600000;0
11763;175370;199;84;42;2;40;.952;3588000;0
11763;192629;226;0;0;0;0;.00nan;0;0
11763;161006;199;0;0;0;0;.00nan;0;0
11765;177248;201;0;0;0;0;.00nan;0;0
11765;-1;207;64;38;3;35;.921;3600000;0
11765;185743;201;57;18;2;16;.889;3600000;0
11765;-1;207;0;0;0;0;.00nan;0;0
11767;171405;2620;0;0;0;0;.00nan;0;0
11767;175723;180;0;0;0;0;.00nan;0;0
11767;176921;2620;81;35;2;33;.943;3600000;0
11767;176938;180;93;29;1;28;.966;3600000;0
11769;167404;215;0;0;0;0;.00nan;0;0
11769;174153;188;0;0;0;0;.00nan;0;0
11769;-1;188;85;28;1;27;.964;3579000;0
11769;161046;215;100;30;0;30;1.000;3600000;0
11771;-1;1371;0;0;0;0;.00nan;0;0
11771;182049;204;88;39;2;37;.949;3600000;0
11771;192688;1371;39;19;3;16;.842;3576000;0
11771;141765;204;0;0;0;0;.00nan;0;0
11773;182454;4864;0;0;0;0;.00nan;0;0
11773;183737;4864;88;43;3;40;.930;3900000;0
11773;-1;197;71;36;3;33;.917;3900000;0
11773;170189;197;0;0;0;0;.00nan;0;0
11775;168907;186;0;0;0;0;.00nan;0;0
11775;169226;186;67;25;2;23;.920;3600000;0
11775;171615;181;0;0;0;0;.00nan;0;0
11775;192552;181;47;31;5;26;.839;3600000;0
11777;171819;177;0;0;0;0;.00nan;0;0
11777;184712;200;0;0;0;0;.00nan;0;0
11777;179602;177;83;31;2;29;.935;3900000;0
11777;187295;200;97;41;2;39;.951;3900000;0
11779;-1;196;62;37;3;34;.919;3004000;0
11779;184648;196;21;9;4;5;.556;565000;0
11779;190125;184;32;34;6;28;.824;3600000;0
11779;179668;184;0;0;0;0;.00nan;0;0
11781;171970;217;85;31;1;30;.968;3600000;0
11781;169096;190;63;22;2;20;.909;3600000;0
11781;171654;217;0;0;0;0;.00nan;0;0
11781;184788;190;0;0;0;0;.00nan;0;0
11783;-1;211;59;34;4;30;.882;2260000;0
11783;170144;227;72;6;0;6;1.000;3600000;0
11783;-1;227;0;0;0;0;.00nan;0;0
11783;179646;211;67;24;2;22;.917;1340000;0
11785;170963;185;52;34;5;29;.853;3529000;0
11785;179679;212;0;0;0;0;.00nan;0;0
11785;180110;185;0;0;0;0;.00nan;0;0
11785;186641;212;64;34;3;31;.912;3600000;0
11787;184610;222;0;0;0;0;.00nan;0;0
11787;175842;214;0;0;0;0;.00nan;0;0
11787;-1;222;77;35;2;33;.943;3600000;0
11787;-1;214;92;48;3;45;.938;3600000;0
11789;166762;213;93;36;1;35;.972;3600000;0
11789;166451;176;0;0;0;0;.00nan;0;0
11789;171662;176;42;19;3;16;.842;3523000;0
11789;180575;213;0;0;0;0;.00nan;0;0
11791;168117;192;0;0;0;0;.00nan;0;0
11791;189885;225;0;0;0;0;.00nan;0;0
11791;175900;192;56;19;2;17;.895;3567000;0
11791;184785;225;99;48;1;47;.979;3600000;0
11793;171835;4960;81;26;1;25;.962;3600000;0
11793;187660;4960;0;0;0;0;.00nan;0;0
11793;170202;195;0;0;0;0;.00nan;0;0
11793;176200;195;63;46;5;41;.891;3600000;0
11795;175423;223;82;47;4;43;.915;3900000;0
11795;175436;229;0;0;0;0;.00nan;0;0
11795;176860;229;52;34;4;30;.882;3900000;0
11795;-1;223;0;0;0;0;.00nan;0;0
11797;171660;209;0;0;0;0;.00nan;0;0
11797;180762;1505;0;0;0;0;.00nan;0;0
11797;186205;209;63;19;1;18;.947;3900000;0
11797;186549;1505;98;41;1;40;.976;3900000;0
11799;187628;191;100;43;2;41;.953;3600000;0
11799;173916;230;0;0;0;0;.00nan;0;0
11799;185960;191;0;0;0;0;.00nan;0;0
11799;186495;230;84;40;3;37;.925;3563000;0
11801;166545;193;69;20;2;18;.900;3600000;0
11801;173770;193;0;0;0;0;.00nan;0;0
11801;175364;206;70;46;5;41;.891;3600000;0
11801;175371;206;0;0;0;0;.00nan;0;0
11803;170076;179;0;0;0;0;.00nan;0;0
11803;174147;179;90;46;3;43;.935;3600000;0
11803;-1;221;0;0;0;0;.00nan;0;0
11803;187362;221;67;19;1;18;.947;3600000;0
11805;168995;205;0;0;0;0;.00nan;0;0
11805;174334;208;49;23;3;20;.870;3581000;0
11805;179702;208;0;0;0;0;.00nan;0;0
11805;-1;205;75;33;2;31;.939;3600000;0
11807;-1;4949;97;42;2;40;.952;3544000;0
11807;168912;4949;0;0;0;0;.00nan;0;0
11807;-1;210;0;0;0;0;.00nan;0;0
11807;192461;210;94;28;1;27;.964;3600000;0
11809;177248;201;87;41;3;38;.927;3743000;0
11809;174153;188;44;20;4;16;.800;3743000;0
11809;-1;188;0;0;0;0;.00nan;0;0
11809;185743;201;0;0;0;0;.00nan;0;0
11811;182454;4864;84;34;2;32;.941;3600000;0
11811;183737;4864;0;0;0;0;.00nan;0;0
11811;173900;182;0;0;0;0;.00nan;0;0
11811;182116;182;77;32;3;29;.906;3565000;0
11813;166695;218;16;29;6;23;.793;2625000;0
11813;170144;227;67;21;2;19;.905;3600000;0
11813;-1;227;0;0;0;0;.00nan;0;0
11813;-1;218;65;16;1;15;.938;975000;0
11815;171730;220;0;0;0;0;.00nan;0;0
11815;176770;219;74;35;3;32;.914;3600000;0
11815;181102;219;0;0;0;0;.00nan;0;0
11815;187443;220;100;29;0;29;1.000;3600000;0
11817;-1;211;84;32;2;30;.938;3600000;0
11817;175436;229;0;0;0;0;.00nan;0;0
11817;176860;229;75;40;3;37;.925;3586000;0
11817;179646;211;0;0;0;0;.00nan;0;0
11819;-1;210;69;31;3;28;.903;3541000;0
11819;175328;183;0;0;0;0;.00nan;0;0
11819;182089;183;95;38;2;36;.947;3600000;0
11819;192461;210;0;0;0;0;.00nan;0;0
11821;187628;191;0;0;0;0;.00nan;0;0
11821;-1;196;0;0;0;0;.00nan;0;0
11821;184648;196;59;35;4;31;.886;3600000;0
11821;185960;191;75;30;2;28;.933;3600000;0
11823;175370;199;0;0;0;0;.00nan;0;0
11823;187232;216;0;0;0;0;.00nan;0;0
11823;187240;216;75;26;1;25;.962;3562000;0
11823;161006;199;81;12;0;12;1.000;3600000;0
11825;-1;1371;86;22;1;21;.955;3600000;0
11825;175364;206;0;0;0;0;.00nan;0;0
11825;175371;206;59;29;3;26;.897;3578000;0
11825;192688;1371;0;0;0;0;.00nan;0;0
11827;166762;213;0;0;0;0;.00nan;0;0
11827;173823;198;78;24;1;23;.958;3600000;0
11827;180575;213;78;37;2;35;.946;3573000;0
11827;181431;198;0;0;0;0;.00nan;0;0
11829;171660;209;31;11;3;8;.727;527000;0
11829;-1;207;0;0;0;0;.00nan;0;0
11829;186205;209;78;25;1;24;.960;3071000;0
11829;-1;207;55;20;3;17;.850;3600000;0
11831;-1;221;54;20;2;18;.900;3600000;0
11831;190125;184;54;4;0;4;1.000;618000;0
11831;179668;184;36;33;6;27;.818;2982000;0
11831;187362;221;0;0;0;0;.00nan;0;0
11833;170202;195;73;21;1;20;.952;3600000;0
11833;171615;181;73;40;4;36;.900;3600000;0
11833;176200;195;0;0;0;0;.00nan;0;0
11833;192552;181;0;0;0;0;.00nan;0;0
11835;-1;197;0;0;0;0;.00nan;0;0
11835;169096;190;0;0;0;0;.00nan;0;0
11835;170189;197;79;29;1;28;.966;3560000;0
11835;184788;190;100;33;0;33;1.000;3600000;0
11837;-1;203;0;0;0;0;.00nan;0;0
11837;179679;212;85;31;1;30;.968;3600000;0
11837;186641;212;0;0;0;0;.00nan;0;0
11837;191078;203;48;33;5;28;.848;3600000;0
11839;168995;205;64;33;3;30;.909;3600000;0
11839;179406;232;0;0;0;0;.00nan;0;0
11839;179434;232;67;49;6;43;.878;3600000;0
11839;-1;205;0;0;0;0;.00nan;0;0
11841;170351;194;0;0;0;0;.00nan;0;0
11841;173916;230;100;23;0;23;1.000;3600000;0
11841;-1;194;37;26;5;21;.808;3600000;0
11841;186495;230;0;0;0;0;.00nan;0;0
11843;189081;187;0;0;0;0;.00nan;0;0
11843;174334;208;0;0;0;0;.00nan;0;0
11843;179702;208;70;43;5;38;.884;3572000;0
11843;-1;187;56;27;3;24;.889;3600000;0
11845;166545;193;0;0;0;0;.00nan;0;0
11845;171819;177;78;41;3;38;.927;3600000;0
11845;173770;193;47;24;4;20;.833;3555000;0
11845;179602;177;0;0;0;0;.00nan;0;0
11847;171970;217;0;0;0;0;.00nan;0;0
11847;166451;176;65;37;4;33;.892;3600000;0
11847;171654;217;50;35;5;30;.857;3600000;0
11847;171662;176;0;0;0;0;.00nan;0;0
11849;167404;215;0;0;0;0;.00nan;0;0
11849;170963;185;0;0;0;0;.00nan;0;0
11849;180110;185;58;27;3;24;.889;3900000;0
11849;161046;215;77;38;3;35;.921;3900000;0
11851;183860;4959;42;34;6;28;.824;3732000;0
11851;170114;4959;0;0;0;0;.00nan;0;0
11851;182049;204;0;0;0;0;.00nan;0;0
11851;141765;204;67;41;5;36;.878;3732000;0
11853;171835;4960;0;0;0;0;.00nan;0;0
11853;187660;4960;62;15;1;14;.933;3600000;0
11853;-1;202;0;0;0;0;.00nan;0;0
11853;180623;202;89;61;5;56;.918;3600000;0
11855;168954;228;37;11;3;8;.727;597000;0
11855;169166;226;0;0;0;0;.00nan;0;0
11855;170300;228;69;25;2;23;.920;3003000;0
11855;192629;226;76;24;1;23;.958;3600000;0
11857;-1;4949;0;0;0;0;.00nan;0;0
11857;168912;4949;71;32;3;29;.906;3600000;0
11857;171405;2620;42;25;4;21;.840;3579000;0
11857;176921;2620;0;0;0;0;.00nan;0;0
11859;168966;189;37;23;5;18;.783;3600000;0
11859;175723;180;56;19;2;17;.895;3600000;0
11859;176915;189;0;0;0;0;.00nan;0;0
11859;176938;180;0;0;0;0;.00nan;0;0
11861;168907;186;57;27;3;24;.889;3600000;0
11861;169226;186;0;0;0;0;.00nan;0;0
11861;184175;224;63;31;4;27;.871;3579000;0
11861;175354;224;0;0;0;0;.00nan;0;0
11863;175423;223;0;0;0;0;.00nan;0;0
11863;175842;214;95;39;1;38;.974;3600000;0
11863;-1;223;73;26;2;24;.923;3594000;0
11863;-1;214;0;0;0;0;.00nan;0;0
11865;174209;178;72;40;4;36;.900;3900000;0
11865;189885;225;53;33;4;29;.879;3900000;0
11865;184785;225;0;0;0;0;.00nan;0;0
11865;176963;178;0;0;0;0;.00nan;0;0
11867;170076;179;56;23;3;20;.870;3587000;0
11867;174147;179;0;0;0;0;.00nan;0;0
11867;180762;1505;75;22;1;21;.955;3600000;0
11867;186549;1505;0;0;0;0;.00nan;0;0
11869;184610;222;82;36;2;34;.944;3600000;0
11869;184712;200;50;32;5;27;.844;3600000;0
11869;-1;222;0;0;0;0;.00nan;0;0
11869;187295;200;0;0;0;0;.00nan;0;0
11871;168117;192;23;6;3;3;.500;325000;0
11871;173340;231;66;40;4;36;.900;3600000;0
11871;175900;192;65;31;3;28;.903;3275000;0
11871;185034;231;0;0;0;0;.00nan;0;0
11873;173823;198;41;34;6;28;.824;3600000;0
11873;175723;180;0;0;0;0;.00nan;0;0
11873;176938;180;82;33;2;31;.939;3600000;0
11873;181431;198;0;0;0;0;.00nan;0;0
11875;169166;226;67;46;5;41;.891;3513000;0
11875;180762;1505;66;28;3;25;.893;3600000;0
11875;186549;1505;0;0;0;0;.00nan;0;0
11875;192629;226;0;0;0;0;.00nan;0;0
11877;170202;195;0;0;0;0;.00nan;0;0
11877;173900;182;51;2;0;2;1.000;462000;0
11877;176200;195;88;16;0;16;1.000;3600000;0
11877;182116;182;61;46;6;40;.870;3138000;0
11879;-1;1371;55;13;1;12;.923;1029000;0
11879;-1;221;82;26;1;25;.962;3600000;0
11879;187362;221;0;0;0;0;.00nan;0;0
11879;192688;1371;12;17;6;11;.647;2571000;0
11881;187628;191;77;14;0;14;1.000;3600000;0
11881;190125;184;55;51;6;45;.882;3600000;0
11881;179668;184;0;0;0;0;.00nan;0;0
11881;185960;191;0;0;0;0;.00nan;0;0
11883;171819;177;0;0;0;0;.00nan;0;0
11883;179406;232;43;22;3;19;.864;3545000;0
11883;179434;232;0;0;0;0;.00nan;0;0
11883;179602;177;84;28;2;26;.929;3600000;0
11885;-1;210;55;16;2;14;.875;3600000;0
11885;175423;223;65;38;4;34;.895;3598000;0
11885;-1;223;0;0;0;0;.00nan;0;0
11885;192461;210;0;0;0;0;.00nan;0;0
11887;166762;213;77;21;1;20;.952;3627000;0
11887;175328;183;78;34;2;32;.941;3627000;0
11887;180575;213;0;0;0;0;.00nan;0;0
11887;182089;183;0;0;0;0;.00nan;0;0
11889;-1;202;66;32;3;29;.906;3572000;0
11889;184712;200;0;0;0;0;.00nan;0;0
11889;180623;202;0;0;0;0;.00nan;0;0
11889;187295;200;99;28;0;28;1.000;3600000;0
11891;166695;218;0;0;0;0;.00nan;0;0
11891;168954;228;90;19;0;19;1.000;3600000;0
11891;170300;228;0;0;0;0;.00nan;0;0
11891;-1;218;81;33;2;31;.939;3568000;0
11893;168117;192;70;28;2;26;.929;3600000;0
11893;189885;225;0;0;0;0;.00nan;0;0
11893;175900;192;0;0;0;0;.00nan;0;0
11893;184785;225;89;32;1;31;.969;3600000;0
11895;182454;4864;0;0;0;0;.00nan;0;0
11895;183737;4864;83;29;1;28;.966;3600000;0
11895;171405;2620;0;0;0;0;.00nan;0;0
11895;176921;2620;98;43;2;41;.953;3568000;0
11897;177248;201;0;0;0;0;.00nan;0;0
11897;183860;4959;0;0;0;0;.00nan;0;0
11897;170114;4959;86;27;1;26;.963;3711000;0
11897;185743;201;70;24;2;22;.917;3711000;0
11899;-1;196;48;24;4;20;.833;3900000;0
11899;174334;208;51;25;4;21;.840;3900000;0
11899;184648;196;0;0;0;0;.00nan;0;0
11899;179702;208;0;0;0;0;.00nan;0;0
11901;171835;4960;51;41;5;36;.878;3600000;0
11901;187660;4960;0;0;0;0;.00nan;0;0
11901;170144;227;0;0;0;0;.00nan;0;0
11901;-1;227;72;19;1;18;.947;3600000;0
11903;189081;187;0;0;0;0;.00nan;0;0
11903;175842;214;82;52;4;48;.923;3600000;0
11903;-1;187;77;10;0;10;1.000;3600000;0
11903;-1;214;0;0;0;0;.00nan;0;0
11905;173340;231;0;0;0;0;.00nan;0;0
11905;171730;220;0;0;0;0;.00nan;0;0
11905;185034;231;69;20;2;18;.900;3551000;0
11905;187443;220;99;46;1;45;.978;3600000;0
11907;-1;4949;73;37;4;33;.892;3900000;0
11907;168912;4949;0;0;0;0;.00nan;0;0
11907;-1;203;99;52;4;48;.923;3900000;0
11907;191078;203;0;0;0;0;.00nan;0;0
11909;169096;190;85;29;1;28;.966;3600000;0
11909;184175;224;0;0;0;0;.00nan;0;0
11909;175354;224;75;35;2;33;.943;3569000;0
11909;184788;190;0;0;0;0;.00nan;0;0
11911;184610;222;0;0;0;0;.00nan;0;0
11911;182049;204;85;31;1;30;.968;3564000;0
11911;-1;222;93;20;0;20;1.000;3600000;0
11911;141765;204;0;0;0;0;.00nan;0;0
11913;171970;217;85;31;1;30;.968;3600000;0
11913;168907;186;0;0;0;0;.00nan;0;0
11913;169226;186;46;26;4;22;.846;3600000;0
11913;171654;217;0;0;0;0;.00nan;0;0
11915;174209;178;78;25;2;23;.920;2424000;0
11915;175370;199;0;0;0;0;.00nan;0;0
11915;176963;178;30;23;5;18;.783;1176000;0
11915;161006;199;100;27;0;27;1.000;3600000;0
11917;166451;176;49;29;4;25;.862;3600000;0
11917;171660;209;0;0;0;0;.00nan;0;0
11917;171662;176;0;0;0;0;.00nan;0;0
11917;186205;209;73;31;3;28;.903;3600000;0
11919;168995;205;56;28;4;24;.857;3600000;0
11919;174153;188;0;0;0;0;.00nan;0;0
11919;-1;188;54;43;5;38;.884;3600000;0
11919;-1;205;0;0;0;0;.00nan;0;0
11921;176770;219;67;42;4;38;.905;3616000;0
11921;181102;219;0;0;0;0;.00nan;0;0
11921;187232;216;40;24;5;19;.792;3616000;0
11921;187240;216;0;0;0;0;.00nan;0;0
11923;175364;206;75;36;3;33;.917;3600000;0
11923;175371;206;0;0;0;0;.00nan;0;0
11923;-1;207;58;27;4;23;.852;3545000;0
11923;-1;207;0;0;0;0;.00nan;0;0
11925;166545;193;44;10;2;8;.800;3600000;0
11925;173770;193;0;0;0;0;.00nan;0;0
11925;175436;229;0;0;0;0;.00nan;0;0
11925;176860;229;89;55;3;52;.945;3555000;0
11927;170076;179;73;30;2;28;.933;3543000;0
11927;174147;179;0;0;0;0;.00nan;0;0
11927;171615;181;89;32;1;31;.969;3600000;0
11927;192552;181;0;0;0;0;.00nan;0;0
11929;167404;215;0;0;0;0;.00nan;0;0
11929;-1;211;81;47;4;43;.915;3600000;0
11929;179646;211;0;0;0;0;.00nan;0;0
11929;161046;215;59;22;3;19;.864;3600000;0
11931;-1;197;23;26;6;20;.769;3600000;0
11931;170189;197;0;0;0;0;.00nan;0;0
11931;179679;212;0;0;0;0;.00nan;0;0
11931;186641;212;74;35;3;32;.914;3600000;0
11933;170351;194;58;26;4;22;.846;3560000;0
11933;173916;230;68;23;2;21;.913;3600000;0
11933;-1;194;0;0;0;0;.00nan;0;0
11933;186495;230;0;0;0;0;.00nan;0;0
11935;168966;189;0;0;0;0;.00nan;0;0
11935;170963;185;39;33;6;27;.818;3544000;0
11935;176915;189;50;36;5;31;.861;3600000;0
11935;180110;185;0;0;0;0;.00nan;0;0
1438;173823;198;89;35;3;32;.914;4765000;0
1438;181431;198;0;0;0;0;.00nan;0;0
1438;187232;216;0;0;0;0;.00nan;0;0
1438;187240;216;47;28;4;24;.857;4765000;0
1439;173340;231;0;0;0;0;.00nan;0;0
1439;176770;219;69;39;4;35;.897;3600000;0
1439;185034;231;65;13;1;12;.923;3600000;0
1439;181102;219;0;0;0;0;.00nan;0;0
1440;166545;193;0;0;0;0;.00nan;0;0
1440;173770;193;83;32;2;30;.938;3600000;0
1440;175370;199;99;26;0;26;1.000;3600000;0
1440;161006;199;0;0;0;0;.00nan;0;0
1441;170076;179;76;33;2;31;.939;4608000;0
1441;173916;230;0;0;0;0;.00nan;0;0
1441;174147;179;0;0;0;0;.00nan;0;0
1441;186495;230;92;58;3;55;.948;4608000;0
1442;187628;191;56;7;0;7;1.000;1530000;0
1442;-1;203;60;26;3;23;.885;3600000;0
1442;-1;203;0;0;0;0;.00nan;0;0
1442;185960;191;46;19;4;15;.789;2067000;0
1443;171835;4960;65;23;2;21;.913;3600000;0
1443;187660;4960;0;0;0;0;.00nan;0;0
1443;168117;192;90;45;3;42;.933;3561000;0
1443;175900;192;0;0;0;0;.00nan;0;0
1444;170963;185;98;51;2;49;.961;3513000;0
1444;180110;185;0;0;0;0;.00nan;0;0
1444;180762;1505;100;34;0;34;1.000;3600000;0
1444;186549;1505;0;0;0;0;.00nan;0;0
1445;168907;186;0;0;0;0;.00nan;0;0
1445;169166;226;92;57;2;55;.965;5415000;0
1445;169226;186;91;40;1;39;.975;5415000;0
1445;192629;226;0;0;0;0;.00nan;0;0
1681;173340;231;0;0;0;0;.00nan;0;0
1681;173823;198;68;24;2;22;.917;3600000;0
1681;185034;231;88;46;3;43;.935;3569000;0
1681;181431;198;0;0;0;0;.00nan;0;0
1682;170076;179;67;46;4;42;.913;4542000;0
1682;174147;179;0;0;0;0;.00nan;0;0
1682;175370;199;72;51;5;46;.902;4542000;0
1682;161006;199;0;0;0;0;.00nan;0;0
1683;171835;4960;63;30;3;27;.900;3785000;0
1683;187660;4960;0;0;0;0;.00nan;0;0
1683;-1;203;53;30;4;26;.867;3785000;0
1683;-1;203;0;0;0;0;.00nan;0;0
1684;168907;186;0;0;0;0;.00nan;0;0
1684;169226;186;98;33;1;32;.970;3600000;0
1684;180762;1505;73;34;3;31;.912;3526000;0
1684;186549;1505;0;0;0;0;.00nan;0;0
1834;173823;198;87;42;1;41;.976;4375000;0
1834;170076;179;76;27;2;25;.926;4375000;0
1834;174147;179;0;0;0;0;.00nan;0;0
1834;181431;198;0;0;0;0;.00nan;0;0
1835;171835;4960;43;21;3;18;.857;3557000;0
1835;187660;4960;0;0;0;0;.00nan;0;0
1835;168907;186;0;0;0;0;.00nan;0;0
1835;169226;186;99;33;1;32;.970;3600000;0
1992;168907;186;0;0;0;0;.00nan;0;0
1992;169226;186;82;46;4;42;.913;3527000;0
1992;173823;198;68;26;2;24;.923;3600000;0
1992;181431;198;0;0;0;0;.00nan;0;0
11936;279;706;61;15;1;14;.933;3600000;0
11936;8504;2465;81;46;4;42;.913;3600000;0
11936;11882;706;0;0;0;0;.00nan;0;0
11936;145636;2465;0;0;0;0;.00nan;0;0
11937;26308;707;0;0;0;0;.00nan;0;0
11937;72229;2474;87;13;0;13;1.000;3600000;0
11937;94107;2474;0;0;0;0;.00nan;0;0
11937;156932;707;60;33;4;29;.879;3600000;0
11938;13946;711;0;0;0;0;.00nan;0;0
11938;31165;2473;58;26;3;23;.885;3575000;0
11938;181748;2473;0;0;0;0;.00nan;0;0
11938;85935;711;83;32;2;30;.938;3600000;0
11939;5997;712;66;17;1;16;.941;3600000;0
11939;13976;710;26;28;6;22;.786;2736000;0
11939;53857;712;0;0;0;0;.00nan;0;0
11939;155177;710;63;11;0;11;1.000;864000;0
11940;6669;714;0;0;0;0;.00nan;0;0
11940;8478;713;0;0;0;0;.00nan;0;0
11940;17565;714;92;46;2;44;.957;3573000;0
11940;41399;713;84;26;1;25;.962;3600000;0
11941;13976;710;55;29;5;24;.828;3600000;0
11941;72229;2474;0;0;0;0;.00nan;0;0
11941;94107;2474;77;29;2;27;.931;3600000;0
11941;155177;710;0;0;0;0;.00nan;0;0
11942;6669;714;0;0;0;0;.00nan;0;0
11942;8504;2465;77;36;3;33;.917;3576000;0
11942;17565;714;55;15;2;13;.867;3600000;0
11942;145636;2465;0;0;0;0;.00nan;0;0
11943;31165;2473;83;11;0;11;1.000;3600000;0
11943;181748;2473;0;0;0;0;.00nan;0;0
11943;72229;2474;0;0;0;0;.00nan;0;0
11943;94107;2474;60;26;3;23;.885;3600000;0
11944;5997;712;63;33;4;29;.879;3564000;0
11944;26308;707;0;0;0;0;.00nan;0;0
11944;53857;712;0;0;0;0;.00nan;0;0
11944;156932;707;84;40;2;38;.950;3600000;0
11945;8478;713;0;0;0;0;.00nan;0;0
11945;13946;711;0;0;0;0;.00nan;0;0
11945;41399;713;71;20;2;18;.900;3600000;0
11945;85935;711;59;24;3;21;.875;3555000;0
11946;279;706;0;0;0;0;.00nan;0;0
11946;11882;706;77;30;3;27;.900;3792000;0
11946;13976;710;72;30;2;28;.933;3792000;0
11946;155177;710;0;0;0;0;.00nan;0;0
11947;6669;714;0;0;0;0;.00nan;0;0
11947;17565;714;45;16;2;14;.875;3550000;0
11947;72229;2474;0;0;0;0;.00nan;0;0
11947;94107;2474;100;43;1;42;.977;3600000;0
11948;8504;2465;89;42;3;39;.929;3532000;0
11948;13976;710;73;20;1;19;.950;3600000;0
11948;145636;2465;0;0;0;0;.00nan;0;0
11948;155177;710;0;0;0;0;.00nan;0;0
11949;8478;713;0;0;0;0;.00nan;0;0
11949;26308;707;0;0;0;0;.00nan;0;0
11949;41399;713;39;22;4;18;.818;3900000;0
11949;156932;707;91;64;4;60;.938;3900000;0
11950;279;706;0;0;0;0;.00nan;0;0
11950;11882;706;84;31;2;29;.935;3683000;0
11950;13946;711;0;0;0;0;.00nan;0;0
11950;85935;711;77;27;3;24;.889;3683000;0
11951;5997;712;85;29;1;28;.966;3900000;0
11951;31165;2473;77;27;1;26;.963;3900000;0
11951;181748;2473;0;0;0;0;.00nan;0;0
11951;53857;712;0;0;0;0;.00nan;0;0
11952;5997;712;66;42;4;38;.905;3535000;0
11952;8478;713;0;0;0;0;.00nan;0;0
11952;41399;713;60;22;2;20;.909;3600000;0
11952;53857;712;0;0;0;0;.00nan;0;0
11953;8504;2465;97;44;1;43;.977;3585000;0
11953;13946;711;0;0;0;0;.00nan;0;0
11953;85935;711;82;12;0;12;1.000;3600000;0
11953;145636;2465;0;0;0;0;.00nan;0;0
11954;6669;714;0;0;0;0;.00nan;0;0
11954;13976;710;65;36;4;32;.889;3600000;0
11954;17565;714;76;25;1;24;.960;3600000;0
11954;155177;710;0;0;0;0;.00nan;0;0
11955;8478;713;0;0;0;0;.00nan;0;0
11955;31165;2473;72;29;2;27;.931;3588000;0
11955;181748;2473;0;0;0;0;.00nan;0;0
11955;41399;713;57;13;1;12;.923;3600000;0
11956;279;706;0;0;0;0;.00nan;0;0
11956;11882;706;96;20;0;20;1.000;3600000;0
11956;26308;707;73;16;0;16;1.000;1308000;0
11956;156932;707;40;38;6;32;.842;2292000;0
11957;5997;712;50;40;5;35;.875;3515000;0
11957;53857;712;0;0;0;0;.00nan;0;0
11957;72229;2474;82;35;3;32;.914;3600000;0
11957;94107;2474;0;0;0;0;.00nan;0;0
11958;279;706;0;0;0;0;.00nan;0;0
11958;11882;706;71;30;2;28;.933;3600000;0
11958;31165;2473;58;25;3;22;.880;3600000;0
11958;181748;2473;0;0;0;0;.00nan;0;0
11959;6669;714;0;0;0;0;.00nan;0;0
11959;13946;711;0;0;0;0;.00nan;0;0
11959;17565;714;63;33;3;30;.909;3600000;0
11959;85935;711;96;22;0;22;1.000;3600000;0
11960;13976;710;66;20;1;19;.950;3600000;0
11960;72229;2474;0;0;0;0;.00nan;0;0
11960;94107;2474;64;31;3;28;.903;3578000;0
11960;155177;710;0;0;0;0;.00nan;0;0
11961;8504;2465;42;32;5;27;.844;3600000;0
11961;26308;707;39;33;6;27;.818;3555000;0
11961;145636;2465;0;0;0;0;.00nan;0;0
11961;156932;707;0;0;0;0;.00nan;0;0
11962;5997;712;0;0;0;0;.00nan;0;0
11962;8478;713;0;0;0;0;.00nan;0;0
11962;41399;713;97;21;0;21;1.000;3600000;0
11962;53857;712;89;47;2;45;.957;3555000;0
11963;13946;711;0;0;0;0;.00nan;0;0
11963;26308;707;0;0;0;0;.00nan;0;0
11963;85935;711;78;11;0;11;1.000;3600000;0
11963;156932;707;69;49;5;44;.898;3600000;0
11964;8504;2465;0;0;0;0;.00nan;0;0
11964;31165;2473;93;32;1;31;.969;3600000;0
11964;181748;2473;0;0;0;0;.00nan;0;0
11964;145636;2465;93;40;2;38;.950;3553000;0
11965;13946;711;0;0;0;0;.00nan;0;0
11965;13976;710;0;0;0;0;.00nan;0;0
11965;85935;711;68;38;4;34;.895;3581000;0
11965;155177;710;74;36;3;33;.917;3600000;0
11966;6669;714;84;25;2;23;.920;3600000;0
11966;17565;714;0;0;0;0;.00nan;0;0
11966;26308;707;0;0;0;0;.00nan;0;0
11966;156932;707;75;51;4;47;.922;3570000;0
11967;8478;713;0;0;0;0;.00nan;0;0
11967;41399;713;56;19;3;16;.842;3900000;0
11967;72229;2474;80;44;3;41;.932;3900000;0
11967;94107;2474;0;0;0;0;.00nan;0;0
11968;279;706;57;29;3;26;.897;3600000;0
11968;5997;712;95;20;0;20;1.000;3600000;0
11968;11882;706;0;0;0;0;.00nan;0;0
11968;53857;712;0;0;0;0;.00nan;0;0
11969;13976;710;76;12;0;12;1.000;3600000;0
11969;26308;707;0;0;0;0;.00nan;0;0
11969;155177;710;0;0;0;0;.00nan;0;0
11969;156932;707;98;44;1;43;.977;3600000;0
11970;5997;712;71;21;1;20;.952;3600000;0
11970;8504;2465;51;40;5;35;.875;3600000;0
11970;53857;712;0;0;0;0;.00nan;0;0
11970;145636;2465;0;0;0;0;.00nan;0;0
11971;279;706;0;0;0;0;.00nan;0;0
11971;8478;713;0;0;0;0;.00nan;0;0
11971;11882;706;73;40;4;36;.900;3600000;0
11971;41399;713;88;23;1;22;.957;3600000;0
11972;13946;711;0;0;0;0;.00nan;0;0
11972;72229;2474;100;24;0;24;1.000;3600000;0
11972;85935;711;80;20;1;19;.950;3561000;0
11972;94107;2474;0;0;0;0;.00nan;0;0
11973;6669;714;0;0;0;0;.00nan;0;0
11973;17565;714;81;45;3;42;.933;3900000;0
11973;31165;2473;80;35;3;32;.914;3900000;0
11973;181748;2473;0;0;0;0;.00nan;0;0
11974;8478;713;0;0;0;0;.00nan;0;0
11974;8504;2465;85;50;4;46;.920;3600000;0
11974;41399;713;71;16;1;15;.938;3600000;0
11974;145636;2465;0;0;0;0;.00nan;0;0
11975;13976;710;47;21;3;18;.857;3513000;0
11975;31165;2473;99;42;1;41;.976;3600000;0
11975;181748;2473;0;0;0;0;.00nan;0;0
11975;155177;710;0;0;0;0;.00nan;0;0
11976;5997;712;23;4;3;1;.250;295000;0
11976;6669;714;0;0;0;0;.00nan;0;0
11976;17565;714;55;30;4;26;.867;3600000;0
11976;53857;712;48;39;5;34;.872;3305000;0
11977;279;706;0;0;0;0;.00nan;0;0
11977;11882;706;71;19;1;18;.947;3600000;0
11977;72229;2474;0;0;0;0;.00nan;0;0
11977;94107;2474;88;33;2;31;.939;3567000;0
11978;279;706;0;0;0;0;.00nan;0;0
11978;8504;2465;75;33;3;30;.909;3600000;0
11978;11882;706;66;25;2;23;.920;3600000;0
11978;145636;2465;0;0;0;0;.00nan;0;0
11979;5997;712;35;14;4;10;.714;741000;0
11979;13976;710;55;19;2;17;.895;3600000;0
11979;53857;712;60;33;3;30;.909;2859000;0
11979;155177;710;0;0;0;0;.00nan;0;0
11980;13946;711;0;0;0;0;.00nan;0;0
11980;31165;2473;79;38;3;35;.921;3589000;0
11980;181748;2473;0;0;0;0;.00nan;0;0
11980;85935;711;71;22;1;21;.955;3600000;0
11981;6669;714;0;0;0;0;.00nan;0;0
11981;8478;713;0;0;0;0;.00nan;0;0
11981;17565;714;77;28;2;26;.929;3900000;0
11981;41399;713;69;23;2;21;.913;3900000;0
11982;26308;707;0;0;0;0;.00nan;0;0
11982;72229;2474;93;23;0;23;1.000;3600000;0
11982;94107;2474;0;0;0;0;.00nan;0;0
11982;156932;707;73;36;3;33;.917;3600000;0
11983;8504;2465;85;30;2;28;.933;3600000;0
11983;72229;2474;0;0;0;0;.00nan;0;0
11983;94107;2474;41;19;4;15;.789;3571000;0
11983;145636;2465;0;0;0;0;.00nan;0;0
11984;26308;707;52;3;0;3;1.000;369000;0
11984;31165;2473;59;32;4;28;.875;3600000;0
11984;181748;2473;0;0;0;0;.00nan;0;0
11984;156932;707;49;45;6;39;.867;3214000;0
11985;8478;713;0;0;0;0;.00nan;0;0
11985;13976;710;64;44;5;39;.886;3600000;0
11985;41399;713;32;22;6;16;.727;3541000;0
11985;155177;710;0;0;0;0;.00nan;0;0
11986;279;706;0;0;0;0;.00nan;0;0
11986;6669;714;0;0;0;0;.00nan;0;0
11986;11882;706;74;30;2;28;.933;3550000;0
11986;17565;714;87;31;1;30;.968;3600000;0
11987;31165;2473;67;30;2;28;.933;3600000;0
11987;181748;2473;0;0;0;0;.00nan;0;0
11987;72229;2474;87;30;1;29;.967;3600000;0
11987;94107;2474;0;0;0;0;.00nan;0;0
11988;279;706;0;0;0;0;.00nan;0;0
11988;11882;706;100;24;0;24;1.000;3600000;0
11988;13976;710;79;26;2;24;.923;3580000;0
11988;155177;710;0;0;0;0;.00nan;0;0
11989;8478;713;0;0;0;0;.00nan;0;0
11989;13946;711;0;0;0;0;.00nan;0;0
11989;41399;713;54;30;5;25;.833;3600000;0
11989;85935;711;100;35;1;34;.971;3600000;0
11990;6669;714;30;20;5;15;.750;3600000;0
11990;8504;2465;47;38;6;32;.842;3596000;0
11990;17565;714;0;0;0;0;.00nan;0;0
11990;145636;2465;0;0;0;0;.00nan;0;0
11991;5997;712;63;13;1;12;.923;3600000;0
11991;26308;707;70;46;5;41;.891;3600000;0
11991;53857;712;0;0;0;0;.00nan;0;0
11991;156932;707;0;0;0;0;.00nan;0;0
11992;5997;712;73;29;2;27;.931;3600000;0
11992;53857;712;0;0;0;0;.00nan;0;0
11992;72229;2474;65;33;3;30;.909;3544000;0
11992;94107;2474;0;0;0;0;.00nan;0;0
11993;6669;714;0;0;0;0;.00nan;0;0
11993;13976;710;100;33;0;33;1.000;3600000;0
11993;17565;714;62;29;4;25;.862;3600000;0
11993;155177;710;0;0;0;0;.00nan;0;0
11994;279;706;0;0;0;0;.00nan;0;0
11994;11882;706;31;22;5;17;.773;3600000;0
11994;26308;707;49;9;1;8;.889;771000;0
11994;156932;707;29;29;6;23;.793;2785000;0
11995;8478;713;0;0;0;0;.00nan;0;0
11995;31165;2473;61;37;5;32;.865;3600000;0
11995;181748;2473;0;0;0;0;.00nan;0;0
11995;41399;713;55;17;2;15;.882;3600000;0
11996;8504;2465;81;40;3;37;.925;3600000;0
11996;13946;711;0;0;0;0;.00nan;0;0
11996;85935;711;59;16;1;15;.938;3600000;0
11996;145636;2465;0;0;0;0;.00nan;0;0
11997;8478;713;0;0;0;0;.00nan;0;0
11997;13976;710;80;33;2;31;.939;3600000;0
11997;41399;713;65;16;1;15;.938;3600000;0
11997;155177;710;0;0;0;0;.00nan;0;0
11998;8504;2465;0;0;0;0;.00nan;0;0
11998;26308;707;0;0;0;0;.00nan;0;0
11998;145636;2465;100;31;0;31;1.000;3600000;0
11998;156932;707;61;23;2;21;.913;3558000;0
11999;6669;714;0;0;0;0;.00nan;0;0
11999;13946;711;0;0;0;0;.00nan;0;0
11999;17565;714;70;27;2;25;.926;3600000;0
11999;85935;711;74;39;3;36;.923;3579000;0
12000;279;706;99;23;0;23;1.000;3600000;0
12000;11882;706;0;0;0;0;.00nan;0;0
12000;31165;2473;81;32;1;31;.969;3600000;0
12000;181748;2473;0;0;0;0;.00nan;0;0
12001;5997;712;0;0;0;0;.00nan;0;0
12001;13946;711;0;0;0;0;.00nan;0;0
12001;53857;712;93;44;2;42;.955;3567000;0
12001;85935;711;97;26;0;26;1.000;3600000;0
12002;8478;713;0;0;0;0;.00nan;0;0
12002;41399;713;44;20;3;17;.850;3577000;0
12002;72229;2474;0;0;0;0;.00nan;0;0
12002;94107;2474;85;37;2;35;.946;3600000;0
12003;6669;714;0;0;0;0;.00nan;0;0
12003;17565;714;48;18;3;15;.833;3900000;0
12003;26308;707;92;49;3;46;.939;3900000;0
12003;156932;707;0;0;0;0;.00nan;0;0
12004;8504;2465;0;0;0;0;.00nan;0;0
12004;31165;2473;0;0;0;0;.00nan;0;0
12004;181748;2473;68;20;1;19;.950;3600000;0
12004;145636;2465;38;51;7;44;.863;3600000;0
12005;279;706;79;21;1;20;.952;3643000;0
12005;5997;712;94;48;2;46;.958;3643000;0
12005;11882;706;0;0;0;0;.00nan;0;0
12005;53857;712;0;0;0;0;.00nan;0;0
12006;13946;711;0;0;0;0;.00nan;0;0
12006;13976;710;44;40;6;34;.850;3600000;0
12006;85935;711;72;26;2;24;.923;3600000;0
12006;155177;710;0;0;0;0;.00nan;0;0
12007;13946;711;0;0;0;0;.00nan;0;0
12007;72229;2474;56;29;4;25;.862;3015000;0
12007;85935;711;52;13;2;11;.846;3600000;0
12007;94107;2474;27;14;4;10;.714;585000;0
12008;5997;712;70;37;3;34;.919;3600000;0
12008;8504;2465;93;39;2;37;.949;3600000;0
12008;53857;712;0;0;0;0;.00nan;0;0
12008;145636;2465;0;0;0;0;.00nan;0;0
12009;6669;714;0;0;0;0;.00nan;0;0
12009;17565;714;63;22;2;20;.909;3900000;0
12009;31165;2473;100;47;2;45;.957;3900000;0
12009;181748;2473;0;0;0;0;.00nan;0;0
12010;279;706;0;0;0;0;.00nan;0;0
12010;8478;713;0;0;0;0;.00nan;0;0
12010;11882;706;65;30;3;27;.900;3600000;0
12010;41399;713;100;26;0;26;1.000;3600000;0
12011;13976;710;62;20;2;18;.900;3575000;0
12011;26308;707;89;34;1;33;.971;3600000;0
12011;155177;710;0;0;0;0;.00nan;0;0
12011;156932;707;0;0;0;0;.00nan;0;0
12012;279;706;0;0;0;0;.00nan;0;0
12012;11882;706;85;14;0;14;1.000;3600000;0
12012;72229;2474;77;28;1;27;.964;3563000;0
12012;94107;2474;0;0;0;0;.00nan;0;0
12013;13976;710;50;24;4;20;.833;3560000;0
12013;31165;2473;74;29;2;27;.931;3600000;0
12013;181748;2473;0;0;0;0;.00nan;0;0
12013;77086;710;0;0;0;0;.00nan;0;0
12014;5997;712;32;32;6;26;.813;2292000;0
12014;6669;714;0;0;0;0;.00nan;0;0
12014;17565;714;60;19;2;17;.895;3600000;0
12014;53857;712;71;14;0;14;1.000;1308000;0
12015;13946;711;0;0;0;0;.00nan;0;0
12015;26308;707;58;43;6;37;.860;2926000;0
12015;85935;711;49;9;2;7;.778;3600000;0
12015;156932;707;49;8;1;7;.875;674000;0
12016;8478;713;40;13;3;10;.769;3600000;0
12016;8504;2465;65;43;5;38;.884;3600000;0
12016;41399;713;0;0;0;0;.00nan;0;0
12016;145636;2465;0;0;0;0;.00nan;0;0
12017;13946;711;0;0;0;0;.00nan;0;0
12017;31165;2473;75;40;4;36;.900;3600000;0
12017;181748;2473;0;0;0;0;.00nan;0;0
12017;85935;711;69;17;1;16;.941;3600000;0
12018;5997;712;0;0;0;0;.00nan;0;0
12018;13976;710;0;0;0;0;.00nan;0;0
12018;53857;712;56;25;2;23;.920;3574000;0
12018;77086;710;100;28;0;28;1.000;3600000;0
12019;6669;714;0;0;0;0;.00nan;0;0
12019;8478;713;0;0;0;0;.00nan;0;0
12019;17565;714;87;27;1;26;.963;3600000;0
12019;41399;713;40;28;5;23;.821;3600000;0
12020;279;706;0;0;0;0;.00nan;0;0
12020;8504;2465;78;41;4;37;.902;3558000;0
12020;11882;706;69;22;2;20;.909;3600000;0
12020;145636;2465;0;0;0;0;.00nan;0;0
12021;26308;707;89;34;2;32;.941;3900000;0
12021;72229;2474;62;29;2;27;.931;3900000;0
12021;94107;2474;0;0;0;0;.00nan;0;0
12021;156932;707;0;0;0;0;.00nan;0;0
12022;279;706;0;0;0;0;.00nan;0;0
12022;11882;706;100;33;0;33;1.000;3600000;0
12022;13946;711;0;0;0;0;.00nan;0;0
12022;85935;711;65;27;3;24;.889;3600000;0
12023;8504;2465;66;38;4;34;.895;3544000;0
12023;72229;2474;64;25;2;23;.920;3600000;0
12023;94107;2474;0;0;0;0;.00nan;0;0
12023;145636;2465;0;0;0;0;.00nan;0;0
12024;8478;713;0;0;0;0;.00nan;0;0
12024;13976;710;0;0;0;0;.00nan;0;0
12024;41399;713;35;20;4;16;.800;3600000;0
12024;77086;710;89;34;1;33;.971;3600000;0
12025;26308;707;21;29;7;22;.759;2321000;0
12025;31165;2473;85;19;1;18;.947;3600000;0
12025;181748;2473;0;0;0;0;.00nan;0;0
12025;156932;707;79;15;0;15;1.000;1279000;0
12026;5997;712;65;37;3;34;.919;3600000;0
12026;13946;711;0;0;0;0;.00nan;0;0
12026;53857;712;0;0;0;0;.00nan;0;0
12026;85935;711;93;19;0;19;1.000;3600000;0
12027;279;706;0;0;0;0;.00nan;0;0
12027;6669;714;0;0;0;0;.00nan;0;0
12027;11882;706;75;33;4;29;.879;3900000;0
12027;17565;714;51;36;4;32;.889;3900000;0
12028;6669;714;0;0;0;0;.00nan;0;0
12028;8504;2465;40;23;4;19;.826;1862000;0
12028;17565;714;67;19;2;17;.895;3600000;0
12028;145636;2465;46;16;2;14;.875;1738000;0
12029;5997;712;59;15;1;14;.933;3900000;0
12029;26308;707;100;37;1;36;.973;3900000;0
12029;53857;712;0;0;0;0;.00nan;0;0
12029;156932;707;0;0;0;0;.00nan;0;0
12030;8478;713;0;0;0;0;.00nan;0;0
12030;13946;711;0;0;0;0;.00nan;0;0
12030;41399;713;64;39;5;34;.872;3600000;0
12030;85935;711;46;24;4;20;.833;3600000;0
12031;31165;2473;54;13;1;12;.923;3561000;0
12031;181748;2473;0;0;0;0;.00nan;0;0
12031;72229;2474;100;24;0;24;1.000;3600000;0
12031;94107;2474;0;0;0;0;.00nan;0;0
12032;279;706;0;0;0;0;.00nan;0;0
12032;11882;706;69;26;2;24;.923;3600000;0
12032;13976;710;0;0;0;0;.00nan;0;0
12032;77086;710;33;24;5;19;.792;3600000;0
12033;6669;714;0;0;0;0;.00nan;0;0
12033;17565;714;85;36;3;33;.917;3600000;0
12033;72229;2474;0;0;0;0;.00nan;0;0
12033;94107;2474;63;37;4;33;.892;3566000;0
12034;8504;2465;64;32;3;29;.906;3600000;0
12034;13976;710;0;0;0;0;.00nan;0;0
12034;77086;710;76;13;0;13;1.000;3600000;0
12034;145636;2465;0;0;0;0;.00nan;0;0
12035;8478;713;0;0;0;0;.00nan;0;0
12035;26308;707;42;35;6;29;.829;3101000;0
12035;41399;713;32;23;5;18;.783;3600000;0
12035;156932;707;37;7;2;5;.714;499000;0
12036;5997;712;0;0;0;0;.00nan;0;0
12036;31165;2473;83;30;1;29;.967;3900000;0
12036;181748;2473;0;0;0;0;.00nan;0;0
12036;53857;712;93;37;1;36;.973;3900000;0
12037;8504;2465;31;18;4;14;.778;711000;0
12037;13946;711;0;0;0;0;.00nan;0;0
12037;85935;711;40;26;5;21;.808;3600000;0
12037;145636;2465;41;28;5;23;.821;2889000;0
12038;5997;712;0;0;0;0;.00nan;0;0
12038;53857;712;83;15;0;15;1.000;3600000;0
12038;72229;2474;25;25;6;19;.760;3231000;0
12038;94107;2474;51;8;1;7;.875;369000;0
12039;6669;714;0;0;0;0;.00nan;0;0
12039;13976;710;0;0;0;0;.00nan;0;0
12039;17565;714;64;28;3;25;.893;3600000;0
12039;77086;710;44;33;5;28;.848;3543000;0
12040;8478;713;0;0;0;0;.00nan;0;0
12040;31165;2473;55;29;3;26;.897;3600000;0
12040;181748;2473;0;0;0;0;.00nan;0;0
12040;41399;713;96;15;0;15;1.000;3600000;0
12041;279;706;0;0;0;0;.00nan;0;0
12041;11882;706;61;13;1;12;.923;3600000;0
12041;26308;707;0;0;0;0;.00nan;0;0
12041;156932;707;72;50;5;45;.900;3600000;0
12042;13976;710;0;0;0;0;.00nan;0;0
12042;72229;2474;45;38;6;32;.842;2753000;0
12042;77086;710;70;24;2;22;.917;3600000;0
12042;94107;2474;49;7;1;6;.857;847000;0
12043;8504;2465;82;33;2;31;.939;3600000;0
12043;26308;707;89;21;0;21;1.000;3600000;0
12043;145636;2465;0;0;0;0;.00nan;0;0
12043;156932;707;0;0;0;0;.00nan;0;0
12044;279;706;0;0;0;0;.00nan;0;0
12044;11882;706;66;17;1;16;.941;3600000;0
12044;31165;2473;49;28;4;24;.857;3600000;0
12044;181748;2473;0;0;0;0;.00nan;0;0
12045;5997;712;0;0;0;0;.00nan;0;0
12045;8478;713;0;0;0;0;.00nan;0;0
12045;41399;713;63;32;4;28;.875;3600000;0
12045;53857;712;100;36;0;36;1.000;3600000;0
12046;6669;714;0;0;0;0;.00nan;0;0
12046;13946;711;69;22;2;20;.909;3645000;0
12046;17565;714;72;41;3;38;.927;3645000;0
12046;85935;711;0;0;0;0;.00nan;0;0
12047;8504;2465;62;30;3;27;.900;3600000;0
12047;31165;2473;18;24;6;18;.750;3600000;0
12047;181748;2473;0;0;0;0;.00nan;0;0
12047;145636;2465;0;0;0;0;.00nan;0;0
12048;13946;711;0;0;0;0;.00nan;0;0
12048;13976;710;0;0;0;0;.00nan;0;0
12048;77086;710;81;31;2;29;.935;3600000;0
12048;85935;711;53;28;3;25;.893;3572000;0
12049;6669;714;0;0;0;0;.00nan;0;0
12049;17565;714;85;34;2;32;.941;3600000;0
12049;26308;707;0;0;0;0;.00nan;0;0
12049;156932;707;58;42;5;37;.881;3600000;0
12050;8478;713;0;0;0;0;.00nan;0;0
12050;41399;713;72;27;2;25;.926;3600000;0
12050;72229;2474;57;39;5;34;.872;3600000;0
12050;94107;2474;0;0;0;0;.00nan;0;0
12051;279;706;79;27;2;25;.926;3600000;0
12051;5997;712;0;0;0;0;.00nan;0;0
12051;11882;706;0;0;0;0;.00nan;0;0
12051;53857;712;50;41;6;35;.854;3600000;0
12052;13976;710;0;0;0;0;.00nan;0;0
12052;26308;707;89;53;4;49;.925;3531000;0
12052;77086;710;59;23;2;21;.913;3600000;0
12052;156932;707;0;0;0;0;.00nan;0;0
12053;6669;714;0;0;0;0;.00nan;0;0
12053;17565;714;99;34;1;33;.971;3600000;0
12053;31165;2473;0;0;0;0;.00nan;0;0
12053;181748;2473;78;45;4;41;.911;3600000;0
12054;5997;712;0;0;0;0;.00nan;0;0
12054;8504;2465;94;37;1;36;.973;3658000;0
12054;53857;712;66;25;2;23;.920;3658000;0
12054;145636;2465;0;0;0;0;.00nan;0;0
12055;13946;711;0;0;0;0;.00nan;0;0
12055;72229;2474;87;37;2;35;.946;3568000;0
12055;85935;711;88;23;1;22;.957;3600000;0
12055;94107;2474;0;0;0;0;.00nan;0;0
12056;279;706;0;0;0;0;.00nan;0;0
12056;8478;713;0;0;0;0;.00nan;0;0
12056;11882;706;79;36;3;33;.917;3575000;0
12056;41399;713;69;18;1;17;.944;3600000;0
12057;8478;713;0;0;0;0;.00nan;0;0
12057;8504;2465;80;49;5;44;.898;3600000;0
12057;41399;713;69;8;0;8;1.000;3600000;0
12057;145636;2465;0;0;0;0;.00nan;0;0
12058;13976;710;0;0;0;0;.00nan;0;0
12058;31165;2473;16;23;6;17;.739;2181000;0
12058;181748;2473;51;10;1;9;.900;1419000;0
12058;77086;710;69;24;2;22;.917;3600000;0
12059;13946;711;0;0;0;0;.00nan;0;0
12059;26308;707;0;0;0;0;.00nan;0;0
12059;85935;711;52;7;1;6;.857;3600000;0
12059;156932;707;89;50;4;46;.920;3600000;0
12060;279;706;0;0;0;0;.00nan;0;0
12060;11882;706;89;32;1;31;.969;3600000;0
12060;72229;2474;0;0;0;0;.00nan;0;0
12060;94107;2474;55;33;4;29;.879;3600000;0
12061;5997;712;64;33;4;29;.879;3554000;0
12061;6669;714;0;0;0;0;.00nan;0;0
12061;17565;714;66;26;2;24;.923;3600000;0
12061;53857;712;0;0;0;0;.00nan;0;0
12062;279;706;0;0;0;0;.00nan;0;0
12062;8504;2465;71;39;4;35;.897;3600000;0
12062;11882;706;63;15;1;14;.933;3600000;0
12062;145636;2465;0;0;0;0;.00nan;0;0
12063;5997;712;54;20;2;18;.900;3600000;0
12063;13976;710;0;0;0;0;.00nan;0;0
12063;53857;712;0;0;0;0;.00nan;0;0
12063;77086;710;64;14;1;13;.929;3600000;0
12064;26308;707;69;26;2;24;.923;3600000;0
12064;72229;2474;0;0;0;0;.00nan;0;0
12064;94107;2474;59;11;1;10;.909;3600000;0
12064;156932;707;0;0;0;0;.00nan;0;0
12065;13946;711;0;0;0;0;.00nan;0;0
12065;31165;2473;16;33;8;25;.758;3600000;0
12065;181748;2473;0;0;0;0;.00nan;0;0
12065;85935;711;88;18;0;18;1.000;3600000;0
12066;6669;714;0;0;0;0;.00nan;0;0
12066;8478;713;0;0;0;0;.00nan;0;0
12066;17565;714;88;35;1;34;.971;3600000;0
12066;41399;713;50;18;2;16;.889;3569000;0
12067;8504;2465;97;41;1;40;.976;3585000;0
12067;72229;2474;0;0;0;0;.00nan;0;0
12067;94107;2474;100;22;0;22;1.000;3600000;0
12067;145636;2465;0;0;0;0;.00nan;0;0
12068;26308;707;0;0;0;0;.00nan;0;0
12068;31165;2473;0;0;0;0;.00nan;0;0
12068;181748;2473;71;20;1;19;.950;3600000;0
12068;156932;707;61;40;5;35;.875;3600000;0
12069;5997;712;0;0;0;0;.00nan;0;0
12069;13946;711;0;0;0;0;.00nan;0;0
12069;53857;712;50;37;5;32;.865;3600000;0
12069;85935;711;89;31;2;29;.935;3600000;0
12070;8478;713;0;0;0;0;.00nan;0;0
12070;13976;710;0;0;0;0;.00nan;0;0
12070;41399;713;57;27;3;24;.889;3541000;0
12070;77086;710;91;40;1;39;.975;3600000;0
12071;279;706;2;17;7;10;.588;3014000;0
12071;6669;714;0;0;0;0;.00nan;0;0
12071;11882;706;24;15;4;11;.733;586000;0
12071;17565;714;94;37;1;36;.973;3600000;0
12072;31165;2473;69;22;2;20;.909;3900000;0
12072;181748;2473;0;0;0;0;.00nan;0;0
12072;72229;2474;0;0;0;0;.00nan;0;0
12072;94107;2474;64;20;2;18;.900;3900000;0
12073;279;706;0;0;0;0;.00nan;0;0
12073;11882;706;54;26;4;22;.846;3900000;0
12073;13976;710;0;0;0;0;.00nan;0;0
12073;77086;710;82;39;4;35;.897;3847000;0
12074;5997;712;62;24;3;21;.875;3600000;0
12074;26308;707;32;15;4;11;.733;851000;0
12074;53857;712;0;0;0;0;.00nan;0;0
12074;156932;707;48;33;5;28;.848;2749000;0
12075;8478;713;0;0;0;0;.00nan;0;0
12075;13946;711;0;0;0;0;.00nan;0;0
12075;41399;713;92;19;0;19;1.000;3600000;0
12075;85935;711;90;34;1;33;.971;3600000;0
12076;6669;714;0;0;0;0;.00nan;0;0
12076;8504;2465;33;29;6;23;.793;2641000;0
12076;17565;714;61;19;2;17;.895;3600000;0
12076;145636;2465;51;9;1;8;.889;959000;0
12077;8504;2465;62;43;5;38;.884;3600000;0
12077;13976;710;0;0;0;0;.00nan;0;0
12077;77086;710;67;16;1;15;.938;3600000;0
12077;145636;2465;0;0;0;0;.00nan;0;0
12078;5997;712;56;34;4;30;.882;3600000;0
12078;31165;2473;40;24;5;19;.792;3527000;0
12078;181748;2473;0;0;0;0;.00nan;0;0
12078;53857;712;0;0;0;0;.00nan;0;0
12079;6669;714;0;0;0;0;.00nan;0;0
12079;17565;714;73;26;2;24;.923;3600000;0
12079;72229;2474;50;6;1;5;.833;1223000;0
12079;94107;2474;17;25;7;18;.720;2377000;0
12080;8478;713;0;0;0;0;.00nan;0;0
12080;26308;707;0;0;0;0;.00nan;0;0
12080;41399;713;87;23;1;22;.957;3600000;0
12080;156932;707;88;39;2;37;.949;3546000;0
12081;279;706;0;0;0;0;.00nan;0;0
12081;11882;706;93;40;1;39;.975;3900000;0
12081;13946;711;0;0;0;0;.00nan;0;0
12081;85935;711;76;19;1;18;.947;3900000;0
12082;5997;712;44;25;4;21;.840;3600000;0
12082;53857;712;0;0;0;0;.00nan;0;0
12082;72229;2474;0;0;0;0;.00nan;0;0
12082;94107;2474;76;27;2;25;.926;3600000;0
12083;6669;714;0;0;0;0;.00nan;0;0
12083;13976;710;0;0;0;0;.00nan;0;0
12083;17565;714;65;38;4;34;.895;3600000;0
12083;77086;710;57;26;3;23;.885;3600000;0
12084;279;706;0;0;0;0;.00nan;0;0
12084;11882;706;76;14;0;14;1.000;3600000;0
12084;26308;707;89;33;2;31;.939;2486000;0
12084;156932;707;37;21;4;17;.810;1114000;0
12085;8478;713;0;0;0;0;.00nan;0;0
12085;31165;2473;0;0;0;0;.00nan;0;0
12085;181748;2473;66;26;2;24;.923;3600000;0
12085;41399;713;63;21;3;18;.857;3586000;0
12086;8504;2465;56;43;6;37;.860;3600000;0
12086;13946;711;0;0;0;0;.00nan;0;0
12086;85935;711;62;16;1;15;.938;3600000;0
12086;145636;2465;0;0;0;0;.00nan;0;0
12087;13976;710;0;0;0;0;.00nan;0;0
12087;72229;2474;0;0;0;0;.00nan;0;0
12087;77086;710;43;21;4;17;.810;3843000;0
12087;94107;2474;71;34;3;31;.912;3843000;0
12088;6669;714;0;0;0;0;.00nan;0;0
12088;13946;711;0;0;0;0;.00nan;0;0
12088;17565;714;74;40;4;36;.900;3577000;0
12088;85935;711;62;18;2;16;.889;3600000;0
12089;5997;712;33;30;6;24;.800;2391000;0
12089;8478;713;0;0;0;0;.00nan;0;0
12089;41399;713;76;24;2;22;.917;3600000;0
12089;53857;712;25;14;4;10;.714;1209000;0
12090;279;706;0;0;0;0;.00nan;0;0
12090;11882;706;67;30;3;27;.900;3600000;0
12090;31165;2473;84;13;0;13;1.000;3600000;0
12090;181748;2473;0;0;0;0;.00nan;0;0
12091;8504;2465;0;0;0;0;.00nan;0;0
12091;26308;707;0;0;0;0;.00nan;0;0
12091;145636;2465;100;27;0;27;1.000;3600000;0
12091;156932;707;66;33;3;30;.909;3600000;0
12092;8478;713;0;0;0;0;.00nan;0;0
12092;41399;713;83;16;0;16;1.000;3600000;0
12092;72229;2474;0;0;0;0;.00nan;0;0
12092;94107;2474;83;28;1;27;.964;3600000;0
12093;6669;714;0;0;0;0;.00nan;0;0
12093;17565;714;72;20;1;19;.950;3600000;0
12093;26308;707;53;48;6;42;.875;3600000;0
12093;156932;707;0;0;0;0;.00nan;0;0
12094;8504;2465;48;0;0;0;.00nan;463000;0
12094;31165;2473;72;18;1;17;.944;3600000;0
12094;181748;2473;0;0;0;0;.00nan;0;0
12094;145636;2465;39;22;5;17;.773;3137000;0
12095;279;706;0;0;0;0;.00nan;0;0
12095;5997;712;56;26;3;23;.885;3900000;0
12095;11882;706;68;30;3;27;.900;3900000;0
12095;53857;712;0;0;0;0;.00nan;0;0
12096;13946;711;0;0;0;0;.00nan;0;0
12096;77086;710;0;0;0;0;.00nan;0;0
12096;85546;710;74;33;2;31;.939;3600000;0
12096;85935;711;74;19;1;18;.947;3600000;0
12097;5997;712;88;30;1;29;.967;3900000;0
12097;8504;2465;100;40;1;39;.975;3900000;0
12097;53857;712;0;0;0;0;.00nan;0;0
12097;145636;2465;0;0;0;0;.00nan;0;0
12098;13946;711;0;0;0;0;.00nan;0;0
12098;72229;2474;0;0;0;0;.00nan;0;0
12098;85935;711;80;8;0;8;1.000;3600000;0
12098;94107;2474;79;35;3;32;.914;3600000;0
12099;6669;714;0;0;0;0;.00nan;0;0
12099;17565;714;73;21;1;20;.952;3600000;0
12099;31165;2473;79;31;2;29;.935;3578000;0
12099;181748;2473;0;0;0;0;.00nan;0;0
12100;279;706;0;0;0;0;.00nan;0;0
12100;8478;713;0;0;0;0;.00nan;0;0
12100;11882;706;77;35;3;32;.914;3621000;0
12100;41399;713;53;28;4;24;.857;3621000;0
12101;26308;707;0;0;0;0;.00nan;0;0
12101;77086;710;0;0;0;0;.00nan;0;0
12101;85546;710;67;20;2;18;.900;3600000;0
12101;156932;707;80;58;4;54;.931;3576000;0
12102;26308;707;0;0;0;0;.00nan;0;0
12102;72229;2474;50;19;3;16;.842;3665000;0
12102;94107;2474;0;0;0;0;.00nan;0;0
12102;156932;707;73;39;4;35;.897;3665000;0
12103;13946;711;0;0;0;0;.00nan;0;0
12103;31165;2473;57;25;3;22;.880;3600000;0
12103;181748;2473;0;0;0;0;.00nan;0;0
12103;85935;711;51;30;4;26;.867;3600000;0
12104;5997;712;0;0;0;0;.00nan;0;0
12104;53857;712;88;49;3;46;.939;3900000;0
12104;77086;710;0;0;0;0;.00nan;0;0
12104;85546;710;73;31;3;28;.903;3900000;0
12105;6669;714;0;0;0;0;.00nan;0;0
12105;8478;713;0;0;0;0;.00nan;0;0
12105;17565;714;68;31;3;28;.903;3600000;0
12105;41399;713;95;34;2;32;.941;3600000;0
12106;279;706;0;0;0;0;.00nan;0;0
12106;8504;2465;58;29;4;25;.862;3573000;0
12106;11882;706;47;21;3;18;.857;3600000;0
12106;145636;2465;0;0;0;0;.00nan;0;0
12107;8478;713;0;0;0;0;.00nan;0;0
12107;41399;713;64;26;3;23;.885;3600000;0
12107;77086;710;0;0;0;0;.00nan;0;0
12107;85546;710;72;34;2;32;.941;3600000;0
12108;5997;712;57;35;4;31;.886;3598000;0
12108;13946;711;0;0;0;0;.00nan;0;0
12108;53857;712;0;0;0;0;.00nan;0;0
12108;85935;711;43;11;2;9;.818;3600000;0
12109;279;706;0;0;0;0;.00nan;0;0
12109;6669;714;0;0;0;0;.00nan;0;0
12109;11882;706;57;23;3;20;.870;3600000;0
12109;17565;714;22;21;6;15;.714;3600000;0
12110;8504;2465;50;16;3;13;.813;3557000;0
12110;72229;2474;0;0;0;0;.00nan;0;0
12110;94107;2474;73;32;2;30;.938;3600000;0
12110;145636;2465;0;0;0;0;.00nan;0;0
12111;26308;707;80;27;2;25;.926;2479000;0
12111;31165;2473;68;15;1;14;.933;3600000;0
12111;181748;2473;0;0;0;0;.00nan;0;0
12111;156932;707;19;9;4;5;.556;1121000;0
12112;6669;714;0;0;0;0;.00nan;0;0
12112;8504;2465;92;44;2;42;.955;3600000;0
12112;17565;714;62;31;3;28;.903;3544000;0
12112;145636;2465;0;0;0;0;.00nan;0;0
12113;31165;2473;0;0;0;0;.00nan;0;0
12113;181748;2473;65;19;2;17;.895;3600000;0
12113;72229;2474;0;0;0;0;.00nan;0;0
12113;94107;2474;72;39;4;35;.897;3600000;0
12114;5997;712;0;0;0;0;.00nan;0;0
12114;26308;707;0;0;0;0;.00nan;0;0
12114;53857;712;70;27;2;25;.926;3900000;0
12114;156932;707;68;26;2;24;.923;3900000;0
12115;8478;713;77;23;1;22;.957;3600000;0
12115;13946;711;44;4;1;3;.750;256000;0
12115;41399;713;0;0;0;0;.00nan;0;0
12115;85935;711;33;34;6;28;.824;3344000;0
12116;279;706;74;21;1;20;.952;3600000;0
12116;11882;706;0;0;0;0;.00nan;0;0
12116;77086;710;0;0;0;0;.00nan;0;0
12116;85546;710;63;26;2;24;.923;3600000;0
12117;6669;714;0;0;0;0;.00nan;0;0
12117;17565;714;83;27;1;26;.963;3600000;0
12117;72229;2474;0;0;0;0;.00nan;0;0
12117;94107;2474;63;36;4;32;.889;3600000;0
12118;5997;712;0;0;0;0;.00nan;0;0
12118;31165;2473;22;32;7;25;.781;2999000;0
12118;181748;2473;50;1;0;1;1.000;583000;0
12118;53857;712;45;37;6;31;.838;3600000;0
12119;279;706;0;0;0;0;.00nan;0;0
12119;11882;706;89;51;3;48;.941;3539000;0
12119;13946;711;0;0;0;0;.00nan;0;0
12119;85935;711;65;16;1;15;.938;3600000;0
12120;8504;2465;83;50;5;45;.900;3600000;0
12120;77086;710;0;0;0;0;.00nan;0;0
12120;85546;710;70;19;1;18;.947;3600000;0
12120;145636;2465;0;0;0;0;.00nan;0;0
12121;8478;713;0;0;0;0;.00nan;0;0
12121;26308;707;80;56;5;51;.911;3600000;0
12121;41399;713;57;18;2;16;.889;3600000;0
12121;156932;707;0;0;0;0;.00nan;0;0
12122;8504;2465;73;36;3;33;.917;3600000;0
12122;13946;711;0;0;0;0;.00nan;0;0
12122;85935;711;45;23;4;19;.826;3600000;0
12122;145636;2465;0;0;0;0;.00nan;0;0
12123;6669;714;53;33;4;29;.879;3600000;0
12123;17565;714;0;0;0;0;.00nan;0;0
12123;77086;710;0;0;0;0;.00nan;0;0
12123;85546;710;83;31;1;30;.968;3600000;0
12124;8478;713;0;0;0;0;.00nan;0;0
12124;31165;2473;59;29;4;25;.862;3600000;0
12124;181748;2473;0;0;0;0;.00nan;0;0
12124;41399;713;100;24;0;24;1.000;3600000;0
12125;279;706;60;13;1;12;.923;3600000;0
12125;18801;706;0;0;0;0;.00nan;0;0
12125;26308;707;49;38;6;32;.842;3600000;0
12125;156932;707;0;0;0;0;.00nan;0;0
12126;5997;712;0;0;0;0;.00nan;0;0
12126;53857;712;75;31;2;29;.935;3558000;0
12126;72229;2474;0;0;0;0;.00nan;0;0
12126;94107;2474;82;24;1;23;.958;3600000;0
12127;6669;714;0;0;0;0;.00nan;0;0
12127;13946;711;0;0;0;0;.00nan;0;0
12127;17565;714;43;30;5;25;.833;3740000;0
12127;85935;711;43;29;4;25;.862;3740000;0
12128;72229;2474;51;3;0;3;1.000;437000;0
12128;77086;710;0;0;0;0;.00nan;0;0
12128;85546;710;70;26;2;24;.923;3600000;0
12128;94107;2474;30;33;6;27;.818;3163000;0
12129;8504;2465;65;19;2;17;.895;3600000;0
12129;26308;707;57;32;4;28;.875;3570000;0
12129;145636;2465;0;0;0;0;.00nan;0;0
12129;156932;707;0;0;0;0;.00nan;0;0
12130;279;706;0;0;0;0;.00nan;0;0
12130;11882;706;76;28;2;26;.929;3592000;0
12130;31165;2473;79;26;1;25;.962;3600000;0
12130;181748;2473;0;0;0;0;.00nan;0;0
12131;5997;712;32;7;3;4;.571;542000;0
12131;8478;713;0;0;0;0;.00nan;0;0
12131;41399;713;63;34;4;30;.882;3600000;0
12131;53857;712;51;15;2;13;.867;3015000;0
12132;8504;2465;99;48;2;46;.958;3600000;0
12132;31165;2473;57;33;5;28;.848;3600000;0
12132;181748;2473;0;0;0;0;.00nan;0;0
12132;145636;2465;0;0;0;0;.00nan;0;0
12133;13946;711;0;0;0;0;.00nan;0;0
12133;77086;710;0;0;0;0;.00nan;0;0
12133;85546;710;84;34;2;32;.941;3600000;0
12133;85935;711;12;23;7;16;.696;3600000;0
12134;6669;714;0;0;0;0;.00nan;0;0
12134;17565;714;55;12;1;11;.917;3600000;0
12134;26308;707;91;54;4;50;.926;3600000;0
12134;156932;707;0;0;0;0;.00nan;0;0
12135;8478;713;0;0;0;0;.00nan;0;0
12135;41399;713;78;21;1;20;.952;3600000;0
12135;72229;2474;0;0;0;0;.00nan;0;0
12135;94107;2474;86;40;3;37;.925;3600000;0
12136;279;706;0;0;0;0;.00nan;0;0
12136;5997;712;67;34;3;31;.912;3589000;0
12136;11882;706;65;18;1;17;.944;3600000;0
12136;53857;712;0;0;0;0;.00nan;0;0
12137;6669;714;0;0;0;0;.00nan;0;0
12137;17565;714;57;35;4;31;.886;3514000;0
12137;31165;2473;78;29;2;27;.931;3600000;0
12137;181748;2473;0;0;0;0;.00nan;0;0
12138;5997;712;82;31;1;30;.968;3600000;0
12138;8504;2465;70;43;4;39;.907;3600000;0
12138;53857;712;0;0;0;0;.00nan;0;0
12138;145636;2465;0;0;0;0;.00nan;0;0
12139;279;706;0;0;0;0;.00nan;0;0
12139;8478;713;0;0;0;0;.00nan;0;0
12139;11882;706;64;27;3;24;.889;3900000;0
12139;41399;713;82;36;3;33;.917;3900000;0
12140;13946;711;0;0;0;0;.00nan;0;0
12140;72229;2474;66;42;5;37;.881;3574000;0
12140;85935;711;40;14;3;11;.786;3600000;0
12140;94107;2474;0;0;0;0;.00nan;0;0
12141;26308;707;96;53;3;50;.943;3900000;0
12141;77086;710;0;0;0;0;.00nan;0;0
12141;85546;710;47;17;3;14;.824;3900000;0
12141;156932;707;0;0;0;0;.00nan;0;0
12142;8478;713;0;0;0;0;.00nan;0;0
12142;8504;2465;98;64;3;61;.953;3600000;0
12142;41399;713;90;14;0;14;1.000;3600000;0
12142;145636;2465;0;0;0;0;.00nan;0;0
12143;31165;2473;83;29;1;28;.966;3600000;0
12143;181748;2473;0;0;0;0;.00nan;0;0
12143;77086;710;0;0;0;0;.00nan;0;0
12143;85546;710;84;42;3;39;.929;3524000;0
12144;13946;711;54;13;1;12;.923;3600000;0
12144;26308;707;40;2;1;1;.500;273000;0
12144;85935;711;0;0;0;0;.00nan;0;0
12144;156932;707;41;41;6;35;.854;3327000;0
12145;5997;712;74;29;2;27;.931;3600000;0
12145;6669;714;0;0;0;0;.00nan;0;0
12145;17565;714;48;26;4;22;.846;3518000;0
12145;53857;712;0;0;0;0;.00nan;0;0
12146;279;706;50;26;4;22;.846;3600000;0
12146;11882;706;0;0;0;0;.00nan;0;0
12146;72229;2474;40;2;1;1;.500;256000;0
12146;94107;2474;45;33;5;28;.848;3331000;0
12147;8504;2465;75;22;3;19;.864;3900000;0
12147;72229;2474;0;0;0;0;.00nan;0;0
12147;94107;2474;93;34;3;31;.912;3900000;0
12147;145636;2465;0;0;0;0;.00nan;0;0
12148;5997;712;48;25;4;21;.840;3600000;0
12148;13946;711;0;0;0;0;.00nan;0;0
12148;53857;712;0;0;0;0;.00nan;0;0
12148;85935;711;77;22;1;21;.955;3600000;0
12149;279;706;0;0;0;0;.00nan;0;0
12149;6669;714;0;0;0;0;.00nan;0;0
12149;11882;706;56;45;6;39;.867;3600000;0
12149;17565;714;64;20;1;19;.950;3600000;0
12150;26308;707;46;15;2;13;.867;3600000;0
12150;31165;2473;62;33;3;30;.909;3574000;0
12150;181748;2473;0;0;0;0;.00nan;0;0
12150;156932;707;0;0;0;0;.00nan;0;0
12151;8504;2465;85;34;2;32;.941;3572000;0
12151;77086;710;0;0;0;0;.00nan;0;0
12151;85546;710;67;18;1;17;.944;3600000;0
12151;145636;2465;0;0;0;0;.00nan;0;0
12152;5997;712;0;0;0;0;.00nan;0;0
12152;31165;2473;78;21;1;20;.952;3600000;0
12152;181748;2473;0;0;0;0;.00nan;0;0
12152;53857;712;37;31;6;25;.806;3600000;0
12153;6669;714;0;0;0;0;.00nan;0;0
12153;17565;714;81;36;3;33;.917;3600000;0
12153;72229;2474;0;0;0;0;.00nan;0;0
12153;94107;2474;50;35;5;30;.857;3584000;0
12154;8478;713;0;0;0;0;.00nan;0;0
12154;26308;707;49;1;0;1;1.000;369000;0
12154;41399;713;84;17;0;17;1.000;3600000;0
12154;156932;707;34;42;7;35;.833;3231000;0
12155;279;706;0;0;0;0;.00nan;0;0
12155;11882;706;64;22;2;20;.909;3559000;0
12155;13946;711;0;0;0;0;.00nan;0;0
12155;85935;711;100;29;0;29;1.000;3600000;0
12156;279;706;0;0;0;0;.00nan;0;0
12156;11882;706;90;17;0;17;1.000;3600000;0
12156;72229;2474;70;54;5;49;.907;3600000;0
12156;94107;2474;0;0;0;0;.00nan;0;0
12157;13946;711;0;0;0;0;.00nan;0;0
12157;26308;707;85;51;4;47;.922;3600000;0
12157;85935;711;71;17;1;16;.941;3600000;0
12157;156932;707;0;0;0;0;.00nan;0;0
12158;31165;2473;0;0;0;0;.00nan;0;0
12158;181748;2473;70;26;1;25;.962;3600000;0
12158;77086;710;0;0;0;0;.00nan;0;0
12158;85546;710;67;27;3;24;.889;3513000;0
12159;5997;712;85;37;3;34;.919;3600000;0
12159;6669;714;0;0;0;0;.00nan;0;0
12159;17565;714;100;36;0;36;1.000;3600000;0
12159;53857;712;0;0;0;0;.00nan;0;0
12160;8478;713;0;0;0;0;.00nan;0;0
12160;8504;2465;96;49;3;46;.939;3531000;0
12160;41399;713;97;25;1;24;.960;3600000;0
12160;145636;2465;0;0;0;0;.00nan;0;0
12162;8504;2465;72;27;2;25;.926;3621000;0
12162;72229;2474;0;0;0;0;.00nan;0;0
12162;94107;2474;78;36;3;33;.917;3621000;0
12162;145636;2465;0;0;0;0;.00nan;0;0
12164;5997;712;100;31;0;31;1.000;3600000;0
12164;13976;710;0;0;0;0;.00nan;0;0
12164;53857;712;0;0;0;0;.00nan;0;0
12164;85489;710;69;28;3;25;.893;3600000;0
12166;8478;713;0;0;0;0;.00nan;0;0
12166;26308;707;97;45;1;44;.978;3600000;0
12166;41399;713;75;10;0;10;1.000;3600000;0
12166;156932;707;0;0;0;0;.00nan;0;0
12170;279;706;0;0;0;0;.00nan;0;0
12170;11882;706;81;29;2;27;.931;3900000;0
12170;31165;2473;75;30;2;28;.933;3900000;0
12170;181748;2473;0;0;0;0;.00nan;0;0
12172;5997;712;15;20;6;14;.700;2104000;0
12172;31165;2473;70;30;3;27;.900;3600000;0
12172;181748;2473;0;0;0;0;.00nan;0;0
12172;53857;712;64;25;2;23;.920;1496000;0
12174;8504;2465;80;38;4;34;.895;3600000;0
12174;13976;710;0;0;0;0;.00nan;0;0
12174;85489;710;24;23;5;18;.783;3546000;0
12174;145636;2465;0;0;0;0;.00nan;0;0
12178;8478;713;0;0;0;0;.00nan;0;0
12178;26308;707;71;31;3;28;.903;3600000;0
12178;41399;713;63;14;1;13;.929;3600000;0
12178;156932;707;0;0;0;0;.00nan;0;0
12180;279;706;75;28;2;26;.929;3767000;0
12180;6669;714;0;0;0;0;.00nan;0;0
12180;11882;706;0;0;0;0;.00nan;0;0
12180;17565;714;59;28;3;25;.893;3767000;0
12182;13946;711;0;0;0;0;.00nan;0;0
12182;13976;710;96;45;3;42;.933;3600000;0
12182;85489;710;0;0;0;0;.00nan;0;0
12182;85935;711;48;27;4;23;.852;3560000;0
12184;5997;712;59;27;3;24;.889;3546000;0
12184;8504;2465;0;0;0;0;.00nan;0;0
12184;53857;712;0;0;0;0;.00nan;0;0
12184;145636;2465;65;25;2;23;.920;3600000;0
12186;279;706;0;0;0;0;.00nan;0;0
12186;11882;706;50;28;4;24;.857;3600000;0
12186;31165;2473;0;0;0;0;.00nan;0;0
12186;181748;2473;78;27;1;26;.963;3600000;0
12188;6669;714;46;39;6;33;.846;3600000;0
12188;8478;713;51;24;3;21;.875;3600000;0
12188;17565;714;0;0;0;0;.00nan;0;0
12188;41399;713;0;0;0;0;.00nan;0;0
12190;26308;707;0;0;0;0;.00nan;0;0
12190;72229;2474;61;12;1;11;.917;3600000;0
12190;94107;2474;0;0;0;0;.00nan;0;0
12190;156932;707;88;43;2;41;.953;3600000;0
12194;8504;2465;86;31;1;30;.968;3600000;0
12194;31165;2473;49;28;4;24;.857;3600000;0
12194;181748;2473;0;0;0;0;.00nan;0;0
12194;145636;2465;0;0;0;0;.00nan;0;0
12196;6669;714;0;0;0;0;.00nan;0;0
12196;17565;714;62;23;2;21;.913;3600000;0
12196;26308;707;52;44;6;38;.864;3600000;0
12196;156932;707;0;0;0;0;.00nan;0;0
12198;5997;712;0;0;0;0;.00nan;0;0
12198;13976;710;0;0;0;0;.00nan;0;0
12198;53857;712;100;36;1;35;.972;3600000;0
12198;85489;710;76;44;4;40;.909;3600000;0
12200;8478;713;0;0;0;0;.00nan;0;0
12200;41399;713;86;18;0;18;1.000;3600000;0
12200;72229;2474;45;35;5;30;.857;3600000;0
12200;94107;2474;0;0;0;0;.00nan;0;0
12202;8478;713;0;0;0;0;.00nan;0;0
12202;13976;710;64;43;5;38;.884;3807000;0
12202;41399;713;55;31;4;27;.871;3807000;0
12202;155177;710;0;0;0;0;.00nan;0;0
12204;5997;712;67;23;2;21;.913;3600000;0
12204;26308;707;0;0;0;0;.00nan;0;0
12204;53857;712;0;0;0;0;.00nan;0;0
12204;156932;707;57;59;7;52;.881;3600000;0
12206;8504;2465;0;0;0;0;.00nan;0;0
12206;31165;2473;0;0;0;0;.00nan;0;0
12206;181748;2473;66;16;1;15;.938;3600000;0
12206;145636;2465;81;52;5;47;.904;3600000;0
12208;279;706;62;20;2;18;.900;3600000;0
12208;11882;706;0;0;0;0;.00nan;0;0
12208;72229;2474;0;0;0;0;.00nan;0;0
12208;94107;2474;79;49;5;44;.898;3600000;0
12212;279;706;71;27;2;25;.926;3600000;0
12212;11882;706;0;0;0;0;.00nan;0;0
12212;31165;2473;54;26;4;22;.846;3600000;0
12212;181748;2473;0;0;0;0;.00nan;0;0
12214;5997;712;53;25;3;22;.880;3600000;0
12214;8504;2465;41;43;7;36;.837;3600000;0
12214;53857;712;0;0;0;0;.00nan;0;0
12214;145636;2465;0;0;0;0;.00nan;0;0
12216;13976;710;65;18;1;17;.944;3600000;0
12216;26308;707;60;44;6;38;.864;3179000;0
12216;155177;710;0;0;0;0;.00nan;0;0
12216;156932;707;42;4;1;3;.750;421000;0
12218;6669;714;0;0;0;0;.00nan;0;0
12218;17565;714;51;29;4;25;.862;3590000;0
12218;72229;2474;92;42;2;40;.952;3600000;0
12218;94107;2474;0;0;0;0;.00nan;0;0
12222;279;706;0;0;0;0;.00nan;0;0
12222;8478;713;0;0;0;0;.00nan;0;0
12222;11882;706;39;28;5;23;.821;3597000;0
12222;41399;713;79;38;3;35;.921;3600000;0
12224;6669;714;60;23;2;21;.913;3600000;0
12224;17565;714;0;0;0;0;.00nan;0;0
12224;31165;2473;0;0;0;0;.00nan;0;0
12224;181748;2473;56;34;4;30;.882;3582000;0
12228;26308;707;0;0;0;0;.00nan;0;0
12228;72229;2474;0;0;0;0;.00nan;0;0
12228;94107;2474;76;7;0;7;1.000;3600000;0
12228;156932;707;81;41;3;38;.927;3600000;0
12230;5997;712;0;0;0;0;.00nan;0;0
12230;8504;2465;0;0;0;0;.00nan;0;0
12230;53857;712;68;17;1;16;.941;3900000;0
12230;145636;2465;96;33;1;32;.970;3900000;0
1245;5997;712;92;30;1;29;.967;3600000;0
1245;13946;711;0;0;0;0;.00nan;0;0
1245;53857;712;0;0;0;0;.00nan;0;0
1245;85935;711;48;18;3;15;.833;3516000;0
1246;8478;713;0;0;0;0;.00nan;0;0
1246;41399;713;57;14;1;13;.929;3600000;0
1246;72229;2474;57;15;1;14;.933;1789000;0
1246;94107;2474;27;26;6;20;.769;1811000;0
1247;279;706;0;0;0;0;.00nan;0;0
1247;11882;706;39;27;5;22;.815;5024000;0
1247;31165;2473;63;46;4;42;.913;5024000;0
1247;181748;2473;0;0;0;0;.00nan;0;0
1248;6669;714;0;0;0;0;.00nan;0;0
1248;17565;714;65;16;1;15;.938;3600000;0
1248;77086;710;0;0;0;0;.00nan;0;0
1248;85546;710;77;36;3;33;.917;3592000;0
1249;5997;712;23;6;3;3;.500;418000;0
1249;13946;711;0;0;0;0;.00nan;0;0
1249;53857;712;66;29;2;27;.931;3182000;0
1249;85935;711;92;26;1;25;.962;3600000;0
1250;8478;713;0;0;0;0;.00nan;0;0
1250;41399;713;79;32;1;31;.969;4457000;0
1250;72229;2474;0;0;0;0;.00nan;0;0
1250;94107;2474;91;40;2;38;.950;4457000;0
1251;279;706;0;0;0;0;.00nan;0;0
1251;11882;706;91;15;0;15;1.000;3600000;0
1251;31165;2473;17;30;7;23;.767;3600000;0
1251;181748;2473;0;0;0;0;.00nan;0;0
1252;6669;714;0;0;0;0;.00nan;0;0
1252;17565;714;92;46;3;43;.935;3600000;0
1252;77086;710;0;0;0;0;.00nan;0;0
1252;85546;710;25;39;8;31;.795;3600000;0
1253;5997;712;39;33;6;27;.818;3173000;0
1253;13946;711;0;0;0;0;.00nan;0;0
1253;53857;712;53;2;0;2;1.000;427000;0
1253;85935;711;50;22;3;19;.864;3600000;0
1254;8478;713;0;0;0;0;.00nan;0;0
1254;41399;713;68;21;2;19;.905;3600000;0
1254;72229;2474;0;0;0;0;.00nan;0;0
1254;94107;2474;93;45;3;42;.933;3581000;0
1255;279;706;0;0;0;0;.00nan;0;0
1255;11882;706;60;16;1;15;.938;4545000;0
1255;31165;2473;77;40;2;38;.950;4545000;0
1255;181748;2473;0;0;0;0;.00nan;0;0
1256;6669;714;0;0;0;0;.00nan;0;0
1256;17565;714;36;32;6;26;.813;3600000;0
1256;77086;710;0;0;0;0;.00nan;0;0
1256;85546;710;85;28;1;27;.964;3600000;0
1257;5997;712;75;32;2;30;.938;3600000;0
1257;13946;711;0;0;0;0;.00nan;0;0
1257;53857;712;0;0;0;0;.00nan;0;0
1257;85935;711;63;22;3;19;.864;3543000;0
1258;8478;713;0;0;0;0;.00nan;0;0
1258;41399;713;57;12;1;11;.917;3600000;0
1258;72229;2474;0;0;0;0;.00nan;0;0
1258;94107;2474;81;30;2;28;.933;3562000;0
1259;279;706;0;0;0;0;.00nan;0;0
1259;11882;706;81;34;3;31;.912;3547000;0
1259;31165;2473;83;33;2;31;.939;3600000;0
1259;181748;2473;0;0;0;0;.00nan;0;0
1260;6669;714;0;0;0;0;.00nan;0;0
1260;17565;714;62;29;3;26;.897;3575000;0
1260;77086;710;0;0;0;0;.00nan;0;0
1260;85546;710;75;25;2;23;.920;3600000;0
1576;5997;712;37;32;6;26;.813;2698000;0
1576;13946;711;0;0;0;0;.00nan;0;0
1576;53857;712;65;7;0;7;1.000;902000;0
1576;85935;711;60;13;1;12;.923;3600000;0
1577;279;706;0;0;0;0;.00nan;0;0
1577;11882;706;100;23;0;23;1.000;3600000;0
1577;31165;2473;69;49;4;45;.918;3600000;0
1577;181748;2473;0;0;0;0;.00nan;0;0
1578;6669;714;0;0;0;0;.00nan;0;0
1578;17565;714;49;20;3;17;.850;3545000;0
1578;77086;710;0;0;0;0;.00nan;0;0
1578;85546;710;81;30;2;28;.933;3600000;0
1618;5997;712;48;35;5;30;.857;4935000;0
1618;13946;711;0;0;0;0;.00nan;0;0
1618;53857;712;0;0;0;0;.00nan;0;0
1618;85935;711;75;44;4;40;.909;4935000;0
1619;279;706;0;0;0;0;.00nan;0;0
1619;11882;706;42;30;5;25;.833;3655000;0
1619;31165;2473;53;31;4;27;.871;3655000;0
1619;181748;2473;0;0;0;0;.00nan;0;0
1620;6669;714;40;9;2;7;.778;2476000;0
1620;17565;714;31;15;4;11;.733;1124000;0
1620;77086;710;0;0;0;0;.00nan;0;0
1620;85546;710;80;36;2;34;.944;3600000;0
1685;279;706;0;0;0;0;.00nan;0;0
1685;11882;706;77;37;3;34;.919;3600000;0
1685;31165;2473;42;36;6;30;.833;3600000;0
1685;181748;2473;0;0;0;0;.00nan;0;0
1813;13946;711;0;0;0;0;.00nan;0;0
1813;77086;710;0;0;0;0;.00nan;0;0
1813;85546;710;86;36;1;35;.972;5042000;0
1813;85935;711;76;34;2;32;.941;5042000;0
1814;279;706;0;0;0;0;.00nan;0;0
1814;8478;713;0;0;0;0;.00nan;0;0
1814;11882;706;77;46;5;41;.891;3600000;0
1814;41399;713;72;14;1;13;.929;3600000;0
1815;13946;711;0;0;0;0;.00nan;0;0
1815;77086;710;0;0;0;0;.00nan;0;0
1815;85546;710;42;26;5;21;.808;3600000;0
1815;85935;711;80;25;1;24;.960;3600000;0
1816;279;706;0;0;0;0;.00nan;0;0
1816;8478;713;0;0;0;0;.00nan;0;0
1816;11882;706;54;32;4;28;.875;3600000;0
1816;41399;713;90;31;1;30;.968;3600000;0
1817;13946;711;0;0;0;0;.00nan;0;0
1817;77086;710;0;0;0;0;.00nan;0;0
1817;85546;710;68;21;2;19;.905;3600000;0
1817;85935;711;64;27;3;24;.889;3565000;0
1818;279;706;0;0;0;0;.00nan;0;0
1818;8478;713;0;0;0;0;.00nan;0;0
1818;11882;706;74;31;2;29;.935;3543000;0
1818;41399;713;82;30;1;29;.967;3600000;0
1819;13946;711;0;0;0;0;.00nan;0;0
1819;77086;710;0;0;0;0;.00nan;0;0
1819;85546;710;49;24;3;21;.875;3600000;0
1819;85935;711;32;27;5;22;.815;3542000;0
1820;279;706;0;0;0;0;.00nan;0;0
1820;8478;713;0;0;0;0;.00nan;0;0
1820;11882;706;85;44;4;40;.909;3600000;0
1820;41399;713;62;25;3;22;.880;3600000;0
1967;13946;711;0;0;0;0;.00nan;0;0
1967;77086;710;0;0;0;0;.00nan;0;0
1967;85546;710;27;25;6;19;.760;3600000;0
1967;85935;711;61;27;3;24;.889;3600000;0
1993;13946;711;0;0;0;0;.00nan;0;0
1993;77086;710;0;0;0;0;.00nan;0;0
1993;85546;710;100;52;2;50;.962;3600000;0
1993;85935;711;20;17;5;12;.706;3600000;0
2044;8478;713;0;0;0;0;.00nan;0;0
2044;41399;713;54;33;4;29;.879;3600000;0
2044;77086;710;0;0;0;0;.00nan;0;0
2044;85546;710;100;30;0;30;1.000;3600000;0
2045;8478;713;0;0;0;0;.00nan;0;0
2045;41399;713;65;36;4;32;.889;4722000;0
2045;77086;710;0;0;0;0;.00nan;0;0
2045;85546;710;92;67;5;62;.925;4722000;0
2046;8478;713;0;0;0;0;.00nan;0;0
2046;41399;713;80;34;2;32;.941;3777000;0
2046;77086;710;0;0;0;0;.00nan;0;0
2046;85546;710;66;33;3;30;.909;3777000;0
2047;8478;713;0;0;0;0;.00nan;0;0
2047;41399;713;48;28;5;23;.821;3600000;0
2047;77086;710;0;0;0;0;.00nan;0;0
2047;85546;710;84;28;1;27;.964;3600000;0
2212;8478;713;0;0;0;0;.00nan;0;0
2212;41399;713;51;9;1;8;.889;3600000;0
2212;77086;710;0;0;0;0;.00nan;0;0
2212;85546;710;85;46;3;43;.935;3580000;0
2283;8478;713;0;0;0;0;.00nan;0;0
2283;41399;713;56;21;2;19;.905;3749000;0
2283;77086;710;0;0;0;0;.00nan;0;0
2283;85546;710;63;29;3;26;.897;3749000;0
12231;584;3923;25;14;4;10;.714;944000;0
12231;45193;3923;85;32;2;30;.938;2656000;0
12231;54273;619;0;0;0;0;.00nan;0;0
12231;78262;619;67;21;2;19;.905;3600000;0
12232;26336;612;57;17;2;15;.882;4200000;0
12232;32712;611;80;40;2;38;.950;4200000;0
12232;65672;612;0;0;0;0;.00nan;0;0
12232;156322;611;0;0;0;0;.00nan;0;0
12233;34959;620;0;0;0;0;.00nan;0;0
12233;63529;2167;64;37;4;33;.892;3600000;0
12233;67724;2167;0;0;0;0;.00nan;0;0
12233;86875;620;100;29;0;29;1.000;3600000;0
12234;10141;1901;0;0;0;0;.00nan;0;0
12234;17596;614;61;12;1;11;.917;3600000;0
12234;73699;1901;85;37;3;34;.919;3590000;0
12234;95056;614;0;0;0;0;.00nan;0;0
12235;65434;2308;0;0;0;0;.00nan;0;0
12235;66477;2319;0;0;0;0;.00nan;0;0
12235;73187;2319;100;58;1;57;.983;3600000;0
12235;156254;2308;39;19;3;16;.842;3548000;0
12236;54273;619;0;0;0;0;.00nan;0;0
12236;66477;2319;0;0;0;0;.00nan;0;0
12236;73187;2319;60;34;4;30;.882;3600000;0
12236;78262;619;45;33;5;28;.848;3554000;0
12237;161763;617;0;0;0;0;.00nan;0;0
12237;16742;617;98;35;1;34;.971;3542000;0
12237;34959;620;0;0;0;0;.00nan;0;0
12237;86875;620;99;29;0;29;1.000;3600000;0
12238;17596;614;55;25;4;21;.840;3533000;0
12238;33044;622;86;32;2;30;.938;3600000;0
12238;45323;622;0;0;0;0;.00nan;0;0
12238;95056;614;0;0;0;0;.00nan;0;0
12239;584;3923;32;15;4;11;.733;3577000;0
12239;45193;3923;0;0;0;0;.00nan;0;0
12239;63529;2167;96;43;2;41;.953;3600000;0
12239;67724;2167;0;0;0;0;.00nan;0;0
12240;10141;1901;46;5;1;4;.800;1435000;0
12240;32712;611;0;0;0;0;.00nan;0;0
12240;73699;1901;29;27;6;21;.778;2165000;0
12240;156322;611;72;23;1;22;.957;3600000;0
12241;26336;612;51;28;3;25;.893;4200000;0
12241;65434;2308;72;35;3;32;.914;4200000;0
12241;65672;612;0;0;0;0;.00nan;0;0
12241;156254;2308;0;0;0;0;.00nan;0;0
12242;584;3923;69;37;4;33;.892;3600000;0
12242;34959;620;0;0;0;0;.00nan;0;0
12242;45193;3923;0;0;0;0;.00nan;0;0
12242;86875;620;97;37;1;36;.973;3600000;0
12243;26336;612;91;48;2;46;.958;3568000;0
12243;54273;619;63;16;1;15;.938;3600000;0
12243;65672;612;0;0;0;0;.00nan;0;0
12243;78262;619;0;0;0;0;.00nan;0;0
12244;32712;611;0;0;0;0;.00nan;0;0
12244;33044;622;62;26;4;22;.846;3600000;0
12244;45323;622;0;0;0;0;.00nan;0;0
12244;156322;611;43;42;7;35;.833;3600000;0
12245;63529;2167;59;30;4;26;.867;3600000;0
12245;66477;2319;0;0;0;0;.00nan;0;0
12245;67724;2167;0;0;0;0;.00nan;0;0
12245;73187;2319;58;16;1;15;.938;3600000;0
12246;10141;1901;63;37;4;33;.892;2209000;0
12246;65434;2308;58;12;1;11;.917;3600000;0
12246;73699;1901;26;27;6;21;.778;1391000;0
12246;156254;2308;0;0;0;0;.00nan;0;0
12247;161763;617;0;0;0;0;.00nan;0;0
12247;16742;617;74;37;4;33;.892;3979000;0
12247;17596;614;49;27;5;22;.815;3979000;0
12247;95056;614;0;0;0;0;.00nan;0;0
12248;161763;617;39;1;1;0;.000;363000;0
12248;16742;617;50;51;7;44;.863;3237000;0
12248;33044;622;81;14;0;14;1.000;3600000;0
12248;45323;622;0;0;0;0;.00nan;0;0
12249;34959;620;0;0;0;0;.00nan;0;0
12249;66477;2319;40;21;4;17;.810;3554000;0
12249;73187;2319;0;0;0;0;.00nan;0;0
12249;86875;620;79;31;2;29;.935;3600000;0
12250;33044;622;94;45;3;42;.933;3600000;0
12250;45323;622;0;0;0;0;.00nan;0;0
12250;65434;2308;36;18;4;14;.778;3600000;0
12250;156254;2308;0;0;0;0;.00nan;0;0
12251;584;3923;27;32;6;26;.813;2811000;0
12251;161763;617;0;0;0;0;.00nan;0;0
12251;16742;617;72;25;2;23;.920;3600000;0
12251;45193;3923;49;13;2;11;.846;789000;0
12252;10141;1901;35;37;7;30;.811;2805000;0
12252;54273;619;0;0;0;0;.00nan;0;0
12252;73699;1901;52;18;2;16;.889;795000;0
12252;78262;619;41;21;4;17;.810;3600000;0
12253;26336;612;60;14;1;13;.929;3600000;0
12253;63529;2167;61;41;5;36;.878;3600000;0
12253;65672;612;0;0;0;0;.00nan;0;0
12253;67724;2167;0;0;0;0;.00nan;0;0
12254;17596;614;100;22;0;22;1.000;3600000;0
12254;32712;611;0;0;0;0;.00nan;0;0
12254;95056;614;0;0;0;0;.00nan;0;0
12254;156322;611;34;41;7;34;.829;3600000;0
12255;26336;612;72;27;2;25;.926;3600000;0
12255;34959;620;0;0;0;0;.00nan;0;0
12255;65672;612;0;0;0;0;.00nan;0;0
12255;86875;620;78;47;4;43;.915;3547000;0
12256;33044;622;72;27;2;25;.926;3600000;0
12256;45323;622;0;0;0;0;.00nan;0;0
12256;54273;619;0;0;0;0;.00nan;0;0
12256;78262;619;44;24;4;20;.833;3578000;0
12257;584;3923;35;33;6;27;.818;2834000;0
12257;45193;3923;64;10;0;10;1.000;751000;0
12257;66477;2319;0;0;0;0;.00nan;0;0
12257;73187;2319;28;13;4;9;.692;3600000;0
12258;10141;1901;78;22;1;21;.955;3600000;0
12258;63529;2167;80;35;3;32;.914;3568000;0
12258;67724;2167;0;0;0;0;.00nan;0;0
12258;73699;1901;0;0;0;0;.00nan;0;0
12259;17596;614;50;34;5;29;.853;3600000;0
12259;65434;2308;85;32;2;30;.938;3600000;0
12259;95056;614;0;0;0;0;.00nan;0;0
12259;156254;2308;0;0;0;0;.00nan;0;0
12260;161763;617;81;33;1;32;.970;4200000;0
12260;16742;617;0;0;0;0;.00nan;0;0
12260;32712;611;77;26;1;25;.962;4200000;0
12260;156322;611;0;0;0;0;.00nan;0;0
12261;161763;617;0;0;0;0;.00nan;0;0
12261;16742;617;71;36;3;33;.917;3550000;0
12261;66477;2319;0;0;0;0;.00nan;0;0
12261;73187;2319;72;29;2;27;.931;3600000;0
12262;33044;622;72;7;0;7;1.000;3600000;0
12262;45323;622;0;0;0;0;.00nan;0;0
12262;63529;2167;89;47;2;45;.957;3600000;0
12262;67724;2167;0;0;0;0;.00nan;0;0
12263;32712;611;0;0;0;0;.00nan;0;0
12263;65434;2308;4;21;7;14;.667;3600000;0
12263;156254;2308;0;0;0;0;.00nan;0;0
12263;156322;611;92;51;3;48;.941;3600000;0
12264;10141;1901;0;0;0;0;.00nan;0;0
12264;34959;620;0;0;0;0;.00nan;0;0
12264;73699;1901;80;40;3;37;.925;3600000;0
12264;86875;620;39;34;6;28;.824;3600000;0
12265;584;3923;91;37;2;35;.946;3600000;0
12265;26336;612;73;29;3;26;.897;3582000;0
12265;45193;3923;0;0;0;0;.00nan;0;0
12265;65672;612;0;0;0;0;.00nan;0;0
12266;17596;614;53;34;5;29;.853;3562000;0
12266;54273;619;0;0;0;0;.00nan;0;0
12266;78262;619;41;20;4;16;.800;3600000;0
12266;95056;614;0;0;0;0;.00nan;0;0
12267;33044;622;60;25;3;22;.880;3600000;0
12267;34959;620;0;0;0;0;.00nan;0;0
12267;45323;622;0;0;0;0;.00nan;0;0
12267;86875;620;65;39;4;35;.897;3575000;0
12268;32712;611;60;39;4;35;.897;3600000;0
12268;54273;619;70;18;1;17;.944;3600000;0
12268;78262;619;0;0;0;0;.00nan;0;0
12268;156322;611;0;0;0;0;.00nan;0;0
12269;584;3923;0;0;0;0;.00nan;0;0
12269;10141;1901;58;31;3;28;.903;3600000;0
12269;45193;3923;40;22;4;18;.818;3583000;0
12269;73699;1901;0;0;0;0;.00nan;0;0
12270;17596;614;62;10;1;9;.900;3600000;0
12270;63529;2167;53;4;0;4;1.000;401000;0
12270;67724;2167;48;36;5;31;.861;3199000;0
12270;95056;614;0;0;0;0;.00nan;0;0
12271;161763;617;0;0;0;0;.00nan;0;0
12271;16742;617;99;45;1;44;.978;3600000;0
12271;65434;2308;44;22;4;18;.818;3600000;0
12271;156254;2308;0;0;0;0;.00nan;0;0
12272;584;3923;62;44;6;38;.864;3600000;0
12272;33044;622;79;10;0;10;1.000;3600000;0
12272;45193;3923;0;0;0;0;.00nan;0;0
12272;45323;622;0;0;0;0;.00nan;0;0
12273;32712;611;0;0;0;0;.00nan;0;0
12273;63529;2167;50;36;5;31;.861;3600000;0
12273;67724;2167;0;0;0;0;.00nan;0;0
12273;156322;611;98;23;0;23;1.000;3600000;0
12274;10141;1901;0;0;0;0;.00nan;0;0
12274;66477;2319;0;0;0;0;.00nan;0;0
12274;73187;2319;58;10;1;9;.900;3600000;0
12274;73699;1901;90;45;3;42;.933;3567000;0
12275;161763;617;40;25;4;21;.840;3153000;0
12275;16742;617;27;8;3;5;.625;447000;0
12275;26336;612;0;0;0;0;.00nan;0;0
12275;65672;612;67;21;1;20;.952;3600000;0
12276;17596;614;0;0;0;0;.00nan;0;0
12276;34959;620;0;0;0;0;.00nan;0;0
12276;86875;620;99;59;3;56;.949;3726000;0
12276;95056;614;33;17;4;13;.765;3726000;0
12277;54273;619;77;28;2;26;.929;3600000;0
12277;65434;2308;0;0;0;0;.00nan;0;0
12277;78262;619;0;0;0;0;.00nan;0;0
12277;156254;2308;45;29;4;25;.862;3529000;0
12278;33044;622;56;38;5;33;.868;3600000;0
12278;45323;622;0;0;0;0;.00nan;0;0
12278;66477;2319;0;0;0;0;.00nan;0;0
12278;73187;2319;75;29;2;27;.931;3600000;0
12279;32712;611;0;0;0;0;.00nan;0;0
12279;34959;620;0;0;0;0;.00nan;0;0
12279;86875;620;66;33;4;29;.879;3819000;0
12279;156322;611;55;23;3;20;.870;3819000;0
12280;584;3923;76;47;4;43;.915;3600000;0
12280;17596;614;92;17;0;17;1.000;3600000;0
12280;45193;3923;0;0;0;0;.00nan;0;0
12280;95056;614;0;0;0;0;.00nan;0;0
12281;63529;2167;61;54;6;48;.889;3269000;0
12281;65434;2308;50;15;2;13;.867;3600000;0
12281;67724;2167;54;5;0;5;1.000;331000;0
12281;156254;2308;0;0;0;0;.00nan;0;0
12282;10141;1901;51;12;2;10;.833;955000;0
12282;26336;612;58;18;2;16;.889;3600000;0
12282;65672;612;0;0;0;0;.00nan;0;0
12282;73699;1901;37;38;7;31;.816;2645000;0
12283;161763;617;0;0;0;0;.00nan;0;0
12283;16742;617;91;53;3;50;.943;3600000;0
12283;54273;619;0;0;0;0;.00nan;0;0
12283;78262;619;39;22;4;18;.818;3532000;0
12284;54273;619;83;17;0;17;1.000;3600000;0
12284;63529;2167;64;37;5;32;.865;3600000;0
12284;67724;2167;0;0;0;0;.00nan;0;0
12284;78262;619;0;0;0;0;.00nan;0;0
12285;26336;612;30;47;8;39;.830;3600000;0
12285;33044;622;60;34;4;30;.882;3600000;0
12285;45323;622;0;0;0;0;.00nan;0;0
12285;65672;612;0;0;0;0;.00nan;0;0
12286;584;3923;76;47;4;43;.915;3600000;0
12286;32712;611;82;16;0;16;1.000;3600000;0
12286;45193;3923;0;0;0;0;.00nan;0;0
12286;156322;611;0;0;0;0;.00nan;0;0
12287;17596;614;52;20;3;17;.850;3577000;0
12287;66477;2319;0;0;0;0;.00nan;0;0
12287;73187;2319;76;30;2;28;.933;3600000;0
12287;95056;614;0;0;0;0;.00nan;0;0
12288;34959;620;0;0;0;0;.00nan;0;0
12288;65434;2308;0;0;0;0;.00nan;0;0
12288;86875;620;88;52;5;47;.904;3600000;0
12288;156254;2308;64;19;1;18;.947;3600000;0
12289;32712;611;96;24;0;24;1.000;3600000;0
12289;66477;2319;0;0;0;0;.00nan;0;0
12289;73187;2319;53;24;3;21;.875;3600000;0
12289;156322;611;0;0;0;0;.00nan;0;0
12290;34959;620;0;0;0;0;.00nan;0;0
12290;54273;619;64;19;1;18;.947;3600000;0
12290;78262;619;0;0;0;0;.00nan;0;0
12290;86875;620;77;46;5;41;.891;3600000;0
12291;584;3923;48;52;7;45;.865;3600000;0
12291;45193;3923;0;0;0;0;.00nan;0;0
12291;65434;2308;60;13;1;12;.923;3600000;0
12291;156254;2308;0;0;0;0;.00nan;0;0
12292;10141;1901;63;56;6;50;.893;3342000;0
12292;33044;622;45;23;4;19;.826;3600000;0
12292;45323;622;0;0;0;0;.00nan;0;0
12292;73699;1901;49;2;0;2;1.000;258000;0
12293;17596;614;87;25;1;24;.960;3600000;0
12293;26336;612;65;25;2;23;.920;3553000;0
12293;65672;612;0;0;0;0;.00nan;0;0
12293;95056;614;0;0;0;0;.00nan;0;0
12294;161763;617;0;0;0;0;.00nan;0;0
12294;16742;617;55;26;3;23;.885;3697000;0
12294;63529;2167;79;40;4;36;.900;3697000;0
12294;67724;2167;0;0;0;0;.00nan;0;0
12295;34959;620;0;0;0;0;.00nan;0;0
12295;54273;619;0;0;0;0;.00nan;0;0
12295;78262;619;96;26;0;26;1.000;3600000;0
12295;86875;620;97;62;5;57;.919;3600000;0
12296;10141;1901;0;0;0;0;.00nan;0;0
12296;33044;622;32;16;4;12;.750;3593000;0
12296;45323;622;0;0;0;0;.00nan;0;0
12296;73699;1901;99;58;3;55;.948;3600000;0
12297;32712;611;0;0;0;0;.00nan;0;0
12297;66477;2319;0;0;0;0;.00nan;0;0
12297;73187;2319;57;33;4;29;.879;3551000;0
12297;156322;611;65;27;3;24;.889;3600000;0
12298;17596;614;57;22;2;20;.909;3600000;0
12298;26336;612;53;35;4;31;.886;3545000;0
12298;65672;612;0;0;0;0;.00nan;0;0
12298;95056;614;0;0;0;0;.00nan;0;0
12299;584;3923;84;51;5;46;.902;3600000;0
12299;45193;3923;0;0;0;0;.00nan;0;0
12299;65434;2308;63;19;1;18;.947;3600000;0
12299;156254;2308;0;0;0;0;.00nan;0;0
12300;17596;614;70;25;2;23;.920;3600000;0
12300;66477;2319;0;0;0;0;.00nan;0;0
12300;73187;2319;46;19;4;15;.789;3600000;0
12300;95056;614;0;0;0;0;.00nan;0;0
12301;34959;620;0;0;0;0;.00nan;0;0
12301;65434;2308;62;15;1;14;.933;3600000;0
12301;86875;620;66;44;4;40;.909;3600000;0
12301;156254;2308;0;0;0;0;.00nan;0;0
12302;584;3923;51;37;5;32;.865;3600000;0
12302;32712;611;0;0;0;0;.00nan;0;0
12302;45193;3923;0;0;0;0;.00nan;0;0
12302;156322;611;77;22;1;21;.955;3600000;0
12303;54273;619;0;0;0;0;.00nan;0;0
12303;63529;2167;78;34;2;32;.941;3594000;0
12303;67724;2167;0;0;0;0;.00nan;0;0
12303;78262;619;85;26;1;25;.962;3600000;0
12304;26336;612;0;0;0;0;.00nan;0;0
12304;33044;622;70;30;3;27;.900;3600000;0
12304;45323;622;0;0;0;0;.00nan;0;0
12304;65672;612;38;26;5;21;.808;3589000;0
12305;161763;617;0;0;0;0;.00nan;0;0
12305;10141;1901;0;0;0;0;.00nan;0;0
12305;16742;617;47;31;4;27;.871;3582000;0
12305;73699;1901;78;32;2;30;.938;3600000;0
12306;161763;617;0;0;0;0;.00nan;0;0
12306;10141;1901;66;47;6;41;.872;3600000;0
12306;16742;617;71;29;2;27;.931;3600000;0
12306;73699;1901;0;0;0;0;.00nan;0;0
12307;161763;617;0;0;0;0;.00nan;0;0
12307;16742;617;47;32;5;27;.844;3600000;0
12307;54273;619;72;22;1;21;.955;3600000;0
12307;78262;619;0;0;0;0;.00nan;0;0
12308;33044;622;63;28;4;24;.857;3653000;0
12308;45323;622;0;0;0;0;.00nan;0;0
12308;66477;2319;0;0;0;0;.00nan;0;0
12308;73187;2319;67;28;3;25;.893;3653000;0
12309;32712;611;88;40;3;37;.925;3600000;0
12309;34959;620;0;0;0;0;.00nan;0;0
12309;86875;620;100;36;0;36;1.000;3600000;0
12309;156322;611;0;0;0;0;.00nan;0;0
12310;10141;1901;0;0;0;0;.00nan;0;0
12310;26336;612;66;32;4;28;.875;3554000;0
12310;65672;612;0;0;0;0;.00nan;0;0
12310;73699;1901;74;36;3;33;.917;3600000;0
12311;584;3923;95;46;2;44;.957;3551000;0
12311;17596;614;75;19;1;18;.947;3600000;0
12311;45193;3923;0;0;0;0;.00nan;0;0
12311;95056;614;0;0;0;0;.00nan;0;0
12312;63529;2167;58;38;4;34;.895;3548000;0
12312;65434;2308;49;12;2;10;.833;3600000;0
12312;67724;2167;0;0;0;0;.00nan;0;0
12312;156254;2308;0;0;0;0;.00nan;0;0
12313;10141;1901;0;0;0;0;.00nan;0;0
12313;66477;2319;0;0;0;0;.00nan;0;0
12313;73187;2319;74;17;1;16;.941;3600000;0
12313;73699;1901;88;50;4;46;.920;3600000;0
12314;54273;619;0;0;0;0;.00nan;0;0
12314;65434;2308;71;44;4;40;.909;3663000;0
12314;78262;619;74;31;3;28;.903;3663000;0
12314;156254;2308;0;0;0;0;.00nan;0;0
12315;584;3923;59;45;5;40;.889;3520000;0
12315;33044;622;56;27;3;24;.889;3600000;0
12315;45193;3923;0;0;0;0;.00nan;0;0
12315;45323;622;0;0;0;0;.00nan;0;0
12316;32712;611;58;26;3;23;.885;4200000;0
12316;63529;2167;90;47;3;44;.936;4200000;0
12316;67724;2167;0;0;0;0;.00nan;0;0
12316;156322;611;0;0;0;0;.00nan;0;0
12317;161763;617;0;0;0;0;.00nan;0;0
12317;16742;617;91;38;2;36;.947;3859000;0
12317;26336;612;48;20;3;17;.850;3859000;0
12317;65672;612;0;0;0;0;.00nan;0;0
12318;33044;622;72;18;1;17;.944;4200000;0
12318;34959;620;0;0;0;0;.00nan;0;0
12318;45323;622;0;0;0;0;.00nan;0;0
12318;86875;620;100;62;1;61;.984;4200000;0
12319;32712;611;0;0;0;0;.00nan;0;0
12319;54273;619;0;0;0;0;.00nan;0;0
12319;78262;619;53;17;2;15;.882;3600000;0
12319;156322;611;78;41;3;38;.927;3576000;0
12320;584;3923;59;34;4;30;.882;3758000;0
12320;10141;1901;65;32;3;29;.906;3758000;0
12320;45193;3923;0;0;0;0;.00nan;0;0
12320;73699;1901;0;0;0;0;.00nan;0;0
12321;26336;612;100;24;0;24;1.000;3600000;0
12321;65672;612;0;0;0;0;.00nan;0;0
12321;66477;2319;67;6;0;6;1.000;1537000;0
12321;73187;2319;31;18;5;13;.722;2063000;0
12322;17596;614;78;12;0;12;1.000;3600000;0
12322;63529;2167;96;67;6;61;.910;3600000;0
12322;67724;2167;0;0;0;0;.00nan;0;0
12322;95056;614;0;0;0;0;.00nan;0;0
12323;161763;617;0;0;0;0;.00nan;0;0
12323;16742;617;89;59;6;53;.898;4200000;0
12323;65434;2308;0;0;0;0;.00nan;0;0
12323;156254;2308;26;34;6;28;.824;4200000;0
12324;10141;1901;0;0;0;0;.00nan;0;0
12324;34959;620;0;0;0;0;.00nan;0;0
12324;73699;1901;45;27;5;22;.815;3553000;0
12324;86875;620;89;38;3;35;.921;3600000;0
12325;17596;614;45;32;6;26;.813;3121000;0
12325;54273;619;76;28;2;26;.929;3600000;0
12325;78262;619;0;0;0;0;.00nan;0;0
12325;95056;614;44;4;1;3;.750;479000;0
12326;33044;622;65;20;2;18;.900;3600000;0
12326;45323;622;0;0;0;0;.00nan;0;0
12326;63529;2167;100;49;1;48;.980;3600000;0
12326;67724;2167;0;0;0;0;.00nan;0;0
12327;32712;611;44;42;6;36;.857;2484000;0
12327;65434;2308;59;25;3;22;.880;3600000;0
12327;156254;2308;0;0;0;0;.00nan;0;0
12327;156322;611;39;15;3;12;.800;1116000;0
12328;161763;617;65;28;3;25;.893;3553000;0
12328;16742;617;0;0;0;0;.00nan;0;0
12328;66477;2319;0;0;0;0;.00nan;0;0
12328;73187;2319;81;26;1;25;.962;3600000;0
12329;17596;614;75;30;1;29;.967;4200000;0
12329;34959;620;0;0;0;0;.00nan;0;0
12329;86875;620;100;33;1;32;.970;4200000;0
12329;95056;614;0;0;0;0;.00nan;0;0
12330;584;3923;60;36;5;31;.861;3707000;0
12330;45193;3923;0;0;0;0;.00nan;0;0
12330;66477;2319;36;7;3;4;.571;376000;0
12330;73187;2319;50;9;1;8;.889;3331000;0
12331;33044;622;83;33;1;32;.970;3600000;0
12331;45323;622;0;0;0;0;.00nan;0;0
12331;54273;619;0;0;0;0;.00nan;0;0
12331;78262;619;97;38;2;36;.947;3553000;0
12332;161763;617;0;0;0;0;.00nan;0;0
12332;16742;617;51;30;4;26;.867;3513000;0
12332;32712;611;0;0;0;0;.00nan;0;0
12332;156322;611;67;25;2;23;.920;3600000;0
12333;10141;1901;0;0;0;0;.00nan;0;0
12333;63529;2167;58;32;3;29;.906;3600000;0
12333;67724;2167;0;0;0;0;.00nan;0;0
12333;73699;1901;67;23;2;21;.913;3600000;0
12334;26336;612;45;17;3;14;.824;3571000;0
12334;34959;620;0;0;0;0;.00nan;0;0
12334;65672;612;0;0;0;0;.00nan;0;0
12334;86875;620;99;53;2;51;.962;3600000;0
12335;17596;614;42;21;4;17;.810;3600000;0
12335;65434;2308;54;39;5;34;.872;3600000;0
12335;95056;614;0;0;0;0;.00nan;0;0
12335;156254;2308;0;0;0;0;.00nan;0;0
12336;34959;620;0;0;0;0;.00nan;0;0
12336;66477;2319;0;0;0;0;.00nan;0;0
12336;73187;2319;61;21;2;19;.905;3600000;0
12336;86875;620;94;50;4;46;.920;3600000;0
12337;10141;1901;64;9;0;9;1.000;594000;0
12337;54273;619;0;0;0;0;.00nan;0;0
12337;73699;1901;1;35;9;26;.743;3006000;0
12337;78262;619;46;16;3;13;.813;3600000;0
12338;17596;614;75;29;3;26;.897;3600000;0
12338;32712;611;41;33;5;28;.848;3582000;0
12338;95056;614;0;0;0;0;.00nan;0;0
12338;156322;611;0;0;0;0;.00nan;0;0
12339;26336;612;66;31;3;28;.903;3600000;0
12339;63529;2167;49;28;4;24;.857;3600000;0
12339;65672;612;0;0;0;0;.00nan;0;0
12339;67724;2167;0;0;0;0;.00nan;0;0
12340;33044;622;52;35;5;30;.857;3585000;0
12340;45323;622;0;0;0;0;.00nan;0;0
12340;65434;2308;60;36;4;32;.889;3600000;0
12340;156254;2308;0;0;0;0;.00nan;0;0
12341;584;3923;63;22;2;20;.909;3600000;0
12341;161763;617;54;4;0;4;1.000;241000;0
12341;16742;617;32;31;6;25;.806;3359000;0
12341;45193;3923;0;0;0;0;.00nan;0;0
12342;63529;2167;97;47;2;45;.957;3573000;0
12342;66477;2319;0;0;0;0;.00nan;0;0
12342;67724;2167;0;0;0;0;.00nan;0;0
12342;73187;2319;62;16;1;15;.938;3600000;0
12343;32712;611;69;29;3;26;.897;2664000;0
12343;33044;622;77;29;2;27;.931;3600000;0
12343;45323;622;0;0;0;0;.00nan;0;0
12343;156322;611;33;20;4;16;.800;936000;0
12344;584;3923;0;0;0;0;.00nan;0;0
12344;34959;620;0;0;0;0;.00nan;0;0
12344;45193;3923;85;38;3;35;.921;4200000;0
12344;86875;620;66;37;3;34;.919;4200000;0
12345;10141;1901;55;51;7;44;.863;3600000;0
12345;65434;2308;75;11;0;11;1.000;3600000;0
12345;73699;1901;0;0;0;0;.00nan;0;0
12345;156254;2308;0;0;0;0;.00nan;0;0
12346;26336;612;0;0;0;0;.00nan;0;0
12346;54273;619;0;0;0;0;.00nan;0;0
12346;65672;612;70;31;3;28;.903;3600000;0
12346;78262;619;50;31;5;26;.839;3600000;0
12347;161763;617;0;0;0;0;.00nan;0;0
12347;16742;617;56;31;4;27;.871;3566000;0
12347;17596;614;0;0;0;0;.00nan;0;0
12347;95056;614;75;31;2;29;.935;3600000;0
12348;54273;619;38;21;4;17;.810;3600000;0
12348;66477;2319;0;0;0;0;.00nan;0;0
12348;73187;2319;78;27;1;26;.963;3600000;0
12348;78262;619;0;0;0;0;.00nan;0;0
12349;10141;1901;0;0;0;0;.00nan;0;0
12349;32712;611;0;0;0;0;.00nan;0;0
12349;73699;1901;80;46;4;42;.913;4015000;0
12349;156322;611;40;17;3;14;.824;4015000;0
12350;584;3923;80;32;2;30;.938;3600000;0
12350;45193;3923;0;0;0;0;.00nan;0;0
12350;63529;2167;55;36;4;32;.889;3600000;0
12350;67724;2167;0;0;0;0;.00nan;0;0
12351;17596;614;58;23;4;19;.826;2144000;0
12351;33044;622;72;27;2;25;.926;3600000;0
12351;45323;622;0;0;0;0;.00nan;0;0
12351;95056;614;50;10;1;9;.900;1456000;0
12352;26336;612;48;26;4;22;.846;3537000;0
12352;65434;2308;67;31;3;28;.903;3600000;0
12352;65672;612;0;0;0;0;.00nan;0;0
12352;156254;2308;0;0;0;0;.00nan;0;0
12353;161763;617;0;0;0;0;.00nan;0;0
12353;16742;617;88;26;1;25;.962;3600000;0
12353;34959;620;0;0;0;0;.00nan;0;0
12353;86875;620;100;29;0;29;1.000;3600000;0
12354;65434;2308;78;30;2;28;.933;3600000;0
12354;66477;2319;0;0;0;0;.00nan;0;0
12354;73187;2319;68;34;4;30;.882;3557000;0
12354;156254;2308;0;0;0;0;.00nan;0;0
12355;34959;620;97;33;1;32;.970;3600000;0
12355;63529;2167;37;26;5;21;.808;3600000;0
12355;67724;2167;0;0;0;0;.00nan;0;0
12355;86875;620;0;0;0;0;.00nan;0;0
12356;161763;617;0;0;0;0;.00nan;0;0
12356;16742;617;72;36;3;33;.917;3583000;0
12356;33044;622;0;0;0;0;.00nan;0;0
12356;45323;622;62;24;2;22;.917;3600000;0
12357;584;3923;9;19;6;13;.684;2079000;0
12357;45193;3923;63;22;2;20;.909;1521000;0
12357;54273;619;0;0;0;0;.00nan;0;0
12357;78262;619;71;28;3;25;.893;3600000;0
12358;10141;1901;71;48;6;42;.875;3131000;0
12358;17596;614;56;17;2;15;.882;3600000;0
12358;73699;1901;58;6;0;6;1.000;469000;0
12358;95056;614;0;0;0;0;.00nan;0;0
12359;26336;612;72;20;1;19;.950;3600000;0
12359;32712;611;85;44;3;41;.932;3600000;0
12359;65672;612;0;0;0;0;.00nan;0;0
12359;156322;611;0;0;0;0;.00nan;0;0
12360;17596;614;65;30;4;26;.867;3623000;0
12360;66477;2319;0;0;0;0;.00nan;0;0
12360;73187;2319;76;33;3;30;.909;3623000;0
12360;95056;614;0;0;0;0;.00nan;0;0
12361;34959;620;0;0;0;0;.00nan;0;0
12361;63529;2167;73;26;1;25;.962;3600000;0
12361;67724;2167;0;0;0;0;.00nan;0;0
12361;86875;620;86;35;2;33;.943;3550000;0
12362;33044;622;48;47;7;40;.851;3600000;0
12362;45323;622;0;0;0;0;.00nan;0;0
12362;54273;619;85;27;1;26;.963;3600000;0
12362;78262;619;0;0;0;0;.00nan;0;0
12363;584;3923;62;29;3;26;.897;3518000;0
12363;32712;611;0;0;0;0;.00nan;0;0
12363;45193;3923;0;0;0;0;.00nan;0;0
12363;156322;611;97;41;1;40;.976;3600000;0
12364;10141;1901;0;0;0;0;.00nan;0;0
12364;65434;2308;0;0;0;0;.00nan;0;0
12364;73699;1901;70;49;6;43;.878;3600000;0
12364;156254;2308;50;14;2;12;.857;3600000;0
12365;161763;617;66;38;3;35;.921;3600000;0
12365;16742;617;0;0;0;0;.00nan;0;0
12365;26336;612;93;22;0;22;1.000;3600000;0
12365;65672;612;0;0;0;0;.00nan;0;0
12366;33044;622;99;43;2;41;.953;3619000;0
12366;45323;622;0;0;0;0;.00nan;0;0
12366;66477;2319;0;0;0;0;.00nan;0;0
12366;73187;2319;73;31;3;28;.903;3619000;0
12367;584;3923;43;29;5;24;.828;3600000;0
12367;34959;620;0;0;0;0;.00nan;0;0
12367;45193;3923;0;0;0;0;.00nan;0;0
12367;86875;620;86;31;1;30;.968;3600000;0
12368;161763;617;0;0;0;0;.00nan;0;0
12368;16742;617;100;50;2;48;.960;4200000;0
12368;63529;2167;65;30;2;28;.933;4200000;0
12368;67724;2167;0;0;0;0;.00nan;0;0
12369;10141;1901;70;34;3;31;.912;3002000;0
12369;54273;619;0;0;0;0;.00nan;0;0
12369;73699;1901;34;13;3;10;.769;598000;0
12369;78262;619;61;14;1;13;.929;3600000;0
12370;26336;612;80;33;2;31;.939;3998000;0
12370;65434;2308;60;29;3;26;.897;3998000;0
12370;65672;612;0;0;0;0;.00nan;0;0
12370;156254;2308;0;0;0;0;.00nan;0;0
12371;17596;614;88;18;0;18;1.000;3600000;0
12371;32712;611;80;54;4;50;.926;3600000;0
12371;95056;614;0;0;0;0;.00nan;0;0
12371;156322;611;0;0;0;0;.00nan;0;0
12372;10141;1901;0;0;0;0;.00nan;0;0
12372;66477;2319;87;16;0;16;1.000;3600000;0
12372;73187;2319;0;0;0;0;.00nan;0;0
12372;73699;1901;52;30;4;26;.867;3600000;0
12373;26336;612;64;40;4;36;.900;3582000;0
12373;54273;619;63;25;2;23;.920;3600000;0
12373;65672;612;0;0;0;0;.00nan;0;0
12373;78262;619;0;0;0;0;.00nan;0;0
12374;32712;611;0;0;0;0;.00nan;0;0
12374;34959;620;0;0;0;0;.00nan;0;0
12374;86875;620;72;41;4;37;.902;3600000;0
12374;156322;611;82;26;1;25;.962;3600000;0
12375;17596;614;68;28;2;26;.929;3549000;0
12375;33044;622;88;27;1;26;.963;3600000;0
12375;45323;622;0;0;0;0;.00nan;0;0
12375;95056;614;0;0;0;0;.00nan;0;0
12376;63529;2167;57;40;5;35;.875;3600000;0
12376;65434;2308;61;14;1;13;.929;3600000;0
12376;67724;2167;0;0;0;0;.00nan;0;0
12376;156254;2308;0;0;0;0;.00nan;0;0
12377;584;3923;25;12;4;8;.667;1017000;0
12377;161763;617;0;0;0;0;.00nan;0;0
12377;16742;617;70;25;2;23;.920;3600000;0
12377;45193;3923;44;30;5;25;.833;2583000;0
12378;161763;617;0;0;0;0;.00nan;0;0
12378;16742;617;89;42;2;40;.952;4200000;0
12378;34959;620;0;0;0;0;.00nan;0;0
12378;86875;620;74;32;2;30;.938;4200000;0
12379;32712;611;81;31;2;29;.935;3655000;0
12379;33044;622;78;22;1;21;.955;3655000;0
12379;45323;622;0;0;0;0;.00nan;0;0
12379;156322;611;0;0;0;0;.00nan;0;0
12380;584;3923;56;41;5;36;.878;3600000;0
12380;45193;3923;0;0;0;0;.00nan;0;0
12380;65434;2308;33;11;3;8;.727;3600000;0
12380;156254;2308;0;0;0;0;.00nan;0;0
12381;54273;619;27;12;4;8;.667;3515000;0
12381;63529;2167;100;36;2;34;.944;3600000;0
12381;67724;2167;0;0;0;0;.00nan;0;0
12381;78262;619;0;0;0;0;.00nan;0;0
12382;10141;1901;75;31;2;29;.935;3600000;0
12382;17596;614;38;26;5;21;.808;3600000;0
12382;73699;1901;0;0;0;0;.00nan;0;0
12382;95056;614;0;0;0;0;.00nan;0;0
12383;26336;612;0;0;0;0;.00nan;0;0
12383;65672;612;81;23;1;22;.957;3600000;0
12383;66477;2319;57;45;6;39;.867;3600000;0
12383;73187;2319;0;0;0;0;.00nan;0;0
12384;63529;2167;91;51;2;49;.961;4200000;0
12384;66477;2319;0;0;0;0;.00nan;0;0
12384;67724;2167;0;0;0;0;.00nan;0;0
12384;73187;2319;71;21;2;19;.905;4200000;0
12385;584;3923;80;51;4;47;.922;3552000;0
12385;45193;3923;0;0;0;0;.00nan;0;0
12385;54273;619;0;0;0;0;.00nan;0;0
12385;78262;619;59;19;2;17;.895;3600000;0
12386;10141;1901;29;41;8;33;.805;2820000;0
12386;33044;622;75;12;0;12;1.000;3600000;0
12386;45323;622;0;0;0;0;.00nan;0;0
12386;73699;1901;25;14;4;10;.714;780000;0
12387;161763;617;0;0;0;0;.00nan;0;0
12387;16742;617;94;39;2;37;.949;3812000;0
12387;32712;611;0;0;0;0;.00nan;0;0
12387;156322;611;80;27;1;26;.963;3812000;0
12388;17596;614;100;33;0;33;1.000;3600000;0
12388;26336;612;72;28;1;27;.964;3600000;0
12388;65672;612;0;0;0;0;.00nan;0;0
12388;95056;614;0;0;0;0;.00nan;0;0
12389;34959;620;54;4;0;4;1.000;608000;0
12389;65434;2308;62;23;3;20;.870;3600000;0
12389;86875;620;50;44;6;38;.864;2992000;0
12389;156254;2308;0;0;0;0;.00nan;0;0
12390;34959;620;0;0;0;0;.00nan;0;0
12390;54273;619;0;0;0;0;.00nan;0;0
12390;78262;619;58;11;1;10;.909;3600000;0
12390;86875;620;71;48;6;42;.875;3600000;0
12391;584;3923;88;36;2;34;.944;3600000;0
12391;45193;3923;0;0;0;0;.00nan;0;0
12391;66477;2319;0;0;0;0;.00nan;0;0
12391;73187;2319;54;25;4;21;.840;3600000;0
12392;17596;614;61;17;2;15;.882;3600000;0
12392;63529;2167;70;35;4;31;.886;3541000;0
12392;67724;2167;0;0;0;0;.00nan;0;0
12392;95056;614;0;0;0;0;.00nan;0;0
12393;10141;1901;0;0;0;0;.00nan;0;0
12393;32712;611;0;0;0;0;.00nan;0;0
12393;73699;1901;97;46;2;44;.957;4200000;0
12393;156322;611;69;28;2;26;.929;4200000;0
12394;26336;612;60;26;4;22;.846;3600000;0
12394;33044;622;57;37;5;32;.865;3574000;0
12394;45323;622;0;0;0;0;.00nan;0;0
12394;65672;612;0;0;0;0;.00nan;0;0
12395;161763;617;51;30;4;26;.867;3600000;0
12395;16742;617;0;0;0;0;.00nan;0;0
12395;65434;2308;89;29;1;28;.966;3600000;0
12395;156254;2308;0;0;0;0;.00nan;0;0
12396;34959;620;0;0;0;0;.00nan;0;0
12396;66477;2319;0;0;0;0;.00nan;0;0
12396;73187;2319;60;23;3;20;.870;3600000;0
12396;86875;620;55;30;4;26;.867;3545000;0
12397;161763;617;25;13;4;9;.692;931000;0
12397;16742;617;42;36;6;30;.833;2669000;0
12397;54273;619;0;0;0;0;.00nan;0;0
12397;78262;619;78;10;0;10;1.000;3600000;0
12398;33044;622;75;22;1;21;.955;3600000;0
12398;45323;622;0;0;0;0;.00nan;0;0
12398;63529;2167;82;55;5;50;.909;3600000;0
12398;67724;2167;0;0;0;0;.00nan;0;0
12399;32712;611;92;56;3;53;.946;3842000;0
12399;65434;2308;67;25;2;23;.920;3842000;0
12399;156254;2308;0;0;0;0;.00nan;0;0
12399;156322;611;0;0;0;0;.00nan;0;0
12400;10141;1901;47;24;4;20;.833;1137000;0
12400;26336;612;46;10;2;8;.800;3600000;0
12400;65672;612;0;0;0;0;.00nan;0;0
12400;73699;1901;60;39;4;35;.897;2463000;0
12401;584;3923;24;28;6;22;.786;2035000;0
12401;17596;614;0;0;0;0;.00nan;0;0
12401;45193;3923;47;19;3;16;.842;1565000;0
12401;95056;614;52;15;2;13;.867;3600000;0
12402;17596;614;83;12;0;12;1.000;3600000;0
12402;34959;620;87;40;3;37;.925;3600000;0
12402;86875;620;0;0;0;0;.00nan;0;0
12402;95056;614;0;0;0;0;.00nan;0;0
12403;584;3923;74;13;0;13;1.000;1047000;0
12403;33044;622;58;25;3;22;.880;3600000;0
12403;45193;3923;33;33;6;27;.818;2553000;0
12403;45323;622;0;0;0;0;.00nan;0;0
12404;10141;1901;0;0;0;0;.00nan;0;0
12404;63529;2167;0;0;0;0;.00nan;0;0
12404;67724;2167;68;20;1;19;.950;3600000;0
12404;73699;1901;67;39;4;35;.897;3600000;0
12405;26336;612;52;21;4;17;.810;3542000;0
12405;32712;611;0;0;0;0;.00nan;0;0
12405;65672;612;0;0;0;0;.00nan;0;0
12405;156322;611;72;34;3;31;.912;3600000;0
12406;54273;619;51;7;1;6;.857;1357000;0
12406;65434;2308;39;34;6;28;.824;3600000;0
12406;78262;619;23;11;4;7;.636;2243000;0
12406;156254;2308;0;0;0;0;.00nan;0;0
12407;161763;617;0;0;0;0;.00nan;0;0
12407;16742;617;65;24;2;22;.917;3600000;0
12407;66477;2319;54;6;0;6;1.000;862000;0
12407;73187;2319;21;23;6;17;.739;2738000;0
12408;65434;2308;25;21;5;16;.762;2011000;0
12408;66477;2319;25;18;5;13;.722;3600000;0
12408;73187;2319;0;0;0;0;.00nan;0;0
12408;156254;2308;53;12;1;11;.917;1534000;0
12409;33044;622;83;13;0;13;1.000;3600000;0
12409;34959;620;0;0;0;0;.00nan;0;0
12409;45323;622;0;0;0;0;.00nan;0;0
12409;86875;620;59;48;7;41;.854;3600000;0
12410;32712;611;72;48;6;42;.875;3120000;0
12410;54273;619;0;0;0;0;.00nan;0;0
12410;78262;619;68;13;1;12;.923;3600000;0
12410;156322;611;49;8;1;7;.875;480000;0
12411;584;3923;71;28;3;25;.893;3568000;0
12411;10141;1901;0;0;0;0;.00nan;0;0
12411;45193;3923;0;0;0;0;.00nan;0;0
12411;73699;1901;78;22;1;21;.955;3600000;0
12412;26336;612;58;22;3;19;.864;3600000;0
12412;63529;2167;52;45;7;38;.844;3600000;0
12412;65672;612;0;0;0;0;.00nan;0;0
12412;67724;2167;0;0;0;0;.00nan;0;0
12413;161763;617;0;0;0;0;.00nan;0;0
12413;16742;617;86;39;3;36;.923;3572000;0
12413;17596;614;65;14;1;13;.929;3600000;0
12413;95056;614;0;0;0;0;.00nan;0;0
12414;10141;1901;0;0;0;0;.00nan;0;0
12414;34959;620;0;0;0;0;.00nan;0;0
12414;73699;1901;80;35;3;32;.914;3600000;0
12414;86875;620;50;32;4;28;.875;3551000;0
12415;54273;619;65;15;1;14;.933;3600000;0
12415;66477;2319;0;0;0;0;.00nan;0;0
12415;73187;2319;82;41;3;38;.927;3569000;0
12415;78262;619;0;0;0;0;.00nan;0;0
12416;584;3923;74;37;3;34;.919;3600000;0
12416;26336;612;38;19;4;15;.789;3596000;0
12416;45193;3923;0;0;0;0;.00nan;0;0
12416;65672;612;0;0;0;0;.00nan;0;0
12417;32712;611;0;0;0;0;.00nan;0;0
12417;63529;2167;70;36;3;33;.917;3576000;0
12417;67724;2167;0;0;0;0;.00nan;0;0
12417;156322;611;73;18;1;17;.944;3600000;0
12418;17596;614;27;6;3;3;.500;401000;0
12418;65434;2308;52;23;3;20;.870;3600000;0
12418;95056;614;43;26;4;22;.846;3199000;0
12418;156254;2308;0;0;0;0;.00nan;0;0
12419;161763;617;70;36;3;33;.917;3600000;0
12419;16742;617;0;0;0;0;.00nan;0;0
12419;33044;622;69;21;1;20;.952;3600000;0
12419;45323;622;0;0;0;0;.00nan;0;0
12420;33044;622;26;21;5;16;.762;3600000;0
12420;45323;622;0;0;0;0;.00nan;0;0
12420;65434;2308;60;30;3;27;.900;3600000;0
12420;156254;2308;0;0;0;0;.00nan;0;0
12421;32712;611;68;42;4;38;.905;4020000;0
12421;66477;2319;52;24;3;21;.875;4020000;0
12421;73187;2319;0;0;0;0;.00nan;0;0
12421;156322;611;0;0;0;0;.00nan;0;0
12422;584;3923;62;28;3;25;.893;3600000;0
12422;45193;3923;0;0;0;0;.00nan;0;0
12422;63529;2167;53;41;6;35;.854;3289000;0
12422;67724;2167;45;5;1;4;.800;311000;0
12423;161763;617;0;0;0;0;.00nan;0;0
12423;10141;1901;84;36;2;34;.944;3600000;0
12423;16742;617;60;27;3;24;.889;3557000;0
12423;73699;1901;0;0;0;0;.00nan;0;0
12424;26336;612;0;0;0;0;.00nan;0;0
12424;34959;620;0;0;0;0;.00nan;0;0
12424;65672;612;70;33;3;30;.909;3600000;0
12424;86875;620;56;40;5;35;.875;3556000;0
12425;17596;614;79;41;3;38;.927;3600000;0
12425;54273;619;0;0;0;0;.00nan;0;0
12425;78262;619;38;21;4;17;.810;3543000;0
12425;95056;614;0;0;0;0;.00nan;0;0
12426;26336;612;60;33;4;29;.879;3549000;0
12426;65672;612;0;0;0;0;.00nan;0;0
12426;66477;2319;0;0;0;0;.00nan;0;0
12426;73187;2319;73;28;3;25;.893;3600000;0
12427;33044;622;48;27;5;22;.815;3227000;0
12427;45323;622;53;4;0;4;1.000;296000;0
12427;66477;2319;0;0;0;0;.00nan;0;0
12427;73187;2319;74;37;3;34;.919;3600000;0
12428;584;3923;54;35;4;31;.886;3600000;0
12428;34959;620;0;0;0;0;.00nan;0;0
12428;45193;3923;0;0;0;0;.00nan;0;0
12428;86875;620;78;26;1;25;.962;3600000;0
12429;10141;1901;0;0;0;0;.00nan;0;0
12429;54273;619;56;9;1;8;.889;3600000;0
12429;73699;1901;83;62;6;56;.903;3600000;0
12429;78262;619;0;0;0;0;.00nan;0;0
12430;17596;614;77;20;1;19;.950;3600000;0
12430;32712;611;63;41;4;37;.902;3600000;0
12430;95056;614;0;0;0;0;.00nan;0;0
12430;156322;611;0;0;0;0;.00nan;0;0
12431;26336;612;93;28;1;27;.964;3600000;0
12431;65434;2308;67;30;2;28;.933;3600000;0
12431;65672;612;0;0;0;0;.00nan;0;0
12431;156254;2308;0;0;0;0;.00nan;0;0
12432;161763;617;0;0;0;0;.00nan;0;0
12432;16742;617;71;18;1;17;.944;3600000;0
12432;63529;2167;71;31;4;27;.871;3600000;0
12432;67724;2167;0;0;0;0;.00nan;0;0
12433;32712;611;0;0;0;0;.00nan;0;0
12433;34959;620;0;0;0;0;.00nan;0;0
12433;86875;620;41;23;4;19;.826;3600000;0
12433;156322;611;53;28;3;25;.893;3600000;0
12434;17596;614;91;33;2;31;.939;3548000;0
12434;33044;622;89;31;1;30;.968;3600000;0
12434;45323;622;0;0;0;0;.00nan;0;0
12434;95056;614;0;0;0;0;.00nan;0;0
12435;584;3923;65;35;3;32;.914;3600000;0
12435;161763;617;0;0;0;0;.00nan;0;0
12435;16742;617;77;39;3;36;.923;3581000;0
12435;45193;3923;0;0;0;0;.00nan;0;0
12436;63529;2167;77;46;4;42;.913;3966000;0
12436;65434;2308;20;9;4;5;.556;432000;0
12436;67724;2167;0;0;0;0;.00nan;0;0
12436;156254;2308;58;10;1;9;.900;3534000;0
12437;10141;1901;0;0;0;0;.00nan;0;0
12437;66477;2319;0;0;0;0;.00nan;0;0
12437;73187;2319;65;15;2;13;.867;3600000;0
12437;73699;1901;43;31;5;26;.839;3600000;0
12438;26336;612;68;22;1;21;.955;3897000;0
12438;54273;619;85;35;2;33;.943;3897000;0
12438;65672;612;0;0;0;0;.00nan;0;0
12438;78262;619;0;0;0;0;.00nan;0;0
12439;26336;612;73;44;4;40;.909;4200000;0
12439;65672;612;0;0;0;0;.00nan;0;0
12439;66477;2319;61;38;4;34;.895;4200000;0
12439;73187;2319;0;0;0;0;.00nan;0;0
12440;54273;619;0;0;0;0;.00nan;0;0
12440;63529;2167;61;56;7;49;.875;3600000;0
12440;67724;2167;0;0;0;0;.00nan;0;0
12440;78262;619;90;15;0;15;1.000;3600000;0
12441;32712;611;69;38;3;35;.921;4200000;0
12441;33044;622;56;31;3;28;.903;4200000;0
12441;45323;622;0;0;0;0;.00nan;0;0
12441;156322;611;0;0;0;0;.00nan;0;0
12442;10141;1901;0;0;0;0;.00nan;0;0
12442;17596;614;56;17;2;15;.882;3600000;0
12442;73699;1901;72;38;4;34;.895;3534000;0
12442;95056;614;0;0;0;0;.00nan;0;0
12443;584;3923;93;39;2;37;.949;3600000;0
12443;45193;3923;0;0;0;0;.00nan;0;0
12443;65434;2308;45;23;4;19;.826;3590000;0
12443;156254;2308;0;0;0;0;.00nan;0;0
12444;161763;617;43;31;5;26;.839;2357000;0
12444;16742;617;57;10;0;10;1.000;1843000;0
12444;34959;620;0;0;0;0;.00nan;0;0
12444;86875;620;55;37;5;32;.865;4200000;0
12445;34959;620;78;45;4;41;.911;3600000;0
12445;65434;2308;56;14;1;13;.929;3600000;0
12445;86875;620;0;0;0;0;.00nan;0;0
12445;156254;2308;0;0;0;0;.00nan;0;0
12446;584;3923;0;0;0;0;.00nan;0;0
12446;45193;3923;99;61;1;60;.984;3600000;0
12446;54273;619;0;0;0;0;.00nan;0;0
12446;78262;619;69;24;2;22;.917;3544000;0
12447;63529;2167;78;38;4;34;.895;3600000;0
12447;66477;2319;0;0;0;0;.00nan;0;0
12447;67724;2167;0;0;0;0;.00nan;0;0
12447;73187;2319;36;27;5;22;.815;3551000;0
12448;10141;1901;27;31;6;25;.806;3600000;0
12448;33044;622;63;24;2;22;.917;3600000;0
12448;45323;622;0;0;0;0;.00nan;0;0
12448;73699;1901;0;0;0;0;.00nan;0;0
12449;17596;614;58;24;2;22;.917;3600000;0
12449;26336;612;65;35;4;31;.886;3600000;0
12449;65672;612;0;0;0;0;.00nan;0;0
12449;95056;614;0;0;0;0;.00nan;0;0
12450;161763;617;75;23;1;22;.957;2608000;0
12450;16742;617;30;13;4;9;.692;992000;0
12450;32712;611;0;0;0;0;.00nan;0;0
12450;156322;611;78;11;0;11;1.000;3600000;0
12451;584;3923;76;51;5;46;.902;3900000;0
12451;45193;3923;0;0;0;0;.00nan;0;0
12451;66477;2319;0;0;0;0;.00nan;0;0
12451;73187;2319;56;26;4;22;.846;3900000;0
12452;34959;620;0;0;0;0;.00nan;0;0
12452;54273;619;60;32;4;28;.875;3600000;0
12452;78262;619;0;0;0;0;.00nan;0;0
12452;86875;620;90;46;2;44;.957;3600000;0
12453;26336;612;78;37;3;34;.919;4200000;0
12453;33044;622;0;0;0;0;.00nan;0;0
12453;45323;622;78;32;3;29;.906;4181000;0
12453;65672;612;0;0;0;0;.00nan;0;0
12454;10141;1901;0;0;0;0;.00nan;0;0
12454;32712;611;0;0;0;0;.00nan;0;0
12454;73699;1901;87;36;2;34;.944;3557000;0
12454;156322;611;78;15;0;15;1.000;3600000;0
12455;17596;614;46;13;2;11;.846;3574000;0
12455;63529;2167;93;38;1;37;.974;3600000;0
12455;67724;2167;0;0;0;0;.00nan;0;0
12455;95056;614;0;0;0;0;.00nan;0;0
12456;161763;617;0;0;0;0;.00nan;0;0
12456;16742;617;47;30;5;25;.833;3600000;0
12456;65434;2308;0;0;0;0;.00nan;0;0
12456;156254;2308;68;24;2;22;.917;3600000;0
12457;34959;620;0;0;0;0;.00nan;0;0
12457;66477;2319;0;0;0;0;.00nan;0;0
12457;73187;2319;43;24;5;19;.792;3600000;0
12457;86875;620;99;40;1;39;.975;3600000;0
12458;584;3923;57;43;5;38;.884;3600000;0
12458;17596;614;86;18;0;18;1.000;3600000;0
12458;45193;3923;0;0;0;0;.00nan;0;0
12458;95056;614;0;0;0;0;.00nan;0;0
12459;33044;622;65;34;4;30;.882;4046000;0
12459;45323;622;0;0;0;0;.00nan;0;0
12459;63529;2167;66;47;5;42;.894;4073000;0
12459;67724;2167;0;0;0;0;.00nan;0;0
12460;10141;1901;0;0;0;0;.00nan;0;0
12460;26336;612;0;0;0;0;.00nan;0;0
12460;65672;612;68;15;1;14;.933;3600000;0
12460;73699;1901;78;50;5;45;.900;3600000;0
12461;32712;611;0;0;0;0;.00nan;0;0
12461;65434;2308;82;28;1;27;.964;3600000;0
12461;156254;2308;0;0;0;0;.00nan;0;0
12461;156322;611;53;36;4;32;.889;3600000;0
12462;161763;617;0;0;0;0;.00nan;0;0
12462;16742;617;100;46;0;46;1.000;3600000;0
12462;54273;619;0;0;0;0;.00nan;0;0
12462;78262;619;44;17;3;14;.824;3600000;0
12463;161763;617;0;0;0;0;.00nan;0;0
12463;16742;617;51;41;6;35;.854;3519000;0
12463;66477;2319;53;27;4;23;.852;3600000;0
12463;73187;2319;0;0;0;0;.00nan;0;0
12464;54273;619;0;0;0;0;.00nan;0;0
12464;65434;2308;87;36;2;34;.944;3600000;0
12464;78262;619;51;25;3;22;.880;3543000;0
12464;156254;2308;0;0;0;0;.00nan;0;0
12465;584;3923;88;46;4;42;.913;3556000;0
12465;33044;622;57;19;2;17;.895;3600000;0
12465;45193;3923;0;0;0;0;.00nan;0;0
12465;45323;622;0;0;0;0;.00nan;0;0
12466;26336;612;63;24;3;21;.875;3873000;0
12466;32712;611;68;47;4;43;.915;3873000;0
12466;65672;612;0;0;0;0;.00nan;0;0
12466;156322;611;0;0;0;0;.00nan;0;0
12467;10141;1901;0;0;0;0;.00nan;0;0
12467;63529;2167;54;31;4;27;.871;3551000;0
12467;67724;2167;0;0;0;0;.00nan;0;0
12467;73699;1901;76;41;3;38;.927;3600000;0
12468;17596;614;54;10;1;9;.900;3600000;0
12468;34959;620;59;22;2;20;.909;1544000;0
12468;86875;620;22;33;7;26;.788;2056000;0
12468;95056;614;0;0;0;0;.00nan;0;0
12469;33044;622;64;12;1;11;.917;3600000;0
12469;34959;620;0;0;0;0;.00nan;0;0
12469;45323;622;0;0;0;0;.00nan;0;0
12469;86875;620;76;28;2;26;.929;3600000;0
12470;32712;611;0;0;0;0;.00nan;0;0
12470;54273;619;31;17;4;13;.765;3600000;0
12470;78262;619;0;0;0;0;.00nan;0;0
12470;156322;611;63;44;5;39;.886;3555000;0
12471;584;3923;0;0;0;0;.00nan;0;0
12471;10141;1901;0;0;0;0;.00nan;0;0
12471;45193;3923;72;22;1;21;.955;3600000;0
12471;73699;1901;60;32;3;29;.906;3554000;0
12472;26336;612;92;24;0;24;1.000;3600000;0
12472;63529;2167;68;42;5;37;.881;3600000;0
12472;65672;612;0;0;0;0;.00nan;0;0
12472;67724;2167;0;0;0;0;.00nan;0;0
12473;65434;2308;79;26;1;25;.962;3600000;0
12473;66477;2319;0;0;0;0;.00nan;0;0
12473;73187;2319;61;34;4;30;.882;3600000;0
12473;156254;2308;0;0;0;0;.00nan;0;0
12474;161763;617;0;0;0;0;.00nan;0;0
12474;16742;617;87;39;3;36;.923;4200000;0
12474;17596;614;65;27;3;24;.889;4200000;0
12474;95056;614;0;0;0;0;.00nan;0;0
12475;54273;619;0;0;0;0;.00nan;0;0
12475;66477;2319;9;40;9;31;.775;3600000;0
12475;73187;2319;0;0;0;0;.00nan;0;0
12475;78262;619;68;18;1;17;.944;3600000;0
12476;161763;617;0;0;0;0;.00nan;0;0
12476;16742;617;88;51;4;47;.922;3536000;0
12476;33044;622;74;26;2;24;.923;3600000;0
12476;45323;622;0;0;0;0;.00nan;0;0
12477;32712;611;72;30;3;27;.900;3600000;0
12477;63529;2167;74;33;4;29;.879;3600000;0
12477;67724;2167;0;0;0;0;.00nan;0;0
12477;156322;611;0;0;0;0;.00nan;0;0
12478;10141;1901;55;4;0;4;1.000;459000;0
12478;34959;620;0;0;0;0;.00nan;0;0
12478;73699;1901;19;26;6;20;.769;3141000;0
12478;86875;620;59;29;3;26;.897;3600000;0
12479;584;3923;0;0;0;0;.00nan;0;0
12479;26336;612;54;23;3;20;.870;3543000;0
12479;45193;3923;100;48;2;46;.958;3600000;0
12479;65672;612;0;0;0;0;.00nan;0;0
12480;17596;614;82;50;4;46;.920;3576000;0
12480;65434;2308;56;21;3;18;.857;3600000;0
12480;95056;614;0;0;0;0;.00nan;0;0
12480;156254;2308;0;0;0;0;.00nan;0;0
12481;584;3923;0;0;0;0;.00nan;0;0
12481;26336;612;69;21;1;20;.952;3600000;0
12481;45193;3923;96;40;2;38;.950;3584000;0
12481;65672;612;0;0;0;0;.00nan;0;0
12482;161763;617;0;0;0;0;.00nan;0;0
12482;16742;617;48;24;5;19;.792;3624000;0
12482;63529;2167;0;0;0;0;.00nan;0;0
12482;67724;2167;63;32;4;28;.875;3624000;0
12483;32712;611;0;0;0;0;.00nan;0;0
12483;66477;2319;0;0;0;0;.00nan;0;0
12483;73187;2319;54;13;2;11;.846;3797000;0
12483;156322;611;85;47;3;44;.936;3797000;0
12484;26336;612;72;7;0;7;1.000;3600000;0
12484;34959;620;0;0;0;0;.00nan;0;0
12484;65672;612;0;0;0;0;.00nan;0;0
12484;86875;620;81;66;7;59;.894;3600000;0
12485;17596;614;60;41;5;36;.878;3600000;0
12485;54273;619;40;38;6;32;.842;3554000;0
12485;78262;619;0;0;0;0;.00nan;0;0
12485;95056;614;0;0;0;0;.00nan;0;0
12486;584;3923;85;28;1;27;.964;3600000;0
12486;45193;3923;0;0;0;0;.00nan;0;0
12486;63529;2167;61;19;2;17;.895;3574000;0
12486;67724;2167;0;0;0;0;.00nan;0;0
12487;33044;622;100;41;0;41;1.000;3600000;0
12487;45323;622;0;0;0;0;.00nan;0;0
12487;65434;2308;0;0;0;0;.00nan;0;0
12487;156254;2308;55;26;3;23;.885;3600000;0
12488;161763;617;0;0;0;0;.00nan;0;0
12488;10141;1901;0;0;0;0;.00nan;0;0
12488;16742;617;81;41;3;38;.927;3513000;0
12488;73699;1901;91;37;1;36;.973;3600000;0
12489;33044;622;69;41;4;37;.902;3646000;0
12489;45323;622;0;0;0;0;.00nan;0;0
12489;54273;619;0;0;0;0;.00nan;0;0
12489;78262;619;48;29;5;24;.828;3646000;0
12490;584;3923;0;0;0;0;.00nan;0;0
12490;32712;611;0;0;0;0;.00nan;0;0
12490;45193;3923;82;34;2;32;.941;4177000;0
12490;156322;611;83;37;3;34;.919;4177000;0
12491;34959;620;0;0;0;0;.00nan;0;0
12491;63529;2167;76;37;2;35;.946;4200000;0
12491;67724;2167;0;0;0;0;.00nan;0;0
12491;86875;620;82;32;2;30;.938;4200000;0
12492;10141;1901;95;48;2;46;.958;3600000;0
12492;65434;2308;95;20;0;20;1.000;3600000;0
12492;73699;1901;0;0;0;0;.00nan;0;0
12492;156254;2308;0;0;0;0;.00nan;0;0
12493;161763;617;0;0;0;0;.00nan;0;0
12493;16742;617;92;57;3;54;.947;3808000;0
12493;26336;612;83;35;2;33;.943;3808000;0
12493;65672;612;0;0;0;0;.00nan;0;0
12494;17596;614;67;26;2;24;.923;3600000;0
12494;66477;2319;76;28;2;26;.929;3277000;0
12494;73187;2319;27;7;3;4;.571;323000;0
12494;95056;614;0;0;0;0;.00nan;0;0
12496;33044;622;77;35;2;33;.943;3600000;0
12496;45323;622;0;0;0;0;.00nan;0;0
12496;65434;2308;69;37;3;34;.919;3600000;0
12496;156254;2308;0;0;0;0;.00nan;0;0
12498;584;3923;76;61;6;55;.902;3600000;0
12498;17596;614;53;20;3;17;.850;3600000;0
12498;45193;3923;0;0;0;0;.00nan;0;0
12498;95056;614;0;0;0;0;.00nan;0;0
12500;32712;611;0;0;0;0;.00nan;0;0
12500;66477;2319;60;13;1;12;.923;3600000;0
12500;73187;2319;0;0;0;0;.00nan;0;0
12500;156322;611;86;49;5;44;.898;3600000;0
12502;16742;619;0;0;0;0;.00nan;0;0
12502;34959;620;41;9;2;7;.778;241000;0
12502;78262;619;38;7;2;5;.714;3600000;0
12502;86875;620;80;59;6;53;.898;3359000;0
12504;26336;612;67;18;1;17;.944;3600000;0
12504;63529;2167;93;53;4;49;.925;3600000;0
12504;65672;612;0;0;0;0;.00nan;0;0
12504;67724;2167;0;0;0;0;.00nan;0;0
12506;161763;617;0;0;0;0;.00nan;0;0
12506;168132;617;60;22;2;20;.909;3600000;0
12506;54273;1901;0;0;0;0;.00nan;0;0
12506;73699;1901;73;36;4;32;.889;3563000;0
12508;16742;619;33;29;5;24;.828;3600000;0
12508;66477;2319;0;0;0;0;.00nan;0;0
12508;73187;2319;76;24;1;23;.958;3600000;0
12508;78262;619;0;0;0;0;.00nan;0;0
12510;161763;617;51;42;6;36;.857;3600000;0
12510;168132;617;0;0;0;0;.00nan;0;0
12510;17596;614;0;0;0;0;.00nan;0;0
12510;95056;614;53;21;3;18;.857;3600000;0
12512;32712;611;41;24;4;20;.833;3600000;0
12512;33044;622;0;0;0;0;.00nan;0;0
12512;45323;622;68;20;1;19;.950;3600000;0
12512;156322;611;0;0;0;0;.00nan;0;0
12514;26336;612;0;0;0;0;.00nan;0;0
12514;63529;2167;0;0;0;0;.00nan;0;0
12514;65672;612;42;16;3;13;.813;3565000;0
12514;67724;2167;100;44;1;43;.977;3600000;0
12516;34959;620;64;23;2;21;.913;3600000;0
12516;54273;1901;30;22;6;16;.727;3025000;0
12516;73699;1901;46;5;1;4;.800;575000;0
12516;86875;620;0;0;0;0;.00nan;0;0
12518;584;3923;0;0;0;0;.00nan;0;0
12518;45193;3923;76;38;3;35;.921;3600000;0
12518;65434;2308;0;0;0;0;.00nan;0;0
12518;156254;2308;31;24;5;19;.792;3524000;0
12520;63529;2167;36;27;5;22;.815;2335000;0
12520;66477;2319;0;0;0;0;.00nan;0;0
12520;67724;2167;67;18;1;17;.944;1265000;0
12520;73187;2319;61;10;1;9;.900;3600000;0
12522;584;3923;100;44;1;43;.977;4200000;0
12522;26336;612;71;25;1;24;.960;4200000;0
12522;45193;3923;0;0;0;0;.00nan;0;0
12522;65672;612;0;0;0;0;.00nan;0;0
12526;161763;617;0;0;0;0;.00nan;0;0
12526;168132;617;78;43;3;40;.930;3600000;0
12526;17596;614;93;23;0;23;1.000;3600000;0
12526;95056;614;0;0;0;0;.00nan;0;0
12528;32712;611;0;0;0;0;.00nan;0;0
12528;34959;620;0;0;0;0;.00nan;0;0
12528;86875;620;88;42;3;39;.929;4200000;0
12528;156322;611;78;34;3;31;.912;4200000;0
12530;16742;619;0;0;0;0;.00nan;0;0
12530;33044;622;48;31;4;27;.871;3551000;0
12530;45323;622;0;0;0;0;.00nan;0;0
12530;78262;619;77;26;2;24;.923;3600000;0
12534;34959;620;0;0;0;0;.00nan;0;0
12534;63529;2167;63;37;4;33;.892;3573000;0
12534;67724;2167;0;0;0;0;.00nan;0;0
12534;86875;620;63;25;2;23;.920;3600000;0
12536;584;3923;79;37;2;35;.946;4200000;0
12536;161763;617;0;0;0;0;.00nan;0;0
12536;16742;617;76;28;2;26;.929;4200000;0
12536;45193;3923;0;0;0;0;.00nan;0;0
12538;17596;614;70;33;3;30;.909;4200000;0
12538;33044;622;58;30;3;27;.900;4200000;0
12538;45323;622;0;0;0;0;.00nan;0;0
12538;95056;614;0;0;0;0;.00nan;0;0
12540;32712;611;0;0;0;0;.00nan;0;0
12540;66477;2319;62;18;2;16;.889;3600000;0
12540;73187;2319;0;0;0;0;.00nan;0;0
12540;156322;611;50;36;5;31;.861;3600000;0
12542;26336;612;75;40;3;37;.925;3600000;0
12542;54273;619;0;0;0;0;.00nan;0;0
12542;65672;612;0;0;0;0;.00nan;0;0
12542;78262;619;51;29;4;25;.862;3560000;0
12544;34959;620;77;47;4;43;.915;3600000;0
12544;66477;2319;0;0;0;0;.00nan;0;0
12544;73187;2319;62;21;2;19;.905;3600000;0
12544;86875;620;0;0;0;0;.00nan;0;0
12548;584;3923;0;0;0;0;.00nan;0;0
12548;45193;3923;69;31;3;28;.903;3527000;0
12548;54273;619;83;24;1;23;.958;3600000;0
12548;78262;619;0;0;0;0;.00nan;0;0
12550;26336;612;0;0;0;0;.00nan;0;0
12550;32712;611;60;36;4;32;.889;3600000;0
12550;65672;612;43;14;3;11;.786;3600000;0
12550;156322;611;0;0;0;0;.00nan;0;0
12552;17596;614;31;10;3;7;.700;3545000;0
12552;63529;2167;0;0;0;0;.00nan;0;0
12552;67724;2167;100;49;2;47;.959;3600000;0
12552;95056;614;0;0;0;0;.00nan;0;0
12554;161763;617;55;34;4;30;.882;3539000;0
12554;10141;1901;0;0;0;0;.00nan;0;0
12554;16742;617;0;0;0;0;.00nan;0;0
12554;73699;1901;60;20;2;18;.900;3600000;0
12556;63529;2167;24;13;4;9;.692;1115000;0
12556;66477;2319;81;9;0;9;1.000;3600000;0
12556;67724;2167;59;43;5;38;.884;2485000;0
12556;73187;2319;0;0;0;0;.00nan;0;0
12558;584;3923;80;34;2;32;.941;3518000;0
12558;17596;614;93;23;0;23;1.000;3600000;0
12558;45193;3923;0;0;0;0;.00nan;0;0
12558;95056;614;0;0;0;0;.00nan;0;0
12560;161763;617;0;0;0;0;.00nan;0;0
12560;16742;617;48;28;4;24;.857;3626000;0
12560;34959;620;0;0;0;0;.00nan;0;0
12560;86875;620;61;37;5;32;.865;3626000;0
12562;26336;612;56;34;5;29;.853;3600000;0
12562;33044;622;85;22;1;21;.955;3600000;0
12562;45323;622;0;0;0;0;.00nan;0;0
12562;65672;612;0;0;0;0;.00nan;0;0
12566;10141;1901;0;0;0;0;.00nan;0;0
12566;54273;619;0;0;0;0;.00nan;0;0
12566;73699;1901;73;58;7;51;.879;3600000;0
12566;78262;619;53;9;1;8;.889;3600000;0
12568;17596;614;63;38;4;34;.895;3600000;0
12568;33044;622;100;24;0;24;1.000;3600000;0
12568;45323;622;0;0;0;0;.00nan;0;0
12568;95056;614;0;0;0;0;.00nan;0;0
12570;63529;2167;93;51;3;48;.941;3600000;0
12570;65434;2308;52;11;1;10;.909;3600000;0
12570;67724;2167;0;0;0;0;.00nan;0;0
12570;156254;2308;0;0;0;0;.00nan;0;0
12572;10141;1901;61;33;4;29;.879;3527000;0
12572;66477;2319;68;21;2;19;.905;3600000;0
12572;73187;2319;0;0;0;0;.00nan;0;0
12572;73699;1901;0;0;0;0;.00nan;0;0
12574;584;3923;0;0;0;0;.00nan;0;0
12574;26336;612;0;0;0;0;.00nan;0;0
12574;45193;3923;66;35;4;31;.886;3600000;0
12574;65672;612;78;24;1;23;.958;3600000;0
12576;32712;611;0;0;0;0;.00nan;0;0
12576;34959;620;100;40;2;38;.950;3600000;0
12576;86875;620;0;0;0;0;.00nan;0;0
12576;156322;611;41;20;3;17;.850;3600000;0
12578;161763;617;60;41;6;35;.854;3600000;0
12578;16742;617;0;0;0;0;.00nan;0;0
12578;54273;619;59;29;3;26;.897;3600000;0
12578;78262;619;0;0;0;0;.00nan;0;0
977;33044;622;50;17;2;15;.882;3600000;0
977;34959;620;35;26;5;21;.808;2009000;0
977;45323;622;0;0;0;0;.00nan;0;0
977;86875;620;36;36;7;29;.806;1591000;0
978;32712;611;97;37;1;36;.973;3220000;0
978;65434;2308;73;25;2;23;.920;3600000;0
978;156254;2308;0;0;0;0;.00nan;0;0
978;156322;611;31;9;3;6;.667;380000;0
979;26336;612;76;28;2;26;.929;3585000;0
979;54273;619;0;0;0;0;.00nan;0;0
979;65672;612;0;0;0;0;.00nan;0;0
979;78262;619;81;26;1;25;.962;3600000;0
980;17596;614;61;20;3;17;.850;3600000;0
980;66477;2319;0;0;0;0;.00nan;0;0
980;73187;2319;44;36;5;31;.861;3514000;0
980;95056;614;0;0;0;0;.00nan;0;0
981;33044;622;68;16;1;15;.938;3600000;0
981;34959;620;0;0;0;0;.00nan;0;0
981;45323;622;0;0;0;0;.00nan;0;0
981;86875;620;32;44;8;36;.818;3600000;0
982;32712;611;0;0;0;0;.00nan;0;0
982;65434;2308;32;21;4;17;.810;3543000;0
982;156254;2308;0;0;0;0;.00nan;0;0
982;156322;611;71;32;3;29;.906;3600000;0
983;26336;612;59;40;4;36;.900;3557000;0
983;54273;619;0;0;0;0;.00nan;0;0
983;65672;612;0;0;0;0;.00nan;0;0
983;78262;619;63;32;3;29;.906;3600000;0
984;17596;614;100;24;0;24;1.000;3600000;0
984;66477;2319;0;0;0;0;.00nan;0;0
984;73187;2319;87;32;1;31;.969;3593000;0
984;95056;614;0;0;0;0;.00nan;0;0
985;33044;622;62;17;1;16;.941;3600000;0
985;34959;620;0;0;0;0;.00nan;0;0
985;45323;622;0;0;0;0;.00nan;0;0
985;86875;620;61;35;4;31;.886;3600000;0
986;32712;611;0;0;0;0;.00nan;0;0
986;65434;2308;24;13;4;9;.692;1071000;0
986;156254;2308;78;20;1;19;.950;2529000;0
986;156322;611;94;30;1;29;.967;3600000;0
987;26336;612;74;33;3;30;.909;3600000;0
987;54273;619;0;0;0;0;.00nan;0;0
987;65672;612;0;0;0;0;.00nan;0;0
987;78262;619;46;23;4;19;.826;3564000;0
988;17596;614;75;22;1;21;.955;3600000;0
988;66477;2319;0;0;0;0;.00nan;0;0
988;73187;2319;73;36;3;33;.917;3514000;0
988;95056;614;0;0;0;0;.00nan;0;0
989;33044;622;35;11;3;8;.727;3600000;0
989;34959;620;48;0;0;0;.00nan;252000;0
989;45323;622;0;0;0;0;.00nan;0;0
989;86875;620;71;56;7;49;.875;3348000;0
990;32712;611;0;0;0;0;.00nan;0;0
990;65434;2308;60;15;1;14;.933;3600000;0
990;156254;2308;0;0;0;0;.00nan;0;0
990;156322;611;78;35;3;32;.914;3524000;0
991;26336;612;95;45;1;44;.978;4189000;0
991;54273;619;0;0;0;0;.00nan;0;0
991;65672;612;0;0;0;0;.00nan;0;0
991;78262;619;68;23;2;21;.913;4181000;0
992;17596;614;62;23;2;21;.913;3587000;0
992;66477;2319;0;0;0;0;.00nan;0;0
992;73187;2319;100;25;0;25;1.000;3600000;0
992;95056;614;0;0;0;0;.00nan;0;0
1364;32712;611;0;0;0;0;.00nan;0;0
1364;65434;2308;25;25;6;19;.760;3600000;0
1364;156254;2308;0;0;0;0;.00nan;0;0
1364;156322;611;100;40;1;39;.975;3600000;0
1365;26336;612;86;34;2;32;.941;3661000;0
1365;54273;619;0;0;0;0;.00nan;0;0
1365;65672;612;0;0;0;0;.00nan;0;0
1365;78262;619;55;24;3;21;.875;3661000;0
1366;17596;614;39;27;5;22;.815;3517000;0
1366;66477;2319;0;0;0;0;.00nan;0;0
1366;73187;2319;61;31;3;28;.903;3600000;0
1366;95056;614;0;0;0;0;.00nan;0;0
1446;32712;611;0;0;0;0;.00nan;0;0
1446;65434;2308;81;25;1;24;.960;3600000;0
1446;156254;2308;0;0;0;0;.00nan;0;0
1446;156322;611;71;35;3;32;.914;3518000;0
1447;26336;612;88;42;3;39;.929;3600000;0
1447;54273;619;0;0;0;0;.00nan;0;0
1447;65672;612;0;0;0;0;.00nan;0;0
1447;78262;619;56;19;2;17;.895;3600000;0
1448;17596;614;59;25;3;22;.880;3600000;0
1448;66477;2319;50;27;4;23;.852;2644000;0
1448;73187;2319;18;9;4;5;.556;956000;0
1448;95056;614;0;0;0;0;.00nan;0;0
1514;32712;611;0;0;0;0;.00nan;0;0
1514;65434;2308;57;12;1;11;.917;3600000;0
1514;156254;2308;0;0;0;0;.00nan;0;0
1514;156322;611;75;36;3;33;.917;3544000;0
1515;26336;612;83;39;4;35;.897;4200000;0
1515;54273;619;0;0;0;0;.00nan;0;0
1515;65672;612;0;0;0;0;.00nan;0;0
1515;78262;619;82;42;4;38;.905;4200000;0
1548;26336;612;59;37;5;32;.865;3600000;0
1548;33044;622;60;21;2;19;.905;3600000;0
1548;45323;622;0;0;0;0;.00nan;0;0
1548;65672;612;0;0;0;0;.00nan;0;0
1549;17596;614;88;35;2;33;.943;3600000;0
1549;65434;2308;75;22;1;21;.955;3600000;0
1549;95056;614;0;0;0;0;.00nan;0;0
1549;156254;2308;0;0;0;0;.00nan;0;0
1550;26336;612;49;29;4;25;.862;2229000;0
1550;33044;622;87;19;0;19;1.000;3600000;0
1550;45323;622;0;0;0;0;.00nan;0;0
1550;65672;612;53;18;2;16;.889;1371000;0
1551;17596;614;80;32;2;30;.938;3600000;0
1551;65434;2308;18;24;6;18;.750;3600000;0
1551;95056;614;0;0;0;0;.00nan;0;0
1551;156254;2308;0;0;0;0;.00nan;0;0
1552;26336;612;91;37;2;35;.946;4200000;0
1552;33044;622;60;26;2;24;.923;4200000;0
1552;45323;622;0;0;0;0;.00nan;0;0
1552;65672;612;0;0;0;0;.00nan;0;0
1553;17596;614;94;29;1;28;.966;3600000;0
1553;65434;2308;79;33;2;31;.939;3600000;0
1553;95056;614;0;0;0;0;.00nan;0;0
1553;156254;2308;0;0;0;0;.00nan;0;0
1554;26336;612;71;23;2;21;.913;3600000;0
1554;33044;622;78;43;4;39;.907;3600000;0
1554;45323;622;0;0;0;0;.00nan;0;0
1554;65672;612;0;0;0;0;.00nan;0;0
1555;17596;614;99;27;1;26;.963;3600000;0
1555;65434;2308;54;17;2;15;.882;3570000;0
1555;95056;614;0;0;0;0;.00nan;0;0
1555;156254;2308;0;0;0;0;.00nan;0;0
1865;26336;612;88;38;2;36;.947;4200000;0
1865;33044;622;65;28;2;26;.929;4200000;0
1865;45323;622;0;0;0;0;.00nan;0;0
1865;65672;612;0;0;0;0;.00nan;0;0
1866;17596;614;57;25;3;22;.880;3581000;0
1866;65434;2308;63;25;2;23;.920;3600000;0
1866;95056;614;0;0;0;0;.00nan;0;0
1866;156254;2308;0;0;0;0;.00nan;0;0
1895;26336;612;76;34;3;31;.912;3600000;0
1895;33044;622;54;32;4;28;.875;3545000;0
1895;45323;622;0;0;0;0;.00nan;0;0
1895;65672;612;0;0;0;0;.00nan;0;0
1896;17596;614;45;23;4;19;.826;3514000;0
1896;65434;2308;82;31;2;29;.935;3600000;0
1896;95056;614;0;0;0;0;.00nan;0;0
1896;156254;2308;0;0;0;0;.00nan;0;0
1919;26336;612;28;12;4;8;.667;1019000;0
1919;33044;622;80;31;1;30;.968;3600000;0
1919;45323;622;0;0;0;0;.00nan;0;0
1919;65672;612;60;29;3;26;.897;2581000;0
1920;17596;614;84;32;2;30;.938;3569000;0
1920;65434;2308;81;26;1;25;.962;3600000;0
1920;95056;614;0;0;0;0;.00nan;0;0
1920;156254;2308;0;0;0;0;.00nan;0;0
1968;33044;622;53;28;4;24;.857;3545000;0
1968;45323;622;0;0;0;0;.00nan;0;0
1968;65434;2308;62;30;3;27;.900;3600000;0
1968;156254;2308;0;0;0;0;.00nan;0;0
1969;33044;622;61;43;5;38;.884;3600000;0
1969;45323;622;0;0;0;0;.00nan;0;0
1969;65434;2308;54;13;2;11;.846;3600000;0
1969;156254;2308;0;0;0;0;.00nan;0;0
1970;33044;622;59;29;3;26;.897;3588000;0
1970;45323;622;0;0;0;0;.00nan;0;0
1970;65434;2308;95;28;1;27;.964;3600000;0
1970;156254;2308;0;0;0;0;.00nan;0;0
1971;33044;622;73;43;4;39;.907;4200000;0
1971;45323;622;0;0;0;0;.00nan;0;0
1971;65434;2308;49;27;4;23;.852;4200000;0
1971;156254;2308;0;0;0;0;.00nan;0;0
12579;173840;718;73;21;1;20;.952;3600000;0
12579;55918;721;0;0;0;0;.00nan;0;0
12579;61411;718;0;0;0;0;.00nan;0;0
12579;77009;721;58;27;3;24;.889;3523000;0
12580;6603;717;80;42;3;39;.929;3761000;0
12580;168089;715;41;19;4;15;.789;3761000;0
12580;168414;717;0;0;0;0;.00nan;0;0
12580;68948;715;0;0;0;0;.00nan;0;0
12581;56048;2529;59;19;2;17;.895;3900000;0
12581;56598;716;0;0;0;0;.00nan;0;0
12581;67910;2529;0;0;0;0;.00nan;0;0
12581;76486;716;79;33;2;31;.939;3900000;0
12582;61170;720;16;6;4;2;.333;665000;0
12582;62392;720;72;18;1;17;.944;2880000;0
12582;77011;719;0;0;0;0;.00nan;0;0
12582;78587;719;64;32;4;28;.875;3600000;0
12583;55932;2188;0;0;0;0;.00nan;0;0
12583;56048;2529;39;21;4;17;.810;3543000;0
12583;67910;2529;0;0;0;0;.00nan;0;0
12583;86283;2188;82;30;2;28;.933;3600000;0
12584;56598;716;0;0;0;0;.00nan;0;0
12584;61170;720;62;42;5;37;.881;3600000;0
12584;62392;720;0;0;0;0;.00nan;0;0
12584;76486;716;99;39;2;37;.949;3600000;0
12585;168089;715;65;26;2;24;.923;3600000;0
12585;173840;718;55;31;3;28;.903;3564000;0
12585;61411;718;0;0;0;0;.00nan;0;0
12585;161163;715;0;0;0;0;.00nan;0;0
12586;6603;717;73;21;1;20;.952;3600000;0
12586;168414;717;0;0;0;0;.00nan;0;0
12586;77011;719;0;0;0;0;.00nan;0;0
12586;78587;719;54;30;4;26;.867;3600000;0
12587;173840;718;84;25;1;24;.960;3900000;0
12587;61411;718;0;0;0;0;.00nan;0;0
12587;77011;719;0;0;0;0;.00nan;0;0
12587;78587;719;92;27;1;26;.963;3900000;0
12588;161540;716;58;26;3;23;.885;3600000;0
12588;6603;717;0;0;0;0;.00nan;0;0
12588;168414;717;56;37;5;32;.865;3521000;0
12588;76486;716;0;0;0;0;.00nan;0;0
12589;168089;715;62;39;4;35;.897;3562000;0
12589;55918;721;0;0;0;0;.00nan;0;0
12589;77009;721;76;29;2;27;.931;3600000;0
12589;161163;715;0;0;0;0;.00nan;0;0
12590;55932;2188;0;0;0;0;.00nan;0;0
12590;61170;720;75;41;3;38;.927;3870000;0
12590;62392;720;0;0;0;0;.00nan;0;0
12590;86283;2188;73;22;2;20;.909;3870000;0
12591;6603;717;67;36;3;33;.917;3578000;0
12591;168414;717;0;0;0;0;.00nan;0;0
12591;55932;2188;0;0;0;0;.00nan;0;0
12591;86283;2188;63;19;2;17;.895;3600000;0
12592;161540;716;81;24;1;23;.958;3900000;0
12592;173840;718;89;31;1;30;.968;3900000;0
12592;61411;718;0;0;0;0;.00nan;0;0
12592;76486;716;0;0;0;0;.00nan;0;0
12593;56048;2529;70;8;0;8;1.000;3600000;0
12593;61170;720;53;47;7;40;.851;3600000;0
12593;62392;720;0;0;0;0;.00nan;0;0
12593;67910;2529;0;0;0;0;.00nan;0;0
12594;55918;721;84;36;2;34;.944;3229000;0
12594;77009;721;22;9;4;5;.556;371000;0
12594;77011;719;0;0;0;0;.00nan;0;0
12594;78587;719;37;13;3;10;.769;3600000;0
12595;173840;718;76;41;3;38;.927;3574000;0
12595;55932;2188;0;0;0;0;.00nan;0;0
12595;61411;718;0;0;0;0;.00nan;0;0
12595;86283;2188;83;29;1;28;.966;3600000;0
12596;6603;717;0;0;0;0;.00nan;0;0
12596;168414;717;73;36;3;33;.917;3600000;0
12596;56048;2529;57;29;4;25;.862;3560000;0
12596;67910;2529;0;0;0;0;.00nan;0;0
12597;161540;716;62;29;3;26;.897;3600000;0
12597;55918;721;92;33;2;31;.939;3600000;0
12597;76486;716;0;0;0;0;.00nan;0;0
12597;77009;721;0;0;0;0;.00nan;0;0
12598;168089;715;76;27;2;25;.926;3900000;0
12598;77011;719;0;0;0;0;.00nan;0;0
12598;78587;719;69;26;2;24;.923;3900000;0
12598;161163;715;0;0;0;0;.00nan;0;0
12599;55918;721;87;40;3;37;.925;3555000;0
12599;55932;2188;0;0;0;0;.00nan;0;0
12599;77009;721;0;0;0;0;.00nan;0;0
12599;86283;2188;49;12;2;10;.833;3600000;0
12600;161540;716;0;0;0;0;.00nan;0;0
12600;168089;715;61;32;3;29;.906;3790000;0
12600;76486;716;64;36;4;32;.889;3790000;0
12600;161163;715;0;0;0;0;.00nan;0;0
12601;173840;718;59;34;4;30;.882;3565000;0
12601;56048;2529;69;30;3;27;.900;3600000;0
12601;61411;718;0;0;0;0;.00nan;0;0
12601;67910;2529;0;0;0;0;.00nan;0;0
12602;6603;717;76;28;2;26;.929;3600000;0
12602;168414;717;0;0;0;0;.00nan;0;0
12602;61170;720;43;30;5;25;.833;3600000;0
12602;62392;720;0;0;0;0;.00nan;0;0
12603;173840;718;84;22;1;21;.955;3600000;0
12603;61170;720;55;30;3;27;.900;3537000;0
12603;61411;718;0;0;0;0;.00nan;0;0
12603;62392;720;0;0;0;0;.00nan;0;0
12604;55918;721;0;0;0;0;.00nan;0;0
12604;56048;2529;70;23;1;22;.957;3600000;0
12604;67910;2529;0;0;0;0;.00nan;0;0
12604;77009;721;58;43;5;38;.884;3600000;0
12605;168089;715;0;0;0;0;.00nan;0;0
12605;55932;2188;0;0;0;0;.00nan;0;0
12605;86283;2188;56;32;4;28;.875;3600000;0
12605;161163;715;39;28;5;23;.821;3571000;0
12606;161540;716;0;0;0;0;.00nan;0;0
12606;76486;716;59;38;4;34;.895;3600000;0
12606;77011;719;0;0;0;0;.00nan;0;0
12606;78587;719;99;38;1;37;.974;3600000;0
12607;55932;2188;0;0;0;0;.00nan;0;0
12607;77011;719;0;0;0;0;.00nan;0;0
12607;78587;719;70;31;3;28;.903;3590000;0
12607;86283;2188;60;20;2;18;.900;3600000;0
12608;6603;717;0;0;0;0;.00nan;0;0
12608;168414;717;78;26;2;24;.923;3900000;0
12608;173840;718;100;43;2;41;.953;3900000;0
12608;61411;718;0;0;0;0;.00nan;0;0
12609;168089;715;67;26;2;24;.923;3600000;0
12609;56048;2529;33;10;3;7;.700;526000;0
12609;67910;2529;71;23;1;22;.957;3001000;0
12609;161163;715;0;0;0;0;.00nan;0;0
12610;55918;721;0;0;0;0;.00nan;0;0
12610;61170;720;0;0;0;0;.00nan;0;0
12610;62392;720;50;29;4;25;.862;3600000;0
12610;77009;721;75;25;1;24;.960;3600000;0
12611;161540;716;0;0;0;0;.00nan;0;0
12611;55932;2188;0;0;0;0;.00nan;0;0
12611;76486;716;78;32;2;30;.938;3600000;0
12611;86283;2188;42;24;4;20;.833;3544000;0
12612;6603;717;61;33;4;29;.879;3588000;0
12612;168414;717;0;0;0;0;.00nan;0;0
12612;55918;721;54;27;3;24;.889;3600000;0
12612;77009;721;0;0;0;0;.00nan;0;0
12613;168089;715;61;23;3;20;.870;3600000;0
12613;61170;720;59;31;4;27;.871;3546000;0
12613;62392;720;0;0;0;0;.00nan;0;0
12613;161163;715;0;0;0;0;.00nan;0;0
12614;56048;2529;58;19;3;16;.842;3600000;0
12614;67910;2529;0;0;0;0;.00nan;0;0
12614;77011;719;0;0;0;0;.00nan;0;0
12614;78587;719;79;41;4;37;.902;3551000;0
12615;161540;716;0;0;0;0;.00nan;0;0
12615;56048;2529;77;25;1;24;.960;3600000;0
12615;67910;2529;0;0;0;0;.00nan;0;0
12615;76486;716;73;35;3;32;.914;3526000;0
12616;173840;718;92;46;2;44;.957;3677000;0
12616;55918;721;0;0;0;0;.00nan;0;0
12616;61411;718;0;0;0;0;.00nan;0;0
12616;77009;721;90;30;1;29;.967;3677000;0
12617;6603;717;0;0;0;0;.00nan;0;0
12617;168089;715;0;0;0;0;.00nan;0;0
12617;168414;717;71;38;4;34;.895;3532000;0
12617;161163;715;96;35;2;33;.943;3600000;0
12618;61170;720;74;24;2;22;.917;3600000;0
12618;62392;720;0;0;0;0;.00nan;0;0
12618;77011;719;0;0;0;0;.00nan;0;0
12618;78587;719;63;31;4;27;.871;3585000;0
12619;168089;715;69;21;1;20;.952;3600000;0
12619;173840;718;79;44;3;41;.932;3519000;0
12619;61411;718;0;0;0;0;.00nan;0;0
12619;161163;715;0;0;0;0;.00nan;0;0
12620;6603;717;54;16;2;14;.875;3600000;0
12620;168414;717;0;0;0;0;.00nan;0;0
12620;77011;719;0;0;0;0;.00nan;0;0
12620;78587;719;46;34;5;29;.853;3600000;0
12621;55932;2188;0;0;0;0;.00nan;0;0
12621;56048;2529;0;0;0;0;.00nan;0;0
12621;67910;2529;62;36;4;32;.889;3552000;0
12621;86283;2188;64;25;2;23;.920;3600000;0
12622;161540;716;0;0;0;0;.00nan;0;0
12622;61170;720;91;39;2;37;.949;3600000;0
12622;62392;720;0;0;0;0;.00nan;0;0
12622;76486;716;53;26;3;23;.885;3600000;0
12623;55932;2188;0;0;0;0;.00nan;0;0
12623;61170;720;77;40;4;36;.900;3600000;0
12623;62392;720;0;0;0;0;.00nan;0;0
12623;86283;2188;72;21;1;20;.952;3600000;0
12624;161540;716;0;0;0;0;.00nan;0;0
12624;6603;717;0;0;0;0;.00nan;0;0
12624;168414;717;60;29;3;26;.897;3552000;0
12624;76486;716;70;19;1;18;.947;3600000;0
12625;168089;715;0;0;0;0;.00nan;0;0
12625;55918;721;0;0;0;0;.00nan;0;0
12625;77009;721;76;49;4;45;.918;3565000;0
12625;161163;715;74;25;2;23;.920;3600000;0
12626;173840;718;87;31;2;29;.935;3600000;0
12626;61411;718;0;0;0;0;.00nan;0;0
12626;77011;719;0;0;0;0;.00nan;0;0
12626;78587;719;63;30;3;27;.900;3576000;0
12627;161540;716;0;0;0;0;.00nan;0;0
12627;173840;718;0;0;0;0;.00nan;0;0
12627;61411;718;79;43;3;40;.930;3600000;0
12627;76486;716;31;25;5;20;.800;3563000;0
12628;6603;717;60;36;4;32;.889;3600000;0
12628;168414;717;0;0;0;0;.00nan;0;0
12628;55932;2188;0;0;0;0;.00nan;0;0
12628;86283;2188;84;26;1;25;.962;3600000;0
12629;55918;721;70;24;2;22;.917;3549000;0
12629;77009;721;0;0;0;0;.00nan;0;0
12629;77011;719;0;0;0;0;.00nan;0;0
12629;78587;719;100;33;0;33;1.000;3600000;0
12630;56048;2529;65;32;3;29;.906;3900000;0
12630;61170;720;0;0;0;0;.00nan;0;0
12630;62392;720;85;42;3;39;.929;3900000;0
12630;67910;2529;0;0;0;0;.00nan;0;0
12631;173840;718;67;44;4;40;.909;3678000;0
12631;55932;2188;52;21;3;18;.857;3678000;0
12631;61411;718;0;0;0;0;.00nan;0;0
12631;86283;2188;0;0;0;0;.00nan;0;0
12632;161540;716;0;0;0;0;.00nan;0;0
12632;55918;721;75;48;5;43;.896;3600000;0
12632;76486;716;70;17;1;16;.941;3600000;0
12632;77009;721;0;0;0;0;.00nan;0;0
12633;6603;717;0;0;0;0;.00nan;0;0
12633;168414;717;61;32;4;28;.875;3600000;0
12633;56048;2529;70;19;1;18;.947;3600000;0
12633;67910;2529;0;0;0;0;.00nan;0;0
12634;168089;715;86;37;3;34;.919;3549000;0
12634;77011;719;0;0;0;0;.00nan;0;0
12634;78587;719;80;26;1;25;.962;3600000;0
12634;161163;715;0;0;0;0;.00nan;0;0
12635;173840;718;51;30;4;26;.867;3590000;0
12635;56048;2529;64;22;2;20;.909;3600000;0
12635;61411;718;0;0;0;0;.00nan;0;0
12635;67910;2529;0;0;0;0;.00nan;0;0
12636;6603;717;48;37;5;32;.865;3890000;0
12636;168414;717;0;0;0;0;.00nan;0;0
12636;61170;720;34;29;5;24;.828;3900000;0
12636;62392;720;0;0;0;0;.00nan;0;0
12637;55918;721;0;0;0;0;.00nan;0;0
12637;55932;2188;0;0;0;0;.00nan;0;0
12637;77009;721;82;37;2;35;.946;3692000;0
12637;86283;2188;63;28;3;25;.893;3692000;0
12638;161540;716;0;0;0;0;.00nan;0;0
12638;168089;715;0;0;0;0;.00nan;0;0
12638;76486;716;45;19;3;16;.842;3565000;0
12638;161163;715;100;40;2;38;.950;3600000;0
12639;168089;715;55;32;3;29;.906;3566000;0
12639;55932;2188;0;0;0;0;.00nan;0;0
12639;86283;2188;98;39;2;37;.949;3600000;0
12639;161163;715;0;0;0;0;.00nan;0;0
12640;161540;716;0;0;0;0;.00nan;0;0
12640;76486;716;41;20;3;17;.850;3591000;0
12640;77011;719;0;0;0;0;.00nan;0;0
12640;78587;719;94;48;2;46;.958;3600000;0
12641;55918;721;0;0;0;0;.00nan;0;0
12641;56048;2529;70;21;1;20;.952;3600000;0
12641;67910;2529;0;0;0;0;.00nan;0;0
12641;77009;721;46;28;4;24;.857;3600000;0
12642;173840;718;55;21;3;18;.857;3600000;0
12642;61170;720;67;43;4;39;.907;3565000;0
12642;61411;718;0;0;0;0;.00nan;0;0
12642;62392;720;0;0;0;0;.00nan;0;0
12643;6603;717;56;23;2;21;.913;3900000;0
12643;168414;717;0;0;0;0;.00nan;0;0
12643;173840;718;79;32;2;30;.938;3900000;0
12643;61411;718;0;0;0;0;.00nan;0;0
12644;55918;721;56;14;1;13;.929;3600000;0
12644;61170;720;57;40;5;35;.875;3600000;0
12644;62392;720;0;0;0;0;.00nan;0;0
12644;77009;721;0;0;0;0;.00nan;0;0
12645;168089;715;0;0;0;0;.00nan;0;0
12645;56048;2529;94;33;2;31;.939;3591000;0
12645;67910;2529;0;0;0;0;.00nan;0;0
12645;161163;715;80;24;1;23;.958;3600000;0
12646;55932;2188;0;0;0;0;.00nan;0;0
12646;77011;719;0;0;0;0;.00nan;0;0
12646;78587;719;77;30;2;28;.933;3900000;0
12646;86283;2188;67;18;2;16;.889;3900000;0
12647;161540;716;0;0;0;0;.00nan;0;0
12647;55932;2188;0;0;0;0;.00nan;0;0
12647;76486;716;59;16;2;14;.875;3614000;0
12647;86283;2188;89;30;1;29;.967;3614000;0
12648;6603;717;0;0;0;0;.00nan;0;0
12648;168414;717;90;33;1;32;.970;3600000;0
12648;55918;721;83;35;2;33;.943;3544000;0
12648;77009;721;0;0;0;0;.00nan;0;0
12649;168089;715;0;0;0;0;.00nan;0;0
12649;61170;720;30;31;6;25;.806;1727000;0
12649;62392;720;56;22;2;20;.909;1873000;0
12649;161163;715;44;15;3;12;.800;3600000;0
12650;56048;2529;45;4;1;3;.750;517000;0
12650;67910;2529;24;31;6;25;.806;3083000;0
12650;77011;719;0;0;0;0;.00nan;0;0
12650;78587;719;100;26;0;26;1.000;3600000;0
12651;173840;718;99;26;0;26;1.000;3600000;0
12651;55918;721;32;10;3;7;.700;494000;0
12651;61411;718;0;0;0;0;.00nan;0;0
12651;77009;721;69;32;4;28;.875;3106000;0
12652;6603;717;0;0;0;0;.00nan;0;0
12652;168089;715;0;0;0;0;.00nan;0;0
12652;168414;717;89;48;3;45;.938;3600000;0
12652;161163;715;58;31;4;27;.871;3588000;0
12653;161540;716;0;0;0;0;.00nan;0;0
12653;56048;2529;67;21;2;19;.905;3600000;0
12653;67910;2529;0;0;0;0;.00nan;0;0
12653;76486;716;50;30;4;26;.867;3515000;0
12654;61170;720;0;0;0;0;.00nan;0;0
12654;62392;720;49;33;4;29;.879;3900000;0
12654;77011;719;0;0;0;0;.00nan;0;0
12654;78587;719;60;35;4;31;.886;3900000;0
12655;55932;2188;0;0;0;0;.00nan;0;0
12655;56048;2529;85;33;2;31;.939;3600000;0
12655;67910;2529;0;0;0;0;.00nan;0;0
12655;86283;2188;86;27;1;26;.963;3600000;0
12656;161540;716;0;0;0;0;.00nan;0;0
12656;61170;720;60;42;3;39;.929;3900000;0
12656;62392;720;0;0;0;0;.00nan;0;0
12656;76486;716;59;26;3;23;.885;3900000;0
12657;168089;715;0;0;0;0;.00nan;0;0
12657;173840;718;61;45;5;40;.889;3900000;0
12657;61411;718;0;0;0;0;.00nan;0;0
12657;161163;715;39;25;5;20;.800;3900000;0
12658;6603;717;66;22;2;20;.909;3600000;0
12658;168414;717;0;0;0;0;.00nan;0;0
12658;77011;719;0;0;0;0;.00nan;0;0
12658;78587;719;77;38;3;35;.921;3600000;0
12659;173840;718;38;22;4;18;.818;3553000;0
12659;61411;718;0;0;0;0;.00nan;0;0
12659;77011;719;0;0;0;0;.00nan;0;0
12659;78587;719;100;49;2;47;.959;3600000;0
12660;161540;716;0;0;0;0;.00nan;0;0
12660;6603;717;49;7;1;6;.857;964000;0
12660;168414;717;39;30;6;24;.800;2636000;0
12660;76486;716;88;35;1;34;.971;3600000;0
12661;168089;715;0;0;0;0;.00nan;0;0
12661;55918;721;0;0;0;0;.00nan;0;0
12661;77009;721;81;39;4;35;.897;3600000;0
12661;161163;715;78;12;0;12;1.000;3600000;0
12662;55932;2188;0;0;0;0;.00nan;0;0
12662;61170;720;99;28;0;28;1.000;3600000;0
12662;62392;720;0;0;0;0;.00nan;0;0
12662;86283;2188;69;26;2;24;.923;3514000;0
12663;6603;717;65;48;6;42;.875;3600000;0
12663;168414;717;0;0;0;0;.00nan;0;0
12663;55932;2188;0;0;0;0;.00nan;0;0
12663;86283;2188;84;23;1;22;.957;3600000;0
12664;161540;716;0;0;0;0;.00nan;0;0
12664;173840;718;100;42;2;40;.952;3900000;0
12664;61411;718;0;0;0;0;.00nan;0;0
12664;76486;716;83;32;2;30;.938;3900000;0
12665;56048;2529;55;26;3;23;.885;3600000;0
12665;61170;720;69;42;4;38;.905;3596000;0
12665;62392;720;0;0;0;0;.00nan;0;0
12665;67910;2529;0;0;0;0;.00nan;0;0
12666;55918;721;0;0;0;0;.00nan;0;0
12666;77009;721;48;32;5;27;.844;3600000;0
12666;77011;719;0;0;0;0;.00nan;0;0
12666;78587;719;65;43;6;37;.860;3557000;0
12667;173840;718;82;38;3;35;.921;3900000;0
12667;55932;2188;0;0;0;0;.00nan;0;0
12667;61411;718;0;0;0;0;.00nan;0;0
12667;86283;2188;65;27;3;24;.889;3869000;0
12668;6603;717;89;31;2;29;.935;3900000;0
12668;168414;717;0;0;0;0;.00nan;0;0
12668;56048;2529;81;34;2;32;.941;3900000;0
12668;67910;2529;0;0;0;0;.00nan;0;0
12669;161540;716;0;0;0;0;.00nan;0;0
12669;55918;721;0;0;0;0;.00nan;0;0
12669;76486;716;62;14;1;13;.929;3600000;0
12669;77009;721;97;54;3;51;.944;3586000;0
12670;168089;715;49;18;3;15;.833;3600000;0
12670;77011;719;0;0;0;0;.00nan;0;0
12670;78587;719;68;46;5;41;.891;3585000;0
12670;161163;715;0;0;0;0;.00nan;0;0
12671;55918;721;58;45;5;40;.889;3130000;0
12671;55932;2188;0;0;0;0;.00nan;0;0
12671;77009;721;33;10;3;7;.700;470000;0
12671;86283;2188;68;18;1;17;.944;3600000;0
12672;161540;716;0;0;0;0;.00nan;0;0
12672;168089;715;73;27;2;25;.926;3600000;0
12672;76486;716;78;41;4;37;.902;3593000;0
12672;161163;715;0;0;0;0;.00nan;0;0
12673;173840;718;66;31;3;28;.903;3600000;0
12673;56048;2529;92;19;0;19;1.000;3600000;0
12673;61411;718;0;0;0;0;.00nan;0;0
12673;67910;2529;0;0;0;0;.00nan;0;0
12674;6603;717;65;26;3;23;.885;3600000;0
12674;168414;717;0;0;0;0;.00nan;0;0
12674;61170;720;95;20;0;20;1.000;3600000;0
12674;62392;720;0;0;0;0;.00nan;0;0
12675;173840;718;74;21;1;20;.952;3900000;0
12675;61170;720;90;36;1;35;.972;3900000;0
12675;61411;718;0;0;0;0;.00nan;0;0
12675;62392;720;0;0;0;0;.00nan;0;0
12676;55918;721;84;39;2;37;.949;3593000;0
12676;56048;2529;58;11;1;10;.909;3600000;0
12676;67910;2529;0;0;0;0;.00nan;0;0
12676;77009;721;0;0;0;0;.00nan;0;0
12677;168089;715;0;0;0;0;.00nan;0;0
12677;55932;2188;0;0;0;0;.00nan;0;0
12677;86283;2188;63;26;2;24;.923;3600000;0
12677;161163;715;71;32;3;29;.906;3555000;0
12678;161540;716;0;0;0;0;.00nan;0;0
12678;76486;716;66;25;2;23;.920;3600000;0
12678;77011;719;77;31;3;28;.903;3550000;0
12678;78587;719;0;0;0;0;.00nan;0;0
12679;55932;2188;0;0;0;0;.00nan;0;0
12679;77011;719;0;0;0;0;.00nan;0;0
12679;78587;719;68;35;3;32;.914;3540000;0
12679;86283;2188;80;24;1;23;.958;3600000;0
12680;6603;717;0;0;0;0;.00nan;0;0
12680;168414;717;87;38;3;35;.921;3600000;0
12680;173840;718;93;23;0;23;1.000;3600000;0
12680;61411;718;0;0;0;0;.00nan;0;0
12681;168089;715;78;37;3;34;.919;3554000;0
12681;56048;2529;73;27;2;25;.926;3600000;0
12681;67910;2529;0;0;0;0;.00nan;0;0
12681;161163;715;0;0;0;0;.00nan;0;0
12682;55918;721;68;35;3;32;.914;3595000;0
12682;61170;720;69;22;1;21;.955;3600000;0
12682;62392;720;0;0;0;0;.00nan;0;0
12682;77009;721;0;0;0;0;.00nan;0;0
12683;161540;716;0;0;0;0;.00nan;0;0
12683;55932;2188;0;0;0;0;.00nan;0;0
12683;76486;716;100;30;0;30;1.000;3600000;0
12683;86283;2188;63;21;2;19;.905;3558000;0
12684;6603;717;100;25;0;25;1.000;3600000;0
12684;168414;717;0;0;0;0;.00nan;0;0
12684;55918;721;55;39;5;34;.872;3600000;0
12684;77009;721;0;0;0;0;.00nan;0;0
12685;168089;715;69;23;2;21;.913;3600000;0
12685;61170;720;28;22;5;17;.773;2094000;0
12685;62392;720;55;14;2;12;.857;1506000;0
12685;161163;715;0;0;0;0;.00nan;0;0
12686;56048;2529;51;19;3;16;.842;3600000;0
12686;67910;2529;0;0;0;0;.00nan;0;0
12686;77011;719;0;0;0;0;.00nan;0;0
12686;78587;719;100;35;0;35;1.000;3600000;0
12687;161540;716;0;0;0;0;.00nan;0;0
12687;56048;2529;58;39;4;35;.897;3600000;0
12687;67910;2529;0;0;0;0;.00nan;0;0
12687;76486;716;85;29;1;28;.966;3600000;0
12688;173840;718;79;29;2;27;.931;3600000;0
12688;55918;721;54;3;0;3;1.000;344000;0
12688;61411;718;0;0;0;0;.00nan;0;0
12688;77009;721;45;40;6;34;.850;3256000;0
12689;6603;717;99;40;1;39;.975;3600000;0
12689;168089;715;64;29;3;26;.897;3512000;0
12689;168414;717;0;0;0;0;.00nan;0;0
12689;161163;715;0;0;0;0;.00nan;0;0
12690;61170;720;62;20;2;18;.900;3600000;0
12690;62392;720;0;0;0;0;.00nan;0;0
12690;77011;719;0;0;0;0;.00nan;0;0
12690;78587;719;75;40;4;36;.900;3571000;0
12691;168089;715;56;17;2;15;.882;3583000;0
12691;173840;718;99;56;1;55;.982;3600000;0
12691;61411;718;0;0;0;0;.00nan;0;0
12691;161163;715;0;0;0;0;.00nan;0;0
12692;6603;717;92;33;2;31;.939;3870000;0
12692;168414;717;0;0;0;0;.00nan;0;0
12692;77011;719;0;0;0;0;.00nan;0;0
12692;78587;719;57;24;2;22;.917;3900000;0
12693;55932;2188;0;0;0;0;.00nan;0;0
12693;56048;2529;0;0;0;0;.00nan;0;0
12693;67910;2529;60;25;3;22;.880;3578000;0
12693;86283;2188;81;30;2;28;.933;3600000;0
12694;161540;716;0;0;0;0;.00nan;0;0
12694;61170;720;0;0;0;0;.00nan;0;0
12694;62392;720;62;43;5;38;.884;3600000;0
12694;76486;716;67;21;1;20;.952;3600000;0
12695;55932;2188;38;27;5;22;.815;2146000;0
12695;61170;720;45;27;5;22;.815;3600000;0
12695;62392;720;0;0;0;0;.00nan;0;0
12695;86283;2188;53;10;1;9;.900;1454000;0
12696;161540;716;0;0;0;0;.00nan;0;0
12696;6603;717;71;18;1;17;.944;3600000;0
12696;168414;717;0;0;0;0;.00nan;0;0
12696;76486;716;68;33;3;30;.909;3532000;0
12697;168089;715;87;23;2;21;.913;3600000;0
12697;55918;721;66;48;5;43;.896;3600000;0
12697;77009;721;0;0;0;0;.00nan;0;0
12697;161163;715;0;0;0;0;.00nan;0;0
12698;173840;718;62;21;2;19;.905;3600000;0
12698;61411;718;0;0;0;0;.00nan;0;0
12698;77011;719;0;0;0;0;.00nan;0;0
12698;78587;719;66;28;3;25;.893;3594000;0
12699;161540;716;0;0;0;0;.00nan;0;0
12699;173840;718;87;38;2;36;.947;3600000;0
12699;61411;718;0;0;0;0;.00nan;0;0
12699;76486;716;80;37;3;34;.919;3570000;0
12700;6603;717;0;0;0;0;.00nan;0;0
12700;168414;717;71;33;3;30;.909;3549000;0
12700;55932;2188;0;0;0;0;.00nan;0;0
12700;86283;2188;63;17;1;16;.941;3600000;0
12701;55918;721;0;0;0;0;.00nan;0;0
12701;77009;721;100;43;1;42;.977;3600000;0
12701;77011;719;0;0;0;0;.00nan;0;0
12701;78587;719;70;26;2;24;.923;3600000;0
12702;56048;2529;26;34;7;27;.794;3247000;0
12702;61170;720;48;33;5;28;.848;3600000;0
12702;62392;720;0;0;0;0;.00nan;0;0
12702;67910;2529;65;9;0;9;1.000;335000;0
12703;173840;718;72;36;3;33;.917;3573000;0
12703;55932;2188;0;0;0;0;.00nan;0;0
12703;61411;718;0;0;0;0;.00nan;0;0
12703;86283;2188;68;24;2;22;.917;3600000;0
12704;161540;716;0;0;0;0;.00nan;0;0
12704;55918;721;63;36;4;32;.889;3600000;0
12704;76486;716;82;27;1;26;.963;3600000;0
12704;77009;721;0;0;0;0;.00nan;0;0
12705;6603;717;64;31;3;28;.903;3900000;0
12705;168414;717;0;0;0;0;.00nan;0;0
12705;56048;2529;53;24;3;21;.875;3900000;0
12705;67910;2529;0;0;0;0;.00nan;0;0
12706;168089;715;64;27;3;24;.889;3900000;0
12706;77011;719;0;0;0;0;.00nan;0;0
12706;78587;719;79;41;3;38;.927;3900000;0
12706;161163;715;0;0;0;0;.00nan;0;0
12707;173840;718;62;31;3;28;.903;3569000;0
12707;56048;2529;84;22;1;21;.955;3600000;0
12707;61411;718;0;0;0;0;.00nan;0;0
12707;67910;2529;0;0;0;0;.00nan;0;0
12708;6603;717;70;29;3;26;.897;3900000;0
12708;168414;717;0;0;0;0;.00nan;0;0
12708;61170;720;79;30;3;27;.900;3900000;0
12708;62392;720;0;0;0;0;.00nan;0;0
12709;55918;721;0;0;0;0;.00nan;0;0
12709;55932;2188;0;0;0;0;.00nan;0;0
12709;77009;721;76;38;3;35;.921;3600000;0
12709;86283;2188;93;20;0;20;1.000;3600000;0
12710;161540;716;0;0;0;0;.00nan;0;0
12710;168089;715;52;20;3;17;.850;3600000;0
12710;76486;716;50;24;4;20;.833;3574000;0
12710;161163;715;0;0;0;0;.00nan;0;0
12711;168089;715;51;23;4;19;.826;3679000;0
12711;55932;2188;0;0;0;0;.00nan;0;0
12711;86283;2188;83;34;3;31;.912;3679000;0
12711;161163;715;0;0;0;0;.00nan;0;0
12712;161540;716;72;14;0;14;1.000;2516000;0
12712;76486;716;14;5;4;1;.200;1031000;0
12712;77011;719;0;0;0;0;.00nan;0;0
12712;78587;719;86;34;2;32;.941;3600000;0
12713;55918;721;94;41;2;39;.951;3600000;0
12713;56048;2529;65;29;3;26;.897;3600000;0
12713;67910;2529;0;0;0;0;.00nan;0;0
12713;77009;721;0;0;0;0;.00nan;0;0
12714;173840;718;46;28;4;24;.857;3527000;0
12714;61170;720;99;45;2;43;.956;3600000;0
12714;61411;718;0;0;0;0;.00nan;0;0
12714;62392;720;0;0;0;0;.00nan;0;0
12715;6603;717;44;21;4;17;.810;1036000;0
12715;168414;717;64;28;2;26;.929;2507000;0
12715;173840;718;42;30;5;25;.833;3600000;0
12715;61411;718;0;0;0;0;.00nan;0;0
12716;55918;721;39;7;2;5;.714;958000;0
12716;61170;720;70;27;2;25;.926;3600000;0
12716;62392;720;0;0;0;0;.00nan;0;0
12716;77009;721;27;25;6;19;.760;2642000;0
12717;168089;715;0;0;0;0;.00nan;0;0
12717;56048;2529;58;24;2;22;.917;3600000;0
12717;67910;2529;0;0;0;0;.00nan;0;0
12717;161163;715;55;22;3;19;.864;3576000;0
12718;55932;2188;0;0;0;0;.00nan;0;0
12718;77011;719;0;0;0;0;.00nan;0;0
12718;78587;719;76;34;3;31;.912;3600000;0
12718;86283;2188;66;18;1;17;.944;3600000;0
12719;161540;716;0;0;0;0;.00nan;0;0
12719;55932;2188;0;0;0;0;.00nan;0;0
12719;76486;716;78;36;2;34;.944;3600000;0
12719;86283;2188;50;23;3;20;.870;3567000;0
12720;6603;717;81;38;3;35;.921;3554000;0
12720;168414;717;0;0;0;0;.00nan;0;0
12720;55918;721;91;38;2;36;.947;3600000;0
12720;77009;721;0;0;0;0;.00nan;0;0
12721;56048;2529;58;21;2;19;.905;3600000;0
12721;67910;2529;0;0;0;0;.00nan;0;0
12721;77011;719;71;16;0;16;1.000;1330000;0
12721;78587;719;20;25;6;19;.760;2270000;0
12722;168089;715;71;27;3;24;.889;3816000;0
12722;61170;720;83;38;2;36;.947;3816000;0
12722;62392;720;0;0;0;0;.00nan;0;0
12722;161163;715;0;0;0;0;.00nan;0;0
12726;55932;720;0;0;0;0;.00nan;0;0
12726;61170;720;70;28;2;26;.929;3600000;0
12726;62392;719;0;0;0;0;.00nan;0;0
12726;78587;719;45;24;5;19;.792;3600000;0
12728;6603;717;48;31;4;27;.871;3900000;0
12728;168414;717;0;0;0;0;.00nan;0;0
12728;77011;2188;0;0;0;0;.00nan;0;0
12728;86283;2188;50;25;4;21;.840;3900000;0
12730;173840;718;53;33;4;29;.879;3600000;0
12730;31122;721;0;0;0;0;.00nan;0;0
12730;61411;718;0;0;0;0;.00nan;0;0
12730;77009;721;100;29;0;29;1.000;3600000;0
12732;173840;718;91;38;1;37;.974;3600000;0
12732;56598;716;0;0;0;0;.00nan;0;0
12732;61411;718;0;0;0;0;.00nan;0;0
12732;76486;716;62;32;4;28;.875;3600000;0
12734;6603;717;76;25;1;24;.960;3600000;0
12734;168414;717;0;0;0;0;.00nan;0;0
12734;61170;720;63;22;2;20;.909;3552000;0
12734;62392;720;0;0;0;0;.00nan;0;0
12738;55932;2188;0;0;0;0;.00nan;0;0
12738;56048;2529;79;23;1;22;.957;3600000;0
12738;67910;2529;0;0;0;0;.00nan;0;0
12738;86283;2188;58;36;4;32;.889;3600000;0
12740;61170;720;0;0;0;0;.00nan;0;0
12740;62392;720;48;31;5;26;.839;3514000;0
12740;77011;719;0;0;0;0;.00nan;0;0
12740;78587;719;54;24;3;21;.875;3600000;0
12742;55932;2188;69;26;2;24;.923;3543000;0
12742;56048;2529;0;0;0;0;.00nan;0;0
12742;67910;2529;65;19;1;18;.947;3600000;0
12742;86283;2188;0;0;0;0;.00nan;0;0
12746;173840;718;0;0;0;0;.00nan;0;0
12746;55918;721;0;0;0;0;.00nan;0;0
12746;61411;718;54;15;2;13;.867;3600000;0
12746;77009;721;38;28;5;23;.821;3600000;0
12748;55932;2188;0;0;0;0;.00nan;0;0
12748;61170;720;67;28;3;25;.893;3900000;0
12748;62392;720;0;0;0;0;.00nan;0;0
12748;86283;2188;54;27;3;24;.889;3900000;0
12750;6603;717;26;35;7;28;.800;3600000;0
12750;168414;717;0;0;0;0;.00nan;0;0
12750;77011;719;0;0;0;0;.00nan;0;0
12750;78587;719;75;31;2;29;.935;3600000;0
12752;173840;718;91;21;0;21;1.000;3600000;0
12752;55918;721;71;34;4;30;.882;3600000;0
12752;61411;718;0;0;0;0;.00nan;0;0
12752;77009;721;0;0;0;0;.00nan;0;0
12754;56048;2529;73;30;2;28;.933;3600000;0
12754;56598;716;0;0;0;0;.00nan;0;0
12754;67910;2529;0;0;0;0;.00nan;0;0
12754;76486;716;77;41;3;38;.927;3600000;0
12756;55918;721;0;0;0;0;.00nan;0;0
12756;77009;721;89;31;1;30;.968;3600000;0
12756;77011;719;0;0;0;0;.00nan;0;0
12756;78587;719;54;23;3;20;.870;3572000;0
12758;6603;717;0;0;0;0;.00nan;0;0
12758;168414;717;62;33;5;28;.848;3542000;0
12758;61170;720;0;0;0;0;.00nan;0;0
12758;62392;720;56;35;4;31;.886;3600000;0
12760;173840;718;46;25;3;22;.880;3600000;0
12760;56598;716;83;33;1;32;.970;3600000;0
12760;61411;718;0;0;0;0;.00nan;0;0
12760;76486;716;0;0;0;0;.00nan;0;0
12762;168089;715;85;32;2;30;.938;3600000;0
12762;55932;2188;40;28;5;23;.821;3600000;0
12762;68948;715;0;0;0;0;.00nan;0;0
12762;86283;2188;0;0;0;0;.00nan;0;0
552;161540;716;0;0;0;0;.00nan;0;0
552;168089;715;82;13;0;13;1.000;3600000;0
552;76486;716;71;40;4;36;.900;3600000;0
552;161163;715;0;0;0;0;.00nan;0;0
553;173840;718;65;25;2;23;.920;3900000;0
553;56048;2529;64;23;2;21;.913;3900000;0
553;61411;718;0;0;0;0;.00nan;0;0
553;67910;2529;0;0;0;0;.00nan;0;0
554;161540;716;0;0;0;0;.00nan;0;0
554;55932;2188;0;0;0;0;.00nan;0;0
554;76486;716;70;37;4;33;.892;3600000;0
554;86283;2188;39;35;6;29;.829;3588000;0
555;168089;715;77;28;1;27;.964;3600000;0
555;56048;2529;74;32;2;30;.938;3577000;0
555;67910;2529;0;0;0;0;.00nan;0;0
555;161163;715;0;0;0;0;.00nan;0;0
556;173840;718;0;0;0;0;.00nan;0;0
556;55932;2188;0;0;0;0;.00nan;0;0
556;61411;718;100;47;2;45;.957;3600000;0
556;86283;2188;43;30;5;25;.833;3600000;0
557;161540;716;0;0;0;0;.00nan;0;0
557;56048;2529;71;25;2;23;.920;3600000;0
557;67910;2529;0;0;0;0;.00nan;0;0
557;76486;716;70;28;3;25;.893;3572000;0
558;55932;2188;0;0;0;0;.00nan;0;0
558;56048;2529;73;24;1;23;.958;3900000;0
558;67910;2529;0;0;0;0;.00nan;0;0
558;86283;2188;82;27;1;26;.963;3900000;0
559;168089;715;45;26;4;22;.846;3829000;0
559;173840;718;78;34;3;31;.912;3829000;0
559;61411;718;0;0;0;0;.00nan;0;0
559;161163;715;0;0;0;0;.00nan;0;0
560;168089;715;90;31;1;30;.968;3600000;0
560;55932;2188;65;19;1;18;.947;2817000;0
560;86283;2188;18;10;4;6;.600;783000;0
560;161163;715;0;0;0;0;.00nan;0;0
561;161540;716;0;0;0;0;.00nan;0;0
561;173840;718;66;28;3;25;.893;3600000;0
561;61411;718;0;0;0;0;.00nan;0;0
561;76486;716;20;29;7;22;.759;3600000;0
562;161540;716;58;7;0;7;1.000;687000;0
562;168089;715;0;0;0;0;.00nan;0;0
562;76486;716;40;36;7;29;.806;2913000;0
562;161163;715;63;21;2;19;.905;3600000;0
563;173840;718;83;32;2;30;.938;3555000;0
563;56048;2529;87;33;1;32;.970;3600000;0
563;61411;718;0;0;0;0;.00nan;0;0
563;67910;2529;0;0;0;0;.00nan;0;0
564;161540;716;0;0;0;0;.00nan;0;0
564;55932;2188;0;0;0;0;.00nan;0;0
564;76486;716;47;14;2;12;.857;3600000;0
564;86283;2188;100;24;0;24;1.000;3600000;0
565;168089;715;71;21;1;20;.952;3600000;0
565;56048;2529;57;34;4;30;.882;3600000;0
565;67910;2529;0;0;0;0;.00nan;0;0
565;161163;715;0;0;0;0;.00nan;0;0
566;173840;718;59;38;4;34;.895;3600000;0
566;55932;2188;0;0;0;0;.00nan;0;0
566;61411;718;0;0;0;0;.00nan;0;0
566;86283;2188;100;25;0;25;1.000;3600000;0
567;161540;716;0;0;0;0;.00nan;0;0
567;56048;2529;96;42;2;40;.952;3556000;0
567;67910;2529;0;0;0;0;.00nan;0;0
567;76486;716;100;22;0;22;1.000;3600000;0
568;55932;2188;0;0;0;0;.00nan;0;0
568;56048;2529;67;17;1;16;.941;3600000;0
568;67910;2529;0;0;0;0;.00nan;0;0
568;86283;2188;38;27;5;22;.815;3600000;0
569;168089;715;62;21;2;19;.905;3600000;0
569;173840;718;54;32;4;28;.875;3526000;0
569;61411;718;0;0;0;0;.00nan;0;0
569;161163;715;0;0;0;0;.00nan;0;0
570;168089;715;42;25;5;20;.800;3514000;0
570;55932;2188;0;0;0;0;.00nan;0;0
570;86283;2188;72;32;3;29;.906;3600000;0
570;161163;715;0;0;0;0;.00nan;0;0
571;161540;716;0;0;0;0;.00nan;0;0
571;173840;718;55;31;4;27;.871;3600000;0
571;61411;718;0;0;0;0;.00nan;0;0
571;76486;716;75;22;1;21;.955;3600000;0
572;55918;721;0;0;0;0;.00nan;0;0
572;61170;720;79;44;5;39;.886;3900000;0
572;62392;720;0;0;0;0;.00nan;0;0
572;77009;721;52;39;5;34;.872;3900000;0
573;6603;717;59;23;2;21;.913;3600000;0
573;168414;717;0;0;0;0;.00nan;0;0
573;77011;719;0;0;0;0;.00nan;0;0
573;78587;719;91;33;1;32;.970;3600000;0
574;61170;720;0;0;0;0;.00nan;0;0
574;62392;720;39;27;5;22;.815;3600000;0
574;77011;719;0;0;0;0;.00nan;0;0
574;78587;719;78;24;2;22;.917;3600000;0
575;6603;717;92;21;0;21;1.000;3600000;0
575;168414;717;0;0;0;0;.00nan;0;0
575;55918;721;97;33;1;32;.970;3555000;0
575;77009;721;0;0;0;0;.00nan;0;0
576;6603;717;42;15;3;12;.800;3600000;0
576;168414;717;0;0;0;0;.00nan;0;0
576;61170;720;51;47;7;40;.851;3600000;0
576;62392;720;0;0;0;0;.00nan;0;0
577;55918;721;0;0;0;0;.00nan;0;0
577;77009;721;88;37;1;36;.973;3600000;0
577;77011;719;0;0;0;0;.00nan;0;0
577;78587;719;62;30;3;27;.900;3537000;0
578;55918;721;99;34;1;33;.971;3600000;0
578;61170;720;33;20;4;16;.800;3600000;0
578;62392;720;0;0;0;0;.00nan;0;0
578;77009;721;0;0;0;0;.00nan;0;0
579;6603;717;72;26;2;24;.923;3600000;0
579;168414;717;0;0;0;0;.00nan;0;0
579;77011;719;0;0;0;0;.00nan;0;0
579;78587;719;90;33;1;32;.970;3600000;0
580;61170;720;83;26;1;25;.962;3600000;0
580;62392;720;0;0;0;0;.00nan;0;0
580;77011;719;17;17;5;12;.706;3600000;0
580;78587;719;0;0;0;0;.00nan;0;0
581;6603;717;0;0;0;0;.00nan;0;0
581;168414;717;61;32;3;29;.906;3887000;0
581;55918;721;0;0;0;0;.00nan;0;0
581;77009;721;43;23;4;19;.826;3887000;0
582;6603;717;80;25;1;24;.960;3549000;0
582;168414;717;0;0;0;0;.00nan;0;0
582;61170;720;100;35;0;35;1.000;3600000;0
582;62392;720;0;0;0;0;.00nan;0;0
583;55918;721;83;31;2;29;.935;3900000;0
583;77009;721;0;0;0;0;.00nan;0;0
583;77011;719;0;0;0;0;.00nan;0;0
583;78587;719;60;18;2;16;.889;3900000;0
864;55932;2188;0;0;0;0;.00nan;0;0
864;77011;719;0;0;0;0;.00nan;0;0
864;78587;719;92;34;2;32;.941;3961000;0
864;86283;2188;75;24;1;23;.958;3961000;0
865;6603;717;74;31;2;29;.935;3569000;0
865;168089;715;99;24;0;24;1.000;3600000;0
865;168414;717;0;0;0;0;.00nan;0;0
865;161163;715;0;0;0;0;.00nan;0;0
866;56048;2529;57;15;1;14;.933;3600000;0
866;61170;720;62;36;4;32;.889;3600000;0
866;62392;720;0;0;0;0;.00nan;0;0
866;67910;2529;0;0;0;0;.00nan;0;0
867;161540;716;0;0;0;0;.00nan;0;0
867;173840;718;99;37;1;36;.973;3600000;0
867;61411;718;0;0;0;0;.00nan;0;0
867;76486;716;74;29;2;27;.931;3559000;0
868;55932;2188;0;0;0;0;.00nan;0;0
868;77011;719;0;0;0;0;.00nan;0;0
868;78587;719;53;33;5;28;.848;3600000;0
868;86283;2188;19;19;6;13;.684;3577000;0
869;6603;717;89;49;3;46;.939;3566000;0
869;168089;715;81;27;1;26;.963;3600000;0
869;168414;717;0;0;0;0;.00nan;0;0
869;161163;715;0;0;0;0;.00nan;0;0
870;56048;2529;48;40;6;34;.850;3600000;0
870;61170;720;98;41;2;39;.951;3600000;0
870;62392;720;0;0;0;0;.00nan;0;0
870;67910;2529;0;0;0;0;.00nan;0;0
871;161540;716;44;25;4;21;.840;3594000;0
871;173840;718;75;32;3;29;.906;3600000;0
871;61411;718;0;0;0;0;.00nan;0;0
871;76486;716;0;0;0;0;.00nan;0;0
872;55932;2188;0;0;0;0;.00nan;0;0
872;77011;719;0;0;0;0;.00nan;0;0
872;78587;719;74;30;2;28;.933;3914000;0
872;86283;2188;74;22;1;21;.955;3914000;0
873;6603;717;82;31;2;29;.935;3990000;0
873;168089;715;84;29;1;28;.966;3990000;0
873;168414;717;0;0;0;0;.00nan;0;0
873;161163;715;0;0;0;0;.00nan;0;0
874;56048;2529;87;14;0;14;1.000;3600000;0
874;61170;720;98;61;4;57;.934;3600000;0
874;62392;720;0;0;0;0;.00nan;0;0
874;67910;2529;0;0;0;0;.00nan;0;0
875;161540;716;80;17;0;17;1.000;3600000;0
875;173840;718;46;26;4;22;.846;3600000;0
875;61411;718;0;0;0;0;.00nan;0;0
875;76486;716;0;0;0;0;.00nan;0;0
876;55932;2188;0;0;0;0;.00nan;0;0
876;77011;719;0;0;0;0;.00nan;0;0
876;78587;719;82;38;3;35;.921;3578000;0
876;86283;2188;71;18;1;17;.944;3600000;0
877;6603;717;28;29;6;23;.793;3063000;0
877;168089;715;100;36;1;35;.972;3600000;0
877;168414;717;50;8;1;7;.875;537000;0
877;161163;715;0;0;0;0;.00nan;0;0
878;56048;2529;95;17;0;17;1.000;3600000;0
878;61170;720;64;38;4;34;.895;3600000;0
878;62392;720;0;0;0;0;.00nan;0;0
878;67910;2529;0;0;0;0;.00nan;0;0
879;161540;716;63;21;2;19;.905;3836000;0
879;173840;718;94;39;3;36;.923;3836000;0
879;61411;718;0;0;0;0;.00nan;0;0
879;76486;716;0;0;0;0;.00nan;0;0
1060;55932;2188;0;0;0;0;.00nan;0;0
1060;77011;719;0;0;0;0;.00nan;0;0
1060;78587;719;85;38;2;36;.947;3600000;0
1060;86283;2188;43;25;4;21;.840;3554000;0
1061;56048;2529;60;13;1;12;.923;3600000;0
1061;61170;720;63;44;5;39;.886;3600000;0
1061;62392;720;0;0;0;0;.00nan;0;0
1061;67910;2529;0;0;0;0;.00nan;0;0
1062;161540;716;26;26;6;20;.769;2089000;0
1062;173840;718;76;29;2;27;.931;3600000;0
1062;61411;718;0;0;0;0;.00nan;0;0
1062;76486;716;47;13;2;11;.846;1511000;0
1122;55932;2188;0;0;0;0;.00nan;0;0
1122;77011;719;0;0;0;0;.00nan;0;0
1122;78587;719;66;33;3;30;.909;3600000;0
1122;86283;2188;50;22;4;18;.818;3544000;0
1123;161540;716;0;0;0;0;.00nan;0;0
1123;173840;718;30;28;6;22;.786;2974000;0
1123;61411;718;60;9;0;9;1.000;626000;0
1123;76486;716;63;17;1;16;.941;3600000;0
1214;55932;2188;0;0;0;0;.00nan;0;0
1214;77011;719;0;0;0;0;.00nan;0;0
1214;78587;719;100;44;0;44;1.000;3600000;0
1214;86283;2188;68;19;1;18;.947;3559000;0
1215;161540;716;0;0;0;0;.00nan;0;0
1215;173840;718;59;19;2;17;.895;3847000;0
1215;61411;718;0;0;0;0;.00nan;0;0
1215;76486;716;66;30;3;27;.900;3847000;0
1323;168089;715;80;24;1;23;.958;3600000;0
1323;77011;719;0;0;0;0;.00nan;0;0
1323;78587;719;89;37;2;35;.946;3590000;0
1323;161163;715;0;0;0;0;.00nan;0;0
1324;173840;718;62;41;5;36;.878;3537000;0
1324;56048;2529;81;38;3;35;.921;3600000;0
1324;61411;718;0;0;0;0;.00nan;0;0
1324;67910;2529;0;0;0;0;.00nan;0;0
1325;168089;715;46;22;4;18;.818;3600000;0
1325;77011;719;0;0;0;0;.00nan;0;0
1325;78587;719;61;38;5;33;.868;3554000;0
1325;161163;715;0;0;0;0;.00nan;0;0
1326;173840;718;75;36;3;33;.917;3600000;0
1326;56048;2529;85;22;1;21;.955;3600000;0
1326;61411;718;0;0;0;0;.00nan;0;0
1326;67910;2529;0;0;0;0;.00nan;0;0
1327;168089;715;66;31;3;28;.903;5588000;0
1327;77011;719;0;0;0;0;.00nan;0;0
1327;78587;719;92;67;4;63;.940;5588000;0
1327;161163;715;0;0;0;0;.00nan;0;0
1328;173840;718;56;35;4;31;.886;3517000;0
1328;56048;2529;85;29;2;27;.931;3600000;0
1328;61411;718;0;0;0;0;.00nan;0;0
1328;67910;2529;0;0;0;0;.00nan;0;0
1329;168089;715;71;32;3;29;.906;3569000;0
1329;77011;719;0;0;0;0;.00nan;0;0
1329;78587;719;85;32;2;30;.938;3600000;0
1329;161163;715;0;0;0;0;.00nan;0;0
1330;173840;718;46;37;6;31;.838;2969000;0
1330;56048;2529;91;16;0;16;1.000;3600000;0
1330;61411;718;58;5;0;5;1.000;631000;0
1330;67910;2529;0;0;0;0;.00nan;0;0
1587;168089;715;60;23;2;21;.913;3600000;0
1587;77011;719;0;0;0;0;.00nan;0;0
1587;78587;719;84;35;3;32;.914;3578000;0
1587;161163;715;0;0;0;0;.00nan;0;0
1621;168089;715;93;34;3;31;.912;3545000;0
1621;56048;2529;89;36;2;34;.944;3600000;0
1621;67910;2529;0;0;0;0;.00nan;0;0
1621;161163;715;0;0;0;0;.00nan;0;0
1622;168089;715;38;25;5;20;.800;3600000;0
1622;56048;2529;74;27;2;25;.926;3600000;0
1622;67910;2529;0;0;0;0;.00nan;0;0
1622;161163;715;0;0;0;0;.00nan;0;0
1623;168089;715;86;32;1;31;.969;4302000;0
1623;56048;2529;92;35;2;33;.943;4302000;0
1623;67910;2529;0;0;0;0;.00nan;0;0
1623;161163;715;0;0;0;0;.00nan;0;0
1624;168089;715;46;27;4;23;.852;3522000;0
1624;56048;2529;72;24;2;22;.917;3600000;0
1624;67910;2529;0;0;0;0;.00nan;0;0
1624;161163;715;0;0;0;0;.00nan;0;0
1887;168089;715;70;35;3;32;.914;3577000;0
1887;56048;2529;91;37;2;35;.946;3600000;0
1887;67910;2529;0;0;0;0;.00nan;0;0
1887;161163;715;0;0;0;0;.00nan;0;0
12763;38369;474;73;30;3;27;.900;3600000;0
12763;44200;490;68;34;4;30;.882;3600000;0
12763;53870;490;0;0;0;0;.00nan;0;0
12763;66491;474;0;0;0;0;.00nan;0;0
12764;3713;675;58;28;4;24;.857;3580000;0
12764;11500;5004;0;0;0;0;.00nan;0;0
12764;46318;5004;100;40;2;38;.950;3600000;0
12764;149969;675;0;0;0;0;.00nan;0;0
12765;55864;476;76;26;2;24;.923;3030000;0
12765;78153;676;0;0;0;0;.00nan;0;0
12765;86343;476;19;10;4;6;.600;515000;0
12765;86347;676;56;33;5;28;.848;3600000;0
12766;183421;4535;0;0;0;0;.00nan;0;0
12766;12048;4535;92;63;3;60;.952;4003000;0
12766;46139;482;0;0;0;0;.00nan;0;0
12766;67222;482;73;21;2;19;.905;4003000;0
12767;168021;473;94;45;2;43;.956;3600000;0
12767;-1;480;82;28;1;27;.964;3600000;0
12767;66551;480;0;0;0;0;.00nan;0;0
12767;85127;473;0;0;0;0;.00nan;0;0
12768;18169;682;66;49;6;43;.878;3600000;0
12768;190235;481;0;0;0;0;.00nan;0;0
12768;44032;682;0;0;0;0;.00nan;0;0
12768;56296;481;47;19;3;16;.842;3600000;0
12769;168021;473;56;15;2;13;.867;3600000;0
12769;44200;490;64;48;5;43;.896;3600000;0
12769;53870;490;0;0;0;0;.00nan;0;0
12769;85127;473;0;0;0;0;.00nan;0;0
12770;162846;472;0;0;0;0;.00nan;0;0
12770;174407;472;70;22;1;21;.955;3600000;0
12770;78153;676;0;0;0;0;.00nan;0;0
12770;86347;676;54;24;3;21;.875;3600000;0
12771;3713;675;42;3;1;2;.667;556000;0
12771;46139;482;75;35;4;31;.886;3600000;0
12771;67222;482;0;0;0;0;.00nan;0;0
12771;149969;675;22;28;6;22;.786;3044000;0
12772;18169;682;89;41;2;39;.951;3551000;0
12772;-1;480;78;28;1;27;.964;3600000;0
12772;44032;682;0;0;0;0;.00nan;0;0
12772;66551;480;0;0;0;0;.00nan;0;0
12773;11500;5004;47;29;5;24;.828;3723000;0
12773;46318;5004;0;0;0;0;.00nan;0;0
12773;55864;476;0;0;0;0;.00nan;0;0
12773;86343;476;55;35;4;31;.886;3701000;0
12774;190235;481;47;12;2;10;.833;3600000;0
12774;38369;474;88;44;4;40;.909;3561000;0
12774;56296;481;0;0;0;0;.00nan;0;0
12774;66491;474;0;0;0;0;.00nan;0;0
12775;162846;472;0;0;0;0;.00nan;0;0
12775;168021;473;72;23;1;22;.957;3600000;0
12775;174407;472;63;25;2;23;.920;3558000;0
12775;85127;473;0;0;0;0;.00nan;0;0
12776;183421;4535;0;0;0;0;.00nan;0;0
12776;12048;4535;53;37;5;32;.865;4005000;0
12776;168021;473;32;28;6;22;.786;4005000;0
12776;85127;473;0;0;0;0;.00nan;0;0
12777;44200;490;62;39;4;35;.897;3600000;0
12777;46139;482;58;14;1;13;.929;3600000;0
12777;53870;490;0;0;0;0;.00nan;0;0
12777;67222;482;0;0;0;0;.00nan;0;0
12778;3713;675;0;0;0;0;.00nan;0;0
12778;55864;476;0;0;0;0;.00nan;0;0
12778;86343;476;68;19;1;18;.947;3600000;0
12778;149969;675;50;37;5;32;.865;3600000;0
12779;18169;682;39;20;4;16;.800;3600000;0
12779;38369;474;54;35;5;30;.857;3600000;0
12779;44032;682;0;0;0;0;.00nan;0;0
12779;66491;474;0;0;0;0;.00nan;0;0
12780;162846;472;0;0;0;0;.00nan;0;0
12780;174407;472;35;27;5;22;.815;3600000;0
12780;-1;480;63;18;1;17;.944;3600000;0
12780;66551;480;0;0;0;0;.00nan;0;0
12781;190235;481;0;0;0;0;.00nan;0;0
12781;56296;481;85;22;1;21;.955;3717000;0
12781;78153;676;0;0;0;0;.00nan;0;0
12781;86347;676;92;31;2;29;.935;3717000;0
12782;-1;480;54;27;4;23;.852;3600000;0
12782;55864;476;41;33;6;27;.818;3073000;0
12782;66551;480;0;0;0;0;.00nan;0;0
12782;86343;476;55;3;0;3;1.000;455000;0
12783;168021;473;90;21;0;21;1.000;3600000;0
12783;38369;474;48;33;5;28;.848;2155000;0
12783;66491;474;49;24;3;21;.875;1445000;0
12783;85127;473;0;0;0;0;.00nan;0;0
12784;18169;682;0;0;0;0;.00nan;0;0
12784;44032;682;75;32;3;29;.906;3513000;0
12784;78153;676;0;0;0;0;.00nan;0;0
12784;86347;676;63;18;1;17;.944;3600000;0
12785;183421;4535;0;0;0;0;.00nan;0;0
12785;12048;4535;60;18;2;16;.889;3600000;0
12785;44200;490;82;36;3;33;.917;3587000;0
12785;53870;490;0;0;0;0;.00nan;0;0
12786;190235;481;0;0;0;0;.00nan;0;0
12786;46139;482;92;18;0;18;1.000;3600000;0
12786;56296;481;73;35;3;32;.914;3600000;0
12786;67222;482;0;0;0;0;.00nan;0;0
12787;162846;472;0;0;0;0;.00nan;0;0
12787;11500;5004;65;27;3;24;.889;3600000;0
12787;174407;472;59;32;4;28;.875;3557000;0
12787;46318;5004;0;0;0;0;.00nan;0;0
12788;168021;473;62;30;3;27;.900;3600000;0
12788;55864;476;92;26;0;26;1.000;2851000;0
12788;85127;473;0;0;0;0;.00nan;0;0
12788;86343;476;19;10;4;6;.600;749000;0
12789;3713;675;0;0;0;0;.00nan;0;0
12789;44200;490;69;40;5;35;.875;3600000;0
12789;53870;490;0;0;0;0;.00nan;0;0
12789;149969;675;52;13;2;11;.846;3600000;0
12790;-1;480;87;42;1;41;.976;3600000;0
12790;46139;482;64;24;2;22;.917;3549000;0
12790;66551;480;0;0;0;0;.00nan;0;0
12790;67222;482;0;0;0;0;.00nan;0;0
12791;183421;4535;0;0;0;0;.00nan;0;0
12791;12048;4535;51;35;5;30;.857;3600000;0
12791;18169;682;65;28;3;25;.893;3600000;0
12791;44032;682;0;0;0;0;.00nan;0;0
12792;162846;472;0;0;0;0;.00nan;0;0
12792;174407;472;61;11;1;10;.909;3600000;0
12792;38369;474;88;43;4;39;.907;3600000;0
12792;66491;474;0;0;0;0;.00nan;0;0
12793;11500;5004;83;47;5;42;.894;3600000;0
12793;190235;481;69;19;1;18;.947;3600000;0
12793;46318;5004;0;0;0;0;.00nan;0;0
12793;56296;481;0;0;0;0;.00nan;0;0
12794;168021;473;57;17;2;15;.882;3600000;0
12794;18169;682;64;26;3;23;.885;3561000;0
12794;44032;682;0;0;0;0;.00nan;0;0
12794;85127;473;0;0;0;0;.00nan;0;0
12795;3713;675;0;0;0;0;.00nan;0;0
12795;-1;480;48;12;2;10;.833;3600000;0
12795;66551;480;0;0;0;0;.00nan;0;0
12795;149969;675;30;47;8;39;.830;3600000;0
12796;190235;481;85;25;1;24;.960;3316000;0
12796;55864;476;0;0;0;0;.00nan;0;0
12796;56296;481;25;6;3;3;.500;264000;0
12796;86343;476;69;26;2;24;.923;3600000;0
12797;183421;4535;39;10;3;7;.700;812000;0
12797;12048;4535;41;41;6;35;.854;2788000;0
12797;78153;676;0;0;0;0;.00nan;0;0
12797;86347;676;44;24;4;20;.833;3600000;0
12798;162846;472;0;0;0;0;.00nan;0;0
12798;174407;472;61;31;3;28;.903;3600000;0
12798;46139;482;84;17;0;17;1.000;3600000;0
12798;67222;482;0;0;0;0;.00nan;0;0
12799;11500;5004;72;21;1;20;.952;3600000;0
12799;44200;490;96;46;3;43;.935;3600000;0
12799;46318;5004;0;0;0;0;.00nan;0;0
12799;53870;490;0;0;0;0;.00nan;0;0
12800;-1;480;0;0;0;0;.00nan;0;0
12800;44200;490;95;57;4;53;.930;3600000;0
12800;53870;490;0;0;0;0;.00nan;0;0
12800;66551;480;64;10;1;9;.900;3600000;0
12801;38369;474;83;45;4;41;.911;3600000;0
12801;66491;474;0;0;0;0;.00nan;0;0
12801;78153;676;0;0;0;0;.00nan;0;0
12801;86347;676;52;8;1;7;.875;3600000;0
12802;3713;675;24;12;4;8;.667;1108000;0
12802;190235;481;0;0;0;0;.00nan;0;0
12802;56296;481;65;27;3;24;.889;3600000;0
12802;149969;675;62;21;2;19;.905;2492000;0
12803;18169;682;76;30;2;28;.933;3600000;0
12803;44032;682;0;0;0;0;.00nan;0;0
12803;55864;476;0;0;0;0;.00nan;0;0
12803;86343;476;56;34;3;31;.912;3546000;0
12804;11500;5004;0;0;0;0;.00nan;0;0
12804;46139;482;87;18;0;18;1.000;3600000;0
12804;46318;5004;76;57;6;51;.895;3600000;0
12804;67222;482;0;0;0;0;.00nan;0;0
12805;162846;472;0;0;0;0;.00nan;0;0
12805;183421;4535;0;0;0;0;.00nan;0;0
12805;12048;4535;100;45;0;45;1.000;3600000;0
12805;174407;472;70;23;2;21;.913;3515000;0
12806;3713;675;0;0;0;0;.00nan;0;0
12806;38369;474;70;43;5;38;.884;3600000;0
12806;66491;474;0;0;0;0;.00nan;0;0
12806;149969;675;48;14;2;12;.857;3600000;0
12807;11500;5004;57;34;4;30;.882;3558000;0
12807;183421;4535;0;0;0;0;.00nan;0;0
12807;12048;4535;58;19;2;17;.895;3600000;0
12807;46318;5004;0;0;0;0;.00nan;0;0
12808;18169;682;63;31;4;27;.871;3600000;0
12808;44032;682;0;0;0;0;.00nan;0;0
12808;46139;482;80;29;1;28;.966;3600000;0
12808;67222;482;0;0;0;0;.00nan;0;0
12809;-1;480;68;25;2;23;.920;3989000;0
12809;66551;480;0;0;0;0;.00nan;0;0
12809;78153;676;0;0;0;0;.00nan;0;0
12809;86347;676;55;28;3;25;.893;3989000;0
12810;162846;472;0;0;0;0;.00nan;0;0
12810;174407;472;85;15;0;15;1.000;3600000;0
12810;44200;490;19;28;7;21;.750;1989000;0
12810;53870;490;46;20;3;17;.850;1611000;0
12811;168021;473;78;41;3;38;.927;3600000;0
12811;190235;481;0;0;0;0;.00nan;0;0
12811;56296;481;100;33;0;33;1.000;3600000;0
12811;85127;473;0;0;0;0;.00nan;0;0
12812;11500;5004;82;27;2;25;.926;3592000;0
12812;38369;474;96;20;0;20;1.000;3600000;0
12812;46318;5004;0;0;0;0;.00nan;0;0
12812;66491;474;0;0;0;0;.00nan;0;0
12813;44200;490;91;51;3;48;.941;3600000;0
12813;53870;490;0;0;0;0;.00nan;0;0
12813;78153;676;0;0;0;0;.00nan;0;0
12813;86347;676;71;18;1;17;.944;3600000;0
12814;46139;482;51;26;4;22;.846;3600000;0
12814;55864;476;99;40;1;39;.975;3600000;0
12814;67222;482;0;0;0;0;.00nan;0;0
12814;86343;476;0;0;0;0;.00nan;0;0
12815;183421;4535;0;0;0;0;.00nan;0;0
12815;12048;4535;70;41;5;36;.878;3600000;0
12815;-1;480;77;22;1;21;.955;3600000;0
12815;66551;480;0;0;0;0;.00nan;0;0
12816;3713;675;38;25;5;20;.800;3336000;0
12816;18169;682;0;0;0;0;.00nan;0;0
12816;44032;682;96;18;0;18;1.000;3600000;0
12816;149969;675;48;0;0;0;.00nan;264000;0
12817;11500;5004;0;0;0;0;.00nan;0;0
12817;168021;473;0;0;0;0;.00nan;0;0
12817;46318;5004;91;46;3;43;.935;3537000;0
12817;85127;473;64;17;1;16;.941;3600000;0
12818;44200;490;70;36;3;33;.917;3568000;0
12818;53870;490;0;0;0;0;.00nan;0;0
12818;55864;476;0;0;0;0;.00nan;0;0
12818;86343;476;72;23;1;22;.957;3600000;0
12819;3713;675;0;0;0;0;.00nan;0;0
12819;78153;676;0;0;0;0;.00nan;0;0
12819;86347;676;67;22;2;20;.909;4020000;0
12819;149969;675;88;32;2;30;.938;4020000;0
12820;183421;4535;0;0;0;0;.00nan;0;0
12820;12048;4535;94;24;0;24;1.000;3600000;0
12820;38369;474;72;35;3;32;.914;3600000;0
12820;66491;474;0;0;0;0;.00nan;0;0
12821;162846;472;0;0;0;0;.00nan;0;0
12821;18169;682;0;0;0;0;.00nan;0;0
12821;174407;472;99;39;1;38;.974;3600000;0
12821;44032;682;38;24;4;20;.833;3600000;0
12822;190235;481;0;0;0;0;.00nan;0;0
12822;-1;480;82;36;2;34;.944;3561000;0
12822;56296;481;87;30;1;29;.967;3600000;0
12822;66551;480;0;0;0;0;.00nan;0;0
12823;55864;476;0;0;0;0;.00nan;0;0
12823;78153;676;0;0;0;0;.00nan;0;0
12823;86343;476;85;29;1;28;.966;3600000;0
12823;86347;676;71;30;2;28;.933;3562000;0
12824;46139;482;44;26;4;22;.846;3526000;0
12824;67222;482;0;0;0;0;.00nan;0;0
12824;78153;676;0;0;0;0;.00nan;0;0
12824;86347;676;66;23;2;21;.913;3600000;0
12825;3713;675;79;32;2;30;.938;2630000;0
12825;168021;473;32;17;4;13;.765;3600000;0
12825;85127;473;0;0;0;0;.00nan;0;0
12825;149969;675;27;13;4;9;.692;887000;0
12826;162846;472;0;0;0;0;.00nan;0;0
12826;174407;472;87;30;1;29;.967;3600000;0
12826;55864;476;0;0;0;0;.00nan;0;0
12826;86343;476;66;27;3;24;.889;3576000;0
12827;183421;4535;0;0;0;0;.00nan;0;0
12827;12048;4535;92;50;4;46;.920;3587000;0
12827;190235;481;0;0;0;0;.00nan;0;0
12827;56296;481;56;27;3;24;.889;3600000;0
12828;11500;5004;0;0;0;0;.00nan;0;0
12828;18169;682;96;20;0;20;1.000;3600000;0
12828;44032;682;0;0;0;0;.00nan;0;0
12828;46318;5004;93;40;2;38;.950;3579000;0
12829;18169;682;62;11;1;10;.909;3600000;0
12829;44032;682;0;0;0;0;.00nan;0;0
12829;44200;490;92;45;2;43;.956;3543000;0
12829;53870;490;0;0;0;0;.00nan;0;0
12830;162846;472;0;0;0;0;.00nan;0;0
12830;174407;472;47;25;4;21;.840;3566000;0
12830;190235;481;73;28;2;26;.929;3600000;0
12830;56296;481;0;0;0;0;.00nan;0;0
12831;38369;474;70;32;3;29;.906;3600000;0
12831;55864;476;0;0;0;0;.00nan;0;0
12831;66491;474;0;0;0;0;.00nan;0;0
12831;86343;476;30;23;5;18;.783;3519000;0
12832;3713;675;0;0;0;0;.00nan;0;0
12832;183421;4535;0;0;0;0;.00nan;0;0
12832;12048;4535;97;41;1;40;.976;3549000;0
12832;149969;675;80;13;0;13;1.000;3600000;0
12833;168021;473;80;34;2;32;.941;3600000;0
12833;46139;482;66;33;3;30;.909;3600000;0
12833;67222;482;0;0;0;0;.00nan;0;0
12833;85127;473;0;0;0;0;.00nan;0;0
12834;11500;5004;86;43;3;40;.930;3600000;0
12834;46318;5004;0;0;0;0;.00nan;0;0
12834;78153;676;0;0;0;0;.00nan;0;0
12834;86347;676;83;14;0;14;1.000;3600000;0
12835;168021;473;82;30;1;29;.967;3600000;0
12835;78153;676;0;0;0;0;.00nan;0;0
12835;85127;473;0;0;0;0;.00nan;0;0
12835;86347;676;79;28;2;26;.929;3581000;0
12836;3713;675;0;0;0;0;.00nan;0;0
12836;162846;472;0;0;0;0;.00nan;0;0
12836;174407;472;52;23;3;20;.870;3544000;0
12836;149969;675;67;23;2;21;.913;3600000;0
12837;183421;4535;46;37;6;31;.838;2777000;0
12837;12048;4535;64;18;1;17;.944;823000;0
12837;55864;476;0;0;0;0;.00nan;0;0
12837;86343;476;82;13;0;13;1.000;3600000;0
12838;38369;474;52;26;4;22;.846;3600000;0
12838;46139;482;75;9;0;9;1.000;3600000;0
12838;66491;474;0;0;0;0;.00nan;0;0
12838;67222;482;0;0;0;0;.00nan;0;0
12839;11500;5004;45;34;6;28;.824;3600000;0
12839;-1;480;100;28;0;28;1.000;3600000;0
12839;46318;5004;0;0;0;0;.00nan;0;0
12839;66551;480;0;0;0;0;.00nan;0;0
12840;190235;481;0;0;0;0;.00nan;0;0
12840;44200;490;24;18;5;13;.722;1823000;0
12840;53870;490;75;29;2;27;.931;1777000;0
12840;56296;481;56;18;2;16;.889;3600000;0
12841;-1;480;65;24;2;22;.917;3600000;0
12841;44200;490;73;39;4;35;.897;2118000;0
12841;53870;490;77;24;1;23;.958;1482000;0
12841;66551;480;0;0;0;0;.00nan;0;0
12842;11500;5004;97;30;0;30;1.000;2466000;0
12842;18169;682;0;0;0;0;.00nan;0;0
12842;44032;682;73;23;1;22;.957;3600000;0
12842;46318;5004;38;18;4;14;.778;1134000;0
12843;190235;481;0;0;0;0;.00nan;0;0
12843;38369;474;69;49;6;43;.878;3600000;0
12843;56296;481;55;16;2;14;.875;3600000;0
12843;66491;474;0;0;0;0;.00nan;0;0
12844;183421;4535;0;0;0;0;.00nan;0;0
12844;12048;4535;78;37;3;34;.919;3600000;0
12844;78153;676;46;14;2;12;.857;3600000;0
12844;86347;676;0;0;0;0;.00nan;0;0
12845;168021;473;82;40;3;37;.925;4020000;0
12845;55864;476;0;0;0;0;.00nan;0;0
12845;85127;473;0;0;0;0;.00nan;0;0
12845;86343;476;58;32;3;29;.906;4020000;0
12846;162846;472;0;0;0;0;.00nan;0;0
12846;174407;472;82;34;2;32;.941;3926000;0
12846;46139;482;55;21;3;18;.857;3926000;0
12846;67222;482;0;0;0;0;.00nan;0;0
12847;3713;675;0;0;0;0;.00nan;0;0
12847;78153;676;0;0;0;0;.00nan;0;0
12847;86347;676;19;15;5;10;.667;3546000;0
12847;149969;675;70;39;4;35;.897;3600000;0
12848;168021;473;67;23;2;21;.913;3600000;0
12848;38369;474;59;37;4;33;.892;3533000;0
12848;66491;474;0;0;0;0;.00nan;0;0
12848;85127;473;0;0;0;0;.00nan;0;0
12849;44200;490;32;22;5;17;.773;2122000;0
12849;53870;490;76;23;1;22;.957;1478000;0
12849;55864;476;0;0;0;0;.00nan;0;0
12849;86343;476;67;5;0;5;1.000;3600000;0
12850;18169;682;40;24;4;20;.833;3557000;0
12850;44032;682;0;0;0;0;.00nan;0;0
12850;46139;482;63;26;2;24;.923;3600000;0
12850;67222;482;0;0;0;0;.00nan;0;0
12851;11500;5004;92;36;1;35;.972;4020000;0
12851;183421;4535;0;0;0;0;.00nan;0;0
12851;12048;4535;100;39;1;38;.974;4020000;0
12851;46318;5004;0;0;0;0;.00nan;0;0
12852;162846;472;0;0;0;0;.00nan;0;0
12852;174407;472;96;40;2;38;.950;3600000;0
12852;190235;481;0;0;0;0;.00nan;0;0
12852;56296;481;61;28;3;25;.893;3600000;0
12853;18169;682;0;0;0;0;.00nan;0;0
12853;38369;474;0;0;0;0;.00nan;0;0
12853;44032;682;80;11;0;11;1.000;3600000;0
12853;66491;474;70;51;5;46;.902;3600000;0
12854;168021;473;62;27;3;24;.889;3600000;0
12854;44200;490;0;0;0;0;.00nan;0;0
12854;53870;490;52;39;5;34;.872;3554000;0
12854;85127;473;0;0;0;0;.00nan;0;0
12855;3713;675;0;0;0;0;.00nan;0;0
12855;183421;4535;67;13;1;12;.923;1180000;0
12855;12048;4535;29;30;6;24;.800;2356000;0
12855;149969;675;38;24;5;19;.792;3600000;0
12856;11500;5004;97;50;3;47;.940;3580000;0
12856;46139;482;53;15;2;13;.867;3600000;0
12856;46318;5004;0;0;0;0;.00nan;0;0
12856;67222;482;0;0;0;0;.00nan;0;0
12857;190235;481;0;0;0;0;.00nan;0;0
12857;-1;480;71;19;1;18;.947;3600000;0
12857;56296;481;59;22;2;20;.909;3600000;0
12857;66551;480;0;0;0;0;.00nan;0;0
12858;162846;472;0;0;0;0;.00nan;0;0
12858;174407;472;45;26;4;22;.846;3521000;0
12858;78153;676;0;0;0;0;.00nan;0;0
12858;86347;676;77;30;2;28;.933;3600000;0
12859;-1;480;68;31;4;27;.871;3574000;0
12859;66551;480;0;0;0;0;.00nan;0;0
12859;78153;676;0;0;0;0;.00nan;0;0
12859;86347;676;58;27;3;24;.889;3600000;0
12860;3713;675;0;0;0;0;.00nan;0;0
12860;46139;482;64;29;3;26;.897;3600000;0
12860;67222;482;0;0;0;0;.00nan;0;0
12860;149969;675;58;30;4;26;.867;3600000;0
12861;38369;474;71;51;6;45;.882;3658000;0
12861;55864;476;0;0;0;0;.00nan;0;0
12861;66491;474;0;0;0;0;.00nan;0;0
12861;86343;476;23;16;5;11;.688;3658000;0
12862;18169;682;0;0;0;0;.00nan;0;0
12862;44032;682;53;15;2;13;.867;3600000;0
12862;44200;490;63;38;4;34;.895;3600000;0
12862;53870;490;0;0;0;0;.00nan;0;0
12863;11500;5004;46;49;6;43;.878;3600000;0
12863;168021;473;63;13;1;12;.923;3600000;0
12863;46318;5004;0;0;0;0;.00nan;0;0
12863;85127;473;0;0;0;0;.00nan;0;0
12864;183421;4535;0;0;0;0;.00nan;0;0
12864;12048;4535;71;48;5;43;.896;3600000;0
12864;190235;481;67;20;2;18;.900;3600000;0
12864;56296;481;0;0;0;0;.00nan;0;0
12865;162846;472;0;0;0;0;.00nan;0;0
12865;174407;472;82;21;2;19;.905;3600000;0
12865;38369;474;67;45;4;41;.911;3600000;0
12865;66491;474;0;0;0;0;.00nan;0;0
12866;3713;675;72;26;3;23;.885;3600000;0
12866;18169;682;0;0;0;0;.00nan;0;0
12866;44032;682;77;13;0;13;1.000;3600000;0
12866;149969;675;0;0;0;0;.00nan;0;0
12867;11500;5004;64;37;4;33;.892;3572000;0
12867;46318;5004;0;0;0;0;.00nan;0;0
12867;55864;476;0;0;0;0;.00nan;0;0
12867;86343;476;77;24;1;23;.958;3600000;0
12868;183421;4535;0;0;0;0;.00nan;0;0
12868;12048;4535;99;36;2;34;.944;3600000;0
12868;168021;473;55;23;3;20;.870;3600000;0
12868;85127;473;0;0;0;0;.00nan;0;0
12869;-1;480;73;33;2;31;.939;3520000;0
12869;46139;482;80;11;0;11;1.000;3600000;0
12869;66551;480;0;0;0;0;.00nan;0;0
12869;67222;482;0;0;0;0;.00nan;0;0
12870;183421;4535;0;0;0;0;.00nan;0;0
12870;12048;4535;47;25;4;21;.840;3541000;0
12870;38369;474;87;39;2;37;.949;3600000;0
12870;66491;474;0;0;0;0;.00nan;0;0
12871;55864;476;0;0;0;0;.00nan;0;0
12871;78153;676;0;0;0;0;.00nan;0;0
12871;86343;476;58;26;3;23;.885;3600000;0
12871;86347;676;77;28;2;26;.929;3600000;0
12872;168021;473;0;0;0;0;.00nan;0;0
12872;46139;482;71;34;3;31;.912;3600000;0
12872;67222;482;0;0;0;0;.00nan;0;0
12872;85127;473;91;19;0;19;1.000;3600000;0
12873;18169;682;0;0;0;0;.00nan;0;0
12873;-1;480;47;34;5;29;.853;3557000;0
12873;44032;682;72;33;3;30;.909;3600000;0
12873;66551;480;0;0;0;0;.00nan;0;0
12874;11500;5004;44;35;5;30;.857;3563000;0
12874;190235;481;0;0;0;0;.00nan;0;0
12874;46318;5004;0;0;0;0;.00nan;0;0
12874;56296;481;61;31;3;28;.903;3600000;0
12875;3713;675;0;0;0;0;.00nan;0;0
12875;162846;472;0;0;0;0;.00nan;0;0
12875;174407;472;68;21;2;19;.905;3600000;0
12875;149969;675;52;26;3;23;.885;3575000;0
12876;190235;481;59;18;2;16;.889;3600000;0
12876;44200;490;30;30;6;24;.800;2604000;0
12876;53870;490;54;13;1;12;.923;996000;0
12876;56296;481;0;0;0;0;.00nan;0;0
12877;11500;5004;80;14;0;14;1.000;3600000;0
12877;44200;490;54;39;5;34;.872;3600000;0
12877;46318;5004;0;0;0;0;.00nan;0;0
12877;53870;490;0;0;0;0;.00nan;0;0
12878;3713;675;0;0;0;0;.00nan;0;0
12878;168021;473;0;0;0;0;.00nan;0;0
12878;85127;473;75;30;3;27;.900;3600000;0
12878;149969;675;47;31;4;27;.871;3554000;0
12879;18169;682;0;0;0;0;.00nan;0;0
12879;44032;682;62;41;5;36;.878;3600000;0
12879;55864;476;0;0;0;0;.00nan;0;0
12879;86343;476;91;22;0;22;1.000;3600000;0
12880;162846;472;0;0;0;0;.00nan;0;0
12880;183421;4535;0;0;0;0;.00nan;0;0
12880;12048;4535;99;37;1;36;.973;3600000;0
12880;174407;472;60;29;3;26;.897;3549000;0
12881;46139;482;61;26;2;24;.923;4020000;0
12881;67222;482;0;0;0;0;.00nan;0;0
12881;78153;676;0;0;0;0;.00nan;0;0
12881;86347;676;80;27;2;25;.926;4020000;0
12882;38369;474;99;49;1;48;.980;3600000;0
12882;-1;480;0;0;0;0;.00nan;0;0
12882;66491;474;0;0;0;0;.00nan;0;0
12882;66551;480;43;24;4;20;.833;3600000;0
12883;18169;682;49;39;5;34;.872;3600000;0
12883;44032;682;0;0;0;0;.00nan;0;0
12883;78153;676;0;0;0;0;.00nan;0;0
12883;86347;676;92;29;1;28;.966;3600000;0
12884;162846;472;0;0;0;0;.00nan;0;0
12884;168021;473;95;40;1;39;.975;4020000;0
12884;174407;472;100;37;1;36;.973;4020000;0
12884;85127;473;0;0;0;0;.00nan;0;0
12885;183421;4535;0;0;0;0;.00nan;0;0
12885;12048;4535;47;33;6;27;.818;3600000;0
12885;44200;490;91;35;2;33;.943;3600000;0
12885;53870;490;0;0;0;0;.00nan;0;0
12886;-1;480;48;27;4;23;.852;4020000;0
12886;55864;476;0;0;0;0;.00nan;0;0
12886;66551;480;0;0;0;0;.00nan;0;0
12886;86343;476;56;32;4;28;.875;4020000;0
12887;11500;5004;81;36;3;33;.917;3600000;0
12887;38369;474;76;39;4;35;.897;3550000;0
12887;46318;5004;0;0;0;0;.00nan;0;0
12887;66491;474;0;0;0;0;.00nan;0;0
12888;3713;675;0;0;0;0;.00nan;0;0
12888;190235;481;68;16;1;15;.938;3600000;0
12888;56296;481;0;0;0;0;.00nan;0;0
12888;149969;675;70;40;4;36;.900;3600000;0
12889;38369;474;58;17;2;15;.882;3648000;0
12889;44200;490;80;38;3;35;.921;3648000;0
12889;53870;490;0;0;0;0;.00nan;0;0
12889;66491;474;0;0;0;0;.00nan;0;0
12890;3713;675;94;30;1;29;.967;3600000;0
12890;-1;480;0;0;0;0;.00nan;0;0
12890;66551;480;66;23;2;21;.913;3543000;0
12890;149969;675;0;0;0;0;.00nan;0;0
12891;190235;481;0;0;0;0;.00nan;0;0
12891;55864;476;0;0;0;0;.00nan;0;0
12891;56296;481;66;25;2;23;.920;3600000;0
12891;86343;476;59;30;4;26;.867;3600000;0
12892;11500;5004;27;30;6;24;.800;2026000;0
12892;46318;5004;41;14;3;11;.786;1574000;0
12892;78153;676;0;0;0;0;.00nan;0;0
12892;86347;676;62;16;1;15;.938;3600000;0
12893;183421;4535;0;0;0;0;.00nan;0;0
12893;12048;4535;77;39;3;36;.923;3600000;0
12893;46139;482;91;17;0;17;1.000;3600000;0
12893;67222;482;0;0;0;0;.00nan;0;0
12894;162846;472;0;0;0;0;.00nan;0;0
12894;18169;682;81;27;1;26;.963;3600000;0
12894;174407;472;54;24;3;21;.875;3540000;0
12894;44032;682;0;0;0;0;.00nan;0;0
12895;190235;481;0;0;0;0;.00nan;0;0
12895;56296;481;97;48;2;46;.958;4020000;0
12895;78153;676;0;0;0;0;.00nan;0;0
12895;86347;676;77;33;2;31;.939;4020000;0
12896;168021;473;96;38;1;37;.974;3600000;0
12896;-1;480;52;22;3;19;.864;3600000;0
12896;66551;480;0;0;0;0;.00nan;0;0
12896;85127;473;0;0;0;0;.00nan;0;0
12897;3713;675;0;0;0;0;.00nan;0;0
12897;44200;490;86;41;3;38;.927;3558000;0
12897;53870;490;0;0;0;0;.00nan;0;0
12897;149969;675;88;23;1;22;.957;3600000;0
12898;183421;4535;0;0;0;0;.00nan;0;0
12898;12048;4535;64;28;2;26;.929;4020000;0
12898;18169;682;62;24;2;22;.917;4020000;0
12898;44032;682;0;0;0;0;.00nan;0;0
12899;46139;482;77;27;1;26;.963;3600000;0
12899;55864;476;0;0;0;0;.00nan;0;0
12899;67222;482;0;0;0;0;.00nan;0;0
12899;86343;476;71;41;3;38;.927;3518000;0
12900;162846;472;59;21;2;19;.905;3600000;0
12900;11500;5004;98;46;3;43;.935;3573000;0
12900;174407;472;0;0;0;0;.00nan;0;0
12900;46318;5004;0;0;0;0;.00nan;0;0
12901;38369;474;71;41;4;37;.902;3600000;0
12901;46139;482;94;20;0;20;1.000;3600000;0
12901;66491;474;0;0;0;0;.00nan;0;0
12901;67222;482;0;0;0;0;.00nan;0;0
12902;168021;473;75;33;3;30;.909;3600000;0
12902;190235;481;0;0;0;0;.00nan;0;0
12902;56296;481;91;19;0;19;1.000;3600000;0
12902;85127;473;0;0;0;0;.00nan;0;0
12903;44200;490;69;50;6;44;.880;3279000;0
12903;53870;490;55;3;0;3;1.000;321000;0
12903;78153;676;0;0;0;0;.00nan;0;0
12903;86347;676;88;13;0;13;1.000;3600000;0
12904;183421;4535;0;0;0;0;.00nan;0;0
12904;12048;4535;98;47;3;44;.936;3600000;0
12904;55864;476;0;0;0;0;.00nan;0;0
12904;86343;476;78;19;1;18;.947;3600000;0
12905;162846;472;0;0;0;0;.00nan;0;0
12905;174407;472;93;20;0;20;1.000;3600000;0
12905;-1;480;89;34;2;32;.941;3582000;0
12905;66551;480;0;0;0;0;.00nan;0;0
12906;3713;675;0;0;0;0;.00nan;0;0
12906;11500;5004;0;0;0;0;.00nan;0;0
12906;46318;5004;100;28;0;28;1.000;3600000;0
12906;149969;675;79;36;3;33;.917;3600000;0
12907;168021;473;70;36;2;34;.944;4020000;0
12907;78153;676;0;0;0;0;.00nan;0;0
12907;85127;473;0;0;0;0;.00nan;0;0
12907;86347;676;98;36;2;34;.944;4020000;0
12908;3713;675;0;0;0;0;.00nan;0;0
12908;38369;474;62;28;3;25;.893;3600000;0
12908;66491;474;0;0;0;0;.00nan;0;0
12908;149969;675;100;22;0;22;1.000;3600000;0
12909;183421;4535;0;0;0;0;.00nan;0;0
12909;12048;4535;66;49;5;44;.898;3600000;0
12909;-1;480;43;15;3;12;.800;3600000;0
12909;66551;480;0;0;0;0;.00nan;0;0
12910;44200;490;23;26;6;20;.769;1981000;0
12910;46139;482;73;8;0;8;1.000;3600000;0
12910;53870;490;30;17;4;13;.765;1619000;0
12910;67222;482;0;0;0;0;.00nan;0;0
12911;162846;472;0;0;0;0;.00nan;0;0
12911;174407;472;33;30;6;24;.800;3546000;0
12911;55864;476;0;0;0;0;.00nan;0;0
12911;86343;476;59;38;5;33;.868;3600000;0
12912;18169;682;0;0;0;0;.00nan;0;0
12912;190235;481;0;0;0;0;.00nan;0;0
12912;44032;682;72;36;3;33;.917;3600000;0
12912;56296;481;44;32;5;27;.844;3600000;0
12913;38369;474;89;39;2;37;.949;3600000;0
12913;66491;474;0;0;0;0;.00nan;0;0
12913;78153;676;0;0;0;0;.00nan;0;0
12913;86347;676;51;18;3;15;.833;3558000;0
12914;162846;472;0;0;0;0;.00nan;0;0
12914;174407;472;49;6;1;5;.833;3600000;0
12914;44200;490;92;52;3;49;.942;3542000;0
12914;53870;490;0;0;0;0;.00nan;0;0
12915;3713;675;53;3;0;3;1.000;1451000;0
12915;55864;476;0;0;0;0;.00nan;0;0
12915;86343;476;72;25;2;23;.920;3600000;0
12915;149969;675;45;28;5;23;.821;2149000;0
12916;168021;473;72;17;1;16;.941;3600000;0
12916;18169;682;0;0;0;0;.00nan;0;0
12916;44032;682;80;42;3;39;.929;3566000;0
12916;85127;473;0;0;0;0;.00nan;0;0
12917;11500;5004;0;0;0;0;.00nan;0;0
12917;-1;480;77;29;1;28;.966;4020000;0
12917;46318;5004;96;43;1;42;.977;4020000;0
12917;66551;480;0;0;0;0;.00nan;0;0
12918;190235;481;0;0;0;0;.00nan;0;0
12918;46139;482;69;31;3;28;.903;3600000;0
12918;56296;481;68;39;5;34;.872;3516000;0
12918;67222;482;0;0;0;0;.00nan;0;0
12919;-1;480;0;0;0;0;.00nan;0;0
12919;44200;490;0;0;0;0;.00nan;0;0
12919;53870;490;65;46;5;41;.891;3600000;0
12919;66551;480;56;14;1;13;.929;3600000;0
12920;18169;682;78;48;3;45;.938;4020000;0
12920;44032;682;0;0;0;0;.00nan;0;0
12920;78153;676;0;0;0;0;.00nan;0;0
12920;86347;676;53;23;3;20;.870;4020000;0
12921;183421;4535;0;0;0;0;.00nan;0;0
12921;12048;4535;33;21;5;16;.762;3600000;0
12921;38369;474;100;42;1;41;.976;3600000;0
12921;66491;474;0;0;0;0;.00nan;0;0
12922;3713;675;0;0;0;0;.00nan;0;0
12922;168021;473;64;20;2;18;.900;4020000;0
12922;85127;473;0;0;0;0;.00nan;0;0
12922;149969;675;96;41;2;39;.951;4020000;0
12923;11500;5004;99;42;1;41;.976;3600000;0
12923;190235;481;0;0;0;0;.00nan;0;0
12923;46318;5004;0;0;0;0;.00nan;0;0
12923;56296;481;41;17;3;14;.824;3567000;0
12924;162846;472;0;0;0;0;.00nan;0;0
12924;174407;472;93;22;0;22;1.000;3600000;0
12924;46139;482;83;34;2;32;.941;3564000;0
12924;67222;482;0;0;0;0;.00nan;0;0
12925;190235;481;0;0;0;0;.00nan;0;0
12925;44200;490;62;48;5;43;.896;3600000;0
12925;53870;490;0;0;0;0;.00nan;0;0
12925;56296;481;81;11;0;11;1.000;3600000;0
12926;11500;5004;93;54;3;51;.944;3594000;0
12926;46318;5004;0;0;0;0;.00nan;0;0
12926;78153;676;57;15;2;13;.867;3600000;0
12926;86347;676;0;0;0;0;.00nan;0;0
12927;38369;474;63;16;2;14;.875;3600000;0
12927;44200;490;73;37;3;34;.919;3584000;0
12927;53870;490;0;0;0;0;.00nan;0;0
12927;66491;474;0;0;0;0;.00nan;0;0
12928;3713;675;0;0;0;0;.00nan;0;0
12928;18169;682;54;31;4;27;.871;3545000;0
12928;44032;682;0;0;0;0;.00nan;0;0
12928;149969;675;55;17;2;15;.882;3600000;0
12929;183421;4535;62;16;1;15;.938;1489000;0
12929;12048;4535;32;20;4;16;.800;2111000;0
12929;168021;473;75;20;1;19;.950;3600000;0
12929;85127;473;0;0;0;0;.00nan;0;0
12930;-1;480;52;30;4;26;.867;3549000;0
12930;55864;476;0;0;0;0;.00nan;0;0
12930;66551;480;0;0;0;0;.00nan;0;0
12930;86343;476;50;22;3;19;.864;3600000;0
12931;162846;472;0;0;0;0;.00nan;0;0
12931;174407;472;84;28;2;26;.929;4020000;0
12931;190235;481;0;0;0;0;.00nan;0;0
12931;56296;481;85;32;2;30;.938;4020000;0
12932;11500;5004;0;0;0;0;.00nan;0;0
12932;38369;474;84;30;1;29;.967;3600000;0
12932;46318;5004;41;24;4;20;.833;3600000;0
12932;66491;474;0;0;0;0;.00nan;0;0
12933;190235;481;52;32;4;28;.875;3648000;0
12933;55864;476;0;0;0;0;.00nan;0;0
12933;56296;481;0;0;0;0;.00nan;0;0
12933;86343;476;83;34;3;31;.912;3648000;0
12934;168021;473;26;23;5;18;.783;3600000;0
12934;78153;676;0;0;0;0;.00nan;0;0
12934;85127;473;0;0;0;0;.00nan;0;0
12934;86347;676;98;22;0;22;1.000;3600000;0
12935;-1;480;85;27;1;26;.963;3600000;0
12935;46139;482;0;0;0;0;.00nan;0;0
12935;66551;480;0;0;0;0;.00nan;0;0
12935;67222;482;57;17;2;15;.882;3564000;0
12936;18169;682;0;0;0;0;.00nan;0;0
12936;44032;682;83;14;0;14;1.000;3600000;0
12936;44200;490;94;55;3;52;.945;3600000;0
12936;53870;490;0;0;0;0;.00nan;0;0
12937;162846;472;0;0;0;0;.00nan;0;0
12937;183421;4535;71;29;2;27;.931;2967000;0
12937;12048;4535;33;12;3;9;.750;546000;0
12937;174407;472;51;23;3;20;.870;3600000;0
12938;38369;474;0;0;0;0;.00nan;0;0
12938;-1;480;36;18;4;14;.778;3580000;0
12938;66491;474;59;30;3;27;.900;3600000;0
12938;66551;480;0;0;0;0;.00nan;0;0
12939;3713;675;0;0;0;0;.00nan;0;0
12939;38369;474;59;40;5;35;.875;3600000;0
12939;66491;474;0;0;0;0;.00nan;0;0
12939;149969;675;88;18;0;18;1.000;3600000;0
12940;183421;4535;0;0;0;0;.00nan;0;0
12940;12048;4535;72;46;5;41;.891;3600000;0
12940;46139;482;74;12;0;12;1.000;3600000;0
12940;67222;482;0;0;0;0;.00nan;0;0
12941;18169;682;0;0;0;0;.00nan;0;0
12941;-1;480;50;31;4;27;.871;3600000;0
12941;44032;682;66;25;2;23;.920;3600000;0
12941;66551;480;0;0;0;0;.00nan;0;0
12942;11500;5004;83;22;1;21;.955;3546000;0
12942;168021;473;94;21;0;21;1.000;3600000;0
12942;46318;5004;0;0;0;0;.00nan;0;0
12942;85127;473;0;0;0;0;.00nan;0;0
12943;190235;481;0;0;0;0;.00nan;0;0
12943;44200;490;65;38;4;34;.895;3535000;0
12943;53870;490;0;0;0;0;.00nan;0;0
12943;56296;481;52;14;2;12;.857;3600000;0
12944;44200;490;38;35;6;29;.829;2625000;0
12944;53870;490;66;12;0;12;1.000;975000;0
12944;78153;676;0;0;0;0;.00nan;0;0
12944;86347;676;74;13;1;12;.923;3600000;0
12945;168021;473;95;23;0;23;1.000;3600000;0
12945;55864;476;48;0;0;0;.00nan;477000;0
12945;85127;473;0;0;0;0;.00nan;0;0
12945;86343;476;26;25;6;19;.760;3123000;0
12946;3713;675;0;0;0;0;.00nan;0;0
12946;183421;4535;0;0;0;0;.00nan;0;0
12946;12048;4535;55;28;4;24;.857;3600000;0
12946;149969;675;86;28;1;27;.964;3600000;0
12947;18169;682;57;30;4;26;.867;3600000;0
12947;44032;682;0;0;0;0;.00nan;0;0
12947;46139;482;100;25;0;25;1.000;3600000;0
12947;67222;482;0;0;0;0;.00nan;0;0
12948;11500;5004;50;38;5;33;.868;3600000;0
12948;-1;480;64;25;2;23;.920;3600000;0
12948;46318;5004;0;0;0;0;.00nan;0;0
12948;66551;480;0;0;0;0;.00nan;0;0
12949;162846;472;0;0;0;0;.00nan;0;0
12949;174407;472;72;19;1;18;.947;3600000;0
12949;38369;474;34;31;6;25;.806;1933000;0
12949;66491;474;69;20;1;19;.950;1667000;0
12950;-1;480;67;30;3;27;.900;3515000;0
12950;66551;480;0;0;0;0;.00nan;0;0
12950;78153;676;0;0;0;0;.00nan;0;0
12950;86347;676;79;24;1;23;.958;3600000;0
12951;162846;472;47;6;1;5;.833;401000;0
12951;168021;473;31;24;5;19;.792;3600000;0
12951;174407;472;45;37;6;31;.838;3199000;0
12951;85127;473;0;0;0;0;.00nan;0;0
12952;3713;675;0;0;0;0;.00nan;0;0
12952;44200;490;58;43;6;37;.860;3600000;0
12952;53870;490;0;0;0;0;.00nan;0;0
12952;149969;675;83;24;1;23;.958;3600000;0
12953;183421;4535;65;22;2;20;.909;1472000;0
12953;12048;4535;28;29;6;23;.793;2128000;0
12953;55864;476;53;16;2;14;.875;3600000;0
12953;86343;476;0;0;0;0;.00nan;0;0
12954;18169;682;58;18;2;16;.889;3600000;0
12954;44032;682;0;0;0;0;.00nan;0;0
12954;56296;481;64;30;3;27;.900;3575000;0
12954;153779;481;0;0;0;0;.00nan;0;0
12955;11500;5004;43;35;6;29;.829;3037000;0
12955;46139;482;82;15;0;15;1.000;3600000;0
12955;46318;5004;25;5;3;2;.400;563000;0
12955;67222;482;0;0;0;0;.00nan;0;0
12956;168021;473;87;20;0;20;1.000;3600000;0
12956;38369;474;72;40;4;36;.900;3600000;0
12956;66491;474;0;0;0;0;.00nan;0;0
12956;85127;473;0;0;0;0;.00nan;0;0
12957;3713;675;0;0;0;0;.00nan;0;0
12957;11500;5004;81;44;4;40;.909;3732000;0
12957;46318;5004;0;0;0;0;.00nan;0;0
12957;149969;675;40;19;3;16;.842;3732000;0
12958;183421;4535;34;22;5;17;.773;2189000;0
12958;12048;4535;58;12;1;11;.917;1411000;0
12958;18169;682;72;20;1;19;.950;3600000;0
12958;44032;682;0;0;0;0;.00nan;0;0
12959;46139;482;100;47;0;47;1.000;4020000;0
12959;55864;476;0;0;0;0;.00nan;0;0
12959;67222;482;0;0;0;0;.00nan;0;0
12959;86343;476;85;26;0;26;1.000;4020000;0
12960;162846;472;0;0;0;0;.00nan;0;0
12960;174407;472;59;12;1;11;.917;3600000;0
12960;44200;490;76;56;6;50;.893;3600000;0
12960;53870;490;0;0;0;0;.00nan;0;0
12961;56296;481;0;0;0;0;.00nan;0;0
12961;78153;676;0;0;0;0;.00nan;0;0
12961;86347;676;72;20;1;19;.950;3600000;0
12961;153779;481;53;34;4;30;.882;3600000;0
12962;3713;675;0;0;0;0;.00nan;0;0
12962;78153;676;0;0;0;0;.00nan;0;0
12962;86347;676;89;24;0;24;1.000;3600000;0
12962;149969;675;56;33;4;29;.879;3600000;0
12963;183421;4535;0;0;0;0;.00nan;0;0
12963;12048;4535;42;25;4;21;.840;3583000;0
12963;44200;490;87;33;2;31;.939;3600000;0
12963;53870;490;0;0;0;0;.00nan;0;0
12964;38369;474;97;45;1;44;.978;3600000;0
12964;55864;476;0;0;0;0;.00nan;0;0
12964;66491;474;0;0;0;0;.00nan;0;0
12964;86343;476;28;7;3;4;.571;3573000;0
12965;168021;473;74;31;3;28;.903;3600000;0
12965;46139;482;31;11;3;8;.727;283000;0
12965;67222;482;63;21;2;19;.905;3307000;0
12965;85127;473;0;0;0;0;.00nan;0;0
12966;-1;480;0;0;0;0;.00nan;0;0
12966;56296;481;64;21;2;19;.905;3600000;0
12966;66551;480;72;33;3;30;.909;3545000;0
12966;153779;481;0;0;0;0;.00nan;0;0
12967;162846;472;0;0;0;0;.00nan;0;0
12967;18169;682;0;0;0;0;.00nan;0;0
12967;174407;472;71;37;4;33;.892;4020000;0
12967;44032;682;56;34;4;30;.882;4020000;0
12968;38369;474;97;52;3;49;.942;4020000;0
12968;56296;481;0;0;0;0;.00nan;0;0
12968;66491;474;0;0;0;0;.00nan;0;0
12968;153779;481;37;10;3;7;.700;4020000;0
12969;168021;473;90;30;2;28;.933;3600000;0
12969;-1;480;79;40;4;36;.900;3557000;0
12969;66551;480;0;0;0;0;.00nan;0;0
12969;85127;473;0;0;0;0;.00nan;0;0
12970;44200;490;94;49;3;46;.939;3840000;0
12970;53870;490;0;0;0;0;.00nan;0;0
12970;55864;476;0;0;0;0;.00nan;0;0
12970;86343;476;65;21;2;19;.905;3840000;0
12971;3713;675;0;0;0;0;.00nan;0;0
12971;46139;482;66;16;1;15;.938;3600000;0
12971;67222;482;0;0;0;0;.00nan;0;0
12971;149969;675;70;34;3;31;.912;3576000;0
12972;11500;5004;67;18;1;17;.944;3600000;0
12972;183421;4535;0;0;0;0;.00nan;0;0
12972;12048;4535;63;33;3;30;.909;3527000;0
12972;46318;5004;0;0;0;0;.00nan;0;0
12973;162846;472;0;0;0;0;.00nan;0;0
12973;174407;472;83;45;4;41;.911;3515000;0
12973;78153;676;0;0;0;0;.00nan;0;0
12973;86347;676;69;25;2;23;.920;3600000;0
12974;3713;675;0;0;0;0;.00nan;0;0
12974;55864;476;0;0;0;0;.00nan;0;0
12974;86343;476;52;19;3;16;.842;3600000;0
12974;149969;675;58;31;4;27;.871;3600000;0
12975;46139;482;71;39;3;36;.923;3600000;0
12975;67222;482;0;0;0;0;.00nan;0;0
12975;78153;676;0;0;0;0;.00nan;0;0
12975;86347;676;86;16;0;16;1.000;3600000;0
12976;162846;472;0;0;0;0;.00nan;0;0
12976;174407;472;71;36;4;32;.889;3747000;0
12976;-1;480;77;39;3;36;.923;3747000;0
12976;66551;480;0;0;0;0;.00nan;0;0
12977;18169;682;55;10;1;9;.900;3600000;0
12977;38369;474;30;7;3;4;.571;288000;0
12977;44032;682;0;0;0;0;.00nan;0;0
12977;66491;474;60;56;8;48;.857;3312000;0
12978;11500;5004;0;0;0;0;.00nan;0;0
12978;44200;490;85;37;3;34;.919;3600000;0
12978;46318;5004;47;24;4;20;.833;3553000;0
12978;53870;490;0;0;0;0;.00nan;0;0
12979;168021;473;44;34;5;29;.853;3600000;0
12979;56296;481;100;28;0;28;1.000;3600000;0
12979;85127;473;0;0;0;0;.00nan;0;0
12979;153779;481;0;0;0;0;.00nan;0;0
12980;38369;474;0;0;0;0;.00nan;0;0
12980;-1;480;68;24;2;22;.917;3600000;0
12980;66491;474;71;39;4;35;.897;3540000;0
12980;66551;480;0;0;0;0;.00nan;0;0
12981;168021;473;66;21;2;19;.905;3600000;0
12981;18169;682;70;36;3;33;.917;3600000;0
12981;44032;682;0;0;0;0;.00nan;0;0
12981;85127;473;0;0;0;0;.00nan;0;0
12982;3713;675;66;36;4;32;.889;3600000;0
12982;162846;472;0;0;0;0;.00nan;0;0
12982;174407;472;84;16;0;16;1.000;3600000;0
12982;149969;675;0;0;0;0;.00nan;0;0
12983;183421;4535;0;0;0;0;.00nan;0;0
12983;12048;4535;53;37;5;32;.865;3600000;0
12983;78153;676;0;0;0;0;.00nan;0;0
12983;86347;676;78;11;0;11;1.000;3600000;0
12984;11500;5004;50;21;3;18;.857;3600000;0
12984;46318;5004;0;0;0;0;.00nan;0;0
12984;55864;476;0;0;0;0;.00nan;0;0
12984;86343;476;77;12;0;12;1.000;3600000;0
12985;46139;482;59;28;4;24;.857;3552000;0
12985;56296;481;66;28;3;25;.893;3600000;0
12985;67222;482;0;0;0;0;.00nan;0;0
12985;153779;481;0;0;0;0;.00nan;0;0
12986;168021;473;72;7;0;7;1.000;3600000;0
12986;44200;490;98;64;2;62;.969;3523000;0
12986;53870;490;0;0;0;0;.00nan;0;0
12986;85127;473;0;0;0;0;.00nan;0;0
12987;38369;474;65;33;4;29;.879;3566000;0
12987;46139;482;60;18;2;16;.889;3600000;0
12987;66491;474;0;0;0;0;.00nan;0;0
12987;67222;482;0;0;0;0;.00nan;0;0
12988;183421;4535;52;11;1;10;.909;673000;0
12988;12048;4535;69;48;6;42;.875;2927000;0
12988;-1;480;72;23;1;22;.957;3600000;0
12988;66551;480;0;0;0;0;.00nan;0;0
12989;18169;682;50;29;4;25;.862;3567000;0
12989;44032;682;0;0;0;0;.00nan;0;0
12989;55864;476;0;0;0;0;.00nan;0;0
12989;86343;476;61;24;3;21;.875;3600000;0
12990;162846;472;0;0;0;0;.00nan;0;0
12990;11500;5004;55;28;3;25;.893;3530000;0
12990;174407;472;63;17;1;16;.941;3600000;0
12990;46318;5004;0;0;0;0;.00nan;0;0
12991;3713;675;0;0;0;0;.00nan;0;0
12991;56296;481;0;0;0;0;.00nan;0;0
12991;149969;675;82;39;2;37;.949;3600000;0
12991;153779;481;49;22;3;19;.864;3568000;0
12992;38369;474;62;33;4;29;.879;3600000;0
12992;66491;474;0;0;0;0;.00nan;0;0
12992;78153;676;0;0;0;0;.00nan;0;0
12992;86347;676;72;25;2;23;.920;3600000;0
12993;44200;490;91;54;4;50;.926;3600000;0
12993;46139;482;58;10;1;9;.900;3600000;0
12993;53870;490;0;0;0;0;.00nan;0;0
12993;67222;482;0;0;0;0;.00nan;0;0
12994;3713;675;0;0;0;0;.00nan;0;0
12994;-1;480;50;18;3;15;.833;3764000;0
12994;66551;480;0;0;0;0;.00nan;0;0
12994;149969;675;53;28;4;24;.857;3764000;0
12995;162846;472;0;0;0;0;.00nan;0;0
12995;174407;472;77;33;3;30;.909;3588000;0
12995;55864;476;0;0;0;0;.00nan;0;0
12995;86343;476;88;27;2;25;.926;3600000;0
12996;183421;4535;0;0;0;0;.00nan;0;0
12996;12048;4535;86;38;2;36;.947;3618000;0
12996;56296;481;74;31;3;28;.903;3618000;0
12996;153779;481;0;0;0;0;.00nan;0;0
12997;11500;5004;80;44;3;41;.932;3750000;0
12997;18169;682;49;25;4;21;.840;3750000;0
12997;44032;682;0;0;0;0;.00nan;0;0
12997;46318;5004;0;0;0;0;.00nan;0;0
12998;18169;682;0;0;0;0;.00nan;0;0
12998;44032;682;93;18;0;18;1.000;3600000;0
12998;44200;490;0;0;0;0;.00nan;0;0
12998;53870;490;98;60;2;58;.967;3561000;0
12999;11500;5004;66;12;0;12;1.000;675000;0
12999;-1;480;0;0;0;0;.00nan;0;0
12999;46318;5004;44;42;6;36;.857;2910000;0
12999;66551;480;33;22;5;17;.773;3600000;0
13000;162846;472;97;45;2;43;.956;3599000;0
13000;174407;472;0;0;0;0;.00nan;0;0
13000;56296;481;0;0;0;0;.00nan;0;0
13000;153779;481;100;34;1;33;.971;3600000;0
13001;3713;675;0;0;0;0;.00nan;0;0
13001;78153;676;0;0;0;0;.00nan;0;0
13001;86347;676;78;22;1;21;.955;3600000;0
13001;149969;675;68;34;3;31;.912;3570000;0
13002;168021;473;78;36;3;33;.917;4020000;0
13002;55864;476;70;36;3;33;.917;4020000;0
13002;85127;473;0;0;0;0;.00nan;0;0
13002;86343;476;0;0;0;0;.00nan;0;0
13003;183421;4535;0;0;0;0;.00nan;0;0
13003;12048;4535;58;37;5;32;.865;3600000;0
13003;46139;482;78;14;0;14;1.000;3600000;0
13003;67222;482;0;0;0;0;.00nan;0;0
13004;38369;474;72;50;6;44;.880;3600000;0
13004;55864;476;0;0;0;0;.00nan;0;0
13004;66491;474;0;0;0;0;.00nan;0;0
13004;86343;476;38;17;4;13;.765;3600000;0
13005;168021;473;30;15;4;11;.733;3600000;0
13005;44200;490;33;26;5;21;.808;2363000;0
13005;53870;490;88;22;0;22;1.000;1237000;0
13005;85127;473;0;0;0;0;.00nan;0;0
13006;3713;675;0;0;0;0;.00nan;0;0
13006;183421;4535;0;0;0;0;.00nan;0;0
13006;12048;4535;99;47;1;46;.979;3600000;0
13006;149969;675;45;30;5;25;.833;3600000;0
13007;-1;480;81;21;1;20;.952;3600000;0
13007;46139;482;95;34;2;32;.941;3558000;0
13007;66551;480;0;0;0;0;.00nan;0;0
13007;67222;482;0;0;0;0;.00nan;0;0
13008;162846;472;0;0;0;0;.00nan;0;0
13008;18169;682;0;0;0;0;.00nan;0;0
13008;174407;472;75;32;3;29;.906;3600000;0
13008;44032;682;35;36;6;30;.833;3600000;0
13009;11500;5004;35;30;6;24;.800;2999000;0
13009;46318;5004;46;5;1;4;.800;601000;0
13009;56296;481;75;21;1;20;.952;3600000;0
13009;153779;481;0;0;0;0;.00nan;0;0
13010;38369;474;64;21;2;19;.905;3600000;0
13010;44200;490;52;24;3;21;.875;3600000;0
13010;53870;490;0;0;0;0;.00nan;0;0
13010;66491;474;0;0;0;0;.00nan;0;0
13011;168021;473;0;0;0;0;.00nan;0;0
13011;46139;482;77;28;2;26;.929;3780000;0
13011;67222;482;0;0;0;0;.00nan;0;0
13011;85127;473;84;28;1;27;.964;3780000;0
13012;11500;5004;0;0;0;0;.00nan;0;0
13012;18169;682;45;27;4;23;.852;3735000;0
13012;44032;682;0;0;0;0;.00nan;0;0
13012;46318;5004;59;26;3;23;.885;3735000;0
13013;3713;675;0;0;0;0;.00nan;0;0
13013;55864;476;0;0;0;0;.00nan;0;0
13013;86343;476;100;22;0;22;1.000;3600000;0
13013;149969;675;53;31;4;27;.871;3600000;0
13014;-1;480;64;30;3;27;.900;4020000;0
13014;66551;480;0;0;0;0;.00nan;0;0
13014;78153;676;0;0;0;0;.00nan;0;0
13014;86347;676;69;36;3;33;.917;4020000;0
13015;183421;4535;0;0;0;0;.00nan;0;0
13015;12048;4535;98;52;3;49;.942;3600000;0
13015;56296;481;65;19;1;18;.947;3600000;0
13015;153779;481;0;0;0;0;.00nan;0;0
13016;46139;482;100;28;0;28;1.000;3600000;0
13016;67222;482;0;0;0;0;.00nan;0;0
13016;78153;676;0;0;0;0;.00nan;0;0
13016;86347;676;74;24;1;23;.958;3587000;0
13017;162846;472;0;0;0;0;.00nan;0;0
13017;174407;472;55;24;3;21;.875;3600000;0
13017;44200;490;86;58;5;53;.914;3552000;0
13017;53870;490;0;0;0;0;.00nan;0;0
13018;18169;682;55;20;2;18;.900;3577000;0
13018;44032;682;0;0;0;0;.00nan;0;0
13018;55864;476;0;0;0;0;.00nan;0;0
13018;86343;476;72;23;1;22;.957;3600000;0
13019;183421;4535;0;0;0;0;.00nan;0;0
13019;12048;4535;74;28;2;26;.929;3600000;0
13019;38369;474;44;23;4;19;.826;3552000;0
13019;66491;474;0;0;0;0;.00nan;0;0
13020;168021;473;72;40;4;36;.900;3600000;0
13020;-1;480;0;0;0;0;.00nan;0;0
13020;66551;480;66;19;1;18;.947;3600000;0
13020;85127;473;0;0;0;0;.00nan;0;0
13021;3713;675;0;0;0;0;.00nan;0;0
13021;11500;5004;81;31;1;30;.968;4020000;0
13021;46318;5004;0;0;0;0;.00nan;0;0
13021;149969;675;63;21;1;20;.952;4020000;0
13022;11500;5004;100;23;0;23;1.000;3600000;0
13022;38369;474;86;46;4;42;.913;3600000;0
13022;46318;5004;0;0;0;0;.00nan;0;0
13022;66491;474;0;0;0;0;.00nan;0;0
13023;55864;476;0;0;0;0;.00nan;0;0
13023;56296;481;74;36;4;32;.889;3600000;0
13023;86343;476;62;24;3;21;.875;3600000;0
13023;153779;481;0;0;0;0;.00nan;0;0
13024;183421;4535;0;0;0;0;.00nan;0;0
13024;12048;4535;79;60;5;55;.917;3600000;0
13024;-1;480;68;17;1;16;.941;3600000;0
13024;66551;480;0;0;0;0;.00nan;0;0
13025;18169;682;53;36;5;31;.861;4020000;0
13025;44032;682;0;0;0;0;.00nan;0;0
13025;78153;676;0;0;0;0;.00nan;0;0
13025;86347;676;33;23;5;18;.783;4020000;0
13026;3713;675;0;0;0;0;.00nan;0;0
13026;162846;472;0;0;0;0;.00nan;0;0
13026;174407;472;94;32;1;31;.969;3600000;0
13026;149969;675;56;31;3;28;.903;3541000;0
13027;11500;5004;100;34;1;33;.971;3625000;0
13027;168021;473;87;29;2;27;.931;3625000;0
13027;46318;5004;0;0;0;0;.00nan;0;0
13027;85127;473;0;0;0;0;.00nan;0;0
13028;3713;675;65;39;4;35;.897;3574000;0
13028;56296;481;0;0;0;0;.00nan;0;0
13028;149969;675;0;0;0;0;.00nan;0;0
13028;153779;481;54;19;2;17;.895;3600000;0
13029;-1;480;56;5;0;5;1.000;362000;0
13029;55864;476;53;15;2;13;.867;3600000;0
13029;66551;480;38;34;6;28;.824;3238000;0
13029;86343;476;0;0;0;0;.00nan;0;0
13030;18169;682;0;0;0;0;.00nan;0;0
13030;38369;474;67;47;5;42;.894;3600000;0
13030;44032;682;63;22;3;19;.864;3600000;0
13030;66491;474;0;0;0;0;.00nan;0;0
13031;183421;4535;0;0;0;0;.00nan;0;0
13031;12048;4535;74;44;5;39;.886;3600000;0
13031;78153;676;0;0;0;0;.00nan;0;0
13031;86347;676;94;22;0;22;1.000;3600000;0
13032;162846;472;0;0;0;0;.00nan;0;0
13032;174407;472;38;35;6;29;.829;3600000;0
13032;46139;482;50;18;3;15;.833;3600000;0
13032;67222;482;0;0;0;0;.00nan;0;0
13033;44200;490;73;52;6;46;.885;3600000;0
13033;46139;482;0;0;0;0;.00nan;0;0
13033;53870;490;0;0;0;0;.00nan;0;0
13033;67222;482;70;8;0;8;1.000;3600000;0
13034;168021;473;39;28;5;23;.821;3600000;0
13034;78153;676;0;0;0;0;.00nan;0;0
13034;85127;473;0;0;0;0;.00nan;0;0
13034;86347;676;63;18;1;17;.944;3600000;0
13035;11500;5004;49;25;4;21;.840;3600000;0
13035;44200;490;97;39;1;38;.974;3600000;0
13035;46318;5004;0;0;0;0;.00nan;0;0
13035;53870;490;0;0;0;0;.00nan;0;0
13036;3713;675;30;9;3;6;.667;590000;0
13036;46139;482;0;0;0;0;.00nan;0;0
13036;67222;482;52;19;3;16;.842;3600000;0
13036;149969;675;81;37;1;36;.973;3010000;0
13037;183421;4535;0;0;0;0;.00nan;0;0
13037;12048;4535;61;38;4;34;.895;4020000;0
13037;18169;682;41;27;4;23;.852;4020000;0
13037;44032;682;0;0;0;0;.00nan;0;0
13038;162846;472;0;0;0;0;.00nan;0;0
13038;174407;472;89;31;1;30;.968;3600000;0
13038;55864;476;0;0;0;0;.00nan;0;0
13038;86343;476;53;29;3;26;.897;3522000;0
13039;38369;474;71;33;3;30;.909;3548000;0
13039;56296;481;63;20;2;18;.900;3600000;0
13039;66491;474;0;0;0;0;.00nan;0;0
13039;153779;481;0;0;0;0;.00nan;0;0
13040;38369;474;68;43;4;39;.907;4020000;0
13040;46139;482;47;23;4;19;.826;4020000;0
13040;66491;474;0;0;0;0;.00nan;0;0
13040;67222;482;0;0;0;0;.00nan;0;0
13041;168021;473;49;31;4;27;.871;3578000;0
13041;56296;481;72;29;2;27;.931;3600000;0
13041;85127;473;0;0;0;0;.00nan;0;0
13041;153779;481;0;0;0;0;.00nan;0;0
13042;162846;472;0;0;0;0;.00nan;0;0
13042;183421;4535;0;0;0;0;.00nan;0;0
13042;12048;4535;77;42;3;39;.929;3600000;0
13042;174407;472;60;15;2;13;.867;3600000;0
13043;18169;682;0;0;0;0;.00nan;0;0
13043;-1;480;64;15;1;14;.933;3600000;0
13043;44032;682;76;42;4;38;.905;3600000;0
13043;66551;480;0;0;0;0;.00nan;0;0
13044;11500;5004;67;32;3;29;.906;3551000;0
13044;46318;5004;0;0;0;0;.00nan;0;0
13044;78153;676;0;0;0;0;.00nan;0;0
13044;86347;676;55;15;2;13;.867;3600000;0
13045;162846;472;0;0;0;0;.00nan;0;0
13045;174407;472;81;22;1;21;.955;3600000;0
13045;38369;474;78;46;4;42;.913;3600000;0
13045;66491;474;0;0;0;0;.00nan;0;0
13046;56296;481;49;32;5;27;.844;3600000;0
13046;78153;676;0;0;0;0;.00nan;0;0
13046;86347;676;62;24;2;22;.917;3600000;0
13046;153779;481;0;0;0;0;.00nan;0;0
13047;11500;5004;84;24;1;23;.958;3600000;0
13047;46318;5004;0;0;0;0;.00nan;0;0
13047;55864;476;0;0;0;0;.00nan;0;0
13047;86343;476;49;26;4;22;.846;3600000;0
13048;183421;4535;0;0;0;0;.00nan;0;0
13048;12048;4535;63;27;3;24;.889;3600000;0
13048;44200;490;36;31;6;25;.806;2874000;0
13048;53870;490;48;0;0;0;.00nan;726000;0
13049;3713;675;0;0;0;0;.00nan;0;0
13049;-1;480;63;14;1;13;.929;3600000;0
13049;66551;480;0;0;0;0;.00nan;0;0
13049;149969;675;98;68;4;64;.941;3600000;0
13050;168021;473;100;31;0;31;1.000;3600000;0
13050;18169;682;85;31;1;30;.968;3556000;0
13050;44032;682;0;0;0;0;.00nan;0;0
13050;85127;473;0;0;0;0;.00nan;0;0
13051;44200;490;99;58;2;56;.966;3600000;0
13051;53870;490;0;0;0;0;.00nan;0;0
13051;78153;676;0;0;0;0;.00nan;0;0
13051;86347;676;28;13;4;9;.692;3523000;0
13052;3713;675;65;29;3;26;.897;2581000;0
13052;38369;474;58;31;5;26;.839;3600000;0
13052;66491;474;0;0;0;0;.00nan;0;0
13052;149969;675;22;10;4;6;.600;967000;0
13053;46139;482;67;23;2;21;.913;3600000;0
13053;55864;476;0;0;0;0;.00nan;0;0
13053;67222;482;0;0;0;0;.00nan;0;0
13053;86343;476;56;35;5;30;.857;3600000;0
13054;11500;5004;0;0;0;0;.00nan;0;0
13054;183421;4535;0;0;0;0;.00nan;0;0
13054;12048;4535;79;33;2;31;.939;3559000;0
13054;46318;5004;97;23;0;23;1.000;3600000;0
13055;162846;472;0;0;0;0;.00nan;0;0
13055;168021;473;89;19;0;19;1.000;3600000;0
13055;174407;472;59;31;4;27;.871;3600000;0
13055;85127;473;0;0;0;0;.00nan;0;0
13056;-1;480;40;25;5;20;.800;3557000;0
13056;56296;481;53;28;4;24;.857;3600000;0
13056;66551;480;0;0;0;0;.00nan;0;0
13056;153779;481;0;0;0;0;.00nan;0;0
13057;162846;472;0;0;0;0;.00nan;0;0
13057;174407;472;67;31;3;28;.903;3594000;0
13057;78153;676;0;0;0;0;.00nan;0;0
13057;86347;676;83;29;2;27;.931;3600000;0
13058;168021;473;89;26;1;25;.962;3600000;0
13058;38369;474;30;9;3;6;.667;314000;0
13058;66491;474;72;27;2;25;.926;3286000;0
13058;85127;473;0;0;0;0;.00nan;0;0
13059;183421;4535;41;38;6;32;.842;3080000;0
13059;12048;4535;52;3;0;3;1.000;482000;0
13059;55864;476;0;0;0;0;.00nan;0;0
13059;86343;476;59;29;4;25;.862;3600000;0
13060;46139;482;70;27;2;25;.926;4020000;0
13060;56296;481;86;41;2;39;.951;4020000;0
13060;67222;482;0;0;0;0;.00nan;0;0
13060;153779;481;0;0;0;0;.00nan;0;0
13061;-1;480;81;14;0;14;1.000;3600000;0
13061;44200;490;98;56;2;54;.964;3600000;0
13061;53870;490;0;0;0;0;.00nan;0;0
13061;66551;480;0;0;0;0;.00nan;0;0
13062;3713;675;0;0;0;0;.00nan;0;0
13062;18169;682;55;12;2;10;.833;3600000;0
13062;44032;682;0;0;0;0;.00nan;0;0
13062;149969;675;87;31;1;30;.968;3600000;0
13063;38369;474;0;0;0;0;.00nan;0;0
13063;66491;474;62;37;3;34;.919;3600000;0
13063;78153;676;0;0;0;0;.00nan;0;0
13063;86347;676;33;17;4;13;.765;3559000;0
13064;3713;675;0;0;0;0;.00nan;0;0
13064;168021;473;55;31;4;27;.871;3600000;0
13064;85127;473;0;0;0;0;.00nan;0;0
13064;149969;675;82;43;3;40;.930;3600000;0
13065;44200;490;31;16;4;12;.750;1010000;0
13065;53870;490;61;27;3;24;.889;2590000;0
13065;55864;476;0;0;0;0;.00nan;0;0
13065;86343;476;62;23;2;21;.913;3600000;0
13066;11500;5004;0;0;0;0;.00nan;0;0
13066;46139;482;67;25;2;23;.920;3600000;0
13066;46318;5004;50;42;6;36;.857;3600000;0
13066;67222;482;0;0;0;0;.00nan;0;0
13067;162846;472;0;0;0;0;.00nan;0;0
13067;174407;472;94;34;1;33;.971;3600000;0
13067;-1;480;41;32;5;27;.844;3600000;0
13067;66551;480;0;0;0;0;.00nan;0;0
13068;18169;682;54;38;6;32;.842;3600000;0
13068;44032;682;0;0;0;0;.00nan;0;0
13068;56296;481;0;0;0;0;.00nan;0;0
13068;153779;481;55;18;3;15;.833;3600000;0
13069;55864;476;0;0;0;0;.00nan;0;0
13069;78153;676;68;25;2;23;.920;3600000;0
13069;86343;476;62;27;3;24;.889;3547000;0
13069;86347;676;0;0;0;0;.00nan;0;0
13070;183421;4535;0;0;0;0;.00nan;0;0
13070;12048;4535;63;38;4;34;.895;3600000;0
13070;168021;473;100;18;0;18;1.000;3600000;0
13070;85127;473;0;0;0;0;.00nan;0;0
13071;3713;675;65;13;1;12;.923;3600000;0
13071;44200;490;72;43;4;39;.907;3600000;0
13071;53870;490;0;0;0;0;.00nan;0;0
13071;149969;675;0;0;0;0;.00nan;0;0
13072;38369;474;83;40;3;37;.925;3600000;0
13072;-1;480;57;18;2;16;.889;3600000;0
13072;66491;474;0;0;0;0;.00nan;0;0
13072;66551;480;0;0;0;0;.00nan;0;0
13073;18169;682;100;48;1;47;.979;3600000;0
13073;44032;682;0;0;0;0;.00nan;0;0
13073;46139;482;51;19;3;16;.842;3600000;0
13073;67222;482;0;0;0;0;.00nan;0;0
13074;162846;472;0;0;0;0;.00nan;0;0
13074;11500;5004;0;0;0;0;.00nan;0;0
13074;174407;472;63;18;2;16;.889;4020000;0
13074;46318;5004;95;49;2;47;.959;4020000;0
13076;161708;481;0;0;0;0;.00nan;0;0
13076;168021;473;57;29;3;26;.897;3600000;0
13076;190235;481;76;27;2;25;.926;3600000;0
13076;85127;473;0;0;0;0;.00nan;0;0
13078;164101;490;0;0;0;0;.00nan;0;0
13078;44200;490;81;65;6;59;.908;3600000;0
13078;78153;676;0;0;0;0;.00nan;0;0
13078;86347;676;57;9;1;8;.889;3600000;0
13080;38369;474;80;55;5;50;.909;3600000;0
13080;46139;482;49;13;2;11;.846;3600000;0
13080;66491;474;0;0;0;0;.00nan;0;0
13080;67222;482;0;0;0;0;.00nan;0;0
13082;162846;472;0;0;0;0;.00nan;0;0
13082;18169;682;52;35;5;30;.857;3540000;0
13082;23482;682;0;0;0;0;.00nan;0;0
13082;174407;472;66;31;3;28;.903;3600000;0
13084;183421;4535;0;0;0;0;.00nan;0;0
13084;12048;4535;56;49;6;43;.878;3600000;0
13084;55864;476;0;0;0;0;.00nan;0;0
13084;86343;476;45;12;2;10;.833;3600000;0
13086;3713;675;75;26;2;24;.923;3548000;0
13086;-1;480;90;25;1;24;.960;3600000;0
13086;66551;480;0;0;0;0;.00nan;0;0
13086;149969;675;0;0;0;0;.00nan;0;0
13088;3713;675;71;21;1;20;.952;3600000;0
13088;183421;4535;0;0;0;0;.00nan;0;0
13088;12048;4535;88;48;3;45;.938;3515000;0
13088;149969;675;0;0;0;0;.00nan;0;0
13090;-1;480;51;21;3;18;.857;3513000;0
13090;55864;476;0;0;0;0;.00nan;0;0
13090;66551;480;0;0;0;0;.00nan;0;0
13090;86343;476;81;29;1;28;.966;3600000;0
13092;162846;472;0;0;0;0;.00nan;0;0
13092;174407;472;64;17;1;16;.941;3600000;0
13092;46139;482;16;17;5;12;.706;1849000;0
13092;67222;482;30;25;5;20;.800;1751000;0
13094;168021;473;92;19;0;19;1.000;3600000;0
13094;18169;682;78;43;3;40;.930;3600000;0
13094;23482;682;0;0;0;0;.00nan;0;0
13094;85127;473;0;0;0;0;.00nan;0;0
13096;161708;481;0;0;0;0;.00nan;0;0
13096;166878;5004;0;0;0;0;.00nan;0;0
13096;11500;5004;85;54;4;50;.926;3600000;0
13096;190235;481;100;22;0;22;1.000;3600000;0
13098;164101;490;0;0;0;0;.00nan;0;0
13098;44200;490;91;41;2;39;.951;3543000;0
13098;78153;676;0;0;0;0;.00nan;0;0
13098;86347;676;63;17;1;16;.941;3600000;0
13100;-1;480;0;0;0;0;.00nan;0;0
13100;55864;476;55;30;4;26;.867;3581000;0
13100;66551;480;73;24;2;22;.917;3600000;0
13100;86343;476;0;0;0;0;.00nan;0;0
13102;3713;675;0;0;0;0;.00nan;0;0
13102;168021;473;75;31;2;29;.935;3551000;0
13102;85127;473;0;0;0;0;.00nan;0;0
13102;149969;675;87;28;1;27;.964;3600000;0
13104;162846;472;77;11;0;11;1.000;3600000;0
13104;183421;4535;85;50;3;47;.940;3600000;0
13104;12048;4535;0;0;0;0;.00nan;0;0
13104;174407;472;0;0;0;0;.00nan;0;0
13106;161708;481;56;18;2;16;.889;3600000;0
13106;166878;5004;50;45;6;39;.867;3600000;0
13106;11500;5004;0;0;0;0;.00nan;0;0
13106;190235;481;0;0;0;0;.00nan;0;0
13108;18169;682;42;4;1;3;.750;722000;0
13108;23482;682;19;22;6;16;.727;2878000;0
13108;46139;482;45;23;4;19;.826;3600000;0
13108;67222;482;0;0;0;0;.00nan;0;0
13110;164101;490;72;37;3;34;.919;4020000;0
13110;38369;474;66;32;3;29;.906;4020000;0
13110;44200;490;0;0;0;0;.00nan;0;0
13110;66491;474;0;0;0;0;.00nan;0;0
13112;164101;490;0;0;0;0;.00nan;0;0
13112;44200;490;41;48;7;41;.854;3600000;0
13112;55864;476;0;0;0;0;.00nan;0;0
13112;86343;476;53;13;2;11;.846;3600000;0
13114;18169;682;72;32;3;29;.906;3757000;0
13114;23482;682;0;0;0;0;.00nan;0;0
13114;46139;482;0;0;0;0;.00nan;0;0
13114;67222;482;52;29;4;25;.862;3762000;0
13116;161708;481;0;0;0;0;.00nan;0;0
13116;190235;481;83;26;1;25;.962;3600000;0
13116;-1;480;71;30;2;28;.933;3575000;0
13116;66551;480;0;0;0;0;.00nan;0;0
13118;162846;472;64;35;3;32;.914;4020000;0
13118;168021;473;59;32;3;29;.906;4020000;0
13118;174407;472;0;0;0;0;.00nan;0;0
13118;85127;473;0;0;0;0;.00nan;0;0
13120;166878;5004;0;0;0;0;.00nan;0;0
13120;11500;5004;91;33;2;31;.939;3622000;0
13120;183421;4535;0;0;0;0;.00nan;0;0
13120;12048;4535;85;30;1;29;.967;3622000;0
13122;3713;675;0;0;0;0;.00nan;0;0
13122;38369;474;60;38;5;33;.868;3600000;0
13122;66491;474;0;0;0;0;.00nan;0;0
13122;149969;675;74;23;2;21;.913;3600000;0
13124;164101;490;64;46;5;41;.891;3600000;0
13124;-1;480;0;0;0;0;.00nan;0;0
13124;44200;490;0;0;0;0;.00nan;0;0
13124;66551;480;58;13;1;12;.923;3600000;0
13126;38369;474;0;0;0;0;.00nan;0;0
13126;46139;482;60;32;4;28;.875;3600000;0
13126;66491;474;52;36;5;31;.861;3558000;0
13126;67222;482;0;0;0;0;.00nan;0;0
13128;161708;481;98;40;1;39;.975;3600000;0
13128;18169;682;0;0;0;0;.00nan;0;0
13128;23482;682;49;20;4;16;.800;3600000;0
13128;190235;481;0;0;0;0;.00nan;0;0
13130;3713;675;48;37;5;32;.865;3600000;0
13130;78153;676;0;0;0;0;.00nan;0;0
13130;86347;676;87;18;0;18;1.000;3600000;0
13130;149969;675;0;0;0;0;.00nan;0;0
13132;166878;5004;67;35;3;32;.914;3600000;0
13132;11500;5004;0;0;0;0;.00nan;0;0
13132;183421;4535;73;29;2;27;.931;3600000;0
13132;12048;4535;0;0;0;0;.00nan;0;0
13134;162846;472;0;0;0;0;.00nan;0;0
13134;168021;473;0;0;0;0;.00nan;0;0
13134;174407;472;51;19;3;16;.842;3565000;0
13134;85127;473;85;38;2;36;.947;3600000;0
13136;3713;675;74;27;2;25;.926;3600000;0
13136;183421;4535;0;0;0;0;.00nan;0;0
13136;12048;4535;63;37;4;33;.892;3537000;0
13136;149969;675;0;0;0;0;.00nan;0;0
13138;164101;490;0;0;0;0;.00nan;0;0
13138;44200;490;90;59;5;54;.915;3600000;0
13138;78153;676;0;0;0;0;.00nan;0;0
13138;86347;676;62;10;1;9;.900;3600000;0
13140;18169;682;43;31;4;27;.871;3557000;0
13140;23482;682;0;0;0;0;.00nan;0;0
13140;46139;482;78;29;2;27;.931;3600000;0
13140;67222;482;0;0;0;0;.00nan;0;0
13142;168021;473;80;23;1;22;.957;3600000;0
13142;55864;476;0;0;0;0;.00nan;0;0
13142;85127;473;0;0;0;0;.00nan;0;0
13142;86343;476;70;40;4;36;.900;3600000;0
13144;162846;472;0;0;0;0;.00nan;0;0
13144;174407;472;53;37;5;32;.865;3600000;0
13144;-1;480;58;26;3;23;.885;3600000;0
13144;66551;480;0;0;0;0;.00nan;0;0
13146;161708;481;61;14;2;12;.857;3600000;0
13146;190235;481;0;0;0;0;.00nan;0;0
13146;38369;474;98;72;4;68;.944;3587000;0
13146;66491;474;0;0;0;0;.00nan;0;0
13148;-1;480;0;0;0;0;.00nan;0;0
13148;66551;480;73;30;2;28;.933;3600000;0
13148;78153;676;70;40;3;37;.925;3576000;0
13148;86347;676;0;0;0;0;.00nan;0;0
13150;164101;490;97;42;1;41;.976;3600000;0
13150;44200;490;0;0;0;0;.00nan;0;0
13150;46139;482;0;0;0;0;.00nan;0;0
13150;67222;482;97;21;0;21;1.000;3600000;0
13152;162846;472;77;30;2;28;.933;3600000;0
13152;174407;472;0;0;0;0;.00nan;0;0
13152;55864;476;42;27;4;23;.852;3516000;0
13152;86343;476;0;0;0;0;.00nan;0;0
13154;168021;473;0;0;0;0;.00nan;0;0
13154;38369;474;0;0;0;0;.00nan;0;0
13154;66491;474;72;42;4;38;.905;3582000;0
13154;85127;473;41;14;3;11;.786;3600000;0
13156;166878;5004;0;0;0;0;.00nan;0;0
13156;11500;5004;38;26;5;21;.808;4020000;0
13156;183421;4535;87;35;2;33;.943;3499000;0
13156;12048;4535;28;9;3;6;.667;521000;0
13158;161708;481;0;0;0;0;.00nan;0;0
13158;18169;682;0;0;0;0;.00nan;0;0
13158;23482;682;82;26;1;25;.962;3600000;0
13158;190235;481;60;24;2;22;.917;3546000;0
860;162846;472;0;0;0;0;.00nan;0;0
860;174407;472;72;21;2;19;.905;3600000;0
860;38369;474;57;31;4;27;.871;3600000;0
860;66491;474;0;0;0;0;.00nan;0;0
861;3713;675;0;0;0;0;.00nan;0;0
861;18169;682;74;20;1;19;.950;3600000;0
861;44032;682;0;0;0;0;.00nan;0;0
861;149969;675;93;43;2;41;.953;3553000;0
862;162846;472;0;0;0;0;.00nan;0;0
862;174407;472;84;14;0;14;1.000;3600000;0
862;38369;474;98;56;2;54;.964;3600000;0
862;66491;474;0;0;0;0;.00nan;0;0
863;3713;675;0;0;0;0;.00nan;0;0
863;18169;682;55;9;1;8;.889;3600000;0
863;44032;682;0;0;0;0;.00nan;0;0
863;149969;675;71;47;5;42;.894;3600000;0
917;18169;682;45;34;5;29;.853;3600000;0
917;44032;682;0;0;0;0;.00nan;0;0
917;78153;676;0;0;0;0;.00nan;0;0
917;86347;676;90;18;0;18;1.000;3600000;0
918;162846;472;0;0;0;0;.00nan;0;0
918;168021;473;57;25;3;22;.880;3557000;0
918;174407;472;80;26;1;25;.962;3600000;0
918;85127;473;0;0;0;0;.00nan;0;0
919;-1;480;36;16;4;12;.750;851000;0
919;46139;482;81;24;1;23;.958;3600000;0
919;66551;480;80;31;2;29;.935;2749000;0
919;67222;482;0;0;0;0;.00nan;0;0
920;1072;481;32;39;7;32;.821;3600000;0
920;55864;476;0;0;0;0;.00nan;0;0
920;56296;481;0;0;0;0;.00nan;0;0
920;86343;476;84;27;1;26;.963;3600000;0
921;18169;682;63;38;4;34;.895;3522000;0
921;44032;682;0;0;0;0;.00nan;0;0
921;78153;676;0;0;0;0;.00nan;0;0
921;86347;676;59;18;2;16;.889;3600000;0
922;162846;472;0;0;0;0;.00nan;0;0
922;168021;473;59;28;3;25;.893;3570000;0
922;174407;472;78;32;2;30;.938;3600000;0
922;85127;473;0;0;0;0;.00nan;0;0
923;-1;480;87;35;2;33;.943;3600000;0
923;46139;482;69;32;3;29;.906;3558000;0
923;66551;480;0;0;0;0;.00nan;0;0
923;67222;482;0;0;0;0;.00nan;0;0
924;1072;481;65;39;4;35;.897;3600000;0
924;55864;476;0;0;0;0;.00nan;0;0
924;56296;481;0;0;0;0;.00nan;0;0
924;86343;476;71;27;3;24;.889;3600000;0
925;18169;682;35;30;6;24;.800;3545000;0
925;44032;682;0;0;0;0;.00nan;0;0
925;78153;676;0;0;0;0;.00nan;0;0
925;86347;676;56;27;4;23;.852;3600000;0
926;162846;472;0;0;0;0;.00nan;0;0
926;168021;473;63;17;2;15;.882;3600000;0
926;174407;472;58;32;4;28;.875;3600000;0
926;85127;473;0;0;0;0;.00nan;0;0
927;-1;480;61;35;4;31;.886;3512000;0
927;46139;482;72;25;2;23;.920;3600000;0
927;66551;480;0;0;0;0;.00nan;0;0
927;67222;482;0;0;0;0;.00nan;0;0
928;1072;481;100;42;0;42;1.000;3600000;0
928;55864;476;0;0;0;0;.00nan;0;0
928;56296;481;0;0;0;0;.00nan;0;0
928;86343;476;85;27;2;25;.926;3586000;0
929;18169;682;85;27;1;26;.963;3600000;0
929;44032;682;0;0;0;0;.00nan;0;0
929;78153;676;0;0;0;0;.00nan;0;0
929;86347;676;54;21;2;19;.905;3576000;0
930;162846;472;0;0;0;0;.00nan;0;0
930;168021;473;99;42;2;40;.952;4172000;0
930;174407;472;70;31;3;28;.903;4172000;0
930;85127;473;0;0;0;0;.00nan;0;0
931;-1;480;80;26;1;25;.962;3600000;0
931;46139;482;59;31;5;26;.839;3600000;0
931;66551;480;0;0;0;0;.00nan;0;0
931;67222;482;0;0;0;0;.00nan;0;0
932;1072;481;67;23;2;21;.913;3600000;0
932;55864;476;0;0;0;0;.00nan;0;0
932;56296;481;0;0;0;0;.00nan;0;0
932;86343;476;49;34;5;29;.853;3600000;0
1078;18169;682;88;44;4;40;.909;3600000;0
1078;44032;682;0;0;0;0;.00nan;0;0
1078;78153;676;0;0;0;0;.00nan;0;0
1078;86347;676;73;23;1;22;.957;3600000;0
1079;162846;472;0;0;0;0;.00nan;0;0
1079;168021;473;77;29;2;27;.931;3600000;0
1079;174407;472;84;45;3;42;.933;3546000;0
1079;85127;473;0;0;0;0;.00nan;0;0
1080;-1;480;69;35;3;32;.914;3552000;0
1080;46139;482;65;23;2;21;.913;3600000;0
1080;66551;480;0;0;0;0;.00nan;0;0
1080;67222;482;0;0;0;0;.00nan;0;0
1081;1072;481;62;38;5;33;.868;3896000;0
1081;55864;476;0;0;0;0;.00nan;0;0
1081;56296;481;0;0;0;0;.00nan;0;0
1081;86343;476;48;30;4;26;.867;3896000;0
1181;162846;472;0;0;0;0;.00nan;0;0
1181;168021;473;53;26;4;22;.846;3548000;0
1181;174407;472;66;25;2;23;.920;3600000;0
1181;85127;473;0;0;0;0;.00nan;0;0
1182;-1;480;41;30;5;25;.833;3600000;0
1182;46139;482;71;27;2;25;.926;3600000;0
1182;66551;480;0;0;0;0;.00nan;0;0
1182;67222;482;0;0;0;0;.00nan;0;0
1183;1072;481;59;28;3;25;.893;3600000;0
1183;55864;476;0;0;0;0;.00nan;0;0
1183;56296;481;0;0;0;0;.00nan;0;0
1183;86343;476;36;26;5;21;.808;3519000;0
1273;162846;472;0;0;0;0;.00nan;0;0
1273;168021;473;100;26;0;26;1.000;3600000;0
1273;174407;472;89;25;1;24;.960;3568000;0
1273;85127;473;0;0;0;0;.00nan;0;0
1274;1072;481;70;47;5;42;.894;3600000;0
1274;55864;476;0;0;0;0;.00nan;0;0
1274;56296;481;0;0;0;0;.00nan;0;0
1274;86343;476;65;19;1;18;.947;3600000;0
1367;55864;476;0;0;0;0;.00nan;0;0
1367;78153;676;0;0;0;0;.00nan;0;0
1367;86343;476;61;29;3;26;.897;3600000;0
1367;86347;676;90;32;1;31;.969;3600000;0
1368;168021;473;33;29;5;24;.828;3333000;0
1368;46139;482;53;17;2;15;.882;3600000;0
1368;67222;482;0;0;0;0;.00nan;0;0
1368;85127;473;48;0;0;0;.00nan;267000;0
1369;55864;476;0;0;0;0;.00nan;0;0
1369;78153;676;0;0;0;0;.00nan;0;0
1369;86343;476;56;36;5;31;.861;3600000;0
1369;86347;676;74;17;1;16;.941;3600000;0
1370;168021;473;42;25;4;21;.840;3569000;0
1370;46139;482;51;15;2;13;.867;3600000;0
1370;67222;482;0;0;0;0;.00nan;0;0
1370;85127;473;0;0;0;0;.00nan;0;0
1371;55864;476;0;0;0;0;.00nan;0;0
1371;78153;676;0;0;0;0;.00nan;0;0
1371;86343;476;100;32;0;32;1.000;3600000;0
1371;86347;676;70;21;1;20;.952;3595000;0
1372;168021;473;83;23;1;22;.957;3600000;0
1372;46139;482;83;31;2;29;.935;3588000;0
1372;67222;482;0;0;0;0;.00nan;0;0
1372;85127;473;0;0;0;0;.00nan;0;0
1373;55864;476;0;0;0;0;.00nan;0;0
1373;78153;676;0;0;0;0;.00nan;0;0
1373;86343;476;93;29;2;27;.931;3546000;0
1373;86347;676;83;26;1;25;.962;3600000;0
1374;168021;473;45;26;4;22;.846;3600000;0
1374;46139;482;81;30;2;28;.933;3600000;0
1374;67222;482;0;0;0;0;.00nan;0;0
1374;85127;473;0;0;0;0;.00nan;0;0
1588;55864;476;0;0;0;0;.00nan;0;0
1588;78153;676;0;0;0;0;.00nan;0;0
1588;86343;476;82;37;2;35;.946;3600000;0
1588;86347;676;68;27;3;24;.889;3600000;0
1589;168021;473;93;40;2;38;.950;3600000;0
1589;46139;482;63;25;3;22;.880;3549000;0
1589;67222;482;0;0;0;0;.00nan;0;0
1589;85127;473;0;0;0;0;.00nan;0;0
1641;55864;476;0;0;0;0;.00nan;0;0
1641;78153;676;0;0;0;0;.00nan;0;0
1641;86343;476;56;27;3;24;.889;3563000;0
1641;86347;676;77;28;1;27;.964;3600000;0
1642;168021;473;81;15;0;15;1.000;3600000;0
1642;46139;482;98;37;1;36;.973;3565000;0
1642;67222;482;0;0;0;0;.00nan;0;0
1642;85127;473;0;0;0;0;.00nan;0;0
1731;168021;473;58;33;4;29;.879;3577000;0
1731;46139;482;66;30;3;27;.900;3600000;0
1731;67222;482;0;0;0;0;.00nan;0;0
1731;85127;473;0;0;0;0;.00nan;0;0
1836;46139;482;39;29;5;24;.828;3600000;0
1836;67222;482;0;0;0;0;.00nan;0;0
1836;78153;676;0;0;0;0;.00nan;0;0
1836;86347;676;90;31;1;30;.968;3600000;0
1837;46139;482;78;27;2;25;.926;3600000;0
1837;67222;482;0;0;0;0;.00nan;0;0
1837;78153;676;0;0;0;0;.00nan;0;0
1837;86347;676;37;24;4;20;.833;3600000;0
1838;46139;482;87;33;2;31;.939;3600000;0
1838;67222;482;0;0;0;0;.00nan;0;0
1838;78153;676;0;0;0;0;.00nan;0;0
1838;86347;676;59;27;3;24;.889;3571000;0
1839;46139;482;80;48;3;45;.938;4404000;0
1839;67222;482;0;0;0;0;.00nan;0;0
1839;78153;676;0;0;0;0;.00nan;0;0
1839;86347;676;51;32;4;28;.875;4404000;0
1933;46139;482;65;46;5;41;.891;3600000;0
1933;67222;482;0;0;0;0;.00nan;0;0
1933;78153;676;0;0;0;0;.00nan;0;0
1933;86347;676;66;22;3;19;.864;3600000;0
1994;46139;482;67;24;2;22;.917;3600000;0
1994;67222;482;0;0;0;0;.00nan;0;0
1994;78153;676;58;8;0;8;1.000;1611000;0
1994;86347;676;23;23;6;17;.739;1989000;0
13159;3359;502;67;25;2;23;.920;3600000;0
13159;-1;497;0;0;0;0;.00nan;0;0
13159;169680;502;0;0;0;0;.00nan;0;0
13159;142810;497;43;27;4;23;.852;3558000;0
13160;1213;504;73;38;3;35;.921;3900000;0
13160;11614;500;79;34;3;31;.912;3900000;0
13160;46365;504;0;0;0;0;.00nan;0;0
13160;63707;500;0;0;0;0;.00nan;0;0
13161;187813;495;0;0;0;0;.00nan;0;0
13161;-1;499;71;34;3;31;.912;3661000;0
13161;-1;499;0;0;0;0;.00nan;0;0
13161;66271;495;75;32;2;30;.938;3661000;0
13162;1061;505;69;23;2;21;.913;3871000;0
13162;-1;505;0;0;0;0;.00nan;0;0
13162;49674;498;95;33;1;32;.970;3871000;0
13162;148576;498;0;0;0;0;.00nan;0;0
13163;167480;503;0;0;0;0;.00nan;0;0
13163;170536;503;75;24;1;23;.958;3600000;0
13163;148573;496;53;25;3;22;.880;3571000;0
13163;149305;496;0;0;0;0;.00nan;0;0
13164;177356;4636;0;0;0;0;.00nan;0;0
13164;40046;2591;92;33;3;30;.909;3600000;0
13164;56078;2591;0;0;0;0;.00nan;0;0
13164;148503;4636;58;29;4;25;.862;3563000;0
13165;1061;505;100;32;0;32;1.000;3600000;0
13165;-1;505;0;0;0;0;.00nan;0;0
13165;-1;499;60;23;2;21;.913;3578000;0
13165;-1;499;0;0;0;0;.00nan;0;0
13166;167480;503;0;0;0;0;.00nan;0;0
13166;170536;503;72;28;2;26;.929;3600000;0
13166;49674;498;70;33;3;30;.909;3579000;0
13166;148576;498;0;0;0;0;.00nan;0;0
13167;177356;4636;0;0;0;0;.00nan;0;0
13167;148503;4636;94;38;2;36;.947;3600000;0
13167;148573;496;69;37;3;34;.919;3544000;0
13167;149305;496;0;0;0;0;.00nan;0;0
13168;11614;500;81;33;2;31;.939;3600000;0
13168;40046;2591;0;0;0;0;.00nan;0;0
13168;56078;2591;55;30;4;26;.867;3600000;0
13168;63707;500;0;0;0;0;.00nan;0;0
13169;3359;502;70;30;3;27;.900;3600000;0
13169;187813;495;0;0;0;0;.00nan;0;0
13169;169680;502;0;0;0;0;.00nan;0;0
13169;66271;495;61;34;4;30;.882;3597000;0
13170;1213;504;54;29;3;26;.897;3544000;0
13170;-1;497;0;0;0;0;.00nan;0;0
13170;46365;504;0;0;0;0;.00nan;0;0
13170;142810;497;82;28;1;27;.964;3600000;0
13171;1061;505;54;26;4;22;.846;3600000;0
13171;-1;505;0;0;0;0;.00nan;0;0
13171;-1;499;0;0;0;0;.00nan;0;0
13171;-1;499;100;25;0;25;1.000;3600000;0
13172;167480;503;0;0;0;0;.00nan;0;0
13172;170536;503;64;28;3;25;.893;3900000;0
13172;49674;498;0;0;0;0;.00nan;0;0
13172;148576;498;78;42;3;39;.929;3900000;0
13173;177356;4636;0;0;0;0;.00nan;0;0
13173;148503;4636;64;17;1;16;.941;3600000;0
13173;148573;496;75;37;3;34;.919;3600000;0
13173;149305;496;0;0;0;0;.00nan;0;0
13174;11614;500;55;33;4;29;.879;3600000;0
13174;40046;2591;0;0;0;0;.00nan;0;0
13174;56078;2591;100;32;0;32;1.000;3600000;0
13174;63707;500;0;0;0;0;.00nan;0;0
13175;3359;502;51;24;4;20;.833;3765000;0
13175;187813;495;0;0;0;0;.00nan;0;0
13175;169680;502;0;0;0;0;.00nan;0;0
13175;66271;495;66;31;3;28;.903;3781000;0
13176;1213;504;91;34;2;32;.941;3600000;0
13176;-1;497;56;28;3;25;.893;3600000;0
13176;46365;504;0;0;0;0;.00nan;0;0
13176;142810;497;0;0;0;0;.00nan;0;0
13177;1213;504;0;0;0;0;.00nan;0;0
13177;187813;495;0;0;0;0;.00nan;0;0
13177;46365;504;46;27;4;23;.852;3600000;0
13177;66271;495;66;25;2;23;.920;3600000;0
13178;-1;497;0;0;0;0;.00nan;0;0
13178;40046;2591;0;0;0;0;.00nan;0;0
13178;56078;2591;65;28;3;25;.893;3600000;0
13178;142810;497;100;38;0;38;1.000;3600000;0
13179;3359;502;54;19;3;16;.842;3600000;0
13179;-1;499;95;63;5;58;.921;3544000;0
13179;169680;502;0;0;0;0;.00nan;0;0
13179;-1;499;0;0;0;0;.00nan;0;0
13180;177356;4636;0;0;0;0;.00nan;0;0
13180;49674;498;58;27;3;24;.889;3608000;0
13180;148503;4636;39;19;4;15;.789;3608000;0
13180;148576;498;0;0;0;0;.00nan;0;0
13181;1061;505;67;33;4;29;.879;3900000;0
13181;167480;503;0;0;0;0;.00nan;0;0
13181;-1;505;0;0;0;0;.00nan;0;0
13181;170536;503;70;42;4;38;.905;3900000;0
13182;11614;500;79;21;1;20;.952;3600000;0
13182;63707;500;0;0;0;0;.00nan;0;0
13182;148573;496;82;40;4;36;.900;3600000;0
13182;149305;496;0;0;0;0;.00nan;0;0
13183;1213;504;0;0;0;0;.00nan;0;0
13183;187813;495;0;0;0;0;.00nan;0;0
13183;46365;504;89;52;3;49;.942;3533000;0
13183;66271;495;93;32;1;31;.969;3600000;0
13184;-1;497;0;0;0;0;.00nan;0;0
13184;40046;2591;100;27;0;27;1.000;3600000;0
13184;56078;2591;0;0;0;0;.00nan;0;0
13184;142810;497;85;33;1;32;.970;3557000;0
13185;3359;502;40;20;4;16;.800;3600000;0
13185;-1;499;51;2;0;2;1.000;239000;0
13185;169680;502;0;0;0;0;.00nan;0;0
13185;-1;499;39;34;6;28;.824;3290000;0
13186;177356;4636;0;0;0;0;.00nan;0;0
13186;49674;498;0;0;0;0;.00nan;0;0
13186;148503;4636;87;21;0;21;1.000;3600000;0
13186;148576;498;92;38;2;36;.947;3558000;0
13187;1061;505;87;30;2;28;.933;3900000;0
13187;167480;503;0;0;0;0;.00nan;0;0
13187;-1;505;0;0;0;0;.00nan;0;0
13187;170536;503;96;40;2;38;.950;3900000;0
13188;11614;500;78;24;1;23;.958;3900000;0
13188;63707;500;0;0;0;0;.00nan;0;0
13188;148573;496;0;0;0;0;.00nan;0;0
13188;149305;496;97;36;1;35;.972;3900000;0
13189;11614;500;54;4;0;4;1.000;721000;0
13189;49674;498;99;47;2;45;.957;3600000;0
13189;63707;500;19;25;6;19;.760;2879000;0
13189;148576;498;0;0;0;0;.00nan;0;0
13190;-1;497;0;0;0;0;.00nan;0;0
13190;142810;497;49;30;4;26;.867;3792000;0
13190;148573;496;70;35;3;32;.914;3792000;0
13190;149305;496;0;0;0;0;.00nan;0;0
13191;1061;505;16;8;4;4;.500;949000;0
13191;177356;4636;0;0;0;0;.00nan;0;0
13191;-1;505;76;23;1;22;.957;2651000;0
13191;148503;4636;72;21;1;20;.952;3600000;0
13192;1213;504;72;33;3;30;.909;3561000;0
13192;3359;502;76;28;2;26;.929;3600000;0
13192;169680;502;0;0;0;0;.00nan;0;0
13192;46365;504;0;0;0;0;.00nan;0;0
13193;167480;503;0;0;0;0;.00nan;0;0
13193;-1;499;68;36;4;32;.889;3600000;0
13193;170536;503;41;25;5;20;.800;3600000;0
13193;-1;499;0;0;0;0;.00nan;0;0
13194;187813;495;0;0;0;0;.00nan;0;0
13194;40046;2591;0;0;0;0;.00nan;0;0
13194;56078;2591;52;25;4;21;.840;3550000;0
13194;66271;495;79;35;3;32;.914;3600000;0
13195;11614;500;63;19;1;18;.947;3600000;0
13195;49674;498;0;0;0;0;.00nan;0;0
13195;63707;500;0;0;0;0;.00nan;0;0
13195;148576;498;39;31;5;26;.839;3600000;0
13196;-1;497;0;0;0;0;.00nan;0;0
13196;142810;497;100;33;0;33;1.000;3600000;0
13196;148573;496;45;25;4;21;.840;3600000;0
13196;149305;496;0;0;0;0;.00nan;0;0
13197;1061;505;72;31;2;29;.935;3546000;0
13197;177356;4636;0;0;0;0;.00nan;0;0
13197;-1;505;0;0;0;0;.00nan;0;0
13197;148503;4636;88;27;1;26;.963;3600000;0
13198;1213;504;100;54;2;52;.963;3600000;0
13198;3359;502;44;19;3;16;.842;3555000;0
13198;169680;502;0;0;0;0;.00nan;0;0
13198;46365;504;0;0;0;0;.00nan;0;0
13199;167480;503;41;36;5;31;.861;3600000;0
13199;-1;499;91;42;2;40;.952;3600000;0
13199;170536;503;0;0;0;0;.00nan;0;0
13199;-1;499;0;0;0;0;.00nan;0;0
13200;187813;495;0;0;0;0;.00nan;0;0
13200;40046;2591;69;21;1;20;.952;3600000;0
13200;56078;2591;0;0;0;0;.00nan;0;0
13200;66271;495;49;33;5;28;.848;3600000;0
13201;1061;505;100;25;0;25;1.000;3600000;0
13201;11614;500;68;41;4;37;.902;3600000;0
13201;-1;505;0;0;0;0;.00nan;0;0
13201;63707;500;0;0;0;0;.00nan;0;0
13202;187813;495;0;0;0;0;.00nan;0;0
13202;66271;495;65;28;2;26;.929;3785000;0
13202;148573;496;71;31;3;28;.903;3785000;0
13202;149305;496;0;0;0;0;.00nan;0;0
13203;3359;502;71;23;2;21;.913;3523000;0
13203;169680;502;0;0;0;0;.00nan;0;0
13203;40046;2591;0;0;0;0;.00nan;0;0
13203;56078;2591;100;35;0;35;1.000;3600000;0
13204;-1;497;0;0;0;0;.00nan;0;0
13204;49674;498;73;30;2;28;.933;3600000;0
13204;142810;497;71;39;3;36;.923;3559000;0
13204;148576;498;0;0;0;0;.00nan;0;0
13205;177356;4636;0;0;0;0;.00nan;0;0
13205;167480;503;0;0;0;0;.00nan;0;0
13205;170536;503;61;33;4;29;.879;3900000;0
13205;148503;4636;51;28;4;24;.857;3894000;0
13206;1213;504;82;34;2;32;.941;3802000;0
13206;-1;499;63;24;3;21;.875;3802000;0
13206;-1;499;0;0;0;0;.00nan;0;0
13206;46365;504;0;0;0;0;.00nan;0;0
13207;1061;505;84;27;2;25;.926;3600000;0
13207;11614;500;65;30;3;27;.900;3600000;0
13207;-1;505;0;0;0;0;.00nan;0;0
13207;63707;500;0;0;0;0;.00nan;0;0
13208;187813;495;0;0;0;0;.00nan;0;0
13208;66271;495;77;39;3;36;.923;3600000;0
13208;148573;496;94;19;0;19;1.000;3600000;0
13208;149305;496;0;0;0;0;.00nan;0;0
13209;3359;502;68;21;1;20;.952;3600000;0
13209;169680;502;0;0;0;0;.00nan;0;0
13209;40046;2591;0;0;0;0;.00nan;0;0
13209;56078;2591;70;41;4;37;.902;3600000;0
13210;-1;497;0;0;0;0;.00nan;0;0
13210;49674;498;75;34;3;31;.912;3900000;0
13210;142810;497;62;29;3;26;.897;3900000;0
13210;148576;498;0;0;0;0;.00nan;0;0
13211;177356;4636;0;0;0;0;.00nan;0;0
13211;167480;503;0;0;0;0;.00nan;0;0
13211;170536;503;82;36;2;34;.944;3600000;0
13211;148503;4636;55;28;4;24;.857;3519000;0
13212;1213;504;61;38;4;34;.895;3600000;0
13212;-1;499;0;0;0;0;.00nan;0;0
13212;-1;499;73;22;1;21;.955;3600000;0
13212;46365;504;0;0;0;0;.00nan;0;0
13213;1213;504;0;0;0;0;.00nan;0;0
13213;40046;2591;0;0;0;0;.00nan;0;0
13213;46365;504;77;29;3;26;.897;3900000;0
13213;56078;2591;64;32;3;29;.906;3900000;0
13214;167480;503;0;0;0;0;.00nan;0;0
13214;11614;500;72;31;2;29;.935;3597000;0
13214;170536;503;81;24;1;23;.958;3600000;0
13214;63707;500;0;0;0;0;.00nan;0;0
13215;1061;505;100;37;0;37;1.000;3600000;0
13215;-1;497;73;27;2;25;.926;3531000;0
13215;-1;505;0;0;0;0;.00nan;0;0
13215;142810;497;0;0;0;0;.00nan;0;0
13216;3359;502;80;32;2;30;.938;3866000;0
13216;169680;502;0;0;0;0;.00nan;0;0
13216;148573;496;83;45;3;42;.933;3866000;0
13216;149305;496;0;0;0;0;.00nan;0;0
13217;187813;495;0;0;0;0;.00nan;0;0
13217;49674;498;47;27;4;23;.852;3520000;0
13217;66271;495;66;24;2;22;.917;3600000;0
13217;148576;498;0;0;0;0;.00nan;0;0
13218;177356;4636;0;0;0;0;.00nan;0;0
13218;-1;499;0;0;0;0;.00nan;0;0
13218;-1;499;78;24;1;23;.958;3600000;0
13218;148503;4636;30;33;6;27;.818;3600000;0
13219;1213;504;97;33;1;32;.970;3900000;0
13219;40046;2591;72;21;1;20;.952;3900000;0
13219;46365;504;0;0;0;0;.00nan;0;0
13219;56078;2591;0;0;0;0;.00nan;0;0
13220;167480;503;0;0;0;0;.00nan;0;0
13220;11614;500;0;0;0;0;.00nan;0;0
13220;170536;503;85;40;3;37;.925;3900000;0
13220;63707;500;68;39;3;36;.923;3900000;0
13221;1061;505;88;27;1;26;.963;3600000;0
13221;-1;497;0;0;0;0;.00nan;0;0
13221;-1;505;0;0;0;0;.00nan;0;0
13221;142810;497;55;25;3;22;.880;3576000;0
13222;3359;502;100;34;0;34;1.000;3600000;0
13222;169680;502;0;0;0;0;.00nan;0;0
13222;148573;496;92;36;2;34;.944;3586000;0
13222;149305;496;0;0;0;0;.00nan;0;0
13223;187813;495;0;0;0;0;.00nan;0;0
13223;49674;498;76;36;3;33;.917;3900000;0
13223;66271;495;68;35;3;32;.914;3900000;0
13223;148576;498;0;0;0;0;.00nan;0;0
13224;177356;4636;74;26;2;24;.923;3600000;0
13224;-1;499;0;0;0;0;.00nan;0;0
13224;-1;499;62;31;3;28;.903;3600000;0
13224;148503;4636;0;0;0;0;.00nan;0;0
13225;3359;502;100;26;0;26;1.000;3600000;0
13225;169680;502;0;0;0;0;.00nan;0;0
13225;49674;498;67;38;4;34;.895;3600000;0
13225;148576;498;0;0;0;0;.00nan;0;0
13226;1213;504;67;16;1;15;.938;3600000;0
13226;46365;504;0;0;0;0;.00nan;0;0
13226;148573;496;72;33;3;30;.909;3566000;0
13226;149305;496;0;0;0;0;.00nan;0;0
13227;177356;4636;0;0;0;0;.00nan;0;0
13227;11614;500;91;35;1;34;.971;3600000;0
13227;63707;500;0;0;0;0;.00nan;0;0
13227;148503;4636;52;24;4;20;.833;3600000;0
13228;1061;505;81;36;3;33;.917;3900000;0
13228;187813;495;0;0;0;0;.00nan;0;0
13228;-1;505;0;0;0;0;.00nan;0;0
13228;66271;495;81;41;3;38;.927;3900000;0
13229;167480;503;0;0;0;0;.00nan;0;0
13229;-1;497;0;0;0;0;.00nan;0;0
13229;170536;503;53;33;4;29;.879;3525000;0
13229;142810;497;72;31;3;28;.903;3600000;0
13230;-1;499;62;43;5;38;.884;3543000;0
13230;-1;499;0;0;0;0;.00nan;0;0
13230;40046;2591;0;0;0;0;.00nan;0;0
13230;56078;2591;50;29;4;25;.862;3600000;0
13231;3359;502;100;34;0;34;1.000;3600000;0
13231;169680;502;0;0;0;0;.00nan;0;0
13231;49674;498;0;0;0;0;.00nan;0;0
13231;148576;498;70;27;2;25;.926;3514000;0
13232;1213;504;94;45;2;43;.956;3568000;0
13232;46365;504;0;0;0;0;.00nan;0;0
13232;148573;496;0;0;0;0;.00nan;0;0
13232;149305;496;100;20;0;20;1.000;3600000;0
13233;177356;4636;0;0;0;0;.00nan;0;0
13233;11614;500;68;27;2;25;.926;3608000;0
13233;63707;500;0;0;0;0;.00nan;0;0
13233;148503;4636;64;17;1;16;.941;3608000;0
13234;1061;505;84;31;2;29;.935;3900000;0
13234;187813;495;0;0;0;0;.00nan;0;0
13234;-1;505;0;0;0;0;.00nan;0;0
13234;66271;495;85;33;2;31;.939;3900000;0
13235;167480;503;62;12;0;12;1.000;1498000;0
13235;-1;497;0;0;0;0;.00nan;0;0
13235;170536;503;10;20;7;13;.650;2102000;0
13235;142810;497;88;42;3;39;.929;3600000;0
13236;-1;499;0;0;0;0;.00nan;0;0
13236;-1;499;100;45;1;44;.978;3600000;0
13236;40046;2591;67;35;3;32;.914;3577000;0
13236;56078;2591;0;0;0;0;.00nan;0;0
13237;1213;504;0;0;0;0;.00nan;0;0
13237;46365;504;89;41;3;38;.927;3900000;0
13237;49674;498;0;0;0;0;.00nan;0;0
13237;148576;498;66;27;3;24;.889;3900000;0
13238;187813;495;0;0;0;0;.00nan;0;0
13238;167480;503;0;0;0;0;.00nan;0;0
13238;170536;503;57;37;4;33;.892;3600000;0
13238;66271;495;89;32;1;31;.969;3600000;0
13239;177356;4636;0;0;0;0;.00nan;0;0
13239;-1;497;0;0;0;0;.00nan;0;0
13239;142810;497;88;31;1;30;.968;3600000;0
13239;148503;4636;68;26;2;24;.923;3548000;0
13240;1061;505;72;28;3;25;.893;3600000;0
13240;3359;502;69;36;4;32;.889;3551000;0
13240;-1;505;0;0;0;0;.00nan;0;0
13240;169680;502;0;0;0;0;.00nan;0;0
13241;11614;500;0;0;0;0;.00nan;0;0
13241;-1;499;70;19;1;18;.947;3600000;0
13241;-1;499;0;0;0;0;.00nan;0;0
13241;63707;500;96;21;0;21;1.000;3600000;0
13242;40046;2591;85;33;1;32;.970;3600000;0
13242;56078;2591;0;0;0;0;.00nan;0;0
13242;148573;496;0;0;0;0;.00nan;0;0
13242;149305;496;89;20;0;20;1.000;3600000;0
13243;1213;504;73;27;2;25;.926;3600000;0
13243;46365;504;0;0;0;0;.00nan;0;0
13243;49674;498;66;24;3;21;.875;3600000;0
13243;148576;498;0;0;0;0;.00nan;0;0
13244;187813;495;0;0;0;0;.00nan;0;0
13244;167480;503;0;0;0;0;.00nan;0;0
13244;170536;503;87;37;2;35;.946;3600000;0
13244;66271;495;62;32;3;29;.906;3582000;0
13245;177356;4636;0;0;0;0;.00nan;0;0
13245;-1;497;0;0;0;0;.00nan;0;0
13245;142810;497;90;45;4;41;.911;3600000;0
13245;148503;4636;36;27;5;22;.815;3600000;0
13246;1061;505;79;36;3;33;.917;3600000;0
13246;3359;502;97;23;0;23;1.000;3600000;0
13246;-1;505;0;0;0;0;.00nan;0;0
13246;169680;502;0;0;0;0;.00nan;0;0
13247;11614;500;0;0;0;0;.00nan;0;0
13247;-1;499;0;0;0;0;.00nan;0;0
13247;-1;499;100;34;0;34;1.000;3600000;0
13247;63707;500;41;30;4;26;.867;3600000;0
13248;40046;2591;100;31;0;31;1.000;3600000;0
13248;56078;2591;0;0;0;0;.00nan;0;0
13248;148573;496;0;0;0;0;.00nan;0;0
13248;149305;496;39;32;5;27;.844;3600000;0
13249;40046;2591;0;0;0;0;.00nan;0;0
13249;49674;498;0;0;0;0;.00nan;0;0
13249;56078;2591;75;22;1;21;.955;3600000;0
13249;148576;498;33;39;6;33;.846;3600000;0
13250;1061;505;0;0;0;0;.00nan;0;0
13250;1213;504;92;19;0;19;1.000;3600000;0
13250;-1;505;69;26;2;24;.923;3543000;0
13250;46365;504;0;0;0;0;.00nan;0;0
13251;3359;502;60;19;2;17;.895;3600000;0
13251;167480;503;64;34;3;31;.912;3554000;0
13251;169680;502;0;0;0;0;.00nan;0;0
13251;170536;503;0;0;0;0;.00nan;0;0
13252;11614;500;78;28;2;26;.929;3541000;0
13252;-1;497;0;0;0;0;.00nan;0;0
13252;63707;500;0;0;0;0;.00nan;0;0
13252;142810;497;80;28;1;27;.964;3600000;0
13253;187813;495;0;0;0;0;.00nan;0;0
13253;177356;4636;0;0;0;0;.00nan;0;0
13253;66271;495;100;40;0;40;1.000;3600000;0
13253;148503;4636;63;33;4;29;.879;3600000;0
13254;-1;499;84;25;1;24;.960;3600000;0
13254;-1;499;0;0;0;0;.00nan;0;0
13254;148573;496;88;37;2;35;.946;3600000;0
13254;149305;496;0;0;0;0;.00nan;0;0
13255;40046;2591;100;34;0;34;1.000;3600000;0
13255;49674;498;78;31;2;29;.935;3530000;0
13255;56078;2591;0;0;0;0;.00nan;0;0
13255;148576;498;0;0;0;0;.00nan;0;0
13256;1061;505;93;25;1;24;.960;3600000;0
13256;1213;504;77;30;2;28;.933;3600000;0
13256;-1;505;0;0;0;0;.00nan;0;0
13256;46365;504;0;0;0;0;.00nan;0;0
13257;3359;502;97;48;1;47;.979;3564000;0
13257;167480;503;0;0;0;0;.00nan;0;0
13257;169680;502;0;0;0;0;.00nan;0;0
13257;170536;503;100;24;0;24;1.000;3600000;0
13258;11614;500;100;34;1;33;.971;3618000;0
13258;-1;497;0;0;0;0;.00nan;0;0
13258;63707;500;0;0;0;0;.00nan;0;0
13258;142810;497;77;31;2;29;.935;3618000;0
13259;187813;495;67;12;0;12;1.000;1877000;0
13259;177356;4636;77;27;1;26;.963;3600000;0
13259;66271;495;16;21;6;15;.714;1723000;0
13259;148503;4636;0;0;0;0;.00nan;0;0
13260;-1;499;0;0;0;0;.00nan;0;0
13260;-1;499;79;29;1;28;.966;3600000;0
13260;148573;496;47;33;5;28;.848;3600000;0
13260;149305;496;0;0;0;0;.00nan;0;0
13261;3359;502;42;28;5;23;.821;3600000;0
13261;177356;4636;0;0;0;0;.00nan;0;0
13261;169680;502;0;0;0;0;.00nan;0;0
13261;148503;4636;76;27;1;26;.963;3600000;0
13262;187813;495;0;0;0;0;.00nan;0;0
13262;11614;500;0;0;0;0;.00nan;0;0
13262;63707;500;98;52;1;51;.981;3900000;0
13262;66271;495;60;21;1;20;.952;3900000;0
13263;-1;497;0;0;0;0;.00nan;0;0
13263;-1;499;41;35;6;29;.829;3600000;0
13263;-1;499;0;0;0;0;.00nan;0;0
13263;142810;497;68;16;1;15;.938;3600000;0
13264;1213;504;56;38;4;34;.895;3900000;0
13264;167480;503;0;0;0;0;.00nan;0;0
13264;170536;503;72;39;4;35;.897;3900000;0
13264;46365;504;0;0;0;0;.00nan;0;0
13265;49674;498;94;41;2;39;.951;3600000;0
13265;148573;496;65;28;3;25;.893;3600000;0
13265;148576;498;0;0;0;0;.00nan;0;0
13265;149305;496;0;0;0;0;.00nan;0;0
13266;1061;505;77;34;2;32;.941;3569000;0
13266;-1;505;0;0;0;0;.00nan;0;0
13266;40046;2591;100;32;0;32;1.000;3600000;0
13266;56078;2591;0;0;0;0;.00nan;0;0
13267;3359;502;99;25;0;25;1.000;3600000;0
13267;177356;4636;0;0;0;0;.00nan;0;0
13267;169680;502;0;0;0;0;.00nan;0;0
13267;148503;4636;78;30;1;29;.967;3579000;0
13268;187813;495;0;0;0;0;.00nan;0;0
13268;11614;500;68;22;1;21;.955;3570000;0
13268;63707;500;0;0;0;0;.00nan;0;0
13268;66271;495;100;28;0;28;1.000;3600000;0
13269;-1;497;0;0;0;0;.00nan;0;0
13269;-1;499;0;0;0;0;.00nan;0;0
13269;-1;499;79;28;2;26;.929;3574000;0
13269;142810;497;83;28;1;27;.964;3600000;0
13270;1213;504;72;37;3;34;.919;3577000;0
13270;167480;503;0;0;0;0;.00nan;0;0
13270;170536;503;74;22;1;21;.955;3600000;0
13270;46365;504;0;0;0;0;.00nan;0;0
13271;49674;498;0;0;0;0;.00nan;0;0
13271;148573;496;90;42;2;40;.952;3545000;0
13271;148576;498;93;31;1;30;.968;3600000;0
13271;149305;496;0;0;0;0;.00nan;0;0
13272;1061;505;55;23;3;20;.870;3900000;0
13272;-1;505;0;0;0;0;.00nan;0;0
13272;40046;2591;67;35;3;32;.914;3900000;0
13272;56078;2591;0;0;0;0;.00nan;0;0
13273;1061;505;81;22;1;21;.955;3600000;0
13273;-1;505;0;0;0;0;.00nan;0;0
13273;148573;496;59;36;4;32;.889;3600000;0
13273;149305;496;0;0;0;0;.00nan;0;0
13274;167480;503;0;0;0;0;.00nan;0;0
13274;170536;503;65;34;3;31;.912;3589000;0
13274;40046;2591;68;23;2;21;.913;3600000;0
13274;56078;2591;0;0;0;0;.00nan;0;0
13275;-1;499;55;19;2;17;.895;3600000;0
13275;-1;499;0;0;0;0;.00nan;0;0
13275;49674;498;46;34;5;29;.853;3600000;0
13275;148576;498;0;0;0;0;.00nan;0;0
13276;3359;502;82;18;0;18;1.000;3600000;0
13276;11614;500;0;0;0;0;.00nan;0;0
13276;169680;502;0;0;0;0;.00nan;0;0
13276;63707;500;73;33;2;31;.939;3589000;0
13277;187813;495;0;0;0;0;.00nan;0;0
13277;-1;497;0;0;0;0;.00nan;0;0
13277;66271;495;81;26;1;25;.962;3600000;0
13277;142810;497;98;44;2;42;.955;3581000;0
13278;1213;504;81;35;3;32;.914;3600000;0
13278;177356;4636;0;0;0;0;.00nan;0;0
13278;46365;504;0;0;0;0;.00nan;0;0
13278;148503;4636;38;22;4;18;.818;3543000;0
13279;1061;505;88;36;2;34;.944;3828000;0
13279;-1;505;0;0;0;0;.00nan;0;0
13279;148573;496;66;21;1;20;.952;3828000;0
13279;149305;496;0;0;0;0;.00nan;0;0
13280;167480;503;100;39;0;39;1.000;3600000;0
13280;170536;503;0;0;0;0;.00nan;0;0
13280;40046;2591;89;31;1;30;.968;3591000;0
13280;56078;2591;0;0;0;0;.00nan;0;0
13281;-1;499;100;32;0;32;1.000;3600000;0
13281;-1;499;0;0;0;0;.00nan;0;0
13281;49674;498;0;0;0;0;.00nan;0;0
13281;148576;498;75;32;2;30;.938;3551000;0
13282;3359;502;91;29;1;28;.966;3600000;0
13282;11614;500;0;0;0;0;.00nan;0;0
13282;169680;502;0;0;0;0;.00nan;0;0
13282;63707;500;53;42;6;36;.857;3600000;0
13283;187813;495;0;0;0;0;.00nan;0;0
13283;-1;497;0;0;0;0;.00nan;0;0
13283;66271;495;100;33;0;33;1.000;3600000;0
13283;142810;497;56;29;3;26;.897;3600000;0
13284;1213;504;93;41;2;39;.951;3600000;0
13284;177356;4636;0;0;0;0;.00nan;0;0
13284;46365;504;0;0;0;0;.00nan;0;0
13284;148503;4636;50;22;3;19;.864;3569000;0
13285;1061;505;68;18;1;17;.944;3600000;0
13285;-1;505;0;0;0;0;.00nan;0;0
13285;49674;498;87;37;2;35;.946;3574000;0
13285;148576;498;0;0;0;0;.00nan;0;0
13286;167480;503;88;32;1;31;.969;3600000;0
13286;170536;503;0;0;0;0;.00nan;0;0
13286;148573;496;64;38;5;33;.868;3600000;0
13286;149305;496;0;0;0;0;.00nan;0;0
13287;177356;4636;0;0;0;0;.00nan;0;0
13287;40046;2591;75;37;3;34;.919;3600000;0
13287;56078;2591;0;0;0;0;.00nan;0;0
13287;148503;4636;96;18;0;18;1.000;3600000;0
13288;1213;504;84;32;2;30;.938;3900000;0
13288;11614;500;72;33;2;31;.939;3900000;0
13288;46365;504;0;0;0;0;.00nan;0;0
13288;63707;500;0;0;0;0;.00nan;0;0
13289;187813;495;0;0;0;0;.00nan;0;0
13289;-1;499;49;35;4;31;.886;3520000;0
13289;-1;499;0;0;0;0;.00nan;0;0
13289;66271;495;84;40;2;38;.950;3600000;0
13290;3359;502;95;36;1;35;.972;3900000;0
13290;-1;497;0;0;0;0;.00nan;0;0
13290;169680;502;0;0;0;0;.00nan;0;0
13290;142810;497;90;31;1;30;.968;3900000;0
13291;1061;505;98;37;1;36;.973;3600000;0
13291;-1;505;0;0;0;0;.00nan;0;0
13291;49674;498;42;22;4;18;.818;3600000;0
13291;148576;498;0;0;0;0;.00nan;0;0
13292;167480;503;0;0;0;0;.00nan;0;0
13292;170536;503;62;24;2;22;.917;3600000;0
13292;148573;496;24;25;6;19;.760;2174000;0
13292;149305;496;57;14;1;13;.929;1426000;0
13293;177356;4636;0;0;0;0;.00nan;0;0
13293;40046;2591;82;29;1;28;.966;3600000;0
13293;56078;2591;0;0;0;0;.00nan;0;0
13293;148503;4636;63;29;3;26;.897;3570000;0
13294;1213;504;66;37;4;33;.892;3600000;0
13294;11614;500;99;37;1;36;.973;3600000;0
13294;46365;504;0;0;0;0;.00nan;0;0
13294;63707;500;0;0;0;0;.00nan;0;0
13295;187813;495;75;28;2;26;.929;3600000;0
13295;-1;499;22;26;6;20;.769;2837000;0
13295;-1;499;55;6;0;6;1.000;763000;0
13295;66271;495;0;0;0;0;.00nan;0;0
13296;3359;502;88;37;2;35;.946;3548000;0
13296;-1;497;0;0;0;0;.00nan;0;0
13296;169680;502;0;0;0;0;.00nan;0;0
13296;142810;497;90;25;1;24;.960;3600000;0
13297;3359;502;0;0;0;0;.00nan;0;0
13297;187813;495;0;0;0;0;.00nan;0;0
13297;169680;502;51;12;2;10;.833;3600000;0
13297;66271;495;61;32;4;28;.875;3565000;0
13298;1213;504;0;0;0;0;.00nan;0;0
13298;-1;497;46;11;2;9;.818;805000;0
13298;46365;504;39;21;4;17;.810;3600000;0
13298;142810;497;22;24;6;18;.750;2795000;0
13299;11614;500;60;34;4;30;.882;3600000;0
13299;40046;2591;91;27;1;26;.963;3600000;0
13299;56078;2591;0;0;0;0;.00nan;0;0
13299;63707;500;0;0;0;0;.00nan;0;0
13300;167480;503;0;0;0;0;.00nan;0;0
13300;170536;503;56;22;3;19;.864;3600000;0
13300;49674;498;77;40;4;36;.900;3600000;0
13300;148576;498;0;0;0;0;.00nan;0;0
13301;177356;4636;0;0;0;0;.00nan;0;0
13301;148503;4636;100;25;0;25;1.000;3900000;0
13301;148573;496;97;31;0;31;1.000;3900000;0
13301;149305;496;0;0;0;0;.00nan;0;0
13302;1061;505;62;23;2;21;.913;3600000;0
13302;-1;505;0;0;0;0;.00nan;0;0
13302;-1;499;0;0;0;0;.00nan;0;0
13302;-1;499;57;27;3;24;.889;3600000;0
13303;3359;502;43;34;6;28;.824;3600000;0
13303;187813;495;0;0;0;0;.00nan;0;0
13303;169680;502;0;0;0;0;.00nan;0;0
13303;66271;495;72;26;2;24;.923;3600000;0
13304;1213;504;78;40;3;37;.925;3600000;0
13304;-1;497;0;0;0;0;.00nan;0;0
13304;46365;504;0;0;0;0;.00nan;0;0
13304;142810;497;63;32;4;28;.875;3551000;0
13305;11614;500;51;40;5;35;.875;3600000;0
13305;40046;2591;50;28;4;24;.857;3600000;0
13305;56078;2591;0;0;0;0;.00nan;0;0
13305;63707;500;0;0;0;0;.00nan;0;0
13306;167480;503;0;0;0;0;.00nan;0;0
13306;170536;503;52;35;4;31;.886;3600000;0
13306;49674;498;60;24;3;21;.875;3600000;0
13306;148576;498;0;0;0;0;.00nan;0;0
13307;177356;4636;0;0;0;0;.00nan;0;0
13307;148503;4636;100;21;0;21;1.000;3600000;0
13307;148573;496;59;29;4;25;.862;3600000;0
13307;149305;496;0;0;0;0;.00nan;0;0
13308;1061;505;79;23;1;22;.957;3600000;0
13308;-1;505;0;0;0;0;.00nan;0;0
13308;-1;499;0;0;0;0;.00nan;0;0
13308;-1;499;44;19;3;16;.842;3514000;0
13309;11614;500;100;43;1;42;.977;3900000;0
13309;63707;500;0;0;0;0;.00nan;0;0
13309;148573;496;80;24;1;23;.958;3900000;0
13309;149305;496;0;0;0;0;.00nan;0;0
13310;1061;505;40;31;5;26;.839;3519000;0
13310;167480;503;0;0;0;0;.00nan;0;0
13310;-1;505;0;0;0;0;.00nan;0;0
13310;170536;503;52;25;3;22;.880;3600000;0
13311;177356;4636;0;0;0;0;.00nan;0;0
13311;49674;498;60;25;3;22;.880;3572000;0
13311;148503;4636;63;18;2;16;.889;3600000;0
13311;148576;498;0;0;0;0;.00nan;0;0
13312;3359;502;52;17;2;15;.882;3552000;0
13312;-1;499;0;0;0;0;.00nan;0;0
13312;169680;502;0;0;0;0;.00nan;0;0
13312;-1;499;98;35;1;34;.971;3600000;0
13313;1213;504;46;33;5;28;.848;3600000;0
13313;187813;495;0;0;0;0;.00nan;0;0
13313;46365;504;0;0;0;0;.00nan;0;0
13313;66271;495;78;26;1;25;.962;3600000;0
13314;-1;497;0;0;0;0;.00nan;0;0
13314;40046;2591;89;36;1;35;.972;3600000;0
13314;56078;2591;0;0;0;0;.00nan;0;0
13314;142810;497;44;27;4;23;.852;3600000;0
13315;11614;500;0;0;0;0;.00nan;0;0
13315;63707;500;100;33;0;33;1.000;3600000;0
13315;148573;496;53;24;3;21;.875;3600000;0
13315;149305;496;0;0;0;0;.00nan;0;0
13316;1061;505;81;44;4;40;.909;3600000;0
13316;167480;503;0;0;0;0;.00nan;0;0
13316;-1;505;0;0;0;0;.00nan;0;0
13316;170536;503;73;20;1;19;.950;3600000;0
13317;177356;4636;0;0;0;0;.00nan;0;0
13317;49674;498;97;30;0;30;1.000;3900000;0
13317;148503;4636;85;15;0;15;1.000;3900000;0
13317;148576;498;0;0;0;0;.00nan;0;0
13318;3359;502;59;27;3;24;.889;3600000;0
13318;-1;499;42;35;6;29;.829;3600000;0
13318;169680;502;0;0;0;0;.00nan;0;0
13318;-1;499;0;0;0;0;.00nan;0;0
13319;1213;504;24;25;6;19;.760;2756000;0
13319;187813;495;0;0;0;0;.00nan;0;0
13319;46365;504;60;7;0;7;1.000;844000;0
13319;66271;495;88;30;1;29;.967;3600000;0
13320;-1;497;90;45;4;41;.911;3543000;0
13320;40046;2591;74;24;2;22;.917;3600000;0
13320;56078;2591;0;0;0;0;.00nan;0;0
13320;142810;497;0;0;0;0;.00nan;0;0
13321;1213;504;0;0;0;0;.00nan;0;0
13321;3359;502;68;20;1;19;.950;3600000;0
13321;169680;502;0;0;0;0;.00nan;0;0
13321;46365;504;94;43;2;41;.953;3599000;0
13322;187813;495;0;0;0;0;.00nan;0;0
13322;40046;2591;89;27;1;26;.963;3600000;0
13322;56078;2591;0;0;0;0;.00nan;0;0
13322;66271;495;87;45;4;41;.911;3600000;0
13323;167480;503;0;0;0;0;.00nan;0;0
13323;-1;499;0;0;0;0;.00nan;0;0
13323;170536;503;88;38;2;36;.947;3600000;0
13323;-1;499;85;31;1;30;.968;3600000;0
13324;11614;500;0;0;0;0;.00nan;0;0
13324;49674;498;30;8;3;5;.625;542000;0
13324;63707;500;56;26;3;23;.885;3600000;0
13324;148576;498;71;27;2;25;.926;3018000;0
13325;1061;505;93;44;2;42;.955;3600000;0
13325;177356;4636;0;0;0;0;.00nan;0;0
13325;-1;505;0;0;0;0;.00nan;0;0
13325;148503;4636;55;19;3;16;.842;3553000;0
13326;-1;497;0;0;0;0;.00nan;0;0
13326;142810;497;84;42;3;39;.929;3600000;0
13326;148573;496;61;25;2;23;.920;3600000;0
13326;149305;496;0;0;0;0;.00nan;0;0
13327;1213;504;95;30;1;29;.967;3900000;0
13327;3359;502;75;25;1;24;.960;3900000;0
13327;169680;502;0;0;0;0;.00nan;0;0
13327;46365;504;0;0;0;0;.00nan;0;0
13328;187813;495;0;0;0;0;.00nan;0;0
13328;40046;2591;0;0;0;0;.00nan;0;0
13328;56078;2591;70;25;2;23;.920;3583000;0
13328;66271;495;78;24;1;23;.958;3600000;0
13329;167480;503;0;0;0;0;.00nan;0;0
13329;-1;499;77;30;2;28;.933;3900000;0
13329;170536;503;93;38;2;36;.947;3900000;0
13329;-1;499;0;0;0;0;.00nan;0;0
13330;11614;500;64;30;4;26;.867;3578000;0
13330;49674;498;0;0;0;0;.00nan;0;0
13330;63707;500;0;0;0;0;.00nan;0;0
13330;148576;498;82;31;2;29;.935;3600000;0
13331;1061;505;74;23;1;22;.957;3600000;0
13331;177356;4636;0;0;0;0;.00nan;0;0
13331;-1;505;0;0;0;0;.00nan;0;0
13331;148503;4636;65;16;2;14;.875;3549000;0
13332;-1;497;0;0;0;0;.00nan;0;0
13332;142810;497;81;33;2;31;.939;3528000;0
13332;148573;496;0;0;0;0;.00nan;0;0
13332;149305;496;86;16;0;16;1.000;3600000;0
13333;1213;504;85;32;2;30;.938;3600000;0
13333;-1;499;0;0;0;0;.00nan;0;0
13333;-1;499;74;22;1;21;.955;3600000;0
13333;46365;504;0;0;0;0;.00nan;0;0
13334;-1;497;0;0;0;0;.00nan;0;0
13334;49674;498;41;22;4;18;.818;3600000;0
13334;142810;497;89;26;1;25;.962;3600000;0
13334;148576;498;0;0;0;0;.00nan;0;0
13335;177356;4636;0;0;0;0;.00nan;0;0
13335;167480;503;0;0;0;0;.00nan;0;0
13335;170536;503;59;37;5;32;.865;3600000;0
13335;148503;4636;77;14;1;13;.929;3600000;0
13336;3359;502;76;26;2;24;.923;3600000;0
13336;169680;502;0;0;0;0;.00nan;0;0
13336;40046;2591;73;38;4;34;.895;3514000;0
13336;56078;2591;0;0;0;0;.00nan;0;0
13337;1061;505;89;31;1;30;.968;3600000;0
13337;11614;500;58;28;3;25;.893;3600000;0
13337;-1;505;0;0;0;0;.00nan;0;0
13337;63707;500;0;0;0;0;.00nan;0;0
13338;187813;495;0;0;0;0;.00nan;0;0
13338;66271;495;80;32;2;30;.938;3900000;0
13338;148573;496;0;0;0;0;.00nan;0;0
13338;149305;496;77;28;2;26;.929;3900000;0
13339;1213;504;72;25;2;23;.920;3600000;0
13339;-1;499;70;43;4;39;.907;3524000;0
13339;-1;499;0;0;0;0;.00nan;0;0
13339;46365;504;0;0;0;0;.00nan;0;0
13340;-1;497;0;0;0;0;.00nan;0;0
13340;49674;498;0;0;0;0;.00nan;0;0
13340;142810;497;64;44;5;39;.886;3599000;0
13340;148576;498;67;28;3;25;.893;3600000;0
13341;177356;4636;0;0;0;0;.00nan;0;0
13341;167480;503;0;0;0;0;.00nan;0;0
13341;170536;503;100;30;0;30;1.000;3600000;0
13341;148503;4636;78;26;2;24;.923;3517000;0
13342;3359;502;89;36;1;35;.972;3600000;0
13342;169680;502;0;0;0;0;.00nan;0;0
13342;40046;2591;95;24;0;24;1.000;3600000;0
13342;56078;2591;0;0;0;0;.00nan;0;0
13343;1061;505;34;35;6;29;.829;2535000;0
13343;11614;500;0;0;0;0;.00nan;0;0
13343;-1;505;66;8;0;8;1.000;1065000;0
13343;63707;500;58;25;3;22;.880;3600000;0
13344;187813;495;0;0;0;0;.00nan;0;0
13344;66271;495;54;34;5;29;.853;3600000;0
13344;148573;496;84;29;1;28;.966;3600000;0
13344;149305;496;0;0;0;0;.00nan;0;0
13345;187813;495;0;0;0;0;.00nan;0;0
13345;49674;498;78;41;4;37;.902;3600000;0
13345;66271;495;83;31;2;29;.935;3600000;0
13345;148576;498;0;0;0;0;.00nan;0;0
13346;3359;502;74;26;2;24;.923;3600000;0
13346;169680;502;0;0;0;0;.00nan;0;0
13346;148573;496;28;26;6;20;.769;2973000;0
13346;149305;496;53;3;0;3;1.000;627000;0
13347;177356;4636;0;0;0;0;.00nan;0;0
13347;-1;499;0;0;0;0;.00nan;0;0
13347;-1;499;87;31;2;29;.935;3600000;0
13347;148503;4636;70;34;3;31;.912;3583000;0
13348;1061;505;54;27;4;23;.852;3519000;0
13348;-1;497;0;0;0;0;.00nan;0;0
13348;-1;505;0;0;0;0;.00nan;0;0
13348;142810;497;87;36;2;34;.944;3600000;0
13349;167480;503;0;0;0;0;.00nan;0;0
13349;11614;500;71;36;4;32;.889;3600000;0
13349;170536;503;78;30;3;27;.900;3600000;0
13349;63707;500;0;0;0;0;.00nan;0;0
13350;1213;504;72;38;4;34;.895;3640000;0
13350;40046;2591;74;27;3;24;.889;3640000;0
13350;46365;504;0;0;0;0;.00nan;0;0
13350;56078;2591;0;0;0;0;.00nan;0;0
13351;187813;495;0;0;0;0;.00nan;0;0
13351;49674;498;0;0;0;0;.00nan;0;0
13351;66271;495;87;33;2;31;.939;3600000;0
13351;148576;498;61;27;3;24;.889;3566000;0
13352;3359;502;69;30;3;27;.900;3555000;0
13352;169680;502;0;0;0;0;.00nan;0;0
13352;148573;496;0;0;0;0;.00nan;0;0
13352;149305;496;82;30;1;29;.967;3600000;0
13353;177356;4636;0;0;0;0;.00nan;0;0
13353;-1;499;89;33;2;31;.939;3600000;0
13353;-1;499;0;0;0;0;.00nan;0;0
13353;148503;4636;52;27;4;23;.852;3539000;0
13354;1061;505;68;37;3;34;.919;3900000;0
13354;-1;497;0;0;0;0;.00nan;0;0
13354;-1;505;0;0;0;0;.00nan;0;0
13354;142810;497;49;27;3;24;.889;3900000;0
13355;167480;503;69;18;1;17;.944;3600000;0
13355;11614;500;89;33;2;31;.939;3543000;0
13355;170536;503;0;0;0;0;.00nan;0;0
13355;63707;500;0;0;0;0;.00nan;0;0
13356;1213;504;83;38;2;36;.947;3523000;0
13356;40046;2591;100;22;0;22;1.000;3600000;0
13356;46365;504;0;0;0;0;.00nan;0;0
13356;56078;2591;0;0;0;0;.00nan;0;0
13357;1061;505;100;43;2;41;.953;3600000;0
13357;-1;505;0;0;0;0;.00nan;0;0
13357;50069;495;0;0;0;0;.00nan;0;0
13357;66271;495;78;33;3;30;.909;3554000;0
13358;-1;499;0;0;0;0;.00nan;0;0
13358;-1;499;97;37;1;36;.973;3600000;0
13358;40046;2591;64;29;3;26;.897;3534000;0
13358;56078;2591;0;0;0;0;.00nan;0;0
13359;167480;503;0;0;0;0;.00nan;0;0
13359;-1;497;88;33;1;32;.970;3600000;0
13359;170536;503;52;18;2;16;.889;3560000;0
13359;142810;497;0;0;0;0;.00nan;0;0
13360;3359;502;81;28;1;27;.964;3600000;0
13360;169680;502;0;0;0;0;.00nan;0;0
13360;49674;498;97;50;2;48;.960;3585000;0
13360;148576;498;0;0;0;0;.00nan;0;0
13361;1213;504;81;43;3;40;.930;3549000;0
13361;46365;504;0;0;0;0;.00nan;0;0
13361;148573;496;53;17;2;15;.882;3600000;0
13361;149305;496;0;0;0;0;.00nan;0;0
13362;177356;4636;0;0;0;0;.00nan;0;0
13362;11614;500;90;26;1;25;.962;3900000;0
13362;63707;500;0;0;0;0;.00nan;0;0
13362;148503;4636;94;34;1;33;.971;3900000;0
13363;1061;505;76;37;2;35;.946;3581000;0
13363;-1;505;0;0;0;0;.00nan;0;0
13363;50069;495;0;0;0;0;.00nan;0;0
13363;66271;495;73;22;1;21;.955;3600000;0
13364;-1;499;68;23;1;22;.957;3900000;0
13364;-1;499;0;0;0;0;.00nan;0;0
13364;40046;2591;100;45;1;44;.978;3900000;0
13364;56078;2591;0;0;0;0;.00nan;0;0
13365;167480;503;0;0;0;0;.00nan;0;0
13365;-1;497;0;0;0;0;.00nan;0;0
13365;170536;503;56;28;3;25;.893;3600000;0
13365;142810;497;68;19;1;18;.947;3600000;0
13366;3359;502;77;29;2;27;.931;3900000;0
13366;169680;502;0;0;0;0;.00nan;0;0
13366;49674;498;0;0;0;0;.00nan;0;0
13366;148576;498;82;38;2;36;.947;3900000;0
13367;1213;504;0;0;0;0;.00nan;0;0
13367;46365;504;48;39;6;33;.846;3600000;0
13367;148573;496;59;27;3;24;.889;3600000;0
13367;149305;496;0;0;0;0;.00nan;0;0
13368;177356;4636;0;0;0;0;.00nan;0;0
13368;11614;500;95;37;2;35;.946;3600000;0
13368;63707;500;0;0;0;0;.00nan;0;0
13368;148503;4636;53;26;3;23;.885;3546000;0
13369;1061;505;96;40;2;38;.950;3540000;0
13369;3359;502;87;33;1;32;.970;3600000;0
13369;-1;505;0;0;0;0;.00nan;0;0
13369;169680;502;0;0;0;0;.00nan;0;0
13370;40046;2591;78;35;2;33;.943;3600000;0
13370;56078;2591;0;0;0;0;.00nan;0;0
13370;148573;496;47;24;4;20;.833;3512000;0
13370;149305;496;0;0;0;0;.00nan;0;0
13371;177356;4636;0;0;0;0;.00nan;0;0
13371;-1;497;0;0;0;0;.00nan;0;0
13371;142810;497;59;27;3;24;.889;3600000;0
13371;148503;4636;72;29;2;27;.931;3600000;0
13372;1213;504;56;39;6;33;.846;3600000;0
13372;46365;504;0;0;0;0;.00nan;0;0
13372;49674;498;0;0;0;0;.00nan;0;0
13372;148576;498;69;27;2;25;.926;3600000;0
13373;167480;503;0;0;0;0;.00nan;0;0
13373;170536;503;100;38;1;37;.974;3600000;0
13373;50069;495;0;0;0;0;.00nan;0;0
13373;66271;495;84;37;2;35;.946;3547000;0
13374;11614;500;96;32;1;31;.969;3900000;0
13374;-1;499;0;0;0;0;.00nan;0;0
13374;-1;499;96;38;1;37;.974;3900000;0
13374;63707;500;0;0;0;0;.00nan;0;0
13375;1061;505;77;32;3;29;.906;3600000;0
13375;3359;502;58;35;4;31;.886;3568000;0
13375;-1;505;0;0;0;0;.00nan;0;0
13375;169680;502;0;0;0;0;.00nan;0;0
13376;40046;2591;100;25;0;25;1.000;3600000;0
13376;56078;2591;0;0;0;0;.00nan;0;0
13376;148573;496;60;32;4;28;.875;3600000;0
13376;149305;496;0;0;0;0;.00nan;0;0
13377;177356;4636;75;21;1;20;.952;3900000;0
13377;-1;497;0;0;0;0;.00nan;0;0
13377;142810;497;88;32;1;31;.969;3900000;0
13377;148503;4636;0;0;0;0;.00nan;0;0
13378;1213;504;69;25;2;23;.920;3581000;0
13378;46365;504;0;0;0;0;.00nan;0;0
13378;49674;498;80;29;1;28;.966;3600000;0
13378;148576;498;0;0;0;0;.00nan;0;0
13379;167480;503;0;0;0;0;.00nan;0;0
13379;170536;503;62;27;3;24;.889;3808000;0
13379;50069;495;0;0;0;0;.00nan;0;0
13379;66271;495;100;41;2;39;.951;3808000;0
13380;11614;500;76;37;3;34;.919;3600000;0
13380;-1;499;100;29;0;29;1.000;3600000;0
13380;-1;499;0;0;0;0;.00nan;0;0
13380;63707;500;0;0;0;0;.00nan;0;0
13381;177356;4636;0;0;0;0;.00nan;0;0
13381;50069;495;0;0;0;0;.00nan;0;0
13381;66271;495;70;24;2;22;.917;3600000;0
13381;148503;4636;62;37;4;33;.892;3555000;0
13382;-1;499;88;34;2;32;.941;3600000;0
13382;-1;499;0;0;0;0;.00nan;0;0
13382;148573;496;56;28;3;25;.893;3542000;0
13382;149305;496;0;0;0;0;.00nan;0;0
13383;11614;500;74;20;1;19;.950;3900000;0
13383;-1;497;0;0;0;0;.00nan;0;0
13383;63707;500;0;0;0;0;.00nan;0;0
13383;142810;497;98;31;1;30;.968;3900000;0
13384;3359;502;56;40;5;35;.875;3600000;0
13384;167480;503;0;0;0;0;.00nan;0;0
13384;169680;502;0;0;0;0;.00nan;0;0
13384;170536;503;91;20;0;20;1.000;3600000;0
13385;1061;505;55;21;3;18;.857;3529000;0
13385;1213;504;0;0;0;0;.00nan;0;0
13385;-1;505;0;0;0;0;.00nan;0;0
13385;46365;504;99;43;1;42;.977;3600000;0
13386;40046;2591;35;23;5;18;.783;3565000;0
13386;49674;498;62;38;4;34;.895;3600000;0
13386;56078;2591;0;0;0;0;.00nan;0;0
13386;148576;498;0;0;0;0;.00nan;0;0
13387;177356;4636;0;0;0;0;.00nan;0;0
13387;50069;495;0;0;0;0;.00nan;0;0
13387;66271;495;69;35;3;32;.914;3557000;0
13387;148503;4636;91;34;2;32;.941;3600000;0
13388;-1;499;66;37;3;34;.919;3600000;0
13388;-1;499;0;0;0;0;.00nan;0;0
13388;148573;496;70;20;2;18;.900;3600000;0
13388;149305;496;0;0;0;0;.00nan;0;0
13389;11614;500;38;19;4;15;.789;3600000;0
13389;-1;497;0;0;0;0;.00nan;0;0
13389;63707;500;0;0;0;0;.00nan;0;0
13389;142810;497;80;36;3;33;.917;3600000;0
13390;3359;502;75;29;1;28;.966;3600000;0
13390;167480;503;0;0;0;0;.00nan;0;0
13390;169680;502;0;0;0;0;.00nan;0;0
13390;170536;503;71;37;4;33;.892;3600000;0
13391;1061;505;72;36;3;33;.917;3600000;0
13391;1213;504;43;23;4;19;.826;3545000;0
13391;-1;505;0;0;0;0;.00nan;0;0
13391;46365;504;0;0;0;0;.00nan;0;0
13392;40046;2591;0;0;0;0;.00nan;0;0
13392;49674;498;0;0;0;0;.00nan;0;0
13392;56078;2591;51;23;3;20;.870;3533000;0
13392;148576;498;88;32;1;31;.969;3600000;0
13393;11614;500;98;36;1;35;.972;3600000;0
13393;50069;495;0;0;0;0;.00nan;0;0
13393;63707;500;0;0;0;0;.00nan;0;0
13393;66271;495;53;24;3;21;.875;3515000;0
13394;3359;502;45;28;4;24;.857;3600000;0
13394;177356;4636;0;0;0;0;.00nan;0;0
13394;169680;502;0;0;0;0;.00nan;0;0
13394;148503;4636;93;32;1;31;.969;3600000;0
13395;-1;497;0;0;0;0;.00nan;0;0
13395;-1;499;100;28;0;28;1.000;3600000;0
13395;-1;499;0;0;0;0;.00nan;0;0
13395;142810;497;70;28;2;26;.929;3547000;0
13396;49674;498;79;31;3;28;.903;3883000;0
13396;148573;496;79;28;2;26;.929;3883000;0
13396;148576;498;0;0;0;0;.00nan;0;0
13396;149305;496;0;0;0;0;.00nan;0;0
13397;1061;505;78;38;3;35;.921;3569000;0
13397;-1;505;0;0;0;0;.00nan;0;0
13397;40046;2591;90;40;2;38;.950;3600000;0
13397;56078;2591;0;0;0;0;.00nan;0;0
13398;1213;504;84;40;3;37;.925;3718000;0
13398;167480;503;0;0;0;0;.00nan;0;0
13398;170536;503;63;29;4;25;.862;3718000;0
13398;46365;504;0;0;0;0;.00nan;0;0
13399;11614;500;34;33;6;27;.818;3148000;0
13399;50069;495;0;0;0;0;.00nan;0;0
13399;63707;500;51;4;0;4;1.000;452000;0
13399;66271;495;66;35;3;32;.914;3600000;0
13400;3359;502;100;36;0;36;1.000;3600000;0
13400;177356;4636;0;0;0;0;.00nan;0;0
13400;169680;502;0;0;0;0;.00nan;0;0
13400;148503;4636;71;21;1;20;.952;3578000;0
13401;-1;497;0;0;0;0;.00nan;0;0
13401;-1;499;86;30;2;28;.933;3900000;0
13401;-1;499;0;0;0;0;.00nan;0;0
13401;142810;497;99;38;2;36;.947;3900000;0
13402;49674;498;0;0;0;0;.00nan;0;0
13402;148573;496;41;26;4;22;.846;3592000;0
13402;148576;498;69;29;3;26;.897;3600000;0
13402;149305;496;0;0;0;0;.00nan;0;0
13403;1061;505;100;49;1;48;.980;3900000;0
13403;-1;505;0;0;0;0;.00nan;0;0
13403;40046;2591;73;23;1;22;.957;3900000;0
13403;56078;2591;0;0;0;0;.00nan;0;0
13404;1213;504;70;37;3;34;.919;3543000;0
13404;167480;503;0;0;0;0;.00nan;0;0
13404;170536;503;86;25;1;24;.960;3600000;0
13404;46365;504;0;0;0;0;.00nan;0;0
13405;-1;499;68;28;2;26;.929;3589000;0
13405;-1;499;0;0;0;0;.00nan;0;0
13405;49674;498;97;37;1;36;.973;3600000;0
13405;148576;498;0;0;0;0;.00nan;0;0
13406;3359;502;94;21;0;21;1.000;3600000;0
13406;11614;500;73;45;4;41;.911;3600000;0
13406;169680;502;0;0;0;0;.00nan;0;0
13406;63707;500;0;0;0;0;.00nan;0;0
13407;-1;497;0;0;0;0;.00nan;0;0
13407;50069;495;0;0;0;0;.00nan;0;0
13407;66271;495;64;32;4;28;.875;3774000;0
13407;142810;497;67;35;3;32;.914;3774000;0
13408;1213;504;86;26;1;25;.962;3600000;0
13408;177356;4636;0;0;0;0;.00nan;0;0
13408;46365;504;0;0;0;0;.00nan;0;0
13408;148503;4636;53;16;2;14;.875;3600000;0
13409;1061;505;100;42;2;40;.952;3900000;0
13409;-1;505;0;0;0;0;.00nan;0;0
13409;148573;496;0;0;0;0;.00nan;0;0
13409;149305;496;56;24;2;22;.917;3900000;0
13410;167480;503;0;0;0;0;.00nan;0;0
13410;170536;503;76;23;1;22;.957;3562000;0
13410;40046;2591;100;34;0;34;1.000;3600000;0
13410;56078;2591;0;0;0;0;.00nan;0;0
13411;-1;499;98;40;1;39;.975;3700000;0
13411;-1;499;0;0;0;0;.00nan;0;0
13411;49674;498;79;37;2;35;.946;3700000;0
13411;148576;498;0;0;0;0;.00nan;0;0
13412;3359;502;47;32;5;27;.844;3600000;0
13412;11614;500;32;26;6;20;.769;3600000;0
13412;169680;502;0;0;0;0;.00nan;0;0
13412;63707;500;0;0;0;0;.00nan;0;0
13413;-1;497;0;0;0;0;.00nan;0;0
13413;50069;495;0;0;0;0;.00nan;0;0
13413;66271;495;90;30;1;29;.967;3757000;0
13413;142810;497;76;28;2;26;.929;3757000;0
13414;1213;504;0;0;0;0;.00nan;0;0
13414;177356;4636;0;0;0;0;.00nan;0;0
13414;46365;504;87;52;3;49;.942;3746000;0
13414;148503;4636;53;30;4;26;.867;3746000;0
13415;1061;505;65;18;1;17;.944;3900000;0
13415;-1;505;0;0;0;0;.00nan;0;0
13415;148573;496;93;38;1;37;.974;3899000;0
13415;149305;496;0;0;0;0;.00nan;0;0
13416;167480;503;56;38;5;33;.868;3067000;0
13416;170536;503;27;7;3;4;.571;533000;0
13416;40046;2591;78;22;1;21;.955;3600000;0
13416;56078;2591;0;0;0;0;.00nan;0;0
13417;1061;505;56;33;4;29;.879;3566000;0
13417;-1;505;0;0;0;0;.00nan;0;0
13417;40046;2591;94;40;2;38;.950;3600000;0
13417;56078;2591;0;0;0;0;.00nan;0;0
13418;167480;503;0;0;0;0;.00nan;0;0
13418;170536;503;67;26;2;24;.923;3600000;0
13418;148573;496;66;37;4;33;.892;3600000;0
13418;149305;496;0;0;0;0;.00nan;0;0
13419;177356;4636;0;0;0;0;.00nan;0;0
13419;-1;497;0;0;0;0;.00nan;0;0
13419;142810;497;100;34;0;34;1.000;3600000;0
13419;148503;4636;65;23;2;21;.913;3519000;0
13420;3359;502;100;25;0;25;1.000;3600000;0
13420;169680;502;0;0;0;0;.00nan;0;0
13420;49674;498;95;35;1;34;.971;3588000;0
13420;148576;498;0;0;0;0;.00nan;0;0
13421;1213;504;90;58;4;54;.931;3575000;0
13421;11614;500;0;0;0;0;.00nan;0;0
13421;46365;504;0;0;0;0;.00nan;0;0
13421;63707;500;40;14;3;11;.786;3600000;0
13422;-1;499;61;21;2;19;.905;3701000;0
13422;-1;499;0;0;0;0;.00nan;0;0
13422;50069;495;0;0;0;0;.00nan;0;0
13422;66271;495;59;26;3;23;.885;3701000;0
13423;1061;505;46;29;4;25;.862;3550000;0
13423;167480;503;0;0;0;0;.00nan;0;0
13423;-1;505;0;0;0;0;.00nan;0;0
13423;170536;503;66;23;2;21;.913;3600000;0
13424;177356;4636;0;0;0;0;.00nan;0;0
13424;148503;4636;100;22;0;22;1.000;3600000;0
13424;148573;496;94;37;1;36;.973;3543000;0
13424;149305;496;0;0;0;0;.00nan;0;0
13425;-1;497;0;0;0;0;.00nan;0;0
13425;40046;2591;89;50;4;46;.920;3900000;0
13425;56078;2591;0;0;0;0;.00nan;0;0
13425;142810;497;40;23;4;19;.826;3900000;0
13426;3359;502;69;24;2;22;.917;3900000;0
13426;169680;502;0;0;0;0;.00nan;0;0
13426;50069;495;0;0;0;0;.00nan;0;0
13426;66271;495;82;38;2;36;.947;3900000;0
13427;11614;500;87;28;1;27;.964;3900000;0
13427;49674;498;97;38;1;37;.974;3900000;0
13427;63707;500;0;0;0;0;.00nan;0;0
13427;148576;498;0;0;0;0;.00nan;0;0
13428;1213;504;86;33;2;31;.939;3630000;0
13428;-1;499;0;0;0;0;.00nan;0;0
13428;-1;499;63;29;3;26;.897;3630000;0
13428;46365;504;0;0;0;0;.00nan;0;0
13429;1061;505;72;32;3;29;.906;3547000;0
13429;177356;4636;0;0;0;0;.00nan;0;0
13429;-1;505;0;0;0;0;.00nan;0;0
13429;148503;4636;77;19;1;18;.947;3600000;0
13430;40046;2591;86;33;2;31;.939;3714000;0
13430;56078;2591;0;0;0;0;.00nan;0;0
13430;148573;496;50;16;3;13;.813;3714000;0
13430;149305;496;0;0;0;0;.00nan;0;0
13431;167480;503;0;0;0;0;.00nan;0;0
13431;-1;497;100;25;0;25;1.000;3600000;0
13431;170536;503;98;47;2;45;.957;3592000;0
13431;142810;497;0;0;0;0;.00nan;0;0
13432;1213;504;88;51;4;47;.922;3600000;0
13432;3359;502;100;29;0;29;1.000;3600000;0
13432;169680;502;0;0;0;0;.00nan;0;0
13432;46365;504;0;0;0;0;.00nan;0;0
13433;11614;500;67;31;3;28;.903;3600000;0
13433;50069;495;0;0;0;0;.00nan;0;0
13433;63707;500;0;0;0;0;.00nan;0;0
13433;66271;495;100;31;0;31;1.000;3600000;0
13434;-1;499;75;25;1;24;.960;3600000;0
13434;-1;499;0;0;0;0;.00nan;0;0
13434;49674;498;0;0;0;0;.00nan;0;0
13434;148576;498;68;34;4;30;.882;3600000;0
13435;167480;503;0;0;0;0;.00nan;0;0
13435;11614;500;80;27;1;26;.963;3600000;0
13435;170536;503;66;28;2;26;.929;3545000;0
13435;63707;500;0;0;0;0;.00nan;0;0
13436;-1;499;45;21;3;18;.857;3547000;0
13436;-1;499;0;0;0;0;.00nan;0;0
13436;40046;2591;90;33;2;31;.939;3600000;0
13436;56078;2591;0;0;0;0;.00nan;0;0
13437;3359;502;61;29;3;26;.897;3600000;0
13437;177356;4636;67;41;5;36;.878;3577000;0
13437;169680;502;0;0;0;0;.00nan;0;0
13437;148503;4636;0;0;0;0;.00nan;0;0
13438;1061;505;88;29;1;28;.966;3600000;0
13438;-1;505;0;0;0;0;.00nan;0;0
13438;49674;498;76;45;4;41;.911;3600000;0
13438;148576;498;0;0;0;0;.00nan;0;0
13439;1213;504;100;48;1;47;.979;3600000;0
13439;46365;504;0;0;0;0;.00nan;0;0
13439;148573;496;36;22;4;18;.818;3600000;0
13439;149305;496;0;0;0;0;.00nan;0;0
13440;-1;497;73;22;1;21;.955;3600000;0
13440;50069;495;0;0;0;0;.00nan;0;0
13440;66271;495;86;43;3;40;.930;3573000;0
13440;142810;497;0;0;0;0;.00nan;0;0
13441;3359;502;62;15;1;14;.933;3600000;0
13441;167480;503;0;0;0;0;.00nan;0;0
13441;169680;502;0;0;0;0;.00nan;0;0
13441;170536;503;93;49;3;46;.939;3534000;0
13442;11614;500;53;25;3;22;.880;3546000;0
13442;40046;2591;79;38;2;36;.947;3600000;0
13442;56078;2591;0;0;0;0;.00nan;0;0
13442;63707;500;0;0;0;0;.00nan;0;0
13443;177356;4636;0;0;0;0;.00nan;0;0
13443;-1;499;73;35;4;31;.886;3600000;0
13443;-1;499;0;0;0;0;.00nan;0;0
13443;148503;4636;100;28;0;28;1.000;3600000;0
13444;-1;497;0;0;0;0;.00nan;0;0
13444;49674;498;0;0;0;0;.00nan;0;0
13444;142810;497;69;20;1;19;.950;3600000;0
13444;148576;498;50;22;3;19;.864;3515000;0
13445;1061;505;86;30;1;29;.967;3723000;0
13445;1213;504;70;26;2;24;.923;3723000;0
13445;-1;505;0;0;0;0;.00nan;0;0
13445;46365;504;0;0;0;0;.00nan;0;0
13446;50069;495;40;28;4;24;.857;3900000;0
13446;66271;495;0;0;0;0;.00nan;0;0
13446;148573;496;65;32;4;28;.875;3900000;0
13446;149305;496;0;0;0;0;.00nan;0;0
13447;167480;503;97;53;4;49;.925;3585000;0
13447;-1;499;78;29;2;27;.931;3600000;0
13447;170536;503;0;0;0;0;.00nan;0;0
13447;-1;499;0;0;0;0;.00nan;0;0
13448;3359;502;92;29;1;28;.966;3900000;0
13448;169680;502;0;0;0;0;.00nan;0;0
13448;40046;2591;0;0;0;0;.00nan;0;0
13448;56078;2591;89;25;1;24;.960;3900000;0
13449;177356;4636;0;0;0;0;.00nan;0;0
13449;11614;500;75;35;3;32;.914;3600000;0
13449;63707;500;0;0;0;0;.00nan;0;0
13449;148503;4636;55;29;4;25;.862;3575000;0
13450;49674;498;95;36;2;34;.944;3600000;0
13450;148573;496;55;26;3;23;.885;3600000;0
13450;148576;498;0;0;0;0;.00nan;0;0
13450;149305;496;0;0;0;0;.00nan;0;0
13451;1213;504;77;37;3;34;.919;3518000;0
13451;-1;497;0;0;0;0;.00nan;0;0
13451;46365;504;0;0;0;0;.00nan;0;0
13451;142810;497;100;34;1;33;.971;3600000;0
13452;1061;505;78;29;1;28;.966;3600000;0
13452;-1;505;0;0;0;0;.00nan;0;0
13452;50069;495;0;0;0;0;.00nan;0;0
13452;66271;495;65;27;2;25;.926;3576000;0
13453;1213;504;57;42;5;37;.881;3577000;0
13453;46365;504;0;0;0;0;.00nan;0;0
13453;49674;498;73;29;3;26;.897;3600000;0
13453;148576;498;0;0;0;0;.00nan;0;0
13454;167480;503;0;0;0;0;.00nan;0;0
13454;170536;503;58;20;3;17;.850;3532000;0
13454;50069;495;0;0;0;0;.00nan;0;0
13454;66271;495;86;30;1;29;.967;3600000;0
13455;177356;4636;0;0;0;0;.00nan;0;0
13455;40046;2591;68;25;2;23;.920;3560000;0
13455;56078;2591;0;0;0;0;.00nan;0;0
13455;148503;4636;86;26;1;25;.962;3600000;0
13456;3359;502;0;0;0;0;.00nan;0;0
13456;-1;497;0;0;0;0;.00nan;0;0
13456;169680;502;80;34;2;32;.941;3900000;0
13456;142810;497;67;26;2;24;.923;3900000;0
13457;1061;505;94;43;3;40;.930;3600000;0
13457;11614;500;69;21;1;20;.952;3600000;0
13457;-1;505;0;0;0;0;.00nan;0;0
13457;63707;500;0;0;0;0;.00nan;0;0
13458;-1;499;94;45;2;43;.956;3622000;0
13458;-1;499;0;0;0;0;.00nan;0;0
13458;148573;496;0;0;0;0;.00nan;0;0
13458;149305;496;85;27;1;26;.963;3635000;0
13459;167480;503;0;0;0;0;.00nan;0;0
13459;170536;503;92;31;1;30;.968;3600000;0
13459;49674;498;0;0;0;0;.00nan;0;0
13459;148576;498;60;30;3;27;.900;3584000;0
13460;1213;504;0;0;0;0;.00nan;0;0
13460;40046;2591;96;30;1;29;.967;3600000;0
13460;46365;504;100;38;0;38;1.000;3600000;0
13460;56078;2591;0;0;0;0;.00nan;0;0
13461;177356;4636;0;0;0;0;.00nan;0;0
13461;50069;495;0;0;0;0;.00nan;0;0
13461;66271;495;66;33;4;29;.879;3600000;0
13461;148503;4636;77;26;1;25;.962;3600000;0
13462;1061;505;0;0;0;0;.00nan;0;0
13462;-1;505;66;38;3;35;.921;3600000;0
13462;148573;496;41;34;6;28;.824;3600000;0
13462;149305;496;0;0;0;0;.00nan;0;0
13463;3359;502;98;38;1;37;.974;3545000;0
13463;11614;500;83;14;0;14;1.000;3600000;0
13463;169680;502;0;0;0;0;.00nan;0;0
13463;63707;500;0;0;0;0;.00nan;0;0
13464;-1;497;0;0;0;0;.00nan;0;0
13464;-1;499;57;22;3;19;.864;3900000;0
13464;-1;499;0;0;0;0;.00nan;0;0
13464;142810;497;72;31;3;28;.903;3900000;0
13465;177356;4636;0;0;0;0;.00nan;0;0
13465;49674;498;76;34;3;31;.912;3541000;0
13465;148503;4636;86;29;1;28;.966;3600000;0
13465;148576;498;0;0;0;0;.00nan;0;0
13466;1213;504;0;0;0;0;.00nan;0;0
13466;167480;503;0;0;0;0;.00nan;0;0
13466;170536;503;44;18;3;15;.833;3900000;0
13466;46365;504;75;35;3;32;.914;3900000;0
13467;40046;2591;65;16;1;15;.938;3600000;0
13467;50069;495;0;0;0;0;.00nan;0;0
13467;56078;2591;0;0;0;0;.00nan;0;0
13467;66271;495;85;47;3;44;.936;3514000;0
13468;1061;505;90;29;1;28;.966;3600000;0
13468;-1;497;0;0;0;0;.00nan;0;0
13468;-1;505;0;0;0;0;.00nan;0;0
13468;142810;497;53;20;3;17;.850;3552000;0
13469;11614;500;50;28;4;24;.857;3600000;0
13469;63707;500;0;0;0;0;.00nan;0;0
13469;148573;496;100;22;0;22;1.000;3600000;0
13469;149305;496;0;0;0;0;.00nan;0;0
13470;3359;502;69;17;1;16;.941;3600000;0
13470;-1;499;81;34;2;32;.941;3550000;0
13470;169680;502;0;0;0;0;.00nan;0;0
13470;-1;499;0;0;0;0;.00nan;0;0
13471;49674;498;84;44;3;41;.932;3566000;0
13471;50069;495;0;0;0;0;.00nan;0;0
13471;66271;495;72;24;2;22;.917;3600000;0
13471;148576;498;0;0;0;0;.00nan;0;0
13472;167480;503;0;0;0;0;.00nan;0;0
13472;170536;503;65;34;4;30;.882;3543000;0
13472;40046;2591;58;23;3;20;.870;3600000;0
13472;56078;2591;0;0;0;0;.00nan;0;0
13473;1213;504;92;42;2;40;.952;3752000;0
13473;177356;4636;0;0;0;0;.00nan;0;0
13473;46365;504;0;0;0;0;.00nan;0;0
13473;148503;4636;81;30;1;29;.967;3752000;0
13474;3359;502;100;23;0;23;1.000;3600000;0
13474;169680;502;0;0;0;0;.00nan;0;0
13474;148573;496;98;39;1;38;.974;3573000;0
13474;149305;496;0;0;0;0;.00nan;0;0
13475;11614;500;95;21;0;21;1.000;3600000;0
13475;-1;497;0;0;0;0;.00nan;0;0
13475;63707;500;0;0;0;0;.00nan;0;0
13475;142810;497;85;32;1;31;.969;3570000;0
13476;1061;505;100;32;0;32;1.000;3600000;0
13476;-1;505;0;0;0;0;.00nan;0;0
13476;-1;499;77;35;3;32;.914;3600000;0
13476;-1;499;0;0;0;0;.00nan;0;0
13477;1213;504;79;35;2;33;.943;3600000;0
13477;46365;504;0;0;0;0;.00nan;0;0
13477;50069;495;0;0;0;0;.00nan;0;0
13477;66271;495;59;28;3;25;.893;3589000;0
13478;40046;2591;92;46;2;44;.957;3600000;0
13478;49674;498;0;0;0;0;.00nan;0;0
13478;56078;2591;0;0;0;0;.00nan;0;0
13478;148576;498;45;19;3;16;.842;3590000;0
13479;177356;4636;0;0;0;0;.00nan;0;0
13479;167480;503;0;0;0;0;.00nan;0;0
13479;170536;503;81;34;2;32;.941;3600000;0
13479;148503;4636;59;26;3;23;.885;3554000;0
13480;1061;505;100;52;2;50;.962;3900000;0
13480;3359;502;58;19;2;17;.895;3900000;0
13480;-1;505;0;0;0;0;.00nan;0;0
13480;169680;502;0;0;0;0;.00nan;0;0
13481;-1;497;0;0;0;0;.00nan;0;0
13481;142810;497;30;25;6;19;.760;3600000;0
13481;148573;496;94;22;0;22;1.000;3600000;0
13481;149305;496;0;0;0;0;.00nan;0;0
13482;11614;500;84;34;2;32;.941;3546000;0
13482;-1;499;89;28;1;27;.964;3600000;0
13482;-1;499;0;0;0;0;.00nan;0;0
13482;63707;500;0;0;0;0;.00nan;0;0
13483;3359;502;76;31;2;29;.935;3544000;0
13483;-1;497;0;0;0;0;.00nan;0;0
13483;169680;502;0;0;0;0;.00nan;0;0
13483;142810;497;99;33;1;32;.970;3600000;0
13484;1213;504;64;30;3;27;.900;3567000;0
13484;11614;500;82;37;2;35;.946;3600000;0
13484;46365;504;0;0;0;0;.00nan;0;0
13484;63707;500;0;0;0;0;.00nan;0;0
13485;-1;499;66;24;2;22;.917;3600000;0
13485;-1;499;0;0;0;0;.00nan;0;0
13485;50069;495;0;0;0;0;.00nan;0;0
13485;66271;495;72;39;4;35;.897;3572000;0
13486;1061;505;75;24;1;23;.958;3600000;0
13486;-1;505;0;0;0;0;.00nan;0;0
13486;49674;498;89;51;3;48;.941;3541000;0
13486;148576;498;0;0;0;0;.00nan;0;0
13487;167480;503;0;0;0;0;.00nan;0;0
13487;170536;503;74;49;5;44;.898;3600000;0
13487;148573;496;51;28;4;24;.857;3600000;0
13487;149305;496;0;0;0;0;.00nan;0;0
13488;177356;4636;0;0;0;0;.00nan;0;0
13488;40046;2591;0;0;0;0;.00nan;0;0
13488;56078;2591;71;22;1;21;.955;3600000;0
13488;148503;4636;98;40;2;38;.950;3583000;0
13490;-1;497;0;0;0;0;.00nan;0;0
13490;142810;497;90;44;2;42;.955;3600000;0
13490;148573;496;23;4;3;1;.250;226000;0
13490;149305;496;52;23;2;21;.913;3374000;0
13492;3359;502;82;37;3;34;.919;3600000;0
13492;40046;2591;0;0;0;0;.00nan;0;0
13492;56078;2591;61;25;4;21;.840;3556000;0
13492;148829;502;0;0;0;0;.00nan;0;0
13494;177356;4636;0;0;0;0;.00nan;0;0
13494;-1;499;0;0;0;0;.00nan;0;0
13494;63932;499;56;37;4;33;.892;3600000;0
13494;148503;4636;70;18;1;17;.944;3600000;0
13496;1061;505;93;31;1;30;.968;3600000;0
13496;-1;505;0;0;0;0;.00nan;0;0
13496;170536;503;0;0;0;0;.00nan;0;0
13496;81096;503;65;28;2;26;.929;3571000;0
13498;1213;504;96;52;3;49;.942;3900000;0
13498;46365;504;0;0;0;0;.00nan;0;0
13498;49674;498;66;24;3;21;.875;3900000;0
13498;148576;498;0;0;0;0;.00nan;0;0
13500;187813;495;0;0;0;0;.00nan;0;0
13500;11614;500;60;29;3;26;.897;3600000;0
13500;63707;500;0;0;0;0;.00nan;0;0
13500;66271;495;47;28;4;24;.857;3554000;0
13502;1213;504;0;0;0;0;.00nan;0;0
13502;46365;504;60;20;2;18;.900;3548000;0
13502;49674;498;0;0;0;0;.00nan;0;0
13502;148576;498;80;25;1;24;.960;3600000;0
13504;167480;503;0;0;0;0;.00nan;0;0
13504;-1;497;55;35;4;31;.886;3600000;0
13504;170536;503;100;31;0;31;1.000;3600000;0
13504;142810;497;0;0;0;0;.00nan;0;0
13506;187813;495;63;28;2;26;.929;3600000;0
13506;66271;495;0;0;0;0;.00nan;0;0
13506;148573;496;43;26;4;22;.846;3600000;0
13506;149305;496;0;0;0;0;.00nan;0;0
13508;1061;505;0;0;0;0;.00nan;0;0
13508;-1;505;79;23;2;21;.913;3700000;0
13508;-1;499;87;45;3;42;.933;3700000;0
13508;-1;499;0;0;0;0;.00nan;0;0
13510;177356;4636;100;25;0;25;1.000;3600000;0
13510;11614;500;0;0;0;0;.00nan;0;0
13510;63707;500;84;40;2;38;.950;3600000;0
13510;148503;4636;0;0;0;0;.00nan;0;0
13512;3359;502;72;25;2;23;.920;3553000;0
13512;169680;502;0;0;0;0;.00nan;0;0
13512;40046;2591;76;21;1;20;.952;3600000;0
13512;56078;2591;0;0;0;0;.00nan;0;0
13514;187813;495;0;0;0;0;.00nan;0;0
13514;-1;497;0;0;0;0;.00nan;0;0
13514;66271;495;40;15;3;12;.800;3600000;0
13514;142810;497;69;43;5;38;.884;3600000;0
13516;-1;499;70;30;2;28;.933;3600000;0
13516;-1;499;0;0;0;0;.00nan;0;0
13516;148573;496;50;22;3;19;.864;3538000;0
13516;149305;496;0;0;0;0;.00nan;0;0
13518;3359;502;66;28;3;25;.893;3518000;0
13518;167480;503;0;0;0;0;.00nan;0;0
13518;169680;502;0;0;0;0;.00nan;0;0
13518;170536;503;99;40;1;39;.975;3600000;0
13520;40046;2591;97;25;0;25;1.000;3600000;0
13520;49674;498;0;0;0;0;.00nan;0;0
13520;56078;2591;0;0;0;0;.00nan;0;0
13520;148576;498;56;36;4;32;.889;3600000;0
13522;1061;505;53;19;3;16;.842;3600000;0
13522;1213;504;97;34;1;33;.971;3600000;0
13522;-1;505;0;0;0;0;.00nan;0;0
13522;46365;504;0;0;0;0;.00nan;0;0
13524;177356;4636;67;35;3;32;.914;3600000;0
13524;11614;500;56;30;4;26;.867;3545000;0
13524;63707;500;0;0;0;0;.00nan;0;0
13524;148503;4636;0;0;0;0;.00nan;0;0
13526;1061;505;0;0;0;0;.00nan;0;0
13526;-1;505;89;41;3;38;.927;3900000;0
13526;40046;2591;97;39;3;36;.923;3900000;0
13526;56078;2591;0;0;0;0;.00nan;0;0
13528;3359;502;0;0;0;0;.00nan;0;0
13528;169680;502;79;33;2;31;.939;3600000;0
13528;49674;498;100;38;1;37;.974;3600000;0
13528;148576;498;0;0;0;0;.00nan;0;0
13530;177356;4636;0;0;0;0;.00nan;0;0
13530;167480;503;40;23;4;19;.826;1939000;0
13530;170536;503;59;15;1;14;.933;1661000;0
13530;148503;4636;82;23;1;22;.957;3600000;0
13532;1213;504;0;0;0;0;.00nan;0;0
13532;-1;497;95;54;3;51;.944;3900000;0
13532;46365;504;54;23;3;20;.870;3900000;0
13532;142810;497;0;0;0;0;.00nan;0;0
13534;187813;495;98;44;2;42;.955;3537000;0
13534;-1;499;0;0;0;0;.00nan;0;0
13534;-1;499;98;23;0;23;1.000;3600000;0
13534;66271;495;0;0;0;0;.00nan;0;0
13536;11614;500;0;0;0;0;.00nan;0;0
13536;63707;500;90;27;1;26;.963;3600000;0
13536;148573;496;0;0;0;0;.00nan;0;0
13536;149305;496;47;30;5;25;.833;3600000;0
13538;167480;503;0;0;0;0;.00nan;0;0
13538;11614;500;95;30;1;29;.967;3900000;0
13538;170536;503;97;42;1;41;.976;3900000;0
13538;63707;500;0;0;0;0;.00nan;0;0
13540;49674;498;84;32;2;30;.938;3600000;0
13540;148573;496;54;24;3;21;.875;3600000;0
13540;148576;498;0;0;0;0;.00nan;0;0
13540;149305;496;0;0;0;0;.00nan;0;0
13542;187813;495;0;0;0;0;.00nan;0;0
13542;-1;497;0;0;0;0;.00nan;0;0
13542;66271;495;95;23;0;23;1.000;3600000;0
13542;142810;497;84;30;1;29;.967;3551000;0
13544;177356;4636;0;0;0;0;.00nan;0;0
13544;40046;2591;44;29;5;24;.828;3600000;0
13544;56078;2591;0;0;0;0;.00nan;0;0
13544;148503;4636;93;39;2;37;.949;3600000;0
13546;1213;504;39;23;4;19;.826;3900000;0
13546;-1;499;0;0;0;0;.00nan;0;0
13546;-1;499;100;45;4;41;.911;3900000;0
13546;46365;504;0;0;0;0;.00nan;0;0
13548;1061;505;61;32;4;28;.875;3600000;0
13548;3359;502;80;28;1;27;.964;3600000;0
13548;-1;505;0;0;0;0;.00nan;0;0
13548;169680;502;0;0;0;0;.00nan;0;0
13550;11614;500;77;23;1;22;.957;3600000;0
13550;-1;499;36;30;6;24;.800;2993000;0
13550;-1;499;49;8;1;7;.875;607000;0
13550;63707;500;0;0;0;0;.00nan;0;0
13552;1061;505;54;36;5;31;.861;3600000;0
13552;167480;503;0;0;0;0;.00nan;0;0
13552;-1;505;0;0;0;0;.00nan;0;0
13552;170536;503;81;22;1;21;.955;3600000;0
13554;3359;502;64;18;2;16;.889;3591000;0
13554;169680;502;0;0;0;0;.00nan;0;0
13554;49674;498;0;0;0;0;.00nan;0;0
13554;148576;498;99;34;1;33;.971;3600000;0
13556;1213;504;79;40;3;37;.925;3570000;0
13556;46365;504;0;0;0;0;.00nan;0;0
13556;148573;496;59;14;1;13;.929;3600000;0
13556;149305;496;0;0;0;0;.00nan;0;0
13558;187813;495;0;0;0;0;.00nan;0;0
13558;40046;2591;0;0;0;0;.00nan;0;0
13558;56078;2591;77;30;2;28;.933;3900000;0
13558;66271;495;75;27;2;25;.926;3900000;0
13560;177356;4636;0;0;0;0;.00nan;0;0
13560;-1;497;0;0;0;0;.00nan;0;0
13560;142810;497;85;44;3;41;.932;3600000;0
13560;148503;4636;90;17;0;17;1.000;3600000;0
13562;1061;505;0;0;0;0;.00nan;0;0
13562;-1;505;46;24;3;21;.875;3556000;0
13562;40046;2591;75;32;2;30;.938;3600000;0
13562;56078;2591;0;0;0;0;.00nan;0;0
13564;3359;502;0;0;0;0;.00nan;0;0
13564;177356;4636;0;0;0;0;.00nan;0;0
13564;169680;502;56;26;3;23;.885;3600000;0
13564;148503;4636;34;31;6;25;.806;3600000;0
13566;167480;503;81;24;1;23;.958;3600000;0
13566;-1;497;86;42;3;39;.929;3561000;0
13566;170536;503;0;0;0;0;.00nan;0;0
13566;142810;497;0;0;0;0;.00nan;0;0
13568;49674;498;76;25;2;23;.920;3900000;0
13568;148573;496;0;0;0;0;.00nan;0;0
13568;148576;498;0;0;0;0;.00nan;0;0
13568;149305;496;83;31;2;29;.935;3900000;0
13570;1213;504;0;0;0;0;.00nan;0;0
13570;11614;500;0;0;0;0;.00nan;0;0
13570;46365;504;94;50;4;46;.920;3886000;0
13570;63707;500;55;31;3;28;.903;3886000;0
13572;187813;495;76;30;2;28;.933;3541000;0
13572;-1;499;0;0;0;0;.00nan;0;0
13572;-1;499;80;28;1;27;.964;3600000;0
13572;66271;495;0;0;0;0;.00nan;0;0
933;40046;2591;54;12;1;11;.917;3600000;0
933;50069;495;0;0;0;0;.00nan;0;0
933;56078;2591;0;0;0;0;.00nan;0;0
933;66271;495;91;41;3;38;.927;3536000;0
934;1061;505;89;41;3;38;.927;3600000;0
934;3359;502;67;20;1;19;.950;3600000;0
934;-1;505;0;0;0;0;.00nan;0;0
934;169680;502;0;0;0;0;.00nan;0;0
935;40046;2591;86;43;3;40;.930;3600000;0
935;50069;495;0;0;0;0;.00nan;0;0
935;56078;2591;0;0;0;0;.00nan;0;0
935;66271;495;77;26;1;25;.962;3600000;0
936;1061;505;91;46;2;44;.957;3600000;0
936;3359;502;79;28;1;27;.964;3600000;0
936;-1;505;0;0;0;0;.00nan;0;0
936;169680;502;0;0;0;0;.00nan;0;0
937;40046;2591;100;29;1;28;.966;3600000;0
937;50069;495;0;0;0;0;.00nan;0;0
937;56078;2591;0;0;0;0;.00nan;0;0
937;66271;495;73;26;2;24;.923;3581000;0
938;1061;505;53;38;4;34;.895;4644000;0
938;3359;502;61;38;5;33;.868;4644000;0
938;-1;505;0;0;0;0;.00nan;0;0
938;169680;502;0;0;0;0;.00nan;0;0
939;40046;2591;57;27;3;24;.889;3583000;0
939;50069;495;0;0;0;0;.00nan;0;0
939;56078;2591;0;0;0;0;.00nan;0;0
939;66271;495;88;27;1;26;.963;3600000;0
940;1061;505;97;27;0;27;1.000;3600000;0
940;3359;502;63;20;1;19;.950;3556000;0
940;-1;505;0;0;0;0;.00nan;0;0
940;169680;502;0;0;0;0;.00nan;0;0
1184;40046;2591;78;27;1;26;.963;6398000;0
1184;50069;495;0;0;0;0;.00nan;0;0
1184;56078;2591;0;0;0;0;.00nan;0;0
1184;66271;495;81;44;2;42;.955;6398000;0
1185;1061;505;69;31;3;28;.903;3558000;0
1185;3359;502;68;29;2;27;.931;3600000;0
1185;-1;505;0;0;0;0;.00nan;0;0
1185;169680;502;0;0;0;0;.00nan;0;0
1275;40046;2591;57;40;5;35;.875;3600000;0
1275;50069;495;0;0;0;0;.00nan;0;0
1275;56078;2591;0;0;0;0;.00nan;0;0
1275;66271;495;59;28;3;25;.893;3600000;0
1276;1061;505;100;45;2;43;.956;3600000;0
1276;3359;502;33;24;5;19;.792;3600000;0
1276;-1;505;0;0;0;0;.00nan;0;0
1276;169680;502;0;0;0;0;.00nan;0;0
1375;40046;2591;54;18;2;16;.889;3600000;0
1375;50069;495;0;0;0;0;.00nan;0;0
1375;56078;2591;0;0;0;0;.00nan;0;0
1375;66271;495;53;45;6;39;.867;3600000;0
1376;1061;505;75;27;2;25;.926;3600000;0
1376;3359;502;64;29;3;26;.897;3544000;0
1376;-1;505;0;0;0;0;.00nan;0;0
1376;169680;502;0;0;0;0;.00nan;0;0
1449;1061;505;44;35;6;29;.829;3600000;0
1449;-1;505;0;0;0;0;.00nan;0;0
1449;40046;2591;94;34;1;33;.971;3600000;0
1449;56078;2591;0;0;0;0;.00nan;0;0
1450;1061;505;100;26;0;26;1.000;3600000;0
1450;-1;505;0;0;0;0;.00nan;0;0
1450;40046;2591;67;24;2;22;.917;3551000;0
1450;56078;2591;0;0;0;0;.00nan;0;0
1451;1061;505;75;11;0;11;1.000;3600000;0
1451;-1;505;0;0;0;0;.00nan;0;0
1451;40046;2591;43;28;4;24;.857;3600000;0
1451;56078;2591;0;0;0;0;.00nan;0;0
1452;1061;505;63;22;2;20;.909;3568000;0
1452;-1;505;0;0;0;0;.00nan;0;0
1452;40046;2591;100;36;0;36;1.000;3600000;0
1452;56078;2591;0;0;0;0;.00nan;0;0
1643;1061;505;100;24;0;24;1.000;3600000;0
1643;-1;505;0;0;0;0;.00nan;0;0
1643;40046;2591;63;24;2;22;.917;3596000;0
1643;56078;2591;0;0;0;0;.00nan;0;0
1732;1061;505;99;29;0;29;1.000;3600000;0
1732;-1;505;0;0;0;0;.00nan;0;0
1732;40046;2591;74;25;3;22;.880;3600000;0
1732;56078;2591;0;0;0;0;.00nan;0;0
13573;46790;547;100;26;0;26;1.000;3600000;0
13573;49864;549;62;23;2;21;.913;3567000;0
13573;59933;549;0;0;0;0;.00nan;0;0
13573;150345;547;0;0;0;0;.00nan;0;0
13574;7821;543;0;0;0;0;.00nan;0;0
13574;12406;551;0;0;0;0;.00nan;0;0
13574;17711;551;58;25;3;22;.880;3558000;0
13574;152201;543;72;24;2;22;.917;3600000;0
13575;3165;546;0;0;0;0;.00nan;0;0
13575;4803;545;86;42;3;39;.929;3678000;0
13575;7063;546;67;37;4;33;.892;3678000;0
13575;67683;545;0;0;0;0;.00nan;0;0
13576;167061;2190;37;44;7;37;.841;3600000;0
13576;4803;545;97;39;2;37;.949;3600000;0
13576;6650;2190;0;0;0;0;.00nan;0;0
13576;67683;545;0;0;0;0;.00nan;0;0
13577;3165;546;0;0;0;0;.00nan;0;0
13577;7063;546;46;21;4;17;.810;3600000;0
13577;7821;543;0;0;0;0;.00nan;0;0
13577;152201;543;41;25;5;20;.800;3544000;0
13578;49864;549;100;31;0;31;1.000;3600000;0
13578;59933;549;0;0;0;0;.00nan;0;0
13578;82817;548;0;0;0;0;.00nan;0;0
13578;160650;548;97;47;2;45;.957;3550000;0
13579;46790;547;62;16;1;15;.938;3600000;0
13579;53895;550;81;39;2;37;.949;2793000;0
13579;71660;550;19;11;4;7;.636;807000;0
13579;150345;547;0;0;0;0;.00nan;0;0
13580;167061;2190;80;25;1;24;.960;3600000;0
13580;6650;2190;0;0;0;0;.00nan;0;0
13580;12406;551;0;0;0;0;.00nan;0;0
13580;17711;551;56;24;3;21;.875;3597000;0
13581;167061;2190;0;0;0;0;.00nan;0;0
13581;6650;2190;67;32;3;29;.906;3651000;0
13581;49864;549;57;28;4;24;.857;3651000;0
13581;59933;549;0;0;0;0;.00nan;0;0
13582;3165;546;0;0;0;0;.00nan;0;0
13582;7063;546;57;13;1;12;.923;3600000;0
13582;53895;550;0;0;0;0;.00nan;0;0
13582;71660;550;79;33;2;31;.939;3591000;0
13583;7821;543;0;0;0;0;.00nan;0;0
13583;46790;547;0;0;0;0;.00nan;0;0
13583;150345;547;74;31;3;28;.903;3600000;0
13583;152201;543;33;33;6;27;.818;3600000;0
13584;4803;545;82;26;0;26;1.000;3900000;0
13584;12406;551;0;0;0;0;.00nan;0;0
13584;17711;551;91;19;0;19;1.000;3900000;0
13584;67683;545;0;0;0;0;.00nan;0;0
13585;7821;543;0;0;0;0;.00nan;0;0
13585;49864;549;0;0;0;0;.00nan;0;0
13585;59933;549;75;35;3;32;.914;3900000;0
13585;152201;543;68;30;3;27;.900;3900000;0
13586;4803;545;70;27;2;25;.926;3900000;0
13586;46790;547;93;37;2;35;.946;3900000;0
13586;67683;545;0;0;0;0;.00nan;0;0
13586;150345;547;0;0;0;0;.00nan;0;0
13587;3165;546;0;0;0;0;.00nan;0;0
13587;7063;546;88;28;1;27;.964;3900000;0
13587;82817;548;0;0;0;0;.00nan;0;0
13587;160650;548;77;22;1;21;.955;3900000;0
13588;7821;543;0;0;0;0;.00nan;0;0
13588;82817;548;0;0;0;0;.00nan;0;0
13588;152201;543;58;30;5;25;.833;3600000;0
13588;160650;548;31;35;7;28;.800;3543000;0
13589;3165;546;0;0;0;0;.00nan;0;0
13589;167061;2190;83;27;1;26;.963;3600000;0
13589;6650;2190;0;0;0;0;.00nan;0;0
13589;7063;546;71;25;2;23;.920;3553000;0
13590;4803;545;60;38;5;33;.868;3900000;0
13590;49864;549;50;31;5;26;.839;3900000;0
13590;59933;549;0;0;0;0;.00nan;0;0
13590;67683;545;0;0;0;0;.00nan;0;0
13591;12406;551;0;0;0;0;.00nan;0;0
13591;17711;551;73;19;1;18;.947;3600000;0
13591;53895;550;98;37;0;37;1.000;2504000;0
13591;71660;550;25;14;4;10;.714;1096000;0
13592;167061;2190;0;0;0;0;.00nan;0;0
13592;6650;2190;61;30;3;27;.900;3582000;0
13592;46790;547;81;25;1;24;.960;3600000;0
13592;150345;547;0;0;0;0;.00nan;0;0
13593;4803;545;72;29;2;27;.931;3600000;0
13593;67683;545;0;0;0;0;.00nan;0;0
13593;82817;548;0;0;0;0;.00nan;0;0
13593;160650;548;61;47;5;42;.894;3600000;0
13594;7821;543;0;0;0;0;.00nan;0;0
13594;53895;550;0;0;0;0;.00nan;0;0
13594;71660;550;74;50;4;46;.920;3600000;0
13594;152201;543;90;30;1;29;.967;3600000;0
13595;12406;551;0;0;0;0;.00nan;0;0
13595;17711;551;71;17;1;16;.941;3600000;0
13595;49864;549;26;27;6;21;.778;3600000;0
13595;59933;549;0;0;0;0;.00nan;0;0
13596;49864;549;76;28;3;25;.893;3600000;0
13596;53895;550;69;32;4;28;.875;3572000;0
13596;59933;549;0;0;0;0;.00nan;0;0
13596;71660;550;0;0;0;0;.00nan;0;0
13597;167061;2190;67;34;3;31;.912;3528000;0
13597;6650;2190;0;0;0;0;.00nan;0;0
13597;7821;543;0;0;0;0;.00nan;0;0
13597;152201;543;72;24;1;23;.958;3600000;0
13598;3165;546;64;37;4;33;.892;3649000;0
13598;7063;546;0;0;0;0;.00nan;0;0
13598;46790;547;75;30;3;27;.900;3649000;0
13598;150345;547;0;0;0;0;.00nan;0;0
13599;12406;551;52;25;3;22;.880;3569000;0
13599;17711;551;0;0;0;0;.00nan;0;0
13599;82817;548;0;0;0;0;.00nan;0;0
13599;160650;548;64;23;2;21;.913;3600000;0
13600;167061;2190;0;0;0;0;.00nan;0;0
13600;6650;2190;38;22;4;18;.818;3600000;0
13600;53895;550;84;37;2;35;.946;3600000;0
13600;71660;550;0;0;0;0;.00nan;0;0
13601;46790;547;0;0;0;0;.00nan;0;0
13601;82817;548;0;0;0;0;.00nan;0;0
13601;150345;547;80;27;2;25;.926;3900000;0
13601;160650;548;86;29;2;27;.931;3900000;0
13602;4803;545;71;27;2;25;.926;3600000;0
13602;7821;543;0;0;0;0;.00nan;0;0
13602;67683;545;0;0;0;0;.00nan;0;0
13602;152201;543;64;41;5;36;.878;3600000;0
13603;167061;2190;59;33;5;28;.848;3584000;0
13603;6650;2190;0;0;0;0;.00nan;0;0
13603;82817;548;0;0;0;0;.00nan;0;0
13603;160650;548;83;40;3;37;.925;3600000;0
13604;4803;545;66;25;2;23;.920;3600000;0
13604;53895;550;46;36;5;31;.861;3306000;0
13604;67683;545;0;0;0;0;.00nan;0;0
13604;71660;550;49;1;0;1;1.000;294000;0
13605;3165;546;0;0;0;0;.00nan;0;0
13605;7063;546;71;34;3;31;.912;3567000;0
13605;49864;549;64;24;2;22;.917;3600000;0
13605;59933;549;0;0;0;0;.00nan;0;0
13606;12406;551;0;0;0;0;.00nan;0;0
13606;17711;551;82;34;3;31;.912;3565000;0
13606;46790;547;97;44;2;42;.955;3600000;0
13606;150345;547;0;0;0;0;.00nan;0;0
13607;53895;550;0;0;0;0;.00nan;0;0
13607;71660;550;97;45;2;43;.956;3600000;0
13607;82817;548;0;0;0;0;.00nan;0;0
13607;160650;548;53;32;4;28;.875;3522000;0
13608;3165;546;0;0;0;0;.00nan;0;0
13608;167061;2190;0;0;0;0;.00nan;0;0
13608;6650;2190;54;25;3;22;.880;3600000;0
13608;7063;546;78;50;5;45;.900;3573000;0
13609;12406;551;0;0;0;0;.00nan;0;0
13609;17711;551;82;17;0;17;1.000;3600000;0
13609;49864;549;30;27;6;21;.778;2712000;0
13609;59933;549;56;11;1;10;.909;888000;0
13610;3165;546;0;0;0;0;.00nan;0;0
13610;7063;546;67;35;4;31;.886;3600000;0
13610;82817;548;0;0;0;0;.00nan;0;0
13610;160650;548;96;37;1;36;.973;3600000;0
13611;7821;543;0;0;0;0;.00nan;0;0
13611;53895;550;69;11;0;11;1.000;582000;0
13611;71660;550;39;32;6;26;.813;3018000;0
13611;152201;543;59;13;1;12;.923;3600000;0
13612;4803;545;54;23;3;20;.870;3600000;0
13612;46790;547;27;10;3;7;.700;425000;0
13612;67683;545;0;0;0;0;.00nan;0;0
13612;150345;547;98;37;1;36;.973;3129000;0
13613;167061;2190;37;29;6;23;.793;3600000;0
13613;6650;2190;0;0;0;0;.00nan;0;0
13613;7821;543;0;0;0;0;.00nan;0;0
13613;152201;543;68;19;1;18;.947;3600000;0
13614;12406;551;0;0;0;0;.00nan;0;0
13614;17711;551;59;18;2;16;.889;3600000;0
13614;53895;550;34;11;3;8;.727;572000;0
13614;71660;550;65;31;3;28;.903;3028000;0
13615;49864;549;0;0;0;0;.00nan;0;0
13615;59933;549;74;24;2;22;.917;3594000;0
13615;82817;548;0;0;0;0;.00nan;0;0
13615;160650;548;100;40;0;40;1.000;3600000;0
13616;3165;546;0;0;0;0;.00nan;0;0
13616;4803;545;50;24;3;21;.875;3543000;0
13616;7063;546;90;40;2;38;.950;3600000;0
13616;67683;545;0;0;0;0;.00nan;0;0
13617;4803;545;0;0;0;0;.00nan;0;0
13617;67683;545;47;17;3;14;.824;3600000;0
13617;82817;548;0;0;0;0;.00nan;0;0
13617;160650;548;56;33;4;29;.879;3583000;0
13618;3165;546;0;0;0;0;.00nan;0;0
13618;7063;546;61;35;4;31;.886;3567000;0
13618;12406;551;60;21;2;19;.905;3600000;0
13618;17711;551;0;0;0;0;.00nan;0;0
13619;46790;547;71;20;1;19;.950;3600000;0
13619;53895;550;0;0;0;0;.00nan;0;0
13619;71660;550;72;34;3;31;.912;3584000;0
13619;150345;547;0;0;0;0;.00nan;0;0
13620;4803;545;90;40;3;37;.925;3600000;0
13620;7821;543;0;0;0;0;.00nan;0;0
13620;67683;545;0;0;0;0;.00nan;0;0
13620;152201;543;79;41;4;37;.902;3584000;0
13621;167061;2190;72;25;2;23;.920;3596000;0
13621;6650;2190;0;0;0;0;.00nan;0;0
13621;49864;549;69;15;1;14;.933;3600000;0
13621;59933;549;0;0;0;0;.00nan;0;0
13622;167061;2190;0;0;0;0;.00nan;0;0
13622;6650;2190;100;30;0;30;1.000;3600000;0
13622;12406;551;0;0;0;0;.00nan;0;0
13622;17711;551;63;33;3;30;.909;3600000;0
13623;7821;543;0;0;0;0;.00nan;0;0
13623;82817;548;0;0;0;0;.00nan;0;0
13623;152201;543;56;28;4;24;.857;3600000;0
13623;160650;548;77;19;1;18;.947;3600000;0
13624;46790;547;97;23;0;23;1.000;3600000;0
13624;49864;549;94;40;2;38;.950;3568000;0
13624;59933;549;0;0;0;0;.00nan;0;0
13624;150345;547;0;0;0;0;.00nan;0;0
13625;4803;545;53;23;3;20;.870;3600000;0
13625;53895;550;0;0;0;0;.00nan;0;0
13625;67683;545;0;0;0;0;.00nan;0;0
13625;71660;550;64;40;4;36;.900;3545000;0
13626;3165;546;61;28;2;26;.929;3900000;0
13626;7063;546;0;0;0;0;.00nan;0;0
13626;12406;551;0;0;0;0;.00nan;0;0
13626;17711;551;68;24;2;22;.917;3900000;0
13627;167061;2190;0;0;0;0;.00nan;0;0
13627;6650;2190;85;33;1;32;.970;3600000;0
13627;53895;550;0;0;0;0;.00nan;0;0
13627;71660;550;94;38;2;36;.947;3561000;0
13628;7821;543;0;0;0;0;.00nan;0;0
13628;46790;547;63;34;4;30;.882;3514000;0
13628;150345;547;0;0;0;0;.00nan;0;0
13628;152201;543;83;34;2;32;.941;3600000;0
13629;4803;545;100;25;0;25;1.000;3600000;0
13629;49864;549;44;30;5;25;.833;3600000;0
13629;59933;549;0;0;0;0;.00nan;0;0
13629;67683;545;0;0;0;0;.00nan;0;0
13630;3165;546;0;0;0;0;.00nan;0;0
13630;7063;546;60;20;2;18;.900;3600000;0
13630;53895;550;0;0;0;0;.00nan;0;0
13630;71660;550;75;36;3;33;.917;3557000;0
13631;12406;551;72;30;3;27;.900;3600000;0
13631;17711;551;0;0;0;0;.00nan;0;0
13631;46790;547;42;28;4;24;.857;3544000;0
13631;150345;547;0;0;0;0;.00nan;0;0
13632;167061;2190;40;22;4;18;.818;3552000;0
13632;6650;2190;0;0;0;0;.00nan;0;0
13632;82817;548;0;0;0;0;.00nan;0;0
13632;160650;548;67;25;2;23;.920;3600000;0
13633;167061;2190;0;0;0;0;.00nan;0;0
13633;4803;545;78;22;1;21;.955;3600000;0
13633;6650;2190;61;29;4;25;.862;3600000;0
13633;67683;545;0;0;0;0;.00nan;0;0
13634;12406;551;0;0;0;0;.00nan;0;0
13634;17711;551;59;14;1;13;.929;3600000;0
13634;82817;548;80;43;4;39;.907;3600000;0
13634;160650;548;0;0;0;0;.00nan;0;0
13635;7821;543;0;0;0;0;.00nan;0;0
13635;49864;549;68;41;4;37;.902;3600000;0
13635;59933;549;0;0;0;0;.00nan;0;0
13635;152201;543;88;27;1;26;.963;3600000;0
13636;3165;546;0;0;0;0;.00nan;0;0
13636;7063;546;62;27;3;24;.889;3600000;0
13636;46790;547;0;0;0;0;.00nan;0;0
13636;150345;547;36;25;5;20;.800;3570000;0
13637;53895;550;0;0;0;0;.00nan;0;0
13637;71660;550;55;41;5;36;.878;3600000;0
13637;82817;548;0;0;0;0;.00nan;0;0
13637;160650;548;75;28;2;26;.929;3600000;0
13638;3165;546;66;24;2;22;.917;3600000;0
13638;7063;546;0;0;0;0;.00nan;0;0
13638;49864;549;38;18;4;14;.778;3527000;0
13638;59933;549;0;0;0;0;.00nan;0;0
13639;7821;543;0;0;0;0;.00nan;0;0
13639;12406;551;0;0;0;0;.00nan;0;0
13639;17711;551;54;19;3;16;.842;3559000;0
13639;152201;543;77;31;2;29;.935;3600000;0
13640;167061;2190;72;45;3;42;.933;3900000;0
13640;6650;2190;0;0;0;0;.00nan;0;0
13640;46790;547;90;41;3;38;.927;3900000;0
13640;150345;547;0;0;0;0;.00nan;0;0
13641;49864;549;0;0;0;0;.00nan;0;0
13641;53895;550;0;0;0;0;.00nan;0;0
13641;59933;549;63;19;2;17;.895;3600000;0
13641;71660;550;76;37;3;34;.919;3577000;0
13642;3165;546;0;0;0;0;.00nan;0;0
13642;7063;546;73;31;2;29;.935;3600000;0
13642;7821;543;0;0;0;0;.00nan;0;0
13642;152201;543;51;28;4;24;.857;3600000;0
13643;46790;547;0;0;0;0;.00nan;0;0
13643;82817;548;0;0;0;0;.00nan;0;0
13643;150345;547;74;34;4;30;.882;3600000;0
13643;160650;548;91;34;1;33;.971;3600000;0
13644;4803;545;65;27;3;24;.889;3564000;0
13644;12406;551;74;25;1;24;.960;3600000;0
13644;17711;551;0;0;0;0;.00nan;0;0
13644;67683;545;0;0;0;0;.00nan;0;0
13645;49864;549;55;27;3;24;.889;3516000;0
13645;53895;550;0;0;0;0;.00nan;0;0
13645;59933;549;0;0;0;0;.00nan;0;0
13645;71660;550;91;32;1;31;.969;3600000;0
13646;4803;545;19;29;7;22;.759;3597000;0
13646;12406;551;0;0;0;0;.00nan;0;0
13646;17711;551;34;30;6;24;.800;3600000;0
13646;67683;545;0;0;0;0;.00nan;0;0
13647;46790;547;80;27;2;25;.926;3900000;0
13647;82817;548;0;0;0;0;.00nan;0;0
13647;150345;547;0;0;0;0;.00nan;0;0
13647;160650;548;84;36;2;34;.944;3900000;0
13648;3165;546;0;0;0;0;.00nan;0;0
13648;7063;546;71;27;2;25;.926;3690000;0
13648;7821;543;0;0;0;0;.00nan;0;0
13648;152201;543;75;21;1;20;.952;3690000;0
13649;53895;550;0;0;0;0;.00nan;0;0
13649;71660;550;91;46;3;43;.935;3600000;0
13649;82817;548;0;0;0;0;.00nan;0;0
13649;160650;548;37;25;5;20;.800;3600000;0
13650;167061;2190;0;0;0;0;.00nan;0;0
13650;6650;2190;82;34;2;32;.941;3600000;0
13650;46790;547;49;33;5;28;.848;3292000;0
13650;150345;547;48;0;0;0;.00nan;308000;0
13651;4803;545;70;28;2;26;.929;3600000;0
13651;7821;543;0;0;0;0;.00nan;0;0
13651;67683;545;0;0;0;0;.00nan;0;0
13651;152201;543;80;40;4;36;.900;3548000;0
13652;3165;546;0;0;0;0;.00nan;0;0
13652;7063;546;76;42;4;38;.905;3600000;0
13652;12406;551;0;0;0;0;.00nan;0;0
13652;17711;551;91;28;1;27;.964;3600000;0
13653;4803;545;48;36;5;31;.861;3900000;0
13653;67683;545;0;0;0;0;.00nan;0;0
13653;82817;548;0;0;0;0;.00nan;0;0
13653;160650;548;75;44;5;39;.886;3900000;0
13654;167061;2190;83;37;3;34;.919;3735000;0
13654;6650;2190;0;0;0;0;.00nan;0;0
13654;49864;549;44;21;4;17;.810;3735000;0
13654;59933;549;0;0;0;0;.00nan;0;0
13655;3165;546;0;0;0;0;.00nan;0;0
13655;7063;546;96;44;1;43;.977;3900000;0
13655;46790;547;100;42;1;41;.976;3900000;0
13655;150345;547;0;0;0;0;.00nan;0;0
13656;7821;543;64;27;3;24;.889;3611000;0
13656;82817;548;0;0;0;0;.00nan;0;0
13656;152201;543;0;0;0;0;.00nan;0;0
13656;160650;548;77;28;2;26;.929;3611000;0
13657;3165;546;0;0;0;0;.00nan;0;0
13657;167061;2190;89;36;1;35;.972;3600000;0
13657;6650;2190;0;0;0;0;.00nan;0;0
13657;7063;546;61;36;5;31;.861;3600000;0
13658;4803;545;58;30;4;26;.867;3900000;0
13658;53895;550;0;0;0;0;.00nan;0;0
13658;67683;545;0;0;0;0;.00nan;0;0
13658;71660;550;86;45;4;41;.911;3900000;0
13659;12406;551;0;0;0;0;.00nan;0;0
13659;17711;551;70;36;3;33;.917;3600000;0
13659;49864;549;57;4;0;4;1.000;727000;0
13659;59933;549;21;25;6;19;.760;2873000;0
13660;46790;547;0;0;0;0;.00nan;0;0
13660;53895;550;0;0;0;0;.00nan;0;0
13660;71660;550;94;44;3;41;.932;3607000;0
13660;150345;547;76;30;2;28;.933;3618000;0
13661;4803;545;0;0;0;0;.00nan;0;0
13661;49864;549;72;29;2;27;.931;3600000;0
13661;59933;549;0;0;0;0;.00nan;0;0
13661;67683;545;65;35;4;31;.886;3556000;0
13662;167061;2190;0;0;0;0;.00nan;0;0
13662;6650;2190;46;35;5;30;.857;3600000;0
13662;12406;551;52;17;2;15;.882;3600000;0
13662;17711;551;0;0;0;0;.00nan;0;0
13663;3165;546;74;29;2;27;.931;3600000;0
13663;7063;546;0;0;0;0;.00nan;0;0
13663;82817;548;0;0;0;0;.00nan;0;0
13663;160650;548;72;32;3;29;.906;3570000;0
13664;3165;546;0;0;0;0;.00nan;0;0
13664;7063;546;67;20;1;19;.950;3600000;0
13664;53895;550;60;12;1;11;.917;1125000;0
13664;71660;550;37;32;6;26;.813;2475000;0
13665;167061;2190;71;38;3;35;.921;3566000;0
13665;4803;545;68;25;2;23;.920;3600000;0
13665;6650;2190;0;0;0;0;.00nan;0;0
13665;67683;545;0;0;0;0;.00nan;0;0
13666;7821;543;0;0;0;0;.00nan;0;0
13666;49864;549;0;0;0;0;.00nan;0;0
13666;59933;549;67;22;1;21;.955;3600000;0
13666;152201;543;65;23;3;20;.870;3595000;0
13667;12406;551;0;0;0;0;.00nan;0;0
13667;17711;551;77;36;3;33;.917;3600000;0
13667;82817;548;52;10;1;9;.900;1349000;0
13667;160650;548;41;37;6;31;.838;2251000;0
13668;49864;549;51;19;3;16;.842;3600000;0
13668;59933;549;0;0;0;0;.00nan;0;0
13668;82817;548;0;0;0;0;.00nan;0;0
13668;160650;548;61;40;5;35;.875;3600000;0
13669;167061;2190;61;37;5;32;.865;3591000;0
13669;6650;2190;0;0;0;0;.00nan;0;0
13669;7821;543;0;0;0;0;.00nan;0;0
13669;152201;543;51;23;3;20;.870;3600000;0
13670;12406;551;0;0;0;0;.00nan;0;0
13670;17711;551;66;27;2;25;.926;3600000;0
13670;46790;547;69;35;3;32;.914;3600000;0
13670;150345;547;0;0;0;0;.00nan;0;0
13671;3165;546;0;0;0;0;.00nan;0;0
13671;4803;545;61;17;2;15;.882;3600000;0
13671;7063;546;62;32;3;29;.906;3563000;0
13671;67683;545;0;0;0;0;.00nan;0;0
13672;12406;551;74;24;2;22;.917;3600000;0
13672;17711;551;0;0;0;0;.00nan;0;0
13672;53895;550;0;0;0;0;.00nan;0;0
13672;71660;550;51;36;5;31;.861;3600000;0
13673;3165;546;0;0;0;0;.00nan;0;0
13673;7063;546;63;35;4;31;.886;3555000;0
13673;7821;543;0;0;0;0;.00nan;0;0
13673;152201;543;67;25;2;23;.920;3600000;0
13674;4803;545;90;34;1;33;.971;3600000;0
13674;12406;551;0;0;0;0;.00nan;0;0
13674;17711;551;56;19;2;17;.895;3551000;0
13674;67683;545;0;0;0;0;.00nan;0;0
13675;167061;2190;49;23;3;20;.870;3600000;0
13675;6650;2190;0;0;0;0;.00nan;0;0
13675;53895;550;0;0;0;0;.00nan;0;0
13675;71660;550;100;31;0;31;1.000;3600000;0
13676;46790;547;0;0;0;0;.00nan;0;0
13676;49864;549;0;0;0;0;.00nan;0;0
13676;59933;549;80;29;1;28;.966;3600000;0
13676;150345;547;67;25;2;23;.920;3549000;0
13677;7821;543;0;0;0;0;.00nan;0;0
13677;12406;551;0;0;0;0;.00nan;0;0
13677;17711;551;87;26;1;25;.962;3600000;0
13677;152201;543;65;29;3;26;.897;3522000;0
13678;167061;2190;74;36;3;33;.917;3600000;0
13678;6650;2190;0;0;0;0;.00nan;0;0
13678;82817;548;0;0;0;0;.00nan;0;0
13678;160650;548;100;26;0;26;1.000;3600000;0
13679;7821;543;0;0;0;0;.00nan;0;0
13679;53895;550;0;0;0;0;.00nan;0;0
13679;71660;550;100;46;2;44;.957;3600000;0
13679;152201;543;56;21;3;18;.857;3565000;0
13680;3165;546;0;0;0;0;.00nan;0;0
13680;7063;546;77;32;3;29;.906;3600000;0
13680;49864;549;52;32;5;27;.844;3591000;0
13680;59933;549;0;0;0;0;.00nan;0;0
13681;4803;545;81;30;1;29;.967;3600000;0
13681;46790;547;58;25;2;23;.920;3546000;0
13681;67683;545;0;0;0;0;.00nan;0;0
13681;150345;547;0;0;0;0;.00nan;0;0
13682;3165;546;46;14;2;12;.857;975000;0
13682;7063;546;27;26;6;20;.769;2625000;0
13682;7821;543;0;0;0;0;.00nan;0;0
13682;152201;543;58;31;4;27;.871;3600000;0
13683;12406;551;72;22;1;21;.955;3600000;0
13683;17711;551;0;0;0;0;.00nan;0;0
13683;49864;549;61;31;3;28;.903;3512000;0
13683;59933;549;0;0;0;0;.00nan;0;0
13684;4803;545;69;13;1;12;.923;3600000;0
13684;53895;550;52;13;1;12;.923;752000;0
13684;67683;545;0;0;0;0;.00nan;0;0
13684;71660;550;43;32;6;26;.813;2848000;0
13685;3165;546;0;0;0;0;.00nan;0;0
13685;7063;546;69;46;5;41;.891;3600000;0
13685;12406;551;0;0;0;0;.00nan;0;0
13685;17711;551;81;27;2;25;.926;3600000;0
13686;49864;549;0;0;0;0;.00nan;0;0
13686;59933;549;52;35;5;30;.857;3600000;0
13686;82817;548;0;0;0;0;.00nan;0;0
13686;160650;548;98;45;1;44;.978;3600000;0
13687;7821;543;0;0;0;0;.00nan;0;0
13687;82817;548;0;0;0;0;.00nan;0;0
13687;152201;543;72;19;1;18;.947;3600000;0
13687;160650;548;87;37;2;35;.946;3600000;0
13688;4803;545;47;32;5;27;.844;3269000;0
13688;49864;549;67;19;1;18;.947;3600000;0
13688;59933;549;0;0;0;0;.00nan;0;0
13688;67683;545;51;3;0;3;1.000;331000;0
13689;3165;546;0;0;0;0;.00nan;0;0
13689;167061;2190;44;34;5;29;.853;3544000;0
13689;6650;2190;0;0;0;0;.00nan;0;0
13689;7063;546;58;27;3;24;.889;3600000;0
13690;12406;551;0;0;0;0;.00nan;0;0
13690;17711;551;67;29;2;27;.931;3600000;0
13690;46790;547;73;40;4;36;.900;3553000;0
13690;150345;547;0;0;0;0;.00nan;0;0
13691;12406;551;0;0;0;0;.00nan;0;0
13691;17711;551;71;16;1;15;.938;3600000;0
13691;53895;550;65;44;5;39;.886;3600000;0
13691;71660;550;0;0;0;0;.00nan;0;0
13692;46790;547;61;19;2;17;.895;3572000;0
13692;82817;548;0;0;0;0;.00nan;0;0
13692;150345;547;0;0;0;0;.00nan;0;0
13692;160650;548;98;25;0;25;1.000;3600000;0
13693;167061;2190;0;0;0;0;.00nan;0;0
13693;6650;2190;31;25;5;20;.800;3600000;0
13693;82817;548;0;0;0;0;.00nan;0;0
13693;160650;548;71;28;2;26;.929;3600000;0
13694;3165;546;0;0;0;0;.00nan;0;0
13694;7063;546;86;41;2;39;.951;3546000;0
13694;82817;548;0;0;0;0;.00nan;0;0
13694;160650;548;80;26;1;25;.962;3600000;0
13695;46790;547;47;21;4;17;.810;3600000;0
13695;53895;550;0;0;0;0;.00nan;0;0
13695;71660;550;74;53;5;48;.906;3596000;0
13695;150345;547;0;0;0;0;.00nan;0;0
13696;7821;543;63;33;4;29;.879;3638000;0
13696;49864;549;0;0;0;0;.00nan;0;0
13696;59933;549;73;39;3;36;.923;3638000;0
13696;152201;543;0;0;0;0;.00nan;0;0
13697;167061;2190;15;7;4;3;.429;1053000;0
13697;4803;545;0;0;0;0;.00nan;0;0
13697;6650;2190;51;19;2;17;.895;2547000;0
13697;67683;545;80;26;1;25;.962;3600000;0
13698;46790;547;56;23;3;20;.870;3600000;0
13698;53895;550;63;34;3;31;.912;2521000;0
13698;71660;550;36;19;4;15;.789;1079000;0
13698;150345;547;0;0;0;0;.00nan;0;0
13699;167061;2190;0;0;0;0;.00nan;0;0
13699;6650;2190;59;47;7;40;.851;3600000;0
13699;7821;543;0;0;0;0;.00nan;0;0
13699;152201;543;77;25;1;24;.960;3600000;0
13700;4803;545;100;31;0;31;1.000;3600000;0
13700;46790;547;73;22;1;21;.955;3565000;0
13700;67683;545;0;0;0;0;.00nan;0;0
13700;150345;547;0;0;0;0;.00nan;0;0
13701;49864;549;69;17;1;16;.941;3600000;0
13701;53895;550;0;0;0;0;.00nan;0;0
13701;59933;549;0;0;0;0;.00nan;0;0
13701;71660;550;73;35;3;32;.914;3570000;0
13702;167061;2190;56;29;3;26;.897;3600000;0
13702;6650;2190;0;0;0;0;.00nan;0;0
13702;46790;547;100;45;0;45;1.000;3600000;0
13702;150345;547;0;0;0;0;.00nan;0;0
13703;7821;543;0;0;0;0;.00nan;0;0
13703;53895;550;82;20;0;20;1.000;1293000;0
13703;71660;550;18;24;6;18;.750;2307000;0
13703;152201;543;61;19;2;17;.895;3600000;0
13704;3165;546;77;32;2;30;.938;3573000;0
13704;7063;546;0;0;0;0;.00nan;0;0
13704;49864;549;84;27;1;26;.963;3600000;0
13704;59933;549;0;0;0;0;.00nan;0;0
13705;4803;545;100;45;3;42;.933;3600000;0
13705;12406;551;0;0;0;0;.00nan;0;0
13705;17711;551;57;31;4;27;.871;3591000;0
13705;67683;545;0;0;0;0;.00nan;0;0
13706;12406;551;0;0;0;0;.00nan;0;0
13706;17711;551;70;29;2;27;.931;3900000;0
13706;82817;548;0;0;0;0;.00nan;0;0
13706;160650;548;80;30;2;28;.933;3900000;0
13707;167061;2190;93;44;2;42;.955;3900000;0
13707;6650;2190;0;0;0;0;.00nan;0;0
13707;53895;550;0;0;0;0;.00nan;0;0
13707;71660;550;94;37;2;35;.946;3900000;0
13708;46790;547;69;22;2;20;.909;3562000;0
13708;49864;549;0;0;0;0;.00nan;0;0
13708;59933;549;70;21;1;20;.952;3600000;0
13708;150345;547;0;0;0;0;.00nan;0;0
13709;3165;546;0;0;0;0;.00nan;0;0
13709;4803;545;26;22;5;17;.773;3563000;0
13709;7063;546;79;48;4;44;.917;3600000;0
13709;67683;545;0;0;0;0;.00nan;0;0
13710;53895;550;0;0;0;0;.00nan;0;0
13710;71660;550;87;43;3;40;.930;3600000;0
13710;82817;548;0;0;0;0;.00nan;0;0
13710;160650;548;99;23;0;23;1.000;3600000;0
13711;167061;2190;0;0;0;0;.00nan;0;0
13711;6650;2190;67;31;4;27;.871;3589000;0
13711;12406;551;0;0;0;0;.00nan;0;0
13711;17711;551;55;16;2;14;.875;3600000;0
13712;7821;543;0;0;0;0;.00nan;0;0
13712;46790;547;100;39;1;38;.974;3600000;0
13712;150345;547;0;0;0;0;.00nan;0;0
13712;152201;543;39;29;5;24;.828;3600000;0
13713;3165;546;0;0;0;0;.00nan;0;0
13713;4803;545;32;22;5;17;.773;3195000;0
13713;7063;546;80;27;1;26;.963;3600000;0
13713;67683;545;43;4;1;3;.750;405000;0
13714;53895;550;91;42;1;41;.976;3600000;0
13714;71660;550;0;0;0;0;.00nan;0;0
13714;82817;548;0;0;0;0;.00nan;0;0
13714;160650;548;59;34;5;29;.853;3600000;0
13715;3165;546;100;50;2;48;.960;3900000;0
13715;7063;546;0;0;0;0;.00nan;0;0
13715;49864;549;72;31;2;29;.935;3900000;0
13715;59933;549;0;0;0;0;.00nan;0;0
13716;7821;543;64;30;3;27;.900;3600000;0
13716;46790;547;64;41;5;36;.878;3600000;0
13716;150345;547;0;0;0;0;.00nan;0;0
13716;152201;543;0;0;0;0;.00nan;0;0
13717;167061;2190;18;22;6;16;.727;2259000;0
13717;6650;2190;62;7;0;7;1.000;1341000;0
13717;12406;551;100;23;0;23;1.000;3600000;0
13717;17711;551;0;0;0;0;.00nan;0;0
13718;3165;546;0;0;0;0;.00nan;0;0
13718;7063;546;84;41;2;39;.951;3898000;0
13718;46790;547;92;37;2;35;.946;3900000;0
13718;150345;547;0;0;0;0;.00nan;0;0
13719;3165;546;0;0;0;0;.00nan;0;0
13719;7063;546;68;30;3;27;.900;3600000;0
13719;53895;550;0;0;0;0;.00nan;0;0
13719;71660;550;62;34;4;30;.882;3551000;0
13720;167061;2190;70;33;3;30;.909;3900000;0
13720;6650;2190;0;0;0;0;.00nan;0;0
13720;49864;549;0;0;0;0;.00nan;0;0
13720;59933;549;67;32;3;29;.906;3900000;0
13721;4803;545;67;25;3;22;.880;3600000;0
13721;67683;545;0;0;0;0;.00nan;0;0
13721;82817;548;0;0;0;0;.00nan;0;0
13721;160650;548;57;33;4;29;.879;3599000;0
13722;7821;543;0;0;0;0;.00nan;0;0
13722;12406;551;54;33;5;28;.848;3900000;0
13722;17711;551;0;0;0;0;.00nan;0;0
13722;152201;543;50;32;5;27;.844;3900000;0
13723;4803;545;74;25;1;24;.960;3600000;0
13723;67683;545;0;0;0;0;.00nan;0;0
13723;82817;548;0;0;0;0;.00nan;0;0
13723;160650;548;64;37;4;33;.892;3600000;0
13724;7821;543;0;0;0;0;.00nan;0;0
13724;46790;547;90;30;1;29;.967;3600000;0
13724;150345;547;0;0;0;0;.00nan;0;0
13724;152201;543;60;30;4;26;.867;3600000;0
13725;167061;2190;0;0;0;0;.00nan;0;0
13725;6650;2190;57;31;4;27;.871;3550000;0
13725;53895;550;0;0;0;0;.00nan;0;0
13725;71660;550;79;41;3;38;.927;3600000;0
13726;49864;549;0;0;0;0;.00nan;0;0
13726;59933;549;34;26;5;21;.808;3600000;0
13726;82817;548;0;0;0;0;.00nan;0;0
13726;160650;548;94;32;2;30;.938;3600000;0
13727;167061;2190;68;28;2;26;.929;3772000;0
13727;6650;2190;0;0;0;0;.00nan;0;0
13727;7821;543;0;0;0;0;.00nan;0;0
13727;152201;543;71;31;3;28;.903;3772000;0
13728;4803;545;36;21;4;17;.810;3600000;0
13728;53895;550;0;0;0;0;.00nan;0;0
13728;67683;545;0;0;0;0;.00nan;0;0
13728;71660;550;72;56;5;51;.911;3574000;0
13729;12406;551;0;0;0;0;.00nan;0;0
13729;17711;551;85;39;3;36;.923;3557000;0
13729;46790;547;74;20;1;19;.950;3600000;0
13729;150345;547;0;0;0;0;.00nan;0;0
13730;3165;546;65;11;0;11;1.000;801000;0
13730;7063;546;17;30;7;23;.767;2799000;0
13730;82817;548;0;0;0;0;.00nan;0;0
13730;160650;548;70;26;2;24;.923;3600000;0
13731;167061;2190;93;42;3;39;.929;3600000;0
13731;6650;2190;0;0;0;0;.00nan;0;0
13731;49864;549;0;0;0;0;.00nan;0;0
13731;59933;549;50;27;4;23;.852;3559000;0
13732;4803;545;0;0;0;0;.00nan;0;0
13732;7821;543;0;0;0;0;.00nan;0;0
13732;67683;545;88;33;2;31;.939;3900000;0
13732;152201;543;76;23;2;21;.913;3868000;0
13733;3165;546;76;36;3;33;.917;3572000;0
13733;7063;546;0;0;0;0;.00nan;0;0
13733;12406;551;82;22;1;21;.955;3600000;0
13733;17711;551;0;0;0;0;.00nan;0;0
13734;12406;551;0;0;0;0;.00nan;0;0
13734;17711;551;65;25;3;22;.880;3900000;0
13734;49864;549;68;27;3;24;.889;3870000;0
13734;59933;549;0;0;0;0;.00nan;0;0
13735;4803;545;100;41;0;41;1.000;3600000;0
13735;7821;543;0;0;0;0;.00nan;0;0
13735;67683;545;0;0;0;0;.00nan;0;0
13735;152201;543;82;21;1;20;.952;3567000;0
13736;3165;546;87;32;2;30;.938;3600000;0
13736;7063;546;0;0;0;0;.00nan;0;0
13736;46790;547;47;16;3;13;.813;3553000;0
13736;150345;547;0;0;0;0;.00nan;0;0
13737;46790;547;88;36;2;34;.944;3841000;0
13737;82817;548;0;0;0;0;.00nan;0;0
13737;150345;547;0;0;0;0;.00nan;0;0
13737;160650;548;86;35;3;32;.914;3841000;0
13738;167061;2190;0;0;0;0;.00nan;0;0
13738;4803;545;47;17;3;14;.824;3900000;0
13738;6650;2190;97;42;3;39;.929;3900000;0
13738;67683;545;0;0;0;0;.00nan;0;0
13739;7821;543;0;0;0;0;.00nan;0;0
13739;49864;549;71;30;3;27;.900;3600000;0
13739;59933;549;0;0;0;0;.00nan;0;0
13739;152201;543;39;29;5;24;.828;3600000;0
13740;12406;551;68;17;1;16;.941;3600000;0
13740;17711;551;0;0;0;0;.00nan;0;0
13740;53895;550;0;0;0;0;.00nan;0;0
13740;71660;550;68;36;4;32;.889;3600000;0
13741;167061;2190;91;27;1;26;.963;3900000;0
13741;6650;2190;0;0;0;0;.00nan;0;0
13741;82817;548;0;0;0;0;.00nan;0;0
13741;160650;548;96;46;1;45;.978;3900000;0
13742;7821;543;0;0;0;0;.00nan;0;0
13742;12406;551;0;0;0;0;.00nan;0;0
13742;17711;551;86;28;1;27;.964;3600000;0
13742;152201;543;46;24;4;20;.833;3600000;0
13743;46790;547;60;16;2;14;.875;3571000;0
13743;49864;549;82;25;1;24;.960;3600000;0
13743;59933;549;0;0;0;0;.00nan;0;0
13743;150345;547;0;0;0;0;.00nan;0;0
13744;3165;546;38;31;5;26;.839;3535000;0
13744;7063;546;0;0;0;0;.00nan;0;0
13744;53895;550;0;0;0;0;.00nan;0;0
13744;71660;550;82;39;3;36;.923;3600000;0
13745;49864;549;58;33;4;29;.879;3900000;0
13745;53895;550;0;0;0;0;.00nan;0;0
13745;59933;549;0;0;0;0;.00nan;0;0
13745;71660;550;73;43;4;39;.907;3900000;0
13746;3165;546;94;52;4;48;.923;3600000;0
13746;167061;2190;91;30;1;29;.967;3600000;0
13746;6650;2190;0;0;0;0;.00nan;0;0
13746;7063;546;0;0;0;0;.00nan;0;0
13747;4803;545;96;38;1;37;.974;3900000;0
13747;46790;547;0;0;0;0;.00nan;0;0
13747;67683;545;0;0;0;0;.00nan;0;0
13747;150345;547;83;24;1;23;.958;3900000;0
13748;12406;551;52;24;4;20;.833;3586000;0
13748;17711;551;0;0;0;0;.00nan;0;0
13748;82817;548;0;0;0;0;.00nan;0;0
13748;160650;548;72;30;2;28;.933;3600000;0
13749;7821;543;58;14;1;13;.929;2420000;0
13749;82817;548;0;0;0;0;.00nan;0;0
13749;152201;543;34;16;4;12;.750;1180000;0
13749;160650;548;70;27;2;25;.926;3600000;0
13750;167061;2190;57;35;4;31;.886;3600000;0
13750;6650;2190;0;0;0;0;.00nan;0;0
13750;46790;547;80;36;3;33;.917;3600000;0
13750;150345;547;0;0;0;0;.00nan;0;0
13751;4803;545;96;34;1;33;.971;3600000;0
13751;49864;549;46;31;5;26;.839;3600000;0
13751;59933;549;0;0;0;0;.00nan;0;0
13751;67683;545;0;0;0;0;.00nan;0;0
13752;12406;551;0;0;0;0;.00nan;0;0
13752;17711;551;62;32;4;28;.875;3813000;0
13752;82817;548;54;37;5;32;.865;3813000;0
13752;160650;548;0;0;0;0;.00nan;0;0
13753;7821;543;0;0;0;0;.00nan;0;0
13753;46790;547;57;33;4;29;.879;3900000;0
13753;72108;547;0;0;0;0;.00nan;0;0
13753;152201;543;61;34;4;30;.882;3900000;0
13754;3165;546;98;43;3;40;.930;3900000;0
13754;167061;2190;77;35;3;32;.914;3900000;0
13754;6650;2190;0;0;0;0;.00nan;0;0
13754;7063;546;0;0;0;0;.00nan;0;0
13755;4803;545;67;26;3;23;.885;3600000;0
13755;53895;550;0;0;0;0;.00nan;0;0
13755;67683;545;0;0;0;0;.00nan;0;0
13755;71660;550;65;45;5;40;.889;3600000;0
13756;7821;543;0;0;0;0;.00nan;0;0
13756;82817;548;0;0;0;0;.00nan;0;0
13756;152201;543;88;39;4;35;.897;3600000;0
13756;160650;548;56;26;3;23;.885;3600000;0
13757;167061;2190;0;0;0;0;.00nan;0;0
13757;6650;2190;97;45;2;43;.956;3600000;0
13757;46790;547;52;19;3;16;.842;3558000;0
13757;150345;547;0;0;0;0;.00nan;0;0
13758;12406;551;0;0;0;0;.00nan;0;0
13758;17711;551;97;43;2;41;.953;3600000;0
13758;53895;550;0;0;0;0;.00nan;0;0
13758;71660;550;98;43;3;40;.930;3600000;0
13759;3165;546;90;33;1;32;.970;3600000;0
13759;7063;546;0;0;0;0;.00nan;0;0
13759;49864;549;60;22;2;20;.909;3572000;0
13759;59933;549;0;0;0;0;.00nan;0;0
13760;167061;2190;56;23;3;20;.870;3600000;0
13760;6650;2190;0;0;0;0;.00nan;0;0
13760;53895;550;0;0;0;0;.00nan;0;0
13760;71660;550;40;37;6;31;.838;3600000;0
13761;49864;549;0;0;0;0;.00nan;0;0
13761;59933;549;85;27;1;26;.963;3600000;0
13761;82817;548;0;0;0;0;.00nan;0;0
13761;160650;548;68;37;3;34;.919;3516000;0
13762;3165;546;64;33;4;29;.879;3577000;0
13762;7063;546;0;0;0;0;.00nan;0;0
13762;7821;543;56;21;3;18;.857;3600000;0
13762;152201;543;0;0;0;0;.00nan;0;0
13763;4803;545;79;37;3;34;.919;3900000;0
13763;12406;551;0;0;0;0;.00nan;0;0
13763;17711;551;78;37;3;34;.919;3900000;0
13763;67683;545;0;0;0;0;.00nan;0;0
13764;167061;2190;86;35;2;33;.943;3600000;0
13764;6650;2190;0;0;0;0;.00nan;0;0
13764;82817;548;0;0;0;0;.00nan;0;0
13764;160650;548;60;37;5;32;.865;3600000;0
13765;7821;543;0;0;0;0;.00nan;0;0
13765;53895;550;97;38;2;36;.947;3546000;0
13765;71660;550;0;0;0;0;.00nan;0;0
13765;152201;543;71;21;1;20;.952;3600000;0
13766;4803;545;83;30;2;28;.933;3600000;0
13766;46790;547;78;34;3;31;.912;3542000;0
13766;67683;545;0;0;0;0;.00nan;0;0
13766;150345;547;0;0;0;0;.00nan;0;0
13767;12406;551;0;0;0;0;.00nan;0;0
13767;17711;551;73;24;1;23;.958;3600000;0
13767;49864;549;52;35;5;30;.857;3600000;0
13767;59933;549;0;0;0;0;.00nan;0;0
13768;53895;550;0;0;0;0;.00nan;0;0
13768;71660;550;81;42;3;39;.929;3600000;0
13768;82817;548;0;0;0;0;.00nan;0;0
13768;160650;548;68;22;2;20;.909;3600000;0
13769;167061;2190;100;20;0;20;1.000;3600000;0
13769;6650;2190;0;0;0;0;.00nan;0;0
13769;12406;551;0;0;0;0;.00nan;0;0
13769;17711;551;82;34;2;32;.941;3546000;0
13770;4803;545;75;38;2;36;.947;3600000;0
13770;49864;549;0;0;0;0;.00nan;0;0
13770;59933;549;97;37;1;36;.973;3600000;0
13770;67683;545;0;0;0;0;.00nan;0;0
13771;3165;546;58;43;6;37;.860;3600000;0
13771;7063;546;0;0;0;0;.00nan;0;0
13771;46790;547;86;34;1;33;.971;3600000;0
13771;150345;547;0;0;0;0;.00nan;0;0
13772;7821;543;0;0;0;0;.00nan;0;0
13772;53895;550;0;0;0;0;.00nan;0;0
13772;71660;550;37;39;6;33;.846;3600000;0
13772;152201;543;100;25;0;25;1.000;3600000;0
13773;167061;2190;64;16;2;14;.875;3576000;0
13773;4803;545;0;0;0;0;.00nan;0;0
13773;6650;2190;0;0;0;0;.00nan;0;0
13773;67683;545;100;25;0;25;1.000;3600000;0
13774;7821;543;0;0;0;0;.00nan;0;0
13774;49864;549;76;40;3;37;.925;3600000;0
13774;59933;549;0;0;0;0;.00nan;0;0
13774;152201;543;80;28;1;27;.964;3600000;0
13775;46790;547;82;26;1;25;.962;3600000;0
13775;82817;548;0;0;0;0;.00nan;0;0
13775;150345;547;0;0;0;0;.00nan;0;0
13775;160650;548;86;38;3;35;.921;3600000;0
13776;3165;546;100;30;0;30;1.000;3600000;0
13776;7063;546;0;0;0;0;.00nan;0;0
13776;12406;551;0;0;0;0;.00nan;0;0
13776;17711;551;79;26;1;25;.962;3600000;0
13777;167061;2190;0;0;0;0;.00nan;0;0
13777;6650;2190;90;32;1;31;.969;3900000;0
13777;7821;543;0;0;0;0;.00nan;0;0
13777;152201;543;91;31;1;30;.968;3900000;0
13778;49864;549;80;39;2;37;.949;3900000;0
13778;53895;550;0;0;0;0;.00nan;0;0
13778;59933;549;0;0;0;0;.00nan;0;0
13778;71660;550;84;44;2;42;.955;3900000;0
13779;3165;546;66;29;3;26;.897;3600000;0
13779;4803;545;0;0;0;0;.00nan;0;0
13779;7063;546;0;0;0;0;.00nan;0;0
13779;67683;545;67;23;2;21;.913;3600000;0
13780;12406;551;29;14;4;10;.714;883000;0
13780;17711;551;54;12;2;10;.833;2717000;0
13780;46790;547;72;22;1;21;.955;3600000;0
13780;150345;547;0;0;0;0;.00nan;0;0
13781;3165;546;50;27;4;23;.852;3900000;0
13781;7063;546;0;0;0;0;.00nan;0;0
13781;82817;548;52;30;4;26;.867;3895000;0
13781;160650;548;0;0;0;0;.00nan;0;0
13782;46790;547;86;15;0;15;1.000;3600000;0
13782;53895;550;52;11;1;10;.909;663000;0
13782;71660;550;21;27;7;20;.741;2937000;0
13782;150345;547;0;0;0;0;.00nan;0;0
13783;167061;2190;83;29;1;28;.966;3600000;0
13783;6650;2190;0;0;0;0;.00nan;0;0
13783;49864;549;69;27;2;25;.926;3567000;0
13783;59933;549;0;0;0;0;.00nan;0;0
13784;4803;545;64;36;4;32;.889;3558000;0
13784;7821;543;0;0;0;0;.00nan;0;0
13784;67683;545;0;0;0;0;.00nan;0;0
13784;152201;543;68;30;3;27;.900;3600000;0
13785;46790;547;99;21;0;21;1.000;3600000;0
13785;49864;549;83;55;4;51;.927;3600000;0
13785;59933;549;0;0;0;0;.00nan;0;0
13785;150345;547;0;0;0;0;.00nan;0;0
13786;3165;546;100;22;0;22;1.000;3600000;0
13786;7063;546;0;0;0;0;.00nan;0;0
13786;53895;550;0;0;0;0;.00nan;0;0
13786;71660;550;68;37;4;33;.892;3600000;0
13787;4803;545;45;31;5;26;.839;3546000;0
13787;67683;545;0;0;0;0;.00nan;0;0
13787;82817;548;0;0;0;0;.00nan;0;0
13787;160650;548;69;30;3;27;.900;3600000;0
13788;7821;543;0;0;0;0;.00nan;0;0
13788;12406;551;0;0;0;0;.00nan;0;0
13788;17711;551;66;34;3;31;.912;3546000;0
13788;152201;543;99;35;1;34;.971;3600000;0
13790;7821;543;0;0;0;0;.00nan;0;0
13790;12406;551;0;0;0;0;.00nan;0;0
13790;17711;551;82;31;2;29;.935;3600000;0
13790;152201;543;55;27;3;24;.889;3546000;0
13792;167061;2190;95;22;0;22;1.000;3600000;0
13792;6650;2190;0;0;0;0;.00nan;0;0
13792;82817;548;0;0;0;0;.00nan;0;0
13792;160650;548;72;30;3;27;.900;3600000;0
13794;3165;546;0;0;0;0;.00nan;0;0
13794;4803;545;83;13;0;13;1.000;3600000;0
13794;7063;546;59;36;4;32;.889;3600000;0
13794;67683;545;0;0;0;0;.00nan;0;0
13796;49864;549;49;15;2;13;.867;3600000;0
13796;53895;550;0;0;0;0;.00nan;0;0
13796;59933;549;0;0;0;0;.00nan;0;0
13796;71660;550;62;43;6;37;.860;3600000;0
13798;3165;546;0;0;0;0;.00nan;0;0
13798;7063;546;79;43;4;39;.907;3600000;0
13798;46790;547;0;0;0;0;.00nan;0;0
13798;150345;547;80;25;1;24;.960;3600000;0
13800;167061;2190;78;35;2;33;.943;3582000;0
13800;6650;2190;0;0;0;0;.00nan;0;0
13800;49864;549;89;22;1;21;.955;3600000;0
13800;59933;549;0;0;0;0;.00nan;0;0
13802;12406;551;0;0;0;0;.00nan;0;0
13802;17711;551;76;20;1;19;.950;3600000;0
13802;82817;548;0;0;0;0;.00nan;0;0
13802;160650;548;73;54;5;49;.907;3600000;0
13804;7821;543;0;0;0;0;.00nan;0;0
13804;53895;550;0;0;0;0;.00nan;0;0
13804;71660;550;58;43;5;38;.884;3516000;0
13804;152201;543;38;13;3;10;.769;3600000;0
13806;12406;551;55;28;3;25;.893;3600000;0
13806;17711;551;0;0;0;0;.00nan;0;0
13806;82817;548;71;40;4;36;.900;3544000;0
13806;160650;548;0;0;0;0;.00nan;0;0
13808;3165;546;70;32;4;28;.875;3553000;0
13808;7063;546;0;0;0;0;.00nan;0;0
13808;53895;550;51;21;3;18;.857;3600000;0
13808;71660;550;0;0;0;0;.00nan;0;0
13810;167061;2190;0;0;0;0;.00nan;0;0
13810;6650;2190;68;29;2;27;.931;3600000;0
13810;49864;549;75;11;0;11;1.000;1233000;0
13810;59933;549;15;19;6;13;.684;2367000;0
13812;4803;545;37;32;6;26;.813;3600000;0
13812;7821;543;67;22;2;20;.909;3600000;0
13812;67683;545;0;0;0;0;.00nan;0;0
13812;152201;543;0;0;0;0;.00nan;0;0
13814;53895;550;74;31;2;29;.935;3556000;0
13814;71660;550;0;0;0;0;.00nan;0;0
13814;82817;548;0;0;0;0;.00nan;0;0
13814;160650;548;98;24;0;24;1.000;3600000;0
13816;167061;2190;0;0;0;0;.00nan;0;0
13816;6650;2190;44;24;4;20;.833;3544000;0
13816;49864;549;62;27;3;24;.889;3600000;0
13816;59933;549;0;0;0;0;.00nan;0;0
13818;4803;545;63;22;2;20;.909;3600000;0
13818;12406;551;0;0;0;0;.00nan;0;0
13818;17711;551;71;35;3;32;.914;3600000;0
13818;67683;545;0;0;0;0;.00nan;0;0
13820;3165;546;0;0;0;0;.00nan;0;0
13820;7063;546;68;30;3;27;.900;3600000;0
13820;46790;547;97;24;0;24;1.000;3600000;0
13820;150345;547;0;0;0;0;.00nan;0;0
13822;167061;2190;65;14;1;13;.929;3600000;0
13822;6650;2190;0;0;0;0;.00nan;0;0
13822;82817;548;0;0;0;0;.00nan;0;0
13822;160650;548;88;35;2;33;.943;3568000;0
13824;4803;545;0;0;0;0;.00nan;0;0
13824;12406;551;71;36;4;32;.889;3600000;0
13824;17711;551;0;0;0;0;.00nan;0;0
13824;67683;545;39;32;6;26;.813;3600000;0
13826;3165;546;43;38;6;32;.842;3275000;0
13826;7063;546;53;3;0;3;1.000;325000;0
13826;46790;547;59;16;2;14;.875;3600000;0
13826;150345;547;0;0;0;0;.00nan;0;0
13828;7821;543;0;0;0;0;.00nan;0;0
13828;49864;549;0;0;0;0;.00nan;0;0
13828;59933;549;83;26;1;25;.962;3600000;0
13828;152201;543;78;34;2;32;.941;3591000;0
13830;167061;2190;79;47;4;43;.915;3600000;0
13830;4803;545;88;18;0;18;1.000;3600000;0
13830;6650;2190;0;0;0;0;.00nan;0;0
13830;67683;545;0;0;0;0;.00nan;0;0
13832;12406;551;0;0;0;0;.00nan;0;0
13832;17711;551;70;22;1;21;.955;3600000;0
13832;82817;548;45;25;4;21;.840;3600000;0
13832;160650;548;0;0;0;0;.00nan;0;0
13834;3165;546;0;0;0;0;.00nan;0;0
13834;7063;546;77;26;2;24;.923;3581000;0
13834;46790;547;79;23;1;22;.957;3600000;0
13834;150345;547;0;0;0;0;.00nan;0;0
13836;7821;543;0;0;0;0;.00nan;0;0
13836;53895;550;0;0;0;0;.00nan;0;0
13836;71660;550;97;38;2;36;.947;3545000;0
13836;152201;543;92;27;1;26;.963;3600000;0
13838;3165;546;100;46;2;44;.957;3900000;0
13838;7063;546;0;0;0;0;.00nan;0;0
13838;49864;549;55;20;2;18;.900;3900000;0
13838;59933;549;0;0;0;0;.00nan;0;0
13840;167061;2190;0;0;0;0;.00nan;0;0
13840;6650;2190;57;30;3;27;.900;3900000;0
13840;82817;548;0;0;0;0;.00nan;0;0
13840;160650;548;57;28;3;25;.893;3900000;0
13842;12406;551;72;20;1;19;.950;3600000;0
13842;17711;551;0;0;0;0;.00nan;0;0
13842;53895;550;65;36;4;32;.889;3018000;0
13842;71660;550;48;8;1;7;.875;582000;0
13844;4803;545;27;28;6;22;.786;2294000;0
13844;7821;543;73;21;1;20;.952;3600000;0
13844;67683;545;51;15;2;13;.867;1306000;0
13844;152201;543;0;0;0;0;.00nan;0;0
1082;167061;2190;64;46;6;40;.870;3835000;0
1082;4803;545;32;20;5;15;.750;3835000;0
1082;6650;2190;0;0;0;0;.00nan;0;0
1082;67683;545;0;0;0;0;.00nan;0;0
1083;12406;551;0;0;0;0;.00nan;0;0
1083;17711;551;66;24;2;22;.917;3600000;0
1083;49864;549;46;28;5;23;.821;3600000;0
1083;59933;549;0;0;0;0;.00nan;0;0
1084;3165;546;82;37;4;33;.892;3600000;0
1084;7063;546;0;0;0;0;.00nan;0;0
1084;7821;543;0;0;0;0;.00nan;0;0
1084;152201;543;51;22;3;19;.864;3600000;0
1085;46790;547;74;28;2;26;.929;3600000;0
1085;82817;548;0;0;0;0;.00nan;0;0
1085;150345;547;0;0;0;0;.00nan;0;0
1085;160650;548;31;26;5;21;.808;3600000;0
1086;167061;2190;83;31;1;30;.968;3600000;0
1086;4803;545;71;24;2;22;.917;3563000;0
1086;6650;2190;0;0;0;0;.00nan;0;0
1086;67683;545;0;0;0;0;.00nan;0;0
1087;12406;551;0;0;0;0;.00nan;0;0
1087;17711;551;62;26;3;23;.885;3573000;0
1087;49864;549;87;28;2;26;.929;3600000;0
1087;59933;549;0;0;0;0;.00nan;0;0
1088;3165;546;0;0;0;0;.00nan;0;0
1088;7063;546;71;31;3;28;.903;3574000;0
1088;7821;543;0;0;0;0;.00nan;0;0
1088;152201;543;78;25;1;24;.960;3600000;0
1089;46790;547;72;31;3;28;.903;3600000;0
1089;82817;548;0;0;0;0;.00nan;0;0
1089;150345;547;0;0;0;0;.00nan;0;0
1089;160650;548;73;47;4;43;.915;3578000;0
1090;167061;2190;55;31;4;27;.871;3553000;0
1090;4803;545;53;17;2;15;.882;3600000;0
1090;6650;2190;0;0;0;0;.00nan;0;0
1090;67683;545;0;0;0;0;.00nan;0;0
1091;12406;551;0;0;0;0;.00nan;0;0
1091;17711;551;96;40;2;38;.950;3600000;0
1091;49864;549;57;25;3;22;.880;3584000;0
1091;59933;549;0;0;0;0;.00nan;0;0
1092;3165;546;0;0;0;0;.00nan;0;0
1092;7063;546;76;26;2;24;.923;3573000;0
1092;7821;543;0;0;0;0;.00nan;0;0
1092;152201;543;100;27;0;27;1.000;3600000;0
1093;46790;547;99;25;0;25;1.000;3600000;0
1093;82817;548;0;0;0;0;.00nan;0;0
1093;150345;547;0;0;0;0;.00nan;0;0
1093;160650;548;66;28;2;26;.929;3533000;0
1094;167061;2190;67;38;4;34;.895;3566000;0
1094;4803;545;71;31;3;28;.903;3600000;0
1094;6650;2190;0;0;0;0;.00nan;0;0
1094;67683;545;0;0;0;0;.00nan;0;0
1095;12406;551;0;0;0;0;.00nan;0;0
1095;17711;551;58;27;3;24;.889;3549000;0
1095;49864;549;69;25;2;23;.920;3600000;0
1095;59933;549;0;0;0;0;.00nan;0;0
1096;3165;546;0;0;0;0;.00nan;0;0
1096;7063;546;95;32;1;31;.969;3600000;0
1096;7821;543;0;0;0;0;.00nan;0;0
1096;152201;543;73;24;2;22;.917;3545000;0
1097;46790;547;71;35;3;32;.914;3575000;0
1097;82817;548;0;0;0;0;.00nan;0;0
1097;150345;547;0;0;0;0;.00nan;0;0
1097;160650;548;65;28;2;26;.929;3600000;0
1492;167061;2190;100;40;0;40;1.000;3600000;0
1492;4803;545;47;23;4;19;.826;3600000;0
1492;6650;2190;0;0;0;0;.00nan;0;0
1492;67683;545;0;0;0;0;.00nan;0;0
1493;12406;551;0;0;0;0;.00nan;0;0
1493;17711;551;100;48;1;47;.979;5287000;0
1493;49864;549;94;48;2;46;.958;5287000;0
1493;59933;549;0;0;0;0;.00nan;0;0
1494;3165;546;69;9;0;9;1.000;463000;0
1494;7063;546;66;46;5;41;.891;3137000;0
1494;7821;543;0;0;0;0;.00nan;0;0
1494;152201;543;45;20;3;17;.850;3600000;0
1495;46790;547;93;20;0;20;1.000;3600000;0
1495;82817;548;0;0;0;0;.00nan;0;0
1495;150345;547;0;0;0;0;.00nan;0;0
1495;160650;548;68;38;3;35;.921;3600000;0
1529;167061;2190;93;26;1;25;.962;3600000;0
1529;4803;545;47;32;5;27;.844;3600000;0
1529;6650;2190;0;0;0;0;.00nan;0;0
1529;67683;545;0;0;0;0;.00nan;0;0
1530;12406;551;0;0;0;0;.00nan;0;0
1530;17711;551;100;29;0;29;1.000;3600000;0
1530;49864;549;33;30;5;25;.833;3057000;0
1530;59933;549;60;8;0;8;1.000;543000;0
1579;167061;2190;55;33;5;28;.848;3642000;0
1579;4803;545;58;32;4;28;.875;3620000;0
1579;6650;2190;0;0;0;0;.00nan;0;0
1579;67683;545;0;0;0;0;.00nan;0;0
1590;4803;545;100;39;0;39;1.000;3600000;0
1590;46790;547;63;37;4;33;.892;3600000;0
1590;67683;545;0;0;0;0;.00nan;0;0
1590;150345;547;0;0;0;0;.00nan;0;0
1591;7821;543;0;0;0;0;.00nan;0;0
1591;12406;551;0;0;0;0;.00nan;0;0
1591;17711;551;62;20;2;18;.900;3644000;0
1591;152201;543;57;27;3;24;.889;3644000;0
1592;4803;545;75;39;5;34;.872;4126000;0
1592;46790;547;83;46;4;42;.913;4126000;0
1592;67683;545;0;0;0;0;.00nan;0;0
1592;150345;547;0;0;0;0;.00nan;0;0
1593;7821;543;0;0;0;0;.00nan;0;0
1593;12406;551;0;0;0;0;.00nan;0;0
1593;17711;551;49;27;4;23;.852;3600000;0
1593;152201;543;86;18;0;18;1.000;3600000;0
1594;4803;545;89;33;2;31;.939;3600000;0
1594;46790;547;52;31;5;26;.839;3600000;0
1594;67683;545;0;0;0;0;.00nan;0;0
1594;150345;547;0;0;0;0;.00nan;0;0
1595;7821;543;0;0;0;0;.00nan;0;0
1595;12406;551;0;0;0;0;.00nan;0;0
1595;17711;551;93;40;2;38;.950;3600000;0
1595;152201;543;44;16;3;13;.813;3562000;0
1596;4803;545;77;44;4;40;.909;3600000;0
1596;46790;547;41;27;5;22;.815;3577000;0
1596;67683;545;0;0;0;0;.00nan;0;0
1596;150345;547;0;0;0;0;.00nan;0;0
1597;7821;543;0;0;0;0;.00nan;0;0
1597;12406;551;0;0;0;0;.00nan;0;0
1597;17711;551;100;33;0;33;1.000;3600000;0
1597;152201;543;68;24;2;22;.917;3547000;0
1888;4803;545;54;18;2;16;.889;3600000;0
1888;46790;547;45;41;6;35;.854;3600000;0
1888;67683;545;0;0;0;0;.00nan;0;0
1888;150345;547;0;0;0;0;.00nan;0;0
1889;7821;543;0;0;0;0;.00nan;0;0
1889;12406;551;0;0;0;0;.00nan;0;0
1889;17711;551;60;32;4;28;.875;3563000;0
1889;152201;543;70;32;3;29;.906;3600000;0
1907;7821;543;0;0;0;0;.00nan;0;0
1907;12406;551;0;0;0;0;.00nan;0;0
1907;17711;551;68;28;2;26;.929;3600000;0
1907;152201;543;39;15;3;12;.800;3560000;0
1934;4803;545;59;21;2;19;.905;3600000;0
1934;12406;551;0;0;0;0;.00nan;0;0
1934;17711;551;56;23;3;20;.870;3559000;0
1934;67683;545;0;0;0;0;.00nan;0;0
1935;7821;543;0;0;0;0;.00nan;0;0
1935;46790;547;94;18;0;18;1.000;3600000;0
1935;150345;547;0;0;0;0;.00nan;0;0
1935;152201;543;83;29;1;28;.966;3600000;0
1936;4803;545;43;24;4;20;.833;3600000;0
1936;12406;551;0;0;0;0;.00nan;0;0
1936;17711;551;95;43;3;40;.930;3600000;0
1936;67683;545;0;0;0;0;.00nan;0;0
1937;7821;543;0;0;0;0;.00nan;0;0
1937;46790;547;44;28;5;23;.821;3600000;0
1937;150345;547;0;0;0;0;.00nan;0;0
1937;152201;543;75;28;2;26;.929;3600000;0
1938;4803;545;87;52;5;47;.904;5301000;0
1938;12406;551;0;0;0;0;.00nan;0;0
1938;17711;551;54;36;4;32;.889;5301000;0
1938;67683;545;0;0;0;0;.00nan;0;0
1939;7821;543;0;0;0;0;.00nan;0;0
1939;46790;547;47;18;3;15;.833;3600000;0
1939;150345;547;0;0;0;0;.00nan;0;0
1939;152201;543;68;38;5;33;.868;3588000;0
1940;4803;545;41;31;5;26;.839;3600000;0
1940;12406;551;0;0;0;0;.00nan;0;0
1940;17711;551;87;29;1;28;.966;3600000;0
1940;67683;545;0;0;0;0;.00nan;0;0
1941;7821;543;0;0;0;0;.00nan;0;0
1941;46790;547;100;38;1;37;.974;3600000;0
1941;150345;547;0;0;0;0;.00nan;0;0
1941;152201;543;57;43;6;37;.860;3600000;0
2138;4803;545;57;31;4;27;.871;3600000;0
2138;12406;551;0;0;0;0;.00nan;0;0
2138;17711;551;90;28;1;27;.964;3600000;0
2138;67683;545;0;0;0;0;.00nan;0;0
2139;7821;543;0;0;0;0;.00nan;0;0
2139;46790;547;14;19;6;13;.684;2235000;0
2139;150345;547;55;13;1;12;.923;1365000;0
2139;152201;543;99;36;1;35;.972;3600000;0
2199;7821;543;0;0;0;0;.00nan;0;0
2199;46790;547;0;0;0;0;.00nan;0;0
2199;150345;547;89;36;2;34;.944;3600000;0
2199;152201;543;74;25;1;24;.960;3600000;0
2267;7821;543;0;0;0;0;.00nan;0;0
2267;46790;547;53;5;0;5;1.000;1281000;0
2267;150345;547;23;27;7;20;.741;2319000;0
2267;152201;543;85;33;2;31;.939;3600000;0
13845;9216;4337;0;0;0;0;.00nan;0;0
13845;172714;460;0;0;0;0;.00nan;0;0
13845;15558;460;27;22;5;17;.773;3528000;0
13845;92283;4337;77;37;3;34;.919;3600000;0
13846;182561;452;52;33;4;29;.879;3561000;0
13846;177321;452;0;0;0;0;.00nan;0;0
13846;9216;4337;0;0;0;0;.00nan;0;0
13846;92283;4337;100;39;2;37;.949;3600000;0
13847;182543;458;66;20;1;19;.950;1360000;0
13847;187774;2579;0;0;0;0;.00nan;0;0
13847;172723;2579;66;19;1;18;.947;3600000;0
13847;75510;458;47;38;6;32;.842;2240000;0
13848;172079;1086;0;0;0;0;.00nan;0;0
13848;172724;457;0;0;0;0;.00nan;0;0
13848;53830;457;55;28;4;24;.857;3565000;0
13848;85947;1086;97;35;2;33;.943;3600000;0
13849;10565;455;0;0;0;0;.00nan;0;0
13849;15564;456;37;30;6;24;.800;3125000;0
13849;175530;455;75;40;3;37;.925;3600000;0
13849;141635;456;52;3;0;3;1.000;475000;0
13850;187774;2579;0;0;0;0;.00nan;0;0
13850;172723;2579;55;24;3;21;.875;3576000;0
13850;22351;459;95;35;1;34;.971;3600000;0
13850;75464;459;0;0;0;0;.00nan;0;0
13851;172714;460;20;30;7;23;.767;2658000;0
13851;15558;460;34;5;2;3;.600;942000;0
13851;15564;456;37;24;5;19;.792;3600000;0
13851;141635;456;0;0;0;0;.00nan;0;0
13852;9216;4337;0;0;0;0;.00nan;0;0
13852;172714;460;50;30;4;26;.867;3550000;0
13852;15558;460;0;0;0;0;.00nan;0;0
13852;92283;4337;74;30;3;27;.900;3600000;0
13853;172079;1086;0;0;0;0;.00nan;0;0
13853;10565;455;0;0;0;0;.00nan;0;0
13853;175530;455;75;37;3;34;.919;3600000;0
13853;85947;1086;38;25;5;20;.800;3534000;0
13854;9216;4337;57;33;4;29;.879;3600000;0
13854;172714;460;34;27;5;22;.815;3553000;0
13854;15558;460;0;0;0;0;.00nan;0;0
13854;92283;4337;0;0;0;0;.00nan;0;0
13855;182561;452;25;29;7;22;.759;3600000;0
13855;177321;452;0;0;0;0;.00nan;0;0
13855;15564;456;52;26;3;23;.885;3600000;0
13855;141635;456;0;0;0;0;.00nan;0;0
13856;182543;458;0;0;0;0;.00nan;0;0
13856;172724;457;0;0;0;0;.00nan;0;0
13856;53830;457;50;9;1;8;.889;3600000;0
13856;75510;458;60;40;5;35;.875;3600000;0
13857;172724;457;0;0;0;0;.00nan;0;0
13857;22351;459;68;27;3;24;.889;3600000;0
13857;53830;457;63;49;6;43;.878;3600000;0
13857;75464;459;0;0;0;0;.00nan;0;0
13858;182561;452;18;24;6;18;.750;1859000;0
13858;177321;452;14;17;6;11;.647;1741000;0
13858;10565;455;26;17;5;12;.706;3600000;0
13858;175530;455;0;0;0;0;.00nan;0;0
13859;172079;1086;0;0;0;0;.00nan;0;0
13859;9216;4337;0;0;0;0;.00nan;0;0
13859;85947;1086;65;14;1;13;.929;3600000;0
13859;92283;4337;68;40;5;35;.875;3600000;0
13860;182543;458;36;27;6;21;.778;1392000;0
13860;22351;459;50;12;2;10;.833;3600000;0
13860;75464;459;0;0;0;0;.00nan;0;0
13860;75510;458;17;36;8;28;.778;2208000;0
13861;172079;1086;0;0;0;0;.00nan;0;0
13861;9216;4337;47;39;5;34;.872;3600000;0
13861;85947;1086;19;24;7;17;.708;3593000;0
13861;92283;4337;0;0;0;0;.00nan;0;0
13862;182543;458;0;0;0;0;.00nan;0;0
13862;182561;452;17;24;6;18;.750;3600000;0
13862;177321;452;0;0;0;0;.00nan;0;0
13862;75510;458;28;38;7;31;.816;3576000;0
13863;172714;460;24;23;6;17;.739;3163000;0
13863;172724;457;0;0;0;0;.00nan;0;0
13863;15558;460;54;5;0;5;1.000;374000;0
13863;53830;457;49;28;4;24;.857;3600000;0
13864;187774;2579;14;12;5;7;.583;1003000;0
13864;10565;455;0;0;0;0;.00nan;0;0
13864;172723;2579;32;20;4;16;.800;2597000;0
13864;175530;455;76;25;2;23;.920;3600000;0
13865;182561;452;64;23;2;21;.913;1981000;0
13865;177321;452;28;25;6;19;.760;1619000;0
13865;22351;459;48;19;3;16;.842;3600000;0
13865;75464;459;0;0;0;0;.00nan;0;0
13866;172079;1086;0;0;0;0;.00nan;0;0
13866;172714;460;0;0;0;0;.00nan;0;0
13866;15558;460;54;38;5;33;.868;3600000;0
13866;85947;1086;51;28;4;24;.857;3600000;0
13867;10565;455;0;0;0;0;.00nan;0;0
13867;15564;456;76;39;4;35;.897;3600000;0
13867;175530;455;69;38;5;33;.868;3600000;0
13867;141635;456;0;0;0;0;.00nan;0;0
13868;172079;1086;0;0;0;0;.00nan;0;0
13868;172714;460;22;27;7;20;.741;2450000;0
13868;15558;460;14;19;6;13;.684;1150000;0
13868;85947;1086;73;20;2;18;.900;3600000;0
13869;182561;452;35;29;5;24;.828;3600000;0
13869;177321;452;0;0;0;0;.00nan;0;0
13869;187774;2579;0;0;0;0;.00nan;0;0
13869;172723;2579;66;21;2;19;.905;3600000;0
13870;187774;2579;52;35;5;30;.857;3600000;0
13870;9216;4337;0;0;0;0;.00nan;0;0
13870;172723;2579;0;0;0;0;.00nan;0;0
13870;92283;4337;69;23;2;21;.913;3600000;0
13871;172724;457;0;0;0;0;.00nan;0;0
13871;22351;459;61;26;4;22;.846;3600000;0
13871;53830;457;43;40;6;34;.850;3561000;0
13871;75464;459;0;0;0;0;.00nan;0;0
13872;182543;458;63;23;3;20;.870;1495000;0
13872;10565;455;63;18;1;17;.944;3600000;0
13872;175530;455;0;0;0;0;.00nan;0;0
13872;75510;458;62;42;5;37;.881;2105000;0
13873;172724;457;33;37;6;31;.838;3279000;0
13873;22351;459;0;0;0;0;.00nan;0;0
13873;53830;457;58;3;0;3;1.000;321000;0
13873;75464;459;91;38;2;36;.947;3600000;0
13874;182543;458;51;37;5;32;.865;2601000;0
13874;15564;456;55;11;1;10;.909;3600000;0
13874;75510;458;18;8;4;4;.500;999000;0
13874;141635;456;0;0;0;0;.00nan;0;0
13875;182561;452;62;47;5;42;.894;3600000;0
13875;177321;452;0;0;0;0;.00nan;0;0
13875;9216;4337;65;27;2;25;.926;3600000;0
13875;92283;4337;0;0;0;0;.00nan;0;0
13876;172079;1086;0;0;0;0;.00nan;0;0
13876;15564;456;17;31;7;24;.774;2563000;0
13876;85947;1086;53;26;4;22;.846;3600000;0
13876;141635;456;8;8;5;3;.375;1037000;0
13877;182543;458;0;0;0;0;.00nan;0;0
13877;172714;460;54;15;2;13;.867;3600000;0
13877;15558;460;0;0;0;0;.00nan;0;0
13877;75510;458;64;40;4;36;.900;3600000;0
13878;187774;2579;0;0;0;0;.00nan;0;0
13878;172723;2579;68;26;2;24;.923;3600000;0
13878;172724;457;0;0;0;0;.00nan;0;0
13878;53830;457;45;22;3;19;.864;3600000;0
13879;172714;460;11;20;6;14;.700;2724000;0
13879;15558;460;20;11;4;7;.636;876000;0
13879;22351;459;78;32;3;29;.906;3600000;0
13879;75464;459;0;0;0;0;.00nan;0;0
13880;9216;4337;0;0;0;0;.00nan;0;0
13880;10565;455;0;0;0;0;.00nan;0;0
13880;175530;455;68;28;3;25;.893;3600000;0
13880;92283;4337;21;31;7;24;.774;3600000;0
13881;172714;460;54;47;6;41;.872;3600000;0
13881;172724;457;0;0;0;0;.00nan;0;0
13881;15558;460;0;0;0;0;.00nan;0;0
13881;53830;457;49;29;4;25;.862;3600000;0
13882;182543;458;44;33;5;28;.848;2753000;0
13882;10565;455;0;0;0;0;.00nan;0;0
13882;175530;455;59;21;3;18;.857;3600000;0
13882;75510;458;32;18;4;14;.778;847000;0
13883;187774;2579;32;16;4;12;.750;3600000;0
13883;9216;4337;0;0;0;0;.00nan;0;0
13883;172723;2579;0;0;0;0;.00nan;0;0
13883;92283;4337;46;33;5;28;.848;3547000;0
13884;182561;452;58;29;4;25;.862;3573000;0
13884;177321;452;0;0;0;0;.00nan;0;0
13884;15564;456;0;0;0;0;.00nan;0;0
13884;141635;456;83;40;3;37;.925;3600000;0
13885;10565;455;66;35;3;32;.914;3600000;0
13885;22351;459;28;23;5;18;.783;3596000;0
13885;175530;455;0;0;0;0;.00nan;0;0
13885;75464;459;0;0;0;0;.00nan;0;0
13886;182543;458;0;0;0;0;.00nan;0;0
13886;22351;459;43;17;3;14;.824;3600000;0
13886;75464;459;0;0;0;0;.00nan;0;0
13886;75510;458;18;34;8;26;.765;3600000;0
13887;182543;458;80;51;4;47;.922;3600000;0
13887;172079;1086;65;16;1;15;.938;3600000;0
13887;75510;458;0;0;0;0;.00nan;0;0
13887;85947;1086;0;0;0;0;.00nan;0;0
13888;182561;452;74;48;5;43;.896;3600000;0
13888;177321;452;0;0;0;0;.00nan;0;0
13888;10565;455;0;0;0;0;.00nan;0;0
13888;175530;455;20;27;7;20;.741;3556000;0
13889;172724;457;0;0;0;0;.00nan;0;0
13889;22351;459;0;0;0;0;.00nan;0;0
13889;53830;457;43;19;3;16;.842;3552000;0
13889;75464;459;81;25;1;24;.960;3600000;0
13890;187774;2579;0;0;0;0;.00nan;0;0
13890;172714;460;60;13;1;12;.923;3600000;0
13890;172723;2579;44;25;4;21;.840;3600000;0
13890;15558;460;0;0;0;0;.00nan;0;0
13891;9216;4337;0;0;0;0;.00nan;0;0
13891;15564;456;25;24;6;18;.750;3600000;0
13891;92283;4337;83;31;2;29;.935;3600000;0
13891;141635;456;0;0;0;0;.00nan;0;0
13892;182543;458;0;0;0;0;.00nan;0;0
13892;172724;457;57;10;1;9;.900;3600000;0
13892;53830;457;0;0;0;0;.00nan;0;0
13892;75510;458;44;51;7;44;.863;3600000;0
13893;182561;452;81;30;1;29;.967;3600000;0
13893;177321;452;0;0;0;0;.00nan;0;0
13893;172714;460;51;29;4;25;.862;3600000;0
13893;15558;460;0;0;0;0;.00nan;0;0
13894;182543;458;0;0;0;0;.00nan;0;0
13894;15564;456;42;10;2;8;.800;3600000;0
13894;75510;458;76;43;4;39;.907;3549000;0
13894;141635;456;0;0;0;0;.00nan;0;0
13895;187774;2579;0;0;0;0;.00nan;0;0
13895;172079;1086;0;0;0;0;.00nan;0;0
13895;172723;2579;25;22;5;17;.773;3569000;0
13895;85947;1086;48;28;4;24;.857;3600000;0
13896;9216;4337;0;0;0;0;.00nan;0;0
13896;172724;457;0;0;0;0;.00nan;0;0
13896;53830;457;66;28;3;25;.893;3600000;0
13896;92283;4337;58;38;5;33;.868;3530000;0
13897;15564;456;0;0;0;0;.00nan;0;0
13897;22351;459;50;14;2;12;.857;3600000;0
13897;75464;459;0;0;0;0;.00nan;0;0
13897;141635;456;79;41;3;38;.927;3556000;0
13898;172079;1086;59;34;5;29;.853;3618000;0
13898;10565;455;0;0;0;0;.00nan;0;0
13898;175530;455;67;36;4;32;.889;3618000;0
13898;85947;1086;0;0;0;0;.00nan;0;0
13899;182561;452;55;3;0;3;1.000;684000;0
13899;177321;452;28;29;6;23;.793;2916000;0
13899;172714;460;47;7;1;6;.857;745000;0
13899;15558;460;7;15;6;9;.600;2855000;0
13900;172079;1086;0;0;0;0;.00nan;0;0
13900;9216;4337;0;0;0;0;.00nan;0;0
13900;85947;1086;56;22;2;20;.909;3900000;0
13900;92283;4337;90;40;2;38;.950;3900000;0
13901;182543;458;55;6;0;6;1.000;426000;0
13901;172714;460;89;17;0;17;1.000;3600000;0
13901;15558;460;0;0;0;0;.00nan;0;0
13901;75510;458;56;50;6;44;.880;3174000;0
13902;182561;452;73;43;4;39;.907;3600000;0
13902;177321;452;0;0;0;0;.00nan;0;0
13902;22351;459;34;22;5;17;.773;3547000;0
13902;75464;459;0;0;0;0;.00nan;0;0
13903;187774;2579;45;27;4;23;.852;3600000;0
13903;172723;2579;0;0;0;0;.00nan;0;0
13903;172724;457;56;12;1;11;.917;1317000;0
13903;53830;457;35;29;5;24;.828;2256000;0
13904;187774;2579;0;0;0;0;.00nan;0;0
13904;172723;2579;59;39;5;34;.872;3900000;0
13904;22351;459;0;0;0;0;.00nan;0;0
13904;75464;459;43;33;5;28;.848;3900000;0
13905;10565;455;76;22;1;21;.955;2668000;0
13905;172724;457;40;8;2;6;.750;272000;0
13905;175530;455;20;8;4;4;.500;932000;0
13905;53830;457;19;35;8;27;.771;3328000;0
13906;172079;1086;49;22;3;19;.864;3655000;0
13906;9216;4337;55;33;4;29;.879;3655000;0
13906;85947;1086;0;0;0;0;.00nan;0;0
13906;92283;4337;0;0;0;0;.00nan;0;0
13907;182543;458;39;15;3;12;.800;870000;0
13907;15564;456;28;14;4;10;.714;3600000;0
13907;75510;458;37;31;6;25;.806;2730000;0
13907;141635;456;0;0;0;0;.00nan;0;0
13908;182543;458;0;0;0;0;.00nan;0;0
13908;9216;4337;0;0;0;0;.00nan;0;0
13908;75510;458;46;41;6;35;.854;3596000;0
13908;92283;4337;21;15;5;10;.667;3600000;0
13909;172079;1086;0;0;0;0;.00nan;0;0
13909;172714;460;62;32;3;29;.906;3900000;0
13909;15558;460;0;0;0;0;.00nan;0;0
13909;85947;1086;54;22;3;19;.864;3900000;0
13910;182561;452;38;39;6;33;.846;3356000;0
13910;177321;452;50;2;0;2;1.000;208000;0
13910;187774;2579;0;0;0;0;.00nan;0;0
13910;172723;2579;31;16;4;12;.750;3600000;0
13911;172724;457;0;0;0;0;.00nan;0;0
13911;15564;456;70;26;2;24;.923;3600000;0
13911;53830;457;62;36;4;32;.889;3575000;0
13911;141635;456;0;0;0;0;.00nan;0;0
13912;182543;458;0;0;0;0;.00nan;0;0
13912;182561;452;0;0;0;0;.00nan;0;0
13912;177321;452;36;29;5;24;.828;3600000;0
13912;75510;458;16;40;9;31;.775;3600000;0
13913;187774;2579;48;31;5;26;.839;3900000;0
13913;9216;4337;0;0;0;0;.00nan;0;0
13913;172723;2579;0;0;0;0;.00nan;0;0
13913;92283;4337;34;23;5;18;.783;3900000;0
13914;172079;1086;100;43;2;41;.953;3600000;0
13914;172714;460;48;0;0;0;.00nan;365000;0
13914;15558;460;29;25;6;19;.760;3235000;0
13914;85947;1086;0;0;0;0;.00nan;0;0
13915;10565;455;0;0;0;0;.00nan;0;0
13915;172724;457;23;10;4;6;.600;1056000;0
13915;175530;455;38;37;6;31;.838;3600000;0
13915;53830;457;16;19;6;13;.684;2544000;0
13916;182543;458;53;2;0;2;1.000;488000;0
13916;22351;459;56;20;2;18;.900;3600000;0
13916;75464;459;0;0;0;0;.00nan;0;0
13916;75510;458;34;38;7;31;.816;3112000;0
13917;172714;460;59;24;4;20;.833;3600000;0
13917;10565;455;0;0;0;0;.00nan;0;0
13917;15558;460;0;0;0;0;.00nan;0;0
13917;175530;455;92;34;1;33;.971;3600000;0
13918;182543;458;60;33;4;29;.879;3600000;0
13918;9216;4337;0;0;0;0;.00nan;0;0
13918;75510;458;0;0;0;0;.00nan;0;0
13918;92283;4337;15;25;7;18;.720;3600000;0
13919;187774;2579;0;0;0;0;.00nan;0;0
13919;172079;1086;0;0;0;0;.00nan;0;0
13919;172723;2579;47;36;5;31;.861;3600000;0
13919;85947;1086;28;31;7;24;.774;3596000;0
13920;182561;452;58;24;3;21;.875;3600000;0
13920;177321;452;0;0;0;0;.00nan;0;0
13920;172724;457;0;0;0;0;.00nan;0;0
13920;53830;457;66;40;5;35;.875;3566000;0
13921;9216;4337;33;36;6;30;.833;3310000;0
13921;22351;459;60;33;4;29;.879;3600000;0
13921;75464;459;0;0;0;0;.00nan;0;0
13921;92283;4337;52;3;0;3;1.000;256000;0
13922;172079;1086;39;32;6;26;.813;3600000;0
13922;15564;456;63;22;2;20;.909;3600000;0
13922;85947;1086;0;0;0;0;.00nan;0;0
13922;141635;456;0;0;0;0;.00nan;0;0
13923;9216;4337;0;0;0;0;.00nan;0;0
13923;22351;459;68;23;2;21;.913;3600000;0
13923;75464;459;0;0;0;0;.00nan;0;0
13923;92283;4337;78;40;3;37;.925;3600000;0
13924;172079;1086;0;0;0;0;.00nan;0;0
13924;172724;457;0;0;0;0;.00nan;0;0
13924;53830;457;23;31;7;24;.774;3532000;0
13924;85947;1086;42;26;5;21;.808;3600000;0
13925;182561;452;70;33;3;30;.909;3573000;0
13925;177321;452;0;0;0;0;.00nan;0;0
13925;172714;460;59;21;2;19;.905;3600000;0
13925;15558;460;0;0;0;0;.00nan;0;0
13926;187774;2579;0;0;0;0;.00nan;0;0
13926;172723;2579;50;18;3;15;.833;3900000;0
13926;15564;456;74;33;3;30;.909;3900000;0
13926;141635;456;0;0;0;0;.00nan;0;0
13927;182543;458;38;7;2;5;.714;691000;0
13927;10565;455;28;16;4;12;.750;3600000;0
13927;175530;455;0;0;0;0;.00nan;0;0
13927;75510;458;56;47;6;41;.872;2909000;0
13928;9216;4337;0;0;0;0;.00nan;0;0
13928;15564;456;40;26;5;21;.808;3553000;0
13928;92283;4337;54;30;4;26;.867;3600000;0
13928;141635;456;0;0;0;0;.00nan;0;0
13929;182543;458;0;0;0;0;.00nan;0;0
13929;187774;2579;50;21;3;18;.857;3589000;0
13929;172723;2579;0;0;0;0;.00nan;0;0
13929;75510;458;100;36;1;35;.972;3600000;0
13930;182561;452;0;0;0;0;.00nan;0;0
13930;177321;452;60;43;5;38;.884;3600000;0
13930;172714;460;0;0;0;0;.00nan;0;0
13930;15558;460;72;28;2;26;.929;3600000;0
13931;10565;455;0;0;0;0;.00nan;0;0
13931;22351;459;86;46;4;42;.913;3900000;0
13931;175530;455;80;43;4;39;.907;3891000;0
13931;75464;459;0;0;0;0;.00nan;0;0
13932;172714;460;25;13;4;9;.692;948000;0
13932;15558;460;47;22;3;19;.864;2652000;0
13932;22351;459;38;23;4;19;.826;3600000;0
13932;75464;459;0;0;0;0;.00nan;0;0
13933;182561;452;36;40;7;33;.825;3600000;0
13933;177321;452;0;0;0;0;.00nan;0;0
13933;172079;1086;0;0;0;0;.00nan;0;0
13933;85947;1086;46;25;4;21;.840;3600000;0
13934;182543;458;0;0;0;0;.00nan;0;0
13934;172724;457;0;0;0;0;.00nan;0;0
13934;53830;457;55;21;3;18;.857;3600000;0
13934;75510;458;35;35;7;28;.800;3600000;0
13935;187774;2579;0;0;0;0;.00nan;0;0
13935;172723;2579;83;25;1;24;.960;3600000;0
13935;15564;456;0;0;0;0;.00nan;0;0
13935;141635;456;43;33;6;27;.818;3600000;0
13936;182561;452;0;0;0;0;.00nan;0;0
13936;177321;452;46;28;4;24;.857;3600000;0
13936;172079;1086;33;21;5;16;.762;3600000;0
13936;85947;1086;0;0;0;0;.00nan;0;0
13937;182543;458;0;0;0;0;.00nan;0;0
13937;172724;457;75;11;0;11;1.000;3600000;0
13937;53830;457;0;0;0;0;.00nan;0;0
13937;75510;458;42;37;6;31;.838;3600000;0
13938;15564;456;70;30;3;27;.900;3600000;0
13938;22351;459;56;32;4;28;.875;3600000;0
13938;75464;459;0;0;0;0;.00nan;0;0
13938;141635;456;0;0;0;0;.00nan;0;0
13939;10565;455;0;0;0;0;.00nan;0;0
13939;15564;456;6;26;8;18;.692;3600000;0
13939;175530;455;41;19;4;15;.789;3600000;0
13939;141635;456;0;0;0;0;.00nan;0;0
13940;187774;2579;0;0;0;0;.00nan;0;0
13940;172079;1086;0;0;0;0;.00nan;0;0
13940;172723;2579;48;32;4;28;.875;3600000;0
13940;85947;1086;32;25;6;19;.760;3591000;0
13941;182561;452;72;22;1;21;.955;3600000;0
13941;177321;452;0;0;0;0;.00nan;0;0
13941;172724;457;58;25;3;22;.880;3557000;0
13941;53830;457;0;0;0;0;.00nan;0;0
13942;10565;455;99;46;2;44;.957;3600000;0
13942;22351;459;49;39;5;34;.872;3600000;0
13942;175530;455;0;0;0;0;.00nan;0;0
13942;75464;459;0;0;0;0;.00nan;0;0
13943;187774;2579;0;0;0;0;.00nan;0;0
13943;172079;1086;93;21;0;21;1.000;3600000;0
13943;172723;2579;48;34;4;30;.882;3600000;0
13943;85947;1086;0;0;0;0;.00nan;0;0
13944;15564;456;48;21;3;18;.857;3600000;0
13944;22351;459;39;33;6;27;.818;3600000;0
13944;75464;459;0;0;0;0;.00nan;0;0
13944;141635;456;0;0;0;0;.00nan;0;0
13945;182543;458;66;14;1;13;.929;1223000;0
13945;22351;459;86;14;0;14;1.000;3600000;0
13945;75464;459;0;0;0;0;.00nan;0;0
13945;75510;458;32;29;6;23;.793;2377000;0
13946;172714;460;55;26;3;23;.885;3600000;0
13946;172723;2579;33;27;6;21;.778;3600000;0
13946;15558;460;0;0;0;0;.00nan;0;0
13946;22349;2579;0;0;0;0;.00nan;0;0
13947;182561;452;98;21;0;21;1.000;3600000;0
13947;177321;452;0;0;0;0;.00nan;0;0
13947;9216;4337;66;21;1;20;.952;3545000;0
13947;92283;4337;0;0;0;0;.00nan;0;0
13948;182543;458;36;26;5;21;.808;2273000;0
13948;10565;455;0;0;0;0;.00nan;0;0
13948;175530;455;63;21;2;19;.905;3600000;0
13948;75510;458;7;21;7;14;.667;1327000;0
13949;172724;457;0;0;0;0;.00nan;0;0
13949;15564;456;30;22;5;17;.773;3600000;0
13949;53830;457;78;31;2;29;.935;3600000;0
13949;141635;456;0;0;0;0;.00nan;0;0
13950;10565;455;48;31;5;26;.839;3600000;0
13950;22351;459;58;33;4;29;.879;3600000;0
13950;175530;455;0;0;0;0;.00nan;0;0
13950;75464;459;0;0;0;0;.00nan;0;0
13951;172714;460;0;0;0;0;.00nan;0;0
13951;172723;2579;46;29;5;24;.828;3600000;0
13951;15558;460;55;15;2;13;.867;3600000;0
13951;22349;2579;0;0;0;0;.00nan;0;0
13952;172724;457;75;34;3;31;.912;3632000;0
13952;15564;456;74;23;2;21;.913;3632000;0
13952;53830;457;0;0;0;0;.00nan;0;0
13952;141635;456;0;0;0;0;.00nan;0;0
13953;9216;4337;49;15;2;13;.867;1769000;0
13953;172724;457;0;0;0;0;.00nan;0;0
13953;53830;457;71;25;2;23;.920;3600000;0
13953;92283;4337;20;22;6;16;.727;1831000;0
13954;10565;455;0;0;0;0;.00nan;0;0
13954;15564;456;53;27;4;23;.852;3600000;0
13954;175530;455;54;17;2;15;.882;3600000;0
13954;141635;456;0;0;0;0;.00nan;0;0
13955;9216;4337;65;41;4;37;.902;3600000;0
13955;10565;455;31;23;5;18;.783;3558000;0
13955;175530;455;0;0;0;0;.00nan;0;0
13955;92283;4337;0;0;0;0;.00nan;0;0
13956;182543;458;0;0;0;0;.00nan;0;0
13956;172079;1086;38;15;4;11;.733;3600000;0
13956;75510;458;55;65;8;57;.877;3600000;0
13956;85947;1086;0;0;0;0;.00nan;0;0
13957;182561;452;52;29;4;25;.862;3592000;0
13957;177321;452;0;0;0;0;.00nan;0;0
13957;172723;2579;66;25;2;23;.920;3600000;0
13957;22349;2579;0;0;0;0;.00nan;0;0
13958;172079;1086;0;0;0;0;.00nan;0;0
13958;22351;459;0;0;0;0;.00nan;0;0
13958;75464;459;79;34;3;31;.912;3600000;0
13958;85947;1086;57;36;4;32;.889;3543000;0
13959;187774;2579;70;26;2;24;.923;3900000;0
13959;172714;460;0;0;0;0;.00nan;0;0
13959;172723;2579;0;0;0;0;.00nan;0;0
13959;15558;460;61;25;2;23;.920;3900000;0
13960;172724;457;0;0;0;0;.00nan;0;0
13960;15564;456;0;0;0;0;.00nan;0;0
13960;53830;457;60;22;2;20;.909;3600000;0
13960;141635;456;74;32;3;29;.906;3543000;0
13961;9216;4337;49;29;4;25;.862;3600000;0
13961;172714;460;41;28;5;23;.821;3562000;0
13961;15558;460;0;0;0;0;.00nan;0;0
13961;92283;4337;0;0;0;0;.00nan;0;0
13962;187774;2579;0;0;0;0;.00nan;0;0
13962;10565;455;0;0;0;0;.00nan;0;0
13962;172723;2579;18;29;7;22;.759;3544000;0
13962;175530;455;46;36;6;30;.833;3600000;0
13963;182561;452;37;32;6;26;.813;2374000;0
13963;177321;452;30;17;4;13;.765;1226000;0
13963;172079;1086;0;0;0;0;.00nan;0;0
13963;85947;1086;35;26;5;21;.808;3600000;0
13964;187774;2579;54;28;4;24;.857;3600000;0
13964;9216;4337;0;0;0;0;.00nan;0;0
13964;172723;2579;0;0;0;0;.00nan;0;0
13964;92283;4337;27;28;6;22;.786;3567000;0
13965;182543;458;0;0;0;0;.00nan;0;0
13965;15564;456;57;17;1;16;.941;3600000;0
13965;75510;458;22;42;8;34;.810;3600000;0
13965;141635;456;0;0;0;0;.00nan;0;0
13966;15564;456;0;0;0;0;.00nan;0;0
13966;22351;459;84;36;2;34;.944;3600000;0
13966;75464;459;0;0;0;0;.00nan;0;0
13966;141635;456;59;28;4;24;.857;3530000;0
13967;182561;452;82;46;3;43;.935;3583000;0
13967;177321;452;0;0;0;0;.00nan;0;0
13967;172079;1086;72;23;2;21;.913;3600000;0
13967;85947;1086;0;0;0;0;.00nan;0;0
13968;172714;460;37;29;5;24;.828;3900000;0
13968;10565;455;28;13;4;9;.692;2298000;0
13968;15558;460;0;0;0;0;.00nan;0;0
13968;175530;455;57;10;1;9;.900;1601000;0
13969;172079;1086;0;0;0;0;.00nan;0;0
13969;22351;459;51;33;4;29;.879;3713000;0
13969;75464;459;0;0;0;0;.00nan;0;0
13969;85947;1086;35;25;5;20;.800;3713000;0
13970;172714;460;0;0;0;0;.00nan;0;0
13970;15558;460;50;29;4;25;.862;3600000;0
13970;15564;456;44;29;5;24;.828;3570000;0
13970;141635;456;0;0;0;0;.00nan;0;0
13971;182561;452;0;0;0;0;.00nan;0;0
13971;177321;452;34;23;4;19;.826;3600000;0
13971;9216;4337;0;0;0;0;.00nan;0;0
13971;92283;4337;95;36;2;34;.944;3600000;0
13972;182561;452;28;36;7;29;.806;3057000;0
13972;177321;452;55;4;0;4;1.000;543000;0
13972;187774;2579;0;0;0;0;.00nan;0;0
13972;172723;2579;70;26;1;25;.962;3600000;0
13973;10565;455;0;0;0;0;.00nan;0;0
13973;172724;457;0;0;0;0;.00nan;0;0
13973;175530;455;56;26;3;23;.885;3557000;0
13973;53830;457;75;29;2;27;.931;3600000;0
13974;10565;455;43;27;4;23;.852;3551000;0
13974;172724;457;79;26;2;24;.923;3600000;0
13974;175530;455;0;0;0;0;.00nan;0;0
13974;53830;457;0;0;0;0;.00nan;0;0
13976;182561;452;34;32;6;26;.813;2304000;0
13976;177321;452;62;11;0;11;1.000;1296000;0
13976;15564;456;88;28;1;27;.964;3600000;0
13976;141635;456;0;0;0;0;.00nan;0;0
13978;187774;2579;0;0;0;0;.00nan;0;0
13978;172723;2579;77;25;1;24;.960;3600000;0
13978;22351;459;43;23;4;19;.826;3600000;0
13978;75464;459;0;0;0;0;.00nan;0;0
13980;172079;1086;0;0;0;0;.00nan;0;0
13980;172724;457;0;0;0;0;.00nan;0;0
13980;53830;457;36;13;3;10;.769;3600000;0
13980;85947;1086;56;50;7;43;.860;3600000;0
13982;182543;458;0;0;0;0;.00nan;0;0
13982;10565;455;59;21;2;19;.905;3782000;0
13982;22349;455;0;0;0;0;.00nan;0;0
13982;75510;458;94;53;3;50;.943;3782000;0
13984;9216;4337;0;0;0;0;.00nan;0;0
13984;172714;460;55;17;2;15;.882;3600000;0
13984;15558;460;0;0;0;0;.00nan;0;0
13984;92283;4337;75;35;3;32;.914;3600000;0
13986;172079;1086;0;0;0;0;.00nan;0;0
13986;172714;460;0;0;0;0;.00nan;0;0
13986;15558;460;34;25;5;20;.800;3598000;0
13986;85947;1086;66;33;4;29;.879;3600000;0
13988;9216;4337;0;0;0;0;.00nan;0;0
13988;22351;459;71;25;1;24;.960;3600000;0
13988;75464;459;0;0;0;0;.00nan;0;0
13988;92283;4337;59;43;6;37;.860;3600000;0
13990;187774;2579;67;25;2;23;.920;3600000;0
13990;172723;2579;0;0;0;0;.00nan;0;0
13990;15564;456;35;38;6;32;.842;3600000;0
13990;141635;456;0;0;0;0;.00nan;0;0
13992;182561;452;86;52;4;48;.923;3600000;0
13992;177321;452;0;0;0;0;.00nan;0;0
13992;10565;455;30;20;5;15;.750;3600000;0
13992;22349;455;0;0;0;0;.00nan;0;0
13994;182543;458;78;41;4;37;.902;2481000;0
13994;172724;457;0;0;0;0;.00nan;0;0
13994;53830;457;57;19;2;17;.895;3600000;0
13994;75510;458;33;18;4;14;.778;1119000;0
13996;187774;2579;0;0;0;0;.00nan;0;0
13996;172723;2579;38;31;5;26;.839;3600000;0
13996;15564;456;0;0;0;0;.00nan;0;0
13996;141635;456;100;27;0;27;1.000;3600000;0
13998;182543;458;0;0;0;0;.00nan;0;0
13998;182561;452;0;0;0;0;.00nan;0;0
13998;177321;452;68;26;2;24;.923;3600000;0
13998;75510;458;54;39;5;34;.872;3600000;0
14000;9216;4337;28;29;6;23;.793;2968000;0
14000;172714;460;27;20;5;15;.750;3600000;0
14000;15558;460;0;0;0;0;.00nan;0;0
14000;92283;4337;47;6;1;5;.833;553000;0
14002;10565;455;0;0;0;0;.00nan;0;0
14002;172724;457;0;0;0;0;.00nan;0;0
14002;22349;455;31;37;7;30;.811;3515000;0
14002;53830;457;32;23;5;18;.783;3600000;0
14004;172079;1086;20;28;7;21;.750;1790000;0
14004;22351;459;0;0;0;0;.00nan;0;0
14004;75464;459;34;26;5;21;.808;3600000;0
14004;85947;1086;29;17;4;13;.765;1810000;0
14006;172079;1086;0;0;0;0;.00nan;0;0
14006;10565;455;36;28;5;23;.821;3582000;0
14006;22349;455;0;0;0;0;.00nan;0;0
14006;85947;1086;50;18;3;15;.833;3600000;0
14008;9216;4337;0;0;0;0;.00nan;0;0
14008;22351;459;75;19;1;18;.947;3600000;0
14008;75464;459;0;0;0;0;.00nan;0;0
14008;92283;4337;63;49;6;43;.878;3600000;0
14010;172714;460;0;0;0;0;.00nan;0;0
14010;15558;460;37;25;5;20;.800;3600000;0
14010;15564;456;32;11;3;8;.727;1951000;0
14010;141635;456;13;22;7;15;.682;1649000;0
14012;182543;458;61;9;0;9;1.000;558000;0
14012;187774;2579;54;16;2;14;.875;3600000;0
14012;172723;2579;0;0;0;0;.00nan;0;0
14012;75510;458;47;43;7;36;.837;3042000;0
14014;182561;452;36;22;4;18;.818;3600000;0
14014;177321;452;0;0;0;0;.00nan;0;0
14014;172724;457;0;0;0;0;.00nan;0;0
14014;53830;457;75;27;2;25;.926;3600000;0
762;10565;455;0;0;0;0;.00nan;0;0
762;15564;456;42;38;6;32;.842;3600000;0
762;175530;455;26;18;5;13;.722;3600000;0
762;141635;456;0;0;0;0;.00nan;0;0
763;187774;2579;0;0;0;0;.00nan;0;0
763;9216;4337;0;0;0;0;.00nan;0;0
763;172723;2579;49;39;6;33;.846;3600000;0
763;92283;4337;76;40;3;37;.925;3600000;0
776;10565;455;0;0;0;0;.00nan;0;0
776;22351;459;25;29;6;23;.793;2706000;0
776;175530;455;67;30;3;27;.900;3600000;0
776;75464;459;49;6;1;5;.833;894000;0
777;172079;1086;0;0;0;0;.00nan;0;0
777;9216;4337;0;0;0;0;.00nan;0;0
777;85947;1086;53;18;3;15;.833;3633000;0
777;92283;4337;99;37;2;35;.946;3633000;0
852;9216;4337;74;17;0;17;1.000;1457000;0
852;10565;455;0;0;0;0;.00nan;0;0
852;175530;455;61;21;2;19;.905;3600000;0
852;92283;4337;27;23;5;18;.783;2143000;0
14015;166423;4998;0;0;0;0;.00nan;0;0
14015;-1;4998;57;35;5;30;.857;4084000;0
14015;175712;4992;0;0;0;0;.00nan;0;0
14015;86268;4992;53;37;4;33;.892;4070000;0
14016;161583;4715;0;0;0;0;.00nan;0;0
14016;163528;165;72;36;3;33;.917;3563000;0
14016;36221;4715;74;25;2;23;.920;3600000;0
14016;46785;165;0;0;0;0;.00nan;0;0
14017;166423;4998;0;0;0;0;.00nan;0;0
14017;-1;4998;64;26;2;24;.923;3600000;0
14017;175712;4992;64;29;3;26;.897;2546000;0
14017;86268;4992;29;15;4;11;.733;1054000;0
14018;161583;4715;56;18;2;16;.889;1010000;0
14018;163528;165;59;20;3;17;.850;3600000;0
14018;36221;4715;21;28;7;21;.750;2590000;0
14018;46785;165;0;0;0;0;.00nan;0;0
14019;-1;4997;54;23;3;20;.870;3586000;0
14019;181874;4997;0;0;0;0;.00nan;0;0
14019;38037;4714;90;36;2;34;.944;3600000;0
14019;161128;4714;0;0;0;0;.00nan;0;0
14020;163528;165;49;32;5;27;.844;3600000;0
14020;175712;4992;38;9;2;7;.778;1290000;0
14020;46785;165;0;0;0;0;.00nan;0;0
14020;86268;4992;37;40;6;34;.850;2310000;0
14021;179411;4919;0;0;0;0;.00nan;0;0
14021;176060;1368;18;20;6;14;.700;2256000;0
14021;55660;1368;49;14;2;12;.857;1344000;0
14021;149889;4919;49;34;5;29;.853;3600000;0
14022;161583;4715;74;26;1;25;.962;3328000;0
14022;166423;4998;0;0;0;0;.00nan;0;0
14022;-1;4998;69;28;2;26;.929;3600000;0
14022;36221;4715;22;11;4;7;.636;272000;0
14023;-1;4997;26;27;6;21;.778;2771000;0
14023;181874;4997;44;4;1;3;.750;829000;0
14023;38037;4714;100;29;0;29;1.000;3600000;0
14023;161128;4714;0;0;0;0;.00nan;0;0
14024;161583;4715;0;0;0;0;.00nan;0;0
14024;166423;4998;77;26;3;23;.885;3600000;0
14024;-1;4998;0;0;0;0;.00nan;0;0
14024;36221;4715;49;35;4;31;.886;3548000;0
14025;163528;165;0;0;0;0;.00nan;0;0
14025;175712;4992;64;23;2;21;.913;3600000;0
14025;46785;165;87;28;1;27;.964;3600000;0
14025;86268;4992;0;0;0;0;.00nan;0;0
14026;179411;4919;0;0;0;0;.00nan;0;0
14026;176060;1368;84;38;2;36;.947;3600000;0
14026;55660;1368;0;0;0;0;.00nan;0;0
14026;149889;4919;24;40;8;32;.800;3600000;0
14027;166423;4998;0;0;0;0;.00nan;0;0
14027;-1;4998;60;31;4;27;.871;4200000;0
14027;175712;4992;0;0;0;0;.00nan;0;0
14027;86268;4992;74;49;4;45;.918;4200000;0
14028;165532;4246;42;9;2;7;.778;1122000;0
14028;-1;4839;0;0;0;0;.00nan;0;0
14028;182097;4839;64;33;3;30;.909;3600000;0
14028;39981;4246;29;22;6;16;.727;2478000;0
14029;166423;4998;39;29;5;24;.828;3768000;0
14029;-1;4998;0;0;0;0;.00nan;0;0
14029;175712;4992;76;42;4;38;.905;3768000;0
14029;86268;4992;0;0;0;0;.00nan;0;0
14030;176060;1368;36;47;8;39;.830;3600000;0
14030;-1;4997;0;0;0;0;.00nan;0;0
14030;181874;4997;26;15;4;11;.733;3600000;0
14030;55660;1368;0;0;0;0;.00nan;0;0
14031;163528;165;56;26;4;22;.846;3600000;0
14031;-1;4991;0;0;0;0;.00nan;0;0
14031;46785;165;0;0;0;0;.00nan;0;0
14031;78820;4991;45;36;5;31;.861;3545000;0
14032;179411;4919;69;41;4;37;.902;3578000;0
14032;38037;4714;56;24;3;21;.875;3600000;0
14032;149889;4919;0;0;0;0;.00nan;0;0
14032;161128;4714;0;0;0;0;.00nan;0;0
14033;165532;4246;0;0;0;0;.00nan;0;0
14033;-1;4839;22;34;8;26;.765;3600000;0
14033;182097;4839;0;0;0;0;.00nan;0;0
14033;39981;4246;67;24;2;22;.917;3600000;0
14034;179411;4919;0;0;0;0;.00nan;0;0
14034;38037;4714;0;0;0;0;.00nan;0;0
14034;149889;4919;83;46;4;42;.913;3543000;0
14034;161128;4714;46;19;3;16;.842;3600000;0
14035;163528;165;55;4;0;4;1.000;306000;0
14035;-1;4991;0;0;0;0;.00nan;0;0
14035;46785;165;33;33;6;27;.818;3294000;0
14035;78820;4991;69;18;1;17;.944;3600000;0
14036;176060;1368;0;0;0;0;.00nan;0;0
14036;-1;4997;36;32;6;26;.813;3547000;0
14036;181874;4997;0;0;0;0;.00nan;0;0
14036;55660;1368;71;42;5;37;.881;3600000;0
14037;161583;4715;34;4;2;2;.500;1165000;0
14037;175712;4992;0;0;0;0;.00nan;0;0
14037;36221;4715;17;24;6;18;.750;2435000;0
14037;86268;4992;66;39;5;34;.872;3600000;0
14038;165532;4246;57;33;4;29;.879;3600000;0
14038;-1;4839;0;0;0;0;.00nan;0;0
14038;182097;4839;50;46;7;39;.848;3600000;0
14038;39981;4246;0;0;0;0;.00nan;0;0
14039;166423;4998;0;0;0;0;.00nan;0;0
14039;-1;4998;100;42;0;42;1.000;3600000;0
14039;38037;4714;49;24;3;21;.875;3600000;0
14039;161128;4714;0;0;0;0;.00nan;0;0
14040;-1;4991;0;0;0;0;.00nan;0;0
14040;179411;4919;34;39;6;33;.846;3600000;0
14040;78820;4991;51;19;2;17;.895;3600000;0
14040;149889;4919;0;0;0;0;.00nan;0;0
14041;161583;4715;0;0;0;0;.00nan;0;0
14041;163528;165;38;42;8;34;.810;3592000;0
14041;36221;4715;38;33;6;27;.818;3600000;0
14041;46785;165;0;0;0;0;.00nan;0;0
14042;165532;4246;0;0;0;0;.00nan;0;0
14042;176060;1368;57;34;4;30;.882;3600000;0
14042;39981;4246;65;47;6;41;.872;3552000;0
14042;55660;1368;0;0;0;0;.00nan;0;0
14043;-1;4991;66;26;2;24;.923;3600000;0
14043;179411;4919;0;0;0;0;.00nan;0;0
14043;78820;4991;0;0;0;0;.00nan;0;0
14043;149889;4919;62;37;5;32;.865;3600000;0
14044;166423;4998;0;0;0;0;.00nan;0;0
14044;-1;4998;78;23;1;22;.957;3600000;0
14044;38037;4714;0;0;0;0;.00nan;0;0
14044;161128;4714;33;25;5;20;.800;3600000;0
14045;163528;165;0;0;0;0;.00nan;0;0
14045;175712;4992;0;0;0;0;.00nan;0;0
14045;46785;165;61;27;4;23;.852;3820000;0
14045;86268;4992;70;38;3;35;.921;3820000;0
14046;165532;4246;0;0;0;0;.00nan;0;0
14046;-1;4839;0;0;0;0;.00nan;0;0
14046;182097;4839;59;29;3;26;.897;3600000;0
14046;39981;4246;51;40;7;33;.825;3600000;0
14047;-1;4991;0;0;0;0;.00nan;0;0
14047;175712;4992;0;0;0;0;.00nan;0;0
14047;78820;4991;49;28;4;24;.857;3600000;0
14047;86268;4992;87;26;1;25;.962;3600000;0
14048;161583;4715;66;25;3;22;.880;3054000;0
14048;166423;4998;26;35;7;28;.800;2955000;0
14048;-1;4998;15;7;4;3;.429;645000;0
14048;36221;4715;32;8;3;5;.625;546000;0
14049;179411;4919;85;30;1;29;.967;3600000;0
14049;176060;1368;56;44;5;39;.886;3600000;0
14049;55660;1368;0;0;0;0;.00nan;0;0
14049;149889;4919;0;0;0;0;.00nan;0;0
14050;-1;4997;0;0;0;0;.00nan;0;0
14050;181874;4997;58;22;3;19;.864;3600000;0
14050;38037;4714;75;53;6;47;.887;3600000;0
14050;161128;4714;0;0;0;0;.00nan;0;0
14051;165532;4246;54;28;3;25;.893;4200000;0
14051;-1;4839;73;37;3;34;.919;4200000;0
14051;182097;4839;0;0;0;0;.00nan;0;0
14051;39981;4246;0;0;0;0;.00nan;0;0
14052;-1;4997;50;26;4;22;.846;3600000;0
14052;181874;4997;0;0;0;0;.00nan;0;0
14052;38037;4714;56;6;0;6;1.000;1002000;0
14052;161128;4714;42;34;6;28;.824;2598000;0
14053;163528;165;81;35;3;32;.914;3600000;0
14053;166423;4998;0;0;0;0;.00nan;0;0
14053;-1;4998;37;30;5;25;.833;3516000;0
14053;46785;165;0;0;0;0;.00nan;0;0
14054;-1;4991;52;35;5;30;.857;3600000;0
14054;175712;4992;55;38;6;32;.842;3586000;0
14054;78820;4991;0;0;0;0;.00nan;0;0
14054;86268;4992;0;0;0;0;.00nan;0;0
14055;179411;4919;0;0;0;0;.00nan;0;0
14055;176060;1368;0;0;0;0;.00nan;0;0
14055;55660;1368;73;38;5;33;.868;3521000;0
14055;149889;4919;54;27;3;24;.889;3600000;0
14056;166423;4998;0;0;0;0;.00nan;0;0
14056;-1;4998;52;21;3;18;.857;3537000;0
14056;175712;4992;0;0;0;0;.00nan;0;0
14056;86268;4992;99;44;1;43;.977;3600000;0
14057;161583;4715;0;0;0;0;.00nan;0;0
14057;163528;165;62;30;3;27;.900;3600000;0
14057;36221;4715;57;32;4;28;.875;3547000;0
14057;46785;165;0;0;0;0;.00nan;0;0
14058;176060;1368;14;23;6;17;.739;2593000;0
14058;-1;4839;0;0;0;0;.00nan;0;0
14058;182097;4839;71;39;4;35;.897;3600000;0
14058;55660;1368;42;3;1;2;.667;1007000;0
14059;-1;4991;0;0;0;0;.00nan;0;0
14059;179411;4919;51;31;5;26;.839;3544000;0
14059;78820;4991;86;43;4;39;.907;3600000;0
14059;149889;4919;0;0;0;0;.00nan;0;0
14060;165532;4246;0;0;0;0;.00nan;0;0
14060;-1;4997;59;5;0;5;1.000;1222000;0
14060;181874;4997;45;24;5;19;.792;2378000;0
14060;39981;4246;47;46;7;39;.848;3561000;0
14061;163528;165;72;38;3;35;.921;3554000;0
14061;166423;4998;70;29;2;27;.931;3600000;0
14061;-1;4998;0;0;0;0;.00nan;0;0
14061;46785;165;0;0;0;0;.00nan;0;0
14062;-1;4991;87;49;5;44;.898;3600000;0
14062;179411;4919;0;0;0;0;.00nan;0;0
14062;78820;4991;0;0;0;0;.00nan;0;0
14062;149889;4919;74;31;2;29;.935;3600000;0
14063;161583;4715;43;22;4;18;.818;3600000;0
14063;175712;4992;26;13;4;9;.692;973000;0
14063;36221;4715;0;0;0;0;.00nan;0;0
14063;86268;4992;82;27;1;26;.963;2585000;0
14064;165532;4246;44;34;6;28;.824;3301000;0
14064;-1;4997;49;33;5;28;.848;3600000;0
14064;181874;4997;0;0;0;0;.00nan;0;0
14064;39981;4246;50;1;0;1;1.000;271000;0
14065;176060;1368;0;0;0;0;.00nan;0;0
14065;-1;4839;43;39;6;33;.846;3560000;0
14065;182097;4839;0;0;0;0;.00nan;0;0
14065;55660;1368;47;32;5;27;.844;3600000;0
14066;163528;165;63;28;3;25;.893;3600000;0
14066;175712;4992;0;0;0;0;.00nan;0;0
14066;46785;165;0;0;0;0;.00nan;0;0
14066;86268;4992;50;30;4;26;.867;3599000;0
14067;161583;4715;0;0;0;0;.00nan;0;0
14067;36221;4715;50;27;4;23;.852;3514000;0
14067;38037;4714;76;26;2;24;.923;3600000;0
14067;161128;4714;0;0;0;0;.00nan;0;0
14068;165532;4246;0;0;0;0;.00nan;0;0
14068;176060;1368;89;30;1;29;.967;3600000;0
14068;39981;4246;69;31;3;28;.903;3523000;0
14068;55660;1368;0;0;0;0;.00nan;0;0
14069;166423;4998;0;0;0;0;.00nan;0;0
14069;-1;4998;48;28;4;24;.857;3582000;0
14069;38037;4714;61;27;3;24;.889;3600000;0
14069;161128;4714;0;0;0;0;.00nan;0;0
14070;163528;165;78;28;2;26;.929;3600000;0
14070;175712;4992;0;0;0;0;.00nan;0;0
14070;46785;165;0;0;0;0;.00nan;0;0
14070;86268;4992;57;29;3;26;.897;3548000;0
14071;-1;4991;0;0;0;0;.00nan;0;0
14071;-1;4839;0;0;0;0;.00nan;0;0
14071;182097;4839;29;28;6;22;.786;3547000;0
14071;78820;4991;68;47;5;42;.894;3600000;0
14072;175651;4997;23;36;7;29;.806;3600000;0
14072;176060;1368;51;25;4;21;.840;3600000;0
14072;181874;4997;0;0;0;0;.00nan;0;0
14072;55660;1368;0;0;0;0;.00nan;0;0
14073;165532;4246;0;0;0;0;.00nan;0;0
14073;-1;4919;0;0;0;0;.00nan;0;0
14073;-1;4919;44;32;5;27;.844;3600000;0
14073;39981;4246;77;20;1;19;.950;3600000;0
14074;-1;4991;35;20;4;16;.800;3580000;0
14074;-1;4839;62;31;3;28;.903;3600000;0
14074;182097;4839;0;0;0;0;.00nan;0;0
14074;78820;4991;0;0;0;0;.00nan;0;0
14075;166423;4998;58;37;4;33;.892;3574000;0
14075;-1;4998;0;0;0;0;.00nan;0;0
14075;38037;4714;0;0;0;0;.00nan;0;0
14075;161128;4714;52;22;3;19;.864;3600000;0
14076;163528;165;91;49;4;45;.918;3554000;0
14076;175712;4992;59;28;3;25;.893;3600000;0
14076;46785;165;0;0;0;0;.00nan;0;0
14076;86268;4992;0;0;0;0;.00nan;0;0
14077;165532;4246;65;38;3;35;.921;3520000;0
14077;-1;4919;0;0;0;0;.00nan;0;0
14077;-1;4919;81;22;1;21;.955;3600000;0
14077;39981;4246;0;0;0;0;.00nan;0;0
14078;175651;4997;59;24;3;21;.875;3600000;0
14078;176060;1368;44;13;2;11;.846;1126000;0
14078;181874;4997;0;0;0;0;.00nan;0;0
14078;55660;1368;40;33;6;27;.818;2474000;0
14079;166423;4998;0;0;0;0;.00nan;0;0
14079;-1;4998;55;30;4;26;.867;3600000;0
14079;175712;4992;68;24;2;22;.917;2742000;0
14079;86268;4992;17;8;4;4;.500;858000;0
14080;-1;4919;45;39;5;34;.872;3519000;0
14080;-1;4919;0;0;0;0;.00nan;0;0
14080;-1;4839;0;0;0;0;.00nan;0;0
14080;182097;4839;80;33;3;30;.909;3600000;0
14081;163528;165;27;17;5;12;.706;1900000;0
14081;38037;4714;76;31;3;28;.903;3600000;0
14081;46785;165;28;20;5;15;.750;1700000;0
14081;161128;4714;0;0;0;0;.00nan;0;0
14082;-1;4991;0;0;0;0;.00nan;0;0
14082;175651;4997;58;30;3;27;.900;3600000;0
14082;181874;4997;0;0;0;0;.00nan;0;0
14082;78820;4991;97;49;4;45;.918;3600000;0
14083;165532;4246;0;0;0;0;.00nan;0;0
14083;176060;1368;61;33;3;30;.909;3600000;0
14083;39981;4246;65;34;4;30;.882;3542000;0
14083;55660;1368;0;0;0;0;.00nan;0;0
14084;-1;4991;30;32;6;26;.813;2776000;0
14084;175651;4997;24;8;4;4;.500;514000;0
14084;181874;4997;42;17;4;13;.765;3062000;0
14084;78820;4991;52;8;1;7;.875;824000;0
14085;161583;4715;0;0;0;0;.00nan;0;0
14085;166423;4998;47;35;5;30;.857;3600000;0
14085;-1;4998;0;0;0;0;.00nan;0;0
14085;36221;4715;53;22;3;19;.864;3600000;0
14086;-1;4919;0;0;0;0;.00nan;0;0
14086;-1;4919;66;16;1;15;.938;3600000;0
14086;-1;4839;0;0;0;0;.00nan;0;0
14086;182097;4839;77;32;2;30;.938;3600000;0
14087;163528;165;89;39;2;37;.949;4200000;0
14087;38037;4714;0;0;0;0;.00nan;0;0
14087;46785;165;0;0;0;0;.00nan;0;0
14087;161128;4714;93;45;2;43;.956;4200000;0
14088;165532;4246;58;28;3;25;.893;3595000;0
14088;176060;1368;0;0;0;0;.00nan;0;0
14088;39981;4246;0;0;0;0;.00nan;0;0
14088;55660;1368;77;31;2;29;.935;3600000;0
14089;-1;4991;0;0;0;0;.00nan;0;0
14089;175651;4997;87;34;2;32;.941;3600000;0
14089;181874;4997;0;0;0;0;.00nan;0;0
14089;78820;4991;50;44;6;38;.864;3600000;0
14090;161583;4715;91;51;5;46;.902;3724000;0
14090;36221;4715;0;0;0;0;.00nan;0;0
14090;38037;4714;50;20;4;16;.800;3724000;0
14090;161128;4714;0;0;0;0;.00nan;0;0
14091;175651;4997;0;0;0;0;.00nan;0;0
14091;181874;4997;25;25;6;19;.760;3600000;0
14091;38037;4714;57;24;2;22;.917;3600000;0
14091;161128;4714;0;0;0;0;.00nan;0;0
14092;161583;4715;77;34;2;32;.941;3600000;0
14092;166423;4998;0;0;0;0;.00nan;0;0
14092;-1;4998;9;22;7;15;.682;3600000;0
14092;36221;4715;0;0;0;0;.00nan;0;0
14093;176060;1368;70;30;4;26;.867;3563000;0
14093;-1;4839;81;46;3;43;.935;3600000;0
14093;182097;4839;0;0;0;0;.00nan;0;0
14093;55660;1368;0;0;0;0;.00nan;0;0
14094;-1;4991;0;0;0;0;.00nan;0;0
14094;175712;4992;61;6;0;6;1.000;791000;0
14094;78820;4991;72;39;4;35;.897;3600000;0
14094;86268;4992;29;36;8;28;.778;2809000;0
14095;165532;4246;0;0;0;0;.00nan;0;0
14095;-1;4919;0;0;0;0;.00nan;0;0
14095;-1;4919;72;42;4;38;.905;3578000;0
14095;39981;4246;79;30;2;28;.933;3600000;0
14096;-1;4991;67;40;5;35;.875;4098000;0
14096;175712;4992;43;30;4;26;.867;4098000;0
14096;78820;4991;0;0;0;0;.00nan;0;0
14096;86268;4992;0;0;0;0;.00nan;0;0
14097;175651;4997;56;37;5;32;.865;3566000;0
14097;181874;4997;0;0;0;0;.00nan;0;0
14097;38037;4714;0;0;0;0;.00nan;0;0
14097;161128;4714;64;27;3;24;.889;3600000;0
14098;176060;1368;0;0;0;0;.00nan;0;0
14098;-1;4839;0;0;0;0;.00nan;0;0
14098;182097;4839;64;26;2;24;.923;3600000;0
14098;55660;1368;75;24;1;23;.958;3600000;0
14099;161583;4715;0;0;0;0;.00nan;0;0
14099;163528;165;72;38;4;34;.895;3544000;0
14099;36221;4715;76;25;2;23;.920;3600000;0
14099;46785;165;0;0;0;0;.00nan;0;0
14100;165532;4246;82;43;3;40;.930;3556000;0
14100;-1;4919;62;23;2;21;.913;3600000;0
14100;-1;4919;0;0;0;0;.00nan;0;0
14100;39981;4246;0;0;0;0;.00nan;0;0
14101;165532;4246;0;0;0;0;.00nan;0;0
14101;176060;1368;72;31;2;29;.935;3547000;0
14101;39981;4246;96;36;1;35;.972;3600000;0
14101;55660;1368;0;0;0;0;.00nan;0;0
14102;163528;165;67;38;5;33;.868;3600000;0
14102;175712;4992;0;0;0;0;.00nan;0;0
14102;46785;165;0;0;0;0;.00nan;0;0
14102;86268;4992;79;31;1;30;.968;3600000;0
14103;161583;4715;0;0;0;0;.00nan;0;0
14103;166423;4998;0;0;0;0;.00nan;0;0
14103;-1;4998;55;22;3;19;.864;3600000;0
14103;36221;4715;86;21;0;21;1.000;3600000;0
14104;-1;4991;0;0;0;0;.00nan;0;0
14104;38037;4714;53;30;4;26;.867;3553000;0
14104;78820;4991;83;37;3;34;.919;3600000;0
14104;161128;4714;0;0;0;0;.00nan;0;0
14105;176060;1368;0;0;0;0;.00nan;0;0
14105;-1;4839;64;30;3;27;.900;3600000;0
14105;182097;4839;0;0;0;0;.00nan;0;0
14105;55660;1368;61;20;2;18;.900;3600000;0
14106;165532;4246;98;48;2;46;.958;4200000;0
14106;-1;4919;64;23;2;21;.913;4200000;0
14106;-1;4919;0;0;0;0;.00nan;0;0
14106;39981;4246;0;0;0;0;.00nan;0;0
14107;-1;4991;14;35;8;27;.771;3600000;0
14107;175651;4997;77;23;1;22;.957;3600000;0
14107;181874;4997;0;0;0;0;.00nan;0;0
14107;78820;4991;0;0;0;0;.00nan;0;0
14108;163528;165;47;5;1;4;.800;1080000;0
14108;166423;4998;16;34;8;26;.765;3653000;0
14108;-1;4998;0;0;0;0;.00nan;0;0
14108;46785;165;18;21;6;15;.714;2619000;0
14109;161583;4715;0;0;0;0;.00nan;0;0
14109;175712;4992;36;32;6;26;.813;2974000;0
14109;36221;4715;68;31;3;28;.903;3600000;0
14109;86268;4992;43;6;1;5;.833;626000;0
14110;-1;4919;0;0;0;0;.00nan;0;0
14110;-1;4919;53;30;5;25;.833;3600000;0
14110;-1;4839;0;0;0;0;.00nan;0;0
14110;182097;4839;41;38;6;32;.842;3600000;0
14111;165532;4246;62;35;3;32;.914;2569000;0
14111;176060;1368;62;25;3;22;.880;3600000;0
14111;39981;4246;22;11;4;7;.636;1031000;0
14111;55660;1368;0;0;0;0;.00nan;0;0
14112;161583;4715;0;0;0;0;.00nan;0;0
14112;175712;4992;0;0;0;0;.00nan;0;0
14112;36221;4715;65;33;4;29;.879;3767000;0
14112;86268;4992;54;25;3;22;.880;3767000;0
14113;-1;4991;0;0;0;0;.00nan;0;0
14113;-1;4919;0;0;0;0;.00nan;0;0
14113;-1;4919;64;30;3;27;.900;3585000;0
14113;78820;4991;92;41;2;39;.951;3600000;0
14114;163528;165;45;29;5;24;.828;3600000;0
14114;175651;4997;32;23;6;17;.739;3600000;0
14114;181874;4997;0;0;0;0;.00nan;0;0
14114;46785;165;0;0;0;0;.00nan;0;0
14115;166423;4998;0;0;0;0;.00nan;0;0
14115;-1;4998;51;36;5;31;.861;3600000;0
14115;38037;4714;32;40;7;33;.825;3521000;0
14115;161128;4714;0;0;0;0;.00nan;0;0
14116;-1;4991;59;38;5;33;.868;3576000;0
14116;-1;4839;75;36;3;33;.917;3600000;0
14116;182097;4839;0;0;0;0;.00nan;0;0
14116;78820;4991;0;0;0;0;.00nan;0;0
14117;166423;4998;83;44;3;41;.932;3600000;0
14117;-1;4998;0;0;0;0;.00nan;0;0
14117;38037;4714;0;0;0;0;.00nan;0;0
14117;161128;4714;42;27;4;23;.852;3547000;0
14118;163528;165;0;0;0;0;.00nan;0;0
14118;175651;4997;0;0;0;0;.00nan;0;0
14118;181874;4997;30;23;5;18;.783;3559000;0
14118;46785;165;72;36;4;32;.889;3600000;0
14119;161583;4715;0;0;0;0;.00nan;0;0
14119;175712;4992;81;38;3;35;.921;3600000;0
14119;36221;4715;57;32;5;27;.844;3600000;0
14119;86268;4992;0;0;0;0;.00nan;0;0
14120;165532;4246;0;0;0;0;.00nan;0;0
14120;176060;1368;85;31;1;30;.968;3600000;0
14120;39981;4246;55;28;4;24;.857;3600000;0
14120;55660;1368;0;0;0;0;.00nan;0;0
14121;175651;4997;51;29;4;25;.862;3548000;0
14121;181874;4997;0;0;0;0;.00nan;0;0
14121;38037;4714;84;38;2;36;.947;3600000;0
14121;161128;4714;0;0;0;0;.00nan;0;0
14122;166423;4998;0;0;0;0;.00nan;0;0
14122;-1;4998;78;29;1;28;.966;3600000;0
14122;175712;4992;0;0;0;0;.00nan;0;0
14122;86268;4992;88;48;2;46;.958;3548000;0
14123;161583;4715;0;0;0;0;.00nan;0;0
14123;163528;165;27;31;6;25;.806;2713000;0
14123;36221;4715;42;31;5;26;.839;3600000;0
14123;46785;165;44;5;1;4;.800;860000;0
14124;-1;4991;0;0;0;0;.00nan;0;0
14124;-1;4839;96;40;2;38;.950;3600000;0
14124;182097;4839;0;0;0;0;.00nan;0;0
14124;78820;4991;71;43;5;38;.884;3600000;0
14125;165532;4246;57;30;4;26;.867;3600000;0
14125;176060;1368;0;0;0;0;.00nan;0;0
14125;39981;4246;0;0;0;0;.00nan;0;0
14125;55660;1368;82;22;1;21;.955;3600000;0
14126;-1;4991;29;32;7;25;.781;3306000;0
14126;-1;4839;62;25;3;22;.880;3600000;0
14126;182097;4839;0;0;0;0;.00nan;0;0
14126;78820;4991;49;2;0;2;1.000;294000;0
14127;163528;165;0;0;0;0;.00nan;0;0
14127;175712;4992;34;33;6;27;.818;3600000;0
14127;46785;165;60;24;3;21;.875;3600000;0
14127;86268;4992;0;0;0;0;.00nan;0;0
14128;175651;4997;0;0;0;0;.00nan;0;0
14128;181874;4997;77;33;3;30;.909;3600000;0
14128;38037;4714;0;0;0;0;.00nan;0;0
14128;161128;4714;94;33;1;32;.970;3600000;0
14129;161583;4715;45;34;6;28;.824;3055000;0
14129;166423;4998;44;32;4;28;.875;3600000;0
14129;-1;4998;0;0;0;0;.00nan;0;0
14129;36221;4715;48;0;0;0;.00nan;459000;0
14130;165532;4246;68;12;0;12;1.000;1148000;0
14130;176060;1368;100;29;0;29;1.000;3600000;0
14130;39981;4246;25;24;6;18;.750;2452000;0
14130;55660;1368;0;0;0;0;.00nan;0;0
14131;175651;4997;94;34;1;33;.971;3600000;0
14131;181874;4997;0;0;0;0;.00nan;0;0
14131;38037;4714;38;17;4;13;.765;3600000;0
14131;161128;4714;0;0;0;0;.00nan;0;0
14132;-1;4991;0;0;0;0;.00nan;0;0
14132;-1;4839;0;0;0;0;.00nan;0;0
14132;182097;4839;41;45;6;39;.867;3600000;0
14132;78820;4991;100;27;0;27;1.000;3600000;0
14133;163528;165;80;28;2;26;.929;4200000;0
14133;175712;4992;0;0;0;0;.00nan;0;0
14133;46785;165;0;0;0;0;.00nan;0;0
14133;86268;4992;100;50;2;48;.960;4200000;0
14134;161583;4715;0;0;0;0;.00nan;0;0
14134;166423;4998;0;0;0;0;.00nan;0;0
14134;-1;4998;49;30;4;26;.867;3600000;0
14134;36221;4715;98;34;1;33;.971;3600000;0
14135;175651;4997;58;27;3;24;.889;3600000;0
14135;176060;1368;55;25;4;21;.840;3589000;0
14135;181874;4997;0;0;0;0;.00nan;0;0
14135;55660;1368;0;0;0;0;.00nan;0;0
14136;175651;4997;0;0;0;0;.00nan;0;0
14136;176060;1368;0;0;0;0;.00nan;0;0
14136;181874;4997;33;29;5;24;.828;3579000;0
14136;55660;1368;68;30;3;27;.900;3600000;0
14137;163528;165;80;29;1;28;.966;3600000;0
14137;166423;4998;0;0;0;0;.00nan;0;0
14137;-1;4998;25;22;6;16;.727;3600000;0
14137;46785;165;0;0;0;0;.00nan;0;0
14138;161583;4715;0;0;0;0;.00nan;0;0
14138;36221;4715;78;50;5;45;.900;3600000;0
14138;38037;4714;56;21;3;18;.857;3600000;0
14138;161128;4714;0;0;0;0;.00nan;0;0
14139;-1;4919;0;0;0;0;.00nan;0;0
14139;-1;4919;55;38;6;32;.842;3600000;0
14139;-1;4839;0;0;0;0;.00nan;0;0
14139;182097;4839;58;19;3;16;.842;3600000;0
14140;-1;4991;0;0;0;0;.00nan;0;0
14140;175651;4997;0;0;0;0;.00nan;0;0
14140;181874;4997;41;35;6;29;.829;3600000;0
14140;78820;4991;79;22;1;21;.955;3600000;0
14141;165532;4246;65;28;3;25;.893;3662000;0
14141;176060;1368;74;34;2;32;.941;3662000;0
14141;39981;4246;0;0;0;0;.00nan;0;0
14141;55660;1368;0;0;0;0;.00nan;0;0
14142;-1;4991;25;18;5;13;.722;3600000;0
14142;175651;4997;31;38;7;31;.816;3600000;0
14142;181874;4997;0;0;0;0;.00nan;0;0
14142;78820;4991;0;0;0;0;.00nan;0;0
14143;175712;4992;90;29;1;28;.966;3600000;0
14143;38037;4714;44;23;4;19;.826;3600000;0
14143;86268;4992;0;0;0;0;.00nan;0;0
14143;161128;4714;0;0;0;0;.00nan;0;0
14144;-1;4919;27;26;6;20;.769;2457000;0
14144;-1;4919;43;3;1;2;.667;1143000;0
14144;-1;4839;0;0;0;0;.00nan;0;0
14144;182097;4839;73;31;2;29;.935;3600000;0
14145;161583;4715;55;16;2;14;.875;3600000;0
14145;163528;165;0;0;0;0;.00nan;0;0
14145;36221;4715;0;0;0;0;.00nan;0;0
14145;46785;165;32;35;7;28;.800;3600000;0
14146;165532;4246;0;0;0;0;.00nan;0;0
14146;176060;1368;0;0;0;0;.00nan;0;0
14146;39981;4246;83;38;2;36;.947;3600000;0
14146;55660;1368;53;24;3;21;.875;3548000;0
14147;-1;4919;37;28;5;23;.821;2828000;0
14147;-1;4919;22;7;4;3;.429;772000;0
14147;176060;1368;32;28;6;22;.786;3600000;0
14147;55660;1368;0;0;0;0;.00nan;0;0
14148;-1;4991;0;0;0;0;.00nan;0;0
14148;-1;4919;0;0;0;0;.00nan;0;0
14148;-1;4919;49;27;4;23;.852;3600000;0
14148;78820;4991;65;16;1;15;.938;3600000;0
14149;161583;4715;0;0;0;0;.00nan;0;0
14149;175651;4997;0;0;0;0;.00nan;0;0
14149;36221;4715;75;37;3;34;.919;3600000;0
14149;181874;4997;45;26;4;22;.846;3600000;0
14150;163528;165;25;24;6;18;.750;3600000;0
14150;175712;4992;27;30;7;23;.767;3600000;0
14150;46785;165;0;0;0;0;.00nan;0;0
14150;86268;4992;0;0;0;0;.00nan;0;0
14151;-1;4919;47;40;6;34;.850;3051000;0
14151;-1;4919;48;5;1;4;.800;549000;0
14151;38037;4714;62;28;3;25;.893;3600000;0
14151;161128;4714;0;0;0;0;.00nan;0;0
14152;166423;4998;0;0;0;0;.00nan;0;0
14152;-1;4998;64;27;2;25;.926;3600000;0
14152;-1;4839;21;25;6;19;.760;2362000;0
14152;182097;4839;51;15;2;13;.867;1238000;0
14153;165532;4246;79;40;3;37;.925;3710000;0
14153;176060;1368;69;24;2;22;.917;3710000;0
14153;39981;4246;0;0;0;0;.00nan;0;0
14153;55660;1368;0;0;0;0;.00nan;0;0
14154;161583;4715;26;33;7;26;.788;3572000;0
14154;175651;4997;29;20;5;15;.750;3600000;0
14154;36221;4715;0;0;0;0;.00nan;0;0
14154;181874;4997;0;0;0;0;.00nan;0;0
14155;163528;165;0;0;0;0;.00nan;0;0
14155;175712;4992;0;0;0;0;.00nan;0;0
14155;46785;165;40;27;5;22;.815;3549000;0
14155;86268;4992;47;29;4;25;.862;3600000;0
14156;-1;4919;0;0;0;0;.00nan;0;0
14156;-1;4919;58;34;4;30;.882;3557000;0
14156;38037;4714;65;24;3;21;.875;3600000;0
14156;161128;4714;0;0;0;0;.00nan;0;0
14157;166423;4998;21;31;7;24;.774;3072000;0
14157;-1;4998;70;12;0;12;1.000;528000;0
14157;-1;4839;0;0;0;0;.00nan;0;0
14157;182097;4839;60;20;2;18;.900;3600000;0
14158;165532;4246;0;0;0;0;.00nan;0;0
14158;176060;1368;0;0;0;0;.00nan;0;0
14158;39981;4246;56;33;4;29;.879;4003000;0
14158;55660;1368;66;24;3;21;.875;4003000;0
14159;161583;4715;0;0;0;0;.00nan;0;0
14159;175651;4997;0;0;0;0;.00nan;0;0
14159;36221;4715;74;50;5;45;.900;3600000;0
14159;181874;4997;58;19;2;17;.895;3600000;0
14160;163528;165;96;45;2;43;.956;3600000;0
14160;175712;4992;0;0;0;0;.00nan;0;0
14160;46785;165;0;0;0;0;.00nan;0;0
14160;86268;4992;55;25;3;22;.880;3600000;0
14161;161583;4715;45;17;3;14;.824;2725000;0
14161;166423;4998;0;0;0;0;.00nan;0;0
14161;-1;4998;59;36;5;31;.861;3600000;0
14161;36221;4715;18;15;5;10;.667;875000;0
14162;-1;4919;90;41;2;39;.951;4148000;0
14162;-1;4919;0;0;0;0;.00nan;0;0
14162;-1;4839;0;0;0;0;.00nan;0;0
14162;182097;4839;75;35;3;32;.914;4148000;0
14163;175651;4997;44;35;6;29;.829;3600000;0
14163;181874;4997;0;0;0;0;.00nan;0;0
14163;38037;4714;62;30;3;27;.900;3600000;0
14163;161128;4714;0;0;0;0;.00nan;0;0
14164;-1;4991;0;0;0;0;.00nan;0;0
14164;176060;1368;30;28;6;22;.786;3566000;0
14164;55660;1368;0;0;0;0;.00nan;0;0
14164;78820;4991;62;33;4;29;.879;3600000;0
14165;-1;4991;37;17;4;13;.765;1053000;0
14165;176060;1368;0;0;0;0;.00nan;0;0
14165;55660;1368;56;20;3;17;.850;3600000;0
14165;78820;4991;97;45;1;44;.978;2547000;0
14166;-1;4919;0;0;0;0;.00nan;0;0
14166;-1;4919;83;38;3;35;.921;3595000;0
14166;-1;4839;78;32;2;30;.938;3600000;0
14166;182097;4839;0;0;0;0;.00nan;0;0
14167;163528;165;0;0;0;0;.00nan;0;0
14167;175712;4992;15;21;6;15;.714;2098000;0
14167;46785;165;53;32;4;28;.875;3600000;0
14167;86268;4992;43;17;3;14;.824;1502000;0
14168;161583;4715;0;0;0;0;.00nan;0;0
14168;166423;4998;73;33;3;30;.909;3555000;0
14168;-1;4998;0;0;0;0;.00nan;0;0
14168;36221;4715;80;31;2;29;.935;3600000;0
14169;175651;4997;0;0;0;0;.00nan;0;0
14169;181874;4997;73;38;4;34;.895;3600000;0
14169;38037;4714;38;28;5;23;.821;3561000;0
14169;161128;4714;0;0;0;0;.00nan;0;0
14170;166423;4998;0;0;0;0;.00nan;0;0
14170;-1;4998;53;19;3;16;.842;3600000;0
14170;175651;4997;49;35;5;30;.857;3539000;0
14170;181874;4997;0;0;0;0;.00nan;0;0
14171;166423;4998;81;34;3;31;.912;3600000;0
14171;-1;4998;0;0;0;0;.00nan;0;0
14171;175651;4997;0;0;0;0;.00nan;0;0
14171;181874;4997;35;25;5;20;.800;3514000;0
14172;161583;4715;0;0;0;0;.00nan;0;0
14172;175712;4992;60;19;2;17;.895;1655000;0
14172;36221;4715;73;30;2;28;.933;3600000;0
14172;86268;4992;14;19;6;13;.684;1945000;0
14173;-1;4919;88;48;3;45;.938;4042000;0
14173;-1;4919;0;0;0;0;.00nan;0;0
14173;38037;4714;54;33;4;29;.879;4042000;0
14173;161128;4714;0;0;0;0;.00nan;0;0
14174;165532;4246;0;0;0;0;.00nan;0;0
14174;-1;4839;0;0;0;0;.00nan;0;0
14174;182097;4839;58;21;2;19;.905;3600000;0
14174;39981;4246;46;23;3;20;.870;3599000;0
14175;-1;4991;0;0;0;0;.00nan;0;0
14175;176060;1368;39;21;4;17;.810;3600000;0
14175;55660;1368;0;0;0;0;.00nan;0;0
14175;78820;4991;84;27;1;26;.963;3600000;0
14176;-1;4919;40;7;2;5;.714;679000;0
14176;-1;4919;22;22;6;16;.727;2921000;0
14176;38037;4714;0;0;0;0;.00nan;0;0
14176;161128;4714;85;38;2;36;.947;3600000;0
14177;161583;4715;0;0;0;0;.00nan;0;0
14177;163528;165;64;36;5;31;.861;3600000;0
14177;36221;4715;49;24;4;20;.833;3600000;0
14177;46785;165;0;0;0;0;.00nan;0;0
14178;166423;4998;0;0;0;0;.00nan;0;0
14178;-1;4998;56;19;2;17;.895;4033000;0
14178;175712;4992;0;0;0;0;.00nan;0;0
14178;86268;4992;100;43;1;42;.977;4033000;0
14179;165532;4246;39;24;5;19;.792;2321000;0
14179;-1;4839;51;31;4;27;.871;3600000;0
14179;182097;4839;0;0;0;0;.00nan;0;0
14179;39981;4246;44;4;1;3;.750;1192000;0
14180;-1;4991;0;0;0;0;.00nan;0;0
14180;176060;1368;0;0;0;0;.00nan;0;0
14180;55660;1368;74;24;2;22;.917;3600000;0
14180;78820;4991;42;31;5;26;.839;3600000;0
14181;-1;4919;49;34;5;29;.853;3600000;0
14181;-1;4919;0;0;0;0;.00nan;0;0
14181;38037;4714;63;23;2;21;.913;3600000;0
14181;161128;4714;0;0;0;0;.00nan;0;0
14182;175712;4992;56;42;5;37;.881;3600000;0
14182;38037;4714;70;25;2;23;.920;3600000;0
14182;86268;4992;0;0;0;0;.00nan;0;0
14182;161128;4714;0;0;0;0;.00nan;0;0
14183;166423;4998;0;0;0;0;.00nan;0;0
14183;-1;4998;66;19;1;18;.947;3600000;0
14183;175651;4997;48;34;5;29;.853;3600000;0
14183;181874;4997;0;0;0;0;.00nan;0;0
14184;165532;4246;79;24;1;23;.958;3600000;0
14184;-1;4919;0;0;0;0;.00nan;0;0
14184;-1;4919;41;35;7;28;.800;3600000;0
14184;39981;4246;0;0;0;0;.00nan;0;0
14185;163528;165;56;42;6;36;.857;3568000;0
14185;-1;4991;0;0;0;0;.00nan;0;0
14185;46785;165;0;0;0;0;.00nan;0;0
14185;78820;4991;45;23;4;19;.826;3600000;0
14186;176060;1368;97;40;1;39;.975;4200000;0
14186;-1;4839;0;0;0;0;.00nan;0;0
14186;182097;4839;65;24;1;23;.958;4200000;0
14186;55660;1368;0;0;0;0;.00nan;0;0
14187;163528;165;79;42;3;39;.929;3762000;0
14187;-1;4991;0;0;0;0;.00nan;0;0
14187;46785;165;0;0;0;0;.00nan;0;0
14187;78820;4991;56;27;4;23;.852;3762000;0
14188;165532;4246;0;0;0;0;.00nan;0;0
14188;-1;4919;58;48;6;42;.875;3576000;0
14188;-1;4919;0;0;0;0;.00nan;0;0
14188;39981;4246;45;21;4;17;.810;3600000;0
14189;166423;4998;67;21;2;19;.905;3545000;0
14189;-1;4998;0;0;0;0;.00nan;0;0
14189;175651;4997;0;0;0;0;.00nan;0;0
14189;181874;4997;75;18;1;17;.944;3600000;0
14190;176060;1368;0;0;0;0;.00nan;0;0
14190;-1;4839;51;29;4;25;.862;3585000;0
14190;182097;4839;0;0;0;0;.00nan;0;0
14190;55660;1368;49;34;5;29;.853;3598000;0
14191;161583;4715;61;32;4;28;.875;3600000;0
14191;36221;4715;0;0;0;0;.00nan;0;0
14191;38037;4714;0;0;0;0;.00nan;0;0
14191;161128;4714;86;31;1;30;.968;3600000;0
14192;165532;4246;34;33;6;27;.818;3600000;0
14192;-1;4919;0;0;0;0;.00nan;0;0
14192;-1;4919;78;28;2;26;.929;3600000;0
14192;39981;4246;0;0;0;0;.00nan;0;0
14193;161583;4715;0;0;0;0;.00nan;0;0
14193;36221;4715;71;33;3;30;.909;3600000;0
14193;38037;4714;28;16;4;12;.750;2207000;0
14193;161128;4714;58;17;2;15;.882;1393000;0
14194;-1;4991;0;0;0;0;.00nan;0;0
14194;-1;4839;0;0;0;0;.00nan;0;0
14194;182097;4839;87;33;1;32;.970;3600000;0
14194;78820;4991;60;24;2;22;.917;3543000;0
14195;163528;165;92;20;0;20;1.000;3600000;0
14195;166423;4998;0;0;0;0;.00nan;0;0
14195;-1;4998;47;30;4;26;.867;3600000;0
14195;46785;165;0;0;0;0;.00nan;0;0
14196;161583;4715;0;0;0;0;.00nan;0;0
14196;175651;4997;21;15;5;10;.667;3600000;0
14196;36221;4715;57;47;6;41;.872;3600000;0
14196;181874;4997;0;0;0;0;.00nan;0;0
14197;165532;4246;0;0;0;0;.00nan;0;0
14197;-1;4839;0;0;0;0;.00nan;0;0
14197;182097;4839;81;35;3;32;.914;3600000;0
14197;39981;4246;61;36;5;31;.861;3553000;0
14198;175712;4992;0;0;0;0;.00nan;0;0
14198;38037;4714;56;21;2;19;.905;3600000;0
14198;86268;4992;50;28;3;25;.893;3544000;0
14198;161128;4714;0;0;0;0;.00nan;0;0
14199;175712;4992;77;34;3;31;.912;3566000;0
14199;38037;4714;0;0;0;0;.00nan;0;0
14199;86268;4992;0;0;0;0;.00nan;0;0
14199;161128;4714;80;22;1;21;.955;3600000;0
14200;161583;4715;0;0;0;0;.00nan;0;0
14200;175651;4997;0;0;0;0;.00nan;0;0
14200;36221;4715;47;31;5;26;.839;3600000;0
14200;181874;4997;67;28;2;26;.929;3600000;0
14201;163528;165;64;33;4;29;.879;3556000;0
14201;166423;4998;60;25;3;22;.880;3600000;0
14201;-1;4998;0;0;0;0;.00nan;0;0
14201;46785;165;0;0;0;0;.00nan;0;0
14202;-1;4991;0;0;0;0;.00nan;0;0
14202;-1;4919;54;31;4;27;.871;3600000;0
14202;-1;4919;0;0;0;0;.00nan;0;0
14202;78820;4991;100;28;0;28;1.000;3600000;0
14203;176060;1368;68;32;3;29;.906;3581000;0
14203;-1;4839;71;29;2;27;.931;3600000;0
14203;182097;4839;0;0;0;0;.00nan;0;0
14203;55660;1368;0;0;0;0;.00nan;0;0
14204;166423;4998;0;0;0;0;.00nan;0;0
14204;-1;4998;47;28;4;24;.857;3600000;0
14204;175712;4992;0;0;0;0;.00nan;0;0
14204;86268;4992;100;37;1;36;.973;3600000;0
14205;166423;4998;0;0;0;0;.00nan;0;0
14205;-1;4998;44;24;4;20;.833;3600000;0
14205;175712;4992;32;27;5;22;.815;2704000;0
14205;86268;4992;32;15;4;11;.733;896000;0
14206;-1;4991;0;0;0;0;.00nan;0;0
14206;-1;4919;0;0;0;0;.00nan;0;0
14206;-1;4919;60;23;3;20;.870;4200000;0
14206;78820;4991;84;37;3;34;.919;4200000;0
14207;175651;4997;60;24;3;21;.875;3600000;0
14207;181874;4997;0;0;0;0;.00nan;0;0
14207;38037;4714;78;43;4;39;.907;3600000;0
14207;161128;4714;0;0;0;0;.00nan;0;0
14208;166423;4998;52;25;3;22;.880;3600000;0
14208;-1;4919;37;6;2;4;.667;754000;0
14208;-1;4998;0;0;0;0;.00nan;0;0
14208;-1;4919;20;27;7;20;.741;2846000;0
14209;161583;4715;0;0;0;0;.00nan;0;0
14209;163528;165;74;26;2;24;.923;3600000;0
14209;36221;4715;37;22;4;18;.818;3518000;0
14209;46785;165;0;0;0;0;.00nan;0;0
14210;165532;4246;0;0;0;0;.00nan;0;0
14210;-1;4839;63;5;0;5;1.000;582000;0
14210;182097;4839;24;26;6;20;.769;3018000;0
14210;39981;4246;59;36;5;31;.861;3600000;0
14211;-1;4991;0;0;0;0;.00nan;0;0
14211;176060;1368;60;22;2;20;.909;3600000;0
14211;55660;1368;0;0;0;0;.00nan;0;0
14211;78820;4991;69;42;5;37;.881;3600000;0
14212;175651;4997;0;0;0;0;.00nan;0;0
14212;181874;4997;73;36;4;32;.889;3600000;0
14212;38037;4714;56;16;2;14;.875;2950000;0
14212;161128;4714;31;11;3;8;.727;595000;0
14213;166423;4998;0;0;0;0;.00nan;0;0
14213;-1;4919;31;27;5;22;.815;3682000;0
14213;-1;4998;36;31;6;25;.806;3682000;0
14213;-1;4919;0;0;0;0;.00nan;0;0
14214;165532;4246;100;27;0;27;1.000;3600000;0
14214;-1;4839;76;31;2;29;.935;3600000;0
14214;182097;4839;0;0;0;0;.00nan;0;0
14214;39981;4246;0;0;0;0;.00nan;0;0
14215;161583;4715;38;29;5;24;.828;3600000;0
14215;163528;165;87;32;2;30;.938;3600000;0
14215;36221;4715;0;0;0;0;.00nan;0;0
14215;46785;165;0;0;0;0;.00nan;0;0
14216;-1;4991;0;0;0;0;.00nan;0;0
14216;176060;1368;0;0;0;0;.00nan;0;0
14216;55660;1368;74;21;1;20;.952;3600000;0
14216;78820;4991;50;31;4;27;.871;3600000;0
14217;161583;4715;0;0;0;0;.00nan;0;0
14217;163528;165;82;34;2;32;.941;3600000;0
14217;36221;4715;46;31;5;26;.839;3600000;0
14217;46785;165;0;0;0;0;.00nan;0;0
14218;175651;4715;53;36;5;31;.861;3600000;0
14218;175712;4992;0;0;0;0;.00nan;0;0
14218;181874;4715;0;0;0;0;.00nan;0;0
14218;86268;4992;79;36;2;34;.944;3600000;0
14219;163528;165;46;37;6;31;.838;2909000;0
14219;166423;4998;0;0;0;0;.00nan;0;0
14219;-1;4998;53;33;5;28;.848;3600000;0
14219;46785;165;53;4;0;4;1.000;634000;0
14220;-1;4919;0;0;0;0;.00nan;0;0
14220;-1;4919;89;35;2;33;.943;3600000;0
14220;176060;1368;40;25;4;21;.840;3562000;0
14220;55660;1368;0;0;0;0;.00nan;0;0
14221;165532;4246;40;25;5;20;.800;3600000;0
14221;-1;4991;85;33;1;32;.970;3600000;0
14221;39981;4246;0;0;0;0;.00nan;0;0
14221;57100;4991;0;0;0;0;.00nan;0;0
14222;-1;4839;0;0;0;0;.00nan;0;0
14222;38037;4714;63;27;3;24;.889;3600000;0
14222;182097;4839;49;25;4;21;.840;3553000;0
14222;161128;4714;0;0;0;0;.00nan;0;0
14223;-1;4991;0;0;0;0;.00nan;0;0
14223;176060;1368;0;0;0;0;.00nan;0;0
14223;55660;1368;52;31;4;27;.871;3600000;0
14223;57100;4991;93;27;1;26;.963;3600000;0
14224;-1;4839;39;33;6;27;.818;3574000;0
14224;38037;4714;0;0;0;0;.00nan;0;0
14224;182097;4839;0;0;0;0;.00nan;0;0
14224;161128;4714;60;29;4;25;.862;3600000;0
14225;175651;4715;41;28;5;23;.821;3600000;0
14225;175712;4992;37;32;6;26;.813;2759000;0
14225;181874;4715;0;0;0;0;.00nan;0;0
14225;86268;4992;61;8;0;8;1.000;830000;0
14226;163528;165;0;0;0;0;.00nan;0;0
14226;166423;4998;44;31;5;26;.839;3546000;0
14226;-1;4998;0;0;0;0;.00nan;0;0
14226;46785;165;61;25;4;21;.840;3600000;0
14227;165532;4246;0;0;0;0;.00nan;0;0
14227;-1;4919;79;48;5;43;.896;3600000;0
14227;-1;4919;0;0;0;0;.00nan;0;0
14227;39981;4246;52;15;2;13;.867;3600000;0
14228;-1;4839;0;0;0;0;.00nan;0;0
14228;38037;4714;58;26;3;23;.885;3600000;0
14228;182097;4839;76;36;4;32;.889;3600000;0
14228;161128;4714;0;0;0;0;.00nan;0;0
14229;163528;165;46;32;5;27;.844;3600000;0
14229;175712;4992;54;12;1;11;.917;1238000;0
14229;46785;165;0;0;0;0;.00nan;0;0
14229;86268;4992;17;20;6;14;.700;2307000;0
14230;165532;4246;39;29;5;24;.828;4200000;0
14230;-1;4919;0;0;0;0;.00nan;0;0
14230;-1;4919;64;41;5;36;.878;4200000;0
14230;39981;4246;0;0;0;0;.00nan;0;0
14231;165532;4246;0;0;0;0;.00nan;0;0
14231;-1;4991;0;0;0;0;.00nan;0;0
14231;39981;4246;45;25;4;21;.840;3600000;0
14231;57100;4991;54;38;5;33;.868;3556000;0
14232;166423;4998;0;0;0;0;.00nan;0;0
14232;-1;4998;51;34;4;30;.882;3514000;0
14232;175651;4715;71;28;2;26;.929;3600000;0
14232;181874;4715;0;0;0;0;.00nan;0;0
14233;161583;4997;49;1;0;1;1.000;266000;0
14233;163528;165;82;34;2;32;.941;3600000;0
14233;179411;4997;17;17;6;11;.647;3334000;0
14233;46785;165;0;0;0;0;.00nan;0;0
14234;-1;4919;52;35;5;30;.857;3600000;0
14234;-1;4919;0;0;0;0;.00nan;0;0
14234;38037;4714;85;29;1;28;.966;3600000;0
14234;161128;4714;0;0;0;0;.00nan;0;0
14235;176060;1368;49;18;3;15;.833;3600000;0
14235;-1;4839;0;0;0;0;.00nan;0;0
14235;182097;4839;49;41;6;35;.854;3600000;0
14235;55660;1368;0;0;0;0;.00nan;0;0
14236;165532;4246;58;34;4;30;.882;3600000;0
14236;-1;4991;0;0;0;0;.00nan;0;0
14236;39981;4246;0;0;0;0;.00nan;0;0
14236;57100;4991;17;21;6;15;.714;3519000;0
14237;-1;4919;0;0;0;0;.00nan;0;0
14237;-1;4919;45;48;7;41;.854;3600000;0
14237;38037;4714;35;17;4;13;.765;3600000;0
14237;161128;4714;0;0;0;0;.00nan;0;0
14238;166423;4998;59;31;4;27;.871;3594000;0
14238;-1;4998;0;0;0;0;.00nan;0;0
14238;175651;4715;0;0;0;0;.00nan;0;0
14238;181874;4715;54;16;3;13;.813;3600000;0
14239;163528;165;77;37;3;34;.919;3600000;0
14239;179411;4997;42;26;4;22;.846;3571000;0
14239;-1;4997;0;0;0;0;.00nan;0;0
14239;46785;165;0;0;0;0;.00nan;0;0
14240;165532;4246;0;0;0;0;.00nan;0;0
14240;-1;4991;0;0;0;0;.00nan;0;0
14240;39981;4246;63;40;4;36;.900;4180000;0
14240;57100;4991;81;33;3;30;.909;4180000;0
14241;163528;165;81;31;2;29;.935;3600000;0
14241;179411;4997;21;22;6;16;.727;3267000;0
14241;-1;4997;57;3;0;3;1.000;333000;0
14241;46785;165;0;0;0;0;.00nan;0;0
14242;175651;4715;67;25;2;23;.920;3600000;0
14242;175712;4992;50;3;0;3;1.000;343000;0
14242;181874;4715;0;0;0;0;.00nan;0;0
14242;86268;4992;29;27;6;21;.778;3257000;0
14243;-1;4991;0;0;0;0;.00nan;0;0
14243;-1;4839;0;0;0;0;.00nan;0;0
14243;182097;4839;59;31;3;28;.903;3600000;0
14243;57100;4991;42;24;4;20;.833;3563000;0
14244;166423;4998;0;0;0;0;.00nan;0;0
14244;-1;4998;97;31;1;30;.968;3600000;0
14244;175712;4992;0;0;0;0;.00nan;0;0
14244;86268;4992;43;33;5;28;.848;3600000;0
14245;-1;4919;55;34;4;30;.882;3600000;0
14245;-1;4919;0;0;0;0;.00nan;0;0
14245;179411;4997;73;19;1;18;.947;3600000;0
14245;-1;4997;0;0;0;0;.00nan;0;0
14246;175651;4715;40;35;6;29;.829;2933000;0
14246;181874;4715;56;6;1;5;.833;768000;0
14246;38037;4714;0;0;0;0;.00nan;0;0
14246;161128;4714;39;29;6;23;.793;3701000;0
14247;165532;4246;0;0;0;0;.00nan;0;0
14247;176060;1368;43;29;5;24;.828;3600000;0
14247;39981;4246;85;22;1;21;.955;3600000;0
14247;55660;1368;0;0;0;0;.00nan;0;0
14248;165532;4246;63;44;4;40;.909;3541000;0
14248;-1;4991;0;0;0;0;.00nan;0;0
14248;39981;4246;0;0;0;0;.00nan;0;0
14248;57100;4991;57;23;3;20;.870;3600000;0
14249;175651;4715;45;5;1;4;.800;626000;0
14249;181874;4715;21;24;6;18;.750;2974000;0
14249;38037;4714;65;23;3;20;.870;3600000;0
14249;161128;4714;0;0;0;0;.00nan;0;0
14250;163528;165;84;38;3;35;.921;3600000;0
14250;175712;4992;34;25;5;20;.800;3578000;0
14250;46785;165;0;0;0;0;.00nan;0;0
14250;86268;4992;0;0;0;0;.00nan;0;0
14251;-1;4919;0;0;0;0;.00nan;0;0
14251;-1;4919;68;45;5;40;.889;3744000;0
14251;179411;4997;51;29;4;25;.862;3744000;0
14251;-1;4997;0;0;0;0;.00nan;0;0
14252;176060;1368;0;0;0;0;.00nan;0;0
14252;-1;4839;68;35;4;31;.886;3901000;0
14252;182097;4839;0;0;0;0;.00nan;0;0
14252;55660;1368;58;23;3;20;.870;3901000;0
14253;-1;4919;78;37;3;34;.919;3600000;0
14253;-1;4919;0;0;0;0;.00nan;0;0
14253;38037;4714;0;0;0;0;.00nan;0;0
14253;161128;4714;40;21;4;17;.810;3551000;0
14254;165532;4246;48;0;0;0;.00nan;269000;0
14254;-1;4991;0;0;0;0;.00nan;0;0
14254;39981;4246;26;26;6;20;.769;3331000;0
14254;57100;4991;91;23;1;22;.957;3600000;0
14255;179411;4997;66;34;3;31;.912;3589000;0
14255;175651;4715;72;30;2;28;.933;3600000;0
14255;-1;4997;0;0;0;0;.00nan;0;0
14255;181874;4715;0;0;0;0;.00nan;0;0
14256;176060;1368;65;19;1;18;.947;3600000;0
14256;-1;4839;49;14;2;12;.857;1574000;0
14256;182097;4839;34;14;4;10;.714;2026000;0
14256;55660;1368;0;0;0;0;.00nan;0;0
14257;175712;4992;0;0;0;0;.00nan;0;0
14257;176060;1368;74;27;2;25;.926;3600000;0
14257;55660;1368;0;0;0;0;.00nan;0;0
14257;86268;4992;76;34;3;31;.912;3600000;0
14258;179411;4997;59;27;3;24;.889;3600000;0
14258;-1;4997;0;0;0;0;.00nan;0;0
14258;38037;4714;0;0;0;0;.00nan;0;0
14258;161128;4714;84;23;1;22;.957;3600000;0
14259;163528;165;48;21;3;18;.857;3600000;0
14259;166423;4998;0;0;0;0;.00nan;0;0
14259;-1;4998;65;20;2;18;.900;3600000;0
14259;46785;165;0;0;0;0;.00nan;0;0
14260;-1;4991;0;0;0;0;.00nan;0;0
14260;-1;4919;49;37;5;32;.865;3600000;0
14260;-1;4919;0;0;0;0;.00nan;0;0
14260;57100;4991;66;18;1;17;.944;3600000;0
14261;165532;4246;73;24;2;22;.917;3600000;0
14261;-1;4839;68;30;3;27;.900;3600000;0
14261;182097;4839;0;0;0;0;.00nan;0;0
14261;39981;4246;0;0;0;0;.00nan;0;0
14262;179411;4997;0;0;0;0;.00nan;0;0
14262;-1;4997;58;32;4;28;.875;3600000;0
14262;38037;4714;72;37;3;34;.919;3600000;0
14262;161128;4714;0;0;0;0;.00nan;0;0
14263;-1;4991;0;0;0;0;.00nan;0;0
14263;-1;4919;45;11;2;9;.818;1631000;0
14263;-1;4919;34;18;5;13;.722;1969000;0
14263;57100;4991;85;28;2;26;.929;3600000;0
14264;165532;4246;0;0;0;0;.00nan;0;0
14264;-1;4839;0;0;0;0;.00nan;0;0
14264;182097;4839;85;37;3;34;.919;3600000;0
14264;39981;4246;23;27;6;21;.778;3600000;0
14265;175712;4992;86;37;2;35;.946;3600000;0
14265;176060;1368;0;0;0;0;.00nan;0;0
14265;55660;1368;36;26;5;21;.808;3600000;0
14265;86268;4992;0;0;0;0;.00nan;0;0
14266;163528;165;47;27;5;22;.815;3560000;0
14266;175651;4715;62;28;3;25;.893;3600000;0
14266;181874;4715;0;0;0;0;.00nan;0;0
14266;46785;165;0;0;0;0;.00nan;0;0
14267;179411;4997;93;26;1;25;.962;3600000;0
14267;-1;4997;0;0;0;0;.00nan;0;0
14267;38037;4714;0;0;0;0;.00nan;0;0
14267;161128;4714;44;33;5;28;.848;3600000;0
14268;175651;4715;0;0;0;0;.00nan;0;0
14268;175712;4992;0;0;0;0;.00nan;0;0
14268;181874;4715;52;30;4;26;.867;4186000;0
14268;86268;4992;62;38;4;34;.895;4200000;0
14269;165532;4246;68;29;3;26;.897;3598000;0
14269;-1;4839;75;26;1;25;.962;3600000;0
14269;182097;4839;0;0;0;0;.00nan;0;0
14269;39981;4246;0;0;0;0;.00nan;0;0
14270;163528;165;73;33;3;30;.909;3600000;0
14270;166423;4998;59;19;2;17;.895;3600000;0
14270;-1;4998;0;0;0;0;.00nan;0;0
14270;46785;165;0;0;0;0;.00nan;0;0
14271;-1;4991;0;0;0;0;.00nan;0;0
14271;-1;4919;50;23;3;20;.870;3600000;0
14271;-1;4919;0;0;0;0;.00nan;0;0
14271;57100;4991;24;36;8;28;.778;3600000;0
14272;175651;4715;47;39;7;32;.821;3079000;0
14272;175712;4992;0;0;0;0;.00nan;0;0
14272;181874;4715;57;6;0;6;1.000;521000;0
14272;86268;4992;60;22;3;19;.864;3600000;0
14273;166423;4998;0;0;0;0;.00nan;0;0
14273;-1;4998;50;36;6;30;.833;3600000;0
14273;179411;4997;0;0;0;0;.00nan;0;0
14273;-1;4997;68;30;3;27;.900;3600000;0
14274;163528;165;63;37;4;33;.892;4028000;0
14274;-1;4919;40;30;5;25;.833;4028000;0
14274;-1;4919;0;0;0;0;.00nan;0;0
14274;46785;165;0;0;0;0;.00nan;0;0
14275;165532;4246;33;30;5;25;.833;3600000;0
14275;-1;4991;0;0;0;0;.00nan;0;0
14275;39981;4246;0;0;0;0;.00nan;0;0
14275;57100;4991;80;32;2;30;.938;3600000;0
14276;-1;4839;46;42;6;36;.857;3600000;0
14276;38037;4714;54;25;3;22;.880;3600000;0
14276;182097;4839;0;0;0;0;.00nan;0;0
14276;161128;4714;0;0;0;0;.00nan;0;0
14277;165532;4246;0;0;0;0;.00nan;0;0
14277;-1;4991;0;0;0;0;.00nan;0;0
14277;39981;4246;69;25;3;22;.880;3600000;0
14277;57100;4991;47;32;4;28;.875;3600000;0
14278;166423;4998;41;31;5;26;.839;3600000;0
14278;-1;4998;0;0;0;0;.00nan;0;0
14278;179411;4997;45;10;2;8;.800;880000;0
14278;-1;4997;10;18;6;12;.667;2720000;0
14279;163528;165;69;39;4;35;.897;3600000;0
14279;-1;4919;0;0;0;0;.00nan;0;0
14279;-1;4919;38;24;5;19;.792;3565000;0
14279;46785;165;0;0;0;0;.00nan;0;0
14280;-1;4839;0;0;0;0;.00nan;0;0
14280;38037;4714;0;0;0;0;.00nan;0;0
14280;182097;4839;47;45;7;38;.844;3600000;0
14280;161128;4714;58;22;2;20;.909;3600000;0
14281;175651;4715;55;3;0;3;1.000;313000;0
14281;175712;4992;48;29;4;25;.862;3600000;0
14281;181874;4715;21;24;6;18;.750;3265000;0
14281;86268;4992;0;0;0;0;.00nan;0;0
14282;175651;4715;46;27;4;23;.852;3600000;0
14282;175712;4992;0;0;0;0;.00nan;0;0
14282;181874;4715;0;0;0;0;.00nan;0;0
14282;86268;4992;87;29;1;28;.966;3600000;0
14283;-1;4839;82;28;1;27;.964;3600000;0
14283;38037;4714;42;26;4;22;.846;3600000;0
14283;182097;4839;0;0;0;0;.00nan;0;0
14283;161128;4714;0;0;0;0;.00nan;0;0
14284;179411;4997;0;0;0;0;.00nan;0;0
14284;-1;4997;59;20;2;18;.900;3544000;0
14284;-1;4839;0;0;0;0;.00nan;0;0
14284;182097;4839;96;34;1;33;.971;3600000;0
14285;165532;4246;49;9;1;8;.889;929000;0
14285;176060;1368;72;26;2;24;.923;3600000;0
14285;39981;4246;37;31;6;25;.806;2671000;0
14285;55660;1368;0;0;0;0;.00nan;0;0
14286;179411;4997;0;0;0;0;.00nan;0;0
14286;175712;4992;0;0;0;0;.00nan;0;0
14286;-1;4997;82;34;2;32;.941;3600000;0
14286;86268;4992;66;49;6;43;.878;3600000;0
14287;163528;165;70;44;4;40;.909;3600000;0
14287;175651;4715;71;20;1;19;.950;3600000;0
14287;181874;4715;0;0;0;0;.00nan;0;0
14287;46785;165;0;0;0;0;.00nan;0;0
14288;-1;4839;20;32;8;24;.750;3251000;0
14288;38037;4714;0;0;0;0;.00nan;0;0
14288;182097;4839;53;4;0;4;1.000;349000;0
14288;161128;4714;70;24;2;22;.917;3600000;0
14289;-1;4991;0;0;0;0;.00nan;0;0
14289;-1;4919;5;7;5;2;.286;1041000;0
14289;-1;4919;56;19;2;17;.895;2559000;0
14289;57100;4991;90;27;1;26;.963;3600000;0
14290;165532;4246;74;24;1;23;.958;3600000;0
14290;176060;1368;0;0;0;0;.00nan;0;0
14290;39981;4246;0;0;0;0;.00nan;0;0
14290;55660;1368;88;41;2;39;.951;3545000;0
14291;175712;4992;22;17;5;12;.706;1097000;0
14291;38037;4714;53;21;3;18;.857;3600000;0
14291;86268;4992;64;31;3;28;.903;2503000;0
14291;161128;4714;0;0;0;0;.00nan;0;0
14292;166423;4998;0;0;0;0;.00nan;0;0
14292;-1;4998;43;25;4;21;.840;4061000;0
14292;175651;4715;0;0;0;0;.00nan;0;0
14292;181874;4715;43;32;5;27;.844;4061000;0
14293;-1;4991;0;0;0;0;.00nan;0;0
14293;-1;4919;0;0;0;0;.00nan;0;0
14293;-1;4919;31;34;6;28;.824;3600000;0
14293;57100;4991;81;29;2;27;.931;3600000;0
14294;179411;4997;68;39;3;36;.923;3600000;0
14294;-1;4997;0;0;0;0;.00nan;0;0
14294;-1;4839;31;10;3;7;.700;986000;0
14294;182097;4839;29;28;6;22;.786;2614000;0
14295;165532;4246;0;0;0;0;.00nan;0;0
14295;176060;1368;23;28;6;22;.786;3600000;0
14295;39981;4246;66;22;2;20;.909;3600000;0
14295;55660;1368;0;0;0;0;.00nan;0;0
14296;163528;165;69;25;2;23;.920;3600000;0
14296;166423;4998;32;25;6;19;.760;3600000;0
14296;-1;4998;0;0;0;0;.00nan;0;0
14296;46785;165;0;0;0;0;.00nan;0;0
14297;165532;4246;35;27;5;22;.815;3600000;0
14297;176060;1368;0;0;0;0;.00nan;0;0
14297;39981;4246;0;0;0;0;.00nan;0;0
14297;55660;1368;42;35;6;29;.829;3577000;0
14298;166423;4998;0;0;0;0;.00nan;0;0
14298;-1;4998;67;27;2;25;.926;3600000;0
14298;175712;4992;0;0;0;0;.00nan;0;0
14298;86268;4992;51;33;4;29;.879;3516000;0
14299;163528;165;53;29;4;25;.862;3584000;0
14299;175712;4992;0;0;0;0;.00nan;0;0
14299;46785;165;0;0;0;0;.00nan;0;0
14299;86268;4992;59;22;2;20;.909;3600000;0
14300;166423;4998;0;0;0;0;.00nan;0;0
14300;-1;4998;43;32;5;27;.844;3610000;0
14300;175651;4715;46;33;6;27;.818;3610000;0
14300;181874;4715;0;0;0;0;.00nan;0;0
14301;-1;4919;0;0;0;0;.00nan;0;0
14301;-1;4919;65;41;5;36;.878;3600000;0
14301;-1;4839;0;0;0;0;.00nan;0;0
14301;182097;4839;61;22;2;20;.909;3600000;0
14302;-1;4991;0;0;0;0;.00nan;0;0
14302;176060;1368;0;0;0;0;.00nan;0;0
14302;55660;1368;78;28;2;26;.929;3586000;0
14302;57100;4991;77;26;1;25;.962;3600000;0
14303;165532;4246;0;0;0;0;.00nan;0;0
14303;179411;4997;0;0;0;0;.00nan;0;0
14303;-1;4997;93;37;2;35;.946;3600000;0
14303;39981;4246;61;35;4;31;.886;3555000;0
14304;163528;165;71;26;3;23;.885;3600000;0
14304;175712;4992;38;30;6;24;.800;3600000;0
14304;46785;165;0;0;0;0;.00nan;0;0
14304;86268;4992;0;0;0;0;.00nan;0;0
14305;-1;4919;8;15;6;9;.600;1693000;0
14305;-1;4919;57;14;2;12;.857;1907000;0
14305;-1;4839;68;35;3;32;.914;3600000;0
14305;182097;4839;0;0;0;0;.00nan;0;0
14306;166423;4998;57;33;4;29;.879;3600000;0
14306;-1;4998;0;0;0;0;.00nan;0;0
14306;175651;4715;31;23;5;18;.783;3562000;0
14306;181874;4715;0;0;0;0;.00nan;0;0
14307;165532;4246;49;22;3;19;.864;3600000;0
14307;179411;4997;0;0;0;0;.00nan;0;0
14307;-1;4997;93;20;0;20;1.000;3600000;0
14307;39981;4246;0;0;0;0;.00nan;0;0
14308;-1;4991;70;26;2;24;.923;3600000;0
14308;176060;1368;63;29;3;26;.897;3544000;0
14308;55660;1368;0;0;0;0;.00nan;0;0
14308;57100;4991;0;0;0;0;.00nan;0;0
14309;163528;165;53;4;0;4;1.000;777000;0
14309;166423;4998;0;0;0;0;.00nan;0;0
14309;-1;4998;47;26;4;22;.846;3600000;0
14309;46785;165;24;26;6;20;.769;2804000;0
14310;176060;1368;0;0;0;0;.00nan;0;0
14310;-1;4839;0;0;0;0;.00nan;0;0
14310;182097;4839;81;35;2;33;.943;3600000;0
14310;55660;1368;49;29;5;24;.828;3600000;0
14311;-1;4991;0;0;0;0;.00nan;0;0
14311;-1;4839;0;0;0;0;.00nan;0;0
14311;182097;4839;34;40;6;34;.850;3600000;0
14311;57100;4991;63;38;4;34;.895;3600000;0
14312;165532;4246;57;28;3;25;.893;3561000;0
14312;176060;1368;0;0;0;0;.00nan;0;0
14312;39981;4246;0;0;0;0;.00nan;0;0
14312;55660;1368;66;23;2;21;.913;3600000;0
14313;179411;4997;51;9;1;8;.889;1236000;0
14313;-1;4997;35;48;8;40;.833;2364000;0
14313;38037;4714;17;15;5;10;.667;3600000;0
14313;161128;4714;0;0;0;0;.00nan;0;0
14314;-1;4919;0;0;0;0;.00nan;0;0
14314;-1;4919;81;37;3;34;.919;3546000;0
14314;175651;4715;74;31;2;29;.935;3600000;0
14314;181874;4715;0;0;0;0;.00nan;0;0
14315;163528;165;100;31;1;30;.968;3600000;0
14315;175712;4992;0;0;0;0;.00nan;0;0
14315;46785;165;0;0;0;0;.00nan;0;0
14315;86268;4992;49;35;5;30;.857;3600000;0
14316;-1;4991;70;30;4;26;.867;3600000;0
14316;-1;4839;75;23;1;22;.957;3600000;0
14316;182097;4839;0;0;0;0;.00nan;0;0
14316;57100;4991;0;0;0;0;.00nan;0;0
14317;165532;4246;0;0;0;0;.00nan;0;0
14317;176060;1368;63;32;4;28;.875;3600000;0
14317;39981;4246;53;33;5;28;.848;3561000;0
14317;55660;1368;0;0;0;0;.00nan;0;0
14318;179411;4997;54;4;0;4;1.000;614000;0
14318;-1;4997;27;25;6;19;.760;2986000;0
14318;38037;4714;86;26;1;25;.962;3600000;0
14318;161128;4714;0;0;0;0;.00nan;0;0
14319;-1;4919;75;32;3;29;.906;3912000;0
14319;-1;4919;0;0;0;0;.00nan;0;0
14319;175651;4715;78;36;2;34;.944;3912000;0
14319;181874;4715;0;0;0;0;.00nan;0;0
14320;166423;4998;0;0;0;0;.00nan;0;0
14320;-1;4998;68;37;4;33;.892;3600000;0
14320;175712;4992;19;19;5;14;.737;3544000;0
14320;86268;4992;0;0;0;0;.00nan;0;0
14321;-1;4991;0;0;0;0;.00nan;0;0
14321;-1;4839;0;0;0;0;.00nan;0;0
14321;182097;4839;100;27;0;27;1.000;3600000;0
14321;57100;4991;55;25;3;22;.880;3600000;0
14322;165532;4246;58;33;3;30;.909;4200000;0
14322;176060;1368;0;0;0;0;.00nan;0;0
14322;39981;4246;0;0;0;0;.00nan;0;0
14322;55660;1368;74;26;3;23;.885;4200000;0
14324;163528;165;65;38;5;33;.868;3600000;0
14324;-1;4997;27;25;6;19;.760;3600000;0
14324;181874;4997;0;0;0;0;.00nan;0;0
14324;46785;165;0;0;0;0;.00nan;0;0
14326;-1;4991;0;0;0;0;.00nan;0;0
14326;38037;4714;99;44;1;43;.977;3600000;0
14326;57852;4991;47;22;3;19;.864;3554000;0
14326;161128;4714;0;0;0;0;.00nan;0;0
14328;165532;4246;0;0;0;0;.00nan;0;0
14328;38124;4246;65;38;4;34;.895;3600000;0
14328;182097;4839;55;4;0;4;1.000;579000;0
14328;91212;4839;19;19;6;13;.684;2946000;0
14330;161583;4715;50;3;0;3;1.000;487000;0
14330;176060;1368;61;29;3;26;.897;3600000;0
14330;36221;4715;39;40;7;33;.825;3113000;0
14330;55660;1368;0;0;0;0;.00nan;0;0
14332;166423;4998;0;0;0;0;.00nan;0;0
14332;-1;4998;57;31;4;27;.871;3576000;0
14332;175712;4992;0;0;0;0;.00nan;0;0
14332;86268;4992;88;54;3;51;.944;3600000;0
2213;-1;4839;0;0;0;0;.00nan;0;0
2213;38037;4714;37;26;5;21;.808;3555000;0
2213;182097;4839;76;43;4;39;.907;3600000;0
2213;161128;4714;0;0;0;0;.00nan;0;0
2214;-1;4991;53;19;2;17;.895;3023000;0
2214;176060;1368;72;44;4;40;.909;3600000;0
2214;55660;1368;0;0;0;0;.00nan;0;0
2214;57100;4991;26;5;3;2;.400;551000;0
2215;163528;165;75;37;4;33;.892;3531000;0
2215;175651;4715;73;23;2;21;.913;3600000;0
2215;181874;4715;0;0;0;0;.00nan;0;0
2215;46785;165;0;0;0;0;.00nan;0;0
2216;166423;4998;0;0;0;0;.00nan;0;0
2216;-1;4998;56;33;4;29;.879;3519000;0
2216;175712;4992;0;0;0;0;.00nan;0;0
2216;86268;4992;82;30;2;28;.933;3600000;0
2217;-1;4839;0;0;0;0;.00nan;0;0
2217;38037;4714;73;28;3;25;.893;3600000;0
2217;182097;4839;33;31;6;25;.806;3600000;0
2217;161128;4714;0;0;0;0;.00nan;0;0
2218;-1;4991;0;0;0;0;.00nan;0;0
2218;176060;1368;40;36;6;30;.833;3231000;0
2218;55660;1368;54;1;0;1;1.000;298000;0
2218;57100;4991;37;22;4;18;.818;3600000;0
2219;163528;165;75;28;2;26;.929;3600000;0
2219;175651;4715;52;27;3;24;.889;3571000;0
2219;181874;4715;0;0;0;0;.00nan;0;0
2219;46785;165;0;0;0;0;.00nan;0;0
2220;166423;4998;0;0;0;0;.00nan;0;0
2220;-1;4998;68;23;2;21;.913;3600000;0
2220;175712;4992;0;0;0;0;.00nan;0;0
2220;86268;4992;36;28;5;23;.821;3600000;0
2330;-1;4839;0;0;0;0;.00nan;0;0
2330;38037;4714;78;21;1;20;.952;3600000;0
2330;182097;4839;67;31;4;27;.871;3600000;0
2330;161128;4714;0;0;0;0;.00nan;0;0
2331;-1;4991;0;0;0;0;.00nan;0;0
2331;176060;1368;69;23;1;22;.957;3600000;0
2331;55660;1368;0;0;0;0;.00nan;0;0
2331;57100;4991;34;24;6;18;.750;3600000;0
2332;163528;165;74;31;2;29;.935;3600000;0
2332;175651;4715;74;34;3;31;.912;3600000;0
2332;181874;4715;0;0;0;0;.00nan;0;0
2332;46785;165;0;0;0;0;.00nan;0;0
2333;166423;4998;0;0;0;0;.00nan;0;0
2333;-1;4998;50;28;4;24;.857;3600000;0
2333;175712;4992;0;0;0;0;.00nan;0;0
2333;86268;4992;100;27;0;27;1.000;3600000;0
3;176060;1368;42;34;6;28;.824;3600000;0
3;38037;4714;66;33;3;30;.909;3600000;0
3;55660;1368;0;0;0;0;.00nan;0;0
3;161128;4714;0;0;0;0;.00nan;0;0
4;163528;165;80;27;2;25;.926;3600000;0
4;175712;4992;0;0;0;0;.00nan;0;0
4;46785;165;0;0;0;0;.00nan;0;0
4;86268;4992;49;32;5;27;.844;3600000;0
5;176060;1368;63;34;3;31;.912;4397000;0
5;38037;4714;51;26;4;22;.846;4397000;0
5;55660;1368;0;0;0;0;.00nan;0;0
5;161128;4714;0;0;0;0;.00nan;0;0
6;163528;165;76;28;3;25;.893;3600000;0
6;175712;4992;0;0;0;0;.00nan;0;0
6;46785;165;0;0;0;0;.00nan;0;0
6;86268;4992;35;28;5;23;.821;3579000;0
105;176060;1368;64;25;3;22;.880;3600000;0
105;38037;4714;87;28;1;27;.964;3600000;0
105;55660;1368;0;0;0;0;.00nan;0;0
105;161128;4714;0;0;0;0;.00nan;0;0
113;163528;165;62;44;6;38;.864;3600000;0
113;38037;4714;65;18;2;16;.889;3600000;0
113;46785;165;0;0;0;0;.00nan;0;0
113;161128;4714;0;0;0;0;.00nan;0;0
114;163528;165;79;34;3;31;.912;3826000;0
114;38037;4714;61;31;4;27;.871;3826000;0
114;46785;165;0;0;0;0;.00nan;0;0
114;161128;4714;0;0;0;0;.00nan;0;0
155;163528;165;70;34;3;31;.912;4049000;0
155;38037;4714;64;33;4;29;.879;4049000;0
155;46785;165;0;0;0;0;.00nan;0;0
155;161128;4714;0;0;0;0;.00nan;0;0
14333;59614;3916;0;0;0;0;.00nan;0;0
14333;64736;3916;72;24;1;23;.958;3600000;0
14333;91414;171;46;34;5;29;.853;3600000;0
14333;92313;171;0;0;0;0;.00nan;0;0
14334;35172;170;0;0;0;0;.00nan;0;0
14334;36719;4247;0;0;0;0;.00nan;0;0
14334;37897;170;93;19;0;19;1.000;3600000;0
14334;44405;4247;78;31;2;29;.935;3547000;0
14335;-1;169;0;0;0;0;.00nan;0;0
14335;44134;175;0;0;0;0;.00nan;0;0
14335;44561;175;68;27;3;24;.889;3710000;0
14335;85354;169;50;31;4;27;.871;3710000;0
14336;35172;170;0;0;0;0;.00nan;0;0
14336;37897;170;52;9;1;8;.889;3900000;0
14336;47547;167;0;0;0;0;.00nan;0;0
14336;65125;167;100;56;1;55;.982;3900000;0
14337;173918;174;83;36;2;34;.944;3600000;0
14337;36719;4247;67;35;3;32;.914;3141000;0
14337;44405;4247;20;9;4;5;.556;459000;0
14337;57564;174;0;0;0;0;.00nan;0;0
14338;-1;169;0;0;0;0;.00nan;0;0
14338;36675;175;68;30;3;27;.900;3209000;0
14338;44134;175;30;9;3;6;.667;391000;0
14338;85354;169;73;36;3;33;.917;3600000;0
14339;2136;1527;0;0;0;0;.00nan;0;0
14339;57155;172;0;0;0;0;.00nan;0;0
14339;57215;172;79;28;1;27;.964;3600000;0
14339;85709;1527;47;32;5;27;.844;3600000;0
14340;59614;3916;54;21;3;18;.857;3600000;0
14340;64736;3916;0;0;0;0;.00nan;0;0
14340;91414;171;89;37;1;36;.973;3600000;0
14340;92313;171;0;0;0;0;.00nan;0;0
14341;-1;169;0;0;0;0;.00nan;0;0
14341;35172;170;0;0;0;0;.00nan;0;0
14341;37897;170;65;35;4;31;.886;3668000;0
14341;85354;169;75;34;3;31;.912;3668000;0
14342;173918;174;0;0;0;0;.00nan;0;0
14342;57155;172;0;0;0;0;.00nan;0;0
14342;57215;172;40;26;5;21;.808;3543000;0
14342;57564;174;47;19;3;16;.842;3600000;0
14343;36675;175;0;0;0;0;.00nan;0;0
14343;44134;175;79;40;3;37;.925;3600000;0
14343;91414;171;68;34;4;30;.882;3552000;0
14343;92313;171;0;0;0;0;.00nan;0;0
14344;36719;4247;50;25;4;21;.840;3900000;0
14344;44405;4247;0;0;0;0;.00nan;0;0
14344;47547;167;0;0;0;0;.00nan;0;0
14344;65125;167;88;41;4;37;.902;3900000;0
14345;2136;1527;0;0;0;0;.00nan;0;0
14345;59614;3916;62;17;1;16;.941;3600000;0
14345;64736;3916;0;0;0;0;.00nan;0;0
14345;85709;1527;81;37;2;35;.946;3588000;0
14346;36675;175;80;35;3;32;.914;3600000;0
14346;44134;175;0;0;0;0;.00nan;0;0
14346;91414;171;0;0;0;0;.00nan;0;0
14346;92313;171;100;29;0;29;1.000;3600000;0
14347;36719;4247;0;0;0;0;.00nan;0;0
14347;44405;4247;30;17;4;13;.765;3900000;0
14347;47547;167;85;44;4;40;.909;3900000;0
14347;65125;167;0;0;0;0;.00nan;0;0
14348;-1;169;74;42;4;38;.905;3600000;0
14348;35172;170;63;17;1;16;.941;3600000;0
14348;37897;170;0;0;0;0;.00nan;0;0
14348;85354;169;0;0;0;0;.00nan;0;0
14349;2136;1527;43;31;5;26;.839;3708000;0
14349;59614;3916;77;35;4;31;.886;3708000;0
14349;64736;3916;0;0;0;0;.00nan;0;0
14349;85709;1527;0;0;0;0;.00nan;0;0
14350;2136;1527;0;0;0;0;.00nan;0;0
14350;57155;172;0;0;0;0;.00nan;0;0
14350;57215;172;74;29;3;26;.897;3577000;0
14350;85709;1527;95;43;2;41;.953;3600000;0
14351;35172;170;0;0;0;0;.00nan;0;0
14351;36719;4247;57;28;4;24;.857;3600000;0
14351;37897;170;82;26;1;25;.962;3600000;0
14351;44405;4247;0;0;0;0;.00nan;0;0
14352;-1;169;0;0;0;0;.00nan;0;0
14352;85354;169;82;45;4;41;.911;3558000;0
14352;91414;171;76;27;2;25;.926;3600000;0
14352;92313;171;0;0;0;0;.00nan;0;0
14353;173918;174;55;23;2;21;.913;3559000;0
14353;36675;175;0;0;0;0;.00nan;0;0
14353;44134;175;72;15;1;14;.933;3600000;0
14353;57564;174;0;0;0;0;.00nan;0;0
14354;47547;167;0;0;0;0;.00nan;0;0
14354;59614;3916;63;17;2;15;.882;2440000;0
14354;64736;3916;32;16;4;12;.750;1160000;0
14354;65125;167;64;23;3;20;.870;3600000;0
14355;2136;1527;0;0;0;0;.00nan;0;0
14355;57155;172;94;20;0;20;1.000;3600000;0
14355;57215;172;0;0;0;0;.00nan;0;0
14355;85709;1527;83;50;4;46;.920;3600000;0
14356;35172;170;52;41;5;36;.878;3600000;0
14356;36719;4247;0;0;0;0;.00nan;0;0
14356;37897;170;0;0;0;0;.00nan;0;0
14356;44405;4247;71;20;1;19;.950;3600000;0
14357;-1;169;58;33;4;29;.879;3515000;0
14357;85354;169;0;0;0;0;.00nan;0;0
14357;91414;171;0;0;0;0;.00nan;0;0
14357;92313;171;65;23;2;21;.913;3600000;0
14358;173918;174;0;0;0;0;.00nan;0;0
14358;36675;175;62;28;2;26;.929;3513000;0
14358;44134;175;0;0;0;0;.00nan;0;0
14358;57564;174;100;40;0;40;1.000;3600000;0
14359;47547;167;56;27;4;23;.852;3584000;0
14359;59614;3916;74;33;2;31;.939;3600000;0
14359;64736;3916;0;0;0;0;.00nan;0;0
14359;65125;167;0;0;0;0;.00nan;0;0
14360;47547;167;0;0;0;0;.00nan;0;0
14360;65125;167;88;26;1;25;.962;3900000;0
14360;91414;171;100;43;1;42;.977;3900000;0
14360;92313;171;0;0;0;0;.00nan;0;0
14361;-1;169;0;0;0;0;.00nan;0;0
14361;36719;4247;96;37;1;36;.973;3600000;0
14361;44405;4247;0;0;0;0;.00nan;0;0
14361;85354;169;68;35;3;32;.914;3558000;0
14362;35172;170;0;0;0;0;.00nan;0;0
14362;37897;170;89;19;0;19;1.000;3600000;0
14362;47547;167;38;29;6;23;.793;2787000;0
14362;65125;167;55;5;0;5;1.000;813000;0
14363;173918;174;0;0;0;0;.00nan;0;0
14363;57155;172;66;25;2;23;.920;3600000;0
14363;57215;172;0;0;0;0;.00nan;0;0
14363;57564;174;39;22;4;18;.818;3543000;0
14364;2136;1527;0;0;0;0;.00nan;0;0
14364;85709;1527;88;48;3;45;.938;3600000;0
14364;91414;171;0;0;0;0;.00nan;0;0
14364;92313;171;100;28;0;28;1.000;3600000;0
14365;-1;169;75;25;1;24;.960;3569000;0
14365;47547;167;0;0;0;0;.00nan;0;0
14365;65125;167;98;29;0;29;1.000;3600000;0
14365;85354;169;0;0;0;0;.00nan;0;0
14366;35172;170;0;0;0;0;.00nan;0;0
14366;36675;175;0;0;0;0;.00nan;0;0
14366;37897;170;92;37;2;35;.946;3900000;0
14366;44134;175;80;32;2;30;.938;3900000;0
14367;36719;4247;0;0;0;0;.00nan;0;0
14367;44405;4247;73;38;3;35;.921;3541000;0
14367;59614;3916;0;0;0;0;.00nan;0;0
14367;64736;3916;91;43;2;41;.953;3600000;0
14368;2136;1527;88;45;3;42;.933;3900000;0
14368;85709;1527;0;0;0;0;.00nan;0;0
14368;91414;171;71;24;3;21;.875;3900000;0
14368;92313;171;0;0;0;0;.00nan;0;0
14369;173918;174;64;25;2;23;.920;3600000;0
14369;36719;4247;53;29;4;25;.862;3547000;0
14369;44405;4247;0;0;0;0;.00nan;0;0
14369;57564;174;0;0;0;0;.00nan;0;0
14370;-1;169;0;0;0;0;.00nan;0;0
14370;47547;167;0;0;0;0;.00nan;0;0
14370;65125;167;88;26;1;25;.962;3600000;0
14370;85354;169;75;27;2;25;.926;3600000;0
14371;36675;175;35;27;6;21;.778;2538000;0
14371;44134;175;63;15;1;14;.933;1062000;0
14371;59614;3916;99;36;1;35;.972;3600000;0
14371;64736;3916;0;0;0;0;.00nan;0;0
14372;173918;174;0;0;0;0;.00nan;0;0
14372;57155;172;0;0;0;0;.00nan;0;0
14372;57215;172;85;31;1;30;.968;3600000;0
14372;57564;174;78;27;2;25;.926;3600000;0
14373;37786;169;0;0;0;0;.00nan;0;0
14373;85354;169;100;45;0;45;1.000;3600000;0
14373;91414;171;0;0;0;0;.00nan;0;0
14373;92313;171;57;27;3;24;.889;3600000;0
14374;173918;174;67;34;3;31;.912;3582000;0
14374;37786;169;88;26;1;25;.962;3600000;0
14374;57564;174;0;0;0;0;.00nan;0;0
14374;85354;169;0;0;0;0;.00nan;0;0
14375;36719;4247;0;0;0;0;.00nan;0;0
14375;44405;4247;100;47;2;45;.957;3600000;0
14375;91414;171;0;0;0;0;.00nan;0;0
14375;92313;171;47;22;3;19;.864;3553000;0
14376;35172;170;0;0;0;0;.00nan;0;0
14376;37897;170;60;29;3;26;.897;3600000;0
14376;47547;167;0;0;0;0;.00nan;0;0
14376;65125;167;100;47;1;46;.979;3600000;0
14377;57155;172;0;0;0;0;.00nan;0;0
14377;57215;172;76;34;2;32;.941;3600000;0
14377;59614;3916;46;30;5;25;.833;3600000;0
14377;64736;3916;0;0;0;0;.00nan;0;0
14378;36719;4247;72;40;5;35;.875;3600000;0
14378;44405;4247;0;0;0;0;.00nan;0;0
14378;91414;171;79;26;1;25;.962;3600000;0
14378;92313;171;0;0;0;0;.00nan;0;0
14379;35172;170;73;24;1;23;.958;3600000;0
14379;37786;169;78;38;4;34;.895;3600000;0
14379;37897;170;0;0;0;0;.00nan;0;0
14379;85354;169;0;0;0;0;.00nan;0;0
14380;36675;175;0;0;0;0;.00nan;0;0
14380;44134;175;66;41;4;37;.902;3616000;0
14380;47547;167;56;30;3;27;.900;3616000;0
14380;65125;167;0;0;0;0;.00nan;0;0
14381;2136;1527;0;0;0;0;.00nan;0;0
14381;173918;174;0;0;0;0;.00nan;0;0
14381;57564;174;91;19;0;19;1.000;3600000;0
14381;85709;1527;70;47;5;42;.894;3600000;0
14382;57155;172;84;30;1;29;.967;3600000;0
14382;57215;172;0;0;0;0;.00nan;0;0
14382;59614;3916;0;0;0;0;.00nan;0;0
14382;64736;3916;56;22;3;19;.864;3570000;0
14383;35172;170;0;0;0;0;.00nan;0;0
14383;37897;170;89;31;2;29;.935;3827000;0
14383;47547;167;0;0;0;0;.00nan;0;0
14383;65125;167;79;40;3;37;.925;3827000;0
14384;2136;1527;43;10;2;8;.800;973000;0
14384;173918;174;0;0;0;0;.00nan;0;0
14384;57564;174;49;23;4;19;.826;3600000;0
14384;85709;1527;35;35;6;29;.829;2627000;0
14385;36719;4247;0;0;0;0;.00nan;0;0
14385;44405;4247;73;26;1;25;.962;3600000;0
14385;59614;3916;0;0;0;0;.00nan;0;0
14385;64736;3916;69;25;2;23;.920;3545000;0
14386;36675;175;0;0;0;0;.00nan;0;0
14386;44134;175;73;51;5;46;.902;3600000;0
14386;91414;171;0;0;0;0;.00nan;0;0
14386;92313;171;70;23;1;22;.957;3600000;0
14387;37786;169;98;41;3;38;.927;3600000;0
14387;57155;172;0;0;0;0;.00nan;0;0
14387;57215;172;92;19;0;19;1.000;3600000;0
14387;85354;169;0;0;0;0;.00nan;0;0
14388;36719;4247;66;26;2;24;.923;3600000;0
14388;44405;4247;0;0;0;0;.00nan;0;0
14388;57155;172;0;0;0;0;.00nan;0;0
14388;57215;172;62;28;3;25;.893;3553000;0
14389;2136;1527;0;0;0;0;.00nan;0;0
14389;173918;174;0;0;0;0;.00nan;0;0
14389;57564;174;62;21;2;19;.905;3600000;0
14389;85709;1527;67;33;3;30;.909;3553000;0
14390;59614;3916;0;0;0;0;.00nan;0;0
14390;64736;3916;55;30;3;27;.900;3589000;0
14390;91414;171;0;0;0;0;.00nan;0;0
14390;92313;171;68;29;2;27;.931;3600000;0
14391;36675;175;22;27;6;21;.778;2279000;0
14391;37786;169;47;19;3;16;.842;3600000;0
14391;44134;175;39;10;2;8;.800;1321000;0
14391;85354;169;0;0;0;0;.00nan;0;0
14392;35172;170;0;0;0;0;.00nan;0;0
14392;37897;170;74;23;1;22;.957;3600000;0
14392;47547;167;0;0;0;0;.00nan;0;0
14392;65125;167;76;27;2;25;.926;3543000;0
14393;36719;4247;0;0;0;0;.00nan;0;0
14393;44405;4247;82;38;3;35;.921;3900000;0
14393;57155;172;60;25;3;22;.880;3900000;0
14393;57215;172;0;0;0;0;.00nan;0;0
14394;2136;1527;50;32;4;28;.875;3600000;0
14394;173918;174;85;16;0;16;1.000;3600000;0
14394;57564;174;0;0;0;0;.00nan;0;0
14394;85709;1527;0;0;0;0;.00nan;0;0
14395;36675;175;0;0;0;0;.00nan;0;0
14395;37786;169;76;31;2;29;.935;3600000;0
14395;44134;175;76;36;3;33;.917;3563000;0
14395;85354;169;0;0;0;0;.00nan;0;0
14396;36675;175;98;41;2;39;.951;3600000;0
14396;44134;175;0;0;0;0;.00nan;0;0
14396;47547;167;66;22;1;21;.955;2615000;0
14396;65125;167;21;10;4;6;.600;985000;0
14397;35172;170;61;9;1;8;.889;2953000;0
14397;36675;175;71;50;5;45;.900;3900000;0
14397;37897;170;27;8;4;4;.500;947000;0
14397;44134;175;0;0;0;0;.00nan;0;0
14398;47547;167;0;0;0;0;.00nan;0;0
14398;57155;172;0;0;0;0;.00nan;0;0
14398;57215;172;48;18;3;15;.833;3900000;0
14398;65125;167;64;31;3;28;.903;3900000;0
14399;173918;174;70;17;1;16;.941;3600000;0
14399;57564;174;0;0;0;0;.00nan;0;0
14399;59614;3916;0;0;0;0;.00nan;0;0
14399;64736;3916;74;46;4;42;.913;3600000;0
14400;35172;170;0;0;0;0;.00nan;0;0
14400;36675;175;0;0;0;0;.00nan;0;0
14400;37897;170;100;27;0;27;1.000;3600000;0
14400;44134;175;66;38;4;34;.895;3600000;0
14401;36719;4247;0;0;0;0;.00nan;0;0
14401;44405;4247;99;46;2;44;.957;3600000;0
14401;91414;171;0;0;0;0;.00nan;0;0
14401;92313;171;34;28;6;22;.786;3600000;0
14402;47547;167;84;26;1;25;.962;3900000;0
14402;57155;172;100;37;1;36;.973;3900000;0
14402;57215;172;0;0;0;0;.00nan;0;0
14402;65125;167;0;0;0;0;.00nan;0;0
14403;173918;174;0;0;0;0;.00nan;0;0
14403;57564;174;87;29;1;28;.966;3600000;0
14403;59614;3916;0;0;0;0;.00nan;0;0
14403;64736;3916;59;33;4;29;.879;3600000;0
14404;36719;4247;82;27;2;25;.926;3600000;0
14404;44405;4247;0;0;0;0;.00nan;0;0
14404;91414;171;36;25;5;20;.800;3600000;0
14404;92313;171;0;0;0;0;.00nan;0;0
14405;173918;174;0;0;0;0;.00nan;0;0
14405;57155;172;0;0;0;0;.00nan;0;0
14405;57215;172;70;36;4;32;.889;3785000;0
14405;57564;174;40;17;3;14;.824;3785000;0
14406;35172;170;0;0;0;0;.00nan;0;0
14406;36719;4247;0;0;0;0;.00nan;0;0
14406;37897;170;77;31;3;28;.903;3667000;0
14406;44405;4247;88;36;2;34;.944;3667000;0
14407;36675;175;0;0;0;0;.00nan;0;0
14407;37786;169;95;35;1;34;.971;3600000;0
14407;44134;175;63;23;2;21;.913;3569000;0
14407;85354;169;0;0;0;0;.00nan;0;0
14408;2136;1527;0;0;0;0;.00nan;0;0
14408;47547;167;0;0;0;0;.00nan;0;0
14408;65125;167;51;21;3;18;.857;3600000;0
14408;85709;1527;76;40;4;36;.900;3600000;0
14409;59614;3916;0;0;0;0;.00nan;0;0
14409;64736;3916;99;39;1;38;.974;3600000;0
14409;91414;171;0;0;0;0;.00nan;0;0
14409;92313;171;26;26;6;20;.769;3600000;0
14410;35172;170;46;34;5;29;.853;3900000;0
14410;36719;4247;52;29;5;24;.828;3900000;0
14410;37897;170;0;0;0;0;.00nan;0;0
14410;44405;4247;0;0;0;0;.00nan;0;0
14411;36675;175;91;26;1;25;.962;3600000;0
14411;37786;169;88;40;3;37;.925;3564000;0
14411;44134;175;0;0;0;0;.00nan;0;0
14411;85354;169;0;0;0;0;.00nan;0;0
14412;2136;1527;20;28;6;22;.786;2293000;0
14412;47547;167;87;29;1;28;.966;3600000;0
14412;65125;167;0;0;0;0;.00nan;0;0
14412;85709;1527;57;15;1;14;.933;1307000;0
14413;173918;174;71;36;4;32;.889;3900000;0
14413;57155;172;69;33;4;29;.879;3900000;0
14413;57215;172;0;0;0;0;.00nan;0;0
14413;57564;174;0;0;0;0;.00nan;0;0
14414;59614;3916;72;46;6;40;.870;3564000;0
14414;64736;3916;0;0;0;0;.00nan;0;0
14414;91414;171;30;21;5;16;.762;2290000;0
14414;92313;171;82;16;0;16;1.000;1310000;0
14415;2136;1527;0;0;0;0;.00nan;0;0
14415;57155;172;0;0;0;0;.00nan;0;0
14415;57215;172;79;31;3;28;.903;3600000;0
14415;85709;1527;90;32;2;30;.938;3600000;0
14416;35172;170;0;0;0;0;.00nan;0;0
14416;37897;170;73;28;2;26;.929;3600000;0
14416;91414;171;0;0;0;0;.00nan;0;0
14416;92313;171;81;37;3;34;.919;3573000;0
14417;173918;174;0;0;0;0;.00nan;0;0
14417;36719;4247;0;0;0;0;.00nan;0;0
14417;44405;4247;89;31;1;30;.968;3600000;0
14417;57564;174;64;29;3;26;.897;3528000;0
14418;2136;1527;0;0;0;0;.00nan;0;0
14418;57155;172;62;27;3;24;.889;3846000;0
14418;57215;172;0;0;0;0;.00nan;0;0
14418;85709;1527;88;45;4;41;.911;3846000;0
14419;37786;169;41;30;6;24;.800;3600000;0
14419;59614;3916;63;29;3;26;.897;3600000;0
14419;64736;3916;0;0;0;0;.00nan;0;0
14419;85354;169;0;0;0;0;.00nan;0;0
14420;35172;170;58;47;6;41;.872;3600000;0
14420;37897;170;0;0;0;0;.00nan;0;0
14420;59614;3916;0;0;0;0;.00nan;0;0
14420;64736;3916;70;21;1;20;.952;3600000;0
14421;36675;175;0;0;0;0;.00nan;0;0
14421;44134;175;64;47;6;41;.872;3600000;0
14421;91414;171;67;27;2;25;.926;3600000;0
14421;92313;171;0;0;0;0;.00nan;0;0
14422;36719;4247;82;31;2;29;.935;3600000;0
14422;44405;4247;0;0;0;0;.00nan;0;0
14422;47547;167;0;0;0;0;.00nan;0;0
14422;65125;167;75;36;3;33;.917;3553000;0
14423;173918;174;89;36;2;34;.944;3600000;0
14423;57155;172;0;0;0;0;.00nan;0;0
14423;57215;172;69;34;3;31;.912;3541000;0
14423;57564;174;0;0;0;0;.00nan;0;0
14424;2136;1527;0;0;0;0;.00nan;0;0
14424;37786;169;95;19;0;19;1.000;3600000;0
14424;85354;169;0;0;0;0;.00nan;0;0
14424;85709;1527;81;54;5;49;.907;3600000;0
14425;2136;1527;0;0;0;0;.00nan;0;0
14425;35172;170;0;0;0;0;.00nan;0;0
14425;37897;170;48;18;3;15;.833;3553000;0
14425;85709;1527;100;56;2;54;.964;3600000;0
14426;35172;170;100;32;0;32;1.000;3600000;0
14426;37786;169;93;36;1;35;.972;3573000;0
14426;37897;170;0;0;0;0;.00nan;0;0
14426;85354;169;0;0;0;0;.00nan;0;0
14427;173918;174;37;14;3;11;.786;3561000;0
14427;57155;172;91;35;2;33;.943;3600000;0
14427;57215;172;0;0;0;0;.00nan;0;0
14427;57564;174;0;0;0;0;.00nan;0;0
14428;36675;175;62;33;4;29;.879;3611000;0
14428;44134;175;0;0;0;0;.00nan;0;0
14428;47547;167;56;27;3;24;.889;3611000;0
14428;65125;167;0;0;0;0;.00nan;0;0
14429;2136;1527;0;0;0;0;.00nan;0;0
14429;36719;4247;0;0;0;0;.00nan;0;0
14429;44405;4247;89;18;0;18;1.000;3600000;0
14429;85709;1527;66;39;4;35;.897;3600000;0
14430;59614;3916;0;0;0;0;.00nan;0;0
14430;64736;3916;92;34;2;32;.941;3600000;0
14430;91414;171;55;30;3;27;.900;3568000;0
14430;92313;171;0;0;0;0;.00nan;0;0
14431;35172;170;100;30;0;30;1.000;3600000;0
14431;36719;4247;0;0;0;0;.00nan;0;0
14431;37897;170;0;0;0;0;.00nan;0;0
14431;44405;4247;97;41;2;39;.951;3590000;0
14432;173918;174;65;37;4;33;.892;3600000;0
14432;57155;172;0;0;0;0;.00nan;0;0
14432;57215;172;92;28;1;27;.964;3600000;0
14432;57564;174;0;0;0;0;.00nan;0;0
14433;59614;3916;91;31;1;30;.968;3600000;0
14433;64736;3916;0;0;0;0;.00nan;0;0
14433;91414;171;68;34;3;31;.912;3536000;0
14433;92313;171;0;0;0;0;.00nan;0;0
14434;36675;175;0;0;0;0;.00nan;0;0
14434;44134;175;82;25;1;24;.960;3600000;0
14434;47547;167;0;0;0;0;.00nan;0;0
14434;65125;167;42;38;6;32;.842;3600000;0
14435;2136;1527;0;0;0;0;.00nan;0;0
14435;37786;169;0;0;0;0;.00nan;0;0
14435;85354;169;62;26;3;23;.885;3600000;0
14435;85709;1527;88;54;4;50;.926;3600000;0
14436;35172;170;62;23;2;21;.913;3568000;0
14436;37897;170;0;0;0;0;.00nan;0;0
14436;47547;167;0;0;0;0;.00nan;0;0
14436;65125;167;100;36;0;36;1.000;3600000;0
14437;173918;174;85;39;3;36;.923;3600000;0
14437;36719;4247;0;0;0;0;.00nan;0;0
14437;44405;4247;32;23;5;18;.783;3586000;0
14437;57564;174;0;0;0;0;.00nan;0;0
14438;2136;1527;0;0;0;0;.00nan;0;0
14438;57155;172;100;27;0;27;1.000;3600000;0
14438;57215;172;0;0;0;0;.00nan;0;0
14438;85709;1527;83;58;4;54;.931;3600000;0
14439;37786;169;71;39;3;36;.923;3585000;0
14439;59614;3916;0;0;0;0;.00nan;0;0
14439;64736;3916;77;26;1;25;.962;3600000;0
14439;85354;169;0;0;0;0;.00nan;0;0
14440;2136;1527;0;0;0;0;.00nan;0;0
14440;173918;174;36;33;6;27;.818;2858000;0
14440;57564;174;45;7;1;6;.857;742000;0
14440;85709;1527;100;30;0;30;1.000;3600000;0
14441;37786;169;81;40;3;37;.925;3900000;0
14441;85354;169;0;0;0;0;.00nan;0;0
14441;91414;171;78;31;3;28;.903;3900000;0
14441;92313;171;0;0;0;0;.00nan;0;0
14442;36719;4247;0;0;0;0;.00nan;0;0
14442;44405;4247;74;27;1;26;.963;3900000;0
14442;59614;3916;0;0;0;0;.00nan;0;0
14442;64736;3916;87;28;1;27;.964;3900000;0
14443;36675;175;75;32;2;30;.938;3900000;0
14443;44134;175;0;0;0;0;.00nan;0;0
14443;57155;172;68;22;2;20;.909;3900000;0
14443;57215;172;0;0;0;0;.00nan;0;0
14444;35172;170;0;0;0;0;.00nan;0;0
14444;37897;170;83;30;2;28;.933;3600000;0
14444;47547;167;0;0;0;0;.00nan;0;0
14444;65125;167;82;29;1;28;.966;3600000;0
14445;35172;170;83;21;1;20;.952;3600000;0
14445;37897;170;0;0;0;0;.00nan;0;0
14445;47547;167;80;31;2;29;.935;3566000;0
14445;65125;167;0;0;0;0;.00nan;0;0
14446;2136;1527;0;0;0;0;.00nan;0;0
14446;173918;174;21;18;6;12;.667;3600000;0
14446;57564;174;0;0;0;0;.00nan;0;0
14446;85709;1527;72;24;1;23;.958;3600000;0
14447;36719;4247;36;29;6;23;.793;3569000;0
14447;44405;4247;0;0;0;0;.00nan;0;0
14447;59614;3916;67;31;4;27;.871;3600000;0
14447;64736;3916;0;0;0;0;.00nan;0;0
14448;37786;169;0;0;0;0;.00nan;0;0
14448;85354;169;68;25;2;23;.920;3600000;0
14448;91414;171;0;0;0;0;.00nan;0;0
14448;92313;171;62;29;4;25;.862;3521000;0
14449;36675;175;0;0;0;0;.00nan;0;0
14449;44134;175;51;30;4;26;.867;3746000;0
14449;57155;172;0;0;0;0;.00nan;0;0
14449;57215;172;65;44;5;39;.886;3743000;0
14450;37786;169;89;19;0;19;1.000;3600000;0
14450;59614;3916;0;0;0;0;.00nan;0;0
14450;64736;3916;75;33;2;31;.939;3533000;0
14450;85354;169;0;0;0;0;.00nan;0;0
14451;173918;174;0;0;0;0;.00nan;0;0
14451;36675;175;86;42;3;39;.929;3600000;0
14451;44134;175;0;0;0;0;.00nan;0;0
14451;57564;174;25;22;5;17;.773;3550000;0
14452;2136;1527;0;0;0;0;.00nan;0;0
14452;57155;172;81;26;1;25;.962;3600000;0
14452;57215;172;0;0;0;0;.00nan;0;0
14452;85709;1527;82;35;2;33;.943;3591000;0
14453;47547;167;0;0;0;0;.00nan;0;0
14453;57155;172;0;0;0;0;.00nan;0;0
14453;57215;172;57;37;5;32;.865;3552000;0
14453;65125;167;65;32;3;29;.906;3600000;0
14454;35172;170;0;0;0;0;.00nan;0;0
14454;37897;170;94;19;0;19;1.000;3600000;0
14454;59614;3916;0;0;0;0;.00nan;0;0
14454;64736;3916;67;32;3;29;.906;3600000;0
14455;37786;169;68;26;2;24;.923;3600000;0
14455;85354;169;0;0;0;0;.00nan;0;0
14455;91414;171;32;10;3;7;.700;591000;0
14455;92313;171;89;22;1;21;.955;2974000;0
14456;36675;175;0;0;0;0;.00nan;0;0
14456;44134;175;71;29;2;27;.931;3804000;0
14456;47547;167;76;41;3;38;.927;3804000;0
14456;65125;167;0;0;0;0;.00nan;0;0
14457;36719;4247;0;0;0;0;.00nan;0;0
14457;44405;4247;65;17;1;16;.941;3600000;0
14457;57155;172;77;35;3;32;.914;3535000;0
14457;57215;172;0;0;0;0;.00nan;0;0
14458;2136;1527;0;0;0;0;.00nan;0;0
14458;173918;174;66;19;2;17;.895;3600000;0
14458;57564;174;0;0;0;0;.00nan;0;0
14458;85709;1527;49;35;5;30;.857;3600000;0
14459;37786;169;55;29;4;25;.862;3600000;0
14459;59614;3916;50;33;5;28;.848;3556000;0
14459;64736;3916;0;0;0;0;.00nan;0;0
14459;85354;169;0;0;0;0;.00nan;0;0
14460;36675;175;96;43;2;41;.953;3600000;0
14460;44134;175;0;0;0;0;.00nan;0;0
14460;91414;171;50;27;3;24;.889;3600000;0
14460;92313;171;0;0;0;0;.00nan;0;0
14461;35172;170;0;0;0;0;.00nan;0;0
14461;37897;170;48;24;4;20;.833;3573000;0
14461;47547;167;0;0;0;0;.00nan;0;0
14461;65125;167;93;42;2;40;.952;3600000;0
14462;36719;4247;59;40;6;34;.850;3214000;0
14462;44405;4247;53;4;0;4;1.000;386000;0
14462;57155;172;0;0;0;0;.00nan;0;0
14462;57215;172;67;20;1;19;.950;3600000;0
14463;2136;1527;0;0;0;0;.00nan;0;0
14463;173918;174;0;0;0;0;.00nan;0;0
14463;57564;174;72;34;3;31;.912;3600000;0
14463;85709;1527;62;41;5;36;.878;3567000;0
14464;173918;174;72;26;2;24;.923;3600000;0
14464;37786;169;31;8;3;5;.625;592000;0
14464;57564;174;0;0;0;0;.00nan;0;0
14464;85354;169;52;31;4;27;.871;3008000;0
14465;36675;175;0;0;0;0;.00nan;0;0
14465;44134;175;78;25;1;24;.960;3600000;0
14465;91414;171;63;28;2;26;.929;3555000;0
14465;92313;171;0;0;0;0;.00nan;0;0
14466;36719;4247;0;0;0;0;.00nan;0;0
14466;44405;4247;44;13;2;11;.846;3600000;0
14466;57155;172;99;40;1;39;.975;3600000;0
14466;57215;172;0;0;0;0;.00nan;0;0
14467;2136;1527;0;0;0;0;.00nan;0;0
14467;35172;170;51;16;2;14;.875;3600000;0
14467;37897;170;0;0;0;0;.00nan;0;0
14467;85709;1527;87;42;3;39;.929;3600000;0
14468;47547;167;0;0;0;0;.00nan;0;0
14468;59614;3916;0;0;0;0;.00nan;0;0
14468;64736;3916;79;33;4;29;.879;3823000;0
14468;65125;167;54;29;3;26;.897;3823000;0
14469;173918;174;0;0;0;0;.00nan;0;0
14469;37786;169;54;43;6;37;.860;2914000;0
14469;57564;174;41;21;4;17;.810;3600000;0
14469;85354;169;52;2;0;2;1.000;666000;0
14470;36675;175;60;27;3;24;.889;3600000;0
14470;44134;175;0;0;0;0;.00nan;0;0
14470;91414;171;0;0;0;0;.00nan;0;0
14470;92313;171;52;34;4;30;.882;3563000;0
14471;36719;4247;89;36;2;34;.944;3600000;0
14471;44405;4247;0;0;0;0;.00nan;0;0
14471;57155;172;0;0;0;0;.00nan;0;0
14471;57215;172;58;29;4;25;.862;3556000;0
14472;2136;1527;0;0;0;0;.00nan;0;0
14472;35172;170;0;0;0;0;.00nan;0;0
14472;37897;170;86;32;2;30;.938;3600000;0
14472;85709;1527;59;32;3;29;.906;3595000;0
14473;47547;167;97;46;2;44;.957;3900000;0
14473;59614;3916;62;18;2;16;.889;3900000;0
14473;64736;3916;0;0;0;0;.00nan;0;0
14473;65125;167;0;0;0;0;.00nan;0;0
14474;36719;4247;0;0;0;0;.00nan;0;0
14474;44405;4247;78;43;4;39;.907;3600000;0
14474;57155;172;82;26;1;25;.962;3600000;0
14474;57215;172;0;0;0;0;.00nan;0;0
14475;35172;170;89;34;2;32;.941;3900000;0
14475;37786;169;89;31;2;29;.935;3900000;0
14475;37897;170;0;0;0;0;.00nan;0;0
14475;85354;169;0;0;0;0;.00nan;0;0
14476;2136;1527;0;0;0;0;.00nan;0;0
14476;36675;175;0;0;0;0;.00nan;0;0
14476;44134;175;67;27;3;24;.889;3900000;0
14476;85709;1527;96;49;3;46;.939;3900000;0
14477;36675;175;97;30;1;29;.967;3600000;0
14477;44134;175;0;0;0;0;.00nan;0;0
14477;59614;3916;0;0;0;0;.00nan;0;0
14477;64736;3916;43;29;5;24;.828;3600000;0
14478;35172;170;0;0;0;0;.00nan;0;0
14478;37897;170;57;39;5;34;.872;3565000;0
14478;91414;171;0;0;0;0;.00nan;0;0
14478;92313;171;57;31;4;27;.871;3600000;0
14479;173918;174;70;33;3;30;.909;3600000;0
14479;57155;172;0;0;0;0;.00nan;0;0
14479;57215;172;64;24;2;22;.917;3600000;0
14479;57564;174;0;0;0;0;.00nan;0;0
14480;36719;4247;0;0;0;0;.00nan;0;0
14480;44405;4247;67;19;1;18;.947;3600000;0
14480;47547;167;0;0;0;0;.00nan;0;0
14480;65125;167;84;28;2;26;.929;3555000;0
14481;2136;1527;0;0;0;0;.00nan;0;0
14481;37786;169;52;26;4;22;.846;3600000;0
14481;85354;169;0;0;0;0;.00nan;0;0
14481;85709;1527;74;48;5;43;.896;3600000;0
14482;36675;175;0;0;0;0;.00nan;0;0
14482;44134;175;84;50;3;47;.940;3550000;0
14482;59614;3916;53;16;2;14;.875;3600000;0
14482;64736;3916;0;0;0;0;.00nan;0;0
14483;35172;170;81;32;3;29;.906;3600000;0
14483;37897;170;0;0;0;0;.00nan;0;0
14483;91414;171;50;27;4;23;.852;3575000;0
14483;92313;171;0;0;0;0;.00nan;0;0
14484;2136;1527;63;35;4;31;.886;3802000;0
14484;37786;169;0;0;0;0;.00nan;0;0
14484;85354;169;53;26;3;23;.885;3802000;0
14484;85709;1527;0;0;0;0;.00nan;0;0
14485;36675;175;60;39;4;35;.897;3569000;0
14485;44134;175;0;0;0;0;.00nan;0;0
14485;47547;167;46;19;3;16;.842;3600000;0
14485;65125;167;0;0;0;0;.00nan;0;0
14486;173918;174;0;0;0;0;.00nan;0;0
14486;57155;172;64;32;5;27;.844;3900000;0
14486;57215;172;0;0;0;0;.00nan;0;0
14486;57564;174;62;42;5;37;.881;3900000;0
14487;36719;4247;88;26;1;25;.962;3600000;0
14487;44405;4247;0;0;0;0;.00nan;0;0
14487;59614;3916;0;0;0;0;.00nan;0;0
14487;64736;3916;82;41;3;38;.927;3528000;0
14488;35172;170;0;0;0;0;.00nan;0;0
14488;37897;170;100;46;2;44;.957;3600000;0
14488;91414;171;0;0;0;0;.00nan;0;0
14488;92313;171;70;35;3;32;.914;3600000;0
14489;173918;174;82;36;2;34;.944;3542000;0
14489;35172;170;0;0;0;0;.00nan;0;0
14489;37897;170;89;14;0;14;1.000;3600000;0
14489;57564;174;0;0;0;0;.00nan;0;0
14490;36719;4247;0;0;0;0;.00nan;0;0
14490;44405;4247;78;28;1;27;.964;3600000;0
14490;91414;171;0;0;0;0;.00nan;0;0
14490;92313;171;75;22;2;20;.909;3556000;0
14491;2136;1527;0;0;0;0;.00nan;0;0
14491;36675;175;80;33;2;31;.939;3219000;0
14491;44134;175;25;5;3;2;.400;371000;0
14491;85709;1527;81;33;3;30;.909;3600000;0
14492;47547;167;0;0;0;0;.00nan;0;0
14492;59614;3916;0;0;0;0;.00nan;0;0
14492;64736;3916;61;28;3;25;.893;3561000;0
14492;65125;167;76;33;2;31;.939;3600000;0
14493;37786;169;86;26;1;25;.962;3600000;0
14493;57155;172;0;0;0;0;.00nan;0;0
14493;57215;172;58;31;3;28;.903;3535000;0
14493;85354;169;0;0;0;0;.00nan;0;0
14494;173918;174;0;0;0;0;.00nan;0;0
14494;35172;170;0;0;0;0;.00nan;0;0
14494;37897;170;70;25;2;23;.920;3575000;0
14494;57564;174;86;34;1;33;.971;3600000;0
14495;36719;4247;19;9;4;5;.556;967000;0
14495;44405;4247;61;32;3;29;.906;2633000;0
14495;91414;171;85;37;2;35;.946;3600000;0
14495;92313;171;0;0;0;0;.00nan;0;0
14496;2136;1527;0;0;0;0;.00nan;0;0
14496;36675;175;62;38;4;34;.895;3900000;0
14496;44134;175;0;0;0;0;.00nan;0;0
14496;85709;1527;75;44;4;40;.909;3900000;0
14497;47547;167;89;52;4;48;.923;3600000;0
14497;59614;3916;68;16;2;14;.875;3600000;0
14497;64736;3916;0;0;0;0;.00nan;0;0
14497;65125;167;0;0;0;0;.00nan;0;0
14498;37786;169;0;0;0;0;.00nan;0;0
14498;57155;172;48;23;4;19;.826;3545000;0
14498;57215;172;0;0;0;0;.00nan;0;0
14498;85354;169;80;30;3;27;.900;3600000;0
14499;35172;170;0;0;0;0;.00nan;0;0
14499;36675;175;0;0;0;0;.00nan;0;0
14499;37897;170;75;14;1;13;.929;3600000;0
14499;44134;175;76;26;2;24;.923;3561000;0
14500;2136;1527;0;0;0;0;.00nan;0;0
14500;173918;174;12;28;7;21;.750;3600000;0
14500;57564;174;0;0;0;0;.00nan;0;0
14500;85709;1527;99;39;2;37;.949;3600000;0
14501;57155;172;0;0;0;0;.00nan;0;0
14501;57215;172;66;34;4;30;.882;3566000;0
14501;59614;3916;0;0;0;0;.00nan;0;0
14501;64736;3916;60;23;2;21;.913;3600000;0
14502;35172;170;72;33;3;30;.909;3600000;0
14502;37897;170;0;0;0;0;.00nan;0;0
14502;47547;167;0;0;0;0;.00nan;0;0
14502;65125;167;86;42;4;38;.905;3594000;0
14503;2136;1527;71;37;4;33;.892;3600000;0
14503;36719;4247;33;25;6;19;.760;3557000;0
14503;44405;4247;0;0;0;0;.00nan;0;0
14503;85709;1527;0;0;0;0;.00nan;0;0
14504;173918;174;0;0;0;0;.00nan;0;0
14504;37786;169;64;32;4;28;.875;3900000;0
14504;57564;174;98;43;4;39;.907;3900000;0
14504;85354;169;0;0;0;0;.00nan;0;0
14505;57155;172;82;25;2;23;.920;3900000;0
14505;57215;172;0;0;0;0;.00nan;0;0
14505;91414;171;68;20;2;18;.900;3900000;0
14505;92313;171;0;0;0;0;.00nan;0;0
14506;36675;175;29;40;8;32;.800;3600000;0
14506;44134;175;0;0;0;0;.00nan;0;0
14506;59614;3916;85;29;2;27;.931;3600000;0
14506;64736;3916;0;0;0;0;.00nan;0;0
14507;2136;1527;0;0;0;0;.00nan;0;0
14507;36719;4247;0;0;0;0;.00nan;0;0
14507;44405;4247;92;34;1;33;.971;3600000;0
14507;85709;1527;88;42;2;40;.952;3594000;0
14508;173918;174;100;37;0;37;1.000;3600000;0
14508;37786;169;45;26;4;22;.846;3600000;0
14508;57564;174;0;0;0;0;.00nan;0;0
14508;85354;169;0;0;0;0;.00nan;0;0
14509;36675;175;0;0;0;0;.00nan;0;0
14509;44134;175;69;29;2;27;.931;3600000;0
14509;47547;167;50;29;4;25;.862;3543000;0
14509;65125;167;0;0;0;0;.00nan;0;0
14510;57155;172;0;0;0;0;.00nan;0;0
14510;57215;172;59;25;2;23;.920;3600000;0
14510;91414;171;42;3;1;2;.667;408000;0
14510;92313;171;25;21;5;16;.762;3192000;0
14511;35172;170;0;0;0;0;.00nan;0;0
14511;37897;170;68;32;3;29;.906;3556000;0
14511;59614;3916;0;0;0;0;.00nan;0;0
14511;64736;3916;67;24;2;22;.917;3600000;0
14512;173918;174;74;32;4;28;.875;3600000;0
14512;35172;170;0;0;0;0;.00nan;0;0
14512;37897;170;99;40;1;39;.975;3600000;0
14512;57564;174;0;0;0;0;.00nan;0;0
14513;37786;169;0;0;0;0;.00nan;0;0
14513;85354;169;80;37;3;34;.919;3600000;0
14513;91414;171;49;25;4;21;.840;3552000;0
14513;92313;171;0;0;0;0;.00nan;0;0
14514;36675;175;37;39;6;33;.846;3093000;0
14514;44134;175;41;2;1;1;.500;507000;0
14514;59614;3916;0;0;0;0;.00nan;0;0
14514;64736;3916;61;22;2;20;.909;3600000;0
14515;36719;4247;0;0;0;0;.00nan;0;0
14515;44405;4247;82;21;1;20;.952;3600000;0
14515;47547;167;83;44;4;40;.909;3600000;0
14515;65125;167;0;0;0;0;.00nan;0;0
14516;2136;1527;0;0;0;0;.00nan;0;0
14516;57155;172;0;0;0;0;.00nan;0;0
14516;57215;172;100;29;0;29;1.000;3600000;0
14516;85709;1527;70;36;3;33;.917;3600000;0
14517;173918;174;0;0;0;0;.00nan;0;0
14517;35172;170;83;29;2;27;.931;3569000;0
14517;37897;170;0;0;0;0;.00nan;0;0
14517;57564;174;86;30;1;29;.967;3600000;0
14518;37786;169;20;23;6;17;.739;2634000;0
14518;59614;3916;71;23;2;21;.913;3600000;0
14518;64736;3916;0;0;0;0;.00nan;0;0
14518;85354;169;33;12;3;9;.750;966000;0
14519;36675;175;66;10;0;10;1.000;1143000;0
14519;44134;175;53;36;6;30;.833;2457000;0
14519;91414;171;0;0;0;0;.00nan;0;0
14519;92313;171;56;18;2;16;.889;3600000;0
14520;36719;4247;100;26;0;26;1.000;3600000;0
14520;44405;4247;0;0;0;0;.00nan;0;0
14520;47547;167;0;0;0;0;.00nan;0;0
14520;65125;167;96;38;2;36;.947;3600000;0
14521;2136;1527;64;42;6;36;.857;2959000;0
14521;57155;172;0;0;0;0;.00nan;0;0
14521;57215;172;80;24;1;23;.958;3600000;0
14521;85709;1527;53;10;1;9;.900;641000;0
14522;2136;1527;0;0;0;0;.00nan;0;0
14522;173918;174;60;26;4;22;.846;3670000;0
14522;57564;174;0;0;0;0;.00nan;0;0
14522;85709;1527;67;29;3;26;.897;3670000;0
14523;173918;174;69;28;2;26;.929;3577000;0
14523;57564;174;0;0;0;0;.00nan;0;0
14523;59614;3916;0;0;0;0;.00nan;0;0
14523;64736;3916;73;22;1;21;.955;3600000;0
14524;57155;172;0;0;0;0;.00nan;0;0
14524;57215;172;61;34;4;30;.882;3600000;0
14524;91414;171;66;16;1;15;.938;3600000;0
14524;92313;171;0;0;0;0;.00nan;0;0
14525;35172;170;0;0;0;0;.00nan;0;0
14525;36719;4247;75;29;2;27;.931;3600000;0
14525;37897;170;50;20;3;17;.850;3583000;0
14525;44405;4247;0;0;0;0;.00nan;0;0
14526;36675;175;79;33;2;31;.939;3547000;0
14526;37786;169;99;26;0;26;1.000;3600000;0
14526;44134;175;0;0;0;0;.00nan;0;0
14526;85354;169;0;0;0;0;.00nan;0;0
14527;2136;1527;0;0;0;0;.00nan;0;0
14527;47547;167;0;0;0;0;.00nan;0;0
14527;65125;167;56;20;3;17;.850;3600000;0
14527;85709;1527;90;36;2;34;.944;3600000;0
14528;173918;174;0;0;0;0;.00nan;0;0
14528;57564;174;87;31;1;30;.968;3600000;0
14528;59614;3916;62;29;3;26;.897;3598000;0
14528;64736;3916;0;0;0;0;.00nan;0;0
14529;57155;172;74;29;2;27;.931;3589000;0
14529;57215;172;0;0;0;0;.00nan;0;0
14529;91414;171;0;0;0;0;.00nan;0;0
14529;92313;171;83;28;1;27;.964;3600000;0
14530;35172;170;50;27;4;23;.852;3600000;0
14530;36719;4247;0;0;0;0;.00nan;0;0
14530;37897;170;0;0;0;0;.00nan;0;0
14530;44405;4247;52;40;5;35;.875;3565000;0
14531;36675;175;0;0;0;0;.00nan;0;0
14531;37786;169;67;35;4;31;.886;3553000;0
14531;44134;175;69;28;3;25;.893;3600000;0
14531;85354;169;0;0;0;0;.00nan;0;0
14532;2136;1527;100;40;1;39;.975;3600000;0
14532;47547;167;44;16;3;13;.813;3570000;0
14532;65125;167;0;0;0;0;.00nan;0;0
14532;85709;1527;0;0;0;0;.00nan;0;0
14533;57155;172;0;0;0;0;.00nan;0;0
14533;57215;172;87;36;3;33;.917;3900000;0
14533;91414;171;96;42;3;39;.929;3900000;0
14533;92313;171;0;0;0;0;.00nan;0;0
14534;36719;4247;0;0;0;0;.00nan;0;0
14534;37786;169;0;0;0;0;.00nan;0;0
14534;44405;4247;73;23;1;22;.957;3600000;0
14534;85354;169;92;47;2;45;.957;3544000;0
14535;2136;1527;0;0;0;0;.00nan;0;0
14535;47547;167;0;0;0;0;.00nan;0;0
14535;65125;167;100;45;2;43;.956;3600000;0
14535;85709;1527;53;27;3;24;.889;3588000;0
14536;173918;174;58;21;2;19;.905;3600000;0
14536;35172;170;0;0;0;0;.00nan;0;0
14536;37897;170;73;33;3;30;.909;3550000;0
14536;57564;174;0;0;0;0;.00nan;0;0
14537;36675;175;0;0;0;0;.00nan;0;0
14537;44134;175;82;32;2;30;.938;3600000;0
14537;59614;3916;0;0;0;0;.00nan;0;0
14537;64736;3916;42;32;6;26;.813;3600000;0
14538;35172;170;0;0;0;0;.00nan;0;0
14538;36675;175;65;40;4;36;.900;3600000;0
14538;37897;170;100;30;0;30;1.000;3600000;0
14538;44134;175;0;0;0;0;.00nan;0;0
14539;173918;174;75;37;3;34;.919;3546000;0
14539;57155;172;0;0;0;0;.00nan;0;0
14539;57215;172;67;24;2;22;.917;3600000;0
14539;57564;174;0;0;0;0;.00nan;0;0
14540;37786;169;63;31;3;28;.903;3772000;0
14540;47547;167;0;0;0;0;.00nan;0;0
14540;65125;167;77;41;4;37;.902;3771000;0
14540;85354;169;0;0;0;0;.00nan;0;0
14541;2136;1527;0;0;0;0;.00nan;0;0
14541;85709;1527;87;38;2;36;.947;3600000;0
14541;91414;171;76;33;3;30;.909;3591000;0
14541;92313;171;0;0;0;0;.00nan;0;0
14542;36719;4247;0;0;0;0;.00nan;0;0
14542;44405;4247;54;25;3;22;.880;3883000;0
14542;59614;3916;89;43;3;40;.930;3900000;0
14542;64736;3916;0;0;0;0;.00nan;0;0
14543;35172;170;0;0;0;0;.00nan;0;0
14543;36675;175;0;0;0;0;.00nan;0;0
14543;37897;170;72;36;4;32;.889;3600000;0
14543;44134;175;68;17;1;16;.941;3600000;0
14544;37786;169;48;29;4;25;.862;3671000;0
14544;47547;167;0;0;0;0;.00nan;0;0
14544;65125;167;59;32;5;27;.844;3671000;0
14544;85354;169;0;0;0;0;.00nan;0;0
14545;173918;174;0;0;0;0;.00nan;0;0
14545;57155;172;69;23;2;21;.913;3551000;0
14545;57215;172;0;0;0;0;.00nan;0;0
14545;57564;174;86;31;1;30;.968;3600000;0
14546;2136;1527;47;35;5;30;.857;3600000;0
14546;85709;1527;0;0;0;0;.00nan;0;0
14546;91414;171;0;0;0;0;.00nan;0;0
14546;92313;171;50;16;2;14;.875;3600000;0
14547;36719;4247;84;43;3;40;.930;3578000;0
14547;44405;4247;0;0;0;0;.00nan;0;0
14547;59614;3916;0;0;0;0;.00nan;0;0
14547;64736;3916;86;32;2;30;.938;3600000;0
14548;2136;1527;51;41;5;36;.878;3261000;0
14548;85709;1527;32;10;3;7;.700;339000;0
14548;91414;171;92;21;0;21;1.000;3600000;0
14548;92313;171;0;0;0;0;.00nan;0;0
14549;36719;4247;0;0;0;0;.00nan;0;0
14549;37786;169;95;33;1;32;.970;3900000;0
14549;44405;4247;83;32;1;31;.969;3900000;0
14549;85354;169;0;0;0;0;.00nan;0;0
14550;35172;170;0;0;0;0;.00nan;0;0
14550;37897;170;86;39;3;36;.923;3545000;0
14550;57155;172;0;0;0;0;.00nan;0;0
14550;57215;172;61;24;2;22;.917;3600000;0
14551;47547;167;65;34;4;30;.882;3586000;0
14551;65125;167;0;0;0;0;.00nan;0;0
14551;91414;171;70;21;2;19;.905;3600000;0
14551;92313;171;0;0;0;0;.00nan;0;0
14552;36675;175;0;0;0;0;.00nan;0;0
14552;36719;4247;100;33;0;33;1.000;3600000;0
14552;44134;175;72;34;3;31;.912;3600000;0
14552;44405;4247;0;0;0;0;.00nan;0;0
14553;37786;169;0;0;0;0;.00nan;0;0
14553;59614;3916;0;0;0;0;.00nan;0;0
14553;64736;3916;44;21;4;17;.810;3600000;0
14553;85354;169;42;40;6;34;.850;3600000;0
14554;2136;1527;0;0;0;0;.00nan;0;0
14554;173918;174;54;18;2;16;.889;3600000;0
14554;57564;174;0;0;0;0;.00nan;0;0
14554;85709;1527;76;38;3;35;.921;3585000;0
14555;35172;170;69;19;2;17;.895;3600000;0
14555;37897;170;0;0;0;0;.00nan;0;0
14555;57155;172;77;35;3;32;.914;3600000;0
14555;57215;172;0;0;0;0;.00nan;0;0
14556;47547;167;0;0;0;0;.00nan;0;0
14556;65125;167;97;56;4;52;.929;3600000;0
14556;91414;171;0;0;0;0;.00nan;0;0
14556;92313;171;69;22;2;20;.909;3600000;0
14557;37786;169;49;26;4;22;.846;3330000;0
14557;59614;3916;81;43;4;39;.907;3600000;0
14557;64736;3916;0;0;0;0;.00nan;0;0
14557;85354;169;41;2;1;1;.500;216000;0
14558;36675;175;44;19;3;16;.842;3513000;0
14558;36719;4247;0;0;0;0;.00nan;0;0
14558;44134;175;0;0;0;0;.00nan;0;0
14558;44405;4247;87;29;1;28;.966;3600000;0
14559;2136;1527;96;41;2;39;.951;3600000;0
14559;173918;174;0;0;0;0;.00nan;0;0
14559;57564;174;53;22;4;18;.818;3598000;0
14559;85709;1527;0;0;0;0;.00nan;0;0
14560;173918;174;29;19;4;15;.789;3600000;0
14560;36719;4247;0;0;0;0;.00nan;0;0
14560;44405;4247;87;25;1;24;.960;3600000;0
14560;57564;174;0;0;0;0;.00nan;0;0
14561;35172;170;0;0;0;0;.00nan;0;0
14561;37897;170;85;36;3;33;.917;3900000;0
14561;91414;171;63;31;3;28;.903;3900000;0
14561;92313;171;0;0;0;0;.00nan;0;0
14562;2136;1527;0;0;0;0;.00nan;0;0
14562;36675;175;0;0;0;0;.00nan;0;0
14562;44134;175;64;30;3;27;.900;3600000;0
14562;85709;1527;45;32;5;27;.844;3600000;0
14563;47547;167;0;0;0;0;.00nan;0;0
14563;57155;172;0;0;0;0;.00nan;0;0
14563;57215;172;67;28;2;26;.929;3600000;0
14563;65125;167;100;26;0;26;1.000;3600000;0
14564;37786;169;0;0;0;0;.00nan;0;0
14564;59614;3916;51;4;0;4;1.000;368000;0
14564;64736;3916;15;21;6;15;.714;3232000;0
14564;85354;169;87;43;2;41;.953;3600000;0
14565;173918;174;0;0;0;0;.00nan;0;0
14565;36719;4247;87;34;2;32;.941;3600000;0
14565;44405;4247;0;0;0;0;.00nan;0;0
14565;57564;174;74;37;4;33;.892;3561000;0
14566;35172;170;99;36;1;35;.972;3600000;0
14566;37897;170;0;0;0;0;.00nan;0;0
14566;91414;171;45;6;1;5;.833;572000;0
14566;92313;171;12;28;8;20;.714;3028000;0
14567;2136;1527;72;35;4;31;.886;3600000;0
14567;36675;175;47;33;5;28;.848;3596000;0
14567;44134;175;0;0;0;0;.00nan;0;0
14567;85709;1527;0;0;0;0;.00nan;0;0
14568;47547;167;0;0;0;0;.00nan;0;0
14568;57155;172;63;22;2;20;.909;3600000;0
14568;57215;172;0;0;0;0;.00nan;0;0
14568;65125;167;85;45;3;42;.933;3554000;0
14569;37786;169;90;35;3;32;.914;3600000;0
14569;59614;3916;93;18;0;18;1.000;3600000;0
14569;64736;3916;0;0;0;0;.00nan;0;0
14569;85354;169;0;0;0;0;.00nan;0;0
14570;173918;174;66;29;4;25;.862;3600000;0
14570;47547;167;80;28;1;27;.964;3600000;0
14570;57564;174;0;0;0;0;.00nan;0;0
14570;65125;167;0;0;0;0;.00nan;0;0
14571;59614;3916;73;29;3;26;.897;3600000;0
14571;64736;3916;0;0;0;0;.00nan;0;0
14571;91414;171;60;31;4;27;.871;3557000;0
14571;92313;171;0;0;0;0;.00nan;0;0
14572;173918;174;16;15;5;10;.667;3537000;0
14572;36675;175;0;0;0;0;.00nan;0;0
14572;44134;175;86;36;3;33;.917;3600000;0
14572;57564;174;0;0;0;0;.00nan;0;0
14573;37786;169;0;0;0;0;.00nan;0;0
14573;85354;169;54;24;3;21;.875;3895000;0
14573;91414;171;0;0;0;0;.00nan;0;0
14573;92313;171;56;23;3;20;.870;3900000;0
14574;36719;4247;83;28;1;27;.964;3600000;0
14574;44405;4247;0;0;0;0;.00nan;0;0
14574;47547;167;0;0;0;0;.00nan;0;0
14574;65125;167;91;44;4;40;.909;3600000;0
14575;2136;1527;0;0;0;0;.00nan;0;0
14575;57155;172;0;0;0;0;.00nan;0;0
14575;57215;172;62;24;3;21;.875;3600000;0
14575;85709;1527;79;51;5;46;.902;3587000;0
14576;35172;170;0;0;0;0;.00nan;0;0
14576;37897;170;61;30;3;27;.900;3596000;0
14576;59614;3916;0;0;0;0;.00nan;0;0
14576;64736;3916;79;29;2;27;.931;3600000;0
14577;173918;174;61;20;2;18;.900;3900000;0
14577;36675;175;81;31;2;29;.935;3900000;0
14577;44134;175;0;0;0;0;.00nan;0;0
14577;57564;174;0;0;0;0;.00nan;0;0
14578;36719;4247;0;0;0;0;.00nan;0;0
14578;44405;4247;71;19;1;18;.947;3600000;0
14578;47547;167;54;37;6;31;.838;2606000;0
14578;65125;167;36;7;2;5;.714;994000;0
14579;37786;169;67;40;4;36;.900;3600000;0
14579;85354;169;0;0;0;0;.00nan;0;0
14579;91414;171;58;26;3;23;.885;3600000;0
14579;92313;171;0;0;0;0;.00nan;0;0
14580;2136;1527;62;26;3;23;.885;3600000;0
14580;57155;172;100;31;0;31;1.000;3600000;0
14580;57215;172;0;0;0;0;.00nan;0;0
14580;85709;1527;0;0;0;0;.00nan;0;0
14581;35172;170;52;30;4;26;.867;3600000;0
14581;37897;170;0;0;0;0;.00nan;0;0
14581;59614;3916;85;14;0;14;1.000;3600000;0
14581;64736;3916;0;0;0;0;.00nan;0;0
14582;35172;170;0;0;0;0;.00nan;0;0
14582;37897;170;86;31;1;30;.968;3600000;0
14582;91414;171;71;34;2;32;.941;3590000;0
14582;92313;171;0;0;0;0;.00nan;0;0
14583;36719;4247;57;31;4;27;.871;3541000;0
14583;37786;169;72;33;3;30;.909;3600000;0
14583;44405;4247;0;0;0;0;.00nan;0;0
14583;85354;169;0;0;0;0;.00nan;0;0
14584;36675;175;0;0;0;0;.00nan;0;0
14584;44134;175;68;30;2;28;.933;3569000;0
14584;47547;167;0;0;0;0;.00nan;0;0
14584;65125;167;99;28;1;27;.964;3600000;0
14585;173918;174;69;40;4;36;.900;3559000;0
14585;57155;172;61;20;2;18;.900;3600000;0
14585;57215;172;0;0;0;0;.00nan;0;0
14585;57564;174;0;0;0;0;.00nan;0;0
14586;2136;1527;0;0;0;0;.00nan;0;0
14586;59614;3916;74;23;1;22;.957;3600000;0
14586;64736;3916;0;0;0;0;.00nan;0;0
14586;85709;1527;78;33;2;31;.939;3582000;0
14587;35172;170;85;40;2;38;.950;3900000;0
14587;37786;169;0;0;0;0;.00nan;0;0
14587;37897;170;0;0;0;0;.00nan;0;0
14587;85354;169;87;30;2;28;.933;3900000;0
14588;36719;4247;0;0;0;0;.00nan;0;0
14588;44405;4247;88;49;2;47;.959;3600000;0
14588;91414;171;0;0;0;0;.00nan;0;0
14588;92313;171;38;11;3;8;.727;3559000;0
14589;36675;175;68;14;1;13;.929;3600000;0
14589;44134;175;0;0;0;0;.00nan;0;0
14589;47547;167;65;47;6;41;.872;3600000;0
14589;65125;167;0;0;0;0;.00nan;0;0
14590;173918;174;81;29;1;28;.966;3600000;0
14590;57155;172;28;17;5;12;.706;2120000;0
14590;57215;172;37;21;4;17;.810;1480000;0
14590;57564;174;0;0;0;0;.00nan;0;0
14591;2136;1527;97;53;3;50;.943;3600000;0
14591;59614;3916;0;0;0;0;.00nan;0;0
14591;64736;3916;23;20;5;15;.750;3529000;0
14591;85709;1527;0;0;0;0;.00nan;0;0
14592;173918;174;100;30;0;30;1.000;3600000;0
14592;47547;167;0;0;0;0;.00nan;0;0
14592;57564;174;0;0;0;0;.00nan;0;0
14592;65125;167;50;33;5;28;.848;3600000;0
14593;59614;3916;100;23;0;23;1.000;3600000;0
14593;64736;3916;0;0;0;0;.00nan;0;0
14593;91414;171;84;34;2;32;.941;3600000;0
14593;92313;171;0;0;0;0;.00nan;0;0
14594;36719;4247;0;0;0;0;.00nan;0;0
14594;37786;169;54;28;4;24;.857;3600000;0
14594;44405;4247;47;30;5;25;.833;3558000;0
14594;85354;169;0;0;0;0;.00nan;0;0
14595;35172;170;0;0;0;0;.00nan;0;0
14595;36675;175;0;0;0;0;.00nan;0;0
14595;37897;170;74;31;3;28;.903;3600000;0
14595;44134;175;100;29;0;29;1.000;3600000;0
14596;2136;1527;0;0;0;0;.00nan;0;0
14596;57155;172;61;18;2;16;.889;3600000;0
14596;57215;172;0;0;0;0;.00nan;0;0
14596;85709;1527;62;37;4;33;.892;3513000;0
14597;173918;174;76;22;1;21;.955;3600000;0
14597;47547;167;62;25;2;23;.920;3600000;0
14597;57564;174;0;0;0;0;.00nan;0;0
14597;65125;167;0;0;0;0;.00nan;0;0
14598;59614;3916;80;34;2;32;.941;3548000;0
14598;64736;3916;0;0;0;0;.00nan;0;0
14598;91414;171;0;0;0;0;.00nan;0;0
14598;92313;171;93;30;1;29;.967;3600000;0
14599;36719;4247;44;35;6;29;.829;3600000;0
14599;37786;169;0;0;0;0;.00nan;0;0
14599;44405;4247;0;0;0;0;.00nan;0;0
14599;85354;169;100;36;1;35;.972;3600000;0
14600;35172;170;89;34;1;33;.971;3600000;0
14600;36675;175;0;0;0;0;.00nan;0;0
14600;37897;170;0;0;0;0;.00nan;0;0
14600;44134;175;65;28;3;25;.893;3516000;0
14601;2136;1527;81;43;3;40;.930;3533000;0
14601;57155;172;0;0;0;0;.00nan;0;0
14601;57215;172;99;42;1;41;.976;3600000;0
14601;85709;1527;0;0;0;0;.00nan;0;0
14602;36675;175;76;33;2;31;.939;3515000;0
14602;44134;175;0;0;0;0;.00nan;0;0
14602;47547;167;0;0;0;0;.00nan;0;0
14602;65125;167;100;27;0;27;1.000;3600000;0
14603;173918;174;52;43;5;38;.884;3520000;0
14603;35172;170;0;0;0;0;.00nan;0;0
14603;37897;170;55;18;3;15;.833;3600000;0
14603;57564;174;0;0;0;0;.00nan;0;0
14604;37786;169;49;36;6;30;.833;3900000;0
14604;59614;3916;41;31;6;25;.806;2946000;0
14604;64736;3916;69;8;0;8;1.000;954000;0
14604;85354;169;0;0;0;0;.00nan;0;0
14605;36675;175;0;0;0;0;.00nan;0;0
14605;36719;4247;0;0;0;0;.00nan;0;0
14605;44134;175;54;22;3;19;.864;3600000;0
14605;44405;4247;69;33;4;29;.879;3547000;0
14606;47547;167;0;0;0;0;.00nan;0;0
14606;65125;167;70;36;3;33;.917;3580000;0
14606;91414;171;65;19;1;18;.947;3600000;0
14606;92313;171;0;0;0;0;.00nan;0;0
14607;2136;1527;0;0;0;0;.00nan;0;0
14607;57155;172;0;0;0;0;.00nan;0;0
14607;57215;172;57;21;2;19;.905;3600000;0
14607;85709;1527;92;50;4;46;.920;3564000;0
14608;173918;174;0;0;0;0;.00nan;0;0
14608;35172;170;0;0;0;0;.00nan;0;0
14608;37897;170;55;31;4;27;.871;3600000;0
14608;57564;174;66;44;5;39;.886;3600000;0
14609;36675;175;84;30;1;29;.967;3600000;0
14609;36719;4247;74;30;3;27;.900;3589000;0
14609;44134;175;0;0;0;0;.00nan;0;0
14609;44405;4247;0;0;0;0;.00nan;0;0
14610;47547;167;93;42;2;40;.952;3557000;0
14610;65125;167;0;0;0;0;.00nan;0;0
14610;91414;171;0;0;0;0;.00nan;0;0
14610;92313;171;76;23;1;22;.957;3600000;0
14611;2136;1527;72;35;3;32;.914;3900000;0
14611;57155;172;65;25;3;22;.880;3900000;0
14611;57215;172;0;0;0;0;.00nan;0;0
14611;85709;1527;0;0;0;0;.00nan;0;0
14612;37786;169;0;0;0;0;.00nan;0;0
14612;59614;3916;0;0;0;0;.00nan;0;0
14612;64736;3916;76;26;2;24;.923;3769000;0
14612;85354;169;83;43;3;40;.930;3769000;0
14614;2136;1527;0;0;0;0;.00nan;0;0
14614;59614;3916;0;0;0;0;.00nan;0;0
14614;64736;3916;100;31;0;31;1.000;3600000;0
14614;85709;1527;36;37;6;31;.838;3600000;0
14616;-1;169;61;31;4;27;.871;3599000;0
14616;85354;169;0;0;0;0;.00nan;0;0
14616;91414;171;86;39;3;36;.923;3600000;0
14616;92313;171;0;0;0;0;.00nan;0;0
14618;35172;170;16;16;5;11;.688;1744000;0
14618;37897;170;54;10;1;9;.900;1856000;0
14618;57155;172;0;0;0;0;.00nan;0;0
14618;57215;172;82;28;1;27;.964;3600000;0
14620;36719;4247;0;0;0;0;.00nan;0;0
14620;44405;4247;95;55;2;53;.964;3900000;0
14620;47547;167;90;27;2;25;.926;3900000;0
14620;65125;167;0;0;0;0;.00nan;0;0
14622;173918;174;0;0;0;0;.00nan;0;0
14622;44134;175;73;46;4;42;.913;3579000;0
14622;44561;175;0;0;0;0;.00nan;0;0
14622;57564;174;66;25;2;23;.920;3600000;0
2060;36675;175;0;0;0;0;.00nan;0;0
2060;44134;175;54;23;3;20;.870;3600000;0
2060;57155;172;0;0;0;0;.00nan;0;0
2060;57215;172;71;23;1;22;.957;3600000;0
2061;35172;170;0;0;0;0;.00nan;0;0
2061;37897;170;80;27;2;25;.926;3600000;0
2061;91414;171;34;26;5;21;.808;3600000;0
2061;92313;171;0;0;0;0;.00nan;0;0
2062;37786;169;40;34;6;28;.824;3600000;0
2062;59614;3916;0;0;0;0;.00nan;0;0
2062;64736;3916;56;30;4;26;.867;3600000;0
2062;85354;169;0;0;0;0;.00nan;0;0
2063;173918;174;82;25;1;24;.960;3600000;0
2063;36719;4247;0;0;0;0;.00nan;0;0
2063;44405;4247;67;33;3;30;.909;3562000;0
2063;57564;174;0;0;0;0;.00nan;0;0
2064;36675;175;0;0;0;0;.00nan;0;0
2064;44134;175;94;39;2;37;.949;4179000;0
2064;57155;172;0;0;0;0;.00nan;0;0
2064;57215;172;77;25;1;24;.960;4179000;0
2065;35172;170;0;0;0;0;.00nan;0;0
2065;37897;170;90;37;3;34;.919;3600000;0
2065;91414;171;100;37;0;37;1.000;3600000;0
2065;92313;171;0;0;0;0;.00nan;0;0
2066;37786;169;78;24;1;23;.958;3600000;0
2066;59614;3916;0;0;0;0;.00nan;0;0
2066;64736;3916;91;39;2;37;.949;3590000;0
2066;85354;169;0;0;0;0;.00nan;0;0
2067;173918;174;76;38;3;35;.921;3557000;0
2067;36719;4247;0;0;0;0;.00nan;0;0
2067;44405;4247;62;23;2;21;.913;3600000;0
2067;57564;174;0;0;0;0;.00nan;0;0
2177;35172;170;0;0;0;0;.00nan;0;0
2177;37897;170;79;36;3;33;.917;3600000;0
2177;91414;171;78;26;1;25;.962;3600000;0
2177;92313;171;0;0;0;0;.00nan;0;0
2178;37786;169;10;22;6;16;.727;1509000;0
2178;59614;3916;0;0;0;0;.00nan;0;0
2178;64736;3916;52;13;2;11;.846;3600000;0
2178;85354;169;43;16;3;13;.813;2091000;0
2179;173918;174;75;32;2;30;.938;4785000;0
2179;36719;4247;0;0;0;0;.00nan;0;0
2179;44405;4247;92;31;1;30;.968;4785000;0
2179;57564;174;0;0;0;0;.00nan;0;0
2221;57155;172;0;0;0;0;.00nan;0;0
2221;57215;172;80;34;2;32;.941;3600000;0
2221;91414;171;57;27;3;24;.889;3549000;0
2221;92313;171;0;0;0;0;.00nan;0;0
2222;36719;4247;0;0;0;0;.00nan;0;0
2222;44405;4247;41;35;6;29;.829;3600000;0
2222;59614;3916;0;0;0;0;.00nan;0;0
2222;64736;3916;76;23;2;21;.913;3600000;0
2223;57155;172;0;0;0;0;.00nan;0;0
2223;57215;172;99;24;0;24;1.000;3600000;0
2223;91414;171;65;24;2;22;.917;3515000;0
2223;92313;171;0;0;0;0;.00nan;0;0
2224;36719;4247;49;15;2;13;.867;1520000;0
2224;44405;4247;35;28;6;22;.786;2080000;0
2224;59614;3916;0;0;0;0;.00nan;0;0
2224;64736;3916;56;28;3;25;.893;3600000;0
2389;57155;172;0;0;0;0;.00nan;0;0
2389;57215;172;75;43;4;39;.907;3547000;0
2389;59614;3916;0;0;0;0;.00nan;0;0
2389;64736;3916;53;16;2;14;.875;3600000;0
2390;57155;172;0;0;0;0;.00nan;0;0
2390;57215;172;65;33;3;30;.909;3600000;0
2390;59614;3916;0;0;0;0;.00nan;0;0
2390;64736;3916;60;15;1;14;.933;3600000;0
14623;-1;441;89;41;2;39;.951;3600000;0
14623;174386;428;48;21;3;18;.857;3546000;0
14623;57764;441;0;0;0;0;.00nan;0;0
14623;86531;428;0;0;0;0;.00nan;0;0
14624;176808;418;0;0;0;0;.00nan;0;0
14624;-1;419;56;11;1;10;.909;3600000;0
14624;180965;418;54;41;5;36;.878;3600000;0
14624;76378;419;0;0;0;0;.00nan;0;0
14625;171930;422;65;22;2;20;.909;3600000;0
14625;166767;422;0;0;0;0;.00nan;0;0
14625;174241;421;90;42;4;38;.905;3600000;0
14625;74680;421;0;0;0;0;.00nan;0;0
14626;176808;418;0;0;0;0;.00nan;0;0
14626;-1;419;54;24;3;21;.875;3546000;0
14626;180965;418;86;45;2;43;.956;3600000;0
14626;76378;419;0;0;0;0;.00nan;0;0
14627;171930;422;0;0;0;0;.00nan;0;0
14627;166767;422;85;13;0;13;1.000;3600000;0
14627;174241;421;78;43;4;39;.907;3600000;0
14627;74680;421;0;0;0;0;.00nan;0;0
14628;168360;444;0;0;0;0;.00nan;0;0
14628;168855;444;72;29;2;27;.931;3600000;0
14628;179143;423;57;29;3;26;.897;3589000;0
14628;85649;423;0;0;0;0;.00nan;0;0
14629;171578;449;0;0;0;0;.00nan;0;0
14629;74980;420;0;0;0;0;.00nan;0;0
14629;77123;420;70;33;3;30;.909;4200000;0
14629;141530;449;66;34;3;31;.912;4200000;0
14630;168360;444;39;24;4;20;.833;3600000;0
14630;168855;444;0;0;0;0;.00nan;0;0
14630;179143;423;75;25;1;24;.960;3600000;0
14630;85649;423;0;0;0;0;.00nan;0;0
14631;171578;449;0;0;0;0;.00nan;0;0
14631;74980;420;76;38;3;35;.921;3968000;0
14631;77123;420;0;0;0;0;.00nan;0;0
14631;141530;449;53;19;2;17;.895;3968000;0
14632;177155;411;51;37;6;31;.838;3587000;0
14632;175989;410;0;0;0;0;.00nan;0;0
14632;78864;410;64;35;4;31;.886;3600000;0
14632;141459;411;0;0;0;0;.00nan;0;0
14633;173954;438;0;0;0;0;.00nan;0;0
14633;78492;438;97;58;4;54;.931;3600000;0
14633;86579;434;91;28;1;27;.964;3600000;0
14633;152650;434;0;0;0;0;.00nan;0;0
14634;170878;430;0;0;0;0;.00nan;0;0
14634;179103;425;76;24;2;22;.917;3600000;0
14634;-1;430;41;36;6;30;.833;3600000;0
14634;160809;425;0;0;0;0;.00nan;0;0
14635;165751;435;0;0;0;0;.00nan;0;0
14635;174325;427;45;22;3;19;.864;3694000;0
14635;-1;427;0;0;0;0;.00nan;0;0
14635;91448;435;46;31;4;27;.871;3733000;0
14636;173575;437;0;0;0;0;.00nan;0;0
14636;139865;437;56;27;3;24;.889;3553000;0
14636;141294;436;0;0;0;0;.00nan;0;0
14636;160967;436;75;22;2;20;.909;3600000;0
14637;171787;417;0;0;0;0;.00nan;0;0
14637;-1;415;0;0;0;0;.00nan;0;0
14637;85050;417;89;36;2;34;.944;3600000;0
14637;94557;415;60;29;3;26;.897;3575000;0
14638;179143;423;75;26;1;25;.962;3600000;0
14638;171578;449;0;0;0;0;.00nan;0;0
14638;85649;423;0;0;0;0;.00nan;0;0
14638;141530;449;51;25;3;22;.880;3542000;0
14639;169027;442;0;0;0;0;.00nan;0;0
14639;171517;431;42;23;4;19;.826;3863000;0
14639;-1;442;65;37;3;34;.919;3879000;0
14639;149996;431;0;0;0;0;.00nan;0;0
14640;176808;418;0;0;0;0;.00nan;0;0
14640;179691;4849;0;0;0;0;.00nan;0;0
14640;180965;418;58;27;3;24;.889;4200000;0
14640;161023;4849;77;34;3;31;.912;4200000;0
14641;179103;425;41;21;4;17;.810;3515000;0
14641;85987;426;0;0;0;0;.00nan;0;0
14641;86226;426;65;23;2;21;.913;3600000;0
14641;160809;425;0;0;0;0;.00nan;0;0
14642;163228;429;0;0;0;0;.00nan;0;0
14642;-1;443;0;0;0;0;.00nan;0;0
14642;-1;429;41;26;4;22;.846;3600000;0
14642;170928;443;59;40;5;35;.875;3600000;0
14643;168360;444;100;26;0;26;1.000;3600000;0
14643;168855;444;0;0;0;0;.00nan;0;0
14643;74980;420;60;13;1;12;.923;3547000;0
14643;77123;420;0;0;0;0;.00nan;0;0
14644;168206;414;66;22;2;20;.909;3600000;0
14644;-1;413;0;0;0;0;.00nan;0;0
14644;-1;413;60;30;4;26;.867;3588000;0
14644;58110;414;0;0;0;0;.00nan;0;0
14645;174241;421;0;0;0;0;.00nan;0;0
14645;-1;419;41;25;5;20;.800;3600000;0
14645;74680;421;87;34;2;32;.941;3600000;0
14645;76378;419;0;0;0;0;.00nan;0;0
14646;165611;440;69;14;1;13;.929;3600000;0
14646;-1;433;24;29;6;23;.793;3600000;0
14646;170886;440;0;0;0;0;.00nan;0;0
14646;149937;433;0;0;0;0;.00nan;0;0
14647;169006;432;0;0;0;0;.00nan;0;0
14647;182093;432;74;43;4;39;.907;3600000;0
14647;59525;439;0;0;0;0;.00nan;0;0
14647;142583;439;76;21;1;20;.952;3600000;0
14648;175989;410;0;0;0;0;.00nan;0;0
14648;-1;412;0;0;0;0;.00nan;0;0
14648;-1;412;67;49;4;45;.918;4200000;0
14648;78864;410;64;29;4;25;.862;4200000;0
14649;165751;435;0;0;0;0;.00nan;0;0
14649;86579;434;62;21;2;19;.905;3600000;0
14649;91448;435;69;44;4;40;.909;3538000;0
14649;152650;434;0;0;0;0;.00nan;0;0
14650;169027;442;0;0;0;0;.00nan;0;0
14650;171517;431;63;14;1;13;.929;3600000;0
14650;-1;442;64;32;3;29;.906;3568000;0
14650;149996;431;0;0;0;0;.00nan;0;0
14651;176808;418;67;19;1;18;.947;3600000;0
14651;179691;4849;0;0;0;0;.00nan;0;0
14651;180965;418;0;0;0;0;.00nan;0;0
14651;161023;4849;91;17;0;17;1.000;3600000;0
14652;163228;429;0;0;0;0;.00nan;0;0
14652;-1;429;85;29;1;28;.966;3600000;0
14652;85987;426;0;0;0;0;.00nan;0;0
14652;86226;426;59;28;3;25;.893;3581000;0
14653;171787;417;0;0;0;0;.00nan;0;0
14653;-1;413;0;0;0;0;.00nan;0;0
14653;-1;413;73;36;3;33;.917;3589000;0
14653;85050;417;65;26;2;24;.923;3600000;0
14654;-1;433;64;34;3;31;.912;3600000;0
14654;141294;436;0;0;0;0;.00nan;0;0
14654;149937;433;0;0;0;0;.00nan;0;0
14654;160967;436;63;41;4;37;.902;3543000;0
14655;179143;423;0;0;0;0;.00nan;0;0
14655;171578;449;62;24;2;22;.917;3600000;0
14655;85649;423;56;30;4;26;.867;3558000;0
14655;141530;449;0;0;0;0;.00nan;0;0
14656;168360;444;100;37;2;35;.946;3772000;0
14656;168855;444;0;0;0;0;.00nan;0;0
14656;74980;420;82;35;3;32;.914;3772000;0
14656;77123;420;0;0;0;0;.00nan;0;0
14657;174241;421;77;37;3;34;.919;3600000;0
14657;-1;419;0;0;0;0;.00nan;0;0
14657;74680;421;0;0;0;0;.00nan;0;0
14657;76378;419;32;38;7;31;.816;3600000;0
14658;168206;414;72;30;2;28;.933;3544000;0
14658;-1;415;99;51;1;50;.980;3600000;0
14658;58110;414;0;0;0;0;.00nan;0;0
14658;94557;415;0;0;0;0;.00nan;0;0
14659;165611;440;58;16;1;15;.938;4200000;0
14659;169006;432;0;0;0;0;.00nan;0;0
14659;170886;440;0;0;0;0;.00nan;0;0
14659;182093;432;100;43;1;42;.977;4200000;0
14660;177155;411;62;27;3;24;.889;3527000;0
14660;-1;412;0;0;0;0;.00nan;0;0
14660;-1;412;86;34;1;33;.971;3600000;0
14660;141459;411;0;0;0;0;.00nan;0;0
14661;173575;437;0;0;0;0;.00nan;0;0
14661;59525;439;0;0;0;0;.00nan;0;0
14661;139865;437;53;46;6;40;.870;3600000;0
14661;142583;439;80;22;1;21;.955;3600000;0
14662;179103;425;72;9;0;9;1.000;3600000;0
14662;174325;427;87;35;2;33;.943;3600000;0
14662;-1;427;0;0;0;0;.00nan;0;0
14662;160809;425;0;0;0;0;.00nan;0;0
14663;165611;440;68;20;1;19;.950;4200000;0
14663;170886;440;0;0;0;0;.00nan;0;0
14663;141294;436;85;31;1;30;.968;4200000;0
14663;160967;436;0;0;0;0;.00nan;0;0
14664;177155;411;0;0;0;0;.00nan;0;0
14664;168206;414;87;30;1;29;.967;3600000;0
14664;58110;414;0;0;0;0;.00nan;0;0
14664;141459;411;49;21;3;18;.857;3520000;0
14665;171517;431;49;46;6;40;.870;3600000;0
14665;174386;428;61;22;3;19;.864;3600000;0
14665;86531;428;0;0;0;0;.00nan;0;0
14665;149996;431;0;0;0;0;.00nan;0;0
14666;165611;440;0;0;0;0;.00nan;0;0
14666;170886;440;82;28;1;27;.964;3600000;0
14666;59525;439;0;0;0;0;.00nan;0;0
14666;142583;439;72;38;4;34;.895;3600000;0
14667;163228;429;28;20;5;15;.750;3600000;0
14667;-1;429;0;0;0;0;.00nan;0;0
14667;174325;427;0;0;0;0;.00nan;0;0
14667;-1;427;50;34;4;30;.882;3600000;0
14668;171787;417;0;0;0;0;.00nan;0;0
14668;177155;411;87;35;2;33;.943;3600000;0
14668;85050;417;58;25;3;22;.880;3574000;0
14668;141459;411;0;0;0;0;.00nan;0;0
14669;179143;423;59;22;3;19;.864;3751000;0
14669;176808;418;0;0;0;0;.00nan;0;0
14669;180965;418;42;21;4;17;.810;3751000;0
14669;85649;423;0;0;0;0;.00nan;0;0
14670;179103;425;38;37;6;31;.838;3600000;0
14670;86579;434;59;17;2;15;.882;3600000;0
14670;152650;434;0;0;0;0;.00nan;0;0
14670;160809;425;0;0;0;0;.00nan;0;0
14671;173575;437;0;0;0;0;.00nan;0;0
14671;169027;442;72;38;3;35;.921;4200000;0
14671;-1;442;0;0;0;0;.00nan;0;0
14671;139865;437;62;30;3;27;.900;4200000;0
14672;171578;449;0;0;0;0;.00nan;0;0
14672;-1;419;64;15;1;14;.933;3600000;0
14672;76378;419;0;0;0;0;.00nan;0;0
14672;141530;449;83;47;4;43;.915;3600000;0
14673;-1;415;40;2;1;1;.500;478000;0
14673;175989;410;0;0;0;0;.00nan;0;0
14673;78864;410;87;43;3;40;.930;3600000;0
14673;94557;415;14;18;6;12;.667;3122000;0
14674;165751;435;81;39;1;38;.974;4200000;0
14674;-1;443;100;39;1;38;.974;4200000;0
14674;170928;443;0;0;0;0;.00nan;0;0
14674;91448;435;0;0;0;0;.00nan;0;0
14675;173954;438;0;0;0;0;.00nan;0;0
14675;78492;438;68;33;3;30;.909;3600000;0
14675;85987;426;0;0;0;0;.00nan;0;0
14675;86226;426;61;19;2;17;.895;3600000;0
14676;168360;444;0;0;0;0;.00nan;0;0
14676;168855;444;60;34;4;30;.882;3583000;0
14676;179691;4849;0;0;0;0;.00nan;0;0
14676;161023;4849;58;23;2;21;.913;3600000;0
14677;171930;422;0;0;0;0;.00nan;0;0
14677;166767;422;56;19;3;16;.842;3769000;0
14677;74980;420;0;0;0;0;.00nan;0;0
14677;77123;420;55;29;4;25;.862;3769000;0
14678;-1;413;91;52;3;49;.942;3600000;0
14678;-1;413;0;0;0;0;.00nan;0;0
14678;-1;412;76;26;1;25;.962;3600000;0
14678;-1;412;0;0;0;0;.00nan;0;0
14679;-1;433;38;32;5;27;.844;3528000;0
14679;171517;431;0;0;0;0;.00nan;0;0
14679;149937;433;0;0;0;0;.00nan;0;0
14679;149996;431;63;26;3;23;.885;3600000;0
14680;169006;432;0;0;0;0;.00nan;0;0
14680;-1;441;58;33;3;30;.909;3600000;0
14680;182093;432;92;16;0;16;1.000;3600000;0
14680;57764;441;0;0;0;0;.00nan;0;0
14681;171578;449;0;0;0;0;.00nan;0;0
14681;-1;419;39;9;2;7;.778;1749000;0
14681;76378;419;31;14;4;10;.714;1851000;0
14681;141530;449;80;33;2;31;.939;3600000;0
14682;174386;428;0;0;0;0;.00nan;0;0
14682;86531;428;46;20;3;17;.850;3553000;0
14682;141294;436;0;0;0;0;.00nan;0;0
14682;160967;436;86;25;1;24;.960;3600000;0
14683;173575;437;79;28;1;27;.964;4094000;0
14683;169027;442;0;0;0;0;.00nan;0;0
14683;-1;442;82;36;2;34;.944;4094000;0
14683;139865;437;0;0;0;0;.00nan;0;0
14684;170878;430;82;36;2;34;.944;3600000;0
14684;174325;427;43;24;5;19;.792;3600000;0
14684;-1;430;0;0;0;0;.00nan;0;0
14684;-1;427;0;0;0;0;.00nan;0;0
14685;-1;413;0;0;0;0;.00nan;0;0
14685;175989;410;0;0;0;0;.00nan;0;0
14685;-1;413;60;26;3;23;.885;3577000;0
14685;78864;410;62;18;2;16;.889;3600000;0
14686;179143;423;0;0;0;0;.00nan;0;0
14686;176808;418;65;25;3;22;.880;3590000;0
14686;180965;418;0;0;0;0;.00nan;0;0
14686;85649;423;100;42;1;41;.976;3600000;0
14687;165751;435;0;0;0;0;.00nan;0;0
14687;85987;426;77;25;1;24;.960;3600000;0
14687;86226;426;0;0;0;0;.00nan;0;0
14687;91448;435;64;30;3;27;.900;3553000;0
14688;-1;443;75;28;2;26;.929;3600000;0
14688;173954;438;43;27;5;22;.815;3600000;0
14688;170928;443;0;0;0;0;.00nan;0;0
14688;78492;438;0;0;0;0;.00nan;0;0
14689;171787;417;85;27;1;26;.963;3600000;0
14689;168206;414;62;28;3;25;.893;3513000;0
14689;58110;414;0;0;0;0;.00nan;0;0
14689;85050;417;0;0;0;0;.00nan;0;0
14690;168360;444;34;30;6;24;.800;3757000;0
14690;168855;444;0;0;0;0;.00nan;0;0
14690;179691;4849;59;32;5;27;.844;3757000;0
14690;161023;4849;0;0;0;0;.00nan;0;0
14691;171930;422;0;0;0;0;.00nan;0;0
14691;166767;422;51;30;4;26;.867;3564000;0
14691;74980;420;89;37;2;35;.946;3600000;0
14691;77123;420;0;0;0;0;.00nan;0;0
14692;-1;415;41;24;4;20;.833;3866000;0
14692;-1;412;0;0;0;0;.00nan;0;0
14692;-1;412;74;51;5;46;.902;3868000;0
14692;94557;415;0;0;0;0;.00nan;0;0
14693;163228;429;0;0;0;0;.00nan;0;0
14693;-1;429;56;28;3;25;.893;3581000;0
14693;86579;434;63;15;1;14;.933;3600000;0
14693;152650;434;0;0;0;0;.00nan;0;0
14694;169006;432;0;0;0;0;.00nan;0;0
14694;-1;441;0;0;0;0;.00nan;0;0
14694;182093;432;74;21;1;20;.952;3600000;0
14694;57764;441;77;35;3;32;.914;3516000;0
14695;-1;413;45;36;5;31;.861;3589000;0
14695;-1;415;0;0;0;0;.00nan;0;0
14695;-1;413;0;0;0;0;.00nan;0;0
14695;94557;415;59;22;3;19;.864;3600000;0
14696;163228;429;54;28;4;24;.857;4200000;0
14696;-1;429;0;0;0;0;.00nan;0;0
14696;170878;430;70;41;4;37;.902;4200000;0
14696;-1;430;0;0;0;0;.00nan;0;0
14697;-1;433;71;29;2;27;.931;3600000;0
14697;59525;439;0;0;0;0;.00nan;0;0
14697;142583;439;64;27;3;24;.889;3573000;0
14697;149937;433;0;0;0;0;.00nan;0;0
14698;179691;4849;0;0;0;0;.00nan;0;0
14698;74980;420;82;35;2;33;.943;3600000;0
14698;77123;420;0;0;0;0;.00nan;0;0
14698;161023;4849;92;19;0;19;1.000;3600000;0
14699;165611;440;88;34;2;32;.941;3600000;0
14699;-1;433;0;0;0;0;.00nan;0;0
14699;170886;440;0;0;0;0;.00nan;0;0
14699;149937;433;36;40;7;33;.825;3600000;0
14700;171787;417;0;0;0;0;.00nan;0;0
14700;-1;412;0;0;0;0;.00nan;0;0
14700;-1;412;79;44;5;39;.886;3600000;0
14700;85050;417;77;15;1;14;.933;3600000;0
14701;171578;449;0;0;0;0;.00nan;0;0
14701;176808;418;0;0;0;0;.00nan;0;0
14701;180965;418;49;23;4;19;.826;3600000;0
14701;141530;449;83;31;1;30;.968;3600000;0
14702;165751;435;62;32;3;29;.906;3545000;0
14702;171517;431;63;23;2;21;.913;3600000;0
14702;91448;435;0;0;0;0;.00nan;0;0
14702;149996;431;0;0;0;0;.00nan;0;0
14703;173575;437;0;0;0;0;.00nan;0;0
14703;85987;426;0;0;0;0;.00nan;0;0
14703;86226;426;47;38;5;33;.868;3600000;0
14703;139865;437;63;25;2;23;.920;3600000;0
14704;173954;438;0;0;0;0;.00nan;0;0
14704;174386;428;90;26;1;25;.962;3600000;0
14704;78492;438;50;30;4;26;.867;3600000;0
14704;86531;428;0;0;0;0;.00nan;0;0
14705;171930;422;0;0;0;0;.00nan;0;0
14705;166767;422;65;27;3;24;.889;4081000;0
14705;-1;419;83;47;4;43;.915;4081000;0
14705;76378;419;0;0;0;0;.00nan;0;0
14706;163228;429;0;0;0;0;.00nan;0;0
14706;-1;429;68;27;2;25;.926;4200000;0
14706;170878;430;100;45;2;43;.956;4200000;0
14706;-1;430;0;0;0;0;.00nan;0;0
14707;-1;441;84;31;1;30;.968;3563000;0
14707;57764;441;0;0;0;0;.00nan;0;0
14707;86579;434;100;25;0;25;1.000;3600000;0
14707;152650;434;0;0;0;0;.00nan;0;0
14708;-1;443;100;33;0;33;1.000;3600000;0
14708;170928;443;0;0;0;0;.00nan;0;0
14708;141294;436;0;0;0;0;.00nan;0;0
14708;160967;436;68;23;1;22;.957;3562000;0
14709;168206;414;63;28;3;25;.893;3863000;0
14709;175989;410;0;0;0;0;.00nan;0;0
14709;58110;414;0;0;0;0;.00nan;0;0
14709;78864;410;62;33;4;29;.879;3863000;0
14710;168360;444;0;0;0;0;.00nan;0;0
14710;168855;444;51;35;5;30;.857;3555000;0
14710;174241;421;57;28;4;24;.857;3600000;0
14710;74680;421;0;0;0;0;.00nan;0;0
14711;165611;440;0;0;0;0;.00nan;0;0
14711;170886;440;51;23;3;20;.870;3600000;0
14711;179103;425;29;31;6;25;.806;3326000;0
14711;160809;425;50;1;0;1;1.000;274000;0
14712;177155;411;0;0;0;0;.00nan;0;0
14712;-1;413;45;7;1;6;.857;462000;0
14712;-1;413;61;46;6;40;.870;3138000;0
14712;141459;411;53;28;4;24;.857;3600000;0
14713;171787;417;98;26;0;26;1.000;3600000;0
14713;175989;410;67;29;2;27;.931;3581000;0
14713;78864;410;0;0;0;0;.00nan;0;0
14713;85050;417;0;0;0;0;.00nan;0;0
14714;173954;438;44;31;6;25;.806;3127000;0
14714;171517;431;0;0;0;0;.00nan;0;0
14714;78492;438;43;4;1;3;.750;473000;0
14714;149996;431;95;21;0;21;1.000;3600000;0
14715;171578;449;67;41;4;37;.902;4200000;0
14715;176808;418;60;29;4;25;.862;4175000;0
14715;180965;418;0;0;0;0;.00nan;0;0
14715;141530;449;0;0;0;0;.00nan;0;0
14716;85987;426;92;33;1;32;.970;3600000;0
14716;86226;426;0;0;0;0;.00nan;0;0
14716;141294;436;53;27;3;24;.889;3600000;0
14716;160967;436;0;0;0;0;.00nan;0;0
14717;165751;435;76;27;1;26;.963;2818000;0
14717;174386;428;0;0;0;0;.00nan;0;0
14717;86531;428;61;33;4;29;.879;3600000;0
14717;91448;435;13;5;4;1;.200;782000;0
14718;169027;442;42;27;5;22;.815;3600000;0
14718;174325;427;94;39;2;37;.949;3600000;0
14718;-1;442;0;0;0;0;.00nan;0;0
14718;-1;427;0;0;0;0;.00nan;0;0
14719;171930;422;82;24;1;23;.958;3600000;0
14719;166767;422;0;0;0;0;.00nan;0;0
14719;-1;419;0;0;0;0;.00nan;0;0
14719;76378;419;57;23;2;21;.913;3600000;0
14720;179103;425;0;0;0;0;.00nan;0;0
14720;-1;441;0;0;0;0;.00nan;0;0
14720;57764;441;95;45;2;43;.956;3600000;0
14720;160809;425;59;10;1;9;.900;3600000;0
14721;-1;443;57;29;4;25;.862;3600000;0
14721;173575;437;51;25;3;22;.880;3600000;0
14721;170928;443;0;0;0;0;.00nan;0;0
14721;139865;437;0;0;0;0;.00nan;0;0
14722;168360;444;98;44;1;43;.977;3600000;0
14722;168855;444;0;0;0;0;.00nan;0;0
14722;174241;421;0;0;0;0;.00nan;0;0
14722;74680;421;51;26;4;22;.846;3600000;0
14723;168206;414;0;0;0;0;.00nan;0;0
14723;-1;412;63;23;3;20;.870;3534000;0
14723;-1;412;0;0;0;0;.00nan;0;0
14723;58110;414;79;25;1;24;.960;3600000;0
14724;179691;4849;0;0;0;0;.00nan;0;0
14724;74980;420;56;33;5;28;.848;3600000;0
14724;77123;420;0;0;0;0;.00nan;0;0
14724;161023;4849;73;24;1;23;.958;3600000;0
14725;177155;411;83;28;1;27;.964;3600000;0
14725;-1;415;53;39;5;34;.872;3600000;0
14725;94557;415;0;0;0;0;.00nan;0;0
14725;141459;411;0;0;0;0;.00nan;0;0
14726;-1;413;67;37;4;33;.892;3600000;0
14726;-1;415;87;31;2;29;.935;3600000;0
14726;-1;413;0;0;0;0;.00nan;0;0
14726;94557;415;0;0;0;0;.00nan;0;0
14727;86579;434;33;24;5;19;.792;3600000;0
14727;141294;436;0;0;0;0;.00nan;0;0
14727;152650;434;0;0;0;0;.00nan;0;0
14727;160967;436;67;39;4;35;.897;3600000;0
14728;179103;425;57;29;3;26;.897;3552000;0
14728;174386;428;91;41;2;39;.951;3600000;0
14728;86531;428;0;0;0;0;.00nan;0;0
14728;160809;425;0;0;0;0;.00nan;0;0
14729;-1;419;46;18;3;15;.833;3600000;0
14729;74980;420;38;27;5;22;.815;3588000;0
14729;76378;419;0;0;0;0;.00nan;0;0
14729;77123;420;0;0;0;0;.00nan;0;0
14730;171930;422;0;0;0;0;.00nan;0;0
14730;166767;422;83;13;0;13;1.000;3600000;0
14730;179143;423;80;52;5;47;.904;3600000;0
14730;85649;423;0;0;0;0;.00nan;0;0
14731;170878;430;59;28;3;25;.893;3600000;0
14731;171517;431;0;0;0;0;.00nan;0;0
14731;-1;430;0;0;0;0;.00nan;0;0
14731;149996;431;67;38;4;34;.895;3588000;0
14732;168206;414;64;35;4;31;.886;4200000;0
14732;175989;410;0;0;0;0;.00nan;0;0
14732;58110;414;0;0;0;0;.00nan;0;0
14732;78864;410;46;29;4;25;.862;4200000;0
14733;174325;427;63;27;2;25;.926;3551000;0
14733;-1;427;0;0;0;0;.00nan;0;0
14733;86579;434;84;26;1;25;.962;3600000;0
14733;152650;434;0;0;0;0;.00nan;0;0
14734;163228;429;0;0;0;0;.00nan;0;0
14734;165751;435;0;0;0;0;.00nan;0;0
14734;-1;429;77;18;1;17;.944;3600000;0
14734;91448;435;62;30;3;27;.900;3546000;0
14735;173954;438;0;0;0;0;.00nan;0;0
14735;59525;439;0;0;0;0;.00nan;0;0
14735;78492;438;24;26;6;20;.769;3600000;0
14735;142583;439;81;22;1;21;.955;3600000;0
14736;174241;421;79;25;1;24;.960;3600000;0
14736;179691;4849;0;0;0;0;.00nan;0;0
14736;74680;421;0;0;0;0;.00nan;0;0
14736;161023;4849;63;25;2;23;.920;3600000;0
14737;165611;440;39;8;2;6;.750;3600000;0
14737;169027;442;0;0;0;0;.00nan;0;0
14737;170886;440;0;0;0;0;.00nan;0;0
14737;-1;442;45;39;6;33;.846;3600000;0
14738;171787;417;71;17;1;16;.941;3600000;0
14738;-1;412;0;0;0;0;.00nan;0;0
14738;-1;412;97;39;2;37;.949;3564000;0
14738;85050;417;0;0;0;0;.00nan;0;0
14739;177155;411;75;19;1;18;.947;3600000;0
14739;-1;413;0;0;0;0;.00nan;0;0
14739;-1;413;83;52;4;48;.923;3600000;0
14739;141459;411;0;0;0;0;.00nan;0;0
14740;173575;437;0;0;0;0;.00nan;0;0
14740;-1;441;67;30;3;27;.900;3600000;0
14740;57764;441;0;0;0;0;.00nan;0;0
14740;139865;437;87;17;0;17;1.000;3600000;0
14741;-1;433;73;32;3;29;.906;3600000;0
14741;85987;426;0;0;0;0;.00nan;0;0
14741;86226;426;66;38;4;34;.895;3600000;0
14741;149937;433;0;0;0;0;.00nan;0;0
14742;-1;443;100;42;2;40;.952;3600000;0
14742;169006;432;0;0;0;0;.00nan;0;0
14742;170928;443;0;0;0;0;.00nan;0;0
14742;182093;432;39;19;4;15;.789;3559000;0
14743;179103;425;0;0;0;0;.00nan;0;0
14743;171517;431;94;35;1;34;.971;3600000;0
14743;149996;431;0;0;0;0;.00nan;0;0
14743;160809;425;6;22;7;15;.682;3600000;0
14744;-1;441;0;0;0;0;.00nan;0;0
14744;57764;441;96;39;1;38;.974;4200000;0
14744;141294;436;0;0;0;0;.00nan;0;0
14744;160967;436;68;19;1;18;.947;4200000;0
14745;-1;419;0;0;0;0;.00nan;0;0
14745;74980;420;0;0;0;0;.00nan;0;0
14745;76378;419;68;20;2;18;.900;4141000;0
14745;77123;420;100;46;1;45;.978;4141000;0
14746;171930;422;0;0;0;0;.00nan;0;0
14746;166767;422;58;23;3;20;.870;3546000;0
14746;179143;423;0;0;0;0;.00nan;0;0
14746;85649;423;94;40;2;38;.950;3600000;0
14747;170878;430;0;0;0;0;.00nan;0;0
14747;174386;428;0;0;0;0;.00nan;0;0
14747;-1;430;76;38;3;35;.921;3600000;0
14747;86531;428;42;22;4;18;.818;3600000;0
14748;171787;417;0;0;0;0;.00nan;0;0
14748;175989;410;52;22;3;19;.864;3982000;0
14748;78864;410;0;0;0;0;.00nan;0;0
14748;85050;417;67;28;2;26;.929;3982000;0
14749;173575;437;0;0;0;0;.00nan;0;0
14749;174325;427;0;0;0;0;.00nan;0;0
14749;-1;427;62;32;3;29;.906;3533000;0
14749;139865;437;92;33;1;32;.970;3600000;0
14750;165751;435;97;47;1;46;.979;3587000;0
14750;59525;439;96;15;0;15;1.000;3600000;0
14750;91448;435;0;0;0;0;.00nan;0;0
14750;142583;439;0;0;0;0;.00nan;0;0
14751;163228;429;58;17;2;15;.882;3600000;0
14751;-1;429;0;0;0;0;.00nan;0;0
14751;173954;438;71;38;3;35;.921;3599000;0
14751;78492;438;0;0;0;0;.00nan;0;0
14752;174241;421;0;0;0;0;.00nan;0;0
14752;179691;4849;98;36;1;35;.972;4200000;0
14752;74680;421;95;37;1;36;.973;4200000;0
14752;161023;4849;0;0;0;0;.00nan;0;0
14753;165611;440;0;0;0;0;.00nan;0;0
14753;169027;442;53;40;5;35;.875;3600000;0
14753;170886;440;84;28;1;27;.964;3600000;0
14753;-1;442;0;0;0;0;.00nan;0;0
14754;168206;414;73;17;1;16;.941;3600000;0
14754;-1;412;24;5;3;2;.400;601000;0
14754;-1;412;66;24;2;22;.917;2999000;0
14754;58110;414;0;0;0;0;.00nan;0;0
14755;177155;411;0;0;0;0;.00nan;0;0
14755;-1;415;90;41;2;39;.951;3976000;0
14755;94557;415;0;0;0;0;.00nan;0;0
14755;141459;411;76;38;3;35;.921;3976000;0
14756;-1;443;69;30;3;27;.900;3692000;0
14756;-1;433;63;26;2;24;.923;3692000;0
14756;170928;443;0;0;0;0;.00nan;0;0
14756;149937;433;0;0;0;0;.00nan;0;0
14757;169006;432;67;18;1;17;.944;4200000;0
14757;182093;432;0;0;0;0;.00nan;0;0
14757;85987;426;81;29;1;28;.966;4200000;0
14757;86226;426;0;0;0;0;.00nan;0;0
14758;177155;411;91;30;1;29;.967;3600000;0
14758;175989;410;0;0;0;0;.00nan;0;0
14758;78864;410;20;18;5;13;.722;3600000;0
14758;141459;411;0;0;0;0;.00nan;0;0
14759;173954;438;0;0;0;0;.00nan;0;0
14759;174325;427;100;39;0;39;1.000;3600000;0
14759;-1;427;0;0;0;0;.00nan;0;0
14759;78492;438;36;15;4;11;.733;3600000;0
14760;163228;429;100;25;0;25;1.000;3600000;0
14760;-1;429;0;0;0;0;.00nan;0;0
14760;179103;425;86;34;1;33;.971;3600000;0
14760;160809;425;0;0;0;0;.00nan;0;0
14761;173575;437;0;0;0;0;.00nan;0;0
14761;86579;434;81;26;1;25;.962;3600000;0
14761;139865;437;89;38;2;36;.947;3600000;0
14761;152650;434;0;0;0;0;.00nan;0;0
14762;59525;439;59;26;4;22;.846;3600000;0
14762;141294;436;67;12;0;12;1.000;1295000;0
14762;142583;439;0;0;0;0;.00nan;0;0
14762;160967;436;39;29;6;23;.793;2253000;0
14763;171930;422;56;18;2;16;.889;3600000;0
14763;166767;422;0;0;0;0;.00nan;0;0
14763;179691;4849;54;2;0;2;1.000;600000;0
14763;161023;4849;46;37;6;31;.838;3000000;0
14764;171787;417;0;0;0;0;.00nan;0;0
14764;-1;415;76;40;3;37;.925;3600000;0
14764;85050;417;78;27;1;26;.963;3600000;0
14764;94557;415;0;0;0;0;.00nan;0;0
14765;171578;449;0;0;0;0;.00nan;0;0
14765;174241;421;81;36;2;34;.944;4200000;0
14765;74680;421;0;0;0;0;.00nan;0;0
14765;141530;449;62;23;2;21;.913;4200000;0
14766;169006;432;0;0;0;0;.00nan;0;0
14766;171517;431;0;0;0;0;.00nan;0;0
14766;182093;432;86;29;1;28;.966;3600000;0
14766;149996;431;67;30;3;27;.900;3540000;0
14767;174325;427;52;33;5;28;.848;3600000;0
14767;174386;428;64;24;2;22;.917;3600000;0
14767;-1;427;0;0;0;0;.00nan;0;0
14767;86531;428;0;0;0;0;.00nan;0;0
14768;-1;433;44;23;3;20;.870;3540000;0
14768;169027;442;0;0;0;0;.00nan;0;0
14768;-1;442;90;38;1;37;.974;3600000;0
14768;149937;433;0;0;0;0;.00nan;0;0
14769;171930;422;0;0;0;0;.00nan;0;0
14769;166767;422;90;33;1;32;.970;3600000;0
14769;179691;4849;79;30;2;28;.933;3580000;0
14769;161023;4849;0;0;0;0;.00nan;0;0
14770;179143;423;44;28;5;23;.821;3600000;0
14770;74980;420;74;24;2;22;.917;3600000;0
14770;77123;420;0;0;0;0;.00nan;0;0
14770;85649;423;0;0;0;0;.00nan;0;0
14771;-1;443;80;26;1;25;.962;3600000;0
14771;170928;443;0;0;0;0;.00nan;0;0
14771;85987;426;0;0;0;0;.00nan;0;0
14771;86226;426;62;29;3;26;.897;3549000;0
14772;165751;435;0;0;0;0;.00nan;0;0
14772;-1;441;72;33;2;31;.939;3562000;0
14772;57764;441;0;0;0;0;.00nan;0;0
14772;91448;435;71;19;1;18;.947;3600000;0
14773;168360;444;77;32;2;30;.938;3563000;0
14773;168855;444;0;0;0;0;.00nan;0;0
14773;176808;418;0;0;0;0;.00nan;0;0
14773;180965;418;69;22;1;21;.955;3600000;0
14774;173954;438;54;36;5;31;.861;3572000;0
14774;170878;430;0;0;0;0;.00nan;0;0
14774;-1;430;59;30;4;26;.867;3600000;0
14774;78492;438;0;0;0;0;.00nan;0;0
14775;168206;414;81;34;2;32;.941;4200000;0
14775;-1;413;75;32;2;30;.938;4200000;0
14775;-1;413;0;0;0;0;.00nan;0;0
14775;58110;414;0;0;0;0;.00nan;0;0
14776;165611;440;77;30;2;28;.933;3600000;0
14776;170886;440;0;0;0;0;.00nan;0;0
14776;141294;436;0;0;0;0;.00nan;0;0
14776;160967;436;77;46;4;42;.913;3600000;0
14777;175989;410;0;0;0;0;.00nan;0;0
14777;-1;412;0;0;0;0;.00nan;0;0
14777;-1;412;74;29;2;27;.931;4200000;0
14777;78864;410;90;37;2;35;.946;4200000;0
14778;171787;417;78;34;3;31;.912;3600000;0
14778;-1;413;46;3;1;2;.667;330000;0
14778;-1;413;40;36;6;30;.833;3270000;0
14778;85050;417;0;0;0;0;.00nan;0;0
14779;171578;449;70;31;3;28;.903;3600000;0
14779;174241;421;58;30;4;26;.867;3600000;0
14779;74680;421;0;0;0;0;.00nan;0;0
14779;141530;449;0;0;0;0;.00nan;0;0
14780;171517;431;81;30;2;28;.933;3600000;0
14780;174325;427;0;0;0;0;.00nan;0;0
14780;-1;427;44;37;5;32;.865;3600000;0
14780;149996;431;0;0;0;0;.00nan;0;0
14781;-1;443;50;33;5;28;.848;3572000;0
14781;170928;443;0;0;0;0;.00nan;0;0
14781;85987;426;51;21;3;18;.857;3600000;0
14781;86226;426;0;0;0;0;.00nan;0;0
14782;169006;432;46;8;1;7;.875;1296000;0
14782;174386;428;0;0;0;0;.00nan;0;0
14782;182093;432;38;32;6;26;.813;2304000;0
14782;86531;428;86;30;1;29;.967;3600000;0
14783;-1;433;0;0;0;0;.00nan;0;0
14783;169027;442;82;41;3;38;.927;3600000;0
14783;-1;442;0;0;0;0;.00nan;0;0
14783;149937;433;71;28;2;26;.929;3600000;0
14784;179143;423;0;0;0;0;.00nan;0;0
14784;74980;420;0;0;0;0;.00nan;0;0
14784;77123;420;78;30;2;28;.933;3600000;0
14784;85649;423;56;29;4;25;.862;3571000;0
14785;165751;435;32;26;5;21;.808;3600000;0
14785;170878;430;73;29;2;27;.931;3600000;0
14785;-1;430;0;0;0;0;.00nan;0;0
14785;91448;435;0;0;0;0;.00nan;0;0
14786;168360;444;0;0;0;0;.00nan;0;0
14786;168855;444;67;33;3;30;.909;4200000;0
14786;176808;418;62;33;3;30;.909;4200000;0
14786;180965;418;0;0;0;0;.00nan;0;0
14787;173954;438;0;0;0;0;.00nan;0;0
14787;-1;441;0;0;0;0;.00nan;0;0
14787;57764;441;66;23;2;21;.913;3600000;0
14787;78492;438;45;33;5;28;.848;3600000;0
14788;168206;414;0;0;0;0;.00nan;0;0
14788;-1;415;0;0;0;0;.00nan;0;0
14788;58110;414;66;30;3;27;.900;4080000;0
14788;94557;415;64;25;2;23;.920;4080000;0
14789;59525;439;0;0;0;0;.00nan;0;0
14789;86579;434;86;15;0;15;1.000;3600000;0
14789;142583;439;98;39;2;37;.949;3570000;0
14789;152650;434;0;0;0;0;.00nan;0;0
14790;177155;411;0;0;0;0;.00nan;0;0
14790;-1;412;49;29;4;25;.862;3600000;0
14790;-1;412;0;0;0;0;.00nan;0;0
14790;141459;411;94;19;0;19;1.000;3600000;0
14791;165611;440;0;0;0;0;.00nan;0;0
14791;173575;437;83;35;2;33;.943;4200000;0
14791;170886;440;70;25;2;23;.920;4200000;0
14791;139865;437;0;0;0;0;.00nan;0;0
14792;163228;429;0;0;0;0;.00nan;0;0
14792;-1;429;65;26;2;24;.923;3600000;0
14792;179103;425;36;24;5;19;.792;3600000;0
14792;160809;425;0;0;0;0;.00nan;0;0
14793;177155;411;0;0;0;0;.00nan;0;0
14793;168206;414;67;23;2;21;.913;3600000;0
14793;58110;414;0;0;0;0;.00nan;0;0
14793;141459;411;58;31;4;27;.871;3517000;0
14794;163228;429;0;0;0;0;.00nan;0;0
14794;-1;429;68;21;1;20;.952;4198000;0
14794;170878;430;94;57;2;55;.965;4198000;0
14794;-1;430;0;0;0;0;.00nan;0;0
14795;174386;428;82;28;1;27;.964;3543000;0
14795;86531;428;0;0;0;0;.00nan;0;0
14795;141294;436;99;26;0;26;1.000;3600000;0
14795;160967;436;0;0;0;0;.00nan;0;0
14796;169027;442;0;0;0;0;.00nan;0;0
14796;-1;441;97;21;0;21;1.000;3600000;0
14796;-1;442;66;17;1;16;.941;3588000;0
14796;57764;441;0;0;0;0;.00nan;0;0
14797;165611;440;73;27;2;25;.926;3567000;0
14797;170886;440;0;0;0;0;.00nan;0;0
14797;86579;434;86;31;1;30;.968;3600000;0
14797;152650;434;0;0;0;0;.00nan;0;0
14798;171787;417;0;0;0;0;.00nan;0;0
14798;177155;411;56;17;2;15;.882;3600000;0
14798;85050;417;61;37;4;33;.892;3533000;0
14798;141459;411;0;0;0;0;.00nan;0;0
14799;173954;438;72;38;3;35;.921;4200000;0
14799;78492;438;0;0;0;0;.00nan;0;0
14799;85987;426;0;0;0;0;.00nan;0;0
14799;86226;426;60;33;3;30;.909;4200000;0
14800;-1;413;0;0;0;0;.00nan;0;0
14800;-1;413;68;29;3;26;.897;3591000;0
14800;-1;412;58;13;1;12;.923;3600000;0
14800;-1;412;0;0;0;0;.00nan;0;0
14801;174386;428;0;0;0;0;.00nan;0;0
14801;59525;439;0;0;0;0;.00nan;0;0
14801;86531;428;97;47;1;46;.979;4200000;0
14801;142583;439;74;19;1;18;.947;4200000;0
14802;179143;423;62;28;4;24;.857;3600000;0
14802;171578;449;0;0;0;0;.00nan;0;0
14802;85649;423;0;0;0;0;.00nan;0;0
14802;141530;449;81;27;1;26;.963;3600000;0
14803;169027;442;50;25;3;22;.880;3572000;0
14803;-1;441;95;38;2;36;.947;3600000;0
14803;-1;442;0;0;0;0;.00nan;0;0
14803;57764;441;0;0;0;0;.00nan;0;0
14804;165751;435;0;0;0;0;.00nan;0;0
14804;-1;443;0;0;0;0;.00nan;0;0
14804;170928;443;100;23;0;23;1.000;3600000;0
14804;91448;435;65;38;4;34;.895;3600000;0
14805;171930;422;0;0;0;0;.00nan;0;0
14805;166767;422;71;15;1;14;.933;3600000;0
14805;168360;444;69;40;4;36;.900;3600000;0
14805;168855;444;0;0;0;0;.00nan;0;0
14806;174241;421;75;24;1;23;.958;3600000;0
14806;176808;418;0;0;0;0;.00nan;0;0
14806;180965;418;67;32;3;29;.906;3550000;0
14806;74680;421;0;0;0;0;.00nan;0;0
14807;-1;415;69;30;3;27;.900;3557000;0
14807;175989;410;0;0;0;0;.00nan;0;0
14807;78864;410;75;25;2;23;.920;3600000;0
14807;94557;415;0;0;0;0;.00nan;0;0
14808;179691;4849;0;0;0;0;.00nan;0;0
14808;-1;419;53;25;3;22;.880;3600000;0
14808;76378;419;0;0;0;0;.00nan;0;0
14808;161023;4849;63;31;4;27;.871;3595000;0
14809;173575;437;0;0;0;0;.00nan;0;0
14809;171517;431;0;0;0;0;.00nan;0;0
14809;139865;437;63;24;3;21;.875;3589000;0
14809;149996;431;71;23;1;22;.957;3600000;0
14810;-1;433;84;44;3;41;.932;3600000;0
14810;179103;425;78;25;1;24;.960;3600000;0
14810;149937;433;0;0;0;0;.00nan;0;0
14810;160809;425;0;0;0;0;.00nan;0;0
14811;169006;432;0;0;0;0;.00nan;0;0
14811;174325;427;90;35;1;34;.971;3600000;0
14811;182093;432;56;21;2;19;.905;3554000;0
14811;-1;427;0;0;0;0;.00nan;0;0
14812;179143;423;0;0;0;0;.00nan;0;0
14812;171578;449;52;16;2;14;.875;3522000;0
14812;85649;423;100;42;0;42;1.000;3600000;0
14812;141530;449;0;0;0;0;.00nan;0;0
14813;165751;435;89;34;2;32;.941;3600000;0
14813;85987;426;35;19;4;15;.789;3579000;0
14813;86226;426;0;0;0;0;.00nan;0;0
14813;91448;435;0;0;0;0;.00nan;0;0
14814;-1;413;56;36;4;32;.889;3558000;0
14814;175989;410;56;23;2;21;.913;3600000;0
14814;-1;413;0;0;0;0;.00nan;0;0
14814;78864;410;0;0;0;0;.00nan;0;0
14815;170878;430;0;0;0;0;.00nan;0;0
14815;-1;430;67;30;3;27;.900;3600000;0
14815;86579;434;66;36;4;32;.889;3600000;0
14815;152650;434;0;0;0;0;.00nan;0;0
14816;-1;443;0;0;0;0;.00nan;0;0
14816;173954;438;0;0;0;0;.00nan;0;0
14816;170928;443;96;44;3;41;.932;3600000;0
14816;78492;438;87;16;0;16;1.000;3600000;0
14817;171930;422;23;16;5;11;.688;3555000;0
14817;166767;422;0;0;0;0;.00nan;0;0
14817;168360;444;0;0;0;0;.00nan;0;0
14817;168855;444;68;29;3;26;.897;3600000;0
14818;171787;417;20;23;6;17;.739;2756000;0
14818;168206;414;81;30;1;29;.967;3600000;0
14818;58110;414;0;0;0;0;.00nan;0;0
14818;85050;417;51;2;0;2;1.000;844000;0
14819;174241;421;68;29;3;26;.897;3583000;0
14819;176808;418;66;26;2;24;.923;3600000;0
14819;180965;418;0;0;0;0;.00nan;0;0
14819;74680;421;0;0;0;0;.00nan;0;0
14820;-1;415;0;0;0;0;.00nan;0;0
14820;-1;412;0;0;0;0;.00nan;0;0
14820;-1;412;87;43;2;41;.953;3587000;0
14820;94557;415;86;29;1;28;.966;3600000;0
14821;173575;437;40;33;5;28;.848;3600000;0
14821;59525;439;91;16;0;16;1.000;3600000;0
14821;139865;437;0;0;0;0;.00nan;0;0
14821;142583;439;0;0;0;0;.00nan;0;0
14822;179691;4849;83;37;2;35;.946;3600000;0
14822;-1;419;0;0;0;0;.00nan;0;0
14822;76378;419;41;23;4;19;.826;3577000;0
14822;161023;4849;0;0;0;0;.00nan;0;0
14823;163228;429;0;0;0;0;.00nan;0;0
14823;165611;440;59;26;3;23;.885;3550000;0
14823;-1;429;56;18;2;16;.889;3600000;0
14823;170886;440;0;0;0;0;.00nan;0;0
14824;-1;433;0;0;0;0;.00nan;0;0
14824;174325;427;0;0;0;0;.00nan;0;0
14824;-1;427;46;26;4;22;.846;3600000;0
14824;149937;433;100;36;0;36;1.000;3600000;0
14825;169006;432;12;31;7;24;.774;3209000;0
14825;179103;425;0;0;0;0;.00nan;0;0
14825;182093;432;60;7;0;7;1.000;391000;0
14825;160809;425;60;20;2;18;.900;3600000;0
14826;171517;431;62;36;3;33;.917;3600000;0
14826;141294;436;86;21;0;21;1.000;3600000;0
14826;149996;431;0;0;0;0;.00nan;0;0
14826;160967;436;0;0;0;0;.00nan;0;0
14827;-1;413;67;33;3;30;.909;3532000;0
14827;-1;415;82;26;1;25;.962;3600000;0
14827;-1;413;0;0;0;0;.00nan;0;0
14827;94557;415;0;0;0;0;.00nan;0;0
14828;165751;435;97;34;1;33;.971;3600000;0
14828;173954;438;0;0;0;0;.00nan;0;0
14828;78492;438;100;25;0;25;1.000;3600000;0
14828;91448;435;0;0;0;0;.00nan;0;0
14829;174325;427;68;32;3;29;.906;3600000;0
14829;-1;427;0;0;0;0;.00nan;0;0
14829;86579;434;76;27;2;25;.926;3600000;0
14829;152650;434;0;0;0;0;.00nan;0;0
14830;165611;440;54;31;4;27;.871;3943000;0
14830;170886;440;0;0;0;0;.00nan;0;0
14830;174386;428;91;38;3;35;.921;3943000;0
14830;86531;428;0;0;0;0;.00nan;0;0
14831;-1;443;70;32;2;30;.938;3600000;0
14831;170928;443;0;0;0;0;.00nan;0;0
14831;59525;439;64;25;3;22;.880;3573000;0
14831;142583;439;0;0;0;0;.00nan;0;0
14832;168360;444;0;0;0;0;.00nan;0;0
14832;168855;444;78;38;3;35;.921;3600000;0
14832;171578;449;0;0;0;0;.00nan;0;0
14832;141530;449;100;29;0;29;1.000;3600000;0
14833;171517;431;88;20;0;20;1.000;3600000;0
14833;174386;428;0;0;0;0;.00nan;0;0
14833;86531;428;45;27;4;23;.852;3600000;0
14833;149996;431;0;0;0;0;.00nan;0;0
14834;171930;422;0;0;0;0;.00nan;0;0
14834;166767;422;42;31;5;26;.839;3600000;0
14834;176808;418;0;0;0;0;.00nan;0;0
14834;180965;418;70;23;2;21;.913;3600000;0
14835;170878;430;0;0;0;0;.00nan;0;0
14835;-1;430;86;29;1;28;.966;3600000;0
14835;141294;436;82;30;2;28;.933;3591000;0
14835;160967;436;0;0;0;0;.00nan;0;0
14836;179143;423;0;0;0;0;.00nan;0;0
14836;-1;419;85;32;1;31;.969;3600000;0
14836;76378;419;0;0;0;0;.00nan;0;0
14836;85649;423;82;32;2;30;.938;3600000;0
14837;168206;414;79;30;1;29;.967;3547000;0
14837;175989;410;0;0;0;0;.00nan;0;0
14837;58110;414;0;0;0;0;.00nan;0;0
14837;78864;410;88;16;0;16;1.000;3600000;0
14838;-1;443;85;33;1;32;.970;3569000;0
14838;170928;443;0;0;0;0;.00nan;0;0
14838;-1;441;86;14;0;14;1.000;3600000;0
14838;57764;441;0;0;0;0;.00nan;0;0
14839;165751;435;0;0;0;0;.00nan;0;0
14839;173954;438;0;0;0;0;.00nan;0;0
14839;78492;438;71;21;1;20;.952;3600000;0
14839;91448;435;68;23;2;21;.913;3570000;0
14840;177155;411;48;24;4;20;.833;3600000;0
14840;-1;415;0;0;0;0;.00nan;0;0
14840;94557;415;79;28;1;27;.964;3600000;0
14840;141459;411;0;0;0;0;.00nan;0;0
14841;59525;439;0;0;0;0;.00nan;0;0
14841;85987;426;0;0;0;0;.00nan;0;0
14841;86226;426;90;49;2;47;.959;3986000;0
14841;142583;439;57;12;1;11;.917;3986000;0
14842;174241;421;59;12;1;11;.917;3600000;0
14842;74680;421;0;0;0;0;.00nan;0;0
14842;74980;420;66;39;5;34;.872;3600000;0
14842;77123;420;0;0;0;0;.00nan;0;0
14843;171787;417;0;0;0;0;.00nan;0;0
14843;-1;412;86;34;2;32;.941;3600000;0
14843;-1;412;0;0;0;0;.00nan;0;0
14843;85050;417;60;17;1;16;.941;3600000;0
14844;163228;429;0;0;0;0;.00nan;0;0
14844;-1;429;71;31;2;29;.935;3600000;0
14844;173575;437;0;0;0;0;.00nan;0;0
14844;139865;437;57;25;3;22;.880;3559000;0
14845;-1;433;31;11;3;8;.727;1565000;0
14845;169006;432;0;0;0;0;.00nan;0;0
14845;182093;432;73;21;1;20;.952;3600000;0
14845;149937;433;29;26;6;20;.769;2035000;0
14846;169027;442;0;0;0;0;.00nan;0;0
14846;-1;442;74;29;2;27;.931;4200000;0
14846;86579;434;55;21;2;19;.905;4200000;0
14846;152650;434;0;0;0;0;.00nan;0;0
14847;168360;444;82;35;2;33;.943;4200000;0
14847;168855;444;0;0;0;0;.00nan;0;0
14847;171578;449;0;0;0;0;.00nan;0;0
14847;141530;449;80;43;2;41;.953;4200000;0
14848;171930;422;63;15;1;14;.933;3600000;0
14848;166767;422;0;0;0;0;.00nan;0;0
14848;176808;418;86;36;3;33;.917;3555000;0
14848;180965;418;0;0;0;0;.00nan;0;0
14849;169027;442;80;49;4;45;.918;3600000;0
14849;179103;425;59;21;2;19;.905;3600000;0
14849;-1;442;0;0;0;0;.00nan;0;0
14849;160809;425;0;0;0;0;.00nan;0;0
14850;177155;411;0;0;0;0;.00nan;0;0
14850;-1;413;0;0;0;0;.00nan;0;0
14850;-1;413;49;43;6;37;.860;3600000;0
14850;141459;411;80;28;2;26;.929;3600000;0
14851;163228;429;25;21;6;15;.714;3531000;0
14851;-1;429;0;0;0;0;.00nan;0;0
14851;141294;436;0;0;0;0;.00nan;0;0
14851;160967;436;54;30;4;26;.867;3600000;0
14852;171787;417;81;39;2;37;.949;4200000;0
14852;175989;410;0;0;0;0;.00nan;0;0
14852;78864;410;85;36;2;34;.944;4200000;0
14852;85050;417;0;0;0;0;.00nan;0;0
14853;179143;423;67;48;5;43;.896;3600000;0
14853;-1;419;0;0;0;0;.00nan;0;0
14853;76378;419;67;13;1;12;.923;3600000;0
14853;85649;423;0;0;0;0;.00nan;0;0
14854;-1;441;85;34;2;32;.941;3589000;0
14854;57764;441;0;0;0;0;.00nan;0;0
14854;85987;426;82;17;0;17;1.000;3600000;0
14854;86226;426;0;0;0;0;.00nan;0;0
14855;165611;440;40;18;3;15;.833;4200000;0
14855;170886;440;0;0;0;0;.00nan;0;0
14855;171517;431;100;56;3;53;.946;4200000;0
14855;149996;431;0;0;0;0;.00nan;0;0
14856;174241;421;25;14;5;9;.643;3600000;0
14856;74680;421;0;0;0;0;.00nan;0;0
14856;74980;420;62;8;0;8;1.000;590000;0
14856;77123;420;30;31;6;25;.806;3010000;0
14857;168206;414;73;40;4;36;.900;4200000;0
14857;-1;412;0;0;0;0;.00nan;0;0
14857;-1;412;45;29;4;25;.862;4200000;0
14857;58110;414;0;0;0;0;.00nan;0;0
14858;173575;437;55;33;4;29;.879;3533000;0
14858;170878;430;96;48;2;46;.958;3600000;0
14858;-1;430;0;0;0;0;.00nan;0;0
14858;139865;437;0;0;0;0;.00nan;0;0
14859;-1;433;70;26;2;24;.923;3549000;0
14859;169006;432;0;0;0;0;.00nan;0;0
14859;182093;432;60;15;1;14;.933;3600000;0
14859;149937;433;0;0;0;0;.00nan;0;0
14860;173954;438;79;23;1;22;.957;3600000;0
14860;174325;427;76;33;2;31;.939;3600000;0
14860;-1;427;0;0;0;0;.00nan;0;0
14860;78492;438;0;0;0;0;.00nan;0;0
14861;177155;411;0;0;0;0;.00nan;0;0
14861;175989;410;0;0;0;0;.00nan;0;0
14861;78864;410;53;37;5;32;.865;3600000;0
14861;141459;411;76;12;0;12;1.000;3600000;0
14862;171787;417;0;0;0;0;.00nan;0;0
14862;-1;413;0;0;0;0;.00nan;0;0
14862;-1;413;63;42;5;37;.881;3600000;0
14862;85050;417;63;20;2;18;.900;3600000;0
14863;165611;440;91;30;1;29;.967;3735000;0
14863;170886;440;0;0;0;0;.00nan;0;0
14863;59525;439;0;0;0;0;.00nan;0;0
14863;142583;439;86;37;2;35;.946;3735000;0
14864;170878;430;81;41;3;38;.927;3600000;0
14864;179103;425;52;30;4;26;.867;3600000;0
14864;-1;430;0;0;0;0;.00nan;0;0
14864;160809;425;0;0;0;0;.00nan;0;0
14865;171517;431;85;51;3;48;.941;4200000;0
14865;59525;439;0;0;0;0;.00nan;0;0
14865;142583;439;70;40;3;37;.925;4186000;0
14865;149996;431;0;0;0;0;.00nan;0;0
14866;176808;418;0;0;0;0;.00nan;0;0
14866;180965;418;68;25;1;24;.960;3600000;0
14866;74980;420;56;26;3;23;.885;3600000;0
14866;77123;420;0;0;0;0;.00nan;0;0
14867;168206;414;66;25;2;23;.920;3600000;0
14867;-1;413;73;41;3;38;.927;3544000;0
14867;-1;413;0;0;0;0;.00nan;0;0
14867;58110;414;0;0;0;0;.00nan;0;0
14868;163228;429;82;23;1;22;.957;3551000;0
14868;-1;429;0;0;0;0;.00nan;0;0
14868;169027;442;0;0;0;0;.00nan;0;0
14868;-1;442;92;30;0;30;1.000;3600000;0
14869;-1;441;74;43;4;39;.907;3583000;0
14869;57764;441;0;0;0;0;.00nan;0;0
14869;141294;436;50;20;3;17;.850;3600000;0
14869;160967;436;0;0;0;0;.00nan;0;0
14870;171930;422;0;0;0;0;.00nan;0;0
14870;166767;422;73;36;3;33;.917;4200000;0
14870;171578;449;0;0;0;0;.00nan;0;0
14870;141530;449;53;25;3;22;.880;4200000;0
14871;179143;423;59;25;3;22;.880;3514000;0
14871;179691;4849;0;0;0;0;.00nan;0;0
14871;85649;423;0;0;0;0;.00nan;0;0
14871;161023;4849;81;31;1;30;.968;3600000;0
14872;174325;427;0;0;0;0;.00nan;0;0
14872;-1;427;77;31;1;30;.968;3600000;0
14872;85987;426;42;25;4;21;.840;3600000;0
14872;86226;426;0;0;0;0;.00nan;0;0
14873;165751;435;87;22;1;21;.955;3600000;0
14873;169006;432;0;0;0;0;.00nan;0;0
14873;182093;432;41;19;3;16;.842;3546000;0
14873;91448;435;0;0;0;0;.00nan;0;0
14874;168360;444;77;39;3;36;.923;4200000;0
14874;168855;444;0;0;0;0;.00nan;0;0
14874;-1;419;37;15;3;12;.800;4200000;0
14874;76378;419;0;0;0;0;.00nan;0;0
14875;-1;433;74;37;2;35;.946;4200000;0
14875;173954;438;0;0;0;0;.00nan;0;0
14875;78492;438;75;33;2;31;.939;4200000;0
14875;149937;433;0;0;0;0;.00nan;0;0
14876;171787;417;0;0;0;0;.00nan;0;0
14876;-1;415;78;28;2;26;.929;3600000;0
14876;85050;417;55;41;5;36;.878;3600000;0
14876;94557;415;0;0;0;0;.00nan;0;0
14877;177155;411;90;25;1;24;.960;3600000;0
14877;-1;412;0;0;0;0;.00nan;0;0
14877;-1;412;64;32;3;29;.906;3535000;0
14877;141459;411;0;0;0;0;.00nan;0;0
14878;173575;437;0;0;0;0;.00nan;0;0
14878;174386;428;67;24;2;22;.917;3600000;0
14878;86531;428;0;0;0;0;.00nan;0;0
14878;139865;437;87;45;3;42;.933;3600000;0
14879;-1;443;55;3;0;3;1.000;293000;0
14879;170928;443;28;36;7;29;.806;3307000;0
14879;86579;434;67;23;2;21;.913;3600000;0
14879;152650;434;0;0;0;0;.00nan;0;0
14880;176808;418;73;19;1;18;.947;3600000;0
14880;180965;418;0;0;0;0;.00nan;0;0
14880;74980;420;0;0;0;0;.00nan;0;0
14880;77123;420;85;41;2;39;.951;3564000;0
14881;169027;442;38;35;6;29;.829;3281000;0
14881;170878;430;95;42;1;41;.976;3600000;0
14881;-1;442;45;5;1;4;.800;319000;0
14881;-1;430;0;0;0;0;.00nan;0;0
14882;171517;431;0;0;0;0;.00nan;0;0
14882;141294;436;0;0;0;0;.00nan;0;0
14882;149996;431;75;53;6;47;.887;3600000;0
14882;160967;436;65;13;1;12;.923;3600000;0
14883;171930;422;71;23;2;21;.913;3579000;0
14883;166767;422;0;0;0;0;.00nan;0;0
14883;171578;449;85;33;1;32;.970;3600000;0
14883;141530;449;0;0;0;0;.00nan;0;0
14884;175989;410;0;0;0;0;.00nan;0;0
14884;-1;412;71;23;1;22;.957;3600000;0
14884;-1;412;0;0;0;0;.00nan;0;0
14884;78864;410;23;25;6;19;.760;3600000;0
14885;179143;423;0;0;0;0;.00nan;0;0
14885;179691;4849;67;21;2;19;.905;3562000;0
14885;85649;423;100;33;1;32;.970;3600000;0
14885;161023;4849;0;0;0;0;.00nan;0;0
14886;179103;425;32;25;5;20;.800;3576000;0
14886;174325;427;85;44;3;41;.932;3600000;0
14886;-1;427;0;0;0;0;.00nan;0;0
14886;160809;425;0;0;0;0;.00nan;0;0
14887;165751;435;0;0;0;0;.00nan;0;0
14887;-1;433;0;0;0;0;.00nan;0;0
14887;91448;435;65;32;3;29;.906;3600000;0
14887;149937;433;67;18;1;17;.944;3600000;0
14888;168360;444;0;0;0;0;.00nan;0;0
14888;168855;444;61;41;4;37;.902;3600000;0
14888;-1;419;0;0;0;0;.00nan;0;0
14888;76378;419;55;15;2;13;.867;3600000;0
14889;169006;432;0;0;0;0;.00nan;0;0
14889;173954;438;0;0;0;0;.00nan;0;0
14889;182093;432;99;23;0;23;1.000;3600000;0
14889;78492;438;79;40;3;37;.925;3600000;0
14890;168206;414;0;0;0;0;.00nan;0;0
14890;-1;415;0;0;0;0;.00nan;0;0
14890;58110;414;63;31;3;28;.903;3600000;0
14890;94557;415;26;24;6;18;.750;3600000;0
14891;165611;440;65;32;4;28;.875;4200000;0
14891;170886;440;0;0;0;0;.00nan;0;0
14891;174386;428;0;0;0;0;.00nan;0;0
14891;86531;428;56;36;4;32;.889;4200000;0
14892;173575;437;60;24;2;22;.917;3600000;0
14892;-1;441;82;43;3;40;.930;3556000;0
14892;57764;441;0;0;0;0;.00nan;0;0
14892;139865;437;0;0;0;0;.00nan;0;0
14893;85987;426;0;0;0;0;.00nan;0;0
14893;86226;426;73;27;2;25;.926;3573000;0
14893;86579;434;0;0;0;0;.00nan;0;0
14893;152650;434;79;15;0;15;1.000;3600000;0
14894;-1;441;77;40;3;37;.925;3748000;0
14894;174386;428;53;17;2;15;.882;3748000;0
14894;57764;441;0;0;0;0;.00nan;0;0
14894;86531;428;0;0;0;0;.00nan;0;0
14895;177155;411;0;0;0;0;.00nan;0;0
14895;168206;414;98;44;2;42;.955;4200000;0
14895;58110;414;0;0;0;0;.00nan;0;0
14895;141459;411;73;25;2;23;.920;4200000;0
14896;-1;415;49;20;3;17;.850;3600000;0
14896;175989;410;0;0;0;0;.00nan;0;0
14896;78864;410;38;21;4;17;.810;3600000;0
14896;94557;415;0;0;0;0;.00nan;0;0
14897;174325;427;93;37;2;35;.946;4110000;0
14897;-1;427;0;0;0;0;.00nan;0;0
14897;141294;436;0;0;0;0;.00nan;0;0
14897;160967;436;66;24;3;21;.875;4110000;0
14898;171787;417;0;0;0;0;.00nan;0;0
14898;168206;414;75;38;4;34;.895;3538000;0
14898;58110;414;0;0;0;0;.00nan;0;0
14898;85050;417;73;27;2;25;.926;3600000;0
14899;171578;449;73;24;1;23;.958;3130000;0
14899;-1;419;65;17;1;16;.941;3600000;0
14899;76378;419;0;0;0;0;.00nan;0;0
14899;141530;449;30;8;3;5;.625;470000;0
14900;174386;428;92;38;1;37;.974;3600000;0
14900;85987;426;60;37;4;33;.892;3600000;0
14900;86226;426;0;0;0;0;.00nan;0;0
14900;86531;428;0;0;0;0;.00nan;0;0
14901;179103;425;49;23;3;20;.870;3527000;0
14901;141294;436;71;24;1;23;.958;3600000;0
14901;160809;425;0;0;0;0;.00nan;0;0
14901;160967;436;0;0;0;0;.00nan;0;0
14902;-1;413;0;0;0;0;.00nan;0;0
14902;175989;410;0;0;0;0;.00nan;0;0
14902;-1;413;61;38;4;34;.895;3600000;0
14902;78864;410;73;23;1;22;.957;3600000;0
14903;165751;435;49;33;5;28;.848;3600000;0
14903;170878;430;0;0;0;0;.00nan;0;0
14903;-1;430;70;25;1;24;.960;3600000;0
14903;91448;435;0;0;0;0;.00nan;0;0
14904;-1;443;71;38;3;35;.921;4047000;0
14904;170928;443;0;0;0;0;.00nan;0;0
14904;171517;431;0;0;0;0;.00nan;0;0
14904;149996;431;89;39;2;37;.949;4047000;0
14905;179143;423;90;40;2;38;.950;3600000;0
14905;174241;421;71;17;1;16;.941;3600000;0
14905;74680;421;0;0;0;0;.00nan;0;0
14905;85649;423;0;0;0;0;.00nan;0;0
14906;-1;415;66;19;1;18;.947;3600000;0
14906;-1;412;0;0;0;0;.00nan;0;0
14906;-1;412;77;26;2;24;.923;3583000;0
14906;94557;415;0;0;0;0;.00nan;0;0
14907;165611;440;88;18;0;18;1.000;3600000;0
14907;173575;437;0;0;0;0;.00nan;0;0
14907;170886;440;0;0;0;0;.00nan;0;0
14907;139865;437;90;48;2;46;.958;3513000;0
14908;169027;442;0;0;0;0;.00nan;0;0
14908;-1;442;78;40;4;36;.900;3600000;0
14908;59525;439;0;0;0;0;.00nan;0;0
14908;142583;439;52;12;2;10;.833;3600000;0
14909;176808;418;0;0;0;0;.00nan;0;0
14909;179691;4849;0;0;0;0;.00nan;0;0
14909;180965;418;54;32;4;28;.875;3568000;0
14909;161023;4849;81;38;3;35;.921;3600000;0
14910;168360;444;57;33;4;29;.879;3600000;0
14910;168855;444;0;0;0;0;.00nan;0;0
14910;74980;420;0;0;0;0;.00nan;0;0
14910;77123;420;96;18;0;18;1.000;3600000;0
14911;163228;429;0;0;0;0;.00nan;0;0
14911;-1;429;61;18;2;16;.889;3600000;0
14911;173954;438;0;0;0;0;.00nan;0;0
14911;78492;438;67;43;5;38;.884;3600000;0
14912;-1;433;61;31;3;28;.903;4200000;0
14912;169006;432;0;0;0;0;.00nan;0;0
14912;182093;432;50;28;3;25;.893;4200000;0
14912;149937;433;0;0;0;0;.00nan;0;0
14913;171517;431;80;27;1;26;.963;3557000;0
14913;85987;426;0;0;0;0;.00nan;0;0
14913;86226;426;100;31;0;31;1.000;3600000;0
14913;149996;431;0;0;0;0;.00nan;0;0
14914;173575;437;54;39;5;34;.872;3600000;0
14914;179103;425;0;0;0;0;.00nan;0;0
14914;139865;437;0;0;0;0;.00nan;0;0
14914;160809;425;61;16;1;15;.938;3600000;0
14915;-1;413;91;43;1;42;.977;3600000;0
14915;-1;413;0;0;0;0;.00nan;0;0
14915;-1;412;31;22;5;17;.773;3600000;0
14915;-1;412;0;0;0;0;.00nan;0;0
14916;171578;449;0;0;0;0;.00nan;0;0
14916;-1;419;0;0;0;0;.00nan;0;0
14916;76378;419;64;23;2;21;.913;3648000;0
14916;141530;449;66;33;3;30;.909;3648000;0
14917;173954;438;44;28;4;24;.857;3600000;0
14917;170878;430;77;27;1;26;.963;3600000;0
14917;-1;430;0;0;0;0;.00nan;0;0
14917;78492;438;0;0;0;0;.00nan;0;0
14918;174325;427;44;18;3;15;.833;3600000;0
14918;-1;441;45;36;5;31;.861;3542000;0
14918;-1;427;0;0;0;0;.00nan;0;0
14918;57764;441;0;0;0;0;.00nan;0;0
14919;-1;443;0;0;0;0;.00nan;0;0
14919;170928;443;36;27;5;22;.815;3566000;0
14919;174386;428;0;0;0;0;.00nan;0;0
14919;86531;428;66;30;3;27;.900;3600000;0
14920;179143;423;0;0;0;0;.00nan;0;0
14920;174241;421;0;0;0;0;.00nan;0;0
14920;74680;421;44;19;3;16;.842;3600000;0
14920;85649;423;83;32;2;30;.938;3600000;0
14921;169027;442;29;10;3;7;.700;462000;0
14921;-1;442;75;23;1;22;.957;3138000;0
14921;59525;439;61;18;1;17;.944;3600000;0
14921;142583;439;0;0;0;0;.00nan;0;0
14922;176808;418;0;0;0;0;.00nan;0;0
14922;179691;4849;43;29;5;24;.828;3600000;0
14922;180965;418;30;38;8;30;.789;3600000;0
14922;161023;4849;0;0;0;0;.00nan;0;0
14923;168360;444;0;0;0;0;.00nan;0;0
14923;168855;444;55;30;4;26;.867;4125000;0
14923;74980;420;0;0;0;0;.00nan;0;0
14923;77123;420;49;19;3;16;.842;4125000;0
14924;171787;417;76;24;1;23;.958;3600000;0
14924;177155;411;49;16;2;14;.875;3566000;0
14924;85050;417;0;0;0;0;.00nan;0;0
14924;141459;411;0;0;0;0;.00nan;0;0
14925;163228;429;57;18;2;16;.889;3600000;0
14925;165751;435;0;0;0;0;.00nan;0;0
14925;-1;429;0;0;0;0;.00nan;0;0
14925;91448;435;79;36;3;33;.917;3600000;0
14926;-1;433;0;0;0;0;.00nan;0;0
14926;86579;434;0;0;0;0;.00nan;0;0
14926;149937;433;49;38;5;33;.868;3600000;0
14926;152650;434;88;28;1;27;.964;3600000;0
14927;169006;432;0;0;0;0;.00nan;0;0
14927;182093;432;98;27;0;27;1.000;3600000;0
14927;86579;434;62;18;2;16;.889;3567000;0
14927;152650;434;0;0;0;0;.00nan;0;0
14928;-1;443;92;34;1;33;.971;3600000;0
14928;170878;430;0;0;0;0;.00nan;0;0
14928;170928;443;0;0;0;0;.00nan;0;0
14928;-1;430;90;19;0;19;1.000;3600000;0
14929;171787;417;0;0;0;0;.00nan;0;0
14929;168206;414;82;42;3;39;.929;3584000;0
14929;58110;414;0;0;0;0;.00nan;0;0
14929;85050;417;68;25;2;23;.920;3600000;0
14930;-1;443;69;30;2;28;.933;4200000;0
14930;170928;443;0;0;0;0;.00nan;0;0
14930;85987;426;0;0;0;0;.00nan;0;0
14930;86226;426;88;35;2;33;.943;4200000;0
14931;171517;431;90;47;3;44;.936;4200000;0
14931;59525;439;0;0;0;0;.00nan;0;0
14931;142583;439;63;23;3;20;.870;4200000;0
14931;149996;431;0;0;0;0;.00nan;0;0
14932;171578;449;0;0;0;0;.00nan;0;0
14932;179691;4849;0;0;0;0;.00nan;0;0
14932;141530;449;74;30;2;28;.933;4200000;0
14932;161023;4849;90;36;2;34;.944;4200000;0
14933;176808;418;0;0;0;0;.00nan;0;0
14933;-1;419;62;25;3;22;.880;3645000;0
14933;180965;418;76;42;4;38;.905;3645000;0
14933;76378;419;0;0;0;0;.00nan;0;0
14934;174386;428;62;23;2;21;.913;3594000;0
14934;86531;428;0;0;0;0;.00nan;0;0
14934;86579;434;78;24;1;23;.958;3600000;0
14934;152650;434;0;0;0;0;.00nan;0;0
14935;165751;435;98;17;0;17;1.000;3600000;0
14935;169027;442;0;0;0;0;.00nan;0;0
14935;-1;442;68;31;2;29;.935;3554000;0
14935;91448;435;0;0;0;0;.00nan;0;0
14936;171930;422;0;0;0;0;.00nan;0;0
14936;166767;422;69;23;2;21;.913;3600000;0
14936;74980;420;0;0;0;0;.00nan;0;0
14936;77123;420;45;40;6;34;.850;3600000;0
14937;-1;433;78;35;2;33;.943;3600000;0
14937;170878;430;0;0;0;0;.00nan;0;0
14937;-1;430;45;29;5;24;.828;3600000;0
14937;149937;433;0;0;0;0;.00nan;0;0
14938;-1;413;0;0;0;0;.00nan;0;0
14938;175989;410;100;33;0;33;1.000;3600000;0
14938;-1;413;81;32;2;30;.938;3520000;0
14938;78864;410;0;0;0;0;.00nan;0;0
14939;165611;440;67;15;1;14;.933;3600000;0
14939;170886;440;0;0;0;0;.00nan;0;0
14939;-1;441;69;43;4;39;.907;3600000;0
14939;57764;441;0;0;0;0;.00nan;0;0
14940;179103;425;70;37;4;33;.892;3600000;0
14940;59525;439;80;21;1;20;.952;3600000;0
14940;142583;439;0;0;0;0;.00nan;0;0
14940;160809;425;0;0;0;0;.00nan;0;0
14941;-1;415;68;38;3;35;.921;3551000;0
14941;-1;412;62;21;2;19;.905;3600000;0
14941;-1;412;0;0;0;0;.00nan;0;0
14941;94557;415;0;0;0;0;.00nan;0;0
14942;177155;411;0;0;0;0;.00nan;0;0
14942;168206;414;64;37;4;33;.892;3600000;0
14942;58110;414;0;0;0;0;.00nan;0;0
14942;141459;411;81;12;0;12;1.000;3600000;0
14943;163228;429;87;34;2;32;.941;3534000;0
14943;-1;429;0;0;0;0;.00nan;0;0
14943;169006;432;0;0;0;0;.00nan;0;0
14943;182093;432;91;19;0;19;1.000;3600000;0
14944;173575;437;0;0;0;0;.00nan;0;0
14944;139865;437;100;36;1;35;.972;4200000;0
14944;141294;436;0;0;0;0;.00nan;0;0
14944;160967;436;78;31;1;30;.968;4200000;0
14945;171578;449;51;31;4;27;.871;3600000;0
14945;179691;4849;0;0;0;0;.00nan;0;0
14945;141530;449;0;0;0;0;.00nan;0;0
14945;161023;4849;71;20;1;19;.950;3600000;0
14946;171517;431;0;0;0;0;.00nan;0;0
14946;174386;428;0;0;0;0;.00nan;0;0
14946;86531;428;64;31;3;28;.903;3600000;0
14946;149996;431;77;11;0;11;1.000;3600000;0
14947;174325;427;31;20;4;16;.800;3600000;0
14947;-1;427;0;0;0;0;.00nan;0;0
14947;85987;426;0;0;0;0;.00nan;0;0
14947;86226;426;73;20;1;19;.950;3600000;0
14948;169027;442;59;23;2;21;.913;3600000;0
14948;173954;438;0;0;0;0;.00nan;0;0
14948;-1;442;0;0;0;0;.00nan;0;0
14948;78492;438;44;19;3;16;.842;3600000;0
14949;176808;418;75;45;5;40;.889;3836000;0
14949;-1;419;0;0;0;0;.00nan;0;0
14949;180965;418;0;0;0;0;.00nan;0;0
14949;76378;419;60;31;4;27;.871;3836000;0
14950;171930;422;71;22;1;21;.955;3600000;0
14950;166767;422;0;0;0;0;.00nan;0;0
14950;74980;420;48;33;5;28;.848;3600000;0
14950;77123;420;0;0;0;0;.00nan;0;0
14951;169006;432;0;0;0;0;.00nan;0;0
14951;170878;430;64;23;2;21;.913;3551000;0
14951;182093;432;94;25;0;25;1.000;3600000;0
14951;-1;430;0;0;0;0;.00nan;0;0
14952;-1;415;0;0;0;0;.00nan;0;0
14952;175989;410;0;0;0;0;.00nan;0;0
14952;78864;410;69;26;2;24;.923;3543000;0
14952;94557;415;80;28;1;27;.964;3600000;0
14953;165611;440;63;19;2;17;.895;3600000;0
14953;170886;440;0;0;0;0;.00nan;0;0
14953;-1;441;0;0;0;0;.00nan;0;0
14953;57764;441;70;44;5;39;.886;3600000;0
14954;168360;444;73;40;3;37;.925;3774000;0
14954;168855;444;0;0;0;0;.00nan;0;0
14954;174241;421;91;40;4;36;.900;3774000;0
14954;74680;421;0;0;0;0;.00nan;0;0
14955;-1;413;82;39;3;36;.923;3726000;0
14955;-1;413;0;0;0;0;.00nan;0;0
14955;-1;412;0;0;0;0;.00nan;0;0
14955;-1;412;32;16;4;12;.750;3726000;0
14956;171787;417;0;0;0;0;.00nan;0;0
14956;177155;411;84;33;2;31;.939;3561000;0
14956;85050;417;82;23;1;22;.957;3600000;0
14956;141459;411;0;0;0;0;.00nan;0;0
14957;163228;429;0;0;0;0;.00nan;0;0
14957;-1;429;91;29;1;28;.966;4200000;0
14957;-1;433;0;0;0;0;.00nan;0;0
14957;149937;433;96;45;1;44;.978;4200000;0
14958;179103;425;0;0;0;0;.00nan;0;0
14958;86579;434;64;22;2;20;.909;3557000;0
14958;152650;434;0;0;0;0;.00nan;0;0
14958;160809;425;65;19;1;18;.947;3600000;0
14959;-1;443;0;0;0;0;.00nan;0;0
14959;170928;443;96;34;2;32;.941;3600000;0
14959;174325;427;0;0;0;0;.00nan;0;0
14959;-1;427;62;25;3;22;.880;3553000;0
14960;168360;444;57;11;1;10;.909;1472000;0
14960;168855;444;16;23;6;17;.739;2128000;0
14960;174241;421;0;0;0;0;.00nan;0;0
14960;74680;421;100;26;0;26;1.000;3600000;0
14961;-1;413;0;0;0;0;.00nan;0;0
14961;-1;415;66;23;2;21;.913;3600000;0
14961;-1;413;63;45;5;40;.889;3600000;0
14961;94557;415;0;0;0;0;.00nan;0;0
14962;171517;431;0;0;0;0;.00nan;0;0
14962;86579;434;68;28;2;26;.929;4170000;0
14962;149996;431;94;59;3;56;.949;4170000;0
14962;152650;434;0;0;0;0;.00nan;0;0
14963;174325;427;54;20;2;18;.900;3544000;0
14963;-1;427;0;0;0;0;.00nan;0;0
14963;86579;434;78;24;1;23;.958;3600000;0
14963;152650;434;0;0;0;0;.00nan;0;0
14964;-1;443;0;0;0;0;.00nan;0;0
14964;170928;443;69;31;2;29;.935;3600000;0
14964;179103;425;64;28;3;25;.893;3600000;0
14964;160809;425;0;0;0;0;.00nan;0;0
14965;171787;417;0;0;0;0;.00nan;0;0
14965;175989;410;0;0;0;0;.00nan;0;0
14965;78864;410;89;57;3;54;.947;3838000;0
14965;85050;417;65;35;4;31;.886;3838000;0
14966;171578;449;29;11;3;8;.727;836000;0
14966;176808;418;0;0;0;0;.00nan;0;0
14966;180965;418;70;31;2;29;.935;3600000;0
14966;141530;449;25;32;7;25;.781;2764000;0
14967;177155;411;100;24;0;24;1.000;3600000;0
14967;-1;413;78;53;4;49;.925;3600000;0
14967;-1;413;0;0;0;0;.00nan;0;0
14967;141459;411;0;0;0;0;.00nan;0;0
14968;163228;429;0;0;0;0;.00nan;0;0
14968;-1;429;65;22;2;20;.909;3762000;0
14968;174386;428;83;43;3;40;.930;3762000;0
14968;86531;428;0;0;0;0;.00nan;0;0
14969;169027;442;0;0;0;0;.00nan;0;0
14969;-1;442;98;58;3;55;.948;3524000;0
14969;141294;436;73;22;1;21;.955;3600000;0
14969;160967;436;0;0;0;0;.00nan;0;0
14970;171930;422;0;0;0;0;.00nan;0;0
14970;166767;422;49;19;3;16;.842;3600000;0
14970;179143;423;87;65;6;59;.908;3600000;0
14970;85649;423;0;0;0;0;.00nan;0;0
14971;168206;414;82;31;1;30;.968;3600000;0
14971;-1;412;0;0;0;0;.00nan;0;0
14971;-1;412;55;17;2;15;.882;3549000;0
14971;58110;414;0;0;0;0;.00nan;0;0
14972;165611;440;0;0;0;0;.00nan;0;0
14972;170878;430;17;29;7;22;.759;3600000;0
14972;170886;440;61;30;3;27;.900;3600000;0
14972;-1;430;0;0;0;0;.00nan;0;0
14973;174241;421;0;0;0;0;.00nan;0;0
14973;179691;4849;0;0;0;0;.00nan;0;0
14973;74680;421;55;19;2;17;.895;3600000;0
14973;161023;4849;48;36;5;31;.861;3600000;0
14974;-1;419;93;26;1;25;.962;3600000;0
14974;74980;420;40;31;6;25;.806;2717000;0
14974;76378;419;0;0;0;0;.00nan;0;0
14974;77123;420;69;13;0;13;1.000;883000;0
14975;-1;433;53;19;2;17;.895;3621000;0
14975;-1;441;89;48;3;45;.938;3621000;0
14975;57764;441;0;0;0;0;.00nan;0;0
14975;149937;433;0;0;0;0;.00nan;0;0
14976;169006;432;0;0;0;0;.00nan;0;0
14976;182093;432;88;48;3;45;.938;4200000;0
14976;59525;439;0;0;0;0;.00nan;0;0
14976;142583;439;46;19;3;16;.842;4200000;0
14977;171787;417;54;30;4;26;.867;3976000;0
14977;-1;412;63;33;3;30;.909;3976000;0
14977;-1;412;0;0;0;0;.00nan;0;0
14977;85050;417;0;0;0;0;.00nan;0;0
14978;171578;449;72;32;2;30;.938;4200000;0
14978;176808;418;75;37;2;35;.946;4200000;0
14978;180965;418;0;0;0;0;.00nan;0;0
14978;141530;449;0;0;0;0;.00nan;0;0
14979;163228;429;65;23;2;21;.913;3770000;0
14979;-1;429;0;0;0;0;.00nan;0;0
14979;171517;431;75;34;3;31;.912;3770000;0
14979;149996;431;0;0;0;0;.00nan;0;0
14980;179103;425;45;17;3;14;.824;3600000;0
14980;85987;426;0;0;0;0;.00nan;0;0
14980;86226;426;68;48;5;43;.896;3600000;0
14980;160809;425;0;0;0;0;.00nan;0;0
14981;173575;437;0;0;0;0;.00nan;0;0
14981;174386;428;0;0;0;0;.00nan;0;0
14981;86531;428;87;30;1;29;.967;3600000;0
14981;139865;437;66;36;5;31;.861;3600000;0
14982;169027;442;0;0;0;0;.00nan;0;0
14982;-1;442;84;41;3;38;.927;3543000;0
14982;141294;436;0;0;0;0;.00nan;0;0
14982;160967;436;79;27;1;26;.963;3600000;0
14983;171930;422;59;15;1;14;.933;3600000;0
14983;166767;422;0;0;0;0;.00nan;0;0
14983;179143;423;0;0;0;0;.00nan;0;0
14983;85649;423;62;27;3;24;.889;3530000;0
14984;-1;443;0;0;0;0;.00nan;0;0
14984;170928;443;71;36;2;34;.944;3559000;0
14984;174325;427;0;0;0;0;.00nan;0;0
14984;-1;427;84;16;0;16;1.000;3600000;0
14985;165751;435;0;0;0;0;.00nan;0;0
14985;173954;438;72;32;3;29;.906;3600000;0
14985;78492;438;0;0;0;0;.00nan;0;0
14985;91448;435;77;31;2;29;.935;3600000;0
14986;168206;414;0;0;0;0;.00nan;0;0
14986;175989;410;60;29;3;26;.897;3547000;0
14986;58110;414;74;28;2;26;.929;3600000;0
14986;78864;410;0;0;0;0;.00nan;0;0
14987;177155;411;82;30;1;29;.967;3600000;0
14987;-1;415;64;35;3;32;.914;3586000;0
14987;94557;415;0;0;0;0;.00nan;0;0
14987;141459;411;0;0;0;0;.00nan;0;0
14988;170878;430;0;0;0;0;.00nan;0;0
14988;-1;430;96;53;3;50;.943;3600000;0
14988;59525;439;47;12;2;10;.833;3600000;0
14988;142583;439;0;0;0;0;.00nan;0;0
14989;174241;421;63;23;2;21;.913;3600000;0
14989;179691;4849;56;34;4;30;.882;3537000;0
14989;74680;421;0;0;0;0;.00nan;0;0
14989;161023;4849;0;0;0;0;.00nan;0;0
14990;-1;419;0;0;0;0;.00nan;0;0
14990;74980;420;0;0;0;0;.00nan;0;0
14990;76378;419;66;26;2;24;.923;3514000;0
14990;77123;420;100;34;0;34;1.000;3600000;0
14991;-1;433;0;0;0;0;.00nan;0;0
14991;-1;441;72;45;5;40;.889;3600000;0
14991;57764;441;0;0;0;0;.00nan;0;0
14991;149937;433;68;27;2;25;.926;3600000;0
14992;165611;440;88;18;0;18;1.000;3600000;0
14992;169006;432;44;34;5;29;.853;3600000;0
14992;170886;440;0;0;0;0;.00nan;0;0
14992;182093;432;0;0;0;0;.00nan;0;0
14993;177155;411;0;0;0;0;.00nan;0;0
14993;175989;410;0;0;0;0;.00nan;0;0
14993;78864;410;49;33;5;28;.848;3526000;0
14993;141459;411;61;24;3;21;.875;3600000;0
14994;-1;433;24;6;3;3;.500;548000;0
14994;171517;431;0;0;0;0;.00nan;0;0
14994;149937;433;88;36;2;34;.944;3052000;0
14994;149996;431;66;15;1;14;.933;3600000;0
14995;173954;438;80;42;3;39;.929;3581000;0
14995;179103;425;51;9;1;8;.889;3600000;0
14995;78492;438;0;0;0;0;.00nan;0;0
14995;160809;425;0;0;0;0;.00nan;0;0
14996;169027;442;45;32;4;28;.875;2411000;0
14996;174386;428;32;19;4;15;.789;3600000;0
14996;-1;442;26;15;4;11;.733;1189000;0
14996;86531;428;0;0;0;0;.00nan;0;0
14997;59525;439;0;0;0;0;.00nan;0;0
14997;141294;436;42;44;6;38;.864;3600000;0
14997;142583;439;58;21;2;19;.905;3600000;0
14997;160967;436;0;0;0;0;.00nan;0;0
14998;179691;4849;0;0;0;0;.00nan;0;0
14998;74980;420;96;39;1;38;.974;3600000;0
14998;77123;420;0;0;0;0;.00nan;0;0
14998;161023;4849;60;25;3;22;.880;3537000;0
14999;85987;426;0;0;0;0;.00nan;0;0
14999;86226;426;57;39;6;33;.846;3600000;0
14999;86579;434;70;19;1;18;.947;3600000;0
14999;152650;434;0;0;0;0;.00nan;0;0
15000;171787;417;0;0;0;0;.00nan;0;0
15000;-1;413;44;4;1;3;.750;391000;0
15000;-1;413;67;42;6;36;.857;3209000;0
15000;85050;417;38;14;4;10;.714;3600000;0
15001;169027;442;0;0;0;0;.00nan;0;0
15001;174386;428;0;0;0;0;.00nan;0;0
15001;-1;442;81;47;3;44;.936;4200000;0
15001;86531;428;47;26;3;23;.885;4200000;0
15002;174241;421;46;36;6;30;.833;3343000;0
15002;-1;419;60;19;2;17;.895;3600000;0
15002;74680;421;56;5;0;5;1.000;257000;0
15002;76378;419;0;0;0;0;.00nan;0;0
15003;171930;422;0;0;0;0;.00nan;0;0
15003;166767;422;85;15;0;15;1.000;3600000;0
15003;176808;418;0;0;0;0;.00nan;0;0
15003;180965;418;32;27;5;22;.815;3600000;0
15004;-1;443;0;0;0;0;.00nan;0;0
15004;170878;430;52;16;2;14;.875;3600000;0
15004;170928;443;54;35;4;31;.886;3600000;0
15004;-1;430;0;0;0;0;.00nan;0;0
15005;165611;440;94;17;0;17;1.000;3600000;0
15005;165751;435;0;0;0;0;.00nan;0;0
15005;170886;440;0;0;0;0;.00nan;0;0
15005;91448;435;39;27;5;22;.815;3600000;0
15006;168360;444;71;33;3;30;.909;3517000;0
15006;168855;444;0;0;0;0;.00nan;0;0
15006;179143;423;99;39;1;38;.974;3600000;0
15006;85649;423;0;0;0;0;.00nan;0;0
15007;168206;414;99;46;1;45;.978;4200000;0
15007;-1;415;85;28;1;27;.964;4200000;0
15007;58110;414;0;0;0;0;.00nan;0;0
15007;94557;415;0;0;0;0;.00nan;0;0
15008;179691;4849;58;30;4;26;.867;3556000;0
15008;74980;420;0;0;0;0;.00nan;0;0
15008;77123;420;66;31;4;27;.871;3600000;0
15008;161023;4849;0;0;0;0;.00nan;0;0
15009;175989;410;0;0;0;0;.00nan;0;0
15009;-1;412;0;0;0;0;.00nan;0;0
15009;-1;412;76;31;2;29;.935;3600000;0
15009;78864;410;46;28;4;24;.857;3524000;0
15010;163228;429;0;0;0;0;.00nan;0;0
15010;-1;429;83;17;0;17;1.000;3600000;0
15010;-1;441;97;39;1;38;.974;3600000;0
15010;57764;441;0;0;0;0;.00nan;0;0
15011;173575;437;0;0;0;0;.00nan;0;0
15011;169006;432;0;0;0;0;.00nan;0;0
15011;182093;432;62;16;1;15;.938;3600000;0
15011;139865;437;100;23;0;23;1.000;3600000;0
15012;171787;417;0;0;0;0;.00nan;0;0
15012;-1;415;100;31;0;31;1.000;3600000;0
15012;85050;417;60;15;1;14;.933;3600000;0
15012;94557;415;0;0;0;0;.00nan;0;0
15013;173575;437;0;0;0;0;.00nan;0;0
15013;171517;431;0;0;0;0;.00nan;0;0
15013;139865;437;37;32;5;27;.844;3600000;0
15013;149996;431;82;29;2;27;.931;3600000;0
15014;165751;435;48;34;4;30;.882;3600000;0
15014;179103;425;0;0;0;0;.00nan;0;0
15014;91448;435;0;0;0;0;.00nan;0;0
15014;160809;425;52;19;3;16;.842;3600000;0
15015;169006;432;0;0;0;0;.00nan;0;0
15015;182093;432;73;26;2;24;.923;4200000;0
15015;141294;436;81;39;2;37;.949;4200000;0
15015;160967;436;0;0;0;0;.00nan;0;0
15016;174241;421;73;26;2;24;.923;2439000;0
15016;-1;419;0;0;0;0;.00nan;0;0
15016;74680;421;44;23;4;19;.826;1161000;0
15016;76378;419;55;26;3;23;.885;3600000;0
15017;171930;422;0;0;0;0;.00nan;0;0
15017;166767;422;65;17;1;16;.941;3600000;0
15017;176808;418;76;32;2;30;.938;3600000;0
15017;180965;418;0;0;0;0;.00nan;0;0
15018;170878;430;0;0;0;0;.00nan;0;0
15018;-1;441;63;35;4;31;.886;3552000;0
15018;-1;430;85;34;2;32;.941;3600000;0
15018;57764;441;0;0;0;0;.00nan;0;0
15019;174325;427;0;0;0;0;.00nan;0;0
15019;-1;427;81;50;4;46;.920;3561000;0
15019;59525;439;0;0;0;0;.00nan;0;0
15019;142583;439;69;22;2;20;.909;3600000;0
15020;-1;443;50;31;4;27;.871;3600000;0
15020;170928;443;0;0;0;0;.00nan;0;0
15020;86579;434;89;20;0;20;1.000;3600000;0
15020;152650;434;0;0;0;0;.00nan;0;0
15021;168360;444;0;0;0;0;.00nan;0;0
15021;168855;444;69;15;1;14;.933;3600000;0
15021;179143;423;0;0;0;0;.00nan;0;0
15021;85649;423;74;27;2;25;.926;3542000;0
15022;165611;440;85;14;0;14;1.000;3600000;0
15022;173954;438;0;0;0;0;.00nan;0;0
15022;170886;440;0;0;0;0;.00nan;0;0
15022;78492;438;67;39;4;35;.897;3600000;0
15023;168206;414;90;35;2;33;.943;3611000;0
15023;-1;413;89;27;1;26;.963;3611000;0
15023;-1;413;0;0;0;0;.00nan;0;0
15023;58110;414;0;0;0;0;.00nan;0;0
15024;177155;411;0;0;0;0;.00nan;0;0
15024;-1;412;64;29;3;26;.897;3600000;0
15024;-1;412;0;0;0;0;.00nan;0;0
15024;141459;411;64;36;4;32;.889;3551000;0
15025;173575;437;0;0;0;0;.00nan;0;0
15025;139865;437;100;32;0;32;1.000;3600000;0
15025;141294;436;81;27;1;26;.963;3546000;0
15025;160967;436;0;0;0;0;.00nan;0;0
15026;-1;413;0;0;0;0;.00nan;0;0
15026;-1;415;73;19;1;18;.947;4200000;0
15026;-1;413;94;39;1;38;.974;4200000;0
15026;94557;415;0;0;0;0;.00nan;0;0
15027;165611;440;83;11;0;11;1.000;3600000;0
15027;170886;440;0;0;0;0;.00nan;0;0
15027;85987;426;63;15;1;14;.933;1500000;0
15027;86226;426;35;27;5;22;.815;2100000;0
15028;173954;438;0;0;0;0;.00nan;0;0
15028;179103;425;100;25;0;25;1.000;3600000;0
15028;78492;438;85;39;2;37;.949;3583000;0
15028;160809;425;0;0;0;0;.00nan;0;0
15029;168360;444;100;45;1;44;.978;3600000;0
15029;168855;444;0;0;0;0;.00nan;0;0
15029;-1;419;47;21;3;18;.857;3521000;0
15029;76378;419;0;0;0;0;.00nan;0;0
15030;171787;417;0;0;0;0;.00nan;0;0
15030;175989;410;0;0;0;0;.00nan;0;0
15030;78864;410;59;29;4;25;.862;3600000;0
15030;85050;417;75;21;1;20;.952;3600000;0
15031;179143;423;68;24;2;22;.917;3592000;0
15031;176808;418;0;0;0;0;.00nan;0;0
15031;180965;418;69;19;1;18;.947;3600000;0
15031;85649;423;0;0;0;0;.00nan;0;0
15032;-1;441;75;46;4;42;.913;3515000;0
15032;57764;441;0;0;0;0;.00nan;0;0
15032;59525;439;0;0;0;0;.00nan;0;0
15032;142583;439;56;17;2;15;.882;3600000;0
15033;163228;429;0;0;0;0;.00nan;0;0
15033;-1;429;93;19;0;19;1.000;3600000;0
15033;174325;427;16;27;7;20;.741;2740000;0
15033;-1;427;51;2;0;2;1.000;860000;0
15034;-1;443;0;0;0;0;.00nan;0;0
15034;169027;442;98;35;1;34;.971;4199000;0
15034;170928;443;64;25;1;24;.960;4200000;0
15034;-1;442;0;0;0;0;.00nan;0;0
15035;165751;435;0;0;0;0;.00nan;0;0
15035;179103;425;53;33;4;29;.879;3590000;0
15035;91448;435;66;31;3;28;.903;3600000;0
15035;160809;425;0;0;0;0;.00nan;0;0
15036;171578;449;0;0;0;0;.00nan;0;0
15036;174241;421;62;27;3;24;.889;3600000;0
15036;74680;421;0;0;0;0;.00nan;0;0
15036;141530;449;91;22;0;22;1.000;3600000;0
15037;171930;422;0;0;0;0;.00nan;0;0
15037;166767;422;64;16;1;15;.938;4200000;0
15037;179691;4849;0;0;0;0;.00nan;0;0
15037;161023;4849;91;39;1;38;.974;4200000;0
15038;168206;414;90;29;1;28;.966;3600000;0
15038;-1;412;0;0;0;0;.00nan;0;0
15038;-1;412;38;24;4;20;.833;3600000;0
15038;58110;414;0;0;0;0;.00nan;0;0
15039;177155;411;85;31;2;29;.935;4200000;0
15039;-1;415;75;32;2;30;.938;4200000;0
15039;94557;415;0;0;0;0;.00nan;0;0
15039;141459;411;0;0;0;0;.00nan;0;0
15040;-1;433;62;26;2;24;.923;3600000;0
15040;141294;436;0;0;0;0;.00nan;0;0
15040;149937;433;0;0;0;0;.00nan;0;0
15040;160967;436;71;23;1;22;.957;3600000;0
15041;169006;432;0;0;0;0;.00nan;0;0
15041;174386;428;48;25;4;21;.840;3526000;0
15041;182093;432;92;36;2;34;.944;3600000;0
15041;86531;428;0;0;0;0;.00nan;0;0
15042;170878;430;74;42;4;38;.905;3548000;0
15042;-1;430;0;0;0;0;.00nan;0;0
15042;86579;434;65;32;3;29;.906;3600000;0
15042;152650;434;0;0;0;0;.00nan;0;0
15043;179143;423;0;0;0;0;.00nan;0;0
15043;176808;418;40;23;4;19;.826;3600000;0
15043;180965;418;0;0;0;0;.00nan;0;0
15043;85649;423;100;27;0;27;1.000;3600000;0
15044;169027;442;0;0;0;0;.00nan;0;0
15044;-1;442;78;36;2;34;.944;3600000;0
15044;85987;426;60;13;1;12;.923;3600000;0
15044;86226;426;0;0;0;0;.00nan;0;0
15045;168360;444;91;45;4;41;.911;3600000;0
15045;168855;444;0;0;0;0;.00nan;0;0
15045;-1;419;0;0;0;0;.00nan;0;0
15045;76378;419;62;17;1;16;.941;3600000;0
15046;168206;414;65;33;3;30;.909;3574000;0
15046;175989;410;86;35;2;33;.943;3600000;0
15046;58110;414;0;0;0;0;.00nan;0;0
15046;78864;410;0;0;0;0;.00nan;0;0
15047;-1;441;66;46;5;41;.891;3600000;0
15047;57764;441;0;0;0;0;.00nan;0;0
15047;59525;439;78;10;0;10;1.000;3600000;0
15047;142583;439;0;0;0;0;.00nan;0;0
15048;170878;430;0;0;0;0;.00nan;0;0
15048;174325;427;0;0;0;0;.00nan;0;0
15048;-1;430;55;34;4;30;.882;3600000;0
15048;-1;427;78;32;1;31;.969;3600000;0
15049;171578;449;0;0;0;0;.00nan;0;0
15049;174241;421;0;0;0;0;.00nan;0;0
15049;74680;421;61;26;3;23;.885;3600000;0
15049;141530;449;36;22;4;18;.818;3575000;0
15050;165611;440;78;11;0;11;1.000;3600000;0
15050;-1;443;71;44;4;40;.909;3600000;0
15050;170886;440;0;0;0;0;.00nan;0;0
15050;170928;443;0;0;0;0;.00nan;0;0
15051;171930;422;100;18;0;18;1.000;3600000;0
15051;166767;422;0;0;0;0;.00nan;0;0
15051;179691;4849;66;47;5;42;.894;3600000;0
15051;161023;4849;0;0;0;0;.00nan;0;0
15052;171787;417;79;24;1;23;.958;3600000;0
15052;-1;412;69;42;5;37;.881;3600000;0
15052;-1;412;0;0;0;0;.00nan;0;0
15052;85050;417;0;0;0;0;.00nan;0;0
15053;177155;411;0;0;0;0;.00nan;0;0
15053;-1;413;0;0;0;0;.00nan;0;0
15053;-1;413;86;40;2;38;.950;3763000;0
15053;141459;411;75;21;1;20;.952;3765000;0
15054;-1;433;0;0;0;0;.00nan;0;0
15054;173575;437;0;0;0;0;.00nan;0;0
15054;139865;437;62;27;3;24;.889;3572000;0
15054;149937;433;63;18;1;17;.944;3600000;0
15055;169006;432;64;40;3;37;.925;4200000;0
15055;171517;431;59;25;3;22;.880;4200000;0
15055;182093;432;0;0;0;0;.00nan;0;0
15055;149996;431;0;0;0;0;.00nan;0;0
15056;163228;429;0;0;0;0;.00nan;0;0
15056;-1;429;68;28;3;25;.893;3600000;0
15056;86579;434;96;31;1;30;.968;3600000;0
15056;152650;434;0;0;0;0;.00nan;0;0
15057;171787;417;0;0;0;0;.00nan;0;0
15057;168206;414;90;32;2;30;.938;3600000;0
15057;58110;414;0;0;0;0;.00nan;0;0
15057;85050;417;51;25;3;22;.880;3551000;0
15058;170878;430;70;31;3;28;.903;3551000;0
15058;179103;425;0;0;0;0;.00nan;0;0
15058;-1;430;0;0;0;0;.00nan;0;0
15058;160809;425;70;28;2;26;.929;3600000;0
15059;165751;435;74;36;3;33;.917;3936000;0
15059;86579;434;64;18;2;16;.889;3936000;0
15059;91448;435;0;0;0;0;.00nan;0;0
15059;152650;434;0;0;0;0;.00nan;0;0
15060;-1;433;40;39;6;33;.846;2987000;0
15060;59525;439;72;21;1;20;.952;3600000;0
15060;142583;439;0;0;0;0;.00nan;0;0
15060;149937;433;50;1;0;1;1.000;613000;0
15061;165611;440;39;15;3;12;.800;3856000;0
15061;170886;440;0;0;0;0;.00nan;0;0
15061;174325;427;0;0;0;0;.00nan;0;0
15061;-1;427;81;32;2;30;.938;3856000;0
15062;171578;449;0;0;0;0;.00nan;0;0
15062;74980;420;18;23;6;17;.739;2969000;0
15062;77123;420;60;6;0;6;1.000;631000;0
15062;141530;449;83;31;2;29;.935;3600000;0
15063;-1;413;46;40;6;34;.850;3600000;0
15063;175989;410;0;0;0;0;.00nan;0;0
15063;-1;413;0;0;0;0;.00nan;0;0
15063;78864;410;85;22;1;21;.955;3600000;0
15064;169006;432;0;0;0;0;.00nan;0;0
15064;169027;442;39;41;6;35;.854;3600000;0
15064;182093;432;84;16;0;16;1.000;3600000;0
15064;-1;442;0;0;0;0;.00nan;0;0
15065;173954;438;0;0;0;0;.00nan;0;0
15065;78492;438;58;33;4;29;.879;4200000;0
15065;141294;436;49;30;4;26;.867;4200000;0
15065;160967;436;0;0;0;0;.00nan;0;0
15066;171930;422;67;23;2;21;.913;3906000;0
15066;166767;422;0;0;0;0;.00nan;0;0
15066;-1;419;79;28;1;27;.964;3906000;0
15066;76378;419;0;0;0;0;.00nan;0;0
15067;179143;423;49;38;5;33;.868;4081000;0
15067;174241;421;51;36;6;30;.833;4048000;0
15067;74680;421;0;0;0;0;.00nan;0;0
15067;85649;423;0;0;0;0;.00nan;0;0
15068;171517;431;45;9;2;7;.778;1338000;0
15068;-1;441;60;33;4;29;.879;3600000;0
15068;57764;441;0;0;0;0;.00nan;0;0
15068;149996;431;1;17;7;10;.588;2262000;0
15069;168360;444;87;30;1;29;.967;3600000;0
15069;168855;444;0;0;0;0;.00nan;0;0
15069;179691;4849;0;0;0;0;.00nan;0;0
15069;161023;4849;90;18;0;18;1.000;3600000;0
15070;177155;411;72;19;2;17;.895;3809000;0
15070;168206;414;98;40;1;39;.975;3809000;0
15070;58110;414;0;0;0;0;.00nan;0;0
15070;141459;411;0;0;0;0;.00nan;0;0
15071;-1;415;64;36;4;32;.889;3600000;0
15071;-1;412;59;6;0;6;1.000;442000;0
15071;-1;412;28;25;6;19;.760;3071000;0
15071;94557;415;0;0;0;0;.00nan;0;0
15072;165611;440;0;0;0;0;.00nan;0;0
15072;170886;440;76;33;3;30;.909;3600000;0
15072;59525;439;0;0;0;0;.00nan;0;0
15072;142583;439;69;24;2;22;.917;3600000;0
15073;163228;429;0;0;0;0;.00nan;0;0
15073;-1;429;67;30;3;27;.900;3600000;0
15073;85987;426;0;0;0;0;.00nan;0;0
15073;86226;426;49;38;5;33;.868;3515000;0
15074;165751;435;0;0;0;0;.00nan;0;0
15074;173575;437;39;29;5;24;.828;3600000;0
15074;91448;435;87;22;1;21;.955;3600000;0
15074;139865;437;0;0;0;0;.00nan;0;0
15075;-1;433;64;33;3;30;.909;3600000;0
15075;174386;428;0;0;0;0;.00nan;0;0
15075;86531;428;49;29;4;25;.862;3570000;0
15075;149937;433;0;0;0;0;.00nan;0;0
15076;171787;417;0;0;0;0;.00nan;0;0
15076;177155;411;0;0;0;0;.00nan;0;0
15076;85050;417;69;33;3;30;.909;3568000;0
15076;141459;411;100;32;1;31;.969;3600000;0
15077;171578;449;99;27;0;27;1.000;3600000;0
15077;74980;420;0;0;0;0;.00nan;0;0
15077;77123;420;67;23;2;21;.913;3544000;0
15077;141530;449;0;0;0;0;.00nan;0;0
15078;-1;443;90;39;2;37;.949;3600000;0
15078;170928;443;0;0;0;0;.00nan;0;0
15078;179103;425;53;25;4;21;.840;3585000;0
15078;160809;425;0;0;0;0;.00nan;0;0
15079;-1;413;0;0;0;0;.00nan;0;0
15079;-1;413;75;31;2;29;.935;3600000;0
15079;-1;412;35;28;5;23;.821;3600000;0
15079;-1;412;0;0;0;0;.00nan;0;0
15080;169006;432;0;0;0;0;.00nan;0;0
15080;169027;442;0;0;0;0;.00nan;0;0
15080;182093;432;80;27;1;26;.963;3600000;0
15080;-1;442;44;43;7;36;.837;3600000;0
15081;165751;435;51;36;6;30;.833;2833000;0
15081;91448;435;60;6;0;6;1.000;767000;0
15081;141294;436;0;0;0;0;.00nan;0;0
15081;160967;436;38;13;3;10;.769;3600000;0
15082;171930;422;0;0;0;0;.00nan;0;0
15082;166767;422;83;36;2;34;.944;4200000;0
15082;-1;419;0;0;0;0;.00nan;0;0
15082;76378;419;86;30;2;28;.933;4200000;0
15083;170878;430;77;28;1;27;.964;3600000;0
15083;-1;430;0;0;0;0;.00nan;0;0
15083;85987;426;18;7;4;3;.429;902000;0
15083;86226;426;84;24;0;24;1.000;2698000;0
15084;179143;423;0;0;0;0;.00nan;0;0
15084;174241;421;0;0;0;0;.00nan;0;0
15084;74680;421;75;25;1;24;.960;3600000;0
15084;85649;423;85;47;3;44;.936;3569000;0
15085;171517;431;29;14;4;10;.714;3535000;0
15085;-1;441;0;0;0;0;.00nan;0;0
15085;57764;441;99;39;2;37;.949;3600000;0
15085;149996;431;0;0;0;0;.00nan;0;0
15086;168360;444;0;0;0;0;.00nan;0;0
15086;168855;444;60;30;3;27;.900;3600000;0
15086;179691;4849;0;0;0;0;.00nan;0;0
15086;161023;4849;100;35;0;35;1.000;3600000;0
15087;-1;415;0;0;0;0;.00nan;0;0
15087;175989;410;46;30;5;25;.833;3562000;0
15087;78864;410;0;0;0;0;.00nan;0;0
15087;94557;415;69;27;3;24;.889;3600000;0
15088;174386;428;25;6;3;3;.500;186000;0
15088;59525;439;0;0;0;0;.00nan;0;0
15088;86531;428;64;29;3;26;.897;3414000;0
15088;142583;439;84;27;2;25;.926;3600000;0
15089;173575;437;0;0;0;0;.00nan;0;0
15089;173954;438;75;42;3;39;.929;4200000;0
15089;78492;438;0;0;0;0;.00nan;0;0
15089;139865;437;67;26;3;23;.885;4200000;0
15090;174325;427;56;26;3;23;.885;3581000;0
15090;-1;427;0;0;0;0;.00nan;0;0
15090;86579;434;62;24;2;22;.917;3600000;0
15090;152650;434;0;0;0;0;.00nan;0;0
15091;163228;429;0;0;0;0;.00nan;0;0
15091;-1;443;0;0;0;0;.00nan;0;0
15091;-1;429;64;16;1;15;.938;3600000;0
15091;170928;443;93;48;2;46;.958;3600000;0
15092;175989;410;0;0;0;0;.00nan;0;0
15092;-1;412;0;0;0;0;.00nan;0;0
15092;-1;412;69;29;2;27;.931;3600000;0
15092;78864;410;55;23;3;20;.870;3545000;0
15093;163228;429;0;0;0;0;.00nan;0;0
15093;-1;429;51;31;5;26;.839;3648000;0
15093;179103;425;56;25;4;21;.840;3648000;0
15093;160809;425;0;0;0;0;.00nan;0;0
15094;-1;433;55;40;5;35;.875;3600000;0
15094;174386;428;0;0;0;0;.00nan;0;0
15094;86531;428;72;22;1;21;.955;3600000;0
15094;149937;433;0;0;0;0;.00nan;0;0
15095;-1;443;53;35;5;30;.857;3600000;0
15095;170928;443;0;0;0;0;.00nan;0;0
15095;85987;426;0;0;0;0;.00nan;0;0
15095;86226;426;74;21;1;20;.952;3600000;0
15096;165751;435;0;0;0;0;.00nan;0;0
15096;173954;438;0;0;0;0;.00nan;0;0
15096;78492;438;82;26;2;24;.923;3600000;0
15096;91448;435;64;31;3;28;.903;3554000;0
15097;171787;417;0;0;0;0;.00nan;0;0
15097;-1;413;94;44;2;42;.955;3600000;0
15097;-1;413;0;0;0;0;.00nan;0;0
15097;85050;417;77;32;3;29;.906;3600000;0
15098;165611;440;98;23;0;23;1.000;3600000;0
15098;170886;440;0;0;0;0;.00nan;0;0
15098;171517;431;0;0;0;0;.00nan;0;0
15098;149996;431;76;44;3;41;.932;3600000;0
15099;168360;444;45;31;5;26;.839;4200000;0
15099;168855;444;0;0;0;0;.00nan;0;0
15099;176808;418;0;0;0;0;.00nan;0;0
15099;180965;418;48;35;5;30;.857;4200000;0
15100;169027;442;54;25;3;22;.880;3600000;0
15100;-1;441;37;33;5;28;.848;3563000;0
15100;-1;442;0;0;0;0;.00nan;0;0
15100;57764;441;0;0;0;0;.00nan;0;0
15101;168206;414;45;37;6;31;.838;3600000;0
15101;-1;415;79;28;2;26;.929;3600000;0
15101;58110;414;0;0;0;0;.00nan;0;0
15101;94557;415;0;0;0;0;.00nan;0;0
15102;171930;422;0;0;0;0;.00nan;0;0
15102;166767;422;47;29;4;25;.862;3600000;0
15102;174241;421;79;26;2;24;.923;3600000;0
15102;74680;421;0;0;0;0;.00nan;0;0
15103;171578;449;57;26;3;23;.885;3560000;0
15103;179691;4849;0;0;0;0;.00nan;0;0
15103;141530;449;0;0;0;0;.00nan;0;0
15103;161023;4849;100;39;2;37;.949;3600000;0
15104;179143;423;36;20;4;16;.800;2036000;0
15104;74980;420;17;19;6;13;.684;2186000;0
15104;77123;420;36;6;2;4;.667;1414000;0
15104;85649;423;75;14;0;14;1.000;1564000;0
15105;177155;411;66;17;1;16;.941;3600000;0
15105;175989;410;0;0;0;0;.00nan;0;0
15105;78864;410;72;41;4;37;.902;3600000;0
15105;141459;411;0;0;0;0;.00nan;0;0
15106;163228;429;92;40;2;38;.950;4200000;0
15106;-1;429;0;0;0;0;.00nan;0;0
15106;59525;439;0;0;0;0;.00nan;0;0
15106;142583;439;74;29;2;27;.931;4200000;0
15107;-1;433;0;0;0;0;.00nan;0;0
15107;173575;437;0;0;0;0;.00nan;0;0
15107;139865;437;52;36;5;31;.861;3535000;0
15107;149937;433;76;36;3;33;.917;3600000;0
15108;169006;432;0;0;0;0;.00nan;0;0
15108;182093;432;59;19;2;17;.895;3600000;0
15108;141294;436;32;27;5;22;.815;3600000;0
15108;160967;436;0;0;0;0;.00nan;0;0
15109;168360;444;0;0;0;0;.00nan;0;0
15109;168855;444;86;36;3;33;.917;3567000;0
15109;176808;418;60;17;1;16;.941;3600000;0
15109;180965;418;0;0;0;0;.00nan;0;0
15110;170878;430;66;35;3;32;.914;4200000;0
15110;-1;430;0;0;0;0;.00nan;0;0
15110;85987;426;0;0;0;0;.00nan;0;0
15110;86226;426;58;24;3;21;.875;4200000;0
15111;168206;414;45;25;4;21;.840;3522000;0
15111;-1;413;0;0;0;0;.00nan;0;0
15111;-1;413;74;30;2;28;.933;3600000;0
15111;58110;414;0;0;0;0;.00nan;0;0
15112;165751;435;64;19;2;17;.895;3600000;0
15112;174325;427;31;32;6;26;.813;3600000;0
15112;-1;427;0;0;0;0;.00nan;0;0
15112;91448;435;0;0;0;0;.00nan;0;0
15113;173954;438;0;0;0;0;.00nan;0;0
15113;78492;438;61;31;3;28;.903;3588000;0
15113;86579;434;100;35;1;34;.971;3600000;0
15113;152650;434;0;0;0;0;.00nan;0;0
15114;171930;422;49;25;4;21;.840;3600000;0
15114;166767;422;0;0;0;0;.00nan;0;0
15114;174241;421;0;0;0;0;.00nan;0;0
15114;74680;421;92;34;1;33;.971;3600000;0
15115;171787;417;80;47;4;43;.915;3600000;0
15115;-1;415;0;0;0;0;.00nan;0;0
15115;85050;417;0;0;0;0;.00nan;0;0
15115;94557;415;85;32;1;31;.969;3600000;0
15116;171578;449;0;0;0;0;.00nan;0;0
15116;179691;4849;66;17;1;16;.941;3600000;0
15116;141530;449;37;21;4;17;.810;3600000;0
15116;161023;4849;0;0;0;0;.00nan;0;0
15117;179143;423;0;0;0;0;.00nan;0;0
15117;74980;420;0;0;0;0;.00nan;0;0
15117;77123;420;52;30;4;26;.867;3877000;0
15117;85649;423;64;30;3;27;.900;3877000;0
15118;177155;411;0;0;0;0;.00nan;0;0
15118;-1;412;71;29;2;27;.931;3600000;0
15118;-1;412;0;0;0;0;.00nan;0;0
15118;141459;411;73;36;3;33;.917;3548000;0
15119;173575;437;54;29;3;26;.897;3528000;0
15119;169006;432;0;0;0;0;.00nan;0;0
15119;182093;432;87;29;1;28;.966;3600000;0
15119;139865;437;0;0;0;0;.00nan;0;0
15121;173575;437;57;32;3;29;.906;3522000;0
15121;85987;426;89;34;1;33;.971;3600000;0
15121;86226;426;0;0;0;0;.00nan;0;0
15121;139865;437;0;0;0;0;.00nan;0;0
15123;-1;443;90;44;2;42;.955;3600000;0
15123;169006;432;0;0;0;0;.00nan;0;0
15123;170928;443;0;0;0;0;.00nan;0;0
15123;182093;432;45;27;4;23;.852;3570000;0
15125;171787;417;0;0;0;0;.00nan;0;0
15125;177155;411;56;28;4;24;.857;4200000;0
15125;85050;417;55;34;4;30;.882;4200000;0
15125;141459;411;0;0;0;0;.00nan;0;0
15127;171578;449;0;0;0;0;.00nan;0;0
15127;-1;413;0;0;0;0;.00nan;0;0
15127;-1;413;60;31;4;27;.871;3553000;0
15127;141530;449;55;17;2;15;.882;3600000;0
15129;163228;429;0;0;0;0;.00nan;0;0
15129;-1;429;49;31;4;27;.871;3598000;0
15129;171517;431;75;39;3;36;.923;3600000;0
15129;149996;431;0;0;0;0;.00nan;0;0
15131;165751;435;0;0;0;0;.00nan;0;0
15131;174241;421;63;19;2;17;.895;3600000;0
15131;74680;421;0;0;0;0;.00nan;0;0
15131;91448;435;75;34;3;31;.912;3586000;0
15133;179103;425;18;20;6;14;.700;2336000;0
15133;-1;415;0;0;0;0;.00nan;0;0
15133;94557;415;62;35;4;31;.886;3600000;0
15133;160809;425;53;11;1;10;.909;1264000;0
15135;169027;442;0;0;0;0;.00nan;0;0
15135;174386;428;85;36;3;33;.917;3600000;0
15135;-1;442;50;30;4;26;.867;3600000;0
15135;86531;428;0;0;0;0;.00nan;0;0
15137;175989;410;0;0;0;0;.00nan;0;0
15137;-1;412;0;0;0;0;.00nan;0;0
15137;-1;412;15;20;6;14;.700;3600000;0
15137;78864;410;100;23;0;23;1.000;3600000;0
15139;-1;433;80;33;2;31;.939;3553000;0
15139;59525;439;0;0;0;0;.00nan;0;0
15139;142583;439;84;23;1;22;.957;3600000;0
15139;149937;433;0;0;0;0;.00nan;0;0
15141;-1;419;45;21;3;18;.857;3600000;0
15141;74980;420;37;37;6;31;.838;3600000;0
15141;76378;419;0;0;0;0;.00nan;0;0
15141;77123;420;0;0;0;0;.00nan;0;0
15143;168206;414;39;18;4;14;.778;3516000;0
15143;176808;418;0;0;0;0;.00nan;0;0
15143;180965;418;73;28;2;26;.929;3600000;0
15143;58110;414;0;0;0;0;.00nan;0;0
15145;173954;438;59;34;4;30;.882;3600000;0
15145;170878;430;82;24;1;23;.958;3600000;0
15145;-1;430;0;0;0;0;.00nan;0;0
15145;78492;438;0;0;0;0;.00nan;0;0
15147;171930;422;68;19;1;18;.947;3600000;0
15147;166767;422;0;0;0;0;.00nan;0;0
15147;179691;4849;0;0;0;0;.00nan;0;0
15147;161023;4849;58;36;5;31;.861;3600000;0
15149;-1;441;88;41;2;39;.951;3608000;0
15149;57764;441;0;0;0;0;.00nan;0;0
15149;141294;436;0;0;0;0;.00nan;0;0
15149;160967;436;61;14;1;13;.929;3608000;0
15151;165611;440;84;15;0;15;1.000;3600000;0
15151;170886;440;0;0;0;0;.00nan;0;0
15151;174325;427;69;46;5;41;.891;3600000;0
15151;-1;427;0;0;0;0;.00nan;0;0
15153;179143;423;65;30;3;27;.900;3534000;0
15153;85649;423;0;0;0;0;.00nan;0;0
15153;86579;434;60;14;1;13;.929;3600000;0
15153;152650;434;0;0;0;0;.00nan;0;0
15155;179691;4849;0;0;0;0;.00nan;0;0
15155;85987;426;0;0;0;0;.00nan;0;0
15155;86226;426;53;27;4;23;.852;3600000;0
15155;161023;4849;80;28;1;27;.964;3600000;0
15157;-1;415;0;0;0;0;.00nan;0;0
15157;175989;410;0;0;0;0;.00nan;0;0
15157;78864;410;86;31;2;29;.935;3600000;0
15157;94557;415;86;15;0;15;1.000;3600000;0
15159;169006;432;0;0;0;0;.00nan;0;0
15159;182093;432;70;32;3;29;.906;3600000;0
15159;-1;412;0;0;0;0;.00nan;0;0
15159;-1;412;87;29;1;28;.966;3600000;0
15161;-1;433;94;33;1;32;.970;3600000;0
15161;-1;441;50;22;3;19;.864;3537000;0
15161;57764;441;0;0;0;0;.00nan;0;0
15161;149937;433;0;0;0;0;.00nan;0;0
15163;165751;435;0;0;0;0;.00nan;0;0
15163;86579;434;37;18;3;15;.833;4200000;0
15163;91448;435;92;49;3;46;.939;4194000;0
15163;152650;434;0;0;0;0;.00nan;0;0
15165;173575;437;0;0;0;0;.00nan;0;0
15165;174386;428;54;23;3;20;.870;4103000;0
15165;86531;428;0;0;0;0;.00nan;0;0
15165;139865;437;76;29;2;27;.931;4103000;0
15167;171787;417;0;0;0;0;.00nan;0;0
15167;163228;429;49;33;5;28;.848;3600000;0
15167;-1;429;0;0;0;0;.00nan;0;0
15167;85050;417;72;20;1;19;.950;3600000;0
15169;-1;443;100;30;0;30;1.000;3600000;0
15169;169027;442;79;25;1;24;.960;3551000;0
15169;170928;443;0;0;0;0;.00nan;0;0
15169;-1;442;0;0;0;0;.00nan;0;0
15171;171930;422;0;0;0;0;.00nan;0;0
15171;166767;422;81;22;1;21;.955;3600000;0
15171;176808;418;0;0;0;0;.00nan;0;0
15171;180965;418;39;31;5;26;.839;3600000;0
15173;177155;411;0;0;0;0;.00nan;0;0
15173;168206;414;72;29;2;27;.931;3581000;0
15173;58110;414;0;0;0;0;.00nan;0;0
15173;141459;411;85;28;1;27;.964;3600000;0
15175;179143;423;0;0;0;0;.00nan;0;0
15175;174325;427;0;0;0;0;.00nan;0;0
15175;-1;427;73;25;2;23;.920;3679000;0
15175;85649;423;88;28;1;27;.964;3679000;0
15177;165611;440;64;16;1;15;.938;3600000;0
15177;170886;440;0;0;0;0;.00nan;0;0
15177;174241;421;75;48;5;43;.896;3600000;0
15177;74680;421;0;0;0;0;.00nan;0;0
15179;168360;444;56;23;3;20;.870;3600000;0
15179;168855;444;0;0;0;0;.00nan;0;0
15179;171578;449;0;0;0;0;.00nan;0;0
15179;141530;449;41;27;5;22;.815;3552000;0
15181;170878;430;40;3;1;2;.667;347000;0
15181;-1;430;36;30;6;24;.800;3253000;0
15181;74980;420;69;21;1;20;.952;3600000;0
15181;77123;420;0;0;0;0;.00nan;0;0
15183;173954;438;27;22;5;17;.773;3600000;0
15183;-1;413;0;0;0;0;.00nan;0;0
15183;-1;413;100;41;1;40;.976;3600000;0
15183;78492;438;0;0;0;0;.00nan;0;0
15185;179103;425;46;25;4;21;.840;3600000;0
15185;-1;419;84;25;1;24;.960;3600000;0
15185;76378;419;0;0;0;0;.00nan;0;0
15185;160809;425;0;0;0;0;.00nan;0;0
15187;171517;431;0;0;0;0;.00nan;0;0
15187;141294;436;0;0;0;0;.00nan;0;0
15187;149996;431;79;29;2;27;.931;4077000;0
15187;160967;436;80;38;3;35;.921;4077000;0
15189;171517;431;60;20;2;18;.900;3600000;0
15189;176808;418;53;19;3;16;.842;3565000;0
15189;180965;418;0;0;0;0;.00nan;0;0
15189;149996;431;0;0;0;0;.00nan;0;0
15191;168360;444;0;0;0;0;.00nan;0;0
15191;168855;444;52;31;4;27;.871;3518000;0
15191;169027;442;0;0;0;0;.00nan;0;0
15191;-1;442;61;18;2;16;.889;3600000;0
15193;165751;435;89;50;3;47;.940;3514000;0
15193;-1;419;0;0;0;0;.00nan;0;0
15193;76378;419;71;18;1;17;.944;3600000;0
15193;91448;435;0;0;0;0;.00nan;0;0
15195;171578;449;63;20;2;18;.900;3600000;0
15195;74980;420;50;26;3;23;.885;2647000;0
15195;77123;420;20;11;4;7;.636;953000;0
15195;141530;449;0;0;0;0;.00nan;0;0
15197;171787;417;57;27;3;24;.889;3695000;0
15197;-1;413;75;40;4;36;.900;3695000;0
15197;-1;413;0;0;0;0;.00nan;0;0
15197;85050;417;0;0;0;0;.00nan;0;0
15199;169006;432;84;38;1;37;.974;3600000;0
15199;179103;425;0;0;0;0;.00nan;0;0
15199;182093;432;0;0;0;0;.00nan;0;0
15199;160809;425;70;28;2;26;.929;3599000;0
15201;173954;438;0;0;0;0;.00nan;0;0
15201;-1;441;0;0;0;0;.00nan;0;0
15201;57764;441;88;34;1;33;.971;3790000;0
15201;78492;438;77;27;2;25;.926;3790000;0
15203;-1;433;0;0;0;0;.00nan;0;0
15203;174325;427;69;21;1;20;.952;3600000;0
15203;-1;427;0;0;0;0;.00nan;0;0
15203;149937;433;75;33;2;31;.939;3600000;0
15205;170878;430;85;36;2;34;.944;3600000;0
15205;-1;430;0;0;0;0;.00nan;0;0
15205;141294;436;67;33;3;30;.909;3600000;0
15205;160967;436;0;0;0;0;.00nan;0;0
15207;174386;428;0;0;0;0;.00nan;0;0
15207;-1;412;100;36;0;36;1.000;3600000;0
15207;-1;412;0;0;0;0;.00nan;0;0
15207;86531;428;74;20;1;19;.950;3572000;0
15209;163228;429;0;0;0;0;.00nan;0;0
15209;-1;429;73;29;2;27;.931;3600000;0
15209;86579;434;83;42;3;39;.929;3564000;0
15209;152650;434;0;0;0;0;.00nan;0;0
15211;165611;440;0;0;0;0;.00nan;0;0
15211;170886;440;55;12;1;11;.917;3600000;0
15211;179691;4849;89;40;2;38;.950;3600000;0
15211;161023;4849;0;0;0;0;.00nan;0;0
15213;171930;422;53;15;2;13;.867;3513000;0
15213;166767;422;0;0;0;0;.00nan;0;0
15213;179143;423;98;20;0;20;1.000;3600000;0
15213;85649;423;0;0;0;0;.00nan;0;0
15215;175989;410;67;34;3;31;.912;3555000;0
15215;59525;439;0;0;0;0;.00nan;0;0
15215;78864;410;0;0;0;0;.00nan;0;0
15215;142583;439;66;19;1;18;.947;3600000;0
15217;173575;437;62;29;2;27;.931;4200000;0
15217;85987;426;75;24;2;22;.917;4200000;0
15217;86226;426;0;0;0;0;.00nan;0;0
15217;139865;437;0;0;0;0;.00nan;0;0
15219;177155;411;76;23;1;22;.957;3600000;0
15219;174241;421;0;0;0;0;.00nan;0;0
15219;74680;421;70;25;2;23;.920;3600000;0
15219;141459;411;0;0;0;0;.00nan;0;0
15221;168206;414;0;0;0;0;.00nan;0;0
15221;-1;443;84;40;3;37;.925;3699000;0
15221;170928;443;0;0;0;0;.00nan;0;0
15221;58110;414;53;17;2;15;.882;3699000;0
15223;-1;413;14;6;4;2;.333;736000;0
15223;174386;428;44;10;2;8;.800;3600000;0
15223;-1;413;42;29;5;24;.828;2864000;0
15223;86531;428;0;0;0;0;.00nan;0;0
15225;179691;4849;0;0;0;0;.00nan;0;0
15225;59525;439;0;0;0;0;.00nan;0;0
15225;142583;439;64;27;3;24;.889;3583000;0
15225;161023;4849;99;40;1;39;.975;3600000;0
15227;170878;430;0;0;0;0;.00nan;0;0
15227;-1;441;22;28;6;22;.786;3335000;0
15227;-1;430;89;28;1;27;.964;3600000;0
15227;57764;441;55;3;0;3;1.000;265000;0
15229;174325;427;0;0;0;0;.00nan;0;0
15229;-1;427;65;41;4;37;.902;3600000;0
15229;86579;434;77;9;0;9;1.000;3600000;0
15229;152650;434;0;0;0;0;.00nan;0;0
15231;179143;423;97;42;2;40;.952;4200000;0
15231;85649;423;0;0;0;0;.00nan;0;0
15231;141294;436;0;0;0;0;.00nan;0;0
15231;160967;436;83;33;2;31;.939;4200000;0
15233;165611;440;52;16;2;14;.875;3600000;0
15233;173575;437;0;0;0;0;.00nan;0;0
15233;170886;440;0;0;0;0;.00nan;0;0
15233;139865;437;56;34;4;30;.882;3600000;0
15235;-1;433;57;22;3;19;.864;3600000;0
15235;-1;419;85;14;0;14;1.000;3600000;0
15235;76378;419;0;0;0;0;.00nan;0;0
15235;149937;433;0;0;0;0;.00nan;0;0
15237;171578;449;0;0;0;0;.00nan;0;0
15237;-1;412;92;34;1;33;.971;3600000;0
15237;-1;412;0;0;0;0;.00nan;0;0
15237;141530;449;96;22;0;22;1.000;3600000;0
15239;171787;417;0;0;0;0;.00nan;0;0
15239;168360;444;0;0;0;0;.00nan;0;0
15239;168855;444;68;35;3;32;.914;3600000;0
15239;85050;417;39;21;4;17;.810;3545000;0
15241;-1;443;75;42;4;38;.905;3600000;0
15241;170928;443;0;0;0;0;.00nan;0;0
15241;-1;415;0;0;0;0;.00nan;0;0
15241;94557;415;77;24;1;23;.958;3600000;0
15243;163228;429;0;0;0;0;.00nan;0;0
15243;-1;429;67;26;2;24;.923;4065000;0
15243;171517;431;98;41;1;40;.976;4065000;0
15243;149996;431;0;0;0;0;.00nan;0;0
15245;179103;425;93;30;1;29;.967;3872000;0
15245;74980;420;84;33;2;31;.939;3872000;0
15245;77123;420;0;0;0;0;.00nan;0;0
15245;160809;425;0;0;0;0;.00nan;0;0
15247;169027;442;71;28;2;26;.929;3581000;0
15247;-1;442;0;0;0;0;.00nan;0;0
15247;85987;426;0;0;0;0;.00nan;0;0
15247;86226;426;96;38;1;37;.974;3600000;0
15249;177155;411;0;0;0;0;.00nan;0;0
15249;176808;418;0;0;0;0;.00nan;0;0
15249;180965;418;99;40;1;39;.975;3600000;0
15249;141459;411;36;18;4;14;.778;3600000;0
15251;168206;414;67;22;2;20;.909;3600000;0
15251;174241;421;66;29;4;25;.862;3560000;0
15251;58110;414;0;0;0;0;.00nan;0;0
15251;74680;421;0;0;0;0;.00nan;0;0
15253;171930;422;0;0;0;0;.00nan;0;0
15253;166767;422;80;22;1;21;.955;3600000;0
15253;169006;432;0;0;0;0;.00nan;0;0
15253;182093;432;72;29;2;27;.931;3600000;0
15255;165751;435;0;0;0;0;.00nan;0;0
15255;173954;438;53;24;3;21;.875;3873000;0
15255;78492;438;0;0;0;0;.00nan;0;0
15255;91448;435;75;36;4;32;.889;3873000;0
15256;9858;945;0;0;0;0;.00nan;0;0
15256;82245;945;57;26;4;22;.846;3632000;0
15256;146386;983;0;0;0;0;.00nan;0;0
15256;154414;983;62;30;3;27;.900;3632000;0
15257;6127;878;83;32;3;29;.906;3900000;0
15257;57413;966;75;40;3;37;.925;3883000;0
15257;146656;878;0;0;0;0;.00nan;0;0
15257;154996;966;0;0;0;0;.00nan;0;0
15258;166514;894;0;0;0;0;.00nan;0;0
15258;168842;880;0;0;0;0;.00nan;0;0
15258;36136;880;65;25;2;23;.920;3600000;0
15258;62287;894;70;35;3;32;.914;3556000;0
15259;8505;978;54;15;2;13;.867;3600000;0
15259;23251;994;83;43;3;40;.930;3579000;0
15259;46905;994;0;0;0;0;.00nan;0;0
15259;62015;978;0;0;0;0;.00nan;0;0
15260;4219;879;0;0;0;0;.00nan;0;0
15260;7624;885;0;0;0;0;.00nan;0;0
15260;176765;885;100;25;0;25;1.000;3600000;0
15260;81792;879;53;30;5;25;.833;3600000;0
15261;14873;874;0;0;0;0;.00nan;0;0
15261;28701;965;70;43;5;38;.884;3883000;0
15261;43896;874;58;29;4;25;.862;3883000;0
15261;56306;965;0;0;0;0;.00nan;0;0
15262;61272;1415;76;40;3;37;.925;3600000;0
15262;70099;890;85;16;0;16;1.000;3600000;0
15262;146934;1415;0;0;0;0;.00nan;0;0
15262;157295;890;0;0;0;0;.00nan;0;0
15263;61272;1415;83;35;3;32;.914;3600000;0
15263;146386;983;0;0;0;0;.00nan;0;0
15263;146934;1415;0;0;0;0;.00nan;0;0
15263;154414;983;70;47;5;42;.894;3531000;0
15264;6127;878;68;33;3;30;.909;3600000;0
15264;23251;994;38;35;6;29;.829;3600000;0
15264;46905;994;0;0;0;0;.00nan;0;0
15264;146656;878;0;0;0;0;.00nan;0;0
15265;7624;885;0;0;0;0;.00nan;0;0
15265;28701;965;99;44;1;43;.977;3600000;0
15265;176765;885;68;24;3;21;.875;3532000;0
15265;56306;965;0;0;0;0;.00nan;0;0
15266;8505;978;26;13;4;9;.692;1081000;0
15266;166514;894;0;0;0;0;.00nan;0;0
15266;62015;978;60;18;2;16;.889;2485000;0
15266;62287;894;29;24;5;19;.792;3600000;0
15267;168842;880;76;32;2;30;.938;3600000;0
15267;36136;880;0;0;0;0;.00nan;0;0
15267;57413;966;68;30;3;27;.900;3551000;0
15267;154996;966;0;0;0;0;.00nan;0;0
15268;4219;879;52;24;3;21;.875;3900000;0
15268;9858;945;70;29;3;26;.897;3900000;0
15268;81792;879;0;0;0;0;.00nan;0;0
15268;82245;945;0;0;0;0;.00nan;0;0
15269;14873;874;0;0;0;0;.00nan;0;0
15269;43896;874;87;38;3;35;.921;3568000;0
15269;70099;890;91;36;1;35;.972;3600000;0
15269;157295;890;0;0;0;0;.00nan;0;0
15270;6127;878;75;21;2;19;.905;3600000;0
15270;7624;885;21;23;6;17;.739;2619000;0
15270;176765;885;47;11;2;9;.818;981000;0
15270;146656;878;0;0;0;0;.00nan;0;0
15271;4487;945;78;29;2;27;.931;3600000;0
15271;9858;945;0;0;0;0;.00nan;0;0
15271;166514;894;0;0;0;0;.00nan;0;0
15271;62287;894;73;34;3;31;.912;3568000;0
15272;14873;874;0;0;0;0;.00nan;0;0
15272;43896;874;76;26;2;24;.923;3600000;0
15272;61272;1415;72;38;3;35;.921;3544000;0
15272;146934;1415;0;0;0;0;.00nan;0;0
15273;7037;966;0;0;0;0;.00nan;0;0
15273;8505;978;70;40;3;37;.925;3900000;0
15273;57413;966;75;35;3;32;.914;3900000;0
15273;62015;978;0;0;0;0;.00nan;0;0
15274;4219;879;86;34;2;32;.941;3600000;0
15274;168842;880;30;21;5;16;.762;2360000;0
15274;36136;880;61;15;1;14;.933;1240000;0
15274;81792;879;0;0;0;0;.00nan;0;0
15275;23251;994;0;0;0;0;.00nan;0;0
15275;46905;994;65;35;3;32;.914;3577000;0
15275;70099;890;73;20;1;19;.950;3600000;0
15275;157295;890;0;0;0;0;.00nan;0;0
15276;28701;965;45;30;4;26;.867;3573000;0
15276;56306;965;0;0;0;0;.00nan;0;0
15276;146386;983;0;0;0;0;.00nan;0;0
15276;154414;983;57;21;2;19;.905;3600000;0
15277;14873;874;0;0;0;0;.00nan;0;0
15277;43896;874;54;27;3;24;.889;3600000;0
15277;61272;1415;40;37;6;31;.838;2527000;0
15277;146934;1415;59;8;0;8;1.000;1073000;0
15278;7037;966;0;0;0;0;.00nan;0;0
15278;8505;978;39;25;4;21;.840;3600000;0
15278;57413;966;66;49;6;43;.878;3579000;0
15278;62015;978;0;0;0;0;.00nan;0;0
15279;7037;966;0;0;0;0;.00nan;0;0
15279;14873;874;0;0;0;0;.00nan;0;0
15279;43896;874;48;20;3;17;.850;3600000;0
15279;57413;966;100;40;1;39;.975;3600000;0
15280;7624;885;0;0;0;0;.00nan;0;0
15280;168842;880;76;23;1;22;.957;3600000;0
15280;176765;885;51;26;4;22;.846;3600000;0
15280;36136;880;0;0;0;0;.00nan;0;0
15281;166514;894;0;0;0;0;.00nan;0;0
15281;62287;894;84;30;1;29;.967;3600000;0
15281;70099;890;61;28;3;25;.893;3559000;0
15281;157295;890;0;0;0;0;.00nan;0;0
15282;6127;878;42;22;4;18;.818;3600000;0
15282;28701;965;56;6;0;6;1.000;502000;0
15282;56306;965;39;35;6;29;.829;3057000;0
15282;146656;878;0;0;0;0;.00nan;0;0
15283;8505;978;80;15;0;15;1.000;3600000;0
15283;62015;978;0;0;0;0;.00nan;0;0
15283;146386;983;0;0;0;0;.00nan;0;0
15283;154414;983;63;41;5;36;.878;3600000;0
15284;4219;879;50;19;3;16;.842;3544000;0
15284;61272;1415;73;30;2;28;.933;3600000;0
15284;81792;879;0;0;0;0;.00nan;0;0
15284;146934;1415;0;0;0;0;.00nan;0;0
15285;23251;994;75;21;1;20;.952;3654000;0
15285;46905;994;0;0;0;0;.00nan;0;0
15285;146386;983;0;0;0;0;.00nan;0;0
15285;154414;983;75;30;2;28;.933;3654000;0
15286;6127;878;69;24;2;22;.917;3559000;0
15286;8505;978;90;31;1;30;.968;3600000;0
15286;62015;978;0;0;0;0;.00nan;0;0
15286;146656;878;0;0;0;0;.00nan;0;0
15287;7624;885;0;0;0;0;.00nan;0;0
15287;176765;885;90;30;1;29;.967;3600000;0
15287;61272;1415;18;18;6;12;.667;3600000;0
15287;146934;1415;0;0;0;0;.00nan;0;0
15288;4219;879;80;20;1;19;.950;3600000;0
15288;166514;894;0;0;0;0;.00nan;0;0
15288;62287;894;65;35;3;32;.914;3590000;0
15288;81792;879;0;0;0;0;.00nan;0;0
15289;7037;966;0;0;0;0;.00nan;0;0
15289;57413;966;81;24;1;23;.958;3600000;0
15289;70099;890;65;28;2;26;.929;3576000;0
15289;157295;890;0;0;0;0;.00nan;0;0
15290;168842;880;74;29;2;27;.931;3600000;0
15290;28701;965;71;36;4;32;.889;3600000;0
15290;36136;880;0;0;0;0;.00nan;0;0
15290;56306;965;0;0;0;0;.00nan;0;0
15291;4487;945;68;30;3;27;.900;3600000;0
15291;9858;945;0;0;0;0;.00nan;0;0
15291;14873;874;0;0;0;0;.00nan;0;0
15291;43896;874;36;32;6;26;.813;3600000;0
15292;8505;978;41;24;4;20;.833;3543000;0
15292;168842;880;0;0;0;0;.00nan;0;0
15292;36136;880;66;22;2;20;.909;3600000;0
15292;62015;978;0;0;0;0;.00nan;0;0
15293;7624;885;0;0;0;0;.00nan;0;0
15293;176765;885;97;39;0;39;1.000;3900000;0
15293;146386;983;0;0;0;0;.00nan;0;0
15293;154414;983;100;19;0;19;1.000;3900000;0
15294;4487;945;62;39;5;34;.872;3524000;0
15294;6127;878;47;17;3;14;.824;3600000;0
15294;9858;945;0;0;0;0;.00nan;0;0
15294;146656;878;0;0;0;0;.00nan;0;0
15295;4219;879;0;0;0;0;.00nan;0;0
15295;70099;890;56;31;3;28;.903;3900000;0
15295;81792;879;65;25;3;22;.880;3900000;0
15295;157295;890;0;0;0;0;.00nan;0;0
15296;7037;966;0;0;0;0;.00nan;0;0
15296;28701;965;39;35;6;29;.829;3600000;0
15296;56306;965;0;0;0;0;.00nan;0;0
15296;57413;966;44;25;4;21;.840;3600000;0
15297;23251;994;0;0;0;0;.00nan;0;0
15297;46905;994;86;49;3;46;.939;3564000;0
15297;61272;1415;70;19;1;18;.947;3600000;0
15297;146934;1415;0;0;0;0;.00nan;0;0
15298;14873;874;0;0;0;0;.00nan;0;0
15298;166514;894;60;7;0;7;1.000;821000;0
15298;43896;874;61;24;3;21;.875;3600000;0
15298;62287;894;20;25;6;19;.760;2779000;0
15299;6127;878;96;21;0;21;1.000;3600000;0
15299;14873;874;0;0;0;0;.00nan;0;0
15299;43896;874;89;39;2;37;.949;3523000;0
15299;146656;878;0;0;0;0;.00nan;0;0
15300;28701;965;0;0;0;0;.00nan;0;0
15300;56306;965;100;41;0;41;1.000;3600000;0
15300;61272;1415;69;24;2;22;.917;3575000;0
15300;146934;1415;0;0;0;0;.00nan;0;0
15301;7624;885;0;0;0;0;.00nan;0;0
15301;166514;894;65;27;3;24;.889;3561000;0
15301;176765;885;83;38;2;36;.947;3600000;0
15301;62287;894;0;0;0;0;.00nan;0;0
15302;4487;945;84;36;3;33;.917;3600000;0
15302;8505;978;71;24;2;22;.917;3600000;0
15302;9858;945;0;0;0;0;.00nan;0;0
15302;62015;978;0;0;0;0;.00nan;0;0
15303;7037;966;0;0;0;0;.00nan;0;0
15303;23251;994;51;32;5;27;.844;3600000;0
15303;46905;994;0;0;0;0;.00nan;0;0
15303;57413;966;66;28;2;26;.929;3600000;0
15304;4219;879;0;0;0;0;.00nan;0;0
15304;81792;879;62;36;4;32;.889;3600000;0
15304;146386;983;0;0;0;0;.00nan;0;0
15304;154414;983;100;31;1;30;.968;3600000;0
15305;168842;880;30;8;3;5;.625;513000;0
15305;36136;880;43;36;6;30;.833;3087000;0
15305;70099;890;69;20;1;19;.950;3600000;0
15305;157295;890;0;0;0;0;.00nan;0;0
15306;4487;945;75;32;3;29;.906;3900000;0
15306;9858;945;0;0;0;0;.00nan;0;0
15306;23251;994;0;0;0;0;.00nan;0;0
15306;46905;994;50;28;3;25;.893;3900000;0
15307;6127;878;60;25;3;22;.880;3600000;0
15307;146386;983;52;8;1;7;.875;362000;0
15307;146656;878;0;0;0;0;.00nan;0;0
15307;154414;983;48;46;6;40;.870;3238000;0
15308;4487;945;78;27;2;25;.926;3900000;0
15308;9858;945;0;0;0;0;.00nan;0;0
15308;70099;890;94;36;2;34;.944;3900000;0
15308;157295;890;0;0;0;0;.00nan;0;0
15309;8505;978;100;46;2;44;.957;3900000;0
15309;61272;1415;0;0;0;0;.00nan;0;0
15309;62015;978;0;0;0;0;.00nan;0;0
15309;146934;1415;70;25;2;23;.920;3900000;0
15310;166514;894;0;0;0;0;.00nan;0;0
15310;28701;965;74;36;3;33;.917;3900000;0
15310;56306;965;0;0;0;0;.00nan;0;0
15310;62287;894;68;26;3;23;.885;3900000;0
15311;7037;966;0;0;0;0;.00nan;0;0
15311;7624;885;0;0;0;0;.00nan;0;0
15311;176765;885;87;47;4;43;.915;3600000;0
15311;57413;966;67;20;2;18;.900;3600000;0
15312;168842;880;0;0;0;0;.00nan;0;0
15312;23251;994;100;48;0;48;1.000;3600000;0
15312;36136;880;46;21;3;18;.857;3600000;0
15312;46905;994;0;0;0;0;.00nan;0;0
15313;4219;879;57;29;3;26;.897;3565000;0
15313;14873;874;0;0;0;0;.00nan;0;0
15313;43896;874;54;17;2;15;.882;3600000;0
15313;81792;879;0;0;0;0;.00nan;0;0
15314;166514;894;0;0;0;0;.00nan;0;0
15314;62287;894;65;35;3;32;.914;3586000;0
15314;146386;983;88;32;1;31;.969;3600000;0
15314;154414;983;0;0;0;0;.00nan;0;0
15315;7624;885;0;0;0;0;.00nan;0;0
15315;8505;978;65;31;3;28;.903;3600000;0
15315;176765;885;82;23;1;22;.957;3600000;0
15315;62015;978;0;0;0;0;.00nan;0;0
15316;6127;878;77;25;1;24;.960;3600000;0
15316;61272;1415;74;34;4;30;.882;3600000;0
15316;146656;878;0;0;0;0;.00nan;0;0
15316;146934;1415;0;0;0;0;.00nan;0;0
15317;4487;945;54;30;5;25;.833;3600000;0
15317;7037;966;0;0;0;0;.00nan;0;0
15317;9858;945;0;0;0;0;.00nan;0;0
15317;57413;966;70;26;2;24;.923;3600000;0
15318;4219;879;87;30;2;28;.933;3600000;0
15318;23251;994;34;21;4;17;.810;3544000;0
15318;46905;994;0;0;0;0;.00nan;0;0
15318;81792;879;0;0;0;0;.00nan;0;0
15319;14873;874;0;0;0;0;.00nan;0;0
15319;168842;880;98;29;0;29;1.000;3600000;0
15319;36136;880;0;0;0;0;.00nan;0;0
15319;43896;874;71;31;2;29;.935;3544000;0
15320;28701;965;50;31;5;26;.839;3600000;0
15320;56306;965;0;0;0;0;.00nan;0;0
15320;70099;890;92;26;1;25;.962;3600000;0
15320;157295;890;0;0;0;0;.00nan;0;0
15321;166514;894;0;0;0;0;.00nan;0;0
15321;23251;994;0;0;0;0;.00nan;0;0
15321;46905;994;63;35;5;30;.857;3712000;0
15321;62287;894;64;34;4;30;.882;3712000;0
15322;166514;894;48;20;3;17;.850;3543000;0
15322;23251;994;81;39;2;37;.949;3600000;0
15322;46905;994;0;0;0;0;.00nan;0;0
15322;62287;894;0;0;0;0;.00nan;0;0
15323;7624;885;0;0;0;0;.00nan;0;0
15323;14873;874;0;0;0;0;.00nan;0;0
15323;176765;885;51;20;3;17;.850;3600000;0
15323;43896;874;48;26;4;22;.846;3543000;0
15324;6127;878;0;0;0;0;.00nan;0;0
15324;168842;880;37;29;6;23;.793;3554000;0
15324;36136;880;0;0;0;0;.00nan;0;0
15324;146656;878;50;27;4;23;.852;3600000;0
15325;70099;890;0;0;0;0;.00nan;0;0
15325;146386;983;0;0;0;0;.00nan;0;0
15325;154414;983;89;46;4;42;.913;3900000;0
15325;157295;890;60;30;4;26;.867;3900000;0
15326;7037;966;0;0;0;0;.00nan;0;0
15326;57413;966;77;37;4;33;.892;3600000;0
15326;61272;1415;93;33;1;32;.970;3600000;0
15326;146934;1415;0;0;0;0;.00nan;0;0
15327;4487;945;93;34;2;32;.941;3600000;0
15327;9858;945;0;0;0;0;.00nan;0;0
15327;28701;965;73;35;3;32;.914;3543000;0
15327;56306;965;0;0;0;0;.00nan;0;0
15328;4219;879;39;23;5;18;.783;3600000;0
15328;8505;978;0;0;0;0;.00nan;0;0
15328;62015;978;100;28;0;28;1.000;3600000;0
15328;81792;879;0;0;0;0;.00nan;0;0
15329;168842;880;92;30;2;28;.933;3543000;0
15329;36136;880;0;0;0;0;.00nan;0;0
15329;146386;983;0;0;0;0;.00nan;0;0
15329;154414;983;92;22;0;22;1.000;3600000;0
15330;7624;885;88;25;0;25;1.000;2671000;0
15330;176765;885;23;11;4;7;.636;879000;0
15330;70099;890;64;23;3;20;.870;3600000;0
15330;157295;890;0;0;0;0;.00nan;0;0
15331;23251;994;0;0;0;0;.00nan;0;0
15331;28701;965;59;35;4;31;.886;3600000;0
15331;46905;994;46;18;3;15;.833;3600000;0
15331;56306;965;0;0;0;0;.00nan;0;0
15332;4219;879;86;44;3;41;.932;3600000;0
15332;6127;878;40;25;5;20;.800;3530000;0
15332;81792;879;0;0;0;0;.00nan;0;0
15332;146656;878;0;0;0;0;.00nan;0;0
15333;8505;978;0;0;0;0;.00nan;0;0
15333;14873;874;0;0;0;0;.00nan;0;0
15333;43896;874;91;23;0;23;1.000;3600000;0
15333;62015;978;57;20;2;18;.900;3600000;0
15334;4487;945;100;28;0;28;1.000;3600000;0
15334;9858;945;0;0;0;0;.00nan;0;0
15334;61272;1415;97;47;2;45;.957;3564000;0
15334;146934;1415;0;0;0;0;.00nan;0;0
15335;7037;966;0;0;0;0;.00nan;0;0
15335;166514;894;0;0;0;0;.00nan;0;0
15335;57413;966;77;25;1;24;.960;3600000;0
15335;62287;894;51;33;4;29;.879;3600000;0
15336;18104;874;0;0;0;0;.00nan;0;0
15336;43896;874;79;33;2;31;.939;3549000;0
15336;146386;983;0;0;0;0;.00nan;0;0
15336;154414;983;83;31;1;30;.968;3600000;0
15337;23251;994;54;25;4;21;.840;3560000;0
15337;176765;885;64;29;2;27;.931;3600000;0
15337;46905;994;0;0;0;0;.00nan;0;0
15337;61999;885;0;0;0;0;.00nan;0;0
15338;6127;878;85;26;1;25;.962;3600000;0
15338;70099;890;83;40;3;37;.925;3531000;0
15338;146656;878;0;0;0;0;.00nan;0;0
15338;157295;890;0;0;0;0;.00nan;0;0
15339;166514;894;0;0;0;0;.00nan;0;0
15339;61272;1415;15;24;6;18;.750;3600000;0
15339;62287;894;59;26;3;23;.885;3600000;0
15339;146934;1415;0;0;0;0;.00nan;0;0
15340;8505;978;33;32;6;26;.813;3600000;0
15340;28701;965;86;35;2;33;.943;3600000;0
15340;56306;965;0;0;0;0;.00nan;0;0
15340;62015;978;0;0;0;0;.00nan;0;0
15341;4487;945;74;32;2;30;.938;3600000;0
15341;168842;880;58;29;3;26;.897;3596000;0
15341;36136;880;0;0;0;0;.00nan;0;0
15341;44487;945;0;0;0;0;.00nan;0;0
15342;779;966;0;0;0;0;.00nan;0;0
15342;4219;879;0;0;0;0;.00nan;0;0
15342;7037;966;42;27;4;23;.852;3548000;0
15342;81792;879;81;40;3;37;.925;3600000;0
15343;4487;945;82;24;1;23;.958;3600000;0
15343;176765;885;73;24;2;22;.917;3543000;0
15343;44487;945;0;0;0;0;.00nan;0;0
15343;61999;885;0;0;0;0;.00nan;0;0
15344;8505;978;83;34;2;32;.941;3562000;0
15344;62015;978;0;0;0;0;.00nan;0;0
15344;70099;890;89;18;0;18;1.000;3600000;0
15344;157295;890;0;0;0;0;.00nan;0;0
15345;168842;880;0;0;0;0;.00nan;0;0
15345;36136;880;87;27;1;26;.963;3600000;0
15345;61272;1415;86;37;2;35;.946;3569000;0
15345;146934;1415;0;0;0;0;.00nan;0;0
15346;4219;879;0;0;0;0;.00nan;0;0
15346;28701;965;86;34;2;32;.941;3652000;0
15346;56306;965;0;0;0;0;.00nan;0;0
15346;81792;879;71;29;3;26;.897;3652000;0
15347;6127;878;69;28;3;25;.893;3600000;0
15347;166514;894;32;24;5;19;.792;2142000;0
15347;62287;894;40;9;2;7;.778;1458000;0
15347;146656;878;0;0;0;0;.00nan;0;0
15348;779;966;46;24;5;19;.792;3600000;0
15348;7037;966;0;0;0;0;.00nan;0;0
15348;146386;983;0;0;0;0;.00nan;0;0
15348;154414;983;70;37;4;33;.892;3600000;0
15349;18104;874;0;0;0;0;.00nan;0;0
15349;23251;994;0;0;0;0;.00nan;0;0
15349;43896;874;62;23;2;21;.913;3600000;0
15349;46905;994;54;31;4;27;.871;3600000;0
15350;4487;945;0;0;0;0;.00nan;0;0
15350;166514;894;0;0;0;0;.00nan;0;0
15350;44487;945;25;21;6;15;.714;3600000;0
15350;62287;894;79;26;1;25;.962;3600000;0
15351;4219;879;0;0;0;0;.00nan;0;0
15351;81792;879;79;32;2;30;.938;3600000;0
15351;146386;983;0;0;0;0;.00nan;0;0
15351;154414;983;82;50;4;46;.920;3574000;0
15352;6127;878;90;39;2;37;.949;3600000;0
15352;23251;994;0;0;0;0;.00nan;0;0
15352;46905;994;56;37;5;32;.865;3600000;0
15352;146656;878;0;0;0;0;.00nan;0;0
15353;18104;874;0;0;0;0;.00nan;0;0
15353;28701;965;76;34;3;31;.912;3600000;0
15353;43896;874;93;22;0;22;1.000;3600000;0
15353;56306;965;0;0;0;0;.00nan;0;0
15354;8505;978;60;40;5;35;.875;3600000;0
15354;61272;1415;65;31;4;27;.871;3600000;0
15354;62015;978;0;0;0;0;.00nan;0;0
15354;146934;1415;0;0;0;0;.00nan;0;0
15355;779;966;63;33;4;29;.879;3600000;0
15355;7037;966;0;0;0;0;.00nan;0;0
15355;168842;880;33;28;5;23;.821;3600000;0
15355;36136;880;0;0;0;0;.00nan;0;0
15356;23251;994;0;0;0;0;.00nan;0;0
15356;46905;994;73;35;3;32;.914;3600000;0
15356;70099;890;32;20;4;16;.800;3600000;0
15356;157295;890;0;0;0;0;.00nan;0;0
15357;18104;874;52;5;0;5;1.000;293000;0
15357;43896;874;24;27;6;21;.778;3307000;0
15357;61272;1415;87;31;2;29;.935;3600000;0
15357;146934;1415;0;0;0;0;.00nan;0;0
15358;176765;885;36;17;4;13;.765;2333000;0
15358;61999;885;50;9;1;8;.889;1267000;0
15358;146386;983;0;0;0;0;.00nan;0;0
15358;154414;983;100;42;1;41;.976;3600000;0
15359;4219;879;0;0;0;0;.00nan;0;0
15359;6127;878;92;23;0;23;1.000;3600000;0
15359;81792;879;95;38;1;37;.974;3548000;0
15359;146656;878;0;0;0;0;.00nan;0;0
15360;6127;878;61;17;1;16;.941;3600000;0
15360;166514;894;0;0;0;0;.00nan;0;0
15360;62287;894;82;38;2;36;.947;3600000;0
15360;146656;878;0;0;0;0;.00nan;0;0
15361;4487;945;96;34;2;32;.941;3900000;0
15361;23251;994;0;0;0;0;.00nan;0;0
15361;44487;945;0;0;0;0;.00nan;0;0
15361;46905;994;90;35;2;33;.943;3900000;0
15362;61272;1415;91;30;1;29;.967;3545000;0
15362;70099;890;96;24;0;24;1.000;3600000;0
15362;146934;1415;0;0;0;0;.00nan;0;0
15362;157295;890;0;0;0;0;.00nan;0;0
15363;779;966;0;0;0;0;.00nan;0;0
15363;7037;966;71;21;2;19;.905;3600000;0
15363;8505;978;65;37;4;33;.892;3600000;0
15363;62015;978;0;0;0;0;.00nan;0;0
15364;18104;874;0;0;0;0;.00nan;0;0
15364;168842;880;0;0;0;0;.00nan;0;0
15364;36136;880;77;26;1;25;.962;3600000;0
15364;43896;874;28;28;6;22;.786;3600000;0
15365;4219;879;71;25;2;23;.920;3600000;0
15365;28701;965;11;19;6;13;.684;2055000;0
15365;56306;965;58;14;1;13;.929;1545000;0
15365;81792;879;0;0;0;0;.00nan;0;0
15366;4219;879;0;0;0;0;.00nan;0;0
15366;176765;885;0;0;0;0;.00nan;0;0
15366;61999;885;77;28;2;26;.929;3900000;0
15366;81792;879;89;41;2;39;.951;3900000;0
15367;28701;965;0;0;0;0;.00nan;0;0
15367;56306;965;86;25;1;24;.960;3600000;0
15367;146386;983;0;0;0;0;.00nan;0;0
15367;154414;983;87;42;2;40;.952;3594000;0
15368;166514;894;44;35;5;30;.857;3600000;0
15368;61272;1415;67;20;2;18;.900;3600000;0
15368;62287;894;0;0;0;0;.00nan;0;0
15368;146934;1415;0;0;0;0;.00nan;0;0
15369;6127;878;37;14;3;11;.786;3561000;0
15369;8505;978;98;41;1;40;.976;3600000;0
15369;62015;978;0;0;0;0;.00nan;0;0
15369;146656;878;0;0;0;0;.00nan;0;0
15370;168842;880;55;24;3;21;.875;3544000;0
15370;23251;994;0;0;0;0;.00nan;0;0
15370;36136;880;0;0;0;0;.00nan;0;0
15370;46905;994;79;30;2;28;.933;3600000;0
15371;4487;945;65;47;6;41;.872;3600000;0
15371;18104;874;0;0;0;0;.00nan;0;0
15371;43896;874;64;26;3;23;.885;3600000;0
15371;44487;945;0;0;0;0;.00nan;0;0
15372;168842;880;0;0;0;0;.00nan;0;0
15372;23251;994;86;36;2;34;.944;3600000;0
15372;36136;880;65;35;4;31;.886;3576000;0
15372;46905;994;0;0;0;0;.00nan;0;0
15373;6127;878;0;0;0;0;.00nan;0;0
15373;61272;1415;50;1;0;1;1.000;487000;0
15373;146656;878;75;31;3;28;.903;3600000;0
15373;146934;1415;21;27;6;21;.778;3113000;0
15374;779;966;0;0;0;0;.00nan;0;0
15374;7037;966;67;32;3;29;.906;3900000;0
15374;18104;874;0;0;0;0;.00nan;0;0
15374;43896;874;56;31;3;28;.903;3900000;0
15375;28701;965;61;47;6;41;.872;3600000;0
15375;176765;885;59;13;1;12;.923;3600000;0
15375;56306;965;0;0;0;0;.00nan;0;0
15375;61999;885;0;0;0;0;.00nan;0;0
15376;4487;945;57;39;6;33;.846;3349000;0
15376;168842;880;63;25;2;23;.920;3600000;0
15376;36136;880;0;0;0;0;.00nan;0;0
15376;44487;945;51;3;0;3;1.000;251000;0
15377;6127;878;88;35;2;33;.943;3547000;0
15377;70099;890;88;29;1;28;.966;3600000;0
15377;146656;878;0;0;0;0;.00nan;0;0
15377;157295;890;0;0;0;0;.00nan;0;0
15378;61272;1415;100;31;1;30;.968;3600000;0
15378;146386;983;0;0;0;0;.00nan;0;0
15378;146934;1415;0;0;0;0;.00nan;0;0
15378;154414;983;74;37;4;33;.892;3600000;0
15379;8505;978;68;26;2;24;.923;3600000;0
15379;23251;994;58;13;1;12;.923;1534000;0
15379;46905;994;42;25;5;20;.800;2066000;0
15379;62015;978;0;0;0;0;.00nan;0;0
15380;4219;879;0;0;0;0;.00nan;0;0
15380;166514;894;0;0;0;0;.00nan;0;0
15380;37414;879;87;17;0;17;1.000;3600000;0
15380;62287;894;69;40;5;35;.875;3600000;0
15381;168842;880;82;34;3;31;.912;3900000;0
15381;36136;880;0;0;0;0;.00nan;0;0
15381;70099;890;48;23;3;20;.870;3900000;0
15381;157295;890;0;0;0;0;.00nan;0;0
15382;6127;878;100;32;0;32;1.000;3600000;0
15382;176765;885;67;26;2;24;.923;3523000;0
15382;61999;885;0;0;0;0;.00nan;0;0
15382;146656;878;0;0;0;0;.00nan;0;0
15383;4219;879;0;0;0;0;.00nan;0;0
15383;37414;879;74;33;2;31;.939;3600000;0
15383;61272;1415;54;28;3;25;.893;3549000;0
15383;146934;1415;0;0;0;0;.00nan;0;0
15384;23251;994;0;0;0;0;.00nan;0;0
15384;28701;965;49;28;4;24;.857;3526000;0
15384;46905;994;81;28;2;26;.929;3600000;0
15384;56306;965;0;0;0;0;.00nan;0;0
15385;779;966;0;0;0;0;.00nan;0;0
15385;7037;966;60;25;2;23;.920;3600000;0
15385;166514;894;0;0;0;0;.00nan;0;0
15385;62287;894;51;26;3;23;.885;3596000;0
15386;8505;978;89;39;1;38;.974;3600000;0
15386;14873;874;0;0;0;0;.00nan;0;0
15386;43896;874;41;29;5;24;.828;3600000;0
15386;62015;978;0;0;0;0;.00nan;0;0
15387;4487;945;97;29;1;28;.966;3600000;0
15387;44487;945;0;0;0;0;.00nan;0;0
15387;146386;983;0;0;0;0;.00nan;0;0
15387;154414;983;68;25;2;23;.920;3573000;0
15388;779;966;29;27;6;21;.778;3600000;0
15388;6127;878;96;37;1;36;.973;3600000;0
15388;7037;966;0;0;0;0;.00nan;0;0
15388;146656;878;0;0;0;0;.00nan;0;0
15389;4219;879;0;0;0;0;.00nan;0;0
15389;168842;880;0;0;0;0;.00nan;0;0
15389;36136;880;84;24;1;23;.958;3684000;0
15389;37414;879;100;31;0;31;1.000;3684000;0
15390;166514;894;0;0;0;0;.00nan;0;0
15390;176765;885;44;21;4;17;.810;3619000;0
15390;61999;885;0;0;0;0;.00nan;0;0
15390;62287;894;74;35;3;32;.914;3619000;0
15391;4487;945;97;37;1;36;.973;3589000;0
15391;8505;978;91;24;0;24;1.000;3600000;0
15391;44487;945;0;0;0;0;.00nan;0;0
15391;62015;978;0;0;0;0;.00nan;0;0
15392;28701;965;86;39;3;36;.923;3900000;0
15392;56306;965;0;0;0;0;.00nan;0;0
15392;70099;890;50;27;3;24;.889;3900000;0
15392;157295;890;0;0;0;0;.00nan;0;0
15393;23251;994;68;37;4;33;.892;3600000;0
15393;46905;994;0;0;0;0;.00nan;0;0
15393;146386;983;0;0;0;0;.00nan;0;0
15393;154414;983;91;33;2;31;.939;3600000;0
15394;6127;878;73;21;1;20;.952;3600000;0
15394;28701;965;85;38;3;35;.921;3536000;0
15394;56306;965;0;0;0;0;.00nan;0;0
15394;146656;878;0;0;0;0;.00nan;0;0
15395;4487;945;57;23;3;20;.870;3560000;0
15395;20645;1415;0;0;0;0;.00nan;0;0
15395;44487;945;0;0;0;0;.00nan;0;0
15395;61272;1415;84;30;2;28;.933;3600000;0
15396;166514;894;0;0;0;0;.00nan;0;0
15396;62287;894;52;32;3;29;.906;3900000;0
15396;146386;983;0;0;0;0;.00nan;0;0
15396;154414;983;70;30;3;27;.900;3900000;0
15397;8505;978;98;25;0;25;1.000;3600000;0
15397;168842;880;0;0;0;0;.00nan;0;0
15397;36136;880;54;30;4;26;.867;3600000;0
15397;62015;978;0;0;0;0;.00nan;0;0
15398;779;966;0;0;0;0;.00nan;0;0
15398;4219;879;0;0;0;0;.00nan;0;0
15398;7037;966;74;33;2;31;.939;3900000;0
15398;37414;879;68;27;2;25;.926;3900000;0
15399;18104;874;74;30;2;28;.933;3600000;0
15399;176765;885;68;34;4;30;.882;3564000;0
15399;43896;874;0;0;0;0;.00nan;0;0
15399;61999;885;0;0;0;0;.00nan;0;0
15400;8505;978;61;23;2;21;.913;3549000;0
15400;62015;978;0;0;0;0;.00nan;0;0
15400;146386;983;92;31;1;30;.968;3600000;0
15400;154414;983;0;0;0;0;.00nan;0;0
15401;20645;1415;0;0;0;0;.00nan;0;0
15401;176765;885;0;0;0;0;.00nan;0;0
15401;61272;1415;69;36;4;32;.889;3600000;0
15401;61999;885;63;19;1;18;.947;3600000;0
15402;779;966;59;21;2;19;.905;3600000;0
15402;4487;945;0;0;0;0;.00nan;0;0
15402;7037;966;0;0;0;0;.00nan;0;0
15402;44487;945;87;43;3;40;.930;3595000;0
15403;166514;894;0;0;0;0;.00nan;0;0
15403;28701;965;0;0;0;0;.00nan;0;0
15403;56306;965;49;26;4;22;.846;3527000;0
15403;62287;894;65;26;2;24;.923;3600000;0
15404;18104;874;0;0;0;0;.00nan;0;0
15404;23251;994;0;0;0;0;.00nan;0;0
15404;43896;874;76;33;2;31;.939;3600000;0
15404;46905;994;72;40;4;36;.900;3568000;0
15405;4219;879;0;0;0;0;.00nan;0;0
15405;37414;879;73;23;1;22;.957;3600000;0
15405;70099;890;54;35;5;30;.857;3600000;0
15405;157295;890;0;0;0;0;.00nan;0;0
15406;6127;878;92;36;1;35;.972;3600000;0
15406;168842;880;79;32;2;30;.938;3600000;0
15406;36136;880;0;0;0;0;.00nan;0;0
15406;146656;878;0;0;0;0;.00nan;0;0
15407;176765;885;71;27;2;25;.926;3544000;0
15407;61999;885;0;0;0;0;.00nan;0;0
15407;70099;890;72;23;1;22;.957;3600000;0
15407;157295;890;0;0;0;0;.00nan;0;0
15408;168842;880;80;26;2;24;.923;3589000;0
15408;36136;880;0;0;0;0;.00nan;0;0
15408;146386;983;0;0;0;0;.00nan;0;0
15408;154414;983;92;32;1;31;.969;3600000;0
15409;4219;879;0;0;0;0;.00nan;0;0
15409;4487;945;88;26;2;24;.923;3600000;0
15409;37414;879;63;27;3;24;.889;3600000;0
15409;44487;945;0;0;0;0;.00nan;0;0
15410;20645;1415;0;0;0;0;.00nan;0;0
15410;28701;965;67;26;3;23;.885;3552000;0
15410;56306;965;0;0;0;0;.00nan;0;0
15410;61272;1415;90;29;1;28;.966;3600000;0
15411;166514;894;0;0;0;0;.00nan;0;0
15411;62287;894;65;20;1;19;.950;3600000;0
15411;70099;890;49;29;4;25;.862;3600000;0
15411;157295;890;0;0;0;0;.00nan;0;0
15412;8505;978;69;40;4;36;.900;3521000;0
15412;176765;885;57;20;2;18;.900;3600000;0
15412;61999;885;0;0;0;0;.00nan;0;0
15412;62015;978;0;0;0;0;.00nan;0;0
15413;779;966;0;0;0;0;.00nan;0;0
15413;7037;966;63;27;3;24;.889;3841000;0
15413;23251;994;88;46;4;42;.913;3841000;0
15413;46905;994;0;0;0;0;.00nan;0;0
15414;6127;878;68;26;2;24;.923;3600000;0
15414;18104;874;42;3;1;2;.667;289000;0
15414;43896;874;24;26;6;20;.769;3311000;0
15414;146656;878;0;0;0;0;.00nan;0;0
15415;176765;885;66;25;2;23;.920;3600000;0
15415;61999;885;0;0;0;0;.00nan;0;0
15415;146386;983;0;0;0;0;.00nan;0;0
15415;154414;983;49;29;4;25;.862;3600000;0
15416;4487;945;26;28;6;22;.786;2141000;0
15416;6127;878;70;16;1;15;.938;3600000;0
15416;44487;945;71;21;1;20;.952;1459000;0
15416;146656;878;0;0;0;0;.00nan;0;0
15417;18104;874;72;25;1;24;.960;3686000;0
15417;43896;874;25;6;3;3;.500;214000;0
15417;70099;890;48;27;4;23;.852;3900000;0
15417;157295;890;0;0;0;0;.00nan;0;0
15418;20645;1415;0;0;0;0;.00nan;0;0
15418;23251;994;0;0;0;0;.00nan;0;0
15418;46905;994;63;39;4;35;.897;3514000;0
15418;61272;1415;64;17;2;15;.882;3600000;0
15419;779;966;84;13;0;13;1.000;3600000;0
15419;7037;966;0;0;0;0;.00nan;0;0
15419;28701;965;73;47;4;43;.915;3600000;0
15419;56306;965;0;0;0;0;.00nan;0;0
15420;166514;894;0;0;0;0;.00nan;0;0
15420;168842;880;84;35;2;33;.943;3600000;0
15420;36136;880;0;0;0;0;.00nan;0;0
15420;62287;894;63;28;3;25;.893;3577000;0
15421;4219;879;0;0;0;0;.00nan;0;0
15421;8505;978;73;26;2;24;.923;3628000;0
15421;37414;879;73;28;3;25;.893;3628000;0
15421;62015;978;0;0;0;0;.00nan;0;0
15422;779;966;0;0;0;0;.00nan;0;0
15422;7037;966;90;26;1;25;.962;3600000;0
15422;176765;885;0;0;0;0;.00nan;0;0
15422;61999;885;78;39;3;36;.923;3562000;0
15423;6127;878;53;18;3;15;.833;3600000;0
15423;146386;983;0;0;0;0;.00nan;0;0
15423;146656;878;0;0;0;0;.00nan;0;0
15423;154414;983;54;42;5;37;.881;3588000;0
15424;4487;945;87;35;2;33;.943;3573000;0
15424;44487;945;0;0;0;0;.00nan;0;0
15424;70099;890;83;30;1;29;.967;3600000;0
15424;157295;890;0;0;0;0;.00nan;0;0
15425;8505;978;81;30;2;28;.933;3900000;0
15425;28701;965;84;26;2;24;.923;3900000;0
15425;56306;965;0;0;0;0;.00nan;0;0
15425;62015;978;0;0;0;0;.00nan;0;0
15426;168842;880;0;0;0;0;.00nan;0;0
15426;20645;1415;0;0;0;0;.00nan;0;0
15426;36136;880;77;24;1;23;.958;3600000;0
15426;61272;1415;76;36;2;34;.944;3554000;0
15427;4219;879;0;0;0;0;.00nan;0;0
15427;18104;874;0;0;0;0;.00nan;0;0
15427;37414;879;72;19;1;18;.947;3600000;0
15427;43896;874;95;44;2;42;.955;3556000;0
15428;779;966;76;20;2;18;.900;3900000;0
15428;7037;966;0;0;0;0;.00nan;0;0
15428;146386;983;0;0;0;0;.00nan;0;0
15428;154414;983;78;34;2;32;.941;3900000;0
15429;4487;945;0;0;0;0;.00nan;0;0
15429;176765;885;78;30;2;28;.933;3585000;0
15429;44487;945;98;19;0;19;1.000;3600000;0
15429;61999;885;0;0;0;0;.00nan;0;0
15430;6127;878;40;30;5;25;.833;3899000;0
15430;20645;1415;0;0;0;0;.00nan;0;0
15430;61272;1415;50;34;5;29;.853;3900000;0
15430;146656;878;0;0;0;0;.00nan;0;0
15431;168842;880;92;21;0;21;1.000;3600000;0
15431;28701;965;60;40;6;34;.850;3145000;0
15431;36136;880;0;0;0;0;.00nan;0;0
15431;56306;965;53;3;0;3;1.000;455000;0
15432;166514;894;0;0;0;0;.00nan;0;0
15432;18104;874;0;0;0;0;.00nan;0;0
15432;43896;874;63;13;1;12;.923;3600000;0
15432;62287;894;87;50;3;47;.940;3578000;0
15433;8505;978;0;0;0;0;.00nan;0;0
15433;62015;978;96;37;1;36;.973;3900000;0
15433;70099;890;91;23;1;22;.957;3900000;0
15433;157295;890;0;0;0;0;.00nan;0;0
15434;4219;879;0;0;0;0;.00nan;0;0
15434;23251;994;96;71;1;70;.986;3900000;0
15434;37414;879;72;22;1;21;.955;3900000;0
15434;46905;994;0;0;0;0;.00nan;0;0
15435;166514;894;0;0;0;0;.00nan;0;0
15435;62287;894;65;22;2;20;.909;3600000;0
15435;146386;983;0;0;0;0;.00nan;0;0
15435;154414;983;100;45;1;44;.978;3600000;0
15436;168842;880;54;26;4;22;.846;3900000;0
15436;176765;885;72;40;4;36;.900;3900000;0
15436;36136;880;0;0;0;0;.00nan;0;0
15436;61999;885;0;0;0;0;.00nan;0;0
15437;18104;874;0;0;0;0;.00nan;0;0
15437;43896;874;73;34;3;31;.912;3892000;0
15437;70099;890;69;41;4;37;.902;3892000;0
15437;157295;890;0;0;0;0;.00nan;0;0
15438;8505;978;81;26;1;25;.962;3600000;0
15438;23251;994;0;0;0;0;.00nan;0;0
15438;46905;994;47;38;5;33;.868;3600000;0
15438;62015;978;0;0;0;0;.00nan;0;0
15439;4487;945;0;0;0;0;.00nan;0;0
15439;28701;965;76;22;1;21;.955;3600000;0
15439;44487;945;59;35;5;30;.857;3600000;0
15439;56306;965;0;0;0;0;.00nan;0;0
15440;779;966;0;0;0;0;.00nan;0;0
15440;7037;966;92;32;1;31;.969;3600000;0
15440;20645;1415;0;0;0;0;.00nan;0;0
15440;61272;1415;38;30;6;24;.800;3600000;0
15441;4487;945;62;35;4;31;.886;3600000;0
15441;176765;885;0;0;0;0;.00nan;0;0
15441;44487;945;0;0;0;0;.00nan;0;0
15441;61999;885;14;22;6;16;.727;3514000;0
15442;6127;878;56;31;4;27;.871;3600000;0
15442;8505;978;45;34;6;28;.824;2845000;0
15442;62015;978;44;4;1;3;.750;755000;0
15442;146656;878;0;0;0;0;.00nan;0;0
15443;28701;965;61;36;4;32;.889;3600000;0
15443;56306;965;0;0;0;0;.00nan;0;0
15443;70099;890;0;0;0;0;.00nan;0;0
15443;157295;890;62;22;2;20;.909;3600000;0
15444;779;966;60;12;1;11;.917;3600000;0
15444;7037;966;0;0;0;0;.00nan;0;0
15444;146386;983;0;0;0;0;.00nan;0;0
15444;154414;983;82;36;2;34;.944;3560000;0
15445;4219;879;0;0;0;0;.00nan;0;0
15445;166514;894;0;0;0;0;.00nan;0;0
15445;37414;879;67;17;1;16;.941;3600000;0
15445;62287;894;76;47;5;42;.894;3600000;0
15446;70099;890;70;22;1;21;.955;3600000;0
15446;146386;983;64;10;0;10;1.000;954000;0
15446;154414;983;28;27;6;21;.778;2646000;0
15446;157295;890;0;0;0;0;.00nan;0;0
15447;779;966;0;0;0;0;.00nan;0;0
15447;4487;945;81;54;5;49;.907;3600000;0
15447;7037;966;67;15;1;14;.933;3600000;0
15447;44487;945;0;0;0;0;.00nan;0;0
15448;4219;879;0;0;0;0;.00nan;0;0
15448;28701;965;0;0;0;0;.00nan;0;0
15448;37414;879;58;17;3;14;.824;3896000;0
15448;56306;965;79;37;2;35;.946;3896000;0
15449;166514;894;76;36;2;34;.944;3798000;0
15449;20645;1415;0;0;0;0;.00nan;0;0
15449;61272;1415;46;19;3;16;.842;3798000;0
15449;62287;894;0;0;0;0;.00nan;0;0
15450;8505;978;80;27;1;26;.963;3600000;0
15450;18104;874;50;24;3;21;.875;2619000;0
15450;43896;874;24;11;4;7;.636;981000;0
15450;62015;978;0;0;0;0;.00nan;0;0
15451;6127;878;70;18;1;17;.944;3600000;0
15451;168842;880;75;39;3;36;.923;3536000;0
15451;36136;880;0;0;0;0;.00nan;0;0
15451;146656;878;0;0;0;0;.00nan;0;0
15452;6127;878;0;0;0;0;.00nan;0;0
15452;28701;965;92;34;1;33;.971;3600000;0
15452;56306;965;0;0;0;0;.00nan;0;0
15452;146656;878;55;19;2;17;.895;3586000;0
15453;168842;880;83;38;3;35;.921;3548000;0
15453;36136;880;0;0;0;0;.00nan;0;0
15453;70099;890;80;33;2;31;.939;3600000;0
15453;157295;890;0;0;0;0;.00nan;0;0
15454;8505;978;61;30;3;27;.900;3532000;0
15454;20645;1415;80;22;1;21;.955;3600000;0
15454;61272;1415;0;0;0;0;.00nan;0;0
15454;62015;978;0;0;0;0;.00nan;0;0
15455;779;966;72;33;3;30;.909;3900000;0
15455;7037;966;0;0;0;0;.00nan;0;0
15455;166514;894;0;0;0;0;.00nan;0;0
15455;62287;894;99;54;3;51;.944;3900000;0
15456;23251;994;0;0;0;0;.00nan;0;0
15456;176765;885;0;0;0;0;.00nan;0;0
15456;46905;994;91;39;2;37;.949;3545000;0
15456;61999;885;72;22;1;21;.955;3600000;0
15457;4219;879;0;0;0;0;.00nan;0;0
15457;37414;879;80;42;3;39;.929;3600000;0
15457;146386;983;0;0;0;0;.00nan;0;0
15457;154414;983;64;14;1;13;.929;3600000;0
15458;4487;945;66;41;5;36;.878;3900000;0
15458;18104;874;41;24;5;19;.792;3900000;0
15458;43896;874;0;0;0;0;.00nan;0;0
15458;44487;945;0;0;0;0;.00nan;0;0
15459;23251;994;100;33;1;32;.970;3600000;0
15459;176765;885;52;36;5;31;.861;3600000;0
15459;46905;994;0;0;0;0;.00nan;0;0
15459;61999;885;0;0;0;0;.00nan;0;0
15460;779;966;0;0;0;0;.00nan;0;0
15460;7037;966;52;25;4;21;.840;3887000;0
15460;70099;890;72;42;4;38;.905;3900000;0
15460;157295;890;0;0;0;0;.00nan;0;0
15461;20645;1415;0;0;0;0;.00nan;0;0
15461;61272;1415;52;18;3;15;.833;3600000;0
15461;146386;983;70;35;4;31;.886;3545000;0
15461;154414;983;0;0;0;0;.00nan;0;0
15462;4219;879;0;0;0;0;.00nan;0;0
15462;176765;885;82;29;1;28;.966;3600000;0
15462;37414;879;68;27;2;25;.926;3564000;0
15462;61999;885;0;0;0;0;.00nan;0;0
15463;4487;945;0;0;0;0;.00nan;0;0
15463;166514;894;0;0;0;0;.00nan;0;0
15463;44487;945;50;33;5;28;.848;3600000;0
15463;62287;894;55;32;4;28;.875;3600000;0
15464;8505;978;78;26;1;25;.962;3558000;0
15464;62015;978;0;0;0;0;.00nan;0;0
15464;70099;890;88;18;0;18;1.000;3600000;0
15464;157295;890;0;0;0;0;.00nan;0;0
15465;779;966;72;37;3;34;.919;3900000;0
15465;7037;966;0;0;0;0;.00nan;0;0
15465;168842;880;82;37;3;34;.919;3900000;0
15465;36136;880;0;0;0;0;.00nan;0;0
15466;6127;878;73;21;2;19;.905;3600000;0
15466;23251;994;26;38;8;30;.789;3342000;0
15466;46905;994;40;3;1;2;.667;258000;0
15466;146656;878;0;0;0;0;.00nan;0;0
15467;18104;874;0;0;0;0;.00nan;0;0
15467;28701;965;59;37;5;32;.865;3600000;0
15467;43896;874;50;15;3;12;.800;3600000;0
15467;56306;965;0;0;0;0;.00nan;0;0
15468;4219;879;0;0;0;0;.00nan;0;0
15468;20645;1415;79;29;1;28;.966;3600000;0
15468;37414;879;47;23;4;19;.826;3600000;0
15468;61272;1415;0;0;0;0;.00nan;0;0
15469;18104;874;0;0;0;0;.00nan;0;0
15469;43896;874;70;27;3;24;.889;3900000;0
15469;70099;890;69;39;3;36;.923;3900000;0
15469;157295;890;0;0;0;0;.00nan;0;0
15470;23251;994;49;31;4;27;.871;3600000;0
15470;46905;994;0;0;0;0;.00nan;0;0
15470;146386;983;0;0;0;0;.00nan;0;0
15470;154414;983;76;21;1;20;.952;3600000;0
15471;779;966;0;0;0;0;.00nan;0;0
15471;7037;966;63;36;4;32;.889;3713000;0
15471;176765;885;61;28;3;25;.893;3713000;0
15471;61999;885;0;0;0;0;.00nan;0;0
15472;6127;878;67;32;3;29;.906;3900000;0
15472;18104;874;0;0;0;0;.00nan;0;0
15472;43896;874;57;24;3;21;.875;3900000;0
15472;146656;878;0;0;0;0;.00nan;0;0
15473;4487;945;77;25;2;23;.920;3600000;0
15473;28701;965;78;41;3;38;.927;3561000;0
15473;44487;945;0;0;0;0;.00nan;0;0
15473;56306;965;0;0;0;0;.00nan;0;0
15474;166514;894;90;33;1;32;.970;3900000;0
15474;62287;894;0;0;0;0;.00nan;0;0
15474;70099;890;86;26;1;25;.962;3900000;0
15474;157295;890;0;0;0;0;.00nan;0;0
15475;8505;978;41;26;5;21;.808;3600000;0
15475;168842;880;83;36;2;34;.944;3600000;0
15475;36136;880;0;0;0;0;.00nan;0;0
15475;62015;978;0;0;0;0;.00nan;0;0
15476;4487;945;67;31;3;28;.903;3532000;0
15476;44487;945;0;0;0;0;.00nan;0;0
15476;146386;983;0;0;0;0;.00nan;0;0
15476;154414;983;78;28;1;27;.964;3600000;0
15477;6127;878;100;24;0;24;1.000;3600000;0
15477;20645;1415;0;0;0;0;.00nan;0;0
15477;61272;1415;69;38;5;33;.868;3600000;0
15477;146656;878;0;0;0;0;.00nan;0;0
15478;8505;978;51;24;4;20;.833;3573000;0
15478;166514;894;0;0;0;0;.00nan;0;0
15478;62015;978;0;0;0;0;.00nan;0;0
15478;62287;894;97;43;2;41;.953;3600000;0
15479;779;966;0;0;0;0;.00nan;0;0
15479;4219;879;0;0;0;0;.00nan;0;0
15479;7037;966;98;24;0;24;1.000;3600000;0
15479;37414;879;91;27;1;26;.963;3543000;0
15480;23251;994;84;32;1;31;.969;3600000;0
15480;28701;965;7;19;6;13;.684;2142000;0
15480;46905;994;0;0;0;0;.00nan;0;0
15480;56306;965;63;14;1;13;.929;1458000;0
15481;18104;874;0;0;0;0;.00nan;0;0
15481;168842;880;69;34;3;31;.912;3900000;0
15481;36136;880;0;0;0;0;.00nan;0;0
15481;43896;874;63;31;3;28;.903;3900000;0
15482;176765;885;29;21;5;16;.762;3195000;0
15482;61999;885;49;1;0;1;1.000;405000;0
15482;70099;890;72;31;2;29;.935;3600000;0
15482;157295;890;0;0;0;0;.00nan;0;0
15483;8505;978;46;33;5;28;.848;3600000;0
15483;20645;1415;63;32;3;29;.906;3090000;0
15483;61272;1415;29;8;3;5;.625;457000;0
15483;62015;978;0;0;0;0;.00nan;0;0
15484;168842;880;76;30;3;27;.900;3900000;0
15484;36136;880;0;0;0;0;.00nan;0;0
15484;146386;983;0;0;0;0;.00nan;0;0
15484;154414;983;66;37;3;34;.919;3900000;0
15485;6127;878;26;15;4;11;.733;3600000;0
15485;70099;890;71;37;3;34;.919;3600000;0
15485;146656;878;0;0;0;0;.00nan;0;0
15485;157295;890;0;0;0;0;.00nan;0;0
15486;4219;879;0;0;0;0;.00nan;0;0
15486;4487;945;70;37;4;33;.892;3600000;0
15486;37414;879;80;29;2;27;.931;3600000;0
15486;44487;945;0;0;0;0;.00nan;0;0
15487;20645;1415;0;0;0;0;.00nan;0;0
15487;28701;965;98;62;4;58;.935;3600000;0
15487;56306;965;0;0;0;0;.00nan;0;0
15487;61272;1415;76;22;1;21;.955;3600000;0
15488;166514;894;0;0;0;0;.00nan;0;0
15488;176765;885;65;35;4;31;.886;3600000;0
15488;61999;885;0;0;0;0;.00nan;0;0
15488;62287;894;74;30;2;28;.933;3600000;0
15489;18104;874;56;27;3;24;.889;3600000;0
15489;23251;994;69;40;4;36;.900;3600000;0
15489;43896;874;0;0;0;0;.00nan;0;0
15489;46905;994;0;0;0;0;.00nan;0;0
15490;6127;878;62;33;4;29;.879;3543000;0
15490;176765;885;90;44;3;41;.932;3600000;0
15490;61999;885;0;0;0;0;.00nan;0;0
15490;146656;878;0;0;0;0;.00nan;0;0
15491;779;966;78;18;1;17;.944;3600000;0
15491;7037;966;0;0;0;0;.00nan;0;0
15491;28701;965;92;57;4;53;.930;3600000;0
15491;56306;965;0;0;0;0;.00nan;0;0
15492;8505;978;75;28;3;25;.893;3600000;0
15492;166514;894;29;26;5;21;.808;3521000;0
15492;62015;978;0;0;0;0;.00nan;0;0
15492;62287;894;0;0;0;0;.00nan;0;0
15493;4487;945;86;42;3;39;.929;3900000;0
15493;168842;880;68;32;3;29;.906;3900000;0
15493;36136;880;0;0;0;0;.00nan;0;0
15493;44487;945;0;0;0;0;.00nan;0;0
15494;20645;1415;0;0;0;0;.00nan;0;0
15494;23251;994;58;39;5;34;.872;3600000;0
15494;46905;994;0;0;0;0;.00nan;0;0
15494;61272;1415;78;28;2;26;.929;3600000;0
15495;18104;874;0;0;0;0;.00nan;0;0
15495;37414;879;78;24;1;23;.958;3600000;0
15495;43896;874;69;36;3;33;.917;3544000;0
15495;148956;879;0;0;0;0;.00nan;0;0
15496;779;966;42;34;6;28;.824;3581000;0
15496;7037;966;0;0;0;0;.00nan;0;0
15496;18104;874;52;32;4;28;.875;3600000;0
15496;43896;874;0;0;0;0;.00nan;0;0
15497;70099;890;78;29;2;27;.931;3600000;0
15497;146386;983;35;22;4;18;.818;3521000;0
15497;154414;983;0;0;0;0;.00nan;0;0
15497;157295;890;0;0;0;0;.00nan;0;0
15498;4487;945;0;0;0;0;.00nan;0;0
15498;8505;978;57;42;5;37;.881;3516000;0
15498;44487;945;78;41;3;38;.927;3600000;0
15498;62015;978;0;0;0;0;.00nan;0;0
15499;28701;965;94;34;1;33;.971;3600000;0
15499;56306;965;0;0;0;0;.00nan;0;0
15499;146386;983;0;0;0;0;.00nan;0;0
15499;154414;983;65;43;4;39;.907;3600000;0
15500;20645;1415;0;0;0;0;.00nan;0;0
15500;61272;1415;41;28;5;23;.821;3900000;0
15500;70099;890;39;28;5;23;.821;3900000;0
15500;157295;890;0;0;0;0;.00nan;0;0
15501;779;966;91;39;2;37;.949;3600000;0
15501;6127;878;86;35;2;33;.943;3551000;0
15501;7037;966;0;0;0;0;.00nan;0;0
15501;146656;878;0;0;0;0;.00nan;0;0
15502;168842;880;67;38;4;34;.895;3567000;0
15502;176765;885;83;29;2;27;.931;3600000;0
15502;36136;880;0;0;0;0;.00nan;0;0
15502;61999;885;0;0;0;0;.00nan;0;0
15503;23251;994;86;50;5;45;.900;3600000;0
15503;37414;879;55;23;3;20;.870;3600000;0
15503;46905;994;0;0;0;0;.00nan;0;0
15503;148956;879;0;0;0;0;.00nan;0;0
15504;166514;894;0;0;0;0;.00nan;0;0
15504;18104;874;0;0;0;0;.00nan;0;0
15504;43896;874;41;20;3;17;.850;3900000;0
15504;62287;894;100;60;3;57;.950;3878000;0
15505;4487;945;63;27;3;24;.889;3569000;0
15505;44487;945;0;0;0;0;.00nan;0;0
15505;70099;890;78;27;2;25;.926;3600000;0
15505;157295;890;0;0;0;0;.00nan;0;0
15506;18104;874;0;0;0;0;.00nan;0;0
15506;176765;885;85;30;1;29;.967;3900000;0
15506;43896;874;100;44;1;43;.977;3900000;0
15506;61999;885;0;0;0;0;.00nan;0;0
15507;6127;878;0;0;0;0;.00nan;0;0
15507;37414;879;57;28;4;24;.857;3600000;0
15507;146656;878;84;27;1;26;.963;3600000;0
15507;148956;879;0;0;0;0;.00nan;0;0
15508;166514;894;0;0;0;0;.00nan;0;0
15508;28701;965;75;29;2;27;.931;3546000;0
15508;56306;965;0;0;0;0;.00nan;0;0
15508;62287;894;69;19;1;18;.947;3600000;0
15509;8505;978;67;22;2;20;.909;3600000;0
15509;62015;978;0;0;0;0;.00nan;0;0
15509;146386;983;0;0;0;0;.00nan;0;0
15509;154414;983;71;46;5;41;.891;3600000;0
15510;779;966;61;21;2;19;.905;3900000;0
15510;7037;966;0;0;0;0;.00nan;0;0
15510;23251;994;0;0;0;0;.00nan;0;0
15510;46905;994;75;36;2;34;.944;3900000;0
15511;168842;880;61;29;3;26;.897;3899000;0
15511;20645;1415;0;0;0;0;.00nan;0;0
15511;36136;880;0;0;0;0;.00nan;0;0
15511;61272;1415;78;37;3;34;.919;3900000;0
15512;6127;878;42;26;4;22;.846;3559000;0
15512;146386;983;0;0;0;0;.00nan;0;0
15512;146656;878;0;0;0;0;.00nan;0;0
15512;154414;983;67;35;3;32;.914;3600000;0
15513;23251;994;75;32;2;30;.938;3600000;0
15513;46905;994;0;0;0;0;.00nan;0;0
15513;70099;890;65;29;3;26;.897;3553000;0
15513;157295;890;0;0;0;0;.00nan;0;0
15514;8505;978;83;29;2;27;.931;3600000;0
15514;37414;879;67;36;4;32;.889;3557000;0
15514;62015;978;0;0;0;0;.00nan;0;0
15514;148956;879;0;0;0;0;.00nan;0;0
15515;28701;965;62;45;5;40;.889;3600000;0
15515;176765;885;48;7;1;6;.857;633000;0
15515;56306;965;0;0;0;0;.00nan;0;0
15515;61999;885;41;33;6;27;.818;2967000;0
15516;4487;945;63;35;4;31;.886;3900000;0
15516;20645;1415;0;0;0;0;.00nan;0;0
15516;44487;945;0;0;0;0;.00nan;0;0
15516;61272;1415;91;46;4;42;.913;3900000;0
15517;166514;894;0;0;0;0;.00nan;0;0
15517;168842;880;80;27;1;26;.963;3600000;0
15517;36136;880;0;0;0;0;.00nan;0;0
15517;62287;894;67;36;4;32;.889;3600000;0
15518;4487;945;62;32;3;29;.906;3549000;0
15518;6127;878;65;21;2;19;.905;3600000;0
15518;44487;945;0;0;0;0;.00nan;0;0
15518;146656;878;0;0;0;0;.00nan;0;0
15519;37414;879;60;21;2;19;.905;3582000;0
15519;70099;890;97;34;1;33;.971;3600000;0
15519;148956;879;0;0;0;0;.00nan;0;0
15519;157295;890;0;0;0;0;.00nan;0;0
15520;779;966;39;15;3;12;.800;3600000;0
15520;7037;966;0;0;0;0;.00nan;0;0
15520;20645;1415;0;0;0;0;.00nan;0;0
15520;61272;1415;70;45;5;40;.889;3544000;0
15521;8505;978;61;30;3;27;.900;3600000;0
15521;176765;885;100;29;0;29;1.000;3600000;0
15521;61999;885;0;0;0;0;.00nan;0;0
15521;62015;978;0;0;0;0;.00nan;0;0
15522;168842;880;56;32;4;28;.875;3600000;0
15522;28701;965;100;29;0;29;1.000;3600000;0
15522;36136;880;0;0;0;0;.00nan;0;0
15522;56306;965;0;0;0;0;.00nan;0;0
15523;18104;874;52;25;3;22;.880;3600000;0
15523;43896;874;0;0;0;0;.00nan;0;0
15523;146386;983;0;0;0;0;.00nan;0;0
15523;154414;983;85;46;4;42;.913;3600000;0
15524;18104;874;0;0;0;0;.00nan;0;0
15524;43896;874;74;19;1;18;.947;3600000;0
15524;146386;983;0;0;0;0;.00nan;0;0
15524;154414;983;59;37;4;33;.892;3600000;0
15525;20645;1415;0;0;0;0;.00nan;0;0
15525;176765;885;61;22;2;20;.909;3600000;0
15525;61272;1415;73;39;3;36;.923;3554000;0
15525;61999;885;0;0;0;0;.00nan;0;0
15526;4487;945;83;31;2;29;.935;3600000;0
15526;23251;994;0;0;0;0;.00nan;0;0
15526;44487;945;0;0;0;0;.00nan;0;0
15526;46905;994;61;41;4;37;.902;3513000;0
15527;8505;978;42;23;4;19;.826;3563000;0
15527;28701;965;90;36;2;34;.944;3600000;0
15527;56306;965;0;0;0;0;.00nan;0;0
15527;62015;978;0;0;0;0;.00nan;0;0
15528;6127;878;56;26;3;23;.885;3600000;0
15528;166514;894;0;0;0;0;.00nan;0;0
15528;62287;894;89;41;2;39;.951;3600000;0
15528;146656;878;0;0;0;0;.00nan;0;0
15529;779;966;74;42;3;39;.929;3900000;0
15529;7037;966;0;0;0;0;.00nan;0;0
15529;70099;890;61;37;3;34;.919;3900000;0
15529;157295;890;0;0;0;0;.00nan;0;0
15530;168842;880;55;40;5;35;.875;3600000;0
15530;36136;880;0;0;0;0;.00nan;0;0
15530;37414;879;0;0;0;0;.00nan;0;0
15530;148956;879;68;18;1;17;.944;3600000;0
15531;168842;880;0;0;0;0;.00nan;0;0
15531;36136;880;84;26;1;25;.962;3600000;0
15531;37414;879;31;29;6;23;.793;3600000;0
15531;148956;879;0;0;0;0;.00nan;0;0
15532;23251;994;56;32;4;28;.875;3581000;0
15532;46905;994;0;0;0;0;.00nan;0;0
15532;70099;890;0;0;0;0;.00nan;0;0
15532;157295;890;67;36;3;33;.917;3600000;0
15533;166514;894;84;29;1;28;.966;3600000;0
15533;62287;894;0;0;0;0;.00nan;0;0
15533;146386;983;51;39;6;33;.846;3600000;0
15533;154414;983;0;0;0;0;.00nan;0;0
15534;779;966;0;0;0;0;.00nan;0;0
15534;7037;966;75;31;2;29;.935;3600000;0
15534;176765;885;62;40;5;35;.875;3600000;0
15534;61999;885;0;0;0;0;.00nan;0;0
15535;6127;878;61;34;4;30;.882;3574000;0
15535;28701;965;0;0;0;0;.00nan;0;0
15535;56306;965;67;32;3;29;.906;3600000;0
15535;146656;878;0;0;0;0;.00nan;0;0
15536;4487;945;41;38;6;32;.842;3600000;0
15536;20645;1415;0;0;0;0;.00nan;0;0
15536;44487;945;0;0;0;0;.00nan;0;0
15536;61272;1415;77;24;1;23;.958;3600000;0
15537;8505;978;18;24;7;17;.708;2802000;0
15537;18104;874;0;0;0;0;.00nan;0;0
15537;43896;874;56;20;3;17;.850;3600000;0
15537;62015;978;58;13;1;12;.923;798000;0
15538;779;966;77;29;2;27;.931;3600000;0
15538;7037;966;0;0;0;0;.00nan;0;0
15538;146386;983;0;0;0;0;.00nan;0;0
15538;154414;983;77;42;4;38;.905;3517000;0
15539;6127;878;0;0;0;0;.00nan;0;0
15539;168842;880;69;33;3;30;.909;3585000;0
15539;36136;880;0;0;0;0;.00nan;0;0
15539;146656;878;82;26;1;25;.962;3600000;0
15540;4487;945;0;0;0;0;.00nan;0;0
15540;44487;945;100;32;0;32;1.000;3600000;0
15540;70099;890;72;27;2;25;.926;3600000;0
15540;157295;890;0;0;0;0;.00nan;0;0
15541;20645;1415;0;0;0;0;.00nan;0;0
15541;176765;885;79;31;2;29;.935;3900000;0
15541;61272;1415;84;36;2;34;.944;3900000;0
15541;61999;885;0;0;0;0;.00nan;0;0
15542;8505;978;55;31;4;27;.871;3600000;0
15542;166514;894;0;0;0;0;.00nan;0;0
15542;62015;978;0;0;0;0;.00nan;0;0
15542;62287;894;42;29;5;24;.828;3587000;0
15543;18104;874;0;0;0;0;.00nan;0;0
15543;23251;994;100;46;2;44;.957;3600000;0
15543;43896;874;46;26;4;22;.846;3584000;0
15543;46905;994;0;0;0;0;.00nan;0;0
15544;28701;965;50;27;5;22;.815;3600000;0
15544;37414;879;100;35;0;35;1.000;3600000;0
15544;56306;965;0;0;0;0;.00nan;0;0
15544;148956;879;0;0;0;0;.00nan;0;0
15545;8505;978;97;46;1;45;.978;3900000;0
15545;176765;885;100;42;1;41;.976;3900000;0
15545;61999;885;0;0;0;0;.00nan;0;0
15545;62015;978;0;0;0;0;.00nan;0;0
15546;6127;878;63;23;3;20;.870;3558000;0
15546;70099;890;99;34;2;32;.941;3600000;0
15546;146656;878;0;0;0;0;.00nan;0;0
15546;157295;890;0;0;0;0;.00nan;0;0
15547;23251;994;62;10;0;10;1.000;1846000;0
15547;28701;965;70;33;3;30;.909;3600000;0
15547;46905;994;17;18;6;12;.667;1754000;0
15547;56306;965;0;0;0;0;.00nan;0;0
15548;4487;945;0;0;0;0;.00nan;0;0
15548;166514;894;0;0;0;0;.00nan;0;0
15548;44487;945;41;23;4;19;.826;3600000;0
15548;62287;894;66;38;5;33;.868;3590000;0
15549;779;966;43;20;3;17;.850;3600000;0
15549;7037;966;0;0;0;0;.00nan;0;0
15549;20645;1415;0;0;0;0;.00nan;0;0
15549;61272;1415;95;57;4;53;.930;3551000;0
15550;168842;880;78;26;1;25;.962;3900000;0
15550;36136;880;0;0;0;0;.00nan;0;0
15550;146386;983;0;0;0;0;.00nan;0;0
15550;154414;983;97;41;1;40;.976;3900000;0
15551;18104;874;63;31;3;28;.903;3600000;0
15551;37414;879;100;41;0;41;1.000;3600000;0
15551;43896;874;0;0;0;0;.00nan;0;0
15551;148956;879;0;0;0;0;.00nan;0;0
15552;4487;945;100;44;1;43;.977;3600000;0
15552;176765;885;0;0;0;0;.00nan;0;0
15552;44487;945;0;0;0;0;.00nan;0;0
15552;61999;885;66;30;2;28;.933;3600000;0
15553;779;966;90;34;2;32;.941;3593000;0
15553;7037;966;0;0;0;0;.00nan;0;0
15553;166514;894;87;31;1;30;.968;3600000;0
15553;62287;894;0;0;0;0;.00nan;0;0
15554;8505;978;0;0;0;0;.00nan;0;0
15554;37414;879;69;28;2;26;.929;3569000;0
15554;62015;978;100;29;0;29;1.000;3600000;0
15554;148956;879;0;0;0;0;.00nan;0;0
15555;23251;994;69;34;3;31;.912;3600000;0
15555;46905;994;0;0;0;0;.00nan;0;0
15555;146386;983;0;0;0;0;.00nan;0;0
15555;154414;983;100;26;0;26;1.000;3600000;0
15556;168842;880;79;32;2;30;.938;3900000;0
15556;28701;965;81;37;2;35;.946;3864000;0
15556;36136;880;0;0;0;0;.00nan;0;0
15556;56306;965;0;0;0;0;.00nan;0;0
15557;166514;894;0;0;0;0;.00nan;0;0
15557;176765;885;89;28;1;27;.964;3600000;0
15557;61999;885;0;0;0;0;.00nan;0;0
15557;62287;894;59;38;5;33;.868;3600000;0
15558;4487;945;61;17;1;16;.941;3600000;0
15558;168842;880;31;27;5;22;.815;3600000;0
15558;36136;880;0;0;0;0;.00nan;0;0
15558;44487;945;0;0;0;0;.00nan;0;0
15559;8505;978;0;0;0;0;.00nan;0;0
15559;62015;978;64;28;3;25;.893;3600000;0
15559;70099;890;63;33;4;29;.879;3571000;0
15559;157295;890;0;0;0;0;.00nan;0;0
15560;20645;1415;0;0;0;0;.00nan;0;0
15560;23251;994;0;0;0;0;.00nan;0;0
15560;46905;994;73;53;6;47;.887;3600000;0
15560;61272;1415;71;29;3;26;.897;3600000;0
15561;779;966;72;26;2;24;.923;3600000;0
15561;7037;966;0;0;0;0;.00nan;0;0
15561;28701;965;79;44;4;40;.909;3522000;0
15561;56306;965;0;0;0;0;.00nan;0;0
15562;6127;878;79;38;3;35;.921;3900000;0
15562;37414;879;90;40;3;37;.925;3900000;0
15562;146656;878;0;0;0;0;.00nan;0;0
15562;148956;879;0;0;0;0;.00nan;0;0
15563;18104;874;0;0;0;0;.00nan;0;0
15563;43896;874;71;29;2;27;.931;3600000;0
15563;146386;983;0;0;0;0;.00nan;0;0
15563;154414;983;57;30;3;27;.900;3562000;0
15564;70099;890;72;19;1;18;.947;3600000;0
15564;146386;983;0;0;0;0;.00nan;0;0
15564;154414;983;91;42;3;39;.929;3574000;0
15564;157295;890;0;0;0;0;.00nan;0;0
15565;6127;878;52;33;5;28;.848;3600000;0
15565;176765;885;92;25;1;24;.960;3600000;0
15565;61999;885;0;0;0;0;.00nan;0;0
15565;146656;878;0;0;0;0;.00nan;0;0
15566;20645;1415;0;0;0;0;.00nan;0;0
15566;28701;965;82;40;4;36;.900;3600000;0
15566;56306;965;0;0;0;0;.00nan;0;0
15566;61272;1415;48;33;5;28;.848;3600000;0
15567;166514;894;0;0;0;0;.00nan;0;0
15567;23251;994;55;31;4;27;.871;3600000;0
15567;46905;994;0;0;0;0;.00nan;0;0
15567;62287;894;85;27;1;26;.963;3600000;0
15568;4487;945;46;29;5;24;.828;3600000;0
15568;8505;978;70;17;2;15;.882;3600000;0
15568;44487;945;0;0;0;0;.00nan;0;0
15568;62015;978;0;0;0;0;.00nan;0;0
15569;18104;874;0;0;0;0;.00nan;0;0
15569;168842;880;98;53;2;51;.962;3600000;0
15569;36136;880;0;0;0;0;.00nan;0;0
15569;43896;874;32;16;4;12;.750;3523000;0
15570;779;966;58;22;3;19;.864;3600000;0
15570;7037;966;0;0;0;0;.00nan;0;0
15570;37414;879;53;31;5;26;.839;3577000;0
15570;148956;879;0;0;0;0;.00nan;0;0
15571;166514;894;85;33;2;31;.939;3600000;0
15571;23251;994;0;0;0;0;.00nan;0;0
15571;46905;994;60;27;4;23;.852;3521000;0
15571;62287;894;0;0;0;0;.00nan;0;0
15572;23251;994;64;29;3;26;.897;3600000;0
15572;37414;879;64;23;2;21;.913;3600000;0
15572;46905;994;0;0;0;0;.00nan;0;0
15572;148956;879;0;0;0;0;.00nan;0;0
15573;168842;880;35;31;6;25;.806;2883000;0
15573;176765;885;93;44;2;42;.955;3600000;0
15573;36136;880;37;8;2;6;.750;717000;0
15573;61999;885;0;0;0;0;.00nan;0;0
15574;6127;878;90;23;0;23;1.000;3600000;0
15574;146386;983;0;0;0;0;.00nan;0;0
15574;146656;878;0;0;0;0;.00nan;0;0
15574;154414;983;83;49;4;45;.918;3600000;0
15575;166514;894;0;0;0;0;.00nan;0;0
15575;62287;894;76;41;3;38;.927;3805000;0
15575;70099;890;50;24;4;20;.833;3830000;0
15575;157295;890;0;0;0;0;.00nan;0;0
15576;18104;874;0;0;0;0;.00nan;0;0
15576;28701;965;0;0;0;0;.00nan;0;0
15576;43896;874;73;17;1;16;.941;3600000;0
15576;56306;965;75;40;4;36;.900;3600000;0
15577;779;966;0;0;0;0;.00nan;0;0
15577;4487;945;44;25;4;21;.840;2056000;0
15577;7037;966;48;27;4;23;.852;3600000;0
15577;44487;945;62;19;2;17;.895;1480000;0
15578;20645;1415;0;0;0;0;.00nan;0;0
15578;37414;879;51;24;3;21;.875;3900000;0
15578;61272;1415;55;25;3;22;.880;3900000;0
15578;148956;879;0;0;0;0;.00nan;0;0
15579;8505;978;43;30;5;25;.833;3600000;0
15579;62015;978;0;0;0;0;.00nan;0;0
15579;146386;983;0;0;0;0;.00nan;0;0
15579;154414;983;94;21;0;21;1.000;3600000;0
15580;4487;945;0;0;0;0;.00nan;0;0
15580;6127;878;63;20;2;18;.900;3600000;0
15580;44487;945;78;47;4;43;.915;3534000;0
15580;146656;878;0;0;0;0;.00nan;0;0
15581;166514;894;0;0;0;0;.00nan;0;0
15581;28701;965;26;5;3;2;.400;204000;0
15581;56306;965;96;26;0;26;1.000;3478000;0
15581;62287;894;42;24;4;20;.833;3682000;0
15582;779;966;58;33;4;29;.879;3600000;0
15582;7037;966;0;0;0;0;.00nan;0;0
15582;23251;994;80;44;3;41;.932;3252000;0
15582;46905;994;26;6;3;3;.500;322000;0
15583;18104;874;93;29;1;28;.966;3600000;0
15583;176765;885;56;42;5;37;.881;3600000;0
15583;43896;874;0;0;0;0;.00nan;0;0
15583;61999;885;0;0;0;0;.00nan;0;0
15584;168842;880;68;34;3;31;.912;3600000;0
15584;36136;880;0;0;0;0;.00nan;0;0
15584;70099;890;100;32;0;32;1.000;3600000;0
15584;157295;890;0;0;0;0;.00nan;0;0
15585;779;966;0;0;0;0;.00nan;0;0
15585;6127;878;57;35;4;31;.886;3600000;0
15585;7037;966;74;42;5;37;.881;3557000;0
15585;146656;878;0;0;0;0;.00nan;0;0
15586;4487;945;72;27;2;25;.926;3600000;0
15586;44487;945;0;0;0;0;.00nan;0;0
15586;146386;983;0;0;0;0;.00nan;0;0
15586;154414;983;71;31;3;28;.903;3562000;0
15587;23251;994;45;22;4;18;.818;2366000;0
15587;176765;885;82;42;4;38;.905;3600000;0
15587;46905;994;45;12;2;10;.833;1176000;0
15587;61999;885;0;0;0;0;.00nan;0;0
15588;166514;894;0;0;0;0;.00nan;0;0
15588;18104;874;0;0;0;0;.00nan;0;0
15588;43896;874;73;21;1;20;.952;3600000;0
15588;62287;894;96;48;3;45;.938;3546000;0
15589;8505;978;57;15;2;13;.867;3600000;0
15589;28701;965;58;28;3;25;.893;3568000;0
15589;56306;965;0;0;0;0;.00nan;0;0
15589;62015;978;0;0;0;0;.00nan;0;0
15590;168842;880;34;32;7;25;.781;3600000;0
15590;20645;1415;0;0;0;0;.00nan;0;0
15590;36136;880;0;0;0;0;.00nan;0;0
15590;61272;1415;83;46;4;42;.913;3600000;0
15591;20645;1415;0;0;0;0;.00nan;0;0
15591;61272;1415;59;33;4;29;.879;3569000;0
15591;70099;890;70;33;3;30;.909;3600000;0
15591;157295;890;0;0;0;0;.00nan;0;0
15592;28701;965;67;23;2;21;.913;3600000;0
15592;56306;965;0;0;0;0;.00nan;0;0
15592;146386;983;0;0;0;0;.00nan;0;0
15592;154414;983;59;32;4;28;.875;3600000;0
15593;166514;894;83;32;1;31;.969;3600000;0
15593;168842;880;62;22;2;20;.909;3565000;0
15593;36136;880;0;0;0;0;.00nan;0;0
15593;62287;894;0;0;0;0;.00nan;0;0
15594;779;966;0;0;0;0;.00nan;0;0
15594;7037;966;49;21;3;18;.857;3600000;0
15594;8505;978;72;40;4;36;.900;3549000;0
15594;62015;978;0;0;0;0;.00nan;0;0
15595;4487;945;79;27;1;26;.963;3600000;0
15595;23251;994;0;0;0;0;.00nan;0;0
15595;44487;945;0;0;0;0;.00nan;0;0
15595;46905;994;78;40;3;37;.925;3554000;0
15596;176765;885;53;34;4;30;.882;3571000;0
15596;37414;879;0;0;0;0;.00nan;0;0
15596;61999;885;0;0;0;0;.00nan;0;0
15596;148956;879;57;25;3;22;.880;3600000;0
15597;6127;878;50;34;6;28;.824;3600000;0
15597;18104;874;0;0;0;0;.00nan;0;0
15597;43896;874;85;41;3;38;.927;3600000;0
15597;146656;878;0;0;0;0;.00nan;0;0
15598;37414;879;82;24;1;23;.958;3600000;0
15598;146386;983;0;0;0;0;.00nan;0;0
15598;148956;879;0;0;0;0;.00nan;0;0
15598;154414;983;73;29;2;27;.931;3570000;0
15599;176765;885;100;41;0;41;1.000;3600000;0
15599;61999;885;0;0;0;0;.00nan;0;0
15599;70099;890;61;29;3;26;.897;3600000;0
15599;157295;890;0;0;0;0;.00nan;0;0
15600;6127;878;56;14;2;12;.857;3600000;0
15600;23251;994;70;40;4;36;.900;3543000;0
15600;46905;994;0;0;0;0;.00nan;0;0
15600;146656;878;0;0;0;0;.00nan;0;0
15601;4487;945;65;26;3;23;.885;3600000;0
15601;28701;965;73;44;4;40;.909;3545000;0
15601;44487;945;0;0;0;0;.00nan;0;0
15601;56306;965;0;0;0;0;.00nan;0;0
15602;166514;894;0;0;0;0;.00nan;0;0
15602;20645;1415;0;0;0;0;.00nan;0;0
15602;61272;1415;68;18;1;17;.944;3600000;0
15602;62287;894;60;27;3;24;.889;3580000;0
15603;779;966;55;3;0;3;1.000;260000;0
15603;7037;966;27;36;7;29;.806;3319000;0
15603;18104;874;0;0;0;0;.00nan;0;0
15603;43896;874;28;20;5;15;.750;3600000;0
15604;8505;978;76;30;2;28;.933;3600000;0
15604;168842;880;69;43;5;38;.884;3600000;0
15604;36136;880;0;0;0;0;.00nan;0;0
15604;62015;978;0;0;0;0;.00nan;0;0
15605;37414;879;0;0;0;0;.00nan;0;0
15605;70099;890;65;32;3;29;.906;3900000;0
15605;148956;879;78;37;3;34;.919;3900000;0
15605;157295;890;0;0;0;0;.00nan;0;0
15606;4487;945;41;13;3;10;.769;525000;0
15606;18104;874;0;0;0;0;.00nan;0;0
15606;43896;874;78;25;2;23;.920;3600000;0
15606;44487;945;27;20;5;15;.750;3075000;0
15607;779;966;0;0;0;0;.00nan;0;0
15607;7037;966;90;40;3;37;.925;3900000;0
15607;70099;890;93;41;3;38;.927;3900000;0
15607;157295;890;0;0;0;0;.00nan;0;0
15608;20645;1415;77;28;2;26;.929;3600000;0
15608;61272;1415;0;0;0;0;.00nan;0;0
15608;146386;983;0;0;0;0;.00nan;0;0
15608;154414;983;44;34;6;28;.824;3600000;0
15609;28701;965;44;34;6;28;.824;3600000;0
15609;176765;885;81;38;3;35;.921;3600000;0
15609;56306;965;0;0;0;0;.00nan;0;0
15609;61999;885;0;0;0;0;.00nan;0;0
15610;166514;894;0;0;0;0;.00nan;0;0
15610;37414;879;22;20;5;15;.750;3600000;0
15610;62287;894;100;35;1;34;.971;3600000;0
15610;148956;879;0;0;0;0;.00nan;0;0
15611;6127;878;88;33;2;31;.939;3600000;0
15611;8505;978;35;37;6;31;.838;3600000;0
15611;62015;978;0;0;0;0;.00nan;0;0
15611;146656;878;0;0;0;0;.00nan;0;0
15612;168842;880;44;30;4;26;.867;3600000;0
15612;23251;994;16;27;7;20;.741;2825000;0
15612;36136;880;0;0;0;0;.00nan;0;0
15612;46905;994;59;10;1;9;.900;775000;0
15613;176765;885;62;30;4;26;.867;3858000;0
15613;61999;885;0;0;0;0;.00nan;0;0
15613;146386;983;70;48;5;43;.896;3858000;0
15613;154414;983;0;0;0;0;.00nan;0;0
15614;6127;878;64;32;3;29;.906;3600000;0
15614;166514;894;0;0;0;0;.00nan;0;0
15614;62287;894;100;30;0;30;1.000;3600000;0
15614;146656;878;0;0;0;0;.00nan;0;0
15615;28701;965;78;34;2;32;.941;3587000;0
15615;56306;965;0;0;0;0;.00nan;0;0
15615;70099;890;92;21;0;21;1.000;3600000;0
15615;157295;890;0;0;0;0;.00nan;0;0
15616;779;966;0;0;0;0;.00nan;0;0
15616;7037;966;62;23;3;20;.870;3617000;0
15616;168842;880;87;50;4;46;.920;3617000;0
15616;36136;880;0;0;0;0;.00nan;0;0
15617;8505;978;73;35;3;32;.914;3600000;0
15617;23251;994;0;0;0;0;.00nan;0;0
15617;46905;994;100;28;0;28;1.000;3600000;0
15617;62015;978;0;0;0;0;.00nan;0;0
15618;4487;945;74;37;3;34;.919;3534000;0
15618;37414;879;77;27;1;26;.963;3600000;0
15618;44487;945;0;0;0;0;.00nan;0;0
15618;148956;879;0;0;0;0;.00nan;0;0
15619;18104;874;0;0;0;0;.00nan;0;0
15619;20645;1415;0;0;0;0;.00nan;0;0
15619;43896;874;41;27;4;23;.852;3558000;0
15619;61272;1415;67;30;3;27;.900;3600000;0
15621;6127;878;34;32;6;26;.813;3600000;0
15621;57413;966;96;45;1;44;.978;3600000;0
15621;146656;878;0;0;0;0;.00nan;0;0
15621;154996;966;0;0;0;0;.00nan;0;0
15623;9858;945;0;0;0;0;.00nan;0;0
15623;14873;874;46;21;3;18;.857;3110000;0
15623;43896;874;21;3;3;0;.000;435000;0
15623;82245;945;69;42;5;37;.881;3600000;0
15625;166514;894;0;0;0;0;.00nan;0;0
15625;61272;1415;53;20;3;17;.850;3561000;0
15625;62287;894;83;33;1;32;.970;3600000;0
15625;146934;1415;0;0;0;0;.00nan;0;0
15627;168842;880;69;26;2;24;.923;3556000;0
15627;36136;880;0;0;0;0;.00nan;0;0
15627;146386;983;77;22;1;21;.955;3600000;0
15627;154414;983;0;0;0;0;.00nan;0;0
15629;7624;885;0;0;0;0;.00nan;0;0
15629;28701;965;71;27;2;25;.926;3514000;0
15629;176765;885;100;44;0;44;1.000;3600000;0
15629;56306;965;0;0;0;0;.00nan;0;0
15631;4219;879;89;34;1;33;.971;3600000;0
15631;23251;994;0;0;0;0;.00nan;0;0
15631;46905;994;58;28;3;25;.893;3525000;0
15631;81792;879;0;0;0;0;.00nan;0;0
15633;8505;978;91;32;1;31;.969;3900000;0
15633;62015;978;0;0;0;0;.00nan;0;0
15633;70099;890;0;0;0;0;.00nan;0;0
15633;157295;890;98;32;1;31;.969;3900000;0
15635;4219;879;0;0;0;0;.00nan;0;0
15635;23251;994;0;0;0;0;.00nan;0;0
15635;46905;994;65;28;3;25;.893;3612000;0
15635;81792;879;55;24;4;20;.833;3600000;0
15637;166514;894;0;0;0;0;.00nan;0;0
15637;57413;966;67;33;3;30;.909;3600000;0
15637;62287;894;40;28;5;23;.821;3546000;0
15637;154996;966;0;0;0;0;.00nan;0;0
15639;9858;945;99;40;1;39;.975;3600000;0
15639;168842;880;56;19;2;17;.895;3544000;0
15639;36136;880;0;0;0;0;.00nan;0;0
15639;82245;945;0;0;0;0;.00nan;0;0
15641;7624;885;0;0;0;0;.00nan;0;0
15641;176765;885;39;32;6;26;.813;3600000;0
15641;146386;983;84;34;2;32;.941;3600000;0
15641;154414;983;0;0;0;0;.00nan;0;0
15643;28701;965;99;36;1;35;.972;3600000;0
15643;56306;965;0;0;0;0;.00nan;0;0
15643;70099;890;0;0;0;0;.00nan;0;0
15643;157295;890;43;19;4;15;.789;3600000;0
15645;14873;874;0;0;0;0;.00nan;0;0
15645;43896;874;60;31;3;28;.903;3527000;0
15645;61272;1415;70;17;1;16;.941;3600000;0
15645;146934;1415;0;0;0;0;.00nan;0;0
15647;6127;878;83;39;3;36;.923;3693000;0
15647;8505;978;66;39;4;35;.897;3693000;0
15647;62015;978;0;0;0;0;.00nan;0;0
15647;146656;878;0;0;0;0;.00nan;0;0
15649;6127;878;0;0;0;0;.00nan;0;0
15649;166514;894;49;35;6;29;.829;3600000;0
15649;62287;894;0;0;0;0;.00nan;0;0
15649;146656;878;84;26;1;25;.962;3600000;0
15651;4219;879;55;31;4;27;.871;3900000;0
15651;14873;874;54;30;4;26;.867;3900000;0
15651;43896;874;0;0;0;0;.00nan;0;0
15651;81792;879;0;0;0;0;.00nan;0;0
15653;70099;890;71;19;1;18;.947;3600000;0
15653;146386;983;0;0;0;0;.00nan;0;0
15653;154414;983;62;29;3;26;.897;3570000;0
15653;157295;890;0;0;0;0;.00nan;0;0
15655;23251;994;100;25;0;25;1.000;3600000;0
15655;46905;994;0;0;0;0;.00nan;0;0
15655;61272;1415;0;0;0;0;.00nan;0;0
15655;146934;1415;90;32;1;31;.969;3559000;0
15657;168842;880;49;2;0;2;1.000;360000;0
15657;36136;880;42;32;6;26;.813;3240000;0
15657;57413;966;88;19;0;19;1.000;3600000;0
15657;154996;966;0;0;0;0;.00nan;0;0
15659;8505;978;0;0;0;0;.00nan;0;0
15659;28701;965;0;0;0;0;.00nan;0;0
15659;56306;965;98;31;1;30;.968;3600000;0
15659;62015;978;49;29;5;24;.828;3600000;0
15661;7624;885;69;18;1;17;.944;3794000;0
15661;9858;945;0;0;0;0;.00nan;0;0
15661;176765;885;0;0;0;0;.00nan;0;0
15661;82245;945;92;52;2;50;.962;3794000;0
15663;4219;879;88;34;1;33;.971;3600000;0
15663;14873;874;0;0;0;0;.00nan;0;0
15663;43896;874;63;20;2;18;.900;3543000;0
15663;81792;879;0;0;0;0;.00nan;0;0
15665;23251;994;64;39;4;35;.897;3600000;0
15665;46905;994;0;0;0;0;.00nan;0;0
15665;57413;966;63;16;2;14;.875;3600000;0
15665;154996;966;0;0;0;0;.00nan;0;0
15667;8505;978;83;31;2;29;.935;3574000;0
15667;28701;965;84;24;1;23;.958;3600000;0
15667;56306;965;0;0;0;0;.00nan;0;0
15667;62015;978;0;0;0;0;.00nan;0;0
15669;7624;885;0;0;0;0;.00nan;0;0
15669;9858;945;0;0;0;0;.00nan;0;0
15669;176765;885;62;27;3;24;.889;3574000;0
15669;82245;945;84;35;2;33;.943;3600000;0
15671;166514;894;0;0;0;0;.00nan;0;0
15671;62287;894;51;26;3;23;.885;3600000;0
15671;70099;890;0;0;0;0;.00nan;0;0
15671;157295;890;71;22;1;21;.955;3600000;0
15673;6127;878;69;34;3;31;.912;3900000;0
15673;168842;880;69;36;3;33;.917;3900000;0
15673;36136;880;0;0;0;0;.00nan;0;0
15673;146656;878;0;0;0;0;.00nan;0;0
15675;61272;1415;39;34;6;28;.824;3600000;0
15675;146386;983;81;30;2;28;.933;3600000;0
15675;146934;1415;0;0;0;0;.00nan;0;0
15675;154414;983;0;0;0;0;.00nan;0;0
15677;4219;879;0;0;0;0;.00nan;0;0
15677;28701;965;0;0;0;0;.00nan;0;0
15677;56306;965;80;28;1;27;.964;3544000;0
15677;81792;879;100;23;0;23;1.000;3600000;0
15679;8505;978;0;0;0;0;.00nan;0;0
15679;62015;978;56;22;3;19;.864;3900000;0
15679;146386;983;0;0;0;0;.00nan;0;0
15679;154414;983;94;46;3;43;.935;3900000;0
15681;166514;894;29;30;6;24;.800;2970000;0
15681;62287;894;55;3;0;3;1.000;630000;0
15681;70099;890;65;18;2;16;.889;3600000;0
15681;157295;890;0;0;0;0;.00nan;0;0
15683;9858;945;85;38;2;36;.947;3900000;0
15683;23251;994;0;0;0;0;.00nan;0;0
15683;46905;994;77;28;2;26;.929;3900000;0
15683;82245;945;0;0;0;0;.00nan;0;0
15685;6127;878;0;0;0;0;.00nan;0;0
15685;14873;874;46;30;5;25;.833;3588000;0
15685;43896;874;0;0;0;0;.00nan;0;0
15685;146656;878;66;36;4;32;.889;3600000;0
15687;57413;966;42;39;6;33;.846;3600000;0
15687;61272;1415;0;0;0;0;.00nan;0;0
15687;146934;1415;83;42;3;39;.929;3600000;0
15687;154996;966;0;0;0;0;.00nan;0;0
15689;7624;885;97;37;1;36;.973;3600000;0
15689;168842;880;0;0;0;0;.00nan;0;0
15689;176765;885;0;0;0;0;.00nan;0;0
15689;36136;880;46;27;4;23;.852;3600000;0
15691;7624;885;0;0;0;0;.00nan;0;0
15691;176765;885;81;36;3;33;.917;3713000;0
15691;57413;966;65;29;4;25;.862;3753000;0
15691;154996;966;0;0;0;0;.00nan;0;0
15693;168842;880;51;23;3;20;.870;3532000;0
15693;28701;965;87;35;2;33;.943;3600000;0
15693;36136;880;0;0;0;0;.00nan;0;0
15693;56306;965;0;0;0;0;.00nan;0;0
15695;4219;879;0;0;0;0;.00nan;0;0
15695;6127;878;70;24;2;22;.917;3900000;0
15695;81792;879;50;20;2;18;.900;3900000;0
15695;146656;878;0;0;0;0;.00nan;0;0
15697;8505;978;89;42;3;39;.929;3593000;0
15697;14873;874;0;0;0;0;.00nan;0;0
15697;43896;874;78;21;1;20;.952;3600000;0
15697;62015;978;0;0;0;0;.00nan;0;0
15699;61272;1415;42;17;3;14;.824;3600000;0
15699;70099;890;0;0;0;0;.00nan;0;0
15699;146934;1415;0;0;0;0;.00nan;0;0
15699;157295;890;78;34;2;32;.941;3600000;0
15701;23251;994;67;21;1;20;.952;3600000;0
15701;46905;994;0;0;0;0;.00nan;0;0
15701;146386;983;0;0;0;0;.00nan;0;0
15701;154414;983;69;40;4;36;.900;3600000;0
15703;9858;945;0;0;0;0;.00nan;0;0
15703;166514;894;70;35;3;32;.914;3579000;0
15703;62287;894;0;0;0;0;.00nan;0;0
15703;82245;945;93;30;1;29;.967;3600000;0
15705;6127;878;0;0;0;0;.00nan;0;0
15705;7624;885;80;34;3;31;.912;3561000;0
15705;176765;885;0;0;0;0;.00nan;0;0
15705;146656;878;95;29;1;28;.966;3600000;0
15707;9858;945;53;42;6;36;.857;3600000;0
15707;14873;874;61;18;2;16;.889;3600000;0
15707;43896;874;0;0;0;0;.00nan;0;0
15707;82245;945;0;0;0;0;.00nan;0;0
15709;4219;879;78;35;2;33;.943;3600000;0
15709;166514;894;0;0;0;0;.00nan;0;0
15709;62287;894;79;35;3;32;.914;3562000;0
15709;81792;879;0;0;0;0;.00nan;0;0
15711;8505;978;0;0;0;0;.00nan;0;0
15711;28701;965;0;0;0;0;.00nan;0;0
15711;56306;965;68;26;2;24;.923;3900000;0
15711;62015;978;63;20;2;18;.900;3900000;0
15713;168842;880;0;0;0;0;.00nan;0;0
15713;36136;880;47;21;3;18;.857;3552000;0
15713;70099;890;77;29;2;27;.931;3600000;0
15713;157295;890;0;0;0;0;.00nan;0;0
15715;23251;994;0;0;0;0;.00nan;0;0
15715;46905;994;78;31;2;29;.935;3545000;0
15715;61272;1415;0;0;0;0;.00nan;0;0
15715;146934;1415;81;30;1;29;.967;3600000;0
15717;57413;966;0;0;0;0;.00nan;0;0
15717;146386;983;100;49;1;48;.980;3600000;0
15717;154414;983;0;0;0;0;.00nan;0;0
15717;154996;966;56;29;3;26;.897;3537000;0
1220;4487;945;38;21;4;17;.810;3810000;0
1220;20645;1415;0;0;0;0;.00nan;0;0
1220;44487;945;0;0;0;0;.00nan;0;0
1220;61272;1415;79;39;3;36;.923;3810000;0
1221;8505;978;80;30;2;28;.933;3600000;0
1221;166514;894;0;0;0;0;.00nan;0;0
1221;62015;978;0;0;0;0;.00nan;0;0
1221;62287;894;46;25;4;21;.840;3588000;0
1222;4487;945;81;46;4;42;.913;3576000;0
1222;20645;1415;0;0;0;0;.00nan;0;0
1222;44487;945;0;0;0;0;.00nan;0;0
1222;61272;1415;51;14;2;12;.857;3600000;0
1223;8505;978;35;31;6;25;.806;3583000;0
1223;166514;894;0;0;0;0;.00nan;0;0
1223;62015;978;0;0;0;0;.00nan;0;0
1223;62287;894;69;36;4;32;.889;3600000;0
1381;8505;978;34;28;5;23;.821;4126000;0
1381;166514;894;0;0;0;0;.00nan;0;0
1381;62015;978;0;0;0;0;.00nan;0;0
1381;62287;894;43;35;6;29;.829;4126000;0
1455;779;966;0;0;0;0;.00nan;0;0
1455;7037;966;80;39;3;36;.923;3909000;0
1455;8505;978;60;33;4;29;.879;3909000;0
1455;62015;978;0;0;0;0;.00nan;0;0
1456;176765;885;67;34;3;31;.912;3600000;0
1456;61999;885;0;0;0;0;.00nan;0;0
1456;70099;890;78;24;1;23;.958;3600000;0
1456;157295;890;0;0;0;0;.00nan;0;0
1457;18104;874;0;0;0;0;.00nan;0;0
1457;37414;879;91;34;2;32;.941;3600000;0
1457;43896;874;54;24;3;21;.875;3547000;0
1457;148956;879;0;0;0;0;.00nan;0;0
1458;6127;878;68;17;1;16;.941;3600000;0
1458;20645;1415;0;0;0;0;.00nan;0;0
1458;61272;1415;55;36;5;31;.861;3600000;0
1458;146656;878;0;0;0;0;.00nan;0;0
1459;779;966;0;0;0;0;.00nan;0;0
1459;7037;966;100;23;0;23;1.000;3600000;0
1459;8505;978;49;37;5;32;.865;3600000;0
1459;62015;978;0;0;0;0;.00nan;0;0
1460;176765;885;92;34;1;33;.971;3600000;0
1460;61999;885;0;0;0;0;.00nan;0;0
1460;70099;890;63;28;3;25;.893;3515000;0
1460;157295;890;0;0;0;0;.00nan;0;0
1461;18104;874;0;0;0;0;.00nan;0;0
1461;37414;879;49;36;5;31;.861;4040000;0
1461;43896;874;63;35;4;31;.886;4013000;0
1461;148956;879;0;0;0;0;.00nan;0;0
1462;6127;878;84;49;3;46;.939;5119000;0
1462;20645;1415;0;0;0;0;.00nan;0;0
1462;61272;1415;84;43;2;41;.953;5119000;0
1462;146656;878;0;0;0;0;.00nan;0;0
1463;779;966;0;0;0;0;.00nan;0;0
1463;7037;966;65;26;3;23;.885;3577000;0
1463;8505;978;80;30;2;28;.933;3600000;0
1463;62015;978;0;0;0;0;.00nan;0;0
1464;176765;885;90;19;0;19;1.000;3600000;0
1464;61999;885;0;0;0;0;.00nan;0;0
1464;70099;890;68;24;1;23;.958;3600000;0
1464;157295;890;0;0;0;0;.00nan;0;0
1465;18104;874;0;0;0;0;.00nan;0;0
1465;37414;879;50;29;5;24;.828;3600000;0
1465;43896;874;99;22;0;22;1.000;3600000;0
1465;148956;879;0;0;0;0;.00nan;0;0
1466;6127;878;91;49;2;47;.959;3600000;0
1466;20645;1415;0;0;0;0;.00nan;0;0
1466;61272;1415;44;23;3;20;.870;3546000;0
1466;146656;878;0;0;0;0;.00nan;0;0
1467;779;966;0;0;0;0;.00nan;0;0
1467;7037;966;71;26;2;24;.923;3600000;0
1467;8505;978;63;33;3;30;.909;3544000;0
1467;62015;978;0;0;0;0;.00nan;0;0
1468;176765;885;54;31;3;28;.903;3592000;0
1468;61999;885;0;0;0;0;.00nan;0;0
1468;70099;890;92;28;2;26;.929;3600000;0
1468;157295;890;0;0;0;0;.00nan;0;0
1469;18104;874;0;0;0;0;.00nan;0;0
1469;37414;879;83;28;1;27;.964;3600000;0
1469;43896;874;79;35;3;32;.914;3544000;0
1469;148956;879;0;0;0;0;.00nan;0;0
1470;6127;878;56;13;1;12;.923;3600000;0
1470;20645;1415;0;0;0;0;.00nan;0;0
1470;61272;1415;64;42;5;37;.881;3600000;0
1470;146656;878;0;0;0;0;.00nan;0;0
1625;779;966;0;0;0;0;.00nan;0;0
1625;7037;966;66;32;3;29;.906;3538000;0
1625;8505;978;97;34;1;33;.971;3600000;0
1625;62015;978;0;0;0;0;.00nan;0;0
1626;176765;885;82;31;1;30;.968;3600000;0
1626;61999;885;0;0;0;0;.00nan;0;0
1626;70099;890;84;38;3;35;.921;3545000;0
1626;157295;890;0;0;0;0;.00nan;0;0
1627;18104;874;0;0;0;0;.00nan;0;0
1627;37414;879;63;33;4;29;.879;3600000;0
1627;43896;874;62;24;3;21;.875;3600000;0
1627;148956;879;0;0;0;0;.00nan;0;0
1628;6127;878;59;21;2;19;.905;3600000;0
1628;20645;1415;0;0;0;0;.00nan;0;0
1628;61272;1415;73;30;3;27;.900;3577000;0
1628;146656;878;0;0;0;0;.00nan;0;0
1686;779;966;0;0;0;0;.00nan;0;0
1686;7037;966;38;29;5;24;.828;3600000;0
1686;8505;978;88;37;2;35;.946;3600000;0
1686;62015;978;0;0;0;0;.00nan;0;0
1687;176765;885;63;28;3;25;.893;3553000;0
1687;61999;885;0;0;0;0;.00nan;0;0
1687;70099;890;80;30;1;29;.967;3600000;0
1687;157295;890;0;0;0;0;.00nan;0;0
1688;18104;874;0;0;0;0;.00nan;0;0
1688;37414;879;100;32;1;31;.969;3600000;0
1688;43896;874;72;29;3;26;.897;3579000;0
1688;148956;879;0;0;0;0;.00nan;0;0
1821;779;966;0;0;0;0;.00nan;0;0
1821;7037;966;48;30;5;25;.833;3534000;0
1821;8505;978;80;39;3;36;.923;3600000;0
1821;62015;978;0;0;0;0;.00nan;0;0
1822;176765;885;66;31;4;27;.871;3600000;0
1822;61999;885;0;0;0;0;.00nan;0;0
1822;70099;890;62;28;3;25;.893;3600000;0
1822;157295;890;0;0;0;0;.00nan;0;0
1823;18104;874;0;0;0;0;.00nan;0;0
1823;37414;879;80;35;3;32;.914;3600000;0
1823;43896;874;65;34;4;30;.882;3600000;0
1823;148956;879;0;0;0;0;.00nan;0;0
1855;6127;878;88;31;2;29;.935;3843000;0
1855;8505;978;59;29;3;26;.897;3843000;0
1855;62015;978;0;0;0;0;.00nan;0;0
1855;146656;878;0;0;0;0;.00nan;0;0
1856;37414;879;89;29;2;27;.931;3600000;0
1856;70099;890;63;33;4;29;.879;3574000;0
1856;148956;879;0;0;0;0;.00nan;0;0
1856;157295;890;0;0;0;0;.00nan;0;0
1857;6127;878;90;30;1;29;.967;3600000;0
1857;8505;978;43;28;5;23;.821;3600000;0
1857;62015;978;0;0;0;0;.00nan;0;0
1857;146656;878;0;0;0;0;.00nan;0;0
1858;37414;879;81;37;3;34;.919;3600000;0
1858;70099;890;47;25;4;21;.840;3588000;0
1858;148956;879;0;0;0;0;.00nan;0;0
1858;157295;890;0;0;0;0;.00nan;0;0
1859;6127;878;90;22;1;21;.955;3600000;0
1859;8505;978;89;52;5;47;.904;3600000;0
1859;62015;978;0;0;0;0;.00nan;0;0
1859;146656;878;0;0;0;0;.00nan;0;0
1860;37414;879;74;22;1;21;.955;3600000;0
1860;70099;890;73;26;2;24;.923;3600000;0
1860;148956;879;0;0;0;0;.00nan;0;0
1860;157295;890;0;0;0;0;.00nan;0;0
1861;6127;878;62;27;3;24;.889;3600000;0
1861;8505;978;59;34;4;30;.882;3559000;0
1861;62015;978;0;0;0;0;.00nan;0;0
1861;146656;878;0;0;0;0;.00nan;0;0
1862;37414;879;85;30;2;28;.933;3600000;0
1862;70099;890;64;31;3;28;.903;3600000;0
1862;148956;879;0;0;0;0;.00nan;0;0
1862;157295;890;0;0;0;0;.00nan;0;0
1995;6127;878;100;33;1;32;.970;3600000;0
1995;37414;879;48;34;6;28;.824;3600000;0
1995;146656;878;0;0;0;0;.00nan;0;0
1995;148956;879;0;0;0;0;.00nan;0;0
1996;6127;878;92;38;2;36;.947;3600000;0
1996;37414;879;76;31;3;28;.903;3553000;0
1996;146656;878;0;0;0;0;.00nan;0;0
1996;148956;879;0;0;0;0;.00nan;0;0
1997;6127;878;77;22;1;21;.955;3600000;0
1997;37414;879;74;35;3;32;.914;3568000;0
1997;146656;878;0;0;0;0;.00nan;0;0
1997;148956;879;0;0;0;0;.00nan;0;0
1998;6127;878;90;37;2;35;.946;3816000;0
1998;37414;879;92;35;1;34;.971;3816000;0
1998;146656;878;0;0;0;0;.00nan;0;0
1998;148956;879;0;0;0;0;.00nan;0;0
2172;6127;878;63;37;4;33;.892;3690000;0
2172;37414;879;41;26;5;21;.808;3690000;0
2172;146656;878;0;0;0;0;.00nan;0;0
2172;148956;879;0;0;0;0;.00nan;0;0
15718;181910;760;0;0;0;0;.00nan;0;0
15718;49815;3721;0;0;0;0;.00nan;0;0
15718;56037;760;94;37;1;36;.973;3900000;0
15718;67818;3721;77;29;1;28;.966;3900000;0
15719;49581;775;0;0;0;0;.00nan;0;0
15719;71485;775;56;23;3;20;.870;3600000;0
15719;76406;4989;0;0;0;0;.00nan;0;0
15719;148691;4989;100;30;0;30;1.000;3600000;0
15720;504;3730;55;19;2;17;.895;3600000;0
15720;180990;772;64;33;4;29;.879;3558000;0
15720;76628;3730;0;0;0;0;.00nan;0;0
15720;94018;772;0;0;0;0;.00nan;0;0
15721;3075;754;91;39;1;38;.974;3600000;0
15721;63932;2197;73;37;3;34;.919;3551000;0
15721;87758;754;0;0;0;0;.00nan;0;0
15721;94508;2197;0;0;0;0;.00nan;0;0
15722;170548;758;75;21;1;20;.952;3600000;0
15722;81085;758;0;0;0;0;.00nan;0;0
15722;81691;762;62;30;4;26;.867;3600000;0
15722;146249;762;0;0;0;0;.00nan;0;0
15723;2140;1093;82;29;1;28;.966;3600000;0
15723;57172;1492;69;27;2;25;.926;3569000;0
15723;68233;1093;0;0;0;0;.00nan;0;0
15723;73639;1492;0;0;0;0;.00nan;0;0
15724;164521;4924;70;41;4;37;.902;3600000;0
15724;180738;755;69;23;2;21;.913;3600000;0
15724;149112;755;0;0;0;0;.00nan;0;0
15724;158630;4924;0;0;0;0;.00nan;0;0
15725;3957;4923;69;12;0;12;1.000;771000;0
15725;93756;1497;0;0;0;0;.00nan;0;0
15725;148508;4923;21;33;7;26;.788;2829000;0
15725;149191;1497;100;37;0;37;1.000;3600000;0
15726;147;767;82;28;1;27;.964;3600000;0
15726;-1;911;0;0;0;0;.00nan;0;0
15726;180177;911;69;27;2;25;.926;3586000;0
15726;82228;767;0;0;0;0;.00nan;0;0
15727;595;3913;83;41;3;38;.927;3900000;0
15727;49815;3721;0;0;0;0;.00nan;0;0
15727;67818;3721;91;46;3;43;.935;3900000;0
15727;149280;3913;0;0;0;0;.00nan;0;0
15728;359;774;0;0;0;0;.00nan;0;0
15728;3241;768;55;26;3;23;.885;3593000;0
15728;82711;768;0;0;0;0;.00nan;0;0
15728;91194;774;80;30;2;28;.933;3600000;0
15729;181910;760;55;10;1;9;.900;446000;0
15729;49935;746;85;21;1;20;.952;3600000;0
15729;56037;760;29;34;6;28;.824;3154000;0
15729;149119;746;0;0;0;0;.00nan;0;0
15730;11627;1503;62;29;3;26;.897;3900000;0
15730;175593;2545;79;37;3;34;.919;3900000;0
15730;67122;1503;0;0;0;0;.00nan;0;0
15730;94134;2545;0;0;0;0;.00nan;0;0
15731;76406;4989;0;0;0;0;.00nan;0;0
15731;81691;762;72;40;4;36;.900;3575000;0
15731;146249;762;0;0;0;0;.00nan;0;0
15731;148691;4989;76;34;3;31;.912;3600000;0
15732;164424;750;97;42;2;40;.952;3900000;0
15732;67446;750;0;0;0;0;.00nan;0;0
15732;93756;1497;0;0;0;0;.00nan;0;0
15732;149191;1497;77;33;2;31;.939;3900000;0
15733;170548;758;63;30;3;27;.900;3600000;0
15733;49581;775;48;30;4;26;.867;3557000;0
15733;71485;775;0;0;0;0;.00nan;0;0
15733;81085;758;0;0;0;0;.00nan;0;0
15734;2140;1093;72;26;2;24;.923;3600000;0
15734;180738;755;55;22;3;19;.864;3577000;0
15734;68233;1093;0;0;0;0;.00nan;0;0
15734;149112;755;0;0;0;0;.00nan;0;0
15735;164521;4924;0;0;0;0;.00nan;0;0
15735;57172;1492;70;34;3;31;.912;3792000;0
15735;73639;1492;0;0;0;0;.00nan;0;0
15735;158630;4924;93;39;2;37;.949;3792000;0
15736;177124;2199;60;21;2;19;.905;3567000;0
15736;3957;4923;0;0;0;0;.00nan;0;0
15736;148508;4923;80;28;1;27;.964;3600000;0
15736;149221;2199;0;0;0;0;.00nan;0;0
15737;10931;759;0;0;0;0;.00nan;0;0
15737;11627;1503;0;0;0;0;.00nan;0;0
15737;66993;759;68;25;2;23;.920;3600000;0
15737;67122;1503;62;42;5;37;.881;3600000;0
15738;170547;769;0;0;0;0;.00nan;0;0
15738;49815;3721;0;0;0;0;.00nan;0;0
15738;67818;3721;63;31;3;28;.903;3561000;0
15738;154296;769;67;27;2;25;.926;3600000;0
15739;359;774;59;13;1;12;.923;3600000;0
15739;174894;766;0;0;0;0;.00nan;0;0
15739;43720;766;86;52;3;49;.942;3564000;0
15739;91194;774;0;0;0;0;.00nan;0;0
15740;595;3913;27;30;6;24;.800;2048000;0
15740;49935;746;63;22;2;20;.909;3600000;0
15740;149119;746;0;0;0;0;.00nan;0;0
15740;149280;3913;76;20;1;19;.950;1552000;0
15741;175593;2545;0;0;0;0;.00nan;0;0
15741;181910;760;61;18;2;16;.889;3555000;0
15741;56037;760;0;0;0;0;.00nan;0;0
15741;94134;2545;79;28;1;27;.964;3600000;0
15742;177124;2199;92;48;3;45;.938;3900000;0
15742;164424;750;77;39;3;36;.923;3900000;0
15742;67446;750;0;0;0;0;.00nan;0;0
15742;149221;2199;0;0;0;0;.00nan;0;0
15743;63932;2197;83;28;1;27;.964;3600000;0
15743;93756;1497;0;0;0;0;.00nan;0;0
15743;94508;2197;0;0;0;0;.00nan;0;0
15743;149191;1497;77;36;4;32;.889;3600000;0
15744;504;3730;51;28;4;24;.857;3600000;0
15744;2140;1093;100;31;0;31;1.000;3600000;0
15744;68233;1093;0;0;0;0;.00nan;0;0
15744;76628;3730;0;0;0;0;.00nan;0;0
15745;164521;4924;0;0;0;0;.00nan;0;0
15745;180990;772;0;0;0;0;.00nan;0;0
15745;94018;772;84;14;0;14;1.000;3600000;0
15745;158630;4924;68;36;3;33;.917;3600000;0
15746;147;767;59;32;4;28;.875;3572000;0
15746;3957;4923;0;0;0;0;.00nan;0;0
15746;82228;767;0;0;0;0;.00nan;0;0
15746;148508;4923;67;32;3;29;.906;3600000;0
15747;10931;759;0;0;0;0;.00nan;0;0
15747;181910;760;0;0;0;0;.00nan;0;0
15747;56037;760;70;32;3;29;.906;3600000;0
15747;66993;759;66;22;2;20;.909;3600000;0
15748;3241;768;55;28;3;25;.893;3563000;0
15748;174894;766;0;0;0;0;.00nan;0;0
15748;43720;766;98;34;1;33;.971;3600000;0
15748;82711;768;0;0;0;0;.00nan;0;0
15749;11627;1503;0;0;0;0;.00nan;0;0
15749;49815;3721;0;0;0;0;.00nan;0;0
15749;67122;1503;100;54;2;52;.963;3600000;0
15749;67818;3721;37;25;5;20;.800;3600000;0
15750;170547;769;0;0;0;0;.00nan;0;0
15750;49935;746;100;17;0;17;1.000;3600000;0
15750;149119;746;0;0;0;0;.00nan;0;0
15750;154296;769;82;66;6;60;.909;3600000;0
15751;595;3913;100;42;2;40;.952;3900000;0
15751;175593;2545;0;0;0;0;.00nan;0;0
15751;94134;2545;77;33;2;31;.939;3900000;0
15751;149280;3913;0;0;0;0;.00nan;0;0
15752;57172;1492;68;24;2;22;.917;3600000;0
15752;73639;1492;0;0;0;0;.00nan;0;0
15752;81691;762;37;28;5;23;.821;2057000;0
15752;146249;762;55;11;1;10;.909;1543000;0
15753;147;767;100;25;0;25;1.000;3600000;0
15753;164424;750;83;30;1;29;.967;3588000;0
15753;67446;750;0;0;0;0;.00nan;0;0
15753;82228;767;0;0;0;0;.00nan;0;0
15754;177124;2199;47;25;3;22;.880;3512000;0
15754;63932;2197;0;0;0;0;.00nan;0;0
15754;94508;2197;88;30;1;29;.967;3600000;0
15754;149221;2199;0;0;0;0;.00nan;0;0
15755;170548;758;60;27;4;23;.852;3546000;0
15755;76406;4989;0;0;0;0;.00nan;0;0
15755;81085;758;0;0;0;0;.00nan;0;0
15755;148691;4989;46;18;3;15;.833;3600000;0
15756;2140;1093;34;23;5;18;.783;3523000;0
15756;180990;772;0;0;0;0;.00nan;0;0
15756;68233;1093;0;0;0;0;.00nan;0;0
15756;94018;772;55;22;3;19;.864;3600000;0
15757;504;3730;0;0;0;0;.00nan;0;0
15757;164521;4924;0;0;0;0;.00nan;0;0
15757;76628;3730;82;25;1;24;.960;3600000;0
15757;158630;4924;74;28;2;26;.929;3590000;0
15758;3075;754;77;25;1;24;.960;3600000;0
15758;87758;754;0;0;0;0;.00nan;0;0
15758;93756;1497;0;0;0;0;.00nan;0;0
15758;149191;1497;75;28;2;26;.929;3550000;0
15759;3957;4923;80;21;1;20;.952;3600000;0
15759;-1;911;0;0;0;0;.00nan;0;0
15759;180177;911;98;42;2;40;.952;3550000;0
15759;148508;4923;0;0;0;0;.00nan;0;0
15760;595;3913;88;44;2;42;.955;3900000;0
15760;10931;759;0;0;0;0;.00nan;0;0
15760;66993;759;62;22;2;20;.909;3900000;0
15760;149280;3913;0;0;0;0;.00nan;0;0
15761;11627;1503;0;0;0;0;.00nan;0;0
15761;49935;746;99;24;0;24;1.000;3600000;0
15761;67122;1503;92;49;4;45;.918;3600000;0
15761;149119;746;0;0;0;0;.00nan;0;0
15762;170547;769;88;31;1;30;.968;3600000;0
15762;175593;2545;0;0;0;0;.00nan;0;0
15762;94134;2545;67;28;2;26;.929;3588000;0
15762;154296;769;0;0;0;0;.00nan;0;0
15763;49581;775;83;37;3;34;.919;3600000;0
15763;57172;1492;68;22;2;20;.909;3600000;0
15763;71485;775;0;0;0;0;.00nan;0;0
15763;73639;1492;0;0;0;0;.00nan;0;0
15764;164424;750;56;19;2;17;.895;3550000;0
15764;-1;911;0;0;0;0;.00nan;0;0
15764;180177;911;74;26;1;25;.962;3600000;0
15764;67446;750;0;0;0;0;.00nan;0;0
15765;180738;755;62;24;3;21;.875;3545000;0
15765;81691;762;96;40;2;38;.950;3600000;0
15765;146249;762;0;0;0;0;.00nan;0;0
15765;149112;755;0;0;0;0;.00nan;0;0
15766;147;767;76;25;1;24;.960;3600000;0
15766;63932;2197;100;30;0;30;1.000;3600000;0
15766;82228;767;0;0;0;0;.00nan;0;0
15766;94508;2197;0;0;0;0;.00nan;0;0
15767;177124;2199;0;0;0;0;.00nan;0;0
15767;3075;754;0;0;0;0;.00nan;0;0
15767;87758;754;85;27;2;25;.926;3900000;0
15767;149221;2199;80;37;2;35;.946;3900000;0
15768;10931;759;0;0;0;0;.00nan;0;0
15768;170547;769;0;0;0;0;.00nan;0;0
15768;66993;759;66;19;1;18;.947;3600000;0
15768;154296;769;91;40;2;38;.950;3544000;0
15769;359;774;85;34;2;32;.941;3577000;0
15769;49815;3721;0;0;0;0;.00nan;0;0
15769;67818;3721;85;29;1;28;.966;3600000;0
15769;91194;774;0;0;0;0;.00nan;0;0
15770;170548;758;81;24;1;23;.958;3600000;0
15770;57172;1492;52;19;2;17;.895;3595000;0
15770;73639;1492;0;0;0;0;.00nan;0;0
15770;81085;758;0;0;0;0;.00nan;0;0
15771;180990;772;0;0;0;0;.00nan;0;0
15771;81691;762;75;27;1;26;.963;3600000;0
15771;94018;772;72;27;2;25;.926;3600000;0
15771;146249;762;0;0;0;0;.00nan;0;0
15772;180738;755;0;0;0;0;.00nan;0;0
15772;49581;775;72;41;4;37;.902;3600000;0
15772;71485;775;0;0;0;0;.00nan;0;0
15772;149112;755;64;15;1;14;.933;3600000;0
15773;504;3730;35;25;5;20;.800;3524000;0
15773;76406;4989;0;0;0;0;.00nan;0;0
15773;76628;3730;0;0;0;0;.00nan;0;0
15773;148691;4989;81;41;3;38;.927;3600000;0
15774;-1;911;0;0;0;0;.00nan;0;0
15774;180177;911;79;24;1;23;.958;3600000;0
15774;63932;2197;100;24;0;24;1.000;3600000;0
15774;94508;2197;0;0;0;0;.00nan;0;0
15775;3957;4923;0;0;0;0;.00nan;0;0
15775;181910;760;95;27;0;27;1.000;3600000;0
15775;56037;760;0;0;0;0;.00nan;0;0
15775;148508;4923;79;25;1;24;.960;3549000;0
15776;147;767;87;37;3;34;.919;3900000;0
15776;3075;754;77;31;3;28;.903;3900000;0
15776;82228;767;0;0;0;0;.00nan;0;0
15776;87758;754;0;0;0;0;.00nan;0;0
15777;164521;4924;0;0;0;0;.00nan;0;0
15777;93756;1497;68;31;3;28;.903;3600000;0
15777;149191;1497;0;0;0;0;.00nan;0;0
15777;158630;4924;67;51;5;46;.902;3600000;0
15778;3241;768;0;0;0;0;.00nan;0;0
15778;49815;3721;83;48;3;45;.938;3001000;0
15778;67818;3721;36;13;3;10;.769;599000;0
15778;86099;768;43;24;4;20;.833;3600000;0
15779;359;774;82;37;2;35;.946;3592000;0
15779;49935;746;68;17;1;16;.941;3600000;0
15779;91194;774;0;0;0;0;.00nan;0;0
15779;149119;746;0;0;0;0;.00nan;0;0
15780;57172;1492;0;0;0;0;.00nan;0;0
15780;73639;1492;23;27;6;21;.778;3600000;0
15780;76406;4989;0;0;0;0;.00nan;0;0
15780;148691;4989;56;20;3;17;.850;3600000;0
15781;180990;772;0;0;0;0;.00nan;0;0
15781;49581;775;99;51;1;50;.980;3600000;0
15781;71485;775;0;0;0;0;.00nan;0;0
15781;94018;772;38;18;3;15;.833;3514000;0
15782;170548;758;77;33;3;30;.909;3600000;0
15782;180738;755;56;29;4;25;.862;3596000;0
15782;81085;758;0;0;0;0;.00nan;0;0
15782;149112;755;0;0;0;0;.00nan;0;0
15783;504;3730;85;54;5;49;.907;3600000;0
15783;76628;3730;0;0;0;0;.00nan;0;0
15783;81691;762;94;22;0;22;1.000;3600000;0
15783;146249;762;0;0;0;0;.00nan;0;0
15784;164424;750;68;34;3;31;.912;3544000;0
15784;181910;760;87;34;1;33;.971;3600000;0
15784;56037;760;0;0;0;0;.00nan;0;0
15784;67446;750;0;0;0;0;.00nan;0;0
15785;177124;2199;0;0;0;0;.00nan;0;0
15785;164521;4924;0;0;0;0;.00nan;0;0
15785;149221;2199;83;21;1;20;.952;3600000;0
15785;158630;4924;81;32;2;30;.938;3585000;0
15786;3075;754;0;0;0;0;.00nan;0;0
15786;-1;911;0;0;0;0;.00nan;0;0
15786;180177;911;67;14;1;13;.929;3600000;0
15786;87758;754;70;37;4;33;.892;3600000;0
15787;2140;1093;60;28;4;24;.857;3891000;0
15787;68233;1093;0;0;0;0;.00nan;0;0
15787;93756;1497;0;0;0;0;.00nan;0;0
15787;149191;1497;68;36;4;32;.889;3900000;0
15788;595;3913;85;27;3;24;.889;3600000;0
15788;3957;4923;0;0;0;0;.00nan;0;0
15788;148508;4923;54;29;4;25;.862;3600000;0
15788;149280;3913;0;0;0;0;.00nan;0;0
15789;3241;768;0;0;0;0;.00nan;0;0
15789;49935;746;67;20;2;18;.900;3600000;0
15789;86099;768;53;37;5;32;.865;3600000;0
15789;149119;746;0;0;0;0;.00nan;0;0
15790;174894;766;0;0;0;0;.00nan;0;0
15790;43720;766;45;35;5;30;.857;3563000;0
15790;49815;3721;0;0;0;0;.00nan;0;0
15790;67818;3721;80;39;3;36;.923;3600000;0
15791;359;774;66;19;1;18;.947;3600000;0
15791;175593;2545;23;23;6;17;.739;2162000;0
15791;91194;774;0;0;0;0;.00nan;0;0
15791;94134;2545;35;13;3;10;.769;1438000;0
15792;170548;758;0;0;0;0;.00nan;0;0
15792;180990;772;87;29;1;28;.966;3600000;0
15792;85395;758;65;24;2;22;.917;3545000;0
15792;94018;772;0;0;0;0;.00nan;0;0
15793;147;767;97;45;1;44;.978;3561000;0
15793;164521;4924;0;0;0;0;.00nan;0;0
15793;82228;767;0;0;0;0;.00nan;0;0
15793;158630;4924;100;33;0;33;1.000;3600000;0
15794;180738;755;0;0;0;0;.00nan;0;0
15794;76406;4989;0;0;0;0;.00nan;0;0
15794;148691;4989;56;25;3;22;.880;3565000;0
15794;149112;755;70;26;2;24;.923;3600000;0
15795;504;3730;0;0;0;0;.00nan;0;0
15795;49581;775;72;40;4;36;.900;3816000;0
15795;71485;775;0;0;0;0;.00nan;0;0
15795;76628;3730;52;22;3;19;.864;3816000;0
15796;181910;760;0;0;0;0;.00nan;0;0
15796;56037;760;61;22;2;20;.909;3600000;0
15796;63932;2197;45;30;5;25;.833;3600000;0
15796;94508;2197;0;0;0;0;.00nan;0;0
15797;177124;2199;74;35;3;32;.914;3591000;0
15797;2140;1093;79;24;2;22;.917;3600000;0
15797;68233;1093;0;0;0;0;.00nan;0;0
15797;149221;2199;0;0;0;0;.00nan;0;0
15798;595;3913;100;27;0;27;1.000;3600000;0
15798;164424;750;90;39;2;37;.949;3515000;0
15798;67446;750;0;0;0;0;.00nan;0;0
15798;149280;3913;0;0;0;0;.00nan;0;0
15799;3957;4923;0;0;0;0;.00nan;0;0
15799;11627;1503;0;0;0;0;.00nan;0;0
15799;67122;1503;73;47;5;42;.894;3600000;0
15799;148508;4923;59;18;2;16;.889;3600000;0
15800;3241;768;0;0;0;0;.00nan;0;0
15800;175593;2545;0;0;0;0;.00nan;0;0
15800;86099;768;48;26;4;22;.846;3900000;0
15800;94134;2545;71;37;4;33;.892;3900000;0
15801;174894;766;0;0;0;0;.00nan;0;0
15801;43720;766;88;39;2;37;.949;3712000;0
15801;49935;746;72;23;1;22;.957;3712000;0
15801;149119;746;0;0;0;0;.00nan;0;0
15802;359;774;88;36;2;34;.944;3600000;0
15802;10931;759;0;0;0;0;.00nan;0;0
15802;66993;759;79;21;1;20;.952;3600000;0
15802;91194;774;0;0;0;0;.00nan;0;0
15803;3957;4923;0;0;0;0;.00nan;0;0
15803;170547;769;0;0;0;0;.00nan;0;0
15803;148508;4923;64;34;3;31;.912;3600000;0
15803;154296;769;92;19;0;19;1.000;3600000;0
15804;180990;772;80;25;1;24;.960;3600000;0
15804;76406;4989;0;0;0;0;.00nan;0;0
15804;94018;772;0;0;0;0;.00nan;0;0
15804;148691;4989;61;34;4;30;.882;3600000;0
15805;147;767;70;29;2;27;.931;3600000;0
15805;2140;1093;71;23;1;22;.957;3600000;0
15805;68233;1093;0;0;0;0;.00nan;0;0
15805;82228;767;0;0;0;0;.00nan;0;0
15806;504;3730;90;30;1;29;.967;3900000;0
15806;170548;758;0;0;0;0;.00nan;0;0
15806;76628;3730;0;0;0;0;.00nan;0;0
15806;85395;758;83;24;1;23;.958;3900000;0
15807;3075;754;97;21;0;21;1.000;3600000;0
15807;181910;760;81;42;4;38;.905;3600000;0
15807;56037;760;0;0;0;0;.00nan;0;0
15807;87758;754;0;0;0;0;.00nan;0;0
15808;595;3913;88;36;2;34;.944;3551000;0
15808;63932;2197;91;17;0;17;1.000;3600000;0
15808;94508;2197;0;0;0;0;.00nan;0;0
15808;149280;3913;0;0;0;0;.00nan;0;0
15809;81691;762;100;26;0;26;1.000;3600000;0
15809;93756;1497;0;0;0;0;.00nan;0;0
15809;146249;762;0;0;0;0;.00nan;0;0
15809;149191;1497;59;29;4;25;.862;3600000;0
15810;164521;4924;0;0;0;0;.00nan;0;0
15810;-1;911;78;35;2;33;.943;3600000;0
15810;180177;911;0;0;0;0;.00nan;0;0
15810;158630;4924;59;29;3;26;.897;3581000;0
15811;164424;750;54;32;5;27;.844;3600000;0
15811;11627;1503;0;0;0;0;.00nan;0;0
15811;67122;1503;83;28;1;27;.964;3600000;0
15811;67446;750;0;0;0;0;.00nan;0;0
15812;3241;768;0;0;0;0;.00nan;0;0
15812;10931;759;0;0;0;0;.00nan;0;0
15812;66993;759;86;42;3;39;.929;3600000;0
15812;86099;768;50;27;4;23;.852;3562000;0
15813;174894;766;0;0;0;0;.00nan;0;0
15813;175593;2545;0;0;0;0;.00nan;0;0
15813;43720;766;87;30;1;29;.967;3600000;0
15813;94134;2545;91;19;0;19;1.000;3600000;0
15814;164424;750;85;15;0;15;1.000;3600000;0
15814;170547;769;0;0;0;0;.00nan;0;0
15814;67446;750;0;0;0;0;.00nan;0;0
15814;154296;769;74;36;2;34;.944;3540000;0
15815;180738;755;72;23;1;22;.957;3580000;0
15815;57172;1492;100;27;0;27;1.000;3600000;0
15815;73639;1492;0;0;0;0;.00nan;0;0
15815;149112;755;0;0;0;0;.00nan;0;0
15816;49581;775;0;0;0;0;.00nan;0;0
15816;71485;775;74;45;4;41;.911;3792000;0
15816;93756;1497;0;0;0;0;.00nan;0;0
15816;149191;1497;65;29;3;26;.897;3792000;0
15817;595;3913;92;28;1;27;.964;3600000;0
15817;3075;754;73;46;4;42;.913;3600000;0
15817;87758;754;0;0;0;0;.00nan;0;0
15817;149280;3913;0;0;0;0;.00nan;0;0
15818;177124;2199;0;0;0;0;.00nan;0;0
15818;81691;762;43;38;6;32;.842;3119000;0
15818;146249;762;48;7;1;6;.857;481000;0
15818;149221;2199;55;26;4;22;.846;3600000;0
15819;2140;1093;63;26;2;24;.923;3544000;0
15819;-1;911;0;0;0;0;.00nan;0;0
15819;180177;911;100;42;1;41;.976;3600000;0
15819;68233;1093;0;0;0;0;.00nan;0;0
15820;11627;1503;0;0;0;0;.00nan;0;0
15820;63932;2197;85;36;2;34;.944;3600000;0
15820;67122;1503;82;30;1;29;.967;3600000;0
15820;94508;2197;0;0;0;0;.00nan;0;0
15821;10931;759;0;0;0;0;.00nan;0;0
15821;174894;766;0;0;0;0;.00nan;0;0
15821;43720;766;65;42;4;38;.905;3600000;0
15821;66993;759;61;22;2;20;.909;3600000;0
15822;170547;769;28;13;4;9;.692;975000;0
15822;63932;2197;95;38;2;36;.947;3600000;0
15822;94508;2197;0;0;0;0;.00nan;0;0
15822;154296;769;52;21;3;18;.857;2625000;0
15823;180738;755;94;33;1;32;.970;3600000;0
15823;180990;772;0;0;0;0;.00nan;0;0
15823;94018;772;63;39;4;35;.897;3600000;0
15823;149112;755;0;0;0;0;.00nan;0;0
15824;76406;4989;82;35;2;33;.943;3561000;0
15824;93756;1497;0;0;0;0;.00nan;0;0
15824;148691;4989;0;0;0;0;.00nan;0;0
15824;149191;1497;91;34;1;33;.971;3600000;0
15825;504;3730;74;39;3;36;.923;3561000;0
15825;57172;1492;70;21;2;19;.905;3600000;0
15825;73639;1492;0;0;0;0;.00nan;0;0
15825;76628;3730;0;0;0;0;.00nan;0;0
15826;164521;4924;60;8;0;8;1.000;390000;0
15826;181910;760;77;25;1;24;.960;3600000;0
15826;56037;760;0;0;0;0;.00nan;0;0
15826;158630;4924;45;38;6;32;.842;3210000;0
15827;177124;2199;66;14;1;13;.929;3600000;0
15827;49581;775;94;41;2;39;.951;3567000;0
15827;71485;775;0;0;0;0;.00nan;0;0
15827;149221;2199;0;0;0;0;.00nan;0;0
15828;359;774;53;17;2;15;.882;3600000;0
15828;3957;4923;0;0;0;0;.00nan;0;0
15828;91194;774;0;0;0;0;.00nan;0;0
15828;148508;4923;66;30;3;27;.900;3581000;0
15829;147;767;65;40;4;36;.900;3900000;0
15829;81691;762;74;33;4;29;.879;3900000;0
15829;82228;767;0;0;0;0;.00nan;0;0
15829;146249;762;0;0;0;0;.00nan;0;0
15830;3075;754;67;28;2;26;.929;3582000;0
15830;11627;1503;0;0;0;0;.00nan;0;0
15830;67122;1503;100;26;0;26;1.000;3600000;0
15830;87758;754;0;0;0;0;.00nan;0;0
15831;49815;3721;67;37;3;34;.919;3600000;0
15831;49935;746;100;38;0;38;1.000;3600000;0
15831;67818;3721;0;0;0;0;.00nan;0;0
15831;149119;746;0;0;0;0;.00nan;0;0
15832;3075;754;0;0;0;0;.00nan;0;0
15832;170547;769;92;47;3;44;.936;3792000;0
15832;87758;754;84;36;2;34;.944;3792000;0
15832;154296;769;0;0;0;0;.00nan;0;0
15833;180990;772;30;34;7;27;.794;3600000;0
15833;57172;1492;72;32;3;29;.906;3600000;0
15833;73639;1492;0;0;0;0;.00nan;0;0
15833;94018;772;0;0;0;0;.00nan;0;0
15834;177124;2199;0;0;0;0;.00nan;0;0
15834;76406;4989;0;0;0;0;.00nan;0;0
15834;148691;4989;96;34;1;33;.971;3600000;0
15834;149221;2199;65;41;4;37;.902;3600000;0
15835;359;774;95;25;0;25;1.000;3600000;0
15835;164424;750;95;30;1;29;.967;3600000;0
15835;67446;750;0;0;0;0;.00nan;0;0
15835;91194;774;0;0;0;0;.00nan;0;0
15836;504;3730;68;36;4;32;.889;3600000;0
15836;180738;755;83;16;0;16;1.000;3600000;0
15836;76628;3730;0;0;0;0;.00nan;0;0
15836;149112;755;0;0;0;0;.00nan;0;0
15837;170548;758;0;0;0;0;.00nan;0;0
15837;85395;758;93;48;3;45;.938;3600000;0
15837;93756;1497;0;0;0;0;.00nan;0;0
15837;149191;1497;48;24;4;20;.833;3578000;0
15838;2140;1093;0;0;0;0;.00nan;0;0
15838;181910;760;54;30;4;26;.867;3900000;0
15838;56037;760;0;0;0;0;.00nan;0;0
15838;68233;1093;54;39;4;35;.897;3900000;0
15839;595;3913;100;29;0;29;1.000;3600000;0
15839;164521;4924;0;0;0;0;.00nan;0;0
15839;149280;3913;0;0;0;0;.00nan;0;0
15839;158630;4924;47;33;5;28;.848;3600000;0
15840;147;767;100;20;0;20;1.000;3600000;0
15840;49581;775;91;42;3;39;.929;3600000;0
15840;71485;775;0;0;0;0;.00nan;0;0
15840;82228;767;0;0;0;0;.00nan;0;0
15841;3241;768;0;0;0;0;.00nan;0;0
15841;3957;4923;75;39;3;36;.923;3549000;0
15841;86099;768;54;16;2;14;.875;3600000;0
15841;148508;4923;0;0;0;0;.00nan;0;0
15842;-1;911;0;0;0;0;.00nan;0;0
15842;180177;911;60;25;2;23;.920;3520000;0
15842;81691;762;0;0;0;0;.00nan;0;0
15842;146249;762;100;27;0;27;1.000;3600000;0
15843;175593;2545;0;0;0;0;.00nan;0;0
15843;49815;3721;0;0;0;0;.00nan;0;0
15843;67818;3721;49;24;3;21;.875;3553000;0
15843;94134;2545;98;49;2;47;.959;3600000;0
15844;147;767;81;32;2;30;.938;3890000;0
15844;76406;4989;0;0;0;0;.00nan;0;0
15844;82228;767;0;0;0;0;.00nan;0;0
15844;148691;4989;98;40;1;39;.975;3890000;0
15845;3241;768;0;0;0;0;.00nan;0;0
15845;164424;750;0;0;0;0;.00nan;0;0
15845;67446;750;66;48;5;43;.896;3600000;0
15845;86099;768;57;12;1;11;.917;3600000;0
15846;359;774;34;31;6;25;.806;2861000;0
15846;63932;2197;0;0;0;0;.00nan;0;0
15846;91194;774;54;4;0;4;1.000;718000;0
15846;94508;2197;45;27;5;22;.815;3600000;0
15847;177124;2199;64;23;2;21;.913;3600000;0
15847;170548;758;0;0;0;0;.00nan;0;0
15847;85395;758;66;29;3;26;.897;3543000;0
15847;149221;2199;0;0;0;0;.00nan;0;0
15848;595;3913;99;43;2;41;.953;3600000;0
15848;2140;1093;60;24;3;21;.875;3600000;0
15848;68233;1093;0;0;0;0;.00nan;0;0
15848;149280;3913;0;0;0;0;.00nan;0;0
15849;164521;4924;0;0;0;0;.00nan;0;0
15849;11627;1503;0;0;0;0;.00nan;0;0
15849;67122;1503;99;25;0;25;1.000;3600000;0
15849;158630;4924;51;36;5;31;.861;3600000;0
15850;-1;911;0;0;0;0;.00nan;0;0
15850;180177;911;35;23;4;19;.826;3600000;0
15850;49581;775;0;0;0;0;.00nan;0;0
15850;71485;775;72;37;3;34;.919;3600000;0
15851;3957;4923;0;0;0;0;.00nan;0;0
15851;174894;766;0;0;0;0;.00nan;0;0
15851;43720;766;75;33;3;30;.909;3900000;0
15851;148508;4923;86;39;3;36;.923;3900000;0
15852;10931;759;0;0;0;0;.00nan;0;0
15852;49815;3721;0;0;0;0;.00nan;0;0
15852;66993;759;66;26;3;23;.885;3688000;0
15852;67818;3721;75;29;2;27;.931;3688000;0
15853;175593;2545;0;0;0;0;.00nan;0;0
15853;49935;746;73;26;2;24;.923;3600000;0
15853;94134;2545;100;43;1;42;.977;3600000;0
15853;149119;746;0;0;0;0;.00nan;0;0
15854;-1;911;0;0;0;0;.00nan;0;0
15854;180177;911;69;27;3;24;.889;3600000;0
15854;76406;4989;44;28;5;23;.821;3538000;0
15854;148691;4989;0;0;0;0;.00nan;0;0
15855;164424;750;59;26;3;23;.885;3545000;0
15855;174894;766;0;0;0;0;.00nan;0;0
15855;43720;766;83;39;2;37;.949;3600000;0
15855;67446;750;0;0;0;0;.00nan;0;0
15856;3241;768;0;0;0;0;.00nan;0;0
15856;63932;2197;97;52;1;51;.981;3900000;0
15856;86099;768;82;21;1;20;.952;3900000;0
15856;94508;2197;0;0;0;0;.00nan;0;0
15857;147;767;93;32;1;31;.969;3589000;0
15857;170548;758;0;0;0;0;.00nan;0;0
15857;82228;767;0;0;0;0;.00nan;0;0
15857;85395;758;100;30;0;30;1.000;3600000;0
15858;181910;760;33;27;5;22;.815;3559000;0
15858;56037;760;0;0;0;0;.00nan;0;0
15858;81691;762;77;19;1;18;.947;3161000;0
15858;146249;762;25;4;3;1;.250;439000;0
15859;2140;1093;65;27;3;24;.889;3600000;0
15859;11627;1503;0;0;0;0;.00nan;0;0
15859;67122;1503;38;28;5;23;.821;3586000;0
15859;68233;1093;0;0;0;0;.00nan;0;0
15860;164521;4924;0;0;0;0;.00nan;0;0
15860;170547;769;100;27;1;26;.963;3900000;0
15860;154296;769;0;0;0;0;.00nan;0;0
15860;158630;4924;90;30;1;29;.967;3900000;0
15861;359;774;63;19;2;17;.895;3600000;0
15861;3075;754;85;43;3;40;.930;3600000;0
15861;87758;754;0;0;0;0;.00nan;0;0
15861;91194;774;0;0;0;0;.00nan;0;0
15862;10931;759;0;0;0;0;.00nan;0;0
15862;49935;746;80;33;2;31;.939;3841000;0
15862;66993;759;74;34;3;31;.912;3841000;0
15862;149119;746;0;0;0;0;.00nan;0;0
15863;174894;766;0;0;0;0;.00nan;0;0
15863;43720;766;53;36;5;31;.861;3600000;0
15863;63932;2197;49;24;4;20;.833;3600000;0
15863;94508;2197;0;0;0;0;.00nan;0;0
15864;-1;911;0;0;0;0;.00nan;0;0
15864;170548;758;0;0;0;0;.00nan;0;0
15864;180177;911;56;30;4;26;.867;3600000;0
15864;85395;758;56;23;3;20;.870;3600000;0
15865;181910;760;64;20;2;18;.900;3900000;0
15865;49581;775;100;43;2;41;.953;3900000;0
15865;56037;760;0;0;0;0;.00nan;0;0
15865;71485;775;0;0;0;0;.00nan;0;0
15866;2140;1093;72;22;1;21;.955;3900000;0
15866;170547;769;0;0;0;0;.00nan;0;0
15866;68233;1093;0;0;0;0;.00nan;0;0
15866;154296;769;91;33;1;32;.970;3900000;0
15867;177124;2199;0;0;0;0;.00nan;0;0
15867;180738;755;72;42;5;37;.881;3600000;0
15867;149112;755;0;0;0;0;.00nan;0;0
15867;149221;2199;97;32;1;31;.969;3600000;0
15868;3075;754;57;49;6;43;.878;3347000;0
15868;3241;768;0;0;0;0;.00nan;0;0
15868;86099;768;43;19;3;16;.842;3600000;0
15868;87758;754;48;3;1;2;.667;253000;0
15869;57172;1492;63;23;2;21;.913;3600000;0
15869;73639;1492;0;0;0;0;.00nan;0;0
15869;93756;1497;47;28;4;24;.857;3551000;0
15869;149191;1497;0;0;0;0;.00nan;0;0
15870;595;3913;73;33;3;30;.909;3569000;0
15870;81691;762;90;38;2;36;.947;3600000;0
15870;146249;762;0;0;0;0;.00nan;0;0
15870;149280;3913;0;0;0;0;.00nan;0;0
15871;3957;4923;34;5;2;3;.600;383000;0
15871;49815;3721;58;19;3;16;.842;3600000;0
15871;67818;3721;0;0;0;0;.00nan;0;0
15871;148508;4923;50;44;6;38;.864;3217000;0
15872;10931;759;0;0;0;0;.00nan;0;0
15872;175593;2545;0;0;0;0;.00nan;0;0
15872;66993;759;38;28;5;23;.821;3585000;0
15872;94134;2545;52;28;4;24;.857;3600000;0
15873;147;767;79;35;3;32;.914;3566000;0
15873;180738;755;86;30;2;28;.933;3600000;0
15873;82228;767;0;0;0;0;.00nan;0;0
15873;149112;755;0;0;0;0;.00nan;0;0
15874;181910;760;0;0;0;0;.00nan;0;0
15874;56037;760;74;33;3;30;.909;3553000;0
15874;76406;4989;0;0;0;0;.00nan;0;0
15874;148691;4989;93;30;1;29;.967;3600000;0
15875;177124;2199;78;41;3;38;.927;3566000;0
15875;57172;1492;68;24;2;22;.917;3600000;0
15875;73639;1492;0;0;0;0;.00nan;0;0
15875;149221;2199;0;0;0;0;.00nan;0;0
15876;3075;754;99;40;1;39;.975;3600000;0
15876;174894;766;0;0;0;0;.00nan;0;0
15876;43720;766;72;33;2;31;.939;3593000;0
15876;87758;754;0;0;0;0;.00nan;0;0
15877;504;3730;70;25;2;23;.920;3600000;0
15877;76628;3730;0;0;0;0;.00nan;0;0
15877;93756;1497;0;0;0;0;.00nan;0;0
15877;149191;1497;57;29;4;25;.862;3533000;0
15878;595;3913;79;27;1;26;.963;3600000;0
15878;49581;775;72;36;4;32;.889;3600000;0
15878;71485;775;0;0;0;0;.00nan;0;0
15878;149280;3913;0;0;0;0;.00nan;0;0
15879;11627;1503;69;43;5;38;.884;3600000;0
15879;67122;1503;0;0;0;0;.00nan;0;0
15879;81691;762;87;26;1;25;.962;3600000;0
15879;146249;762;0;0;0;0;.00nan;0;0
15880;164424;750;99;32;1;31;.969;3600000;0
15880;49815;3721;0;0;0;0;.00nan;0;0
15880;67446;750;0;0;0;0;.00nan;0;0
15880;67818;3721;69;32;2;30;.938;3559000;0
15881;359;774;75;27;2;25;.926;3600000;0
15881;164521;4924;0;0;0;0;.00nan;0;0
15881;91194;774;0;0;0;0;.00nan;0;0
15881;158630;4924;64;33;3;30;.909;3562000;0
15882;3957;4923;0;0;0;0;.00nan;0;0
15882;49935;746;53;20;2;18;.900;3545000;0
15882;148508;4923;93;37;1;36;.973;3600000;0
15882;149119;746;0;0;0;0;.00nan;0;0
15883;170547;769;0;0;0;0;.00nan;0;0
15883;81691;762;70;29;3;26;.897;3600000;0
15883;146249;762;0;0;0;0;.00nan;0;0
15883;154296;769;69;41;4;37;.902;3600000;0
15884;147;767;70;26;2;24;.923;3600000;0
15884;57172;1492;100;38;1;37;.974;3600000;0
15884;73639;1492;0;0;0;0;.00nan;0;0
15884;82228;767;0;0;0;0;.00nan;0;0
15885;170548;758;0;0;0;0;.00nan;0;0
15885;181910;760;67;23;2;21;.913;3600000;0
15885;56037;760;0;0;0;0;.00nan;0;0
15885;85395;758;61;38;4;34;.895;3600000;0
15886;504;3730;45;40;6;34;.850;3600000;0
15886;177124;2199;0;0;0;0;.00nan;0;0
15886;76628;3730;0;0;0;0;.00nan;0;0
15886;149221;2199;84;22;1;21;.955;3600000;0
15887;180990;772;79;49;4;45;.918;3600000;0
15887;93756;1497;0;0;0;0;.00nan;0;0
15887;94018;772;0;0;0;0;.00nan;0;0
15887;149191;1497;70;16;1;15;.938;3600000;0
15888;595;3913;74;22;1;21;.955;3600000;0
15888;76406;4989;0;0;0;0;.00nan;0;0
15888;148691;4989;57;31;4;27;.871;3600000;0
15888;149280;3913;0;0;0;0;.00nan;0;0
15889;-1;911;0;0;0;0;.00nan;0;0
15889;180177;911;97;50;2;48;.960;3900000;0
15889;180738;755;0;0;0;0;.00nan;0;0
15889;149112;755;72;21;2;19;.905;3900000;0
15890;11627;1503;0;0;0;0;.00nan;0;0
15890;49581;775;91;41;1;40;.976;3600000;0
15890;67122;1503;57;21;3;18;.857;3534000;0
15890;71485;775;0;0;0;0;.00nan;0;0
15891;3957;4923;0;0;0;0;.00nan;0;0
15891;10931;759;0;0;0;0;.00nan;0;0
15891;66993;759;63;23;2;21;.913;3600000;0
15891;148508;4923;79;47;4;43;.915;3600000;0
15892;3241;768;0;0;0;0;.00nan;0;0
15892;164521;4924;0;0;0;0;.00nan;0;0
15892;86099;768;78;21;1;20;.952;3600000;0
15892;158630;4924;75;38;3;35;.921;3573000;0
15893;49815;3721;0;0;0;0;.00nan;0;0
15893;63932;2197;69;33;4;29;.879;3600000;0
15893;67818;3721;86;34;1;33;.971;3600000;0
15893;94508;2197;0;0;0;0;.00nan;0;0
15894;359;774;100;30;1;29;.967;3900000;0
15894;2140;1093;78;23;1;22;.957;3900000;0
15894;68233;1093;0;0;0;0;.00nan;0;0
15894;91194;774;0;0;0;0;.00nan;0;0
15895;164424;750;46;23;3;20;.870;3900000;0
15895;49935;746;74;30;3;27;.900;3900000;0
15895;67446;750;0;0;0;0;.00nan;0;0
15895;149119;746;0;0;0;0;.00nan;0;0
15896;170547;769;62;29;3;26;.897;3900000;0
15896;49581;775;100;57;3;54;.947;3900000;0
15896;71485;775;0;0;0;0;.00nan;0;0
15896;154296;769;0;0;0;0;.00nan;0;0
15897;147;767;18;16;5;11;.688;3600000;0
15897;504;3730;0;0;0;0;.00nan;0;0
15897;76628;3730;83;38;3;35;.921;3600000;0
15897;82228;767;0;0;0;0;.00nan;0;0
15898;177124;2199;67;31;3;28;.903;3588000;0
15898;180990;772;0;0;0;0;.00nan;0;0
15898;94018;772;90;33;2;31;.939;3600000;0
15898;149221;2199;0;0;0;0;.00nan;0;0
15899;180738;755;50;23;3;20;.870;3536000;0
15899;93756;1497;0;0;0;0;.00nan;0;0
15899;149112;755;0;0;0;0;.00nan;0;0
15899;149191;1497;86;29;1;28;.966;3600000;0
15900;595;3913;0;0;0;0;.00nan;0;0
15900;170548;758;0;0;0;0;.00nan;0;0
15900;85395;758;75;21;1;20;.952;3600000;0
15900;149280;3913;69;42;4;38;.905;3600000;0
15901;-1;911;0;0;0;0;.00nan;0;0
15901;180177;911;98;34;1;33;.971;3600000;0
15901;57172;1492;46;22;4;18;.818;3600000;0
15901;73639;1492;0;0;0;0;.00nan;0;0
15902;11627;1503;0;0;0;0;.00nan;0;0
15902;67122;1503;100;36;0;36;1.000;3600000;0
15902;76406;4989;0;0;0;0;.00nan;0;0
15902;148691;4989;66;20;2;18;.900;3514000;0
15903;164424;750;81;27;1;26;.963;3600000;0
15903;10931;759;0;0;0;0;.00nan;0;0
15903;66993;759;83;25;1;24;.960;3572000;0
15903;67446;750;0;0;0;0;.00nan;0;0
15904;2140;1093;76;36;3;33;.917;3600000;0
15904;3241;768;0;0;0;0;.00nan;0;0
15904;68233;1093;0;0;0;0;.00nan;0;0
15904;86099;768;78;24;1;23;.958;3600000;0
15905;3075;754;80;35;2;33;.943;3600000;0
15905;49815;3721;0;0;0;0;.00nan;0;0
15905;67818;3721;77;22;1;21;.955;3600000;0
15905;87758;754;0;0;0;0;.00nan;0;0
15906;164521;4924;0;0;0;0;.00nan;0;0
15906;174894;766;38;23;4;19;.826;3565000;0
15906;43720;766;0;0;0;0;.00nan;0;0
15906;158630;4924;99;49;2;47;.959;3600000;0
15907;49935;746;100;25;0;25;1.000;3600000;0
15907;63932;2197;63;33;4;29;.879;3600000;0
15907;94508;2197;0;0;0;0;.00nan;0;0
15907;149119;746;0;0;0;0;.00nan;0;0
15908;3957;4923;0;0;0;0;.00nan;0;0
15908;175593;2545;90;15;0;15;1.000;3600000;0
15908;94134;2545;0;0;0;0;.00nan;0;0
15908;148508;4923;50;25;4;21;.840;3600000;0
15909;170547;769;0;0;0;0;.00nan;0;0
15909;76406;4989;73;15;1;14;.933;2090000;0
15909;148691;4989;52;27;4;23;.852;1810000;0
15909;154296;769;55;32;5;27;.844;3900000;0
15910;147;767;74;25;2;23;.920;3600000;0
15910;180990;772;0;0;0;0;.00nan;0;0
15910;82228;767;0;0;0;0;.00nan;0;0
15910;94018;772;38;34;6;28;.824;3600000;0
15911;504;3730;52;26;4;22;.846;3565000;0
15911;-1;911;0;0;0;0;.00nan;0;0
15911;180177;911;77;29;2;27;.931;3600000;0
15911;76628;3730;0;0;0;0;.00nan;0;0
15912;11627;1503;0;0;0;0;.00nan;0;0
15912;170548;758;0;0;0;0;.00nan;0;0
15912;67122;1503;67;20;1;19;.950;3600000;0
15912;85395;758;66;32;3;29;.906;3587000;0
15913;10931;759;0;0;0;0;.00nan;0;0
15913;63932;2197;69;34;3;31;.912;3600000;0
15913;66993;759;100;34;0;34;1.000;3600000;0
15913;94508;2197;0;0;0;0;.00nan;0;0
15914;2140;1093;46;24;4;20;.833;3557000;0
15914;174894;766;0;0;0;0;.00nan;0;0
15914;43720;766;80;38;3;35;.921;3600000;0
15914;68233;1093;0;0;0;0;.00nan;0;0
15915;3075;754;70;41;4;37;.902;3600000;0
15915;49935;746;67;19;1;18;.947;3600000;0
15915;87758;754;0;0;0;0;.00nan;0;0
15915;149119;746;0;0;0;0;.00nan;0;0
15916;164424;750;79;34;2;32;.941;3600000;0
15916;175593;2545;84;31;3;28;.903;3575000;0
15916;67446;750;0;0;0;0;.00nan;0;0
15916;94134;2545;0;0;0;0;.00nan;0;0
15917;359;774;93;20;0;20;1.000;3600000;0
15917;81691;762;71;41;4;37;.902;3600000;0
15917;91194;774;0;0;0;0;.00nan;0;0
15917;146249;762;0;0;0;0;.00nan;0;0
15918;170547;769;45;24;4;20;.833;3600000;0
15918;170548;758;0;0;0;0;.00nan;0;0
15918;85395;758;70;23;1;22;.957;3600000;0
15918;154296;769;0;0;0;0;.00nan;0;0
15919;595;3913;63;27;3;24;.889;3900000;0
15919;57172;1492;0;0;0;0;.00nan;0;0
15919;73639;1492;70;32;3;29;.906;3900000;0
15919;149280;3913;0;0;0;0;.00nan;0;0
15920;-1;911;97;23;0;23;1.000;3600000;0
15920;180177;911;0;0;0;0;.00nan;0;0
15920;180990;772;0;0;0;0;.00nan;0;0
15920;94018;772;88;36;1;35;.972;3579000;0
15921;3075;754;75;39;4;35;.897;3600000;0
15921;10931;759;0;0;0;0;.00nan;0;0
15921;66993;759;77;12;0;12;1.000;3600000;0
15921;87758;754;0;0;0;0;.00nan;0;0
15922;164521;4924;62;34;4;30;.882;3600000;0
15922;49815;3721;0;0;0;0;.00nan;0;0
15922;67818;3721;67;18;1;17;.944;3600000;0
15922;158630;4924;0;0;0;0;.00nan;0;0
15923;359;774;58;23;3;20;.870;3600000;0
15923;49581;775;27;6;3;3;.500;499000;0
15923;71485;775;67;34;3;31;.912;3101000;0
15923;91194;774;0;0;0;0;.00nan;0;0
15924;175593;2545;0;0;0;0;.00nan;0;0
15924;63932;2197;72;28;2;26;.929;3528000;0
15924;94134;2545;100;27;0;27;1.000;3600000;0
15924;94508;2197;0;0;0;0;.00nan;0;0
15925;3241;768;0;0;0;0;.00nan;0;0
15925;81691;762;0;0;0;0;.00nan;0;0
15925;86099;768;65;21;2;19;.905;3600000;0
15925;146249;762;91;45;3;42;.933;3600000;0
15926;181910;760;59;32;4;28;.875;3600000;0
15926;56037;760;0;0;0;0;.00nan;0;0
15926;57172;1492;68;19;2;17;.895;3600000;0
15926;73639;1492;0;0;0;0;.00nan;0;0
15927;595;3913;96;38;2;36;.947;3900000;0
15927;180738;755;90;42;2;40;.952;3900000;0
15927;149112;755;0;0;0;0;.00nan;0;0
15927;149280;3913;0;0;0;0;.00nan;0;0
15928;504;3730;52;21;3;18;.857;3533000;0
15928;11627;1503;0;0;0;0;.00nan;0;0
15928;67122;1503;100;36;1;35;.972;3600000;0
15928;76628;3730;0;0;0;0;.00nan;0;0
15929;359;774;79;14;0;14;1.000;3600000;0
15929;76406;4989;82;47;3;44;.936;3600000;0
15929;91194;774;0;0;0;0;.00nan;0;0
15929;148691;4989;0;0;0;0;.00nan;0;0
15930;2140;1093;0;0;0;0;.00nan;0;0
15930;49815;3721;0;0;0;0;.00nan;0;0
15930;67818;3721;61;32;3;29;.906;3567000;0
15930;68233;1093;90;31;1;30;.968;3600000;0
15931;164521;4924;0;0;0;0;.00nan;0;0
15931;49935;746;74;21;1;20;.952;3600000;0
15931;149119;746;0;0;0;0;.00nan;0;0
15931;158630;4924;84;57;5;52;.912;3600000;0
15932;3241;768;0;0;0;0;.00nan;0;0
15932;49581;775;0;0;0;0;.00nan;0;0
15932;71485;775;95;45;2;43;.956;3900000;0
15932;86099;768;70;19;2;17;.895;3900000;0
15933;3075;754;49;23;3;20;.870;3574000;0
15933;175593;2545;0;0;0;0;.00nan;0;0
15933;87758;754;0;0;0;0;.00nan;0;0
15933;94134;2545;77;27;2;25;.926;3600000;0
15934;174894;766;0;0;0;0;.00nan;0;0
15934;43720;766;99;60;2;58;.967;3600000;0
15934;81691;762;52;23;3;20;.870;3574000;0
15934;146249;762;0;0;0;0;.00nan;0;0
15935;170547;769;0;0;0;0;.00nan;0;0
15935;57172;1492;60;23;3;20;.870;3600000;0
15935;73639;1492;0;0;0;0;.00nan;0;0
15935;154296;769;62;41;4;37;.902;3576000;0
15936;11627;1503;0;0;0;0;.00nan;0;0
15936;180990;772;43;17;3;14;.824;3900000;0
15936;67122;1503;72;35;3;32;.914;3900000;0
15936;94018;772;0;0;0;0;.00nan;0;0
15937;3957;4923;0;0;0;0;.00nan;0;0
15937;164424;750;61;5;0;5;1.000;340000;0
15937;67446;750;30;32;6;26;.813;3260000;0
15937;148508;4923;98;40;1;39;.975;3600000;0
15938;180738;755;0;0;0;0;.00nan;0;0
15938;181910;760;0;0;0;0;.00nan;0;0
15938;56037;760;66;37;4;33;.892;3588000;0
15938;149112;755;59;27;3;24;.889;3600000;0
15939;504;3730;0;0;0;0;.00nan;0;0
15939;595;3913;60;34;4;30;.882;3600000;0
15939;76628;3730;40;29;5;24;.828;3583000;0
15939;149280;3913;0;0;0;0;.00nan;0;0
15940;147;767;85;33;2;31;.939;3600000;0
15940;177124;2199;0;0;0;0;.00nan;0;0
15940;82228;767;0;0;0;0;.00nan;0;0
15940;149221;2199;97;51;3;48;.941;3582000;0
15941;-1;911;85;33;1;32;.970;3600000;0
15941;180177;911;0;0;0;0;.00nan;0;0
15941;93756;1497;76;31;2;29;.935;3552000;0
15941;149191;1497;0;0;0;0;.00nan;0;0
15942;3241;768;0;0;0;0;.00nan;0;0
15942;76406;4989;0;0;0;0;.00nan;0;0
15942;86099;768;100;27;0;27;1.000;3600000;0
15942;148691;4989;68;32;3;29;.906;3600000;0
15943;359;774;100;24;0;24;1.000;3600000;0
15943;170548;758;65;37;4;33;.892;3600000;0
15943;85395;758;0;0;0;0;.00nan;0;0
15943;91194;774;0;0;0;0;.00nan;0;0
15944;2140;1093;57;29;4;25;.862;3600000;0
15944;49935;746;100;24;0;24;1.000;3600000;0
15944;68233;1093;0;0;0;0;.00nan;0;0
15944;149119;746;0;0;0;0;.00nan;0;0
15945;164521;4924;0;0;0;0;.00nan;0;0
15945;10931;759;0;0;0;0;.00nan;0;0
15945;66993;759;89;15;0;15;1.000;3600000;0
15945;158630;4924;59;41;5;36;.878;3600000;0
15946;174894;766;0;0;0;0;.00nan;0;0
15946;43720;766;48;19;3;16;.842;3600000;0
15946;49581;775;56;47;6;41;.872;2657000;0
15946;71485;775;63;10;0;10;1.000;943000;0
15947;11627;1503;0;0;0;0;.00nan;0;0
15947;57172;1492;79;26;1;25;.962;3580000;0
15947;67122;1503;100;34;0;34;1.000;3600000;0
15947;73639;1492;0;0;0;0;.00nan;0;0
15948;595;3913;64;26;3;23;.885;3821000;0
15948;180990;772;62;38;4;34;.895;3821000;0
15948;94018;772;0;0;0;0;.00nan;0;0
15948;149280;3913;0;0;0;0;.00nan;0;0
15949;170547;769;88;32;1;31;.969;3600000;0
15949;180738;755;66;23;2;21;.913;3600000;0
15949;149112;755;0;0;0;0;.00nan;0;0
15949;154296;769;0;0;0;0;.00nan;0;0
15950;504;3730;100;27;0;27;1.000;3600000;0
15950;181910;760;85;36;2;34;.944;3600000;0
15950;56037;760;0;0;0;0;.00nan;0;0
15950;76628;3730;0;0;0;0;.00nan;0;0
15951;3957;4923;0;0;0;0;.00nan;0;0
15951;63932;2197;71;26;3;23;.885;3600000;0
15951;94508;2197;0;0;0;0;.00nan;0;0
15951;148508;4923;53;35;5;30;.857;3569000;0
15952;177124;2199;53;29;4;25;.862;3514000;0
15952;-1;911;0;0;0;0;.00nan;0;0
15952;180177;911;83;35;2;33;.943;3600000;0
15952;149221;2199;0;0;0;0;.00nan;0;0
15953;147;767;55;31;4;27;.871;3600000;0
15953;82228;767;0;0;0;0;.00nan;0;0
15953;93756;1497;0;0;0;0;.00nan;0;0
15953;149191;1497;97;28;0;28;1.000;3600000;0
15954;174894;766;0;0;0;0;.00nan;0;0
15954;43720;766;71;27;2;25;.926;3553000;0
15954;76406;4989;0;0;0;0;.00nan;0;0
15954;148691;4989;100;32;1;31;.969;3600000;0
15955;3241;768;0;0;0;0;.00nan;0;0
15955;170548;758;0;0;0;0;.00nan;0;0
15955;85395;758;54;41;6;35;.854;3600000;0
15955;86099;768;86;13;0;13;1.000;3600000;0
15956;2140;1093;90;48;4;44;.917;3600000;0
15956;10931;759;0;0;0;0;.00nan;0;0
15956;66993;759;18;16;6;10;.625;3581000;0
15956;68233;1093;0;0;0;0;.00nan;0;0
15957;164521;4924;0;0;0;0;.00nan;0;0
15957;175593;2545;0;0;0;0;.00nan;0;0
15957;94134;2545;60;33;4;29;.879;3600000;0
15957;158630;4924;99;38;1;37;.974;3600000;0
15958;180990;772;85;31;1;30;.968;3600000;0
15958;181910;760;0;0;0;0;.00nan;0;0
15958;56037;760;40;22;4;18;.818;3600000;0
15958;94018;772;0;0;0;0;.00nan;0;0
15959;11627;1503;0;0;0;0;.00nan;0;0
15959;180738;755;85;26;1;25;.962;3600000;0
15959;67122;1503;66;22;2;20;.909;3600000;0
15959;149112;755;0;0;0;0;.00nan;0;0
15960;504;3730;78;32;2;30;.938;3900000;0
15960;170547;769;0;0;0;0;.00nan;0;0
15960;76628;3730;0;0;0;0;.00nan;0;0
15960;154296;769;77;22;2;20;.909;3900000;0
15961;164424;750;51;22;4;18;.818;3600000;0
15961;63932;2197;78;24;1;23;.958;3600000;0
15961;67446;750;0;0;0;0;.00nan;0;0
15961;94508;2197;0;0;0;0;.00nan;0;0
15962;49815;3721;59;24;3;21;.875;3514000;0
15962;67818;3721;0;0;0;0;.00nan;0;0
15962;81691;762;99;46;1;45;.978;3600000;0
15962;146249;762;0;0;0;0;.00nan;0;0
15963;3075;754;76;21;1;20;.952;3600000;0
15963;3957;4923;0;0;0;0;.00nan;0;0
15963;87758;754;0;0;0;0;.00nan;0;0
15963;148508;4923;51;35;5;30;.857;3600000;0
15964;170548;758;0;0;0;0;.00nan;0;0
15964;174894;766;0;0;0;0;.00nan;0;0
15964;43720;766;77;33;2;31;.939;3600000;0
15964;85395;758;50;28;4;24;.857;3566000;0
15965;2140;1093;72;26;2;24;.923;3600000;0
15965;175593;2545;54;7;0;7;1.000;999000;0
15965;68233;1093;0;0;0;0;.00nan;0;0
15965;94134;2545;29;26;6;20;.769;2601000;0
15966;170547;769;89;37;2;35;.946;3560000;0
15966;180990;772;74;22;1;21;.955;3600000;0
15966;94018;772;0;0;0;0;.00nan;0;0
15966;154296;769;0;0;0;0;.00nan;0;0
15967;49581;775;64;38;4;34;.895;3548000;0
15967;49815;3721;0;0;0;0;.00nan;0;0
15967;67818;3721;87;20;2;18;.900;3600000;0
15967;71485;775;0;0;0;0;.00nan;0;0
15968;3075;754;0;0;0;0;.00nan;0;0
15968;164424;750;69;25;3;22;.880;3600000;0
15968;67446;750;0;0;0;0;.00nan;0;0
15968;87758;754;96;37;1;36;.973;3600000;0
15969;359;774;65;33;4;29;.879;3540000;0
15969;57172;1492;76;28;2;26;.929;3600000;0
15969;73639;1492;0;0;0;0;.00nan;0;0
15969;91194;774;0;0;0;0;.00nan;0;0
15970;49935;746;83;28;1;27;.964;3600000;0
15970;81691;762;70;36;3;33;.917;3550000;0
15970;146249;762;0;0;0;0;.00nan;0;0
15970;149119;746;0;0;0;0;.00nan;0;0
15971;595;3913;100;30;0;30;1.000;3863000;0
15971;177124;2199;0;0;0;0;.00nan;0;0
15971;149221;2199;89;28;1;27;.964;3863000;0
15971;149280;3913;0;0;0;0;.00nan;0;0
15972;10931;759;92;21;0;21;1.000;3600000;0
15972;66993;759;0;0;0;0;.00nan;0;0
15972;81691;762;62;38;4;34;.895;3600000;0
15972;146249;762;0;0;0;0;.00nan;0;0
15973;3241;768;0;0;0;0;.00nan;0;0
15973;57172;1492;59;46;6;40;.870;3600000;0
15973;73639;1492;0;0;0;0;.00nan;0;0
15973;86099;768;100;23;0;23;1.000;3600000;0
15974;49815;3721;0;0;0;0;.00nan;0;0
15974;67818;3721;80;29;2;27;.931;3600000;0
15974;76406;4989;0;0;0;0;.00nan;0;0
15974;148691;4989;50;28;4;24;.857;3546000;0
15975;359;774;77;23;1;22;.957;3600000;0
15975;180738;755;73;34;3;31;.912;3578000;0
15975;91194;774;0;0;0;0;.00nan;0;0
15975;149112;755;0;0;0;0;.00nan;0;0
15976;3957;4923;0;0;0;0;.00nan;0;0
15976;164521;4924;0;0;0;0;.00nan;0;0
15976;148508;4923;71;23;2;21;.913;3600000;0
15976;158630;4924;92;46;3;43;.935;3600000;0
15977;49581;775;82;49;4;45;.918;3600000;0
15977;49935;746;99;31;1;30;.968;3600000;0
15977;71485;775;0;0;0;0;.00nan;0;0
15977;149119;746;0;0;0;0;.00nan;0;0
15978;177124;2199;66;27;2;25;.926;3600000;0
15978;181910;760;48;26;3;23;.885;3564000;0
15978;56037;760;0;0;0;0;.00nan;0;0
15978;149221;2199;0;0;0;0;.00nan;0;0
15979;595;3913;80;32;2;30;.938;3549000;0
15979;93756;1497;0;0;0;0;.00nan;0;0
15979;149191;1497;82;33;1;32;.970;3600000;0
15979;149280;3913;0;0;0;0;.00nan;0;0
15980;164424;750;0;0;0;0;.00nan;0;0
15980;164521;4924;0;0;0;0;.00nan;0;0
15980;67446;750;77;19;1;18;.947;3600000;0
15980;158630;4924;83;43;3;40;.930;3566000;0
15981;10931;759;40;15;3;12;.800;3600000;0
15981;49581;775;25;13;4;9;.692;949000;0
15981;66993;759;0;0;0;0;.00nan;0;0
15981;71485;775;88;38;2;36;.947;2651000;0
15982;3241;768;0;0;0;0;.00nan;0;0
15982;180738;755;63;48;6;42;.875;3600000;0
15982;86099;768;70;24;2;22;.917;3600000;0
15982;149112;755;0;0;0;0;.00nan;0;0
15983;170548;758;0;0;0;0;.00nan;0;0
15983;49815;3721;0;0;0;0;.00nan;0;0
15983;67818;3721;67;31;3;28;.903;3567000;0
15983;85395;758;74;24;1;23;.958;3600000;0
15984;174894;766;47;42;6;36;.857;3576000;0
15984;43720;766;0;0;0;0;.00nan;0;0
15984;57172;1492;63;28;4;24;.857;3600000;0
15984;73639;1492;0;0;0;0;.00nan;0;0
15985;359;774;61;22;2;20;.909;3600000;0
15985;180990;772;0;0;0;0;.00nan;0;0
15985;91194;774;0;0;0;0;.00nan;0;0
15985;94018;772;46;26;4;22;.846;3553000;0
15986;2140;1093;70;36;4;32;.889;3583000;0
15986;3957;4923;0;0;0;0;.00nan;0;0
15986;68233;1093;0;0;0;0;.00nan;0;0
15986;148508;4923;75;32;2;30;.938;3600000;0
15987;49935;746;0;0;0;0;.00nan;0;0
15987;76406;4989;75;47;5;42;.894;3600000;0
15987;148691;4989;0;0;0;0;.00nan;0;0
15987;149119;746;92;15;0;15;1.000;3600000;0
15988;175593;2545;62;27;3;24;.889;3600000;0
15988;81691;762;40;32;5;27;.844;3580000;0
15988;94134;2545;0;0;0;0;.00nan;0;0
15988;146249;762;0;0;0;0;.00nan;0;0
15989;177124;2199;0;0;0;0;.00nan;0;0
15989;170547;769;0;0;0;0;.00nan;0;0
15989;149221;2199;95;33;0;33;1.000;3900000;0
15989;154296;769;100;45;0;45;1.000;3900000;0
15990;181910;760;0;0;0;0;.00nan;0;0
15990;56037;760;74;36;3;33;.917;3600000;0
15990;93756;1497;56;9;0;9;1.000;663000;0
15990;149191;1497;23;25;6;19;.760;2937000;0
15991;595;3913;72;22;2;20;.909;3600000;0
15991;-1;911;0;0;0;0;.00nan;0;0
15991;180177;911;37;21;4;17;.810;3540000;0
15991;149280;3913;0;0;0;0;.00nan;0;0
15992;147;767;57;35;5;30;.857;3600000;0
15992;11627;1503;63;21;1;20;.952;3600000;0
15992;67122;1503;0;0;0;0;.00nan;0;0
15992;82228;767;0;0;0;0;.00nan;0;0
15993;2140;1093;72;37;3;34;.919;3570000;0
15993;164424;750;79;21;1;20;.952;3600000;0
15993;67446;750;0;0;0;0;.00nan;0;0
15993;68233;1093;0;0;0;0;.00nan;0;0
15994;10931;759;0;0;0;0;.00nan;0;0
15994;66993;759;63;21;2;19;.905;3600000;0
15994;76406;4989;55;25;3;22;.880;3331000;0
15994;148691;4989;26;7;3;4;.571;269000;0
15995;3241;768;0;0;0;0;.00nan;0;0
15995;180990;772;87;52;4;48;.923;3600000;0
15995;86099;768;95;23;0;23;1.000;3600000;0
15995;94018;772;0;0;0;0;.00nan;0;0
15996;3075;754;58;21;2;19;.905;3600000;0
15996;164521;4924;0;0;0;0;.00nan;0;0
15996;87758;754;0;0;0;0;.00nan;0;0
15996;158630;4924;47;31;5;26;.839;3600000;0
15997;174894;766;0;0;0;0;.00nan;0;0
15997;180738;755;0;0;0;0;.00nan;0;0
15997;43720;766;78;39;3;36;.923;3600000;0
15997;149112;755;79;26;1;25;.962;3600000;0
15998;359;774;38;15;3;12;.800;3544000;0
15998;504;3730;90;38;2;36;.947;3600000;0
15998;76628;3730;0;0;0;0;.00nan;0;0
15998;91194;774;0;0;0;0;.00nan;0;0
15999;170548;758;0;0;0;0;.00nan;0;0
15999;49935;746;0;0;0;0;.00nan;0;0
15999;85395;758;86;24;1;23;.958;3600000;0
15999;149119;746;59;30;4;26;.867;3600000;0
16000;175593;2545;0;0;0;0;.00nan;0;0
16000;49581;775;91;45;3;42;.933;3518000;0
16000;71485;775;0;0;0;0;.00nan;0;0
16000;94134;2545;77;22;1;21;.955;3600000;0
16001;170547;769;0;0;0;0;.00nan;0;0
16001;93756;1497;0;0;0;0;.00nan;0;0
16001;149191;1497;87;39;1;38;.974;3600000;0
16001;154296;769;63;40;4;36;.900;3600000;0
16002;-1;911;69;31;3;28;.903;3576000;0
16002;180177;911;0;0;0;0;.00nan;0;0
16002;181910;760;70;25;2;23;.920;3600000;0
16002;56037;760;0;0;0;0;.00nan;0;0
16003;147;767;100;27;1;26;.963;3900000;0
16003;595;3913;94;32;1;31;.969;3900000;0
16003;82228;767;0;0;0;0;.00nan;0;0
16003;149280;3913;0;0;0;0;.00nan;0;0
16004;177124;2199;49;19;3;16;.842;3600000;0
16004;11627;1503;0;0;0;0;.00nan;0;0
16004;67122;1503;52;43;6;37;.860;3600000;0
16004;149221;2199;0;0;0;0;.00nan;0;0
16005;10931;759;0;0;0;0;.00nan;0;0
16005;170548;758;0;0;0;0;.00nan;0;0
16005;66993;759;68;19;2;17;.895;3600000;0
16005;85395;758;64;42;4;38;.905;3559000;0
16006;504;3730;66;37;4;33;.892;3600000;0
16006;3241;768;0;0;0;0;.00nan;0;0
16006;76628;3730;0;0;0;0;.00nan;0;0
16006;86099;768;75;10;0;10;1.000;3600000;0
16007;164521;4924;0;0;0;0;.00nan;0;0
16007;63932;2197;51;27;4;23;.852;3556000;0
16007;94508;2197;0;0;0;0;.00nan;0;0
16007;158630;4924;63;30;3;27;.900;3600000;0
16008;2140;1093;24;5;3;2;.400;318000;0
16008;3075;754;100;50;0;50;1.000;3600000;0
16008;68233;1093;76;32;3;29;.906;3282000;0
16008;87758;754;0;0;0;0;.00nan;0;0
16009;174894;766;0;0;0;0;.00nan;0;0
16009;180990;772;0;0;0;0;.00nan;0;0
16009;43720;766;84;31;1;30;.968;3900000;0
16009;94018;772;92;34;1;33;.971;3900000;0
16010;175593;2545;0;0;0;0;.00nan;0;0
16010;76406;4989;0;0;0;0;.00nan;0;0
16010;94134;2545;91;36;3;33;.917;3900000;0
16010;148691;4989;62;22;3;19;.864;3900000;0
16011;-1;911;0;0;0;0;.00nan;0;0
16011;170547;769;59;21;2;19;.905;3900000;0
16011;180177;911;82;38;2;36;.947;3900000;0
16011;154296;769;0;0;0;0;.00nan;0;0
16012;147;767;30;26;5;21;.808;3576000;0
16012;181910;760;0;0;0;0;.00nan;0;0
16012;56037;760;73;39;3;36;.923;3600000;0
16012;82228;767;0;0;0;0;.00nan;0;0
16013;11627;1503;0;0;0;0;.00nan;0;0
16013;67122;1503;62;36;4;32;.889;3600000;0
16013;93756;1497;0;0;0;0;.00nan;0;0
16013;149191;1497;86;32;1;31;.969;3600000;0
16014;49935;746;81;27;1;26;.963;3600000;0
16014;57172;1492;0;0;0;0;.00nan;0;0
16014;73639;1492;47;38;5;33;.868;3600000;0
16014;149119;746;0;0;0;0;.00nan;0;0
16015;180738;755;34;24;4;20;.833;3514000;0
16015;49815;3721;0;0;0;0;.00nan;0;0
16015;67818;3721;77;29;2;27;.931;3600000;0
16015;149112;755;0;0;0;0;.00nan;0;0
16016;2140;1093;68;34;4;30;.882;3543000;0
16016;63932;2197;66;25;3;22;.880;3600000;0
16016;68233;1093;0;0;0;0;.00nan;0;0
16016;94508;2197;0;0;0;0;.00nan;0;0
16017;504;3730;70;36;4;32;.889;3900000;0
16017;174894;766;0;0;0;0;.00nan;0;0
16017;43720;766;36;22;4;18;.818;3900000;0
16017;76628;3730;0;0;0;0;.00nan;0;0
16018;170548;758;0;0;0;0;.00nan;0;0
16018;175593;2545;0;0;0;0;.00nan;0;0
16018;85395;758;90;21;0;21;1.000;3600000;0
16018;94134;2545;48;28;4;24;.857;3600000;0
16019;147;767;55;21;3;18;.857;3600000;0
16019;170547;769;0;0;0;0;.00nan;0;0
16019;82228;767;0;0;0;0;.00nan;0;0
16019;154296;769;61;43;5;38;.884;3550000;0
16020;595;3913;69;34;4;30;.882;3859000;0
16020;181910;760;0;0;0;0;.00nan;0;0
16020;56037;760;67;41;4;37;.902;3900000;0
16020;149280;3913;0;0;0;0;.00nan;0;0
16021;164424;750;66;15;1;14;.933;3600000;0
16021;49581;775;0;0;0;0;.00nan;0;0
16021;67446;750;0;0;0;0;.00nan;0;0
16021;71485;775;72;41;4;37;.902;3600000;0
16022;3957;4923;0;0;0;0;.00nan;0;0
16022;81691;762;0;0;0;0;.00nan;0;0
16022;146249;762;57;29;3;26;.897;3798000;0
16022;148508;4923;55;32;4;28;.875;3823000;0
16023;11627;1503;0;0;0;0;.00nan;0;0
16023;-1;911;0;0;0;0;.00nan;0;0
16023;180177;911;82;24;1;23;.958;3600000;0
16023;67122;1503;42;35;6;29;.829;3600000;0
16024;49815;3721;0;0;0;0;.00nan;0;0
16024;57172;1492;92;30;1;29;.967;3600000;0
16024;67818;3721;81;33;2;31;.939;3600000;0
16024;73639;1492;0;0;0;0;.00nan;0;0
16025;180990;772;95;32;1;31;.969;3578000;0
16025;49935;746;88;16;0;16;1.000;3600000;0
16025;94018;772;0;0;0;0;.00nan;0;0
16025;149119;746;0;0;0;0;.00nan;0;0
16026;10931;759;0;0;0;0;.00nan;0;0
16026;180738;755;0;0;0;0;.00nan;0;0
16026;66993;759;85;25;1;24;.960;3600000;0
16026;149112;755;59;38;5;33;.868;3600000;0
16027;359;774;87;33;2;31;.939;3900000;0
16027;177124;2199;89;35;2;33;.943;3900000;0
16027;91194;774;0;0;0;0;.00nan;0;0
16027;149221;2199;0;0;0;0;.00nan;0;0
16028;3075;754;72;24;1;23;.958;3544000;0
16028;76406;4989;97;23;0;23;1.000;3600000;0
16028;87758;754;0;0;0;0;.00nan;0;0
16028;148691;4989;0;0;0;0;.00nan;0;0
16029;3957;4923;0;0;0;0;.00nan;0;0
16029;49581;775;100;36;1;35;.972;3600000;0
16029;71485;775;0;0;0;0;.00nan;0;0
16029;148508;4923;79;43;3;40;.930;3521000;0
16030;164424;750;49;18;3;15;.833;3547000;0
16030;67446;750;0;0;0;0;.00nan;0;0
16030;81691;762;100;43;1;42;.977;3600000;0
16030;146249;762;0;0;0;0;.00nan;0;0
16031;10931;759;0;0;0;0;.00nan;0;0
16031;57172;1492;71;30;2;28;.933;3600000;0
16031;66993;759;51;33;5;28;.848;3600000;0
16031;73639;1492;0;0;0;0;.00nan;0;0
16032;180990;772;89;34;2;32;.941;3600000;0
16032;49815;3721;0;0;0;0;.00nan;0;0
16032;67818;3721;64;28;3;25;.893;3600000;0
16032;94018;772;0;0;0;0;.00nan;0;0
16033;175593;2545;0;0;0;0;.00nan;0;0
16033;180738;755;79;37;2;35;.946;3600000;0
16033;94134;2545;85;28;1;27;.964;3600000;0
16033;149112;755;0;0;0;0;.00nan;0;0
16034;504;3730;98;60;4;56;.933;3600000;0
16034;49935;746;62;22;2;20;.909;3600000;0
16034;76628;3730;0;0;0;0;.00nan;0;0
16034;149119;746;0;0;0;0;.00nan;0;0
16035;177124;2199;0;0;0;0;.00nan;0;0
16035;3241;768;0;0;0;0;.00nan;0;0
16035;86099;768;94;40;4;36;.900;3900000;0
16035;149221;2199;64;37;4;33;.892;3900000;0
16036;359;774;50;21;3;18;.857;3594000;0
16036;91194;774;0;0;0;0;.00nan;0;0
16036;93756;1497;0;0;0;0;.00nan;0;0
16036;149191;1497;94;40;2;38;.950;3600000;0
16037;3957;4923;0;0;0;0;.00nan;0;0
16037;76406;4989;83;29;2;27;.931;3600000;0
16037;148508;4923;39;21;4;17;.810;3572000;0
16037;148691;4989;0;0;0;0;.00nan;0;0
16038;164424;750;52;28;4;24;.857;3547000;0
16038;170548;758;0;0;0;0;.00nan;0;0
16038;67446;750;0;0;0;0;.00nan;0;0
16038;85395;758;68;29;3;26;.897;3600000;0
16039;170547;769;0;0;0;0;.00nan;0;0
16039;181910;760;0;0;0;0;.00nan;0;0
16039;56037;760;73;34;3;31;.912;3519000;0
16039;154296;769;83;24;1;23;.958;3600000;0
16040;3075;754;75;20;1;19;.950;3600000;0
16040;49581;775;67;43;5;38;.884;3600000;0
16040;71485;775;0;0;0;0;.00nan;0;0
16040;87758;754;0;0;0;0;.00nan;0;0
16041;63932;2197;82;23;1;22;.957;3600000;0
16041;81691;762;32;16;4;12;.750;1135000;0
16041;94508;2197;0;0;0;0;.00nan;0;0
16041;146249;762;80;27;1;26;.963;2465000;0
16042;175593;2545;0;0;0;0;.00nan;0;0
16042;57172;1492;67;24;2;22;.917;3600000;0
16042;73639;1492;0;0;0;0;.00nan;0;0
16042;94134;2545;59;27;3;24;.889;3558000;0
16043;10931;759;0;0;0;0;.00nan;0;0
16043;180990;772;38;33;6;27;.818;3289000;0
16043;66993;759;91;32;1;31;.969;3600000;0
16043;94018;772;53;4;0;4;1.000;311000;0
16044;180738;755;0;0;0;0;.00nan;0;0
16044;49935;746;86;17;0;17;1.000;3600000;0
16044;149112;755;79;43;4;39;.907;3600000;0
16044;149119;746;0;0;0;0;.00nan;0;0
16045;504;3730;0;0;0;0;.00nan;0;0
16045;49815;3721;0;0;0;0;.00nan;0;0
16045;67818;3721;64;35;4;31;.886;3526000;0
16045;76628;3730;79;30;2;28;.933;3600000;0
16046;2140;1093;0;0;0;0;.00nan;0;0
16046;164521;4924;0;0;0;0;.00nan;0;0
16046;68233;1093;57;21;2;19;.905;3600000;0
16046;158630;4924;66;39;4;35;.897;3557000;0
16047;177124;2199;90;19;0;19;1.000;3600000;0
16047;174894;766;0;0;0;0;.00nan;0;0
16047;43720;766;80;37;3;34;.919;3600000;0
16047;149221;2199;0;0;0;0;.00nan;0;0
16048;3241;768;0;0;0;0;.00nan;0;0
16048;86099;768;40;13;3;10;.769;3600000;0
16048;93756;1497;0;0;0;0;.00nan;0;0
16048;149191;1497;62;41;4;37;.902;3546000;0
16049;359;774;75;23;2;21;.913;3600000;0
16049;-1;911;0;0;0;0;.00nan;0;0
16049;180177;911;51;46;6;40;.870;3600000;0
16049;91194;774;0;0;0;0;.00nan;0;0
16050;164424;750;99;23;0;23;1.000;3600000;0
16050;67446;750;0;0;0;0;.00nan;0;0
16050;76406;4989;0;0;0;0;.00nan;0;0
16050;148691;4989;64;31;4;27;.871;3600000;0
16051;3957;4923;46;15;2;13;.867;1411000;0
16051;170548;758;77;30;3;27;.900;3600000;0
16051;85395;758;0;0;0;0;.00nan;0;0
16051;148508;4923;12;21;6;15;.714;2189000;0
16052;11627;1503;0;0;0;0;.00nan;0;0
16052;181910;760;32;26;5;21;.808;3600000;0
16052;56037;760;0;0;0;0;.00nan;0;0
16052;67122;1503;79;27;2;25;.926;3600000;0
16053;49581;775;78;43;3;40;.930;3548000;0
16053;63932;2197;61;18;2;16;.889;3600000;0
16053;71485;775;0;0;0;0;.00nan;0;0
16053;94508;2197;0;0;0;0;.00nan;0;0
16054;595;3913;98;30;1;29;.967;3600000;0
16054;170547;769;75;35;4;31;.886;3600000;0
16054;149280;3913;0;0;0;0;.00nan;0;0
16054;154296;769;0;0;0;0;.00nan;0;0
16055;3075;754;87;28;1;27;.964;3600000;0
16055;81691;762;100;27;0;27;1.000;3600000;0
16055;87758;754;0;0;0;0;.00nan;0;0
16055;146249;762;0;0;0;0;.00nan;0;0
16056;175593;2545;0;0;0;0;.00nan;0;0
16056;180990;772;46;27;4;23;.852;3600000;0
16056;94018;772;0;0;0;0;.00nan;0;0
16056;94134;2545;74;24;2;22;.917;3600000;0
16057;147;767;91;43;3;40;.930;3584000;0
16057;359;774;77;23;1;22;.957;3600000;0
16057;82228;767;0;0;0;0;.00nan;0;0
16057;91194;774;0;0;0;0;.00nan;0;0
16058;504;3730;88;35;2;33;.943;3600000;0
16058;10931;759;0;0;0;0;.00nan;0;0
16058;66993;759;68;28;3;25;.893;3545000;0
16058;76628;3730;0;0;0;0;.00nan;0;0
16059;174894;766;0;0;0;0;.00nan;0;0
16059;43720;766;82;30;2;28;.933;3600000;0
16059;93756;1497;37;26;5;21;.808;3600000;0
16059;149191;1497;0;0;0;0;.00nan;0;0
16060;3241;768;0;0;0;0;.00nan;0;0
16060;-1;911;0;0;0;0;.00nan;0;0
16060;180177;911;98;50;2;48;.960;3588000;0
16060;86099;768;72;12;1;11;.917;3600000;0
16061;63932;2197;90;39;3;36;.923;3900000;0
16061;76406;4989;64;31;3;28;.903;3900000;0
16061;94508;2197;0;0;0;0;.00nan;0;0
16061;148691;4989;0;0;0;0;.00nan;0;0
16062;3075;754;72;47;4;43;.915;3600000;0
16062;170548;758;0;0;0;0;.00nan;0;0
16062;85395;758;72;17;1;16;.941;3600000;0
16062;87758;754;0;0;0;0;.00nan;0;0
16063;595;3913;78;18;1;17;.944;3600000;0
16063;11627;1503;0;0;0;0;.00nan;0;0
16063;67122;1503;76;35;2;33;.943;3547000;0
16063;149280;3913;0;0;0;0;.00nan;0;0
16064;147;767;78;44;4;40;.909;3600000;0
16064;3241;768;0;0;0;0;.00nan;0;0
16064;82228;767;0;0;0;0;.00nan;0;0
16064;86099;768;85;20;0;20;1.000;3600000;0
16065;504;3730;98;50;1;49;.980;3547000;0
16065;175593;2545;0;0;0;0;.00nan;0;0
16065;76628;3730;0;0;0;0;.00nan;0;0
16065;94134;2545;100;25;0;25;1.000;3600000;0
16066;-1;911;77;30;2;28;.933;3600000;0
16066;174894;766;0;0;0;0;.00nan;0;0
16066;180177;911;0;0;0;0;.00nan;0;0
16066;43720;766;63;34;4;30;.882;3528000;0
16067;11627;1503;0;0;0;0;.00nan;0;0
16067;170547;769;0;0;0;0;.00nan;0;0
16067;67122;1503;65;36;3;33;.917;3600000;0
16067;154296;769;27;21;5;16;.762;3520000;0
16068;170548;758;0;0;0;0;.00nan;0;0
16068;63932;2197;91;41;3;38;.927;3900000;0
16068;85395;758;73;34;3;31;.912;3898000;0
16068;94508;2197;0;0;0;0;.00nan;0;0
16069;147;767;71;20;1;19;.950;3600000;0
16069;174894;766;0;0;0;0;.00nan;0;0
16069;43720;766;61;33;3;30;.909;3595000;0
16069;82228;767;0;0;0;0;.00nan;0;0
16070;2140;1093;72;25;2;23;.920;3595000;0
16070;49581;775;100;36;0;36;1.000;3600000;0
16070;68233;1093;0;0;0;0;.00nan;0;0
16070;71485;775;0;0;0;0;.00nan;0;0
16071;359;774;0;0;0;0;.00nan;0;0
16071;181910;760;0;0;0;0;.00nan;0;0
16071;56037;760;100;35;0;35;1.000;3600000;0
16071;91194;774;69;29;2;27;.931;3596000;0
16072;177124;2199;79;32;2;30;.938;3600000;0
16072;49935;746;60;29;3;26;.897;3547000;0
16072;149119;746;0;0;0;0;.00nan;0;0
16072;149221;2199;0;0;0;0;.00nan;0;0
16073;164424;750;97;39;1;38;.974;3600000;0
16073;57172;1492;54;26;4;22;.846;3600000;0
16073;67446;750;0;0;0;0;.00nan;0;0
16073;73639;1492;0;0;0;0;.00nan;0;0
16074;3075;754;0;0;0;0;.00nan;0;0
16074;180990;772;68;23;2;21;.913;3600000;0
16074;87758;754;67;37;3;34;.919;3543000;0
16074;94018;772;0;0;0;0;.00nan;0;0
16075;3957;4923;85;25;1;24;.960;3600000;0
16075;180738;755;61;23;2;21;.913;3552000;0
16075;148508;4923;0;0;0;0;.00nan;0;0
16075;149112;755;0;0;0;0;.00nan;0;0
16076;10931;759;0;0;0;0;.00nan;0;0
16076;66993;759;41;24;5;19;.792;3513000;0
16076;93756;1497;0;0;0;0;.00nan;0;0
16076;149191;1497;95;44;3;41;.932;3600000;0
16077;3241;768;0;0;0;0;.00nan;0;0
16077;181910;760;0;0;0;0;.00nan;0;0
16077;56037;760;58;43;5;38;.884;3534000;0
16077;86099;768;39;17;3;14;.824;3600000;0
16078;2140;1093;47;27;4;23;.852;3553000;0
16078;68233;1093;0;0;0;0;.00nan;0;0
16078;81691;762;83;37;2;35;.946;3600000;0
16078;146249;762;0;0;0;0;.00nan;0;0
16079;177124;2199;69;23;1;22;.957;3600000;0
16079;49815;3721;0;0;0;0;.00nan;0;0
16079;67818;3721;93;45;3;42;.933;3600000;0
16079;149221;2199;0;0;0;0;.00nan;0;0
16080;164521;4924;70;30;2;28;.933;3550000;0
16080;49581;775;100;31;0;31;1.000;3600000;0
16080;71485;775;0;0;0;0;.00nan;0;0
16080;158630;4924;0;0;0;0;.00nan;0;0
16081;359;774;100;26;0;26;1.000;3600000;0
16081;595;3913;57;35;4;31;.886;3600000;0
16081;91194;774;0;0;0;0;.00nan;0;0
16081;149280;3913;0;0;0;0;.00nan;0;0
16082;-1;911;0;0;0;0;.00nan;0;0
16082;180177;911;54;28;4;24;.857;3600000;0
16082;49935;746;55;34;5;29;.853;3555000;0
16082;149119;746;0;0;0;0;.00nan;0;0
16083;164424;750;0;0;0;0;.00nan;0;0
16083;180738;755;78;36;3;33;.917;3529000;0
16083;67446;750;88;30;1;29;.967;3600000;0
16083;149112;755;0;0;0;0;.00nan;0;0
16084;180990;772;0;0;0;0;.00nan;0;0
16084;63932;2197;0;0;0;0;.00nan;0;0
16084;94018;772;50;32;4;28;.875;3527000;0
16084;94508;2197;71;27;2;25;.926;3600000;0
16085;3075;754;50;27;5;22;.815;3663000;0
16085;57172;1492;55;41;6;35;.854;3663000;0
16085;73639;1492;0;0;0;0;.00nan;0;0
16085;87758;754;0;0;0;0;.00nan;0;0
16086;504;3730;69;29;3;26;.897;3588000;0
16086;3957;4923;0;0;0;0;.00nan;0;0
16086;76628;3730;0;0;0;0;.00nan;0;0
16086;148508;4923;69;30;2;28;.933;3600000;0
16087;177124;2199;0;0;0;0;.00nan;0;0
16087;17384;759;0;0;0;0;.00nan;0;0
16087;66993;759;77;22;1;21;.955;3643000;0
16087;149221;2199;100;32;0;32;1.000;3643000;0
16088;595;3913;75;52;6;46;.885;3600000;0
16088;3241;768;68;19;1;18;.947;3600000;0
16088;86099;768;0;0;0;0;.00nan;0;0
16088;149280;3913;0;0;0;0;.00nan;0;0
16089;2140;1093;87;26;1;25;.962;3600000;0
16089;170548;758;0;0;0;0;.00nan;0;0
16089;68233;1093;0;0;0;0;.00nan;0;0
16089;85395;758;64;30;3;27;.900;3548000;0
16090;-1;911;0;0;0;0;.00nan;0;0
16090;180177;911;68;44;4;40;.909;3600000;0
16090;49815;3721;0;0;0;0;.00nan;0;0
16090;67818;3721;55;19;2;17;.895;3600000;0
16091;164521;4924;0;0;0;0;.00nan;0;0
16091;81691;762;54;20;3;17;.850;3600000;0
16091;146249;762;0;0;0;0;.00nan;0;0
16091;158630;4924;73;39;4;35;.897;3600000;0
16092;174894;766;8;27;8;19;.704;3600000;0
16092;181910;760;0;0;0;0;.00nan;0;0
16092;43720;766;0;0;0;0;.00nan;0;0
16092;56037;760;57;28;4;24;.857;3600000;0
16093;359;774;77;23;1;22;.957;3543000;0
16093;170547;769;100;35;0;35;1.000;3600000;0
16093;91194;774;0;0;0;0;.00nan;0;0
16093;154296;769;0;0;0;0;.00nan;0;0
16094;147;767;41;42;6;36;.857;3600000;0
16094;49935;746;83;27;1;26;.963;3600000;0
16094;82228;767;0;0;0;0;.00nan;0;0
16094;149119;746;0;0;0;0;.00nan;0;0
16095;175593;2545;46;5;1;4;.800;445000;0
16095;93756;1497;0;0;0;0;.00nan;0;0
16095;94134;2545;65;34;4;30;.882;3155000;0
16095;149191;1497;77;22;1;21;.955;3600000;0
16096;504;3730;97;42;1;41;.976;3573000;0
16096;164424;750;100;20;0;20;1.000;3600000;0
16096;67446;750;0;0;0;0;.00nan;0;0
16096;76628;3730;0;0;0;0;.00nan;0;0
16097;57172;1492;89;39;2;37;.949;3900000;0
16097;63932;2197;99;32;2;30;.938;3900000;0
16097;73639;1492;0;0;0;0;.00nan;0;0
16097;94508;2197;0;0;0;0;.00nan;0;0
16098;3075;754;75;32;3;29;.906;3583000;0
16098;180738;755;0;0;0;0;.00nan;0;0
16098;87758;754;0;0;0;0;.00nan;0;0
16098;149112;755;78;24;1;23;.958;3600000;0
16099;3957;4923;0;0;0;0;.00nan;0;0
16099;180990;772;91;26;1;25;.962;3600000;0
16099;94018;772;0;0;0;0;.00nan;0;0
16099;148508;4923;48;18;3;15;.833;3560000;0
16100;17384;759;0;0;0;0;.00nan;0;0
16100;-1;911;0;0;0;0;.00nan;0;0
16100;180177;911;97;31;1;30;.968;3600000;0
16100;66993;759;47;16;3;13;.813;3559000;0
16101;3241;768;0;0;0;0;.00nan;0;0
16101;170547;769;0;0;0;0;.00nan;0;0
16101;86099;768;53;16;2;14;.875;3600000;0
16101;154296;769;89;57;5;52;.912;3600000;0
16102;2140;1093;85;27;1;26;.963;3600000;0
16102;68233;1093;0;0;0;0;.00nan;0;0
16102;76406;4989;65;28;3;25;.893;3551000;0
16102;148691;4989;0;0;0;0;.00nan;0;0
16103;147;767;41;30;5;25;.833;3600000;0
16103;49815;3721;0;0;0;0;.00nan;0;0
16103;67818;3721;81;31;2;29;.935;3600000;0
16103;82228;767;0;0;0;0;.00nan;0;0
16104;164521;4924;93;42;3;39;.929;3600000;0
16104;170548;758;0;0;0;0;.00nan;0;0
16104;85395;758;67;24;2;22;.917;3600000;0
16104;158630;4924;0;0;0;0;.00nan;0;0
16105;595;3913;92;29;1;28;.966;3600000;0
16105;174894;766;0;0;0;0;.00nan;0;0
16105;43720;766;88;34;3;31;.912;3517000;0
16105;149280;3913;0;0;0;0;.00nan;0;0
16106;359;774;50;10;2;8;.800;3600000;0
16106;11627;1503;51;12;1;11;.917;1071000;0
16106;67122;1503;31;28;6;22;.786;2529000;0
16106;91194;774;0;0;0;0;.00nan;0;0
16107;49935;746;98;21;0;21;1.000;3600000;0
16107;93756;1497;0;0;0;0;.00nan;0;0
16107;149119;746;0;0;0;0;.00nan;0;0
16107;149191;1497;92;45;2;43;.956;3583000;0
16108;177124;2199;0;0;0;0;.00nan;0;0
16108;175593;2545;89;33;2;31;.939;3742000;0
16108;94134;2545;0;0;0;0;.00nan;0;0
16108;149221;2199;99;35;1;34;.971;3742000;0
16109;164424;750;69;32;3;29;.906;3600000;0
16109;180990;772;0;0;0;0;.00nan;0;0
16109;67446;750;0;0;0;0;.00nan;0;0
16109;94018;772;48;33;5;28;.848;3582000;0
16110;180738;755;56;18;2;16;.889;3600000;0
16110;63932;2197;75;34;3;31;.912;3556000;0
16110;94508;2197;0;0;0;0;.00nan;0;0
16110;149112;755;0;0;0;0;.00nan;0;0
16111;504;3730;0;0;0;0;.00nan;0;0
16111;3075;754;0;0;0;0;.00nan;0;0
16111;76628;3730;60;30;3;27;.900;3559000;0
16111;87758;754;82;27;1;26;.963;3600000;0
16112;3957;4923;0;0;0;0;.00nan;0;0
16112;57172;1492;70;27;2;25;.926;3600000;0
16112;73639;1492;0;0;0;0;.00nan;0;0
16112;148508;4923;15;30;7;23;.767;3600000;0
16113;147;767;94;46;3;43;.935;3793000;0
16113;17384;759;0;0;0;0;.00nan;0;0
16113;66993;759;64;30;4;26;.867;3793000;0
16113;82228;767;0;0;0;0;.00nan;0;0
16114;3241;768;0;0;0;0;.00nan;0;0
16114;11627;1503;89;36;1;35;.972;1594000;0
16114;67122;1503;47;34;5;29;.853;2006000;0
16114;86099;768;54;17;2;15;.882;3600000;0
16115;49815;3721;0;0;0;0;.00nan;0;0
16115;67818;3721;91;18;0;18;1.000;3600000;0
16115;93756;1497;0;0;0;0;.00nan;0;0
16115;149191;1497;79;32;2;30;.938;3532000;0
16116;164521;4924;0;0;0;0;.00nan;0;0
16116;76406;4989;68;31;3;28;.903;3600000;0
16116;148691;4989;0;0;0;0;.00nan;0;0
16116;158630;4924;43;26;4;22;.846;3561000;0
16117;170547;769;68;36;4;32;.889;3553000;0
16117;174894;766;0;0;0;0;.00nan;0;0
16117;43720;766;74;29;2;27;.931;3600000;0
16117;154296;769;0;0;0;0;.00nan;0;0
16118;-1;911;0;0;0;0;.00nan;0;0
16118;175593;2545;0;0;0;0;.00nan;0;0
16118;180177;911;97;30;0;30;1.000;3600000;0
16118;94134;2545;70;35;3;32;.914;3600000;0
16119;504;3730;88;30;1;29;.967;3600000;0
16119;63932;2197;59;25;3;22;.880;3514000;0
16119;76628;3730;0;0;0;0;.00nan;0;0
16119;94508;2197;0;0;0;0;.00nan;0;0
16120;49581;775;98;58;4;54;.931;3600000;0
16120;71485;775;0;0;0;0;.00nan;0;0
16120;81691;762;71;16;1;15;.938;3600000;0
16120;146249;762;0;0;0;0;.00nan;0;0
16121;11627;1503;0;0;0;0;.00nan;0;0
16121;174894;766;0;0;0;0;.00nan;0;0
16121;43720;766;57;26;3;23;.885;3557000;0
16121;67122;1503;84;29;1;28;.966;3600000;0
16122;595;3913;90;16;0;16;1.000;3600000;0
16122;35024;760;0;0;0;0;.00nan;0;0
16122;56037;760;98;56;1;55;.982;3545000;0
16122;149280;3913;0;0;0;0;.00nan;0;0
16123;147;767;93;32;1;31;.969;3600000;0
16123;175593;2545;0;0;0;0;.00nan;0;0
16123;82228;767;0;0;0;0;.00nan;0;0
16123;94134;2545;78;28;2;26;.929;3543000;0
16124;164424;750;94;21;0;21;1.000;3600000;0
16124;57172;1492;0;0;0;0;.00nan;0;0
16124;67446;750;0;0;0;0;.00nan;0;0
16124;73639;1492;59;21;2;19;.905;3589000;0
16125;3075;754;87;39;2;37;.949;3600000;0
16125;180990;772;21;23;6;17;.739;3600000;0
16125;87758;754;0;0;0;0;.00nan;0;0
16125;94018;772;0;0;0;0;.00nan;0;0
16126;2140;1093;68;28;3;25;.893;3900000;0
16126;170548;758;49;21;3;18;.857;3900000;0
16126;68233;1093;0;0;0;0;.00nan;0;0
16126;85395;758;0;0;0;0;.00nan;0;0
16127;3241;768;0;0;0;0;.00nan;0;0
16127;170547;769;99;39;1;38;.974;3600000;0
16127;86099;768;50;14;2;12;.857;3546000;0
16127;154296;769;0;0;0;0;.00nan;0;0
16128;177124;2199;100;38;2;36;.947;3900000;0
16128;17384;759;0;0;0;0;.00nan;0;0
16128;66993;759;82;29;2;27;.931;3900000;0
16128;149221;2199;0;0;0;0;.00nan;0;0
16129;49935;746;100;21;0;21;1.000;3600000;0
16129;93756;1497;0;0;0;0;.00nan;0;0
16129;149119;746;0;0;0;0;.00nan;0;0
16129;149191;1497;97;43;1;42;.977;3588000;0
16130;359;774;72;27;2;25;.926;3696000;0
16130;595;3913;85;33;3;30;.909;3696000;0
16130;91194;774;0;0;0;0;.00nan;0;0
16130;149280;3913;0;0;0;0;.00nan;0;0
16131;-1;911;0;0;0;0;.00nan;0;0
16131;180177;911;80;33;2;31;.939;3600000;0
16131;49815;3721;0;0;0;0;.00nan;0;0
16131;67818;3721;64;27;3;24;.889;3600000;0
16132;3957;4923;0;0;0;0;.00nan;0;0
16132;57172;1492;50;21;3;18;.857;3600000;0
16132;73639;1492;0;0;0;0;.00nan;0;0
16132;148508;4923;89;48;4;44;.917;3569000;0
16133;164424;750;77;27;2;25;.926;3600000;0
16133;180990;772;0;0;0;0;.00nan;0;0
16133;67446;750;0;0;0;0;.00nan;0;0
16133;94018;772;94;35;1;34;.971;3600000;0
16134;2140;1093;70;19;1;18;.947;3600000;0
16134;68233;1093;0;0;0;0;.00nan;0;0
16134;76406;4989;0;0;0;0;.00nan;0;0
16134;148691;4989;75;38;3;35;.921;3565000;0
16135;180738;755;84;40;2;38;.950;3600000;0
16135;63932;2197;39;22;4;18;.818;3554000;0
16135;94508;2197;0;0;0;0;.00nan;0;0
16135;149112;755;0;0;0;0;.00nan;0;0
16136;504;3730;78;20;1;19;.950;3900000;0
16136;3075;754;100;36;1;35;.972;3900000;0
16136;76628;3730;0;0;0;0;.00nan;0;0
16136;87758;754;0;0;0;0;.00nan;0;0
16137;164521;4924;0;0;0;0;.00nan;0;0
16137;170548;758;0;0;0;0;.00nan;0;0
16137;85395;758;79;26;2;24;.923;3600000;0
16137;158630;4924;44;32;5;27;.844;3600000;0
16138;170547;769;92;47;3;44;.936;3597000;0
16138;174894;766;0;0;0;0;.00nan;0;0
16138;43720;766;76;25;2;23;.920;3600000;0
16138;154296;769;0;0;0;0;.00nan;0;0
16139;147;767;0;0;0;0;.00nan;0;0
16139;49815;3721;0;0;0;0;.00nan;0;0
16139;67818;3721;84;33;3;30;.909;3900000;0
16139;82228;767;61;28;3;25;.893;3900000;0
16140;359;774;58;18;2;16;.889;3600000;0
16140;35024;760;57;33;4;29;.879;3600000;0
16140;56037;760;0;0;0;0;.00nan;0;0
16140;91194;774;0;0;0;0;.00nan;0;0
16141;177124;2199;0;0;0;0;.00nan;0;0
16141;175593;2545;0;0;0;0;.00nan;0;0
16141;94134;2545;80;39;3;36;.923;3573000;0
16141;149221;2199;64;17;1;16;.941;3600000;0
16142;17384;759;0;0;0;0;.00nan;0;0
16142;66993;759;68;19;1;18;.947;3600000;0
16142;93756;1497;0;0;0;0;.00nan;0;0
16142;149191;1497;65;42;4;38;.905;3600000;0
16143;-1;911;0;0;0;0;.00nan;0;0
16143;180177;911;72;33;3;30;.909;3900000;0
16143;49935;746;55;24;3;21;.875;3900000;0
16143;149119;746;0;0;0;0;.00nan;0;0
16144;3241;768;0;0;0;0;.00nan;0;0
16144;11627;1503;100;72;3;69;.958;3900000;0
16144;67122;1503;0;0;0;0;.00nan;0;0
16144;86099;768;58;22;3;19;.864;3900000;0
16145;57172;1492;95;36;1;35;.972;3552000;0
16145;63932;2197;98;27;0;27;1.000;3600000;0
16145;73639;1492;0;0;0;0;.00nan;0;0
16145;94508;2197;0;0;0;0;.00nan;0;0
16146;3957;4923;0;0;0;0;.00nan;0;0
16146;180990;772;0;0;0;0;.00nan;0;0
16146;94018;772;84;29;1;28;.966;3600000;0
16146;148508;4923;79;35;2;33;.943;3557000;0
16147;164521;4924;0;0;0;0;.00nan;0;0
16147;76406;4989;0;0;0;0;.00nan;0;0
16147;148691;4989;69;25;2;23;.920;3600000;0
16147;158630;4924;82;43;3;40;.930;3561000;0
16148;3075;754;74;31;2;29;.935;3600000;0
16148;180738;755;0;0;0;0;.00nan;0;0
16148;87758;754;0;0;0;0;.00nan;0;0
16148;149112;755;73;30;3;27;.900;3600000;0
16149;504;3730;0;0;0;0;.00nan;0;0
16149;164424;750;47;21;3;18;.857;3600000;0
16149;67446;750;0;0;0;0;.00nan;0;0
16149;76628;3730;54;29;4;25;.862;3589000;0
16150;2140;1093;78;34;3;31;.912;3600000;0
16150;68233;1093;0;0;0;0;.00nan;0;0
16150;81691;762;0;0;0;0;.00nan;0;0
16150;146249;762;61;24;2;22;.917;3600000;0
16151;359;774;79;31;2;29;.935;3770000;0
16151;170547;769;0;0;0;0;.00nan;0;0
16151;91194;774;0;0;0;0;.00nan;0;0
16151;154296;769;99;52;1;51;.981;3770000;0
16152;147;767;98;40;2;38;.950;3900000;0
16152;49935;746;91;30;2;28;.933;3900000;0
16152;82228;767;0;0;0;0;.00nan;0;0
16152;149119;746;0;0;0;0;.00nan;0;0
16153;177124;2199;84;31;2;29;.935;3837000;0
16153;49815;3721;0;0;0;0;.00nan;0;0
16153;67818;3721;77;35;3;32;.914;3837000;0
16153;149221;2199;0;0;0;0;.00nan;0;0
16154;175593;2545;0;0;0;0;.00nan;0;0
16154;93756;1497;0;0;0;0;.00nan;0;0
16154;94134;2545;75;33;3;30;.909;3900000;0
16154;149191;1497;57;25;3;22;.880;3900000;0
16155;595;3913;79;49;5;44;.898;3600000;0
16155;3241;768;0;0;0;0;.00nan;0;0
16155;86099;768;93;15;0;15;1.000;3600000;0
16155;149280;3913;0;0;0;0;.00nan;0;0
16156;17384;759;0;0;0;0;.00nan;0;0
16156;-1;911;0;0;0;0;.00nan;0;0
16156;180177;911;100;51;2;49;.961;3600000;0
16156;66993;759;78;31;3;28;.903;3580000;0
16157;11627;1503;0;0;0;0;.00nan;0;0
16157;174894;766;0;0;0;0;.00nan;0;0
16157;43720;766;100;33;0;33;1.000;3600000;0
16157;67122;1503;70;29;3;26;.897;3600000;0
16158;3075;754;0;0;0;0;.00nan;0;0
16158;57172;1492;60;15;2;13;.867;3600000;0
16158;73639;1492;0;0;0;0;.00nan;0;0
16158;87758;754;62;35;4;31;.886;3559000;0
16159;180990;772;54;30;4;26;.867;3600000;0
16159;63932;2197;100;26;0;26;1.000;3600000;0
16159;94018;772;0;0;0;0;.00nan;0;0
16159;94508;2197;0;0;0;0;.00nan;0;0
16160;164424;750;65;27;3;24;.889;3518000;0
16160;10931;750;0;0;0;0;.00nan;0;0
16160;180738;755;78;23;1;22;.957;3600000;0
16160;149112;755;0;0;0;0;.00nan;0;0
16161;504;3730;65;42;5;37;.881;3600000;0
16161;3957;4923;46;6;1;5;.833;1291000;0
16161;76628;3730;0;0;0;0;.00nan;0;0
16161;148508;4923;32;20;5;15;.750;2297000;0
16162;2140;1093;77;30;2;28;.933;3557000;0
16162;49581;775;0;0;0;0;.00nan;0;0
16162;68233;1093;0;0;0;0;.00nan;0;0
16162;71485;775;80;27;1;26;.963;3600000;0
16163;164521;4924;0;0;0;0;.00nan;0;0
16163;81691;762;100;41;1;40;.976;3600000;0
16163;146249;762;0;0;0;0;.00nan;0;0
16163;158630;4924;45;17;3;14;.824;3553000;0
16164;147;767;51;36;6;30;.833;3600000;0
16164;66993;759;66;32;3;29;.906;3600000;0
16164;67446;759;0;0;0;0;.00nan;0;0
16164;82228;767;0;0;0;0;.00nan;0;0
16165;3241;768;0;0;0;0;.00nan;0;0
16165;35024;760;100;39;0;39;1.000;3600000;0
16165;56037;760;0;0;0;0;.00nan;0;0
16165;86099;768;60;19;2;17;.895;3557000;0
16166;177124;2199;0;0;0;0;.00nan;0;0
16166;49935;746;98;43;2;41;.953;3900000;0
16166;149119;746;0;0;0;0;.00nan;0;0
16166;149221;2199;74;31;2;29;.935;3900000;0
16167;49815;3721;0;0;0;0;.00nan;0;0
16167;67818;3721;100;42;2;40;.952;3900000;0
16167;93756;1497;75;29;2;27;.931;3900000;0
16167;149191;1497;0;0;0;0;.00nan;0;0
16168;595;3913;64;30;4;26;.867;3900000;0
16168;174894;766;0;0;0;0;.00nan;0;0
16168;43720;766;97;54;4;50;.926;3900000;0
16168;149280;3913;0;0;0;0;.00nan;0;0
16169;-1;911;0;0;0;0;.00nan;0;0
16169;175593;2545;0;0;0;0;.00nan;0;0
16169;180177;911;100;34;0;34;1.000;3600000;0
16169;94134;2545;39;26;5;21;.808;3600000;0
16170;359;774;66;26;4;22;.846;3900000;0
16170;11627;1503;0;0;0;0;.00nan;0;0
16170;67122;1503;100;54;4;50;.926;3900000;0
16170;91194;774;0;0;0;0;.00nan;0;0
16171;3957;4923;0;0;0;0;.00nan;0;0
16171;180738;755;31;21;5;16;.762;3600000;0
16171;148508;4923;99;51;2;49;.961;3600000;0
16171;149112;755;0;0;0;0;.00nan;0;0
16172;504;3730;66;23;2;21;.913;3600000;0
16172;63932;2197;31;30;6;24;.800;3149000;0
16172;76628;3730;0;0;0;0;.00nan;0;0
16172;94508;2197;50;1;0;1;1.000;451000;0
16173;164521;4924;0;0;0;0;.00nan;0;0
16173;49581;775;60;38;4;34;.895;3550000;0
16173;71485;775;0;0;0;0;.00nan;0;0
16173;158630;4924;49;20;3;17;.850;3600000;0
16174;147;767;70;26;2;24;.923;3600000;0
16174;175593;2545;0;0;0;0;.00nan;0;0
16174;82228;767;0;0;0;0;.00nan;0;0
16174;94134;2545;41;18;4;14;.778;3536000;0
16175;174894;766;0;0;0;0;.00nan;0;0
16175;35024;760;69;32;3;29;.906;3600000;0
16175;43720;766;91;35;2;33;.943;3600000;0
16175;56037;760;0;0;0;0;.00nan;0;0
16176;11627;1503;66;39;4;35;.897;3600000;0
16176;170547;769;0;0;0;0;.00nan;0;0
16176;67122;1503;0;0;0;0;.00nan;0;0
16176;154296;769;40;32;5;27;.844;3600000;0
16177;164424;750;75;21;1;20;.952;3600000;0
16177;10931;750;0;0;0;0;.00nan;0;0
16177;170548;758;0;0;0;0;.00nan;0;0
16177;85395;758;74;35;3;32;.914;3517000;0
16178;3075;754;58;26;3;23;.885;3600000;0
16178;76406;4989;0;0;0;0;.00nan;0;0
16178;87758;754;0;0;0;0;.00nan;0;0
16178;148691;4989;52;34;4;30;.882;3580000;0
16179;180990;772;69;36;3;33;.917;3577000;0
16179;66993;759;88;30;1;29;.967;3600000;0
16179;67446;759;0;0;0;0;.00nan;0;0
16179;94018;772;0;0;0;0;.00nan;0;0
16180;3241;768;0;0;0;0;.00nan;0;0
16180;-1;911;0;0;0;0;.00nan;0;0
16180;180177;911;77;38;3;35;.921;3600000;0
16180;86099;768;100;27;0;27;1.000;3600000;0
16181;177124;2199;54;14;2;12;.857;3600000;0
16181;93756;1497;80;29;1;28;.966;2639000;0
16181;149191;1497;26;13;4;9;.692;961000;0
16181;149221;2199;0;0;0;0;.00nan;0;0
16182;49815;3721;58;29;3;26;.897;3596000;0
16182;57172;1492;82;26;2;24;.923;3600000;0
16182;67818;3721;0;0;0;0;.00nan;0;0
16182;73639;1492;0;0;0;0;.00nan;0;0
16183;164424;750;57;14;2;12;.857;3600000;0
16183;10931;750;0;0;0;0;.00nan;0;0
16183;49581;775;84;46;3;43;.935;3551000;0
16183;71485;775;0;0;0;0;.00nan;0;0
16184;63932;2197;0;0;0;0;.00nan;0;0
16184;76406;4989;25;6;3;3;.500;251000;0
16184;94508;2197;100;21;0;21;1.000;3600000;0
16184;148691;4989;51;28;4;24;.857;3349000;0
16185;3075;754;79;28;1;27;.964;3794000;0
16185;170548;758;0;0;0;0;.00nan;0;0
16185;85395;758;90;37;2;35;.946;3794000;0
16185;87758;754;0;0;0;0;.00nan;0;0
16186;3957;4923;0;0;0;0;.00nan;0;0
16186;81691;762;98;43;4;39;.907;3600000;0
16186;146249;762;0;0;0;0;.00nan;0;0
16186;148508;4923;33;32;6;26;.813;3546000;0
16187;595;3913;47;34;5;29;.853;3547000;0
16187;170547;769;67;40;4;36;.900;3600000;0
16187;149280;3913;0;0;0;0;.00nan;0;0
16187;154296;769;0;0;0;0;.00nan;0;0
16188;180738;755;89;39;2;37;.949;3592000;0
16188;66993;759;86;14;0;14;1.000;3600000;0
16188;67446;759;0;0;0;0;.00nan;0;0
16188;149112;755;0;0;0;0;.00nan;0;0
16189;147;767;33;9;3;6;.667;482000;0
16189;3241;768;0;0;0;0;.00nan;0;0
16189;82228;767;92;30;0;30;1.000;3047000;0
16189;86099;768;88;30;1;29;.967;3600000;0
16190;504;3730;100;37;1;36;.973;3900000;0
16190;49815;3721;0;0;0;0;.00nan;0;0
16190;67818;3721;73;23;1;22;.957;3900000;0
16190;76628;3730;0;0;0;0;.00nan;0;0
16191;-1;911;0;0;0;0;.00nan;0;0
16191;174894;766;32;30;5;25;.833;3579000;0
16191;180177;911;70;34;4;30;.882;3600000;0
16191;43720;766;0;0;0;0;.00nan;0;0
16192;49935;746;0;0;0;0;.00nan;0;0
16192;57172;1492;63;32;4;28;.875;3564000;0
16192;73639;1492;0;0;0;0;.00nan;0;0
16192;149119;746;53;25;3;22;.880;3600000;0
16193;175593;2545;52;16;2;14;.875;3600000;0
16193;180990;772;97;36;1;35;.972;3600000;0
16193;94018;772;0;0;0;0;.00nan;0;0
16193;94134;2545;0;0;0;0;.00nan;0;0
16194;164424;750;0;0;0;0;.00nan;0;0
16194;10931;750;63;39;4;35;.897;3582000;0
16194;81691;762;86;42;3;39;.929;3600000;0
16194;146249;762;0;0;0;0;.00nan;0;0
16195;170548;758;48;5;1;4;.800;760000;0
16195;63932;2197;0;0;0;0;.00nan;0;0
16195;85395;758;47;35;6;29;.829;2840000;0
16195;94508;2197;50;21;3;18;.857;3600000;0
16196;2140;1093;56;22;3;19;.864;3670000;0
16196;164521;4924;85;32;2;30;.938;3670000;0
16196;68233;1093;0;0;0;0;.00nan;0;0
16196;158630;4924;0;0;0;0;.00nan;0;0
16197;3075;754;0;0;0;0;.00nan;0;0
16197;49581;775;76;42;5;37;.881;3600000;0
16197;71485;775;0;0;0;0;.00nan;0;0
16197;87758;754;100;25;0;25;1.000;3600000;0
16198;3957;4923;0;0;0;0;.00nan;0;0
16198;76406;4989;0;0;0;0;.00nan;0;0
16198;148508;4923;72;33;3;30;.909;3900000;0
16198;148691;4989;67;34;3;31;.912;3900000;0
16199;170547;769;94;31;1;30;.968;3900000;0
16199;35024;760;92;33;1;32;.970;3900000;0
16199;56037;760;0;0;0;0;.00nan;0;0
16199;154296;769;0;0;0;0;.00nan;0;0
16200;57172;1492;48;40;5;35;.875;3600000;0
16200;66993;759;100;35;0;35;1.000;3600000;0
16200;67446;759;0;0;0;0;.00nan;0;0
16200;73639;1492;0;0;0;0;.00nan;0;0
16201;177124;2199;65;43;4;39;.907;3900000;0
16201;3241;768;0;0;0;0;.00nan;0;0
16201;86099;768;59;27;4;23;.852;3900000;0
16201;149221;2199;0;0;0;0;.00nan;0;0
16202;180990;772;78;37;3;34;.919;3600000;0
16202;49815;3721;0;0;0;0;.00nan;0;0
16202;67818;3721;87;24;1;23;.958;3600000;0
16202;94018;772;0;0;0;0;.00nan;0;0
16203;147;767;58;29;3;26;.897;3546000;0
16203;174894;766;0;0;0;0;.00nan;0;0
16203;43720;766;100;44;1;43;.977;3600000;0
16203;82228;767;0;0;0;0;.00nan;0;0
16204;359;774;100;32;0;32;1.000;3600000;0
16204;-1;911;0;0;0;0;.00nan;0;0
16204;180177;911;66;32;3;29;.906;3600000;0
16204;91194;774;0;0;0;0;.00nan;0;0
16205;504;3730;67;30;2;28;.933;3557000;0
16205;49935;746;77;24;1;23;.958;3600000;0
16205;76628;3730;0;0;0;0;.00nan;0;0
16205;149119;746;0;0;0;0;.00nan;0;0
16206;175593;2545;44;27;4;23;.852;3583000;0
16206;180738;755;65;29;3;26;.897;3600000;0
16206;94134;2545;0;0;0;0;.00nan;0;0
16206;149112;755;0;0;0;0;.00nan;0;0
16207;595;3913;46;22;4;18;.818;3900000;0
16207;11627;1503;0;0;0;0;.00nan;0;0
16207;67122;1503;54;32;4;28;.875;3900000;0
16207;149280;3913;0;0;0;0;.00nan;0;0
16208;164424;750;59;28;3;25;.893;3589000;0
16208;10931;750;0;0;0;0;.00nan;0;0
16208;76406;4989;89;23;1;22;.957;3600000;0
16208;148691;4989;0;0;0;0;.00nan;0;0
16209;49581;775;98;47;3;44;.936;3577000;0
16209;63932;2197;58;17;1;16;.941;3600000;0
16209;71485;775;0;0;0;0;.00nan;0;0
16209;94508;2197;0;0;0;0;.00nan;0;0
16210;3075;754;0;0;0;0;.00nan;0;0
16210;81691;762;83;37;2;35;.946;3600000;0
16210;87758;754;71;49;5;44;.898;3600000;0
16210;146249;762;0;0;0;0;.00nan;0;0
16211;3957;4923;0;0;0;0;.00nan;0;0
16211;170548;758;0;0;0;0;.00nan;0;0
16211;85395;758;77;22;1;21;.955;3600000;0
16211;148508;4923;83;30;2;28;.933;3600000;0
16212;504;3730;0;0;0;0;.00nan;0;0
16212;66993;759;79;25;1;24;.960;3600000;0
16212;67446;759;0;0;0;0;.00nan;0;0
16212;76628;3730;82;50;5;45;.900;3600000;0
16213;3241;768;0;0;0;0;.00nan;0;0
16213;86099;768;85;25;2;23;.920;3600000;0
16213;93756;1497;29;40;8;32;.800;2450000;0
16213;149191;1497;1;17;7;10;.588;1150000;0
16214;180738;755;65;41;4;37;.902;3567000;0
16214;49815;3721;0;0;0;0;.00nan;0;0
16214;67818;3721;62;23;3;20;.870;3600000;0
16214;149112;755;0;0;0;0;.00nan;0;0
16215;177124;2199;0;0;0;0;.00nan;0;0
16215;174894;766;0;0;0;0;.00nan;0;0
16215;43720;766;81;34;2;32;.941;3600000;0
16215;149221;2199;66;31;3;28;.903;3596000;0
16216;147;767;87;27;1;26;.963;3600000;0
16216;359;774;87;31;2;29;.935;3559000;0
16216;82228;767;0;0;0;0;.00nan;0;0
16216;91194;774;0;0;0;0;.00nan;0;0
16217;180990;772;58;39;5;34;.872;3600000;0
16217;49935;746;90;27;1;26;.963;3600000;0
16217;94018;772;0;0;0;0;.00nan;0;0
16217;149119;746;0;0;0;0;.00nan;0;0
16218;175593;2545;0;0;0;0;.00nan;0;0
16218;57172;1492;57;38;5;33;.868;3540000;0
16218;73639;1492;0;0;0;0;.00nan;0;0
16218;94134;2545;72;27;3;24;.889;3600000;0
16219;11627;1503;85;34;1;33;.971;3581000;0
16219;35024;760;100;29;0;29;1.000;3600000;0
16219;56037;760;0;0;0;0;.00nan;0;0
16219;67122;1503;0;0;0;0;.00nan;0;0
16220;63932;2197;97;39;1;38;.974;3900000;0
16220;81691;762;100;40;1;39;.975;3900000;0
16220;94508;2197;0;0;0;0;.00nan;0;0
16220;146249;762;0;0;0;0;.00nan;0;0
16221;3957;4923;50;26;4;22;.846;3900000;0
16221;49581;775;65;42;4;38;.905;3900000;0
16221;71485;775;0;0;0;0;.00nan;0;0
16221;148508;4923;0;0;0;0;.00nan;0;0
16222;174894;766;45;26;4;22;.846;3043000;0
16222;43720;766;23;14;4;10;.714;557000;0
16222;93756;1497;0;0;0;0;.00nan;0;0
16222;149191;1497;55;39;5;34;.872;3600000;0
16223;359;774;88;31;2;29;.935;3600000;0
16223;177124;2199;70;39;4;35;.897;3573000;0
16223;91194;774;0;0;0;0;.00nan;0;0
16223;149221;2199;0;0;0;0;.00nan;0;0
16224;180738;755;0;0;0;0;.00nan;0;0
16224;49935;746;68;32;3;29;.906;3600000;0
16224;149112;755;34;40;7;33;.825;3600000;0
16224;149119;746;0;0;0;0;.00nan;0;0
16225;504;3730;60;38;4;34;.895;3600000;0
16225;175593;2545;66;16;1;15;.938;3600000;0
16225;76628;3730;0;0;0;0;.00nan;0;0
16225;94134;2545;0;0;0;0;.00nan;0;0
16226;2140;1093;0;0;0;0;.00nan;0;0
16226;3075;754;87;50;3;47;.940;3556000;0
16226;68233;1093;59;18;2;16;.889;3600000;0
16226;87758;754;0;0;0;0;.00nan;0;0
16227;164424;750;74;25;1;24;.960;3600000;0
16227;164521;4924;0;0;0;0;.00nan;0;0
16227;10931;750;0;0;0;0;.00nan;0;0
16227;158630;4924;59;31;3;28;.903;3520000;0
16228;3241;768;0;0;0;0;.00nan;0;0
16228;180990;772;59;16;1;15;.938;846000;0
16228;86099;768;80;11;0;11;1.000;3600000;0
16228;94018;772;36;36;6;30;.833;2754000;0
16229;66993;759;59;21;2;19;.905;3600000;0
16229;67446;759;0;0;0;0;.00nan;0;0
16229;76406;4989;0;0;0;0;.00nan;0;0
16229;148691;4989;50;39;5;34;.872;3600000;0
16230;147;767;85;37;3;34;.919;3560000;0
16230;170547;769;79;27;2;25;.926;3600000;0
16230;82228;767;0;0;0;0;.00nan;0;0
16230;154296;769;0;0;0;0;.00nan;0;0
16231;170548;758;54;15;2;13;.867;3600000;0
16231;49815;3721;0;0;0;0;.00nan;0;0
16231;67818;3721;75;33;3;30;.909;3568000;0
16231;85395;758;0;0;0;0;.00nan;0;0
16232;359;774;83;23;1;22;.957;3600000;0
16232;91194;774;0;0;0;0;.00nan;0;0
16232;93756;1497;0;0;0;0;.00nan;0;0
16232;149191;1497;72;37;3;34;.919;3515000;0
16233;11627;1503;0;0;0;0;.00nan;0;0
16233;-1;911;0;0;0;0;.00nan;0;0
16233;180177;911;67;34;3;31;.912;3900000;0
16233;67122;1503;84;37;3;34;.919;3900000;0
16234;2140;1093;64;20;2;18;.900;3571000;0
16234;164424;750;84;25;1;24;.960;3600000;0
16234;10931;750;0;0;0;0;.00nan;0;0
16234;68233;1093;0;0;0;0;.00nan;0;0
16235;3075;754;79;40;3;37;.925;3600000;0
16235;164521;4924;0;0;0;0;.00nan;0;0
16235;87758;754;0;0;0;0;.00nan;0;0
16235;158630;4924;57;32;4;28;.875;3574000;0
16236;174894;766;0;0;0;0;.00nan;0;0
16236;180990;772;0;0;0;0;.00nan;0;0
16236;43720;766;97;23;0;23;1.000;3600000;0
16236;94018;772;86;35;2;33;.943;3596000;0
16237;49815;3721;0;0;0;0;.00nan;0;0
16237;67818;3721;64;26;4;22;.846;3886000;0
16237;76406;4989;0;0;0;0;.00nan;0;0
16237;148691;4989;49;28;4;24;.857;3900000;0
16238;147;767;71;38;5;33;.868;3570000;0
16238;11627;1503;0;0;0;0;.00nan;0;0
16238;67122;1503;39;23;4;19;.826;3600000;0
16238;82228;767;0;0;0;0;.00nan;0;0
16239;504;3730;92;55;2;53;.964;3577000;0
16239;3241;768;0;0;0;0;.00nan;0;0
16239;76628;3730;0;0;0;0;.00nan;0;0
16239;86099;768;78;13;0;13;1.000;3600000;0
16240;170548;758;0;0;0;0;.00nan;0;0
16240;175593;2545;0;0;0;0;.00nan;0;0
16240;85395;758;72;23;1;22;.957;3600000;0
16240;94134;2545;72;37;3;34;.919;3584000;0
16241;177124;2199;74;26;2;24;.923;3749000;0
16241;170547;769;82;45;3;42;.933;3749000;0
16241;149221;2199;0;0;0;0;.00nan;0;0
16241;154296;769;0;0;0;0;.00nan;0;0
16242;49581;775;84;42;3;39;.929;3600000;0
16242;66993;759;64;15;1;14;.933;3600000;0
16242;67446;759;0;0;0;0;.00nan;0;0
16242;71485;775;0;0;0;0;.00nan;0;0
16243;49935;746;65;21;1;20;.952;3600000;0
16243;81691;762;0;0;0;0;.00nan;0;0
16243;146249;762;78;42;4;38;.905;3600000;0
16243;149119;746;0;0;0;0;.00nan;0;0
16244;595;3913;71;24;2;22;.917;3877000;0
16244;-1;911;0;0;0;0;.00nan;0;0
16244;180177;911;92;54;2;52;.963;3900000;0
16244;149280;3913;0;0;0;0;.00nan;0;0
16245;2140;1093;76;30;2;28;.933;3600000;0
16245;63932;2197;60;25;3;22;.880;3564000;0
16245;68233;1093;0;0;0;0;.00nan;0;0
16245;94508;2197;0;0;0;0;.00nan;0;0
16246;3957;4923;0;0;0;0;.00nan;0;0
16246;164521;4924;100;30;0;30;1.000;3600000;0
16246;148508;4923;68;26;2;24;.923;3558000;0
16246;158630;4924;0;0;0;0;.00nan;0;0
16247;359;774;88;25;1;24;.960;3900000;0
16247;180990;772;85;35;1;34;.971;3900000;0
16247;91194;774;0;0;0;0;.00nan;0;0
16247;94018;772;0;0;0;0;.00nan;0;0
16248;175593;2545;0;0;0;0;.00nan;0;0
16248;76406;4989;77;29;2;27;.931;3900000;0
16248;94134;2545;67;25;2;23;.920;3900000;0
16248;148691;4989;0;0;0;0;.00nan;0;0
16249;147;767;23;18;5;13;.722;2080000;0
16249;595;3913;82;33;3;30;.909;3600000;0
16249;82228;767;45;15;3;12;.800;1520000;0
16249;149280;3913;0;0;0;0;.00nan;0;0
16250;3241;768;0;0;0;0;.00nan;0;0
16250;180738;755;100;56;2;54;.964;3600000;0
16250;86099;768;40;14;3;11;.786;3600000;0
16250;149112;755;0;0;0;0;.00nan;0;0
16251;504;3730;0;0;0;0;.00nan;0;0
16251;174894;766;0;0;0;0;.00nan;0;0
16251;43720;766;100;39;0;39;1.000;3600000;0
16251;76628;3730;75;30;3;27;.900;3600000;0
16252;170548;758;0;0;0;0;.00nan;0;0
16252;49935;746;62;30;3;27;.900;3600000;0
16252;85395;758;70;38;4;34;.895;3542000;0
16252;149119;746;0;0;0;0;.00nan;0;0
16253;177124;2199;98;20;0;20;1.000;3600000;0
16253;11627;1503;0;0;0;0;.00nan;0;0
16253;67122;1503;63;39;5;34;.872;3600000;0
16253;149221;2199;0;0;0;0;.00nan;0;0
16254;49581;775;81;35;3;32;.914;3600000;0
16254;49815;3721;0;0;0;0;.00nan;0;0
16254;67818;3721;58;21;2;19;.905;3600000;0
16254;71485;775;0;0;0;0;.00nan;0;0
16255;170547;769;53;27;4;23;.852;2250000;0
16255;93756;1497;0;0;0;0;.00nan;0;0
16255;149191;1497;99;38;1;37;.974;3600000;0
16255;154296;769;66;12;0;12;1.000;1350000;0
16256;66993;759;77;27;2;25;.926;3900000;0
16256;67446;759;0;0;0;0;.00nan;0;0
16256;81691;762;73;33;2;31;.939;3900000;0
16256;146249;762;0;0;0;0;.00nan;0;0
16257;-1;911;84;43;3;40;.930;3600000;0
16257;180177;911;0;0;0;0;.00nan;0;0
16257;35024;760;29;22;5;17;.773;3524000;0
16257;56037;760;0;0;0;0;.00nan;0;0
16258;2140;1093;81;32;2;30;.938;3600000;0
16258;3957;4923;0;0;0;0;.00nan;0;0
16258;68233;1093;0;0;0;0;.00nan;0;0
16258;148508;4923;51;20;3;17;.850;3544000;0
16259;164521;4924;100;39;0;39;1.000;3600000;0
16259;63932;2197;0;0;0;0;.00nan;0;0
16259;94508;2197;86;27;1;26;.963;3553000;0
16259;158630;4924;0;0;0;0;.00nan;0;0
16260;3241;768;0;0;0;0;.00nan;0;0
16260;57172;1492;86;46;3;43;.935;3582000;0
16260;73639;1492;0;0;0;0;.00nan;0;0
16260;86099;768;75;19;1;18;.947;3600000;0
16261;49935;746;70;23;2;21;.913;3600000;0
16261;76406;4989;52;29;3;26;.897;3600000;0
16261;148691;4989;0;0;0;0;.00nan;0;0
16261;149119;746;0;0;0;0;.00nan;0;0
16262;147;767;75;38;2;36;.947;3900000;0
16262;35024;760;97;37;2;35;.946;3900000;0
16262;56037;760;0;0;0;0;.00nan;0;0
16262;82228;767;0;0;0;0;.00nan;0;0
16263;174894;766;0;0;0;0;.00nan;0;0
16263;180738;755;43;21;4;17;.810;3567000;0
16263;43720;766;81;36;2;34;.944;3600000;0
16263;149112;755;0;0;0;0;.00nan;0;0
16264;359;774;60;26;3;23;.885;3564000;0
16264;504;3730;99;43;2;41;.953;3600000;0
16264;76628;3730;0;0;0;0;.00nan;0;0
16264;91194;774;0;0;0;0;.00nan;0;0
16265;170548;758;82;29;2;27;.931;3600000;0
16265;66993;759;90;38;1;37;.974;3600000;0
16265;67446;759;0;0;0;0;.00nan;0;0
16265;85395;758;0;0;0;0;.00nan;0;0
16266;595;3913;99;38;1;37;.974;3900000;0
16266;177124;2199;96;37;1;36;.973;3900000;0
16266;149221;2199;0;0;0;0;.00nan;0;0
16266;149280;3913;0;0;0;0;.00nan;0;0
16267;175593;2545;0;0;0;0;.00nan;0;0
16267;49581;775;45;38;6;32;.842;3543000;0
16267;71485;775;0;0;0;0;.00nan;0;0
16267;94134;2545;27;21;5;16;.762;3600000;0
16268;11627;1503;0;0;0;0;.00nan;0;0
16268;67122;1503;70;39;5;34;.872;3600000;0
16268;93756;1497;0;0;0;0;.00nan;0;0
16268;149191;1497;100;33;0;33;1.000;3600000;0
16269;49815;3721;0;0;0;0;.00nan;0;0
16269;67818;3721;67;20;1;19;.950;3600000;0
16269;81691;762;0;0;0;0;.00nan;0;0
16269;146249;762;73;29;2;27;.931;3571000;0
16270;-1;911;0;0;0;0;.00nan;0;0
16270;170547;769;87;31;1;30;.968;3600000;0
16270;180177;911;64;30;3;27;.900;3544000;0
16270;154296;769;0;0;0;0;.00nan;0;0
16271;174894;766;0;0;0;0;.00nan;0;0
16271;43720;766;73;30;3;27;.900;3579000;0
16271;57172;1492;62;23;2;21;.913;3600000;0
16271;73639;1492;0;0;0;0;.00nan;0;0
16272;359;774;100;31;0;31;1.000;3600000;0
16272;180738;755;58;31;4;27;.871;3600000;0
16272;91194;774;0;0;0;0;.00nan;0;0
16272;149112;755;0;0;0;0;.00nan;0;0
16273;177124;2199;75;42;5;37;.881;3600000;0
16273;35024;760;63;14;1;13;.929;3600000;0
16273;56037;760;0;0;0;0;.00nan;0;0
16273;149221;2199;0;0;0;0;.00nan;0;0
16274;49581;775;66;42;5;37;.881;3600000;0
16274;49935;746;100;26;0;26;1.000;3600000;0
16274;71485;775;0;0;0;0;.00nan;0;0
16274;149119;746;0;0;0;0;.00nan;0;0
16275;595;3913;47;31;5;26;.839;3600000;0
16275;93756;1497;0;0;0;0;.00nan;0;0
16275;149191;1497;100;26;0;26;1.000;3600000;0
16275;149280;3913;0;0;0;0;.00nan;0;0
16276;175593;2545;0;0;0;0;.00nan;0;0
16276;81691;762;70;29;3;26;.897;3600000;0
16276;94134;2545;49;23;4;19;.826;3569000;0
16276;146249;762;0;0;0;0;.00nan;0;0
16277;3075;754;49;23;3;20;.870;3583000;0
16277;164424;750;76;24;1;23;.958;3600000;0
16277;10931;750;0;0;0;0;.00nan;0;0
16277;87758;754;0;0;0;0;.00nan;0;0
16278;359;774;60;25;3;22;.880;3600000;0
16278;57172;1492;0;0;0;0;.00nan;0;0
16278;73639;1492;99;42;1;41;.976;3600000;0
16278;91194;774;0;0;0;0;.00nan;0;0
16279;2140;1093;92;51;2;49;.961;3774000;0
16279;66993;759;72;29;3;26;.897;3721000;0
16279;67446;759;0;0;0;0;.00nan;0;0
16279;68233;1093;0;0;0;0;.00nan;0;0
16280;3241;768;0;0;0;0;.00nan;0;0
16280;170548;758;0;0;0;0;.00nan;0;0
16280;85395;758;76;55;5;50;.909;3600000;0
16280;86099;768;50;25;4;21;.840;3600000;0
16281;35024;760;87;38;2;36;.947;3600000;0
16281;56037;760;0;0;0;0;.00nan;0;0
16281;93756;1497;0;0;0;0;.00nan;0;0
16281;149191;1497;26;27;6;21;.778;3600000;0
16282;164424;750;48;25;4;21;.840;3600000;0
16282;10931;750;0;0;0;0;.00nan;0;0
16282;63932;2197;100;32;0;32;1.000;3600000;0
16282;94508;2197;0;0;0;0;.00nan;0;0
16283;3075;754;67;28;3;25;.893;3600000;0
16283;3957;4923;0;0;0;0;.00nan;0;0
16283;87758;754;0;0;0;0;.00nan;0;0
16283;148508;4923;98;24;0;24;1.000;3600000;0
16284;504;3730;89;27;1;26;.963;3900000;0
16284;11627;1503;78;24;1;23;.958;3900000;0
16284;67122;1503;0;0;0;0;.00nan;0;0
16284;76628;3730;0;0;0;0;.00nan;0;0
16285;147;767;71;24;1;23;.958;3900000;0
16285;-1;911;0;0;0;0;.00nan;0;0
16285;180177;911;96;35;1;34;.971;3900000;0
16285;82228;767;0;0;0;0;.00nan;0;0
16286;3241;768;0;0;0;0;.00nan;0;0
16286;76406;4989;51;10;1;9;.900;1066000;0
16286;86099;768;77;24;1;23;.958;3600000;0
16286;148691;4989;22;23;6;17;.739;2534000;0
16287;170548;758;0;0;0;0;.00nan;0;0
16287;174894;766;78;34;1;33;.971;3862000;0
16287;43720;766;0;0;0;0;.00nan;0;0
16287;85395;758;100;28;0;28;1.000;3862000;0
16288;2140;1093;50;16;2;14;.875;3568000;0
16288;175593;2545;97;23;0;23;1.000;3600000;0
16288;68233;1093;0;0;0;0;.00nan;0;0
16288;94134;2545;0;0;0;0;.00nan;0;0
16289;504;3730;83;30;1;29;.967;3600000;0
16289;170547;769;84;42;4;38;.905;3600000;0
16289;76628;3730;0;0;0;0;.00nan;0;0
16289;154296;769;0;0;0;0;.00nan;0;0
16290;3957;4923;0;0;0;0;.00nan;0;0
16290;4281;2197;0;0;0;0;.00nan;0;0
16290;94508;2197;87;38;2;36;.947;3900000;0
16290;148508;4923;92;41;2;39;.951;3900000;0
16291;49581;775;82;40;3;37;.925;3559000;0
16291;71485;775;0;0;0;0;.00nan;0;0
16291;81691;762;0;0;0;0;.00nan;0;0
16291;146249;762;67;18;1;17;.944;3600000;0
16292;11627;1503;0;0;0;0;.00nan;0;0
16292;180990;772;96;39;1;38;.974;3600000;0
16292;67122;1503;41;21;4;17;.810;3600000;0
16292;94018;772;0;0;0;0;.00nan;0;0
16293;35024;760;100;45;1;44;.978;3600000;0
16293;56037;760;0;0;0;0;.00nan;0;0
16293;57172;1492;40;28;5;23;.821;3600000;0
16293;73639;1492;0;0;0;0;.00nan;0;0
16294;174894;766;32;30;6;24;.800;3271000;0
16294;43720;766;40;2;1;1;.500;329000;0
16294;76406;4989;49;36;6;30;.833;3600000;0
16294;148691;4989;0;0;0;0;.00nan;0;0
16295;359;774;0;0;0;0;.00nan;0;0
16295;63932;758;0;0;0;0;.00nan;0;0
16295;85395;758;100;34;0;34;1.000;3600000;0
16295;91194;774;77;17;1;16;.941;3548000;0
16296;177124;2199;100;26;0;26;1.000;3600000;0
16296;93756;1497;0;0;0;0;.00nan;0;0
16296;149191;1497;77;40;2;38;.950;3576000;0
16296;149221;2199;0;0;0;0;.00nan;0;0
16297;595;3913;0;0;0;0;.00nan;0;0
16297;180738;755;82;33;2;31;.939;3554000;0
16297;149112;755;0;0;0;0;.00nan;0;0
16297;149280;3913;100;29;0;29;1.000;3600000;0
16298;2140;1093;56;37;5;32;.865;3600000;0
16298;49935;746;81;31;2;29;.935;3600000;0
16298;68233;1093;0;0;0;0;.00nan;0;0
16298;149119;746;0;0;0;0;.00nan;0;0
16299;164521;4924;63;34;3;31;.912;3548000;0
16299;175593;2545;63;28;2;26;.929;3600000;0
16299;94134;2545;0;0;0;0;.00nan;0;0
16299;158630;4924;0;0;0;0;.00nan;0;0
16300;170547;769;75;33;3;30;.909;3600000;0
16300;180990;772;0;0;0;0;.00nan;0;0
16300;94018;772;58;33;4;29;.879;3545000;0
16300;154296;769;0;0;0;0;.00nan;0;0
16301;3075;754;100;49;1;48;.980;3900000;0
16301;4281;2197;0;0;0;0;.00nan;0;0
16301;87758;754;0;0;0;0;.00nan;0;0
16301;94508;2197;97;33;1;32;.970;3900000;0
16302;3957;4923;0;0;0;0;.00nan;0;0
16302;164424;750;53;25;4;21;.840;3600000;0
16302;10931;750;0;0;0;0;.00nan;0;0
16302;148508;4923;82;33;2;31;.939;3600000;0
16303;164521;4924;0;0;0;0;.00nan;0;0
16303;66993;759;20;9;4;5;.556;946000;0
16303;67446;759;63;11;0;11;1.000;2600000;0
16303;158630;4924;67;36;3;33;.917;3600000;0
16304;35024;760;77;26;2;24;.923;3600000;0
16304;180738;755;94;50;3;47;.940;3565000;0
16304;56037;760;0;0;0;0;.00nan;0;0
16304;149112;755;0;0;0;0;.00nan;0;0
16305;2140;1093;94;21;0;21;1.000;3600000;0
16305;49815;3721;0;0;0;0;.00nan;0;0
16305;67818;3721;98;41;1;40;.976;3571000;0
16305;68233;1093;0;0;0;0;.00nan;0;0
16306;359;774;22;21;6;15;.714;3340000;0
16306;76406;4989;0;0;0;0;.00nan;0;0
16306;91194;774;54;1;0;1;1.000;260000;0
16306;148691;4989;88;42;3;39;.929;3600000;0
16307;595;3913;0;0;0;0;.00nan;0;0
16307;57172;1492;96;20;0;20;1.000;3600000;0
16307;73639;1492;0;0;0;0;.00nan;0;0
16307;149280;3913;69;28;2;26;.929;3600000;0
16308;49581;775;78;55;6;49;.891;3600000;0
16308;71485;775;0;0;0;0;.00nan;0;0
16308;86099;768;62;10;1;9;.900;3600000;0
16308;88874;768;0;0;0;0;.00nan;0;0
16309;147;767;100;32;0;32;1.000;3600000;0
16309;177124;2199;55;20;2;18;.900;3563000;0
16309;82228;767;0;0;0;0;.00nan;0;0
16309;149221;2199;0;0;0;0;.00nan;0;0
16310;-1;911;0;0;0;0;.00nan;0;0
16310;180177;911;89;33;1;32;.970;3600000;0
16310;93756;1497;0;0;0;0;.00nan;0;0
16310;149191;1497;68;37;4;33;.892;3600000;0
16311;15257;762;0;0;0;0;.00nan;0;0
16311;81691;762;100;46;2;44;.957;3600000;0
16311;86099;768;39;16;3;13;.813;3544000;0
16311;88874;768;0;0;0;0;.00nan;0;0
16312;504;3730;87;23;1;22;.957;3900000;0
16312;35024;760;89;26;1;25;.962;3900000;0
16312;56037;760;0;0;0;0;.00nan;0;0
16312;76628;3730;0;0;0;0;.00nan;0;0
16313;174894;766;0;0;0;0;.00nan;0;0
16313;43720;766;52;23;3;20;.870;3545000;0
16313;49581;775;69;25;2;23;.920;3600000;0
16313;71485;775;0;0;0;0;.00nan;0;0
16314;595;3913;94;28;1;27;.964;3600000;0
16314;180990;772;64;35;4;31;.886;3600000;0
16314;94018;772;0;0;0;0;.00nan;0;0
16314;149280;3913;0;0;0;0;.00nan;0;0
16315;170547;769;100;28;0;28;1.000;3600000;0
16315;49629;769;0;0;0;0;.00nan;0;0
16315;57172;1492;84;36;2;34;.944;3580000;0
16315;73639;1492;0;0;0;0;.00nan;0;0
16316;63932;758;55;4;0;4;1.000;1354000;0
16316;76406;4989;0;0;0;0;.00nan;0;0
16316;85395;758;10;18;6;12;.667;2246000;0
16316;148691;4989;100;46;0;46;1.000;3600000;0
16317;147;767;44;24;4;20;.833;3600000;0
16317;82228;767;0;0;0;0;.00nan;0;0
16317;93756;1497;0;0;0;0;.00nan;0;0
16317;149191;1497;57;26;3;23;.885;3600000;0
16318;4281;2197;0;0;0;0;.00nan;0;0
16318;175593;2545;0;0;0;0;.00nan;0;0
16318;94134;2545;72;29;2;27;.931;3522000;0
16318;94508;2197;100;21;0;21;1.000;3600000;0
16319;164521;4924;91;40;2;38;.950;3566000;0
16319;49935;746;67;12;1;11;.917;3600000;0
16319;149119;746;0;0;0;0;.00nan;0;0
16319;158630;4924;0;0;0;0;.00nan;0;0
16320;177124;2199;80;39;3;36;.923;3600000;0
16320;-1;911;51;9;1;8;.889;1285000;0
16320;180177;911;35;18;4;14;.778;2283000;0
16320;149221;2199;0;0;0;0;.00nan;0;0
16321;11627;1503;0;0;0;0;.00nan;0;0
16321;180738;755;63;29;3;26;.897;3600000;0
16321;67122;1503;46;35;5;30;.857;3575000;0
16321;149112;755;0;0;0;0;.00nan;0;0
16322;35024;760;79;33;3;30;.909;3693000;0
16322;180990;772;84;44;4;40;.909;3693000;0
16322;56037;760;0;0;0;0;.00nan;0;0
16322;94018;772;0;0;0;0;.00nan;0;0
16323;15257;762;61;29;3;26;.897;3600000;0
16323;174894;766;0;0;0;0;.00nan;0;0
16323;43720;766;69;39;4;35;.897;3600000;0
16323;81691;762;0;0;0;0;.00nan;0;0
16324;359;774;74;22;1;21;.955;3600000;0
16324;49581;775;90;52;4;48;.923;3600000;0
16324;71485;775;0;0;0;0;.00nan;0;0
16324;91194;774;0;0;0;0;.00nan;0;0
16325;504;3730;67;31;3;28;.903;3584000;0
16325;595;3913;99;39;1;38;.974;3600000;0
16325;76628;3730;0;0;0;0;.00nan;0;0
16325;149280;3913;0;0;0;0;.00nan;0;0
16326;164521;755;70;36;3;33;.917;3600000;0
16326;170547;769;0;0;0;0;.00nan;0;0
16326;180738;755;0;0;0;0;.00nan;0;0
16326;49629;769;40;24;5;19;.792;3600000;0
16327;4281;2197;0;0;0;0;.00nan;0;0
16327;66993;759;57;22;4;18;.818;3600000;0
16327;67446;759;0;0;0;0;.00nan;0;0
16327;94508;2197;100;39;1;38;.974;3600000;0
16328;9559;4924;0;0;0;0;.00nan;0;0
16328;49815;3721;87;29;1;28;.966;3600000;0
16328;67818;3721;0;0;0;0;.00nan;0;0
16328;158630;4924;54;42;5;37;.881;3600000;0
16329;3075;754;95;21;0;21;1.000;3600000;0
16329;175593;2545;60;34;4;30;.882;3600000;0
16329;87758;754;0;0;0;0;.00nan;0;0
16329;94134;2545;0;0;0;0;.00nan;0;0
16330;11627;1503;98;39;1;38;.974;3600000;0
16330;57172;1492;51;27;4;23;.852;3600000;0
16330;67122;1503;0;0;0;0;.00nan;0;0
16330;73639;1492;0;0;0;0;.00nan;0;0
16331;359;774;71;22;1;21;.955;3600000;0
16331;15257;762;86;35;2;33;.943;3600000;0
16331;81691;762;0;0;0;0;.00nan;0;0
16331;91194;774;0;0;0;0;.00nan;0;0
16332;164424;750;28;29;6;23;.793;3600000;0
16332;10931;750;0;0;0;0;.00nan;0;0
16332;175593;2545;0;0;0;0;.00nan;0;0
16332;94134;2545;100;38;0;38;1.000;3600000;0
16333;4281;2197;0;0;0;0;.00nan;0;0
16333;49935;746;92;34;1;33;.971;3600000;0
16333;94508;2197;55;29;4;25;.862;3600000;0
16333;149119;746;0;0;0;0;.00nan;0;0
16334;2140;1093;51;35;5;30;.857;2159000;0
16334;68233;1093;52;12;1;11;.917;1441000;0
16334;86099;768;95;16;0;16;1.000;3600000;0
16334;88874;768;0;0;0;0;.00nan;0;0
16335;3075;754;41;40;6;34;.850;3600000;0
16335;66993;759;63;23;2;21;.913;3600000;0
16335;67446;759;0;0;0;0;.00nan;0;0
16335;87758;754;0;0;0;0;.00nan;0;0
16336;-1;911;0;0;0;0;.00nan;0;0
16336;180177;911;70;39;4;35;.897;3600000;0
16336;180990;772;52;23;3;20;.870;3600000;0
16336;94018;772;0;0;0;0;.00nan;0;0
16337;11627;1503;0;0;0;0;.00nan;0;0
16337;67122;1503;73;36;3;33;.917;3600000;0
16337;76406;4989;0;0;0;0;.00nan;0;0
16337;148691;4989;39;29;5;24;.828;3565000;0
16338;147;767;85;32;1;31;.969;3600000;0
16338;504;3730;69;30;3;27;.900;3578000;0
16338;76628;3730;0;0;0;0;.00nan;0;0
16338;82228;767;0;0;0;0;.00nan;0;0
16339;170547;769;0;0;0;0;.00nan;0;0
16339;49629;769;83;34;2;32;.941;3730000;0
16339;63932;758;0;0;0;0;.00nan;0;0
16339;85395;758;53;24;3;21;.875;3730000;0
16340;595;3913;82;32;2;30;.938;3534000;0
16340;71485;775;0;0;0;0;.00nan;0;0
16340;149280;3913;0;0;0;0;.00nan;0;0
16340;154296;775;90;38;1;37;.974;3600000;0
16341;164424;750;91;37;0;37;1.000;3900000;0
16341;10931;750;0;0;0;0;.00nan;0;0
16341;66993;759;92;20;0;20;1.000;3900000;0
16341;67446;759;0;0;0;0;.00nan;0;0
16342;4281;2197;0;0;0;0;.00nan;0;0
16342;49815;3721;0;0;0;0;.00nan;0;0
16342;67818;3721;57;25;3;22;.880;3600000;0
16342;94508;2197;35;27;5;22;.815;3517000;0
16343;2140;1093;0;0;0;0;.00nan;0;0
16343;174894;766;0;0;0;0;.00nan;0;0
16343;43720;766;56;28;4;24;.857;3878000;0
16343;68233;1093;73;43;5;38;.884;3878000;0
16344;9559;4924;0;0;0;0;.00nan;0;0
16344;86099;768;64;21;2;19;.905;3900000;0
16344;88874;768;0;0;0;0;.00nan;0;0
16344;158630;4924;96;47;2;45;.957;3900000;0
16345;3075;754;0;0;0;0;.00nan;0;0
16345;49935;746;72;23;2;21;.913;3600000;0
16345;87758;754;65;40;4;36;.900;3595000;0
16345;149119;746;0;0;0;0;.00nan;0;0
16346;3957;4923;0;0;0;0;.00nan;0;0
16346;175593;2545;0;0;0;0;.00nan;0;0
16346;94134;2545;67;26;2;24;.923;3600000;0
16346;148508;4923;62;26;3;23;.885;3547000;0
16347;-1;911;0;0;0;0;.00nan;0;0
16347;180177;911;100;43;1;42;.977;3600000;0
16347;57172;1492;56;18;2;16;.889;3567000;0
16347;73639;1492;0;0;0;0;.00nan;0;0
16348;177124;2199;85;29;1;28;.966;3600000;0
16348;180990;772;96;37;2;35;.946;3582000;0
16348;94018;772;0;0;0;0;.00nan;0;0
16348;94134;2199;0;0;0;0;.00nan;0;0
16349;595;3913;100;17;0;17;1.000;3600000;0
16349;76406;4989;43;24;4;20;.833;3600000;0
16349;148691;4989;0;0;0;0;.00nan;0;0
16349;149280;3913;0;0;0;0;.00nan;0;0
16350;147;767;69;28;2;26;.929;3900000;0
16350;6098;767;0;0;0;0;.00nan;0;0
16350;164521;755;0;0;0;0;.00nan;0;0
16350;180738;755;80;29;2;27;.931;3900000;0
16351;504;3730;51;41;6;35;.854;3567000;0
16351;76628;3730;0;0;0;0;.00nan;0;0
16351;149191;1497;66;42;5;37;.881;3600000;0
16351;149221;1497;0;0;0;0;.00nan;0;0
16352;11627;1503;83;47;3;44;.936;3600000;0
16352;63932;758;0;0;0;0;.00nan;0;0
16352;82228;1503;0;0;0;0;.00nan;0;0
16352;85395;758;95;23;0;23;1.000;3600000;0
16353;35024;760;96;23;0;23;1.000;3600000;0
16353;56037;760;0;0;0;0;.00nan;0;0
16353;71485;775;50;27;5;22;.815;3600000;0
16353;154296;775;0;0;0;0;.00nan;0;0
16354;15257;762;0;0;0;0;.00nan;0;0
16354;170547;769;0;0;0;0;.00nan;0;0
16354;174894;762;80;31;2;29;.935;3886000;0
16354;49629;769;77;33;3;30;.909;3886000;0
16355;164424;750;73;30;2;28;.933;3600000;0
16355;10931;750;0;0;0;0;.00nan;0;0
16355;49581;746;0;0;0;0;.00nan;0;0
16355;49935;746;57;32;4;28;.875;3559000;0
16356;359;774;82;17;0;17;1.000;3600000;0
16356;2140;1093;78;38;3;35;.921;3600000;0
16356;68233;1093;0;0;0;0;.00nan;0;0
16356;91194;774;0;0;0;0;.00nan;0;0
16357;3075;4924;39;32;5;27;.844;3600000;0
16357;43720;766;88;29;1;28;.966;3600000;0
16357;149119;766;0;0;0;0;.00nan;0;0
16357;158630;4924;0;0;0;0;.00nan;0;0
16358;45363;754;0;0;0;0;.00nan;0;0
16358;49815;3721;0;0;0;0;.00nan;0;0
16358;67818;3721;80;27;1;26;.963;3600000;0
16358;87758;754;56;34;4;30;.882;3600000;0
16359;3957;4923;76;41;4;37;.902;3600000;0
16359;66993;759;65;13;1;12;.923;3600000;0
16359;67446;759;0;0;0;0;.00nan;0;0
16359;148508;4923;0;0;0;0;.00nan;0;0
16360;147;767;86;34;2;32;.941;3563000;0
16360;6098;767;0;0;0;0;.00nan;0;0
16360;57172;1492;79;13;0;13;1.000;3600000;0
16360;73639;1492;0;0;0;0;.00nan;0;0
16361;180990;772;87;32;1;31;.969;3859000;0
16361;94018;772;0;0;0;0;.00nan;0;0
16361;149191;1497;82;33;2;31;.939;3859000;0
16361;149221;1497;0;0;0;0;.00nan;0;0
16362;35024;760;71;30;3;27;.900;3600000;0
16362;56037;760;0;0;0;0;.00nan;0;0
16362;76406;4989;0;0;0;0;.00nan;0;0
16362;148691;4989;63;33;4;29;.879;3593000;0
16363;164521;755;0;0;0;0;.00nan;0;0
16363;-1;911;0;0;0;0;.00nan;0;0
16363;180177;911;96;38;2;36;.947;3900000;0
16363;180738;755;68;22;2;20;.909;3900000;0
16364;504;3730;71;31;3;28;.903;3522000;0
16364;177124;2199;85;30;1;29;.967;3600000;0
16364;76628;3730;0;0;0;0;.00nan;0;0
16364;94134;2199;0;0;0;0;.00nan;0;0
16365;595;3913;78;41;4;37;.902;3600000;0
16365;63932;758;0;0;0;0;.00nan;0;0
16365;85395;758;73;24;1;23;.958;3600000;0
16365;149280;3913;0;0;0;0;.00nan;0;0
16366;170547;769;0;0;0;0;.00nan;0;0
16366;49629;769;80;32;2;30;.938;3600000;0
16366;71485;775;0;0;0;0;.00nan;0;0
16366;154296;775;64;31;3;28;.903;3577000;0
16367;11627;1503;24;30;6;24;.800;3072000;0
16367;15257;762;0;0;0;0;.00nan;0;0
16367;174894;762;67;25;2;23;.920;3600000;0
16367;82228;1503;45;5;1;4;.800;528000;0
16368;164424;750;95;20;0;20;1.000;3600000;0
16368;10931;750;0;0;0;0;.00nan;0;0
16368;49815;3721;0;0;0;0;.00nan;0;0
16368;67818;3721;86;40;3;37;.925;3600000;0
16369;4281;2197;72;17;0;17;1.000;1455000;0
16369;86099;768;82;13;0;13;1.000;3600000;0
16369;93756;768;0;0;0;0;.00nan;0;0
16369;94508;2197;45;27;4;23;.852;2145000;0
16370;359;774;87;32;2;30;.938;3900000;0
16370;3075;4924;95;45;2;43;.956;3900000;0
16370;91194;774;0;0;0;0;.00nan;0;0
16370;158630;4924;0;0;0;0;.00nan;0;0
16371;3957;4923;0;0;0;0;.00nan;0;0
16371;49581;746;0;0;0;0;.00nan;0;0
16371;49935;746;61;27;4;23;.852;3900000;0
16371;148508;4923;63;39;4;35;.897;3900000;0
16372;57172;1492;87;17;0;17;1.000;3600000;0
16372;73639;1492;0;0;0;0;.00nan;0;0
16372;149191;1497;62;23;2;21;.913;3516000;0
16372;149221;1497;0;0;0;0;.00nan;0;0
16373;147;767;49;35;5;30;.857;3600000;0
16373;6098;767;0;0;0;0;.00nan;0;0
16373;180990;772;99;24;0;24;1.000;3600000;0
16373;94018;772;0;0;0;0;.00nan;0;0
16374;170547;769;0;0;0;0;.00nan;0;0
16374;49629;769;60;27;3;24;.889;3561000;0
16374;76406;4989;91;35;2;33;.943;3600000;0
16374;148691;4989;0;0;0;0;.00nan;0;0
16375;177124;2199;0;0;0;0;.00nan;0;0
16375;164521;755;100;54;1;53;.981;3900000;0
16375;180738;755;0;0;0;0;.00nan;0;0
16375;94134;2199;77;17;1;16;.941;3900000;0
16376;504;3730;0;0;0;0;.00nan;0;0
16376;-1;911;17;22;6;16;.727;1605000;0
16376;180177;911;51;29;4;25;.862;1995000;0
16376;76628;3730;75;23;1;22;.957;3600000;0
16377;35024;760;52;26;3;23;.885;3600000;0
16377;56037;760;0;0;0;0;.00nan;0;0
16377;63932;758;0;0;0;0;.00nan;0;0
16377;85395;758;74;45;4;41;.911;3585000;0
16378;11627;1503;81;18;0;18;1.000;3600000;0
16378;71485;775;0;0;0;0;.00nan;0;0
16378;82228;1503;0;0;0;0;.00nan;0;0
16378;154296;775;49;32;4;28;.875;3600000;0
16379;595;3913;91;44;2;42;.955;3600000;0
16379;15257;762;0;0;0;0;.00nan;0;0
16379;174894;762;39;15;3;12;.800;3565000;0
16379;149280;3913;0;0;0;0;.00nan;0;0
16380;45363;754;43;40;7;33;.825;2933000;0
16380;86099;768;63;17;1;16;.941;3600000;0
16380;87758;754;57;6;0;6;1.000;667000;0
16380;93756;768;0;0;0;0;.00nan;0;0
16381;4281;2197;0;0;0;0;.00nan;0;0
16381;43720;766;72;34;3;31;.912;3565000;0
16381;94508;2197;82;26;1;25;.962;3600000;0
16381;149119;766;0;0;0;0;.00nan;0;0
16382;3957;4923;0;0;0;0;.00nan;0;0
16382;49815;3721;0;0;0;0;.00nan;0;0
16382;67818;3721;60;23;2;21;.913;3900000;0
16382;148508;4923;73;38;2;36;.947;3900000;0
16383;177124;2199;64;28;2;26;.929;3571000;0
16383;57172;1492;88;32;1;31;.969;3600000;0
16383;73639;1492;0;0;0;0;.00nan;0;0
16383;94134;2199;0;0;0;0;.00nan;0;0
16384;164521;755;0;0;0;0;.00nan;0;0
16384;180738;755;89;39;2;37;.949;3600000;0
16384;149191;1497;50;24;3;21;.875;3579000;0
16384;149221;1497;0;0;0;0;.00nan;0;0
16385;9559;2545;0;0;0;0;.00nan;0;0
16385;175593;2545;79;25;1;24;.960;3784000;0
16385;66993;759;0;0;0;0;.00nan;0;0
16385;67446;759;76;29;2;27;.931;3784000;0
16386;15257;762;0;0;0;0;.00nan;0;0
16386;174894;762;54;35;4;31;.886;3600000;0
16386;35024;760;80;25;1;24;.960;3600000;0
16386;56037;760;0;0;0;0;.00nan;0;0
16387;164424;750;85;55;5;50;.909;3600000;0
16387;10931;750;0;0;0;0;.00nan;0;0
16387;86099;768;49;14;2;12;.857;3600000;0
16387;93756;768;0;0;0;0;.00nan;0;0
16388;43720;766;75;32;2;30;.938;3600000;0
16388;45363;754;62;29;3;26;.897;3600000;0
16388;87758;754;0;0;0;0;.00nan;0;0
16388;149119;766;0;0;0;0;.00nan;0;0
16389;359;774;58;25;3;22;.880;3622000;0
16389;4281;2197;0;0;0;0;.00nan;0;0
16389;190589;774;0;0;0;0;.00nan;0;0
16389;94508;2197;67;37;4;33;.892;3622000;0
16390;3075;4924;82;38;3;35;.921;3590000;0
16390;170547;769;0;0;0;0;.00nan;0;0
16390;49629;769;68;21;1;20;.952;3600000;0
16390;158630;4924;0;0;0;0;.00nan;0;0
16391;147;767;100;37;1;36;.973;3600000;0
16391;6098;767;0;0;0;0;.00nan;0;0
16391;63932;758;0;0;0;0;.00nan;0;0
16391;85395;758;60;30;3;27;.900;3514000;0
16392;9559;2545;0;0;0;0;.00nan;0;0
16392;175593;2545;72;30;3;27;.900;3735000;0
16392;49581;746;0;0;0;0;.00nan;0;0
16392;49935;746;66;23;2;21;.913;3735000;0
16393;-1;911;45;30;5;25;.833;3600000;0
16393;180177;911;0;0;0;0;.00nan;0;0
16393;76406;4989;0;0;0;0;.00nan;0;0
16393;148691;4989;82;30;2;28;.933;3600000;0
16394;2140;1093;64;20;3;17;.850;3515000;0
16394;11627;1503;89;36;1;35;.972;3600000;0
16394;68233;1093;0;0;0;0;.00nan;0;0
16394;82228;1503;0;0;0;0;.00nan;0;0
16395;3957;4923;0;0;0;0;.00nan;0;0
16395;86099;768;42;12;2;10;.833;3600000;0
16395;93756;768;0;0;0;0;.00nan;0;0
16395;148508;4923;99;68;1;67;.985;3600000;0
16396;164424;750;100;29;1;28;.966;3900000;0
16396;10931;750;0;0;0;0;.00nan;0;0
16396;43720;766;94;32;1;31;.969;3900000;0
16396;149119;766;0;0;0;0;.00nan;0;0
16397;359;774;44;24;4;20;.833;3573000;0
16397;190589;774;0;0;0;0;.00nan;0;0
16397;45363;754;100;35;2;33;.943;3600000;0
16397;87758;754;0;0;0;0;.00nan;0;0
16398;2140;1093;73;37;3;34;.919;3547000;0
16398;170547;769;0;0;0;0;.00nan;0;0
16398;49629;769;79;33;2;31;.939;3600000;0
16398;68233;1093;0;0;0;0;.00nan;0;0
16399;147;767;22;12;4;8;.667;936000;0
16399;6098;767;65;25;2;23;.920;2664000;0
16399;15257;762;0;0;0;0;.00nan;0;0
16399;174894;762;82;31;2;29;.935;3600000;0
16400;49581;746;0;0;0;0;.00nan;0;0
16400;49935;746;45;26;5;21;.808;3600000;0
16400;66993;759;92;42;2;40;.952;3600000;0
16400;67446;759;0;0;0;0;.00nan;0;0
16401;177124;2199;63;14;1;13;.929;3600000;0
16401;63932;758;0;0;0;0;.00nan;0;0
16401;85395;758;75;37;3;34;.919;3560000;0
16401;94134;2199;0;0;0;0;.00nan;0;0
16402;76406;4989;63;29;3;26;.897;3575000;0
16402;148691;4989;0;0;0;0;.00nan;0;0
16402;149191;1497;0;0;0;0;.00nan;0;0
16402;149221;1497;99;38;1;37;.974;3600000;0
16403;9559;2545;0;0;0;0;.00nan;0;0
16403;175593;2545;86;36;2;34;.944;3900000;0
16403;49815;3721;0;0;0;0;.00nan;0;0
16403;67818;3721;69;26;2;24;.923;3900000;0
16404;-1;911;0;0;0;0;.00nan;0;0
16404;180177;911;78;37;3;34;.919;3600000;0
16404;71485;775;0;0;0;0;.00nan;0;0
16404;154296;775;65;42;5;37;.881;3564000;0
16405;3075;4924;73;32;3;29;.906;3525000;0
16405;11627;1503;0;0;0;0;.00nan;0;0
16405;82228;1503;72;27;2;25;.926;3600000;0
16405;158630;4924;0;0;0;0;.00nan;0;0
16406;504;3730;79;30;1;29;.967;3900000;0
16406;57172;1492;81;24;1;23;.958;3900000;0
16406;73639;1492;0;0;0;0;.00nan;0;0
16406;76628;3730;0;0;0;0;.00nan;0;0
16407;164521;755;0;0;0;0;.00nan;0;0
16407;180738;755;84;31;1;30;.968;3600000;0
16407;180990;772;74;37;3;34;.919;3535000;0
16407;94018;772;0;0;0;0;.00nan;0;0
16408;3957;4923;0;0;0;0;.00nan;0;0
16408;43720;766;86;42;3;39;.929;3569000;0
16408;148508;4923;74;25;2;23;.920;3600000;0
16408;149119;766;0;0;0;0;.00nan;0;0
16409;359;774;70;30;2;28;.933;3600000;0
16409;164424;750;58;38;5;33;.868;3600000;0
16409;10931;750;0;0;0;0;.00nan;0;0
16409;190589;774;0;0;0;0;.00nan;0;0
16410;147;767;88;31;2;29;.935;3900000;0
16410;6098;767;0;0;0;0;.00nan;0;0
16410;71485;775;0;0;0;0;.00nan;0;0
16410;154296;775;90;43;2;41;.953;3900000;0
16411;49815;3721;0;0;0;0;.00nan;0;0
16411;66993;759;84;16;0;16;1.000;3600000;0
16411;67446;759;0;0;0;0;.00nan;0;0
16411;67818;3721;89;26;2;24;.923;3560000;0
16412;2140;1093;67;33;3;30;.909;3547000;0
16412;35024;760;77;22;1;21;.955;3600000;0
16412;56037;760;0;0;0;0;.00nan;0;0
16412;68233;1093;0;0;0;0;.00nan;0;0
16413;177124;2199;0;0;0;0;.00nan;0;0
16413;76406;4989;74;30;2;28;.933;3900000;0
16413;94134;2199;69;27;2;25;.926;3900000;0
16413;148691;4989;0;0;0;0;.00nan;0;0
16414;63932;758;0;0;0;0;.00nan;0;0
16414;85395;758;77;31;2;29;.935;3600000;0
16414;149191;1497;52;28;4;24;.857;3550000;0
16414;149221;1497;0;0;0;0;.00nan;0;0
16415;595;3913;73;29;3;26;.897;3600000;0
16415;3075;4924;65;43;5;38;.884;3576000;0
16415;149280;3913;0;0;0;0;.00nan;0;0
16415;158630;4924;0;0;0;0;.00nan;0;0
16416;15257;762;0;0;0;0;.00nan;0;0
16416;-1;911;0;0;0;0;.00nan;0;0
16416;174894;762;53;31;4;27;.871;3600000;0
16416;180177;911;97;31;1;30;.968;3600000;0
16417;180990;772;51;19;3;16;.842;3600000;0
16417;57172;1492;40;21;4;17;.810;1062000;0
16417;73639;1492;69;20;1;19;.950;2468000;0
16417;94018;772;0;0;0;0;.00nan;0;0
16418;504;3730;69;34;3;31;.912;3600000;0
16418;164521;755;0;0;0;0;.00nan;0;0
16418;180738;755;55;28;4;24;.857;3565000;0
16418;76628;3730;0;0;0;0;.00nan;0;0
16419;359;774;72;31;3;28;.903;3676000;0
16419;3957;4923;0;0;0;0;.00nan;0;0
16419;190589;774;0;0;0;0;.00nan;0;0
16419;148508;4923;62;28;4;24;.857;3676000;0
16420;147;767;48;22;3;19;.864;3600000;0
16420;6098;767;0;0;0;0;.00nan;0;0
16420;76406;4989;0;0;0;0;.00nan;0;0
16420;148691;4989;94;33;2;31;.939;3600000;0
16421;3075;4924;83;28;1;27;.964;3600000;0
16421;35024;760;0;0;0;0;.00nan;0;0
16421;56037;760;72;25;2;23;.920;3600000;0
16421;158630;4924;0;0;0;0;.00nan;0;0
16422;177124;2199;70;21;2;19;.905;3900000;0
16422;71485;775;0;0;0;0;.00nan;0;0
16422;94134;2199;0;0;0;0;.00nan;0;0
16422;154296;775;96;42;2;40;.952;3900000;0
16423;15257;762;0;0;0;0;.00nan;0;0
16423;174894;762;65;32;3;29;.906;3600000;0
16423;149191;1497;88;23;1;22;.957;3600000;0
16423;149221;1497;0;0;0;0;.00nan;0;0
16424;595;3913;84;24;1;23;.958;3600000;0
16424;2140;1093;58;34;4;30;.882;3600000;0
16424;68233;1093;0;0;0;0;.00nan;0;0
16424;149280;3913;0;0;0;0;.00nan;0;0
16425;49581;746;0;0;0;0;.00nan;0;0
16425;49815;3721;0;0;0;0;.00nan;0;0
16425;49935;746;99;36;1;35;.972;3900000;0
16425;67818;3721;82;34;1;33;.971;3900000;0
16426;-1;911;0;0;0;0;.00nan;0;0
16426;180177;911;63;21;2;19;.905;3600000;0
16426;63932;758;0;0;0;0;.00nan;0;0
16426;85395;758;62;18;1;17;.944;3600000;0
16427;9559;2545;71;49;4;45;.918;3900000;0
16427;175593;2545;0;0;0;0;.00nan;0;0
16427;86099;768;34;17;4;13;.765;2205000;0
16427;93756;768;55;1;0;1;1.000;1695000;0
16428;4281;2197;65;44;5;39;.886;3600000;0
16428;170547;769;74;28;2;26;.929;3600000;0
16428;49629;769;0;0;0;0;.00nan;0;0
16428;94508;2197;0;0;0;0;.00nan;0;0
16429;177124;2199;0;0;0;0;.00nan;0;0
16429;15257;762;0;0;0;0;.00nan;0;0
16429;174894;762;95;50;3;47;.940;3695000;0
16429;94134;2199;45;21;4;17;.810;3695000;0
16430;11627;1503;56;32;4;28;.875;3600000;0
16430;45363;754;57;26;3;23;.885;3600000;0
16430;82228;1503;0;0;0;0;.00nan;0;0
16430;87758;754;0;0;0;0;.00nan;0;0
16431;71485;775;0;0;0;0;.00nan;0;0
16431;149191;1497;50;20;3;17;.850;3600000;0
16431;149221;1497;0;0;0;0;.00nan;0;0
16431;154296;775;46;30;5;25;.833;3536000;0
16432;164521;755;0;0;0;0;.00nan;0;0
16432;180738;755;54;29;4;25;.862;3664000;0
16432;57172;1492;69;32;3;29;.906;3664000;0
16432;73639;1492;0;0;0;0;.00nan;0;0
16433;66993;759;66;39;5;34;.872;3600000;0
16433;67446;759;0;0;0;0;.00nan;0;0
16433;86099;768;77;25;1;24;.960;3600000;0
16433;93756;768;0;0;0;0;.00nan;0;0
16434;43720;766;84;36;3;33;.917;3537000;0
16434;49581;746;0;0;0;0;.00nan;0;0
16434;49935;746;66;17;1;16;.941;3600000;0
16434;149119;766;0;0;0;0;.00nan;0;0
16435;359;774;71;23;1;22;.957;3600000;0
16435;9559;2545;0;0;0;0;.00nan;0;0
16435;175593;2545;83;41;3;38;.927;3584000;0
16435;190589;774;0;0;0;0;.00nan;0;0
16436;504;3730;67;30;3;27;.900;3548000;0
16436;76406;4989;0;0;0;0;.00nan;0;0
16436;76628;3730;0;0;0;0;.00nan;0;0
16436;148691;4989;75;31;2;29;.935;3600000;0
16437;164424;750;0;0;0;0;.00nan;0;0
16437;10931;750;70;27;2;25;.926;3600000;0
16437;11627;1503;90;32;1;31;.969;3600000;0
16437;82228;1503;0;0;0;0;.00nan;0;0
16438;595;3913;76;34;3;31;.912;3537000;0
16438;4281;2197;0;0;0;0;.00nan;0;0
16438;94508;2197;83;24;1;23;.958;3600000;0
16438;149280;3913;0;0;0;0;.00nan;0;0
16439;180990;772;87;27;1;26;.963;3600000;0
16439;63932;758;0;0;0;0;.00nan;0;0
16439;85395;758;75;28;2;26;.929;3600000;0
16439;94018;772;0;0;0;0;.00nan;0;0
16440;2140;1093;0;0;0;0;.00nan;0;0
16440;-1;911;0;0;0;0;.00nan;0;0
16440;180177;911;95;31;1;30;.968;3600000;0
16440;68233;1093;51;14;2;12;.857;3574000;0
16441;147;767;59;22;2;20;.909;3600000;0
16441;3075;4924;41;31;6;25;.806;3094000;0
16441;6098;767;0;0;0;0;.00nan;0;0
16441;158630;4924;40;3;1;2;.667;506000;0
16442;35024;760;74;36;3;33;.917;3900000;0
16442;45363;754;0;0;0;0;.00nan;0;0
16442;56037;760;0;0;0;0;.00nan;0;0
16442;87758;754;61;30;3;27;.900;3900000;0
16443;3957;4923;0;0;0;0;.00nan;0;0
16443;170547;769;78;41;4;37;.902;3551000;0
16443;49629;769;0;0;0;0;.00nan;0;0
16443;148508;4923;70;29;2;27;.931;3600000;0
16444;359;774;84;29;1;28;.966;3600000;0
16444;190589;774;0;0;0;0;.00nan;0;0
16444;66993;759;88;47;4;43;.915;3600000;0
16444;67446;759;0;0;0;0;.00nan;0;0
16445;43720;766;100;47;2;45;.957;3600000;0
16445;49815;3721;53;23;3;20;.870;3543000;0
16445;67818;3721;0;0;0;0;.00nan;0;0
16445;149119;766;0;0;0;0;.00nan;0;0
16446;49581;746;0;0;0;0;.00nan;0;0
16446;49935;746;91;49;4;45;.918;3600000;0
16446;86099;768;43;31;5;26;.839;3587000;0
16446;93756;768;0;0;0;0;.00nan;0;0
16447;180990;772;63;19;2;17;.895;3600000;0
16447;76406;4989;68;36;3;33;.917;3571000;0
16447;94018;772;0;0;0;0;.00nan;0;0
16447;148691;4989;0;0;0;0;.00nan;0;0
16448;164424;750;79;23;1;22;.957;3600000;0
16448;10931;750;0;0;0;0;.00nan;0;0
16448;170547;769;70;33;3;30;.909;3559000;0
16448;49629;769;0;0;0;0;.00nan;0;0
16449;4281;2197;0;0;0;0;.00nan;0;0
16449;35024;760;72;19;1;18;.947;3600000;0
16449;56037;760;0;0;0;0;.00nan;0;0
16449;94508;2197;69;26;2;24;.923;3592000;0
16450;504;3730;45;28;5;23;.821;3664000;0
16450;63932;758;0;0;0;0;.00nan;0;0
16450;76628;3730;0;0;0;0;.00nan;0;0
16450;85395;758;67;36;4;32;.889;3669000;0
16451;147;767;84;36;2;34;.944;3796000;0
16451;2140;1093;78;40;3;37;.925;3796000;0
16451;6098;767;0;0;0;0;.00nan;0;0
16451;68233;1093;0;0;0;0;.00nan;0;0
16452;3075;4924;85;36;3;33;.917;3600000;0
16452;-1;911;0;0;0;0;.00nan;0;0
16452;180177;911;94;34;2;32;.941;3600000;0
16452;158630;4924;0;0;0;0;.00nan;0;0
16453;595;3913;62;30;4;26;.867;3600000;0
16453;45363;754;94;24;0;24;1.000;3600000;0
16453;87758;754;0;0;0;0;.00nan;0;0
16453;149280;3913;0;0;0;0;.00nan;0;0
16454;3957;4923;0;0;0;0;.00nan;0;0
16454;11627;1503;60;36;4;32;.889;3547000;0
16454;82228;1503;0;0;0;0;.00nan;0;0
16454;148508;4923;68;28;3;25;.893;3600000;0
16455;49815;3721;0;0;0;0;.00nan;0;0
16455;67818;3721;100;43;1;42;.977;3600000;0
16455;86099;768;71;27;2;25;.926;3556000;0
16455;93756;768;0;0;0;0;.00nan;0;0
16456;359;774;38;23;4;19;.826;2265000;0
16456;190589;774;55;5;0;5;1.000;1335000;0
16456;49581;746;0;0;0;0;.00nan;0;0
16456;49935;746;87;26;1;25;.962;3600000;0
16457;9559;2545;88;26;1;25;.962;3600000;0
16457;175593;2545;0;0;0;0;.00nan;0;0
16457;43720;766;74;28;2;26;.929;3558000;0
16457;149119;766;0;0;0;0;.00nan;0;0
16458;57172;1492;99;39;2;37;.949;3900000;0
16458;73639;1492;0;0;0;0;.00nan;0;0
16458;76406;4989;0;0;0;0;.00nan;0;0
16458;148691;4989;59;25;2;23;.920;3900000;0
16459;595;3913;100;42;0;42;1.000;3600000;0
16459;164424;750;59;19;2;17;.895;3534000;0
16459;10931;750;0;0;0;0;.00nan;0;0
16459;149280;3913;0;0;0;0;.00nan;0;0
16460;4281;2197;0;0;0;0;.00nan;0;0
16460;11627;1503;72;28;2;26;.929;3596000;0
16460;82228;1503;0;0;0;0;.00nan;0;0
16460;94508;2197;100;30;1;29;.967;3600000;0
16461;164521;755;0;0;0;0;.00nan;0;0
16461;180738;755;69;23;2;21;.913;3600000;0
16461;63932;758;84;30;1;29;.967;3600000;0
16461;85395;758;0;0;0;0;.00nan;0;0
16462;2140;1093;89;36;2;34;.944;3600000;0
16462;68233;1093;0;0;0;0;.00nan;0;0
16462;149191;1497;35;29;5;24;.828;3600000;0
16462;149221;1497;0;0;0;0;.00nan;0;0
16463;177124;2199;60;33;3;30;.909;3900000;0
16463;3075;4924;89;42;3;39;.929;3900000;0
16463;94134;2199;0;0;0;0;.00nan;0;0
16463;158630;4924;0;0;0;0;.00nan;0;0
16464;180990;772;77;36;2;34;.944;3600000;0
16464;71485;775;0;0;0;0;.00nan;0;0
16464;94018;772;0;0;0;0;.00nan;0;0
16464;154296;775;55;33;4;29;.879;3600000;0
16465;170547;769;44;21;4;17;.810;3600000;0
16465;45363;754;30;44;8;36;.818;3600000;0
16465;49629;769;0;0;0;0;.00nan;0;0
16465;87758;754;0;0;0;0;.00nan;0;0
16466;3957;4923;0;0;0;0;.00nan;0;0
16466;35024;760;61;33;4;29;.879;3600000;0
16466;56037;760;0;0;0;0;.00nan;0;0
16466;148508;4923;43;17;3;14;.824;3600000;0
16467;504;3730;85;45;4;41;.911;3600000;0
16467;15257;762;68;20;1;19;.950;3600000;0
16467;174894;762;0;0;0;0;.00nan;0;0
16467;76628;3730;0;0;0;0;.00nan;0;0
16468;43720;766;58;30;4;26;.867;3600000;0
16468;66993;759;100;30;0;30;1.000;3600000;0
16468;67446;759;0;0;0;0;.00nan;0;0
16468;149119;766;0;0;0;0;.00nan;0;0
16469;359;774;73;28;2;26;.929;3600000;0
16469;190589;774;0;0;0;0;.00nan;0;0
16469;49815;3721;0;0;0;0;.00nan;0;0
16469;67818;3721;93;35;1;34;.971;3600000;0
16470;164521;755;93;29;1;28;.966;3600000;0
16470;180738;755;0;0;0;0;.00nan;0;0
16470;76406;4989;0;0;0;0;.00nan;0;0
16470;148691;4989;69;29;2;27;.931;3600000;0
16471;164424;750;59;30;4;26;.867;3576000;0
16471;10931;750;0;0;0;0;.00nan;0;0
16471;35024;760;74;35;3;32;.914;3600000;0
16471;56037;760;0;0;0;0;.00nan;0;0
16472;57172;1492;84;35;2;33;.943;3550000;0
16472;63932;758;0;0;0;0;.00nan;0;0
16472;73639;1492;0;0;0;0;.00nan;0;0
16472;85395;758;81;27;1;26;.963;3600000;0
16473;177124;2199;0;0;0;0;.00nan;0;0
16473;2140;1093;88;35;2;33;.943;3600000;0
16473;68233;1093;0;0;0;0;.00nan;0;0
16473;94134;2199;72;22;1;21;.955;3600000;0
16474;3075;4924;45;40;6;34;.850;3209000;0
16474;149191;1497;60;27;3;24;.889;3600000;0
16474;149221;1497;0;0;0;0;.00nan;0;0
16474;158630;4924;53;4;0;4;1.000;391000;0
16475;504;3730;0;0;0;0;.00nan;0;0
16475;71485;775;0;0;0;0;.00nan;0;0
16475;76628;3730;57;27;3;24;.889;3849000;0
16475;154296;775;72;30;2;28;.933;3849000;0
16476;595;3913;74;22;1;21;.955;3600000;0
16476;3957;4923;0;0;0;0;.00nan;0;0
16476;148508;4923;80;52;5;47;.904;3600000;0
16476;149280;3913;0;0;0;0;.00nan;0;0
16477;15257;762;0;0;0;0;.00nan;0;0
16477;174894;762;58;43;5;38;.884;3600000;0
16477;180990;772;70;26;2;24;.923;3600000;0
16477;94018;772;0;0;0;0;.00nan;0;0
16478;164521;755;0;0;0;0;.00nan;0;0
16478;180738;755;67;25;2;23;.920;3600000;0
16478;71485;775;52;43;7;36;.837;3600000;0
16478;154296;775;0;0;0;0;.00nan;0;0
16479;15257;762;0;0;0;0;.00nan;0;0
16479;174894;762;100;43;1;42;.977;3600000;0
16479;57172;1492;87;30;2;28;.933;3598000;0
16479;73639;1492;0;0;0;0;.00nan;0;0
16480;170547;769;98;49;3;46;.939;3577000;0
16480;49629;769;0;0;0;0;.00nan;0;0
16480;49815;3721;0;0;0;0;.00nan;0;0
16480;67818;3721;85;30;2;28;.933;3600000;0
16481;2140;1093;78;31;2;29;.935;3569000;0
16481;180990;772;83;27;1;26;.963;3600000;0
16481;68233;1093;0;0;0;0;.00nan;0;0
16481;94018;772;0;0;0;0;.00nan;0;0
16482;147;767;86;28;1;27;.964;3600000;0
16482;164424;750;43;29;5;24;.828;3600000;0
16482;10931;750;0;0;0;0;.00nan;0;0
16482;67122;767;0;0;0;0;.00nan;0;0
16483;504;3730;58;25;3;22;.880;3589000;0
16483;3075;4924;73;27;2;25;.926;3600000;0
16483;76628;3730;0;0;0;0;.00nan;0;0
16483;158630;4924;0;0;0;0;.00nan;0;0
16484;35024;760;100;39;0;39;1.000;3600000;0
16484;56037;760;0;0;0;0;.00nan;0;0
16484;66993;759;63;19;2;17;.895;3572000;0
16484;67446;759;0;0;0;0;.00nan;0;0
16485;177124;2199;93;44;3;41;.932;3900000;0
16485;4281;2197;0;0;0;0;.00nan;0;0
16485;94134;2199;0;0;0;0;.00nan;0;0
16485;94508;2197;55;26;3;23;.885;3900000;0
16486;57172;1492;73;29;2;27;.931;3600000;0
16486;71485;775;0;0;0;0;.00nan;0;0
16486;73639;1492;0;0;0;0;.00nan;0;0
16486;154296;775;56;38;5;33;.868;3600000;0
16487;45363;754;71;39;3;36;.923;3549000;0
16487;87758;754;0;0;0;0;.00nan;0;0
16487;149191;1497;79;27;1;26;.963;3600000;0
16487;149221;1497;0;0;0;0;.00nan;0;0
16488;595;3913;0;0;0;0;.00nan;0;0
16488;9559;2545;0;0;0;0;.00nan;0;0
16488;175593;2545;33;26;5;21;.808;3600000;0
16488;149280;3913;86;31;1;30;.968;3600000;0
16489;164521;755;62;31;3;28;.903;3542000;0
16489;15257;762;0;0;0;0;.00nan;0;0
16489;174894;762;75;29;2;27;.931;3600000;0
16489;180738;755;0;0;0;0;.00nan;0;0
16490;3957;4923;0;0;0;0;.00nan;0;0
16490;-1;911;0;0;0;0;.00nan;0;0
16490;180177;911;84;30;2;28;.933;3600000;0
16490;148508;4923;58;27;3;24;.889;3566000;0
16491;11627;1503;83;40;2;38;.950;3900000;0
16491;49581;746;0;0;0;0;.00nan;0;0
16491;49935;746;76;26;2;24;.923;3900000;0
16491;82228;1503;0;0;0;0;.00nan;0;0
16492;43720;766;0;0;0;0;.00nan;0;0
16492;86099;768;59;11;1;10;.909;3600000;0
16492;93756;768;0;0;0;0;.00nan;0;0
16492;149119;766;88;57;6;51;.895;3600000;0
16493;170547;769;98;37;1;36;.973;3600000;0
16493;49581;746;0;0;0;0;.00nan;0;0
16493;49629;769;0;0;0;0;.00nan;0;0
16493;49935;746;69;25;2;23;.920;3600000;0
16494;3075;4924;63;30;3;27;.900;3512000;0
16494;180990;772;76;25;1;24;.960;3600000;0
16494;94018;772;0;0;0;0;.00nan;0;0
16494;158630;4924;0;0;0;0;.00nan;0;0
16495;147;767;75;38;4;34;.895;3567000;0
16495;3957;4923;0;0;0;0;.00nan;0;0
16495;67122;767;0;0;0;0;.00nan;0;0
16495;148508;4923;61;29;3;26;.897;3600000;0
16496;504;3730;34;19;4;15;.789;3523000;0
16496;2140;1093;98;45;2;43;.956;3600000;0
16496;68233;1093;0;0;0;0;.00nan;0;0
16496;76628;3730;0;0;0;0;.00nan;0;0
16497;9559;2545;0;0;0;0;.00nan;0;0
16497;175593;2545;81;45;4;41;.911;3600000;0
16497;35024;760;31;23;5;18;.783;3570000;0
16497;56037;760;0;0;0;0;.00nan;0;0
16498;177124;2199;0;0;0;0;.00nan;0;0
16498;45363;754;0;0;0;0;.00nan;0;0
16498;87758;754;61;44;6;38;.864;3600000;0
16498;94134;2199;64;15;1;14;.933;3600000;0
16499;4281;2197;0;0;0;0;.00nan;0;0
16499;94508;2197;84;33;2;31;.939;3600000;0
16499;149191;1497;59;34;4;30;.882;3576000;0
16499;149221;1497;0;0;0;0;.00nan;0;0
16500;595;3913;36;23;5;18;.783;3550000;0
16500;66993;759;90;44;4;40;.909;3600000;0
16500;67446;759;0;0;0;0;.00nan;0;0
16500;149280;3913;0;0;0;0;.00nan;0;0
16501;164424;750;70;22;2;20;.909;3600000;0
16501;10931;750;0;0;0;0;.00nan;0;0
16501;-1;911;0;0;0;0;.00nan;0;0
16501;180177;911;71;36;3;33;.917;3600000;0
16502;11627;1503;0;0;0;0;.00nan;0;0
16502;49815;3721;0;0;0;0;.00nan;0;0
16502;67818;3721;100;31;0;31;1.000;3600000;0
16502;82228;1503;73;32;2;30;.938;3513000;0
16503;359;774;70;24;2;22;.917;3600000;0
16503;190589;774;0;0;0;0;.00nan;0;0
16503;43720;766;64;37;4;33;.892;3600000;0
16503;149119;766;0;0;0;0;.00nan;0;0
16504;9559;2545;62;30;3;27;.900;3900000;0
16504;170547;769;76;36;3;33;.917;3900000;0
16504;175593;2545;0;0;0;0;.00nan;0;0
16504;49629;769;0;0;0;0;.00nan;0;0
16505;3075;4924;82;39;3;36;.923;3586000;0
16505;57172;1492;76;29;2;27;.931;3600000;0
16505;73639;1492;0;0;0;0;.00nan;0;0
16505;158630;4924;0;0;0;0;.00nan;0;0
16506;147;767;100;28;1;27;.964;3600000;0
16506;45363;754;75;33;2;31;.939;3543000;0
16506;87758;754;0;0;0;0;.00nan;0;0
16506;91358;767;0;0;0;0;.00nan;0;0
16507;2140;1093;96;32;1;31;.969;3600000;0
16507;164521;755;0;0;0;0;.00nan;0;0
16507;180738;755;85;29;2;27;.931;3588000;0
16507;68233;1093;0;0;0;0;.00nan;0;0
16508;35024;760;0;0;0;0;.00nan;0;0
16508;49581;746;0;0;0;0;.00nan;0;0
16508;49935;746;53;18;3;15;.833;3552000;0
16508;56037;760;84;41;2;39;.951;3600000;0
16509;177124;2199;81;30;2;28;.933;3600000;0
16509;3957;4923;0;0;0;0;.00nan;0;0
16509;94134;2199;0;0;0;0;.00nan;0;0
16509;148508;4923;55;47;5;42;.894;3600000;0
16510;63932;758;0;0;0;0;.00nan;0;0
16510;71485;775;67;30;3;27;.900;3075000;0
16510;85395;758;89;38;1;37;.974;3600000;0
16510;154296;775;23;6;3;3;.500;525000;0
16511;164424;750;90;39;2;37;.949;3600000;0
16511;10931;750;0;0;0;0;.00nan;0;0
16511;149191;1497;59;43;5;38;.884;3600000;0
16511;149221;1497;0;0;0;0;.00nan;0;0
16512;595;3913;55;28;4;24;.857;3600000;0
16512;49815;3721;0;0;0;0;.00nan;0;0
16512;67818;3721;54;38;6;32;.842;3600000;0
16512;149280;3913;0;0;0;0;.00nan;0;0
16513;15257;762;0;0;0;0;.00nan;0;0
16513;174894;762;44;36;5;31;.861;3570000;0
16513;76406;4989;0;0;0;0;.00nan;0;0
16513;148691;4989;55;30;4;26;.867;3600000;0
16514;4281;2197;0;0;0;0;.00nan;0;0
16514;-1;911;0;0;0;0;.00nan;0;0
16514;180177;911;72;41;4;37;.902;3530000;0
16514;94508;2197;74;28;2;26;.929;3600000;0
16515;11627;1503;58;35;4;31;.886;3600000;0
16515;66993;759;96;34;1;33;.971;3600000;0
16515;67446;759;0;0;0;0;.00nan;0;0
16515;82228;1503;0;0;0;0;.00nan;0;0
16516;359;774;43;44;7;37;.841;3600000;0
16516;190589;774;0;0;0;0;.00nan;0;0
16516;86099;768;0;0;0;0;.00nan;0;0
16516;93756;768;53;15;2;13;.867;3600000;0
16517;170547;769;99;41;1;40;.976;3600000;0
16517;49629;769;0;0;0;0;.00nan;0;0
16517;66993;759;67;21;3;18;.857;3596000;0
16517;67446;759;0;0;0;0;.00nan;0;0
16518;2140;1093;98;36;0;36;1.000;3900000;0
16518;57172;1492;89;20;0;20;1.000;3900000;0
16518;68233;1093;0;0;0;0;.00nan;0;0
16518;73639;1492;0;0;0;0;.00nan;0;0
16519;504;3730;62;39;4;35;.897;3600000;0
16519;180990;772;84;29;1;28;.966;3600000;0
16519;76628;3730;0;0;0;0;.00nan;0;0
16519;94018;772;0;0;0;0;.00nan;0;0
16520;147;767;93;30;1;29;.967;3600000;0
16520;4281;2197;0;0;0;0;.00nan;0;0
16520;91358;767;0;0;0;0;.00nan;0;0
16520;94508;2197;63;26;3;23;.885;3547000;0
16521;3075;4924;96;33;1;32;.970;3900000;0
16521;164521;755;96;36;1;35;.972;3900000;0
16521;180738;755;0;0;0;0;.00nan;0;0
16521;158630;4924;0;0;0;0;.00nan;0;0
16522;35024;760;100;39;0;39;1.000;3600000;0
16522;49815;3721;0;0;0;0;.00nan;0;0
16522;56037;760;0;0;0;0;.00nan;0;0
16522;67818;3721;76;29;3;26;.897;3600000;0
16523;177124;2199;81;25;2;23;.920;3543000;0
16523;164424;750;89;26;1;25;.962;3600000;0
16523;10931;750;0;0;0;0;.00nan;0;0
16523;94134;2199;0;0;0;0;.00nan;0;0
16524;71485;775;80;38;5;33;.868;3585000;0
16524;76406;4989;0;0;0;0;.00nan;0;0
16524;148691;4989;68;22;3;19;.864;3600000;0
16524;154296;775;0;0;0;0;.00nan;0;0
16525;3957;4923;0;0;0;0;.00nan;0;0
16525;148508;4923;62;41;5;36;.878;3600000;0
16525;149191;1497;100;25;0;25;1.000;3600000;0
16525;149221;1497;0;0;0;0;.00nan;0;0
16526;595;3913;100;33;0;33;1.000;3644000;0
16526;49581;746;0;0;0;0;.00nan;0;0
16526;49935;746;91;28;1;27;.964;3644000;0
16526;149280;3913;0;0;0;0;.00nan;0;0
16527;15257;762;0;0;0;0;.00nan;0;0
16527;174894;762;74;26;2;24;.923;3549000;0
16527;63932;758;0;0;0;0;.00nan;0;0
16527;85395;758;94;18;0;18;1.000;3600000;0
16528;-1;911;0;0;0;0;.00nan;0;0
16528;180177;911;92;28;1;27;.964;3600000;0
16528;45363;754;46;35;5;30;.857;3600000;0
16528;87758;754;0;0;0;0;.00nan;0;0
16529;9559;2545;0;0;0;0;.00nan;0;0
16529;11627;1503;61;23;3;20;.870;3580000;0
16529;175593;2545;72;26;2;24;.923;3600000;0
16529;82228;1503;0;0;0;0;.00nan;0;0
16531;177124;2199;0;0;0;0;.00nan;0;0
16531;174894;766;0;0;0;0;.00nan;0;0
16531;43720;766;47;24;4;20;.833;3553000;0
16531;149221;2199;73;35;3;32;.914;3600000;0
16533;180738;755;86;31;1;30;.968;3600000;0
16533;49935;746;56;20;2;18;.900;3578000;0
16533;149112;755;0;0;0;0;.00nan;0;0
16533;149119;746;0;0;0;0;.00nan;0;0
16535;10931;759;0;0;0;0;.00nan;0;0
16535;-1;911;60;8;0;8;1.000;811000;0
16535;180177;911;33;37;7;30;.811;2789000;0
16535;66993;759;70;30;4;26;.867;3600000;0
16537;170547;769;77;42;4;38;.905;3600000;0
16537;180990;772;100;27;0;27;1.000;3600000;0
16537;94018;772;0;0;0;0;.00nan;0;0
16537;154296;769;0;0;0;0;.00nan;0;0
16539;147;767;94;44;3;41;.932;3900000;0
16539;175593;2545;0;0;0;0;.00nan;0;0
16539;82228;767;0;0;0;0;.00nan;0;0
16539;94134;2545;66;32;3;29;.906;3900000;0
16541;595;3913;50;31;4;27;.871;3201000;0
16541;2140;1093;100;29;0;29;1.000;3600000;0
16541;68233;1093;0;0;0;0;.00nan;0;0
16541;149280;3913;42;3;1;2;.667;399000;0
16543;63932;2197;59;36;4;32;.889;3600000;0
16543;76406;4989;42;3;1;2;.667;646000;0
16543;94508;2197;0;0;0;0;.00nan;0;0
16543;148691;4989;43;22;4;18;.818;2950000;0
16545;164424;750;71;21;1;20;.952;3900000;0
16545;181910;760;0;0;0;0;.00nan;0;0
16545;56037;760;86;28;1;27;.964;3898000;0
16545;67446;750;0;0;0;0;.00nan;0;0
16547;164521;4924;0;0;0;0;.00nan;0;0
16547;11627;1503;0;0;0;0;.00nan;0;0
16547;67122;1503;64;30;3;27;.900;3512000;0
16547;158630;4924;94;30;1;29;.967;3600000;0
16549;504;3730;92;36;2;34;.944;3665000;0
16549;57172;1492;84;26;1;25;.962;3665000;0
16549;76628;3730;0;0;0;0;.00nan;0;0
16549;148652;1492;0;0;0;0;.00nan;0;0
16551;3241;768;89;29;2;27;.931;3900000;0
16551;49581;775;81;34;2;32;.941;3900000;0
16551;71485;775;0;0;0;0;.00nan;0;0
16551;82711;768;0;0;0;0;.00nan;0;0
16553;3075;754;73;30;2;28;.933;3546000;0
16553;170548;758;77;23;1;22;.957;3600000;0
16553;81085;758;0;0;0;0;.00nan;0;0
16553;87758;754;0;0;0;0;.00nan;0;0
16555;359;774;66;22;2;20;.909;3600000;0
16555;91194;774;0;0;0;0;.00nan;0;0
16555;93756;1497;0;0;0;0;.00nan;0;0
16555;149191;1497;55;31;3;28;.903;3551000;0
16557;3957;4923;0;0;0;0;.00nan;0;0
16557;81691;762;0;0;0;0;.00nan;0;0
16557;146249;762;85;39;2;37;.949;3584000;0
16557;148508;4923;77;23;1;22;.957;3600000;0
16559;170548;758;69;22;1;21;.955;3600000;0
16559;181910;760;51;32;4;28;.875;3600000;0
16559;56037;760;0;0;0;0;.00nan;0;0
16559;81085;758;0;0;0;0;.00nan;0;0
16561;359;774;79;32;2;30;.938;3600000;0
16561;81691;762;50;21;3;18;.857;3552000;0
16561;91194;774;0;0;0;0;.00nan;0;0
16561;146249;762;0;0;0;0;.00nan;0;0
16563;177124;2199;0;0;0;0;.00nan;0;0
16563;3075;754;0;0;0;0;.00nan;0;0
16563;87758;754;74;34;3;31;.912;3900000;0
16563;149221;2199;79;32;3;29;.906;3888000;0
16565;180738;755;0;0;0;0;.00nan;0;0
16565;76406;4989;0;0;0;0;.00nan;0;0
16565;148691;4989;100;23;0;23;1.000;3600000;0
16565;149112;755;84;32;1;31;.969;3573000;0
16567;-1;911;0;0;0;0;.00nan;0;0
16567;175593;2545;0;0;0;0;.00nan;0;0
16567;180177;911;97;38;2;36;.947;3900000;0
16567;94134;2545;81;30;2;28;.933;3900000;0
16569;10931;759;0;0;0;0;.00nan;0;0
16569;180990;772;78;36;2;34;.944;3600000;0
16569;66993;759;39;31;6;25;.806;3600000;0
16569;94018;772;0;0;0;0;.00nan;0;0
16571;2140;1093;34;23;5;18;.783;3600000;0
16571;11627;1503;0;0;0;0;.00nan;0;0
16571;67122;1503;56;21;3;18;.857;3600000;0
16571;68233;1093;0;0;0;0;.00nan;0;0
16573;504;3730;82;36;2;34;.944;3600000;0
16573;49815;3721;0;0;0;0;.00nan;0;0
16573;67818;3721;62;24;3;21;.875;3546000;0
16573;76628;3730;0;0;0;0;.00nan;0;0
16575;595;3913;81;21;1;20;.952;3600000;0
16575;3957;4923;0;0;0;0;.00nan;0;0
16575;148508;4923;30;30;6;24;.800;3600000;0
16575;149280;3913;0;0;0;0;.00nan;0;0
16577;3241;768;0;0;0;0;.00nan;0;0
16577;49935;746;100;31;0;31;1.000;3600000;0
16577;82711;768;75;22;1;21;.955;3555000;0
16577;149119;746;0;0;0;0;.00nan;0;0
16579;164424;750;77;24;1;23;.958;3600000;0
16579;49581;775;10;31;8;23;.742;2768000;0
16579;67446;750;0;0;0;0;.00nan;0;0
16579;71485;775;57;5;0;5;1.000;832000;0
16581;147;767;84;32;2;30;.938;3639000;0
16581;63932;2197;71;33;3;30;.909;3639000;0
16581;82228;767;0;0;0;0;.00nan;0;0
16581;94508;2197;0;0;0;0;.00nan;0;0
16583;57172;1492;62;28;3;25;.893;3600000;0
16583;73639;1492;0;0;0;0;.00nan;0;0
16583;93756;1497;81;50;4;46;.920;3588000;0
16583;149191;1497;0;0;0;0;.00nan;0;0
16585;164521;4924;17;34;7;27;.794;3060000;0
16585;174894;766;0;0;0;0;.00nan;0;0
16585;43720;766;62;22;2;20;.909;3600000;0
16585;158630;4924;39;1;1;0;.000;540000;0
16587;177124;2199;66;26;2;24;.923;3600000;0
16587;3241;768;24;25;6;19;.760;3600000;0
16587;82711;768;0;0;0;0;.00nan;0;0
16587;149221;2199;0;0;0;0;.00nan;0;0
16589;164521;4924;0;0;0;0;.00nan;0;0
16589;11627;1503;75;35;3;32;.914;3584000;0
16589;67122;1503;0;0;0;0;.00nan;0;0
16589;158630;4924;83;31;1;30;.968;3600000;0
16591;49581;775;0;0;0;0;.00nan;0;0
16591;49935;746;88;24;1;23;.958;3900000;0
16591;71485;775;89;36;1;35;.972;3900000;0
16591;149119;746;0;0;0;0;.00nan;0;0
16593;170547;769;25;6;3;3;.500;585000;0
16593;174894;766;75;26;2;24;.923;3600000;0
16593;43720;766;0;0;0;0;.00nan;0;0
16593;154296;769;76;34;3;31;.912;3015000;0
16595;3957;4923;93;40;2;38;.950;3600000;0
16595;170548;758;0;0;0;0;.00nan;0;0
16595;81085;758;36;23;4;19;.826;3567000;0
16595;148508;4923;0;0;0;0;.00nan;0;0
16597;175593;2545;78;34;2;32;.941;3900000;0
16597;57172;1492;0;0;0;0;.00nan;0;0
16597;73639;1492;93;38;2;36;.947;3900000;0
16597;94134;2545;0;0;0;0;.00nan;0;0
16599;504;3730;0;0;0;0;.00nan;0;0
16599;595;3913;0;0;0;0;.00nan;0;0
16599;76628;3730;92;23;0;23;1.000;3600000;0
16599;149280;3913;67;38;4;34;.895;3600000;0
16601;10931;759;77;26;1;25;.962;3600000;0
16601;181910;760;0;0;0;0;.00nan;0;0
16601;56037;760;70;34;3;31;.912;3575000;0
16601;66993;759;0;0;0;0;.00nan;0;0
16603;3075;754;58;25;3;22;.880;3515000;0
16603;76406;4989;0;0;0;0;.00nan;0;0
16603;87758;754;0;0;0;0;.00nan;0;0
16603;148691;4989;75;26;1;25;.962;3600000;0
16605;147;767;0;0;0;0;.00nan;0;0
16605;82228;767;100;36;0;36;1.000;3600000;0
16605;93756;1497;0;0;0;0;.00nan;0;0
16605;149191;1497;69;20;1;19;.950;3558000;0
16607;180990;772;0;0;0;0;.00nan;0;0
16607;49815;3721;77;34;2;32;.941;3621000;0
16607;67818;3721;0;0;0;0;.00nan;0;0
16607;94018;772;69;32;3;29;.906;3621000;0
16609;-1;911;61;41;4;37;.902;3600000;0
16609;180177;911;0;0;0;0;.00nan;0;0
16609;180738;755;82;25;1;24;.960;3600000;0
16609;149112;755;0;0;0;0;.00nan;0;0
16611;164424;750;0;0;0;0;.00nan;0;0
16611;67446;750;90;49;4;45;.918;3600000;0
16611;81691;762;0;0;0;0;.00nan;0;0
16611;146249;762;88;33;1;32;.970;3600000;0
16613;2140;1093;0;0;0;0;.00nan;0;0
16613;63932;2197;0;0;0;0;.00nan;0;0
16613;68233;1093;50;21;2;19;.905;3900000;0
16613;94508;2197;95;36;2;34;.944;3900000;0
16615;170547;769;0;0;0;0;.00nan;0;0
16615;175593;2545;63;33;4;29;.879;3569000;0
16615;94134;2545;0;0;0;0;.00nan;0;0
16615;154296;769;99;40;2;38;.950;3600000;0
16617;147;767;48;34;5;29;.853;3600000;0
16617;3075;754;0;0;0;0;.00nan;0;0
16617;82228;767;0;0;0;0;.00nan;0;0
16617;87758;754;100;35;0;35;1.000;3600000;0
16619;177124;2199;0;0;0;0;.00nan;0;0
16619;-1;911;0;0;0;0;.00nan;0;0
16619;180177;911;79;31;1;30;.968;3600000;0
16619;149221;2199;77;22;2;20;.909;3542000;0
16621;2140;1093;100;26;0;26;1.000;3600000;0
16621;170548;758;80;33;2;31;.939;3562000;0
16621;68233;1093;0;0;0;0;.00nan;0;0
16621;81085;758;0;0;0;0;.00nan;0;0
16623;181910;760;28;16;4;12;.750;1092000;0
16623;49935;746;71;23;2;21;.913;3600000;0
16623;56037;760;79;38;2;36;.947;2508000;0
16623;149119;746;0;0;0;0;.00nan;0;0
16625;164521;4924;0;0;0;0;.00nan;0;0
16625;57172;1492;46;16;2;14;.875;3551000;0
16625;73639;1492;0;0;0;0;.00nan;0;0
16625;158630;4924;80;26;1;25;.962;3600000;0
16627;49815;3721;0;0;0;0;.00nan;0;0
16627;67818;3721;71;41;4;37;.902;3600000;0
16627;93756;1497;0;0;0;0;.00nan;0;0
16627;149191;1497;30;22;5;17;.773;3573000;0
16629;63932;2197;0;0;0;0;.00nan;0;0
16629;81691;762;45;2;1;1;.500;282000;0
16629;94508;2197;60;30;4;26;.867;3600000;0
16629;146249;762;74;38;4;34;.895;3281000;0
16631;180990;772;93;50;3;47;.940;3672000;0
16631;76406;4989;0;0;0;0;.00nan;0;0
16631;94018;772;0;0;0;0;.00nan;0;0
16631;148691;4989;46;21;4;17;.810;3684000;0
16633;3957;4923;0;0;0;0;.00nan;0;0
16633;10931;759;0;0;0;0;.00nan;0;0
16633;66993;759;79;23;2;21;.913;3516000;0
16633;148508;4923;100;25;0;25;1.000;3600000;0
16635;359;774;53;13;2;11;.846;3600000;0
16635;49581;775;85;38;3;35;.921;3600000;0
16635;71485;775;0;0;0;0;.00nan;0;0
16635;91194;774;0;0;0;0;.00nan;0;0
16637;504;3730;0;0;0;0;.00nan;0;0
16637;11627;1503;0;0;0;0;.00nan;0;0
16637;67122;1503;89;32;1;31;.969;3600000;0
16637;76628;3730;67;35;3;32;.914;3564000;0
16639;595;3913;49;20;3;17;.850;3600000;0
16639;164424;750;40;28;5;23;.821;3549000;0
16639;67446;750;0;0;0;0;.00nan;0;0
16639;149280;3913;0;0;0;0;.00nan;0;0
16641;3241;768;89;29;1;28;.966;3863000;0
16641;174894;766;0;0;0;0;.00nan;0;0
16641;43720;766;89;37;2;35;.946;3863000;0
16641;82711;768;0;0;0;0;.00nan;0;0
16643;2140;1093;96;27;1;26;.963;3600000;0
16643;10931;759;43;24;4;20;.833;3600000;0
16643;66993;759;0;0;0;0;.00nan;0;0
16643;68233;1093;0;0;0;0;.00nan;0;0
16645;164424;750;0;0;0;0;.00nan;0;0
16645;175593;2545;0;0;0;0;.00nan;0;0
16645;67446;750;90;42;2;40;.952;3557000;0
16645;94134;2545;99;24;0;24;1.000;3600000;0
16647;63932;2197;25;20;5;15;.750;1879000;0
16647;81691;762;63;38;5;33;.868;3900000;0
16647;94508;2197;66;17;0;17;1.000;2021000;0
16647;146249;762;0;0;0;0;.00nan;0;0
16649;174894;766;80;23;1;22;.957;3600000;0
16649;180738;755;80;25;2;23;.920;3568000;0
16649;43720;766;0;0;0;0;.00nan;0;0
16649;149112;755;0;0;0;0;.00nan;0;0
16651;3075;754;0;0;0;0;.00nan;0;0
16651;164521;4924;61;24;2;22;.917;3576000;0
16651;87758;754;78;25;1;24;.960;3600000;0
16651;158630;4924;0;0;0;0;.00nan;0;0
16653;3957;4923;0;0;0;0;.00nan;0;0
16653;49935;746;0;0;0;0;.00nan;0;0
16653;148508;4923;57;34;4;30;.882;3600000;0
16653;149119;746;73;23;1;22;.957;3600000;0
16655;170547;769;73;38;3;35;.921;3600000;0
16655;49581;775;0;0;0;0;.00nan;0;0
16655;71485;775;100;23;0;23;1.000;3600000;0
16655;154296;769;0;0;0;0;.00nan;0;0
16657;49815;3721;40;28;5;23;.821;3600000;0
16657;67818;3721;0;0;0;0;.00nan;0;0
16657;76406;4989;61;20;2;18;.900;3600000;0
16657;148691;4989;0;0;0;0;.00nan;0;0
16659;177124;2199;85;46;4;42;.913;3574000;0
16659;3241;768;0;0;0;0;.00nan;0;0
16659;82711;768;64;21;3;18;.857;3600000;0
16659;149221;2199;0;0;0;0;.00nan;0;0
16661;359;774;0;0;0;0;.00nan;0;0
16661;180990;772;0;0;0;0;.00nan;0;0
16661;91194;774;43;27;4;23;.852;3600000;0
16661;94018;772;60;34;5;29;.853;3570000;0
16663;170548;758;0;0;0;0;.00nan;0;0
16663;181910;760;75;15;1;14;.933;3600000;0
16663;56037;760;0;0;0;0;.00nan;0;0
16663;81085;758;72;26;2;24;.923;3542000;0
16665;11627;1503;70;25;2;23;.920;3600000;0
16665;-1;911;57;33;4;29;.879;3546000;0
16665;180177;911;0;0;0;0;.00nan;0;0
16665;67122;1503;0;0;0;0;.00nan;0;0
16667;595;3913;0;0;0;0;.00nan;0;0
16667;57172;1492;0;0;0;0;.00nan;0;0
16667;73639;1492;58;28;3;25;.893;3600000;0
16667;149280;3913;81;41;4;37;.902;3578000;0
16669;147;767;0;0;0;0;.00nan;0;0
16669;82228;767;86;31;3;28;.903;3600000;0
16669;93756;1497;48;29;4;25;.862;3598000;0
16669;149191;1497;0;0;0;0;.00nan;0;0
16671;359;774;72;27;2;25;.926;3600000;0
16671;164424;750;32;39;8;31;.795;3045000;0
16671;67446;750;56;4;0;4;1.000;555000;0
16671;91194;774;0;0;0;0;.00nan;0;0
16673;3957;4923;78;31;2;29;.935;3900000;0
16673;170548;758;83;33;2;31;.939;3900000;0
16673;81085;758;0;0;0;0;.00nan;0;0
16673;148508;4923;0;0;0;0;.00nan;0;0
16675;177124;2199;0;0;0;0;.00nan;0;0
16675;81691;762;63;25;2;23;.920;3600000;0
16675;146249;762;0;0;0;0;.00nan;0;0
16675;149221;2199;41;24;4;20;.833;3581000;0
16677;147;767;70;26;2;24;.923;3900000;0
16677;181910;760;0;0;0;0;.00nan;0;0
16677;56037;760;48;19;2;17;.895;3900000;0
16677;82228;767;0;0;0;0;.00nan;0;0
16679;504;3730;64;23;2;21;.913;3576000;0
16679;11627;1503;0;0;0;0;.00nan;0;0
16679;67122;1503;100;29;0;29;1.000;3600000;0
16679;76628;3730;0;0;0;0;.00nan;0;0
16681;49815;3721;0;0;0;0;.00nan;0;0
16681;67818;3721;77;34;3;31;.912;3900000;0
16681;76406;4989;0;0;0;0;.00nan;0;0
16681;148691;4989;59;23;3;20;.870;3876000;0
16683;175593;2545;0;0;0;0;.00nan;0;0
16683;49581;775;0;0;0;0;.00nan;0;0
16683;71485;775;68;34;3;31;.912;3600000;0
16683;94134;2545;93;23;0;23;1.000;3600000;0
16685;3241;768;78;27;1;26;.963;3600000;0
16685;63932;2197;98;43;2;41;.953;3573000;0
16685;82711;768;0;0;0;0;.00nan;0;0
16685;94508;2197;0;0;0;0;.00nan;0;0
16687;2140;1093;87;31;1;30;.968;3600000;0
16687;68233;1093;0;0;0;0;.00nan;0;0
16687;93756;1497;0;0;0;0;.00nan;0;0
16687;149191;1497;28;24;6;18;.750;3600000;0
16689;10931;759;0;0;0;0;.00nan;0;0
16689;180738;755;0;0;0;0;.00nan;0;0
16689;66993;759;67;32;3;29;.906;3557000;0
16689;149112;755;84;29;2;27;.931;3600000;0
16691;180990;772;84;36;2;34;.944;3600000;0
16691;57172;1492;60;31;3;28;.903;3555000;0
16691;73639;1492;0;0;0;0;.00nan;0;0
16691;94018;772;0;0;0;0;.00nan;0;0
16693;595;3913;26;6;3;3;.500;517000;0
16693;49935;746;87;16;0;16;1.000;3600000;0
16693;149119;746;0;0;0;0;.00nan;0;0
16693;149280;3913;84;39;3;36;.923;3083000;0
16695;164521;4924;0;0;0;0;.00nan;0;0
16695;174894;766;0;0;0;0;.00nan;0;0
16695;43720;766;35;24;5;19;.792;3600000;0
16695;158630;4924;94;37;1;36;.973;3600000;0
16697;3075;754;82;31;2;29;.935;3531000;0
16697;170547;769;0;0;0;0;.00nan;0;0
16697;87758;754;0;0;0;0;.00nan;0;0
16697;154296;769;100;22;0;22;1.000;3600000;0
16699;3241;768;0;0;0;0;.00nan;0;0
16699;49815;3721;96;42;2;40;.952;3900000;0
16699;67818;3721;0;0;0;0;.00nan;0;0
16699;82711;768;64;15;2;13;.867;3900000;0
16701;3957;4923;0;0;0;0;.00nan;0;0
16701;164521;4924;56;33;4;29;.879;3521000;0
16701;148508;4923;72;24;2;22;.917;3600000;0
16701;158630;4924;0;0;0;0;.00nan;0;0
16703;10931;759;0;0;0;0;.00nan;0;0
16703;66993;759;55;13;1;12;.923;3600000;0
16703;81691;762;0;0;0;0;.00nan;0;0
16703;146249;762;75;42;4;38;.905;3600000;0
16705;49581;775;77;40;3;37;.925;3600000;0
16705;49935;746;94;19;0;19;1.000;3600000;0
16705;71485;775;0;0;0;0;.00nan;0;0
16705;149119;746;0;0;0;0;.00nan;0;0
16707;359;774;0;0;0;0;.00nan;0;0
16707;76406;4989;89;45;2;43;.956;3575000;0
16707;91194;774;100;17;0;17;1.000;3600000;0
16707;148691;4989;0;0;0;0;.00nan;0;0
16709;-1;911;0;0;0;0;.00nan;0;0
16709;180177;911;46;27;4;23;.852;3552000;0
16709;180990;772;0;0;0;0;.00nan;0;0
16709;94018;772;99;44;2;42;.955;3600000;0
16711;177124;2199;83;23;1;22;.957;3600000;0
16711;164424;750;0;0;0;0;.00nan;0;0
16711;67446;750;92;60;5;55;.917;3600000;0
16711;149221;2199;0;0;0;0;.00nan;0;0
16713;174894;766;61;23;2;21;.913;3546000;0
16713;181910;760;92;32;1;31;.969;3600000;0
16713;43720;766;0;0;0;0;.00nan;0;0
16713;56037;760;0;0;0;0;.00nan;0;0
16715;595;3913;58;26;3;23;.885;3840000;0
16715;180738;755;63;21;2;19;.905;3840000;0
16715;149112;755;0;0;0;0;.00nan;0;0
16715;149280;3913;0;0;0;0;.00nan;0;0
16717;504;3730;0;0;0;0;.00nan;0;0
16717;57172;1492;0;0;0;0;.00nan;0;0
16717;73639;1492;62;22;2;20;.909;3600000;0
16717;76628;3730;68;33;3;30;.909;3600000;0
16719;3075;754;0;0;0;0;.00nan;0;0
16719;63932;2197;0;0;0;0;.00nan;0;0
16719;87758;754;62;34;4;30;.882;3775000;0
16719;94508;2197;62;29;3;26;.897;3775000;0
16721;2140;1093;0;0;0;0;.00nan;0;0
16721;170548;758;0;0;0;0;.00nan;0;0
16721;68233;1093;57;22;2;20;.909;3600000;0
16721;81085;758;57;25;3;22;.880;3600000;0
16723;170547;769;0;0;0;0;.00nan;0;0
16723;175593;2545;61;14;1;13;.929;2192000;0
16723;94134;2545;20;26;6;20;.769;1660000;0
16723;154296;769;57;36;7;29;.806;3900000;0
16725;147;767;0;0;0;0;.00nan;0;0
16725;82228;767;96;36;2;34;.944;3600000;0
16725;93756;1497;73;18;1;17;.944;3600000;0
16725;149191;1497;0;0;0;0;.00nan;0;0
790;164424;750;32;28;6;22;.786;3086000;0
790;10931;750;31;4;2;2;.500;514000;0
790;49581;746;0;0;0;0;.00nan;0;0
790;49935;746;100;28;0;28;1.000;3600000;0
791;170547;769;89;45;3;42;.933;3600000;0
791;49629;769;0;0;0;0;.00nan;0;0
791;86099;768;73;10;0;10;1.000;3600000;0
791;93756;768;0;0;0;0;.00nan;0;0
792;49815;3721;0;0;0;0;.00nan;0;0
792;66993;759;82;29;1;28;.966;3600000;0
792;67446;759;0;0;0;0;.00nan;0;0
792;67818;3721;66;27;2;25;.926;3555000;0
793;359;774;66;28;3;25;.893;3543000;0
793;9559;2545;0;0;0;0;.00nan;0;0
793;175593;2545;74;28;2;26;.929;3600000;0
793;190589;774;0;0;0;0;.00nan;0;0
794;595;3913;71;34;3;31;.912;3559000;0
794;-1;911;0;0;0;0;.00nan;0;0
794;180177;911;77;26;2;24;.923;3600000;0
794;149280;3913;0;0;0;0;.00nan;0;0
795;177124;2199;85;42;3;39;.929;3544000;0
795;35024;760;75;29;2;27;.931;3600000;0
795;56037;760;0;0;0;0;.00nan;0;0
795;94134;2199;0;0;0;0;.00nan;0;0
796;4281;2197;0;0;0;0;.00nan;0;0
796;15257;762;61;22;2;20;.909;1231000;0
796;174894;762;50;28;4;24;.857;2369000;0
796;94508;2197;78;23;1;22;.957;3600000;0
797;57172;1492;80;27;1;26;.963;3555000;0
797;63932;758;0;0;0;0;.00nan;0;0
797;73639;1492;0;0;0;0;.00nan;0;0
797;85395;758;96;22;0;22;1.000;3600000;0
798;164424;750;66;40;4;36;.900;3600000;0
798;10931;750;0;0;0;0;.00nan;0;0
798;49581;746;0;0;0;0;.00nan;0;0
798;49935;746;72;22;1;21;.955;3600000;0
799;170547;769;0;0;0;0;.00nan;0;0
799;49629;769;52;51;8;43;.843;3600000;0
799;86099;768;68;19;1;18;.947;3600000;0
799;93756;768;0;0;0;0;.00nan;0;0
800;49815;3721;0;0;0;0;.00nan;0;0
800;66993;759;91;37;3;34;.919;3541000;0
800;67446;759;0;0;0;0;.00nan;0;0
800;67818;3721;80;30;1;29;.967;3600000;0
801;359;774;70;20;1;19;.950;3600000;0
801;9559;2545;0;0;0;0;.00nan;0;0
801;175593;2545;78;34;2;32;.941;3548000;0
801;190589;774;0;0;0;0;.00nan;0;0
802;595;3913;47;26;4;22;.846;3575000;0
802;-1;911;0;0;0;0;.00nan;0;0
802;180177;911;95;34;2;32;.941;3600000;0
802;149280;3913;0;0;0;0;.00nan;0;0
803;177124;2199;63;18;1;17;.944;3600000;0
803;35024;760;32;28;6;22;.786;2823000;0
803;56037;760;49;7;1;6;.857;777000;0
803;94134;2199;0;0;0;0;.00nan;0;0
804;4281;2197;0;0;0;0;.00nan;0;0
804;15257;762;0;0;0;0;.00nan;0;0
804;174894;762;51;30;4;26;.867;3692000;0
804;94508;2197;66;39;5;34;.872;3692000;0
805;57172;1492;62;27;3;24;.889;3587000;0
805;63932;758;0;0;0;0;.00nan;0;0
805;73639;1492;0;0;0;0;.00nan;0;0
805;85395;758;73;23;2;21;.913;3600000;0
806;164424;750;67;36;4;32;.889;3600000;0
806;10931;750;0;0;0;0;.00nan;0;0
806;49581;746;0;0;0;0;.00nan;0;0
806;49935;746;71;23;1;22;.957;3600000;0
807;170547;769;0;0;0;0;.00nan;0;0
807;49629;769;66;49;6;43;.878;3600000;0
807;86099;768;83;10;0;10;1.000;3600000;0
807;93756;768;0;0;0;0;.00nan;0;0
808;49815;3721;0;0;0;0;.00nan;0;0
808;66993;759;83;28;2;26;.929;3581000;0
808;67446;759;0;0;0;0;.00nan;0;0
808;67818;3721;68;22;1;21;.955;3600000;0
809;359;774;100;23;0;23;1.000;3600000;0
809;9559;2545;0;0;0;0;.00nan;0;0
809;175593;2545;97;32;1;31;.969;3551000;0
809;190589;774;0;0;0;0;.00nan;0;0
810;595;3913;54;34;4;30;.882;3600000;0
810;-1;911;0;0;0;0;.00nan;0;0
810;180177;911;100;40;0;40;1.000;3600000;0
810;149280;3913;0;0;0;0;.00nan;0;0
811;177124;2199;77;43;2;41;.953;5466000;0
811;35024;760;89;58;3;55;.948;5466000;0
811;56037;760;0;0;0;0;.00nan;0;0
811;94134;2199;0;0;0;0;.00nan;0;0
812;4281;2197;0;0;0;0;.00nan;0;0
812;15257;762;0;0;0;0;.00nan;0;0
812;174894;762;50;23;3;20;.870;3600000;0
812;94508;2197;48;42;6;36;.857;3600000;0
813;57172;1492;71;41;4;37;.902;3600000;0
813;63932;758;0;0;0;0;.00nan;0;0
813;73639;1492;0;0;0;0;.00nan;0;0
813;85395;758;59;16;1;15;.938;3600000;0
814;164424;750;99;49;2;47;.959;3687000;0
814;10931;750;0;0;0;0;.00nan;0;0
814;49581;746;0;0;0;0;.00nan;0;0
814;49935;746;58;25;3;22;.880;3687000;0
815;170547;769;80;18;0;18;1.000;1583000;0
815;49629;769;23;24;6;18;.750;2017000;0
815;86099;768;100;22;0;22;1.000;3600000;0
815;93756;768;0;0;0;0;.00nan;0;0
816;49815;3721;0;0;0;0;.00nan;0;0
816;66993;759;100;26;0;26;1.000;3600000;0
816;67446;759;0;0;0;0;.00nan;0;0
816;67818;3721;58;34;4;30;.882;3600000;0
817;359;774;74;19;1;18;.947;3600000;0
817;9559;2545;0;0;0;0;.00nan;0;0
817;175593;2545;63;29;3;26;.897;3517000;0
817;190589;774;0;0;0;0;.00nan;0;0
818;595;3913;90;32;1;31;.969;3600000;0
818;-1;911;0;0;0;0;.00nan;0;0
818;180177;911;56;29;4;25;.862;3600000;0
818;149280;3913;0;0;0;0;.00nan;0;0
819;177124;2199;65;22;3;19;.864;3600000;0
819;35024;760;64;40;5;35;.875;3578000;0
819;56037;760;0;0;0;0;.00nan;0;0
819;94134;2199;0;0;0;0;.00nan;0;0
820;4281;2197;0;0;0;0;.00nan;0;0
820;15257;762;0;0;0;0;.00nan;0;0
820;174894;762;50;30;4;26;.867;3600000;0
820;94508;2197;60;34;5;29;.853;3560000;0
821;57172;1492;54;32;4;28;.875;3600000;0
821;63932;758;0;0;0;0;.00nan;0;0
821;73639;1492;0;0;0;0;.00nan;0;0
821;85395;758;82;25;1;24;.960;3600000;0
947;164424;750;78;45;4;41;.911;3552000;0
947;10931;750;0;0;0;0;.00nan;0;0
947;49581;746;0;0;0;0;.00nan;0;0
947;49935;746;59;24;3;21;.875;3600000;0
948;49815;3721;0;0;0;0;.00nan;0;0
948;66993;759;79;41;4;37;.902;3890000;0
948;67446;759;0;0;0;0;.00nan;0;0
948;67818;3721;60;30;3;27;.900;3890000;0
949;359;774;52;24;3;21;.875;3860000;0
949;9559;2545;0;0;0;0;.00nan;0;0
949;175593;2545;77;32;2;30;.938;3860000;0
949;190589;774;0;0;0;0;.00nan;0;0
950;595;3913;66;22;2;20;.909;3600000;0
950;-1;911;0;0;0;0;.00nan;0;0
950;180177;911;45;21;3;18;.857;3600000;0
950;149280;3913;0;0;0;0;.00nan;0;0
951;177124;2199;100;38;0;38;1.000;3600000;0
951;35024;760;47;23;3;20;.870;3600000;0
951;56037;760;0;0;0;0;.00nan;0;0
951;94134;2199;0;0;0;0;.00nan;0;0
952;4281;2197;0;0;0;0;.00nan;0;0
952;15257;762;0;0;0;0;.00nan;0;0
952;174894;762;83;27;2;25;.926;3600000;0
952;94508;2197;61;32;4;28;.875;3600000;0
1005;49815;3721;0;0;0;0;.00nan;0;0
1005;66993;759;85;22;1;21;.955;3600000;0
1005;67446;759;0;0;0;0;.00nan;0;0
1005;67818;3721;43;36;6;30;.833;3600000;0
1006;359;774;54;30;5;25;.833;3172000;0
1006;9559;2545;0;0;0;0;.00nan;0;0
1006;175593;2545;60;21;3;18;.857;3600000;0
1006;190589;774;50;1;0;1;1.000;345000;0
1007;595;3913;68;18;1;17;.944;3600000;0
1007;-1;911;0;0;0;0;.00nan;0;0
1007;180177;911;76;31;3;28;.903;3546000;0
1007;149280;3913;0;0;0;0;.00nan;0;0
1041;49815;3721;0;0;0;0;.00nan;0;0
1041;66993;759;81;21;1;20;.952;3600000;0
1041;67446;759;0;0;0;0;.00nan;0;0
1041;67818;3721;79;32;3;29;.906;3579000;0
1042;359;774;92;24;1;23;.958;3660000;0
1042;9559;2545;0;0;0;0;.00nan;0;0
1042;175593;2545;100;31;0;31;1.000;3660000;0
1042;190589;774;0;0;0;0;.00nan;0;0
1043;595;3913;94;30;0;30;1.000;4212000;0
1043;-1;911;0;0;0;0;.00nan;0;0
1043;180177;911;94;35;1;34;.971;4212000;0
1043;149280;3913;0;0;0;0;.00nan;0;0
1100;9559;2545;0;0;0;0;.00nan;0;0
1100;175593;2545;85;52;3;49;.942;5657000;0
1100;49581;746;0;0;0;0;.00nan;0;0
1100;49935;746;63;39;4;35;.897;5657000;0
1101;15257;762;0;0;0;0;.00nan;0;0
1101;174894;762;61;34;4;30;.882;3578000;0
1101;66993;759;91;38;2;36;.947;3600000;0
1101;67446;759;0;0;0;0;.00nan;0;0
1102;595;3913;78;23;1;22;.957;3600000;0
1102;177124;2199;74;33;4;29;.879;3600000;0
1102;94134;2199;0;0;0;0;.00nan;0;0
1102;149280;3913;0;0;0;0;.00nan;0;0
1103;63932;758;0;0;0;0;.00nan;0;0
1103;85395;758;58;37;5;32;.865;3600000;0
1103;86099;768;60;13;1;12;.923;3600000;0
1103;93756;768;0;0;0;0;.00nan;0;0
1104;9559;2545;44;4;1;3;.750;299000;0
1104;175593;2545;61;50;6;44;.880;3301000;0
1104;49581;746;0;0;0;0;.00nan;0;0
1104;49935;746;67;21;2;19;.905;3600000;0
1105;15257;762;0;0;0;0;.00nan;0;0
1105;174894;762;75;31;2;29;.935;3551000;0
1105;66993;759;100;40;1;39;.975;3600000;0
1105;67446;759;0;0;0;0;.00nan;0;0
1106;595;3913;84;32;2;30;.938;3556000;0
1106;177124;2199;90;18;0;18;1.000;3600000;0
1106;94134;2199;0;0;0;0;.00nan;0;0
1106;149280;3913;0;0;0;0;.00nan;0;0
1107;63932;758;0;0;0;0;.00nan;0;0
1107;85395;758;72;46;4;42;.913;4147000;0
1107;86099;768;74;37;3;34;.919;4147000;0
1107;93756;768;0;0;0;0;.00nan;0;0
1108;9559;2545;0;0;0;0;.00nan;0;0
1108;175593;2545;49;32;5;27;.844;3517000;0
1108;49581;746;0;0;0;0;.00nan;0;0
1108;49935;746;56;21;3;18;.857;3600000;0
1109;15257;762;0;0;0;0;.00nan;0;0
1109;174894;762;73;25;2;23;.920;3600000;0
1109;66993;759;55;45;6;39;.867;3600000;0
1109;67446;759;0;0;0;0;.00nan;0;0
1110;595;3913;47;31;5;26;.839;3600000;0
1110;177124;2199;58;31;4;27;.871;3600000;0
1110;94134;2199;0;0;0;0;.00nan;0;0
1110;149280;3913;0;0;0;0;.00nan;0;0
1111;63932;758;0;0;0;0;.00nan;0;0
1111;85395;758;91;31;1;30;.968;3600000;0
1111;86099;768;31;17;5;12;.706;2253000;0
1111;93756;768;47;6;1;5;.833;1347000;0
1112;9559;2545;43;4;1;3;.750;334000;0
1112;175593;2545;56;41;6;35;.854;3266000;0
1112;49581;746;0;0;0;0;.00nan;0;0
1112;49935;746;61;20;2;18;.900;3600000;0
1113;15257;762;0;0;0;0;.00nan;0;0
1113;174894;762;100;28;0;28;1.000;3600000;0
1113;66993;759;90;33;1;32;.970;3541000;0
1113;67446;759;0;0;0;0;.00nan;0;0
1114;595;3913;81;40;2;38;.950;4049000;0
1114;177124;2199;89;41;3;38;.927;4049000;0
1114;94134;2199;0;0;0;0;.00nan;0;0
1114;149280;3913;0;0;0;0;.00nan;0;0
1115;63932;758;0;0;0;0;.00nan;0;0
1115;85395;758;86;52;4;48;.923;3599000;0
1115;86099;768;58;17;2;15;.882;3600000;0
1115;93756;768;0;0;0;0;.00nan;0;0
1519;9559;2545;0;0;0;0;.00nan;0;0
1519;175593;2545;77;25;2;23;.920;3564000;0
1519;49581;746;0;0;0;0;.00nan;0;0
1519;49935;746;69;22;1;21;.955;3600000;0
1520;15257;762;0;0;0;0;.00nan;0;0
1520;174894;762;41;29;5;24;.828;3600000;0
1520;66993;759;68;26;2;24;.923;3600000;0
1520;67446;759;0;0;0;0;.00nan;0;0
1521;595;3913;87;38;2;36;.947;3600000;0
1521;177124;2199;95;23;0;23;1.000;3600000;0
1521;94134;2199;0;0;0;0;.00nan;0;0
1521;149280;3913;0;0;0;0;.00nan;0;0
1522;63932;758;0;0;0;0;.00nan;0;0
1522;85395;758;55;40;5;35;.875;3600000;0
1522;86099;768;68;21;1;20;.952;3600000;0
1522;93756;768;0;0;0;0;.00nan;0;0
1557;15257;762;0;0;0;0;.00nan;0;0
1557;174894;762;99;34;2;32;.941;3600000;0
1557;66993;759;64;30;3;27;.900;3545000;0
1557;67446;759;0;0;0;0;.00nan;0;0
1558;595;3913;50;27;4;23;.852;3555000;0
1558;177124;2199;65;28;3;25;.893;3600000;0
1558;94134;2199;0;0;0;0;.00nan;0;0
1558;149280;3913;0;0;0;0;.00nan;0;0
1599;15257;762;0;0;0;0;.00nan;0;0
1599;174894;762;60;29;3;26;.897;3600000;0
1599;66993;759;87;18;0;18;1.000;3600000;0
1599;67446;759;0;0;0;0;.00nan;0;0
1644;177124;2199;90;34;2;32;.941;3865000;0
1644;49581;746;0;0;0;0;.00nan;0;0
1644;49935;746;71;35;3;32;.914;3865000;0
1644;94134;2199;0;0;0;0;.00nan;0;0
1645;66993;759;64;36;5;31;.861;3574000;0
1645;67446;759;0;0;0;0;.00nan;0;0
1645;86099;768;55;23;3;20;.870;3600000;0
1645;93756;768;0;0;0;0;.00nan;0;0
1646;177124;2199;72;44;4;40;.909;4104000;0
1646;49581;746;0;0;0;0;.00nan;0;0
1646;49935;746;77;36;3;33;.917;4104000;0
1646;94134;2199;0;0;0;0;.00nan;0;0
1647;66993;759;97;48;4;44;.917;3600000;0
1647;67446;759;0;0;0;0;.00nan;0;0
1647;86099;768;72;20;1;19;.950;3600000;0
1647;93756;768;0;0;0;0;.00nan;0;0
1648;177124;2199;100;43;1;42;.977;3600000;0
1648;49581;746;0;0;0;0;.00nan;0;0
1648;49935;746;88;49;2;47;.959;3576000;0
1648;94134;2199;0;0;0;0;.00nan;0;0
1649;66993;759;89;54;4;50;.926;3600000;0
1649;67446;759;0;0;0;0;.00nan;0;0
1649;86099;768;66;15;1;14;.933;3600000;0
1649;93756;768;0;0;0;0;.00nan;0;0
1650;177124;2199;88;34;2;32;.941;3600000;0
1650;49581;746;42;13;2;11;.846;1228000;0
1650;49935;746;35;29;5;24;.828;2372000;0
1650;94134;2199;0;0;0;0;.00nan;0;0
1651;66993;759;83;39;3;36;.923;3600000;0
1651;67446;759;0;0;0;0;.00nan;0;0
1651;86099;768;69;17;1;16;.941;3600000;0
1651;93756;768;0;0;0;0;.00nan;0;0
1921;177124;2199;84;34;3;31;.912;3550000;0
1921;49581;746;100;44;2;42;.955;3600000;0
1921;49935;746;0;0;0;0;.00nan;0;0
1921;94134;2199;0;0;0;0;.00nan;0;0
1942;177124;2199;64;21;1;20;.952;3600000;0
1942;49581;746;100;24;0;24;1.000;3600000;0
1942;49935;746;0;0;0;0;.00nan;0;0
1942;94134;2199;0;0;0;0;.00nan;0;0
1999;177124;2199;91;50;4;46;.920;3557000;0
1999;49581;746;53;17;2;15;.882;3600000;0
1999;49935;746;0;0;0;0;.00nan;0;0
1999;94134;2199;0;0;0;0;.00nan;0;0
2048;49581;746;51;48;7;41;.854;3600000;0
2048;49935;746;0;0;0;0;.00nan;0;0
2048;86099;768;68;26;2;24;.923;3600000;0
2048;93756;768;0;0;0;0;.00nan;0;0
2049;49581;746;98;55;4;51;.927;3600000;0
2049;49935;746;0;0;0;0;.00nan;0;0
2049;86099;768;61;17;1;16;.941;3600000;0
2049;93756;768;0;0;0;0;.00nan;0;0
2050;49581;746;90;41;2;39;.951;3549000;0
2050;49935;746;0;0;0;0;.00nan;0;0
2050;86099;768;100;23;0;23;1.000;3600000;0
2050;93756;768;0;0;0;0;.00nan;0;0
2051;49581;746;93;56;4;52;.929;3600000;0
2051;49935;746;0;0;0;0;.00nan;0;0
2051;86099;768;82;26;1;25;.962;3600000;0
2051;93756;768;0;0;0;0;.00nan;0;0
16726;13033;586;0;0;0;0;.00nan;0;0
16726;14191;2557;0;0;0;0;.00nan;0;0
16726;53936;2557;54;30;4;26;.867;3562000;0
16726;143829;586;63;36;3;33;.917;3600000;0
16727;13041;2277;0;0;0;0;.00nan;0;0
16727;19954;580;84;36;2;34;.944;3600000;0
16727;56653;580;0;0;0;0;.00nan;0;0
16727;66790;2277;24;28;6;22;.786;3600000;0
16728;170037;567;62;31;3;28;.903;3804000;0
16728;67625;567;0;0;0;0;.00nan;0;0
16728;155769;583;86;33;2;31;.939;3804000;0
16728;161069;583;0;0;0;0;.00nan;0;0
16729;13033;586;0;0;0;0;.00nan;0;0
16729;72514;1927;0;0;0;0;.00nan;0;0
16729;143829;586;45;22;4;18;.818;3585000;0
16729;155943;1927;65;32;3;29;.906;3600000;0
16730;190423;1918;0;0;0;0;.00nan;0;0
16730;179950;563;67;24;2;22;.917;3600000;0
16730;34168;563;0;0;0;0;.00nan;0;0
16730;185744;1918;42;26;4;22;.846;3539000;0
16731;6202;1922;63;36;4;32;.889;3526000;0
16731;36571;1928;79;29;2;27;.931;3600000;0
16731;55285;1928;0;0;0;0;.00nan;0;0
16731;67162;1922;0;0;0;0;.00nan;0;0
16732;7412;585;0;0;0;0;.00nan;0;0
16732;13065;1925;74;32;2;30;.938;3549000;0
16732;35052;585;75;24;1;23;.958;3600000;0
16732;40088;1925;0;0;0;0;.00nan;0;0
16733;170037;567;50;22;3;19;.864;3600000;0
16733;36571;1928;79;44;4;40;.909;3549000;0
16733;55285;1928;0;0;0;0;.00nan;0;0
16733;67625;567;0;0;0;0;.00nan;0;0
16734;6202;1922;0;0;0;0;.00nan;0;0
16734;13065;1925;0;0;0;0;.00nan;0;0
16734;40088;1925;96;38;1;37;.974;3600000;0
16734;67162;1922;65;26;3;23;.885;3600000;0
16735;7412;585;0;0;0;0;.00nan;0;0
16735;14191;2557;0;0;0;0;.00nan;0;0
16735;35052;585;63;35;4;31;.886;3592000;0
16735;53936;2557;46;21;3;18;.857;3600000;0
16736;13041;2277;58;5;0;5;1.000;767000;0
16736;190423;1918;0;0;0;0;.00nan;0;0
16736;185744;1918;99;25;0;25;1.000;3600000;0
16736;66790;2277;46;41;6;35;.854;2833000;0
16737;19954;580;77;26;1;25;.962;3600000;0
16737;56653;580;0;0;0;0;.00nan;0;0
16737;155769;583;0;0;0;0;.00nan;0;0
16737;161069;583;46;36;6;30;.833;3600000;0
16738;13041;2277;0;0;0;0;.00nan;0;0
16738;170037;567;0;0;0;0;.00nan;0;0
16738;66790;2277;60;34;4;30;.882;3517000;0
16738;67625;567;49;13;2;11;.846;3600000;0
16739;13033;586;44;26;4;22;.846;3545000;0
16739;179950;563;95;46;3;43;.935;3600000;0
16739;34168;563;0;0;0;0;.00nan;0;0
16739;143829;586;0;0;0;0;.00nan;0;0
16740;13065;1925;65;33;3;30;.909;3600000;0
16740;14191;2557;0;0;0;0;.00nan;0;0
16740;40088;1925;0;0;0;0;.00nan;0;0
16740;53936;2557;54;41;5;36;.878;3553000;0
16741;190423;1918;0;0;0;0;.00nan;0;0
16741;185744;1918;68;18;1;17;.944;3600000;0
16741;72514;1927;0;0;0;0;.00nan;0;0
16741;155943;1927;90;44;2;42;.955;3557000;0
16742;6202;1922;0;0;0;0;.00nan;0;0
16742;19954;580;72;39;3;36;.923;3600000;0
16742;56653;580;0;0;0;0;.00nan;0;0
16742;67162;1922;68;27;2;25;.926;3600000;0
16743;13041;2277;75;29;2;27;.931;3600000;0
16743;13065;1925;0;0;0;0;.00nan;0;0
16743;40088;1925;53;38;5;33;.868;3600000;0
16743;66790;2277;0;0;0;0;.00nan;0;0
16744;72514;1927;0;0;0;0;.00nan;0;0
16744;155769;583;0;0;0;0;.00nan;0;0
16744;155943;1927;87;29;2;27;.931;3579000;0
16744;161069;583;89;21;0;21;1.000;3600000;0
16745;170037;567;49;27;4;23;.852;3600000;0
16745;179950;563;55;43;6;37;.860;3537000;0
16745;34168;563;0;0;0;0;.00nan;0;0
16745;67625;567;0;0;0;0;.00nan;0;0
16746;13033;586;0;0;0;0;.00nan;0;0
16746;36571;1928;75;25;1;24;.960;3600000;0
16746;55285;1928;0;0;0;0;.00nan;0;0
16746;143829;586;70;24;2;22;.917;3600000;0
16747;14191;2557;0;0;0;0;.00nan;0;0
16747;19954;580;39;29;5;24;.828;2678000;0
16747;53936;2557;40;19;4;15;.789;3600000;0
16747;56653;580;29;13;4;9;.692;922000;0
16748;13041;2277;0;0;0;0;.00nan;0;0
16748;66790;2277;52;34;4;30;.882;3600000;0
16748;72514;1927;84;33;1;32;.970;3600000;0
16748;155943;1927;0;0;0;0;.00nan;0;0
16749;13065;1925;71;26;3;23;.885;3572000;0
16749;40088;1925;0;0;0;0;.00nan;0;0
16749;155769;583;0;0;0;0;.00nan;0;0
16749;161069;583;73;26;2;24;.923;3600000;0
16750;13033;586;63;19;2;17;.895;3600000;0
16750;19954;580;0;0;0;0;.00nan;0;0
16750;56653;580;74;46;4;42;.913;3566000;0
16750;143829;586;0;0;0;0;.00nan;0;0
16751;6202;1922;0;0;0;0;.00nan;0;0
16751;179950;563;62;41;4;37;.902;3545000;0
16751;34168;563;0;0;0;0;.00nan;0;0
16751;67162;1922;83;31;2;29;.935;3600000;0
16752;170037;567;0;0;0;0;.00nan;0;0
16752;190423;1918;0;0;0;0;.00nan;0;0
16752;185744;1918;95;39;2;37;.949;3900000;0
16752;67625;567;71;24;2;22;.917;3900000;0
16753;7412;585;0;0;0;0;.00nan;0;0
16753;35052;585;56;34;4;30;.882;3552000;0
16753;36571;1928;0;0;0;0;.00nan;0;0
16753;55285;1928;68;31;3;28;.903;3600000;0
16754;13041;2277;49;26;4;22;.846;3600000;0
16754;66790;2277;0;0;0;0;.00nan;0;0
16754;155769;583;73;34;3;31;.912;3600000;0
16754;161069;583;0;0;0;0;.00nan;0;0
16755;170037;567;86;18;0;18;1.000;3600000;0
16755;67625;567;0;0;0;0;.00nan;0;0
16755;72514;1927;0;0;0;0;.00nan;0;0
16755;155943;1927;67;33;3;30;.909;3600000;0
16756;170037;567;59;28;3;25;.893;3600000;0
16756;67625;567;0;0;0;0;.00nan;0;0
16756;155769;583;0;0;0;0;.00nan;0;0
16756;161069;583;45;30;4;26;.867;3551000;0
16757;13041;2277;0;0;0;0;.00nan;0;0
16757;14191;2557;0;0;0;0;.00nan;0;0
16757;53936;2557;71;28;2;26;.929;3600000;0
16757;66790;2277;65;28;3;25;.893;3565000;0
16758;6202;1922;0;0;0;0;.00nan;0;0
16758;13033;586;0;0;0;0;.00nan;0;0
16758;67162;1922;73;25;2;23;.920;3773000;0
16758;143829;586;94;37;3;34;.919;3773000;0
16759;179950;563;73;26;2;24;.923;3600000;0
16759;34168;563;0;0;0;0;.00nan;0;0
16759;72514;1927;0;0;0;0;.00nan;0;0
16759;155943;1927;90;32;1;31;.969;3600000;0
16760;7412;585;0;0;0;0;.00nan;0;0
16760;35052;585;61;29;3;26;.897;3600000;0
16760;36571;1928;67;27;2;25;.926;3600000;0
16760;55285;1928;0;0;0;0;.00nan;0;0
16761;19954;580;55;34;4;30;.882;3600000;0
16761;190423;1918;0;0;0;0;.00nan;0;0
16761;185744;1918;73;28;2;26;.929;3600000;0
16761;56653;580;0;0;0;0;.00nan;0;0
16762;6202;1922;52;15;2;13;.867;3600000;0
16762;13065;1925;63;38;4;34;.895;3524000;0
16762;40088;1925;0;0;0;0;.00nan;0;0
16762;67162;1922;0;0;0;0;.00nan;0;0
16763;170037;567;0;0;0;0;.00nan;0;0
16763;190423;1918;71;43;4;39;.907;3600000;0
16763;185744;1918;0;0;0;0;.00nan;0;0
16763;67625;567;86;16;0;16;1.000;3600000;0
16764;14191;2557;100;24;0;24;1.000;3600000;0
16764;53936;2557;0;0;0;0;.00nan;0;0
16764;155769;583;79;26;2;24;.923;3546000;0
16764;161069;583;0;0;0;0;.00nan;0;0
16765;179950;563;0;0;0;0;.00nan;0;0
16765;34168;563;92;23;0;23;1.000;3600000;0
16765;36571;1928;0;0;0;0;.00nan;0;0
16765;55285;1928;55;30;4;26;.867;3600000;0
16766;7412;585;57;34;4;30;.882;3880000;0
16766;13033;586;52;24;3;21;.875;3880000;0
16766;35052;585;0;0;0;0;.00nan;0;0
16766;143829;586;0;0;0;0;.00nan;0;0
16767;14191;2557;31;28;6;22;.786;3548000;0
16767;179950;563;53;31;5;26;.839;3600000;0
16767;34168;563;0;0;0;0;.00nan;0;0
16767;53936;2557;0;0;0;0;.00nan;0;0
16768;190423;1918;0;0;0;0;.00nan;0;0
16768;185744;1918;82;34;2;32;.941;3900000;0
16768;155769;583;0;0;0;0;.00nan;0;0
16768;161069;583;47;16;2;14;.875;3900000;0
16769;13065;1925;43;25;4;21;.840;3600000;0
16769;40088;1925;0;0;0;0;.00nan;0;0
16769;72514;1927;0;0;0;0;.00nan;0;0
16769;155943;1927;82;25;1;24;.960;3600000;0
16770;19954;580;0;0;0;0;.00nan;0;0
16770;170037;567;0;0;0;0;.00nan;0;0
16770;56653;580;63;33;3;30;.909;3600000;0
16770;67625;567;98;26;0;26;1.000;3600000;0
16771;13041;2277;0;0;0;0;.00nan;0;0
16771;179950;563;77;26;2;24;.923;3614000;0
16771;34168;563;0;0;0;0;.00nan;0;0
16771;66790;2277;66;30;3;27;.900;3614000;0
16772;13065;1925;0;0;0;0;.00nan;0;0
16772;170037;567;68;25;2;23;.920;3600000;0
16772;40088;1925;77;45;4;41;.911;3555000;0
16772;67625;567;0;0;0;0;.00nan;0;0
16773;13033;586;0;0;0;0;.00nan;0;0
16773;143829;586;42;22;4;18;.818;3544000;0
16773;155769;583;0;0;0;0;.00nan;0;0
16773;161069;583;74;37;3;34;.919;3600000;0
16774;6202;1922;0;0;0;0;.00nan;0;0
16774;14191;2557;0;0;0;0;.00nan;0;0
16774;53936;2557;78;42;3;39;.929;3580000;0
16774;67162;1922;71;29;2;27;.931;3600000;0
16775;190423;1918;21;24;6;18;.750;3012000;0
16775;36571;1928;90;27;1;26;.963;3600000;0
16775;185744;1918;24;7;3;4;.571;588000;0
16775;55285;1928;0;0;0;0;.00nan;0;0
16776;19954;580;95;33;1;32;.970;3894000;0
16776;56653;580;0;0;0;0;.00nan;0;0
16776;72514;1927;0;0;0;0;.00nan;0;0
16776;155943;1927;67;30;2;28;.933;3894000;0
16777;7412;585;0;0;0;0;.00nan;0;0
16777;13065;1925;43;29;5;24;.828;3600000;0
16777;35052;585;24;26;6;20;.769;3599000;0
16777;40088;1925;0;0;0;0;.00nan;0;0
16778;13033;586;68;24;2;22;.917;3600000;0
16778;13041;2277;85;46;3;43;.935;3587000;0
16778;66790;2277;0;0;0;0;.00nan;0;0
16778;143829;586;0;0;0;0;.00nan;0;0
16779;190423;1918;0;0;0;0;.00nan;0;0
16779;179950;563;37;27;5;22;.815;3517000;0
16779;34168;563;0;0;0;0;.00nan;0;0
16779;185744;1918;69;31;3;28;.903;3600000;0
16780;67162;1922;0;0;0;0;.00nan;0;0
16780;72514;1927;0;0;0;0;.00nan;0;0
16780;85661;1922;58;28;3;25;.893;3900000;0
16780;155943;1927;69;33;3;30;.909;3900000;0
16781;179950;563;48;31;4;27;.871;3592000;0
16781;34168;563;0;0;0;0;.00nan;0;0
16781;155769;583;72;29;3;26;.897;3600000;0
16781;161069;583;0;0;0;0;.00nan;0;0
16782;13065;1925;0;0;0;0;.00nan;0;0
16782;14191;2557;0;0;0;0;.00nan;0;0
16782;40088;1925;59;14;1;13;.929;3600000;0
16782;53936;2557;48;23;3;20;.870;3538000;0
16783;170037;567;84;17;0;17;1.000;3600000;0
16783;179950;563;27;7;3;4;.571;458000;0
16783;34168;563;60;22;2;20;.909;3142000;0
16783;67625;567;0;0;0;0;.00nan;0;0
16784;13041;2277;87;52;3;49;.942;3553000;0
16784;66790;2277;0;0;0;0;.00nan;0;0
16784;67162;1922;0;0;0;0;.00nan;0;0
16784;85661;1922;84;29;2;27;.931;3600000;0
16785;7412;585;0;0;0;0;.00nan;0;0
16785;190423;1918;52;23;3;20;.870;3554000;0
16785;35052;585;79;25;1;24;.960;3600000;0
16785;185744;1918;0;0;0;0;.00nan;0;0
16786;13033;586;0;0;0;0;.00nan;0;0
16786;19954;580;0;0;0;0;.00nan;0;0
16786;56653;580;43;30;5;25;.833;3600000;0
16786;143829;586;88;32;1;31;.969;3600000;0
16787;13065;1925;99;31;1;30;.968;3600000;0
16787;40088;1925;0;0;0;0;.00nan;0;0
16787;72514;1927;43;25;4;21;.840;3600000;0
16787;155943;1927;0;0;0;0;.00nan;0;0
16788;7412;585;27;27;6;21;.778;3257000;0
16788;35052;585;53;4;0;4;1.000;343000;0
16788;155769;583;90;31;1;30;.968;3600000;0
16788;161069;583;0;0;0;0;.00nan;0;0
16789;179950;563;72;32;3;29;.906;3600000;0
16789;34168;563;0;0;0;0;.00nan;0;0
16789;36571;1928;89;22;0;22;1.000;3600000;0
16789;55285;1928;0;0;0;0;.00nan;0;0
16790;13041;2277;0;0;0;0;.00nan;0;0
16790;14191;2557;0;0;0;0;.00nan;0;0
16790;53936;2557;59;23;3;20;.870;3600000;0
16790;66790;2277;61;48;5;43;.896;3515000;0
16791;13033;586;59;18;2;16;.889;3900000;0
16791;19954;580;77;30;2;28;.933;3900000;0
16791;56653;580;0;0;0;0;.00nan;0;0
16791;143829;586;0;0;0;0;.00nan;0;0
16792;179950;563;35;31;6;25;.806;2737000;0
16792;34168;563;56;19;2;17;.895;863000;0
16792;67162;1922;0;0;0;0;.00nan;0;0
16792;85661;1922;59;22;3;19;.864;3600000;0
16793;14191;2557;0;0;0;0;.00nan;0;0
16793;53936;2557;73;31;3;28;.903;3900000;0
16793;72514;1927;69;30;3;27;.900;3900000;0
16793;155943;1927;0;0;0;0;.00nan;0;0
16794;190423;1918;0;0;0;0;.00nan;0;0
16794;185744;1918;67;33;3;30;.909;3600000;0
16794;67162;1922;0;0;0;0;.00nan;0;0
16794;85661;1922;49;29;4;25;.862;3546000;0
16795;13041;2277;36;37;6;31;.838;3600000;0
16795;170037;567;73;21;1;20;.952;3600000;0
16795;66790;2277;0;0;0;0;.00nan;0;0
16795;67625;567;0;0;0;0;.00nan;0;0
16796;13065;1925;0;0;0;0;.00nan;0;0
16796;179950;563;57;22;2;20;.909;3900000;0
16796;34168;563;0;0;0;0;.00nan;0;0
16796;40088;1925;78;28;2;26;.929;3900000;0
16797;14191;2557;0;0;0;0;.00nan;0;0
16797;170037;567;0;0;0;0;.00nan;0;0
16797;53936;2557;57;29;3;26;.897;3600000;0
16797;67625;567;84;26;2;24;.923;3600000;0
16798;36571;1928;88;21;1;20;.952;3900000;0
16798;55285;1928;0;0;0;0;.00nan;0;0
16798;155769;583;90;38;1;37;.974;3900000;0
16798;161069;583;0;0;0;0;.00nan;0;0
16799;7412;585;0;0;0;0;.00nan;0;0
16799;35052;585;77;32;2;30;.938;3582000;0
16799;67162;1922;0;0;0;0;.00nan;0;0
16799;85661;1922;72;22;1;21;.955;3600000;0
16800;19954;580;0;0;0;0;.00nan;0;0
16800;56653;580;63;30;3;27;.900;3600000;0
16800;72514;1927;0;0;0;0;.00nan;0;0
16800;155943;1927;54;18;2;16;.889;3600000;0
16801;13041;2277;46;39;5;34;.872;3589000;0
16801;66790;2277;0;0;0;0;.00nan;0;0
16801;72514;1927;82;39;4;35;.897;3600000;0
16801;155943;1927;0;0;0;0;.00nan;0;0
16802;13033;586;0;0;0;0;.00nan;0;0
16802;13065;1925;42;39;6;33;.846;3600000;0
16802;40088;1925;0;0;0;0;.00nan;0;0
16802;143829;586;85;28;1;27;.964;3600000;0
16803;14191;2557;73;33;3;30;.909;3600000;0
16803;36571;1928;0;0;0;0;.00nan;0;0
16803;53936;2557;0;0;0;0;.00nan;0;0
16803;55285;1928;70;42;4;38;.905;3600000;0
16804;190423;1918;51;25;3;22;.880;3600000;0
16804;185744;1918;0;0;0;0;.00nan;0;0
16804;155769;583;67;34;4;30;.882;3577000;0
16804;161069;583;0;0;0;0;.00nan;0;0
16805;7412;585;96;46;2;44;.957;3551000;0
16805;179950;563;0;0;0;0;.00nan;0;0
16805;34168;563;84;24;1;23;.958;3600000;0
16805;35052;585;0;0;0;0;.00nan;0;0
16806;190423;1918;48;20;3;17;.850;3552000;0
16806;185744;1918;0;0;0;0;.00nan;0;0
16806;155769;583;78;30;2;28;.933;3600000;0
16806;161069;583;0;0;0;0;.00nan;0;0
16807;7412;585;0;0;0;0;.00nan;0;0
16807;13033;586;68;18;2;16;.889;3600000;0
16807;35052;585;58;39;4;35;.897;3512000;0
16807;143829;586;0;0;0;0;.00nan;0;0
16808;14191;2557;0;0;0;0;.00nan;0;0
16808;170037;567;60;13;1;12;.923;3600000;0
16808;53936;2557;84;42;2;40;.952;3574000;0
16808;67625;567;0;0;0;0;.00nan;0;0
16809;170037;567;0;0;0;0;.00nan;0;0
16809;67162;1922;0;0;0;0;.00nan;0;0
16809;67625;567;68;32;3;29;.906;3600000;0
16809;85661;1922;25;23;5;18;.783;3531000;0
16810;7412;585;0;0;0;0;.00nan;0;0
16810;19954;580;40;23;4;19;.826;3519000;0
16810;35052;585;83;30;2;28;.933;3600000;0
16810;56653;580;0;0;0;0;.00nan;0;0
16811;13065;1925;44;28;4;24;.857;3554000;0
16811;19954;580;0;0;0;0;.00nan;0;0
16811;40088;1925;0;0;0;0;.00nan;0;0
16811;56653;580;71;31;3;28;.903;3600000;0
16812;67162;1922;0;0;0;0;.00nan;0;0
16812;85661;1922;34;16;4;12;.750;3600000;0
16812;155769;583;0;0;0;0;.00nan;0;0
16812;161069;583;53;42;6;36;.857;3599000;0
16813;14191;2557;0;0;0;0;.00nan;0;0
16813;179950;563;69;35;3;32;.914;3588000;0
16813;34168;563;0;0;0;0;.00nan;0;0
16813;53936;2557;88;36;1;35;.972;3600000;0
16814;13041;2277;0;0;0;0;.00nan;0;0
16814;36571;1928;67;21;2;19;.905;3600000;0
16814;55285;1928;0;0;0;0;.00nan;0;0
16814;66790;2277;43;33;5;28;.848;3600000;0
16815;13033;586;0;0;0;0;.00nan;0;0
16815;72514;1927;0;0;0;0;.00nan;0;0
16815;143829;586;38;27;5;22;.815;3600000;0
16815;155943;1927;83;33;2;31;.939;3600000;0
16816;13033;586;100;32;0;32;1.000;3600000;0
16816;170037;567;84;32;1;31;.969;3554000;0
16816;67625;567;0;0;0;0;.00nan;0;0
16816;143829;586;0;0;0;0;.00nan;0;0
16817;13041;2277;60;38;4;34;.895;3600000;0
16817;36571;1928;80;25;1;24;.960;3600000;0
16817;55285;1928;0;0;0;0;.00nan;0;0
16817;66790;2277;0;0;0;0;.00nan;0;0
16818;14191;2557;94;34;2;32;.941;3900000;0
16818;190423;1918;0;0;0;0;.00nan;0;0
16818;185744;1918;64;26;2;24;.923;3900000;0
16818;53936;2557;0;0;0;0;.00nan;0;0
16819;179950;563;0;0;0;0;.00nan;0;0
16819;34168;563;75;35;3;32;.914;3900000;0
16819;72514;1927;75;38;3;35;.921;3900000;0
16819;155943;1927;0;0;0;0;.00nan;0;0
16820;7412;585;0;0;0;0;.00nan;0;0
16820;35052;585;79;35;2;33;.943;3600000;0
16820;155769;583;66;24;3;21;.875;3564000;0
16820;161069;583;0;0;0;0;.00nan;0;0
16821;7412;585;0;0;0;0;.00nan;0;0
16821;35052;585;11;32;8;24;.750;3600000;0
16821;72514;1927;0;0;0;0;.00nan;0;0
16821;155943;1927;67;31;3;28;.903;3600000;0
16822;13065;1925;75;32;2;30;.938;3600000;0
16822;36571;1928;80;34;3;31;.912;3554000;0
16822;40088;1925;0;0;0;0;.00nan;0;0
16822;55285;1928;0;0;0;0;.00nan;0;0
16823;19954;580;70;31;3;28;.903;3536000;0
16823;56653;580;0;0;0;0;.00nan;0;0
16823;155769;583;73;22;1;21;.955;3600000;0
16823;161069;583;0;0;0;0;.00nan;0;0
16824;13041;2277;0;0;0;0;.00nan;0;0
16824;190423;1918;0;0;0;0;.00nan;0;0
16824;185744;1918;89;47;3;44;.936;3529000;0
16824;66790;2277;83;28;1;27;.964;3600000;0
16825;13033;586;0;0;0;0;.00nan;0;0
16825;14191;2557;0;0;0;0;.00nan;0;0
16825;53936;2557;64;36;4;32;.889;3600000;0
16825;143829;586;76;23;1;22;.957;3600000;0
16826;36571;1928;51;26;4;22;.846;3571000;0
16826;55285;1928;0;0;0;0;.00nan;0;0
16826;67162;1922;0;0;0;0;.00nan;0;0
16826;85661;1922;91;35;3;32;.914;3600000;0
16827;13065;1925;0;0;0;0;.00nan;0;0
16827;190423;1918;57;53;7;46;.868;3600000;0
16827;185744;1918;0;0;0;0;.00nan;0;0
16827;40088;1925;76;12;0;12;1.000;3600000;0
16828;7412;585;47;41;6;35;.854;3600000;0
16828;170037;567;55;20;3;17;.850;3600000;0
16828;35052;585;0;0;0;0;.00nan;0;0
16828;67625;567;0;0;0;0;.00nan;0;0
16829;72514;1927;55;6;0;6;1.000;457000;0
16829;155769;583;72;29;3;26;.897;3600000;0
16829;155943;1927;33;29;6;23;.793;3143000;0
16829;161069;583;0;0;0;0;.00nan;0;0
16830;13065;1925;0;0;0;0;.00nan;0;0
16830;179950;563;79;25;2;23;.920;3546000;0
16830;34168;563;0;0;0;0;.00nan;0;0
16830;40088;1925;88;34;1;33;.971;3600000;0
16831;170037;567;37;15;4;11;.733;3544000;0
16831;36571;1928;0;0;0;0;.00nan;0;0
16831;55285;1928;76;35;3;32;.914;3600000;0
16831;67625;567;0;0;0;0;.00nan;0;0
16832;13041;2277;47;32;5;27;.844;3600000;0
16832;19954;580;81;26;2;24;.923;3600000;0
16832;56653;580;0;0;0;0;.00nan;0;0
16832;66790;2277;0;0;0;0;.00nan;0;0
16833;13041;2277;0;0;0;0;.00nan;0;0
16833;190423;1918;0;0;0;0;.00nan;0;0
16833;185744;1918;87;16;0;16;1.000;3600000;0
16833;66790;2277;27;42;8;34;.810;3600000;0
16834;7412;585;0;0;0;0;.00nan;0;0
16834;179950;563;22;21;5;16;.762;3529000;0
16834;34168;563;0;0;0;0;.00nan;0;0
16834;35052;585;67;30;3;27;.900;3600000;0
16835;36571;1928;91;34;1;33;.971;3542000;0
16835;55285;1928;0;0;0;0;.00nan;0;0
16835;72514;1927;0;0;0;0;.00nan;0;0
16835;155943;1927;97;22;0;22;1.000;3600000;0
16836;13033;586;0;0;0;0;.00nan;0;0
16836;190423;1918;0;0;0;0;.00nan;0;0
16836;185744;1918;89;33;1;32;.970;3590000;0
16836;143829;586;100;34;0;34;1.000;3600000;0
16837;170037;567;42;18;4;14;.778;3600000;0
16837;67625;567;0;0;0;0;.00nan;0;0
16837;72514;1927;0;0;0;0;.00nan;0;0
16837;155943;1927;54;67;9;58;.866;3600000;0
16838;13041;2277;100;34;0;34;1.000;3600000;0
16838;179950;563;59;29;3;26;.897;3600000;0
16838;34168;563;0;0;0;0;.00nan;0;0
16838;66790;2277;0;0;0;0;.00nan;0;0
16839;67162;1922;56;23;3;20;.870;2618000;0
16839;85661;1922;12;9;5;4;.444;982000;0
16839;155769;583;100;41;1;40;.976;3600000;0
16839;161069;583;0;0;0;0;.00nan;0;0
16840;13033;586;0;0;0;0;.00nan;0;0
16840;36571;1928;66;38;4;34;.895;3600000;0
16840;55285;1928;0;0;0;0;.00nan;0;0
16840;143829;586;100;30;0;30;1.000;3600000;0
16841;13065;1925;0;0;0;0;.00nan;0;0
16841;19954;580;0;0;0;0;.00nan;0;0
16841;40088;1925;76;22;1;21;.955;3600000;0
16841;56653;580;43;28;5;23;.821;3600000;0
16842;7412;585;0;0;0;0;.00nan;0;0
16842;190423;1918;65;18;1;17;.944;3600000;0
16842;35052;585;89;33;2;31;.939;3578000;0
16842;185744;1918;0;0;0;0;.00nan;0;0
16843;13041;2277;0;0;0;0;.00nan;0;0
16843;66790;2277;43;28;4;24;.857;3566000;0
16843;67162;1922;0;0;0;0;.00nan;0;0
16843;85661;1922;83;32;2;30;.938;3600000;0
16844;179950;563;0;0;0;0;.00nan;0;0
16844;34168;563;98;30;0;30;1.000;3600000;0
16844;155769;583;0;0;0;0;.00nan;0;0
16844;161069;583;62;35;3;32;.914;3600000;0
16845;170037;567;0;0;0;0;.00nan;0;0
16845;36571;1928;0;0;0;0;.00nan;0;0
16845;55285;1928;88;39;2;37;.949;3600000;0
16845;67625;567;36;20;4;16;.800;3522000;0
16846;13065;1925;63;24;2;22;.917;3551000;0
16846;19954;580;69;21;1;20;.952;3600000;0
16846;40088;1925;0;0;0;0;.00nan;0;0
16846;56653;580;0;0;0;0;.00nan;0;0
16847;7412;585;73;38;3;35;.921;3556000;0
16847;14191;2557;0;0;0;0;.00nan;0;0
16847;35052;585;0;0;0;0;.00nan;0;0
16847;53936;2557;67;24;2;22;.917;3600000;0
16848;13065;1925;0;0;0;0;.00nan;0;0
16848;40088;1925;88;30;1;29;.967;3555000;0
16848;67162;1922;0;0;0;0;.00nan;0;0
16848;85661;1922;96;26;0;26;1.000;3600000;0
16849;67162;1922;0;0;0;0;.00nan;0;0
16849;72514;1927;0;0;0;0;.00nan;0;0
16849;85661;1922;55;37;4;33;.892;3600000;0
16849;155943;1927;79;26;1;25;.962;3600000;0
16850;19954;580;72;26;2;24;.923;3900000;0
16850;190423;1918;0;0;0;0;.00nan;0;0
16850;185744;1918;83;31;2;29;.935;3900000;0
16850;56653;580;0;0;0;0;.00nan;0;0
16851;13041;2277;0;0;0;0;.00nan;0;0
16851;66790;2277;55;38;5;33;.868;3600000;0
16851;72514;1927;83;26;1;25;.962;3600000;0
16851;155943;1927;0;0;0;0;.00nan;0;0
16852;13065;1925;69;26;2;24;.923;3578000;0
16852;40088;1925;0;0;0;0;.00nan;0;0
16852;155769;583;83;26;1;25;.962;3600000;0
16852;161069;583;0;0;0;0;.00nan;0;0
16853;14191;2557;0;0;0;0;.00nan;0;0
16853;170037;567;73;27;2;25;.926;3600000;0
16853;53936;2557;66;33;4;29;.879;3567000;0
16853;67625;567;0;0;0;0;.00nan;0;0
16854;13033;586;0;0;0;0;.00nan;0;0
16854;13041;2277;88;49;4;45;.918;3600000;0
16854;66790;2277;0;0;0;0;.00nan;0;0
16854;143829;586;63;17;1;16;.941;3600000;0
16855;19954;580;0;0;0;0;.00nan;0;0
16855;179950;563;0;0;0;0;.00nan;0;0
16855;34168;563;61;30;3;27;.900;3600000;0
16855;56653;580;100;27;0;27;1.000;3600000;0
16856;190423;1918;46;5;1;4;.800;809000;0
16856;36571;1928;60;23;2;21;.913;3600000;0
16856;185744;1918;31;24;6;18;.750;2791000;0
16856;55285;1928;0;0;0;0;.00nan;0;0
16857;7412;585;0;0;0;0;.00nan;0;0
16857;35052;585;82;33;3;30;.909;3600000;0
16857;67162;1922;0;0;0;0;.00nan;0;0
16857;85661;1922;17;17;6;11;.647;3600000;0
16858;13033;586;0;0;0;0;.00nan;0;0
16858;143829;586;69;17;1;16;.941;3600000;0
16858;155769;583;0;0;0;0;.00nan;0;0
16858;161069;583;82;43;3;40;.930;3563000;0
16859;19954;580;0;0;0;0;.00nan;0;0
16859;179950;563;74;22;2;20;.909;3600000;0
16859;34168;563;0;0;0;0;.00nan;0;0
16859;56653;580;83;38;3;35;.921;3600000;0
16860;14191;2557;31;9;3;6;.667;447000;0
16860;36571;1928;0;0;0;0;.00nan;0;0
16860;53936;2557;78;25;2;23;.920;3153000;0
16860;55285;1928;65;16;1;15;.938;3600000;0
16861;7412;585;89;30;1;29;.967;3600000;0
16861;35052;585;0;0;0;0;.00nan;0;0
16861;72514;1927;0;0;0;0;.00nan;0;0
16861;155943;1927;51;29;5;24;.828;3600000;0
16862;36571;1928;72;31;3;28;.903;3543000;0
16862;55285;1928;0;0;0;0;.00nan;0;0
16862;67162;1922;0;0;0;0;.00nan;0;0
16862;85661;1922;60;25;2;23;.920;3600000;0
16863;67162;1922;0;0;0;0;.00nan;0;0
16863;72514;1927;0;0;0;0;.00nan;0;0
16863;85661;1922;62;31;3;28;.903;3600000;0
16863;155943;1927;100;29;0;29;1.000;3600000;0
16864;13065;1925;0;0;0;0;.00nan;0;0
16864;190423;1918;61;22;2;20;.909;2732000;0
16864;185744;1918;24;12;4;8;.667;868000;0
16864;40088;1925;92;21;0;21;1.000;3600000;0
16865;13041;2277;0;0;0;0;.00nan;0;0
16865;170037;567;48;24;4;20;.833;3600000;0
16865;66790;2277;99;41;1;40;.976;3600000;0
16865;67625;567;0;0;0;0;.00nan;0;0
16866;13033;586;0;0;0;0;.00nan;0;0
16866;179950;563;91;18;0;18;1.000;3600000;0
16866;34168;563;0;0;0;0;.00nan;0;0
16866;143829;586;61;29;4;25;.862;3600000;0
16867;14191;2557;0;0;0;0;.00nan;0;0
16867;36571;1928;41;17;3;14;.824;3545000;0
16867;53936;2557;87;37;2;35;.946;3600000;0
16867;55285;1928;0;0;0;0;.00nan;0;0
16868;7412;585;0;0;0;0;.00nan;0;0
16868;19954;580;76;37;3;34;.919;3900000;0
16868;35052;585;62;29;3;26;.897;3900000;0
16868;56653;580;0;0;0;0;.00nan;0;0
16869;170037;567;0;0;0;0;.00nan;0;0
16869;67625;567;65;26;3;23;.885;3863000;0
16869;155769;583;97;40;2;38;.950;3863000;0
16869;161069;583;0;0;0;0;.00nan;0;0
16870;179950;563;78;24;2;22;.917;3900000;0
16870;34168;563;0;0;0;0;.00nan;0;0
16870;67162;1922;0;0;0;0;.00nan;0;0
16870;85661;1922;61;22;2;20;.909;3900000;0
16871;13065;1925;0;0;0;0;.00nan;0;0
16871;36571;1928;0;0;0;0;.00nan;0;0
16871;40088;1925;76;35;3;32;.914;3600000;0
16871;55285;1928;58;29;4;25;.862;3576000;0
16872;190423;1918;0;0;0;0;.00nan;0;0
16872;185744;1918;85;25;1;24;.960;3600000;0
16872;72514;1927;0;0;0;0;.00nan;0;0
16872;155943;1927;47;28;4;24;.857;3600000;0
16873;7412;585;83;29;2;27;.931;3732000;0
16873;19954;580;0;0;0;0;.00nan;0;0
16873;35052;585;0;0;0;0;.00nan;0;0
16873;56653;580;69;30;3;27;.900;3732000;0
16874;14191;2557;0;0;0;0;.00nan;0;0
16874;179950;563;0;0;0;0;.00nan;0;0
16874;34168;563;57;26;3;23;.885;3600000;0
16874;53936;2557;66;25;2;23;.920;3600000;0
16875;13033;586;41;16;3;13;.813;3563000;0
16875;72514;1927;72;27;2;25;.926;3600000;0
16875;143829;586;0;0;0;0;.00nan;0;0
16875;155943;1927;0;0;0;0;.00nan;0;0
16876;190423;1918;0;0;0;0;.00nan;0;0
16876;36571;1928;61;20;2;18;.900;3600000;0
16876;185744;1918;54;30;4;26;.867;3544000;0
16876;55285;1928;0;0;0;0;.00nan;0;0
16877;13033;586;0;0;0;0;.00nan;0;0
16877;19954;580;53;40;6;34;.850;3014000;0
16877;56653;580;66;4;0;4;1.000;586000;0
16877;143829;586;73;21;1;20;.952;3600000;0
16878;7412;585;0;0;0;0;.00nan;0;0
16878;35052;585;74;27;2;25;.926;3600000;0
16878;155769;583;54;31;4;27;.871;3600000;0
16878;161069;583;0;0;0;0;.00nan;0;0
16879;13041;2277;48;30;5;25;.833;3600000;0
16879;13065;1925;76;36;2;34;.944;3600000;0
16879;40088;1925;0;0;0;0;.00nan;0;0
16879;66790;2277;0;0;0;0;.00nan;0;0
16880;170037;567;35;22;5;17;.773;3532000;0
16880;179950;563;95;44;2;42;.955;3600000;0
16880;34168;563;0;0;0;0;.00nan;0;0
16880;67625;567;0;0;0;0;.00nan;0;0
16881;190423;1918;0;0;0;0;.00nan;0;0
16881;185744;1918;62;36;4;32;.889;3600000;0
16881;67162;1922;0;0;0;0;.00nan;0;0
16881;85661;1922;70;24;3;21;.875;3600000;0
16882;14191;2557;0;0;0;0;.00nan;0;0
16882;19954;580;0;0;0;0;.00nan;0;0
16882;53936;2557;56;22;2;20;.909;3900000;0
16882;56653;580;88;42;2;40;.952;3900000;0
16883;72514;1927;91;30;1;29;.967;3600000;0
16883;155769;583;0;0;0;0;.00nan;0;0
16883;155943;1927;0;0;0;0;.00nan;0;0
16883;161069;583;50;36;4;32;.889;3600000;0
16884;1601;586;0;0;0;0;.00nan;0;0
16884;13065;1925;0;0;0;0;.00nan;0;0
16884;40088;1925;70;32;3;29;.906;3579000;0
16884;143829;586;69;20;1;19;.950;3600000;0
16885;13033;580;60;32;4;28;.875;3600000;0
16885;56653;580;0;0;0;0;.00nan;0;0
16885;67162;1922;90;29;1;28;.966;3600000;0
16885;85661;1922;0;0;0;0;.00nan;0;0
16886;179950;563;0;0;0;0;.00nan;0;0
16886;34168;563;89;49;2;47;.959;3585000;0
16886;36571;1928;71;22;1;21;.955;3600000;0
16886;55285;1928;0;0;0;0;.00nan;0;0
16887;14191;2557;79;23;1;22;.957;3600000;0
16887;190423;1918;70;31;2;29;.935;3595000;0
16887;185744;1918;0;0;0;0;.00nan;0;0
16887;53936;2557;0;0;0;0;.00nan;0;0
16888;7412;585;0;0;0;0;.00nan;0;0
16888;13041;2277;0;0;0;0;.00nan;0;0
16888;35052;585;94;35;1;34;.971;3600000;0
16888;66790;2277;51;29;5;24;.828;3600000;0
16889;1601;586;0;0;0;0;.00nan;0;0
16889;67162;1922;0;0;0;0;.00nan;0;0
16889;85661;1922;87;34;3;31;.912;3600000;0
16889;143829;586;39;20;4;16;.800;3543000;0
16890;7412;585;0;0;0;0;.00nan;0;0
16890;13065;1925;0;0;0;0;.00nan;0;0
16890;35052;585;53;24;3;21;.875;3588000;0
16890;40088;1925;78;26;1;25;.962;3600000;0
16891;14191;2557;0;0;0;0;.00nan;0;0
16891;53936;2557;81;43;3;40;.930;3900000;0
16891;67162;1922;0;0;0;0;.00nan;0;0
16891;85661;1922;61;28;3;25;.893;3900000;0
16892;13033;580;59;40;5;35;.875;3600000;0
16892;170037;567;65;18;1;17;.944;3600000;0
16892;56653;580;0;0;0;0;.00nan;0;0
16892;67625;567;0;0;0;0;.00nan;0;0
16893;13041;2277;74;43;4;39;.907;3600000;0
16893;66790;2277;0;0;0;0;.00nan;0;0
16893;155769;583;28;25;6;19;.760;3566000;0
16893;161069;583;0;0;0;0;.00nan;0;0
16894;14191;2557;90;48;2;46;.958;3600000;0
16894;53936;2557;0;0;0;0;.00nan;0;0
16894;67162;1922;0;0;0;0;.00nan;0;0
16894;85661;1922;77;31;3;28;.903;3587000;0
16895;190423;1918;0;0;0;0;.00nan;0;0
16895;179950;563;74;24;1;23;.958;3600000;0
16895;34168;563;0;0;0;0;.00nan;0;0
16895;185744;1918;79;33;2;31;.939;3545000;0
16896;36571;1928;58;31;4;27;.871;3600000;0
16896;55285;1928;0;0;0;0;.00nan;0;0
16896;72514;1927;0;0;0;0;.00nan;0;0
16896;155943;1927;87;29;1;28;.966;3600000;0
16897;1601;586;0;0;0;0;.00nan;0;0
16897;7412;585;42;35;6;29;.829;3191000;0
16897;35052;585;45;5;1;4;.800;409000;0
16897;143829;586;66;32;3;29;.906;3600000;0
16898;13041;2277;0;0;0;0;.00nan;0;0
16898;66790;2277;86;29;2;27;.931;3900000;0
16898;155769;583;0;0;0;0;.00nan;0;0
16898;161069;583;72;34;2;32;.941;3900000;0
16899;1601;586;0;0;0;0;.00nan;0;0
16899;13065;1925;0;0;0;0;.00nan;0;0
16899;40088;1925;59;46;6;40;.870;3600000;0
16899;143829;586;41;13;3;10;.769;3600000;0
16900;190423;1918;71;28;2;26;.929;3900000;0
16900;179950;563;0;0;0;0;.00nan;0;0
16900;34168;563;94;33;2;31;.939;3900000;0
16900;185744;1918;0;0;0;0;.00nan;0;0
16901;36571;1928;0;0;0;0;.00nan;0;0
16901;55285;1928;74;24;1;23;.958;3600000;0
16901;72514;1927;77;32;2;30;.938;3574000;0
16901;155943;1927;0;0;0;0;.00nan;0;0
16902;13033;580;85;39;2;37;.949;3546000;0
16902;170037;567;0;0;0;0;.00nan;0;0
16902;56653;580;0;0;0;0;.00nan;0;0
16902;67625;567;70;17;1;16;.941;3600000;0
16903;7412;585;0;0;0;0;.00nan;0;0
16903;35052;585;36;28;5;23;.821;3545000;0
16903;36571;1928;45;22;4;18;.818;3600000;0
16903;55285;1928;0;0;0;0;.00nan;0;0
16904;1601;586;0;0;0;0;.00nan;0;0
16904;143829;586;86;29;2;27;.931;3900000;0
16904;155769;583;95;57;2;55;.965;3900000;0
16904;161069;583;0;0;0;0;.00nan;0;0
16905;7412;585;45;38;6;32;.842;3600000;0
16905;170037;567;62;22;2;20;.909;3600000;0
16905;35052;585;0;0;0;0;.00nan;0;0
16905;67625;567;0;0;0;0;.00nan;0;0
16906;13041;2277;63;37;4;33;.892;3600000;0
16906;66790;2277;0;0;0;0;.00nan;0;0
16906;67162;1922;0;0;0;0;.00nan;0;0
16906;85661;1922;63;17;1;16;.941;3600000;0
16907;14191;2557;0;0;0;0;.00nan;0;0
16907;53936;2557;42;15;3;12;.800;3554000;0
16907;155769;583;81;34;2;32;.941;3600000;0
16907;161069;583;0;0;0;0;.00nan;0;0
16908;190423;1918;0;0;0;0;.00nan;0;0
16908;185744;1918;76;26;2;24;.923;3600000;0
16908;72514;1927;0;0;0;0;.00nan;0;0
16908;155943;1927;63;38;4;34;.895;3566000;0
16909;13033;580;70;25;2;23;.920;3600000;0
16909;179950;563;61;38;4;34;.895;3545000;0
16909;34168;563;0;0;0;0;.00nan;0;0
16909;56653;580;0;0;0;0;.00nan;0;0
16910;13065;1925;50;1;0;1;1.000;333000;0
16910;170037;567;0;0;0;0;.00nan;0;0
16910;40088;1925;43;40;6;34;.850;3267000;0
16910;67625;567;58;24;2;22;.917;3600000;0
16911;190423;1918;68;25;2;23;.920;3888000;0
16911;36571;1928;66;25;2;23;.920;3900000;0
16911;185744;1918;0;0;0;0;.00nan;0;0
16911;55285;1928;0;0;0;0;.00nan;0;0
16912;13041;2277;0;0;0;0;.00nan;0;0
16912;14191;2557;66;32;3;29;.906;3600000;0
16912;53936;2557;0;0;0;0;.00nan;0;0
16912;66790;2277;51;36;5;31;.861;3593000;0
16913;13033;580;62;34;4;30;.882;3695000;0
16913;179950;563;0;0;0;0;.00nan;0;0
16913;34168;563;44;33;5;28;.848;3695000;0
16913;56653;580;0;0;0;0;.00nan;0;0
16914;13041;2277;80;55;6;49;.891;3600000;0
16914;36571;1928;0;0;0;0;.00nan;0;0
16914;55285;1928;61;23;2;21;.913;3600000;0
16914;66790;2277;0;0;0;0;.00nan;0;0
16915;170037;567;69;27;2;25;.926;3600000;0
16915;179950;563;62;37;4;33;.892;3528000;0
16915;34168;563;0;0;0;0;.00nan;0;0
16915;67625;567;0;0;0;0;.00nan;0;0
16916;36571;1928;47;32;4;28;.875;3600000;0
16916;55285;1928;0;0;0;0;.00nan;0;0
16916;155769;583;53;33;5;28;.848;3553000;0
16916;161069;583;0;0;0;0;.00nan;0;0
16917;13065;1925;0;0;0;0;.00nan;0;0
16917;14191;2557;100;36;2;34;.944;3600000;0
16917;40088;1925;63;29;3;26;.897;3600000;0
16917;53936;2557;0;0;0;0;.00nan;0;0
16918;170037;567;0;0;0;0;.00nan;0;0
16918;190423;1918;0;0;0;0;.00nan;0;0
16918;185744;1918;65;32;4;28;.875;3599000;0
16918;67625;567;56;21;2;19;.905;3600000;0
16919;14191;2557;0;0;0;0;.00nan;0;0
16919;53936;2557;63;26;3;23;.885;3600000;0
16919;72514;1927;0;0;0;0;.00nan;0;0
16919;155943;1927;69;26;2;24;.923;3600000;0
16920;13041;2277;0;0;0;0;.00nan;0;0
16920;66790;2277;94;39;1;38;.974;3600000;0
16920;67162;1922;0;0;0;0;.00nan;0;0
16920;85661;1922;49;31;5;26;.839;3600000;0
16921;1601;586;0;0;0;0;.00nan;0;0
16921;143829;586;37;25;5;20;.800;3600000;0
16921;155769;583;78;39;3;36;.923;3600000;0
16921;161069;583;0;0;0;0;.00nan;0;0
16922;13033;580;68;42;4;38;.905;3580000;0
16922;36571;1928;0;0;0;0;.00nan;0;0
16922;55285;1928;44;18;3;15;.833;3600000;0
16922;56653;580;0;0;0;0;.00nan;0;0
16923;7412;585;57;21;2;19;.905;3600000;0
16923;179950;563;78;40;4;36;.900;3568000;0
16923;34168;563;0;0;0;0;.00nan;0;0
16923;35052;585;0;0;0;0;.00nan;0;0
16924;13065;1925;73;30;2;28;.933;3600000;0
16924;179950;563;0;0;0;0;.00nan;0;0
16924;34168;563;46;20;3;17;.850;3600000;0
16924;40088;1925;0;0;0;0;.00nan;0;0
16925;170037;567;83;23;1;22;.957;3600000;0
16925;67162;1922;71;37;3;34;.919;3600000;0
16925;67625;567;0;0;0;0;.00nan;0;0
16925;85661;1922;0;0;0;0;.00nan;0;0
16926;13033;580;63;30;3;27;.900;3900000;0
16926;13041;2277;68;34;3;31;.912;3900000;0
16926;56653;580;0;0;0;0;.00nan;0;0
16926;66790;2277;0;0;0;0;.00nan;0;0
16927;7412;585;0;0;0;0;.00nan;0;0
16927;14191;2557;100;23;0;23;1.000;3600000;0
16927;35052;585;74;28;2;26;.929;3533000;0
16927;53936;2557;0;0;0;0;.00nan;0;0
16928;1601;586;0;0;0;0;.00nan;0;0
16928;190423;1918;0;0;0;0;.00nan;0;0
16928;185744;1918;80;28;2;26;.929;3585000;0
16928;143829;586;82;27;1;26;.963;3600000;0
16929;1601;586;0;0;0;0;.00nan;0;0
16929;170037;567;50;31;4;27;.871;3531000;0
16929;67625;567;0;0;0;0;.00nan;0;0
16929;143829;586;74;27;2;25;.926;3600000;0
16930;7412;585;57;32;4;28;.875;3600000;0
16930;35052;585;0;0;0;0;.00nan;0;0
16930;72514;1927;34;31;6;25;.806;3570000;0
16930;155943;1927;0;0;0;0;.00nan;0;0
16931;13041;2277;0;0;0;0;.00nan;0;0
16931;179950;563;66;28;2;26;.929;3600000;0
16931;34168;563;0;0;0;0;.00nan;0;0
16931;66790;2277;62;35;4;31;.886;3554000;0
16932;14191;2557;90;43;3;40;.930;3600000;0
16932;170037;567;0;0;0;0;.00nan;0;0
16932;53936;2557;0;0;0;0;.00nan;0;0
16932;67625;567;96;24;0;24;1.000;3600000;0
16933;13033;580;37;29;5;24;.828;3600000;0
16933;56653;580;0;0;0;0;.00nan;0;0
16933;155769;583;65;31;3;28;.903;3600000;0
16933;161069;583;0;0;0;0;.00nan;0;0
16934;7412;585;0;0;0;0;.00nan;0;0
16934;170037;567;0;0;0;0;.00nan;0;0
16934;35052;585;77;38;4;34;.895;3600000;0
16934;67625;567;57;9;1;8;.889;3600000;0
16935;13041;2277;47;6;1;5;.833;1244000;0
16935;13065;1925;0;0;0;0;.00nan;0;0
16935;40088;1925;53;25;3;22;.880;3600000;0
16935;66790;2277;11;22;6;16;.727;2356000;0
16936;36571;1928;65;27;2;25;.926;3600000;0
16936;55285;1928;0;0;0;0;.00nan;0;0
16936;67162;1922;57;4;0;4;1.000;292000;0
16936;85661;1922;29;26;6;20;.769;3308000;0
16937;14191;2557;57;24;3;21;.875;3544000;0
16937;179950;563;69;23;2;21;.913;3600000;0
16937;34168;563;0;0;0;0;.00nan;0;0
16937;53936;2557;0;0;0;0;.00nan;0;0
16938;13033;580;55;39;4;35;.897;3600000;0
16938;56653;580;0;0;0;0;.00nan;0;0
16938;72514;1927;0;0;0;0;.00nan;0;0
16938;155943;1927;50;25;3;22;.880;3600000;0
16939;7412;585;91;29;1;28;.966;3600000;0
16939;13041;2277;83;32;2;30;.938;3585000;0
16939;35052;585;0;0;0;0;.00nan;0;0
16939;66790;2277;0;0;0;0;.00nan;0;0
16940;13065;1925;56;18;2;16;.889;3562000;0
16940;40088;1925;0;0;0;0;.00nan;0;0
16940;155769;583;0;0;0;0;.00nan;0;0
16940;161069;583;99;25;0;25;1.000;3600000;0
16941;1601;586;0;0;0;0;.00nan;0;0
16941;67162;1922;58;32;4;28;.875;3571000;0
16941;85661;1922;0;0;0;0;.00nan;0;0
16941;143829;586;66;19;2;17;.895;3600000;0
16942;13033;580;85;42;3;39;.929;3600000;0
16942;36571;1928;48;0;0;0;.00nan;749000;0
16942;55285;1928;21;19;6;13;.684;2851000;0
16942;56653;580;0;0;0;0;.00nan;0;0
16943;14191;2557;0;0;0;0;.00nan;0;0
16943;190423;1918;0;0;0;0;.00nan;0;0
16943;185744;1918;74;19;1;18;.947;3600000;0
16943;53936;2557;65;34;3;31;.912;3545000;0
16944;13033;580;74;46;4;42;.913;3600000;0
16944;170037;567;66;19;1;18;.947;3600000;0
16944;56653;580;0;0;0;0;.00nan;0;0
16944;67625;567;0;0;0;0;.00nan;0;0
16945;1601;586;0;0;0;0;.00nan;0;0
16945;72514;1927;22;28;6;22;.786;2705000;0
16945;143829;586;58;25;3;22;.880;3600000;0
16945;155943;1927;32;11;3;8;.727;895000;0
16946;7412;585;0;0;0;0;.00nan;0;0
16946;13065;1925;0;0;0;0;.00nan;0;0
16946;35052;585;82;35;2;33;.943;3600000;0
16946;40088;1925;53;23;3;20;.870;3579000;0
16947;67162;1922;0;0;0;0;.00nan;0;0
16947;85661;1922;41;22;4;18;.818;3518000;0
16947;155769;583;0;0;0;0;.00nan;0;0
16947;161069;583;76;33;2;31;.939;3600000;0
16948;13065;1925;0;0;0;0;.00nan;0;0
16948;40088;1925;80;33;3;30;.909;3600000;0
16948;155769;583;36;20;4;16;.800;1089000;0
16948;161069;583;61;14;1;13;.929;2445000;0
16949;170037;567;70;23;2;21;.913;3600000;0
16949;67625;567;0;0;0;0;.00nan;0;0
16949;72514;1927;38;44;7;37;.841;2665000;0
16949;155943;1927;59;7;0;7;1.000;935000;0
16950;7412;585;0;0;0;0;.00nan;0;0
16950;13041;2277;71;33;3;30;.909;3600000;0
16950;35052;585;100;32;0;32;1.000;3600000;0
16950;66790;2277;0;0;0;0;.00nan;0;0
16951;1601;586;0;0;0;0;.00nan;0;0
16951;179950;563;63;42;5;37;.881;3600000;0
16951;34168;563;0;0;0;0;.00nan;0;0
16951;143829;586;97;29;1;28;.966;3600000;0
16952;14191;2557;69;26;2;24;.923;3600000;0
16952;53936;2557;0;0;0;0;.00nan;0;0
16952;67162;1922;38;34;6;28;.824;3600000;0
16952;85661;1922;0;0;0;0;.00nan;0;0
16953;13033;580;51;29;5;24;.828;3600000;0
16953;36571;1928;52;25;4;21;.840;3600000;0
16953;55285;1928;0;0;0;0;.00nan;0;0
16953;56653;580;0;0;0;0;.00nan;0;0
16954;13065;1925;35;29;6;23;.793;2821000;0
16954;170037;567;0;0;0;0;.00nan;0;0
16954;40088;1925;65;11;0;11;1.000;779000;0
16954;67625;567;73;27;3;24;.889;3600000;0
16955;13041;2277;49;15;2;13;.867;1213000;0
16955;36571;1928;0;0;0;0;.00nan;0;0
16955;55285;1928;98;20;0;20;1.000;3600000;0
16955;66790;2277;60;33;4;29;.879;2387000;0
16956;1601;586;0;0;0;0;.00nan;0;0
16956;14191;2557;0;0;0;0;.00nan;0;0
16956;53936;2557;50;30;4;26;.867;3600000;0
16956;143829;586;62;18;1;17;.944;3600000;0
16957;7412;585;0;0;0;0;.00nan;0;0
16957;190423;1918;0;0;0;0;.00nan;0;0
16957;35052;585;92;44;2;42;.955;3900000;0
16957;185744;1918;73;24;2;22;.917;3900000;0
16958;13033;580;69;24;3;21;.875;3600000;0
16958;56653;580;0;0;0;0;.00nan;0;0
16958;72514;1927;0;0;0;0;.00nan;0;0
16958;155943;1927;55;26;4;22;.846;3570000;0
16959;67162;1922;0;0;0;0;.00nan;0;0
16959;72514;1927;0;0;0;0;.00nan;0;0
16959;85661;1922;46;28;5;23;.821;3616000;0
16959;155943;1927;61;44;6;38;.864;3616000;0
16960;1601;586;0;0;0;0;.00nan;0;0
16960;13065;1925;0;0;0;0;.00nan;0;0
16960;40088;1925;53;44;7;37;.841;3541000;0
16960;143829;586;30;24;5;19;.792;3600000;0
16961;179950;563;71;23;2;21;.913;3600000;0
16961;34168;563;0;0;0;0;.00nan;0;0
16961;155769;583;73;39;3;36;.923;3580000;0
16961;161069;583;0;0;0;0;.00nan;0;0
16962;13041;2277;81;43;3;40;.930;3575000;0
16962;66790;2277;0;0;0;0;.00nan;0;0
16962;72514;1927;0;0;0;0;.00nan;0;0
16962;155943;1927;96;32;1;31;.969;3600000;0
16963;1601;586;63;27;3;24;.889;3600000;0
16963;13041;2277;0;0;0;0;.00nan;0;0
16963;66790;2277;79;45;4;41;.911;3600000;0
16963;143829;586;0;0;0;0;.00nan;0;0
16964;170037;567;27;19;5;14;.737;3850000;0
16964;67162;1922;0;0;0;0;.00nan;0;0
16964;67625;567;0;0;0;0;.00nan;0;0
16964;85661;1922;59;44;6;38;.864;3850000;0
16965;13065;1925;57;13;1;12;.923;1450000;0
16965;36571;1928;0;0;0;0;.00nan;0;0
16965;40088;1925;19;21;6;15;.714;2150000;0
16965;55285;1928;95;27;0;27;1.000;3600000;0
16966;13033;580;70;19;1;18;.947;3600000;0
16966;14191;2557;65;37;4;33;.892;3600000;0
16966;53936;2557;0;0;0;0;.00nan;0;0
16966;56653;580;0;0;0;0;.00nan;0;0
16967;7412;585;0;0;0;0;.00nan;0;0
16967;190423;1918;0;0;0;0;.00nan;0;0
16967;35052;585;54;47;6;41;.872;3600000;0
16967;185744;1918;64;14;1;13;.929;3600000;0
16968;13065;1925;0;0;0;0;.00nan;0;0
16968;190423;1918;82;30;2;28;.933;3600000;0
16968;185744;1918;0;0;0;0;.00nan;0;0
16968;40088;1925;59;30;3;27;.900;3574000;0
16969;36571;1928;0;0;0;0;.00nan;0;0
16969;55285;1928;41;22;4;18;.818;3900000;0
16969;155769;583;0;0;0;0;.00nan;0;0
16969;161069;583;61;38;4;34;.895;3900000;0
16970;1601;586;0;0;0;0;.00nan;0;0
16970;170037;567;0;0;0;0;.00nan;0;0
16970;67625;567;73;21;1;20;.952;3600000;0
16970;143829;586;77;36;3;33;.917;3600000;0
16971;7412;585;26;15;4;11;.733;1142000;0
16971;35052;585;62;23;2;21;.913;2458000;0
16971;67162;1922;0;0;0;0;.00nan;0;0
16971;85661;1922;77;29;2;27;.931;3600000;0
16972;179950;563;66;31;3;28;.903;3900000;0
16972;34168;563;0;0;0;0;.00nan;0;0
16972;72514;1927;0;0;0;0;.00nan;0;0
16972;155943;1927;70;34;3;31;.912;3900000;0
16973;13033;580;0;0;0;0;.00nan;0;0
16973;14191;2557;0;0;0;0;.00nan;0;0
16973;53936;2557;38;30;5;25;.833;3586000;0
16973;56653;580;41;19;4;15;.789;3600000;0
16974;13041;2277;0;0;0;0;.00nan;0;0
16974;179950;563;95;47;2;45;.957;3600000;0
16974;34168;563;0;0;0;0;.00nan;0;0
16974;66790;2277;57;39;5;34;.872;3600000;0
16975;179950;563;0;0;0;0;.00nan;0;0
16975;34168;563;86;33;1;32;.970;3600000;0
16975;155769;583;0;0;0;0;.00nan;0;0
16975;161069;583;47;30;4;26;.867;3600000;0
16976;14191;2557;88;31;1;30;.968;3600000;0
16976;53936;2557;0;0;0;0;.00nan;0;0
16976;72514;1927;76;29;2;27;.931;3565000;0
16976;155943;1927;0;0;0;0;.00nan;0;0
16977;13033;580;68;43;5;38;.884;3600000;0
16977;36571;1928;0;0;0;0;.00nan;0;0
16977;55285;1928;66;17;1;16;.941;3600000;0
16977;56653;580;0;0;0;0;.00nan;0;0
16978;13033;580;39;22;4;18;.818;3589000;0
16978;13065;1925;0;0;0;0;.00nan;0;0
16978;40088;1925;68;32;3;29;.906;3600000;0
16978;56653;580;0;0;0;0;.00nan;0;0
16979;1601;586;76;24;1;23;.958;3151000;0
16979;170037;567;75;34;3;31;.912;3600000;0
16979;67625;567;0;0;0;0;.00nan;0;0
16979;143829;586;32;10;3;7;.700;449000;0
16980;13041;2277;78;39;3;36;.923;3900000;0
16980;14191;2557;68;28;3;25;.893;3900000;0
16980;53936;2557;0;0;0;0;.00nan;0;0
16980;66790;2277;0;0;0;0;.00nan;0;0
16981;190423;1918;0;0;0;0;.00nan;0;0
16981;185744;1918;75;35;4;31;.886;3600000;0
16981;67162;1922;0;0;0;0;.00nan;0;0
16981;85661;1922;24;34;7;27;.794;3600000;0
16982;7412;585;0;0;0;0;.00nan;0;0
16982;35052;585;52;44;6;38;.864;3600000;0
16982;72514;1927;0;0;0;0;.00nan;0;0
16982;155943;1927;84;32;1;31;.969;3600000;0
16983;1601;586;62;23;2;21;.913;3028000;0
16983;13041;2277;0;0;0;0;.00nan;0;0
16983;66790;2277;85;52;4;48;.923;3600000;0
16983;143829;586;23;4;3;1;.250;520000;0
16984;14191;2557;0;0;0;0;.00nan;0;0
16984;53936;2557;84;40;3;37;.925;3536000;0
16984;155769;583;81;22;1;21;.955;3600000;0
16984;161069;583;0;0;0;0;.00nan;0;0
16985;179950;563;63;22;2;20;.909;3600000;0
16985;34168;563;0;0;0;0;.00nan;0;0
16985;67162;1922;0;0;0;0;.00nan;0;0
16985;85661;1922;34;11;3;8;.727;3542000;0
16986;13065;1925;62;28;4;24;.857;3714000;0
16986;40088;1925;0;0;0;0;.00nan;0;0
16986;72514;1927;55;33;5;28;.848;3714000;0
16986;155943;1927;0;0;0;0;.00nan;0;0
16987;7412;585;60;20;2;18;.900;3600000;0
16987;13033;580;58;32;4;28;.875;3525000;0
16987;35052;585;0;0;0;0;.00nan;0;0
16987;56653;580;0;0;0;0;.00nan;0;0
16988;190423;1918;0;0;0;0;.00nan;0;0
16988;185744;1918;72;21;1;20;.952;3600000;0
16988;72514;1927;30;30;6;24;.800;3600000;0
16988;155943;1927;0;0;0;0;.00nan;0;0
16989;14191;2557;77;22;1;21;.955;3600000;0
16989;36571;1928;0;0;0;0;.00nan;0;0
16989;53936;2557;0;0;0;0;.00nan;0;0
16989;55285;1928;74;30;2;28;.933;3592000;0
16990;13041;2277;99;46;1;45;.978;3600000;0
16990;170037;567;48;21;3;18;.857;3518000;0
16990;66790;2277;0;0;0;0;.00nan;0;0
16990;67625;567;0;0;0;0;.00nan;0;0
16991;190423;1918;0;0;0;0;.00nan;0;0
16991;185744;1918;62;36;5;31;.861;3600000;0
16991;155769;583;48;38;6;32;.842;3573000;0
16991;161069;583;0;0;0;0;.00nan;0;0
16992;13065;1925;0;0;0;0;.00nan;0;0
16992;179950;563;68;30;3;27;.900;3600000;0
16992;34168;563;0;0;0;0;.00nan;0;0
16992;40088;1925;81;35;2;33;.943;3600000;0
16993;1601;586;0;0;0;0;.00nan;0;0
16993;36571;1928;84;31;1;30;.968;3600000;0
16993;55285;1928;0;0;0;0;.00nan;0;0
16993;143829;586;59;26;3;23;.885;3600000;0
16994;14191;2557;81;32;2;30;.938;3600000;0
16994;53936;2557;0;0;0;0;.00nan;0;0
16994;72514;1927;0;0;0;0;.00nan;0;0
16994;155943;1927;100;28;0;28;1.000;3600000;0
16995;13033;580;71;43;5;38;.884;3600000;0
16995;56653;580;0;0;0;0;.00nan;0;0
16995;67162;1922;0;0;0;0;.00nan;0;0
16995;85661;1922;69;25;2;23;.920;3600000;0
16996;170037;567;80;27;1;26;.963;3600000;0
16996;36571;1928;0;0;0;0;.00nan;0;0
16996;55285;1928;61;36;4;32;.889;3600000;0
16996;67625;567;0;0;0;0;.00nan;0;0
16997;13041;2277;0;0;0;0;.00nan;0;0
16997;66790;2277;51;21;3;18;.857;3588000;0
16997;155769;583;0;0;0;0;.00nan;0;0
16997;161069;583;78;35;2;33;.943;3600000;0
16998;1601;586;74;19;1;18;.947;3600000;0
16998;7412;585;60;7;0;7;1.000;481000;0
16998;35052;585;66;44;5;39;.886;3119000;0
16998;143829;586;0;0;0;0;.00nan;0;0
16999;13065;1925;75;37;3;34;.919;3900000;0
16999;190423;1918;0;0;0;0;.00nan;0;0
16999;185744;1918;67;31;3;28;.903;3900000;0
16999;40088;1925;0;0;0;0;.00nan;0;0
17000;13033;580;0;0;0;0;.00nan;0;0
17000;56653;580;100;46;2;44;.957;3900000;0
17000;67162;1922;0;0;0;0;.00nan;0;0
17000;85661;1922;63;18;2;16;.889;3900000;0
17001;7412;585;0;0;0;0;.00nan;0;0
17001;35052;585;97;21;0;21;1.000;3600000;0
17001;36571;1928;0;0;0;0;.00nan;0;0
17001;55285;1928;67;33;4;29;.879;3600000;0
17002;7412;585;57;21;2;19;.905;3900000;0
17002;35052;585;0;0;0;0;.00nan;0;0
17002;155769;583;54;19;2;17;.895;3900000;0
17002;161069;583;0;0;0;0;.00nan;0;0
17003;13065;1925;0;0;0;0;.00nan;0;0
17003;40088;1925;44;38;6;32;.842;3600000;0
17003;67162;1922;0;0;0;0;.00nan;0;0
17003;85661;1922;86;29;1;28;.966;3600000;0
17004;1601;586;0;0;0;0;.00nan;0;0
17004;190423;1918;0;0;0;0;.00nan;0;0
17004;185744;1918;60;30;3;27;.900;3600000;0
17004;143829;586;50;27;4;23;.852;3549000;0
17005;179950;563;74;34;3;31;.912;3900000;0
17005;34168;563;0;0;0;0;.00nan;0;0
17005;72514;1927;0;0;0;0;.00nan;0;0
17005;155943;1927;63;33;3;30;.909;3900000;0
17006;13041;2277;51;30;4;26;.867;3586000;0
17006;13065;1925;0;0;0;0;.00nan;0;0
17006;40088;1925;56;24;3;21;.875;3595000;0
17006;66790;2277;0;0;0;0;.00nan;0;0
17007;170037;567;0;0;0;0;.00nan;0;0
17007;190423;1918;0;0;0;0;.00nan;0;0
17007;185744;1918;79;30;2;28;.933;3900000;0
17007;67625;567;59;26;2;24;.923;3900000;0
17008;67162;1922;0;0;0;0;.00nan;0;0
17008;85661;1922;50;27;4;23;.852;3591000;0
17008;155769;583;0;0;0;0;.00nan;0;0
17008;161069;583;73;38;3;35;.921;3600000;0
17009;1601;586;0;0;0;0;.00nan;0;0
17009;179950;563;0;0;0;0;.00nan;0;0
17009;34168;563;97;46;2;44;.957;3582000;0
17009;143829;586;75;18;1;17;.944;3600000;0
17010;13065;1925;71;39;4;35;.897;3638000;0
17010;40088;1925;0;0;0;0;.00nan;0;0
17010;72514;1927;0;0;0;0;.00nan;0;0
17010;155943;1927;61;37;5;32;.865;3638000;0
17011;170037;567;84;16;0;16;1.000;3600000;0
17011;67162;1922;0;0;0;0;.00nan;0;0
17011;67625;567;0;0;0;0;.00nan;0;0
17011;85661;1922;46;35;5;30;.857;3600000;0
17012;1601;586;36;28;5;23;.821;3600000;0
17012;14191;2557;82;26;2;24;.923;3600000;0
17012;53936;2557;0;0;0;0;.00nan;0;0
17012;143829;586;0;0;0;0;.00nan;0;0
17013;36571;1928;46;2;1;1;.500;944000;0
17013;55285;1928;17;17;6;11;.647;2956000;0
17013;155769;583;49;48;6;42;.875;2621000;0
17013;161069;583;61;14;1;13;.929;1279000;0
17014;13033;580;94;42;2;40;.952;3558000;0
17014;190423;1918;82;25;1;24;.960;3600000;0
17014;185744;1918;0;0;0;0;.00nan;0;0
17014;56653;580;0;0;0;0;.00nan;0;0
17015;7412;585;0;0;0;0;.00nan;0;0
17015;13041;2277;0;0;0;0;.00nan;0;0
17015;35052;585;99;41;1;40;.976;3600000;0
17015;66790;2277;52;26;4;22;.846;3600000;0
17016;7412;585;0;0;0;0;.00nan;0;0
17016;14191;2557;52;3;0;3;1.000;483000;0
17016;35052;585;87;27;1;26;.963;3600000;0
17016;53936;2557;20;22;6;16;.727;3117000;0
17017;14191;2557;84;32;2;30;.938;3813000;0
17017;190423;1918;0;0;0;0;.00nan;0;0
17017;185744;1918;98;26;1;25;.962;3813000;0
17017;53936;2557;0;0;0;0;.00nan;0;0
17018;190423;1918;17;27;7;20;.741;3341000;0
17018;185744;1918;49;1;0;1;1.000;183000;0
17018;67162;1922;0;0;0;0;.00nan;0;0
17018;85661;1922;47;32;5;27;.844;3600000;0
17019;13065;1925;36;35;6;29;.829;2666000;0
17019;36571;1928;53;29;4;25;.862;3600000;0
17019;40088;1925;61;9;1;8;.889;934000;0
17019;55285;1928;0;0;0;0;.00nan;0;0
17020;1601;586;0;0;0;0;.00nan;0;0
17020;190423;1918;68;19;1;18;.947;1404000;0
17020;185744;1918;37;22;5;17;.773;2196000;0
17020;143829;586;86;27;1;26;.963;3600000;0
17021;72514;1927;0;0;0;0;.00nan;0;0
17021;155769;583;0;0;0;0;.00nan;0;0
17021;155943;1927;58;29;3;26;.897;3600000;0
17021;161069;583;91;21;0;21;1.000;3600000;0
17022;13033;580;63;29;2;27;.931;3600000;0
17022;13041;2277;31;34;6;28;.824;3600000;0
17022;56653;580;0;0;0;0;.00nan;0;0
17022;66790;2277;0;0;0;0;.00nan;0;0
17023;7412;585;0;0;0;0;.00nan;0;0
17023;170037;567;55;21;3;18;.857;3600000;0
17023;35052;585;63;36;4;32;.889;3592000;0
17023;67625;567;0;0;0;0;.00nan;0;0
17024;13065;1925;94;46;3;43;.935;3574000;0
17024;170037;567;0;0;0;0;.00nan;0;0
17024;40088;1925;0;0;0;0;.00nan;0;0
17024;67625;567;94;22;1;21;.955;3600000;0
17025;1601;586;67;27;3;24;.889;3580000;0
17025;67162;1922;0;0;0;0;.00nan;0;0
17025;85661;1922;89;32;1;31;.969;3600000;0
17025;143829;586;0;0;0;0;.00nan;0;0
17026;7412;585;62;51;7;44;.863;3600000;0
17026;179950;563;99;23;0;23;1.000;3600000;0
17026;34168;563;0;0;0;0;.00nan;0;0
17026;35052;585;0;0;0;0;.00nan;0;0
17027;36571;1928;0;0;0;0;.00nan;0;0
17027;55285;1928;67;27;2;25;.926;3900000;0
17027;72514;1927;86;30;2;28;.933;3900000;0
17027;155943;1927;0;0;0;0;.00nan;0;0
17028;14191;2557;0;0;0;0;.00nan;0;0
17028;53936;2557;79;24;2;22;.917;3600000;0
17028;155769;583;57;33;4;29;.879;3583000;0
17028;161069;583;0;0;0;0;.00nan;0;0
17029;170037;567;88;19;0;19;1.000;3600000;0
17029;67625;567;0;0;0;0;.00nan;0;0
17029;155769;583;0;0;0;0;.00nan;0;0
17029;161069;583;71;40;3;37;.925;3600000;0
17030;1601;586;0;0;0;0;.00nan;0;0
17030;36571;1928;94;34;1;33;.971;3600000;0
17030;55285;1928;0;0;0;0;.00nan;0;0
17030;143829;586;71;31;2;29;.935;3558000;0
17031;13033;580;37;46;7;39;.848;3600000;0
17031;190423;1918;0;0;0;0;.00nan;0;0
17031;185744;1918;26;29;6;23;.793;3600000;0
17031;56653;580;0;0;0;0;.00nan;0;0
17032;13065;1925;29;34;6;28;.824;3600000;0
17032;14191;2557;0;0;0;0;.00nan;0;0
17032;40088;1925;0;0;0;0;.00nan;0;0
17032;53936;2557;91;22;0;22;1.000;3600000;0
17033;13041;2277;73;34;2;32;.941;2902000;0
17033;190423;1918;72;22;1;21;.955;3600000;0
17033;185744;1918;0;0;0;0;.00nan;0;0
17033;66790;2277;23;12;4;8;.667;698000;0
17034;13033;580;0;0;0;0;.00nan;0;0
17034;56653;580;97;43;3;40;.930;3900000;0
17034;155769;583;0;0;0;0;.00nan;0;0
17034;161069;583;73;33;3;30;.909;3900000;0
17035;179950;563;58;34;4;30;.882;3545000;0
17035;34168;563;0;0;0;0;.00nan;0;0
17035;36571;1928;63;22;3;19;.864;3600000;0
17035;55285;1928;0;0;0;0;.00nan;0;0
17036;170037;567;72;20;1;19;.950;3600000;0
17036;67625;567;0;0;0;0;.00nan;0;0
17036;72514;1927;0;0;0;0;.00nan;0;0
17036;155943;1927;72;47;4;43;.915;3600000;0
17037;7412;585;0;0;0;0;.00nan;0;0
17037;35052;585;38;29;5;24;.828;3517000;0
17037;67162;1922;0;0;0;0;.00nan;0;0
17037;85661;1922;64;26;3;23;.885;3600000;0
17039;14191;2557;0;0;0;0;.00nan;0;0
17039;36571;1928;61;26;3;23;.885;3600000;0
17039;53936;2557;55;32;4;28;.875;3564000;0
17039;55285;1928;0;0;0;0;.00nan;0;0
17041;19473;1918;66;15;0;15;1.000;1041000;0
17041;185744;1918;23;24;6;18;.750;2559000;0
17041;155769;583;0;0;0;0;.00nan;0;0
17041;161069;583;64;23;2;21;.913;3600000;0
17043;13065;1925;85;45;3;42;.933;3600000;0
17043;170037;567;61;14;1;13;.929;3600000;0
17043;40088;1925;0;0;0;0;.00nan;0;0
17043;67625;567;0;0;0;0;.00nan;0;0
17045;13033;586;62;19;2;17;.895;3600000;0
17045;13041;2277;69;22;1;21;.955;2748000;0
17045;66790;2277;22;16;4;12;.750;852000;0
17045;143829;586;0;0;0;0;.00nan;0;0
17047;19954;580;55;30;4;26;.867;3600000;0
17047;56653;580;0;0;0;0;.00nan;0;0
17047;72514;1927;0;0;0;0;.00nan;0;0
17047;155943;1927;68;21;1;20;.952;3600000;0
17049;7412;585;53;4;0;4;1.000;343000;0
17049;179950;563;40;12;3;9;.750;3600000;0
17049;34168;563;0;0;0;0;.00nan;0;0
17049;35052;585;39;36;6;30;.833;3257000;0
17051;19954;580;0;0;0;0;.00nan;0;0
17051;56653;580;63;27;2;25;.926;3900000;0
17051;155769;583;87;34;2;32;.941;3900000;0
17051;161069;583;0;0;0;0;.00nan;0;0
17053;13041;2277;0;0;0;0;.00nan;0;0
17053;13065;1925;0;0;0;0;.00nan;0;0
17053;40088;1925;61;37;5;32;.865;3551000;0
17053;66790;2277;49;35;4;31;.886;3600000;0
17055;6202;1922;0;0;0;0;.00nan;0;0
17055;67162;1922;76;35;3;32;.914;3600000;0
17055;72514;1927;70;36;4;32;.889;3552000;0
17055;155943;1927;0;0;0;0;.00nan;0;0
17057;19473;1918;82;39;3;36;.923;3662000;0
17057;170037;567;0;0;0;0;.00nan;0;0
17057;185744;1918;0;0;0;0;.00nan;0;0
17057;67625;567;54;19;2;17;.895;3662000;0
17059;179950;563;0;0;0;0;.00nan;0;0
17059;34168;563;84;44;3;41;.932;3600000;0
17059;36571;1928;0;0;0;0;.00nan;0;0
17059;55285;1928;33;19;5;14;.737;3516000;0
17061;7412;585;60;28;3;25;.893;3600000;0
17061;14191;2557;57;17;2;15;.882;3600000;0
17061;35052;585;0;0;0;0;.00nan;0;0
17061;53936;2557;0;0;0;0;.00nan;0;0
17063;13041;2277;0;0;0;0;.00nan;0;0
17063;36571;1928;36;26;5;21;.808;3600000;0
17063;55285;1928;0;0;0;0;.00nan;0;0
17063;66790;2277;89;33;1;32;.970;3600000;0
17065;19954;580;49;19;3;16;.842;3532000;0
17065;56653;580;0;0;0;0;.00nan;0;0
17065;155769;583;0;0;0;0;.00nan;0;0
17065;161069;583;100;43;1;42;.977;3600000;0
17067;14191;2557;80;49;4;45;.918;3600000;0
17067;19473;1918;0;0;0;0;.00nan;0;0
17067;185744;1918;58;27;3;24;.889;3600000;0
17067;53936;2557;0;0;0;0;.00nan;0;0
17069;13033;586;0;0;0;0;.00nan;0;0
17069;13065;1925;34;31;6;25;.806;3600000;0
17069;40088;1925;0;0;0;0;.00nan;0;0
17069;143829;586;87;27;1;26;.963;3600000;0
17071;170037;567;65;21;2;19;.905;3900000;0
17071;179950;563;100;46;2;44;.957;3900000;0
17071;34168;563;0;0;0;0;.00nan;0;0
17071;67625;567;0;0;0;0;.00nan;0;0
17073;6202;1922;41;24;5;19;.792;3691000;0
17073;67162;1922;0;0;0;0;.00nan;0;0
17073;72514;1927;0;0;0;0;.00nan;0;0
17073;155943;1927;65;35;4;31;.886;3691000;0
17075;36571;1928;0;0;0;0;.00nan;0;0
17075;55285;1928;59;31;3;28;.903;3900000;0
17075;72514;1927;66;30;3;27;.900;3900000;0
17075;155943;1927;0;0;0;0;.00nan;0;0
17077;13065;1925;0;0;0;0;.00nan;0;0
17077;179950;563;0;0;0;0;.00nan;0;0
17077;34168;563;44;24;3;21;.875;3600000;0
17077;40088;1925;78;13;0;13;1.000;3600000;0
17079;13041;2277;87;35;2;33;.943;3600000;0
17079;170037;567;0;0;0;0;.00nan;0;0
17079;66790;2277;0;0;0;0;.00nan;0;0
17079;67625;567;54;26;3;23;.885;3563000;0
17081;6202;1922;0;0;0;0;.00nan;0;0
17081;67162;1922;35;23;4;19;.826;3591000;0
17081;155769;583;77;35;3;32;.914;3600000;0
17081;161069;583;0;0;0;0;.00nan;0;0
17083;7412;585;0;0;0;0;.00nan;0;0
17083;13033;586;83;27;1;26;.963;3600000;0
17083;35052;585;84;36;2;34;.944;3592000;0
17083;143829;586;0;0;0;0;.00nan;0;0
17085;19473;1918;70;22;1;21;.955;3600000;0
17085;19954;580;0;0;0;0;.00nan;0;0
17085;185744;1918;0;0;0;0;.00nan;0;0
17085;56653;580;91;43;2;41;.953;3567000;0
17087;13041;2277;0;0;0;0;.00nan;0;0
17087;179950;563;68;30;3;27;.900;3600000;0
17087;34168;563;0;0;0;0;.00nan;0;0
17087;66790;2277;25;22;6;16;.727;3600000;0
17089;13065;1925;0;0;0;0;.00nan;0;0
17089;36571;1928;54;10;1;9;.900;3600000;0
17089;40088;1925;57;23;2;21;.913;3569000;0
17089;55285;1928;0;0;0;0;.00nan;0;0
17091;13033;586;86;35;2;33;.943;3600000;0
17091;170037;567;36;25;4;21;.840;3528000;0
17091;67625;567;0;0;0;0;.00nan;0;0
17091;143829;586;0;0;0;0;.00nan;0;0
17093;6202;1922;0;0;0;0;.00nan;0;0
17093;19954;580;82;44;3;41;.932;3780000;0
17093;56653;580;0;0;0;0;.00nan;0;0
17093;67162;1922;80;28;2;26;.929;3780000;0
17095;72514;1927;0;0;0;0;.00nan;0;0
17095;155769;583;0;0;0;0;.00nan;0;0
17095;155943;1927;66;23;2;21;.913;3600000;0
17095;161069;583;35;29;5;24;.828;3600000;0
17097;7412;585;0;0;0;0;.00nan;0;0
17097;14191;2557;72;25;2;23;.920;3900000;0
17097;35052;585;98;42;2;40;.952;3900000;0
17097;53936;2557;0;0;0;0;.00nan;0;0
17099;13041;2277;76;27;1;26;.963;3600000;0
17099;179950;563;0;0;0;0;.00nan;0;0
17099;34168;563;56;35;4;31;.886;3600000;0
17099;66790;2277;0;0;0;0;.00nan;0;0
17101;13065;1925;47;29;4;25;.862;3600000;0
17101;14191;2557;0;0;0;0;.00nan;0;0
17101;40088;1925;0;0;0;0;.00nan;0;0
17101;53936;2557;64;19;1;18;.947;3600000;0
17103;13033;586;0;0;0;0;.00nan;0;0
17103;36571;1928;0;0;0;0;.00nan;0;0
17103;55285;1928;66;34;3;31;.912;3563000;0
17103;143829;586;73;25;2;23;.920;3600000;0
17105;19954;580;0;0;0;0;.00nan;0;0
17105;56653;580;82;26;2;24;.923;3600000;0
17105;155769;583;58;26;3;23;.885;3557000;0
17105;161069;583;0;0;0;0;.00nan;0;0
17107;6202;1922;30;24;5;19;.792;3600000;0
17107;19473;1918;68;24;2;22;.917;3600000;0
17107;185744;1918;0;0;0;0;.00nan;0;0
17107;67162;1922;0;0;0;0;.00nan;0;0
17109;7412;585;67;31;3;28;.903;3600000;0
17109;35052;585;0;0;0;0;.00nan;0;0
17109;72514;1927;38;25;4;21;.840;3545000;0
17109;155943;1927;0;0;0;0;.00nan;0;0
17111;13065;1925;51;24;4;20;.833;3599000;0
17111;179950;563;82;29;2;27;.931;3600000;0
17111;34168;563;0;0;0;0;.00nan;0;0
17111;40088;1925;0;0;0;0;.00nan;0;0
17113;170037;567;63;13;1;12;.923;3600000;0
17113;67625;567;0;0;0;0;.00nan;0;0
17113;155769;583;0;0;0;0;.00nan;0;0
17113;161069;583;79;50;5;45;.900;3600000;0
17115;6202;1922;0;0;0;0;.00nan;0;0
17115;19473;1918;0;0;0;0;.00nan;0;0
17115;185744;1918;81;25;1;24;.960;3600000;0
17115;67162;1922;42;24;4;20;.833;3600000;0
17117;19954;580;57;38;5;33;.868;3600000;0
17117;36571;1928;70;22;2;20;.909;3600000;0
17117;55285;1928;0;0;0;0;.00nan;0;0
17117;56653;580;0;0;0;0;.00nan;0;0
17119;13041;2277;81;28;1;27;.964;3600000;0
17119;66790;2277;0;0;0;0;.00nan;0;0
17119;72514;1927;0;0;0;0;.00nan;0;0
17119;155943;1927;60;31;4;27;.871;3600000;0
17121;13033;586;0;0;0;0;.00nan;0;0
17121;14191;2557;60;36;5;31;.861;3600000;0
17121;53936;2557;0;0;0;0;.00nan;0;0
17121;143829;586;66;26;2;24;.923;3600000;0
1187;179950;563;30;26;6;20;.769;2559000;0
1187;34168;563;63;12;0;12;1.000;1041000;0
1187;72514;1927;0;0;0;0;.00nan;0;0
1187;155943;1927;60;30;3;27;.900;3600000;0
1188;13065;1925;55;41;5;36;.878;3546000;0
1188;14191;2557;0;0;0;0;.00nan;0;0
1188;40088;1925;0;0;0;0;.00nan;0;0
1188;53936;2557;46;27;4;23;.852;3600000;0
1189;179950;563;78;22;1;21;.955;3600000;0
1189;34168;563;0;0;0;0;.00nan;0;0
1189;72514;1927;0;0;0;0;.00nan;0;0
1189;155943;1927;44;41;6;35;.854;3600000;0
1190;13065;1925;84;32;2;30;.938;3600000;0
1190;14191;2557;0;0;0;0;.00nan;0;0
1190;40088;1925;0;0;0;0;.00nan;0;0
1190;53936;2557;57;31;3;28;.903;3544000;0
1331;179950;563;79;38;4;34;.895;3600000;0
1331;34168;563;0;0;0;0;.00nan;0;0
1331;72514;1927;0;0;0;0;.00nan;0;0
1331;155943;1927;23;24;6;18;.750;3566000;0
1332;13065;1925;55;28;3;25;.893;4083000;0
1332;14191;2557;0;0;0;0;.00nan;0;0
1332;40088;1925;0;0;0;0;.00nan;0;0
1332;53936;2557;72;40;4;36;.900;4083000;0
1423;170037;567;47;23;4;19;.826;3600000;0
1423;179950;563;36;29;6;23;.793;3002000;0
1423;34168;563;54;6;1;5;.833;598000;0
1423;67625;567;0;0;0;0;.00nan;0;0
1424;1601;586;0;0;0;0;.00nan;0;0
1424;143829;586;38;21;4;17;.810;3577000;0
1424;155769;583;0;0;0;0;.00nan;0;0
1424;161069;583;58;26;3;23;.885;3600000;0
1425;190423;1918;0;0;0;0;.00nan;0;0
1425;185744;1918;43;13;3;10;.769;3600000;0
1425;67162;1922;0;0;0;0;.00nan;0;0
1425;85661;1922;100;30;0;30;1.000;3600000;0
1426;13065;1925;47;37;6;31;.838;3600000;0
1426;36571;1928;63;23;2;21;.913;3600000;0
1426;40088;1925;0;0;0;0;.00nan;0;0
1426;55285;1928;0;0;0;0;.00nan;0;0
1427;170037;567;59;17;2;15;.882;3600000;0
1427;179950;563;88;50;3;47;.940;3600000;0
1427;34168;563;0;0;0;0;.00nan;0;0
1427;67625;567;0;0;0;0;.00nan;0;0
1428;1601;586;0;0;0;0;.00nan;0;0
1428;143829;586;82;21;1;20;.952;3600000;0
1428;155769;583;0;0;0;0;.00nan;0;0
1428;161069;583;65;28;3;25;.893;3588000;0
1429;190423;1918;0;0;0;0;.00nan;0;0
1429;185744;1918;50;37;5;32;.865;3549000;0
1429;67162;1922;0;0;0;0;.00nan;0;0
1429;85661;1922;98;49;3;46;.939;3600000;0
1430;13065;1925;93;53;3;50;.943;3543000;0
1430;36571;1928;59;14;2;12;.857;3600000;0
1430;40088;1925;0;0;0;0;.00nan;0;0
1430;55285;1928;0;0;0;0;.00nan;0;0
1431;170037;567;53;19;3;16;.842;3786000;0
1431;179950;563;92;58;4;54;.931;3786000;0
1431;34168;563;0;0;0;0;.00nan;0;0
1431;67625;567;0;0;0;0;.00nan;0;0
1432;1601;586;0;0;0;0;.00nan;0;0
1432;143829;586;79;21;1;20;.952;3600000;0
1432;155769;583;0;0;0;0;.00nan;0;0
1432;161069;583;64;37;4;33;.892;3600000;0
1433;190423;1918;0;0;0;0;.00nan;0;0
1433;185744;1918;92;35;1;34;.971;3600000;0
1433;67162;1922;0;0;0;0;.00nan;0;0
1433;85661;1922;30;28;6;22;.786;3600000;0
1434;13065;1925;86;36;2;34;.944;3594000;0
1434;36571;1928;76;25;1;24;.960;3600000;0
1434;40088;1925;0;0;0;0;.00nan;0;0
1434;55285;1928;0;0;0;0;.00nan;0;0
1629;1601;586;0;0;0;0;.00nan;0;0
1629;143829;586;93;40;2;38;.950;4406000;0
1629;155769;583;0;0;0;0;.00nan;0;0
1629;161069;583;86;38;1;37;.974;4406000;0
1630;190423;1918;0;0;0;0;.00nan;0;0
1630;185744;1918;71;30;2;28;.933;3600000;0
1630;67162;1922;0;0;0;0;.00nan;0;0
1630;85661;1922;74;33;3;30;.909;3588000;0
1689;1601;586;0;0;0;0;.00nan;0;0
1689;143829;586;72;24;1;23;.958;3600000;0
1689;155769;583;0;0;0;0;.00nan;0;0
1689;161069;583;37;38;6;32;.842;3600000;0
1690;190423;1918;0;0;0;0;.00nan;0;0
1690;185744;1918;100;31;0;31;1.000;3690000;0
1690;67162;1922;0;0;0;0;.00nan;0;0
1690;85661;1922;81;25;1;24;.960;3690000;0
1824;170037;567;48;16;3;13;.813;3573000;0
1824;190423;1918;0;0;0;0;.00nan;0;0
1824;185744;1918;89;39;2;37;.949;3600000;0
1824;67625;567;0;0;0;0;.00nan;0;0
1825;1601;586;0;0;0;0;.00nan;0;0
1825;36571;1928;67;30;3;27;.900;4067000;0
1825;55285;1928;0;0;0;0;.00nan;0;0
1825;143829;586;71;24;2;22;.917;4075000;0
1826;170037;567;61;30;3;27;.900;3565000;0
1826;190423;1918;0;0;0;0;.00nan;0;0
1826;185744;1918;82;35;2;33;.943;3600000;0
1826;67625;567;0;0;0;0;.00nan;0;0
1827;1601;586;0;0;0;0;.00nan;0;0
1827;36571;1928;47;32;5;27;.844;3600000;0
1827;55285;1928;0;0;0;0;.00nan;0;0
1827;143829;586;77;32;2;30;.938;3600000;0
1828;170037;567;89;27;1;26;.963;3600000;0
1828;190423;1918;0;0;0;0;.00nan;0;0
1828;185744;1918;51;29;4;25;.862;3600000;0
1828;67625;567;0;0;0;0;.00nan;0;0
1829;1601;586;56;5;0;5;1.000;269000;0
1829;36571;1928;69;24;2;22;.917;3600000;0
1829;55285;1928;0;0;0;0;.00nan;0;0
1829;143829;586;64;45;6;39;.867;3331000;0
1943;170037;567;57;19;2;17;.895;3600000;0
1943;190423;1918;56;10;1;9;.900;1142000;0
1943;185744;1918;55;39;6;33;.846;2458000;0
1943;67625;567;0;0;0;0;.00nan;0;0
1944;1601;586;0;0;0;0;.00nan;0;0
1944;36571;1928;69;28;2;26;.929;3516000;0
1944;55285;1928;0;0;0;0;.00nan;0;0
1944;143829;586;100;23;0;23;1.000;3600000;0
2000;170037;567;100;24;0;24;1.000;3600000;0
2000;190423;1918;0;0;0;0;.00nan;0;0
2000;185744;1918;63;45;5;40;.889;3600000;0
2000;67625;567;0;0;0;0;.00nan;0;0
2012;190423;1918;0;0;0;0;.00nan;0;0
2012;36571;1928;56;24;3;21;.875;3514000;0
2012;185744;1918;88;30;1;29;.967;3600000;0
2012;55285;1928;0;0;0;0;.00nan;0;0
2013;1601;586;52;8;1;7;.875;404000;0
2013;170037;567;57;24;3;21;.875;3600000;0
2013;67625;567;0;0;0;0;.00nan;0;0
2013;143829;586;26;34;7;27;.794;3196000;0
2014;1601;586;0;0;0;0;.00nan;0;0
2014;170037;567;59;24;3;21;.875;3600000;0
2014;67625;567;0;0;0;0;.00nan;0;0
2014;143829;586;52;45;6;39;.867;3600000;0
2015;1601;586;51;2;0;2;1.000;293000;0
2015;170037;567;99;28;0;28;1.000;3600000;0
2015;67625;567;0;0;0;0;.00nan;0;0
2015;143829;586;46;32;5;27;.844;3307000;0
2016;1601;586;0;0;0;0;.00nan;0;0
2016;170037;567;55;18;2;16;.889;3600000;0
2016;67625;567;0;0;0;0;.00nan;0;0
2016;143829;586;72;47;5;42;.894;3600000;0
17122;-1;1825;0;0;0;0;.00nan;0;0
17122;174806;1825;73;28;2;26;.929;3600000;0
17122;145838;5088;0;0;0;0;.00nan;0;0
17122;161336;5088;59;34;4;30;.882;3514000;0
17123;1838;644;42;21;4;17;.810;3585000;0
17123;51328;1809;0;0;0;0;.00nan;0;0
17123;61425;1809;69;26;2;24;.923;3600000;0
17123;61683;644;0;0;0;0;.00nan;0;0
17124;164404;1838;20;21;6;15;.714;2509000;0
17124;-1;1838;56;12;1;11;.917;1091000;0
17124;156632;626;80;30;2;28;.933;3600000;0
17124;160907;626;0;0;0;0;.00nan;0;0
17125;-1;648;50;27;4;23;.852;3550000;0
17125;-1;635;80;34;2;32;.941;3600000;0
17125;195761;635;0;0;0;0;.00nan;0;0
17125;-1;648;0;0;0;0;.00nan;0;0
17126;17625;651;73;18;1;17;.944;3600000;0
17126;-1;633;0;0;0;0;.00nan;0;0
17126;-1;633;62;24;2;22;.917;3576000;0
17126;58112;651;0;0;0;0;.00nan;0;0
17127;-1;632;0;0;0;0;.00nan;0;0
17127;-1;1847;0;0;0;0;.00nan;0;0
17127;82273;632;64;25;3;22;.880;3600000;0
17127;160577;1847;69;17;1;16;.941;3600000;0
17128;3435;4538;92;36;2;34;.944;3600000;0
17128;168926;638;48;38;5;33;.868;3600000;0
17128;190508;4538;0;0;0;0;.00nan;0;0
17128;55209;638;0;0;0;0;.00nan;0;0
17129;-1;632;0;0;0;0;.00nan;0;0
17129;51328;1809;0;0;0;0;.00nan;0;0
17129;61425;1809;87;34;2;32;.941;3600000;0
17129;82273;632;88;16;0;16;1.000;3600000;0
17130;-1;633;62;26;2;24;.923;3600000;0
17130;-1;633;0;0;0;0;.00nan;0;0
17130;145838;5088;0;0;0;0;.00nan;0;0
17130;161336;5088;44;37;6;31;.838;3600000;0
17131;-1;635;74;36;3;33;.917;4923000;0
17131;195761;635;0;0;0;0;.00nan;0;0
17131;156632;626;77;36;2;34;.944;4923000;0
17131;160907;626;0;0;0;0;.00nan;0;0
17132;3435;4538;59;24;3;21;.875;3600000;0
17132;-1;1825;0;0;0;0;.00nan;0;0
17132;174806;1825;41;24;4;20;.833;3549000;0
17132;190508;4538;0;0;0;0;.00nan;0;0
17133;168926;638;44;23;4;19;.826;3600000;0
17133;-1;1847;0;0;0;0;.00nan;0;0
17133;55209;638;0;0;0;0;.00nan;0;0
17133;160577;1847;53;38;5;33;.868;3553000;0
17134;164404;1838;84;48;4;44;.917;3600000;0
17134;17625;651;30;19;5;14;.737;3600000;0
17134;-1;1838;0;0;0;0;.00nan;0;0
17134;58112;651;0;0;0;0;.00nan;0;0
17135;1838;644;71;35;2;33;.943;3600000;0
17135;-1;648;56;36;4;32;.889;3513000;0
17135;-1;648;0;0;0;0;.00nan;0;0
17135;61683;644;0;0;0;0;.00nan;0;0
17136;-1;632;0;0;0;0;.00nan;0;0
17136;82273;632;84;29;2;27;.931;3561000;0
17136;145838;5088;0;0;0;0;.00nan;0;0
17136;161336;5088;78;23;1;22;.957;3600000;0
17137;-1;635;57;30;3;27;.900;3570000;0
17137;195761;635;0;0;0;0;.00nan;0;0
17137;51328;1809;0;0;0;0;.00nan;0;0
17137;61425;1809;69;24;2;22;.917;3600000;0
17138;-1;1825;0;0;0;0;.00nan;0;0
17138;174806;1825;86;24;1;23;.958;3600000;0
17138;156632;626;78;29;2;27;.931;3569000;0
17138;160907;626;0;0;0;0;.00nan;0;0
17139;164404;1838;69;27;3;24;.889;3584000;0
17139;-1;1838;0;0;0;0;.00nan;0;0
17139;-1;648;0;0;0;0;.00nan;0;0
17139;-1;648;82;30;2;28;.933;3600000;0
17140;17625;651;53;26;3;23;.885;3579000;0
17140;168926;638;91;36;2;34;.944;3600000;0
17140;55209;638;0;0;0;0;.00nan;0;0
17140;58112;651;0;0;0;0;.00nan;0;0
17141;1838;644;68;39;4;35;.897;3600000;0
17141;-1;1847;46;9;1;8;.889;738000;0
17141;61683;644;0;0;0;0;.00nan;0;0
17141;160577;1847;25;24;6;18;.750;2862000;0
17142;3435;4538;56;39;6;33;.846;3600000;0
17142;-1;633;61;30;3;27;.900;3600000;0
17142;190508;4538;0;0;0;0;.00nan;0;0
17142;-1;633;0;0;0;0;.00nan;0;0
17143;-1;632;0;0;0;0;.00nan;0;0
17143;82273;632;82;31;2;29;.935;3881000;0
17143;156632;626;78;35;3;32;.914;3881000;0
17143;160907;626;0;0;0;0;.00nan;0;0
17144;-1;633;72;24;2;22;.917;4041000;0
17144;-1;1847;0;0;0;0;.00nan;0;0
17144;-1;633;0;0;0;0;.00nan;0;0
17144;160577;1847;66;34;3;31;.912;4041000;0
17145;3435;4538;64;27;3;24;.889;3817000;0
17145;-1;635;52;27;4;23;.852;3817000;0
17145;195761;635;0;0;0;0;.00nan;0;0
17145;190508;4538;0;0;0;0;.00nan;0;0
17146;-1;648;86;47;3;44;.936;4675000;0
17146;-1;1825;69;38;4;34;.895;4675000;0
17146;174806;1825;0;0;0;0;.00nan;0;0
17146;-1;648;0;0;0;0;.00nan;0;0
17147;168926;638;99;33;1;32;.970;3600000;0
17147;55209;638;0;0;0;0;.00nan;0;0
17147;145838;5088;0;0;0;0;.00nan;0;0
17147;161336;5088;48;41;5;36;.878;3600000;0
17148;1838;644;82;50;4;46;.920;3568000;0
17148;17625;651;65;25;2;23;.920;3600000;0
17148;58112;651;0;0;0;0;.00nan;0;0
17148;61683;644;0;0;0;0;.00nan;0;0
17149;164404;1838;0;0;0;0;.00nan;0;0
17149;-1;1838;82;20;0;20;1.000;3600000;0
17149;51328;1809;0;0;0;0;.00nan;0;0
17149;61425;1809;57;28;3;25;.893;3600000;0
17150;-1;632;0;0;0;0;.00nan;0;0
17150;-1;633;91;31;2;29;.935;3535000;0
17150;-1;633;0;0;0;0;.00nan;0;0
17150;82273;632;100;24;0;24;1.000;3600000;0
17151;164404;1838;0;0;0;0;.00nan;0;0
17151;-1;1838;42;23;3;20;.870;3565000;0
17151;145838;5088;0;0;0;0;.00nan;0;0
17151;161336;5088;91;32;2;30;.938;3600000;0
17152;17625;651;56;17;2;15;.882;3600000;0
17152;51328;1809;50;34;5;29;.853;3600000;0
17152;58112;651;0;0;0;0;.00nan;0;0
17152;61425;1809;0;0;0;0;.00nan;0;0
17153;168926;638;81;41;2;39;.951;4580000;0
17153;55209;638;0;0;0;0;.00nan;0;0
17153;156632;626;87;38;1;37;.974;4580000;0
17153;160907;626;0;0;0;0;.00nan;0;0
17154;-1;635;56;21;3;18;.857;3600000;0
17154;195761;635;0;0;0;0;.00nan;0;0
17154;-1;1847;50;28;5;23;.821;3541000;0
17154;160577;1847;0;0;0;0;.00nan;0;0
17155;3435;4538;63;39;5;34;.872;3530000;0
17155;-1;648;83;41;3;38;.927;3600000;0
17155;190508;4538;0;0;0;0;.00nan;0;0
17155;-1;648;0;0;0;0;.00nan;0;0
17156;1838;644;32;31;6;25;.806;3071000;0
17156;-1;1825;56;27;3;24;.889;2432000;0
17156;174806;1825;24;13;4;9;.692;1168000;0
17156;61683;644;58;5;0;5;1.000;529000;0
17157;-1;633;0;0;0;0;.00nan;0;0
17157;-1;633;54;21;3;18;.857;3569000;0
17157;156632;626;84;43;2;41;.953;3600000;0
17157;160907;626;0;0;0;0;.00nan;0;0
17158;-1;648;73;23;1;22;.957;3600000;0
17158;-1;648;0;0;0;0;.00nan;0;0
17158;145838;5088;0;0;0;0;.00nan;0;0
17158;161336;5088;81;40;3;37;.925;3536000;0
17159;-1;632;0;0;0;0;.00nan;0;0
17159;-1;635;0;0;0;0;.00nan;0;0
17159;195761;635;97;40;1;39;.975;3600000;0
17159;82273;632;66;29;2;27;.931;3559000;0
17160;-1;1825;0;0;0;0;.00nan;0;0
17160;174806;1825;42;25;4;21;.840;3547000;0
17160;51328;1809;0;0;0;0;.00nan;0;0
17160;61425;1809;75;30;2;28;.933;3600000;0
17161;3435;4538;87;57;3;54;.947;3600000;0
17161;17625;651;0;0;0;0;.00nan;0;0
17161;190508;4538;0;0;0;0;.00nan;0;0
17161;58112;651;100;22;0;22;1.000;3600000;0
17162;1838;644;58;27;3;24;.889;3600000;0
17162;168926;638;80;24;2;22;.917;3600000;0
17162;55209;638;0;0;0;0;.00nan;0;0
17162;61683;644;0;0;0;0;.00nan;0;0
17163;164404;1838;81;23;1;22;.957;3600000;0
17163;-1;1838;0;0;0;0;.00nan;0;0
17163;-1;1847;63;16;1;15;.938;1584000;0
17163;160577;1847;23;27;6;21;.778;2016000;0
17164;-1;632;0;0;0;0;.00nan;0;0
17164;168926;638;74;23;1;22;.957;3600000;0
17164;55209;638;0;0;0;0;.00nan;0;0
17164;82273;632;56;26;3;23;.885;3599000;0
17165;-1;648;86;32;2;30;.938;3600000;0
17165;-1;648;0;0;0;0;.00nan;0;0
17165;51328;1809;0;0;0;0;.00nan;0;0
17165;61425;1809;74;19;1;18;.947;3600000;0
17166;17625;651;0;0;0;0;.00nan;0;0
17166;58112;651;87;14;0;14;1.000;3600000;0
17166;156632;626;64;31;3;28;.903;3195000;0
17166;160907;626;29;8;3;5;.625;405000;0
17167;-1;635;76;25;1;24;.960;3600000;0
17167;-1;1825;0;0;0;0;.00nan;0;0
17167;174806;1825;53;28;3;25;.893;3513000;0
17167;195761;635;0;0;0;0;.00nan;0;0
17168;3435;4538;83;26;1;25;.962;3600000;0
17168;-1;1847;31;9;3;6;.667;1451000;0
17168;190508;4538;0;0;0;0;.00nan;0;0
17168;160577;1847;34;34;6;28;.824;2149000;0
17169;164404;1838;0;0;0;0;.00nan;0;0
17169;-1;1838;91;41;1;40;.976;4540000;0
17169;-1;633;71;28;2;26;.929;4540000;0
17169;-1;633;0;0;0;0;.00nan;0;0
17170;1838;644;62;30;4;26;.867;4023000;0
17170;61683;644;0;0;0;0;.00nan;0;0
17170;145838;5088;0;0;0;0;.00nan;0;0
17170;161336;5088;85;37;3;34;.919;4023000;0
17171;164404;1838;70;31;2;29;.935;3540000;0
17171;-1;632;0;0;0;0;.00nan;0;0
17171;-1;1838;0;0;0;0;.00nan;0;0
17171;82273;632;100;24;0;24;1.000;3600000;0
17172;3435;4538;89;30;1;29;.967;3625000;0
17172;190508;4538;0;0;0;0;.00nan;0;0
17172;145838;5088;67;22;2;20;.909;3625000;0
17172;161336;5088;0;0;0;0;.00nan;0;0
17173;51328;1809;0;0;0;0;.00nan;0;0
17173;61425;1809;64;47;4;43;.915;3600000;0
17173;156632;626;100;17;0;17;1.000;3600000;0
17173;160907;626;0;0;0;0;.00nan;0;0
17174;17625;651;0;0;0;0;.00nan;0;0
17174;-1;635;71;40;4;36;.900;3515000;0
17174;195761;635;0;0;0;0;.00nan;0;0
17174;58112;651;66;24;2;22;.917;3600000;0
17175;168926;638;8;24;7;17;.708;3356000;0
17175;-1;1825;0;0;0;0;.00nan;0;0
17175;174806;1825;49;30;5;25;.833;3600000;0
17175;55209;638;50;1;0;1;1.000;244000;0
17176;-1;648;47;20;3;17;.850;3563000;0
17176;-1;1847;91;34;1;33;.971;3600000;0
17176;-1;648;0;0;0;0;.00nan;0;0
17176;160577;1847;0;0;0;0;.00nan;0;0
17177;1838;644;0;0;0;0;.00nan;0;0
17177;-1;633;72;27;2;25;.926;3600000;0
17177;-1;633;0;0;0;0;.00nan;0;0
17177;61683;644;34;41;7;34;.829;3600000;0
17178;-1;1825;0;0;0;0;.00nan;0;0
17178;174806;1825;78;34;2;32;.941;3546000;0
17178;-1;633;0;0;0;0;.00nan;0;0
17178;-1;633;87;28;1;27;.964;3600000;0
17179;-1;1847;0;0;0;0;.00nan;0;0
17179;156632;626;54;23;4;19;.826;3938000;0
17179;160577;1847;39;29;5;24;.828;3938000;0
17179;160907;626;0;0;0;0;.00nan;0;0
17180;-1;632;0;0;0;0;.00nan;0;0
17180;-1;648;79;37;3;34;.919;3803000;0
17180;-1;648;0;0;0;0;.00nan;0;0
17180;82273;632;70;29;2;27;.931;3803000;0
17181;17625;651;0;0;0;0;.00nan;0;0
17181;58112;651;79;10;0;10;1.000;3600000;0
17181;145838;5088;0;0;0;0;.00nan;0;0
17181;161336;5088;60;47;5;42;.894;3600000;0
17182;168926;638;0;0;0;0;.00nan;0;0
17182;-1;635;98;37;1;36;.973;3600000;0
17182;195761;635;0;0;0;0;.00nan;0;0
17182;55209;638;61;22;2;20;.909;3574000;0
17183;1838;644;94;23;0;23;1.000;3600000;0
17183;164404;1838;0;0;0;0;.00nan;0;0
17183;-1;1838;60;24;2;22;.917;3539000;0
17183;61683;644;0;0;0;0;.00nan;0;0
17184;3435;4538;87;25;1;24;.960;2709000;0
17184;190508;4538;15;10;5;5;.500;813000;0
17184;51328;1809;0;0;0;0;.00nan;0;0
17184;61425;1809;49;29;4;25;.862;3600000;0
17185;164404;1838;62;25;2;23;.920;3600000;0
17185;-1;1838;0;0;0;0;.00nan;0;0
17185;156632;626;84;50;5;45;.900;3600000;0
17185;160907;626;0;0;0;0;.00nan;0;0
17186;3435;4538;96;31;1;30;.968;3600000;0
17186;-1;632;0;0;0;0;.00nan;0;0
17186;190508;4538;0;0;0;0;.00nan;0;0
17186;82273;632;43;17;3;14;.824;3553000;0
17187;145838;5088;0;0;0;0;.00nan;0;0
17187;156632;626;79;31;2;29;.935;3600000;0
17187;160907;626;0;0;0;0;.00nan;0;0
17187;161336;5088;61;34;4;30;.882;3528000;0
17188;17625;651;42;16;3;13;.813;3600000;0
17188;-1;648;55;46;6;40;.870;3600000;0
17188;-1;648;0;0;0;0;.00nan;0;0
17188;58112;651;0;0;0;0;.00nan;0;0
17189;1838;644;58;23;2;21;.913;3600000;0
17189;-1;635;96;37;1;36;.973;3600000;0
17189;195761;635;0;0;0;0;.00nan;0;0
17189;61683;644;0;0;0;0;.00nan;0;0
17190;164404;1838;24;22;6;16;.727;3600000;0
17190;-1;1838;0;0;0;0;.00nan;0;0
17190;-1;1825;0;0;0;0;.00nan;0;0
17190;174806;1825;63;29;3;26;.897;3600000;0
17191;168926;638;92;40;3;37;.925;3600000;0
17191;-1;633;0;0;0;0;.00nan;0;0
17191;-1;633;33;31;6;25;.806;3600000;0
17191;55209;638;0;0;0;0;.00nan;0;0
17192;-1;1847;68;35;3;32;.914;3543000;0
17192;51328;1809;0;0;0;0;.00nan;0;0
17192;61425;1809;92;45;2;43;.956;3600000;0
17192;160577;1847;0;0;0;0;.00nan;0;0
17193;-1;1847;0;0;0;0;.00nan;0;0
17193;145838;5088;0;0;0;0;.00nan;0;0
17193;160577;1847;28;30;6;24;.800;3565000;0
17193;161336;5088;65;33;4;29;.879;3600000;0
17194;-1;648;83;35;2;33;.943;3600000;0
17194;-1;633;0;0;0;0;.00nan;0;0
17194;-1;633;72;31;3;28;.903;3585000;0
17194;-1;648;0;0;0;0;.00nan;0;0
17195;168926;638;73;29;2;27;.931;3600000;0
17195;51328;1809;0;0;0;0;.00nan;0;0
17195;55209;638;0;0;0;0;.00nan;0;0
17195;61425;1809;72;35;3;32;.914;3543000;0
17196;17625;651;53;2;0;2;1.000;371000;0
17196;-1;1825;0;0;0;0;.00nan;0;0
17196;174806;1825;68;40;5;35;.875;3600000;0
17196;58112;651;14;28;8;20;.714;3229000;0
17197;164404;1838;0;0;0;0;.00nan;0;0
17197;-1;1838;31;31;6;25;.806;3600000;0
17197;-1;635;64;21;1;20;.952;3600000;0
17197;195761;635;0;0;0;0;.00nan;0;0
17198;3435;4538;97;22;0;22;1.000;3600000;0
17198;190508;4538;0;0;0;0;.00nan;0;0
17198;156632;626;74;28;2;26;.929;3559000;0
17198;160907;626;0;0;0;0;.00nan;0;0
17199;1838;644;99;32;1;31;.969;3600000;0
17199;-1;632;0;0;0;0;.00nan;0;0
17199;61683;644;0;0;0;0;.00nan;0;0
17199;82273;632;76;33;2;31;.939;3543000;0
17200;-1;635;63;34;4;30;.882;3600000;0
17200;195761;635;0;0;0;0;.00nan;0;0
17200;145838;5088;100;31;0;31;1.000;3600000;0
17200;161336;5088;0;0;0;0;.00nan;0;0
17201;-1;633;58;18;2;16;.889;3600000;0
17201;-1;633;0;0;0;0;.00nan;0;0
17201;51328;1809;0;0;0;0;.00nan;0;0
17201;61425;1809;58;50;7;43;.860;3600000;0
17202;1838;644;90;48;3;45;.938;5989000;0
17202;61683;644;0;0;0;0;.00nan;0;0
17202;156632;626;83;46;2;44;.957;5989000;0
17202;160907;626;0;0;0;0;.00nan;0;0
17203;168926;638;89;27;1;26;.963;3600000;0
17203;-1;648;46;38;5;33;.868;3600000;0
17203;-1;648;0;0;0;0;.00nan;0;0
17203;55209;638;0;0;0;0;.00nan;0;0
17204;-1;1825;100;23;0;23;1.000;3600000;0
17204;174806;1825;0;0;0;0;.00nan;0;0
17204;-1;1847;69;30;2;28;.933;3529000;0
17204;160577;1847;0;0;0;0;.00nan;0;0
17205;-1;632;0;0;0;0;.00nan;0;0
17205;17625;651;69;32;3;29;.906;3600000;0
17205;58112;651;0;0;0;0;.00nan;0;0
17205;82273;632;44;36;6;30;.833;3600000;0
17206;3435;4538;67;36;4;32;.889;3600000;0
17206;164404;1838;100;32;0;32;1.000;3600000;0
17206;-1;1838;0;0;0;0;.00nan;0;0
17206;190508;4538;0;0;0;0;.00nan;0;0
17207;-1;632;0;0;0;0;.00nan;0;0
17207;-1;1847;0;0;0;0;.00nan;0;0
17207;82273;632;97;22;0;22;1.000;3600000;0
17207;160577;1847;71;52;5;47;.904;3600000;0
17208;17625;651;0;0;0;0;.00nan;0;0
17208;-1;633;88;36;1;35;.972;3241000;0
17208;-1;633;22;4;3;1;.250;276000;0
17208;58112;651;52;18;2;16;.889;3600000;0
17209;-1;648;61;36;4;32;.889;3557000;0
17209;-1;635;0;0;0;0;.00nan;0;0
17209;195761;635;65;26;2;24;.923;3600000;0
17209;-1;648;0;0;0;0;.00nan;0;0
17210;-1;1825;23;17;5;12;.706;3874000;0
17210;174806;1825;0;0;0;0;.00nan;0;0
17210;145838;5088;62;37;4;33;.892;3874000;0
17210;161336;5088;0;0;0;0;.00nan;0;0
17211;3435;4538;47;26;4;22;.846;3582000;0
17211;168926;638;54;19;3;16;.842;3600000;0
17211;190508;4538;0;0;0;0;.00nan;0;0
17211;55209;638;0;0;0;0;.00nan;0;0
17212;1838;644;78;38;3;35;.921;3600000;0
17212;51328;1809;0;0;0;0;.00nan;0;0
17212;61425;1809;43;35;5;30;.857;3588000;0
17212;61683;644;0;0;0;0;.00nan;0;0
17213;-1;632;0;0;0;0;.00nan;0;0
17213;82273;632;73;25;1;24;.960;3600000;0
17213;145838;5088;0;0;0;0;.00nan;0;0
17213;161336;5088;38;23;5;18;.783;3600000;0
17214;3435;4538;79;39;3;36;.923;3600000;0
17214;-1;633;34;23;4;19;.826;3579000;0
17214;190508;4538;0;0;0;0;.00nan;0;0
17214;-1;633;0;0;0;0;.00nan;0;0
17215;-1;635;72;27;1;26;.963;3802000;0
17215;195761;635;0;0;0;0;.00nan;0;0
17215;51328;1809;0;0;0;0;.00nan;0;0
17215;61425;1809;73;27;2;25;.926;3802000;0
17216;-1;1825;0;0;0;0;.00nan;0;0
17216;174806;1825;54;43;6;37;.860;3600000;0
17216;156632;626;100;19;0;19;1.000;3600000;0
17216;160907;626;0;0;0;0;.00nan;0;0
17217;17625;651;63;19;2;17;.895;3600000;0
17217;168926;638;41;37;6;31;.838;3272000;0
17217;55209;638;52;4;0;4;1.000;328000;0
17217;58112;651;0;0;0;0;.00nan;0;0
17218;164404;1838;78;27;2;25;.926;3600000;0
17218;-1;1838;0;0;0;0;.00nan;0;0
17218;-1;648;40;24;4;20;.833;2135000;0
17218;-1;648;48;12;2;10;.833;1465000;0
17219;1838;644;98;27;1;26;.963;3600000;0
17219;-1;1847;0;0;0;0;.00nan;0;0
17219;61683;644;0;0;0;0;.00nan;0;0
17219;160577;1847;85;34;2;32;.941;3570000;0
17220;168926;638;49;15;2;13;.867;3600000;0
17220;55209;638;0;0;0;0;.00nan;0;0
17220;145838;5088;0;0;0;0;.00nan;0;0
17220;161336;5088;62;35;4;31;.886;3570000;0
17221;164404;1838;62;29;3;26;.897;3600000;0
17221;-1;1838;0;0;0;0;.00nan;0;0
17221;51328;1809;0;0;0;0;.00nan;0;0
17221;61425;1809;94;24;0;24;1.000;3600000;0
17222;-1;632;0;0;0;0;.00nan;0;0
17222;82273;632;63;24;3;21;.875;5808000;0
17222;156632;626;62;51;4;47;.922;5808000;0
17222;160907;626;0;0;0;0;.00nan;0;0
17223;-1;648;51;12;2;10;.833;1561000;0
17223;-1;1825;0;0;0;0;.00nan;0;0
17223;174806;1825;67;26;2;24;.923;3600000;0
17223;-1;648;40;31;6;25;.806;2039000;0
17224;1838;644;21;24;6;18;.750;2386000;0
17224;17625;651;0;0;0;0;.00nan;0;0
17224;58112;651;100;24;0;24;1.000;3600000;0
17224;61683;644;48;15;2;13;.867;1214000;0
17225;-1;633;39;34;6;28;.824;3600000;0
17225;-1;1847;69;14;0;14;1.000;2426000;0
17225;-1;633;0;0;0;0;.00nan;0;0
17225;160577;1847;17;13;5;8;.615;1174000;0
17226;3435;4538;76;38;4;34;.895;5278000;0
17226;-1;635;68;38;3;35;.921;5278000;0
17226;195761;635;0;0;0;0;.00nan;0;0
17226;190508;4538;0;0;0;0;.00nan;0;0
17227;51328;1809;0;0;0;0;.00nan;0;0
17227;61425;1809;68;27;3;24;.889;3600000;0
17227;145838;5088;0;0;0;0;.00nan;0;0
17227;161336;5088;28;29;6;23;.793;3600000;0
17228;-1;632;0;0;0;0;.00nan;0;0
17228;-1;633;0;0;0;0;.00nan;0;0
17228;-1;633;43;28;4;24;.857;3600000;0
17228;82273;632;89;18;0;18;1.000;3600000;0
17229;3435;4538;76;41;4;37;.902;3600000;0
17229;-1;648;62;18;1;17;.944;3600000;0
17229;190508;4538;0;0;0;0;.00nan;0;0
17229;-1;648;0;0;0;0;.00nan;0;0
17230;-1;635;74;28;2;26;.929;3661000;0
17230;195761;635;0;0;0;0;.00nan;0;0
17230;-1;1847;0;0;0;0;.00nan;0;0
17230;160577;1847;58;27;3;24;.889;3661000;0
17231;1838;644;84;43;3;40;.930;4462000;0
17231;-1;1825;69;26;2;24;.923;4462000;0
17231;174806;1825;0;0;0;0;.00nan;0;0
17231;61683;644;0;0;0;0;.00nan;0;0
17232;17625;651;64;17;1;16;.941;3600000;0
17232;51328;1809;0;0;0;0;.00nan;0;0
17232;58112;651;0;0;0;0;.00nan;0;0
17232;61425;1809;84;49;4;45;.918;3600000;0
17233;168926;638;66;32;4;28;.875;3657000;0
17233;55209;638;0;0;0;0;.00nan;0;0
17233;156632;626;75;36;3;33;.917;3657000;0
17233;160907;626;0;0;0;0;.00nan;0;0
17234;164404;1838;0;0;0;0;.00nan;0;0
17234;-1;1838;66;27;3;24;.889;3600000;0
17234;145838;5088;0;0;0;0;.00nan;0;0
17234;161336;5088;45;42;6;36;.857;3600000;0
17235;-1;632;0;0;0;0;.00nan;0;0
17235;-1;635;54;24;3;21;.875;3563000;0
17235;195761;635;0;0;0;0;.00nan;0;0
17235;82273;632;61;19;2;17;.895;3600000;0
17236;-1;648;68;23;2;21;.913;3600000;0
17236;-1;648;0;0;0;0;.00nan;0;0
17236;145838;5088;60;39;4;35;.897;3600000;0
17236;161336;5088;0;0;0;0;.00nan;0;0
17237;-1;1825;0;0;0;0;.00nan;0;0
17237;174806;1825;66;21;1;20;.952;3578000;0
17237;51328;1809;100;24;0;24;1.000;3600000;0
17237;61425;1809;0;0;0;0;.00nan;0;0
17238;-1;633;77;30;2;28;.933;3600000;0
17238;-1;633;0;0;0;0;.00nan;0;0
17238;156632;626;0;0;0;0;.00nan;0;0
17238;160907;626;60;28;3;25;.893;3599000;0
17239;164404;1838;66;30;3;27;.900;3600000;0
17239;-1;1838;0;0;0;0;.00nan;0;0
17239;-1;1847;0;0;0;0;.00nan;0;0
17239;160577;1847;53;40;5;35;.875;3542000;0
17240;3435;4538;89;55;6;49;.891;3600000;0
17240;17625;651;57;25;3;22;.880;3600000;0
17240;190508;4538;0;0;0;0;.00nan;0;0
17240;58112;651;0;0;0;0;.00nan;0;0
17241;1838;644;0;0;0;0;.00nan;0;0
17241;168926;638;58;26;3;23;.885;3550000;0
17241;55209;638;0;0;0;0;.00nan;0;0
17241;61683;644;86;40;2;38;.950;3600000;0
17242;1838;644;77;28;1;27;.964;3600000;0
17242;61683;644;0;0;0;0;.00nan;0;0
17242;145838;5088;0;0;0;0;.00nan;0;0
17242;161336;5088;40;32;6;26;.813;3600000;0
17243;164404;1838;59;30;3;27;.900;3553000;0
17243;-1;1838;0;0;0;0;.00nan;0;0
17243;-1;633;0;0;0;0;.00nan;0;0
17243;-1;633;95;40;2;38;.950;3600000;0
17244;-1;635;39;30;5;25;.833;3600000;0
17244;-1;1825;0;0;0;0;.00nan;0;0
17244;174806;1825;100;25;0;25;1.000;3600000;0
17244;195761;635;0;0;0;0;.00nan;0;0
17245;17625;651;0;0;0;0;.00nan;0;0
17245;58112;651;73;8;0;8;1.000;3600000;0
17245;156632;626;91;38;2;36;.947;3580000;0
17245;160907;626;0;0;0;0;.00nan;0;0
17246;-1;632;0;0;0;0;.00nan;0;0
17246;168926;638;50;35;4;31;.886;3566000;0
17246;55209;638;0;0;0;0;.00nan;0;0
17246;82273;632;83;27;2;25;.926;3600000;0
17247;3435;4538;88;39;3;36;.923;5019000;0
17247;-1;1847;0;0;0;0;.00nan;0;0
17247;190508;4538;0;0;0;0;.00nan;0;0
17247;160577;1847;86;37;2;35;.946;5019000;0
17248;-1;632;75;28;2;26;.929;3600000;0
17248;-1;1825;0;0;0;0;.00nan;0;0
17248;174806;1825;53;37;5;32;.865;3600000;0
17248;82273;632;0;0;0;0;.00nan;0;0
17249;51328;1809;73;28;2;26;.929;3600000;0
17249;61425;1809;0;0;0;0;.00nan;0;0
17249;145838;5088;0;0;0;0;.00nan;0;0
17249;161336;5088;39;30;5;25;.833;3600000;0
17250;-1;648;57;27;2;25;.926;3570000;0
17250;-1;648;0;0;0;0;.00nan;0;0
17250;156632;626;100;27;0;27;1.000;3600000;0
17250;160907;626;0;0;0;0;.00nan;0;0
17251;-1;635;88;50;3;47;.940;4347000;0
17251;195761;635;0;0;0;0;.00nan;0;0
17251;-1;633;0;0;0;0;.00nan;0;0
17251;-1;633;79;32;2;30;.938;4347000;0
17252;17625;651;0;0;0;0;.00nan;0;0
17252;-1;1847;0;0;0;0;.00nan;0;0
17252;58112;651;51;13;2;11;.846;3600000;0
17252;160577;1847;79;53;4;49;.925;3583000;0
17253;164404;1838;0;0;0;0;.00nan;0;0
17253;168926;638;51;30;5;25;.833;3567000;0
17253;-1;1838;59;26;3;23;.885;3600000;0
17253;55209;638;0;0;0;0;.00nan;0;0
17254;1838;644;67;19;1;18;.947;3600000;0
17254;3435;4538;83;44;2;42;.955;3552000;0
17254;190508;4538;0;0;0;0;.00nan;0;0
17254;61683;644;0;0;0;0;.00nan;0;0
17255;-1;648;0;0;0;0;.00nan;0;0
17255;-1;648;57;27;3;24;.889;3600000;0
17255;51328;1809;0;0;0;0;.00nan;0;0
17255;61425;1809;48;33;5;28;.848;3600000;0
17256;168926;638;65;19;2;17;.895;3600000;0
17256;55209;638;0;0;0;0;.00nan;0;0
17256;156632;626;58;21;3;18;.857;3578000;0
17256;160907;626;0;0;0;0;.00nan;0;0
17257;1838;644;52;23;3;20;.870;3600000;0
17257;-1;633;31;19;4;15;.789;3546000;0
17257;-1;633;0;0;0;0;.00nan;0;0
17257;61683;644;0;0;0;0;.00nan;0;0
17258;51328;1809;0;0;0;0;.00nan;0;0
17258;61425;1809;40;35;6;29;.829;3600000;0
17258;156632;626;78;23;1;22;.957;3600000;0
17258;160907;626;0;0;0;0;.00nan;0;0
17259;-1;648;35;21;4;17;.810;3600000;0
17259;-1;1847;0;0;0;0;.00nan;0;0
17259;-1;648;0;0;0;0;.00nan;0;0
17259;160577;1847;70;29;3;26;.897;3600000;0
17260;17625;651;89;16;0;16;1.000;3600000;0
17260;-1;635;78;43;4;39;.907;3600000;0
17260;195761;635;0;0;0;0;.00nan;0;0
17260;58112;651;0;0;0;0;.00nan;0;0
17261;168926;638;14;20;6;14;.700;2192000;0
17261;-1;1825;0;0;0;0;.00nan;0;0
17261;174806;1825;45;31;5;26;.839;3600000;0
17261;55209;638;49;8;1;7;.875;1356000;0
17262;164404;1838;52;13;2;11;.846;3600000;0
17262;-1;632;48;0;0;0;.00nan;371000;0
17262;-1;1838;0;0;0;0;.00nan;0;0
17262;82273;632;31;29;6;23;.793;3229000;0
17263;3435;4538;73;35;3;32;.914;3600000;0
17263;190508;4538;0;0;0;0;.00nan;0;0
17263;145838;5088;0;0;0;0;.00nan;0;0
17263;161336;5088;64;32;4;28;.875;3545000;0
17264;-1;632;0;0;0;0;.00nan;0;0
17264;-1;648;73;41;4;37;.902;3565000;0
17264;-1;648;0;0;0;0;.00nan;0;0
17264;82273;632;52;21;3;18;.857;3600000;0
17265;17625;651;85;30;1;29;.967;3600000;0
17265;58112;651;0;0;0;0;.00nan;0;0
17265;145838;5088;64;41;4;37;.902;3600000;0
17265;161336;5088;0;0;0;0;.00nan;0;0
17266;3435;4538;77;37;3;34;.919;3592000;0
17266;190508;4538;0;0;0;0;.00nan;0;0
17266;51328;1809;0;0;0;0;.00nan;0;0
17266;61425;1809;87;28;1;27;.964;3600000;0
17267;168926;638;81;29;1;28;.966;3600000;0
17267;-1;635;0;0;0;0;.00nan;0;0
17267;195761;635;64;31;3;28;.903;3539000;0
17267;55209;638;0;0;0;0;.00nan;0;0
17268;-1;1825;56;20;2;18;.900;3600000;0
17268;174806;1825;0;0;0;0;.00nan;0;0
17268;-1;633;57;29;3;26;.897;3600000;0
17268;-1;633;0;0;0;0;.00nan;0;0
17269;-1;1847;0;0;0;0;.00nan;0;0
17269;156632;626;80;16;1;15;.938;3600000;0
17269;160577;1847;72;37;3;34;.919;3587000;0
17269;160907;626;0;0;0;0;.00nan;0;0
17270;1838;644;79;40;3;37;.925;3600000;0
17270;164404;1838;14;6;4;2;.333;831000;0
17270;-1;1838;36;19;4;15;.789;2769000;0
17270;61683;644;0;0;0;0;.00nan;0;0
17271;-1;635;48;22;3;19;.864;3568000;0
17271;195761;635;0;0;0;0;.00nan;0;0
17271;-1;633;0;0;0;0;.00nan;0;0
17271;-1;633;72;29;2;27;.931;3600000;0
17272;-1;648;0;0;0;0;.00nan;0;0
17272;-1;648;69;20;1;19;.950;3600000;0
17272;156632;626;43;32;6;26;.813;3600000;0
17272;160907;626;0;0;0;0;.00nan;0;0
17273;-1;632;0;0;0;0;.00nan;0;0
17273;-1;1825;0;0;0;0;.00nan;0;0
17273;174806;1825;13;32;7;25;.781;3600000;0
17273;82273;632;74;26;2;24;.923;3600000;0
17274;17625;651;0;0;0;0;.00nan;0;0
17274;-1;1847;52;2;0;2;1.000;312000;0
17274;58112;651;87;16;0;16;1.000;3600000;0
17274;160577;1847;70;43;5;38;.884;3288000;0
17275;164404;1838;0;0;0;0;.00nan;0;0
17275;168926;638;57;25;3;22;.880;3585000;0
17275;-1;1838;71;22;1;21;.955;3600000;0
17275;55209;638;0;0;0;0;.00nan;0;0
17276;1838;644;100;33;0;33;1.000;3600000;0
17276;3435;4538;80;30;2;28;.933;3519000;0
17276;190508;4538;0;0;0;0;.00nan;0;0
17276;61683;644;0;0;0;0;.00nan;0;0
17277;145838;5088;49;24;4;20;.833;3545000;0
17277;156632;626;71;37;3;34;.919;3600000;0
17277;160907;626;0;0;0;0;.00nan;0;0
17277;161336;5088;0;0;0;0;.00nan;0;0
17278;168926;638;21;23;6;17;.739;3723000;0
17278;-1;633;37;31;5;26;.839;3723000;0
17278;-1;633;0;0;0;0;.00nan;0;0
17278;55209;638;0;0;0;0;.00nan;0;0
17279;-1;1847;0;0;0;0;.00nan;0;0
17279;51328;1809;0;0;0;0;.00nan;0;0
17279;61425;1809;68;42;4;38;.905;4335000;0
17279;160577;1847;63;42;5;37;.881;4335000;0
17280;17625;651;50;21;3;18;.857;3600000;0
17280;-1;648;54;52;7;45;.865;3600000;0
17280;-1;648;0;0;0;0;.00nan;0;0
17280;58112;651;0;0;0;0;.00nan;0;0
17281;164404;1838;79;27;1;26;.963;3600000;0
17281;-1;1838;0;0;0;0;.00nan;0;0
17281;-1;1825;0;0;0;0;.00nan;0;0
17281;174806;1825;54;37;5;32;.865;3600000;0
17282;3435;4538;69;33;4;29;.879;3783000;0
17282;-1;632;0;0;0;0;.00nan;0;0
17282;190508;4538;0;0;0;0;.00nan;0;0
17282;82273;632;57;23;3;20;.870;3783000;0
17283;1838;644;60;28;3;25;.893;3600000;0
17283;-1;635;91;25;0;25;1.000;3600000;0
17283;195761;635;0;0;0;0;.00nan;0;0
17283;61683;644;0;0;0;0;.00nan;0;0
17284;1838;644;52;30;4;26;.867;3517000;0
17284;-1;632;0;0;0;0;.00nan;0;0
17284;61683;644;0;0;0;0;.00nan;0;0
17284;82273;632;99;41;2;39;.951;3600000;0
17285;3435;4538;63;30;4;26;.867;3600000;0
17285;190508;4538;0;0;0;0;.00nan;0;0
17285;156632;626;29;21;5;16;.762;3594000;0
17285;160907;626;0;0;0;0;.00nan;0;0
17286;-1;648;46;20;3;17;.850;3600000;0
17286;-1;633;0;0;0;0;.00nan;0;0
17286;-1;633;48;21;4;17;.810;3570000;0
17286;-1;648;0;0;0;0;.00nan;0;0
17287;164404;1838;0;0;0;0;.00nan;0;0
17287;-1;1838;61;26;3;23;.885;3600000;0
17287;-1;635;35;35;6;29;.829;3600000;0
17287;195761;635;0;0;0;0;.00nan;0;0
17288;17625;651;89;32;1;31;.969;4242000;0
17288;-1;1825;0;0;0;0;.00nan;0;0
17288;174806;1825;94;44;2;42;.955;4242000;0
17288;58112;651;0;0;0;0;.00nan;0;0
17289;168926;638;0;0;0;0;.00nan;0;0
17289;51328;1809;0;0;0;0;.00nan;0;0
17289;55209;638;88;29;1;28;.966;3600000;0
17289;61425;1809;64;26;2;24;.923;3545000;0
17290;-1;1847;88;34;1;33;.971;3600000;0
17290;145838;5088;61;23;2;21;.913;3564000;0
17290;160577;1847;0;0;0;0;.00nan;0;0
17290;161336;5088;0;0;0;0;.00nan;0;0
17291;-1;632;0;0;0;0;.00nan;0;0
17291;17625;651;81;13;0;13;1.000;3600000;0
17291;58112;651;0;0;0;0;.00nan;0;0
17291;82273;632;65;43;4;39;.907;3600000;0
17292;-1;633;93;19;0;19;1.000;3600000;0
17292;-1;633;0;0;0;0;.00nan;0;0
17292;51328;1809;58;6;0;6;1.000;986000;0
17292;61425;1809;32;34;7;27;.794;2614000;0
17293;-1;635;36;29;5;24;.828;2398000;0
17293;195761;635;64;12;0;12;1.000;1202000;0
17293;145838;5088;63;26;2;24;.923;3600000;0
17293;161336;5088;0;0;0;0;.00nan;0;0
17294;168926;638;59;29;3;26;.897;3552000;0
17294;-1;648;69;27;2;25;.926;3600000;0
17294;-1;648;0;0;0;0;.00nan;0;0
17294;55209;638;0;0;0;0;.00nan;0;0
17295;-1;1825;0;0;0;0;.00nan;0;0
17295;174806;1825;60;32;4;28;.875;3600000;0
17295;-1;1847;0;0;0;0;.00nan;0;0
17295;160577;1847;100;25;0;25;1.000;3600000;0
17296;3435;4538;32;30;6;24;.800;2015000;0
17296;164404;1838;49;28;4;24;.857;3600000;0
17296;-1;1838;0;0;0;0;.00nan;0;0
17296;190508;4538;68;11;0;11;1.000;1585000;0
17297;1838;644;87;38;2;36;.947;4015000;0
17297;61683;644;0;0;0;0;.00nan;0;0
17297;156632;626;54;20;3;17;.850;4015000;0
17297;160907;626;0;0;0;0;.00nan;0;0
17298;-1;633;85;41;3;38;.927;3600000;0
17298;-1;633;0;0;0;0;.00nan;0;0
17298;145838;5088;66;39;5;34;.872;3553000;0
17298;161336;5088;0;0;0;0;.00nan;0;0
17299;-1;632;0;0;0;0;.00nan;0;0
17299;51328;1809;0;0;0;0;.00nan;0;0
17299;61425;1809;75;41;4;37;.902;4086000;0
17299;82273;632;80;33;3;30;.909;4086000;0
17300;-1;635;48;32;5;27;.844;3600000;0
17300;195761;635;0;0;0;0;.00nan;0;0
17300;156632;626;100;29;0;29;1.000;3600000;0
17300;160907;626;0;0;0;0;.00nan;0;0
17301;1838;644;79;37;3;34;.919;3563000;0
17301;-1;648;68;18;1;17;.944;3600000;0
17301;-1;648;0;0;0;0;.00nan;0;0
17301;61683;644;0;0;0;0;.00nan;0;0
17302;164404;1838;0;0;0;0;.00nan;0;0
17302;17625;651;68;25;2;23;.920;3600000;0
17302;-1;1838;84;51;3;48;.941;3600000;0
17302;58112;651;0;0;0;0;.00nan;0;0
17303;168926;638;35;32;5;27;.844;3600000;0
17303;-1;1847;0;0;0;0;.00nan;0;0
17303;55209;638;0;0;0;0;.00nan;0;0
17303;160577;1847;78;28;1;27;.964;3600000;0
17304;3435;4538;98;43;2;41;.953;3600000;0
17304;-1;1825;0;0;0;0;.00nan;0;0
17304;174806;1825;83;23;1;22;.957;3600000;0
17304;190508;4538;0;0;0;0;.00nan;0;0
17305;-1;632;0;0;0;0;.00nan;0;0
17305;51328;1809;0;0;0;0;.00nan;0;0
17305;61425;1809;65;38;4;34;.895;3600000;0
17305;82273;632;77;22;1;21;.955;3600000;0
17306;-1;633;0;0;0;0;.00nan;0;0
17306;-1;633;70;27;2;25;.926;3600000;0
17306;145838;5088;40;2;1;1;.500;351000;0
17306;161336;5088;36;31;6;25;.806;3249000;0
17307;-1;635;82;38;3;35;.921;3600000;0
17307;195761;635;0;0;0;0;.00nan;0;0
17307;156632;626;57;29;5;24;.828;3555000;0
17307;160907;626;0;0;0;0;.00nan;0;0
17308;3435;4538;80;45;5;40;.889;3562000;0
17308;-1;1825;0;0;0;0;.00nan;0;0
17308;174806;1825;46;23;4;19;.826;3600000;0
17308;190508;4538;0;0;0;0;.00nan;0;0
17309;168926;638;96;41;1;40;.976;3600000;0
17309;-1;1847;0;0;0;0;.00nan;0;0
17309;55209;638;0;0;0;0;.00nan;0;0
17309;160577;1847;45;12;2;10;.833;3543000;0
17310;164404;1838;0;0;0;0;.00nan;0;0
17310;17625;651;0;0;0;0;.00nan;0;0
17310;-1;1838;90;41;1;40;.976;3600000;0
17310;58112;651;72;23;2;21;.913;3562000;0
17311;1838;644;48;35;5;30;.857;3746000;0
17311;-1;648;44;37;6;31;.838;3746000;0
17311;-1;648;0;0;0;0;.00nan;0;0
17311;61683;644;0;0;0;0;.00nan;0;0
17312;-1;1825;0;0;0;0;.00nan;0;0
17312;174806;1825;53;27;3;24;.889;3600000;0
17312;145838;5088;18;28;6;22;.786;3046000;0
17312;161336;5088;56;5;0;5;1.000;554000;0
17313;1838;644;24;21;6;15;.714;3600000;0
17313;51328;1809;0;0;0;0;.00nan;0;0
17313;61425;1809;74;33;3;30;.909;3600000;0
17313;61683;644;0;0;0;0;.00nan;0;0
17314;164404;1838;99;40;1;39;.975;3600000;0
17314;-1;1838;0;0;0;0;.00nan;0;0
17314;156632;626;0;0;0;0;.00nan;0;0
17314;160907;626;66;34;4;30;.882;3600000;0
17315;-1;648;0;0;0;0;.00nan;0;0
17315;-1;635;33;28;6;22;.786;3600000;0
17315;195761;635;0;0;0;0;.00nan;0;0
17315;-1;648;96;30;1;29;.967;3600000;0
17316;17625;651;69;34;4;30;.882;3543000;0
17316;-1;633;93;44;3;41;.932;3600000;0
17316;-1;633;0;0;0;0;.00nan;0;0
17316;58112;651;0;0;0;0;.00nan;0;0
17317;-1;632;0;0;0;0;.00nan;0;0
17317;-1;1847;0;0;0;0;.00nan;0;0
17317;82273;632;94;28;2;26;.929;3600000;0
17317;160577;1847;42;28;4;24;.857;3525000;0
17318;3435;4538;86;30;1;29;.967;3600000;0
17318;168926;638;52;24;3;21;.875;3600000;0
17318;190508;4538;0;0;0;0;.00nan;0;0
17318;55209;638;0;0;0;0;.00nan;0;0
17319;-1;632;0;0;0;0;.00nan;0;0
17319;82273;632;43;20;3;17;.850;3600000;0
17319;156632;626;59;37;5;32;.865;3539000;0
17319;160907;626;0;0;0;0;.00nan;0;0
17320;-1;633;0;0;0;0;.00nan;0;0
17320;-1;1847;0;0;0;0;.00nan;0;0
17320;-1;633;43;26;4;22;.846;4432000;0
17320;160577;1847;57;43;5;38;.884;4432000;0
17321;3435;4538;63;41;5;36;.878;3582000;0
17321;-1;635;58;30;3;27;.900;3600000;0
17321;195761;635;0;0;0;0;.00nan;0;0
17321;190508;4538;0;0;0;0;.00nan;0;0
17322;-1;648;4;13;6;7;.538;1617000;0
17322;-1;1825;0;0;0;0;.00nan;0;0
17322;174806;1825;84;34;2;32;.941;3600000;0
17322;-1;648;74;16;1;15;.938;1983000;0
17323;168926;638;60;23;3;20;.870;3549000;0
17323;55209;638;0;0;0;0;.00nan;0;0
17323;145838;5088;0;0;0;0;.00nan;0;0
17323;161336;5088;96;34;1;33;.971;3600000;0
17324;164404;1838;91;19;0;19;1.000;3600000;0
17324;-1;1838;0;0;0;0;.00nan;0;0
17324;51328;1809;0;0;0;0;.00nan;0;0
17324;61425;1809;76;34;3;31;.912;3600000;0
17325;1838;644;26;7;3;4;.571;172000;0
17325;17625;651;50;23;3;20;.870;3600000;0
17325;58112;651;0;0;0;0;.00nan;0;0
17325;61683;644;54;27;4;23;.852;3428000;0
17326;-1;632;0;0;0;0;.00nan;0;0
17326;82273;632;85;26;1;25;.962;3600000;0
17326;145838;5088;0;0;0;0;.00nan;0;0
17326;161336;5088;65;32;3;29;.906;3541000;0
17327;-1;635;21;27;6;21;.778;2087000;0
17327;195761;635;73;16;0;16;1.000;1513000;0
17327;51328;1809;92;23;0;23;1.000;3600000;0
17327;61425;1809;0;0;0;0;.00nan;0;0
17328;-1;1825;0;0;0;0;.00nan;0;0
17328;174806;1825;67;27;2;25;.926;3600000;0
17328;156632;626;44;16;3;13;.813;3600000;0
17328;160907;626;0;0;0;0;.00nan;0;0
17329;164404;1838;41;17;3;14;.824;3566000;0
17329;-1;1838;0;0;0;0;.00nan;0;0
17329;-1;648;0;0;0;0;.00nan;0;0
17329;-1;648;91;38;2;36;.947;3600000;0
17330;17625;651;0;0;0;0;.00nan;0;0
17330;168926;638;85;47;3;44;.936;3600000;0
17330;55209;638;0;0;0;0;.00nan;0;0
17330;58112;651;59;17;2;15;.882;3600000;0
17331;1838;644;65;32;4;28;.875;3597000;0
17331;-1;1847;0;0;0;0;.00nan;0;0
17331;61683;644;0;0;0;0;.00nan;0;0
17331;160577;1847;75;37;3;34;.919;3600000;0
17332;3435;4538;33;34;6;28;.824;3513000;0
17332;-1;633;55;33;4;29;.879;3600000;0
17332;190508;4538;0;0;0;0;.00nan;0;0
17332;-1;633;0;0;0;0;.00nan;0;0
17333;-1;633;50;23;3;20;.870;3600000;0
17333;-1;633;0;0;0;0;.00nan;0;0
17333;156632;626;45;22;4;18;.818;3579000;0
17333;160907;626;0;0;0;0;.00nan;0;0
17334;-1;648;0;0;0;0;.00nan;0;0
17334;-1;648;47;26;4;22;.846;3583000;0
17334;145838;5088;0;0;0;0;.00nan;0;0
17334;161336;5088;54;23;3;20;.870;3600000;0
17335;-1;632;0;0;0;0;.00nan;0;0
17335;-1;635;83;31;1;30;.968;3600000;0
17335;195761;635;0;0;0;0;.00nan;0;0
17335;82273;632;64;26;2;24;.923;3578000;0
17336;-1;1825;0;0;0;0;.00nan;0;0
17336;174806;1825;84;35;2;33;.943;3600000;0
17336;51328;1809;23;14;4;10;.714;1577000;0
17336;61425;1809;39;16;4;12;.750;2023000;0
17337;3435;4538;85;33;2;31;.939;3600000;0
17337;17625;651;54;28;3;25;.893;3543000;0
17337;190508;4538;0;0;0;0;.00nan;0;0
17337;58112;651;0;0;0;0;.00nan;0;0
17338;1838;644;31;28;6;22;.786;1746000;0
17338;168926;638;73;27;2;25;.926;3600000;0
17338;55209;638;0;0;0;0;.00nan;0;0
17338;61683;644;60;9;0;9;1.000;1854000;0
17339;164404;1838;0;0;0;0;.00nan;0;0
17339;-1;1838;47;32;5;27;.844;3526000;0
17339;-1;1847;0;0;0;0;.00nan;0;0
17339;160577;1847;52;30;4;26;.867;3600000;0
17340;-1;632;0;0;0;0;.00nan;0;0
17340;-1;633;0;0;0;0;.00nan;0;0
17340;-1;633;67;39;3;36;.923;4142000;0
17340;82273;632;69;31;2;29;.935;4142000;0
17341;164404;1838;68;26;2;24;.923;3600000;0
17341;-1;1838;0;0;0;0;.00nan;0;0
17341;145838;5088;61;32;3;29;.906;3600000;0
17341;161336;5088;0;0;0;0;.00nan;0;0
17342;17625;651;50;23;4;19;.826;3568000;0
17342;51328;1809;0;0;0;0;.00nan;0;0
17342;58112;651;0;0;0;0;.00nan;0;0
17342;61425;1809;100;52;3;49;.942;3600000;0
17343;168926;638;58;27;3;24;.889;3554000;0
17343;55209;638;0;0;0;0;.00nan;0;0
17343;156632;626;100;33;1;32;.970;3600000;0
17343;160907;626;0;0;0;0;.00nan;0;0
17344;-1;635;65;15;1;14;.933;3600000;0
17344;195761;635;0;0;0;0;.00nan;0;0
17344;-1;1847;59;29;4;25;.862;3600000;0
17344;160577;1847;0;0;0;0;.00nan;0;0
17345;3435;4538;68;36;4;32;.889;4510000;0
17345;-1;648;58;41;5;36;.878;4510000;0
17345;190508;4538;0;0;0;0;.00nan;0;0
17345;-1;648;0;0;0;0;.00nan;0;0
17346;1838;644;0;0;0;0;.00nan;0;0
17346;-1;1825;0;0;0;0;.00nan;0;0
17346;174806;1825;74;45;4;41;.911;3600000;0
17346;61683;644;82;22;1;21;.955;3600000;0
17347;-1;1825;0;0;0;0;.00nan;0;0
17347;174806;1825;53;35;4;31;.886;5424000;0
17347;-1;633;70;35;3;32;.914;5424000;0
17347;-1;633;0;0;0;0;.00nan;0;0
17348;-1;1847;0;0;0;0;.00nan;0;0
17348;156632;626;75;23;1;22;.957;3600000;0
17348;160577;1847;61;36;4;32;.889;3600000;0
17348;160907;626;0;0;0;0;.00nan;0;0
17349;-1;632;0;0;0;0;.00nan;0;0
17349;-1;648;81;25;1;24;.960;3600000;0
17349;-1;648;0;0;0;0;.00nan;0;0
17349;82273;632;28;23;6;17;.739;3600000;0
17350;17625;651;0;0;0;0;.00nan;0;0
17350;58112;651;71;17;1;16;.941;3600000;0
17350;145838;5088;0;0;0;0;.00nan;0;0
17350;161336;5088;98;54;2;52;.963;3570000;0
17351;168926;638;0;0;0;0;.00nan;0;0
17351;-1;635;68;30;3;27;.900;3600000;0
17351;195761;635;0;0;0;0;.00nan;0;0
17351;55209;638;66;27;2;25;.926;3600000;0
17352;1838;644;94;40;2;38;.950;3600000;0
17352;164404;1838;46;19;3;16;.842;3600000;0
17352;-1;1838;0;0;0;0;.00nan;0;0
17352;61683;644;0;0;0;0;.00nan;0;0
17353;3435;4538;0;0;0;0;.00nan;0;0
17353;190508;4538;65;39;5;34;.872;3535000;0
17353;51328;1809;0;0;0;0;.00nan;0;0
17353;61425;1809;80;38;3;35;.921;3600000;0
17354;51328;1809;0;0;0;0;.00nan;0;0
17354;61425;1809;88;12;0;12;1.000;3600000;0
17354;145838;5088;0;0;0;0;.00nan;0;0
17354;161336;5088;77;26;1;25;.962;3586000;0
17355;-1;635;57;27;3;24;.889;3567000;0
17355;195761;635;0;0;0;0;.00nan;0;0
17355;-1;633;0;0;0;0;.00nan;0;0
17355;-1;633;91;40;2;38;.950;3600000;0
17356;-1;648;49;17;3;14;.824;3600000;0
17356;-1;648;0;0;0;0;.00nan;0;0
17356;156632;626;51;35;5;30;.857;3519000;0
17356;160907;626;0;0;0;0;.00nan;0;0
17357;-1;632;0;0;0;0;.00nan;0;0
17357;-1;1825;62;29;4;25;.862;3600000;0
17357;174806;1825;0;0;0;0;.00nan;0;0
17357;82273;632;66;26;3;23;.885;3600000;0
17358;17625;651;0;0;0;0;.00nan;0;0
17358;-1;1847;89;45;3;42;.933;3008000;0
17358;58112;651;54;17;2;15;.882;3600000;0
17358;160577;1847;32;10;3;7;.700;592000;0
17359;164404;1838;47;20;3;17;.850;3600000;0
17359;168926;638;75;25;1;24;.960;3600000;0
17359;-1;1838;0;0;0;0;.00nan;0;0
17359;55209;638;0;0;0;0;.00nan;0;0
17360;1838;644;67;35;3;32;.914;3584000;0
17360;3435;4538;71;30;2;28;.933;3600000;0
17360;190508;4538;0;0;0;0;.00nan;0;0
17360;61683;644;0;0;0;0;.00nan;0;0
17361;-1;632;0;0;0;0;.00nan;0;0
17361;168926;638;92;34;2;32;.941;3600000;0
17361;55209;638;0;0;0;0;.00nan;0;0
17361;82273;632;77;41;3;38;.927;3542000;0
17362;-1;648;44;25;4;21;.840;3600000;0
17362;-1;648;0;0;0;0;.00nan;0;0
17362;51328;1809;0;0;0;0;.00nan;0;0
17362;61425;1809;42;32;6;26;.813;3546000;0
17363;17625;651;54;36;3;33;.917;6367000;0
17363;58112;651;0;0;0;0;.00nan;0;0
17363;156632;626;87;51;2;49;.961;6367000;0
17363;160907;626;0;0;0;0;.00nan;0;0
17364;-1;635;0;0;0;0;.00nan;0;0
17364;-1;1825;0;0;0;0;.00nan;0;0
17364;174806;1825;55;30;4;26;.867;3600000;0
17364;195761;635;38;36;6;30;.833;3588000;0
17365;3435;4538;95;39;2;37;.949;3600000;0
17365;-1;1847;0;0;0;0;.00nan;0;0
17365;190508;4538;0;0;0;0;.00nan;0;0
17365;160577;1847;59;27;3;24;.889;3543000;0
17366;164404;1838;0;0;0;0;.00nan;0;0
17366;-1;1838;40;14;3;11;.786;3600000;0
17366;-1;633;0;0;0;0;.00nan;0;0
17366;-1;633;60;40;4;36;.900;3600000;0
17367;1838;644;72;36;4;32;.889;3600000;0
17367;61683;644;0;0;0;0;.00nan;0;0
17367;145838;5088;0;0;0;0;.00nan;0;0
17367;161336;5088;53;39;5;34;.872;3600000;0
17368;164404;1838;76;33;2;31;.939;4029000;0
17368;-1;632;0;0;0;0;.00nan;0;0
17368;-1;1838;0;0;0;0;.00nan;0;0
17368;82273;632;61;25;3;22;.880;4004000;0
17369;-1;1847;0;0;0;0;.00nan;0;0
17369;145838;5088;100;37;1;36;.973;3600000;0
17369;160577;1847;47;27;4;23;.852;3600000;0
17369;161336;5088;0;0;0;0;.00nan;0;0
17370;-1;648;69;34;3;31;.912;3600000;0
17370;-1;633;86;31;1;30;.968;3600000;0
17370;-1;633;0;0;0;0;.00nan;0;0
17370;-1;648;0;0;0;0;.00nan;0;0
17371;168926;638;64;24;2;22;.917;3554000;0
17371;51328;1809;0;0;0;0;.00nan;0;0
17371;55209;638;0;0;0;0;.00nan;0;0
17371;61425;1809;100;29;0;29;1.000;3600000;0
17372;17625;651;75;17;1;16;.941;3600000;0
17372;-1;1825;0;0;0;0;.00nan;0;0
17372;174806;1825;57;42;6;36;.857;3600000;0
17372;58112;651;0;0;0;0;.00nan;0;0
17373;164404;1838;100;22;0;22;1.000;3600000;0
17373;-1;1838;0;0;0;0;.00nan;0;0
17373;-1;635;88;35;2;33;.943;3559000;0
17373;195761;635;0;0;0;0;.00nan;0;0
17374;3435;4538;78;36;2;34;.944;5625000;0
17374;190508;4538;0;0;0;0;.00nan;0;0
17374;156632;626;71;38;3;35;.921;5625000;0
17374;160907;626;0;0;0;0;.00nan;0;0
17375;1838;644;58;37;4;33;.892;3549000;0
17375;-1;632;0;0;0;0;.00nan;0;0
17375;61683;644;0;0;0;0;.00nan;0;0
17375;82273;632;66;22;2;20;.909;3600000;0
17376;3435;4538;82;39;4;35;.897;3558000;0
17376;-1;632;52;19;2;17;.895;3600000;0
17376;190508;4538;0;0;0;0;.00nan;0;0
17376;82273;632;0;0;0;0;.00nan;0;0
17377;145838;5088;0;0;0;0;.00nan;0;0
17377;156632;626;0;0;0;0;.00nan;0;0
17377;160907;626;66;27;2;25;.926;3600000;0
17377;161336;5088;41;29;5;24;.828;3600000;0
17378;17625;651;76;38;2;36;.947;4341000;0
17378;-1;648;0;0;0;0;.00nan;0;0
17378;-1;648;85;35;1;34;.971;4341000;0
17378;58112;651;0;0;0;0;.00nan;0;0
17379;1838;644;90;21;0;21;1.000;3600000;0
17379;-1;635;78;22;1;21;.955;3576000;0
17379;195761;635;0;0;0;0;.00nan;0;0
17379;61683;644;0;0;0;0;.00nan;0;0
17380;164404;1838;94;25;0;25;1.000;3600000;0
17380;-1;1838;0;0;0;0;.00nan;0;0
17380;-1;1825;0;0;0;0;.00nan;0;0
17380;174806;1825;78;40;3;37;.925;3600000;0
17381;168926;638;49;31;5;26;.839;3552000;0
17381;-1;633;0;0;0;0;.00nan;0;0
17381;-1;633;67;37;4;33;.892;3600000;0
17381;55209;638;0;0;0;0;.00nan;0;0
17382;-1;1847;0;0;0;0;.00nan;0;0
17382;51328;1809;0;0;0;0;.00nan;0;0
17382;61425;1809;42;31;5;26;.839;3573000;0
17382;160577;1847;70;40;4;36;.900;3600000;0
17383;3435;4538;63;27;4;23;.852;3600000;0
17383;190508;4538;0;0;0;0;.00nan;0;0
17383;145838;5088;0;0;0;0;.00nan;0;0
17383;161336;5088;43;32;5;27;.844;3562000;0
17384;51328;1809;0;0;0;0;.00nan;0;0
17384;61425;1809;52;28;4;24;.857;3600000;0
17384;156632;626;88;29;1;28;.966;3600000;0
17384;160907;626;0;0;0;0;.00nan;0;0
17385;17625;651;60;11;1;10;.909;3600000;0
17385;-1;635;84;61;4;57;.934;3600000;0
17385;195761;635;0;0;0;0;.00nan;0;0
17385;58112;651;0;0;0;0;.00nan;0;0
17386;168926;638;93;45;3;42;.933;3600000;0
17386;-1;1825;56;14;1;13;.929;1794000;0
17386;174806;1825;20;23;6;17;.739;1806000;0
17386;55209;638;0;0;0;0;.00nan;0;0
17387;-1;648;61;35;4;31;.886;3600000;0
17387;-1;1847;0;0;0;0;.00nan;0;0
17387;-1;648;0;0;0;0;.00nan;0;0
17387;160577;1847;81;29;1;28;.966;3600000;0
17388;1838;644;95;28;1;27;.964;3600000;0
17388;-1;633;58;26;4;22;.846;3600000;0
17388;-1;633;0;0;0;0;.00nan;0;0
17388;61683;644;0;0;0;0;.00nan;0;0
17389;-1;632;0;0;0;0;.00nan;0;0
17389;-1;1847;0;0;0;0;.00nan;0;0
17389;82273;632;54;17;2;15;.882;3600000;0
17389;160577;1847;48;30;4;26;.867;3520000;0
17390;17625;651;77;16;1;15;.938;3600000;0
17390;-1;633;61;39;4;35;.897;3600000;0
17390;-1;633;0;0;0;0;.00nan;0;0
17390;58112;651;0;0;0;0;.00nan;0;0
17391;-1;648;47;30;4;26;.867;3590000;0
17391;-1;635;71;28;3;25;.893;3600000;0
17391;195761;635;0;0;0;0;.00nan;0;0
17391;-1;648;0;0;0;0;.00nan;0;0
17392;-1;1825;0;0;0;0;.00nan;0;0
17392;174806;1825;72;23;1;22;.957;3552000;0
17392;145838;5088;0;0;0;0;.00nan;0;0
17392;161336;5088;90;24;0;24;1.000;3600000;0
17393;3435;4538;79;44;4;40;.909;3600000;0
17393;168926;638;0;0;0;0;.00nan;0;0
17393;190508;4538;0;0;0;0;.00nan;0;0
17393;55209;638;79;21;1;20;.952;3600000;0
17394;164404;1838;0;0;0;0;.00nan;0;0
17394;-1;1838;85;24;1;23;.958;3600000;0
17394;156632;626;54;27;3;24;.889;3546000;0
17394;160907;626;0;0;0;0;.00nan;0;0
17395;1838;644;75;22;1;21;.955;3600000;0
17395;51328;1809;0;0;0;0;.00nan;0;0
17395;61425;1809;43;24;4;20;.833;3600000;0
17395;61683;644;0;0;0;0;.00nan;0;0
17396;-1;635;80;34;2;32;.941;3545000;0
17396;195761;635;0;0;0;0;.00nan;0;0
17396;145838;5088;0;0;0;0;.00nan;0;0
17396;161336;5088;80;25;1;24;.960;3600000;0
17397;-1;633;58;30;5;25;.833;3600000;0
17397;-1;633;0;0;0;0;.00nan;0;0
17397;51328;1809;65;35;4;31;.886;3600000;0
17397;61425;1809;0;0;0;0;.00nan;0;0
17398;1838;644;88;33;1;32;.970;3600000;0
17398;61683;644;0;0;0;0;.00nan;0;0
17398;156632;626;70;28;2;26;.929;3547000;0
17398;160907;626;0;0;0;0;.00nan;0;0
17399;168926;638;84;15;0;15;1.000;3600000;0
17399;-1;648;77;39;3;36;.923;3600000;0
17399;-1;648;0;0;0;0;.00nan;0;0
17399;55209;638;0;0;0;0;.00nan;0;0
17400;-1;632;47;13;2;11;.846;854000;0
17400;17625;651;0;0;0;0;.00nan;0;0
17400;58112;651;100;20;0;20;1.000;3600000;0
17400;82273;632;46;39;6;33;.846;2746000;0
17401;-1;1825;0;0;0;0;.00nan;0;0
17401;174806;1825;100;26;0;26;1.000;3698000;0
17401;-1;1847;0;0;0;0;.00nan;0;0
17401;160577;1847;88;31;1;30;.968;3698000;0
17402;3435;4538;99;40;1;39;.975;4094000;0
17402;164404;1838;77;32;2;30;.938;4094000;0
17402;-1;1838;0;0;0;0;.00nan;0;0
17402;190508;4538;0;0;0;0;.00nan;0;0
17403;168926;638;54;26;4;22;.846;3761000;0
17403;55209;638;0;0;0;0;.00nan;0;0
17403;145838;5088;0;0;0;0;.00nan;0;0
17403;161336;5088;52;36;5;31;.861;3761000;0
17404;164404;1838;71;25;2;23;.920;3600000;0
17404;-1;1838;0;0;0;0;.00nan;0;0
17404;51328;1809;0;0;0;0;.00nan;0;0
17404;61425;1809;62;32;4;28;.875;3570000;0
17405;-1;632;0;0;0;0;.00nan;0;0
17405;82273;632;91;36;2;34;.944;3600000;0
17405;156632;626;40;24;5;19;.792;3600000;0
17405;160907;626;0;0;0;0;.00nan;0;0
17406;-1;648;52;35;6;29;.829;3529000;0
17406;-1;1825;0;0;0;0;.00nan;0;0
17406;174806;1825;45;23;4;19;.826;3600000;0
17406;-1;648;0;0;0;0;.00nan;0;0
17407;1838;644;41;37;6;31;.838;3600000;0
17407;17625;651;0;0;0;0;.00nan;0;0
17407;58112;651;75;11;0;11;1.000;3600000;0
17407;61683;644;0;0;0;0;.00nan;0;0
17408;-1;633;76;24;1;23;.958;3600000;0
17408;-1;1847;0;0;0;0;.00nan;0;0
17408;-1;633;0;0;0;0;.00nan;0;0
17408;160577;1847;40;34;6;28;.824;3600000;0
17409;3435;4538;71;37;4;33;.892;3687000;0
17409;-1;635;48;31;5;26;.839;3687000;0
17409;195761;635;0;0;0;0;.00nan;0;0
17409;190508;4538;0;0;0;0;.00nan;0;0
17410;-1;632;0;0;0;0;.00nan;0;0
17410;82273;632;68;19;1;18;.947;3600000;0
17410;145838;5088;0;0;0;0;.00nan;0;0
17410;161336;5088;61;39;5;34;.872;3600000;0
17411;3435;4538;54;37;5;32;.865;3600000;0
17411;-1;633;0;0;0;0;.00nan;0;0
17411;190508;4538;0;0;0;0;.00nan;0;0
17411;-1;633;64;20;2;18;.900;3600000;0
17412;-1;635;0;0;0;0;.00nan;0;0
17412;195761;635;88;27;1;26;.963;3600000;0
17412;51328;1809;0;0;0;0;.00nan;0;0
17412;61425;1809;41;25;5;20;.800;3600000;0
17413;-1;1825;58;34;4;30;.882;3552000;0
17413;174806;1825;0;0;0;0;.00nan;0;0
17413;156632;626;72;33;3;30;.909;3600000;0
17413;160907;626;0;0;0;0;.00nan;0;0
17414;17625;651;0;0;0;0;.00nan;0;0
17414;168926;638;94;49;3;46;.939;4262000;0
17414;55209;638;0;0;0;0;.00nan;0;0
17414;58112;651;58;21;2;19;.905;4262000;0
17415;164404;1838;0;0;0;0;.00nan;0;0
17415;-1;1838;90;32;2;30;.938;3968000;0
17415;-1;648;70;35;3;32;.914;3968000;0
17415;-1;648;0;0;0;0;.00nan;0;0
17416;1838;644;0;0;0;0;.00nan;0;0
17416;-1;1847;0;0;0;0;.00nan;0;0
17416;61683;644;65;24;2;22;.917;3600000;0
17416;160577;1847;50;38;5;33;.868;3600000;0
17417;-1;632;0;0;0;0;.00nan;0;0
17417;-1;633;0;0;0;0;.00nan;0;0
17417;-1;633;69;35;3;32;.914;3558000;0
17417;82273;632;79;25;2;23;.920;3600000;0
17418;3435;4538;62;33;4;29;.879;3600000;0
17418;-1;648;17;27;7;20;.741;2952000;0
17418;190508;4538;0;0;0;0;.00nan;0;0
17418;-1;648;44;4;1;3;.750;648000;0
17419;-1;635;38;22;4;18;.818;3600000;0
17419;195761;635;0;0;0;0;.00nan;0;0
17419;-1;1847;73;35;3;32;.914;3600000;0
17419;160577;1847;0;0;0;0;.00nan;0;0
17420;1838;644;68;31;2;29;.935;3817000;0
17420;-1;1825;0;0;0;0;.00nan;0;0
17420;174806;1825;87;35;3;32;.914;3817000;0
17420;61683;644;0;0;0;0;.00nan;0;0
17421;17625;651;81;13;0;13;1.000;3600000;0
17421;51328;1809;0;0;0;0;.00nan;0;0
17421;58112;651;0;0;0;0;.00nan;0;0
17421;61425;1809;82;38;3;35;.921;3600000;0
17422;164404;1838;76;30;2;28;.933;3600000;0
17422;-1;1838;0;0;0;0;.00nan;0;0
17422;145838;5088;0;0;0;0;.00nan;0;0
17422;161336;5088;58;32;4;28;.875;3586000;0
17423;-1;632;0;0;0;0;.00nan;0;0
17423;-1;1825;0;0;0;0;.00nan;0;0
17423;174806;1825;48;37;6;31;.838;3600000;0
17423;82273;632;46;19;3;16;.842;3600000;0
17424;51328;1809;0;0;0;0;.00nan;0;0
17424;61425;1809;67;28;3;25;.893;3600000;0
17424;145838;5088;0;0;0;0;.00nan;0;0
17424;161336;5088;91;34;2;32;.941;3600000;0
17425;-1;648;82;35;2;33;.943;3600000;0
17425;-1;648;0;0;0;0;.00nan;0;0
17425;156632;626;70;29;3;26;.897;3543000;0
17425;160907;626;0;0;0;0;.00nan;0;0
17426;-1;635;68;22;1;21;.955;3600000;0
17426;195761;635;0;0;0;0;.00nan;0;0
17426;-1;633;88;36;2;34;.944;2604000;0
17426;-1;633;33;17;4;13;.765;996000;0
17427;17625;651;72;23;1;22;.957;3600000;0
17427;-1;1847;45;28;4;24;.857;2760000;0
17427;58112;651;0;0;0;0;.00nan;0;0
17427;160577;1847;20;11;4;7;.636;840000;0
17428;164404;1838;55;34;5;29;.853;3544000;0
17428;168926;638;55;32;4;28;.875;3600000;0
17428;-1;1838;0;0;0;0;.00nan;0;0
17428;55209;638;0;0;0;0;.00nan;0;0
17429;1838;644;44;19;3;16;.842;3600000;0
17429;3435;4538;58;29;4;25;.862;3560000;0
17429;190508;4538;0;0;0;0;.00nan;0;0
17429;61683;644;0;0;0;0;.00nan;0;0
17430;1838;644;65;23;2;21;.913;3600000;0
17430;61683;644;0;0;0;0;.00nan;0;0
17430;145838;5088;0;0;0;0;.00nan;0;0
17430;161336;5088;67;39;5;34;.872;3600000;0
17431;164404;1838;78;37;4;33;.892;3984000;0
17431;-1;1838;0;0;0;0;.00nan;0;0
17431;-1;633;72;33;3;30;.909;3984000;0
17431;-1;633;0;0;0;0;.00nan;0;0
17432;-1;648;74;39;4;35;.897;3546000;0
17432;-1;648;0;0;0;0;.00nan;0;0
17432;51328;1809;0;0;0;0;.00nan;0;0
17432;61425;1809;73;33;3;30;.909;3600000;0
17433;-1;635;60;24;2;22;.917;3600000;0
17433;-1;1825;0;0;0;0;.00nan;0;0
17433;174806;1825;35;20;4;16;.800;3513000;0
17433;195761;635;0;0;0;0;.00nan;0;0
17434;17625;651;54;20;3;17;.850;3600000;0
17434;58112;651;0;0;0;0;.00nan;0;0
17434;156632;626;45;39;7;32;.821;3600000;0
17434;160907;626;0;0;0;0;.00nan;0;0
17435;-1;632;0;0;0;0;.00nan;0;0
17435;168926;638;65;29;2;27;.931;3600000;0
17435;55209;638;0;0;0;0;.00nan;0;0
17435;82273;632;60;32;3;29;.906;3571000;0
17436;3435;4538;0;0;0;0;.00nan;0;0
17436;-1;1847;0;0;0;0;.00nan;0;0
17436;190508;4538;76;29;2;27;.931;3600000;0
17436;160577;1847;81;38;3;35;.921;3577000;0
17437;-1;632;0;0;0;0;.00nan;0;0
17437;-1;648;67;40;4;36;.900;3600000;0
17437;-1;648;0;0;0;0;.00nan;0;0
17437;82273;632;81;31;1;30;.968;3600000;0
17438;17625;651;59;10;1;9;.900;3600000;0
17438;58112;651;0;0;0;0;.00nan;0;0
17438;145838;5088;0;0;0;0;.00nan;0;0
17438;161336;5088;60;37;4;33;.892;3600000;0
17439;168926;638;63;19;2;17;.895;3561000;0
17439;-1;635;100;37;0;37;1.000;3600000;0
17439;195761;635;0;0;0;0;.00nan;0;0
17439;55209;638;0;0;0;0;.00nan;0;0
17440;-1;1825;0;0;0;0;.00nan;0;0
17440;174806;1825;48;29;4;25;.862;3558000;0
17440;-1;633;55;25;3;22;.880;3600000;0
17440;-1;633;0;0;0;0;.00nan;0;0
17441;-1;1847;0;0;0;0;.00nan;0;0
17441;156632;626;94;22;0;22;1.000;3600000;0
17441;160577;1847;51;22;3;19;.864;3600000;0
17441;160907;626;0;0;0;0;.00nan;0;0
17442;1838;644;48;30;5;25;.833;3966000;0
17442;164404;1838;61;34;4;30;.882;3966000;0
17442;-1;1838;0;0;0;0;.00nan;0;0
17442;61683;644;0;0;0;0;.00nan;0;0
17443;1838;644;40;15;3;12;.800;1760000;0
17443;-1;633;82;29;2;27;.931;3600000;0
17443;-1;633;0;0;0;0;.00nan;0;0
17443;61683;644;31;17;4;13;.765;1840000;0
17444;51328;1809;0;0;0;0;.00nan;0;0
17444;61425;1809;63;30;3;27;.900;3528000;0
17444;156632;626;82;31;1;30;.968;3600000;0
17444;160907;626;0;0;0;0;.00nan;0;0
17445;-1;648;0;0;0;0;.00nan;0;0
17445;-1;1847;0;0;0;0;.00nan;0;0
17445;-1;648;74;39;2;37;.949;4464000;0
17445;160577;1847;62;34;3;31;.912;4464000;0
17446;17625;651;0;0;0;0;.00nan;0;0
17446;-1;635;63;44;6;38;.864;3570000;0
17446;195761;635;0;0;0;0;.00nan;0;0
17446;58112;651;57;28;4;24;.857;3600000;0
17447;168926;638;83;28;1;27;.964;3600000;0
17447;-1;1825;0;0;0;0;.00nan;0;0
17447;174806;1825;57;32;4;28;.875;3600000;0
17447;55209;638;0;0;0;0;.00nan;0;0
17448;164404;1838;0;0;0;0;.00nan;0;0
17448;-1;632;0;0;0;0;.00nan;0;0
17448;-1;1838;73;29;2;27;.931;3980000;0
17448;82273;632;74;24;3;21;.875;3980000;0
17449;3435;4538;54;24;3;21;.875;3600000;0
17449;190508;4538;0;0;0;0;.00nan;0;0
17449;145838;5088;49;19;3;16;.842;1225000;0
17449;161336;5088;38;25;5;20;.800;2375000;0
17450;3435;4538;100;38;1;37;.974;3600000;0
17450;190508;4538;0;0;0;0;.00nan;0;0
17450;51328;1809;53;24;3;21;.875;3569000;0
17450;61425;1809;0;0;0;0;.00nan;0;0
17451;-1;632;0;0;0;0;.00nan;0;0
17451;-1;635;94;50;2;48;.960;3952000;0
17451;195761;635;0;0;0;0;.00nan;0;0
17451;82273;632;61;25;3;22;.880;3952000;0
17452;-1;648;43;16;3;13;.813;3580000;0
17452;-1;648;0;0;0;0;.00nan;0;0
17452;145838;5088;73;28;2;26;.929;3600000;0
17452;161336;5088;0;0;0;0;.00nan;0;0
17453;-1;1825;0;0;0;0;.00nan;0;0
17453;174806;1825;65;18;1;17;.944;3600000;0
17453;51328;1809;0;0;0;0;.00nan;0;0
17453;61425;1809;36;41;7;34;.829;3600000;0
17454;-1;633;60;30;4;26;.867;3600000;0
17454;-1;633;0;0;0;0;.00nan;0;0
17454;156632;626;0;0;0;0;.00nan;0;0
17454;160907;626;92;20;0;20;1.000;3600000;0
17455;164404;1838;42;30;5;25;.833;3593000;0
17455;-1;1838;0;0;0;0;.00nan;0;0
17455;-1;1847;59;32;4;28;.875;3600000;0
17455;160577;1847;0;0;0;0;.00nan;0;0
17456;3435;4538;50;44;6;38;.864;3600000;0
17456;17625;651;64;26;3;23;.885;3600000;0
17456;190508;4538;0;0;0;0;.00nan;0;0
17456;58112;651;0;0;0;0;.00nan;0;0
17457;1838;644;54;29;4;25;.862;3600000;0
17457;168926;638;61;35;5;30;.857;3557000;0
17457;55209;638;0;0;0;0;.00nan;0;0
17457;61683;644;0;0;0;0;.00nan;0;0
17458;1838;644;70;26;3;23;.885;3561000;0
17458;-1;632;0;0;0;0;.00nan;0;0
17458;61683;644;0;0;0;0;.00nan;0;0
17458;82273;632;66;18;1;17;.944;3600000;0
17459;3435;4538;93;41;3;38;.927;3600000;0
17459;190508;4538;0;0;0;0;.00nan;0;0
17459;156632;626;0;0;0;0;.00nan;0;0
17459;160907;626;50;24;4;20;.833;3600000;0
17460;-1;648;72;34;2;32;.941;5536000;0
17460;-1;633;94;64;3;61;.953;5536000;0
17460;-1;633;0;0;0;0;.00nan;0;0
17460;-1;648;0;0;0;0;.00nan;0;0
17461;164404;1838;25;24;6;18;.750;2920000;0
17461;-1;1838;59;4;0;4;1.000;680000;0
17461;-1;635;25;26;6;20;.769;2966000;0
17461;195761;635;44;3;1;2;.667;596000;0
17462;17625;651;50;14;2;12;.857;3600000;0
17462;-1;1825;47;52;7;45;.865;3600000;0
17462;174806;1825;0;0;0;0;.00nan;0;0
17462;58112;651;0;0;0;0;.00nan;0;0
17463;168926;638;70;21;1;20;.952;3600000;0
17463;51328;1809;62;32;3;29;.906;2729000;0
17463;55209;638;0;0;0;0;.00nan;0;0
17463;61425;1809;17;13;5;8;.615;871000;0
17464;-1;1847;0;0;0;0;.00nan;0;0
17464;145838;5088;0;0;0;0;.00nan;0;0
17464;160577;1847;61;16;1;15;.938;3600000;0
17464;161336;5088;62;30;4;26;.867;3600000;0
17465;145838;5088;0;0;0;0;.00nan;0;0
17465;156632;626;73;24;2;22;.917;3600000;0
17465;160907;626;0;0;0;0;.00nan;0;0
17465;161336;5088;76;33;3;30;.909;3591000;0
17466;168926;638;69;32;3;29;.906;3585000;0
17466;-1;633;0;0;0;0;.00nan;0;0
17466;-1;633;71;24;1;23;.958;3600000;0
17466;55209;638;0;0;0;0;.00nan;0;0
17467;-1;1847;89;21;1;20;.952;4270000;0
17467;51328;1809;0;0;0;0;.00nan;0;0
17467;61425;1809;100;45;0;45;1.000;4270000;0
17467;160577;1847;0;0;0;0;.00nan;0;0
17468;17625;651;0;0;0;0;.00nan;0;0
17468;-1;648;33;46;8;38;.826;3600000;0
17468;-1;648;0;0;0;0;.00nan;0;0
17468;58112;651;88;15;0;15;1.000;3600000;0
17469;164404;1838;65;27;3;24;.889;3600000;0
17469;-1;1838;0;0;0;0;.00nan;0;0
17469;-1;1825;0;0;0;0;.00nan;0;0
17469;174806;1825;95;43;2;41;.953;3600000;0
17470;3435;4538;100;41;0;41;1.000;3600000;0
17470;-1;632;0;0;0;0;.00nan;0;0
17470;190508;4538;0;0;0;0;.00nan;0;0
17470;82273;632;59;28;4;24;.857;3600000;0
17471;1838;644;0;0;0;0;.00nan;0;0
17471;-1;635;75;30;2;28;.933;3585000;0
17471;195761;635;0;0;0;0;.00nan;0;0
17471;61683;644;100;27;0;27;1.000;3600000;0
17472;-1;633;57;18;2;16;.889;3600000;0
17472;-1;633;0;0;0;0;.00nan;0;0
17472;145838;5088;59;42;5;37;.881;3573000;0
17472;161336;5088;0;0;0;0;.00nan;0;0
17473;-1;632;0;0;0;0;.00nan;0;0
17473;51328;1809;0;0;0;0;.00nan;0;0
17473;61425;1809;89;34;2;32;.941;3600000;0
17473;82273;632;60;27;3;24;.889;3558000;0
17474;-1;635;66;35;4;31;.886;3600000;0
17474;195761;635;0;0;0;0;.00nan;0;0
17474;156632;626;53;22;3;19;.864;3600000;0
17474;160907;626;0;0;0;0;.00nan;0;0
17475;1838;644;0;0;0;0;.00nan;0;0
17475;-1;648;0;0;0;0;.00nan;0;0
17475;-1;648;94;34;1;33;.971;3600000;0
17475;61683;644;66;30;3;27;.900;3600000;0
17476;164404;1838;57;36;4;32;.889;3600000;0
17476;17625;651;0;0;0;0;.00nan;0;0
17476;-1;1838;0;0;0;0;.00nan;0;0
17476;58112;651;53;24;3;21;.875;3600000;0
17477;168926;638;41;34;5;29;.853;3536000;0
17477;-1;1847;66;29;3;26;.897;3600000;0
17477;55209;638;0;0;0;0;.00nan;0;0
17477;160577;1847;0;0;0;0;.00nan;0;0
17478;3435;4538;46;19;3;16;.842;3600000;0
17478;-1;1825;0;0;0;0;.00nan;0;0
17478;174806;1825;56;34;4;30;.882;3581000;0
17478;190508;4538;0;0;0;0;.00nan;0;0
17479;-1;632;95;31;1;30;.968;3600000;0
17479;17625;651;56;23;3;20;.870;3554000;0
17479;58112;651;0;0;0;0;.00nan;0;0
17479;82273;632;0;0;0;0;.00nan;0;0
17480;-1;633;71;21;1;20;.952;3600000;0
17480;-1;633;0;0;0;0;.00nan;0;0
17480;51328;1809;0;0;0;0;.00nan;0;0
17480;61425;1809;52;32;5;27;.844;3600000;0
17481;-1;635;0;0;0;0;.00nan;0;0
17481;195761;635;59;30;4;26;.867;3531000;0
17481;145838;5088;0;0;0;0;.00nan;0;0
17481;161336;5088;95;40;2;38;.950;3600000;0
17482;-1;1825;0;0;0;0;.00nan;0;0
17482;174806;1825;72;22;1;21;.955;3600000;0
17482;-1;1847;56;25;3;22;.880;3584000;0
17482;160577;1847;0;0;0;0;.00nan;0;0
17483;168926;638;52;30;4;26;.867;3553000;0
17483;-1;648;0;0;0;0;.00nan;0;0
17483;-1;648;69;28;3;25;.893;3600000;0
17483;55209;638;0;0;0;0;.00nan;0;0
17484;3435;4538;92;54;2;52;.963;5151000;0
17484;164404;1838;57;23;3;20;.870;5151000;0
17484;-1;1838;0;0;0;0;.00nan;0;0
17484;190508;4538;0;0;0;0;.00nan;0;0
17485;1838;644;68;20;2;18;.900;3596000;0
17485;61683;644;0;0;0;0;.00nan;0;0
17485;156632;626;60;16;1;15;.938;3600000;0
17485;160907;626;0;0;0;0;.00nan;0;0
17487;145838;5088;0;0;0;0;.00nan;0;0
17487;156632;626;74;30;2;28;.933;3600000;0
17487;160907;626;0;0;0;0;.00nan;0;0
17487;161336;5088;55;34;5;29;.853;3600000;0
17489;-1;632;0;0;0;0;.00nan;0;0
17489;-1;1825;0;0;0;0;.00nan;0;0
17489;174806;1825;72;33;2;31;.939;3600000;0
17489;82273;632;64;29;3;26;.897;3600000;0
17491;1838;644;74;53;5;48;.906;4850000;0
17491;-1;635;35;40;6;34;.850;4850000;0
17491;195761;635;0;0;0;0;.00nan;0;0
17491;61683;644;0;0;0;0;.00nan;0;0
17493;168926;638;47;18;3;15;.833;3560000;0
17493;-1;1847;0;0;0;0;.00nan;0;0
17493;55209;638;0;0;0;0;.00nan;0;0
17493;160577;1847;92;38;2;36;.947;3600000;0
17495;164404;1838;66;24;2;22;.917;3600000;0
17495;17625;651;69;32;3;29;.906;3591000;0
17495;-1;1838;0;0;0;0;.00nan;0;0
17495;58112;651;0;0;0;0;.00nan;0;0
17497;-1;648;98;52;2;50;.962;3600000;0
17497;-1;633;64;12;0;12;1.000;1439000;0
17497;-1;633;17;21;6;15;.714;2161000;0
17497;-1;648;0;0;0;0;.00nan;0;0
17499;3435;4538;90;32;2;30;.938;3600000;0
17499;190508;4538;0;0;0;0;.00nan;0;0
17499;51328;1809;0;0;0;0;.00nan;0;0
17499;61425;1809;65;30;3;27;.900;3594000;0
17501;-1;1847;0;0;0;0;.00nan;0;0
17501;156632;626;0;0;0;0;.00nan;0;0
17501;160577;1847;79;48;4;44;.917;5067000;0
17501;160907;626;76;34;3;31;.912;5023000;0
17503;3435;4538;62;44;5;39;.886;3600000;0
17503;-1;632;0;0;0;0;.00nan;0;0
17503;190508;4538;0;0;0;0;.00nan;0;0
17503;82273;632;63;20;2;18;.900;3600000;0
17505;-1;648;0;0;0;0;.00nan;0;0
17505;-1;648;60;32;4;28;.875;3600000;0
17505;145838;5088;0;0;0;0;.00nan;0;0
17505;161336;5088;48;38;6;32;.842;3560000;0
17507;17625;651;65;26;3;23;.885;3600000;0
17507;-1;1825;66;11;0;11;1.000;829000;0
17507;174806;1825;29;26;6;20;.769;2771000;0
17507;58112;651;0;0;0;0;.00nan;0;0
17509;168926;638;82;24;1;23;.958;3600000;0
17509;-1;633;54;37;5;32;.865;3600000;0
17509;-1;633;0;0;0;0;.00nan;0;0
17509;55209;638;0;0;0;0;.00nan;0;0
17511;1838;644;79;40;3;37;.925;3591000;0
17511;164404;1838;75;23;1;22;.957;3600000;0
17511;-1;1838;0;0;0;0;.00nan;0;0
17511;61683;644;0;0;0;0;.00nan;0;0
17513;-1;635;48;27;4;23;.852;3646000;0
17513;195761;635;0;0;0;0;.00nan;0;0
17513;51328;1809;0;0;0;0;.00nan;0;0
17513;61425;1809;79;36;3;33;.917;3646000;0
17515;164404;1838;0;0;0;0;.00nan;0;0
17515;168926;638;0;0;0;0;.00nan;0;0
17515;-1;1838;58;30;3;27;.900;3600000;0
17515;55209;638;90;31;1;30;.968;3600000;0
17517;17625;651;0;0;0;0;.00nan;0;0
17517;-1;635;0;0;0;0;.00nan;0;0
17517;195761;635;56;35;5;30;.857;3618000;0
17517;58112;651;56;25;4;21;.840;3618000;0
17519;1838;644;0;0;0;0;.00nan;0;0
17519;-1;1847;21;10;4;6;.600;1080000;0
17519;61683;644;64;36;3;33;.917;3600000;0
17519;160577;1847;73;19;0;19;1.000;2479000;0
17521;-1;648;60;42;5;37;.881;3657000;0
17521;-1;633;0;0;0;0;.00nan;0;0
17521;-1;633;50;27;4;23;.852;3625000;0
17521;-1;648;0;0;0;0;.00nan;0;0
17523;-1;632;67;23;2;21;.913;3600000;0
17523;51328;1809;54;30;3;27;.900;3556000;0
17523;61425;1809;0;0;0;0;.00nan;0;0
17523;82273;632;0;0;0;0;.00nan;0;0
17525;145838;5088;70;35;4;31;.886;3864000;0
17525;156632;626;67;32;3;29;.906;3864000;0
17525;160907;626;0;0;0;0;.00nan;0;0
17525;161336;5088;0;0;0;0;.00nan;0;0
17527;3435;4538;0;0;0;0;.00nan;0;0
17527;-1;1825;41;24;4;20;.833;3545000;0
17527;174806;1825;0;0;0;0;.00nan;0;0
17527;190508;4538;58;28;3;25;.893;3600000;0
17529;164404;1838;0;0;0;0;.00nan;0;0
17529;-1;1838;27;20;5;15;.750;3600000;0
17529;51328;1809;0;0;0;0;.00nan;0;0
17529;61425;1809;88;39;2;37;.949;3600000;0
17531;-1;1825;0;0;0;0;.00nan;0;0
17531;174806;1825;82;35;2;33;.943;4925000;0
17531;156632;626;87;36;1;35;.972;4925000;0
17531;160907;626;0;0;0;0;.00nan;0;0
17533;1838;644;99;21;0;21;1.000;3600000;0
17533;3435;4538;24;25;6;19;.760;1648000;0
17533;190508;4538;44;20;3;17;.850;1952000;0
17533;61683;644;0;0;0;0;.00nan;0;0
17535;-1;632;0;0;0;0;.00nan;0;0
17535;-1;635;57;28;3;25;.893;3600000;0
17535;195761;635;0;0;0;0;.00nan;0;0
17535;82273;632;43;21;4;17;.810;3600000;0
17537;168926;638;69;34;3;31;.912;3600000;0
17537;55209;638;0;0;0;0;.00nan;0;0
17537;145838;5088;0;0;0;0;.00nan;0;0
17537;161336;5088;43;28;6;22;.786;3600000;0
17539;17625;651;35;28;6;22;.786;2671000;0
17539;-1;633;44;34;5;29;.853;3600000;0
17539;-1;633;0;0;0;0;.00nan;0;0
17539;58112;651;49;7;1;6;.857;865000;0
17541;-1;648;0;0;0;0;.00nan;0;0
17541;-1;1847;0;0;0;0;.00nan;0;0
17541;-1;648;82;37;3;34;.919;3566000;0
17541;160577;1847;84;25;1;24;.960;3600000;0
17543;145838;5088;58;40;4;36;.900;3555000;0
17543;156632;626;0;0;0;0;.00nan;0;0
17543;160907;626;61;21;2;19;.905;3600000;0
17543;161336;5088;0;0;0;0;.00nan;0;0
17545;164404;1838;63;15;1;14;.933;3600000;0
17545;-1;1838;0;0;0;0;.00nan;0;0
17545;-1;1847;21;31;7;24;.774;2909000;0
17545;160577;1847;57;5;0;5;1.000;691000;0
17547;-1;635;0;0;0;0;.00nan;0;0
17547;195761;635;54;37;5;32;.865;3543000;0
17547;51328;1809;48;21;3;18;.857;3600000;0
17547;61425;1809;0;0;0;0;.00nan;0;0
17549;-1;632;78;27;1;26;.963;3600000;0
17549;-1;648;73;30;3;27;.900;3552000;0
17549;-1;648;0;0;0;0;.00nan;0;0
17549;82273;632;0;0;0;0;.00nan;0;0
17551;168926;638;0;0;0;0;.00nan;0;0
17551;-1;633;0;0;0;0;.00nan;0;0
17551;-1;633;80;34;1;33;.971;3600000;0
17551;55209;638;82;34;2;32;.941;3550000;0
17553;17625;651;0;0;0;0;.00nan;0;0
17553;-1;1825;86;28;1;27;.964;3600000;0
17553;174806;1825;0;0;0;0;.00nan;0;0
17553;58112;651;76;25;2;23;.920;3600000;0
17555;1838;644;60;25;3;22;.880;3545000;0
17555;3435;4538;100;45;2;43;.956;3600000;0
17555;190508;4538;0;0;0;0;.00nan;0;0
17555;61683;644;0;0;0;0;.00nan;0;0
17557;-1;632;0;0;0;0;.00nan;0;0
17557;-1;1847;0;0;0;0;.00nan;0;0
17557;82273;632;76;32;2;30;.938;4159000;0
17557;160577;1847;71;34;3;31;.912;4159000;0
17559;145838;5088;0;0;0;0;.00nan;0;0
17559;156632;626;61;24;2;22;.917;3600000;0
17559;160907;626;0;0;0;0;.00nan;0;0
17559;161336;5088;49;28;4;24;.857;3515000;0
17561;3435;4538;87;41;3;38;.927;3577000;0
17561;-1;635;61;16;1;15;.938;3600000;0
17561;195761;635;0;0;0;0;.00nan;0;0
17561;190508;4538;0;0;0;0;.00nan;0;0
17563;164404;1838;0;0;0;0;.00nan;0;0
17563;-1;1838;69;41;4;37;.902;4134000;0
17563;-1;1825;0;0;0;0;.00nan;0;0
17563;174806;1825;53;26;3;23;.885;4134000;0
17565;-1;648;76;32;2;30;.938;3600000;0
17565;-1;633;56;30;4;26;.867;3597000;0
17565;-1;633;0;0;0;0;.00nan;0;0
17565;-1;648;0;0;0;0;.00nan;0;0
17567;17625;651;68;32;4;28;.875;3600000;0
17567;51328;1809;0;0;0;0;.00nan;0;0
17567;58112;651;0;0;0;0;.00nan;0;0
17567;61425;1809;39;36;6;30;.833;3540000;0
17569;1838;644;75;35;3;32;.914;3600000;0
17569;168926;638;41;30;5;25;.833;3555000;0
17569;55209;638;0;0;0;0;.00nan;0;0
17569;61683;644;0;0;0;0;.00nan;0;0
17571;17625;651;0;0;0;0;.00nan;0;0
17571;58112;651;54;26;4;22;.846;3608000;0
17571;156632;626;0;0;0;0;.00nan;0;0
17571;160907;626;62;39;5;34;.872;3608000;0
17573;164404;1838;57;13;1;12;.923;3600000;0
17573;-1;1838;0;0;0;0;.00nan;0;0
17573;-1;1825;79;35;3;32;.914;3582000;0
17573;174806;1825;0;0;0;0;.00nan;0;0
17575;-1;632;67;21;1;20;.952;3600000;0
17575;51328;1809;51;44;5;39;.886;3600000;0
17575;61425;1809;0;0;0;0;.00nan;0;0
17575;82273;632;0;0;0;0;.00nan;0;0
17577;1838;644;0;0;0;0;.00nan;0;0
17577;-1;1847;55;30;4;26;.867;3512000;0
17577;61683;644;73;26;2;24;.923;3600000;0
17577;160577;1847;0;0;0;0;.00nan;0;0
17579;3435;4538;82;58;6;52;.897;3600000;0
17579;168926;638;0;0;0;0;.00nan;0;0
17579;190508;4538;0;0;0;0;.00nan;0;0
17579;55209;638;66;24;2;22;.917;3600000;0
17581;-1;648;0;0;0;0;.00nan;0;0
17581;-1;648;82;22;1;21;.955;3600000;0
17581;145838;5088;22;12;4;8;.667;951000;0
17581;161336;5088;97;32;0;32;1.000;2649000;0
17583;-1;635;26;25;6;19;.760;2971000;0
17583;195761;635;50;10;1;9;.900;629000;0
17583;-1;633;0;0;0;0;.00nan;0;0
17583;-1;633;55;24;4;20;.833;3600000;0
1044;-1;648;0;0;0;0;.00nan;0;0
1044;-1;648;67;28;3;25;.893;3600000;0
1044;156632;626;32;32;6;26;.813;3600000;0
1044;160907;626;0;0;0;0;.00nan;0;0
1045;3435;4538;92;29;2;27;.931;3600000;0
1045;-1;1825;0;0;0;0;.00nan;0;0
1045;174806;1825;66;45;4;41;.911;3553000;0
1045;190508;4538;0;0;0;0;.00nan;0;0
1046;-1;648;31;26;5;21;.808;3552000;0
1046;-1;648;0;0;0;0;.00nan;0;0
1046;156632;626;73;35;3;32;.914;3600000;0
1046;160907;626;0;0;0;0;.00nan;0;0
1047;3435;4538;64;31;4;27;.871;3624000;0
1047;-1;1825;0;0;0;0;.00nan;0;0
1047;174806;1825;53;26;3;23;.885;3624000;0
1047;190508;4538;0;0;0;0;.00nan;0;0
1124;-1;648;62;22;2;20;.909;3806000;0
1124;-1;648;0;0;0;0;.00nan;0;0
1124;156632;626;77;36;3;33;.917;3806000;0
1124;160907;626;0;0;0;0;.00nan;0;0
1125;3435;4538;59;51;6;45;.882;2882000;0
1125;-1;1825;0;0;0;0;.00nan;0;0
1125;174806;1825;64;32;4;28;.875;3600000;0
1125;190508;4538;14;5;4;1;.200;718000;0
1224;17625;651;68;16;1;15;.938;3600000;0
1224;-1;648;55;39;5;34;.872;3600000;0
1224;-1;648;0;0;0;0;.00nan;0;0
1224;58112;651;0;0;0;0;.00nan;0;0
1225;164404;1838;83;26;2;24;.923;3600000;0
1225;168926;638;29;28;6;22;.786;3600000;0
1225;-1;1838;0;0;0;0;.00nan;0;0
1225;55209;638;0;0;0;0;.00nan;0;0
1226;1838;644;89;27;1;26;.963;3600000;0
1226;-1;633;74;27;2;25;.926;3541000;0
1226;-1;633;0;0;0;0;.00nan;0;0
1226;61683;644;0;0;0;0;.00nan;0;0
1227;-1;632;0;0;0;0;.00nan;0;0
1227;-1;1825;0;0;0;0;.00nan;0;0
1227;174806;1825;66;21;2;19;.905;3600000;0
1227;82273;632;29;26;5;21;.808;3600000;0
1228;17625;651;56;17;2;15;.882;3600000;0
1228;-1;648;35;20;4;16;.800;729000;0
1228;-1;648;49;34;5;29;.853;2871000;0
1228;58112;651;0;0;0;0;.00nan;0;0
1229;164404;1838;69;42;4;38;.905;3600000;0
1229;168926;638;85;29;1;28;.966;3600000;0
1229;-1;1838;0;0;0;0;.00nan;0;0
1229;55209;638;0;0;0;0;.00nan;0;0
1230;1838;644;35;25;5;20;.800;3600000;0
1230;-1;633;95;34;1;33;.971;3600000;0
1230;-1;633;0;0;0;0;.00nan;0;0
1230;61683;644;0;0;0;0;.00nan;0;0
1231;-1;632;0;0;0;0;.00nan;0;0
1231;-1;1825;0;0;0;0;.00nan;0;0
1231;174806;1825;84;38;2;36;.947;3564000;0
1231;82273;632;70;20;1;19;.950;3600000;0
1232;17625;651;51;11;2;9;.818;3543000;0
1232;-1;648;0;0;0;0;.00nan;0;0
1232;-1;648;99;50;1;49;.980;3600000;0
1232;58112;651;0;0;0;0;.00nan;0;0
1233;164404;1838;50;14;2;12;.857;3600000;0
1233;168926;638;68;40;5;35;.875;3600000;0
1233;-1;1838;0;0;0;0;.00nan;0;0
1233;55209;638;0;0;0;0;.00nan;0;0
1234;1838;644;71;25;2;23;.920;3785000;0
1234;-1;633;97;38;1;37;.974;3785000;0
1234;-1;633;0;0;0;0;.00nan;0;0
1234;61683;644;0;0;0;0;.00nan;0;0
1235;-1;632;0;0;0;0;.00nan;0;0
1235;-1;1825;0;0;0;0;.00nan;0;0
1235;174806;1825;37;23;5;18;.783;3600000;0
1235;82273;632;55;44;6;38;.864;3588000;0
1236;17625;651;20;17;5;12;.706;3600000;0
1236;-1;648;0;0;0;0;.00nan;0;0
1236;-1;648;98;46;2;44;.957;3600000;0
1236;58112;651;0;0;0;0;.00nan;0;0
1237;164404;1838;41;32;6;26;.813;2977000;0
1237;168926;638;77;30;2;28;.933;3600000;0
1237;-1;1838;42;3;1;2;.667;623000;0
1237;55209;638;0;0;0;0;.00nan;0;0
1238;1838;644;89;30;1;29;.967;3600000;0
1238;-1;633;53;37;6;31;.838;3600000;0
1238;-1;633;0;0;0;0;.00nan;0;0
1238;61683;644;0;0;0;0;.00nan;0;0
1239;-1;632;0;0;0;0;.00nan;0;0
1239;-1;1825;0;0;0;0;.00nan;0;0
1239;174806;1825;97;37;1;36;.973;3600000;0
1239;82273;632;50;29;3;26;.897;3516000;0
1531;17625;651;53;23;2;21;.913;4200000;0
1531;-1;648;87;46;2;44;.957;4200000;0
1531;-1;648;0;0;0;0;.00nan;0;0
1531;58112;651;0;0;0;0;.00nan;0;0
1532;164404;1838;80;32;2;30;.938;3563000;0
1532;168926;638;77;26;1;25;.962;3600000;0
1532;-1;1838;0;0;0;0;.00nan;0;0
1532;55209;638;0;0;0;0;.00nan;0;0
1533;1838;644;73;19;1;18;.947;3600000;0
1533;-1;633;53;28;4;24;.857;3600000;0
1533;-1;633;0;0;0;0;.00nan;0;0
1533;61683;644;0;0;0;0;.00nan;0;0
1534;-1;632;0;0;0;0;.00nan;0;0
1534;-1;1825;0;0;0;0;.00nan;0;0
1534;174806;1825;73;28;3;25;.893;3600000;0
1534;82273;632;70;39;4;35;.897;3593000;0
1580;17625;651;57;13;1;12;.923;3600000;0
1580;-1;648;86;50;3;47;.940;3563000;0
1580;-1;648;0;0;0;0;.00nan;0;0
1580;58112;651;0;0;0;0;.00nan;0;0
1581;164404;1838;45;25;4;21;.840;3533000;0
1581;168926;638;61;19;2;17;.895;3600000;0
1581;-1;1838;0;0;0;0;.00nan;0;0
1581;55209;638;0;0;0;0;.00nan;0;0
1582;1838;644;97;27;0;27;1.000;3600000;0
1582;-1;633;81;39;2;37;.949;3549000;0
1582;-1;633;0;0;0;0;.00nan;0;0
1582;61683;644;0;0;0;0;.00nan;0;0
1631;17625;651;80;23;1;22;.957;3600000;0
1631;-1;1825;0;0;0;0;.00nan;0;0
1631;174806;1825;62;36;4;32;.889;3600000;0
1631;58112;651;0;0;0;0;.00nan;0;0
1632;1838;644;66;28;2;26;.929;3600000;0
1632;168926;638;54;33;5;28;.848;3600000;0
1632;55209;638;0;0;0;0;.00nan;0;0
1632;61683;644;0;0;0;0;.00nan;0;0
1633;17625;651;66;20;2;18;.900;3600000;0
1633;-1;1825;0;0;0;0;.00nan;0;0
1633;174806;1825;54;35;4;31;.886;3514000;0
1633;58112;651;0;0;0;0;.00nan;0;0
1634;1838;644;61;18;2;16;.889;3600000;0
1634;168926;638;70;33;3;30;.909;3600000;0
1634;55209;638;0;0;0;0;.00nan;0;0
1634;61683;644;0;0;0;0;.00nan;0;0
1635;17625;651;58;14;1;13;.929;3600000;0
1635;-1;1825;0;0;0;0;.00nan;0;0
1635;174806;1825;86;46;4;42;.913;3600000;0
1635;58112;651;0;0;0;0;.00nan;0;0
1636;1838;644;44;22;4;18;.818;3600000;0
1636;168926;638;95;30;1;29;.967;3600000;0
1636;55209;638;0;0;0;0;.00nan;0;0
1636;61683;644;0;0;0;0;.00nan;0;0
1637;17625;651;59;28;3;25;.893;3600000;0
1637;-1;1825;57;3;0;3;1.000;347000;0
1637;174806;1825;44;39;6;33;.846;3253000;0
1637;58112;651;0;0;0;0;.00nan;0;0
1638;1838;644;63;16;1;15;.938;3600000;0
1638;168926;638;21;10;4;6;.600;854000;0
1638;55209;638;98;33;0;33;1.000;2746000;0
1638;61683;644;0;0;0;0;.00nan;0;0
1890;1838;644;91;44;3;41;.932;3554000;0
1890;168926;638;76;30;2;28;.933;3600000;0
1890;55209;638;0;0;0;0;.00nan;0;0
1890;61683;644;0;0;0;0;.00nan;0;0
1908;1838;644;96;39;1;38;.974;4200000;0
1908;168926;638;76;29;1;28;.966;4200000;0
1908;55209;638;0;0;0;0;.00nan;0;0
1908;61683;644;0;0;0;0;.00nan;0;0
1945;1838;644;72;38;4;34;.895;3600000;0
1945;17625;651;92;32;1;31;.969;3600000;0
1945;58112;651;0;0;0;0;.00nan;0;0
1945;61683;644;0;0;0;0;.00nan;0;0
1946;1838;644;86;37;3;34;.919;3600000;0
1946;17625;651;60;19;2;17;.895;3600000;0
1946;58112;651;0;0;0;0;.00nan;0;0
1946;61683;644;0;0;0;0;.00nan;0;0
1947;1838;644;77;35;3;32;.914;3600000;0
1947;17625;651;63;24;2;22;.917;3600000;0
1947;58112;651;0;0;0;0;.00nan;0;0
1947;61683;644;0;0;0;0;.00nan;0;0
1948;1838;644;43;43;7;36;.837;3600000;0
1948;17625;651;78;12;0;12;1.000;3600000;0
1948;58112;651;0;0;0;0;.00nan;0;0
1948;61683;644;0;0;0;0;.00nan;0;0
17584;30696;2508;62;38;4;34;.895;3594000;0
17584;47741;2508;0;0;0;0;.00nan;0;0
17584;47754;841;58;20;2;18;.900;3600000;0
17584;47864;841;0;0;0;0;.00nan;0;0
17585;167824;2493;95;38;1;37;.974;3600000;0
17585;16907;2517;63;21;2;19;.905;3550000;0
17585;47728;2517;0;0;0;0;.00nan;0;0
17585;62975;2493;0;0;0;0;.00nan;0;0
17586;5573;2488;0;0;0;0;.00nan;0;0
17586;10322;838;43;16;3;13;.813;3600000;0
17586;91202;2488;61;45;5;40;.889;3582000;0
17586;94240;838;0;0;0;0;.00nan;0;0
17587;16588;843;0;0;0;0;.00nan;0;0
17587;31439;835;0;0;0;0;.00nan;0;0
17587;78920;835;63;22;2;20;.909;3600000;0
17587;89874;843;64;42;5;37;.881;3600000;0
17588;11751;846;100;30;0;30;1.000;3600000;0
17588;47982;845;0;0;0;0;.00nan;0;0
17588;54885;846;0;0;0;0;.00nan;0;0
17588;77730;845;49;15;2;13;.867;3528000;0
17589;10322;838;0;0;0;0;.00nan;0;0
17589;30696;2508;27;9;3;6;.667;498000;0
17589;47741;2508;61;48;6;42;.875;3102000;0
17589;94240;838;62;22;2;20;.909;3600000;0
17590;5573;2488;0;0;0;0;.00nan;0;0
17590;167824;2493;81;28;1;27;.964;3600000;0
17590;62975;2493;0;0;0;0;.00nan;0;0
17590;91202;2488;53;27;3;24;.889;3559000;0
17591;47754;841;77;36;3;33;.917;3600000;0
17591;47864;841;0;0;0;0;.00nan;0;0
17591;47982;845;0;0;0;0;.00nan;0;0
17591;77730;845;50;30;4;26;.867;3600000;0
17592;11751;846;90;44;3;41;.932;3600000;0
17592;31439;835;0;0;0;0;.00nan;0;0
17592;54885;846;0;0;0;0;.00nan;0;0
17592;78920;835;64;31;4;27;.871;3586000;0
17593;16588;843;0;0;0;0;.00nan;0;0
17593;16907;2517;96;18;0;18;1.000;3600000;0
17593;47728;2517;0;0;0;0;.00nan;0;0
17593;89874;843;78;32;1;31;.969;3598000;0
17594;167824;2493;94;19;0;19;1.000;3600000;0
17594;11751;846;85;35;1;34;.971;3600000;0
17594;54885;846;0;0;0;0;.00nan;0;0
17594;62975;2493;0;0;0;0;.00nan;0;0
17595;10322;838;0;0;0;0;.00nan;0;0
17595;16588;843;83;47;3;44;.936;3600000;0
17595;89874;843;0;0;0;0;.00nan;0;0
17595;94240;838;100;30;0;30;1.000;3600000;0
17596;5573;2488;0;0;0;0;.00nan;0;0
17596;16907;2517;86;31;2;29;.935;3900000;0
17596;47728;2517;0;0;0;0;.00nan;0;0
17596;91202;2488;85;27;2;25;.926;3900000;0
17597;30696;2508;50;41;6;35;.854;3596000;0
17597;47741;2508;0;0;0;0;.00nan;0;0
17597;47982;845;50;30;4;26;.867;3600000;0
17597;77730;845;0;0;0;0;.00nan;0;0
17598;31439;835;0;0;0;0;.00nan;0;0
17598;47754;841;78;40;4;36;.900;3600000;0
17598;47864;841;0;0;0;0;.00nan;0;0
17598;78920;835;75;20;1;19;.950;3600000;0
17599;10322;838;0;0;0;0;.00nan;0;0
17599;47754;841;46;47;7;40;.851;3600000;0
17599;47864;841;0;0;0;0;.00nan;0;0
17599;94240;838;53;15;2;13;.867;3600000;0
17600;167824;2493;76;55;4;51;.927;3900000;0
17600;31439;835;0;0;0;0;.00nan;0;0
17600;62975;2493;0;0;0;0;.00nan;0;0
17600;78920;835;53;26;4;22;.846;3900000;0
17601;16907;2517;63;33;3;30;.909;3568000;0
17601;47728;2517;0;0;0;0;.00nan;0;0
17601;47982;845;0;0;0;0;.00nan;0;0
17601;77730;845;65;28;2;26;.929;3600000;0
17602;5573;2488;0;0;0;0;.00nan;0;0
17602;16588;843;0;0;0;0;.00nan;0;0
17602;89874;843;64;47;5;42;.894;3600000;0
17602;91202;2488;64;23;2;21;.913;3600000;0
17603;11751;846;0;0;0;0;.00nan;0;0
17603;30696;2508;51;29;4;25;.862;3600000;0
17603;47741;2508;0;0;0;0;.00nan;0;0
17603;54885;846;39;34;5;29;.853;3596000;0
17604;167824;2493;35;42;8;34;.810;2789000;0
17604;47754;841;62;17;1;16;.941;3600000;0
17604;47864;841;0;0;0;0;.00nan;0;0
17604;62975;2493;55;14;1;13;.929;811000;0
17605;16907;2517;91;33;1;32;.970;3600000;0
17605;30696;2508;0;0;0;0;.00nan;0;0
17605;47728;2517;0;0;0;0;.00nan;0;0
17605;47741;2508;43;34;5;29;.853;3600000;0
17606;10322;838;30;34;6;28;.824;3256000;0
17606;31439;835;0;0;0;0;.00nan;0;0
17606;78920;835;82;41;3;38;.927;3600000;0
17606;94240;838;50;1;0;1;1.000;344000;0
17607;16588;843;74;41;3;38;.927;3900000;0
17607;47982;845;60;33;3;30;.909;3898000;0
17607;77730;845;0;0;0;0;.00nan;0;0
17607;89874;843;0;0;0;0;.00nan;0;0
17608;5573;2488;0;0;0;0;.00nan;0;0
17608;11751;846;34;43;7;36;.837;3600000;0
17608;54885;846;0;0;0;0;.00nan;0;0
17608;91202;2488;77;30;2;28;.933;3600000;0
17609;167824;2493;0;0;0;0;.00nan;0;0
17609;16588;843;0;0;0;0;.00nan;0;0
17609;62975;2493;97;33;1;32;.970;3578000;0
17609;89874;843;99;24;0;24;1.000;3600000;0
17610;5573;2488;0;0;0;0;.00nan;0;0
17610;47754;841;75;28;2;26;.929;3600000;0
17610;47864;841;0;0;0;0;.00nan;0;0
17610;91202;2488;50;29;5;24;.828;3600000;0
17611;10322;838;0;0;0;0;.00nan;0;0
17611;47982;845;0;0;0;0;.00nan;0;0
17611;77730;845;37;34;6;28;.824;3600000;0
17611;94240;838;80;24;1;23;.958;3600000;0
17612;30696;2508;61;45;6;39;.867;3600000;0
17612;31439;835;0;0;0;0;.00nan;0;0
17612;47741;2508;0;0;0;0;.00nan;0;0
17612;78920;835;50;13;2;11;.846;3600000;0
17613;5573;2488;0;0;0;0;.00nan;0;0
17613;30696;2508;0;0;0;0;.00nan;0;0
17613;47741;2508;64;31;3;28;.903;3530000;0
17613;91202;2488;81;25;1;24;.960;3600000;0
17614;16907;2517;90;41;3;38;.927;3900000;0
17614;47728;2517;0;0;0;0;.00nan;0;0
17614;47754;841;73;35;3;32;.914;3900000;0
17614;47864;841;0;0;0;0;.00nan;0;0
17615;10322;838;0;0;0;0;.00nan;0;0
17615;167824;2493;91;63;5;58;.921;3600000;0
17615;62975;2493;0;0;0;0;.00nan;0;0
17615;94240;838;58;15;2;13;.867;3600000;0
17616;31439;835;0;0;0;0;.00nan;0;0
17616;38277;845;70;42;4;38;.905;3554000;0
17616;77730;845;0;0;0;0;.00nan;0;0
17616;78920;835;46;12;2;10;.833;3600000;0
17617;11751;846;68;21;1;20;.952;3559000;0
17617;16588;843;0;0;0;0;.00nan;0;0
17617;54885;846;0;0;0;0;.00nan;0;0
17617;89874;843;100;35;0;35;1.000;3600000;0
17618;167824;2493;70;41;4;37;.902;3600000;0
17618;38277;845;75;22;1;21;.955;3600000;0
17618;62975;2493;0;0;0;0;.00nan;0;0
17618;77730;845;0;0;0;0;.00nan;0;0
17619;10322;838;0;0;0;0;.00nan;0;0
17619;16907;2517;0;0;0;0;.00nan;0;0
17619;47728;2517;86;41;3;38;.927;3722000;0
17619;94240;838;53;24;4;20;.833;3722000;0
17620;16588;843;0;0;0;0;.00nan;0;0
17620;30696;2508;39;30;5;25;.833;3600000;0
17620;47741;2508;0;0;0;0;.00nan;0;0
17620;89874;843;79;33;2;31;.939;3600000;0
17621;11751;846;0;0;0;0;.00nan;0;0
17621;47754;841;55;35;5;30;.857;3600000;0
17621;47864;841;0;0;0;0;.00nan;0;0
17621;54885;846;61;21;2;19;.905;3600000;0
17622;167824;2493;93;43;2;41;.953;3592000;0
17622;30696;2508;0;0;0;0;.00nan;0;0
17622;47741;2508;84;29;1;28;.966;3600000;0
17622;62975;2493;0;0;0;0;.00nan;0;0
17623;10322;838;60;15;1;14;.933;3600000;0
17623;11751;846;41;37;6;31;.838;3079000;0
17623;54885;846;44;4;1;3;.750;521000;0
17623;94240;838;0;0;0;0;.00nan;0;0
17624;5573;2488;0;0;0;0;.00nan;0;0
17624;38277;845;75;20;1;19;.950;3600000;0
17624;77730;845;0;0;0;0;.00nan;0;0
17624;91202;2488;54;34;4;30;.882;3600000;0
17625;16907;2517;72;42;4;38;.905;3900000;0
17625;31439;835;61;38;4;34;.895;3900000;0
17625;47728;2517;0;0;0;0;.00nan;0;0
17625;78920;835;0;0;0;0;.00nan;0;0
17626;30696;2508;30;44;8;36;.818;3600000;0
17626;47741;2508;0;0;0;0;.00nan;0;0
17626;47754;841;37;20;4;16;.800;3600000;0
17626;47864;841;0;0;0;0;.00nan;0;0
17627;5573;2488;0;0;0;0;.00nan;0;0
17627;10322;838;0;0;0;0;.00nan;0;0
17627;91202;2488;97;40;2;38;.950;3600000;0
17627;94240;838;69;18;1;17;.944;3600000;0
17628;11751;846;58;24;3;21;.875;3600000;0
17628;38277;845;59;30;4;26;.867;3569000;0
17628;54885;846;0;0;0;0;.00nan;0;0
17628;77730;845;0;0;0;0;.00nan;0;0
17629;16588;843;38;8;2;6;.750;967000;0
17629;31439;835;0;0;0;0;.00nan;0;0
17629;78920;835;80;12;0;12;1.000;3600000;0
17629;89874;843;41;34;6;28;.824;2633000;0
17630;167824;2493;51;37;5;32;.865;3600000;0
17630;16907;2517;43;32;6;26;.813;3588000;0
17630;47728;2517;0;0;0;0;.00nan;0;0
17630;62975;2493;0;0;0;0;.00nan;0;0
17631;16588;843;0;0;0;0;.00nan;0;0
17631;47754;841;44;27;4;23;.852;3592000;0
17631;47864;841;0;0;0;0;.00nan;0;0
17631;89874;843;99;56;3;53;.946;3600000;0
17632;5573;2488;0;0;0;0;.00nan;0;0
17632;167824;2493;0;0;0;0;.00nan;0;0
17632;62975;2493;82;38;2;36;.947;3600000;0
17632;91202;2488;70;31;3;28;.903;3600000;0
17633;10322;838;0;0;0;0;.00nan;0;0
17633;30696;2508;97;57;4;53;.930;3600000;0
17633;47741;2508;0;0;0;0;.00nan;0;0
17633;94240;838;80;11;0;11;1.000;3600000;0
17634;16588;843;67;30;3;27;.900;3550000;0
17634;16907;2517;64;20;2;18;.900;3600000;0
17634;47728;2517;0;0;0;0;.00nan;0;0
17634;89874;843;0;0;0;0;.00nan;0;0
17635;11751;846;0;0;0;0;.00nan;0;0
17635;31439;835;0;0;0;0;.00nan;0;0
17635;54885;846;78;39;4;35;.897;3591000;0
17635;78920;835;72;25;2;23;.920;3600000;0
17636;38277;845;60;24;2;22;.917;3580000;0
17636;47754;841;0;0;0;0;.00nan;0;0
17636;47864;841;87;33;1;32;.970;3600000;0
17636;77730;845;0;0;0;0;.00nan;0;0
17637;31439;835;0;0;0;0;.00nan;0;0
17637;47754;841;53;19;2;17;.895;3547000;0
17637;47864;841;0;0;0;0;.00nan;0;0
17637;78920;835;99;50;1;49;.980;3600000;0
17638;5573;2488;0;0;0;0;.00nan;0;0
17638;16907;2517;60;35;5;30;.857;3600000;0
17638;47728;2517;0;0;0;0;.00nan;0;0
17638;91202;2488;80;23;1;22;.957;3600000;0
17639;10322;838;0;0;0;0;.00nan;0;0
17639;16588;843;0;0;0;0;.00nan;0;0
17639;89874;843;100;53;2;51;.962;3900000;0
17639;94240;838;68;19;2;17;.895;3900000;0
17640;167824;2493;53;40;5;35;.875;3558000;0
17640;11751;846;53;21;3;18;.857;3600000;0
17640;54885;846;0;0;0;0;.00nan;0;0
17640;62975;2493;0;0;0;0;.00nan;0;0
17641;167824;2493;54;37;5;32;.865;3600000;0
17641;47754;841;61;23;2;21;.913;3600000;0
17641;47864;841;0;0;0;0;.00nan;0;0
17641;62975;2493;0;0;0;0;.00nan;0;0
17642;5573;2488;0;0;0;0;.00nan;0;0
17642;11751;846;59;37;4;33;.892;3600000;0
17642;54885;846;0;0;0;0;.00nan;0;0
17642;91202;2488;98;43;1;42;.977;3600000;0
17643;16588;843;0;0;0;0;.00nan;0;0
17643;38277;845;84;16;0;16;1.000;3600000;0
17643;77730;845;0;0;0;0;.00nan;0;0
17643;89874;843;78;48;5;43;.896;3600000;0
17644;10322;838;0;0;0;0;.00nan;0;0
17644;31439;835;0;0;0;0;.00nan;0;0
17644;78920;835;89;46;2;44;.957;3900000;0
17644;94240;838;67;22;2;20;.909;3900000;0
17645;16907;2517;72;24;1;23;.958;3600000;0
17645;30696;2508;40;30;6;24;.800;3088000;0
17645;47728;2517;0;0;0;0;.00nan;0;0
17645;47741;2508;55;4;0;4;1.000;512000;0
17646;5573;2488;0;0;0;0;.00nan;0;0
17646;47754;841;72;28;3;25;.893;3599000;0
17646;47864;841;0;0;0;0;.00nan;0;0
17646;91202;2488;70;19;2;17;.895;3600000;0
17647;10322;838;76;17;1;16;.941;3600000;0
17647;38277;845;81;43;3;40;.930;3600000;0
17647;77730;845;0;0;0;0;.00nan;0;0
17647;94240;838;0;0;0;0;.00nan;0;0
17648;167824;2493;56;19;2;17;.895;3600000;0
17648;16588;843;0;0;0;0;.00nan;0;0
17648;62975;2493;0;0;0;0;.00nan;0;0
17648;89874;843;35;26;5;21;.808;3595000;0
17649;11751;846;0;0;0;0;.00nan;0;0
17649;16907;2517;47;42;6;36;.857;3007000;0
17649;47728;2517;64;10;0;10;1.000;593000;0
17649;54885;846;63;27;3;24;.889;3600000;0
17650;10322;838;0;0;0;0;.00nan;0;0
17650;167824;2493;64;38;4;34;.895;3600000;0
17650;62975;2493;0;0;0;0;.00nan;0;0
17650;94240;838;80;21;1;20;.952;3600000;0
17651;5573;2488;73;24;1;23;.958;3600000;0
17651;30696;2508;89;45;2;43;.956;3585000;0
17651;47741;2508;0;0;0;0;.00nan;0;0
17651;91202;2488;0;0;0;0;.00nan;0;0
17652;31439;835;0;0;0;0;.00nan;0;0
17652;38277;845;81;34;2;32;.941;3561000;0
17652;77730;845;0;0;0;0;.00nan;0;0
17652;78920;835;79;25;1;24;.960;3600000;0
17653;16907;2517;39;31;6;25;.806;3058000;0
17653;47728;2517;51;2;0;2;1.000;542000;0
17653;47754;841;72;29;2;27;.931;3600000;0
17653;47864;841;0;0;0;0;.00nan;0;0
17654;11751;846;90;22;0;22;1.000;3600000;0
17654;16588;843;0;0;0;0;.00nan;0;0
17654;54885;846;0;0;0;0;.00nan;0;0
17654;89874;843;63;29;3;26;.897;3600000;0
17655;11751;846;33;28;6;22;.786;3521000;0
17655;47754;841;56;28;4;24;.857;3600000;0
17655;47864;841;0;0;0;0;.00nan;0;0
17655;54885;846;0;0;0;0;.00nan;0;0
17656;10322;838;53;16;2;14;.875;3600000;0
17656;16907;2517;83;44;4;40;.909;3577000;0
17656;47728;2517;0;0;0;0;.00nan;0;0
17656;94240;838;0;0;0;0;.00nan;0;0
17657;167824;2493;69;38;4;34;.895;3569000;0
17657;38277;845;54;25;3;22;.880;3600000;0
17657;62975;2493;0;0;0;0;.00nan;0;0
17657;77730;845;0;0;0;0;.00nan;0;0
17658;5573;2488;59;6;0;6;1.000;737000;0
17658;31439;835;0;0;0;0;.00nan;0;0
17658;78920;835;81;16;0;16;1.000;3600000;0
17658;91202;2488;39;31;6;25;.806;2863000;0
17659;16588;843;86;41;3;38;.927;3600000;0
17659;30696;2508;62;36;4;32;.889;3579000;0
17659;47741;2508;0;0;0;0;.00nan;0;0
17659;89874;843;0;0;0;0;.00nan;0;0
17660;167824;2493;50;32;5;27;.844;3671000;0
17660;30696;2508;68;37;4;33;.892;3671000;0
17660;47741;2508;0;0;0;0;.00nan;0;0
17660;62975;2493;0;0;0;0;.00nan;0;0
17661;5573;2488;0;0;0;0;.00nan;0;0
17661;38277;845;78;30;2;28;.933;3571000;0
17661;77730;845;0;0;0;0;.00nan;0;0
17661;91202;2488;100;35;1;34;.971;3600000;0
17662;16907;2517;33;14;3;11;.786;1068000;0
17662;31439;835;0;0;0;0;.00nan;0;0
17662;47728;2517;45;37;6;31;.838;2532000;0
17662;78920;835;54;23;3;20;.870;3600000;0
17663;16588;843;0;0;0;0;.00nan;0;0
17663;47754;841;55;16;2;14;.875;3600000;0
17663;47864;841;0;0;0;0;.00nan;0;0
17663;89874;843;94;61;5;56;.918;3600000;0
17664;10322;838;0;0;0;0;.00nan;0;0
17664;11751;846;0;0;0;0;.00nan;0;0
17664;54885;846;90;38;2;36;.947;3600000;0
17664;94240;838;52;19;3;16;.842;3560000;0
17665;11751;846;52;27;4;23;.852;3900000;0
17665;30696;2508;0;0;0;0;.00nan;0;0
17665;47741;2508;60;44;4;40;.909;3900000;0
17665;54885;846;0;0;0;0;.00nan;0;0
17666;10322;838;0;0;0;0;.00nan;0;0
17666;47754;841;95;39;1;38;.974;3600000;0
17666;47864;841;0;0;0;0;.00nan;0;0
17666;94240;838;36;20;4;16;.800;3600000;0
17667;5573;2488;0;0;0;0;.00nan;0;0
17667;16588;843;0;0;0;0;.00nan;0;0
17667;89874;843;76;40;4;36;.900;3600000;0
17667;91202;2488;69;19;1;18;.947;3600000;0
17668;16907;2517;63;29;2;27;.931;3900000;0
17668;38277;845;67;22;2;20;.909;3900000;0
17668;47728;2517;0;0;0;0;.00nan;0;0
17668;77730;845;0;0;0;0;.00nan;0;0
17669;167824;2493;98;54;3;51;.944;3600000;0
17669;31439;835;0;0;0;0;.00nan;0;0
17669;62975;2493;0;0;0;0;.00nan;0;0
17669;78920;835;34;19;4;15;.789;3545000;0
17670;11751;846;67;37;4;33;.892;3600000;0
17670;47754;841;0;0;0;0;.00nan;0;0
17670;47864;841;40;27;5;22;.815;3600000;0
17670;54885;846;0;0;0;0;.00nan;0;0
17671;5573;2488;0;0;0;0;.00nan;0;0
17671;47754;841;59;28;3;25;.893;3798000;0
17671;47864;841;0;0;0;0;.00nan;0;0
17671;91202;2488;75;40;4;36;.900;3798000;0
17672;167824;2493;87;33;2;31;.939;3600000;0
17672;16588;843;0;0;0;0;.00nan;0;0
17672;62975;2493;0;0;0;0;.00nan;0;0
17672;89874;843;37;24;5;19;.792;3600000;0
17673;10322;838;64;20;2;18;.900;3600000;0
17673;30696;2508;56;5;0;5;1.000;326000;0
17673;47741;2508;48;42;6;36;.857;3274000;0
17673;94240;838;0;0;0;0;.00nan;0;0
17674;31439;835;0;0;0;0;.00nan;0;0
17674;38277;845;48;38;6;32;.842;3600000;0
17674;77730;845;0;0;0;0;.00nan;0;0
17674;78920;835;100;23;0;23;1.000;3600000;0
17675;11751;846;55;24;3;21;.875;3600000;0
17675;16907;2517;58;37;4;33;.892;3600000;0
17675;47728;2517;0;0;0;0;.00nan;0;0
17675;54885;846;0;0;0;0;.00nan;0;0
17676;30696;2508;100;50;3;47;.940;3900000;0
17676;38277;845;58;22;3;19;.864;3900000;0
17676;47741;2508;0;0;0;0;.00nan;0;0
17676;77730;845;0;0;0;0;.00nan;0;0
17677;5573;2488;0;0;0;0;.00nan;0;0
17677;167824;2493;62;39;5;34;.872;3564000;0
17677;62975;2493;0;0;0;0;.00nan;0;0
17677;91202;2488;54;31;4;27;.871;3600000;0
17678;10322;838;70;34;3;31;.912;3600000;0
17678;31439;835;0;0;0;0;.00nan;0;0
17678;78920;835;48;26;4;22;.846;3585000;0
17678;94240;838;0;0;0;0;.00nan;0;0
17679;16588;843;0;0;0;0;.00nan;0;0
17679;16907;2517;79;30;2;28;.933;3600000;0
17679;47728;2517;0;0;0;0;.00nan;0;0
17679;89874;843;42;20;3;17;.850;3579000;0
17680;11751;846;0;0;0;0;.00nan;0;0
17680;38277;845;65;26;3;23;.885;3545000;0
17680;54885;846;89;32;2;30;.938;3600000;0
17680;77730;845;0;0;0;0;.00nan;0;0
17681;30696;2508;100;45;1;44;.978;3600000;0
17681;31439;835;0;0;0;0;.00nan;0;0
17681;47741;2508;0;0;0;0;.00nan;0;0
17681;78920;835;41;15;3;12;.800;3534000;0
17682;10322;838;0;0;0;0;.00nan;0;0
17682;167824;2493;93;57;4;53;.930;3600000;0
17682;62975;2493;0;0;0;0;.00nan;0;0
17682;94240;838;57;11;1;10;.909;3600000;0
17683;16588;843;64;34;3;31;.912;3563000;0
17683;38277;845;0;0;0;0;.00nan;0;0
17683;77730;845;66;21;2;19;.905;3600000;0
17683;89874;843;0;0;0;0;.00nan;0;0
17684;16907;2517;0;0;0;0;.00nan;0;0
17684;47728;2517;66;38;5;33;.868;3581000;0
17684;47754;841;47;17;3;14;.824;3600000;0
17684;47864;841;0;0;0;0;.00nan;0;0
17685;5573;2488;56;29;3;26;.897;3098000;0
17685;11751;846;0;0;0;0;.00nan;0;0
17685;54885;846;83;34;3;31;.912;3600000;0
17685;91202;2488;24;5;3;2;.400;502000;0
17686;16588;843;0;0;0;0;.00nan;0;0
17686;30696;2508;0;0;0;0;.00nan;0;0
17686;47741;2508;90;35;2;33;.943;3600000;0
17686;89874;843;40;48;7;41;.854;3600000;0
17687;10322;838;0;0;0;0;.00nan;0;0
17687;47754;841;79;55;5;50;.909;3600000;0
17687;47864;841;0;0;0;0;.00nan;0;0
17687;94240;838;57;17;2;15;.882;3600000;0
17688;167824;2493;0;0;0;0;.00nan;0;0
17688;16907;2517;25;23;6;17;.739;2587000;0
17688;47728;2517;68;14;0;14;1.000;1013000;0
17688;62975;2493;62;18;1;17;.944;3600000;0
17689;5573;2488;0;0;0;0;.00nan;0;0
17689;38277;845;81;33;3;30;.909;3600000;0
17689;77730;845;0;0;0;0;.00nan;0;0
17689;91202;2488;66;40;4;36;.900;3568000;0
17690;11751;846;96;27;1;26;.963;3600000;0
17690;31439;835;0;0;0;0;.00nan;0;0
17690;54885;846;0;0;0;0;.00nan;0;0
17690;78920;835;48;15;2;13;.867;3555000;0
17691;167824;2493;21;11;4;7;.636;671000;0
17691;30696;2508;0;0;0;0;.00nan;0;0
17691;47741;2508;29;14;4;10;.714;3600000;0
17691;62975;2493;73;32;3;29;.906;2929000;0
17692;10322;838;34;19;5;14;.737;1928000;0
17692;38277;845;66;47;7;40;.851;3182000;0
17692;77730;845;53;8;1;7;.875;418000;0
17692;94240;838;60;7;0;7;1.000;1672000;0
17693;5573;2488;0;0;0;0;.00nan;0;0
17693;16907;2517;69;32;3;29;.906;3558000;0
17693;47728;2517;0;0;0;0;.00nan;0;0
17693;91202;2488;99;37;1;36;.973;3600000;0
17694;16588;843;0;0;0;0;.00nan;0;0
17694;31439;835;0;0;0;0;.00nan;0;0
17694;78920;835;37;18;4;14;.778;3599000;0
17694;89874;843;77;31;2;29;.935;3600000;0
17695;11751;846;81;36;4;32;.889;3584000;0
17695;47754;841;73;35;3;32;.914;3600000;0
17695;47864;841;0;0;0;0;.00nan;0;0
17695;54885;846;0;0;0;0;.00nan;0;0
17696;5573;2488;0;0;0;0;.00nan;0;0
17696;31439;835;0;0;0;0;.00nan;0;0
17696;78920;835;29;8;3;5;.625;3600000;0
17696;91202;2488;76;44;4;40;.909;3562000;0
17697;11751;846;0;0;0;0;.00nan;0;0
17697;30696;2508;0;0;0;0;.00nan;0;0
17697;47741;2508;43;30;5;25;.833;3600000;0
17697;54885;846;68;21;2;19;.905;3600000;0
17698;167824;2493;91;35;1;34;.971;3600000;0
17698;47754;841;85;42;3;39;.929;3577000;0
17698;47864;841;0;0;0;0;.00nan;0;0
17698;62975;2493;0;0;0;0;.00nan;0;0
17699;10322;838;0;0;0;0;.00nan;0;0
17699;16588;843;0;0;0;0;.00nan;0;0
17699;89874;843;82;56;5;51;.911;3600000;0
17699;94240;838;59;11;1;10;.909;3600000;0
17700;5573;2488;0;0;0;0;.00nan;0;0
17700;31439;835;0;0;0;0;.00nan;0;0
17700;78920;835;62;22;2;20;.909;3900000;0
17700;91202;2488;72;31;2;29;.935;3900000;0
17701;16907;2517;98;45;2;43;.956;3900000;0
17701;38277;845;77;31;2;29;.935;3900000;0
17701;47728;2517;0;0;0;0;.00nan;0;0
17701;77730;845;0;0;0;0;.00nan;0;0
17702;167824;2493;100;43;0;43;1.000;3600000;0
17702;11751;846;30;19;4;15;.789;3600000;0
17702;13715;846;0;0;0;0;.00nan;0;0
17702;62975;2493;0;0;0;0;.00nan;0;0
17703;5573;2488;0;0;0;0;.00nan;0;0
17703;10322;838;0;0;0;0;.00nan;0;0
17703;91202;2488;88;58;5;53;.914;3600000;0
17703;94240;838;91;21;0;21;1.000;3600000;0
17704;30696;2508;57;38;4;34;.895;3600000;0
17704;38277;845;100;25;0;25;1.000;3600000;0
17704;47741;2508;0;0;0;0;.00nan;0;0
17704;77730;845;0;0;0;0;.00nan;0;0
17705;16907;2517;58;44;6;38;.864;3265000;0
17705;31439;835;0;0;0;0;.00nan;0;0
17705;47728;2517;49;2;0;2;1.000;335000;0
17705;78920;835;72;25;2;23;.920;3600000;0
17706;16588;843;81;33;2;31;.939;3723000;0
17706;47754;841;64;15;1;14;.933;3723000;0
17706;47864;841;0;0;0;0;.00nan;0;0
17706;89874;843;0;0;0;0;.00nan;0;0
17707;167824;2493;100;59;2;57;.966;3900000;0
17707;31439;835;0;0;0;0;.00nan;0;0
17707;62975;2493;0;0;0;0;.00nan;0;0
17707;78920;835;62;17;2;15;.882;3900000;0
17708;5573;2488;0;0;0;0;.00nan;0;0
17708;16588;843;0;0;0;0;.00nan;0;0
17708;89874;843;55;39;5;34;.872;3600000;0
17708;91202;2488;69;33;3;30;.909;3600000;0
17709;16907;2517;0;0;0;0;.00nan;0;0
17709;30696;2508;52;34;5;29;.853;3600000;0
17709;47728;2517;70;51;6;45;.882;3586000;0
17709;47741;2508;0;0;0;0;.00nan;0;0
17710;10322;838;0;0;0;0;.00nan;0;0
17710;11751;846;0;0;0;0;.00nan;0;0
17710;13715;846;81;32;2;30;.938;3600000;0
17710;94240;838;72;19;1;18;.947;3600000;0
17711;38277;845;72;27;2;25;.926;3600000;0
17711;47754;841;82;41;4;37;.902;3588000;0
17711;47864;841;0;0;0;0;.00nan;0;0
17711;77730;845;0;0;0;0;.00nan;0;0
17712;5573;2488;0;0;0;0;.00nan;0;0
17712;30696;2508;0;0;0;0;.00nan;0;0
17712;47741;2508;66;39;5;34;.872;3515000;0
17712;91202;2488;73;34;3;31;.912;3600000;0
17713;10322;838;83;25;1;24;.960;3600000;0
17713;16907;2517;74;44;4;40;.909;3600000;0
17713;47728;2517;0;0;0;0;.00nan;0;0
17713;94240;838;0;0;0;0;.00nan;0;0
17714;167824;2493;84;38;2;36;.947;3572000;0
17714;38277;845;84;25;1;24;.960;3600000;0
17714;62975;2493;0;0;0;0;.00nan;0;0
17714;77730;845;0;0;0;0;.00nan;0;0
17715;31439;835;49;31;4;27;.871;3900000;0
17715;47754;841;53;26;4;22;.846;3900000;0
17715;47864;841;0;0;0;0;.00nan;0;0
17715;78920;835;0;0;0;0;.00nan;0;0
17716;11751;846;63;22;2;20;.909;3600000;0
17716;13715;846;0;0;0;0;.00nan;0;0
17716;16588;843;0;0;0;0;.00nan;0;0
17716;89874;843;89;45;3;42;.933;3543000;0
17717;5573;2488;0;0;0;0;.00nan;0;0
17717;16588;843;0;0;0;0;.00nan;0;0
17717;89874;843;70;35;3;32;.914;3530000;0
17717;91202;2488;82;22;1;21;.955;3600000;0
17718;16907;2517;41;34;5;29;.853;3900000;0
17718;47728;2517;0;0;0;0;.00nan;0;0
17718;47754;841;0;0;0;0;.00nan;0;0
17718;47864;841;49;31;5;26;.839;3900000;0
17719;167824;2493;0;0;0;0;.00nan;0;0
17719;38277;845;74;15;1;14;.933;3600000;0
17719;62975;2493;81;41;3;38;.927;3600000;0
17719;77730;845;0;0;0;0;.00nan;0;0
17720;10322;838;0;0;0;0;.00nan;0;0
17720;30696;2508;47;48;7;41;.854;3600000;0
17720;47741;2508;0;0;0;0;.00nan;0;0
17720;94240;838;53;12;2;10;.833;3600000;0
17721;11751;846;0;0;0;0;.00nan;0;0
17721;13715;846;77;29;2;27;.931;3900000;0
17721;31439;835;0;0;0;0;.00nan;0;0
17721;78920;835;90;36;2;34;.944;3883000;0
17722;30696;2508;0;0;0;0;.00nan;0;0
17722;47741;2508;96;41;3;38;.927;3600000;0
17722;47754;841;83;13;0;13;1.000;3600000;0
17722;47864;841;0;0;0;0;.00nan;0;0
17723;5573;2488;100;40;1;39;.975;3600000;0
17723;11751;846;73;24;2;22;.917;3578000;0
17723;13715;846;0;0;0;0;.00nan;0;0
17723;91202;2488;0;0;0;0;.00nan;0;0
17724;16588;843;0;0;0;0;.00nan;0;0
17724;38277;845;57;19;3;16;.842;3600000;0
17724;77730;845;0;0;0;0;.00nan;0;0
17724;89874;843;78;46;4;42;.913;3546000;0
17725;167824;2493;39;30;5;25;.833;3564000;0
17725;31439;835;0;0;0;0;.00nan;0;0
17725;62975;2493;0;0;0;0;.00nan;0;0
17725;78920;835;84;36;3;33;.917;3600000;0
17726;10322;838;0;0;0;0;.00nan;0;0
17726;16907;2517;96;44;3;41;.932;3900000;0
17726;47728;2517;0;0;0;0;.00nan;0;0
17726;94240;838;64;19;3;16;.842;3900000;0
17727;30696;2508;54;42;6;36;.857;3600000;0
17727;31439;835;0;0;0;0;.00nan;0;0
17727;47741;2508;0;0;0;0;.00nan;0;0
17727;78920;835;60;27;3;24;.889;3600000;0
17728;167824;2493;79;35;3;32;.914;3568000;0
17728;16907;2517;85;31;1;30;.968;3600000;0
17728;47728;2517;0;0;0;0;.00nan;0;0
17728;62975;2493;0;0;0;0;.00nan;0;0
17729;11751;846;65;30;3;27;.900;3600000;0
17729;13715;846;0;0;0;0;.00nan;0;0
17729;30696;2508;0;0;0;0;.00nan;0;0
17729;47741;2508;49;38;5;33;.868;3593000;0
17730;10322;838;80;28;2;26;.929;3600000;0
17730;16588;843;0;0;0;0;.00nan;0;0
17730;89874;843;57;42;5;37;.881;3600000;0
17730;94240;838;0;0;0;0;.00nan;0;0
17731;38277;845;74;44;4;40;.909;3600000;0
17731;47754;841;92;18;0;18;1.000;3600000;0
17731;47864;841;0;0;0;0;.00nan;0;0
17731;77730;845;0;0;0;0;.00nan;0;0
17732;5573;2488;62;6;0;6;1.000;529000;0
17732;31439;835;0;0;0;0;.00nan;0;0
17732;78920;835;82;27;1;26;.963;3600000;0
17732;91202;2488;38;38;7;31;.816;3071000;0
17733;31439;835;0;0;0;0;.00nan;0;0
17733;47754;841;63;39;4;35;.897;3600000;0
17733;47864;841;0;0;0;0;.00nan;0;0
17733;78920;835;92;33;1;32;.970;3600000;0
17734;10322;838;0;0;0;0;.00nan;0;0
17734;167824;2493;78;51;5;46;.902;3600000;0
17734;62975;2493;0;0;0;0;.00nan;0;0
17734;94240;838;30;13;4;9;.692;3600000;0
17735;5573;2488;0;0;0;0;.00nan;0;0
17735;16907;2517;65;22;2;20;.909;3556000;0
17735;47728;2517;0;0;0;0;.00nan;0;0
17735;91202;2488;73;20;1;19;.950;3600000;0
17736;16588;843;79;34;2;32;.941;3600000;0
17736;30696;2508;0;0;0;0;.00nan;0;0
17736;47741;2508;41;24;5;19;.792;3600000;0
17736;89874;843;0;0;0;0;.00nan;0;0
17737;11751;846;49;27;4;23;.852;3600000;0
17737;13715;846;0;0;0;0;.00nan;0;0
17737;38277;845;80;26;1;25;.962;3600000;0
17737;77730;845;0;0;0;0;.00nan;0;0
17738;167824;2493;79;30;2;28;.933;3600000;0
17738;30696;2508;25;20;5;15;.750;2336000;0
17738;47741;2508;59;13;1;12;.923;1264000;0
17738;62975;2493;0;0;0;0;.00nan;0;0
17739;10322;838;0;0;0;0;.00nan;0;0
17739;47754;841;40;34;5;29;.853;3600000;0
17739;47864;841;0;0;0;0;.00nan;0;0
17739;94240;838;59;24;2;22;.917;3600000;0
17740;5573;2488;0;0;0;0;.00nan;0;0
17740;38277;845;50;27;4;23;.852;3600000;0
17740;77730;845;0;0;0;0;.00nan;0;0
17740;91202;2488;70;26;1;25;.962;3600000;0
17741;16588;843;0;0;0;0;.00nan;0;0
17741;31439;835;0;0;0;0;.00nan;0;0
17741;78920;835;49;25;4;21;.840;3619000;0
17741;89874;843;76;34;3;31;.912;3619000;0
17742;11751;846;64;32;3;29;.906;3548000;0
17742;13715;846;0;0;0;0;.00nan;0;0
17742;16907;2517;0;0;0;0;.00nan;0;0
17742;47728;2517;91;32;2;30;.938;3600000;0
17743;30696;2508;60;42;5;37;.881;3600000;0
17743;31439;835;0;0;0;0;.00nan;0;0
17743;47741;2508;0;0;0;0;.00nan;0;0
17743;78920;835;77;26;1;25;.962;3600000;0
17744;5573;2488;0;0;0;0;.00nan;0;0
17744;10322;838;0;0;0;0;.00nan;0;0
17744;91202;2488;70;35;3;32;.914;3900000;0
17744;94240;838;55;17;3;14;.824;3900000;0
17745;16907;2517;96;51;3;48;.941;3600000;0
17745;38277;845;0;0;0;0;.00nan;0;0
17745;47728;2517;0;0;0;0;.00nan;0;0
17745;77730;845;26;17;5;12;.706;3582000;0
17746;16588;843;49;18;3;15;.833;1619000;0
17746;47754;841;69;15;1;14;.933;3600000;0
17746;47864;841;0;0;0;0;.00nan;0;0
17746;89874;843;25;21;5;16;.762;1981000;0
17747;167824;2493;45;40;6;34;.850;3600000;0
17747;11751;846;64;19;2;17;.895;3600000;0
17747;13715;846;0;0;0;0;.00nan;0;0
17747;62975;2493;0;0;0;0;.00nan;0;0
17748;5573;2488;0;0;0;0;.00nan;0;0
17748;47754;841;71;16;1;15;.938;3600000;0
17748;47864;841;0;0;0;0;.00nan;0;0
17748;91202;2488;72;33;2;31;.939;3577000;0
17749;167824;2493;72;31;2;29;.935;3600000;0
17749;16588;843;0;0;0;0;.00nan;0;0
17749;62975;2493;0;0;0;0;.00nan;0;0
17749;89874;843;66;31;3;28;.903;3600000;0
17750;10322;838;63;15;1;14;.933;3600000;0
17750;11751;846;65;39;4;35;.897;3600000;0
17750;13715;846;0;0;0;0;.00nan;0;0
17750;94240;838;0;0;0;0;.00nan;0;0
17751;31439;835;0;0;0;0;.00nan;0;0
17751;38277;845;63;20;3;17;.850;3600000;0
17751;77730;845;0;0;0;0;.00nan;0;0
17751;78920;835;57;40;5;35;.875;3560000;0
17752;16907;2517;74;32;2;30;.938;3691000;0
17752;30696;2508;79;37;3;34;.919;3691000;0
17752;47728;2517;0;0;0;0;.00nan;0;0
17752;47741;2508;0;0;0;0;.00nan;0;0
17753;30696;2508;0;0;0;0;.00nan;0;0
17753;38277;845;67;17;1;16;.941;3600000;0
17753;47741;2508;91;44;3;41;.932;3526000;0
17753;77730;845;0;0;0;0;.00nan;0;0
17754;10322;838;0;0;0;0;.00nan;0;0
17754;31439;835;0;0;0;0;.00nan;0;0
17754;78920;835;63;35;4;31;.886;3538000;0
17754;94240;838;67;26;2;24;.923;3600000;0
17755;16588;843;60;30;3;27;.900;3684000;0
17755;16907;2517;82;42;4;38;.905;3684000;0
17755;47728;2517;0;0;0;0;.00nan;0;0
17755;89874;843;0;0;0;0;.00nan;0;0
17756;11751;846;68;11;0;11;1.000;1726000;0
17756;13715;846;11;18;6;12;.667;1874000;0
17756;47754;841;50;23;3;20;.870;3600000;0
17756;47864;841;0;0;0;0;.00nan;0;0
17757;30696;2508;57;28;4;24;.857;3600000;0
17757;47741;2508;0;0;0;0;.00nan;0;0
17757;47754;841;57;26;3;23;.885;3600000;0
17757;47864;841;0;0;0;0;.00nan;0;0
17758;5573;2488;0;0;0;0;.00nan;0;0
17758;167824;2493;0;0;0;0;.00nan;0;0
17758;62975;2493;93;47;3;44;.936;3900000;0
17758;91202;2488;61;20;3;17;.850;3900000;0
17759;167824;2493;73;37;3;34;.919;3551000;0
17759;47754;841;0;0;0;0;.00nan;0;0
17759;47864;841;71;27;2;25;.926;3600000;0
17759;62975;2493;0;0;0;0;.00nan;0;0
17760;5573;2488;0;0;0;0;.00nan;0;0
17760;30696;2508;48;36;6;30;.833;3600000;0
17760;47741;2508;0;0;0;0;.00nan;0;0
17760;91202;2488;74;27;2;25;.926;3600000;0
17761;10322;838;55;10;1;9;.900;3600000;0
17761;38277;845;71;37;4;33;.892;3600000;0
17761;77730;845;0;0;0;0;.00nan;0;0
17761;94240;838;0;0;0;0;.00nan;0;0
17762;16907;2517;98;60;4;56;.933;3600000;0
17762;31439;835;0;0;0;0;.00nan;0;0
17762;47728;2517;0;0;0;0;.00nan;0;0
17762;78920;835;88;19;0;19;1.000;3600000;0
17763;11751;846;66;17;1;16;.941;3585000;0
17763;13715;846;0;0;0;0;.00nan;0;0
17763;16588;843;0;0;0;0;.00nan;0;0
17763;89874;843;100;26;0;26;1.000;3600000;0
17764;10322;838;37;17;4;13;.765;3600000;0
17764;30696;2508;0;0;0;0;.00nan;0;0
17764;47741;2508;88;64;6;58;.906;3579000;0
17764;94240;838;0;0;0;0;.00nan;0;0
17765;5573;2488;0;0;0;0;.00nan;0;0
17765;16588;843;0;0;0;0;.00nan;0;0
17765;89874;843;83;34;2;32;.941;3600000;0
17765;91202;2488;82;30;1;29;.967;3600000;0
17766;167824;2493;96;35;1;34;.971;3600000;0
17766;38277;845;65;25;2;23;.920;3576000;0
17766;62975;2493;0;0;0;0;.00nan;0;0
17766;77730;845;0;0;0;0;.00nan;0;0
17767;11751;846;55;45;6;39;.867;3172000;0
17767;13715;846;45;5;1;4;.800;428000;0
17767;31439;835;0;0;0;0;.00nan;0;0
17767;78920;835;55;22;3;19;.864;3600000;0
17768;16907;2517;99;34;1;33;.971;3600000;0
17768;47728;2517;0;0;0;0;.00nan;0;0
17768;47754;841;82;36;2;34;.944;3544000;0
17768;47864;841;0;0;0;0;.00nan;0;0
17769;11751;846;67;39;4;35;.897;3600000;0
17769;13715;846;0;0;0;0;.00nan;0;0
17769;16907;2517;0;0;0;0;.00nan;0;0
17769;47728;2517;35;26;5;21;.808;3548000;0
17770;167824;2493;81;40;3;37;.925;3600000;0
17770;31439;835;0;0;0;0;.00nan;0;0
17770;62975;2493;0;0;0;0;.00nan;0;0
17770;78920;835;56;29;4;25;.862;3550000;0
17771;10322;838;0;0;0;0;.00nan;0;0
17771;16907;2517;84;55;4;51;.927;3578000;0
17771;47728;2517;0;0;0;0;.00nan;0;0
17771;94240;838;53;16;2;14;.875;3600000;0
17772;16588;843;66;39;4;35;.897;3600000;0
17772;38277;845;88;32;1;31;.969;3600000;0
17772;77730;845;0;0;0;0;.00nan;0;0
17772;89874;843;0;0;0;0;.00nan;0;0
17773;5573;2488;0;0;0;0;.00nan;0;0
17773;11751;846;62;25;3;22;.880;3600000;0
17773;13715;846;0;0;0;0;.00nan;0;0
17773;91202;2488;87;37;2;35;.946;3600000;0
17774;30696;2508;65;33;4;29;.879;3523000;0
17774;47741;2508;0;0;0;0;.00nan;0;0
17774;47754;841;77;34;2;32;.941;3600000;0
17774;47864;841;0;0;0;0;.00nan;0;0
17775;5573;2488;0;0;0;0;.00nan;0;0
17775;167824;2493;85;32;2;30;.938;3600000;0
17775;62975;2493;0;0;0;0;.00nan;0;0
17775;91202;2488;87;29;1;28;.966;3600000;0
17776;30696;2508;0;0;0;0;.00nan;0;0
17776;38277;845;44;25;4;21;.840;3600000;0
17776;47741;2508;53;31;5;26;.839;3587000;0
17776;77730;845;0;0;0;0;.00nan;0;0
17777;10322;838;0;0;0;0;.00nan;0;0
17777;31439;835;0;0;0;0;.00nan;0;0
17777;78920;835;32;25;6;19;.760;3600000;0
17777;94240;838;78;29;2;27;.931;3600000;0
17778;16588;843;96;32;0;32;1.000;3027000;0
17778;16907;2517;67;23;2;21;.913;3600000;0
17778;47728;2517;0;0;0;0;.00nan;0;0
17778;89874;843;23;6;3;3;.500;562000;0
17779;5573;2488;0;0;0;0;.00nan;0;0
17779;30696;2508;77;31;2;29;.935;3561000;0
17779;47741;2508;0;0;0;0;.00nan;0;0
17779;91202;2488;74;23;1;22;.957;3600000;0
17780;167824;2493;32;43;8;35;.814;3135000;0
17780;47754;841;77;36;3;33;.917;3600000;0
17780;47864;841;0;0;0;0;.00nan;0;0
17780;62975;2493;50;1;0;1;1.000;465000;0
17781;10322;838;0;0;0;0;.00nan;0;0
17781;38277;845;86;47;4;43;.915;3550000;0
17781;77730;845;0;0;0;0;.00nan;0;0
17781;94240;838;57;18;2;16;.889;3600000;0
17782;16907;2517;62;39;5;34;.872;3555000;0
17782;31439;835;0;0;0;0;.00nan;0;0
17782;47728;2517;0;0;0;0;.00nan;0;0
17782;78920;835;59;30;4;26;.867;3600000;0
17783;11751;846;63;18;1;17;.944;3600000;0
17783;13715;846;0;0;0;0;.00nan;0;0
17783;16588;843;0;0;0;0;.00nan;0;0
17783;89874;843;72;54;5;49;.907;3600000;0
17784;38277;845;71;41;4;37;.902;3900000;0
17784;47754;841;0;0;0;0;.00nan;0;0
17784;47864;841;68;33;4;29;.879;3900000;0
17784;77730;845;0;0;0;0;.00nan;0;0
17785;167824;2493;57;43;5;38;.884;3600000;0
17785;16907;2517;77;21;1;20;.952;3600000;0
17785;47728;2517;0;0;0;0;.00nan;0;0
17785;62975;2493;0;0;0;0;.00nan;0;0
17786;5573;2488;0;0;0;0;.00nan;0;0
17786;31439;835;0;0;0;0;.00nan;0;0
17786;78920;835;100;28;0;28;1.000;3600000;0
17786;91202;2488;70;39;3;36;.923;3600000;0
17787;10322;838;0;0;0;0;.00nan;0;0
17787;16588;843;0;0;0;0;.00nan;0;0
17787;89874;843;77;56;6;50;.893;3600000;0
17787;94240;838;52;18;2;16;.889;3600000;0
17788;11751;846;0;0;0;0;.00nan;0;0
17788;13715;846;100;25;0;25;1.000;3600000;0
17788;30696;2508;79;38;3;35;.921;3600000;0
17788;47741;2508;0;0;0;0;.00nan;0;0
17789;16588;843;0;0;0;0;.00nan;0;0
17789;30696;2508;0;0;0;0;.00nan;0;0
17789;47741;2508;61;31;3;28;.903;3781000;0
17789;89874;843;65;36;4;32;.889;3781000;0
17790;10322;838;0;0;0;0;.00nan;0;0
17790;167824;2493;81;37;3;34;.919;3592000;0
17790;62975;2493;0;0;0;0;.00nan;0;0
17790;94240;838;65;16;1;15;.938;3600000;0
17791;11751;846;0;0;0;0;.00nan;0;0
17791;13715;846;67;24;2;22;.917;3900000;0
17791;38277;845;73;29;2;27;.931;3900000;0
17791;77730;845;0;0;0;0;.00nan;0;0
17792;31439;835;0;0;0;0;.00nan;0;0
17792;47754;841;65;29;3;26;.897;3549000;0
17792;47864;841;0;0;0;0;.00nan;0;0
17792;78920;835;50;16;2;14;.875;3600000;0
17793;5573;2488;0;0;0;0;.00nan;0;0
17793;16907;2517;0;0;0;0;.00nan;0;0
17793;47728;2517;62;29;3;26;.897;3543000;0
17793;91202;2488;55;20;2;18;.900;3600000;0
17794;10322;838;0;0;0;0;.00nan;0;0
17794;47754;841;53;40;6;34;.850;3600000;0
17794;47864;841;0;0;0;0;.00nan;0;0
17794;94240;838;54;21;3;18;.857;3600000;0
17795;167824;2493;62;31;3;28;.903;3600000;0
17795;30696;2508;99;36;2;34;.944;3600000;0
17795;47741;2508;0;0;0;0;.00nan;0;0
17795;62975;2493;0;0;0;0;.00nan;0;0
17796;5573;2488;0;0;0;0;.00nan;0;0
17796;38277;845;53;41;5;36;.878;3600000;0
17796;77730;845;0;0;0;0;.00nan;0;0
17796;91202;2488;87;34;2;32;.941;3600000;0
17797;16588;843;47;12;2;10;.833;1143000;0
17797;31439;835;0;0;0;0;.00nan;0;0
17797;78920;835;55;17;2;15;.882;3600000;0
17797;89874;843;23;31;7;24;.774;2457000;0
17798;11751;846;61;19;2;17;.895;3600000;0
17798;13715;846;0;0;0;0;.00nan;0;0
17798;16907;2517;37;12;3;9;.750;484000;0
17798;47728;2517;38;35;6;29;.829;3116000;0
17799;16588;843;0;0;0;0;.00nan;0;0
17799;47754;841;28;24;6;18;.750;3118000;0
17799;47864;841;51;6;1;5;.833;482000;0
17799;89874;843;89;30;1;29;.967;3600000;0
17800;167824;2493;96;40;1;39;.975;3600000;0
17800;11751;846;42;19;3;16;.842;3600000;0
17800;13715;846;0;0;0;0;.00nan;0;0
17800;62975;2493;0;0;0;0;.00nan;0;0
17801;5573;2488;0;0;0;0;.00nan;0;0
17801;10322;838;0;0;0;0;.00nan;0;0
17801;91202;2488;98;48;2;46;.958;3900000;0
17801;94240;838;72;23;2;21;.913;3900000;0
17802;30696;2508;58;32;4;28;.875;3578000;0
17802;31439;835;0;0;0;0;.00nan;0;0
17802;47741;2508;0;0;0;0;.00nan;0;0
17802;78920;835;66;27;3;24;.889;3600000;0
17803;16907;2517;22;26;6;20;.769;2261000;0
17803;38277;845;30;21;5;16;.762;3600000;0
17803;47728;2517;69;16;1;15;.938;1291000;0
17803;77730;845;0;0;0;0;.00nan;0;0
17804;16907;2517;72;27;2;25;.926;3600000;0
17804;30696;2508;54;3;0;3;1.000;271000;0
17804;47728;2517;0;0;0;0;.00nan;0;0
17804;47741;2508;41;43;6;37;.860;3329000;0
17805;5573;2488;0;0;0;0;.00nan;0;0
17805;47754;841;56;29;4;25;.862;3600000;0
17805;47864;841;0;0;0;0;.00nan;0;0
17805;91202;2488;68;19;1;18;.947;3600000;0
17806;31439;835;0;0;0;0;.00nan;0;0
17806;38277;845;38;38;7;31;.816;3600000;0
17806;77730;845;0;0;0;0;.00nan;0;0
17806;78920;835;86;32;2;30;.938;3600000;0
17807;167824;2493;99;40;1;39;.975;3600000;0
17807;16588;843;0;0;0;0;.00nan;0;0
17807;62975;2493;0;0;0;0;.00nan;0;0
17807;89874;843;41;25;4;21;.840;3600000;0
17808;10322;838;0;0;0;0;.00nan;0;0
17808;11751;846;69;29;3;26;.897;3600000;0
17808;13715;846;0;0;0;0;.00nan;0;0
17808;94240;838;56;33;4;29;.879;3578000;0
17810;11751;846;72;18;1;17;.944;3600000;0
17810;16711;841;0;0;0;0;.00nan;0;0
17810;47754;841;45;39;6;33;.846;3600000;0
17810;54885;846;0;0;0;0;.00nan;0;0
17812;5573;2488;0;0;0;0;.00nan;0;0
17812;10322;838;0;0;0;0;.00nan;0;0
17812;91202;2488;59;37;4;33;.892;3600000;0
17812;94240;838;79;29;1;28;.966;3600000;0
17814;16588;843;0;0;0;0;.00nan;0;0
17814;30696;2508;54;33;5;28;.848;3600000;0
17814;47741;2508;0;0;0;0;.00nan;0;0
17814;89874;843;47;25;4;21;.840;3600000;0
17816;167824;2493;70;33;3;30;.909;3890000;0
17816;47982;845;0;0;0;0;.00nan;0;0
17816;62975;2493;0;0;0;0;.00nan;0;0
17816;77730;845;73;21;2;19;.905;3890000;0
17818;16907;2517;92;32;1;31;.969;3600000;0
17818;31439;835;0;0;0;0;.00nan;0;0
17818;47728;2517;0;0;0;0;.00nan;0;0
17818;78920;835;69;22;2;20;.909;3595000;0
17820;31439;835;99;24;0;24;1.000;3600000;0
17820;47982;845;17;7;4;3;.429;1150000;0
17820;77730;845;45;22;3;19;.864;2450000;0
17820;78920;835;0;0;0;0;.00nan;0;0
17822;16711;841;56;24;3;21;.875;3608000;0
17822;30696;2508;0;0;0;0;.00nan;0;0
17822;47741;2508;56;31;4;27;.871;3608000;0
17822;47754;841;0;0;0;0;.00nan;0;0
17824;10322;838;36;18;4;14;.778;3600000;0
17824;16907;2517;45;36;5;31;.861;3600000;0
17824;47728;2517;0;0;0;0;.00nan;0;0
17824;94240;838;0;0;0;0;.00nan;0;0
17826;5573;2488;63;21;2;19;.905;3600000;0
17826;11751;846;0;0;0;0;.00nan;0;0
17826;54885;846;64;30;3;27;.900;3544000;0
17826;91202;2488;0;0;0;0;.00nan;0;0
17828;167824;2493;0;0;0;0;.00nan;0;0
17828;16588;843;58;40;6;34;.850;3600000;0
17828;62975;2493;65;23;2;21;.913;3600000;0
17828;89874;843;0;0;0;0;.00nan;0;0
17830;11751;846;56;23;3;20;.870;3551000;0
17830;16588;843;0;0;0;0;.00nan;0;0
17830;54885;846;0;0;0;0;.00nan;0;0
17830;89874;843;86;29;1;28;.966;3600000;0
17832;16711;841;0;0;0;0;.00nan;0;0
17832;30696;2508;47;26;4;22;.846;3600000;0
17832;47741;2508;0;0;0;0;.00nan;0;0
17832;47754;841;86;18;0;18;1.000;3600000;0
17834;5573;2488;0;0;0;0;.00nan;0;0
17834;167824;2493;90;46;2;44;.957;3600000;0
17834;62975;2493;0;0;0;0;.00nan;0;0
17834;91202;2488;50;22;3;19;.864;3546000;0
17836;10322;838;57;16;2;14;.875;3600000;0
17836;47982;845;56;44;5;39;.886;3600000;0
17836;77730;845;0;0;0;0;.00nan;0;0
17836;94240;838;0;0;0;0;.00nan;0;0
17838;16907;2517;64;38;5;33;.868;3600000;0
17838;31439;835;54;21;2;19;.905;3600000;0
17838;47728;2517;0;0;0;0;.00nan;0;0
17838;78920;835;0;0;0;0;.00nan;0;0
17840;16588;843;68;45;5;40;.889;3600000;0
17840;31439;835;0;0;0;0;.00nan;0;0
17840;78920;835;66;16;1;15;.938;3600000;0
17840;89874;843;0;0;0;0;.00nan;0;0
17842;167824;2493;0;0;0;0;.00nan;0;0
17842;16711;841;0;0;0;0;.00nan;0;0
17842;47754;841;93;27;1;26;.963;3600000;0
17842;62975;2493;42;41;7;34;.829;3600000;0
17844;16907;2517;0;0;0;0;.00nan;0;0
17844;47728;2517;78;33;3;30;.909;3655000;0
17844;47982;845;0;0;0;0;.00nan;0;0
17844;77730;845;73;27;2;25;.926;3655000;0
17846;5573;2488;77;31;2;29;.935;3600000;0
17846;10322;838;0;0;0;0;.00nan;0;0
17846;91202;2488;0;0;0;0;.00nan;0;0
17846;94240;838;63;33;4;29;.879;3592000;0
17848;11751;846;0;0;0;0;.00nan;0;0
17848;30696;2508;0;0;0;0;.00nan;0;0
17848;47741;2508;70;22;1;21;.955;3600000;0
17848;54885;846;57;35;4;31;.886;3600000;0
17850;16588;843;0;0;0;0;.00nan;0;0
17850;47982;845;72;20;1;19;.950;3600000;0
17850;77730;845;0;0;0;0;.00nan;0;0
17850;89874;843;73;43;4;39;.907;3600000;0
17852;167824;2493;67;27;2;25;.926;3600000;0
17852;30696;2508;91;35;1;34;.971;3600000;0
17852;47741;2508;0;0;0;0;.00nan;0;0
17852;62975;2493;0;0;0;0;.00nan;0;0
17854;5573;2488;0;0;0;0;.00nan;0;0
17854;10322;838;100;22;0;22;1.000;3600000;0
17854;91202;2488;52;35;5;30;.857;3600000;0
17854;94240;838;0;0;0;0;.00nan;0;0
17856;11751;846;0;0;0;0;.00nan;0;0
17856;31439;835;0;0;0;0;.00nan;0;0
17856;54885;846;100;31;0;31;1.000;3600000;0
17856;78920;835;56;17;1;16;.941;3547000;0
17858;16711;841;0;0;0;0;.00nan;0;0
17858;16907;2517;100;20;0;20;1.000;3600000;0
17858;47728;2517;0;0;0;0;.00nan;0;0
17858;47754;841;69;26;2;24;.923;3582000;0
17860;16907;2517;85;42;3;39;.929;3600000;0
17860;47728;2517;0;0;0;0;.00nan;0;0
17860;47982;845;0;0;0;0;.00nan;0;0
17860;77730;845;61;20;2;18;.900;3600000;0
17862;5573;2488;53;30;4;26;.867;3518000;0
17862;16711;841;81;32;2;30;.938;3600000;0
17862;47754;841;0;0;0;0;.00nan;0;0
17862;91202;2488;0;0;0;0;.00nan;0;0
17864;10322;838;58;18;2;16;.889;3900000;0
17864;167824;2493;0;0;0;0;.00nan;0;0
17864;62975;2493;95;40;2;38;.950;3900000;0
17864;94240;838;0;0;0;0;.00nan;0;0
17866;16588;843;84;20;0;20;1.000;3600000;0
17866;30696;2508;0;0;0;0;.00nan;0;0
17866;47741;2508;60;28;4;24;.857;3600000;0
17866;89874;843;0;0;0;0;.00nan;0;0
17868;11751;846;0;0;0;0;.00nan;0;0
17868;31439;835;44;18;3;15;.833;3600000;0
17868;54885;846;57;31;4;27;.871;3545000;0
17868;78920;835;0;0;0;0;.00nan;0;0
17870;11751;846;96;41;2;39;.951;3900000;0
17870;31439;835;63;24;2;22;.917;3900000;0
17870;54885;846;0;0;0;0;.00nan;0;0
17870;78920;835;0;0;0;0;.00nan;0;0
17872;5573;2488;0;0;0;0;.00nan;0;0
17872;167824;2493;56;28;4;24;.857;3560000;0
17872;62975;2493;0;0;0;0;.00nan;0;0
17872;91202;2488;87;34;2;32;.941;3600000;0
17874;10322;838;63;14;2;12;.857;3900000;0
17874;16711;841;0;0;0;0;.00nan;0;0
17874;47754;841;97;53;2;51;.962;3900000;0
17874;94240;838;0;0;0;0;.00nan;0;0
17876;16588;843;65;35;3;32;.914;3531000;0
17876;16907;2517;67;16;1;15;.938;3600000;0
17876;47728;2517;0;0;0;0;.00nan;0;0
17876;89874;843;0;0;0;0;.00nan;0;0
17878;30696;2508;0;0;0;0;.00nan;0;0
17878;47741;2508;65;29;3;26;.897;3600000;0
17878;47982;845;68;23;2;21;.913;3600000;0
17878;77730;845;0;0;0;0;.00nan;0;0
536;10322;838;0;0;0;0;.00nan;0;0
536;16907;2517;97;40;1;39;.975;3600000;0
536;47728;2517;0;0;0;0;.00nan;0;0
536;94240;838;59;22;3;19;.864;3547000;0
537;167824;2493;39;39;7;32;.821;3600000;0
537;31439;835;0;0;0;0;.00nan;0;0
537;62975;2493;0;0;0;0;.00nan;0;0
537;78920;835;100;23;0;23;1.000;3600000;0
538;180287;2488;0;0;0;0;.00nan;0;0
538;38277;845;64;31;3;28;.903;3543000;0
538;77730;845;0;0;0;0;.00nan;0;0
538;91202;2488;80;30;2;28;.933;3600000;0
539;11751;846;74;29;3;26;.897;3600000;0
539;13715;846;0;0;0;0;.00nan;0;0
539;47754;841;95;42;2;40;.952;3600000;0
539;47864;841;0;0;0;0;.00nan;0;0
540;10322;838;0;0;0;0;.00nan;0;0
540;16907;2517;53;33;4;29;.879;3600000;0
540;47728;2517;0;0;0;0;.00nan;0;0
540;94240;838;99;28;0;28;1.000;3600000;0
541;167824;2493;64;43;6;37;.860;3600000;0
541;31439;835;0;0;0;0;.00nan;0;0
541;62975;2493;0;0;0;0;.00nan;0;0
541;78920;835;80;29;2;27;.931;3600000;0
542;180287;2488;0;0;0;0;.00nan;0;0
542;38277;845;71;29;2;27;.931;3641000;0
542;77730;845;0;0;0;0;.00nan;0;0
542;91202;2488;91;44;3;41;.932;3641000;0
543;11751;846;43;20;4;16;.800;3564000;0
543;13715;846;0;0;0;0;.00nan;0;0
543;47754;841;66;17;1;16;.941;3600000;0
543;47864;841;0;0;0;0;.00nan;0;0
544;10322;838;0;0;0;0;.00nan;0;0
544;16907;2517;69;40;4;36;.900;3575000;0
544;47728;2517;0;0;0;0;.00nan;0;0
544;94240;838;67;24;2;22;.917;3600000;0
545;167824;2493;23;14;4;10;.714;1121000;0
545;31439;835;0;0;0;0;.00nan;0;0
545;62975;2493;74;32;2;30;.938;2479000;0
545;78920;835;90;24;1;23;.958;3600000;0
546;180287;2488;0;0;0;0;.00nan;0;0
546;38277;845;67;21;2;19;.905;3600000;0
546;77730;845;0;0;0;0;.00nan;0;0
546;91202;2488;65;31;4;27;.871;3549000;0
547;11751;846;19;22;6;16;.727;3600000;0
547;13715;846;0;0;0;0;.00nan;0;0
547;47754;841;64;46;5;41;.891;3600000;0
547;47864;841;0;0;0;0;.00nan;0;0
548;10322;838;0;0;0;0;.00nan;0;0
548;16907;2517;72;61;4;57;.934;3600000;0
548;47728;2517;0;0;0;0;.00nan;0;0
548;94240;838;53;30;5;25;.833;3581000;0
549;167824;2493;91;46;2;44;.957;3600000;0
549;31439;835;0;0;0;0;.00nan;0;0
549;62975;2493;0;0;0;0;.00nan;0;0
549;78920;835;53;23;3;20;.870;3554000;0
550;180287;2488;0;0;0;0;.00nan;0;0
550;38277;845;100;28;0;28;1.000;3600000;0
550;77730;845;0;0;0;0;.00nan;0;0
550;91202;2488;39;28;5;23;.821;3600000;0
551;11751;846;65;30;2;28;.933;4390000;0
551;13715;846;0;0;0;0;.00nan;0;0
551;47754;841;92;44;3;41;.932;4390000;0
551;47864;841;0;0;0;0;.00nan;0;0
584;10322;838;0;0;0;0;.00nan;0;0
584;16907;2517;82;48;4;44;.917;3737000;0
584;47728;2517;0;0;0;0;.00nan;0;0
584;94240;838;48;17;3;14;.824;3737000;0
585;167824;2493;38;36;6;30;.833;3053000;0
585;31439;835;0;0;0;0;.00nan;0;0
585;62975;2493;50;10;1;9;.900;547000;0
585;78920;835;88;31;1;30;.968;3600000;0
586;180287;2488;0;0;0;0;.00nan;0;0
586;38277;845;99;26;0;26;1.000;3600000;0
586;77730;845;0;0;0;0;.00nan;0;0
586;91202;2488;77;32;3;29;.906;3600000;0
587;11751;846;23;24;6;18;.750;2434000;0
587;13715;846;74;16;0;16;1.000;1166000;0
587;47754;841;89;26;2;24;.923;3600000;0
587;47864;841;0;0;0;0;.00nan;0;0
588;10322;838;0;0;0;0;.00nan;0;0
588;16907;2517;100;47;1;46;.979;3600000;0
588;47728;2517;0;0;0;0;.00nan;0;0
588;94240;838;57;19;2;17;.895;3561000;0
589;10322;838;0;0;0;0;.00nan;0;0
589;16907;2517;53;31;4;27;.871;3600000;0
589;47728;2517;0;0;0;0;.00nan;0;0
589;94240;838;71;17;1;16;.941;3600000;0
602;10322;838;0;0;0;0;.00nan;0;0
602;38277;845;64;32;3;29;.906;3539000;0
602;77730;845;0;0;0;0;.00nan;0;0
602;94240;838;84;27;1;26;.963;3600000;0
603;31439;835;44;11;2;9;.818;1756000;0
603;47754;841;88;36;1;35;.972;3600000;0
603;47864;841;0;0;0;0;.00nan;0;0
603;78920;835;28;21;6;15;.714;1844000;0
604;10322;838;0;0;0;0;.00nan;0;0
604;38277;845;62;31;3;28;.903;3600000;0
604;77730;845;0;0;0;0;.00nan;0;0
604;94240;838;99;24;0;24;1.000;3600000;0
605;31439;835;0;0;0;0;.00nan;0;0
605;47754;841;24;22;5;17;.773;2385000;0
605;47864;841;52;14;2;12;.857;1215000;0
605;78920;835;73;20;1;19;.950;3600000;0
606;10322;838;0;0;0;0;.00nan;0;0
606;38277;845;55;26;3;23;.885;3600000;0
606;77730;845;0;0;0;0;.00nan;0;0
606;94240;838;79;28;1;27;.964;3600000;0
607;31439;835;0;0;0;0;.00nan;0;0
607;47754;841;66;32;3;29;.906;4133000;0
607;47864;841;0;0;0;0;.00nan;0;0
607;78920;835;74;33;2;31;.939;4133000;0
608;10322;838;0;0;0;0;.00nan;0;0
608;38277;845;64;27;2;25;.926;4151000;0
608;77730;845;0;0;0;0;.00nan;0;0
608;94240;838;62;32;3;29;.906;4151000;0
609;31439;835;0;0;0;0;.00nan;0;0
609;47754;841;100;41;1;40;.976;3998000;0
609;47864;841;0;0;0;0;.00nan;0;0
609;78920;835;63;20;2;18;.900;3998000;0
691;10322;838;0;0;0;0;.00nan;0;0
691;38277;845;78;38;3;35;.921;3600000;0
691;77730;845;0;0;0;0;.00nan;0;0
691;94240;838;78;29;2;27;.931;3600000;0
692;31439;835;0;0;0;0;.00nan;0;0
692;47754;841;35;32;6;26;.813;2726000;0
692;47864;841;56;5;0;5;1.000;874000;0
692;78920;835;61;25;3;22;.880;3600000;0
733;31439;835;0;0;0;0;.00nan;0;0
733;47754;841;44;40;6;34;.850;3589000;0
733;47864;841;0;0;0;0;.00nan;0;0
733;78920;835;48;29;5;24;.828;3600000;0
764;10322;838;0;0;0;0;.00nan;0;0
764;31439;835;0;0;0;0;.00nan;0;0
764;78920;835;99;34;1;33;.971;3600000;0
764;94240;838;74;33;2;31;.939;3558000;0
765;10322;838;0;0;0;0;.00nan;0;0
765;31439;835;0;0;0;0;.00nan;0;0
765;78920;835;52;46;6;40;.870;3600000;0
765;94240;838;43;17;3;14;.824;3600000;0
766;10322;838;0;0;0;0;.00nan;0;0
766;31439;835;0;0;0;0;.00nan;0;0
766;78920;835;74;32;3;29;.906;3550000;0
766;94240;838;82;32;2;30;.938;3600000;0
767;10322;838;0;0;0;0;.00nan;0;0
767;31439;835;0;0;0;0;.00nan;0;0
767;78920;835;99;39;1;38;.974;3600000;0
767;94240;838;67;18;2;16;.889;3560000;0
839;10322;838;0;0;0;0;.00nan;0;0
839;31439;835;0;0;0;0;.00nan;0;0
839;78920;835;38;30;6;24;.800;3600000;0
839;94240;838;70;19;1;18;.947;3600000;0
853;10322;838;0;0;0;0;.00nan;0;0
853;31439;835;0;0;0;0;.00nan;0;0
853;78920;835;97;36;1;35;.972;3600000;0
853;94240;838;45;20;3;17;.850;3551000;0
880;10322;838;0;0;0;0;.00nan;0;0
880;31439;835;0;0;0;0;.00nan;0;0
880;78920;835;90;46;3;43;.935;3600000;0
880;94240;838;90;23;0;23;1.000;3600000;0
17879;63830;521;76;32;3;29;.906;3532000;0
17879;89998;523;75;26;1;25;.962;3600000;0
17879;143191;523;0;0;0;0;.00nan;0;0
17879;143523;521;0;0;0;0;.00nan;0;0
17880;63848;1871;100;25;0;25;1.000;3600000;0
17880;143063;1871;0;0;0;0;.00nan;0;0
17880;143256;1869;0;0;0;0;.00nan;0;0
17880;143412;1869;57;36;5;31;.861;3600000;0
17881;7332;2193;0;0;0;0;.00nan;0;0
17881;9373;1854;44;34;5;29;.853;3600000;0
17881;64271;2193;79;21;1;20;.952;3600000;0
17881;155664;1854;0;0;0;0;.00nan;0;0
17882;167036;517;0;0;0;0;.00nan;0;0
17882;46912;2173;70;32;3;29;.906;3600000;0
17882;56058;2173;0;0;0;0;.00nan;0;0
17882;62530;517;36;22;4;18;.818;3600000;0
17883;6944;1872;69;23;1;22;.957;3600000;0
17883;54658;4962;38;17;4;13;.765;1049000;0
17883;55495;4962;53;19;2;17;.895;2551000;0
17883;84287;1872;0;0;0;0;.00nan;0;0
17884;177519;1477;0;0;0;0;.00nan;0;0
17884;8035;522;41;21;4;17;.810;2156000;0
17884;174581;1477;79;39;3;36;.923;3600000;0
17884;54290;522;52;9;1;8;.889;1376000;0
17885;185051;1877;0;0;0;0;.00nan;0;0
17885;56231;1861;56;16;3;13;.813;3900000;0
17885;143100;1877;72;34;3;31;.912;3900000;0
17885;152464;1861;0;0;0;0;.00nan;0;0
17886;56231;1861;100;26;0;26;1.000;3600000;0
17886;63830;521;69;26;2;24;.923;3517000;0
17886;143523;521;0;0;0;0;.00nan;0;0
17886;152464;1861;0;0;0;0;.00nan;0;0
17887;7332;2193;61;22;2;20;.909;3600000;0
17887;46912;2173;59;27;3;24;.889;3584000;0
17887;56058;2173;0;0;0;0;.00nan;0;0
17887;64271;2193;0;0;0;0;.00nan;0;0
17888;9373;1854;79;22;1;21;.955;3600000;0
17888;54658;4962;0;0;0;0;.00nan;0;0
17888;55495;4962;48;21;4;17;.810;3600000;0
17888;155664;1854;0;0;0;0;.00nan;0;0
17889;177519;1477;0;0;0;0;.00nan;0;0
17889;174581;1477;95;40;2;38;.950;3600000;0
17889;57426;1871;62;35;4;31;.886;2938000;0
17889;63848;1871;13;11;5;6;.545;662000;0
17890;185051;1877;0;0;0;0;.00nan;0;0
17890;143100;1877;59;39;5;34;.872;3600000;0
17890;143256;1869;0;0;0;0;.00nan;0;0
17890;143412;1869;60;17;1;16;.941;3600000;0
17891;4622;523;86;35;2;33;.943;3597000;0
17891;8035;522;0;0;0;0;.00nan;0;0
17891;54290;522;79;23;1;22;.957;3600000;0
17891;89998;523;0;0;0;0;.00nan;0;0
17892;167036;517;0;0;0;0;.00nan;0;0
17892;6944;1872;70;26;2;24;.923;3600000;0
17892;62530;517;84;42;3;39;.929;3600000;0
17892;84287;1872;0;0;0;0;.00nan;0;0
17893;9373;1854;71;51;5;46;.902;3600000;0
17893;63830;521;72;18;1;17;.944;3600000;0
17893;143523;521;0;0;0;0;.00nan;0;0
17893;155664;1854;0;0;0;0;.00nan;0;0
17894;56231;1861;61;31;3;28;.903;3600000;0
17894;57426;1871;54;35;4;31;.886;3579000;0
17894;63848;1871;0;0;0;0;.00nan;0;0
17894;152464;1861;0;0;0;0;.00nan;0;0
17895;4622;523;85;30;2;28;.933;3900000;0
17895;7332;2193;68;28;2;26;.929;3900000;0
17895;64271;2193;0;0;0;0;.00nan;0;0
17895;89998;523;0;0;0;0;.00nan;0;0
17896;167036;517;71;22;1;21;.955;3889000;0
17896;62530;517;0;0;0;0;.00nan;0;0
17896;143256;1869;0;0;0;0;.00nan;0;0
17896;143412;1869;94;45;2;43;.956;3889000;0
17897;177519;1477;0;0;0;0;.00nan;0;0
17897;174581;1477;38;24;5;19;.792;3600000;0
17897;54658;4962;0;0;0;0;.00nan;0;0
17897;55495;4962;76;37;2;35;.946;3600000;0
17898;6944;1872;74;20;1;19;.950;3600000;0
17898;46912;2173;67;32;2;30;.938;3556000;0
17898;56058;2173;0;0;0;0;.00nan;0;0
17898;84287;1872;0;0;0;0;.00nan;0;0
17899;8035;522;0;0;0;0;.00nan;0;0
17899;185051;1877;0;0;0;0;.00nan;0;0
17899;54290;522;75;18;1;17;.944;3600000;0
17899;143100;1877;71;62;6;56;.903;3600000;0
17900;6944;1872;70;18;1;17;.944;3600000;0
17900;56231;1861;0;0;0;0;.00nan;0;0
17900;84287;1872;0;0;0;0;.00nan;0;0
17900;152464;1861;64;30;4;26;.867;3600000;0
17901;46912;2173;0;0;0;0;.00nan;0;0
17901;54658;4962;0;0;0;0;.00nan;0;0
17901;55495;4962;100;24;0;24;1.000;3600000;0
17901;56058;2173;85;26;1;25;.962;3557000;0
17902;9373;1854;100;37;0;37;1.000;3600000;0
17902;57426;1871;55;12;1;11;.917;3558000;0
17902;63848;1871;0;0;0;0;.00nan;0;0
17902;155664;1854;0;0;0;0;.00nan;0;0
17903;167036;517;0;0;0;0;.00nan;0;0
17903;177519;1477;41;42;7;35;.833;3600000;0
17903;174581;1477;0;0;0;0;.00nan;0;0
17903;62530;517;58;31;4;27;.871;3600000;0
17904;7332;2193;43;30;5;25;.833;3574000;0
17904;64271;2193;0;0;0;0;.00nan;0;0
17904;143256;1869;64;28;3;25;.893;3600000;0
17904;143412;1869;0;0;0;0;.00nan;0;0
17905;4622;523;100;21;0;21;1.000;3600000;0
17905;185051;1877;0;0;0;0;.00nan;0;0
17905;89998;523;0;0;0;0;.00nan;0;0
17905;143100;1877;89;34;2;32;.941;3541000;0
17906;8035;522;0;0;0;0;.00nan;0;0
17906;54290;522;98;35;2;33;.943;3600000;0
17906;63830;521;51;28;4;24;.857;3567000;0
17906;143523;521;0;0;0;0;.00nan;0;0
17907;63830;521;100;27;0;27;1.000;3600000;0
17907;143256;1869;0;0;0;0;.00nan;0;0
17907;143412;1869;72;44;5;39;.886;3600000;0
17907;143523;521;0;0;0;0;.00nan;0;0
17908;185051;1877;0;0;0;0;.00nan;0;0
17908;57426;1871;0;0;0;0;.00nan;0;0
17908;63848;1871;52;11;1;10;.909;3600000;0
17908;143100;1877;81;38;2;36;.947;3584000;0
17909;9373;1854;49;36;6;30;.833;3218000;0
17909;46912;2173;70;26;2;24;.923;3600000;0
17909;56058;2173;0;0;0;0;.00nan;0;0
17909;155664;1854;53;3;0;3;1.000;382000;0
17910;7332;2193;0;0;0;0;.00nan;0;0
17910;8035;522;74;39;4;35;.897;3550000;0
17910;54290;522;0;0;0;0;.00nan;0;0
17910;64271;2193;65;33;3;30;.909;3600000;0
17911;167036;517;0;0;0;0;.00nan;0;0
17911;4622;523;64;24;2;22;.917;3511000;0
17911;62530;517;97;23;0;23;1.000;3600000;0
17911;89998;523;0;0;0;0;.00nan;0;0
17912;54658;4962;0;0;0;0;.00nan;0;0
17912;55495;4962;59;36;4;32;.889;3550000;0
17912;56231;1861;68;22;2;20;.909;3600000;0
17912;152464;1861;0;0;0;0;.00nan;0;0
17913;177519;1477;0;0;0;0;.00nan;0;0
17913;6944;1872;75;23;1;22;.957;3600000;0
17913;174581;1477;75;31;2;29;.935;3600000;0
17913;84287;1872;0;0;0;0;.00nan;0;0
17914;7332;2193;91;29;1;28;.966;3600000;0
17914;56231;1861;0;0;0;0;.00nan;0;0
17914;64271;2193;0;0;0;0;.00nan;0;0
17914;152464;1861;75;38;3;35;.921;3514000;0
17915;167036;517;0;0;0;0;.00nan;0;0
17915;9373;1854;78;40;3;37;.925;3825000;0
17915;62530;517;46;22;4;18;.818;3825000;0
17915;155664;1854;0;0;0;0;.00nan;0;0
17916;177519;1477;0;0;0;0;.00nan;0;0
17916;174581;1477;100;29;0;29;1.000;3600000;0
17916;46912;2173;0;0;0;0;.00nan;0;0
17916;56058;2173;34;29;6;23;.793;3600000;0
17917;6944;1872;0;0;0;0;.00nan;0;0
17917;84287;1872;57;35;4;31;.886;3600000;0
17917;143256;1869;0;0;0;0;.00nan;0;0
17917;143412;1869;71;21;1;20;.952;3600000;0
17918;4622;523;87;31;2;29;.935;3600000;0
17918;54658;4962;70;41;4;37;.902;3561000;0
17918;55495;4962;0;0;0;0;.00nan;0;0
17918;89998;523;0;0;0;0;.00nan;0;0
17919;8035;522;0;0;0;0;.00nan;0;0
17919;54290;522;71;40;4;36;.900;3521000;0
17919;57426;1871;0;0;0;0;.00nan;0;0
17919;63848;1871;52;16;2;14;.875;3600000;0
17920;185051;1877;41;44;7;37;.841;2288000;0
17920;63830;521;31;10;3;7;.700;3600000;0
17920;143100;1877;53;14;2;12;.857;1312000;0
17920;143523;521;0;0;0;0;.00nan;0;0
17921;4622;523;58;27;4;23;.852;3600000;0
17921;57426;1871;56;46;6;40;.870;3570000;0
17921;63848;1871;0;0;0;0;.00nan;0;0
17921;89998;523;0;0;0;0;.00nan;0;0
17922;46912;2173;61;21;2;19;.905;3600000;0
17922;56058;2173;0;0;0;0;.00nan;0;0
17922;56231;1861;61;21;3;18;.857;3569000;0
17922;152464;1861;0;0;0;0;.00nan;0;0
17923;177519;1477;0;0;0;0;.00nan;0;0
17923;174581;1477;44;17;3;14;.824;3600000;0
17923;143256;1869;0;0;0;0;.00nan;0;0
17923;143412;1869;99;44;2;42;.955;3600000;0
17924;7332;2193;0;0;0;0;.00nan;0;0
17924;63830;521;51;26;3;23;.885;3600000;0
17924;64271;2193;96;29;1;28;.966;3600000;0
17924;143523;521;0;0;0;0;.00nan;0;0
17925;167036;517;0;0;0;0;.00nan;0;0
17925;8035;522;74;43;4;39;.907;3600000;0
17925;54290;522;0;0;0;0;.00nan;0;0
17925;62530;517;81;28;1;27;.964;3600000;0
17926;185051;1877;63;6;0;6;1.000;1327000;0
17926;54658;4962;87;18;0;18;1.000;3600000;0
17926;55495;4962;0;0;0;0;.00nan;0;0
17926;143100;1877;41;25;5;20;.800;2273000;0
17927;6944;1872;64;17;1;16;.941;3600000;0
17927;9373;1854;83;46;3;43;.935;3529000;0
17927;84287;1872;0;0;0;0;.00nan;0;0
17927;155664;1854;0;0;0;0;.00nan;0;0
17928;57426;1871;0;0;0;0;.00nan;0;0
17928;63830;521;67;27;2;25;.926;3536000;0
17928;63848;1871;91;17;0;17;1.000;3600000;0
17928;143523;521;0;0;0;0;.00nan;0;0
17929;167036;517;0;0;0;0;.00nan;0;0
17929;56231;1861;72;33;3;30;.909;3600000;0
17929;62530;517;63;17;1;16;.941;3600000;0
17929;152464;1861;0;0;0;0;.00nan;0;0
17930;177519;1477;0;0;0;0;.00nan;0;0
17930;9373;1854;62;32;4;28;.875;3542000;0
17930;174581;1477;64;29;3;26;.897;3600000;0
17930;155664;1854;0;0;0;0;.00nan;0;0
17931;46912;2173;0;0;0;0;.00nan;0;0
17931;56058;2173;65;21;2;19;.905;3900000;0
17931;143256;1869;0;0;0;0;.00nan;0;0
17931;143412;1869;59;19;2;17;.895;3900000;0
17932;4622;523;76;33;3;30;.909;3559000;0
17932;6944;1872;67;20;1;19;.950;3600000;0
17932;84287;1872;0;0;0;0;.00nan;0;0
17932;89998;523;0;0;0;0;.00nan;0;0
17933;8035;522;0;0;0;0;.00nan;0;0
17933;54290;522;48;21;4;17;.810;3888000;0
17933;54658;4962;65;36;3;33;.917;3888000;0
17933;55495;4962;0;0;0;0;.00nan;0;0
17934;7332;2193;62;20;3;17;.850;3600000;0
17934;185051;1877;0;0;0;0;.00nan;0;0
17934;64271;2193;0;0;0;0;.00nan;0;0
17934;143100;1877;71;51;5;46;.902;3572000;0
17935;7332;2193;48;21;3;18;.857;3600000;0
17935;57426;1871;0;0;0;0;.00nan;0;0
17935;63848;1871;90;19;0;19;1.000;3600000;0
17935;64271;2193;0;0;0;0;.00nan;0;0
17936;4622;523;90;26;1;25;.962;3600000;0
17936;46912;2173;85;37;2;35;.946;3600000;0
17936;56058;2173;0;0;0;0;.00nan;0;0
17936;89998;523;0;0;0;0;.00nan;0;0
17937;177519;1477;23;28;6;22;.786;3600000;0
17937;174581;1477;0;0;0;0;.00nan;0;0
17937;56231;1861;0;0;0;0;.00nan;0;0
17937;152464;1861;100;33;1;32;.970;3600000;0
17938;9373;1854;53;19;2;17;.895;3600000;0
17938;143256;1869;85;38;3;35;.921;3542000;0
17938;143412;1869;0;0;0;0;.00nan;0;0
17938;155664;1854;0;0;0;0;.00nan;0;0
17939;167036;517;0;0;0;0;.00nan;0;0
17939;185051;1877;0;0;0;0;.00nan;0;0
17939;62530;517;100;25;0;25;1.000;3600000;0
17939;143100;1877;59;59;8;51;.864;3600000;0
17940;54658;4962;62;8;0;8;1.000;499000;0
17940;55495;4962;34;36;6;30;.833;3101000;0
17940;63830;521;56;21;2;19;.905;3600000;0
17940;143523;521;0;0;0;0;.00nan;0;0
17941;6944;1872;57;19;2;17;.895;3600000;0
17941;8035;522;75;32;3;29;.906;3553000;0
17941;54290;522;0;0;0;0;.00nan;0;0
17941;84287;1872;0;0;0;0;.00nan;0;0
17942;6944;1872;64;30;3;27;.900;3575000;0
17942;63830;521;89;39;2;37;.949;3600000;0
17942;84287;1872;0;0;0;0;.00nan;0;0
17942;143523;521;0;0;0;0;.00nan;0;0
17943;9373;1854;59;19;2;17;.895;3600000;0
17943;56231;1861;66;42;4;38;.905;3544000;0
17943;152464;1861;0;0;0;0;.00nan;0;0
17943;155664;1854;0;0;0;0;.00nan;0;0
17944;54658;4962;0;0;0;0;.00nan;0;0
17944;55495;4962;85;41;3;38;.927;3600000;0
17944;57426;1871;0;0;0;0;.00nan;0;0
17944;63848;1871;100;25;0;25;1.000;3600000;0
17945;167036;517;0;0;0;0;.00nan;0;0
17945;7332;2193;0;0;0;0;.00nan;0;0
17945;62530;517;82;43;3;40;.930;3600000;0
17945;64271;2193;62;34;4;30;.882;3549000;0
17946;4622;523;70;29;2;27;.931;3600000;0
17946;89998;523;0;0;0;0;.00nan;0;0
17946;143256;1869;0;0;0;0;.00nan;0;0
17946;143412;1869;71;51;5;46;.902;3600000;0
17947;8035;522;0;0;0;0;.00nan;0;0
17947;46912;2173;41;31;5;26;.839;3600000;0
17947;54290;522;78;28;2;26;.929;3600000;0
17947;56058;2173;0;0;0;0;.00nan;0;0
17948;177519;1477;0;0;0;0;.00nan;0;0
17948;174581;1477;67;20;1;19;.950;3600000;0
17948;185051;1877;0;0;0;0;.00nan;0;0
17948;143100;1877;73;38;4;34;.895;3600000;0
17949;46912;2173;69;31;2;29;.935;3600000;0
17949;56058;2173;0;0;0;0;.00nan;0;0
17949;57426;1871;0;0;0;0;.00nan;0;0
17949;63848;1871;74;22;1;21;.955;3600000;0
17950;8035;522;54;20;2;18;.900;3600000;0
17950;9373;1854;0;0;0;0;.00nan;0;0
17950;54290;522;0;0;0;0;.00nan;0;0
17950;155664;1854;56;32;4;28;.875;3579000;0
17951;4622;523;56;23;3;20;.870;3900000;0
17951;177519;1477;0;0;0;0;.00nan;0;0
17951;174581;1477;75;36;3;33;.917;3900000;0
17951;89998;523;0;0;0;0;.00nan;0;0
17952;56231;1861;80;30;1;29;.967;3600000;0
17952;143256;1869;0;0;0;0;.00nan;0;0
17952;143412;1869;54;27;5;22;.815;3600000;0
17952;152464;1861;0;0;0;0;.00nan;0;0
17953;167036;517;0;0;0;0;.00nan;0;0
17953;62530;517;81;28;1;27;.964;3900000;0
17953;63830;521;100;38;1;37;.974;3900000;0
17953;143523;521;0;0;0;0;.00nan;0;0
17954;7332;2193;85;24;1;23;.958;3600000;0
17954;54658;4962;88;38;2;36;.947;3600000;0
17954;55495;4962;0;0;0;0;.00nan;0;0
17954;64271;2193;0;0;0;0;.00nan;0;0
17955;6944;1872;0;0;0;0;.00nan;0;0
17955;185051;1877;53;21;3;18;.857;1610000;0
17955;84287;1872;56;18;2;16;.889;3600000;0
17955;143100;1877;20;25;6;19;.760;1990000;0
17956;46912;2173;84;36;2;34;.944;3600000;0
17956;56058;2173;0;0;0;0;.00nan;0;0
17956;63830;521;45;26;4;22;.846;3522000;0
17956;143523;521;0;0;0;0;.00nan;0;0
17957;6944;1872;57;32;4;28;.875;3600000;0
17957;57426;1871;0;0;0;0;.00nan;0;0
17957;63848;1871;77;24;1;23;.958;3600000;0
17957;84287;1872;0;0;0;0;.00nan;0;0
17958;177519;1477;0;0;0;0;.00nan;0;0
17958;7332;2193;51;30;4;26;.867;3560000;0
17958;174581;1477;90;48;3;45;.938;3600000;0
17958;64271;2193;0;0;0;0;.00nan;0;0
17959;4622;523;53;30;4;26;.867;3554000;0
17959;56231;1861;100;41;2;39;.951;3600000;0
17959;89998;523;0;0;0;0;.00nan;0;0
17959;152464;1861;0;0;0;0;.00nan;0;0
17960;167036;517;0;0;0;0;.00nan;0;0
17960;54658;4962;0;0;0;0;.00nan;0;0
17960;55495;4962;84;41;3;38;.927;3550000;0
17960;62530;517;71;23;1;22;.957;3600000;0
17961;8035;522;0;0;0;0;.00nan;0;0
17961;54290;522;61;22;2;20;.909;3600000;0
17961;143256;1869;0;0;0;0;.00nan;0;0
17961;143412;1869;68;39;4;35;.897;3535000;0
17962;9373;1854;52;23;3;20;.870;3600000;0
17962;185051;1877;0;0;0;0;.00nan;0;0
17962;143100;1877;79;46;4;42;.913;3552000;0
17962;155664;1854;0;0;0;0;.00nan;0;0
17963;8035;522;59;23;2;21;.913;3900000;0
17963;54290;522;0;0;0;0;.00nan;0;0
17963;56231;1861;0;0;0;0;.00nan;0;0
17963;152464;1861;81;30;2;28;.933;3900000;0
17964;185051;1877;0;0;0;0;.00nan;0;0
17964;46912;2173;0;0;0;0;.00nan;0;0
17964;56058;2173;88;14;0;14;1.000;3600000;0
17964;143100;1877;58;26;4;22;.846;3600000;0
17965;4622;523;70;27;2;25;.926;3900000;0
17965;9373;1854;69;30;2;28;.933;3900000;0
17965;89998;523;0;0;0;0;.00nan;0;0
17965;155664;1854;0;0;0;0;.00nan;0;0
17966;177519;1477;0;0;0;0;.00nan;0;0
17966;174581;1477;94;57;2;55;.965;3900000;0
17966;63830;521;59;21;2;19;.905;3900000;0
17966;143523;521;0;0;0;0;.00nan;0;0
17967;54658;4962;94;39;2;37;.949;3900000;0
17967;55495;4962;0;0;0;0;.00nan;0;0
17967;143256;1869;0;0;0;0;.00nan;0;0
17967;143412;1869;76;27;2;25;.926;3900000;0
17968;167036;517;0;0;0;0;.00nan;0;0
17968;57426;1871;0;0;0;0;.00nan;0;0
17968;62530;517;82;45;3;42;.933;3900000;0
17968;63848;1871;60;25;3;22;.880;3900000;0
17969;6944;1872;52;36;5;31;.861;3566000;0
17969;7332;2193;54;26;3;23;.885;3600000;0
17969;64271;2193;0;0;0;0;.00nan;0;0
17969;84287;1872;0;0;0;0;.00nan;0;0
17970;185051;1877;0;0;0;0;.00nan;0;0
17970;56231;1861;66;19;1;18;.947;3600000;0
17970;143100;1877;89;41;2;39;.951;3600000;0
17970;152464;1861;0;0;0;0;.00nan;0;0
17971;167036;517;0;0;0;0;.00nan;0;0
17971;46912;2173;0;0;0;0;.00nan;0;0
17971;56058;2173;89;42;2;40;.952;3568000;0
17971;62530;517;71;21;1;20;.952;3600000;0
17972;7332;2193;61;28;3;25;.893;3900000;0
17972;9373;1854;80;47;3;44;.936;3900000;0
17972;64271;2193;0;0;0;0;.00nan;0;0
17972;155664;1854;0;0;0;0;.00nan;0;0
17973;177519;1477;51;28;4;24;.857;3016000;0
17973;8035;522;0;0;0;0;.00nan;0;0
17973;174581;1477;29;10;3;7;.700;546000;0
17973;54290;522;30;26;6;20;.769;3600000;0
17974;57426;1871;0;0;0;0;.00nan;0;0
17974;63848;1871;75;39;4;35;.897;3566000;0
17974;143256;1869;81;43;3;40;.930;3600000;0
17974;143412;1869;0;0;0;0;.00nan;0;0
17975;4622;523;66;24;1;23;.958;3600000;0
17975;63830;521;54;29;5;24;.828;3600000;0
17975;89998;523;0;0;0;0;.00nan;0;0
17975;143523;521;0;0;0;0;.00nan;0;0
17976;6944;1872;49;20;3;17;.850;3600000;0
17976;54658;4962;98;38;0;38;1.000;3082000;0
17976;55495;4962;20;8;4;4;.500;462000;0
17976;84287;1872;0;0;0;0;.00nan;0;0
17977;56231;1861;86;44;3;41;.932;3600000;0
17977;63830;521;0;0;0;0;.00nan;0;0
17977;143523;521;84;21;0;21;1.000;3600000;0
17977;152464;1861;0;0;0;0;.00nan;0;0
17978;177519;1477;0;0;0;0;.00nan;0;0
17978;174581;1477;56;44;7;37;.841;3600000;0
17978;57426;1871;0;0;0;0;.00nan;0;0
17978;63848;1871;72;27;2;25;.926;3600000;0
17979;7332;2193;0;0;0;0;.00nan;0;0
17979;46912;2173;0;0;0;0;.00nan;0;0
17979;56058;2173;97;56;4;52;.929;3600000;0
17979;64271;2193;56;22;2;20;.909;3600000;0
17980;167036;517;0;0;0;0;.00nan;0;0
17980;6944;1872;76;27;2;25;.926;3900000;0
17980;62530;517;100;41;2;39;.951;3900000;0
17980;84287;1872;0;0;0;0;.00nan;0;0
17981;9373;1854;70;33;2;31;.939;3600000;0
17981;54658;4962;46;40;6;34;.850;3219000;0
17981;55495;4962;55;5;0;5;1.000;381000;0
17981;155664;1854;0;0;0;0;.00nan;0;0
17982;4622;523;58;21;3;18;.857;3900000;0
17982;8035;522;49;23;3;20;.870;3900000;0
17982;54290;522;0;0;0;0;.00nan;0;0
17982;89998;523;0;0;0;0;.00nan;0;0
17983;185051;1877;0;0;0;0;.00nan;0;0
17983;143100;1877;74;43;4;39;.907;3600000;0
17983;143256;1869;0;0;0;0;.00nan;0;0
17983;143412;1869;73;19;1;18;.947;3600000;0
17984;56231;1861;38;13;3;10;.769;356000;0
17984;57426;1871;0;0;0;0;.00nan;0;0
17984;63848;1871;76;22;1;21;.955;3600000;0
17984;152464;1861;75;22;2;20;.909;3244000;0
17985;6944;1872;47;25;4;21;.840;3600000;0
17985;46912;2173;0;0;0;0;.00nan;0;0
17985;56058;2173;46;43;6;37;.860;3600000;0
17985;84287;1872;0;0;0;0;.00nan;0;0
17986;9373;1854;57;16;2;14;.875;3600000;0
17986;63830;521;0;0;0;0;.00nan;0;0
17986;143523;521;78;38;3;35;.921;3578000;0
17986;155664;1854;0;0;0;0;.00nan;0;0
17987;177519;1477;63;23;2;21;.913;3600000;0
17987;174581;1477;0;0;0;0;.00nan;0;0
17987;54658;4962;0;0;0;0;.00nan;0;0
17987;55495;4962;62;33;3;30;.909;3600000;0
17988;167036;517;0;0;0;0;.00nan;0;0
17988;62530;517;54;34;4;30;.882;3900000;0
17988;143256;1869;0;0;0;0;.00nan;0;0
17988;143412;1869;61;36;4;32;.889;3894000;0
17989;4622;523;66;37;4;33;.892;3577000;0
17989;7332;2193;46;16;3;13;.813;3600000;0
17989;64271;2193;0;0;0;0;.00nan;0;0
17989;89998;523;0;0;0;0;.00nan;0;0
17990;8035;522;0;0;0;0;.00nan;0;0
17990;185051;1877;0;0;0;0;.00nan;0;0
17990;54290;522;61;15;1;14;.933;3600000;0
17990;143100;1877;95;52;4;48;.923;3600000;0
17991;8035;522;23;34;8;26;.765;3600000;0
17991;54290;522;0;0;0;0;.00nan;0;0
17991;63830;521;100;27;0;27;1.000;3600000;0
17991;143523;521;0;0;0;0;.00nan;0;0
17992;9373;1854;70;29;2;27;.931;3598000;0
17992;57426;1871;0;0;0;0;.00nan;0;0
17992;63848;1871;95;35;1;34;.971;3600000;0
17992;155664;1854;0;0;0;0;.00nan;0;0
17993;7332;2193;0;0;0;0;.00nan;0;0
17993;64271;2193;69;25;2;23;.920;3680000;0
17993;143256;1869;0;0;0;0;.00nan;0;0
17993;143412;1869;92;49;3;46;.939;3680000;0
17994;167036;517;0;0;0;0;.00nan;0;0
17994;177519;1477;0;0;0;0;.00nan;0;0
17994;174581;1477;100;33;0;33;1.000;3600000;0
17994;62530;517;59;22;3;19;.864;3600000;0
17995;46912;2173;0;0;0;0;.00nan;0;0
17995;54658;4962;50;34;5;29;.853;3553000;0
17995;55495;4962;0;0;0;0;.00nan;0;0
17995;56058;2173;68;29;3;26;.897;3600000;0
17996;6944;1872;98;20;0;20;1.000;3600000;0
17996;56231;1861;92;65;6;59;.908;3600000;0
17996;84287;1872;0;0;0;0;.00nan;0;0
17996;152464;1861;0;0;0;0;.00nan;0;0
17997;4622;523;57;12;1;11;.917;3600000;0
17997;185051;1877;88;35;2;33;.943;3147000;0
17997;89998;523;0;0;0;0;.00nan;0;0
17997;143100;1877;32;9;3;6;.667;453000;0
17998;54658;4962;0;0;0;0;.00nan;0;0
17998;55495;4962;97;35;1;34;.971;3600000;0
17998;56231;1861;24;33;7;26;.788;3600000;0
17998;152464;1861;0;0;0;0;.00nan;0;0
17999;9373;1854;0;0;0;0;.00nan;0;0
17999;46912;2173;70;27;2;25;.926;3600000;0
17999;56058;2173;0;0;0;0;.00nan;0;0
17999;155664;1854;54;28;4;24;.857;3576000;0
18000;177519;1477;0;0;0;0;.00nan;0;0
18000;6944;1872;56;28;4;24;.857;3584000;0
18000;174581;1477;81;36;3;33;.917;3600000;0
18000;84287;1872;0;0;0;0;.00nan;0;0
18001;63830;521;50;28;4;24;.857;3900000;0
18001;143256;1869;0;0;0;0;.00nan;0;0
18001;143412;1869;63;36;4;32;.889;3900000;0
18001;143523;521;0;0;0;0;.00nan;0;0
18002;167036;517;0;0;0;0;.00nan;0;0
18002;4622;523;78;39;3;36;.923;3755000;0
18002;62530;517;78;30;4;26;.867;3755000;0
18002;89998;523;0;0;0;0;.00nan;0;0
18003;7332;2193;66;18;2;16;.889;3900000;0
18003;8035;522;0;0;0;0;.00nan;0;0
18003;54290;522;73;31;2;29;.935;3900000;0
18003;64271;2193;0;0;0;0;.00nan;0;0
18004;185051;1877;35;10;3;7;.700;272000;0
18004;57426;1871;0;0;0;0;.00nan;0;0
18004;63848;1871;26;12;4;8;.667;3600000;0
18004;143100;1877;81;47;4;43;.915;3328000;0
18005;185051;1877;43;3;1;2;.667;361000;0
18005;63830;521;43;22;4;18;.818;3600000;0
18005;143100;1877;33;35;7;28;.800;3239000;0
18005;143523;521;0;0;0;0;.00nan;0;0
18006;8035;522;71;30;2;28;.933;3600000;0
18006;54290;522;0;0;0;0;.00nan;0;0
18006;57426;1871;0;0;0;0;.00nan;0;0
18006;63848;1871;78;35;3;32;.914;3556000;0
18007;177519;1477;0;0;0;0;.00nan;0;0
18007;174581;1477;41;32;5;27;.844;3600000;0
18007;46912;2173;0;0;0;0;.00nan;0;0
18007;56058;2173;82;24;2;22;.917;3600000;0
18008;7332;2193;84;22;1;21;.955;3600000;0
18008;56231;1861;28;8;3;5;.625;570000;0
18008;64271;2193;0;0;0;0;.00nan;0;0
18008;152464;1861;52;24;3;21;.875;3030000;0
18009;167036;517;70;18;1;17;.944;3600000;0
18009;9373;1854;66;38;3;35;.921;3600000;0
18009;62530;517;0;0;0;0;.00nan;0;0
18009;155664;1854;0;0;0;0;.00nan;0;0
18010;4622;523;72;27;2;25;.926;3600000;0
18010;54658;4962;73;44;4;40;.909;3600000;0
18010;55495;4962;0;0;0;0;.00nan;0;0
18010;89998;523;0;0;0;0;.00nan;0;0
18011;6944;1872;0;0;0;0;.00nan;0;0
18011;84287;1872;68;24;2;22;.917;3600000;0
18011;143256;1869;0;0;0;0;.00nan;0;0
18011;143412;1869;72;39;3;36;.923;3600000;0
18012;7332;2193;67;30;2;28;.933;3600000;0
18012;63830;521;70;32;3;29;.906;3547000;0
18012;64271;2193;0;0;0;0;.00nan;0;0
18012;143523;521;0;0;0;0;.00nan;0;0
18013;46912;2173;83;27;1;26;.963;3549000;0
18013;56058;2173;0;0;0;0;.00nan;0;0
18013;56231;1861;0;0;0;0;.00nan;0;0
18013;152464;1861;92;23;0;23;1.000;3600000;0
18014;6944;1872;43;45;7;38;.844;3600000;0
18014;9373;1854;80;25;1;24;.960;3600000;0
18014;84287;1872;0;0;0;0;.00nan;0;0
18014;155664;1854;0;0;0;0;.00nan;0;0
18015;177519;1477;0;0;0;0;.00nan;0;0
18015;174581;1477;78;23;1;22;.957;3569000;0
18015;143256;1869;0;0;0;0;.00nan;0;0
18015;143412;1869;100;27;0;27;1.000;3600000;0
18016;4622;523;98;41;1;40;.976;3573000;0
18016;57426;1871;0;0;0;0;.00nan;0;0
18016;63848;1871;100;30;0;30;1.000;3600000;0
18016;89998;523;0;0;0;0;.00nan;0;0
18017;167036;517;0;0;0;0;.00nan;0;0
18017;8035;522;0;0;0;0;.00nan;0;0
18017;54290;522;76;33;2;31;.939;3600000;0
18017;62530;517;53;25;3;22;.880;3583000;0
18018;185051;1877;0;0;0;0;.00nan;0;0
18018;54658;4962;0;0;0;0;.00nan;0;0
18018;55495;4962;55;27;3;24;.889;3685000;0
18018;143100;1877;78;38;4;34;.895;3685000;0
18019;57426;1871;48;7;1;6;.857;317000;0
18019;63830;521;24;27;6;21;.778;2776000;0
18019;63848;1871;41;24;4;20;.833;3283000;0
18019;143523;521;51;5;0;5;1.000;767000;0
18020;46912;2173;58;27;3;24;.889;3600000;0
18020;56058;2173;0;0;0;0;.00nan;0;0
18020;143256;1869;0;0;0;0;.00nan;0;0
18020;143412;1869;77;22;1;21;.955;3600000;0
18021;177519;1477;67;13;0;13;1.000;1671000;0
18021;9373;1854;75;28;1;27;.964;3600000;0
18021;174581;1477;19;15;5;10;.667;1929000;0
18021;155664;1854;0;0;0;0;.00nan;0;0
18022;7332;2193;67;16;1;15;.938;3600000;0
18022;185051;1877;0;0;0;0;.00nan;0;0
18022;64271;2193;0;0;0;0;.00nan;0;0
18022;143100;1877;88;51;4;47;.922;3600000;0
18023;167036;517;0;0;0;0;.00nan;0;0
18023;56231;1861;0;0;0;0;.00nan;0;0
18023;62530;517;87;38;2;36;.947;3600000;0
18023;152464;1861;60;29;3;26;.897;3544000;0
18024;8035;522;0;0;0;0;.00nan;0;0
18024;54290;522;72;21;1;20;.952;3600000;0
18024;54658;4962;0;0;0;0;.00nan;0;0
18024;55495;4962;85;42;2;40;.952;3598000;0
18025;4622;523;100;43;2;41;.953;3600000;0
18025;6944;1872;75;33;3;30;.909;3591000;0
18025;84287;1872;0;0;0;0;.00nan;0;0
18025;89998;523;0;0;0;0;.00nan;0;0
18026;54658;4962;88;29;0;29;1.000;3900000;0
18026;55495;4962;0;0;0;0;.00nan;0;0
18026;63830;521;91;16;0;16;1.000;3900000;0
18026;143523;521;0;0;0;0;.00nan;0;0
18027;177519;1477;0;0;0;0;.00nan;0;0
18027;174581;1477;67;34;4;30;.882;3600000;0
18027;56231;1861;63;29;3;26;.897;3600000;0
18027;152464;1861;0;0;0;0;.00nan;0;0
18028;9373;1854;100;40;0;40;1.000;3600000;0
18028;143256;1869;0;0;0;0;.00nan;0;0
18028;143412;1869;89;34;1;33;.971;3545000;0
18028;155664;1854;0;0;0;0;.00nan;0;0
18029;7332;2193;82;33;2;31;.939;3600000;0
18029;57426;1871;0;0;0;0;.00nan;0;0
18029;63848;1871;49;29;4;25;.862;3545000;0
18029;64271;2193;0;0;0;0;.00nan;0;0
18030;4622;523;29;16;4;12;.750;3600000;0
18030;46912;2173;0;0;0;0;.00nan;0;0
18030;56058;2173;41;32;5;27;.844;3600000;0
18030;89998;523;0;0;0;0;.00nan;0;0
18031;6944;1872;74;18;1;17;.944;3600000;0
18031;8035;522;46;25;4;21;.840;3600000;0
18031;54290;522;0;0;0;0;.00nan;0;0
18031;84287;1872;0;0;0;0;.00nan;0;0
18032;167036;517;0;0;0;0;.00nan;0;0
18032;185051;1877;89;50;3;47;.940;3900000;0
18032;62530;517;48;16;3;13;.813;3900000;0
18032;143100;1877;0;0;0;0;.00nan;0;0
18033;8035;522;0;0;0;0;.00nan;0;0
18033;46912;2173;61;41;5;36;.878;3600000;0
18033;54290;522;60;10;1;9;.900;3600000;0
18033;56058;2173;0;0;0;0;.00nan;0;0
18034;9373;1854;63;22;2;20;.909;3600000;0
18034;56231;1861;37;27;4;23;.852;3532000;0
18034;152464;1861;0;0;0;0;.00nan;0;0
18034;155664;1854;0;0;0;0;.00nan;0;0
18035;177519;1477;76;21;1;20;.952;3600000;0
18035;174581;1477;0;0;0;0;.00nan;0;0
18035;185051;1877;0;0;0;0;.00nan;0;0
18035;143100;1877;96;43;3;40;.930;3574000;0
18036;4622;523;67;19;1;18;.947;3600000;0
18036;89998;523;0;0;0;0;.00nan;0;0
18036;143256;1869;85;47;4;43;.915;3600000;0
18036;143412;1869;0;0;0;0;.00nan;0;0
18037;167036;517;52;16;2;14;.875;3600000;0
18037;7332;2193;40;29;5;24;.828;3600000;0
18037;62530;517;0;0;0;0;.00nan;0;0
18037;64271;2193;0;0;0;0;.00nan;0;0
18038;54658;4962;0;0;0;0;.00nan;0;0
18038;55495;4962;83;29;1;28;.966;3600000;0
18038;57426;1871;0;0;0;0;.00nan;0;0
18038;63848;1871;44;17;3;14;.824;3556000;0
18039;6944;1872;43;26;4;22;.846;3600000;0
18039;63830;521;36;27;5;22;.815;2182000;0
18039;84287;1872;0;0;0;0;.00nan;0;0
18039;143523;521;35;5;2;3;.600;1418000;0
18040;167036;517;0;0;0;0;.00nan;0;0
18040;62530;517;59;28;3;25;.893;3600000;0
18040;63830;521;50;28;4;24;.857;3580000;0
18040;143523;521;0;0;0;0;.00nan;0;0
18041;56231;1861;0;0;0;0;.00nan;0;0
18041;143256;1869;0;0;0;0;.00nan;0;0
18041;143412;1869;73;33;4;29;.879;3745000;0
18041;152464;1861;63;26;3;23;.885;3745000;0
18042;46912;2173;0;0;0;0;.00nan;0;0
18042;56058;2173;88;37;2;35;.946;3547000;0
18042;57426;1871;0;0;0;0;.00nan;0;0
18042;63848;1871;60;12;1;11;.917;3600000;0
18043;7332;2193;65;22;2;20;.909;3600000;0
18043;54658;4962;42;39;6;33;.846;2477000;0
18043;55495;4962;54;5;0;5;1.000;1123000;0
18043;64271;2193;0;0;0;0;.00nan;0;0
18044;4622;523;60;25;3;22;.880;3600000;0
18044;177519;1477;0;0;0;0;.00nan;0;0
18044;174581;1477;100;43;2;41;.953;3600000;0
18044;89998;523;0;0;0;0;.00nan;0;0
18045;8035;522;60;33;4;29;.879;3513000;0
18045;9373;1854;88;40;2;38;.950;3600000;0
18045;54290;522;0;0;0;0;.00nan;0;0
18045;155664;1854;0;0;0;0;.00nan;0;0
18046;6944;1872;69;16;1;15;.938;3600000;0
18046;185051;1877;0;0;0;0;.00nan;0;0
18046;84287;1872;0;0;0;0;.00nan;0;0
18046;143100;1877;73;48;5;43;.896;3600000;0
18047;4622;523;42;12;3;9;.750;3900000;0
18047;56231;1861;89;43;3;40;.930;3900000;0
18047;89998;523;0;0;0;0;.00nan;0;0
18047;152464;1861;0;0;0;0;.00nan;0;0
18048;46912;2173;56;30;5;25;.833;3552000;0
18048;56058;2173;0;0;0;0;.00nan;0;0
18048;63830;521;56;32;4;28;.875;3600000;0
18048;143523;521;0;0;0;0;.00nan;0;0
18049;9373;1854;80;16;0;16;1.000;3600000;0
18049;185051;1877;0;0;0;0;.00nan;0;0
18049;143100;1877;77;38;3;35;.921;3600000;0
18049;155664;1854;0;0;0;0;.00nan;0;0
18050;177519;1477;0;0;0;0;.00nan;0;0
18050;7332;2193;63;22;2;20;.909;3600000;0
18050;174581;1477;70;39;4;35;.897;3600000;0
18050;64271;2193;0;0;0;0;.00nan;0;0
18051;8035;522;0;0;0;0;.00nan;0;0
18051;54290;522;65;30;3;27;.900;3900000;0
18051;143256;1869;0;0;0;0;.00nan;0;0
18051;143412;1869;73;34;3;31;.912;3900000;0
18052;167036;517;0;0;0;0;.00nan;0;0
18052;54658;4962;0;0;0;0;.00nan;0;0
18052;55495;4962;64;39;5;34;.872;3575000;0
18052;62530;517;63;24;3;21;.875;3600000;0
18053;6944;1872;55;26;3;23;.885;3600000;0
18053;57426;1871;0;0;0;0;.00nan;0;0
18053;63848;1871;30;31;6;25;.806;3600000;0
18053;84287;1872;0;0;0;0;.00nan;0;0
18054;177519;1477;82;31;2;29;.935;3600000;0
18054;174581;1477;0;0;0;0;.00nan;0;0
18054;63830;521;36;36;6;30;.833;3600000;0
18054;143523;521;0;0;0;0;.00nan;0;0
18055;167036;517;0;0;0;0;.00nan;0;0
18055;57426;1871;0;0;0;0;.00nan;0;0
18055;62530;517;83;22;1;21;.955;3594000;0
18055;63848;1871;100;24;0;24;1.000;3600000;0
18056;6944;1872;9;17;6;11;.647;2253000;0
18056;7332;2193;0;0;0;0;.00nan;0;0
18056;64271;2193;39;28;5;23;.821;3600000;0
18056;84287;1872;48;7;1;6;.857;1300000;0
18057;4622;523;49;21;3;18;.857;3600000;0
18057;9373;1854;29;37;7;30;.811;3231000;0
18057;89998;523;0;0;0;0;.00nan;0;0
18057;155664;1854;64;7;0;7;1.000;369000;0
18058;54658;4962;75;41;4;37;.902;3600000;0
18058;55495;4962;0;0;0;0;.00nan;0;0
18058;143256;1869;0;0;0;0;.00nan;0;0
18058;143412;1869;100;28;0;28;1.000;3600000;0
18059;8035;522;0;0;0;0;.00nan;0;0
18059;54290;522;61;10;1;9;.900;3600000;0
18059;56231;1861;0;0;0;0;.00nan;0;0
18059;152464;1861;69;32;2;30;.938;3600000;0
18060;185051;1877;45;46;6;40;.870;3600000;0
18060;46912;2173;0;0;0;0;.00nan;0;0
18060;56058;2173;43;20;4;16;.800;3600000;0
18060;143100;1877;0;0;0;0;.00nan;0;0
18061;4622;523;100;26;0;26;1.000;3600000;0
18061;63830;521;0;0;0;0;.00nan;0;0
18061;89998;523;0;0;0;0;.00nan;0;0
18061;143523;521;64;27;3;24;.889;3600000;0
18062;57426;1871;0;0;0;0;.00nan;0;0
18062;63848;1871;42;21;4;17;.810;3600000;0
18062;143256;1869;44;4;1;3;.750;908000;0
18062;143412;1869;48;42;6;36;.857;2692000;0
18063;7332;2193;59;21;3;18;.857;3550000;0
18063;9373;1854;99;44;1;43;.977;3600000;0
18063;64271;2193;0;0;0;0;.00nan;0;0
18063;155664;1854;0;0;0;0;.00nan;0;0
18064;167036;517;0;0;0;0;.00nan;0;0
18064;46912;2173;25;37;7;30;.811;3514000;0
18064;56058;2173;0;0;0;0;.00nan;0;0
18064;62530;517;39;25;5;20;.800;3600000;0
18065;6944;1872;89;20;0;20;1.000;3600000;0
18065;54658;4962;0;0;0;0;.00nan;0;0
18065;55495;4962;82;36;3;33;.917;3600000;0
18065;84287;1872;0;0;0;0;.00nan;0;0
18066;177519;1477;55;11;1;10;.909;1621000;0
18066;8035;522;67;27;2;25;.926;3600000;0
18066;174581;1477;32;26;6;20;.769;1979000;0
18066;54290;522;0;0;0;0;.00nan;0;0
18067;185051;1877;56;21;2;19;.905;1716000;0
18067;56231;1861;58;12;1;11;.917;3600000;0
18067;143100;1877;37;20;4;16;.800;1884000;0
18067;152464;1861;0;0;0;0;.00nan;0;0
18068;56231;1861;0;0;0;0;.00nan;0;0
18068;63830;521;43;12;3;9;.750;3600000;0
18068;143523;521;0;0;0;0;.00nan;0;0
18068;152464;1861;66;37;4;33;.892;3600000;0
18069;7332;2193;48;16;3;13;.813;3600000;0
18069;46912;2173;0;0;0;0;.00nan;0;0
18069;56058;2173;47;46;7;39;.848;3600000;0
18069;64271;2193;0;0;0;0;.00nan;0;0
18070;9373;1854;55;22;2;20;.909;3559000;0
18070;54658;4962;99;47;1;46;.979;3600000;0
18070;55495;4962;0;0;0;0;.00nan;0;0
18070;155664;1854;0;0;0;0;.00nan;0;0
18071;177519;1477;0;0;0;0;.00nan;0;0
18071;174581;1477;70;36;3;33;.917;3600000;0
18071;57426;1871;0;0;0;0;.00nan;0;0
18071;63848;1871;64;32;4;28;.875;3547000;0
18072;185051;1877;0;0;0;0;.00nan;0;0
18072;143100;1877;85;39;2;37;.949;3600000;0
18072;143256;1869;0;0;0;0;.00nan;0;0
18072;143412;1869;63;14;1;13;.929;3600000;0
18073;4622;523;0;0;0;0;.00nan;0;0
18073;8035;522;0;0;0;0;.00nan;0;0
18073;54290;522;89;34;2;32;.941;3600000;0
18073;89998;523;56;32;4;28;.875;3600000;0
18074;167036;517;0;0;0;0;.00nan;0;0
18074;6944;1872;65;35;4;31;.886;3833000;0
18074;62530;517;78;39;3;36;.923;3833000;0
18074;84287;1872;0;0;0;0;.00nan;0;0
18075;9373;1854;73;37;4;33;.892;3600000;0
18075;63830;521;86;15;0;15;1.000;3600000;0
18075;143523;521;0;0;0;0;.00nan;0;0
18075;155664;1854;0;0;0;0;.00nan;0;0
18076;56231;1861;92;45;2;43;.956;3900000;0
18076;57426;1871;0;0;0;0;.00nan;0;0
18076;63848;1871;71;24;2;22;.917;3900000;0
18076;152464;1861;0;0;0;0;.00nan;0;0
18077;4622;523;100;23;0;23;1.000;3600000;0
18077;7332;2193;50;41;6;35;.854;3600000;0
18077;64271;2193;0;0;0;0;.00nan;0;0
18077;89998;523;0;0;0;0;.00nan;0;0
18078;167036;517;0;0;0;0;.00nan;0;0
18078;62530;517;100;22;0;22;1.000;3600000;0
18078;143256;1869;0;0;0;0;.00nan;0;0
18078;143412;1869;85;39;3;36;.923;3600000;0
18079;177519;1477;40;21;4;17;.810;3600000;0
18079;174581;1477;0;0;0;0;.00nan;0;0
18079;54658;4962;0;0;0;0;.00nan;0;0
18079;55495;4962;64;21;2;19;.905;3600000;0
18080;6944;1872;0;0;0;0;.00nan;0;0
18080;46912;2173;44;32;4;28;.875;3600000;0
18080;56058;2173;0;0;0;0;.00nan;0;0
18080;84287;1872;64;19;1;18;.947;3600000;0
18081;8035;522;0;0;0;0;.00nan;0;0
18081;185051;1877;0;0;0;0;.00nan;0;0
18081;54290;522;83;14;0;14;1.000;3600000;0
18081;143100;1877;70;37;3;34;.919;3600000;0
18082;6944;1872;40;27;5;22;.815;3900000;0
18082;56231;1861;35;28;5;23;.821;3900000;0
18082;84287;1872;0;0;0;0;.00nan;0;0
18082;152464;1861;0;0;0;0;.00nan;0;0
18083;46912;2173;0;0;0;0;.00nan;0;0
18083;54658;4962;47;27;4;23;.852;3600000;0
18083;55495;4962;0;0;0;0;.00nan;0;0
18083;56058;2173;93;25;0;25;1.000;3600000;0
18084;9373;1854;55;26;3;23;.885;3588000;0
18084;57426;1871;0;0;0;0;.00nan;0;0
18084;63848;1871;85;33;2;31;.939;3600000;0
18084;155664;1854;0;0;0;0;.00nan;0;0
18085;167036;517;0;0;0;0;.00nan;0;0
18085;177519;1477;57;42;5;37;.881;3110000;0
18085;174581;1477;45;6;1;5;.833;490000;0
18085;62530;517;60;30;3;27;.900;3600000;0
18086;7332;2193;68;33;3;30;.909;3593000;0
18086;64271;2193;0;0;0;0;.00nan;0;0
18086;143256;1869;0;0;0;0;.00nan;0;0
18086;143412;1869;90;34;1;33;.971;3600000;0
18087;4622;523;55;9;1;8;.889;3600000;0
18087;185051;1877;0;0;0;0;.00nan;0;0
18087;89998;523;0;0;0;0;.00nan;0;0
18087;143100;1877;84;42;3;39;.929;3544000;0
18088;8035;522;0;0;0;0;.00nan;0;0
18088;54290;522;56;34;5;29;.853;3553000;0
18088;63830;521;76;37;3;34;.919;3600000;0
18088;143523;521;0;0;0;0;.00nan;0;0
18089;63830;521;52;29;4;25;.862;3589000;0
18089;143256;1869;0;0;0;0;.00nan;0;0
18089;143412;1869;91;35;2;33;.943;3600000;0
18089;143523;521;0;0;0;0;.00nan;0;0
18090;185051;1877;0;0;0;0;.00nan;0;0
18090;57426;1871;56;16;2;14;.875;3600000;0
18090;143100;1877;88;62;6;56;.903;3600000;0
18090;159851;1871;0;0;0;0;.00nan;0;0
18091;9373;1854;67;21;1;20;.952;3900000;0
18091;46912;2173;100;37;1;36;.973;3900000;0
18091;56058;2173;0;0;0;0;.00nan;0;0
18091;155664;1854;0;0;0;0;.00nan;0;0
18092;7332;2193;0;0;0;0;.00nan;0;0
18092;8035;522;83;35;2;33;.943;3542000;0
18092;54290;522;0;0;0;0;.00nan;0;0
18092;64271;2193;86;28;1;27;.964;3600000;0
18093;167036;517;0;0;0;0;.00nan;0;0
18093;4622;523;65;29;3;26;.897;3584000;0
18093;62530;517;85;25;1;24;.960;3600000;0
18093;89998;523;0;0;0;0;.00nan;0;0
18094;54658;4962;0;0;0;0;.00nan;0;0
18094;55495;4962;74;32;2;30;.938;3900000;0
18094;56231;1861;71;25;2;23;.920;3900000;0
18094;152464;1861;0;0;0;0;.00nan;0;0
18095;177519;1477;0;0;0;0;.00nan;0;0
18095;6944;1872;38;32;5;27;.844;3900000;0
18095;174581;1477;64;43;5;38;.884;3900000;0
18095;84287;1872;0;0;0;0;.00nan;0;0
18096;7332;2193;46;29;4;25;.862;3600000;0
18096;56231;1861;0;0;0;0;.00nan;0;0
18096;64271;2193;0;0;0;0;.00nan;0;0
18096;152464;1861;47;32;5;27;.844;3555000;0
18097;167036;517;0;0;0;0;.00nan;0;0
18097;9373;1854;67;38;3;35;.921;3579000;0
18097;62530;517;75;26;2;24;.923;3600000;0
18097;155664;1854;0;0;0;0;.00nan;0;0
18098;177519;1477;0;0;0;0;.00nan;0;0
18098;174581;1477;85;16;0;16;1.000;3600000;0
18098;46912;2173;0;0;0;0;.00nan;0;0
18098;56058;2173;97;50;1;49;.980;3600000;0
18099;6944;1872;58;26;3;23;.885;3600000;0
18099;84287;1872;0;0;0;0;.00nan;0;0
18099;143256;1869;0;0;0;0;.00nan;0;0
18099;143412;1869;47;38;7;31;.816;3600000;0
18100;4622;523;62;21;2;19;.905;3600000;0
18100;54658;4962;71;39;3;36;.923;3553000;0
18100;55495;4962;0;0;0;0;.00nan;0;0
18100;89998;523;0;0;0;0;.00nan;0;0
18101;8035;522;0;0;0;0;.00nan;0;0
18101;54290;522;31;40;8;32;.800;3600000;0
18101;57426;1871;76;16;1;15;.938;3600000;0
18101;159851;1871;0;0;0;0;.00nan;0;0
18102;185051;1877;0;0;0;0;.00nan;0;0
18102;63830;521;84;16;0;16;1.000;3600000;0
18102;143100;1877;98;52;3;49;.942;3600000;0
18102;143523;521;0;0;0;0;.00nan;0;0
18103;4622;523;98;38;2;36;.947;3584000;0
18103;57426;1871;0;0;0;0;.00nan;0;0
18103;89998;523;0;0;0;0;.00nan;0;0
18103;159851;1871;84;25;1;24;.960;3600000;0
18104;46912;2173;100;47;2;45;.957;3900000;0
18104;56058;2173;0;0;0;0;.00nan;0;0
18104;56231;1861;54;22;2;20;.909;3900000;0
18104;152464;1861;0;0;0;0;.00nan;0;0
18105;177519;1477;0;0;0;0;.00nan;0;0
18105;174581;1477;54;39;5;34;.872;3600000;0
18105;143256;1869;0;0;0;0;.00nan;0;0
18105;143412;1869;100;28;0;28;1.000;3600000;0
18106;7332;2193;69;30;3;27;.900;3800000;0
18106;63830;521;68;38;4;34;.895;3807000;0
18106;64271;2193;0;0;0;0;.00nan;0;0
18106;143523;521;0;0;0;0;.00nan;0;0
18107;167036;517;0;0;0;0;.00nan;0;0
18107;8035;522;50;1;0;1;1.000;375000;0
18107;54290;522;30;26;6;20;.769;3225000;0
18107;62530;517;69;27;3;24;.889;3600000;0
18108;185051;1877;0;0;0;0;.00nan;0;0
18108;54658;4962;0;0;0;0;.00nan;0;0
18108;55495;4962;70;17;1;16;.941;3600000;0
18108;143100;1877;79;32;2;30;.938;3544000;0
18109;6944;1872;53;37;5;32;.865;3600000;0
18109;9373;1854;75;25;2;23;.920;3600000;0
18109;84287;1872;0;0;0;0;.00nan;0;0
18109;155664;1854;0;0;0;0;.00nan;0;0
18110;57426;1871;46;22;3;19;.864;3600000;0
18110;63830;521;96;46;2;44;.957;3600000;0
18110;143523;521;0;0;0;0;.00nan;0;0
18110;159851;1871;0;0;0;0;.00nan;0;0
18111;167036;517;0;0;0;0;.00nan;0;0
18111;56231;1861;29;9;3;6;.667;554000;0
18111;62530;517;67;29;3;26;.897;3600000;0
18111;152464;1861;60;22;2;20;.909;2977000;0
18112;177519;1477;0;0;0;0;.00nan;0;0
18112;9373;1854;0;0;0;0;.00nan;0;0
18112;174581;1477;68;32;3;29;.906;3600000;0
18112;155664;1854;72;27;2;25;.926;3600000;0
18113;46912;2173;0;0;0;0;.00nan;0;0
18113;56058;2173;78;38;4;34;.895;3600000;0
18113;143256;1869;0;0;0;0;.00nan;0;0
18113;143412;1869;100;21;0;21;1.000;3600000;0
18114;4622;523;72;24;2;22;.917;3600000;0
18114;6944;1872;48;31;4;27;.871;3576000;0
18114;84287;1872;0;0;0;0;.00nan;0;0
18114;89998;523;0;0;0;0;.00nan;0;0
18115;8035;522;24;18;5;13;.722;2217000;0
18115;54290;522;65;10;0;10;1.000;1354000;0
18115;54658;4962;70;27;3;24;.889;3600000;0
18115;55495;4962;0;0;0;0;.00nan;0;0
18116;7332;2193;91;15;0;15;1.000;3600000;0
18116;185051;1877;0;0;0;0;.00nan;0;0
18116;64271;2193;0;0;0;0;.00nan;0;0
18116;143100;1877;64;62;8;54;.871;3600000;0
18117;7332;2193;83;44;4;40;.909;3556000;0
18117;57426;1871;52;19;2;17;.895;3600000;0
18117;64271;2193;0;0;0;0;.00nan;0;0
18117;159851;1871;0;0;0;0;.00nan;0;0
18118;4622;523;78;27;1;26;.963;3600000;0
18118;46912;2173;75;41;3;38;.927;3570000;0
18118;56058;2173;0;0;0;0;.00nan;0;0
18118;89998;523;0;0;0;0;.00nan;0;0
18119;177519;1477;61;4;0;4;1.000;622000;0
18119;174581;1477;31;31;6;25;.806;2978000;0
18119;56231;1861;91;39;2;37;.949;3600000;0
18119;152464;1861;0;0;0;0;.00nan;0;0
18120;9373;1854;69;34;3;31;.912;3600000;0
18120;143256;1869;0;0;0;0;.00nan;0;0
18120;143412;1869;100;32;1;31;.969;3600000;0
18120;155664;1854;0;0;0;0;.00nan;0;0
18121;167036;517;0;0;0;0;.00nan;0;0
18121;185051;1877;0;0;0;0;.00nan;0;0
18121;62530;517;69;15;1;14;.933;3600000;0
18121;143100;1877;96;41;2;39;.951;3577000;0
18122;54658;4962;0;0;0;0;.00nan;0;0
18122;55495;4962;68;37;4;33;.892;3600000;0
18122;63830;521;100;25;0;25;1.000;3600000;0
18122;143523;521;0;0;0;0;.00nan;0;0
18123;6944;1872;73;20;1;19;.950;3600000;0
18123;8035;522;59;41;6;35;.854;3600000;0
18123;54290;522;0;0;0;0;.00nan;0;0
18123;84287;1872;0;0;0;0;.00nan;0;0
18124;6944;1872;80;37;3;34;.919;3543000;0
18124;63830;521;78;28;1;27;.964;3600000;0
18124;84287;1872;0;0;0;0;.00nan;0;0
18124;143523;521;0;0;0;0;.00nan;0;0
18125;9373;1854;84;23;1;22;.957;3600000;0
18125;56231;1861;0;0;0;0;.00nan;0;0
18125;152464;1861;98;40;2;38;.950;3566000;0
18125;155664;1854;0;0;0;0;.00nan;0;0
18126;54658;4962;81;52;5;47;.904;3600000;0
18126;55495;4962;0;0;0;0;.00nan;0;0
18126;57426;1871;18;24;7;17;.708;3036000;0
18126;159851;1871;49;1;0;1;1.000;479000;0
18127;167036;517;0;0;0;0;.00nan;0;0
18127;7332;2193;24;22;6;16;.727;3600000;0
18127;62530;517;85;38;3;35;.921;3600000;0
18127;64271;2193;0;0;0;0;.00nan;0;0
18128;4622;523;75;20;1;19;.950;3600000;0
18128;89998;523;0;0;0;0;.00nan;0;0
18128;143256;1869;90;49;4;45;.918;3363000;0
18128;143412;1869;30;8;3;5;.625;237000;0
18129;8035;522;86;33;2;31;.939;3551000;0
18129;46912;2173;98;42;1;41;.976;3600000;0
18129;54290;522;0;0;0;0;.00nan;0;0
18129;56058;2173;0;0;0;0;.00nan;0;0
18130;177519;1477;0;0;0;0;.00nan;0;0
18130;174581;1477;86;16;0;16;1.000;3600000;0
18130;185051;1877;48;40;5;35;.875;3600000;0
18130;143100;1877;0;0;0;0;.00nan;0;0
18131;46912;2173;89;44;2;42;.955;3598000;0
18131;56058;2173;0;0;0;0;.00nan;0;0
18131;57426;1871;100;20;0;20;1.000;3600000;0
18131;159851;1871;0;0;0;0;.00nan;0;0
18132;8035;522;81;28;1;27;.964;3600000;0
18132;9373;1854;77;44;3;41;.932;3571000;0
18132;54290;522;0;0;0;0;.00nan;0;0
18132;155664;1854;0;0;0;0;.00nan;0;0
18133;4622;523;64;20;2;18;.900;3600000;0
18133;177519;1477;0;0;0;0;.00nan;0;0
18133;174581;1477;51;43;6;37;.860;3600000;0
18133;89998;523;0;0;0;0;.00nan;0;0
18134;56231;1861;99;40;1;39;.975;3600000;0
18134;143256;1869;62;31;3;28;.903;3600000;0
18134;143412;1869;0;0;0;0;.00nan;0;0
18134;152464;1861;0;0;0;0;.00nan;0;0
18135;167036;517;0;0;0;0;.00nan;0;0
18135;62530;517;93;36;1;35;.972;3600000;0
18135;63830;521;34;25;5;20;.800;3600000;0
18135;143523;521;0;0;0;0;.00nan;0;0
18136;7332;2193;52;21;3;18;.857;3590000;0
18136;54658;4962;0;0;0;0;.00nan;0;0
18136;55495;4962;86;32;2;30;.938;3600000;0
18136;64271;2193;0;0;0;0;.00nan;0;0
18137;6944;1872;78;9;0;9;1.000;3600000;0
18137;185051;1877;0;0;0;0;.00nan;0;0
18137;84287;1872;0;0;0;0;.00nan;0;0
18137;143100;1877;98;55;3;52;.945;3600000;0
18138;46912;2173;0;0;0;0;.00nan;0;0
18138;56058;2173;78;34;3;31;.912;3600000;0
18138;63830;521;0;0;0;0;.00nan;0;0
18138;143523;521;100;29;0;29;1.000;3600000;0
18139;6944;1872;74;57;6;51;.895;3600000;0
18139;57426;1871;83;25;1;24;.960;3600000;0
18139;84287;1872;0;0;0;0;.00nan;0;0
18139;159851;1871;0;0;0;0;.00nan;0;0
18140;177519;1477;40;32;5;27;.844;3600000;0
18140;7332;2193;0;0;0;0;.00nan;0;0
18140;174581;1477;0;0;0;0;.00nan;0;0
18140;64271;2193;74;21;1;20;.952;3600000;0
18141;4622;523;63;12;1;11;.917;3600000;0
18141;56231;1861;71;44;4;40;.909;3600000;0
18141;89998;523;0;0;0;0;.00nan;0;0
18141;152464;1861;0;0;0;0;.00nan;0;0
18142;167036;517;0;0;0;0;.00nan;0;0
18142;54658;4962;94;26;0;26;1.000;3900000;0
18142;55495;4962;0;0;0;0;.00nan;0;0
18142;62530;517;100;32;0;32;1.000;3900000;0
18143;8035;522;74;25;1;24;.960;3600000;0
18143;54290;522;0;0;0;0;.00nan;0;0
18143;143256;1869;0;0;0;0;.00nan;0;0
18143;143412;1869;89;35;2;33;.943;3558000;0
18144;9373;1854;62;14;1;13;.929;3600000;0
18144;185051;1877;0;0;0;0;.00nan;0;0
18144;143100;1877;97;55;3;52;.945;3521000;0
18144;155664;1854;0;0;0;0;.00nan;0;0
18145;8035;522;75;19;1;18;.947;3600000;0
18145;54290;522;0;0;0;0;.00nan;0;0
18145;56231;1861;80;45;4;41;.911;3600000;0
18145;152464;1861;0;0;0;0;.00nan;0;0
18146;185051;1877;0;0;0;0;.00nan;0;0
18146;46912;2173;57;24;2;22;.917;3600000;0
18146;56058;2173;0;0;0;0;.00nan;0;0
18146;143100;1877;56;39;5;34;.872;3600000;0
18147;4622;523;78;31;2;29;.935;3669000;0
18147;9373;1854;84;38;3;35;.921;3669000;0
18147;89998;523;0;0;0;0;.00nan;0;0
18147;155664;1854;0;0;0;0;.00nan;0;0
18148;177519;1477;0;0;0;0;.00nan;0;0
18148;174581;1477;89;54;4;50;.926;3577000;0
18148;63830;521;0;0;0;0;.00nan;0;0
18148;143523;521;71;18;1;17;.944;3600000;0
18149;54658;4962;0;0;0;0;.00nan;0;0
18149;55495;4962;85;28;1;27;.964;3600000;0
18149;143256;1869;0;0;0;0;.00nan;0;0
18149;143412;1869;100;23;0;23;1.000;3600000;0
18150;167036;517;0;0;0;0;.00nan;0;0
18150;57426;1871;52;19;3;16;.842;3600000;0
18150;62530;517;62;39;5;34;.872;3558000;0
18150;159851;1871;0;0;0;0;.00nan;0;0
18151;6944;1872;79;26;1;25;.962;3600000;0
18151;7332;2193;0;0;0;0;.00nan;0;0
18151;64271;2193;73;34;2;32;.941;3589000;0
18151;84287;1872;0;0;0;0;.00nan;0;0
18152;185051;1877;53;2;0;2;1.000;657000;0
18152;56231;1861;62;29;3;26;.897;3600000;0
18152;143100;1877;64;48;6;42;.875;2943000;0
18152;152464;1861;0;0;0;0;.00nan;0;0
18153;167036;517;0;0;0;0;.00nan;0;0
18153;46912;2173;99;54;2;52;.963;3600000;0
18153;56058;2173;0;0;0;0;.00nan;0;0
18153;62530;517;36;11;3;8;.727;3544000;0
18154;7332;2193;92;19;0;19;1.000;3600000;0
18154;9373;1854;62;31;3;28;.903;3600000;0
18154;64271;2193;0;0;0;0;.00nan;0;0
18154;155664;1854;0;0;0;0;.00nan;0;0
18155;177519;1477;0;0;0;0;.00nan;0;0
18155;8035;522;68;19;1;18;.947;3600000;0
18155;174581;1477;96;53;4;49;.925;3600000;0
18155;54290;522;0;0;0;0;.00nan;0;0
18156;57426;1871;100;21;0;21;1.000;3600000;0
18156;143256;1869;0;0;0;0;.00nan;0;0
18156;143412;1869;61;45;5;40;.889;3600000;0
18156;159851;1871;0;0;0;0;.00nan;0;0
18157;4622;523;59;18;3;15;.833;3900000;0
18157;63830;521;84;44;3;41;.932;3900000;0
18157;89998;523;0;0;0;0;.00nan;0;0
18157;143523;521;0;0;0;0;.00nan;0;0
18158;6944;1872;47;13;2;11;.846;3600000;0
18158;54658;4962;0;0;0;0;.00nan;0;0
18158;55495;4962;73;39;4;35;.897;3592000;0
18158;84287;1872;0;0;0;0;.00nan;0;0
18159;56231;1861;0;0;0;0;.00nan;0;0
18159;63830;521;72;35;3;32;.914;3600000;0
18159;143523;521;0;0;0;0;.00nan;0;0
18159;152464;1861;89;36;2;34;.944;3600000;0
18160;177519;1477;0;0;0;0;.00nan;0;0
18160;174581;1477;90;39;1;38;.974;3900000;0
18160;57426;1871;77;21;1;20;.952;3900000;0
18160;159851;1871;0;0;0;0;.00nan;0;0
18161;7332;2193;58;20;2;18;.900;3600000;0
18161;46912;2173;60;29;3;26;.897;3573000;0
18161;56058;2173;0;0;0;0;.00nan;0;0
18161;64271;2193;0;0;0;0;.00nan;0;0
18162;167036;517;0;0;0;0;.00nan;0;0
18162;6944;1872;69;22;2;20;.909;3600000;0
18162;62530;517;52;33;5;28;.848;3600000;0
18162;84287;1872;0;0;0;0;.00nan;0;0
18163;9373;1854;70;34;3;31;.912;3583000;0
18163;54658;4962;93;32;2;30;.938;3600000;0
18163;55495;4962;0;0;0;0;.00nan;0;0
18163;155664;1854;0;0;0;0;.00nan;0;0
18164;4622;523;79;37;3;34;.919;3600000;0
18164;8035;522;100;31;0;31;1.000;3600000;0
18164;54290;522;0;0;0;0;.00nan;0;0
18164;89998;523;0;0;0;0;.00nan;0;0
18165;185051;1877;56;25;3;22;.880;1816000;0
18165;143100;1877;19;24;6;18;.750;1784000;0
18165;143256;1869;0;0;0;0;.00nan;0;0
18165;143412;1869;30;21;5;16;.762;3600000;0
18166;56231;1861;82;45;3;42;.933;3649000;0
18166;57426;1871;73;23;2;21;.913;3649000;0
18166;152464;1861;0;0;0;0;.00nan;0;0
18166;159851;1871;0;0;0;0;.00nan;0;0
18167;6944;1872;74;20;1;19;.950;3600000;0
18167;46912;2173;66;42;4;38;.905;3600000;0
18167;56058;2173;0;0;0;0;.00nan;0;0
18167;84287;1872;0;0;0;0;.00nan;0;0
18168;9373;1854;0;0;0;0;.00nan;0;0
18168;63830;521;68;18;1;17;.944;3600000;0
18168;143523;521;0;0;0;0;.00nan;0;0
18168;155664;1854;55;43;5;38;.884;3600000;0
18169;177519;1477;77;32;2;30;.938;3720000;0
18169;174581;1477;0;0;0;0;.00nan;0;0
18169;54658;4962;0;0;0;0;.00nan;0;0
18169;55495;4962;99;45;1;44;.978;3720000;0
18170;167036;517;0;0;0;0;.00nan;0;0
18170;62530;517;90;31;1;30;.968;3600000;0
18170;143256;1869;44;34;6;28;.824;3600000;0
18170;143412;1869;0;0;0;0;.00nan;0;0
18171;4622;523;95;27;1;26;.963;3600000;0
18171;7332;2193;67;30;3;27;.900;3576000;0
18171;64271;2193;0;0;0;0;.00nan;0;0
18171;89998;523;0;0;0;0;.00nan;0;0
18172;8035;522;60;16;2;14;.875;3600000;0
18172;185051;1877;0;0;0;0;.00nan;0;0
18172;54290;522;0;0;0;0;.00nan;0;0
18172;143100;1877;57;39;5;34;.872;3600000;0
18173;8035;522;46;30;4;26;.867;3860000;0
18173;54290;522;0;0;0;0;.00nan;0;0
18173;63830;521;67;38;5;33;.868;3860000;0
18173;143523;521;0;0;0;0;.00nan;0;0
18174;9373;1854;66;34;3;31;.912;3674000;0
18174;57426;1871;70;37;4;33;.892;3674000;0
18174;155664;1854;0;0;0;0;.00nan;0;0
18174;159851;1871;0;0;0;0;.00nan;0;0
18175;7332;2193;57;33;5;28;.848;3600000;0
18175;64271;2193;0;0;0;0;.00nan;0;0
18175;143256;1869;55;39;5;34;.872;3085000;0
18175;143412;1869;33;9;3;6;.667;515000;0
18176;167036;517;98;21;0;21;1.000;3600000;0
18176;177519;1477;55;4;0;4;1.000;303000;0
18176;174581;1477;56;43;6;37;.860;3297000;0
18176;62530;517;0;0;0;0;.00nan;0;0
18177;46912;2173;93;34;1;33;.971;3600000;0
18177;55495;4962;0;0;0;0;.00nan;0;0
18177;56058;2173;0;0;0;0;.00nan;0;0
18177;68627;4962;90;39;2;37;.949;3578000;0
18178;6944;1872;67;32;3;29;.906;3600000;0
18178;56231;1861;49;8;1;7;.875;1154000;0
18178;84287;1872;0;0;0;0;.00nan;0;0
18178;152464;1861;45;30;6;24;.800;2446000;0
18179;4622;523;89;13;0;13;1.000;3900000;0
18179;185051;1877;0;0;0;0;.00nan;0;0
18179;89998;523;0;0;0;0;.00nan;0;0
18179;143100;1877;96;55;0;55;1.000;3900000;0
18180;55495;4962;0;0;0;0;.00nan;0;0
18180;56231;1861;58;24;3;21;.875;3600000;0
18180;68627;4962;32;24;5;19;.792;3580000;0
18180;152464;1861;0;0;0;0;.00nan;0;0
18181;9373;1854;67;25;2;23;.920;3600000;0
18181;46912;2173;69;44;5;39;.886;3600000;0
18181;56058;2173;0;0;0;0;.00nan;0;0
18181;155664;1854;0;0;0;0;.00nan;0;0
18182;177519;1477;0;0;0;0;.00nan;0;0
18182;6944;1872;44;22;4;18;.818;3600000;0
18182;174581;1477;57;47;5;42;.894;3546000;0
18182;84287;1872;0;0;0;0;.00nan;0;0
18183;63830;521;83;49;5;44;.898;3591000;0
18183;143256;1869;0;0;0;0;.00nan;0;0
18183;143412;1869;52;27;4;23;.852;3600000;0
18183;143523;521;0;0;0;0;.00nan;0;0
18184;167036;517;36;27;5;22;.815;3034000;0
18184;4622;523;80;23;1;22;.957;3600000;0
18184;62530;517;60;7;0;7;1.000;566000;0
18184;89998;523;0;0;0;0;.00nan;0;0
18185;7332;2193;100;43;2;41;.953;3634000;0
18185;8035;522;52;20;3;17;.850;3634000;0
18185;54290;522;0;0;0;0;.00nan;0;0
18185;64271;2193;0;0;0;0;.00nan;0;0
18186;185051;1877;0;0;0;0;.00nan;0;0
18186;143036;1871;70;6;0;6;1.000;3600000;0
18186;143100;1877;79;47;4;43;.915;3600000;0
18186;159851;1871;0;0;0;0;.00nan;0;0
18187;185051;1877;0;0;0;0;.00nan;0;0
18187;63830;521;61;27;3;24;.889;3600000;0
18187;143100;1877;81;49;4;45;.918;3600000;0
18187;143523;521;0;0;0;0;.00nan;0;0
18188;8035;522;32;17;4;13;.765;1089000;0
18188;54290;522;38;15;3;12;.800;2452000;0
18188;143036;1871;42;30;5;25;.833;3600000;0
18188;159851;1871;0;0;0;0;.00nan;0;0
18189;177519;1477;71;24;1;23;.958;3600000;0
18189;174581;1477;0;0;0;0;.00nan;0;0
18189;46912;2173;0;0;0;0;.00nan;0;0
18189;56058;2173;58;35;5;30;.857;3600000;0
18190;7332;2193;0;0;0;0;.00nan;0;0
18190;56231;1861;86;38;3;35;.921;3600000;0
18190;64271;2193;43;22;4;18;.818;3600000;0
18190;152464;1861;0;0;0;0;.00nan;0;0
18191;167036;517;0;0;0;0;.00nan;0;0
18191;9373;1854;79;30;1;29;.967;3600000;0
18191;62530;517;61;20;2;18;.900;3547000;0
18191;155664;1854;0;0;0;0;.00nan;0;0
18192;4622;523;65;24;2;22;.917;3600000;0
18192;55495;4962;0;0;0;0;.00nan;0;0
18192;68627;4962;60;34;4;30;.882;3580000;0
18192;89998;523;0;0;0;0;.00nan;0;0
18193;6944;1872;74;25;1;24;.960;3573000;0
18193;84287;1872;0;0;0;0;.00nan;0;0
18193;143256;1869;0;0;0;0;.00nan;0;0
18193;143412;1869;100;41;0;41;1.000;3600000;0
18194;7332;2193;27;23;5;18;.783;3600000;0
18194;63830;521;89;28;1;27;.964;3600000;0
18194;64271;2193;0;0;0;0;.00nan;0;0
18194;143523;521;0;0;0;0;.00nan;0;0
18195;46912;2173;100;32;0;32;1.000;3600000;0
18195;56058;2173;0;0;0;0;.00nan;0;0
18195;56231;1861;55;23;3;20;.870;3600000;0
18195;152464;1861;0;0;0;0;.00nan;0;0
18196;6944;1872;42;32;5;27;.844;3900000;0
18196;9373;1854;46;33;5;28;.848;3900000;0
18196;84287;1872;0;0;0;0;.00nan;0;0
18196;155664;1854;0;0;0;0;.00nan;0;0
18197;177519;1477;0;0;0;0;.00nan;0;0
18197;174581;1477;47;26;4;22;.846;3600000;0
18197;143256;1869;0;0;0;0;.00nan;0;0
18197;143412;1869;82;52;5;47;.904;3600000;0
18198;4622;523;37;32;6;26;.813;2839000;0
18198;89998;523;45;5;1;4;.800;761000;0
18198;143036;1871;68;22;2;20;.909;3600000;0
18198;159851;1871;0;0;0;0;.00nan;0;0
18199;167036;517;0;0;0;0;.00nan;0;0
18199;8035;522;0;0;0;0;.00nan;0;0
18199;54290;522;73;33;2;31;.939;3570000;0
18199;62530;517;72;22;1;21;.955;3600000;0
18200;185051;1877;91;26;0;26;1.000;1569000;0
18200;55495;4962;0;0;0;0;.00nan;0;0
18200;68627;4962;62;20;2;18;.900;3600000;0
18200;143100;1877;32;22;5;17;.773;2031000;0
18201;63830;521;73;36;3;33;.917;3521000;0
18201;143036;1871;0;0;0;0;.00nan;0;0
18201;143523;521;0;0;0;0;.00nan;0;0
18201;159851;1871;70;21;1;20;.952;3600000;0
18202;46912;2173;69;24;2;22;.917;3566000;0
18202;56058;2173;0;0;0;0;.00nan;0;0
18202;143256;1869;0;0;0;0;.00nan;0;0
18202;143412;1869;89;19;0;19;1.000;3600000;0
18203;177519;1477;56;23;3;20;.870;3900000;0
18203;9373;1854;67;42;3;39;.929;3900000;0
18203;174581;1477;0;0;0;0;.00nan;0;0
18203;155664;1854;0;0;0;0;.00nan;0;0
18204;7332;2193;88;19;0;19;1.000;3600000;0
18204;185051;1877;0;0;0;0;.00nan;0;0
18204;64271;2193;0;0;0;0;.00nan;0;0
18204;143100;1877;95;46;2;44;.957;3578000;0
18205;167036;517;0;0;0;0;.00nan;0;0
18205;56231;1861;79;27;1;26;.963;3600000;0
18205;62530;517;74;26;3;23;.885;3512000;0
18205;152464;1861;0;0;0;0;.00nan;0;0
18206;8035;522;42;21;4;17;.810;3656000;0
18206;54290;522;0;0;0;0;.00nan;0;0
18206;55495;4962;0;0;0;0;.00nan;0;0
18206;68627;4962;71;30;3;27;.900;3656000;0
18207;4622;523;80;31;2;29;.935;3600000;0
18207;6944;1872;26;27;6;21;.778;3212000;0
18207;84287;1872;48;0;0;0;.00nan;388000;0
18207;89998;523;0;0;0;0;.00nan;0;0
18208;55495;4962;0;0;0;0;.00nan;0;0
18208;63830;521;0;0;0;0;.00nan;0;0
18208;68627;4962;100;26;0;26;1.000;3600000;0
18208;143523;521;41;25;4;21;.840;3600000;0
18209;177519;1477;0;0;0;0;.00nan;0;0
18209;174581;1477;44;25;4;21;.840;3586000;0
18209;56231;1861;0;0;0;0;.00nan;0;0
18209;152464;1861;89;44;3;41;.932;3600000;0
18210;9373;1854;59;32;4;28;.875;3600000;0
18210;143256;1869;0;0;0;0;.00nan;0;0
18210;143412;1869;59;39;5;34;.872;3572000;0
18210;155664;1854;0;0;0;0;.00nan;0;0
18211;7332;2193;100;31;0;31;1.000;3600000;0
18211;64271;2193;0;0;0;0;.00nan;0;0
18211;143036;1871;74;24;1;23;.958;3552000;0
18211;159851;1871;0;0;0;0;.00nan;0;0
18212;6944;1872;52;18;2;16;.889;3600000;0
18212;8035;522;49;42;6;36;.857;3314000;0
18212;54290;522;50;1;0;1;1.000;286000;0
18212;84287;1872;0;0;0;0;.00nan;0;0
18213;167036;517;0;0;0;0;.00nan;0;0
18213;185051;1877;0;0;0;0;.00nan;0;0
18213;62530;517;61;12;1;11;.917;3600000;0
18213;143100;1877;85;54;4;50;.926;3600000;0
18214;4622;523;61;17;2;15;.882;3600000;0
18214;46912;2173;44;20;4;16;.800;687000;0
18214;56058;2173;72;19;1;18;.947;2913000;0
18214;89998;523;0;0;0;0;.00nan;0;0
18215;8035;522;83;34;2;32;.941;3600000;0
18215;46912;2173;0;0;0;0;.00nan;0;0
18215;54290;522;0;0;0;0;.00nan;0;0
18215;56058;2173;76;38;3;35;.921;3593000;0
18216;9373;1854;87;26;1;25;.962;3600000;0
18216;56231;1861;66;39;4;35;.897;3600000;0
18216;152464;1861;0;0;0;0;.00nan;0;0
18216;155664;1854;0;0;0;0;.00nan;0;0
18217;177519;1477;0;0;0;0;.00nan;0;0
18217;174581;1477;46;15;2;13;.867;3900000;0
18217;185051;1877;0;0;0;0;.00nan;0;0
18217;143100;1877;100;45;2;43;.956;3900000;0
18218;4622;523;80;25;1;24;.960;3600000;0
18218;89998;523;0;0;0;0;.00nan;0;0
18218;143256;1869;72;17;0;17;1.000;1214000;0
18218;143412;1869;41;32;6;26;.813;2386000;0
18219;167036;517;0;0;0;0;.00nan;0;0
18219;7332;2193;92;40;3;37;.925;3588000;0
18219;62530;517;94;30;2;28;.933;3600000;0
18219;64271;2193;0;0;0;0;.00nan;0;0
18220;55495;4962;38;7;2;5;.714;369000;0
18220;68627;4962;38;33;6;27;.818;3231000;0
18220;143036;1871;58;11;1;10;.909;3600000;0
18220;159851;1871;0;0;0;0;.00nan;0;0
18221;6944;1872;69;35;3;32;.914;3600000;0
18221;63830;521;60;30;4;26;.867;3600000;0
18221;84287;1872;0;0;0;0;.00nan;0;0
18221;143523;521;0;0;0;0;.00nan;0;0
18222;167036;517;0;0;0;0;.00nan;0;0
18222;62530;517;99;24;0;24;1.000;3600000;0
18222;63830;521;23;30;7;23;.767;2533000;0
18222;143523;521;50;9;1;8;.889;1067000;0
18223;56231;1861;0;0;0;0;.00nan;0;0
18223;143256;1869;0;0;0;0;.00nan;0;0
18223;143412;1869;59;35;4;31;.886;3564000;0
18223;152464;1861;78;33;2;31;.939;3600000;0
18224;46912;2173;75;43;3;40;.930;3780000;0
18224;56058;2173;0;0;0;0;.00nan;0;0
18224;143036;1871;67;19;2;17;.895;3780000;0
18224;159851;1871;0;0;0;0;.00nan;0;0
18225;7332;2193;65;19;1;18;.947;3600000;0
18225;55495;4962;59;9;0;9;1.000;989000;0
18225;64271;2193;0;0;0;0;.00nan;0;0
18225;68627;4962;47;39;6;33;.846;2611000;0
18226;4622;523;54;17;2;15;.882;3600000;0
18226;177519;1477;52;45;6;39;.867;3600000;0
18226;174581;1477;0;0;0;0;.00nan;0;0
18226;89998;523;0;0;0;0;.00nan;0;0
18227;8035;522;0;0;0;0;.00nan;0;0
18227;9373;1854;75;31;2;29;.935;3600000;0
18227;54290;522;72;33;3;30;.909;3557000;0
18227;155664;1854;0;0;0;0;.00nan;0;0
18228;6944;1872;87;14;0;14;1.000;3600000;0
18228;185051;1877;0;0;0;0;.00nan;0;0
18228;84287;1872;0;0;0;0;.00nan;0;0
18228;143100;1877;68;45;5;40;.889;3600000;0
18229;4622;523;27;6;3;3;.500;197000;0
18229;56231;1861;0;0;0;0;.00nan;0;0
18229;89998;523;41;18;4;14;.778;3403000;0
18229;152464;1861;95;56;2;54;.964;3600000;0
18230;46912;2173;69;37;4;33;.892;3600000;0
18230;56058;2173;0;0;0;0;.00nan;0;0
18230;63830;521;88;13;0;13;1.000;3600000;0
18230;143523;521;0;0;0;0;.00nan;0;0
18231;9373;1854;50;26;3;23;.885;3600000;0
18231;185051;1877;50;45;7;38;.844;3321000;0
18231;143100;1877;31;8;3;5;.625;279000;0
18231;155664;1854;0;0;0;0;.00nan;0;0
18232;177519;1477;0;0;0;0;.00nan;0;0
18232;7332;2193;65;21;2;19;.905;3600000;0
18232;174581;1477;80;59;5;54;.915;3600000;0
18232;64271;2193;0;0;0;0;.00nan;0;0
18233;8035;522;49;30;4;26;.867;3563000;0
18233;54290;522;0;0;0;0;.00nan;0;0
18233;143256;1869;80;35;3;32;.914;3600000;0
18233;143412;1869;0;0;0;0;.00nan;0;0
18234;167036;517;0;0;0;0;.00nan;0;0
18234;55495;4962;0;0;0;0;.00nan;0;0
18234;62530;517;90;33;1;32;.970;3600000;0
18234;68627;4962;96;46;3;43;.935;3552000;0
18235;6944;1872;76;23;2;21;.913;3600000;0
18235;84287;1872;0;0;0;0;.00nan;0;0
18235;143036;1871;90;29;1;28;.966;3600000;0
18235;159851;1871;0;0;0;0;.00nan;0;0
18236;177519;1477;0;0;0;0;.00nan;0;0
18236;174581;1477;63;45;5;40;.889;3600000;0
18236;63830;521;74;28;2;26;.929;3600000;0
18236;143523;521;0;0;0;0;.00nan;0;0
18237;167036;517;0;0;0;0;.00nan;0;0
18237;62530;517;99;46;3;43;.935;3600000;0
18237;143036;1871;32;18;4;14;.778;3568000;0
18237;159851;1871;0;0;0;0;.00nan;0;0
18238;6944;1872;64;36;4;32;.889;3544000;0
18238;7332;2193;71;31;3;28;.903;3600000;0
18238;64271;2193;0;0;0;0;.00nan;0;0
18238;84287;1872;0;0;0;0;.00nan;0;0
18239;4622;523;0;0;0;0;.00nan;0;0
18239;9373;1854;84;29;1;28;.966;3600000;0
18239;89998;523;65;23;2;21;.913;3600000;0
18239;155664;1854;0;0;0;0;.00nan;0;0
18240;55495;4962;0;0;0;0;.00nan;0;0
18240;68627;4962;96;25;1;24;.960;3600000;0
18240;143256;1869;0;0;0;0;.00nan;0;0
18240;143412;1869;53;15;2;13;.867;3559000;0
18241;8035;522;0;0;0;0;.00nan;0;0
18241;54290;522;54;20;3;17;.850;3900000;0
18241;56231;1861;0;0;0;0;.00nan;0;0
18241;152464;1861;98;55;3;52;.945;3900000;0
18242;185051;1877;83;40;3;37;.925;3600000;0
18242;46912;2173;53;19;2;17;.895;3600000;0
18242;56058;2173;0;0;0;0;.00nan;0;0
18242;143100;1877;0;0;0;0;.00nan;0;0
18244;177519;1477;0;0;0;0;.00nan;0;0
18244;174581;1477;85;45;3;42;.933;3560000;0
18244;46912;2173;91;31;1;30;.968;3600000;0
18244;56058;2173;0;0;0;0;.00nan;0;0
18246;7332;2193;61;23;2;21;.913;3600000;0
18246;64271;2193;0;0;0;0;.00nan;0;0
18246;89998;523;67;36;4;32;.889;3527000;0
18246;143191;523;0;0;0;0;.00nan;0;0
18248;167036;517;0;0;0;0;.00nan;0;0
18248;6944;1872;100;44;2;42;.955;3600000;0
18248;62530;517;31;34;6;28;.824;3600000;0
18248;84287;1872;0;0;0;0;.00nan;0;0
18250;8035;522;93;45;3;42;.933;3552000;0
18250;54290;522;0;0;0;0;.00nan;0;0
18250;63848;1871;82;29;1;28;.966;3600000;0
18250;143063;1871;0;0;0;0;.00nan;0;0
18252;54658;4962;0;0;0;0;.00nan;0;0
18252;55495;4962;76;31;2;29;.935;3600000;0
18252;63830;521;86;41;3;38;.927;3546000;0
18252;143523;521;0;0;0;0;.00nan;0;0
18254;9373;1854;100;25;0;25;1.000;3600000;0
18254;185051;1877;91;45;3;42;.933;3600000;0
18254;45547;1877;0;0;0;0;.00nan;0;0
18254;155664;1854;0;0;0;0;.00nan;0;0
18256;56231;1861;80;29;2;27;.931;3600000;0
18256;143256;1869;0;0;0;0;.00nan;0;0
18256;143412;1869;63;31;3;28;.903;3600000;0
18256;152464;1861;0;0;0;0;.00nan;0;0
18258;54658;4962;100;40;1;39;.975;3600000;0
18258;55495;4962;0;0;0;0;.00nan;0;0
18258;63848;1871;0;0;0;0;.00nan;0;0
18258;143063;1871;48;28;4;24;.857;3600000;0
18260;6944;1872;0;0;0;0;.00nan;0;0
18260;8035;522;0;0;0;0;.00nan;0;0
18260;54290;522;98;55;1;54;.982;3600000;0
18260;84287;1872;83;10;0;10;1.000;3600000;0
18262;185051;1877;0;0;0;0;.00nan;0;0
18262;56231;1861;0;0;0;0;.00nan;0;0
18262;143100;1877;75;41;4;37;.902;3600000;0
18262;152464;1861;71;21;1;20;.952;3600000;0
18264;7332;2193;0;0;0;0;.00nan;0;0
18264;64271;2193;52;22;3;19;.864;3600000;0
18264;89998;523;0;0;0;0;.00nan;0;0
18264;143191;523;43;29;5;24;.828;3571000;0
18266;177519;1477;88;38;3;35;.921;3635000;0
18266;9373;1854;51;16;2;14;.875;3635000;0
18266;174581;1477;0;0;0;0;.00nan;0;0
18266;155664;1854;0;0;0;0;.00nan;0;0
18268;63830;521;58;9;1;8;.889;1505000;0
18268;143256;1869;80;49;4;45;.918;3807000;0
18268;143412;1869;0;0;0;0;.00nan;0;0
18268;143523;521;45;20;4;16;.800;2302000;0
18270;167036;517;63;15;1;14;.933;3600000;0
18270;46912;2173;0;0;0;0;.00nan;0;0
18270;56058;2173;98;42;2;40;.952;3555000;0
18270;62530;517;0;0;0;0;.00nan;0;0
18272;185051;1877;0;0;0;0;.00nan;0;0
18272;63830;521;88;18;0;18;1.000;3600000;0
18272;143100;1877;92;48;4;44;.917;3600000;0
18272;143523;521;0;0;0;0;.00nan;0;0
18274;89998;523;0;0;0;0;.00nan;0;0
18274;143191;523;59;13;1;12;.923;3600000;0
18274;143256;1869;85;53;4;49;.925;3600000;0
18274;143412;1869;0;0;0;0;.00nan;0;0
18276;7332;2193;30;25;5;20;.800;1917000;0
18276;63848;1871;79;35;4;31;.886;3600000;0
18276;64271;2193;58;8;0;8;1.000;1669000;0
18276;143063;1871;0;0;0;0;.00nan;0;0
18278;177519;1477;0;0;0;0;.00nan;0;0
18278;174581;1477;72;29;2;27;.931;3600000;0
18278;56231;1861;49;20;3;17;.850;3600000;0
18278;152464;1861;0;0;0;0;.00nan;0;0
18280;8035;522;0;0;0;0;.00nan;0;0
18280;9373;1854;30;15;4;11;.733;805000;0
18280;54290;522;85;38;2;36;.947;3600000;0
18280;155664;1854;75;23;1;22;.957;2795000;0
18282;167036;517;0;0;0;0;.00nan;0;0
18282;54658;4962;67;43;4;39;.907;3565000;0
18282;55495;4962;0;0;0;0;.00nan;0;0
18282;62530;517;77;31;2;29;.935;3600000;0
18284;6944;1872;0;0;0;0;.00nan;0;0
18284;46912;2173;67;45;4;41;.911;3554000;0
18284;56058;2173;0;0;0;0;.00nan;0;0
18284;84287;1872;56;19;2;17;.895;3600000;0
18286;185051;1877;71;41;4;37;.902;3544000;0
18286;63848;1871;0;0;0;0;.00nan;0;0
18286;143063;1871;62;19;2;17;.895;3600000;0
18286;143100;1877;0;0;0;0;.00nan;0;0
18288;167036;517;60;28;3;25;.893;3600000;0
18288;46912;2173;0;0;0;0;.00nan;0;0
18288;56058;2173;41;41;7;34;.829;3600000;0
18288;62530;517;0;0;0;0;.00nan;0;0
18290;8035;522;34;27;5;22;.815;3600000;0
18290;54290;522;0;0;0;0;.00nan;0;0
18290;56231;1861;0;0;0;0;.00nan;0;0
18290;152464;1861;79;29;2;27;.931;3600000;0
18292;89998;523;74;28;1;27;.964;3600000;0
18292;143191;523;0;0;0;0;.00nan;0;0
18292;143256;1869;0;0;0;0;.00nan;0;0
18292;143412;1869;64;28;3;25;.893;3525000;0
18294;177519;1477;96;45;1;44;.978;3600000;0
18294;6944;1872;49;26;4;22;.846;3600000;0
18294;174581;1477;0;0;0;0;.00nan;0;0
18294;84287;1872;0;0;0;0;.00nan;0;0
18296;7332;2193;0;0;0;0;.00nan;0;0
18296;54658;4962;0;0;0;0;.00nan;0;0
18296;55495;4962;98;42;1;41;.976;3600000;0
18296;64271;2193;91;17;0;17;1.000;3600000;0
18298;9373;1854;95;23;0;23;1.000;3600000;0
18298;63830;521;98;39;1;38;.974;3579000;0
18298;143523;521;0;0;0;0;.00nan;0;0
18298;155664;1854;0;0;0;0;.00nan;0;0
18300;63848;1871;100;25;0;25;1.000;3600000;0
18300;89998;523;90;41;1;40;.976;3599000;0
18300;143063;1871;0;0;0;0;.00nan;0;0
18300;143191;523;0;0;0;0;.00nan;0;0
18302;9373;1854;74;42;4;38;.905;3596000;0
18302;63830;521;64;32;3;29;.906;3600000;0
18302;143523;521;0;0;0;0;.00nan;0;0
18302;155664;1854;0;0;0;0;.00nan;0;0
18304;167036;517;0;0;0;0;.00nan;0;0
18304;56231;1861;81;37;2;35;.946;3534000;0
18304;62530;517;86;21;0;21;1.000;3600000;0
18304;152464;1861;0;0;0;0;.00nan;0;0
18306;6944;1872;47;20;3;17;.850;3600000;0
18306;54658;4962;100;29;0;29;1.000;3600000;0
18306;55495;4962;0;0;0;0;.00nan;0;0
18306;84287;1872;0;0;0;0;.00nan;0;0
18308;7332;2193;0;0;0;0;.00nan;0;0
18308;8035;522;88;23;0;23;1.000;1893000;0
18308;54290;522;38;23;5;18;.783;1707000;0
18308;64271;2193;44;34;6;28;.824;3576000;0
18310;177519;1477;0;0;0;0;.00nan;0;0
18310;174581;1477;64;13;1;12;.923;3600000;0
18310;185051;1877;0;0;0;0;.00nan;0;0
18310;143100;1877;88;36;2;34;.944;3600000;0
18312;46912;2173;100;37;1;36;.973;3600000;0
18312;56058;2173;0;0;0;0;.00nan;0;0
18312;143256;1869;57;27;4;23;.852;3600000;0
18312;143412;1869;0;0;0;0;.00nan;0;0
18314;7332;2193;0;0;0;0;.00nan;0;0
18314;46912;2173;80;51;4;47;.922;3578000;0
18314;56058;2173;0;0;0;0;.00nan;0;0
18314;64271;2193;60;24;2;22;.917;3600000;0
18316;177519;1477;65;23;2;21;.913;3585000;0
18316;174581;1477;0;0;0;0;.00nan;0;0
18316;56231;1861;0;0;0;0;.00nan;0;0
18316;152464;1861;79;27;1;26;.963;3600000;0
18318;54658;4962;64;35;3;32;.914;3520000;0
18318;55495;4962;0;0;0;0;.00nan;0;0
18318;63830;521;86;25;1;24;.960;3600000;0
18318;143523;521;0;0;0;0;.00nan;0;0
18320;6944;1872;0;0;0;0;.00nan;0;0
18320;63848;1871;71;38;4;34;.895;3567000;0
18320;84287;1872;67;24;2;22;.917;3600000;0
18320;143063;1871;0;0;0;0;.00nan;0;0
18322;167036;517;0;0;0;0;.00nan;0;0
18322;8035;522;100;40;2;38;.950;3600000;0
18322;54290;522;0;0;0;0;.00nan;0;0
18322;62530;517;54;29;4;25;.862;3545000;0
18324;185051;1877;62;44;5;39;.886;3142000;0
18324;143100;1877;32;10;3;7;.700;458000;0
18324;143256;1869;0;0;0;0;.00nan;0;0
18324;143412;1869;63;21;2;19;.905;3600000;0
18326;9373;1854;82;46;4;42;.913;3600000;0
18326;89998;523;71;18;1;17;.944;3600000;0
18326;143191;523;0;0;0;0;.00nan;0;0
18326;155664;1854;0;0;0;0;.00nan;0;0
18328;167036;517;94;29;1;28;.966;3600000;0
18328;8035;522;0;0;0;0;.00nan;0;0
18328;54290;522;71;28;2;26;.929;3572000;0
18328;62530;517;0;0;0;0;.00nan;0;0
18330;46912;2173;0;0;0;0;.00nan;0;0
18330;56058;2173;98;53;2;51;.962;3600000;0
18330;89998;523;0;0;0;0;.00nan;0;0
18330;143191;523;67;15;1;14;.933;3600000;0
18332;185051;1877;0;0;0;0;.00nan;0;0
18332;54658;4962;0;0;0;0;.00nan;0;0
18332;55495;4962;76;23;1;22;.957;3600000;0
18332;143100;1877;53;28;4;24;.857;3600000;0
18334;177519;1477;0;0;0;0;.00nan;0;0
18334;6944;1872;79;28;2;26;.929;3600000;0
18334;174581;1477;81;39;3;36;.923;3545000;0
18334;84287;1872;0;0;0;0;.00nan;0;0
18336;9373;1854;0;0;0;0;.00nan;0;0
18336;63848;1871;0;0;0;0;.00nan;0;0
18336;143063;1871;50;28;5;23;.821;3626000;0
18336;155664;1854;66;40;4;36;.900;3626000;0
18338;7332;2193;58;16;2;14;.875;3600000;0
18338;56231;1861;80;40;3;37;.925;3600000;0
18338;64271;2193;0;0;0;0;.00nan;0;0
18338;152464;1861;0;0;0;0;.00nan;0;0
18340;63830;521;0;0;0;0;.00nan;0;0
18340;143256;1869;79;28;2;26;.929;3564000;0
18340;143412;1869;0;0;0;0;.00nan;0;0
18340;143523;521;95;34;1;33;.971;3600000;0
1008;167036;517;0;0;0;0;.00nan;0;0
1008;62530;517;56;15;2;13;.867;3600000;0
1008;63830;521;64;46;5;41;.891;3600000;0
1008;143523;521;0;0;0;0;.00nan;0;0
1009;8035;522;33;24;4;20;.833;3600000;0
1009;54290;522;0;0;0;0;.00nan;0;0
1009;143036;1871;76;25;1;24;.960;3600000;0
1009;159851;1871;0;0;0;0;.00nan;0;0
1010;4622;523;61;24;3;21;.875;3600000;0
1010;9373;1854;53;36;5;31;.861;3548000;0
1010;89998;523;0;0;0;0;.00nan;0;0
1010;155664;1854;0;0;0;0;.00nan;0;0
1011;6944;1872;51;24;4;20;.833;3875000;0
1011;7332;2193;76;41;5;36;.878;3875000;0
1011;64271;2193;0;0;0;0;.00nan;0;0
1011;84287;1872;0;0;0;0;.00nan;0;0
1012;167036;517;0;0;0;0;.00nan;0;0
1012;62530;517;49;21;3;18;.857;3568000;0
1012;63830;521;88;38;2;36;.947;3600000;0
1012;143523;521;0;0;0;0;.00nan;0;0
1013;8035;522;96;40;2;38;.950;4025000;0
1013;54290;522;0;0;0;0;.00nan;0;0
1013;143036;1871;48;20;3;17;.850;4025000;0
1013;159851;1871;0;0;0;0;.00nan;0;0
1014;4622;523;71;27;2;25;.926;3600000;0
1014;9373;1854;70;39;3;36;.923;3600000;0
1014;89998;523;0;0;0;0;.00nan;0;0
1014;155664;1854;0;0;0;0;.00nan;0;0
1015;6944;1872;78;39;3;36;.923;5595000;0
1015;7332;2193;74;42;4;38;.905;5595000;0
1015;64271;2193;0;0;0;0;.00nan;0;0
1015;84287;1872;0;0;0;0;.00nan;0;0
1016;167036;517;0;0;0;0;.00nan;0;0
1016;62530;517;86;21;1;20;.952;3600000;0
1016;63830;521;47;25;4;21;.840;3600000;0
1016;143523;521;0;0;0;0;.00nan;0;0
1017;8035;522;79;30;2;28;.933;4309000;0
1017;54290;522;0;0;0;0;.00nan;0;0
1017;143036;1871;75;21;1;20;.952;4309000;0
1017;159851;1871;0;0;0;0;.00nan;0;0
1018;4622;523;80;27;2;25;.926;3600000;0
1018;9373;1854;68;36;3;33;.917;3581000;0
1018;89998;523;0;0;0;0;.00nan;0;0
1018;155664;1854;0;0;0;0;.00nan;0;0
1019;6944;1872;74;34;2;32;.941;3552000;0
1019;7332;2193;88;29;1;28;.966;3600000;0
1019;64271;2193;0;0;0;0;.00nan;0;0
1019;84287;1872;0;0;0;0;.00nan;0;0
1240;167036;517;0;0;0;0;.00nan;0;0
1240;62530;517;59;26;3;23;.885;3600000;0
1240;63830;521;11;11;5;6;.545;790000;0
1240;143523;521;85;33;1;32;.970;2810000;0
1241;8035;522;73;38;3;35;.921;3572000;0
1241;54290;522;0;0;0;0;.00nan;0;0
1241;143036;1871;78;23;1;22;.957;3600000;0
1241;159851;1871;0;0;0;0;.00nan;0;0
1242;6944;1872;67;20;1;19;.950;3845000;0
1242;7332;2193;87;36;2;34;.944;3845000;0
1242;64271;2193;0;0;0;0;.00nan;0;0
1242;84287;1872;0;0;0;0;.00nan;0;0
1333;167036;517;0;0;0;0;.00nan;0;0
1333;6944;1872;99;34;1;33;.971;3600000;0
1333;62530;517;71;32;3;29;.906;3576000;0
1333;84287;1872;0;0;0;0;.00nan;0;0
1334;4622;523;63;37;4;33;.892;3568000;0
1334;89998;523;0;0;0;0;.00nan;0;0
1334;143036;1871;79;29;2;27;.931;3600000;0
1334;159851;1871;0;0;0;0;.00nan;0;0
1335;167036;517;0;0;0;0;.00nan;0;0
1335;6944;1872;61;31;3;28;.903;3582000;0
1335;62530;517;68;23;2;21;.913;3600000;0
1335;84287;1872;0;0;0;0;.00nan;0;0
1336;4622;523;78;36;3;33;.917;3549000;0
1336;89998;523;0;0;0;0;.00nan;0;0
1336;143036;1871;66;25;2;23;.920;3600000;0
1336;159851;1871;0;0;0;0;.00nan;0;0
1337;167036;517;0;0;0;0;.00nan;0;0
1337;6944;1872;78;41;4;37;.902;3600000;0
1337;62530;517;49;30;5;25;.833;3567000;0
1337;84287;1872;0;0;0;0;.00nan;0;0
1338;4622;523;97;52;3;49;.942;3600000;0
1338;89998;523;0;0;0;0;.00nan;0;0
1338;143036;1871;95;17;0;17;1.000;3600000;0
1338;159851;1871;0;0;0;0;.00nan;0;0
1339;167036;517;0;0;0;0;.00nan;0;0
1339;6944;1872;100;31;0;31;1.000;3600000;0
1339;62530;517;91;39;2;37;.949;3557000;0
1339;84287;1872;0;0;0;0;.00nan;0;0
1340;4622;523;72;27;2;25;.926;3600000;0
1340;89998;523;0;0;0;0;.00nan;0;0
1340;143036;1871;63;27;3;24;.889;3546000;0
1340;159851;1871;0;0;0;0;.00nan;0;0
1600;167036;517;42;3;1;2;.667;763000;0
1600;6944;1872;63;16;1;15;.938;3600000;0
1600;62530;517;60;39;6;33;.846;2837000;0
1600;84287;1872;0;0;0;0;.00nan;0;0
1601;4622;523;89;45;4;41;.911;3733000;0
1601;89998;523;0;0;0;0;.00nan;0;0
1601;143036;1871;73;33;3;30;.909;3733000;0
1601;159851;1871;0;0;0;0;.00nan;0;0
1652;6944;1872;46;26;4;22;.846;3600000;0
1652;84287;1872;0;0;0;0;.00nan;0;0
1652;143036;1871;99;38;1;37;.974;3600000;0
1652;159851;1871;0;0;0;0;.00nan;0;0
1653;6944;1872;96;22;0;22;1.000;3600000;0
1653;84287;1872;0;0;0;0;.00nan;0;0
1653;143036;1871;67;36;3;33;.917;3600000;0
1653;159851;1871;0;0;0;0;.00nan;0;0
1654;6944;1872;93;17;0;17;1.000;3600000;0
1654;84287;1872;0;0;0;0;.00nan;0;0
1654;143036;1871;73;20;1;19;.950;3600000;0
1654;159851;1871;0;0;0;0;.00nan;0;0
1655;6944;1872;100;31;0;31;1.000;3600000;0
1655;84287;1872;0;0;0;0;.00nan;0;0
1655;143036;1871;30;17;4;13;.765;1894000;0
1655;159851;1871;63;12;0;12;1.000;1706000;0
1897;6944;1872;46;24;4;20;.833;3516000;0
1897;84287;1872;0;0;0;0;.00nan;0;0
1897;143036;1871;0;0;0;0;.00nan;0;0
1897;159851;1871;65;26;2;24;.923;3600000;0
1922;6944;1872;87;32;2;30;.938;3600000;0
1922;84287;1872;0;0;0;0;.00nan;0;0
1922;143036;1871;0;0;0;0;.00nan;0;0
1922;159851;1871;37;37;6;31;.838;3600000;0
18341;11352;582;0;0;0;0;.00nan;0;0
18341;14259;2256;0;0;0;0;.00nan;0;0
18341;-1;582;46;24;4;20;.833;3600000;0
18341;56901;2256;78;45;5;40;.889;3600000;0
18342;14783;1930;0;0;0;0;.00nan;0;0
18342;169493;1930;59;14;1;13;.929;3600000;0
18342;67614;2259;85;38;3;35;.921;3515000;0
18342;89930;2259;0;0;0;0;.00nan;0;0
18343;218;1931;33;28;6;22;.786;3600000;0
18343;20196;1931;0;0;0;0;.00nan;0;0
18343;50683;579;65;20;1;19;.950;3600000;0
18343;56155;579;0;0;0;0;.00nan;0;0
18344;169478;2287;67;18;2;16;.889;3600000;0
18344;50245;2287;0;0;0;0;.00nan;0;0
18344;56480;1923;55;10;1;9;.900;1211000;0
18344;149847;1923;23;28;6;22;.786;2389000;0
18345;4484;584;56;24;3;21;.875;3600000;0
18345;163021;584;0;0;0;0;.00nan;0;0
18345;11687;1933;40;33;6;27;.818;3600000;0
18345;19010;1933;0;0;0;0;.00nan;0;0
18346;218;1931;66;14;1;13;.929;3600000;0
18346;4484;584;36;43;7;36;.837;3600000;0
18346;163021;584;0;0;0;0;.00nan;0;0
18346;20196;1931;0;0;0;0;.00nan;0;0
18347;67614;2259;31;49;9;40;.816;3600000;0
18347;67663;1920;68;31;3;28;.903;3600000;0
18347;89930;2259;0;0;0;0;.00nan;0;0
18347;143879;1920;0;0;0;0;.00nan;0;0
18348;6541;1934;48;34;5;29;.853;3600000;0
18348;14783;1930;59;20;2;18;.900;3600000;0
18348;169493;1930;0;0;0;0;.00nan;0;0
18348;67454;1934;0;0;0;0;.00nan;0;0
18349;11687;1933;0;0;0;0;.00nan;0;0
18349;19010;1933;73;30;3;27;.900;3543000;0
18349;50683;579;59;24;2;22;.917;3600000;0
18349;56155;579;0;0;0;0;.00nan;0;0
18350;6541;1934;62;17;2;15;.882;3600000;0
18350;56480;1923;0;0;0;0;.00nan;0;0
18350;67454;1934;0;0;0;0;.00nan;0;0
18350;149847;1923;69;38;4;34;.895;3515000;0
18351;56480;1923;73;16;0;16;1.000;1309000;0
18351;67663;1920;0;0;0;0;.00nan;0;0
18351;143879;1920;75;29;2;27;.931;3600000;0
18351;149847;1923;41;34;6;28;.824;2291000;0
18352;218;1931;54;39;5;34;.872;3600000;0
18352;20196;1931;0;0;0;0;.00nan;0;0
18352;169478;2287;69;18;2;16;.889;3600000;0
18352;50245;2287;0;0;0;0;.00nan;0;0
18353;218;1931;0;0;0;0;.00nan;0;0
18353;14259;2256;0;0;0;0;.00nan;0;0
18353;20196;1931;80;26;1;25;.962;3600000;0
18353;56901;2256;72;45;4;41;.911;3600000;0
18354;6541;1934;48;29;5;24;.828;3600000;0
18354;67454;1934;0;0;0;0;.00nan;0;0
18354;67663;1920;71;30;2;28;.933;2555000;0
18354;143879;1920;45;28;4;24;.857;1045000;0
18355;169478;2287;0;0;0;0;.00nan;0;0
18355;50245;2287;36;31;5;26;.839;3600000;0
18355;50683;579;63;21;2;19;.905;3600000;0
18355;56155;579;0;0;0;0;.00nan;0;0
18356;11687;1933;87;30;1;29;.967;3600000;0
18356;14783;1930;74;32;3;29;.906;3538000;0
18356;19010;1933;0;0;0;0;.00nan;0;0
18356;169493;1930;0;0;0;0;.00nan;0;0
18357;4484;584;0;0;0;0;.00nan;0;0
18357;163021;584;83;34;3;31;.912;3600000;0
18357;67614;2259;50;27;4;23;.852;3553000;0
18357;89930;2259;0;0;0;0;.00nan;0;0
18358;11352;582;0;0;0;0;.00nan;0;0
18358;-1;582;38;22;4;18;.818;3600000;0
18358;67614;2259;0;0;0;0;.00nan;0;0
18358;89930;2259;44;45;7;38;.844;3600000;0
18359;6541;1934;43;33;5;28;.848;3548000;0
18359;14783;1930;0;0;0;0;.00nan;0;0
18359;169493;1930;65;31;3;28;.903;3600000;0
18359;67454;1934;0;0;0;0;.00nan;0;0
18360;6541;1934;67;47;5;42;.894;3552000;0
18360;50683;579;77;35;3;32;.914;3600000;0
18360;56155;579;0;0;0;0;.00nan;0;0
18360;67454;1934;0;0;0;0;.00nan;0;0
18361;4484;584;61;42;4;38;.905;3600000;0
18361;163021;584;0;0;0;0;.00nan;0;0
18361;11352;582;0;0;0;0;.00nan;0;0
18361;-1;582;63;16;1;15;.938;3600000;0
18362;218;1931;59;26;3;23;.885;3600000;0
18362;11687;1933;100;34;0;34;1.000;3600000;0
18362;19010;1933;0;0;0;0;.00nan;0;0
18362;20196;1931;0;0;0;0;.00nan;0;0
18363;169478;2287;61;20;2;18;.900;3740000;0
18363;50245;2287;0;0;0;0;.00nan;0;0
18363;67663;1920;0;0;0;0;.00nan;0;0
18363;143879;1920;74;31;3;28;.903;3740000;0
18364;14259;2256;0;0;0;0;.00nan;0;0
18364;56901;2256;55;27;3;24;.889;3557000;0
18364;67614;2259;70;24;2;22;.917;3600000;0
18364;89930;2259;0;0;0;0;.00nan;0;0
18365;218;1931;50;2;0;2;1.000;282000;0
18365;20196;1931;32;42;8;34;.810;3318000;0
18365;67663;1920;54;31;4;27;.871;3600000;0
18365;143879;1920;0;0;0;0;.00nan;0;0
18366;4484;584;36;8;2;6;.750;635000;0
18366;163021;584;49;42;6;36;.857;2965000;0
18366;50683;579;22;16;5;11;.688;3600000;0
18366;56155;579;0;0;0;0;.00nan;0;0
18367;11687;1933;46;29;4;25;.862;3578000;0
18367;19010;1933;0;0;0;0;.00nan;0;0
18367;56480;1923;0;0;0;0;.00nan;0;0
18367;149847;1923;84;35;2;33;.943;3600000;0
18368;14259;2256;0;0;0;0;.00nan;0;0
18368;14783;1930;82;12;0;12;1.000;3600000;0
18368;169493;1930;0;0;0;0;.00nan;0;0
18368;56901;2256;89;34;2;32;.941;3557000;0
18369;4484;584;80;34;2;32;.941;3600000;0
18369;163021;584;0;0;0;0;.00nan;0;0
18369;14259;2256;0;0;0;0;.00nan;0;0
18369;56901;2256;43;33;5;28;.848;3600000;0
18370;218;1931;78;31;2;29;.935;3600000;0
18370;20196;1931;0;0;0;0;.00nan;0;0
18370;67614;2259;66;27;3;24;.889;3553000;0
18370;89930;2259;0;0;0;0;.00nan;0;0
18371;11687;1933;62;42;5;37;.881;3600000;0
18371;19010;1933;0;0;0;0;.00nan;0;0
18371;169478;2287;0;0;0;0;.00nan;0;0
18371;50245;2287;65;16;2;14;.875;3600000;0
18372;11687;1933;0;0;0;0;.00nan;0;0
18372;14259;2256;0;0;0;0;.00nan;0;0
18372;19010;1933;50;17;3;14;.824;3900000;0
18372;56901;2256;91;42;3;39;.929;3900000;0
18373;50683;579;31;18;4;14;.778;3551000;0
18373;56155;579;0;0;0;0;.00nan;0;0
18373;67663;1920;0;0;0;0;.00nan;0;0
18373;143879;1920;57;26;3;23;.885;3600000;0
18374;218;1931;0;0;0;0;.00nan;0;0
18374;14783;1930;87;37;3;34;.919;3600000;0
18374;20196;1931;53;41;6;35;.854;3600000;0
18374;169493;1930;0;0;0;0;.00nan;0;0
18375;11352;582;0;0;0;0;.00nan;0;0
18375;-1;582;90;20;0;20;1.000;3600000;0
18375;56480;1923;0;0;0;0;.00nan;0;0
18375;149847;1923;79;51;4;47;.922;3600000;0
18376;4484;584;76;13;0;13;1.000;911000;0
18376;163021;584;8;27;8;19;.704;2689000;0
18376;169478;2287;91;21;0;21;1.000;3600000;0
18376;50245;2287;0;0;0;0;.00nan;0;0
18377;6541;1934;81;21;1;20;.952;3600000;0
18377;11352;582;0;0;0;0;.00nan;0;0
18377;-1;582;68;30;3;27;.900;3600000;0
18377;67454;1934;0;0;0;0;.00nan;0;0
18378;11352;582;0;0;0;0;.00nan;0;0
18378;-1;582;28;21;5;16;.762;3600000;0
18378;50683;579;13;33;8;25;.758;2621000;0
18378;56155;579;49;8;1;7;.875;979000;0
18379;11687;1933;63;25;3;22;.880;3600000;0
18379;19010;1933;0;0;0;0;.00nan;0;0
18379;67614;2259;77;44;4;40;.909;3600000;0
18379;89930;2259;0;0;0;0;.00nan;0;0
18380;56480;1923;0;0;0;0;.00nan;0;0
18380;67663;1920;61;19;2;17;.895;3900000;0
18380;143879;1920;0;0;0;0;.00nan;0;0
18380;149847;1923;90;49;2;47;.959;3900000;0
18381;14783;1930;43;34;6;28;.824;3600000;0
18381;169478;2287;67;29;3;26;.897;3600000;0
18381;169493;1930;0;0;0;0;.00nan;0;0
18381;50245;2287;0;0;0;0;.00nan;0;0
18382;6541;1934;92;20;0;20;1.000;3600000;0
18382;50683;579;0;0;0;0;.00nan;0;0
18382;56155;579;65;23;2;21;.913;3600000;0
18382;67454;1934;0;0;0;0;.00nan;0;0
18383;11687;1933;0;0;0;0;.00nan;0;0
18383;14783;1930;0;0;0;0;.00nan;0;0
18383;19010;1933;68;37;3;34;.919;3600000;0
18383;169493;1930;74;23;1;22;.957;3600000;0
18384;4484;584;49;30;4;26;.867;3744000;0
18384;163021;584;0;0;0;0;.00nan;0;0
18384;56480;1923;65;31;3;28;.903;3744000;0
18384;149847;1923;0;0;0;0;.00nan;0;0
18385;14259;2256;0;0;0;0;.00nan;0;0
18385;169478;2287;0;0;0;0;.00nan;0;0
18385;50245;2287;60;23;3;20;.870;3830000;0
18385;56901;2256;73;31;2;29;.935;3830000;0
18386;218;1931;0;0;0;0;.00nan;0;0
18386;11352;582;0;0;0;0;.00nan;0;0
18386;-1;582;42;32;6;26;.813;3600000;0
18386;37467;1931;48;32;4;28;.875;3600000;0
18387;14259;2256;69;27;2;25;.926;2760000;0
18387;56901;2256;30;15;4;11;.733;1140000;0
18387;67663;1920;0;0;0;0;.00nan;0;0
18387;143879;1920;40;33;6;27;.818;3900000;0
18388;4484;584;0;0;0;0;.00nan;0;0
18388;163021;584;69;38;5;33;.868;3900000;0
18388;6541;1934;44;25;5;20;.800;2340000;0
18388;67454;1934;55;7;0;7;1.000;1560000;0
18389;14259;2256;0;0;0;0;.00nan;0;0
18389;14783;1930;0;0;0;0;.00nan;0;0
18389;169493;1930;54;25;3;22;.880;3600000;0
18389;56901;2256;46;40;6;34;.850;3600000;0
18390;218;1931;82;34;2;32;.941;3600000;0
18390;11352;582;47;20;3;17;.850;3549000;0
18390;-1;582;0;0;0;0;.00nan;0;0
18390;37467;1931;0;0;0;0;.00nan;0;0
18391;11687;1933;76;30;2;28;.933;3900000;0
18391;19010;1933;0;0;0;0;.00nan;0;0
18391;67614;2259;77;34;2;32;.941;3900000;0
18391;89930;2259;0;0;0;0;.00nan;0;0
18392;4484;584;34;28;6;22;.786;3664000;0
18392;163021;584;0;0;0;0;.00nan;0;0
18392;67663;1920;56;39;5;34;.872;3664000;0
18392;143879;1920;0;0;0;0;.00nan;0;0
18393;169478;2287;48;0;0;0;.00nan;371000;0
18393;50245;2287;31;28;6;22;.786;3178000;0
18393;50683;579;61;40;5;35;.875;3600000;0
18393;56155;579;0;0;0;0;.00nan;0;0
18394;11352;582;0;0;0;0;.00nan;0;0
18394;-1;582;64;29;3;26;.897;3600000;0
18394;67663;1920;50;1;0;1;1.000;621000;0
18394;143879;1920;26;26;6;20;.769;2979000;0
18395;6541;1934;50;20;3;17;.850;3768000;0
18395;67454;1934;0;0;0;0;.00nan;0;0
18395;67614;2259;68;34;4;30;.882;3768000;0
18395;89930;2259;0;0;0;0;.00nan;0;0
18396;14259;2256;55;4;0;4;1.000;243000;0
18396;50683;579;55;30;4;26;.867;3600000;0
18396;56155;579;0;0;0;0;.00nan;0;0
18396;56901;2256;47;42;6;36;.857;3293000;0
18397;14783;1930;0;0;0;0;.00nan;0;0
18397;169493;1930;58;27;3;24;.889;3600000;0
18397;67614;2259;40;34;6;28;.824;3235000;0
18397;89930;2259;43;4;1;3;.750;365000;0
18398;11352;582;0;0;0;0;.00nan;0;0
18398;-1;582;54;26;3;23;.885;3600000;0
18398;56480;1923;45;4;1;3;.750;755000;0
18398;149847;1923;46;35;6;29;.829;2845000;0
18399;218;1931;33;30;6;24;.800;3600000;0
18399;169478;2287;5;24;7;17;.708;3600000;0
18399;37467;1931;0;0;0;0;.00nan;0;0
18399;50245;2287;0;0;0;0;.00nan;0;0
18400;50683;579;0;0;0;0;.00nan;0;0
18400;56155;579;61;25;3;22;.880;3600000;0
18400;67663;1920;59;41;5;36;.878;3600000;0
18400;143879;1920;0;0;0;0;.00nan;0;0
18401;4484;584;56;35;4;31;.886;3574000;0
18401;163021;584;0;0;0;0;.00nan;0;0
18401;14783;1930;84;36;2;34;.944;3600000;0
18401;169493;1930;0;0;0;0;.00nan;0;0
18402;14259;2256;0;0;0;0;.00nan;0;0
18402;56480;1923;0;0;0;0;.00nan;0;0
18402;56901;2256;68;31;2;29;.935;3758000;0
18402;149847;1923;59;24;3;21;.875;3758000;0
18403;4484;584;0;0;0;0;.00nan;0;0
18403;163021;584;86;31;1;30;.968;3600000;0
18403;67614;2259;59;24;3;21;.875;3540000;0
18403;89930;2259;0;0;0;0;.00nan;0;0
18404;4484;584;47;21;3;18;.857;3600000;0
18404;163021;584;0;0;0;0;.00nan;0;0
18404;14259;2256;35;44;7;37;.841;3600000;0
18404;56901;2256;0;0;0;0;.00nan;0;0
18405;169478;2287;73;19;1;18;.947;3600000;0
18405;50245;2287;0;0;0;0;.00nan;0;0
18405;67663;1920;0;0;0;0;.00nan;0;0
18405;143879;1920;38;29;6;23;.793;3600000;0
18406;11352;582;0;0;0;0;.00nan;0;0
18406;-1;582;43;32;5;27;.844;3600000;0
18406;50683;579;71;27;2;25;.926;3600000;0
18406;56155;579;0;0;0;0;.00nan;0;0
18407;6541;1934;81;38;3;35;.921;3600000;0
18407;11352;582;37;28;5;23;.821;3600000;0
18407;-1;582;0;0;0;0;.00nan;0;0
18407;67454;1934;0;0;0;0;.00nan;0;0
18408;218;1931;66;26;2;24;.923;3900000;0
18408;37467;1931;0;0;0;0;.00nan;0;0
18408;56480;1923;0;0;0;0;.00nan;0;0
18408;149847;1923;73;31;2;29;.935;3900000;0
18409;14783;1930;72;13;0;13;1.000;2564000;0
18409;169493;1930;24;11;4;7;.636;1036000;0
18409;67663;1920;28;44;7;37;.841;3600000;0
18409;143879;1920;0;0;0;0;.00nan;0;0
18410;4484;584;28;25;5;20;.800;2217000;0
18410;163021;584;52;9;1;8;.889;1355000;0
18410;11687;1933;53;27;4;23;.852;3600000;0
18410;19010;1933;0;0;0;0;.00nan;0;0
18411;14259;2256;48;13;3;10;.769;1353000;0
18411;56480;1923;49;25;4;21;.840;3600000;0
18411;56901;2256;38;41;7;34;.829;2247000;0
18411;149847;1923;0;0;0;0;.00nan;0;0
18412;169478;2287;50;22;4;18;.818;3593000;0
18412;50245;2287;0;0;0;0;.00nan;0;0
18412;67614;2259;87;39;2;37;.949;3600000;0
18412;89930;2259;0;0;0;0;.00nan;0;0
18413;218;1931;52;41;6;35;.854;3600000;0
18413;37467;1931;0;0;0;0;.00nan;0;0
18413;50683;579;40;19;3;16;.842;3600000;0
18413;56155;579;0;0;0;0;.00nan;0;0
18414;11352;582;0;0;0;0;.00nan;0;0
18414;-1;582;52;45;6;39;.867;3600000;0
18414;169478;2287;66;20;1;19;.950;3600000;0
18414;50245;2287;0;0;0;0;.00nan;0;0
18415;50683;579;0;0;0;0;.00nan;0;0
18415;56155;579;76;25;2;23;.920;3600000;0
18415;67614;2259;72;34;3;31;.912;3600000;0
18415;89930;2259;0;0;0;0;.00nan;0;0
18416;14783;1930;0;0;0;0;.00nan;0;0
18416;169493;1930;71;19;1;18;.947;3600000;0
18416;56480;1923;0;0;0;0;.00nan;0;0
18416;149847;1923;48;41;6;35;.854;3600000;0
18417;11687;1933;55;26;3;23;.885;3600000;0
18417;19010;1933;0;0;0;0;.00nan;0;0
18417;67663;1920;0;0;0;0;.00nan;0;0
18417;143879;1920;74;34;2;32;.941;3600000;0
18418;4484;584;68;43;4;39;.907;3513000;0
18418;163021;584;0;0;0;0;.00nan;0;0
18418;6541;1934;84;34;2;32;.941;3600000;0
18418;67454;1934;0;0;0;0;.00nan;0;0
18419;14259;2256;0;0;0;0;.00nan;0;0
18419;169478;2287;47;13;3;10;.769;2419000;0
18419;50245;2287;39;18;4;14;.778;1181000;0
18419;56901;2256;69;35;4;31;.886;3600000;0
18420;218;1931;24;5;3;2;.400;270000;0
18420;37467;1931;52;32;5;27;.844;3289000;0
18420;67614;2259;0;0;0;0;.00nan;0;0
18420;89930;2259;42;33;6;27;.818;3600000;0
18421;6541;1934;71;30;2;28;.933;3600000;0
18421;67454;1934;0;0;0;0;.00nan;0;0
18421;67663;1920;57;32;4;28;.875;3575000;0
18421;143879;1920;0;0;0;0;.00nan;0;0
18422;11687;1933;54;37;5;32;.865;3566000;0
18422;19010;1933;0;0;0;0;.00nan;0;0
18422;169478;2287;63;19;2;17;.895;3600000;0
18422;50245;2287;0;0;0;0;.00nan;0;0
18423;6541;1934;74;34;3;31;.912;3900000;0
18423;14259;2256;0;0;0;0;.00nan;0;0
18423;56901;2256;87;41;3;38;.927;3900000;0
18423;67454;1934;0;0;0;0;.00nan;0;0
18424;50683;579;70;17;1;16;.941;3600000;0
18424;56155;579;0;0;0;0;.00nan;0;0
18424;67614;2259;44;40;6;34;.850;3600000;0
18424;89930;2259;0;0;0;0;.00nan;0;0
18425;11687;1933;0;0;0;0;.00nan;0;0
18425;19010;1933;75;42;3;39;.929;3600000;0
18425;67663;1920;82;25;1;24;.960;3139000;0
18425;143879;1920;31;11;3;8;.727;404000;0
18426;218;1931;48;21;3;18;.857;3900000;0
18426;37467;1931;0;0;0;0;.00nan;0;0
18426;56480;1923;0;0;0;0;.00nan;0;0
18426;149847;1923;72;28;3;25;.893;3900000;0
18427;218;1931;65;11;0;11;1.000;1019000;0
18427;6541;1934;52;20;3;17;.850;3600000;0
18427;37467;1931;16;18;6;12;.667;2581000;0
18427;67454;1934;0;0;0;0;.00nan;0;0
18428;14783;1930;0;0;0;0;.00nan;0;0
18428;169493;1930;59;24;3;21;.875;3600000;0
18428;50683;579;45;36;6;30;.833;2873000;0
18428;56155;579;50;1;0;1;1.000;727000;0
18429;6541;1934;49;29;5;24;.828;3600000;0
18429;11687;1933;18;24;6;18;.750;3124000;0
18429;19010;1933;57;6;0;6;1.000;476000;0
18429;67454;1934;0;0;0;0;.00nan;0;0
18430;14259;2256;0;0;0;0;.00nan;0;0
18430;56901;2256;26;35;7;28;.800;3600000;0
18430;67614;2259;73;27;2;25;.926;3600000;0
18430;89930;2259;0;0;0;0;.00nan;0;0
18431;11352;582;0;0;0;0;.00nan;0;0
18431;11687;1933;46;27;4;23;.852;3600000;0
18431;-1;582;75;26;1;25;.962;3600000;0
18431;19010;1933;0;0;0;0;.00nan;0;0
18432;4484;584;48;38;5;33;.868;3575000;0
18432;163021;584;0;0;0;0;.00nan;0;0
18432;14783;1930;27;12;4;8;.667;1043000;0
18432;169493;1930;82;17;0;17;1.000;2557000;0
18433;11352;582;52;22;3;19;.864;3600000;0
18433;14783;1930;0;0;0;0;.00nan;0;0
18433;-1;582;0;0;0;0;.00nan;0;0
18433;169493;1930;45;27;4;23;.852;3600000;0
18434;218;1931;67;24;2;22;.917;3600000;0
18434;37467;1931;0;0;0;0;.00nan;0;0
18434;67663;1920;59;38;5;33;.868;3600000;0
18434;143879;1920;0;0;0;0;.00nan;0;0
18435;6541;1934;0;0;0;0;.00nan;0;0
18435;169478;2287;90;19;1;18;.947;3900000;0
18435;50245;2287;0;0;0;0;.00nan;0;0
18435;67454;1934;81;23;1;22;.957;3900000;0
18436;50683;579;99;46;2;44;.957;3600000;0
18436;56155;579;0;0;0;0;.00nan;0;0
18436;56480;1923;0;0;0;0;.00nan;0;0
18436;149847;1923;39;39;6;33;.846;3600000;0
18437;11352;582;0;0;0;0;.00nan;0;0
18437;14259;2256;11;43;10;33;.767;3345000;0
18437;-1;582;56;21;3;18;.857;3600000;0
18437;56901;2256;51;3;0;3;1.000;255000;0
18438;50683;579;36;33;6;27;.818;3600000;0
18438;56155;579;0;0;0;0;.00nan;0;0
18438;56480;1923;54;20;3;17;.850;2444000;0
18438;149847;1923;26;13;4;9;.692;1100000;0
18439;14783;1930;62;27;3;24;.889;3600000;0
18439;169478;2287;52;30;4;26;.867;3572000;0
18439;169493;1930;0;0;0;0;.00nan;0;0
18439;50245;2287;0;0;0;0;.00nan;0;0
18440;67614;2259;33;15;4;11;.733;950000;0
18440;67663;1920;0;0;0;0;.00nan;0;0
18440;89930;2259;57;22;2;20;.909;2650000;0
18440;143879;1920;95;42;2;40;.952;3600000;0
18441;6541;1934;19;23;6;17;.739;3278000;0
18441;56480;1923;0;0;0;0;.00nan;0;0
18441;67454;1934;44;4;1;3;.750;322000;0
18441;149847;1923;55;25;3;22;.880;3600000;0
18442;218;1931;95;37;1;36;.973;3600000;0
18442;11687;1933;51;18;2;16;.889;3549000;0
18442;19010;1933;0;0;0;0;.00nan;0;0
18442;37467;1931;0;0;0;0;.00nan;0;0
18443;4484;584;0;0;0;0;.00nan;0;0
18443;163021;584;75;30;2;28;.933;3600000;0
18443;50683;579;43;27;5;22;.815;3600000;0
18443;56155;579;0;0;0;0;.00nan;0;0
18444;6541;1934;58;19;3;16;.842;3900000;0
18444;14259;2256;0;0;0;0;.00nan;0;0
18444;56901;2256;85;41;3;38;.927;3900000;0
18444;67454;1934;0;0;0;0;.00nan;0;0
18445;14783;1930;0;0;0;0;.00nan;0;0
18445;169493;1930;19;27;6;21;.778;3593000;0
18445;67663;1920;55;37;5;32;.865;3600000;0
18445;143879;1920;0;0;0;0;.00nan;0;0
18446;11687;1933;68;36;4;32;.889;3600000;0
18446;14259;2256;75;25;2;23;.920;3600000;0
18446;19010;1933;0;0;0;0;.00nan;0;0
18446;56901;2256;0;0;0;0;.00nan;0;0
18447;169478;2287;23;32;7;25;.781;3600000;0
18447;50245;2287;0;0;0;0;.00nan;0;0
18447;56480;1923;0;0;0;0;.00nan;0;0
18447;149847;1923;56;34;4;30;.882;3600000;0
18448;14259;2256;0;0;0;0;.00nan;0;0
18448;50683;579;68;31;4;27;.871;3600000;0
18448;56155;579;0;0;0;0;.00nan;0;0
18448;56901;2256;21;39;8;31;.795;3590000;0
18449;11352;582;68;21;1;20;.952;2456000;0
18449;-1;582;29;12;4;8;.667;1144000;0
18449;67663;1920;0;0;0;0;.00nan;0;0
18449;143879;1920;77;34;3;31;.912;3600000;0
18450;56480;1923;0;0;0;0;.00nan;0;0
18450;67614;2259;80;31;2;29;.935;3600000;0
18450;89930;2259;0;0;0;0;.00nan;0;0
18450;149847;1923;30;31;6;25;.806;3600000;0
18451;6541;1934;41;19;4;15;.789;3600000;0
18451;11687;1933;0;0;0;0;.00nan;0;0
18451;19010;1933;21;32;7;25;.781;3600000;0
18451;67454;1934;0;0;0;0;.00nan;0;0
18452;218;1931;61;39;4;35;.897;3600000;0
18452;4484;584;58;26;3;23;.885;3600000;0
18452;163021;584;0;0;0;0;.00nan;0;0
18452;37467;1931;0;0;0;0;.00nan;0;0
18453;6541;1934;74;21;2;19;.905;3600000;0
18453;67454;1934;0;0;0;0;.00nan;0;0
18453;67614;2259;87;51;4;47;.922;3563000;0
18453;89930;2259;0;0;0;0;.00nan;0;0
18454;11352;582;0;0;0;0;.00nan;0;0
18454;-1;582;42;20;4;16;.800;3563000;0
18454;169478;2287;75;37;3;34;.919;3600000;0
18454;50245;2287;0;0;0;0;.00nan;0;0
18455;4484;584;41;34;5;29;.853;3600000;0
18455;163021;584;0;0;0;0;.00nan;0;0
18455;11352;582;0;0;0;0;.00nan;0;0
18455;-1;582;89;42;2;40;.952;3600000;0
18456;6541;1934;60;15;1;14;.933;3600000;0
18456;169478;2287;50;1;0;1;1.000;354000;0
18456;50245;2287;39;33;6;27;.818;3246000;0
18456;67454;1934;0;0;0;0;.00nan;0;0
18457;14259;2256;64;32;3;29;.906;3600000;0
18457;56901;2256;0;0;0;0;.00nan;0;0
18457;67663;1920;0;0;0;0;.00nan;0;0
18457;143879;1920;56;37;4;33;.892;3544000;0
18458;169478;2287;67;17;1;16;.941;3600000;0
18458;50245;2287;0;0;0;0;.00nan;0;0
18458;67614;2259;77;36;3;33;.917;3573000;0
18458;89930;2259;0;0;0;0;.00nan;0;0
18459;218;1931;0;0;0;0;.00nan;0;0
18459;14783;1930;42;3;1;2;.667;755000;0
18459;169493;1930;25;23;6;17;.739;2845000;0
18459;37467;1931;63;26;3;23;.885;3600000;0
18460;11687;1933;58;32;4;28;.875;3756000;0
18460;19010;1933;0;0;0;0;.00nan;0;0
18460;56480;1923;0;0;0;0;.00nan;0;0
18460;149847;1923;53;23;3;20;.870;3756000;0
18461;11352;582;74;29;3;26;.897;3900000;0
18461;11687;1933;0;0;0;0;.00nan;0;0
18461;-1;582;0;0;0;0;.00nan;0;0
18461;19010;1933;73;28;3;25;.893;3900000;0
18462;14783;1930;21;12;4;8;.667;1149000;0
18462;169493;1930;32;24;5;19;.792;2451000;0
18462;50683;579;0;0;0;0;.00nan;0;0
18462;56155;579;59;32;4;28;.875;3600000;0
18463;4484;584;26;30;6;24;.800;3600000;0
18463;163021;584;0;0;0;0;.00nan;0;0
18463;56480;1923;52;31;4;27;.871;3600000;0
18463;149847;1923;0;0;0;0;.00nan;0;0
18464;218;1931;63;14;2;12;.857;3530000;0
18464;14259;2256;100;30;0;30;1.000;3600000;0
18464;37467;1931;0;0;0;0;.00nan;0;0
18464;56901;2256;0;0;0;0;.00nan;0;0
18465;11687;1933;55;37;5;32;.865;3600000;0
18465;19010;1933;0;0;0;0;.00nan;0;0
18465;50683;579;49;20;3;17;.850;3600000;0
18465;56155;579;0;0;0;0;.00nan;0;0
18466;56480;1923;0;0;0;0;.00nan;0;0
18466;67614;2259;94;38;2;36;.947;3600000;0
18466;89930;2259;0;0;0;0;.00nan;0;0
18466;149847;1923;63;28;3;25;.893;3544000;0
18467;4484;584;60;47;6;41;.872;3135000;0
18467;163021;584;49;8;1;7;.875;465000;0
18467;67663;1920;87;22;1;21;.955;3600000;0
18467;143879;1920;0;0;0;0;.00nan;0;0
18468;11352;582;0;0;0;0;.00nan;0;0
18468;14783;1930;0;0;0;0;.00nan;0;0
18468;-1;582;71;34;3;31;.912;3600000;0
18468;169493;1930;69;19;2;17;.895;3600000;0
18469;11352;582;85;33;2;31;.939;3600000;0
18469;-1;582;0;0;0;0;.00nan;0;0
18469;67614;2259;60;8;0;8;1.000;632000;0
18469;89930;2259;3;35;9;26;.743;2968000;0
18470;218;1931;0;0;0;0;.00nan;0;0
18470;6541;1934;54;24;3;21;.875;3900000;0
18470;37467;1931;78;36;3;33;.917;3900000;0
18470;67454;1934;0;0;0;0;.00nan;0;0
18471;14783;1930;30;22;5;17;.773;3600000;0
18471;169493;1930;0;0;0;0;.00nan;0;0
18471;56480;1923;9;17;6;11;.647;2234000;0
18471;149847;1923;54;11;1;10;.909;1313000;0
18472;4484;584;29;14;4;10;.714;1426000;0
18472;163021;584;24;25;6;19;.760;2174000;0
18472;169478;2287;84;15;0;15;1.000;3600000;0
18472;50245;2287;0;0;0;0;.00nan;0;0
18473;11352;582;0;0;0;0;.00nan;0;0
18473;14259;2256;75;37;3;34;.919;3600000;0
18473;-1;582;45;25;4;21;.840;3554000;0
18473;56901;2256;0;0;0;0;.00nan;0;0
18474;218;1931;21;24;6;18;.750;3565000;0
18474;37467;1931;0;0;0;0;.00nan;0;0
18474;50683;579;37;24;5;19;.792;3600000;0
18474;56155;579;0;0;0;0;.00nan;0;0
18475;4484;584;82;39;2;37;.949;3555000;0
18475;163021;584;0;0;0;0;.00nan;0;0
18475;11687;1933;62;17;1;16;.941;3600000;0
18475;19010;1933;0;0;0;0;.00nan;0;0
18476;218;1931;49;40;6;34;.850;3236000;0
18476;14259;2256;66;30;3;27;.900;3600000;0
18476;37467;1931;52;2;0;2;1.000;364000;0
18476;56901;2256;0;0;0;0;.00nan;0;0
18477;14783;1930;0;0;0;0;.00nan;0;0
18477;169493;1930;46;10;2;8;.800;3600000;0
18477;67614;2259;31;23;5;18;.783;1917000;0
18477;89930;2259;60;14;1;13;.929;1683000;0
18478;56480;1923;61;33;4;29;.879;3094000;0
18478;67663;1920;0;0;0;0;.00nan;0;0
18478;143879;1920;68;23;2;21;.913;3600000;0
18478;149847;1923;30;10;3;7;.700;506000;0
18479;4484;584;36;33;6;27;.818;3053000;0
18479;163021;584;70;12;0;12;1.000;547000;0
18479;50683;579;45;23;4;19;.826;3600000;0
18479;56155;579;0;0;0;0;.00nan;0;0
18480;67614;2259;91;42;2;40;.952;3558000;0
18480;67663;1920;79;14;0;14;1.000;3600000;0
18480;89930;2259;0;0;0;0;.00nan;0;0
18480;143879;1920;0;0;0;0;.00nan;0;0
18481;11352;582;37;5;2;3;.600;473000;0
18481;-1;582;37;27;5;22;.815;3127000;0
18481;50683;579;0;0;0;0;.00nan;0;0
18481;56155;579;67;28;4;24;.857;3600000;0
18482;6541;1934;29;32;6;26;.813;2418000;0
18482;169478;2287;65;18;1;17;.944;3600000;0
18482;50245;2287;0;0;0;0;.00nan;0;0
18482;67454;1934;44;6;1;5;.833;1182000;0
18483;11687;1933;0;0;0;0;.00nan;0;0
18483;14259;2256;27;12;4;8;.667;1089000;0
18483;19010;1933;62;30;4;26;.867;3600000;0
18483;56901;2256;76;27;1;26;.963;2508000;0
18484;218;1931;0;0;0;0;.00nan;0;0
18484;11687;1933;100;35;0;35;1.000;3600000;0
18484;19010;1933;0;0;0;0;.00nan;0;0
18484;37467;1931;56;37;5;32;.865;3600000;0
18485;6541;1934;0;0;0;0;.00nan;0;0
18485;56480;1923;0;0;0;0;.00nan;0;0
18485;67454;1934;81;22;1;21;.955;3600000;0
18485;149847;1923;65;27;3;24;.889;3600000;0
18486;14783;1930;0;0;0;0;.00nan;0;0
18486;169478;2287;0;0;0;0;.00nan;0;0
18486;169493;1930;70;39;4;35;.897;3600000;0
18486;50245;2287;77;26;1;25;.962;3600000;0
18487;4484;584;58;32;4;28;.875;3589000;0
18487;163021;584;0;0;0;0;.00nan;0;0
18487;11352;582;0;0;0;0;.00nan;0;0
18487;-1;582;81;29;2;27;.931;3600000;0
18488;14783;1930;0;0;0;0;.00nan;0;0
18488;169493;1930;76;24;1;23;.958;3600000;0
18488;67614;2259;72;40;4;36;.900;3600000;0
18488;89930;2259;0;0;0;0;.00nan;0;0
18489;11687;1933;52;34;5;29;.853;3828000;0
18489;19010;1933;0;0;0;0;.00nan;0;0
18489;50683;579;59;35;4;31;.886;3851000;0
18489;56155;579;0;0;0;0;.00nan;0;0
18490;169478;2287;14;20;6;14;.700;3600000;0
18490;50245;2287;0;0;0;0;.00nan;0;0
18490;56480;1923;0;0;0;0;.00nan;0;0
18490;149847;1923;100;34;0;34;1.000;3600000;0
18491;6541;1934;57;25;3;22;.880;3551000;0
18491;67454;1934;0;0;0;0;.00nan;0;0
18491;67663;1920;0;0;0;0;.00nan;0;0
18491;143879;1920;65;25;2;23;.920;3600000;0
18492;14259;2256;45;33;5;28;.848;3600000;0
18492;50683;579;0;0;0;0;.00nan;0;0
18492;56155;579;85;25;1;24;.960;3600000;0
18492;56901;2256;0;0;0;0;.00nan;0;0
18493;14783;1930;81;38;2;36;.947;3600000;0
18493;169493;1930;0;0;0;0;.00nan;0;0
18493;56480;1923;0;0;0;0;.00nan;0;0
18493;149847;1923;68;31;3;28;.903;3600000;0
18494;4484;584;0;0;0;0;.00nan;0;0
18494;163021;584;91;21;0;21;1.000;3600000;0
18494;11687;1933;0;0;0;0;.00nan;0;0
18494;19010;1933;39;23;5;18;.783;3600000;0
18495;218;1931;70;42;4;38;.905;3515000;0
18495;11352;582;74;24;2;22;.917;3600000;0
18495;-1;582;0;0;0;0;.00nan;0;0
18495;37467;1931;0;0;0;0;.00nan;0;0
18496;6541;1934;0;0;0;0;.00nan;0;0
18496;67454;1934;60;35;4;31;.886;3600000;0
18496;67614;2259;100;30;0;30;1.000;3600000;0
18496;89930;2259;0;0;0;0;.00nan;0;0
18497;169478;2287;58;23;3;20;.870;3600000;0
18497;50245;2287;0;0;0;0;.00nan;0;0
18497;67663;1920;26;25;6;19;.760;2132000;0
18497;143879;1920;46;19;3;16;.842;1468000;0
18498;11352;582;0;0;0;0;.00nan;0;0
18498;14259;2256;65;50;5;45;.900;3600000;0
18498;-1;582;72;18;1;17;.944;3600000;0
18498;56901;2256;0;0;0;0;.00nan;0;0
18499;218;1931;48;0;0;0;.00nan;271000;0
18499;37467;1931;29;42;7;35;.833;3329000;0
18499;50683;579;64;29;3;26;.897;3600000;0
18499;56155;579;0;0;0;0;.00nan;0;0
18500;14783;1930;44;27;4;23;.852;3600000;0
18500;169493;1930;0;0;0;0;.00nan;0;0
18500;67663;1920;0;0;0;0;.00nan;0;0
18500;143879;1920;61;41;5;36;.878;3600000;0
18501;169478;2287;37;14;3;11;.786;3560000;0
18501;50245;2287;0;0;0;0;.00nan;0;0
18501;56480;1923;0;0;0;0;.00nan;0;0
18501;149847;1923;79;33;2;31;.939;3600000;0
18502;4484;584;0;0;0;0;.00nan;0;0
18502;163021;584;81;25;2;23;.920;3600000;0
18502;14259;2256;10;26;7;19;.731;2812000;0
18502;56901;2256;55;11;1;10;.909;788000;0
18503;11352;582;0;0;0;0;.00nan;0;0
18503;11687;1933;54;45;6;39;.867;2536000;0
18503;-1;582;87;29;1;28;.966;3600000;0
18503;19010;1933;43;4;1;3;.750;1064000;0
18504;218;1931;63;28;3;25;.893;3600000;0
18504;4484;584;55;31;4;27;.871;3600000;0
18504;163021;584;0;0;0;0;.00nan;0;0
18504;37467;1931;0;0;0;0;.00nan;0;0
18505;6541;1934;59;22;3;19;.864;3553000;0
18505;14783;1930;0;0;0;0;.00nan;0;0
18505;169493;1930;78;27;2;25;.926;3600000;0
18505;67454;1934;0;0;0;0;.00nan;0;0
18506;56480;1923;60;29;3;26;.897;3600000;0
18506;67614;2259;49;31;5;26;.839;3597000;0
18506;89930;2259;0;0;0;0;.00nan;0;0
18506;149847;1923;0;0;0;0;.00nan;0;0
18507;169478;2287;79;20;1;19;.950;3600000;0
18507;50245;2287;0;0;0;0;.00nan;0;0
18507;67614;2259;81;51;4;47;.922;3600000;0
18507;89930;2259;0;0;0;0;.00nan;0;0
18508;6541;1934;0;0;0;0;.00nan;0;0
18508;67454;1934;57;24;3;21;.875;3557000;0
18508;67663;1920;76;29;2;27;.931;3600000;0
18508;143879;1920;0;0;0;0;.00nan;0;0
18510;6541;1934;51;30;5;25;.833;3545000;0
18510;50683;579;74;42;4;38;.905;3600000;0
18510;56155;579;0;0;0;0;.00nan;0;0
18510;67454;1934;0;0;0;0;.00nan;0;0
18512;11352;582;0;0;0;0;.00nan;0;0
18512;14783;1930;0;0;0;0;.00nan;0;0
18512;-1;582;53;27;4;23;.852;3600000;0
18512;169493;1930;100;35;0;35;1.000;3600000;0
18514;11687;1933;75;19;1;18;.947;3600000;0
18514;19010;1933;0;0;0;0;.00nan;0;0
18514;89930;2259;68;52;6;46;.885;3600000;0
18514;155945;2259;0;0;0;0;.00nan;0;0
18516;20196;1931;0;0;0;0;.00nan;0;0
18516;169478;2287;54;15;2;13;.867;3749000;0
18516;50245;2287;0;0;0;0;.00nan;0;0
18516;67614;1931;86;43;3;40;.930;3749000;0
18518;14259;2256;0;0;0;0;.00nan;0;0
18518;56480;1923;0;0;0;0;.00nan;0;0
18518;56901;2256;54;24;3;21;.875;3578000;0
18518;155917;1923;68;25;2;23;.920;3600000;0
18520;4484;584;51;34;5;29;.853;3600000;0
18520;163021;584;0;0;0;0;.00nan;0;0
18520;67663;1920;0;0;0;0;.00nan;0;0
18520;143879;1920;60;44;6;38;.864;3561000;0
18522;11687;1933;0;0;0;0;.00nan;0;0
18522;19010;1933;28;35;7;28;.800;3595000;0
18522;50683;579;0;0;0;0;.00nan;0;0
18522;56155;579;68;48;6;42;.875;3600000;0
18524;14259;2256;28;24;5;19;.792;3581000;0
18524;20196;1931;52;23;3;20;.870;3600000;0
18524;56901;2256;0;0;0;0;.00nan;0;0
18524;67614;1931;0;0;0;0;.00nan;0;0
18526;67663;1920;81;33;3;30;.909;3780000;0
18526;89930;2259;0;0;0;0;.00nan;0;0
18526;143879;1920;0;0;0;0;.00nan;0;0
18526;155945;2259;58;27;4;23;.852;3780000;0
18528;11352;582;0;0;0;0;.00nan;0;0
18528;14783;1930;0;0;0;0;.00nan;0;0
18528;-1;582;42;22;4;18;.818;3600000;0
18528;169493;1930;100;35;0;35;1.000;3600000;0
18530;4484;584;0;0;0;0;.00nan;0;0
18530;163021;584;70;31;3;28;.903;3600000;0
18530;169478;2287;0;0;0;0;.00nan;0;0
18530;50245;2287;48;26;5;21;.808;3554000;0
18532;6541;1934;0;0;0;0;.00nan;0;0
18532;56480;1923;74;34;3;31;.912;3545000;0
18532;67454;1934;74;31;2;29;.935;3600000;0
18532;155917;1923;0;0;0;0;.00nan;0;0
18534;50683;579;59;23;3;20;.870;3600000;0
18534;56155;579;0;0;0;0;.00nan;0;0
18534;56480;1923;57;10;0;10;1.000;450000;0
18534;155917;1923;48;31;5;26;.839;3094000;0
18536;4484;584;84;44;3;41;.932;3600000;0
18536;163021;584;0;0;0;0;.00nan;0;0
18536;169478;2287;49;25;4;21;.840;3600000;0
18536;50245;2287;0;0;0;0;.00nan;0;0
18538;20196;1931;0;0;0;0;.00nan;0;0
18538;67614;1931;97;26;1;25;.962;3600000;0
18538;89930;2259;66;35;4;31;.886;3600000;0
18538;155945;2259;0;0;0;0;.00nan;0;0
18540;14259;2256;0;0;0;0;.00nan;0;0
18540;56901;2256;72;37;3;34;.919;3600000;0
18540;67663;1920;41;2;1;1;.500;467000;0
18540;143879;1920;23;26;6;20;.769;3133000;0
18542;6541;1934;43;25;4;21;.840;3600000;0
18542;11352;582;0;0;0;0;.00nan;0;0
18542;-1;582;47;37;5;32;.865;3547000;0
18542;67454;1934;0;0;0;0;.00nan;0;0
18544;11687;1933;67;31;3;28;.903;3600000;0
18544;14783;1930;55;21;3;18;.857;2993000;0
18544;19010;1933;0;0;0;0;.00nan;0;0
18544;169493;1930;22;12;4;8;.667;607000;0
18546;56480;1923;48;34;6;28;.824;3600000;0
18546;89930;2259;0;0;0;0;.00nan;0;0
18546;155917;1923;0;0;0;0;.00nan;0;0
18546;155945;2259;80;27;1;26;.963;3600000;0
18548;11352;582;61;39;5;34;.872;3566000;0
18548;11687;1933;0;0;0;0;.00nan;0;0
18548;-1;582;0;0;0;0;.00nan;0;0
18548;19010;1933;56;28;4;24;.857;3600000;0
18550;14259;2256;96;43;2;41;.953;3900000;0
18550;169478;2287;0;0;0;0;.00nan;0;0
18550;50245;2287;57;18;2;16;.889;3900000;0
18550;56901;2256;0;0;0;0;.00nan;0;0
18552;6541;1934;0;0;0;0;.00nan;0;0
18552;67454;1934;48;22;3;19;.864;3600000;0
18552;67663;1920;80;47;5;42;.894;3579000;0
18552;143879;1920;0;0;0;0;.00nan;0;0
18554;4484;584;0;0;0;0;.00nan;0;0
18554;163021;584;57;31;3;28;.903;3564000;0
18554;20196;1931;93;34;1;33;.971;3600000;0
18554;67614;1931;0;0;0;0;.00nan;0;0
18556;14783;1930;57;4;0;4;1.000;657000;0
18556;169493;1930;30;28;6;22;.786;2943000;0
18556;50683;579;0;0;0;0;.00nan;0;0
18556;56155;579;82;35;2;33;.943;3600000;0
610;50683;579;25;25;6;19;.760;2312000;0
610;56155;579;46;6;1;5;.833;1288000;0
610;67663;1920;0;0;0;0;.00nan;0;0
610;143879;1920;66;30;3;27;.900;3600000;0
611;6541;1934;92;29;1;28;.966;3600000;0
611;14783;1930;49;22;3;19;.864;3561000;0
611;169493;1930;0;0;0;0;.00nan;0;0
611;67454;1934;0;0;0;0;.00nan;0;0
612;11352;582;0;0;0;0;.00nan;0;0
612;-1;582;39;14;3;11;.786;3600000;0
612;169478;2287;31;29;6;23;.793;3600000;0
612;50245;2287;0;0;0;0;.00nan;0;0
613;6541;1934;81;33;2;31;.939;3600000;0
613;50683;579;41;29;5;24;.828;3600000;0
613;56155;579;0;0;0;0;.00nan;0;0
613;67454;1934;0;0;0;0;.00nan;0;0
614;11352;582;0;0;0;0;.00nan;0;0
614;-1;582;46;30;5;25;.833;3520000;0
614;67663;1920;81;38;3;35;.921;3600000;0
614;143879;1920;0;0;0;0;.00nan;0;0
615;14783;1930;64;24;3;21;.875;3600000;0
615;169478;2287;86;33;2;31;.939;3600000;0
615;169493;1930;0;0;0;0;.00nan;0;0
615;50245;2287;0;0;0;0;.00nan;0;0
616;11352;582;93;26;0;26;1.000;3600000;0
616;-1;582;0;0;0;0;.00nan;0;0
616;50683;579;51;37;4;33;.892;3600000;0
616;56155;579;0;0;0;0;.00nan;0;0
617;6541;1934;95;22;0;22;1.000;3600000;0
617;169478;2287;49;24;4;20;.833;3600000;0
617;50245;2287;0;0;0;0;.00nan;0;0
617;67454;1934;0;0;0;0;.00nan;0;0
618;14783;1930;0;0;0;0;.00nan;0;0
618;169493;1930;54;36;5;31;.861;3900000;0
618;67663;1920;0;0;0;0;.00nan;0;0
618;143879;1920;43;28;5;23;.821;3900000;0
619;169478;2287;19;9;4;5;.556;623000;0
619;50245;2287;73;22;1;21;.955;2977000;0
619;50683;579;43;3;1;2;.667;483000;0
619;56155;579;41;37;6;31;.838;3033000;0
620;11352;582;0;0;0;0;.00nan;0;0
620;14783;1930;83;31;1;30;.968;3600000;0
620;-1;582;30;35;7;28;.800;3600000;0
620;169493;1930;0;0;0;0;.00nan;0;0
621;6541;1934;78;23;1;22;.957;3600000;0
621;67454;1934;0;0;0;0;.00nan;0;0
621;67663;1920;72;32;3;29;.906;3576000;0
621;143879;1920;0;0;0;0;.00nan;0;0
622;14783;1930;0;0;0;0;.00nan;0;0
622;169493;1930;32;41;8;33;.805;3517000;0
622;50683;579;39;33;6;27;.818;3030000;0
622;56155;579;56;4;0;4;1.000;570000;0
623;169478;2287;28;20;5;15;.750;3600000;0
623;50245;2287;0;0;0;0;.00nan;0;0
623;67663;1920;0;0;0;0;.00nan;0;0
623;143879;1920;77;30;2;28;.933;3600000;0
624;6541;1934;74;33;3;30;.909;3600000;0
624;11352;582;27;22;5;17;.773;2464000;0
624;-1;582;41;18;4;14;.778;1136000;0
624;67454;1934;0;0;0;0;.00nan;0;0
625;50683;579;40;37;6;31;.838;3600000;0
625;56155;579;0;0;0;0;.00nan;0;0
625;67663;1920;86;32;2;30;.938;3600000;0
625;143879;1920;0;0;0;0;.00nan;0;0
626;6541;1934;47;18;3;15;.833;3600000;0
626;14783;1930;64;37;4;33;.892;3545000;0
626;169493;1930;0;0;0;0;.00nan;0;0
626;67454;1934;0;0;0;0;.00nan;0;0
627;11352;582;60;22;2;20;.909;3073000;0
627;-1;582;16;7;4;3;.429;527000;0
627;169478;2287;0;0;0;0;.00nan;0;0
627;50245;2287;58;25;3;22;.880;3600000;0
628;6541;1934;68;19;2;17;.895;3600000;0
628;50683;579;72;27;3;24;.889;3561000;0
628;56155;579;0;0;0;0;.00nan;0;0
628;67454;1934;0;0;0;0;.00nan;0;0
629;11352;582;0;0;0;0;.00nan;0;0
629;-1;582;52;28;4;24;.857;3600000;0
629;67663;1920;66;13;0;13;1.000;1419000;0
629;143879;1920;14;23;6;17;.739;2100000;0
630;14783;1930;0;0;0;0;.00nan;0;0
630;169478;2287;42;20;3;17;.850;3537000;0
630;169493;1930;99;46;1;45;.978;3600000;0
630;50245;2287;0;0;0;0;.00nan;0;0
631;11352;582;0;0;0;0;.00nan;0;0
631;-1;582;71;45;5;40;.889;3580000;0
631;50683;579;59;32;4;28;.875;3600000;0
631;56155;579;0;0;0;0;.00nan;0;0
632;6541;1934;86;42;3;39;.929;3553000;0
632;169478;2287;79;21;1;20;.952;3600000;0
632;50245;2287;0;0;0;0;.00nan;0;0
632;67454;1934;0;0;0;0;.00nan;0;0
633;14783;1930;52;2;0;2;1.000;437000;0
633;169493;1930;27;30;6;24;.800;3163000;0
633;67663;1920;0;0;0;0;.00nan;0;0
633;143879;1920;57;28;3;25;.893;3600000;0
634;169478;2287;51;26;3;23;.885;3563000;0
634;50245;2287;0;0;0;0;.00nan;0;0
634;50683;579;69;28;2;26;.929;3600000;0
634;56155;579;0;0;0;0;.00nan;0;0
635;11352;582;0;0;0;0;.00nan;0;0
635;14783;1930;57;20;2;18;.900;3570000;0
635;-1;582;80;30;1;29;.967;3600000;0
635;169493;1930;0;0;0;0;.00nan;0;0
636;6541;1934;53;34;5;29;.853;3600000;0
636;67454;1934;0;0;0;0;.00nan;0;0
636;67663;1920;27;10;4;6;.600;310000;0
636;143879;1920;87;36;2;34;.944;3266000;0
637;14783;1930;0;0;0;0;.00nan;0;0
637;169493;1930;41;42;7;35;.833;3600000;0
637;50683;579;79;35;2;33;.943;3600000;0
637;56155;579;0;0;0;0;.00nan;0;0
638;169478;2287;0;0;0;0;.00nan;0;0
638;50245;2287;48;26;5;21;.808;3600000;0
638;67663;1920;14;18;6;12;.667;1559000;0
638;143879;1920;51;12;2;10;.833;2041000;0
639;6541;1934;17;7;4;3;.429;142000;0
639;11352;582;51;33;5;28;.848;3600000;0
639;-1;582;0;0;0;0;.00nan;0;0
639;67454;1934;4;33;9;24;.727;3458000;0
640;218;1931;78;30;2;28;.933;3600000;0
640;37467;1931;0;0;0;0;.00nan;0;0
640;67614;2259;75;32;3;29;.906;3549000;0
640;89930;2259;0;0;0;0;.00nan;0;0
641;14259;2256;43;34;6;28;.824;3900000;0
641;56480;1923;0;0;0;0;.00nan;0;0
641;56901;2256;0;0;0;0;.00nan;0;0
641;149847;1923;31;29;6;23;.793;3900000;0
642;4484;584;47;37;5;32;.865;3600000;0
642;163021;584;0;0;0;0;.00nan;0;0
642;11687;1933;68;19;1;18;.947;3600000;0
642;19010;1933;0;0;0;0;.00nan;0;0
643;218;1931;0;0;0;0;.00nan;0;0
643;14259;2256;7;32;8;24;.750;3600000;0
643;37467;1931;71;23;1;22;.957;3600000;0
643;56901;2256;0;0;0;0;.00nan;0;0
644;11687;1933;57;25;3;22;.880;3600000;0
644;19010;1933;0;0;0;0;.00nan;0;0
644;67614;2259;18;24;7;17;.708;2042000;0
644;89930;2259;75;14;0;14;1.000;1558000;0
645;4484;584;51;34;4;30;.882;3521000;0
645;163021;584;0;0;0;0;.00nan;0;0
645;56480;1923;0;0;0;0;.00nan;0;0
645;149847;1923;81;30;2;28;.933;3600000;0
646;218;1931;0;0;0;0;.00nan;0;0
646;11687;1933;11;22;6;16;.727;3131000;0
646;19010;1933;40;2;1;1;.500;391000;0
646;37467;1931;60;39;5;34;.872;3600000;0
647;4484;584;0;0;0;0;.00nan;0;0
647;163021;584;66;31;3;28;.903;3600000;0
647;14259;2256;38;31;6;25;.806;3320000;0
647;56901;2256;52;2;0;2;1.000;280000;0
648;56480;1923;55;3;0;3;1.000;646000;0
648;67614;2259;21;34;7;27;.794;3177000;0
648;89930;2259;42;4;1;3;.750;342000;0
648;149847;1923;22;21;6;15;.714;2954000;0
649;218;1931;30;7;3;4;.571;350000;0
649;4484;584;0;0;0;0;.00nan;0;0
649;163021;584;37;37;6;31;.838;3900000;0
649;37467;1931;70;31;3;28;.903;3550000;0
650;11687;1933;0;0;0;0;.00nan;0;0
650;19010;1933;68;22;2;20;.909;3600000;0
650;56480;1923;0;0;0;0;.00nan;0;0
650;149847;1923;39;28;5;23;.821;3600000;0
651;14259;2256;71;38;4;34;.895;3600000;0
651;56901;2256;0;0;0;0;.00nan;0;0
651;67614;2259;89;30;1;29;.967;3600000;0
651;89930;2259;0;0;0;0;.00nan;0;0
652;218;1931;0;0;0;0;.00nan;0;0
652;37467;1931;47;34;5;29;.853;3579000;0
652;56480;1923;0;0;0;0;.00nan;0;0
652;149847;1923;52;29;4;25;.862;3600000;0
653;4484;584;49;37;5;32;.865;3573000;0
653;163021;584;0;0;0;0;.00nan;0;0
653;67614;2259;92;40;3;37;.925;3600000;0
653;89930;2259;0;0;0;0;.00nan;0;0
654;11687;1933;43;19;3;16;.842;3542000;0
654;14259;2256;84;31;1;30;.968;3600000;0
654;19010;1933;0;0;0;0;.00nan;0;0
654;56901;2256;0;0;0;0;.00nan;0;0
655;218;1931;29;30;6;24;.800;3600000;0
655;37467;1931;0;0;0;0;.00nan;0;0
655;67614;2259;95;36;2;34;.944;3600000;0
655;89930;2259;0;0;0;0;.00nan;0;0
656;14259;2256;53;26;3;23;.885;3600000;0
656;56480;1923;0;0;0;0;.00nan;0;0
656;56901;2256;0;0;0;0;.00nan;0;0
656;149847;1923;43;28;4;24;.857;3600000;0
657;4484;584;84;39;2;37;.949;3600000;0
657;163021;584;0;0;0;0;.00nan;0;0
657;11687;1933;72;29;3;26;.897;3547000;0
657;19010;1933;0;0;0;0;.00nan;0;0
658;218;1931;71;18;1;17;.944;3600000;0
658;14259;2256;40;27;5;22;.815;3600000;0
658;37467;1931;0;0;0;0;.00nan;0;0
658;56901;2256;0;0;0;0;.00nan;0;0
659;11687;1933;0;0;0;0;.00nan;0;0
659;19010;1933;91;21;0;21;1.000;3600000;0
659;67614;2259;71;41;5;36;.878;3600000;0
659;89930;2259;0;0;0;0;.00nan;0;0
660;4484;584;25;26;6;20;.769;3600000;0
660;163021;584;0;0;0;0;.00nan;0;0
660;56480;1923;0;0;0;0;.00nan;0;0
660;149847;1923;82;47;3;44;.936;3600000;0
661;218;1931;0;0;0;0;.00nan;0;0
661;11687;1933;0;0;0;0;.00nan;0;0
661;19010;1933;56;12;2;10;.833;3600000;0
661;37467;1931;65;27;3;24;.889;3574000;0
662;4484;584;71;33;3;30;.909;3600000;0
662;163021;584;0;0;0;0;.00nan;0;0
662;14259;2256;48;25;4;21;.840;3546000;0
662;56901;2256;0;0;0;0;.00nan;0;0
663;56480;1923;62;16;1;15;.938;3054000;0
663;67614;2259;77;33;3;30;.909;3600000;0
663;89930;2259;0;0;0;0;.00nan;0;0
663;149847;1923;26;8;3;5;.625;494000;0
664;218;1931;0;0;0;0;.00nan;0;0
664;4484;584;24;12;4;8;.667;829000;0
664;163021;584;47;20;3;17;.850;2771000;0
664;37467;1931;56;22;3;19;.864;3600000;0
665;11687;1933;0;0;0;0;.00nan;0;0
665;19010;1933;55;28;3;25;.893;3522000;0
665;56480;1923;88;25;1;24;.960;3600000;0
665;149847;1923;0;0;0;0;.00nan;0;0
666;14259;2256;64;31;3;28;.903;3600000;0
666;56901;2256;0;0;0;0;.00nan;0;0
666;67614;2259;35;26;5;21;.808;3546000;0
666;89930;2259;0;0;0;0;.00nan;0;0
667;218;1931;0;0;0;0;.00nan;0;0
667;37467;1931;56;33;4;29;.879;3600000;0
667;56480;1923;0;0;0;0;.00nan;0;0
667;149847;1923;58;25;3;22;.880;3600000;0
668;4484;584;50;29;4;25;.862;3900000;0
668;163021;584;0;0;0;0;.00nan;0;0
668;67614;2259;66;27;4;23;.852;3900000;0
668;89930;2259;0;0;0;0;.00nan;0;0
669;11687;1933;0;0;0;0;.00nan;0;0
669;14259;2256;58;8;0;8;1.000;602000;0
669;19010;1933;71;32;3;29;.906;3600000;0
669;56901;2256;25;27;6;21;.778;2998000;0
1279;218;1931;67;30;3;27;.900;3600000;0
1279;37467;1931;0;0;0;0;.00nan;0;0
1279;50683;579;66;21;2;19;.905;3600000;0
1279;56155;579;0;0;0;0;.00nan;0;0
1280;6541;1934;27;7;3;4;.571;387000;0
1280;56480;1923;8;17;6;11;.647;1607000;0
1280;67454;1934;54;21;4;17;.810;3213000;0
1280;149847;1923;32;25;5;20;.800;1993000;0
1281;14783;1930;0;0;0;0;.00nan;0;0
1281;169493;1930;92;35;1;34;.971;3600000;0
1281;67663;1920;0;0;0;0;.00nan;0;0
1281;143879;1920;58;28;3;25;.893;3544000;0
1282;11352;582;54;22;2;20;.909;1928000;0
1282;-1;582;13;18;6;12;.667;2340000;0
1282;169478;2287;19;25;7;18;.720;3333000;0
1282;50245;2287;56;5;0;5;1.000;935000;0
1283;218;1931;91;38;2;36;.947;3600000;0
1283;37467;1931;0;0;0;0;.00nan;0;0
1283;50683;579;11;11;5;6;.545;2059000;0
1283;56155;579;50;2;0;2;1.000;1541000;0
1284;6541;1934;46;33;4;29;.879;4694000;0
1284;56480;1923;0;0;0;0;.00nan;0;0
1284;67454;1934;0;0;0;0;.00nan;0;0
1284;149847;1923;81;48;3;45;.938;4694000;0
1285;14783;1930;0;0;0;0;.00nan;0;0
1285;169493;1930;86;33;2;31;.939;3989000;0
1285;67663;1920;0;0;0;0;.00nan;0;0
1285;143879;1920;100;39;1;38;.974;3989000;0
1286;11352;582;0;0;0;0;.00nan;0;0
1286;-1;582;83;33;2;31;.939;3600000;0
1286;169478;2287;26;9;4;5;.556;1970000;0
1286;50245;2287;67;9;0;9;1.000;1551000;0
1287;218;1931;100;38;0;38;1.000;3600000;0
1287;37467;1931;0;0;0;0;.00nan;0;0
1287;50683;579;60;19;2;17;.895;3594000;0
1287;56155;579;0;0;0;0;.00nan;0;0
1288;6541;1934;67;27;2;25;.926;3600000;0
1288;56480;1923;0;0;0;0;.00nan;0;0
1288;67454;1934;0;0;0;0;.00nan;0;0
1288;149847;1923;58;36;4;32;.889;3538000;0
1289;14783;1930;0;0;0;0;.00nan;0;0
1289;169493;1930;55;24;4;20;.833;3632000;0
1289;67663;1920;0;0;0;0;.00nan;0;0
1289;143879;1920;62;28;3;25;.893;3632000;0
1290;11352;582;0;0;0;0;.00nan;0;0
1290;-1;582;26;30;6;24;.800;3592000;0
1290;169478;2287;61;35;4;31;.886;3600000;0
1290;50245;2287;0;0;0;0;.00nan;0;0
1602;218;1931;69;32;3;29;.906;4060000;0
1602;37467;1931;0;0;0;0;.00nan;0;0
1602;50683;579;81;49;4;45;.918;4076000;0
1602;56155;579;0;0;0;0;.00nan;0;0
1603;6541;1934;4;16;7;9;.563;3013000;0
1603;56480;1923;0;0;0;0;.00nan;0;0
1603;67454;1934;62;5;0;5;1.000;587000;0
1603;149847;1923;95;37;1;36;.973;3600000;0
1604;14783;1930;0;0;0;0;.00nan;0;0
1604;169493;1930;24;31;6;25;.806;3600000;0
1604;67663;1920;0;0;0;0;.00nan;0;0
1604;143879;1920;41;22;4;18;.818;3600000;0
1605;11352;582;0;0;0;0;.00nan;0;0
1605;-1;582;84;35;2;33;.943;3600000;0
1605;169478;2287;48;18;3;15;.833;3560000;0
1605;50245;2287;0;0;0;0;.00nan;0;0
1656;6541;1934;23;16;5;11;.688;3587000;0
1656;56480;1923;0;0;0;0;.00nan;0;0
1656;67454;1934;0;0;0;0;.00nan;0;0
1656;149847;1923;74;36;3;33;.917;3600000;0
1657;11352;582;0;0;0;0;.00nan;0;0
1657;-1;582;58;29;3;26;.897;3600000;0
1657;169478;2287;55;34;5;29;.853;3553000;0
1657;50245;2287;0;0;0;0;.00nan;0;0
1733;56480;1923;0;0;0;0;.00nan;0;0
1733;67663;1920;0;0;0;0;.00nan;0;0
1733;143879;1920;54;33;4;29;.879;4112000;0
1733;149847;1923;62;39;5;34;.872;4112000;0
1734;218;1931;79;25;1;24;.960;3600000;0
1734;11352;582;0;0;0;0;.00nan;0;0
1734;-1;582;28;32;6;26;.813;3600000;0
1734;37467;1931;0;0;0;0;.00nan;0;0
1735;56480;1923;0;0;0;0;.00nan;0;0
1735;67663;1920;0;0;0;0;.00nan;0;0
1735;143879;1920;65;27;2;25;.926;4119000;0
1735;149847;1923;74;40;3;37;.925;4119000;0
1736;218;1931;61;56;8;48;.857;3333000;0
1736;11352;582;0;0;0;0;.00nan;0;0
1736;-1;582;53;22;3;19;.864;3600000;0
1736;37467;1931;49;1;0;1;1.000;267000;0
1737;56480;1923;0;0;0;0;.00nan;0;0
1737;67663;1920;0;0;0;0;.00nan;0;0
1737;143879;1920;41;15;3;12;.800;3600000;0
1737;149847;1923;56;39;4;35;.897;3600000;0
1738;218;1931;61;49;6;43;.878;3600000;0
1738;11352;582;0;0;0;0;.00nan;0;0
1738;-1;582;65;17;1;16;.941;3600000;0
1738;37467;1931;0;0;0;0;.00nan;0;0
1972;218;1931;75;29;2;27;.931;3600000;0
1972;11352;582;0;0;0;0;.00nan;0;0
1972;-1;582;62;26;3;23;.885;3555000;0
1972;37467;1931;0;0;0;0;.00nan;0;0
2017;218;1931;81;32;2;30;.938;3580000;0
2017;11352;582;0;0;0;0;.00nan;0;0
2017;-1;582;64;16;1;15;.938;3600000;0
2017;37467;1931;0;0;0;0;.00nan;0;0
2068;11352;582;0;0;0;0;.00nan;0;0
2068;-1;582;27;23;5;18;.783;3582000;0
2068;67663;1920;0;0;0;0;.00nan;0;0
2068;143879;1920;76;41;4;37;.902;3600000;0
2069;11352;582;0;0;0;0;.00nan;0;0
2069;-1;582;35;30;5;25;.833;3554000;0
2069;67663;1920;0;0;0;0;.00nan;0;0
2069;143879;1920;60;25;3;22;.880;3600000;0
2070;11352;582;0;0;0;0;.00nan;0;0
2070;-1;582;61;23;3;20;.870;3600000;0
2070;67663;1920;55;33;4;29;.879;3081000;0
2070;143879;1920;21;3;3;0;.000;519000;0
2284;11352;582;75;22;1;21;.955;2485000;0
2284;35520;582;9;10;5;5;.500;1082000;0
2284;67663;1920;50;32;5;27;.844;3600000;0
2284;143879;1920;0;0;0;0;.00nan;0;0
18557;177771;2163;97;65;3;62;.954;3600000;0
18557;181051;2163;0;0;0;0;.00nan;0;0
18557;48586;2158;0;0;0;0;.00nan;0;0
18557;75764;2158;49;14;2;12;.857;3600000;0
18558;14792;4840;68;35;4;31;.886;3900000;0
18558;21607;2162;0;0;0;0;.00nan;0;0
18558;22316;2162;63;45;4;41;.911;3900000;0
18558;-1;4840;0;0;0;0;.00nan;0;0
18559;6998;2164;0;0;0;0;.00nan;0;0
18559;163361;2164;69;20;1;19;.950;3600000;0
18559;-1;2161;0;0;0;0;.00nan;0;0
18559;161081;2161;65;41;5;36;.878;3600000;0
18560;177771;2163;59;47;5;42;.894;3600000;0
18560;181051;2163;0;0;0;0;.00nan;0;0
18560;48586;2158;0;0;0;0;.00nan;0;0
18560;75764;2158;53;12;2;10;.833;3600000;0
18561;14792;4840;70;26;2;24;.923;3244000;0
18561;21607;2162;96;33;1;32;.970;3600000;0
18561;22316;2162;0;0;0;0;.00nan;0;0
18561;-1;4840;33;6;3;3;.500;356000;0
18562;6998;2164;0;0;0;0;.00nan;0;0
18562;163361;2164;53;28;4;24;.857;3600000;0
18562;-1;2161;79;24;1;23;.958;2764000;0
18562;161081;2161;20;9;4;5;.556;800000;0
18563;6998;2164;0;0;0;0;.00nan;0;0
18563;163361;2164;52;24;3;21;.875;3889000;0
18563;21607;2162;81;41;2;39;.951;3889000;0
18563;22316;2162;0;0;0;0;.00nan;0;0
18564;14792;4840;0;0;0;0;.00nan;0;0
18564;-1;4840;77;42;4;38;.905;3600000;0
18564;48586;2158;0;0;0;0;.00nan;0;0
18564;75764;2158;51;24;3;21;.875;3600000;0
18565;177771;2163;71;20;1;19;.950;3600000;0
18565;-1;2161;0;0;0;0;.00nan;0;0
18565;181051;2163;0;0;0;0;.00nan;0;0
18565;161081;2161;41;32;4;28;.875;3600000;0
18566;6998;2164;61;30;3;27;.900;3575000;0
18566;163361;2164;0;0;0;0;.00nan;0;0
18566;21607;2162;89;36;2;34;.944;3600000;0
18566;22316;2162;0;0;0;0;.00nan;0;0
18567;14792;4840;0;0;0;0;.00nan;0;0
18567;-1;4840;97;63;4;59;.937;3600000;0
18567;48586;2158;0;0;0;0;.00nan;0;0
18567;75764;2158;57;11;1;10;.909;3600000;0
18568;177771;2163;0;0;0;0;.00nan;0;0
18568;-1;2161;69;22;1;21;.955;3600000;0
18568;181051;2163;49;39;5;34;.872;3600000;0
18568;161081;2161;0;0;0;0;.00nan;0;0
18569;6998;2164;0;0;0;0;.00nan;0;0
18569;163361;2164;60;28;3;25;.893;3900000;0
18569;177771;2163;76;36;3;33;.917;3848000;0
18569;181051;2163;0;0;0;0;.00nan;0;0
18570;14792;4840;61;36;4;32;.889;3556000;0
18570;-1;2161;79;40;3;37;.925;3600000;0
18570;-1;4840;0;0;0;0;.00nan;0;0
18570;161081;2161;0;0;0;0;.00nan;0;0
18571;6998;2164;83;32;1;31;.969;3600000;0
18571;163361;2164;0;0;0;0;.00nan;0;0
18571;177771;2163;0;0;0;0;.00nan;0;0
18571;181051;2163;81;40;3;37;.925;3600000;0
18572;14792;4840;0;0;0;0;.00nan;0;0
18572;-1;2161;0;0;0;0;.00nan;0;0
18572;-1;4840;44;21;4;17;.810;3900000;0
18572;161081;2161;86;50;4;46;.920;3900000;0
18573;21607;2162;0;0;0;0;.00nan;0;0
18573;22316;2162;84;32;2;30;.938;3600000;0
18573;-1;2161;74;31;3;28;.903;3562000;0
18573;161081;2161;0;0;0;0;.00nan;0;0
18574;6998;2164;0;0;0;0;.00nan;0;0
18574;163361;2164;64;28;3;25;.893;3600000;0
18574;177771;2163;100;34;0;34;1.000;3600000;0
18574;181051;2163;0;0;0;0;.00nan;0;0
18575;21607;2162;57;30;4;26;.867;3600000;0
18575;22316;2162;0;0;0;0;.00nan;0;0
18575;-1;2161;0;0;0;0;.00nan;0;0
18575;161081;2161;51;41;6;35;.854;3566000;0
18576;6998;2164;0;0;0;0;.00nan;0;0
18576;163361;2164;53;34;4;30;.882;3600000;0
18576;177771;2163;41;38;6;32;.842;3588000;0
18576;181051;2163;0;0;0;0;.00nan;0;0
18577;21607;2162;63;8;0;8;1.000;1096000;0
18577;22316;2162;24;28;6;22;.786;2484000;0
18577;48586;2158;0;0;0;0;.00nan;0;0
18577;75764;2158;36;24;5;19;.792;3600000;0
18578;6998;2164;0;0;0;0;.00nan;0;0
18578;163361;2164;66;30;3;27;.900;3600000;0
18578;14792;4840;0;0;0;0;.00nan;0;0
18578;-1;4840;98;42;2;40;.952;3600000;0
18579;177771;2163;0;0;0;0;.00nan;0;0
18579;-1;2161;66;12;0;12;1.000;1294000;0
18579;181051;2163;76;29;1;28;.966;3600000;0
18579;161081;2161;35;20;4;16;.800;2306000;0
18580;21607;2162;61;53;6;47;.887;3600000;0
18580;22316;2162;0;0;0;0;.00nan;0;0
18580;48586;2158;49;13;2;11;.846;3600000;0
18580;75764;2158;0;0;0;0;.00nan;0;0
18581;6998;2164;0;0;0;0;.00nan;0;0
18581;163361;2164;49;36;5;31;.861;3590000;0
18581;14792;4840;24;4;3;1;.250;480000;0
18581;-1;4840;68;19;1;18;.947;3120000;0
18582;177771;2163;63;38;4;34;.895;3600000;0
18582;-1;2161;0;0;0;0;.00nan;0;0
18582;181051;2163;0;0;0;0;.00nan;0;0
18582;161081;2161;39;38;6;32;.842;3588000;0
18583;6998;2164;0;0;0;0;.00nan;0;0
18583;163361;2164;84;29;1;28;.966;3600000;0
18583;21607;2162;30;15;4;11;.733;1089000;0
18583;22316;2162;58;20;2;18;.900;2511000;0
18584;14792;4840;0;0;0;0;.00nan;0;0
18584;-1;2161;19;35;7;28;.800;2526000;0
18584;-1;4840;97;42;2;40;.952;3600000;0
18584;161081;2161;68;14;0;14;1.000;1074000;0
18585;177771;2163;85;54;5;49;.907;3600000;0
18585;181051;2163;0;0;0;0;.00nan;0;0
18585;48586;2158;0;0;0;0;.00nan;0;0
18585;75764;2158;78;11;0;11;1.000;3600000;0
18586;6998;2164;80;34;2;32;.941;3600000;0
18586;163361;2164;0;0;0;0;.00nan;0;0
18586;21607;2162;50;31;4;27;.871;3592000;0
18586;22316;2162;0;0;0;0;.00nan;0;0
18587;14792;4840;0;0;0;0;.00nan;0;0
18587;-1;2161;0;0;0;0;.00nan;0;0
18587;-1;4840;45;22;4;18;.818;3900000;0
18587;161081;2161;85;47;4;43;.915;3900000;0
18588;177771;2163;0;0;0;0;.00nan;0;0
18588;181051;2163;75;51;4;47;.922;3600000;0
18588;48586;2158;0;0;0;0;.00nan;0;0
18588;75764;2158;49;7;1;6;.857;3600000;0
18589;6998;2164;56;19;2;17;.895;1447000;0
18589;163361;2164;39;38;7;31;.816;2153000;0
18589;48586;2158;0;0;0;0;.00nan;0;0
18589;75764;2158;99;27;0;27;1.000;3600000;0
18590;21607;2162;0;0;0;0;.00nan;0;0
18590;22316;2162;41;30;5;25;.833;3546000;0
18590;-1;2161;0;0;0;0;.00nan;0;0
18590;161081;2161;41;23;4;19;.826;3600000;0
18591;177771;2163;35;35;6;29;.829;2243000;0
18591;14792;4840;0;0;0;0;.00nan;0;0
18591;-1;4840;68;42;4;38;.905;3600000;0
18591;181051;2163;63;9;0;9;1.000;1290000;0
18592;6998;2164;0;0;0;0;.00nan;0;0
18592;163361;2164;97;57;3;54;.947;3600000;0
18592;48586;2158;0;0;0;0;.00nan;0;0
18592;75764;2158;79;13;0;13;1.000;3600000;0
18593;21607;2162;55;29;3;26;.897;3553000;0
18593;22316;2162;0;0;0;0;.00nan;0;0
18593;-1;2161;76;24;1;23;.958;3600000;0
18593;161081;2161;0;0;0;0;.00nan;0;0
18594;177771;2163;73;25;2;23;.920;3708000;0
18594;14792;4840;0;0;0;0;.00nan;0;0
18594;-1;4840;86;32;1;31;.969;3708000;0
18594;181051;2163;0;0;0;0;.00nan;0;0
18595;-1;2161;0;0;0;0;.00nan;0;0
18595;48586;2158;0;0;0;0;.00nan;0;0
18595;75764;2158;46;12;2;10;.833;3600000;0
18595;161081;2161;98;66;4;62;.939;3566000;0
18596;177771;2163;70;33;3;30;.909;3900000;0
18596;21607;2162;70;37;3;34;.919;3900000;0
18596;22316;2162;0;0;0;0;.00nan;0;0
18596;181051;2163;0;0;0;0;.00nan;0;0
18597;6998;2164;0;0;0;0;.00nan;0;0
18597;163361;2164;91;33;2;31;.939;3600000;0
18597;14792;4840;0;0;0;0;.00nan;0;0
18597;-1;4840;52;31;4;27;.871;3554000;0
18598;-1;2161;61;51;6;45;.882;3260000;0
18598;48586;2158;0;0;0;0;.00nan;0;0
18598;75764;2158;79;8;0;8;1.000;3600000;0
18598;161081;2161;47;5;1;4;.800;340000;0
18599;177771;2163;0;0;0;0;.00nan;0;0
18599;21607;2162;0;0;0;0;.00nan;0;0
18599;22316;2162;50;30;4;26;.867;3759000;0
18599;181051;2163;69;44;5;39;.886;3759000;0
18600;6998;2164;0;0;0;0;.00nan;0;0
18600;163361;2164;74;21;1;20;.952;3600000;0
18600;14792;4840;0;0;0;0;.00nan;0;0
18600;-1;4840;72;29;2;27;.931;3588000;0
18601;14792;4840;88;48;3;45;.938;3538000;0
18601;-1;4840;0;0;0;0;.00nan;0;0
18601;48586;2158;0;0;0;0;.00nan;0;0
18601;75764;2158;77;25;1;24;.960;3600000;0
18602;6998;2164;53;6;1;5;.833;1593000;0
18602;163361;2164;45;25;4;21;.840;2240000;0
18602;-1;2161;0;0;0;0;.00nan;0;0
18602;161081;2161;76;42;4;38;.905;3833000;0
18603;177771;2163;87;38;2;36;.947;3558000;0
18603;21607;2162;72;26;1;25;.962;3600000;0
18603;22316;2162;0;0;0;0;.00nan;0;0
18603;181051;2163;0;0;0;0;.00nan;0;0
18604;14792;4840;0;0;0;0;.00nan;0;0
18604;-1;4840;69;58;6;52;.897;3600000;0
18604;48586;2158;0;0;0;0;.00nan;0;0
18604;75764;2158;89;17;0;17;1.000;3600000;0
18605;6998;2164;0;0;0;0;.00nan;0;0
18605;163361;2164;69;32;3;29;.906;3600000;0
18605;-1;2161;35;29;6;23;.793;2616000;0
18605;161081;2161;50;1;0;1;1.000;984000;0
18606;177771;2163;0;0;0;0;.00nan;0;0
18606;21607;2162;0;0;0;0;.00nan;0;0
18606;22316;2162;84;35;1;34;.971;3600000;0
18606;181051;2163;56;36;4;32;.889;3568000;0
18607;14792;4840;0;0;0;0;.00nan;0;0
18607;21607;2162;0;0;0;0;.00nan;0;0
18607;22316;2162;83;34;2;32;.941;3600000;0
18607;-1;4840;100;47;1;46;.979;3600000;0
18608;-1;2161;0;0;0;0;.00nan;0;0
18608;48586;2158;0;0;0;0;.00nan;0;0
18608;75764;2158;58;11;1;10;.909;3600000;0
18608;161081;2161;84;52;4;48;.923;3600000;0
18609;14792;4840;53;33;4;29;.879;3600000;0
18609;21607;2162;80;26;1;25;.962;3600000;0
18609;22316;2162;0;0;0;0;.00nan;0;0
18609;-1;4840;0;0;0;0;.00nan;0;0
18610;-1;2161;87;61;5;56;.918;3600000;0
18610;48586;2158;75;8;0;8;1.000;3600000;0
18610;75764;2158;0;0;0;0;.00nan;0;0
18610;161081;2161;0;0;0;0;.00nan;0;0
18611;21607;2162;90;43;2;41;.953;2400000;0
18611;22316;2162;39;21;4;17;.810;1200000;0
18611;48586;2158;61;14;1;13;.929;3600000;0
18611;75764;2158;0;0;0;0;.00nan;0;0
18612;177771;2163;87;28;1;27;.964;3600000;0
18612;14792;4840;0;0;0;0;.00nan;0;0
18612;-1;4840;79;33;3;30;.909;3513000;0
18612;181051;2163;0;0;0;0;.00nan;0;0
18613;21607;2162;82;38;2;36;.947;2471000;0
18613;22316;2162;25;19;5;14;.737;1129000;0
18613;48586;2158;0;0;0;0;.00nan;0;0
18613;75764;2158;48;14;2;12;.857;3600000;0
18614;177771;2163;0;0;0;0;.00nan;0;0
18614;14792;4840;92;40;3;37;.925;3600000;0
18614;-1;4840;0;0;0;0;.00nan;0;0
18614;181051;2163;41;20;4;16;.800;3576000;0
18615;6998;2164;0;0;0;0;.00nan;0;0
18615;163361;2164;91;51;4;47;.922;3591000;0
18615;48586;2158;0;0;0;0;.00nan;0;0
18615;75764;2158;63;29;3;26;.897;3600000;0
18616;14792;4840;0;0;0;0;.00nan;0;0
18616;-1;2161;0;0;0;0;.00nan;0;0
18616;-1;4840;71;28;2;26;.929;3539000;0
18616;161081;2161;100;32;0;32;1.000;3600000;0
18617;177771;2163;64;30;3;27;.900;3600000;0
18617;21607;2162;74;35;4;31;.886;3598000;0
18617;22316;2162;0;0;0;0;.00nan;0;0
18617;181051;2163;0;0;0;0;.00nan;0;0
18618;6998;2164;94;53;3;50;.943;3518000;0
18618;163361;2164;0;0;0;0;.00nan;0;0
18618;48586;2158;0;0;0;0;.00nan;0;0
18618;75764;2158;73;17;1;16;.941;3600000;0
18619;14792;4840;99;27;0;27;1.000;3600000;0
18619;-1;2161;0;0;0;0;.00nan;0;0
18619;-1;4840;0;0;0;0;.00nan;0;0
18619;161081;2161;76;46;5;41;.891;3600000;0
18620;177771;2163;0;0;0;0;.00nan;0;0
18620;21607;2162;0;0;0;0;.00nan;0;0
18620;22316;2162;94;41;2;39;.951;3606000;0
18620;181051;2163;96;41;1;40;.976;3606000;0
18621;6998;2164;0;0;0;0;.00nan;0;0
18621;163361;2164;100;37;0;37;1.000;3600000;0
18621;177771;2163;88;29;1;28;.966;3600000;0
18621;181051;2163;0;0;0;0;.00nan;0;0
18622;-1;2161;62;15;1;14;.933;796000;0
18622;48586;2158;0;0;0;0;.00nan;0;0
18622;75764;2158;47;20;3;17;.850;3600000;0
18622;161081;2161;35;46;6;40;.870;2804000;0
18623;6998;2164;0;0;0;0;.00nan;0;0
18623;163361;2164;69;32;3;29;.906;3569000;0
18623;177771;2163;0;0;0;0;.00nan;0;0
18623;181051;2163;68;23;2;21;.913;3600000;0
18624;-1;2161;96;50;3;47;.940;3175000;0
18624;48586;2158;0;0;0;0;.00nan;0;0
18624;75764;2158;66;18;1;17;.944;3600000;0
18624;161081;2161;30;15;4;11;.733;425000;0
18625;6998;2164;0;0;0;0;.00nan;0;0
18625;163361;2164;65;56;6;50;.893;3600000;0
18625;48586;2158;0;0;0;0;.00nan;0;0
18625;75764;2158;93;21;0;21;1.000;3600000;0
18626;21607;2162;88;31;1;30;.968;3600000;0
18626;22316;2162;0;0;0;0;.00nan;0;0
18626;-1;2161;0;0;0;0;.00nan;0;0
18626;161081;2161;88;46;3;43;.935;3582000;0
18627;177771;2163;57;26;3;23;.885;3545000;0
18627;14792;4840;83;29;1;28;.966;3600000;0
18627;-1;4840;0;0;0;0;.00nan;0;0
18627;181051;2163;0;0;0;0;.00nan;0;0
18628;6998;2164;0;0;0;0;.00nan;0;0
18628;163361;2164;98;58;2;56;.966;3600000;0
18628;48586;2158;0;0;0;0;.00nan;0;0
18628;75764;2158;89;19;0;19;1.000;3600000;0
18629;21607;2162;0;0;0;0;.00nan;0;0
18629;22316;2162;61;39;5;34;.872;3600000;0
18629;-1;2161;0;0;0;0;.00nan;0;0
18629;161081;2161;36;35;6;29;.829;3600000;0
18630;177771;2163;0;0;0;0;.00nan;0;0
18630;14792;4840;0;0;0;0;.00nan;0;0
18630;-1;4840;86;43;3;40;.930;3566000;0
18630;181051;2163;72;29;2;27;.931;3600000;0
18631;21607;2162;89;51;3;48;.941;3544000;0
18631;22316;2162;0;0;0;0;.00nan;0;0
18631;48586;2158;0;0;0;0;.00nan;0;0
18631;75764;2158;52;10;2;8;.800;3600000;0
18632;6998;2164;0;0;0;0;.00nan;0;0
18632;163361;2164;87;25;1;24;.960;3600000;0
18632;14792;4840;54;37;4;33;.892;3600000;0
18632;-1;4840;0;0;0;0;.00nan;0;0
18633;177771;2163;87;24;1;23;.958;3561000;0
18633;-1;2161;100;39;0;39;1.000;3600000;0
18633;181051;2163;0;0;0;0;.00nan;0;0
18633;161081;2161;0;0;0;0;.00nan;0;0
18634;21607;2162;0;0;0;0;.00nan;0;0
18634;22316;2162;91;56;4;52;.929;3569000;0
18634;48586;2158;53;19;2;17;.895;3600000;0
18634;75764;2158;0;0;0;0;.00nan;0;0
18635;6998;2164;57;25;3;22;.880;3750000;0
18635;163361;2164;0;0;0;0;.00nan;0;0
18635;14792;4840;0;0;0;0;.00nan;0;0
18635;-1;4840;59;32;4;28;.875;3750000;0
18636;177771;2163;0;0;0;0;.00nan;0;0
18636;-1;2161;81;25;1;24;.960;3600000;0
18636;181051;2163;59;30;3;27;.900;3571000;0
18636;161081;2161;0;0;0;0;.00nan;0;0
18637;14792;4840;59;39;6;33;.846;1777000;0
18637;-1;4840;66;19;1;18;.947;1823000;0
18637;48586;2158;0;0;0;0;.00nan;0;0
18637;75764;2158;74;9;0;9;1.000;3600000;0
18638;177771;2163;77;36;3;33;.917;3543000;0
18638;21607;2162;90;43;2;41;.953;3600000;0
18638;22316;2162;0;0;0;0;.00nan;0;0
18638;181051;2163;0;0;0;0;.00nan;0;0
18639;6998;2164;0;0;0;0;.00nan;0;0
18639;163361;2164;66;28;3;25;.893;3600000;0
18639;-1;2161;0;0;0;0;.00nan;0;0
18639;161081;2161;78;43;4;39;.907;3582000;0
18640;14792;4840;32;4;2;2;.500;518000;0
18640;-1;4840;83;67;7;60;.896;3082000;0
18640;48586;2158;0;0;0;0;.00nan;0;0
18640;75764;2158;55;10;1;9;.900;3600000;0
18641;177771;2163;0;0;0;0;.00nan;0;0
18641;21607;2162;0;0;0;0;.00nan;0;0
18641;22316;2162;77;24;1;23;.958;3900000;0
18641;181051;2163;88;33;1;32;.970;3900000;0
18642;6998;2164;0;0;0;0;.00nan;0;0
18642;163361;2164;56;24;3;21;.875;3600000;0
18642;-1;2161;0;0;0;0;.00nan;0;0
18642;161081;2161;64;36;4;32;.889;3597000;0
18643;21607;2162;100;51;2;49;.961;3900000;0
18643;22316;2162;0;0;0;0;.00nan;0;0
18643;48586;2158;0;0;0;0;.00nan;0;0
18643;75764;2158;39;12;2;10;.833;3900000;0
18644;6998;2164;0;0;0;0;.00nan;0;0
18644;163361;2164;84;42;3;39;.929;3545000;0
18644;-1;2161;89;38;2;36;.947;3600000;0
18644;161081;2161;0;0;0;0;.00nan;0;0
18645;177771;2163;58;37;5;32;.865;3554000;0
18645;14792;4840;47;22;3;19;.864;3600000;0
18645;-1;4840;0;0;0;0;.00nan;0;0
18645;181051;2163;0;0;0;0;.00nan;0;0
18646;21607;2162;0;0;0;0;.00nan;0;0
18646;22316;2162;63;45;5;40;.889;3600000;0
18646;48586;2158;0;0;0;0;.00nan;0;0
18646;75764;2158;56;21;2;19;.905;3600000;0
18647;6998;2164;0;0;0;0;.00nan;0;0
18647;163361;2164;78;36;3;33;.917;3600000;0
18647;-1;2161;0;0;0;0;.00nan;0;0
18647;161081;2161;60;32;4;28;.875;3600000;0
18648;177771;2163;0;0;0;0;.00nan;0;0
18648;14792;4840;0;0;0;0;.00nan;0;0
18648;-1;4840;76;28;2;26;.929;3600000;0
18648;181051;2163;63;41;5;36;.878;3600000;0
18649;6998;2164;0;0;0;0;.00nan;0;0
18649;163361;2164;93;36;1;35;.972;3600000;0
18649;21607;2162;33;33;7;26;.788;3600000;0
18649;22316;2162;0;0;0;0;.00nan;0;0
18650;14792;4840;72;33;3;30;.909;3600000;0
18650;-1;2161;100;33;0;33;1.000;3600000;0
18650;-1;4840;0;0;0;0;.00nan;0;0
18650;161081;2161;0;0;0;0;.00nan;0;0
18651;177771;2163;88;46;2;44;.957;3545000;0
18651;181051;2163;0;0;0;0;.00nan;0;0
18651;48586;2158;0;0;0;0;.00nan;0;0
18651;75764;2158;69;9;0;9;1.000;3600000;0
18652;6998;2164;0;0;0;0;.00nan;0;0
18652;163361;2164;100;37;1;36;.973;3600000;0
18652;21607;2162;0;0;0;0;.00nan;0;0
18652;22316;2162;60;26;3;23;.885;3544000;0
18653;14792;4840;0;0;0;0;.00nan;0;0
18653;-1;2161;57;37;5;32;.865;3600000;0
18653;-1;4840;68;23;2;21;.913;3600000;0
18653;161081;2161;0;0;0;0;.00nan;0;0
18654;177771;2163;0;0;0;0;.00nan;0;0
18654;181051;2163;97;55;3;52;.945;3600000;0
18654;48586;2158;0;0;0;0;.00nan;0;0
18654;75764;2158;74;9;0;9;1.000;3600000;0
18655;6998;2164;0;0;0;0;.00nan;0;0
18655;163361;2164;57;51;6;45;.882;3600000;0
18655;48586;2158;0;0;0;0;.00nan;0;0
18655;75764;2158;71;6;0;6;1.000;3600000;0
18656;14792;4840;48;31;5;26;.839;3600000;0
18656;21607;2162;88;36;2;34;.944;3600000;0
18656;22316;2162;0;0;0;0;.00nan;0;0
18656;-1;4840;0;0;0;0;.00nan;0;0
18657;6998;2164;62;42;5;37;.881;1967000;0
18657;163361;2164;55;28;3;25;.893;1633000;0
18657;48586;2158;0;0;0;0;.00nan;0;0
18657;75764;2158;51;24;3;21;.875;3600000;0
18658;14792;4840;0;0;0;0;.00nan;0;0
18658;21607;2162;0;0;0;0;.00nan;0;0
18658;22316;2162;74;29;2;27;.931;3600000;0
18658;-1;4840;37;31;6;25;.806;3600000;0
18659;177771;2163;95;59;4;55;.932;3600000;0
18659;181051;2163;0;0;0;0;.00nan;0;0
18659;48586;2158;0;0;0;0;.00nan;0;0
18659;75764;2158;59;10;1;9;.900;3600000;0
18660;6998;2164;0;0;0;0;.00nan;0;0
18660;163361;2164;81;31;2;29;.935;3865000;0
18660;14792;4840;84;39;3;36;.923;3865000;0
18660;-1;4840;0;0;0;0;.00nan;0;0
18661;21607;2162;91;30;1;29;.967;3600000;0
18661;22316;2162;0;0;0;0;.00nan;0;0
18661;-1;2161;84;34;2;32;.941;3544000;0
18661;161081;2161;0;0;0;0;.00nan;0;0
18662;177771;2163;55;9;1;8;.889;405000;0
18662;181051;2163;68;53;6;47;.887;3195000;0
18662;48586;2158;0;0;0;0;.00nan;0;0
18662;75764;2158;49;15;2;13;.867;3600000;0
18663;6998;2164;0;0;0;0;.00nan;0;0
18663;163361;2164;67;32;3;29;.906;3600000;0
18663;14792;4840;0;0;0;0;.00nan;0;0
18663;-1;4840;96;27;1;26;.963;3600000;0
18664;21607;2162;0;0;0;0;.00nan;0;0
18664;22316;2162;81;35;2;33;.943;3549000;0
18664;-1;2161;0;0;0;0;.00nan;0;0
18664;161081;2161;93;36;1;35;.972;3600000;0
18665;6998;2164;0;0;0;0;.00nan;0;0
18665;163361;2164;95;38;1;37;.974;3900000;0
18665;21607;2162;100;39;1;38;.974;3900000;0
18665;22316;2162;0;0;0;0;.00nan;0;0
18666;14792;4840;65;55;6;49;.891;3600000;0
18666;-1;4840;0;0;0;0;.00nan;0;0
18666;48586;2158;0;0;0;0;.00nan;0;0
18666;75764;2158;49;19;3;16;.842;3600000;0
18667;177771;2163;97;34;1;33;.971;3600000;0
18667;-1;2161;0;0;0;0;.00nan;0;0
18667;181051;2163;0;0;0;0;.00nan;0;0
18667;161081;2161;61;29;3;26;.897;3534000;0
18668;6998;2164;0;0;0;0;.00nan;0;0
18668;163361;2164;70;32;4;28;.875;3600000;0
18668;21607;2162;0;0;0;0;.00nan;0;0
18668;22316;2162;42;41;6;35;.854;3575000;0
18669;14792;4840;0;0;0;0;.00nan;0;0
18669;-1;4840;77;52;5;47;.904;3600000;0
18669;48586;2158;65;17;1;16;.941;3600000;0
18669;75764;2158;0;0;0;0;.00nan;0;0
18670;177771;2163;0;0;0;0;.00nan;0;0
18670;-1;2161;57;38;4;34;.895;3600000;0
18670;181051;2163;96;34;1;33;.971;3600000;0
18670;161081;2161;0;0;0;0;.00nan;0;0
18671;-1;2161;0;0;0;0;.00nan;0;0
18671;48586;2158;0;0;0;0;.00nan;0;0
18671;75764;2158;50;19;3;16;.842;3575000;0
18671;161081;2161;92;46;2;44;.957;3600000;0
18672;14792;4840;65;18;1;17;.944;2447000;0
18672;21607;2162;62;34;3;31;.912;3600000;0
18672;22316;2162;0;0;0;0;.00nan;0;0
18672;-1;4840;24;11;4;7;.636;1101000;0
18673;6998;2164;0;0;0;0;.00nan;0;0
18673;163361;2164;59;27;3;24;.889;3600000;0
18673;177771;2163;44;40;5;35;.875;3553000;0
18673;181051;2163;0;0;0;0;.00nan;0;0
18674;-1;2161;98;60;3;57;.950;3600000;0
18674;48586;2158;0;0;0;0;.00nan;0;0
18674;75764;2158;89;18;0;18;1.000;3600000;0
18674;161081;2161;0;0;0;0;.00nan;0;0
18675;14792;4840;0;0;0;0;.00nan;0;0
18675;21607;2162;83;36;2;34;.944;3600000;0
18675;22316;2162;0;0;0;0;.00nan;0;0
18675;-1;4840;71;32;3;29;.906;3549000;0
18676;6998;2164;91;47;3;44;.936;3900000;0
18676;163361;2164;0;0;0;0;.00nan;0;0
18676;177771;2163;0;0;0;0;.00nan;0;0
18676;181051;2163;53;23;3;20;.870;3900000;0
18678;14792;4840;84;29;1;28;.966;3600000;0
18678;21607;2162;0;0;0;0;.00nan;0;0
18678;22316;2162;83;37;2;35;.946;3567000;0
18678;-1;4840;0;0;0;0;.00nan;0;0
18680;6998;2164;97;60;3;57;.950;3600000;0
18680;25244;2164;0;0;0;0;.00nan;0;0
18680;48586;2158;0;0;0;0;.00nan;0;0
18680;75764;2158;81;11;0;11;1.000;3600000;0
18682;177771;2163;58;29;2;27;.931;3900000;0
18682;-1;2161;79;35;2;33;.943;3900000;0
18682;181051;2163;0;0;0;0;.00nan;0;0
18682;161081;2161;0;0;0;0;.00nan;0;0
18684;6998;2164;0;0;0;0;.00nan;0;0
18684;21607;2162;80;38;3;35;.921;3770000;0
18684;22316;2162;0;0;0;0;.00nan;0;0
18684;25244;2164;51;29;4;25;.862;3770000;0
18686;177771;2163;0;0;0;0;.00nan;0;0
18686;-1;2161;0;0;0;0;.00nan;0;0
18686;181051;2163;33;33;6;27;.818;3600000;0
18686;161081;2161;100;34;0;34;1.000;3600000;0
18688;14792;4840;0;0;0;0;.00nan;0;0
18688;-1;4840;97;59;2;57;.966;3531000;0
18688;48586;2158;0;0;0;0;.00nan;0;0
18688;75764;2158;86;13;0;13;1.000;3600000;0
18690;21607;2162;0;0;0;0;.00nan;0;0
18690;22316;2162;48;18;2;16;.889;3551000;0
18690;-1;2161;0;0;0;0;.00nan;0;0
18690;161081;2161;90;29;1;28;.966;3600000;0
18692;177771;2163;36;14;3;11;.786;541000;0
18692;181051;2163;69;51;5;46;.902;3059000;0
18692;48586;2158;0;0;0;0;.00nan;0;0
18692;75764;2158;83;12;0;12;1.000;3600000;0
18694;6998;2164;60;40;5;35;.875;3576000;0
18694;14792;4840;0;0;0;0;.00nan;0;0
18694;25244;2164;0;0;0;0;.00nan;0;0
18694;-1;4840;91;49;3;46;.939;3600000;0
18696;14792;4840;31;28;6;22;.786;1959000;0
18696;-1;4840;83;26;0;26;1.000;1641000;0
18696;48586;2158;0;0;0;0;.00nan;0;0
18696;75764;2158;84;14;0;14;1.000;3600000;0
18698;21607;2162;95;33;1;32;.970;3900000;0
18698;22316;2162;0;0;0;0;.00nan;0;0
18698;-1;2161;97;42;1;41;.976;3900000;0
18698;161081;2161;0;0;0;0;.00nan;0;0
18700;6998;2164;0;0;0;0;.00nan;0;0
18700;177771;2163;68;26;2;24;.923;3574000;0
18700;25244;2164;99;26;0;26;1.000;3600000;0
18700;181051;2163;0;0;0;0;.00nan;0;0
18702;6998;2164;48;38;5;33;.868;2667000;0
18702;25244;2164;31;15;4;11;.733;933000;0
18702;48586;2158;0;0;0;0;.00nan;0;0
18702;75764;2158;84;7;0;7;1.000;3600000;0
18704;14792;4840;0;0;0;0;.00nan;0;0
18704;-1;2161;0;0;0;0;.00nan;0;0
18704;-1;4840;85;24;1;23;.958;3600000;0
18704;161081;2161;47;34;4;30;.882;3600000;0
18706;177771;2163;0;0;0;0;.00nan;0;0
18706;21607;2162;0;0;0;0;.00nan;0;0
18706;22316;2162;53;36;4;32;.889;3600000;0
18706;181051;2163;51;38;5;33;.868;3600000;0
18708;177771;2163;55;34;4;30;.882;3600000;0
18708;14792;4840;56;45;5;40;.889;3543000;0
18708;-1;4840;0;0;0;0;.00nan;0;0
18708;181051;2163;0;0;0;0;.00nan;0;0
18710;6998;2164;0;0;0;0;.00nan;0;0
18710;25244;2164;50;30;4;26;.867;3757000;0
18710;-1;2161;85;51;5;46;.902;3757000;0
18710;161081;2161;0;0;0;0;.00nan;0;0
18712;21607;2162;90;52;2;50;.962;3600000;0
18712;22316;2162;0;0;0;0;.00nan;0;0
18712;48586;2158;0;0;0;0;.00nan;0;0
18712;75764;2158;83;14;0;14;1.000;3600000;0
1830;14792;4840;0;0;0;0;.00nan;0;0
1830;-1;4840;95;59;3;56;.949;3600000;0
1830;48586;2158;0;0;0;0;.00nan;0;0
1830;75764;2158;39;25;5;20;.800;3527000;0
1831;6998;2164;0;0;0;0;.00nan;0;0
1831;163361;2164;76;25;1;24;.960;3600000;0
1831;21607;2162;89;36;2;34;.944;3566000;0
1831;22316;2162;0;0;0;0;.00nan;0;0
1832;14792;4840;0;0;0;0;.00nan;0;0
1832;-1;4840;68;42;4;38;.905;3557000;0
1832;48586;2158;0;0;0;0;.00nan;0;0
1832;75764;2158;67;20;2;18;.900;3600000;0
1833;6998;2164;0;0;0;0;.00nan;0;0
1833;163361;2164;69;24;2;22;.917;3600000;0
1833;21607;2162;74;37;3;34;.919;3590000;0
1833;22316;2162;0;0;0;0;.00nan;0;0
2001;14792;4840;0;0;0;0;.00nan;0;0
2001;-1;4840;57;47;6;41;.872;3600000;0
2001;48586;2158;0;0;0;0;.00nan;0;0
2001;75764;2158;75;21;2;19;.905;3600000;0
2018;6998;2164;0;0;0;0;.00nan;0;0
2018;163361;2164;75;38;4;34;.895;3600000;0
2018;48586;2158;0;0;0;0;.00nan;0;0
2018;75764;2158;86;16;0;16;1.000;3600000;0
2019;6998;2164;0;0;0;0;.00nan;0;0
2019;163361;2164;98;51;3;48;.941;3600000;0
2019;48586;2158;0;0;0;0;.00nan;0;0
2019;75764;2158;56;15;2;13;.867;3600000;0
2020;6998;2164;0;0;0;0;.00nan;0;0
2020;163361;2164;97;51;2;49;.961;3564000;0
2020;48586;2158;0;0;0;0;.00nan;0;0
2020;75764;2158;87;15;0;15;1.000;3600000;0
18713;168001;3800;81;30;2;28;.933;3600000;0
18713;44141;3798;51;35;5;30;.857;3600000;0
18713;57046;3798;0;0;0;0;.00nan;0;0
18713;78845;3800;0;0;0;0;.00nan;0;0
18714;37070;3797;66;29;3;26;.897;3600000;0
18714;58856;3795;48;25;4;21;.840;3551000;0
18714;59153;3797;0;0;0;0;.00nan;0;0
18714;59231;3795;0;0;0;0;.00nan;0;0
18715;44141;3798;67;21;2;19;.905;3562000;0
18715;57046;3798;0;0;0;0;.00nan;0;0
18715;57390;4635;100;44;1;43;.977;3600000;0
18715;152696;4635;0;0;0;0;.00nan;0;0
18716;168001;3800;66;29;3;26;.897;3900000;0
18716;37638;3796;95;47;3;44;.936;3900000;0
18716;78845;3800;0;0;0;0;.00nan;0;0
18716;161024;3796;0;0;0;0;.00nan;0;0
18717;37070;3797;90;39;2;37;.949;3674000;0
18717;37638;3796;65;31;3;28;.903;3674000;0
18717;59153;3797;0;0;0;0;.00nan;0;0
18717;161024;3796;0;0;0;0;.00nan;0;0
18718;57390;4635;85;16;0;16;1.000;3600000;0
18718;58856;3795;0;0;0;0;.00nan;0;0
18718;59231;3795;68;41;4;37;.902;3600000;0
18718;152696;4635;0;0;0;0;.00nan;0;0
18719;37070;3797;0;0;0;0;.00nan;0;0
18719;44141;3798;56;47;6;41;.872;3530000;0
18719;57046;3798;0;0;0;0;.00nan;0;0
18719;59153;3797;72;39;4;35;.897;3600000;0
18720;168001;3800;73;29;3;26;.897;3600000;0
18720;37638;3796;10;18;6;12;.667;2042000;0
18720;78845;3800;0;0;0;0;.00nan;0;0
18720;161024;3796;64;15;1;14;.933;1558000;0
18721;37638;3796;83;36;2;34;.944;3600000;0
18721;57390;4635;52;36;5;31;.861;3600000;0
18721;152696;4635;0;0;0;0;.00nan;0;0
18721;161024;3796;0;0;0;0;.00nan;0;0
18722;168001;3800;0;0;0;0;.00nan;0;0
18722;58856;3795;0;0;0;0;.00nan;0;0
18722;59231;3795;97;50;2;48;.960;3900000;0
18722;78845;3800;62;21;2;19;.905;3900000;0
18723;37070;3797;59;37;5;32;.865;3600000;0
18723;44141;3798;50;25;4;21;.840;3600000;0
18723;57046;3798;0;0;0;0;.00nan;0;0
18723;59153;3797;0;0;0;0;.00nan;0;0
18724;37638;3796;27;21;5;16;.762;3600000;0
18724;58856;3795;0;0;0;0;.00nan;0;0
18724;59231;3795;95;41;2;39;.951;3600000;0
18724;161024;3796;0;0;0;0;.00nan;0;0
18725;168001;3800;75;22;1;21;.955;3600000;0
18725;57390;4635;86;42;2;40;.952;3557000;0
18725;78845;3800;0;0;0;0;.00nan;0;0
18725;152696;4635;0;0;0;0;.00nan;0;0
18726;37070;3797;0;0;0;0;.00nan;0;0
18726;58856;3795;85;39;2;37;.949;3573000;0
18726;59153;3797;91;36;1;35;.972;3600000;0
18726;59231;3795;0;0;0;0;.00nan;0;0
18727;168001;3800;0;0;0;0;.00nan;0;0
18727;57390;4635;42;37;6;31;.838;3600000;0
18727;78845;3800;77;29;3;26;.897;3600000;0
18727;152696;4635;0;0;0;0;.00nan;0;0
18728;37638;3796;0;0;0;0;.00nan;0;0
18728;44141;3798;79;34;2;32;.941;3900000;0
18728;57046;3798;0;0;0;0;.00nan;0;0
18728;161024;3796;78;40;2;38;.950;3900000;0
18729;168001;3800;71;34;3;31;.912;3550000;0
18729;37070;3797;85;32;2;30;.938;3600000;0
18729;59153;3797;0;0;0;0;.00nan;0;0
18729;78845;3800;0;0;0;0;.00nan;0;0
18730;37638;3796;74;20;1;19;.950;3600000;0
18730;58856;3795;0;0;0;0;.00nan;0;0
18730;59231;3795;90;39;3;36;.923;3570000;0
18730;161024;3796;0;0;0;0;.00nan;0;0
18731;44141;3798;95;47;3;44;.936;3546000;0
18731;57046;3798;0;0;0;0;.00nan;0;0
18731;57390;4635;80;25;2;23;.920;3600000;0
18731;152696;4635;0;0;0;0;.00nan;0;0
18732;168001;3800;0;0;0;0;.00nan;0;0
18732;57390;4635;66;30;3;27;.900;3600000;0
18732;78845;3800;46;26;4;22;.846;3600000;0
18732;152696;4635;0;0;0;0;.00nan;0;0
18733;37070;3797;0;0;0;0;.00nan;0;0
18733;57390;4635;59;20;2;18;.900;3556000;0
18733;59153;3797;97;41;1;40;.976;3600000;0
18733;152696;4635;0;0;0;0;.00nan;0;0
18734;37638;3796;51;35;5;30;.857;3562000;0
18734;44141;3798;67;32;4;28;.875;3600000;0
18734;57046;3798;0;0;0;0;.00nan;0;0
18734;161024;3796;0;0;0;0;.00nan;0;0
18735;168001;3800;79;22;1;21;.955;3600000;0
18735;58856;3795;39;40;7;33;.825;3600000;0
18735;59231;3795;0;0;0;0;.00nan;0;0
18735;78845;3800;0;0;0;0;.00nan;0;0
18736;37070;3797;56;28;3;25;.893;3566000;0
18736;58856;3795;0;0;0;0;.00nan;0;0
18736;59153;3797;0;0;0;0;.00nan;0;0
18736;59231;3795;81;32;2;30;.938;3600000;0
18737;37070;3797;0;0;0;0;.00nan;0;0
18737;37638;3796;70;25;2;23;.920;3736000;0
18737;59153;3797;70;34;3;31;.912;3736000;0
18737;161024;3796;0;0;0;0;.00nan;0;0
18738;57390;4635;50;22;4;18;.818;3600000;0
18738;58856;3795;44;39;7;32;.821;2173000;0
18738;59231;3795;81;21;1;20;.952;1427000;0
18738;152696;4635;0;0;0;0;.00nan;0;0
18739;168001;3800;74;35;3;32;.914;3548000;0
18739;44141;3798;88;34;2;32;.941;3600000;0
18739;57046;3798;0;0;0;0;.00nan;0;0
18739;78845;3800;0;0;0;0;.00nan;0;0
18740;37638;3796;53;5;0;5;1.000;521000;0
18740;57390;4635;0;0;0;0;.00nan;0;0
18740;152696;4635;46;27;5;22;.815;3600000;0
18740;161024;3796;32;32;6;26;.813;3056000;0
18741;44141;3798;85;32;2;30;.938;3600000;0
18741;57046;3798;0;0;0;0;.00nan;0;0
18741;58856;3795;0;0;0;0;.00nan;0;0
18741;59231;3795;56;28;4;24;.857;3577000;0
18742;168001;3800;50;22;3;19;.864;3600000;0
18742;37070;3797;80;44;4;40;.909;3563000;0
18742;45317;3800;0;0;0;0;.00nan;0;0
18742;59153;3797;0;0;0;0;.00nan;0;0
18743;168001;3800;43;27;5;22;.815;3019000;0
18743;45317;3800;30;8;3;5;.625;581000;0
18743;57390;4635;81;43;4;39;.907;3600000;0
18743;152696;4635;0;0;0;0;.00nan;0;0
18744;37070;3797;42;37;6;31;.838;3600000;0
18744;37638;3796;93;39;2;37;.949;3600000;0
18744;59153;3797;0;0;0;0;.00nan;0;0
18744;161024;3796;0;0;0;0;.00nan;0;0
18745;37070;3797;55;43;7;36;.837;3600000;0
18745;57390;4635;70;26;3;23;.885;3600000;0
18745;59153;3797;0;0;0;0;.00nan;0;0
18745;152696;4635;0;0;0;0;.00nan;0;0
18746;44141;3798;69;29;3;26;.897;3600000;0
18746;57046;3798;0;0;0;0;.00nan;0;0
18746;58856;3795;0;0;0;0;.00nan;0;0
18746;59231;3795;68;44;5;39;.886;3556000;0
18747;168001;3800;0;0;0;0;.00nan;0;0
18747;37638;3796;63;25;3;22;.880;3600000;0
18747;45317;3800;75;25;2;23;.920;3600000;0
18747;161024;3796;0;0;0;0;.00nan;0;0
18748;37070;3797;61;26;3;23;.885;3600000;0
18748;58856;3795;71;46;5;41;.891;3600000;0
18748;59153;3797;0;0;0;0;.00nan;0;0
18748;59231;3795;0;0;0;0;.00nan;0;0
18749;168001;3800;0;0;0;0;.00nan;0;0
18749;45317;3800;63;36;4;32;.889;3878000;0
18749;57390;4635;82;42;3;39;.929;3878000;0
18749;152696;4635;0;0;0;0;.00nan;0;0
18750;37638;3796;92;23;0;23;1.000;3600000;0
18750;58856;3795;0;0;0;0;.00nan;0;0
18750;59231;3795;86;32;2;30;.938;3582000;0
18750;161024;3796;0;0;0;0;.00nan;0;0
18751;37070;3797;75;34;2;32;.941;3600000;0
18751;44141;3798;48;24;4;20;.833;3578000;0
18751;57046;3798;0;0;0;0;.00nan;0;0
18751;59153;3797;0;0;0;0;.00nan;0;0
18752;37638;3796;28;26;6;20;.769;2331000;0
18752;57390;4635;9;22;7;15;.682;3247000;0
18752;152696;4635;48;7;1;6;.857;453000;0
18752;161024;3796;47;13;3;10;.769;1369000;0
18753;44141;3798;0;0;0;0;.00nan;0;0
18753;57046;3798;85;35;1;34;.971;3600000;0
18753;58856;3795;0;0;0;0;.00nan;0;0
18753;59231;3795;67;38;3;35;.921;3583000;0
18754;37070;3797;29;20;5;15;.750;1634000;0
18754;57390;4635;100;41;1;40;.976;3600000;0
18754;59153;3797;17;16;6;10;.625;1966000;0
18754;152696;4635;0;0;0;0;.00nan;0;0
18755;168001;3800;0;0;0;0;.00nan;0;0
18755;45317;3800;35;29;5;24;.828;3558000;0
18755;58856;3795;68;37;4;33;.892;3600000;0
18755;59231;3795;0;0;0;0;.00nan;0;0
18756;37638;3796;46;24;4;20;.833;2382000;0
18756;44141;3798;65;18;1;17;.944;3600000;0
18756;57046;3798;0;0;0;0;.00nan;0;0
18756;161024;3796;57;6;0;6;1.000;1218000;0
18757;168001;3800;0;0;0;0;.00nan;0;0
18757;44141;3798;96;33;1;32;.970;3600000;0
18757;45317;3800;63;20;2;18;.900;3545000;0
18757;57046;3798;0;0;0;0;.00nan;0;0
18758;44141;3798;0;0;0;0;.00nan;0;0
18758;57046;3798;79;36;3;33;.917;3600000;0
18758;57390;4635;55;37;5;32;.865;3548000;0
18758;152696;4635;0;0;0;0;.00nan;0;0
18759;168001;3800;0;0;0;0;.00nan;0;0
18759;37070;3797;67;40;4;36;.900;3543000;0
18759;45317;3800;63;30;3;27;.900;3600000;0
18759;59153;3797;0;0;0;0;.00nan;0;0
18760;37638;3796;88;21;0;21;1.000;3600000;0
18760;58856;3795;0;0;0;0;.00nan;0;0
18760;59231;3795;54;37;5;32;.865;3600000;0
18760;161024;3796;0;0;0;0;.00nan;0;0
18761;37070;3797;0;0;0;0;.00nan;0;0
18761;58856;3795;52;30;4;26;.867;3600000;0
18761;59153;3797;42;30;5;25;.833;3600000;0
18761;59231;3795;0;0;0;0;.00nan;0;0
18762;37638;3796;95;41;3;38;.927;3600000;0
18762;57390;4635;54;25;4;21;.840;3581000;0
18762;152696;4635;0;0;0;0;.00nan;0;0
18762;161024;3796;0;0;0;0;.00nan;0;0
18763;37070;3797;77;32;2;30;.938;3600000;0
18763;37638;3796;63;16;1;15;.938;3600000;0
18763;59153;3797;0;0;0;0;.00nan;0;0
18763;161024;3796;0;0;0;0;.00nan;0;0
18764;57390;4635;44;21;4;17;.810;3600000;0
18764;58856;3795;0;0;0;0;.00nan;0;0
18764;59231;3795;54;38;5;33;.868;3547000;0
18764;152696;4635;0;0;0;0;.00nan;0;0
18765;168001;3800;0;0;0;0;.00nan;0;0
18765;44141;3798;61;34;4;30;.882;3548000;0
18765;45317;3800;64;22;2;20;.909;3600000;0
18765;57046;3798;0;0;0;0;.00nan;0;0
18766;37070;3797;0;0;0;0;.00nan;0;0
18766;44141;3798;0;0;0;0;.00nan;0;0
18766;57046;3798;91;35;1;34;.971;3600000;0
18766;59153;3797;30;31;6;25;.806;3600000;0
18767;37638;3796;61;17;1;16;.941;3600000;0
18767;57390;4635;84;32;2;30;.938;3586000;0
18767;152696;4635;0;0;0;0;.00nan;0;0
18767;161024;3796;0;0;0;0;.00nan;0;0
18768;57340;3795;54;3;0;3;1.000;299000;0
18768;57390;4635;67;21;2;19;.905;3600000;0
18768;58856;4635;0;0;0;0;.00nan;0;0
18768;59231;3795;42;31;6;25;.806;3301000;0
18769;37638;3796;85;46;3;43;.935;3596000;0
18769;44141;3798;80;30;2;28;.933;3600000;0
18769;57046;3798;0;0;0;0;.00nan;0;0
18769;161024;3796;0;0;0;0;.00nan;0;0
18770;168001;3800;0;0;0;0;.00nan;0;0
18770;37070;3797;52;43;6;37;.860;3600000;0
18770;45317;3800;52;14;2;12;.857;3600000;0
18770;59153;3797;0;0;0;0;.00nan;0;0
18771;37070;3797;0;0;0;0;.00nan;0;0
18771;37638;3796;99;34;1;33;.971;3600000;0
18771;59153;3797;65;30;3;27;.900;3575000;0
18771;161024;3796;0;0;0;0;.00nan;0;0
18772;168001;3800;0;0;0;0;.00nan;0;0
18772;44141;3798;66;41;5;36;.878;3587000;0
18772;45317;3800;59;29;4;25;.862;3600000;0
18772;57046;3798;0;0;0;0;.00nan;0;0
18773;37070;3797;100;34;0;34;1.000;3600000;0
18773;57390;4635;72;26;2;24;.923;3591000;0
18773;58856;4635;0;0;0;0;.00nan;0;0
18773;59153;3797;0;0;0;0;.00nan;0;0
18774;44141;3798;0;0;0;0;.00nan;0;0
18774;57046;3798;39;26;5;21;.808;3600000;0
18774;57340;3795;0;0;0;0;.00nan;0;0
18774;59231;3795;89;29;2;27;.931;3600000;0
18775;168001;3800;0;0;0;0;.00nan;0;0
18775;37638;3796;68;28;2;26;.929;3600000;0
18775;45317;3800;56;25;3;22;.880;3600000;0
18775;161024;3796;0;0;0;0;.00nan;0;0
18776;37638;3796;28;18;4;14;.778;3600000;0
18776;57340;3795;0;0;0;0;.00nan;0;0
18776;59231;3795;100;48;1;47;.979;3600000;0
18776;161024;3796;0;0;0;0;.00nan;0;0
18777;57340;3795;0;0;0;0;.00nan;0;0
18777;57390;4635;72;26;2;24;.923;3600000;0
18777;58856;4635;0;0;0;0;.00nan;0;0
18777;59231;3795;45;28;4;24;.857;3574000;0
18778;168001;3800;100;25;0;25;1.000;3600000;0
18778;44141;3798;79;32;2;30;.938;3591000;0
18778;45317;3800;0;0;0;0;.00nan;0;0
18778;57046;3798;0;0;0;0;.00nan;0;0
18779;37070;3797;75;28;2;26;.929;3600000;0
18779;37638;3796;80;53;5;48;.906;3600000;0
18779;59153;3797;0;0;0;0;.00nan;0;0
18779;161024;3796;0;0;0;0;.00nan;0;0
18780;44141;3798;0;0;0;0;.00nan;0;0
18780;57046;3798;64;15;1;14;.933;3600000;0
18780;57340;3795;0;0;0;0;.00nan;0;0
18780;59231;3795;95;56;5;51;.911;3600000;0
18781;37070;3796;47;26;4;22;.846;3553000;0
18781;37638;3797;90;48;3;45;.938;3600000;0
18781;59153;3797;0;0;0;0;.00nan;0;0
18781;161024;3796;0;0;0;0;.00nan;0;0
18782;44141;3798;52;28;4;24;.857;3600000;0
18782;57046;3798;0;0;0;0;.00nan;0;0
18782;57390;4635;93;29;1;28;.966;3600000;0
18782;58856;4635;0;0;0;0;.00nan;0;0
18783;168001;3800;0;0;0;0;.00nan;0;0
18783;45317;3800;96;32;2;30;.938;3600000;0
18783;57340;3795;49;15;2;13;.867;1065000;0
18783;59231;3795;30;29;6;23;.793;2535000;0
18784;37638;3797;23;13;4;9;.692;1001000;0
18784;57390;4635;74;33;3;30;.909;3600000;0
18784;58856;4635;0;0;0;0;.00nan;0;0
18784;59153;3797;52;26;4;22;.846;2599000;0
18785;168001;3800;0;0;0;0;.00nan;0;0
18785;45317;3800;62;17;1;16;.941;3600000;0
18785;57340;3795;0;0;0;0;.00nan;0;0
18785;59231;3795;96;39;2;37;.949;3593000;0
18786;37070;3796;63;41;4;37;.902;3600000;0
18786;44141;3798;58;38;5;33;.868;3577000;0
18786;57046;3798;0;0;0;0;.00nan;0;0
18786;161024;3796;0;0;0;0;.00nan;0;0
18787;37070;3796;83;40;3;37;.925;3600000;0
18787;57390;4635;70;37;4;33;.892;3573000;0
18787;58856;4635;0;0;0;0;.00nan;0;0
18787;161024;3796;0;0;0;0;.00nan;0;0
18788;44141;3798;66;37;5;32;.865;3600000;0
18788;57046;3798;0;0;0;0;.00nan;0;0
18788;57340;3795;0;0;0;0;.00nan;0;0
18788;59231;3795;90;38;2;36;.947;3600000;0
18789;168001;3800;68;22;2;20;.909;3900000;0
18789;37638;3797;92;40;2;38;.950;3900000;0
18789;45317;3800;0;0;0;0;.00nan;0;0
18789;59153;3797;0;0;0;0;.00nan;0;0
18790;168001;3800;0;0;0;0;.00nan;0;0
18790;44141;3798;20;9;4;5;.556;1053000;0
18790;45317;3800;92;33;1;32;.970;3600000;0
18790;57046;3798;61;31;3;28;.903;2547000;0
18791;168001;3800;0;0;0;0;.00nan;0;0
18791;45317;3800;64;23;2;21;.913;3531000;0
18791;57390;4635;90;29;1;28;.966;3600000;0
18791;58856;4635;0;0;0;0;.00nan;0;0
18792;37070;3796;49;27;5;22;.815;3600000;0
18792;57340;3795;0;0;0;0;.00nan;0;0
18792;59231;3795;40;37;7;30;.811;3512000;0
18792;161024;3796;0;0;0;0;.00nan;0;0
18793;44141;3798;59;26;3;23;.885;3900000;0
18793;57046;3798;0;0;0;0;.00nan;0;0
18793;57390;4635;48;24;3;21;.875;3900000;0
18793;58856;4635;0;0;0;0;.00nan;0;0
18794;37638;3797;98;31;1;30;.968;3900000;0
18794;44141;3798;74;24;1;23;.958;3900000;0
18794;57046;3798;0;0;0;0;.00nan;0;0
18794;59153;3797;0;0;0;0;.00nan;0;0
18795;37638;3797;64;32;4;28;.875;3600000;0
18795;57390;4635;100;33;1;32;.970;3600000;0
18795;58856;4635;0;0;0;0;.00nan;0;0
18795;59153;3797;0;0;0;0;.00nan;0;0
18796;37070;3796;60;34;4;30;.882;3561000;0
18796;44141;3798;0;0;0;0;.00nan;0;0
18796;57046;3798;64;28;3;25;.893;3600000;0
18796;161024;3796;0;0;0;0;.00nan;0;0
18797;168001;3800;50;26;4;22;.846;3569000;0
18797;45317;3800;0;0;0;0;.00nan;0;0
18797;57340;3795;0;0;0;0;.00nan;0;0
18797;59231;3795;93;32;2;30;.938;3600000;0
18798;168001;3800;60;26;3;23;.885;3600000;0
18798;45317;3800;0;0;0;0;.00nan;0;0
18798;57340;3795;100;38;0;38;1.000;3600000;0
18798;59231;3795;0;0;0;0;.00nan;0;0
18799;37070;3796;72;40;3;37;.925;3600000;0
18799;57390;4635;0;0;0;0;.00nan;0;0
18799;58856;4635;90;42;4;38;.905;3583000;0
18799;161024;3796;0;0;0;0;.00nan;0;0
18800;37638;3797;60;38;5;33;.868;3600000;0
18800;57390;4635;47;13;2;11;.846;3600000;0
18800;58856;4635;0;0;0;0;.00nan;0;0
18800;59153;3797;0;0;0;0;.00nan;0;0
18801;44141;3798;55;17;2;15;.882;3600000;0
18801;57046;3798;0;0;0;0;.00nan;0;0
18801;57340;3795;71;32;3;29;.906;3582000;0
18801;59231;3795;0;0;0;0;.00nan;0;0
18802;168001;3800;0;0;0;0;.00nan;0;0
18802;37070;3796;95;43;3;40;.930;3900000;0
18802;45317;3800;66;32;3;29;.906;3900000;0
18802;161024;3796;0;0;0;0;.00nan;0;0
18803;44141;3798;57;41;5;36;.878;3600000;0
18803;57046;3798;0;0;0;0;.00nan;0;0
18803;57390;4635;46;23;4;19;.826;3600000;0
18803;58856;4635;0;0;0;0;.00nan;0;0
18804;37638;3797;74;22;1;21;.955;3600000;0
18804;57340;3795;0;0;0;0;.00nan;0;0
18804;59153;3797;0;0;0;0;.00nan;0;0
18804;59231;3795;83;35;2;33;.943;3581000;0
18805;168001;3800;70;22;1;21;.955;3600000;0
18805;37070;3796;0;0;0;0;.00nan;0;0
18805;45317;3800;0;0;0;0;.00nan;0;0
18805;161024;3796;72;38;3;35;.921;3546000;0
18806;168001;3800;0;0;0;0;.00nan;0;0
18806;37638;3797;70;41;4;37;.902;3600000;0
18806;45317;3800;83;14;0;14;1.000;3600000;0
18806;59153;3797;0;0;0;0;.00nan;0;0
18807;37070;3796;60;44;5;39;.886;3600000;0
18807;57390;4635;80;27;1;26;.963;3600000;0
18807;58856;4635;0;0;0;0;.00nan;0;0
18807;161024;3796;0;0;0;0;.00nan;0;0
18808;168001;3800;0;0;0;0;.00nan;0;0
18808;44141;3798;55;39;5;34;.872;3600000;0
18808;45317;3800;75;23;1;22;.957;3600000;0
18808;57046;3798;0;0;0;0;.00nan;0;0
18809;37638;3797;52;35;5;30;.857;3561000;0
18809;57340;3795;0;0;0;0;.00nan;0;0
18809;59153;3797;0;0;0;0;.00nan;0;0
18809;59231;3795;70;35;4;31;.886;3600000;0
18810;37638;3797;79;40;3;37;.925;3559000;0
18810;44141;3798;79;24;1;23;.958;3600000;0
18810;57046;3798;0;0;0;0;.00nan;0;0
18810;59153;3797;0;0;0;0;.00nan;0;0
18811;168001;3800;68;27;3;24;.889;3585000;0
18811;37070;3796;93;33;1;32;.970;3600000;0
18811;45317;3800;0;0;0;0;.00nan;0;0
18811;161024;3796;0;0;0;0;.00nan;0;0
18812;57340;3795;57;6;0;6;1.000;458000;0
18812;57390;4635;80;25;1;24;.960;3600000;0
18812;58856;4635;0;0;0;0;.00nan;0;0
18812;59231;3795;40;40;7;33;.825;3142000;0
18813;37638;3797;0;0;0;0;.00nan;0;0
18813;44141;3798;0;0;0;0;.00nan;0;0
18813;57046;3798;90;36;2;34;.944;3600000;0
18813;59153;3797;58;32;4;28;.875;3600000;0
18814;57340;3795;0;0;0;0;.00nan;0;0
18814;57390;4635;35;18;4;14;.778;3600000;0
18814;58856;4635;0;0;0;0;.00nan;0;0
18814;59231;3795;86;27;1;26;.963;3600000;0
18815;37638;3797;64;22;2;20;.909;3600000;0
18815;57340;3795;0;0;0;0;.00nan;0;0
18815;59153;3797;0;0;0;0;.00nan;0;0
18815;59231;3795;99;33;1;32;.970;3600000;0
18816;37070;3796;89;34;1;33;.971;3600000;0
18816;44141;3798;73;40;4;36;.900;3600000;0
18816;57046;3798;0;0;0;0;.00nan;0;0
18816;161024;3796;0;0;0;0;.00nan;0;0
18817;168001;3800;53;22;3;19;.864;3553000;0
18817;45317;3800;0;0;0;0;.00nan;0;0
18817;57390;4635;66;26;2;24;.923;3600000;0
18817;58856;4635;0;0;0;0;.00nan;0;0
18818;168001;3800;0;0;0;0;.00nan;0;0
18818;37638;3797;67;25;2;23;.920;3549000;0
18818;45317;3800;100;22;0;22;1.000;3600000;0
18818;59153;3797;0;0;0;0;.00nan;0;0
18819;37070;3796;0;0;0;0;.00nan;0;0
18819;57340;3795;0;0;0;0;.00nan;0;0
18819;59231;3795;82;41;3;38;.927;3900000;0
18819;161024;3796;71;26;3;23;.885;3900000;0
18820;44141;3798;79;32;2;30;.938;3900000;0
18820;57046;3798;0;0;0;0;.00nan;0;0
18820;57390;4635;0;0;0;0;.00nan;0;0
18820;58856;4635;71;25;2;23;.920;3900000;0
18822;37070;3797;81;26;1;25;.962;3600000;0
18822;37638;3796;20;20;6;14;.700;2182000;0
18822;59153;3797;0;0;0;0;.00nan;0;0
18822;161024;3796;71;26;1;25;.962;1418000;0
18824;168001;3800;38;36;6;30;.833;3560000;0
18824;57390;4635;65;36;4;32;.889;3600000;0
18824;78845;3800;0;0;0;0;.00nan;0;0
18824;152696;4635;0;0;0;0;.00nan;0;0
18826;44141;3798;39;26;6;20;.769;3648000;0
18826;57046;3798;0;0;0;0;.00nan;0;0
18826;58856;3795;0;0;0;0;.00nan;0;0
18826;59231;3795;52;34;5;29;.853;3648000;0
18828;44141;3798;0;0;0;0;.00nan;0;0
18828;57046;3798;52;16;2;14;.875;3600000;0
18828;58856;3795;63;54;7;47;.870;3600000;0
18828;59231;3795;0;0;0;0;.00nan;0;0
18830;168001;3800;0;0;0;0;.00nan;0;0
18830;37638;3796;57;35;4;31;.886;3600000;0
18830;78845;3800;87;28;1;27;.964;3600000;0
18830;161024;3796;0;0;0;0;.00nan;0;0
18832;37070;3797;64;10;0;10;1.000;1301000;0
18832;57390;4635;74;31;3;28;.903;3600000;0
18832;59153;3797;11;18;6;12;.667;2299000;0
18832;152696;4635;0;0;0;0;.00nan;0;0
18834;37070;3797;77;40;4;36;.900;3555000;0
18834;57390;4635;50;15;3;12;.800;3600000;0
18834;59153;3797;0;0;0;0;.00nan;0;0
18834;152696;4635;0;0;0;0;.00nan;0;0
18836;44141;3798;55;20;2;18;.900;3600000;0
18836;57046;3798;0;0;0;0;.00nan;0;0
18836;58856;3795;0;0;0;0;.00nan;0;0
18836;59231;3795;54;45;6;39;.867;3600000;0
18838;168001;3800;66;36;4;32;.889;3600000;0
18838;37638;3796;53;44;6;38;.864;3519000;0
18838;78845;3800;0;0;0;0;.00nan;0;0
18838;161024;3796;0;0;0;0;.00nan;0;0
18840;37638;3796;61;32;3;29;.906;3600000;0
18840;57390;4635;63;36;4;32;.889;3584000;0
18840;152696;4635;0;0;0;0;.00nan;0;0
18840;161024;3796;0;0;0;0;.00nan;0;0
18842;44141;3798;47;33;5;28;.848;3600000;0
18842;57046;3798;0;0;0;0;.00nan;0;0
18842;58856;3795;42;37;7;30;.811;3600000;0
18842;59231;3795;0;0;0;0;.00nan;0;0
18844;168001;3800;71;28;2;26;.929;3600000;0
18844;37070;3797;48;38;6;32;.842;2839000;0
18844;59153;3797;63;11;0;11;1.000;761000;0
18844;78845;3800;0;0;0;0;.00nan;0;0
18846;37638;3796;0;0;0;0;.00nan;0;0
18846;57390;4635;71;27;2;25;.926;3600000;0
18846;152696;4635;0;0;0;0;.00nan;0;0
18846;161024;3796;99;42;1;41;.976;3600000;0
18848;44141;3798;0;0;0;0;.00nan;0;0
18848;57046;3798;55;19;2;17;.895;3713000;0
18848;58856;3795;0;0;0;0;.00nan;0;0
18848;59231;3795;89;44;3;41;.932;3713000;0
18850;168001;3800;0;0;0;0;.00nan;0;0
18850;37070;3797;0;0;0;0;.00nan;0;0
18850;59153;3797;83;51;4;47;.922;3564000;0
18850;78845;3800;70;24;2;22;.917;3600000;0
18852;37070;3797;75;30;2;28;.933;3582000;0
18852;58856;3795;78;26;1;25;.962;3600000;0
18852;59153;3797;0;0;0;0;.00nan;0;0
18852;59231;3795;0;0;0;0;.00nan;0;0
18854;44141;3798;73;26;1;25;.962;3567000;0
18854;57046;3798;0;0;0;0;.00nan;0;0
18854;57390;4635;100;23;0;23;1.000;3600000;0
18854;152696;4635;0;0;0;0;.00nan;0;0
18856;168001;3800;0;0;0;0;.00nan;0;0
18856;37638;3796;71;30;2;28;.933;3600000;0
18856;78845;3800;51;19;3;16;.842;3585000;0
18856;161024;3796;0;0;0;0;.00nan;0;0
1536;37070;3796;100;29;0;29;1.000;3600000;0
1536;57340;3795;0;0;0;0;.00nan;0;0
1536;59231;3795;77;23;1;22;.957;3586000;0
1536;161024;3796;0;0;0;0;.00nan;0;0
1537;37638;3797;53;40;5;35;.875;3600000;0
1537;44141;3798;70;26;2;24;.923;3600000;0
1537;57046;3798;0;0;0;0;.00nan;0;0
1537;59153;3797;0;0;0;0;.00nan;0;0
1538;37070;3796;52;19;3;16;.842;3600000;0
1538;57340;3795;0;0;0;0;.00nan;0;0
1538;59231;3795;58;35;5;30;.857;3600000;0
1538;161024;3796;0;0;0;0;.00nan;0;0
1539;37638;3797;24;24;6;18;.750;2587000;0
1539;44141;3798;85;28;1;27;.964;3600000;0
1539;57046;3798;0;0;0;0;.00nan;0;0
1539;59153;3797;38;8;2;6;.750;1013000;0
1540;37070;3796;72;42;5;37;.881;3600000;0
1540;57340;3795;0;0;0;0;.00nan;0;0
1540;59231;3795;74;27;2;25;.926;3600000;0
1540;161024;3796;0;0;0;0;.00nan;0;0
1541;37638;3797;36;42;7;35;.833;3203000;0
1541;44141;3798;66;29;2;27;.931;3600000;0
1541;57046;3798;0;0;0;0;.00nan;0;0
1541;59153;3797;55;6;0;6;1.000;397000;0
1542;37070;3796;58;32;4;28;.875;3600000;0
1542;57340;3795;0;0;0;0;.00nan;0;0
1542;59231;3795;100;34;1;33;.971;3600000;0
1542;161024;3796;0;0;0;0;.00nan;0;0
1543;37638;3797;78;53;5;48;.906;3600000;0
1543;44141;3798;78;30;2;28;.933;3600000;0
1543;57046;3798;0;0;0;0;.00nan;0;0
1543;59153;3797;0;0;0;0;.00nan;0;0
1840;37070;3796;31;39;8;31;.795;3600000;0
1840;57340;3795;0;0;0;0;.00nan;0;0
1840;59231;3795;80;22;1;21;.955;3600000;0
1840;161024;3796;0;0;0;0;.00nan;0;0
1864;37070;3796;80;38;3;35;.921;3600000;0
1864;57340;3795;49;2;0;2;1.000;394000;0
1864;59231;3795;24;28;7;21;.750;3206000;0
1864;161024;3796;0;0;0;0;.00nan;0;0
1892;37070;3796;61;25;3;22;.880;3600000;0
1892;57340;3795;0;0;0;0;.00nan;0;0
1892;59231;3795;53;27;4;23;.852;3579000;0
1892;161024;3796;0;0;0;0;.00nan;0;0
1909;44141;3798;38;27;6;21;.778;2787000;0
1909;57046;3798;56;6;0;6;1.000;739000;0
1909;57390;4635;63;25;4;21;.840;3600000;0
1909;58856;4635;0;0;0;0;.00nan;0;0
1910;168001;3800;81;22;1;21;.955;3600000;0
1910;37070;3796;72;50;5;45;.900;3600000;0
1910;45317;3800;0;0;0;0;.00nan;0;0
1910;161024;3796;0;0;0;0;.00nan;0;0
1911;44141;3798;69;24;2;22;.917;3600000;0
1911;57046;3798;0;0;0;0;.00nan;0;0
1911;57390;4635;62;34;5;29;.853;3600000;0
1911;58856;4635;0;0;0;0;.00nan;0;0
1912;168001;3800;0;0;0;0;.00nan;0;0
1912;37070;3796;16;7;4;3;.429;410000;0
1912;45317;3800;72;19;1;18;.947;3600000;0
1912;161024;3796;85;38;2;36;.947;3190000;0
1913;44141;3798;56;33;4;29;.879;3584000;0
1913;57046;3798;0;0;0;0;.00nan;0;0
1913;57390;4635;76;33;3;30;.909;3600000;0
1913;58856;4635;0;0;0;0;.00nan;0;0
1914;168001;3800;0;0;0;0;.00nan;0;0
1914;37070;3796;78;37;3;34;.919;3600000;0
1914;45317;3800;77;17;1;16;.941;3600000;0
1914;161024;3796;0;0;0;0;.00nan;0;0
1915;44141;3798;48;31;5;26;.839;3600000;0
1915;57046;3798;0;0;0;0;.00nan;0;0
1915;57390;4635;91;34;1;33;.971;3600000;0
1915;58856;4635;0;0;0;0;.00nan;0;0
1916;168001;3800;0;0;0;0;.00nan;0;0
1916;37070;3796;98;47;2;45;.957;3584000;0
1916;45317;3800;66;14;1;13;.929;3600000;0
1916;161024;3796;0;0;0;0;.00nan;0;0
2119;44141;3798;49;37;6;31;.838;3561000;0
2119;57046;3798;0;0;0;0;.00nan;0;0
2119;57390;4635;42;23;5;18;.783;3600000;0
2119;58856;4635;0;0;0;0;.00nan;0;0
2140;168001;3800;0;0;0;0;.00nan;0;0
2140;45317;3800;33;19;4;15;.789;3600000;0
2140;57390;4635;99;40;1;39;.975;3600000;0
2140;58856;4635;0;0;0;0;.00nan;0;0
2141;168001;3800;0;0;0;0;.00nan;0;0
2141;45317;3800;37;28;5;23;.821;3600000;0
2141;57390;4635;98;30;1;29;.967;3600000;0
2141;58856;4635;0;0;0;0;.00nan;0;0
2142;168001;3800;0;0;0;0;.00nan;0;0
2142;45317;3800;88;30;1;29;.967;3600000;0
2142;57390;4635;41;21;4;17;.810;3600000;0
2142;58856;4635;0;0;0;0;.00nan;0;0
2143;168001;3800;0;0;0;0;.00nan;0;0
2143;45317;3800;59;21;2;19;.905;3600000;0
2143;57390;4635;46;24;4;20;.833;2202000;0
2143;58856;4635;70;18;1;17;.944;1398000;0
2334;168001;3800;0;0;0;0;.00nan;0;0
2334;45317;3800;60;32;3;29;.906;3600000;0
2334;57390;4635;85;31;2;29;.935;3600000;0
2334;58856;4635;0;0;0;0;.00nan;0;0
7;168001;3800;0;0;0;0;.00nan;0;0
7;45317;3800;57;29;4;25;.862;3600000;0
7;57390;4635;20;16;5;11;.688;1854000;0
7;58856;4635;52;13;2;11;.846;1746000;0
64;168001;3800;0;0;0;0;.00nan;0;0
64;45317;3800;70;41;4;37;.902;4464000;0
64;57390;4635;81;35;3;32;.914;4464000;0
64;58856;4635;0;0;0;0;.00nan;0;0
18857;2751;4961;61;44;5;39;.886;3423000;0
18857;-1;4961;22;4;3;1;.250;177000;0
18857;46781;1422;40;15;3;12;.800;3600000;0
18857;68961;1422;0;0;0;0;.00nan;0;0
18858;4379;1426;55;20;2;18;.900;2518000;0
18858;46781;1422;46;27;4;23;.852;3600000;0
18858;68961;1422;0;0;0;0;.00nan;0;0
18858;149981;1426;21;11;4;7;.636;1082000;0
18859;1756;1443;0;0;0;0;.00nan;0;0
18859;4127;1440;0;0;0;0;.00nan;0;0
18859;165150;1443;59;15;2;13;.867;3600000;0
18859;28148;1440;82;55;5;50;.909;3600000;0
18860;5923;4742;26;32;7;25;.781;2714000;0
18860;32819;1430;27;14;4;10;.714;1950000;0
18860;36946;4742;61;6;0;6;1.000;886000;0
18860;54860;1430;55;14;1;13;.929;1650000;0
18861;1765;1425;35;19;4;15;.789;2382000;0
18861;9524;1425;50;14;2;12;.857;1218000;0
18861;165030;1453;50;33;5;28;.848;3600000;0
18861;28989;1453;0;0;0;0;.00nan;0;0
18862;2691;1427;0;0;0;0;.00nan;0;0
18862;10214;1429;0;0;0;0;.00nan;0;0
18862;160027;1429;54;31;4;27;.871;3587000;0
18862;161180;1427;84;38;2;36;.947;3600000;0
18863;2691;1427;0;0;0;0;.00nan;0;0
18863;2751;4961;0;0;0;0;.00nan;0;0
18863;-1;4961;83;52;3;49;.942;3583000;0
18863;161180;1427;89;25;1;24;.960;3600000;0
18864;1756;1443;28;6;3;3;.500;3600000;0
18864;4127;1440;44;14;2;12;.857;639000;0
18864;165150;1443;0;0;0;0;.00nan;0;0
18864;28148;1440;52;46;6;40;.870;2961000;0
18865;5923;4742;86;28;1;27;.964;3600000;0
18865;165030;1453;70;32;3;29;.906;3556000;0
18865;28989;1453;0;0;0;0;.00nan;0;0
18865;36946;4742;0;0;0;0;.00nan;0;0
18866;10214;1429;49;1;0;1;1.000;223000;0
18866;32819;1430;0;0;0;0;.00nan;0;0
18866;54860;1430;50;38;5;33;.868;3600000;0
18866;160027;1429;41;36;7;29;.806;3290000;0
18867;1765;1425;0;0;0;0;.00nan;0;0
18867;4379;1426;0;0;0;0;.00nan;0;0
18867;9524;1425;78;30;2;28;.933;3900000;0
18867;149981;1426;83;35;2;33;.943;3900000;0
18868;2751;4961;0;0;0;0;.00nan;0;0
18868;-1;4961;66;38;5;33;.868;3541000;0
18868;32819;1430;0;0;0;0;.00nan;0;0
18868;54860;1430;90;45;3;42;.933;3600000;0
18869;1756;1443;73;19;1;18;.947;3600000;0
18869;4379;1426;60;12;1;11;.917;623000;0
18869;165150;1443;0;0;0;0;.00nan;0;0
18869;149981;1426;38;46;8;38;.826;2977000;0
18870;4127;1440;59;4;0;4;1.000;1097000;0
18870;28148;1440;23;24;6;18;.750;2503000;0
18870;46781;1422;26;40;8;32;.800;3589000;0
18870;68961;1422;0;0;0;0;.00nan;0;0
18871;10214;1429;0;0;0;0;.00nan;0;0
18871;165030;1453;60;39;4;35;.897;3600000;0
18871;28989;1453;0;0;0;0;.00nan;0;0
18871;160027;1429;95;39;1;38;.974;3600000;0
18872;2691;1427;0;0;0;0;.00nan;0;0
18872;32819;1430;0;0;0;0;.00nan;0;0
18872;54860;1430;88;29;1;28;.966;3600000;0
18872;161180;1427;56;32;4;28;.875;3600000;0
18873;1765;1425;34;10;3;7;.700;1718000;0
18873;5923;4742;73;31;2;29;.935;3600000;0
18873;9524;1425;20;18;5;13;.722;1882000;0
18873;36946;4742;0;0;0;0;.00nan;0;0
18874;4127;1440;0;0;0;0;.00nan;0;0
18874;4379;1426;53;30;4;26;.867;3869000;0
18874;28148;1440;60;31;3;28;.903;3869000;0
18874;149981;1426;0;0;0;0;.00nan;0;0
18875;1765;1425;0;0;0;0;.00nan;0;0
18875;2751;4961;0;0;0;0;.00nan;0;0
18875;9524;1425;40;34;6;28;.824;3600000;0
18875;-1;4961;75;34;3;31;.912;3600000;0
18876;1756;1443;80;10;0;10;1.000;3600000;0
18876;165150;1443;0;0;0;0;.00nan;0;0
18876;46781;1422;29;31;6;25;.806;1258000;0
18876;68961;1422;39;38;6;32;.842;2342000;0
18877;2691;1427;85;35;2;33;.943;3600000;0
18877;5923;4742;51;42;6;36;.857;3231000;0
18877;36946;4742;18;8;4;4;.500;369000;0
18877;161180;1427;0;0;0;0;.00nan;0;0
18878;10214;1429;0;0;0;0;.00nan;0;0
18878;165030;1453;80;27;2;25;.926;3600000;0
18878;28989;1453;0;0;0;0;.00nan;0;0
18878;160027;1429;55;32;4;28;.875;3593000;0
18879;1756;1443;55;13;2;11;.846;3600000;0
18879;10214;1429;25;44;8;36;.818;2194000;0
18879;165150;1443;0;0;0;0;.00nan;0;0
18879;160027;1429;11;27;7;20;.741;1406000;0
18880;4127;1440;0;0;0;0;.00nan;0;0
18880;28148;1440;56;22;3;19;.864;3600000;0
18880;32819;1430;0;0;0;0;.00nan;0;0
18880;54860;1430;66;42;5;37;.881;3515000;0
18881;1765;1425;68;30;2;28;.933;3600000;0
18881;9524;1425;0;0;0;0;.00nan;0;0
18881;46781;1422;39;30;5;25;.833;3600000;0
18881;68961;1422;0;0;0;0;.00nan;0;0
18882;4379;1426;71;14;0;14;1.000;1359000;0
18882;165030;1453;80;29;2;27;.931;3600000;0
18882;28989;1453;0;0;0;0;.00nan;0;0
18882;149981;1426;34;30;6;24;.800;2241000;0
18883;2691;1427;39;30;5;25;.833;3600000;0
18883;5923;4742;74;27;2;25;.926;3600000;0
18883;36946;4742;0;0;0;0;.00nan;0;0
18883;161180;1427;0;0;0;0;.00nan;0;0
18884;2751;4961;0;0;0;0;.00nan;0;0
18884;4379;1426;70;39;4;35;.897;3600000;0
18884;-1;4961;35;32;6;26;.813;3532000;0
18884;149981;1426;0;0;0;0;.00nan;0;0
18885;4127;1440;89;26;2;24;.923;3900000;0
18885;28148;1440;0;0;0;0;.00nan;0;0
18885;32819;1430;87;42;2;40;.952;3900000;0
18885;54860;1430;0;0;0;0;.00nan;0;0
18886;5923;4742;0;0;0;0;.00nan;0;0
18886;36946;4742;26;35;7;28;.800;3600000;0
18886;46781;1422;0;0;0;0;.00nan;0;0
18886;68961;1422;70;17;1;16;.941;3600000;0
18887;1756;1443;0;0;0;0;.00nan;0;0
18887;10214;1429;40;39;6;33;.846;2170000;0
18887;165150;1443;70;8;0;8;1.000;3600000;0
18887;160027;1429;57;28;3;25;.893;1430000;0
18888;1765;1425;0;0;0;0;.00nan;0;0
18888;9524;1425;51;16;2;14;.875;3600000;0
18888;165030;1453;61;37;4;33;.892;3559000;0
18888;28989;1453;0;0;0;0;.00nan;0;0
18889;4379;1426;36;20;4;16;.800;3574000;0
18889;5923;4742;78;35;2;33;.943;3600000;0
18889;36946;4742;0;0;0;0;.00nan;0;0
18889;149981;1426;0;0;0;0;.00nan;0;0
18890;2751;4961;41;23;4;19;.826;2719000;0
18890;-1;4961;27;11;4;7;.636;881000;0
18890;46781;1422;75;30;2;28;.933;3600000;0
18890;68961;1422;0;0;0;0;.00nan;0;0
18891;1756;1443;0;0;0;0;.00nan;0;0
18891;165150;1443;50;13;2;11;.846;3632000;0
18891;32819;1430;0;0;0;0;.00nan;0;0
18891;54860;1430;92;56;3;53;.946;3632000;0
18892;1765;1425;0;0;0;0;.00nan;0;0
18892;9524;1425;50;33;5;28;.848;3578000;0
18892;10214;1429;0;0;0;0;.00nan;0;0
18892;160027;1429;81;41;3;38;.927;3600000;0
18893;5923;4742;0;0;0;0;.00nan;0;0
18893;165030;1453;46;33;5;28;.848;3573000;0
18893;28989;1453;0;0;0;0;.00nan;0;0
18893;36946;4742;56;25;3;22;.880;3600000;0
18894;2691;1427;0;0;0;0;.00nan;0;0
18894;4127;1440;26;5;3;2;.400;560000;0
18894;28148;1440;18;30;7;23;.767;3040000;0
18894;161180;1427;76;36;3;33;.917;3600000;0
18895;4379;1426;0;0;0;0;.00nan;0;0
18895;165030;1453;81;40;3;37;.925;3600000;0
18895;28989;1453;0;0;0;0;.00nan;0;0
18895;149981;1426;44;29;4;25;.862;3547000;0
18896;1756;1443;48;18;3;15;.833;3600000;0
18896;165150;1443;0;0;0;0;.00nan;0;0
18896;32819;1430;23;10;4;6;.600;972000;0
18896;54860;1430;84;30;1;29;.967;2628000;0
18897;4127;1440;99;38;1;37;.974;3600000;0
18897;10214;1429;0;0;0;0;.00nan;0;0
18897;28148;1440;0;0;0;0;.00nan;0;0
18897;160027;1429;26;23;5;18;.783;3600000;0
18898;2691;1427;94;43;2;41;.953;3778000;0
18898;46781;1422;0;0;0;0;.00nan;0;0
18898;68961;1422;77;24;1;23;.958;3778000;0
18898;161180;1427;0;0;0;0;.00nan;0;0
18899;2751;4961;0;0;0;0;.00nan;0;0
18899;9524;1425;0;0;0;0;.00nan;0;0
18899;-1;4961;81;51;4;47;.922;3600000;0
18899;62884;1425;70;30;2;28;.933;3600000;0
18900;1756;1443;46;17;3;14;.824;3600000;0
18900;2691;1427;0;0;0;0;.00nan;0;0
18900;165150;1443;0;0;0;0;.00nan;0;0
18900;161180;1427;63;52;7;45;.865;3600000;0
18901;4127;1440;0;0;0;0;.00nan;0;0
18901;4379;1426;0;0;0;0;.00nan;0;0
18901;28148;1440;55;12;1;11;.917;3600000;0
18901;149981;1426;52;36;5;31;.861;3600000;0
18902;165030;1453;64;31;3;28;.903;3900000;0
18902;28989;1453;0;0;0;0;.00nan;0;0
18902;32819;1430;0;0;0;0;.00nan;0;0
18902;54860;1430;81;39;3;36;.923;3900000;0
18903;5923;4742;48;32;6;26;.813;3600000;0
18903;9524;1425;0;0;0;0;.00nan;0;0
18903;36946;4742;0;0;0;0;.00nan;0;0
18903;62884;1425;58;26;3;23;.885;3600000;0
18904;10214;1429;0;0;0;0;.00nan;0;0
18904;46781;1422;46;28;4;24;.857;3600000;0
18904;68961;1422;0;0;0;0;.00nan;0;0
18904;160027;1429;43;31;5;26;.839;3571000;0
18905;2751;4961;0;0;0;0;.00nan;0;0
18905;4379;1426;25;29;6;23;.793;1921000;0
18905;-1;4961;54;32;5;27;.844;3600000;0
18905;149981;1426;60;10;1;9;.900;1593000;0
18906;5923;4742;0;0;0;0;.00nan;0;0
18906;36946;4742;66;20;2;18;.900;3600000;0
18906;46781;1422;0;0;0;0;.00nan;0;0
18906;68961;1422;54;33;4;29;.879;3582000;0
18907;4127;1440;54;30;4;26;.867;3530000;0
18907;165030;1453;0;0;0;0;.00nan;0;0
18907;28148;1440;0;0;0;0;.00nan;0;0
18907;28989;1453;55;23;3;20;.870;3600000;0
18908;1756;1443;0;0;0;0;.00nan;0;0
18908;2691;1427;28;7;3;4;.571;541000;0
18908;165150;1443;47;13;2;11;.846;3600000;0
18908;161180;1427;55;39;5;34;.872;3059000;0
18909;9524;1425;48;0;0;0;.00nan;355000;0
18909;32819;1430;72;33;3;30;.909;3600000;0
18909;54860;1430;0;0;0;0;.00nan;0;0
18909;62884;1425;57;41;6;35;.854;3245000;0
18910;4127;1440;0;0;0;0;.00nan;0;0
18910;10214;1429;0;0;0;0;.00nan;0;0
18910;28148;1440;94;46;2;44;.957;3900000;0
18910;160027;1429;49;17;2;15;.882;3900000;0
18911;4379;1426;0;0;0;0;.00nan;0;0
18911;10214;1429;0;0;0;0;.00nan;0;0
18911;149981;1426;64;23;2;21;.913;3600000;0
18911;160027;1429;64;33;4;29;.879;3582000;0
18912;1756;1443;0;0;0;0;.00nan;0;0
18912;5923;4742;1;16;8;8;.500;636000;0
18912;165150;1443;76;10;0;10;1.000;3600000;0
18912;36946;4742;65;30;3;27;.900;2964000;0
18913;9524;1425;65;26;2;24;.923;2552000;0
18913;32819;1430;0;0;0;0;.00nan;0;0
18913;54860;1430;74;39;5;34;.872;3600000;0
18913;62884;1425;21;9;4;5;.556;1048000;0
18914;2751;4961;0;0;0;0;.00nan;0;0
18914;165030;1453;95;43;2;41;.953;3600000;0
18914;-1;4961;59;36;5;31;.861;3600000;0
18914;28989;1453;0;0;0;0;.00nan;0;0
18915;2691;1427;0;0;0;0;.00nan;0;0
18915;46781;1422;57;26;3;23;.885;3600000;0
18915;68961;1422;0;0;0;0;.00nan;0;0
18915;161180;1427;79;33;2;31;.939;3600000;0
18916;2751;4961;0;0;0;0;.00nan;0;0
18916;165030;1453;48;22;3;19;.864;3609000;0
18916;-1;4961;54;30;4;26;.867;3609000;0
18916;28989;1453;0;0;0;0;.00nan;0;0
18917;4127;1440;0;0;0;0;.00nan;0;0
18917;9524;1425;67;12;0;12;1.000;647000;0
18917;28148;1440;30;33;6;27;.818;3900000;0
18917;62884;1425;18;21;6;15;.714;3253000;0
18918;32819;1430;70;44;5;39;.886;3600000;0
18918;46781;1422;0;0;0;0;.00nan;0;0
18918;54860;1430;0;0;0;0;.00nan;0;0
18918;68961;1422;93;24;0;24;1.000;3600000;0
18919;1756;1443;60;13;1;12;.923;3600000;0
18919;5923;4742;44;57;8;49;.860;3600000;0
18919;165150;1443;0;0;0;0;.00nan;0;0
18919;36946;4742;0;0;0;0;.00nan;0;0
18920;2691;1427;22;14;4;10;.714;981000;0
18920;10214;1429;0;0;0;0;.00nan;0;0
18920;160027;1429;68;18;1;17;.944;3600000;0
18920;161180;1427;48;26;4;22;.846;2619000;0
18921;9524;1425;0;0;0;0;.00nan;0;0
18921;46781;1422;0;0;0;0;.00nan;0;0
18921;62884;1425;49;28;4;24;.857;3600000;0
18921;68961;1422;25;26;6;20;.769;3600000;0
18922;1756;1443;0;0;0;0;.00nan;0;0
18922;2751;4961;0;0;0;0;.00nan;0;0
18922;165150;1443;54;23;3;20;.870;3600000;0
18922;-1;4961;54;46;6;40;.870;3564000;0
18923;4379;1426;0;0;0;0;.00nan;0;0
18923;32819;1430;0;0;0;0;.00nan;0;0
18923;54860;1430;50;35;5;30;.857;3600000;0
18923;149981;1426;88;31;1;30;.968;3600000;0
18924;4127;1440;0;0;0;0;.00nan;0;0
18924;28148;1440;42;23;4;19;.826;3526000;0
18924;46781;1422;71;32;3;29;.906;3600000;0
18924;68961;1422;0;0;0;0;.00nan;0;0
18925;5923;4742;63;26;3;23;.885;3900000;0
18925;10214;1429;0;0;0;0;.00nan;0;0
18925;36946;4742;0;0;0;0;.00nan;0;0
18925;160027;1429;73;38;3;35;.921;3900000;0
18926;2691;1427;0;0;0;0;.00nan;0;0
18926;165030;1453;48;28;4;24;.857;3580000;0
18926;28989;1453;0;0;0;0;.00nan;0;0
18926;161180;1427;61;22;2;20;.909;3600000;0
18927;4379;1426;23;26;6;20;.769;2944000;0
18927;46781;1422;53;46;6;40;.870;3600000;0
18927;68961;1422;0;0;0;0;.00nan;0;0
18927;149981;1426;45;5;1;4;.800;640000;0
18928;2751;4961;70;41;5;36;.878;3558000;0
18928;-1;4961;0;0;0;0;.00nan;0;0
18928;32819;1430;37;20;4;16;.800;3600000;0
18928;54860;1430;0;0;0;0;.00nan;0;0
18929;5923;4742;0;0;0;0;.00nan;0;0
18929;10214;1429;100;26;0;26;1.000;3600000;0
18929;36946;4742;91;37;2;35;.946;3524000;0
18929;160027;1429;0;0;0;0;.00nan;0;0
18930;2691;1427;63;39;5;34;.872;3600000;0
18930;165030;1453;83;27;1;26;.963;3600000;0
18930;28989;1453;0;0;0;0;.00nan;0;0
18930;161180;1427;0;0;0;0;.00nan;0;0
18931;4127;1440;24;31;6;25;.806;3600000;0
18931;9524;1425;0;0;0;0;.00nan;0;0
18931;28148;1440;0;0;0;0;.00nan;0;0
18931;62884;1425;64;30;3;27;.900;3600000;0
18932;2691;1427;0;0;0;0;.00nan;0;0
18932;32819;1430;0;0;0;0;.00nan;0;0
18932;54860;1430;100;37;0;37;1.000;3600000;0
18932;161180;1427;94;30;1;29;.967;3546000;0
18933;4379;1426;0;0;0;0;.00nan;0;0
18933;9524;1425;43;3;1;2;.667;292000;0
18933;62884;1425;17;34;8;26;.765;3308000;0
18933;149981;1426;71;25;2;23;.920;3600000;0
18934;1756;1443;53;9;1;8;.889;3600000;0
18934;165150;1443;0;0;0;0;.00nan;0;0
18934;46781;1422;98;55;2;53;.964;3600000;0
18934;68961;1422;0;0;0;0;.00nan;0;0
18935;4127;1440;0;0;0;0;.00nan;0;0
18935;5923;4742;53;30;5;25;.833;3600000;0
18935;28148;1440;67;24;2;22;.917;3600000;0
18935;36946;4742;0;0;0;0;.00nan;0;0
18936;2751;4961;0;0;0;0;.00nan;0;0
18936;10214;1429;64;35;4;31;.886;3726000;0
18936;-1;4961;56;32;5;27;.844;3726000;0
18936;160027;1429;0;0;0;0;.00nan;0;0
18937;2691;1427;72;28;1;27;.964;3600000;0
18937;165030;1453;71;31;2;29;.935;3549000;0
18937;28989;1453;0;0;0;0;.00nan;0;0
18937;161180;1427;0;0;0;0;.00nan;0;0
18938;1756;1443;0;0;0;0;.00nan;0;0
18938;2751;4961;0;0;0;0;.00nan;0;0
18938;165150;1443;49;14;2;12;.857;3867000;0
18938;-1;4961;91;62;3;59;.952;3867000;0
18939;4127;1440;29;20;5;15;.750;3590000;0
18939;5923;4742;0;0;0;0;.00nan;0;0
18939;28148;1440;0;0;0;0;.00nan;0;0
18939;36946;4742;69;41;4;37;.902;3600000;0
18940;4379;1426;43;15;3;12;.800;3600000;0
18940;46781;1422;25;31;6;25;.806;3600000;0
18940;68961;1422;0;0;0;0;.00nan;0;0
18940;149981;1426;0;0;0;0;.00nan;0;0
18941;165030;1453;68;40;4;36;.900;3600000;0
18941;28989;1453;0;0;0;0;.00nan;0;0
18941;32819;1430;0;0;0;0;.00nan;0;0
18941;54860;1430;64;26;3;23;.885;3600000;0
18942;9524;1425;63;32;3;29;.906;3600000;0
18942;10214;1429;0;0;0;0;.00nan;0;0
18942;62884;1425;0;0;0;0;.00nan;0;0
18942;160027;1429;52;31;4;27;.871;3573000;0
18943;1756;1443;80;8;0;8;1.000;3600000;0
18943;9524;1425;60;16;1;15;.938;1256000;0
18943;165150;1443;0;0;0;0;.00nan;0;0
18943;62884;1425;60;50;6;44;.880;2344000;0
18944;4127;1440;0;0;0;0;.00nan;0;0
18944;4379;1426;67;22;1;21;.955;3600000;0
18944;28148;1440;40;41;6;35;.854;3600000;0
18944;149981;1426;0;0;0;0;.00nan;0;0
18945;32819;1430;38;34;6;28;.824;2787000;0
18945;46781;1422;62;25;2;23;.920;3600000;0
18945;54860;1430;57;6;0;6;1.000;813000;0
18945;68961;1422;0;0;0;0;.00nan;0;0
18946;10214;1429;0;0;0;0;.00nan;0;0
18946;165030;1453;78;28;2;26;.929;3600000;0
18946;28989;1453;0;0;0;0;.00nan;0;0
18946;160027;1429;42;33;5;28;.848;3600000;0
18947;2691;1427;0;0;0;0;.00nan;0;0
18947;2751;4961;0;0;0;0;.00nan;0;0
18947;-1;4961;59;28;3;25;.893;3600000;0
18947;161180;1427;85;31;2;29;.935;3600000;0
18948;4379;1426;0;0;0;0;.00nan;0;0
18948;32819;1430;0;0;0;0;.00nan;0;0
18948;54860;1430;69;28;3;25;.893;3567000;0
18948;149981;1426;76;33;2;31;.939;3600000;0
18949;2751;4961;0;0;0;0;.00nan;0;0
18949;10214;1429;52;27;4;23;.852;3600000;0
18949;-1;4961;71;45;5;40;.889;3545000;0
18949;160027;1429;0;0;0;0;.00nan;0;0
18950;165030;1453;0;0;0;0;.00nan;0;0
18950;28989;1453;77;37;4;33;.892;3900000;0
18950;46781;1422;55;33;4;29;.879;3900000;0
18950;68961;1422;0;0;0;0;.00nan;0;0
18951;2691;1427;59;45;5;40;.889;3600000;0
18951;5923;4742;69;25;2;23;.920;3600000;0
18951;36946;4742;0;0;0;0;.00nan;0;0
18951;161180;1427;0;0;0;0;.00nan;0;0
18952;1756;1443;0;0;0;0;.00nan;0;0
18952;9524;1425;41;27;4;23;.852;1667000;0
18952;165150;1443;89;13;0;13;1.000;3600000;0
18952;62884;1425;23;22;5;17;.773;1933000;0
18953;1756;1443;43;14;3;11;.786;3600000;0
18953;10214;1429;0;0;0;0;.00nan;0;0
18953;165150;1443;0;0;0;0;.00nan;0;0
18953;160027;1429;78;44;4;40;.909;3589000;0
18954;2751;4961;0;0;0;0;.00nan;0;0
18954;4127;1440;0;0;0;0;.00nan;0;0
18954;-1;4961;94;20;0;20;1.000;3600000;0
18954;28148;1440;46;32;5;27;.844;3600000;0
18955;5923;4742;85;43;4;39;.907;3546000;0
18955;32819;1430;0;0;0;0;.00nan;0;0
18955;36946;4742;0;0;0;0;.00nan;0;0
18955;54860;1430;58;27;3;24;.889;3600000;0
18956;165030;1453;62;46;5;41;.891;3600000;0
18956;28989;1453;0;0;0;0;.00nan;0;0
18956;46781;1422;61;25;3;22;.880;3600000;0
18956;68961;1422;0;0;0;0;.00nan;0;0
18957;2691;1427;0;0;0;0;.00nan;0;0
18957;4379;1426;0;0;0;0;.00nan;0;0
18957;149981;1426;84;27;1;26;.963;3600000;0
18957;161180;1427;62;30;3;27;.900;3600000;0
18958;1756;1443;0;0;0;0;.00nan;0;0
18958;4379;1426;43;43;6;37;.860;2711000;0
18958;165150;1443;59;12;1;11;.917;3600000;0
18958;149981;1426;71;18;1;17;.944;889000;0
18959;2751;4961;46;6;1;5;.833;1671000;0
18959;-1;4961;34;16;4;12;.750;1872000;0
18959;46781;1422;45;25;4;21;.840;3600000;0
18959;68961;1422;0;0;0;0;.00nan;0;0
18960;5923;4742;62;12;0;12;1.000;954000;0
18960;32819;1430;90;29;1;28;.966;3600000;0
18960;36946;4742;32;33;6;27;.818;2646000;0
18960;54860;1430;0;0;0;0;.00nan;0;0
18961;10214;1429;24;25;6;19;.760;3600000;0
18961;165030;1453;0;0;0;0;.00nan;0;0
18961;28989;1453;64;29;3;26;.897;3600000;0
18961;160027;1429;0;0;0;0;.00nan;0;0
18962;2691;1427;96;49;3;46;.939;3571000;0
18962;9524;1425;0;0;0;0;.00nan;0;0
18962;62884;1425;73;23;2;21;.913;3600000;0
18962;161180;1427;0;0;0;0;.00nan;0;0
18963;1756;1443;70;7;0;7;1.000;3600000;0
18963;165030;1453;52;38;6;32;.842;2534000;0
18963;165150;1443;0;0;0;0;.00nan;0;0
18963;28989;1453;69;18;1;17;.944;1066000;0
18964;2751;4961;0;0;0;0;.00nan;0;0
18964;5923;4742;46;33;5;28;.848;3600000;0
18964;-1;4961;76;28;2;26;.929;3600000;0
18964;36946;4742;0;0;0;0;.00nan;0;0
18965;4127;1440;0;0;0;0;.00nan;0;0
18965;28148;1440;41;24;4;20;.833;3558000;0
18965;32819;1430;0;0;0;0;.00nan;0;0
18965;54860;1430;78;28;2;26;.929;3600000;0
18966;2691;1427;0;0;0;0;.00nan;0;0
18966;10214;1429;0;0;0;0;.00nan;0;0
18966;160027;1429;66;33;3;30;.909;3872000;0
18966;161180;1427;66;35;4;31;.886;3872000;0
18967;4379;1426;0;0;0;0;.00nan;0;0
18967;9524;1425;0;0;0;0;.00nan;0;0
18967;62884;1425;61;30;3;27;.900;3600000;0
18967;149981;1426;71;36;4;32;.889;3569000;0
18968;2691;1427;44;4;1;3;.750;340000;0
18968;4379;1426;38;28;5;23;.821;3600000;0
18968;149981;1426;0;0;0;0;.00nan;0;0
18968;161180;1427;39;35;6;29;.829;3219000;0
18969;4127;1440;51;28;4;24;.857;3900000;0
18969;28148;1440;0;0;0;0;.00nan;0;0
18969;32819;1430;59;26;4;22;.846;3900000;0
18969;54860;1430;0;0;0;0;.00nan;0;0
18970;10214;1429;68;44;5;39;.886;3548000;0
18970;46781;1422;54;28;4;24;.857;3600000;0
18970;68961;1422;0;0;0;0;.00nan;0;0
18970;160027;1429;0;0;0;0;.00nan;0;0
18971;2751;4961;0;0;0;0;.00nan;0;0
18971;5923;4742;0;0;0;0;.00nan;0;0
18971;-1;4961;67;21;2;19;.905;3600000;0
18971;36946;4742;56;27;3;24;.889;3600000;0
18972;1756;1443;87;15;0;15;1.000;3600000;0
18972;165030;1453;28;18;4;14;.778;1104000;0
18972;165150;1443;0;0;0;0;.00nan;0;0
18972;28989;1453;60;33;3;30;.909;2496000;0
18973;1756;1443;51;7;1;6;.857;3600000;0
18973;5923;4742;60;49;6;43;.878;3600000;0
18973;165150;1443;0;0;0;0;.00nan;0;0
18973;36946;4742;0;0;0;0;.00nan;0;0
18974;4127;1440;0;0;0;0;.00nan;0;0
18974;9524;1425;0;0;0;0;.00nan;0;0
18974;28148;1440;61;22;2;20;.909;3600000;0
18974;62884;1425;49;23;3;20;.870;3545000;0
18975;10214;1429;0;0;0;0;.00nan;0;0
18975;32819;1430;0;0;0;0;.00nan;0;0
18975;54860;1430;82;37;2;35;.946;3600000;0
18975;160027;1429;25;31;6;25;.806;3600000;0
18976;2751;4961;0;0;0;0;.00nan;0;0
18976;-1;4961;64;28;3;25;.893;3900000;0
18976;46781;1422;57;26;3;23;.885;3900000;0
18976;68961;1422;0;0;0;0;.00nan;0;0
18977;2691;1427;12;20;6;14;.700;1606000;0
18977;165030;1453;42;30;5;25;.833;3600000;0
18977;28989;1453;0;0;0;0;.00nan;0;0
18977;161180;1427;40;13;3;10;.769;1994000;0
18978;4127;1440;28;27;6;21;.778;2533000;0
18978;4379;1426;0;0;0;0;.00nan;0;0
18978;28148;1440;29;7;3;4;.571;1067000;0
18978;149981;1426;74;38;3;35;.921;3600000;0
18979;2751;4961;31;23;5;18;.783;3561000;0
18979;-1;4961;0;0;0;0;.00nan;0;0
18979;32819;1430;78;42;3;39;.929;3600000;0
18979;54860;1430;0;0;0;0;.00nan;0;0
18980;1756;1443;0;0;0;0;.00nan;0;0
18980;5923;4742;94;60;5;55;.917;3600000;0
18980;165150;1443;81;9;0;9;1.000;3600000;0
18980;36946;4742;0;0;0;0;.00nan;0;0
18981;2691;1427;0;0;0;0;.00nan;0;0
18981;10214;1429;89;26;1;25;.962;3600000;0
18981;160027;1429;0;0;0;0;.00nan;0;0
18981;161180;1427;46;37;6;31;.838;3600000;0
18982;9524;1425;80;38;3;35;.921;3600000;0
18982;46781;1422;43;36;6;30;.833;3600000;0
18982;62884;1425;0;0;0;0;.00nan;0;0
18982;68961;1422;0;0;0;0;.00nan;0;0
18983;1756;1443;0;0;0;0;.00nan;0;0
18983;165150;1443;42;21;4;17;.810;3600000;0
18983;46781;1422;39;47;7;40;.851;3600000;0
18983;68961;1422;0;0;0;0;.00nan;0;0
18984;4379;1426;0;0;0;0;.00nan;0;0
18984;32819;1430;0;0;0;0;.00nan;0;0
18984;54860;1430;83;33;2;31;.939;3600000;0
18984;149981;1426;56;28;4;24;.857;3554000;0
18985;2691;1427;0;0;0;0;.00nan;0;0
18985;4127;1440;0;0;0;0;.00nan;0;0
18985;28148;1440;75;31;2;29;.935;3600000;0
18985;161180;1427;69;37;4;33;.892;3567000;0
18986;5923;4742;93;29;1;28;.966;3600000;0
18986;9524;1425;0;0;0;0;.00nan;0;0
18986;36946;4742;0;0;0;0;.00nan;0;0
18986;62884;1425;58;27;3;24;.889;3521000;0
18987;4379;1426;100;35;0;35;1.000;3600000;0
18987;9524;1425;0;0;0;0;.00nan;0;0
18987;62884;1425;79;27;2;25;.926;3541000;0
18987;149981;1426;0;0;0;0;.00nan;0;0
18988;1756;1443;68;16;1;15;.938;3600000;0
18988;2751;4961;44;5;1;4;.800;395000;0
18988;165150;1443;0;0;0;0;.00nan;0;0
18988;-1;4961;41;48;8;40;.833;3205000;0
18989;2691;1427;46;32;5;27;.844;3600000;0
18989;4127;1440;64;23;2;21;.913;3600000;0
18989;28148;1440;0;0;0;0;.00nan;0;0
18989;161180;1427;0;0;0;0;.00nan;0;0
18990;165030;1453;80;22;1;21;.955;3600000;0
18990;28989;1453;0;0;0;0;.00nan;0;0
18990;46781;1422;0;0;0;0;.00nan;0;0
18990;68961;1422;61;20;2;18;.900;3590000;0
18991;5923;4742;0;0;0;0;.00nan;0;0
18991;10214;1429;0;0;0;0;.00nan;0;0
18991;36946;4742;89;38;2;36;.947;3767000;0
18991;160027;1429;50;24;3;21;.875;3770000;0
18992;2751;4961;0;0;0;0;.00nan;0;0
18992;4127;1440;0;0;0;0;.00nan;0;0
18992;-1;4961;92;41;3;38;.927;3900000;0
18992;28148;1440;54;21;3;18;.857;3900000;0
18993;1756;1443;0;0;0;0;.00nan;0;0
18993;165150;1443;98;22;0;22;1.000;3600000;0
18993;32819;1430;0;0;0;0;.00nan;0;0
18993;54860;1430;59;41;5;36;.878;3600000;0
18994;2751;4961;0;0;0;0;.00nan;0;0
18994;4127;1440;50;33;4;29;.879;3600000;0
18994;-1;4961;78;30;2;28;.933;3600000;0
18994;28148;1440;0;0;0;0;.00nan;0;0
18995;5923;4742;58;41;5;36;.878;3900000;0
18995;165030;1453;60;42;5;37;.881;3900000;0
18995;28989;1453;0;0;0;0;.00nan;0;0
18995;36946;4742;0;0;0;0;.00nan;0;0
18996;4379;1426;43;25;4;21;.840;3725000;0
18996;10214;1429;0;0;0;0;.00nan;0;0
18996;149981;1426;0;0;0;0;.00nan;0;0
18996;160027;1429;57;28;3;25;.893;3672000;0
18997;2691;1427;0;0;0;0;.00nan;0;0
18997;9524;1425;0;0;0;0;.00nan;0;0
18997;62884;1425;58;22;2;20;.909;3600000;0
18997;161180;1427;87;57;5;52;.912;3600000;0
18998;4379;1426;0;0;0;0;.00nan;0;0
18998;5923;4742;95;50;2;48;.960;3600000;0
18998;36946;4742;0;0;0;0;.00nan;0;0
18998;149981;1426;14;23;6;17;.739;3600000;0
18999;2751;4961;0;0;0;0;.00nan;0;0
18999;10214;1429;0;0;0;0;.00nan;0;0
18999;-1;4961;97;44;3;41;.932;3600000;0
18999;160027;1429;47;39;6;33;.846;3600000;0
19000;4127;1440;0;0;0;0;.00nan;0;0
19000;165030;1453;68;26;2;24;.923;3600000;0
19000;28148;1440;66;26;3;23;.885;3559000;0
19000;28989;1453;0;0;0;0;.00nan;0;0
19001;1756;1443;52;16;2;14;.875;3600000;0
19001;2691;1427;92;50;3;47;.940;3586000;0
19001;165150;1443;0;0;0;0;.00nan;0;0
19001;161180;1427;0;0;0;0;.00nan;0;0
19002;1756;1443;0;0;0;0;.00nan;0;0
19002;2691;1427;0;0;0;0;.00nan;0;0
19002;165150;1443;51;15;2;13;.867;3600000;0
19002;161180;1427;91;59;4;55;.932;3600000;0
19003;32819;1430;0;0;0;0;.00nan;0;0
19003;46781;1422;70;20;1;19;.950;3600000;0
19003;54860;1430;57;21;2;19;.905;3583000;0
19003;68961;1422;0;0;0;0;.00nan;0;0
19004;4379;1426;70;22;1;21;.955;3600000;0
19004;5923;4742;0;0;0;0;.00nan;0;0
19004;36946;4742;86;40;3;37;.925;3530000;0
19004;149981;1426;0;0;0;0;.00nan;0;0
19005;2751;4961;0;0;0;0;.00nan;0;0
19005;165030;1453;0;0;0;0;.00nan;0;0
19005;-1;4961;44;34;5;29;.853;3600000;0
19005;28989;1453;71;25;2;23;.920;3600000;0
19006;4127;1440;38;31;5;26;.839;3600000;0
19006;9524;1425;0;0;0;0;.00nan;0;0
19006;28148;1440;0;0;0;0;.00nan;0;0
19006;62884;1425;80;23;1;22;.957;3600000;0
19007;32819;1430;57;18;2;16;.889;3600000;0
19007;46781;1422;34;19;5;14;.737;2241000;0
19007;54860;1430;0;0;0;0;.00nan;0;0
19007;68961;1422;61;21;2;19;.905;1359000;0
19008;9524;1425;0;0;0;0;.00nan;0;0
19008;10214;1429;0;0;0;0;.00nan;0;0
19008;62884;1425;60;25;3;22;.880;3600000;0
19008;160027;1429;49;30;4;26;.867;3600000;0
19009;1756;1443;51;21;3;18;.857;3600000;0
19009;4379;1426;47;39;6;33;.846;2859000;0
19009;165150;1443;0;0;0;0;.00nan;0;0
19009;149981;1426;44;11;2;9;.818;741000;0
19010;4127;1440;0;0;0;0;.00nan;0;0
19010;10214;1429;0;0;0;0;.00nan;0;0
19010;28148;1440;78;32;2;30;.938;3900000;0
19010;160027;1429;69;29;2;27;.931;3900000;0
19011;5923;4742;49;34;5;29;.853;3534000;0
19011;36946;4742;0;0;0;0;.00nan;0;0
19011;46781;1422;73;32;3;29;.906;3600000;0
19011;68961;1422;0;0;0;0;.00nan;0;0
19012;9524;1425;0;0;0;0;.00nan;0;0
19012;165030;1453;61;24;3;21;.875;3900000;0
19012;28989;1453;0;0;0;0;.00nan;0;0
19012;62884;1425;83;36;3;33;.917;3900000;0
19013;2691;1427;0;0;0;0;.00nan;0;0
19013;32819;1430;56;20;3;17;.850;2500000;0
19013;54860;1430;22;11;4;7;.636;1100000;0
19013;161180;1427;52;31;4;27;.871;3600000;0
19014;1756;1443;0;0;0;0;.00nan;0;0
19014;4379;1426;0;0;0;0;.00nan;0;0
19014;165150;1443;74;7;0;7;1.000;3600000;0
19014;149981;1426;66;51;6;45;.882;3600000;0
19015;4127;1440;65;42;5;37;.881;3600000;0
19015;10214;1429;68;30;4;26;.867;3600000;0
19015;28148;1440;0;0;0;0;.00nan;0;0
19015;160027;1429;0;0;0;0;.00nan;0;0
19016;2751;4961;0;0;0;0;.00nan;0;0
19016;165030;1453;83;25;2;23;.920;3600000;0
19016;-1;4961;61;37;4;33;.892;3551000;0
19016;28989;1453;0;0;0;0;.00nan;0;0
19017;2691;1427;0;0;0;0;.00nan;0;0
19017;32819;1430;0;0;0;0;.00nan;0;0
19017;54860;1430;62;23;3;20;.870;3891000;0
19017;161180;1427;51;29;4;25;.862;3891000;0
19018;5923;4742;70;35;3;32;.914;3600000;0
19018;36946;4742;0;0;0;0;.00nan;0;0
19018;46781;1422;61;37;4;33;.892;3543000;0
19018;68961;1422;0;0;0;0;.00nan;0;0
19019;4127;1440;0;0;0;0;.00nan;0;0
19019;28148;1440;57;38;3;35;.921;3600000;0
19019;46781;1422;68;23;2;21;.913;3600000;0
19019;68961;1422;0;0;0;0;.00nan;0;0
19020;10214;1429;0;0;0;0;.00nan;0;0
19020;32819;1430;74;21;1;20;.952;3600000;0
19020;54860;1430;0;0;0;0;.00nan;0;0
19020;160027;1429;74;42;3;39;.929;3561000;0
19021;1756;1443;99;23;0;23;1.000;3600000;0
19021;165030;1453;74;53;5;48;.906;3600000;0
19021;165150;1443;0;0;0;0;.00nan;0;0
19021;28989;1453;0;0;0;0;.00nan;0;0
19022;2691;1427;0;0;0;0;.00nan;0;0
19022;5923;4742;41;39;7;32;.821;3600000;0
19022;36946;4742;0;0;0;0;.00nan;0;0
19022;161180;1427;52;25;3;22;.880;3600000;0
19023;2751;4961;0;0;0;0;.00nan;0;0
19023;9524;1425;79;16;0;16;1.000;3600000;0
19023;-1;4961;92;38;1;37;.974;3551000;0
19023;62884;1425;0;0;0;0;.00nan;0;0
19024;2691;1427;62;50;6;44;.880;3600000;0
19024;4379;1426;0;0;0;0;.00nan;0;0
19024;149981;1426;52;18;3;15;.833;3600000;0
19024;161180;1427;0;0;0;0;.00nan;0;0
19025;2751;4961;100;46;3;43;.935;3741000;0
19025;9524;1425;0;0;0;0;.00nan;0;0
19025;-1;4961;0;0;0;0;.00nan;0;0
19025;62884;1425;67;30;4;26;.867;3741000;0
19026;4127;1440;0;0;0;0;.00nan;0;0
19026;28148;1440;3;17;7;10;.588;3600000;0
19026;46781;1422;93;33;1;32;.970;3600000;0
19026;68961;1422;0;0;0;0;.00nan;0;0
19027;5923;4742;72;33;3;30;.909;3567000;0
19027;10214;1429;0;0;0;0;.00nan;0;0
19027;36946;4742;0;0;0;0;.00nan;0;0
19027;160027;1429;62;13;1;12;.923;3600000;0
19028;1756;1443;57;11;1;10;.909;3600000;0
19028;165030;1453;78;46;5;41;.891;3600000;0
19028;165150;1443;0;0;0;0;.00nan;0;0
19028;28989;1453;0;0;0;0;.00nan;0;0
19029;4127;1440;0;0;0;0;.00nan;0;0
19029;165030;1453;51;38;5;33;.868;3513000;0
19029;28148;1440;65;30;3;27;.900;3600000;0
19029;28989;1453;0;0;0;0;.00nan;0;0
19030;1756;1443;0;0;0;0;.00nan;0;0
19030;165030;1453;97;49;2;47;.959;3559000;0
19030;165150;1443;52;8;1;7;.875;3600000;0
19030;28989;1453;0;0;0;0;.00nan;0;0
19031;9524;1425;0;0;0;0;.00nan;0;0
19031;32819;1430;60;23;2;21;.913;3600000;0
19031;54860;1430;0;0;0;0;.00nan;0;0
19031;62884;1425;64;27;4;23;.852;3600000;0
19032;2751;4961;0;0;0;0;.00nan;0;0
19032;5923;4742;31;24;5;19;.792;3600000;0
19032;-1;4961;85;39;2;37;.949;3600000;0
19032;36946;4742;0;0;0;0;.00nan;0;0
19033;10214;1429;0;0;0;0;.00nan;0;0
19033;46781;1422;100;40;1;39;.975;3900000;0
19033;68961;1422;0;0;0;0;.00nan;0;0
19033;160027;1429;84;25;1;24;.960;3900000;0
19034;2691;1427;0;0;0;0;.00nan;0;0
19034;4379;1426;0;0;0;0;.00nan;0;0
19034;149981;1426;75;30;3;27;.900;3900000;0
19034;161180;1427;83;45;3;42;.933;3900000;0
19035;4379;1426;44;26;4;22;.846;3600000;0
19035;5923;4742;47;38;5;33;.868;3580000;0
19035;36946;4742;0;0;0;0;.00nan;0;0
19035;149981;1426;0;0;0;0;.00nan;0;0
19036;2751;4961;49;38;6;32;.842;3035000;0
19036;-1;4961;67;10;0;10;1.000;565000;0
19036;32819;1430;0;0;0;0;.00nan;0;0
19036;54860;1430;54;18;2;16;.889;3600000;0
19037;1756;1443;67;15;1;14;.933;3600000;0
19037;4127;1440;59;8;0;8;1.000;954000;0
19037;165150;1443;0;0;0;0;.00nan;0;0
19037;28148;1440;52;38;6;32;.842;2646000;0
19038;2691;1427;64;39;4;35;.897;3600000;0
19038;46781;1422;92;20;0;20;1.000;3600000;0
19038;68961;1422;0;0;0;0;.00nan;0;0
19038;161180;1427;0;0;0;0;.00nan;0;0
19039;9524;1425;51;26;4;22;.846;3600000;0
19039;10214;1429;0;0;0;0;.00nan;0;0
19039;62884;1425;0;0;0;0;.00nan;0;0
19039;160027;1429;45;35;5;30;.857;3560000;0
19040;1756;1443;71;22;2;20;.909;3600000;0
19040;4127;1440;0;0;0;0;.00nan;0;0
19040;165150;1443;0;0;0;0;.00nan;0;0
19040;28148;1440;74;51;4;47;.922;3600000;0
19041;2751;4961;0;0;0;0;.00nan;0;0
19041;4379;1426;0;0;0;0;.00nan;0;0
19041;-1;4961;64;46;5;41;.891;3557000;0
19041;149981;1426;51;16;3;13;.813;3600000;0
19042;5923;4742;93;56;4;52;.929;3553000;0
19042;32819;1430;68;26;2;24;.923;3600000;0
19042;36946;4742;0;0;0;0;.00nan;0;0
19042;54860;1430;0;0;0;0;.00nan;0;0
19043;10214;1429;0;0;0;0;.00nan;0;0
19043;165030;1453;75;29;2;27;.931;3600000;0
19043;28989;1453;0;0;0;0;.00nan;0;0
19043;160027;1429;60;38;4;34;.895;3523000;0
19044;2691;1427;0;0;0;0;.00nan;0;0
19044;9524;1425;0;0;0;0;.00nan;0;0
19044;62884;1425;85;19;0;19;1.000;3600000;0
19044;161180;1427;91;31;1;30;.968;3550000;0
19045;2751;4961;0;0;0;0;.00nan;0;0
19045;4379;1426;92;38;2;36;.947;3600000;0
19045;-1;4961;19;33;7;26;.788;3600000;0
19045;149981;1426;0;0;0;0;.00nan;0;0
19046;1756;1443;0;0;0;0;.00nan;0;0
19046;165150;1443;51;7;1;6;.857;3600000;0
19046;46781;1422;63;48;6;42;.875;2634000;0
19046;68961;1422;61;15;1;14;.933;966000;0
19047;5923;4742;0;0;0;0;.00nan;0;0
19047;32819;1430;39;8;2;6;.750;1445000;0
19047;36946;4742;84;43;3;40;.930;3600000;0
19047;54860;1430;37;23;5;18;.783;2155000;0
19048;10214;1429;0;0;0;0;.00nan;0;0
19048;165030;1453;13;19;6;13;.684;3251000;0
19048;28989;1453;50;7;1;6;.857;349000;0
19048;160027;1429;86;31;2;29;.935;3600000;0
19049;2691;1427;48;49;7;42;.857;3050000;0
19049;9524;1425;0;0;0;0;.00nan;0;0
19049;62884;1425;62;21;2;19;.905;3600000;0
19049;161180;1427;40;3;1;2;.667;550000;0
19050;4127;1440;0;0;0;0;.00nan;0;0
19050;28148;1440;53;28;3;25;.893;3567000;0
19050;32819;1430;72;15;1;14;.933;3600000;0
19050;54860;1430;0;0;0;0;.00nan;0;0
19051;32819;1430;0;0;0;0;.00nan;0;0
19051;46781;1422;46;41;6;35;.854;2904000;0
19051;54860;1430;46;21;4;17;.810;3600000;0
19051;68961;1422;43;3;1;2;.667;696000;0
19052;2751;4961;0;0;0;0;.00nan;0;0
19052;10214;1429;0;0;0;0;.00nan;0;0
19052;-1;4961;83;18;0;18;1.000;3600000;0
19052;160027;1429;80;33;1;32;.970;3551000;0
19053;2691;1427;53;2;0;2;1.000;618000;0
19053;165030;1453;27;27;6;21;.778;3112000;0
19053;28989;1453;47;2;0;2;1.000;788000;0
19053;161180;1427;59;41;6;35;.854;3282000;0
19054;4379;1426;0;0;0;0;.00nan;0;0
19054;9524;1425;0;0;0;0;.00nan;0;0
19054;62884;1425;46;32;6;26;.813;3776000;0
19054;149981;1426;67;43;5;38;.884;3776000;0
19055;4379;1426;86;32;2;30;.938;3600000;0
19055;9524;1425;0;0;0;0;.00nan;0;0
19055;62884;1425;82;26;1;25;.962;3600000;0
19055;149981;1426;0;0;0;0;.00nan;0;0
19056;1756;1443;0;0;0;0;.00nan;0;0
19056;165030;1453;37;33;6;27;.818;2882000;0
19056;165150;1443;63;28;3;25;.893;3600000;0
19056;28989;1453;42;14;3;11;.786;718000;0
19057;2691;1427;42;22;4;18;.818;3245000;0
19057;2751;4961;0;0;0;0;.00nan;0;0
19057;-1;4961;86;48;3;45;.938;3600000;0
19057;161180;1427;39;1;1;0;.000;323000;0
19058;10214;1429;0;0;0;0;.00nan;0;0
19058;46781;1422;54;32;4;28;.875;3600000;0
19058;68961;1422;0;0;0;0;.00nan;0;0
19058;160027;1429;32;27;5;22;.815;3548000;0
19059;4127;1440;0;0;0;0;.00nan;0;0
19059;5923;4742;67;24;2;22;.917;3600000;0
19059;28148;1440;72;28;3;25;.893;3599000;0
19059;36946;4742;0;0;0;0;.00nan;0;0
19060;4379;1426;0;0;0;0;.00nan;0;0
19060;10214;1429;0;0;0;0;.00nan;0;0
19060;149981;1426;42;18;3;15;.833;3600000;0
19060;160027;1429;76;32;1;31;.969;3600000;0
19061;1756;1443;44;21;3;18;.857;3598000;0
19061;9524;1425;0;0;0;0;.00nan;0;0
19061;165150;1443;0;0;0;0;.00nan;0;0
19061;62884;1425;97;44;2;42;.955;3600000;0
19062;4127;1440;71;19;1;18;.947;3600000;0
19062;5923;4742;55;37;5;32;.865;3600000;0
19062;28148;1440;0;0;0;0;.00nan;0;0
19062;36946;4742;0;0;0;0;.00nan;0;0
19063;165030;1453;42;30;5;25;.833;3600000;0
19063;28989;1453;0;0;0;0;.00nan;0;0
19063;32819;1430;77;30;2;28;.933;3600000;0
19063;54860;1430;0;0;0;0;.00nan;0;0
19064;2691;1427;0;0;0;0;.00nan;0;0
19064;46781;1422;70;27;2;25;.926;3600000;0
19064;68961;1422;0;0;0;0;.00nan;0;0
19064;161180;1427;51;31;5;26;.839;3600000;0
19065;1756;1443;0;0;0;0;.00nan;0;0
19065;2751;4961;0;0;0;0;.00nan;0;0
19065;165150;1443;55;13;1;12;.923;3600000;0
19065;-1;4961;30;53;9;44;.830;3600000;0
19066;32819;1430;0;0;0;0;.00nan;0;0
19066;46781;1422;0;0;0;0;.00nan;0;0
19066;54860;1430;86;22;1;21;.955;3600000;0
19066;68961;1422;93;53;3;50;.943;3600000;0
19067;2691;1427;63;31;3;28;.903;3552000;0
19067;5923;4742;0;0;0;0;.00nan;0;0
19067;36946;4742;75;30;2;28;.933;3600000;0
19067;161180;1427;0;0;0;0;.00nan;0;0
19068;4379;1426;34;27;5;22;.815;2377000;0
19068;10214;1429;0;0;0;0;.00nan;0;0
19068;149981;1426;70;14;0;14;1.000;1223000;0
19068;160027;1429;86;35;2;33;.943;3600000;0
19069;9524;1425;0;0;0;0;.00nan;0;0
19069;165030;1453;47;28;4;24;.857;3557000;0
19069;28989;1453;0;0;0;0;.00nan;0;0
19069;62884;1425;55;27;3;24;.889;3600000;0
19070;4379;1426;0;0;0;0;.00nan;0;0
19070;165030;1453;89;38;2;36;.947;3600000;0
19070;28989;1453;0;0;0;0;.00nan;0;0
19070;149981;1426;57;28;3;25;.893;3553000;0
19071;1756;1443;48;14;2;12;.857;3600000;0
19071;165150;1443;0;0;0;0;.00nan;0;0
19071;32819;1430;22;10;4;6;.600;765000;0
19071;54860;1430;43;32;5;27;.844;2835000;0
19072;2751;4961;0;0;0;0;.00nan;0;0
19072;10214;1429;0;0;0;0;.00nan;0;0
19072;-1;4961;100;29;0;29;1.000;3600000;0
19072;160027;1429;20;33;8;25;.758;3600000;0
19073;2691;1427;0;0;0;0;.00nan;0;0
19073;4127;1440;0;0;0;0;.00nan;0;0
19073;28148;1440;47;24;4;20;.833;3900000;0
19073;161180;1427;77;39;4;35;.897;3900000;0
19074;9524;1425;0;0;0;0;.00nan;0;0
19074;46781;1422;72;26;2;24;.923;3600000;0
19074;62884;1425;50;21;3;18;.857;3550000;0
19074;68961;1422;0;0;0;0;.00nan;0;0
19075;4127;1440;80;43;3;40;.930;3590000;0
19075;9524;1425;0;0;0;0;.00nan;0;0
19075;28148;1440;0;0;0;0;.00nan;0;0
19075;62884;1425;57;17;2;15;.882;3600000;0
19076;2691;1427;71;34;3;31;.912;3600000;0
19076;32819;1430;100;32;0;32;1.000;3600000;0
19076;54860;1430;0;0;0;0;.00nan;0;0
19076;161180;1427;0;0;0;0;.00nan;0;0
19077;4379;1426;69;28;2;26;.929;3600000;0
19077;46781;1422;0;0;0;0;.00nan;0;0
19077;68961;1422;56;37;4;33;.892;3568000;0
19077;149981;1426;0;0;0;0;.00nan;0;0
19078;2751;4961;0;0;0;0;.00nan;0;0
19078;5923;4742;63;29;3;26;.897;3544000;0
19078;-1;4961;87;28;1;27;.964;3600000;0
19078;36946;4742;0;0;0;0;.00nan;0;0
19079;1756;1443;0;0;0;0;.00nan;0;0
19079;10214;1429;0;0;0;0;.00nan;0;0
19079;165150;1443;97;17;0;17;1.000;3600000;0
19079;160027;1429;64;39;4;35;.897;3600000;0
19080;2751;4961;0;0;0;0;.00nan;0;0
19080;10214;1429;0;0;0;0;.00nan;0;0
19080;-1;4961;64;31;3;28;.903;3600000;0
19080;160027;1429;35;27;5;22;.815;3550000;0
19081;1756;1443;67;15;1;14;.933;3600000;0
19081;4379;1426;0;0;0;0;.00nan;0;0
19081;165150;1443;0;0;0;0;.00nan;0;0
19081;149981;1426;61;48;6;42;.875;3600000;0
19082;4127;1440;0;0;0;0;.00nan;0;0
19082;28148;1440;43;18;3;15;.833;3874000;0
19082;46781;1422;60;36;4;32;.889;3874000;0
19082;68961;1422;0;0;0;0;.00nan;0;0
19083;5923;4742;50;30;4;26;.867;3561000;0
19083;9524;1425;0;0;0;0;.00nan;0;0
19083;36946;4742;0;0;0;0;.00nan;0;0
19083;62884;1425;79;32;2;30;.938;3600000;0
19084;165030;1453;54;40;5;35;.875;3900000;0
19084;28989;1453;0;0;0;0;.00nan;0;0
19084;32819;1430;46;33;5;28;.848;3900000;0
19084;54860;1430;0;0;0;0;.00nan;0;0
19085;2691;1427;0;0;0;0;.00nan;0;0
19085;2751;4961;0;0;0;0;.00nan;0;0
19085;-1;4961;54;32;4;28;.875;3600000;0
19085;161180;1427;47;32;5;27;.844;3544000;0
19086;2751;4961;0;0;0;0;.00nan;0;0
19086;4379;1426;18;31;8;23;.742;3278000;0
19086;-1;4961;60;31;3;28;.903;3600000;0
19086;149981;1426;58;5;0;5;1.000;322000;0
19087;4127;1440;52;26;3;23;.885;3534000;0
19087;28148;1440;0;0;0;0;.00nan;0;0
19087;46781;1422;0;0;0;0;.00nan;0;0
19087;68961;1422;74;19;1;18;.947;3600000;0
19088;5923;4742;0;0;0;0;.00nan;0;0
19088;10214;1429;0;0;0;0;.00nan;0;0
19088;36946;4742;77;46;4;42;.913;3600000;0
19088;160027;1429;39;30;5;25;.833;3566000;0
19089;165030;1453;0;0;0;0;.00nan;0;0
19089;28989;1453;72;24;1;23;.958;3600000;0
19089;32819;1430;0;0;0;0;.00nan;0;0
19089;54860;1430;40;28;5;23;.821;3600000;0
19090;1756;1443;0;0;0;0;.00nan;0;0
19090;9524;1425;57;5;0;5;1.000;449000;0
19090;165150;1443;62;17;2;15;.882;3600000;0
19090;62884;1425;50;42;6;36;.857;3151000;0
19091;1756;1443;51;14;2;12;.857;3600000;0
19091;4127;1440;54;14;1;13;.929;876000;0
19091;165150;1443;0;0;0;0;.00nan;0;0
19091;28148;1440;38;38;6;32;.842;2724000;0
19092;2751;4961;0;0;0;0;.00nan;0;0
19092;-1;4961;72;40;4;36;.900;3600000;0
19092;32819;1430;32;27;6;21;.778;3593000;0
19092;54860;1430;0;0;0;0;.00nan;0;0
19093;10214;1429;0;0;0;0;.00nan;0;0
19093;46781;1422;40;32;5;27;.844;3600000;0
19093;68961;1422;0;0;0;0;.00nan;0;0
19093;160027;1429;68;20;1;19;.950;3600000;0
19094;5923;4742;62;27;3;24;.889;3600000;0
19094;165030;1453;48;29;4;25;.862;3541000;0
19094;28989;1453;0;0;0;0;.00nan;0;0
19094;36946;4742;0;0;0;0;.00nan;0;0
19095;2691;1427;79;28;1;27;.964;3600000;0
19095;9524;1425;62;9;0;9;1.000;688000;0
19095;62884;1425;25;23;6;17;.739;2912000;0
19095;161180;1427;0;0;0;0;.00nan;0;0
19096;2691;1427;0;0;0;0;.00nan;0;0
19096;4379;1426;0;0;0;0;.00nan;0;0
19096;149981;1426;98;49;3;46;.939;3894000;0
19096;161180;1427;59;27;4;23;.852;3894000;0
19097;2751;4961;97;41;2;39;.951;3600000;0
19097;165030;1453;62;29;3;26;.897;3584000;0
19097;-1;4961;0;0;0;0;.00nan;0;0
19097;28989;1453;0;0;0;0;.00nan;0;0
19098;4127;1440;53;22;3;19;.864;3600000;0
19098;5923;4742;0;0;0;0;.00nan;0;0
19098;28148;1440;0;0;0;0;.00nan;0;0
19098;36946;4742;53;35;4;31;.886;3600000;0
19099;1756;1443;0;0;0;0;.00nan;0;0
19099;165150;1443;80;11;0;11;1.000;3600000;0
19099;46781;1422;51;58;7;51;.879;3600000;0
19099;68961;1422;0;0;0;0;.00nan;0;0
19100;9524;1425;49;40;6;34;.850;3600000;0
19100;32819;1430;0;0;0;0;.00nan;0;0
19100;54860;1430;29;19;5;14;.737;3600000;0
19100;62884;1425;0;0;0;0;.00nan;0;0
19101;1756;1443;58;11;1;10;.909;3600000;0
19101;10214;1429;0;0;0;0;.00nan;0;0
19101;165150;1443;0;0;0;0;.00nan;0;0
19101;160027;1429;88;59;5;54;.915;3600000;0
19102;2751;4961;0;0;0;0;.00nan;0;0
19102;5923;4742;80;44;3;41;.932;3577000;0
19102;-1;4961;62;19;2;17;.895;3600000;0
19102;36946;4742;0;0;0;0;.00nan;0;0
19103;9524;1425;0;0;0;0;.00nan;0;0
19103;32819;1430;53;25;4;21;.840;3600000;0
19103;54860;1430;0;0;0;0;.00nan;0;0
19103;62884;1425;20;32;7;25;.781;3600000;0
19104;4127;1440;0;0;0;0;.00nan;0;0
19104;165030;1453;42;26;5;21;.808;3558000;0
19104;28148;1440;60;34;4;30;.882;3600000;0
19104;28989;1453;0;0;0;0;.00nan;0;0
19105;2691;1427;0;0;0;0;.00nan;0;0
19105;4379;1426;0;0;0;0;.00nan;0;0
19105;149981;1426;34;18;4;14;.778;3600000;0
19105;161180;1427;100;47;1;46;.979;3600000;0
19106;1756;1443;0;0;0;0;.00nan;0;0
19106;4379;1426;97;67;4;63;.940;3600000;0
19106;165150;1443;56;13;1;12;.923;3600000;0
19106;149981;1426;0;0;0;0;.00nan;0;0
19107;2691;1427;24;7;3;4;.571;446000;0
19107;4127;1440;51;17;2;15;.882;3600000;0
19107;28148;1440;0;0;0;0;.00nan;0;0
19107;161180;1427;75;38;3;35;.921;3154000;0
19108;2751;4961;0;0;0;0;.00nan;0;0
19108;-1;4961;26;34;7;27;.794;3581000;0
19108;46781;1422;33;16;4;12;.750;993000;0
19108;68961;1422;58;19;2;17;.895;2607000;0
19109;5923;4742;0;0;0;0;.00nan;0;0
19109;165030;1453;32;22;5;17;.773;3600000;0
19109;28989;1453;0;0;0;0;.00nan;0;0
19109;36946;4742;86;45;3;42;.933;3600000;0
19110;9524;1425;65;16;1;15;.938;2541000;0
19110;10214;1429;0;0;0;0;.00nan;0;0
19110;62884;1425;29;15;4;11;.733;1059000;0
19110;160027;1429;32;29;6;23;.793;3600000;0
19111;2751;4961;0;0;0;0;.00nan;0;0
19111;4127;1440;0;0;0;0;.00nan;0;0
19111;-1;4961;60;31;4;27;.871;3600000;0
19111;28148;1440;53;27;3;24;.889;3600000;0
19112;4379;1426;0;0;0;0;.00nan;0;0
19112;32819;1430;60;36;4;32;.889;3600000;0
19112;54860;1430;0;0;0;0;.00nan;0;0
19112;149981;1426;61;38;5;33;.868;3571000;0
19113;165030;1453;61;24;2;22;.917;3600000;0
19113;28989;1453;0;0;0;0;.00nan;0;0
19113;46781;1422;52;22;3;19;.864;3564000;0
19113;68961;1422;0;0;0;0;.00nan;0;0
19114;1756;1443;92;26;1;25;.962;3600000;0
19114;2691;1427;0;0;0;0;.00nan;0;0
19114;165150;1443;0;0;0;0;.00nan;0;0
19114;161180;1427;90;44;3;41;.932;3562000;0
19115;5923;4742;47;30;5;25;.833;3600000;0
19115;9524;1425;0;0;0;0;.00nan;0;0
19115;36946;4742;0;0;0;0;.00nan;0;0
19115;62884;1425;86;16;1;15;.938;3600000;0
19116;4379;1426;77;39;4;35;.897;3572000;0
19116;32819;1430;0;0;0;0;.00nan;0;0
19116;54860;1430;47;22;3;19;.864;3600000;0
19116;149981;1426;0;0;0;0;.00nan;0;0
19117;2751;4961;0;0;0;0;.00nan;0;0
19117;4127;1440;49;37;5;32;.865;3600000;0
19117;-1;4961;68;29;2;27;.931;3600000;0
19117;28148;1440;0;0;0;0;.00nan;0;0
19118;165030;1453;61;33;4;29;.879;3581000;0
19118;28989;1453;0;0;0;0;.00nan;0;0
19118;46781;1422;74;32;3;29;.906;3600000;0
19118;68961;1422;0;0;0;0;.00nan;0;0
19119;1756;1443;0;0;0;0;.00nan;0;0
19119;5923;4742;76;61;6;55;.902;2715000;0
19119;165150;1443;46;3;1;2;.667;3600000;0
19119;36946;4742;38;19;4;15;.789;885000;0
19120;9524;1425;0;0;0;0;.00nan;0;0
19120;10214;1429;43;33;5;28;.848;3600000;0
19120;62884;1425;45;20;4;16;.800;3600000;0
19120;160027;1429;0;0;0;0;.00nan;0;0
19121;4379;1426;0;0;0;0;.00nan;0;0
19121;5923;4742;82;30;2;28;.933;3600000;0
19121;36946;4742;0;0;0;0;.00nan;0;0
19121;149981;1426;57;20;3;17;.850;3559000;0
19122;1756;1443;57;17;2;15;.882;3600000;0
19122;2751;4961;50;28;4;24;.857;1374000;0
19122;165150;1443;0;0;0;0;.00nan;0;0
19122;-1;4961;54;44;6;38;.864;2226000;0
19123;4127;1440;0;0;0;0;.00nan;0;0
19123;28148;1440;67;31;3;28;.903;3579000;0
19123;32819;1430;63;25;2;23;.920;3600000;0
19123;54860;1430;0;0;0;0;.00nan;0;0
19124;9524;1425;0;0;0;0;.00nan;0;0
19124;46781;1422;23;6;3;3;.500;259000;0
19124;62884;1425;67;28;2;26;.929;3600000;0
19124;68961;1422;93;35;1;34;.971;3329000;0
19125;4379;1426;60;43;5;38;.884;3515000;0
19125;165030;1453;85;40;3;37;.925;3600000;0
19125;28989;1453;0;0;0;0;.00nan;0;0
19125;149981;1426;0;0;0;0;.00nan;0;0
19126;2691;1427;0;0;0;0;.00nan;0;0
19126;10214;1429;0;0;0;0;.00nan;0;0
19126;160027;1429;49;38;6;32;.842;3600000;0
19126;161180;1427;84;33;2;31;.939;3600000;0
19127;2691;1427;0;0;0;0;.00nan;0;0
19127;2751;4961;0;0;0;0;.00nan;0;0
19127;-1;4961;89;31;1;30;.968;3600000;0
19127;161180;1427;57;33;4;29;.879;3600000;0
19128;4127;1440;0;0;0;0;.00nan;0;0
19128;4379;1426;0;0;0;0;.00nan;0;0
19128;28148;1440;41;29;5;24;.828;3572000;0
19128;149981;1426;57;27;4;23;.852;3600000;0
19129;5923;4742;0;0;0;0;.00nan;0;0
19129;36946;4742;100;32;1;31;.969;3600000;0
19129;46781;1422;49;31;5;26;.839;3600000;0
19129;68961;1422;0;0;0;0;.00nan;0;0
19130;10214;1429;0;0;0;0;.00nan;0;0
19130;32819;1430;0;0;0;0;.00nan;0;0
19130;54860;1430;84;34;3;31;.912;3817000;0
19130;160027;1429;79;32;2;30;.938;3794000;0
19131;9524;1425;86;44;4;40;.909;3898000;0
19131;165030;1453;60;37;4;33;.892;3900000;0
19131;28989;1453;0;0;0;0;.00nan;0;0
19131;62884;1425;0;0;0;0;.00nan;0;0
19132;1756;1443;37;16;3;13;.813;3600000;0
19132;2691;1427;54;38;5;33;.868;2536000;0
19132;165150;1443;0;0;0;0;.00nan;0;0
19132;161180;1427;26;12;4;8;.667;1064000;0
19133;2751;4961;76;21;1;20;.952;2946000;0
19133;-1;4961;29;14;4;10;.714;654000;0
19133;46781;1422;76;33;4;29;.879;3600000;0
19133;68961;1422;0;0;0;0;.00nan;0;0
19134;4379;1426;0;0;0;0;.00nan;0;0
19134;5923;4742;70;43;4;39;.907;3600000;0
19134;36946;4742;0;0;0;0;.00nan;0;0
19134;149981;1426;75;22;1;21;.955;3600000;0
19135;4127;1440;0;0;0;0;.00nan;0;0
19135;10214;1429;0;0;0;0;.00nan;0;0
19135;28148;1440;62;30;5;25;.833;3553000;0
19135;160027;1429;77;36;4;32;.889;3600000;0
19136;9524;1425;0;0;0;0;.00nan;0;0
19136;165030;1453;80;24;1;23;.958;3600000;0
19136;28989;1453;0;0;0;0;.00nan;0;0
19136;62884;1425;77;31;2;29;.935;3552000;0
19137;2691;1427;0;0;0;0;.00nan;0;0
19137;32819;1430;68;24;2;22;.917;3600000;0
19137;54860;1430;0;0;0;0;.00nan;0;0
19137;161180;1427;71;39;4;35;.897;3536000;0
19138;4379;1426;62;40;5;35;.875;3600000;0
19138;165030;1453;48;19;3;16;.842;3600000;0
19138;28989;1453;0;0;0;0;.00nan;0;0
19138;149981;1426;0;0;0;0;.00nan;0;0
19139;4127;1440;74;38;3;35;.921;3600000;0
19139;10214;1429;0;0;0;0;.00nan;0;0
19139;28148;1440;0;0;0;0;.00nan;0;0
19139;160027;1429;100;23;0;23;1.000;3600000;0
19140;1756;1443;0;0;0;0;.00nan;0;0
19140;165150;1443;55;11;1;10;.909;3600000;0
19140;32819;1430;20;17;5;12;.706;1440000;0
19140;54860;1430;30;33;6;27;.818;2160000;0
19141;5923;4742;0;0;0;0;.00nan;0;0
19141;36946;4742;62;34;4;30;.882;3600000;0
19141;46781;1422;0;0;0;0;.00nan;0;0
19141;68961;1422;49;18;3;15;.833;3600000;0
19142;2751;4961;0;0;0;0;.00nan;0;0
19142;9524;1425;0;0;0;0;.00nan;0;0
19142;-1;4961;96;38;2;36;.947;3600000;0
19142;62884;1425;31;22;5;17;.773;3600000;0
19143;4127;1440;0;0;0;0;.00nan;0;0
19143;165030;1453;55;25;3;22;.880;3600000;0
19143;28148;1440;34;31;6;25;.806;3600000;0
19143;28989;1453;0;0;0;0;.00nan;0;0
19144;4379;1426;78;22;1;21;.955;3600000;0
19144;46781;1422;45;41;5;36;.878;3600000;0
19144;68961;1422;0;0;0;0;.00nan;0;0
19144;149981;1426;0;0;0;0;.00nan;0;0
19145;1756;1443;60;21;2;19;.905;3600000;0
19145;9524;1425;0;0;0;0;.00nan;0;0
19145;165150;1443;0;0;0;0;.00nan;0;0
19145;62884;1425;83;39;3;36;.923;3577000;0
19146;10214;1429;0;0;0;0;.00nan;0;0
19146;32819;1430;83;39;2;37;.949;3758000;0
19146;54860;1430;0;0;0;0;.00nan;0;0
19146;160027;1429;78;33;3;30;.909;3778000;0
19147;2751;4961;0;0;0;0;.00nan;0;0
19147;165030;1453;0;0;0;0;.00nan;0;0
19147;-1;4961;54;22;3;19;.864;3673000;0
19147;28989;1453;41;24;4;20;.833;3673000;0
19148;2691;1427;69;34;3;31;.912;3600000;0
19148;5923;4742;48;28;4;24;.857;3587000;0
19148;36946;4742;0;0;0;0;.00nan;0;0
19148;161180;1427;0;0;0;0;.00nan;0;0
19149;2751;4961;69;30;3;27;.900;3900000;0
19149;4127;1440;0;0;0;0;.00nan;0;0
19149;-1;4961;0;0;0;0;.00nan;0;0
19149;28148;1440;76;34;3;31;.912;3885000;0
19150;2691;1427;0;0;0;0;.00nan;0;0
19150;46781;1422;86;26;1;25;.962;3864000;0
19150;68961;1422;0;0;0;0;.00nan;0;0
19150;161180;1427;86;31;2;29;.935;3864000;0
19151;5923;4742;54;4;0;4;1.000;739000;0
19151;32819;1430;0;0;0;0;.00nan;0;0
19151;36946;4742;47;34;6;28;.824;2861000;0
19151;54860;1430;72;30;2;28;.933;3600000;0
19152;4379;1426;0;0;0;0;.00nan;0;0
19152;10214;1429;48;0;0;0;.00nan;271000;0
19152;149981;1426;91;31;1;30;.968;3600000;0
19152;160027;1429;26;32;7;25;.781;3329000;0
19153;1756;1443;0;0;0;0;.00nan;0;0
19153;9524;1425;49;9;1;8;.889;1095000;0
19153;165150;1443;63;22;2;20;.909;3600000;0
19153;62884;1425;43;43;7;36;.837;2505000;0
19155;4127;1440;0;0;0;0;.00nan;0;0
19155;28148;1440;41;29;5;24;.828;3600000;0
19155;32819;1430;0;0;0;0;.00nan;0;0
19155;54860;1430;67;35;4;31;.886;3600000;0
19157;2751;4961;0;0;0;0;.00nan;0;0
19157;10214;1429;0;0;0;0;.00nan;0;0
19157;-1;4961;58;42;5;37;.881;3600000;0
19157;160027;1429;79;27;1;26;.963;3600000;0
19159;1765;1425;0;0;0;0;.00nan;0;0
19159;9524;1425;75;35;2;33;.943;3577000;0
19159;165030;1453;98;32;1;31;.969;3600000;0
19159;28989;1453;0;0;0;0;.00nan;0;0
19161;4379;1426;56;28;4;24;.857;3548000;0
19161;46781;1422;82;30;2;28;.933;3600000;0
19161;68961;1422;0;0;0;0;.00nan;0;0
19161;149981;1426;0;0;0;0;.00nan;0;0
19163;2691;1427;0;0;0;0;.00nan;0;0
19163;5923;4742;49;26;5;21;.808;3517000;0
19163;36946;4742;0;0;0;0;.00nan;0;0
19163;161180;1427;44;17;3;14;.824;3600000;0
19165;10214;1429;0;0;0;0;.00nan;0;0
19165;32819;1430;0;0;0;0;.00nan;0;0
19165;54860;1430;47;33;5;28;.848;3563000;0
19165;160027;1429;51;25;4;21;.840;3600000;0
19167;1765;1425;53;2;0;2;1.000;271000;0
19167;9524;1425;39;37;6;31;.838;3329000;0
19167;165030;1453;97;36;2;34;.944;3600000;0
19167;28989;1453;0;0;0;0;.00nan;0;0
19169;1756;1443;87;10;0;10;1.000;3600000;0
19169;165150;1443;0;0;0;0;.00nan;0;0
19169;46781;1422;61;46;5;41;.891;3600000;0
19169;68961;1422;0;0;0;0;.00nan;0;0
19171;2751;4961;0;0;0;0;.00nan;0;0
19171;4127;1440;0;0;0;0;.00nan;0;0
19171;-1;4961;64;26;2;24;.923;3600000;0
19171;28148;1440;61;24;3;21;.875;3546000;0
19173;2691;1427;58;30;3;27;.900;3600000;0
19173;5923;4742;61;30;4;26;.867;3559000;0
19173;36946;4742;0;0;0;0;.00nan;0;0
19173;161180;1427;0;0;0;0;.00nan;0;0
19175;2751;4961;99;37;1;36;.973;3600000;0
19175;5923;4742;0;0;0;0;.00nan;0;0
19175;-1;4961;0;0;0;0;.00nan;0;0
19175;36946;4742;32;30;6;24;.800;3600000;0
19177;4379;1426;65;23;2;21;.913;3900000;0
19177;165030;1453;71;28;2;26;.929;3900000;0
19177;28989;1453;0;0;0;0;.00nan;0;0
19177;149981;1426;0;0;0;0;.00nan;0;0
19179;1756;1443;51;9;1;8;.889;3600000;0
19179;4127;1440;87;49;4;45;.918;3600000;0
19179;165150;1443;0;0;0;0;.00nan;0;0
19179;28148;1440;0;0;0;0;.00nan;0;0
19181;2691;1427;0;0;0;0;.00nan;0;0
19181;32819;1430;44;31;5;26;.839;3588000;0
19181;54860;1430;0;0;0;0;.00nan;0;0
19181;161180;1427;71;34;3;31;.912;3600000;0
19183;1765;1425;60;46;5;41;.891;3600000;0
19183;9524;1425;0;0;0;0;.00nan;0;0
19183;10214;1429;27;27;6;21;.778;3596000;0
19183;160027;1429;0;0;0;0;.00nan;0;0
19185;2691;1427;50;34;4;30;.882;3900000;0
19185;165030;1453;60;29;4;25;.862;3900000;0
19185;28989;1453;0;0;0;0;.00nan;0;0
19185;161180;1427;0;0;0;0;.00nan;0;0
19187;1756;1443;50;21;3;18;.857;3600000;0
19187;165150;1443;0;0;0;0;.00nan;0;0
19187;46781;1422;67;46;5;41;.891;3585000;0
19187;68961;1422;0;0;0;0;.00nan;0;0
19189;4127;1440;0;0;0;0;.00nan;0;0
19189;10214;1429;0;0;0;0;.00nan;0;0
19189;28148;1440;99;48;2;46;.958;3600000;0
19189;160027;1429;53;23;3;20;.870;3600000;0
19191;2751;4961;0;0;0;0;.00nan;0;0
19191;4379;1426;0;0;0;0;.00nan;0;0
19191;-1;4961;48;46;6;40;.870;3600000;0
19191;149981;1426;45;23;4;19;.826;3600000;0
19193;1765;1425;81;29;2;27;.931;3600000;0
19193;5923;4742;37;23;5;18;.783;3600000;0
19193;9524;1425;0;0;0;0;.00nan;0;0
19193;36946;4742;0;0;0;0;.00nan;0;0
19195;1756;1443;0;0;0;0;.00nan;0;0
19195;1765;1425;0;0;0;0;.00nan;0;0
19195;9524;1425;61;57;8;49;.860;3600000;0
19195;165150;1443;53;7;1;6;.857;3600000;0
19197;2691;1427;0;0;0;0;.00nan;0;0
19197;2751;4961;80;24;1;23;.958;3600000;0
19197;-1;4961;0;0;0;0;.00nan;0;0
19197;161180;1427;64;38;4;34;.895;3600000;0
19199;4127;1440;82;40;3;37;.925;3900000;0
19199;5923;4742;0;0;0;0;.00nan;0;0
19199;28148;1440;0;0;0;0;.00nan;0;0
19199;36946;4742;69;35;3;32;.914;3900000;0
19201;165030;1453;0;0;0;0;.00nan;0;0
19201;28989;1453;74;53;5;48;.906;3556000;0
19201;32819;1430;0;0;0;0;.00nan;0;0
19201;54860;1430;55;26;3;23;.885;3600000;0
19203;4379;1426;95;31;1;30;.968;3600000;0
19203;10214;1429;73;43;4;39;.907;3600000;0
19203;149981;1426;0;0;0;0;.00nan;0;0
19203;160027;1429;0;0;0;0;.00nan;0;0
19205;1756;1443;0;0;0;0;.00nan;0;0
19205;4127;1440;72;34;3;31;.912;2508000;0
19205;165150;1443;70;7;0;7;1.000;3600000;0
19205;28148;1440;27;13;4;9;.692;1092000;0
19207;2751;4961;0;0;0;0;.00nan;0;0
19207;4379;1426;0;0;0;0;.00nan;0;0
19207;-1;4961;96;55;3;52;.945;3585000;0
19207;149981;1426;72;21;2;19;.905;3600000;0
19209;1765;1425;0;0;0;0;.00nan;0;0
19209;5923;4742;46;25;4;21;.840;3600000;0
19209;9524;1425;62;16;1;15;.938;3600000;0
19209;36946;4742;0;0;0;0;.00nan;0;0
19211;2691;1427;0;0;0;0;.00nan;0;0
19211;32819;1430;0;0;0;0;.00nan;0;0
19211;54860;1430;82;16;0;16;1.000;3600000;0
19211;161180;1427;86;50;5;45;.900;3600000;0
19213;10214;1429;86;27;0;27;1.000;2933000;0
19213;165030;1453;72;42;4;38;.905;3900000;0
19213;28989;1453;0;0;0;0;.00nan;0;0
19213;160027;1429;25;15;4;11;.733;967000;0
19215;4127;1440;0;0;0;0;.00nan;0;0
19215;28148;1440;46;33;5;28;.848;3600000;0
19215;32819;1430;0;0;0;0;.00nan;0;0
19215;54860;1430;69;5;0;5;1.000;3600000;0
19217;1765;1425;100;27;0;27;1.000;3600000;0
19217;5923;4742;0;0;0;0;.00nan;0;0
19217;9524;1425;0;0;0;0;.00nan;0;0
19217;36946;4742;65;26;2;24;.923;3513000;0
19219;1756;1443;0;0;0;0;.00nan;0;0
19219;2751;4961;92;71;6;65;.915;3600000;0
19219;165150;1443;67;5;0;5;1.000;3600000;0
19219;-1;4961;0;0;0;0;.00nan;0;0
19221;4379;1426;76;35;3;32;.914;3600000;0
19221;10214;1429;0;0;0;0;.00nan;0;0
19221;149981;1426;0;0;0;0;.00nan;0;0
19221;160027;1429;39;42;7;35;.833;3600000;0
19223;165030;1453;91;38;2;36;.947;3600000;0
19223;28989;1453;0;0;0;0;.00nan;0;0
19223;46781;1422;36;26;5;21;.808;3600000;0
19223;68961;1422;0;0;0;0;.00nan;0;0
1923;1756;1443;49;13;2;11;.846;3600000;0
1923;4127;1440;0;0;0;0;.00nan;0;0
1923;165150;1443;0;0;0;0;.00nan;0;0
1923;28148;1440;84;48;3;45;.938;3600000;0
1924;4379;1426;58;27;3;24;.889;2867000;0
1924;32819;1430;49;37;6;31;.838;3600000;0
1924;54860;1430;0;0;0;0;.00nan;0;0
1924;149981;1426;12;11;5;6;.545;733000;0
1925;2751;4961;0;0;0;0;.00nan;0;0
1925;9524;1425;0;0;0;0;.00nan;0;0
1925;-1;4961;49;21;3;18;.857;3701000;0
1925;62884;1425;61;21;2;19;.905;3701000;0
1926;165030;1453;88;37;3;34;.919;3525000;0
1926;28989;1453;0;0;0;0;.00nan;0;0
1926;46781;1422;99;34;1;33;.971;3600000;0
1926;68961;1422;0;0;0;0;.00nan;0;0
1973;1756;1443;59;19;2;17;.895;3600000;0
1973;165150;1443;0;0;0;0;.00nan;0;0
1973;46781;1422;34;50;9;41;.820;3242000;0
1973;68961;1422;50;8;1;7;.875;358000;0
1974;9524;1425;52;3;0;3;1.000;491000;0
1974;32819;1430;0;0;0;0;.00nan;0;0
1974;54860;1430;91;36;2;34;.944;3600000;0
1974;62884;1425;33;30;6;24;.800;3109000;0
2021;1756;1443;66;15;1;14;.933;3600000;0
2021;165150;1443;0;0;0;0;.00nan;0;0
2021;32819;1430;0;0;0;0;.00nan;0;0
2021;54860;1430;61;54;7;47;.870;3600000;0
