Game Id;PlayerId;TeamId;Game Rating;SA;GA;SV;SV%;TOI;PIM
24528;174718;12;0;0;0;0;.00nan;0;0
24528;85798;12;89;31;1;30;.968;3600000;0
24528;149452;31;0;0;0;0;.00nan;0;0
24528;152717;31;73;34;3;31;.912;3514000;0
24529;170314;25;47;28;4;24;.857;3858000;0
24529;175084;22;0;0;0;0;.00nan;0;0
24529;184770;22;55;39;5;34;.872;3858000;0
24529;191813;25;0;0;0;0;.00nan;0;0
24530;170977;30;0;0;0;0;.00nan;0;0
24530;179452;27;0;0;0;0;.00nan;0;0
24530;175660;27;77;38;2;36;.947;3572000;0
24530;86697;30;64;14;1;13;.929;3600000;0
24531;320;21;0;0;0;0;.00nan;0;0
24531;3284;21;98;25;0;25;1.000;3600000;0
24531;194416;17;0;0;0;0;.00nan;0;0
24531;178413;17;92;43;3;40;.930;3600000;0
24532;166646;0;0;0;0;0;.00nan;0;0
24532;59540;0;94;44;2;42;.955;3861000;0
24532;139409;3;65;31;3;28;.903;3861000;0
24532;148958;3;0;0;0;0;.00nan;0;0
24533;170314;25;0;0;0;0;.00nan;0;0
24533;175092;9;0;0;0;0;.00nan;0;0
24533;190106;9;43;36;6;30;.833;3600000;0
24533;191813;25;100;30;0;30;1.000;3600000;0
24534;183859;23;0;0;0;0;.00nan;0;0
24534;184229;35;0;0;0;0;.00nan;0;0
24534;57338;35;85;23;1;22;.957;3763000;0
24534;78573;23;73;25;2;23;.920;3763000;0
24535;167642;18;0;0;0;0;.00nan;0;0
24535;13714;8;0;0;0;0;.00nan;0;0
24535;173727;18;70;22;1;21;.955;4086000;0
24535;58830;8;93;55;2;53;.964;4086000;0
24536;197940;11;82;31;1;30;.968;3600000;0
24536;187537;19;51;27;4;23;.852;3600000;0
24536;178384;19;0;0;0;0;.00nan;0;0
24536;45323;11;0;0;0;0;.00nan;0;0
24537;175912;14;0;0;0;0;.00nan;0;0
24537;185034;14;65;23;2;21;.913;3600000;0
24537;77955;28;0;0;0;0;.00nan;0;0
24537;85437;28;50;45;6;39;.867;3600000;0
24538;166591;20;0;0;0;0;.00nan;0;0
24538;187578;10;57;30;3;27;.900;3596000;0
24538;183783;20;96;39;1;38;.974;3600000;0
24538;90164;10;0;0;0;0;.00nan;0;0
24539;168872;24;0;0;0;0;.00nan;0;0
24539;-1;5;0;0;0;0;.00nan;0;0
24539;61425;5;56;23;2;21;.913;3600000;0
24539;85727;24;62;36;4;32;.889;3556000;0
24540;165723;32;91;37;2;35;.946;3600000;0
24540;20432;32;0;0;0;0;.00nan;0;0
24540;179154;26;28;15;4;11;.733;877000;0
24540;152835;26;62;21;2;19;.905;2723000;0
24541;556;33;60;28;3;25;.893;3563000;0
24541;183844;29;0;0;0;0;.00nan;0;0
24541;173699;29;66;23;2;21;.913;3600000;0
24541;197038;33;0;0;0;0;.00nan;0;0
24542;170977;30;0;0;0;0;.00nan;0;0
24542;174718;12;0;0;0;0;.00nan;0;0
24542;85798;12;68;30;2;28;.933;3573000;0
24542;86697;30;97;24;0;24;1.000;3600000;0
24543;162029;4182;0;0;0;0;.00nan;0;0
24543;172340;4182;63;44;6;38;.864;3600000;0
24543;179452;27;0;0;0;0;.00nan;0;0
24543;175660;27;73;21;1;20;.952;3600000;0
24544;168872;24;0;0;0;0;.00nan;0;0
24544;186573;16;39;1;1;0;.000;1081000;0
24544;50065;16;19;22;6;16;.727;2519000;0
24544;85727;24;60;35;4;31;.886;3600000;0
24545;3928;15;72;46;4;42;.913;3600000;0
24545;163195;15;0;0;0;0;.00nan;0;0
24545;175084;22;41;32;6;26;.813;3514000;0
24545;184770;22;0;0;0;0;.00nan;0;0
24546;187578;10;66;35;4;31;.886;3600000;0
24546;194416;17;0;0;0;0;.00nan;0;0
24546;178413;17;71;22;1;21;.955;3600000;0
24546;90164;10;0;0;0;0;.00nan;0;0
24547;183844;29;0;0;0;0;.00nan;0;0
24547;173699;29;79;44;4;40;.909;3514000;0
24547;184229;35;0;0;0;0;.00nan;0;0
24547;57338;35;74;31;2;29;.935;3600000;0
24548;174718;12;0;0;0;0;.00nan;0;0
24548;175092;9;0;0;0;0;.00nan;0;0
24548;190106;9;88;31;1;30;.968;3600000;0
24548;85798;12;57;21;2;19;.905;3600000;0
24549;166591;20;36;33;6;27;.818;3563000;0
24549;183783;20;0;0;0;0;.00nan;0;0
24549;175912;14;0;0;0;0;.00nan;0;0
24549;185034;14;57;28;4;24;.857;3600000;0
24550;-1;5;0;0;0;0;.00nan;0;0
24550;61425;5;58;23;3;20;.870;3600000;0
24550;149452;31;81;42;4;38;.905;3575000;0
24550;152717;31;0;0;0;0;.00nan;0;0
24551;170314;25;0;0;0;0;.00nan;0;0
24551;191813;25;53;16;2;14;.875;3600000;0
24551;139409;3;69;38;3;35;.921;3572000;0
24551;148958;3;0;0;0;0;.00nan;0;0
24552;183859;23;0;0;0;0;.00nan;0;0
24552;175084;22;66;24;2;22;.917;3576000;0
24552;184770;22;0;0;0;0;.00nan;0;0
24552;78573;23;99;35;1;34;.971;3600000;0
24553;556;33;45;24;4;20;.833;3553000;0
24553;166646;0;0;0;0;0;.00nan;0;0
24553;197038;33;0;0;0;0;.00nan;0;0
24553;59540;0;73;23;2;21;.913;3600000;0
24554;183904;34;0;0;0;0;.00nan;0;0
24554;77955;28;0;0;0;0;.00nan;0;0
24554;78806;34;70;20;1;19;.950;3600000;0
24554;85437;28;86;40;3;37;.925;3516000;0
24555;170977;30;0;0;0;0;.00nan;0;0
24555;179154;26;80;29;2;27;.931;4200000;0
24555;86697;30;64;24;2;22;.917;4200000;0
24555;152835;26;0;0;0;0;.00nan;0;0
24556;197940;11;58;39;5;34;.872;3564000;0
24556;187537;19;0;0;0;0;.00nan;0;0
24556;178384;19;45;28;4;24;.857;3600000;0
24556;45323;11;0;0;0;0;.00nan;0;0
24557;162029;4182;0;0;0;0;.00nan;0;0
24557;172340;4182;81;41;3;38;.927;3600000;0
24557;13714;8;100;29;0;29;1.000;3600000;0
24557;58830;8;0;0;0;0;.00nan;0;0
24558;179452;27;0;0;0;0;.00nan;0;0
24558;175660;27;92;21;0;21;1.000;3600000;0
24558;196090;4838;67;28;2;26;.929;3560000;0
24558;185743;4838;0;0;0;0;.00nan;0;0
24559;320;21;0;0;0;0;.00nan;0;0
24559;3284;21;54;28;4;24;.857;3569000;0
24559;167642;18;0;0;0;0;.00nan;0;0
24559;173727;18;87;35;2;33;.943;3600000;0
24560;194416;17;97;19;0;19;1.000;3600000;0
24560;178413;17;0;0;0;0;.00nan;0;0
24560;149452;31;0;0;0;0;.00nan;0;0
24560;152717;31;80;45;4;41;.911;3600000;0
24561;320;21;44;30;5;25;.833;3600000;0
24561;3284;21;0;0;0;0;.00nan;0;0
24561;196090;4838;0;0;0;0;.00nan;0;0
24561;185743;4838;71;19;1;18;.947;3600000;0
24562;166591;20;45;23;4;19;.826;3513000;0
24562;183783;20;0;0;0;0;.00nan;0;0
24562;-1;5;0;0;0;0;.00nan;0;0
24562;61425;5;80;37;2;35;.946;3600000;0
24563;183844;29;0;0;0;0;.00nan;0;0
24563;168872;24;0;0;0;0;.00nan;0;0
24563;173699;29;60;37;4;33;.892;3600000;0
24563;85727;24;51;22;3;19;.864;3600000;0
24564;175912;14;45;32;5;27;.844;4200000;0
24564;185034;14;0;0;0;0;.00nan;0;0
24564;186573;16;0;0;0;0;.00nan;0;0
24564;50065;16;53;35;5;30;.857;4200000;0
24565;166646;0;0;0;0;0;.00nan;0;0
24565;170314;25;0;0;0;0;.00nan;0;0
24565;191813;25;89;26;1;25;.962;3600000;0
24565;59540;0;62;33;3;30;.909;3530000;0
24566;3928;15;0;0;0;0;.00nan;0;0
24566;163195;15;59;20;2;18;.900;3600000;0
24566;183859;23;0;0;0;0;.00nan;0;0
24566;78573;23;65;32;3;29;.906;3575000;0
24567;77955;28;0;0;0;0;.00nan;0;0
24567;85437;28;82;28;1;27;.964;3600000;0
24567;149452;31;0;0;0;0;.00nan;0;0
24567;152717;31;44;29;5;24;.828;3600000;0
24568;556;33;79;41;4;37;.902;3600000;0
24568;197038;33;0;0;0;0;.00nan;0;0
24568;139409;3;0;0;0;0;.00nan;0;0
24568;148958;3;80;23;1;22;.957;3600000;0
24569;197940;11;96;43;1;42;.977;3554000;0
24569;187578;10;0;0;0;0;.00nan;0;0
24569;45323;11;0;0;0;0;.00nan;0;0
24569;90164;10;100;32;0;32;1.000;3600000;0
24570;183904;34;83;35;3;32;.914;3574000;0
24570;186573;16;71;19;1;18;.947;3600000;0
24570;50065;16;0;0;0;0;.00nan;0;0
24570;78806;34;0;0;0;0;.00nan;0;0
24571;187537;19;41;9;2;7;.778;1023000;0
24571;178384;19;30;28;6;22;.786;2577000;0
24571;174718;12;0;0;0;0;.00nan;0;0
24571;85798;12;77;35;3;32;.914;3600000;0
24572;167642;18;0;0;0;0;.00nan;0;0
24572;173727;18;55;17;2;15;.882;3600000;0
24572;184229;35;0;0;0;0;.00nan;0;0
24572;57338;35;54;42;5;37;.881;3600000;0
24573;13714;8;95;34;2;32;.941;3600000;0
24573;170977;30;0;0;0;0;.00nan;0;0
24573;58830;8;0;0;0;0;.00nan;0;0
24573;86697;30;35;15;4;11;.733;3556000;0
24574;320;21;0;0;0;0;.00nan;0;0
24574;162029;4182;0;0;0;0;.00nan;0;0
24574;3284;21;80;35;3;32;.914;3600000;0
24574;172340;4182;84;30;2;28;.933;3600000;0
24575;165723;32;0;0;0;0;.00nan;0;0
24575;20432;32;91;42;3;39;.929;3600000;0
24575;179452;27;0;0;0;0;.00nan;0;0
24575;175660;27;38;24;4;20;.833;3544000;0
24576;3928;15;77;23;1;22;.957;3600000;0
24576;163195;15;0;0;0;0;.00nan;0;0
24576;194416;17;0;0;0;0;.00nan;0;0
24576;178413;17;62;34;4;30;.882;3600000;0
24577;175084;22;96;19;0;19;1.000;3600000;0
24577;184770;22;0;0;0;0;.00nan;0;0
24577;-1;5;41;25;4;21;.840;3600000;0
24577;61425;5;0;0;0;0;.00nan;0;0
24578;183859;23;0;0;0;0;.00nan;0;0
24578;77955;28;0;0;0;0;.00nan;0;0
24578;78573;23;34;39;6;33;.846;4200000;0
24578;85437;28;47;45;6;39;.867;4196000;0
24579;166646;0;0;0;0;0;.00nan;0;0
24579;183844;29;0;0;0;0;.00nan;0;0
24579;173699;29;79;32;3;29;.906;3600000;0
24579;59540;0;60;31;4;27;.871;3580000;0
24580;174718;12;0;0;0;0;.00nan;0;0
24580;175912;14;0;0;0;0;.00nan;0;0
24580;185034;14;64;24;3;21;.875;4200000;0
24580;85798;12;73;46;3;43;.935;4200000;0
24581;187537;19;0;0;0;0;.00nan;0;0
24581;187578;10;81;37;2;35;.946;3562000;0
24581;178384;19;83;27;1;26;.963;3600000;0
24581;90164;10;0;0;0;0;.00nan;0;0
24582;197940;11;42;36;6;30;.833;3036000;0
24582;45323;11;53;3;0;3;1.000;564000;0
24582;149452;31;0;0;0;0;.00nan;0;0
24582;152717;31;69;29;2;27;.931;3600000;0
24583;556;33;89;52;4;48;.923;3600000;0
24583;167642;18;0;0;0;0;.00nan;0;0
24583;173727;18;90;18;0;18;1.000;3600000;0
24583;197038;33;0;0;0;0;.00nan;0;0
24584;179154;26;98;42;2;40;.952;3585000;0
24584;186573;16;0;0;0;0;.00nan;0;0
24584;50065;16;93;32;1;31;.969;3600000;0
24584;152835;26;0;0;0;0;.00nan;0;0
24585;184229;35;0;0;0;0;.00nan;0;0
24585;179452;27;0;0;0;0;.00nan;0;0
24585;175660;27;82;38;3;35;.921;3600000;0
24585;57338;35;37;26;5;21;.808;3541000;0
24586;165723;32;0;0;0;0;.00nan;0;0
24586;20432;32;88;36;2;34;.944;3600000;0
24586;196090;4838;72;14;0;14;1.000;1271000;0
24586;185743;4838;21;26;6;20;.769;2329000;0
24587;320;21;0;0;0;0;.00nan;0;0
24587;3284;21;90;37;1;36;.973;3600000;0
24587;170977;30;0;0;0;0;.00nan;0;0
24587;86697;30;81;34;2;32;.941;3582000;0
24588;13714;8;93;61;4;57;.934;3596000;0
24588;170314;25;0;0;0;0;.00nan;0;0
24588;191813;25;54;18;2;16;.889;3600000;0
24588;58830;8;0;0;0;0;.00nan;0;0
24589;162029;4182;0;0;0;0;.00nan;0;0
24589;172340;4182;57;32;4;28;.875;3523000;0
24589;175092;9;0;0;0;0;.00nan;0;0
24589;190106;9;90;36;2;34;.944;3600000;0
24590;166591;20;87;31;1;30;.968;3600000;0
24590;183783;20;0;0;0;0;.00nan;0;0
24590;183859;23;54;29;5;24;.828;3600000;0
24590;78573;23;0;0;0;0;.00nan;0;0
24591;183904;34;62;30;3;27;.900;3600000;0
24591;168872;24;0;0;0;0;.00nan;0;0
24591;78806;34;0;0;0;0;.00nan;0;0
24591;85727;24;40;20;4;16;.800;3544000;0
24592;194416;17;0;0;0;0;.00nan;0;0
24592;178413;17;86;31;2;29;.935;3600000;0
24592;-1;5;0;0;0;0;.00nan;0;0
24592;61425;5;71;41;4;37;.902;3525000;0
24593;196090;4838;0;0;0;0;.00nan;0;0
24593;185743;4838;50;23;4;19;.826;3552000;0
24593;186573;16;0;0;0;0;.00nan;0;0
24593;50065;16;64;24;2;22;.917;3600000;0
24594;183904;34;58;29;3;26;.897;4200000;0
24594;77955;28;0;0;0;0;.00nan;0;0
24594;78806;34;0;0;0;0;.00nan;0;0
24594;85437;28;67;38;3;35;.921;4200000;0
24595;197940;11;58;31;4;27;.871;3600000;0
24595;183844;29;0;0;0;0;.00nan;0;0
24595;173699;29;40;27;5;22;.815;3577000;0
24595;45323;11;0;0;0;0;.00nan;0;0
24596;3928;15;89;35;1;34;.971;3600000;0
24596;163195;15;0;0;0;0;.00nan;0;0
24596;139409;3;92;33;2;31;.939;3578000;0
24596;148958;3;0;0;0;0;.00nan;0;0
24597;166646;0;0;0;0;0;.00nan;0;0
24597;59540;0;89;29;1;28;.966;3600000;0
24597;149452;31;83;43;4;39;.907;3600000;0
24597;152717;31;0;0;0;0;.00nan;0;0
24598;170314;25;0;0;0;0;.00nan;0;0
24598;179452;27;0;0;0;0;.00nan;0;0
24598;175660;27;79;35;3;32;.914;4200000;0
24598;191813;25;64;30;3;27;.900;4200000;0
24599;187578;10;0;0;0;0;.00nan;0;0
24599;165723;32;0;0;0;0;.00nan;0;0
24599;20432;32;95;23;0;23;1.000;3600000;0
24599;90164;10;95;38;2;36;.947;3526000;0
24600;556;33;0;0;0;0;.00nan;0;0
24600;166591;20;0;0;0;0;.00nan;0;0
24600;183783;20;58;29;3;26;.897;3600000;0
24600;197038;33;100;46;0;46;1.000;3600000;0
24601;162029;4182;0;0;0;0;.00nan;0;0
24601;172340;4182;77;27;2;25;.926;4200000;0
24601;174718;12;0;0;0;0;.00nan;0;0
24601;85798;12;92;42;2;40;.952;4178000;0
24602;179154;26;70;26;3;23;.885;4060000;0
24602;175084;22;0;0;0;0;.00nan;0;0
24602;184770;22;59;33;4;29;.879;4061000;0
24602;152835;26;0;0;0;0;.00nan;0;0
24603;320;21;0;0;0;0;.00nan;0;0
24603;3284;21;66;27;3;24;.889;3600000;0
24603;13714;8;50;28;4;24;.857;3578000;0
24603;58830;8;0;0;0;0;.00nan;0;0
24604;187537;19;84;41;3;38;.927;3700000;0
24604;178384;19;0;0;0;0;.00nan;0;0
24604;184229;35;0;0;0;0;.00nan;0;0
24604;57338;35;49;26;4;22;.846;3687000;0
24605;170977;30;68;26;2;24;.923;2845000;0
24605;175912;14;0;0;0;0;.00nan;0;0
24605;185034;14;33;27;5;22;.815;3868000;0
24605;86697;30;26;16;4;12;.750;1023000;0
24606;167642;18;0;0;0;0;.00nan;0;0
24606;173727;18;100;23;0;23;1.000;3600000;0
24606;175092;9;0;0;0;0;.00nan;0;0
24606;190106;9;68;35;4;31;.886;3600000;0
24607;183859;23;0;0;0;0;.00nan;0;0
24607;-1;5;60;18;2;16;.889;3600000;0
24607;61425;5;0;0;0;0;.00nan;0;0
24607;78573;23;76;36;3;33;.917;3577000;0
24608;175092;9;91;46;3;43;.935;3574000;0
24608;190106;9;0;0;0;0;.00nan;0;0
24608;196090;4838;44;8;2;6;.750;3600000;0
24608;185743;4838;0;0;0;0;.00nan;0;0
24609;77955;28;92;30;1;29;.967;3600000;0
24609;85437;28;0;0;0;0;.00nan;0;0
24609;139409;3;61;27;3;24;.889;3525000;0
24609;148958;3;0;0;0;0;.00nan;0;0
24610;166646;0;0;0;0;0;.00nan;0;0
24610;3928;15;100;20;0;20;1.000;3600000;0
24610;163195;15;0;0;0;0;.00nan;0;0
24610;59540;0;68;45;5;40;.889;3600000;0
24611;166591;20;83;53;5;48;.906;3580000;0
24611;183783;20;0;0;0;0;.00nan;0;0
24611;196090;4838;0;0;0;0;.00nan;0;0
24611;185743;4838;49;26;4;22;.846;3600000;0
24612;194416;17;69;32;3;29;.906;3600000;0
24612;178413;17;0;0;0;0;.00nan;0;0
24612;77955;28;66;10;0;10;1.000;544000;0
24612;85437;28;47;35;6;29;.829;3056000;0
24613;320;21;0;0;0;0;.00nan;0;0
24613;3284;21;78;35;2;33;.943;3585000;0
24613;149452;31;0;0;0;0;.00nan;0;0
24613;152717;31;74;22;1;21;.955;3600000;0
24614;168872;24;0;0;0;0;.00nan;0;0
24614;85727;24;63;31;3;28;.903;3600000;0
24614;139409;3;0;0;0;0;.00nan;0;0
24614;148958;3;100;31;0;31;1.000;3600000;0
24615;165723;32;0;0;0;0;.00nan;0;0
24615;20432;32;60;35;5;30;.857;3565000;0
24615;175084;22;63;32;4;28;.875;3600000;0
24615;184770;22;0;0;0;0;.00nan;0;0
24616;162029;4182;0;0;0;0;.00nan;0;0
24616;172340;4182;89;28;2;26;.929;3600000;0
24616;183844;29;0;0;0;0;.00nan;0;0
24616;173699;29;63;44;5;39;.886;3600000;0
24617;13714;8;71;38;4;34;.895;3600000;0
24617;183904;34;0;0;0;0;.00nan;0;0
24617;58830;8;0;0;0;0;.00nan;0;0
24617;78806;34;92;26;1;25;.962;3600000;0
24618;170977;30;0;0;0;0;.00nan;0;0
24618;-1;5;0;0;0;0;.00nan;0;0
24618;61425;5;84;27;1;26;.963;3600000;0
24618;86697;30;70;26;2;24;.923;3563000;0
24619;170314;25;0;0;0;0;.00nan;0;0
24619;175092;9;0;0;0;0;.00nan;0;0
24619;190106;9;100;28;0;28;1.000;3600000;0
24619;191813;25;82;25;1;24;.960;3573000;0
24620;184229;35;0;0;0;0;.00nan;0;0
24620;179154;26;0;0;0;0;.00nan;0;0
24620;57338;35;89;37;3;34;.919;3982000;0
24620;152835;26;68;26;2;24;.923;3982000;0
24621;556;33;94;45;2;43;.956;4200000;0
24621;187537;19;0;0;0;0;.00nan;0;0
24621;178384;19;66;28;2;26;.929;4200000;0
24621;197038;33;0;0;0;0;.00nan;0;0
24622;197940;11;91;45;3;42;.933;3600000;0
24622;174718;12;0;0;0;0;.00nan;0;0
24622;45323;11;0;0;0;0;.00nan;0;0
24622;85798;12;57;30;4;26;.867;3544000;0
24623;183859;23;78;17;0;17;1.000;1668000;0
24623;175912;14;0;0;0;0;.00nan;0;0
24623;185034;14;65;17;1;16;.941;3600000;0
24623;78573;23;39;22;4;18;.818;1932000;0
24624;167642;18;0;0;0;0;.00nan;0;0
24624;173727;18;69;25;2;23;.920;3600000;0
24624;186573;16;0;0;0;0;.00nan;0;0
24624;50065;16;57;34;4;30;.882;3600000;0
24625;187578;10;87;44;2;42;.955;3525000;0
24625;179452;27;0;0;0;0;.00nan;0;0
24625;175660;27;93;26;0;26;1.000;3600000;0
24625;90164;10;0;0;0;0;.00nan;0;0
24626;3928;15;51;16;3;13;.813;3646000;0
24626;163195;15;0;0;0;0;.00nan;0;0
24626;168872;24;80;30;2;28;.933;3646000;0
24626;85727;24;0;0;0;0;.00nan;0;0
24627;175092;9;0;0;0;0;.00nan;0;0
24627;190106;9;96;41;2;39;.951;3600000;0
24627;196090;4838;0;0;0;0;.00nan;0;0
24627;185743;4838;51;26;4;22;.846;3564000;0
24628;320;21;0;0;0;0;.00nan;0;0
24628;3284;21;88;44;3;41;.932;3600000;0
24628;170977;30;0;0;0;0;.00nan;0;0
24628;86697;30;84;14;0;14;1.000;3600000;0
24629;184229;35;0;0;0;0;.00nan;0;0
24629;-1;5;0;0;0;0;.00nan;0;0
24629;57338;35;95;30;1;29;.967;3600000;0
24629;61425;5;61;28;3;25;.893;3559000;0
24630;166591;20;76;30;2;28;.933;3600000;0
24630;183783;20;0;0;0;0;.00nan;0;0
24630;139409;3;0;0;0;0;.00nan;0;0
24630;148958;3;85;26;1;25;.962;3600000;0
24631;556;33;84;41;3;38;.927;3580000;0
24631;187578;10;0;0;0;0;.00nan;0;0
24631;197038;33;0;0;0;0;.00nan;0;0
24631;90164;10;85;33;2;31;.939;3600000;0
24632;13714;8;45;37;6;31;.838;3600000;0
24632;175084;22;0;0;0;0;.00nan;0;0
24632;184770;22;54;24;3;21;.875;3600000;0
24632;58830;8;0;0;0;0;.00nan;0;0
24633;162029;4182;0;0;0;0;.00nan;0;0
24633;172340;4182;88;21;0;21;1.000;3600000;0
24633;149452;31;0;0;0;0;.00nan;0;0
24633;152717;31;75;56;6;50;.893;3600000;0
24634;194416;17;0;0;0;0;.00nan;0;0
24634;178413;17;85;36;2;34;.944;3600000;0
24634;183904;34;81;21;1;20;.952;3600000;0
24634;78806;34;0;0;0;0;.00nan;0;0
24635;166646;0;0;0;0;0;.00nan;0;0
24635;165723;32;86;20;0;20;1.000;3600000;0
24635;20432;32;0;0;0;0;.00nan;0;0
24635;59540;0;92;46;3;43;.935;3600000;0
24636;183859;23;0;0;0;0;.00nan;0;0
24636;179154;26;0;0;0;0;.00nan;0;0
24636;78573;23;38;28;5;23;.821;3600000;0
24636;152835;26;100;29;0;29;1.000;3600000;0
24637;187537;19;76;27;2;25;.926;3544000;0
24637;178384;19;0;0;0;0;.00nan;0;0
24637;175912;14;0;0;0;0;.00nan;0;0
24637;185034;14;75;24;1;23;.958;3600000;0
24638;170314;25;91;29;1;28;.966;3600000;0
24638;179452;27;0;0;0;0;.00nan;0;0
24638;175660;27;51;33;5;28;.848;3600000;0
24638;191813;25;0;0;0;0;.00nan;0;0
24639;320;21;69;41;4;37;.902;3600000;0
24639;162029;4182;0;0;0;0;.00nan;0;0
24639;3284;21;0;0;0;0;.00nan;0;0
24639;172340;4182;46;29;5;24;.828;3590000;0
24640;168872;24;0;0;0;0;.00nan;0;0
24640;77955;28;72;34;3;31;.912;3526000;0
24640;85437;28;0;0;0;0;.00nan;0;0
24640;85727;24;100;43;1;42;.977;3600000;0
24641;556;33;0;0;0;0;.00nan;0;0
24641;3928;15;0;0;0;0;.00nan;0;0
24641;163195;15;39;23;4;19;.826;3600000;0
24641;197038;33;36;56;9;47;.839;3600000;0
24642;167642;18;0;0;0;0;.00nan;0;0
24642;173727;18;89;20;0;20;1.000;3600000;0
24642;186573;16;68;35;3;32;.914;3600000;0
24642;50065;16;0;0;0;0;.00nan;0;0
24643;197940;11;54;22;3;19;.864;2500000;0
24643;179154;26;0;0;0;0;.00nan;0;0
24643;45323;11;21;12;4;8;.667;1100000;0
24643;152835;26;57;26;3;23;.885;3600000;0
24644;187578;10;65;50;6;44;.880;3344000;0
24644;196090;4838;74;35;4;31;.886;3600000;0
24644;185743;4838;0;0;0;0;.00nan;0;0
24644;90164;10;49;1;0;1;1.000;235000;0
24645;183844;29;0;0;0;0;.00nan;0;0
24645;173699;29;84;47;4;43;.915;3600000;0
24645;170977;30;0;0;0;0;.00nan;0;0
24645;86697;30;76;28;2;26;.929;3600000;0
24646;175092;9;0;0;0;0;.00nan;0;0
24646;190106;9;65;35;3;32;.914;4200000;0
24646;-1;5;0;0;0;0;.00nan;0;0
24646;61425;5;45;25;3;22;.880;4200000;0
24647;166591;20;62;20;1;19;.950;1537000;0
24647;183783;20;39;33;6;27;.818;2063000;0
24647;183904;34;0;0;0;0;.00nan;0;0
24647;78806;34;55;10;1;9;.900;3600000;0
24648;184229;35;0;0;0;0;.00nan;0;0
24648;57338;35;98;30;1;29;.967;3600000;0
24648;139409;3;52;31;4;27;.871;3600000;0
24648;148958;3;0;0;0;0;.00nan;0;0
24649;166646;0;0;0;0;0;.00nan;0;0
24649;174718;12;62;16;1;15;.938;3600000;0
24649;59540;0;55;32;4;28;.875;3600000;0
24649;85798;12;0;0;0;0;.00nan;0;0
24650;194416;17;0;0;0;0;.00nan;0;0
24650;178413;17;41;33;5;28;.848;3600000;0
24650;175084;22;57;21;2;19;.905;3600000;0
24650;184770;22;0;0;0;0;.00nan;0;0
24651;197940;11;0;0;0;0;.00nan;0;0
24651;175912;14;0;0;0;0;.00nan;0;0
24651;185034;14;37;21;4;17;.810;3580000;0
24651;45323;11;79;33;3;30;.909;3600000;0
24652;167642;18;69;25;2;23;.920;3600000;0
24652;173727;18;0;0;0;0;.00nan;0;0
24652;179452;27;24;35;7;28;.800;3600000;0
24652;175660;27;0;0;0;0;.00nan;0;0
24653;13714;8;61;18;2;16;.889;3600000;0
24653;58830;8;0;0;0;0;.00nan;0;0
24653;77955;28;0;0;0;0;.00nan;0;0
24653;85437;28;78;37;3;34;.919;3563000;0
24654;556;33;81;38;3;35;.921;4059000;0
24654;168872;24;0;0;0;0;.00nan;0;0
24654;197038;33;0;0;0;0;.00nan;0;0
24654;85727;24;66;27;2;25;.926;4059000;0
24655;162029;4182;0;0;0;0;.00nan;0;0
24655;3928;15;0;0;0;0;.00nan;0;0
24655;163195;15;67;34;4;30;.882;3600000;0
24655;172340;4182;78;36;3;33;.917;3600000;0
24656;187537;19;0;0;0;0;.00nan;0;0
24656;178384;19;51;21;3;18;.857;3600000;0
24656;183859;23;0;0;0;0;.00nan;0;0
24656;78573;23;57;35;5;30;.857;3600000;0
24657;183844;29;0;0;0;0;.00nan;0;0
24657;173699;29;68;15;1;14;.933;3596000;0
24657;175092;9;100;29;0;29;1.000;3600000;0
24657;190106;9;0;0;0;0;.00nan;0;0
24658;320;21;0;0;0;0;.00nan;0;0
24658;187578;10;0;0;0;0;.00nan;0;0
24658;3284;21;76;22;1;21;.955;3600000;0
24658;90164;10;57;40;6;34;.850;3600000;0
24659;175084;22;81;34;2;32;.941;3600000;0
24659;184770;22;0;0;0;0;.00nan;0;0
24659;196090;4838;0;0;0;0;.00nan;0;0
24659;185743;4838;58;34;4;30;.882;3600000;0
24660;170977;30;0;0;0;0;.00nan;0;0
24660;86697;30;63;22;2;20;.909;3600000;0
24660;149452;31;69;21;2;19;.905;1716000;0
24660;152717;31;50;36;5;31;.861;1884000;0
24661;183904;34;37;18;4;14;.778;3600000;0
24661;-1;5;38;32;5;27;.844;3600000;0
24661;61425;5;0;0;0;0;.00nan;0;0
24661;78806;34;0;0;0;0;.00nan;0;0
24662;184229;35;0;0;0;0;.00nan;0;0
24662;175912;14;0;0;0;0;.00nan;0;0
24662;185034;14;73;38;3;35;.921;3548000;0
24662;57338;35;87;28;1;27;.964;3600000;0
24663;166591;20;0;0;0;0;.00nan;0;0
24663;165723;32;100;22;0;22;1.000;3600000;0
24663;183783;20;60;30;3;27;.900;3600000;0
24663;20432;32;0;0;0;0;.00nan;0;0
24664;170314;25;62;23;3;20;.870;3715000;0
24664;186573;16;0;0;0;0;.00nan;0;0
24664;191813;25;0;0;0;0;.00nan;0;0
24664;50065;16;60;34;4;30;.882;3715000;0
24665;179452;27;0;0;0;0;.00nan;0;0
24665;175660;27;59;38;4;34;.895;3532000;0
24665;139409;3;73;29;2;27;.931;3600000;0
24665;148958;3;0;0;0;0;.00nan;0;0
24666;166646;0;0;0;0;0;.00nan;0;0
24666;167642;18;0;0;0;0;.00nan;0;0
24666;173727;18;66;24;3;21;.875;3600000;0
24666;59540;0;75;41;5;36;.878;3600000;0
24667;197940;11;73;41;3;38;.927;3600000;0
24667;174718;12;0;0;0;0;.00nan;0;0
24667;45323;11;0;0;0;0;.00nan;0;0
24667;85798;12;90;37;2;35;.946;3600000;0
24668;187578;10;63;27;3;24;.889;3600000;0
24668;77955;28;0;0;0;0;.00nan;0;0
24668;85437;28;55;34;5;29;.853;3579000;0
24668;90164;10;0;0;0;0;.00nan;0;0
24669;165723;32;0;0;0;0;.00nan;0;0
24669;183859;23;86;31;2;29;.935;3600000;0
24669;20432;32;63;35;4;31;.886;3566000;0
24669;78573;23;0;0;0;0;.00nan;0;0
24670;13714;8;58;33;4;29;.879;3543000;0
24670;179154;26;0;0;0;0;.00nan;0;0
24670;58830;8;0;0;0;0;.00nan;0;0
24670;152835;26;73;29;3;26;.897;3600000;0
24671;196090;4838;93;23;0;23;1.000;4125000;0
24671;185743;4838;0;0;0;0;.00nan;0;0
24671;186573;16;82;32;1;31;.969;4125000;0
24671;50065;16;0;0;0;0;.00nan;0;0
24672;166646;0;0;0;0;0;.00nan;0;0
24672;175092;9;64;32;3;29;.906;3600000;0
24672;190106;9;0;0;0;0;.00nan;0;0
24672;59540;0;66;30;4;26;.867;3546000;0
24673;166591;20;71;36;3;33;.917;3600000;0
24673;183783;20;0;0;0;0;.00nan;0;0
24673;149452;31;48;6;1;5;.833;270000;0
24673;152717;31;53;40;5;35;.875;3330000;0
24674;183844;29;0;0;0;0;.00nan;0;0
24674;173699;29;72;31;3;28;.903;3600000;0
24674;-1;5;0;0;0;0;.00nan;0;0
24674;61425;5;65;35;4;31;.886;3560000;0
24675;320;21;0;0;0;0;.00nan;0;0
24675;3284;21;62;31;4;27;.871;3600000;0
24675;175912;14;42;30;5;25;.833;3599000;0
24675;185034;14;0;0;0;0;.00nan;0;0
24676;167642;18;0;0;0;0;.00nan;0;0
24676;194416;17;89;40;2;38;.950;3565000;0
24676;178413;17;0;0;0;0;.00nan;0;0
24676;173727;18;91;31;1;30;.968;3600000;0
24677;3928;15;55;32;4;28;.875;3600000;0
24677;163195;15;0;0;0;0;.00nan;0;0
24677;183904;34;0;0;0;0;.00nan;0;0
24677;78806;34;88;36;3;33;.917;3600000;0
24678;556;33;51;40;6;34;.850;3600000;0
24678;168872;24;0;0;0;0;.00nan;0;0
24678;197038;33;0;0;0;0;.00nan;0;0
24678;85727;24;92;30;2;28;.933;3600000;0
24679;187537;19;0;0;0;0;.00nan;0;0
24679;165723;32;100;30;0;30;1.000;3600000;0
24679;178384;19;79;28;1;27;.964;3583000;0
24679;20432;32;0;0;0;0;.00nan;0;0
24680;186573;16;0;0;0;0;.00nan;0;0
24680;50065;16;38;21;4;17;.810;3548000;0
24680;139409;3;72;26;2;24;.923;3600000;0
24680;148958;3;0;0;0;0;.00nan;0;0
24681;170977;30;60;13;1;12;.923;3600000;0
24681;174718;12;0;0;0;0;.00nan;0;0
24681;85798;12;89;44;3;41;.932;3570000;0
24681;86697;30;0;0;0;0;.00nan;0;0
24682;184229;35;0;0;0;0;.00nan;0;0
24682;179452;27;0;0;0;0;.00nan;0;0
24682;175660;27;60;26;3;23;.885;3656000;0
24682;57338;35;84;29;2;27;.931;3656000;0
24683;197940;11;81;34;3;31;.912;3600000;0
24683;162029;4182;0;0;0;0;.00nan;0;0
24683;172340;4182;64;19;2;17;.895;3600000;0
24683;45323;11;0;0;0;0;.00nan;0;0
24684;187578;10;0;0;0;0;.00nan;0;0
24684;77955;28;0;0;0;0;.00nan;0;0
24684;85437;28;75;40;3;37;.925;3600000;0
24684;90164;10;50;28;4;24;.857;3600000;0
24685;168872;24;65;24;2;22;.917;3600000;0
24685;179154;26;0;0;0;0;.00nan;0;0
24685;85727;24;0;0;0;0;.00nan;0;0
24685;152835;26;56;29;4;25;.862;3584000;0
24686;187537;19;62;35;4;31;.886;3600000;0
24686;178384;19;0;0;0;0;.00nan;0;0
24686;174718;12;0;0;0;0;.00nan;0;0
24686;85798;12;70;30;3;27;.900;3600000;0
24687;184229;35;0;0;0;0;.00nan;0;0
24687;186573;16;68;26;2;24;.923;3600000;0
24687;50065;16;0;0;0;0;.00nan;0;0
24687;57338;35;70;37;4;33;.892;3529000;0
24688;175092;9;0;0;0;0;.00nan;0;0
24688;190106;9;85;49;4;45;.918;4200000;0
24688;-1;5;0;0;0;0;.00nan;0;0
24688;61425;5;49;29;4;25;.862;4200000;0
24689;194416;17;0;0;0;0;.00nan;0;0
24689;178413;17;39;21;4;17;.810;3600000;0
24689;149452;31;0;0;0;0;.00nan;0;0
24689;152717;31;92;37;1;36;.973;3600000;0
24690;187578;10;56;34;4;30;.882;3600000;0
24690;167642;18;0;0;0;0;.00nan;0;0
24690;173727;18;89;33;1;32;.970;3600000;0
24690;90164;10;0;0;0;0;.00nan;0;0
24691;179154;26;56;25;3;22;.880;3600000;0
24691;139409;3;49;31;5;26;.839;3574000;0
24691;148958;3;0;0;0;0;.00nan;0;0
24691;152835;26;0;0;0;0;.00nan;0;0
24692;166646;0;0;0;0;0;.00nan;0;0
24692;59540;0;89;41;2;39;.951;4200000;0
24692;77955;28;76;37;2;35;.946;4200000;0
24692;85437;28;0;0;0;0;.00nan;0;0
24693;166591;20;0;0;0;0;.00nan;0;0
24693;3928;15;0;0;0;0;.00nan;0;0
24693;163195;15;73;22;2;20;.909;4200000;0
24693;183783;20;97;52;2;50;.962;4200000;0
24694;320;21;0;0;0;0;.00nan;0;0
24694;3284;21;84;36;2;34;.944;3705000;0
24694;183904;34;58;22;3;19;.864;3705000;0
24694;78806;34;0;0;0;0;.00nan;0;0
24695;183844;29;0;0;0;0;.00nan;0;0
24695;173699;29;80;41;3;38;.927;3549000;0
24695;170314;25;0;0;0;0;.00nan;0;0
24695;191813;25;79;25;2;23;.920;3600000;0
24696;556;33;80;43;3;40;.930;4188000;0
24696;175912;14;0;0;0;0;.00nan;0;0
24696;185034;14;46;24;4;20;.833;4188000;0
24696;197038;33;0;0;0;0;.00nan;0;0
24697;183859;23;0;0;0;0;.00nan;0;0
24697;170977;30;0;0;0;0;.00nan;0;0
24697;78573;23;72;35;3;32;.914;3562000;0
24697;86697;30;75;18;1;17;.944;3600000;0
24698;162029;4182;0;0;0;0;.00nan;0;0
24698;172340;4182;60;38;4;34;.895;3639000;0
24698;175084;22;0;0;0;0;.00nan;0;0
24698;184770;22;63;40;5;35;.875;3639000;0
24699;197940;11;0;0;0;0;.00nan;0;0
24699;165723;32;0;0;0;0;.00nan;0;0
24699;20432;32;45;33;6;27;.818;3570000;0
24699;45323;11;65;35;4;31;.886;3600000;0
24700;13714;8;77;38;4;34;.895;3600000;0
24700;179452;27;0;0;0;0;.00nan;0;0
24700;175660;27;76;21;2;19;.905;3600000;0
24700;58830;8;0;0;0;0;.00nan;0;0
24701;168872;24;0;0;0;0;.00nan;0;0
24701;170314;25;0;0;0;0;.00nan;0;0
24701;191813;25;92;31;1;30;.968;3792000;0
24701;85727;24;86;36;2;34;.944;3792000;0
24702;179452;27;79;42;3;39;.929;3513000;0
24702;175660;27;0;0;0;0;.00nan;0;0
24702;196090;4838;82;29;1;28;.966;3600000;0
24702;185743;4838;0;0;0;0;.00nan;0;0
24703;166591;20;99;42;2;40;.952;4200000;0
24703;183783;20;0;0;0;0;.00nan;0;0
24703;183844;29;73;28;2;26;.929;4200000;0
24703;173699;29;0;0;0;0;.00nan;0;0
24704;166646;0;98;48;2;46;.958;3554000;0
24704;59540;0;0;0;0;0;.00nan;0;0
24704;149452;31;0;0;0;0;.00nan;0;0
24704;152717;31;86;16;0;16;1.000;3600000;0
24705;165723;32;72;30;3;27;.900;3600000;0
24705;20432;32;0;0;0;0;.00nan;0;0
24705;175092;9;76;28;2;26;.929;3600000;0
24705;190106;9;0;0;0;0;.00nan;0;0
24706;197940;11;51;33;4;29;.879;3531000;0
24706;187537;19;0;0;0;0;.00nan;0;0
24706;178384;19;80;29;2;27;.931;3600000;0
24706;45323;11;0;0;0;0;.00nan;0;0
24707;320;21;0;0;0;0;.00nan;0;0
24707;3284;21;68;24;2;22;.917;3600000;0
24707;77955;28;41;37;6;31;.838;2979000;0
24707;85437;28;6;7;5;2;.286;621000;0
24708;139409;3;73;19;1;18;.947;3600000;0
24708;148958;3;0;0;0;0;.00nan;0;0
24708;149452;31;0;0;0;0;.00nan;0;0
24708;152717;31;98;44;2;42;.955;3597000;0
24709;556;33;81;37;2;35;.946;3600000;0
24709;183904;34;65;14;1;13;.929;3600000;0
24709;197038;33;0;0;0;0;.00nan;0;0
24709;78806;34;0;0;0;0;.00nan;0;0
24710;175912;14;0;0;0;0;.00nan;0;0
24710;185034;14;88;43;3;40;.930;3600000;0
24710;-1;5;0;0;0;0;.00nan;0;0
24710;61425;5;54;31;4;27;.871;3562000;0
24711;184229;35;0;0;0;0;.00nan;0;0
24711;179154;26;0;0;0;0;.00nan;0;0
24711;57338;35;60;34;4;30;.882;3600000;0
24711;152835;26;100;26;0;26;1.000;3600000;0
24712;170977;30;0;0;0;0;.00nan;0;0
24712;186573;16;0;0;0;0;.00nan;0;0
24712;50065;16;90;25;1;24;.960;3600000;0
24712;86697;30;81;34;2;32;.941;3545000;0
24713;183859;23;0;0;0;0;.00nan;0;0
24713;174718;12;35;11;3;8;.727;1742000;0
24713;78573;23;94;35;2;33;.943;3600000;0
24713;85798;12;17;15;5;10;.667;1858000;0
24714;175084;22;73;19;1;18;.947;3600000;0
24714;184770;22;0;0;0;0;.00nan;0;0
24714;196090;4838;0;0;0;0;.00nan;0;0
24714;185743;4838;79;40;3;37;.925;3522000;0
24715;13714;8;0;0;0;0;.00nan;0;0
24715;168872;24;0;0;0;0;.00nan;0;0
24715;58830;8;60;30;3;27;.900;3600000;0
24715;85727;24;56;32;4;28;.875;3557000;0
24716;187578;10;0;0;0;0;.00nan;0;0
24716;162029;4182;0;0;0;0;.00nan;0;0
24716;172340;4182;100;43;2;41;.953;4200000;0
24716;90164;10;97;40;2;38;.950;4200000;0
24717;166646;0;0;0;0;0;.00nan;0;0
24717;194416;17;0;0;0;0;.00nan;0;0
24717;178413;17;71;26;2;24;.923;3884000;0
24717;59540;0;94;31;1;30;.968;3884000;0
24718;3928;15;64;13;1;12;.923;3600000;0
24718;163195;15;0;0;0;0;.00nan;0;0
24718;183844;29;0;0;0;0;.00nan;0;0
24718;173699;29;70;31;2;29;.935;3569000;0
24719;167642;18;0;0;0;0;.00nan;0;0
24719;173727;18;90;37;1;36;.973;4200000;0
24719;179452;27;0;0;0;0;.00nan;0;0
24719;175660;27;100;34;1;33;.971;4200000;0
24720;183904;34;61;19;2;17;.895;3600000;0
24720;175092;9;39;25;4;21;.840;3174000;0
24720;190106;9;28;6;3;3;.500;426000;0
24720;78806;34;0;0;0;0;.00nan;0;0
24721;166591;20;0;0;0;0;.00nan;0;0
24721;165723;32;0;0;0;0;.00nan;0;0
24721;183783;20;58;30;3;27;.900;3544000;0
24721;20432;32;86;32;2;30;.938;3600000;0
24722;-1;5;0;0;0;0;.00nan;0;0
24722;61425;5;77;24;2;22;.917;3600000;0
24722;139409;3;94;29;1;28;.966;3600000;0
24722;148958;3;0;0;0;0;.00nan;0;0
24723;556;33;74;36;3;33;.917;3600000;0
24723;175912;14;0;0;0;0;.00nan;0;0
24723;185034;14;92;18;0;18;1.000;3600000;0
24723;197038;33;0;0;0;0;.00nan;0;0
24724;197940;11;0;0;0;0;.00nan;0;0
24724;194416;17;51;21;3;18;.857;3564000;0
24724;178413;17;0;0;0;0;.00nan;0;0
24724;45323;11;77;23;1;22;.957;3600000;0
24725;170314;25;0;0;0;0;.00nan;0;0
24725;191813;25;84;23;1;22;.957;3600000;0
24725;149452;31;63;28;4;24;.857;3600000;0
24725;152717;31;0;0;0;0;.00nan;0;0
24726;179154;26;0;0;0;0;.00nan;0;0
24726;186573;16;0;0;0;0;.00nan;0;0
24726;50065;16;85;38;3;35;.921;3600000;0
24726;152835;26;94;37;2;35;.946;3600000;0
24727;184229;35;0;0;0;0;.00nan;0;0
24727;174718;12;0;0;0;0;.00nan;0;0
24727;57338;35;95;30;1;29;.967;3600000;0
24727;85798;12;59;25;3;22;.880;3600000;0
24728;13714;8;51;30;4;26;.867;3756000;0
24728;170977;30;0;0;0;0;.00nan;0;0
24728;58830;8;0;0;0;0;.00nan;0;0
24728;86697;30;35;24;5;19;.792;3756000;0
24729;167642;18;57;27;3;24;.889;3544000;0
24729;173727;18;0;0;0;0;.00nan;0;0
24729;175084;22;81;29;2;27;.931;3600000;0
24729;184770;22;0;0;0;0;.00nan;0;0
24730;187537;19;0;0;0;0;.00nan;0;0
24730;162029;4182;0;0;0;0;.00nan;0;0
24730;172340;4182;80;36;3;33;.917;3600000;0
24730;178384;19;65;41;5;36;.878;3524000;0
24731;556;33;0;0;0;0;.00nan;0;0
24731;197038;33;73;33;3;30;.909;3600000;0
24731;77955;28;0;0;0;0;.00nan;0;0
24731;85437;28;70;37;4;33;.892;3600000;0
24732;320;21;0;0;0;0;.00nan;0;0
24732;3284;21;67;24;2;22;.917;3600000;0
24732;183844;29;50;1;0;1;1.000;360000;0
24732;173699;29;37;35;6;29;.829;3240000;0
24733;3928;15;53;22;3;19;.864;3600000;0
24733;163195;15;0;0;0;0;.00nan;0;0
24733;168872;24;93;55;2;53;.964;3600000;0
24733;85727;24;0;0;0;0;.00nan;0;0
24734;166646;0;0;0;0;0;.00nan;0;0
24734;183859;23;0;0;0;0;.00nan;0;0
24734;59540;0;94;44;2;42;.955;3674000;0
24734;78573;23;66;18;1;17;.944;3674000;0
24735;187578;10;63;30;3;27;.900;3870000;0
24735;196090;4838;77;32;4;28;.875;3870000;0
24735;185743;4838;0;0;0;0;.00nan;0;0
24735;90164;10;0;0;0;0;.00nan;0;0
24736;162029;4182;62;33;3;30;.909;3548000;0
24736;172340;4182;0;0;0;0;.00nan;0;0
24736;179452;27;0;0;0;0;.00nan;0;0
24736;175660;27;78;32;2;30;.938;3600000;0
24737;166591;20;43;36;6;30;.833;3046000;0
24737;183783;20;54;5;0;5;1.000;554000;0
24737;-1;5;0;0;0;0;.00nan;0;0
24737;61425;5;82;36;2;34;.944;3600000;0
24738;165723;32;53;28;4;24;.857;3600000;0
24738;20432;32;0;0;0;0;.00nan;0;0
24738;184229;35;0;0;0;0;.00nan;0;0
24738;57338;35;60;29;3;26;.897;3600000;0
24739;175092;9;0;0;0;0;.00nan;0;0
24739;190106;9;64;36;4;32;.889;3600000;0
24739;139409;3;78;24;1;23;.958;3600000;0
24739;148958;3;0;0;0;0;.00nan;0;0
24740;194416;17;0;0;0;0;.00nan;0;0
24740;178413;17;89;30;1;29;.967;3600000;0
24740;183859;23;47;28;4;24;.857;3600000;0
24740;78573;23;0;0;0;0;.00nan;0;0
24741;320;21;75;29;2;27;.931;3570000;0
24741;3284;21;0;0;0;0;.00nan;0;0
24741;149452;31;0;0;0;0;.00nan;0;0
24741;152717;31;87;29;1;28;.966;3600000;0
24742;197940;11;88;30;1;29;.967;3600000;0
24742;166646;0;0;0;0;0;.00nan;0;0
24742;45323;11;0;0;0;0;.00nan;0;0
24742;59540;0;40;30;5;25;.833;3600000;0
24743;3928;15;0;0;0;0;.00nan;0;0
24743;163195;15;83;31;2;29;.935;3778000;0
24743;183904;34;0;0;0;0;.00nan;0;0
24743;78806;34;100;41;1;40;.976;3778000;0
24744;175084;22;0;0;0;0;.00nan;0;0
24744;184770;22;52;14;2;12;.857;3600000;0
24744;77955;28;82;60;5;55;.917;3600000;0
24744;85437;28;0;0;0;0;.00nan;0;0
24745;174718;12;100;40;0;40;1.000;3600000;0
24745;186573;16;0;0;0;0;.00nan;0;0
24745;50065;16;56;12;1;11;.917;3574000;0
24745;85798;12;0;0;0;0;.00nan;0;0
24746;13714;8;92;39;1;38;.974;3600000;0
24746;179154;26;0;0;0;0;.00nan;0;0
24746;58830;8;0;0;0;0;.00nan;0;0
24746;152835;26;64;26;4;22;.846;3600000;0
24747;187537;19;0;0;0;0;.00nan;0;0
24747;178384;19;98;37;2;35;.946;4200000;0
24747;170977;30;0;0;0;0;.00nan;0;0
24747;86697;30;72;26;2;24;.923;4200000;0
24748;187578;10;0;0;0;0;.00nan;0;0
24748;167642;18;0;0;0;0;.00nan;0;0
24748;173727;18;81;30;1;29;.967;4023000;0
24748;90164;10;88;44;2;42;.955;4023000;0
24749;183844;29;0;0;0;0;.00nan;0;0
24749;173699;29;100;52;1;51;.981;3600000;0
24749;170314;25;37;23;5;18;.783;3600000;0
24749;191813;25;0;0;0;0;.00nan;0;0
24750;556;33;85;34;2;32;.941;3600000;0
24750;165723;32;0;0;0;0;.00nan;0;0
24750;20432;32;67;33;3;30;.909;3553000;0
24750;197038;33;0;0;0;0;.00nan;0;0
24751;197940;11;0;0;0;0;.00nan;0;0
24751;45323;11;91;38;1;37;.974;3600000;0
24751;139409;3;0;0;0;0;.00nan;0;0
24751;148958;3;68;20;2;18;.900;3548000;0
24752;166591;20;0;0;0;0;.00nan;0;0
24752;183783;20;49;32;5;27;.844;3600000;0
24752;175912;14;0;0;0;0;.00nan;0;0
24752;185034;14;75;27;2;25;.926;3600000;0
24753;162029;4182;0;0;0;0;.00nan;0;0
24753;172340;4182;80;38;3;35;.921;3600000;0
24753;196090;4838;0;0;0;0;.00nan;0;0
24753;185743;4838;51;26;4;22;.846;3561000;0
24754;187537;19;0;0;0;0;.00nan;0;0
24754;178384;19;81;33;2;31;.939;3600000;0
24754;183904;34;43;21;3;18;.857;3521000;0
24754;78806;34;0;0;0;0;.00nan;0;0
24755;13714;8;94;55;1;54;.982;3597000;0
24755;170977;30;0;0;0;0;.00nan;0;0
24755;58830;8;0;0;0;0;.00nan;0;0
24755;86697;30;90;17;0;17;1.000;3600000;0
24756;175092;9;0;0;0;0;.00nan;0;0
24756;190106;9;80;27;1;26;.963;3600000;0
24756;77955;28;0;0;0;0;.00nan;0;0
24756;85437;28;56;41;5;36;.878;3600000;0
24757;166591;20;98;68;2;66;.971;3600000;0
24757;183783;20;0;0;0;0;.00nan;0;0
24757;175084;22;57;16;1;15;.938;3600000;0
24757;184770;22;0;0;0;0;.00nan;0;0
24758;183859;23;0;0;0;0;.00nan;0;0
24758;78573;23;84;42;4;38;.905;3600000;0
24758;139409;3;82;24;1;23;.958;3600000;0
24758;148958;3;0;0;0;0;.00nan;0;0
24759;3928;15;91;41;1;40;.976;3600000;0
24759;163195;15;0;0;0;0;.00nan;0;0
24759;179452;27;0;0;0;0;.00nan;0;0
24759;175660;27;81;36;2;34;.944;3555000;0
24760;165723;32;78;42;4;38;.905;3600000;0
24760;20432;32;0;0;0;0;.00nan;0;0
24760;186573;16;0;0;0;0;.00nan;0;0
24760;50065;16;71;19;1;18;.947;3600000;0
24761;174718;12;59;30;3;27;.900;3584000;0
24761;196090;4838;86;25;1;24;.960;3600000;0
24761;185743;4838;0;0;0;0;.00nan;0;0
24761;85798;12;0;0;0;0;.00nan;0;0
24762;179154;26;0;0;0;0;.00nan;0;0
24762;149452;31;0;0;0;0;.00nan;0;0
24762;152717;31;82;46;4;42;.913;3600000;0
24762;152835;26;68;31;3;28;.903;3600000;0
24763;168872;24;0;0;0;0;.00nan;0;0
24763;184229;35;58;33;4;29;.879;3600000;0
24763;57338;35;0;0;0;0;.00nan;0;0
24763;85727;24;47;31;5;26;.839;3597000;0
24764;162029;4182;0;0;0;0;.00nan;0;0
24764;172340;4182;86;17;0;17;1.000;3600000;0
24764;183844;29;0;0;0;0;.00nan;0;0
24764;173699;29;77;28;2;26;.929;3541000;0
24765;320;21;0;0;0;0;.00nan;0;0
24765;187578;10;81;54;5;49;.907;3600000;0
24765;3284;21;72;26;2;24;.923;3600000;0
24765;90164;10;0;0;0;0;.00nan;0;0
24766;187537;19;0;0;0;0;.00nan;0;0
24766;178384;19;82;31;2;29;.935;4200000;0
24766;170977;30;0;0;0;0;.00nan;0;0
24766;86697;30;82;29;2;27;.931;4200000;0
24767;13714;8;59;37;5;32;.865;3600000;0
24767;196090;4838;0;0;0;0;.00nan;0;0
24767;185743;4838;90;23;0;23;1.000;3600000;0
24767;58830;8;0;0;0;0;.00nan;0;0
24768;197940;11;0;0;0;0;.00nan;0;0
24768;183904;34;63;14;1;13;.929;3600000;0
24768;45323;11;94;52;4;48;.923;3600000;0
24768;78806;34;0;0;0;0;.00nan;0;0
24769;194416;17;0;0;0;0;.00nan;0;0
24769;178413;17;77;25;1;24;.960;3600000;0
24769;-1;5;0;0;0;0;.00nan;0;0
24769;61425;5;98;28;0;28;1.000;3600000;0
24770;166591;20;0;0;0;0;.00nan;0;0
24770;183783;20;57;26;3;23;.885;3600000;0
24770;186573;16;0;0;0;0;.00nan;0;0
24770;50065;16;48;31;5;26;.839;3600000;0
24771;179452;27;0;0;0;0;.00nan;0;0
24771;175660;27;46;27;4;23;.852;3594000;0
24771;139409;3;90;46;2;44;.957;3600000;0
24771;148958;3;0;0;0;0;.00nan;0;0
24772;168872;24;33;20;4;16;.800;3559000;0
24772;175084;22;52;22;3;19;.864;3600000;0
24772;184770;22;0;0;0;0;.00nan;0;0
24772;85727;24;0;0;0;0;.00nan;0;0
24773;170314;25;63;6;0;6;1.000;1357000;0
24773;191813;25;32;17;4;13;.765;2194000;0
24773;149452;31;0;0;0;0;.00nan;0;0
24773;152717;31;88;46;3;43;.935;3600000;0
24774;197940;11;56;33;4;29;.879;3258000;0
24774;183859;23;0;0;0;0;.00nan;0;0
24774;45323;11;51;2;0;2;1.000;316000;0
24774;78573;23;64;30;3;27;.900;3600000;0
24775;183904;34;0;0;0;0;.00nan;0;0
24775;170977;30;89;44;3;41;.932;3549000;0
24775;78806;34;63;25;2;23;.920;3600000;0
24775;86697;30;0;0;0;0;.00nan;0;0
24776;167642;18;0;0;0;0;.00nan;0;0
24776;183844;29;0;0;0;0;.00nan;0;0
24776;173699;29;68;45;5;40;.889;3600000;0
24776;173727;18;59;20;2;18;.900;3600000;0
24777;162029;4182;0;0;0;0;.00nan;0;0
24777;172340;4182;71;31;3;28;.903;3600000;0
24777;179154;26;0;0;0;0;.00nan;0;0
24777;152835;26;66;35;4;31;.886;3563000;0
24778;166646;0;0;0;0;0;.00nan;0;0
24778;-1;5;50;19;3;16;.842;3701000;0
24778;59540;0;92;38;2;36;.947;3701000;0
24778;61425;5;0;0;0;0;.00nan;0;0
24779;184229;35;0;0;0;0;.00nan;0;0
24779;57338;35;58;10;1;9;.900;3600000;0
24779;77955;28;0;0;0;0;.00nan;0;0
24779;85437;28;98;57;4;53;.930;3600000;0
24780;183844;29;97;43;2;41;.953;3529000;0
24780;173699;29;0;0;0;0;.00nan;0;0
24780;196090;4838;0;0;0;0;.00nan;0;0
24780;185743;4838;93;23;0;23;1.000;3600000;0
24781;556;33;80;31;2;29;.935;3600000;0
24781;194416;17;0;0;0;0;.00nan;0;0
24781;178413;17;66;27;3;24;.889;3568000;0
24781;197038;33;0;0;0;0;.00nan;0;0
24782;187578;10;0;0;0;0;.00nan;0;0
24782;179452;27;0;0;0;0;.00nan;0;0
24782;175660;27;52;26;4;22;.846;3517000;0
24782;90164;10;84;38;2;36;.947;3600000;0
24783;170314;25;0;0;0;0;.00nan;0;0
24783;174718;12;57;42;6;36;.857;3600000;0
24783;191813;25;56;19;3;16;.842;3600000;0
24783;85798;12;0;0;0;0;.00nan;0;0
24784;187537;19;0;0;0;0;.00nan;0;0
24784;178384;19;55;23;3;20;.870;3547000;0
24784;149452;31;0;0;0;0;.00nan;0;0
24784;152717;31;73;30;2;28;.933;3600000;0
24785;175092;9;20;35;7;28;.800;3600000;0
24785;190106;9;0;0;0;0;.00nan;0;0
24785;139409;3;71;25;2;23;.920;3600000;0
24785;148958;3;0;0;0;0;.00nan;0;0
24786;320;21;0;0;0;0;.00nan;0;0
24786;3284;21;99;22;0;22;1.000;3600000;0
24786;175084;22;0;0;0;0;.00nan;0;0
24786;184770;22;57;26;3;23;.885;3600000;0
24787;183859;23;0;0;0;0;.00nan;0;0
24787;183904;34;57;28;3;25;.893;3492000;0
24787;78573;23;99;40;1;39;.975;3600000;0
24787;78806;34;0;0;0;0;.00nan;0;0
24788;168872;24;60;50;6;44;.880;3575000;0
24788;175912;14;0;0;0;0;.00nan;0;0
24788;185034;14;57;39;5;34;.872;3600000;0
24788;85727;24;0;0;0;0;.00nan;0;0
24789;184229;35;66;39;4;35;.897;3600000;0
24789;186573;16;81;29;2;27;.931;3600000;0
24789;50065;16;0;0;0;0;.00nan;0;0
24789;57338;35;0;0;0;0;.00nan;0;0
24790;166591;20;62;42;5;37;.881;3600000;0
24790;3928;15;67;15;1;14;.933;3600000;0
24790;163195;15;0;0;0;0;.00nan;0;0
24790;183783;20;0;0;0;0;.00nan;0;0
24791;13714;8;65;25;3;22;.880;3600000;0
24791;165723;32;0;0;0;0;.00nan;0;0
24791;20432;32;58;18;2;16;.889;3600000;0
24791;58830;8;0;0;0;0;.00nan;0;0
24792;197940;11;0;0;0;0;.00nan;0;0
24792;170977;30;0;0;0;0;.00nan;0;0
24792;45323;11;99;44;1;43;.977;3600000;0
24792;86697;30;56;16;2;14;.875;3569000;0
24793;167642;18;0;0;0;0;.00nan;0;0
24793;173727;18;46;17;3;14;.824;3600000;0
24793;179154;26;0;0;0;0;.00nan;0;0
24793;152835;26;65;36;4;32;.889;3597000;0
24794;556;33;48;0;0;0;.00nan;297000;0
24794;166646;0;0;0;0;0;.00nan;0;0
24794;197038;33;23;23;6;17;.739;3303000;0
24794;59540;0;91;42;3;39;.929;3600000;0
24795;166591;20;0;0;0;0;.00nan;0;0
24795;187578;10;94;30;1;29;.967;3600000;0
24795;183783;20;84;53;3;50;.943;3582000;0
24795;90164;10;0;0;0;0;.00nan;0;0
24796;175084;22;63;26;2;24;.923;3600000;0
24796;179452;27;65;32;3;29;.906;3546000;0
24796;175660;27;0;0;0;0;.00nan;0;0
24796;184770;22;0;0;0;0;.00nan;0;0
24797;170314;25;0;0;0;0;.00nan;0;0
24797;191813;25;53;16;2;14;.875;3600000;0
24797;77955;28;0;0;0;0;.00nan;0;0
24797;85437;28;98;68;5;63;.926;3600000;0
24798;179154;26;51;36;5;31;.861;3586000;0
24798;196090;4838;0;0;0;0;.00nan;0;0
24798;185743;4838;65;26;3;23;.885;3600000;0
24798;152835;26;0;0;0;0;.00nan;0;0
24799;187537;19;0;0;0;0;.00nan;0;0
24799;178384;19;82;27;1;26;.963;3600000;0
24799;183844;29;0;0;0;0;.00nan;0;0
24799;173699;29;85;41;3;38;.927;3580000;0
24800;175092;9;0;0;0;0;.00nan;0;0
24800;190106;9;52;33;6;27;.818;3600000;0
24800;149452;31;0;0;0;0;.00nan;0;0
24800;152717;31;76;29;2;27;.931;3600000;0
24801;165723;32;55;27;4;23;.852;3600000;0
24801;20432;32;0;0;0;0;.00nan;0;0
24801;175912;14;0;0;0;0;.00nan;0;0
24801;185034;14;57;37;5;32;.865;3600000;0
24802;13714;8;59;20;2;18;.900;3600000;0
24802;174718;12;0;0;0;0;.00nan;0;0
24802;58830;8;0;0;0;0;.00nan;0;0
24802;85798;12;48;27;4;23;.852;3514000;0
24803;167642;18;0;0;0;0;.00nan;0;0
24803;173727;18;65;43;4;39;.907;4125000;0
24803;186573;16;0;0;0;0;.00nan;0;0
24803;50065;16;37;27;5;22;.815;4125000;0
24804;183859;23;0;0;0;0;.00nan;0;0
24804;170977;30;0;0;0;0;.00nan;0;0
24804;78573;23;55;32;4;28;.875;3600000;0
24804;86697;30;62;16;1;15;.938;3600000;0
24805;197940;11;69;43;4;39;.907;3600000;0
24805;162029;4182;0;0;0;0;.00nan;0;0
24805;172340;4182;79;9;0;9;1.000;3600000;0
24805;45323;11;0;0;0;0;.00nan;0;0
24806;320;21;0;0;0;0;.00nan;0;0
24806;187537;19;0;0;0;0;.00nan;0;0
24806;3284;21;84;27;1;26;.963;3600000;0
24806;178384;19;56;29;3;26;.897;3600000;0
24807;166591;20;29;32;6;26;.813;2888000;0
24807;183783;20;51;10;1;9;.900;712000;0
24807;170314;25;85;26;2;24;.923;3600000;0
24807;191813;25;0;0;0;0;.00nan;0;0
24808;168872;24;79;27;1;26;.963;3579000;0
24808;-1;5;0;0;0;0;.00nan;0;0
24808;61425;5;100;32;0;32;1.000;3600000;0
24808;85727;24;0;0;0;0;.00nan;0;0
24809;183844;29;0;0;0;0;.00nan;0;0
24809;173699;29;65;22;2;20;.909;3600000;0
24809;175092;9;0;0;0;0;.00nan;0;0
24809;190106;9;83;36;4;32;.889;3587000;0
24810;175084;22;0;0;0;0;.00nan;0;0
24810;184770;22;67;32;3;29;.906;3600000;0
24810;175912;14;0;0;0;0;.00nan;0;0
24810;185034;14;85;49;4;45;.918;3600000;0
24811;184229;35;0;0;0;0;.00nan;0;0
24811;57338;35;57;28;3;25;.893;4053000;0
24811;149452;31;0;0;0;0;.00nan;0;0
24811;152717;31;93;36;2;34;.944;4053000;0
24812;3928;15;59;11;1;10;.909;3600000;0
24812;163195;15;0;0;0;0;.00nan;0;0
24812;77955;28;0;0;0;0;.00nan;0;0
24812;85437;28;54;45;6;39;.867;3600000;0
24813;187578;10;0;0;0;0;.00nan;0;0
24813;183904;34;0;0;0;0;.00nan;0;0
24813;78806;34;75;36;3;33;.917;4069000;0
24813;90164;10;99;50;2;48;.960;4069000;0
24814;179154;26;0;0;0;0;.00nan;0;0
24814;186573;16;63;26;2;24;.923;3514000;0
24814;50065;16;0;0;0;0;.00nan;0;0
24814;152835;26;100;28;0;28;1.000;3600000;0
24815;183859;23;0;0;0;0;.00nan;0;0
24815;174718;12;77;32;2;30;.938;3536000;0
24815;78573;23;100;24;0;24;1.000;3600000;0
24815;85798;12;0;0;0;0;.00nan;0;0
24816;165723;32;0;0;0;0;.00nan;0;0
24816;20432;32;92;48;2;46;.958;3600000;0
24816;179452;27;0;0;0;0;.00nan;0;0
24816;175660;27;47;24;4;20;.833;3556000;0
24817;196090;4838;59;20;2;18;.900;3600000;0
24817;185743;4838;0;0;0;0;.00nan;0;0
24817;139409;3;49;28;4;24;.857;3587000;0
24817;148958;3;0;0;0;0;.00nan;0;0
24818;197940;11;50;28;4;24;.857;3685000;0
24818;13714;8;63;30;5;25;.833;3685000;0
24818;45323;11;0;0;0;0;.00nan;0;0
24818;58830;8;0;0;0;0;.00nan;0;0
24819;162029;4182;0;0;0;0;.00nan;0;0
24819;172340;4182;59;33;4;29;.879;3600000;0
24819;170977;30;0;0;0;0;.00nan;0;0
24819;86697;30;92;22;0;22;1.000;3600000;0
24820;175092;9;71;20;1;19;.950;3600000;0
24820;190106;9;0;0;0;0;.00nan;0;0
24820;-1;5;0;0;0;0;.00nan;0;0
24820;61425;5;66;26;2;24;.923;3591000;0
24821;187578;10;100;33;0;33;1.000;3600000;0
24821;175912;14;0;0;0;0;.00nan;0;0
24821;185034;14;68;41;5;36;.878;3600000;0
24821;90164;10;0;0;0;0;.00nan;0;0
24822;166646;0;0;0;0;0;.00nan;0;0
24822;170314;25;0;0;0;0;.00nan;0;0
24822;191813;25;42;10;2;8;.800;3600000;0
24822;59540;0;69;40;4;36;.900;3586000;0
24823;166591;20;98;49;2;47;.959;4200000;0
24823;183783;20;0;0;0;0;.00nan;0;0
24823;168872;24;0;0;0;0;.00nan;0;0
24823;85727;24;94;39;2;37;.949;4200000;0
24824;179154;26;0;0;0;0;.00nan;0;0
24824;174718;12;41;22;4;18;.818;1906000;0
24824;85798;12;12;18;6;12;.667;1694000;0
24824;152835;26;67;26;2;24;.923;3600000;0
24825;187537;19;0;0;0;0;.00nan;0;0
24825;3928;15;75;25;3;22;.880;3899000;0
24825;163195;15;0;0;0;0;.00nan;0;0
24825;178384;19;91;44;2;42;.955;3899000;0
24826;167642;18;0;0;0;0;.00nan;0;0
24826;173727;18;79;31;2;29;.935;3600000;0
24826;196090;4838;0;0;0;0;.00nan;0;0
24826;185743;4838;48;23;3;20;.870;3600000;0
24827;162029;4182;0;0;0;0;.00nan;0;0
24827;172340;4182;76;36;4;32;.889;3600000;0
24827;139409;3;70;25;2;23;.920;3600000;0
24827;148958;3;0;0;0;0;.00nan;0;0
24828;175084;22;0;0;0;0;.00nan;0;0
24828;184770;22;69;26;3;23;.885;3600000;0
24828;77955;28;0;0;0;0;.00nan;0;0
24828;85437;28;87;54;4;50;.926;3569000;0
24829;194416;17;98;39;2;37;.949;3559000;0
24829;178413;17;0;0;0;0;.00nan;0;0
24829;183904;34;69;21;1;20;.952;3600000;0
24829;78806;34;0;0;0;0;.00nan;0;0
24830;320;21;0;0;0;0;.00nan;0;0
24830;3284;21;96;36;2;34;.944;3600000;0
24830;149452;31;0;0;0;0;.00nan;0;0
24830;152717;31;87;41;3;38;.927;3600000;0
24831;183844;29;0;0;0;0;.00nan;0;0
24831;173699;29;54;25;3;22;.880;3586000;0
24831;184229;35;0;0;0;0;.00nan;0;0
24831;57338;35;66;27;2;25;.926;3600000;0
24832;165723;32;70;18;1;17;.944;3600000;0
24832;183859;23;0;0;0;0;.00nan;0;0
24832;20432;32;0;0;0;0;.00nan;0;0
24832;78573;23;65;39;6;33;.846;3600000;0
24833;556;33;58;28;3;25;.893;3545000;0
24833;13714;8;90;29;1;28;.966;3600000;0
24833;197038;33;0;0;0;0;.00nan;0;0
24833;58830;8;0;0;0;0;.00nan;0;0
24834;197940;11;0;0;0;0;.00nan;0;0
24834;170977;30;0;0;0;0;.00nan;0;0
24834;45323;11;89;46;2;44;.957;3600000;0
24834;86697;30;28;22;5;17;.773;3600000;0
24835;175092;9;0;0;0;0;.00nan;0;0
24835;175912;14;81;34;2;32;.941;3586000;0
24835;190106;9;85;30;1;29;.967;3600000;0
24835;185034;14;0;0;0;0;.00nan;0;0
24836;167642;18;74;20;1;19;.950;3580000;0
24836;173727;18;0;0;0;0;.00nan;0;0
24836;139409;3;0;0;0;0;.00nan;0;0
24836;148958;3;100;37;0;37;1.000;3600000;0
24837;168872;24;35;18;4;14;.778;3600000;0
24837;77955;28;63;47;5;42;.894;3563000;0
24837;85437;28;0;0;0;0;.00nan;0;0
24837;85727;24;0;0;0;0;.00nan;0;0
24838;166646;0;55;35;5;30;.857;3600000;0
24838;175084;22;96;22;0;22;1.000;3600000;0
24838;184770;22;0;0;0;0;.00nan;0;0
24838;59540;0;0;0;0;0;.00nan;0;0
24839;187578;10;48;26;4;22;.846;3600000;0
24839;183904;34;0;0;0;0;.00nan;0;0
24839;78806;34;46;32;5;27;.844;3507000;0
24839;90164;10;0;0;0;0;.00nan;0;0
24840;13714;8;0;0;0;0;.00nan;0;0
24840;183859;23;82;39;3;36;.923;3600000;0
24840;58830;8;38;23;5;18;.783;3547000;0
24840;78573;23;0;0;0;0;.00nan;0;0
24841;197940;11;74;46;5;41;.891;3600000;0
24841;162029;4182;72;26;1;25;.962;3600000;0
24841;172340;4182;0;0;0;0;.00nan;0;0
24841;45323;11;0;0;0;0;.00nan;0;0
24842;179452;27;0;0;0;0;.00nan;0;0
24842;175660;27;65;18;1;17;.944;3566000;0
24842;186573;16;0;0;0;0;.00nan;0;0
24842;50065;16;100;31;0;31;1.000;3600000;0
24843;556;33;75;45;5;40;.889;3744000;0
24843;-1;5;0;0;0;0;.00nan;0;0
24843;197038;33;0;0;0;0;.00nan;0;0
24843;61425;5;58;25;4;21;.840;3744000;0
24844;170314;25;61;27;3;24;.889;3600000;0
24844;179154;26;0;0;0;0;.00nan;0;0
24844;191813;25;0;0;0;0;.00nan;0;0
24844;152835;26;61;32;4;28;.875;3579000;0
24845;320;21;0;0;0;0;.00nan;0;0
24845;166591;20;0;0;0;0;.00nan;0;0
24845;3284;21;77;26;1;25;.962;3600000;0
24845;183783;20;69;29;3;26;.897;3589000;0
24846;184229;35;0;0;0;0;.00nan;0;0
24846;174718;12;50;34;5;29;.853;3600000;0
24846;57338;35;75;22;1;21;.955;3600000;0
24846;85798;12;0;0;0;0;.00nan;0;0
24847;187537;19;46;21;3;18;.857;3600000;0
24847;178384;19;0;0;0;0;.00nan;0;0
24847;196090;4838;0;0;0;0;.00nan;0;0
24847;185743;4838;70;31;2;29;.935;3600000;0
24848;166591;20;78;30;3;27;.900;3600000;0
24848;183783;20;0;0;0;0;.00nan;0;0
24848;175092;9;37;24;5;19;.792;2113000;0
24848;190106;9;84;18;0;18;1.000;1466000;0
24849;175912;14;0;0;0;0;.00nan;0;0
24849;185034;14;84;14;0;14;1.000;3600000;0
24849;77955;28;57;11;1;10;.909;973000;0
24849;85437;28;47;33;6;27;.818;2627000;0
24850;194416;17;0;0;0;0;.00nan;0;0
24850;183844;29;0;0;0;0;.00nan;0;0
24850;178413;17;89;17;0;17;1.000;3600000;0
24850;173699;29;81;51;4;47;.922;3600000;0
24851;171838;31;43;26;5;21;.808;1851000;0
24851;13714;8;82;28;2;26;.929;3600000;0
24851;58830;8;0;0;0;0;.00nan;0;0
24851;149452;31;51;6;1;5;.833;1749000;0
24852;183859;23;0;0;0;0;.00nan;0;0
24852;179452;27;0;0;0;0;.00nan;0;0
24852;175660;27;68;15;1;14;.933;3600000;0
24852;78573;23;89;40;2;38;.950;3554000;0
24853;162029;4182;0;0;0;0;.00nan;0;0
24853;3928;15;0;0;0;0;.00nan;0;0
24853;172340;4182;63;36;4;32;.889;3600000;0
24853;75268;15;64;17;1;16;.941;3600000;0
24854;183904;34;80;17;1;16;.941;3658000;0
24854;168872;24;0;0;0;0;.00nan;0;0
24854;78806;34;0;0;0;0;.00nan;0;0
24854;85727;24;89;37;2;35;.946;3658000;0
24855;320;21;0;0;0;0;.00nan;0;0
24855;187578;10;0;0;0;0;.00nan;0;0
24855;3284;21;58;30;4;26;.867;3529000;0
24855;90164;10;71;30;2;28;.933;3600000;0
24856;166646;0;0;0;0;0;.00nan;0;0
24856;183844;29;92;35;1;34;.971;3836000;0
24856;173699;29;0;0;0;0;.00nan;0;0
24856;59540;0;100;39;0;39;1.000;3836000;0
24857;556;33;95;54;4;50;.926;3600000;0
24857;179154;26;0;0;0;0;.00nan;0;0
24857;197038;33;0;0;0;0;.00nan;0;0
24857;152835;26;92;28;1;27;.964;3600000;0
24858;174718;12;0;0;0;0;.00nan;0;0
24858;175084;22;0;0;0;0;.00nan;0;0
24858;85798;12;75;35;3;32;.914;3595000;0
24858;152717;22;65;20;2;18;.900;3600000;0
24859;165723;32;0;0;0;0;.00nan;0;0
24859;20432;32;82;32;2;30;.938;3600000;0
24859;184229;35;0;0;0;0;.00nan;0;0
24859;57338;35;44;24;4;20;.833;3587000;0
24860;170314;25;63;29;3;26;.897;3600000;0
24860;170977;30;0;0;0;0;.00nan;0;0
24860;191813;25;0;0;0;0;.00nan;0;0
24860;86697;30;40;28;5;23;.821;3600000;0
24861;171838;31;44;30;5;25;.833;2205000;0
24861;186573;16;0;0;0;0;.00nan;0;0
24861;50065;16;96;21;0;21;1.000;3600000;0
24861;149452;31;53;18;2;16;.889;1395000;0
24862;187537;19;0;0;0;0;.00nan;0;0
24862;178384;19;94;32;2;30;.938;4051000;0
24862;179452;27;63;29;3;26;.897;4051000;0
24862;175660;27;0;0;0;0;.00nan;0;0
24863;197940;11;0;0;0;0;.00nan;0;0
24863;196090;4838;0;0;0;0;.00nan;0;0
24863;185743;4838;60;23;2;21;.913;3600000;0
24863;45323;11;67;38;4;34;.895;3600000;0
24864;166591;20;0;0;0;0;.00nan;0;0
24864;183783;20;90;30;1;29;.967;3600000;0
24864;139409;3;0;0;0;0;.00nan;0;0
24864;148958;3;49;40;5;35;.875;3600000;0
24865;175912;14;0;0;0;0;.00nan;0;0
24865;185034;14;54;28;4;24;.857;3600000;0
24865;-1;5;60;24;2;22;.917;2667000;0
24865;61425;5;32;17;4;13;.765;888000;0
24866;3928;15;0;0;0;0;.00nan;0;0
24866;167642;18;0;0;0;0;.00nan;0;0
24866;173727;18;31;21;5;16;.762;3600000;0
24866;75268;15;77;31;2;29;.935;3600000;0
24867;162029;4182;0;0;0;0;.00nan;0;0
24867;172340;4182;73;32;4;28;.875;3600000;0
24867;175092;9;0;0;0;0;.00nan;0;0
24867;190106;9;99;35;1;34;.971;3600000;0
24868;320;21;0;0;0;0;.00nan;0;0
24868;3284;21;49;31;4;27;.871;3600000;0
24868;183904;34;98;26;1;25;.962;3600000;0
24868;78806;34;0;0;0;0;.00nan;0;0
24869;170314;25;55;23;3;20;.870;3798000;0
24869;-1;5;0;0;0;0;.00nan;0;0
24869;191813;25;0;0;0;0;.00nan;0;0
24869;61425;5;80;44;4;40;.909;3798000;0
24870;183844;29;85;38;3;35;.921;3553000;0
24870;173699;29;0;0;0;0;.00nan;0;0
24870;139409;3;77;29;2;27;.931;3600000;0
24870;148958;3;0;0;0;0;.00nan;0;0
24871;187578;10;74;42;4;38;.905;3600000;0
24871;168872;24;0;0;0;0;.00nan;0;0
24871;85727;24;78;24;1;23;.958;3600000;0
24871;90164;10;0;0;0;0;.00nan;0;0
24872;171838;31;0;0;0;0;.00nan;0;0
24872;175084;22;0;0;0;0;.00nan;0;0
24872;149452;31;63;44;5;39;.886;3600000;0
24872;152717;22;53;16;2;14;.875;3600000;0
24873;166646;0;0;0;0;0;.00nan;0;0
24873;170977;30;0;0;0;0;.00nan;0;0
24873;59540;0;93;63;2;61;.968;3600000;0
24873;86697;30;46;21;3;18;.857;3574000;0
24874;556;33;67;37;3;34;.919;3600000;0
24874;174718;12;0;0;0;0;.00nan;0;0
24874;197038;33;0;0;0;0;.00nan;0;0
24874;85798;12;80;33;2;31;.939;3600000;0
24875;179154;26;0;0;0;0;.00nan;0;0
24875;77955;28;0;0;0;0;.00nan;0;0
24875;85437;28;53;49;7;42;.857;3600000;0
24875;152835;26;50;12;2;10;.833;3600000;0
24876;187537;19;0;0;0;0;.00nan;0;0
24876;178384;19;86;48;4;44;.917;3584000;0
24876;184229;35;0;0;0;0;.00nan;0;0
24876;57338;35;66;27;3;24;.889;3600000;0
24877;13714;8;100;39;2;37;.949;3600000;0
24877;186573;16;0;0;0;0;.00nan;0;0
24877;50065;16;53;22;3;19;.864;3546000;0
24877;58830;8;0;0;0;0;.00nan;0;0
24878;165723;32;0;0;0;0;.00nan;0;0
24878;183859;23;0;0;0;0;.00nan;0;0
24878;20432;32;52;22;3;19;.864;3600000;0
24878;78573;23;50;39;5;34;.872;3600000;0
24879;3928;15;96;26;1;25;.962;3600000;0
24879;196090;4838;60;31;4;27;.871;3600000;0
24879;185743;4838;0;0;0;0;.00nan;0;0
24879;75268;15;0;0;0;0;.00nan;0;0
24880;197940;11;0;0;0;0;.00nan;0;0
24880;179452;27;0;0;0;0;.00nan;0;0
24880;175660;27;47;24;4;20;.833;3566000;0
24880;45323;11;74;38;3;35;.921;3600000;0
24881;166591;20;90;29;1;28;.966;3600000;0
24881;183783;20;0;0;0;0;.00nan;0;0
24881;194416;17;0;0;0;0;.00nan;0;0
24881;178413;17;70;30;2;28;.933;3565000;0
24882;162029;4182;66;39;4;35;.897;3600000;0
24882;172340;4182;0;0;0;0;.00nan;0;0
24882;168872;24;55;33;5;28;.848;3551000;0
24882;85727;24;0;0;0;0;.00nan;0;0
24883;171838;31;100;35;0;35;1.000;3600000;0
24883;165723;32;85;29;2;27;.931;3518000;0
24883;20432;32;0;0;0;0;.00nan;0;0
24883;149452;31;0;0;0;0;.00nan;0;0
24884;184229;35;0;0;0;0;.00nan;0;0
24884;170314;25;72;29;3;26;.897;3573000;0
24884;191813;25;0;0;0;0;.00nan;0;0
24884;57338;35;99;36;1;35;.972;3600000;0
24885;174718;12;93;58;4;54;.931;3600000;0
24885;175912;14;0;0;0;0;.00nan;0;0
24885;185034;14;81;18;1;17;.944;3600000;0
24885;85798;12;0;0;0;0;.00nan;0;0
24886;183844;29;0;0;0;0;.00nan;0;0
24886;183904;34;0;0;0;0;.00nan;0;0
24886;173699;29;65;50;5;45;.900;3600000;0
24886;78806;34;56;22;3;19;.864;3600000;0
24887;320;21;0;0;0;0;.00nan;0;0
24887;3284;21;66;34;4;30;.882;3600000;0
24887;77955;28;0;0;0;0;.00nan;0;0
24887;85437;28;47;37;5;32;.865;3600000;0
24888;-1;5;65;11;0;11;1.000;1330000;0
24888;61425;5;39;25;5;20;.800;2270000;0
24888;139409;3;74;23;1;22;.957;3600000;0
24888;148958;3;0;0;0;0;.00nan;0;0
24889;194416;17;100;40;0;40;1.000;3600000;0
24889;178413;17;0;0;0;0;.00nan;0;0
24889;170977;30;0;0;0;0;.00nan;0;0
24889;86697;30;48;28;4;24;.857;3600000;0
24890;187578;10;0;0;0;0;.00nan;0;0
24890;175084;22;0;0;0;0;.00nan;0;0
24890;90164;10;95;50;3;47;.940;3517000;0
24890;152717;22;82;17;1;16;.941;3600000;0
24891;166646;0;0;0;0;0;.00nan;0;0
24891;175092;9;0;0;0;0;.00nan;0;0
24891;190106;9;100;37;3;34;.919;3600000;0
24891;59540;0;45;31;6;25;.806;3600000;0
24892;179154;26;0;0;0;0;.00nan;0;0
24892;186573;16;87;17;0;17;1.000;3600000;0
24892;50065;16;0;0;0;0;.00nan;0;0
24892;152835;26;47;29;4;25;.862;3600000;0
24893;13714;8;24;27;6;21;.778;2737000;0
24893;196090;4838;0;0;0;0;.00nan;0;0
24893;185743;4838;63;30;3;27;.900;3600000;0
24893;58830;8;45;7;1;6;.857;863000;0
24894;197940;11;99;34;1;33;.971;3600000;0
24894;183859;23;0;0;0;0;.00nan;0;0
24894;45323;11;0;0;0;0;.00nan;0;0
24894;78573;23;46;28;4;24;.857;3600000;0
24895;3928;15;0;0;0;0;.00nan;0;0
24895;179452;27;0;0;0;0;.00nan;0;0
24895;175660;27;78;38;3;35;.921;3600000;0
24895;75268;15;67;26;2;24;.923;3600000;0
24896;556;33;92;45;2;43;.956;3614000;0
24896;170314;25;95;27;1;26;.963;3614000;0
24896;197038;33;0;0;0;0;.00nan;0;0
24896;191813;25;0;0;0;0;.00nan;0;0
24897;162029;4182;0;0;0;0;.00nan;0;0
24897;172340;4182;72;32;3;29;.906;3600000;0
24897;175912;14;93;26;0;26;1.000;3600000;0
24897;185034;14;0;0;0;0;.00nan;0;0
24898;166591;20;0;0;0;0;.00nan;0;0
24898;183783;20;55;29;3;26;.897;3600000;0
24898;175092;9;76;46;5;41;.891;3553000;0
24898;190106;9;0;0;0;0;.00nan;0;0
24899;174718;12;47;5;1;4;.800;1385000;0
24899;77955;28;87;41;3;38;.927;3600000;0
24899;85437;28;0;0;0;0;.00nan;0;0
24899;85798;12;34;21;4;17;.810;2139000;0
24900;167642;18;0;0;0;0;.00nan;0;0
24900;13714;8;0;0;0;0;.00nan;0;0
24900;173727;18;40;28;5;23;.821;3600000;0
24900;58830;8;35;34;6;28;.824;3583000;0
24901;187578;10;88;39;2;37;.949;3564000;0
24901;175084;22;0;0;0;0;.00nan;0;0
24901;90164;10;0;0;0;0;.00nan;0;0
24901;152717;22;79;20;1;19;.950;3600000;0
24902;171838;31;100;23;0;23;1.000;3600000;0
24902;165723;32;0;0;0;0;.00nan;0;0
24902;20432;32;39;26;5;21;.808;3600000;0
24902;149452;31;0;0;0;0;.00nan;0;0
24903;170977;30;0;0;0;0;.00nan;0;0
24903;86697;30;91;31;1;30;.968;3600000;0
24903;139409;3;64;34;4;30;.882;3600000;0
24903;148958;3;0;0;0;0;.00nan;0;0
24904;320;21;0;0;0;0;.00nan;0;0
24904;3284;21;51;29;5;24;.828;3600000;0
24904;184229;35;0;0;0;0;.00nan;0;0
24904;57338;35;78;27;2;25;.926;3600000;0
24905;3928;15;0;0;0;0;.00nan;0;0
24905;186573;16;89;40;2;38;.950;3600000;0
24905;50065;16;0;0;0;0;.00nan;0;0
24905;75268;15;83;26;1;25;.962;3600000;0
24906;179154;26;0;0;0;0;.00nan;0;0
24906;179452;27;0;0;0;0;.00nan;0;0
24906;175660;27;72;35;3;32;.914;3600000;0
24906;152835;26;52;33;4;29;.879;3558000;0
24907;-1;5;0;0;0;0;.00nan;0;0
24907;61425;5;87;35;1;34;.971;3600000;0
24907;77955;28;0;0;0;0;.00nan;0;0
24907;85437;28;78;31;3;28;.903;3551000;0
24908;166591;20;46;44;6;38;.864;3600000;0
24908;167642;18;0;0;0;0;.00nan;0;0
24908;183783;20;0;0;0;0;.00nan;0;0
24908;173727;18;79;29;2;27;.931;3600000;0
24909;194416;17;35;9;3;6;.667;576000;0
24909;178413;17;64;28;3;25;.893;3024000;0
24909;175912;14;0;0;0;0;.00nan;0;0
24909;185034;14;96;40;3;37;.925;3600000;0
24910;162029;4182;0;0;0;0;.00nan;0;0
24910;172340;4182;100;43;2;41;.953;3600000;0
24910;183904;34;31;16;4;12;.750;3552000;0
24910;78806;34;0;0;0;0;.00nan;0;0
24911;170314;25;0;0;0;0;.00nan;0;0
24911;174718;12;0;0;0;0;.00nan;0;0
24911;191813;25;91;21;0;21;1.000;3600000;0
24911;85798;12;72;33;3;30;.909;3600000;0
24912;556;33;28;16;4;12;.750;1146000;0
24912;183859;23;0;0;0;0;.00nan;0;0
24912;197038;33;56;27;3;24;.889;2454000;0
24912;78573;23;71;28;2;26;.929;3600000;0
24913;13714;8;92;37;2;35;.946;3600000;0
24913;196090;4838;0;0;0;0;.00nan;0;0
24913;185743;4838;48;30;4;26;.867;3514000;0
24913;58830;8;0;0;0;0;.00nan;0;0
24914;197940;11;0;0;0;0;.00nan;0;0
24914;168872;24;0;0;0;0;.00nan;0;0
24914;45323;11;72;42;3;39;.929;3522000;0
24914;85727;24;66;19;1;18;.947;3600000;0
24915;165723;32;72;27;2;25;.926;4200000;0
24915;183844;29;0;0;0;0;.00nan;0;0
24915;20432;32;0;0;0;0;.00nan;0;0
24915;173699;29;83;39;2;37;.949;4200000;0
24916;171838;31;75;54;6;48;.889;3600000;0
24916;175084;22;0;0;0;0;.00nan;0;0
24916;149452;31;0;0;0;0;.00nan;0;0
24916;152717;22;82;14;0;14;1.000;3600000;0
24917;179154;26;0;0;0;0;.00nan;0;0
24917;179452;27;0;0;0;0;.00nan;0;0
24917;175660;27;81;28;1;27;.964;3600000;0
24917;152835;26;74;27;2;25;.926;3581000;0
24918;320;21;0;0;0;0;.00nan;0;0
24918;187537;19;0;0;0;0;.00nan;0;0
24918;3284;21;32;30;7;23;.767;3600000;0
24918;178384;19;60;19;2;17;.895;3600000;0
24919;175092;9;0;0;0;0;.00nan;0;0
24919;190106;9;57;32;6;26;.813;3524000;0
24919;77955;28;0;0;0;0;.00nan;0;0
24919;85437;28;65;38;4;34;.895;3600000;0
24920;162029;4182;0;0;0;0;.00nan;0;0
24920;172340;4182;71;18;1;17;.944;3600000;0
24920;-1;5;62;46;5;41;.891;3600000;0
24920;61425;5;0;0;0;0;.00nan;0;0
24921;167642;18;0;0;0;0;.00nan;0;0
24921;173727;18;65;22;2;20;.909;3544000;0
24921;139409;3;0;0;0;0;.00nan;0;0
24921;148958;3;99;37;1;36;.973;3600000;0
24922;166646;0;0;0;0;0;.00nan;0;0
24922;194416;17;0;0;0;0;.00nan;0;0
24922;178413;17;76;22;1;21;.955;3600000;0
24922;59540;0;83;35;3;32;.914;3539000;0
24923;3928;15;0;0;0;0;.00nan;0;0
24923;165723;32;0;0;0;0;.00nan;0;0
24923;20432;32;89;32;2;30;.938;3600000;0
24923;75268;15;68;31;4;27;.871;3528000;0
24924;166591;20;0;0;0;0;.00nan;0;0
24924;183783;20;97;44;2;42;.955;3592000;0
24924;183904;34;67;21;1;20;.952;3600000;0
24924;78806;34;0;0;0;0;.00nan;0;0
24925;171838;31;0;0;0;0;.00nan;0;0
24925;174718;12;0;0;0;0;.00nan;0;0
24925;85798;12;69;21;2;19;.905;3600000;0
24925;149452;31;70;35;3;32;.914;3600000;0
24926;170314;25;0;0;0;0;.00nan;0;0
24926;196090;4838;0;0;0;0;.00nan;0;0
24926;185743;4838;61;18;2;16;.889;3600000;0
24926;191813;25;64;30;3;27;.900;3600000;0
24927;187578;10;28;7;3;4;.571;544000;0
24927;186573;16;92;28;1;27;.964;3600000;0
24927;50065;16;0;0;0;0;.00nan;0;0
24927;90164;10;94;35;1;34;.971;3056000;0
24928;320;21;41;17;3;14;.824;3545000;0
24928;3284;21;0;0;0;0;.00nan;0;0
24928;183859;23;0;0;0;0;.00nan;0;0
24928;78573;23;68;25;2;23;.920;3600000;0
24929;13714;8;58;24;3;21;.875;3560000;0
24929;184229;35;0;0;0;0;.00nan;0;0
24929;57338;35;76;21;1;20;.952;3600000;0
24929;58830;8;0;0;0;0;.00nan;0;0
24930;168872;24;0;0;0;0;.00nan;0;0
24930;170977;30;90;32;1;31;.969;3600000;0
24930;85727;24;87;35;2;33;.943;3569000;0
24930;86697;30;0;0;0;0;.00nan;0;0
24931;197940;11;0;0;0;0;.00nan;0;0
24931;556;33;12;20;6;14;.700;2923000;0
24931;197038;33;53;11;1;10;.909;677000;0
24931;45323;11;64;32;3;29;.906;3600000;0
24932;166591;20;100;40;1;39;.975;3600000;0
24932;183783;20;0;0;0;0;.00nan;0;0
24932;179154;26;0;0;0;0;.00nan;0;0
24932;152835;26;47;25;4;21;.840;3600000;0
24933;183844;29;0;0;0;0;.00nan;0;0
24933;173699;29;56;53;7;46;.868;3600000;0
24933;175084;22;0;0;0;0;.00nan;0;0
24933;152717;22;81;19;1;18;.947;3600000;0
24934;556;33;0;0;0;0;.00nan;0;0
24934;187537;19;0;0;0;0;.00nan;0;0
24934;178384;19;99;31;1;30;.968;3600000;0
24934;197038;33;48;37;5;32;.865;3600000;0
24935;175092;9;84;47;4;43;.915;3520000;0
24935;190106;9;0;0;0;0;.00nan;0;0
24935;186573;16;68;24;2;22;.917;3600000;0
24935;50065;16;0;0;0;0;.00nan;0;0
24936;183859;23;0;0;0;0;.00nan;0;0
24936;168872;24;0;0;0;0;.00nan;0;0
24936;78573;23;99;43;1;42;.977;3600000;0
24936;85727;24;73;24;2;22;.917;3600000;0
24937;165723;32;72;27;1;26;.963;4013000;0
24937;20432;32;0;0;0;0;.00nan;0;0
24937;179452;27;0;0;0;0;.00nan;0;0
24937;175660;27;61;26;2;24;.923;4013000;0
24938;77955;28;0;0;0;0;.00nan;0;0
24938;85437;28;57;30;4;26;.867;3600000;0
24938;139409;3;84;27;1;26;.963;3600000;0
24938;148958;3;0;0;0;0;.00nan;0;0
24939;194416;17;0;0;0;0;.00nan;0;0
24939;178413;17;71;30;3;27;.900;3526000;0
24939;-1;5;0;0;0;0;.00nan;0;0
24939;61425;5;83;25;1;24;.960;3600000;0
24940;166646;0;0;0;0;0;.00nan;0;0
24940;174718;12;0;0;0;0;.00nan;0;0
24940;59540;0;80;37;3;34;.919;3870000;0
24940;85798;12;52;28;4;24;.857;3870000;0
24941;3928;15;0;0;0;0;.00nan;0;0
24941;175912;14;0;0;0;0;.00nan;0;0
24941;185034;14;45;47;6;41;.872;3600000;0
24941;75268;15;68;20;2;18;.900;3600000;0
24942;167642;18;0;0;0;0;.00nan;0;0
24942;183904;34;0;0;0;0;.00nan;0;0
24942;173727;18;91;35;2;33;.943;3600000;0
24942;78806;34;68;32;3;29;.906;3538000;0
24943;170314;25;43;34;5;29;.853;3529000;0
24943;179154;26;0;0;0;0;.00nan;0;0
24943;191813;25;0;0;0;0;.00nan;0;0
24943;152835;26;72;29;3;26;.897;3600000;0
24944;187578;10;0;0;0;0;.00nan;0;0
24944;13714;8;83;44;4;40;.909;3570000;0
24944;58830;8;0;0;0;0;.00nan;0;0
24944;90164;10;79;27;2;25;.926;3600000;0
24945;171838;31;83;35;2;33;.943;3543000;0
24945;170977;30;0;0;0;0;.00nan;0;0
24945;86697;30;90;15;0;15;1.000;3600000;0
24945;149452;31;0;0;0;0;.00nan;0;0
24946;197940;11;0;0;0;0;.00nan;0;0
24946;320;21;0;0;0;0;.00nan;0;0
24946;3284;21;58;32;4;28;.875;3566000;0
24946;45323;11;58;25;3;22;.880;3600000;0
24947;166591;20;0;0;0;0;.00nan;0;0
24947;183783;20;50;49;8;41;.837;3600000;0
24947;183844;29;0;0;0;0;.00nan;0;0
24947;173699;29;41;30;5;25;.833;3600000;0
24948;187537;19;0;0;0;0;.00nan;0;0
24948;178384;19;47;45;7;38;.844;3600000;0
24948;168872;24;83;46;4;42;.913;3600000;0
24948;85727;24;0;0;0;0;.00nan;0;0
24949;3928;15;70;24;1;23;.958;3600000;0
24949;170314;25;63;37;4;33;.892;3600000;0
24949;191813;25;0;0;0;0;.00nan;0;0
24949;75268;15;0;0;0;0;.00nan;0;0
24950;174718;12;59;30;3;27;.900;3571000;0
24950;85798;12;0;0;0;0;.00nan;0;0
24950;139409;3;0;0;0;0;.00nan;0;0
24950;148958;3;92;34;2;32;.941;3600000;0
24951;167642;18;0;0;0;0;.00nan;0;0
24951;173727;18;72;27;2;25;.926;3600000;0
24951;175912;14;18;21;6;15;.714;1716000;0
24951;185034;14;43;19;3;16;.842;1884000;0
24952;184229;35;0;0;0;0;.00nan;0;0
24952;196090;4838;0;0;0;0;.00nan;0;0
24952;185743;4838;53;39;5;34;.872;3600000;0
24952;57338;35;86;29;1;28;.966;3600000;0
24953;556;33;90;51;5;46;.902;3600000;0
24953;170977;30;76;18;1;17;.944;3600000;0
24953;197038;33;0;0;0;0;.00nan;0;0
24953;86697;30;0;0;0;0;.00nan;0;0
24954;162029;4182;0;0;0;0;.00nan;0;0
24954;172340;4182;56;42;6;36;.857;3600000;0
24954;179452;27;77;25;1;24;.960;3600000;0
24954;175660;27;0;0;0;0;.00nan;0;0
24955;186573;16;40;19;4;15;.789;3600000;0
24955;50065;16;0;0;0;0;.00nan;0;0
24955;77955;28;0;0;0;0;.00nan;0;0
24955;85437;28;90;61;5;56;.918;3586000;0
24956;166646;0;0;0;0;0;.00nan;0;0
24956;183904;34;68;21;2;19;.905;3600000;0
24956;59540;0;66;40;5;35;.875;3600000;0
24956;78806;34;0;0;0;0;.00nan;0;0
24957;165723;32;0;0;0;0;.00nan;0;0
24957;20432;32;100;37;0;37;1.000;3600000;0
24957;-1;5;0;0;0;0;.00nan;0;0
24957;61425;5;34;24;5;19;.792;3600000;0
24958;13714;8;71;17;1;16;.941;3600000;0
24958;183859;23;0;0;0;0;.00nan;0;0
24958;58830;8;0;0;0;0;.00nan;0;0
24958;78573;23;67;31;3;28;.903;3540000;0
24959;166646;0;81;30;2;28;.933;3600000;0
24959;175912;14;0;0;0;0;.00nan;0;0
24959;185034;14;34;17;4;13;.765;3527000;0
24959;59540;0;0;0;0;0;.00nan;0;0
24960;320;21;0;0;0;0;.00nan;0;0
24960;3284;21;50;34;5;29;.853;3552000;0
24960;194416;17;0;0;0;0;.00nan;0;0
24960;178413;17;60;38;4;34;.895;3600000;0
24961;175084;22;0;0;0;0;.00nan;0;0
24961;186573;16;0;0;0;0;.00nan;0;0
24961;50065;16;68;36;4;32;.889;3571000;0
24961;152717;22;84;37;2;35;.946;3600000;0
24962;187578;10;67;33;3;30;.909;3600000;0
24962;174718;12;0;0;0;0;.00nan;0;0
24962;85798;12;59;42;5;37;.881;3517000;0
24962;90164;10;0;0;0;0;.00nan;0;0
24963;179154;26;0;0;0;0;.00nan;0;0
24963;-1;5;25;30;7;23;.767;2793000;0
24963;61425;5;53;9;1;8;.889;807000;0
24963;152835;26;48;7;1;6;.857;3600000;0
24964;187537;19;0;0;0;0;.00nan;0;0
24964;178384;19;89;39;3;36;.923;3600000;0
24964;170314;25;0;0;0;0;.00nan;0;0
24964;191813;25;100;37;0;37;1.000;3600000;0
24965;183844;29;0;0;0;0;.00nan;0;0
24965;173699;29;78;28;2;26;.929;3600000;0
24965;170977;30;0;0;0;0;.00nan;0;0
24965;86697;30;66;34;3;31;.912;3600000;0
24966;197940;11;76;44;4;40;.909;3558000;0
24966;171838;31;75;36;3;33;.917;3600000;0
24966;45323;11;0;0;0;0;.00nan;0;0
24966;149452;31;0;0;0;0;.00nan;0;0
24967;183859;23;99;44;1;43;.977;3600000;0
24967;179452;27;0;0;0;0;.00nan;0;0
24967;175660;27;64;29;2;27;.931;3549000;0
24967;78573;23;0;0;0;0;.00nan;0;0
24968;162029;4182;0;0;0;0;.00nan;0;0
24968;172340;4182;50;20;3;17;.850;3600000;0
24968;184229;35;33;16;4;12;.750;855000;0
24968;57338;35;32;31;6;25;.806;2745000;0
24969;175084;22;0;0;0;0;.00nan;0;0
24969;139409;3;0;0;0;0;.00nan;0;0
24969;148958;3;69;35;3;32;.914;3560000;0
24969;152717;22;65;19;1;18;.947;3600000;0
24970;168872;24;27;26;5;21;.808;3513000;0
24970;175092;9;0;0;0;0;.00nan;0;0
24970;190106;9;71;36;3;33;.917;3600000;0
24970;85727;24;0;0;0;0;.00nan;0;0
24971;183904;34;0;0;0;0;.00nan;0;0
24971;196090;4838;0;0;0;0;.00nan;0;0
24971;185743;4838;64;43;5;38;.884;3600000;0
24971;78806;34;61;14;1;13;.929;3600000;0
24972;13714;8;94;18;0;18;1.000;3600000;0
24972;58830;8;0;0;0;0;.00nan;0;0
24972;77955;28;0;0;0;0;.00nan;0;0
24972;85437;28;89;40;3;37;.925;3600000;0
24973;167642;18;52;15;2;13;.867;3600000;0
24973;173727;18;0;0;0;0;.00nan;0;0
24973;184229;35;65;37;4;33;.892;3569000;0
24973;57338;35;0;0;0;0;.00nan;0;0
24974;320;21;0;0;0;0;.00nan;0;0
24974;3284;21;71;16;1;15;.938;3868000;0
24974;-1;5;0;0;0;0;.00nan;0;0
24974;61425;5;92;40;2;38;.950;3868000;0
24975;187578;10;0;0;0;0;.00nan;0;0
24975;3928;15;0;0;0;0;.00nan;0;0
24975;75268;15;49;27;4;23;.852;3600000;0
24975;90164;10;58;37;5;32;.865;3600000;0
24976;166591;20;100;35;0;35;1.000;3600000;0
24976;166646;0;0;0;0;0;.00nan;0;0
24976;183783;20;0;0;0;0;.00nan;0;0
24976;59540;0;60;25;3;22;.880;3600000;0
24977;556;33;100;37;1;36;.973;4200000;0
24977;183859;23;0;0;0;0;.00nan;0;0
24977;197038;33;0;0;0;0;.00nan;0;0
24977;78573;23;72;24;1;23;.958;4200000;0
24978;194416;17;0;0;0;0;.00nan;0;0
24978;178413;17;91;31;1;30;.968;3600000;0
24978;179154;26;0;0;0;0;.00nan;0;0
24978;152835;26;37;30;5;25;.833;3600000;0
24979;171838;31;80;33;3;30;.909;4200000;0
24979;187537;19;0;0;0;0;.00nan;0;0
24979;178384;19;66;35;3;32;.914;4200000;0
24979;149452;31;0;0;0;0;.00nan;0;0
24980;170314;25;0;0;0;0;.00nan;0;0
24980;170977;30;0;0;0;0;.00nan;0;0
24980;191813;25;89;33;2;31;.939;4200000;0
24980;86697;30;90;43;2;41;.953;4200000;0
24981;197940;11;0;0;0;0;.00nan;0;0
24981;183844;29;0;0;0;0;.00nan;0;0
24981;173699;29;58;35;4;31;.886;3597000;0
24981;45323;11;69;31;3;28;.903;3600000;0
24982;320;21;75;38;3;35;.921;3539000;0
24982;3284;21;0;0;0;0;.00nan;0;0
24982;174718;12;0;0;0;0;.00nan;0;0
24982;85798;12;100;36;1;35;.972;3600000;0
24983;175912;14;0;0;0;0;.00nan;0;0
24983;196090;4838;0;0;0;0;.00nan;0;0
24983;185034;14;79;28;2;26;.929;3600000;0
24983;185743;4838;50;27;4;23;.852;3584000;0
24984;183904;34;0;0;0;0;.00nan;0;0
24984;175092;9;0;0;0;0;.00nan;0;0
24984;190106;9;20;35;8;27;.771;3600000;0
24984;78806;34;93;16;0;16;1.000;3600000;0
24985;165723;32;0;0;0;0;.00nan;0;0
24985;194416;17;41;28;4;24;.857;3564000;0
24985;178413;17;0;0;0;0;.00nan;0;0
24985;20432;32;70;34;3;31;.912;3600000;0
24986;162029;4182;0;0;0;0;.00nan;0;0
24986;172340;4182;100;32;1;31;.969;3600000;0
24986;186573;16;52;24;3;21;.875;3531000;0
24986;50065;16;0;0;0;0;.00nan;0;0
24987;179452;27;0;0;0;0;.00nan;0;0
24987;175660;27;91;20;0;20;1.000;3600000;0
24987;77955;28;0;0;0;0;.00nan;0;0
24987;85437;28;98;52;3;49;.942;3600000;0
24988;197940;11;65;42;4;38;.905;4200000;0
24988;556;33;59;34;4;30;.882;4200000;0
24988;197038;33;0;0;0;0;.00nan;0;0
24988;45323;11;0;0;0;0;.00nan;0;0
24989;175092;9;56;23;3;20;.870;3600000;0
24989;175912;14;77;20;1;19;.950;3600000;0
24989;190106;9;0;0;0;0;.00nan;0;0
24989;185034;14;0;0;0;0;.00nan;0;0
24990;166591;20;77;36;3;33;.917;3600000;0
24990;183783;20;0;0;0;0;.00nan;0;0
24990;168872;24;35;31;5;26;.839;3540000;0
24990;85727;24;0;0;0;0;.00nan;0;0
24991;183904;34;63;31;5;26;.839;3766000;0
24991;78806;34;0;0;0;0;.00nan;0;0
24991;139409;3;0;0;0;0;.00nan;0;0
24991;148958;3;66;46;6;40;.870;3766000;0
24992;187578;10;0;0;0;0;.00nan;0;0
24992;-1;5;0;0;0;0;.00nan;0;0
24992;61425;5;76;46;4;42;.913;3600000;0
24992;90164;10;82;23;1;22;.957;3600000;0
24993;166646;0;49;1;0;1;1.000;272000;0
24993;175084;22;0;0;0;0;.00nan;0;0
24993;59540;0;38;40;7;33;.825;3328000;0
24993;152717;22;43;9;2;7;.778;3600000;0
24994;13714;8;76;27;2;25;.926;3600000;0
24994;184229;35;0;0;0;0;.00nan;0;0
24994;57338;35;44;34;6;28;.824;3600000;0
24994;58830;8;0;0;0;0;.00nan;0;0
24995;3928;15;0;0;0;0;.00nan;0;0
24995;174718;12;70;36;4;32;.889;3600000;0
24995;75268;15;60;20;2;18;.900;3600000;0
24995;85798;12;0;0;0;0;.00nan;0;0
24996;165723;32;75;34;3;31;.912;3600000;0
24996;20432;32;0;0;0;0;.00nan;0;0
24996;179154;26;0;0;0;0;.00nan;0;0
24996;152835;26;84;24;1;23;.958;3600000;0
24997;186573;16;0;0;0;0;.00nan;0;0
24997;50065;16;61;14;1;13;.929;3600000;0
24997;77955;28;29;8;3;5;.625;569000;0
24997;85437;28;46;37;6;31;.838;3031000;0
24998;171838;31;70;26;2;24;.923;3600000;0
24998;183859;23;0;0;0;0;.00nan;0;0
24998;78573;23;58;25;3;22;.880;3600000;0
24998;149452;31;0;0;0;0;.00nan;0;0
24999;187537;19;0;0;0;0;.00nan;0;0
24999;178384;19;89;30;1;29;.967;3600000;0
24999;183844;29;0;0;0;0;.00nan;0;0
24999;173699;29;91;41;2;39;.951;3545000;0
25000;167642;18;0;0;0;0;.00nan;0;0
25000;173727;18;92;27;1;26;.963;3600000;0
25000;170977;30;0;0;0;0;.00nan;0;0
25000;86697;30;52;29;4;25;.862;3600000;0
25001;197940;11;0;0;0;0;.00nan;0;0
25001;170314;25;36;14;3;11;.786;2412000;0
25001;191813;25;21;9;4;5;.556;1161000;0
25001;45323;11;55;40;5;35;.875;3600000;0
25002;320;21;0;0;0;0;.00nan;0;0
25002;3284;21;99;47;2;45;.957;4016000;0
25002;3928;15;67;33;3;30;.909;4016000;0
25002;75268;15;0;0;0;0;.00nan;0;0
25003;168872;24;0;0;0;0;.00nan;0;0
25003;196090;4838;58;6;0;6;1.000;568000;0
25003;185743;4838;53;45;6;39;.867;2995000;0
25003;85727;24;55;29;4;25;.862;3600000;0
25004;162029;4182;0;0;0;0;.00nan;0;0
25004;172340;4182;80;25;2;23;.920;3567000;0
25004;13714;8;0;0;0;0;.00nan;0;0
25004;58830;8;89;32;1;31;.969;3600000;0
25005;194416;17;0;0;0;0;.00nan;0;0
25005;178413;17;77;41;3;38;.927;4200000;0
25005;179452;27;0;0;0;0;.00nan;0;0
25005;175660;27;67;34;3;31;.912;4200000;0
25006;196090;4838;91;16;0;16;1.000;3600000;0
25006;-1;5;0;0;0;0;.00nan;0;0
25006;185743;4838;0;0;0;0;.00nan;0;0
25006;61425;5;75;47;4;43;.915;3600000;0
25007;556;33;84;46;4;42;.913;3600000;0
25007;175084;22;0;0;0;0;.00nan;0;0
25007;197038;33;0;0;0;0;.00nan;0;0
25007;152717;22;84;11;0;11;1.000;3600000;0
25008;184229;35;0;0;0;0;.00nan;0;0
25008;57338;35;58;27;3;24;.889;3600000;0
25008;139409;3;0;0;0;0;.00nan;0;0
25008;148958;3;79;35;4;31;.886;3600000;0
25009;165723;32;0;0;0;0;.00nan;0;0
25009;20432;32;73;40;4;36;.900;3600000;0
25009;170977;30;0;0;0;0;.00nan;0;0
25009;86697;30;57;19;2;17;.895;3600000;0
25010;183844;29;0;0;0;0;.00nan;0;0
25010;183859;23;0;0;0;0;.00nan;0;0
25010;173699;29;56;25;3;22;.880;3513000;0
25010;78573;23;92;31;1;30;.968;3600000;0
25011;556;33;0;0;0;0;.00nan;0;0
25011;175092;9;0;0;0;0;.00nan;0;0
25011;190106;9;65;39;4;35;.897;3600000;0
25011;197038;33;86;25;1;24;.960;3600000;0
25012;166591;20;64;28;3;25;.893;3835000;0
25012;183783;20;0;0;0;0;.00nan;0;0
25012;77955;28;0;0;0;0;.00nan;0;0
25012;85437;28;75;40;4;36;.900;3835000;0
25013;320;21;0;0;0;0;.00nan;0;0
25013;3284;21;95;43;1;42;.977;3600000;0
25013;179452;27;0;0;0;0;.00nan;0;0
25013;175660;27;71;46;5;41;.891;3600000;0
25014;187578;10;99;39;1;38;.974;3600000;0
25014;168872;24;57;33;4;29;.879;3600000;0
25014;85727;24;0;0;0;0;.00nan;0;0
25014;90164;10;0;0;0;0;.00nan;0;0
25015;171838;31;66;39;5;34;.872;4200000;0
25015;179154;26;0;0;0;0;.00nan;0;0
25015;149452;31;0;0;0;0;.00nan;0;0
25015;152835;26;64;39;5;34;.872;4200000;0
25016;166646;0;0;0;0;0;.00nan;0;0
25016;175912;14;0;0;0;0;.00nan;0;0
25016;185034;14;78;12;0;12;1.000;3600000;0
25016;59540;0;66;42;5;37;.881;3600000;0
25017;187537;19;0;0;0;0;.00nan;0;0
25017;178384;19;82;41;3;38;.927;3578000;0
25017;183904;34;0;0;0;0;.00nan;0;0
25017;78806;34;63;19;1;18;.947;3600000;0
25018;197940;11;74;35;2;33;.943;3573000;0
25018;174718;12;0;0;0;0;.00nan;0;0
25018;45323;11;0;0;0;0;.00nan;0;0
25018;85798;12;77;25;1;24;.960;3600000;0
25019;13714;8;62;27;3;24;.889;3543000;0
25019;170314;25;0;0;0;0;.00nan;0;0
25019;191813;25;83;35;2;33;.943;3600000;0
25019;58830;8;0;0;0;0;.00nan;0;0
25020;194416;17;0;0;0;0;.00nan;0;0
25020;178413;17;61;32;4;28;.875;3597000;0
25020;186573;16;71;25;2;23;.920;3600000;0
25020;50065;16;0;0;0;0;.00nan;0;0
25021;162029;4182;0;0;0;0;.00nan;0;0
25021;172340;4182;84;28;1;27;.964;3600000;0
25021;167642;18;0;0;0;0;.00nan;0;0
25021;173727;18;65;23;2;21;.913;3558000;0
25022;184229;35;0;0;0;0;.00nan;0;0
25022;-1;5;0;0;0;0;.00nan;0;0
25022;57338;35;89;19;0;19;1.000;3600000;0
25022;61425;5;78;51;4;47;.922;3600000;0
25023;3928;15;0;0;0;0;.00nan;0;0
25023;183904;34;87;39;3;36;.923;3600000;0
25023;75268;15;55;36;5;31;.861;3584000;0
25023;78806;34;0;0;0;0;.00nan;0;0
25024;167642;18;61;28;3;25;.893;3600000;0
25024;173727;18;0;0;0;0;.00nan;0;0
25024;170977;30;0;0;0;0;.00nan;0;0
25024;86697;30;11;40;9;31;.775;3600000;0
25025;166646;0;0;0;0;0;.00nan;0;0
25025;59540;0;82;29;2;27;.931;3600000;0
25025;77955;28;0;0;0;0;.00nan;0;0
25025;85437;28;76;53;5;48;.906;3600000;0
25026;166591;20;61;13;1;12;.923;1152000;0
25026;3928;15;46;17;3;14;.824;3600000;0
25026;183783;20;50;33;4;29;.879;2370000;0
25026;75268;15;0;0;0;0;.00nan;0;0
25027;183844;29;0;0;0;0;.00nan;0;0
25027;173699;29;60;37;4;33;.892;3600000;0
25027;179154;26;0;0;0;0;.00nan;0;0
25027;152835;26;59;14;1;13;.929;3600000;0
25028;187537;19;0;0;0;0;.00nan;0;0
25028;178384;19;55;30;4;26;.867;3553000;0
25028;168872;24;0;0;0;0;.00nan;0;0
25028;85727;24;82;37;3;34;.919;3600000;0
25029;187578;10;0;0;0;0;.00nan;0;0
25029;174718;12;0;0;0;0;.00nan;0;0
25029;85798;12;87;39;3;36;.923;3600000;0
25029;90164;10;47;30;4;26;.867;3534000;0
25030;320;21;0;0;0;0;.00nan;0;0
25030;3284;21;75;45;4;41;.911;3524000;0
25030;175084;22;0;0;0;0;.00nan;0;0
25030;152717;22;60;21;2;19;.905;3600000;0
25031;171838;31;52;47;7;40;.851;3600000;0
25031;179452;27;0;0;0;0;.00nan;0;0
25031;175660;27;100;28;0;28;1.000;3600000;0
25031;149452;31;0;0;0;0;.00nan;0;0
25032;197940;11;0;0;0;0;.00nan;0;0
25032;165723;32;0;0;0;0;.00nan;0;0
25032;20432;32;64;26;3;23;.885;3530000;0
25032;45323;11;80;27;1;26;.963;3600000;0
25033;556;33;94;47;2;45;.957;3600000;0
25033;197038;33;0;0;0;0;.00nan;0;0
25033;139409;3;0;0;0;0;.00nan;0;0
25033;148958;3;62;18;1;17;.944;3600000;0
25034;13714;8;51;17;3;14;.824;3561000;0
25034;194416;17;0;0;0;0;.00nan;0;0
25034;178413;17;96;38;1;37;.974;3600000;0
25034;58830;8;0;0;0;0;.00nan;0;0
25035;183859;23;0;0;0;0;.00nan;0;0
25035;196090;4838;98;21;0;21;1.000;3600000;0
25035;185743;4838;0;0;0;0;.00nan;0;0
25035;78573;23;81;30;2;28;.933;3574000;0
25036;162029;4182;0;0;0;0;.00nan;0;0
25036;172340;4182;72;38;4;34;.895;4200000;0
25036;186573;16;59;31;4;27;.871;4200000;0
25036;50065;16;0;0;0;0;.00nan;0;0
25037;187578;10;71;20;1;19;.950;3600000;0
25037;-1;5;0;0;0;0;.00nan;0;0
25037;61425;5;53;27;3;24;.889;3574000;0
25037;90164;10;0;0;0;0;.00nan;0;0
25038;187537;19;0;0;0;0;.00nan;0;0
25038;178384;19;89;37;2;35;.946;3556000;0
25038;175912;14;0;0;0;0;.00nan;0;0
25038;185034;14;83;24;1;23;.958;3600000;0
25039;184229;35;0;0;0;0;.00nan;0;0
25039;175092;9;0;0;0;0;.00nan;0;0
25039;190106;9;65;31;3;28;.903;3600000;0
25039;57338;35;74;29;2;27;.931;3600000;0
25040;170314;25;0;0;0;0;.00nan;0;0
25040;191813;25;33;24;5;19;.792;3530000;0
25040;139409;3;95;43;3;40;.930;3600000;0
25040;148958;3;0;0;0;0;.00nan;0;0
25041;183844;29;0;0;0;0;.00nan;0;0
25041;173699;29;80;30;2;28;.933;3600000;0
25041;179452;27;0;0;0;0;.00nan;0;0
25041;175660;27;64;34;3;31;.912;3579000;0
25042;165723;32;0;0;0;0;.00nan;0;0
25042;20432;32;99;36;1;35;.972;3975000;0
25042;174718;12;89;37;2;35;.946;3975000;0
25042;85798;12;0;0;0;0;.00nan;0;0
25043;320;21;0;0;0;0;.00nan;0;0
25043;3284;21;70;43;4;39;.907;3771000;0
25043;183904;34;73;36;5;31;.861;3771000;0
25043;78806;34;0;0;0;0;.00nan;0;0
25044;166591;20;67;23;2;21;.913;3600000;0
25044;166646;0;0;0;0;0;.00nan;0;0
25044;183783;20;0;0;0;0;.00nan;0;0
25044;59540;0;97;59;4;55;.932;3544000;0
25045;556;33;97;41;1;40;.976;3600000;0
25045;175092;9;100;34;0;34;1.000;3600000;0
25045;190106;9;0;0;0;0;.00nan;0;0
25045;197038;33;0;0;0;0;.00nan;0;0
25046;168872;24;0;0;0;0;.00nan;0;0
25046;-1;5;78;45;4;41;.911;3583000;0
25046;61425;5;0;0;0;0;.00nan;0;0
25046;85727;24;71;21;2;19;.905;3600000;0
25047;194416;17;49;38;6;32;.842;3600000;0
25047;178413;17;0;0;0;0;.00nan;0;0
25047;175084;22;0;0;0;0;.00nan;0;0
25047;152717;22;100;22;0;22;1.000;3600000;0
25048;171838;31;0;0;0;0;.00nan;0;0
25048;3928;15;0;0;0;0;.00nan;0;0
25048;75268;15;81;26;2;24;.923;3600000;0
25048;149452;31;86;45;3;42;.933;3541000;0
25049;175912;14;91;22;0;22;1.000;3600000;0
25049;185034;14;0;0;0;0;.00nan;0;0
25049;77955;28;0;0;0;0;.00nan;0;0
25049;85437;28;86;34;2;32;.941;3570000;0
25050;170977;30;0;0;0;0;.00nan;0;0
25050;196090;4838;86;15;0;15;1.000;3600000;0
25050;185743;4838;0;0;0;0;.00nan;0;0
25050;86697;30;66;37;4;33;.892;3600000;0
25051;170314;25;0;0;0;0;.00nan;0;0
25051;179154;26;0;0;0;0;.00nan;0;0
25051;191813;25;79;28;2;26;.929;4200000;0
25051;152835;26;100;51;2;49;.961;4200000;0
25052;13714;8;58;16;2;14;.875;3600000;0
25052;186573;16;50;27;4;23;.852;3560000;0
25052;50065;16;0;0;0;0;.00nan;0;0
25052;58830;8;0;0;0;0;.00nan;0;0
25053;167642;18;0;0;0;0;.00nan;0;0
25053;183859;23;0;0;0;0;.00nan;0;0
25053;173727;18;58;28;3;25;.893;3586000;0
25053;78573;23;100;39;1;38;.974;3600000;0
25054;197940;11;75;45;4;41;.911;3600000;0
25054;162029;4182;0;0;0;0;.00nan;0;0
25054;172340;4182;65;15;1;14;.933;3600000;0
25054;45323;11;0;0;0;0;.00nan;0;0
25055;166591;20;70;42;4;38;.905;3544000;0
25055;183783;20;0;0;0;0;.00nan;0;0
25055;168872;24;0;0;0;0;.00nan;0;0
25055;85727;24;63;32;3;29;.906;3600000;0
25056;3928;15;0;0;0;0;.00nan;0;0
25056;175912;14;57;30;4;26;.867;3600000;0
25056;185034;14;0;0;0;0;.00nan;0;0
25056;75268;15;74;24;1;23;.958;3600000;0
25057;171838;31;75;39;4;35;.897;3829000;0
25057;183844;29;0;0;0;0;.00nan;0;0
25057;173699;29;66;41;5;36;.878;3829000;0
25057;149452;31;0;0;0;0;.00nan;0;0
25058;166646;0;0;0;0;0;.00nan;0;0
25058;194416;17;0;0;0;0;.00nan;0;0
25058;178413;17;68;23;2;21;.913;3600000;0
25058;59540;0;62;40;5;35;.875;3600000;0
25059;175092;9;79;22;1;21;.955;3600000;0
25059;190106;9;0;0;0;0;.00nan;0;0
25059;77955;28;0;0;0;0;.00nan;0;0
25059;85437;28;90;45;3;42;.933;3533000;0
25060;183904;34;0;0;0;0;.00nan;0;0
25060;175084;22;0;0;0;0;.00nan;0;0
25060;78806;34;75;42;3;39;.929;3600000;0
25060;152717;22;72;34;4;30;.882;3600000;0
25061;556;33;87;29;1;28;.966;3600000;0
25061;-1;5;0;0;0;0;.00nan;0;0
25061;197038;33;0;0;0;0;.00nan;0;0
25061;61425;5;69;29;2;27;.931;3600000;0
25062;320;21;0;0;0;0;.00nan;0;0
25062;3284;21;38;22;4;18;.818;3600000;0
25062;174718;12;0;0;0;0;.00nan;0;0
25062;85798;12;90;36;1;35;.972;3600000;0
25063;165723;32;0;0;0;0;.00nan;0;0
25063;20432;32;100;34;0;34;1.000;3600000;0
25063;179154;26;0;0;0;0;.00nan;0;0
25063;152835;26;89;30;1;29;.967;3554000;0
25064;13714;8;42;33;6;27;.818;3552000;0
25064;186573;16;0;0;0;0;.00nan;0;0
25064;50065;16;43;31;5;26;.839;3600000;0
25064;58830;8;0;0;0;0;.00nan;0;0
25065;184229;35;0;0;0;0;.00nan;0;0
25065;170314;25;0;0;0;0;.00nan;0;0
25065;191813;25;47;18;3;15;.833;3600000;0
25065;57338;35;49;32;5;27;.844;3561000;0
25066;183859;23;0;0;0;0;.00nan;0;0
25066;170977;30;0;0;0;0;.00nan;0;0
25066;78573;23;95;37;1;36;.973;3600000;0
25066;86697;30;41;21;4;17;.810;3600000;0
25067;179452;27;0;0;0;0;.00nan;0;0
25067;175660;27;68;22;2;20;.909;3600000;0
25067;196090;4838;80;36;3;33;.917;3555000;0
25067;185743;4838;0;0;0;0;.00nan;0;0
25068;162029;4182;0;0;0;0;.00nan;0;0
25068;172340;4182;91;39;1;38;.974;3600000;0
25068;167642;18;0;0;0;0;.00nan;0;0
25068;173727;18;49;18;2;16;.889;3556000;0
25069;320;21;35;23;4;19;.826;3534000;0
25069;3284;21;0;0;0;0;.00nan;0;0
25069;139409;3;0;0;0;0;.00nan;0;0
25069;148958;3;82;29;2;27;.931;3600000;0
25070;197940;11;63;35;4;31;.886;3552000;0
25070;187578;10;0;0;0;0;.00nan;0;0
25070;45323;11;0;0;0;0;.00nan;0;0
25070;90164;10;66;27;3;24;.889;3600000;0
25071;167642;18;0;0;0;0;.00nan;0;0
25071;173727;18;100;22;0;22;1.000;3600000;0
25071;179452;27;36;35;6;29;.829;3600000;0
25071;175660;27;0;0;0;0;.00nan;0;0
25072;187537;19;0;0;0;0;.00nan;0;0
25072;162029;4182;92;39;2;37;.949;3770000;0
25072;172340;4182;0;0;0;0;.00nan;0;0
25072;178384;19;88;27;1;26;.963;3770000;0
25073;166591;20;0;0;0;0;.00nan;0;0
25073;166646;0;0;0;0;0;.00nan;0;0
25073;183783;20;65;26;2;24;.923;3594000;0
25073;59540;0;100;33;0;33;1.000;3600000;0
25074;174718;12;0;0;0;0;.00nan;0;0
25074;-1;5;24;34;7;27;.794;3600000;0
25074;61425;5;0;0;0;0;.00nan;0;0
25074;85798;12;59;18;2;16;.889;3600000;0
25075;183844;29;0;0;0;0;.00nan;0;0
25075;173699;29;67;29;2;27;.931;3600000;0
25075;175912;14;0;0;0;0;.00nan;0;0
25075;185034;14;48;21;3;18;.857;3557000;0
25076;194416;17;49;28;4;24;.857;3600000;0
25076;178413;17;0;0;0;0;.00nan;0;0
25076;168872;24;0;0;0;0;.00nan;0;0
25076;85727;24;76;33;2;31;.939;3600000;0
25077;3928;15;40;28;5;23;.821;3556000;0
25077;183904;34;70;33;3;30;.909;3600000;0
25077;75268;15;0;0;0;0;.00nan;0;0
25077;78806;34;0;0;0;0;.00nan;0;0
25078;165723;32;0;0;0;0;.00nan;0;0
25078;20432;32;76;35;3;32;.914;3561000;0
25078;170314;25;0;0;0;0;.00nan;0;0
25078;191813;25;47;15;2;13;.867;3600000;0
25079;13714;8;66;42;5;37;.881;3600000;0
25079;179154;26;67;24;2;22;.917;3600000;0
25079;58830;8;0;0;0;0;.00nan;0;0
25079;152835;26;0;0;0;0;.00nan;0;0
25080;196090;4838;0;0;0;0;.00nan;0;0
25080;185743;4838;63;37;4;33;.892;3585000;0
25080;186573;16;0;0;0;0;.00nan;0;0
25080;50065;16;63;21;2;19;.905;3600000;0
25081;187578;10;78;31;2;29;.935;3600000;0
25081;170977;30;0;0;0;0;.00nan;0;0
25081;86697;30;48;25;4;21;.840;3566000;0
25081;90164;10;0;0;0;0;.00nan;0;0
25082;556;33;66;47;6;41;.872;3093000;0
25082;184229;35;0;0;0;0;.00nan;0;0
25082;197038;33;69;14;0;14;1.000;493000;0
25082;57338;35;46;23;4;19;.826;3600000;0
25083;166591;20;91;15;0;15;1.000;3600000;0
25083;183783;20;0;0;0;0;.00nan;0;0
25083;77955;28;0;0;0;0;.00nan;0;0
25083;85437;28;98;47;1;46;.979;3600000;0
25084;168872;24;70;33;3;30;.909;4200000;0
25084;175092;9;0;0;0;0;.00nan;0;0
25084;190106;9;88;37;3;34;.919;4200000;0
25084;85727;24;0;0;0;0;.00nan;0;0
25085;183844;29;28;28;5;23;.821;3516000;0
25085;173699;29;0;0;0;0;.00nan;0;0
25085;139409;3;0;0;0;0;.00nan;0;0
25085;148958;3;53;25;3;22;.880;3600000;0
25086;179154;26;0;0;0;0;.00nan;0;0
25086;175084;22;0;0;0;0;.00nan;0;0
25086;152717;22;37;18;4;14;.778;4007000;0
25086;152835;26;92;48;3;45;.938;4007000;0
25087;171838;31;63;34;4;30;.882;3560000;0
25087;175912;14;66;23;2;21;.913;3600000;0
25087;185034;14;0;0;0;0;.00nan;0;0
25087;149452;31;0;0;0;0;.00nan;0;0
25088;320;21;0;0;0;0;.00nan;0;0
25088;166646;0;0;0;0;0;.00nan;0;0
25088;3284;21;51;24;3;21;.875;3600000;0
25088;59540;0;67;37;4;33;.892;3581000;0
25089;3928;15;0;0;0;0;.00nan;0;0
25089;174718;12;62;40;4;36;.900;3600000;0
25089;75268;15;75;32;3;29;.906;3600000;0
25089;85798;12;0;0;0;0;.00nan;0;0
25090;187537;19;0;0;0;0;.00nan;0;0
25090;167642;18;0;0;0;0;.00nan;0;0
25090;178384;19;50;36;5;31;.861;3600000;0
25090;173727;18;68;22;2;20;.909;3600000;0
25091;556;33;0;0;0;0;.00nan;0;0
25091;184229;35;48;27;4;23;.852;3600000;0
25091;197038;33;85;26;1;25;.962;3600000;0
25091;57338;35;0;0;0;0;.00nan;0;0
25092;175092;9;99;42;1;41;.976;3600000;0
25092;190106;9;0;0;0;0;.00nan;0;0
25092;-1;5;0;0;0;0;.00nan;0;0
25092;61425;5;81;43;3;40;.930;3511000;0
25093;194416;17;0;0;0;0;.00nan;0;0
25093;178413;17;60;28;3;25;.893;3556000;0
25093;77955;28;85;24;1;23;.958;3600000;0
25093;85437;28;0;0;0;0;.00nan;0;0
25094;183904;34;34;21;4;17;.810;3600000;0
25094;175084;22;0;0;0;0;.00nan;0;0
25094;78806;34;0;0;0;0;.00nan;0;0
25094;152717;22;88;24;1;23;.958;3600000;0
25095;171838;31;0;0;0;0;.00nan;0;0
25095;139409;3;60;21;2;19;.905;3600000;0
25095;148958;3;0;0;0;0;.00nan;0;0
25095;149452;31;80;46;4;42;.913;3571000;0
25096;187537;19;57;32;4;28;.875;3581000;0
25096;178384;19;0;0;0;0;.00nan;0;0
25096;196090;4838;71;31;3;28;.903;3600000;0
25096;185743;4838;0;0;0;0;.00nan;0;0
25097;187578;10;0;0;0;0;.00nan;0;0
25097;183859;23;0;0;0;0;.00nan;0;0
25097;78573;23;47;25;4;21;.840;3543000;0
25097;90164;10;73;34;3;31;.912;3600000;0
25098;162029;4182;0;0;0;0;.00nan;0;0
25098;172340;4182;83;32;2;30;.938;3600000;0
25098;13714;8;40;19;4;15;.789;3513000;0
25098;58830;8;0;0;0;0;.00nan;0;0
25099;165723;32;0;0;0;0;.00nan;0;0
25099;20432;32;52;40;6;34;.850;3600000;0
25099;170314;25;0;0;0;0;.00nan;0;0
25099;191813;25;78;23;1;22;.957;3600000;0
25100;170977;30;70;38;4;34;.895;3600000;0
25100;179452;27;0;0;0;0;.00nan;0;0
25100;175660;27;100;33;0;33;1.000;3600000;0
25100;86697;30;0;0;0;0;.00nan;0;0
25101;166591;20;49;37;6;31;.838;3600000;0
25101;183783;20;0;0;0;0;.00nan;0;0
25101;175092;9;0;0;0;0;.00nan;0;0
25101;190106;9;91;36;3;33;.917;3600000;0
25102;320;21;0;0;0;0;.00nan;0;0
25102;3284;21;64;31;4;27;.871;3600000;0
25102;175912;14;0;0;0;0;.00nan;0;0
25102;185034;14;80;25;1;24;.960;3600000;0
25103;3928;15;74;38;4;34;.895;3903000;0
25103;175084;22;64;26;3;23;.885;3903000;0
25103;75268;15;0;0;0;0;.00nan;0;0
25103;152717;22;0;0;0;0;.00nan;0;0
25104;165723;32;20;27;6;21;.778;3087000;0
25104;20432;32;57;6;0;6;1.000;513000;0
25104;139409;3;0;0;0;0;.00nan;0;0
25104;148958;3;85;33;1;32;.970;3600000;0
25105;556;33;66;38;5;33;.868;3600000;0
25105;183859;23;0;0;0;0;.00nan;0;0
25105;197038;33;0;0;0;0;.00nan;0;0
25105;78573;23;71;29;2;27;.931;3600000;0
25106;170314;25;0;0;0;0;.00nan;0;0
25106;174718;12;0;0;0;0;.00nan;0;0
25106;191813;25;65;19;2;17;.895;3600000;0
25106;85798;12;70;40;4;36;.900;3600000;0
25107;171838;31;66;38;4;34;.895;3560000;0
25107;184229;35;0;0;0;0;.00nan;0;0
25107;57338;35;46;16;3;13;.813;3600000;0
25107;149452;31;0;0;0;0;.00nan;0;0
25108;183844;29;0;0;0;0;.00nan;0;0
25108;173699;29;64;32;3;29;.906;3600000;0
25108;186573;16;79;15;0;15;1.000;3600000;0
25108;50065;16;0;0;0;0;.00nan;0;0
25109;13714;8;0;0;0;0;.00nan;0;0
25109;183904;34;0;0;0;0;.00nan;0;0
25109;58830;8;73;21;2;19;.905;3600000;0
25109;78806;34;72;36;4;32;.889;3562000;0
25110;187537;19;0;0;0;0;.00nan;0;0
25110;187578;10;89;33;2;31;.939;3600000;0
25110;178384;19;80;24;1;23;.958;3600000;0
25110;90164;10;0;0;0;0;.00nan;0;0
25111;197940;11;0;0;0;0;.00nan;0;0
25111;194416;17;0;0;0;0;.00nan;0;0
25111;178413;17;74;30;2;28;.933;3600000;0
25111;45323;11;82;46;3;43;.935;3539000;0
25112;166646;0;0;0;0;0;.00nan;0;0
25112;167642;18;0;0;0;0;.00nan;0;0
25112;173727;18;59;19;2;17;.895;3600000;0
25112;59540;0;81;46;4;42;.913;3600000;0
25113;162029;4182;0;0;0;0;.00nan;0;0
25113;172340;4182;79;26;2;24;.923;3600000;0
25113;-1;5;0;0;0;0;.00nan;0;0
25113;61425;5;79;30;3;27;.900;3600000;0
25114;3928;15;0;0;0;0;.00nan;0;0
25114;168872;24;0;0;0;0;.00nan;0;0
25114;75268;15;58;35;4;31;.886;4200000;0
25114;85727;24;86;44;4;40;.909;4200000;0
25115;166646;0;67;12;0;12;1.000;1325000;0
25115;196090;4838;94;22;0;22;1.000;3600000;0
25115;185743;4838;0;0;0;0;.00nan;0;0
25115;59540;0;37;32;6;26;.813;2275000;0
25116;175084;22;0;0;0;0;.00nan;0;0
25116;175092;9;0;0;0;0;.00nan;0;0
25116;190106;9;55;41;5;36;.878;3600000;0
25116;152717;22;71;24;2;22;.917;3600000;0
25117;77955;28;0;0;0;0;.00nan;0;0
25117;85437;28;88;52;4;48;.923;3600000;0
25117;139409;3;0;0;0;0;.00nan;0;0
25117;148958;3;61;15;1;14;.933;3600000;0
25118;170314;25;0;0;0;0;.00nan;0;0
25118;175912;14;0;0;0;0;.00nan;0;0
25118;185034;14;69;35;4;31;.886;3600000;0
25118;191813;25;44;30;5;25;.833;3599000;0
25119;166591;20;89;26;1;25;.962;3755000;0
25119;187578;10;0;0;0;0;.00nan;0;0
25119;183783;20;0;0;0;0;.00nan;0;0
25119;90164;10;90;39;2;37;.949;3755000;0
25120;13714;8;22;4;3;1;.250;510000;0
25120;165723;32;0;0;0;0;.00nan;0;0
25120;20432;32;100;29;0;29;1.000;3600000;0
25120;58830;8;98;33;0;33;1.000;3090000;0
25121;556;33;66;28;2;26;.929;3600000;0
25121;171838;31;84;36;3;33;.917;3600000;0
25121;197038;33;0;0;0;0;.00nan;0;0
25121;149452;31;0;0;0;0;.00nan;0;0
25122;183859;23;0;0;0;0;.00nan;0;0
25122;174718;12;54;21;2;19;.905;3600000;0
25122;78573;23;75;23;1;22;.957;3600000;0
25122;85798;12;0;0;0;0;.00nan;0;0
25123;197940;11;62;29;3;26;.897;3600000;0
25123;179154;26;0;0;0;0;.00nan;0;0
25123;45323;11;0;0;0;0;.00nan;0;0
25123;152835;26;100;26;0;26;1.000;3600000;0
25124;183904;34;66;29;4;25;.862;3600000;0
25124;186573;16;78;27;1;26;.963;3600000;0
25124;50065;16;0;0;0;0;.00nan;0;0
25124;78806;34;0;0;0;0;.00nan;0;0
25125;194416;17;53;21;2;19;.905;1795000;0
25125;178413;17;31;27;6;21;.778;1805000;0
25125;170977;30;0;0;0;0;.00nan;0;0
25125;86697;30;78;13;0;13;1.000;3600000;0
25126;183844;29;0;0;0;0;.00nan;0;0
25126;173699;29;94;52;1;51;.981;4165000;0
25126;179452;27;0;0;0;0;.00nan;0;0
25126;175660;27;100;23;0;23;1.000;4165000;0
25127;167642;18;0;0;0;0;.00nan;0;0
25127;173727;18;74;19;1;18;.947;3600000;0
25127;-1;5;0;0;0;0;.00nan;0;0
25127;61425;5;67;33;3;30;.909;3534000;0
25128;162029;4182;0;0;0;0;.00nan;0;0
25128;172340;4182;59;28;3;25;.893;3600000;0
25128;184229;35;0;0;0;0;.00nan;0;0
25128;57338;35;32;31;6;25;.806;3600000;0
25129;168872;24;0;0;0;0;.00nan;0;0
25129;170314;25;0;0;0;0;.00nan;0;0
25129;191813;25;84;34;2;32;.941;3600000;0
25129;85727;24;73;39;3;36;.923;3581000;0
25130;320;21;0;0;0;0;.00nan;0;0
25130;3284;21;100;31;0;31;1.000;3600000;0
25130;3928;15;88;35;2;33;.943;3558000;0
25130;75268;15;0;0;0;0;.00nan;0;0
25131;184229;35;58;35;4;31;.886;3600000;0
25131;196090;4838;91;31;1;30;.968;3600000;0
25131;185743;4838;0;0;0;0;.00nan;0;0
25131;57338;35;0;0;0;0;.00nan;0;0
25132;187578;10;71;38;4;34;.895;3519000;0
25132;183859;23;0;0;0;0;.00nan;0;0
25132;78573;23;77;28;2;26;.929;3600000;0
25132;90164;10;0;0;0;0;.00nan;0;0
25133;13714;8;41;16;3;13;.813;3580000;0
25133;183844;29;0;0;0;0;.00nan;0;0
25133;173699;29;100;35;1;34;.971;3600000;0
25133;58830;8;0;0;0;0;.00nan;0;0
25134;171838;31;85;38;3;35;.921;3701000;0
25134;175092;9;61;31;4;27;.871;3701000;0
25134;190106;9;0;0;0;0;.00nan;0;0
25134;149452;31;0;0;0;0;.00nan;0;0
25135;320;21;0;0;0;0;.00nan;0;0
25135;3284;21;66;34;4;30;.882;3600000;0
25135;179154;26;0;0;0;0;.00nan;0;0
25135;152835;26;87;28;1;27;.964;3600000;0
25136;556;33;89;36;2;34;.944;3600000;0
25136;166591;20;0;0;0;0;.00nan;0;0
25136;183783;20;69;34;3;31;.912;3543000;0
25136;197038;33;0;0;0;0;.00nan;0;0
25137;175912;14;0;0;0;0;.00nan;0;0
25137;185034;14;75;28;1;27;.964;3600000;0
25137;139409;3;0;0;0;0;.00nan;0;0
25137;148958;3;52;29;4;25;.862;3600000;0
25138;197940;11;33;35;7;28;.800;3179000;0
25138;168872;24;97;31;1;30;.968;3600000;0
25138;45323;11;58;4;0;4;1.000;421000;0
25138;85727;24;0;0;0;0;.00nan;0;0
25139;175084;22;0;0;0;0;.00nan;0;0
25139;77955;28;0;0;0;0;.00nan;0;0
25139;85437;28;89;47;4;43;.915;3600000;0
25139;152717;22;86;14;0;14;1.000;3600000;0
25140;166646;0;0;0;0;0;.00nan;0;0
25140;162029;4182;0;0;0;0;.00nan;0;0
25140;172340;4182;61;23;2;21;.913;4200000;0
25140;59540;0;100;45;2;43;.956;4200000;0
25141;165723;32;0;0;0;0;.00nan;0;0
25141;20432;32;49;24;4;20;.833;3572000;0
25141;174718;12;0;0;0;0;.00nan;0;0
25141;85798;12;96;38;2;36;.947;3600000;0
25142;187537;19;0;0;0;0;.00nan;0;0
25142;178384;19;66;32;3;29;.906;3552000;0
25142;194416;17;0;0;0;0;.00nan;0;0
25142;178413;17;79;36;2;34;.944;3600000;0
25143;183904;34;73;30;3;27;.900;3531000;0
25143;179452;27;0;0;0;0;.00nan;0;0
25143;175660;27;74;30;2;28;.933;3600000;0
25143;78806;34;0;0;0;0;.00nan;0;0
25144;183859;23;77;32;2;30;.938;3600000;0
25144;170314;25;0;0;0;0;.00nan;0;0
25144;191813;25;54;24;3;21;.875;3544000;0
25144;78573;23;0;0;0;0;.00nan;0;0
25145;3928;15;0;0;0;0;.00nan;0;0
25145;167642;18;0;0;0;0;.00nan;0;0
25145;173727;18;60;32;4;28;.875;3600000;0
25145;75268;15;45;37;5;32;.865;3600000;0
25146;184229;35;0;0;0;0;.00nan;0;0
25146;186573;16;0;0;0;0;.00nan;0;0
25146;50065;16;58;21;2;19;.905;3512000;0
25146;57338;35;100;28;0;28;1.000;3600000;0
25147;196090;4838;0;0;0;0;.00nan;0;0
25147;-1;5;0;0;0;0;.00nan;0;0
25147;185743;4838;83;28;1;27;.964;3600000;0
25147;61425;5;42;26;4;22;.846;3600000;0
25148;197940;11;0;0;0;0;.00nan;0;0
25148;175912;14;0;0;0;0;.00nan;0;0
25148;185034;14;51;35;5;30;.857;3553000;0
25148;45323;11;71;41;4;37;.902;3600000;0
25149;187578;10;82;42;3;39;.929;4200000;0
25149;175084;22;0;0;0;0;.00nan;0;0
25149;90164;10;0;0;0;0;.00nan;0;0
25149;152717;22;78;33;3;30;.909;4200000;0
25150;556;33;89;39;3;36;.923;3600000;0
25150;165723;32;0;0;0;0;.00nan;0;0
25150;20432;32;95;42;1;41;.976;3600000;0
25150;197038;33;0;0;0;0;.00nan;0;0
25151;13714;8;67;18;1;17;.944;3600000;0
25151;175092;9;60;13;1;12;.923;1411000;0
25151;190106;9;55;31;5;26;.839;2189000;0
25151;58830;8;0;0;0;0;.00nan;0;0
25152;170977;30;0;0;0;0;.00nan;0;0
25152;77955;28;0;0;0;0;.00nan;0;0
25152;85437;28;64;37;4;33;.892;3556000;0
25152;86697;30;60;19;2;17;.895;3600000;0
25153;171838;31;60;34;4;30;.882;3559000;0
25153;167642;18;0;0;0;0;.00nan;0;0
25153;173727;18;43;9;2;7;.778;3600000;0
25153;149452;31;0;0;0;0;.00nan;0;0
25154;166646;0;60;7;0;7;1.000;810000;0
25154;162029;4182;0;0;0;0;.00nan;0;0
25154;172340;4182;63;27;3;24;.889;3600000;0
25154;59540;0;42;34;6;28;.824;2790000;0
25155;197940;11;61;42;5;37;.881;3588000;0
25155;183904;34;0;0;0;0;.00nan;0;0
25155;45323;11;0;0;0;0;.00nan;0;0
25155;78806;34;55;19;3;16;.842;3600000;0
25156;174718;12;57;23;3;20;.870;3600000;0
25156;196090;4838;0;0;0;0;.00nan;0;0
25156;185743;4838;34;24;5;19;.792;3531000;0
25156;85798;12;0;0;0;0;.00nan;0;0
25157;183844;29;0;0;0;0;.00nan;0;0
25157;173699;29;76;34;3;31;.912;3520000;0
25157;179154;26;0;0;0;0;.00nan;0;0
25157;152835;26;77;23;1;22;.957;3600000;0
25158;166591;20;64;29;2;27;.931;4200000;0
25158;183783;20;0;0;0;0;.00nan;0;0
25158;184229;35;0;0;0;0;.00nan;0;0
25158;57338;35;86;43;2;41;.953;4200000;0
25159;187537;19;0;0;0;0;.00nan;0;0
25159;178384;19;73;38;4;34;.895;3600000;0
25159;170314;25;52;32;5;27;.844;3556000;0
25159;191813;25;0;0;0;0;.00nan;0;0
25160;175092;9;67;61;7;54;.885;3600000;0
25160;190106;9;0;0;0;0;.00nan;0;0
25160;186573;16;38;19;4;15;.789;3600000;0
25160;50065;16;0;0;0;0;.00nan;0;0
25161;194416;17;0;0;0;0;.00nan;0;0
25161;178413;17;39;24;4;20;.833;3572000;0
25161;183859;23;0;0;0;0;.00nan;0;0
25161;78573;23;87;38;2;36;.947;3600000;0
25162;187578;10;0;0;0;0;.00nan;0;0
25162;90164;10;86;33;1;32;.970;3600000;0
25162;139409;3;0;0;0;0;.00nan;0;0
25162;148958;3;36;28;5;23;.821;3600000;0
25163;556;33;61;33;4;29;.879;3600000;0
25163;165723;32;0;0;0;0;.00nan;0;0
25163;20432;32;87;28;1;27;.964;3600000;0
25163;197038;33;0;0;0;0;.00nan;0;0
25164;13714;8;68;42;5;37;.881;4074000;0
25164;179452;27;0;0;0;0;.00nan;0;0
25164;175660;27;34;30;6;24;.800;4074000;0
25164;58830;8;0;0;0;0;.00nan;0;0
25165;194416;17;0;0;0;0;.00nan;0;0
25165;178413;17;61;30;3;27;.900;3600000;0
25165;77955;28;0;0;0;0;.00nan;0;0
25165;85437;28;99;45;2;43;.956;3600000;0
25166;320;21;0;0;0;0;.00nan;0;0
25166;3284;21;38;29;5;24;.828;3600000;0
25166;196090;4838;76;24;1;23;.958;3600000;0
25166;185743;4838;0;0;0;0;.00nan;0;0
25167;187537;19;0;0;0;0;.00nan;0;0
25167;178384;19;59;16;2;14;.875;3600000;0
25167;-1;5;59;36;4;32;.889;3600000;0
25167;61425;5;0;0;0;0;.00nan;0;0
25168;167642;18;0;0;0;0;.00nan;0;0
25168;183844;29;0;0;0;0;.00nan;0;0
25168;173699;29;72;18;1;17;.944;3600000;0
25168;173727;18;93;33;2;31;.939;3556000;0
25169;162029;4182;0;0;0;0;.00nan;0;0
25169;172340;4182;85;33;2;31;.939;3600000;0
25169;139409;3;66;16;1;15;.938;3600000;0
25169;148958;3;0;0;0;0;.00nan;0;0
25170;197940;11;99;38;1;37;.974;3600000;0
25170;175084;22;0;0;0;0;.00nan;0;0
25170;45323;11;0;0;0;0;.00nan;0;0
25170;152717;22;50;14;2;12;.857;3572000;0
25171;171838;31;55;31;4;27;.871;3552000;0
25171;168872;24;0;0;0;0;.00nan;0;0
25171;85727;24;68;31;3;28;.903;3600000;0
25171;149452;31;0;0;0;0;.00nan;0;0
25172;3928;15;0;0;0;0;.00nan;0;0
25172;170977;30;0;0;0;0;.00nan;0;0
25172;75268;15;53;23;3;20;.870;4200000;0
25172;86697;30;93;48;3;45;.938;4200000;0
25173;166646;0;0;0;0;0;.00nan;0;0
25173;183904;34;0;0;0;0;.00nan;0;0
25173;59540;0;100;39;0;39;1.000;3600000;0
25173;78806;34;45;18;3;15;.833;3600000;0
25174;179154;26;0;0;0;0;.00nan;0;0
25174;175912;14;65;21;2;19;.905;2649000;0
25174;185034;14;22;10;4;6;.600;909000;0
25174;152835;26;45;21;5;16;.762;3600000;0
25175;184229;35;0;0;0;0;.00nan;0;0
25175;170314;25;79;24;1;23;.958;3600000;0
25175;191813;25;0;0;0;0;.00nan;0;0
25175;57338;35;56;27;3;24;.889;3530000;0
25176;183859;23;0;0;0;0;.00nan;0;0
25176;186573;16;0;0;0;0;.00nan;0;0
25176;50065;16;64;27;3;24;.889;3600000;0
25176;78573;23;73;42;4;38;.905;3570000;0
25177;175092;9;0;0;0;0;.00nan;0;0
25177;179452;27;51;31;4;27;.871;4200000;0
25177;175660;27;0;0;0;0;.00nan;0;0
25177;190106;9;83;42;4;38;.905;4197000;0
25178;165723;32;50;28;4;24;.857;2434000;0
25178;20432;32;12;11;5;6;.545;1166000;0
25178;174718;12;0;0;0;0;.00nan;0;0
25178;85798;12;71;31;2;29;.935;3600000;0
25179;556;33;72;40;3;37;.925;3600000;0
25179;187578;10;48;27;5;22;.815;3552000;0
25179;197038;33;0;0;0;0;.00nan;0;0
25179;90164;10;0;0;0;0;.00nan;0;0
25180;3928;15;52;22;3;19;.864;3589000;0
25180;175912;14;0;0;0;0;.00nan;0;0
25180;185034;14;91;44;2;42;.955;3600000;0
25180;75268;15;0;0;0;0;.00nan;0;0
25181;197940;11;65;26;3;23;.885;3538000;0
25181;45323;11;0;0;0;0;.00nan;0;0
25181;77955;28;0;0;0;0;.00nan;0;0
25181;85437;28;63;13;1;12;.923;3600000;0
25182;162029;4182;0;0;0;0;.00nan;0;0
25182;172340;4182;92;35;2;33;.943;4200000;0
25182;194416;17;73;28;2;26;.929;4200000;0
25182;178413;17;0;0;0;0;.00nan;0;0
25183;183844;29;39;28;5;23;.821;2565000;0
25183;168872;24;0;0;0;0;.00nan;0;0
25183;173699;29;28;16;4;12;.750;1035000;0
25183;85727;24;48;22;3;19;.864;3600000;0
25184;320;21;0;0;0;0;.00nan;0;0
25184;3284;21;95;40;2;38;.950;3776000;0
25184;175084;22;0;0;0;0;.00nan;0;0
25184;152717;22;61;24;3;21;.875;3776000;0
25185;166591;20;70;43;4;39;.907;3594000;0
25185;183783;20;0;0;0;0;.00nan;0;0
25185;170977;30;0;0;0;0;.00nan;0;0
25185;86697;30;76;26;2;24;.923;3600000;0
25186;167642;18;0;0;0;0;.00nan;0;0
25186;173727;18;83;16;0;16;1.000;3600000;0
25186;-1;5;0;0;0;0;.00nan;0;0
25186;61425;5;89;42;3;39;.929;3600000;0
25187;187537;19;0;0;0;0;.00nan;0;0
25187;178384;19;93;19;0;19;1.000;3600000;0
25187;139409;3;92;27;1;26;.963;3577000;0
25187;148958;3;0;0;0;0;.00nan;0;0
25188;171838;31;0;0;0;0;.00nan;0;0
25188;196090;4838;0;0;0;0;.00nan;0;0
25188;185743;4838;57;14;1;13;.929;3542000;0
25188;149452;31;100;38;0;38;1.000;3600000;0
25189;166646;0;0;0;0;0;.00nan;0;0
25189;13714;8;0;0;0;0;.00nan;0;0
25189;58830;8;55;20;3;17;.850;3600000;0
25189;59540;0;100;38;0;38;1.000;3600000;0
25190;187578;10;0;0;0;0;.00nan;0;0
25190;184229;35;0;0;0;0;.00nan;0;0
25190;57338;35;96;30;1;29;.967;3600000;0
25190;90164;10;75;38;3;35;.921;3600000;0
25191;165723;32;0;0;0;0;.00nan;0;0
25191;20432;32;78;20;1;19;.950;3600000;0
25191;170314;25;0;0;0;0;.00nan;0;0
25191;191813;25;59;23;2;21;.913;3547000;0
25192;556;33;0;0;0;0;.00nan;0;0
25192;186573;16;68;24;2;22;.917;3600000;0
25192;197038;33;71;46;5;41;.891;3600000;0
25192;50065;16;0;0;0;0;.00nan;0;0
25193;183904;34;92;22;0;22;1.000;3600000;0
25193;174718;12;89;50;4;46;.920;3600000;0
25193;78806;34;0;0;0;0;.00nan;0;0
25193;85798;12;0;0;0;0;.00nan;0;0
25194;179154;26;0;0;0;0;.00nan;0;0
25194;175092;9;93;37;1;36;.973;4200000;0
25194;190106;9;0;0;0;0;.00nan;0;0
25194;152835;26;97;35;1;34;.971;4200000;0
25195;183859;23;0;0;0;0;.00nan;0;0
25195;179452;27;0;0;0;0;.00nan;0;0
25195;175660;27;56;11;1;10;.909;3600000;0
25195;78573;23;77;37;3;34;.919;3572000;0
25196;3928;15;0;0;0;0;.00nan;0;0
25196;175912;14;90;34;1;33;.971;3865000;0
25196;185034;14;0;0;0;0;.00nan;0;0
25196;75268;15;78;30;2;28;.933;3865000;0
25197;166646;0;0;0;0;0;.00nan;0;0
25197;-1;5;100;26;0;26;1.000;3600000;0
25197;59540;0;78;26;1;25;.962;3547000;0
25197;61425;5;0;0;0;0;.00nan;0;0
25198;168872;24;0;0;0;0;.00nan;0;0
25198;175092;9;88;62;4;58;.935;3600000;0
25198;190106;9;0;0;0;0;.00nan;0;0
25198;85727;24;67;20;2;18;.900;3600000;0
25199;162029;4182;0;0;0;0;.00nan;0;0
25199;172340;4182;70;24;2;22;.917;3600000;0
25199;77955;28;0;0;0;0;.00nan;0;0
25199;85437;28;73;36;3;33;.917;3592000;0
25200;197940;11;84;42;3;39;.929;3600000;0
25200;166591;20;56;32;4;28;.875;3543000;0
25200;183783;20;0;0;0;0;.00nan;0;0
25200;45323;11;0;0;0;0;.00nan;0;0
25201;183844;29;0;0;0;0;.00nan;0;0
25201;173699;29;78;41;3;38;.927;3553000;0
25201;196090;4838;66;15;1;14;.933;3600000;0
25201;179950;4838;0;0;0;0;.00nan;0;0
25202;320;21;0;0;0;0;.00nan;0;0
25202;3284;21;70;31;3;28;.903;3543000;0
25202;167642;18;0;0;0;0;.00nan;0;0
25202;173727;18;77;25;2;23;.920;3600000;0
25203;556;33;98;48;3;45;.938;3594000;0
25203;183904;34;55;16;2;14;.875;3600000;0
25203;197038;33;0;0;0;0;.00nan;0;0
25203;78806;34;0;0;0;0;.00nan;0;0
25204;170977;30;0;0;0;0;.00nan;0;0
25204;175084;22;0;0;0;0;.00nan;0;0
25204;86697;30;71;23;2;21;.913;3600000;0
25204;152717;22;69;29;3;26;.897;3546000;0
25205;13714;8;0;0;0;0;.00nan;0;0
25205;58830;8;77;24;1;23;.958;4200000;0
25205;139409;3;93;29;1;28;.966;4200000;0
25205;148958;3;0;0;0;0;.00nan;0;0
25206;187578;10;64;41;5;36;.878;3597000;0
25206;179154;26;0;0;0;0;.00nan;0;0
25206;90164;10;0;0;0;0;.00nan;0;0
25206;152835;26;72;31;3;28;.903;3600000;0
25207;174718;12;0;0;0;0;.00nan;0;0
25207;179452;27;0;0;0;0;.00nan;0;0
25207;175660;27;67;20;1;19;.950;3615000;0
25207;85798;12;92;47;2;45;.957;3615000;0
25208;170977;30;0;0;0;0;.00nan;0;0
25208;175912;14;0;0;0;0;.00nan;0;0
25208;185034;14;66;30;3;27;.900;4200000;0
25208;86697;30;49;20;3;17;.850;4200000;0
25209;13714;8;68;37;4;33;.892;3600000;0
25209;194416;17;0;0;0;0;.00nan;0;0
25209;178413;17;90;36;1;35;.972;3600000;0
25209;58830;8;0;0;0;0;.00nan;0;0
25210;3928;15;0;0;0;0;.00nan;0;0
25210;196090;4838;0;0;0;0;.00nan;0;0
25210;179950;4838;88;35;2;33;.943;3561000;0
25210;75268;15;73;20;1;19;.950;3600000;0
25211;167642;18;0;0;0;0;.00nan;0;0
25211;165723;32;62;9;0;9;1.000;283000;0
25211;20432;32;45;37;6;31;.838;3317000;0
25211;173727;18;66;22;2;20;.909;3600000;0
25212;183904;34;0;0;0;0;.00nan;0;0
25212;184229;35;0;0;0;0;.00nan;0;0
25212;57338;35;48;39;6;33;.846;3581000;0
25212;78806;34;43;21;4;17;.810;3600000;0
25213;162029;4182;48;38;5;33;.868;3600000;0
25213;172340;4182;0;0;0;0;.00nan;0;0
25213;201673;25;100;39;0;39;1.000;3600000;0
25213;191813;25;0;0;0;0;.00nan;0;0
25214;186573;16;0;0;0;0;.00nan;0;0
25214;50065;16;70;39;4;35;.897;3600000;0
25214;59540;23;0;0;0;0;.00nan;0;0
25214;78573;23;89;34;1;33;.971;3600000;0
25215;187537;19;0;0;0;0;.00nan;0;0
25215;166646;0;0;0;0;0;.00nan;0;0
25215;188888;0;42;23;4;19;.826;3600000;0
25215;178384;19;90;27;1;26;.963;3600000;0
25216;183844;29;0;0;0;0;.00nan;0;0
25216;173699;29;77;26;1;25;.962;3600000;0
25216;-1;5;49;35;5;30;.857;3600000;0
25216;61425;5;0;0;0;0;.00nan;0;0
25217;168872;24;0;0;0;0;.00nan;0;0
25217;85727;24;64;17;1;16;.941;3600000;0
25217;139409;3;68;34;3;31;.912;3541000;0
25217;148958;3;0;0;0;0;.00nan;0;0
25218;201673;25;43;17;3;14;.824;3790000;0
25218;191813;25;0;0;0;0;.00nan;0;0
25218;77955;28;0;0;0;0;.00nan;0;0
25218;85437;28;62;34;4;30;.882;3768000;0
25219;13714;8;86;15;0;15;1.000;3600000;0
25219;175092;9;0;0;0;0;.00nan;0;0
25219;190106;9;96;43;3;40;.930;3600000;0
25219;58830;8;0;0;0;0;.00nan;0;0
25220;194416;17;66;11;0;11;1.000;1181000;0
25220;178413;17;30;25;5;20;.800;2379000;0
25220;139409;3;0;0;0;0;.00nan;0;0
25220;148958;3;82;37;3;34;.919;3600000;0
25221;187578;10;0;0;0;0;.00nan;0;0
25221;165723;32;0;0;0;0;.00nan;0;0
25221;20432;32;47;30;5;25;.833;3600000;0
25221;90164;10;75;28;2;26;.929;3600000;0
25222;556;33;72;36;4;32;.889;3600000;0
25222;171838;31;0;0;0;0;.00nan;0;0
25222;197038;33;0;0;0;0;.00nan;0;0
25222;149452;31;43;29;5;24;.828;3600000;0
25223;3928;15;63;35;5;30;.857;3622000;0
25223;179154;26;0;0;0;0;.00nan;0;0
25223;75268;15;0;0;0;0;.00nan;0;0
25223;152835;26;64;32;4;28;.875;3622000;0
25224;166646;0;75;43;4;39;.907;3550000;0
25224;188888;0;0;0;0;0;.00nan;0;0
25224;59540;23;54;20;3;17;.850;3600000;0
25224;78573;23;0;0;0;0;.00nan;0;0
25225;187537;19;0;0;0;0;.00nan;0;0
25225;178384;19;60;34;4;30;.882;3600000;0
25225;170977;30;49;34;5;29;.853;3572000;0
25225;86697;30;0;0;0;0;.00nan;0;0
25226;167642;18;93;38;1;37;.974;4200000;0
25226;173727;18;0;0;0;0;.00nan;0;0
25226;174718;12;0;0;0;0;.00nan;0;0
25226;85798;12;95;42;1;41;.976;4200000;0
25227;197940;11;76;40;3;37;.925;3600000;0
25227;186573;16;0;0;0;0;.00nan;0;0
25227;45323;11;0;0;0;0;.00nan;0;0
25227;50065;16;77;23;1;22;.957;3600000;0
25228;179452;27;0;0;0;0;.00nan;0;0
25228;175660;27;65;29;2;27;.931;3600000;0
25228;175912;14;0;0;0;0;.00nan;0;0
25228;185034;14;92;47;3;44;.936;3543000;0
25229;320;21;66;27;2;25;.926;3549000;0
25229;3284;21;0;0;0;0;.00nan;0;0
25229;-1;5;0;0;0;0;.00nan;0;0
25229;61425;5;99;42;1;41;.976;3600000;0
25230;166591;20;86;51;5;46;.902;3600000;0
25230;183783;20;0;0;0;0;.00nan;0;0
25230;168872;24;0;0;0;0;.00nan;0;0
25230;85727;24;100;30;0;30;1.000;3600000;0
25231;556;33;0;0;0;0;.00nan;0;0
25231;183844;29;0;0;0;0;.00nan;0;0
25231;173699;29;44;27;4;23;.852;3541000;0
25231;197038;33;97;37;2;35;.946;3600000;0
25232;183904;34;82;27;1;26;.963;3600000;0
25232;201673;25;59;24;3;21;.875;3580000;0
25232;191813;25;0;0;0;0;.00nan;0;0
25232;78806;34;0;0;0;0;.00nan;0;0
25233;171838;31;44;34;6;28;.824;3739000;0
25233;77955;28;70;16;1;15;.938;1960000;0
25233;85437;28;48;25;4;21;.840;1779000;0
25233;149452;31;0;0;0;0;.00nan;0;0
25234;187578;10;87;46;3;43;.935;4125000;0
25234;13714;8;64;29;2;27;.931;4099000;0
25234;58830;8;0;0;0;0;.00nan;0;0
25234;90164;10;0;0;0;0;.00nan;0;0
25235;174718;12;0;0;0;0;.00nan;0;0
25235;186573;16;67;23;2;21;.913;3600000;0
25235;50065;16;0;0;0;0;.00nan;0;0
25235;85798;12;65;33;4;29;.879;3574000;0
25236;194416;17;0;0;0;0;.00nan;0;0
25236;178413;17;36;32;5;27;.844;3530000;0
25236;184229;35;0;0;0;0;.00nan;0;0
25236;57338;35;67;29;3;26;.897;3600000;0
25237;175092;9;0;0;0;0;.00nan;0;0
25237;190106;9;78;23;1;22;.957;3600000;0
25237;139409;3;84;43;4;39;.907;3600000;0
25237;148958;3;0;0;0;0;.00nan;0;0
25238;165723;32;0;0;0;0;.00nan;0;0
25238;168872;24;0;0;0;0;.00nan;0;0
25238;20432;32;66;34;4;30;.882;3600000;0
25238;85727;24;100;26;0;26;1.000;3600000;0
25239;197940;11;0;0;0;0;.00nan;0;0
25239;166646;0;0;0;0;0;.00nan;0;0
25239;188888;0;83;35;2;33;.943;3600000;0
25239;45323;11;78;35;3;32;.914;3566000;0
25240;3928;15;74;22;1;21;.955;4179000;0
25240;179154;26;0;0;0;0;.00nan;0;0
25240;75268;15;0;0;0;0;.00nan;0;0
25240;152835;26;94;41;2;39;.951;4179000;0
25241;187537;19;0;0;0;0;.00nan;0;0
25241;178384;19;76;28;2;26;.929;3557000;0
25241;59540;23;66;19;1;18;.947;3600000;0
25241;78573;23;0;0;0;0;.00nan;0;0
25242;162029;4182;0;0;0;0;.00nan;0;0
25242;172340;4182;40;23;5;18;.783;4001000;0
25242;196090;4838;40;38;6;32;.842;3959000;0
25242;179950;4838;0;0;0;0;.00nan;0;0
25243;175084;22;0;0;0;0;.00nan;0;0
25243;179452;27;0;0;0;0;.00nan;0;0
25243;175660;27;94;20;0;20;1.000;3600000;0
25243;152717;22;41;22;4;18;.818;3600000;0
25244;167642;18;0;0;0;0;.00nan;0;0
25244;173727;18;71;37;3;34;.919;3600000;0
25244;175912;14;0;0;0;0;.00nan;0;0
25244;185034;14;62;33;4;29;.879;3577000;0
25245;187578;10;0;0;0;0;.00nan;0;0
25245;194416;17;81;26;1;25;.962;4097000;0
25245;178413;17;0;0;0;0;.00nan;0;0
25245;90164;10;91;37;2;35;.946;4097000;0
25246;320;21;0;0;0;0;.00nan;0;0
25246;556;33;17;23;6;17;.739;1791000;0
25246;3284;21;62;22;2;20;.909;3600000;0
25246;197038;33;86;33;1;32;.970;1809000;0
25247;171838;31;0;0;0;0;.00nan;0;0
25247;-1;5;0;0;0;0;.00nan;0;0
25247;61425;5;57;23;2;21;.913;3600000;0
25247;149452;31;48;43;6;37;.860;3600000;0
25248;165723;32;56;11;1;10;.909;812000;0
25248;183904;34;68;27;3;24;.889;3600000;0
25248;20432;32;46;35;6;29;.829;2788000;0
25248;78806;34;0;0;0;0;.00nan;0;0
25249;175912;14;63;37;4;33;.892;3561000;0
25249;196090;4838;0;0;0;0;.00nan;0;0
25249;185034;14;0;0;0;0;.00nan;0;0
25249;179950;4838;70;33;3;30;.909;3600000;0
25250;166646;0;84;44;4;40;.909;3600000;0
25250;188888;0;0;0;0;0;.00nan;0;0
25250;170977;30;0;0;0;0;.00nan;0;0
25250;86697;30;59;12;1;11;.917;3600000;0
25251;184229;35;0;0;0;0;.00nan;0;0
25251;175092;9;65;34;4;30;.882;3578000;0
25251;190106;9;0;0;0;0;.00nan;0;0
25251;57338;35;49;19;3;16;.842;3600000;0
25252;168872;24;0;0;0;0;.00nan;0;0
25252;179452;27;0;0;0;0;.00nan;0;0
25252;175660;27;68;28;2;26;.929;3600000;0
25252;85727;24;94;41;3;38;.927;3563000;0
25253;183844;29;0;0;0;0;.00nan;0;0
25253;173699;29;80;27;2;25;.926;3600000;0
25253;174718;12;69;29;3;26;.897;3546000;0
25253;85798;12;0;0;0;0;.00nan;0;0
25254;175084;22;0;0;0;0;.00nan;0;0
25254;186573;16;0;0;0;0;.00nan;0;0
25254;50065;16;89;31;1;30;.968;3600000;0
25254;152717;22;64;35;3;32;.914;3550000;0
25255;197940;11;80;40;3;37;.925;3600000;0
25255;201673;25;89;20;0;20;1.000;3600000;0
25255;191813;25;0;0;0;0;.00nan;0;0
25255;45323;11;0;0;0;0;.00nan;0;0
25256;162029;4182;52;17;2;15;.882;1269000;0
25256;172340;4182;29;29;6;23;.793;2331000;0
25256;167642;18;0;0;0;0;.00nan;0;0
25256;173727;18;78;27;2;25;.926;3600000;0
25257;165723;32;0;0;0;0;.00nan;0;0
25257;20432;32;63;23;2;21;.913;3600000;0
25257;-1;5;0;0;0;0;.00nan;0;0
25257;61425;5;94;36;1;35;.972;3600000;0
25258;194416;17;0;0;0;0;.00nan;0;0
25258;178413;17;47;33;5;28;.848;3857000;0
25258;139409;3;58;44;6;38;.864;3857000;0
25258;148958;3;0;0;0;0;.00nan;0;0
25259;171838;31;66;41;5;36;.878;3600000;0
25259;187578;10;78;25;1;24;.960;3600000;0
25259;90164;10;0;0;0;0;.00nan;0;0
25259;149452;31;0;0;0;0;.00nan;0;0
25260;183904;34;79;22;1;21;.955;3600000;0
25260;179452;27;0;0;0;0;.00nan;0;0
25260;175660;27;73;47;4;43;.915;3600000;0
25260;78806;34;0;0;0;0;.00nan;0;0
25261;556;33;93;49;3;46;.939;3560000;0
25261;3928;15;72;17;1;16;.941;3600000;0
25261;197038;33;0;0;0;0;.00nan;0;0
25261;75268;15;0;0;0;0;.00nan;0;0
25262;179154;26;0;0;0;0;.00nan;0;0
25262;59540;23;70;29;3;26;.897;3553000;0
25262;78573;23;0;0;0;0;.00nan;0;0
25262;152835;26;68;17;1;16;.941;3600000;0
25263;166591;20;75;31;2;29;.935;3600000;0
25263;187537;19;32;33;6;27;.818;3600000;0
25263;183783;20;0;0;0;0;.00nan;0;0
25263;178384;19;0;0;0;0;.00nan;0;0
25264;196090;4838;0;0;0;0;.00nan;0;0
25264;179950;4838;60;22;2;20;.909;3600000;0
25264;77955;28;49;1;0;1;1.000;307000;0
25264;85437;28;59;44;6;38;.864;3293000;0
25265;162029;4182;0;0;0;0;.00nan;0;0
25265;172340;4182;60;32;3;29;.906;3531000;0
25265;175912;14;0;0;0;0;.00nan;0;0
25265;185034;14;72;23;1;22;.957;3600000;0
25266;183844;29;51;44;6;38;.864;3600000;0
25266;173699;29;0;0;0;0;.00nan;0;0
25266;186573;16;40;21;4;17;.810;2972000;0
25266;50065;16;25;5;3;2;.400;573000;0
25267;166646;0;62;52;6;46;.885;3600000;0
25267;188888;0;0;0;0;0;.00nan;0;0
25267;184229;35;0;0;0;0;.00nan;0;0
25267;57338;35;67;18;1;17;.944;3600000;0
25268;320;21;0;0;0;0;.00nan;0;0
25268;3284;21;100;23;0;23;1.000;3600000;0
25268;175092;9;0;0;0;0;.00nan;0;0
25268;190106;9;85;29;1;28;.966;3590000;0
25269;3928;15;0;0;0;0;.00nan;0;0
25269;13714;8;48;34;5;29;.853;3796000;0
25269;58830;8;0;0;0;0;.00nan;0;0
25269;75268;15;50;22;4;18;.818;3796000;0
25270;170977;30;0;0;0;0;.00nan;0;0
25270;201673;25;67;20;2;18;.900;3569000;0
25270;191813;25;0;0;0;0;.00nan;0;0
25270;86697;30;99;36;1;35;.972;3600000;0
25271;197940;11;100;36;0;36;1.000;3600000;0
25271;179154;26;32;24;5;19;.792;3600000;0
25271;45323;11;0;0;0;0;.00nan;0;0
25271;152835;26;0;0;0;0;.00nan;0;0
25272;167642;18;0;0;0;0;.00nan;0;0
25272;173727;18;51;17;2;15;.882;3600000;0
25272;77955;28;80;42;4;38;.905;3538000;0
25272;85437;28;0;0;0;0;.00nan;0;0
25273;320;21;0;0;0;0;.00nan;0;0
25273;3284;21;47;21;3;18;.857;3596000;0
25273;168872;24;0;0;0;0;.00nan;0;0
25273;85727;24;91;29;2;27;.931;3600000;0
25274;187578;10;0;0;0;0;.00nan;0;0
25274;-1;5;0;0;0;0;.00nan;0;0
25274;61425;5;82;35;2;33;.943;3514000;0
25274;90164;10;100;34;0;34;1.000;3600000;0
25275;183904;34;56;13;1;12;.923;3600000;0
25275;78806;34;0;0;0;0;.00nan;0;0
25275;139409;3;0;0;0;0;.00nan;0;0
25275;148958;3;59;41;5;36;.878;3600000;0
25276;194416;17;79;22;1;21;.955;3600000;0
25276;178413;17;0;0;0;0;.00nan;0;0
25276;175092;9;86;40;3;37;.925;3514000;0
25276;190106;9;0;0;0;0;.00nan;0;0
25277;171838;31;98;53;2;51;.962;3553000;0
25277;186573;16;0;0;0;0;.00nan;0;0
25277;50065;16;74;21;1;20;.952;3600000;0
25277;149452;31;0;0;0;0;.00nan;0;0
25278;165723;32;47;16;3;13;.813;552000;0
25278;20432;32;53;28;4;24;.857;3048000;0
25278;196090;4838;0;0;0;0;.00nan;0;0
25278;179950;4838;100;34;1;33;.971;3600000;0
25279;556;33;73;46;5;41;.891;3600000;0
25279;174718;12;0;0;0;0;.00nan;0;0
25279;197038;33;0;0;0;0;.00nan;0;0
25279;85798;12;79;27;2;25;.926;3600000;0
25280;166591;20;82;42;3;39;.929;3600000;0
25280;183783;20;0;0;0;0;.00nan;0;0
25280;59540;23;70;26;2;24;.923;3600000;0
25280;78573;23;0;0;0;0;.00nan;0;0
25281;187537;19;0;0;0;0;.00nan;0;0
25281;178384;19;67;44;6;38;.864;3778000;0
25281;201673;25;38;26;5;21;.808;3778000;0
25281;191813;25;0;0;0;0;.00nan;0;0
25282;179452;27;0;0;0;0;.00nan;0;0
25282;175660;27;81;17;1;16;.941;3600000;0
25282;175912;14;0;0;0;0;.00nan;0;0
25282;185034;14;71;29;3;26;.897;3600000;0
25283;183844;29;0;0;0;0;.00nan;0;0
25283;173699;29;83;54;5;49;.907;3600000;0
25283;175084;22;62;16;1;15;.938;3600000;0
25283;152717;22;0;0;0;0;.00nan;0;0
25284;167642;18;0;0;0;0;.00nan;0;0
25284;13714;8;0;0;0;0;.00nan;0;0
25284;173727;18;49;32;5;27;.844;3600000;0
25284;58830;8;87;34;2;32;.941;3600000;0
25285;170977;30;0;0;0;0;.00nan;0;0
25285;179154;26;0;0;0;0;.00nan;0;0
25285;86697;30;49;26;4;22;.846;3524000;0
25285;152835;26;74;25;2;23;.920;3600000;0
25286;187578;10;65;31;3;28;.903;3514000;0
25286;175092;9;0;0;0;0;.00nan;0;0
25286;190106;9;89;27;1;26;.963;3600000;0
25286;90164;10;0;0;0;0;.00nan;0;0
25287;3928;15;78;28;1;27;.964;3600000;0
25287;165723;32;0;0;0;0;.00nan;0;0
25287;20432;32;78;39;3;36;.923;3537000;0
25287;75268;15;0;0;0;0;.00nan;0;0
25288;187537;19;0;0;0;0;.00nan;0;0
25288;178384;19;96;33;1;32;.970;3600000;0
25288;174718;12;0;0;0;0;.00nan;0;0
25288;85798;12;74;38;4;34;.895;3600000;0
25289;162029;4182;0;0;0;0;.00nan;0;0
25289;172340;4182;84;25;1;24;.960;3600000;0
25289;77955;28;0;0;0;0;.00nan;0;0
25289;85437;28;67;46;6;40;.870;3600000;0
25290;320;21;0;0;0;0;.00nan;0;0
25290;3284;21;71;31;3;28;.903;3600000;0
25290;186573;16;0;0;0;0;.00nan;0;0
25290;50065;16;28;25;6;19;.760;3600000;0
25291;179452;27;35;21;4;17;.810;3587000;0
25291;175660;27;0;0;0;0;.00nan;0;0
25291;-1;5;0;0;0;0;.00nan;0;0
25291;61425;5;99;56;2;54;.964;3600000;0
25292;194416;17;0;0;0;0;.00nan;0;0
25292;178413;17;99;41;2;39;.951;3600000;0
25292;175912;14;63;28;3;25;.893;3544000;0
25292;185034;14;0;0;0;0;.00nan;0;0
25293;175084;22;0;0;0;0;.00nan;0;0
25293;139409;3;62;42;6;36;.857;2646000;0
25293;148958;3;45;13;2;11;.846;954000;0
25293;152717;22;78;28;2;26;.929;3600000;0
25294;171838;31;72;27;1;26;.963;1437000;0
25294;168872;24;0;0;0;0;.00nan;0;0
25294;85727;24;53;20;2;18;.900;3600000;0
25294;149452;31;39;35;6;29;.829;2163000;0
25295;166646;0;0;0;0;0;.00nan;0;0
25295;188888;0;68;31;3;28;.903;3576000;0
25295;184229;35;0;0;0;0;.00nan;0;0
25295;57338;35;80;25;1;24;.960;3600000;0
25296;183844;29;84;47;5;42;.894;3600000;0
25296;183904;34;61;21;2;19;.905;3600000;0
25296;173699;29;0;0;0;0;.00nan;0;0
25296;78806;34;0;0;0;0;.00nan;0;0
25297;556;33;100;54;1;53;.981;4200000;0
25297;196090;4838;64;18;1;17;.944;4200000;0
25297;179950;4838;0;0;0;0;.00nan;0;0
25297;197038;33;0;0;0;0;.00nan;0;0
25298;201673;25;86;30;1;29;.967;3600000;0
25298;191813;25;0;0;0;0;.00nan;0;0
25298;59540;23;58;30;4;26;.867;3600000;0
25298;78573;23;0;0;0;0;.00nan;0;0
25299;197940;11;90;37;2;35;.946;3600000;0
25299;166591;20;50;22;3;19;.864;3548000;0
25299;183783;20;0;0;0;0;.00nan;0;0
25299;45323;11;0;0;0;0;.00nan;0;0
25300;167642;18;0;0;0;0;.00nan;0;0
25300;173727;18;49;32;5;27;.844;3846000;0
25300;179154;26;86;27;2;25;.926;2744000;0
25300;152835;26;37;19;4;15;.789;1102000;0
25301;166591;20;39;8;2;6;.750;504000;0
25301;183783;20;43;49;7;42;.857;3096000;0
25301;170977;30;0;0;0;0;.00nan;0;0
25301;86697;30;88;16;0;16;1.000;3600000;0
25302;194416;17;0;0;0;0;.00nan;0;0
25302;178413;17;77;37;3;34;.919;3684000;0
25302;174718;12;0;0;0;0;.00nan;0;0
25302;85798;12;69;36;4;32;.889;3684000;0
25303;166591;20;78;31;3;28;.903;4200000;0
25303;183783;20;0;0;0;0;.00nan;0;0
25303;179154;26;0;0;0;0;.00nan;0;0
25303;152835;26;67;27;3;24;.889;4200000;0
25304;162029;4182;0;0;0;0;.00nan;0;0
25304;172340;4182;89;36;2;34;.944;3600000;0
25304;170977;30;0;0;0;0;.00nan;0;0
25304;86697;30;59;30;3;27;.900;3600000;0
25305;194416;17;0;0;0;0;.00nan;0;0
25305;178413;17;69;19;1;18;.947;3600000;0
25305;-1;5;0;0;0;0;.00nan;0;0
25305;61425;5;76;43;4;39;.907;3600000;0
25306;167642;18;0;0;0;0;.00nan;0;0
25306;173727;18;71;19;1;18;.947;4200000;0
25306;174718;12;96;56;1;55;.982;4200000;0
25306;85798;12;0;0;0;0;.00nan;0;0
25307;162029;4182;0;0;0;0;.00nan;0;0
25307;172340;4182;99;45;1;44;.978;3600000;0
25307;196090;4838;0;0;0;0;.00nan;0;0
25307;179950;4838;62;23;2;21;.913;3563000;0
25308;13714;8;0;0;0;0;.00nan;0;0
25308;175912;14;0;0;0;0;.00nan;0;0
25308;185034;14;90;17;0;17;1.000;3600000;0
25308;58830;8;71;32;2;30;.938;3600000;0
25309;166646;0;0;0;0;0;.00nan;0;0
25309;188888;0;79;41;3;38;.927;3567000;0
25309;183904;34;45;12;2;10;.833;3600000;0
25309;78806;34;0;0;0;0;.00nan;0;0
25310;175092;9;73;44;5;39;.886;3600000;0
25310;190106;9;0;0;0;0;.00nan;0;0
25310;59540;23;58;23;3;20;.870;3600000;0
25310;78573;23;0;0;0;0;.00nan;0;0
25311;165723;32;0;0;0;0;.00nan;0;0
25311;20432;32;61;21;2;19;.905;3600000;0
25311;77955;28;0;0;0;0;.00nan;0;0
25311;85437;28;97;55;3;52;.945;3546000;0
25312;197940;11;63;46;6;40;.870;3600000;0
25312;320;21;0;0;0;0;.00nan;0;0
25312;3284;21;74;22;1;21;.955;3600000;0
25312;45323;11;0;0;0;0;.00nan;0;0
25313;187578;10;70;25;2;23;.920;2856000;0
25313;183844;29;0;0;0;0;.00nan;0;0
25313;173699;29;85;33;2;31;.939;3600000;0
25313;90164;10;19;8;4;4;.500;744000;0
25314;13714;8;93;48;2;46;.958;3600000;0
25314;168872;24;67;33;3;30;.909;3546000;0
25314;58830;8;0;0;0;0;.00nan;0;0
25314;85727;24;0;0;0;0;.00nan;0;0
25315;184229;35;0;0;0;0;.00nan;0;0
25315;175084;22;0;0;0;0;.00nan;0;0
25315;57338;35;82;41;3;38;.927;3536000;0
25315;152717;22;84;28;1;27;.964;3600000;0
25316;3928;15;83;33;2;31;.939;3600000;0
25316;75268;15;0;0;0;0;.00nan;0;0
25316;139409;3;0;0;0;0;.00nan;0;0
25316;148958;3;30;30;7;23;.767;3600000;0
25317;187537;19;0;0;0;0;.00nan;0;0
25317;178384;19;80;46;3;43;.935;3544000;0
25317;179452;27;0;0;0;0;.00nan;0;0
25317;175660;27;54;19;2;17;.895;3600000;0
25318;171838;31;49;32;5;27;.844;2367000;0
25318;175912;14;0;0;0;0;.00nan;0;0
25318;185034;14;72;19;1;18;.947;3600000;0
25318;149452;31;75;20;1;19;.950;1233000;0
25319;166646;0;62;31;4;27;.871;2906000;0
25319;165723;32;0;0;0;0;.00nan;0;0
25319;188888;0;26;17;4;13;.765;694000;0
25319;20432;32;63;16;1;15;.938;3600000;0
25320;556;33;84;60;3;57;.950;4136000;0
25320;201673;25;67;22;2;20;.909;4136000;0
25320;197038;33;0;0;0;0;.00nan;0;0
25320;191813;25;0;0;0;0;.00nan;0;0
25321;197940;11;99;42;1;41;.976;3600000;0
25321;175092;9;66;33;3;30;.909;3565000;0
25321;190106;9;0;0;0;0;.00nan;0;0
25321;45323;11;0;0;0;0;.00nan;0;0
25322;3928;15;80;34;2;32;.941;3543000;0
25322;183844;29;0;0;0;0;.00nan;0;0
25322;173699;29;95;36;1;35;.972;3600000;0
25322;75268;15;0;0;0;0;.00nan;0;0
25323;168872;24;0;0;0;0;.00nan;0;0
25323;59540;23;70;39;4;35;.897;3554000;0
25323;78573;23;0;0;0;0;.00nan;0;0
25323;85727;24;59;23;3;20;.870;3600000;0
25324;187578;10;48;29;4;25;.862;3569000;0
25324;184229;35;0;0;0;0;.00nan;0;0
25324;57338;35;80;39;3;36;.923;3600000;0
25324;90164;10;0;0;0;0;.00nan;0;0
25325;171838;31;0;0;0;0;.00nan;0;0
25325;183904;34;0;0;0;0;.00nan;0;0
25325;78806;34;69;15;1;14;.933;3600000;0
25325;149452;31;79;36;2;34;.944;3565000;0
25326;320;21;0;0;0;0;.00nan;0;0
25326;3284;21;89;20;0;20;1.000;3600000;0
25326;13714;8;0;0;0;0;.00nan;0;0
25326;58830;8;53;30;4;26;.867;3600000;0
25327;179452;27;0;0;0;0;.00nan;0;0
25327;175660;27;80;36;3;33;.917;3565000;0
25327;186573;16;70;22;2;20;.909;3600000;0
25327;50065;16;0;0;0;0;.00nan;0;0
25328;556;33;94;43;2;41;.953;3600000;0
25328;175084;22;0;0;0;0;.00nan;0;0
25328;197038;33;0;0;0;0;.00nan;0;0
25328;152717;22;49;22;3;19;.864;3565000;0
25329;175912;14;0;0;0;0;.00nan;0;0
25329;201673;25;99;39;1;38;.974;3600000;0
25329;185034;14;52;33;4;29;.879;3600000;0
25329;191813;25;0;0;0;0;.00nan;0;0
25330;187537;19;0;0;0;0;.00nan;0;0
25330;178384;19;80;40;5;35;.875;3600000;0
25330;196090;4838;50;16;2;14;.875;3600000;0
25330;179950;4838;0;0;0;0;.00nan;0;0
25331;179154;26;0;0;0;0;.00nan;0;0
25331;77955;28;0;0;0;0;.00nan;0;0
25331;85437;28;74;44;5;39;.886;3514000;0
25331;152835;26;78;31;3;28;.903;3600000;0
25332;197940;11;99;44;2;42;.955;3600000;0
25332;-1;5;64;32;3;29;.906;3572000;0
25332;45323;11;0;0;0;0;.00nan;0;0
25332;61425;5;0;0;0;0;.00nan;0;0
25333;165723;32;0;0;0;0;.00nan;0;0
25333;20432;32;55;21;3;18;.857;3600000;0
25333;139409;3;91;36;2;34;.944;3600000;0
25333;148958;3;0;0;0;0;.00nan;0;0
25334;183904;34;59;20;2;18;.900;3600000;0
25334;59540;23;68;36;4;32;.889;3580000;0
25334;78573;23;0;0;0;0;.00nan;0;0
25334;78806;34;0;0;0;0;.00nan;0;0
25335;3928;15;54;17;2;15;.882;3600000;0
25335;175092;9;68;40;4;36;.900;3572000;0
25335;190106;9;0;0;0;0;.00nan;0;0
25335;75268;15;0;0;0;0;.00nan;0;0
25336;13714;8;54;23;3;20;.870;3600000;0
25336;183844;29;0;0;0;0;.00nan;0;0
25336;173699;29;100;49;2;47;.959;3600000;0
25336;58830;8;0;0;0;0;.00nan;0;0
25337;320;21;0;0;0;0;.00nan;0;0
25337;3284;21;77;39;3;36;.923;4200000;0
25337;168872;24;0;0;0;0;.00nan;0;0
25337;85727;24;67;29;3;26;.897;4200000;0
25338;166591;20;63;29;3;26;.897;3600000;0
25338;171838;31;0;0;0;0;.00nan;0;0
25338;183783;20;0;0;0;0;.00nan;0;0
25338;149452;31;59;41;5;36;.878;3549000;0
25339;166646;0;74;44;4;40;.909;3600000;0
25339;188888;0;0;0;0;0;.00nan;0;0
25339;194416;17;0;0;0;0;.00nan;0;0
25339;178413;17;51;14;2;12;.857;3600000;0
25340;187578;10;0;0;0;0;.00nan;0;0
25340;170977;30;0;0;0;0;.00nan;0;0
25340;86697;30;51;27;4;23;.852;3536000;0
25340;90164;10;68;27;2;25;.926;3600000;0
25341;184229;35;0;0;0;0;.00nan;0;0
25341;175084;22;41;18;4;14;.778;3553000;0
25341;57338;35;99;50;3;47;.940;3600000;0
25341;152717;22;0;0;0;0;.00nan;0;0
25342;174718;12;0;0;0;0;.00nan;0;0
25342;186573;16;90;22;0;22;1.000;3600000;0
25342;50065;16;0;0;0;0;.00nan;0;0
25342;85798;12;85;28;1;27;.964;3558000;0
25343;187537;19;0;0;0;0;.00nan;0;0
25343;167642;18;0;0;0;0;.00nan;0;0
25343;178384;19;100;55;1;54;.982;4200000;0
25343;173727;18;97;37;1;36;.973;4200000;0
25344;179154;26;0;0;0;0;.00nan;0;0
25344;139409;3;0;0;0;0;.00nan;0;0
25344;148958;3;62;33;3;30;.909;3600000;0
25344;152835;26;63;35;4;31;.886;3589000;0
25345;197940;11;0;0;0;0;.00nan;0;0
25345;3928;15;0;0;0;0;.00nan;0;0
25345;45323;11;61;32;4;28;.875;3600000;0
25345;75268;15;100;18;0;18;1.000;3600000;0
25346;168872;24;0;0;0;0;.00nan;0;0
25346;170977;30;0;0;0;0;.00nan;0;0
25346;85727;24;80;38;4;34;.895;3838000;0
25346;86697;30;66;44;5;39;.886;3838000;0
25347;175912;14;34;22;5;17;.773;3600000;0
25347;185034;14;0;0;0;0;.00nan;0;0
25347;59540;23;98;32;1;31;.969;3600000;0
25347;78573;23;0;0;0;0;.00nan;0;0
25348;187578;10;67;38;4;34;.895;3600000;0
25348;186573;16;74;17;1;16;.941;3600000;0
25348;50065;16;0;0;0;0;.00nan;0;0
25348;90164;10;0;0;0;0;.00nan;0;0
25349;556;33;43;50;7;43;.860;3600000;0
25349;179452;27;0;0;0;0;.00nan;0;0
25349;175660;27;67;31;3;28;.903;3600000;0
25349;197038;33;0;0;0;0;.00nan;0;0
25350;171838;31;0;0;0;0;.00nan;0;0
25350;175092;9;0;0;0;0;.00nan;0;0
25350;190106;9;43;22;4;18;.818;4081000;0
25350;149452;31;57;42;5;37;.881;4074000;0
25351;167642;18;0;0;0;0;.00nan;0;0
25351;173727;18;87;18;0;18;1.000;3600000;0
25351;77955;28;0;0;0;0;.00nan;0;0
25351;85437;28;81;49;5;44;.898;3600000;0
25352;196090;4838;62;23;3;20;.870;3600000;0
25352;179950;4838;0;0;0;0;.00nan;0;0
25352;139409;3;100;34;0;34;1.000;3600000;0
25352;148958;3;0;0;0;0;.00nan;0;0
25353;166591;20;77;43;3;40;.930;3810000;0
25353;183783;20;0;0;0;0;.00nan;0;0
25353;194416;17;0;0;0;0;.00nan;0;0
25353;178413;17;65;21;2;19;.905;3810000;0
25354;166646;0;74;44;4;40;.909;3600000;0
25354;188888;0;0;0;0;0;.00nan;0;0
25354;179154;26;0;0;0;0;.00nan;0;0
25354;152835;26;54;8;1;7;.875;3600000;0
25355;3928;15;0;0;0;0;.00nan;0;0
25355;13714;8;100;41;2;39;.951;3600000;0
25355;58830;8;0;0;0;0;.00nan;0;0
25355;75268;15;66;27;3;24;.889;3560000;0
25356;183904;34;91;36;2;34;.944;3600000;0
25356;170977;30;0;0;0;0;.00nan;0;0
25356;78806;34;0;0;0;0;.00nan;0;0
25356;86697;30;57;26;3;23;.885;3600000;0
25357;320;21;0;0;0;0;.00nan;0;0
25357;3284;21;77;25;2;23;.920;3600000;0
25357;165723;32;0;0;0;0;.00nan;0;0
25357;20432;32;78;41;4;37;.902;3585000;0
25358;168872;24;0;0;0;0;.00nan;0;0
25358;174718;12;89;31;2;29;.935;3551000;0
25358;85727;24;91;33;1;32;.970;3600000;0
25358;85798;12;0;0;0;0;.00nan;0;0
25359;197940;11;71;43;5;38;.884;3600000;0
25359;201673;25;93;30;1;29;.967;3600000;0
25359;191813;25;0;0;0;0;.00nan;0;0
25359;45323;11;0;0;0;0;.00nan;0;0
25360;187537;19;0;0;0;0;.00nan;0;0
25360;178384;19;63;36;4;32;.889;3553000;0
25360;-1;5;0;0;0;0;.00nan;0;0
25360;61425;5;80;36;3;33;.917;3600000;0
25361;183844;29;62;8;0;8;1.000;519000;0
25361;173699;29;70;44;5;39;.886;3081000;0
25361;175084;22;0;0;0;0;.00nan;0;0
25361;152717;22;71;19;2;17;.895;3600000;0
25362;162029;4182;0;0;0;0;.00nan;0;0
25362;172340;4182;93;34;1;33;.971;3600000;0
25362;184229;35;0;0;0;0;.00nan;0;0
25362;57338;35;74;32;2;30;.938;3576000;0
25363;556;33;31;29;6;23;.793;2690000;0
25363;186573;16;81;29;1;28;.966;3600000;0
25363;197038;33;57;11;1;10;.909;910000;0
25363;50065;16;0;0;0;0;.00nan;0;0
25364;170977;30;0;0;0;0;.00nan;0;0
25364;175092;9;65;27;3;24;.889;3568000;0
25364;190106;9;0;0;0;0;.00nan;0;0
25364;86697;30;74;20;1;19;.950;3600000;0
25365;183844;29;21;22;6;16;.727;3600000;0
25365;173699;29;0;0;0;0;.00nan;0;0
25365;77955;28;0;0;0;0;.00nan;0;0
25365;85437;28;97;40;1;39;.975;3600000;0
25366;167642;18;0;0;0;0;.00nan;0;0
25366;168872;24;0;0;0;0;.00nan;0;0
25366;173727;18;68;29;3;26;.897;3579000;0
25366;85727;24;90;38;2;36;.947;3600000;0
25367;175912;14;0;0;0;0;.00nan;0;0
25367;185034;14;60;33;5;28;.848;3600000;0
25367;139409;3;95;20;0;20;1.000;3600000;0
25367;148958;3;0;0;0;0;.00nan;0;0
25368;194416;17;0;0;0;0;.00nan;0;0
25368;178413;17;84;31;1;30;.968;3600000;0
25368;196090;4838;75;36;3;33;.917;3555000;0
25368;179950;4838;0;0;0;0;.00nan;0;0
25369;171838;31;69;39;4;35;.897;3600000;0
25369;13714;8;69;16;1;15;.938;3600000;0
25369;58830;8;0;0;0;0;.00nan;0;0
25369;149452;31;0;0;0;0;.00nan;0;0
25370;166646;0;0;0;0;0;.00nan;0;0
25370;187578;10;0;0;0;0;.00nan;0;0
25370;188888;0;74;42;4;38;.905;3572000;0
25370;90164;10;85;29;2;27;.931;3600000;0
25371;187537;19;0;0;0;0;.00nan;0;0
25371;178384;19;91;33;1;32;.970;3600000;0
25371;179154;26;0;0;0;0;.00nan;0;0
25371;152835;26;67;33;3;30;.909;3570000;0
25372;175084;22;55;29;2;27;.931;4142000;0
25372;201673;25;81;27;1;26;.963;4142000;0
25372;191813;25;0;0;0;0;.00nan;0;0
25372;152717;22;0;0;0;0;.00nan;0;0
25373;162029;4182;0;0;0;0;.00nan;0;0
25373;172340;4182;82;37;3;34;.919;3575000;0
25373;59540;23;73;19;1;18;.947;3600000;0
25373;78573;23;0;0;0;0;.00nan;0;0
25374;165723;32;0;0;0;0;.00nan;0;0
25374;20432;32;67;26;2;24;.923;3548000;0
25374;174718;12;0;0;0;0;.00nan;0;0
25374;85798;12;87;33;1;32;.970;3600000;0
25375;197940;11;86;30;1;29;.967;3600000;0
25375;-1;5;0;0;0;0;.00nan;0;0
25375;45323;11;0;0;0;0;.00nan;0;0
25375;61425;5;82;35;2;33;.943;3557000;0
25376;320;21;0;0;0;0;.00nan;0;0
25376;3284;21;88;31;1;30;.968;3600000;0
25376;186573;16;25;36;7;29;.806;3600000;0
25376;50065;16;0;0;0;0;.00nan;0;0
25377;187537;19;0;0;0;0;.00nan;0;0
25377;165723;32;0;0;0;0;.00nan;0;0
25377;178384;19;76;32;3;29;.906;3566000;0
25377;20432;32;88;33;2;31;.939;3600000;0
25378;194416;17;0;0;0;0;.00nan;0;0
25378;178413;17;75;29;2;27;.931;3600000;0
25378;201673;25;0;0;0;0;.00nan;0;0
25378;191813;25;51;21;3;18;.857;3549000;0
25379;-1;5;0;0;0;0;.00nan;0;0
25379;59540;23;100;36;0;36;1.000;3600000;0
25379;61425;5;60;31;3;28;.903;3600000;0
25379;78573;23;0;0;0;0;.00nan;0;0
25380;167642;18;0;0;0;0;.00nan;0;0
25380;173727;18;50;20;3;17;.850;3527000;0
25380;175092;9;0;0;0;0;.00nan;0;0
25380;190106;9;100;49;1;48;.980;3600000;0
25381;556;33;0;0;0;0;.00nan;0;0
25381;197038;33;58;24;3;21;.875;3600000;0
25381;77955;28;0;0;0;0;.00nan;0;0
25381;85437;28;78;45;4;41;.911;3593000;0
25382;179154;26;0;0;0;0;.00nan;0;0
25382;174718;12;0;0;0;0;.00nan;0;0
25382;85798;12;65;44;5;39;.886;3600000;0
25382;152835;26;72;27;2;25;.926;3600000;0
25383;171838;31;0;0;0;0;.00nan;0;0
25383;183844;29;0;0;0;0;.00nan;0;0
25383;173699;29;80;31;1;30;.968;3600000;0
25383;149452;31;100;30;0;30;1.000;3600000;0
25384;3928;15;63;36;4;32;.889;3579000;0
25384;75268;15;0;0;0;0;.00nan;0;0
25384;139409;3;72;31;3;28;.903;3600000;0
25384;148958;3;0;0;0;0;.00nan;0;0
25385;166646;0;91;47;3;44;.936;3836000;0
25385;188888;0;0;0;0;0;.00nan;0;0
25385;196090;4838;36;16;4;12;.750;3836000;0
25385;179950;4838;0;0;0;0;.00nan;0;0
25386;187578;10;83;29;1;28;.966;3600000;0
25386;168872;24;0;0;0;0;.00nan;0;0
25386;85727;24;87;56;5;51;.911;3600000;0
25386;90164;10;0;0;0;0;.00nan;0;0
25387;197940;11;48;33;5;28;.848;3600000;0
25387;184229;35;0;0;0;0;.00nan;0;0
25387;45323;11;0;0;0;0;.00nan;0;0
25387;57338;35;60;22;2;20;.909;3600000;0
25388;166591;20;69;26;2;24;.923;3600000;0
25388;162029;4182;0;0;0;0;.00nan;0;0
25388;172340;4182;46;33;5;28;.848;3600000;0
25388;183783;20;0;0;0;0;.00nan;0;0
25389;320;21;58;38;4;34;.895;3600000;0
25389;3284;21;0;0;0;0;.00nan;0;0
25389;179452;27;0;0;0;0;.00nan;0;0
25389;175660;27;66;17;1;16;.941;3600000;0
25390;183904;34;97;35;1;34;.971;3600000;0
25390;175912;14;0;0;0;0;.00nan;0;0
25390;185034;14;61;29;3;26;.897;3585000;0
25390;78806;34;0;0;0;0;.00nan;0;0
25391;13714;8;0;0;0;0;.00nan;0;0
25391;186573;16;0;0;0;0;.00nan;0;0
25391;50065;16;43;28;5;23;.821;3554000;0
25391;58830;8;60;34;4;30;.882;3600000;0
25392;167642;18;0;0;0;0;.00nan;0;0
25392;173727;18;42;38;6;32;.842;3600000;0
25392;175084;22;0;0;0;0;.00nan;0;0
25392;152717;22;79;23;1;22;.957;3600000;0
25393;196090;4838;83;25;1;24;.960;3600000;0
25393;179950;4838;0;0;0;0;.00nan;0;0
25393;77955;28;0;0;0;0;.00nan;0;0
25393;85437;28;79;36;3;33;.917;3600000;0
25394;165723;32;0;0;0;0;.00nan;0;0
25394;20432;32;74;37;4;33;.892;3600000;0
25394;175092;9;64;43;5;38;.884;3551000;0
25394;190106;9;0;0;0;0;.00nan;0;0
25395;166646;0;20;31;7;24;.774;3600000;0
25395;188888;0;0;0;0;0;.00nan;0;0
25395;179154;26;0;0;0;0;.00nan;0;0
25395;152835;26;70;14;1;13;.929;3600000;0
25396;197940;11;80;39;4;35;.897;3618000;0
25396;556;33;52;32;5;27;.844;3618000;0
25396;197038;33;0;0;0;0;.00nan;0;0
25396;45323;11;0;0;0;0;.00nan;0;0
25397;170977;30;56;23;2;21;.913;3940000;0
25397;-1;5;0;0;0;0;.00nan;0;0
25397;61425;5;85;43;3;40;.930;3940000;0
25397;86697;30;0;0;0;0;.00nan;0;0
25398;187537;19;0;0;0;0;.00nan;0;0
25398;178384;19;63;24;2;22;.917;3584000;0
25398;186573;16;100;34;0;34;1.000;3600000;0
25398;50065;16;0;0;0;0;.00nan;0;0
25399;184229;35;0;0;0;0;.00nan;0;0
25399;57338;35;87;29;1;28;.966;3600000;0
25399;59540;23;65;40;5;35;.875;3600000;0
25399;78573;23;0;0;0;0;.00nan;0;0
25400;162029;4182;0;0;0;0;.00nan;0;0
25400;172340;4182;73;40;3;37;.925;3543000;0
25400;179452;27;0;0;0;0;.00nan;0;0
25400;175660;27;69;23;2;21;.913;3600000;0
25401;320;21;0;0;0;0;.00nan;0;0
25401;3284;21;69;36;4;32;.889;3550000;0
25401;201673;25;83;32;2;30;.938;3600000;0
25401;191813;25;0;0;0;0;.00nan;0;0
25402;171838;31;0;0;0;0;.00nan;0;0
25402;194416;17;0;0;0;0;.00nan;0;0
25402;178413;17;40;21;3;18;.857;4200000;0
25402;149452;31;88;38;3;35;.921;4200000;0
25403;194416;17;28;28;6;22;.786;3600000;0
25403;183844;29;0;0;0;0;.00nan;0;0
25403;178413;17;0;0;0;0;.00nan;0;0
25403;173699;29;74;33;3;30;.909;3600000;0
25404;165723;32;79;26;1;25;.962;3600000;0
25404;20432;32;0;0;0;0;.00nan;0;0
25404;175912;14;0;0;0;0;.00nan;0;0
25404;185034;14;62;26;3;23;.885;3516000;0
25405;183904;34;81;41;3;38;.927;3553000;0
25405;175084;22;0;0;0;0;.00nan;0;0
25405;78806;34;0;0;0;0;.00nan;0;0
25405;152717;22;61;15;1;14;.933;3600000;0
25406;3928;15;82;26;1;25;.962;3600000;0
25406;168872;24;0;0;0;0;.00nan;0;0
25406;75268;15;0;0;0;0;.00nan;0;0
25406;85727;24;74;39;4;35;.897;3600000;0
25407;556;33;52;10;1;9;.900;618000;0
25407;184229;35;69;26;2;24;.923;3600000;0
25407;197038;33;37;37;6;31;.838;2982000;0
25407;57338;35;0;0;0;0;.00nan;0;0
25408;197940;11;0;0;0;0;.00nan;0;0
25408;13714;8;89;29;1;28;.966;3600000;0
25408;45323;11;52;38;5;33;.868;3600000;0
25408;58830;8;0;0;0;0;.00nan;0;0
25409;174718;12;0;0;0;0;.00nan;0;0
25409;179452;27;67;24;2;22;.917;3930000;0
25409;175660;27;0;0;0;0;.00nan;0;0
25409;85798;12;60;32;3;29;.906;3930000;0
25410;166591;20;91;45;3;42;.933;3567000;0
25410;167642;18;61;16;1;15;.938;3600000;0
25410;183783;20;0;0;0;0;.00nan;0;0
25410;173727;18;0;0;0;0;.00nan;0;0
25411;77955;28;0;0;0;0;.00nan;0;0
25411;85437;28;69;31;3;28;.903;3600000;0
25411;139409;3;45;29;5;24;.828;3531000;0
25411;148958;3;0;0;0;0;.00nan;0;0
25412;187578;10;0;0;0;0;.00nan;0;0
25412;201673;25;94;22;0;22;1.000;3600000;0
25412;191813;25;0;0;0;0;.00nan;0;0
25412;90164;10;88;49;4;45;.918;3600000;0
25413;166591;20;71;39;3;36;.923;3600000;0
25413;183783;20;0;0;0;0;.00nan;0;0
25413;196090;4838;90;29;1;28;.966;3600000;0
25413;179950;4838;0;0;0;0;.00nan;0;0
25414;166646;0;0;0;0;0;.00nan;0;0
25414;188888;0;83;52;5;47;.904;4057000;0
25414;186573;16;0;0;0;0;.00nan;0;0
25414;50065;16;31;21;4;17;.810;4057000;0
25415;187537;19;100;29;0;29;1.000;3600000;0
25415;178384;19;0;0;0;0;.00nan;0;0
25415;175092;9;89;36;2;34;.944;3554000;0
25415;190106;9;0;0;0;0;.00nan;0;0
25416;320;21;0;0;0;0;.00nan;0;0
25416;3284;21;91;43;2;41;.953;3600000;0
25416;183844;29;0;0;0;0;.00nan;0;0
25416;173699;29;63;45;5;40;.889;3600000;0
25417;13714;8;0;0;0;0;.00nan;0;0
25417;-1;5;0;0;0;0;.00nan;0;0
25417;58830;8;95;21;0;21;1.000;3600000;0
25417;61425;5;88;53;4;49;.925;3600000;0
25418;168872;24;73;38;3;35;.921;3812000;0
25418;175912;14;0;0;0;0;.00nan;0;0
25418;185034;14;74;28;2;26;.929;3808000;0
25418;85727;24;0;0;0;0;.00nan;0;0
25419;165723;32;0;0;0;0;.00nan;0;0
25419;194416;17;0;0;0;0;.00nan;0;0
25419;178413;17;75;38;3;35;.921;3600000;0
25419;20432;32;54;36;6;30;.833;3600000;0
25420;175084;22;0;0;0;0;.00nan;0;0
25420;139409;3;0;0;0;0;.00nan;0;0
25420;148958;3;96;45;2;43;.956;3600000;0
25420;152717;22;50;19;3;16;.842;3543000;0
25421;171838;31;0;0;0;0;.00nan;0;0
25421;3928;15;62;19;2;17;.895;3749000;0
25421;75268;15;0;0;0;0;.00nan;0;0
25421;149452;31;100;55;1;54;.982;3749000;0
25422;183904;34;83;26;1;25;.962;3600000;0
25422;179154;26;0;0;0;0;.00nan;0;0
25422;78806;34;0;0;0;0;.00nan;0;0
25422;152835;26;65;30;3;27;.900;3568000;0
25423;175092;9;0;0;0;0;.00nan;0;0
25423;190106;9;66;42;5;37;.881;3600000;0
25423;59540;23;47;23;4;19;.826;3600000;0
25423;78573;23;0;0;0;0;.00nan;0;0
25424;197940;11;30;39;7;32;.821;2560000;0
25424;170977;30;0;0;0;0;.00nan;0;0
25424;45323;11;53;11;1;10;.909;1040000;0
25424;86697;30;64;22;2;20;.909;3600000;0
25425;166646;0;72;44;4;40;.909;3600000;0
25425;188888;0;0;0;0;0;.00nan;0;0
25425;179452;27;0;0;0;0;.00nan;0;0
25425;175660;27;91;30;1;29;.967;3600000;0
25426;167642;18;0;0;0;0;.00nan;0;0
25426;173727;18;65;15;2;13;.867;3600000;0
25426;174718;12;0;0;0;0;.00nan;0;0
25426;85798;12;91;62;4;58;.935;3600000;0
25427;166591;20;0;0;0;0;.00nan;0;0
25427;183783;20;72;34;3;31;.912;3600000;0
25427;77955;28;0;0;0;0;.00nan;0;0
25427;85437;28;89;55;5;50;.909;3600000;0
25428;184229;35;0;0;0;0;.00nan;0;0
25428;201673;25;84;36;2;34;.944;3600000;0
25428;191813;25;0;0;0;0;.00nan;0;0
25428;57338;35;87;44;4;40;.909;3581000;0
25429;556;33;75;41;4;37;.902;3901000;0
25429;187537;19;54;29;3;26;.897;3901000;0
25429;178384;19;0;0;0;0;.00nan;0;0
25429;197038;33;0;0;0;0;.00nan;0;0
25430;168872;24;0;0;0;0;.00nan;0;0
25430;85727;24;83;30;2;28;.933;4019000;0
25430;139409;3;79;33;3;30;.909;4019000;0
25430;148958;3;0;0;0;0;.00nan;0;0
25431;171838;31;0;0;0;0;.00nan;0;0
25431;183904;34;0;0;0;0;.00nan;0;0
25431;78806;34;54;16;2;14;.875;4176000;0
25431;149452;31;97;51;2;49;.961;4200000;0
25432;187578;10;59;30;3;27;.900;3919000;0
25432;175912;14;0;0;0;0;.00nan;0;0
25432;185034;14;81;44;4;40;.909;3919000;0
25432;90164;10;0;0;0;0;.00nan;0;0
25433;3928;15;57;21;2;19;.905;3518000;0
25433;183844;29;0;0;0;0;.00nan;0;0
25433;173699;29;100;30;0;30;1.000;3600000;0
25433;75268;15;0;0;0;0;.00nan;0;0
25434;320;21;0;0;0;0;.00nan;0;0
25434;3284;21;45;18;3;15;.833;3600000;0
25434;165723;32;0;0;0;0;.00nan;0;0
25434;20432;32;59;41;6;35;.854;3600000;0
25435;166646;0;37;32;6;26;.813;3128000;0
25435;13714;8;0;0;0;0;.00nan;0;0
25435;188888;0;61;8;0;8;1.000;472000;0
25435;58830;8;71;24;2;22;.917;3600000;0
25436;179154;26;0;0;0;0;.00nan;0;0
25436;-1;5;82;34;1;33;.971;4200000;0
25436;61425;5;0;0;0;0;.00nan;0;0
25436;152835;26;83;24;1;23;.958;4200000;0
25437;194416;17;0;0;0;0;.00nan;0;0
25437;178413;17;73;31;2;29;.935;3558000;0
25437;179452;27;0;0;0;0;.00nan;0;0
25437;175660;27;83;26;1;25;.962;3600000;0
25438;197940;11;46;34;5;29;.853;3566000;0
25438;175092;9;0;0;0;0;.00nan;0;0
25438;190106;9;39;26;5;21;.808;3600000;0
25438;45323;11;0;0;0;0;.00nan;0;0
25439;187537;19;0;0;0;0;.00nan;0;0
25439;178384;19;47;29;5;24;.828;3677000;0
25439;59540;23;71;36;4;32;.889;3677000;0
25439;78573;23;0;0;0;0;.00nan;0;0
25440;556;33;0;0;0;0;.00nan;0;0
25440;170977;30;0;0;0;0;.00nan;0;0
25440;197038;33;69;43;4;39;.907;3600000;0
25440;86697;30;71;16;1;15;.938;3600000;0
25441;162029;4182;0;0;0;0;.00nan;0;0
25441;172340;4182;81;38;3;35;.921;3600000;0
25441;174718;12;50;1;0;1;1.000;250000;0
25441;85798;12;32;27;6;21;.778;3350000;0
25442;167642;18;0;0;0;0;.00nan;0;0
25442;173727;18;82;27;1;26;.963;3600000;0
25442;196090;4838;52;30;4;26;.867;3600000;0
25442;179950;4838;0;0;0;0;.00nan;0;0
25443;171838;31;79;49;5;44;.898;3600000;0
25443;168872;24;58;24;3;21;.875;3600000;0
25443;85727;24;0;0;0;0;.00nan;0;0
25443;149452;31;0;0;0;0;.00nan;0;0
25444;187578;10;0;0;0;0;.00nan;0;0
25444;175084;22;0;0;0;0;.00nan;0;0
25444;90164;10;90;55;2;53;.964;3600000;0
25444;152717;22;52;19;3;16;.842;3546000;0
25445;320;21;71;30;3;27;.900;3798000;0
25445;3284;21;0;0;0;0;.00nan;0;0
25445;77955;28;100;49;2;47;.959;3798000;0
25445;85437;28;0;0;0;0;.00nan;0;0
25446;166591;20;59;39;5;34;.872;4146000;0
25446;183783;20;0;0;0;0;.00nan;0;0
25446;175912;14;59;45;6;39;.867;4146000;0
25446;185034;14;0;0;0;0;.00nan;0;0
25447;201673;25;95;23;0;23;1.000;4200000;0
25447;-1;5;0;0;0;0;.00nan;0;0
25447;191813;25;0;0;0;0;.00nan;0;0
25447;61425;5;97;44;0;44;1.000;4200000;0
25448;184229;35;0;0;0;0;.00nan;0;0
25448;186573;16;72;30;3;27;.900;3864000;0
25448;50065;16;0;0;0;0;.00nan;0;0
25448;57338;35;79;25;2;23;.920;3864000;0
25449;174718;12;39;27;5;22;.815;3600000;0
25449;196090;4838;0;0;0;0;.00nan;0;0
25449;179950;4838;52;40;6;34;.850;3553000;0
25449;85798;12;0;0;0;0;.00nan;0;0
25450;3928;15;0;0;0;0;.00nan;0;0
25450;194416;17;0;0;0;0;.00nan;0;0
25450;178413;17;100;25;0;25;1.000;3600000;0
25450;75268;15;75;33;2;31;.939;3550000;0
25451;165723;32;0;0;0;0;.00nan;0;0
25451;183904;34;52;11;2;9;.818;3600000;0
25451;20432;32;80;46;4;42;.913;3535000;0
25451;78806;34;0;0;0;0;.00nan;0;0
25452;187537;19;0;0;0;0;.00nan;0;0
25452;167642;18;0;0;0;0;.00nan;0;0
25452;178384;19;75;47;4;43;.915;3600000;0
25452;173727;18;69;19;1;18;.947;3600000;0
25453;170977;30;0;0;0;0;.00nan;0;0
25453;175092;9;0;0;0;0;.00nan;0;0
25453;190106;9;70;47;6;41;.872;3600000;0
25453;86697;30;58;11;1;10;.909;3600000;0
25454;3928;15;53;10;1;9;.900;3600000;0
25454;-1;5;0;0;0;0;.00nan;0;0
25454;61425;5;70;51;5;46;.902;3600000;0
25454;75268;15;0;0;0;0;.00nan;0;0
25455;183844;29;0;0;0;0;.00nan;0;0
25455;173699;29;76;26;1;25;.962;3600000;0
25455;77955;28;0;0;0;0;.00nan;0;0
25455;85437;28;92;46;3;43;.935;3548000;0
25456;186573;16;0;0;0;0;.00nan;0;0
25456;50065;16;99;36;1;35;.972;3600000;0
25456;139409;3;60;42;6;36;.857;3600000;0
25456;148958;3;0;0;0;0;.00nan;0;0
25457;171838;31;0;0;0;0;.00nan;0;0
25457;187578;10;32;19;5;14;.737;3533000;0
25457;90164;10;0;0;0;0;.00nan;0;0
25457;149452;31;87;40;3;37;.925;3600000;0
25458;166646;0;79;34;2;32;.941;3545000;0
25458;188888;0;0;0;0;0;.00nan;0;0
25458;179452;27;0;0;0;0;.00nan;0;0
25458;175660;27;94;32;1;31;.969;3600000;0
25459;320;21;0;0;0;0;.00nan;0;0
25459;556;33;100;45;0;45;1.000;3600000;0
25459;3284;21;69;31;2;29;.935;3523000;0
25459;197038;33;0;0;0;0;.00nan;0;0
25460;194416;17;0;0;0;0;.00nan;0;0
25460;178413;17;77;32;3;29;.906;3600000;0
25460;174718;12;0;0;0;0;.00nan;0;0
25460;85798;12;48;32;5;27;.844;3575000;0
25461;184229;35;0;0;0;0;.00nan;0;0
25461;179154;26;0;0;0;0;.00nan;0;0
25461;57338;35;100;34;0;34;1.000;3600000;0
25461;152835;26;62;27;3;24;.889;3600000;0
25462;167642;18;0;0;0;0;.00nan;0;0
25462;173727;18;74;24;2;22;.917;3600000;0
25462;59540;23;72;34;3;31;.912;3600000;0
25462;78573;23;0;0;0;0;.00nan;0;0
25463;13714;8;0;0;0;0;.00nan;0;0
25463;165723;32;47;36;5;31;.861;3600000;0
25463;20432;32;0;0;0;0;.00nan;0;0
25463;58830;8;96;21;0;21;1.000;3600000;0
25464;197940;11;91;51;4;47;.922;3576000;0
25464;175084;22;0;0;0;0;.00nan;0;0
25464;45323;11;0;0;0;0;.00nan;0;0
25464;152717;22;55;17;2;15;.882;3600000;0
25465;162029;4182;42;3;1;2;.667;256000;0
25465;172340;4182;46;36;6;30;.833;3344000;0
25465;168872;24;0;0;0;0;.00nan;0;0
25465;85727;24;100;34;1;33;.971;3600000;0
25466;166591;20;83;33;2;31;.939;3689000;0
25466;183783;20;0;0;0;0;.00nan;0;0
25466;175912;14;100;44;1;43;.977;3689000;0
25466;185034;14;0;0;0;0;.00nan;0;0
25467;187537;19;0;0;0;0;.00nan;0;0
25467;178384;19;100;47;2;45;.957;3600000;0
25467;179154;26;51;26;3;23;.885;3600000;0
25467;152835;26;0;0;0;0;.00nan;0;0
25468;175092;9;92;44;2;42;.955;3555000;0
25468;179452;27;0;0;0;0;.00nan;0;0
25468;175660;27;72;17;1;16;.941;3600000;0
25468;190106;9;0;0;0;0;.00nan;0;0
25469;320;21;100;41;1;40;.976;2837000;0
25469;166591;20;46;4;1;3;.750;850000;0
25469;3284;21;30;12;4;8;.667;763000;0
25469;183783;20;22;23;6;17;.739;2680000;0
25470;167642;5;0;0;0;0;.00nan;0;0
25470;183904;34;58;30;4;26;.867;3538000;0
25470;170314;5;72;31;3;28;.903;3600000;0
25470;78806;34;0;0;0;0;.00nan;0;0
25471;183844;29;0;0;0;0;.00nan;0;0
25471;173699;29;87;22;1;21;.955;3600000;0
25471;139409;3;41;30;5;25;.833;3600000;0
25471;148958;3;0;0;0;0;.00nan;0;0
25472;171838;31;0;0;0;0;.00nan;0;0
25472;77955;28;0;0;0;0;.00nan;0;0
25472;85437;28;46;29;4;25;.862;3537000;0
25472;149452;31;94;32;2;30;.938;3600000;0
25473;166646;0;55;45;6;39;.867;3303000;0
25473;188888;0;59;6;0;6;1.000;297000;0
25473;186573;16;0;0;0;0;.00nan;0;0
25473;50065;16;84;26;1;25;.962;3600000;0
25474;165723;32;0;0;0;0;.00nan;0;0
25474;20432;32;81;26;1;25;.962;3600000;0
25474;184229;35;0;0;0;0;.00nan;0;0
25474;57338;35;49;21;3;18;.857;3566000;0
25475;556;33;60;25;3;22;.880;3600000;0
25475;174718;12;0;0;0;0;.00nan;0;0
25475;197038;33;0;0;0;0;.00nan;0;0
25475;85798;12;69;45;5;40;.889;3587000;0
25476;13714;8;0;0;0;0;.00nan;0;0
25476;201673;25;51;31;4;27;.871;3545000;0
25476;191813;25;0;0;0;0;.00nan;0;0
25476;58830;8;47;20;3;17;.850;3600000;0
25477;170977;30;0;0;0;0;.00nan;0;0
25477;175084;22;0;0;0;0;.00nan;0;0
25477;86697;30;63;30;3;27;.900;3600000;0
25477;152717;22;92;19;0;19;1.000;3600000;0
25478;197940;11;56;45;5;40;.889;3600000;0
25478;173727;18;100;24;0;24;1.000;3600000;0
25478;45323;11;0;0;0;0;.00nan;0;0
25478;61425;18;0;0;0;0;.00nan;0;0
25479;162029;4182;42;13;2;11;.846;2162000;0
25479;172340;4182;11;17;6;11;.647;1438000;0
25479;196090;4838;0;0;0;0;.00nan;0;0
25479;179950;4838;60;26;3;23;.885;3600000;0
25480;194416;17;0;0;0;0;.00nan;0;0
25480;178413;17;59;22;2;20;.909;3600000;0
25480;186573;16;50;24;3;21;.875;3582000;0
25480;50065;16;0;0;0;0;.00nan;0;0
25481;187578;10;53;35;5;30;.857;4188000;0
25481;3928;15;76;42;4;38;.905;4164000;0
25481;75268;15;0;0;0;0;.00nan;0;0
25481;90164;10;0;0;0;0;.00nan;0;0
25482;168872;24;0;0;0;0;.00nan;0;0
25482;196090;4838;37;28;5;23;.821;3600000;0
25482;179950;4838;0;0;0;0;.00nan;0;0
25482;85727;24;62;36;4;32;.889;3600000;0
25483;320;21;0;0;0;0;.00nan;0;0
25483;3284;21;64;21;2;19;.905;3562000;0
25483;184229;35;0;0;0;0;.00nan;0;0
25483;57338;35;84;28;1;27;.964;3600000;0
25484;183904;34;70;23;2;21;.913;3838000;0
25484;175092;9;0;0;0;0;.00nan;0;0
25484;190106;9;92;47;3;44;.936;3838000;0
25484;78806;34;0;0;0;0;.00nan;0;0
25485;187537;19;0;0;0;0;.00nan;0;0
25485;178384;19;66;40;4;36;.900;3600000;0
25485;170977;30;0;0;0;0;.00nan;0;0
25485;86697;30;88;26;1;25;.962;3600000;0
25486;13714;8;0;0;0;0;.00nan;0;0
25486;174718;12;87;39;2;37;.949;3922000;0
25486;58830;8;100;39;1;38;.974;3915000;0
25486;85798;12;0;0;0;0;.00nan;0;0
25487;179452;27;0;0;0;0;.00nan;0;0
25487;175660;27;60;18;2;16;.889;3575000;0
25487;77955;28;0;0;0;0;.00nan;0;0
25487;85437;28;99;47;1;46;.979;3600000;0
25488;167642;5;0;0;0;0;.00nan;0;0
25488;183844;29;0;0;0;0;.00nan;0;0
25488;173699;29;64;29;4;25;.862;3544000;0
25488;170314;5;100;45;2;43;.956;3600000;0
25489;187578;10;0;0;0;0;.00nan;0;0
25489;194416;17;29;31;7;24;.774;3600000;0
25489;178413;17;0;0;0;0;.00nan;0;0
25489;90164;10;86;28;1;27;.964;3600000;0
25490;171838;31;0;0;0;0;.00nan;0;0
25490;139409;3;54;32;4;28;.875;3569000;0
25490;148958;3;0;0;0;0;.00nan;0;0
25490;149452;31;85;38;3;35;.921;3600000;0
25491;166646;0;60;33;4;29;.879;3600000;0
25491;188888;0;0;0;0;0;.00nan;0;0
25491;175912;14;0;0;0;0;.00nan;0;0
25491;185034;14;58;9;1;8;.889;3600000;0
25492;166591;20;42;34;5;29;.853;3565000;0
25492;183783;20;0;0;0;0;.00nan;0;0
25492;201673;25;47;29;4;25;.862;3600000;0
25492;191813;25;0;0;0;0;.00nan;0;0
25493;162029;4182;0;0;0;0;.00nan;0;0
25493;172340;4182;77;32;3;29;.906;3600000;0
25493;165723;32;0;0;0;0;.00nan;0;0
25493;20432;32;98;23;0;23;1.000;3600000;0
25494;556;33;89;42;3;39;.929;3553000;0
25494;179154;26;0;0;0;0;.00nan;0;0
25494;197038;33;0;0;0;0;.00nan;0;0
25494;152835;26;74;21;1;20;.952;3600000;0
25495;175084;22;0;0;0;0;.00nan;0;0
25495;59540;23;85;45;4;41;.911;3600000;0
25495;78573;23;0;0;0;0;.00nan;0;0
25495;152717;22;84;27;1;26;.963;3600000;0
25496;3928;15;70;33;3;30;.909;3600000;0
25496;186573;16;0;0;0;0;.00nan;0;0
25496;50065;16;57;34;4;30;.882;3600000;0
25496;75268;15;0;0;0;0;.00nan;0;0
25497;168872;24;0;0;0;0;.00nan;0;0
25497;173727;18;77;20;1;19;.950;3600000;0
25497;61425;18;0;0;0;0;.00nan;0;0
25497;85727;24;57;30;3;27;.900;3578000;0
25498;184229;35;0;0;0;0;.00nan;0;0
25498;57338;35;82;26;2;24;.923;3600000;0
25498;77955;28;89;47;3;44;.936;3558000;0
25498;85437;28;0;0;0;0;.00nan;0;0
25499;556;33;0;0;0;0;.00nan;0;0
25499;162029;4182;0;0;0;0;.00nan;0;0
25499;172340;4182;56;37;5;32;.865;3600000;0
25499;197038;33;36;38;7;31;.816;3545000;0
25500;197940;11;23;11;4;7;.636;834000;0
25500;196090;4838;0;0;0;0;.00nan;0;0
25500;179950;4838;54;14;2;12;.857;3600000;0
25500;45323;11;97;35;0;35;1.000;2766000;0
25501;187537;19;82;29;2;27;.931;3600000;0
25501;178384;19;0;0;0;0;.00nan;0;0
25501;175084;22;56;32;4;28;.875;3530000;0
25501;152717;22;0;0;0;0;.00nan;0;0
25502;166591;20;25;28;6;22;.786;2996000;0
25502;183783;20;63;10;0;10;1.000;589000;0
25502;179452;27;0;0;0;0;.00nan;0;0
25502;175660;27;45;29;5;24;.828;3600000;0
25503;183844;29;0;0;0;0;.00nan;0;0
25503;173699;29;79;26;2;24;.923;3600000;0
25503;175912;14;71;38;5;33;.868;3600000;0
25503;185034;14;0;0;0;0;.00nan;0;0
25504;187578;10;86;40;2;38;.950;3578000;0
25504;179154;26;0;0;0;0;.00nan;0;0
25504;90164;10;0;0;0;0;.00nan;0;0
25504;152835;26;72;18;1;17;.944;3600000;0
25505;166646;0;100;46;1;45;.978;3600000;0
25505;188888;0;0;0;0;0;.00nan;0;0
25505;175092;9;0;0;0;0;.00nan;0;0
25505;190106;9;66;31;3;28;.903;3557000;0
25506;13714;8;0;0;0;0;.00nan;0;0
25506;201673;25;72;43;3;40;.930;4200000;0
25506;191813;25;0;0;0;0;.00nan;0;0
25506;58830;8;56;31;3;28;.903;4200000;0
25507;170977;30;0;0;0;0;.00nan;0;0
25507;59540;23;86;42;4;38;.905;3600000;0
25507;78573;23;0;0;0;0;.00nan;0;0
25507;86697;30;81;29;1;28;.966;3600000;0
25508;187537;19;0;0;0;0;.00nan;0;0
25508;178384;19;59;34;4;30;.882;3600000;0
25508;175092;9;99;32;1;31;.969;3600000;0
25508;190106;9;0;0;0;0;.00nan;0;0
25509;183844;29;75;38;3;35;.921;4123000;0
25509;168872;24;0;0;0;0;.00nan;0;0
25509;173699;29;0;0;0;0;.00nan;0;0
25509;85727;24;60;37;4;33;.892;4123000;0
25510;166591;20;48;14;2;12;.857;1321000;0
25510;183783;20;30;31;6;25;.806;2279000;0
25510;175084;22;0;0;0;0;.00nan;0;0
25510;152717;22;70;13;1;12;.923;3600000;0
25511;183904;34;81;23;1;22;.957;3600000;0
25511;179154;26;70;41;4;37;.902;3600000;0
25511;78806;34;0;0;0;0;.00nan;0;0
25511;152835;26;0;0;0;0;.00nan;0;0
25512;174718;12;0;0;0;0;.00nan;0;0
25512;85798;12;65;32;3;29;.906;3528000;0
25512;139409;3;74;15;1;14;.933;3600000;0
25512;148958;3;0;0;0;0;.00nan;0;0
25513;184229;35;0;0;0;0;.00nan;0;0
25513;170977;30;0;0;0;0;.00nan;0;0
25513;57338;35;82;36;2;34;.944;3914000;0
25513;86697;30;73;31;3;28;.903;3914000;0
25514;201673;25;56;32;4;28;.875;3569000;0
25514;186573;16;83;36;3;33;.917;3600000;0
25514;191813;25;0;0;0;0;.00nan;0;0
25514;50065;16;0;0;0;0;.00nan;0;0
25515;197940;11;84;44;3;41;.932;3563000;0
25515;173727;18;57;14;2;12;.857;3600000;0
25515;45323;11;0;0;0;0;.00nan;0;0
25515;61425;18;0;0;0;0;.00nan;0;0
25516;162029;4182;0;0;0;0;.00nan;0;0
25516;172340;4182;96;44;2;42;.955;4200000;0
25516;165723;32;0;0;0;0;.00nan;0;0
25516;20432;32;68;22;2;20;.909;4200000;0
25517;166646;0;46;23;4;19;.826;1816000;0
25517;188888;0;57;21;2;19;.905;1784000;0
25517;77955;28;0;0;0;0;.00nan;0;0
25517;85437;28;100;24;0;24;1.000;3600000;0
25518;167642;5;0;0;0;0;.00nan;0;0
25518;13714;8;0;0;0;0;.00nan;0;0
25518;170314;5;91;35;2;33;.943;3808000;0
25518;58830;8;67;27;3;24;.889;3808000;0
25519;194416;17;0;0;0;0;.00nan;0;0
25519;178413;17;64;36;4;32;.889;4163000;0
25519;196090;4838;53;23;3;20;.870;4163000;0
25519;179950;4838;0;0;0;0;.00nan;0;0
25520;166646;0;93;48;2;46;.958;3600000;0
25520;188888;0;0;0;0;0;.00nan;0;0
25520;175092;9;100;24;0;24;1.000;3600000;0
25520;190106;9;0;0;0;0;.00nan;0;0
25521;320;21;0;0;0;0;.00nan;0;0
25521;3284;21;42;28;5;23;.821;3600000;0
25521;139409;3;78;29;2;27;.931;3600000;0
25521;148958;3;0;0;0;0;.00nan;0;0
25522;166591;20;0;0;0;0;.00nan;0;0
25522;187537;19;0;0;0;0;.00nan;0;0
25522;183783;20;79;37;3;34;.919;3600000;0
25522;178384;19;64;34;4;30;.882;3547000;0
25523;187578;10;44;4;1;3;.750;762000;0
25523;183844;29;0;0;0;0;.00nan;0;0
25523;173699;29;89;41;2;39;.951;3600000;0
25523;90164;10;15;19;6;13;.684;2838000;0
25524;168872;24;0;0;0;0;.00nan;0;0
25524;179154;26;0;0;0;0;.00nan;0;0
25524;85727;24;93;30;1;29;.967;3600000;0
25524;152835;26;70;26;2;24;.923;3547000;0
25525;3928;15;76;36;3;33;.917;4083000;0
25525;175084;22;0;0;0;0;.00nan;0;0
25525;75268;15;0;0;0;0;.00nan;0;0
25525;152717;22;53;31;4;27;.871;4083000;0
25526;171838;31;0;0;0;0;.00nan;0;0
25526;59540;23;70;18;1;17;.944;3554000;0
25526;78573;23;0;0;0;0;.00nan;0;0
25526;149452;31;100;23;0;23;1.000;3600000;0
25527;174718;12;0;0;0;0;.00nan;0;0
25527;77955;28;0;0;0;0;.00nan;0;0
25527;85437;28;78;35;3;32;.914;3588000;0
25527;85798;12;78;24;1;23;.958;3600000;0
25528;556;33;99;45;1;44;.978;3600000;0
25528;186573;16;0;0;0;0;.00nan;0;0
25528;197038;33;0;0;0;0;.00nan;0;0
25528;50065;16;35;21;4;17;.810;3600000;0
25529;197940;11;90;43;2;41;.953;3600000;0
25529;179452;27;0;0;0;0;.00nan;0;0
25529;175660;27;29;19;5;14;.737;3600000;0
25529;45323;11;0;0;0;0;.00nan;0;0
25530;194416;17;64;25;2;23;.920;3552000;0
25530;178413;17;0;0;0;0;.00nan;0;0
25530;173727;18;82;33;1;32;.970;3600000;0
25530;61425;18;0;0;0;0;.00nan;0;0
25531;162029;4182;0;0;0;0;.00nan;0;0
25531;172340;4182;44;38;6;32;.842;3600000;0
25531;183904;34;68;17;1;16;.941;3600000;0
25531;78806;34;0;0;0;0;.00nan;0;0
25532;167642;5;0;0;0;0;.00nan;0;0
25532;170314;5;100;26;0;26;1.000;3600000;0
25532;186573;16;90;33;1;32;.970;3546000;0
25532;50065;16;0;0;0;0;.00nan;0;0
25533;556;33;100;51;1;50;.980;4200000;0
25533;13714;8;0;0;0;0;.00nan;0;0
25533;197038;33;0;0;0;0;.00nan;0;0
25533;58830;8;74;20;1;19;.950;4200000;0
25534;165723;32;0;0;0;0;.00nan;0;0
25534;20432;32;87;33;1;32;.970;4200000;0
25534;196090;4838;0;0;0;0;.00nan;0;0
25534;179950;4838;86;31;1;30;.968;4200000;0
25535;184229;35;0;0;0;0;.00nan;0;0
25535;170977;30;0;0;0;0;.00nan;0;0
25535;57338;35;100;33;0;33;1.000;3600000;0
25535;86697;30;68;26;2;24;.923;3520000;0
25536;187537;19;0;0;0;0;.00nan;0;0
25536;178384;19;74;23;2;21;.913;3600000;0
25536;77955;28;71;37;4;33;.892;3575000;0
25536;85437;28;0;0;0;0;.00nan;0;0
25537;166591;20;80;39;3;36;.923;3690000;0
25537;183783;20;0;0;0;0;.00nan;0;0
25537;174718;12;0;0;0;0;.00nan;0;0
25537;85798;12;65;31;4;27;.871;3690000;0
25538;320;21;0;0;0;0;.00nan;0;0
25538;3284;21;81;32;2;30;.938;3600000;0
25538;168872;24;0;0;0;0;.00nan;0;0
25538;85727;24;42;38;7;31;.816;3600000;0
25539;175084;22;0;0;0;0;.00nan;0;0
25539;175092;9;87;52;4;48;.923;3600000;0
25539;190106;9;0;0;0;0;.00nan;0;0
25539;152717;22;59;11;1;10;.909;3600000;0
25540;183844;29;0;0;0;0;.00nan;0;0
25540;173699;29;69;36;4;32;.889;3936000;0
25540;59540;23;71;31;3;28;.903;3936000;0
25540;78573;23;0;0;0;0;.00nan;0;0
25541;166646;0;88;41;2;39;.951;4186000;0
25541;188888;0;0;0;0;0;.00nan;0;0
25541;139409;3;0;0;0;0;.00nan;0;0
25541;148958;3;63;27;3;24;.889;4186000;0
25542;162029;4182;84;34;2;32;.941;3600000;0
25542;172340;4182;0;0;0;0;.00nan;0;0
25542;194416;17;0;0;0;0;.00nan;0;0
25542;178413;17;62;31;3;28;.903;3581000;0
25543;171838;31;0;0;0;0;.00nan;0;0
25543;187578;10;83;32;1;31;.969;3600000;0
25543;90164;10;0;0;0;0;.00nan;0;0
25543;149452;31;63;42;5;37;.881;3600000;0
25544;3928;15;70;22;2;20;.909;3682000;0
25544;201673;25;86;34;3;31;.912;3682000;0
25544;191813;25;0;0;0;0;.00nan;0;0
25544;75268;15;0;0;0;0;.00nan;0;0
25545;179154;26;0;0;0;0;.00nan;0;0
25545;175912;14;0;0;0;0;.00nan;0;0
25545;185034;14;62;24;3;21;.875;3578000;0
25545;152835;26;86;37;2;35;.946;3600000;0
25546;197940;11;96;57;3;54;.947;4200000;0
25546;184229;35;0;0;0;0;.00nan;0;0
25546;45323;11;0;0;0;0;.00nan;0;0
25546;57338;35;69;32;3;29;.906;4200000;0
25547;167642;5;0;0;0;0;.00nan;0;0
25547;170314;5;99;32;1;31;.969;3600000;0
25547;179452;27;0;0;0;0;.00nan;0;0
25547;175660;27;58;19;2;17;.895;3548000;0
25548;165723;32;91;48;2;46;.958;3769000;0
25548;20432;32;0;0;0;0;.00nan;0;0
25548;173727;18;61;26;3;23;.885;3745000;0
25548;61425;18;0;0;0;0;.00nan;0;0
25549;187537;19;60;42;6;36;.857;3600000;0
25549;178384;19;0;0;0;0;.00nan;0;0
25549;175084;22;83;24;1;23;.958;3600000;0
25549;152717;22;0;0;0;0;.00nan;0;0
25550;556;33;85;36;2;34;.944;3587000;0
25550;174718;12;97;29;0;29;1.000;3600000;0
25550;197038;33;0;0;0;0;.00nan;0;0
25550;85798;12;0;0;0;0;.00nan;0;0
25551;320;21;93;27;1;26;.963;3600000;0
25551;3284;21;0;0;0;0;.00nan;0;0
25551;59540;23;100;32;0;32;1.000;3600000;0
25551;78573;23;0;0;0;0;.00nan;0;0
25552;201673;25;59;22;3;19;.864;3552000;0
25552;186573;16;0;0;0;0;.00nan;0;0
25552;191813;25;0;0;0;0;.00nan;0;0
25552;50065;16;79;27;1;26;.963;3600000;0
25553;183904;34;94;23;0;23;1.000;3600000;0
25553;196090;4838;0;0;0;0;.00nan;0;0
25553;179950;4838;75;36;2;34;.944;3570000;0
25553;78806;34;0;0;0;0;.00nan;0;0
25554;179154;26;0;0;0;0;.00nan;0;0
25554;175092;9;75;48;5;43;.896;3600000;0
25554;190106;9;0;0;0;0;.00nan;0;0
25554;152835;26;83;28;2;26;.929;3600000;0
25555;168872;24;0;0;0;0;.00nan;0;0
25555;175912;14;0;0;0;0;.00nan;0;0
25555;185034;14;82;31;2;29;.935;4200000;0
25555;85727;24;98;47;2;45;.957;4200000;0
25556;3928;15;49;31;4;27;.871;4093000;0
25556;184229;35;0;0;0;0;.00nan;0;0
25556;57338;35;49;33;5;28;.848;4093000;0
25556;75268;15;0;0;0;0;.00nan;0;0
25557;183904;34;100;27;0;27;1.000;3600000;0
25557;173727;18;59;33;4;29;.879;3600000;0
25557;61425;18;0;0;0;0;.00nan;0;0
25557;78806;34;0;0;0;0;.00nan;0;0
25558;167642;5;0;0;0;0;.00nan;0;0
25558;170314;5;54;24;3;21;.875;3554000;0
25558;77955;28;0;0;0;0;.00nan;0;0
25558;85437;28;100;41;1;40;.976;3600000;0
25559;320;21;0;0;0;0;.00nan;0;0
25559;3284;21;58;34;4;30;.882;4200000;0
25559;175912;14;50;26;4;22;.846;4200000;0
25559;185034;14;0;0;0;0;.00nan;0;0
25560;166591;20;75;39;3;36;.923;3546000;0
25560;183783;20;0;0;0;0;.00nan;0;0
25560;139409;3;84;26;1;25;.962;3600000;0
25560;148958;3;0;0;0;0;.00nan;0;0
25561;194416;17;0;0;0;0;.00nan;0;0
25561;178413;17;77;33;3;30;.909;3584000;0
25561;175084;22;0;0;0;0;.00nan;0;0
25561;152717;22;86;30;2;28;.933;3600000;0
25562;187578;10;0;0;0;0;.00nan;0;0
25562;162029;4182;0;0;0;0;.00nan;0;0
25562;172340;4182;99;46;2;44;.957;3600000;0
25562;90164;10;33;21;4;17;.810;3576000;0
25563;165723;32;0;0;0;0;.00nan;0;0
25563;183844;29;0;0;0;0;.00nan;0;0
25563;20432;32;100;28;0;28;1.000;3600000;0
25563;173699;29;64;21;2;19;.905;3514000;0
25564;556;33;89;48;4;44;.917;3912000;0
25564;186573;16;56;31;5;26;.839;3912000;0
25564;197038;33;0;0;0;0;.00nan;0;0
25564;50065;16;0;0;0;0;.00nan;0;0
25565;201673;25;66;26;2;24;.923;3582000;0
25565;196090;4838;82;23;1;22;.957;3600000;0
25565;179950;4838;0;0;0;0;.00nan;0;0
25565;191813;25;0;0;0;0;.00nan;0;0
25566;13714;8;0;0;0;0;.00nan;0;0
25566;58830;8;57;42;5;37;.881;3600000;0
25566;59540;23;42;19;4;15;.789;3600000;0
25566;78573;23;0;0;0;0;.00nan;0;0
25567;170977;30;62;28;3;25;.893;3608000;0
25567;179452;27;0;0;0;0;.00nan;0;0
25567;175660;27;81;34;2;32;.941;3608000;0
25567;86697;30;0;0;0;0;.00nan;0;0
25568;173727;18;71;18;1;17;.944;3600000;0
25568;179154;26;0;0;0;0;.00nan;0;0
25568;61425;18;0;0;0;0;.00nan;0;0
25568;152835;26;51;33;4;29;.879;3600000;0
25569;184229;35;0;0;0;0;.00nan;0;0
25569;174718;12;97;46;2;44;.957;4173000;0
25569;57338;35;61;20;2;18;.900;4200000;0
25569;85798;12;0;0;0;0;.00nan;0;0
25570;187537;19;0;0;0;0;.00nan;0;0
25570;3928;15;55;28;3;25;.893;4200000;0
25570;178384;19;94;62;3;59;.952;4200000;0
25570;75268;15;0;0;0;0;.00nan;0;0
25571;197940;11;76;34;2;32;.941;3588000;0
25571;13714;8;100;28;0;28;1.000;3600000;0
25571;45323;11;0;0;0;0;.00nan;0;0
25571;58830;8;0;0;0;0;.00nan;0;0
25572;183904;34;54;18;2;16;.889;3600000;0
25572;77955;28;0;0;0;0;.00nan;0;0
25572;78806;34;0;0;0;0;.00nan;0;0
25572;85437;28;66;37;5;32;.865;3600000;0
25573;320;21;0;0;0;0;.00nan;0;0
25573;3284;21;52;26;3;23;.885;3600000;0
25573;183844;29;0;0;0;0;.00nan;0;0
25573;173699;29;100;47;1;46;.979;3600000;0
25574;166591;20;0;0;0;0;.00nan;0;0
25574;183783;20;78;47;5;42;.894;3565000;0
25574;194416;17;0;0;0;0;.00nan;0;0
25574;178413;17;51;31;4;27;.871;3600000;0
25575;167642;5;60;28;3;25;.893;3600000;0
25575;170314;5;0;0;0;0;.00nan;0;0
25575;186573;16;0;0;0;0;.00nan;0;0
25575;50065;16;38;25;5;20;.800;3528000;0
25576;175092;9;0;0;0;0;.00nan;0;0
25576;190106;9;84;28;1;27;.964;3571000;0
25576;139409;3;100;27;0;27;1.000;3600000;0
25576;148958;3;0;0;0;0;.00nan;0;0
25577;166646;0;26;31;6;25;.806;2846000;0
25577;187578;10;39;19;4;15;.789;3600000;0
25577;188888;0;38;14;3;11;.786;754000;0
25577;90164;10;0;0;0;0;.00nan;0;0
25578;162029;4182;0;0;0;0;.00nan;0;0
25578;172340;4182;64;45;5;40;.889;3600000;0
25578;175084;22;0;0;0;0;.00nan;0;0
25578;152717;22;55;16;2;14;.875;3600000;0
25579;171838;31;0;0;0;0;.00nan;0;0
25579;175912;14;41;31;5;26;.839;3600000;0
25579;185034;14;0;0;0;0;.00nan;0;0
25579;149452;31;87;27;1;26;.963;3600000;0
25580;165723;32;0;0;0;0;.00nan;0;0
25580;168872;24;51;2;0;2;1.000;301000;0
25580;20432;32;88;36;2;34;.944;3600000;0
25580;85727;24;51;46;6;40;.870;3299000;0
25581;556;33;85;44;4;40;.909;3600000;0
25581;196090;4838;92;20;0;20;1.000;3600000;0
25581;179950;4838;0;0;0;0;.00nan;0;0
25581;197038;33;0;0;0;0;.00nan;0;0
25582;179452;27;0;0;0;0;.00nan;0;0
25582;175660;27;63;22;2;20;.909;3600000;0
25582;59540;23;54;30;4;26;.867;3516000;0
25582;78573;23;0;0;0;0;.00nan;0;0
25583;3928;15;0;0;0;0;.00nan;0;0
25583;170977;30;0;0;0;0;.00nan;0;0
25583;75268;15;61;32;3;29;.906;3600000;0
25583;86697;30;65;35;4;31;.886;3563000;0
25584;184229;35;0;0;0;0;.00nan;0;0
25584;196090;4838;65;34;4;30;.882;3513000;0
25584;179950;4838;0;0;0;0;.00nan;0;0
25584;57338;35;76;28;2;26;.929;3600000;0
25585;173727;18;52;26;3;23;.885;3796000;0
25585;201673;25;70;36;4;32;.889;3827000;0
25585;191813;25;0;0;0;0;.00nan;0;0
25585;61425;18;0;0;0;0;.00nan;0;0
25586;167642;5;0;0;0;0;.00nan;0;0
25586;170314;5;35;29;5;24;.828;3561000;0
25586;77955;28;0;0;0;0;.00nan;0;0
25586;85437;28;46;29;4;25;.862;3600000;0
25587;194416;17;0;0;0;0;.00nan;0;0
25587;178413;17;78;43;3;40;.930;3600000;0
25587;183904;34;0;0;0;0;.00nan;0;0
25587;78806;34;84;26;1;25;.962;3600000;0
25588;175084;22;0;0;0;0;.00nan;0;0
25588;175912;14;0;0;0;0;.00nan;0;0
25588;185034;14;57;31;4;27;.871;3600000;0
25588;152717;22;86;26;1;25;.962;3600000;0
25589;168872;24;0;0;0;0;.00nan;0;0
25589;186573;16;100;29;0;29;1.000;3600000;0
25589;50065;16;0;0;0;0;.00nan;0;0
25589;85727;24;80;37;4;33;.892;3600000;0
25590;171838;31;0;0;0;0;.00nan;0;0
25590;183844;29;0;0;0;0;.00nan;0;0
25590;173699;29;74;32;2;30;.938;3600000;0
25590;149452;31;87;46;4;42;.913;3600000;0
25591;187578;10;0;0;0;0;.00nan;0;0
25591;175092;9;92;45;3;42;.933;3951000;0
25591;190106;9;0;0;0;0;.00nan;0;0
25591;90164;10;60;32;4;28;.875;3951000;0
25592;166591;20;86;41;3;38;.927;4200000;0
25592;162029;4182;0;0;0;0;.00nan;0;0
25592;172340;4182;69;39;3;36;.923;4200000;0
25592;183783;20;0;0;0;0;.00nan;0;0
25593;59540;23;56;30;4;26;.867;3600000;0
25593;78573;23;0;0;0;0;.00nan;0;0
25593;139409;3;80;24;1;23;.958;3600000;0
25593;148958;3;0;0;0;0;.00nan;0;0
25594;320;21;0;0;0;0;.00nan;0;0
25594;166646;0;74;33;3;30;.909;3600000;0
25594;3284;21;68;35;4;31;.886;3574000;0
25594;188888;0;0;0;0;0;.00nan;0;0
25595;165723;32;0;0;0;0;.00nan;0;0
25595;20432;32;100;48;2;46;.958;3600000;0
25595;173727;18;0;0;0;0;.00nan;0;0
25595;61425;18;45;25;4;21;.840;3531000;0
25596;556;33;82;38;2;36;.947;3600000;0
25596;179154;26;0;0;0;0;.00nan;0;0
25596;197038;33;0;0;0;0;.00nan;0;0
25596;152835;26;52;31;5;26;.839;3600000;0
25597;187537;19;0;0;0;0;.00nan;0;0
25597;13714;8;82;22;1;21;.955;3600000;0
25597;178384;19;71;34;3;31;.912;3548000;0
25597;58830;8;0;0;0;0;.00nan;0;0
25598;170977;30;0;0;0;0;.00nan;0;0
25598;174718;12;25;28;6;22;.786;2983000;0
25598;85798;12;48;5;1;4;.800;617000;0
25598;86697;30;65;31;3;28;.903;3600000;0
25599;197940;11;0;0;0;0;.00nan;0;0
25599;3928;15;50;13;2;11;.846;3600000;0
25599;45323;11;52;31;4;27;.871;3555000;0
25599;75268;15;0;0;0;0;.00nan;0;0
25600;183904;34;57;16;2;14;.875;3600000;0
25600;175912;14;78;41;3;38;.927;3563000;0
25600;185034;14;0;0;0;0;.00nan;0;0
25600;78806;34;0;0;0;0;.00nan;0;0
25601;168872;24;51;2;0;2;1.000;382000;0
25601;179452;27;0;0;0;0;.00nan;0;0
25601;175660;27;63;27;3;24;.889;3600000;0
25601;85727;24;21;25;6;19;.760;3218000;0
25602;166591;20;83;39;3;36;.923;3111000;0
25602;183783;20;36;11;3;8;.727;489000;0
25602;184229;35;0;0;0;0;.00nan;0;0
25602;57338;35;98;25;0;25;1.000;3600000;0
25603;162029;4182;0;0;0;0;.00nan;0;0
25603;172340;4182;88;41;3;38;.927;4189000;0
25603;201673;25;60;25;3;22;.880;4200000;0
25603;191813;25;0;0;0;0;.00nan;0;0
25604;320;21;60;27;3;24;.889;3522000;0
25604;3284;21;0;0;0;0;.00nan;0;0
25604;194416;17;95;33;1;32;.970;3600000;0
25604;178413;17;0;0;0;0;.00nan;0;0
25605;167642;5;92;39;3;36;.923;3600000;0
25605;170314;5;0;0;0;0;.00nan;0;0
25605;175084;22;100;24;0;24;1.000;3600000;0
25605;152717;22;0;0;0;0;.00nan;0;0
25606;179154;26;55;32;5;27;.844;4200000;0
25606;196090;4838;0;0;0;0;.00nan;0;0
25606;179950;4838;64;39;5;34;.872;4200000;0
25606;152835;26;0;0;0;0;.00nan;0;0
25607;3928;15;63;23;2;21;.913;3585000;0
25607;59540;23;100;38;0;38;1.000;3600000;0
25607;75268;15;0;0;0;0;.00nan;0;0
25607;78573;23;0;0;0;0;.00nan;0;0
25608;170977;30;0;0;0;0;.00nan;0;0
25608;77955;28;0;0;0;0;.00nan;0;0
25608;85437;28;84;36;2;34;.944;3585000;0
25608;86697;30;65;16;1;15;.938;3600000;0
25609;194416;17;0;0;0;0;.00nan;0;0
25609;178413;17;71;31;3;28;.903;3600000;0
25609;175092;9;92;55;4;51;.927;3547000;0
25609;190106;9;0;0;0;0;.00nan;0;0
25610;166591;20;0;0;0;0;.00nan;0;0
25610;167642;5;0;0;0;0;.00nan;0;0
25610;183783;20;65;37;4;33;.892;4200000;0
25610;170314;5;57;33;4;29;.879;4200000;0
25611;168872;24;51;23;4;19;.826;3600000;0
25611;175084;22;0;0;0;0;.00nan;0;0
25611;85727;24;0;0;0;0;.00nan;0;0
25611;152717;22;65;39;5;34;.872;3600000;0
25612;184229;35;0;0;0;0;.00nan;0;0
25612;175912;14;90;43;4;39;.907;3600000;0
25612;185034;14;0;0;0;0;.00nan;0;0
25612;57338;35;70;23;1;22;.957;3600000;0
25613;166646;0;83;43;3;40;.930;3600000;0
25613;187578;10;39;21;4;17;.810;3600000;0
25613;188888;0;0;0;0;0;.00nan;0;0
25613;90164;10;0;0;0;0;.00nan;0;0
25614;320;21;0;0;0;0;.00nan;0;0
25614;3284;21;96;36;2;34;.944;3876000;0
25614;183904;34;64;28;3;25;.893;3876000;0
25614;78806;34;0;0;0;0;.00nan;0;0
25615;162029;4182;0;0;0;0;.00nan;0;0
25615;172340;4182;64;25;3;22;.880;3600000;0
25615;174718;12;37;21;4;17;.810;3600000;0
25615;85798;12;0;0;0;0;.00nan;0;0
25616;13714;8;59;25;4;21;.840;4112000;0
25616;179154;26;0;0;0;0;.00nan;0;0
25616;58830;8;0;0;0;0;.00nan;0;0
25616;152835;26;66;31;3;28;.903;4112000;0
25617;187537;19;0;0;0;0;.00nan;0;0
25617;178384;19;62;30;3;27;.900;3517000;0
25617;139409;3;96;36;1;35;.972;3600000;0
25617;148958;3;0;0;0;0;.00nan;0;0
25618;556;33;54;43;6;37;.860;2846000;0
25618;196090;4838;83;14;0;14;1.000;3600000;0
25618;179950;4838;0;0;0;0;.00nan;0;0
25618;197038;33;57;5;0;5;1.000;754000;0
25619;173727;18;35;29;5;24;.828;3583000;0
25619;201673;25;79;41;4;37;.902;3600000;0
25619;191813;25;0;0;0;0;.00nan;0;0
25619;61425;18;0;0;0;0;.00nan;0;0
25620;197940;11;81;38;3;35;.921;3600000;0
25620;45323;11;0;0;0;0;.00nan;0;0
25620;77955;28;31;29;6;23;.793;2948000;0
25620;85437;28;34;6;2;4;.667;652000;0
25621;171838;31;0;0;0;0;.00nan;0;0
25621;179452;27;0;0;0;0;.00nan;0;0
25621;175660;27;50;21;4;17;.810;4200000;0
25621;149452;31;78;50;4;46;.920;4200000;0
25622;166646;0;0;0;0;0;.00nan;0;0
25622;3928;15;81;13;0;13;1.000;3600000;0
25622;188888;0;48;35;5;30;.857;3600000;0
25622;75268;15;0;0;0;0;.00nan;0;0
25623;165723;32;0;0;0;0;.00nan;0;0
25623;20432;32;75;24;1;23;.958;4200000;0
25623;186573;16;0;0;0;0;.00nan;0;0
25623;50065;16;96;44;1;43;.977;4200000;0
25624;556;33;0;0;0;0;.00nan;0;0
25624;173727;18;0;0;0;0;.00nan;0;0
25624;197038;33;98;44;2;42;.955;3580000;0
25624;61425;18;86;14;0;14;1.000;3600000;0
25625;175092;9;0;0;0;0;.00nan;0;0
25625;175912;14;0;0;0;0;.00nan;0;0
25625;190106;9;94;48;3;45;.938;3600000;0
25625;185034;14;71;35;4;31;.886;3595000;0
25626;320;21;0;0;0;0;.00nan;0;0
25626;187578;10;87;26;1;25;.962;3600000;0
25626;3284;21;69;38;4;34;.895;3600000;0
25626;90164;10;0;0;0;0;.00nan;0;0
25627;167642;5;49;26;4;22;.846;2519000;0
25627;183904;34;63;18;2;16;.889;3600000;0
25627;170314;5;37;16;4;12;.750;1081000;0
25627;78806;34;0;0;0;0;.00nan;0;0
25628;183844;29;0;0;0;0;.00nan;0;0
25628;173699;29;95;29;1;28;.966;4200000;0
25628;174718;12;98;44;1;43;.977;4200000;0
25628;85798;12;0;0;0;0;.00nan;0;0
25629;168872;24;0;0;0;0;.00nan;0;0
25629;184229;35;0;0;0;0;.00nan;0;0
25629;57338;35;70;18;1;17;.944;3600000;0
25629;85727;24;86;37;3;34;.919;3544000;0
25630;194416;17;0;0;0;0;.00nan;0;0
25630;178413;17;95;20;0;20;1.000;3600000;0
25630;179154;26;0;0;0;0;.00nan;0;0
25630;152835;26;86;26;1;25;.962;3584000;0
25631;187537;19;82;35;3;32;.914;3552000;0
25631;178384;19;0;0;0;0;.00nan;0;0
25631;77955;28;0;0;0;0;.00nan;0;0
25631;85437;28;72;28;2;26;.929;3600000;0
25632;201673;25;44;39;6;33;.846;3586000;0
25632;196090;4838;80;39;4;35;.897;3600000;0
25632;179950;4838;0;0;0;0;.00nan;0;0
25632;191813;25;0;0;0;0;.00nan;0;0
25633;197940;11;100;34;0;34;1.000;3600000;0
25633;45323;11;0;0;0;0;.00nan;0;0
25633;139409;3;78;27;2;25;.926;3516000;0
25633;148958;3;0;0;0;0;.00nan;0;0
25634;170977;30;0;0;0;0;.00nan;0;0
25634;179452;27;0;0;0;0;.00nan;0;0
25634;175660;27;54;36;5;31;.861;3559000;0
25634;86697;30;69;39;4;35;.897;3600000;0
25635;171838;31;0;0;0;0;.00nan;0;0
25635;162029;4182;0;0;0;0;.00nan;0;0
25635;172340;4182;100;28;0;28;1.000;3600000;0
25635;149452;31;76;37;4;33;.892;3600000;0
25636;320;21;19;8;4;4;.500;717000;0
25636;3284;21;53;23;3;20;.870;2883000;0
25636;3928;15;67;22;2;20;.909;3600000;0
25636;75268;15;0;0;0;0;.00nan;0;0
25637;165723;32;89;39;3;36;.923;3585000;0
25637;20432;32;0;0;0;0;.00nan;0;0
25637;175084;22;0;0;0;0;.00nan;0;0
25637;152717;22;89;24;1;23;.958;3600000;0
25638;166591;20;0;0;0;0;.00nan;0;0
25638;13714;8;0;0;0;0;.00nan;0;0
25638;183783;20;52;44;5;39;.886;3553000;0
25638;58830;8;61;23;3;20;.870;3600000;0
25639;170977;30;75;30;2;28;.933;3600000;0
25639;186573;16;31;22;5;17;.773;3600000;0
25639;50065;16;0;0;0;0;.00nan;0;0
25639;86697;30;0;0;0;0;.00nan;0;0
25640;183904;34;75;13;0;13;1.000;3600000;0
25640;184229;35;0;0;0;0;.00nan;0;0
25640;57338;35;98;50;2;48;.960;3577000;0
25640;78806;34;0;0;0;0;.00nan;0;0
25641;187578;10;0;0;0;0;.00nan;0;0
25641;175092;9;0;0;0;0;.00nan;0;0
25641;190106;9;100;51;2;49;.961;3600000;0
25641;90164;10;41;22;4;18;.818;3578000;0
25642;556;33;100;28;0;28;1.000;3600000;0
25642;179154;26;0;0;0;0;.00nan;0;0
25642;197038;33;0;0;0;0;.00nan;0;0
25642;152835;26;65;31;4;27;.871;3600000;0
25643;167642;5;0;0;0;0;.00nan;0;0
25643;170314;5;64;27;2;25;.926;3567000;0
25643;174718;12;89;31;1;30;.968;3600000;0
25643;85798;12;0;0;0;0;.00nan;0;0
25644;194416;17;0;0;0;0;.00nan;0;0
25644;178413;17;58;28;3;25;.893;3587000;0
25644;168872;24;0;0;0;0;.00nan;0;0
25644;85727;24;89;34;2;32;.941;3600000;0
25645;187537;19;0;0;0;0;.00nan;0;0
25645;166646;0;93;36;1;35;.972;3600000;0
25645;188888;0;0;0;0;0;.00nan;0;0
25645;178384;19;56;18;2;16;.889;3568000;0
25646;183844;29;0;0;0;0;.00nan;0;0
25646;173699;29;87;37;2;35;.946;3600000;0
25646;175912;14;70;30;3;27;.900;3570000;0
25646;185034;14;0;0;0;0;.00nan;0;0
25647;197940;11;84;31;1;30;.968;3600000;0
25647;45323;11;0;0;0;0;.00nan;0;0
25647;59540;23;63;28;3;25;.893;3600000;0
25647;78573;23;0;0;0;0;.00nan;0;0
25648;171838;31;0;0;0;0;.00nan;0;0
25648;173727;18;69;21;2;19;.905;3600000;0
25648;61425;18;0;0;0;0;.00nan;0;0
25648;149452;31;98;54;3;51;.944;3600000;0
25649;162029;4182;0;0;0;0;.00nan;0;0
25649;172340;4182;73;28;2;26;.929;3600000;0
25649;201673;25;76;43;3;40;.930;3583000;0
25649;191813;25;0;0;0;0;.00nan;0;0
25650;166591;20;54;40;6;34;.850;3600000;0
25650;183783;20;0;0;0;0;.00nan;0;0
25650;179452;27;0;0;0;0;.00nan;0;0
25650;175660;27;60;23;2;21;.913;3600000;0
25651;3928;15;75;25;2;23;.920;3600000;0
25651;184229;35;0;0;0;0;.00nan;0;0
25651;57338;35;73;47;5;42;.894;3600000;0
25651;75268;15;0;0;0;0;.00nan;0;0
25652;13714;8;0;0;0;0;.00nan;0;0
25652;175084;22;0;0;0;0;.00nan;0;0
25652;58830;8;89;34;2;32;.941;3581000;0
25652;152717;22;94;38;1;37;.974;3600000;0
25653;183904;34;91;25;1;24;.960;3600000;0
25653;168872;24;0;0;0;0;.00nan;0;0
25653;78806;34;0;0;0;0;.00nan;0;0
25653;85727;24;97;44;3;41;.932;3573000;0
25654;320;21;0;0;0;0;.00nan;0;0
25654;166646;0;0;0;0;0;.00nan;0;0
25654;3284;21;70;21;2;19;.905;3600000;0
25654;188888;0;76;40;3;37;.925;3600000;0
25655;187537;19;100;26;0;26;1.000;3600000;0
25655;178384;19;0;0;0;0;.00nan;0;0
25655;194416;17;65;34;3;31;.912;3600000;0
25655;178413;17;0;0;0;0;.00nan;0;0
25656;187578;10;80;27;1;26;.963;3600000;0
25656;183844;29;69;25;2;23;.920;3583000;0
25656;173699;29;0;0;0;0;.00nan;0;0
25656;90164;10;0;0;0;0;.00nan;0;0
25657;165723;32;0;0;0;0;.00nan;0;0
25657;20432;32;68;28;3;25;.893;3600000;0
25657;186573;16;0;0;0;0;.00nan;0;0
25657;50065;16;75;43;4;39;.907;3600000;0
25658;171838;31;73;42;3;39;.929;3600000;0
25658;196090;4838;95;20;0;20;1.000;3600000;0
25658;179950;4838;0;0;0;0;.00nan;0;0
25658;149452;31;0;0;0;0;.00nan;0;0
25659;59540;23;22;22;6;16;.727;3580000;0
25659;77955;28;0;0;0;0;.00nan;0;0
25659;78573;23;0;0;0;0;.00nan;0;0
25659;85437;28;79;51;5;46;.902;3600000;0
25660;170977;30;56;7;0;7;1.000;797000;0
25660;86697;30;4;19;7;12;.632;2803000;0
25660;139409;3;88;44;3;41;.932;3600000;0
25660;148958;3;0;0;0;0;.00nan;0;0
25661;179154;26;0;0;0;0;.00nan;0;0
25661;179452;27;0;0;0;0;.00nan;0;0
25661;175660;27;74;18;1;17;.944;3600000;0
25661;152835;26;60;24;3;21;.875;3513000;0
25662;197940;11;69;30;2;28;.933;3570000;0
25662;173727;18;76;16;1;15;.938;3600000;0
25662;45323;11;0;0;0;0;.00nan;0;0
25662;61425;18;0;0;0;0;.00nan;0;0
25663;183844;29;0;0;0;0;.00nan;0;0
25663;173699;29;72;39;4;35;.897;3588000;0
25663;175092;9;0;0;0;0;.00nan;0;0
25663;190106;9;84;34;2;32;.941;3600000;0
25664;187578;10;0;0;0;0;.00nan;0;0
25664;175912;14;0;0;0;0;.00nan;0;0
25664;185034;14;54;25;3;22;.880;3600000;0
25664;90164;10;100;34;1;33;.971;3600000;0
25665;320;21;0;0;0;0;.00nan;0;0
25665;3284;21;70;40;3;37;.925;3587000;0
25665;175084;22;0;0;0;0;.00nan;0;0
25665;152717;22;63;19;2;17;.895;3600000;0
25666;166646;0;96;41;2;39;.951;3600000;0
25666;188888;0;0;0;0;0;.00nan;0;0
25666;168872;24;0;0;0;0;.00nan;0;0
25666;85727;24;44;23;4;19;.826;3596000;0
25667;3928;15;70;23;2;21;.913;3600000;0
25667;167642;5;0;0;0;0;.00nan;0;0
25667;170314;5;91;47;3;44;.936;3579000;0
25667;75268;15;0;0;0;0;.00nan;0;0
25668;174718;12;73;41;4;37;.902;3576000;0
25668;179452;27;0;0;0;0;.00nan;0;0
25668;175660;27;58;19;2;17;.895;3600000;0
25668;85798;12;0;0;0;0;.00nan;0;0
25669;187537;19;84;52;4;48;.923;3808000;0
25669;178384;19;0;0;0;0;.00nan;0;0
25669;184229;35;0;0;0;0;.00nan;0;0
25669;57338;35;85;34;3;31;.912;3808000;0
25670;201673;25;35;21;4;17;.810;3549000;0
25670;191813;25;0;0;0;0;.00nan;0;0
25670;59540;23;77;32;3;29;.906;3600000;0
25670;78573;23;0;0;0;0;.00nan;0;0
25671;13714;8;0;0;0;0;.00nan;0;0
25671;58830;8;100;26;0;26;1.000;3600000;0
25671;139409;3;73;21;1;20;.952;3548000;0
25671;148958;3;0;0;0;0;.00nan;0;0
25672;166591;20;34;33;6;27;.818;2239000;0
25672;183783;20;55;20;2;18;.900;1361000;0
25672;186573;16;38;29;5;24;.828;3600000;0
25672;50065;16;0;0;0;0;.00nan;0;0
25673;170977;30;0;0;0;0;.00nan;0;0
25673;196090;4838;60;27;3;24;.889;3600000;0
25673;179950;4838;0;0;0;0;.00nan;0;0
25673;86697;30;51;32;4;28;.875;3544000;0
25674;162029;4182;0;0;0;0;.00nan;0;0
25674;172340;4182;84;39;3;36;.923;4200000;0
25674;165723;32;0;0;0;0;.00nan;0;0
25674;20432;32;47;15;3;12;.800;4200000;0
25675;194416;17;0;0;0;0;.00nan;0;0
25675;178413;17;100;25;0;25;1.000;3600000;0
25675;77955;28;0;0;0;0;.00nan;0;0
25675;85437;28;97;48;3;45;.938;3600000;0
25676;171838;31;0;0;0;0;.00nan;0;0
25676;175092;9;72;24;3;21;.875;3576000;0
25676;190106;9;0;0;0;0;.00nan;0;0
25676;149452;31;79;28;2;26;.929;3600000;0
25677;320;21;0;0;0;0;.00nan;0;0
25677;3284;21;55;39;6;33;.846;3600000;0
25677;167642;5;0;0;0;0;.00nan;0;0
25677;170314;5;69;22;1;21;.955;3600000;0
25678;183844;29;0;0;0;0;.00nan;0;0
25678;183904;34;49;26;4;22;.846;3600000;0
25678;173699;29;61;41;5;36;.878;3600000;0
25678;78806;34;0;0;0;0;.00nan;0;0
25679;187578;10;0;0;0;0;.00nan;0;0
25679;90164;10;73;39;4;35;.897;3541000;0
25679;139409;3;51;21;3;18;.857;3600000;0
25679;148958;3;0;0;0;0;.00nan;0;0
25680;194416;17;0;0;0;0;.00nan;0;0
25680;178413;17;29;46;8;38;.826;3600000;0
25680;201673;25;77;27;2;25;.926;3600000;0
25680;191813;25;0;0;0;0;.00nan;0;0
25681;166591;20;26;34;7;27;.794;3600000;0
25681;183783;20;0;0;0;0;.00nan;0;0
25681;175084;22;0;0;0;0;.00nan;0;0
25681;152717;22;75;19;1;18;.947;3600000;0
25682;166646;0;55;36;5;31;.861;3544000;0
25682;3928;15;58;27;4;23;.852;3600000;0
25682;188888;0;0;0;0;0;.00nan;0;0
25682;75268;15;0;0;0;0;.00nan;0;0
25683;556;33;88;28;1;27;.964;3600000;0
25683;162029;4182;0;0;0;0;.00nan;0;0
25683;172340;4182;65;34;4;30;.882;3600000;0
25683;197038;33;0;0;0;0;.00nan;0;0
25684;179154;26;0;0;0;0;.00nan;0;0
25684;59540;23;22;21;6;15;.714;3304000;0
25684;78573;23;50;2;0;2;1.000;296000;0
25684;152835;26;79;37;3;34;.919;3600000;0
25685;184229;35;0;0;0;0;.00nan;0;0
25685;179452;27;0;0;0;0;.00nan;0;0
25685;175660;27;58;35;3;32;.914;4200000;0
25685;57338;35;72;29;3;26;.897;4200000;0
25686;13714;8;0;0;0;0;.00nan;0;0
25686;175912;14;0;0;0;0;.00nan;0;0
25686;185034;14;86;32;2;30;.938;3696000;0
25686;58830;8;58;24;3;21;.875;3696000;0
25687;187537;19;0;0;0;0;.00nan;0;0
25687;178384;19;79;27;1;26;.963;4200000;0
25687;173727;18;82;27;1;26;.963;4200000;0
25687;61425;18;0;0;0;0;.00nan;0;0
25688;174718;12;77;37;3;34;.919;3600000;0
25688;186573;16;0;0;0;0;.00nan;0;0
25688;50065;16;43;18;4;14;.778;3545000;0
25688;85798;12;0;0;0;0;.00nan;0;0
25689;170977;30;0;0;0;0;.00nan;0;0
25689;196090;4838;0;0;0;0;.00nan;0;0
25689;179950;4838;72;29;2;27;.931;3600000;0
25689;86697;30;39;23;4;19;.826;3586000;0
25690;197940;11;83;39;3;36;.923;3902000;0
25690;165723;32;0;0;0;0;.00nan;0;0
25690;20432;32;79;30;2;28;.933;3902000;0
25690;45323;11;0;0;0;0;.00nan;0;0
25691;168872;24;0;0;0;0;.00nan;0;0
25691;77955;28;0;0;0;0;.00nan;0;0
25691;85437;28;88;39;3;36;.923;3524000;0
25691;85727;24;86;27;1;26;.963;3600000;0
25692;167642;5;44;3;1;2;.667;335000;0
25692;183844;29;0;0;0;0;.00nan;0;0
25692;173699;29;81;27;1;26;.963;3600000;0
25692;170314;5;18;26;6;20;.769;3265000;0
25693;556;33;78;43;4;39;.907;3600000;0
25693;179452;27;0;0;0;0;.00nan;0;0
25693;175660;27;48;18;3;15;.833;3600000;0
25693;197038;33;0;0;0;0;.00nan;0;0
25694;187537;19;98;48;4;44;.917;3590000;0
25694;178384;19;0;0;0;0;.00nan;0;0
25694;196090;4838;52;21;3;18;.857;3600000;0
25694;179950;4838;0;0;0;0;.00nan;0;0
25695;175912;14;61;28;3;25;.893;3544000;0
25695;185034;14;0;0;0;0;.00nan;0;0
25695;186573;16;73;20;1;19;.950;3600000;0
25695;50065;16;0;0;0;0;.00nan;0;0
25696;13714;8;0;0;0;0;.00nan;0;0
25696;174718;12;58;26;3;23;.885;3544000;0
25696;58830;8;89;33;2;31;.939;3600000;0
25696;85798;12;0;0;0;0;.00nan;0;0
25697;166646;0;74;36;3;33;.917;3600000;0
25697;188888;0;0;0;0;0;.00nan;0;0
25697;77955;28;68;22;2;20;.909;3600000;0
25697;85437;28;0;0;0;0;.00nan;0;0
25698;166591;20;0;0;0;0;.00nan;0;0
25698;183783;20;83;42;3;39;.929;3554000;0
25698;175084;22;0;0;0;0;.00nan;0;0
25698;152717;22;61;15;1;14;.933;3600000;0
25699;320;21;0;0;0;0;.00nan;0;0
25699;3284;21;94;36;1;35;.972;3600000;0
25699;139409;3;37;24;4;20;.833;3600000;0
25699;148958;3;0;0;0;0;.00nan;0;0
25700;187578;10;83;39;3;36;.923;3600000;0
25700;201673;25;54;18;2;16;.889;3600000;0
25700;191813;25;0;0;0;0;.00nan;0;0
25700;90164;10;0;0;0;0;.00nan;0;0
25701;171838;31;0;0;0;0;.00nan;0;0
25701;183904;34;100;34;0;34;1.000;3600000;0
25701;78806;34;0;0;0;0;.00nan;0;0
25701;149452;31;89;43;3;40;.930;3600000;0
25702;194416;17;0;0;0;0;.00nan;0;0
25702;178413;17;60;37;4;33;.892;4200000;0
25702;184229;35;0;0;0;0;.00nan;0;0
25702;57338;35;58;32;4;28;.875;4200000;0
25703;3928;15;27;24;6;18;.750;3317000;0
25703;175092;9;100;42;1;41;.976;3600000;0
25703;190106;9;0;0;0;0;.00nan;0;0
25703;75268;15;49;1;0;1;1.000;283000;0
25704;162029;4182;0;0;0;0;.00nan;0;0
25704;172340;4182;57;26;3;23;.885;3575000;0
25704;179154;26;0;0;0;0;.00nan;0;0
25704;152835;26;69;23;2;21;.913;3600000;0
25705;173727;18;80;30;1;29;.967;3600000;0
25705;59540;23;75;28;3;25;.893;3578000;0
25705;61425;18;0;0;0;0;.00nan;0;0
25705;78573;23;0;0;0;0;.00nan;0;0
25706;165723;32;0;0;0;0;.00nan;0;0
25706;20432;32;54;26;4;22;.846;3600000;0
25706;170977;30;0;0;0;0;.00nan;0;0
25706;86697;30;62;24;2;22;.917;3600000;0
25707;197940;11;47;33;5;28;.848;3899000;0
25707;196090;4838;0;0;0;0;.00nan;0;0
25707;179950;4838;35;21;4;17;.810;3899000;0
25707;45323;11;0;0;0;0;.00nan;0;0
25708;166591;20;93;44;3;41;.932;3600000;0
25708;13714;8;0;0;0;0;.00nan;0;0
25708;183783;20;0;0;0;0;.00nan;0;0
25708;58830;8;81;13;0;13;1.000;3600000;0
25709;175084;22;0;0;0;0;.00nan;0;0
25709;175912;14;41;34;5;29;.853;2215000;0
25709;185034;14;63;10;0;10;1.000;1385000;0
25709;152717;22;54;17;3;14;.824;3600000;0
25710;187578;10;0;0;0;0;.00nan;0;0
25710;183904;34;54;29;4;25;.862;3587000;0
25710;78806;34;0;0;0;0;.00nan;0;0
25710;90164;10;85;48;3;45;.938;3600000;0
25711;171838;31;0;0;0;0;.00nan;0;0
25711;167642;5;0;0;0;0;.00nan;0;0
25711;170314;5;50;22;3;19;.864;3548000;0
25711;149452;31;89;34;2;32;.941;3600000;0
25712;166646;0;60;40;5;35;.875;3600000;0
25712;188888;0;0;0;0;0;.00nan;0;0
25712;183844;29;0;0;0;0;.00nan;0;0
25712;173699;29;61;18;2;16;.889;3600000;0
25713;187537;19;56;36;4;32;.889;3600000;0
25713;178384;19;0;0;0;0;.00nan;0;0
25713;179154;26;0;0;0;0;.00nan;0;0
25713;152835;26;100;31;0;31;1.000;3600000;0
25714;173727;18;78;23;1;22;.957;3600000;0
25714;184229;35;0;0;0;0;.00nan;0;0
25714;57338;35;68;42;5;37;.881;3600000;0
25714;61425;18;0;0;0;0;.00nan;0;0
25715;162029;4182;0;0;0;0;.00nan;0;0
25715;172340;4182;79;39;4;35;.897;3524000;0
25715;170977;30;0;0;0;0;.00nan;0;0
25715;86697;30;62;19;2;17;.895;3600000;0
25716;3928;15;75;21;2;19;.905;3600000;0
25716;75268;15;0;0;0;0;.00nan;0;0
25716;77955;28;0;0;0;0;.00nan;0;0
25716;85437;28;58;40;4;36;.900;3538000;0
25717;183844;29;74;28;1;27;.964;3600000;0
25717;173699;29;0;0;0;0;.00nan;0;0
25717;139409;3;68;31;3;28;.903;3590000;0
25717;148958;3;0;0;0;0;.00nan;0;0
25718;168872;24;0;0;0;0;.00nan;0;0
25718;175084;22;84;28;1;27;.964;3600000;0
25718;85727;24;95;36;3;33;.917;3544000;0
25718;152717;22;0;0;0;0;.00nan;0;0
25719;183904;34;0;0;0;0;.00nan;0;0
25719;201673;25;65;26;3;23;.885;3545000;0
25719;191813;25;0;0;0;0;.00nan;0;0
25719;78806;34;79;32;2;30;.938;3600000;0
25720;556;33;63;29;3;26;.897;4200000;0
25720;194416;17;0;0;0;0;.00nan;0;0
25720;178413;17;68;34;3;31;.912;4200000;0
25720;197038;33;0;0;0;0;.00nan;0;0
25721;174718;12;81;39;3;36;.923;3565000;0
25721;175092;9;0;0;0;0;.00nan;0;0
25721;190106;9;62;20;2;18;.900;3600000;0
25721;85798;12;0;0;0;0;.00nan;0;0
25722;196090;4838;21;18;6;12;.667;2310000;0
25722;179950;4838;77;13;0;13;1.000;1229000;0
25722;59540;23;75;35;4;31;.886;3600000;0
25722;78573;23;0;0;0;0;.00nan;0;0
25723;197940;11;68;40;4;36;.900;3514000;0
25723;179452;27;0;0;0;0;.00nan;0;0
25723;175660;27;58;14;2;12;.857;3600000;0
25723;45323;11;0;0;0;0;.00nan;0;0
25724;171838;31;0;0;0;0;.00nan;0;0
25724;166646;0;43;42;7;35;.833;3171000;0
25724;188888;0;44;3;1;2;.667;429000;0
25724;149452;31;57;31;5;26;.839;3600000;0
25725;168872;24;0;0;0;0;.00nan;0;0
25725;175912;14;65;31;3;28;.903;3600000;0
25725;185034;14;0;0;0;0;.00nan;0;0
25725;85727;24;55;31;4;27;.871;3600000;0
25726;187537;19;81;28;2;26;.929;3600000;0
25726;165723;32;0;0;0;0;.00nan;0;0
25726;178384;19;0;0;0;0;.00nan;0;0
25726;20432;32;48;20;3;17;.850;3591000;0
25727;197940;11;98;53;3;50;.943;3600000;0
25727;186573;16;0;0;0;0;.00nan;0;0
25727;45323;11;0;0;0;0;.00nan;0;0
25727;50065;16;52;14;2;12;.857;3600000;0
25728;173727;18;0;0;0;0;.00nan;0;0
25728;170977;30;0;0;0;0;.00nan;0;0
25728;61425;18;61;32;3;29;.906;3544000;0
25728;86697;30;71;32;2;30;.938;3600000;0
25729;320;21;0;0;0;0;.00nan;0;0
25729;3284;21;56;16;2;14;.875;3600000;0
25729;175092;9;0;0;0;0;.00nan;0;0
25729;190106;9;34;45;8;37;.822;3600000;0
25730;166591;20;90;48;4;44;.917;3600000;0
25730;183783;20;0;0;0;0;.00nan;0;0
25730;183904;34;51;20;3;17;.850;3600000;0
25730;78806;34;0;0;0;0;.00nan;0;0
25731;171838;31;70;44;5;39;.886;3600000;0
25731;139409;3;98;21;0;21;1.000;3600000;0
25731;148958;3;0;0;0;0;.00nan;0;0
25731;149452;31;0;0;0;0;.00nan;0;0
25732;194416;17;0;0;0;0;.00nan;0;0
25732;183844;29;49;17;2;15;.882;2450000;0
25732;178413;17;67;19;1;18;.947;3600000;0
25732;173699;29;30;17;4;13;.765;1150000;0
25733;3928;15;83;32;2;30;.938;3522000;0
25733;175084;22;0;0;0;0;.00nan;0;0
25733;75268;15;0;0;0;0;.00nan;0;0
25733;152717;22;100;39;0;39;1.000;3600000;0
25734;556;33;75;39;4;35;.897;3592000;0
25734;13714;8;0;0;0;0;.00nan;0;0
25734;197038;33;0;0;0;0;.00nan;0;0
25734;58830;8;83;31;2;29;.935;3600000;0
25735;179154;26;0;0;0;0;.00nan;0;0
25735;174718;12;54;34;4;30;.882;3515000;0
25735;85798;12;0;0;0;0;.00nan;0;0
25735;152835;26;72;21;2;19;.905;3600000;0
25736;184229;35;0;0;0;0;.00nan;0;0
25736;57338;35;88;28;2;26;.929;3600000;0
25736;59540;23;67;33;3;30;.909;3600000;0
25736;78573;23;0;0;0;0;.00nan;0;0
25737;162029;4182;0;0;0;0;.00nan;0;0
25737;172340;4182;63;37;4;33;.892;3558000;0
25737;173727;18;51;23;3;20;.870;3600000;0
25737;61425;18;0;0;0;0;.00nan;0;0
25738;187578;10;56;33;5;28;.848;3562000;0
25738;77955;28;0;0;0;0;.00nan;0;0
25738;85437;28;52;29;4;25;.862;3600000;0
25738;90164;10;0;0;0;0;.00nan;0;0
25739;320;21;87;32;1;31;.969;3600000;0
25739;3284;21;0;0;0;0;.00nan;0;0
25739;3928;15;53;19;2;17;.895;3552000;0
25739;75268;15;0;0;0;0;.00nan;0;0
25740;167642;5;43;32;5;27;.844;4200000;0
25740;170314;5;0;0;0;0;.00nan;0;0
25740;175912;14;0;0;0;0;.00nan;0;0
25740;185034;14;76;49;5;44;.898;4200000;0
25741;187537;19;87;31;1;30;.968;3600000;0
25741;13714;8;92;29;2;27;.931;3568000;0
25741;178384;19;0;0;0;0;.00nan;0;0
25741;58830;8;0;0;0;0;.00nan;0;0
25742;170977;30;0;0;0;0;.00nan;0;0
25742;196090;4838;100;43;0;43;1.000;3600000;0
25742;179950;4838;0;0;0;0;.00nan;0;0
25742;86697;30;61;35;5;30;.857;3600000;0
25743;179452;27;0;0;0;0;.00nan;0;0
25743;175660;27;97;29;0;29;1.000;3600000;0
25743;186573;16;60;31;4;27;.871;3600000;0
25743;50065;16;0;0;0;0;.00nan;0;0
25744;171838;31;0;0;0;0;.00nan;0;0
25744;175084;22;0;0;0;0;.00nan;0;0
25744;149452;31;43;31;5;26;.839;3588000;0
25744;152717;22;58;21;3;18;.857;3600000;0
25745;183844;29;0;0;0;0;.00nan;0;0
25745;173699;29;55;31;4;27;.871;3600000;0
25745;175092;9;68;31;3;28;.903;3600000;0
25745;190106;9;0;0;0;0;.00nan;0;0
25746;556;33;77;38;3;35;.921;3600000;0
25746;184229;35;0;0;0;0;.00nan;0;0
25746;197038;33;0;0;0;0;.00nan;0;0
25746;57338;35;41;23;4;19;.826;3554000;0
25747;165723;32;0;0;0;0;.00nan;0;0
25747;20432;32;74;45;4;41;.911;4200000;0
25747;201673;25;54;28;4;24;.857;4200000;0
25747;191813;25;0;0;0;0;.00nan;0;0
25748;162029;4182;0;0;0;0;.00nan;0;0
25748;172340;4182;86;32;2;30;.938;3575000;0
25748;179154;26;0;0;0;0;.00nan;0;0
25748;152835;26;86;29;1;28;.966;3600000;0
25749;166591;20;0;0;0;0;.00nan;0;0
25749;187578;10;85;29;1;28;.966;3600000;0
25749;183783;20;67;33;3;30;.909;3550000;0
25749;90164;10;0;0;0;0;.00nan;0;0
25750;166646;0;44;36;6;30;.833;2782000;0
25750;188888;0;56;13;1;12;.923;818000;0
25750;139409;3;60;24;3;21;.875;3600000;0
25750;148958;3;0;0;0;0;.00nan;0;0
25751;194416;17;0;0;0;0;.00nan;0;0
25751;178413;17;79;30;2;28;.933;3600000;0
25751;168872;24;57;14;1;13;.929;1251000;0
25751;85727;24;38;18;4;14;.778;2349000;0
25752;183904;34;84;15;0;15;1.000;3600000;0
25752;174718;12;70;49;6;43;.878;3600000;0
25752;78806;34;0;0;0;0;.00nan;0;0
25752;85798;12;0;0;0;0;.00nan;0;0
25753;187537;19;31;27;5;22;.815;2515000;0
25753;178384;19;22;11;4;7;.636;1085000;0
25753;59540;23;42;27;5;22;.815;3600000;0
25753;78573;23;0;0;0;0;.00nan;0;0
25754;197940;11;100;48;1;47;.979;3600000;0
25754;173727;18;69;26;2;24;.923;3552000;0
25754;45323;11;0;0;0;0;.00nan;0;0
25754;61425;18;0;0;0;0;.00nan;0;0
25755;167642;5;0;0;0;0;.00nan;0;0
25755;170314;5;43;27;5;22;.815;3600000;0
25755;77955;28;0;0;0;0;.00nan;0;0
25755;85437;28;99;21;0;21;1.000;3600000;0
25756;556;33;0;0;0;0;.00nan;0;0
25756;201673;25;51;12;2;10;.833;3600000;0
25756;197038;33;64;49;6;43;.878;3600000;0
25756;191813;25;0;0;0;0;.00nan;0;0
25757;320;21;0;0;0;0;.00nan;0;0
25757;166591;20;57;28;3;25;.893;3574000;0
25757;3284;21;100;31;1;30;.968;3600000;0
25757;183783;20;0;0;0;0;.00nan;0;0
25758;162029;4182;74;35;3;32;.914;3694000;0
25758;172340;4182;0;0;0;0;.00nan;0;0
25758;186573;16;0;0;0;0;.00nan;0;0
25758;50065;16;66;25;2;23;.920;3694000;0
25759;3928;15;37;21;4;17;.810;3590000;0
25759;194416;17;91;49;3;46;.939;3600000;0
25759;178413;17;0;0;0;0;.00nan;0;0
25759;75268;15;0;0;0;0;.00nan;0;0
25760;168872;24;84;32;2;30;.938;3600000;0
25760;174718;12;0;0;0;0;.00nan;0;0
25760;85727;24;0;0;0;0;.00nan;0;0
25760;85798;12;71;32;3;29;.906;3563000;0
25761;175912;14;0;0;0;0;.00nan;0;0
25761;185034;14;100;24;0;24;1.000;3600000;0
25761;139409;3;97;52;3;49;.942;3600000;0
25761;148958;3;0;0;0;0;.00nan;0;0
25762;179154;26;86;42;3;39;.929;3600000;0
25762;196090;4838;46;25;4;21;.840;3561000;0
25762;179950;4838;0;0;0;0;.00nan;0;0
25762;152835;26;0;0;0;0;.00nan;0;0
25763;13714;8;0;0;0;0;.00nan;0;0
25763;165723;32;69;39;3;36;.923;3600000;0
25763;20432;32;0;0;0;0;.00nan;0;0
25763;58830;8;82;15;0;15;1.000;3600000;0
25764;166646;0;68;50;6;44;.880;2984000;0
25764;188888;0;60;4;0;4;1.000;616000;0
25764;175084;22;0;0;0;0;.00nan;0;0
25764;152717;22;58;11;1;10;.909;3600000;0
25765;197940;11;0;0;0;0;.00nan;0;0
25765;179452;27;0;0;0;0;.00nan;0;0
25765;175660;27;75;35;3;32;.914;3803000;0
25765;45323;11;64;36;4;32;.889;3803000;0
25766;320;21;0;0;0;0;.00nan;0;0
25766;3284;21;52;30;4;26;.867;3778000;0
25766;175092;9;0;0;0;0;.00nan;0;0
25766;190106;9;72;31;3;28;.903;3778000;0
25767;3928;15;57;27;3;24;.889;3565000;0
25767;167642;5;0;0;0;0;.00nan;0;0
25767;170314;5;90;37;2;35;.946;3600000;0
25767;75268;15;0;0;0;0;.00nan;0;0
25768;194416;17;0;0;0;0;.00nan;0;0
25768;183844;29;0;0;0;0;.00nan;0;0
25768;178413;17;77;47;3;44;.936;4086000;0
25768;173699;29;60;33;4;29;.879;4086000;0
25769;187578;10;0;0;0;0;.00nan;0;0
25769;90164;10;100;35;0;35;1.000;3600000;0
25769;139409;3;66;29;3;26;.897;3600000;0
25769;148958;3;0;0;0;0;.00nan;0;0
25770;166646;0;44;4;1;3;.750;809000;0
25770;188888;0;48;40;6;34;.850;2791000;0
25770;168872;24;0;0;0;0;.00nan;0;0
25770;85727;24;100;24;0;24;1.000;3600000;0
25771;183904;34;47;24;4;20;.833;3600000;0
25771;175912;14;55;3;0;3;1.000;251000;0
25771;185034;14;52;44;6;38;.864;3349000;0
25771;78806;34;0;0;0;0;.00nan;0;0
25772;166591;20;0;0;0;0;.00nan;0;0
25772;171838;31;0;0;0;0;.00nan;0;0
25772;183783;20;29;22;5;17;.773;3557000;0
25772;149452;31;96;43;3;40;.930;3600000;0
25773;165723;32;0;0;0;0;.00nan;0;0
25773;20432;32;57;40;6;34;.850;3564000;0
25773;77955;28;0;0;0;0;.00nan;0;0
25773;85437;28;48;35;5;30;.857;3600000;0
25774;184229;35;66;13;0;13;1.000;1421000;0
25774;174718;12;85;46;4;42;.913;3600000;0
25774;57338;35;5;16;6;10;.625;2111000;0
25774;85798;12;0;0;0;0;.00nan;0;0
25775;556;33;76;48;5;43;.896;3600000;0
25775;13714;8;0;0;0;0;.00nan;0;0
25775;197038;33;0;0;0;0;.00nan;0;0
25775;58830;8;75;24;1;23;.958;3600000;0
25776;173727;18;42;24;4;20;.833;4200000;0
25776;196090;4838;0;0;0;0;.00nan;0;0
25776;179950;4838;57;39;4;35;.897;4200000;0
25776;61425;18;0;0;0;0;.00nan;0;0
25777;170977;30;0;0;0;0;.00nan;0;0
25777;186573;16;0;0;0;0;.00nan;0;0
25777;50065;16;52;24;3;21;.875;3574000;0
25777;86697;30;75;30;2;28;.933;3600000;0
25778;162029;4182;0;0;0;0;.00nan;0;0
25778;172340;4182;95;41;2;39;.951;3542000;0
25778;59540;23;58;11;1;10;.909;3600000;0
25778;78573;23;0;0;0;0;.00nan;0;0
25779;179154;26;0;0;0;0;.00nan;0;0
25779;201673;25;65;36;4;32;.889;3599000;0
25779;191813;25;0;0;0;0;.00nan;0;0
25779;152835;26;86;43;3;40;.930;3600000;0
25780;187537;19;69;32;3;29;.906;4048000;0
25780;178384;19;0;0;0;0;.00nan;0;0
25780;179452;27;0;0;0;0;.00nan;0;0
25780;175660;27;64;31;4;27;.871;4048000;0
25781;197940;11;91;40;3;37;.925;3600000;0
25781;186573;16;84;14;0;14;1.000;3600000;0
25781;45323;11;0;0;0;0;.00nan;0;0
25781;50065;16;0;0;0;0;.00nan;0;0
25782;3928;15;53;19;2;17;.895;3600000;0
25782;75268;15;0;0;0;0;.00nan;0;0
25782;77955;28;0;0;0;0;.00nan;0;0
25782;85437;28;77;55;5;50;.909;3600000;0
25783;166591;20;79;29;2;27;.931;3600000;0
25783;183783;20;0;0;0;0;.00nan;0;0
25783;183844;29;0;0;0;0;.00nan;0;0
25783;173699;29;58;31;5;26;.839;3600000;0
25784;187578;10;87;37;2;35;.946;4200000;0
25784;175912;14;56;25;2;23;.920;4200000;0
25784;185034;14;0;0;0;0;.00nan;0;0
25784;90164;10;0;0;0;0;.00nan;0;0
25785;167642;5;0;0;0;0;.00nan;0;0
25785;170314;5;72;42;4;38;.905;3600000;0
25785;175084;22;0;0;0;0;.00nan;0;0
25785;152717;22;85;21;1;20;.952;3600000;0
25786;171838;31;0;0;0;0;.00nan;0;0
25786;194416;17;0;0;0;0;.00nan;0;0
25786;178413;17;100;24;0;24;1.000;3600000;0
25786;149452;31;95;37;2;35;.946;3600000;0
25787;166646;0;91;38;2;36;.947;3600000;0
25787;188888;0;0;0;0;0;.00nan;0;0
25787;168872;24;0;0;0;0;.00nan;0;0
25787;85727;24;61;30;3;27;.900;3564000;0
25788;183904;34;67;11;1;10;.909;3600000;0
25788;78806;34;0;0;0;0;.00nan;0;0
25788;139409;3;34;37;7;30;.811;3600000;0
25788;148958;3;0;0;0;0;.00nan;0;0
25789;165723;32;0;0;0;0;.00nan;0;0
25789;20432;32;88;40;3;37;.925;4002000;0
25789;184229;35;0;0;0;0;.00nan;0;0
25789;57338;35;55;38;4;34;.895;4002000;0
25790;162029;4182;0;0;0;0;.00nan;0;0
25790;172340;4182;76;39;4;35;.897;3600000;0
25790;170977;30;56;22;3;19;.864;3600000;0
25790;86697;30;0;0;0;0;.00nan;0;0
25791;173727;18;58;30;4;26;.867;4026000;0
25791;59540;23;75;29;3;26;.897;4026000;0
25791;61425;18;0;0;0;0;.00nan;0;0
25791;78573;23;0;0;0;0;.00nan;0;0
25792;320;21;0;0;0;0;.00nan;0;0
25792;3284;21;78;44;3;41;.932;4200000;0
25792;179154;26;0;0;0;0;.00nan;0;0
25792;152835;26;66;27;3;24;.889;4200000;0
25793;174718;12;99;31;1;30;.968;3600000;0
25793;201673;25;52;34;5;29;.853;3600000;0
25793;191813;25;0;0;0;0;.00nan;0;0
25793;85798;12;0;0;0;0;.00nan;0;0
25794;187537;19;69;31;3;28;.903;4200000;0
25794;178384;19;0;0;0;0;.00nan;0;0
25794;186573;16;0;0;0;0;.00nan;0;0
25794;50065;16;85;43;3;40;.930;4200000;0
25795;196090;4838;31;21;5;16;.762;3600000;0
25795;179950;4838;0;0;0;0;.00nan;0;0
25795;59540;23;91;43;3;40;.930;3600000;0
25795;78573;23;0;0;0;0;.00nan;0;0
25796;556;33;31;38;6;32;.842;3600000;0
25796;179452;27;0;0;0;0;.00nan;0;0
25796;175660;27;52;17;2;15;.882;3600000;0
25796;197038;33;0;0;0;0;.00nan;0;0
25797;183904;34;83;15;0;15;1.000;3600000;0
25797;175912;14;0;0;0;0;.00nan;0;0
25797;185034;14;83;36;2;34;.944;3567000;0
25797;78806;34;0;0;0;0;.00nan;0;0
25798;165723;32;0;0;0;0;.00nan;0;0
25798;20432;32;68;33;4;29;.879;3600000;0
25798;170977;30;0;0;0;0;.00nan;0;0
25798;86697;30;77;23;1;22;.957;3600000;0
25799;13714;8;0;0;0;0;.00nan;0;0
25799;184229;35;0;0;0;0;.00nan;0;0
25799;57338;35;71;27;2;25;.926;3596000;0
25799;58830;8;72;19;1;18;.947;3600000;0
25800;183844;29;0;0;0;0;.00nan;0;0
25800;173699;29;96;28;0;28;1.000;3600000;0
25800;77955;28;0;0;0;0;.00nan;0;0
25800;85437;28;84;42;3;39;.929;3600000;0
25801;187578;10;0;0;0;0;.00nan;0;0
25801;168872;24;0;0;0;0;.00nan;0;0
25801;85727;24;51;51;7;44;.863;3600000;0
25801;90164;10;86;18;1;17;.944;3600000;0
25802;171838;31;60;6;0;6;1.000;424000;0
25802;3928;15;0;0;0;0;.00nan;0;0
25802;75268;15;60;20;2;18;.900;3600000;0
25802;149452;31;55;44;6;38;.864;3176000;0
25803;194416;17;0;0;0;0;.00nan;0;0
25803;178413;17;49;28;4;24;.857;3600000;0
25803;139409;3;56;27;3;24;.889;3600000;0
25803;148958;3;0;0;0;0;.00nan;0;0
25804;166646;0;55;37;5;32;.865;3592000;0
25804;167642;5;0;0;0;0;.00nan;0;0
25804;188888;0;0;0;0;0;.00nan;0;0
25804;170314;5;53;23;4;19;.826;3600000;0
25805;166591;20;75;38;3;35;.921;3517000;0
25805;183783;20;0;0;0;0;.00nan;0;0
25805;174718;12;0;0;0;0;.00nan;0;0
25805;85798;12;95;38;1;37;.974;3600000;0
25806;175084;22;0;0;0;0;.00nan;0;0
25806;175092;9;0;0;0;0;.00nan;0;0
25806;190106;9;94;46;3;43;.935;4200000;0
25806;152717;22;51;25;3;22;.880;4200000;0
25807;197940;11;24;8;3;5;.625;451000;0
25807;187537;19;0;0;0;0;.00nan;0;0
25807;178384;19;84;33;1;32;.970;3600000;0
25807;45323;11;25;28;6;22;.786;3149000;0
25808;173727;18;82;38;3;35;.921;3600000;0
25808;196090;4838;0;0;0;0;.00nan;0;0
25808;179950;4838;21;30;7;23;.767;3600000;0
25808;61425;18;0;0;0;0;.00nan;0;0
25809;556;33;0;0;0;0;.00nan;0;0
25809;162029;4182;0;0;0;0;.00nan;0;0
25809;172340;4182;54;26;4;22;.846;3600000;0
25809;197038;33;65;47;5;42;.894;3600000;0
25810;170977;30;0;0;0;0;.00nan;0;0
25810;179154;26;0;0;0;0;.00nan;0;0
25810;86697;30;96;24;0;24;1.000;3600000;0
25810;152835;26;77;30;2;28;.933;3519000;0
25811;13714;8;71;23;1;22;.957;3600000;0
25811;179452;27;0;0;0;0;.00nan;0;0
25811;175660;27;79;27;2;25;.926;3545000;0
25811;58830;8;0;0;0;0;.00nan;0;0
25812;320;21;0;0;0;0;.00nan;0;0
25812;3284;21;79;55;4;51;.927;3569000;0
25812;201673;25;64;26;3;23;.885;3600000;0
25812;191813;25;0;0;0;0;.00nan;0;0
25813;186573;16;61;26;3;23;.885;3600000;0
25813;50065;16;0;0;0;0;.00nan;0;0
25813;59540;23;77;50;6;44;.880;3600000;0
25813;78573;23;0;0;0;0;.00nan;0;0
25814;167642;5;0;0;0;0;.00nan;0;0
25814;170314;5;49;18;3;15;.833;3543000;0
25814;139409;3;82;33;2;31;.939;3600000;0
25814;148958;3;0;0;0;0;.00nan;0;0
25815;183904;34;68;27;2;25;.926;3600000;0
25815;168872;24;0;0;0;0;.00nan;0;0
25815;78806;34;0;0;0;0;.00nan;0;0
25815;85727;24;47;34;5;29;.853;3600000;0
25816;174718;12;78;48;5;43;.896;3600000;0
25816;175084;22;0;0;0;0;.00nan;0;0
25816;85798;12;0;0;0;0;.00nan;0;0
25816;152717;22;60;24;3;21;.875;3600000;0
25817;171838;31;0;0;0;0;.00nan;0;0
25817;77955;28;0;0;0;0;.00nan;0;0
25817;85437;28;52;37;5;32;.865;3572000;0
25817;149452;31;67;29;3;26;.897;3600000;0
25818;3928;15;58;24;3;21;.875;3600000;0
25818;175092;9;69;50;5;45;.900;3572000;0
25818;190106;9;0;0;0;0;.00nan;0;0
25818;75268;15;0;0;0;0;.00nan;0;0
25819;194416;17;0;0;0;0;.00nan;0;0
25819;178413;17;71;37;3;34;.919;3600000;0
25819;175912;14;0;0;0;0;.00nan;0;0
25819;185034;14;40;33;6;27;.818;3600000;0
25820;187537;19;0;0;0;0;.00nan;0;0
25820;162029;4182;0;0;0;0;.00nan;0;0
25820;172340;4182;91;19;0;19;1.000;3600000;0
25820;178384;19;98;41;2;39;.951;3574000;0
25821;556;33;99;57;3;54;.947;4029000;0
25821;173727;18;33;14;4;10;.714;4029000;0
25821;197038;33;0;0;0;0;.00nan;0;0
25821;61425;18;0;0;0;0;.00nan;0;0
25822;194416;17;87;38;2;36;.947;4200000;0
25822;178413;17;0;0;0;0;.00nan;0;0
25822;175092;9;0;0;0;0;.00nan;0;0
25822;190106;9;96;48;2;46;.958;4200000;0
25823;320;21;0;0;0;0;.00nan;0;0
25823;166591;20;0;0;0;0;.00nan;0;0
25823;3284;21;61;16;2;14;.875;3600000;0
25823;183783;20;66;43;5;38;.884;3600000;0
25824;166646;0;82;33;2;31;.939;3600000;0
25824;188888;0;0;0;0;0;.00nan;0;0
25824;183844;29;0;0;0;0;.00nan;0;0
25824;173699;29;53;21;3;18;.857;3600000;0
25825;167642;5;79;38;2;36;.947;4200000;0
25825;170314;5;0;0;0;0;.00nan;0;0
25825;139409;3;0;0;0;0;.00nan;0;0
25825;148958;3;69;27;2;25;.926;4200000;0
25826;187578;10;64;26;2;24;.923;3554000;0
25826;3928;15;0;0;0;0;.00nan;0;0
25826;75268;15;98;38;1;37;.974;3600000;0
25826;90164;10;0;0;0;0;.00nan;0;0
25827;184229;35;85;36;2;34;.944;2903000;0
25827;170977;30;0;0;0;0;.00nan;0;0
25827;57338;35;21;7;4;3;.429;697000;0
25827;86697;30;72;23;1;22;.957;3600000;0
25828;179452;27;0;0;0;0;.00nan;0;0
25828;175660;27;57;24;3;21;.875;3600000;0
25828;201673;25;61;29;4;25;.862;3565000;0
25828;191813;25;0;0;0;0;.00nan;0;0
25829;197940;11;50;34;5;29;.853;3533000;0
25829;45323;11;0;0;0;0;.00nan;0;0
25829;59540;23;60;23;3;20;.870;3600000;0
25829;78573;23;0;0;0;0;.00nan;0;0
25830;183904;34;81;33;2;31;.939;3600000;0
25830;175084;22;0;0;0;0;.00nan;0;0
25830;78806;34;0;0;0;0;.00nan;0;0
25830;152717;22;39;25;5;20;.800;3600000;0
25831;171838;31;0;0;0;0;.00nan;0;0
25831;166646;0;0;0;0;0;.00nan;0;0
25831;188888;0;83;37;3;34;.919;3545000;0
25831;149452;31;63;19;2;17;.895;3600000;0
25832;165723;32;0;0;0;0;.00nan;0;0
25832;20432;32;100;46;1;45;.978;3600000;0
25832;179154;26;0;0;0;0;.00nan;0;0
25832;152835;26;51;30;4;26;.867;3600000;0
25833;187537;19;0;0;0;0;.00nan;0;0
25833;178384;19;86;36;2;34;.944;3600000;0
25833;186573;16;0;0;0;0;.00nan;0;0
25833;50065;16;38;24;4;20;.833;3540000;0
25834;556;33;75;43;4;39;.907;3600000;0
25834;170977;30;75;21;1;20;.952;3600000;0
25834;197038;33;0;0;0;0;.00nan;0;0
25834;86697;30;0;0;0;0;.00nan;0;0
25835;197940;11;67;25;2;23;.920;3600000;0
25835;184229;35;0;0;0;0;.00nan;0;0
25835;45323;11;0;0;0;0;.00nan;0;0
25835;57338;35;74;32;3;29;.906;3600000;0
25836;162029;4182;0;0;0;0;.00nan;0;0
25836;172340;4182;100;40;0;40;1.000;3815000;0
25836;59540;23;85;23;1;22;.957;3815000;0
25836;78573;23;0;0;0;0;.00nan;0;0
25837;187537;19;67;28;2;26;.929;3600000;0
25837;13714;8;0;0;0;0;.00nan;0;0
25837;178384;19;0;0;0;0;.00nan;0;0
25837;58830;8;98;32;1;31;.969;3600000;0
25838;179452;27;0;0;0;0;.00nan;0;0
25838;175660;27;68;39;4;35;.897;3600000;0
25838;196090;4838;79;26;2;24;.923;3600000;0
25838;179950;4838;0;0;0;0;.00nan;0;0
25839;173727;18;81;29;2;27;.931;3600000;0
25839;201673;25;21;24;6;18;.750;2162000;0
25839;191813;25;61;11;0;11;1.000;1438000;0
25839;61425;18;0;0;0;0;.00nan;0;0
25841;167642;18;0;0;0;0;.00nan;0;0
25841;173727;18;67;21;2;19;.905;3947000;0
25841;186573;0;0;0;0;0;.00nan;0;0
25841;59540;0;92;51;3;48;.941;3947000;0
25843;187537;19;53;28;4;24;.857;3551000;0
25843;163565;19;0;0;0;0;.00nan;0;0
25843;194416;17;0;0;0;0;.00nan;0;0
25843;178413;17;70;31;2;29;.935;3600000;0
25845;3928;15;28;35;7;28;.800;2969000;0
25845;163195;15;40;3;1;2;.667;631000;0
25845;175084;22;79;26;1;25;.962;3600000;0
25845;184770;22;0;0;0;0;.00nan;0;0
25847;165723;32;0;0;0;0;.00nan;0;0
25847;20432;32;100;38;0;38;1.000;3600000;0
25847;170977;30;0;0;0;0;.00nan;0;0
25847;86697;30;43;28;5;23;.821;3600000;0
25849;197940;11;60;25;3;22;.880;3600000;0
25849;45323;11;0;0;0;0;.00nan;0;0
25849;139409;3;81;33;2;31;.939;3600000;0
25849;148958;3;0;0;0;0;.00nan;0;0
25851;168872;24;0;0;0;0;.00nan;0;0
25851;184229;35;0;0;0;0;.00nan;0;0
25851;57338;35;78;30;2;28;.933;3600000;0
25851;85727;24;83;46;3;43;.935;3588000;0
25853;187578;10;22;32;7;25;.781;2655000;0
25853;183844;29;0;0;0;0;.00nan;0;0
25853;173699;29;68;38;5;33;.868;3600000;0
25853;90164;10;53;3;0;3;1.000;862000;0
25855;556;33;67;47;5;42;.894;3657000;0
25855;175092;9;0;0;0;0;.00nan;0;0
25855;190106;9;40;35;6;29;.829;3657000;0
25855;197038;33;0;0;0;0;.00nan;0;0
25857;13714;8;72;23;2;21;.913;3571000;0
25857;-1;5;0;0;0;0;.00nan;0;0
25857;58830;8;0;0;0;0;.00nan;0;0
25857;61425;5;62;18;1;17;.944;3600000;0
25859;179154;26;87;35;2;33;.943;3600000;0
25859;179452;27;0;0;0;0;.00nan;0;0
25859;175660;27;84;26;1;25;.962;3600000;0
25859;152835;26;0;0;0;0;.00nan;0;0
25861;77955;28;72;30;2;28;.933;3577000;0
25861;85437;28;0;0;0;0;.00nan;0;0
25861;149452;31;85;26;1;25;.962;3600000;0
25861;152717;31;0;0;0;0;.00nan;0;0
25863;166591;20;49;27;4;23;.852;3593000;0
25863;183783;20;0;0;0;0;.00nan;0;0
25863;183904;34;72;36;3;33;.917;3600000;0
25863;78806;34;0;0;0;0;.00nan;0;0
25865;183859;23;0;0;0;0;.00nan;0;0
25865;66491;12;0;0;0;0;.00nan;0;0
25865;78573;23;97;31;1;30;.968;3600000;0
25865;85798;12;56;23;3;20;.870;3520000;0
25867;162029;4182;0;0;0;0;.00nan;0;0
25867;172340;4182;80;47;3;44;.936;4200000;0
25867;179950;4838;0;0;0;0;.00nan;0;0
25867;185743;4838;73;35;3;32;.914;4200000;0
25869;320;21;0;0;0;0;.00nan;0;0
25869;3284;21;85;41;2;39;.951;3600000;0
25869;175912;14;0;0;0;0;.00nan;0;0
25869;185034;14;46;23;3;20;.870;3600000;0
25871;166646;16;0;0;0;0;.00nan;0;0
25871;170314;25;65;21;2;19;.905;3600000;0
25871;201673;25;0;0;0;0;.00nan;0;0
25871;50065;16;60;30;3;27;.900;3542000;0
25873;179452;27;64;37;5;32;.865;3557000;0
25873;175660;27;0;0;0;0;.00nan;0;0
25873;66491;12;0;0;0;0;.00nan;0;0
25873;85798;12;54;20;3;17;.850;3600000;0
25875;183904;34;0;0;0;0;.00nan;0;0
25875;175912;14;0;0;0;0;.00nan;0;0
25875;185034;14;46;33;5;28;.848;3600000;0
25875;78806;34;81;25;1;24;.960;3600000;0
25877;13714;8;64;34;4;30;.882;3600000;0
25877;170314;25;47;30;5;25;.833;3572000;0
25877;201673;25;0;0;0;0;.00nan;0;0
25877;58830;8;0;0;0;0;.00nan;0;0
25879;187578;10;0;0;0;0;.00nan;0;0
25879;183859;23;0;0;0;0;.00nan;0;0
25879;78573;23;73;38;4;34;.895;4200000;0
25879;90164;10;40;30;4;26;.867;4200000;0
25881;162029;4182;0;0;0;0;.00nan;0;0
25881;172340;4182;100;32;0;32;1.000;3600000;0
25881;186573;0;0;0;0;0;.00nan;0;0
25881;59540;0;86;46;3;43;.935;3600000;0
25883;197940;11;4;12;6;6;.500;2220000;0
25883;-1;5;0;0;0;0;.00nan;0;0
25883;45323;11;63;12;0;12;1.000;1380000;0
25883;61425;5;71;24;1;23;.958;3600000;0
25885;168872;24;0;0;0;0;.00nan;0;0
25885;170977;30;57;7;0;7;1.000;1036000;0
25885;85727;24;59;24;2;22;.917;3600000;0
25885;86697;30;28;28;6;22;.786;2564000;0
25887;320;21;0;0;0;0;.00nan;0;0
25887;3284;21;51;14;2;12;.857;3600000;0
25887;149452;31;0;0;0;0;.00nan;0;0
25887;152717;31;55;49;6;43;.878;3600000;0
25889;166591;20;91;40;3;37;.925;3600000;0
25889;165723;32;0;0;0;0;.00nan;0;0
25889;183783;20;0;0;0;0;.00nan;0;0
25889;20432;32;24;15;5;10;.667;3600000;0
25891;556;33;97;49;3;46;.939;3600000;0
25891;3928;15;68;20;1;19;.950;3600000;0
25891;163195;15;0;0;0;0;.00nan;0;0
25891;197038;33;0;0;0;0;.00nan;0;0
25893;167642;18;0;0;0;0;.00nan;0;0
25893;173727;18;57;31;4;27;.871;3600000;0
25893;175092;9;43;5;1;4;.800;348000;0
25893;190106;9;34;33;6;27;.818;3252000;0
25895;166646;16;63;21;2;19;.905;3600000;0
25895;183844;29;45;38;5;33;.868;3600000;0
25895;173699;29;0;0;0;0;.00nan;0;0
25895;50065;16;0;0;0;0;.00nan;0;0
25897;184229;35;0;0;0;0;.00nan;0;0
25897;179154;26;84;30;2;28;.933;3600000;0
25897;57338;35;38;33;6;27;.818;3600000;0
25897;152835;26;0;0;0;0;.00nan;0;0
25899;187537;19;78;43;3;40;.930;3545000;0
25899;163565;19;0;0;0;0;.00nan;0;0
25899;194416;17;0;0;0;0;.00nan;0;0
25899;178413;17;75;28;2;26;.929;3600000;0
25901;175084;22;73;29;1;28;.966;4200000;0
25901;184770;22;0;0;0;0;.00nan;0;0
25901;139409;3;82;35;1;34;.971;4200000;0
25901;148958;3;0;0;0;0;.00nan;0;0
25903;179950;4838;70;19;1;18;.947;3600000;0
25903;185743;4838;0;0;0;0;.00nan;0;0
25903;77955;28;0;0;0;0;.00nan;0;0
25903;85437;28;77;40;4;36;.900;3600000;0
25905;170977;30;0;0;0;0;.00nan;0;0
25905;77955;28;61;38;4;34;.895;3514000;0
25905;85437;28;0;0;0;0;.00nan;0;0
25905;86697;30;55;23;2;21;.913;3600000;0
25907;184229;35;56;30;4;26;.867;3872000;0
25907;175084;22;0;0;0;0;.00nan;0;0
25907;184770;22;47;33;5;28;.848;3912000;0
25907;57338;35;0;0;0;0;.00nan;0;0
25909;-1;5;48;28;5;23;.821;3547000;0
25909;186573;0;0;0;0;0;.00nan;0;0
25909;59540;0;64;32;4;28;.875;3600000;0
25909;61425;5;0;0;0;0;.00nan;0;0
25911;183859;23;71;31;3;28;.903;3600000;0
25911;175912;14;69;24;2;22;.917;3600000;0
25911;185034;14;0;0;0;0;.00nan;0;0
25911;78573;23;0;0;0;0;.00nan;0;0
25913;187537;19;0;0;0;0;.00nan;0;0
25913;163565;19;54;22;3;19;.864;3599000;0
25913;149452;31;83;40;2;38;.950;3600000;0
25913;152717;31;0;0;0;0;.00nan;0;0
25915;162029;4182;0;0;0;0;.00nan;0;0
25915;172340;4182;60;35;4;31;.886;3517000;0
25915;179950;4838;0;0;0;0;.00nan;0;0
25915;185743;4838;80;33;2;31;.939;3600000;0
25917;187578;10;88;27;1;26;.963;3600000;0
25917;66491;12;63;30;3;27;.900;3528000;0
25917;85798;12;0;0;0;0;.00nan;0;0
25917;90164;10;0;0;0;0;.00nan;0;0
25919;167642;18;64;39;5;34;.872;3600000;0
25919;173727;18;0;0;0;0;.00nan;0;0
25919;179452;27;0;0;0;0;.00nan;0;0
25919;175660;27;6;33;9;24;.727;3600000;0
25921;3928;15;0;0;0;0;.00nan;0;0
25921;163195;15;80;15;0;15;1.000;3600000;0
25921;165723;32;96;51;3;48;.941;3600000;0
25921;20432;32;0;0;0;0;.00nan;0;0
25923;197940;11;15;7;4;3;.429;642000;0
25923;183844;29;0;0;0;0;.00nan;0;0
25923;173699;29;80;29;1;28;.966;3600000;0
25923;45323;11;70;27;2;25;.926;2958000;0
25925;556;33;0;0;0;0;.00nan;0;0
25925;175092;9;79;42;3;39;.929;4200000;0
25925;190106;9;0;0;0;0;.00nan;0;0
25925;197038;33;96;49;3;46;.939;4188000;0
25927;320;21;69;35;3;32;.914;3600000;0
25927;3284;21;0;0;0;0;.00nan;0;0
25927;13714;8;0;0;0;0;.00nan;0;0
25927;58830;8;79;40;4;36;.900;3554000;0
25929;194416;17;58;35;5;30;.857;4134000;0
25929;178413;17;0;0;0;0;.00nan;0;0
25929;179154;26;0;0;0;0;.00nan;0;0
25929;152835;26;72;41;4;37;.902;4151000;0
25931;183904;34;75;34;3;31;.912;3587000;0
25931;168872;24;70;19;1;18;.947;3600000;0
25931;78806;34;0;0;0;0;.00nan;0;0
25931;85727;24;0;0;0;0;.00nan;0;0
25933;166591;20;0;0;0;0;.00nan;0;0
25933;183783;20;72;23;1;22;.957;3600000;0
25933;139409;3;57;32;4;28;.875;3600000;0
25933;148958;3;0;0;0;0;.00nan;0;0
25935;166646;16;0;0;0;0;.00nan;0;0
25935;170314;25;0;0;0;0;.00nan;0;0
25935;201673;25;80;17;0;17;1.000;3600000;0
25935;50065;16;74;39;3;36;.923;3600000;0
25937;13714;8;84;30;2;28;.933;3865000;0
25937;165723;32;0;0;0;0;.00nan;0;0
25937;20432;32;77;32;3;29;.906;3865000;0
25937;58830;8;0;0;0;0;.00nan;0;0
25939;3928;15;0;0;0;0;.00nan;0;0
25939;163195;15;19;19;5;14;.737;3550000;0
25939;175092;9;0;0;0;0;.00nan;0;0
25939;190106;9;75;32;3;29;.906;3600000;0
25941;162029;4182;0;0;0;0;.00nan;0;0
25941;172340;4182;57;25;3;22;.880;3558000;0
25941;175912;14;0;0;0;0;.00nan;0;0
25941;185034;14;91;32;1;31;.969;3600000;0
25943;166646;16;51;26;3;23;.885;3600000;0
25943;184229;35;0;0;0;0;.00nan;0;0
25943;50065;16;0;0;0;0;.00nan;0;0
25943;57338;35;81;27;1;26;.963;3600000;0
25945;167642;18;0;0;0;0;.00nan;0;0
25945;194416;17;0;0;0;0;.00nan;0;0
25945;178413;17;88;41;2;39;.951;3572000;0
25945;173727;18;80;16;0;16;1.000;3600000;0
25947;197940;11;71;27;2;25;.926;3600000;0
25947;183859;23;0;0;0;0;.00nan;0;0
25947;45323;11;0;0;0;0;.00nan;0;0
25947;78573;23;44;16;3;13;.813;3548000;0
25949;320;21;0;0;0;0;.00nan;0;0
25949;3284;21;81;36;3;33;.917;3600000;0
25949;66491;12;0;0;0;0;.00nan;0;0
25949;85798;12;49;37;5;32;.865;3530000;0
25951;168872;24;0;0;0;0;.00nan;0;0
25951;85727;24;79;32;2;30;.938;3600000;0
25951;139409;3;73;41;4;37;.902;3600000;0
25951;148958;3;0;0;0;0;.00nan;0;0
25953;166591;20;0;0;0;0;.00nan;0;0
25953;183783;20;79;49;4;45;.918;3600000;0
25953;175084;22;51;24;3;21;.875;3600000;0
25953;184770;22;0;0;0;0;.00nan;0;0
25955;-1;5;0;0;0;0;.00nan;0;0
25955;179950;4838;69;26;3;23;.885;4200000;0
25955;185743;4838;0;0;0;0;.00nan;0;0
25955;61425;5;58;38;3;35;.921;4200000;0
25957;170314;25;0;0;0;0;.00nan;0;0
25957;179154;26;100;36;0;36;1.000;3600000;0
25957;201673;25;23;17;5;12;.706;3600000;0
25957;152835;26;0;0;0;0;.00nan;0;0
25959;179452;27;0;0;0;0;.00nan;0;0
25959;175660;27;59;13;1;12;.923;3600000;0
25959;186573;0;50;27;4;23;.852;1525000;0
25959;59540;0;48;30;5;25;.833;2075000;0
25961;556;33;47;28;4;24;.857;3600000;0
25961;187578;10;84;30;1;29;.967;3600000;0
25961;197038;33;0;0;0;0;.00nan;0;0
25961;90164;10;0;0;0;0;.00nan;0;0
25963;183844;29;53;4;0;4;1.000;397000;0
25963;173699;29;43;37;6;31;.838;3203000;0
25963;170977;30;63;24;2;22;.917;3600000;0
25963;86697;30;0;0;0;0;.00nan;0;0
25965;187537;19;55;37;5;32;.865;3558000;0
25965;163565;19;0;0;0;0;.00nan;0;0
25965;77955;28;0;0;0;0;.00nan;0;0
25965;85437;28;80;41;4;37;.902;3600000;0
25967;183904;34;0;0;0;0;.00nan;0;0
25967;78806;34;72;10;0;10;1.000;3600000;0
25967;149452;31;0;0;0;0;.00nan;0;0
25967;152717;31;97;44;1;43;.977;3600000;0
25969;184229;35;81;15;0;15;1.000;3600000;0
25969;57338;35;0;0;0;0;.00nan;0;0
25969;66491;12;71;35;3;32;.914;3600000;0
25969;85798;12;0;0;0;0;.00nan;0;0
25971;197940;11;0;0;0;0;.00nan;0;0
25971;45323;11;69;20;1;19;.950;3600000;0
25971;77955;28;72;33;3;30;.909;3576000;0
25971;85437;28;0;0;0;0;.00nan;0;0
25973;166646;16;0;0;0;0;.00nan;0;0
25973;186573;0;0;0;0;0;.00nan;0;0
25973;50065;16;52;16;2;14;.875;3600000;0
25973;59540;0;71;48;5;43;.896;3600000;0
25975;3928;15;52;8;1;7;.875;3600000;0
25975;163195;15;0;0;0;0;.00nan;0;0
25975;165723;32;84;44;4;40;.909;3600000;0
25975;20432;32;0;0;0;0;.00nan;0;0
25977;175084;22;0;0;0;0;.00nan;0;0
25977;184770;22;72;25;1;24;.960;3600000;0
25977;149452;31;67;27;2;25;.926;3591000;0
25977;152717;31;0;0;0;0;.00nan;0;0
25979;183859;23;76;30;1;29;.967;3600000;0
25979;78573;23;0;0;0;0;.00nan;0;0
25979;139409;3;66;25;2;23;.920;3600000;0
25979;148958;3;0;0;0;0;.00nan;0;0
25981;194416;17;15;29;7;22;.759;3600000;0
25981;178413;17;0;0;0;0;.00nan;0;0
25981;168872;24;69;29;3;26;.897;3600000;0
25981;85727;24;0;0;0;0;.00nan;0;0
25983;187578;10;0;0;0;0;.00nan;0;0
25983;170977;30;0;0;0;0;.00nan;0;0
25983;86697;30;71;20;1;19;.950;4200000;0
25983;90164;10;85;32;1;31;.969;4200000;0
25985;187537;19;46;6;1;5;.833;375000;0
25985;163565;19;44;47;7;40;.851;3225000;0
25985;13714;8;0;0;0;0;.00nan;0;0
25985;58830;8;43;15;3;12;.800;3600000;0
25987;166591;20;98;32;1;31;.969;3600000;0
25987;183783;20;0;0;0;0;.00nan;0;0
25987;170314;25;51;22;3;19;.864;3568000;0
25987;201673;25;0;0;0;0;.00nan;0;0
25989;179154;26;57;23;3;20;.870;3988000;0
25989;175912;14;95;41;2;39;.951;3988000;0
25989;185034;14;0;0;0;0;.00nan;0;0
25989;152835;26;0;0;0;0;.00nan;0;0
25991;320;21;100;45;3;42;.933;3600000;0
25991;3284;21;0;0;0;0;.00nan;0;0
25991;175092;9;52;32;4;28;.875;3555000;0
25991;190106;9;0;0;0;0;.00nan;0;0
25993;-1;5;53;38;5;33;.868;3535000;0
25993;179950;4838;0;0;0;0;.00nan;0;0
25993;185743;4838;52;23;3;20;.870;3600000;0
25993;61425;5;0;0;0;0;.00nan;0;0
25995;183844;29;42;39;6;33;.846;2801000;0
25995;183904;34;67;18;1;17;.944;3600000;0
25995;173699;29;42;11;2;9;.818;799000;0
25995;78806;34;0;0;0;0;.00nan;0;0
25997;556;33;0;0;0;0;.00nan;0;0
25997;179452;27;56;24;3;21;.875;3544000;0
25997;175660;27;0;0;0;0;.00nan;0;0
25997;197038;33;88;36;2;34;.944;3600000;0
25999;162029;4182;52;26;3;23;.885;3600000;0
25999;172340;4182;0;0;0;0;.00nan;0;0
25999;167642;18;0;0;0;0;.00nan;0;0
25999;173727;18;92;40;2;38;.950;3600000;0
26001;320;21;0;0;0;0;.00nan;0;0
26001;3284;21;68;50;6;44;.880;3600000;0
26001;183904;34;0;0;0;0;.00nan;0;0
26001;78806;34;43;24;4;20;.833;3600000;0
26003;556;33;97;34;1;33;.971;3600000;0
26003;197038;33;0;0;0;0;.00nan;0;0
26003;139409;3;94;23;0;23;1.000;3600000;0
26003;148958;3;0;0;0;0;.00nan;0;0
26005;187537;19;77;33;2;31;.939;4008000;0
26005;163565;19;0;0;0;0;.00nan;0;0
26005;184229;35;80;35;3;32;.914;4008000;0
26005;57338;35;0;0;0;0;.00nan;0;0
26007;13714;8;66;41;5;36;.878;3775000;0
26007;58830;8;0;0;0;0;.00nan;0;0
26007;77955;28;0;0;0;0;.00nan;0;0
26007;85437;28;78;46;4;42;.913;3775000;0
26009;170314;25;47;26;4;22;.846;3557000;0
26009;201673;25;0;0;0;0;.00nan;0;0
26009;-1;5;0;0;0;0;.00nan;0;0
26009;61425;5;78;40;3;37;.925;3600000;0
26011;194416;17;0;0;0;0;.00nan;0;0
26011;178413;17;94;41;2;39;.951;4200000;0
26011;179452;27;0;0;0;0;.00nan;0;0
26011;175660;27;82;35;2;33;.943;4200000;0
26013;183844;29;0;0;0;0;.00nan;0;0
26013;173699;29;73;45;5;40;.889;3600000;0
26013;179950;4838;0;0;0;0;.00nan;0;0
26013;185743;4838;71;16;1;15;.938;3600000;0
26015;179154;26;0;0;0;0;.00nan;0;0
26015;175092;9;0;0;0;0;.00nan;0;0
26015;190106;9;90;39;2;37;.949;3600000;0
26015;152835;26;60;23;3;20;.870;3560000;0
26017;170977;30;0;0;0;0;.00nan;0;0
26017;66491;12;0;0;0;0;.00nan;0;0
26017;85798;12;84;36;2;34;.944;3600000;0
26017;86697;30;63;24;3;21;.875;3573000;0
26019;167642;18;0;0;0;0;.00nan;0;0
26019;173727;18;48;19;3;16;.842;3578000;0
26019;149452;31;0;0;0;0;.00nan;0;0
26019;152717;31;100;56;2;54;.964;3600000;0
26021;197940;11;59;39;5;34;.872;3600000;0
26021;168872;24;0;0;0;0;.00nan;0;0
26021;45323;11;0;0;0;0;.00nan;0;0
26021;85727;24;82;20;1;19;.950;3600000;0
26023;183859;23;0;0;0;0;.00nan;0;0
26023;175912;14;0;0;0;0;.00nan;0;0
26023;185034;14;80;30;2;28;.933;3527000;0
26023;78573;23;100;27;0;27;1.000;3600000;0
26025;166591;20;0;0;0;0;.00nan;0;0
26025;183783;20;74;35;3;32;.914;3513000;0
26025;175084;22;0;0;0;0;.00nan;0;0
26025;184770;22;81;25;1;24;.960;3600000;0
26027;187578;10;94;38;1;37;.974;4182000;0
26027;186573;0;0;0;0;0;.00nan;0;0
26027;59540;0;94;44;2;42;.955;4182000;0
26027;90164;10;0;0;0;0;.00nan;0;0
26029;166646;16;92;42;2;40;.952;3600000;0
26029;3928;15;0;0;0;0;.00nan;0;0
26029;163195;15;52;21;3;18;.857;3549000;0
26029;50065;16;0;0;0;0;.00nan;0;0
26031;162029;4182;0;0;0;0;.00nan;0;0
26031;172340;4182;82;23;2;21;.913;3600000;0
26031;165723;32;61;39;5;34;.872;3600000;0
26031;20432;32;0;0;0;0;.00nan;0;0
26033;167642;18;51;20;3;17;.850;3575000;0
26033;173727;18;0;0;0;0;.00nan;0;0
26033;175092;9;78;32;2;30;.938;3600000;0
26033;190106;9;0;0;0;0;.00nan;0;0
26035;556;33;0;0;0;0;.00nan;0;0
26035;197038;33;61;31;4;27;.871;3935000;0
26035;66491;12;58;29;3;26;.897;3935000;0
26035;85798;12;0;0;0;0;.00nan;0;0
26037;166591;20;70;34;3;31;.912;3600000;0
26037;183783;20;0;0;0;0;.00nan;0;0
26037;170314;25;0;0;0;0;.00nan;0;0
26037;201673;25;75;27;2;25;.926;3600000;0
26039;194416;17;35;23;4;19;.826;3529000;0
26039;178413;17;0;0;0;0;.00nan;0;0
26039;186573;0;68;30;2;28;.933;3600000;0
26039;59540;0;0;0;0;0;.00nan;0;0
26041;183859;23;0;0;0;0;.00nan;0;0
26041;179154;26;51;30;5;25;.833;3600000;0
26041;78573;23;69;24;2;22;.917;3600000;0
26041;152835;26;0;0;0;0;.00nan;0;0
26043;13714;8;61;15;1;14;.933;1564000;0
26043;58830;8;18;24;7;17;.708;2006000;0
26043;139409;3;32;33;6;27;.818;3600000;0
26043;148958;3;0;0;0;0;.00nan;0;0
26045;175084;22;79;38;3;35;.921;3560000;0
26045;184770;22;0;0;0;0;.00nan;0;0
26045;179950;4838;73;22;2;20;.909;3600000;0
26045;185743;4838;0;0;0;0;.00nan;0;0
26047;320;21;60;41;6;35;.854;3268000;0
26047;3284;21;37;8;2;6;.750;332000;0
26047;170977;30;69;14;1;13;.929;3600000;0
26047;86697;30;0;0;0;0;.00nan;0;0
26049;184229;35;0;0;0;0;.00nan;0;0
26049;175912;14;35;39;6;33;.846;3339000;0
26049;185034;14;44;4;1;3;.750;261000;0
26049;57338;35;74;26;1;25;.962;3600000;0
26051;165723;32;0;0;0;0;.00nan;0;0
26051;183904;34;78;22;1;21;.955;3600000;0
26051;20432;32;82;41;3;38;.927;3591000;0
26051;78806;34;0;0;0;0;.00nan;0;0
26053;187578;10;0;0;0;0;.00nan;0;0
26053;-1;5;65;39;3;36;.923;4200000;0
26053;61425;5;0;0;0;0;.00nan;0;0
26053;90164;10;45;19;3;16;.842;4200000;0
26055;166646;16;0;0;0;0;.00nan;0;0
26055;3928;15;56;27;3;24;.889;3547000;0
26055;163195;15;0;0;0;0;.00nan;0;0
26055;50065;16;86;42;2;40;.952;3600000;0
26057;179452;27;62;15;2;13;.867;3600000;0
26057;175660;27;0;0;0;0;.00nan;0;0
26057;77955;28;68;39;4;35;.897;3569000;0
26057;85437;28;0;0;0;0;.00nan;0;0
26059;197940;11;0;0;0;0;.00nan;0;0
26059;183844;29;69;25;2;23;.920;3600000;0
26059;173699;29;0;0;0;0;.00nan;0;0
26059;45323;11;74;40;4;36;.900;3546000;0
26061;162029;4182;28;26;5;21;.808;4200000;0
26061;172340;4182;0;0;0;0;.00nan;0;0
26061;149452;31;82;52;5;47;.904;4200000;0
26061;152717;31;0;0;0;0;.00nan;0;0
26063;187537;19;0;0;0;0;.00nan;0;0
26063;163565;19;80;47;4;43;.915;3600000;0
26063;168872;24;64;22;2;20;.909;3600000;0
26063;85727;24;0;0;0;0;.00nan;0;0
2333;187578;10;80;57;6;51;.895;3600000;0
2333;183904;34;82;18;1;17;.944;3600000;0
2333;78806;34;0;0;0;0;.00nan;0;0
2333;90164;10;0;0;0;0;.00nan;0;0
2334;320;21;0;0;0;0;.00nan;0;0
2334;3284;21;64;22;2;20;.909;3600000;0
2334;139409;3;48;39;5;34;.872;3600000;0
2334;148958;3;0;0;0;0;.00nan;0;0
2335;194416;17;0;0;0;0;.00nan;0;0
2335;178413;17;87;36;2;34;.944;3571000;0
2335;175084;22;0;0;0;0;.00nan;0;0
2335;152717;22;73;20;1;19;.950;3600000;0
2336;3928;15;61;27;3;24;.889;3600000;0
2336;168872;24;0;0;0;0;.00nan;0;0
2336;75268;15;0;0;0;0;.00nan;0;0
2336;85727;24;62;43;5;38;.884;3543000;0
2337;173727;18;77;25;2;23;.920;4146000;0
2337;196090;4838;92;27;1;26;.963;4146000;0
2337;179950;4838;0;0;0;0;.00nan;0;0
2337;61425;18;0;0;0;0;.00nan;0;0
2338;13714;8;0;0;0;0;.00nan;0;0
2338;184229;35;0;0;0;0;.00nan;0;0
2338;57338;35;75;41;4;37;.902;3576000;0
2338;58830;8;65;20;2;18;.900;3600000;0
2339;201673;25;0;0;0;0;.00nan;0;0
2339;186573;16;0;0;0;0;.00nan;0;0
2339;191813;25;83;33;2;31;.939;3600000;0
2339;50065;16;70;36;3;33;.917;3572000;0
2340;179154;26;0;0;0;0;.00nan;0;0
2340;179452;27;0;0;0;0;.00nan;0;0
2340;175660;27;58;31;4;27;.871;3600000;0
2340;152835;26;83;37;3;34;.919;3600000;0
2341;187578;10;84;36;2;34;.944;3599000;0
2341;183904;34;68;17;1;16;.941;3600000;0
2341;78806;34;0;0;0;0;.00nan;0;0
2341;90164;10;0;0;0;0;.00nan;0;0
2342;320;21;0;0;0;0;.00nan;0;0
2342;3284;21;94;32;1;31;.969;3600000;0
2342;139409;3;42;26;5;21;.808;3600000;0
2342;148958;3;0;0;0;0;.00nan;0;0
2343;194416;17;0;0;0;0;.00nan;0;0
2343;178413;17;79;45;4;41;.911;3600000;0
2343;175084;22;0;0;0;0;.00nan;0;0
2343;152717;22;67;5;0;5;1.000;3600000;0
2344;3928;15;55;25;4;21;.840;3554000;0
2344;168872;24;0;0;0;0;.00nan;0;0
2344;75268;15;0;0;0;0;.00nan;0;0
2344;85727;24;91;45;3;42;.933;3600000;0
2345;173727;18;71;25;2;23;.920;3600000;0
2345;196090;4838;34;32;6;26;.813;2891000;0
2345;179950;4838;49;2;0;2;1.000;709000;0
2345;61425;18;0;0;0;0;.00nan;0;0
2346;13714;8;45;28;5;23;.821;3600000;0
2346;184229;35;0;0;0;0;.00nan;0;0
2346;57338;35;73;22;1;21;.955;3600000;0
2346;58830;8;0;0;0;0;.00nan;0;0
2347;201673;25;0;0;0;0;.00nan;0;0
2347;186573;16;0;0;0;0;.00nan;0;0
2347;191813;25;98;39;1;38;.974;4690000;0
2347;50065;16;87;40;2;38;.950;4690000;0
2348;179154;26;0;0;0;0;.00nan;0;0
2348;179452;27;0;0;0;0;.00nan;0;0
2348;175660;27;93;15;0;15;1.000;3600000;0
2348;152835;26;98;49;2;47;.959;3591000;0
2349;187578;10;82;42;3;39;.929;3868000;0
2349;183904;34;61;21;2;19;.905;3868000;0
2349;78806;34;0;0;0;0;.00nan;0;0
2349;90164;10;0;0;0;0;.00nan;0;0
2350;320;21;0;0;0;0;.00nan;0;0
2350;3284;21;67;16;1;15;.938;3600000;0
2350;139409;3;68;29;2;27;.931;3550000;0
2350;148958;3;0;0;0;0;.00nan;0;0
2351;194416;17;0;0;0;0;.00nan;0;0
2351;178413;17;50;38;5;33;.868;3600000;0
2351;175084;22;0;0;0;0;.00nan;0;0
2351;152717;22;100;38;2;36;.947;3600000;0
2352;3928;15;96;19;0;19;1.000;3600000;0
2352;168872;24;0;0;0;0;.00nan;0;0
2352;75268;15;0;0;0;0;.00nan;0;0
2352;85727;24;75;43;3;40;.930;3600000;0
2353;173727;18;47;36;5;31;.861;3568000;0
2353;196090;4838;75;38;3;35;.921;3600000;0
2353;179950;4838;0;0;0;0;.00nan;0;0
2353;61425;18;0;0;0;0;.00nan;0;0
2354;13714;8;80;34;4;30;.882;3747000;0
2354;184229;35;0;0;0;0;.00nan;0;0
2354;57338;35;76;31;3;28;.903;3747000;0
2354;58830;8;0;0;0;0;.00nan;0;0
2355;201673;25;0;0;0;0;.00nan;0;0
2355;186573;16;0;0;0;0;.00nan;0;0
2355;191813;25;51;34;5;29;.853;3929000;0
2355;50065;16;83;42;4;38;.905;3929000;0
2356;179154;26;0;0;0;0;.00nan;0;0
2356;179452;27;0;0;0;0;.00nan;0;0
2356;175660;27;63;20;2;18;.900;3600000;0
2356;152835;26;80;43;5;38;.884;3600000;0
2357;187578;10;74;20;1;19;.950;3600000;0
2357;183904;34;55;37;6;31;.838;3600000;0
2357;78806;34;0;0;0;0;.00nan;0;0
2357;90164;10;0;0;0;0;.00nan;0;0
2358;320;21;0;0;0;0;.00nan;0;0
2358;3284;21;95;39;2;37;.949;3600000;0
2358;139409;3;54;24;4;20;.833;3593000;0
2358;148958;3;0;0;0;0;.00nan;0;0
2359;194416;17;0;0;0;0;.00nan;0;0
2359;178413;17;81;39;3;36;.923;3676000;0
2359;175084;22;0;0;0;0;.00nan;0;0
2359;152717;22;45;22;4;18;.818;3676000;0
2360;3928;15;93;20;0;20;1.000;3600000;0
2360;168872;24;0;0;0;0;.00nan;0;0
2360;75268;15;0;0;0;0;.00nan;0;0
2360;85727;24;74;40;4;36;.900;3600000;0
2361;173727;18;62;18;2;16;.889;3600000;0
2361;196090;4838;62;36;4;32;.889;3531000;0
2361;179950;4838;0;0;0;0;.00nan;0;0
2361;61425;18;0;0;0;0;.00nan;0;0
2362;13714;8;73;21;1;20;.952;3600000;0
2362;184229;35;0;0;0;0;.00nan;0;0
2362;57338;35;60;31;3;28;.903;3600000;0
2362;58830;8;0;0;0;0;.00nan;0;0
2363;201673;25;0;0;0;0;.00nan;0;0
2363;186573;16;0;0;0;0;.00nan;0;0
2363;191813;25;60;37;4;33;.892;3586000;0
2363;50065;16;60;23;2;21;.913;3600000;0
2364;179154;26;0;0;0;0;.00nan;0;0
2364;179452;27;0;0;0;0;.00nan;0;0
2364;175660;27;68;22;2;20;.909;3546000;0
2364;152835;26;100;41;1;40;.976;3600000;0
2505;187578;10;49;41;6;35;.854;3600000;0
2505;183904;34;100;23;0;23;1.000;3600000;0
2505;78806;34;0;0;0;0;.00nan;0;0
2505;90164;10;0;0;0;0;.00nan;0;0
2506;194416;17;0;0;0;0;.00nan;0;0
2506;178413;17;58;40;4;36;.900;3600000;0
2506;175084;22;0;0;0;0;.00nan;0;0
2506;152717;22;71;15;1;14;.933;3600000;0
2507;3928;15;55;23;3;20;.870;3600000;0
2507;168872;24;0;0;0;0;.00nan;0;0
2507;75268;15;0;0;0;0;.00nan;0;0
2507;85727;24;100;36;0;36;1.000;3600000;0
2508;173727;18;68;34;3;31;.912;3600000;0
2508;196090;4838;35;18;4;14;.778;1825000;0
2508;179950;4838;52;18;2;16;.889;1775000;0
2508;61425;18;0;0;0;0;.00nan;0;0
2509;13714;8;84;26;1;25;.962;3600000;0
2509;184229;35;0;0;0;0;.00nan;0;0
2509;57338;35;69;29;3;26;.897;3553000;0
2509;58830;8;0;0;0;0;.00nan;0;0
2510;201673;25;0;0;0;0;.00nan;0;0
2510;186573;16;0;0;0;0;.00nan;0;0
2510;191813;25;52;29;4;25;.862;3575000;0
2510;50065;16;81;39;3;36;.923;3600000;0
2511;179154;26;0;0;0;0;.00nan;0;0
2511;179452;27;0;0;0;0;.00nan;0;0
2511;175660;27;82;23;1;22;.957;3600000;0
2511;152835;26;82;31;2;29;.935;3543000;0
2529;3928;15;37;33;6;27;.818;3600000;0
2529;168872;24;0;0;0;0;.00nan;0;0
2529;75268;15;0;0;0;0;.00nan;0;0
2529;85727;24;90;43;3;40;.930;3600000;0
2530;173727;18;94;28;1;27;.964;3600000;0
2530;196090;4838;58;41;5;36;.878;3600000;0
2530;179950;4838;0;0;0;0;.00nan;0;0
2530;61425;18;0;0;0;0;.00nan;0;0
2531;13714;8;72;24;2;22;.917;3552000;0
2531;184229;35;0;0;0;0;.00nan;0;0
2531;57338;35;94;27;1;26;.963;3600000;0
2531;58830;8;0;0;0;0;.00nan;0;0
2532;201673;25;0;0;0;0;.00nan;0;0
2532;186573;16;0;0;0;0;.00nan;0;0
2532;191813;25;94;52;2;50;.962;4470000;0
2532;50065;16;80;22;1;21;.955;4470000;0
2533;179154;26;0;0;0;0;.00nan;0;0
2533;179452;27;0;0;0;0;.00nan;0;0
2533;175660;27;87;21;0;21;1.000;3600000;0
2533;152835;26;76;28;2;26;.929;3560000;0
2548;3928;15;71;26;2;24;.923;3600000;0
2548;168872;24;0;0;0;0;.00nan;0;0
2548;75268;15;0;0;0;0;.00nan;0;0
2548;85727;24;45;34;5;29;.853;3600000;0
2549;13714;8;51;30;5;25;.833;3600000;0
2549;184229;35;0;0;0;0;.00nan;0;0
2549;57338;35;100;25;0;25;1.000;3600000;0
2549;58830;8;0;0;0;0;.00nan;0;0
2613;320;21;0;0;0;0;.00nan;0;0
2613;3284;21;81;45;4;41;.911;3600000;0
2613;183904;34;69;15;1;14;.933;3600000;0
2613;78806;34;0;0;0;0;.00nan;0;0
2614;3928;15;88;35;2;33;.943;3600000;0
2614;175084;22;0;0;0;0;.00nan;0;0
2614;75268;15;0;0;0;0;.00nan;0;0
2614;152717;22;95;19;0;19;1.000;3600000;0
2615;173727;18;63;23;2;21;.913;3569000;0
2615;186573;16;0;0;0;0;.00nan;0;0
2615;50065;16;100;26;0;26;1.000;3600000;0
2615;61425;18;0;0;0;0;.00nan;0;0
2616;184229;35;0;0;0;0;.00nan;0;0
2616;179452;27;0;0;0;0;.00nan;0;0
2616;175660;27;60;25;3;22;.880;3634000;0
2616;57338;35;82;30;2;28;.933;3634000;0
2617;320;21;0;0;0;0;.00nan;0;0
2617;3284;21;83;26;1;25;.962;3600000;0
2617;183904;34;48;14;2;12;.857;3565000;0
2617;78806;34;0;0;0;0;.00nan;0;0
2618;3928;15;92;45;2;43;.956;6314000;0
2618;175084;22;0;0;0;0;.00nan;0;0
2618;75268;15;0;0;0;0;.00nan;0;0
2618;152717;22;74;44;3;41;.932;6314000;0
2619;173727;18;93;43;2;41;.953;4259000;0
2619;186573;16;0;0;0;0;.00nan;0;0
2619;50065;16;91;50;3;47;.940;4259000;0
2619;61425;18;0;0;0;0;.00nan;0;0
2620;184229;35;0;0;0;0;.00nan;0;0
2620;179452;27;0;0;0;0;.00nan;0;0
2620;175660;27;54;30;4;26;.867;3537000;0
2620;57338;35;92;39;2;37;.949;3600000;0
2621;320;21;74;16;0;16;1.000;1391000;0
2621;3284;21;38;29;5;24;.828;2152000;0
2621;183904;34;59;34;4;30;.882;3600000;0
2621;78806;34;0;0;0;0;.00nan;0;0
2622;3928;15;81;37;2;35;.946;3600000;0
2622;175084;22;0;0;0;0;.00nan;0;0
2622;75268;15;0;0;0;0;.00nan;0;0
2622;152717;22;70;21;1;20;.952;3600000;0
2623;173727;18;57;32;4;28;.875;3600000;0
2623;186573;16;0;0;0;0;.00nan;0;0
2623;50065;16;100;40;1;39;.975;3600000;0
2623;61425;18;0;0;0;0;.00nan;0;0
2624;184229;35;0;0;0;0;.00nan;0;0
2624;179452;27;0;0;0;0;.00nan;0;0
2624;175660;27;58;37;5;32;.865;4094000;0
2624;57338;35;58;28;4;24;.857;4094000;0
2625;320;21;94;36;2;34;.944;3600000;0
2625;3284;21;0;0;0;0;.00nan;0;0
2625;183904;34;40;26;5;21;.808;3593000;0
2625;78806;34;0;0;0;0;.00nan;0;0
2626;3928;15;49;51;7;44;.863;2903000;0
2626;175084;22;0;0;0;0;.00nan;0;0
2626;75268;15;48;8;1;7;.875;697000;0
2626;152717;22;80;28;2;26;.929;3600000;0
2627;173727;18;92;35;1;34;.971;3918000;0
2627;186573;16;0;0;0;0;.00nan;0;0
2627;50065;16;100;24;0;24;1.000;3918000;0
2627;61425;18;0;0;0;0;.00nan;0;0
2628;184229;35;0;0;0;0;.00nan;0;0
2628;179452;27;0;0;0;0;.00nan;0;0
2628;175660;27;65;30;3;27;.900;3600000;0
2628;57338;35;40;30;5;25;.833;3600000;0
2715;320;21;100;37;0;37;1.000;3675000;0
2715;3284;21;0;0;0;0;.00nan;0;0
2715;183904;34;70;15;1;14;.933;3675000;0
2715;78806;34;0;0;0;0;.00nan;0;0
2716;3928;15;90;42;3;39;.929;3600000;0
2716;175084;22;0;0;0;0;.00nan;0;0
2716;75268;15;0;0;0;0;.00nan;0;0
2716;152717;22;45;24;4;20;.833;3598000;0
2717;173727;18;59;26;3;23;.885;3600000;0
2717;186573;16;44;5;1;4;.800;907000;0
2717;50065;16;23;28;7;21;.750;2693000;0
2717;61425;18;0;0;0;0;.00nan;0;0
2718;184229;35;0;0;0;0;.00nan;0;0
2718;179452;27;0;0;0;0;.00nan;0;0
2718;175660;27;62;26;3;23;.885;3563000;0
2718;57338;35;97;38;2;36;.947;3600000;0
2734;320;21;64;27;3;24;.889;3663000;0
2734;3284;21;0;0;0;0;.00nan;0;0
2734;183904;34;79;30;2;28;.933;3663000;0
2734;78806;34;0;0;0;0;.00nan;0;0
2735;3928;15;90;34;2;32;.941;3600000;0
2735;175084;22;0;0;0;0;.00nan;0;0
2735;75268;15;0;0;0;0;.00nan;0;0
2735;152717;22;65;24;3;21;.875;3543000;0
2736;173727;18;82;38;3;35;.921;3600000;0
2736;186573;16;40;25;5;20;.800;3515000;0
2736;50065;16;0;0;0;0;.00nan;0;0
2736;61425;18;0;0;0;0;.00nan;0;0
2748;320;21;54;39;5;34;.872;3600000;0
2748;3284;21;0;0;0;0;.00nan;0;0
2748;183904;34;77;20;1;19;.950;3600000;0
2748;78806;34;0;0;0;0;.00nan;0;0
2749;3928;15;78;20;1;19;.950;3600000;0
2749;175084;22;0;0;0;0;.00nan;0;0
2749;75268;15;0;0;0;0;.00nan;0;0
2749;152717;22;63;22;2;20;.909;3571000;0
2750;173727;18;73;29;3;26;.897;3600000;0
2750;186573;16;53;33;5;28;.848;3521000;0
2750;50065;16;0;0;0;0;.00nan;0;0
2750;61425;18;0;0;0;0;.00nan;0;0
2753;3928;15;22;33;7;26;.788;3102000;0
2753;183904;34;71;31;3;28;.903;3600000;0
2753;75268;15;13;5;4;1;.200;498000;0
2753;78806;34;0;0;0;0;.00nan;0;0
2754;173727;18;59;38;4;34;.895;3527000;0
2754;184229;35;0;0;0;0;.00nan;0;0
2754;57338;35;72;28;2;26;.929;3600000;0
2754;61425;18;0;0;0;0;.00nan;0;0
2755;3928;15;80;36;2;34;.944;3578000;0
2755;183904;34;86;24;1;23;.958;3600000;0
2755;75268;15;0;0;0;0;.00nan;0;0
2755;78806;34;0;0;0;0;.00nan;0;0
2756;173727;18;89;23;0;23;1.000;3600000;0
2756;184229;35;0;0;0;0;.00nan;0;0
2756;57338;35;68;37;4;33;.892;3600000;0
2756;61425;18;0;0;0;0;.00nan;0;0
2757;3928;15;46;25;4;21;.840;3537000;0
2757;183904;34;97;39;2;37;.949;3600000;0
2757;75268;15;0;0;0;0;.00nan;0;0
2757;78806;34;0;0;0;0;.00nan;0;0
2758;173727;18;83;34;2;32;.941;3600000;0
2758;184229;35;0;0;0;0;.00nan;0;0
2758;57338;35;77;36;3;33;.917;3600000;0
2758;61425;18;0;0;0;0;.00nan;0;0
2759;3928;15;99;41;1;40;.976;3600000;0
2759;183904;34;59;27;3;24;.889;3521000;0
2759;75268;15;0;0;0;0;.00nan;0;0
2759;78806;34;0;0;0;0;.00nan;0;0
2760;173727;18;55;18;2;16;.889;3600000;0
2760;184229;35;0;0;0;0;.00nan;0;0
2760;57338;35;68;45;5;40;.889;3600000;0
2760;61425;18;0;0;0;0;.00nan;0;0
2775;3928;15;77;30;2;28;.933;3600000;0
2775;183904;34;69;28;3;25;.893;3568000;0
2775;75268;15;0;0;0;0;.00nan;0;0
2775;78806;34;0;0;0;0;.00nan;0;0
2776;173727;18;67;36;3;33;.917;3557000;0
2776;184229;35;0;0;0;0;.00nan;0;0
2776;57338;35;72;27;2;25;.926;3600000;0
2776;61425;18;0;0;0;0;.00nan;0;0
2783;3928;15;92;49;3;46;.939;4171000;0
2783;183904;34;65;23;2;21;.913;4171000;0
2783;75268;15;0;0;0;0;.00nan;0;0
2783;78806;34;0;0;0;0;.00nan;0;0
2784;173727;18;67;40;3;37;.925;5396000;0
2784;184229;35;0;0;0;0;.00nan;0;0
2784;57338;35;79;48;4;44;.917;5396000;0
2784;61425;18;0;0;0;0;.00nan;0;0
2785;183904;34;90;30;1;29;.967;3600000;0
2785;173727;18;64;33;3;30;.909;3515000;0
2785;61425;18;0;0;0;0;.00nan;0;0
2785;78806;34;0;0;0;0;.00nan;0;0
2786;183904;34;0;0;0;0;.00nan;0;0
2786;173727;18;76;27;3;24;.889;4434000;0
2786;61425;18;0;0;0;0;.00nan;0;0
2786;78806;34;100;41;2;39;.951;4434000;0
2787;183904;34;0;0;0;0;.00nan;0;0
2787;173727;18;46;28;4;24;.857;3600000;0
2787;61425;18;0;0;0;0;.00nan;0;0
2787;78806;34;91;24;0;24;1.000;3600000;0
2788;183904;34;0;0;0;0;.00nan;0;0
2788;173727;18;80;25;1;24;.960;3724000;0
2788;61425;18;0;0;0;0;.00nan;0;0
2788;78806;34;90;33;2;31;.939;3724000;0
2794;183904;34;0;0;0;0;.00nan;0;0
2794;173727;18;70;38;3;35;.921;4114000;0
2794;61425;18;0;0;0;0;.00nan;0;0
2794;78806;34;72;40;4;36;.900;4114000;0
2795;183904;34;0;0;0;0;.00nan;0;0
2795;173727;18;75;22;1;21;.955;3600000;0
2795;61425;18;0;0;0;0;.00nan;0;0
2795;78806;34;97;51;3;48;.941;3544000;0
2796;183904;34;0;0;0;0;.00nan;0;0
2796;173727;18;77;32;2;30;.938;3600000;0
2796;61425;18;0;0;0;0;.00nan;0;0
2796;78806;34;39;18;4;14;.778;3538000;0
26064;161535;52;0;0;0;0;.00nan;0;0
26064;184081;52;79;46;4;42;.913;3520000;0
26064;169323;53;57;18;2;16;.889;3600000;0
26064;91403;53;0;0;0;0;.00nan;0;0
26065;176200;44;0;0;0;0;.00nan;0;0
26065;201673;4619;0;0;0;0;.00nan;0;0
26065;64911;44;100;52;2;50;.962;3600000;0
26065;78820;4619;47;25;4;21;.840;3522000;0
26066;179950;4837;0;0;0;0;.00nan;0;0
26066;186549;45;42;39;6;33;.846;3600000;0
26066;187295;4837;50;11;2;9;.818;3600000;0
26066;66491;45;0;0;0;0;.00nan;0;0
26067;192733;61;98;44;2;42;.955;3600000;0
26067;189639;54;82;29;1;28;.966;3600000;0
26067;-1;61;0;0;0;0;.00nan;0;0
26067;201876;54;0;0;0;0;.00nan;0;0
26068;165744;43;56;22;3;19;.864;3600000;0
26068;191026;48;80;33;2;31;.939;2887000;0
26068;64811;43;0;0;0;0;.00nan;0;0
26068;142492;48;15;13;5;8;.615;713000;0
26069;189644;42;42;32;6;26;.813;3132000;0
26069;176915;62;84;36;3;33;.917;3600000;0
26069;196372;62;0;0;0;0;.00nan;0;0
26069;149450;42;49;1;0;1;1.000;468000;0
26070;163565;40;76;34;4;30;.882;3530000;0
26070;185812;40;0;0;0;0;.00nan;0;0
26070;86862;60;86;37;2;35;.946;3600000;0
26070;91398;60;0;0;0;0;.00nan;0;0
26071;171838;41;66;18;1;17;.944;3544000;0
26071;199481;57;0;0;0;0;.00nan;0;0
26071;194264;41;0;0;0;0;.00nan;0;0
26071;152418;57;96;28;0;28;1.000;3600000;0
26072;181123;63;84;51;4;47;.922;3584000;0
26072;186527;59;0;0;0;0;.00nan;0;0
26072;192457;63;0;0;0;0;.00nan;0;0
26072;75268;59;52;13;2;11;.846;3600000;0
26073;184610;49;0;0;0;0;.00nan;0;0
26073;190465;37;0;0;0;0;.00nan;0;0
26073;202161;37;48;21;3;18;.857;3600000;0
26073;79132;49;97;33;1;32;.970;3600000;0
26074;184069;46;53;34;5;29;.853;3600000;0
26074;182049;46;0;0;0;0;.00nan;0;0
26074;186495;47;72;30;2;28;.933;3600000;0
26074;78479;47;0;0;0;0;.00nan;0;0
26075;171970;55;0;0;0;0;.00nan;0;0
26075;194502;55;47;39;5;34;.872;3600000;0
26075;195089;36;0;0;0;0;.00nan;0;0
26075;187362;36;96;33;1;32;.970;3600000;0
26076;161535;52;0;0;0;0;.00nan;0;0
26076;184081;52;85;48;4;44;.917;3680000;0
26076;169323;53;0;0;0;0;.00nan;0;0
26076;91403;53;67;36;3;33;.917;3680000;0
26077;4622;64;82;28;2;26;.929;3600000;0
26077;57215;50;0;0;0;0;.00nan;0;0
26077;58037;64;0;0;0;0;.00nan;0;0
26077;141998;50;53;30;4;26;.867;3600000;0
26078;179950;4837;0;0;0;0;.00nan;0;0
26078;186549;45;98;40;2;38;.950;3576000;0
26078;187295;4837;89;26;1;25;.962;3600000;0
26078;66491;45;0;0;0;0;.00nan;0;0
26079;189081;56;0;0;0;0;.00nan;0;0
26079;176921;58;62;39;4;35;.897;3600000;0
26079;38124;58;0;0;0;0;.00nan;0;0
26079;57207;56;100;35;0;35;1.000;3600000;0
26080;192733;61;51;26;4;22;.846;3600000;0
26080;189639;54;40;2;1;1;.500;342000;0
26080;-1;61;0;0;0;0;.00nan;0;0
26080;201876;54;56;54;7;47;.870;3258000;0
26081;165744;43;58;18;2;16;.889;3600000;0
26081;191026;48;48;23;4;19;.826;1973000;0
26081;64811;43;0;0;0;0;.00nan;0;0
26081;142492;48;33;30;6;24;.800;1627000;0
26082;188888;51;0;0;0;0;.00nan;0;0
26082;173856;38;0;0;0;0;.00nan;0;0
26082;181102;38;76;34;3;31;.912;3900000;0
26082;86360;51;95;43;3;40;.930;3900000;0
26083;184610;49;0;0;0;0;.00nan;0;0
26083;190465;37;41;32;6;26;.813;3594000;0
26083;202161;37;0;0;0;0;.00nan;0;0
26083;79132;49;50;39;5;34;.872;3600000;0
26084;171838;41;71;27;2;25;.926;3600000;0
26084;194264;41;0;0;0;0;.00nan;0;0
26084;169226;65;48;40;6;34;.850;3600000;0
26084;176938;65;0;0;0;0;.00nan;0;0
26085;171970;55;95;65;5;60;.923;3600000;0
26085;194502;55;0;0;0;0;.00nan;0;0
26085;186527;59;0;0;0;0;.00nan;0;0
26085;75268;59;60;12;1;11;.917;3600000;0
26086;184069;46;0;0;0;0;.00nan;0;0
26086;182049;46;72;25;2;23;.920;3900000;0
26086;186495;47;86;37;2;35;.946;3900000;0
26086;78479;47;0;0;0;0;.00nan;0;0
26087;187699;39;46;25;4;21;.840;3589000;0
26087;181123;63;57;24;3;21;.875;3600000;0
26087;192457;63;0;0;0;0;.00nan;0;0
26087;197704;39;0;0;0;0;.00nan;0;0
26088;188888;51;0;0;0;0;.00nan;0;0
26088;176921;58;69;30;2;28;.933;3900000;0
26088;38124;58;0;0;0;0;.00nan;0;0
26088;86360;51;84;32;2;30;.938;3900000;0
26089;189081;56;0;0;0;0;.00nan;0;0
26089;173856;38;80;39;2;37;.949;3900000;0
26089;181102;38;0;0;0;0;.00nan;0;0
26089;57207;56;79;25;2;23;.920;3900000;0
26090;189644;42;37;23;5;18;.783;3600000;0
26090;176915;62;61;9;0;9;1.000;745000;0
26090;196372;62;43;36;6;30;.833;2810000;0
26090;149450;42;0;0;0;0;.00nan;0;0
26091;163565;40;91;32;1;31;.969;3600000;0
26091;185812;40;0;0;0;0;.00nan;0;0
26091;86862;60;65;27;2;25;.926;3600000;0
26091;91398;60;0;0;0;0;.00nan;0;0
26092;199481;57;0;0;0;0;.00nan;0;0
26092;169226;65;0;0;0;0;.00nan;0;0
26092;176938;65;57;37;5;32;.865;3600000;0
26092;152418;57;70;28;3;25;.893;3600000;0
26093;187699;39;91;51;4;47;.922;3567000;0
26093;195089;36;0;0;0;0;.00nan;0;0
26093;187362;36;63;22;2;20;.909;3600000;0
26093;197704;39;0;0;0;0;.00nan;0;0
26094;4622;64;0;0;0;0;.00nan;0;0
26094;184069;46;45;36;6;30;.833;3600000;0
26094;182049;46;0;0;0;0;.00nan;0;0
26094;58037;64;60;22;2;20;.909;3600000;0
26095;165744;43;0;0;0;0;.00nan;0;0
26095;181123;63;85;51;4;47;.922;3600000;0
26095;192457;63;0;0;0;0;.00nan;0;0
26095;64811;43;50;13;2;11;.846;3600000;0
26096;199481;57;0;0;0;0;.00nan;0;0
26096;186527;59;0;0;0;0;.00nan;0;0
26096;75268;59;48;22;3;19;.864;3600000;0
26096;152418;57;58;46;6;40;.870;3600000;0
26097;176915;62;0;0;0;0;.00nan;0;0
26097;196372;62;70;30;2;28;.933;3900000;0
26097;191026;48;90;36;2;34;.944;3900000;0
26097;142492;48;0;0;0;0;.00nan;0;0
26098;171970;55;0;0;0;0;.00nan;0;0
26098;188888;51;26;12;4;8;.667;1153000;0
26098;194502;55;60;40;4;36;.900;3600000;0
26098;86360;51;56;10;1;9;.900;2420000;0
26099;179950;4837;92;27;0;27;1.000;3600000;0
26099;186549;45;85;43;3;40;.930;3600000;0
26099;187295;4837;0;0;0;0;.00nan;0;0
26099;66491;45;0;0;0;0;.00nan;0;0
26100;161535;52;34;26;5;21;.808;3600000;0
26100;171838;41;100;27;0;27;1.000;3600000;0
26100;194264;41;0;0;0;0;.00nan;0;0
26100;184081;52;0;0;0;0;.00nan;0;0
26101;192733;61;99;41;1;40;.976;3664000;0
26101;-1;61;0;0;0;0;.00nan;0;0
26101;184610;49;0;0;0;0;.00nan;0;0
26101;79132;49;55;17;2;15;.882;3664000;0
26102;165744;43;72;17;2;15;.882;3900000;0
26102;181123;63;96;47;2;45;.957;3900000;0
26102;192457;63;0;0;0;0;.00nan;0;0
26102;64811;43;0;0;0;0;.00nan;0;0
26103;189639;54;0;0;0;0;.00nan;0;0
26103;189644;42;0;0;0;0;.00nan;0;0
26103;201876;54;67;41;5;36;.878;3600000;0
26103;149450;42;66;19;1;18;.947;3600000;0
26104;199481;57;0;0;0;0;.00nan;0;0
26104;176921;58;77;25;1;24;.960;3600000;0
26104;38124;58;0;0;0;0;.00nan;0;0
26104;152418;57;55;26;3;23;.885;3515000;0
26105;163565;40;0;0;0;0;.00nan;0;0
26105;185812;40;49;31;5;26;.839;3600000;0
26105;86862;60;98;21;0;21;1.000;3600000;0
26105;91398;60;0;0;0;0;.00nan;0;0
26106;169226;65;0;0;0;0;.00nan;0;0
26106;173856;38;54;23;3;20;.870;3544000;0
26106;176938;65;69;28;2;26;.929;3600000;0
26106;181102;38;0;0;0;0;.00nan;0;0
26107;176915;62;0;0;0;0;.00nan;0;0
26107;196372;62;58;37;4;33;.892;3900000;0
26107;191026;48;0;0;0;0;.00nan;0;0
26107;142492;48;58;28;4;24;.857;3900000;0
26108;176200;44;0;0;0;0;.00nan;0;0
26108;64911;44;100;48;3;45;.938;3900000;0
26108;86862;60;0;0;0;0;.00nan;0;0
26108;91398;60;59;23;3;20;.870;3900000;0
26109;165744;43;0;0;0;0;.00nan;0;0
26109;189081;56;94;42;3;39;.929;3600000;0
26109;57207;56;0;0;0;0;.00nan;0;0
26109;64811;43;88;17;0;17;1.000;3600000;0
26110;195089;36;0;0;0;0;.00nan;0;0
26110;186527;59;0;0;0;0;.00nan;0;0
26110;187362;36;100;46;1;45;.978;3600000;0
26110;75268;59;49;13;2;11;.846;3552000;0
26111;171970;55;76;42;3;39;.929;3600000;0
26111;188888;51;0;0;0;0;.00nan;0;0
26111;194502;55;0;0;0;0;.00nan;0;0
26111;86360;51;77;20;1;19;.950;3600000;0
26112;179950;4837;0;0;0;0;.00nan;0;0
26112;186549;45;57;6;0;6;1.000;418000;0
26112;187295;4837;72;20;1;19;.950;3600000;0
26112;66491;45;68;48;6;42;.875;3182000;0
26113;171838;41;74;30;2;28;.933;3621000;0
26113;194264;41;0;0;0;0;.00nan;0;0
26113;173856;38;70;23;1;22;.957;3621000;0
26113;181102;38;0;0;0;0;.00nan;0;0
26114;192733;61;0;0;0;0;.00nan;0;0
26114;-1;61;67;33;2;31;.939;3559000;0
26114;184610;49;100;28;0;28;1.000;3600000;0
26114;79132;49;0;0;0;0;.00nan;0;0
26115;189639;54;78;46;4;42;.913;3580000;0
26115;189644;42;59;21;2;19;.905;3600000;0
26115;201876;54;0;0;0;0;.00nan;0;0
26115;149450;42;0;0;0;0;.00nan;0;0
26116;184069;46;81;36;3;33;.917;3554000;0
26116;182049;46;0;0;0;0;.00nan;0;0
26116;57215;50;0;0;0;0;.00nan;0;0
26116;141998;50;72;24;2;22;.917;3600000;0
26117;199481;57;62;18;1;17;.944;3600000;0
26117;176921;58;0;0;0;0;.00nan;0;0
26117;38124;58;79;35;2;33;.943;3566000;0
26117;152418;57;0;0;0;0;.00nan;0;0
26118;4622;64;0;0;0;0;.00nan;0;0
26118;190465;37;0;0;0;0;.00nan;0;0
26118;202161;37;90;35;2;33;.943;3900000;0
26118;58037;64;94;30;2;28;.933;3900000;0
26119;187699;39;94;42;2;40;.952;3900000;0
26119;169323;53;0;0;0;0;.00nan;0;0
26119;197704;39;0;0;0;0;.00nan;0;0
26119;91403;53;81;32;2;30;.938;3900000;0
26120;201673;4619;72;29;2;27;.931;3600000;0
26120;186495;47;21;24;6;18;.750;3600000;0
26120;78479;47;0;0;0;0;.00nan;0;0
26120;78820;4619;0;0;0;0;.00nan;0;0
26121;161535;52;0;0;0;0;.00nan;0;0
26121;184081;52;80;34;2;32;.941;3576000;0
26121;169226;65;0;0;0;0;.00nan;0;0
26121;176938;65;91;35;1;34;.971;3600000;0
26122;176921;58;42;65;10;55;.846;3600000;0
26122;38124;58;0;0;0;0;.00nan;0;0
26122;186527;59;56;8;1;7;.875;3600000;0
26122;75268;59;0;0;0;0;.00nan;0;0
26123;4622;64;0;0;0;0;.00nan;0;0
26123;184069;46;0;0;0;0;.00nan;0;0
26123;182049;46;54;38;6;32;.842;3600000;0
26123;58037;64;67;31;3;28;.903;3600000;0
26124;169226;65;100;50;3;47;.940;3900000;0
26124;173856;38;0;0;0;0;.00nan;0;0
26124;176938;65;0;0;0;0;.00nan;0;0
26124;181102;38;57;26;3;23;.885;3900000;0
26125;187699;39;0;0;0;0;.00nan;0;0
26125;169323;53;46;29;5;24;.828;3557000;0
26125;197704;39;88;43;3;40;.930;3600000;0
26125;91403;53;0;0;0;0;.00nan;0;0
26126;179950;4837;0;0;0;0;.00nan;0;0
26126;191026;48;95;43;3;40;.930;3557000;0
26126;187295;4837;74;23;2;21;.913;3600000;0
26126;142492;48;0;0;0;0;.00nan;0;0
26127;192733;61;56;27;4;23;.852;3600000;0
26127;-1;61;0;0;0;0;.00nan;0;0
26127;176200;44;0;0;0;0;.00nan;0;0
26127;64911;44;62;46;6;40;.870;3600000;0
26128;187699;39;90;44;3;41;.932;3600000;0
26128;197704;39;0;0;0;0;.00nan;0;0
26128;57215;50;0;0;0;0;.00nan;0;0
26128;141998;50;56;31;4;27;.871;3546000;0
26129;163565;40;100;39;1;38;.974;3600000;0
26129;185812;40;0;0;0;0;.00nan;0;0
26129;186495;47;85;44;3;41;.932;3591000;0
26129;78479;47;0;0;0;0;.00nan;0;0
26130;179950;4837;55;24;3;21;.875;3600000;0
26130;191026;48;0;0;0;0;.00nan;0;0
26130;187295;4837;0;0;0;0;.00nan;0;0
26130;142492;48;70;37;4;33;.892;3600000;0
26131;189081;56;0;0;0;0;.00nan;0;0
26131;57207;56;88;33;2;31;.939;3596000;0
26131;57215;50;72;20;1;19;.950;3600000;0
26131;141998;50;0;0;0;0;.00nan;0;0
26132;201673;4619;58;21;2;19;.905;3600000;0
26132;78820;4619;0;0;0;0;.00nan;0;0
26132;86862;60;83;40;3;37;.925;3542000;0
26132;91398;60;0;0;0;0;.00nan;0;0
26133;4622;64;0;0;0;0;.00nan;0;0
26133;189639;54;98;39;1;38;.974;3600000;0
26133;201876;54;0;0;0;0;.00nan;0;0
26133;58037;64;100;23;0;23;1.000;3600000;0
26134;169323;53;0;0;0;0;.00nan;0;0
26134;181123;63;39;29;5;24;.828;2061000;0
26134;192457;63;58;6;0;6;1.000;1539000;0
26134;91403;53;84;30;1;29;.967;3600000;0
26135;192733;61;0;0;0;0;.00nan;0;0
26135;-1;61;76;38;4;34;.895;3728000;0
26135;184610;49;45;29;5;24;.828;3728000;0
26135;79132;49;0;0;0;0;.00nan;0;0
26136;161535;52;0;0;0;0;.00nan;0;0
26136;184081;52;61;26;3;23;.885;3600000;0
26136;176921;58;61;35;4;31;.886;3566000;0
26136;38124;58;0;0;0;0;.00nan;0;0
26137;187699;39;90;35;2;33;.943;3600000;0
26137;189081;56;68;40;4;36;.900;3382000;0
26137;197704;39;0;0;0;0;.00nan;0;0
26137;57207;56;27;6;3;3;.500;218000;0
26138;169323;53;0;0;0;0;.00nan;0;0
26138;186527;59;0;0;0;0;.00nan;0;0
26138;75268;59;100;30;0;30;1.000;3600000;0
26138;91403;53;84;41;3;38;.927;3600000;0
26139;188888;51;47;22;3;19;.864;3519000;0
26139;186549;45;81;25;1;24;.960;3600000;0
26139;66491;45;0;0;0;0;.00nan;0;0
26139;86360;51;0;0;0;0;.00nan;0;0
26140;171838;41;68;21;2;19;.905;3600000;0
26140;194264;41;0;0;0;0;.00nan;0;0
26140;169226;65;0;0;0;0;.00nan;0;0
26140;176938;65;77;52;5;47;.904;3600000;0
26141;192733;61;34;32;6;26;.813;2768000;0
26141;-1;61;63;18;1;17;.944;832000;0
26141;86862;60;70;16;1;15;.938;3600000;0
26141;91398;60;0;0;0;0;.00nan;0;0
26142;165744;43;45;19;3;16;.842;3600000;0
26142;181123;63;0;0;0;0;.00nan;0;0
26142;192457;63;56;35;5;30;.857;3547000;0
26142;64811;43;0;0;0;0;.00nan;0;0
26143;189639;54;0;0;0;0;.00nan;0;0
26143;201876;54;70;37;3;34;.919;3600000;0
26143;190465;37;40;25;5;20;.800;3514000;0
26143;202161;37;0;0;0;0;.00nan;0;0
26144;163565;40;48;19;3;16;.842;3600000;0
26144;185812;40;0;0;0;0;.00nan;0;0
26144;191026;48;45;38;6;32;.842;3064000;0
26144;142492;48;30;11;3;8;.727;536000;0
26145;171970;55;0;0;0;0;.00nan;0;0
26145;194502;55;100;35;0;35;1.000;3600000;0
26145;195089;36;0;0;0;0;.00nan;0;0
26145;187362;36;57;27;3;24;.889;3600000;0
26146;184069;46;0;0;0;0;.00nan;0;0
26146;189644;42;58;21;3;18;.857;3600000;0
26146;182049;46;57;34;4;30;.882;3592000;0
26146;149450;42;0;0;0;0;.00nan;0;0
26147;176200;44;0;0;0;0;.00nan;0;0
26147;186495;47;0;0;0;0;.00nan;0;0
26147;64911;44;88;39;2;37;.949;3600000;0
26147;78479;47;54;29;3;26;.897;3562000;0
26148;187699;39;0;0;0;0;.00nan;0;0
26148;189081;56;0;0;0;0;.00nan;0;0
26148;197704;39;76;28;3;25;.893;3600000;0
26148;57207;56;63;37;5;32;.865;3578000;0
26149;176915;62;33;23;5;18;.783;1152000;0
26149;179950;4837;0;0;0;0;.00nan;0;0
26149;196372;62;53;16;2;14;.875;2448000;0
26149;187295;4837;68;19;1;18;.947;3600000;0
26150;169323;53;92;48;4;44;.917;3600000;0
26150;186527;59;0;0;0;0;.00nan;0;0
26150;75268;59;78;15;0;15;1.000;3600000;0
26150;91403;53;0;0;0;0;.00nan;0;0
26151;4622;64;0;0;0;0;.00nan;0;0
26151;188888;51;0;0;0;0;.00nan;0;0
26151;58037;64;73;25;2;23;.920;3600000;0
26151;86360;51;64;38;5;33;.868;3600000;0
26152;173856;38;62;33;4;29;.879;3600000;0
26152;176921;58;0;0;0;0;.00nan;0;0
26152;181102;38;0;0;0;0;.00nan;0;0
26152;38124;58;98;32;1;31;.969;3600000;0
26153;189639;54;84;58;5;53;.914;3543000;0
26153;201876;54;0;0;0;0;.00nan;0;0
26153;57215;50;0;0;0;0;.00nan;0;0
26153;141998;50;44;19;3;16;.842;3600000;0
26154;190465;37;0;0;0;0;.00nan;0;0
26154;202161;37;93;17;0;17;1.000;3600000;0
26154;186549;45;0;0;0;0;.00nan;0;0
26154;66491;45;97;40;2;38;.950;3517000;0
26155;184610;49;0;0;0;0;.00nan;0;0
26155;201673;4619;63;26;3;23;.885;3551000;0
26155;78820;4619;0;0;0;0;.00nan;0;0
26155;79132;49;87;32;2;30;.938;3600000;0
26156;199481;57;0;0;0;0;.00nan;0;0
26156;169226;65;97;34;1;33;.971;3900000;0
26156;176938;65;0;0;0;0;.00nan;0;0
26156;152418;57;100;46;1;45;.978;3900000;0
26157;171970;55;72;41;4;37;.902;3600000;0
26157;165744;43;0;0;0;0;.00nan;0;0
26157;194502;55;0;0;0;0;.00nan;0;0
26157;64811;43;81;13;0;13;1.000;3600000;0
26158;184069;46;51;43;6;37;.860;3600000;0
26158;189644;42;0;0;0;0;.00nan;0;0
26158;182049;46;0;0;0;0;.00nan;0;0
26158;149450;42;72;22;1;21;.955;3600000;0
26159;176200;44;63;53;6;47;.887;3600000;0
26159;186495;47;61;22;2;20;.909;3600000;0
26159;64911;44;0;0;0;0;.00nan;0;0
26159;78479;47;0;0;0;0;.00nan;0;0
26160;195089;36;65;43;5;38;.884;3600000;0
26160;181123;63;38;33;6;27;.818;3600000;0
26160;187362;36;0;0;0;0;.00nan;0;0
26160;192457;63;0;0;0;0;.00nan;0;0
26161;161535;52;100;29;0;29;1.000;3600000;0
26161;171838;41;0;0;0;0;.00nan;0;0
26161;194264;41;85;37;2;35;.946;3600000;0
26161;184081;52;0;0;0;0;.00nan;0;0
26162;176915;62;0;0;0;0;.00nan;0;0
26162;179950;4837;88;30;2;28;.933;3600000;0
26162;196372;62;77;37;3;34;.919;3592000;0
26162;187295;4837;0;0;0;0;.00nan;0;0
26163;192733;61;48;27;4;23;.852;3600000;0
26163;163565;40;90;33;1;32;.970;3600000;0
26163;-1;61;0;0;0;0;.00nan;0;0
26163;185812;40;0;0;0;0;.00nan;0;0
26164;161535;52;0;0;0;0;.00nan;0;0
26164;184081;52;51;38;5;33;.868;3804000;0
26164;176921;58;66;45;6;39;.867;3804000;0
26164;38124;58;0;0;0;0;.00nan;0;0
26165;171838;41;94;26;1;25;.962;3900000;0
26165;194264;41;0;0;0;0;.00nan;0;0
26165;173856;38;0;0;0;0;.00nan;0;0
26165;181102;38;80;28;1;27;.964;3900000;0
26166;191026;48;0;0;0;0;.00nan;0;0
26166;86862;60;60;24;3;21;.875;3900000;0
26166;91398;60;0;0;0;0;.00nan;0;0
26166;142492;48;65;32;3;29;.906;3900000;0
26167;199481;57;85;31;2;29;.935;3900000;0
26167;169226;65;0;0;0;0;.00nan;0;0
26167;176938;65;85;38;2;36;.947;3900000;0
26167;152418;57;0;0;0;0;.00nan;0;0
26168;184610;49;57;28;4;24;.857;3779000;0
26168;201673;4619;0;0;0;0;.00nan;0;0
26168;78820;4619;61;38;5;33;.868;3779000;0
26168;79132;49;0;0;0;0;.00nan;0;0
26169;201673;4619;82;32;2;30;.938;3600000;0
26169;191026;48;40;34;5;29;.853;3600000;0
26169;78820;4619;0;0;0;0;.00nan;0;0
26169;142492;48;0;0;0;0;.00nan;0;0
26170;188888;51;0;0;0;0;.00nan;0;0
26170;186549;45;64;53;6;47;.887;2840000;0
26170;66491;45;62;9;0;9;1.000;760000;0
26170;86360;51;74;22;1;21;.955;3600000;0
26171;165744;43;87;16;0;16;1.000;3600000;0
26171;195089;36;0;0;0;0;.00nan;0;0
26171;187362;36;51;46;6;40;.870;3600000;0
26171;64811;43;0;0;0;0;.00nan;0;0
26172;171970;55;0;0;0;0;.00nan;0;0
26172;194502;55;46;33;5;28;.848;3600000;0
26172;181123;63;78;24;1;23;.958;3600000;0
26172;192457;63;0;0;0;0;.00nan;0;0
26173;161535;52;0;0;0;0;.00nan;0;0
26173;199481;57;0;0;0;0;.00nan;0;0
26173;184081;52;89;31;1;30;.968;3600000;0
26173;152418;57;68;24;2;22;.917;3571000;0
26174;189639;54;49;44;6;38;.864;2795000;0
26174;201876;54;61;11;0;11;1.000;805000;0
26174;57215;50;0;0;0;0;.00nan;0;0
26174;141998;50;77;26;2;24;.923;3600000;0
26175;192733;61;64;24;2;22;.917;3678000;0
26175;-1;61;0;0;0;0;.00nan;0;0
26175;191026;48;0;0;0;0;.00nan;0;0
26175;142492;48;61;28;3;25;.893;3678000;0
26176;184610;49;0;0;0;0;.00nan;0;0
26176;176915;62;0;0;0;0;.00nan;0;0
26176;196372;62;98;20;0;20;1.000;3600000;0
26176;79132;49;55;43;5;38;.884;3600000;0
26177;163565;40;52;29;4;25;.862;3579000;0
26177;169323;53;0;0;0;0;.00nan;0;0
26177;185812;40;0;0;0;0;.00nan;0;0
26177;91403;53;85;40;3;37;.925;3600000;0
26178;199481;57;0;0;0;0;.00nan;0;0
26178;188888;51;68;29;3;26;.897;3554000;0
26178;86360;51;0;0;0;0;.00nan;0;0
26178;152418;57;75;26;2;24;.923;3600000;0
26179;179950;4837;0;0;0;0;.00nan;0;0
26179;187295;4837;100;27;0;27;1.000;3600000;0
26179;86862;60;78;34;3;31;.912;3600000;0
26179;91398;60;0;0;0;0;.00nan;0;0
26180;187699;39;57;37;5;32;.865;3600000;0
26180;165744;43;68;17;1;16;.941;3600000;0
26180;197704;39;0;0;0;0;.00nan;0;0
26180;64811;43;0;0;0;0;.00nan;0;0
26181;171838;41;88;48;4;44;.917;3577000;0
26181;194264;41;0;0;0;0;.00nan;0;0
26181;173856;38;49;18;3;15;.833;3600000;0
26181;181102;38;0;0;0;0;.00nan;0;0
26182;195089;36;0;0;0;0;.00nan;0;0
26182;181123;63;53;23;3;20;.870;3561000;0
26182;187362;36;82;39;2;37;.949;3600000;0
26182;192457;63;0;0;0;0;.00nan;0;0
26183;189081;56;0;0;0;0;.00nan;0;0
26183;169226;65;20;28;6;22;.786;2583000;0
26183;176938;65;63;9;0;9;1.000;1017000;0
26183;57207;56;98;38;2;36;.947;3600000;0
26184;4622;64;0;0;0;0;.00nan;0;0
26184;186495;47;86;31;1;30;.968;3600000;0
26184;58037;64;64;30;3;27;.900;3550000;0
26184;78479;47;0;0;0;0;.00nan;0;0
26185;161535;52;0;0;0;0;.00nan;0;0
26185;184081;52;71;28;2;26;.929;3600000;0
26185;176921;58;46;22;4;18;.818;3595000;0
26185;38124;58;0;0;0;0;.00nan;0;0
26186;192733;61;0;0;0;0;.00nan;0;0
26186;-1;61;77;32;2;30;.938;3600000;0
26186;191026;48;71;33;3;30;.909;3553000;0
26186;142492;48;0;0;0;0;.00nan;0;0
26187;176200;44;0;0;0;0;.00nan;0;0
26187;201673;4619;0;0;0;0;.00nan;0;0
26187;64911;44;69;40;4;36;.900;3600000;0
26187;78820;4619;70;17;1;16;.941;3600000;0
26188;163565;40;0;0;0;0;.00nan;0;0
26188;169323;53;76;23;1;22;.957;3600000;0
26188;185812;40;79;40;2;38;.950;3554000;0
26188;91403;53;0;0;0;0;.00nan;0;0
26189;199481;57;66;27;3;24;.889;3600000;0
26189;188888;51;0;0;0;0;.00nan;0;0
26189;86360;51;85;31;2;29;.935;3600000;0
26189;152418;57;0;0;0;0;.00nan;0;0
26190;179950;4837;44;30;5;25;.833;3576000;0
26190;187295;4837;0;0;0;0;.00nan;0;0
26190;86862;60;0;0;0;0;.00nan;0;0
26190;91398;60;72;35;3;32;.914;3600000;0
26191;176921;58;0;0;0;0;.00nan;0;0
26191;38124;58;66;43;5;38;.884;3600000;0
26191;186527;59;0;0;0;0;.00nan;0;0
26191;75268;59;23;8;4;4;.500;3600000;0
26192;184069;46;90;21;0;21;1.000;3600000;0
26192;189639;54;0;0;0;0;.00nan;0;0
26192;201876;54;61;43;5;38;.884;3600000;0
26192;182049;46;0;0;0;0;.00nan;0;0
26193;187699;39;0;0;0;0;.00nan;0;0
26193;165744;43;0;0;0;0;.00nan;0;0
26193;197704;39;100;47;1;46;.979;3600000;0
26193;64811;43;64;22;2;20;.909;3547000;0
26194;189644;42;31;27;6;21;.778;3600000;0
26194;190465;37;0;0;0;0;.00nan;0;0
26194;202161;37;99;35;1;34;.971;3600000;0
26194;149450;42;0;0;0;0;.00nan;0;0
26195;186549;45;79;55;5;50;.909;3600000;0
26195;57215;50;70;20;1;19;.950;3600000;0
26195;66491;45;0;0;0;0;.00nan;0;0
26195;141998;50;0;0;0;0;.00nan;0;0
26196;169226;65;0;0;0;0;.00nan;0;0
26196;173856;38;0;0;0;0;.00nan;0;0
26196;176938;65;76;42;4;38;.905;3600000;0
26196;181102;38;100;32;0;32;1.000;3600000;0
26197;171970;55;0;0;0;0;.00nan;0;0
26197;194502;55;78;37;4;33;.892;3600000;0
26197;181123;63;83;30;1;29;.967;3600000;0
26197;192457;63;0;0;0;0;.00nan;0;0
26198;4622;64;0;0;0;0;.00nan;0;0
26198;186495;47;0;0;0;0;.00nan;0;0
26198;58037;64;68;40;4;36;.900;3558000;0
26198;78479;47;60;20;3;17;.850;3600000;0
26199;171838;41;51;8;1;7;.875;1306000;0
26199;194264;41;42;33;6;27;.818;2294000;0
26199;195089;36;68;21;2;19;.905;3600000;0
26199;187362;36;0;0;0;0;.00nan;0;0
26200;161535;52;67;18;1;17;.944;3600000;0
26200;189081;56;35;34;6;28;.824;3312000;0
26200;184081;52;0;0;0;0;.00nan;0;0
26200;57207;56;51;2;0;2;1.000;288000;0
26201;169226;65;91;65;5;60;.923;3600000;0
26201;176938;65;0;0;0;0;.00nan;0;0
26201;186527;59;0;0;0;0;.00nan;0;0
26201;75268;59;70;8;0;8;1.000;3600000;0
26202;184610;49;0;0;0;0;.00nan;0;0
26202;176915;62;0;0;0;0;.00nan;0;0
26202;196372;62;77;38;4;34;.895;3600000;0
26202;79132;49;72;24;1;23;.958;3600000;0
26203;184069;46;60;29;3;26;.897;3557000;0
26203;189639;54;87;34;2;32;.941;3600000;0
26203;201876;54;0;0;0;0;.00nan;0;0
26203;182049;46;0;0;0;0;.00nan;0;0
26204;189644;42;50;0;0;0;.00nan;493000;0
26204;190465;37;41;43;7;36;.837;3600000;0
26204;202161;37;0;0;0;0;.00nan;0;0
26204;149450;42;35;18;4;14;.778;3107000;0
26205;192733;61;80;31;2;29;.935;3525000;0
26205;-1;61;0;0;0;0;.00nan;0;0
26205;179950;4837;0;0;0;0;.00nan;0;0
26205;187295;4837;96;25;0;25;1.000;3600000;0
26206;171970;55;0;0;0;0;.00nan;0;0
26206;189081;56;0;0;0;0;.00nan;0;0
26206;194502;55;89;30;1;29;.967;3600000;0
26206;57207;56;45;28;5;23;.821;3600000;0
26207;163565;40;76;32;2;30;.938;3600000;0
26207;201673;4619;55;32;4;28;.875;3556000;0
26207;185812;40;0;0;0;0;.00nan;0;0
26207;78820;4619;0;0;0;0;.00nan;0;0
26208;192733;61;0;0;0;0;.00nan;0;0
26208;-1;61;58;37;5;32;.865;3600000;0
26208;179950;4837;91;32;1;31;.969;3600000;0
26208;187295;4837;0;0;0;0;.00nan;0;0
26209;187699;39;61;47;6;41;.872;3600000;0
26209;197704;39;0;0;0;0;.00nan;0;0
26209;57215;50;0;0;0;0;.00nan;0;0
26209;141998;50;77;23;1;22;.957;3600000;0
26210;186495;47;84;47;3;44;.936;3549000;0
26210;78479;47;0;0;0;0;.00nan;0;0
26210;84945;60;100;36;1;35;.972;3600000;0
26210;86862;60;0;0;0;0;.00nan;0;0
26211;184069;46;99;42;2;40;.952;3600000;0
26211;190465;37;0;0;0;0;.00nan;0;0
26211;202161;37;83;36;3;33;.917;3552000;0
26211;182049;46;0;0;0;0;.00nan;0;0
26212;169226;65;0;0;0;0;.00nan;0;0
26212;173856;38;73;22;1;21;.955;3600000;0
26212;176938;65;89;37;2;35;.946;3546000;0
26212;181102;38;0;0;0;0;.00nan;0;0
26213;176200;44;0;0;0;0;.00nan;0;0
26213;191026;48;41;25;4;21;.840;3574000;0
26213;64911;44;99;48;2;46;.958;3600000;0
26213;142492;48;0;0;0;0;.00nan;0;0
26214;188888;51;88;31;1;30;.968;3600000;0
26214;189081;56;0;0;0;0;.00nan;0;0
26214;57207;56;65;42;5;37;.881;3600000;0
26214;86360;51;0;0;0;0;.00nan;0;0
26215;171838;41;66;39;4;35;.897;3600000;0
26215;194264;41;0;0;0;0;.00nan;0;0
26215;186527;59;0;0;0;0;.00nan;0;0
26215;75268;59;85;11;0;11;1.000;3600000;0
26216;187699;39;53;30;4;26;.867;3900000;0
26216;186549;45;71;37;4;33;.892;3900000;0
26216;197704;39;0;0;0;0;.00nan;0;0
26216;66491;45;0;0;0;0;.00nan;0;0
26217;186495;47;97;40;1;39;.975;3900000;0
26217;78479;47;0;0;0;0;.00nan;0;0
26217;84945;60;100;26;1;25;.962;3900000;0
26217;86862;60;0;0;0;0;.00nan;0;0
26218;199481;57;0;0;0;0;.00nan;0;0
26218;169226;65;0;0;0;0;.00nan;0;0
26218;176938;65;86;45;3;42;.933;3576000;0
26218;152418;57;69;13;1;12;.923;3600000;0
26219;195089;36;0;0;0;0;.00nan;0;0
26219;181123;63;58;23;3;20;.870;3600000;0
26219;187362;36;51;28;4;24;.857;3570000;0
26219;192457;63;0;0;0;0;.00nan;0;0
26220;189639;54;43;40;6;34;.850;3113000;0
26220;201876;54;51;7;1;6;.857;487000;0
26220;190465;37;0;0;0;0;.00nan;0;0
26220;202161;37;74;22;1;21;.955;3600000;0
26221;163565;40;70;26;2;24;.923;3900000;0
26221;176915;62;0;0;0;0;.00nan;0;0
26221;196372;62;74;25;2;23;.920;3900000;0
26221;185812;40;0;0;0;0;.00nan;0;0
26222;169323;53;0;0;0;0;.00nan;0;0
26222;184610;49;89;41;3;38;.927;3600000;0
26222;79132;49;0;0;0;0;.00nan;0;0
26222;91403;53;60;22;2;20;.909;3600000;0
26223;161535;52;0;0;0;0;.00nan;0;0
26223;171970;55;0;0;0;0;.00nan;0;0
26223;194502;55;96;37;1;36;.973;3600000;0
26223;184081;52;72;24;2;22;.917;3543000;0
26224;184069;46;88;29;1;28;.966;3600000;0
26224;182049;46;0;0;0;0;.00nan;0;0
26224;57215;50;0;0;0;0;.00nan;0;0
26224;141998;50;55;28;4;24;.857;3600000;0
26225;176200;44;0;0;0;0;.00nan;0;0
26225;191026;48;52;34;4;30;.882;3546000;0
26225;64911;44;61;25;3;22;.880;3600000;0
26225;142492;48;0;0;0;0;.00nan;0;0
26226;169226;65;73;64;7;57;.891;3600000;0
26226;176938;65;0;0;0;0;.00nan;0;0
26226;186527;59;0;0;0;0;.00nan;0;0
26226;75268;59;35;9;3;6;.667;3600000;0
26227;4622;64;0;0;0;0;.00nan;0;0
26227;189639;54;0;0;0;0;.00nan;0;0
26227;201876;54;65;22;2;20;.909;3705000;0
26227;58037;64;58;22;3;19;.864;3705000;0
26228;176915;62;87;30;1;29;.967;3600000;0
26228;201673;4619;0;0;0;0;.00nan;0;0
26228;196372;62;0;0;0;0;.00nan;0;0
26228;78820;4619;80;47;3;44;.936;3557000;0
26229;187699;39;0;0;0;0;.00nan;0;0
26229;186549;45;0;0;0;0;.00nan;0;0
26229;197704;39;49;24;5;19;.792;3900000;0
26229;66491;45;45;30;5;25;.833;3900000;0
26230;171838;41;0;0;0;0;.00nan;0;0
26230;199481;57;81;34;2;32;.941;3900000;0
26230;194264;41;82;31;2;29;.935;3900000;0
26230;152418;57;0;0;0;0;.00nan;0;0
26231;173856;38;71;19;1;18;.947;3600000;0
26231;176921;58;75;38;3;35;.921;3553000;0
26231;181102;38;0;0;0;0;.00nan;0;0
26231;38124;58;0;0;0;0;.00nan;0;0
26232;163565;40;0;0;0;0;.00nan;0;0
26232;179950;4837;53;15;2;13;.867;1113000;0
26232;185812;40;76;32;3;29;.906;3600000;0
26232;187295;4837;31;28;6;22;.786;2487000;0
26233;184069;46;0;0;0;0;.00nan;0;0
26233;182049;46;92;41;2;39;.951;3808000;0
26233;57215;50;61;13;1;12;.923;3812000;0
26233;141998;50;0;0;0;0;.00nan;0;0
26234;195089;36;67;18;1;17;.944;3600000;0
26234;181123;63;0;0;0;0;.00nan;0;0
26234;187362;36;0;0;0;0;.00nan;0;0
26234;192457;63;44;35;6;29;.829;3600000;0
26235;161535;52;54;22;3;19;.864;3597000;0
26235;171970;55;91;38;2;36;.947;3600000;0
26235;194502;55;0;0;0;0;.00nan;0;0
26235;184081;52;0;0;0;0;.00nan;0;0
26236;188888;51;0;0;0;0;.00nan;0;0
26236;189081;56;0;0;0;0;.00nan;0;0
26236;57207;56;83;45;4;41;.911;3531000;0
26236;86360;51;65;22;2;20;.909;3600000;0
26237;4622;64;50;40;6;34;.850;2521000;0
26237;190465;37;0;0;0;0;.00nan;0;0
26237;202161;37;66;27;3;24;.889;3600000;0
26237;58037;64;69;11;0;11;1.000;1079000;0
26238;201673;4619;52;31;4;27;.871;3600000;0
26238;186495;47;43;40;6;34;.850;3584000;0
26238;78479;47;0;0;0;0;.00nan;0;0
26238;78820;4619;0;0;0;0;.00nan;0;0
26239;173856;38;0;0;0;0;.00nan;0;0
26239;176921;58;0;0;0;0;.00nan;0;0
26239;181102;38;53;22;3;19;.864;3594000;0
26239;38124;58;74;19;1;18;.947;3600000;0
26240;165744;43;0;0;0;0;.00nan;0;0
26240;189644;42;80;13;0;13;1.000;3600000;0
26240;64811;43;61;39;5;34;.872;3600000;0
26240;149450;42;0;0;0;0;.00nan;0;0
26241;179950;4837;0;0;0;0;.00nan;0;0
26241;187295;4837;55;16;2;14;.875;3600000;0
26241;84945;60;0;0;0;0;.00nan;0;0
26241;86862;60;60;27;3;24;.889;3593000;0
26242;171838;41;66;28;3;25;.893;3600000;0
26242;199481;57;0;0;0;0;.00nan;0;0
26242;194264;41;0;0;0;0;.00nan;0;0
26242;152418;57;68;43;5;38;.884;3567000;0
26243;169323;53;0;0;0;0;.00nan;0;0
26243;184610;49;0;0;0;0;.00nan;0;0
26243;79132;49;99;48;2;46;.958;3600000;0
26243;91403;53;59;21;3;18;.857;3564000;0
26244;165744;43;73;36;3;33;.917;3600000;0
26244;189644;42;57;35;5;30;.857;3544000;0
26244;64811;43;0;0;0;0;.00nan;0;0
26244;149450;42;0;0;0;0;.00nan;0;0
26245;171970;55;0;0;0;0;.00nan;0;0
26245;194502;55;85;66;6;60;.909;3600000;0
26245;186527;59;0;0;0;0;.00nan;0;0
26245;75268;59;91;18;0;18;1.000;3600000;0
26246;176200;44;0;0;0;0;.00nan;0;0
26246;176915;62;0;0;0;0;.00nan;0;0
26246;196372;62;61;16;1;15;.938;3600000;0
26246;64911;44;64;44;6;38;.864;3600000;0
26247;176200;44;67;30;3;27;.900;3831000;0
26247;176915;62;79;30;2;28;.933;3838000;0
26247;196372;62;0;0;0;0;.00nan;0;0
26247;64911;44;0;0;0;0;.00nan;0;0
26248;4622;64;0;0;0;0;.00nan;0;0
26248;186549;45;59;27;3;24;.889;3595000;0
26248;58037;64;50;12;2;10;.833;3600000;0
26248;66491;45;0;0;0;0;.00nan;0;0
26249;171838;41;65;32;3;29;.906;3900000;0
26249;194264;41;0;0;0;0;.00nan;0;0
26249;169226;65;0;0;0;0;.00nan;0;0
26249;176938;65;83;40;3;37;.925;3900000;0
26250;192733;61;43;34;5;29;.853;3567000;0
26250;-1;61;0;0;0;0;.00nan;0;0
26250;201673;4619;68;32;3;29;.906;3600000;0
26250;78820;4619;0;0;0;0;.00nan;0;0
26251;165744;43;68;15;1;14;.933;3600000;0
26251;189081;56;0;0;0;0;.00nan;0;0
26251;57207;56;88;39;2;37;.949;3573000;0
26251;64811;43;0;0;0;0;.00nan;0;0
26252;163565;40;68;31;3;28;.903;3586000;0
26252;169323;53;0;0;0;0;.00nan;0;0
26252;185812;40;0;0;0;0;.00nan;0;0
26252;91403;53;89;35;2;33;.943;3600000;0
26253;161535;52;0;0;0;0;.00nan;0;0
26253;184081;52;32;16;4;12;.750;3600000;0
26253;176921;58;99;40;1;39;.975;3600000;0
26253;38124;58;0;0;0;0;.00nan;0;0
26254;188888;51;0;0;0;0;.00nan;0;0
26254;181123;63;76;20;1;19;.950;3600000;0
26254;192457;63;0;0;0;0;.00nan;0;0
26254;86360;51;57;26;3;23;.885;3545000;0
26255;189081;56;0;0;0;0;.00nan;0;0
26255;189644;42;93;18;0;18;1.000;3600000;0
26255;57207;56;66;54;7;47;.870;3600000;0
26255;149450;42;0;0;0;0;.00nan;0;0
26256;192733;61;63;25;3;22;.880;3600000;0
26256;-1;61;0;0;0;0;.00nan;0;0
26256;191026;48;44;32;6;26;.813;2648000;0
26256;142492;48;57;6;0;6;1.000;952000;0
26257;176921;58;58;34;4;30;.882;2853000;0
26257;38124;58;18;8;4;4;.500;747000;0
26257;186527;59;0;0;0;0;.00nan;0;0
26257;75268;59;56;11;1;10;.909;3600000;0
26258;165744;43;0;0;0;0;.00nan;0;0
26258;173856;38;80;40;3;37;.925;2754000;0
26258;181102;38;32;19;4;15;.789;846000;0
26258;64811;43;52;20;3;17;.850;3600000;0
26259;176915;62;0;0;0;0;.00nan;0;0
26259;196372;62;36;32;5;27;.844;3527000;0
26259;84945;60;0;0;0;0;.00nan;0;0
26259;86862;60;93;39;3;36;.923;3600000;0
26260;161535;52;0;0;0;0;.00nan;0;0
26260;199481;57;0;0;0;0;.00nan;0;0
26260;184081;52;85;43;3;40;.930;3565000;0
26260;152418;57;93;33;2;31;.939;3600000;0
26261;190465;37;68;26;2;24;.923;3600000;0
26261;202161;37;0;0;0;0;.00nan;0;0
26261;57215;50;0;0;0;0;.00nan;0;0
26261;141998;50;55;42;5;37;.881;3600000;0
26262;163565;40;0;0;0;0;.00nan;0;0
26262;169323;53;0;0;0;0;.00nan;0;0
26262;185812;40;91;32;1;31;.969;3600000;0
26262;91403;53;68;23;2;21;.913;3600000;0
26263;184610;49;0;0;0;0;.00nan;0;0
26263;179950;4837;0;0;0;0;.00nan;0;0
26263;187295;4837;61;29;4;25;.862;3587000;0
26263;79132;49;89;45;3;42;.933;3600000;0
26264;169226;65;0;0;0;0;.00nan;0;0
26264;195089;36;0;0;0;0;.00nan;0;0
26264;176938;65;95;51;2;49;.961;3584000;0
26264;187362;36;93;18;0;18;1.000;3600000;0
26265;171838;41;93;20;0;20;1.000;3600000;0
26265;171970;55;0;0;0;0;.00nan;0;0
26265;194264;41;0;0;0;0;.00nan;0;0
26265;194502;55;96;46;3;43;.935;3600000;0
26266;184069;46;72;28;3;25;.893;3600000;0
26266;182049;46;0;0;0;0;.00nan;0;0
26266;186549;45;56;36;5;31;.861;3576000;0
26266;66491;45;0;0;0;0;.00nan;0;0
26267;201673;4619;72;28;2;26;.929;3600000;0
26267;186495;47;80;46;5;41;.891;3600000;0
26267;78479;47;0;0;0;0;.00nan;0;0
26267;78820;4619;0;0;0;0;.00nan;0;0
26268;189081;56;0;0;0;0;.00nan;0;0
26268;173856;38;57;26;3;23;.885;3900000;0
26268;181102;38;0;0;0;0;.00nan;0;0
26268;57207;56;80;40;3;37;.925;3900000;0
26269;176921;58;0;0;0;0;.00nan;0;0
26269;38124;58;57;48;5;43;.896;3600000;0
26269;186527;59;60;11;1;10;.909;3600000;0
26269;75268;59;0;0;0;0;.00nan;0;0
26270;188888;51;0;0;0;0;.00nan;0;0
26270;181123;63;59;25;3;22;.880;3560000;0
26270;192457;63;0;0;0;0;.00nan;0;0
26270;86360;51;76;23;1;22;.957;3600000;0
26271;171838;41;54;18;2;16;.889;3600000;0
26271;171970;55;80;44;4;40;.909;3598000;0
26271;194264;41;0;0;0;0;.00nan;0;0
26271;194502;55;0;0;0;0;.00nan;0;0
26272;192733;61;0;0;0;0;.00nan;0;0
26272;-1;61;73;26;2;24;.923;3600000;0
26272;191026;48;0;0;0;0;.00nan;0;0
26272;142492;48;99;39;1;38;.974;3600000;0
26273;189639;54;94;42;3;39;.929;3865000;0
26273;201876;54;0;0;0;0;.00nan;0;0
26273;190465;37;0;0;0;0;.00nan;0;0
26273;202161;37;59;19;2;17;.895;3865000;0
26274;4622;64;0;0;0;0;.00nan;0;0
26274;57215;50;50;30;5;25;.833;3600000;0
26274;58037;64;100;37;0;37;1.000;3600000;0
26274;141998;50;0;0;0;0;.00nan;0;0
26275;161535;52;73;23;1;22;.957;3900000;0
26275;199481;57;100;31;1;30;.968;3896000;0
26275;184081;52;0;0;0;0;.00nan;0;0
26275;152418;57;0;0;0;0;.00nan;0;0
26276;184610;49;97;47;2;45;.957;3900000;0
26276;179950;4837;52;12;2;10;.833;3900000;0
26276;187295;4837;0;0;0;0;.00nan;0;0
26276;79132;49;0;0;0;0;.00nan;0;0
26277;184069;46;0;0;0;0;.00nan;0;0
26277;182049;46;78;23;1;22;.957;3600000;0
26277;186549;45;0;0;0;0;.00nan;0;0
26277;66491;45;45;30;5;25;.833;3600000;0
26278;187699;39;77;31;3;28;.903;3533000;0
26278;189644;42;100;31;1;30;.968;3600000;0
26278;197704;39;0;0;0;0;.00nan;0;0
26278;149450;42;0;0;0;0;.00nan;0;0
26279;201673;4619;0;0;0;0;.00nan;0;0
26279;186495;47;0;0;0;0;.00nan;0;0
26279;78479;47;100;31;1;30;.968;3600000;0
26279;78820;4619;75;35;3;32;.914;3514000;0
26280;165744;43;36;17;4;13;.765;3748000;0
26280;195089;36;0;0;0;0;.00nan;0;0
26280;187362;36;94;57;5;52;.912;3748000;0
26280;64811;43;0;0;0;0;.00nan;0;0
26281;199481;57;0;0;0;0;.00nan;0;0
26281;186527;59;0;0;0;0;.00nan;0;0
26281;75268;59;81;12;0;12;1.000;3600000;0
26281;152418;57;52;47;6;41;.872;3600000;0
26282;4622;64;0;0;0;0;.00nan;0;0
26282;57215;50;0;0;0;0;.00nan;0;0
26282;58037;64;100;50;2;48;.960;3600000;0
26282;141998;50;41;24;4;20;.833;3536000;0
26283;189639;54;0;0;0;0;.00nan;0;0
26283;201876;54;99;40;1;39;.975;3600000;0
26283;190465;37;26;22;5;17;.773;3600000;0
26283;202161;37;0;0;0;0;.00nan;0;0
26284;176915;62;0;0;0;0;.00nan;0;0
26284;196372;62;86;50;5;45;.900;3557000;0
26284;84945;60;64;31;4;27;.871;3600000;0
26284;86862;60;0;0;0;0;.00nan;0;0
26285;187699;39;0;0;0;0;.00nan;0;0
26285;189644;42;0;0;0;0;.00nan;0;0
26285;197704;39;98;40;1;39;.975;3571000;0
26285;149450;42;98;27;0;27;1.000;3600000;0
26286;188888;51;0;0;0;0;.00nan;0;0
26286;169323;53;98;38;1;37;.974;3600000;0
26286;86360;51;74;36;3;33;.917;3600000;0
26286;91403;53;0;0;0;0;.00nan;0;0
26287;192733;61;70;27;2;25;.926;3514000;0
26287;-1;61;0;0;0;0;.00nan;0;0
26287;176200;44;0;0;0;0;.00nan;0;0
26287;64911;44;100;28;0;28;1.000;3600000;0
26288;176915;62;10;21;7;14;.667;2752000;0
26288;196372;62;56;4;0;4;1.000;848000;0
26288;186495;47;78;32;2;30;.938;3600000;0
26288;78479;47;0;0;0;0;.00nan;0;0
26289;201673;4619;71;19;1;18;.947;3600000;0
26289;78820;4619;0;0;0;0;.00nan;0;0
26289;84945;60;0;0;0;0;.00nan;0;0
26289;86862;60;81;38;3;35;.921;3594000;0
26290;163565;40;0;0;0;0;.00nan;0;0
26290;184610;49;0;0;0;0;.00nan;0;0
26290;185812;40;46;17;3;14;.824;3900000;0
26290;79132;49;83;42;3;39;.929;3900000;0
26291;187699;39;69;21;1;20;.952;3600000;0
26291;173856;38;70;37;3;34;.919;3572000;0
26291;181102;38;0;0;0;0;.00nan;0;0
26291;197704;39;0;0;0;0;.00nan;0;0
26292;176915;62;0;0;0;0;.00nan;0;0
26292;196372;62;84;36;2;34;.944;3900000;0
26292;186495;47;0;0;0;0;.00nan;0;0
26292;78479;47;81;34;2;32;.941;3900000;0
26293;188888;51;0;0;0;0;.00nan;0;0
26293;169323;53;0;0;0;0;.00nan;0;0
26293;86360;51;41;31;5;26;.839;3600000;0
26293;91403;53;93;40;2;38;.950;3600000;0
26294;171838;41;82;14;0;14;1.000;3600000;0
26294;199481;57;0;0;0;0;.00nan;0;0
26294;194264;41;0;0;0;0;.00nan;0;0
26294;152418;57;67;24;1;23;.958;3600000;0
26295;161535;52;0;0;0;0;.00nan;0;0
26295;184081;52;44;28;4;24;.857;3574000;0
26295;176921;58;98;44;2;42;.955;3600000;0
26295;38124;58;0;0;0;0;.00nan;0;0
26296;189639;54;18;23;6;17;.739;2081000;0
26296;201876;54;47;27;4;23;.852;1519000;0
26296;57215;50;0;0;0;0;.00nan;0;0
26296;141998;50;56;18;3;15;.833;3600000;0
26297;165744;43;69;20;1;19;.950;3600000;0
26297;181123;63;69;37;4;33;.892;3600000;0
26297;192457;63;0;0;0;0;.00nan;0;0
26297;64811;43;0;0;0;0;.00nan;0;0
26298;189644;42;0;0;0;0;.00nan;0;0
26298;190465;37;22;31;7;24;.774;3707000;0
26298;202161;37;0;0;0;0;.00nan;0;0
26298;149450;42;43;35;6;29;.829;3708000;0
26299;169226;65;0;0;0;0;.00nan;0;0
26299;176938;65;91;48;3;45;.938;3600000;0
26299;186527;59;0;0;0;0;.00nan;0;0
26299;75268;59;81;13;0;13;1.000;3600000;0
26300;171970;55;0;0;0;0;.00nan;0;0
26300;194502;55;97;49;3;46;.939;3600000;0
26300;195089;36;0;0;0;0;.00nan;0;0
26300;187362;36;73;21;1;20;.952;3600000;0
26301;161535;52;0;0;0;0;.00nan;0;0
26301;184081;52;43;30;5;25;.833;3554000;0
26301;169323;53;0;0;0;0;.00nan;0;0
26301;91403;53;62;34;4;30;.882;3600000;0
26302;187699;39;89;40;1;39;.975;3600000;0
26302;188888;51;38;32;6;26;.813;2973000;0
26302;197704;39;0;0;0;0;.00nan;0;0
26302;86360;51;54;3;0;3;1.000;627000;0
26303;184069;46;71;38;3;35;.921;3570000;0
26303;179950;4837;0;0;0;0;.00nan;0;0
26303;182049;46;0;0;0;0;.00nan;0;0
26303;187295;4837;88;26;1;25;.962;3600000;0
26304;189644;42;91;33;2;31;.939;3567000;0
26304;186549;45;0;0;0;0;.00nan;0;0
26304;66491;45;88;32;1;31;.969;3600000;0
26304;149450;42;0;0;0;0;.00nan;0;0
26305;199481;57;0;0;0;0;.00nan;0;0
26305;173856;38;55;16;2;14;.875;3600000;0
26305;181102;38;0;0;0;0;.00nan;0;0
26305;152418;57;98;53;3;50;.943;3600000;0
26306;165744;43;80;20;1;19;.950;3600000;0
26306;181123;63;68;37;3;34;.919;3600000;0
26306;192457;63;0;0;0;0;.00nan;0;0
26306;64811;43;0;0;0;0;.00nan;0;0
26307;190465;37;71;30;2;28;.933;3600000;0
26307;202161;37;0;0;0;0;.00nan;0;0
26307;57215;50;26;21;5;16;.762;1066000;0
26307;141998;50;63;21;3;18;.857;2534000;0
26308;4622;64;0;0;0;0;.00nan;0;0
26308;163565;40;62;17;2;15;.882;3600000;0
26308;185812;40;0;0;0;0;.00nan;0;0
26308;58037;64;39;21;4;17;.810;3588000;0
26309;184610;49;95;43;1;42;.977;3600000;0
26309;79132;49;0;0;0;0;.00nan;0;0
26309;84945;60;59;21;2;19;.905;3574000;0
26309;86862;60;0;0;0;0;.00nan;0;0
26310;171838;41;87;28;1;27;.964;3600000;0
26310;194264;41;0;0;0;0;.00nan;0;0
26310;169226;65;0;0;0;0;.00nan;0;0
26310;176938;65;61;45;5;40;.889;3600000;0
26311;171970;55;0;0;0;0;.00nan;0;0
26311;194502;55;78;54;5;49;.907;3600000;0
26311;195089;36;0;0;0;0;.00nan;0;0
26311;187362;36;56;17;2;15;.882;3600000;0
26312;176200;44;0;0;0;0;.00nan;0;0
26312;201673;4619;80;29;3;26;.897;3575000;0
26312;64911;44;99;44;2;42;.955;3600000;0
26312;78820;4619;0;0;0;0;.00nan;0;0
26313;199481;57;78;53;5;48;.906;3600000;0
26313;186527;59;0;0;0;0;.00nan;0;0
26313;75268;59;72;18;1;17;.944;3600000;0
26313;152418;57;0;0;0;0;.00nan;0;0
26314;176915;62;0;0;0;0;.00nan;0;0
26314;196372;62;47;18;3;15;.833;3600000;0
26314;191026;48;62;9;0;9;1.000;696000;0
26314;142492;48;28;27;6;21;.778;2904000;0
26315;161535;52;53;36;5;31;.861;3569000;0
26315;184081;52;0;0;0;0;.00nan;0;0
26315;169323;53;76;41;4;37;.902;3600000;0
26315;91403;53;0;0;0;0;.00nan;0;0
26316;184069;46;0;0;0;0;.00nan;0;0
26316;179950;4837;87;28;1;27;.964;3600000;0
26316;182049;46;75;37;3;34;.919;3568000;0
26316;187295;4837;0;0;0;0;.00nan;0;0
26317;171838;41;0;0;0;0;.00nan;0;0
26317;194264;41;72;23;1;22;.957;3600000;0
26317;189081;56;0;0;0;0;.00nan;0;0
26317;57207;56;64;34;3;31;.912;3600000;0
26318;192733;61;88;51;3;48;.941;3600000;0
26318;-1;61;0;0;0;0;.00nan;0;0
26318;186495;47;73;25;2;23;.920;3600000;0
26318;78479;47;0;0;0;0;.00nan;0;0
26319;189639;54;62;23;2;21;.913;3549000;0
26319;176921;58;88;23;1;22;.957;3600000;0
26319;201876;54;0;0;0;0;.00nan;0;0
26319;38124;58;0;0;0;0;.00nan;0;0
26320;173856;38;0;0;0;0;.00nan;0;0
26320;181102;38;76;24;2;22;.917;3561000;0
26320;181123;63;92;21;0;21;1.000;3600000;0
26320;192457;63;0;0;0;0;.00nan;0;0
26321;190465;37;0;0;0;0;.00nan;0;0
26321;202161;37;72;31;3;28;.903;3600000;0
26321;57215;50;25;25;6;19;.760;3600000;0
26321;141998;50;0;0;0;0;.00nan;0;0
26322;4622;64;0;0;0;0;.00nan;0;0
26322;163565;40;0;0;0;0;.00nan;0;0
26322;185812;40;46;34;5;29;.853;3596000;0
26322;58037;64;51;28;4;24;.857;3600000;0
26323;184610;49;0;0;0;0;.00nan;0;0
26323;79132;49;82;42;3;39;.929;3600000;0
26323;84945;60;0;0;0;0;.00nan;0;0
26323;86862;60;45;27;4;23;.852;3559000;0
26324;169226;65;86;44;2;42;.955;3900000;0
26324;195089;36;79;31;2;29;.935;3900000;0
26324;176938;65;0;0;0;0;.00nan;0;0
26324;187362;36;0;0;0;0;.00nan;0;0
26325;171970;55;86;56;5;51;.911;3600000;0
26325;165744;43;0;0;0;0;.00nan;0;0
26325;194502;55;0;0;0;0;.00nan;0;0
26325;64811;43;73;8;0;8;1.000;3600000;0
26326;189081;56;0;0;0;0;.00nan;0;0
26326;186527;59;50;19;3;16;.842;3900000;0
26326;57207;56;95;42;3;39;.929;3900000;0
26326;75268;59;0;0;0;0;.00nan;0;0
26327;176915;62;83;22;1;21;.955;3600000;0
26327;196372;62;0;0;0;0;.00nan;0;0
26327;191026;48;72;31;2;29;.935;3600000;0
26327;142492;48;0;0;0;0;.00nan;0;0
26328;189644;42;97;33;1;32;.970;3600000;0
26328;186549;45;72;38;3;35;.921;3576000;0
26328;66491;45;0;0;0;0;.00nan;0;0
26328;149450;42;0;0;0;0;.00nan;0;0
26329;192733;61;0;0;0;0;.00nan;0;0
26329;-1;61;72;38;4;34;.895;3758000;0
26329;186495;47;0;0;0;0;.00nan;0;0
26329;78479;47;40;28;5;23;.821;3758000;0
26330;189639;54;0;0;0;0;.00nan;0;0
26330;176921;58;62;24;2;22;.917;2369000;0
26330;201876;54;44;34;5;29;.853;3600000;0
26330;38124;58;15;9;4;5;.556;1186000;0
26331;187699;39;0;0;0;0;.00nan;0;0
26331;188888;51;59;28;3;25;.893;3088000;0
26331;197704;39;88;42;3;39;.929;3600000;0
26331;86360;51;26;7;3;4;.571;512000;0
26332;186495;47;59;35;4;31;.886;3562000;0
26332;78479;47;0;0;0;0;.00nan;0;0
26332;84945;60;0;0;0;0;.00nan;0;0
26332;86862;60;56;26;3;23;.885;3600000;0
26333;184610;49;0;0;0;0;.00nan;0;0
26333;201673;4619;0;0;0;0;.00nan;0;0
26333;78820;4619;62;24;3;21;.875;3600000;0
26333;79132;49;42;32;5;27;.844;3533000;0
26334;4622;64;0;0;0;0;.00nan;0;0
26334;186549;45;59;42;5;37;.881;3525000;0
26334;58037;64;53;22;3;19;.864;3600000;0
26334;66491;45;0;0;0;0;.00nan;0;0
26335;192733;61;62;28;4;24;.857;3600000;0
26335;-1;61;0;0;0;0;.00nan;0;0
26335;176200;44;0;0;0;0;.00nan;0;0
26335;64911;44;45;31;5;26;.839;3565000;0
26336;163565;40;56;25;3;22;.880;3600000;0
26336;184069;46;0;0;0;0;.00nan;0;0
26336;182049;46;62;36;4;32;.889;3567000;0
26336;185812;40;0;0;0;0;.00nan;0;0
26337;189081;56;64;14;1;13;.929;1425000;0
26337;195089;36;0;0;0;0;.00nan;0;0
26337;187362;36;25;20;5;15;.750;3600000;0
26337;57207;56;22;24;6;18;.750;2090000;0
26338;161535;52;0;0;0;0;.00nan;0;0
26338;184081;52;60;20;3;17;.850;3600000;0
26338;176921;58;70;51;6;45;.882;3600000;0
26338;38124;58;0;0;0;0;.00nan;0;0
26339;165744;43;0;0;0;0;.00nan;0;0
26339;191026;48;0;0;0;0;.00nan;0;0
26339;64811;43;71;18;1;17;.944;3600000;0
26339;142492;48;83;33;3;30;.909;3564000;0
26340;184069;46;0;0;0;0;.00nan;0;0
26340;176200;44;0;0;0;0;.00nan;0;0
26340;182049;46;54;25;3;22;.880;3600000;0
26340;64911;44;50;38;6;32;.842;3600000;0
26341;189081;56;0;0;0;0;.00nan;0;0
26341;181123;63;90;20;0;20;1.000;3600000;0
26341;192457;63;0;0;0;0;.00nan;0;0
26341;57207;56;81;34;2;32;.941;3590000;0
26342;169323;53;0;0;0;0;.00nan;0;0
26342;176921;58;63;60;7;53;.883;3600000;0
26342;38124;58;0;0;0;0;.00nan;0;0
26342;91403;53;79;21;1;20;.952;3600000;0
26343;189639;54;21;35;7;28;.800;2828000;0
26343;179950;4837;0;0;0;0;.00nan;0;0
26343;201876;54;51;7;1;6;.857;772000;0
26343;187295;4837;74;28;2;26;.929;3600000;0
26344;186549;45;0;0;0;0;.00nan;0;0
26344;57215;50;0;0;0;0;.00nan;0;0
26344;66491;45;99;50;2;48;.960;3600000;0
26344;141998;50;58;24;3;21;.875;3571000;0
26345;194264;41;0;0;0;0;.00nan;0;0
26345;173856;38;0;0;0;0;.00nan;0;0
26345;181102;38;36;26;5;21;.808;3600000;0
26345;75313;41;69;25;2;23;.920;3600000;0
26346;192733;61;89;35;2;33;.943;3900000;0
26346;-1;61;0;0;0;0;.00nan;0;0
26346;176915;62;0;0;0;0;.00nan;0;0
26346;196372;62;69;32;2;30;.938;3900000;0
26347;189644;42;0;0;0;0;.00nan;0;0
26347;190465;37;57;34;4;30;.882;3600000;0
26347;202161;37;0;0;0;0;.00nan;0;0
26347;149450;42;81;23;1;22;.957;3600000;0
26348;201673;4619;96;31;1;30;.968;3600000;0
26348;78820;4619;0;0;0;0;.00nan;0;0
26348;84945;60;63;38;5;33;.868;3600000;0
26348;86862;60;0;0;0;0;.00nan;0;0
26349;163195;59;47;28;4;24;.857;3679000;0
26349;199481;57;0;0;0;0;.00nan;0;0
26349;186527;59;0;0;0;0;.00nan;0;0
26349;152418;57;100;47;3;44;.936;3679000;0
26350;161535;52;0;0;0;0;.00nan;0;0
26350;184081;52;50;21;3;18;.857;3600000;0
26350;169226;65;0;0;0;0;.00nan;0;0
26350;176938;65;38;28;5;23;.821;3517000;0
26351;171970;55;0;0;0;0;.00nan;0;0
26351;187699;39;59;21;2;19;.905;3543000;0
26351;194502;55;85;33;1;32;.970;3600000;0
26351;197704;39;0;0;0;0;.00nan;0;0
26352;184610;49;0;0;0;0;.00nan;0;0
26352;186495;47;83;32;2;30;.938;3600000;0
26352;78479;47;0;0;0;0;.00nan;0;0
26352;79132;49;63;37;4;33;.892;3553000;0
26353;165744;43;63;27;3;24;.889;3600000;0
26353;191026;48;57;45;6;39;.867;3600000;0
26353;64811;43;0;0;0;0;.00nan;0;0
26353;142492;48;0;0;0;0;.00nan;0;0
26354;184069;46;37;34;6;28;.824;3024000;0
26354;176200;44;73;30;3;27;.900;3600000;0
26354;182049;46;52;2;0;2;1.000;576000;0
26354;64911;44;0;0;0;0;.00nan;0;0
26355;189081;56;73;34;3;31;.912;3774000;0
26355;181123;63;100;51;2;49;.961;3774000;0
26355;192457;63;0;0;0;0;.00nan;0;0
26355;57207;56;0;0;0;0;.00nan;0;0
26356;163195;59;97;19;0;19;1.000;3600000;0
26356;199481;57;69;54;6;48;.889;3600000;0
26356;186527;59;0;0;0;0;.00nan;0;0
26356;152418;57;0;0;0;0;.00nan;0;0
26357;169323;53;0;0;0;0;.00nan;0;0
26357;176921;58;25;5;3;2;.400;417000;0
26357;38124;58;86;30;1;29;.967;3170000;0
26357;91403;53;57;26;3;23;.885;3600000;0
26358;4622;64;0;0;0;0;.00nan;0;0
26358;163565;40;43;20;4;16;.800;3600000;0
26358;185812;40;0;0;0;0;.00nan;0;0
26358;58037;64;69;39;5;34;.872;3549000;0
26359;188888;51;0;0;0;0;.00nan;0;0
26359;195089;36;0;0;0;0;.00nan;0;0
26359;187362;36;70;27;2;25;.926;3600000;0
26359;86360;51;62;35;4;31;.886;3568000;0
26360;201673;4619;0;0;0;0;.00nan;0;0
26360;78820;4619;69;38;5;33;.868;3600000;0
26360;84945;60;0;0;0;0;.00nan;0;0
26360;86862;60;58;30;4;26;.867;3600000;0
26361;189639;54;0;0;0;0;.00nan;0;0
26361;179950;4837;70;29;2;27;.931;3900000;0
26361;201876;54;100;51;2;49;.961;3900000;0
26361;187295;4837;0;0;0;0;.00nan;0;0
26362;194264;41;79;25;1;24;.960;3600000;0
26362;173856;38;79;29;2;27;.931;3600000;0
26362;181102;38;0;0;0;0;.00nan;0;0
26362;75313;41;0;0;0;0;.00nan;0;0
26363;186549;45;34;29;6;23;.793;3600000;0
26363;57215;50;63;18;2;16;.889;3600000;0
26363;66491;45;0;0;0;0;.00nan;0;0
26363;141998;50;0;0;0;0;.00nan;0;0
26364;171970;55;22;34;7;27;.794;3121000;0
26364;187699;39;0;0;0;0;.00nan;0;0
26364;194502;55;53;3;0;3;1.000;479000;0
26364;197704;39;68;18;1;17;.944;3600000;0
26365;184610;49;82;48;4;44;.917;3528000;0
26365;186495;47;55;16;2;14;.875;3600000;0
26365;78479;47;0;0;0;0;.00nan;0;0
26365;79132;49;0;0;0;0;.00nan;0;0
26366;161535;52;80;31;3;28;.903;3900000;0
26366;184081;52;0;0;0;0;.00nan;0;0
26366;169226;65;73;27;3;24;.889;3900000;0
26366;176938;65;0;0;0;0;.00nan;0;0
26367;4622;64;94;31;1;30;.968;3600000;0
26367;163565;40;0;0;0;0;.00nan;0;0
26367;185812;40;13;25;7;18;.720;3600000;0
26367;58037;64;0;0;0;0;.00nan;0;0
26368;188888;51;99;40;1;39;.975;3600000;0
26368;195089;36;79;28;2;26;.929;3600000;0
26368;187362;36;0;0;0;0;.00nan;0;0
26368;86360;51;0;0;0;0;.00nan;0;0
26369;192733;61;46;34;5;29;.853;3518000;0
26369;-1;61;0;0;0;0;.00nan;0;0
26369;176915;62;54;27;3;24;.889;3600000;0
26369;196372;62;0;0;0;0;.00nan;0;0
26370;189644;42;42;19;4;15;.789;3600000;0
26370;190465;37;64;42;5;37;.881;3558000;0
26370;202161;37;0;0;0;0;.00nan;0;0
26370;149450;42;0;0;0;0;.00nan;0;0
26371;199481;57;0;0;0;0;.00nan;0;0
26371;173856;38;0;0;0;0;.00nan;0;0
26371;181102;38;82;37;2;35;.946;3600000;0
26371;152418;57;33;26;5;21;.808;3600000;0
26372;189639;54;61;20;2;18;.900;1095000;0
26372;201876;54;24;26;6;20;.769;2505000;0
26372;190465;37;0;0;0;0;.00nan;0;0
26372;202161;37;73;16;1;15;.938;3600000;0
26373;187699;39;64;21;2;19;.905;3600000;0
26373;186549;45;0;0;0;0;.00nan;0;0
26373;197704;39;0;0;0;0;.00nan;0;0
26373;66491;45;64;44;5;39;.886;3600000;0
26374;188888;51;88;28;2;26;.929;3900000;0
26374;194264;41;71;27;2;25;.926;3900000;0
26374;75313;41;0;0;0;0;.00nan;0;0
26374;86360;51;0;0;0;0;.00nan;0;0
26375;165744;43;74;15;1;14;.933;3600000;0
26375;189081;56;77;36;2;34;.944;2793000;0
26375;57207;56;29;12;4;8;.667;807000;0
26375;64811;43;0;0;0;0;.00nan;0;0
26376;163565;40;64;42;4;38;.905;3900000;0
26376;185812;40;0;0;0;0;.00nan;0;0
26376;57215;50;0;0;0;0;.00nan;0;0
26376;141998;50;58;33;4;29;.879;3900000;0
26377;192733;61;70;35;4;31;.886;3900000;0
26377;-1;61;0;0;0;0;.00nan;0;0
26377;84945;60;0;0;0;0;.00nan;0;0
26377;86862;60;67;27;4;23;.852;3900000;0
26378;201673;4619;75;30;2;28;.933;3900000;0
26378;191026;48;0;0;0;0;.00nan;0;0
26378;78820;4619;0;0;0;0;.00nan;0;0
26378;142492;48;75;31;2;29;.935;3900000;0
26379;189081;56;0;0;0;0;.00nan;0;0
26379;186549;45;0;0;0;0;.00nan;0;0
26379;57207;56;62;32;4;28;.875;3900000;0
26379;66491;45;67;31;4;27;.871;3900000;0
26380;189644;42;50;25;4;21;.840;3561000;0
26380;176915;62;0;0;0;0;.00nan;0;0
26380;196372;62;80;32;3;29;.906;3600000;0
26380;149450;42;0;0;0;0;.00nan;0;0
26381;179950;4837;0;0;0;0;.00nan;0;0
26381;186495;47;66;34;3;31;.912;3562000;0
26381;187295;4837;66;20;1;19;.950;3600000;0
26381;78479;47;0;0;0;0;.00nan;0;0
26382;189639;54;81;42;4;38;.905;3519000;0
26382;201876;54;0;0;0;0;.00nan;0;0
26382;57215;50;60;16;2;14;.875;3600000;0
26382;141998;50;0;0;0;0;.00nan;0;0
26383;165744;43;0;0;0;0;.00nan;0;0
26383;194264;41;0;0;0;0;.00nan;0;0
26383;64811;43;67;19;2;17;.895;3600000;0
26383;75313;41;57;40;5;35;.875;3600000;0
26384;199481;57;0;0;0;0;.00nan;0;0
26384;173856;38;63;32;3;29;.906;3900000;0
26384;181102;38;0;0;0;0;.00nan;0;0
26384;152418;57;65;30;3;27;.900;3888000;0
26385;176200;44;0;0;0;0;.00nan;0;0
26385;64911;44;88;48;3;45;.938;3587000;0
26385;84945;60;69;26;2;24;.923;3600000;0
26385;86862;60;0;0;0;0;.00nan;0;0
26386;169323;53;0;0;0;0;.00nan;0;0
26386;181123;63;73;31;3;28;.903;3596000;0
26386;192457;63;0;0;0;0;.00nan;0;0
26386;91403;53;81;28;1;27;.964;3600000;0
26387;163565;40;60;40;5;35;.875;3600000;0
26387;190465;37;75;11;0;11;1.000;3600000;0
26387;202161;37;0;0;0;0;.00nan;0;0
26387;185812;40;0;0;0;0;.00nan;0;0
26388;192733;61;59;43;5;38;.884;3600000;0
26388;-1;61;0;0;0;0;.00nan;0;0
26388;184610;49;0;0;0;0;.00nan;0;0
26388;79132;49;85;33;1;32;.970;3600000;0
26389;171970;55;0;0;0;0;.00nan;0;0
26389;194502;55;61;49;7;42;.857;3600000;0
26389;176921;58;87;14;0;14;1.000;3600000;0
26389;38124;58;0;0;0;0;.00nan;0;0
26390;4622;64;0;0;0;0;.00nan;0;0
26390;184069;46;0;0;0;0;.00nan;0;0
26390;182049;46;68;37;4;33;.892;3544000;0
26390;58037;64;56;17;2;15;.882;3600000;0
26391;163195;59;40;14;3;11;.786;3900000;0
26391;195089;36;0;0;0;0;.00nan;0;0
26391;186527;59;0;0;0;0;.00nan;0;0
26391;187362;36;100;68;3;65;.956;3896000;0
26392;161535;52;0;0;0;0;.00nan;0;0
26392;188888;51;0;0;0;0;.00nan;0;0
26392;184081;52;87;39;3;36;.923;3600000;0
26392;86360;51;52;31;5;26;.839;3570000;0
26393;201673;4619;0;0;0;0;.00nan;0;0
26393;191026;48;73;38;4;34;.895;3600000;0
26393;78820;4619;65;25;2;23;.920;3600000;0
26393;142492;48;0;0;0;0;.00nan;0;0
26394;176200;44;81;40;4;36;.900;3540000;0
26394;64911;44;0;0;0;0;.00nan;0;0
26394;84945;60;0;0;0;0;.00nan;0;0
26394;86862;60;57;17;2;15;.882;3600000;0
26395;189081;56;86;45;3;42;.933;3544000;0
26395;186549;45;94;41;2;39;.951;3600000;0
26395;57207;56;0;0;0;0;.00nan;0;0
26395;66491;45;0;0;0;0;.00nan;0;0
26396;179950;4837;65;26;3;23;.885;3600000;0
26396;186495;47;54;31;4;27;.871;3547000;0
26396;187295;4837;0;0;0;0;.00nan;0;0
26396;78479;47;0;0;0;0;.00nan;0;0
26397;188888;51;39;34;6;28;.824;3244000;0
26397;176921;58;84;30;1;29;.967;3600000;0
26397;38124;58;0;0;0;0;.00nan;0;0
26397;86360;51;63;6;0;6;1.000;356000;0
26398;189639;54;50;29;4;25;.862;2557000;0
26398;201876;54;27;15;4;11;.733;1043000;0
26398;57215;50;0;0;0;0;.00nan;0;0
26398;141998;50;77;18;1;17;.944;3600000;0
26399;165744;43;60;19;2;17;.895;3600000;0
26399;194264;41;92;42;3;39;.929;3600000;0
26399;64811;43;0;0;0;0;.00nan;0;0
26399;75313;41;0;0;0;0;.00nan;0;0
26400;169323;53;0;0;0;0;.00nan;0;0
26400;173856;38;0;0;0;0;.00nan;0;0
26400;181102;38;76;41;3;38;.927;3512000;0
26400;91403;53;86;35;1;34;.971;3600000;0
26401;163565;40;0;0;0;0;.00nan;0;0
26401;190465;37;0;0;0;0;.00nan;0;0
26401;202161;37;52;14;1;13;.929;3900000;0
26401;185812;40;99;35;1;34;.971;3900000;0
26402;192733;61;86;31;1;30;.968;3600000;0
26402;-1;61;0;0;0;0;.00nan;0;0
26402;184610;49;67;40;4;36;.900;3600000;0
26402;79132;49;0;0;0;0;.00nan;0;0
26403;163195;59;14;16;6;10;.625;1856000;0
26403;169226;65;0;0;0;0;.00nan;0;0
26403;176938;65;85;33;2;31;.939;3600000;0
26403;186527;59;61;15;1;14;.933;1744000;0
26404;171970;55;73;37;3;34;.919;3900000;0
26404;194502;55;0;0;0;0;.00nan;0;0
26404;195089;36;0;0;0;0;.00nan;0;0
26404;187362;36;81;34;3;31;.912;3900000;0
26405;4622;64;86;26;1;25;.962;3600000;0
26405;184069;46;78;39;4;35;.897;3600000;0
26405;182049;46;0;0;0;0;.00nan;0;0
26405;58037;64;0;0;0;0;.00nan;0;0
26406;161535;52;0;0;0;0;.00nan;0;0
26406;199481;57;86;26;1;25;.962;3600000;0
26406;184081;52;55;40;6;34;.850;3600000;0
26406;152418;57;0;0;0;0;.00nan;0;0
26407;189644;42;33;27;6;21;.778;3600000;0
26407;176915;62;0;0;0;0;.00nan;0;0
26407;196372;62;81;32;2;30;.938;3600000;0
26407;149450;42;0;0;0;0;.00nan;0;0
26408;169323;53;0;0;0;0;.00nan;0;0
26408;176921;58;0;0;0;0;.00nan;0;0
26408;38124;58;100;39;0;39;1.000;3600000;0
26408;91403;53;79;30;1;29;.967;3600000;0
26409;187699;39;62;35;5;30;.857;3900000;0
26409;186549;45;0;0;0;0;.00nan;0;0
26409;197704;39;0;0;0;0;.00nan;0;0
26409;66491;45;59;35;5;30;.857;3900000;0
26410;171970;55;0;0;0;0;.00nan;0;0
26410;194502;55;89;38;2;36;.947;3517000;0
26410;195089;36;100;34;0;34;1.000;3600000;0
26410;187362;36;0;0;0;0;.00nan;0;0
26411;176200;44;0;0;0;0;.00nan;0;0
26411;179950;4837;0;0;0;0;.00nan;0;0
26411;187295;4837;86;28;1;27;.964;3600000;0
26411;64911;44;31;30;6;24;.800;3600000;0
26412;4622;64;0;0;0;0;.00nan;0;0
26412;189639;54;76;51;6;45;.882;3600000;0
26412;201876;54;0;0;0;0;.00nan;0;0
26412;58037;64;44;15;3;12;.800;3600000;0
26413;201673;4619;0;0;0;0;.00nan;0;0
26413;191026;48;71;43;6;37;.860;2809000;0
26413;78820;4619;57;12;1;11;.917;3600000;0
26413;142492;48;43;10;2;8;.800;791000;0
26414;184069;46;0;0;0;0;.00nan;0;0
26414;182049;46;65;25;2;23;.920;3600000;0
26414;186549;45;0;0;0;0;.00nan;0;0
26414;66491;45;78;28;3;25;.893;3565000;0
26415;199481;57;0;0;0;0;.00nan;0;0
26415;176921;58;0;0;0;0;.00nan;0;0
26415;38124;58;79;32;2;30;.938;3900000;0
26415;152418;57;60;25;2;23;.920;3891000;0
26416;169323;53;49;17;3;14;.824;3600000;0
26416;173856;38;94;50;4;46;.920;3600000;0
26416;181102;38;0;0;0;0;.00nan;0;0
26416;91403;53;0;0;0;0;.00nan;0;0
26417;192733;61;88;39;3;36;.923;3600000;0
26417;-1;61;0;0;0;0;.00nan;0;0
26417;84945;60;4;26;8;18;.692;3600000;0
26417;86862;60;0;0;0;0;.00nan;0;0
26418;169226;65;0;0;0;0;.00nan;0;0
26418;176938;65;56;35;5;30;.857;3600000;0
26418;181123;63;58;17;2;15;.882;3600000;0
26418;192457;63;0;0;0;0;.00nan;0;0
26419;161535;52;0;0;0;0;.00nan;0;0
26419;171970;55;71;15;0;15;1.000;1300000;0
26419;194502;55;13;21;6;15;.714;2300000;0
26419;184081;52;100;17;0;17;1.000;3600000;0
26420;188888;51;0;0;0;0;.00nan;0;0
26420;189081;56;0;0;0;0;.00nan;0;0
26420;57207;56;79;25;1;24;.960;3600000;0
26420;86360;51;88;38;2;36;.947;3550000;0
26421;163195;59;99;37;1;36;.973;3600000;0
26421;169323;53;0;0;0;0;.00nan;0;0
26421;186527;59;0;0;0;0;.00nan;0;0
26421;91403;53;36;32;5;27;.844;3600000;0
26422;188888;51;91;29;1;28;.966;3600000;0
26422;189081;56;65;25;2;23;.920;3570000;0
26422;57207;56;0;0;0;0;.00nan;0;0
26422;86360;51;0;0;0;0;.00nan;0;0
26423;184069;46;0;0;0;0;.00nan;0;0
26423;182049;46;97;22;0;22;1.000;3600000;0
26423;186549;45;0;0;0;0;.00nan;0;0
26423;66491;45;73;46;5;41;.891;3600000;0
26424;194264;41;79;22;1;21;.955;3569000;0
26424;181123;63;100;41;0;41;1.000;3600000;0
26424;192457;63;0;0;0;0;.00nan;0;0
26424;75313;41;0;0;0;0;.00nan;0;0
26425;165744;43;47;20;3;17;.850;3900000;0
26425;173856;38;83;38;3;35;.921;3900000;0
26425;181102;38;0;0;0;0;.00nan;0;0
26425;64811;43;0;0;0;0;.00nan;0;0
26426;189644;42;22;19;5;14;.737;2384000;0
26426;57215;50;0;0;0;0;.00nan;0;0
26426;141998;50;70;38;4;34;.895;3600000;0
26426;149450;42;58;8;0;8;1.000;1191000;0
26427;187699;39;87;32;1;31;.969;3600000;0
26427;199481;57;0;0;0;0;.00nan;0;0
26427;197704;39;0;0;0;0;.00nan;0;0
26427;152418;57;72;56;5;51;.911;3600000;0
26428;189639;54;63;33;4;29;.879;3565000;0
26428;201876;54;0;0;0;0;.00nan;0;0
26428;190465;37;0;0;0;0;.00nan;0;0
26428;202161;37;45;12;2;10;.833;3600000;0
26429;184610;49;0;0;0;0;.00nan;0;0
26429;176915;62;0;0;0;0;.00nan;0;0
26429;196372;62;58;27;3;24;.889;3549000;0
26429;79132;49;83;37;2;35;.946;3600000;0
26430;191026;48;87;40;2;38;.950;3900000;0
26430;186495;47;55;20;2;18;.900;3900000;0
26430;78479;47;0;0;0;0;.00nan;0;0
26430;142492;48;0;0;0;0;.00nan;0;0
26431;161535;52;0;0;0;0;.00nan;0;0
26431;184081;52;100;26;0;26;1.000;3900000;0
26431;195089;36;0;0;0;0;.00nan;0;0
26431;187362;36;94;40;0;40;1.000;3900000;0
26432;163195;59;0;0;0;0;.00nan;0;0
26432;169323;53;84;27;1;26;.963;3545000;0
26432;186527;59;94;24;0;24;1.000;3600000;0
26432;91403;53;0;0;0;0;.00nan;0;0
26433;4622;64;0;0;0;0;.00nan;0;0
26433;184069;46;0;0;0;0;.00nan;0;0
26433;182049;46;93;30;2;28;.933;3600000;0
26433;58037;64;60;22;3;19;.864;3553000;0
26434;176200;44;0;0;0;0;.00nan;0;0
26434;201673;4619;67;17;1;16;.941;3600000;0
26434;64911;44;87;64;6;58;.906;3600000;0
26434;78820;4619;0;0;0;0;.00nan;0;0
26435;165744;43;0;0;0;0;.00nan;0;0
26435;176921;58;25;6;3;3;.500;165000;0
26435;38124;58;90;48;3;45;.938;3435000;0
26435;64811;43;50;20;3;17;.850;3600000;0
26436;169226;65;0;0;0;0;.00nan;0;0
26436;173856;38;0;0;0;0;.00nan;0;0
26436;176938;65;76;32;2;30;.938;3600000;0
26436;181102;38;38;28;5;23;.821;3600000;0
26437;179950;4837;0;0;0;0;.00nan;0;0
26437;187295;4837;83;31;1;30;.968;3600000;0
26437;84945;60;0;0;0;0;.00nan;0;0
26437;86862;60;84;38;2;36;.947;3567000;0
26438;189639;54;0;0;0;0;.00nan;0;0
26438;201876;54;93;48;2;46;.958;3600000;0
26438;190465;37;0;0;0;0;.00nan;0;0
26438;202161;37;48;17;3;14;.824;3556000;0
26439;192733;61;76;44;4;40;.909;3600000;0
26439;163565;40;81;24;1;23;.958;3600000;0
26439;-1;61;0;0;0;0;.00nan;0;0
26439;185812;40;0;0;0;0;.00nan;0;0
26440;184610;49;77;26;1;25;.962;3600000;0
26440;176915;62;91;34;2;32;.941;3600000;0
26440;196372;62;0;0;0;0;.00nan;0;0
26440;79132;49;0;0;0;0;.00nan;0;0
26441;191026;48;0;0;0;0;.00nan;0;0
26441;186495;47;68;20;2;18;.900;3600000;0
26441;78479;47;0;0;0;0;.00nan;0;0
26441;142492;48;56;37;5;32;.865;3600000;0
26442;171970;55;0;0;0;0;.00nan;0;0
26442;194502;55;92;51;3;48;.941;3600000;0
26442;195089;36;82;19;0;19;1.000;3600000;0
26442;187362;36;0;0;0;0;.00nan;0;0
26443;161535;52;0;0;0;0;.00nan;0;0
26443;184081;52;41;30;5;25;.833;3600000;0
26443;181123;63;0;0;0;0;.00nan;0;0
26443;192457;63;75;37;3;34;.919;3600000;0
26444;4622;64;67;34;3;31;.912;3600000;0
26444;190465;37;70;27;2;25;.926;3600000;0
26444;202161;37;0;0;0;0;.00nan;0;0
26444;58037;64;0;0;0;0;.00nan;0;0
26445;201673;4619;61;7;0;7;1.000;844000;0
26445;179950;4837;56;27;4;23;.852;3600000;0
26445;187295;4837;0;0;0;0;.00nan;0;0
26445;78820;4619;36;26;6;20;.769;2756000;0
26446;187699;39;58;36;4;32;.889;3900000;0
26446;194264;41;64;32;4;28;.875;3900000;0
26446;197704;39;0;0;0;0;.00nan;0;0
26446;75313;41;0;0;0;0;.00nan;0;0
26447;169226;65;35;13;3;10;.769;1219000;0
26447;176921;58;100;25;0;25;1.000;3600000;0
26447;176938;65;16;20;6;14;.700;2381000;0
26447;38124;58;0;0;0;0;.00nan;0;0
26448;189644;42;0;0;0;0;.00nan;0;0
26448;57215;50;100;42;0;42;1.000;3600000;0
26448;141998;50;0;0;0;0;.00nan;0;0
26448;149450;42;63;23;2;21;.913;3530000;0
26449;171970;55;70;40;4;36;.900;3600000;0
26449;199481;57;0;0;0;0;.00nan;0;0
26449;194502;55;0;0;0;0;.00nan;0;0
26449;152418;57;70;20;1;19;.950;3600000;0
26450;4622;64;0;0;0;0;.00nan;0;0
26450;189644;42;93;32;1;31;.969;3600000;0
26450;58037;64;83;36;3;33;.917;3543000;0
26450;149450;42;0;0;0;0;.00nan;0;0
26451;184069;46;64;36;4;32;.889;3600000;0
26451;182049;46;0;0;0;0;.00nan;0;0
26451;186549;45;78;28;2;26;.929;3600000;0
26451;66491;45;0;0;0;0;.00nan;0;0
26452;191026;48;100;31;0;31;1.000;3600000;0
26452;84945;60;0;0;0;0;.00nan;0;0
26452;86862;60;44;31;5;26;.839;3600000;0
26452;142492;48;0;0;0;0;.00nan;0;0
26453;176200;44;0;0;0;0;.00nan;0;0
26453;176915;62;0;0;0;0;.00nan;0;0
26453;196372;62;100;22;0;22;1.000;3600000;0
26453;64911;44;96;48;2;46;.958;3571000;0
26454;192733;61;0;0;0;0;.00nan;0;0
26454;-1;61;69;37;4;33;.892;3600000;0
26454;201673;4619;26;22;5;17;.773;3571000;0
26454;78820;4619;0;0;0;0;.00nan;0;0
26455;189639;54;61;44;5;39;.886;3600000;0
26455;201876;54;0;0;0;0;.00nan;0;0
26455;57215;50;84;12;0;12;1.000;3600000;0
26455;141998;50;0;0;0;0;.00nan;0;0
26456;188888;51;72;31;2;29;.935;3600000;0
26456;181123;63;84;30;1;29;.967;3600000;0
26456;192457;63;0;0;0;0;.00nan;0;0
26456;86360;51;0;0;0;0;.00nan;0;0
26457;163565;40;62;40;4;36;.900;3600000;0
26457;190465;37;0;0;0;0;.00nan;0;0
26457;202161;37;100;18;0;18;1.000;3600000;0
26457;185812;40;0;0;0;0;.00nan;0;0
26458;184610;49;0;0;0;0;.00nan;0;0
26458;186495;47;67;26;3;23;.885;3564000;0
26458;78479;47;0;0;0;0;.00nan;0;0
26458;79132;49;80;32;2;30;.938;3600000;0
26459;171970;55;0;0;0;0;.00nan;0;0
26459;165744;43;71;23;2;21;.913;3600000;0
26459;194502;55;87;57;5;52;.912;3600000;0
26459;64811;43;0;0;0;0;.00nan;0;0
26460;184069;46;0;0;0;0;.00nan;0;0
26460;182049;46;91;33;2;31;.939;3600000;0
26460;186549;45;0;0;0;0;.00nan;0;0
26460;66491;45;78;39;4;35;.897;3600000;0
26461;187699;39;0;0;0;0;.00nan;0;0
26461;199481;57;0;0;0;0;.00nan;0;0
26461;197704;39;88;43;2;41;.953;3600000;0
26461;152418;57;63;28;3;25;.893;3556000;0
26462;191026;48;98;53;3;50;.943;3600000;0
26462;84945;60;53;16;2;14;.875;3600000;0
26462;86862;60;0;0;0;0;.00nan;0;0
26462;142492;48;0;0;0;0;.00nan;0;0
26463;161535;52;0;0;0;0;.00nan;0;0
26463;189081;56;0;0;0;0;.00nan;0;0
26463;184081;52;60;33;4;29;.879;3600000;0
26463;57207;56;100;35;0;35;1.000;3600000;0
26464;169323;53;0;0;0;0;.00nan;0;0
26464;173856;38;88;43;3;40;.930;3514000;0
26464;181102;38;0;0;0;0;.00nan;0;0
26464;91403;53;67;18;1;17;.944;3600000;0
26465;176200;44;0;0;0;0;.00nan;0;0
26465;186495;47;89;30;1;29;.967;3600000;0
26465;64911;44;83;33;2;31;.939;3583000;0
26465;78479;47;0;0;0;0;.00nan;0;0
26466;187699;39;54;20;3;17;.850;3900000;0
26466;189081;56;0;0;0;0;.00nan;0;0
26466;197704;39;0;0;0;0;.00nan;0;0
26466;57207;56;62;30;3;27;.900;3900000;0
26467;169323;53;48;32;5;27;.844;3600000;0
26467;173856;38;0;0;0;0;.00nan;0;0
26467;181102;38;74;50;6;44;.880;3591000;0
26467;91403;53;0;0;0;0;.00nan;0;0
26468;176915;62;0;0;0;0;.00nan;0;0
26468;179950;4837;0;0;0;0;.00nan;0;0
26468;196372;62;89;35;1;34;.971;3600000;0
26468;187295;4837;72;30;3;27;.900;3533000;0
26469;163195;59;69;22;1;21;.955;3600000;0
26469;194264;41;55;48;6;42;.875;3600000;0
26469;186527;59;0;0;0;0;.00nan;0;0
26469;75313;41;0;0;0;0;.00nan;0;0
26470;192733;61;68;25;2;23;.920;3551000;0
26470;-1;61;0;0;0;0;.00nan;0;0
26470;184610;49;0;0;0;0;.00nan;0;0
26470;79132;49;95;36;1;35;.972;3600000;0
26471;189639;54;81;53;5;48;.906;3600000;0
26471;189644;42;42;10;2;8;.800;3600000;0
26471;201876;54;0;0;0;0;.00nan;0;0
26471;149450;42;0;0;0;0;.00nan;0;0
26472;161535;52;28;26;6;20;.769;3140000;0
26472;165744;43;77;27;2;25;.926;3600000;0
26472;184081;52;46;7;1;6;.857;460000;0
26472;64811;43;0;0;0;0;.00nan;0;0
26473;4622;64;49;1;0;1;1.000;279000;0
26473;57215;50;68;38;4;34;.895;3600000;0
26473;58037;64;36;33;6;27;.818;3237000;0
26473;141998;50;0;0;0;0;.00nan;0;0
26474;199481;57;0;0;0;0;.00nan;0;0
26474;181123;63;67;20;2;18;.900;3900000;0
26474;192457;63;0;0;0;0;.00nan;0;0
26474;152418;57;84;43;2;41;.953;3900000;0
26475;163565;40;90;34;2;32;.941;3562000;0
26475;190465;37;0;0;0;0;.00nan;0;0
26475;202161;37;67;19;1;18;.947;3600000;0
26475;185812;40;0;0;0;0;.00nan;0;0
26476;169226;65;0;0;0;0;.00nan;0;0
26476;176921;58;35;19;4;15;.789;3600000;0
26476;176938;65;95;34;1;33;.971;3600000;0
26476;38124;58;0;0;0;0;.00nan;0;0
26477;171970;55;62;21;2;19;.905;1677000;0
26477;188888;51;0;0;0;0;.00nan;0;0
26477;194502;55;38;22;5;17;.773;1923000;0
26477;86360;51;70;20;1;19;.950;3600000;0
26478;4622;64;58;32;4;28;.875;3600000;0
26478;57215;50;0;0;0;0;.00nan;0;0
26478;58037;64;0;0;0;0;.00nan;0;0
26478;141998;50;81;24;1;23;.958;3600000;0
26479;176200;44;0;0;0;0;.00nan;0;0
26479;201673;4619;100;26;0;26;1.000;3600000;0
26479;64911;44;81;36;2;34;.944;3522000;0
26479;78820;4619;0;0;0;0;.00nan;0;0
26480;176915;62;49;28;4;24;.857;3600000;0
26480;179950;4837;73;30;2;28;.933;3600000;0
26480;196372;62;0;0;0;0;.00nan;0;0
26480;187295;4837;0;0;0;0;.00nan;0;0
26481;192733;61;0;0;0;0;.00nan;0;0
26481;-1;61;99;35;1;34;.971;3600000;0
26481;184610;49;26;9;3;6;.667;597000;0
26481;79132;49;98;43;1;42;.977;3003000;0
26482;199481;57;54;31;4;27;.871;3600000;0
26482;176921;58;0;0;0;0;.00nan;0;0
26482;38124;58;100;37;0;37;1.000;3600000;0
26482;152418;57;0;0;0;0;.00nan;0;0
26483;189639;54;0;0;0;0;.00nan;0;0
26483;189644;42;0;0;0;0;.00nan;0;0
26483;201876;54;71;31;3;28;.903;3525000;0
26483;149450;42;94;30;1;29;.967;3600000;0
26484;163565;40;0;0;0;0;.00nan;0;0
26484;185812;40;65;21;1;20;.952;3900000;0
26484;186495;47;90;31;1;30;.968;3900000;0
26484;78479;47;0;0;0;0;.00nan;0;0
26485;163195;59;0;0;0;0;.00nan;0;0
26485;169226;65;98;55;4;51;.927;3600000;0
26485;176938;65;0;0;0;0;.00nan;0;0
26485;186527;59;49;17;2;15;.882;3600000;0
26486;171970;55;0;0;0;0;.00nan;0;0
26486;194502;55;98;47;1;46;.979;3558000;0
26486;181123;63;0;0;0;0;.00nan;0;0
26486;192457;63;71;6;0;6;1.000;3600000;0
26487;188888;51;89;44;3;41;.932;3600000;0
26487;195089;36;0;0;0;0;.00nan;0;0
26487;187362;36;58;16;2;14;.875;3600000;0
26487;86360;51;0;0;0;0;.00nan;0;0
26488;13337;39;0;0;0;0;.00nan;0;0
26488;189081;56;0;0;0;0;.00nan;0;0
26488;197704;39;74;25;2;23;.920;3600000;0
26488;57207;56;55;42;5;37;.881;3600000;0
26489;192733;61;100;33;0;33;1.000;3600000;0
26489;-1;61;0;0;0;0;.00nan;0;0
26489;176200;44;0;0;0;0;.00nan;0;0
26489;64911;44;93;42;2;40;.952;3549000;0
26490;163195;59;57;27;3;24;.889;3600000;0
26490;199481;57;0;0;0;0;.00nan;0;0
26490;186527;59;0;0;0;0;.00nan;0;0
26490;152418;57;71;50;6;44;.880;3600000;0
26491;13337;39;77;33;3;30;.909;3900000;0
26491;188888;51;0;0;0;0;.00nan;0;0
26491;197704;39;0;0;0;0;.00nan;0;0
26491;86360;51;74;41;3;38;.927;3900000;0
26492;163565;40;74;43;3;40;.930;3588000;0
26492;201673;4619;82;32;2;30;.938;3600000;0
26492;185812;40;0;0;0;0;.00nan;0;0
26492;78820;4619;0;0;0;0;.00nan;0;0
26493;161535;52;0;0;0;0;.00nan;0;0
26493;184081;52;68;35;4;31;.886;3900000;0
26493;176921;58;0;0;0;0;.00nan;0;0
26493;38124;58;56;35;4;31;.886;3900000;0
26494;173856;38;62;31;4;27;.871;3900000;0
26494;195089;36;0;0;0;0;.00nan;0;0
26494;181102;38;0;0;0;0;.00nan;0;0
26494;187362;36;79;41;4;37;.902;3900000;0
26495;4622;64;69;48;5;43;.896;3600000;0
26495;57215;50;91;28;1;27;.964;3600000;0
26495;58037;64;0;0;0;0;.00nan;0;0
26495;141998;50;0;0;0;0;.00nan;0;0
26496;171970;55;0;0;0;0;.00nan;0;0
26496;194502;55;78;44;4;40;.909;3600000;0
26496;181123;63;87;23;1;22;.957;3600000;0
26496;192457;63;0;0;0;0;.00nan;0;0
26497;190465;37;0;0;0;0;.00nan;0;0
26497;202161;37;70;30;3;27;.900;3600000;0
26497;186549;45;59;40;6;34;.850;3600000;0
26497;66491;45;0;0;0;0;.00nan;0;0
26498;194264;41;76;27;2;25;.926;3600000;0
26498;169226;65;0;0;0;0;.00nan;0;0
26498;176938;65;65;27;3;24;.889;3600000;0
26498;75313;41;0;0;0;0;.00nan;0;0
26499;165744;43;0;0;0;0;.00nan;0;0
26499;189081;56;49;50;8;42;.840;3261000;0
26499;57207;56;51;10;1;9;.900;339000;0
26499;64811;43;100;23;0;23;1.000;3600000;0
26500;176915;62;0;0;0;0;.00nan;0;0
26500;196372;62;71;29;2;27;.931;3600000;0
26500;191026;48;76;34;3;31;.912;3600000;0
26500;142492;48;0;0;0;0;.00nan;0;0
26501;189639;54;88;42;3;39;.929;3600000;0
26501;179950;4837;0;0;0;0;.00nan;0;0
26501;201876;54;0;0;0;0;.00nan;0;0
26501;187295;4837;98;25;0;25;1.000;3600000;0
26502;163565;40;0;0;0;0;.00nan;0;0
26502;185812;40;45;26;4;22;.846;3600000;0
26502;84945;60;0;0;0;0;.00nan;0;0
26502;86862;60;75;22;1;21;.955;3600000;0
26503;184610;49;0;0;0;0;.00nan;0;0
26503;176200;44;0;0;0;0;.00nan;0;0
26503;64911;44;93;42;3;39;.929;3585000;0
26503;79132;49;83;29;1;28;.966;3600000;0
26504;176915;62;83;27;1;26;.963;3600000;0
26504;196372;62;0;0;0;0;.00nan;0;0
26504;191026;48;0;0;0;0;.00nan;0;0
26504;142492;48;64;45;5;40;.889;3600000;0
26505;4622;64;0;0;0;0;.00nan;0;0
26505;186549;45;0;0;0;0;.00nan;0;0
26505;58037;64;65;36;4;32;.889;3900000;0
26505;66491;45;62;35;4;31;.886;3900000;0
26506;171970;55;0;0;0;0;.00nan;0;0
26506;165744;43;69;5;0;5;1.000;3600000;0
26506;194502;55;83;57;5;52;.912;3600000;0
26506;64811;43;0;0;0;0;.00nan;0;0
26507;184069;46;0;0;0;0;.00nan;0;0
26507;189644;42;52;21;3;18;.857;3600000;0
26507;182049;46;60;41;5;36;.878;3543000;0
26507;149450;42;0;0;0;0;.00nan;0;0
26508;176921;58;60;49;7;42;.857;3600000;0
26508;181123;63;80;28;1;27;.964;3600000;0
26508;38124;58;0;0;0;0;.00nan;0;0
26508;192457;63;0;0;0;0;.00nan;0;0
26509;163195;59;64;16;1;15;.938;3600000;0
26509;169226;65;0;0;0;0;.00nan;0;0
26509;176938;65;98;63;3;60;.952;3600000;0
26509;186527;59;0;0;0;0;.00nan;0;0
26510;187699;47;0;0;0;0;.00nan;0;0
26510;201673;4619;68;28;2;26;.929;3600000;0
26510;186495;47;79;40;4;36;.900;3532000;0
26510;78820;4619;0;0;0;0;.00nan;0;0
26511;199481;57;0;0;0;0;.00nan;0;0
26511;195089;36;0;0;0;0;.00nan;0;0
26511;187362;36;75;40;3;37;.925;3600000;0
26511;152418;57;44;34;5;29;.853;3539000;0
26512;161535;52;0;0;0;0;.00nan;0;0
26512;184081;52;70;33;3;30;.909;3600000;0
26512;169323;53;0;0;0;0;.00nan;0;0
26512;91403;53;60;35;4;31;.886;3600000;0
26513;4622;64;61;19;2;17;.895;3517000;0
26513;188888;51;0;0;0;0;.00nan;0;0
26513;58037;64;0;0;0;0;.00nan;0;0
26513;86360;51;100;30;0;30;1.000;3600000;0
26514;163195;59;0;0;0;0;.00nan;0;0
26514;194264;41;48;42;6;36;.857;3600000;0
26514;186527;59;76;20;1;19;.950;3600000;0
26514;75313;41;0;0;0;0;.00nan;0;0
26515;192733;61;79;38;4;34;.895;3571000;0
26515;-1;61;0;0;0;0;.00nan;0;0
26515;84945;60;0;0;0;0;.00nan;0;0
26515;86862;60;60;26;3;23;.885;3600000;0
26516;189639;54;0;0;0;0;.00nan;0;0
26516;179950;4837;0;0;0;0;.00nan;0;0
26516;201876;54;95;47;3;44;.936;3600000;0
26516;187295;4837;100;30;0;30;1.000;3600000;0
26517;171970;55;54;43;6;37;.860;2757000;0
26517;165744;43;0;0;0;0;.00nan;0;0
26517;194502;55;49;16;2;14;.875;843000;0
26517;64811;43;81;13;0;13;1.000;3600000;0
26518;173856;38;72;21;2;19;.905;3600000;0
26518;176921;58;0;0;0;0;.00nan;0;0
26518;181102;38;0;0;0;0;.00nan;0;0
26518;38124;58;88;49;4;45;.918;3600000;0
26519;190465;37;0;0;0;0;.00nan;0;0
26519;202161;37;97;46;3;43;.935;3900000;0
26519;57215;50;68;34;3;31;.912;3900000;0
26519;141998;50;0;0;0;0;.00nan;0;0
26520;184610;49;61;34;4;30;.882;3600000;0
26520;176200;44;95;40;1;39;.975;3600000;0
26520;64911;44;0;0;0;0;.00nan;0;0
26520;79132;49;0;0;0;0;.00nan;0;0
26521;199481;57;0;0;0;0;.00nan;0;0
26521;169226;65;69;32;3;29;.906;3515000;0
26521;176938;65;0;0;0;0;.00nan;0;0
26521;152418;57;88;32;1;31;.969;3600000;0
26522;13337;39;78;45;4;41;.911;3600000;0
26522;189081;56;0;0;0;0;.00nan;0;0
26522;197704;39;0;0;0;0;.00nan;0;0
26522;57207;56;63;23;3;20;.870;3600000;0
26523;187699;47;75;35;3;32;.914;3600000;0
26523;163565;40;64;41;5;36;.878;3586000;0
26523;185812;40;0;0;0;0;.00nan;0;0
26523;186495;47;0;0;0;0;.00nan;0;0
26524;195089;36;67;30;2;28;.933;3549000;0
26524;181123;63;0;0;0;0;.00nan;0;0
26524;187362;36;0;0;0;0;.00nan;0;0
26524;192457;63;99;34;1;33;.971;3600000;0
26525;161535;52;100;27;0;27;1.000;3600000;0
26525;184081;52;0;0;0;0;.00nan;0;0
26525;169323;53;72;31;3;28;.903;3600000;0
26525;91403;53;0;0;0;0;.00nan;0;0
26526;188888;51;0;0;0;0;.00nan;0;0
26526;186549;45;93;36;3;33;.917;3900000;0
26526;66491;45;0;0;0;0;.00nan;0;0
26526;86360;51;57;28;3;25;.893;3900000;0
26527;169323;53;0;0;0;0;.00nan;0;0
26527;173856;38;0;0;0;0;.00nan;0;0
26527;181102;38;83;35;3;32;.914;3600000;0
26527;91403;53;61;14;1;13;.929;3600000;0
26528;184069;46;0;0;0;0;.00nan;0;0
26528;189644;42;53;29;4;25;.862;3600000;0
26528;182049;46;86;26;1;25;.962;3600000;0
26528;149450;42;0;0;0;0;.00nan;0;0
26529;192733;61;0;0;0;0;.00nan;0;0
26529;-1;61;80;38;3;35;.921;3600000;0
26529;84945;60;88;32;1;31;.969;3600000;0
26529;86862;60;0;0;0;0;.00nan;0;0
26530;190465;37;96;28;1;27;.964;3900000;0
26530;202161;37;0;0;0;0;.00nan;0;0
26530;57215;50;0;0;0;0;.00nan;0;0
26530;141998;50;90;27;1;26;.963;3900000;0
26531;176915;62;0;0;0;0;.00nan;0;0
26531;201673;4619;56;26;3;23;.885;3600000;0
26531;196372;62;47;38;5;33;.868;3574000;0
26531;78820;4619;0;0;0;0;.00nan;0;0
26532;176915;62;68;26;2;24;.923;3600000;0
26532;201673;4619;0;0;0;0;.00nan;0;0
26532;196372;62;0;0;0;0;.00nan;0;0
26532;78820;4619;57;43;5;38;.884;3600000;0
26533;4622;64;0;0;0;0;.00nan;0;0
26533;184069;46;42;4;1;3;.750;289000;0
26533;182049;46;33;37;6;31;.838;3311000;0
26533;58037;64;43;18;3;15;.833;3600000;0
26534;176200;44;0;0;0;0;.00nan;0;0
26534;191026;48;96;29;1;28;.966;3600000;0
26534;64911;44;75;35;3;32;.914;3600000;0
26534;142492;48;0;0;0;0;.00nan;0;0
26535;192733;61;44;31;5;26;.839;3600000;0
26535;163565;40;50;26;4;22;.846;3600000;0
26535;-1;61;0;0;0;0;.00nan;0;0
26535;185812;40;0;0;0;0;.00nan;0;0
26536;169323;53;0;0;0;0;.00nan;0;0
26536;176921;58;89;42;2;40;.952;3900000;0
26536;38124;58;0;0;0;0;.00nan;0;0
26536;91403;53;76;20;2;18;.900;3900000;0
26537;187699;47;0;0;0;0;.00nan;0;0
26537;184610;49;0;0;0;0;.00nan;0;0
26537;186495;47;80;35;3;32;.914;3556000;0
26537;79132;49;92;30;1;29;.967;3600000;0
26538;13337;39;64;17;1;16;.941;3600000;0
26538;188888;51;0;0;0;0;.00nan;0;0
26538;197704;39;0;0;0;0;.00nan;0;0
26538;86360;51;67;37;4;33;.892;3600000;0
26539;163195;59;89;19;0;19;1.000;3600000;0
26539;194264;41;0;0;0;0;.00nan;0;0
26539;186527;59;0;0;0;0;.00nan;0;0
26539;75313;41;34;38;7;31;.816;3600000;0
26540;192733;61;66;27;3;24;.889;3564000;0
26540;-1;61;0;0;0;0;.00nan;0;0
26540;176915;62;0;0;0;0;.00nan;0;0
26540;196372;62;74;36;2;34;.944;3600000;0
26541;187699;47;55;19;2;17;.895;3600000;0
26541;4622;64;0;0;0;0;.00nan;0;0
26541;186495;47;0;0;0;0;.00nan;0;0
26541;58037;64;65;39;4;35;.897;3545000;0
26542;189639;54;100;35;0;35;1.000;3600000;0
26542;201876;54;0;0;0;0;.00nan;0;0
26542;186549;45;0;0;0;0;.00nan;0;0
26542;66491;45;55;23;3;20;.870;3600000;0
26543;179950;4837;0;0;0;0;.00nan;0;0
26543;187295;4837;75;50;5;45;.900;3600000;0
26543;57215;50;75;32;2;30;.938;3600000;0
26543;141998;50;0;0;0;0;.00nan;0;0
26544;184610;49;0;0;0;0;.00nan;0;0
26544;79132;49;100;28;0;28;1.000;3600000;0
26544;84945;60;0;0;0;0;.00nan;0;0
26544;86862;60;61;29;2;27;.931;3600000;0
26545;188888;51;57;22;2;20;.909;1697000;0
26545;181123;63;59;30;4;26;.867;3600000;0
26545;192457;63;0;0;0;0;.00nan;0;0
26545;86360;51;13;20;6;14;.700;1903000;0
26546;163565;40;67;25;2;23;.920;3543000;0
26546;176200;44;0;0;0;0;.00nan;0;0
26546;185812;40;0;0;0;0;.00nan;0;0
26546;64911;44;100;42;1;41;.976;3600000;0
26547;161535;52;50;21;3;18;.857;3600000;0
26547;184081;52;0;0;0;0;.00nan;0;0
26547;169226;65;0;0;0;0;.00nan;0;0
26547;176938;65;70;42;5;37;.881;3545000;0
26548;184069;46;71;57;6;51;.895;3600000;0
26548;190465;37;0;0;0;0;.00nan;0;0
26548;202161;37;83;17;0;17;1.000;3600000;0
26548;182049;46;0;0;0;0;.00nan;0;0
26549;165744;43;55;22;3;19;.864;3600000;0
26549;195089;36;83;24;0;24;1.000;1204000;0
26549;187362;36;36;32;6;26;.813;2396000;0
26549;64811;43;0;0;0;0;.00nan;0;0
26550;163195;59;75;20;1;19;.950;3600000;0
26550;169323;53;0;0;0;0;.00nan;0;0
26550;186527;59;0;0;0;0;.00nan;0;0
26550;91403;53;59;45;5;40;.889;3600000;0
26551;192733;61;0;0;0;0;.00nan;0;0
26551;-1;61;68;35;3;32;.914;3600000;0
26551;176915;62;90;16;0;16;1.000;3600000;0
26551;196372;62;0;0;0;0;.00nan;0;0
26552;187699;47;0;0;0;0;.00nan;0;0
26552;4622;64;87;29;1;28;.966;3600000;0
26552;186495;47;69;34;3;31;.912;3547000;0
26552;58037;64;0;0;0;0;.00nan;0;0
26553;188888;51;63;30;3;27;.900;3587000;0
26553;181123;63;75;22;1;21;.955;3600000;0
26553;192457;63;0;0;0;0;.00nan;0;0
26553;86360;51;0;0;0;0;.00nan;0;0
26554;201673;4619;73;37;2;35;.946;3900000;0
26554;191026;48;0;0;0;0;.00nan;0;0
26554;78820;4619;0;0;0;0;.00nan;0;0
26554;142492;48;100;44;2;42;.955;3900000;0
26555;194264;41;47;36;5;31;.861;3588000;0
26555;176921;58;0;0;0;0;.00nan;0;0
26555;38124;58;55;28;4;24;.857;3600000;0
26555;75313;41;0;0;0;0;.00nan;0;0
26556;189639;54;55;29;4;25;.862;3900000;0
26556;201876;54;0;0;0;0;.00nan;0;0
26556;186549;45;69;40;4;36;.900;3900000;0
26556;66491;45;0;0;0;0;.00nan;0;0
26557;189081;56;0;0;0;0;.00nan;0;0
26557;189644;42;27;29;6;23;.793;3600000;0
26557;57207;56;96;40;2;38;.950;3600000;0
26557;149450;42;0;0;0;0;.00nan;0;0
26558;179950;4837;75;32;3;29;.906;3548000;0
26558;187295;4837;0;0;0;0;.00nan;0;0
26558;57215;50;0;0;0;0;.00nan;0;0
26558;141998;50;84;33;2;31;.939;3600000;0
26559;184610;49;0;0;0;0;.00nan;0;0
26559;79132;49;71;28;2;26;.929;3595000;0
26559;84945;60;74;23;1;22;.957;3600000;0
26559;86862;60;0;0;0;0;.00nan;0;0
26560;163565;40;0;0;0;0;.00nan;0;0
26560;176200;44;0;0;0;0;.00nan;0;0
26560;185812;40;78;22;1;21;.955;3600000;0
26560;64911;44;70;42;4;38;.905;3600000;0
26561;199481;57;0;0;0;0;.00nan;0;0
26561;169226;65;97;30;0;30;1.000;3900000;0
26561;176938;65;0;0;0;0;.00nan;0;0
26561;152418;57;96;19;0;19;1.000;3900000;0
26562;184069;46;0;0;0;0;.00nan;0;0
26562;190465;37;93;23;0;23;1.000;3600000;0
26562;202161;37;0;0;0;0;.00nan;0;0
26562;182049;46;61;30;3;27;.900;3600000;0
26563;171970;55;0;0;0;0;.00nan;0;0
26563;13337;39;85;23;1;22;.957;3600000;0
26563;194502;55;92;40;2;38;.950;3556000;0
26563;197704;39;0;0;0;0;.00nan;0;0
26564;161535;52;0;0;0;0;.00nan;0;0
26564;184081;52;69;33;3;30;.909;3600000;0
26564;173856;38;49;27;5;22;.815;3571000;0
26564;181102;38;0;0;0;0;.00nan;0;0
26565;163195;59;0;0;0;0;.00nan;0;0
26565;169323;53;95;53;3;50;.943;3900000;0
26565;186527;59;42;23;3;20;.870;3900000;0
26565;91403;53;0;0;0;0;.00nan;0;0
26566;201673;4619;0;0;0;0;.00nan;0;0
26566;191026;48;68;30;3;27;.900;3600000;0
26566;78820;4619;100;23;0;23;1.000;3600000;0
26566;142492;48;0;0;0;0;.00nan;0;0
26567;173856;38;0;0;0;0;.00nan;0;0
26567;176921;58;58;22;2;20;.909;3600000;0
26567;181102;38;57;37;4;33;.892;3516000;0
26567;38124;58;0;0;0;0;.00nan;0;0
26568;189081;56;86;44;3;41;.932;3591000;0
26568;189644;42;0;0;0;0;.00nan;0;0
26568;57207;56;0;0;0;0;.00nan;0;0
26568;149450;42;75;20;1;19;.950;3600000;0
26569;199481;57;0;0;0;0;.00nan;0;0
26569;169226;65;0;0;0;0;.00nan;0;0
26569;176938;65;70;26;3;23;.885;3598000;0
26569;152418;57;100;43;2;41;.953;3600000;0
26570;171970;55;50;47;6;41;.872;3600000;0
26570;13337;39;86;13;0;13;1.000;3600000;0
26570;194502;55;0;0;0;0;.00nan;0;0
26570;197704;39;0;0;0;0;.00nan;0;0
26571;165744;43;73;19;1;18;.947;3600000;0
26571;195089;36;0;0;0;0;.00nan;0;0
26571;187362;36;98;65;4;61;.938;3600000;0
26571;64811;43;0;0;0;0;.00nan;0;0
26572;161535;52;49;31;4;27;.871;3567000;0
26572;194264;41;0;0;0;0;.00nan;0;0
26572;184081;52;0;0;0;0;.00nan;0;0
26572;75313;41;86;33;2;31;.939;3600000;0
26573;184610;49;0;0;0;0;.00nan;0;0
26573;79132;49;72;36;3;33;.917;3563000;0
26573;84945;60;96;36;1;35;.972;3600000;0
26573;86862;60;0;0;0;0;.00nan;0;0
26574;189081;56;0;0;0;0;.00nan;0;0
26574;189644;42;84;27;1;26;.963;3600000;0
26574;57207;56;61;35;4;31;.886;3600000;0
26574;149450;42;0;0;0;0;.00nan;0;0
26575;163195;59;50;17;2;15;.882;3600000;0
26575;169226;65;0;0;0;0;.00nan;0;0
26575;176938;65;76;48;5;43;.896;3600000;0
26575;186527;59;0;0;0;0;.00nan;0;0
26576;186549;45;0;0;0;0;.00nan;0;0
26576;57215;50;72;17;1;16;.941;3600000;0
26576;66491;45;89;49;4;45;.918;3600000;0
26576;141998;50;0;0;0;0;.00nan;0;0
26577;165744;43;0;0;0;0;.00nan;0;0
26577;195089;36;0;0;0;0;.00nan;0;0
26577;187362;36;98;66;6;60;.909;3600000;0
26577;64811;43;55;12;2;10;.833;3600000;0
26578;163565;40;92;26;1;25;.962;3600000;0
26578;201673;4619;0;0;0;0;.00nan;0;0
26578;185812;40;0;0;0;0;.00nan;0;0
26578;78820;4619;45;23;4;19;.826;3600000;0
26579;176915;62;72;27;2;25;.926;3600000;0
26579;196372;62;0;0;0;0;.00nan;0;0
26579;84945;60;72;30;3;27;.900;3549000;0
26579;86862;60;0;0;0;0;.00nan;0;0
26580;187699;47;0;0;0;0;.00nan;0;0
26580;191026;48;0;0;0;0;.00nan;0;0
26580;186495;47;97;26;1;25;.962;3600000;0
26580;142492;48;64;29;3;26;.897;3575000;0
26581;176915;62;0;0;0;0;.00nan;0;0
26581;196372;62;100;26;0;26;1.000;3600000;0
26581;84945;60;0;0;0;0;.00nan;0;0
26581;86862;60;74;26;2;24;.923;3543000;0
26582;169323;53;0;0;0;0;.00nan;0;0
26582;181123;63;95;28;1;27;.964;3600000;0
26582;192457;63;0;0;0;0;.00nan;0;0
26582;91403;53;42;38;6;32;.842;3600000;0
26583;201673;4619;0;0;0;0;.00nan;0;0
26583;179950;4837;0;0;0;0;.00nan;0;0
26583;187295;4837;62;23;3;20;.870;3704000;0
26583;78820;4619;97;40;2;38;.950;3704000;0
26584;190465;37;0;0;0;0;.00nan;0;0
26584;202161;37;84;26;1;25;.962;3600000;0
26584;186549;45;44;38;6;32;.842;3600000;0
26584;66491;45;0;0;0;0;.00nan;0;0
26585;192733;61;75;48;5;43;.896;3600000;0
26585;-1;61;0;0;0;0;.00nan;0;0
26585;57215;50;0;0;0;0;.00nan;0;0
26585;141998;50;68;19;1;18;.947;3600000;0
26586;165744;43;0;0;0;0;.00nan;0;0
26586;189644;42;64;44;4;40;.909;3600000;0
26586;64811;43;83;20;1;19;.950;3600000;0
26586;149450;42;0;0;0;0;.00nan;0;0
26587;194264;41;76;26;2;24;.923;3900000;0
26587;173856;38;85;30;2;28;.933;3900000;0
26587;181102;38;0;0;0;0;.00nan;0;0
26587;75313;41;0;0;0;0;.00nan;0;0
26588;161535;52;0;0;0;0;.00nan;0;0
26588;199481;57;80;43;3;40;.930;3011000;0
26588;184081;52;68;23;2;21;.913;3600000;0
26588;152418;57;25;7;3;4;.571;589000;0
26589;163565;40;60;17;1;16;.941;3600000;0
26589;189639;54;88;42;2;40;.952;3562000;0
26589;201876;54;0;0;0;0;.00nan;0;0
26589;185812;40;0;0;0;0;.00nan;0;0
26590;184610;49;0;0;0;0;.00nan;0;0
26590;176200;44;0;0;0;0;.00nan;0;0
26590;64911;44;57;29;4;25;.862;3566000;0
26590;79132;49;100;41;2;39;.951;3600000;0
26591;171970;55;0;0;0;0;.00nan;0;0
26591;194502;55;68;32;4;28;.875;3600000;0
26591;169226;65;0;0;0;0;.00nan;0;0
26591;176938;65;43;29;6;23;.793;3600000;0
26592;13337;39;46;38;6;32;.842;3600000;0
26592;189081;56;0;0;0;0;.00nan;0;0
26592;197704;39;0;0;0;0;.00nan;0;0
26592;57207;56;93;42;3;39;.929;3600000;0
26593;188888;51;68;37;4;33;.892;3600000;0
26593;195089;36;0;0;0;0;.00nan;0;0
26593;187362;36;44;31;5;26;.839;3568000;0
26593;86360;51;0;0;0;0;.00nan;0;0
26594;187699;47;52;22;3;19;.864;3600000;0
26594;191026;48;80;48;4;44;.917;3600000;0
26594;186495;47;0;0;0;0;.00nan;0;0
26594;142492;48;0;0;0;0;.00nan;0;0
26595;184610;49;0;0;0;0;.00nan;0;0
26595;176200;44;59;30;3;27;.900;3600000;0
26595;64911;44;0;0;0;0;.00nan;0;0
26595;79132;49;100;22;0;22;1.000;3600000;0
26596;161535;52;66;46;5;41;.891;3600000;0
26596;163195;59;82;16;0;16;1.000;3600000;0
26596;184081;52;0;0;0;0;.00nan;0;0
26596;186527;59;0;0;0;0;.00nan;0;0
26597;169323;53;0;0;0;0;.00nan;0;0
26597;181123;63;97;34;2;32;.941;3600000;0
26597;192457;63;0;0;0;0;.00nan;0;0
26597;91403;53;64;24;3;21;.875;3560000;0
26598;201673;4619;83;38;3;35;.921;3566000;0
26598;179950;4837;74;28;2;26;.929;3600000;0
26598;187295;4837;0;0;0;0;.00nan;0;0
26598;78820;4619;0;0;0;0;.00nan;0;0
26599;190465;37;56;12;1;11;.917;3600000;0
26599;202161;37;0;0;0;0;.00nan;0;0
26599;186549;45;0;0;0;0;.00nan;0;0
26599;66491;45;86;36;2;34;.944;3559000;0
26600;199481;57;0;0;0;0;.00nan;0;0
26600;194264;41;0;0;0;0;.00nan;0;0
26600;75313;41;63;19;2;17;.895;3600000;0
26600;152418;57;60;27;3;24;.889;3551000;0
26601;192733;61;35;26;5;21;.808;3600000;0
26601;-1;61;0;0;0;0;.00nan;0;0
26601;57215;50;86;18;0;18;1.000;3600000;0
26601;141998;50;0;0;0;0;.00nan;0;0
26602;165744;43;48;21;3;18;.857;3600000;0
26602;189644;42;0;0;0;0;.00nan;0;0
26602;64811;43;0;0;0;0;.00nan;0;0
26602;149450;42;63;50;6;44;.880;3600000;0
26603;173856;38;0;0;0;0;.00nan;0;0
26603;176921;58;0;0;0;0;.00nan;0;0
26603;181102;38;61;28;3;25;.893;3543000;0
26603;38124;58;53;14;2;12;.857;3600000;0
26604;163565;40;0;0;0;0;.00nan;0;0
26604;189639;54;0;0;0;0;.00nan;0;0
26604;201876;54;96;46;2;44;.957;3587000;0
26604;185812;40;73;21;1;20;.952;3600000;0
26605;171970;55;70;35;3;32;.914;3556000;0
26605;188888;51;0;0;0;0;.00nan;0;0
26605;194502;55;0;0;0;0;.00nan;0;0
26605;86360;51;96;35;1;34;.971;3600000;0
26606;4622;64;0;0;0;0;.00nan;0;0
26606;184069;46;0;0;0;0;.00nan;0;0
26606;182049;46;97;38;2;36;.947;3600000;0
26606;58037;64;58;36;4;32;.889;3534000;0
26607;169226;65;91;44;2;42;.955;3600000;0
26607;195089;36;79;28;1;27;.964;3600000;0
26607;176938;65;0;0;0;0;.00nan;0;0
26607;187362;36;0;0;0;0;.00nan;0;0
26608;13337;39;60;36;5;31;.861;3900000;0
26608;189081;56;0;0;0;0;.00nan;0;0
26608;197704;39;0;0;0;0;.00nan;0;0
26608;57207;56;47;37;5;32;.865;3900000;0
26609;163195;59;62;13;1;12;.923;3600000;0
26609;199481;57;94;57;3;54;.947;3513000;0
26609;186527;59;0;0;0;0;.00nan;0;0
26609;152418;57;0;0;0;0;.00nan;0;0
26610;4622;64;92;20;0;20;1.000;3600000;0
26610;184069;46;98;40;1;39;.975;3559000;0
26610;182049;46;0;0;0;0;.00nan;0;0
26610;58037;64;0;0;0;0;.00nan;0;0
26611;163195;59;0;0;0;0;.00nan;0;0
26611;176921;58;0;0;0;0;.00nan;0;0
26611;38124;58;100;74;2;72;.973;3900000;0
26611;186527;59;58;17;2;15;.882;3900000;0
26612;192733;61;87;40;2;38;.950;3565000;0
26612;170314;4619;82;31;1;30;.968;3600000;0
26612;-1;61;0;0;0;0;.00nan;0;0
26612;78820;4619;0;0;0;0;.00nan;0;0
26613;161535;52;72;17;1;16;.941;3600000;0
26613;184081;52;0;0;0;0;.00nan;0;0
26613;169226;65;0;0;0;0;.00nan;0;0
26613;176938;65;63;49;6;43;.878;3600000;0
26614;171970;55;0;0;0;0;.00nan;0;0
26614;194502;55;88;49;3;46;.939;3600000;0
26614;195089;36;0;0;0;0;.00nan;0;0
26614;187362;36;52;25;4;21;.840;3570000;0
26615;183859;47;0;0;0;0;.00nan;0;0
26615;189639;54;0;0;0;0;.00nan;0;0
26615;201876;54;64;45;5;40;.889;3600000;0
26615;186495;47;62;14;1;13;.929;3600000;0
26616;191026;48;74;45;5;40;.889;3600000;0
26616;84945;60;30;29;6;23;.793;3577000;0
26616;86862;60;0;0;0;0;.00nan;0;0
26616;142492;48;0;0;0;0;.00nan;0;0
26617;169323;53;43;10;2;8;.800;1971000;0
26617;184610;49;0;0;0;0;.00nan;0;0
26617;79132;49;91;52;4;48;.923;3600000;0
26617;91403;53;33;23;5;18;.783;1629000;0
26618;176200;44;0;0;0;0;.00nan;0;0
26618;185743;4837;0;0;0;0;.00nan;0;0
26618;187295;4837;67;17;2;15;.882;3600000;0
26618;64911;44;76;40;5;35;.875;3600000;0
26619;191026;48;0;0;0;0;.00nan;0;0
26619;84945;60;0;0;0;0;.00nan;0;0
26619;86862;60;42;29;5;24;.828;3643000;0
26619;142492;48;72;39;4;35;.897;3643000;0
26620;169323;53;0;0;0;0;.00nan;0;0
26620;184610;49;0;0;0;0;.00nan;0;0
26620;79132;49;87;49;3;46;.939;3600000;0
26620;91403;53;45;22;4;18;.818;3572000;0
26621;192733;61;84;37;2;35;.946;3600000;0
26621;170314;4619;46;20;3;17;.850;3545000;0
26621;-1;61;0;0;0;0;.00nan;0;0
26621;78820;4619;0;0;0;0;.00nan;0;0
26622;176200;44;0;0;0;0;.00nan;0;0
26622;185743;4837;76;24;1;23;.958;3600000;0
26622;187295;4837;0;0;0;0;.00nan;0;0
26622;64911;44;53;29;4;25;.862;3600000;0
26623;173856;38;61;43;4;39;.907;3600000;0
26623;181102;38;0;0;0;0;.00nan;0;0
26623;181123;63;84;20;0;20;1.000;3600000;0
26623;192457;63;0;0;0;0;.00nan;0;0
26624;183859;47;59;13;1;12;.923;3600000;0
26624;189639;54;48;34;5;29;.853;3600000;0
26624;201876;54;0;0;0;0;.00nan;0;0
26624;186495;47;0;0;0;0;.00nan;0;0
26625;189081;56;0;0;0;0;.00nan;0;0
26625;195089;36;0;0;0;0;.00nan;0;0
26625;187362;36;46;18;4;14;.778;3843000;0
26625;57207;56;100;52;3;49;.942;3843000;0
26626;161535;52;47;29;5;24;.828;3600000;0
26626;199481;57;0;0;0;0;.00nan;0;0
26626;184081;52;0;0;0;0;.00nan;0;0
26626;152418;57;90;45;2;43;.956;3600000;0
26627;2195;51;51;23;4;19;.826;3600000;0
26627;173856;38;70;49;6;43;.878;3600000;0
26627;181102;38;0;0;0;0;.00nan;0;0
26627;86360;51;0;0;0;0;.00nan;0;0
26628;170314;4619;73;41;4;37;.902;3600000;0
26628;176915;62;0;0;0;0;.00nan;0;0
26628;196372;62;73;24;1;23;.958;3600000;0
26628;78820;4619;0;0;0;0;.00nan;0;0
26629;194264;41;52;27;4;23;.852;3600000;0
26629;176921;58;0;0;0;0;.00nan;0;0
26629;38124;58;85;30;2;28;.933;3600000;0
26629;75313;41;0;0;0;0;.00nan;0;0
26630;165744;43;82;16;0;16;1.000;3600000;0
26630;189081;56;55;20;2;18;.900;1327000;0
26630;57207;56;45;42;6;36;.857;2273000;0
26630;64811;43;0;0;0;0;.00nan;0;0
26631;189644;42;96;21;0;21;1.000;3600000;0
26631;186549;45;68;39;4;35;.897;3600000;0
26631;66491;45;0;0;0;0;.00nan;0;0
26631;149450;42;0;0;0;0;.00nan;0;0
26632;184069;46;0;0;0;0;.00nan;0;0
26632;182049;46;92;55;4;51;.927;3600000;0
26632;57215;50;0;0;0;0;.00nan;0;0
26632;141998;50;70;20;1;19;.950;3600000;0
26633;4622;64;63;37;4;33;.892;3560000;0
26633;190465;37;0;0;0;0;.00nan;0;0
26633;202161;37;83;26;2;24;.923;3600000;0
26633;58037;64;0;0;0;0;.00nan;0;0
26634;171970;55;0;0;0;0;.00nan;0;0
26634;199481;57;0;0;0;0;.00nan;0;0
26634;194502;55;56;31;4;27;.871;3600000;0
26634;152418;57;78;21;1;20;.952;3600000;0
26635;192733;61;64;46;5;41;.891;3600000;0
26635;183859;47;51;20;3;17;.850;3600000;0
26635;-1;61;0;0;0;0;.00nan;0;0
26635;186495;47;0;0;0;0;.00nan;0;0
26636;195089;36;0;0;0;0;.00nan;0;0
26636;181123;63;70;32;3;29;.906;3512000;0
26636;187362;36;93;38;1;37;.974;3600000;0
26636;192457;63;0;0;0;0;.00nan;0;0
26637;163565;40;0;0;0;0;.00nan;0;0
26637;185812;40;67;22;2;20;.909;3550000;0
26637;191026;48;99;43;1;42;.977;3600000;0
26637;142492;48;0;0;0;0;.00nan;0;0
26638;176200;44;0;0;0;0;.00nan;0;0
26638;176915;62;59;14;1;13;.929;3600000;0
26638;196372;62;0;0;0;0;.00nan;0;0
26638;64911;44;96;52;2;50;.962;3552000;0
26639;165744;43;51;16;2;14;.875;3600000;0
26639;189081;56;77;57;5;52;.912;3600000;0
26639;57207;56;0;0;0;0;.00nan;0;0
26639;64811;43;0;0;0;0;.00nan;0;0
26640;163195;59;62;29;3;26;.897;3600000;0
26640;194264;41;34;6;2;4;.667;266000;0
26640;186527;59;0;0;0;0;.00nan;0;0
26640;75313;41;27;30;6;24;.800;3334000;0
26641;13337;39;84;47;5;42;.894;3600000;0
26641;169323;53;0;0;0;0;.00nan;0;0
26641;197704;39;0;0;0;0;.00nan;0;0
26641;91403;53;79;24;1;23;.958;3600000;0
26642;2195;51;58;24;3;21;.875;3900000;0
26642;173856;38;95;47;3;44;.936;3900000;0
26642;181102;38;0;0;0;0;.00nan;0;0
26642;86360;51;0;0;0;0;.00nan;0;0
26643;184610;49;0;0;0;0;.00nan;0;0
26643;185743;4837;0;0;0;0;.00nan;0;0
26643;187295;4837;66;22;3;19;.864;3600000;0
26643;79132;49;79;43;5;38;.884;3600000;0
26644;161535;52;42;22;4;18;.818;3545000;0
26644;184081;52;0;0;0;0;.00nan;0;0
26644;176921;58;84;43;3;40;.930;3600000;0
26644;38124;58;0;0;0;0;.00nan;0;0
26645;189644;42;82;27;1;26;.963;3600000;0
26645;186549;45;0;0;0;0;.00nan;0;0
26645;66491;45;40;49;8;41;.837;3600000;0
26645;149450;42;0;0;0;0;.00nan;0;0
26646;184069;46;86;42;3;39;.929;3600000;0
26646;182049;46;0;0;0;0;.00nan;0;0
26646;57215;50;63;18;2;16;.889;3600000;0
26646;141998;50;0;0;0;0;.00nan;0;0
26647;170314;4619;76;36;3;33;.917;3578000;0
26647;78820;4619;0;0;0;0;.00nan;0;0
26647;84945;60;58;14;1;13;.929;3600000;0
26647;86862;60;0;0;0;0;.00nan;0;0
26648;169226;65;49;43;6;37;.860;2332000;0
26648;176938;65;36;12;3;9;.750;1268000;0
26648;181123;63;0;0;0;0;.00nan;0;0
26648;192457;63;100;24;0;24;1.000;3600000;0
26649;189639;54;0;0;0;0;.00nan;0;0
26649;201876;54;93;43;2;41;.953;3600000;0
26649;190465;37;34;10;3;7;.700;3527000;0
26649;202161;37;0;0;0;0;.00nan;0;0
26650;171970;55;50;38;5;33;.868;3600000;0
26650;194502;55;0;0;0;0;.00nan;0;0
26650;195089;36;86;16;0;16;1.000;3600000;0
26650;187362;36;0;0;0;0;.00nan;0;0
26651;192733;61;81;41;3;38;.927;3642000;0
26651;183859;47;46;20;4;16;.800;3642000;0
26651;-1;61;0;0;0;0;.00nan;0;0
26651;186495;47;0;0;0;0;.00nan;0;0
26652;163565;40;100;27;0;27;1.000;3600000;0
26652;185812;40;0;0;0;0;.00nan;0;0
26652;191026;48;0;0;0;0;.00nan;0;0
26652;142492;48;74;36;3;33;.917;3600000;0
26653;13337;39;47;26;4;22;.846;3522000;0
26653;169323;53;96;42;2;40;.952;3600000;0
26653;197704;39;0;0;0;0;.00nan;0;0
26653;91403;53;0;0;0;0;.00nan;0;0
26654;184610;49;0;0;0;0;.00nan;0;0
26654;185743;4837;38;21;4;17;.810;3759000;0
26654;187295;4837;0;0;0;0;.00nan;0;0
26654;79132;49;94;52;5;47;.904;3734000;0
26655;176200;44;0;0;0;0;.00nan;0;0
26655;64911;44;100;40;1;39;.975;3735000;0
26655;84945;60;0;0;0;0;.00nan;0;0
26655;86862;60;58;20;2;18;.900;3735000;0
26656;163195;59;43;16;3;13;.813;3600000;0
26656;199481;57;0;0;0;0;.00nan;0;0
26656;186527;59;0;0;0;0;.00nan;0;0
26656;152418;57;74;37;4;33;.892;3565000;0
26657;161535;52;0;0;0;0;.00nan;0;0
26657;184081;52;75;14;0;14;1.000;3600000;0
26657;169226;65;0;0;0;0;.00nan;0;0
26657;176938;65;71;31;2;29;.935;3544000;0
26658;184069;46;0;0;0;0;.00nan;0;0
26658;189639;54;0;0;0;0;.00nan;0;0
26658;201876;54;74;37;3;34;.919;3897000;0
26658;182049;46;51;25;4;21;.840;3897000;0
26659;4622;64;80;31;2;29;.935;3576000;0
26659;189644;42;92;32;1;31;.969;3600000;0
26659;58037;64;0;0;0;0;.00nan;0;0
26659;149450;42;0;0;0;0;.00nan;0;0
26660;163565;40;61;19;2;17;.895;3600000;0
26660;185812;40;0;0;0;0;.00nan;0;0
26660;191026;48;65;15;1;14;.933;1401000;0
26660;142492;48;52;30;5;25;.833;2199000;0
26661;2195;51;68;23;2;21;.913;3600000;0
26661;13337;39;50;28;4;24;.857;3526000;0
26661;197704;39;0;0;0;0;.00nan;0;0
26661;86360;51;0;0;0;0;.00nan;0;0
26662;190465;37;0;0;0;0;.00nan;0;0
26662;202161;37;100;29;0;29;1.000;3600000;0
26662;186549;45;61;34;4;30;.882;3600000;0
26662;66491;45;0;0;0;0;.00nan;0;0
26663;192733;61;100;31;0;31;1.000;3600000;0
26663;170314;4619;69;21;1;20;.952;3545000;0
26663;-1;61;0;0;0;0;.00nan;0;0
26663;78820;4619;0;0;0;0;.00nan;0;0
26664;169226;65;0;0;0;0;.00nan;0;0
26664;176921;58;0;0;0;0;.00nan;0;0
26664;176938;65;89;41;3;38;.927;3547000;0
26664;38124;58;83;25;1;24;.960;3600000;0
26665;184069;46;84;33;1;32;.970;3600000;0
26665;189639;54;48;38;6;32;.842;3600000;0
26665;201876;54;0;0;0;0;.00nan;0;0
26665;182049;46;0;0;0;0;.00nan;0;0
26666;165744;43;69;20;1;19;.950;3600000;0
26666;195089;36;65;45;5;40;.889;3600000;0
26666;187362;36;0;0;0;0;.00nan;0;0
26666;64811;43;0;0;0;0;.00nan;0;0
26667;4622;64;0;0;0;0;.00nan;0;0
26667;189644;42;0;0;0;0;.00nan;0;0
26667;58037;64;91;49;4;45;.918;3600000;0
26667;149450;42;90;26;1;25;.962;3600000;0
26668;189081;56;0;0;0;0;.00nan;0;0
26668;57207;56;86;47;3;44;.936;3600000;0
26668;57215;50;0;0;0;0;.00nan;0;0
26668;141998;50;48;21;4;17;.810;3553000;0
26669;184610;49;0;0;0;0;.00nan;0;0
26669;176200;44;0;0;0;0;.00nan;0;0
26669;64911;44;80;28;2;26;.929;3663000;0
26669;79132;49;100;40;1;39;.975;3663000;0
26670;161535;52;46;24;4;20;.833;3600000;0
26670;194264;41;75;28;2;26;.929;3600000;0
26670;184081;52;0;0;0;0;.00nan;0;0
26670;75313;41;0;0;0;0;.00nan;0;0
26671;176200;44;0;0;0;0;.00nan;0;0
26671;191026;48;43;16;3;13;.813;3600000;0
26671;64911;44;62;42;6;36;.857;3600000;0
26671;142492;48;0;0;0;0;.00nan;0;0
26672;2195;51;74;22;1;21;.955;3600000;0
26672;194264;41;0;0;0;0;.00nan;0;0
26672;75313;41;64;26;2;24;.923;3571000;0
26672;86360;51;0;0;0;0;.00nan;0;0
26673;189081;56;0;0;0;0;.00nan;0;0
26673;186549;45;0;0;0;0;.00nan;0;0
26673;57207;56;75;27;1;26;.963;3561000;0
26673;66491;45;81;13;0;13;1.000;3600000;0
26674;192733;61;88;29;2;27;.931;3900000;0
26674;-1;61;0;0;0;0;.00nan;0;0
26674;185743;4837;0;0;0;0;.00nan;0;0
26674;187295;4837;77;28;2;26;.929;3872000;0
26675;163565;40;55;28;4;24;.857;3900000;0
26675;189639;54;0;0;0;0;.00nan;0;0
26675;201876;54;92;51;4;47;.922;3900000;0
26675;185812;40;0;0;0;0;.00nan;0;0
26676;161535;52;72;25;2;23;.920;3900000;0
26676;184081;52;0;0;0;0;.00nan;0;0
26676;173856;38;100;37;2;35;.946;3900000;0
26676;181102;38;0;0;0;0;.00nan;0;0
26677;190465;37;59;19;3;16;.842;2483000;0
26677;202161;37;41;22;4;18;.818;1117000;0
26677;57215;50;87;32;1;31;.969;3600000;0
26677;141998;50;0;0;0;0;.00nan;0;0
26678;163195;59;54;18;3;15;.833;3515000;0
26678;199481;57;0;0;0;0;.00nan;0;0
26678;186527;59;0;0;0;0;.00nan;0;0
26678;152418;57;89;36;1;35;.972;3600000;0
26679;195089;36;0;0;0;0;.00nan;0;0
26679;181123;63;0;0;0;0;.00nan;0;0
26679;187362;36;75;35;3;32;.914;3600000;0
26679;192457;63;44;22;4;18;.818;3570000;0
26680;184610;49;72;38;3;35;.921;3600000;0
26680;176915;62;0;0;0;0;.00nan;0;0
26680;196372;62;95;24;0;24;1.000;3600000;0
26680;79132;49;0;0;0;0;.00nan;0;0
26681;169226;65;100;37;0;37;1.000;3600000;0
26681;169323;53;0;0;0;0;.00nan;0;0
26681;176938;65;0;0;0;0;.00nan;0;0
26681;91403;53;39;25;5;20;.800;3600000;0
26682;171970;55;0;0;0;0;.00nan;0;0
26682;165744;43;44;8;2;6;.750;3600000;0
26682;194502;55;98;67;4;63;.940;3574000;0
26682;64811;43;0;0;0;0;.00nan;0;0
26683;184069;46;22;5;3;2;.400;795000;0
26683;170314;4619;69;23;2;21;.913;3600000;0
26683;182049;46;47;30;5;25;.833;2805000;0
26683;78820;4619;0;0;0;0;.00nan;0;0
26684;183859;47;80;28;1;27;.964;3600000;0
26684;186495;47;0;0;0;0;.00nan;0;0
26684;84945;60;0;0;0;0;.00nan;0;0
26684;86862;60;87;45;3;42;.933;3544000;0
26685;176200;44;100;48;1;47;.979;3600000;0
26685;191026;48;0;0;0;0;.00nan;0;0
26685;64911;44;0;0;0;0;.00nan;0;0
26685;142492;48;30;15;4;11;.733;3600000;0
26686;163195;59;78;13;0;13;1.000;3600000;0
26686;199481;57;62;40;6;34;.850;2841000;0
26686;186527;59;0;0;0;0;.00nan;0;0
26686;152418;57;55;4;0;4;1.000;759000;0
26687;4622;64;51;44;6;38;.864;3600000;0
26687;57215;50;0;0;0;0;.00nan;0;0
26687;58037;64;0;0;0;0;.00nan;0;0
26687;141998;50;100;37;1;36;.973;3600000;0
26688;2195;51;67;40;4;36;.900;3546000;0
26688;194264;41;92;31;2;29;.935;3600000;0
26688;75313;41;0;0;0;0;.00nan;0;0
26688;86360;51;0;0;0;0;.00nan;0;0
26689;189081;56;61;20;2;18;.900;3600000;0
26689;186549;45;64;41;4;37;.902;3557000;0
26689;57207;56;0;0;0;0;.00nan;0;0
26689;66491;45;0;0;0;0;.00nan;0;0
26690;192733;61;89;48;4;44;.917;3535000;0
26690;-1;61;0;0;0;0;.00nan;0;0
26690;185743;4837;54;20;2;18;.900;3600000;0
26690;187295;4837;0;0;0;0;.00nan;0;0
26691;163565;40;0;0;0;0;.00nan;0;0
26691;189639;54;86;35;2;33;.943;3550000;0
26691;201876;54;0;0;0;0;.00nan;0;0
26691;185812;40;87;20;1;19;.950;3600000;0
26692;13337;39;72;18;1;17;.944;3600000;0
26692;173856;38;0;0;0;0;.00nan;0;0
26692;181102;38;97;46;3;43;.935;3513000;0
26692;197704;39;0;0;0;0;.00nan;0;0
26693;165744;43;40;13;3;10;.769;3600000;0
26693;181123;63;72;40;4;36;.900;3600000;0
26693;192457;63;0;0;0;0;.00nan;0;0
26693;64811;43;0;0;0;0;.00nan;0;0
26694;189644;42;63;36;5;31;.861;3900000;0
26694;190465;37;0;0;0;0;.00nan;0;0
26694;202161;37;61;43;5;38;.884;3900000;0
26694;149450;42;0;0;0;0;.00nan;0;0
26695;184610;49;0;0;0;0;.00nan;0;0
26695;176915;62;0;0;0;0;.00nan;0;0
26695;196372;62;67;20;2;18;.900;3600000;0
26695;79132;49;98;50;3;47;.940;3600000;0
26696;169226;65;0;0;0;0;.00nan;0;0
26696;169323;53;47;13;2;11;.846;3600000;0
26696;176938;65;51;34;5;29;.853;3600000;0
26696;91403;53;0;0;0;0;.00nan;0;0
26697;184069;46;68;35;3;32;.914;3591000;0
26697;170314;4619;63;23;2;21;.913;3600000;0
26697;182049;46;0;0;0;0;.00nan;0;0
26697;78820;4619;0;0;0;0;.00nan;0;0
26698;183859;47;69;23;2;21;.913;3788000;0
26698;186495;47;0;0;0;0;.00nan;0;0
26698;84945;60;76;36;3;33;.917;3776000;0
26698;86862;60;0;0;0;0;.00nan;0;0
26699;171970;55;96;65;4;61;.938;3600000;0
26699;194502;55;0;0;0;0;.00nan;0;0
26699;195089;36;83;13;0;13;1.000;3600000;0
26699;187362;36;0;0;0;0;.00nan;0;0
26700;161535;52;0;0;0;0;.00nan;0;0
26700;184081;52;70;28;3;25;.893;3600000;0
26700;176921;58;0;0;0;0;.00nan;0;0
26700;38124;58;84;47;4;43;.915;3587000;0
26701;4622;64;0;0;0;0;.00nan;0;0
26701;189644;42;0;0;0;0;.00nan;0;0
26701;58037;64;54;32;4;28;.875;3600000;0
26701;149450;42;84;26;1;25;.962;3600000;0
26702;13337;39;87;31;1;30;.968;3600000;0
26702;176921;58;80;45;4;41;.911;3600000;0
26702;38124;58;0;0;0;0;.00nan;0;0
26702;197704;39;0;0;0;0;.00nan;0;0
26703;199481;57;0;0;0;0;.00nan;0;0
26703;169323;53;0;0;0;0;.00nan;0;0
26703;91403;53;79;41;3;38;.927;3600000;0
26703;152418;57;83;42;4;38;.905;3595000;0
26704;163565;40;66;39;4;35;.897;3600000;0
26704;185812;40;0;0;0;0;.00nan;0;0
26704;57215;50;0;0;0;0;.00nan;0;0
26704;141998;50;85;21;1;20;.952;3600000;0
26705;185743;4837;0;0;0;0;.00nan;0;0
26705;187295;4837;93;21;0;21;1.000;3600000;0
26705;84945;60;71;16;0;16;1.000;1341000;0
26705;86862;60;48;31;5;26;.839;2259000;0
26706;189644;42;81;26;2;24;.923;3900000;0
26706;190465;37;0;0;0;0;.00nan;0;0
26706;202161;37;68;28;2;26;.929;3900000;0
26706;149450;42;0;0;0;0;.00nan;0;0
26707;183859;47;26;28;6;22;.786;2937000;0
26707;176200;44;0;0;0;0;.00nan;0;0
26707;186495;47;50;10;2;8;.800;663000;0
26707;64911;44;94;45;1;44;.978;3600000;0
26708;163195;59;50;15;2;13;.867;3561000;0
26708;169226;65;0;0;0;0;.00nan;0;0
26708;176938;65;92;47;1;46;.979;3600000;0
26708;186527;59;0;0;0;0;.00nan;0;0
26709;170314;4619;68;34;4;30;.882;3600000;0
26709;176915;62;0;0;0;0;.00nan;0;0
26709;196372;62;60;46;5;41;.891;3565000;0
26709;78820;4619;0;0;0;0;.00nan;0;0
26710;194264;41;28;23;5;18;.783;3536000;0
26710;169323;53;0;0;0;0;.00nan;0;0
26710;75313;41;0;0;0;0;.00nan;0;0
26710;91403;53;76;36;3;33;.917;3600000;0
26711;165744;43;0;0;0;0;.00nan;0;0
26711;195089;36;68;47;5;42;.894;3600000;0
26711;187362;36;0;0;0;0;.00nan;0;0
26711;64811;43;95;24;0;24;1.000;3600000;0
26712;173856;38;46;28;4;24;.857;3600000;0
26712;176921;58;0;0;0;0;.00nan;0;0
26712;181102;38;0;0;0;0;.00nan;0;0
26712;38124;58;100;35;0;35;1.000;3600000;0
26713;171970;55;0;0;0;0;.00nan;0;0
26713;194502;55;100;46;2;44;.957;3900000;0
26713;181123;63;56;18;2;16;.889;3877000;0
26713;192457;63;0;0;0;0;.00nan;0;0
26714;161535;52;0;0;0;0;.00nan;0;0
26714;13337;39;97;39;2;37;.949;3600000;0
26714;184081;52;81;33;3;30;.909;3566000;0
26714;197704;39;0;0;0;0;.00nan;0;0
26715;2195;51;42;26;5;21;.808;3600000;0
26715;4622;64;0;0;0;0;.00nan;0;0
26715;58037;64;52;25;4;21;.840;3600000;0
26715;86360;51;0;0;0;0;.00nan;0;0
26716;184610;49;50;0;0;0;.00nan;314000;0
26716;191026;48;40;36;6;30;.833;3581000;0
26716;79132;49;61;35;5;30;.857;3286000;0
26716;142492;48;0;0;0;0;.00nan;0;0
26717;163195;59;55;11;1;10;.909;3600000;0
26717;169226;65;81;48;3;45;.938;3563000;0
26717;176938;65;0;0;0;0;.00nan;0;0
26717;186527;59;0;0;0;0;.00nan;0;0
26718;199481;57;0;0;0;0;.00nan;0;0
26718;169323;53;0;0;0;0;.00nan;0;0
26718;91403;53;72;18;1;17;.944;3600000;0
26718;152418;57;93;44;3;41;.932;3583000;0
26719;170314;4619;71;39;4;35;.897;3600000;0
26719;176915;62;55;5;0;5;1.000;447000;0
26719;196372;62;29;26;6;20;.769;3153000;0
26719;78820;4619;0;0;0;0;.00nan;0;0
26720;161535;52;0;0;0;0;.00nan;0;0
26720;194264;41;37;29;5;24;.828;3600000;0
26720;184081;52;100;25;0;25;1.000;3600000;0
26720;75313;41;0;0;0;0;.00nan;0;0
26721;192733;61;34;19;4;15;.789;3540000;0
26721;189639;54;0;0;0;0;.00nan;0;0
26721;-1;61;0;0;0;0;.00nan;0;0
26721;201876;54;96;34;2;32;.941;3600000;0
26722;165744;43;0;0;0;0;.00nan;0;0
26722;181123;63;80;38;3;35;.921;3542000;0
26722;192457;63;0;0;0;0;.00nan;0;0
26722;64811;43;80;21;1;20;.952;3600000;0
26723;173856;38;49;36;6;30;.833;3600000;0
26723;176921;58;0;0;0;0;.00nan;0;0
26723;181102;38;0;0;0;0;.00nan;0;0
26723;38124;58;63;30;3;27;.900;3600000;0
26724;189644;42;53;36;5;31;.861;3600000;0
26724;57215;50;95;22;0;22;1.000;3600000;0
26724;141998;50;0;0;0;0;.00nan;0;0
26724;149450;42;0;0;0;0;.00nan;0;0
26725;185743;4837;52;4;0;4;1.000;1076000;0
26725;187295;4837;26;25;6;19;.760;2438000;0
26725;84945;60;0;0;0;0;.00nan;0;0
26725;86862;60;94;48;4;44;.917;3600000;0
26726;190465;37;0;0;0;0;.00nan;0;0
26726;202161;37;67;26;2;24;.923;3600000;0
26726;186549;45;80;48;5;43;.896;3600000;0
26726;66491;45;0;0;0;0;.00nan;0;0
26727;163565;40;87;37;3;34;.919;3600000;0
26727;183859;47;51;26;4;22;.846;3600000;0
26727;185812;40;0;0;0;0;.00nan;0;0
26727;186495;47;0;0;0;0;.00nan;0;0
26728;171970;55;0;0;0;0;.00nan;0;0
26728;189081;56;0;0;0;0;.00nan;0;0
26728;194502;55;90;43;3;40;.930;3576000;0
26728;57207;56;62;22;2;20;.909;3600000;0
26729;184069;46;0;0;0;0;.00nan;0;0
26729;176200;44;0;0;0;0;.00nan;0;0
26729;182049;46;70;36;3;33;.917;3546000;0
26729;64911;44;67;24;2;22;.917;3600000;0
26730;13337;39;92;34;1;33;.971;3574000;0
26730;195089;36;0;0;0;0;.00nan;0;0
26730;187362;36;100;32;0;32;1.000;3600000;0
26730;197704;39;0;0;0;0;.00nan;0;0
26731;184610;49;0;0;0;0;.00nan;0;0
26731;191026;48;0;0;0;0;.00nan;0;0
26731;79132;49;66;38;4;34;.895;3542000;0
26731;142492;48;57;27;3;24;.889;3600000;0
26732;199481;57;100;38;1;37;.974;3600000;0
26732;169323;53;62;33;3;30;.909;3570000;0
26732;91403;53;0;0;0;0;.00nan;0;0
26732;152418;57;0;0;0;0;.00nan;0;0
26733;2195;51;89;32;3;29;.906;3900000;0
26733;4622;64;0;0;0;0;.00nan;0;0
26733;58037;64;89;42;3;39;.929;3900000;0
26733;86360;51;0;0;0;0;.00nan;0;0
26734;183859;47;62;33;4;29;.879;3600000;0
26734;170314;4619;91;15;0;15;1.000;3600000;0
26734;186495;47;0;0;0;0;.00nan;0;0
26734;78820;4619;0;0;0;0;.00nan;0;0
26735;194264;41;0;0;0;0;.00nan;0;0
26735;169226;65;0;0;0;0;.00nan;0;0
26735;176938;65;84;47;3;44;.936;3600000;0
26735;75313;41;85;17;0;17;1.000;3600000;0
26736;192733;61;82;17;0;17;1.000;3600000;0
26736;189639;54;63;36;4;32;.889;3600000;0
26736;-1;61;0;0;0;0;.00nan;0;0
26736;201876;54;0;0;0;0;.00nan;0;0
26737;163195;59;53;18;2;16;.889;3600000;0
26737;176921;58;57;40;5;35;.875;3600000;0
26737;38124;58;0;0;0;0;.00nan;0;0
26737;186527;59;0;0;0;0;.00nan;0;0
26738;165744;43;71;16;1;15;.938;3600000;0
26738;181123;63;47;38;6;32;.842;2862000;0
26738;192457;63;57;4;0;4;1.000;738000;0
26738;64811;43;0;0;0;0;.00nan;0;0
26739;161535;52;84;37;3;34;.919;3537000;0
26739;184081;52;0;0;0;0;.00nan;0;0
26739;173856;38;0;0;0;0;.00nan;0;0
26739;181102;38;100;45;1;44;.978;3600000;0
26740;176915;62;90;23;0;23;1.000;3600000;0
26740;196372;62;0;0;0;0;.00nan;0;0
26740;84945;60;50;23;3;20;.870;3600000;0
26740;86862;60;0;0;0;0;.00nan;0;0
26741;189644;42;0;0;0;0;.00nan;0;0
26741;190465;37;75;31;2;29;.935;3600000;0
26741;202161;37;0;0;0;0;.00nan;0;0
26741;149450;42;99;33;1;32;.970;3600000;0
26742;163565;40;53;15;2;13;.867;1434000;0
26742;185743;4837;38;21;4;17;.810;3600000;0
26742;185812;40;49;25;4;21;.840;2166000;0
26742;187295;4837;0;0;0;0;.00nan;0;0
26743;171970;55;81;34;2;32;.941;3553000;0
26743;189081;56;93;19;0;19;1.000;3600000;0
26743;194502;55;0;0;0;0;.00nan;0;0
26743;57207;56;0;0;0;0;.00nan;0;0
26744;184069;46;71;26;2;24;.923;3600000;0
26744;176200;44;0;0;0;0;.00nan;0;0
26744;182049;46;0;0;0;0;.00nan;0;0
26744;64911;44;66;31;3;28;.903;3600000;0
26745;13337;39;0;0;0;0;.00nan;0;0
26745;195089;36;0;0;0;0;.00nan;0;0
26745;187362;36;99;48;3;45;.938;3600000;0
26745;197704;39;38;27;4;23;.852;3571000;0
26746;184610;49;0;0;0;0;.00nan;0;0
26746;176200;44;0;0;0;0;.00nan;0;0
26746;64911;44;85;26;1;25;.962;3600000;0
26746;79132;49;48;20;3;17;.850;3571000;0
26747;189081;56;97;56;2;54;.964;3591000;0
26747;195089;36;0;0;0;0;.00nan;0;0
26747;187362;36;72;20;1;19;.950;3600000;0
26747;57207;56;0;0;0;0;.00nan;0;0
26748;163565;40;62;43;5;38;.884;3600000;0
26748;176915;62;96;17;0;17;1.000;3600000;0
26748;196372;62;0;0;0;0;.00nan;0;0
26748;185812;40;0;0;0;0;.00nan;0;0
26749;2195;51;86;33;2;31;.939;3600000;0
26749;169323;53;0;0;0;0;.00nan;0;0
26749;86360;51;0;0;0;0;.00nan;0;0
26749;91403;53;58;29;3;26;.897;3549000;0
26750;185743;4837;0;0;0;0;.00nan;0;0
26750;191026;48;0;0;0;0;.00nan;0;0
26750;187295;4837;35;22;5;17;.773;3600000;0
26750;142492;48;63;52;7;45;.865;3592000;0
26751;189644;42;81;31;2;29;.935;3575000;0
26751;186549;45;0;0;0;0;.00nan;0;0
26751;66491;45;100;26;0;26;1.000;3600000;0
26751;149450;42;0;0;0;0;.00nan;0;0
26752;163195;59;34;23;5;18;.783;3600000;0
26752;194264;41;0;0;0;0;.00nan;0;0
26752;186527;59;0;0;0;0;.00nan;0;0
26752;75313;41;88;40;2;38;.950;3600000;0
26753;183859;47;74;28;2;26;.929;3600000;0
26753;189639;54;75;23;1;22;.957;1915000;0
26753;201876;54;30;20;5;15;.750;1685000;0
26753;186495;47;0;0;0;0;.00nan;0;0
26754;161535;52;0;0;0;0;.00nan;0;0
26754;184081;52;92;36;3;33;.917;3900000;0
26754;173856;38;71;34;3;31;.912;3900000;0
26754;181102;38;0;0;0;0;.00nan;0;0
26755;192733;61;100;47;1;46;.979;3600000;0
26755;-1;61;0;0;0;0;.00nan;0;0
26755;84945;60;0;0;0;0;.00nan;0;0
26755;86862;60;48;20;3;17;.850;3578000;0
26756;199481;57;0;0;0;0;.00nan;0;0
26756;176921;58;0;0;0;0;.00nan;0;0
26756;38124;58;99;30;1;29;.967;3600000;0
26756;152418;57;65;24;2;22;.917;3550000;0
26757;171970;55;0;0;0;0;.00nan;0;0
26757;194502;55;100;37;2;35;.946;3900000;0
26757;181123;63;92;28;2;26;.929;3900000;0
26757;192457;63;0;0;0;0;.00nan;0;0
26758;184069;46;39;8;2;6;.750;647000;0
26758;190465;37;0;0;0;0;.00nan;0;0
26758;202161;37;68;14;1;13;.929;3600000;0
26758;182049;46;40;27;6;21;.778;2953000;0
26759;13337;39;72;45;5;40;.889;3600000;0
26759;165744;43;80;13;0;13;1.000;3600000;0
26759;197704;39;0;0;0;0;.00nan;0;0
26759;64811;43;0;0;0;0;.00nan;0;0
26760;189081;56;0;0;0;0;.00nan;0;0
26760;195089;36;0;0;0;0;.00nan;0;0
26760;187362;36;52;26;4;22;.846;3600000;0
26760;57207;56;99;38;1;37;.974;3600000;0
26761;163195;59;75;16;1;15;.938;3600000;0
26761;173856;38;0;0;0;0;.00nan;0;0
26761;181102;38;84;42;3;39;.929;3535000;0
26761;186527;59;0;0;0;0;.00nan;0;0
26762;163565;40;0;0;0;0;.00nan;0;0
26762;176915;62;62;27;3;24;.889;3554000;0
26762;196372;62;0;0;0;0;.00nan;0;0
26762;185812;40;83;33;2;31;.939;3600000;0
26763;192733;61;88;59;4;55;.932;3544000;0
26763;170314;4619;76;36;3;33;.917;3600000;0
26763;-1;61;0;0;0;0;.00nan;0;0
26763;78820;4619;0;0;0;0;.00nan;0;0
26764;185743;4837;55;36;5;31;.861;3570000;0
26764;191026;48;86;39;3;36;.923;3600000;0
26764;187295;4837;0;0;0;0;.00nan;0;0
26764;142492;48;0;0;0;0;.00nan;0;0
26765;189644;42;0;0;0;0;.00nan;0;0
26765;186549;45;61;50;6;44;.880;3600000;0
26765;66491;45;0;0;0;0;.00nan;0;0
26765;149450;42;46;21;3;18;.857;3600000;0
26766;199481;57;46;32;5;27;.844;3600000;0
26766;194264;41;68;19;1;18;.947;3600000;0
26766;75313;41;0;0;0;0;.00nan;0;0
26766;152418;57;0;0;0;0;.00nan;0;0
26767;183859;47;61;28;3;25;.893;3600000;0
26767;189639;54;0;0;0;0;.00nan;0;0
26767;201876;54;63;45;5;40;.889;3530000;0
26767;186495;47;0;0;0;0;.00nan;0;0
26768;184069;46;51;34;5;29;.853;3228000;0
26768;182049;46;44;5;1;4;.800;372000;0
26768;57215;50;0;0;0;0;.00nan;0;0
26768;141998;50;74;33;3;30;.909;3600000;0
26769;4622;64;0;0;0;0;.00nan;0;0
26769;190465;37;68;27;2;25;.926;3600000;0
26769;202161;37;0;0;0;0;.00nan;0;0
26769;58037;64;63;33;4;29;.879;3515000;0
26770;184610;49;46;23;4;19;.826;3562000;0
26770;176200;44;0;0;0;0;.00nan;0;0
26770;64911;44;99;49;3;46;.939;3600000;0
26770;79132;49;0;0;0;0;.00nan;0;0
26771;169226;65;0;0;0;0;.00nan;0;0
26771;176921;58;2;13;6;7;.538;1648000;0
26771;176938;65;96;38;2;36;.947;3600000;0
26771;38124;58;51;17;2;15;.882;1952000;0
26772;171970;55;67;38;4;34;.895;3600000;0
26772;194502;55;0;0;0;0;.00nan;0;0
26772;181123;63;55;17;2;15;.882;3600000;0
26772;192457;63;0;0;0;0;.00nan;0;0
26773;13337;39;0;0;0;0;.00nan;0;0
26773;165744;43;89;14;0;14;1.000;3600000;0
26773;197704;39;80;53;5;48;.906;3600000;0
26773;64811;43;0;0;0;0;.00nan;0;0
26774;2195;51;69;31;2;29;.935;3889000;0
26774;169323;53;0;0;0;0;.00nan;0;0
26774;86360;51;0;0;0;0;.00nan;0;0
26774;91403;53;91;57;3;54;.947;3889000;0
26775;189644;42;73;28;2;26;.929;3600000;0
26775;176915;62;0;0;0;0;.00nan;0;0
26775;196372;62;57;38;5;33;.868;3600000;0
26775;149450;42;0;0;0;0;.00nan;0;0
26776;2195;51;60;29;3;26;.897;3600000;0
26776;186549;45;0;0;0;0;.00nan;0;0
26776;66491;45;56;35;5;30;.857;3558000;0
26776;86360;51;0;0;0;0;.00nan;0;0
26777;176200;44;44;6;1;5;.833;485000;0
26777;185743;4837;0;0;0;0;.00nan;0;0
26777;187295;4837;91;31;2;29;.935;3600000;0
26777;64911;44;23;32;7;25;.781;3115000;0
26778;4622;64;45;4;1;3;.750;330000;0
26778;57215;50;62;18;2;16;.889;3600000;0
26778;58037;64;43;37;6;31;.838;3270000;0
26778;141998;50;0;0;0;0;.00nan;0;0
26779;184069;46;68;36;4;32;.889;3600000;0
26779;190465;37;0;0;0;0;.00nan;0;0
26779;202161;37;85;29;2;27;.931;3600000;0
26779;182049;46;0;0;0;0;.00nan;0;0
26780;171970;55;0;0;0;0;.00nan;0;0
26780;189081;56;0;0;0;0;.00nan;0;0
26780;194502;55;86;47;3;44;.936;3669000;0
26780;57207;56;74;23;2;21;.913;3669000;0
26781;189644;42;0;0;0;0;.00nan;0;0
26781;176915;62;100;25;0;25;1.000;3600000;0
26781;196372;62;0;0;0;0;.00nan;0;0
26781;149450;42;87;45;3;42;.933;3600000;0
26782;176200;44;0;0;0;0;.00nan;0;0
26782;185743;4837;37;28;5;23;.821;3600000;0
26782;187295;4837;0;0;0;0;.00nan;0;0
26782;64911;44;90;46;2;44;.957;3600000;0
26783;173856;38;100;32;1;31;.969;3600000;0
26783;176921;58;0;0;0;0;.00nan;0;0
26783;181102;38;0;0;0;0;.00nan;0;0
26783;38124;58;79;37;3;34;.919;3519000;0
26784;163565;40;77;40;4;36;.900;3600000;0
26784;184610;49;0;0;0;0;.00nan;0;0
26784;185812;40;0;0;0;0;.00nan;0;0
26784;79132;49;46;32;6;26;.813;3563000;0
26785;161535;52;0;0;0;0;.00nan;0;0
26785;13337;39;82;26;1;25;.962;3600000;0
26785;184081;52;41;39;6;33;.846;3600000;0
26785;197704;39;0;0;0;0;.00nan;0;0
26786;195089;36;67;25;2;23;.920;3600000;0
26786;181123;63;85;35;3;32;.914;3571000;0
26786;187362;36;0;0;0;0;.00nan;0;0
26786;192457;63;0;0;0;0;.00nan;0;0
26787;170314;4619;96;18;0;18;1.000;3600000;0
26787;184610;49;0;0;0;0;.00nan;0;0
26787;78820;4619;0;0;0;0;.00nan;0;0
26787;79132;49;43;43;7;36;.837;3600000;0
26788;13337;39;42;33;6;27;.818;3163000;0
26788;189081;56;0;0;0;0;.00nan;0;0
26788;197704;39;56;5;0;5;1.000;437000;0
26788;57207;56;100;32;0;32;1.000;3600000;0
26789;2195;51;88;39;2;37;.949;3600000;0
26789;186549;45;99;36;1;35;.972;3600000;0
26789;66491;45;0;0;0;0;.00nan;0;0
26789;86360;51;0;0;0;0;.00nan;0;0
26790;165744;43;69;26;2;24;.923;3900000;0
26790;194264;41;0;0;0;0;.00nan;0;0
26790;64811;43;0;0;0;0;.00nan;0;0
26790;75313;41;94;42;2;40;.952;3900000;0
26791;163195;59;75;30;2;28;.933;3600000;0
26791;199481;57;0;0;0;0;.00nan;0;0
26791;186527;59;0;0;0;0;.00nan;0;0
26791;152418;57;92;45;3;42;.933;3557000;0
26792;161535;52;0;0;0;0;.00nan;0;0
26792;184081;52;56;29;4;25;.862;3582000;0
26792;181123;63;0;0;0;0;.00nan;0;0
26792;192457;63;66;32;3;29;.906;3600000;0
26793;4622;64;84;34;3;31;.912;3900000;0
26793;190465;37;0;0;0;0;.00nan;0;0
26793;202161;37;58;19;3;16;.842;3900000;0
26793;58037;64;0;0;0;0;.00nan;0;0
26794;184069;46;0;0;0;0;.00nan;0;0
26794;189639;54;0;0;0;0;.00nan;0;0
26794;201876;54;100;45;1;44;.978;3662000;0
26794;182049;46;69;26;2;24;.923;3662000;0
26795;183859;47;41;34;5;29;.853;3600000;0
26795;186495;47;0;0;0;0;.00nan;0;0
26795;84945;60;0;0;0;0;.00nan;0;0
26795;86862;60;100;39;0;39;1.000;3600000;0
26796;176915;62;66;23;2;21;.913;3600000;0
26796;196372;62;0;0;0;0;.00nan;0;0
26796;191026;48;61;35;4;31;.886;3600000;0
26796;142492;48;0;0;0;0;.00nan;0;0
26797;184610;49;0;0;0;0;.00nan;0;0
26797;176200;44;75;27;1;26;.963;3600000;0
26797;64911;44;0;0;0;0;.00nan;0;0
26797;79132;49;79;25;2;23;.920;3600000;0
26798;163195;59;0;0;0;0;.00nan;0;0
26798;194264;41;67;48;4;44;.917;3573000;0
26798;186527;59;53;21;3;18;.857;3600000;0
26798;75313;41;0;0;0;0;.00nan;0;0
26799;169226;65;0;0;0;0;.00nan;0;0
26799;169323;53;0;0;0;0;.00nan;0;0
26799;176938;65;98;35;1;34;.971;3581000;0
26799;91403;53;92;22;0;22;1.000;3600000;0
26800;2195;51;90;31;1;30;.968;3600000;0
26800;4622;64;0;0;0;0;.00nan;0;0
26800;58037;64;62;26;3;23;.885;3513000;0
26800;86360;51;0;0;0;0;.00nan;0;0
26801;170314;4619;90;34;2;32;.941;3866000;0
26801;185743;4837;0;0;0;0;.00nan;0;0
26801;187295;4837;75;22;1;21;.955;3898000;0
26801;78820;4619;0;0;0;0;.00nan;0;0
26802;171970;55;0;0;0;0;.00nan;0;0
26802;194502;55;74;28;3;25;.893;3579000;0
26802;173856;38;63;19;2;17;.895;3600000;0
26802;181102;38;0;0;0;0;.00nan;0;0
26803;189644;42;73;31;2;29;.935;3600000;0
26803;57215;50;0;0;0;0;.00nan;0;0
26803;141998;50;49;17;3;14;.824;3546000;0
26803;149450;42;0;0;0;0;.00nan;0;0
26804;190465;37;79;24;2;22;.917;3600000;0
26804;202161;37;0;0;0;0;.00nan;0;0
26804;186549;45;0;0;0;0;.00nan;0;0
26804;66491;45;98;49;3;46;.939;3600000;0
26805;192733;61;94;49;2;47;.959;3812000;0
26805;163565;40;79;31;1;30;.968;3812000;0
26805;-1;61;0;0;0;0;.00nan;0;0
26805;185812;40;0;0;0;0;.00nan;0;0
26806;184069;46;75;25;1;24;.960;3600000;0
26806;189639;54;47;24;4;20;.833;3600000;0
26806;201876;54;0;0;0;0;.00nan;0;0
26806;182049;46;0;0;0;0;.00nan;0;0
26807;13337;39;61;29;3;26;.897;3600000;0
26807;176921;58;0;0;0;0;.00nan;0;0
26807;38124;58;100;31;0;31;1.000;3600000;0
26807;197704;39;0;0;0;0;.00nan;0;0
26808;183859;47;66;16;1;15;.938;3600000;0
26808;186495;47;0;0;0;0;.00nan;0;0
26808;84945;60;28;10;3;7;.700;759000;0
26808;86862;60;31;34;7;27;.794;2841000;0
26809;189081;56;0;0;0;0;.00nan;0;0
26809;195089;36;0;0;0;0;.00nan;0;0
26809;187362;36;86;23;1;22;.957;3600000;0
26809;57207;56;53;35;5;30;.857;3600000;0
26810;161535;52;100;40;0;40;1.000;3600000;0
26810;165744;43;0;0;0;0;.00nan;0;0
26810;184081;52;0;0;0;0;.00nan;0;0
26810;64811;43;57;13;2;11;.846;3513000;0
26811;176200;44;0;0;0;0;.00nan;0;0
26811;185743;4837;27;21;5;16;.762;3517000;0
26811;187295;4837;0;0;0;0;.00nan;0;0
26811;64911;44;61;29;3;26;.897;3600000;0
26812;163195;59;60;39;5;34;.872;3571000;0
26812;165744;43;60;32;3;29;.906;3600000;0
26812;186527;59;0;0;0;0;.00nan;0;0
26812;64811;43;0;0;0;0;.00nan;0;0
26813;169226;65;92;40;2;38;.950;3784000;0
26813;169323;53;0;0;0;0;.00nan;0;0
26813;176938;65;0;0;0;0;.00nan;0;0
26813;91403;53;78;27;1;26;.963;3784000;0
26814;2195;51;76;28;2;26;.929;3600000;0
26814;4622;64;62;40;4;36;.900;3530000;0
26814;58037;64;0;0;0;0;.00nan;0;0
26814;86360;51;0;0;0;0;.00nan;0;0
26815;192733;61;86;33;2;31;.939;3570000;0
26815;170314;4619;92;37;1;36;.973;3600000;0
26815;-1;61;0;0;0;0;.00nan;0;0
26815;78820;4619;0;0;0;0;.00nan;0;0
26816;199481;57;0;0;0;0;.00nan;0;0
26816;194264;41;0;0;0;0;.00nan;0;0
26816;75313;41;82;31;3;28;.903;3560000;0
26816;152418;57;63;23;2;21;.913;3600000;0
26817;195089;36;71;30;2;28;.933;3900000;0
26817;181123;63;75;31;2;29;.935;3900000;0
26817;187362;36;0;0;0;0;.00nan;0;0
26817;192457;63;0;0;0;0;.00nan;0;0
26818;176915;62;0;0;0;0;.00nan;0;0
26818;196372;62;69;28;2;26;.929;3600000;0
26818;191026;48;94;37;3;34;.919;3545000;0
26818;142492;48;0;0;0;0;.00nan;0;0
26819;189081;56;48;20;3;17;.850;3580000;0
26819;176921;58;0;0;0;0;.00nan;0;0
26819;38124;58;92;38;2;36;.947;3600000;0
26819;57207;56;0;0;0;0;.00nan;0;0
26820;189639;54;0;0;0;0;.00nan;0;0
26820;201876;54;44;35;6;29;.829;3600000;0
26820;190465;37;0;0;0;0;.00nan;0;0
26820;202161;37;62;28;3;25;.893;3600000;0
26821;189644;42;74;29;2;27;.931;3600000;0
26821;57215;50;63;25;3;22;.880;3600000;0
26821;141998;50;0;0;0;0;.00nan;0;0
26821;149450;42;0;0;0;0;.00nan;0;0
26822;13337;39;76;31;3;28;.903;3898000;0
26822;181123;63;93;41;3;38;.927;3900000;0
26822;192457;63;0;0;0;0;.00nan;0;0
26822;197704;39;0;0;0;0;.00nan;0;0
26823;163565;40;64;23;2;21;.913;3600000;0
26823;176200;44;0;0;0;0;.00nan;0;0
26823;185812;40;0;0;0;0;.00nan;0;0
26823;64911;44;59;41;5;36;.878;3600000;0
26824;184069;46;63;13;1;12;.923;3600000;0
26824;182049;46;0;0;0;0;.00nan;0;0
26824;186549;45;97;43;2;41;.953;3562000;0
26824;66491;45;0;0;0;0;.00nan;0;0
26825;163195;59;85;37;2;35;.946;3600000;0
26825;194264;41;28;36;7;29;.806;3600000;0
26825;186527;59;0;0;0;0;.00nan;0;0
26825;75313;41;0;0;0;0;.00nan;0;0
26826;189639;54;0;0;0;0;.00nan;0;0
26826;201876;54;50;48;5;43;.896;3900000;0
26826;190465;37;0;0;0;0;.00nan;0;0
26826;202161;37;46;30;5;25;.833;3900000;0
26827;176921;58;42;20;3;17;.850;825000;0
26827;38124;58;26;36;7;29;.806;2775000;0
26827;64811;43;84;12;0;12;1.000;3600000;0
26827;78773;43;0;0;0;0;.00nan;0;0
26828;191026;48;0;0;0;0;.00nan;0;0
26828;84945;60;51;36;5;31;.861;3562000;0
26828;86862;60;0;0;0;0;.00nan;0;0
26828;142492;48;78;44;4;40;.909;3600000;0
26829;189081;56;0;0;0;0;.00nan;0;0
26829;181123;63;45;18;3;15;.833;3600000;0
26829;192457;63;0;0;0;0;.00nan;0;0
26829;57207;56;100;29;0;29;1.000;3600000;0
26830;170314;4619;63;37;4;33;.892;3600000;0
26830;184610;49;79;25;1;24;.960;3600000;0
26830;78820;4619;0;0;0;0;.00nan;0;0
26830;79132;49;0;0;0;0;.00nan;0;0
26831;161535;52;61;21;2;19;.905;3600000;0
26831;184081;52;0;0;0;0;.00nan;0;0
26831;173856;38;65;45;5;40;.889;3600000;0
26831;181102;38;0;0;0;0;.00nan;0;0
26832;4622;64;0;0;0;0;.00nan;0;0
26832;57215;50;0;0;0;0;.00nan;0;0
26832;58037;64;100;35;0;35;1.000;3600000;0
26832;141998;50;77;22;1;21;.955;3545000;0
26833;192733;61;72;39;4;35;.897;3600000;0
26833;-1;61;0;0;0;0;.00nan;0;0
26833;185743;4837;63;18;1;17;.944;3600000;0
26833;187295;4837;0;0;0;0;.00nan;0;0
26834;161535;52;0;0;0;0;.00nan;0;0
26834;184081;52;78;23;1;22;.957;3600000;0
26834;176921;58;98;49;2;47;.959;3600000;0
26834;38124;58;0;0;0;0;.00nan;0;0
26835;13337;39;63;41;5;36;.878;3600000;0
26835;197704;39;0;0;0;0;.00nan;0;0
26835;64811;43;59;12;1;11;.917;3600000;0
26835;78773;43;0;0;0;0;.00nan;0;0
26836;189644;42;84;27;1;26;.963;3600000;0
26836;176915;62;84;31;2;29;.935;3553000;0
26836;196372;62;0;0;0;0;.00nan;0;0
26836;149450;42;0;0;0;0;.00nan;0;0
26837;170314;4619;64;34;4;30;.882;3600000;0
26837;78820;4619;0;0;0;0;.00nan;0;0
26837;84945;60;0;0;0;0;.00nan;0;0
26837;86862;60;64;33;5;28;.848;3583000;0
26838;2195;51;89;16;0;16;1.000;3600000;0
26838;199481;57;0;0;0;0;.00nan;0;0
26838;86360;51;0;0;0;0;.00nan;0;0
26838;152418;57;62;33;4;29;.879;3600000;0
26839;189081;56;0;0;0;0;.00nan;0;0
26839;181123;63;43;16;4;12;.750;3691000;0
26839;192457;63;0;0;0;0;.00nan;0;0
26839;57207;56;68;33;3;30;.909;3691000;0
26840;184069;46;89;39;2;37;.949;3806000;0
26840;190465;37;0;0;0;0;.00nan;0;0
26840;202161;37;70;33;3;30;.909;3806000;0
26840;182049;46;0;0;0;0;.00nan;0;0
26841;184610;49;48;0;0;0;.00nan;241000;0
26841;191026;48;0;0;0;0;.00nan;0;0
26841;79132;49;25;29;7;22;.759;3359000;0
26841;142492;48;80;27;2;25;.926;3600000;0
26842;194264;41;49;16;2;14;.875;3552000;0
26842;169226;65;0;0;0;0;.00nan;0;0
26842;176938;65;90;45;1;44;.978;3600000;0
26842;75313;41;0;0;0;0;.00nan;0;0
26843;183859;47;97;31;1;30;.968;3600000;0
26843;176200;44;0;0;0;0;.00nan;0;0
26843;186495;47;0;0;0;0;.00nan;0;0
26843;64911;44;78;34;2;32;.941;3546000;0
26844;171970;55;0;0;0;0;.00nan;0;0
26844;194502;55;63;39;4;35;.897;3599000;0
26844;195089;36;0;0;0;0;.00nan;0;0
26844;187362;36;75;26;3;23;.885;3600000;0
26845;169323;53;0;0;0;0;.00nan;0;0
26845;173856;38;64;36;4;32;.889;3600000;0
26845;181102;38;0;0;0;0;.00nan;0;0
26845;91403;53;77;28;1;27;.964;3600000;0
26846;192733;61;70;43;5;38;.884;3600000;0
26846;-1;61;0;0;0;0;.00nan;0;0
26846;185743;4837;58;21;2;19;.905;3600000;0
26846;187295;4837;0;0;0;0;.00nan;0;0
26847;184069;46;0;0;0;0;.00nan;0;0
26847;182049;46;100;35;0;35;1.000;3600000;0
26847;186549;45;0;0;0;0;.00nan;0;0
26847;66491;45;49;32;5;27;.844;3600000;0
26848;2195;51;95;35;2;33;.943;3600000;0
26848;194264;41;0;0;0;0;.00nan;0;0
26848;75313;41;34;24;5;19;.792;3600000;0
26848;86360;51;0;0;0;0;.00nan;0;0
26849;176921;58;0;0;0;0;.00nan;0;0
26849;181123;63;54;24;3;21;.875;3548000;0
26849;38124;58;94;27;1;26;.963;3600000;0
26849;192457;63;0;0;0;0;.00nan;0;0
26850;13337;39;85;58;5;53;.914;3600000;0
26850;197704;39;0;0;0;0;.00nan;0;0
26850;64811;43;0;0;0;0;.00nan;0;0
26850;78773;43;64;14;1;13;.929;3600000;0
26851;189644;42;0;0;0;0;.00nan;0;0
26851;176915;62;46;32;5;27;.844;3600000;0
26851;196372;62;0;0;0;0;.00nan;0;0
26851;149450;42;22;27;6;21;.778;3600000;0
26852;4622;64;0;0;0;0;.00nan;0;0
26852;57215;50;87;31;1;30;.968;3600000;0
26852;58037;64;58;26;3;23;.885;3570000;0
26852;141998;50;0;0;0;0;.00nan;0;0
26853;189639;54;9;9;5;4;.444;681000;0
26853;201876;54;50;43;6;37;.860;2919000;0
26853;190465;37;93;19;0;19;1.000;3600000;0
26853;202161;37;0;0;0;0;.00nan;0;0
26854;163565;40;77;27;2;25;.926;3600000;0
26854;185812;40;0;0;0;0;.00nan;0;0
26854;84945;60;53;29;4;25;.862;3588000;0
26854;86862;60;0;0;0;0;.00nan;0;0
26855;184610;49;83;32;1;31;.969;3600000;0
26855;191026;48;79;38;4;34;.895;3600000;0
26855;79132;49;0;0;0;0;.00nan;0;0
26855;142492;48;0;0;0;0;.00nan;0;0
26856;199481;57;62;22;3;19;.864;3566000;0
26856;169226;65;100;36;1;35;.972;3600000;0
26856;176938;65;0;0;0;0;.00nan;0;0
26856;152418;57;0;0;0;0;.00nan;0;0
26857;171970;55;100;49;1;48;.980;3600000;0
26857;189081;56;53;24;3;21;.875;3528000;0
26857;194502;55;0;0;0;0;.00nan;0;0
26857;57207;56;0;0;0;0;.00nan;0;0
26858;183859;47;87;29;1;28;.966;3600000;0
26858;176200;44;78;36;2;34;.944;3600000;0
26858;186495;47;0;0;0;0;.00nan;0;0
26858;64911;44;0;0;0;0;.00nan;0;0
26859;161535;52;100;38;1;37;.974;3600000;0
26859;163195;59;60;27;3;24;.889;3554000;0
26859;184081;52;0;0;0;0;.00nan;0;0
26859;186527;59;0;0;0;0;.00nan;0;0
26860;163195;59;0;0;0;0;.00nan;0;0
26860;169226;65;0;0;0;0;.00nan;0;0
26860;176938;65;70;49;7;42;.857;3600000;0
26860;186527;59;76;13;0;13;1.000;3600000;0
26861;169323;53;87;28;1;27;.964;3572000;0
26861;173856;38;100;44;0;44;1.000;3600000;0
26861;181102;38;0;0;0;0;.00nan;0;0
26861;91403;53;0;0;0;0;.00nan;0;0
26862;4622;64;64;22;2;20;.909;3600000;0
26862;189639;54;59;38;5;33;.868;3600000;0
26862;201876;54;0;0;0;0;.00nan;0;0
26862;58037;64;0;0;0;0;.00nan;0;0
26863;186549;45;97;57;3;54;.947;3600000;0
26863;57215;50;0;0;0;0;.00nan;0;0
26863;66491;45;0;0;0;0;.00nan;0;0
26863;141998;50;22;29;7;22;.759;3600000;0
26864;2195;51;35;23;5;18;.783;3600000;0
26864;199481;57;55;3;0;3;1.000;245000;0
26864;86360;51;0;0;0;0;.00nan;0;0
26864;152418;57;41;37;6;31;.838;3345000;0
26865;171970;55;59;8;0;8;1.000;727000;0
26865;194502;55;25;28;7;21;.750;2873000;0
26865;195089;36;0;0;0;0;.00nan;0;0
26865;187362;36;67;15;1;14;.933;3600000;0
26866;185743;4837;85;16;0;16;1.000;3600000;0
26866;191026;48;65;38;4;34;.895;3600000;0
26866;187295;4837;0;0;0;0;.00nan;0;0
26866;142492;48;0;0;0;0;.00nan;0;0
26867;184610;49;0;0;0;0;.00nan;0;0
26867;79132;49;54;38;5;33;.868;3583000;0
26867;84945;60;0;0;0;0;.00nan;0;0
26867;86862;60;65;28;3;25;.893;3600000;0
26868;163565;40;73;43;4;39;.907;3900000;0
26868;184069;46;0;0;0;0;.00nan;0;0
26868;182049;46;81;43;4;39;.907;3900000;0
26868;185812;40;0;0;0;0;.00nan;0;0
26869;185743;4837;86;24;1;23;.958;3600000;0
26869;191026;48;0;0;0;0;.00nan;0;0
26869;187295;4837;0;0;0;0;.00nan;0;0
26869;142492;48;69;48;4;44;.917;3600000;0
26870;183859;47;77;34;3;31;.912;3600000;0
26870;176200;44;74;17;0;17;1.000;1463000;0
26870;186495;47;0;0;0;0;.00nan;0;0
26870;64911;44;34;31;6;25;.806;2137000;0
26871;189081;56;0;0;0;0;.00nan;0;0
26871;195089;36;0;0;0;0;.00nan;0;0
26871;187362;36;100;26;0;26;1.000;3600000;0
26871;57207;56;86;32;1;31;.969;3600000;0
26872;163195;59;0;0;0;0;.00nan;0;0
26872;186527;59;44;18;3;15;.833;3900000;0
26872;64811;43;56;23;3;20;.870;3900000;0
26872;78773;43;0;0;0;0;.00nan;0;0
26873;2195;51;53;36;5;31;.861;3514000;0
26873;13337;39;100;43;3;40;.930;3600000;0
26873;197704;39;0;0;0;0;.00nan;0;0
26873;86360;51;0;0;0;0;.00nan;0;0
26874;184610;49;40;38;6;32;.842;3600000;0
26874;78820;4619;68;22;2;20;.909;3600000;0
26874;79132;49;0;0;0;0;.00nan;0;0
26874;91391;4619;0;0;0;0;.00nan;0;0
26875;189639;54;0;0;0;0;.00nan;0;0
26875;201876;54;50;28;4;24;.857;3522000;0
26875;186549;45;0;0;0;0;.00nan;0;0
26875;66491;45;77;32;2;30;.938;3600000;0
26876;194264;41;85;33;2;31;.939;3600000;0
26876;169323;53;0;0;0;0;.00nan;0;0
26876;75313;41;0;0;0;0;.00nan;0;0
26876;91403;53;81;44;4;40;.909;3516000;0
26877;171970;55;0;0;0;0;.00nan;0;0
26877;194502;55;98;49;3;46;.939;3600000;0
26877;181123;63;0;0;0;0;.00nan;0;0
26877;192457;63;59;21;2;19;.905;3600000;0
26878;163565;40;0;0;0;0;.00nan;0;0
26878;184069;46;96;36;1;35;.972;3600000;0
26878;182049;46;0;0;0;0;.00nan;0;0
26878;185812;40;51;20;3;17;.850;3566000;0
26879;176200;44;0;0;0;0;.00nan;0;0
26879;64911;44;50;36;5;31;.861;3516000;0
26879;78820;4619;58;26;3;23;.885;3600000;0
26879;91391;4619;0;0;0;0;.00nan;0;0
26880;189081;56;0;0;0;0;.00nan;0;0
26880;181123;63;82;34;2;32;.941;3556000;0
26880;192457;63;0;0;0;0;.00nan;0;0
26880;57207;56;96;36;1;35;.972;3600000;0
26881;176915;62;55;36;5;31;.861;3599000;0
26881;196372;62;0;0;0;0;.00nan;0;0
26881;185743;4837;64;37;4;33;.892;3600000;0
26881;187295;4837;0;0;0;0;.00nan;0;0
26882;2195;51;67;15;1;14;.933;3600000;0
26882;4622;64;0;0;0;0;.00nan;0;0
26882;58037;64;93;44;3;41;.932;3534000;0
26882;86360;51;0;0;0;0;.00nan;0;0
26883;189639;54;80;27;2;25;.926;3600000;0
26883;201876;54;0;0;0;0;.00nan;0;0
26883;186549;45;47;34;5;29;.853;3600000;0
26883;66491;45;0;0;0;0;.00nan;0;0
26884;194264;41;0;0;0;0;.00nan;0;0
26884;64811;43;67;25;1;24;.960;3900000;0
26884;75313;41;99;41;1;40;.976;3900000;0
26884;78773;43;0;0;0;0;.00nan;0;0
26885;192733;61;0;0;0;0;.00nan;0;0
26885;183859;47;58;35;4;31;.886;3571000;0
26885;-1;61;93;52;3;49;.942;3600000;0
26885;186495;47;0;0;0;0;.00nan;0;0
26886;190465;37;0;0;0;0;.00nan;0;0
26886;202161;37;55;31;4;27;.871;3563000;0
26886;57215;50;63;27;3;24;.889;3600000;0
26886;141998;50;0;0;0;0;.00nan;0;0
26887;163565;40;79;37;3;34;.919;3600000;0
26887;185812;40;0;0;0;0;.00nan;0;0
26887;84945;60;0;0;0;0;.00nan;0;0
26887;86862;60;94;31;1;30;.968;3600000;0
26888;199481;57;0;0;0;0;.00nan;0;0
26888;169226;65;0;0;0;0;.00nan;0;0
26888;176938;65;87;27;1;26;.963;3600000;0
26888;152418;57;63;31;3;28;.903;3585000;0
26889;171970;55;0;0;0;0;.00nan;0;0
26889;13337;39;61;13;1;12;.923;3564000;0
26889;194502;55;100;38;0;38;1.000;3600000;0
26889;197704;39;0;0;0;0;.00nan;0;0
26890;173856;38;56;26;4;22;.846;3600000;0
26890;195089;36;0;0;0;0;.00nan;0;0
26890;-1;38;0;0;0;0;.00nan;0;0
26890;187362;36;100;32;0;32;1.000;3600000;0
26891;161535;52;68;29;3;26;.897;3788000;0
26891;184081;52;0;0;0;0;.00nan;0;0
26891;169323;53;0;0;0;0;.00nan;0;0
26891;91403;53;84;32;2;30;.938;3788000;0
26892;176200;44;80;40;3;37;.925;3600000;0
26892;191026;48;57;36;4;32;.889;3560000;0
26892;64911;44;0;0;0;0;.00nan;0;0
26892;142492;48;0;0;0;0;.00nan;0;0
26893;189081;56;84;34;2;32;.941;3600000;0
26893;181123;63;0;0;0;0;.00nan;0;0
26893;192457;63;64;16;1;15;.938;3600000;0
26893;57207;56;0;0;0;0;.00nan;0;0
26894;2195;51;75;43;3;40;.930;3883000;0
26894;4622;64;62;31;4;27;.871;3883000;0
26894;58037;64;0;0;0;0;.00nan;0;0
26894;86360;51;0;0;0;0;.00nan;0;0
26895;190465;37;53;18;3;15;.833;3558000;0
26895;202161;37;0;0;0;0;.00nan;0;0
26895;186549;45;0;0;0;0;.00nan;0;0
26895;66491;45;92;42;2;40;.952;3600000;0
26896;192733;61;51;39;6;33;.846;3600000;0
26896;183859;47;73;26;1;25;.962;3600000;0
26896;-1;61;0;0;0;0;.00nan;0;0
26896;186495;47;0;0;0;0;.00nan;0;0
26897;195089;36;78;41;3;38;.927;3580000;0
26897;176921;58;0;0;0;0;.00nan;0;0
26897;38124;58;89;34;1;33;.971;3600000;0
26897;187362;36;0;0;0;0;.00nan;0;0
26898;163195;59;52;14;2;12;.857;3600000;0
26898;173856;38;56;45;6;39;.867;3600000;0
26898;-1;38;0;0;0;0;.00nan;0;0
26898;186527;59;0;0;0;0;.00nan;0;0
26899;184069;46;37;38;6;32;.842;3600000;0
26899;189644;42;65;12;1;11;.917;3600000;0
26899;182049;46;0;0;0;0;.00nan;0;0
26899;149450;42;0;0;0;0;.00nan;0;0
26900;184610;49;0;0;0;0;.00nan;0;0
26900;78820;4619;0;0;0;0;.00nan;0;0
26900;79132;49;86;27;1;26;.963;3600000;0
26900;91391;4619;67;26;2;24;.923;3600000;0
26901;169226;65;34;37;7;30;.811;2202000;0
26901;176938;65;36;13;3;10;.769;1398000;0
26901;64811;43;0;0;0;0;.00nan;0;0
26901;78773;43;66;30;3;27;.900;3600000;0
26902;171970;55;0;0;0;0;.00nan;0;0
26902;13337;39;0;0;0;0;.00nan;0;0
26902;194502;55;65;43;5;38;.884;3600000;0
26902;197704;39;73;17;1;16;.941;3600000;0
26903;161535;52;0;0;0;0;.00nan;0;0
26903;184081;52;51;30;5;25;.833;3900000;0
26903;169323;53;68;46;5;41;.891;3900000;0
26903;91403;53;0;0;0;0;.00nan;0;0
26904;176915;62;89;26;1;25;.962;3600000;0
26904;196372;62;0;0;0;0;.00nan;0;0
26904;185743;4837;59;29;3;26;.897;3575000;0
26904;187295;4837;0;0;0;0;.00nan;0;0
26905;173856;38;54;27;3;24;.889;3600000;0
26905;176921;58;78;28;1;27;.964;3600000;0
26905;-1;38;0;0;0;0;.00nan;0;0
26905;38124;58;0;0;0;0;.00nan;0;0
26906;184069;46;0;0;0;0;.00nan;0;0
26906;189644;42;0;0;0;0;.00nan;0;0
26906;182049;46;93;44;1;43;.977;3883000;0
26906;149450;42;85;30;1;29;.967;3900000;0
26907;189639;54;0;0;0;0;.00nan;0;0
26907;201876;54;59;29;3;26;.897;3600000;0
26907;57215;50;0;0;0;0;.00nan;0;0
26907;141998;50;78;27;2;25;.926;3600000;0
26908;191026;48;0;0;0;0;.00nan;0;0
26908;84945;60;0;0;0;0;.00nan;0;0
26908;86862;60;40;22;4;18;.818;3600000;0
26908;142492;48;57;37;5;32;.865;3600000;0
26909;199481;57;0;0;0;0;.00nan;0;0
26909;194264;41;40;15;3;12;.800;3574000;0
26909;75313;41;0;0;0;0;.00nan;0;0
26909;152418;57;88;39;2;37;.949;3600000;0
26910;163195;59;58;16;2;14;.875;3600000;0
26910;169226;65;0;0;0;0;.00nan;0;0
26910;176938;65;60;46;6;40;.870;3600000;0
26910;186527;59;0;0;0;0;.00nan;0;0
26911;2195;51;80;33;2;31;.939;3600000;0
26911;186549;45;91;30;1;29;.967;3600000;0
26911;66491;45;0;0;0;0;.00nan;0;0
26911;86360;51;0;0;0;0;.00nan;0;0
26912;183859;47;67;39;4;35;.897;3534000;0
26912;176915;62;100;47;2;45;.957;3600000;0
26912;196372;62;0;0;0;0;.00nan;0;0
26912;186495;47;0;0;0;0;.00nan;0;0
26913;192733;61;68;36;4;32;.889;3568000;0
26913;-1;61;0;0;0;0;.00nan;0;0
26913;176200;44;0;0;0;0;.00nan;0;0
26913;64911;44;76;28;2;26;.929;3600000;0
26914;171970;55;0;0;0;0;.00nan;0;0
26914;3359;43;78;10;0;10;1.000;3600000;0
26914;194502;55;70;57;7;50;.877;3600000;0
26914;78773;43;0;0;0;0;.00nan;0;0
26915;189644;42;75;35;3;32;.914;3600000;0
26915;57215;50;46;26;4;22;.846;3568000;0
26915;141998;50;0;0;0;0;.00nan;0;0
26915;149450;42;0;0;0;0;.00nan;0;0
26916;191026;48;69;35;4;31;.886;3543000;0
26916;84945;60;0;0;0;0;.00nan;0;0
26916;86862;60;69;33;3;30;.909;3600000;0
26916;142492;48;0;0;0;0;.00nan;0;0
26917;163565;40;83;41;4;37;.902;3576000;0
26917;185812;40;0;0;0;0;.00nan;0;0
26917;78820;4619;81;35;3;32;.914;3600000;0
26917;91391;4619;0;0;0;0;.00nan;0;0
26918;13337;39;63;34;4;30;.882;3623000;0
26918;189081;56;0;0;0;0;.00nan;0;0
26918;197704;39;0;0;0;0;.00nan;0;0
26918;57207;56;58;33;5;28;.848;3624000;0
26919;183859;47;60;37;4;33;.892;3600000;0
26919;176915;62;80;26;1;25;.962;3600000;0
26919;196372;62;0;0;0;0;.00nan;0;0
26919;186495;47;0;0;0;0;.00nan;0;0
26920;176200;44;0;0;0;0;.00nan;0;0
26920;185743;4837;73;32;2;30;.938;3600000;0
26920;187295;4837;0;0;0;0;.00nan;0;0
26920;64911;44;85;45;4;41;.911;3600000;0
26921;169323;53;0;0;0;0;.00nan;0;0
26921;176921;58;0;0;0;0;.00nan;0;0
26921;38124;58;73;36;3;33;.917;3900000;0
26921;91403;53;83;37;3;34;.919;3900000;0
26922;4622;64;0;0;0;0;.00nan;0;0
26922;186549;45;0;0;0;0;.00nan;0;0
26922;58037;64;64;18;1;17;.944;3600000;0
26922;66491;45;81;41;3;38;.927;3595000;0
26923;199481;57;0;0;0;0;.00nan;0;0
26923;194264;41;78;26;1;25;.962;3600000;0
26923;75313;41;0;0;0;0;.00nan;0;0
26923;152418;57;98;55;2;53;.964;3587000;0
26924;192733;61;88;32;1;31;.969;3600000;0
26924;-1;61;0;0;0;0;.00nan;0;0
26924;191026;48;67;30;3;27;.900;3600000;0
26924;142492;48;0;0;0;0;.00nan;0;0
26925;2195;51;79;39;3;36;.923;3545000;0
26925;3359;43;81;20;1;19;.950;3600000;0
26925;78773;43;0;0;0;0;.00nan;0;0
26925;86360;51;0;0;0;0;.00nan;0;0
26926;161535;52;0;0;0;0;.00nan;0;0
26926;184081;52;55;17;2;15;.882;3600000;0
26926;173856;38;78;42;3;39;.929;3585000;0
26926;-1;38;0;0;0;0;.00nan;0;0
26927;171970;55;0;0;0;0;.00nan;0;0
26927;194502;55;75;39;4;35;.897;3600000;0
26927;181123;63;86;31;1;30;.968;3600000;0
26927;192457;63;0;0;0;0;.00nan;0;0
26928;163565;40;30;28;6;22;.786;3600000;0
26928;185812;40;0;0;0;0;.00nan;0;0
26928;78820;4619;79;39;3;36;.923;3600000;0
26928;91391;4619;0;0;0;0;.00nan;0;0
26929;163195;59;50;22;3;19;.864;3600000;0
26929;169226;65;0;0;0;0;.00nan;0;0
26929;176938;65;80;53;5;48;.906;3562000;0
26929;186527;59;0;0;0;0;.00nan;0;0
26930;184069;46;0;0;0;0;.00nan;0;0
26930;184610;49;94;36;1;35;.972;3600000;0
26930;182049;46;53;22;3;19;.864;3534000;0
26930;79132;49;0;0;0;0;.00nan;0;0
26931;13337;39;92;38;2;36;.947;3600000;0
26931;195089;36;0;0;0;0;.00nan;0;0
26931;187362;36;47;50;7;43;.860;3600000;0
26931;197704;39;0;0;0;0;.00nan;0;0
26932;176200;44;50;29;4;25;.862;3600000;0
26932;185743;4837;90;32;1;31;.969;3600000;0
26932;187295;4837;0;0;0;0;.00nan;0;0
26932;64911;44;0;0;0;0;.00nan;0;0
26933;163195;59;47;5;1;4;.800;329000;0
26933;194264;41;49;7;1;6;.857;640000;0
26933;186527;59;19;25;7;18;.720;3271000;0
26933;75313;41;23;40;8;32;.800;2938000;0
26934;176915;62;57;10;1;9;.900;3600000;0
26934;196372;62;0;0;0;0;.00nan;0;0
26934;84945;60;0;0;0;0;.00nan;0;0
26934;86862;60;84;39;3;36;.923;3575000;0
26935;169323;53;78;38;2;36;.947;3900000;0
26935;176921;58;100;48;2;46;.958;3900000;0
26935;38124;58;0;0;0;0;.00nan;0;0
26935;91403;53;0;0;0;0;.00nan;0;0
26936;4622;64;82;33;3;30;.909;3563000;0
26936;190465;37;0;0;0;0;.00nan;0;0
26936;202161;37;91;35;2;33;.943;3600000;0
26936;58037;64;0;0;0;0;.00nan;0;0
26937;183859;47;86;45;3;42;.933;3900000;0
26937;186495;47;0;0;0;0;.00nan;0;0
26937;78820;4619;0;0;0;0;.00nan;0;0
26937;91391;4619;77;34;3;31;.912;3900000;0
26938;192733;61;0;0;0;0;.00nan;0;0
26938;-1;61;45;18;3;15;.833;3593000;0
26938;191026;48;0;0;0;0;.00nan;0;0
26938;142492;48;89;33;2;31;.939;3600000;0
26939;189639;54;55;38;6;32;.842;3358000;0
26939;189644;42;28;20;5;15;.750;3600000;0
26939;201876;54;49;2;0;2;1.000;242000;0
26939;149450;42;0;0;0;0;.00nan;0;0
26940;2195;51;59;44;5;39;.886;3600000;0
26940;3359;43;71;22;2;20;.909;3600000;0
26940;78773;43;0;0;0;0;.00nan;0;0
26940;86360;51;0;0;0;0;.00nan;0;0
26941;186549;45;92;46;3;43;.935;3587000;0
26941;57215;50;0;0;0;0;.00nan;0;0
26941;66491;45;0;0;0;0;.00nan;0;0
26941;141998;50;78;28;2;26;.929;3600000;0
26942;13337;39;72;22;2;20;.909;3600000;0
26942;169226;65;57;44;6;38;.864;3600000;0
26942;176938;65;0;0;0;0;.00nan;0;0
26942;197704;39;0;0;0;0;.00nan;0;0
26943;171970;55;97;42;2;40;.952;3600000;0
26943;194502;55;0;0;0;0;.00nan;0;0
26943;181123;63;0;0;0;0;.00nan;0;0
26943;192457;63;67;17;1;16;.941;3600000;0
26944;184069;46;75;37;3;34;.919;3587000;0
26944;184610;49;0;0;0;0;.00nan;0;0
26944;182049;46;0;0;0;0;.00nan;0;0
26944;79132;49;87;31;1;30;.968;3600000;0
26945;189081;56;0;0;0;0;.00nan;0;0
26945;195089;36;98;42;2;40;.952;3569000;0
26945;187362;36;0;0;0;0;.00nan;0;0
26945;57207;56;96;23;0;23;1.000;3600000;0
26946;161535;52;77;27;2;25;.926;3600000;0
26946;184081;52;0;0;0;0;.00nan;0;0
26946;173856;38;48;25;4;21;.840;2078000;0
26946;-1;38;71;15;0;15;1.000;1522000;0
26947;163195;59;100;23;0;23;1.000;3600000;0
26947;173856;38;67;40;5;35;.875;3600000;0
26947;-1;38;0;0;0;0;.00nan;0;0
26947;186527;59;0;0;0;0;.00nan;0;0
26948;176915;62;85;17;0;17;1.000;3600000;0
26948;196372;62;0;0;0;0;.00nan;0;0
26948;84945;60;0;0;0;0;.00nan;0;0
26948;86862;60;74;29;3;26;.897;3600000;0
26949;4622;64;0;0;0;0;.00nan;0;0
26949;57215;50;6;14;6;8;.571;2341000;0
26949;58037;64;83;35;3;32;.914;3600000;0
26949;141998;50;66;9;0;9;1.000;1259000;0
26950;189639;54;0;0;0;0;.00nan;0;0
26950;189644;42;0;0;0;0;.00nan;0;0
26950;201876;54;57;46;6;40;.870;3600000;0
26950;149450;42;56;19;3;16;.842;3600000;0
26951;199481;57;0;0;0;0;.00nan;0;0
26951;169226;65;0;0;0;0;.00nan;0;0
26951;176938;65;68;26;2;24;.923;3819000;0
26951;152418;57;55;25;3;22;.880;3819000;0
26952;195089;36;0;0;0;0;.00nan;0;0
26952;181123;63;62;29;3;26;.897;3564000;0
26952;187362;36;67;22;2;20;.909;3600000;0
26952;192457;63;0;0;0;0;.00nan;0;0
26953;176200;44;0;0;0;0;.00nan;0;0
26953;191026;48;75;35;4;31;.886;3900000;0
26953;64911;44;72;40;4;36;.900;3900000;0
26953;142492;48;0;0;0;0;.00nan;0;0
26954;194264;41;66;24;3;21;.875;3544000;0
26954;169323;53;0;0;0;0;.00nan;0;0
26954;75313;41;0;0;0;0;.00nan;0;0
26954;91403;53;71;27;2;25;.926;3600000;0
26955;184069;46;0;0;0;0;.00nan;0;0
26955;190465;37;0;0;0;0;.00nan;0;0
26955;202161;37;100;37;0;37;1.000;3600000;0
26955;182049;46;53;26;4;22;.846;3600000;0
26956;192733;61;90;39;2;37;.949;3600000;0
26956;183859;47;53;26;3;23;.885;3567000;0
26956;-1;61;0;0;0;0;.00nan;0;0
26956;186495;47;0;0;0;0;.00nan;0;0
26957;176200;44;80;36;3;33;.917;3554000;0
26957;191026;48;0;0;0;0;.00nan;0;0
26957;64911;44;0;0;0;0;.00nan;0;0
26957;142492;48;86;28;1;27;.964;3600000;0
26958;189081;56;0;0;0;0;.00nan;0;0
26958;195089;36;0;0;0;0;.00nan;0;0
26958;187362;36;57;26;3;23;.885;3600000;0
26958;57207;56;73;37;3;34;.919;3545000;0
26959;194264;41;0;0;0;0;.00nan;0;0
26959;169323;53;95;26;0;26;1.000;3600000;0
26959;75313;41;53;33;4;29;.879;3600000;0
26959;91403;53;0;0;0;0;.00nan;0;0
26960;2195;51;71;18;1;17;.944;3600000;0
26960;186549;45;76;50;5;45;.900;3600000;0
26960;66491;45;0;0;0;0;.00nan;0;0
26960;86360;51;0;0;0;0;.00nan;0;0
26961;3359;43;79;40;3;37;.925;3560000;0
26961;163195;59;83;34;2;32;.941;3600000;0
26961;186527;59;0;0;0;0;.00nan;0;0
26961;78773;43;0;0;0;0;.00nan;0;0
26962;189644;42;54;15;2;13;.867;3540000;0
26962;57215;50;0;0;0;0;.00nan;0;0
26962;141998;50;100;39;0;39;1.000;3600000;0
26962;149450;42;0;0;0;0;.00nan;0;0
26963;163565;40;0;0;0;0;.00nan;0;0
26963;185812;40;64;44;5;39;.886;3664000;0
26963;84945;60;0;0;0;0;.00nan;0;0
26963;86862;60;64;37;4;33;.892;3664000;0
26964;171970;55;0;0;0;0;.00nan;0;0
26964;194502;55;88;28;1;27;.964;3600000;0
26964;181123;63;29;25;5;20;.800;3600000;0
26964;192457;63;0;0;0;0;.00nan;0;0
26965;184069;46;85;36;2;34;.944;3600000;0
26965;190465;37;0;0;0;0;.00nan;0;0
26965;202161;37;36;26;5;21;.808;3600000;0
26965;182049;46;0;0;0;0;.00nan;0;0
26966;192733;61;99;50;2;48;.960;3600000;0
26966;183859;47;62;30;3;27;.900;3581000;0
26966;-1;61;0;0;0;0;.00nan;0;0
26966;186495;47;0;0;0;0;.00nan;0;0
26967;161535;52;0;0;0;0;.00nan;0;0
26967;184081;52;100;33;0;33;1.000;3600000;0
26967;173856;38;76;31;1;30;.968;3600000;0
26967;-1;38;0;0;0;0;.00nan;0;0
26968;4622;64;0;0;0;0;.00nan;0;0
26968;189644;42;84;41;2;39;.951;3600000;0
26968;58037;64;49;26;3;23;.885;3595000;0
26968;149450;42;0;0;0;0;.00nan;0;0
26969;161535;52;0;0;0;0;.00nan;0;0
26969;2195;51;87;35;2;33;.943;3576000;0
26969;184081;52;70;21;1;20;.952;3600000;0
26969;86360;51;0;0;0;0;.00nan;0;0
26970;176915;62;77;27;2;25;.926;3702000;0
26970;196372;62;0;0;0;0;.00nan;0;0
26970;185743;4837;59;28;3;25;.893;3702000;0
26970;187295;4837;0;0;0;0;.00nan;0;0
26971;189639;54;90;34;1;33;.971;3600000;0
26971;201876;54;0;0;0;0;.00nan;0;0
26971;186549;45;61;17;1;16;.941;1476000;0
26971;66491;45;37;24;5;19;.792;2124000;0
26972;3359;43;44;24;4;20;.833;3900000;0
26972;163195;59;98;56;4;52;.929;3900000;0
26972;186527;59;0;0;0;0;.00nan;0;0
26972;78773;43;0;0;0;0;.00nan;0;0
26973;78820;4619;78;26;2;24;.923;3600000;0
26973;84945;60;50;33;5;28;.848;3600000;0
26973;86862;60;0;0;0;0;.00nan;0;0
26973;91391;4619;0;0;0;0;.00nan;0;0
26974;199481;57;0;0;0;0;.00nan;0;0
26974;173856;38;89;30;1;29;.967;3600000;0
26974;-1;38;0;0;0;0;.00nan;0;0
26974;152418;57;55;22;3;19;.864;3540000;0
26975;13337;39;99;25;1;24;.960;3600000;0
26975;181123;63;84;32;2;30;.938;3600000;0
26975;192457;63;0;0;0;0;.00nan;0;0
26975;197704;39;0;0;0;0;.00nan;0;0
26976;163565;40;77;36;3;33;.917;3600000;0
26976;185812;40;0;0;0;0;.00nan;0;0
26976;57215;50;0;0;0;0;.00nan;0;0
26976;141998;50;85;33;2;31;.939;3600000;0
26977;171970;55;0;0;0;0;.00nan;0;0
26977;189081;56;0;0;0;0;.00nan;0;0
26977;194502;55;47;29;4;25;.862;3600000;0
26977;57207;56;43;26;5;21;.808;3550000;0
26978;195089;36;86;26;1;25;.962;3600000;0
26978;176921;58;0;0;0;0;.00nan;0;0
26978;38124;58;66;34;4;30;.882;3600000;0
26978;187362;36;0;0;0;0;.00nan;0;0
26979;192733;61;97;29;1;28;.966;3600000;0
26979;-1;61;0;0;0;0;.00nan;0;0
26979;191026;48;51;28;4;24;.857;3600000;0
26979;142492;48;0;0;0;0;.00nan;0;0
26980;176200;44;0;0;0;0;.00nan;0;0
26980;64911;44;88;38;2;36;.947;3600000;0
26980;84945;60;0;0;0;0;.00nan;0;0
26980;86862;60;30;24;5;19;.792;3600000;0
26981;163195;59;75;30;2;28;.933;3600000;0
26981;189081;56;90;56;5;51;.911;3600000;0
26981;186527;59;0;0;0;0;.00nan;0;0
26981;57207;56;0;0;0;0;.00nan;0;0
26982;169226;65;0;0;0;0;.00nan;0;0
26982;169323;53;59;25;4;21;.840;3900000;0
26982;176938;65;96;59;4;55;.932;3900000;0
26982;91403;53;0;0;0;0;.00nan;0;0
26983;4622;64;84;46;3;43;.935;3523000;0
26983;189644;42;0;0;0;0;.00nan;0;0
26983;58037;64;0;0;0;0;.00nan;0;0
26983;149450;42;66;21;1;20;.952;3600000;0
26984;161535;52;91;32;2;30;.938;3600000;0
26984;2195;51;46;36;5;31;.861;3600000;0
26984;184081;52;0;0;0;0;.00nan;0;0
26984;86360;51;0;0;0;0;.00nan;0;0
26985;176915;62;40;24;5;19;.792;3600000;0
26985;196372;62;0;0;0;0;.00nan;0;0
26985;185743;4837;82;31;1;30;.968;3600000;0
26985;187295;4837;0;0;0;0;.00nan;0;0
26986;189639;54;0;0;0;0;.00nan;0;0
26986;201876;54;80;32;1;31;.969;3600000;0
26986;186549;45;53;36;6;30;.833;3600000;0
26986;66491;45;0;0;0;0;.00nan;0;0
26987;194264;41;67;13;1;12;.923;3600000;0
26987;195089;36;0;0;0;0;.00nan;0;0
26987;187362;36;61;37;4;33;.892;3600000;0
26987;75313;41;0;0;0;0;.00nan;0;0
26988;171970;55;90;41;2;39;.951;3600000;0
26988;194502;55;0;0;0;0;.00nan;0;0
26988;176921;58;84;16;0;16;1.000;3600000;0
26988;38124;58;0;0;0;0;.00nan;0;0
26989;199481;57;83;13;0;13;1.000;3600000;0
26989;173856;38;29;32;7;25;.781;2372000;0
26989;-1;38;50;13;2;11;.846;1228000;0
26989;152418;57;0;0;0;0;.00nan;0;0
26990;184610;49;0;0;0;0;.00nan;0;0
26990;190465;37;0;0;0;0;.00nan;0;0
26990;202161;37;66;28;3;25;.893;3576000;0
26990;79132;49;85;32;1;31;.969;3600000;0
26991;163565;40;75;19;1;18;.947;1586000;0
26991;185812;40;31;30;6;24;.800;2014000;0
26991;57215;50;55;35;4;31;.886;3600000;0
26991;141998;50;0;0;0;0;.00nan;0;0
26992;13337;39;0;0;0;0;.00nan;0;0
26992;181123;63;0;0;0;0;.00nan;0;0
26992;192457;63;74;44;4;40;.909;3900000;0
26992;197704;39;42;18;4;14;.778;3900000;0
26993;183859;47;33;21;6;15;.714;3600000;0
26993;184069;46;0;0;0;0;.00nan;0;0
26993;182049;46;97;35;1;34;.971;3600000;0
26993;186495;47;0;0;0;0;.00nan;0;0
26994;192733;61;70;30;2;28;.933;3600000;0
26994;-1;61;0;0;0;0;.00nan;0;0
26994;191026;48;0;0;0;0;.00nan;0;0
26994;142492;48;73;45;4;41;.911;3600000;0
26995;169226;65;80;54;5;49;.907;3600000;0
26995;169323;53;0;0;0;0;.00nan;0;0
26995;176938;65;0;0;0;0;.00nan;0;0
26995;91403;53;61;18;2;16;.889;3600000;0
26996;4622;64;0;0;0;0;.00nan;0;0
26996;189639;54;46;32;5;27;.844;3600000;0
26996;201876;54;0;0;0;0;.00nan;0;0
26996;58037;64;96;21;0;21;1.000;3600000;0
26997;194264;41;0;0;0;0;.00nan;0;0
26997;176921;58;52;49;7;42;.857;3281000;0
26997;38124;58;51;4;0;4;1.000;319000;0
26997;75313;41;47;20;3;17;.850;3600000;0
26998;184610;49;59;37;4;33;.892;3571000;0
26998;190465;37;56;24;3;21;.875;3600000;0
26998;202161;37;0;0;0;0;.00nan;0;0
26998;79132;49;0;0;0;0;.00nan;0;0
26999;3359;43;38;17;4;13;.765;3743000;0
26999;13337;39;99;60;3;57;.950;3743000;0
26999;197704;39;0;0;0;0;.00nan;0;0
26999;78773;43;0;0;0;0;.00nan;0;0
27000;183859;47;0;0;0;0;.00nan;0;0
27000;184069;46;0;0;0;0;.00nan;0;0
27000;182049;46;100;34;1;33;.971;3600000;0
27000;186495;47;62;28;3;25;.893;3529000;0
27001;176200;44;0;0;0;0;.00nan;0;0
27001;176915;62;97;24;0;24;1.000;3600000;0
27001;196372;62;0;0;0;0;.00nan;0;0
27001;64911;44;87;32;1;31;.969;3545000;0
27002;185743;4837;57;22;2;20;.909;3600000;0
27002;187295;4837;0;0;0;0;.00nan;0;0
27002;57215;50;0;0;0;0;.00nan;0;0
27002;141998;50;53;25;4;21;.840;3569000;0
27003;189644;42;35;25;5;20;.800;3600000;0
27003;186549;45;85;41;2;39;.951;3600000;0
27003;66491;45;0;0;0;0;.00nan;0;0
27003;149450;42;0;0;0;0;.00nan;0;0
27004;176200;44;97;46;3;43;.935;3571000;0
27004;176915;62;55;11;1;10;.909;3600000;0
27004;196372;62;0;0;0;0;.00nan;0;0
27004;64911;44;0;0;0;0;.00nan;0;0
27005;184069;46;0;0;0;0;.00nan;0;0
27005;182049;46;69;24;1;23;.958;3600000;0
27005;78820;4619;98;44;2;42;.955;3571000;0
27005;91391;4619;0;0;0;0;.00nan;0;0
27006;185743;4837;93;28;1;27;.964;3900000;0
27006;187295;4837;0;0;0;0;.00nan;0;0
27006;57215;50;95;39;1;38;.974;3900000;0
27006;141998;50;0;0;0;0;.00nan;0;0
27007;169226;65;0;0;0;0;.00nan;0;0
27007;173856;38;0;0;0;0;.00nan;0;0
27007;176938;65;93;38;1;37;.974;3600000;0
27007;-1;38;66;24;2;22;.917;3600000;0
27008;189644;42;0;0;0;0;.00nan;0;0
27008;186549;45;0;0;0;0;.00nan;0;0
27008;66491;45;88;38;3;35;.921;3900000;0
27008;149450;42;60;28;3;25;.893;3900000;0
27009;183859;47;81;41;2;39;.951;3600000;0
27009;186495;47;0;0;0;0;.00nan;0;0
27009;84945;60;0;0;0;0;.00nan;0;0
27009;86862;60;59;35;4;31;.886;3600000;0
27010;194264;41;85;16;0;16;1.000;3600000;0
27010;181123;63;68;48;6;42;.875;3225000;0
27010;192457;63;43;4;1;3;.750;375000;0
27010;75313;41;0;0;0;0;.00nan;0;0
27011;4622;64;0;0;0;0;.00nan;0;0
27011;190465;37;56;5;0;5;1.000;751000;0
27011;202161;37;1;19;7;12;.632;2849000;0
27011;58037;64;67;28;2;26;.929;3600000;0
27012;163565;40;86;29;2;27;.931;3600000;0
27012;184610;49;0;0;0;0;.00nan;0;0
27012;185812;40;0;0;0;0;.00nan;0;0
27012;79132;49;62;37;4;33;.892;3582000;0
27013;2195;51;61;17;2;15;.882;3600000;0
27013;176921;58;0;0;0;0;.00nan;0;0
27013;38124;58;76;32;3;29;.906;3600000;0
27013;86360;51;0;0;0;0;.00nan;0;0
27014;176200;44;73;25;2;23;.920;2818000;0
27014;64911;44;38;21;4;17;.810;1082000;0
27014;78820;4619;40;29;6;23;.793;3262000;0
27014;91391;4619;57;6;0;6;1.000;638000;0
27015;3359;43;47;12;2;10;.833;3600000;0
27015;189081;56;0;0;0;0;.00nan;0;0
27015;57207;56;90;62;5;57;.919;3600000;0
27015;78773;43;0;0;0;0;.00nan;0;0
27016;4622;64;0;0;0;0;.00nan;0;0
27016;189639;54;0;0;0;0;.00nan;0;0
27016;201876;54;74;43;4;39;.907;3600000;0
27016;58037;64;87;17;0;17;1.000;3600000;0
27017;176915;62;30;19;5;14;.737;3600000;0
27017;196372;62;0;0;0;0;.00nan;0;0
27017;84945;60;0;0;0;0;.00nan;0;0
27017;86862;60;61;43;5;38;.884;3582000;0
27018;13337;39;94;27;1;26;.963;3900000;0
27018;181123;63;83;25;1;24;.960;3900000;0
27018;192457;63;0;0;0;0;.00nan;0;0
27018;197704;39;0;0;0;0;.00nan;0;0
27019;163565;40;85;25;1;24;.960;3600000;0
27019;184069;46;0;0;0;0;.00nan;0;0
27019;182049;46;56;30;5;25;.833;3600000;0
27019;185812;40;0;0;0;0;.00nan;0;0
27020;169226;65;0;0;0;0;.00nan;0;0
27020;169323;53;0;0;0;0;.00nan;0;0
27020;176938;65;79;46;5;41;.891;3600000;0
27020;91403;53;63;23;2;21;.913;3600000;0
27021;161535;52;0;0;0;0;.00nan;0;0
27021;171970;55;0;0;0;0;.00nan;0;0
27021;194502;55;77;39;4;35;.897;3600000;0
27021;184081;52;67;20;1;19;.950;3600000;0
27022;163195;59;54;22;3;19;.864;3665000;0
27022;195089;36;0;0;0;0;.00nan;0;0
27022;186527;59;0;0;0;0;.00nan;0;0
27022;187362;36;100;56;2;54;.964;3665000;0
27023;3359;43;68;15;1;14;.933;3600000;0
27023;189081;56;72;42;4;38;.905;3600000;0
27023;57207;56;0;0;0;0;.00nan;0;0
27023;78773;43;0;0;0;0;.00nan;0;0
27024;2195;51;0;0;0;0;.00nan;0;0
27024;176921;58;61;42;5;37;.881;3600000;0
27024;38124;58;0;0;0;0;.00nan;0;0
27024;86360;51;91;19;0;19;1.000;3600000;0
27025;184069;46;46;47;7;40;.851;3079000;0
27025;182049;46;53;2;0;2;1.000;521000;0
27025;78820;4619;0;0;0;0;.00nan;0;0
27025;91391;4619;64;23;2;21;.913;3600000;0
27026;4622;64;0;0;0;0;.00nan;0;0
27026;189639;54;56;22;2;20;.909;3600000;0
27026;201876;54;0;0;0;0;.00nan;0;0
27026;58037;64;68;32;3;29;.906;3549000;0
27027;163195;59;94;17;0;17;1.000;3600000;0
27027;173856;38;52;32;5;27;.844;3600000;0
27027;-1;38;0;0;0;0;.00nan;0;0
27027;186527;59;0;0;0;0;.00nan;0;0
27028;189644;42;93;19;0;19;1.000;3600000;0
27028;191026;48;74;35;3;32;.914;3600000;0
27028;142492;48;0;0;0;0;.00nan;0;0
27028;149450;42;0;0;0;0;.00nan;0;0
27029;192733;61;88;50;4;46;.920;3600000;0
27029;-1;61;0;0;0;0;.00nan;0;0
27029;57215;50;0;0;0;0;.00nan;0;0
27029;141998;50;46;31;5;26;.839;3600000;0
27030;199481;57;0;0;0;0;.00nan;0;0
27030;169323;53;81;15;0;15;1.000;3600000;0
27030;91403;53;0;0;0;0;.00nan;0;0
27030;152418;57;39;36;5;31;.861;3600000;0
27031;190465;37;0;0;0;0;.00nan;0;0
27031;202161;37;60;13;1;12;.923;3600000;0
27031;186549;45;74;47;4;43;.915;3600000;0
27031;66491;45;0;0;0;0;.00nan;0;0
27032;183859;47;90;34;1;33;.971;3600000;0
27032;184610;49;0;0;0;0;.00nan;0;0
27032;186495;47;0;0;0;0;.00nan;0;0
27032;79132;49;89;37;2;35;.946;3588000;0
27033;171970;55;0;0;0;0;.00nan;0;0
27033;194502;55;59;30;3;27;.900;3537000;0
27033;169226;65;87;31;1;30;.968;3600000;0
27033;176938;65;0;0;0;0;.00nan;0;0
27034;13337;39;0;0;0;0;.00nan;0;0
27034;194264;41;37;12;3;9;.750;3600000;0
27034;197704;39;75;42;4;38;.905;3600000;0
27034;75313;41;0;0;0;0;.00nan;0;0
27035;161535;52;57;22;3;19;.864;3600000;0
27035;184081;52;0;0;0;0;.00nan;0;0
27035;195089;36;40;35;6;29;.829;3600000;0
27035;187362;36;0;0;0;0;.00nan;0;0
27036;194264;41;0;0;0;0;.00nan;0;0
27036;189081;56;0;0;0;0;.00nan;0;0
27036;57207;56;99;43;1;42;.977;3600000;0
27036;75313;41;75;31;2;29;.935;3565000;0
27037;161535;52;0;0;0;0;.00nan;0;0
27037;184081;52;56;32;4;28;.875;3555000;0
27037;173856;38;66;31;3;28;.903;3600000;0
27037;-1;38;0;0;0;0;.00nan;0;0
27038;189644;42;60;26;3;23;.885;3779000;0
27038;191026;48;0;0;0;0;.00nan;0;0
27038;142492;48;78;45;4;41;.911;3779000;0
27038;149450;42;0;0;0;0;.00nan;0;0
27039;192733;61;87;47;3;44;.936;3590000;0
27039;-1;61;0;0;0;0;.00nan;0;0
27039;57215;50;78;25;2;23;.920;3600000;0
27039;141998;50;0;0;0;0;.00nan;0;0
27040;176200;44;68;35;4;31;.886;3600000;0
27040;64911;44;0;0;0;0;.00nan;0;0
27040;84945;60;0;0;0;0;.00nan;0;0
27040;86862;60;42;11;2;9;.818;3600000;0
27041;171970;55;80;41;3;38;.927;3613000;0
27041;199481;57;72;30;2;28;.933;3613000;0
27041;194502;55;0;0;0;0;.00nan;0;0
27041;152418;57;0;0;0;0;.00nan;0;0
27042;195089;36;0;0;0;0;.00nan;0;0
27042;181123;63;0;0;0;0;.00nan;0;0
27042;187362;36;74;37;4;33;.892;3600000;0
27042;192457;63;100;25;0;25;1.000;3600000;0
27043;163565;40;0;0;0;0;.00nan;0;0
27043;176915;62;74;25;3;22;.880;3900000;0
27043;196372;62;0;0;0;0;.00nan;0;0
27043;185812;40;86;34;3;31;.912;3900000;0
27044;183859;47;65;27;3;24;.889;3899000;0
27044;184610;49;100;51;2;49;.961;3899000;0
27044;186495;47;0;0;0;0;.00nan;0;0
27044;79132;49;0;0;0;0;.00nan;0;0
27045;3359;43;0;0;0;0;.00nan;0;0
27045;13337;39;55;38;4;34;.895;3166000;0
27045;197704;39;52;2;0;2;1.000;434000;0
27045;78773;43;95;36;1;35;.972;3600000;0
27046;176915;62;69;22;2;20;.909;3600000;0
27046;196372;62;0;0;0;0;.00nan;0;0
27046;78820;4619;97;50;3;47;.940;3589000;0
27046;91391;4619;0;0;0;0;.00nan;0;0
27047;199481;57;0;0;0;0;.00nan;0;0
27047;176921;58;36;24;5;19;.792;3600000;0
27047;38124;58;0;0;0;0;.00nan;0;0
27047;152418;57;59;39;6;33;.846;3586000;0
27048;189639;54;0;0;0;0;.00nan;0;0
27048;201876;54;62;34;5;29;.853;3600000;0
27048;57215;50;0;0;0;0;.00nan;0;0
27048;141998;50;76;24;1;23;.958;3600000;0
27049;176915;62;0;0;0;0;.00nan;0;0
27049;196372;62;100;38;2;36;.947;3900000;0
27049;78820;4619;79;36;2;34;.944;3900000;0
27049;91391;4619;0;0;0;0;.00nan;0;0
27050;4622;64;0;0;0;0;.00nan;0;0
27050;190465;37;0;0;0;0;.00nan;0;0
27050;202161;37;74;29;2;27;.931;3600000;0
27050;58037;64;72;34;3;31;.912;3544000;0
27051;2195;51;86;31;2;29;.935;3900000;0
27051;186549;45;90;45;2;43;.956;3900000;0
27051;66491;45;0;0;0;0;.00nan;0;0
27051;86360;51;0;0;0;0;.00nan;0;0
27052;194264;41;80;42;3;39;.929;3532000;0
27052;169323;53;87;31;1;30;.968;3600000;0
27052;75313;41;0;0;0;0;.00nan;0;0
27052;91403;53;0;0;0;0;.00nan;0;0
27053;13337;39;47;41;6;35;.854;3600000;0
27053;189644;42;70;29;2;27;.931;3600000;0
27053;197704;39;0;0;0;0;.00nan;0;0
27053;149450;42;0;0;0;0;.00nan;0;0
27054;184610;49;65;35;4;31;.886;3600000;0
27054;79132;49;0;0;0;0;.00nan;0;0
27054;84945;60;0;0;0;0;.00nan;0;0
27054;86862;60;56;23;3;20;.870;3600000;0
27055;171970;55;0;0;0;0;.00nan;0;0
27055;194502;55;82;41;3;38;.927;3662000;0
27055;181123;63;81;30;2;28;.933;3662000;0
27055;192457;63;0;0;0;0;.00nan;0;0
27056;3359;43;41;12;2;10;.833;3600000;0
27056;195089;36;90;50;4;46;.920;3548000;0
27056;187362;36;0;0;0;0;.00nan;0;0
27056;78773;43;0;0;0;0;.00nan;0;0
27057;163195;59;100;26;0;26;1.000;3600000;0
27057;169323;53;0;0;0;0;.00nan;0;0
27057;186527;59;0;0;0;0;.00nan;0;0
27057;91403;53;33;42;7;35;.833;3600000;0
27058;184610;49;68;42;4;38;.905;3600000;0
27058;176915;62;65;23;2;21;.913;3600000;0
27058;196372;62;0;0;0;0;.00nan;0;0
27058;79132;49;0;0;0;0;.00nan;0;0
27059;4622;64;0;0;0;0;.00nan;0;0
27059;186549;45;42;31;6;25;.806;2519000;0
27059;58037;64;64;29;3;26;.897;3600000;0
27059;66491;45;46;12;2;10;.833;1081000;0
27060;185743;4837;52;16;2;14;.875;3600000;0
27060;191026;48;0;0;0;0;.00nan;0;0
27060;187295;4837;0;0;0;0;.00nan;0;0
27060;142492;48;92;52;4;48;.923;3600000;0
27061;194264;41;37;22;5;17;.773;3543000;0
27061;169226;65;0;0;0;0;.00nan;0;0
27061;176938;65;69;37;4;33;.892;3600000;0
27061;75313;41;0;0;0;0;.00nan;0;0
27062;192733;61;99;27;1;26;.963;3600000;0
27062;-1;61;0;0;0;0;.00nan;0;0
27062;176200;44;65;37;3;34;.919;3559000;0
27062;64911;44;0;0;0;0;.00nan;0;0
27063;3359;43;78;11;0;11;1.000;3600000;0
27063;189081;56;48;0;0;0;.00nan;278000;0
27063;57207;56;69;59;7;52;.881;3322000;0
27063;78773;43;0;0;0;0;.00nan;0;0
27064;13337;39;38;34;6;28;.824;3600000;0
27064;189644;42;0;0;0;0;.00nan;0;0
27064;197704;39;0;0;0;0;.00nan;0;0
27064;149450;42;80;15;0;15;1.000;3600000;0
27065;190465;37;0;0;0;0;.00nan;0;0
27065;202161;37;83;35;2;33;.943;3600000;0
27065;57215;50;66;37;4;33;.892;3513000;0
27065;141998;50;0;0;0;0;.00nan;0;0
27066;171970;55;0;0;0;0;.00nan;0;0
27066;194502;55;90;43;3;40;.930;3900000;0
27066;173856;38;66;28;3;25;.893;3900000;0
27066;-1;38;0;0;0;0;.00nan;0;0
27067;184069;46;0;0;0;0;.00nan;0;0
27067;189639;54;0;0;0;0;.00nan;0;0
27067;201876;54;61;47;6;41;.872;3835000;0
27067;182049;46;45;32;5;27;.844;3835000;0
27068;163565;40;0;0;0;0;.00nan;0;0
27068;183859;47;100;33;0;33;1.000;3600000;0
27068;185812;40;73;28;2;26;.929;3596000;0
27068;186495;47;0;0;0;0;.00nan;0;0
27069;199481;57;0;0;0;0;.00nan;0;0
27069;195089;36;0;0;0;0;.00nan;0;0
27069;187362;36;85;26;1;25;.962;3600000;0
27069;152418;57;73;38;4;34;.895;3600000;0
27070;163195;59;0;0;0;0;.00nan;0;0
27070;169323;53;50;32;4;28;.875;1999000;0
27070;186527;59;71;33;3;30;.909;3600000;0
27070;91403;53;60;15;1;14;.933;1517000;0
27071;4622;64;98;50;3;47;.940;3536000;0
27071;190465;37;70;22;1;21;.955;3600000;0
27071;202161;37;0;0;0;0;.00nan;0;0
27071;58037;64;0;0;0;0;.00nan;0;0
27072;2195;51;85;24;1;23;.958;3600000;0
27072;181123;63;76;37;3;34;.919;3558000;0
27072;192457;63;0;0;0;0;.00nan;0;0
27072;86360;51;0;0;0;0;.00nan;0;0
27073;185743;4837;74;24;1;23;.958;3600000;0
27073;191026;48;74;52;6;46;.885;3600000;0
27073;187295;4837;0;0;0;0;.00nan;0;0
27073;142492;48;0;0;0;0;.00nan;0;0
27074;194264;41;0;0;0;0;.00nan;0;0
27074;176921;58;70;36;4;32;.889;3600000;0
27074;38124;58;0;0;0;0;.00nan;0;0
27074;75313;41;47;32;5;27;.844;3547000;0
27075;192733;61;0;0;0;0;.00nan;0;0
27075;-1;61;67;45;6;39;.867;3600000;0
27075;78820;4619;66;17;1;16;.941;3600000;0
27075;91391;4619;0;0;0;0;.00nan;0;0
27076;3359;43;71;18;1;17;.944;3600000;0
27076;189081;56;60;56;7;49;.875;3600000;0
27076;57207;56;0;0;0;0;.00nan;0;0
27076;78773;43;0;0;0;0;.00nan;0;0
27077;186549;45;0;0;0;0;.00nan;0;0
27077;57215;50;0;0;0;0;.00nan;0;0
27077;66491;45;57;42;6;36;.857;3600000;0
27077;141998;50;25;18;5;13;.722;3600000;0
27078;176200;44;0;0;0;0;.00nan;0;0
27078;64911;44;89;37;3;34;.919;3900000;0
27078;84945;60;68;33;3;30;.909;3900000;0
27078;86862;60;0;0;0;0;.00nan;0;0
27079;171970;55;68;28;2;26;.929;3600000;0
27079;199481;57;57;23;3;20;.870;3585000;0
27079;194502;55;0;0;0;0;.00nan;0;0
27079;152418;57;0;0;0;0;.00nan;0;0
27080;184069;46;43;22;4;18;.818;3584000;0
27080;189639;54;67;34;2;32;.941;3600000;0
27080;201876;54;0;0;0;0;.00nan;0;0
27080;182049;46;0;0;0;0;.00nan;0;0
27081;163565;40;69;36;4;32;.889;3600000;0
27081;183859;47;100;27;0;27;1.000;3600000;0
27081;185812;40;0;0;0;0;.00nan;0;0
27081;186495;47;0;0;0;0;.00nan;0;0
27082;169226;65;70;31;2;29;.935;3600000;0
27082;195089;36;38;23;4;19;.826;3515000;0
27082;176938;65;0;0;0;0;.00nan;0;0
27082;187362;36;0;0;0;0;.00nan;0;0
27083;161535;52;0;0;0;0;.00nan;0;0
27083;184081;52;73;36;4;32;.889;3611000;0
27083;173856;38;51;30;5;25;.833;3611000;0
27083;-1;38;0;0;0;0;.00nan;0;0
27084;184610;49;61;38;5;33;.868;3600000;0
27084;176915;62;100;24;0;24;1.000;3600000;0
27084;196372;62;0;0;0;0;.00nan;0;0
27084;79132;49;0;0;0;0;.00nan;0;0
27085;189644;42;0;0;0;0;.00nan;0;0
27085;191026;48;91;46;4;42;.913;3600000;0
27085;142492;48;0;0;0;0;.00nan;0;0
27085;149450;42;56;23;3;20;.870;3600000;0
27086;163195;59;91;14;0;14;1.000;3600000;0
27086;195089;36;0;0;0;0;.00nan;0;0
27086;186527;59;0;0;0;0;.00nan;0;0
27086;187362;36;27;47;8;39;.830;3600000;0
27087;173856;38;67;28;3;25;.893;3600000;0
27087;176921;58;0;0;0;0;.00nan;0;0
27087;-1;38;0;0;0;0;.00nan;0;0
27087;38124;58;68;48;5;43;.896;3583000;0
27088;190465;37;0;0;0;0;.00nan;0;0
27088;202161;37;96;45;4;41;.911;3600000;0
27088;57215;50;0;0;0;0;.00nan;0;0
27088;141998;50;90;33;1;32;.970;3600000;0
27089;184069;46;0;0;0;0;.00nan;0;0
27089;182049;46;100;40;0;40;1.000;3600000;0
27089;185743;4837;50;23;3;20;.870;3600000;0
27089;187295;4837;0;0;0;0;.00nan;0;0
27090;189644;42;45;23;4;19;.826;3554000;0
27090;191026;48;0;0;0;0;.00nan;0;0
27090;142492;48;85;43;3;40;.930;3600000;0
27090;149450;42;0;0;0;0;.00nan;0;0
27091;183859;47;50;18;3;15;.833;3563000;0
27091;176200;44;100;48;2;46;.958;3600000;0
27091;186495;47;0;0;0;0;.00nan;0;0
27091;64911;44;0;0;0;0;.00nan;0;0
27092;4622;64;0;0;0;0;.00nan;0;0
27092;186549;45;37;36;6;30;.833;2284000;0
27092;58037;64;72;20;2;18;.900;3600000;0
27092;66491;45;55;11;1;10;.909;1316000;0
27093;163195;59;55;32;4;28;.875;3652000;0
27093;194264;41;78;42;3;39;.929;3652000;0
27093;186527;59;0;0;0;0;.00nan;0;0
27093;75313;41;0;0;0;0;.00nan;0;0
27094;192733;61;87;27;1;26;.963;3580000;0
27094;-1;61;0;0;0;0;.00nan;0;0
27094;84945;60;0;0;0;0;.00nan;0;0
27094;86862;60;79;15;0;15;1.000;3600000;0
27095;2195;51;34;25;5;20;.800;3600000;0
27095;181123;63;0;0;0;0;.00nan;0;0
27095;192457;63;68;44;4;40;.909;3600000;0
27095;86360;51;0;0;0;0;.00nan;0;0
27096;163565;40;74;24;2;22;.917;3900000;0
27096;184610;49;96;43;2;41;.953;3900000;0
27096;185812;40;0;0;0;0;.00nan;0;0
27096;79132;49;0;0;0;0;.00nan;0;0
27097;184069;46;0;0;0;0;.00nan;0;0
27097;182049;46;33;22;5;17;.773;3600000;0
27097;185743;4837;72;24;2;22;.917;3600000;0
27097;187295;4837;0;0;0;0;.00nan;0;0
27098;13337;39;0;0;0;0;.00nan;0;0
27098;169226;65;0;0;0;0;.00nan;0;0
27098;176938;65;86;38;3;35;.921;3600000;0
27098;197704;39;49;29;4;25;.862;3561000;0
27099;184610;49;39;8;2;6;.750;1588000;0
27099;78820;4619;82;29;2;27;.931;3600000;0
27099;79132;49;16;26;7;19;.731;2012000;0
27099;91391;4619;0;0;0;0;.00nan;0;0
27100;176200;44;67;42;4;38;.905;3597000;0
27100;176915;62;53;20;3;17;.850;3600000;0
27100;196372;62;0;0;0;0;.00nan;0;0
27100;64911;44;0;0;0;0;.00nan;0;0
27101;189081;56;0;0;0;0;.00nan;0;0
27101;169226;65;0;0;0;0;.00nan;0;0
27101;176938;65;67;31;4;27;.871;3558000;0
27101;57207;56;79;36;3;33;.917;3600000;0
27102;190465;37;0;0;0;0;.00nan;0;0
27102;202161;37;78;24;1;23;.958;3600000;0
27102;186549;45;79;40;3;37;.925;3586000;0
27102;66491;45;0;0;0;0;.00nan;0;0
27103;189639;54;0;0;0;0;.00nan;0;0
27103;176921;58;64;27;3;24;.889;3558000;0
27103;201876;54;87;40;2;38;.950;3600000;0
27103;38124;58;0;0;0;0;.00nan;0;0
27104;171970;55;0;0;0;0;.00nan;0;0
27104;3359;43;70;18;1;17;.944;3600000;0
27104;194502;55;74;47;5;42;.894;3600000;0
27104;78773;43;0;0;0;0;.00nan;0;0
27105;199481;57;0;0;0;0;.00nan;0;0
27105;173856;38;45;22;4;18;.818;3600000;0
27105;-1;38;0;0;0;0;.00nan;0;0
27105;152418;57;91;35;1;34;.971;3600000;0
27106;161535;52;89;26;1;25;.962;3600000;0
27106;2195;51;72;43;5;38;.884;3600000;0
27106;184081;52;0;0;0;0;.00nan;0;0
27106;86360;51;0;0;0;0;.00nan;0;0
27107;191026;48;42;37;6;31;.838;3600000;0
27107;78820;4619;72;22;2;20;.909;3600000;0
27107;91391;4619;0;0;0;0;.00nan;0;0
27107;142492;48;0;0;0;0;.00nan;0;0
27108;176200;44;0;0;0;0;.00nan;0;0
27108;176915;62;0;0;0;0;.00nan;0;0
27108;196372;62;78;13;0;13;1.000;3600000;0
27108;64911;44;98;62;3;59;.952;3600000;0
27109;171970;55;81;32;3;29;.906;3900000;0
27109;189081;56;68;23;3;20;.870;3900000;0
27109;194502;55;0;0;0;0;.00nan;0;0
27109;57207;56;0;0;0;0;.00nan;0;0
27110;161535;52;0;0;0;0;.00nan;0;0
27110;163195;59;78;23;1;22;.957;3900000;0
27110;184081;52;99;36;1;35;.972;3900000;0
27110;186527;59;0;0;0;0;.00nan;0;0
27111;194264;41;82;32;2;30;.938;3600000;0
27111;169323;53;0;0;0;0;.00nan;0;0
27111;75313;41;0;0;0;0;.00nan;0;0
27111;91403;53;50;27;4;23;.852;3562000;0
27112;192733;61;53;38;5;33;.868;3526000;0
27112;-1;61;0;0;0;0;.00nan;0;0
27112;185743;4837;54;21;3;18;.857;3600000;0
27112;187295;4837;0;0;0;0;.00nan;0;0
27113;189639;54;67;23;2;21;.913;3551000;0
27113;176921;58;0;0;0;0;.00nan;0;0
27113;201876;54;0;0;0;0;.00nan;0;0
27113;38124;58;87;29;1;28;.966;3600000;0
27114;3359;43;0;0;0;0;.00nan;0;0
27114;169226;65;100;40;0;40;1.000;3600000;0
27114;176938;65;0;0;0;0;.00nan;0;0
27114;78773;43;69;21;1;20;.952;3547000;0
27115;2195;51;73;28;2;26;.929;3600000;0
27115;173856;38;0;0;0;0;.00nan;0;0
27115;-1;38;37;23;4;19;.826;3568000;0
27115;86360;51;0;0;0;0;.00nan;0;0
27116;4622;64;0;0;0;0;.00nan;0;0
27116;189644;42;79;32;2;30;.938;3600000;0
27116;58037;64;57;33;4;29;.879;3577000;0
27116;149450;42;0;0;0;0;.00nan;0;0
27117;184610;49;78;50;5;45;.900;3600000;0
27117;79132;49;0;0;0;0;.00nan;0;0
27117;84945;60;0;0;0;0;.00nan;0;0
27117;86862;60;94;21;0;21;1.000;3600000;0
27118;199481;57;61;30;4;26;.867;3576000;0
27118;181123;63;70;33;3;30;.909;3600000;0
27118;192457;63;0;0;0;0;.00nan;0;0
27118;152418;57;0;0;0;0;.00nan;0;0
27119;190465;37;56;20;2;18;.900;3570000;0
27119;202161;37;0;0;0;0;.00nan;0;0
27119;186549;45;0;0;0;0;.00nan;0;0
27119;66491;45;99;50;1;49;.980;3600000;0
27120;163565;40;0;0;0;0;.00nan;0;0
27120;183859;47;94;35;2;33;.943;3600000;0
27120;185812;40;47;33;5;28;.848;3600000;0
27120;186495;47;0;0;0;0;.00nan;0;0
27121;184069;46;89;37;2;35;.946;3600000;0
27121;182049;46;0;0;0;0;.00nan;0;0
27121;57215;50;68;9;0;9;1.000;1328000;0
27121;141998;50;23;19;5;14;.737;2272000;0
27122;13337;39;45;22;4;18;.818;3600000;0
27122;195089;36;0;0;0;0;.00nan;0;0
27122;187362;36;86;30;1;29;.967;3600000;0
27122;197704;39;0;0;0;0;.00nan;0;0
27123;191026;48;64;20;1;19;.950;1378000;0
27123;78820;4619;62;17;2;15;.882;3600000;0
27123;91391;4619;0;0;0;0;.00nan;0;0
27123;142492;48;37;29;5;24;.828;2222000;0
27124;163195;59;0;0;0;0;.00nan;0;0
27124;181123;63;89;53;2;51;.962;3560000;0
27124;186527;59;88;18;0;18;1.000;3600000;0
27124;192457;63;0;0;0;0;.00nan;0;0
27125;194264;41;45;5;1;4;.800;787000;0
27125;169323;53;53;31;4;27;.871;3600000;0
27125;75313;41;13;23;6;17;.739;2813000;0
27125;91403;53;0;0;0;0;.00nan;0;0
27126;192733;61;83;34;2;32;.941;3600000;0
27126;-1;61;0;0;0;0;.00nan;0;0
27126;185743;4837;67;21;1;20;.952;3600000;0
27126;187295;4837;0;0;0;0;.00nan;0;0
27127;4622;64;89;38;3;35;.921;3600000;0
27127;189644;42;0;0;0;0;.00nan;0;0
27127;58037;64;0;0;0;0;.00nan;0;0
27127;149450;42;100;35;0;35;1.000;3600000;0
27128;163565;40;79;21;1;20;.952;3600000;0
27128;183859;47;76;39;4;35;.897;3600000;0
27128;185812;40;0;0;0;0;.00nan;0;0
27128;186495;47;0;0;0;0;.00nan;0;0
27129;184069;46;0;0;0;0;.00nan;0;0
27129;182049;46;44;25;4;21;.840;3513000;0
27129;57215;50;71;23;2;21;.913;3600000;0
27129;141998;50;0;0;0;0;.00nan;0;0
27130;13337;39;0;0;0;0;.00nan;0;0
27130;195089;36;71;42;4;38;.905;3600000;0
27130;187362;36;0;0;0;0;.00nan;0;0
27130;197704;39;66;18;1;17;.944;3600000;0
27131;161535;52;0;0;0;0;.00nan;0;0
27131;184081;52;76;22;1;21;.955;3600000;0
27131;173856;38;16;9;4;5;.556;927000;0
27131;-1;38;68;23;2;21;.913;2673000;0
27132;189639;54;0;0;0;0;.00nan;0;0
27132;201876;54;59;29;3;26;.897;3536000;0
27132;190465;37;0;0;0;0;.00nan;0;0
27132;202161;37;83;25;1;24;.960;3600000;0
27133;163565;40;100;23;0;23;1.000;3600000;0
27133;176200;44;83;56;5;51;.911;3600000;0
27133;185812;40;0;0;0;0;.00nan;0;0
27133;64911;44;0;0;0;0;.00nan;0;0
27134;78820;4619;0;0;0;0;.00nan;0;0
27134;84945;60;0;0;0;0;.00nan;0;0
27134;86862;60;62;31;3;28;.903;3600000;0
27134;91391;4619;88;31;1;30;.968;3600000;0
27135;192733;61;49;29;4;25;.862;3551000;0
27135;-1;61;0;0;0;0;.00nan;0;0
27135;184610;49;59;27;3;24;.889;3600000;0
27135;79132;49;0;0;0;0;.00nan;0;0
27136;13337;39;78;27;1;26;.963;3600000;0
27136;189081;56;0;0;0;0;.00nan;0;0
27136;197704;39;0;0;0;0;.00nan;0;0
27136;57207;56;41;29;5;24;.828;3600000;0
27137;176915;62;0;0;0;0;.00nan;0;0
27137;196372;62;32;18;4;14;.778;3600000;0
27137;191026;48;0;0;0;0;.00nan;0;0
27137;142492;48;100;53;1;52;.981;3600000;0
27138;2195;51;80;45;3;42;.933;3600000;0
27138;3359;43;54;29;4;25;.862;3543000;0
27138;78773;43;0;0;0;0;.00nan;0;0
27138;86360;51;0;0;0;0;.00nan;0;0
27139;176915;62;77;21;1;20;.952;3600000;0
27139;196372;62;0;0;0;0;.00nan;0;0
27139;191026;48;97;54;2;52;.963;3573000;0
27139;142492;48;0;0;0;0;.00nan;0;0
27140;176200;44;0;0;0;0;.00nan;0;0
27140;64911;44;85;41;3;38;.927;3600000;0
27140;78820;4619;75;8;0;8;1.000;3600000;0
27140;91391;4619;0;0;0;0;.00nan;0;0
27141;190465;37;0;0;0;0;.00nan;0;0
27141;202161;37;100;22;0;22;1.000;3600000;0
27141;186549;45;97;45;2;43;.956;3526000;0
27141;66491;45;0;0;0;0;.00nan;0;0
27142;194264;41;69;25;2;23;.920;3600000;0
27142;169226;65;77;45;4;41;.911;3533000;0
27142;176938;65;0;0;0;0;.00nan;0;0
27142;75313;41;0;0;0;0;.00nan;0;0
27143;173856;38;68;24;2;22;.917;3600000;0
27143;176921;58;59;33;4;29;.879;3597000;0
27143;-1;38;0;0;0;0;.00nan;0;0
27143;38124;58;0;0;0;0;.00nan;0;0
27144;4622;64;0;0;0;0;.00nan;0;0
27144;57215;50;0;0;0;0;.00nan;0;0
27144;58037;64;47;25;4;21;.840;3557000;0
27144;141998;50;66;28;3;25;.893;3600000;0
27145;163565;40;85;26;1;25;.962;3600000;0
27145;185812;40;0;0;0;0;.00nan;0;0
27145;84945;60;0;0;0;0;.00nan;0;0
27145;86862;60;86;35;2;33;.943;3543000;0
27146;199481;57;40;10;2;8;.800;473000;0
27146;195089;36;0;0;0;0;.00nan;0;0
27146;187362;36;64;27;2;25;.926;3600000;0
27146;152418;57;45;34;6;28;.824;3127000;0
27147;189081;56;0;0;0;0;.00nan;0;0
27147;181123;63;0;0;0;0;.00nan;0;0
27147;192457;63;69;28;3;25;.893;3519000;0
27147;57207;56;84;27;1;26;.963;3600000;0
27148;184069;46;0;0;0;0;.00nan;0;0
27148;184610;49;44;40;6;34;.850;3600000;0
27148;182049;46;65;24;3;21;.875;3600000;0
27148;79132;49;0;0;0;0;.00nan;0;0
27149;171970;55;0;0;0;0;.00nan;0;0
27149;13337;39;48;21;3;18;.857;3546000;0
27149;194502;55;84;37;2;35;.946;3600000;0
27149;197704;39;0;0;0;0;.00nan;0;0
27150;183859;47;60;42;5;37;.881;3559000;0
27150;185743;4837;47;18;3;15;.833;3600000;0
27150;186495;47;0;0;0;0;.00nan;0;0
27150;187295;4837;0;0;0;0;.00nan;0;0
27151;161535;52;0;0;0;0;.00nan;0;0
27151;163195;59;70;34;3;31;.912;3600000;0
27151;184081;52;62;30;4;26;.867;3545000;0
27151;186527;59;0;0;0;0;.00nan;0;0
27152;4622;64;89;28;1;27;.964;3900000;0
27152;186549;45;0;0;0;0;.00nan;0;0
27152;58037;64;0;0;0;0;.00nan;0;0
27152;66491;45;80;21;1;20;.952;3900000;0
27153;2195;51;95;36;1;35;.972;3600000;0
27153;3359;43;54;30;4;26;.867;3600000;0
27153;78773;43;0;0;0;0;.00nan;0;0
27153;86360;51;0;0;0;0;.00nan;0;0
27154;192733;61;63;17;1;16;.941;3600000;0
27154;-1;61;0;0;0;0;.00nan;0;0
27154;84945;60;82;36;2;34;.944;3591000;0
27154;86862;60;0;0;0;0;.00nan;0;0
27155;163195;59;91;14;0;14;1.000;3600000;0
27155;173856;38;0;0;0;0;.00nan;0;0
27155;-1;38;54;36;5;31;.861;3600000;0
27155;186527;59;0;0;0;0;.00nan;0;0
27156;189639;54;0;0;0;0;.00nan;0;0
27156;189644;42;0;0;0;0;.00nan;0;0
27156;201876;54;97;45;2;43;.956;3544000;0
27156;149450;42;75;23;1;22;.957;3600000;0
27157;199481;57;83;34;2;32;.941;3600000;0
27157;195089;36;92;20;0;20;1.000;3600000;0
27157;187362;36;0;0;0;0;.00nan;0;0
27157;152418;57;0;0;0;0;.00nan;0;0
27158;189081;56;94;50;2;48;.960;3600000;0
27158;181123;63;62;30;3;27;.900;3544000;0
27158;192457;63;0;0;0;0;.00nan;0;0
27158;57207;56;0;0;0;0;.00nan;0;0
27159;190465;37;0;0;0;0;.00nan;0;0
27159;202161;37;90;39;2;37;.949;3600000;0
27159;57215;50;61;23;3;20;.870;3569000;0
27159;141998;50;0;0;0;0;.00nan;0;0
27160;184069;46;67;19;1;18;.947;3600000;0
27160;184610;49;0;0;0;0;.00nan;0;0
27160;182049;46;0;0;0;0;.00nan;0;0
27160;79132;49;84;46;3;43;.935;3579000;0
27161;169226;65;0;0;0;0;.00nan;0;0
27161;169323;53;0;0;0;0;.00nan;0;0
27161;176938;65;83;43;3;40;.930;3600000;0
27161;91403;53;77;28;1;27;.964;3600000;0
27162;171970;55;99;52;2;50;.962;3600000;0
27162;13337;39;0;0;0;0;.00nan;0;0
27162;194502;55;0;0;0;0;.00nan;0;0
27162;197704;39;36;13;3;10;.769;3545000;0
27163;183859;47;80;47;4;43;.915;3677000;0
27163;185743;4837;56;34;5;29;.853;3677000;0
27163;186495;47;0;0;0;0;.00nan;0;0
27163;187295;4837;0;0;0;0;.00nan;0;0
27164;161535;52;75;25;1;24;.960;3600000;0
27164;184081;52;0;0;0;0;.00nan;0;0
27164;176921;58;0;0;0;0;.00nan;0;0
27164;38124;58;94;49;3;46;.939;3600000;0
27165;4622;64;0;0;0;0;.00nan;0;0
27165;186549;45;73;48;5;43;.896;3600000;0
27165;58037;64;47;19;3;16;.842;3600000;0
27165;66491;45;0;0;0;0;.00nan;0;0
27166;163565;40;0;0;0;0;.00nan;0;0
27166;185812;40;41;26;5;21;.808;3600000;0
27166;78820;4619;90;36;2;34;.944;3600000;0
27166;91391;4619;0;0;0;0;.00nan;0;0
27167;194264;41;84;47;4;43;.915;3830000;0
27167;169323;53;0;0;0;0;.00nan;0;0
27167;75313;41;0;0;0;0;.00nan;0;0
27167;91403;53;82;36;3;33;.917;3830000;0
27168;161535;52;0;0;0;0;.00nan;0;0
27168;184081;52;76;22;1;21;.955;3600000;0
27168;176921;58;66;36;4;32;.889;3600000;0
27168;38124;58;0;0;0;0;.00nan;0;0
27169;189639;54;65;37;4;33;.892;3600000;0
27169;189644;42;59;18;2;16;.889;3600000;0
27169;201876;54;0;0;0;0;.00nan;0;0
27169;149450;42;0;0;0;0;.00nan;0;0
27170;190465;37;58;20;2;18;.900;3544000;0
27170;202161;37;0;0;0;0;.00nan;0;0
27170;57215;50;0;0;0;0;.00nan;0;0
27170;141998;50;85;26;1;25;.962;3600000;0
27171;199481;57;0;0;0;0;.00nan;0;0
27171;169226;65;94;49;3;46;.939;3900000;0
27171;176938;65;0;0;0;0;.00nan;0;0
27171;152418;57;71;29;3;26;.897;3900000;0
27172;163565;40;0;0;0;0;.00nan;0;0
27172;185743;4837;90;29;1;28;.966;3578000;0
27172;185812;40;100;25;0;25;1.000;3600000;0
27172;187295;4837;0;0;0;0;.00nan;0;0
27173;176200;44;82;48;4;44;.917;3533000;0
27173;64911;44;0;0;0;0;.00nan;0;0
27173;84945;60;0;0;0;0;.00nan;0;0
27173;86862;60;66;27;2;25;.926;3600000;0
27174;171970;55;0;0;0;0;.00nan;0;0
27174;189081;56;0;0;0;0;.00nan;0;0
27174;194502;55;42;40;6;34;.850;3600000;0
27174;57207;56;70;37;3;34;.919;3600000;0
27175;183859;47;56;35;5;30;.857;3600000;0
27175;186495;47;0;0;0;0;.00nan;0;0
27175;78820;4619;62;23;2;21;.913;3600000;0
27175;91391;4619;0;0;0;0;.00nan;0;0
27176;163565;40;0;0;0;0;.00nan;0;0
27176;185743;4837;29;16;4;12;.750;1798000;0
27176;185812;40;92;30;1;29;.967;3600000;0
27176;187295;4837;88;27;0;27;1.000;1802000;0
27177;169323;53;0;0;0;0;.00nan;0;0
27177;176921;58;97;37;1;36;.973;3600000;0
27177;38124;58;0;0;0;0;.00nan;0;0
27177;91403;53;83;39;3;36;.923;3555000;0
27178;189639;54;0;0;0;0;.00nan;0;0
27178;201876;54;67;30;2;28;.933;3600000;0
27178;186549;45;34;19;4;15;.789;3562000;0
27178;66491;45;0;0;0;0;.00nan;0;0
27179;189644;42;71;47;4;43;.915;3600000;0
27179;57215;50;73;24;1;23;.958;3600000;0
27179;141998;50;0;0;0;0;.00nan;0;0
27179;149450;42;0;0;0;0;.00nan;0;0
27180;13337;39;65;42;4;38;.905;3600000;0
27180;181123;63;63;21;2;19;.905;3600000;0
27180;192457;63;0;0;0;0;.00nan;0;0
27180;197704;39;0;0;0;0;.00nan;0;0
27181;176915;62;56;22;3;19;.864;3600000;0
27181;196372;62;0;0;0;0;.00nan;0;0
27181;191026;48;0;0;0;0;.00nan;0;0
27181;142492;48;91;49;2;47;.959;3600000;0
27182;3359;43;55;15;2;13;.867;3600000;0
27182;189081;56;0;0;0;0;.00nan;0;0
27182;57207;56;80;49;5;44;.898;3600000;0
27182;78773;43;0;0;0;0;.00nan;0;0
27183;163195;59;89;29;1;28;.966;3600000;0
27183;173856;38;40;44;7;37;.841;3600000;0
27183;-1;38;0;0;0;0;.00nan;0;0
27183;186527;59;0;0;0;0;.00nan;0;0
27184;161535;52;0;0;0;0;.00nan;0;0
27184;194264;41;65;20;2;18;.900;3600000;0
27184;184081;52;47;35;5;30;.857;3600000;0
27184;75313;41;0;0;0;0;.00nan;0;0
27185;192733;61;60;39;5;34;.872;3600000;0
27185;-1;61;0;0;0;0;.00nan;0;0
27185;176200;44;0;0;0;0;.00nan;0;0
27185;64911;44;68;19;1;18;.947;3600000;0
27186;189639;54;42;9;2;7;.778;1062000;0
27186;201876;54;30;30;6;24;.800;2538000;0
27186;186549;45;73;24;2;22;.917;3600000;0
27186;66491;45;0;0;0;0;.00nan;0;0
27187;199481;57;0;0;0;0;.00nan;0;0
27187;169226;65;0;0;0;0;.00nan;0;0
27187;176938;65;63;40;5;35;.875;3600000;0
27187;152418;57;57;17;2;15;.882;3600000;0
27188;2195;51;100;37;1;36;.973;3727000;0
27188;181123;63;89;34;2;32;.941;3727000;0
27188;192457;63;0;0;0;0;.00nan;0;0
27188;86360;51;0;0;0;0;.00nan;0;0
27189;4622;64;97;33;1;32;.970;3600000;0
27189;190465;37;0;0;0;0;.00nan;0;0
27189;202161;37;53;29;4;25;.862;3600000;0
27189;58037;64;0;0;0;0;.00nan;0;0
27190;184069;46;99;39;1;38;.974;3600000;0
27190;189644;42;0;0;0;0;.00nan;0;0
27190;182049;46;0;0;0;0;.00nan;0;0
27190;149450;42;72;28;2;26;.929;3554000;0
27191;183859;47;0;0;0;0;.00nan;0;0
27191;184610;49;69;40;4;36;.900;3600000;0
27191;186495;47;75;26;2;24;.923;3600000;0
27191;79132;49;0;0;0;0;.00nan;0;0
27192;171970;55;0;0;0;0;.00nan;0;0
27192;194502;55;60;43;5;38;.884;3588000;0
27192;195089;36;62;25;3;22;.880;3600000;0
27192;187362;36;0;0;0;0;.00nan;0;0
27193;176915;62;0;0;0;0;.00nan;0;0
27193;196372;62;77;38;4;34;.895;3600000;0
27193;191026;48;100;40;1;39;.975;3600000;0
27193;142492;48;0;0;0;0;.00nan;0;0
27194;192733;61;31;21;5;16;.762;3544000;0
27194;-1;61;0;0;0;0;.00nan;0;0
27194;176200;44;94;55;4;51;.927;3600000;0
27194;64911;44;0;0;0;0;.00nan;0;0
27195;163195;59;0;0;0;0;.00nan;0;0
27195;199481;57;49;25;5;20;.800;1285000;0
27195;186527;59;77;23;1;22;.957;3600000;0
27195;152418;57;69;40;4;36;.900;2315000;0
27196;4622;64;84;31;2;29;.935;3535000;0
27196;189639;54;100;32;0;32;1.000;3600000;0
27196;201876;54;0;0;0;0;.00nan;0;0
27196;58037;64;0;0;0;0;.00nan;0;0
27197;185743;4837;83;44;4;40;.909;3600000;0
27197;187295;4837;0;0;0;0;.00nan;0;0
27197;84945;60;0;0;0;0;.00nan;0;0
27197;86862;60;63;22;2;20;.909;3600000;0
27198;169323;53;0;0;0;0;.00nan;0;0
27198;176921;58;0;0;0;0;.00nan;0;0
27198;38124;58;88;33;2;31;.939;3900000;0
27198;91403;53;79;32;2;30;.938;3900000;0
27199;3359;43;0;0;0;0;.00nan;0;0
27199;189081;56;93;50;2;48;.960;3588000;0
27199;57207;56;0;0;0;0;.00nan;0;0
27199;78773;43;55;13;1;12;.923;3600000;0
27200;161535;52;50;31;4;27;.871;3600000;0
27200;184081;52;0;0;0;0;.00nan;0;0
27200;173856;38;0;0;0;0;.00nan;0;0
27200;-1;38;96;32;1;31;.969;3600000;0
27201;190465;37;15;19;6;13;.684;2083000;0
27201;202161;37;70;10;0;10;1.000;1517000;0
27201;57215;50;0;0;0;0;.00nan;0;0
27201;141998;50;84;34;2;32;.941;3600000;0
27202;163565;40;65;28;3;25;.893;3900000;0
27202;185812;40;0;0;0;0;.00nan;0;0
27202;78820;4619;78;43;3;40;.930;3900000;0
27202;91391;4619;0;0;0;0;.00nan;0;0
27203;194264;41;0;0;0;0;.00nan;0;0
27203;169226;65;46;23;4;19;.826;2212000;0
27203;176938;65;61;17;1;16;.941;1388000;0
27203;75313;41;73;26;3;23;.885;3600000;0
27204;171970;55;82;50;4;46;.920;3600000;0
27204;194502;55;0;0;0;0;.00nan;0;0
27204;195089;36;0;0;0;0;.00nan;0;0
27204;187362;36;72;22;1;21;.955;3600000;0
27205;184069;46;59;1;0;1;1.000;519000;0
27205;189644;42;57;29;4;25;.862;3900000;0
27205;182049;46;72;37;4;33;.892;3360000;0
27205;149450;42;0;0;0;0;.00nan;0;0
27206;2195;51;71;33;3;30;.909;3900000;0
27206;13337;39;0;0;0;0;.00nan;0;0
27206;197704;39;78;35;3;32;.914;3900000;0
27206;86360;51;0;0;0;0;.00nan;0;0
27207;183859;47;87;22;1;21;.955;3900000;0
27207;184610;49;0;0;0;0;.00nan;0;0
27207;186495;47;0;0;0;0;.00nan;0;0
27207;79132;49;98;53;1;52;.981;3900000;0
27208;4622;64;76;41;3;38;.927;3600000;0
27208;190465;37;0;0;0;0;.00nan;0;0
27208;202161;37;100;29;0;29;1.000;3600000;0
27208;58037;64;0;0;0;0;.00nan;0;0
27209;163565;40;48;2;0;2;1.000;564000;0
27209;185812;40;36;31;6;25;.806;3336000;0
27209;78820;4619;46;37;6;31;.838;3032000;0
27209;91391;4619;65;9;0;9;1.000;868000;0
27210;185743;4837;66;32;3;29;.906;3558000;0
27210;187295;4837;0;0;0;0;.00nan;0;0
27210;84945;60;94;33;2;31;.939;3600000;0
27210;86862;60;0;0;0;0;.00nan;0;0
27211;186549;45;0;0;0;0;.00nan;0;0
27211;57215;50;73;23;1;22;.957;3600000;0
27211;66491;45;79;45;3;42;.933;3563000;0
27211;141998;50;0;0;0;0;.00nan;0;0
27212;169323;53;0;0;0;0;.00nan;0;0
27212;173856;38;63;43;6;37;.860;2991000;0
27212;-1;38;52;2;0;2;1.000;609000;0
27212;91403;53;73;33;3;30;.909;3600000;0
27213;199481;57;0;0;0;0;.00nan;0;0
27213;194264;41;52;14;2;12;.857;3600000;0
27213;75313;41;0;0;0;0;.00nan;0;0
27213;152418;57;60;41;5;36;.878;3600000;0
27214;2195;51;41;22;5;17;.773;3797000;0
27214;13337;39;51;29;4;25;.862;3797000;0
27214;197704;39;0;0;0;0;.00nan;0;0
27214;86360;51;0;0;0;0;.00nan;0;0
27215;195089;36;88;30;2;28;.933;3589000;0
27215;181123;63;93;29;1;28;.966;3600000;0
27215;187362;36;0;0;0;0;.00nan;0;0
27215;192457;63;0;0;0;0;.00nan;0;0
27217;161535;52;0;0;0;0;.00nan;0;0
27217;199481;57;0;0;0;0;.00nan;0;0
27217;184081;52;71;28;2;26;.929;3721000;0
27217;152418;57;76;39;3;36;.923;3721000;0
27219;189081;56;0;0;0;0;.00nan;0;0
27219;179950;4837;0;0;0;0;.00nan;0;0
27219;187295;4837;60;22;2;20;.909;3600000;0
27219;57207;56;72;35;3;32;.914;3600000;0
27221;163565;40;44;25;4;21;.840;3600000;0
27221;185812;40;0;0;0;0;.00nan;0;0
27221;186549;45;93;29;1;28;.966;3600000;0
27221;66491;45;0;0;0;0;.00nan;0;0
27223;184069;46;64;34;3;31;.912;2618000;0
27223;190465;37;40;17;4;13;.765;3600000;0
27223;202161;37;0;0;0;0;.00nan;0;0
27223;182049;46;34;19;4;15;.789;982000;0
27225;201673;4619;82;33;2;31;.939;3900000;0
27225;181123;63;72;27;2;25;.926;3900000;0
27225;192457;63;0;0;0;0;.00nan;0;0
27225;78820;4619;0;0;0;0;.00nan;0;0
27227;176915;62;54;15;2;13;.867;3609000;0
27227;196372;62;0;0;0;0;.00nan;0;0
27227;186495;47;81;37;3;34;.919;3609000;0
27227;78479;47;0;0;0;0;.00nan;0;0
27229;169323;53;51;25;4;21;.840;3544000;0
27229;176200;44;0;0;0;0;.00nan;0;0
27229;64911;44;63;36;3;33;.917;3600000;0
27229;91403;53;0;0;0;0;.00nan;0;0
27231;184610;49;0;0;0;0;.00nan;0;0
27231;176921;58;53;28;3;25;.893;3575000;0
27231;38124;58;0;0;0;0;.00nan;0;0
27231;79132;49;67;20;2;18;.900;3600000;0
27233;189639;54;95;47;3;44;.936;3600000;0
27233;189644;42;89;20;0;20;1.000;3600000;0
27233;201876;54;0;0;0;0;.00nan;0;0
27233;149450;42;0;0;0;0;.00nan;0;0
27235;192733;61;47;35;5;30;.857;3600000;0
27235;169226;65;0;0;0;0;.00nan;0;0
27235;-1;61;0;0;0;0;.00nan;0;0
27235;176938;65;99;42;2;40;.952;3600000;0
27237;171970;55;0;0;0;0;.00nan;0;0
27237;194502;55;92;67;4;63;.940;3600000;0
27237;186527;59;0;0;0;0;.00nan;0;0
27237;75268;59;52;9;2;7;.778;3600000;0
27239;4622;64;100;30;0;30;1.000;3900000;0
27239;173856;38;0;0;0;0;.00nan;0;0
27239;181102;38;97;34;0;34;1.000;3900000;0
27239;58037;64;0;0;0;0;.00nan;0;0
27241;187699;39;59;33;4;29;.879;3600000;0
27241;197704;39;0;0;0;0;.00nan;0;0
27241;57215;50;0;0;0;0;.00nan;0;0
27241;141998;50;100;31;0;31;1.000;3600000;0
27243;171838;41;47;18;3;15;.833;3563000;0
27243;194264;41;0;0;0;0;.00nan;0;0
27243;86862;60;0;0;0;0;.00nan;0;0
27243;91398;60;69;24;2;22;.917;3600000;0
27245;188888;51;0;0;0;0;.00nan;0;0
27245;195089;36;0;0;0;0;.00nan;0;0
27245;187362;36;94;35;1;34;.971;3600000;0
27245;86360;51;65;20;2;18;.900;3567000;0
27247;165744;43;74;28;3;25;.893;3582000;0
27247;191026;48;0;0;0;0;.00nan;0;0
27247;64811;43;0;0;0;0;.00nan;0;0
27247;142492;48;96;39;2;37;.949;3600000;0
2400;161535;52;0;0;0;0;.00nan;0;0
2400;199481;57;0;0;0;0;.00nan;0;0
2400;184081;52;61;28;3;25;.893;3551000;0
2400;152418;57;73;28;2;26;.929;3600000;0
2401;194264;41;22;4;3;1;.250;228000;0
2401;176921;58;76;52;5;47;.904;3600000;0
2401;38124;58;0;0;0;0;.00nan;0;0
2401;75313;41;54;23;3;20;.870;3346000;0
2402;2195;51;100;39;0;39;1.000;3600000;0
2402;13337;39;51;28;4;24;.857;3600000;0
2402;197704;39;0;0;0;0;.00nan;0;0
2402;86360;51;0;0;0;0;.00nan;0;0
2403;4622;64;0;0;0;0;.00nan;0;0
2403;184069;46;76;32;3;29;.906;3600000;0
2403;182049;46;0;0;0;0;.00nan;0;0
2403;58037;64;36;26;5;21;.808;3514000;0
2404;184610;49;0;0;0;0;.00nan;0;0
2404;78820;4619;85;32;2;30;.938;3600000;0
2404;79132;49;71;34;4;30;.882;3533000;0
2404;91391;4619;0;0;0;0;.00nan;0;0
2405;176915;62;65;23;2;21;.913;3674000;0
2405;196372;62;0;0;0;0;.00nan;0;0
2405;84945;60;0;0;0;0;.00nan;0;0
2405;86862;60;82;46;3;43;.935;3674000;0
2406;163565;40;100;36;0;36;1.000;3600000;0
2406;183859;47;90;31;1;30;.968;3600000;0
2406;185812;40;0;0;0;0;.00nan;0;0
2406;186495;47;0;0;0;0;.00nan;0;0
2407;161535;52;0;0;0;0;.00nan;0;0
2407;199481;57;0;0;0;0;.00nan;0;0
2407;184081;52;69;34;4;30;.882;3549000;0
2407;152418;57;86;40;3;37;.925;3600000;0
2408;194264;41;71;25;2;23;.920;3605000;0
2408;176921;58;76;32;3;29;.906;3605000;0
2408;38124;58;0;0;0;0;.00nan;0;0
2408;75313;41;0;0;0;0;.00nan;0;0
2409;2195;51;99;37;1;36;.973;3600000;0
2409;13337;39;91;45;2;43;.956;3574000;0
2409;197704;39;0;0;0;0;.00nan;0;0
2409;86360;51;0;0;0;0;.00nan;0;0
2410;4622;64;91;41;2;39;.951;3823000;0
2410;184069;46;0;0;0;0;.00nan;0;0
2410;182049;46;89;39;3;36;.923;3823000;0
2410;58037;64;0;0;0;0;.00nan;0;0
2411;184610;49;0;0;0;0;.00nan;0;0
2411;78820;4619;44;21;3;18;.857;3564000;0
2411;79132;49;83;32;1;31;.969;3600000;0
2411;91391;4619;0;0;0;0;.00nan;0;0
2412;176915;62;62;25;3;22;.880;3600000;0
2412;196372;62;0;0;0;0;.00nan;0;0
2412;84945;60;0;0;0;0;.00nan;0;0
2412;86862;60;97;54;4;50;.926;3600000;0
2413;163565;40;61;21;2;19;.905;3600000;0
2413;183859;47;31;29;6;23;.793;2873000;0
2413;185812;40;0;0;0;0;.00nan;0;0
2413;186495;47;51;7;1;6;.857;727000;0
2454;194264;41;68;30;2;28;.933;5431000;0
2454;176921;58;92;54;3;51;.944;5431000;0
2454;38124;58;0;0;0;0;.00nan;0;0
2454;75313;41;0;0;0;0;.00nan;0;0
2455;4622;64;79;30;2;28;.933;3607000;0
2455;184069;46;0;0;0;0;.00nan;0;0
2455;182049;46;82;37;3;34;.919;3607000;0
2455;58037;64;0;0;0;0;.00nan;0;0
2456;184610;49;0;0;0;0;.00nan;0;0
2456;78820;4619;76;26;2;24;.923;3600000;0
2456;79132;49;63;36;4;32;.889;3600000;0
2456;91391;4619;0;0;0;0;.00nan;0;0
2477;163195;59;83;14;0;14;1.000;3600000;0
2477;199481;57;0;0;0;0;.00nan;0;0
2477;186527;59;0;0;0;0;.00nan;0;0
2477;152418;57;98;36;1;35;.972;3600000;0
2478;194264;41;73;28;2;26;.929;3580000;0
2478;169323;53;0;0;0;0;.00nan;0;0
2478;75313;41;0;0;0;0;.00nan;0;0
2478;91403;53;61;15;1;14;.933;3600000;0
2479;2195;51;74;34;3;31;.912;3600000;0
2479;3359;43;100;25;0;25;1.000;3600000;0
2479;78773;43;0;0;0;0;.00nan;0;0
2479;86360;51;0;0;0;0;.00nan;0;0
2480;195089;36;0;0;0;0;.00nan;0;0
2480;181123;63;64;24;2;22;.917;3544000;0
2480;187362;36;99;35;1;34;.971;3600000;0
2480;192457;63;0;0;0;0;.00nan;0;0
2481;4622;64;55;46;6;40;.870;3600000;0
2481;189644;42;94;40;2;38;.950;3600000;0
2481;58037;64;0;0;0;0;.00nan;0;0
2481;149450;42;0;0;0;0;.00nan;0;0
2482;190465;37;0;0;0;0;.00nan;0;0
2482;202161;37;95;18;0;18;1.000;3600000;0
2482;57215;50;0;0;0;0;.00nan;0;0
2482;141998;50;64;20;2;18;.900;3552000;0
2483;163565;40;63;18;2;16;.889;4154000;0
2483;185743;4837;96;28;1;27;.964;4154000;0
2483;185812;40;0;0;0;0;.00nan;0;0
2483;187295;4837;0;0;0;0;.00nan;0;0
2484;176915;62;81;29;2;27;.931;3600000;0
2484;196372;62;0;0;0;0;.00nan;0;0
2484;78820;4619;91;39;3;36;.923;3541000;0
2484;91391;4619;0;0;0;0;.00nan;0;0
2485;163195;59;85;15;0;15;1.000;3600000;0
2485;199481;57;0;0;0;0;.00nan;0;0
2485;186527;59;0;0;0;0;.00nan;0;0
2485;152418;57;80;47;4;43;.915;3600000;0
2486;194264;41;53;27;4;23;.852;3600000;0
2486;169323;53;0;0;0;0;.00nan;0;0
2486;75313;41;0;0;0;0;.00nan;0;0
2486;91403;53;82;22;1;21;.955;3600000;0
2487;2195;51;29;22;5;17;.773;1994000;0
2487;3359;43;95;18;0;18;1.000;3600000;0
2487;78773;43;0;0;0;0;.00nan;0;0
2487;86360;51;65;19;1;18;.947;1606000;0
2488;195089;36;0;0;0;0;.00nan;0;0
2488;181123;63;74;21;1;20;.952;3600000;0
2488;187362;36;75;34;2;32;.941;3600000;0
2488;192457;63;0;0;0;0;.00nan;0;0
2489;4622;64;60;34;4;30;.882;3753000;0
2489;189644;42;58;26;3;23;.885;3753000;0
2489;58037;64;0;0;0;0;.00nan;0;0
2489;149450;42;0;0;0;0;.00nan;0;0
2490;190465;37;64;27;2;25;.926;2566000;0
2490;202161;37;45;22;4;18;.818;1034000;0
2490;57215;50;0;0;0;0;.00nan;0;0
2490;141998;50;100;19;0;19;1.000;3600000;0
2491;163565;40;75;34;3;31;.912;3600000;0
2491;185743;4837;94;25;0;25;1.000;3600000;0
2491;185812;40;0;0;0;0;.00nan;0;0
2491;187295;4837;0;0;0;0;.00nan;0;0
2492;176915;62;49;22;3;19;.864;3537000;0
2492;196372;62;0;0;0;0;.00nan;0;0
2492;78820;4619;81;23;1;22;.957;3600000;0
2492;91391;4619;0;0;0;0;.00nan;0;0
2493;163195;59;77;25;1;24;.960;3600000;0
2493;199481;57;0;0;0;0;.00nan;0;0
2493;186527;59;0;0;0;0;.00nan;0;0
2493;152418;57;97;51;3;48;.941;3600000;0
2494;194264;41;56;21;2;19;.905;3600000;0
2494;169323;53;0;0;0;0;.00nan;0;0
2494;75313;41;0;0;0;0;.00nan;0;0
2494;91403;53;75;36;3;33;.917;3545000;0
2495;2195;51;75;34;3;31;.912;3600000;0
2495;3359;43;88;32;2;30;.938;3600000;0
2495;78773;43;0;0;0;0;.00nan;0;0
2495;86360;51;0;0;0;0;.00nan;0;0
2496;195089;36;0;0;0;0;.00nan;0;0
2496;181123;63;74;35;3;32;.914;3600000;0
2496;187362;36;45;22;4;18;.818;3544000;0
2496;192457;63;0;0;0;0;.00nan;0;0
2497;4622;64;69;39;5;34;.872;3546000;0
2497;189644;42;63;30;3;27;.900;3600000;0
2497;58037;64;0;0;0;0;.00nan;0;0
2497;149450;42;0;0;0;0;.00nan;0;0
2498;190465;37;56;6;0;6;1.000;448000;0
2498;202161;37;43;16;3;13;.813;3152000;0
2498;57215;50;0;0;0;0;.00nan;0;0
2498;141998;50;100;26;0;26;1.000;3600000;0
2499;163565;40;64;39;4;35;.897;4133000;0
2499;185743;4837;50;23;3;20;.870;4133000;0
2499;185812;40;0;0;0;0;.00nan;0;0
2499;187295;4837;0;0;0;0;.00nan;0;0
2500;176915;62;70;27;2;25;.926;3600000;0
2500;196372;62;0;0;0;0;.00nan;0;0
2500;78820;4619;55;38;5;33;.868;3600000;0
2500;91391;4619;0;0;0;0;.00nan;0;0
2550;194264;41;54;28;3;25;.893;3600000;0
2550;169323;53;0;0;0;0;.00nan;0;0
2550;75313;41;0;0;0;0;.00nan;0;0
2550;91403;53;100;28;0;28;1.000;3600000;0
2551;195089;36;0;0;0;0;.00nan;0;0
2551;181123;63;62;28;2;26;.929;3565000;0
2551;187362;36;100;22;0;22;1.000;3600000;0
2551;192457;63;0;0;0;0;.00nan;0;0
2552;190465;37;0;0;0;0;.00nan;0;0
2552;202161;37;38;35;7;28;.800;3513000;0
2552;57215;50;0;0;0;0;.00nan;0;0
2552;141998;50;64;41;5;36;.878;3600000;0
2553;176915;62;64;27;3;24;.889;3576000;0
2553;196372;62;0;0;0;0;.00nan;0;0
2553;78820;4619;98;35;1;34;.971;3600000;0
2553;91391;4619;0;0;0;0;.00nan;0;0
2629;195089;36;0;0;0;0;.00nan;0;0
2629;181123;63;56;31;4;27;.871;3600000;0
2629;187362;36;62;14;1;13;.929;3600000;0
2629;192457;63;0;0;0;0;.00nan;0;0
2630;176915;62;69;15;1;14;.933;3600000;0
2630;196372;62;0;0;0;0;.00nan;0;0
2630;78820;4619;93;48;2;46;.958;3546000;0
2630;91391;4619;0;0;0;0;.00nan;0;0
2656;163195;59;75;20;1;19;.950;3600000;0
2656;169323;53;0;0;0;0;.00nan;0;0
2656;186527;59;0;0;0;0;.00nan;0;0
2656;91403;53;95;45;2;43;.956;3600000;0
2657;3359;43;68;25;2;23;.920;3600000;0
2657;195089;36;11;18;6;12;.667;1160000;0
2657;187362;36;41;32;6;26;.813;2440000;0
2657;78773;43;0;0;0;0;.00nan;0;0
2658;189644;42;83;33;2;31;.939;3553000;0
2658;57215;50;0;0;0;0;.00nan;0;0
2658;141998;50;93;38;1;37;.974;3600000;0
2658;149450;42;0;0;0;0;.00nan;0;0
2659;176915;62;68;14;1;13;.929;3600000;0
2659;196372;62;0;0;0;0;.00nan;0;0
2659;185743;4837;30;28;6;22;.786;3238000;0
2659;187295;4837;55;3;0;3;1.000;362000;0
2660;163195;59;52;21;3;18;.857;3600000;0
2660;169323;53;0;0;0;0;.00nan;0;0
2660;186527;59;0;0;0;0;.00nan;0;0
2660;91403;53;79;41;4;37;.902;3545000;0
2661;3359;43;32;17;4;13;.765;3567000;0
2661;195089;36;0;0;0;0;.00nan;0;0
2661;187362;36;99;53;3;50;.943;3600000;0
2661;78773;43;0;0;0;0;.00nan;0;0
2662;189644;42;88;33;1;32;.970;3600000;0
2662;57215;50;0;0;0;0;.00nan;0;0
2662;141998;50;64;26;3;23;.885;3540000;0
2662;149450;42;0;0;0;0;.00nan;0;0
2663;176915;62;54;26;3;23;.885;3545000;0
2663;196372;62;0;0;0;0;.00nan;0;0
2663;185743;4837;85;30;2;28;.933;3600000;0
2663;187295;4837;0;0;0;0;.00nan;0;0
2664;163195;59;99;26;0;26;1.000;3600000;0
2664;169323;53;0;0;0;0;.00nan;0;0
2664;186527;59;0;0;0;0;.00nan;0;0
2664;91403;53;61;42;6;36;.857;3600000;0
2665;3359;43;31;15;4;11;.733;3600000;0
2665;195089;36;0;0;0;0;.00nan;0;0
2665;187362;36;75;49;6;43;.878;3600000;0
2665;78773;43;0;0;0;0;.00nan;0;0
2666;189644;42;94;33;2;31;.939;3576000;0
2666;57215;50;0;0;0;0;.00nan;0;0
2666;141998;50;100;47;0;47;1.000;3600000;0
2666;149450;42;0;0;0;0;.00nan;0;0
2667;176915;62;72;19;1;18;.947;3653000;0
2667;196372;62;0;0;0;0;.00nan;0;0
2667;185743;4837;85;37;2;35;.946;3658000;0
2667;187295;4837;0;0;0;0;.00nan;0;0
2708;3359;43;79;24;1;23;.958;3600000;0
2708;195089;36;0;0;0;0;.00nan;0;0
2708;187362;36;83;39;3;36;.923;3572000;0
2708;78773;43;0;0;0;0;.00nan;0;0
2709;189644;42;60;26;3;23;.885;3600000;0
2709;57215;50;0;0;0;0;.00nan;0;0
2709;141998;50;51;32;5;27;.844;3531000;0
2709;149450;42;0;0;0;0;.00nan;0;0
2710;176915;62;66;34;3;31;.912;3600000;0
2710;196372;62;0;0;0;0;.00nan;0;0
2710;185743;4837;100;28;0;28;1.000;3600000;0
2710;187295;4837;0;0;0;0;.00nan;0;0
2719;189644;42;91;32;1;31;.969;3600000;0
2719;57215;50;0;0;0;0;.00nan;0;0
2719;141998;50;88;43;2;41;.953;3551000;0
2719;149450;42;0;0;0;0;.00nan;0;0
2720;176915;62;81;24;1;23;.958;3600000;0
2720;196372;62;0;0;0;0;.00nan;0;0
2720;185743;4837;72;37;4;33;.892;3600000;0
2720;187295;4837;0;0;0;0;.00nan;0;0
2737;3359;43;53;23;3;20;.870;3549000;0
2737;163195;59;99;35;1;34;.971;3600000;0
2737;186527;59;0;0;0;0;.00nan;0;0
2737;78773;43;0;0;0;0;.00nan;0;0
2738;189644;42;66;42;4;38;.905;4720000;0
2738;176915;62;59;36;3;33;.917;4757000;0
2738;196372;62;0;0;0;0;.00nan;0;0
2738;149450;42;0;0;0;0;.00nan;0;0
2739;3359;43;72;35;2;33;.943;3940000;0
2739;163195;59;66;31;3;28;.903;3940000;0
2739;186527;59;0;0;0;0;.00nan;0;0
2739;78773;43;0;0;0;0;.00nan;0;0
2740;189644;42;82;29;1;28;.966;3600000;0
2740;176915;62;75;30;2;28;.933;3576000;0
2740;196372;62;0;0;0;0;.00nan;0;0
2740;149450;42;0;0;0;0;.00nan;0;0
2741;3359;43;62;31;3;28;.903;4135000;0
2741;163195;59;72;40;4;36;.900;4135000;0
2741;186527;59;0;0;0;0;.00nan;0;0
2741;78773;43;0;0;0;0;.00nan;0;0
2742;189644;42;78;33;3;30;.909;3553000;0
2742;176915;62;99;43;2;41;.953;3600000;0
2742;196372;62;0;0;0;0;.00nan;0;0
2742;149450;42;0;0;0;0;.00nan;0;0
2743;3359;43;48;23;3;20;.870;3600000;0
2743;163195;59;71;48;5;43;.896;3559000;0
2743;186527;59;0;0;0;0;.00nan;0;0
2743;78773;43;0;0;0;0;.00nan;0;0
2744;189644;42;76;30;2;28;.933;3517000;0
2744;176915;62;100;26;0;26;1.000;3600000;0
2744;196372;62;0;0;0;0;.00nan;0;0
2744;149450;42;0;0;0;0;.00nan;0;0
2762;3359;43;66;36;4;32;.889;3600000;0
2762;163195;59;34;31;7;24;.774;3273000;0
2762;186527;59;48;0;0;0;.00nan;327000;0
2762;78773;43;0;0;0;0;.00nan;0;0
2763;189644;42;73;34;3;31;.912;3600000;0
2763;176915;62;61;34;4;30;.882;3578000;0
2763;196372;62;0;0;0;0;.00nan;0;0
2763;149450;42;0;0;0;0;.00nan;0;0
2765;189644;42;71;34;4;30;.882;3588000;0
2765;176915;62;66;24;2;22;.917;3600000;0
2765;196372;62;0;0;0;0;.00nan;0;0
2765;149450;42;0;0;0;0;.00nan;0;0
2767;3359;43;70;22;2;20;.909;3600000;0
2767;176915;62;95;45;3;42;.933;3600000;0
2767;196372;62;0;0;0;0;.00nan;0;0
2767;78773;43;0;0;0;0;.00nan;0;0
2768;3359;43;53;34;4;30;.882;3550000;0
2768;176915;62;61;25;3;22;.880;3600000;0
2768;196372;62;0;0;0;0;.00nan;0;0
2768;78773;43;0;0;0;0;.00nan;0;0
2769;3359;43;48;19;3;16;.842;3600000;0
2769;176915;62;45;30;5;25;.833;3536000;0
2769;196372;62;0;0;0;0;.00nan;0;0
2769;78773;43;0;0;0;0;.00nan;0;0
2770;3359;43;100;29;0;29;1.000;3600000;0
2770;176915;62;87;37;2;35;.946;3520000;0
2770;196372;62;0;0;0;0;.00nan;0;0
2770;78773;43;0;0;0;0;.00nan;0;0
2789;3359;43;80;29;2;27;.931;3600000;0
2789;176915;62;45;27;5;22;.815;3600000;0
2789;196372;62;0;0;0;0;.00nan;0;0
2789;78773;43;0;0;0;0;.00nan;0;0
27248;1957;738;0;0;0;0;.00nan;0;0
27248;184158;738;91;44;3;41;.932;3575000;0
27248;206313;745;68;25;2;23;.920;3600000;0
27248;202104;745;0;0;0;0;.00nan;0;0
27249;2195;748;97;19;0;19;1.000;3600000;0
27249;203533;748;0;0;0;0;.00nan;0;0
27249;49935;2168;48;21;3;18;.857;3600000;0
27249;76405;2168;0;0;0;0;.00nan;0;0
27250;3359;751;100;31;0;31;1.000;3600000;0
27250;198736;749;0;0;0;0;.00nan;0;0
27250;85661;749;64;27;2;25;.926;3540000;0
27250;148788;751;0;0;0;0;.00nan;0;0
27251;3165;1880;69;30;2;28;.933;3588000;0
27251;203977;729;0;0;0;0;.00nan;0;0
27251;211604;729;100;32;0;32;1.000;3600000;0
27251;148503;1880;0;0;0;0;.00nan;0;0
27252;2643;736;100;47;1;46;.979;3600000;0
27252;3435;739;0;0;0;0;.00nan;0;0
27252;74734;736;0;0;0;0;.00nan;0;0
27252;152624;739;37;14;3;11;.786;3553000;0
27253;195887;743;99;43;2;41;.953;3600000;0
27253;202516;743;0;0;0;0;.00nan;0;0
27253;-1;742;0;0;0;0;.00nan;0;0
27253;85797;742;49;21;3;18;.857;3592000;0
27254;-1;3789;0;0;0;0;.00nan;0;0
27254;56565;741;77;26;2;24;.923;3900000;0
27254;82273;741;0;0;0;0;.00nan;0;0
27254;91742;3789;71;27;2;25;.926;3900000;0
27255;359;740;0;0;0;0;.00nan;0;0
27255;204272;737;73;31;2;29;.935;3600000;0
27255;201947;737;0;0;0;0;.00nan;0;0
27255;207184;740;55;40;5;35;.875;3600000;0
27256;595;732;0;0;0;0;.00nan;0;0
27256;8505;732;67;34;4;30;.882;3600000;0
27256;175764;747;0;0;0;0;.00nan;0;0
27256;180177;747;42;31;5;26;.839;3575000;0
27257;196698;744;0;0;0;0;.00nan;0;0
27257;207771;744;83;28;2;26;.929;3900000;0
27257;-1;764;100;43;2;41;.953;3900000;0
27257;-1;764;0;0;0;0;.00nan;0;0
27258;1957;738;0;0;0;0;.00nan;0;0
27258;184158;738;93;46;3;43;.935;3692000;0
27258;31165;752;0;0;0;0;.00nan;0;0
27258;149221;752;70;26;2;24;.923;3692000;0
27259;178098;733;100;45;2;43;.956;3900000;0
27259;44526;734;61;26;2;24;.923;3900000;0
27259;-1;734;0;0;0;0;.00nan;0;0
27259;66245;733;0;0;0;0;.00nan;0;0
27260;206313;745;56;19;2;17;.895;3600000;0
27260;202104;745;0;0;0;0;.00nan;0;0
27260;-1;742;0;0;0;0;.00nan;0;0
27260;85797;742;70;37;4;33;.892;3600000;0
27261;3359;751;0;0;0;0;.00nan;0;0
27261;49935;2168;29;29;6;23;.793;2325000;0
27261;76405;2168;45;12;2;10;.833;1275000;0
27261;148788;751;48;24;4;20;.833;3600000;0
27262;3435;739;55;26;4;22;.846;3600000;0
27262;175764;747;0;0;0;0;.00nan;0;0
27262;180177;747;88;28;1;27;.964;3600000;0
27262;152624;739;0;0;0;0;.00nan;0;0
27263;3165;1880;66;24;3;21;.875;3600000;0
27263;204272;737;0;0;0;0;.00nan;0;0
27263;201947;737;69;37;4;33;.892;3565000;0
27263;148503;1880;0;0;0;0;.00nan;0;0
27264;2643;736;80;43;3;40;.930;3534000;0
27264;195887;743;59;12;1;11;.917;3600000;0
27264;202516;743;0;0;0;0;.00nan;0;0
27264;74734;736;0;0;0;0;.00nan;0;0
27265;359;740;53;34;5;29;.853;3600000;0
27265;203977;729;0;0;0;0;.00nan;0;0
27265;211604;729;60;28;3;25;.893;3600000;0
27265;207184;740;0;0;0;0;.00nan;0;0
27266;595;732;55;34;5;29;.853;3547000;0
27266;8505;732;0;0;0;0;.00nan;0;0
27266;-1;3789;0;0;0;0;.00nan;0;0
27266;91742;3789;68;29;3;26;.897;3600000;0
27267;198736;749;0;0;0;0;.00nan;0;0
27267;196698;744;0;0;0;0;.00nan;0;0
27267;207771;744;51;12;2;10;.833;3600000;0
27267;85661;749;96;50;3;47;.940;3583000;0
27268;1957;738;0;0;0;0;.00nan;0;0
27268;184158;738;88;45;2;43;.956;3546000;0
27268;-1;764;80;23;1;22;.957;3600000;0
27268;-1;764;0;0;0;0;.00nan;0;0
27269;3165;1880;0;0;0;0;.00nan;0;0
27269;206313;745;51;11;1;10;.909;628000;0
27269;202104;745;23;31;6;25;.806;2972000;0
27269;148503;1880;55;16;2;14;.875;3600000;0
27270;204272;737;0;0;0;0;.00nan;0;0
27270;201947;737;49;34;5;29;.853;3759000;0
27270;-1;3789;0;0;0;0;.00nan;0;0
27270;91742;3789;31;27;6;21;.778;3759000;0
27271;198736;749;0;0;0;0;.00nan;0;0
27271;195887;743;72;17;0;17;1.000;2453000;0
27271;202516;743;27;12;4;8;.667;1147000;0
27271;85661;749;85;33;1;32;.970;3600000;0
27272;44526;734;90;20;0;20;1.000;3600000;0
27272;-1;742;36;6;2;4;.667;752000;0
27272;-1;734;0;0;0;0;.00nan;0;0
27272;85797;742;32;34;6;28;.824;2848000;0
27273;2643;736;91;39;1;38;.974;3600000;0
27273;178098;733;70;27;3;24;.889;3535000;0
27273;66245;733;0;0;0;0;.00nan;0;0
27273;74734;736;0;0;0;0;.00nan;0;0
27274;203977;729;0;0;0;0;.00nan;0;0
27274;211604;729;82;30;2;28;.933;3600000;0
27274;56565;741;63;29;3;26;.897;3561000;0
27274;82273;741;0;0;0;0;.00nan;0;0
27275;359;740;96;43;1;42;.977;3900000;0
27275;175764;747;0;0;0;0;.00nan;0;0
27275;180177;747;97;32;1;31;.969;3900000;0
27275;207184;740;0;0;0;0;.00nan;0;0
27276;595;732;77;34;3;31;.912;3600000;0
27276;8505;732;0;0;0;0;.00nan;0;0
27276;31165;752;0;0;0;0;.00nan;0;0
27276;149221;752;64;38;4;34;.895;3583000;0
27277;2195;748;77;28;2;26;.929;3900000;0
27277;203533;748;0;0;0;0;.00nan;0;0
27277;196698;744;0;0;0;0;.00nan;0;0
27277;207771;744;85;32;2;30;.938;3900000;0
27278;3435;739;47;29;5;24;.828;3600000;0
27278;-1;764;100;37;0;37;1.000;3600000;0
27278;-1;764;0;0;0;0;.00nan;0;0
27278;152624;739;0;0;0;0;.00nan;0;0
27279;3359;751;0;0;0;0;.00nan;0;0
27279;49935;2168;0;0;0;0;.00nan;0;0
27279;76405;2168;100;43;0;43;1.000;3600000;0
27279;148788;751;44;25;4;21;.840;3600000;0
27280;204272;737;0;0;0;0;.00nan;0;0
27280;206313;745;54;30;3;27;.900;3545000;0
27280;201947;737;88;39;2;37;.949;3600000;0
27280;202104;745;0;0;0;0;.00nan;0;0
27281;2643;736;55;40;5;35;.875;3600000;0
27281;44526;734;73;20;1;19;.950;3600000;0
27281;-1;734;0;0;0;0;.00nan;0;0
27281;74734;736;0;0;0;0;.00nan;0;0
27282;178098;733;87;41;2;39;.951;3600000;0
27282;-1;3789;61;6;0;6;1.000;880000;0
27282;66245;733;0;0;0;0;.00nan;0;0
27282;91742;3789;31;27;6;21;.778;2720000;0
27283;1957;738;0;0;0;0;.00nan;0;0
27283;184158;738;76;37;2;35;.946;3526000;0
27283;56565;741;97;25;0;25;1.000;3600000;0
27283;82273;741;0;0;0;0;.00nan;0;0
27284;359;740;97;75;4;71;.947;3600000;0
27284;31165;752;84;25;1;24;.960;3600000;0
27284;207184;740;0;0;0;0;.00nan;0;0
27284;149221;752;0;0;0;0;.00nan;0;0
27285;595;732;86;34;1;33;.971;3600000;0
27285;8505;732;0;0;0;0;.00nan;0;0
27285;-1;742;0;0;0;0;.00nan;0;0
27285;85797;742;83;31;2;29;.935;3586000;0
27286;2195;748;66;17;1;16;.941;3600000;0
27286;3359;751;0;0;0;0;.00nan;0;0
27286;203533;748;0;0;0;0;.00nan;0;0
27286;148788;751;70;32;2;30;.938;3558000;0
27287;3165;1880;72;42;4;38;.905;3542000;0
27287;3435;739;100;45;2;43;.956;3600000;0
27287;148503;1880;0;0;0;0;.00nan;0;0
27287;152624;739;0;0;0;0;.00nan;0;0
27288;175764;747;0;0;0;0;.00nan;0;0
27288;195887;743;63;28;3;25;.893;3594000;0
27288;180177;747;86;32;2;30;.938;3600000;0
27288;202516;743;0;0;0;0;.00nan;0;0
27289;196698;744;45;16;3;13;.813;3529000;0
27289;207771;744;0;0;0;0;.00nan;0;0
27289;49935;2168;98;39;1;38;.974;3600000;0
27289;76405;2168;0;0;0;0;.00nan;0;0
27290;595;732;0;0;0;0;.00nan;0;0
27290;8505;732;71;37;4;33;.892;3514000;0
27290;-1;764;76;36;2;34;.944;3600000;0
27290;-1;764;0;0;0;0;.00nan;0;0
27291;1957;738;0;0;0;0;.00nan;0;0
27291;204272;737;67;26;2;24;.923;3688000;0
27291;184158;738;82;26;1;25;.962;3688000;0
27291;201947;737;0;0;0;0;.00nan;0;0
27292;2195;748;71;18;1;17;.944;3600000;0
27292;203533;748;0;0;0;0;.00nan;0;0
27292;175764;747;62;11;0;11;1.000;948000;0
27292;180177;747;33;33;6;27;.818;2652000;0
27293;3359;751;0;0;0;0;.00nan;0;0
27293;3435;739;0;0;0;0;.00nan;0;0
27293;148788;751;60;31;4;27;.871;3844000;0
27293;152624;739;79;46;4;42;.913;3900000;0
27294;3165;1880;0;0;0;0;.00nan;0;0
27294;44526;734;72;25;2;23;.920;3600000;0
27294;-1;734;0;0;0;0;.00nan;0;0
27294;148503;1880;75;37;3;34;.919;3580000;0
27295;196698;744;0;0;0;0;.00nan;0;0
27295;207771;744;71;30;3;27;.900;3543000;0
27295;56565;741;88;34;2;32;.941;3600000;0
27295;82273;741;0;0;0;0;.00nan;0;0
27296;198736;749;0;0;0;0;.00nan;0;0
27296;-1;764;82;29;1;28;.966;3600000;0
27296;-1;764;0;0;0;0;.00nan;0;0
27296;85661;749;70;42;4;38;.905;3600000;0
27297;206313;745;0;0;0;0;.00nan;0;0
27297;202104;745;82;36;3;33;.917;3694000;0
27297;-1;3789;0;0;0;0;.00nan;0;0
27297;91742;3789;80;30;2;28;.933;3694000;0
27298;204272;737;0;0;0;0;.00nan;0;0
27298;201947;737;69;26;2;24;.923;3900000;0
27298;44526;734;77;35;2;33;.943;3900000;0
27298;-1;734;0;0;0;0;.00nan;0;0
27299;178098;733;100;37;1;36;.973;3600000;0
27299;31165;752;0;0;0;0;.00nan;0;0
27299;66245;733;0;0;0;0;.00nan;0;0
27299;149221;752;49;19;3;16;.842;3544000;0
27300;359;740;100;41;1;40;.976;3600000;0
27300;2643;736;71;35;3;32;.914;3524000;0
27300;207184;740;0;0;0;0;.00nan;0;0
27300;74734;736;0;0;0;0;.00nan;0;0
27301;195887;743;0;0;0;0;.00nan;0;0
27301;202516;743;90;31;1;30;.968;3600000;0
27301;-1;742;0;0;0;0;.00nan;0;0
27301;85797;742;39;27;5;22;.815;3600000;0
27302;3165;1880;78;29;3;26;.897;3684000;0
27302;203977;729;0;0;0;0;.00nan;0;0
27302;211604;729;87;40;2;38;.950;3684000;0
27302;148503;1880;0;0;0;0;.00nan;0;0
27303;1957;738;59;34;4;30;.882;3554000;0
27303;3435;739;70;23;2;21;.913;3600000;0
27303;184158;738;0;0;0;0;.00nan;0;0
27303;152624;739;0;0;0;0;.00nan;0;0
27304;175764;747;0;0;0;0;.00nan;0;0
27304;180177;747;64;22;2;20;.909;3570000;0
27304;49935;2168;0;0;0;0;.00nan;0;0
27304;76405;2168;99;32;1;31;.969;3600000;0
27305;2195;748;100;32;0;32;1.000;3600000;0
27305;203533;748;0;0;0;0;.00nan;0;0
27305;31165;752;89;31;1;30;.968;3546000;0
27305;149221;752;0;0;0;0;.00nan;0;0
27306;195887;743;87;34;2;32;.941;3600000;0
27306;202516;743;0;0;0;0;.00nan;0;0
27306;-1;764;68;33;4;29;.879;3516000;0
27306;-1;764;0;0;0;0;.00nan;0;0
27307;204272;737;40;37;6;31;.838;3567000;0
27307;178098;733;78;39;4;35;.897;3600000;0
27307;201947;737;0;0;0;0;.00nan;0;0
27307;66245;733;0;0;0;0;.00nan;0;0
27308;198736;749;0;0;0;0;.00nan;0;0
27308;206313;745;0;0;0;0;.00nan;0;0
27308;202104;745;77;39;3;36;.923;3531000;0
27308;85661;749;63;17;1;16;.941;3600000;0
27309;-1;3789;0;0;0;0;.00nan;0;0
27309;-1;742;0;0;0;0;.00nan;0;0
27309;85797;742;38;25;5;20;.800;3558000;0
27309;91742;3789;58;34;4;30;.882;3600000;0
27310;359;740;73;30;3;27;.900;3702000;0
27310;595;732;74;28;2;26;.929;3702000;0
27310;8505;732;0;0;0;0;.00nan;0;0
27310;207184;740;0;0;0;0;.00nan;0;0
27311;196698;744;0;0;0;0;.00nan;0;0
27311;207771;744;38;24;4;20;.833;3525000;0
27311;56565;741;80;41;3;38;.927;3600000;0
27311;82273;741;0;0;0;0;.00nan;0;0
27312;2643;736;0;0;0;0;.00nan;0;0
27312;3435;739;0;0;0;0;.00nan;0;0
27312;74734;736;82;55;4;51;.927;3531000;0
27312;152624;739;46;14;2;12;.857;3600000;0
27313;3165;1880;0;0;0;0;.00nan;0;0
27313;49935;2168;61;37;4;33;.892;3571000;0
27313;76405;2168;0;0;0;0;.00nan;0;0
27313;148503;1880;89;38;2;36;.947;3600000;0
27314;2195;748;80;43;3;40;.930;3600000;0
27314;203533;748;0;0;0;0;.00nan;0;0
27314;56565;741;51;33;4;29;.879;3572000;0
27314;82273;741;0;0;0;0;.00nan;0;0
27315;178098;733;100;32;0;32;1.000;3600000;0
27315;206313;745;57;29;3;26;.897;3600000;0
27315;202104;745;0;0;0;0;.00nan;0;0
27315;66245;733;0;0;0;0;.00nan;0;0
27316;3359;751;0;0;0;0;.00nan;0;0
27316;31165;752;0;0;0;0;.00nan;0;0
27316;148788;751;90;33;1;32;.970;3600000;0
27316;149221;752;84;36;2;34;.944;3545000;0
27317;359;740;96;46;2;44;.957;3900000;0
27317;1957;738;0;0;0;0;.00nan;0;0
27317;184158;738;69;24;2;22;.917;3900000;0
27317;207184;740;0;0;0;0;.00nan;0;0
27318;204272;737;0;0;0;0;.00nan;0;0
27318;201947;737;89;40;2;38;.950;3581000;0
27318;44526;734;92;27;1;26;.963;3600000;0
27318;-1;734;0;0;0;0;.00nan;0;0
27319;195887;743;0;0;0;0;.00nan;0;0
27319;202516;743;81;34;2;32;.941;3900000;0
27319;-1;764;68;24;2;22;.917;3900000;0
27319;-1;764;0;0;0;0;.00nan;0;0
27320;196698;744;0;0;0;0;.00nan;0;0
27320;207771;744;61;23;2;21;.913;3733000;0
27320;-1;742;0;0;0;0;.00nan;0;0
27320;85797;742;91;42;3;39;.929;3733000;0
27321;595;732;62;41;5;36;.878;3600000;0
27321;8505;732;0;0;0;0;.00nan;0;0
27321;203977;729;0;0;0;0;.00nan;0;0
27321;211604;729;80;31;3;28;.903;3600000;0
27322;2643;736;69;68;6;62;.912;3900000;0
27322;49935;2168;34;25;6;19;.760;3900000;0
27322;74734;736;0;0;0;0;.00nan;0;0
27322;76405;2168;0;0;0;0;.00nan;0;0
27323;595;732;99;30;1;29;.967;3900000;0
27323;8505;732;0;0;0;0;.00nan;0;0
27323;206313;745;0;0;0;0;.00nan;0;0
27323;202104;745;77;30;1;29;.967;3900000;0
27324;3359;751;85;39;3;36;.923;3568000;0
27324;56565;741;91;34;1;33;.971;3600000;0
27324;82273;741;0;0;0;0;.00nan;0;0
27324;148788;751;0;0;0;0;.00nan;0;0
27325;1957;738;0;0;0;0;.00nan;0;0
27325;184158;738;48;33;5;28;.848;3547000;0
27325;44526;734;67;39;4;35;.897;3600000;0
27325;-1;734;0;0;0;0;.00nan;0;0
27326;359;740;68;42;5;37;.881;3600000;0
27326;3435;739;100;23;0;23;1.000;3600000;0
27326;207184;740;0;0;0;0;.00nan;0;0
27326;152624;739;0;0;0;0;.00nan;0;0
27327;196698;744;99;44;1;43;.977;3600000;0
27327;207771;744;0;0;0;0;.00nan;0;0
27327;-1;764;73;36;3;33;.917;3595000;0
27327;-1;764;0;0;0;0;.00nan;0;0
27328;178098;733;83;38;3;35;.921;3600000;0
27328;66245;733;0;0;0;0;.00nan;0;0
27328;85661;749;0;0;0;0;.00nan;0;0
27328;91742;749;30;21;5;16;.762;3584000;0
27329;3165;1880;72;23;1;22;.957;3600000;0
27329;203977;729;0;0;0;0;.00nan;0;0
27329;211604;729;72;41;4;37;.902;3600000;0
27329;148503;1880;0;0;0;0;.00nan;0;0
27330;195887;743;77;37;3;34;.919;3570000;0
27330;202516;743;0;0;0;0;.00nan;0;0
27330;-1;742;0;0;0;0;.00nan;0;0
27330;85797;742;87;36;2;34;.944;3600000;0
27331;204272;737;62;28;3;25;.893;3900000;0
27331;175764;747;76;43;3;40;.930;3900000;0
27331;180177;747;0;0;0;0;.00nan;0;0
27331;201947;737;0;0;0;0;.00nan;0;0
27332;198736;3789;0;0;0;0;.00nan;0;0
27332;44526;734;30;10;3;7;.700;600000;0
27332;-1;3789;60;25;3;22;.880;3600000;0
27332;-1;734;59;21;2;19;.905;3000000;0
27333;196698;744;0;0;0;0;.00nan;0;0
27333;207771;744;41;26;4;22;.846;3892000;0
27333;-1;764;80;48;5;43;.896;3892000;0
27333;-1;764;0;0;0;0;.00nan;0;0
27334;595;732;85;27;1;26;.963;3600000;0
27334;8505;732;0;0;0;0;.00nan;0;0
27334;178098;733;31;35;7;28;.800;3600000;0
27334;66245;733;0;0;0;0;.00nan;0;0
27335;56565;741;47;31;5;26;.839;3600000;0
27335;82273;741;0;0;0;0;.00nan;0;0
27335;85661;749;65;32;4;28;.875;3600000;0
27335;91742;749;0;0;0;0;.00nan;0;0
27336;2643;736;84;39;3;36;.923;3582000;0
27336;203977;729;0;0;0;0;.00nan;0;0
27336;211604;729;73;21;1;20;.952;3600000;0
27336;74734;736;0;0;0;0;.00nan;0;0
27337;3435;739;69;34;3;31;.912;3542000;0
27337;175764;747;0;0;0;0;.00nan;0;0
27337;180177;747;91;34;1;33;.971;3600000;0
27337;152624;739;0;0;0;0;.00nan;0;0
27338;1957;738;0;0;0;0;.00nan;0;0
27338;184158;738;90;31;1;30;.968;3600000;0
27338;195887;743;61;22;3;19;.864;3529000;0
27338;202516;743;0;0;0;0;.00nan;0;0
27339;2195;748;48;31;5;26;.839;3600000;0
27339;203533;748;0;0;0;0;.00nan;0;0
27339;49935;2168;84;28;1;27;.964;3600000;0
27339;76405;2168;0;0;0;0;.00nan;0;0
27340;3165;1880;0;0;0;0;.00nan;0;0
27340;-1;742;0;0;0;0;.00nan;0;0
27340;85797;742;100;30;0;30;1.000;3600000;0
27340;148503;1880;78;31;2;29;.935;3557000;0
27341;359;740;0;0;0;0;.00nan;0;0
27341;3359;751;0;0;0;0;.00nan;0;0
27341;207184;740;90;57;4;53;.930;3600000;0
27341;148788;751;59;14;1;13;.929;3600000;0
27342;204272;737;0;0;0;0;.00nan;0;0
27342;31165;752;0;0;0;0;.00nan;0;0
27342;201947;737;61;29;2;27;.931;3587000;0
27342;149221;752;94;33;1;32;.970;3600000;0
27343;595;732;63;48;6;42;.875;3600000;0
27343;198736;3789;100;27;0;27;1.000;3600000;0
27343;8505;732;0;0;0;0;.00nan;0;0
27343;-1;3789;0;0;0;0;.00nan;0;0
27344;196698;744;0;0;0;0;.00nan;0;0
27344;207771;744;62;40;5;35;.875;3900000;0
27344;85661;749;63;48;5;43;.896;3900000;0
27344;91742;749;0;0;0;0;.00nan;0;0
27345;203977;729;15;16;6;10;.625;1672000;0
27345;211604;729;38;23;4;19;.826;1928000;0
27345;-1;764;87;37;3;34;.919;3600000;0
27345;-1;764;0;0;0;0;.00nan;0;0
27346;2643;736;70;35;3;32;.914;3555000;0
27346;175764;747;0;0;0;0;.00nan;0;0
27346;180177;747;68;28;2;26;.929;3600000;0
27346;74734;736;0;0;0;0;.00nan;0;0
27347;204272;737;79;53;3;50;.943;3600000;0
27347;195887;743;72;25;2;23;.920;3600000;0
27347;201947;737;0;0;0;0;.00nan;0;0
27347;202516;743;0;0;0;0;.00nan;0;0
27348;1957;738;0;0;0;0;.00nan;0;0
27348;184158;738;75;25;2;23;.920;3600000;0
27348;44526;734;46;26;4;22;.846;3597000;0
27348;-1;734;0;0;0;0;.00nan;0;0
27349;2195;748;70;25;2;23;.920;3600000;0
27349;203533;748;0;0;0;0;.00nan;0;0
27349;56565;741;0;0;0;0;.00nan;0;0
27349;82273;741;71;34;3;31;.912;3545000;0
27350;3359;751;71;25;2;23;.920;3600000;0
27350;49935;2168;0;0;0;0;.00nan;0;0
27350;76405;2168;69;34;3;31;.912;3600000;0
27350;148788;751;0;0;0;0;.00nan;0;0
27351;359;740;58;36;5;31;.861;3600000;0
27351;207184;740;0;0;0;0;.00nan;0;0
27351;-1;742;0;0;0;0;.00nan;0;0
27351;85797;742;77;30;1;29;.967;3600000;0
27352;3435;739;100;35;0;35;1.000;3600000;0
27352;31165;752;77;28;2;26;.929;3578000;0
27352;149221;752;0;0;0;0;.00nan;0;0
27352;152624;739;0;0;0;0;.00nan;0;0
27353;206313;745;100;32;0;32;1.000;3600000;0
27353;202104;745;0;0;0;0;.00nan;0;0
27353;85661;749;61;17;1;16;.941;3600000;0
27353;91742;749;0;0;0;0;.00nan;0;0
27354;198736;3789;56;27;3;24;.889;3599000;0
27354;178098;733;89;36;2;34;.944;3593000;0
27354;-1;3789;0;0;0;0;.00nan;0;0
27354;66245;733;0;0;0;0;.00nan;0;0
27355;195887;743;0;0;0;0;.00nan;0;0
27355;202516;743;80;30;2;28;.933;3600000;0
27355;-1;742;0;0;0;0;.00nan;0;0
27355;85797;742;60;33;4;29;.879;3600000;0
27356;44526;734;40;29;5;24;.828;3600000;0
27356;-1;764;74;22;1;21;.955;3600000;0
27356;-1;734;0;0;0;0;.00nan;0;0
27356;-1;764;0;0;0;0;.00nan;0;0
27357;3359;751;0;0;0;0;.00nan;0;0
27357;56565;741;62;27;3;24;.889;3600000;0
27357;82273;741;0;0;0;0;.00nan;0;0
27357;148788;751;100;25;0;25;1.000;3600000;0
27358;3435;739;99;44;1;43;.977;3600000;0
27358;49935;2168;73;25;2;23;.920;3545000;0
27358;76405;2168;0;0;0;0;.00nan;0;0
27358;152624;739;0;0;0;0;.00nan;0;0
27359;2643;736;72;55;5;50;.909;3600000;0
27359;31165;752;0;0;0;0;.00nan;0;0
27359;74734;736;0;0;0;0;.00nan;0;0
27359;149221;752;51;14;2;12;.857;3600000;0
27360;2195;748;44;42;6;36;.857;3344000;0
27360;203533;748;39;1;1;0;.000;256000;0
27360;196698;744;45;16;3;13;.813;3600000;0
27360;207771;744;0;0;0;0;.00nan;0;0
27361;1957;738;0;0;0;0;.00nan;0;0
27361;203977;729;0;0;0;0;.00nan;0;0
27361;184158;738;77;24;1;23;.958;3600000;0
27361;211604;729;74;47;4;43;.915;3600000;0
27362;198736;3789;78;26;1;25;.962;3600000;0
27362;206313;745;28;26;6;20;.769;2429000;0
27362;202104;745;58;9;1;8;.889;1171000;0
27362;-1;3789;0;0;0;0;.00nan;0;0
27363;359;740;100;32;0;32;1.000;3600000;0
27363;3165;1880;76;25;2;23;.920;3564000;0
27363;207184;740;0;0;0;0;.00nan;0;0
27363;148503;1880;0;0;0;0;.00nan;0;0
27364;595;732;65;38;4;34;.895;3544000;0
27364;8505;732;0;0;0;0;.00nan;0;0
27364;178098;733;75;30;2;28;.933;3600000;0
27364;66245;733;0;0;0;0;.00nan;0;0
27365;204272;737;0;0;0;0;.00nan;0;0
27365;201947;737;80;37;3;34;.919;3600000;0
27365;-1;764;50;37;5;32;.865;3530000;0
27365;-1;764;0;0;0;0;.00nan;0;0
27366;196698;744;0;0;0;0;.00nan;0;0
27366;207771;744;59;22;2;20;.909;3600000;0
27366;44526;734;74;43;3;40;.930;3600000;0
27366;-1;734;0;0;0;0;.00nan;0;0
27367;180177;747;0;0;0;0;.00nan;0;0
27367;56565;741;73;26;2;24;.923;3600000;0
27367;71565;747;46;35;5;30;.857;3600000;0
27367;82273;741;0;0;0;0;.00nan;0;0
27368;2643;736;59;32;4;28;.875;3600000;0
27368;49935;2168;84;31;1;30;.968;3600000;0
27368;74734;736;0;0;0;0;.00nan;0;0
27368;76405;2168;0;0;0;0;.00nan;0;0
27369;-1;742;0;0;0;0;.00nan;0;0
27369;85661;749;75;25;2;23;.920;3600000;0
27369;85797;742;53;21;3;18;.857;3600000;0
27369;91742;749;0;0;0;0;.00nan;0;0
27370;3359;751;0;0;0;0;.00nan;0;0
27370;31165;752;0;0;0;0;.00nan;0;0
27370;148788;751;100;29;0;29;1.000;3600000;0
27370;149221;752;84;46;4;42;.913;3600000;0
27371;203977;729;0;0;0;0;.00nan;0;0
27371;211604;729;70;35;3;32;.914;3567000;0
27371;207184;740;0;0;0;0;.00nan;0;0
27371;86151;740;65;27;3;24;.889;3600000;0
27372;1957;738;0;0;0;0;.00nan;0;0
27372;3165;1880;0;0;0;0;.00nan;0;0
27372;184158;738;34;23;4;19;.826;3554000;0
27372;148503;1880;100;48;2;46;.958;3600000;0
27373;178098;733;79;28;3;25;.893;3528000;0
27373;202104;745;0;0;0;0;.00nan;0;0
27373;66245;733;0;0;0;0;.00nan;0;0
27373;75362;745;82;19;1;18;.947;3600000;0
27374;595;732;70;37;4;33;.892;3600000;0
27374;202516;743;0;0;0;0;.00nan;0;0
27374;87798;743;72;25;3;22;.880;3600000;0
27374;88646;732;0;0;0;0;.00nan;0;0
27375;2195;748;82;27;1;26;.963;3600000;0
27375;3435;739;0;0;0;0;.00nan;0;0
27375;203533;748;0;0;0;0;.00nan;0;0
27375;152624;739;67;33;3;30;.909;3545000;0
27376;204272;737;77;20;1;19;.950;3600000;0
27376;180177;747;0;0;0;0;.00nan;0;0
27376;201947;737;0;0;0;0;.00nan;0;0
27376;71565;747;85;49;4;45;.918;3600000;0
27377;-1;764;99;47;3;44;.936;3600000;0
27377;-1;764;0;0;0;0;.00nan;0;0
27377;85661;749;73;40;4;36;.900;3600000;0
27377;91742;749;0;0;0;0;.00nan;0;0
27378;3359;751;0;0;0;0;.00nan;0;0
27378;49935;2168;75;23;1;22;.957;3600000;0
27378;76405;2168;0;0;0;0;.00nan;0;0
27378;148788;751;61;24;2;22;.917;3546000;0
27379;203977;729;0;0;0;0;.00nan;0;0
27379;211604;729;74;37;3;34;.919;3574000;0
27379;44526;734;66;25;2;23;.920;3600000;0
27379;-1;734;0;0;0;0;.00nan;0;0
27380;198736;3789;71;34;3;31;.912;3559000;0
27380;202516;743;0;0;0;0;.00nan;0;0
27380;-1;3789;0;0;0;0;.00nan;0;0
27380;87798;743;100;46;2;44;.957;3600000;0
27381;3165;1880;81;25;1;24;.960;3900000;0
27381;178098;733;96;38;1;37;.974;3900000;0
27381;66245;733;0;0;0;0;.00nan;0;0
27381;148503;1880;0;0;0;0;.00nan;0;0
27382;-1;742;0;0;0;0;.00nan;0;0
27382;56565;741;97;21;0;21;1.000;3600000;0
27382;82273;741;0;0;0;0;.00nan;0;0
27382;85797;742;63;30;3;27;.900;3600000;0
27383;31165;752;0;0;0;0;.00nan;0;0
27383;196698;744;0;0;0;0;.00nan;0;0
27383;207771;744;77;36;3;33;.917;3900000;0
27383;149221;752;56;29;3;26;.897;3900000;0
27384;180177;747;0;0;0;0;.00nan;0;0
27384;202104;745;0;0;0;0;.00nan;0;0
27384;71565;747;86;39;2;37;.949;3900000;0
27384;75362;745;66;23;2;21;.913;3900000;0
27385;2195;748;70;22;1;21;.955;3600000;0
27385;203533;748;0;0;0;0;.00nan;0;0
27385;204272;737;0;0;0;0;.00nan;0;0
27385;201947;737;79;28;2;26;.929;3546000;0
27386;595;732;53;23;3;20;.870;3571000;0
27386;1957;738;76;26;1;25;.962;3600000;0
27386;184158;738;0;0;0;0;.00nan;0;0
27386;88646;732;0;0;0;0;.00nan;0;0
27387;3359;751;86;29;1;28;.966;3600000;0
27387;198736;3789;54;31;3;28;.903;3553000;0
27387;-1;3789;0;0;0;0;.00nan;0;0
27387;148788;751;0;0;0;0;.00nan;0;0
27388;3435;739;84;25;1;24;.960;3600000;0
27388;204272;737;65;37;4;33;.892;3600000;0
27388;201947;737;0;0;0;0;.00nan;0;0
27388;152624;739;0;0;0;0;.00nan;0;0
27389;202516;743;0;0;0;0;.00nan;0;0
27389;85661;749;77;22;2;20;.909;3579000;0
27389;87798;743;94;31;1;30;.968;3600000;0
27389;91742;749;0;0;0;0;.00nan;0;0
27390;-1;764;43;22;4;18;.818;3568000;0
27390;-1;764;0;0;0;0;.00nan;0;0
27390;56565;741;75;37;3;34;.919;3600000;0
27390;82273;741;0;0;0;0;.00nan;0;0
27391;2643;736;63;35;5;30;.857;2314000;0
27391;3165;1880;0;0;0;0;.00nan;0;0
27391;74734;736;52;11;1;10;.909;1286000;0
27391;148503;1880;75;31;2;29;.935;3600000;0
27392;207184;740;0;0;0;0;.00nan;0;0
27392;44526;734;46;24;4;20;.833;3590000;0
27392;-1;734;0;0;0;0;.00nan;0;0
27392;86151;740;88;45;3;42;.933;3600000;0
27393;-1;742;0;0;0;0;.00nan;0;0
27393;49935;2168;0;0;0;0;.00nan;0;0
27393;76405;2168;78;31;2;29;.935;3600000;0
27393;85797;742;47;17;3;14;.824;3600000;0
27394;203977;729;0;0;0;0;.00nan;0;0
27394;211604;729;51;36;5;31;.861;3563000;0
27394;202104;745;0;0;0;0;.00nan;0;0
27394;75362;745;86;37;3;34;.919;3600000;0
27395;2195;748;50;16;2;14;.875;3600000;0
27395;203533;748;0;0;0;0;.00nan;0;0
27395;178098;733;32;14;4;10;.714;1192000;0
27395;66245;733;70;32;2;30;.938;2408000;0
27396;180177;747;0;0;0;0;.00nan;0;0
27396;196698;744;0;0;0;0;.00nan;0;0
27396;207771;744;69;18;1;17;.944;3600000;0
27396;71565;747;78;39;3;36;.923;3558000;0
27397;1957;738;0;0;0;0;.00nan;0;0
27397;3359;751;67;21;2;19;.905;3600000;0
27397;184158;738;53;30;3;27;.900;3561000;0
27397;148788;751;0;0;0;0;.00nan;0;0
27398;2643;736;33;41;7;34;.829;3083000;0
27398;198736;3789;46;18;4;14;.778;3600000;0
27398;-1;3789;0;0;0;0;.00nan;0;0
27398;74734;736;51;2;0;2;1.000;517000;0
27399;3435;739;92;37;2;35;.946;3600000;0
27399;44526;734;53;33;5;28;.848;3205000;0
27399;-1;734;50;7;1;6;.857;395000;0
27399;152624;739;0;0;0;0;.00nan;0;0
27400;-1;764;0;0;0;0;.00nan;0;0
27400;-1;764;47;24;3;21;.875;3600000;0
27400;56565;741;27;28;6;22;.786;3262000;0
27400;82273;741;40;2;1;1;.500;338000;0
27401;207184;740;0;0;0;0;.00nan;0;0
27401;49935;2168;0;0;0;0;.00nan;0;0
27401;76405;2168;79;41;3;38;.927;3700000;0
27401;86151;740;78;40;4;36;.900;3700000;0
27402;-1;742;0;0;0;0;.00nan;0;0
27402;85661;749;78;32;3;29;.906;3596000;0
27402;85797;742;100;39;1;38;.974;3600000;0
27402;91742;749;0;0;0;0;.00nan;0;0
27403;595;732;71;25;2;23;.920;3600000;0
27403;204272;737;0;0;0;0;.00nan;0;0
27403;201947;737;74;42;4;38;.905;3600000;0
27403;88646;732;0;0;0;0;.00nan;0;0
27404;2195;748;64;24;2;22;.917;3900000;0
27404;203533;748;0;0;0;0;.00nan;0;0
27404;202104;745;0;0;0;0;.00nan;0;0
27404;75362;745;96;38;2;36;.947;3900000;0
27405;204272;737;69;38;3;35;.921;3586000;0
27405;178098;733;77;21;2;19;.905;3600000;0
27405;201947;737;0;0;0;0;.00nan;0;0
27405;66245;733;0;0;0;0;.00nan;0;0
27406;3165;1880;59;29;3;26;.897;3600000;0
27406;203977;729;0;0;0;0;.00nan;0;0
27406;211604;729;100;26;0;26;1.000;3600000;0
27406;148503;1880;0;0;0;0;.00nan;0;0
27407;31165;752;78;25;1;24;.960;3900000;0
27407;202516;743;0;0;0;0;.00nan;0;0
27407;87798;743;86;33;1;32;.970;3900000;0
27407;149221;752;0;0;0;0;.00nan;0;0
27408;1957;738;0;0;0;0;.00nan;0;0
27408;2643;736;60;28;3;25;.893;3566000;0
27408;184158;738;90;35;2;33;.943;3600000;0
27408;74734;736;0;0;0;0;.00nan;0;0
27409;198736;3789;84;38;2;36;.947;3560000;0
27409;44526;734;80;25;1;24;.960;3600000;0
27409;-1;3789;0;0;0;0;.00nan;0;0
27409;-1;734;0;0;0;0;.00nan;0;0
27410;-1;764;66;31;3;28;.903;3600000;0
27410;-1;764;0;0;0;0;.00nan;0;0
27410;85661;749;37;24;5;19;.792;3074000;0
27410;91742;749;50;1;0;1;1.000;499000;0
27411;196698;744;0;0;0;0;.00nan;0;0
27411;207771;744;65;15;1;14;.933;3600000;0
27411;49935;2168;0;0;0;0;.00nan;0;0
27411;76405;2168;66;47;6;41;.872;3600000;0
27412;595;732;81;23;1;22;.957;3600000;0
27412;3359;751;0;0;0;0;.00nan;0;0
27412;88646;732;0;0;0;0;.00nan;0;0
27412;148788;751;40;22;4;18;.818;3600000;0
27413;31165;752;88;36;2;34;.944;3518000;0
27413;202516;743;0;0;0;0;.00nan;0;0
27413;87798;743;86;18;0;18;1.000;3600000;0
27413;149221;752;0;0;0;0;.00nan;0;0
27414;2195;748;0;0;0;0;.00nan;0;0
27414;203533;748;50;22;3;19;.864;3600000;0
27414;-1;742;0;0;0;0;.00nan;0;0
27414;85797;742;58;38;5;33;.868;3600000;0
27415;3435;739;38;30;5;25;.833;3900000;0
27415;178098;733;48;30;5;25;.833;3900000;0
27415;66245;733;0;0;0;0;.00nan;0;0
27415;152624;739;0;0;0;0;.00nan;0;0
27416;204272;737;0;0;0;0;.00nan;0;0
27416;201947;737;57;27;3;24;.889;3600000;0
27416;207184;740;0;0;0;0;.00nan;0;0
27416;86151;740;66;39;4;35;.897;3543000;0
27417;3165;1880;0;0;0;0;.00nan;0;0
27417;203977;729;0;0;0;0;.00nan;0;0
27417;211604;729;75;25;1;24;.960;3600000;0
27417;148503;1880;58;29;4;25;.862;3600000;0
27418;180177;747;0;0;0;0;.00nan;0;0
27418;202516;743;0;0;0;0;.00nan;0;0
27418;71565;747;73;35;3;32;.914;3512000;0
27418;87798;743;67;21;1;20;.952;3600000;0
27419;-1;764;67;36;4;32;.889;3600000;0
27419;-1;764;0;0;0;0;.00nan;0;0
27419;85661;749;86;30;1;29;.967;3600000;0
27419;91742;749;0;0;0;0;.00nan;0;0
27420;196698;744;0;0;0;0;.00nan;0;0
27420;207771;744;100;33;0;33;1.000;3600000;0
27420;56565;741;73;44;4;40;.909;3600000;0
27420;82273;741;0;0;0;0;.00nan;0;0
27421;31165;752;67;31;3;28;.903;3600000;0
27421;202104;745;0;0;0;0;.00nan;0;0
27421;75362;745;67;25;2;23;.920;3600000;0
27421;149221;752;0;0;0;0;.00nan;0;0
27422;3359;751;45;31;5;26;.839;3600000;0
27422;-1;742;49;7;1;6;.857;1098000;0
27422;85797;742;20;22;6;16;.727;2488000;0
27422;148788;751;0;0;0;0;.00nan;0;0
27423;3435;739;79;39;3;36;.923;3550000;0
27423;203977;729;0;0;0;0;.00nan;0;0
27423;211604;729;87;40;2;38;.950;3600000;0
27423;152624;739;0;0;0;0;.00nan;0;0
27424;178098;733;49;30;5;25;.833;3600000;0
27424;44526;734;63;31;3;28;.903;3600000;0
27424;-1;734;0;0;0;0;.00nan;0;0
27424;66245;733;0;0;0;0;.00nan;0;0
27425;2643;736;0;0;0;0;.00nan;0;0
27425;204272;737;66;33;3;30;.909;3900000;0
27425;201947;737;0;0;0;0;.00nan;0;0
27425;74734;736;67;37;3;34;.919;3900000;0
27426;1957;738;0;0;0;0;.00nan;0;0
27426;3165;1880;60;29;3;26;.897;3600000;0
27426;184158;738;79;49;4;45;.918;3555000;0
27426;148503;1880;0;0;0;0;.00nan;0;0
27427;595;732;69;24;2;22;.917;3600000;0
27427;207184;740;0;0;0;0;.00nan;0;0
27427;86151;740;86;41;3;38;.927;3545000;0
27427;88646;732;0;0;0;0;.00nan;0;0
27428;180177;747;0;0;0;0;.00nan;0;0
27428;202516;743;0;0;0;0;.00nan;0;0
27428;71565;747;43;45;7;38;.844;3600000;0
27428;87798;743;79;27;2;25;.926;3600000;0
27429;196698;744;0;0;0;0;.00nan;0;0
27429;207771;744;73;17;1;16;.941;3600000;0
27429;85661;749;80;36;2;34;.944;3545000;0
27429;91742;749;0;0;0;0;.00nan;0;0
27430;31165;752;69;20;1;19;.950;3600000;0
27430;202104;745;0;0;0;0;.00nan;0;0
27430;75362;745;59;30;3;27;.900;3514000;0
27430;149221;752;0;0;0;0;.00nan;0;0
27431;2195;748;100;24;0;24;1.000;3600000;0
27431;203533;748;0;0;0;0;.00nan;0;0
27431;-1;764;66;26;2;24;.923;3536000;0
27431;-1;764;0;0;0;0;.00nan;0;0
27432;3359;751;0;0;0;0;.00nan;0;0
27432;3435;739;97;43;2;41;.953;3545000;0
27432;148788;751;76;23;1;22;.957;3600000;0
27432;152624;739;0;0;0;0;.00nan;0;0
27433;203977;729;0;0;0;0;.00nan;0;0
27433;178098;733;82;28;2;26;.929;3600000;0
27433;211604;729;83;31;1;30;.968;3600000;0
27433;66245;733;0;0;0;0;.00nan;0;0
27434;198736;3789;80;42;3;39;.929;3600000;0
27434;204272;737;0;0;0;0;.00nan;0;0
27434;201947;737;99;46;2;44;.957;3600000;0
27434;-1;3789;0;0;0;0;.00nan;0;0
27435;595;732;100;46;2;44;.957;3615000;0
27435;56565;741;55;26;3;23;.885;3615000;0
27435;82273;741;0;0;0;0;.00nan;0;0
27435;88646;732;0;0;0;0;.00nan;0;0
27436;-1;742;0;0;0;0;.00nan;0;0
27436;49935;2168;0;0;0;0;.00nan;0;0
27436;76405;2168;89;30;2;28;.933;3884000;0
27436;85797;742;84;30;1;29;.967;3884000;0
27437;2643;736;71;36;3;33;.917;3569000;0
27437;44526;734;72;20;1;19;.950;3600000;0
27437;-1;734;0;0;0;0;.00nan;0;0
27437;74734;736;0;0;0;0;.00nan;0;0
27438;1957;738;0;0;0;0;.00nan;0;0
27438;184158;738;96;32;1;31;.969;3839000;0
27438;207184;740;0;0;0;0;.00nan;0;0
27438;86151;740;86;33;2;31;.939;3839000;0
27439;180177;747;0;0;0;0;.00nan;0;0
27439;202104;745;0;0;0;0;.00nan;0;0
27439;71565;747;70;17;1;16;.941;3600000;0
27439;75362;745;79;43;4;39;.907;3600000;0
27440;3165;1880;61;40;4;36;.900;3600000;0
27440;56565;741;0;0;0;0;.00nan;0;0
27440;82273;741;89;31;1;30;.968;3600000;0
27440;148503;1880;0;0;0;0;.00nan;0;0
27441;2195;748;53;28;5;23;.821;3519000;0
27441;3435;739;79;36;3;33;.917;3600000;0
27441;203533;748;0;0;0;0;.00nan;0;0
27441;152624;739;0;0;0;0;.00nan;0;0
27442;3359;751;59;34;4;30;.882;3567000;0
27442;44526;734;81;40;3;37;.925;3600000;0
27442;-1;734;0;0;0;0;.00nan;0;0
27442;148788;751;0;0;0;0;.00nan;0;0
27443;-1;764;100;29;0;29;1.000;3600000;0
27443;-1;764;0;0;0;0;.00nan;0;0
27443;49935;2168;0;0;0;0;.00nan;0;0
27443;76405;2168;72;34;3;31;.912;3600000;0
27444;595;732;100;48;1;47;.979;3900000;0
27444;85661;749;0;0;0;0;.00nan;0;0
27444;88646;732;0;0;0;0;.00nan;0;0
27444;91742;749;95;32;1;31;.969;3900000;0
27445;2643;736;95;53;3;50;.943;3600000;0
27445;198736;3789;51;31;5;26;.839;3525000;0
27445;-1;3789;0;0;0;0;.00nan;0;0
27445;74734;736;0;0;0;0;.00nan;0;0
27446;196698;744;75;29;2;27;.931;3600000;0
27446;207771;744;0;0;0;0;.00nan;0;0
27446;-1;742;0;0;0;0;.00nan;0;0
27446;85797;742;38;27;4;23;.852;3529000;0
27447;1957;738;0;0;0;0;.00nan;0;0
27447;3165;1880;0;0;0;0;.00nan;0;0
27447;184158;738;88;46;3;43;.935;3600000;0
27447;148503;1880;100;25;0;25;1.000;3600000;0
27448;180177;747;0;0;0;0;.00nan;0;0
27448;202104;745;0;0;0;0;.00nan;0;0
27448;71565;747;79;29;3;26;.897;3900000;0
27448;75362;745;86;46;3;43;.935;3900000;0
27449;204272;737;0;0;0;0;.00nan;0;0
27449;201947;737;39;23;4;19;.826;3600000;0
27449;56565;741;82;45;3;42;.933;3600000;0
27449;82273;741;0;0;0;0;.00nan;0;0
27450;31165;752;64;40;4;36;.900;3900000;0
27450;202516;743;0;0;0;0;.00nan;0;0
27450;87798;743;60;36;4;32;.889;3900000;0
27450;149221;752;0;0;0;0;.00nan;0;0
27451;178098;733;0;0;0;0;.00nan;0;0
27451;207184;740;0;0;0;0;.00nan;0;0
27451;66245;733;69;37;4;33;.892;3600000;0
27451;86151;740;65;28;3;25;.893;3600000;0
27452;2195;748;63;27;3;24;.889;3600000;0
27452;203533;748;0;0;0;0;.00nan;0;0
27452;44526;734;75;46;4;42;.913;3600000;0
27452;-1;734;0;0;0;0;.00nan;0;0
27453;3359;751;0;0;0;0;.00nan;0;0
27453;-1;764;62;33;4;29;.879;3516000;0
27453;-1;764;0;0;0;0;.00nan;0;0
27453;148788;751;81;36;2;34;.944;3600000;0
27454;198736;3789;86;29;2;27;.931;3600000;0
27454;-1;3789;0;0;0;0;.00nan;0;0
27454;85661;749;90;36;3;33;.917;3574000;0
27454;91742;749;0;0;0;0;.00nan;0;0
27455;595;732;89;46;2;44;.957;3600000;0
27455;196698;744;0;0;0;0;.00nan;0;0
27455;207771;744;82;22;1;21;.955;3600000;0
27455;88646;732;0;0;0;0;.00nan;0;0
27456;1957;738;0;0;0;0;.00nan;0;0
27456;204272;737;88;29;1;28;.966;3600000;0
27456;184158;738;82;42;4;38;.905;3600000;0
27456;201947;737;0;0;0;0;.00nan;0;0
27457;3435;739;92;27;0;27;1.000;3320000;0
27457;49935;2168;66;24;2;22;.917;2491000;0
27457;76405;2168;22;11;4;7;.636;1109000;0
27457;152624;739;23;3;3;0;.000;280000;0
27458;202516;743;0;0;0;0;.00nan;0;0
27458;56565;741;74;27;2;25;.926;3584000;0
27458;82273;741;0;0;0;0;.00nan;0;0
27458;87798;743;84;24;1;23;.958;3600000;0
27459;203977;729;0;0;0;0;.00nan;0;0
27459;178098;733;91;33;1;32;.970;3600000;0
27459;211604;729;76;42;4;38;.905;3600000;0
27459;66245;733;0;0;0;0;.00nan;0;0
27460;2643;736;80;35;3;32;.914;3600000;0
27460;31165;752;71;27;2;25;.926;3600000;0
27460;74734;736;0;0;0;0;.00nan;0;0
27460;149221;752;0;0;0;0;.00nan;0;0
27461;3165;1880;0;0;0;0;.00nan;0;0
27461;207184;740;0;0;0;0;.00nan;0;0
27461;86151;740;75;42;4;38;.905;3600000;0
27461;148503;1880;69;26;2;24;.923;3600000;0
27462;180177;747;0;0;0;0;.00nan;0;0
27462;-1;742;0;0;0;0;.00nan;0;0
27462;71565;747;47;26;4;22;.846;3600000;0
27462;85797;742;100;37;0;37;1.000;3600000;0
27463;196698;744;0;0;0;0;.00nan;0;0
27463;207771;744;65;36;4;32;.889;3536000;0
27463;-1;764;86;35;2;33;.943;3600000;0
27463;-1;764;0;0;0;0;.00nan;0;0
27464;3435;739;57;20;2;18;.900;3600000;0
27464;203977;729;0;0;0;0;.00nan;0;0
27464;211604;729;68;38;3;35;.921;3582000;0
27464;152624;739;0;0;0;0;.00nan;0;0
27465;3359;751;0;0;0;0;.00nan;0;0
27465;202516;743;0;0;0;0;.00nan;0;0
27465;87798;743;68;31;3;28;.903;3600000;0
27465;148788;751;100;34;0;34;1.000;3600000;0
27466;178098;733;70;32;3;29;.906;3600000;0
27466;49935;2168;0;0;0;0;.00nan;0;0
27466;66245;733;0;0;0;0;.00nan;0;0
27466;76405;2168;49;30;5;25;.833;3571000;0
27467;31165;752;47;32;4;28;.875;3600000;0
27467;56565;741;73;23;1;22;.957;3600000;0
27467;82273;741;0;0;0;0;.00nan;0;0
27467;149221;752;0;0;0;0;.00nan;0;0
27468;3165;1880;83;43;3;40;.930;3600000;0
27468;207184;740;0;0;0;0;.00nan;0;0
27468;86151;740;52;29;4;25;.862;3543000;0
27468;148503;1880;0;0;0;0;.00nan;0;0
27469;595;732;98;37;2;35;.946;3600000;0
27469;2195;748;25;28;6;22;.786;2870000;0
27469;203533;748;51;2;0;2;1.000;730000;0
27469;88646;732;0;0;0;0;.00nan;0;0
27470;1957;738;75;36;3;33;.917;3560000;0
27470;184158;738;0;0;0;0;.00nan;0;0
27470;44526;734;90;35;2;33;.943;3600000;0
27470;-1;734;0;0;0;0;.00nan;0;0
27471;198736;3789;0;0;0;0;.00nan;0;0
27471;204272;737;0;0;0;0;.00nan;0;0
27471;201947;737;67;28;3;25;.893;3600000;0
27471;-1;3789;85;61;6;55;.902;3600000;0
27472;-1;764;100;25;0;25;1.000;3600000;0
27472;-1;742;0;0;0;0;.00nan;0;0
27472;-1;764;0;0;0;0;.00nan;0;0
27472;85797;742;73;34;4;30;.882;3600000;0
27473;180177;747;0;0;0;0;.00nan;0;0
27473;196698;744;0;0;0;0;.00nan;0;0
27473;207771;744;100;25;0;25;1.000;3600000;0
27473;71565;747;62;42;5;37;.881;3600000;0
27474;202104;745;0;0;0;0;.00nan;0;0
27474;49935;2168;0;0;0;0;.00nan;0;0
27474;75362;745;78;29;2;27;.931;3600000;0
27474;76405;2168;66;31;3;28;.903;3575000;0
27475;203977;729;27;30;6;24;.800;3600000;0
27475;211604;729;0;0;0;0;.00nan;0;0
27475;85661;749;83;31;2;29;.935;3600000;0
27475;91742;749;0;0;0;0;.00nan;0;0
27476;2195;748;64;29;2;27;.931;3600000;0
27476;203533;748;0;0;0;0;.00nan;0;0
27476;202516;743;0;0;0;0;.00nan;0;0
27476;87798;743;87;41;3;38;.927;3558000;0
27477;3165;1880;87;42;3;39;.929;3600000;0
27477;3359;751;0;0;0;0;.00nan;0;0
27477;148503;1880;0;0;0;0;.00nan;0;0
27477;148788;751;96;18;0;18;1.000;3600000;0
27478;178098;733;15;6;4;2;.333;989000;0
27478;180177;747;0;0;0;0;.00nan;0;0
27478;66245;733;56;20;2;18;.900;2611000;0
27478;71565;747;63;28;3;25;.893;3600000;0
27479;2643;736;88;41;2;39;.951;3600000;0
27479;56565;741;64;34;3;31;.912;3568000;0
27479;74734;736;0;0;0;0;.00nan;0;0
27479;82273;741;0;0;0;0;.00nan;0;0
27480;595;732;100;29;0;29;1.000;3600000;0
27480;44526;734;80;31;1;30;.968;3576000;0
27480;-1;734;0;0;0;0;.00nan;0;0
27480;88646;732;0;0;0;0;.00nan;0;0
27481;1957;738;0;0;0;0;.00nan;0;0
27481;184158;738;38;34;7;27;.794;3600000;0
27481;202104;745;0;0;0;0;.00nan;0;0
27481;75362;745;49;27;4;23;.852;3600000;0
27482;198736;3789;90;33;1;32;.970;3900000;0
27482;-1;3789;0;0;0;0;.00nan;0;0
27482;85661;749;100;44;1;43;.977;3900000;0
27482;91742;749;0;0;0;0;.00nan;0;0
27483;3435;739;74;26;2;24;.923;3900000;0
27483;202516;743;0;0;0;0;.00nan;0;0
27483;87798;743;78;29;2;27;.931;3900000;0
27483;152624;739;0;0;0;0;.00nan;0;0
27484;3359;751;0;0;0;0;.00nan;0;0
27484;204272;737;97;42;1;41;.976;3586000;0
27484;201947;737;0;0;0;0;.00nan;0;0
27484;148788;751;100;22;0;22;1.000;3600000;0
27485;2195;748;29;23;6;17;.739;3250000;0
27485;203533;748;52;2;0;2;1.000;350000;0
27485;-1;764;100;25;0;25;1.000;3600000;0
27485;-1;764;0;0;0;0;.00nan;0;0
27486;31165;752;0;0;0;0;.00nan;0;0
27486;207184;740;0;0;0;0;.00nan;0;0
27486;86151;740;92;42;2;40;.952;3745000;0
27486;149221;752;63;14;1;13;.929;3745000;0
27487;196698;744;0;0;0;0;.00nan;0;0
27487;207771;744;71;19;2;17;.895;3600000;0
27487;49935;2168;0;0;0;0;.00nan;0;0
27487;76405;2168;79;35;3;32;.914;3589000;0
27488;2643;736;58;29;4;25;.862;3600000;0
27488;44526;734;0;0;0;0;.00nan;0;0
27488;-1;734;48;37;5;32;.865;3584000;0
27488;74734;736;0;0;0;0;.00nan;0;0
27489;-1;742;0;0;0;0;.00nan;0;0
27489;56565;741;41;31;6;25;.806;3600000;0
27489;82273;741;0;0;0;0;.00nan;0;0
27489;85797;742;99;40;2;38;.950;3600000;0
27490;2195;748;59;18;2;16;.889;3600000;0
27490;203533;748;0;0;0;0;.00nan;0;0
27490;202104;745;0;0;0;0;.00nan;0;0
27490;75362;745;83;37;3;34;.919;3545000;0
27491;203977;729;50;9;1;8;.889;1029000;0
27491;211604;729;45;42;6;36;.857;2571000;0
27491;202516;743;0;0;0;0;.00nan;0;0
27491;87798;743;81;22;1;21;.955;3600000;0
27492;180177;747;99;20;0;20;1.000;3600000;0
27492;207184;740;0;0;0;0;.00nan;0;0
27492;71565;747;0;0;0;0;.00nan;0;0
27492;86151;740;96;51;2;49;.961;3600000;0
27493;178098;733;75;28;3;25;.893;3900000;0
27493;66245;733;0;0;0;0;.00nan;0;0
27493;85661;749;64;24;3;21;.875;3900000;0
27493;91742;749;0;0;0;0;.00nan;0;0
27494;595;732;100;45;1;44;.978;3600000;0
27494;3435;739;74;32;2;30;.938;3568000;0
27494;88646;732;0;0;0;0;.00nan;0;0
27494;152624;739;0;0;0;0;.00nan;0;0
27495;1957;738;0;0;0;0;.00nan;0;0
27495;184158;738;93;52;4;48;.923;3900000;0
27495;31165;752;70;32;4;28;.875;3900000;0
27495;149221;752;0;0;0;0;.00nan;0;0
27496;3359;751;73;16;0;16;1.000;1364000;0
27496;196698;744;0;0;0;0;.00nan;0;0
27496;207771;744;93;33;1;32;.970;3600000;0
27496;148788;751;50;34;5;29;.853;2236000;0
27497;2643;736;50;36;5;31;.861;3557000;0
27497;204272;737;0;0;0;0;.00nan;0;0
27497;201947;737;56;20;3;17;.850;3600000;0
27497;74734;736;0;0;0;0;.00nan;0;0
27498;-1;764;48;30;4;26;.867;3600000;0
27498;-1;742;0;0;0;0;.00nan;0;0
27498;-1;764;0;0;0;0;.00nan;0;0
27498;85797;742;100;37;0;37;1.000;3600000;0
27499;2195;748;71;30;3;27;.900;3564000;0
27499;203533;748;0;0;0;0;.00nan;0;0
27499;85661;749;86;33;2;31;.939;3600000;0
27499;91742;749;0;0;0;0;.00nan;0;0
27500;1957;738;0;0;0;0;.00nan;0;0
27500;184158;738;38;30;6;24;.800;3578000;0
27500;180177;747;0;0;0;0;.00nan;0;0
27500;71565;747;66;39;5;34;.872;3600000;0
27501;207184;740;56;7;0;7;1.000;1408000;0
27501;49935;2168;90;30;1;29;.967;3600000;0
27501;76405;2168;0;0;0;0;.00nan;0;0
27501;86151;740;32;23;5;18;.783;2192000;0
27502;595;732;74;33;2;31;.939;3706000;0
27502;31165;752;68;28;3;25;.893;3706000;0
27502;88646;732;0;0;0;0;.00nan;0;0
27502;149221;752;0;0;0;0;.00nan;0;0
27503;3359;751;0;0;0;0;.00nan;0;0
27503;198736;3789;76;29;2;27;.931;3900000;0
27503;-1;3789;0;0;0;0;.00nan;0;0
27503;148788;751;70;29;2;27;.931;3900000;0
27504;202104;745;0;0;0;0;.00nan;0;0
27504;202516;743;0;0;0;0;.00nan;0;0
27504;75362;745;89;35;2;33;.943;3600000;0
27504;87798;743;37;20;4;16;.800;3595000;0
27505;203977;729;0;0;0;0;.00nan;0;0
27505;211604;729;83;42;3;39;.929;3689000;0
27505;44526;734;70;38;4;34;.895;3689000;0
27505;-1;734;0;0;0;0;.00nan;0;0
27506;178098;733;98;55;2;53;.964;3600000;0
27506;196698;744;0;0;0;0;.00nan;0;0
27506;207771;744;73;24;1;23;.958;3600000;0
27506;66245;733;0;0;0;0;.00nan;0;0
27507;204272;737;0;0;0;0;.00nan;0;0
27507;201947;737;64;29;3;26;.897;3866000;0
27507;56565;741;100;40;2;38;.950;3866000;0
27507;82273;741;0;0;0;0;.00nan;0;0
27508;2643;736;97;45;3;42;.933;3572000;0
27508;3165;1880;0;0;0;0;.00nan;0;0
27508;74734;736;0;0;0;0;.00nan;0;0
27508;148503;1880;67;21;2;19;.905;3600000;0
27509;-1;764;33;21;5;16;.762;1122000;0
27509;-1;742;0;0;0;0;.00nan;0;0
27509;-1;764;69;15;0;15;1.000;2455000;0
27509;85797;742;82;39;3;36;.923;3600000;0
27510;595;732;78;25;1;24;.960;3545000;0
27510;180177;747;0;0;0;0;.00nan;0;0
27510;71565;747;100;30;0;30;1.000;3600000;0
27510;88646;732;0;0;0;0;.00nan;0;0
27511;1957;738;0;0;0;0;.00nan;0;0
27511;184158;738;100;21;0;21;1.000;3600000;0
27511;49935;2168;0;0;0;0;.00nan;0;0
27511;76405;2168;88;56;5;51;.911;3600000;0
27512;3435;739;51;34;5;29;.853;3588000;0
27512;85661;749;77;33;3;30;.909;3600000;0
27512;91742;749;0;0;0;0;.00nan;0;0
27512;152624;739;0;0;0;0;.00nan;0;0
27513;2195;748;25;22;5;17;.773;3600000;0
27513;203533;748;0;0;0;0;.00nan;0;0
27513;198736;3789;100;40;0;40;1.000;3600000;0
27513;-1;3789;0;0;0;0;.00nan;0;0
27514;3359;751;95;37;1;36;.973;3600000;0
27514;178098;733;66;32;3;29;.906;3580000;0
27514;66245;733;0;0;0;0;.00nan;0;0
27514;148788;751;0;0;0;0;.00nan;0;0
27515;203977;729;94;64;3;61;.953;3699000;0
27515;211604;729;0;0;0;0;.00nan;0;0
27515;196698;744;0;0;0;0;.00nan;0;0
27515;207771;744;84;33;2;31;.939;3699000;0
27516;202516;743;0;0;0;0;.00nan;0;0
27516;-1;764;85;31;1;30;.968;3900000;0
27516;-1;764;0;0;0;0;.00nan;0;0
27516;87798;743;77;27;1;26;.963;3900000;0
27517;202104;745;0;0;0;0;.00nan;0;0
27517;56565;741;56;29;4;25;.862;3600000;0
27517;75362;745;99;36;1;35;.972;3600000;0
27517;82273;741;0;0;0;0;.00nan;0;0
27518;204272;737;0;0;0;0;.00nan;0;0
27518;201947;737;72;36;4;32;.889;3529000;0
27518;-1;742;0;0;0;0;.00nan;0;0
27518;85797;742;62;20;2;18;.900;3600000;0
27519;31165;752;56;38;5;33;.868;3600000;0
27519;202516;743;86;28;1;27;.964;3600000;0
27519;87798;743;0;0;0;0;.00nan;0;0
27519;149221;752;0;0;0;0;.00nan;0;0
27520;595;732;93;37;2;35;.946;3900000;0
27520;49935;2168;71;27;2;25;.926;3900000;0
27520;76405;2168;0;0;0;0;.00nan;0;0
27520;88646;732;0;0;0;0;.00nan;0;0
27521;3165;1880;85;44;3;41;.932;3600000;0
27521;3435;739;54;29;4;25;.862;3580000;0
27521;148503;1880;0;0;0;0;.00nan;0;0
27521;152624;739;0;0;0;0;.00nan;0;0
27522;2195;748;59;14;2;12;.857;3584000;0
27522;203533;748;0;0;0;0;.00nan;0;0
27522;178098;733;100;69;1;68;.986;3600000;0
27522;66245;733;0;0;0;0;.00nan;0;0
27523;198736;3789;94;19;0;19;1.000;3600000;0
27523;203977;729;0;0;0;0;.00nan;0;0
27523;211604;729;68;53;5;48;.906;3600000;0
27523;-1;3789;0;0;0;0;.00nan;0;0
27524;3359;751;0;0;0;0;.00nan;0;0
27524;-1;764;0;0;0;0;.00nan;0;0
27524;-1;764;57;27;3;24;.889;3592000;0
27524;148788;751;92;33;1;32;.970;3600000;0
27525;180177;747;0;0;0;0;.00nan;0;0
27525;71565;747;72;39;5;34;.872;3559000;0
27525;85661;749;72;33;3;30;.909;3600000;0
27525;91742;749;0;0;0;0;.00nan;0;0
27526;2643;736;89;39;2;37;.949;3600000;0
27526;202104;745;0;0;0;0;.00nan;0;0
27526;74734;736;0;0;0;0;.00nan;0;0
27526;75362;745;68;32;3;29;.906;3549000;0
27527;3165;1880;0;0;0;0;.00nan;0;0
27527;3435;739;0;0;0;0;.00nan;0;0
27527;148503;1880;50;24;3;21;.875;3600000;0
27527;152624;739;64;36;4;32;.889;3549000;0
27528;207184;740;0;0;0;0;.00nan;0;0
27528;56565;741;67;33;3;30;.909;3600000;0
27528;82273;741;0;0;0;0;.00nan;0;0
27528;86151;740;99;36;2;34;.944;3600000;0
27529;204272;737;0;0;0;0;.00nan;0;0
27529;201947;737;93;46;2;44;.957;3600000;0
27529;196698;744;93;33;1;32;.970;3600000;0
27529;207771;744;0;0;0;0;.00nan;0;0
27530;31165;752;0;0;0;0;.00nan;0;0
27530;-1;742;0;0;0;0;.00nan;0;0
27530;85797;742;85;42;3;39;.929;3548000;0
27530;149221;752;73;26;2;24;.923;3600000;0
27531;204272;737;53;27;4;23;.852;3600000;0
27531;178098;733;84;60;5;55;.917;3600000;0
27531;201947;737;0;0;0;0;.00nan;0;0
27531;66245;733;0;0;0;0;.00nan;0;0
27532;203977;729;0;0;0;0;.00nan;0;0
27532;211604;729;79;31;2;29;.935;3600000;0
27532;202516;743;0;0;0;0;.00nan;0;0
27532;87798;743;74;38;4;34;.895;3578000;0
27533;198736;3789;48;24;4;20;.833;3538000;0
27533;44526;734;90;44;3;41;.932;3600000;0
27533;-1;3789;0;0;0;0;.00nan;0;0
27533;-1;734;0;0;0;0;.00nan;0;0
27534;49935;2168;100;46;2;44;.957;3600000;0
27534;56565;741;61;27;3;24;.889;3600000;0
27534;76405;2168;0;0;0;0;.00nan;0;0
27534;82273;741;0;0;0;0;.00nan;0;0
27535;202104;745;0;0;0;0;.00nan;0;0
27535;75362;745;81;28;2;26;.929;3551000;0
27535;85661;749;0;0;0;0;.00nan;0;0
27535;91742;749;100;38;1;37;.974;3600000;0
27536;2195;748;60;27;3;24;.889;3600000;0
27536;2643;736;91;54;1;53;.981;3600000;0
27536;203533;748;0;0;0;0;.00nan;0;0
27536;74734;736;0;0;0;0;.00nan;0;0
27537;3165;1880;90;37;2;35;.946;3544000;0
27537;180177;747;0;0;0;0;.00nan;0;0
27537;71565;747;68;16;1;15;.938;3600000;0
27537;148503;1880;0;0;0;0;.00nan;0;0
27538;1957;738;0;0;0;0;.00nan;0;0
27538;184158;738;67;29;2;27;.931;3600000;0
27538;207184;740;0;0;0;0;.00nan;0;0
27538;86151;740;59;29;4;25;.862;3526000;0
27539;3359;751;0;0;0;0;.00nan;0;0
27539;196698;744;0;0;0;0;.00nan;0;0
27539;207771;744;99;37;1;36;.973;3900000;0
27539;148788;751;96;42;1;41;.976;3900000;0
27540;31165;752;0;0;0;0;.00nan;0;0
27540;-1;742;38;38;6;32;.842;3180000;0
27540;85797;742;51;3;0;3;1.000;420000;0
27540;149221;752;100;33;0;33;1.000;3600000;0
27541;3359;751;0;0;0;0;.00nan;0;0
27541;202104;745;0;0;0;0;.00nan;0;0
27541;75362;745;99;29;2;27;.931;3867000;0
27541;148788;751;77;27;2;25;.926;3900000;0
27542;3435;739;56;21;3;18;.857;3600000;0
27542;44526;734;59;33;4;29;.879;3576000;0
27542;-1;734;0;0;0;0;.00nan;0;0
27542;152624;739;0;0;0;0;.00nan;0;0
27543;198736;3789;97;43;3;40;.930;3592000;0
27543;-1;764;64;26;2;24;.923;3600000;0
27543;-1;3789;0;0;0;0;.00nan;0;0
27543;-1;764;0;0;0;0;.00nan;0;0
27544;49935;2168;100;44;0;44;1.000;3600000;0
27544;76405;2168;0;0;0;0;.00nan;0;0
27544;85661;749;85;26;1;25;.962;3587000;0
27544;91742;749;0;0;0;0;.00nan;0;0
27545;2195;748;72;24;2;22;.917;3600000;0
27545;3165;1880;100;34;1;33;.971;3600000;0
27545;203533;748;0;0;0;0;.00nan;0;0
27545;148503;1880;0;0;0;0;.00nan;0;0
27546;178098;733;77;29;2;27;.931;3541000;0
27546;207184;740;0;0;0;0;.00nan;0;0
27546;66245;733;0;0;0;0;.00nan;0;0
27546;86151;740;80;25;1;24;.960;3600000;0
27547;595;732;75;8;0;8;1.000;3600000;0
27547;2643;736;98;42;1;41;.976;3579000;0
27547;74734;736;0;0;0;0;.00nan;0;0
27547;88646;732;0;0;0;0;.00nan;0;0
27548;196698;744;0;0;0;0;.00nan;0;0
27548;207771;744;100;33;1;32;.970;3600000;0
27548;56565;741;10;25;7;18;.720;2421000;0
27548;82273;741;59;12;1;11;.917;1179000;0
27549;1957;738;0;0;0;0;.00nan;0;0
27549;184158;738;85;36;2;34;.944;3600000;0
27549;202516;743;0;0;0;0;.00nan;0;0
27549;87798;743;55;24;3;21;.875;3550000;0
27550;203977;729;0;0;0;0;.00nan;0;0
27550;204272;737;0;0;0;0;.00nan;0;0
27550;211604;729;60;48;6;42;.875;3600000;0
27550;201947;737;90;19;0;19;1.000;3600000;0
27551;2195;748;84;29;2;27;.931;3600000;0
27551;203533;748;0;0;0;0;.00nan;0;0
27551;198736;3789;0;0;0;0;.00nan;0;0
27551;-1;3789;81;50;4;46;.920;3561000;0
27552;180177;747;99;25;0;25;1.000;3600000;0
27552;44526;734;98;61;1;60;.984;3550000;0
27552;-1;734;0;0;0;0;.00nan;0;0
27552;71565;747;0;0;0;0;.00nan;0;0
27553;203977;729;0;0;0;0;.00nan;0;0
27553;204272;737;0;0;0;0;.00nan;0;0
27553;211604;729;53;38;5;33;.868;3600000;0
27553;201947;737;61;20;2;18;.900;3600000;0
27554;56565;741;66;31;2;29;.935;3550000;0
27554;82273;741;0;0;0;0;.00nan;0;0
27554;85661;749;100;36;0;36;1.000;3600000;0
27554;91742;749;0;0;0;0;.00nan;0;0
27555;2643;736;67;30;3;27;.900;3599000;0
27555;207184;740;0;0;0;0;.00nan;0;0
27555;74734;736;0;0;0;0;.00nan;0;0
27555;86151;740;85;27;1;26;.963;3600000;0
27556;595;732;75;34;3;31;.912;3600000;0
27556;3435;739;26;45;8;37;.822;2734000;0
27556;88646;732;0;0;0;0;.00nan;0;0
27556;152624;739;64;7;0;7;1.000;866000;0
27557;196698;744;0;0;0;0;.00nan;0;0
27557;207771;744;61;41;5;36;.878;3735000;0
27557;49935;2168;20;9;4;5;.556;807000;0
27557;76405;2168;85;24;0;24;1.000;2928000;0
27558;3359;751;80;21;1;20;.952;3600000;0
27558;202104;745;0;0;0;0;.00nan;0;0
27558;75362;745;66;28;3;25;.893;3526000;0
27558;148788;751;0;0;0;0;.00nan;0;0
27559;1957;738;98;43;3;40;.930;3526000;0
27559;184158;738;0;0;0;0;.00nan;0;0
27559;-1;742;0;0;0;0;.00nan;0;0
27559;85797;742;97;36;1;35;.972;3600000;0
27560;3165;1880;92;32;1;31;.969;3900000;0
27560;85661;749;100;37;1;36;.973;3900000;0
27560;91742;749;0;0;0;0;.00nan;0;0
27560;148503;1880;0;0;0;0;.00nan;0;0
27561;3435;739;0;0;0;0;.00nan;0;0
27561;204272;737;0;0;0;0;.00nan;0;0
27561;201947;737;62;24;2;22;.917;3600000;0
27561;152624;739;69;38;4;34;.895;3536000;0
27562;-1;764;99;27;1;26;.963;3900000;0
27562;-1;764;0;0;0;0;.00nan;0;0
27562;49935;2168;98;37;1;36;.973;3900000;0
27562;76405;2168;0;0;0;0;.00nan;0;0
27563;595;732;100;26;0;26;1.000;3600000;0
27563;178098;733;27;26;6;20;.769;2218000;0
27563;66245;733;19;10;4;6;.600;1382000;0
27563;88646;732;0;0;0;0;.00nan;0;0
27564;31165;752;0;0;0;0;.00nan;0;0
27564;44526;734;78;37;3;34;.919;3570000;0
27564;-1;734;0;0;0;0;.00nan;0;0
27564;149221;752;63;20;2;18;.900;3625000;0
27565;1957;738;0;0;0;0;.00nan;0;0
27565;2195;748;84;31;1;30;.968;3600000;0
27565;203533;748;0;0;0;0;.00nan;0;0
27565;184158;738;65;23;2;21;.913;3578000;0
27566;3165;1880;0;0;0;0;.00nan;0;0
27566;198736;3789;73;21;3;18;.857;3600000;0
27566;-1;3789;0;0;0;0;.00nan;0;0
27566;148503;1880;58;35;4;31;.886;3590000;0
27567;180177;747;80;32;3;29;.906;3566000;0
27567;196698;744;0;0;0;0;.00nan;0;0
27567;207771;744;66;19;1;18;.947;3600000;0
27567;71565;747;0;0;0;0;.00nan;0;0
27568;202104;745;0;0;0;0;.00nan;0;0
27568;202516;743;0;0;0;0;.00nan;0;0
27568;75362;745;84;42;4;38;.905;3600000;0
27568;87798;743;90;33;1;32;.970;3600000;0
27569;207184;740;0;0;0;0;.00nan;0;0
27569;56565;741;0;0;0;0;.00nan;0;0
27569;82273;741;100;35;0;35;1.000;3600000;0
27569;86151;740;77;44;4;40;.909;3600000;0
27570;2643;736;99;49;1;48;.980;3900000;0
27570;-1;742;0;0;0;0;.00nan;0;0
27570;74734;736;0;0;0;0;.00nan;0;0
27570;85797;742;57;15;1;14;.933;3900000;0
27571;3359;751;0;0;0;0;.00nan;0;0
27571;204272;737;0;0;0;0;.00nan;0;0
27571;201947;737;93;41;2;39;.951;3600000;0
27571;148788;751;68;36;3;33;.917;3563000;0
27572;3165;1880;100;49;1;48;.980;3900000;0
27572;198736;3789;0;0;0;0;.00nan;0;0
27572;-1;3789;71;22;1;21;.955;3900000;0
27572;148503;1880;0;0;0;0;.00nan;0;0
27573;180177;747;0;0;0;0;.00nan;0;0
27573;196698;744;87;40;3;37;.925;3600000;0
27573;207771;744;0;0;0;0;.00nan;0;0
27573;71565;747;100;34;0;34;1.000;3600000;0
27574;44526;734;76;24;2;22;.917;3900000;0
27574;-1;734;0;0;0;0;.00nan;0;0
27574;49935;2168;100;44;2;42;.955;3900000;0
27574;76405;2168;0;0;0;0;.00nan;0;0
27575;595;732;100;28;0;28;1.000;3600000;0
27575;203977;729;0;0;0;0;.00nan;0;0
27575;211604;729;59;41;5;36;.878;3600000;0
27575;88646;732;0;0;0;0;.00nan;0;0
27576;178098;733;90;51;4;47;.922;3600000;0
27576;31165;752;0;0;0;0;.00nan;0;0
27576;66245;733;0;0;0;0;.00nan;0;0
27576;149221;752;28;24;5;19;.792;3536000;0
27577;207184;740;0;0;0;0;.00nan;0;0
27577;202516;743;0;0;0;0;.00nan;0;0
27577;86151;740;45;31;6;25;.806;3600000;0
27577;87798;743;70;31;2;29;.935;3600000;0
27578;202104;745;0;0;0;0;.00nan;0;0
27578;-1;764;100;34;0;34;1.000;3600000;0
27578;-1;764;0;0;0;0;.00nan;0;0
27578;75362;745;63;39;5;34;.872;3600000;0
27579;2643;736;98;43;3;40;.930;3541000;0
27579;56565;741;0;0;0;0;.00nan;0;0
27579;74734;736;0;0;0;0;.00nan;0;0
27579;82273;741;66;28;2;26;.929;3600000;0
27580;2195;748;55;27;3;24;.889;3600000;0
27580;203533;748;0;0;0;0;.00nan;0;0
27580;204272;737;0;0;0;0;.00nan;0;0
27580;201947;737;65;38;4;34;.895;3582000;0
27581;3359;751;0;0;0;0;.00nan;0;0
27581;203977;729;41;7;2;5;.714;717000;0
27581;211604;729;64;44;6;38;.864;2883000;0
27581;148788;751;81;30;2;28;.933;3600000;0
27582;3435;739;58;33;4;29;.879;3522000;0
27582;198736;3789;70;28;2;26;.929;3600000;0
27582;-1;3789;0;0;0;0;.00nan;0;0
27582;152624;739;0;0;0;0;.00nan;0;0
27583;178098;733;89;44;3;41;.932;3600000;0
27583;180177;747;0;0;0;0;.00nan;0;0
27583;66245;733;0;0;0;0;.00nan;0;0
27583;71565;747;52;33;4;29;.879;3551000;0
27584;44526;734;60;30;4;26;.867;3655000;0
27584;-1;734;0;0;0;0;.00nan;0;0
27584;85661;749;49;20;3;17;.850;3655000;0
27584;91742;749;0;0;0;0;.00nan;0;0
27585;31165;752;0;0;0;0;.00nan;0;0
27585;196698;744;0;0;0;0;.00nan;0;0
27585;207771;744;76;26;1;25;.962;3600000;0
27585;149221;752;53;38;5;33;.868;3600000;0
27586;1957;738;0;0;0;0;.00nan;0;0
27586;184158;738;100;44;2;42;.955;3600000;0
27586;56565;741;66;28;3;25;.893;3600000;0
27586;82273;741;0;0;0;0;.00nan;0;0
27587;595;732;99;37;2;35;.946;3707000;0
27587;3165;1880;69;26;3;23;.885;3707000;0
27587;88646;732;0;0;0;0;.00nan;0;0
27587;148503;1880;0;0;0;0;.00nan;0;0
27588;2195;748;0;0;0;0;.00nan;0;0
27588;203533;748;29;20;5;15;.750;3600000;0
27588;203977;729;60;7;0;7;1.000;270000;0
27588;211604;729;26;34;7;27;.794;3330000;0
27589;2643;736;44;33;6;27;.818;3579000;0
27589;201075;736;0;0;0;0;.00nan;0;0
27589;202104;745;72;37;4;33;.892;3600000;0
27589;75362;745;0;0;0;0;.00nan;0;0
27590;198736;3789;0;0;0;0;.00nan;0;0
27590;-1;764;92;34;1;33;.971;3645000;0
27590;-1;764;0;0;0;0;.00nan;0;0
27590;74734;3789;71;26;2;24;.923;3645000;0
27591;178098;733;60;49;6;43;.878;3600000;0
27591;49935;2168;0;0;0;0;.00nan;0;0
27591;66245;733;0;0;0;0;.00nan;0;0
27591;76405;2168;69;22;2;20;.909;3600000;0
27592;595;732;84;27;1;26;.963;3600000;0
27592;3165;1880;0;0;0;0;.00nan;0;0
27592;88646;732;0;0;0;0;.00nan;0;0
27592;148503;1880;49;34;6;28;.824;3600000;0
27593;3435;739;83;24;1;23;.958;3600000;0
27593;207184;740;0;0;0;0;.00nan;0;0
27593;86151;740;64;37;4;33;.892;3600000;0
27593;152624;739;0;0;0;0;.00nan;0;0
27594;-1;742;0;0;0;0;.00nan;0;0
27594;85661;749;55;28;3;25;.893;3600000;0
27594;85797;742;62;46;6;40;.870;3600000;0
27594;91742;749;0;0;0;0;.00nan;0;0
27595;31165;752;63;8;0;8;1.000;506000;0
27595;196698;744;0;0;0;0;.00nan;0;0
27595;207771;744;69;31;3;28;.903;3600000;0
27595;149221;752;21;26;6;20;.769;3094000;0
27596;1957;738;0;0;0;0;.00nan;0;0
27596;184158;738;69;28;2;26;.929;3543000;0
27596;180177;747;0;0;0;0;.00nan;0;0
27596;71565;747;80;24;1;23;.958;3600000;0
27597;3435;739;71;30;3;27;.900;3600000;0
27597;202104;745;0;0;0;0;.00nan;0;0
27597;75362;745;52;36;5;31;.861;3513000;0
27597;152624;739;0;0;0;0;.00nan;0;0
27598;2643;736;72;27;1;26;.963;3600000;0
27598;203977;729;67;34;3;31;.912;3600000;0
27598;201075;736;0;0;0;0;.00nan;0;0
27598;211604;729;0;0;0;0;.00nan;0;0
27599;595;732;45;32;5;27;.844;3600000;0
27599;198736;3789;0;0;0;0;.00nan;0;0
27599;74734;3789;81;28;1;27;.964;3600000;0
27599;88646;732;0;0;0;0;.00nan;0;0
27600;204272;737;77;39;3;36;.923;3600000;0
27600;201947;737;0;0;0;0;.00nan;0;0
27600;44526;734;50;26;4;22;.846;3600000;0
27600;-1;734;0;0;0;0;.00nan;0;0
27601;-1;764;76;34;3;31;.912;3600000;0
27601;-1;764;0;0;0;0;.00nan;0;0
27601;49935;2168;58;34;4;30;.882;3556000;0
27601;76405;2168;0;0;0;0;.00nan;0;0
27602;3165;1880;60;18;1;17;.944;3600000;0
27602;202516;743;0;0;0;0;.00nan;0;0
27602;87798;743;72;30;2;28;.933;3552000;0
27602;148503;1880;0;0;0;0;.00nan;0;0
27603;207184;740;0;0;0;0;.00nan;0;0
27603;85661;749;73;35;4;31;.886;3900000;0
27603;86151;740;76;33;4;29;.879;3900000;0
27603;91742;749;0;0;0;0;.00nan;0;0
27604;3359;751;0;0;0;0;.00nan;0;0
27604;-1;742;0;0;0;0;.00nan;0;0
27604;85797;742;100;42;0;42;1.000;3600000;0
27604;148788;751;62;25;3;22;.880;3600000;0
27605;2195;748;78;26;2;24;.923;3600000;0
27605;203533;748;0;0;0;0;.00nan;0;0
27605;31165;752;45;6;1;5;.833;704000;0
27605;149221;752;30;30;6;24;.800;2896000;0
27606;180177;747;0;0;0;0;.00nan;0;0
27606;56565;741;100;34;0;34;1.000;3600000;0
27606;71565;747;89;31;1;30;.968;3600000;0
27606;82273;741;0;0;0;0;.00nan;0;0
27607;202104;745;0;0;0;0;.00nan;0;0
27607;75362;745;64;32;3;29;.906;3900000;0
27607;85661;749;69;29;3;26;.897;3900000;0
27607;91742;749;0;0;0;0;.00nan;0;0
27608;595;732;87;15;0;15;1.000;3600000;0
27608;203977;729;0;0;0;0;.00nan;0;0
27608;211604;729;78;42;3;39;.929;3600000;0
27608;88646;732;0;0;0;0;.00nan;0;0
27609;204272;737;58;27;3;24;.889;3900000;0
27609;201947;737;0;0;0;0;.00nan;0;0
27609;49935;2168;100;46;3;43;.935;3900000;0
27609;76405;2168;0;0;0;0;.00nan;0;0
27610;2643;736;91;32;2;30;.938;3900000;0
27610;201075;736;0;0;0;0;.00nan;0;0
27610;44526;734;64;27;2;25;.926;3900000;0
27610;-1;734;0;0;0;0;.00nan;0;0
27611;3359;751;0;0;0;0;.00nan;0;0
27611;-1;764;96;52;3;49;.942;3584000;0
27611;-1;764;0;0;0;0;.00nan;0;0
27611;148788;751;87;26;1;25;.962;3600000;0
27612;3435;739;53;20;4;16;.800;3804000;0
27612;178098;733;0;0;0;0;.00nan;0;0
27612;66245;733;84;44;3;41;.932;3804000;0
27612;152624;739;0;0;0;0;.00nan;0;0
27613;1957;738;0;0;0;0;.00nan;0;0
27613;3165;1880;0;0;0;0;.00nan;0;0
27613;184158;738;53;20;3;17;.850;3543000;0
27613;148503;1880;76;35;2;33;.943;3600000;0
27614;207184;740;0;0;0;0;.00nan;0;0
27614;202516;743;0;0;0;0;.00nan;0;0
27614;86151;740;98;41;2;39;.951;3539000;0
27614;87798;743;86;20;0;20;1.000;3600000;0
27615;196698;744;0;0;0;0;.00nan;0;0
27615;207771;744;72;29;2;27;.931;3570000;0
27615;-1;742;0;0;0;0;.00nan;0;0
27615;85797;742;90;37;1;36;.973;3600000;0
27616;595;732;69;20;1;19;.950;3600000;0
27616;203977;729;94;52;3;49;.942;3600000;0
27616;211604;729;0;0;0;0;.00nan;0;0
27616;88646;732;0;0;0;0;.00nan;0;0
27617;31165;752;100;43;0;43;1.000;3600000;0
27617;180177;747;57;34;4;30;.882;3600000;0
27617;71565;747;0;0;0;0;.00nan;0;0
27617;149221;752;0;0;0;0;.00nan;0;0
27618;2195;748;80;28;2;26;.929;3566000;0
27618;203533;748;0;0;0;0;.00nan;0;0
27618;56565;741;88;30;1;29;.967;3600000;0
27618;82273;741;0;0;0;0;.00nan;0;0
27619;198736;3789;0;0;0;0;.00nan;0;0
27619;202516;743;0;0;0;0;.00nan;0;0
27619;74734;3789;62;20;2;18;.900;3557000;0
27619;87798;743;76;22;1;21;.955;3600000;0
27620;-1;764;78;32;2;30;.938;3900000;0
27620;-1;764;0;0;0;0;.00nan;0;0
27620;49935;2168;74;29;2;27;.931;3900000;0
27620;76405;2168;0;0;0;0;.00nan;0;0
27621;3359;751;0;0;0;0;.00nan;0;0
27621;178098;733;69;30;2;28;.933;3828000;0
27621;66245;733;0;0;0;0;.00nan;0;0
27621;148788;751;62;24;3;21;.875;3828000;0
27622;1957;738;0;0;0;0;.00nan;0;0
27622;2643;736;100;32;0;32;1.000;3600000;0
27622;184158;738;87;30;1;29;.967;3556000;0
27622;201075;736;0;0;0;0;.00nan;0;0
27623;3435;739;45;11;2;9;.818;3600000;0
27623;202104;745;0;0;0;0;.00nan;0;0
27623;75362;745;98;52;3;49;.942;3546000;0
27623;152624;739;0;0;0;0;.00nan;0;0
27624;31165;752;0;0;0;0;.00nan;0;0
27624;180177;747;0;0;0;0;.00nan;0;0
27624;71565;747;71;26;2;24;.923;3600000;0
27624;149221;752;48;35;5;30;.857;3600000;0
27625;207184;740;62;37;5;32;.865;3600000;0
27625;44526;734;72;28;2;26;.929;3600000;0
27625;-1;734;0;0;0;0;.00nan;0;0
27625;-1;740;0;0;0;0;.00nan;0;0
27626;56565;741;68;25;2;23;.920;3536000;0
27626;82273;741;0;0;0;0;.00nan;0;0
27626;85661;749;100;34;0;34;1.000;3600000;0
27626;91742;749;0;0;0;0;.00nan;0;0
27627;2195;748;49;25;4;21;.840;3554000;0
27627;203533;748;0;0;0;0;.00nan;0;0
27627;-1;742;0;0;0;0;.00nan;0;0
27627;85797;742;70;32;3;29;.906;3600000;0
27628;1957;738;0;0;0;0;.00nan;0;0
27628;203977;729;0;0;0;0;.00nan;0;0
27628;184158;738;52;33;5;28;.848;3680000;0
27628;211604;729;78;45;4;41;.911;3680000;0
27629;3165;1880;91;40;3;37;.925;3600000;0
27629;49935;2168;43;23;4;19;.826;3578000;0
27629;76405;2168;0;0;0;0;.00nan;0;0
27629;148503;1880;0;0;0;0;.00nan;0;0
27630;198736;3789;0;0;0;0;.00nan;0;0
27630;196698;744;0;0;0;0;.00nan;0;0
27630;207771;744;100;23;0;23;1.000;3600000;0
27630;74734;3789;98;64;5;59;.922;3600000;0
27631;3359;751;0;0;0;0;.00nan;0;0
27631;56565;741;100;33;0;33;1.000;3600000;0
27631;82273;741;0;0;0;0;.00nan;0;0
27631;148788;751;65;28;3;25;.893;3600000;0
27632;3435;739;84;12;0;12;1.000;3600000;0
27632;178098;733;76;41;4;37;.902;3600000;0
27632;66245;733;0;0;0;0;.00nan;0;0
27632;152624;739;0;0;0;0;.00nan;0;0
27633;204272;737;62;15;1;14;.933;3900000;0
27633;201947;737;0;0;0;0;.00nan;0;0
27633;202104;745;0;0;0;0;.00nan;0;0
27633;75362;745;94;42;1;41;.976;3900000;0
27634;202516;743;0;0;0;0;.00nan;0;0
27634;44526;734;64;41;4;37;.902;3600000;0
27634;-1;734;0;0;0;0;.00nan;0;0
27634;87798;743;70;21;1;20;.952;3600000;0
27635;-1;764;78;36;3;33;.917;3900000;0
27635;-1;742;0;0;0;0;.00nan;0;0
27635;-1;764;0;0;0;0;.00nan;0;0
27635;85797;742;65;36;3;33;.917;3900000;0
27636;2195;748;40;29;5;24;.828;3600000;0
27636;203533;748;0;0;0;0;.00nan;0;0
27636;85661;749;79;17;1;16;.941;3600000;0
27636;91742;749;0;0;0;0;.00nan;0;0
27637;2643;736;78;24;1;23;.958;3600000;0
27637;201075;736;0;0;0;0;.00nan;0;0
27637;207184;740;53;23;3;20;.870;3561000;0
27637;-1;740;0;0;0;0;.00nan;0;0
27638;1957;738;0;0;0;0;.00nan;0;0
27638;198736;3789;0;0;0;0;.00nan;0;0
27638;184158;738;78;37;3;34;.919;3900000;0
27638;74734;3789;78;35;3;32;.914;3900000;0
27639;203977;729;62;21;2;19;.905;2464000;0
27639;211604;729;34;18;4;14;.778;1136000;0
27639;180177;747;0;0;0;0;.00nan;0;0
27639;71565;747;100;40;1;39;.975;3600000;0
27640;3165;1880;45;26;4;22;.846;3658000;0
27640;31165;752;70;32;3;29;.906;3658000;0
27640;148503;1880;0;0;0;0;.00nan;0;0
27640;149221;752;0;0;0;0;.00nan;0;0
27641;207184;740;0;0;0;0;.00nan;0;0
27641;-1;764;47;31;5;26;.839;3640000;0
27641;-1;764;0;0;0;0;.00nan;0;0
27641;86151;740;99;51;4;47;.922;3640000;0
27642;49935;2168;0;0;0;0;.00nan;0;0
27642;56565;741;81;25;1;24;.960;3600000;0
27642;76405;2168;98;39;2;37;.949;3568000;0
27642;82273;741;0;0;0;0;.00nan;0;0
27643;-1;742;0;0;0;0;.00nan;0;0
27643;85661;749;41;30;5;25;.833;3600000;0
27643;85797;742;94;38;2;36;.947;3600000;0
27643;91742;749;0;0;0;0;.00nan;0;0
27644;2643;736;79;35;3;32;.914;3561000;0
27644;178098;733;80;26;2;24;.923;3600000;0
27644;201075;736;0;0;0;0;.00nan;0;0
27644;66245;733;0;0;0;0;.00nan;0;0
27645;595;732;65;20;2;18;.900;3600000;0
27645;202104;745;0;0;0;0;.00nan;0;0
27645;75362;745;83;44;4;40;.909;3514000;0
27645;88646;732;0;0;0;0;.00nan;0;0
27646;196698;744;0;0;0;0;.00nan;0;0
27646;207771;744;54;15;2;13;.867;3600000;0
27646;202516;743;0;0;0;0;.00nan;0;0
27646;87798;743;90;54;3;51;.944;3599000;0
27647;3435;739;89;26;1;25;.962;3600000;0
27647;198736;3789;0;0;0;0;.00nan;0;0
27647;74734;3789;79;29;2;27;.931;3543000;0
27647;152624;739;0;0;0;0;.00nan;0;0
27648;3165;1880;0;0;0;0;.00nan;0;0
27648;180177;747;0;0;0;0;.00nan;0;0
27648;71565;747;70;38;4;34;.895;3600000;0
27648;148503;1880;100;35;0;35;1.000;3600000;0
27649;203977;729;0;0;0;0;.00nan;0;0
27649;211604;729;68;38;3;35;.921;3569000;0
27649;31165;752;0;0;0;0;.00nan;0;0
27649;149221;752;73;24;2;22;.917;3600000;0
27650;595;732;74;29;2;27;.931;3600000;0
27650;3359;751;74;36;3;33;.917;3569000;0
27650;88646;732;0;0;0;0;.00nan;0;0
27650;148788;751;0;0;0;0;.00nan;0;0
27651;1957;738;80;24;1;23;.958;3600000;0
27651;184158;738;0;0;0;0;.00nan;0;0
27651;44526;734;90;42;2;40;.952;3600000;0
27651;-1;734;0;0;0;0;.00nan;0;0
27652;204272;737;76;26;2;24;.923;3900000;0
27652;201947;737;0;0;0;0;.00nan;0;0
27652;49935;2168;0;0;0;0;.00nan;0;0
27652;76405;2168;89;40;2;38;.950;3900000;0
27653;178098;733;69;34;3;31;.912;3600000;0
27653;-1;742;0;0;0;0;.00nan;0;0
27653;66245;733;0;0;0;0;.00nan;0;0
27653;85797;742;84;26;2;24;.923;3600000;0
27654;207184;740;0;0;0;0;.00nan;0;0
27654;196698;744;0;0;0;0;.00nan;0;0
27654;207771;744;80;12;0;12;1.000;3600000;0
27654;86151;740;96;45;2;43;.956;3596000;0
27655;202104;745;0;0;0;0;.00nan;0;0
27655;202516;743;0;0;0;0;.00nan;0;0
27655;75362;745;100;47;1;46;.979;3600000;0
27655;87798;743;70;27;3;24;.889;3575000;0
27656;31165;752;84;37;2;35;.946;3587000;0
27656;180177;747;93;30;1;29;.967;3600000;0
27656;71565;747;0;0;0;0;.00nan;0;0
27656;149221;752;0;0;0;0;.00nan;0;0
27657;-1;764;65;23;1;22;.957;3900000;0
27657;-1;764;0;0;0;0;.00nan;0;0
27657;56565;741;87;28;1;27;.964;3900000;0
27657;82273;741;0;0;0;0;.00nan;0;0
27658;203977;729;0;0;0;0;.00nan;0;0
27658;211604;729;48;21;3;18;.857;3563000;0
27658;49935;2168;78;19;1;18;.947;3600000;0
27658;76405;2168;0;0;0;0;.00nan;0;0
27659;2643;736;0;0;0;0;.00nan;0;0
27659;3435;739;80;26;1;25;.962;3600000;0
27659;201075;736;67;27;2;25;.926;3600000;0
27659;152624;739;0;0;0;0;.00nan;0;0
27660;595;732;99;34;1;33;.971;3600000;0
27660;2195;748;46;23;4;19;.826;3600000;0
27660;203533;748;0;0;0;0;.00nan;0;0
27660;88646;732;0;0;0;0;.00nan;0;0
27661;1957;738;0;0;0;0;.00nan;0;0
27661;198736;3789;0;0;0;0;.00nan;0;0
27661;184158;738;97;29;1;28;.966;3900000;0
27661;74734;3789;83;32;1;31;.969;3900000;0
27662;178098;733;0;0;0;0;.00nan;0;0
27662;44526;734;49;28;4;24;.857;3600000;0
27662;-1;734;0;0;0;0;.00nan;0;0
27662;66245;733;90;35;1;34;.971;3600000;0
27663;202104;745;73;22;1;21;.955;2415000;0
27663;196698;744;0;0;0;0;.00nan;0;0
27663;207771;744;98;31;1;30;.968;3600000;0
27663;75362;745;32;16;4;12;.750;1185000;0
27664;3359;751;63;19;2;17;.895;3600000;0
27664;-1;764;66;39;4;35;.897;3600000;0
27664;-1;764;0;0;0;0;.00nan;0;0
27664;148788;751;0;0;0;0;.00nan;0;0
27665;204272;737;0;0;0;0;.00nan;0;0
27665;201947;737;89;31;1;30;.968;3600000;0
27665;207184;740;0;0;0;0;.00nan;0;0
27665;86151;740;57;32;4;28;.875;3600000;0
27666;31165;752;0;0;0;0;.00nan;0;0
27666;49935;2168;99;44;2;42;.955;3619000;0
27666;76405;2168;0;0;0;0;.00nan;0;0
27666;149221;752;73;33;3;30;.909;3619000;0
27667;202516;743;0;0;0;0;.00nan;0;0
27667;85661;749;93;34;1;33;.971;3600000;0
27667;87798;743;80;34;2;32;.941;3571000;0
27667;91742;749;0;0;0;0;.00nan;0;0
27668;2195;748;54;29;4;25;.862;3562000;0
27668;203533;748;0;0;0;0;.00nan;0;0
27668;56565;741;60;26;3;23;.885;3600000;0
27668;82273;741;0;0;0;0;.00nan;0;0
27669;198736;3789;0;0;0;0;.00nan;0;0
27669;180177;747;51;13;2;11;.846;797000;0
27669;71565;747;50;44;6;38;.864;2803000;0
27669;74734;3789;58;28;3;25;.893;3600000;0
27670;595;732;90;29;1;28;.966;3600000;0
27670;2643;736;78;39;3;36;.923;3515000;0
27670;201075;736;0;0;0;0;.00nan;0;0
27670;88646;732;0;0;0;0;.00nan;0;0
27671;3165;1880;0;0;0;0;.00nan;0;0
27671;44526;734;81;38;4;34;.895;3554000;0
27671;-1;734;0;0;0;0;.00nan;0;0
27671;148503;1880;50;21;3;18;.857;3600000;0
27672;3435;739;100;35;1;34;.971;3600000;0
27672;-1;742;0;0;0;0;.00nan;0;0
27672;85797;742;71;38;3;35;.921;3519000;0
27672;152624;739;0;0;0;0;.00nan;0;0
27673;204272;737;71;39;4;35;.897;3600000;0
27673;201947;737;0;0;0;0;.00nan;0;0
27673;196698;744;0;0;0;0;.00nan;0;0
27673;207771;744;68;34;3;31;.912;3600000;0
27674;202516;743;0;0;0;0;.00nan;0;0
27674;49935;2168;0;0;0;0;.00nan;0;0
27674;76405;2168;57;28;4;24;.857;3560000;0
27674;87798;743;70;28;2;26;.929;3600000;0
27675;207184;740;0;0;0;0;.00nan;0;0
27675;85661;749;76;11;0;11;1.000;3600000;0
27675;86151;740;87;41;3;38;.927;3600000;0
27675;91742;749;0;0;0;0;.00nan;0;0
27676;202104;745;0;0;0;0;.00nan;0;0
27676;56565;741;100;25;0;25;1.000;3600000;0
27676;75362;745;79;27;2;25;.926;3543000;0
27676;82273;741;0;0;0;0;.00nan;0;0
27677;3359;751;0;0;0;0;.00nan;0;0
27677;203977;729;0;0;0;0;.00nan;0;0
27677;211604;729;65;29;2;27;.931;3600000;0
27677;148788;751;72;33;3;30;.909;3600000;0
27678;2643;736;28;29;6;23;.793;3093000;0
27678;201075;736;48;7;1;6;.857;507000;0
27678;-1;764;64;22;2;20;.909;3600000;0
27678;-1;764;0;0;0;0;.00nan;0;0
27679;3435;739;43;24;4;20;.833;3639000;0
27679;178098;733;94;51;3;48;.941;3643000;0
27679;66245;733;0;0;0;0;.00nan;0;0
27679;152624;739;0;0;0;0;.00nan;0;0
27680;3165;1880;86;29;1;28;.966;3600000;0
27680;44526;734;78;35;3;32;.914;3526000;0
27680;-1;734;0;0;0;0;.00nan;0;0
27680;148503;1880;0;0;0;0;.00nan;0;0
27681;1957;738;0;0;0;0;.00nan;0;0
27681;184158;738;58;25;3;22;.880;3537000;0
27681;-1;742;0;0;0;0;.00nan;0;0
27681;85797;742;99;45;1;44;.978;3600000;0
27682;198736;3789;0;0;0;0;.00nan;0;0
27682;31165;752;79;35;3;32;.914;3537000;0
27682;74734;3789;78;27;1;26;.963;3600000;0
27682;149221;752;0;0;0;0;.00nan;0;0
27683;2195;748;80;27;2;25;.926;3600000;0
27683;203533;748;0;0;0;0;.00nan;0;0
27683;180177;747;0;0;0;0;.00nan;0;0
27683;71565;747;51;36;5;31;.861;3600000;0
27684;2195;748;0;0;0;0;.00nan;0;0
27684;3359;751;58;7;0;7;1.000;493000;0
27684;203533;748;66;23;2;21;.913;3600000;0
27684;148788;751;34;31;6;25;.806;3107000;0
27685;203977;729;0;0;0;0;.00nan;0;0
27685;206313;745;0;0;0;0;.00nan;0;0
27685;211604;729;68;23;2;21;.913;3514000;0
27685;75362;745;100;35;0;35;1.000;3600000;0
27686;3165;1880;0;0;0;0;.00nan;0;0
27686;204272;737;77;29;2;27;.931;3600000;0
27686;201947;737;0;0;0;0;.00nan;0;0
27686;148503;1880;56;31;4;27;.871;3535000;0
27687;178098;733;95;41;1;40;.976;3900000;0
27687;202516;743;0;0;0;0;.00nan;0;0
27687;66245;733;0;0;0;0;.00nan;0;0
27687;87798;743;90;27;1;26;.963;3900000;0
27688;1957;738;0;0;0;0;.00nan;0;0
27688;184158;738;64;30;3;27;.900;3600000;0
27688;-1;764;44;35;5;30;.857;3600000;0
27688;-1;764;0;0;0;0;.00nan;0;0
27689;198736;3789;0;0;0;0;.00nan;0;0
27689;49935;2168;100;35;1;34;.971;3600000;0
27689;74734;3789;10;21;6;15;.714;3600000;0
27689;76405;2168;0;0;0;0;.00nan;0;0
27690;3435;739;93;23;0;23;1.000;3600000;0
27690;207184;740;0;0;0;0;.00nan;0;0
27690;86151;740;98;51;1;50;.980;3570000;0
27690;152624;739;0;0;0;0;.00nan;0;0
27691;595;732;0;0;0;0;.00nan;0;0
27691;85661;749;65;29;4;25;.862;3600000;0
27691;88646;732;35;32;6;26;.813;3546000;0
27691;91742;749;0;0;0;0;.00nan;0;0
27692;2643;736;41;38;6;32;.842;3054000;0
27692;201075;736;44;4;1;3;.750;546000;0
27692;196698;744;0;0;0;0;.00nan;0;0
27692;207771;744;56;12;2;10;.833;3600000;0
27693;31165;752;0;0;0;0;.00nan;0;0
27693;180177;747;0;0;0;0;.00nan;0;0
27693;71565;747;80;32;2;30;.938;3600000;0
27693;149221;752;78;38;3;35;.921;3562000;0
27694;3435;739;67;32;3;29;.906;3900000;0
27694;203977;729;0;0;0;0;.00nan;0;0
27694;211604;729;87;42;3;39;.929;3900000;0
27694;152624;739;0;0;0;0;.00nan;0;0
27695;202516;743;0;0;0;0;.00nan;0;0
27695;56565;741;73;35;2;33;.943;3711000;0
27695;82273;741;0;0;0;0;.00nan;0;0
27695;87798;743;65;29;3;26;.897;3711000;0
27696;206313;745;0;0;0;0;.00nan;0;0
27696;44526;734;0;0;0;0;.00nan;0;0
27696;-1;734;45;21;3;18;.857;3527000;0
27696;75362;745;100;47;1;46;.979;3600000;0
27697;178098;733;98;42;1;41;.976;3595000;0
27697;-1;764;90;19;0;19;1.000;3600000;0
27697;-1;764;0;0;0;0;.00nan;0;0
27697;66245;733;0;0;0;0;.00nan;0;0
27698;3359;751;39;13;3;10;.769;3600000;0
27698;49935;2168;80;32;2;30;.938;3600000;0
27698;76405;2168;0;0;0;0;.00nan;0;0
27698;148788;751;0;0;0;0;.00nan;0;0
27699;3165;1880;53;36;5;31;.861;3600000;0
27699;207184;740;0;0;0;0;.00nan;0;0
27699;86151;740;92;38;2;36;.947;3600000;0
27699;148503;1880;0;0;0;0;.00nan;0;0
27700;2643;736;81;49;4;45;.918;3600000;0
27700;201075;736;0;0;0;0;.00nan;0;0
27700;-1;742;0;0;0;0;.00nan;0;0
27700;85797;742;82;27;1;26;.963;3600000;0
27701;595;732;70;32;3;29;.906;3577000;0
27701;1957;738;0;0;0;0;.00nan;0;0
27701;184158;738;100;43;1;42;.977;3600000;0
27701;88646;732;0;0;0;0;.00nan;0;0
27702;31165;752;64;31;3;28;.903;3600000;0
27702;180177;747;73;42;4;38;.905;3544000;0
27702;71565;747;0;0;0;0;.00nan;0;0
27702;149221;752;0;0;0;0;.00nan;0;0
27703;196698;744;0;0;0;0;.00nan;0;0
27703;207771;744;79;31;2;29;.935;3600000;0
27703;85661;749;60;42;5;37;.881;3600000;0
27703;91742;749;0;0;0;0;.00nan;0;0
27704;2195;748;43;21;4;17;.810;3600000;0
27704;203533;748;0;0;0;0;.00nan;0;0
27704;206313;745;0;0;0;0;.00nan;0;0
27704;75362;745;62;35;5;30;.857;3544000;0
27705;595;732;65;35;4;31;.886;3900000;0
27705;198736;3789;0;0;0;0;.00nan;0;0
27705;74734;3789;67;34;4;30;.882;3900000;0
27705;88646;732;0;0;0;0;.00nan;0;0
27706;1957;738;0;0;0;0;.00nan;0;0
27706;3435;739;69;33;3;30;.909;3558000;0
27706;184158;738;90;32;1;31;.969;3600000;0
27706;152624;739;0;0;0;0;.00nan;0;0
27707;202516;743;94;36;2;34;.944;3600000;0
27707;49935;2168;91;51;4;47;.922;3517000;0
27707;76405;2168;0;0;0;0;.00nan;0;0
27707;87798;743;0;0;0;0;.00nan;0;0
27708;203977;729;0;0;0;0;.00nan;0;0
27708;211604;729;52;27;3;24;.889;3600000;0
27708;44526;734;100;40;0;40;1.000;3600000;0
27708;-1;734;0;0;0;0;.00nan;0;0
27709;178098;733;73;40;4;36;.900;3589000;0
27709;207184;740;0;0;0;0;.00nan;0;0
27709;66245;733;0;0;0;0;.00nan;0;0
27709;86151;740;94;35;2;33;.943;3600000;0
27710;3359;751;51;24;3;21;.875;3544000;0
27710;85661;749;90;35;2;33;.943;3600000;0
27710;91742;749;0;0;0;0;.00nan;0;0
27710;148788;751;0;0;0;0;.00nan;0;0
27711;2643;736;34;26;5;21;.808;3575000;0
27711;3165;1880;0;0;0;0;.00nan;0;0
27711;201075;736;0;0;0;0;.00nan;0;0
27711;148503;1880;68;31;3;28;.903;3600000;0
27712;196698;744;62;26;3;23;.885;3600000;0
27712;207771;744;0;0;0;0;.00nan;0;0
27712;-1;742;53;10;1;9;.900;583000;0
27712;85797;742;34;38;8;30;.789;3017000;0
27713;31165;752;0;0;0;0;.00nan;0;0
27713;180177;747;0;0;0;0;.00nan;0;0
27713;71565;747;63;39;5;34;.872;3600000;0
27713;149221;752;74;26;1;25;.962;3600000;0
27714;2195;748;62;23;2;21;.913;3825000;0
27714;3165;1880;70;25;3;22;.880;3825000;0
27714;203533;748;0;0;0;0;.00nan;0;0
27714;148503;1880;0;0;0;0;.00nan;0;0
27715;203977;729;62;26;2;24;.923;3600000;0
27715;178098;733;86;38;3;35;.921;3579000;0
27715;211604;729;0;0;0;0;.00nan;0;0
27715;66245;733;0;0;0;0;.00nan;0;0
27716;3435;739;0;0;0;0;.00nan;0;0
27716;-1;742;0;0;0;0;.00nan;0;0
27716;85797;742;82;33;2;31;.939;3600000;0
27716;152624;739;74;38;3;35;.921;3570000;0
27717;202516;743;0;0;0;0;.00nan;0;0
27717;49935;2168;97;47;2;45;.957;3549000;0
27717;76405;2168;0;0;0;0;.00nan;0;0
27717;87798;743;79;22;1;21;.955;3600000;0
27718;595;732;73;19;1;18;.947;3600000;0
27718;44526;734;86;37;3;34;.919;3581000;0
27718;-1;734;0;0;0;0;.00nan;0;0
27718;88646;732;0;0;0;0;.00nan;0;0
27719;3359;751;98;46;2;44;.957;3552000;0
27719;56565;741;0;0;0;0;.00nan;0;0
27719;82273;741;99;37;1;36;.973;3600000;0
27719;148788;751;0;0;0;0;.00nan;0;0
27720;1957;738;0;0;0;0;.00nan;0;0
27720;2643;736;91;48;3;45;.938;3600000;0
27720;184158;738;34;21;4;17;.810;3577000;0
27720;201075;736;0;0;0;0;.00nan;0;0
27721;206313;745;0;0;0;0;.00nan;0;0
27721;196698;744;0;0;0;0;.00nan;0;0
27721;207771;744;59;28;4;24;.857;3600000;0
27721;75362;745;65;32;3;29;.906;3600000;0
27722;204272;737;0;0;0;0;.00nan;0;0
27722;201947;737;30;21;5;16;.762;3600000;0
27722;-1;742;0;0;0;0;.00nan;0;0
27722;85797;742;87;35;2;33;.943;3600000;0
27723;180177;747;0;0;0;0;.00nan;0;0
27723;-1;764;89;31;1;30;.968;3600000;0
27723;-1;764;0;0;0;0;.00nan;0;0
27723;71565;747;26;31;7;24;.774;3600000;0
27724;31165;752;0;0;0;0;.00nan;0;0
27724;85661;749;85;34;2;32;.941;3752000;0
27724;91742;749;0;0;0;0;.00nan;0;0
27724;149221;752;91;35;1;34;.971;3752000;0
27725;198736;3789;0;0;0;0;.00nan;0;0
27725;207184;740;0;0;0;0;.00nan;0;0
27725;74734;3789;43;28;5;23;.821;3600000;0
27725;86151;740;62;20;2;18;.900;3600000;0
27726;3165;1880;0;0;0;0;.00nan;0;0
27726;3359;751;0;0;0;0;.00nan;0;0
27726;148503;1880;47;26;4;22;.846;3600000;0
27726;148788;751;91;32;1;31;.969;3600000;0
27727;1957;738;0;0;0;0;.00nan;0;0
27727;184158;738;60;39;5;34;.872;3588000;0
27727;44526;734;58;26;3;23;.885;3600000;0
27727;-1;734;0;0;0;0;.00nan;0;0
27728;2643;736;44;19;3;16;.842;3900000;0
27728;178098;733;70;26;3;23;.885;3900000;0
27728;201075;736;0;0;0;0;.00nan;0;0
27728;66245;733;0;0;0;0;.00nan;0;0
27729;3435;739;82;40;4;36;.900;3600000;0
27729;56565;741;100;47;1;46;.979;3600000;0
27729;82273;741;0;0;0;0;.00nan;0;0
27729;152624;739;0;0;0;0;.00nan;0;0
27730;206313;745;0;0;0;0;.00nan;0;0
27730;49935;2168;95;23;0;23;1.000;3900000;0
27730;75362;745;100;36;0;36;1.000;3900000;0
27730;76405;2168;0;0;0;0;.00nan;0;0
27731;2195;748;89;27;1;26;.963;3600000;0
27731;218546;748;0;0;0;0;.00nan;0;0
27731;-1;764;40;30;5;25;.833;3600000;0
27731;-1;764;0;0;0;0;.00nan;0;0
27732;206301;729;0;0;0;0;.00nan;0;0
27732;211604;729;54;41;5;36;.878;3600000;0
27732;31165;752;56;20;2;18;.900;3600000;0
27732;149221;752;0;0;0;0;.00nan;0;0
27733;196698;744;0;0;0;0;.00nan;0;0
27733;207771;744;80;21;1;20;.952;3600000;0
27733;202516;743;0;0;0;0;.00nan;0;0
27733;87798;743;74;40;3;37;.925;3514000;0
27734;204272;737;96;21;0;21;1.000;3600000;0
27734;201947;737;0;0;0;0;.00nan;0;0
27734;207184;740;0;0;0;0;.00nan;0;0
27734;86151;740;98;55;3;52;.945;3600000;0
27735;595;732;56;28;4;24;.857;3600000;0
27735;198736;3789;0;0;0;0;.00nan;0;0
27735;74734;3789;71;48;5;43;.896;3600000;0
27735;88646;732;0;0;0;0;.00nan;0;0
27736;1957;738;0;0;0;0;.00nan;0;0
27736;184158;738;68;26;2;24;.923;3542000;0
27736;85661;749;98;35;1;34;.971;3600000;0
27736;91742;749;0;0;0;0;.00nan;0;0
27737;2643;736;29;25;5;20;.800;2214000;0
27737;3435;739;75;23;2;21;.913;3600000;0
27737;201075;736;35;18;4;14;.778;1386000;0
27737;152624;739;0;0;0;0;.00nan;0;0
27738;180177;747;60;23;2;21;.913;3512000;0
27738;56565;741;100;43;0;43;1.000;3600000;0
27738;71565;747;0;0;0;0;.00nan;0;0
27738;82273;741;0;0;0;0;.00nan;0;0
27739;206301;729;0;0;0;0;.00nan;0;0
27739;211604;729;54;42;5;37;.881;3600000;0
27739;-1;742;0;0;0;0;.00nan;0;0
27739;85797;742;71;25;2;23;.920;3600000;0
27740;198736;3789;0;0;0;0;.00nan;0;0
27740;196698;744;0;0;0;0;.00nan;0;0
27740;207771;744;75;29;2;27;.931;3900000;0
27740;74734;3789;80;42;2;40;.952;3900000;0
27741;204272;737;88;48;3;45;.938;3566000;0
27741;201947;737;0;0;0;0;.00nan;0;0
27741;44526;734;86;27;1;26;.963;3600000;0
27741;-1;734;0;0;0;0;.00nan;0;0
27742;202516;743;0;0;0;0;.00nan;0;0
27742;-1;764;64;19;2;17;.895;3586000;0
27742;-1;764;0;0;0;0;.00nan;0;0
27742;87798;743;87;32;1;31;.969;3600000;0
27743;178098;733;74;23;1;22;.957;3600000;0
27743;207184;740;0;0;0;0;.00nan;0;0
27743;66245;733;0;0;0;0;.00nan;0;0
27743;86151;740;37;33;6;27;.818;3600000;0
27744;2195;748;70;25;2;23;.920;3600000;0
27744;218546;748;0;0;0;0;.00nan;0;0
27744;49935;2168;87;44;3;41;.932;3563000;0
27744;76405;2168;0;0;0;0;.00nan;0;0
27745;3165;1880;69;36;3;33;.917;3600000;0
27745;31165;752;0;0;0;0;.00nan;0;0
27745;148503;1880;0;0;0;0;.00nan;0;0
27745;149221;752;79;25;1;24;.960;3600000;0
27746;1957;738;0;0;0;0;.00nan;0;0
27746;2643;736;72;46;5;41;.891;3600000;0
27746;184158;738;75;25;1;24;.960;3600000;0
27746;201075;736;0;0;0;0;.00nan;0;0
27747;180177;747;100;52;3;49;.942;3600000;0
27747;56565;741;42;25;4;21;.840;3600000;0
27747;71565;747;0;0;0;0;.00nan;0;0
27747;82273;741;0;0;0;0;.00nan;0;0
27748;206313;745;0;0;0;0;.00nan;0;0
27748;-1;764;64;25;2;23;.920;3555000;0
27748;-1;764;0;0;0;0;.00nan;0;0
27748;75362;745;100;36;1;35;.972;3600000;0
27749;2195;748;78;34;2;32;.941;3558000;0
27749;3359;751;0;0;0;0;.00nan;0;0
27749;218546;748;0;0;0;0;.00nan;0;0
27749;148788;751;100;22;0;22;1.000;3600000;0
27750;204272;737;0;0;0;0;.00nan;0;0
27750;206301;729;0;0;0;0;.00nan;0;0
27750;211604;729;100;51;0;51;1.000;3600000;0
27750;201947;737;41;19;4;15;.789;3600000;0
27751;198736;3789;0;0;0;0;.00nan;0;0
27751;207184;740;0;0;0;0;.00nan;0;0
27751;74734;3789;64;16;1;15;.938;3900000;0
27751;86151;740;100;38;1;37;.974;3900000;0
27752;3435;739;94;38;3;35;.921;3900000;0
27752;202516;743;0;0;0;0;.00nan;0;0
27752;87798;743;69;27;3;24;.889;3900000;0
27752;152624;739;0;0;0;0;.00nan;0;0
27753;178098;733;76;36;3;33;.917;3551000;0
27753;44526;734;62;25;2;23;.920;3600000;0
27753;-1;734;0;0;0;0;.00nan;0;0
27753;66245;733;0;0;0;0;.00nan;0;0
27754;-1;742;0;0;0;0;.00nan;0;0
27754;49935;2168;74;39;3;36;.923;3514000;0
27754;76405;2168;0;0;0;0;.00nan;0;0
27754;85797;742;81;22;1;21;.955;3600000;0
27755;3165;1880;0;0;0;0;.00nan;0;0
27755;85661;749;94;49;3;46;.939;3900000;0
27755;91742;749;0;0;0;0;.00nan;0;0
27755;148503;1880;93;37;3;34;.919;3900000;0
27756;595;732;89;49;2;47;.959;3580000;0
27756;196698;744;0;0;0;0;.00nan;0;0
27756;207771;744;97;25;0;25;1.000;3600000;0
27756;88646;732;0;0;0;0;.00nan;0;0
27757;31165;752;79;33;2;31;.939;3600000;0
27757;56565;741;96;40;3;37;.925;3570000;0
27757;82273;741;0;0;0;0;.00nan;0;0
27757;149221;752;0;0;0;0;.00nan;0;0
27758;206313;745;0;0;0;0;.00nan;0;0
27758;75362;745;82;30;2;28;.933;3900000;0
27758;85661;749;90;36;2;34;.944;3900000;0
27758;91742;749;0;0;0;0;.00nan;0;0
27759;3359;751;0;0;0;0;.00nan;0;0
27759;-1;742;0;0;0;0;.00nan;0;0
27759;85797;742;82;24;1;23;.958;3600000;0
27759;148788;751;46;32;5;27;.844;3600000;0
27760;1957;738;71;31;2;29;.935;3600000;0
27760;184158;738;0;0;0;0;.00nan;0;0
27760;206301;729;0;0;0;0;.00nan;0;0
27760;211604;729;54;27;3;24;.889;3523000;0
27761;2195;748;73;39;4;35;.897;3545000;0
27761;202516;743;0;0;0;0;.00nan;0;0
27761;-1;748;0;0;0;0;.00nan;0;0
27761;87798;743;65;30;3;27;.900;3600000;0
27762;3435;739;84;30;1;29;.967;3600000;0
27762;175764;734;0;0;0;0;.00nan;0;0
27762;44526;734;65;30;3;27;.900;3560000;0
27762;152624;739;0;0;0;0;.00nan;0;0
27763;204272;737;80;33;2;31;.939;3900000;0
27763;201947;737;0;0;0;0;.00nan;0;0
27763;-1;764;95;48;2;46;.958;3900000;0
27763;-1;764;0;0;0;0;.00nan;0;0
27764;2643;736;33;34;7;27;.794;2831000;0
27764;201075;736;64;15;1;14;.933;769000;0
27764;196698;744;0;0;0;0;.00nan;0;0
27764;207771;744;88;19;0;19;1.000;3600000;0
27765;3165;1880;74;31;3;28;.903;3576000;0
27765;198736;3789;0;0;0;0;.00nan;0;0
27765;74734;3789;86;36;2;34;.944;3600000;0
27765;148503;1880;0;0;0;0;.00nan;0;0
27766;595;732;88;25;1;24;.960;3900000;0
27766;207184;740;0;0;0;0;.00nan;0;0
27766;86151;740;85;28;1;27;.964;3900000;0
27766;88646;732;0;0;0;0;.00nan;0;0
27767;31165;752;0;0;0;0;.00nan;0;0
27767;56565;741;98;48;3;45;.938;3579000;0
27767;82273;741;0;0;0;0;.00nan;0;0
27767;149221;752;81;32;2;30;.938;3600000;0
27768;2195;748;80;27;1;26;.963;3600000;0
27768;-1;748;0;0;0;0;.00nan;0;0
27768;85661;749;68;31;3;28;.903;3600000;0
27768;91742;749;0;0;0;0;.00nan;0;0
27769;203977;729;0;0;0;0;.00nan;0;0
27769;211604;729;61;35;3;32;.914;3577000;0
27769;180177;747;77;25;1;24;.960;3600000;0
27769;71565;747;0;0;0;0;.00nan;0;0
27770;3359;751;0;0;0;0;.00nan;0;0
27770;175764;734;100;44;1;43;.977;3600000;0
27770;44526;734;0;0;0;0;.00nan;0;0
27770;148788;751;54;23;3;20;.870;3544000;0
27771;31165;752;90;48;3;45;.938;3543000;0
27771;49935;2168;84;36;2;34;.944;3600000;0
27771;76405;2168;0;0;0;0;.00nan;0;0
27771;149221;752;0;0;0;0;.00nan;0;0
27772;595;732;69;19;1;18;.947;3600000;0
27772;2643;736;75;32;2;30;.938;2135000;0
27772;201075;736;34;30;6;24;.800;1465000;0
27772;88646;732;0;0;0;0;.00nan;0;0
27773;3165;1880;0;0;0;0;.00nan;0;0
27773;-1;764;100;28;0;28;1.000;3600000;0
27773;-1;764;0;0;0;0;.00nan;0;0
27773;148503;1880;66;33;4;29;.879;3600000;0
27774;196698;744;0;0;0;0;.00nan;0;0
27774;207771;744;46;26;4;22;.846;3542000;0
27774;-1;742;0;0;0;0;.00nan;0;0
27774;85797;742;95;39;2;37;.949;3600000;0
27775;204272;737;0;0;0;0;.00nan;0;0
27775;178098;733;99;35;1;34;.971;3600000;0
27775;201947;737;69;25;2;23;.920;3557000;0
27775;66245;733;0;0;0;0;.00nan;0;0
27776;202516;743;0;0;0;0;.00nan;0;0
27776;56565;741;83;29;2;27;.931;3600000;0
27776;82273;741;0;0;0;0;.00nan;0;0
27776;87798;743;65;27;3;24;.889;3547000;0
27777;206313;745;0;0;0;0;.00nan;0;0
27777;31165;752;0;0;0;0;.00nan;0;0
27777;75362;745;68;35;4;31;.886;3600000;0
27777;149221;752;77;25;1;24;.960;3600000;0
27778;595;732;95;33;2;31;.939;3900000;0
27778;203977;729;77;33;2;31;.939;3855000;0
27778;211604;729;0;0;0;0;.00nan;0;0
27778;88646;732;0;0;0;0;.00nan;0;0
27779;1957;738;0;0;0;0;.00nan;0;0
27779;184158;738;64;23;2;21;.913;3600000;0
27779;207184;740;0;0;0;0;.00nan;0;0
27779;86151;740;64;39;4;35;.897;3562000;0
27780;198736;3789;0;0;0;0;.00nan;0;0
27780;180177;747;0;0;0;0;.00nan;0;0
27780;71565;747;87;46;2;44;.957;3600000;0
27780;74734;3789;79;23;1;22;.957;3600000;0
27781;-1;764;100;33;1;32;.970;3600000;0
27781;-1;764;0;0;0;0;.00nan;0;0
27781;56565;741;0;0;0;0;.00nan;0;0
27781;82273;741;72;29;2;27;.931;3581000;0
27782;49935;2168;56;28;3;25;.893;3600000;0
27782;76405;2168;0;0;0;0;.00nan;0;0
27782;85661;749;51;29;4;25;.862;3600000;0
27782;91742;749;0;0;0;0;.00nan;0;0
27783;2643;736;38;40;6;34;.850;3589000;0
27783;201075;736;0;0;0;0;.00nan;0;0
27783;175764;734;0;0;0;0;.00nan;0;0
27783;44526;734;46;25;4;21;.840;3600000;0
27784;3165;1880;82;35;3;32;.914;3600000;0
27784;196698;744;0;0;0;0;.00nan;0;0
27784;207771;744;100;28;0;28;1.000;3600000;0
27784;148503;1880;0;0;0;0;.00nan;0;0
27785;3359;751;0;0;0;0;.00nan;0;0
27785;-1;742;99;39;3;36;.923;3649000;0
27785;85797;742;0;0;0;0;.00nan;0;0
27785;148788;751;88;40;4;36;.900;3649000;0
27786;2195;748;84;15;0;15;1.000;3600000;0
27786;202516;743;0;0;0;0;.00nan;0;0
27786;218546;748;0;0;0;0;.00nan;0;0
27786;87798;743;88;38;1;37;.974;3546000;0
27787;3435;739;61;27;3;24;.889;3578000;0
27787;204272;737;97;40;1;39;.975;3600000;0
27787;201947;737;0;0;0;0;.00nan;0;0
27787;152624;739;0;0;0;0;.00nan;0;0
27788;203533;745;0;0;0;0;.00nan;0;0
27788;196698;744;0;0;0;0;.00nan;0;0
27788;75362;745;98;61;2;59;.967;3582000;0
27788;93324;744;63;16;1;15;.938;3600000;0
27789;1957;1880;47;18;3;15;.833;3900000;0
27789;3165;1880;0;0;0;0;.00nan;0;0
27789;203977;729;0;0;0;0;.00nan;0;0
27789;211604;729;93;47;3;44;.936;3900000;0
27790;1957;738;0;0;0;0;.00nan;0;0
27790;204272;737;0;0;0;0;.00nan;0;0
27790;184158;738;100;34;0;34;1.000;3600000;0
27790;201947;737;76;21;1;20;.952;3600000;0
27791;3435;739;0;0;0;0;.00nan;0;0
27791;207184;740;43;10;2;8;.800;762000;0
27791;86151;740;33;32;6;26;.813;2838000;0
27791;152624;739;65;20;1;19;.950;3600000;0
27792;198736;3789;0;0;0;0;.00nan;0;0
27792;178098;733;32;28;6;22;.786;3083000;0
27792;66245;733;54;4;0;4;1.000;467000;0
27792;74734;3789;39;21;4;17;.810;3600000;0
27793;3359;751;0;0;0;0;.00nan;0;0
27793;8505;749;87;32;1;31;.969;3600000;0
27793;91742;749;0;0;0;0;.00nan;0;0
27793;148788;751;68;32;3;29;.906;3518000;0
27794;2643;736;47;46;7;39;.848;2711000;0
27794;201075;736;51;7;1;6;.857;889000;0
27794;-1;764;56;14;1;13;.929;3600000;0
27794;-1;764;0;0;0;0;.00nan;0;0
27795;175764;734;0;0;0;0;.00nan;0;0
27795;44526;734;90;44;2;42;.955;3600000;0
27795;-1;742;0;0;0;0;.00nan;0;0
27795;85797;742;76;23;1;22;.957;3600000;0
27796;595;732;62;22;2;20;.909;3600000;0
27796;56565;741;63;28;4;24;.857;3589000;0
27796;82273;741;0;0;0;0;.00nan;0;0
27796;88646;732;0;0;0;0;.00nan;0;0
27797;180177;747;100;26;0;26;1.000;3600000;0
27797;49935;2168;94;35;1;34;.971;3600000;0
27797;71565;747;0;0;0;0;.00nan;0;0
27797;76405;2168;0;0;0;0;.00nan;0;0
27798;31165;752;46;34;5;29;.853;3600000;0
27798;218546;748;0;0;0;0;.00nan;0;0
27798;-1;748;86;40;2;38;.950;3600000;0
27798;149221;752;0;0;0;0;.00nan;0;0
27799;3359;751;0;0;0;0;.00nan;0;0
27799;75362;745;100;44;1;43;.977;3600000;0
27799;148788;751;65;27;3;24;.889;3584000;0
27799;152624;745;0;0;0;0;.00nan;0;0
27800;8505;738;0;0;0;0;.00nan;0;0
27800;178098;733;81;30;2;28;.933;3570000;0
27800;184158;738;83;28;1;27;.964;3600000;0
27800;66245;733;0;0;0;0;.00nan;0;0
27801;198736;3789;0;0;0;0;.00nan;0;0
27801;207184;740;0;0;0;0;.00nan;0;0
27801;74734;3789;72;28;2;26;.929;3600000;0
27801;86151;740;100;47;1;46;.979;3600000;0
27802;1957;1880;76;34;3;31;.912;3600000;0
27802;3165;1880;0;0;0;0;.00nan;0;0
27802;3435;739;73;23;2;21;.913;3600000;0
27802;148503;739;0;0;0;0;.00nan;0;0
27803;196698;744;0;0;0;0;.00nan;0;0
27803;202516;743;56;26;3;23;.885;3600000;0
27803;87798;743;0;0;0;0;.00nan;0;0
27803;93324;744;93;25;0;25;1.000;3600000;0
27804;175764;734;0;0;0;0;.00nan;0;0
27804;44526;734;96;28;0;28;1.000;3600000;0
27804;-1;764;0;0;0;0;.00nan;0;0
27804;-1;764;21;31;7;24;.774;3600000;0
27805;204272;737;61;26;2;24;.923;3585000;0
27805;201947;737;0;0;0;0;.00nan;0;0
27805;85661;749;99;35;1;34;.971;3600000;0
27805;91742;749;0;0;0;0;.00nan;0;0
27806;-1;742;0;0;0;0;.00nan;0;0
27806;56565;741;100;45;2;43;.956;3900000;0
27806;82273;741;0;0;0;0;.00nan;0;0
27806;85797;742;72;23;2;21;.913;3900000;0
27807;180177;747;71;28;2;26;.929;3600000;0
27807;49935;2168;57;38;5;33;.868;3600000;0
27807;71565;747;0;0;0;0;.00nan;0;0
27807;76405;2168;0;0;0;0;.00nan;0;0
27808;595;732;84;33;2;31;.939;3600000;0
27808;2643;736;64;37;4;33;.892;3527000;0
27808;201075;736;0;0;0;0;.00nan;0;0
27808;88646;732;0;0;0;0;.00nan;0;0
27809;31165;752;0;0;0;0;.00nan;0;0
27809;218546;748;64;23;2;21;.913;3600000;0
27809;-1;748;0;0;0;0;.00nan;0;0
27809;149221;752;62;37;5;32;.865;3600000;0
27810;3435;739;80;32;2;30;.938;3900000;0
27810;8505;738;0;0;0;0;.00nan;0;0
27810;184158;738;90;44;2;42;.955;3900000;0
27810;148503;739;0;0;0;0;.00nan;0;0
27811;198736;3789;0;0;0;0;.00nan;0;0
27811;178098;733;87;43;2;41;.953;3600000;0
27811;66245;733;0;0;0;0;.00nan;0;0
27811;74734;3789;74;22;1;21;.955;3600000;0
27812;175764;734;0;0;0;0;.00nan;0;0
27812;202516;743;0;0;0;0;.00nan;0;0
27812;44526;734;78;34;3;31;.912;3600000;0
27812;87798;743;100;25;0;25;1.000;3600000;0
27813;1957;1880;53;35;6;29;.829;3600000;0
27813;3165;1880;0;0;0;0;.00nan;0;0
27813;-1;764;68;33;3;30;.909;3600000;0
27813;-1;764;0;0;0;0;.00nan;0;0
27814;203977;729;0;0;0;0;.00nan;0;0
27814;204272;737;0;0;0;0;.00nan;0;0
27814;211604;729;53;49;5;44;.898;3548000;0
27814;201947;737;67;41;4;37;.902;3600000;0
27815;180177;747;57;25;3;22;.880;3600000;0
27815;218546;748;0;0;0;0;.00nan;0;0
27815;-1;748;60;13;1;12;.923;3600000;0
27815;71565;747;0;0;0;0;.00nan;0;0
27816;56565;741;56;17;2;15;.882;3600000;0
27816;82273;741;0;0;0;0;.00nan;0;0
27816;85661;749;48;34;5;29;.853;3600000;0
27816;91742;749;0;0;0;0;.00nan;0;0
27817;2643;736;76;37;3;34;.919;3900000;0
27817;201075;736;0;0;0;0;.00nan;0;0
27817;207184;740;0;0;0;0;.00nan;0;0
27817;86151;740;100;41;3;38;.927;3900000;0
27818;-1;742;0;0;0;0;.00nan;0;0
27818;75362;745;100;55;2;53;.964;3600000;0
27818;85797;742;67;30;3;27;.900;3547000;0
27818;152624;745;0;0;0;0;.00nan;0;0
27819;31165;752;77;27;2;25;.926;3900000;0
27819;49935;2168;81;39;2;37;.949;3900000;0
27819;76405;2168;0;0;0;0;.00nan;0;0
27819;149221;752;0;0;0;0;.00nan;0;0
27820;3435;739;66;28;3;25;.893;3577000;0
27820;178098;733;84;39;2;37;.949;3600000;0
27820;66245;733;0;0;0;0;.00nan;0;0
27820;148503;739;0;0;0;0;.00nan;0;0
27821;180177;747;0;0;0;0;.00nan;0;0
27821;218546;748;40;27;4;23;.852;3571000;0
27821;-1;748;0;0;0;0;.00nan;0;0
27821;71565;747;71;28;2;26;.929;3600000;0
27822;196698;744;0;0;0;0;.00nan;0;0
27822;202516;743;0;0;0;0;.00nan;0;0
27822;87798;743;100;52;3;49;.942;3600000;0
27822;93324;744;42;22;4;18;.818;3551000;0
27823;2643;736;74;26;2;24;.923;3600000;0
27823;203977;729;34;40;6;34;.850;3600000;0
27823;201075;736;0;0;0;0;.00nan;0;0
27823;211604;729;0;0;0;0;.00nan;0;0
27824;198736;3789;0;0;0;0;.00nan;0;0
27824;-1;742;0;0;0;0;.00nan;0;0
27824;74734;3789;64;36;6;30;.833;3600000;0
27824;85797;742;87;34;2;32;.941;3600000;0
27825;204272;737;0;0;0;0;.00nan;0;0
27825;201947;737;100;27;0;27;1.000;3600000;0
27825;85661;749;97;38;1;37;.974;3552000;0
27825;91742;749;0;0;0;0;.00nan;0;0
27826;595;732;81;32;2;30;.938;3600000;0
27826;175764;734;0;0;0;0;.00nan;0;0
27826;44526;734;28;37;6;31;.838;3600000;0
27826;88646;732;0;0;0;0;.00nan;0;0
27827;56565;741;0;0;0;0;.00nan;0;0
27827;75362;745;91;26;1;25;.962;3600000;0
27827;82273;741;72;29;2;27;.931;3591000;0
27827;152624;745;0;0;0;0;.00nan;0;0
27828;207184;740;0;0;0;0;.00nan;0;0
27828;-1;764;66;23;2;21;.913;3600000;0
27828;-1;764;0;0;0;0;.00nan;0;0
27828;86151;740;51;39;5;34;.872;3600000;0
27829;31165;752;0;0;0;0;.00nan;0;0
27829;49935;2168;100;24;0;24;1.000;3600000;0
27829;76405;2168;0;0;0;0;.00nan;0;0
27829;149221;752;50;28;3;25;.893;3600000;0
27830;3359;751;28;21;5;16;.762;3600000;0
27830;202516;743;0;0;0;0;.00nan;0;0
27830;87798;743;95;35;2;33;.943;3600000;0
27830;148788;751;0;0;0;0;.00nan;0;0
27831;8505;738;0;0;0;0;.00nan;0;0
27831;184158;738;71;49;5;44;.898;3528000;0
27831;196698;744;0;0;0;0;.00nan;0;0
27831;93324;744;58;24;3;21;.875;3600000;0
27832;3359;751;0;0;0;0;.00nan;0;0
27832;85661;749;87;27;1;26;.963;3627000;0
27832;91742;749;0;0;0;0;.00nan;0;0
27832;148788;751;78;29;2;27;.931;3627000;0
27833;198736;3789;0;0;0;0;.00nan;0;0
27833;204272;737;0;0;0;0;.00nan;0;0
27833;201947;737;50;24;3;21;.875;3600000;0
27833;74734;3789;81;46;4;42;.913;3578000;0
27834;175764;734;60;29;2;27;.931;3900000;0
27834;44526;734;0;0;0;0;.00nan;0;0
27834;56565;741;99;42;2;40;.952;3900000;0
27834;82273;741;0;0;0;0;.00nan;0;0
27835;178098;733;0;0;0;0;.00nan;0;0
27835;-1;764;38;28;5;23;.821;3600000;0
27835;-1;764;0;0;0;0;.00nan;0;0
27835;66245;733;89;31;1;30;.968;3600000;0
27836;1957;1880;68;25;2;23;.920;3600000;0
27836;3165;1880;0;0;0;0;.00nan;0;0
27836;75362;745;77;44;3;41;.932;3559000;0
27836;152624;745;0;0;0;0;.00nan;0;0
27837;595;732;99;39;2;37;.949;3600000;0
27837;207184;740;31;9;3;6;.667;458000;0
27837;86151;740;57;28;3;25;.893;3142000;0
27837;88646;732;0;0;0;0;.00nan;0;0
27838;8505;738;0;0;0;0;.00nan;0;0
27838;184158;738;100;31;0;31;1.000;3600000;0
27838;218546;748;58;22;2;20;.909;3595000;0
27838;-1;748;0;0;0;0;.00nan;0;0
27839;198736;3789;50;40;6;34;.850;3662000;0
27839;204272;737;38;30;5;25;.833;3662000;0
27839;201947;737;0;0;0;0;.00nan;0;0
27839;74734;3789;0;0;0;0;.00nan;0;0
27840;2643;736;100;41;2;39;.951;3600000;0
27840;201075;736;0;0;0;0;.00nan;0;0
27840;180177;747;57;25;3;22;.880;3600000;0
27840;71565;747;0;0;0;0;.00nan;0;0
27841;203977;729;0;0;0;0;.00nan;0;0
27841;211604;729;56;21;2;19;.905;3600000;0
27841;-1;742;0;0;0;0;.00nan;0;0
27841;85797;742;58;39;4;35;.897;3529000;0
27842;31165;752;71;38;4;34;.895;3600000;0
27842;196698;744;0;0;0;0;.00nan;0;0
27842;93324;744;79;24;1;23;.958;3600000;0
27842;149221;752;0;0;0;0;.00nan;0;0
27843;202516;743;0;0;0;0;.00nan;0;0
27843;75362;745;62;28;3;25;.893;3537000;0
27843;87798;743;99;35;1;34;.971;3600000;0
27843;152624;745;0;0;0;0;.00nan;0;0
27844;3435;739;97;40;3;37;.925;3600000;0
27844;56565;741;0;0;0;0;.00nan;0;0
27844;82273;741;55;31;4;27;.871;3561000;0
27844;148503;739;0;0;0;0;.00nan;0;0
27845;595;732;89;35;2;33;.943;3900000;0
27845;178098;733;100;48;2;46;.958;3900000;0
27845;66245;733;0;0;0;0;.00nan;0;0
27845;88646;732;0;0;0;0;.00nan;0;0
27846;49935;2168;99;21;0;21;1.000;3600000;0
27846;76405;2168;0;0;0;0;.00nan;0;0
27846;85661;749;81;35;3;32;.914;3600000;0
27846;91742;749;0;0;0;0;.00nan;0;0
27847;3359;751;0;0;0;0;.00nan;0;0
27847;8505;738;0;0;0;0;.00nan;0;0
27847;184158;738;59;23;3;20;.870;3600000;0
27847;148788;751;39;20;4;16;.800;3585000;0
27848;175764;734;0;0;0;0;.00nan;0;0
27848;180177;747;81;27;2;25;.926;3900000;0
27848;44526;734;97;37;2;35;.946;3900000;0
27848;71565;747;0;0;0;0;.00nan;0;0
27849;31165;752;0;0;0;0;.00nan;0;0
27849;-1;764;63;26;3;23;.885;3566000;0
27849;-1;764;0;0;0;0;.00nan;0;0
27849;149221;752;82;33;2;31;.939;3600000;0
27850;2643;736;61;45;6;39;.867;3600000;0
27850;204272;737;80;34;2;32;.941;3600000;0
27850;201075;736;0;0;0;0;.00nan;0;0
27850;201947;737;0;0;0;0;.00nan;0;0
27851;207184;740;0;0;0;0;.00nan;0;0
27851;-1;742;0;0;0;0;.00nan;0;0
27851;85797;742;39;30;5;25;.833;3600000;0
27851;86151;740;100;40;1;39;.975;3600000;0
27852;203977;729;0;0;0;0;.00nan;0;0
27852;211604;729;71;51;5;46;.902;3600000;0
27852;196698;744;60;32;3;29;.906;3174000;0
27852;93324;744;26;5;3;2;.400;413000;0
27853;3435;739;85;33;2;31;.939;3600000;0
27853;198736;3789;0;0;0;0;.00nan;0;0
27853;74734;3789;64;41;5;36;.878;3600000;0
27853;148503;739;0;0;0;0;.00nan;0;0
27854;595;732;96;24;0;24;1.000;3600000;0
27854;202516;743;0;0;0;0;.00nan;0;0
27854;87798;743;36;38;7;31;.816;3600000;0
27854;88646;732;0;0;0;0;.00nan;0;0
27855;207184;740;0;0;0;0;.00nan;0;0
27855;75362;745;84;33;2;31;.939;3511000;0
27855;86151;740;100;24;0;24;1.000;3600000;0
27855;152624;745;0;0;0;0;.00nan;0;0
27856;175764;734;0;0;0;0;.00nan;0;0
27856;218546;748;33;31;6;25;.806;3600000;0
27856;44526;734;72;33;3;30;.909;3600000;0
27856;-1;748;0;0;0;0;.00nan;0;0
27857;203977;729;0;0;0;0;.00nan;0;0
27857;211604;729;67;41;4;37;.902;3600000;0
27857;-1;764;90;21;0;21;1.000;3600000;0
27857;-1;764;0;0;0;0;.00nan;0;0
27858;8505;738;0;0;0;0;.00nan;0;0
27858;178098;733;100;53;2;51;.962;3900000;0
27858;184158;738;87;35;2;33;.943;3900000;0
27858;66245;733;0;0;0;0;.00nan;0;0
27859;31165;752;86;45;4;41;.911;3576000;0
27859;56565;741;66;31;3;28;.903;3600000;0
27859;82273;741;0;0;0;0;.00nan;0;0
27859;149221;752;0;0;0;0;.00nan;0;0
27860;180177;747;71;41;4;37;.902;3794000;0
27860;71565;747;0;0;0;0;.00nan;0;0
27860;85661;749;0;0;0;0;.00nan;0;0
27860;91742;749;53;36;5;31;.861;3794000;0
27861;3359;751;80;43;3;40;.930;3600000;0
27861;207771;744;100;26;0;26;1.000;3600000;0
27861;93324;744;0;0;0;0;.00nan;0;0
27861;148788;751;0;0;0;0;.00nan;0;0
27862;1957;1880;75;45;5;40;.889;3600000;0
27862;3165;1880;0;0;0;0;.00nan;0;0
27862;202516;743;0;0;0;0;.00nan;0;0
27862;87798;743;100;27;0;27;1.000;3600000;0
27863;2643;736;62;28;3;25;.893;3568000;0
27863;198736;3789;0;0;0;0;.00nan;0;0
27863;201075;736;0;0;0;0;.00nan;0;0
27863;74734;3789;68;27;2;25;.926;3600000;0
27864;-1;742;0;0;0;0;.00nan;0;0
27864;49935;2168;88;48;3;45;.938;3542000;0
27864;76405;2168;0;0;0;0;.00nan;0;0
27864;85797;742;55;18;2;16;.889;3600000;0
27865;203977;729;92;51;3;48;.941;3600000;0
27865;211604;729;0;0;0;0;.00nan;0;0
27865;218546;748;73;16;1;15;.938;3600000;0
27865;-1;748;0;0;0;0;.00nan;0;0
27866;3435;739;74;25;2;23;.920;3600000;0
27866;207184;740;0;0;0;0;.00nan;0;0
27866;86151;740;65;37;4;33;.892;3543000;0
27866;148503;739;0;0;0;0;.00nan;0;0
27867;198736;3789;0;0;0;0;.00nan;0;0
27867;8505;738;0;0;0;0;.00nan;0;0
27867;184158;738;97;52;2;50;.962;3600000;0
27867;74734;3789;61;35;4;31;.886;3560000;0
27868;180177;747;61;34;4;30;.882;3530000;0
27868;71565;747;0;0;0;0;.00nan;0;0
27868;85661;749;99;38;2;36;.947;3600000;0
27868;91742;749;0;0;0;0;.00nan;0;0
27869;1957;1880;88;32;2;30;.938;3600000;0
27869;3165;1880;0;0;0;0;.00nan;0;0
27869;175764;734;0;0;0;0;.00nan;0;0
27869;44526;734;88;48;4;44;.917;3600000;0
27870;178098;733;100;35;1;34;.971;3600000;0
27870;56565;741;0;0;0;0;.00nan;0;0
27870;66245;733;0;0;0;0;.00nan;0;0
27870;82273;741;62;31;3;28;.903;3513000;0
27871;2643;736;70;34;3;31;.912;3600000;0
27871;3359;751;0;0;0;0;.00nan;0;0
27871;201075;736;0;0;0;0;.00nan;0;0
27871;148788;751;65;48;5;43;.896;3600000;0
27872;595;732;63;24;3;21;.875;3581000;0
27872;49935;2168;99;35;1;34;.971;3600000;0
27872;76405;2168;0;0;0;0;.00nan;0;0
27872;88646;732;0;0;0;0;.00nan;0;0
27873;31165;752;0;0;0;0;.00nan;0;0
27873;-1;764;61;29;3;26;.897;3600000;0
27873;-1;764;0;0;0;0;.00nan;0;0
27873;149221;752;100;34;0;34;1.000;3600000;0
27874;207771;744;100;29;0;29;1.000;3600000;0
27874;75362;745;81;36;4;32;.889;3600000;0
27874;93324;744;0;0;0;0;.00nan;0;0
27874;152624;745;0;0;0;0;.00nan;0;0
27875;3435;739;57;36;5;31;.861;3900000;0
27875;204272;737;68;43;5;38;.884;3900000;0
27875;201947;737;0;0;0;0;.00nan;0;0
27875;148503;739;0;0;0;0;.00nan;0;0
27876;218546;748;80;30;2;28;.933;3751000;0
27876;-1;748;0;0;0;0;.00nan;0;0
27876;75362;745;80;43;3;40;.930;3751000;0
27876;152624;745;0;0;0;0;.00nan;0;0
27877;203977;729;0;0;0;0;.00nan;0;0
27877;211604;729;32;21;5;16;.762;3820000;0
27877;49935;2168;48;30;4;26;.867;3820000;0
27877;76405;2168;0;0;0;0;.00nan;0;0
27878;180177;747;0;0;0;0;.00nan;0;0
27878;71565;747;91;33;2;31;.939;3900000;0
27878;85661;749;90;44;2;42;.955;3900000;0
27878;91742;749;0;0;0;0;.00nan;0;0
27879;3359;751;0;0;0;0;.00nan;0;0
27879;202516;743;0;0;0;0;.00nan;0;0
27879;87798;743;77;25;1;24;.960;3600000;0
27879;148788;751;68;23;2;21;.913;3543000;0
27880;198736;3789;0;0;0;0;.00nan;0;0
27880;175764;734;96;40;1;39;.975;3900000;0
27880;44526;734;0;0;0;0;.00nan;0;0
27880;74734;3789;100;41;1;40;.976;3900000;0
27881;-1;742;0;0;0;0;.00nan;0;0
27881;56565;741;91;37;2;35;.946;3600000;0
27881;82273;741;0;0;0;0;.00nan;0;0
27881;85797;742;81;44;3;41;.932;3582000;0
27882;2643;736;0;0;0;0;.00nan;0;0
27882;8505;738;0;0;0;0;.00nan;0;0
27882;184158;738;77;26;1;25;.962;3600000;0
27882;201075;736;82;25;2;23;.920;3600000;0
27883;595;732;100;28;0;28;1.000;3600000;0
27883;1957;1880;63;41;4;37;.902;3600000;0
27883;3165;1880;0;0;0;0;.00nan;0;0
27883;88646;732;0;0;0;0;.00nan;0;0
27884;31165;752;0;0;0;0;.00nan;0;0
27884;-1;764;61;31;3;28;.903;3600000;0
27884;-1;764;0;0;0;0;.00nan;0;0
27884;149221;752;53;44;7;37;.841;3600000;0
27885;178098;733;89;50;4;46;.920;3600000;0
27885;207771;744;76;22;1;21;.955;3600000;0
27885;66245;733;0;0;0;0;.00nan;0;0
27885;93324;744;0;0;0;0;.00nan;0;0
27886;3435;739;71;25;2;23;.920;3600000;0
27886;207184;740;0;0;0;0;.00nan;0;0
27886;86151;740;68;35;4;31;.886;3558000;0
27886;148503;739;0;0;0;0;.00nan;0;0
27887;218546;748;0;0;0;0;.00nan;0;0
27887;-1;742;0;0;0;0;.00nan;0;0
27887;-1;748;89;37;2;35;.946;3574000;0
27887;85797;742;99;35;1;34;.971;3600000;0
27888;3359;751;0;0;0;0;.00nan;0;0
27888;75362;745;59;40;5;35;.875;3574000;0
27888;148788;751;55;24;3;21;.875;3600000;0
27888;152624;745;0;0;0;0;.00nan;0;0
27889;203977;729;97;40;0;40;1.000;2669000;0
27889;184158;738;100;31;0;31;1.000;3600000;0
27889;211604;729;29;14;4;10;.714;931000;0
27889;-1;738;0;0;0;0;.00nan;0;0
27890;198736;3789;0;0;0;0;.00nan;0;0
27890;49935;2168;75;57;6;51;.895;3133000;0
27890;74734;3789;67;26;2;24;.923;3600000;0
27890;76405;2168;47;7;1;6;.857;467000;0
27891;180177;747;0;0;0;0;.00nan;0;0
27891;-1;764;100;44;3;41;.932;3900000;0
27891;-1;764;0;0;0;0;.00nan;0;0
27891;71565;747;53;29;3;26;.897;3900000;0
27892;202516;743;0;0;0;0;.00nan;0;0
27892;56565;741;100;40;1;39;.975;3600000;0
27892;82273;741;0;0;0;0;.00nan;0;0
27892;87798;743;51;24;4;20;.833;3600000;0
27893;1957;1880;76;31;2;29;.935;3600000;0
27893;3165;1880;0;0;0;0;.00nan;0;0
27893;204272;737;0;0;0;0;.00nan;0;0
27893;201947;737;72;29;3;26;.897;3560000;0
27894;31165;752;58;41;4;37;.902;3600000;0
27894;85661;749;93;23;0;23;1.000;3600000;0
27894;91742;749;0;0;0;0;.00nan;0;0
27894;149221;752;0;0;0;0;.00nan;0;0
27895;595;732;98;45;2;43;.956;3900000;0
27895;3435;739;63;28;2;26;.929;3900000;0
27895;88646;732;0;0;0;0;.00nan;0;0
27895;148503;739;0;0;0;0;.00nan;0;0
27896;180177;747;67;44;5;39;.886;3600000;0
27896;-1;764;0;0;0;0;.00nan;0;0
27896;-1;764;83;32;2;30;.938;3600000;0
27896;71565;747;0;0;0;0;.00nan;0;0
27897;2643;736;54;36;5;31;.861;3600000;0
27897;201075;736;0;0;0;0;.00nan;0;0
27897;175764;734;0;0;0;0;.00nan;0;0
27897;44526;734;98;38;1;37;.974;3600000;0
27898;1957;1880;46;25;3;22;.880;3519000;0
27898;3165;1880;0;0;0;0;.00nan;0;0
27898;204272;737;100;46;1;45;.978;3600000;0
27898;201947;737;0;0;0;0;.00nan;0;0
27899;178098;733;59;33;4;29;.879;3600000;0
27899;207184;740;64;25;2;23;.920;3111000;0
27899;66245;733;0;0;0;0;.00nan;0;0
27899;86151;740;26;5;3;2;.400;437000;0
27900;31165;752;0;0;0;0;.00nan;0;0
27900;85661;749;76;17;1;16;.941;3600000;0
27900;91742;749;0;0;0;0;.00nan;0;0
27900;149221;752;79;33;2;31;.939;3553000;0
27901;202516;743;0;0;0;0;.00nan;0;0
27901;56565;741;0;0;0;0;.00nan;0;0
27901;82273;741;64;27;3;24;.889;3600000;0
27901;87798;743;54;29;4;25;.862;3596000;0
27902;49935;2168;0;0;0;0;.00nan;0;0
27902;75362;745;99;37;1;36;.973;3600000;0
27902;76405;2168;86;33;2;31;.939;3547000;0
27902;152624;745;0;0;0;0;.00nan;0;0
27903;3359;751;63;29;4;25;.862;3714000;0
27903;218546;748;52;39;5;34;.872;3714000;0
27903;-1;748;0;0;0;0;.00nan;0;0
27903;148788;751;0;0;0;0;.00nan;0;0
27904;178098;733;77;53;5;48;.906;3600000;0
27904;184158;738;87;15;0;15;1.000;3600000;0
27904;-1;738;0;0;0;0;.00nan;0;0
27904;66245;733;0;0;0;0;.00nan;0;0
27905;595;732;90;40;2;38;.950;3600000;0
27905;204272;737;67;30;3;27;.900;3305000;0
27905;201947;737;21;3;3;0;.000;295000;0
27905;88646;732;0;0;0;0;.00nan;0;0
27906;1957;1880;80;34;3;31;.912;3600000;0
27906;3165;1880;0;0;0;0;.00nan;0;0
27906;198736;3789;0;0;0;0;.00nan;0;0
27906;74734;3789;71;28;2;26;.929;3600000;0
27907;175764;734;0;0;0;0;.00nan;0;0
27907;207184;740;0;0;0;0;.00nan;0;0
27907;44526;734;78;32;2;30;.938;3900000;0
27907;86151;740;96;49;2;47;.959;3900000;0
27908;207771;744;60;33;4;29;.879;3572000;0
27908;-1;742;0;0;0;0;.00nan;0;0
27908;85797;742;72;25;2;23;.920;3600000;0
27908;93324;744;0;0;0;0;.00nan;0;0
27909;202516;743;0;0;0;0;.00nan;0;0
27909;85661;749;57;25;3;22;.880;3600000;0
27909;87798;743;83;32;1;31;.969;3600000;0
27909;91742;749;0;0;0;0;.00nan;0;0
27910;198736;3789;0;0;0;0;.00nan;0;0
27910;203977;729;71;38;4;34;.895;3600000;0
27910;211604;729;0;0;0;0;.00nan;0;0
27910;74734;3789;89;30;1;29;.967;3600000;0
27911;2643;736;100;31;0;31;1.000;3600000;0
27911;184158;738;47;29;4;25;.862;3600000;0
27911;201075;736;0;0;0;0;.00nan;0;0
27911;-1;738;0;0;0;0;.00nan;0;0
27912;204272;737;0;0;0;0;.00nan;0;0
27912;31165;752;39;21;4;17;.810;1167000;0
27912;201947;737;65;25;2;23;.920;3600000;0
27912;149221;752;69;22;1;21;.955;2433000;0
27913;218546;748;0;0;0;0;.00nan;0;0
27913;-1;764;81;35;3;32;.914;3900000;0
27913;-1;748;82;34;3;31;.912;3900000;0
27913;-1;764;0;0;0;0;.00nan;0;0
27914;3435;739;44;23;4;19;.826;3565000;0
27914;178098;733;63;31;3;28;.903;3600000;0
27914;66245;733;0;0;0;0;.00nan;0;0
27914;148503;739;0;0;0;0;.00nan;0;0
27915;180177;747;0;0;0;0;.00nan;0;0
27915;49935;2168;80;35;2;33;.943;3798000;0
27915;71565;747;92;43;3;40;.930;3798000;0
27915;76405;2168;0;0;0;0;.00nan;0;0
27916;207184;740;0;0;0;0;.00nan;0;0
27916;207771;744;81;14;0;14;1.000;3600000;0
27916;86151;740;92;45;3;42;.933;3600000;0
27916;93324;744;0;0;0;0;.00nan;0;0
27917;595;732;97;39;1;38;.974;3600000;0
27917;175764;734;0;0;0;0;.00nan;0;0
27917;44526;734;90;45;4;41;.911;3600000;0
27917;88646;732;0;0;0;0;.00nan;0;0
27918;-1;742;0;0;0;0;.00nan;0;0
27918;75362;745;100;45;1;44;.978;3600000;0
27918;85797;742;64;22;3;19;.864;3523000;0
27918;152624;745;0;0;0;0;.00nan;0;0
27919;3359;751;0;0;0;0;.00nan;0;0
27919;180177;747;0;0;0;0;.00nan;0;0
27919;71565;747;65;42;4;38;.905;3529000;0
27919;148788;751;93;35;2;33;.943;3600000;0
27920;184158;738;94;35;1;34;.971;3600000;0
27920;207771;744;68;24;2;22;.917;3555000;0
27920;-1;738;0;0;0;0;.00nan;0;0
27920;93324;744;0;0;0;0;.00nan;0;0
27921;198736;3789;0;0;0;0;.00nan;0;0
27921;31165;752;0;0;0;0;.00nan;0;0
27921;74734;3789;86;40;3;37;.925;3600000;0
27921;149221;752;42;24;4;20;.833;3560000;0
27922;3435;739;73;25;2;23;.920;3600000;0
27922;175764;734;0;0;0;0;.00nan;0;0
27922;44526;734;68;42;4;38;.905;3532000;0
27922;148503;739;0;0;0;0;.00nan;0;0
27923;203977;729;0;0;0;0;.00nan;0;0
27923;178098;733;80;45;4;41;.911;3600000;0
27923;211604;729;66;25;2;23;.920;3600000;0
27923;66245;733;0;0;0;0;.00nan;0;0
27924;2643;736;85;39;3;36;.923;3561000;0
27924;201075;736;0;0;0;0;.00nan;0;0
27924;85661;749;78;26;2;24;.923;3600000;0
27924;91742;749;0;0;0;0;.00nan;0;0
27925;207184;740;0;0;0;0;.00nan;0;0
27925;218546;748;87;14;0;14;1.000;3600000;0
27925;-1;748;0;0;0;0;.00nan;0;0
27925;86151;740;57;40;5;35;.875;3600000;0
27926;595;732;76;33;3;30;.909;3600000;0
27926;204272;737;77;48;5;43;.896;3600000;0
27926;201947;737;0;0;0;0;.00nan;0;0
27926;88646;732;0;0;0;0;.00nan;0;0
27927;49935;2168;57;24;2;22;.917;3555000;0
27927;75362;745;100;35;1;34;.971;3600000;0
27927;76405;2168;0;0;0;0;.00nan;0;0
27927;152624;745;0;0;0;0;.00nan;0;0
27928;202516;743;0;0;0;0;.00nan;0;0
27928;56565;741;86;41;2;39;.951;3586000;0
27928;82273;741;0;0;0;0;.00nan;0;0
27928;87798;743;95;21;0;21;1.000;3600000;0
27929;178098;733;0;0;0;0;.00nan;0;0
27929;-1;742;0;0;0;0;.00nan;0;0
27929;66245;733;84;42;3;39;.929;3546000;0
27929;85797;742;78;26;2;24;.923;3600000;0
27930;595;732;0;0;0;0;.00nan;0;0
27930;1957;1880;85;27;1;26;.963;3600000;0
27930;3165;1880;0;0;0;0;.00nan;0;0
27930;88646;732;84;42;3;39;.929;3600000;0
27931;2643;736;15;24;7;17;.708;2258000;0
27931;201075;736;61;27;3;24;.889;1342000;0
27931;218546;748;35;19;4;15;.789;3600000;0
27931;-1;748;0;0;0;0;.00nan;0;0
27932;3359;751;0;0;0;0;.00nan;0;0
27932;180177;747;0;0;0;0;.00nan;0;0
27932;71565;747;51;18;3;15;.833;3600000;0
27932;148788;751;47;33;5;28;.848;3550000;0
27933;198736;3789;0;0;0;0;.00nan;0;0
27933;203977;729;44;5;1;4;.800;348000;0
27933;211604;729;59;51;8;43;.843;3252000;0
27933;74734;3789;99;23;0;23;1.000;3600000;0
27934;3435;739;94;45;2;43;.956;3522000;0
27934;207771;744;100;29;0;29;1.000;3600000;0
27934;93324;744;0;0;0;0;.00nan;0;0
27934;148503;739;0;0;0;0;.00nan;0;0
27935;31165;752;83;52;5;47;.904;3600000;0
27935;-1;764;85;30;2;28;.933;3600000;0
27935;-1;764;0;0;0;0;.00nan;0;0
27935;149221;752;0;0;0;0;.00nan;0;0
27936;184158;738;84;34;2;32;.941;3797000;0
27936;-1;738;0;0;0;0;.00nan;0;0
27936;85661;749;61;22;3;19;.864;3797000;0
27936;91742;749;0;0;0;0;.00nan;0;0
27937;175764;734;55;35;4;31;.886;3600000;0
27937;44526;734;0;0;0;0;.00nan;0;0
27937;49935;2168;100;34;1;33;.971;3600000;0
27937;76405;2168;0;0;0;0;.00nan;0;0
27938;1957;1880;100;36;1;35;.972;3600000;0
27938;3165;1880;0;0;0;0;.00nan;0;0
27938;-1;742;0;0;0;0;.00nan;0;0
27938;85797;742;81;35;3;32;.914;3552000;0
27939;207184;740;0;0;0;0;.00nan;0;0
27939;218546;748;0;0;0;0;.00nan;0;0
27939;-1;748;58;19;2;17;.895;3600000;0
27939;86151;740;50;29;4;25;.862;3600000;0
27940;2643;736;27;23;5;18;.783;3600000;0
27940;3359;751;0;0;0;0;.00nan;0;0
27940;201075;736;0;0;0;0;.00nan;0;0
27940;148788;751;100;29;0;29;1.000;3600000;0
27941;198736;3789;0;0;0;0;.00nan;0;0
27941;184158;738;67;32;3;29;.906;3600000;0
27941;-1;738;0;0;0;0;.00nan;0;0
27941;74734;3789;57;26;4;22;.846;3600000;0
27942;180177;747;0;0;0;0;.00nan;0;0
27942;202516;743;0;0;0;0;.00nan;0;0
27942;71565;747;76;34;3;31;.912;3551000;0
27942;87798;743;69;23;1;22;.957;3600000;0
27943;175764;734;0;0;0;0;.00nan;0;0
27943;31165;752;0;0;0;0;.00nan;0;0
27943;44526;734;80;38;3;35;.921;3574000;0
27943;149221;752;88;30;1;29;.967;3600000;0
27944;-1;742;91;37;2;35;.946;3600000;0
27944;75362;745;46;38;6;32;.842;3600000;0
27944;85797;742;0;0;0;0;.00nan;0;0
27944;152624;745;0;0;0;0;.00nan;0;0
27945;595;732;90;37;2;35;.946;3600000;0
27945;203977;729;0;0;0;0;.00nan;0;0
27945;211604;729;96;51;3;48;.941;3581000;0
27945;88646;732;0;0;0;0;.00nan;0;0
27946;1957;1880;83;12;0;12;1.000;3600000;0
27946;3165;1880;0;0;0;0;.00nan;0;0
27946;178098;733;93;45;2;43;.956;3561000;0
27946;66245;733;0;0;0;0;.00nan;0;0
27947;49935;2168;50;34;5;29;.853;3594000;0
27947;56565;741;54;27;4;23;.852;3600000;0
27947;76405;2168;0;0;0;0;.00nan;0;0
27947;82273;741;0;0;0;0;.00nan;0;0
27948;3359;751;0;0;0;0;.00nan;0;0
27948;207184;740;0;0;0;0;.00nan;0;0
27948;86151;740;72;35;3;32;.914;3600000;0
27948;148788;751;99;20;0;20;1.000;3600000;0
27949;203977;729;75;31;2;29;.935;3688000;0
27949;211604;729;0;0;0;0;.00nan;0;0
27949;175764;734;0;0;0;0;.00nan;0;0
27949;44526;734;74;35;3;32;.914;3688000;0
27950;75362;745;54;34;5;29;.853;3600000;0
27950;85661;749;81;35;3;32;.914;3600000;0
27950;91742;749;0;0;0;0;.00nan;0;0
27950;152624;745;0;0;0;0;.00nan;0;0
27951;218546;748;61;33;4;29;.879;3900000;0
27951;-1;748;0;0;0;0;.00nan;0;0
27951;49935;2168;75;47;4;43;.915;3900000;0
27951;76405;2168;0;0;0;0;.00nan;0;0
27952;198736;3789;0;0;0;0;.00nan;0;0
27952;203977;729;0;0;0;0;.00nan;0;0
27952;211604;729;90;38;1;37;.974;3600000;0
27952;74734;3789;47;15;2;13;.867;3579000;0
27953;3435;739;96;36;2;34;.944;3600000;0
27953;-1;764;74;35;3;32;.914;3600000;0
27953;-1;764;0;0;0;0;.00nan;0;0
27953;148503;739;0;0;0;0;.00nan;0;0
27954;178098;733;89;38;3;35;.921;3587000;0
27954;56565;741;74;18;1;17;.944;3600000;0
27954;66245;733;0;0;0;0;.00nan;0;0
27954;82273;741;0;0;0;0;.00nan;0;0
27955;1957;1880;48;21;3;18;.857;3576000;0
27955;2643;736;79;25;1;24;.960;3600000;0
27955;3165;1880;0;0;0;0;.00nan;0;0
27955;201075;736;0;0;0;0;.00nan;0;0
27956;595;732;78;31;2;29;.935;3600000;0
27956;184158;738;65;40;4;36;.900;3577000;0
27956;-1;738;0;0;0;0;.00nan;0;0
27956;88646;732;0;0;0;0;.00nan;0;0
27957;175764;734;100;57;2;55;.965;3600000;0
27957;207184;740;0;0;0;0;.00nan;0;0
27957;44526;734;0;0;0;0;.00nan;0;0
27957;86151;740;68;33;3;30;.909;3600000;0
27958;56565;741;99;20;0;20;1.000;3600000;0
27958;75362;745;0;0;0;0;.00nan;0;0
27958;82273;741;0;0;0;0;.00nan;0;0
27958;152624;745;85;32;1;31;.969;3599000;0
27959;180177;747;76;35;3;32;.914;3564000;0
27959;-1;742;0;0;0;0;.00nan;0;0
27959;71565;747;0;0;0;0;.00nan;0;0
27959;85797;742;75;26;2;24;.923;3600000;0
27960;204272;737;0;0;0;0;.00nan;0;0
27960;184158;738;82;39;3;36;.923;3574000;0
27960;201947;737;99;32;1;31;.969;3600000;0
27960;-1;738;0;0;0;0;.00nan;0;0
27961;218546;748;0;0;0;0;.00nan;0;0
27961;-1;748;81;26;1;25;.962;3600000;0
27961;85661;749;0;0;0;0;.00nan;0;0
27961;91742;749;84;35;2;33;.943;3600000;0
27962;2643;736;98;38;2;36;.947;3900000;0
27962;201075;736;0;0;0;0;.00nan;0;0
27962;202516;743;0;0;0;0;.00nan;0;0
27962;87798;743;87;40;2;38;.950;3900000;0
27963;595;732;76;34;2;32;.941;3600000;0
27963;198736;3789;0;0;0;0;.00nan;0;0
27963;74734;3789;68;29;3;26;.897;3586000;0
27963;88646;732;0;0;0;0;.00nan;0;0
27964;3359;751;0;0;0;0;.00nan;0;0
27964;31165;752;39;21;5;16;.762;3776000;0
27964;148788;751;66;33;4;29;.879;3776000;0
27964;149221;752;0;0;0;0;.00nan;0;0
27965;3435;739;100;30;0;30;1.000;3600000;0
27965;207771;744;97;36;1;35;.972;3585000;0
27965;93324;744;0;0;0;0;.00nan;0;0
27965;148503;739;0;0;0;0;.00nan;0;0
27966;203977;729;0;0;0;0;.00nan;0;0
27966;211604;729;80;26;1;25;.962;3600000;0
27966;207184;740;0;0;0;0;.00nan;0;0
27966;86151;740;43;24;4;20;.833;3600000;0
27967;180177;747;0;0;0;0;.00nan;0;0
27967;-1;742;0;0;0;0;.00nan;0;0
27967;71565;747;81;15;0;15;1.000;3600000;0
27967;85797;742;92;36;1;35;.972;3548000;0
27968;1957;1880;63;29;4;25;.862;3900000;0
27968;3165;1880;0;0;0;0;.00nan;0;0
27968;178098;733;53;27;4;23;.852;3900000;0
27968;66245;733;0;0;0;0;.00nan;0;0
27969;3359;751;57;24;3;21;.875;3600000;0
27969;31165;752;0;0;0;0;.00nan;0;0
27969;148788;751;0;0;0;0;.00nan;0;0
27969;149221;752;79;47;4;43;.915;3595000;0
27970;-1;764;85;29;1;28;.966;3600000;0
27970;-1;764;0;0;0;0;.00nan;0;0
27970;75362;745;61;49;6;43;.878;3600000;0
27970;152624;745;0;0;0;0;.00nan;0;0
27971;3435;739;99;39;1;38;.974;3600000;0
27971;198736;3789;0;0;0;0;.00nan;0;0
27971;74734;3789;50;21;4;17;.810;3600000;0
27971;148503;739;0;0;0;0;.00nan;0;0
27972;204272;737;48;23;3;20;.870;3513000;0
27972;201947;737;0;0;0;0;.00nan;0;0
27972;202516;743;0;0;0;0;.00nan;0;0
27972;87798;743;100;43;1;42;.977;3600000;0
27973;184158;738;93;43;3;40;.930;3600000;0
27973;175764;734;0;0;0;0;.00nan;0;0
27973;44526;734;46;33;5;28;.848;3576000;0
27973;-1;738;0;0;0;0;.00nan;0;0
27974;49935;2168;70;25;2;23;.920;3600000;0
27974;56565;741;54;29;4;25;.862;3557000;0
27974;76405;2168;0;0;0;0;.00nan;0;0
27974;82273;741;0;0;0;0;.00nan;0;0
27975;2643;736;97;42;3;39;.929;3600000;0
27975;201075;736;0;0;0;0;.00nan;0;0
27975;85661;749;65;34;4;30;.882;3533000;0
27975;91742;749;0;0;0;0;.00nan;0;0
27976;207771;744;54;30;4;26;.867;3574000;0
27976;218546;748;88;43;3;40;.930;3600000;0
27976;-1;748;0;0;0;0;.00nan;0;0
27976;93324;744;0;0;0;0;.00nan;0;0
27977;3359;751;0;0;0;0;.00nan;0;0
27977;180177;747;0;0;0;0;.00nan;0;0
27977;71565;747;69;40;4;36;.900;3600000;0
27977;148788;751;86;26;1;25;.962;3600000;0
27978;1957;1880;98;38;2;36;.947;3900000;0
27978;3165;1880;0;0;0;0;.00nan;0;0
27978;178098;733;80;29;2;27;.931;3900000;0
27978;66245;733;0;0;0;0;.00nan;0;0
27979;31165;752;50;29;4;25;.862;3579000;0
27979;-1;742;0;0;0;0;.00nan;0;0
27979;85797;742;66;31;3;28;.903;3600000;0
27979;149221;752;0;0;0;0;.00nan;0;0
27980;218546;748;0;0;0;0;.00nan;0;0
27980;-1;764;100;32;0;32;1.000;3600000;0
27980;-1;748;54;18;2;16;.889;3519000;0
27980;-1;764;0;0;0;0;.00nan;0;0
27981;595;732;61;33;4;29;.879;3600000;0
27981;3435;739;0;0;0;0;.00nan;0;0
27981;88646;732;0;0;0;0;.00nan;0;0
27981;148503;739;100;37;0;37;1.000;3600000;0
27982;198736;3789;0;0;0;0;.00nan;0;0
27982;204272;737;0;0;0;0;.00nan;0;0
27982;201947;737;77;32;3;29;.906;3530000;0
27982;74734;3789;95;35;1;34;.971;3600000;0
27983;175764;734;0;0;0;0;.00nan;0;0
27983;44526;734;89;36;1;35;.972;3900000;0
27983;85661;749;88;19;1;18;.947;3900000;0
27983;91742;749;0;0;0;0;.00nan;0;0
27984;207184;740;0;0;0;0;.00nan;0;0
27984;75362;745;54;31;5;26;.839;3549000;0
27984;86151;740;78;41;3;38;.927;3600000;0
27984;152624;745;0;0;0;0;.00nan;0;0
27985;203977;729;0;0;0;0;.00nan;0;0
27985;211604;729;95;39;2;37;.949;3600000;0
27985;56565;741;74;28;3;25;.893;3544000;0
27985;82273;741;0;0;0;0;.00nan;0;0
27986;3359;751;70;38;4;34;.895;3900000;0
27986;180177;747;0;0;0;0;.00nan;0;0
27986;71565;747;50;27;4;23;.852;3900000;0
27986;148788;751;0;0;0;0;.00nan;0;0
27987;2643;736;85;45;3;42;.933;3586000;0
27987;178098;733;80;25;1;24;.960;3600000;0
27987;201075;736;0;0;0;0;.00nan;0;0
27987;66245;733;0;0;0;0;.00nan;0;0
27988;31165;752;0;0;0;0;.00nan;0;0
27988;-1;742;0;0;0;0;.00nan;0;0
27988;85797;742;100;32;0;32;1.000;3600000;0
27988;149221;752;76;33;3;30;.909;3600000;0
27989;1957;1880;97;51;3;48;.941;3900000;0
27989;3165;1880;0;0;0;0;.00nan;0;0
27989;207771;744;64;21;3;18;.857;3900000;0
27989;93324;744;0;0;0;0;.00nan;0;0
27990;595;732;100;36;2;34;.944;3892000;0
27990;184158;738;79;29;2;27;.931;3900000;0
27990;-1;738;0;0;0;0;.00nan;0;0
27990;88646;732;0;0;0;0;.00nan;0;0
27991;3435;739;0;0;0;0;.00nan;0;0
27991;85661;749;48;33;5;28;.848;3600000;0
27991;91742;749;0;0;0;0;.00nan;0;0
27991;148503;739;80;28;1;27;.964;3600000;0
27992;-1;764;94;20;0;20;1.000;3600000;0
27992;-1;764;0;0;0;0;.00nan;0;0
27992;75362;745;52;31;4;27;.871;3600000;0
27992;152624;745;0;0;0;0;.00nan;0;0
27993;207771;744;90;38;2;36;.947;3600000;0
27993;218546;748;47;21;4;17;.810;1847000;0
27993;-1;748;71;13;0;13;1.000;1737000;0
27993;93324;744;0;0;0;0;.00nan;0;0
27994;198736;3789;0;0;0;0;.00nan;0;0
27994;56565;741;64;51;6;45;.882;3562000;0
27994;74734;3789;62;32;4;28;.875;3600000;0
27994;82273;741;0;0;0;0;.00nan;0;0
27995;1957;1880;95;56;2;54;.964;3900000;0
27995;3165;1880;0;0;0;0;.00nan;0;0
27995;204272;737;76;30;2;28;.933;3900000;0
27995;201947;737;0;0;0;0;.00nan;0;0
27996;202516;743;0;0;0;0;.00nan;0;0
27996;49935;2168;0;0;0;0;.00nan;0;0
27996;76405;2168;81;35;3;32;.914;3589000;0
27996;87798;743;99;33;1;32;.970;3600000;0
27997;2643;736;84;45;3;42;.933;3600000;0
27997;203977;729;0;0;0;0;.00nan;0;0
27997;201075;736;0;0;0;0;.00nan;0;0
27997;211604;729;27;19;5;14;.737;3543000;0
27998;178098;733;68;46;6;40;.870;3600000;0
27998;207184;740;0;0;0;0;.00nan;0;0
27998;66245;733;0;0;0;0;.00nan;0;0
27998;86151;740;73;33;2;31;.939;3600000;0
27999;175764;734;0;0;0;0;.00nan;0;0
27999;44526;734;73;25;2;23;.920;3600000;0
27999;75362;745;58;43;6;37;.860;3600000;0
27999;152624;745;0;0;0;0;.00nan;0;0
28000;31165;752;65;35;4;31;.886;3600000;0
28000;85661;749;84;32;1;31;.969;2767000;0
28000;91742;749;20;11;4;7;.636;782000;0
28000;149221;752;0;0;0;0;.00nan;0;0
28001;202516;743;0;0;0;0;.00nan;0;0
28001;218546;748;43;31;5;26;.839;3600000;0
28001;-1;748;0;0;0;0;.00nan;0;0
28001;87798;743;80;26;2;24;.923;3600000;0
28002;3359;751;0;0;0;0;.00nan;0;0
28002;207771;744;68;37;4;33;.892;3900000;0
28002;93324;744;0;0;0;0;.00nan;0;0
28002;148788;751;47;32;4;28;.875;3900000;0
28003;184158;738;64;25;2;23;.920;3600000;0
28003;-1;738;0;0;0;0;.00nan;0;0
28003;49935;2168;82;37;3;34;.919;3551000;0
28003;76405;2168;0;0;0;0;.00nan;0;0
28004;3435;739;68;37;4;33;.892;3900000;0
28004;203977;729;0;0;0;0;.00nan;0;0
28004;211604;729;79;41;4;37;.902;3900000;0
28004;148503;739;0;0;0;0;.00nan;0;0
28005;180177;747;0;0;0;0;.00nan;0;0
28005;-1;764;99;39;1;38;.974;3600000;0
28005;-1;764;0;0;0;0;.00nan;0;0
28005;71565;747;63;24;2;22;.917;3558000;0
28006;595;732;69;21;2;19;.905;3600000;0
28006;-1;742;0;0;0;0;.00nan;0;0
28006;85797;742;79;43;3;40;.930;3577000;0
28006;88646;732;0;0;0;0;.00nan;0;0
28007;2643;736;58;43;5;38;.884;3600000;0
28007;198736;3789;0;0;0;0;.00nan;0;0
28007;201075;736;0;0;0;0;.00nan;0;0
28007;74734;3789;89;25;1;24;.960;3600000;0
28008;175764;734;0;0;0;0;.00nan;0;0
28008;44526;734;96;42;2;40;.952;3600000;0
28008;56565;741;53;28;4;24;.857;3527000;0
28008;82273;741;0;0;0;0;.00nan;0;0
28009;1957;1880;74;25;2;23;.920;3600000;0
28009;3165;1880;0;0;0;0;.00nan;0;0
28009;204272;737;52;34;4;30;.882;3586000;0
28009;201947;737;0;0;0;0;.00nan;0;0
28010;180177;747;57;24;3;21;.875;3600000;0
28010;71565;747;0;0;0;0;.00nan;0;0
28010;75362;745;0;0;0;0;.00nan;0;0
28010;152624;745;87;56;4;52;.929;3582000;0
28011;3359;751;80;21;1;20;.952;3900000;0
28011;202516;743;0;0;0;0;.00nan;0;0
28011;87798;743;97;51;1;50;.980;3900000;0
28011;148788;751;0;0;0;0;.00nan;0;0
28012;3435;739;79;30;2;28;.933;3600000;0
28012;31165;752;0;0;0;0;.00nan;0;0
28012;148503;739;0;0;0;0;.00nan;0;0
28012;149221;752;37;30;5;25;.833;3600000;0
28013;595;732;85;27;1;26;.963;3600000;0
28013;-1;764;62;39;4;35;.897;3600000;0
28013;-1;764;0;0;0;0;.00nan;0;0
28013;88646;732;0;0;0;0;.00nan;0;0
28014;178098;733;73;46;5;41;.891;3600000;0
28014;184158;738;84;25;1;24;.960;3600000;0
28014;-1;738;0;0;0;0;.00nan;0;0
28014;66245;733;0;0;0;0;.00nan;0;0
28015;49935;2168;100;29;0;29;1.000;3600000;0
28015;76405;2168;0;0;0;0;.00nan;0;0
28015;85661;749;44;33;6;27;.818;3600000;0
28015;91742;749;0;0;0;0;.00nan;0;0
28016;203977;729;77;27;1;26;.963;2458000;0
28016;211604;729;33;19;4;15;.789;1142000;0
28016;207184;740;0;0;0;0;.00nan;0;0
28016;86151;740;100;28;0;28;1.000;3600000;0
28017;218546;748;0;0;0;0;.00nan;0;0
28017;-1;742;0;0;0;0;.00nan;0;0
28017;-1;748;47;23;4;19;.826;3543000;0
28017;85797;742;99;40;2;38;.950;3600000;0
28018;2643;736;72;35;3;32;.914;3879000;0
28018;204272;737;0;0;0;0;.00nan;0;0
28018;201075;736;0;0;0;0;.00nan;0;0
28018;201947;737;77;34;3;31;.912;3900000;0
28019;1957;1880;68;41;5;36;.878;3900000;0
28019;3165;1880;0;0;0;0;.00nan;0;0
28019;56565;741;44;34;5;29;.853;3900000;0
28019;82273;741;0;0;0;0;.00nan;0;0
28020;175764;734;0;0;0;0;.00nan;0;0
28020;207771;744;0;0;0;0;.00nan;0;0
28020;44526;734;84;31;2;29;.935;3600000;0
28020;93324;744;59;27;3;24;.889;3553000;0
28021;31165;752;61;18;1;17;.944;3600000;0
28021;75362;745;64;30;3;27;.900;3516000;0
28021;149221;752;0;0;0;0;.00nan;0;0
28021;152624;745;0;0;0;0;.00nan;0;0
28022;3359;751;0;0;0;0;.00nan;0;0
28022;49935;2168;96;45;2;43;.956;3557000;0
28022;76405;2168;0;0;0;0;.00nan;0;0
28022;148788;751;100;28;0;28;1.000;3600000;0
28023;3435;739;84;16;0;16;1.000;3600000;0
28023;184158;738;62;41;4;37;.902;3600000;0
28023;-1;738;0;0;0;0;.00nan;0;0
28023;148503;739;0;0;0;0;.00nan;0;0
28024;595;732;80;39;3;36;.923;3517000;0
28024;204272;737;90;31;1;30;.968;3600000;0
28024;201947;737;0;0;0;0;.00nan;0;0
28024;88646;732;0;0;0;0;.00nan;0;0
28025;218546;748;57;20;2;18;.900;3600000;0
28025;-1;764;82;27;1;26;.963;3600000;0
28025;-1;748;0;0;0;0;.00nan;0;0
28025;-1;764;0;0;0;0;.00nan;0;0
28026;178098;733;94;48;4;44;.917;3600000;0
28026;202516;743;0;0;0;0;.00nan;0;0
28026;66245;733;0;0;0;0;.00nan;0;0
28026;87798;743;54;18;3;15;.833;3600000;0
28027;203977;729;0;0;0;0;.00nan;0;0
28027;211604;729;100;49;2;47;.959;3600000;0
28027;85661;749;71;32;4;28;.875;3530000;0
28027;91742;749;0;0;0;0;.00nan;0;0
28028;198736;3789;0;0;0;0;.00nan;0;0
28028;207184;740;0;0;0;0;.00nan;0;0
28028;74734;3789;62;29;3;26;.897;3600000;0
28028;86151;740;70;39;4;35;.897;3600000;0
28029;180177;747;0;0;0;0;.00nan;0;0
28029;-1;742;0;0;0;0;.00nan;0;0
28029;71565;747;62;34;4;30;.882;3600000;0
28029;85797;742;33;25;5;20;.800;3585000;0
28031;178098;733;98;31;1;30;.968;3600000;0
28031;206313;745;48;29;4;25;.862;3600000;0
28031;202104;745;0;0;0;0;.00nan;0;0
28031;66245;733;0;0;0;0;.00nan;0;0
28033;2643;736;95;32;1;31;.969;3900000;0
28033;56565;741;77;27;1;26;.963;3900000;0
28033;74734;736;0;0;0;0;.00nan;0;0
28033;82273;741;0;0;0;0;.00nan;0;0
28035;1957;738;0;0;0;0;.00nan;0;0
28035;184158;738;66;17;1;16;.941;3600000;0
28035;-1;3789;0;0;0;0;.00nan;0;0
28035;91742;3789;85;37;2;35;.946;3565000;0
28037;196698;744;47;26;4;22;.846;3600000;0
28037;207771;744;0;0;0;0;.00nan;0;0
28037;49935;2168;30;34;6;28;.824;2478000;0
28037;76405;2168;42;9;2;7;.778;1122000;0
28039;359;740;62;28;3;25;.893;3588000;0
28039;175764;747;0;0;0;0;.00nan;0;0
28039;180177;747;98;39;1;38;.974;3600000;0
28039;207184;740;0;0;0;0;.00nan;0;0
28041;2195;748;69;33;4;29;.879;3600000;0
28041;203533;748;0;0;0;0;.00nan;0;0
28041;-1;742;0;0;0;0;.00nan;0;0
28041;85797;742;99;34;1;33;.971;3600000;0
28043;3359;751;0;0;0;0;.00nan;0;0
28043;31165;752;0;0;0;0;.00nan;0;0
28043;148788;751;78;31;1;30;.968;3600000;0
28043;149221;752;47;39;6;33;.846;3600000;0
28045;595;732;79;29;2;27;.931;3600000;0
28045;3165;1880;11;23;7;16;.696;2429000;0
28045;8505;732;0;0;0;0;.00nan;0;0
28045;148503;1880;46;18;3;15;.833;1171000;0
28047;195887;743;50;40;6;34;.850;3600000;0
28047;202516;743;0;0;0;0;.00nan;0;0
28047;44526;734;88;30;1;29;.967;3600000;0
28047;-1;734;0;0;0;0;.00nan;0;0
28049;203977;729;0;0;0;0;.00nan;0;0
28049;204272;737;74;30;2;28;.933;3591000;0
28049;211604;729;100;27;0;27;1.000;3600000;0
28049;201947;737;0;0;0;0;.00nan;0;0
28051;3435;739;60;34;4;30;.882;3584000;0
28051;198736;749;0;0;0;0;.00nan;0;0
28051;85661;749;91;43;3;40;.930;3600000;0
28051;152624;739;0;0;0;0;.00nan;0;0
28053;359;740;79;40;3;37;.925;3572000;0
28053;204272;737;0;0;0;0;.00nan;0;0
28053;201947;737;87;42;2;40;.952;3600000;0
28053;207184;740;0;0;0;0;.00nan;0;0
28055;178098;733;59;33;4;29;.879;3600000;0
28055;196698;744;0;0;0;0;.00nan;0;0
28055;207771;744;77;34;3;31;.912;3600000;0
28055;66245;733;0;0;0;0;.00nan;0;0
28057;175764;747;81;39;3;36;.923;3600000;0
28057;31165;752;0;0;0;0;.00nan;0;0
28057;180177;747;0;0;0;0;.00nan;0;0
28057;149221;752;51;30;4;26;.867;3543000;0
28059;3165;1880;0;0;0;0;.00nan;0;0
28059;-1;764;69;31;3;28;.903;3569000;0
28059;-1;764;0;0;0;0;.00nan;0;0
28059;148503;1880;97;31;1;30;.968;3600000;0
28061;198736;749;0;0;0;0;.00nan;0;0
28061;203977;729;0;0;0;0;.00nan;0;0
28061;211604;729;93;37;1;36;.973;3600000;0
28061;85661;749;70;36;3;33;.917;3548000;0
28063;3359;751;0;0;0;0;.00nan;0;0
28063;56565;741;93;20;0;20;1.000;3600000;0
28063;82273;741;0;0;0;0;.00nan;0;0
28063;148788;751;42;29;5;24;.828;3600000;0
28065;195887;743;0;0;0;0;.00nan;0;0
28065;202516;743;46;34;5;29;.853;3600000;0
28065;44526;734;94;34;2;32;.941;3600000;0
28065;-1;734;0;0;0;0;.00nan;0;0
28067;595;732;84;35;2;33;.943;3600000;0
28067;8505;732;0;0;0;0;.00nan;0;0
28067;49935;2168;53;31;4;27;.871;3520000;0
28067;76405;2168;0;0;0;0;.00nan;0;0
28069;2643;736;81;49;4;45;.918;3600000;0
28069;206313;745;83;26;1;25;.962;3600000;0
28069;202104;745;0;0;0;0;.00nan;0;0
28069;74734;736;0;0;0;0;.00nan;0;0
28071;3435;739;89;53;4;49;.925;3600000;0
28071;-1;742;0;0;0;0;.00nan;0;0
28071;85797;742;56;13;1;12;.923;3600000;0
28071;152624;739;0;0;0;0;.00nan;0;0
28073;2195;748;71;34;3;31;.912;3582000;0
28073;203533;748;0;0;0;0;.00nan;0;0
28073;-1;3789;0;0;0;0;.00nan;0;0
28073;91742;3789;92;31;2;29;.935;3600000;0
28075;204272;737;56;46;6;40;.870;3600000;0
28075;31165;752;76;20;1;19;.950;3600000;0
28075;201947;737;0;0;0;0;.00nan;0;0
28075;149221;752;0;0;0;0;.00nan;0;0
28077;359;740;0;0;0;0;.00nan;0;0
28077;207184;740;71;36;4;32;.889;3544000;0
28077;-1;3789;0;0;0;0;.00nan;0;0
28077;91742;3789;68;29;3;26;.897;3600000;0
28079;2643;736;0;0;0;0;.00nan;0;0
28079;56565;741;58;15;1;14;.933;3600000;0
28079;74734;736;86;47;4;43;.915;3600000;0
28079;82273;741;0;0;0;0;.00nan;0;0
28081;1957;738;0;0;0;0;.00nan;0;0
28081;2195;748;0;0;0;0;.00nan;0;0
28081;203533;748;91;32;2;30;.938;3600000;0
28081;184158;738;76;39;3;36;.923;3558000;0
28083;3165;1880;91;29;1;28;.966;3600000;0
28083;196698;744;81;33;2;31;.939;3600000;0
28083;207771;744;0;0;0;0;.00nan;0;0
28083;148503;1880;0;0;0;0;.00nan;0;0
28085;595;732;94;36;1;35;.972;3600000;0
28085;8505;732;0;0;0;0;.00nan;0;0
28085;178098;733;0;0;0;0;.00nan;0;0
28085;66245;733;82;34;2;32;.941;3565000;0
28087;198736;749;91;44;2;42;.955;3600000;0
28087;175764;747;0;0;0;0;.00nan;0;0
28087;180177;747;37;37;6;31;.838;3600000;0
28087;85661;749;0;0;0;0;.00nan;0;0
28089;203977;729;75;48;5;43;.896;3731000;0
28089;211604;729;0;0;0;0;.00nan;0;0
28089;-1;742;89;43;4;39;.907;3731000;0
28089;85797;742;0;0;0;0;.00nan;0;0
28091;3359;751;68;27;2;25;.926;3900000;0
28091;-1;764;0;0;0;0;.00nan;0;0
28091;-1;764;70;30;2;28;.933;3900000;0
28091;148788;751;0;0;0;0;.00nan;0;0
28093;3435;739;61;20;2;18;.900;3673000;0
28093;49935;2168;0;0;0;0;.00nan;0;0
28093;76405;2168;43;30;5;25;.833;3900000;0
28093;152624;739;24;8;3;5;.625;227000;0
28095;195887;743;24;5;3;2;.400;458000;0
28095;202516;743;60;30;3;27;.900;3142000;0
28095;44526;734;0;0;0;0;.00nan;0;0
28095;-1;734;67;33;3;30;.909;3600000;0
28097;3165;1880;0;0;0;0;.00nan;0;0
28097;198736;749;0;0;0;0;.00nan;0;0
28097;85661;749;87;36;1;35;.972;3900000;0
28097;148503;1880;74;20;1;19;.950;3900000;0
28099;3359;751;0;0;0;0;.00nan;0;0
28099;49935;2168;74;35;3;32;.914;3580000;0
28099;76405;2168;0;0;0;0;.00nan;0;0
28099;148788;751;73;26;1;25;.962;3600000;0
28101;204272;737;71;33;3;30;.909;3600000;0
28101;201947;737;0;0;0;0;.00nan;0;0
28101;-1;742;0;0;0;0;.00nan;0;0
28101;85797;742;60;34;4;30;.882;3564000;0
28103;2643;736;0;0;0;0;.00nan;0;0
28103;178098;733;91;15;0;15;1.000;3600000;0
28103;66245;733;0;0;0;0;.00nan;0;0
28103;74734;736;90;31;1;30;.968;3583000;0
28105;31165;752;0;0;0;0;.00nan;0;0
28105;44526;734;83;33;2;31;.939;3560000;0
28105;-1;734;0;0;0;0;.00nan;0;0
28105;149221;752;85;31;1;30;.968;3600000;0
28107;203977;729;0;0;0;0;.00nan;0;0
28107;211604;729;91;43;3;40;.930;3600000;0
28107;196698;744;64;9;0;9;1.000;775000;0
28107;207771;744;25;28;6;22;.786;2825000;0
28109;2195;748;82;27;1;26;.963;3600000;0
28109;203533;748;0;0;0;0;.00nan;0;0
28109;195887;743;56;32;4;28;.875;3600000;0
28109;202516;743;0;0;0;0;.00nan;0;0
28111;359;740;26;19;5;14;.737;1069000;0
28111;207184;740;64;37;4;33;.892;2531000;0
28111;-1;764;79;25;1;24;.960;3600000;0
28111;-1;764;0;0;0;0;.00nan;0;0
28113;3435;739;66;30;3;27;.900;3600000;0
28113;206313;745;0;0;0;0;.00nan;0;0
28113;202104;745;91;33;1;32;.970;3600000;0
28113;152624;739;0;0;0;0;.00nan;0;0
28115;595;732;97;41;1;40;.976;3600000;0
28115;8505;732;0;0;0;0;.00nan;0;0
28115;56565;741;0;0;0;0;.00nan;0;0
28115;82273;741;72;26;2;24;.923;3545000;0
28117;1957;738;0;0;0;0;.00nan;0;0
28117;184158;738;50;23;3;20;.870;3545000;0
28117;-1;3789;0;0;0;0;.00nan;0;0
28117;91742;3789;92;37;2;35;.946;3600000;0
28119;44526;734;0;0;0;0;.00nan;0;0
28119;-1;764;0;0;0;0;.00nan;0;0
28119;-1;734;43;33;5;28;.848;3600000;0
28119;-1;764;88;34;1;33;.971;3600000;0
28121;1957;738;74;23;1;22;.957;3600000;0
28121;184158;738;0;0;0;0;.00nan;0;0
28121;56565;741;61;33;3;30;.909;3600000;0
28121;82273;741;0;0;0;0;.00nan;0;0
28123;178098;733;56;29;5;24;.828;3600000;0
28123;206313;745;91;29;1;28;.966;3600000;0
28123;202104;745;0;0;0;0;.00nan;0;0
28123;66245;733;0;0;0;0;.00nan;0;0
28125;204272;737;0;0;0;0;.00nan;0;0
28125;175764;747;71;25;2;23;.920;3600000;0
28125;180177;747;0;0;0;0;.00nan;0;0
28125;201947;737;73;33;3;30;.909;3552000;0
28127;3435;739;0;0;0;0;.00nan;0;0
28127;-1;3789;0;0;0;0;.00nan;0;0
28127;91742;3789;93;26;0;26;1.000;3600000;0
28127;152624;739;47;35;5;30;.857;3600000;0
28129;359;740;100;42;0;42;1.000;3600000;0
28129;595;732;44;11;2;9;.818;3535000;0
28129;8505;732;0;0;0;0;.00nan;0;0
28129;207184;740;0;0;0;0;.00nan;0;0
28131;198736;749;76;45;4;41;.911;2126000;0
28131;196698;744;21;14;5;9;.643;3600000;0
28131;207771;744;0;0;0;0;.00nan;0;0
28131;85661;749;24;24;6;18;.750;1474000;0
28133;2195;748;0;0;0;0;.00nan;0;0
28133;203533;748;72;31;3;28;.903;3600000;0
28133;-1;742;56;37;5;32;.865;3583000;0
28133;85797;742;0;0;0;0;.00nan;0;0
28135;2643;736;85;46;4;42;.913;3780000;0
28135;195887;743;0;0;0;0;.00nan;0;0
28135;202516;743;39;15;3;12;.800;3780000;0
28135;74734;736;0;0;0;0;.00nan;0;0
28137;3165;1880;25;20;6;14;.700;1977000;0
28137;31165;752;55;23;3;20;.870;3600000;0
28137;148503;1880;40;17;3;14;.824;1623000;0
28137;149221;752;0;0;0;0;.00nan;0;0
28139;203977;729;86;31;1;30;.968;3600000;0
28139;211604;729;0;0;0;0;.00nan;0;0
28139;49935;2168;0;0;0;0;.00nan;0;0
28139;76405;2168;95;41;2;39;.951;3589000;0
28141;2643;736;0;0;0;0;.00nan;0;0
28141;204272;737;27;13;4;9;.692;1778000;0
28141;201947;737;74;17;1;16;.941;2005000;0
28141;74734;736;49;25;4;21;.840;3783000;0
28143;595;732;77;33;3;30;.909;3551000;0
28143;1957;738;0;0;0;0;.00nan;0;0
28143;8505;732;0;0;0;0;.00nan;0;0
28143;184158;738;79;31;2;29;.935;3600000;0
28145;2195;748;83;25;1;24;.960;3600000;0
28145;203533;748;0;0;0;0;.00nan;0;0
28145;-1;742;0;0;0;0;.00nan;0;0
28145;85797;742;75;27;2;25;.926;3573000;0
28147;3359;751;0;0;0;0;.00nan;0;0
28147;175764;747;0;0;0;0;.00nan;0;0
28147;180177;747;35;40;7;33;.825;3600000;0
28147;148788;751;76;33;2;31;.939;3600000;0
28149;-1;764;75;26;1;25;.962;3600000;0
28149;-1;764;0;0;0;0;.00nan;0;0
28149;56565;741;0;0;0;0;.00nan;0;0
28149;82273;741;75;33;3;30;.909;3532000;0
28151;44526;734;49;21;3;18;.857;3543000;0
28151;-1;734;0;0;0;0;.00nan;0;0
28151;49935;2168;79;28;2;26;.929;3600000;0
28151;76405;2168;0;0;0;0;.00nan;0;0
28153;198736;749;0;0;0;0;.00nan;0;0
28153;195887;743;45;24;5;19;.792;3600000;0
28153;202516;743;0;0;0;0;.00nan;0;0
28153;85661;749;100;47;0;47;1.000;3600000;0
28155;3165;1880;0;0;0;0;.00nan;0;0
28155;206313;745;89;30;1;29;.967;3600000;0
28155;202104;745;0;0;0;0;.00nan;0;0
28155;148503;1880;57;25;3;22;.880;3600000;0
28157;203977;729;0;0;0;0;.00nan;0;0
28157;211604;729;81;43;3;40;.930;3900000;0
28157;196698;744;0;0;0;0;.00nan;0;0
28157;207771;744;68;30;3;27;.900;3900000;0
28159;359;740;35;13;3;10;.769;399000;0
28159;31165;752;0;0;0;0;.00nan;0;0
28159;207184;740;98;32;0;32;1.000;3201000;0
28159;149221;752;54;15;2;13;.867;3600000;0
28161;178098;733;96;32;1;31;.969;3600000;0
28161;-1;3789;0;0;0;0;.00nan;0;0
28161;66245;733;0;0;0;0;.00nan;0;0
28161;91742;3789;98;42;2;40;.952;3551000;0
28163;2643;736;100;39;1;38;.974;3600000;0
28163;31165;752;40;14;3;11;.786;3528000;0
28163;74734;736;0;0;0;0;.00nan;0;0
28163;149221;752;0;0;0;0;.00nan;0;0
28165;195887;743;0;0;0;0;.00nan;0;0
28165;202516;743;67;29;2;27;.931;3600000;0
28165;-1;3789;0;0;0;0;.00nan;0;0
28165;91742;3789;77;37;3;34;.919;3556000;0
28167;44526;734;0;0;0;0;.00nan;0;0
28167;-1;742;55;24;3;21;.875;3600000;0
28167;-1;734;55;47;6;41;.872;3600000;0
28167;85797;742;0;0;0;0;.00nan;0;0
28169;2195;748;0;0;0;0;.00nan;0;0
28169;203533;748;54;34;4;30;.882;3600000;0
28169;196698;744;85;31;1;30;.968;3600000;0
28169;207771;744;0;0;0;0;.00nan;0;0
28171;3359;751;100;28;0;28;1.000;3600000;0
28171;178098;733;0;0;0;0;.00nan;0;0
28171;66245;733;84;48;3;45;.938;3600000;0
28171;148788;751;0;0;0;0;.00nan;0;0
28173;359;740;96;32;1;31;.969;3600000;0
28173;207184;740;0;0;0;0;.00nan;0;0
28173;-1;764;0;0;0;0;.00nan;0;0
28173;-1;764;55;24;3;21;.875;3521000;0
28175;595;732;83;30;2;28;.933;3600000;0
28175;8505;732;0;0;0;0;.00nan;0;0
28175;204272;737;64;44;5;39;.886;3600000;0
28175;201947;737;0;0;0;0;.00nan;0;0
28177;203977;729;91;33;1;32;.970;3600000;0
28177;211604;729;0;0;0;0;.00nan;0;0
28177;175764;747;53;32;4;28;.875;3600000;0
28177;180177;747;0;0;0;0;.00nan;0;0
28179;3165;1880;66;28;2;26;.929;3543000;0
28179;49935;2168;0;0;0;0;.00nan;0;0
28179;76405;2168;93;33;1;32;.970;3600000;0
28179;148503;1880;0;0;0;0;.00nan;0;0
28181;198736;749;0;0;0;0;.00nan;0;0
28181;56565;741;63;15;1;14;.933;3600000;0
28181;82273;741;0;0;0;0;.00nan;0;0
28181;85661;749;74;40;3;37;.925;3600000;0
28183;3435;739;79;22;1;21;.955;3600000;0
28183;206313;745;0;0;0;0;.00nan;0;0
28183;202104;745;91;58;5;53;.914;3600000;0
28183;152624;739;0;0;0;0;.00nan;0;0
889;595;732;70;25;2;23;.920;3600000;0
889;175764;734;0;0;0;0;.00nan;0;0
889;44526;734;47;33;5;28;.848;3600000;0
889;88646;732;0;0;0;0;.00nan;0;0
890;3435;739;51;20;3;17;.850;3560000;0
890;178098;733;75;27;2;25;.926;3600000;0
890;66245;733;0;0;0;0;.00nan;0;0
890;148503;739;0;0;0;0;.00nan;0;0
891;1957;1880;71;32;3;29;.906;3576000;0
891;3165;1880;0;0;0;0;.00nan;0;0
891;204272;737;0;0;0;0;.00nan;0;0
891;201947;737;79;27;1;26;.963;3600000;0
892;198736;3789;0;0;0;0;.00nan;0;0
892;184158;738;100;27;0;27;1.000;3600000;0
892;-1;738;0;0;0;0;.00nan;0;0
892;74734;3789;65;26;2;24;.923;3537000;0
893;207771;744;77;29;2;27;.931;4044000;0
893;85661;749;91;46;3;43;.935;4044000;0
893;91742;749;0;0;0;0;.00nan;0;0
893;93324;744;0;0;0;0;.00nan;0;0
894;218546;748;54;18;2;16;.889;3600000;0
894;-1;748;0;0;0;0;.00nan;0;0
894;56565;741;79;45;3;42;.933;3569000;0
894;82273;741;0;0;0;0;.00nan;0;0
895;203533;751;0;0;0;0;.00nan;0;0
895;202516;743;0;0;0;0;.00nan;0;0
895;87798;743;97;52;3;49;.942;3600000;0
895;148788;751;72;24;1;23;.958;3600000;0
896;-1;764;77;41;3;38;.927;3530000;0
896;-1;742;0;0;0;0;.00nan;0;0
896;-1;764;0;0;0;0;.00nan;0;0
896;85797;742;90;28;1;27;.964;3600000;0
897;595;732;92;30;1;29;.967;3600000;0
897;175764;734;0;0;0;0;.00nan;0;0
897;44526;734;75;47;5;42;.894;3600000;0
897;88646;732;0;0;0;0;.00nan;0;0
898;3435;739;100;35;0;35;1.000;3600000;0
898;178098;733;60;38;5;33;.868;3600000;0
898;66245;733;0;0;0;0;.00nan;0;0
898;148503;739;0;0;0;0;.00nan;0;0
899;1957;1880;93;37;1;36;.973;3600000;0
899;3165;1880;0;0;0;0;.00nan;0;0
899;204272;737;0;0;0;0;.00nan;0;0
899;201947;737;66;30;2;28;.933;3569000;0
900;198736;3789;0;0;0;0;.00nan;0;0
900;184158;738;76;29;3;26;.897;3587000;0
900;-1;738;0;0;0;0;.00nan;0;0
900;74734;3789;74;28;2;26;.929;3600000;0
901;207771;744;55;31;4;27;.871;3820000;0
901;85661;749;81;50;5;45;.900;3815000;0
901;91742;749;0;0;0;0;.00nan;0;0
901;93324;744;0;0;0;0;.00nan;0;0
902;218546;748;62;29;3;26;.897;3600000;0
902;-1;748;0;0;0;0;.00nan;0;0
902;56565;741;63;44;6;38;.864;2842000;0
902;82273;741;54;11;1;10;.909;758000;0
903;203533;751;0;0;0;0;.00nan;0;0
903;202516;743;0;0;0;0;.00nan;0;0
903;87798;743;85;38;1;37;.974;5751000;0
903;148788;751;92;58;2;56;.966;5751000;0
904;-1;764;81;37;4;33;.892;3600000;0
904;-1;742;0;0;0;0;.00nan;0;0
904;-1;764;0;0;0;0;.00nan;0;0
904;85797;742;27;26;6;20;.769;3584000;0
905;595;732;75;22;1;21;.955;3548000;0
905;175764;734;0;0;0;0;.00nan;0;0
905;44526;734;100;45;0;45;1.000;3600000;0
905;88646;732;0;0;0;0;.00nan;0;0
906;3435;739;75;20;1;19;.950;3600000;0
906;178098;733;59;31;4;27;.871;3600000;0
906;66245;733;0;0;0;0;.00nan;0;0
906;148503;739;0;0;0;0;.00nan;0;0
907;1957;1880;29;25;6;19;.760;2790000;0
907;3165;1880;39;9;2;7;.778;810000;0
907;204272;737;0;0;0;0;.00nan;0;0
907;201947;737;100;24;0;24;1.000;3600000;0
908;198736;3789;0;0;0;0;.00nan;0;0
908;184158;738;48;27;4;23;.852;3587000;0
908;-1;738;0;0;0;0;.00nan;0;0
908;74734;3789;77;24;2;22;.917;3600000;0
909;207771;744;97;24;0;24;1.000;3600000;0
909;85661;749;74;37;3;34;.919;3600000;0
909;91742;749;0;0;0;0;.00nan;0;0
909;93324;744;0;0;0;0;.00nan;0;0
910;218546;748;61;25;3;22;.880;3923000;0
910;-1;748;0;0;0;0;.00nan;0;0
910;56565;741;81;31;2;29;.935;3923000;0
910;82273;741;0;0;0;0;.00nan;0;0
911;203533;751;0;0;0;0;.00nan;0;0
911;202516;743;62;17;1;16;.941;1306000;0
911;87798;743;40;29;5;24;.828;2294000;0
911;148788;751;64;29;3;26;.897;3600000;0
912;-1;764;69;35;3;32;.914;3600000;0
912;-1;742;0;0;0;0;.00nan;0;0
912;-1;764;0;0;0;0;.00nan;0;0
912;85797;742;69;32;2;30;.938;3600000;0
913;595;732;61;20;2;18;.900;3875000;0
913;175764;734;0;0;0;0;.00nan;0;0
913;44526;734;99;48;1;47;.979;3875000;0
913;88646;732;0;0;0;0;.00nan;0;0
914;3435;739;78;37;3;34;.919;3858000;0
914;178098;733;71;36;4;32;.889;3858000;0
914;66245;733;0;0;0;0;.00nan;0;0
914;148503;739;0;0;0;0;.00nan;0;0
915;1957;1880;61;35;4;31;.886;3519000;0
915;3165;1880;0;0;0;0;.00nan;0;0
915;204272;737;0;0;0;0;.00nan;0;0
915;201947;737;90;32;2;30;.938;3600000;0
916;198736;3789;0;0;0;0;.00nan;0;0
916;184158;738;98;42;3;39;.929;3565000;0
916;-1;738;0;0;0;0;.00nan;0;0
916;74734;3789;87;40;2;38;.950;3600000;0
917;207771;744;86;18;0;18;1.000;3600000;0
917;85661;749;62;27;2;25;.926;3578000;0
917;91742;749;0;0;0;0;.00nan;0;0
917;93324;744;0;0;0;0;.00nan;0;0
918;218546;748;66;27;2;25;.926;3600000;0
918;-1;748;0;0;0;0;.00nan;0;0
918;56565;741;72;37;3;34;.919;3542000;0
918;82273;741;0;0;0;0;.00nan;0;0
919;203533;751;0;0;0;0;.00nan;0;0
919;202516;743;0;0;0;0;.00nan;0;0
919;87798;743;54;35;5;30;.857;3600000;0
919;148788;751;100;17;0;17;1.000;3600000;0
920;-1;764;28;18;4;14;.778;2228000;0
920;-1;742;0;0;0;0;.00nan;0;0
920;-1;764;58;9;0;9;1.000;1372000;0
920;85797;742;77;24;1;23;.958;3600000;0
1147;595;732;58;32;4;28;.875;3565000;0
1147;175764;734;0;0;0;0;.00nan;0;0
1147;44526;734;97;35;2;33;.943;3600000;0
1147;88646;732;0;0;0;0;.00nan;0;0
1148;3435;739;56;31;4;27;.871;3600000;0
1148;178098;733;64;41;5;36;.878;3600000;0
1148;66245;733;0;0;0;0;.00nan;0;0
1148;148503;739;0;0;0;0;.00nan;0;0
1149;1957;1880;100;37;1;36;.973;3600000;0
1149;3165;1880;0;0;0;0;.00nan;0;0
1149;204272;737;0;0;0;0;.00nan;0;0
1149;201947;737;25;13;4;9;.692;3600000;0
1150;198736;3789;0;0;0;0;.00nan;0;0
1150;184158;738;99;43;1;42;.977;3600000;0
1150;-1;738;0;0;0;0;.00nan;0;0
1150;74734;3789;96;42;2;40;.952;3589000;0
1151;218546;748;80;28;2;26;.929;3600000;0
1151;-1;748;0;0;0;0;.00nan;0;0
1151;56565;741;71;38;4;34;.895;3570000;0
1151;82273;741;0;0;0;0;.00nan;0;0
1152;203533;751;0;0;0;0;.00nan;0;0
1152;202516;743;0;0;0;0;.00nan;0;0
1152;87798;743;76;40;3;37;.925;5409000;0
1152;148788;751;70;46;4;42;.913;5409000;0
1153;-1;764;64;32;3;29;.906;3557000;0
1153;-1;742;0;0;0;0;.00nan;0;0
1153;-1;764;0;0;0;0;.00nan;0;0
1153;85797;742;91;36;2;34;.944;3600000;0
1206;595;732;43;22;4;18;.818;3600000;0
1206;175764;734;0;0;0;0;.00nan;0;0
1206;44526;734;95;32;1;31;.969;3600000;0
1206;88646;732;0;0;0;0;.00nan;0;0
1207;1957;1880;80;40;3;37;.925;3750000;0
1207;3165;1880;0;0;0;0;.00nan;0;0
1207;204272;737;0;0;0;0;.00nan;0;0
1207;201947;737;55;31;4;27;.871;3750000;0
1208;198736;3789;0;0;0;0;.00nan;0;0
1208;184158;738;57;42;6;36;.857;3196000;0
1208;-1;738;41;2;1;1;.500;404000;0
1208;74734;3789;90;33;2;31;.939;3600000;0
1209;203533;751;0;0;0;0;.00nan;0;0
1209;202516;743;0;0;0;0;.00nan;0;0
1209;87798;743;59;28;3;25;.893;3600000;0
1209;148788;751;69;47;5;42;.894;3600000;0
1321;1957;1880;60;49;5;44;.898;3600000;0
1321;3165;1880;0;0;0;0;.00nan;0;0
1321;204272;737;0;0;0;0;.00nan;0;0
1321;201947;737;77;30;2;28;.933;3600000;0
1322;203533;751;0;0;0;0;.00nan;0;0
1322;202516;743;0;0;0;0;.00nan;0;0
1322;87798;743;80;36;3;33;.917;3835000;0
1322;148788;751;86;37;2;35;.946;3835000;0
1368;3435;739;78;47;4;43;.915;3600000;0
1368;175764;734;0;0;0;0;.00nan;0;0
1368;44526;734;100;24;0;24;1.000;3600000;0
1368;148503;739;0;0;0;0;.00nan;0;0
1369;198736;3789;0;0;0;0;.00nan;0;0
1369;204272;737;0;0;0;0;.00nan;0;0
1369;201947;737;90;34;2;32;.941;3600000;0
1369;74734;3789;49;23;3;20;.870;3592000;0
1370;203533;751;0;0;0;0;.00nan;0;0
1370;207771;744;81;27;2;25;.926;3600000;0
1370;93324;744;0;0;0;0;.00nan;0;0
1370;148788;751;67;32;3;29;.906;3579000;0
1371;218546;748;43;32;5;27;.844;3600000;0
1371;-1;742;0;0;0;0;.00nan;0;0
1371;-1;748;0;0;0;0;.00nan;0;0
1371;85797;742;92;34;2;32;.941;3600000;0
1372;3435;739;87;27;1;26;.963;3600000;0
1372;175764;734;0;0;0;0;.00nan;0;0
1372;44526;734;81;43;2;41;.953;3568000;0
1372;148503;739;0;0;0;0;.00nan;0;0
1373;198736;3789;0;0;0;0;.00nan;0;0
1373;204272;737;57;7;0;7;1.000;607000;0
1373;201947;737;37;32;6;26;.813;2993000;0
1373;74734;3789;85;25;1;24;.960;3600000;0
1374;203533;751;48;8;1;7;.875;741000;0
1374;207771;744;74;29;2;27;.931;3600000;0
1374;93324;744;0;0;0;0;.00nan;0;0
1374;148788;751;37;36;6;30;.833;2859000;0
1375;218546;748;100;24;0;24;1.000;3600000;0
1375;-1;742;0;0;0;0;.00nan;0;0
1375;-1;748;0;0;0;0;.00nan;0;0
1375;85797;742;70;21;1;20;.952;3585000;0
1376;3435;739;57;22;3;19;.864;3600000;0
1376;175764;734;0;0;0;0;.00nan;0;0
1376;44526;734;45;33;5;28;.848;3553000;0
1376;148503;739;0;0;0;0;.00nan;0;0
1377;198736;3789;0;0;0;0;.00nan;0;0
1377;204272;737;0;0;0;0;.00nan;0;0
1377;201947;737;60;44;6;38;.864;3600000;0
1377;74734;3789;63;22;2;20;.909;3600000;0
1378;203533;751;0;0;0;0;.00nan;0;0
1378;207771;744;84;40;2;38;.950;4610000;0
1378;93324;744;0;0;0;0;.00nan;0;0
1378;148788;751;91;49;3;46;.939;4610000;0
1379;218546;748;87;27;1;26;.963;3600000;0
1379;-1;742;0;0;0;0;.00nan;0;0
1379;-1;748;0;0;0;0;.00nan;0;0
1379;85797;742;93;44;3;41;.932;3522000;0
1380;3435;739;72;36;4;32;.889;3978000;0
1380;175764;734;0;0;0;0;.00nan;0;0
1380;44526;734;88;42;3;39;.929;3941000;0
1380;148503;739;0;0;0;0;.00nan;0;0
1381;198736;3789;0;0;0;0;.00nan;0;0
1381;204272;737;0;0;0;0;.00nan;0;0
1381;201947;737;91;41;2;39;.951;3600000;0
1381;74734;3789;73;33;3;30;.909;3579000;0
1382;203533;751;47;14;2;12;.857;1238000;0
1382;207771;744;100;32;0;32;1.000;3600000;0
1382;93324;744;0;0;0;0;.00nan;0;0
1382;148788;751;44;36;6;30;.833;2362000;0
1383;218546;748;75;40;4;36;.900;3515000;0
1383;-1;742;0;0;0;0;.00nan;0;0
1383;-1;748;0;0;0;0;.00nan;0;0
1383;85797;742;83;36;2;34;.944;3600000;0
1595;3435;739;65;31;3;28;.903;3600000;0
1595;175764;734;75;18;0;18;1.000;1565000;0
1595;44526;734;41;21;4;17;.810;2021000;0
1595;148503;739;0;0;0;0;.00nan;0;0
1596;198736;3789;0;0;0;0;.00nan;0;0
1596;204272;737;0;0;0;0;.00nan;0;0
1596;201947;737;80;25;1;24;.960;3600000;0
1596;74734;3789;81;47;4;43;.915;3600000;0
1597;218546;748;52;43;6;37;.860;3346000;0
1597;-1;742;0;0;0;0;.00nan;0;0
1597;-1;748;49;1;0;1;1.000;254000;0
1597;85797;742;100;25;0;25;1.000;3600000;0
1623;3435;739;97;35;1;34;.971;3600000;0
1623;175764;734;0;0;0;0;.00nan;0;0
1623;44526;734;70;39;4;35;.897;3600000;0
1623;148503;739;0;0;0;0;.00nan;0;0
1624;198736;3789;0;0;0;0;.00nan;0;0
1624;204272;737;59;22;2;20;.909;2397000;0
1624;201947;737;35;18;4;14;.778;1158000;0
1624;74734;3789;48;24;4;20;.833;3600000;0
1625;218546;748;63;34;3;31;.912;3589000;0
1625;-1;742;0;0;0;0;.00nan;0;0
1625;-1;748;0;0;0;0;.00nan;0;0
1625;85797;742;81;24;1;23;.958;3600000;0
1698;198736;3789;0;0;0;0;.00nan;0;0
1698;204272;737;67;36;4;32;.889;4008000;0
1698;201947;737;0;0;0;0;.00nan;0;0
1698;74734;3789;77;39;3;36;.923;4008000;0
1813;3435;739;100;38;0;38;1.000;3600000;0
1813;198736;3789;0;0;0;0;.00nan;0;0
1813;74734;3789;86;36;2;34;.944;3600000;0
1813;148503;739;0;0;0;0;.00nan;0;0
1814;207771;744;47;31;4;27;.871;3547000;0
1814;-1;742;0;0;0;0;.00nan;0;0
1814;85797;742;76;34;3;31;.912;3600000;0
1814;93324;744;0;0;0;0;.00nan;0;0
1815;3435;739;63;29;3;26;.897;3600000;0
1815;198736;3789;0;0;0;0;.00nan;0;0
1815;74734;3789;80;46;4;42;.913;3577000;0
1815;148503;739;0;0;0;0;.00nan;0;0
1816;207771;744;47;31;5;26;.839;3311000;0
1816;-1;742;0;0;0;0;.00nan;0;0
1816;85797;742;90;34;3;31;.912;3600000;0
1816;93324;744;41;2;1;1;.500;289000;0
1817;3435;739;90;28;2;26;.929;3600000;0
1817;198736;3789;0;0;0;0;.00nan;0;0
1817;74734;3789;75;35;3;32;.914;3600000;0
1817;148503;739;0;0;0;0;.00nan;0;0
1818;207771;744;83;45;3;42;.933;3600000;0
1818;-1;742;0;0;0;0;.00nan;0;0
1818;85797;742;100;25;0;25;1.000;3600000;0
1818;93324;744;0;0;0;0;.00nan;0;0
1819;3435;739;83;47;5;42;.894;3600000;0
1819;198736;3789;0;0;0;0;.00nan;0;0
1819;74734;3789;44;38;6;32;.842;3600000;0
1819;148503;739;0;0;0;0;.00nan;0;0
1820;207771;744;46;35;6;29;.829;2798000;0
1820;-1;742;0;0;0;0;.00nan;0;0
1820;85797;742;69;37;4;33;.892;3600000;0
1820;93324;744;49;1;0;1;1.000;773000;0
1939;3435;739;29;26;6;20;.769;2460000;0
1939;-1;742;0;0;0;0;.00nan;0;0
1939;85797;742;88;34;2;32;.941;3600000;0
1939;148503;739;55;4;0;4;1.000;1140000;0
1940;3435;739;0;0;0;0;.00nan;0;0
1940;-1;742;0;0;0;0;.00nan;0;0
1940;85797;742;82;34;2;32;.941;3568000;0
1940;148503;739;87;30;1;29;.967;3600000;0
1941;3435;739;0;0;0;0;.00nan;0;0
1941;-1;742;0;0;0;0;.00nan;0;0
1941;85797;742;49;26;4;22;.846;3577000;0
1941;148503;739;79;31;3;28;.903;3600000;0
1942;3435;739;0;0;0;0;.00nan;0;0
1942;-1;742;0;0;0;0;.00nan;0;0
1942;85797;742;96;35;1;34;.971;3600000;0
1942;148503;739;90;42;3;39;.929;3587000;0
2148;3435;739;0;0;0;0;.00nan;0;0
2148;-1;742;0;0;0;0;.00nan;0;0
2148;85797;742;62;29;3;26;.897;4069000;0
2148;148503;739;84;37;4;33;.892;4069000;0
2181;3435;739;46;6;1;5;.833;839000;0
2181;8505;742;0;0;0;0;.00nan;0;0
2181;85797;742;99;22;0;22;1.000;3600000;0
2181;148503;739;28;26;6;20;.769;2761000;0
28184;14459;562;57;25;3;22;.880;3900000;0
28184;170144;574;57;24;3;21;.875;3900000;0
28184;176963;574;0;0;0;0;.00nan;0;0
28184;155917;562;0;0;0;0;.00nan;0;0
28185;169493;564;0;0;0;0;.00nan;0;0
28185;179602;564;66;24;2;22;.917;3900000;0
28185;-1;571;0;0;0;0;.00nan;0;0
28185;64961;571;80;28;2;26;.929;3900000;0
28186;6127;575;71;26;2;24;.923;3600000;0
28186;185232;575;0;0;0;0;.00nan;0;0
28186;73939;572;88;34;3;31;.912;3591000;0
28186;84430;572;0;0;0;0;.00nan;0;0
28187;483;570;0;0;0;0;.00nan;0;0
28187;185220;565;0;0;0;0;.00nan;0;0
28187;67614;565;98;49;2;47;.959;3551000;0
28187;68167;570;72;21;1;20;.952;3600000;0
28188;174736;577;77;36;4;32;.889;3600000;0
28188;195646;577;0;0;0;0;.00nan;0;0
28188;43896;573;0;0;0;0;.00nan;0;0
28188;85749;573;68;29;3;26;.897;3600000;0
28189;13065;578;69;45;5;40;.889;3600000;0
28189;35520;578;0;0;0;0;.00nan;0;0
28189;185744;568;52;10;1;9;.900;3600000;0
28189;56126;568;0;0;0;0;.00nan;0;0
28190;11925;576;40;13;3;10;.769;3600000;0
28190;19473;569;0;0;0;0;.00nan;0;0
28190;190423;569;52;26;4;22;.846;3558000;0
28190;67454;576;0;0;0;0;.00nan;0;0
28191;14459;562;25;6;3;3;.500;559000;0
28191;169493;564;0;0;0;0;.00nan;0;0
28191;179602;564;69;22;1;21;.955;3600000;0
28191;155917;562;65;29;3;26;.897;3041000;0
28192;176963;574;59;25;3;22;.880;3900000;0
28192;185220;565;0;0;0;0;.00nan;0;0
28192;67614;565;73;40;3;37;.925;3900000;0
28192;86099;574;0;0;0;0;.00nan;0;0
28193;6127;575;96;39;2;37;.949;3600000;0
28193;174736;577;43;26;4;22;.846;3567000;0
28193;195646;577;0;0;0;0;.00nan;0;0
28193;185232;575;0;0;0;0;.00nan;0;0
28194;7063;566;71;21;2;19;.905;3900000;0
28194;19473;569;0;0;0;0;.00nan;0;0
28194;190423;569;88;34;2;32;.941;3900000;0
28194;67626;566;0;0;0;0;.00nan;0;0
28195;13065;578;63;29;3;26;.897;3600000;0
28195;-1;571;0;0;0;0;.00nan;0;0
28195;35520;578;0;0;0;0;.00nan;0;0
28195;64961;571;53;16;2;14;.875;3600000;0
28196;-1;571;52;34;4;30;.882;3600000;0
28196;43896;573;100;33;0;33;1.000;3600000;0
28196;64961;571;0;0;0;0;.00nan;0;0
28196;153618;573;0;0;0;0;.00nan;0;0
28197;179602;564;0;0;0;0;.00nan;0;0
28197;176963;574;0;0;0;0;.00nan;0;0
28197;86099;574;61;41;5;36;.878;3600000;0
28197;141419;564;72;28;2;26;.929;3600000;0
28198;483;570;0;0;0;0;.00nan;0;0
28198;68167;570;89;16;0;16;1.000;3600000;0
28198;73939;572;0;0;0;0;.00nan;0;0
28198;84430;572;98;50;1;49;.980;3555000;0
28199;6127;575;38;36;6;30;.833;3600000;0
28199;174736;577;0;0;0;0;.00nan;0;0
28199;195646;577;70;24;1;23;.958;3600000;0
28199;185232;575;0;0;0;0;.00nan;0;0
28200;7063;566;8;14;6;8;.571;2966000;0
28200;14459;562;0;0;0;0;.00nan;0;0
28200;67626;566;53;2;0;2;1.000;634000;0
28200;155917;562;23;33;7;26;.788;3589000;0
28201;11925;576;78;32;2;30;.938;3600000;0
28201;185744;568;0;0;0;0;.00nan;0;0
28201;56126;568;73;32;3;29;.906;3600000;0
28201;67454;576;0;0;0;0;.00nan;0;0
28202;13065;578;70;37;3;34;.919;3592000;0
28202;185220;565;75;29;2;27;.931;3600000;0
28202;35520;578;0;0;0;0;.00nan;0;0
28202;67614;565;0;0;0;0;.00nan;0;0
28203;176963;574;97;19;0;19;1.000;3600000;0
28203;73939;572;0;0;0;0;.00nan;0;0
28203;84430;572;88;33;1;32;.970;3549000;0
28203;86099;574;0;0;0;0;.00nan;0;0
28204;6127;575;80;34;2;32;.941;3600000;0
28204;7063;566;0;0;0;0;.00nan;0;0
28204;185232;575;0;0;0;0;.00nan;0;0
28204;67626;566;64;32;4;28;.875;3545000;0
28205;483;570;0;0;0;0;.00nan;0;0
28205;19473;569;90;34;1;33;.971;3600000;0
28205;190423;569;0;0;0;0;.00nan;0;0
28205;68167;570;61;22;2;20;.909;3600000;0
28206;11925;576;94;37;3;34;.919;3900000;0
28206;43896;573;0;0;0;0;.00nan;0;0
28206;67454;576;0;0;0;0;.00nan;0;0
28206;85749;573;59;31;3;28;.903;3900000;0
28207;185220;565;0;0;0;0;.00nan;0;0
28207;185744;568;0;0;0;0;.00nan;0;0
28207;67614;565;77;28;2;26;.929;3517000;0
28207;86875;568;88;18;0;18;1.000;3600000;0
28208;14459;562;77;38;2;36;.947;3600000;0
28208;179602;564;63;31;4;27;.871;3570000;0
28208;141419;564;0;0;0;0;.00nan;0;0
28208;155917;562;0;0;0;0;.00nan;0;0
28209;174736;577;100;29;0;29;1.000;3600000;0
28209;195646;577;0;0;0;0;.00nan;0;0
28209;64961;571;67;29;3;26;.897;3600000;0
28209;86180;571;0;0;0;0;.00nan;0;0
28210;-1;571;0;0;0;0;.00nan;0;0
28210;64961;571;61;16;2;14;.875;3900000;0
28210;73939;572;0;0;0;0;.00nan;0;0
28210;84430;572;89;44;2;42;.955;3900000;0
28211;7063;566;64;36;4;32;.889;3557000;0
28211;176963;574;90;33;2;31;.939;3600000;0
28211;67626;566;0;0;0;0;.00nan;0;0
28211;86099;574;0;0;0;0;.00nan;0;0
28212;11925;576;47;30;5;25;.833;3600000;0
28212;179602;564;0;0;0;0;.00nan;0;0
28212;67454;576;0;0;0;0;.00nan;0;0
28212;141419;564;66;24;2;22;.917;3600000;0
28213;14459;562;0;0;0;0;.00nan;0;0
28213;43896;573;74;21;1;20;.952;3600000;0
28213;59614;562;70;35;3;32;.914;3600000;0
28213;85749;573;0;0;0;0;.00nan;0;0
28214;6127;575;0;0;0;0;.00nan;0;0
28214;13065;578;92;32;2;30;.938;3600000;0
28214;185232;575;59;28;3;25;.893;3583000;0
28214;35520;578;0;0;0;0;.00nan;0;0
28215;170144;574;0;0;0;0;.00nan;0;0
28215;-1;571;0;0;0;0;.00nan;0;0
28215;64961;571;60;26;3;23;.885;3549000;0
28215;86099;574;90;32;1;31;.969;3600000;0
28216;483;570;0;0;0;0;.00nan;0;0
28216;6127;575;71;36;3;33;.917;3590000;0
28216;185232;575;0;0;0;0;.00nan;0;0
28216;68167;570;82;24;1;23;.958;3600000;0
28217;14459;562;63;41;4;37;.902;3576000;0
28217;185744;568;78;24;2;22;.917;3600000;0
28217;56126;568;0;0;0;0;.00nan;0;0
28217;155917;562;0;0;0;0;.00nan;0;0
28218;11925;576;0;0;0;0;.00nan;0;0
28218;67454;576;70;25;2;23;.920;3600000;0
28218;73939;572;44;33;5;28;.848;3600000;0
28218;84430;572;0;0;0;0;.00nan;0;0
28219;13065;578;0;0;0;0;.00nan;0;0
28219;174736;577;60;10;1;9;.900;3600000;0
28219;195646;577;0;0;0;0;.00nan;0;0
28219;35520;578;89;30;2;28;.933;3553000;0
28220;19473;569;0;0;0;0;.00nan;0;0
28220;190423;569;97;38;1;37;.974;3900000;0
28220;43896;573;82;24;1;23;.958;3900000;0
28220;153618;573;0;0;0;0;.00nan;0;0
28221;179602;564;64;32;3;29;.906;3595000;0
28221;185220;565;0;0;0;0;.00nan;0;0
28221;67614;565;100;52;1;51;.981;3600000;0
28221;141419;564;0;0;0;0;.00nan;0;0
28222;179602;564;77;31;2;29;.935;3551000;0
28222;43896;573;96;32;1;31;.969;3600000;0
28222;141419;564;0;0;0;0;.00nan;0;0
28222;153618;573;0;0;0;0;.00nan;0;0
28223;483;570;0;0;0;0;.00nan;0;0
28223;170144;574;67;31;3;28;.903;3600000;0
28223;68167;570;64;42;4;38;.905;3560000;0
28223;86099;574;0;0;0;0;.00nan;0;0
28224;7063;566;0;0;0;0;.00nan;0;0
28224;73939;572;0;0;0;0;.00nan;0;0
28224;84430;572;86;32;2;30;.938;3600000;0
28224;85633;566;39;23;4;19;.826;3545000;0
28225;6127;575;68;28;2;26;.929;3577000;0
28225;9455;569;96;20;0;20;1.000;3600000;0
28225;190423;569;0;0;0;0;.00nan;0;0
28225;86228;575;0;0;0;0;.00nan;0;0
28226;11925;576;94;23;0;23;1.000;3600000;0
28226;14459;562;0;0;0;0;.00nan;0;0
28226;59614;562;49;33;4;29;.879;3600000;0
28226;67454;576;0;0;0;0;.00nan;0;0
28227;13065;578;0;0;0;0;.00nan;0;0
28227;35520;578;86;59;5;54;.915;3900000;0
28227;185744;568;54;1;0;1;1.000;611000;0
28227;86875;568;32;25;5;20;.800;3289000;0
28228;9455;569;81;42;3;39;.929;3600000;0
28228;179602;564;67;22;2;20;.909;3600000;0
28228;190423;569;0;0;0;0;.00nan;0;0
28228;141419;564;0;0;0;0;.00nan;0;0
28229;7063;566;0;0;0;0;.00nan;0;0
28229;179602;564;0;0;0;0;.00nan;0;0
28229;85633;566;72;36;2;34;.944;3900000;0
28229;141419;564;54;13;2;11;.846;3900000;0
28230;483;570;0;0;0;0;.00nan;0;0
28230;43896;573;24;5;3;2;.400;478000;0
28230;68167;570;95;34;1;33;.971;3600000;0
28230;85749;573;53;26;3;23;.885;3122000;0
28231;174736;577;66;30;3;27;.900;3543000;0
28231;195646;577;0;0;0;0;.00nan;0;0
28231;185744;568;0;0;0;0;.00nan;0;0
28231;86875;568;100;39;1;38;.974;3600000;0
28232;6127;575;0;0;0;0;.00nan;0;0
28232;14459;562;0;0;0;0;.00nan;0;0
28232;59614;562;74;34;3;31;.912;3593000;0
28232;86228;575;93;31;1;30;.968;3600000;0
28233;11925;576;54;17;3;14;.824;3900000;0
28233;13065;578;100;50;3;47;.940;3900000;0
28233;35520;578;0;0;0;0;.00nan;0;0
28233;67454;576;0;0;0;0;.00nan;0;0
28234;185220;565;55;43;5;38;.884;3600000;0
28234;64961;571;94;18;0;18;1.000;3600000;0
28234;67614;565;0;0;0;0;.00nan;0;0
28234;86180;571;0;0;0;0;.00nan;0;0
28235;185220;565;0;0;0;0;.00nan;0;0
28235;64961;571;0;0;0;0;.00nan;0;0
28235;67614;565;100;35;0;35;1.000;3600000;0
28235;86180;571;67;24;2;22;.917;3540000;0
28236;7063;566;0;0;0;0;.00nan;0;0
28236;11925;576;0;0;0;0;.00nan;0;0
28236;67454;576;59;20;2;18;.900;3600000;0
28236;85633;566;57;32;3;29;.906;3600000;0
28237;483;570;58;25;3;22;.880;3600000;0
28237;174736;577;88;29;1;28;.966;2968000;0
28237;195646;577;26;6;3;3;.500;585000;0
28237;68167;570;0;0;0;0;.00nan;0;0
28238;9455;569;100;33;0;33;1.000;3600000;0
28238;170144;574;0;0;0;0;.00nan;0;0
28238;190423;569;0;0;0;0;.00nan;0;0
28238;86099;574;88;22;1;21;.955;3547000;0
28239;13065;578;0;0;0;0;.00nan;0;0
28239;35520;578;68;48;6;42;.875;3600000;0
28239;73939;572;94;23;0;23;1.000;3600000;0
28239;84430;572;0;0;0;0;.00nan;0;0
28240;14459;562;0;0;0;0;.00nan;0;0
28240;43896;573;0;0;0;0;.00nan;0;0
28240;59614;562;72;37;5;32;.865;3537000;0
28240;85749;573;48;20;3;17;.850;3600000;0
28241;9455;569;50;50;7;43;.860;3600000;0
28241;14459;562;0;0;0;0;.00nan;0;0
28241;190423;569;0;0;0;0;.00nan;0;0
28241;59614;562;82;26;1;25;.962;3600000;0
28242;483;570;0;0;0;0;.00nan;0;0
28242;64961;571;81;31;1;30;.968;3600000;0
28242;68167;570;53;32;4;28;.875;3600000;0
28242;86180;571;0;0;0;0;.00nan;0;0
28243;6127;575;0;0;0;0;.00nan;0;0
28243;11925;576;64;28;3;25;.893;3900000;0
28243;67454;576;0;0;0;0;.00nan;0;0
28243;86228;575;73;33;3;30;.909;3900000;0
28244;170144;574;0;0;0;0;.00nan;0;0
28244;185220;565;49;23;3;20;.870;3600000;0
28244;67614;565;0;0;0;0;.00nan;0;0
28244;86099;574;56;34;4;30;.882;3571000;0
28245;7063;566;0;0;0;0;.00nan;0;0
28245;13065;578;85;27;1;26;.963;3600000;0
28245;35520;578;0;0;0;0;.00nan;0;0
28245;85633;566;42;17;3;14;.824;3527000;0
28246;179602;564;83;30;1;29;.967;3600000;0
28246;185744;568;0;0;0;0;.00nan;0;0
28246;86875;568;59;49;6;43;.878;3600000;0
28246;141419;564;0;0;0;0;.00nan;0;0
28247;14459;562;0;0;0;0;.00nan;0;0
28247;174736;577;0;0;0;0;.00nan;0;0
28247;195646;577;76;27;3;24;.889;3600000;0
28247;59614;562;59;41;5;36;.878;3557000;0
28248;13065;578;0;0;0;0;.00nan;0;0
28248;35520;578;54;39;5;34;.872;3600000;0
28248;43896;573;0;0;0;0;.00nan;0;0
28248;85749;573;59;15;1;14;.933;3600000;0
28249;6127;575;0;0;0;0;.00nan;0;0
28249;170144;574;0;0;0;0;.00nan;0;0
28249;86099;574;84;31;1;30;.968;3600000;0
28249;86228;575;76;39;3;36;.923;3516000;0
28250;9455;569;60;29;2;27;.931;3600000;0
28250;190423;569;0;0;0;0;.00nan;0;0
28250;73939;572;0;0;0;0;.00nan;0;0
28250;84430;572;51;28;4;24;.857;3513000;0
28251;11925;576;82;25;1;24;.960;3600000;0
28251;185220;565;51;21;3;18;.857;1307000;0
28251;67454;576;0;0;0;0;.00nan;0;0
28251;67614;565;26;24;6;18;.750;2293000;0
28252;7063;566;0;0;0;0;.00nan;0;0
28252;64961;571;82;29;3;26;.897;3900000;0
28252;85633;566;65;24;3;21;.875;3900000;0
28252;86180;571;0;0;0;0;.00nan;0;0
28253;170144;574;57;27;3;24;.889;3592000;0
28253;174736;577;58;17;2;15;.882;3600000;0
28253;195646;577;0;0;0;0;.00nan;0;0
28253;86099;574;0;0;0;0;.00nan;0;0
28254;6127;575;0;0;0;0;.00nan;0;0
28254;179602;564;0;0;0;0;.00nan;0;0
28254;86228;575;83;51;4;47;.922;3600000;0
28254;141419;564;39;16;3;13;.813;3600000;0
28255;13065;578;98;52;2;50;.962;3865000;0
28255;35520;578;0;0;0;0;.00nan;0;0
28255;73939;572;52;16;2;14;.875;3900000;0
28255;84430;572;0;0;0;0;.00nan;0;0
28256;483;570;0;0;0;0;.00nan;0;0
28256;185744;568;0;0;0;0;.00nan;0;0
28256;68167;570;52;25;3;22;.880;3600000;0
28256;86875;568;70;37;4;33;.892;3600000;0
28257;14459;562;0;0;0;0;.00nan;0;0
28257;185220;565;0;0;0;0;.00nan;0;0
28257;59614;562;84;27;1;26;.963;3600000;0
28257;67614;565;76;35;3;32;.914;3562000;0
28258;9455;569;0;0;0;0;.00nan;0;0
28258;11925;576;0;0;0;0;.00nan;0;0
28258;190423;569;69;35;3;32;.914;3600000;0
28258;67454;576;71;17;2;15;.882;3600000;0
28259;6127;575;0;0;0;0;.00nan;0;0
28259;64961;571;67;13;1;12;.923;3600000;0
28259;86180;571;0;0;0;0;.00nan;0;0
28259;86228;575;90;34;2;32;.941;3600000;0
28260;7063;566;0;0;0;0;.00nan;0;0
28260;170144;574;0;0;0;0;.00nan;0;0
28260;85633;566;64;24;3;21;.875;3585000;0
28260;86099;574;98;34;1;33;.971;3600000;0
28261;174736;577;42;30;5;25;.833;3600000;0
28261;195646;577;0;0;0;0;.00nan;0;0
28261;185744;568;52;2;0;2;1.000;291000;0
28261;86875;568;32;29;6;23;.793;3273000;0
28262;185220;565;81;37;3;34;.919;3600000;0
28262;43896;573;0;0;0;0;.00nan;0;0
28262;67614;565;0;0;0;0;.00nan;0;0
28262;85749;573;76;28;2;26;.929;3600000;0
28263;7063;566;39;35;6;29;.829;3600000;0
28263;185744;568;0;0;0;0;.00nan;0;0
28263;85633;566;0;0;0;0;.00nan;0;0
28263;86875;568;87;38;3;35;.921;3600000;0
28264;179602;564;79;12;0;12;1.000;3600000;0
28264;64961;571;0;0;0;0;.00nan;0;0
28264;86180;571;75;24;2;22;.917;3600000;0
28264;141419;564;0;0;0;0;.00nan;0;0
28265;170144;574;53;14;2;12;.857;3600000;0
28265;73939;572;0;0;0;0;.00nan;0;0
28265;84430;572;91;44;3;41;.932;3562000;0
28265;86099;574;0;0;0;0;.00nan;0;0
28266;6127;575;0;0;0;0;.00nan;0;0
28266;185220;565;0;0;0;0;.00nan;0;0
28266;67614;565;87;25;1;24;.960;3600000;0
28266;86228;575;79;38;3;35;.921;3571000;0
28267;483;570;0;0;0;0;.00nan;0;0
28267;14459;562;0;0;0;0;.00nan;0;0
28267;59614;562;99;55;2;53;.964;3600000;0
28267;68167;570;57;25;3;22;.880;3600000;0
28268;9455;569;60;24;3;21;.875;3550000;0
28268;13065;578;85;37;2;35;.946;3600000;0
28268;190423;569;0;0;0;0;.00nan;0;0
28268;35520;578;0;0;0;0;.00nan;0;0
28269;170144;574;0;0;0;0;.00nan;0;0
28269;64961;571;49;36;5;31;.861;3600000;0
28269;86099;574;72;24;2;22;.917;3600000;0
28269;86180;571;0;0;0;0;.00nan;0;0
28270;7063;566;0;0;0;0;.00nan;0;0
28270;43896;573;0;0;0;0;.00nan;0;0
28270;85633;566;85;24;1;23;.958;3600000;0
28270;85749;573;42;16;3;13;.813;3567000;0
28271;11925;576;67;23;2;21;.913;3591000;0
28271;185744;568;91;32;1;31;.969;3600000;0
28271;67454;576;0;0;0;0;.00nan;0;0
28271;86875;568;0;0;0;0;.00nan;0;0
28272;174736;577;95;37;1;36;.973;3600000;0
28272;195646;577;0;0;0;0;.00nan;0;0
28272;179602;564;93;21;0;21;1.000;3600000;0
28272;141419;564;0;0;0;0;.00nan;0;0
28273;6127;575;0;0;0;0;.00nan;0;0
28273;9455;569;0;0;0;0;.00nan;0;0
28273;190423;569;64;39;5;34;.872;3881000;0
28273;86228;575;50;33;4;29;.879;3881000;0
28274;14459;562;44;27;5;22;.815;3521000;0
28274;185220;565;86;39;3;36;.923;3600000;0
28274;59614;562;0;0;0;0;.00nan;0;0
28274;67614;565;0;0;0;0;.00nan;0;0
28275;483;570;89;21;0;21;1.000;3600000;0
28275;68167;570;0;0;0;0;.00nan;0;0
28275;73939;572;85;53;3;50;.943;3600000;0
28275;84430;572;0;0;0;0;.00nan;0;0
28276;6127;575;0;0;0;0;.00nan;0;0
28276;43896;573;0;0;0;0;.00nan;0;0
28276;85749;573;91;30;2;28;.933;3900000;0
28276;86228;575;100;55;2;53;.964;3900000;0
28277;7063;566;52;11;1;10;.909;1422000;0
28277;64961;571;99;40;2;38;.950;3600000;0
28277;85633;566;17;21;6;15;.714;2178000;0
28277;86180;571;0;0;0;0;.00nan;0;0
28278;185744;568;0;0;0;0;.00nan;0;0
28278;73939;572;0;0;0;0;.00nan;0;0
28278;84430;572;73;27;2;25;.926;3600000;0
28278;86875;568;65;19;1;18;.947;3600000;0
28279;170144;574;91;51;4;47;.922;3554000;0
28279;43896;573;0;0;0;0;.00nan;0;0
28279;85749;573;66;23;2;21;.913;3600000;0
28279;86099;574;0;0;0;0;.00nan;0;0
28280;483;570;75;33;3;30;.909;3600000;0
28280;6127;575;73;43;4;39;.907;3575000;0
28280;68167;570;0;0;0;0;.00nan;0;0
28280;86228;575;0;0;0;0;.00nan;0;0
28281;11925;576;98;20;0;20;1.000;3600000;0
28281;14459;562;0;0;0;0;.00nan;0;0
28281;59614;562;83;52;4;48;.923;3600000;0
28281;67454;576;0;0;0;0;.00nan;0;0
28282;9455;569;70;36;4;32;.889;3900000;0
28282;174736;577;55;32;4;28;.875;3900000;0
28282;195646;577;0;0;0;0;.00nan;0;0
28282;190423;569;0;0;0;0;.00nan;0;0
28283;7063;566;0;0;0;0;.00nan;0;0
28283;185220;565;36;7;2;5;.714;1367000;0
28283;67614;565;27;27;6;21;.778;2233000;0
28283;85633;566;90;40;2;38;.950;3600000;0
28284;11925;576;77;33;3;30;.909;3600000;0
28284;170144;574;65;22;2;20;.909;3600000;0
28284;67454;576;0;0;0;0;.00nan;0;0
28284;86099;574;0;0;0;0;.00nan;0;0
28285;483;570;0;0;0;0;.00nan;0;0
28285;179602;564;89;14;0;14;1.000;3600000;0
28285;68167;570;91;54;5;49;.907;3600000;0
28285;141419;564;0;0;0;0;.00nan;0;0
28286;9455;569;100;37;1;36;.973;3900000;0
28286;59592;569;0;0;0;0;.00nan;0;0
28286;85336;568;0;0;0;0;.00nan;0;0
28286;86875;568;79;26;1;25;.962;3900000;0
28287;14459;562;76;19;1;18;.947;3600000;0
28287;59614;562;0;0;0;0;.00nan;0;0
28287;73939;572;63;34;4;30;.882;3600000;0
28287;84430;572;0;0;0;0;.00nan;0;0
28288;174736;577;0;0;0;0;.00nan;0;0
28288;195646;577;82;27;1;26;.963;3600000;0
28288;185220;565;0;0;0;0;.00nan;0;0
28288;67614;565;68;28;3;25;.893;3542000;0
28289;13065;578;82;39;3;36;.923;3768000;0
28289;35520;578;0;0;0;0;.00nan;0;0
28289;43896;573;69;19;2;17;.895;3768000;0
28289;85749;573;0;0;0;0;.00nan;0;0
28290;13065;578;77;37;3;34;.919;3570000;0
28290;179602;564;65;19;2;17;.895;3600000;0
28290;35520;578;0;0;0;0;.00nan;0;0
28290;141419;564;0;0;0;0;.00nan;0;0
28291;11925;576;65;31;2;29;.935;3600000;0
28291;67454;576;0;0;0;0;.00nan;0;0
28291;73939;572;0;0;0;0;.00nan;0;0
28291;84430;572;84;28;1;27;.964;3600000;0
28292;7063;566;77;22;1;21;.955;3600000;0
28292;174736;577;82;39;2;37;.949;3594000;0
28292;195646;577;0;0;0;0;.00nan;0;0
28292;85633;566;0;0;0;0;.00nan;0;0
28293;6127;575;0;0;0;0;.00nan;0;0
28293;179602;564;66;26;3;23;.885;3574000;0
28293;86228;575;85;39;2;37;.949;3600000;0
28293;141419;564;0;0;0;0;.00nan;0;0
28294;9455;569;78;50;4;46;.920;3600000;0
28294;190423;569;0;0;0;0;.00nan;0;0
28294;64961;571;64;15;1;14;.933;3600000;0
28294;86180;571;0;0;0;0;.00nan;0;0
28295;185220;565;0;0;0;0;.00nan;0;0
28295;185744;568;0;0;0;0;.00nan;0;0
28295;67614;565;81;37;2;35;.946;3581000;0
28295;86875;568;88;30;1;29;.967;3600000;0
28296;13065;578;91;39;2;37;.949;3600000;0
28296;14459;562;0;0;0;0;.00nan;0;0
28296;35520;578;0;0;0;0;.00nan;0;0
28296;59614;562;36;25;5;20;.800;3600000;0
28297;11925;576;0;0;0;0;.00nan;0;0
28297;185220;565;68;24;2;22;.917;3544000;0
28297;67454;576;65;16;1;15;.938;3600000;0
28297;67614;565;0;0;0;0;.00nan;0;0
28298;59614;562;60;23;3;20;.870;3600000;0
28298;64961;571;52;3;0;3;1.000;250000;0
28298;78864;562;0;0;0;0;.00nan;0;0
28298;86180;571;41;45;7;38;.844;3350000;0
28299;9455;569;73;41;6;35;.854;3600000;0
28299;179602;564;0;0;0;0;.00nan;0;0
28299;59592;569;0;0;0;0;.00nan;0;0
28299;141419;564;90;31;1;30;.968;3600000;0
28300;43896;573;64;17;2;15;.882;3600000;0
28300;73939;572;22;4;3;1;.250;600000;0
28300;84430;572;92;29;1;28;.966;2977000;0
28300;85749;573;0;0;0;0;.00nan;0;0
28301;483;570;32;20;5;15;.750;3600000;0
28301;7063;566;0;0;0;0;.00nan;0;0
28301;68167;570;0;0;0;0;.00nan;0;0
28301;85633;566;73;25;2;23;.920;3600000;0
28302;170144;574;0;0;0;0;.00nan;0;0
28302;85336;568;0;0;0;0;.00nan;0;0
28302;86099;574;61;20;2;18;.900;3600000;0
28302;86875;568;74;33;3;30;.909;3554000;0
28303;7063;566;68;30;3;27;.900;3517000;0
28303;179602;564;100;37;1;36;.973;3600000;0
28303;85633;566;0;0;0;0;.00nan;0;0
28303;141419;564;0;0;0;0;.00nan;0;0
28304;170144;574;0;0;0;0;.00nan;0;0
28304;85336;568;61;25;3;22;.880;3900000;0
28304;86099;574;78;36;3;33;.917;3900000;0
28304;86875;568;0;0;0;0;.00nan;0;0
28305;59614;562;0;0;0;0;.00nan;0;0
28305;64961;571;81;35;2;33;.943;3575000;0
28305;78864;562;93;37;1;36;.973;3600000;0
28305;86180;571;0;0;0;0;.00nan;0;0
28306;6127;575;0;0;0;0;.00nan;0;0
28306;174736;577;99;21;0;21;1.000;3600000;0
28306;195646;577;0;0;0;0;.00nan;0;0
28306;86228;575;75;31;2;29;.935;3582000;0
28307;483;570;0;0;0;0;.00nan;0;0
28307;9455;569;0;0;0;0;.00nan;0;0
28307;59592;569;77;30;2;28;.933;3579000;0
28307;68167;570;100;34;0;34;1.000;3600000;0
28308;11925;576;95;19;0;19;1.000;3600000;0
28308;13065;578;76;32;2;30;.938;3513000;0
28308;35520;578;0;0;0;0;.00nan;0;0
28308;67454;576;0;0;0;0;.00nan;0;0
28309;43896;573;52;27;4;23;.852;3526000;0
28309;73939;572;0;0;0;0;.00nan;0;0
28309;84430;572;84;34;2;32;.941;3600000;0
28309;85749;573;0;0;0;0;.00nan;0;0
28310;11925;576;55;28;4;24;.857;3600000;0
28310;43896;573;0;0;0;0;.00nan;0;0
28310;67454;576;0;0;0;0;.00nan;0;0
28310;85749;573;89;28;1;27;.964;3600000;0
28311;483;570;0;0;0;0;.00nan;0;0
28311;174736;577;100;40;0;40;1.000;3600000;0
28311;195646;577;0;0;0;0;.00nan;0;0
28311;68167;570;58;36;5;31;.861;3600000;0
28312;170144;574;0;0;0;0;.00nan;0;0
28312;85336;568;53;25;3;22;.880;3578000;0
28312;86099;574;71;23;1;22;.957;3600000;0
28312;86875;568;0;0;0;0;.00nan;0;0
28313;185220;565;0;0;0;0;.00nan;0;0
28313;67614;565;75;21;1;20;.952;3600000;0
28313;73939;572;74;31;2;29;.935;3600000;0
28313;84430;572;0;0;0;0;.00nan;0;0
28314;179602;564;84;28;1;27;.964;3600000;0
28314;43896;573;72;35;3;32;.914;3533000;0
28314;85749;573;0;0;0;0;.00nan;0;0
28314;141419;564;0;0;0;0;.00nan;0;0
28315;9455;569;89;29;1;28;.966;3600000;0
28315;59592;569;0;0;0;0;.00nan;0;0
28315;59614;562;75;30;2;28;.933;3543000;0
28315;78864;562;0;0;0;0;.00nan;0;0
28316;6127;575;0;0;0;0;.00nan;0;0
28316;64961;571;0;0;0;0;.00nan;0;0
28316;86180;571;74;33;2;31;.939;3600000;0
28316;86228;575;61;31;3;28;.903;3547000;0
28317;7063;566;97;24;0;24;1.000;3600000;0
28317;170144;574;58;20;2;18;.900;3541000;0
28317;85633;566;0;0;0;0;.00nan;0;0
28317;86099;574;0;0;0;0;.00nan;0;0
28318;179602;564;0;0;0;0;.00nan;0;0
28318;85336;568;0;0;0;0;.00nan;0;0
28318;86875;568;99;38;2;36;.947;3600000;0
28318;141419;564;46;28;5;23;.821;3600000;0
28319;483;570;0;0;0;0;.00nan;0;0
28319;13065;578;76;27;2;25;.926;3585000;0
28319;35520;578;0;0;0;0;.00nan;0;0
28319;68167;570;79;23;1;22;.957;3605000;0
28320;6127;575;100;44;0;44;1.000;3600000;0
28320;59614;562;0;0;0;0;.00nan;0;0
28320;78864;562;69;18;1;17;.944;3560000;0
28320;86228;575;0;0;0;0;.00nan;0;0
28321;11925;576;71;26;2;24;.923;3600000;0
28321;174736;577;69;35;3;32;.914;3599000;0
28321;195646;577;0;0;0;0;.00nan;0;0
28321;67454;576;0;0;0;0;.00nan;0;0
28322;9455;569;52;36;5;31;.861;3791000;0
28322;185220;565;0;0;0;0;.00nan;0;0
28322;59592;569;0;0;0;0;.00nan;0;0
28322;67614;565;44;23;4;19;.826;3791000;0
28323;170144;574;0;0;0;0;.00nan;0;0
28323;59614;562;26;13;4;9;.692;876000;0
28323;78864;562;59;31;3;28;.903;2724000;0
28323;86099;574;68;18;1;17;.944;3600000;0
28324;73939;572;0;0;0;0;.00nan;0;0
28324;84430;572;64;35;4;31;.886;3521000;0
28324;85336;568;0;0;0;0;.00nan;0;0
28324;86875;568;75;32;2;30;.938;3600000;0
28325;483;570;0;0;0;0;.00nan;0;0
28325;11925;576;0;0;0;0;.00nan;0;0
28325;67454;576;64;33;5;28;.848;3600000;0
28325;68167;570;95;38;2;36;.947;3600000;0
28326;43896;573;73;25;1;24;.960;3600000;0
28326;64961;571;0;0;0;0;.00nan;0;0
28326;85749;573;0;0;0;0;.00nan;0;0
28326;86180;571;68;35;4;31;.886;3600000;0
28327;6127;575;83;44;4;40;.909;3600000;0
28327;7063;566;52;23;3;20;.870;3600000;0
28327;85633;566;0;0;0;0;.00nan;0;0
28327;86228;575;0;0;0;0;.00nan;0;0
28328;9455;569;0;0;0;0;.00nan;0;0
28328;174736;577;0;0;0;0;.00nan;0;0
28328;195646;577;100;34;0;34;1.000;3600000;0
28328;59592;569;84;47;3;44;.936;3558000;0
28329;13065;578;97;38;1;37;.974;3900000;0
28329;179602;564;84;23;1;22;.957;3900000;0
28329;35520;578;0;0;0;0;.00nan;0;0
28329;141419;564;0;0;0;0;.00nan;0;0
28330;13065;578;63;26;2;24;.923;3600000;0
28330;35520;578;0;0;0;0;.00nan;0;0
28330;64961;571;0;0;0;0;.00nan;0;0
28330;86180;571;54;23;3;20;.870;3600000;0
28331;170144;574;73;38;3;35;.921;3600000;0
28331;43896;573;0;0;0;0;.00nan;0;0
28331;85749;573;48;35;5;30;.857;3552000;0
28331;86099;574;0;0;0;0;.00nan;0;0
28332;483;570;0;0;0;0;.00nan;0;0
28332;7063;566;43;3;1;2;.667;819000;0
28332;68167;570;69;27;2;25;.926;3600000;0
28332;85633;566;48;35;6;29;.829;2781000;0
28333;6127;575;0;0;0;0;.00nan;0;0
28333;85336;568;0;0;0;0;.00nan;0;0
28333;86228;575;85;48;4;44;.917;3600000;0
28333;86875;568;46;16;3;13;.813;3600000;0
28334;174736;577;74;26;1;25;.962;3871000;0
28334;195646;577;0;0;0;0;.00nan;0;0
28334;185220;565;73;24;2;22;.917;3871000;0
28334;67614;565;0;0;0;0;.00nan;0;0
28335;483;570;59;21;2;19;.905;3600000;0
28335;68167;570;0;0;0;0;.00nan;0;0
28335;73939;572;0;0;0;0;.00nan;0;0
28335;84430;572;67;37;3;34;.919;3600000;0
28336;43896;573;0;0;0;0;.00nan;0;0
28336;85336;568;0;0;0;0;.00nan;0;0
28336;85749;573;39;20;3;17;.850;3600000;0
28336;86875;568;35;40;7;33;.825;3600000;0
28337;11925;576;79;30;1;29;.967;3600000;0
28337;64961;571;0;0;0;0;.00nan;0;0
28337;67454;576;0;0;0;0;.00nan;0;0
28337;86180;571;74;37;3;34;.919;3515000;0
28338;7063;566;66;39;4;35;.897;3600000;0
28338;174736;577;0;0;0;0;.00nan;0;0
28338;195646;577;73;23;1;22;.957;3600000;0
28338;85633;566;0;0;0;0;.00nan;0;0
28339;9455;569;89;44;3;41;.932;3595000;0
28339;179602;564;62;23;2;21;.913;3600000;0
28339;59592;569;0;0;0;0;.00nan;0;0
28339;141419;564;0;0;0;0;.00nan;0;0
28340;13065;578;60;25;2;23;.920;3900000;0
28340;185220;565;64;25;2;23;.920;3900000;0
28340;35520;578;0;0;0;0;.00nan;0;0
28340;67614;565;0;0;0;0;.00nan;0;0
28341;185220;565;0;0;0;0;.00nan;0;0
28341;64961;571;0;0;0;0;.00nan;0;0
28341;67614;565;69;40;4;36;.900;3536000;0
28341;86180;571;69;24;2;22;.917;3600000;0
28342;13065;578;84;42;3;39;.929;3600000;0
28342;170144;574;65;17;1;16;.941;3600000;0
28342;35520;578;0;0;0;0;.00nan;0;0
28342;86099;574;0;0;0;0;.00nan;0;0
28343;7063;566;0;0;0;0;.00nan;0;0
28343;9455;569;0;0;0;0;.00nan;0;0
28343;59592;569;94;37;0;37;1.000;3900000;0
28343;85633;566;96;23;0;23;1.000;3900000;0
28344;174736;577;84;41;3;38;.927;3544000;0
28344;195646;577;0;0;0;0;.00nan;0;0
28344;179602;564;0;0;0;0;.00nan;0;0
28344;141419;564;75;35;2;33;.943;3600000;0
28345;59614;562;58;36;4;32;.889;3600000;0
28345;73939;572;0;0;0;0;.00nan;0;0
28345;78864;562;0;0;0;0;.00nan;0;0
28345;84430;572;100;42;1;41;.976;3600000;0
28346;43896;573;0;0;0;0;.00nan;0;0
28346;85336;568;37;25;5;20;.800;2310000;0
28346;85749;573;68;42;5;37;.881;3600000;0
28346;86875;568;50;8;1;7;.875;1236000;0
28347;6127;575;0;0;0;0;.00nan;0;0
28347;11925;576;52;26;4;22;.846;3600000;0
28347;67454;576;0;0;0;0;.00nan;0;0
28347;86228;575;100;49;1;48;.980;3600000;0
28348;185220;565;66;20;2;18;.900;3600000;0
28348;67614;565;0;0;0;0;.00nan;0;0
28348;73939;572;80;40;3;37;.925;3572000;0
28348;84430;572;0;0;0;0;.00nan;0;0
28349;6127;575;0;0;0;0;.00nan;0;0
28349;13065;578;68;25;2;23;.920;3600000;0
28349;35520;578;0;0;0;0;.00nan;0;0
28349;86228;575;45;39;6;33;.846;3600000;0
28350;179602;564;72;20;1;19;.950;3600000;0
28350;73939;572;0;0;0;0;.00nan;0;0
28350;84430;572;44;37;6;31;.838;3600000;0
28350;141419;564;0;0;0;0;.00nan;0;0
28351;483;570;0;0;0;0;.00nan;0;0
28351;43896;573;0;0;0;0;.00nan;0;0
28351;68167;570;60;28;4;24;.857;3600000;0
28351;85749;573;41;30;5;25;.833;3545000;0
28352;64961;571;0;0;0;0;.00nan;0;0
28352;85336;568;0;0;0;0;.00nan;0;0
28352;86180;571;68;38;4;34;.895;3900000;0
28352;86875;568;52;29;4;25;.862;3900000;0
28353;11925;576;58;19;2;17;.895;3600000;0
28353;170144;574;0;0;0;0;.00nan;0;0
28353;67454;576;0;0;0;0;.00nan;0;0
28353;86099;574;55;29;4;25;.862;3550000;0
28354;7063;566;0;0;0;0;.00nan;0;0
28354;185220;565;87;31;1;30;.968;3599000;0
28354;67614;565;0;0;0;0;.00nan;0;0
28354;85633;566;94;16;0;16;1.000;3600000;0
28355;483;570;0;0;0;0;.00nan;0;0
28355;43896;573;0;0;0;0;.00nan;0;0
28355;68167;570;99;50;1;49;.980;3678000;0
28355;85749;573;75;29;2;27;.931;3678000;0
28356;174736;577;0;0;0;0;.00nan;0;0
28356;195646;577;46;31;4;27;.871;3600000;0
28356;59614;562;41;21;4;17;.810;2312000;0
28356;78864;562;68;18;1;17;.944;1288000;0
28357;9455;569;0;0;0;0;.00nan;0;0
28357;13065;578;0;0;0;0;.00nan;0;0
28357;35520;578;95;33;1;32;.970;3600000;0
28357;59592;569;61;25;3;22;.880;3557000;0
28358;7063;566;0;0;0;0;.00nan;0;0
28358;11925;576;57;21;2;19;.905;3600000;0
28358;67454;576;0;0;0;0;.00nan;0;0
28358;85633;566;58;33;4;29;.879;3530000;0
28359;6127;575;0;0;0;0;.00nan;0;0
28359;170144;574;0;0;0;0;.00nan;0;0
28359;86099;574;94;18;0;18;1.000;3600000;0
28359;86228;575;65;45;5;40;.889;3600000;0
28360;179602;564;85;13;0;13;1.000;3600000;0
28360;73939;572;91;51;2;49;.961;3561000;0
28360;84430;572;0;0;0;0;.00nan;0;0
28360;141419;564;0;0;0;0;.00nan;0;0
28361;13065;578;84;29;1;28;.966;3600000;0
28361;35520;578;0;0;0;0;.00nan;0;0
28361;85336;568;0;0;0;0;.00nan;0;0
28361;86875;568;58;25;3;22;.880;3526000;0
28362;9455;569;60;23;3;20;.870;3600000;0
28362;185220;565;0;0;0;0;.00nan;0;0
28362;59592;569;0;0;0;0;.00nan;0;0
28362;67614;565;52;37;6;31;.838;3600000;0
28363;483;570;51;2;0;2;1.000;314000;0
28363;179602;564;53;23;3;20;.870;3600000;0
28363;68167;570;53;43;7;36;.837;3286000;0
28363;141419;564;0;0;0;0;.00nan;0;0
28364;11925;576;96;36;0;36;1.000;3900000;0
28364;174736;577;0;0;0;0;.00nan;0;0
28364;195646;577;100;36;0;36;1.000;3900000;0
28364;67454;576;0;0;0;0;.00nan;0;0
28365;170144;574;0;0;0;0;.00nan;0;0
28365;185220;565;100;45;0;45;1.000;3600000;0
28365;67614;565;0;0;0;0;.00nan;0;0
28365;86099;574;77;20;1;19;.950;3549000;0
28366;7063;566;0;0;0;0;.00nan;0;0
28366;73939;572;0;0;0;0;.00nan;0;0
28366;84430;572;100;28;0;28;1.000;3600000;0
28366;85633;566;60;14;1;13;.929;3596000;0
28367;11925;576;86;34;2;32;.941;3900000;0
28367;43896;573;72;26;2;24;.923;3900000;0
28367;67454;576;0;0;0;0;.00nan;0;0
28367;85749;573;0;0;0;0;.00nan;0;0
28368;6127;575;0;0;0;0;.00nan;0;0
28368;64961;571;0;0;0;0;.00nan;0;0
28368;86180;571;51;21;3;18;.857;3531000;0
28368;86228;575;100;44;1;43;.977;3600000;0
28369;13065;578;80;44;3;41;.932;3600000;0
28369;35520;578;0;0;0;0;.00nan;0;0
28369;59614;562;71;26;2;24;.923;3600000;0
28369;78864;562;0;0;0;0;.00nan;0;0
28370;9455;569;77;31;2;29;.935;3555000;0
28370;59592;569;0;0;0;0;.00nan;0;0
28370;85336;568;0;0;0;0;.00nan;0;0
28370;86875;568;82;24;1;23;.958;3600000;0
28371;170144;574;0;0;0;0;.00nan;0;0
28371;179602;564;0;0;0;0;.00nan;0;0
28371;86099;574;55;29;5;24;.828;3600000;0
28371;141419;564;77;25;1;24;.960;3600000;0
28372;59614;562;74;45;4;41;.911;3559000;0
28372;64961;571;0;0;0;0;.00nan;0;0
28372;78864;562;0;0;0;0;.00nan;0;0
28372;86180;571;54;14;2;12;.857;3600000;0
28373;7063;566;88;20;0;20;1.000;3600000;0
28373;85336;568;0;0;0;0;.00nan;0;0
28373;85633;566;0;0;0;0;.00nan;0;0
28373;86875;568;93;28;1;27;.964;3560000;0
28374;179602;564;59;15;2;13;.867;3514000;0
28374;185220;565;100;31;0;31;1.000;3600000;0
28374;67614;565;0;0;0;0;.00nan;0;0
28374;141419;564;0;0;0;0;.00nan;0;0
28375;9455;569;93;38;1;37;.974;3600000;0
28375;43896;573;0;0;0;0;.00nan;0;0
28375;59592;569;0;0;0;0;.00nan;0;0
28375;85749;573;65;20;2;18;.900;3559000;0
28376;6127;575;0;0;0;0;.00nan;0;0
28376;73939;572;77;20;0;20;1.000;2651000;0
28376;84430;572;5;15;6;9;.600;949000;0
28376;86228;575;72;28;2;26;.929;3600000;0
28377;13065;578;86;57;5;52;.912;3600000;0
28377;174736;577;66;17;1;16;.941;3600000;0
28377;195646;577;0;0;0;0;.00nan;0;0
28377;35520;578;0;0;0;0;.00nan;0;0
28378;174736;577;0;0;0;0;.00nan;0;0
28378;195646;577;52;14;2;12;.857;3600000;0
28378;64961;571;0;0;0;0;.00nan;0;0
28378;86180;571;84;49;3;46;.939;3565000;0
28379;43896;573;0;0;0;0;.00nan;0;0
28379;73939;572;0;0;0;0;.00nan;0;0
28379;84430;572;98;46;2;44;.957;3553000;0
28379;85749;573;100;23;0;23;1.000;3600000;0
28380;14459;566;0;0;0;0;.00nan;0;0
28380;85336;568;0;0;0;0;.00nan;0;0
28380;85633;566;81;30;2;28;.933;3565000;0
28380;86875;568;80;25;1;24;.960;3600000;0
28381;185220;565;73;30;3;27;.900;3573000;0
28381;59614;562;0;0;0;0;.00nan;0;0
28381;67614;565;0;0;0;0;.00nan;0;0
28381;78864;562;69;27;2;25;.926;3600000;0
28382;483;570;0;0;0;0;.00nan;0;0
28382;11925;576;61;29;3;26;.897;3600000;0
28382;67454;576;0;0;0;0;.00nan;0;0
28382;68167;570;58;33;4;29;.879;3566000;0
28383;9455;569;0;0;0;0;.00nan;0;0
28383;13065;578;97;31;1;30;.968;3900000;0
28383;35520;578;0;0;0;0;.00nan;0;0
28383;59592;569;92;27;1;26;.963;3900000;0
28384;64961;571;0;0;0;0;.00nan;0;0
28384;85336;568;0;0;0;0;.00nan;0;0
28384;86180;571;74;25;2;23;.920;3600000;0
28384;86875;568;63;35;3;32;.914;3600000;0
28385;14459;566;0;0;0;0;.00nan;0;0
28385;43896;573;0;0;0;0;.00nan;0;0
28385;85633;566;84;33;2;31;.939;3587000;0
28385;85749;573;81;22;1;21;.955;3600000;0
28386;9455;569;51;30;4;26;.867;3600000;0
28386;179602;564;53;13;2;11;.846;3600000;0
28386;59592;569;0;0;0;0;.00nan;0;0
28386;141419;564;0;0;0;0;.00nan;0;0
28387;174736;577;62;25;3;22;.880;3600000;0
28387;195646;577;0;0;0;0;.00nan;0;0
28387;73939;572;88;38;2;36;.947;3600000;0
28387;84430;572;0;0;0;0;.00nan;0;0
28388;483;570;0;0;0;0;.00nan;0;0
28388;170144;574;0;0;0;0;.00nan;0;0
28388;68167;570;45;20;4;16;.800;3682000;0
28388;86099;574;66;37;5;32;.865;3682000;0
28389;6127;575;0;0;0;0;.00nan;0;0
28389;11925;576;76;37;3;34;.919;3536000;0
28389;67454;576;0;0;0;0;.00nan;0;0
28389;86228;575;92;31;1;30;.968;3600000;0
28390;185220;565;0;0;0;0;.00nan;0;0
28390;59614;562;100;33;0;33;1.000;3600000;0
28390;67614;565;71;30;2;28;.933;3544000;0
28390;78864;562;0;0;0;0;.00nan;0;0
28391;9455;569;0;0;0;0;.00nan;0;0
28391;170144;574;80;20;0;20;1.000;3900000;0
28391;59592;569;100;39;0;39;1.000;3900000;0
28391;86099;574;0;0;0;0;.00nan;0;0
28392;59614;562;52;27;4;23;.852;3600000;0
28392;78864;562;0;0;0;0;.00nan;0;0
28392;85336;568;52;35;5;30;.857;3580000;0
28392;86875;568;0;0;0;0;.00nan;0;0
28393;11925;576;100;27;0;27;1.000;3600000;0
28393;179602;564;0;0;0;0;.00nan;0;0
28393;67454;576;0;0;0;0;.00nan;0;0
28393;141419;564;69;26;2;24;.923;3555000;0
28394;174736;577;0;0;0;0;.00nan;0;0
28394;195646;577;67;20;1;19;.950;3600000;0
28394;73939;572;0;0;0;0;.00nan;0;0
28394;84430;572;75;28;2;26;.929;3566000;0
28395;185220;565;76;32;2;30;.938;3560000;0
28395;64961;571;0;0;0;0;.00nan;0;0
28395;67614;565;0;0;0;0;.00nan;0;0
28395;86180;571;63;10;1;9;.900;3600000;0
28396;483;570;62;10;1;9;.900;3600000;0
28396;13065;578;86;43;3;40;.930;3563000;0
28396;35520;578;0;0;0;0;.00nan;0;0
28396;68167;570;0;0;0;0;.00nan;0;0
28397;6127;575;0;0;0;0;.00nan;0;0
28397;43896;573;63;26;3;23;.885;3600000;0
28397;85749;573;0;0;0;0;.00nan;0;0
28397;86228;575;42;38;6;32;.842;3600000;0
28398;483;570;0;0;0;0;.00nan;0;0
28398;64961;571;0;0;0;0;.00nan;0;0
28398;68167;570;68;27;2;25;.926;3600000;0
28398;86180;571;45;22;4;18;.818;3542000;0
28399;13065;578;76;31;2;29;.935;3820000;0
28399;14459;566;0;0;0;0;.00nan;0;0
28399;35520;578;0;0;0;0;.00nan;0;0
28399;85633;566;61;11;1;10;.909;3820000;0
28400;11925;576;100;20;0;20;1.000;3600000;0
28400;64961;571;0;0;0;0;.00nan;0;0
28400;67454;576;0;0;0;0;.00nan;0;0
28400;86180;571;58;18;2;16;.889;3535000;0
28401;13065;578;92;50;3;47;.940;3640000;0
28401;179602;564;67;25;2;23;.920;3640000;0
28401;35520;578;0;0;0;0;.00nan;0;0
28401;141419;564;0;0;0;0;.00nan;0;0
28402;9455;569;0;0;0;0;.00nan;0;0
28402;59592;569;61;17;1;16;.941;3600000;0
28402;73939;572;38;11;3;8;.727;904000;0
28402;84430;572;25;31;7;24;.774;2696000;0
28403;185220;565;70;28;2;26;.929;3542000;0
28403;43896;573;0;0;0;0;.00nan;0;0
28403;67614;565;0;0;0;0;.00nan;0;0
28403;85749;573;100;31;0;31;1.000;3600000;0
28404;6127;575;0;0;0;0;.00nan;0;0
28404;85336;568;65;17;1;16;.941;3600000;0
28404;86228;575;87;45;4;41;.911;3565000;0
28404;86875;568;0;0;0;0;.00nan;0;0
28405;483;570;0;0;0;0;.00nan;0;0
28405;59614;562;97;38;2;36;.947;3600000;0
28405;68167;570;65;36;3;33;.917;3562000;0
28405;78864;562;0;0;0;0;.00nan;0;0
28406;170144;574;70;27;2;25;.926;3600000;0
28406;174736;577;59;25;3;22;.880;3600000;0
28406;195646;577;0;0;0;0;.00nan;0;0
28406;86099;574;0;0;0;0;.00nan;0;0
28407;170144;574;0;0;0;0;.00nan;0;0
28407;73939;572;0;0;0;0;.00nan;0;0
28407;84430;572;97;42;1;41;.976;3900000;0
28407;86099;574;83;22;1;21;.955;3900000;0
28408;483;570;0;0;0;0;.00nan;0;0
28408;64961;571;0;0;0;0;.00nan;0;0
28408;68167;570;90;35;2;33;.943;3600000;0
28408;86180;571;73;31;3;28;.903;3571000;0
28409;179602;564;61;24;3;21;.875;3600000;0
28409;59614;562;25;21;5;16;.762;3594000;0
28409;78864;562;0;0;0;0;.00nan;0;0
28409;141419;564;0;0;0;0;.00nan;0;0
28410;11925;576;100;23;0;23;1.000;3600000;0
28410;14459;566;0;0;0;0;.00nan;0;0
28410;67454;576;0;0;0;0;.00nan;0;0
28410;85633;566;91;31;3;28;.903;3600000;0
28411;6127;575;0;0;0;0;.00nan;0;0
28411;9455;569;0;0;0;0;.00nan;0;0
28411;59592;569;78;16;0;16;1.000;3600000;0
28411;86228;575;65;45;4;41;.911;3600000;0
28412;185220;565;0;0;0;0;.00nan;0;0
28412;43896;573;0;0;0;0;.00nan;0;0
28412;67614;565;100;27;0;27;1.000;3635000;0
28412;85749;573;67;17;1;16;.941;3635000;0
28413;13065;578;81;25;2;23;.920;2585000;0
28413;35520;578;18;9;4;5;.556;1015000;0
28413;85336;568;0;0;0;0;.00nan;0;0
28413;86875;568;72;30;3;27;.900;3600000;0
28414;14459;566;58;21;2;19;.905;3550000;0
28414;59614;562;0;0;0;0;.00nan;0;0
28414;78864;562;100;35;1;34;.971;3600000;0
28414;85633;566;0;0;0;0;.00nan;0;0
28415;179602;564;84;33;2;31;.939;3579000;0
28415;64961;571;0;0;0;0;.00nan;0;0
28415;86180;571;100;30;0;30;1.000;3600000;0
28415;141419;564;0;0;0;0;.00nan;0;0
28416;483;570;0;0;0;0;.00nan;0;0
28416;68167;570;97;22;0;22;1.000;3600000;0
28416;73939;572;93;38;1;37;.974;3600000;0
28416;84430;572;0;0;0;0;.00nan;0;0
28417;11925;576;53;23;3;20;.870;3591000;0
28417;67454;576;0;0;0;0;.00nan;0;0
28417;85336;568;79;33;2;31;.939;3600000;0
28417;86875;568;0;0;0;0;.00nan;0;0
28418;174736;577;70;25;1;24;.960;3900000;0
28418;195646;577;0;0;0;0;.00nan;0;0
28418;43896;573;0;0;0;0;.00nan;0;0
28418;85749;573;80;25;1;24;.960;3900000;0
28419;6127;575;0;0;0;0;.00nan;0;0
28419;185220;565;0;0;0;0;.00nan;0;0
28419;67614;565;57;21;2;19;.905;3600000;0
28419;86228;575;66;34;3;31;.912;3581000;0
28420;13065;578;74;58;6;52;.897;3600000;0
28420;170144;574;49;11;2;9;.818;3600000;0
28420;35520;578;0;0;0;0;.00nan;0;0
28420;86099;574;0;0;0;0;.00nan;0;0
28421;9455;569;0;0;0;0;.00nan;0;0
28421;59592;569;100;35;0;35;1.000;3600000;0
28421;64961;571;0;0;0;0;.00nan;0;0
28421;86180;571;93;26;1;25;.962;3545000;0
28422;14459;566;0;0;0;0;.00nan;0;0
28422;170144;574;68;22;1;21;.955;3708000;0
28422;85633;566;84;32;2;30;.938;3708000;0
28422;86099;574;0;0;0;0;.00nan;0;0
28423;179602;564;73;17;1;16;.941;3900000;0
28423;185220;565;100;54;1;53;.981;3900000;0
28423;67614;565;0;0;0;0;.00nan;0;0
28423;141419;564;0;0;0;0;.00nan;0;0
28424;11925;576;37;17;4;13;.765;3560000;0
28424;67454;576;0;0;0;0;.00nan;0;0
28424;73939;572;0;0;0;0;.00nan;0;0
28424;84430;572;75;30;2;28;.933;3600000;0
28425;483;570;0;0;0;0;.00nan;0;0
28425;68167;570;94;39;2;37;.949;3600000;0
28425;85336;568;0;0;0;0;.00nan;0;0
28425;86875;568;56;37;4;33;.892;3567000;0
28426;6127;575;70;40;4;36;.900;3558000;0
28426;174736;577;69;28;2;26;.929;3600000;0
28426;195646;577;0;0;0;0;.00nan;0;0
28426;86228;575;0;0;0;0;.00nan;0;0
28427;13065;578;63;22;2;20;.909;3600000;0
28427;35520;578;0;0;0;0;.00nan;0;0
28427;59614;562;40;33;6;27;.818;2175000;0
28427;78864;562;36;7;2;5;.714;1425000;0
28428;6127;575;0;0;0;0;.00nan;0;0
28428;73939;572;92;40;2;38;.950;3900000;0
28428;84430;572;0;0;0;0;.00nan;0;0
28428;86228;575;80;23;2;21;.913;3900000;0
28429;483;570;0;0;0;0;.00nan;0;0
28429;170144;574;0;0;0;0;.00nan;0;0
28429;68167;570;62;34;4;30;.882;3564000;0
28429;86099;574;61;19;2;17;.895;3600000;0
28430;14459;566;0;0;0;0;.00nan;0;0
28430;59614;562;44;38;6;32;.842;3552000;0
28430;78864;562;0;0;0;0;.00nan;0;0
28430;85633;566;37;21;5;16;.762;3600000;0
28431;11925;576;97;34;1;33;.971;3600000;0
28431;64961;571;0;0;0;0;.00nan;0;0
28431;67454;576;0;0;0;0;.00nan;0;0
28431;86180;571;56;24;3;21;.875;3550000;0
28432;174736;577;0;0;0;0;.00nan;0;0
28432;195646;577;100;38;0;38;1.000;3600000;0
28432;179602;564;65;34;4;30;.882;3600000;0
28432;141419;564;0;0;0;0;.00nan;0;0
28433;9455;569;0;0;0;0;.00nan;0;0
28433;13065;578;100;41;0;41;1.000;3600000;0
28433;35520;578;0;0;0;0;.00nan;0;0
28433;59592;569;68;20;1;19;.950;3578000;0
28434;185220;565;51;15;2;13;.867;3558000;0
28434;67614;565;0;0;0;0;.00nan;0;0
28434;85336;568;0;0;0;0;.00nan;0;0
28434;86875;568;78;29;1;28;.966;3600000;0
28435;9455;569;0;0;0;0;.00nan;0;0
28435;59592;569;51;39;6;33;.846;3600000;0
28435;85336;568;82;15;0;15;1.000;3600000;0
28435;86875;568;0;0;0;0;.00nan;0;0
28436;64961;571;63;16;1;15;.938;3600000;0
28436;73939;572;0;0;0;0;.00nan;0;0
28436;84430;572;75;46;4;42;.913;3600000;0
28436;86180;571;0;0;0;0;.00nan;0;0
28437;170144;574;62;26;3;23;.885;3563000;0
28437;174736;577;0;0;0;0;.00nan;0;0
28437;195646;577;92;36;1;35;.972;3600000;0
28437;86099;574;0;0;0;0;.00nan;0;0
28438;13065;578;48;40;7;33;.825;3600000;0
28438;14459;566;0;0;0;0;.00nan;0;0
28438;35520;578;0;0;0;0;.00nan;0;0
28438;85633;566;72;16;1;15;.938;3600000;0
28439;6127;575;0;0;0;0;.00nan;0;0
28439;179602;564;89;30;1;29;.967;3841000;0
28439;86228;575;92;43;2;41;.953;3841000;0
28439;141419;564;0;0;0;0;.00nan;0;0
28440;11925;576;37;13;3;10;.769;3557000;0
28440;59614;562;99;46;2;44;.957;3600000;0
28440;67454;576;0;0;0;0;.00nan;0;0
28440;78864;562;0;0;0;0;.00nan;0;0
28441;483;570;0;0;0;0;.00nan;0;0
28441;185220;565;0;0;0;0;.00nan;0;0
28441;67614;565;97;39;1;38;.974;3549000;0
28441;68167;570;97;19;0;19;1.000;3600000;0
28442;170144;574;56;27;3;24;.889;3545000;0
28442;179602;564;91;32;2;30;.938;3600000;0
28442;86099;574;0;0;0;0;.00nan;0;0
28442;141419;564;0;0;0;0;.00nan;0;0
28443;185220;565;0;0;0;0;.00nan;0;0
28443;67614;565;84;33;2;31;.939;3600000;0
28443;73939;572;50;28;4;24;.857;3596000;0
28443;84430;572;0;0;0;0;.00nan;0;0
28444;483;570;0;0;0;0;.00nan;0;0
28444;68167;570;93;32;1;31;.969;3900000;0
28444;85336;568;0;0;0;0;.00nan;0;0
28444;86875;568;100;39;1;38;.974;3900000;0
28445;6127;575;0;0;0;0;.00nan;0;0
28445;59614;562;91;16;0;16;1.000;3600000;0
28445;78864;562;0;0;0;0;.00nan;0;0
28445;86228;575;77;26;2;24;.923;3563000;0
28446;14459;566;0;0;0;0;.00nan;0;0
28446;174736;577;0;0;0;0;.00nan;0;0
28446;195646;577;45;32;5;27;.844;3543000;0
28446;85633;566;48;26;4;22;.846;3600000;0
28447;170144;574;0;0;0;0;.00nan;0;0
28447;64961;571;0;0;0;0;.00nan;0;0
28447;86099;574;66;35;4;31;.886;3579000;0
28447;86180;571;65;26;2;24;.923;3600000;0
28448;64961;571;67;26;2;24;.923;3600000;0
28448;85336;568;0;0;0;0;.00nan;0;0
28448;86180;571;0;0;0;0;.00nan;0;0
28448;86875;568;86;33;1;32;.970;3600000;0
28449;179602;564;91;22;1;21;.955;3600000;0
28449;73939;572;0;0;0;0;.00nan;0;0
28449;84430;572;76;53;6;47;.887;3600000;0
28449;141419;564;0;0;0;0;.00nan;0;0
28450;483;570;0;0;0;0;.00nan;0;0
28450;43896;573;0;0;0;0;.00nan;0;0
28450;68167;570;99;34;1;33;.971;3900000;0
28450;85749;573;76;29;1;28;.966;3900000;0
28451;6127;575;0;0;0;0;.00nan;0;0
28451;14459;566;0;0;0;0;.00nan;0;0
28451;85633;566;73;30;2;28;.933;3600000;0
28451;86228;575;70;35;5;30;.857;3600000;0
28452;9455;569;0;0;0;0;.00nan;0;0
28452;13065;578;93;50;3;47;.940;3600000;0
28452;35520;578;0;0;0;0;.00nan;0;0
28452;59592;569;69;27;2;25;.926;3600000;0
28453;174736;577;75;35;3;32;.914;3558000;0
28453;195646;577;0;0;0;0;.00nan;0;0
28453;185220;565;0;0;0;0;.00nan;0;0
28453;67614;565;87;31;1;30;.968;3600000;0
28454;14459;566;48;15;3;12;.800;3571000;0
28454;73939;572;81;43;2;41;.953;3600000;0
28454;84430;572;0;0;0;0;.00nan;0;0
28454;85633;566;0;0;0;0;.00nan;0;0
28455;483;570;0;0;0;0;.00nan;0;0
28455;179602;564;0;0;0;0;.00nan;0;0
28455;68167;570;95;41;2;39;.951;3564000;0
28455;141419;564;88;32;1;31;.969;3600000;0
28456;170144;574;87;35;2;33;.943;3900000;0
28456;43896;573;73;31;2;29;.935;3900000;0
28456;85749;573;0;0;0;0;.00nan;0;0
28456;86099;574;0;0;0;0;.00nan;0;0
28457;59614;562;100;40;0;40;1.000;3600000;0
28457;78864;562;0;0;0;0;.00nan;0;0
28457;85336;568;46;33;6;27;.818;3600000;0
28457;86875;568;0;0;0;0;.00nan;0;0
28458;6127;575;0;0;0;0;.00nan;0;0
28458;11925;576;0;0;0;0;.00nan;0;0
28458;67454;576;39;27;5;22;.815;3600000;0
28458;86228;575;57;48;7;41;.854;3600000;0
28459;13065;578;0;0;0;0;.00nan;0;0
28459;185220;565;64;31;4;27;.871;3600000;0
28459;35520;578;100;42;1;41;.976;3600000;0
28459;67614;565;0;0;0;0;.00nan;0;0
28460;14459;566;0;0;0;0;.00nan;0;0
28460;64961;571;100;24;0;24;1.000;3600000;0
28460;85633;566;86;29;1;28;.966;3570000;0
28460;86180;571;0;0;0;0;.00nan;0;0
28461;179602;564;65;20;2;18;.900;3600000;0
28461;59614;562;60;36;5;31;.861;3600000;0
28461;78864;562;0;0;0;0;.00nan;0;0
28461;141419;564;0;0;0;0;.00nan;0;0
28462;73939;572;0;0;0;0;.00nan;0;0
28462;84430;572;98;50;3;47;.940;3600000;0
28462;85336;568;0;0;0;0;.00nan;0;0
28462;86875;568;86;10;0;10;1.000;3600000;0
28463;11925;576;86;30;1;29;.967;3600000;0
28463;174736;577;60;29;3;26;.897;3583000;0
28463;195646;577;0;0;0;0;.00nan;0;0
28463;67454;576;0;0;0;0;.00nan;0;0
28464;13065;578;88;44;1;43;.977;3565000;0
28464;35520;578;0;0;0;0;.00nan;0;0
28464;43896;573;0;0;0;0;.00nan;0;0
28464;85749;573;93;18;0;18;1.000;3600000;0
28465;6127;575;0;0;0;0;.00nan;0;0
28465;185220;565;0;0;0;0;.00nan;0;0
28465;67614;565;99;27;1;26;.963;3600000;0
28465;86228;575;41;25;4;21;.840;3600000;0
28466;13065;578;73;47;5;42;.894;3600000;0
28466;170144;574;90;30;1;29;.967;3600000;0
28466;35520;578;0;0;0;0;.00nan;0;0
28466;86099;574;0;0;0;0;.00nan;0;0
28467;11925;576;69;27;2;25;.926;3600000;0
28467;179602;564;59;28;3;25;.893;3598000;0
28467;67454;576;0;0;0;0;.00nan;0;0
28467;141419;564;0;0;0;0;.00nan;0;0
28468;483;570;92;32;1;31;.969;3600000;0
28468;14459;566;0;0;0;0;.00nan;0;0
28468;68167;570;0;0;0;0;.00nan;0;0
28468;85633;566;57;43;5;38;.884;3600000;0
28469;174736;577;0;0;0;0;.00nan;0;0
28469;195646;577;81;44;4;40;.909;3550000;0
28469;43896;573;0;0;0;0;.00nan;0;0
28469;85749;573;91;35;2;33;.943;3600000;0
28470;9455;569;0;0;0;0;.00nan;0;0
28470;59592;569;56;20;2;18;.900;3900000;0
28470;59614;562;0;0;0;0;.00nan;0;0
28470;78864;562;93;38;2;36;.947;3900000;0
28471;483;570;0;0;0;0;.00nan;0;0
28471;68167;570;41;20;4;16;.800;3600000;0
28471;73939;572;96;40;1;39;.975;3600000;0
28471;84430;572;0;0;0;0;.00nan;0;0
28472;14459;566;66;30;3;27;.900;3623000;0
28472;85336;568;0;0;0;0;.00nan;0;0
28472;85633;566;0;0;0;0;.00nan;0;0
28472;86875;568;73;28;2;26;.929;3623000;0
28473;6127;575;69;29;2;27;.931;3524000;0
28473;170144;574;0;0;0;0;.00nan;0;0
28473;86099;574;100;28;0;28;1.000;3600000;0
28473;86228;575;0;0;0;0;.00nan;0;0
28474;11925;576;63;19;2;17;.895;3600000;0
28474;174736;577;0;0;0;0;.00nan;0;0
28474;195646;577;70;45;5;40;.889;3600000;0
28474;67454;576;0;0;0;0;.00nan;0;0
28475;9455;569;94;47;2;45;.957;3779000;0
28475;43896;573;0;0;0;0;.00nan;0;0
28475;59592;569;0;0;0;0;.00nan;0;0
28475;85749;573;74;17;1;16;.941;3779000;0
28476;13065;578;49;23;4;19;.826;1230000;0
28476;179602;564;93;18;0;18;1.000;3600000;0
28476;35520;578;48;36;6;30;.833;2370000;0
28476;141419;564;0;0;0;0;.00nan;0;0
28477;185220;565;0;0;0;0;.00nan;0;0
28477;64961;571;100;30;0;30;1.000;3600000;0
28477;67614;565;42;36;6;30;.833;3600000;0
28477;86180;571;0;0;0;0;.00nan;0;0
28478;13065;578;60;36;5;31;.861;3600000;0
28478;35520;578;0;0;0;0;.00nan;0;0
28478;64961;571;67;16;1;15;.938;3600000;0
28478;86180;571;0;0;0;0;.00nan;0;0
28479;170144;574;0;0;0;0;.00nan;0;0
28479;59614;562;86;51;4;47;.922;3575000;0
28479;78864;562;0;0;0;0;.00nan;0;0
28479;86099;574;54;21;3;18;.857;3600000;0
28480;14459;566;0;0;0;0;.00nan;0;0
28480;174736;577;78;36;3;33;.917;3872000;0
28480;195646;577;0;0;0;0;.00nan;0;0
28480;85633;566;55;15;2;13;.867;3872000;0
28481;11925;576;67;27;3;24;.889;3552000;0
28481;185220;565;0;0;0;0;.00nan;0;0
28481;67454;576;0;0;0;0;.00nan;0;0
28481;67614;565;87;30;2;28;.933;3600000;0
28482;483;570;0;0;0;0;.00nan;0;0
28482;9455;569;0;0;0;0;.00nan;0;0
28482;59592;569;85;34;2;32;.941;3600000;0
28482;68167;570;68;19;1;18;.947;3600000;0
28483;483;570;0;0;0;0;.00nan;0;0
28483;6127;575;0;0;0;0;.00nan;0;0
28483;68167;570;75;22;1;21;.955;3751000;0
28483;86228;575;94;45;2;43;.956;3751000;0
28484;59614;562;0;0;0;0;.00nan;0;0
28484;73939;572;0;0;0;0;.00nan;0;0
28484;78864;562;97;37;1;36;.973;3557000;0
28484;84430;572;96;19;0;19;1.000;3600000;0
28485;170144;574;0;0;0;0;.00nan;0;0
28485;85336;568;0;0;0;0;.00nan;0;0
28485;86099;574;29;18;4;14;.778;3600000;0
28485;86875;568;99;39;1;38;.974;3600000;0
28486;14459;566;0;0;0;0;.00nan;0;0
28486;64961;571;0;0;0;0;.00nan;0;0
28486;85633;566;71;35;4;31;.886;3600000;0
28486;86180;571;87;25;1;24;.960;3600000;0
28487;9455;569;0;0;0;0;.00nan;0;0
28487;43896;573;0;0;0;0;.00nan;0;0
28487;59592;569;86;37;2;35;.946;3900000;0
28487;85749;573;58;13;2;11;.846;3900000;0
28488;13065;578;53;20;3;17;.850;3600000;0
28488;174736;577;0;0;0;0;.00nan;0;0
28488;195646;577;93;28;1;27;.964;3600000;0
28488;35520;578;0;0;0;0;.00nan;0;0
28489;185220;565;86;32;1;31;.969;3600000;0
28489;59614;562;65;27;3;24;.889;3555000;0
28489;67614;565;0;0;0;0;.00nan;0;0
28489;78864;562;0;0;0;0;.00nan;0;0
28490;170144;574;88;17;0;17;1.000;3600000;0
28490;85336;568;0;0;0;0;.00nan;0;0
28490;86099;574;0;0;0;0;.00nan;0;0
28490;86875;568;46;31;5;26;.839;3600000;0
28491;14459;566;100;44;0;44;1.000;3600000;0
28491;179602;564;71;35;3;32;.914;3600000;0
28491;85633;566;0;0;0;0;.00nan;0;0
28491;141419;564;0;0;0;0;.00nan;0;0
28492;13065;578;0;0;0;0;.00nan;0;0
28492;35520;578;87;44;2;42;.955;3553000;0
28492;73939;572;0;0;0;0;.00nan;0;0
28492;84430;572;93;19;0;19;1.000;3600000;0
28493;6127;575;97;25;0;25;1.000;3600000;0
28493;43896;573;0;0;0;0;.00nan;0;0
28493;85749;573;63;22;2;20;.909;3518000;0
28493;86228;575;0;0;0;0;.00nan;0;0
28494;9455;569;83;33;2;31;.939;3545000;0
28494;11925;576;85;33;1;32;.970;3600000;0
28494;59592;569;0;0;0;0;.00nan;0;0
28494;67454;576;0;0;0;0;.00nan;0;0
28495;483;570;0;0;0;0;.00nan;0;0
28495;174736;577;45;27;5;22;.815;3600000;0
28495;195646;577;0;0;0;0;.00nan;0;0
28495;68167;570;63;24;2;22;.917;3600000;0
28496;9455;569;0;0;0;0;.00nan;0;0
28496;59592;569;100;37;1;36;.973;3600000;0
28496;73939;572;0;0;0;0;.00nan;0;0
28496;84430;572;61;29;4;25;.862;3600000;0
28497;11925;576;39;25;5;20;.800;3600000;0
28497;64961;571;68;29;2;27;.931;3600000;0
28497;67454;576;0;0;0;0;.00nan;0;0
28497;86180;571;0;0;0;0;.00nan;0;0
28498;14459;566;78;38;3;35;.921;3600000;0
28498;59614;562;72;36;4;32;.889;3567000;0
28498;78864;562;0;0;0;0;.00nan;0;0
28498;85633;566;0;0;0;0;.00nan;0;0
28499;483;570;0;0;0;0;.00nan;0;0
28499;6127;575;94;32;1;31;.969;3600000;0
28499;68167;570;100;21;0;21;1.000;3600000;0
28499;86228;575;0;0;0;0;.00nan;0;0
28500;179602;564;65;24;2;22;.917;3600000;0
28500;43896;573;0;0;0;0;.00nan;0;0
28500;85749;573;62;39;4;35;.897;3556000;0
28500;141419;564;0;0;0;0;.00nan;0;0
28501;174736;577;0;0;0;0;.00nan;0;0
28501;195646;577;58;28;3;25;.893;3600000;0
28501;85336;568;0;0;0;0;.00nan;0;0
28501;86875;568;81;41;4;37;.902;3598000;0
28502;14459;566;0;0;0;0;.00nan;0;0
28502;185220;565;0;0;0;0;.00nan;0;0
28502;67614;565;46;37;6;31;.838;3600000;0
28502;85633;566;72;21;2;19;.905;3600000;0
28503;43896;573;0;0;0;0;.00nan;0;0
28503;73939;572;0;0;0;0;.00nan;0;0
28503;84430;572;74;35;3;32;.914;3600000;0
28503;85749;573;100;20;0;20;1.000;3600000;0
28504;6127;575;0;0;0;0;.00nan;0;0
28504;174736;577;49;28;5;23;.821;3600000;0
28504;195646;577;0;0;0;0;.00nan;0;0
28504;86228;575;72;24;2;22;.917;3600000;0
28505;59614;562;75;47;4;43;.915;3600000;0
28505;64961;571;0;0;0;0;.00nan;0;0
28505;78864;562;0;0;0;0;.00nan;0;0
28505;86180;571;92;21;0;21;1.000;3600000;0
28506;11925;576;100;22;0;22;1.000;3900000;0
28506;170144;574;0;0;0;0;.00nan;0;0
28506;67454;576;0;0;0;0;.00nan;0;0
28506;86099;574;96;30;0;30;1.000;3900000;0
28507;9455;569;0;0;0;0;.00nan;0;0
28507;179602;564;78;24;1;23;.958;3600000;0
28507;59592;569;81;42;3;39;.929;3548000;0
28507;141419;564;0;0;0;0;.00nan;0;0
28508;483;570;0;0;0;0;.00nan;0;0
28508;13065;578;100;52;2;50;.962;3900000;0
28508;35520;578;0;0;0;0;.00nan;0;0
28508;68167;570;65;21;2;19;.905;3900000;0
28509;9455;569;60;21;2;19;.905;3900000;0
28509;14459;566;50;18;2;16;.889;3900000;0
28509;59592;569;0;0;0;0;.00nan;0;0
28509;85633;566;0;0;0;0;.00nan;0;0
28510;59614;562;0;0;0;0;.00nan;0;0
28510;64961;571;0;0;0;0;.00nan;0;0
28510;78864;562;100;30;1;29;.967;3600000;0
28510;86180;571;60;18;2;16;.889;3600000;0
28511;13065;578;43;5;1;4;.800;366000;0
28511;179602;564;70;18;2;16;.889;3600000;0
28511;35520;578;66;49;6;43;.878;3234000;0
28511;141419;564;0;0;0;0;.00nan;0;0
28512;43896;573;0;0;0;0;.00nan;0;0
28512;73939;572;53;28;4;24;.857;3569000;0
28512;84430;572;0;0;0;0;.00nan;0;0
28512;85749;573;54;23;3;20;.870;3600000;0
28513;185220;565;0;0;0;0;.00nan;0;0
28513;67614;565;95;31;2;29;.935;3600000;0
28513;85336;568;0;0;0;0;.00nan;0;0
28513;86875;568;61;23;3;20;.870;3600000;0
28514;6127;575;24;29;6;23;.793;3600000;0
28514;174736;577;0;0;0;0;.00nan;0;0
28514;195646;577;92;47;3;44;.936;3600000;0
28514;86228;575;0;0;0;0;.00nan;0;0
28515;483;570;48;19;3;16;.842;3600000;0
28515;11925;576;68;38;4;34;.895;3600000;0
28515;67454;576;0;0;0;0;.00nan;0;0
28515;68167;570;0;0;0;0;.00nan;0;0
28516;64961;571;73;21;2;19;.905;3600000;0
28516;73939;572;0;0;0;0;.00nan;0;0
28516;84430;572;99;40;1;39;.975;3600000;0
28516;86180;571;0;0;0;0;.00nan;0;0
28517;170144;574;0;0;0;0;.00nan;0;0
28517;179602;564;33;18;4;14;.778;3515000;0
28517;86099;574;91;47;2;45;.957;3600000;0
28517;141419;564;0;0;0;0;.00nan;0;0
28518;59614;562;47;34;5;29;.853;3600000;0
28518;78864;562;0;0;0;0;.00nan;0;0
28518;85336;568;78;22;1;21;.955;3600000;0
28518;86875;568;0;0;0;0;.00nan;0;0
28519;11925;576;78;24;1;23;.958;3900000;0
28519;174736;577;0;0;0;0;.00nan;0;0
28519;195646;577;92;30;1;29;.967;3900000;0
28519;67454;576;0;0;0;0;.00nan;0;0
28520;483;570;0;0;0;0;.00nan;0;0
28520;43896;573;0;0;0;0;.00nan;0;0
28520;68167;570;100;25;0;25;1.000;3600000;0
28520;85749;573;97;41;2;39;.951;3579000;0
28521;6127;575;0;0;0;0;.00nan;0;0
28521;179602;564;78;26;1;25;.962;3600000;0
28521;86228;575;77;39;4;35;.897;3600000;0
28521;141419;564;0;0;0;0;.00nan;0;0
28522;9455;569;0;0;0;0;.00nan;0;0
28522;185220;565;0;0;0;0;.00nan;0;0
28522;59592;569;74;40;4;36;.900;3600000;0
28522;67614;565;42;28;5;23;.821;3577000;0
28523;170144;574;0;0;0;0;.00nan;0;0
28523;73939;572;80;41;2;39;.951;3900000;0
28523;84430;572;0;0;0;0;.00nan;0;0
28523;86099;574;46;12;2;10;.833;3900000;0
28524;6127;575;93;42;3;39;.929;3900000;0
28524;11925;576;60;32;4;28;.875;3900000;0
28524;67454;576;0;0;0;0;.00nan;0;0
28524;86228;575;0;0;0;0;.00nan;0;0
28525;13065;578;61;38;5;33;.868;3600000;0
28525;185220;565;42;15;3;12;.800;3600000;0
28525;35520;578;0;0;0;0;.00nan;0;0
28525;67614;565;0;0;0;0;.00nan;0;0
28526;9455;569;68;41;3;38;.927;3860000;0
28526;59592;569;0;0;0;0;.00nan;0;0
28526;64961;571;52;21;3;18;.857;3900000;0
28526;86180;571;0;0;0;0;.00nan;0;0
28527;179602;564;66;29;3;26;.897;3600000;0
28527;85336;568;0;0;0;0;.00nan;0;0
28527;86875;568;100;27;0;27;1.000;3600000;0
28527;141419;564;0;0;0;0;.00nan;0;0
28528;174736;577;0;0;0;0;.00nan;0;0
28528;195646;577;85;37;2;35;.946;3900000;0
28528;43896;573;0;0;0;0;.00nan;0;0
28528;85749;573;72;32;2;30;.938;3900000;0
28529;9455;569;73;32;3;29;.906;3600000;0
28529;170144;574;0;0;0;0;.00nan;0;0
28529;59592;569;0;0;0;0;.00nan;0;0
28529;86099;574;60;21;2;19;.905;3600000;0
28530;483;570;0;0;0;0;.00nan;0;0
28530;185220;565;0;0;0;0;.00nan;0;0
28530;67614;565;68;45;5;40;.889;3600000;0
28530;68167;570;83;15;0;15;1.000;3600000;0
28531;14459;566;0;0;0;0;.00nan;0;0
28531;43896;573;81;28;1;27;.964;3600000;0
28531;85633;566;42;31;5;26;.839;3600000;0
28531;85749;573;0;0;0;0;.00nan;0;0
28532;179602;564;49;36;5;31;.861;3600000;0
28532;85336;568;0;0;0;0;.00nan;0;0
28532;86875;568;95;24;0;24;1.000;3600000;0
28532;141419;564;0;0;0;0;.00nan;0;0
28533;6127;575;0;0;0;0;.00nan;0;0
28533;73939;572;0;0;0;0;.00nan;0;0
28533;84430;572;74;28;2;26;.929;3600000;0
28533;86228;575;55;25;3;22;.880;3600000;0
28534;174736;577;95;26;0;26;1.000;3600000;0
28534;195646;577;0;0;0;0;.00nan;0;0
28534;59614;562;67;37;3;34;.919;3600000;0
28534;78864;562;0;0;0;0;.00nan;0;0
28535;11925;576;75;18;1;17;.944;3600000;0
28535;13065;578;69;37;3;34;.919;3566000;0
28535;35520;578;0;0;0;0;.00nan;0;0
28535;67454;576;0;0;0;0;.00nan;0;0
28536;170144;574;67;18;1;17;.944;3600000;0
28536;185220;565;0;0;0;0;.00nan;0;0
28536;67614;565;70;37;4;33;.892;3600000;0
28536;86099;574;0;0;0;0;.00nan;0;0
28537;483;570;0;0;0;0;.00nan;0;0
28537;14459;566;0;0;0;0;.00nan;0;0
28537;68167;570;56;27;3;24;.889;3900000;0
28537;85633;566;85;37;3;34;.919;3900000;0
28538;9455;569;0;0;0;0;.00nan;0;0
28538;59592;569;85;24;1;23;.958;3600000;0
28538;73939;572;48;0;0;0;.00nan;734000;0
28538;84430;572;33;24;6;18;.750;2866000;0
28539;64961;571;0;0;0;0;.00nan;0;0
28539;85336;568;0;0;0;0;.00nan;0;0
28539;86180;571;78;25;1;24;.960;3545000;0
28539;86875;568;86;18;0;18;1.000;3600000;0
28540;6127;575;0;0;0;0;.00nan;0;0
28540;59614;562;68;31;3;28;.903;3846000;0
28540;78864;562;0;0;0;0;.00nan;0;0
28540;86228;575;70;34;3;31;.912;3900000;0
28541;11925;576;69;29;2;27;.931;3661000;0
28541;43896;573;0;0;0;0;.00nan;0;0
28541;67454;576;0;0;0;0;.00nan;0;0
28541;85749;573;94;32;1;31;.969;3661000;0
28542;13065;578;95;56;4;52;.929;3516000;0
28542;174736;577;55;16;2;14;.875;3600000;0
28542;195646;577;0;0;0;0;.00nan;0;0
28542;35520;578;0;0;0;0;.00nan;0;0
28543;14459;566;0;0;0;0;.00nan;0;0
28543;170144;574;0;0;0;0;.00nan;0;0
28543;85633;566;90;30;1;29;.967;3600000;0
28543;86099;574;63;26;2;24;.923;3600000;0
28544;483;570;0;0;0;0;.00nan;0;0
28544;68167;570;29;14;4;10;.714;3546000;0
28544;85336;568;0;0;0;0;.00nan;0;0
28544;86875;568;69;29;3;26;.897;3600000;0
28545;43896;573;0;0;0;0;.00nan;0;0
28545;64961;571;60;25;3;22;.880;3569000;0
28545;85749;573;71;29;2;27;.931;3600000;0
28545;86180;571;0;0;0;0;.00nan;0;0
28546;6127;575;0;0;0;0;.00nan;0;0
28546;13065;578;74;37;4;33;.892;3600000;0
28546;35520;578;0;0;0;0;.00nan;0;0
28546;86228;575;77;20;1;19;.950;3600000;0
28547;11925;576;81;43;3;40;.930;3531000;0
28547;179602;564;80;22;1;21;.955;3600000;0
28547;67454;576;0;0;0;0;.00nan;0;0
28547;141419;564;0;0;0;0;.00nan;0;0
28548;9455;569;89;30;1;29;.967;3900000;0
28548;174736;577;0;0;0;0;.00nan;0;0
28548;195646;577;93;31;1;30;.968;3900000;0
28548;59592;569;0;0;0;0;.00nan;0;0
28549;185220;565;0;0;0;0;.00nan;0;0
28549;67614;565;80;42;2;40;.952;3559000;0
28549;73939;572;0;0;0;0;.00nan;0;0
28549;84430;572;100;36;0;36;1.000;3600000;0
28550;174736;577;0;0;0;0;.00nan;0;0
28550;195646;577;100;25;0;25;1.000;3600000;0
28550;64961;571;0;0;0;0;.00nan;0;0
28550;86180;571;82;34;2;32;.941;3517000;0
28551;179602;564;0;0;0;0;.00nan;0;0
28551;73939;572;0;0;0;0;.00nan;0;0
28551;84430;572;85;51;3;48;.941;3568000;0
28551;141419;564;70;14;1;13;.929;3600000;0
28552;483;570;0;0;0;0;.00nan;0;0
28552;59614;562;65;35;3;32;.914;3600000;0
28552;68167;570;78;28;1;27;.964;3600000;0
28552;78864;562;0;0;0;0;.00nan;0;0
28553;14459;566;29;31;6;25;.806;3234000;0
28553;179602;564;33;16;4;12;.750;3600000;0
28553;85633;566;31;8;3;5;.625;366000;0
28553;141419;564;0;0;0;0;.00nan;0;0
28554;43896;573;0;0;0;0;.00nan;0;0
28554;59614;562;72;34;2;32;.941;3600000;0
28554;78864;562;0;0;0;0;.00nan;0;0
28554;85749;573;60;27;3;24;.889;3561000;0
28555;19473;569;0;0;0;0;.00nan;0;0
28555;174736;577;0;0;0;0;.00nan;0;0
28555;195646;577;95;29;1;28;.966;3600000;0
28555;59592;569;51;22;3;19;.864;3522000;0
28556;13065;578;41;44;7;37;.841;3600000;0
28556;35520;578;0;0;0;0;.00nan;0;0
28556;73939;572;71;22;1;21;.955;3600000;0
28556;84430;572;0;0;0;0;.00nan;0;0
28557;170144;574;72;27;2;25;.926;3600000;0
28557;64961;571;0;0;0;0;.00nan;0;0
28557;86099;574;0;0;0;0;.00nan;0;0
28557;86180;571;76;37;4;33;.892;3589000;0
28558;6127;575;0;0;0;0;.00nan;0;0
28558;185220;565;0;0;0;0;.00nan;0;0
28558;67614;565;38;21;4;17;.810;3569000;0
28558;86228;575;72;35;3;32;.914;3600000;0
28559;14459;566;0;0;0;0;.00nan;0;0
28559;73939;572;76;37;3;34;.919;3600000;0
28559;84430;572;0;0;0;0;.00nan;0;0
28559;85633;566;94;24;0;24;1.000;3600000;0
28560;483;570;0;0;0;0;.00nan;0;0
28560;19473;569;0;0;0;0;.00nan;0;0
28560;59592;569;59;31;4;27;.871;3533000;0
28560;68167;570;65;22;2;20;.909;3600000;0
28561;9455;568;0;0;0;0;.00nan;0;0
28561;43896;573;0;0;0;0;.00nan;0;0
28561;85749;573;67;32;3;29;.906;3547000;0
28561;86875;568;82;31;2;29;.935;3600000;0
28562;11925;576;69;21;1;20;.952;3600000;0
28562;13065;578;66;52;6;46;.885;3211000;0
28562;35520;578;56;5;0;5;1.000;389000;0
28562;67454;576;0;0;0;0;.00nan;0;0
28563;6127;575;0;0;0;0;.00nan;0;0
28563;170144;574;92;29;1;28;.966;3852000;0
28563;86099;574;0;0;0;0;.00nan;0;0
28563;86228;575;100;47;0;47;1.000;3852000;0
28564;9455;568;0;0;0;0;.00nan;0;0
28564;43896;573;0;0;0;0;.00nan;0;0
28564;85749;573;40;24;4;20;.833;3900000;0
28564;86875;568;50;29;4;25;.862;3900000;0
28565;59614;562;68;30;3;27;.900;3575000;0
28565;64961;571;88;29;1;28;.966;3600000;0
28565;78864;562;0;0;0;0;.00nan;0;0
28565;86180;571;0;0;0;0;.00nan;0;0
28566;483;570;88;33;2;31;.939;3600000;0
28566;174736;577;65;11;0;11;1.000;1613000;0
28566;195646;577;43;23;4;19;.826;1987000;0
28566;68167;570;0;0;0;0;.00nan;0;0
28567;14459;566;0;0;0;0;.00nan;0;0
28567;19473;569;97;41;0;41;1.000;3900000;0
28567;59592;569;0;0;0;0;.00nan;0;0
28567;85633;566;100;18;0;18;1.000;3900000;0
28568;11925;576;86;29;1;28;.966;3600000;0
28568;185220;565;52;35;4;31;.886;3600000;0
28568;67454;576;0;0;0;0;.00nan;0;0
28568;67614;565;0;0;0;0;.00nan;0;0
28569;13065;578;0;0;0;0;.00nan;0;0
28569;179602;564;61;22;2;20;.909;3565000;0
28569;35520;578;100;43;1;42;.977;3600000;0
28569;141419;564;0;0;0;0;.00nan;0;0
28570;483;570;0;0;0;0;.00nan;0;0
28570;43896;573;0;0;0;0;.00nan;0;0
28570;68167;570;100;27;0;27;1.000;3600000;0
28570;85749;573;51;45;6;39;.867;3600000;0
28571;9455;568;0;0;0;0;.00nan;0;0
28571;170144;574;67;33;3;30;.909;3900000;0
28571;86099;574;0;0;0;0;.00nan;0;0
28571;86875;568;68;28;3;25;.893;3900000;0
28572;11925;576;100;21;0;21;1.000;3600000;0
28572;67454;576;0;0;0;0;.00nan;0;0
28572;73939;572;97;41;1;40;.976;3544000;0
28572;84430;572;0;0;0;0;.00nan;0;0
28573;174736;577;0;0;0;0;.00nan;0;0
28573;195646;577;100;25;0;25;1.000;3600000;0
28573;185220;565;0;0;0;0;.00nan;0;0
28573;67614;565;63;45;5;40;.889;3600000;0
28574;6127;575;0;0;0;0;.00nan;0;0
28574;13065;578;96;58;2;56;.966;3900000;0
28574;35520;578;0;0;0;0;.00nan;0;0
28574;86228;575;89;34;2;32;.941;3900000;0
28575;43896;573;0;0;0;0;.00nan;0;0
28575;64961;571;78;30;2;28;.933;3600000;0
28575;85749;573;51;27;4;23;.852;3536000;0
28575;86180;571;0;0;0;0;.00nan;0;0
28576;6127;575;0;0;0;0;.00nan;0;0
28576;14459;566;0;0;0;0;.00nan;0;0
28576;85633;566;53;29;4;25;.862;3600000;0
28576;86228;575;67;44;5;39;.886;3600000;0
28577;174736;577;0;0;0;0;.00nan;0;0
28577;195646;577;62;37;5;32;.865;3600000;0
28577;179602;564;0;0;0;0;.00nan;0;0
28577;141419;564;86;31;1;30;.968;3600000;0
28578;59614;562;97;18;0;18;1.000;3600000;0
28578;73939;572;0;0;0;0;.00nan;0;0
28578;78864;562;0;0;0;0;.00nan;0;0
28578;84430;572;66;34;3;31;.912;3600000;0
28579;9455;568;0;0;0;0;.00nan;0;0
28579;11925;576;100;35;1;34;.971;3600000;0
28579;67454;576;0;0;0;0;.00nan;0;0
28579;86875;568;72;27;2;25;.926;3547000;0
28580;483;570;0;0;0;0;.00nan;0;0
28580;185220;565;0;0;0;0;.00nan;0;0
28580;67614;565;96;36;2;34;.944;3600000;0
28580;68167;570;61;24;3;21;.875;3543000;0
28581;13065;578;95;42;2;40;.952;3600000;0
28581;19473;569;31;23;4;19;.826;3514000;0
28581;35520;578;0;0;0;0;.00nan;0;0
28581;59592;569;0;0;0;0;.00nan;0;0
28582;11925;576;67;34;5;29;.853;3564000;0
28582;170144;574;47;16;3;13;.813;3600000;0
28582;67454;576;0;0;0;0;.00nan;0;0
28582;86099;574;0;0;0;0;.00nan;0;0
28583;13065;578;0;0;0;0;.00nan;0;0
28583;35520;578;100;34;0;34;1.000;3600000;0
28583;43896;573;0;0;0;0;.00nan;0;0
28583;85749;573;66;24;3;21;.875;3600000;0
28584;6127;575;84;31;2;29;.935;3600000;0
28584;9455;568;0;0;0;0;.00nan;0;0
28584;86228;575;0;0;0;0;.00nan;0;0
28584;86875;568;55;31;5;26;.839;3600000;0
28585;174736;577;76;26;1;25;.962;3600000;0
28585;195646;577;0;0;0;0;.00nan;0;0
28585;59614;562;64;36;4;32;.889;3600000;0
28585;78864;562;0;0;0;0;.00nan;0;0
28586;19473;569;0;0;0;0;.00nan;0;0
28586;59592;569;99;45;2;43;.956;3607000;0
28586;64961;571;0;0;0;0;.00nan;0;0
28586;86180;571;51;19;3;16;.842;3607000;0
28587;483;570;0;0;0;0;.00nan;0;0
28587;68167;570;84;17;0;17;1.000;3600000;0
28587;73939;572;82;33;2;31;.939;3579000;0
28587;84430;572;0;0;0;0;.00nan;0;0
28588;185220;565;0;0;0;0;.00nan;0;0
28588;64961;571;56;18;2;16;.889;3579000;0
28588;67614;565;100;41;1;40;.976;3600000;0
28588;86180;571;0;0;0;0;.00nan;0;0
28589;179602;564;70;28;2;26;.929;3549000;0
28589;64961;571;0;0;0;0;.00nan;0;0
28589;86180;571;100;36;0;36;1.000;3600000;0
28589;141419;564;0;0;0;0;.00nan;0;0
28590;11925;576;46;26;4;22;.846;3600000;0
28590;14459;566;51;21;3;18;.857;3600000;0
28590;67454;576;0;0;0;0;.00nan;0;0
28590;85633;566;0;0;0;0;.00nan;0;0
28591;185220;565;0;0;0;0;.00nan;0;0
28591;43896;573;0;0;0;0;.00nan;0;0
28591;67614;565;84;44;3;41;.932;3600000;0
28591;85749;573;89;31;2;29;.935;3600000;0
28592;9455;568;0;0;0;0;.00nan;0;0
28592;174736;577;0;0;0;0;.00nan;0;0
28592;195646;577;55;31;4;27;.871;3600000;0
28592;86875;568;95;37;1;36;.973;3600000;0
28593;6127;575;0;0;0;0;.00nan;0;0
28593;19473;569;0;0;0;0;.00nan;0;0
28593;59592;569;59;32;4;28;.875;3576000;0
28593;86228;575;80;35;3;32;.914;3600000;0
28594;170144;574;67;28;3;25;.893;3900000;0
28594;59614;562;0;0;0;0;.00nan;0;0
28594;78864;562;79;42;3;39;.929;3900000;0
28594;86099;574;0;0;0;0;.00nan;0;0
28595;11925;576;67;28;3;25;.893;3600000;0
28595;19473;569;71;26;2;24;.923;3600000;0
28595;59592;569;0;0;0;0;.00nan;0;0
28595;67454;576;0;0;0;0;.00nan;0;0
28596;9455;568;0;0;0;0;.00nan;0;0
28596;14459;566;0;0;0;0;.00nan;0;0
28596;85633;566;65;26;3;23;.885;3574000;0
28596;86875;568;79;29;2;27;.931;3600000;0
28597;483;570;0;0;0;0;.00nan;0;0
28597;179602;564;100;32;1;31;.969;3600000;0
28597;68167;570;75;29;2;27;.931;3542000;0
28597;141419;564;0;0;0;0;.00nan;0;0
28598;43896;573;0;0;0;0;.00nan;0;0
28598;59614;562;56;21;3;18;.857;3600000;0
28598;78864;562;0;0;0;0;.00nan;0;0
28598;85749;573;47;33;5;28;.848;3598000;0
28599;174736;577;0;0;0;0;.00nan;0;0
28599;195646;577;57;17;2;15;.882;3600000;0
28599;73939;572;0;0;0;0;.00nan;0;0
28599;84430;572;72;45;5;40;.889;3600000;0
28600;13065;578;68;21;1;20;.952;1292000;0
28600;170144;574;60;22;2;20;.909;3600000;0
28600;35520;578;32;26;6;20;.769;2308000;0
28600;86099;574;0;0;0;0;.00nan;0;0
28601;19473;569;0;0;0;0;.00nan;0;0
28601;185220;565;0;0;0;0;.00nan;0;0
28601;59592;569;74;19;1;18;.947;3900000;0
28601;67614;565;93;37;1;36;.973;3900000;0
28602;483;570;0;0;0;0;.00nan;0;0
28602;170144;574;100;28;0;28;1.000;3600000;0
28602;68167;570;63;23;2;21;.913;3580000;0
28602;86099;574;0;0;0;0;.00nan;0;0
28603;179602;564;99;36;1;35;.972;3600000;0
28603;43896;573;0;0;0;0;.00nan;0;0
28603;85749;573;59;42;5;37;.881;3600000;0
28603;141419;564;0;0;0;0;.00nan;0;0
28604;174736;577;56;28;3;25;.893;3600000;0
28604;195646;577;0;0;0;0;.00nan;0;0
28604;73939;572;69;43;5;38;.884;3573000;0
28604;84430;572;0;0;0;0;.00nan;0;0
28605;9455;568;84;27;1;26;.963;3600000;0
28605;14459;566;63;33;3;30;.909;3555000;0
28605;85633;566;0;0;0;0;.00nan;0;0
28605;86875;568;0;0;0;0;.00nan;0;0
28606;6127;575;0;0;0;0;.00nan;0;0
28606;64961;571;0;0;0;0;.00nan;0;0
28606;86180;571;60;15;1;14;.933;3600000;0
28606;86228;575;89;39;2;37;.949;3600000;0
28607;11925;576;0;0;0;0;.00nan;0;0
28607;59614;562;60;37;5;32;.865;3600000;0
28607;67454;576;100;29;0;29;1.000;3600000;0
28607;78864;562;0;0;0;0;.00nan;0;0
28608;483;570;0;0;0;0;.00nan;0;0
28608;13065;578;90;36;1;35;.972;3600000;0
28608;35520;578;0;0;0;0;.00nan;0;0
28608;68167;570;57;17;2;15;.882;3556000;0
28609;174736;577;0;0;0;0;.00nan;0;0
28609;195646;577;64;40;5;35;.875;3600000;0
28609;64961;571;82;22;1;21;.955;3600000;0
28609;86180;571;0;0;0;0;.00nan;0;0
28610;19473;569;0;0;0;0;.00nan;0;0
28610;59592;569;81;27;1;26;.963;3900000;0
28610;59614;562;100;38;1;37;.974;3900000;0
28610;78864;562;0;0;0;0;.00nan;0;0
28611;14459;566;0;0;0;0;.00nan;0;0
28611;170144;574;55;28;4;24;.857;3543000;0
28611;85633;566;81;31;3;28;.903;3600000;0
28611;86099;574;0;0;0;0;.00nan;0;0
28612;64961;571;0;0;0;0;.00nan;0;0
28612;73939;572;0;0;0;0;.00nan;0;0
28612;84430;572;96;47;2;45;.957;3592000;0
28612;86180;571;78;20;1;19;.950;3600000;0
28613;6127;575;0;0;0;0;.00nan;0;0
28613;43896;573;0;0;0;0;.00nan;0;0
28613;85749;573;93;19;0;19;1.000;3600000;0
28613;86228;575;77;51;4;47;.922;3600000;0
28614;6127;575;98;52;4;48;.923;3600000;0
28614;9455;568;0;0;0;0;.00nan;0;0
28614;86228;575;0;0;0;0;.00nan;0;0
28614;86875;568;85;16;0;16;1.000;3600000;0
28615;13065;578;83;48;4;44;.917;3787000;0
28615;35520;578;0;0;0;0;.00nan;0;0
28615;59614;562;65;22;3;19;.864;3787000;0
28615;78864;562;0;0;0;0;.00nan;0;0
28616;170144;574;68;20;2;18;.900;3600000;0
28616;43896;573;0;0;0;0;.00nan;0;0
28616;85749;573;89;39;3;36;.923;3590000;0
28616;86099;574;0;0;0;0;.00nan;0;0
28617;14459;566;0;0;0;0;.00nan;0;0
28617;185220;565;0;0;0;0;.00nan;0;0
28617;67614;565;70;25;2;23;.920;3600000;0
28617;85633;566;62;27;3;24;.889;3580000;0
28618;19473;569;0;0;0;0;.00nan;0;0
28618;179602;564;90;15;0;15;1.000;3600000;0
28618;59592;569;70;26;2;24;.923;3562000;0
28618;141419;564;0;0;0;0;.00nan;0;0
28619;483;570;0;0;0;0;.00nan;0;0
28619;11925;576;0;0;0;0;.00nan;0;0
28619;67454;576;44;18;3;15;.833;3562000;0
28619;68167;570;71;29;2;27;.931;3600000;0
28620;9455;568;0;0;0;0;.00nan;0;0
28620;19473;569;62;28;3;25;.893;3900000;0
28620;59592;569;0;0;0;0;.00nan;0;0
28620;86875;568;79;29;3;26;.897;3900000;0
28621;483;570;89;51;3;48;.941;3893000;0
28621;64961;571;61;27;3;24;.889;3900000;0
28621;68167;570;0;0;0;0;.00nan;0;0
28621;86180;571;0;0;0;0;.00nan;0;0
28622;43896;573;46;11;2;9;.818;3900000;0
28622;73939;572;0;0;0;0;.00nan;0;0
28622;84430;572;100;40;2;38;.950;3900000;0
28622;85749;573;0;0;0;0;.00nan;0;0
28623;6127;575;0;0;0;0;.00nan;0;0
28623;11925;576;84;24;2;22;.917;3600000;0
28623;67454;576;0;0;0;0;.00nan;0;0
28623;86228;575;74;36;3;33;.917;3544000;0
28624;185220;565;45;6;1;5;.833;265000;0
28624;59614;562;95;30;1;29;.967;3600000;0
28624;67614;565;44;35;6;29;.829;3335000;0
28624;78864;562;0;0;0;0;.00nan;0;0
28625;170144;574;44;38;6;32;.842;3600000;0
28625;174736;577;0;0;0;0;.00nan;0;0
28625;195646;577;81;28;2;26;.929;3600000;0
28625;86099;574;0;0;0;0;.00nan;0;0
28626;13065;578;70;35;4;31;.886;3900000;0
28626;14459;566;31;8;3;5;.625;546000;0
28626;35520;578;0;0;0;0;.00nan;0;0
28626;85633;566;63;15;1;14;.933;3354000;0
28627;14459;566;0;0;0;0;.00nan;0;0
28627;43896;573;0;0;0;0;.00nan;0;0
28627;85633;566;78;35;3;32;.914;3562000;0
28627;85749;573;82;27;2;25;.926;3600000;0
28628;9455;568;0;0;0;0;.00nan;0;0
28628;73939;572;0;0;0;0;.00nan;0;0
28628;84430;572;63;24;3;21;.875;3600000;0
28628;86875;568;64;20;1;19;.950;3600000;0
28629;483;570;0;0;0;0;.00nan;0;0
28629;59614;562;98;32;1;31;.969;3600000;0
28629;68167;570;90;23;0;23;1.000;3600000;0
28629;78864;562;0;0;0;0;.00nan;0;0
28630;11925;576;75;32;2;30;.938;3556000;0
28630;174736;577;0;0;0;0;.00nan;0;0
28630;195646;577;84;29;1;28;.966;3600000;0
28630;67454;576;0;0;0;0;.00nan;0;0
28631;19473;569;0;0;0;0;.00nan;0;0
28631;170144;574;17;26;7;19;.731;3600000;0
28631;59592;569;87;43;3;40;.930;3600000;0
28631;86099;574;0;0;0;0;.00nan;0;0
28632;179602;564;64;27;3;24;.889;3837000;0
28632;185220;565;0;0;0;0;.00nan;0;0
28632;67614;565;92;38;2;36;.947;3837000;0
28632;141419;564;0;0;0;0;.00nan;0;0
28633;13065;578;66;49;5;44;.898;3600000;0
28633;35520;578;0;0;0;0;.00nan;0;0
28633;64961;571;0;0;0;0;.00nan;0;0
28633;86180;571;53;15;2;13;.867;3600000;0
28635;483;570;0;0;0;0;.00nan;0;0
28635;6127;575;0;0;0;0;.00nan;0;0
28635;185232;575;51;41;6;35;.854;3600000;0
28635;68167;570;64;25;3;22;.880;3600000;0
28637;170144;574;0;0;0;0;.00nan;0;0
28637;176963;574;40;24;5;19;.792;3900000;0
28637;73939;572;44;31;5;26;.839;3900000;0
28637;84430;572;0;0;0;0;.00nan;0;0
28639;174736;577;0;0;0;0;.00nan;0;0
28639;195646;577;65;25;2;23;.920;3600000;0
28639;185220;565;0;0;0;0;.00nan;0;0
28639;67614;565;62;37;4;33;.892;3584000;0
28641;169493;564;0;0;0;0;.00nan;0;0
28641;179602;564;76;19;1;18;.947;3600000;0
28641;185744;568;60;46;6;40;.870;3600000;0
28641;56126;568;0;0;0;0;.00nan;0;0
28643;13065;578;100;46;2;44;.957;3900000;0
28643;-1;571;0;0;0;0;.00nan;0;0
28643;35520;578;0;0;0;0;.00nan;0;0
28643;64961;571;67;22;2;20;.909;3900000;0
28645;11925;576;26;35;7;28;.800;3600000;0
28645;43896;573;65;14;1;13;.929;3600000;0
28645;67454;576;0;0;0;0;.00nan;0;0
28645;153618;573;0;0;0;0;.00nan;0;0
28647;7063;566;93;32;1;31;.969;3600000;0
28647;14459;562;84;46;4;42;.913;3600000;0
28647;67626;566;0;0;0;0;.00nan;0;0
28647;155917;562;0;0;0;0;.00nan;0;0
28649;-1;571;0;0;0;0;.00nan;0;0
28649;185744;568;79;28;2;26;.929;3600000;0
28649;56126;568;0;0;0;0;.00nan;0;0
28649;64961;571;59;29;3;26;.897;3580000;0
28651;483;570;0;0;0;0;.00nan;0;0
28651;19473;569;0;0;0;0;.00nan;0;0
28651;190423;569;94;29;1;28;.966;3600000;0
28651;68167;570;52;24;3;21;.875;3516000;0
28653;169493;564;0;0;0;0;.00nan;0;0
28653;179602;564;51;14;2;12;.857;3600000;0
28653;185220;565;0;0;0;0;.00nan;0;0
28653;67614;565;48;35;5;30;.857;3600000;0
28655;7063;566;100;25;0;25;1.000;3600000;0
28655;43896;573;51;28;4;24;.857;3600000;0
28655;67626;566;0;0;0;0;.00nan;0;0
28655;153618;573;0;0;0;0;.00nan;0;0
28657;6127;575;88;41;3;38;.927;3600000;0
28657;11925;576;43;22;4;18;.818;3565000;0
28657;185232;575;0;0;0;0;.00nan;0;0
28657;67454;576;0;0;0;0;.00nan;0;0
28659;13065;578;83;45;3;42;.933;3574000;0
28659;174736;577;0;0;0;0;.00nan;0;0
28659;195646;577;70;22;1;21;.955;3600000;0
28659;35520;578;0;0;0;0;.00nan;0;0
28661;170144;574;0;0;0;0;.00nan;0;0
28661;176963;574;99;35;1;34;.971;3600000;0
28661;73939;572;0;0;0;0;.00nan;0;0
28661;84430;572;59;32;4;28;.875;3600000;0
28663;7063;566;64;23;2;21;.913;3600000;0
28663;169493;564;71;33;3;30;.909;3600000;0
28663;179602;564;0;0;0;0;.00nan;0;0
28663;67626;566;0;0;0;0;.00nan;0;0
28665;483;570;45;24;4;20;.833;3749000;0
28665;185220;565;69;49;5;44;.898;3749000;0
28665;67614;565;0;0;0;0;.00nan;0;0
28665;68167;570;0;0;0;0;.00nan;0;0
28667;170144;574;90;25;1;24;.960;3600000;0
28667;176963;574;0;0;0;0;.00nan;0;0
28667;43896;573;73;27;2;25;.926;3576000;0
28667;153618;573;0;0;0;0;.00nan;0;0
28669;13065;578;0;0;0;0;.00nan;0;0
28669;14459;562;56;16;2;14;.875;3586000;0
28669;35520;578;100;31;0;31;1.000;3600000;0
28669;155917;562;0;0;0;0;.00nan;0;0
28671;11925;576;0;0;0;0;.00nan;0;0
28671;-1;571;51;41;5;36;.878;3563000;0
28671;64961;571;0;0;0;0;.00nan;0;0
28671;67454;576;72;33;4;29;.879;3600000;0
28673;6127;575;52;13;1;12;.923;264000;0
28673;185232;575;42;35;6;29;.829;3336000;0
28673;185744;568;0;0;0;0;.00nan;0;0
28673;56126;568;61;16;2;14;.875;3600000;0
28675;19473;569;82;32;3;29;.906;3600000;0
28675;190423;569;0;0;0;0;.00nan;0;0
28675;73939;572;48;35;5;30;.857;3560000;0
28675;84430;572;0;0;0;0;.00nan;0;0
28677;6127;575;59;29;3;26;.897;3600000;0
28677;185220;565;0;0;0;0;.00nan;0;0
28677;185232;575;0;0;0;0;.00nan;0;0
28677;67614;565;60;21;2;19;.905;3600000;0
28679;14459;562;0;0;0;0;.00nan;0;0
28679;170144;574;0;0;0;0;.00nan;0;0
28679;176963;574;54;38;5;33;.868;3567000;0
28679;155917;562;51;24;4;20;.833;3600000;0
28681;19473;569;0;0;0;0;.00nan;0;0
28681;174736;577;62;18;2;16;.889;3600000;0
28681;195646;577;0;0;0;0;.00nan;0;0
28681;190423;569;67;39;4;35;.897;3600000;0
28683;7063;566;0;0;0;0;.00nan;0;0
28683;169493;564;0;0;0;0;.00nan;0;0
28683;179602;564;41;14;3;11;.786;3900000;0
28683;67626;566;100;44;3;41;.932;3900000;0
28685;13065;578;0;0;0;0;.00nan;0;0
28685;35520;578;84;44;3;41;.932;3600000;0
28685;185744;568;92;20;0;20;1.000;3600000;0
28685;56126;568;0;0;0;0;.00nan;0;0
28687;11925;576;61;33;4;29;.879;3600000;0
28687;43896;573;66;28;3;25;.893;3600000;0
28687;67454;576;0;0;0;0;.00nan;0;0
28687;153618;573;0;0;0;0;.00nan;0;0
28689;-1;571;0;0;0;0;.00nan;0;0
28689;64961;571;48;31;4;27;.871;3600000;0
28689;73939;572;91;41;2;39;.951;3600000;0
28689;84430;572;0;0;0;0;.00nan;0;0
28691;7063;566;71;21;1;20;.952;3600000;0
28691;170144;574;51;24;3;21;.875;3554000;0
28691;176963;574;0;0;0;0;.00nan;0;0
28691;67626;566;0;0;0;0;.00nan;0;0
28693;14459;562;100;33;0;33;1.000;3600000;0
28693;-1;571;52;32;4;28;.875;3600000;0
28693;64961;571;0;0;0;0;.00nan;0;0
28693;155917;562;0;0;0;0;.00nan;0;0
28695;13065;578;84;46;4;42;.913;3572000;0
28695;174736;577;0;0;0;0;.00nan;0;0
28695;195646;577;54;17;2;15;.882;3600000;0
28695;35520;578;0;0;0;0;.00nan;0;0
28697;11925;576;0;0;0;0;.00nan;0;0
28697;169493;564;79;26;1;25;.962;3600000;0
28697;179602;564;0;0;0;0;.00nan;0;0
28697;67454;576;67;35;4;31;.886;3600000;0
28699;19473;569;100;25;0;25;1.000;3600000;0
28699;190423;569;0;0;0;0;.00nan;0;0
28699;185220;565;39;24;4;20;.833;3600000;0
28699;67614;565;0;0;0;0;.00nan;0;0
28701;483;570;0;0;0;0;.00nan;0;0
28701;43896;573;0;0;0;0;.00nan;0;0
28701;68167;570;88;26;1;25;.962;3600000;0
28701;153618;573;38;35;6;29;.829;3600000;0
28703;185744;568;0;0;0;0;.00nan;0;0
28703;56126;568;56;18;2;16;.889;3551000;0
28703;73939;572;0;0;0;0;.00nan;0;0
28703;84430;572;94;28;1;27;.964;3600000;0
28705;7063;566;95;23;0;23;1.000;3600000;0
28705;170144;574;93;30;1;29;.967;3580000;0
28705;176963;574;0;0;0;0;.00nan;0;0
28705;67626;566;0;0;0;0;.00nan;0;0
28707;19473;569;64;43;4;39;.907;3600000;0
28707;190423;569;0;0;0;0;.00nan;0;0
28707;185744;568;70;9;0;9;1.000;3600000;0
28707;56126;568;0;0;0;0;.00nan;0;0
28709;174736;577;76;13;0;13;1.000;3600000;0
28709;195646;577;0;0;0;0;.00nan;0;0
28709;73939;572;78;50;4;46;.920;3600000;0
28709;84430;572;0;0;0;0;.00nan;0;0
28711;483;570;0;0;0;0;.00nan;0;0
28711;-1;571;0;0;0;0;.00nan;0;0
28711;64961;571;61;27;4;23;.852;3600000;0
28711;68167;570;98;32;1;31;.969;3600000;0
28713;11925;576;75;26;2;24;.923;3600000;0
28713;185220;565;0;0;0;0;.00nan;0;0
28713;67454;576;0;0;0;0;.00nan;0;0
28713;67614;565;71;33;3;30;.909;3600000;0
28715;13065;578;76;28;1;27;.964;3570000;0
28715;35520;578;0;0;0;0;.00nan;0;0
28715;43896;573;100;28;0;28;1.000;3600000;0
28715;153618;573;0;0;0;0;.00nan;0;0
28717;14459;562;67;35;3;32;.914;3589000;0
28717;169493;564;0;0;0;0;.00nan;0;0
28717;179602;564;71;19;1;18;.947;3600000;0
28717;155917;562;0;0;0;0;.00nan;0;0
28719;6127;575;65;42;5;37;.881;3600000;0
28719;11925;576;0;0;0;0;.00nan;0;0
28719;185232;575;0;0;0;0;.00nan;0;0
28719;67454;576;72;29;2;27;.931;3600000;0
28721;7063;566;56;30;4;26;.867;3900000;0
28721;43896;573;64;45;4;41;.911;3900000;0
28721;67626;566;0;0;0;0;.00nan;0;0
28721;153618;573;0;0;0;0;.00nan;0;0
28723;174736;577;81;27;1;26;.963;3600000;0
28723;195646;577;0;0;0;0;.00nan;0;0
28723;185220;565;84;34;2;32;.941;3600000;0
28723;67614;565;0;0;0;0;.00nan;0;0
28725;185744;568;64;14;1;13;.929;3600000;0
28725;56126;568;0;0;0;0;.00nan;0;0
28725;73939;572;0;0;0;0;.00nan;0;0
28725;84430;572;89;33;2;31;.939;3600000;0
28727;13065;578;0;0;0;0;.00nan;0;0
28727;19473;569;0;0;0;0;.00nan;0;0
28727;190423;569;51;21;3;18;.857;3515000;0
28727;35520;578;82;25;1;24;.960;3600000;0
28729;483;570;79;29;2;27;.931;3600000;0
28729;14459;562;0;0;0;0;.00nan;0;0
28729;68167;570;0;0;0;0;.00nan;0;0
28729;155917;562;67;31;3;28;.903;3600000;0
28731;170144;574;0;0;0;0;.00nan;0;0
28731;176963;574;100;23;0;23;1.000;3600000;0
28731;-1;571;52;29;4;25;.862;3600000;0
28731;64961;571;0;0;0;0;.00nan;0;0
1384;185220;565;0;0;0;0;.00nan;0;0
1384;43896;573;0;0;0;0;.00nan;0;0
1384;67614;565;97;53;3;50;.943;3536000;0
1384;85749;573;68;15;1;14;.933;3600000;0
1385;14459;566;0;0;0;0;.00nan;0;0
1385;64961;571;45;20;4;16;.800;3560000;0
1385;85633;566;90;35;2;33;.943;3600000;0
1385;86180;571;0;0;0;0;.00nan;0;0
1386;185220;565;50;1;0;1;1.000;247000;0
1386;43896;573;0;0;0;0;.00nan;0;0
1386;67614;565;34;35;6;29;.829;3353000;0
1386;85749;573;86;27;1;26;.963;3600000;0
1387;14459;566;0;0;0;0;.00nan;0;0
1387;64961;571;0;0;0;0;.00nan;0;0
1387;85633;566;94;19;0;19;1.000;3600000;0
1387;86180;571;52;22;3;19;.864;3600000;0
1487;14459;566;0;0;0;0;.00nan;0;0
1487;179602;564;100;25;0;25;1.000;3600000;0
1487;85633;566;98;36;1;35;.972;3556000;0
1487;141419;564;0;0;0;0;.00nan;0;0
1488;483;570;0;0;0;0;.00nan;0;0
1488;43896;573;0;0;0;0;.00nan;0;0
1488;68167;570;54;37;5;32;.865;3519000;0
1488;85749;573;69;34;3;31;.912;3600000;0
1489;9455;568;0;0;0;0;.00nan;0;0
1489;11925;576;77;21;1;20;.952;3541000;0
1489;67454;576;0;0;0;0;.00nan;0;0
1489;86875;568;81;15;0;15;1.000;3600000;0
1490;170144;574;57;19;2;17;.895;3600000;0
1490;174736;577;0;0;0;0;.00nan;0;0
1490;195646;577;83;45;3;42;.933;3583000;0
1490;86099;574;0;0;0;0;.00nan;0;0
1491;14459;566;0;0;0;0;.00nan;0;0
1491;179602;564;84;40;1;39;.975;7778000;0
1491;85633;566;92;71;2;69;.972;7778000;0
1491;141419;564;0;0;0;0;.00nan;0;0
1492;483;570;0;0;0;0;.00nan;0;0
1492;43896;573;0;0;0;0;.00nan;0;0
1492;68167;570;64;25;2;23;.920;3587000;0
1492;85749;573;100;22;0;22;1.000;3600000;0
1493;9455;568;0;0;0;0;.00nan;0;0
1493;11925;576;78;30;2;28;.933;3576000;0
1493;67454;576;0;0;0;0;.00nan;0;0
1493;86875;568;62;16;1;15;.938;3600000;0
1494;170144;574;70;31;3;28;.903;3600000;0
1494;174736;577;62;49;6;43;.878;3600000;0
1494;195646;577;0;0;0;0;.00nan;0;0
1494;86099;574;0;0;0;0;.00nan;0;0
1495;14459;566;94;28;0;28;1.000;2664000;0
1495;179602;564;49;21;3;18;.857;3600000;0
1495;85633;566;30;17;4;13;.765;914000;0
1495;141419;564;0;0;0;0;.00nan;0;0
1496;483;570;63;10;0;10;1.000;2454000;0
1496;43896;573;0;0;0;0;.00nan;0;0
1496;68167;570;38;18;4;14;.778;1134000;0
1496;85749;573;91;36;2;34;.944;3600000;0
1497;9455;568;0;0;0;0;.00nan;0;0
1497;11925;576;84;39;2;37;.949;4426000;0
1497;67454;576;0;0;0;0;.00nan;0;0
1497;86875;568;77;33;3;30;.909;4438000;0
1498;170144;574;39;25;5;20;.800;2910000;0
1498;174736;577;65;33;4;29;.879;3600000;0
1498;195646;577;0;0;0;0;.00nan;0;0
1498;86099;574;67;11;0;11;1.000;668000;0
1499;14459;566;0;0;0;0;.00nan;0;0
1499;179602;564;28;11;4;7;.636;858000;0
1499;85633;566;77;39;4;35;.897;3600000;0
1499;141419;564;56;20;3;17;.850;2742000;0
1500;483;570;0;0;0;0;.00nan;0;0
1500;43896;573;0;0;0;0;.00nan;0;0
1500;68167;570;100;32;1;31;.969;3600000;0
1500;85749;573;60;32;4;28;.875;3600000;0
1501;9455;568;0;0;0;0;.00nan;0;0
1501;11925;576;99;47;1;46;.979;5680000;0
1501;67454;576;0;0;0;0;.00nan;0;0
1501;86875;568;57;27;2;25;.926;5680000;0
1502;170144;574;61;40;4;36;.900;3600000;0
1502;174736;577;83;26;1;25;.962;3600000;0
1502;195646;577;0;0;0;0;.00nan;0;0
1502;86099;574;0;0;0;0;.00nan;0;0
1821;14459;566;0;0;0;0;.00nan;0;0
1821;179602;564;61;19;2;17;.895;3600000;0
1821;85633;566;65;34;4;30;.882;3513000;0
1821;141419;564;0;0;0;0;.00nan;0;0
1822;483;570;0;0;0;0;.00nan;0;0
1822;43896;573;0;0;0;0;.00nan;0;0
1822;68167;570;84;36;2;34;.944;3596000;0
1822;85749;573;84;25;1;24;.960;3600000;0
1823;9455;568;0;0;0;0;.00nan;0;0
1823;11925;576;74;19;1;18;.947;3600000;0
1823;67454;576;0;0;0;0;.00nan;0;0
1823;86875;568;90;36;2;34;.944;3600000;0
1824;170144;574;86;29;1;28;.966;3896000;0
1824;174736;577;69;28;2;26;.929;3896000;0
1824;195646;577;0;0;0;0;.00nan;0;0
1824;86099;574;0;0;0;0;.00nan;0;0
1859;9455;568;0;0;0;0;.00nan;0;0
1859;11925;576;77;36;3;33;.917;3586000;0
1859;67454;576;0;0;0;0;.00nan;0;0
1859;86875;568;58;15;2;13;.867;3600000;0
1860;170144;574;86;34;1;33;.971;3600000;0
1860;174736;577;37;33;5;28;.848;3600000;0
1860;195646;577;0;0;0;0;.00nan;0;0
1860;86099;574;0;0;0;0;.00nan;0;0
1881;9455;568;0;0;0;0;.00nan;0;0
1881;11925;576;63;37;4;33;.892;3558000;0
1881;67454;576;0;0;0;0;.00nan;0;0
1881;86875;568;70;27;2;25;.926;3600000;0
1888;179602;564;78;19;1;18;.947;3600000;0
1888;43896;573;0;0;0;0;.00nan;0;0
1888;85749;573;76;36;3;33;.917;3583000;0
1888;141419;564;0;0;0;0;.00nan;0;0
1889;9455;568;0;0;0;0;.00nan;0;0
1889;170144;574;87;25;1;24;.960;3600000;0
1889;86099;574;0;0;0;0;.00nan;0;0
1889;86875;568;55;16;2;14;.875;3584000;0
1890;179602;564;81;28;2;26;.929;3711000;0
1890;43896;573;0;0;0;0;.00nan;0;0
1890;85749;573;83;39;3;36;.923;3711000;0
1890;141419;564;0;0;0;0;.00nan;0;0
1891;9455;568;0;0;0;0;.00nan;0;0
1891;170144;574;66;30;3;27;.900;3549000;0
1891;86099;574;0;0;0;0;.00nan;0;0
1891;86875;568;77;34;2;32;.941;3600000;0
1892;179602;564;63;23;2;21;.913;3600000;0
1892;43896;573;59;11;1;10;.909;1442000;0
1892;85749;573;34;18;4;14;.778;2158000;0
1892;141419;564;0;0;0;0;.00nan;0;0
1893;9455;568;0;0;0;0;.00nan;0;0
1893;170144;574;75;38;3;35;.921;3600000;0
1893;86099;574;0;0;0;0;.00nan;0;0
1893;86875;568;85;19;0;19;1.000;3600000;0
1894;179602;564;39;19;4;15;.789;1734000;0
1894;43896;573;92;32;1;31;.969;3600000;0
1894;85749;573;0;0;0;0;.00nan;0;0
1894;141419;564;52;17;2;15;.882;1866000;0
1895;9455;568;0;0;0;0;.00nan;0;0
1895;170144;574;66;33;3;30;.909;3542000;0
1895;86099;574;0;0;0;0;.00nan;0;0
1895;86875;568;77;24;1;23;.958;3600000;0
2143;179602;564;0;0;0;0;.00nan;0;0
2143;43896;573;78;30;2;28;.933;3600000;0
2143;85749;573;0;0;0;0;.00nan;0;0
2143;141419;564;71;32;3;29;.906;3600000;0
2144;9455;568;0;0;0;0;.00nan;0;0
2144;170144;574;71;30;2;28;.933;3549000;0
2144;86099;574;0;0;0;0;.00nan;0;0
2144;86875;568;77;24;1;23;.958;3600000;0
2158;179602;564;0;0;0;0;.00nan;0;0
2158;43896;573;99;65;1;64;.985;9326000;0
2158;85749;573;0;0;0;0;.00nan;0;0
2158;141419;564;94;68;2;66;.971;9326000;0
2182;179602;564;0;0;0;0;.00nan;0;0
2182;43896;573;47;26;4;22;.846;3600000;0
2182;85749;573;0;0;0;0;.00nan;0;0
2182;141419;564;86;32;1;31;.969;3600000;0
2266;170144;574;76;31;2;29;.935;3600000;0
2266;43896;573;48;25;4;21;.840;3532000;0
2266;85749;573;0;0;0;0;.00nan;0;0
2266;86099;574;0;0;0;0;.00nan;0;0
2267;9455;568;0;0;0;0;.00nan;0;0
2267;179602;564;0;0;0;0;.00nan;0;0
2267;86875;568;80;39;3;36;.923;3639000;0
2267;141419;564;53;29;4;25;.862;3639000;0
2268;9455;568;0;0;0;0;.00nan;0;0
2268;179602;564;0;0;0;0;.00nan;0;0
2268;86875;568;81;31;2;29;.935;4342000;0
2268;141419;564;80;29;3;26;.897;4342000;0
2269;9455;568;0;0;0;0;.00nan;0;0
2269;179602;564;0;0;0;0;.00nan;0;0
2269;86875;568;78;25;1;24;.960;3600000;0
2269;141419;564;52;28;5;23;.821;3600000;0
2270;9455;568;0;0;0;0;.00nan;0;0
2270;179602;564;0;0;0;0;.00nan;0;0
2270;86875;568;65;31;3;28;.903;3578000;0
2270;141419;564;63;14;1;13;.929;3600000;0
2457;9455;568;0;0;0;0;.00nan;0;0
2457;179602;564;0;0;0;0;.00nan;0;0
2457;86875;568;100;37;0;37;1.000;3600000;0
2457;141419;564;70;34;4;30;.882;3600000;0
28732;1712;893;0;0;0;0;.00nan;0;0
28732;183775;893;98;42;2;40;.952;3600000;0
28732;28831;881;0;0;0;0;.00nan;0;0
28732;78348;881;45;18;3;15;.833;3554000;0
28733;176860;878;81;40;3;37;.925;3600000;0
28733;192461;892;36;19;4;15;.789;3567000;0
28733;146300;878;0;0;0;0;.00nan;0;0
28733;146684;892;0;0;0;0;.00nan;0;0
28734;166751;883;91;33;2;31;.939;3550000;0
28734;7624;883;0;0;0;0;.00nan;0;0
28734;164715;882;0;0;0;0;.00nan;0;0
28734;142911;882;90;30;1;29;.967;3600000;0
28735;162945;886;84;14;0;14;1.000;3600000;0
28735;184648;886;0;0;0;0;.00nan;0;0
28735;196005;875;31;33;6;27;.818;3600000;0
28735;76885;875;0;0;0;0;.00nan;0;0
28736;8519;877;0;0;0;0;.00nan;0;0
28736;28833;873;0;0;0;0;.00nan;0;0
28736;180731;877;77;25;1;24;.960;3600000;0
28736;70879;873;80;38;3;35;.921;3515000;0
28737;169868;874;0;0;0;0;.00nan;0;0
28737;184398;887;0;0;0;0;.00nan;0;0
28737;63551;874;76;39;3;36;.923;3538000;0
28737;147264;887;64;17;1;16;.941;3600000;0
28738;168712;876;28;31;6;25;.806;3591000;0
28738;180316;876;0;0;0;0;.00nan;0;0
28738;65762;1415;0;0;0;0;.00nan;0;0
28738;85787;1415;44;29;5;24;.828;3600000;0
28739;1712;893;0;0;0;0;.00nan;0;0
28739;183775;893;69;35;3;32;.914;3600000;0
28739;184398;887;98;20;0;20;1.000;3600000;0
28739;147264;887;0;0;0;0;.00nan;0;0
28740;166751;883;72;31;3;28;.903;3600000;0
28740;7624;883;0;0;0;0;.00nan;0;0
28740;168712;876;59;37;5;32;.865;3518000;0
28740;180316;876;0;0;0;0;.00nan;0;0
28741;176860;878;89;46;3;43;.935;3900000;0
28741;196005;875;65;31;3;28;.903;3900000;0
28741;76885;875;0;0;0;0;.00nan;0;0
28741;146300;878;0;0;0;0;.00nan;0;0
28742;162945;886;0;0;0;0;.00nan;0;0
28742;184648;886;90;22;0;22;1.000;3600000;0
28742;196012;1415;0;0;0;0;.00nan;0;0
28742;65762;1415;79;30;1;29;.967;3565000;0
28743;164715;882;0;0;0;0;.00nan;0;0
28743;28833;873;0;0;0;0;.00nan;0;0
28743;70879;873;66;31;3;28;.903;3600000;0
28743;142911;882;65;45;4;41;.911;3597000;0
28744;8519;877;0;0;0;0;.00nan;0;0
28744;28831;881;0;0;0;0;.00nan;0;0
28744;180731;877;87;34;1;33;.971;3900000;0
28744;78348;881;100;39;1;38;.974;3900000;0
28745;183775;893;0;0;0;0;.00nan;0;0
28745;192461;892;0;0;0;0;.00nan;0;0
28745;85670;893;62;34;4;30;.882;3600000;0
28745;146684;892;91;28;1;27;.964;3600000;0
28746;166751;883;93;39;1;38;.974;3900000;0
28746;7624;883;0;0;0;0;.00nan;0;0
28746;28833;873;0;0;0;0;.00nan;0;0
28746;70879;873;93;28;1;27;.964;3900000;0
28747;162945;886;48;17;3;14;.824;3600000;0
28747;184648;886;0;0;0;0;.00nan;0;0
28747;76574;882;0;0;0;0;.00nan;0;0
28747;142911;882;61;32;4;28;.875;3600000;0
28748;8519;877;0;0;0;0;.00nan;0;0
28748;168712;876;93;38;2;36;.947;3536000;0
28748;180316;876;0;0;0;0;.00nan;0;0
28748;180731;877;100;24;0;24;1.000;3600000;0
28749;169868;874;0;0;0;0;.00nan;0;0
28749;176860;878;85;33;2;31;.939;3600000;0
28749;63551;874;46;30;5;25;.833;3600000;0
28749;146300;878;0;0;0;0;.00nan;0;0
28750;28831;881;0;0;0;0;.00nan;0;0
28750;196005;875;37;32;6;26;.813;1894000;0
28750;76885;875;78;24;0;24;1.000;1670000;0
28750;78348;881;52;25;4;21;.840;3600000;0
28751;184398;887;28;7;3;4;.571;522000;0
28751;196012;1415;0;0;0;0;.00nan;0;0
28751;65762;1415;63;35;4;31;.886;3739000;0
28751;147264;887;73;25;2;23;.920;3217000;0
28752;162945;886;85;23;1;22;.957;3600000;0
28752;168712;876;65;36;4;32;.889;3600000;0
28752;184648;886;0;0;0;0;.00nan;0;0
28752;180316;876;0;0;0;0;.00nan;0;0
28753;196005;875;60;29;3;26;.897;3900000;0
28753;192461;892;83;36;3;33;.917;3900000;0
28753;76885;875;0;0;0;0;.00nan;0;0
28753;146684;892;0;0;0;0;.00nan;0;0
28754;166751;883;71;22;1;21;.955;3600000;0
28754;7624;883;0;0;0;0;.00nan;0;0
28754;176860;878;49;26;4;22;.846;3600000;0
28754;146300;878;0;0;0;0;.00nan;0;0
28755;1712;893;0;0;0;0;.00nan;0;0
28755;8519;877;77;21;1;20;.952;3600000;0
28755;183775;893;53;33;4;29;.879;3600000;0
28755;180731;877;0;0;0;0;.00nan;0;0
28756;28831;881;0;0;0;0;.00nan;0;0
28756;28833;873;0;0;0;0;.00nan;0;0
28756;70879;873;62;46;6;40;.870;3559000;0
28756;78348;881;56;38;5;33;.868;3600000;0
28757;164715;882;0;0;0;0;.00nan;0;0
28757;184398;887;38;29;6;23;.793;2951000;0
28757;142911;882;30;33;7;26;.788;3545000;0
28757;147264;887;62;7;0;7;1.000;649000;0
28758;169868;874;0;0;0;0;.00nan;0;0
28758;196012;1415;0;0;0;0;.00nan;0;0
28758;63551;874;81;41;3;38;.927;3900000;0
28758;65762;1415;51;26;3;23;.885;3900000;0
28759;168712;876;0;0;0;0;.00nan;0;0
28759;176860;878;100;39;0;39;1.000;3600000;0
28759;180316;876;41;31;6;25;.806;3600000;0
28759;146300;878;0;0;0;0;.00nan;0;0
28760;169868;874;69;46;4;42;.913;3893000;0
28760;192461;892;48;25;4;21;.840;3900000;0
28760;63551;874;0;0;0;0;.00nan;0;0
28760;146684;892;0;0;0;0;.00nan;0;0
28761;183775;893;86;32;2;30;.938;3651000;0
28761;176860;878;69;31;3;28;.903;3651000;0
28761;85670;893;0;0;0;0;.00nan;0;0
28761;146300;878;0;0;0;0;.00nan;0;0
28762;166751;883;58;27;3;24;.889;3600000;0
28762;7624;883;0;0;0;0;.00nan;0;0
28762;184398;887;89;33;1;32;.970;3600000;0
28762;147264;887;0;0;0;0;.00nan;0;0
28763;162945;886;27;20;5;15;.750;3552000;0
28763;184648;886;0;0;0;0;.00nan;0;0
28763;192461;892;70;40;4;36;.900;3600000;0
28763;146684;892;0;0;0;0;.00nan;0;0
28764;28833;873;0;0;0;0;.00nan;0;0
28764;63551;874;0;0;0;0;.00nan;0;0
28764;70879;873;67;20;1;19;.950;3600000;0
28764;78775;874;83;42;3;39;.929;3600000;0
28765;8519;877;0;0;0;0;.00nan;0;0
28765;180731;877;91;36;1;35;.972;3600000;0
28765;76574;882;0;0;0;0;.00nan;0;0
28765;142911;882;72;38;3;35;.921;3570000;0
28766;196005;875;51;38;6;32;.842;2936000;0
28766;65762;1415;0;0;0;0;.00nan;0;0
28766;76885;875;44;4;1;3;.750;664000;0
28766;85787;1415;97;25;0;25;1.000;3600000;0
28767;168712;876;79;26;1;25;.962;3865000;0
28767;28831;881;90;38;2;36;.947;3865000;0
28767;180316;876;0;0;0;0;.00nan;0;0
28767;78348;881;0;0;0;0;.00nan;0;0
28768;166751;883;69;28;3;25;.893;3900000;0
28768;7624;883;0;0;0;0;.00nan;0;0
28768;183775;893;0;0;0;0;.00nan;0;0
28768;85670;893;70;30;3;27;.900;3900000;0
28769;168712;876;74;21;1;20;.952;3600000;0
28769;28833;873;0;0;0;0;.00nan;0;0
28769;180316;876;0;0;0;0;.00nan;0;0
28769;70879;873;89;43;3;40;.930;3513000;0
28770;162945;886;0;0;0;0;.00nan;0;0
28770;184648;886;67;18;1;17;.944;3600000;0
28770;176860;878;98;53;2;51;.962;3600000;0
28770;146300;878;0;0;0;0;.00nan;0;0
28771;8519;877;78;12;0;12;1.000;3600000;0
28771;180731;877;0;0;0;0;.00nan;0;0
28771;63551;874;0;0;0;0;.00nan;0;0
28771;78775;874;51;39;6;33;.846;3600000;0
28772;196005;875;58;24;3;21;.875;3600000;0
28772;76574;882;0;0;0;0;.00nan;0;0
28772;76885;875;0;0;0;0;.00nan;0;0
28772;142911;882;62;31;4;27;.871;3550000;0
28773;184398;887;0;0;0;0;.00nan;0;0
28773;192461;892;53;30;4;26;.867;3576000;0
28773;146684;892;0;0;0;0;.00nan;0;0
28773;147264;887;61;25;3;22;.880;3600000;0
28774;28831;881;0;0;0;0;.00nan;0;0
28774;65762;1415;0;0;0;0;.00nan;0;0
28774;78348;881;75;34;3;31;.912;3524000;0
28774;85787;1415;76;22;1;21;.955;3600000;0
28775;166751;883;88;27;1;26;.963;3600000;0
28775;7624;883;0;0;0;0;.00nan;0;0
28775;63551;874;0;0;0;0;.00nan;0;0
28775;78775;874;68;48;5;43;.896;3600000;0
28776;168712;876;91;19;0;19;1.000;3600000;0
28776;180316;876;0;0;0;0;.00nan;0;0
28776;76574;882;0;0;0;0;.00nan;0;0
28776;142911;882;43;29;6;23;.793;3600000;0
28777;28831;881;0;0;0;0;.00nan;0;0
28777;192461;892;50;39;6;33;.846;3600000;0
28777;78348;881;59;24;3;21;.875;3600000;0
28777;146684;892;0;0;0;0;.00nan;0;0
28778;8519;877;0;0;0;0;.00nan;0;0
28778;176860;878;55;6;0;6;1.000;356000;0
28778;180731;877;46;12;2;10;.833;3600000;0
28778;146300;878;68;49;6;43;.878;3244000;0
28779;184398;887;71;35;3;32;.914;3547000;0
28779;196005;875;0;0;0;0;.00nan;0;0
28779;76885;875;62;17;1;16;.941;3600000;0
28779;147264;887;0;0;0;0;.00nan;0;0
28780;162945;886;39;24;4;20;.833;3600000;0
28780;184648;886;0;0;0;0;.00nan;0;0
28780;28833;873;0;0;0;0;.00nan;0;0
28780;70879;873;94;33;1;32;.970;3600000;0
28781;183775;893;0;0;0;0;.00nan;0;0
28781;65762;1415;0;0;0;0;.00nan;0;0
28781;85670;893;96;31;1;30;.968;3600000;0
28781;85787;1415;92;14;0;14;1.000;3600000;0
28782;166751;883;100;51;1;50;.980;3757000;0
28782;7624;883;0;0;0;0;.00nan;0;0
28782;192461;892;77;32;2;30;.938;3757000;0
28782;146684;892;0;0;0;0;.00nan;0;0
28783;162945;886;50;33;5;28;.848;3796000;0
28783;8519;877;60;37;4;33;.892;3796000;0
28783;184648;886;0;0;0;0;.00nan;0;0
28783;180731;877;0;0;0;0;.00nan;0;0
28784;168712;876;32;39;7;32;.821;3600000;0
28784;180316;876;0;0;0;0;.00nan;0;0
28784;63551;874;0;0;0;0;.00nan;0;0
28784;78775;874;100;41;0;41;1.000;3600000;0
28785;183775;893;0;0;0;0;.00nan;0;0
28785;76574;882;0;0;0;0;.00nan;0;0
28785;85670;893;49;33;5;28;.848;3600000;0
28785;142911;882;43;23;4;19;.826;3600000;0
28786;28833;873;0;0;0;0;.00nan;0;0
28786;196005;875;62;38;4;34;.895;3523000;0
28786;70879;873;80;34;2;32;.941;3600000;0
28786;76885;875;0;0;0;0;.00nan;0;0
28787;176860;878;98;47;2;45;.957;3548000;0
28787;65762;1415;0;0;0;0;.00nan;0;0
28787;85787;1415;75;22;1;21;.955;3600000;0
28787;146300;878;0;0;0;0;.00nan;0;0
28788;184398;887;90;33;1;32;.970;3600000;0
28788;28831;881;0;0;0;0;.00nan;0;0
28788;78348;881;84;30;2;28;.933;3555000;0
28788;147264;887;0;0;0;0;.00nan;0;0
28789;183775;893;0;0;0;0;.00nan;0;0
28789;196005;875;82;32;2;30;.938;3900000;0
28789;76885;875;0;0;0;0;.00nan;0;0
28789;85670;893;80;36;2;34;.944;3900000;0
28790;28833;873;0;0;0;0;.00nan;0;0
28790;192461;892;100;41;0;41;1.000;3600000;0
28790;70879;873;92;35;2;33;.943;3520000;0
28790;146684;892;0;0;0;0;.00nan;0;0
28791;28831;881;0;0;0;0;.00nan;0;0
28791;176860;878;57;34;5;29;.853;3600000;0
28791;78348;881;73;24;2;22;.917;3600000;0
28791;146300;878;0;0;0;0;.00nan;0;0
28792;162945;886;0;0;0;0;.00nan;0;0
28792;184648;886;55;15;2;13;.867;3600000;0
28792;63551;874;0;0;0;0;.00nan;0;0
28792;78775;874;98;55;3;52;.945;3553000;0
28793;166751;883;95;32;1;31;.969;3600000;0
28793;7624;883;0;0;0;0;.00nan;0;0
28793;8519;877;0;0;0;0;.00nan;0;0
28793;180731;877;87;28;2;26;.929;3589000;0
28794;65762;1415;0;0;0;0;.00nan;0;0
28794;76574;882;64;24;2;22;.917;3563000;0
28794;85787;1415;83;29;1;28;.966;3600000;0
28794;142911;882;0;0;0;0;.00nan;0;0
28795;168712;876;51;32;5;27;.844;3600000;0
28795;184398;887;94;37;2;35;.946;3600000;0
28795;180316;876;0;0;0;0;.00nan;0;0
28795;147264;887;0;0;0;0;.00nan;0;0
28796;183775;893;0;0;0;0;.00nan;0;0
28796;69536;873;0;0;0;0;.00nan;0;0
28796;70879;873;41;23;5;18;.783;3590000;0
28796;85670;893;79;33;3;30;.909;3600000;0
28797;168712;876;51;5;0;5;1.000;388000;0
28797;180316;876;46;35;6;29;.829;3212000;0
28797;192461;892;86;31;1;30;.968;3600000;0
28797;146684;892;0;0;0;0;.00nan;0;0
28798;63551;874;97;33;1;32;.970;3600000;0
28798;76574;882;0;0;0;0;.00nan;0;0
28798;78775;874;0;0;0;0;.00nan;0;0
28798;142911;882;82;30;2;28;.933;3600000;0
28799;8519;877;57;31;4;27;.871;3600000;0
28799;196005;875;92;37;1;36;.973;3600000;0
28799;180731;877;0;0;0;0;.00nan;0;0
28799;76885;875;0;0;0;0;.00nan;0;0
28800;184398;887;48;20;3;17;.850;3555000;0
28800;176860;878;77;28;2;26;.929;3600000;0
28800;146300;878;0;0;0;0;.00nan;0;0
28800;147264;887;0;0;0;0;.00nan;0;0
28801;166751;883;92;49;2;47;.959;3761000;0
28801;7624;883;0;0;0;0;.00nan;0;0
28801;65762;1415;95;26;1;25;.962;3761000;0
28801;85787;1415;0;0;0;0;.00nan;0;0
28802;162945;886;61;29;3;26;.897;3600000;0
28802;184648;886;0;0;0;0;.00nan;0;0
28802;28831;881;82;40;4;36;.900;3554000;0
28802;78348;881;0;0;0;0;.00nan;0;0
28803;166751;883;53;16;2;14;.875;3600000;0
28803;7624;883;0;0;0;0;.00nan;0;0
28803;196005;875;97;49;3;46;.939;3600000;0
28803;76885;875;0;0;0;0;.00nan;0;0
28804;168712;876;100;24;0;24;1.000;3600000;0
28804;176860;878;0;0;0;0;.00nan;0;0
28804;180316;876;0;0;0;0;.00nan;0;0
28804;146300;878;79;31;2;29;.935;3564000;0
28805;162945;886;96;27;0;27;1.000;3600000;0
28805;183775;893;0;0;0;0;.00nan;0;0
28805;184648;886;0;0;0;0;.00nan;0;0
28805;85670;893;88;50;2;48;.960;3564000;0
28806;8519;877;81;25;1;24;.960;3900000;0
28806;180731;877;0;0;0;0;.00nan;0;0
28806;65762;1415;0;0;0;0;.00nan;0;0
28806;85787;1415;71;21;1;20;.952;3900000;0
28807;192461;892;61;40;6;34;.850;3530000;0
28807;76574;882;0;0;0;0;.00nan;0;0
28807;142911;882;48;25;4;21;.840;3600000;0
28807;146684;892;0;0;0;0;.00nan;0;0
28808;184398;887;98;29;1;28;.966;3600000;0
28808;69536;873;85;34;2;32;.941;3582000;0
28808;70879;873;0;0;0;0;.00nan;0;0
28808;147264;887;0;0;0;0;.00nan;0;0
28809;28831;881;0;0;0;0;.00nan;0;0
28809;63551;874;0;0;0;0;.00nan;0;0
28809;78348;881;100;23;0;23;1.000;3600000;0
28809;78775;874;93;53;4;49;.925;3600000;0
28810;183775;893;49;21;3;18;.857;3600000;0
28810;168712;876;51;32;4;28;.875;3592000;0
28810;180316;876;0;0;0;0;.00nan;0;0
28810;85670;893;0;0;0;0;.00nan;0;0
28811;8519;877;0;0;0;0;.00nan;0;0
28811;180731;877;79;25;1;24;.960;3600000;0
28811;192461;892;93;21;0;21;1.000;3600000;0
28811;146684;892;0;0;0;0;.00nan;0;0
28812;676;883;63;40;4;36;.900;3512000;0
28812;166751;883;0;0;0;0;.00nan;0;0
28812;163471;881;93;34;2;32;.941;3600000;0
28812;78348;881;0;0;0;0;.00nan;0;0
28813;176860;878;57;47;6;41;.872;3600000;0
28813;76574;882;0;0;0;0;.00nan;0;0
28813;142911;882;88;17;0;17;1.000;3600000;0
28813;146300;878;0;0;0;0;.00nan;0;0
28814;196005;875;54;29;4;25;.862;3535000;0
28814;63551;874;0;0;0;0;.00nan;0;0
28814;76885;875;0;0;0;0;.00nan;0;0
28814;78775;874;66;25;2;23;.920;3600000;0
28815;65762;1415;0;0;0;0;.00nan;0;0
28815;69536;873;97;56;4;52;.929;3900000;0
28815;70879;873;0;0;0;0;.00nan;0;0
28815;85787;1415;49;19;4;15;.789;3900000;0
28816;162945;886;100;32;0;32;1.000;3600000;0
28816;184398;887;32;37;7;30;.811;2962000;0
28816;184648;886;0;0;0;0;.00nan;0;0
28816;147264;887;52;3;0;3;1.000;638000;0
28817;176860;878;95;39;2;37;.949;3600000;0
28817;69536;873;38;21;4;17;.810;3550000;0
28817;70879;873;0;0;0;0;.00nan;0;0
28817;146300;878;0;0;0;0;.00nan;0;0
28818;168712;876;89;35;1;34;.971;3600000;0
28818;28831;881;0;0;0;0;.00nan;0;0
28818;180316;876;0;0;0;0;.00nan;0;0
28818;78348;881;100;25;0;25;1.000;3600000;0
28819;168712;876;65;24;3;21;.875;3536000;0
28819;196005;875;99;43;1;42;.977;3600000;0
28819;180316;876;0;0;0;0;.00nan;0;0
28819;76885;875;0;0;0;0;.00nan;0;0
28820;166751;883;81;48;4;44;.917;3600000;0
28820;162945;886;100;24;0;24;1.000;3600000;0
28820;7624;883;0;0;0;0;.00nan;0;0
28820;184648;886;0;0;0;0;.00nan;0;0
28821;8519;877;37;22;4;18;.818;3597000;0
28821;184398;887;81;44;3;41;.932;3600000;0
28821;180731;877;0;0;0;0;.00nan;0;0
28821;147264;887;0;0;0;0;.00nan;0;0
28822;183775;893;0;0;0;0;.00nan;0;0
28822;63551;874;0;0;0;0;.00nan;0;0
28822;78775;874;68;37;4;33;.892;3547000;0
28822;85670;893;64;28;3;25;.893;3600000;0
28823;192461;892;58;32;4;28;.875;3600000;0
28823;65762;1415;0;0;0;0;.00nan;0;0
28823;85787;1415;71;22;1;21;.955;3600000;0
28823;146684;892;0;0;0;0;.00nan;0;0
28824;28831;881;0;0;0;0;.00nan;0;0
28824;76574;882;0;0;0;0;.00nan;0;0
28824;78348;881;59;14;1;13;.929;3600000;0
28824;142911;882;46;39;5;34;.872;3600000;0
28825;14266;1415;0;0;0;0;.00nan;0;0
28825;176860;878;83;39;3;36;.923;3600000;0
28825;85787;1415;36;29;5;24;.828;3576000;0
28825;146300;878;0;0;0;0;.00nan;0;0
28826;163471;881;96;32;1;31;.969;3600000;0
28826;8519;877;0;0;0;0;.00nan;0;0
28826;180731;877;66;26;2;24;.923;3563000;0
28826;78348;881;0;0;0;0;.00nan;0;0
28827;162945;886;61;21;2;19;.905;3555000;0
28827;184648;886;0;0;0;0;.00nan;0;0
28827;78775;874;100;41;0;41;1.000;3600000;0
28827;143301;874;0;0;0;0;.00nan;0;0
28828;168712;876;75;36;3;33;.917;3600000;0
28828;180316;876;0;0;0;0;.00nan;0;0
28828;76574;882;58;44;6;38;.864;3600000;0
28828;142911;882;0;0;0;0;.00nan;0;0
28829;28833;892;0;0;0;0;.00nan;0;0
28829;196005;875;57;22;3;19;.864;3673000;0
28829;192461;892;96;53;2;51;.962;3673000;0
28829;76885;875;0;0;0;0;.00nan;0;0
28830;183775;893;83;31;1;30;.968;3895000;0
28830;69536;873;97;23;0;23;1.000;3895000;0
28830;70879;873;0;0;0;0;.00nan;0;0
28830;85670;893;0;0;0;0;.00nan;0;0
28831;676;883;0;0;0;0;.00nan;0;0
28831;166751;883;68;31;3;28;.903;3750000;0
28831;184398;887;0;0;0;0;.00nan;0;0
28831;147264;887;80;31;2;29;.935;3750000;0
28832;676;883;58;32;4;28;.875;3554000;0
28832;166751;883;0;0;0;0;.00nan;0;0
28832;14266;1415;52;15;2;13;.867;3600000;0
28832;85787;1415;0;0;0;0;.00nan;0;0
28833;162945;886;77;31;2;29;.935;3879000;0
28833;183775;893;92;47;3;44;.936;3879000;0
28833;184648;886;0;0;0;0;.00nan;0;0
28833;85670;893;0;0;0;0;.00nan;0;0
28834;168712;876;0;0;0;0;.00nan;0;0
28834;180316;876;61;23;2;21;.913;3600000;0
28834;78775;874;0;0;0;0;.00nan;0;0
28834;143301;874;28;28;6;22;.786;3600000;0
28835;184398;887;70;35;3;32;.914;3575000;0
28835;28833;892;70;22;2;20;.909;3600000;0
28835;192461;892;0;0;0;0;.00nan;0;0
28835;147264;887;0;0;0;0;.00nan;0;0
28836;676;883;67;19;1;18;.947;3600000;0
28836;166751;883;0;0;0;0;.00nan;0;0
28836;8519;877;62;30;2;28;.933;3575000;0
28836;180731;877;0;0;0;0;.00nan;0;0
28837;176860;878;63;33;4;29;.879;3600000;0
28837;196005;875;32;25;5;20;.800;3575000;0
28837;76885;875;0;0;0;0;.00nan;0;0
28837;146300;878;0;0;0;0;.00nan;0;0
28838;69536;873;95;44;2;42;.955;3900000;0
28838;70879;873;0;0;0;0;.00nan;0;0
28838;76574;882;0;0;0;0;.00nan;0;0
28838;142911;882;80;29;2;27;.931;3900000;0
28839;163471;881;60;49;6;43;.878;3600000;0
28839;14266;1415;64;26;2;24;.923;3600000;0
28839;78348;881;0;0;0;0;.00nan;0;0
28839;85787;1415;0;0;0;0;.00nan;0;0
28840;183775;893;0;0;0;0;.00nan;0;0
28840;168712;876;72;38;4;34;.895;3600000;0
28840;180316;876;0;0;0;0;.00nan;0;0
28840;85670;893;100;31;1;30;.968;3600000;0
28841;28833;892;76;27;1;26;.963;3600000;0
28841;192461;892;0;0;0;0;.00nan;0;0
28841;78775;874;0;0;0;0;.00nan;0;0
28841;143301;874;80;37;3;34;.919;3542000;0
28842;184398;887;69;31;3;28;.903;3572000;0
28842;176860;878;87;37;2;35;.946;3600000;0
28842;146300;878;0;0;0;0;.00nan;0;0
28842;147264;887;0;0;0;0;.00nan;0;0
28843;162945;886;36;27;5;22;.815;3600000;0
28843;184648;886;0;0;0;0;.00nan;0;0
28843;69536;873;41;42;7;35;.833;3523000;0
28843;70879;873;0;0;0;0;.00nan;0;0
28844;8519;877;0;0;0;0;.00nan;0;0
28844;180731;877;61;32;4;28;.875;3561000;0
28844;76574;882;0;0;0;0;.00nan;0;0
28844;142911;882;100;54;3;51;.944;3600000;0
28845;163471;881;81;27;2;25;.926;3600000;0
28845;196005;875;88;46;3;43;.935;3567000;0
28845;76885;875;0;0;0;0;.00nan;0;0
28845;78348;881;0;0;0;0;.00nan;0;0
28846;8519;877;37;26;4;22;.846;3559000;0
28846;168712;876;75;37;3;34;.919;3600000;0
28846;180316;876;0;0;0;0;.00nan;0;0
28846;180731;877;0;0;0;0;.00nan;0;0
28847;183775;893;0;0;0;0;.00nan;0;0
28847;176860;878;100;37;0;37;1.000;3600000;0
28847;85670;893;52;27;3;24;.889;3600000;0
28847;146300;878;0;0;0;0;.00nan;0;0
28848;196005;875;43;39;6;33;.846;3600000;0
28848;76885;875;0;0;0;0;.00nan;0;0
28848;78775;874;0;0;0;0;.00nan;0;0
28848;143301;874;78;35;3;32;.914;3600000;0
28849;676;883;89;36;2;34;.944;3556000;0
28849;166751;883;0;0;0;0;.00nan;0;0
28849;76574;882;0;0;0;0;.00nan;0;0
28849;142911;882;91;21;0;21;1.000;3600000;0
28850;28833;892;79;30;2;28;.933;3514000;0
28850;192461;892;0;0;0;0;.00nan;0;0
28850;69536;873;100;43;0;43;1.000;3600000;0
28850;70879;873;0;0;0;0;.00nan;0;0
28851;163471;881;69;25;2;23;.920;3566000;0
28851;184398;887;83;31;1;30;.968;3600000;0
28851;78348;881;0;0;0;0;.00nan;0;0
28851;147264;887;0;0;0;0;.00nan;0;0
28852;162945;886;82;17;0;17;1.000;3600000;0
28852;14266;1415;45;33;5;28;.848;3600000;0
28852;184648;886;0;0;0;0;.00nan;0;0
28852;85787;1415;0;0;0;0;.00nan;0;0
28853;183775;893;0;0;0;0;.00nan;0;0
28853;76574;882;0;0;0;0;.00nan;0;0
28853;85670;893;76;21;1;20;.952;3600000;0
28853;142911;882;53;25;3;22;.880;3578000;0
28854;676;883;65;31;3;28;.903;3566000;0
28854;166751;883;0;0;0;0;.00nan;0;0
28854;28833;892;86;30;1;29;.967;3600000;0
28854;192461;892;0;0;0;0;.00nan;0;0
28855;162945;886;60;17;1;16;.941;3600000;0
28855;168712;876;65;29;3;26;.897;3539000;0
28855;184648;886;0;0;0;0;.00nan;0;0
28855;180316;876;0;0;0;0;.00nan;0;0
28856;8519;877;0;0;0;0;.00nan;0;0
28856;180731;877;66;14;1;13;.929;3600000;0
28856;78775;874;0;0;0;0;.00nan;0;0
28856;143301;874;59;36;5;31;.861;3600000;0
28857;196005;875;68;24;2;22;.917;3588000;0
28857;69536;873;74;24;1;23;.958;3600000;0
28857;70879;873;0;0;0;0;.00nan;0;0
28857;76885;875;0;0;0;0;.00nan;0;0
28858;14266;1415;74;23;2;21;.913;3600000;0
28858;184398;887;61;44;5;39;.886;3600000;0
28858;85787;1415;0;0;0;0;.00nan;0;0
28858;147264;887;0;0;0;0;.00nan;0;0
28859;163471;881;57;17;2;15;.882;3600000;0
28859;176860;878;56;41;5;36;.878;3600000;0
28859;78348;881;0;0;0;0;.00nan;0;0
28859;146300;878;0;0;0;0;.00nan;0;0
28860;8519;877;49;20;3;17;.850;3600000;0
28860;183775;893;63;33;4;29;.879;3546000;0
28860;180731;877;0;0;0;0;.00nan;0;0
28860;85670;893;0;0;0;0;.00nan;0;0
28861;163471;881;99;39;1;38;.974;3900000;0
28861;168712;876;0;0;0;0;.00nan;0;0
28861;180316;876;89;30;1;29;.967;3900000;0
28861;78348;881;0;0;0;0;.00nan;0;0
28862;28833;892;66;36;4;32;.889;3600000;0
28862;192461;892;0;0;0;0;.00nan;0;0
28862;65762;1415;0;0;0;0;.00nan;0;0
28862;85787;1415;70;21;1;20;.952;3600000;0
28863;166751;883;70;35;4;31;.886;3600000;0
28863;162945;886;68;18;1;17;.944;3600000;0
28863;7624;883;0;0;0;0;.00nan;0;0
28863;184648;886;0;0;0;0;.00nan;0;0
28864;63551;874;0;0;0;0;.00nan;0;0
28864;76574;882;0;0;0;0;.00nan;0;0
28864;78775;874;50;39;5;34;.872;3600000;0
28864;142911;882;100;28;0;28;1.000;3600000;0
28865;11422;873;0;0;0;0;.00nan;0;0
28865;28831;873;71;26;2;24;.923;3600000;0
28865;176860;878;68;29;3;26;.897;3600000;0
28865;146300;878;0;0;0;0;.00nan;0;0
28866;184398;887;64;34;3;31;.912;3600000;0
28866;196005;875;31;26;5;21;.808;3538000;0
28866;76885;875;0;0;0;0;.00nan;0;0
28866;147264;887;0;0;0;0;.00nan;0;0
28867;14266;1415;100;25;0;25;1.000;3600000;0
28867;168712;876;92;32;2;30;.938;3567000;0
28867;180316;876;0;0;0;0;.00nan;0;0
28867;85787;1415;0;0;0;0;.00nan;0;0
28868;676;883;66;20;1;19;.950;3600000;0
28868;166751;883;0;0;0;0;.00nan;0;0
28868;183775;893;0;0;0;0;.00nan;0;0
28868;85670;893;93;45;3;42;.933;3600000;0
28869;176860;878;0;0;0;0;.00nan;0;0
28869;76574;882;0;0;0;0;.00nan;0;0
28869;142911;882;69;17;2;15;.882;3600000;0
28869;146300;878;77;33;3;30;.909;3559000;0
28870;162945;886;76;22;2;20;.909;3600000;0
28870;184648;886;0;0;0;0;.00nan;0;0
28870;196005;875;49;33;4;29;.879;3600000;0
28870;76885;875;0;0;0;0;.00nan;0;0
28871;184398;887;68;27;2;25;.926;3567000;0
28871;78775;874;0;0;0;0;.00nan;0;0
28871;143301;874;91;37;1;36;.973;3600000;0
28871;147264;887;0;0;0;0;.00nan;0;0
28872;163471;881;72;33;3;30;.909;3567000;0
28872;28833;892;99;39;1;38;.974;3600000;0
28872;192461;892;0;0;0;0;.00nan;0;0
28872;78348;881;0;0;0;0;.00nan;0;0
28873;8519;877;0;0;0;0;.00nan;0;0
28873;180731;877;58;21;2;19;.905;3600000;0
28873;69536;873;92;50;4;46;.920;3546000;0
28873;70879;873;0;0;0;0;.00nan;0;0
28874;168712;876;99;40;1;39;.975;3600000;0
28874;176860;878;46;32;5;27;.844;3600000;0
28874;180316;876;0;0;0;0;.00nan;0;0
28874;146300;878;0;0;0;0;.00nan;0;0
28875;163471;881;100;33;1;32;.970;3600000;0
28875;78348;881;0;0;0;0;.00nan;0;0
28875;78775;874;0;0;0;0;.00nan;0;0
28875;143301;874;73;36;3;33;.917;3542000;0
28876;162945;886;43;19;3;16;.842;3600000;0
28876;184648;886;0;0;0;0;.00nan;0;0
28876;76574;882;0;0;0;0;.00nan;0;0
28876;142911;882;55;37;5;32;.865;3554000;0
28877;676;883;63;18;1;17;.944;3593000;0
28877;166751;883;0;0;0;0;.00nan;0;0
28877;196005;875;0;0;0;0;.00nan;0;0
28877;76885;875;100;28;0;28;1.000;3600000;0
28878;183775;893;0;0;0;0;.00nan;0;0
28878;184398;887;69;46;4;42;.913;3600000;0
28878;85670;893;84;33;1;32;.970;3600000;0
28878;147264;887;0;0;0;0;.00nan;0;0
28879;14266;1415;59;22;2;20;.909;3600000;0
28879;69536;873;79;45;3;42;.933;3600000;0
28879;70879;873;0;0;0;0;.00nan;0;0
28879;85787;1415;0;0;0;0;.00nan;0;0
28880;14266;1415;80;30;2;28;.933;3900000;0
28880;183775;893;0;0;0;0;.00nan;0;0
28880;85670;893;100;34;2;32;.941;3900000;0
28880;85787;1415;0;0;0;0;.00nan;0;0
28881;28833;892;73;29;2;27;.931;3674000;0
28881;192461;892;0;0;0;0;.00nan;0;0
28881;76574;882;0;0;0;0;.00nan;0;0
28881;142911;882;100;32;1;31;.969;3674000;0
28882;176860;878;74;35;3;32;.914;3515000;0
28882;78775;874;0;0;0;0;.00nan;0;0
28882;143301;874;89;28;1;27;.964;3600000;0
28882;146300;878;0;0;0;0;.00nan;0;0
28883;162945;886;65;29;2;27;.931;3900000;0
28883;184398;887;73;25;2;23;.920;3900000;0
28883;184648;886;0;0;0;0;.00nan;0;0
28883;147264;887;0;0;0;0;.00nan;0;0
28884;8519;877;0;0;0;0;.00nan;0;0
28884;196005;875;0;0;0;0;.00nan;0;0
28884;180731;877;38;28;5;23;.821;3600000;0
28884;76885;875;99;39;2;37;.949;3600000;0
28885;168712;876;81;31;2;29;.935;3600000;0
28885;180316;876;0;0;0;0;.00nan;0;0
28885;69536;873;64;27;3;24;.889;3583000;0
28885;70879;873;0;0;0;0;.00nan;0;0
28886;676;883;66;38;4;34;.895;3581000;0
28886;166751;883;0;0;0;0;.00nan;0;0
28886;163471;881;73;35;3;32;.914;3600000;0
28886;78348;881;0;0;0;0;.00nan;0;0
28887;183775;893;53;34;4;30;.882;3885000;0
28887;28833;892;52;25;4;21;.840;3900000;0
28887;192461;892;0;0;0;0;.00nan;0;0
28887;85670;893;0;0;0;0;.00nan;0;0
28888;676;883;62;26;3;23;.885;3600000;0
28888;166751;883;0;0;0;0;.00nan;0;0
28888;176860;878;50;41;6;35;.854;3009000;0
28888;146300;878;45;6;1;5;.833;591000;0
28889;162945;886;0;0;0;0;.00nan;0;0
28889;163471;881;71;34;4;30;.882;3545000;0
28889;184648;886;67;30;3;27;.900;3600000;0
28889;78348;881;0;0;0;0;.00nan;0;0
28890;184398;887;78;46;4;42;.913;3568000;0
28890;76574;882;0;0;0;0;.00nan;0;0
28890;142911;882;73;36;3;33;.917;3600000;0
28890;147264;887;0;0;0;0;.00nan;0;0
28891;168712;876;70;26;2;24;.923;3600000;0
28891;196005;875;0;0;0;0;.00nan;0;0
28891;180316;876;0;0;0;0;.00nan;0;0
28891;76885;875;48;29;4;25;.862;3555000;0
28892;69536;873;89;35;2;33;.943;3600000;0
28892;70879;873;0;0;0;0;.00nan;0;0
28892;78775;874;61;7;0;7;1.000;510000;0
28892;143301;874;49;36;6;30;.833;3090000;0
28893;8519;877;0;0;0;0;.00nan;0;0
28893;14266;1415;100;35;0;35;1.000;3600000;0
28893;180731;877;54;35;4;31;.886;3600000;0
28893;85787;1415;0;0;0;0;.00nan;0;0
28894;162945;886;80;31;2;29;.935;3727000;0
28894;184648;886;0;0;0;0;.00nan;0;0
28894;28833;892;89;46;3;43;.935;3727000;0
28894;192461;892;0;0;0;0;.00nan;0;0
28895;676;883;89;25;1;24;.960;3600000;0
28895;166751;883;0;0;0;0;.00nan;0;0
28895;168712;876;78;48;5;43;.896;3600000;0
28895;180316;876;0;0;0;0;.00nan;0;0
28896;8519;877;62;26;3;23;.885;3600000;0
28896;176860;878;66;47;5;42;.894;3565000;0
28896;180731;877;0;0;0;0;.00nan;0;0
28896;146300;878;0;0;0;0;.00nan;0;0
28897;14266;1415;100;41;2;39;.951;3600000;0
28897;78775;874;0;0;0;0;.00nan;0;0
28897;85787;1415;0;0;0;0;.00nan;0;0
28897;143301;874;48;23;4;19;.826;3600000;0
28898;196005;875;0;0;0;0;.00nan;0;0
28898;76574;882;0;0;0;0;.00nan;0;0
28898;76885;875;70;34;3;31;.912;3600000;0
28898;142911;882;96;22;0;22;1.000;3600000;0
28899;184398;887;25;36;8;28;.778;3600000;0
28899;69536;873;74;24;2;22;.917;3600000;0
28899;70879;873;0;0;0;0;.00nan;0;0
28899;147264;887;0;0;0;0;.00nan;0;0
28900;163471;881;86;27;1;26;.963;3600000;0
28900;183775;893;0;0;0;0;.00nan;0;0
28900;78348;881;0;0;0;0;.00nan;0;0
28900;85670;893;82;37;2;35;.946;3551000;0
28901;183775;893;0;0;0;0;.00nan;0;0
28901;78775;874;0;0;0;0;.00nan;0;0
28901;85670;893;92;37;2;35;.946;3557000;0
28901;143301;874;100;28;0;28;1.000;3600000;0
28902;168712;876;95;38;2;36;.947;3728000;0
28902;28833;892;81;43;3;40;.930;3728000;0
28902;180316;876;0;0;0;0;.00nan;0;0
28902;192461;892;0;0;0;0;.00nan;0;0
28903;162945;886;67;15;1;14;.933;3600000;0
28903;184648;886;0;0;0;0;.00nan;0;0
28903;176860;878;93;46;2;44;.957;3544000;0
28903;146300;878;0;0;0;0;.00nan;0;0
28904;163471;881;76;35;3;32;.914;3900000;0
28904;76574;882;0;0;0;0;.00nan;0;0
28904;78348;881;0;0;0;0;.00nan;0;0
28904;142911;882;74;29;3;26;.897;3900000;0
28905;676;883;54;30;4;26;.867;3560000;0
28905;166751;883;0;0;0;0;.00nan;0;0
28905;69536;873;0;0;0;0;.00nan;0;0
28905;70879;873;61;30;3;27;.900;3600000;0
28906;8519;877;71;30;3;27;.900;3600000;0
28906;184398;887;0;0;0;0;.00nan;0;0
28906;180731;877;0;0;0;0;.00nan;0;0
28906;147264;887;81;55;4;51;.927;3556000;0
28907;14266;1415;41;23;4;19;.826;3600000;0
28907;196005;875;0;0;0;0;.00nan;0;0
28907;76885;875;89;31;1;30;.968;3600000;0
28907;85787;1415;0;0;0;0;.00nan;0;0
28908;183775;893;0;0;0;0;.00nan;0;0
28908;78775;874;0;0;0;0;.00nan;0;0
28908;85670;893;70;38;4;34;.895;3600000;0
28908;143301;874;75;38;3;35;.921;3600000;0
28909;168712;876;70;23;3;20;.870;3554000;0
28909;184398;887;83;37;2;35;.946;3600000;0
28909;180316;876;0;0;0;0;.00nan;0;0
28909;147264;887;0;0;0;0;.00nan;0;0
28910;676;883;61;29;4;25;.862;3870000;0
28910;166751;883;0;0;0;0;.00nan;0;0
28910;176860;878;81;48;4;44;.917;3900000;0
28910;146300;878;0;0;0;0;.00nan;0;0
28911;28833;892;82;42;3;39;.929;3600000;0
28911;196005;875;0;0;0;0;.00nan;0;0
28911;192461;892;0;0;0;0;.00nan;0;0
28911;76885;875;53;36;5;31;.861;3571000;0
28912;163471;881;81;27;1;26;.963;3541000;0
28912;69536;873;100;29;0;29;1.000;3600000;0
28912;70879;873;0;0;0;0;.00nan;0;0
28912;78348;881;0;0;0;0;.00nan;0;0
28913;676;883;84;24;1;23;.958;3600000;0
28913;166751;883;0;0;0;0;.00nan;0;0
28913;78775;874;0;0;0;0;.00nan;0;0
28913;143301;874;76;27;3;24;.889;3600000;0
28914;28833;892;34;23;4;19;.826;3582000;0
28914;176860;878;65;25;2;23;.920;3600000;0
28914;192461;892;0;0;0;0;.00nan;0;0
28914;146300;878;0;0;0;0;.00nan;0;0
28915;162945;886;94;16;0;16;1.000;3600000;0
28915;8519;877;0;0;0;0;.00nan;0;0
28915;184648;886;0;0;0;0;.00nan;0;0
28915;180731;877;49;38;5;33;.868;3600000;0
28916;183775;893;0;0;0;0;.00nan;0;0
28916;196005;875;0;0;0;0;.00nan;0;0
28916;76885;875;93;46;2;44;.957;3600000;0
28916;85670;893;65;32;3;29;.906;3545000;0
28917;14266;1415;55;22;3;19;.864;3542000;0
28917;76574;882;0;0;0;0;.00nan;0;0
28917;85787;1415;0;0;0;0;.00nan;0;0
28917;142911;882;77;26;1;25;.962;3600000;0
28918;163471;881;0;0;0;0;.00nan;0;0
28918;69536;873;68;34;3;31;.912;3566000;0
28918;70879;873;0;0;0;0;.00nan;0;0
28918;78348;881;100;34;1;33;.971;3600000;0
28919;162945;886;53;25;3;22;.880;3900000;0
28919;183775;893;0;0;0;0;.00nan;0;0
28919;184648;886;0;0;0;0;.00nan;0;0
28919;85670;893;88;32;3;29;.906;3900000;0
28920;676;883;99;33;1;32;.970;3600000;0
28920;166751;883;0;0;0;0;.00nan;0;0
28920;8519;877;63;29;3;26;.897;3569000;0
28920;180731;877;0;0;0;0;.00nan;0;0
28921;28833;892;90;29;1;28;.966;3600000;0
28921;192461;892;0;0;0;0;.00nan;0;0
28921;78775;874;0;0;0;0;.00nan;0;0
28921;143301;874;50;24;3;21;.875;3564000;0
28922;176860;878;90;34;1;33;.971;3900000;0
28922;76574;882;79;27;1;26;.963;3900000;0
28922;142911;882;0;0;0;0;.00nan;0;0
28922;146300;878;0;0;0;0;.00nan;0;0
28923;196005;875;0;0;0;0;.00nan;0;0
28923;69536;873;0;0;0;0;.00nan;0;0
28923;70879;873;49;27;4;23;.852;3900000;0
28923;76885;875;74;48;4;44;.917;3900000;0
28924;14266;1415;44;20;3;17;.850;3547000;0
28924;184398;887;87;36;2;34;.944;3600000;0
28924;85787;1415;0;0;0;0;.00nan;0;0
28924;147264;887;0;0;0;0;.00nan;0;0
28925;183775;893;67;33;3;30;.909;3900000;0
28925;196005;875;0;0;0;0;.00nan;0;0
28925;76885;875;62;35;3;32;.914;3900000;0
28925;85670;893;0;0;0;0;.00nan;0;0
28926;163471;881;58;25;3;22;.880;3600000;0
28926;28833;892;100;40;0;40;1.000;3600000;0
28926;192461;892;0;0;0;0;.00nan;0;0
28926;78348;881;0;0;0;0;.00nan;0;0
28927;76574;882;70;20;1;19;.950;2720000;0
28927;78775;874;0;0;0;0;.00nan;0;0
28927;142911;882;26;14;4;10;.714;880000;0
28927;143301;874;100;31;0;31;1.000;3600000;0
28928;8519;877;0;0;0;0;.00nan;0;0
28928;180731;877;49;25;4;21;.840;3598000;0
28928;69536;873;78;35;3;32;.914;3600000;0
28928;70879;873;0;0;0;0;.00nan;0;0
28929;162945;886;74;27;2;25;.926;3824000;0
28929;184398;887;99;44;1;43;.977;3824000;0
28929;184648;886;0;0;0;0;.00nan;0;0
28929;147264;887;0;0;0;0;.00nan;0;0
28930;676;883;57;22;2;20;.909;3600000;0
28930;166751;883;0;0;0;0;.00nan;0;0
28930;14266;1415;56;32;4;28;.875;3559000;0
28930;85787;1415;0;0;0;0;.00nan;0;0
28931;8519;877;0;0;0;0;.00nan;0;0
28931;184398;887;79;26;1;25;.962;3588000;0
28931;180731;877;100;28;0;28;1.000;3600000;0
28931;147264;887;0;0;0;0;.00nan;0;0
28932;183775;893;0;0;0;0;.00nan;0;0
28932;168712;876;69;40;3;37;.925;3889000;0
28932;180316;876;0;0;0;0;.00nan;0;0
28932;85670;893;44;18;3;15;.833;3900000;0
28933;676;883;64;27;2;25;.926;3600000;0
28933;166751;883;0;0;0;0;.00nan;0;0
28933;69536;873;50;28;4;24;.857;3589000;0
28933;70879;873;0;0;0;0;.00nan;0;0
28934;162945;886;70;29;2;27;.931;3600000;0
28934;184648;886;0;0;0;0;.00nan;0;0
28934;78775;874;0;0;0;0;.00nan;0;0
28934;143301;874;70;36;4;32;.889;3589000;0
28935;28833;892;85;23;1;22;.957;3600000;0
28935;192461;892;0;0;0;0;.00nan;0;0
28935;76574;882;0;0;0;0;.00nan;0;0
28935;142911;882;76;45;4;41;.911;3600000;0
28936;184398;887;100;26;0;26;1.000;3600000;0
28936;196005;875;0;0;0;0;.00nan;0;0
28936;76885;875;48;27;4;23;.852;3600000;0
28936;147264;887;0;0;0;0;.00nan;0;0
28937;14266;1415;75;24;1;23;.958;3900000;0
28937;176860;878;90;28;1;27;.964;3900000;0
28937;85787;1415;0;0;0;0;.00nan;0;0
28937;146300;878;0;0;0;0;.00nan;0;0
28938;163471;881;0;0;0;0;.00nan;0;0
28938;8519;877;0;0;0;0;.00nan;0;0
28938;180731;877;61;23;4;19;.826;3735000;0
28938;78348;881;75;29;3;26;.897;3735000;0
28939;28833;892;88;25;1;24;.960;3900000;0
28939;176860;878;100;38;1;37;.974;3900000;0
28939;192461;892;0;0;0;0;.00nan;0;0
28939;146300;878;0;0;0;0;.00nan;0;0
28940;676;883;96;38;2;36;.947;3600000;0
28940;166751;883;0;0;0;0;.00nan;0;0
28940;196005;875;0;0;0;0;.00nan;0;0
28940;76885;875;53;25;3;22;.880;3600000;0
28941;162945;886;100;28;0;28;1.000;3600000;0
28941;14266;1415;46;30;5;25;.833;3600000;0
28941;184648;886;0;0;0;0;.00nan;0;0
28941;85787;1415;0;0;0;0;.00nan;0;0
28942;8519;877;76;34;2;32;.941;3600000;0
28942;168712;876;58;37;4;33;.892;3584000;0
28942;180316;876;0;0;0;0;.00nan;0;0
28942;180731;877;0;0;0;0;.00nan;0;0
28943;69536;873;0;0;0;0;.00nan;0;0
28943;70879;873;67;30;3;27;.900;3558000;0
28943;78775;874;0;0;0;0;.00nan;0;0
28943;143301;874;66;23;2;21;.913;3600000;0
28944;183775;893;0;0;0;0;.00nan;0;0
28944;76574;882;0;0;0;0;.00nan;0;0
28944;85670;893;80;32;2;30;.938;3639000;0
28944;142911;882;58;30;3;27;.900;3639000;0
28945;163471;881;78;25;2;23;.920;3600000;0
28945;184398;887;89;50;3;47;.940;3546000;0
28945;78348;881;0;0;0;0;.00nan;0;0
28945;147264;887;0;0;0;0;.00nan;0;0
28946;14266;1415;0;0;0;0;.00nan;0;0
28946;69536;873;24;21;6;15;.714;2772000;0
28946;70879;873;55;5;0;5;1.000;828000;0
28946;85787;1415;89;28;1;27;.964;3600000;0
28947;163471;881;31;26;5;21;.808;3515000;0
28947;183775;893;0;0;0;0;.00nan;0;0
28947;78348;881;0;0;0;0;.00nan;0;0
28947;85670;893;78;41;3;38;.927;3600000;0
28948;168712;876;0;0;0;0;.00nan;0;0
28948;180316;876;49;25;4;21;.840;3600000;0
28948;76574;882;0;0;0;0;.00nan;0;0
28948;142911;882;57;44;5;39;.886;3566000;0
28949;8519;877;0;0;0;0;.00nan;0;0
28949;176860;878;0;0;0;0;.00nan;0;0
28949;180731;877;55;7;1;6;.857;3600000;0
28949;146300;878;67;43;5;38;.884;3600000;0
28950;676;883;61;29;3;26;.897;3554000;0
28950;166751;883;0;0;0;0;.00nan;0;0
28950;78775;874;0;0;0;0;.00nan;0;0
28950;143301;874;99;42;1;41;.976;3600000;0
28951;162945;886;83;23;1;22;.957;3600000;0
28951;184648;886;0;0;0;0;.00nan;0;0
28951;196005;875;0;0;0;0;.00nan;0;0
28951;76885;875;77;41;4;37;.902;3600000;0
28952;14266;1415;64;16;1;15;.938;3600000;0
28952;69536;873;56;29;4;25;.862;3600000;0
28952;70879;873;0;0;0;0;.00nan;0;0
28952;85787;1415;0;0;0;0;.00nan;0;0
28953;184398;887;62;20;2;18;.900;3600000;0
28953;28833;892;78;36;3;33;.917;3600000;0
28953;192461;892;0;0;0;0;.00nan;0;0
28953;147264;887;0;0;0;0;.00nan;0;0
28954;168712;876;85;39;3;36;.923;3586000;0
28954;180316;876;0;0;0;0;.00nan;0;0
28954;69536;873;78;25;2;23;.920;3600000;0
28954;70879;873;0;0;0;0;.00nan;0;0
28955;162945;886;0;0;0;0;.00nan;0;0
28955;184648;886;76;22;1;21;.955;3600000;0
28955;28833;892;89;41;3;38;.927;3538000;0
28955;192461;892;0;0;0;0;.00nan;0;0
28956;8519;877;0;0;0;0;.00nan;0;0
28956;180731;877;67;18;2;16;.889;3600000;0
28956;76574;882;98;48;3;45;.938;3593000;0
28956;142911;882;0;0;0;0;.00nan;0;0
28957;196005;875;0;0;0;0;.00nan;0;0
28957;76885;875;50;24;4;20;.833;3600000;0
28957;78775;874;0;0;0;0;.00nan;0;0
28957;143301;874;43;38;6;32;.842;3600000;0
28958;184398;887;69;19;1;18;.947;3600000;0
28958;176860;878;64;39;5;34;.872;3600000;0
28958;146300;878;0;0;0;0;.00nan;0;0
28958;147264;887;0;0;0;0;.00nan;0;0
28959;14266;1415;85;33;3;30;.909;3568000;0
28959;183775;893;0;0;0;0;.00nan;0;0
28959;85670;893;78;36;2;34;.944;3600000;0
28959;85787;1415;0;0;0;0;.00nan;0;0
28960;676;883;59;7;0;7;1.000;752000;0
28960;166751;883;37;33;6;27;.818;2848000;0
28960;163471;881;87;31;1;30;.968;3600000;0
28960;78348;881;0;0;0;0;.00nan;0;0
28961;8519;877;0;0;0;0;.00nan;0;0
28961;28833;892;84;33;2;31;.939;3548000;0
28961;180731;877;100;25;0;25;1.000;3600000;0
28961;192461;892;0;0;0;0;.00nan;0;0
28962;183775;893;72;25;1;24;.960;2859000;0
28962;184398;887;79;31;2;29;.935;3600000;0
28962;85670;893;21;10;4;6;.600;741000;0
28962;147264;887;0;0;0;0;.00nan;0;0
28963;8519;877;0;0;0;0;.00nan;0;0
28963;28833;892;0;0;0;0;.00nan;0;0
28963;180731;877;40;25;4;21;.840;3600000;0
28963;192461;892;80;34;3;31;.912;3600000;0
28964;676;883;0;0;0;0;.00nan;0;0
28964;166751;883;91;19;0;19;1.000;3600000;0
28964;176860;878;97;47;1;46;.979;3564000;0
28964;146300;878;0;0;0;0;.00nan;0;0
28965;196005;875;0;0;0;0;.00nan;0;0
28965;76574;882;0;0;0;0;.00nan;0;0
28965;76885;875;82;37;3;34;.919;3600000;0
28965;142911;882;99;42;2;40;.952;3600000;0
28966;162945;886;100;24;0;24;1.000;3600000;0
28966;184648;886;0;0;0;0;.00nan;0;0
28966;69536;873;0;0;0;0;.00nan;0;0
28966;70879;873;72;41;4;37;.902;3600000;0
28967;14266;1415;50;29;5;24;.828;3788000;0
28967;168712;876;42;32;6;26;.813;3788000;0
28967;180316;876;0;0;0;0;.00nan;0;0
28967;85787;1415;0;0;0;0;.00nan;0;0
28968;163471;881;67;25;3;22;.880;3600000;0
28968;78348;881;0;0;0;0;.00nan;0;0
28968;78775;874;54;4;0;4;1.000;278000;0
28968;143301;874;36;43;8;35;.814;3322000;0
28969;183775;893;0;0;0;0;.00nan;0;0
28969;69536;873;40;36;5;31;.861;3600000;0
28969;70879;873;0;0;0;0;.00nan;0;0
28969;85670;893;69;25;2;23;.920;3600000;0
28970;676;883;0;0;0;0;.00nan;0;0
28970;166751;883;64;28;3;25;.893;3600000;0
28970;28833;892;45;37;5;32;.865;3568000;0
28970;192461;892;0;0;0;0;.00nan;0;0
28971;162945;886;76;38;4;34;.895;3600000;0
28971;8519;877;0;0;0;0;.00nan;0;0
28971;184648;886;0;0;0;0;.00nan;0;0
28971;180731;877;61;25;3;22;.880;3600000;0
28972;176860;878;78;32;2;30;.938;3600000;0
28972;78775;874;66;27;3;24;.889;3587000;0
28972;143301;874;0;0;0;0;.00nan;0;0
28972;146300;878;0;0;0;0;.00nan;0;0
28973;14266;1415;72;24;2;22;.917;3575000;0
28973;196005;875;0;0;0;0;.00nan;0;0
28973;76885;875;100;43;1;42;.977;3600000;0
28973;85787;1415;0;0;0;0;.00nan;0;0
28974;168712;876;63;30;3;27;.900;3600000;0
28974;184398;887;81;35;2;33;.943;3600000;0
28974;180316;876;0;0;0;0;.00nan;0;0
28974;147264;887;0;0;0;0;.00nan;0;0
28975;163471;881;0;0;0;0;.00nan;0;0
28975;76574;882;0;0;0;0;.00nan;0;0
28975;78348;881;66;25;2;23;.920;3600000;0
28975;142911;882;72;40;3;37;.925;3600000;0
28976;14266;1415;41;24;4;20;.833;3124000;0
28976;183775;893;0;0;0;0;.00nan;0;0
28976;85670;893;76;26;1;25;.962;3600000;0
28976;85787;1415;56;6;0;6;1.000;476000;0
28977;162945;886;77;28;1;27;.964;3600000;0
28977;163471;881;54;30;4;26;.867;3600000;0
28977;184648;886;0;0;0;0;.00nan;0;0
28977;78348;881;0;0;0;0;.00nan;0;0
28978;168712;876;100;37;1;36;.973;3900000;0
28978;180316;876;0;0;0;0;.00nan;0;0
28978;76574;882;0;0;0;0;.00nan;0;0
28978;142911;882;80;30;1;29;.967;3900000;0
28979;168712;876;86;29;1;28;.966;3600000;0
28979;196005;875;0;0;0;0;.00nan;0;0
28979;180316;876;0;0;0;0;.00nan;0;0
28979;76885;875;98;38;2;36;.947;3551000;0
28980;28833;892;0;0;0;0;.00nan;0;0
28980;192461;892;73;40;4;36;.900;3600000;0
28980;69536;873;25;19;5;14;.737;1663000;0
28980;70879;873;38;17;3;14;.824;1937000;0
28981;163471;881;89;31;1;30;.968;3600000;0
28981;176860;878;67;36;4;32;.889;3600000;0
28981;78348;881;0;0;0;0;.00nan;0;0
28981;146300;878;0;0;0;0;.00nan;0;0
28982;676;883;0;0;0;0;.00nan;0;0
28982;166751;883;68;33;4;29;.879;3600000;0
28982;162945;886;64;18;1;17;.944;3600000;0
28982;184648;886;0;0;0;0;.00nan;0;0
28983;8519;877;0;0;0;0;.00nan;0;0
28983;183775;893;0;0;0;0;.00nan;0;0
28983;180731;877;60;20;2;18;.900;3600000;0
28983;85670;893;69;37;4;33;.892;3513000;0
28984;184398;887;57;29;5;24;.828;3859000;0
28984;76574;882;0;0;0;0;.00nan;0;0
28984;142911;882;56;41;6;35;.854;3859000;0
28984;147264;887;0;0;0;0;.00nan;0;0
28985;14266;1415;0;0;0;0;.00nan;0;0
28985;78775;874;0;0;0;0;.00nan;0;0
28985;85787;1415;90;33;1;32;.970;3600000;0
28985;143301;874;43;43;7;36;.837;3600000;0
28986;676;883;0;0;0;0;.00nan;0;0
28986;166751;883;57;21;3;18;.857;3515000;0
28986;183775;893;0;0;0;0;.00nan;0;0
28986;85670;893;91;29;1;28;.966;3600000;0
28987;168712;876;69;28;2;26;.929;3600000;0
28987;28833;892;53;24;3;21;.875;3600000;0
28987;180316;876;0;0;0;0;.00nan;0;0
28987;192461;892;0;0;0;0;.00nan;0;0
28988;162945;886;80;29;2;27;.931;3600000;0
28988;184648;886;0;0;0;0;.00nan;0;0
28988;176860;878;62;38;5;33;.868;3600000;0
28988;146300;878;0;0;0;0;.00nan;0;0
28989;8519;877;0;0;0;0;.00nan;0;0
28989;180731;877;83;32;2;30;.938;3600000;0
28989;78775;874;0;0;0;0;.00nan;0;0
28989;143301;874;91;45;3;42;.933;3594000;0
28990;14266;1415;47;28;4;24;.857;3578000;0
28990;76574;882;0;0;0;0;.00nan;0;0
28990;85787;1415;0;0;0;0;.00nan;0;0
28990;142911;882;68;29;2;27;.931;3600000;0
28991;163471;881;55;19;2;17;.895;3600000;0
28991;196005;875;71;43;4;39;.907;3527000;0
28991;76885;875;0;0;0;0;.00nan;0;0
28991;78348;881;0;0;0;0;.00nan;0;0
28992;184398;887;100;43;2;41;.953;3600000;0
28992;69536;873;82;44;4;40;.909;3600000;0
28992;70879;873;0;0;0;0;.00nan;0;0
28992;147264;887;0;0;0;0;.00nan;0;0
28993;183775;893;0;0;0;0;.00nan;0;0
28993;28833;892;0;0;0;0;.00nan;0;0
28993;192461;892;100;28;0;28;1.000;3600000;0
28993;85670;893;50;30;4;26;.867;3600000;0
28994;676;883;0;0;0;0;.00nan;0;0
28994;166751;883;63;21;2;19;.905;3600000;0
28994;184398;887;47;25;4;21;.840;2082000;0
28994;147264;887;52;16;2;14;.875;1518000;0
28995;176860;878;0;0;0;0;.00nan;0;0
28995;196005;875;0;0;0;0;.00nan;0;0
28995;76885;875;72;32;3;29;.906;3691000;0
28995;146300;878;79;32;2;30;.938;3691000;0
28996;8519;877;63;32;3;29;.906;3591000;0
28996;14266;1415;96;36;2;34;.944;3600000;0
28996;180731;877;0;0;0;0;.00nan;0;0
28996;85787;1415;0;0;0;0;.00nan;0;0
28997;168712;876;87;25;1;24;.960;3600000;0
28997;180316;876;0;0;0;0;.00nan;0;0
28997;78775;874;0;0;0;0;.00nan;0;0
28997;143301;874;85;37;3;34;.919;3600000;0
28998;69536;873;42;23;4;19;.826;3572000;0
28998;70879;873;0;0;0;0;.00nan;0;0
28998;76574;882;0;0;0;0;.00nan;0;0
28998;142911;882;80;31;2;29;.935;3600000;0
28999;162945;886;74;37;3;34;.919;3560000;0
28999;163471;881;100;34;1;33;.971;3600000;0
28999;184648;886;0;0;0;0;.00nan;0;0
28999;78348;881;0;0;0;0;.00nan;0;0
29000;183775;893;0;0;0;0;.00nan;0;0
29000;176860;878;46;34;5;29;.853;3600000;0
29000;85670;893;70;25;2;23;.920;3600000;0
29000;146300;878;0;0;0;0;.00nan;0;0
29001;676;883;73;16;1;15;.938;3600000;0
29001;166751;883;0;0;0;0;.00nan;0;0
29001;168712;876;0;0;0;0;.00nan;0;0
29001;180316;876;73;56;6;50;.893;3600000;0
29002;162945;886;0;0;0;0;.00nan;0;0
29002;184648;886;85;18;0;18;1.000;3600000;0
29002;76574;882;0;0;0;0;.00nan;0;0
29002;142911;882;72;35;3;32;.914;3600000;0
29003;8519;877;0;0;0;0;.00nan;0;0
29003;196005;875;50;36;5;31;.861;3600000;0
29003;180731;877;79;25;1;24;.960;3600000;0
29003;76885;875;0;0;0;0;.00nan;0;0
29004;163471;881;83;32;2;30;.938;3600000;0
29004;69536;873;0;0;0;0;.00nan;0;0
29004;70879;873;66;38;4;34;.895;3600000;0
29004;78348;881;0;0;0;0;.00nan;0;0
29005;184398;887;0;0;0;0;.00nan;0;0
29005;78775;874;0;0;0;0;.00nan;0;0
29005;143301;874;60;27;3;24;.889;3558000;0
29005;147264;887;71;24;1;23;.958;3600000;0
29006;14266;1415;63;25;3;22;.880;3600000;0
29006;28833;892;0;0;0;0;.00nan;0;0
29006;192461;892;45;23;4;19;.826;3600000;0
29006;85787;1415;0;0;0;0;.00nan;0;0
29007;162945;886;0;0;0;0;.00nan;0;0
29007;168712;876;52;33;5;28;.848;3567000;0
29007;184648;886;65;32;3;29;.906;3600000;0
29007;180316;876;0;0;0;0;.00nan;0;0
29008;28833;892;0;0;0;0;.00nan;0;0
29008;196005;875;86;28;2;26;.929;3600000;0
29008;192461;892;86;47;3;44;.936;3549000;0
29008;76885;875;0;0;0;0;.00nan;0;0
29009;676;883;59;19;2;17;.895;3600000;0
29009;166751;883;0;0;0;0;.00nan;0;0
29009;76574;882;0;0;0;0;.00nan;0;0
29009;142911;882;51;33;5;28;.848;3600000;0
29010;176860;878;98;38;2;36;.947;3868000;0
29010;69536;873;92;35;2;33;.943;3900000;0
29010;70879;873;0;0;0;0;.00nan;0;0
29010;146300;878;0;0;0;0;.00nan;0;0
29011;8519;877;0;0;0;0;.00nan;0;0
29011;184398;887;99;43;1;42;.977;3600000;0
29011;180731;877;69;21;2;19;.905;3583000;0
29011;147264;887;0;0;0;0;.00nan;0;0
29012;183775;893;0;0;0;0;.00nan;0;0
29012;78775;874;0;0;0;0;.00nan;0;0
29012;85670;893;88;33;1;32;.970;3600000;0
29012;143301;874;68;31;3;28;.903;3578000;0
29013;163471;881;0;0;0;0;.00nan;0;0
29013;14266;1415;49;36;5;31;.861;3595000;0
29013;78348;881;61;27;3;24;.889;3600000;0
29013;85787;1415;0;0;0;0;.00nan;0;0
29014;183775;893;77;26;1;25;.962;3563000;0
29014;28833;892;100;23;0;23;1.000;3600000;0
29014;192461;892;0;0;0;0;.00nan;0;0
29014;85670;893;0;0;0;0;.00nan;0;0
29015;14266;1415;61;29;3;26;.897;3547000;0
29015;168712;876;0;0;0;0;.00nan;0;0
29015;180316;876;90;36;2;34;.944;3600000;0
29015;85787;1415;0;0;0;0;.00nan;0;0
29016;162945;886;80;34;2;32;.941;3600000;0
29016;8519;877;0;0;0;0;.00nan;0;0
29016;184648;886;0;0;0;0;.00nan;0;0
29016;180731;877;82;39;3;36;.923;3556000;0
29017;76574;882;48;32;4;28;.875;3512000;0
29017;78775;874;0;0;0;0;.00nan;0;0
29017;142911;882;0;0;0;0;.00nan;0;0
29017;143301;874;74;25;2;23;.920;3600000;0
29018;176860;878;75;29;2;27;.931;3900000;0
29018;196005;875;0;0;0;0;.00nan;0;0
29018;76885;875;66;28;2;26;.929;3900000;0
29018;146300;878;0;0;0;0;.00nan;0;0
29019;676;883;98;23;0;23;1.000;3900000;0
29019;166751;883;0;0;0;0;.00nan;0;0
29019;184398;887;90;27;0;27;1.000;3900000;0
29019;147264;887;0;0;0;0;.00nan;0;0
29020;163471;881;89;40;2;38;.950;3900000;0
29020;168712;876;0;0;0;0;.00nan;0;0
29020;180316;876;80;29;2;27;.931;3900000;0
29020;78348;881;0;0;0;0;.00nan;0;0
29021;162945;886;74;25;2;23;.920;3600000;0
29021;184648;886;0;0;0;0;.00nan;0;0
29021;28833;892;50;41;6;35;.854;3600000;0
29021;192461;892;0;0;0;0;.00nan;0;0
29022;676;883;100;24;0;24;1.000;3600000;0
29022;166751;883;0;0;0;0;.00nan;0;0
29022;183775;893;0;0;0;0;.00nan;0;0
29022;85670;893;80;35;2;33;.943;3517000;0
29023;184398;887;78;29;3;26;.897;3600000;0
29023;176860;878;41;30;5;25;.833;3600000;0
29023;146300;878;0;0;0;0;.00nan;0;0
29023;147264;887;0;0;0;0;.00nan;0;0
29024;196005;875;70;27;2;25;.926;3600000;0
29024;76885;875;0;0;0;0;.00nan;0;0
29024;78775;874;0;0;0;0;.00nan;0;0
29024;143301;874;69;28;3;25;.893;3546000;0
29025;69536;873;0;0;0;0;.00nan;0;0
29025;70879;873;63;29;3;26;.897;3600000;0
29025;76574;882;0;0;0;0;.00nan;0;0
29025;142911;882;36;33;5;28;.848;3519000;0
29026;8519;877;0;0;0;0;.00nan;0;0
29026;14266;1415;0;0;0;0;.00nan;0;0
29026;180731;877;100;22;0;22;1.000;3600000;0
29026;85787;1415;71;36;3;33;.917;3600000;0
29027;184398;887;73;39;3;36;.923;3512000;0
29027;28833;892;0;0;0;0;.00nan;0;0
29027;192461;892;71;23;1;22;.957;3600000;0
29027;147264;887;0;0;0;0;.00nan;0;0
29028;676;883;50;28;4;24;.857;3600000;0
29028;166751;883;0;0;0;0;.00nan;0;0
29028;163471;881;98;27;0;27;1.000;3600000;0
29028;78348;881;0;0;0;0;.00nan;0;0
29029;162945;886;88;28;1;27;.964;3600000;0
29029;184648;886;0;0;0;0;.00nan;0;0
29029;176860;878;62;48;5;43;.896;3600000;0
29029;146300;878;0;0;0;0;.00nan;0;0
29030;8519;877;0;0;0;0;.00nan;0;0
29030;180731;877;85;26;1;25;.962;3600000;0
29030;76574;882;0;0;0;0;.00nan;0;0
29030;142911;882;46;33;5;28;.848;3600000;0
29031;14266;1415;38;32;6;26;.813;3600000;0
29031;78775;874;0;0;0;0;.00nan;0;0
29031;85787;1415;0;0;0;0;.00nan;0;0
29031;143301;874;62;26;3;23;.885;3600000;0
29032;168712;876;0;0;0;0;.00nan;0;0
29032;196005;875;0;0;0;0;.00nan;0;0
29032;180316;876;71;30;3;27;.900;3600000;0
29032;76885;875;67;40;4;36;.900;3552000;0
29033;183775;893;0;0;0;0;.00nan;0;0
29033;69536;873;0;0;0;0;.00nan;0;0
29033;70879;873;64;42;5;37;.881;3573000;0
29033;85670;893;64;30;4;26;.867;3600000;0
29034;14266;1415;85;45;4;41;.911;3600000;0
29034;28833;892;0;0;0;0;.00nan;0;0
29034;192461;892;72;25;1;24;.960;3600000;0
29034;85787;1415;0;0;0;0;.00nan;0;0
29035;162945;886;0;0;0;0;.00nan;0;0
29035;184648;886;30;29;6;23;.793;3600000;0
29035;196005;875;79;38;3;35;.921;3600000;0
29035;76885;875;0;0;0;0;.00nan;0;0
29036;8519;877;0;0;0;0;.00nan;0;0
29036;168712;878;54;40;6;34;.850;3230000;0
29036;176860;878;59;6;0;6;1.000;370000;0
29036;180731;877;73;26;2;24;.923;3600000;0
29037;184398;887;77;28;2;26;.929;3600000;0
29037;78775;874;0;0;0;0;.00nan;0;0
29037;143301;874;79;35;3;32;.914;3552000;0
29037;147264;887;0;0;0;0;.00nan;0;0
29038;676;883;99;44;1;43;.977;3600000;0
29038;166751;883;0;0;0;0;.00nan;0;0
29038;76574;882;0;0;0;0;.00nan;0;0
29038;142911;882;58;53;6;47;.887;3600000;0
29039;180316;876;31;16;4;12;.750;1856000;0
29039;65762;876;91;25;0;25;1.000;2044000;0
29039;69536;873;48;23;4;19;.826;3900000;0
29039;70879;873;0;0;0;0;.00nan;0;0
29040;163471;881;49;32;5;27;.844;3600000;0
29040;183775;893;0;0;0;0;.00nan;0;0
29040;78348;881;0;0;0;0;.00nan;0;0
29040;85670;893;98;26;0;26;1.000;3600000;0
29041;183775;893;0;0;0;0;.00nan;0;0
29041;76574;882;0;0;0;0;.00nan;0;0
29041;85670;893;75;22;1;21;.955;3600000;0
29041;142911;882;66;23;2;21;.913;3600000;0
29042;28833;892;79;38;4;34;.895;3600000;0
29042;180316;876;97;37;1;36;.973;3600000;0
29042;192461;892;0;0;0;0;.00nan;0;0
29042;65762;876;0;0;0;0;.00nan;0;0
29043;676;883;98;42;2;40;.952;3600000;0
29043;166751;883;0;0;0;0;.00nan;0;0
29043;162945;886;92;20;0;20;1.000;3600000;0
29043;184648;886;0;0;0;0;.00nan;0;0
29044;168712;878;86;28;1;27;.964;3611000;0
29044;176860;878;0;0;0;0;.00nan;0;0
29044;78775;874;0;0;0;0;.00nan;0;0
29044;143301;874;85;31;2;29;.935;3611000;0
29045;8519;877;0;0;0;0;.00nan;0;0
29045;180731;877;99;24;0;24;1.000;3600000;0
29045;69536;873;95;33;1;32;.970;3589000;0
29045;70879;873;0;0;0;0;.00nan;0;0
29046;184398;887;58;26;4;22;.846;3600000;0
29046;196005;875;100;28;0;28;1.000;3600000;0
29046;76885;875;0;0;0;0;.00nan;0;0
29046;147264;887;0;0;0;0;.00nan;0;0
29047;163471;881;86;18;0;18;1.000;3600000;0
29047;14266;1415;75;41;4;37;.902;3600000;0
29047;78348;881;0;0;0;0;.00nan;0;0
29047;85787;1415;0;0;0;0;.00nan;0;0
29048;8519;877;0;0;0;0;.00nan;0;0
29048;180316;876;74;34;2;32;.941;3585000;0
29048;180731;877;67;22;1;21;.955;3600000;0
29048;65762;876;0;0;0;0;.00nan;0;0
29049;183775;893;0;0;0;0;.00nan;0;0
29049;168712;878;76;29;2;27;.931;3704000;0
29049;176860;878;0;0;0;0;.00nan;0;0
29049;85670;893;94;44;3;41;.932;3704000;0
29050;162945;886;79;26;1;25;.962;3600000;0
29050;184398;887;51;28;4;24;.857;3600000;0
29050;184648;886;0;0;0;0;.00nan;0;0
29050;147264;887;0;0;0;0;.00nan;0;0
29051;163471;881;98;36;2;34;.944;3600000;0
29051;78348;881;0;0;0;0;.00nan;0;0
29051;78775;874;75;34;3;31;.912;3593000;0
29051;143301;874;0;0;0;0;.00nan;0;0
29052;676;883;83;27;2;25;.926;3584000;0
29052;166751;883;0;0;0;0;.00nan;0;0
29052;196005;875;89;31;1;30;.968;3600000;0
29052;76885;875;0;0;0;0;.00nan;0;0
29053;28833;892;83;38;3;35;.921;3600000;0
29053;192461;892;0;0;0;0;.00nan;0;0
29053;69536;873;79;35;2;33;.943;3600000;0
29053;70879;873;0;0;0;0;.00nan;0;0
29054;14266;1415;0;0;0;0;.00nan;0;0
29054;76574;882;0;0;0;0;.00nan;0;0
29054;85787;1415;62;25;3;22;.880;3600000;0
29054;142911;882;74;54;5;49;.907;3552000;0
29055;28833;892;0;0;0;0;.00nan;0;0
29055;192461;892;95;23;0;23;1.000;3600000;0
29055;78775;874;0;0;0;0;.00nan;0;0
29055;143301;874;71;29;2;27;.931;3558000;0
29056;676;883;0;0;0;0;.00nan;0;0
29056;166751;883;49;30;4;26;.867;3571000;0
29056;180316;876;76;35;3;32;.914;3600000;0
29056;65762;876;0;0;0;0;.00nan;0;0
29057;8519;877;68;26;2;24;.923;3851000;0
29057;196005;875;100;52;1;51;.981;3851000;0
29057;180731;877;0;0;0;0;.00nan;0;0
29057;76885;875;0;0;0;0;.00nan;0;0
29058;162945;886;67;23;2;21;.913;3514000;0
29058;184648;886;0;0;0;0;.00nan;0;0
29058;76574;882;0;0;0;0;.00nan;0;0
29058;142911;882;100;36;0;36;1.000;3600000;0
29059;184398;887;89;36;2;34;.944;3600000;0
29059;69536;873;71;27;3;24;.889;3600000;0
29059;70879;873;0;0;0;0;.00nan;0;0
29059;147264;887;0;0;0;0;.00nan;0;0
29060;163471;881;0;0;0;0;.00nan;0;0
29060;168712;878;35;27;5;22;.815;3600000;0
29060;176860;878;0;0;0;0;.00nan;0;0
29060;78348;881;72;22;1;21;.955;3600000;0
29061;180316;876;45;31;5;26;.839;3552000;0
29061;65762;876;0;0;0;0;.00nan;0;0
29061;78775;874;0;0;0;0;.00nan;0;0
29061;143301;874;87;38;3;35;.921;3600000;0
29062;676;883;74;20;1;19;.950;3600000;0
29062;166751;883;0;0;0;0;.00nan;0;0
29062;8519;877;0;0;0;0;.00nan;0;0
29062;180731;877;71;35;3;32;.914;3515000;0
29063;168712;878;63;45;5;40;.889;3738000;0
29063;28833;892;0;0;0;0;.00nan;0;0
29063;176860;878;0;0;0;0;.00nan;0;0
29063;192461;892;68;36;4;32;.889;3738000;0
29064;162945;886;0;0;0;0;.00nan;0;0
29064;184648;886;76;24;2;22;.917;3600000;0
29064;69536;873;37;28;6;22;.786;3600000;0
29064;70879;873;0;0;0;0;.00nan;0;0
29065;163471;881;50;21;4;17;.810;3861000;0
29065;76574;882;0;0;0;0;.00nan;0;0
29065;78348;881;0;0;0;0;.00nan;0;0
29065;142911;882;84;41;4;37;.902;3900000;0
29066;183775;893;0;0;0;0;.00nan;0;0
29066;196005;875;67;38;4;34;.895;3524000;0
29066;76885;875;0;0;0;0;.00nan;0;0
29066;85670;893;72;21;2;19;.905;3600000;0
29067;14266;1415;45;23;4;19;.826;3600000;0
29067;184398;887;17;7;4;3;.429;367000;0
29067;85787;1415;0;0;0;0;.00nan;0;0
29067;147264;887;55;30;4;26;.867;3233000;0
29068;168712;878;85;43;3;40;.930;3626000;0
29068;176860;878;0;0;0;0;.00nan;0;0
29068;180316;876;39;19;4;15;.789;3626000;0
29068;65762;876;0;0;0;0;.00nan;0;0
29069;28833;892;100;24;0;24;1.000;3600000;0
29069;192461;892;0;0;0;0;.00nan;0;0
29069;76574;882;56;22;3;19;.864;1936000;0
29069;142911;882;17;22;6;16;.727;1664000;0
29070;163471;881;53;31;4;27;.871;3587000;0
29070;8519;877;0;0;0;0;.00nan;0;0
29070;180731;877;64;26;3;23;.885;3600000;0
29070;78348;881;0;0;0;0;.00nan;0;0
29071;162945;886;89;30;1;29;.967;3600000;0
29071;184648;886;0;0;0;0;.00nan;0;0
29071;78775;874;0;0;0;0;.00nan;0;0
29071;143301;874;59;27;3;24;.889;3557000;0
29072;676;883;83;30;2;28;.933;3600000;0
29072;166751;883;0;0;0;0;.00nan;0;0
29072;69536;873;0;0;0;0;.00nan;0;0
29072;70879;873;61;28;3;25;.893;3553000;0
29073;183775;893;0;0;0;0;.00nan;0;0
29073;184398;887;0;0;0;0;.00nan;0;0
29073;85670;893;78;33;2;31;.939;3600000;0
29073;147264;887;90;32;1;31;.969;3600000;0
29074;14266;1415;0;0;0;0;.00nan;0;0
29074;196005;875;42;37;5;32;.865;3600000;0
29074;76885;875;0;0;0;0;.00nan;0;0
29074;85787;1415;97;21;0;21;1.000;3600000;0
29075;8519;877;0;0;0;0;.00nan;0;0
29075;183775;893;74;32;2;30;.938;3548000;0
29075;180731;877;100;24;0;24;1.000;3600000;0
29075;85670;893;0;0;0;0;.00nan;0;0
29076;676;883;0;0;0;0;.00nan;0;0
29076;166751;883;57;27;4;23;.852;3600000;0
29076;78775;874;0;0;0;0;.00nan;0;0
29076;143301;874;52;38;5;33;.868;3591000;0
29077;14266;1415;0;0;0;0;.00nan;0;0
29077;168712;878;82;31;1;30;.968;3600000;0
29077;176860;878;0;0;0;0;.00nan;0;0
29077;85787;1415;63;29;3;26;.897;3522000;0
29078;162945;886;57;19;2;17;.895;3585000;0
29078;184648;886;0;0;0;0;.00nan;0;0
29078;180316;876;92;37;1;36;.973;3600000;0
29078;65762;876;0;0;0;0;.00nan;0;0
29079;184398;887;91;28;1;27;.964;3568000;0
29079;76574;882;0;0;0;0;.00nan;0;0
29079;142911;882;100;32;0;32;1.000;3600000;0
29079;147264;887;0;0;0;0;.00nan;0;0
29080;196005;875;0;0;0;0;.00nan;0;0
29080;69536;873;69;29;3;26;.897;3900000;0
29080;70879;873;0;0;0;0;.00nan;0;0
29080;76885;875;97;46;3;43;.935;3900000;0
29081;163471;881;0;0;0;0;.00nan;0;0
29081;28833;892;42;36;6;30;.833;3600000;0
29081;192461;892;0;0;0;0;.00nan;0;0
29081;78348;881;60;21;2;19;.905;3600000;0
29082;183775;893;0;0;0;0;.00nan;0;0
29082;180316;876;0;0;0;0;.00nan;0;0
29082;65762;876;68;34;3;31;.912;3787000;0
29082;85670;893;67;37;4;33;.892;3787000;0
29083;676;883;0;0;0;0;.00nan;0;0
29083;166751;883;57;30;5;25;.833;3600000;0
29083;28833;892;0;0;0;0;.00nan;0;0
29083;192461;892;100;46;2;44;.957;3600000;0
29084;8519;877;0;0;0;0;.00nan;0;0
29084;180731;877;66;24;2;22;.917;3600000;0
29084;78775;874;100;30;0;30;1.000;3600000;0
29084;143301;874;0;0;0;0;.00nan;0;0
29085;196005;875;76;26;1;25;.962;3563000;0
29085;76574;882;0;0;0;0;.00nan;0;0
29085;76885;875;0;0;0;0;.00nan;0;0
29085;142911;882;100;45;0;45;1.000;3600000;0
29086;168712;878;54;38;6;32;.842;3600000;0
29086;176860;878;0;0;0;0;.00nan;0;0
29086;69536;873;96;35;2;33;.943;3600000;0
29086;70879;873;0;0;0;0;.00nan;0;0
29087;163471;881;90;33;1;32;.970;3600000;0
29087;184398;887;62;38;4;34;.895;3600000;0
29087;78348;881;0;0;0;0;.00nan;0;0
29087;147264;887;0;0;0;0;.00nan;0;0
29088;162945;886;67;29;3;26;.897;3900000;0
29088;14266;1415;88;39;3;36;.923;3900000;0
29088;184648;886;0;0;0;0;.00nan;0;0
29088;85787;1415;0;0;0;0;.00nan;0;0
29089;162945;886;27;29;6;23;.793;2009000;0
29089;183775;893;0;0;0;0;.00nan;0;0
29089;184648;886;61;10;0;10;1.000;1591000;0
29089;85670;893;89;42;3;39;.929;3600000;0
29090;184398;887;63;27;2;25;.926;3537000;0
29090;180316;876;100;25;0;25;1.000;3600000;0
29090;65762;876;0;0;0;0;.00nan;0;0
29090;147264;887;0;0;0;0;.00nan;0;0
29091;676;883;0;0;0;0;.00nan;0;0
29091;166751;883;53;33;5;28;.848;3600000;0
29091;14266;1415;83;16;0;16;1.000;3600000;0
29091;85787;1415;0;0;0;0;.00nan;0;0
29092;168712;878;73;23;2;21;.913;3692000;0
29092;176860;878;0;0;0;0;.00nan;0;0
29092;76574;882;0;0;0;0;.00nan;0;0
29092;142911;882;68;29;3;26;.897;3646000;0
29093;8519;877;0;0;0;0;.00nan;0;0
29093;28833;892;81;36;3;33;.917;3600000;0
29093;180731;877;100;27;0;27;1.000;3600000;0
29093;192461;892;0;0;0;0;.00nan;0;0
29094;69536;873;68;37;3;34;.919;3600000;0
29094;70879;873;0;0;0;0;.00nan;0;0
29094;78775;874;73;40;4;36;.900;3544000;0
29094;143301;874;0;0;0;0;.00nan;0;0
29095;163471;881;84;19;0;19;1.000;3600000;0
29095;196005;875;87;40;2;38;.950;3600000;0
29095;76885;875;0;0;0;0;.00nan;0;0
29095;78348;881;0;0;0;0;.00nan;0;0
29097;162945;886;97;27;0;27;1.000;3600000;0
29097;184648;886;0;0;0;0;.00nan;0;0
29097;196005;875;28;15;4;11;.733;872000;0
29097;76885;875;63;34;3;31;.912;2728000;0
29099;184398;887;78;31;2;29;.935;3900000;0
29099;176860;878;79;25;2;23;.920;3900000;0
29099;146300;878;0;0;0;0;.00nan;0;0
29099;147264;887;0;0;0;0;.00nan;0;0
29101;166751;883;99;44;1;43;.977;3600000;0
29101;7624;883;0;0;0;0;.00nan;0;0
29101;8519;877;0;0;0;0;.00nan;0;0
29101;180731;877;48;17;2;15;.882;3544000;0
29103;164715;882;0;0;0;0;.00nan;0;0
29103;169868;874;86;36;2;34;.944;3900000;0
29103;63551;874;0;0;0;0;.00nan;0;0
29103;142911;882;79;29;2;27;.931;3900000;0
29105;28831;881;0;0;0;0;.00nan;0;0
29105;192461;892;71;22;1;21;.955;3574000;0
29105;78348;881;97;20;0;20;1.000;3600000;0
29105;146684;892;0;0;0;0;.00nan;0;0
29107;1712;893;0;0;0;0;.00nan;0;0
29107;183775;893;78;41;3;38;.927;3545000;0
29107;28833;873;0;0;0;0;.00nan;0;0
29107;70879;873;83;37;2;35;.946;3600000;0
29109;168712;876;34;29;6;23;.793;3229000;0
29109;196012;1415;95;25;0;25;1.000;3600000;0
29109;180316;876;48;0;0;0;.00nan;371000;0
29109;65762;1415;0;0;0;0;.00nan;0;0
29111;166751;883;0;0;0;0;.00nan;0;0
29111;7624;883;76;23;2;21;.913;3600000;0
29111;168712;876;0;0;0;0;.00nan;0;0
29111;180316;876;86;42;4;38;.905;3561000;0
29113;196012;1415;47;18;3;15;.833;3600000;0
29113;192461;892;0;0;0;0;.00nan;0;0
29113;65762;1415;0;0;0;0;.00nan;0;0
29113;146684;892;57;41;5;36;.878;3600000;0
29115;8519;877;16;22;6;16;.727;3600000;0
29115;164715;882;75;29;2;27;.931;3600000;0
29115;180731;877;0;0;0;0;.00nan;0;0
29115;142911;882;0;0;0;0;.00nan;0;0
29117;162945;886;0;0;0;0;.00nan;0;0
29117;184648;886;89;15;0;15;1.000;3600000;0
29117;176860;878;0;0;0;0;.00nan;0;0
29117;146300;878;88;47;3;44;.936;3600000;0
29119;1712;893;87;28;1;27;.964;3600000;0
29119;183775;893;0;0;0;0;.00nan;0;0
29119;196005;875;56;20;2;18;.900;3543000;0
29119;76885;875;0;0;0;0;.00nan;0;0
29121;184398;887;0;0;0;0;.00nan;0;0
29121;28833;873;45;26;4;22;.846;3552000;0
29121;70879;873;0;0;0;0;.00nan;0;0
29121;147264;887;97;45;2;43;.956;3600000;0
29123;169868;874;0;0;0;0;.00nan;0;0
29123;28831;881;0;0;0;0;.00nan;0;0
29123;63551;874;72;25;2;23;.920;3600000;0
29123;78348;881;46;23;4;19;.826;3590000;0
29125;28831;881;0;0;0;0;.00nan;0;0
29125;196005;875;75;34;3;31;.912;3562000;0
29125;76885;875;0;0;0;0;.00nan;0;0
29125;78348;881;82;33;2;31;.939;3600000;0
29127;169868;874;0;0;0;0;.00nan;0;0
29127;176860;878;75;35;4;31;.886;3592000;0
29127;63551;874;71;29;3;26;.897;3600000;0
29127;146300;878;0;0;0;0;.00nan;0;0
29129;168712;876;83;30;1;29;.967;3600000;0
29129;196012;1415;0;0;0;0;.00nan;0;0
29129;180316;876;0;0;0;0;.00nan;0;0
29129;65762;1415;84;28;2;26;.929;3578000;0
29131;1712;893;0;0;0;0;.00nan;0;0
29131;8519;877;0;0;0;0;.00nan;0;0
29131;183775;893;81;25;1;24;.960;3600000;0
29131;180731;877;51;26;4;22;.846;3600000;0
29133;28833;873;0;0;0;0;.00nan;0;0
29133;192461;892;61;28;3;25;.893;3600000;0
29133;70879;873;62;32;4;28;.875;3543000;0
29133;146684;892;0;0;0;0;.00nan;0;0
29135;166751;883;60;32;4;28;.875;3538000;0
29135;7624;883;0;0;0;0;.00nan;0;0
29135;184398;887;71;33;3;30;.909;3600000;0
29135;147264;887;0;0;0;0;.00nan;0;0
29137;162945;886;0;0;0;0;.00nan;0;0
29137;164715;882;0;0;0;0;.00nan;0;0
29137;184648;886;81;22;1;21;.955;3600000;0
29137;142911;882;75;35;3;32;.914;3557000;0
29139;168712;876;0;0;0;0;.00nan;0;0
29139;28831;881;47;28;5;23;.821;3600000;0
29139;180316;876;92;40;2;38;.950;3600000;0
29139;78348;881;0;0;0;0;.00nan;0;0
29141;162945;886;61;16;1;15;.938;3600000;0
29141;184398;887;0;0;0;0;.00nan;0;0
29141;184648;886;0;0;0;0;.00nan;0;0
29141;147264;887;100;40;0;40;1.000;3600000;0
29143;166751;883;0;0;0;0;.00nan;0;0
29143;7624;883;100;30;0;30;1.000;3600000;0
29143;28833;873;80;30;1;29;.967;3553000;0
29143;70879;873;0;0;0;0;.00nan;0;0
29145;169868;874;95;43;3;40;.930;3600000;0
29145;192461;892;0;0;0;0;.00nan;0;0
29145;63551;874;0;0;0;0;.00nan;0;0
29145;146684;892;40;25;4;21;.840;3544000;0
29147;164715;882;35;28;6;22;.786;3311000;0
29147;196012;1415;53;23;4;19;.826;3600000;0
29147;65762;1415;0;0;0;0;.00nan;0;0
29147;142911;882;50;1;0;1;1.000;234000;0
29149;1712;893;49;32;5;27;.844;3600000;0
29149;183775;893;0;0;0;0;.00nan;0;0
29149;196005;875;0;0;0;0;.00nan;0;0
29149;76885;875;71;21;1;20;.952;3600000;0
29151;8519;877;41;16;3;13;.813;3600000;0
29151;176860;878;0;0;0;0;.00nan;0;0
29151;180731;877;0;0;0;0;.00nan;0;0
29151;146300;878;100;40;1;39;.975;3600000;0
29153;164715;882;0;0;0;0;.00nan;0;0
29153;28833;873;0;0;0;0;.00nan;0;0
29153;70879;873;40;27;4;23;.852;3600000;0
29153;142911;882;67;27;3;24;.889;3600000;0
29155;8519;877;0;0;0;0;.00nan;0;0
29155;168712;876;75;44;4;40;.909;3560000;0
29155;180316;876;0;0;0;0;.00nan;0;0
29155;180731;877;94;32;2;30;.938;3600000;0
29157;1712;893;0;0;0;0;.00nan;0;0
29157;183775;893;91;48;3;45;.938;3600000;0
29157;196005;875;24;25;6;19;.760;3600000;0
29157;76885;875;0;0;0;0;.00nan;0;0
29159;184398;887;0;0;0;0;.00nan;0;0
29159;196012;1415;0;0;0;0;.00nan;0;0
29159;65762;1415;47;26;3;23;.885;3533000;0
29159;147264;887;93;36;1;35;.972;3600000;0
29161;162945;886;0;0;0;0;.00nan;0;0
29161;184648;886;80;30;2;28;.933;3600000;0
29161;28831;881;0;0;0;0;.00nan;0;0
29161;78348;881;75;38;3;35;.921;3557000;0
29163;166751;883;0;0;0;0;.00nan;0;0
29163;7624;883;63;29;3;26;.897;3600000;0
29163;169868;874;0;0;0;0;.00nan;0;0
29163;63551;874;41;39;6;33;.846;3600000;0
29165;176860;878;24;26;6;20;.769;2232000;0
29165;192461;892;97;34;1;33;.971;3600000;0
29165;146300;878;35;12;3;9;.750;1368000;0
29165;146684;892;0;0;0;0;.00nan;0;0
29167;166751;883;85;22;1;21;.955;3600000;0
29167;7624;883;0;0;0;0;.00nan;0;0
29167;28833;873;50;23;3;20;.870;3577000;0
29167;70879;873;0;0;0;0;.00nan;0;0
29169;162945;886;100;31;0;31;1.000;3600000;0
29169;184648;886;0;0;0;0;.00nan;0;0
29169;28831;881;31;29;6;23;.793;3600000;0
29169;78348;881;0;0;0;0;.00nan;0;0
29171;8519;877;91;21;0;21;1.000;3600000;0
29171;196005;875;0;0;0;0;.00nan;0;0
29171;180731;877;0;0;0;0;.00nan;0;0
29171;76885;875;94;29;1;28;.966;3563000;0
29173;169868;874;68;30;2;28;.933;3562000;0
29173;184398;887;89;19;0;19;1.000;3600000;0
29173;63551;874;0;0;0;0;.00nan;0;0
29173;147264;887;0;0;0;0;.00nan;0;0
29175;176860;878;19;26;7;19;.731;3049000;0
29175;192461;892;0;0;0;0;.00nan;0;0
29175;146300;878;60;7;0;7;1.000;551000;0
29175;146684;892;48;21;3;18;.857;3600000;0
29177;1712;893;55;36;5;31;.861;3600000;0
29177;183775;893;0;0;0;0;.00nan;0;0
29177;168712;876;0;0;0;0;.00nan;0;0
29177;180316;876;76;22;2;20;.909;3600000;0
29179;164715;882;89;32;2;30;.938;3600000;0
29179;196012;1415;59;31;5;26;.839;3600000;0
29179;65762;1415;0;0;0;0;.00nan;0;0
29179;142911;882;0;0;0;0;.00nan;0;0
29181;28833;873;0;0;0;0;.00nan;0;0
29181;196005;875;71;32;2;30;.938;3600000;0
29181;70879;873;51;43;6;37;.860;3600000;0
29181;76885;875;0;0;0;0;.00nan;0;0
29183;168712;876;81;31;2;29;.935;3600000;0
29183;196012;1415;69;37;3;34;.919;3573000;0
29183;180316;876;0;0;0;0;.00nan;0;0
29183;65762;1415;0;0;0;0;.00nan;0;0
29185;166751;883;41;39;6;33;.846;3600000;0
29185;7624;883;0;0;0;0;.00nan;0;0
29185;28831;881;0;0;0;0;.00nan;0;0
29185;78348;881;74;19;1;18;.947;3600000;0
29187;1712;893;0;0;0;0;.00nan;0;0
29187;183775;893;88;27;1;26;.963;3900000;0
29187;169868;874;0;0;0;0;.00nan;0;0
29187;63551;874;78;30;1;29;.967;3900000;0
29189;8519;877;69;21;1;20;.952;3600000;0
29189;176860;878;24;16;5;11;.688;994000;0
29189;180731;877;0;0;0;0;.00nan;0;0
29189;146300;878;63;40;4;36;.900;2606000;0
29191;164715;882;0;0;0;0;.00nan;0;0
29191;184398;887;68;30;2;28;.933;3677000;0
29191;142911;882;95;31;1;30;.968;3651000;0
29191;147264;887;0;0;0;0;.00nan;0;0
29193;162945;886;66;24;2;22;.917;3600000;0
29193;184648;886;0;0;0;0;.00nan;0;0
29193;192461;892;74;50;5;45;.900;3600000;0
29193;146684;892;0;0;0;0;.00nan;0;0
1388;28833;892;71;33;3;30;.909;3934000;0
1388;192461;892;0;0;0;0;.00nan;0;0
1388;69536;873;68;31;4;27;.871;3934000;0
1388;70879;873;0;0;0;0;.00nan;0;0
1389;183775;893;0;0;0;0;.00nan;0;0
1389;180316;876;83;35;3;32;.914;4151000;0
1389;65762;876;0;0;0;0;.00nan;0;0
1389;85670;893;68;35;4;31;.886;4151000;0
1390;28833;892;37;28;5;23;.821;3600000;0
1390;192461;892;0;0;0;0;.00nan;0;0
1390;69536;873;95;35;2;33;.943;3600000;0
1390;70879;873;0;0;0;0;.00nan;0;0
1391;183775;893;0;0;0;0;.00nan;0;0
1391;180316;876;85;25;1;24;.960;3600000;0
1391;65762;876;0;0;0;0;.00nan;0;0
1391;85670;893;75;29;2;27;.931;3600000;0
1483;28833;892;59;37;5;32;.865;3600000;0
1483;192461;892;0;0;0;0;.00nan;0;0
1483;69536;873;90;37;2;35;.946;3600000;0
1483;70879;873;0;0;0;0;.00nan;0;0
1534;162945;886;53;36;5;31;.861;3600000;0
1534;184648;886;0;0;0;0;.00nan;0;0
1534;69536;873;88;29;1;28;.966;3600000;0
1534;70879;873;0;0;0;0;.00nan;0;0
1535;163471;881;96;24;0;24;1.000;3600000;0
1535;180316;876;77;24;1;23;.958;3584000;0
1535;65762;876;0;0;0;0;.00nan;0;0
1535;78348;881;0;0;0;0;.00nan;0;0
1536;676;883;98;36;1;35;.972;3600000;0
1536;166751;883;0;0;0;0;.00nan;0;0
1536;8519;877;0;0;0;0;.00nan;0;0
1536;180731;877;58;33;4;29;.879;3600000;0
1537;14266;1415;65;32;3;29;.906;3600000;0
1537;184398;887;72;28;2;26;.929;3600000;0
1537;85787;1415;0;0;0;0;.00nan;0;0
1537;147264;887;0;0;0;0;.00nan;0;0
1538;162945;886;100;34;0;34;1.000;3600000;0
1538;184648;886;0;0;0;0;.00nan;0;0
1538;69536;873;87;38;4;34;.895;3600000;0
1538;70879;873;0;0;0;0;.00nan;0;0
1539;163471;881;58;21;2;19;.905;3600000;0
1539;180316;876;22;5;3;2;.400;509000;0
1539;65762;876;91;27;0;27;1.000;3091000;0
1539;78348;881;0;0;0;0;.00nan;0;0
1540;676;883;85;36;2;34;.944;3553000;0
1540;166751;883;0;0;0;0;.00nan;0;0
1540;8519;877;0;0;0;0;.00nan;0;0
1540;180731;877;100;27;0;27;1.000;3600000;0
1541;14266;1415;66;24;3;21;.875;3600000;0
1541;184398;887;48;33;5;28;.848;3540000;0
1541;85787;1415;0;0;0;0;.00nan;0;0
1541;147264;887;0;0;0;0;.00nan;0;0
1542;162945;886;58;26;3;23;.885;3600000;0
1542;184648;886;0;0;0;0;.00nan;0;0
1542;69536;873;100;32;0;32;1.000;3600000;0
1542;70879;873;0;0;0;0;.00nan;0;0
1543;163471;881;56;27;4;23;.852;3584000;0
1543;180316;876;99;38;2;36;.947;3600000;0
1543;65762;876;0;0;0;0;.00nan;0;0
1543;78348;881;0;0;0;0;.00nan;0;0
1544;676;883;84;36;2;34;.944;3600000;0
1544;166751;883;0;0;0;0;.00nan;0;0
1544;8519;877;57;9;1;8;.889;1260000;0
1544;180731;877;41;29;5;24;.828;2340000;0
1545;14266;1415;100;22;0;22;1.000;3645000;0
1545;184398;887;79;22;1;21;.955;3645000;0
1545;85787;1415;0;0;0;0;.00nan;0;0
1545;147264;887;0;0;0;0;.00nan;0;0
1546;162945;886;80;28;1;27;.964;3600000;0
1546;184648;886;0;0;0;0;.00nan;0;0
1546;69536;873;76;41;4;37;.902;3600000;0
1546;70879;873;0;0;0;0;.00nan;0;0
1547;163471;881;69;26;1;25;.962;4185000;0
1547;180316;876;72;33;2;31;.939;4185000;0
1547;65762;876;0;0;0;0;.00nan;0;0
1547;78348;881;0;0;0;0;.00nan;0;0
1548;676;883;18;11;4;7;.636;1015000;0
1548;166751;883;70;25;1;24;.960;2546000;0
1548;8519;877;0;0;0;0;.00nan;0;0
1548;180731;877;73;28;3;25;.893;3600000;0
1549;14266;1415;68;22;2;20;.909;3600000;0
1549;184398;887;78;42;4;38;.905;3575000;0
1549;85787;1415;0;0;0;0;.00nan;0;0
1549;147264;887;0;0;0;0;.00nan;0;0
1825;162945;886;89;27;1;26;.963;4755000;0
1825;184648;886;0;0;0;0;.00nan;0;0
1825;69536;873;100;37;0;37;1.000;4755000;0
1825;70879;873;0;0;0;0;.00nan;0;0
1826;163471;881;100;26;0;26;1.000;3600000;0
1826;180316;876;81;36;3;33;.917;3600000;0
1826;65762;876;0;0;0;0;.00nan;0;0
1826;78348;881;0;0;0;0;.00nan;0;0
1827;676;883;79;22;1;21;.955;3600000;0
1827;166751;883;0;0;0;0;.00nan;0;0
1827;8519;877;0;0;0;0;.00nan;0;0
1827;180731;877;65;32;4;28;.875;3600000;0
1828;14266;1415;100;25;0;25;1.000;3600000;0
1828;184398;887;64;21;2;19;.905;3583000;0
1828;85787;1415;0;0;0;0;.00nan;0;0
1828;147264;887;0;0;0;0;.00nan;0;0
1861;162945;886;59;23;2;21;.913;3600000;0
1861;184648;886;0;0;0;0;.00nan;0;0
1861;69536;873;83;36;3;33;.917;3566000;0
1861;70879;873;0;0;0;0;.00nan;0;0
1862;676;883;78;28;2;26;.929;3600000;0
1862;166751;883;0;0;0;0;.00nan;0;0
1862;8519;877;0;0;0;0;.00nan;0;0
1862;180731;877;76;33;3;30;.909;3600000;0
1882;162945;886;75;33;2;31;.939;3600000;0
1882;184648;886;0;0;0;0;.00nan;0;0
1882;69536;873;56;27;4;23;.852;3535000;0
1882;70879;873;0;0;0;0;.00nan;0;0
1896;676;883;59;28;3;25;.893;3600000;0
1896;166751;883;0;0;0;0;.00nan;0;0
1896;162945;886;67;22;2;20;.909;3600000;0
1896;184648;886;0;0;0;0;.00nan;0;0
1897;163471;881;79;25;1;24;.960;3600000;0
1897;14266;1415;81;35;3;32;.914;3556000;0
1897;78348;881;0;0;0;0;.00nan;0;0
1897;85787;1415;0;0;0;0;.00nan;0;0
1898;676;883;75;28;2;26;.929;3600000;0
1898;166751;883;0;0;0;0;.00nan;0;0
1898;162945;886;53;26;3;23;.885;3600000;0
1898;184648;886;0;0;0;0;.00nan;0;0
1899;163471;881;45;17;3;14;.824;3600000;0
1899;14266;1415;64;41;5;36;.878;3600000;0
1899;78348;881;0;0;0;0;.00nan;0;0
1899;85787;1415;0;0;0;0;.00nan;0;0
1900;676;883;52;28;4;24;.857;3727000;0
1900;166751;883;0;0;0;0;.00nan;0;0
1900;162945;886;74;47;5;42;.894;3727000;0
1900;184648;886;0;0;0;0;.00nan;0;0
1901;163471;881;74;28;2;26;.929;3561000;0
1901;14266;1415;87;24;1;23;.958;3600000;0
1901;78348;881;0;0;0;0;.00nan;0;0
1901;85787;1415;0;0;0;0;.00nan;0;0
1902;676;883;73;32;2;30;.938;3577000;0
1902;166751;883;0;0;0;0;.00nan;0;0
1902;162945;886;75;20;1;19;.950;3600000;0
1902;184648;886;0;0;0;0;.00nan;0;0
1903;163471;881;73;23;2;21;.913;3600000;0
1903;14266;1415;78;45;4;41;.911;3530000;0
1903;78348;881;0;0;0;0;.00nan;0;0
1903;85787;1415;0;0;0;0;.00nan;0;0
2124;676;883;92;37;1;36;.973;4341000;0
2124;166751;883;0;0;0;0;.00nan;0;0
2124;162945;886;100;48;0;48;1.000;4341000;0
2124;184648;886;0;0;0;0;.00nan;0;0
2125;163471;881;55;31;4;27;.871;3600000;0
2125;14266;1415;100;37;1;36;.973;3600000;0
2125;78348;881;0;0;0;0;.00nan;0;0
2125;85787;1415;0;0;0;0;.00nan;0;0
2149;676;883;94;53;3;50;.943;5445000;0
2149;166751;883;0;0;0;0;.00nan;0;0
2149;162945;886;64;42;4;38;.905;5445000;0
2149;184648;886;0;0;0;0;.00nan;0;0
2150;163471;881;36;16;4;12;.750;1037000;0
2150;14266;1415;68;36;4;32;.889;3600000;0
2150;78348;881;45;18;3;15;.833;2563000;0
2150;85787;1415;0;0;0;0;.00nan;0;0
2183;676;883;73;34;4;30;.882;3527000;0
2183;166751;883;0;0;0;0;.00nan;0;0
2183;162945;886;83;39;2;37;.949;3600000;0
2183;184648;886;0;0;0;0;.00nan;0;0
2184;163471;881;91;38;2;36;.947;3546000;0
2184;14266;1415;91;29;1;28;.966;3600000;0
2184;78348;881;0;0;0;0;.00nan;0;0
2184;85787;1415;0;0;0;0;.00nan;0;0
2271;162945;886;52;35;5;30;.857;3600000;0
2271;14266;1415;91;31;2;29;.935;3600000;0
2271;184648;886;0;0;0;0;.00nan;0;0
2271;85787;1415;0;0;0;0;.00nan;0;0
2272;162945;886;82;32;2;30;.938;3820000;0
2272;14266;1415;85;31;1;30;.968;3820000;0
2272;184648;886;0;0;0;0;.00nan;0;0
2272;85787;1415;0;0;0;0;.00nan;0;0
2273;162945;886;46;24;4;20;.833;3600000;0
2273;14266;1415;51;29;5;24;.828;3572000;0
2273;184648;886;0;0;0;0;.00nan;0;0
2273;85787;1415;0;0;0;0;.00nan;0;0
2274;162945;886;91;43;3;40;.930;3600000;0
2274;14266;1415;100;26;0;26;1.000;3600000;0
2274;184648;886;0;0;0;0;.00nan;0;0
2274;85787;1415;0;0;0;0;.00nan;0;0
2445;162945;886;77;42;3;39;.929;3600000;0
2445;14266;1415;100;25;0;25;1.000;3600000;0
2445;184648;886;0;0;0;0;.00nan;0;0
2445;85787;1415;0;0;0;0;.00nan;0;0
29194;68425;519;0;0;0;0;.00nan;0;0
29194;143083;513;0;0;0;0;.00nan;0;0
29194;143307;519;52;25;4;21;.840;3532000;0
29194;143421;513;78;28;2;26;.929;3600000;0
29195;4618;520;0;0;0;0;.00nan;0;0
29195;177519;512;0;0;0;0;.00nan;0;0
29195;143191;512;81;13;0;13;1.000;3600000;0
29195;152478;520;93;43;3;40;.930;3600000;0
29196;62279;1472;97;39;1;38;.974;3600000;0
29196;84287;516;86;16;0;16;1.000;3600000;0
29196;143100;516;0;0;0;0;.00nan;0;0
29196;159851;1472;0;0;0;0;.00nan;0;0
29197;8426;2193;66;33;3;30;.909;3600000;0
29197;14047;511;55;28;4;24;.857;3599000;0
29197;64800;511;0;0;0;0;.00nan;0;0
29197;76951;2193;0;0;0;0;.00nan;0;0
29198;179830;1876;0;0;0;0;.00nan;0;0
29198;141978;1876;67;40;5;35;.875;3552000;0
29198;143156;515;54;25;3;22;.880;3600000;0
29198;143507;515;0;0;0;0;.00nan;0;0
29199;62287;517;0;0;0;0;.00nan;0;0
29199;63107;514;0;0;0;0;.00nan;0;0
29199;143330;514;58;9;1;8;.889;3600000;0
29199;152202;517;92;53;3;50;.943;3577000;0
29200;13613;518;52;20;3;17;.850;3576000;0
29200;174581;518;0;0;0;0;.00nan;0;0
29200;142929;1872;81;32;2;30;.938;3600000;0
29200;151590;1872;0;0;0;0;.00nan;0;0
29201;62287;517;76;41;3;38;.927;3566000;0
29201;84287;516;84;28;2;26;.929;3600000;0
29201;143100;516;0;0;0;0;.00nan;0;0
29201;152202;517;0;0;0;0;.00nan;0;0
29202;13613;518;100;31;0;31;1.000;3600000;0
29202;174581;518;0;0;0;0;.00nan;0;0
29202;143083;513;0;0;0;0;.00nan;0;0
29202;143421;513;75;40;3;37;.925;3600000;0
29203;14047;511;74;38;4;34;.895;3900000;0
29203;62279;1472;64;34;4;30;.882;3900000;0
29203;64800;511;0;0;0;0;.00nan;0;0
29203;159851;1472;0;0;0;0;.00nan;0;0
29204;8426;2193;0;0;0;0;.00nan;0;0
29204;76951;2193;81;31;2;29;.935;3600000;0
29204;143156;515;31;25;6;19;.760;3600000;0
29204;143507;515;0;0;0;0;.00nan;0;0
29205;4618;520;0;0;0;0;.00nan;0;0
29205;142929;1872;57;23;3;20;.870;3859000;0
29205;151590;1872;0;0;0;0;.00nan;0;0
29205;152478;520;72;29;2;27;.931;3859000;0
29206;177519;512;0;0;0;0;.00nan;0;0
29206;68425;519;0;0;0;0;.00nan;0;0
29206;143191;512;52;19;3;16;.842;3560000;0
29206;143307;519;87;41;2;39;.951;3600000;0
29207;179830;1876;0;0;0;0;.00nan;0;0
29207;63107;514;0;0;0;0;.00nan;0;0
29207;141978;1876;50;31;5;26;.839;3600000;0
29207;143330;514;87;27;1;26;.963;3600000;0
29208;14047;511;91;38;2;36;.947;3600000;0
29208;63107;514;0;0;0;0;.00nan;0;0
29208;64800;511;0;0;0;0;.00nan;0;0
29208;143330;514;56;25;3;22;.880;3572000;0
29209;8426;2193;0;0;0;0;.00nan;0;0
29209;76951;2193;93;21;0;21;1.000;3600000;0
29209;143083;513;68;32;3;29;.906;3600000;0
29209;143421;513;0;0;0;0;.00nan;0;0
29210;177519;512;0;0;0;0;.00nan;0;0
29210;179830;1876;47;46;7;39;.848;3600000;0
29210;-1;1876;0;0;0;0;.00nan;0;0
29210;143191;512;80;13;0;13;1.000;3600000;0
29211;4618;520;0;0;0;0;.00nan;0;0
29211;68425;519;60;28;3;25;.893;3572000;0
29211;143307;519;0;0;0;0;.00nan;0;0
29211;152478;520;80;25;1;24;.960;3600000;0
29212;13613;518;62;27;3;24;.889;3600000;0
29212;174581;518;0;0;0;0;.00nan;0;0
29212;84287;516;0;0;0;0;.00nan;0;0
29212;143100;516;69;19;1;18;.947;3600000;0
29213;62287;517;59;22;2;20;.909;3552000;0
29213;143156;515;0;0;0;0;.00nan;0;0
29213;143507;515;88;30;1;29;.967;3600000;0
29213;152202;517;0;0;0;0;.00nan;0;0
29214;62279;1472;56;22;3;19;.864;3694000;0
29214;142929;1872;60;39;4;35;.897;3701000;0
29214;151590;1872;0;0;0;0;.00nan;0;0
29214;159851;1472;0;0;0;0;.00nan;0;0
29215;62287;517;0;0;0;0;.00nan;0;0
29215;68425;519;0;0;0;0;.00nan;0;0
29215;143307;519;79;30;2;28;.933;3600000;0
29215;152202;517;77;41;3;38;.927;3600000;0
29216;13613;518;65;17;2;15;.882;3600000;0
29216;174581;518;0;0;0;0;.00nan;0;0
29216;143156;515;71;39;4;35;.897;3551000;0
29216;143507;515;0;0;0;0;.00nan;0;0
29217;62279;1472;30;33;6;27;.818;2618000;0
29217;63107;514;0;0;0;0;.00nan;0;0
29217;143330;514;42;16;3;13;.813;3600000;0
29217;159851;1472;62;10;0;10;1.000;982000;0
29218;177519;512;0;0;0;0;.00nan;0;0
29218;8426;2193;19;21;6;15;.714;2903000;0
29218;76951;2193;43;3;1;2;.667;697000;0
29218;143191;512;74;39;4;35;.897;3600000;0
29219;4618;520;63;29;3;26;.897;3849000;0
29219;143083;513;0;0;0;0;.00nan;0;0
29219;143421;513;74;26;2;24;.923;3849000;0
29219;152478;520;0;0;0;0;.00nan;0;0
29220;14047;511;91;49;4;45;.918;3570000;0
29220;63848;511;0;0;0;0;.00nan;0;0
29220;84287;516;54;16;2;14;.875;3600000;0
29220;143100;516;0;0;0;0;.00nan;0;0
29221;179830;1876;80;36;2;34;.944;3600000;0
29221;-1;1876;0;0;0;0;.00nan;0;0
29221;142929;1872;68;30;3;27;.900;3577000;0
29221;151590;1872;0;0;0;0;.00nan;0;0
29222;62287;517;0;0;0;0;.00nan;0;0
29222;143083;513;0;0;0;0;.00nan;0;0
29222;143421;513;57;25;3;22;.880;3900000;0
29222;152202;517;68;34;4;30;.882;3900000;0
29223;177519;512;0;0;0;0;.00nan;0;0
29223;62279;1472;71;34;3;31;.912;3600000;0
29223;143191;512;45;22;4;18;.818;3574000;0
29223;159851;1472;0;0;0;0;.00nan;0;0
29224;4618;520;0;0;0;0;.00nan;0;0
29224;13613;518;80;35;2;33;.943;3900000;0
29224;86394;518;0;0;0;0;.00nan;0;0
29224;152478;520;67;24;2;22;.917;3900000;0
29225;8426;2193;86;32;2;30;.938;3546000;0
29225;68425;519;100;46;1;45;.978;3600000;0
29225;76951;2193;0;0;0;0;.00nan;0;0
29225;143307;519;0;0;0;0;.00nan;0;0
29226;179830;1876;0;0;0;0;.00nan;0;0
29226;84287;516;87;17;0;17;1.000;3600000;0
29226;141978;1876;61;43;6;37;.860;3600000;0
29226;143100;516;0;0;0;0;.00nan;0;0
29227;63107;514;0;0;0;0;.00nan;0;0
29227;143156;515;42;34;6;28;.824;3540000;0
29227;143330;514;70;36;4;32;.889;3600000;0
29227;143507;515;0;0;0;0;.00nan;0;0
29228;14047;511;32;30;6;24;.800;3600000;0
29228;64800;511;0;0;0;0;.00nan;0;0
29228;91202;1872;91;32;1;31;.969;3600000;0
29228;142929;1872;0;0;0;0;.00nan;0;0
29229;62287;517;0;0;0;0;.00nan;0;0
29229;91202;1872;82;39;2;37;.949;3600000;0
29229;142929;1872;0;0;0;0;.00nan;0;0
29229;152202;517;58;32;3;29;.906;3599000;0
29230;177519;512;0;0;0;0;.00nan;0;0
29230;13613;518;0;0;0;0;.00nan;0;0
29230;86394;518;68;31;3;28;.903;3565000;0
29230;143191;512;79;25;1;24;.960;3600000;0
29231;62279;1472;71;33;3;30;.909;3600000;0
29231;143083;513;0;0;0;0;.00nan;0;0
29231;143421;513;76;29;2;27;.931;3600000;0
29231;159851;1472;0;0;0;0;.00nan;0;0
29232;4618;520;0;0;0;0;.00nan;0;0
29232;8426;2193;68;33;3;30;.909;3553000;0
29232;76951;2193;0;0;0;0;.00nan;0;0
29232;152478;520;84;26;2;24;.923;3600000;0
29233;14047;511;92;34;1;33;.971;3600000;0
29233;64800;511;0;0;0;0;.00nan;0;0
29233;143156;515;73;30;2;28;.933;3582000;0
29233;143507;515;0;0;0;0;.00nan;0;0
29234;63107;514;0;0;0;0;.00nan;0;0
29234;84287;516;88;32;1;31;.969;3600000;0
29234;143100;516;0;0;0;0;.00nan;0;0
29234;143330;514;66;23;2;21;.913;3600000;0
29235;179830;1876;0;0;0;0;.00nan;0;0
29235;68425;519;0;0;0;0;.00nan;0;0
29235;141978;1876;64;38;4;34;.895;3597000;0
29235;143307;519;56;27;3;24;.889;3600000;0
29236;177519;512;0;0;0;0;.00nan;0;0
29236;14047;511;87;52;4;48;.923;3560000;0
29236;64800;511;0;0;0;0;.00nan;0;0
29236;143191;512;86;31;2;29;.935;3600000;0
29237;8426;2193;0;0;0;0;.00nan;0;0
29237;179830;1876;0;0;0;0;.00nan;0;0
29237;76951;2193;89;14;0;14;1.000;3600000;0
29237;141978;1876;45;23;4;19;.826;3600000;0
29238;4618;520;69;19;1;18;.947;3600000;0
29238;62287;517;70;31;3;28;.903;3535000;0
29238;152202;517;0;0;0;0;.00nan;0;0
29238;152478;520;0;0;0;0;.00nan;0;0
29239;13613;518;0;0;0;0;.00nan;0;0
29239;68425;519;0;0;0;0;.00nan;0;0
29239;86394;518;61;29;3;26;.897;3531000;0
29239;143307;519;79;28;1;27;.964;3600000;0
29240;62279;1472;75;34;3;31;.912;3539000;0
29240;143156;515;91;37;2;35;.946;3600000;0
29240;143507;515;0;0;0;0;.00nan;0;0
29240;159851;1472;0;0;0;0;.00nan;0;0
29241;63107;514;59;32;3;29;.906;3600000;0
29241;143083;513;0;0;0;0;.00nan;0;0
29241;143330;514;0;0;0;0;.00nan;0;0
29241;143421;513;68;42;4;38;.905;3600000;0
29242;84287;516;82;16;0;16;1.000;3600000;0
29242;91202;1872;97;41;1;40;.976;3600000;0
29242;142929;1872;0;0;0;0;.00nan;0;0
29242;143100;516;0;0;0;0;.00nan;0;0
29243;177519;512;0;0;0;0;.00nan;0;0
29243;62287;517;77;48;4;44;.917;3551000;0
29243;143191;512;89;29;2;27;.931;3600000;0
29243;152202;517;0;0;0;0;.00nan;0;0
29244;8426;2193;0;0;0;0;.00nan;0;0
29244;13613;518;0;0;0;0;.00nan;0;0
29244;76951;2193;86;33;2;31;.939;3900000;0
29244;86394;518;66;25;2;23;.920;3900000;0
29245;62279;1472;0;0;0;0;.00nan;0;0
29245;68425;519;0;0;0;0;.00nan;0;0
29245;143307;519;100;56;4;52;.929;3600000;0
29245;159851;1472;23;22;5;17;.773;3600000;0
29246;84287;516;81;33;3;30;.909;3900000;0
29246;143100;516;0;0;0;0;.00nan;0;0
29246;143156;515;58;26;3;23;.885;3900000;0
29246;143507;515;0;0;0;0;.00nan;0;0
29247;14047;511;62;28;3;25;.893;3544000;0
29247;64800;511;0;0;0;0;.00nan;0;0
29247;143083;513;0;0;0;0;.00nan;0;0
29247;143421;513;75;31;2;29;.935;3600000;0
29248;63107;514;0;0;0;0;.00nan;0;0
29248;91202;1872;83;34;1;33;.971;3546000;0
29248;142929;1872;0;0;0;0;.00nan;0;0
29248;143330;514;100;35;0;35;1.000;3600000;0
29249;4618;520;0;0;0;0;.00nan;0;0
29249;179830;1876;82;25;1;24;.960;3600000;0
29249;141978;1876;0;0;0;0;.00nan;0;0
29249;152478;520;55;38;5;33;.868;3600000;0
29250;84287;516;70;29;3;26;.897;3571000;0
29250;143083;513;96;32;1;31;.969;3600000;0
29250;143100;516;0;0;0;0;.00nan;0;0
29250;143421;513;0;0;0;0;.00nan;0;0
29251;177519;512;0;0;0;0;.00nan;0;0
29251;63107;514;0;0;0;0;.00nan;0;0
29251;143191;512;88;38;2;36;.947;3600000;0
29251;143330;514;77;20;1;19;.950;3600000;0
29252;8426;2193;46;29;4;25;.862;3555000;0
29252;62287;517;0;0;0;0;.00nan;0;0
29252;76951;2193;0;0;0;0;.00nan;0;0
29252;152202;517;64;29;3;26;.897;3600000;0
29253;4618;520;0;0;0;0;.00nan;0;0
29253;62279;1472;63;31;3;28;.903;3894000;0
29253;152478;520;78;40;3;37;.925;3900000;0
29253;159851;1472;0;0;0;0;.00nan;0;0
29254;14047;511;62;21;1;20;.952;3600000;0
29254;64800;511;0;0;0;0;.00nan;0;0
29254;68425;519;64;32;3;29;.906;3542000;0
29254;143307;519;0;0;0;0;.00nan;0;0
29255;91202;1872;81;40;3;37;.925;3881000;0
29255;142929;1872;0;0;0;0;.00nan;0;0
29255;143156;515;50;25;3;22;.880;3900000;0
29255;143507;515;0;0;0;0;.00nan;0;0
29256;13613;518;42;3;1;2;.667;566000;0
29256;179830;1876;0;0;0;0;.00nan;0;0
29256;86394;518;35;36;7;29;.806;3034000;0
29256;141978;1876;82;26;1;25;.962;3600000;0
29257;13613;518;0;0;0;0;.00nan;0;0
29257;62287;517;15;21;6;15;.714;2855000;0
29257;86394;518;94;32;1;31;.969;3600000;0
29257;152202;517;52;5;0;5;1.000;745000;0
29258;179830;1876;0;0;0;0;.00nan;0;0
29258;62279;1472;53;17;2;15;.882;3900000;0
29258;141978;1876;65;26;2;24;.923;3900000;0
29258;159851;1472;0;0;0;0;.00nan;0;0
29259;8426;2193;100;29;0;29;1.000;3600000;0
29259;63107;514;0;0;0;0;.00nan;0;0
29259;76951;2193;0;0;0;0;.00nan;0;0
29259;143330;514;48;34;5;29;.853;3600000;0
29260;68425;519;0;0;0;0;.00nan;0;0
29260;84287;516;0;0;0;0;.00nan;0;0
29260;143100;516;73;22;1;21;.955;3600000;0
29260;143307;519;71;45;4;41;.911;3600000;0
29261;4618;520;0;0;0;0;.00nan;0;0
29261;14047;511;0;0;0;0;.00nan;0;0
29261;64800;511;86;45;3;42;.933;3600000;0
29261;152478;520;95;18;0;18;1.000;3600000;0
29262;143083;513;0;0;0;0;.00nan;0;0
29262;143156;515;0;0;0;0;.00nan;0;0
29262;143421;513;100;45;0;45;1.000;3900000;0
29262;143507;515;96;32;0;32;1.000;3900000;0
29263;177519;512;0;0;0;0;.00nan;0;0
29263;91202;1872;93;35;1;34;.971;3600000;0
29263;142929;1872;0;0;0;0;.00nan;0;0
29263;143191;512;95;20;0;20;1.000;3600000;0
29264;13613;518;0;0;0;0;.00nan;0;0
29264;14047;511;97;41;0;41;1.000;3900000;0
29264;64800;511;0;0;0;0;.00nan;0;0
29264;86394;518;100;33;0;33;1.000;3900000;0
29265;91202;1872;80;33;3;30;.909;3573000;0
29265;142929;1872;0;0;0;0;.00nan;0;0
29265;143083;513;0;0;0;0;.00nan;0;0
29265;143421;513;66;17;1;16;.941;3600000;0
29266;177519;512;0;0;0;0;.00nan;0;0
29266;84287;516;52;18;2;16;.889;3600000;0
29266;143100;516;0;0;0;0;.00nan;0;0
29266;143191;512;63;29;3;26;.897;3542000;0
29267;8426;2193;58;44;6;38;.864;3600000;0
29267;62279;1472;67;32;3;29;.906;3600000;0
29267;76951;2193;0;0;0;0;.00nan;0;0
29267;159851;1472;0;0;0;0;.00nan;0;0
29268;4618;520;0;0;0;0;.00nan;0;0
29268;143156;515;0;0;0;0;.00nan;0;0
29268;143507;515;100;27;0;27;1.000;3600000;0
29268;152478;520;70;33;3;30;.909;3600000;0
29269;63107;514;0;0;0;0;.00nan;0;0
29269;68425;519;71;39;3;36;.923;3600000;0
29269;143307;519;0;0;0;0;.00nan;0;0
29269;143330;514;98;22;0;22;1.000;3600000;0
29270;179830;1876;0;0;0;0;.00nan;0;0
29270;62287;517;0;0;0;0;.00nan;0;0
29270;141978;1876;83;31;1;30;.968;3600000;0
29270;152202;517;73;28;2;26;.929;3559000;0
29271;62279;1472;56;34;4;30;.882;3832000;0
29271;62287;517;0;0;0;0;.00nan;0;0
29271;152202;517;57;36;5;31;.861;3828000;0
29271;159851;1472;0;0;0;0;.00nan;0;0
29272;177519;512;0;0;0;0;.00nan;0;0
29272;143083;513;0;0;0;0;.00nan;0;0
29272;143191;512;47;13;2;11;.846;3900000;0
29272;143421;513;87;32;2;30;.938;3900000;0
29273;4618;520;0;0;0;0;.00nan;0;0
29273;84287;516;0;0;0;0;.00nan;0;0
29273;143100;516;59;19;2;17;.895;3900000;0
29273;152478;520;100;43;2;41;.953;3900000;0
29274;14047;511;100;31;0;31;1.000;3600000;0
29274;179830;1876;0;0;0;0;.00nan;0;0
29274;64800;511;0;0;0;0;.00nan;0;0
29274;141978;1876;81;27;1;26;.963;3600000;0
29275;68425;519;0;0;0;0;.00nan;0;0
29275;143156;515;59;24;3;21;.875;3544000;0
29275;143307;519;90;37;2;35;.946;3600000;0
29275;143507;515;0;0;0;0;.00nan;0;0
29276;13613;518;0;0;0;0;.00nan;0;0
29276;63107;514;0;0;0;0;.00nan;0;0
29276;86394;518;46;40;7;33;.825;3600000;0
29276;143330;514;64;20;2;18;.900;3600000;0
29277;8426;2193;30;14;4;10;.714;1112000;0
29277;76951;2193;80;25;1;24;.960;2515000;0
29277;91202;1872;0;0;0;0;.00nan;0;0
29277;142929;1872;43;30;6;24;.800;3627000;0
29278;14047;511;39;25;4;21;.840;3600000;0
29278;62287;517;0;0;0;0;.00nan;0;0
29278;64800;511;0;0;0;0;.00nan;0;0
29278;152202;517;89;33;1;32;.970;3600000;0
29279;13613;518;0;0;0;0;.00nan;0;0
29279;62279;1472;100;30;1;29;.967;3600000;0
29279;86394;518;70;36;3;33;.917;3580000;0
29279;159851;1472;0;0;0;0;.00nan;0;0
29280;177519;512;0;0;0;0;.00nan;0;0
29280;143156;515;99;44;1;43;.977;3600000;0
29280;143191;512;56;27;3;24;.889;3528000;0
29280;143507;515;0;0;0;0;.00nan;0;0
29281;8426;2193;0;0;0;0;.00nan;0;0
29281;76951;2193;97;50;4;46;.920;3600000;0
29281;84287;516;68;30;3;27;.900;3600000;0
29281;143100;516;0;0;0;0;.00nan;0;0
29282;68425;519;96;43;2;41;.953;3900000;0
29282;91202;1872;80;28;2;26;.929;3900000;0
29282;142929;1872;0;0;0;0;.00nan;0;0
29282;143307;519;0;0;0;0;.00nan;0;0
29283;4618;520;0;0;0;0;.00nan;0;0
29283;63107;514;0;0;0;0;.00nan;0;0
29283;143330;514;63;23;2;21;.913;3600000;0
29283;152478;520;78;37;3;34;.919;3569000;0
29284;179830;1876;0;0;0;0;.00nan;0;0
29284;141978;1876;78;37;3;34;.919;3600000;0
29284;143083;513;0;0;0;0;.00nan;0;0
29284;143421;513;95;17;0;17;1.000;3600000;0
29285;62287;517;0;0;0;0;.00nan;0;0
29285;63107;514;0;0;0;0;.00nan;0;0
29285;143330;514;34;21;4;17;.810;3576000;0
29285;152202;517;68;32;3;29;.906;3600000;0
29286;13613;518;87;25;1;24;.960;3545000;0
29286;38276;1872;0;0;0;0;.00nan;0;0
29286;86394;518;0;0;0;0;.00nan;0;0
29286;91202;1872;100;21;0;21;1.000;3600000;0
29287;62279;1472;62;40;4;36;.900;3600000;0
29287;84287;516;90;26;1;25;.962;3600000;0
29287;143100;516;0;0;0;0;.00nan;0;0
29287;159851;1472;0;0;0;0;.00nan;0;0
29288;8426;2193;0;0;0;0;.00nan;0;0
29288;14047;511;76;26;2;24;.923;3900000;0
29288;64800;511;0;0;0;0;.00nan;0;0
29288;76951;2193;95;53;2;51;.962;3900000;0
29289;4618;520;0;0;0;0;.00nan;0;0
29289;177519;512;0;0;0;0;.00nan;0;0
29289;143191;512;95;20;0;20;1.000;3600000;0
29289;152478;520;59;32;4;28;.875;3600000;0
29290;68425;519;53;35;5;30;.857;3549000;0
29290;143083;513;0;0;0;0;.00nan;0;0
29290;143307;519;0;0;0;0;.00nan;0;0
29290;143421;513;71;36;4;32;.889;3600000;0
29291;179830;1876;0;0;0;0;.00nan;0;0
29291;141978;1876;17;44;9;35;.795;3600000;0
29291;143156;515;51;16;2;14;.875;3600000;0
29291;143507;515;0;0;0;0;.00nan;0;0
29292;13613;518;0;0;0;0;.00nan;0;0
29292;86394;518;59;36;4;32;.889;3600000;0
29292;143083;513;0;0;0;0;.00nan;0;0
29292;143421;513;95;29;1;28;.966;3600000;0
29293;177519;512;0;0;0;0;.00nan;0;0
29293;68425;519;69;33;4;29;.879;3641000;0
29293;143191;512;30;19;5;14;.737;3641000;0
29293;143307;519;0;0;0;0;.00nan;0;0
29294;62287;517;0;0;0;0;.00nan;0;0
29294;84287;516;0;0;0;0;.00nan;0;0
29294;143100;516;57;23;3;20;.870;3692000;0
29294;152202;517;58;38;4;34;.895;3692000;0
29295;14047;511;0;0;0;0;.00nan;0;0
29295;62279;1472;0;0;0;0;.00nan;0;0
29295;64800;511;95;40;2;38;.950;3900000;0
29295;159851;1472;71;34;2;32;.941;3900000;0
29296;8426;2193;73;40;4;36;.900;3600000;0
29296;76951;2193;0;0;0;0;.00nan;0;0
29296;143156;515;77;19;1;18;.947;3600000;0
29296;143507;515;0;0;0;0;.00nan;0;0
29297;179830;1876;0;0;0;0;.00nan;0;0
29297;63107;514;0;0;0;0;.00nan;0;0
29297;141978;1876;85;35;3;32;.914;3900000;0
29297;143330;514;71;35;3;32;.914;3900000;0
29298;4618;520;0;0;0;0;.00nan;0;0
29298;38276;1872;81;18;0;18;1.000;2458000;0
29298;91202;1872;22;9;4;5;.556;1097000;0
29298;152478;520;65;28;3;25;.893;3600000;0
29299;62287;517;40;31;5;26;.839;3600000;0
29299;143156;515;100;29;0;29;1.000;3600000;0
29299;143507;515;0;0;0;0;.00nan;0;0
29299;152202;517;0;0;0;0;.00nan;0;0
29300;38276;1872;0;0;0;0;.00nan;0;0
29300;62279;1472;0;0;0;0;.00nan;0;0
29300;91202;1872;66;39;4;35;.897;3600000;0
29300;159851;1472;100;38;0;38;1.000;3600000;0
29301;8426;2193;0;0;0;0;.00nan;0;0
29301;76951;2193;77;36;2;34;.944;3761000;0
29301;143083;513;0;0;0;0;.00nan;0;0
29301;143421;513;72;34;3;31;.912;3761000;0
29302;4618;520;0;0;0;0;.00nan;0;0
29302;68425;519;0;0;0;0;.00nan;0;0
29302;143307;519;65;37;4;33;.892;3900000;0
29302;152478;520;67;39;4;35;.897;3900000;0
29303;14047;511;84;33;1;32;.970;3600000;0
29303;63107;514;0;0;0;0;.00nan;0;0
29303;64800;511;0;0;0;0;.00nan;0;0
29303;143330;514;60;28;3;25;.893;3600000;0
29304;177519;512;0;0;0;0;.00nan;0;0
29304;179830;1876;0;0;0;0;.00nan;0;0
29304;141978;1876;97;51;3;48;.941;3600000;0
29304;143191;512;53;18;2;16;.889;3600000;0
29305;13613;518;0;0;0;0;.00nan;0;0
29305;84287;516;65;21;2;19;.905;3570000;0
29305;86394;518;96;38;1;37;.974;3600000;0
29305;143100;516;0;0;0;0;.00nan;0;0
29306;4618;520;54;5;0;5;1.000;325000;0
29306;143083;513;70;33;3;30;.909;3600000;0
29306;143421;513;0;0;0;0;.00nan;0;0
29306;152478;520;28;22;6;16;.727;3275000;0
29307;177519;512;0;0;0;0;.00nan;0;0
29307;8426;2193;0;0;0;0;.00nan;0;0
29307;76951;2193;80;58;6;52;.897;3600000;0
29307;143191;512;75;18;1;17;.944;3600000;0
29308;62287;517;0;0;0;0;.00nan;0;0
29308;68425;519;100;25;0;25;1.000;3600000;0
29308;143307;519;0;0;0;0;.00nan;0;0
29308;152202;517;64;24;2;22;.917;3530000;0
29309;14047;511;85;39;2;37;.949;3566000;0
29309;64800;511;0;0;0;0;.00nan;0;0
29309;84287;516;66;17;1;16;.941;3600000;0
29309;143100;516;0;0;0;0;.00nan;0;0
29310;13613;518;0;0;0;0;.00nan;0;0
29310;86394;518;81;51;4;47;.922;3600000;0
29310;143156;515;90;32;1;31;.969;3600000;0
29310;143507;515;0;0;0;0;.00nan;0;0
29311;62279;1472;0;0;0;0;.00nan;0;0
29311;63107;514;0;0;0;0;.00nan;0;0
29311;143330;514;43;27;4;23;.852;3600000;0
29311;159851;1472;79;35;2;33;.943;3600000;0
29312;179830;1876;0;0;0;0;.00nan;0;0
29312;38276;1872;0;0;0;0;.00nan;0;0
29312;91202;1872;72;37;4;33;.892;3600000;0
29312;141978;1876;39;35;6;29;.829;3570000;0
29313;62287;517;83;30;1;29;.967;3600000;0
29313;143083;513;0;0;0;0;.00nan;0;0
29313;143421;513;82;28;2;26;.929;3559000;0
29313;152202;517;0;0;0;0;.00nan;0;0
29314;4618;520;56;6;0;6;1.000;497000;0
29314;13613;518;0;0;0;0;.00nan;0;0
29314;86394;518;80;39;3;36;.923;3600000;0
29314;152478;520;27;32;6;26;.813;3103000;0
29315;177519;512;0;0;0;0;.00nan;0;0
29315;62279;1472;76;33;3;30;.909;3877000;0
29315;143191;512;68;21;2;19;.905;3877000;0
29315;159851;1472;0;0;0;0;.00nan;0;0
29316;8426;2193;86;38;2;36;.947;3567000;0
29316;68425;519;0;0;0;0;.00nan;0;0
29316;76951;2193;0;0;0;0;.00nan;0;0
29316;143307;519;90;24;0;24;1.000;3600000;0
29317;14047;511;33;10;3;7;.700;528000;0
29317;38276;1872;0;0;0;0;.00nan;0;0
29317;64800;511;44;31;5;26;.839;3072000;0
29317;91202;1872;58;39;4;35;.897;3600000;0
29318;63107;514;63;44;5;39;.886;3600000;0
29318;143156;515;59;20;2;18;.900;3600000;0
29318;143330;514;0;0;0;0;.00nan;0;0
29318;143507;515;0;0;0;0;.00nan;0;0
29319;179830;1876;0;0;0;0;.00nan;0;0
29319;84287;516;90;18;0;18;1.000;3600000;0
29319;141978;1876;70;31;2;29;.935;3511000;0
29319;143100;516;0;0;0;0;.00nan;0;0
29320;62279;1472;63;28;3;25;.893;3600000;0
29320;143083;513;0;0;0;0;.00nan;0;0
29320;143421;513;76;25;1;24;.960;3600000;0
29320;159851;1472;0;0;0;0;.00nan;0;0
29321;177519;512;0;0;0;0;.00nan;0;0
29321;13613;518;0;0;0;0;.00nan;0;0
29321;86394;518;81;36;2;34;.944;3572000;0
29321;143191;512;82;22;1;21;.955;3600000;0
29322;4618;520;69;21;2;19;.905;3600000;0
29322;8426;2193;0;0;0;0;.00nan;0;0
29322;76951;2193;74;43;4;39;.907;3548000;0
29322;152478;520;0;0;0;0;.00nan;0;0
29323;179830;1876;0;0;0;0;.00nan;0;0
29323;68425;519;0;0;0;0;.00nan;0;0
29323;141978;1876;51;32;5;27;.844;3600000;0
29323;143307;519;77;24;1;23;.958;3600000;0
29324;63107;514;0;0;0;0;.00nan;0;0
29324;84287;516;61;29;4;25;.862;3600000;0
29324;143100;516;0;0;0;0;.00nan;0;0
29324;143330;514;49;32;5;27;.844;3548000;0
29325;14047;511;89;51;4;47;.922;3589000;0
29325;64800;511;0;0;0;0;.00nan;0;0
29325;143156;515;67;23;3;20;.870;3600000;0
29325;143507;515;0;0;0;0;.00nan;0;0
29326;38276;1872;0;0;0;0;.00nan;0;0
29326;62287;517;0;0;0;0;.00nan;0;0
29326;91202;1872;26;19;5;14;.737;3545000;0
29326;152202;517;75;35;3;32;.914;3600000;0
29327;62287;517;95;24;1;23;.958;3900000;0
29327;143191;520;72;19;1;18;.947;3900000;0
29327;152202;517;0;0;0;0;.00nan;0;0
29327;152478;520;0;0;0;0;.00nan;0;0
29328;13613;518;82;42;3;39;.929;3600000;0
29328;68425;519;27;21;6;15;.714;3600000;0
29328;86394;518;0;0;0;0;.00nan;0;0
29328;143307;519;0;0;0;0;.00nan;0;0
29329;62279;1472;0;0;0;0;.00nan;0;0
29329;143156;515;66;27;2;25;.926;3600000;0
29329;143507;515;0;0;0;0;.00nan;0;0
29329;159851;1472;51;23;3;20;.870;3600000;0
29330;63107;514;0;0;0;0;.00nan;0;0
29330;143083;513;0;0;0;0;.00nan;0;0
29330;143330;514;100;45;0;45;1.000;3600000;0
29330;143421;513;68;21;2;19;.905;3549000;0
29331;38276;1872;0;0;0;0;.00nan;0;0
29331;84287;516;70;19;1;18;.947;3600000;0
29331;91202;1872;66;38;4;34;.895;3600000;0
29331;143100;516;0;0;0;0;.00nan;0;0
29332;4618;512;0;0;0;0;.00nan;0;0
29332;177519;512;43;22;3;19;.864;3600000;0
29332;14047;511;93;36;2;34;.944;3600000;0
29332;64800;511;0;0;0;0;.00nan;0;0
29333;8426;2193;65;21;2;19;.905;3600000;0
29333;179830;1876;81;45;4;41;.911;3583000;0
29333;76951;2193;0;0;0;0;.00nan;0;0
29333;141978;1876;0;0;0;0;.00nan;0;0
29334;14047;511;66;39;4;35;.897;3600000;0
29334;64800;511;0;0;0;0;.00nan;0;0
29334;143083;513;0;0;0;0;.00nan;0;0
29334;143421;513;70;18;1;17;.944;3600000;0
29335;4618;512;0;0;0;0;.00nan;0;0
29335;177519;512;70;27;3;24;.889;3700000;0
29335;62287;517;0;0;0;0;.00nan;0;0
29335;152202;517;98;36;2;34;.944;3700000;0
29336;8426;2193;49;24;4;20;.833;3600000;0
29336;13613;518;0;0;0;0;.00nan;0;0
29336;76951;2193;0;0;0;0;.00nan;0;0
29336;86394;518;95;39;1;38;.974;3600000;0
29337;179830;1876;43;13;2;11;.846;1076000;0
29337;141978;1876;22;21;6;15;.714;2524000;0
29337;143191;520;68;26;2;24;.923;3600000;0
29337;152478;520;0;0;0;0;.00nan;0;0
29338;62279;1472;84;30;1;29;.967;3600000;0
29338;68425;519;0;0;0;0;.00nan;0;0
29338;143307;519;73;23;2;21;.913;3567000;0
29338;159851;1472;0;0;0;0;.00nan;0;0
29339;84287;516;75;28;2;26;.929;3600000;0
29339;143100;516;0;0;0;0;.00nan;0;0
29339;143156;515;74;32;3;29;.906;3600000;0
29339;143507;515;0;0;0;0;.00nan;0;0
29340;38276;1872;0;0;0;0;.00nan;0;0
29340;63107;514;0;0;0;0;.00nan;0;0
29340;91202;1872;91;43;2;41;.953;3600000;0
29340;143330;514;56;25;3;22;.880;3561000;0
29341;8426;2193;0;0;0;0;.00nan;0;0
29341;62287;517;98;40;2;38;.950;3600000;0
29341;76951;2193;67;28;4;24;.857;3514000;0
29341;152202;517;0;0;0;0;.00nan;0;0
29342;13613;518;0;0;0;0;.00nan;0;0
29342;179830;1876;0;0;0;0;.00nan;0;0
29342;86394;518;88;32;1;31;.969;3600000;0
29342;141978;1876;50;30;4;26;.867;3600000;0
29343;62279;1472;100;36;1;35;.972;3600000;0
29343;143191;520;82;39;3;36;.923;3578000;0
29343;152478;520;0;0;0;0;.00nan;0;0
29343;159851;1472;0;0;0;0;.00nan;0;0
29344;84287;516;48;29;5;24;.828;3600000;0
29344;143083;513;0;0;0;0;.00nan;0;0
29344;143100;516;0;0;0;0;.00nan;0;0
29344;143421;513;100;40;2;38;.950;3600000;0
29345;14047;511;88;31;1;30;.968;3732000;0
29345;64800;511;0;0;0;0;.00nan;0;0
29345;68425;519;0;0;0;0;.00nan;0;0
29345;143307;519;75;27;2;25;.926;3732000;0
29346;4618;512;40;36;6;30;.833;2323000;0
29346;177519;512;61;10;0;10;1.000;1277000;0
29346;63107;514;0;0;0;0;.00nan;0;0
29346;143330;514;98;43;2;41;.953;3600000;0
29347;38276;1872;0;0;0;0;.00nan;0;0
29347;91202;1872;81;52;4;48;.923;3600000;0
29347;143156;515;46;15;3;12;.800;3600000;0
29347;143507;515;0;0;0;0;.00nan;0;0
29348;13613;518;48;26;4;22;.846;3600000;0
29348;62287;517;26;11;4;7;.636;1571000;0
29348;86394;518;0;0;0;0;.00nan;0;0
29348;152202;517;59;15;1;14;.933;2007000;0
29349;143083;513;61;16;1;15;.938;2612000;0
29349;143156;515;84;39;3;36;.923;3600000;0
29349;143421;513;22;12;4;8;.667;983000;0
29349;143507;515;0;0;0;0;.00nan;0;0
29350;4618;512;67;22;2;20;.909;3566000;0
29350;177519;512;0;0;0;0;.00nan;0;0
29350;38276;1872;0;0;0;0;.00nan;0;0
29350;91202;1872;94;41;1;40;.976;3600000;0
29351;14047;511;76;27;2;25;.926;3600000;0
29351;64800;511;0;0;0;0;.00nan;0;0
29351;143191;520;85;35;3;32;.914;3555000;0
29351;152478;520;0;0;0;0;.00nan;0;0
29352;68425;519;81;54;5;49;.907;3600000;0
29352;84287;516;95;22;0;22;1.000;3600000;0
29352;143100;516;0;0;0;0;.00nan;0;0
29352;143307;519;0;0;0;0;.00nan;0;0
29353;8426;2193;97;43;2;41;.953;3600000;0
29353;63107;514;0;0;0;0;.00nan;0;0
29353;76951;2193;0;0;0;0;.00nan;0;0
29353;143330;514;84;28;1;27;.964;3600000;0
29354;179830;1876;82;33;2;31;.939;3600000;0
29354;62279;1472;46;19;3;16;.842;3582000;0
29354;141978;1876;0;0;0;0;.00nan;0;0
29354;159851;1472;0;0;0;0;.00nan;0;0
29355;179830;1876;0;0;0;0;.00nan;0;0
29355;62287;517;0;0;0;0;.00nan;0;0
29355;141978;1876;41;18;3;15;.833;3578000;0
29355;152202;517;68;25;2;23;.920;3600000;0
29356;8426;2193;0;0;0;0;.00nan;0;0
29356;62279;1472;0;0;0;0;.00nan;0;0
29356;76951;2193;40;27;5;22;.815;3600000;0
29356;159851;1472;71;22;1;21;.955;3600000;0
29357;4618;512;0;0;0;0;.00nan;0;0
29357;177519;512;85;32;2;30;.938;3545000;0
29357;84287;516;75;20;1;19;.950;3600000;0
29357;143100;516;0;0;0;0;.00nan;0;0
29358;13613;518;58;35;5;30;.857;3600000;0
29358;14047;511;100;21;0;21;1.000;3600000;0
29358;64800;511;0;0;0;0;.00nan;0;0
29358;86394;518;0;0;0;0;.00nan;0;0
29359;143156;515;66;18;1;17;.944;3600000;0
29359;143191;520;94;35;2;33;.943;3561000;0
29359;143507;515;0;0;0;0;.00nan;0;0
29359;152478;520;0;0;0;0;.00nan;0;0
29360;63107;514;0;0;0;0;.00nan;0;0
29360;68425;519;100;25;0;25;1.000;3600000;0
29360;143307;519;0;0;0;0;.00nan;0;0
29360;143330;514;61;20;2;18;.900;3530000;0
29361;38276;1872;0;0;0;0;.00nan;0;0
29361;91202;1872;91;36;1;35;.972;3600000;0
29361;143083;513;0;0;0;0;.00nan;0;0
29361;143421;513;42;26;4;22;.846;3600000;0
29362;62279;1472;82;27;1;26;.963;3600000;0
29362;62287;517;0;0;0;0;.00nan;0;0
29362;152202;517;61;25;2;23;.920;3600000;0
29362;159851;1472;0;0;0;0;.00nan;0;0
29363;13613;518;83;33;2;31;.939;3600000;0
29363;63107;514;0;0;0;0;.00nan;0;0
29363;86394;518;0;0;0;0;.00nan;0;0
29363;143330;514;80;41;3;38;.927;3588000;0
29364;4618;512;60;29;3;26;.897;3900000;0
29364;177519;512;0;0;0;0;.00nan;0;0
29364;143083;513;0;0;0;0;.00nan;0;0
29364;143421;513;87;39;3;36;.923;3900000;0
29365;8426;2193;62;39;5;34;.872;3600000;0
29365;38276;1872;0;0;0;0;.00nan;0;0
29365;76951;2193;0;0;0;0;.00nan;0;0
29365;91202;1872;80;26;1;25;.962;3600000;0
29366;84287;516;52;16;2;14;.875;3600000;0
29366;143100;516;0;0;0;0;.00nan;0;0
29366;143191;520;66;49;6;43;.878;3600000;0
29366;152478;520;0;0;0;0;.00nan;0;0
29367;68425;519;100;27;0;27;1.000;3600000;0
29367;143156;515;27;23;5;18;.783;3600000;0
29367;143307;519;0;0;0;0;.00nan;0;0
29367;143507;515;0;0;0;0;.00nan;0;0
29368;14047;511;81;29;2;27;.931;3600000;0
29368;179830;1876;47;29;4;25;.862;3581000;0
29368;64800;511;0;0;0;0;.00nan;0;0
29368;141978;1876;0;0;0;0;.00nan;0;0
29369;13613;518;0;0;0;0;.00nan;0;0
29369;62279;1472;100;24;0;24;1.000;3600000;0
29369;86394;518;98;37;1;36;.973;3557000;0
29369;159851;1472;0;0;0;0;.00nan;0;0
29370;179830;1876;0;0;0;0;.00nan;0;0
29370;141978;1876;76;29;2;27;.931;3600000;0
29370;143083;513;66;25;3;22;.880;3543000;0
29370;143421;513;0;0;0;0;.00nan;0;0
29371;63107;514;0;0;0;0;.00nan;0;0
29371;143191;520;82;44;3;41;.932;3600000;0
29371;143330;514;42;21;4;17;.810;3554000;0
29371;152478;520;0;0;0;0;.00nan;0;0
29372;8426;2193;0;0;0;0;.00nan;0;0
29372;76951;2193;72;40;4;36;.900;3583000;0
29372;84287;516;0;0;0;0;.00nan;0;0
29372;143100;516;75;27;2;25;.926;3600000;0
29373;14047;511;80;28;2;26;.929;3900000;0
29373;62287;517;0;0;0;0;.00nan;0;0
29373;64800;511;0;0;0;0;.00nan;0;0
29373;152202;517;64;35;2;33;.943;3887000;0
29374;4618;512;0;0;0;0;.00nan;0;0
29374;177519;512;90;33;2;31;.939;3600000;0
29374;143156;515;27;21;5;16;.762;2301000;0
29374;143507;515;68;12;0;12;1.000;1299000;0
29375;38276;1872;48;0;0;0;.00nan;339000;0
29375;68425;519;0;0;0;0;.00nan;0;0
29375;91202;1872;53;35;6;29;.829;3261000;0
29375;143307;519;81;28;1;27;.964;3600000;0
29376;68425;519;71;35;2;33;.943;3900000;0
29376;143083;513;0;0;0;0;.00nan;0;0
29376;143307;519;0;0;0;0;.00nan;0;0
29376;143421;513;59;17;2;15;.882;3900000;0
29377;4618;512;0;0;0;0;.00nan;0;0
29377;177519;512;85;30;1;29;.967;3600000;0
29377;143191;520;89;58;6;52;.897;3600000;0
29377;152478;520;0;0;0;0;.00nan;0;0
29378;62279;1472;75;47;4;43;.915;3600000;0
29378;84287;516;89;15;0;15;1.000;3600000;0
29378;143100;516;0;0;0;0;.00nan;0;0
29378;159851;1472;0;0;0;0;.00nan;0;0
29379;8426;2193;40;34;6;28;.824;2875000;0
29379;14047;511;75;25;1;24;.960;3600000;0
29379;64800;511;0;0;0;0;.00nan;0;0
29379;76951;2193;57;5;0;5;1.000;725000;0
29380;179830;1876;0;0;0;0;.00nan;0;0
29380;141978;1876;100;47;1;46;.979;3900000;0
29380;143156;515;65;18;1;17;.944;3900000;0
29380;143507;515;0;0;0;0;.00nan;0;0
29381;62287;517;0;0;0;0;.00nan;0;0
29381;63107;514;37;29;5;24;.828;3600000;0
29381;143330;514;0;0;0;0;.00nan;0;0
29381;152202;517;99;43;1;42;.977;3600000;0
29382;13613;518;0;0;0;0;.00nan;0;0
29382;38276;1872;0;0;0;0;.00nan;0;0
29382;86394;518;53;23;3;20;.870;3532000;0
29382;91202;1872;81;25;1;24;.960;3600000;0
29383;14047;511;0;0;0;0;.00nan;0;0
29383;64800;511;59;29;3;26;.897;3600000;0
29383;84287;516;45;35;5;30;.857;3540000;0
29383;143100;516;0;0;0;0;.00nan;0;0
29384;62287;517;63;39;4;35;.897;3600000;0
29384;84287;516;85;25;1;24;.960;3600000;0
29384;143100;516;0;0;0;0;.00nan;0;0
29384;152202;517;0;0;0;0;.00nan;0;0
29385;13613;518;0;0;0;0;.00nan;0;0
29385;86394;518;59;38;5;33;.868;3561000;0
29385;143083;513;0;0;0;0;.00nan;0;0
29385;143421;513;61;34;4;30;.882;3600000;0
29386;14047;511;25;7;3;4;.571;551000;0
29386;62279;1472;76;27;2;25;.926;3600000;0
29386;64800;511;95;38;2;36;.947;3049000;0
29386;159851;1472;0;0;0;0;.00nan;0;0
29387;8426;2193;0;0;0;0;.00nan;0;0
29387;76951;2193;54;48;7;41;.854;3600000;0
29387;143156;515;68;23;2;21;.913;3600000;0
29387;143507;515;0;0;0;0;.00nan;0;0
29388;38276;1872;0;0;0;0;.00nan;0;0
29388;91202;1872;100;19;0;19;1.000;3600000;0
29388;143191;520;75;30;2;28;.933;3560000;0
29388;152478;520;0;0;0;0;.00nan;0;0
29389;4618;512;0;0;0;0;.00nan;0;0
29389;177519;512;65;20;2;18;.900;3600000;0
29389;68425;519;42;31;6;25;.806;2895000;0
29389;143307;519;49;13;2;11;.846;705000;0
29390;179830;1876;98;42;2;40;.952;3900000;0
29390;63107;514;0;0;0;0;.00nan;0;0
29390;141978;1876;0;0;0;0;.00nan;0;0
29390;143330;514;66;26;2;24;.923;3900000;0
29391;8426;2193;83;47;3;44;.936;3900000;0
29391;76951;2193;0;0;0;0;.00nan;0;0
29391;143083;513;71;27;3;24;.889;3900000;0
29391;143421;513;0;0;0;0;.00nan;0;0
29392;4618;512;63;20;2;18;.900;3900000;0
29392;177519;512;0;0;0;0;.00nan;0;0
29392;179830;1876;0;0;0;0;.00nan;0;0
29392;141978;1876;81;31;2;29;.935;3900000;0
29393;68425;519;0;0;0;0;.00nan;0;0
29393;143191;520;76;32;2;30;.938;3559000;0
29393;143307;519;96;35;1;34;.971;3600000;0
29393;152478;520;0;0;0;0;.00nan;0;0
29394;13613;518;76;33;3;30;.909;3650000;0
29394;84287;516;80;27;2;25;.926;3650000;0
29394;86394;518;0;0;0;0;.00nan;0;0
29394;143100;516;0;0;0;0;.00nan;0;0
29395;62287;517;0;0;0;0;.00nan;0;0
29395;143156;515;80;25;1;24;.960;3600000;0
29395;143507;515;0;0;0;0;.00nan;0;0
29395;152202;517;70;31;2;29;.935;3583000;0
29396;14047;511;47;39;5;34;.872;3600000;0
29396;63107;514;0;0;0;0;.00nan;0;0
29396;64800;511;0;0;0;0;.00nan;0;0
29396;143330;514;83;27;1;26;.963;3600000;0
29397;38276;1872;0;0;0;0;.00nan;0;0
29397;62279;1472;50;24;3;21;.875;3578000;0
29397;91202;1872;65;22;2;20;.909;3600000;0
29397;159851;1472;0;0;0;0;.00nan;0;0
29398;62287;517;0;0;0;0;.00nan;0;0
29398;68425;519;0;0;0;0;.00nan;0;0
29398;143307;519;62;32;4;28;.875;3513000;0
29398;152202;517;64;24;2;22;.917;3600000;0
29399;13613;518;0;0;0;0;.00nan;0;0
29399;86394;518;87;60;5;55;.917;3600000;0
29399;143156;515;70;23;2;21;.913;3600000;0
29399;143507;515;0;0;0;0;.00nan;0;0
29400;62279;1472;92;38;2;36;.947;3600000;0
29400;63107;514;0;0;0;0;.00nan;0;0
29400;143330;514;64;30;3;27;.900;3600000;0
29400;159851;1472;0;0;0;0;.00nan;0;0
29401;4618;512;0;0;0;0;.00nan;0;0
29401;177519;512;72;18;1;17;.944;3600000;0
29401;8426;2193;0;0;0;0;.00nan;0;0
29401;76951;2193;92;37;2;35;.946;3575000;0
29402;143083;513;0;0;0;0;.00nan;0;0
29402;143191;520;75;44;4;40;.909;3600000;0
29402;143421;513;83;15;0;15;1.000;3600000;0
29402;152478;520;0;0;0;0;.00nan;0;0
29403;179830;1876;0;0;0;0;.00nan;0;0
29403;38276;1872;0;0;0;0;.00nan;0;0
29403;91202;1872;64;14;1;13;.929;3600000;0
29403;141978;1876;62;35;4;31;.886;3600000;0
29404;62287;517;79;38;3;35;.921;3600000;0
29404;143083;513;0;0;0;0;.00nan;0;0
29404;143421;513;85;13;0;13;1.000;3600000;0
29404;152202;517;0;0;0;0;.00nan;0;0
29405;4618;512;94;25;1;24;.960;3600000;0
29405;177519;512;0;0;0;0;.00nan;0;0
29405;62279;1472;55;24;3;21;.875;3518000;0
29405;159851;1472;0;0;0;0;.00nan;0;0
29406;13613;518;0;0;0;0;.00nan;0;0
29406;86394;518;70;33;3;30;.909;3900000;0
29406;143191;520;83;36;3;33;.917;3900000;0
29406;152478;520;0;0;0;0;.00nan;0;0
29407;8426;2193;54;41;6;35;.854;3585000;0
29407;68425;519;69;17;1;16;.941;2507000;0
29407;76951;2193;0;0;0;0;.00nan;0;0
29407;143307;519;25;11;4;7;.636;1093000;0
29408;179830;1876;0;0;0;0;.00nan;0;0
29408;84287;516;53;10;1;9;.900;3644000;0
29408;141978;1876;80;34;2;32;.941;3644000;0
29408;143100;516;0;0;0;0;.00nan;0;0
29409;63107;514;0;0;0;0;.00nan;0;0
29409;143156;515;41;27;4;23;.852;3569000;0
29409;143330;514;75;32;3;29;.906;3600000;0
29409;143507;515;0;0;0;0;.00nan;0;0
29410;14047;511;95;34;1;33;.971;3600000;0
29410;38276;1872;0;0;0;0;.00nan;0;0
29410;64800;511;0;0;0;0;.00nan;0;0
29410;91202;1872;49;30;4;26;.867;3600000;0
29411;38276;1872;0;0;0;0;.00nan;0;0
29411;62287;517;90;25;1;24;.960;3600000;0
29411;91202;1872;79;38;3;35;.921;3600000;0
29411;152202;517;0;0;0;0;.00nan;0;0
29412;4618;512;67;24;2;22;.917;3691000;0
29412;177519;512;0;0;0;0;.00nan;0;0
29412;13613;518;70;31;3;28;.903;3691000;0
29412;86394;518;0;0;0;0;.00nan;0;0
29413;62279;1472;100;27;0;27;1.000;3600000;0
29413;143083;513;60;5;0;5;1.000;944000;0
29413;143421;513;13;20;6;14;.700;2656000;0
29413;159851;1472;0;0;0;0;.00nan;0;0
29414;8426;2193;0;0;0;0;.00nan;0;0
29414;76951;2193;98;41;2;39;.951;3552000;0
29414;143191;520;100;24;0;24;1.000;3600000;0
29414;152478;520;0;0;0;0;.00nan;0;0
29415;14047;511;44;29;4;25;.862;3585000;0
29415;64800;511;0;0;0;0;.00nan;0;0
29415;143156;515;77;21;2;19;.905;3600000;0
29415;143507;515;0;0;0;0;.00nan;0;0
29416;63107;514;75;27;1;26;.963;3600000;0
29416;84287;516;37;22;4;18;.818;3600000;0
29416;143100;516;0;0;0;0;.00nan;0;0
29416;143330;514;0;0;0;0;.00nan;0;0
29417;179830;1876;100;44;1;43;.977;3782000;0
29417;68425;519;63;22;2;20;.909;3782000;0
29417;141978;1876;0;0;0;0;.00nan;0;0
29417;143307;519;0;0;0;0;.00nan;0;0
29418;14047;511;0;0;0;0;.00nan;0;0
29418;64800;511;96;46;3;43;.935;3600000;0
29418;143083;513;0;0;0;0;.00nan;0;0
29418;143421;513;100;25;0;25;1.000;3600000;0
29419;4618;512;0;0;0;0;.00nan;0;0
29419;177519;512;38;17;4;13;.765;3600000;0
29419;62287;517;85;54;5;49;.907;3600000;0
29419;152202;517;0;0;0;0;.00nan;0;0
29420;8426;2193;82;51;6;45;.882;3600000;0
29420;13613;518;69;33;3;30;.909;3600000;0
29420;76951;2193;0;0;0;0;.00nan;0;0
29420;86394;518;0;0;0;0;.00nan;0;0
29421;179830;1876;0;0;0;0;.00nan;0;0
29421;141978;1876;95;41;2;39;.951;3600000;0
29421;143191;520;52;20;3;17;.850;3552000;0
29421;152478;520;0;0;0;0;.00nan;0;0
29422;62279;1472;70;38;4;34;.895;3900000;0
29422;68425;519;0;0;0;0;.00nan;0;0
29422;143307;519;65;39;4;35;.897;3900000;0
29422;159851;1472;0;0;0;0;.00nan;0;0
29423;84287;516;74;19;1;18;.947;3600000;0
29423;143100;516;0;0;0;0;.00nan;0;0
29423;143156;515;0;0;0;0;.00nan;0;0
29423;143507;515;92;34;2;32;.941;3600000;0
29424;38276;1872;0;0;0;0;.00nan;0;0
29424;63107;514;0;0;0;0;.00nan;0;0
29424;91202;1872;76;40;4;36;.900;3551000;0
29424;143330;514;59;19;2;17;.895;3600000;0
29425;63107;514;0;0;0;0;.00nan;0;0
29425;143083;513;0;0;0;0;.00nan;0;0
29425;143330;514;83;33;2;31;.939;3600000;0
29425;143421;513;74;31;3;28;.903;3554000;0
29426;4618;512;69;32;3;29;.906;3600000;0
29426;177519;512;0;0;0;0;.00nan;0;0
29426;14047;511;70;35;4;31;.886;3600000;0
29426;64800;511;0;0;0;0;.00nan;0;0
29427;8426;2193;0;0;0;0;.00nan;0;0
29427;179830;1876;0;0;0;0;.00nan;0;0
29427;76951;2193;96;31;1;30;.968;3600000;0
29427;141978;1876;83;40;3;37;.925;3566000;0
29428;62287;517;64;42;5;37;.881;3600000;0
29428;143191;520;0;0;0;0;.00nan;0;0
29428;152202;517;0;0;0;0;.00nan;0;0
29428;152478;520;83;32;2;30;.938;3600000;0
29429;13613;518;0;0;0;0;.00nan;0;0
29429;68425;519;41;21;4;17;.810;3590000;0
29429;86394;518;66;37;3;34;.919;3600000;0
29429;143307;519;0;0;0;0;.00nan;0;0
29430;62279;1472;97;46;2;44;.957;3600000;0
29430;143156;515;56;24;3;21;.875;3574000;0
29430;143507;515;0;0;0;0;.00nan;0;0
29430;159851;1472;0;0;0;0;.00nan;0;0
29431;38276;1872;0;0;0;0;.00nan;0;0
29431;84287;516;91;20;0;20;1.000;3600000;0
29431;91202;1872;81;36;2;34;.944;3600000;0
29431;143100;516;0;0;0;0;.00nan;0;0
29432;4618;512;0;0;0;0;.00nan;0;0
29432;177519;512;59;31;4;27;.871;3596000;0
29432;62287;517;76;37;3;34;.919;3600000;0
29432;152202;517;0;0;0;0;.00nan;0;0
29433;8426;2193;55;37;5;32;.865;3600000;0
29433;13613;518;78;23;1;22;.957;3600000;0
29433;76951;2193;0;0;0;0;.00nan;0;0
29433;86394;518;0;0;0;0;.00nan;0;0
29434;62279;1472;0;0;0;0;.00nan;0;0
29434;68425;519;0;0;0;0;.00nan;0;0
29434;143307;519;87;21;0;21;1.000;3600000;0
29434;159851;1472;77;22;1;21;.955;3575000;0
29435;84287;516;67;24;2;22;.917;3600000;0
29435;143100;516;0;0;0;0;.00nan;0;0
29435;143156;515;75;36;3;33;.917;3600000;0
29435;143507;515;0;0;0;0;.00nan;0;0
29436;14047;511;0;0;0;0;.00nan;0;0
29436;64800;511;52;24;3;21;.875;3600000;0
29436;143083;513;100;39;0;39;1.000;3600000;0
29436;143421;513;0;0;0;0;.00nan;0;0
29437;179830;1876;53;30;4;26;.867;3536000;0
29437;141978;1876;0;0;0;0;.00nan;0;0
29437;143191;520;66;22;2;20;.909;3600000;0
29437;152478;520;0;0;0;0;.00nan;0;0
29438;38276;1872;0;0;0;0;.00nan;0;0
29438;63107;514;0;0;0;0;.00nan;0;0
29438;91202;1872;60;35;5;30;.857;3600000;0
29438;143330;514;76;25;1;24;.960;3600000;0
29439;84287;516;90;20;0;20;1.000;3600000;0
29439;143083;513;97;44;2;42;.955;3579000;0
29439;143100;516;0;0;0;0;.00nan;0;0
29439;143421;513;0;0;0;0;.00nan;0;0
29440;4618;512;54;25;4;21;.840;3567000;0
29440;177519;512;0;0;0;0;.00nan;0;0
29440;63107;514;0;0;0;0;.00nan;0;0
29440;143330;514;92;37;3;34;.919;3600000;0
29441;8426;2193;0;0;0;0;.00nan;0;0
29441;62287;517;46;31;5;26;.839;3600000;0
29441;76951;2193;99;32;1;31;.969;3600000;0
29441;152202;517;0;0;0;0;.00nan;0;0
29442;62279;1472;61;20;2;18;.900;3572000;0
29442;143191;520;94;30;1;29;.967;3600000;0
29442;152478;520;0;0;0;0;.00nan;0;0
29442;159851;1472;0;0;0;0;.00nan;0;0
29443;14047;511;80;34;2;32;.941;3900000;0
29443;64800;511;0;0;0;0;.00nan;0;0
29443;68425;519;0;0;0;0;.00nan;0;0
29443;143307;519;100;47;2;45;.957;3900000;0
29444;38276;1872;0;0;0;0;.00nan;0;0
29444;91202;1872;73;36;4;32;.889;3600000;0
29444;143156;515;80;25;1;24;.960;3600000;0
29444;143507;515;0;0;0;0;.00nan;0;0
29445;13613;518;0;0;0;0;.00nan;0;0
29445;179830;1876;0;0;0;0;.00nan;0;0
29445;86394;518;54;41;6;35;.854;3600000;0
29445;141978;1876;71;31;2;29;.935;3600000;0
29446;13613;518;0;0;0;0;.00nan;0;0
29446;62287;517;0;0;0;0;.00nan;0;0
29446;86394;518;87;39;2;37;.949;3600000;0
29446;152202;517;39;31;5;26;.839;3600000;0
29447;179830;1876;0;0;0;0;.00nan;0;0
29447;62279;1472;35;14;3;11;.786;3567000;0
29447;141978;1876;96;45;2;43;.956;3600000;0
29447;159851;1472;0;0;0;0;.00nan;0;0
29448;68425;519;0;0;0;0;.00nan;0;0
29448;84287;516;62;23;2;21;.913;3600000;0
29448;143100;516;0;0;0;0;.00nan;0;0
29448;143307;519;42;48;7;41;.854;3600000;0
29449;14047;511;0;0;0;0;.00nan;0;0
29449;64800;511;87;25;1;24;.960;3600000;0
29449;143191;520;76;47;4;43;.915;3600000;0
29449;152478;520;0;0;0;0;.00nan;0;0
29450;143083;513;0;0;0;0;.00nan;0;0
29450;143156;515;94;26;1;25;.962;3900000;0
29450;143421;513;96;54;1;53;.981;3899000;0
29450;143507;515;0;0;0;0;.00nan;0;0
29451;8426;2193;45;42;6;36;.857;3106000;0
29451;63107;514;48;27;4;23;.852;3600000;0
29451;76951;2193;53;3;0;3;1.000;494000;0
29451;143330;514;0;0;0;0;.00nan;0;0
29452;4618;512;0;0;0;0;.00nan;0;0
29452;177519;512;65;27;3;24;.889;3587000;0
29452;38276;1872;83;46;2;44;.957;3600000;0
29452;91202;1872;0;0;0;0;.00nan;0;0
29453;13613;518;38;36;6;30;.833;3600000;0
29453;14047;511;93;43;2;41;.953;3600000;0
29453;64800;511;0;0;0;0;.00nan;0;0
29453;86394;518;0;0;0;0;.00nan;0;0
29454;38276;1872;0;0;0;0;.00nan;0;0
29454;91202;1872;78;46;4;42;.913;3576000;0
29454;143083;513;0;0;0;0;.00nan;0;0
29454;143421;513;52;22;3;19;.864;3600000;0
29455;4618;512;76;34;2;32;.941;3596000;0
29455;177519;512;0;0;0;0;.00nan;0;0
29455;84287;516;66;19;1;18;.947;3600000;0
29455;143100;516;0;0;0;0;.00nan;0;0
29456;8426;2193;0;0;0;0;.00nan;0;0
29456;62279;1472;53;17;2;15;.882;3600000;0
29456;76951;2193;98;54;3;51;.944;3583000;0
29456;159851;1472;0;0;0;0;.00nan;0;0
29457;143156;515;75;23;2;21;.913;3600000;0
29457;143191;520;86;44;3;41;.932;3600000;0
29457;143507;515;0;0;0;0;.00nan;0;0
29457;152478;520;0;0;0;0;.00nan;0;0
29458;63107;514;0;0;0;0;.00nan;0;0
29458;68425;519;0;0;0;0;.00nan;0;0
29458;143307;519;75;38;3;35;.921;3600000;0
29458;143330;514;85;12;0;12;1.000;3600000;0
29459;179830;1876;0;0;0;0;.00nan;0;0
29459;62287;517;82;28;1;27;.964;3600000;0
29459;141978;1876;73;30;2;28;.933;3600000;0
29459;152202;517;0;0;0;0;.00nan;0;0
29460;62279;1472;75;38;3;35;.921;3900000;0
29460;62287;517;0;0;0;0;.00nan;0;0
29460;152202;517;64;30;3;27;.900;3900000;0
29460;159851;1472;0;0;0;0;.00nan;0;0
29461;4618;512;0;0;0;0;.00nan;0;0
29461;177519;512;58;22;2;20;.909;3600000;0
29461;143083;513;0;0;0;0;.00nan;0;0
29461;143421;513;43;31;4;27;.871;3600000;0
29462;84287;516;0;0;0;0;.00nan;0;0
29462;143100;516;65;27;3;24;.889;3600000;0
29462;143191;520;22;11;4;7;.636;1067000;0
29462;152478;520;63;31;3;28;.903;2533000;0
29463;14047;511;0;0;0;0;.00nan;0;0
29463;179830;1876;0;0;0;0;.00nan;0;0
29463;64800;511;76;17;1;16;.941;3600000;0
29463;141978;1876;98;44;2;42;.955;3600000;0
29464;68425;519;0;0;0;0;.00nan;0;0
29464;143156;515;71;27;2;25;.926;3600000;0
29464;143307;519;57;35;4;31;.886;3547000;0
29464;143507;515;0;0;0;0;.00nan;0;0
29465;13613;518;0;0;0;0;.00nan;0;0
29465;63107;514;0;0;0;0;.00nan;0;0
29465;86394;518;94;41;3;38;.927;3600000;0
29465;143330;514;50;17;2;15;.882;3600000;0
29466;8426;2193;92;38;2;36;.947;3600000;0
29466;38276;1872;0;0;0;0;.00nan;0;0
29466;76951;2193;0;0;0;0;.00nan;0;0
29466;91202;1872;65;34;3;31;.912;3543000;0
29467;14047;511;86;19;0;19;1.000;3600000;0
29467;62287;517;0;0;0;0;.00nan;0;0
29467;64800;511;0;0;0;0;.00nan;0;0
29467;152202;517;74;32;2;30;.938;3517000;0
29468;13613;518;0;0;0;0;.00nan;0;0
29468;62279;1472;50;28;4;24;.857;3594000;0
29468;86394;518;73;41;3;38;.927;3600000;0
29468;159851;1472;0;0;0;0;.00nan;0;0
29469;4618;512;0;0;0;0;.00nan;0;0
29469;177519;512;65;32;4;28;.875;3577000;0
29469;143156;515;74;30;2;28;.933;3600000;0
29469;143507;515;0;0;0;0;.00nan;0;0
29470;8426;2193;98;52;2;50;.962;3589000;0
29470;76951;2193;0;0;0;0;.00nan;0;0
29470;84287;516;77;19;1;18;.947;3600000;0
29470;143100;516;0;0;0;0;.00nan;0;0
29471;63107;514;0;0;0;0;.00nan;0;0
29471;143191;520;91;45;4;41;.911;3900000;0
29471;143330;514;52;28;4;24;.857;3900000;0
29471;152478;520;0;0;0;0;.00nan;0;0
29472;38276;1872;0;0;0;0;.00nan;0;0
29472;68425;519;83;31;2;29;.935;3577000;0
29472;91202;1872;80;27;1;26;.963;3600000;0
29472;143307;519;0;0;0;0;.00nan;0;0
29473;179830;1876;0;0;0;0;.00nan;0;0
29473;141978;1876;92;47;3;44;.936;3600000;0
29473;143083;513;0;0;0;0;.00nan;0;0
29473;143421;513;11;18;6;12;.667;3600000;0
29474;62287;517;0;0;0;0;.00nan;0;0
29474;63107;514;0;0;0;0;.00nan;0;0
29474;143330;514;83;20;1;19;.950;3600000;0
29474;152202;517;64;39;5;34;.872;3600000;0
29475;13613;518;0;0;0;0;.00nan;0;0
29475;38276;1872;0;0;0;0;.00nan;0;0
29475;86394;518;71;29;2;27;.931;3600000;0
29475;91202;1872;75;33;3;30;.909;3555000;0
29476;62279;1472;54;26;4;22;.846;3598000;0
29476;84287;516;73;23;3;20;.870;3600000;0
29476;143100;516;0;0;0;0;.00nan;0;0
29476;159851;1472;0;0;0;0;.00nan;0;0
29477;8426;2193;0;0;0;0;.00nan;0;0
29477;14047;511;73;28;2;26;.929;3900000;0
29477;64800;511;0;0;0;0;.00nan;0;0
29477;76951;2193;100;47;2;45;.957;3900000;0
29478;4618;512;0;0;0;0;.00nan;0;0
29478;177519;512;97;22;0;22;1.000;3600000;0
29478;143191;520;89;29;1;28;.966;3543000;0
29478;152478;520;0;0;0;0;.00nan;0;0
29479;68425;519;0;0;0;0;.00nan;0;0
29479;143083;513;0;0;0;0;.00nan;0;0
29479;143307;519;74;37;3;34;.919;3600000;0
29479;143421;513;33;26;5;21;.808;3583000;0
29480;179830;1876;63;29;3;26;.897;3562000;0
29480;141978;1876;0;0;0;0;.00nan;0;0
29480;143156;515;77;26;1;25;.962;3600000;0
29480;143507;515;0;0;0;0;.00nan;0;0
29481;13613;518;0;0;0;0;.00nan;0;0
29481;86394;518;70;36;4;32;.889;3521000;0
29481;143083;513;66;21;2;19;.905;3600000;0
29481;143421;513;0;0;0;0;.00nan;0;0
29482;4618;512;0;0;0;0;.00nan;0;0
29482;177519;512;50;22;3;19;.864;3600000;0
29482;68425;519;0;0;0;0;.00nan;0;0
29482;143307;519;49;28;4;24;.857;3562000;0
29483;62287;517;97;49;3;46;.939;3600000;0
29483;84287;516;87;17;0;17;1.000;3600000;0
29483;143100;516;0;0;0;0;.00nan;0;0
29483;152202;517;0;0;0;0;.00nan;0;0
29484;14047;511;0;0;0;0;.00nan;0;0
29484;62279;1472;68;34;3;31;.912;3572000;0
29484;64800;511;75;25;2;23;.920;3600000;0
29484;159851;1472;0;0;0;0;.00nan;0;0
29485;8426;2193;51;29;4;25;.862;3600000;0
29485;76951;2193;0;0;0;0;.00nan;0;0
29485;143156;515;71;22;1;21;.955;3600000;0
29485;143507;515;0;0;0;0;.00nan;0;0
29486;179830;1876;0;0;0;0;.00nan;0;0
29486;63107;1876;78;53;3;50;.943;3600000;0
29486;141978;514;85;13;0;13;1.000;3600000;0
29486;143330;514;0;0;0;0;.00nan;0;0
29487;38276;1872;47;6;1;5;.833;771000;0
29487;91202;1872;32;31;6;25;.806;2829000;0
29487;143191;520;68;23;2;21;.913;3600000;0
29487;152478;520;0;0;0;0;.00nan;0;0
29488;62287;517;98;51;2;49;.961;3579000;0
29488;143156;515;88;27;1;26;.963;3600000;0
29488;143507;515;0;0;0;0;.00nan;0;0
29488;152202;517;0;0;0;0;.00nan;0;0
29489;13613;518;65;31;3;28;.903;3575000;0
29489;84287;516;52;10;1;9;.900;3600000;0
29489;86394;518;0;0;0;0;.00nan;0;0
29489;143100;516;0;0;0;0;.00nan;0;0
29490;38276;1872;0;0;0;0;.00nan;0;0
29490;62279;1472;82;36;3;33;.917;3600000;0
29490;91202;1872;50;38;5;33;.868;3600000;0
29490;159851;1472;0;0;0;0;.00nan;0;0
29491;8426;2193;0;0;0;0;.00nan;0;0
29491;76951;2193;86;40;3;37;.925;3600000;0
29491;143083;513;0;0;0;0;.00nan;0;0
29491;143421;513;100;32;0;32;1.000;3600000;0
29492;68425;519;0;0;0;0;.00nan;0;0
29492;143191;520;0;0;0;0;.00nan;0;0
29492;143307;519;87;42;3;39;.929;3738000;0
29492;152478;520;41;22;4;18;.818;3738000;0
29493;14047;511;0;0;0;0;.00nan;0;0
29493;64800;511;91;33;1;32;.970;3600000;0
29493;141978;514;90;32;2;30;.938;3545000;0
29493;143330;514;0;0;0;0;.00nan;0;0
29494;4618;512;54;11;1;10;.909;3549000;0
29494;177519;512;0;0;0;0;.00nan;0;0
29494;179830;1876;0;0;0;0;.00nan;0;0
29494;63107;1876;100;31;0;31;1.000;3600000;0
29495;143083;513;0;0;0;0;.00nan;0;0
29495;143191;520;51;33;5;28;.848;3600000;0
29495;143421;513;79;23;1;22;.957;3600000;0
29495;152478;520;0;0;0;0;.00nan;0;0
29496;4618;512;0;0;0;0;.00nan;0;0
29496;177519;512;74;28;2;26;.929;3600000;0
29496;8426;2193;60;43;5;38;.884;3600000;0
29496;76951;2193;0;0;0;0;.00nan;0;0
29497;62287;517;0;0;0;0;.00nan;0;0
29497;68425;519;0;0;0;0;.00nan;0;0
29497;143307;519;88;23;1;22;.957;3600000;0
29497;152202;517;71;35;3;32;.914;3600000;0
29498;14047;511;0;0;0;0;.00nan;0;0
29498;64800;511;73;35;4;31;.886;3600000;0
29498;84287;516;76;30;2;28;.933;3600000;0
29498;143100;516;0;0;0;0;.00nan;0;0
29499;13613;518;0;0;0;0;.00nan;0;0
29499;86394;518;52;29;4;25;.862;3600000;0
29499;143156;515;92;18;0;18;1.000;3600000;0
29499;143507;515;0;0;0;0;.00nan;0;0
29500;62279;1472;65;27;3;24;.889;3579000;0
29500;141978;514;0;0;0;0;.00nan;0;0
29500;143330;514;65;21;2;19;.905;3600000;0
29500;159851;1472;0;0;0;0;.00nan;0;0
29501;179830;1876;0;0;0;0;.00nan;0;0
29501;38276;1872;91;40;2;38;.950;3544000;0
29501;63107;1876;77;24;1;23;.958;3600000;0
29501;91202;1872;0;0;0;0;.00nan;0;0
29502;62287;517;90;49;4;45;.918;3556000;0
29502;143083;513;0;0;0;0;.00nan;0;0
29502;143421;513;51;19;3;16;.842;3600000;0
29502;152202;517;0;0;0;0;.00nan;0;0
29503;13613;518;76;32;2;30;.938;3600000;0
29503;86394;518;0;0;0;0;.00nan;0;0
29503;143191;520;41;33;6;27;.818;3600000;0
29503;152478;520;0;0;0;0;.00nan;0;0
29504;4618;512;0;0;0;0;.00nan;0;0
29504;177519;512;57;28;3;25;.893;3600000;0
29504;62279;1472;56;39;5;34;.872;3529000;0
29504;159851;1472;0;0;0;0;.00nan;0;0
29505;8426;2193;0;0;0;0;.00nan;0;0
29505;68425;519;0;0;0;0;.00nan;0;0
29505;76951;2193;85;31;2;29;.935;3877000;0
29505;143307;519;74;32;3;29;.906;3877000;0
29506;14047;511;0;0;0;0;.00nan;0;0
29506;38276;1872;0;0;0;0;.00nan;0;0
29506;64800;511;92;33;1;32;.970;3600000;0
29506;91202;1872;80;34;3;31;.912;3600000;0
29507;141978;514;0;0;0;0;.00nan;0;0
29507;143156;515;51;24;4;20;.833;3600000;0
29507;143330;514;88;31;1;30;.968;3600000;0
29507;143507;515;0;0;0;0;.00nan;0;0
29508;179830;1876;0;0;0;0;.00nan;0;0
29508;63107;1876;92;49;2;47;.959;3600000;0
29508;84287;516;51;6;1;5;.833;3600000;0
29508;143100;516;0;0;0;0;.00nan;0;0
29509;62279;1472;64;28;3;25;.893;3546000;0
29509;143083;513;0;0;0;0;.00nan;0;0
29509;143421;513;82;24;1;23;.958;3600000;0
29509;159851;1472;0;0;0;0;.00nan;0;0
29510;4618;512;50;18;3;15;.833;3600000;0
29510;177519;512;0;0;0;0;.00nan;0;0
29510;13613;518;0;0;0;0;.00nan;0;0
29510;86394;518;49;39;5;34;.872;3561000;0
29511;8426;2193;62;45;5;40;.889;3600000;0
29511;76951;2193;0;0;0;0;.00nan;0;0
29511;143191;520;100;28;0;28;1.000;3600000;0
29511;152478;520;0;0;0;0;.00nan;0;0
29512;179830;1876;0;0;0;0;.00nan;0;0
29512;63107;1876;64;39;5;34;.872;3618000;0
29512;68425;519;45;24;4;20;.833;3618000;0
29512;143307;519;0;0;0;0;.00nan;0;0
29513;84287;516;0;0;0;0;.00nan;0;0
29513;141978;514;71;32;3;29;.906;3600000;0
29513;143100;516;100;33;0;33;1.000;3600000;0
29513;143330;514;0;0;0;0;.00nan;0;0
29514;14047;511;0;0;0;0;.00nan;0;0
29514;64800;511;56;27;4;23;.852;3600000;0
29514;143156;515;0;0;0;0;.00nan;0;0
29514;143507;515;100;38;1;37;.974;3600000;0
29515;38276;1872;0;0;0;0;.00nan;0;0
29515;62287;517;0;0;0;0;.00nan;0;0
29515;91202;1872;100;32;0;32;1.000;3600000;0
29515;152202;517;53;33;4;29;.879;3600000;0
29516;62287;517;59;30;3;27;.900;3600000;0
29516;143191;520;93;17;0;17;1.000;3600000;0
29516;152202;517;0;0;0;0;.00nan;0;0
29516;152478;520;0;0;0;0;.00nan;0;0
29517;13613;518;48;22;4;18;.818;3540000;0
29517;68425;519;0;0;0;0;.00nan;0;0
29517;86394;518;0;0;0;0;.00nan;0;0
29517;143307;519;78;34;2;32;.941;3600000;0
29518;62279;1472;28;27;6;21;.778;3552000;0
29518;143156;515;66;33;4;29;.879;3600000;0
29518;143507;515;0;0;0;0;.00nan;0;0
29518;159851;1472;0;0;0;0;.00nan;0;0
29519;38276;1872;0;0;0;0;.00nan;0;0
29519;84287;516;74;24;1;23;.958;3600000;0
29519;91202;1872;91;50;4;46;.920;3600000;0
29519;143100;516;0;0;0;0;.00nan;0;0
29520;4618;512;0;0;0;0;.00nan;0;0
29520;177519;512;97;25;1;24;.960;3600000;0
29520;14047;511;0;0;0;0;.00nan;0;0
29520;64800;511;97;44;2;42;.955;3600000;0
29521;141978;514;0;0;0;0;.00nan;0;0
29521;143083;513;0;0;0;0;.00nan;0;0
29521;143330;514;79;28;2;26;.929;3600000;0
29521;143421;513;66;36;3;33;.917;3600000;0
29522;8426;2193;0;0;0;0;.00nan;0;0
29522;179830;1876;0;0;0;0;.00nan;0;0
29522;63107;1876;93;42;2;40;.952;3900000;0
29522;76951;2193;80;29;2;27;.931;3900000;0
29523;8426;2193;30;14;4;10;.714;1072000;0
29523;62287;517;0;0;0;0;.00nan;0;0
29523;76951;2193;69;27;2;25;.926;2528000;0
29523;152202;517;77;30;2;28;.933;3600000;0
29524;13613;518;0;0;0;0;.00nan;0;0
29524;179830;1876;0;0;0;0;.00nan;0;0
29524;63107;1876;28;30;7;23;.767;3600000;0
29524;86394;518;69;31;3;28;.903;3600000;0
29525;62279;1472;59;24;3;21;.875;3559000;0
29525;143191;520;100;33;1;32;.970;3600000;0
29525;152478;520;0;0;0;0;.00nan;0;0
29525;159851;1472;0;0;0;0;.00nan;0;0
29526;84287;516;0;0;0;0;.00nan;0;0
29526;143083;513;0;0;0;0;.00nan;0;0
29526;143330;516;57;34;5;29;.853;3600000;0
29526;143421;513;87;38;3;35;.921;3600000;0
29527;14047;511;77;24;1;23;.958;3600000;0
29527;64271;511;0;0;0;0;.00nan;0;0
29527;68425;519;0;0;0;0;.00nan;0;0
29527;143307;519;97;39;2;37;.949;3580000;0
29528;4618;512;53;30;5;25;.833;3529000;0
29528;141978;514;58;25;3;22;.880;3600000;0
29528;143019;514;0;0;0;0;.00nan;0;0
29528;155465;512;0;0;0;0;.00nan;0;0
29529;38276;1872;86;38;2;36;.947;3600000;0
29529;64800;515;0;0;0;0;.00nan;0;0
29529;91202;1872;0;0;0;0;.00nan;0;0
29529;143156;515;55;23;3;20;.870;3561000;0
29530;13613;518;51;21;3;18;.857;3576000;0
29530;62287;517;64;19;1;18;.947;3600000;0
29530;86394;518;0;0;0;0;.00nan;0;0
29530;152202;517;0;0;0;0;.00nan;0;0
29531;64800;515;0;0;0;0;.00nan;0;0
29531;143083;513;54;38;5;33;.868;3805000;0
29531;143156;515;67;35;4;31;.886;3805000;0
29531;143421;513;0;0;0;0;.00nan;0;0
29532;4618;512;79;21;1;20;.952;3600000;0
29532;38276;1872;0;0;0;0;.00nan;0;0
29532;91202;1872;97;39;2;37;.949;3600000;0
29532;155465;512;0;0;0;0;.00nan;0;0
29533;8426;2193;0;0;0;0;.00nan;0;0
29533;76951;2193;89;50;3;47;.940;3900000;0
29533;141978;514;64;25;3;22;.880;3900000;0
29533;143019;514;0;0;0;0;.00nan;0;0
29534;14047;511;63;30;3;27;.900;3600000;0
29534;64271;511;0;0;0;0;.00nan;0;0
29534;143191;520;20;9;4;5;.556;997000;0
29534;152478;520;46;19;3;16;.842;2603000;0
29535;68425;519;0;0;0;0;.00nan;0;0
29535;84287;516;0;0;0;0;.00nan;0;0
29535;143307;519;99;47;2;45;.957;3650000;0
29535;143330;516;78;32;3;29;.906;3650000;0
29536;179830;1876;0;0;0;0;.00nan;0;0
29536;62279;1472;83;36;2;34;.944;3600000;0
29536;63107;1876;60;31;3;28;.903;3600000;0
29536;159851;1472;0;0;0;0;.00nan;0;0
29537;179830;1876;0;0;0;0;.00nan;0;0
29537;62287;517;0;0;0;0;.00nan;0;0
29537;63107;1876;100;37;1;36;.973;3600000;0
29537;152202;517;62;36;4;32;.889;3600000;0
29538;8426;2193;42;34;6;28;.824;3252000;0
29538;62279;1472;0;0;0;0;.00nan;0;0
29538;76951;2193;53;3;0;3;1.000;348000;0
29538;159851;1472;78;34;3;31;.912;3600000;0
29539;4618;512;69;52;6;46;.885;3600000;0
29539;84287;516;0;0;0;0;.00nan;0;0
29539;143330;516;92;21;0;21;1.000;3600000;0
29539;155465;512;0;0;0;0;.00nan;0;0
29540;13613;518;0;0;0;0;.00nan;0;0
29540;14047;511;72;40;5;35;.875;3550000;0
29540;64271;511;0;0;0;0;.00nan;0;0
29540;86394;518;84;37;3;34;.919;3600000;0
29541;64800;515;41;32;5;27;.844;3600000;0
29541;143156;515;0;0;0;0;.00nan;0;0
29541;143191;520;60;31;4;27;.871;3600000;0
29541;152478;520;0;0;0;0;.00nan;0;0
29542;68425;519;0;0;0;0;.00nan;0;0
29542;141978;514;92;28;1;27;.964;3600000;0
29542;143019;514;0;0;0;0;.00nan;0;0
29542;143307;519;69;39;4;35;.897;3600000;0
29543;38276;1872;64;8;0;8;1.000;1307000;0
29543;91202;1872;17;15;5;10;.667;2257000;0
29543;143083;513;0;0;0;0;.00nan;0;0
29543;143421;513;51;25;3;22;.880;3600000;0
29544;62279;1472;81;28;2;26;.929;3557000;0
29544;62287;517;86;32;1;31;.969;3600000;0
29544;152202;517;0;0;0;0;.00nan;0;0
29544;159851;1472;0;0;0;0;.00nan;0;0
29545;13613;518;0;0;0;0;.00nan;0;0
29545;86394;518;58;26;3;23;.885;3566000;0
29545;141978;514;70;28;2;26;.929;3600000;0
29545;143019;514;0;0;0;0;.00nan;0;0
29546;4618;512;75;33;3;30;.909;3566000;0
29546;143083;513;0;0;0;0;.00nan;0;0
29546;143421;513;100;29;0;29;1.000;3600000;0
29546;155465;512;0;0;0;0;.00nan;0;0
29547;8426;2193;0;0;0;0;.00nan;0;0
29547;38276;1872;63;33;4;29;.879;3900000;0
29547;76951;2193;67;48;4;44;.917;3900000;0
29547;91202;1872;0;0;0;0;.00nan;0;0
29548;84287;516;0;0;0;0;.00nan;0;0
29548;143191;520;100;35;1;34;.971;3900000;0
29548;143330;516;82;28;1;27;.964;3900000;0
29548;152478;520;0;0;0;0;.00nan;0;0
29549;64800;515;0;0;0;0;.00nan;0;0
29549;68425;519;0;0;0;0;.00nan;0;0
29549;143156;515;89;18;0;18;1.000;3600000;0
29549;143307;519;85;37;2;35;.946;3577000;0
29550;14047;511;93;20;0;20;1.000;3600000;0
29550;179830;1876;0;0;0;0;.00nan;0;0
29550;63107;1876;68;47;5;42;.894;3600000;0
29550;64271;511;0;0;0;0;.00nan;0;0
29551;62279;1472;71;26;2;24;.923;3541000;0
29551;86394;518;100;33;1;32;.970;3600000;0
29551;152494;518;0;0;0;0;.00nan;0;0
29551;159851;1472;0;0;0;0;.00nan;0;0
29552;13613;513;0;0;0;0;.00nan;0;0
29552;179830;1876;0;0;0;0;.00nan;0;0
29552;63107;1876;93;36;2;34;.944;3600000;0
29552;143421;513;85;30;1;29;.967;3600000;0
29553;8426;2193;82;33;2;31;.939;3600000;0
29553;76951;2193;0;0;0;0;.00nan;0;0
29553;84287;516;0;0;0;0;.00nan;0;0
29553;143330;516;53;20;3;17;.850;3553000;0
29554;14047;511;57;22;4;18;.818;3900000;0
29554;62287;517;0;0;0;0;.00nan;0;0
29554;64271;511;0;0;0;0;.00nan;0;0
29554;152202;517;74;48;4;44;.917;3900000;0
29555;4618;512;68;40;5;35;.875;3600000;0
29555;64800;515;0;0;0;0;.00nan;0;0
29555;143156;515;88;25;1;24;.960;3600000;0
29555;155465;512;0;0;0;0;.00nan;0;0
29556;141978;514;57;30;4;26;.867;3582000;0
29556;143019;514;0;0;0;0;.00nan;0;0
29556;143191;520;79;42;3;39;.929;3600000;0
29556;152478;520;0;0;0;0;.00nan;0;0
29557;38276;1872;0;0;0;0;.00nan;0;0
29557;68425;519;0;0;0;0;.00nan;0;0
29557;91202;1872;82;23;1;22;.957;3900000;0
29557;143307;519;89;32;1;31;.969;3900000;0
29559;13613;518;98;66;2;64;.970;3600000;0
29559;174581;518;0;0;0;0;.00nan;0;0
29559;63107;514;72;15;1;14;.933;3600000;0
29559;143256;514;0;0;0;0;.00nan;0;0
29561;68425;519;0;0;0;0;.00nan;0;0
29561;84287;516;84;32;3;29;.906;3834000;0
29561;143100;516;0;0;0;0;.00nan;0;0
29561;143307;519;65;39;4;35;.897;3834000;0
29563;142929;1872;75;34;3;31;.912;3563000;0
29563;143330;515;67;24;2;22;.917;3600000;0
29563;143507;515;0;0;0;0;.00nan;0;0
29563;151590;1872;0;0;0;0;.00nan;0;0
29565;8426;2193;0;0;0;0;.00nan;0;0
29565;62287;517;0;0;0;0;.00nan;0;0
29565;76951;2193;61;32;3;29;.906;3581000;0
29565;152202;517;91;34;1;33;.971;3600000;0
29567;62279;1472;100;40;2;38;.950;3900000;0
29567;143083;513;75;31;2;29;.935;3900000;0
29567;143421;513;0;0;0;0;.00nan;0;0
29567;159851;1472;0;0;0;0;.00nan;0;0
29569;177519;512;74;20;1;19;.950;3545000;0
29569;179830;1876;93;27;0;27;1.000;3600000;0
29569;-1;1876;0;0;0;0;.00nan;0;0
29569;143191;512;0;0;0;0;.00nan;0;0
29571;4618;520;0;0;0;0;.00nan;0;0
29571;14047;511;58;34;4;30;.882;3551000;0
29571;63848;511;0;0;0;0;.00nan;0;0
29571;152478;520;67;32;3;29;.906;3600000;0
29573;177519;512;0;0;0;0;.00nan;0;0
29573;63107;514;91;41;2;39;.951;3900000;0
29573;143191;512;87;37;2;35;.946;3900000;0
29573;143256;514;0;0;0;0;.00nan;0;0
29575;62287;517;74;42;3;39;.929;3600000;0
29575;143330;515;81;25;1;24;.960;3600000;0
29575;143507;515;0;0;0;0;.00nan;0;0
29575;152202;517;0;0;0;0;.00nan;0;0
29577;8426;2193;63;29;3;26;.897;3600000;0
29577;76951;2193;0;0;0;0;.00nan;0;0
29577;84287;516;29;9;3;6;.667;574000;0
29577;143100;516;93;33;1;32;.970;3026000;0
29579;68425;519;0;0;0;0;.00nan;0;0
29579;142929;1872;0;0;0;0;.00nan;0;0
29579;143307;519;99;27;0;27;1.000;3600000;0
29579;151590;1872;55;29;4;25;.862;3600000;0
29581;179830;1876;64;26;2;24;.923;3900000;0
29581;-1;1876;0;0;0;0;.00nan;0;0
29581;62279;1472;78;32;2;30;.938;3900000;0
29581;159851;1472;0;0;0;0;.00nan;0;0
29583;4618;520;0;0;0;0;.00nan;0;0
29583;13613;518;38;20;4;16;.800;3562000;0
29583;174581;518;0;0;0;0;.00nan;0;0
29583;152478;520;74;30;2;28;.933;3600000;0
29585;14047;511;53;32;4;28;.875;3600000;0
29585;63848;511;0;0;0;0;.00nan;0;0
29585;143083;513;0;0;0;0;.00nan;0;0
29585;143421;513;69;30;3;27;.900;3600000;0
29587;177519;512;87;30;2;28;.933;3600000;0
29587;179830;1876;0;0;0;0;.00nan;0;0
29587;-1;1876;59;25;3;22;.880;3557000;0
29587;143191;512;0;0;0;0;.00nan;0;0
29589;84287;516;66;21;1;20;.952;3600000;0
29589;142929;1872;72;30;2;28;.933;3563000;0
29589;143100;516;0;0;0;0;.00nan;0;0
29589;151590;1872;0;0;0;0;.00nan;0;0
29591;62279;1472;0;0;0;0;.00nan;0;0
29591;143330;515;0;0;0;0;.00nan;0;0
29591;143507;515;94;16;0;16;1.000;3600000;0
29591;159851;1472;69;25;1;24;.960;3584000;0
29593;8426;2193;0;0;0;0;.00nan;0;0
29593;63107;514;0;0;0;0;.00nan;0;0
29593;76951;2193;60;41;4;37;.902;3600000;0
29593;143256;514;76;25;1;24;.960;3600000;0
29595;4618;520;93;33;2;31;.939;3900000;0
29595;14047;511;0;0;0;0;.00nan;0;0
29595;63848;511;75;29;2;27;.931;3900000;0
29595;152478;520;0;0;0;0;.00nan;0;0
29597;13613;518;0;0;0;0;.00nan;0;0
29597;174581;518;66;33;3;30;.909;3580000;0
29597;62287;517;0;0;0;0;.00nan;0;0
29597;152202;517;61;22;2;20;.909;3600000;0
29599;68425;519;0;0;0;0;.00nan;0;0
29599;143083;513;69;25;2;23;.920;3548000;0
29599;143307;519;90;33;1;32;.970;3600000;0
29599;143421;513;0;0;0;0;.00nan;0;0
29601;84287;516;0;0;0;0;.00nan;0;0
29601;142929;1872;0;0;0;0;.00nan;0;0
29601;143100;516;95;23;0;23;1.000;3600000;0
29601;151590;1872;56;35;5;30;.857;3600000;0
29603;68425;519;59;20;2;18;.900;3600000;0
29603;143083;513;0;0;0;0;.00nan;0;0
29603;143307;519;0;0;0;0;.00nan;0;0
29603;143421;513;72;33;3;30;.909;3600000;0
29605;179830;1876;19;9;4;5;.556;728000;0
29605;-1;1876;52;31;4;27;.871;2872000;0
29605;62279;1472;72;28;2;26;.929;3600000;0
29605;159851;1472;0;0;0;0;.00nan;0;0
29607;8426;2193;0;0;0;0;.00nan;0;0
29607;62287;517;73;31;3;28;.903;3518000;0
29607;76951;2193;72;23;1;22;.957;3600000;0
29607;152202;517;0;0;0;0;.00nan;0;0
29609;13613;518;89;27;1;26;.963;3600000;0
29609;174581;518;0;0;0;0;.00nan;0;0
29609;63107;514;28;26;6;20;.769;3600000;0
29609;143256;514;0;0;0;0;.00nan;0;0
29611;4618;520;0;0;0;0;.00nan;0;0
29611;177519;512;0;0;0;0;.00nan;0;0
29611;143191;512;41;20;4;16;.800;3600000;0
29611;152478;520;83;27;1;26;.963;3600000;0
29613;14047;511;82;41;3;38;.927;3693000;0
29613;63848;511;0;0;0;0;.00nan;0;0
29613;143330;515;0;0;0;0;.00nan;0;0
29613;143507;515;64;40;4;36;.900;3705000;0
29615;13613;518;0;0;0;0;.00nan;0;0
29615;174581;518;94;41;2;39;.951;3600000;0
29615;143083;513;61;25;3;22;.880;3600000;0
29615;143421;513;0;0;0;0;.00nan;0;0
29617;4618;520;82;16;0;16;1.000;3600000;0
29617;68425;519;0;0;0;0;.00nan;0;0
29617;143307;519;73;27;1;26;.963;3561000;0
29617;152478;520;0;0;0;0;.00nan;0;0
29619;179830;1876;84;29;2;27;.931;3600000;0
29619;-1;1876;0;0;0;0;.00nan;0;0
29619;84287;516;0;0;0;0;.00nan;0;0
29619;143100;516;70;30;3;27;.900;3544000;0
29621;177519;512;86;28;2;26;.929;3600000;0
29621;62279;1472;0;0;0;0;.00nan;0;0
29621;143191;512;0;0;0;0;.00nan;0;0
29621;159851;1472;95;33;1;32;.970;3600000;0
29623;8426;2193;71;19;1;18;.947;3600000;0
29623;76951;2193;0;0;0;0;.00nan;0;0
29623;142929;1872;89;37;2;35;.946;3600000;0
29623;151590;1872;0;0;0;0;.00nan;0;0
29625;14047;511;71;36;3;33;.917;3600000;0
29625;62287;517;0;0;0;0;.00nan;0;0
29625;63848;511;0;0;0;0;.00nan;0;0
29625;152202;517;99;24;0;24;1.000;3600000;0
29627;63107;514;0;0;0;0;.00nan;0;0
29627;143256;514;86;28;1;27;.964;3600000;0
29627;143330;515;44;23;4;19;.826;3600000;0
29627;143507;515;0;0;0;0;.00nan;0;0
29629;4618;520;85;16;0;16;1.000;3600000;0
29629;62287;517;0;0;0;0;.00nan;0;0
29629;152202;517;80;44;3;41;.932;3600000;0
29629;152478;520;0;0;0;0;.00nan;0;0
29631;8426;2193;0;0;0;0;.00nan;0;0
29631;179830;1876;78;46;5;41;.891;3600000;0
29631;-1;1876;0;0;0;0;.00nan;0;0
29631;76951;2193;76;28;2;26;.929;3600000;0
29633;177519;512;0;0;0;0;.00nan;0;0
29633;68425;519;32;25;5;20;.800;1927000;0
29633;143191;512;99;27;0;27;1.000;3600000;0
29633;143307;519;68;12;0;12;1.000;1673000;0
29635;63107;514;68;25;2;23;.920;3600000;0
29635;143256;514;0;0;0;0;.00nan;0;0
29635;143330;515;76;24;1;23;.958;3600000;0
29635;143507;515;0;0;0;0;.00nan;0;0
29637;13613;518;52;17;2;15;.882;3551000;0
29637;14047;511;93;33;1;32;.970;3600000;0
29637;174581;518;0;0;0;0;.00nan;0;0
29637;63848;511;0;0;0;0;.00nan;0;0
29639;84287;516;53;21;3;18;.857;3533000;0
29639;142929;1872;74;23;1;22;.957;3600000;0
29639;143100;516;0;0;0;0;.00nan;0;0
29639;151590;1872;0;0;0;0;.00nan;0;0
29641;62279;1472;92;31;1;30;.968;3600000;0
29641;143083;513;0;0;0;0;.00nan;0;0
29641;143421;513;89;47;3;44;.936;3580000;0
29641;159851;1472;0;0;0;0;.00nan;0;0
29645;62279;1472;0;0;0;0;.00nan;0;0
29645;143083;513;94;40;3;37;.925;3900000;0
29645;143421;513;0;0;0;0;.00nan;0;0
29645;159851;1472;61;25;3;22;.880;3900000;0
29647;68425;519;63;34;3;31;.912;3600000;0
29647;142929;1872;0;0;0;0;.00nan;0;0
29647;143307;519;0;0;0;0;.00nan;0;0
29647;151590;1872;70;21;1;20;.952;3600000;0
29649;8426;2193;71;27;2;25;.926;3600000;0
29649;179830;1876;0;0;0;0;.00nan;0;0
29649;-1;1876;59;25;3;22;.880;3575000;0
29649;76951;2193;0;0;0;0;.00nan;0;0
29651;4618;520;0;0;0;0;.00nan;0;0
29651;84287;516;0;0;0;0;.00nan;0;0
29651;143100;516;74;23;1;22;.957;3600000;0
29651;152478;520;71;32;4;28;.875;3600000;0
1035;4618;512;42;22;4;18;.818;3600000;0
1035;62287;517;0;0;0;0;.00nan;0;0
1035;152202;517;64;37;5;32;.865;3557000;0
1035;155465;512;0;0;0;0;.00nan;0;0
1036;14047;511;64;18;1;17;.944;3600000;0
1036;38276;1872;68;9;0;9;1.000;1292000;0
1036;64271;511;0;0;0;0;.00nan;0;0
1036;91202;1872;50;33;4;29;.879;2308000;0
1037;62279;1472;89;33;1;32;.970;3791000;0
1037;68425;519;0;0;0;0;.00nan;0;0
1037;143307;519;94;39;2;37;.949;3791000;0
1037;159851;1472;0;0;0;0;.00nan;0;0
1038;86394;518;98;40;1;39;.975;3560000;0
1038;143191;520;90;10;0;10;1.000;3600000;0
1038;152478;520;0;0;0;0;.00nan;0;0
1038;152494;518;0;0;0;0;.00nan;0;0
1039;4618;512;46;26;4;22;.846;4199000;0
1039;62287;517;0;0;0;0;.00nan;0;0
1039;152202;517;54;44;5;39;.886;4199000;0
1039;155465;512;0;0;0;0;.00nan;0;0
1040;14047;511;93;57;4;53;.930;5880000;0
1040;38276;1872;0;0;0;0;.00nan;0;0
1040;64271;511;0;0;0;0;.00nan;0;0
1040;91202;1872;93;56;3;53;.946;5880000;0
1041;62279;1472;37;26;5;21;.808;3600000;0
1041;68425;519;0;0;0;0;.00nan;0;0
1041;143307;519;53;25;3;22;.880;3600000;0
1041;159851;1472;0;0;0;0;.00nan;0;0
1042;86394;518;70;29;3;26;.897;3618000;0
1042;143191;520;82;32;2;30;.938;3618000;0
1042;152478;520;0;0;0;0;.00nan;0;0
1042;152494;518;0;0;0;0;.00nan;0;0
1043;4618;512;51;22;3;19;.864;3600000;0
1043;62287;517;0;0;0;0;.00nan;0;0
1043;152202;517;49;33;5;28;.848;3582000;0
1043;155465;512;0;0;0;0;.00nan;0;0
1044;14047;511;94;42;1;41;.976;7058000;0
1044;38276;1872;0;0;0;0;.00nan;0;0
1044;64271;511;0;0;0;0;.00nan;0;0
1044;91202;1872;100;63;0;63;1.000;7058000;0
1045;62279;1472;72;25;2;23;.920;3600000;0
1045;68425;519;0;0;0;0;.00nan;0;0
1045;143307;519;70;35;3;32;.914;3585000;0
1045;159851;1472;0;0;0;0;.00nan;0;0
1046;86394;518;45;30;5;25;.833;3600000;0
1046;143191;520;82;31;2;29;.935;3600000;0
1046;152478;520;0;0;0;0;.00nan;0;0
1046;152494;518;0;0;0;0;.00nan;0;0
1210;14047;511;93;30;1;29;.967;3600000;0
1210;38276;1872;0;0;0;0;.00nan;0;0
1210;64271;511;0;0;0;0;.00nan;0;0
1210;91202;1872;89;38;2;36;.947;3600000;0
1211;62279;1472;83;40;2;38;.950;3600000;0
1211;68425;519;0;0;0;0;.00nan;0;0
1211;143307;519;36;23;4;19;.826;3518000;0
1211;159851;1472;0;0;0;0;.00nan;0;0
1323;14047;511;55;22;3;19;.864;3545000;0
1323;38276;1872;0;0;0;0;.00nan;0;0
1323;64271;511;0;0;0;0;.00nan;0;0
1323;91202;1872;100;42;2;40;.952;3600000;0
1392;38276;1872;0;0;0;0;.00nan;0;0
1392;84287;516;0;0;0;0;.00nan;0;0
1392;91202;1872;100;32;0;32;1.000;3600000;0
1392;143330;516;87;30;1;29;.967;3545000;0
1393;141978;514;84;27;1;26;.963;3739000;0
1393;143019;514;0;0;0;0;.00nan;0;0
1393;143191;520;70;26;2;24;.923;3739000;0
1393;152478;520;0;0;0;0;.00nan;0;0
1394;4618;512;70;28;2;26;.929;3600000;0
1394;13613;513;57;38;5;33;.868;3600000;0
1394;143421;513;0;0;0;0;.00nan;0;0
1394;155465;512;0;0;0;0;.00nan;0;0
1395;62279;1472;69;39;4;35;.897;3600000;0
1395;64800;515;0;0;0;0;.00nan;0;0
1395;143156;515;71;14;1;13;.929;3600000;0
1395;159851;1472;0;0;0;0;.00nan;0;0
1396;38276;1872;0;0;0;0;.00nan;0;0
1396;84287;516;0;0;0;0;.00nan;0;0
1396;91202;1872;42;35;6;29;.829;3600000;0
1396;143330;516;100;25;0;25;1.000;3600000;0
1397;141978;514;70;42;5;37;.881;3600000;0
1397;143019;514;0;0;0;0;.00nan;0;0
1397;143191;520;53;26;4;22;.846;3600000;0
1397;152478;520;0;0;0;0;.00nan;0;0
1398;4618;512;38;31;5;26;.839;1889000;0
1398;13613;513;63;37;4;33;.892;3600000;0
1398;143421;513;0;0;0;0;.00nan;0;0
1398;155465;512;49;9;1;8;.889;1687000;0
1399;62279;1472;100;49;1;48;.980;4484000;0
1399;64800;515;0;0;0;0;.00nan;0;0
1399;143156;515;67;26;2;24;.923;4484000;0
1399;159851;1472;0;0;0;0;.00nan;0;0
1400;38276;1872;0;0;0;0;.00nan;0;0
1400;84287;516;0;0;0;0;.00nan;0;0
1400;91202;1872;98;47;3;44;.936;3600000;0
1400;143330;516;73;15;1;14;.933;3600000;0
1401;141978;514;69;22;2;20;.909;3695000;0
1401;143019;514;0;0;0;0;.00nan;0;0
1401;143191;520;87;28;1;27;.964;3695000;0
1401;152478;520;0;0;0;0;.00nan;0;0
1402;4618;512;57;18;2;16;.889;3600000;0
1402;13613;513;66;40;3;37;.925;3585000;0
1402;143421;513;0;0;0;0;.00nan;0;0
1402;155465;512;0;0;0;0;.00nan;0;0
1403;62279;1472;63;28;3;25;.893;3582000;0
1403;64800;515;0;0;0;0;.00nan;0;0
1403;143156;515;76;23;1;22;.957;3600000;0
1403;159851;1472;0;0;0;0;.00nan;0;0
1404;38276;1872;61;18;1;17;.944;1551000;0
1404;84287;516;0;0;0;0;.00nan;0;0
1404;91202;1872;38;23;4;19;.826;2049000;0
1404;143330;516;70;7;0;7;1.000;3600000;0
1405;141978;514;85;27;1;26;.963;3959000;0
1405;143019;514;0;0;0;0;.00nan;0;0
1405;143191;520;90;43;2;41;.953;3959000;0
1405;152478;520;0;0;0;0;.00nan;0;0
1406;4618;512;64;35;4;31;.886;3574000;0
1406;13613;513;71;32;3;29;.906;3600000;0
1406;143421;513;0;0;0;0;.00nan;0;0
1406;155465;512;0;0;0;0;.00nan;0;0
1407;62279;1472;72;39;3;36;.923;3600000;0
1407;64800;515;0;0;0;0;.00nan;0;0
1407;143156;515;100;27;0;27;1.000;3600000;0
1407;159851;1472;0;0;0;0;.00nan;0;0
1626;38276;1872;0;0;0;0;.00nan;0;0
1626;84287;516;0;0;0;0;.00nan;0;0
1626;91202;1872;87;33;2;31;.939;3679000;0
1626;143330;516;78;36;3;33;.917;3679000;0
1627;141978;514;45;30;5;25;.833;3600000;0
1627;143019;514;0;0;0;0;.00nan;0;0
1627;143191;520;19;22;6;16;.727;1900000;0
1627;152478;520;49;17;2;15;.882;1700000;0
1628;4618;512;56;30;3;27;.900;3553000;0
1628;13613;513;80;31;2;29;.935;3600000;0
1628;143421;513;0;0;0;0;.00nan;0;0
1628;155465;512;0;0;0;0;.00nan;0;0
1629;62279;1472;75;49;5;44;.898;3600000;0
1629;64800;515;0;0;0;0;.00nan;0;0
1629;143156;515;71;22;1;21;.955;3600000;0
1629;159851;1472;0;0;0;0;.00nan;0;0
1699;38276;1872;0;0;0;0;.00nan;0;0
1699;84287;516;0;0;0;0;.00nan;0;0
1699;91202;1872;85;48;4;44;.917;4521000;0
1699;143330;516;68;36;3;33;.917;4521000;0
1700;141978;514;34;25;5;20;.800;3600000;0
1700;143019;514;0;0;0;0;.00nan;0;0
1700;143191;520;0;0;0;0;.00nan;0;0
1700;152478;520;69;26;2;24;.923;3600000;0
1701;4618;512;66;40;4;36;.900;3600000;0
1701;13613;513;100;40;1;39;.975;3600000;0
1701;143421;513;0;0;0;0;.00nan;0;0
1701;155465;512;0;0;0;0;.00nan;0;0
1829;141978;514;79;28;1;27;.964;3948000;0
1829;143019;514;0;0;0;0;.00nan;0;0
1829;143191;520;0;0;0;0;.00nan;0;0
1829;152478;520;66;23;2;21;.913;3948000;0
1863;13613;513;83;32;1;31;.969;3572000;0
1863;84287;516;0;0;0;0;.00nan;0;0
1863;143330;516;100;38;0;38;1.000;3600000;0
1863;143421;513;0;0;0;0;.00nan;0;0
1864;64800;515;0;0;0;0;.00nan;0;0
1864;141978;514;62;29;3;26;.897;3600000;0
1864;143019;514;0;0;0;0;.00nan;0;0
1864;143156;515;43;30;5;25;.833;3568000;0
1865;13613;513;100;29;0;29;1.000;3600000;0
1865;84287;516;0;0;0;0;.00nan;0;0
1865;143330;516;86;28;1;27;.964;3600000;0
1865;143421;513;0;0;0;0;.00nan;0;0
1866;64800;515;0;0;0;0;.00nan;0;0
1866;141978;514;100;33;0;33;1.000;3600000;0
1866;143019;514;0;0;0;0;.00nan;0;0
1866;143156;515;48;20;3;17;.850;3600000;0
1867;13613;513;35;33;6;27;.818;3600000;0
1867;84287;516;0;0;0;0;.00nan;0;0
1867;143330;516;89;31;2;29;.935;3600000;0
1867;143421;513;0;0;0;0;.00nan;0;0
1868;64800;515;0;0;0;0;.00nan;0;0
1868;141978;514;60;25;2;23;.920;3600000;0
1868;143019;514;0;0;0;0;.00nan;0;0
1868;143156;515;99;46;1;45;.978;3600000;0
1869;13613;513;83;38;3;35;.921;3585000;0
1869;84287;516;0;0;0;0;.00nan;0;0
1869;143330;516;86;30;2;28;.933;3600000;0
1869;143421;513;0;0;0;0;.00nan;0;0
1870;64800;515;0;0;0;0;.00nan;0;0
1870;141978;514;96;30;1;29;.967;3600000;0
1870;143019;514;0;0;0;0;.00nan;0;0
1870;143156;515;74;25;2;23;.920;3563000;0
2040;13613;513;77;34;2;32;.941;3535000;0
2040;84287;516;0;0;0;0;.00nan;0;0
2040;143330;516;89;19;0;19;1.000;3600000;0
2040;143421;513;0;0;0;0;.00nan;0;0
2041;64800;515;0;0;0;0;.00nan;0;0
2041;141978;514;57;18;2;16;.889;3548000;0
2041;143019;514;0;0;0;0;.00nan;0;0
2041;143156;515;100;38;1;37;.974;3600000;0
2126;64800;515;0;0;0;0;.00nan;0;0
2126;141978;514;72;33;3;30;.909;3590000;0
2126;143019;514;0;0;0;0;.00nan;0;0
2126;143156;515;76;27;2;25;.926;3600000;0
2151;64800;515;0;0;0;0;.00nan;0;0
2151;141978;514;75;30;3;27;.900;3600000;0
2151;143019;514;0;0;0;0;.00nan;0;0
2151;143156;515;100;30;0;30;1.000;3600000;0
2185;64800;515;0;0;0;0;.00nan;0;0
2185;84287;516;0;0;0;0;.00nan;0;0
2185;143156;515;63;25;2;23;.920;3548000;0
2185;143330;516;89;18;0;18;1.000;3600000;0
2186;64800;515;0;0;0;0;.00nan;0;0
2186;84287;516;56;12;1;11;.917;1429000;0
2186;143156;515;77;23;2;21;.913;3600000;0
2186;143330;516;31;21;5;16;.762;2171000;0
2187;64800;515;0;0;0;0;.00nan;0;0
2187;84287;516;0;0;0;0;.00nan;0;0
2187;143156;515;82;31;2;29;.935;3574000;0
2187;143330;516;99;32;1;31;.969;3600000;0
2188;64800;515;0;0;0;0;.00nan;0;0
2188;84287;516;0;0;0;0;.00nan;0;0
2188;143156;515;75;28;2;26;.929;3635000;0
2188;143330;516;69;32;3;29;.906;3635000;0
2428;64800;515;0;0;0;0;.00nan;0;0
2428;84287;516;0;0;0;0;.00nan;0;0
2428;143156;515;75;20;1;19;.950;3600000;0
2428;143330;516;44;27;5;22;.815;3600000;0
2458;64800;515;0;0;0;0;.00nan;0;0
2458;84287;516;0;0;0;0;.00nan;0;0
2458;143156;515;72;25;2;23;.920;3600000;0
2458;143330;516;58;24;3;21;.875;3600000;0
29656;186641;625;62;25;3;22;.880;3600000;0
29656;65823;627;62;46;5;41;.891;3600000;0
29656;85468;627;0;0;0;0;.00nan;0;0
29656;145038;625;0;0;0;0;.00nan;0;0
29657;1838;628;87;20;0;20;1.000;3600000;0
29657;22684;632;0;0;0;0;.00nan;0;0
29657;197595;632;96;36;1;35;.972;3550000;0
29657;161336;628;0;0;0;0;.00nan;0;0
29658;168651;651;72;52;6;46;.885;3600000;0
29658;174209;631;0;0;0;0;.00nan;0;0
29658;195761;651;0;0;0;0;.00nan;0;0
29658;144705;631;100;30;0;30;1.000;3600000;0
29659;193854;1836;69;28;3;25;.893;3600000;0
29659;190508;626;41;31;6;25;.806;2879000;0
29659;-1;1836;0;0;0;0;.00nan;0;0
29659;145079;626;55;5;0;5;1.000;721000;0
29660;-1;642;86;27;0;27;1.000;2812000;0
29660;181431;636;49;28;4;24;.857;3900000;0
29660;38277;636;0;0;0;0;.00nan;0;0
29660;151728;642;24;10;4;6;.600;1088000;0
29661;-1;637;0;0;0;0;.00nan;0;0
29661;67362;1814;82;24;1;23;.958;3600000;0
29661;73274;637;79;37;3;34;.919;3560000;0
29661;156632;1814;0;0;0;0;.00nan;0;0
29662;192739;639;0;0;0;0;.00nan;0;0
29662;11068;641;69;37;3;34;.919;3558000;0
29662;-1;641;0;0;0;0;.00nan;0;0
29662;149969;639;80;33;2;31;.939;3600000;0
29663;186641;625;66;17;1;16;.941;3600000;0
29663;-1;637;0;0;0;0;.00nan;0;0
29663;73274;637;75;39;3;36;.923;3600000;0
29663;145038;625;0;0;0;0;.00nan;0;0
29664;193854;1836;60;32;3;29;.906;3543000;0
29664;168651;651;93;44;2;42;.955;3600000;0
29664;195761;651;0;0;0;0;.00nan;0;0
29664;-1;1836;0;0;0;0;.00nan;0;0
29665;11068;641;85;58;6;52;.897;3600000;0
29665;190508;626;76;26;2;24;.923;3600000;0
29665;-1;641;0;0;0;0;.00nan;0;0
29665;145079;626;0;0;0;0;.00nan;0;0
29666;22684;632;59;9;0;9;1.000;768000;0
29666;197595;632;32;33;6;27;.818;2832000;0
29666;65823;627;0;0;0;0;.00nan;0;0
29666;85468;627;58;24;2;22;.917;3600000;0
29667;174209;631;0;0;0;0;.00nan;0;0
29667;67362;1814;100;30;0;30;1.000;3600000;0
29667;144705;631;50;25;4;21;.840;3600000;0
29667;156632;1814;0;0;0;0;.00nan;0;0
29668;1838;628;62;19;2;17;.895;3600000;0
29668;-1;642;0;0;0;0;.00nan;0;0
29668;151728;642;83;44;3;41;.932;3554000;0
29668;161336;628;0;0;0;0;.00nan;0;0
29669;192739;639;0;0;0;0;.00nan;0;0
29669;181431;636;66;19;1;18;.947;3600000;0
29669;38277;636;0;0;0;0;.00nan;0;0
29669;149969;639;61;36;5;31;.861;3600000;0
29670;11068;641;79;32;3;29;.906;3544000;0
29670;168651;651;65;24;2;22;.917;3600000;0
29670;195761;651;0;0;0;0;.00nan;0;0
29670;-1;641;0;0;0;0;.00nan;0;0
29671;174209;631;0;0;0;0;.00nan;0;0
29671;-1;637;0;0;0;0;.00nan;0;0
29671;73274;637;73;27;2;25;.926;3600000;0
29671;144705;631;30;36;7;29;.806;3600000;0
29672;193854;1836;100;33;0;33;1.000;3600000;0
29672;22684;632;0;0;0;0;.00nan;0;0
29672;-1;1836;0;0;0;0;.00nan;0;0
29672;197595;632;72;28;2;26;.929;3533000;0
29673;1838;628;61;28;3;25;.893;3900000;0
29673;67362;1814;87;38;3;35;.921;3900000;0
29673;156632;1814;0;0;0;0;.00nan;0;0
29673;161336;628;0;0;0;0;.00nan;0;0
29674;192739;639;0;0;0;0;.00nan;0;0
29674;190508;626;86;29;1;28;.966;3588000;0
29674;145079;626;0;0;0;0;.00nan;0;0
29674;149969;639;100;32;0;32;1.000;3600000;0
29675;-1;642;0;0;0;0;.00nan;0;0
29675;186641;625;81;24;2;22;.917;3600000;0
29675;145038;625;0;0;0;0;.00nan;0;0
29675;151728;642;71;32;4;28;.875;3600000;0
29676;181431;636;89;45;3;42;.933;3900000;0
29676;38277;636;0;0;0;0;.00nan;0;0
29676;65823;627;0;0;0;0;.00nan;0;0
29676;85468;627;71;35;3;32;.914;3900000;0
29677;22684;632;55;35;5;30;.857;3600000;0
29677;-1;637;0;0;0;0;.00nan;0;0
29677;197595;632;0;0;0;0;.00nan;0;0
29677;73274;637;71;30;2;28;.933;3600000;0
29678;193854;1836;55;17;2;15;.882;3600000;0
29678;181431;636;22;24;6;18;.750;3223000;0
29678;38277;636;58;5;0;5;1.000;377000;0
29678;-1;1836;0;0;0;0;.00nan;0;0
29679;11068;641;0;0;0;0;.00nan;0;0
29679;-1;641;99;55;2;53;.964;3600000;0
29679;186641;625;51;27;4;23;.852;3600000;0
29679;145038;625;0;0;0;0;.00nan;0;0
29680;1838;628;86;27;1;26;.963;3600000;0
29680;174209;631;79;36;3;33;.917;3515000;0
29680;144705;631;0;0;0;0;.00nan;0;0
29680;161336;628;0;0;0;0;.00nan;0;0
29681;176963;627;67;31;3;28;.903;3600000;0
29681;-1;642;0;0;0;0;.00nan;0;0
29681;85468;627;0;0;0;0;.00nan;0;0
29681;151728;642;62;40;5;35;.875;3541000;0
29682;190508;626;90;35;2;33;.943;3600000;0
29682;67362;1814;0;0;0;0;.00nan;0;0
29682;145079;626;0;0;0;0;.00nan;0;0
29682;156632;1814;46;40;6;34;.850;3600000;0
29683;192739;639;0;0;0;0;.00nan;0;0
29683;168651;651;68;30;3;27;.900;3600000;0
29683;195761;651;0;0;0;0;.00nan;0;0
29683;149969;639;100;44;1;43;.977;3600000;0
29684;168651;651;38;27;5;22;.815;2187000;0
29684;195761;651;50;21;3;18;.857;1413000;0
29684;-1;637;0;0;0;0;.00nan;0;0
29684;73274;637;95;23;0;23;1.000;3600000;0
29685;174209;631;0;0;0;0;.00nan;0;0
29685;-1;642;0;0;0;0;.00nan;0;0
29685;144705;631;51;29;3;26;.897;3572000;0
29685;151728;642;84;37;2;35;.946;3600000;0
29686;193854;1836;100;51;2;49;.961;3900000;0
29686;176963;627;69;33;2;31;.939;3900000;0
29686;-1;1836;0;0;0;0;.00nan;0;0
29686;85468;627;0;0;0;0;.00nan;0;0
29687;1838;628;72;28;2;26;.929;3600000;0
29687;190508;626;71;38;3;35;.921;3543000;0
29687;145079;626;0;0;0;0;.00nan;0;0
29687;161336;628;0;0;0;0;.00nan;0;0
29688;11068;641;98;49;0;49;1.000;3900000;0
29688;181431;636;0;0;0;0;.00nan;0;0
29688;38277;636;100;29;0;29;1.000;3900000;0
29688;-1;641;0;0;0;0;.00nan;0;0
29689;22684;632;0;0;0;0;.00nan;0;0
29689;197595;632;60;38;5;33;.868;3600000;0
29689;67362;1814;75;23;2;21;.913;3600000;0
29689;156632;1814;0;0;0;0;.00nan;0;0
29690;192739;639;95;31;1;30;.968;3600000;0
29690;186641;625;72;41;4;37;.902;3600000;0
29690;145038;625;0;0;0;0;.00nan;0;0
29690;149969;639;0;0;0;0;.00nan;0;0
29691;-1;642;0;0;0;0;.00nan;0;0
29691;-1;637;0;0;0;0;.00nan;0;0
29691;73274;637;74;24;1;23;.958;3600000;0
29691;151728;642;69;31;3;28;.903;3543000;0
29692;192739;639;0;0;0;0;.00nan;0;0
29692;193854;1836;64;22;1;21;.955;3900000;0
29692;-1;1836;0;0;0;0;.00nan;0;0
29692;149969;639;91;42;1;41;.976;3900000;0
29693;11068;641;35;13;3;10;.769;524000;0
29693;-1;641;72;30;2;28;.933;3076000;0
29693;67362;1814;100;28;0;28;1.000;3600000;0
29693;156632;1814;0;0;0;0;.00nan;0;0
29694;22684;632;83;44;4;40;.909;3600000;0
29694;181431;636;0;0;0;0;.00nan;0;0
29694;38277;636;65;16;1;15;.938;3600000;0
29694;197595;632;0;0;0;0;.00nan;0;0
29695;1838;628;0;0;0;0;.00nan;0;0
29695;176963;627;50;30;4;26;.867;3523000;0
29695;85468;627;0;0;0;0;.00nan;0;0
29695;161336;628;66;28;2;26;.929;3600000;0
29696;174209;631;0;0;0;0;.00nan;0;0
29696;190508;626;50;1;0;1;1.000;462000;0
29696;144705;631;78;29;2;27;.931;3600000;0
29696;145079;626;47;28;4;24;.857;3099000;0
29697;168651;651;41;38;6;32;.842;3600000;0
29697;195761;651;0;0;0;0;.00nan;0;0
29697;186641;625;0;0;0;0;.00nan;0;0
29697;145038;625;57;14;1;13;.929;3600000;0
29698;192739;639;0;0;0;0;.00nan;0;0
29698;-1;637;0;0;0;0;.00nan;0;0
29698;73274;637;78;25;1;24;.960;3600000;0
29698;149969;639;93;40;2;38;.950;3544000;0
29699;1838;628;53;30;4;26;.867;3519000;0
29699;11068;641;0;0;0;0;.00nan;0;0
29699;-1;641;99;58;2;56;.966;3600000;0
29699;161336;628;0;0;0;0;.00nan;0;0
29700;176963;627;99;25;0;25;1.000;3600000;0
29700;190508;626;70;43;5;38;.884;3600000;0
29700;85468;627;0;0;0;0;.00nan;0;0
29700;145079;626;0;0;0;0;.00nan;0;0
29701;168651;651;62;41;4;37;.902;3600000;0
29701;195761;651;0;0;0;0;.00nan;0;0
29701;67362;1814;75;28;2;26;.929;3600000;0
29701;156632;1814;0;0;0;0;.00nan;0;0
29702;22684;632;84;42;3;39;.929;3565000;0
29702;174209;631;0;0;0;0;.00nan;0;0
29702;197595;632;0;0;0;0;.00nan;0;0
29702;144705;631;78;21;1;20;.952;3600000;0
29703;193854;1836;63;23;2;21;.913;3544000;0
29703;-1;642;0;0;0;0;.00nan;0;0
29703;-1;1836;0;0;0;0;.00nan;0;0
29703;151728;642;100;57;1;56;.982;3600000;0
29704;181431;636;61;27;3;24;.889;3600000;0
29704;38277;636;0;0;0;0;.00nan;0;0
29704;186641;625;66;37;4;33;.892;3565000;0
29704;145038;625;0;0;0;0;.00nan;0;0
29705;174209;631;77;26;1;25;.962;3900000;0
29705;186641;625;92;29;1;28;.966;3900000;0
29705;144705;631;0;0;0;0;.00nan;0;0
29705;145038;625;0;0;0;0;.00nan;0;0
29706;11068;641;0;0;0;0;.00nan;0;0
29706;193854;1836;0;0;0;0;.00nan;0;0
29706;-1;641;93;41;1;40;.976;3600000;0
29706;-1;1836;53;26;3;23;.885;3530000;0
29707;168651;651;60;37;4;33;.892;3583000;0
29707;195761;651;0;0;0;0;.00nan;0;0
29707;176963;627;59;16;2;14;.875;3600000;0
29707;85468;627;0;0;0;0;.00nan;0;0
29708;190508;626;38;31;6;25;.806;3537000;0
29708;-1;637;0;0;0;0;.00nan;0;0
29708;73274;637;58;33;4;29;.879;3600000;0
29708;145079;626;0;0;0;0;.00nan;0;0
29709;22684;632;0;0;0;0;.00nan;0;0
29709;-1;642;63;23;2;21;.913;3600000;0
29709;197595;632;51;23;3;20;.870;3555000;0
29709;151728;642;0;0;0;0;.00nan;0;0
29710;181431;636;96;49;2;47;.959;3900000;0
29710;38277;636;0;0;0;0;.00nan;0;0
29710;67362;1814;78;29;2;27;.931;3900000;0
29710;156632;1814;0;0;0;0;.00nan;0;0
29711;192739;639;31;16;4;12;.750;1569000;0
29711;1838;628;67;33;3;30;.909;3600000;0
29711;149969;639;72;25;2;23;.920;2031000;0
29711;161336;628;0;0;0;0;.00nan;0;0
29712;193854;1836;49;30;3;27;.900;3900000;0
29712;-1;1836;0;0;0;0;.00nan;0;0
29712;-1;637;0;0;0;0;.00nan;0;0
29712;73274;637;83;36;3;33;.917;3900000;0
29713;11068;641;0;0;0;0;.00nan;0;0
29713;-1;642;0;0;0;0;.00nan;0;0
29713;-1;641;92;36;1;35;.972;3900000;0
29713;151728;642;88;27;1;26;.963;3900000;0
29714;1838;628;0;0;0;0;.00nan;0;0
29714;186641;625;50;35;5;30;.857;3600000;0
29714;145038;625;0;0;0;0;.00nan;0;0
29714;161336;628;34;37;7;30;.811;3540000;0
29715;168651;651;97;49;2;47;.959;3600000;0
29715;195761;651;0;0;0;0;.00nan;0;0
29715;181431;636;74;23;1;22;.957;3600000;0
29715;38277;636;0;0;0;0;.00nan;0;0
29716;22684;632;90;28;1;27;.964;3600000;0
29716;190508;626;0;0;0;0;.00nan;0;0
29716;197595;632;0;0;0;0;.00nan;0;0
29716;145079;626;30;22;5;17;.773;3600000;0
29717;174209;631;0;0;0;0;.00nan;0;0
29717;176963;627;64;34;3;31;.912;3562000;0
29717;85468;627;0;0;0;0;.00nan;0;0
29717;144705;631;98;33;1;32;.970;3600000;0
29718;192739;639;34;12;3;9;.750;1199000;0
29718;67362;1814;0;0;0;0;.00nan;0;0
29718;149969;639;27;24;6;18;.750;2401000;0
29718;156632;1814;87;35;1;34;.971;3600000;0
29719;11068;641;86;36;1;35;.972;3600000;0
29719;-1;641;0;0;0;0;.00nan;0;0
29719;-1;637;0;0;0;0;.00nan;0;0
29719;73274;637;64;29;3;26;.897;3545000;0
29720;192739;639;0;0;0;0;.00nan;0;0
29720;22684;632;0;0;0;0;.00nan;0;0
29720;197595;632;79;33;3;30;.909;3900000;0
29720;149969;639;71;28;3;25;.893;3900000;0
29721;1838;628;96;24;0;24;1.000;3600000;0
29721;181431;636;97;35;1;34;.971;3551000;0
29721;38277;636;0;0;0;0;.00nan;0;0
29721;161336;628;0;0;0;0;.00nan;0;0
29722;168651;651;67;15;1;14;.933;3600000;0
29722;195761;651;0;0;0;0;.00nan;0;0
29722;-1;642;0;0;0;0;.00nan;0;0
29722;151728;642;72;24;2;22;.917;3595000;0
29723;193854;1836;61;43;6;37;.860;3804000;0
29723;174209;631;0;0;0;0;.00nan;0;0
29723;-1;1836;0;0;0;0;.00nan;0;0
29723;144705;631;56;36;5;31;.861;3804000;0
29724;190508;626;93;38;2;36;.947;3556000;0
29724;186641;625;66;19;1;18;.947;3600000;0
29724;145038;625;0;0;0;0;.00nan;0;0
29724;145079;626;0;0;0;0;.00nan;0;0
29725;176963;627;66;33;3;30;.909;3600000;0
29725;67362;1814;88;15;0;15;1.000;3600000;0
29725;85468;627;0;0;0;0;.00nan;0;0
29725;156632;1814;0;0;0;0;.00nan;0;0
29726;1838;628;75;10;0;10;1.000;3600000;0
29726;-1;637;78;41;3;38;.927;3600000;0
29726;73274;637;0;0;0;0;.00nan;0;0
29726;161336;628;0;0;0;0;.00nan;0;0
29727;193854;1836;84;23;1;22;.957;3600000;0
29727;-1;1836;0;0;0;0;.00nan;0;0
29727;67362;1814;42;32;5;27;.844;3600000;0
29727;156632;1814;0;0;0;0;.00nan;0;0
29728;11068;641;0;0;0;0;.00nan;0;0
29728;176963;627;91;30;1;29;.967;3600000;0
29728;-1;641;98;53;2;51;.962;3600000;0
29728;85468;627;0;0;0;0;.00nan;0;0
29729;22684;632;57;39;5;34;.872;3546000;0
29729;186641;625;71;29;3;26;.897;3600000;0
29729;197595;632;0;0;0;0;.00nan;0;0
29729;145038;625;0;0;0;0;.00nan;0;0
29730;168651;651;20;10;4;6;.600;1000000;0
29730;195761;651;78;27;2;25;.926;2600000;0
29730;190508;626;77;29;2;27;.931;3600000;0
29730;145079;626;0;0;0;0;.00nan;0;0
29731;174209;631;0;0;0;0;.00nan;0;0
29731;181431;636;0;0;0;0;.00nan;0;0
29731;38277;636;78;30;2;28;.933;3600000;0
29731;144705;631;78;36;3;33;.917;3565000;0
29732;192739;639;0;0;0;0;.00nan;0;0
29732;-1;642;0;0;0;0;.00nan;0;0
29732;149969;639;96;32;1;31;.969;3600000;0
29732;151728;642;72;23;2;21;.913;3586000;0
29733;11068;641;70;23;1;22;.957;3600000;0
29733;174209;631;0;0;0;0;.00nan;0;0
29733;-1;641;0;0;0;0;.00nan;0;0
29733;144705;631;76;34;3;31;.912;3559000;0
29734;181431;636;64;35;4;31;.886;3517000;0
29734;38277;636;0;0;0;0;.00nan;0;0
29734;-1;637;0;0;0;0;.00nan;0;0
29734;73274;637;92;34;2;32;.941;3600000;0
29735;1838;628;65;34;4;30;.882;3566000;0
29735;193854;1836;74;32;3;29;.906;3600000;0
29735;-1;1836;0;0;0;0;.00nan;0;0
29735;161336;628;0;0;0;0;.00nan;0;0
29736;168651;651;0;0;0;0;.00nan;0;0
29736;22684;632;0;0;0;0;.00nan;0;0
29736;195761;651;77;20;1;19;.950;3900000;0
29736;197595;632;90;33;1;32;.970;3900000;0
29737;-1;642;0;0;0;0;.00nan;0;0
29737;190508;626;45;28;5;23;.821;2121000;0
29737;145079;626;68;11;0;11;1.000;1410000;0
29737;151728;642;55;26;3;23;.885;3600000;0
29738;186641;625;97;31;1;30;.968;3600000;0
29738;67362;1814;54;33;4;29;.879;3600000;0
29738;145038;625;0;0;0;0;.00nan;0;0
29738;156632;1814;0;0;0;0;.00nan;0;0
29739;192739;639;0;0;0;0;.00nan;0;0
29739;176963;627;73;23;1;22;.957;3600000;0
29739;85468;627;0;0;0;0;.00nan;0;0
29739;149969;639;62;42;5;37;.881;3600000;0
29740;8424;627;86;17;0;17;1.000;3600000;0
29740;176963;627;0;0;0;0;.00nan;0;0
29740;-1;637;0;0;0;0;.00nan;0;0
29740;73274;637;77;51;5;46;.902;3600000;0
29741;11068;641;81;32;2;30;.938;3600000;0
29741;22684;632;0;0;0;0;.00nan;0;0
29741;-1;641;0;0;0;0;.00nan;0;0
29741;197595;632;59;25;3;22;.880;3557000;0
29742;1838;628;0;0;0;0;.00nan;0;0
29742;168651;651;65;36;4;32;.889;3600000;0
29742;195761;651;0;0;0;0;.00nan;0;0
29742;161336;628;58;30;3;27;.900;3600000;0
29743;192739;639;0;0;0;0;.00nan;0;0
29743;174209;631;0;0;0;0;.00nan;0;0
29743;144705;631;76;24;1;23;.958;3600000;0
29743;149969;639;98;47;3;44;.936;3554000;0
29744;193854;1836;41;38;6;32;.842;3013000;0
29744;-1;1836;56;6;0;6;1.000;587000;0
29744;186641;625;74;24;2;22;.917;3600000;0
29744;145038;625;0;0;0;0;.00nan;0;0
29745;190508;626;66;34;3;31;.912;3555000;0
29745;181431;636;88;38;2;36;.947;3600000;0
29745;38277;636;0;0;0;0;.00nan;0;0
29745;145079;626;0;0;0;0;.00nan;0;0
29746;-1;642;0;0;0;0;.00nan;0;0
29746;67362;1814;74;26;1;25;.962;3600000;0
29746;151728;642;64;42;5;37;.881;3600000;0
29746;156632;1814;0;0;0;0;.00nan;0;0
29747;193854;1836;0;0;0;0;.00nan;0;0
29747;168651;651;90;46;3;43;.935;3600000;0
29747;195761;651;0;0;0;0;.00nan;0;0
29747;-1;1836;100;30;0;30;1.000;3600000;0
29748;174209;631;63;30;3;27;.900;3600000;0
29748;-1;637;52;3;0;3;1.000;447000;0
29748;73274;637;47;35;6;29;.829;3153000;0
29748;144705;631;0;0;0;0;.00nan;0;0
29749;8424;627;67;29;3;26;.897;3600000;0
29749;176963;627;0;0;0;0;.00nan;0;0
29749;190508;626;48;27;4;23;.852;3600000;0
29749;145079;626;0;0;0;0;.00nan;0;0
29750;22684;632;62;41;4;37;.902;3783000;0
29750;197595;632;0;0;0;0;.00nan;0;0
29750;67362;1814;53;30;5;25;.833;3783000;0
29750;156632;1814;0;0;0;0;.00nan;0;0
29751;1838;628;54;25;3;22;.880;3600000;0
29751;11068;641;0;0;0;0;.00nan;0;0
29751;-1;641;99;51;2;49;.961;3600000;0
29751;161336;628;0;0;0;0;.00nan;0;0
29752;-1;642;0;0;0;0;.00nan;0;0
29752;186641;625;81;26;1;25;.962;3600000;0
29752;145038;625;0;0;0;0;.00nan;0;0
29752;151728;642;83;41;2;39;.951;3600000;0
29753;192739;639;0;0;0;0;.00nan;0;0
29753;181431;636;49;20;3;17;.850;3600000;0
29753;38277;636;0;0;0;0;.00nan;0;0
29753;149969;639;53;34;5;29;.853;3600000;0
29754;193854;1836;79;29;2;27;.931;3600000;0
29754;-1;1836;0;0;0;0;.00nan;0;0
29754;-1;637;64;36;4;32;.889;3583000;0
29754;73274;637;0;0;0;0;.00nan;0;0
29755;8424;627;56;20;2;18;.900;3600000;0
29755;11068;641;0;0;0;0;.00nan;0;0
29755;176963;627;0;0;0;0;.00nan;0;0
29755;-1;641;76;32;3;29;.906;3596000;0
29756;192739;639;0;0;0;0;.00nan;0;0
29756;22684;632;0;0;0;0;.00nan;0;0
29756;197595;632;97;30;1;29;.967;3900000;0
29756;149969;639;88;31;1;30;.968;3900000;0
29757;168651;651;68;32;3;29;.906;3600000;0
29757;195761;651;0;0;0;0;.00nan;0;0
29757;-1;642;0;0;0;0;.00nan;0;0
29757;151728;642;39;36;5;31;.861;3597000;0
29758;174209;631;0;0;0;0;.00nan;0;0
29758;190508;626;100;43;2;41;.953;3600000;0
29758;144705;631;90;34;3;31;.912;3555000;0
29758;145079;626;0;0;0;0;.00nan;0;0
29759;181431;636;64;42;5;37;.881;3587000;0
29759;38277;636;0;0;0;0;.00nan;0;0
29759;186641;625;62;22;3;19;.864;3600000;0
29759;145038;625;0;0;0;0;.00nan;0;0
29760;1838;628;59;27;4;23;.852;3600000;0
29760;67362;1814;73;39;5;34;.872;3542000;0
29760;156632;1814;0;0;0;0;.00nan;0;0
29760;161336;628;0;0;0;0;.00nan;0;0
29761;168651;651;76;30;3;27;.900;3582000;0
29761;195761;651;0;0;0;0;.00nan;0;0
29761;-1;637;0;0;0;0;.00nan;0;0
29761;73274;637;86;27;1;26;.963;3600000;0
29762;8424;627;55;29;4;25;.862;2317000;0
29762;193854;1836;0;0;0;0;.00nan;0;0
29762;176963;627;51;23;3;20;.870;1265000;0
29762;-1;1836;52;46;6;40;.870;3600000;0
29763;174209;631;0;0;0;0;.00nan;0;0
29763;186641;625;73;24;1;23;.958;3900000;0
29763;144705;631;97;35;1;34;.971;3900000;0
29763;145038;625;0;0;0;0;.00nan;0;0
29764;22684;632;0;0;0;0;.00nan;0;0
29764;181431;636;0;0;0;0;.00nan;0;0
29764;38277;636;91;41;3;38;.927;3600000;0
29764;197595;632;58;37;5;32;.865;3518000;0
29765;192739;639;0;0;0;0;.00nan;0;0
29765;67362;1814;75;26;3;23;.885;3900000;0
29765;149969;639;72;42;3;39;.929;3900000;0
29765;156632;1814;0;0;0;0;.00nan;0;0
29766;1838;628;45;29;5;24;.828;3549000;0
29766;190508;626;73;30;3;27;.900;3600000;0
29766;145079;626;0;0;0;0;.00nan;0;0
29766;161336;628;0;0;0;0;.00nan;0;0
29767;11068;641;71;27;2;25;.926;3543000;0
29767;-1;642;0;0;0;0;.00nan;0;0
29767;-1;641;0;0;0;0;.00nan;0;0
29767;151728;642;74;24;1;23;.958;3600000;0
29768;11068;641;0;0;0;0;.00nan;0;0
29768;193854;1836;11;16;6;10;.625;2497000;0
29768;-1;641;68;41;5;36;.878;3600000;0
29768;-1;1836;52;17;2;15;.882;1103000;0
29769;8424;627;63;14;1;13;.929;3600000;0
29769;176963;627;0;0;0;0;.00nan;0;0
29769;-1;637;0;0;0;0;.00nan;0;0
29769;73274;637;98;52;3;49;.942;3562000;0
29770;22684;632;0;0;0;0;.00nan;0;0
29770;-1;642;0;0;0;0;.00nan;0;0
29770;197595;632;49;23;3;20;.870;3600000;0
29770;151728;642;100;35;0;35;1.000;3600000;0
29771;1838;628;68;28;3;25;.893;3544000;0
29771;168651;651;100;49;2;47;.959;3600000;0
29771;195761;651;0;0;0;0;.00nan;0;0
29771;161336;628;0;0;0;0;.00nan;0;0
29772;190508;626;94;38;2;36;.947;3600000;0
29772;181431;636;72;36;3;33;.917;3559000;0
29772;38277;636;0;0;0;0;.00nan;0;0
29772;145079;626;0;0;0;0;.00nan;0;0
29773;174209;631;0;0;0;0;.00nan;0;0
29773;67362;1814;66;32;3;29;.906;3600000;0
29773;144705;631;45;28;4;24;.857;3553000;0
29773;156632;1814;0;0;0;0;.00nan;0;0
29774;192739;639;0;0;0;0;.00nan;0;0
29774;186641;625;58;15;1;14;.933;3600000;0
29774;145038;625;0;0;0;0;.00nan;0;0
29774;149969;639;74;47;5;42;.894;3600000;0
29775;192739;639;0;0;0;0;.00nan;0;0
29775;-1;637;0;0;0;0;.00nan;0;0
29775;73274;637;76;19;1;18;.947;3600000;0
29775;149969;639;63;42;6;36;.857;3600000;0
29776;193854;1836;61;37;4;33;.892;3515000;0
29776;181431;636;76;31;2;29;.935;3600000;0
29776;38277;636;0;0;0;0;.00nan;0;0
29776;-1;1836;0;0;0;0;.00nan;0;0
29777;1838;628;0;0;0;0;.00nan;0;0
29777;22684;632;0;0;0;0;.00nan;0;0
29777;197595;632;85;40;4;36;.900;3665000;0
29777;161336;628;67;27;3;24;.889;3665000;0
29778;168651;651;97;51;2;49;.961;3900000;0
29778;195761;651;0;0;0;0;.00nan;0;0
29778;190508;626;0;0;0;0;.00nan;0;0
29778;145079;626;85;30;2;28;.933;3900000;0
29779;11068;641;66;51;5;46;.902;3600000;0
29779;174209;631;0;0;0;0;.00nan;0;0
29779;-1;641;0;0;0;0;.00nan;0;0
29779;144705;631;47;20;4;16;.800;3600000;0
29780;8424;627;70;17;1;16;.941;3600000;0
29780;176963;627;0;0;0;0;.00nan;0;0
29780;186641;625;74;40;3;37;.925;3530000;0
29780;145038;625;0;0;0;0;.00nan;0;0
29781;-1;642;0;0;0;0;.00nan;0;0
29781;67362;1814;73;26;2;24;.923;3600000;0
29781;151728;642;50;51;6;45;.882;3600000;0
29781;156632;1814;0;0;0;0;.00nan;0;0
29782;193854;1836;69;34;3;31;.912;3600000;0
29782;22684;632;0;0;0;0;.00nan;0;0
29782;-1;1836;0;0;0;0;.00nan;0;0
29782;197595;632;46;40;6;34;.850;3600000;0
29783;190508;626;89;42;2;40;.952;3900000;0
29783;67362;1814;81;31;2;29;.935;3900000;0
29783;145079;626;0;0;0;0;.00nan;0;0
29783;156632;1814;0;0;0;0;.00nan;0;0
29784;11068;641;0;0;0;0;.00nan;0;0
29784;-1;641;64;42;5;37;.881;3600000;0
29784;-1;637;0;0;0;0;.00nan;0;0
29784;73274;637;72;25;2;23;.920;3600000;0
29785;8424;627;50;25;4;21;.840;3549000;0
29785;174209;631;0;0;0;0;.00nan;0;0
29785;176963;627;0;0;0;0;.00nan;0;0
29785;144705;631;77;34;3;31;.912;3600000;0
29786;192739;639;0;0;0;0;.00nan;0;0
29786;168651;651;94;43;1;42;.977;3600000;0
29786;195761;651;0;0;0;0;.00nan;0;0
29786;149969;639;66;22;2;20;.909;3567000;0
29787;1838;628;32;30;6;24;.800;3600000;0
29787;186641;625;54;33;5;28;.848;3600000;0
29787;145038;625;0;0;0;0;.00nan;0;0
29787;161336;628;0;0;0;0;.00nan;0;0
29788;-1;642;0;0;0;0;.00nan;0;0
29788;181431;636;0;0;0;0;.00nan;0;0
29788;38277;636;78;24;1;23;.958;3600000;0
29788;151728;642;72;36;3;33;.917;3542000;0
29789;22684;632;33;26;5;21;.808;3600000;0
29789;190508;626;65;22;2;20;.909;3600000;0
29789;197595;632;0;0;0;0;.00nan;0;0
29789;145079;626;0;0;0;0;.00nan;0;0
29790;11068;641;4;23;7;16;.696;2431000;0
29790;168651;651;79;33;3;30;.909;3600000;0
29790;195761;651;0;0;0;0;.00nan;0;0
29790;-1;641;61;13;1;12;.923;1169000;0
29791;1838;628;0;0;0;0;.00nan;0;0
29791;-1;637;20;27;6;21;.778;2923000;0
29791;160906;637;60;7;0;7;1.000;677000;0
29791;161336;628;100;32;0;32;1.000;3600000;0
29792;174209;631;0;0;0;0;.00nan;0;0
29792;-1;631;84;41;3;38;.927;3554000;0
29792;181431;636;74;27;2;25;.926;3600000;0
29792;38277;636;0;0;0;0;.00nan;0;0
29793;193854;1836;70;22;1;21;.955;3600000;0
29793;-1;642;34;19;4;15;.789;1084000;0
29793;-1;1836;0;0;0;0;.00nan;0;0
29793;156545;642;51;29;5;24;.828;2516000;0
29794;186641;625;49;20;3;17;.850;3550000;0
29794;67362;1814;0;0;0;0;.00nan;0;0
29794;145038;625;0;0;0;0;.00nan;0;0
29794;156632;1814;71;29;2;27;.931;3600000;0
29795;192739;639;0;0;0;0;.00nan;0;0
29795;8424;627;73;23;1;22;.957;3600000;0
29795;176963;627;0;0;0;0;.00nan;0;0
29795;149969;639;77;38;3;35;.921;3540000;0
29796;1838;628;0;0;0;0;.00nan;0;0
29796;174209;631;75;27;2;25;.926;3600000;0
29796;-1;631;0;0;0;0;.00nan;0;0
29796;161336;628;79;38;3;35;.921;3547000;0
29797;190508;626;50;38;6;32;.842;3600000;0
29797;73274;637;100;29;0;29;1.000;3600000;0
29797;145079;626;0;0;0;0;.00nan;0;0
29797;160906;637;0;0;0;0;.00nan;0;0
29798;193854;1836;73;40;4;36;.900;3583000;0
29798;-1;1836;0;0;0;0;.00nan;0;0
29798;186641;625;73;22;2;20;.909;3600000;0
29798;145038;625;0;0;0;0;.00nan;0;0
29799;11068;641;44;52;8;44;.846;2522000;0
29799;181431;636;37;22;5;17;.773;3600000;0
29799;38277;636;0;0;0;0;.00nan;0;0
29799;-1;641;56;17;2;15;.882;1078000;0
29800;22684;632;0;0;0;0;.00nan;0;0
29800;176963;627;54;21;3;18;.857;3600000;0
29800;197595;632;66;37;4;33;.892;3600000;0
29800;85468;627;0;0;0;0;.00nan;0;0
29801;168651;651;47;36;5;31;.861;3600000;0
29801;195761;651;0;0;0;0;.00nan;0;0
29801;67362;1814;73;27;2;25;.926;3600000;0
29801;156632;1814;0;0;0;0;.00nan;0;0
29802;192739;639;0;0;0;0;.00nan;0;0
29802;-1;642;0;0;0;0;.00nan;0;0
29802;149969;639;91;30;1;29;.967;3600000;0
29802;151728;642;54;30;4;26;.867;3600000;0
29803;1838;628;0;0;0;0;.00nan;0;0
29803;8424;627;92;40;2;38;.950;3870000;0
29803;176963;627;0;0;0;0;.00nan;0;0
29803;161336;628;85;30;1;29;.967;3870000;0
29804;22684;632;0;0;0;0;.00nan;0;0
29804;174209;631;0;0;0;0;.00nan;0;0
29804;197595;632;59;34;4;30;.882;3556000;0
29804;144705;631;66;21;2;19;.905;3600000;0
29805;186641;625;52;3;0;3;1.000;287000;0
29805;73274;637;47;40;6;34;.850;3600000;0
29805;145038;625;18;27;7;20;.741;3298000;0
29805;160906;637;0;0;0;0;.00nan;0;0
29806;168651;651;73;42;4;38;.905;3545000;0
29806;195761;651;0;0;0;0;.00nan;0;0
29806;181431;636;73;26;2;24;.923;3600000;0
29806;38277;636;0;0;0;0;.00nan;0;0
29807;193854;1836;68;34;3;31;.912;3577000;0
29807;-1;1836;0;0;0;0;.00nan;0;0
29807;67362;1814;82;30;1;29;.967;3600000;0
29807;156632;1814;0;0;0;0;.00nan;0;0
29808;192739;639;0;0;0;0;.00nan;0;0
29808;11068;641;0;0;0;0;.00nan;0;0
29808;-1;641;59;25;3;22;.880;3632000;0
29808;149969;639;74;28;2;26;.929;3632000;0
29809;-1;642;0;0;0;0;.00nan;0;0
29809;190508;626;59;24;3;21;.875;3571000;0
29809;145079;626;0;0;0;0;.00nan;0;0
29809;151728;642;91;31;1;30;.968;3600000;0
29810;67362;1814;64;22;2;20;.909;3600000;0
29810;73274;637;60;37;5;32;.865;3600000;0
29810;156632;1814;0;0;0;0;.00nan;0;0
29810;160906;637;0;0;0;0;.00nan;0;0
29811;8424;627;36;19;4;15;.789;3551000;0
29811;176963;627;0;0;0;0;.00nan;0;0
29811;181431;636;99;48;2;46;.958;3600000;0
29811;38277;636;0;0;0;0;.00nan;0;0
29812;168651;651;47;25;4;21;.840;3571000;0
29812;22684;632;88;37;2;35;.946;3600000;0
29812;195761;651;0;0;0;0;.00nan;0;0
29812;197595;632;0;0;0;0;.00nan;0;0
29813;192739;639;0;0;0;0;.00nan;0;0
29813;1838;628;0;0;0;0;.00nan;0;0
29813;149969;639;100;52;2;50;.962;3900000;0
29813;161336;628;56;20;2;18;.900;3900000;0
29814;193854;1836;77;27;1;26;.963;3600000;0
29814;190508;626;0;0;0;0;.00nan;0;0
29814;-1;1836;0;0;0;0;.00nan;0;0
29814;145079;626;69;34;3;31;.912;3548000;0
29815;174209;631;0;0;0;0;.00nan;0;0
29815;-1;642;0;0;0;0;.00nan;0;0
29815;144705;631;66;17;1;16;.941;3600000;0
29815;151728;642;87;37;2;35;.946;3585000;0
29816;11068;641;64;44;4;40;.909;3600000;0
29816;-1;641;0;0;0;0;.00nan;0;0
29816;186641;625;82;20;1;19;.950;3600000;0
29816;145038;625;0;0;0;0;.00nan;0;0
29817;22684;632;0;0;0;0;.00nan;0;0
29817;197595;632;77;45;4;41;.911;3900000;0
29817;73274;637;52;28;4;24;.857;3856000;0
29817;160906;637;0;0;0;0;.00nan;0;0
29818;193854;1836;0;0;0;0;.00nan;0;0
29818;174209;631;0;0;0;0;.00nan;0;0
29818;-1;1836;79;36;2;34;.944;3600000;0
29818;144705;631;62;29;3;26;.897;3570000;0
29819;11068;641;0;0;0;0;.00nan;0;0
29819;-1;641;80;47;4;43;.915;3600000;0
29819;67362;1814;44;20;3;17;.850;3600000;0
29819;156632;1814;0;0;0;0;.00nan;0;0
29820;8424;627;49;8;1;7;.875;3546000;0
29820;176963;627;0;0;0;0;.00nan;0;0
29820;-1;642;0;0;0;0;.00nan;0;0
29820;151728;642;100;57;0;57;1.000;3600000;0
29821;168651;651;96;47;3;44;.936;3600000;0
29821;195761;651;0;0;0;0;.00nan;0;0
29821;186641;625;75;29;2;27;.931;3600000;0
29821;145038;625;0;0;0;0;.00nan;0;0
29822;1838;628;0;0;0;0;.00nan;0;0
29822;181431;636;0;0;0;0;.00nan;0;0
29822;38277;636;63;39;4;35;.897;3600000;0
29822;161336;628;100;29;0;29;1.000;3600000;0
29823;192739;639;0;0;0;0;.00nan;0;0
29823;190508;626;98;43;2;41;.953;3600000;0
29823;145079;626;0;0;0;0;.00nan;0;0
29823;149969;639;65;37;4;33;.892;3526000;0
29824;1838;628;0;0;0;0;.00nan;0;0
29824;-1;642;23;18;5;13;.722;1485000;0
29824;151728;642;40;33;6;27;.818;2115000;0
29824;161336;628;56;24;3;21;.875;3600000;0
29825;192739;639;0;0;0;0;.00nan;0;0
29825;193854;1836;78;29;2;27;.931;3600000;0
29825;-1;1836;0;0;0;0;.00nan;0;0
29825;149969;639;54;48;7;41;.854;3600000;0
29826;11068;641;0;0;0;0;.00nan;0;0
29826;22684;632;0;0;0;0;.00nan;0;0
29826;-1;641;100;30;0;30;1.000;3600000;0
29826;197595;632;84;28;1;27;.964;3600000;0
29827;8424;627;78;39;3;36;.923;3600000;0
29827;176963;627;0;0;0;0;.00nan;0;0
29827;67362;1814;53;39;5;34;.872;3515000;0
29827;156632;1814;0;0;0;0;.00nan;0;0
29828;168651;651;70;37;3;34;.919;3600000;0
29828;174209;631;47;29;4;25;.862;3600000;0
29828;195761;651;0;0;0;0;.00nan;0;0
29828;144705;631;0;0;0;0;.00nan;0;0
29829;190508;626;39;29;5;24;.828;3600000;0
29829;186641;625;100;42;2;40;.952;3600000;0
29829;145038;625;0;0;0;0;.00nan;0;0
29829;145079;626;0;0;0;0;.00nan;0;0
29830;181431;636;57;22;2;20;.909;3900000;0
29830;38277;636;0;0;0;0;.00nan;0;0
29830;73274;637;100;51;2;49;.961;3900000;0
29830;160906;637;0;0;0;0;.00nan;0;0
29831;-1;642;0;0;0;0;.00nan;0;0
29831;73274;637;80;33;2;31;.939;3555000;0
29831;151728;642;99;36;1;35;.972;3600000;0
29831;160906;637;0;0;0;0;.00nan;0;0
29832;22684;632;0;0;0;0;.00nan;0;0
29832;186641;625;81;36;3;33;.917;3600000;0
29832;197595;632;100;30;0;30;1.000;3600000;0
29832;145038;625;0;0;0;0;.00nan;0;0
29833;1838;628;60;6;0;6;1.000;543000;0
29833;193854;1836;70;35;3;32;.914;3600000;0
29833;-1;1836;0;0;0;0;.00nan;0;0
29833;161336;628;38;39;7;32;.821;3057000;0
29834;8424;627;71;32;3;29;.906;3600000;0
29834;168651;651;51;8;1;7;.875;992000;0
29834;195761;651;32;37;7;30;.811;2608000;0
29834;176963;627;0;0;0;0;.00nan;0;0
29835;11068;641;0;0;0;0;.00nan;0;0
29835;190508;626;0;0;0;0;.00nan;0;0
29835;-1;641;95;48;2;46;.958;3900000;0
29835;145079;626;69;23;2;21;.913;3900000;0
29836;181431;636;71;35;4;31;.886;3600000;0
29836;38277;636;0;0;0;0;.00nan;0;0
29836;67362;1814;81;25;1;24;.960;3600000;0
29836;156632;1814;0;0;0;0;.00nan;0;0
29837;192739;639;89;38;2;36;.947;3600000;0
29837;174209;631;0;0;0;0;.00nan;0;0
29837;144705;631;65;29;3;26;.897;3584000;0
29837;149969;639;0;0;0;0;.00nan;0;0
29838;1838;628;0;0;0;0;.00nan;0;0
29838;186641;625;76;33;3;30;.909;3600000;0
29838;145038;625;0;0;0;0;.00nan;0;0
29838;161336;628;66;30;4;26;.867;3600000;0
29839;8424;627;27;22;6;16;.727;3600000;0
29839;176963;627;0;0;0;0;.00nan;0;0
29839;73274;637;100;37;1;36;.973;3600000;0
29839;160906;637;0;0;0;0;.00nan;0;0
29840;11068;641;0;0;0;0;.00nan;0;0
29840;193854;1836;76;22;1;21;.955;3600000;0
29840;-1;641;55;50;6;44;.880;3600000;0
29840;-1;1836;0;0;0;0;.00nan;0;0
29841;190508;626;51;33;4;29;.879;3579000;0
29841;181431;636;81;35;2;33;.943;3600000;0
29841;38277;636;0;0;0;0;.00nan;0;0
29841;145079;626;0;0;0;0;.00nan;0;0
29842;22684;632;0;0;0;0;.00nan;0;0
29842;174209;631;56;35;5;30;.857;3600000;0
29842;197595;632;100;45;1;44;.978;3600000;0
29842;144705;631;0;0;0;0;.00nan;0;0
29843;192739;639;0;0;0;0;.00nan;0;0
29843;-1;642;0;0;0;0;.00nan;0;0
29843;149969;639;59;40;5;35;.875;3884000;0
29843;151728;642;57;37;5;32;.865;3900000;0
29844;168651;651;63;32;4;28;.875;3600000;0
29844;195761;651;0;0;0;0;.00nan;0;0
29844;67362;1814;90;27;1;26;.963;3600000;0
29844;156632;1814;0;0;0;0;.00nan;0;0
29845;192739;639;0;0;0;0;.00nan;0;0
29845;11068;641;0;0;0;0;.00nan;0;0
29845;-1;641;57;39;5;34;.872;3600000;0
29845;149969;639;64;22;2;20;.909;3600000;0
29846;8424;627;0;0;0;0;.00nan;0;0
29846;174209;631;0;0;0;0;.00nan;0;0
29846;176963;627;68;24;2;22;.917;3600000;0
29846;144705;631;86;44;3;41;.932;3592000;0
29847;22684;632;66;36;4;32;.889;3643000;0
29847;197595;632;0;0;0;0;.00nan;0;0
29847;73274;637;56;27;3;24;.889;3643000;0
29847;160906;637;0;0;0;0;.00nan;0;0
29848;193854;1836;92;17;0;17;1.000;3600000;0
29848;168651;651;81;45;4;41;.911;3600000;0
29848;195761;651;0;0;0;0;.00nan;0;0
29848;-1;1836;0;0;0;0;.00nan;0;0
29849;1838;628;0;0;0;0;.00nan;0;0
29849;190508;626;0;0;0;0;.00nan;0;0
29849;145079;626;79;30;1;29;.967;3600000;0
29849;161336;628;40;22;4;18;.818;3600000;0
29850;-1;642;0;0;0;0;.00nan;0;0
29850;181431;636;72;25;2;23;.920;3600000;0
29850;38277;636;0;0;0;0;.00nan;0;0
29850;151728;642;65;37;5;32;.865;3600000;0
29851;186641;625;59;29;4;25;.862;3600000;0
29851;67362;1814;41;37;6;31;.838;3581000;0
29851;145038;625;0;0;0;0;.00nan;0;0
29851;156632;1814;0;0;0;0;.00nan;0;0
29852;168651;651;64;29;3;26;.897;3900000;0
29852;195761;651;0;0;0;0;.00nan;0;0
29852;73274;637;66;34;3;31;.912;3900000;0
29852;160906;637;0;0;0;0;.00nan;0;0
29853;11068;641;0;0;0;0;.00nan;0;0
29853;-1;641;86;38;2;36;.947;3600000;0
29853;186641;625;19;17;5;12;.706;3600000;0
29853;145038;625;0;0;0;0;.00nan;0;0
29854;1838;628;0;0;0;0;.00nan;0;0
29854;8424;627;61;38;5;33;.868;3560000;0
29854;176963;627;0;0;0;0;.00nan;0;0
29854;161336;628;37;23;4;19;.826;3600000;0
29855;193854;1836;47;26;4;22;.846;3600000;0
29855;22684;632;0;0;0;0;.00nan;0;0
29855;-1;1836;0;0;0;0;.00nan;0;0
29855;197595;632;81;53;5;48;.906;3557000;0
29856;-1;642;0;0;0;0;.00nan;0;0
29856;190508;626;70;28;3;25;.893;3600000;0
29856;145079;626;0;0;0;0;.00nan;0;0
29856;151728;642;51;26;4;22;.846;3565000;0
29857;174209;631;0;0;0;0;.00nan;0;0
29857;181431;636;37;23;4;19;.826;2343000;0
29857;38277;636;51;21;3;18;.857;1257000;0
29857;144705;631;100;34;0;34;1.000;3600000;0
29858;192739;639;69;28;2;26;.929;1729000;0
29858;67362;1814;44;27;6;21;.778;3600000;0
29858;149969;639;30;29;6;23;.793;1802000;0
29858;156632;1814;0;0;0;0;.00nan;0;0
29859;193854;1836;54;17;2;15;.882;3600000;0
29859;-1;642;0;0;0;0;.00nan;0;0
29859;-1;1836;0;0;0;0;.00nan;0;0
29859;151728;642;77;39;3;36;.923;3596000;0
29860;22684;632;0;0;0;0;.00nan;0;0
29860;181431;636;67;36;4;32;.889;3545000;0
29860;38277;636;0;0;0;0;.00nan;0;0
29860;197595;632;99;45;3;42;.933;3600000;0
29861;192739;639;0;0;0;0;.00nan;0;0
29861;1838;628;0;0;0;0;.00nan;0;0
29861;149969;639;60;22;2;20;.909;3566000;0
29861;161336;628;61;16;1;15;.938;3600000;0
29862;8424;627;0;0;0;0;.00nan;0;0
29862;168651;651;75;30;2;28;.933;3516000;0
29862;195761;651;0;0;0;0;.00nan;0;0
29862;176963;627;94;29;0;29;1.000;3600000;0
29863;190508;626;0;0;0;0;.00nan;0;0
29863;73274;637;50;30;5;25;.833;3600000;0
29863;145079;626;75;29;2;27;.931;3600000;0
29863;160906;637;0;0;0;0;.00nan;0;0
29864;174209;631;0;0;0;0;.00nan;0;0
29864;186641;625;54;24;3;21;.875;3545000;0
29864;144705;631;89;43;2;41;.953;3600000;0
29864;145038;625;0;0;0;0;.00nan;0;0
29865;11068;641;53;18;2;16;.889;1568000;0
29865;-1;641;36;27;5;22;.815;2032000;0
29865;67362;1814;0;0;0;0;.00nan;0;0
29865;156632;1814;91;16;0;16;1.000;3600000;0
29866;67362;1814;100;40;1;39;.975;3900000;0
29866;73274;637;71;19;1;18;.947;3900000;0
29866;156632;1814;0;0;0;0;.00nan;0;0
29866;160906;637;0;0;0;0;.00nan;0;0
29867;8424;627;0;0;0;0;.00nan;0;0
29867;193854;1836;69;35;4;31;.886;3577000;0
29867;176963;627;56;18;2;16;.889;3600000;0
29867;-1;1836;0;0;0;0;.00nan;0;0
29868;22684;632;61;34;4;30;.882;3838000;0
29868;190508;626;54;35;5;30;.857;3838000;0
29868;197595;632;0;0;0;0;.00nan;0;0
29868;145079;626;0;0;0;0;.00nan;0;0
29869;11068;641;0;0;0;0;.00nan;0;0
29869;174209;631;0;0;0;0;.00nan;0;0
29869;-1;641;51;28;5;23;.821;3600000;0
29869;144705;631;86;16;0;16;1.000;3600000;0
29870;168651;651;54;41;5;36;.878;3600000;0
29870;195761;651;0;0;0;0;.00nan;0;0
29870;-1;642;0;0;0;0;.00nan;0;0
29870;151728;642;67;21;1;20;.952;3600000;0
29871;192739;639;0;0;0;0;.00nan;0;0
29871;186641;625;65;23;3;20;.870;3600000;0
29871;145038;625;0;0;0;0;.00nan;0;0
29871;149969;639;71;41;4;37;.902;3581000;0
29872;1838;628;0;0;0;0;.00nan;0;0
29872;181431;636;78;37;4;33;.892;3535000;0
29872;38277;636;0;0;0;0;.00nan;0;0
29872;161336;628;73;27;2;25;.926;3600000;0
29873;1838;628;0;0;0;0;.00nan;0;0
29873;11068;641;66;38;4;34;.895;3600000;0
29873;-1;641;0;0;0;0;.00nan;0;0
29873;161336;628;57;17;2;15;.882;3600000;0
29874;168651;651;90;26;1;25;.962;3600000;0
29874;22684;632;0;0;0;0;.00nan;0;0
29874;195761;651;0;0;0;0;.00nan;0;0
29874;197595;632;81;33;2;31;.939;3592000;0
29875;190508;626;67;25;2;23;.920;3600000;0
29875;186641;625;61;27;3;24;.889;3559000;0
29875;145038;625;0;0;0;0;.00nan;0;0
29875;145079;626;0;0;0;0;.00nan;0;0
29876;8424;627;79;24;1;23;.958;3600000;0
29876;176963;627;0;0;0;0;.00nan;0;0
29876;-1;642;0;0;0;0;.00nan;0;0
29876;151728;642;93;42;2;40;.952;3562000;0
29877;193854;1836;93;36;1;35;.972;3546000;0
29877;181431;636;100;29;0;29;1.000;3600000;0
29877;38277;636;0;0;0;0;.00nan;0;0
29877;-1;1836;0;0;0;0;.00nan;0;0
29878;174209;631;0;0;0;0;.00nan;0;0
29878;67362;1814;0;0;0;0;.00nan;0;0
29878;144705;631;100;30;0;30;1.000;3600000;0
29878;156632;1814;53;34;4;30;.882;3600000;0
29879;192739;639;0;0;0;0;.00nan;0;0
29879;73274;637;96;36;1;35;.972;3600000;0
29879;149969;639;73;27;2;25;.926;3557000;0
29879;160906;637;0;0;0;0;.00nan;0;0
29880;-1;642;0;0;0;0;.00nan;0;0
29880;73274;637;60;27;3;24;.889;3600000;0
29880;151728;642;86;28;2;26;.929;3600000;0
29880;160906;637;0;0;0;0;.00nan;0;0
29881;193854;1836;82;31;2;29;.935;3600000;0
29881;-1;1836;0;0;0;0;.00nan;0;0
29881;67362;1814;75;32;3;29;.906;3600000;0
29881;156632;1814;0;0;0;0;.00nan;0;0
29882;11068;641;0;0;0;0;.00nan;0;0
29882;190508;626;75;24;1;23;.958;3840000;0
29882;-1;641;89;39;2;37;.949;3840000;0
29882;145079;626;0;0;0;0;.00nan;0;0
29883;8424;627;0;0;0;0;.00nan;0;0
29883;176963;627;100;30;0;30;1.000;3600000;0
29883;186641;625;93;42;3;39;.929;3600000;0
29883;145038;625;0;0;0;0;.00nan;0;0
29884;1838;628;0;0;0;0;.00nan;0;0
29884;22684;632;83;29;1;28;.966;3600000;0
29884;197595;632;0;0;0;0;.00nan;0;0
29884;161336;628;54;25;3;22;.880;3553000;0
29885;168651;651;85;48;4;44;.917;3600000;0
29885;174209;631;0;0;0;0;.00nan;0;0
29885;195761;651;0;0;0;0;.00nan;0;0
29885;144705;631;66;18;1;17;.944;3600000;0
29886;192739;639;76;34;2;32;.941;3600000;0
29886;181431;636;72;45;4;41;.911;3573000;0
29886;38277;636;0;0;0;0;.00nan;0;0
29886;149969;639;0;0;0;0;.00nan;0;0
29887;8424;627;75;26;2;24;.923;3600000;0
29887;22684;632;71;16;0;16;1.000;1249000;0
29887;176963;627;0;0;0;0;.00nan;0;0
29887;197595;632;70;45;6;39;.867;2351000;0
29888;174209;631;0;0;0;0;.00nan;0;0
29888;-1;642;0;0;0;0;.00nan;0;0
29888;144705;631;71;23;2;21;.913;3600000;0
29888;151728;642;91;54;4;50;.926;3555000;0
29889;186641;625;68;23;2;21;.913;3600000;0
29889;73274;637;65;45;5;40;.889;3320000;0
29889;145038;625;0;0;0;0;.00nan;0;0
29889;160906;637;55;3;0;3;1.000;280000;0
29890;11068;641;0;0;0;0;.00nan;0;0
29890;181431;636;76;31;2;29;.935;3600000;0
29890;38277;636;0;0;0;0;.00nan;0;0
29890;-1;641;71;40;4;36;.900;3566000;0
29891;1838;628;86;34;3;31;.912;3827000;0
29891;67362;1814;73;26;2;24;.923;3827000;0
29891;156632;1814;0;0;0;0;.00nan;0;0
29891;161336;628;0;0;0;0;.00nan;0;0
29892;168651;651;0;0;0;0;.00nan;0;0
29892;195761;651;100;36;0;36;1.000;3600000;0
29892;190508;626;58;19;2;17;.895;3555000;0
29892;145079;626;0;0;0;0;.00nan;0;0
29893;192739;639;0;0;0;0;.00nan;0;0
29893;193854;1836;88;28;1;27;.964;3600000;0
29893;-1;1836;0;0;0;0;.00nan;0;0
29893;149969;639;57;25;3;22;.880;3564000;0
29894;22684;632;0;0;0;0;.00nan;0;0
29894;197595;632;98;51;3;48;.941;3900000;0
29894;67362;1814;49;20;3;17;.850;3900000;0
29894;156632;1814;0;0;0;0;.00nan;0;0
29895;192739;639;0;0;0;0;.00nan;0;0
29895;8424;627;0;0;0;0;.00nan;0;0
29895;176963;627;61;34;4;30;.882;3521000;0
29895;149969;639;87;37;2;35;.946;3600000;0
29896;1838;628;67;30;3;27;.900;3600000;0
29896;193854;1836;55;34;6;28;.824;3600000;0
29896;-1;1836;0;0;0;0;.00nan;0;0
29896;161336;628;0;0;0;0;.00nan;0;0
29897;11068;641;0;0;0;0;.00nan;0;0
29897;168651;651;0;0;0;0;.00nan;0;0
29897;195761;651;55;28;3;25;.893;3600000;0
29897;-1;641;59;30;4;26;.867;3600000;0
29898;174209;631;0;0;0;0;.00nan;0;0
29898;190508;626;0;0;0;0;.00nan;0;0
29898;144705;631;44;20;4;16;.800;3600000;0
29898;145079;626;60;44;5;39;.886;3584000;0
29899;-1;642;0;0;0;0;.00nan;0;0
29899;186641;625;72;29;3;26;.897;3600000;0
29899;145038;625;0;0;0;0;.00nan;0;0
29899;151728;642;55;43;5;38;.884;3600000;0
29900;181431;636;78;12;0;12;1.000;3600000;0
29900;38277;636;0;0;0;0;.00nan;0;0
29900;73274;637;68;33;2;31;.939;3564000;0
29900;160906;637;0;0;0;0;.00nan;0;0
29901;193854;1836;0;0;0;0;.00nan;0;0
29901;-1;1836;88;32;2;30;.938;3871000;0
29901;73274;637;63;31;3;28;.903;3871000;0
29901;160906;637;0;0;0;0;.00nan;0;0
29902;11068;641;0;0;0;0;.00nan;0;0
29902;22684;632;0;0;0;0;.00nan;0;0
29902;-1;641;71;30;2;28;.933;3600000;0
29902;197595;632;64;31;3;28;.903;3556000;0
29903;1838;628;0;0;0;0;.00nan;0;0
29903;-1;642;0;0;0;0;.00nan;0;0
29903;151728;642;98;42;2;40;.952;3600000;0
29903;161336;628;50;19;3;16;.842;3557000;0
29904;8424;627;75;38;4;34;.895;3900000;0
29904;176963;627;0;0;0;0;.00nan;0;0
29904;190508;626;74;49;4;45;.918;3900000;0
29904;145079;626;0;0;0;0;.00nan;0;0
29905;168651;651;91;45;3;42;.933;3675000;0
29905;195761;651;0;0;0;0;.00nan;0;0
29905;186641;625;0;0;0;0;.00nan;0;0
29905;145038;625;61;22;2;20;.909;3675000;0
29906;181431;636;62;41;5;36;.878;3556000;0
29906;38277;636;0;0;0;0;.00nan;0;0
29906;67362;1814;64;27;3;24;.889;3600000;0
29906;156632;1814;0;0;0;0;.00nan;0;0
29907;192739;639;0;0;0;0;.00nan;0;0
29907;174209;631;0;0;0;0;.00nan;0;0
29907;144705;631;60;17;2;15;.882;3600000;0
29907;149969;639;82;47;4;43;.915;3600000;0
29908;1838;628;0;0;0;0;.00nan;0;0
29908;168651;651;99;37;1;36;.973;3600000;0
29908;195761;651;0;0;0;0;.00nan;0;0
29908;161336;628;46;25;4;21;.840;3600000;0
29909;193854;1836;98;37;2;35;.946;3600000;0
29909;190508;626;53;26;3;23;.885;3593000;0
29909;-1;1836;0;0;0;0;.00nan;0;0
29909;145079;626;0;0;0;0;.00nan;0;0
29910;11068;641;0;0;0;0;.00nan;0;0
29910;-1;642;0;0;0;0;.00nan;0;0
29910;-1;641;78;31;2;29;.935;3900000;0
29910;151728;642;86;37;2;35;.946;3900000;0
29911;174209;631;0;0;0;0;.00nan;0;0
29911;73274;637;49;37;6;31;.838;3600000;0
29911;144705;631;98;39;2;37;.949;3600000;0
29911;160906;637;0;0;0;0;.00nan;0;0
29912;181431;636;100;36;1;35;.972;3600000;0
29912;38277;636;0;0;0;0;.00nan;0;0
29912;186641;625;55;23;3;20;.870;3581000;0
29912;145038;625;0;0;0;0;.00nan;0;0
29913;8424;627;0;0;0;0;.00nan;0;0
29913;176963;627;100;25;0;25;1.000;3600000;0
29913;67362;1814;17;32;8;24;.750;2880000;0
29913;156632;1814;59;7;0;7;1.000;720000;0
29914;192739;639;0;0;0;0;.00nan;0;0
29914;22684;632;66;28;3;25;.893;3900000;0
29914;197595;632;0;0;0;0;.00nan;0;0
29914;149969;639;82;40;3;37;.925;3900000;0
29915;8424;627;73;19;1;18;.947;3600000;0
29915;11068;641;63;40;4;36;.900;3273000;0
29915;176963;627;0;0;0;0;.00nan;0;0
29915;-1;641;28;9;3;6;.667;327000;0
29916;1838;628;0;0;0;0;.00nan;0;0
29916;73274;637;65;49;5;44;.898;3600000;0
29916;160906;637;0;0;0;0;.00nan;0;0
29916;161336;628;77;25;2;23;.920;3600000;0
29917;192739;639;0;0;0;0;.00nan;0;0
29917;190508;626;58;27;4;23;.852;3520000;0
29917;145079;626;0;0;0;0;.00nan;0;0
29917;149969;639;80;35;2;33;.943;3600000;0
29918;193854;1836;81;27;1;26;.963;3600000;0
29918;174209;631;0;0;0;0;.00nan;0;0
29918;-1;1836;0;0;0;0;.00nan;0;0
29918;144705;631;67;37;4;33;.892;3600000;0
29919;-1;642;93;44;2;42;.955;3843000;0
29919;67362;1814;68;23;1;22;.957;3843000;0
29919;151728;642;0;0;0;0;.00nan;0;0
29919;156632;1814;0;0;0;0;.00nan;0;0
29920;22684;632;0;0;0;0;.00nan;0;0
29920;186641;625;63;19;2;17;.895;3600000;0
29920;197595;632;97;56;3;53;.946;3558000;0
29920;145038;625;0;0;0;0;.00nan;0;0
29921;168651;651;61;39;6;33;.846;3600000;0
29921;195761;651;0;0;0;0;.00nan;0;0
29921;181431;636;0;0;0;0;.00nan;0;0
29921;38277;636;54;27;4;23;.852;3600000;0
29922;193854;1836;26;13;4;9;.692;909000;0
29922;-1;1836;52;24;3;21;.875;2691000;0
29922;186641;625;100;36;1;35;.972;3600000;0
29922;145038;625;0;0;0;0;.00nan;0;0
29923;11068;641;0;0;0;0;.00nan;0;0
29923;-1;641;57;29;4;25;.862;3734000;0
29923;73274;637;70;26;3;23;.885;3734000;0
29923;160906;637;0;0;0;0;.00nan;0;0
29924;8424;627;0;0;0;0;.00nan;0;0
29924;176963;627;100;24;0;24;1.000;3600000;0
29924;181431;636;66;38;4;34;.895;3600000;0
29924;38277;636;0;0;0;0;.00nan;0;0
29925;22684;632;0;0;0;0;.00nan;0;0
29925;-1;642;0;0;0;0;.00nan;0;0
29925;197595;632;53;32;4;28;.875;3600000;0
29925;151728;642;91;29;1;28;.966;3600000;0
29926;1838;628;0;0;0;0;.00nan;0;0
29926;174209;631;0;0;0;0;.00nan;0;0
29926;144705;631;58;40;5;35;.875;3600000;0
29926;161336;628;89;29;1;28;.966;3600000;0
29927;192739;639;0;0;0;0;.00nan;0;0
29927;168651;651;32;29;6;23;.793;2556000;0
29927;195761;651;53;18;2;16;.889;1044000;0
29927;149969;639;73;31;3;28;.903;3600000;0
29928;190508;626;65;32;3;29;.906;3563000;0
29928;67362;1814;0;0;0;0;.00nan;0;0
29928;145079;626;0;0;0;0;.00nan;0;0
29928;156632;1814;78;25;1;24;.960;3600000;0
29929;8424;627;69;16;1;15;.938;3600000;0
29929;176963;627;0;0;0;0;.00nan;0;0
29929;73274;637;67;48;6;42;.875;3077000;0
29929;160906;637;55;5;0;5;1.000;523000;0
29930;168651;651;58;34;4;30;.882;3596000;0
29930;22684;632;76;36;3;33;.917;3600000;0
29930;195761;651;0;0;0;0;.00nan;0;0
29930;197595;632;0;0;0;0;.00nan;0;0
29931;1838;628;0;0;0;0;.00nan;0;0
29931;67362;1814;41;30;6;24;.800;2789000;0
29931;156632;1814;49;2;0;2;1.000;739000;0
29931;161336;628;63;33;4;29;.879;3600000;0
29932;174209;631;0;0;0;0;.00nan;0;0
29932;190508;626;88;22;1;21;.955;3600000;0
29932;144705;631;61;32;4;28;.875;3600000;0
29932;145079;626;0;0;0;0;.00nan;0;0
29933;11068;641;0;0;0;0;.00nan;0;0
29933;-1;641;73;51;5;46;.902;3600000;0
29933;186641;625;76;17;1;16;.941;3600000;0
29933;145038;625;0;0;0;0;.00nan;0;0
29934;-1;642;0;0;0;0;.00nan;0;0
29934;181431;636;54;22;3;19;.864;3534000;0
29934;38277;636;0;0;0;0;.00nan;0;0
29934;151728;642;91;34;1;33;.971;3600000;0
29935;192739;639;74;40;3;37;.925;3600000;0
29935;193854;1836;56;32;4;28;.875;3584000;0
29935;-1;1836;0;0;0;0;.00nan;0;0
29935;149969;639;0;0;0;0;.00nan;0;0
29936;192739;639;64;17;1;16;.941;1099000;0
29936;8424;627;0;0;0;0;.00nan;0;0
29936;176963;627;72;28;2;26;.929;3600000;0
29936;149969;639;34;27;6;21;.778;2501000;0
29937;174209;631;0;0;0;0;.00nan;0;0
29937;73274;637;89;49;3;46;.939;3590000;0
29937;144705;631;70;23;2;21;.913;3600000;0
29937;160906;637;0;0;0;0;.00nan;0;0
29938;1838;628;0;0;0;0;.00nan;0;0
29938;193854;1836;75;33;2;31;.939;3900000;0
29938;-1;1836;0;0;0;0;.00nan;0;0
29938;161336;628;89;30;2;28;.933;3900000;0
29939;11068;641;97;54;2;52;.963;3900000;0
29939;181431;636;88;31;2;29;.935;3900000;0
29939;38277;636;0;0;0;0;.00nan;0;0
29939;-1;641;0;0;0;0;.00nan;0;0
29940;22684;632;0;0;0;0;.00nan;0;0
29940;190508;626;0;0;0;0;.00nan;0;0
29940;197595;632;85;36;3;33;.917;3843000;0
29940;145079;626;62;27;2;25;.926;3843000;0
29941;-1;642;0;0;0;0;.00nan;0;0
29941;186641;625;62;21;2;19;.905;3600000;0
29941;145038;625;0;0;0;0;.00nan;0;0
29941;151728;642;57;40;5;35;.875;3600000;0
29942;168651;651;85;40;2;38;.950;3600000;0
29942;195761;651;0;0;0;0;.00nan;0;0
29942;67362;1814;72;21;1;20;.952;3600000;0
29942;156632;1814;0;0;0;0;.00nan;0;0
29943;186641;625;55;29;4;25;.862;3900000;0
29943;73274;637;0;0;0;0;.00nan;0;0
29943;145038;625;0;0;0;0;.00nan;0;0
29943;160906;637;75;39;4;35;.897;3900000;0
29944;168651;651;71;16;0;16;1.000;1915000;0
29944;195761;651;1;17;7;10;.588;1685000;0
29944;190508;626;100;26;0;26;1.000;3600000;0
29944;145079;626;0;0;0;0;.00nan;0;0
29945;8424;627;57;31;4;27;.871;3600000;0
29945;174209;631;0;0;0;0;.00nan;0;0
29945;176963;627;0;0;0;0;.00nan;0;0
29945;144705;631;67;21;1;20;.952;3600000;0
29946;22684;632;0;0;0;0;.00nan;0;0
29946;181431;636;61;12;1;11;.917;3600000;0
29946;38277;636;0;0;0;0;.00nan;0;0
29946;197595;632;97;48;3;45;.938;3600000;0
29947;193854;1836;82;36;3;33;.917;3583000;0
29947;-1;1836;0;0;0;0;.00nan;0;0
29947;67362;1814;77;34;2;32;.941;3600000;0
29947;156632;1814;0;0;0;0;.00nan;0;0
29948;192739;639;56;31;4;27;.871;3600000;0
29948;1838;628;0;0;0;0;.00nan;0;0
29948;149969;639;0;0;0;0;.00nan;0;0
29948;161336;628;72;21;1;20;.952;3600000;0
29949;8424;627;82;32;3;29;.906;3900000;0
29949;22684;632;0;0;0;0;.00nan;0;0
29949;176963;627;0;0;0;0;.00nan;0;0
29949;197595;632;73;38;3;35;.921;3900000;0
29950;11068;641;0;0;0;0;.00nan;0;0
29950;-1;642;0;0;0;0;.00nan;0;0
29950;-1;641;61;29;3;26;.897;3600000;0
29950;151728;642;97;25;0;25;1.000;3600000;0
29951;192739;639;86;38;2;36;.947;3600000;0
29951;186641;625;100;22;0;22;1.000;3600000;0
29951;145038;625;0;0;0;0;.00nan;0;0
29951;149969;639;0;0;0;0;.00nan;0;0
29952;193854;1836;94;26;1;25;.962;3600000;0
29952;-1;642;81;26;2;24;.923;2722000;0
29952;-1;1836;0;0;0;0;.00nan;0;0
29952;151728;642;33;18;4;14;.778;878000;0
29953;11068;641;50;43;6;37;.860;2742000;0
29953;174209;631;0;0;0;0;.00nan;0;0
29953;-1;641;65;10;0;10;1.000;858000;0
29953;144705;631;55;10;1;9;.900;3600000;0
29954;8424;627;0;0;0;0;.00nan;0;0
29954;176963;627;65;21;2;19;.905;3600000;0
29954;67362;1814;63;47;5;42;.894;3349000;0
29954;156632;1814;58;8;0;8;1.000;251000;0
29955;22684;632;95;36;1;35;.972;3600000;0
29955;197595;632;0;0;0;0;.00nan;0;0
29955;73274;637;86;33;2;31;.939;3565000;0
29955;160906;637;0;0;0;0;.00nan;0;0
29956;168651;651;53;38;5;33;.868;3600000;0
29956;195761;651;0;0;0;0;.00nan;0;0
29956;181431;636;94;27;0;27;1.000;3600000;0
29956;38277;636;0;0;0;0;.00nan;0;0
29957;1838;628;0;0;0;0;.00nan;0;0
29957;190508;626;51;23;3;20;.870;3600000;0
29957;145079;626;0;0;0;0;.00nan;0;0
29957;161336;628;23;34;7;27;.794;3600000;0
29958;11068;641;81;38;3;35;.921;3600000;0
29958;168651;651;59;42;5;37;.881;3562000;0
29958;195761;651;0;0;0;0;.00nan;0;0
29958;-1;641;0;0;0;0;.00nan;0;0
29959;190508;626;64;32;3;29;.906;3542000;0
29959;186641;625;70;19;1;18;.947;3600000;0
29959;145038;625;0;0;0;0;.00nan;0;0
29959;145079;626;0;0;0;0;.00nan;0;0
29960;1838;628;0;0;0;0;.00nan;0;0
29960;174209;631;0;0;0;0;.00nan;0;0
29960;144705;631;95;45;3;42;.933;3600000;0
29960;161336;628;55;35;5;30;.857;3536000;0
29961;193854;1836;79;24;1;23;.958;3600000;0
29961;181431;636;72;34;2;32;.941;3584000;0
29961;38277;636;0;0;0;0;.00nan;0;0
29961;-1;1836;0;0;0;0;.00nan;0;0
29962;-1;642;64;16;1;15;.938;1225000;0
29962;67362;1814;0;0;0;0;.00nan;0;0
29962;151728;642;32;31;6;25;.806;2375000;0
29962;156632;1814;73;18;1;17;.944;3600000;0
29963;192739;639;80;32;2;30;.938;3600000;0
29963;73274;637;63;46;5;41;.891;3600000;0
29963;149969;639;0;0;0;0;.00nan;0;0
29963;160906;637;0;0;0;0;.00nan;0;0
29964;174209;631;0;0;0;0;.00nan;0;0
29964;-1;642;0;0;0;0;.00nan;0;0
29964;144705;631;91;19;0;19;1.000;3600000;0
29964;151728;642;56;37;5;32;.865;3600000;0
29965;181431;636;85;24;1;23;.958;3600000;0
29965;38277;636;0;0;0;0;.00nan;0;0
29965;87603;639;0;0;0;0;.00nan;0;0
29965;149969;639;92;44;3;41;.932;3549000;0
29966;22684;632;0;0;0;0;.00nan;0;0
29966;197595;632;89;49;3;46;.939;3900000;0
29966;67362;1814;50;16;3;13;.813;3890000;0
29966;156632;1814;0;0;0;0;.00nan;0;0
29967;190508;626;83;39;3;36;.923;3545000;0
29967;73274;637;63;25;2;23;.920;3600000;0
29967;145079;626;0;0;0;0;.00nan;0;0
29967;160906;637;0;0;0;0;.00nan;0;0
29968;1838;628;0;0;0;0;.00nan;0;0
29968;8424;627;72;34;3;31;.912;3589000;0
29968;176963;627;0;0;0;0;.00nan;0;0
29968;161336;628;75;19;1;18;.947;3600000;0
29969;186641;625;0;0;0;0;.00nan;0;0
29969;67362;1814;63;27;2;25;.926;3564000;0
29969;145038;625;94;35;1;34;.971;3600000;0
29969;156632;1814;0;0;0;0;.00nan;0;0
29970;11068;641;96;23;0;23;1.000;3600000;0
29970;-1;641;0;0;0;0;.00nan;0;0
29970;87603;639;0;0;0;0;.00nan;0;0
29970;149969;639;92;35;2;33;.943;3524000;0
29971;193854;1836;82;22;1;21;.955;3600000;0
29971;22684;632;58;32;5;27;.844;3600000;0
29971;-1;1836;0;0;0;0;.00nan;0;0
29971;197595;632;0;0;0;0;.00nan;0;0
29972;174209;631;0;0;0;0;.00nan;0;0
29972;181431;636;76;27;2;25;.926;3600000;0
29972;38277;636;0;0;0;0;.00nan;0;0
29972;144705;631;55;29;4;25;.862;3545000;0
29973;168651;651;33;34;7;27;.794;2946000;0
29973;195761;651;62;9;0;9;1.000;654000;0
29973;-1;642;0;0;0;0;.00nan;0;0
29973;151728;642;75;30;2;28;.933;3600000;0
29974;8424;627;0;0;0;0;.00nan;0;0
29974;176963;627;55;33;4;29;.879;3600000;0
29974;186641;625;49;19;3;16;.842;3600000;0
29974;145038;625;0;0;0;0;.00nan;0;0
29975;193854;1836;0;0;0;0;.00nan;0;0
29975;174209;631;0;0;0;0;.00nan;0;0
29975;-1;1836;56;29;4;25;.862;3781000;0
29975;144705;631;89;43;3;40;.930;3781000;0
29976;1838;628;0;0;0;0;.00nan;0;0
29976;22684;632;0;0;0;0;.00nan;0;0
29976;197595;632;88;30;2;28;.933;3900000;0
29976;161336;628;79;38;2;36;.947;3900000;0
29977;168651;651;72;34;3;31;.912;3545000;0
29977;195761;651;0;0;0;0;.00nan;0;0
29977;73274;637;83;28;2;26;.929;3600000;0
29977;160906;637;0;0;0;0;.00nan;0;0
29978;11068;641;62;31;4;27;.871;3600000;0
29978;190508;626;12;10;5;5;.500;928000;0
29978;-1;641;0;0;0;0;.00nan;0;0
29978;145079;626;45;12;2;10;.833;2672000;0
29979;181431;636;65;34;3;31;.912;3574000;0
29979;38277;636;0;0;0;0;.00nan;0;0
29979;67362;1814;87;28;2;26;.929;3600000;0
29979;156632;1814;0;0;0;0;.00nan;0;0
29980;-1;642;0;0;0;0;.00nan;0;0
29980;87603;639;0;0;0;0;.00nan;0;0
29980;149969;639;35;17;4;13;.765;3576000;0
29980;151728;642;83;34;2;32;.941;3600000;0
29981;8424;627;66;36;3;33;.917;3887000;0
29981;176963;627;0;0;0;0;.00nan;0;0
29981;190508;626;0;0;0;0;.00nan;0;0
29981;145079;626;92;45;3;42;.933;3900000;0
29982;22684;632;0;0;0;0;.00nan;0;0
29982;-1;642;0;0;0;0;.00nan;0;0
29982;197595;632;60;29;4;25;.862;3600000;0
29982;151728;642;38;25;5;20;.800;3571000;0
29983;174209;631;0;0;0;0;.00nan;0;0
29983;87603;639;0;0;0;0;.00nan;0;0
29983;144705;631;58;28;3;25;.893;3581000;0
29983;149969;639;87;30;1;29;.967;3600000;0
29984;181431;636;99;29;0;29;1.000;3600000;0
29984;38277;636;0;0;0;0;.00nan;0;0
29984;-1;637;53;11;1;10;.909;1437000;0
29984;73274;637;34;29;6;23;.793;2163000;0
29985;8424;627;0;0;0;0;.00nan;0;0
29985;11068;641;87;56;4;52;.929;3550000;0
29985;176963;627;36;13;3;10;.769;3600000;0
29985;-1;641;0;0;0;0;.00nan;0;0
29986;193854;1836;82;38;3;35;.921;3595000;0
29986;168651;651;100;40;1;39;.975;3600000;0
29986;195761;651;0;0;0;0;.00nan;0;0
29986;-1;1836;0;0;0;0;.00nan;0;0
29987;1838;628;0;0;0;0;.00nan;0;0
29987;186641;625;73;10;0;10;1.000;3600000;0
29987;145038;625;0;0;0;0;.00nan;0;0
29987;161336;628;71;36;3;33;.917;3600000;0
29988;190508;626;77;27;1;26;.963;3600000;0
29988;67362;1814;57;20;2;18;.900;3572000;0
29988;145079;626;0;0;0;0;.00nan;0;0
29988;156632;1814;0;0;0;0;.00nan;0;0
29989;1838;628;0;0;0;0;.00nan;0;0
29989;-1;637;0;0;0;0;.00nan;0;0
29989;73274;637;97;48;3;45;.938;3600000;0
29989;161336;628;100;18;0;18;1.000;3600000;0
29990;193854;1836;97;30;1;29;.967;3600000;0
29990;190508;626;83;38;3;35;.921;3549000;0
29990;-1;1836;0;0;0;0;.00nan;0;0
29990;145079;626;0;0;0;0;.00nan;0;0
29991;8424;627;59;16;2;14;.875;3600000;0
29991;176963;627;0;0;0;0;.00nan;0;0
29991;-1;642;0;0;0;0;.00nan;0;0
29991;151728;642;88;49;3;46;.939;3590000;0
29992;22684;632;0;0;0;0;.00nan;0;0
29992;174209;631;0;0;0;0;.00nan;0;0
29992;197595;632;92;41;2;39;.951;3556000;0
29992;144705;631;100;30;0;30;1.000;3600000;0
29993;181431;636;48;26;4;22;.846;3590000;0
29993;38277;636;0;0;0;0;.00nan;0;0
29993;186641;625;60;18;2;16;.889;3600000;0
29993;145038;625;0;0;0;0;.00nan;0;0
29994;11068;641;100;38;0;38;1.000;3600000;0
29994;-1;641;0;0;0;0;.00nan;0;0
29994;67362;1814;59;21;2;19;.905;3522000;0
29994;156632;1814;0;0;0;0;.00nan;0;0
29995;168651;651;44;33;6;27;.818;2540000;0
29995;195761;651;82;22;1;21;.955;1060000;0
29995;87603;639;0;0;0;0;.00nan;0;0
29995;149969;639;71;13;1;12;.923;3600000;0
29996;1838;628;0;0;0;0;.00nan;0;0
29996;11068;641;54;38;5;33;.868;3600000;0
29996;-1;641;0;0;0;0;.00nan;0;0
29996;161336;628;87;18;0;18;1.000;3600000;0
29997;168651;651;51;11;1;10;.909;783000;0
29997;195761;651;36;37;6;31;.838;2817000;0
29997;186641;625;60;14;1;13;.929;3600000;0
29997;145038;625;0;0;0;0;.00nan;0;0
29998;193854;1836;97;33;1;32;.970;3600000;0
29998;-1;1836;0;0;0;0;.00nan;0;0
29998;-1;637;0;0;0;0;.00nan;0;0
29998;73274;637;77;33;3;30;.909;3600000;0
29999;-1;637;0;0;0;0;.00nan;0;0
29999;67362;1814;88;12;0;12;1.000;3600000;0
29999;73274;637;45;52;8;44;.846;3600000;0
29999;156632;1814;0;0;0;0;.00nan;0;0
30000;11068;641;99;40;1;39;.975;3600000;0
30000;193854;1836;58;20;2;18;.900;3576000;0
30000;-1;641;0;0;0;0;.00nan;0;0
30000;-1;1836;0;0;0;0;.00nan;0;0
30001;1838;628;0;0;0;0;.00nan;0;0
30001;168651;651;95;48;3;45;.938;3600000;0
30001;195761;651;0;0;0;0;.00nan;0;0
30001;161336;628;50;25;4;21;.840;3600000;0
30002;-1;642;0;0;0;0;.00nan;0;0
30002;190508;626;79;22;1;21;.955;3600000;0
30002;145079;626;0;0;0;0;.00nan;0;0
30002;151728;642;54;31;4;27;.871;3600000;0
30003;174209;631;48;7;1;6;.857;809000;0
30003;186641;625;48;25;4;21;.840;3600000;0
30003;144705;631;54;41;6;35;.854;2791000;0
30003;145038;625;0;0;0;0;.00nan;0;0
30004;8424;627;0;0;0;0;.00nan;0;0
30004;176963;627;91;19;0;19;1.000;3600000;0
30004;181431;636;0;0;0;0;.00nan;0;0
30004;38277;636;97;39;1;38;.974;3565000;0
30005;22684;632;0;0;0;0;.00nan;0;0
30005;197595;632;78;35;3;32;.914;3600000;0
30005;87603;639;74;27;2;25;.926;2946000;0
30005;149969;639;30;7;3;4;.571;571000;0
30006;8424;627;53;29;4;25;.862;3539000;0
30006;193854;1836;0;0;0;0;.00nan;0;0
30006;176963;627;0;0;0;0;.00nan;0;0
30006;-1;1836;73;28;2;26;.929;3600000;0
30007;11068;641;82;41;3;38;.927;3600000;0
30007;-1;641;0;0;0;0;.00nan;0;0
30007;-1;637;0;0;0;0;.00nan;0;0
30007;73274;637;51;37;5;32;.865;3513000;0
30008;1838;628;0;0;0;0;.00nan;0;0
30008;-1;642;0;0;0;0;.00nan;0;0
30008;151728;642;60;43;5;38;.884;3600000;0
30008;161336;628;61;16;1;15;.938;3600000;0
30009;168651;651;97;39;1;38;.974;3900000;0
30009;174209;631;0;0;0;0;.00nan;0;0
30009;195761;651;0;0;0;0;.00nan;0;0
30009;144705;631;91;23;1;22;.957;3900000;0
30010;190508;626;0;0;0;0;.00nan;0;0
30010;181431;636;83;35;2;33;.943;3549000;0
30010;38277;636;0;0;0;0;.00nan;0;0
30010;145079;626;90;36;1;35;.972;3600000;0
30011;22684;632;57;12;1;11;.917;1264000;0
30011;186641;625;70;28;2;26;.929;3600000;0
30011;197595;632;20;34;7;27;.794;2336000;0
30011;145038;625;0;0;0;0;.00nan;0;0
30012;67362;1814;69;18;1;17;.944;3600000;0
30012;87603;639;0;0;0;0;.00nan;0;0
30012;149969;639;66;37;4;33;.892;3600000;0
30012;156632;1814;0;0;0;0;.00nan;0;0
30013;8424;627;0;0;0;0;.00nan;0;0
30013;168651;651;100;50;2;48;.960;3900000;0
30013;195761;651;0;0;0;0;.00nan;0;0
30013;176963;627;89;30;2;28;.933;3900000;0
30014;11068;641;98;35;1;34;.971;3900000;0
30014;22684;632;0;0;0;0;.00nan;0;0
30014;-1;641;0;0;0;0;.00nan;0;0
30014;197595;632;81;31;1;30;.968;3900000;0
30015;1838;628;0;0;0;0;.00nan;0;0
30015;181431;636;76;39;4;35;.897;3600000;0
30015;38277;636;0;0;0;0;.00nan;0;0
30015;161336;628;86;26;1;25;.962;3600000;0
30016;174209;631;71;33;3;30;.909;3600000;0
30016;67362;1814;33;31;6;25;.806;3216000;0
30016;144705;631;0;0;0;0;.00nan;0;0
30016;156632;1814;49;1;0;1;1.000;384000;0
30017;-1;642;96;37;1;36;.973;3900000;0
30017;-1;637;0;0;0;0;.00nan;0;0
30017;73274;637;68;21;1;20;.952;3900000;0
30017;151728;642;0;0;0;0;.00nan;0;0
30018;193854;1836;73;30;2;28;.933;3595000;0
30018;-1;1836;0;0;0;0;.00nan;0;0
30018;186641;625;100;38;0;38;1.000;3600000;0
30018;145038;625;0;0;0;0;.00nan;0;0
30019;190508;626;91;20;0;20;1.000;3600000;0
30019;87603;639;0;0;0;0;.00nan;0;0
30019;145079;626;0;0;0;0;.00nan;0;0
30019;149969;639;44;32;5;27;.844;3600000;0
30021;168651;651;43;30;4;26;.867;3545000;0
30021;195761;651;0;0;0;0;.00nan;0;0
30021;190508;626;68;30;3;27;.900;3600000;0
30021;145079;626;0;0;0;0;.00nan;0;0
30023;1838;628;0;0;0;0;.00nan;0;0
30023;174209;631;0;0;0;0;.00nan;0;0
30023;144705;631;64;42;4;38;.905;3545000;0
30023;161336;628;76;28;2;26;.929;3600000;0
30025;186641;625;67;32;3;29;.906;3600000;0
30025;65823;627;54;5;0;5;1.000;575000;0
30025;85468;627;31;28;6;22;.786;3025000;0
30025;145038;625;0;0;0;0;.00nan;0;0
30027;22684;632;74;25;2;23;.920;3900000;0
30027;-1;642;0;0;0;0;.00nan;0;0
30027;197595;632;0;0;0;0;.00nan;0;0
30027;151728;642;82;40;2;38;.950;3900000;0
30029;193854;1836;84;27;1;26;.963;3600000;0
30029;181431;636;76;29;2;27;.931;3568000;0
30029;38277;636;0;0;0;0;.00nan;0;0
30029;-1;1836;0;0;0;0;.00nan;0;0
30031;-1;637;0;0;0;0;.00nan;0;0
30031;67362;1814;72;26;2;24;.923;3600000;0
30031;73274;637;42;24;4;20;.833;3525000;0
30031;156632;1814;0;0;0;0;.00nan;0;0
30033;192739;639;0;0;0;0;.00nan;0;0
30033;11068;641;57;34;4;30;.882;3573000;0
30033;-1;641;0;0;0;0;.00nan;0;0
30033;149969;639;64;22;2;20;.909;3600000;0
30035;193854;1836;69;6;0;6;1.000;566000;0
30035;174209;631;79;26;1;25;.962;3600000;0
30035;-1;1836;62;46;6;40;.870;3034000;0
30035;144705;631;0;0;0;0;.00nan;0;0
30037;-1;642;50;31;4;27;.871;3600000;0
30037;190508;626;0;0;0;0;.00nan;0;0
30037;145079;626;66;19;1;18;.947;3600000;0
30037;151728;642;0;0;0;0;.00nan;0;0
30039;1838;628;43;13;3;10;.769;3600000;0
30039;11068;641;50;1;0;1;1.000;256000;0
30039;-1;641;66;62;7;55;.887;3344000;0
30039;161336;628;0;0;0;0;.00nan;0;0
30041;65823;627;82;41;3;38;.927;3533000;0
30041;67362;1814;0;0;0;0;.00nan;0;0
30041;85468;627;0;0;0;0;.00nan;0;0
30041;156632;1814;76;27;1;26;.963;3600000;0
30043;181431;636;0;0;0;0;.00nan;0;0
30043;38277;636;68;45;5;40;.889;3600000;0
30043;186641;625;0;0;0;0;.00nan;0;0
30043;145038;625;73;32;2;30;.938;3600000;0
30045;192739;639;70;29;2;27;.931;3814000;0
30045;22684;632;0;0;0;0;.00nan;0;0
30045;197595;632;54;22;3;19;.864;3814000;0
30045;149969;639;0;0;0;0;.00nan;0;0
30047;168651;651;0;0;0;0;.00nan;0;0
30047;195761;651;51;31;4;27;.871;3544000;0
30047;-1;637;63;24;3;21;.875;3600000;0
30047;73274;637;0;0;0;0;.00nan;0;0
30049;192739;639;0;0;0;0;.00nan;0;0
30049;186641;625;54;20;3;17;.850;3600000;0
30049;145038;625;0;0;0;0;.00nan;0;0
30049;149969;639;63;35;4;31;.886;3600000;0
30051;168651;651;78;47;5;42;.894;3600000;0
30051;195761;651;0;0;0;0;.00nan;0;0
30051;181431;636;29;23;6;17;.739;3566000;0
30051;38277;636;0;0;0;0;.00nan;0;0
30053;174209;631;0;0;0;0;.00nan;0;0
30053;67362;1814;100;37;1;36;.973;3600000;0
30053;144705;631;68;35;3;32;.914;3512000;0
30053;156632;1814;0;0;0;0;.00nan;0;0
30055;193854;1836;85;36;2;34;.944;3600000;0
30055;22684;632;0;0;0;0;.00nan;0;0
30055;-1;1836;0;0;0;0;.00nan;0;0
30055;197595;632;69;43;4;39;.907;3599000;0
30057;190508;626;78;24;1;23;.958;3600000;0
30057;-1;637;0;0;0;0;.00nan;0;0
30057;73274;637;61;33;4;29;.879;3600000;0
30057;145079;626;0;0;0;0;.00nan;0;0
30059;11068;641;70;29;2;27;.931;3597000;0
30059;-1;642;0;0;0;0;.00nan;0;0
30059;-1;641;0;0;0;0;.00nan;0;0
30059;151728;642;79;25;1;24;.960;3600000;0
30061;1838;628;0;0;0;0;.00nan;0;0
30061;65823;627;85;36;2;34;.944;3600000;0
30061;85468;627;0;0;0;0;.00nan;0;0
30061;161336;628;67;24;3;21;.875;3567000;0
30063;22684;632;100;41;2;39;.951;3628000;0
30063;197595;632;0;0;0;0;.00nan;0;0
30063;65823;627;0;0;0;0;.00nan;0;0
30063;85468;627;55;20;3;17;.850;3628000;0
30065;168651;651;0;0;0;0;.00nan;0;0
30065;195761;651;78;48;4;44;.917;3600000;0
30065;67362;1814;0;0;0;0;.00nan;0;0
30065;156632;1814;79;26;1;25;.962;3600000;0
30067;181431;636;0;0;0;0;.00nan;0;0
30067;38277;636;100;32;0;32;1.000;3600000;0
30067;186641;625;0;0;0;0;.00nan;0;0
30067;145038;625;66;37;4;33;.892;3600000;0
30069;1838;628;71;22;1;21;.955;3600000;0
30069;193854;1836;0;0;0;0;.00nan;0;0
30069;-1;1836;68;51;5;46;.902;3600000;0
30069;161336;628;0;0;0;0;.00nan;0;0
30071;192739;639;98;51;2;49;.961;3600000;0
30071;190508;626;0;0;0;0;.00nan;0;0
30071;145079;626;86;32;1;31;.969;3600000;0
30071;149969;639;0;0;0;0;.00nan;0;0
30073;-1;642;94;23;0;23;1.000;3600000;0
30073;-1;637;52;24;3;21;.875;3600000;0
30073;73274;637;0;0;0;0;.00nan;0;0
30073;151728;642;0;0;0;0;.00nan;0;0
30075;11068;641;0;0;0;0;.00nan;0;0
30075;174209;631;79;19;1;18;.947;3600000;0
30075;-1;641;93;40;2;38;.950;3550000;0
30075;144705;631;0;0;0;0;.00nan;0;0
30077;186641;625;38;27;5;22;.815;3600000;0
30077;67362;1814;100;41;2;39;.951;3600000;0
30077;145038;625;0;0;0;0;.00nan;0;0
30077;156632;1814;0;0;0;0;.00nan;0;0
30079;1838;628;0;0;0;0;.00nan;0;0
30079;22684;632;76;45;4;41;.911;3600000;0
30079;197595;632;0;0;0;0;.00nan;0;0
30079;161336;628;68;24;2;22;.917;3600000;0
30081;168651;651;83;47;4;43;.915;3573000;0
30081;174209;631;0;0;0;0;.00nan;0;0
30081;195761;651;0;0;0;0;.00nan;0;0
30081;144705;631;43;16;3;13;.813;3600000;0
30083;-1;642;0;0;0;0;.00nan;0;0
30083;-1;637;0;0;0;0;.00nan;0;0
30083;73274;637;52;31;5;26;.839;3573000;0
30083;151728;642;97;36;3;33;.917;3600000;0
30085;192739;639;0;0;0;0;.00nan;0;0
30085;190508;626;53;32;4;28;.875;3833000;0
30085;145079;626;0;0;0;0;.00nan;0;0
30085;149969;639;74;32;3;29;.906;3833000;0
30087;11068;641;35;26;5;21;.808;2006000;0
30087;193854;1836;83;36;3;33;.917;3600000;0
30087;-1;641;23;13;4;9;.692;1594000;0
30087;-1;1836;0;0;0;0;.00nan;0;0
30089;181431;636;0;0;0;0;.00nan;0;0
30089;38277;636;94;38;2;36;.947;3514000;0
30089;65823;627;100;35;0;35;1.000;3600000;0
30089;85468;627;0;0;0;0;.00nan;0;0
30091;1838;628;36;14;4;10;.714;3669000;0
30091;22684;632;0;0;0;0;.00nan;0;0
30091;197595;632;89;50;3;47;.940;3669000;0
30091;161336;628;0;0;0;0;.00nan;0;0
30093;168651;651;91;52;4;48;.923;3600000;0
30093;195761;651;0;0;0;0;.00nan;0;0
30093;65823;627;83;14;0;14;1.000;3600000;0
30093;85468;627;0;0;0;0;.00nan;0;0
30095;11068;641;0;0;0;0;.00nan;0;0
30095;-1;642;58;34;4;30;.882;3546000;0
30095;-1;641;60;28;3;25;.893;3600000;0
30095;151728;642;0;0;0;0;.00nan;0;0
30097;192739;639;64;40;4;36;.900;3588000;0
30097;-1;637;66;30;3;27;.900;3600000;0
30097;73274;637;0;0;0;0;.00nan;0;0
30097;149969;639;0;0;0;0;.00nan;0;0
30099;193854;1836;0;0;0;0;.00nan;0;0
30099;-1;1836;22;34;7;27;.794;3600000;0
30099;67362;1814;0;0;0;0;.00nan;0;0
30099;156632;1814;63;33;3;30;.909;3600000;0
30101;174209;631;92;33;1;32;.970;3600000;0
30101;181431;636;92;47;3;44;.936;3541000;0
30101;38277;636;0;0;0;0;.00nan;0;0
30101;144705;631;0;0;0;0;.00nan;0;0
30103;190508;626;0;0;0;0;.00nan;0;0
30103;186641;625;0;0;0;0;.00nan;0;0
30103;145038;625;67;28;3;25;.893;3600000;0
30103;145079;626;43;28;4;24;.857;3561000;0
30105;193854;1836;41;38;6;32;.842;3891000;0
30105;-1;1836;0;0;0;0;.00nan;0;0
30105;67362;1814;63;47;6;41;.872;3900000;0
30105;156632;1814;0;0;0;0;.00nan;0;0
30107;11068;641;0;0;0;0;.00nan;0;0
30107;168651;651;100;33;0;33;1.000;3600000;0
30107;195761;651;0;0;0;0;.00nan;0;0
30107;-1;641;86;30;1;29;.967;3589000;0
30109;190508;626;47;31;5;26;.839;3562000;0
30109;-1;637;0;0;0;0;.00nan;0;0
30109;73274;637;94;47;3;44;.936;3600000;0
30109;145079;626;0;0;0;0;.00nan;0;0
30111;22684;632;58;46;6;40;.870;3600000;0
30111;186641;625;80;30;2;28;.933;3600000;0
30111;197595;632;0;0;0;0;.00nan;0;0
30111;145038;625;0;0;0;0;.00nan;0;0
30113;-1;642;0;0;0;0;.00nan;0;0
30113;181431;636;46;27;4;23;.852;3569000;0
30113;38277;636;0;0;0;0;.00nan;0;0
30113;151728;642;74;28;3;25;.893;3600000;0
30115;192739;639;0;0;0;0;.00nan;0;0
30115;65823;627;42;24;5;19;.792;3600000;0
30115;85468;627;0;0;0;0;.00nan;0;0
30115;149969;639;99;43;2;41;.953;3600000;0
30117;1838;628;0;0;0;0;.00nan;0;0
30117;174209;631;0;0;0;0;.00nan;0;0
30117;144705;631;84;27;1;26;.963;3600000;0
30117;161336;628;53;30;4;26;.867;3600000;0
1212;11068;641;74;32;2;30;.938;3600000;0
1212;181431;636;40;25;4;21;.840;3513000;0
1212;38277;636;0;0;0;0;.00nan;0;0
1212;-1;641;0;0;0;0;.00nan;0;0
1213;190508;626;100;23;0;23;1.000;3600000;0
1213;-1;637;0;0;0;0;.00nan;0;0
1213;73274;637;52;28;4;24;.857;3600000;0
1213;145079;626;0;0;0;0;.00nan;0;0
1214;11068;641;91;38;2;36;.947;3600000;0
1214;181431;636;20;9;4;5;.556;696000;0
1214;38277;636;74;17;0;17;1.000;2882000;0
1214;-1;641;0;0;0;0;.00nan;0;0
1215;190508;626;71;27;3;24;.889;3600000;0
1215;-1;637;37;7;2;5;.714;1067000;0
1215;73274;637;32;27;6;21;.778;2533000;0
1215;145079;626;0;0;0;0;.00nan;0;0
1333;11068;641;25;27;6;21;.778;2652000;0
1333;-1;641;55;13;1;12;.923;948000;0
1333;186641;625;57;17;2;15;.882;3600000;0
1333;145038;625;0;0;0;0;.00nan;0;0
1334;8424;627;0;0;0;0;.00nan;0;0
1334;174209;631;82;24;0;24;1.000;2493000;0
1334;176963;627;64;21;2;19;.905;3600000;0
1334;144705;631;31;16;4;12;.750;1050000;0
1335;1838;628;0;0;0;0;.00nan;0;0
1335;193854;1836;85;23;1;22;.957;3600000;0
1335;-1;1836;0;0;0;0;.00nan;0;0
1335;161336;628;65;27;3;24;.889;3523000;0
1336;190508;626;32;21;5;16;.762;3592000;0
1336;67362;1814;62;31;4;27;.871;3600000;0
1336;145079;626;0;0;0;0;.00nan;0;0
1336;156632;1814;0;0;0;0;.00nan;0;0
1337;11068;641;86;50;4;46;.920;3600000;0
1337;-1;641;0;0;0;0;.00nan;0;0
1337;186641;625;62;10;1;9;.900;3600000;0
1337;145038;625;0;0;0;0;.00nan;0;0
1338;8424;627;75;24;1;23;.958;3579000;0
1338;174209;631;0;0;0;0;.00nan;0;0
1338;176963;627;0;0;0;0;.00nan;0;0
1338;144705;631;100;43;0;43;1.000;3600000;0
1339;1838;628;0;0;0;0;.00nan;0;0
1339;193854;1836;78;38;3;35;.921;4152000;0
1339;-1;1836;0;0;0;0;.00nan;0;0
1339;161336;628;55;25;4;21;.840;4152000;0
1340;190508;626;91;41;2;39;.951;4356000;0
1340;67362;1814;60;32;3;29;.906;4383000;0
1340;145079;626;0;0;0;0;.00nan;0;0
1340;156632;1814;0;0;0;0;.00nan;0;0
1341;11068;641;77;35;2;33;.943;3600000;0
1341;-1;641;0;0;0;0;.00nan;0;0
1341;186641;625;39;22;4;18;.818;3526000;0
1341;145038;625;0;0;0;0;.00nan;0;0
1342;8424;627;63;27;3;24;.889;4273000;0
1342;174209;631;0;0;0;0;.00nan;0;0
1342;176963;627;0;0;0;0;.00nan;0;0
1342;144705;631;70;37;4;33;.892;4273000;0
1343;1838;628;0;0;0;0;.00nan;0;0
1343;193854;1836;86;43;4;39;.907;3550000;0
1343;-1;1836;0;0;0;0;.00nan;0;0
1343;161336;628;53;26;3;23;.885;3600000;0
1344;190508;626;58;31;4;27;.871;3553000;0
1344;67362;1814;59;25;3;22;.880;3600000;0
1344;145079;626;0;0;0;0;.00nan;0;0
1344;156632;1814;0;0;0;0;.00nan;0;0
1345;11068;641;36;38;6;32;.842;3600000;0
1345;-1;641;0;0;0;0;.00nan;0;0
1345;186641;625;36;25;5;20;.800;3600000;0
1345;145038;625;0;0;0;0;.00nan;0;0
1346;8424;627;37;13;3;10;.769;3600000;0
1346;174209;631;0;0;0;0;.00nan;0;0
1346;176963;627;0;0;0;0;.00nan;0;0
1346;144705;631;83;48;5;43;.896;3512000;0
1347;1838;628;0;0;0;0;.00nan;0;0
1347;193854;1836;78;32;2;30;.938;3600000;0
1347;-1;1836;0;0;0;0;.00nan;0;0
1347;161336;628;42;31;6;25;.806;3600000;0
1348;190508;626;87;31;1;30;.968;3600000;0
1348;67362;1814;60;35;5;30;.857;3600000;0
1348;145079;626;0;0;0;0;.00nan;0;0
1348;156632;1814;0;0;0;0;.00nan;0;0
1614;11068;641;40;37;6;31;.838;3019000;0
1614;-1;641;47;6;1;5;.833;581000;0
1614;186641;625;77;23;1;22;.957;3600000;0
1614;145038;625;0;0;0;0;.00nan;0;0
1615;8424;627;81;25;1;24;.960;3600000;0
1615;174209;631;49;1;0;1;1.000;241000;0
1615;176963;627;0;0;0;0;.00nan;0;0
1615;144705;631;28;40;7;33;.825;3359000;0
1616;1838;628;0;0;0;0;.00nan;0;0
1616;193854;1836;96;51;1;50;.980;3600000;0
1616;-1;1836;0;0;0;0;.00nan;0;0
1616;161336;628;47;26;4;22;.846;3600000;0
1617;190508;626;31;29;6;23;.793;3600000;0
1617;67362;1814;92;27;1;26;.963;3600000;0
1617;145079;626;0;0;0;0;.00nan;0;0
1617;156632;1814;0;0;0;0;.00nan;0;0
1654;190508;626;97;38;2;36;.947;3583000;0
1654;67362;1814;85;24;1;23;.958;3600000;0
1654;145079;626;0;0;0;0;.00nan;0;0
1654;156632;1814;0;0;0;0;.00nan;0;0
1795;193854;1836;22;13;5;8;.615;762000;0
1795;-1;1836;93;29;0;29;1.000;2838000;0
1795;186641;625;93;24;1;23;.958;3600000;0
1795;145038;625;0;0;0;0;.00nan;0;0
1796;8424;627;75;39;4;35;.897;3791000;0
1796;176963;627;0;0;0;0;.00nan;0;0
1796;67362;1814;93;41;3;38;.927;3791000;0
1796;156632;1814;0;0;0;0;.00nan;0;0
1797;193854;1836;93;56;5;51;.911;3522000;0
1797;-1;1836;0;0;0;0;.00nan;0;0
1797;186641;625;66;29;3;26;.897;3600000;0
1797;145038;625;0;0;0;0;.00nan;0;0
1798;8424;627;60;19;2;17;.895;3600000;0
1798;176963;627;0;0;0;0;.00nan;0;0
1798;67362;1814;37;29;6;23;.793;2602000;0
1798;156632;1814;61;11;0;11;1.000;998000;0
1799;193854;1836;100;30;0;30;1.000;3600000;0
1799;-1;1836;0;0;0;0;.00nan;0;0
1799;186641;625;71;25;1;24;.960;3568000;0
1799;145038;625;0;0;0;0;.00nan;0;0
1800;8424;627;62;24;3;21;.875;3600000;0
1800;176963;627;0;0;0;0;.00nan;0;0
1800;67362;1814;64;36;4;32;.889;3600000;0
1800;156632;1814;0;0;0;0;.00nan;0;0
1801;193854;1836;34;26;5;21;.808;3600000;0
1801;-1;1836;0;0;0;0;.00nan;0;0
1801;186641;625;86;28;2;26;.929;3600000;0
1801;145038;625;0;0;0;0;.00nan;0;0
1802;8424;627;82;27;1;26;.963;3600000;0
1802;176963;627;0;0;0;0;.00nan;0;0
1802;67362;1814;97;46;2;44;.957;3546000;0
1802;156632;1814;0;0;0;0;.00nan;0;0
1960;193854;1836;61;33;4;29;.879;3600000;0
1960;-1;1836;0;0;0;0;.00nan;0;0
1960;186641;625;50;34;5;29;.853;3578000;0
1960;145038;625;0;0;0;0;.00nan;0;0
1961;8424;627;50;17;2;15;.882;3600000;0
1961;176963;627;0;0;0;0;.00nan;0;0
1961;67362;1814;74;38;3;35;.921;3589000;0
1961;156632;1814;0;0;0;0;.00nan;0;0
1991;193854;1836;83;51;4;47;.922;4353000;0
1991;-1;1836;0;0;0;0;.00nan;0;0
1991;186641;625;67;31;3;28;.903;4353000;0
1991;145038;625;0;0;0;0;.00nan;0;0
2042;8424;627;95;29;1;28;.966;3600000;0
2042;176963;627;0;0;0;0;.00nan;0;0
2042;186641;625;71;32;3;29;.906;3577000;0
2042;145038;625;0;0;0;0;.00nan;0;0
2043;8424;627;94;36;2;34;.944;3766000;0
2043;176963;627;0;0;0;0;.00nan;0;0
2043;186641;625;91;44;3;41;.932;3766000;0
2043;145038;625;0;0;0;0;.00nan;0;0
2044;8424;627;99;58;2;56;.966;5318000;0
2044;176963;627;0;0;0;0;.00nan;0;0
2044;186641;625;78;42;3;39;.929;5318000;0
2044;145038;625;0;0;0;0;.00nan;0;0
2045;8424;627;79;48;4;44;.917;4198000;0
2045;176963;627;0;0;0;0;.00nan;0;0
2045;186641;625;78;36;3;33;.917;4198000;0
2045;145038;625;0;0;0;0;.00nan;0;0
2296;8424;627;75;35;3;32;.914;3600000;0
2296;176963;627;0;0;0;0;.00nan;0;0
2296;186641;625;80;26;1;25;.962;3600000;0
2296;145038;625;0;0;0;0;.00nan;0;0
2365;8424;627;95;22;0;22;1.000;3600000;0
2365;176963;627;0;0;0;0;.00nan;0;0
2365;186641;625;80;32;2;30;.938;3593000;0
2365;145038;625;0;0;0;0;.00nan;0;0
30118;5573;836;0;0;0;0;.00nan;0;0
30118;167824;834;0;0;0;0;.00nan;0;0
30118;182116;836;84;28;1;27;.964;3600000;0
30118;67287;834;57;43;6;37;.860;3600000;0
30119;2410;838;0;0;0;0;.00nan;0;0
30119;174334;838;69;33;4;29;.879;3900000;0
30119;180287;847;88;43;4;39;.907;3900000;0
30119;89874;847;0;0;0;0;.00nan;0;0
30120;5573;836;0;0;0;0;.00nan;0;0
30120;182116;836;61;34;5;29;.853;3600000;0
30120;192688;831;55;30;4;26;.867;3600000;0
30120;89190;831;0;0;0;0;.00nan;0;0
30121;167824;834;40;26;5;21;.808;3600000;0
30121;183545;842;0;0;0;0;.00nan;0;0
30121;23433;842;91;35;2;33;.943;3600000;0
30121;67287;834;0;0;0;0;.00nan;0;0
30122;26336;829;69;49;5;44;.898;3600000;0
30122;53867;829;0;0;0;0;.00nan;0;0
30122;68390;828;69;18;1;17;.944;3600000;0
30122;147845;828;0;0;0;0;.00nan;0;0
30123;5663;833;0;0;0;0;.00nan;0;0
30123;16838;830;63;48;6;42;.875;3600000;0
30123;-1;833;55;12;1;11;.917;3600000;0
30123;47791;830;0;0;0;0;.00nan;0;0
30124;165582;848;85;40;3;37;.925;3900000;0
30124;78223;839;61;31;3;28;.903;3900000;0
30124;87603;848;0;0;0;0;.00nan;0;0
30124;148041;839;0;0;0;0;.00nan;0;0
30125;13373;837;0;0;0;0;.00nan;0;0
30125;16588;832;90;37;2;35;.946;3600000;0
30125;47736;832;0;0;0;0;.00nan;0;0
30125;78920;837;61;32;4;28;.875;3528000;0
30126;183545;842;62;42;5;37;.881;3076000;0
30126;13373;837;0;0;0;0;.00nan;0;0
30126;23433;842;27;7;3;4;.571;524000;0
30126;78920;837;81;25;1;24;.960;3600000;0
30127;16838;830;54;22;3;19;.864;3600000;0
30127;47791;830;0;0;0;0;.00nan;0;0
30127;78223;839;65;16;1;15;.938;2348000;0
30127;148041;839;8;18;6;12;.667;1252000;0
30128;2410;838;63;21;2;19;.905;2546000;0
30128;174334;838;31;16;4;12;.750;1054000;0
30128;47742;848;0;0;0;0;.00nan;0;0
30128;87603;848;81;23;1;22;.957;3600000;0
30129;5663;833;91;22;0;22;1.000;3600000;0
30129;167824;834;66;50;5;45;.900;3600000;0
30129;-1;833;0;0;0;0;.00nan;0;0
30129;67287;834;0;0;0;0;.00nan;0;0
30130;5573;836;0;0;0;0;.00nan;0;0
30130;26336;829;94;40;1;39;.975;3600000;0
30130;182116;836;56;28;4;24;.857;3600000;0
30130;53867;829;0;0;0;0;.00nan;0;0
30131;16588;832;0;0;0;0;.00nan;0;0
30131;47736;832;35;24;5;19;.792;3600000;0
30131;68390;828;98;45;2;43;.956;3600000;0
30131;147845;828;0;0;0;0;.00nan;0;0
30132;180287;847;70;38;4;34;.895;3544000;0
30132;192688;831;75;29;2;27;.931;3600000;0
30132;89190;831;0;0;0;0;.00nan;0;0
30132;89874;847;0;0;0;0;.00nan;0;0
30133;2410;838;100;41;0;41;1.000;3600000;0
30133;167824;834;0;0;0;0;.00nan;0;0
30133;174334;838;0;0;0;0;.00nan;0;0
30133;67287;834;98;37;1;36;.973;3586000;0
30134;165582;848;46;39;7;32;.821;3600000;0
30134;192688;831;83;23;1;22;.957;3600000;0
30134;87603;848;0;0;0;0;.00nan;0;0
30134;89190;831;0;0;0;0;.00nan;0;0
30135;183545;842;0;0;0;0;.00nan;0;0
30135;23433;842;92;45;3;42;.933;3576000;0
30135;26336;829;82;34;2;32;.941;3600000;0
30135;53867;829;0;0;0;0;.00nan;0;0
30136;5573;836;61;17;1;16;.941;2689000;0
30136;182116;836;30;15;4;11;.733;854000;0
30136;68390;828;99;57;4;53;.930;3600000;0
30136;147845;828;0;0;0;0;.00nan;0;0
30137;5663;833;71;40;4;36;.900;3582000;0
30137;13373;837;0;0;0;0;.00nan;0;0
30137;-1;833;0;0;0;0;.00nan;0;0
30137;78920;837;76;37;3;34;.919;3600000;0
30138;180287;847;61;29;3;26;.897;3600000;0
30138;78223;839;0;0;0;0;.00nan;0;0
30138;89874;847;0;0;0;0;.00nan;0;0
30138;148041;839;62;32;4;28;.875;3549000;0
30139;16588;832;0;0;0;0;.00nan;0;0
30139;16838;830;32;33;6;27;.818;1771000;0
30139;47736;832;34;17;4;13;.765;3600000;0
30139;47791;830;47;12;2;10;.833;1829000;0
30140;13373;837;55;23;3;20;.870;3558000;0
30140;16838;830;99;45;1;44;.978;3600000;0
30140;47791;830;0;0;0;0;.00nan;0;0
30140;78920;837;0;0;0;0;.00nan;0;0
30141;2410;838;95;45;2;43;.956;3600000;0
30141;174334;838;0;0;0;0;.00nan;0;0
30141;78223;839;0;0;0;0;.00nan;0;0
30141;148041;839;81;26;1;25;.962;3600000;0
30142;26336;829;0;0;0;0;.00nan;0;0
30142;192688;831;76;32;3;29;.906;3600000;0
30142;53867;829;27;33;7;26;.788;3600000;0
30142;89190;831;0;0;0;0;.00nan;0;0
30143;183545;842;82;36;2;34;.944;3545000;0
30143;23433;842;0;0;0;0;.00nan;0;0
30143;180287;847;77;24;1;23;.958;3600000;0
30143;89874;847;0;0;0;0;.00nan;0;0
30144;5573;836;0;0;0;0;.00nan;0;0
30144;165582;848;100;38;1;37;.974;3900000;0
30144;182116;836;97;38;1;37;.974;3900000;0
30144;87603;848;0;0;0;0;.00nan;0;0
30145;167824;834;0;0;0;0;.00nan;0;0
30145;67287;834;81;28;2;26;.929;3600000;0
30145;68390;828;41;24;4;20;.833;3573000;0
30145;147845;828;0;0;0;0;.00nan;0;0
30146;183545;842;0;0;0;0;.00nan;0;0
30146;16838;830;0;0;0;0;.00nan;0;0
30146;23433;842;97;31;1;30;.968;3900000;0
30146;47791;830;75;22;1;21;.955;3900000;0
30147;2410;838;0;0;0;0;.00nan;0;0
30147;174334;838;79;23;1;22;.957;3600000;0
30147;26336;829;0;0;0;0;.00nan;0;0
30147;53867;829;61;34;4;30;.882;3600000;0
30148;5573;836;0;0;0;0;.00nan;0;0
30148;5663;833;87;29;1;28;.966;3600000;0
30148;-1;833;0;0;0;0;.00nan;0;0
30148;182116;836;97;55;4;51;.927;3600000;0
30149;180287;847;0;0;0;0;.00nan;0;0
30149;47742;848;0;0;0;0;.00nan;0;0
30149;87603;848;100;30;0;30;1.000;3900000;0
30149;89874;847;97;31;0;31;1.000;3900000;0
30150;13373;837;0;0;0;0;.00nan;0;0
30150;68390;828;0;0;0;0;.00nan;0;0
30150;78920;837;77;40;3;37;.925;3600000;0
30150;147845;828;35;23;5;18;.783;3555000;0
30151;185506;831;57;24;2;22;.917;3900000;0
30151;78223;839;78;27;2;25;.926;3900000;0
30151;89190;831;0;0;0;0;.00nan;0;0
30151;148041;839;0;0;0;0;.00nan;0;0
30152;167824;834;0;0;0;0;.00nan;0;0
30152;16588;832;0;0;0;0;.00nan;0;0
30152;47736;832;58;14;1;13;.929;3600000;0
30152;67287;834;75;47;4;43;.915;3600000;0
30153;5663;833;0;0;0;0;.00nan;0;0
30153;16588;832;24;12;4;8;.667;970000;0
30153;-1;833;56;27;3;24;.889;3600000;0
30153;47736;832;61;21;2;19;.905;2630000;0
30154;2410;838;0;0;0;0;.00nan;0;0
30154;5573;836;0;0;0;0;.00nan;0;0
30154;174334;838;53;28;3;25;.893;3600000;0
30154;182116;836;71;23;2;21;.913;3600000;0
30155;16588;832;0;0;0;0;.00nan;0;0
30155;185506;831;84;42;3;39;.929;3554000;0
30155;47736;832;84;26;1;25;.962;3600000;0
30155;89190;831;0;0;0;0;.00nan;0;0
30156;183545;842;0;0;0;0;.00nan;0;0
30156;23433;842;99;24;0;24;1.000;3600000;0
30156;68390;828;68;33;3;30;.909;3600000;0
30156;147845;828;0;0;0;0;.00nan;0;0
30157;13373;837;0;0;0;0;.00nan;0;0
30157;47742;848;0;0;0;0;.00nan;0;0
30157;78920;837;78;36;2;34;.944;3600000;0
30157;87603;848;63;32;4;28;.875;3573000;0
30158;167824;834;0;0;0;0;.00nan;0;0
30158;16838;830;70;26;2;24;.923;3900000;0
30158;47791;830;0;0;0;0;.00nan;0;0
30158;67287;834;72;36;2;34;.944;3900000;0
30159;26336;829;94;48;3;45;.938;3600000;0
30159;180287;847;0;0;0;0;.00nan;0;0
30159;53867;829;0;0;0;0;.00nan;0;0
30159;89874;847;60;33;4;29;.879;3600000;0
30160;5663;833;85;21;1;20;.952;3900000;0
30160;-1;833;0;0;0;0;.00nan;0;0
30160;78223;839;0;0;0;0;.00nan;0;0
30160;148041;839;97;29;1;28;.966;3900000;0
30161;5573;836;0;0;0;0;.00nan;0;0
30161;16588;832;71;24;2;22;.917;3600000;0
30161;182116;836;74;35;3;32;.914;3590000;0
30161;47736;832;0;0;0;0;.00nan;0;0
30162;13373;837;0;0;0;0;.00nan;0;0
30162;192688;831;96;38;1;37;.974;3588000;0
30162;78920;837;94;23;0;23;1.000;3600000;0
30162;89190;831;0;0;0;0;.00nan;0;0
30163;16838;830;92;30;2;28;.933;3600000;0
30163;26336;829;52;29;4;25;.862;3588000;0
30163;47791;830;0;0;0;0;.00nan;0;0
30163;53867;829;0;0;0;0;.00nan;0;0
30164;167824;834;0;0;0;0;.00nan;0;0
30164;67287;834;72;46;5;41;.891;3600000;0
30164;78223;839;0;0;0;0;.00nan;0;0
30164;148041;839;88;25;1;24;.960;3600000;0
30165;2410;838;0;0;0;0;.00nan;0;0
30165;5663;833;67;33;4;29;.879;3600000;0
30165;174334;838;86;33;1;32;.970;3600000;0
30165;-1;833;0;0;0;0;.00nan;0;0
30166;180287;847;63;33;3;30;.909;3600000;0
30166;68390;828;44;40;6;34;.850;2622000;0
30166;89874;847;0;0;0;0;.00nan;0;0
30166;147845;828;71;8;0;8;1.000;978000;0
30167;165582;848;81;40;3;37;.925;3573000;0
30167;16588;832;0;0;0;0;.00nan;0;0
30167;47736;832;82;26;1;25;.962;3600000;0
30167;87603;848;0;0;0;0;.00nan;0;0
30168;2410;838;68;24;2;22;.917;3600000;0
30168;183545;842;0;0;0;0;.00nan;0;0
30168;23433;842;80;46;4;42;.913;3515000;0
30168;174334;838;0;0;0;0;.00nan;0;0
30169;16838;830;82;38;3;35;.921;3600000;0
30169;192688;831;54;27;4;23;.852;3577000;0
30169;47791;830;0;0;0;0;.00nan;0;0
30169;89190;831;0;0;0;0;.00nan;0;0
30170;5663;833;0;0;0;0;.00nan;0;0
30170;165582;848;81;35;2;33;.943;3900000;0
30170;-1;833;51;14;2;12;.857;3900000;0
30170;87603;848;0;0;0;0;.00nan;0;0
30171;167824;834;0;0;0;0;.00nan;0;0
30171;26336;829;0;0;0;0;.00nan;0;0
30171;53867;829;100;32;1;31;.969;3900000;0
30171;67287;834;94;35;1;34;.971;3900000;0
30172;13373;837;0;0;0;0;.00nan;0;0
30172;180287;847;85;32;1;31;.969;3198000;0
30172;78920;837;48;23;3;20;.870;3600000;0
30172;89874;847;23;4;3;1;.250;364000;0
30173;5573;836;0;0;0;0;.00nan;0;0
30173;183545;842;78;34;3;31;.912;3600000;0
30173;23433;842;0;0;0;0;.00nan;0;0
30173;182116;836;54;27;4;23;.852;3546000;0
30174;68390;828;90;45;3;42;.933;3900000;0
30174;78223;839;0;0;0;0;.00nan;0;0
30174;147845;828;0;0;0;0;.00nan;0;0
30174;148041;839;89;29;3;26;.897;3900000;0
30175;13373;837;0;0;0;0;.00nan;0;0
30175;26336;829;88;38;3;35;.921;3600000;0
30175;53867;829;0;0;0;0;.00nan;0;0
30175;78920;837;40;27;5;22;.815;3572000;0
30176;2410;838;0;0;0;0;.00nan;0;0
30176;16838;830;27;22;5;17;.773;3547000;0
30176;174334;838;60;32;4;28;.875;3600000;0
30176;47791;830;0;0;0;0;.00nan;0;0
30177;183545;842;46;19;3;16;.842;1497000;0
30177;23433;842;45;33;6;27;.818;2103000;0
30177;192688;831;55;16;2;14;.875;3600000;0
30177;89190;831;0;0;0;0;.00nan;0;0
30178;5573;836;0;0;0;0;.00nan;0;0
30178;167824;834;0;0;0;0;.00nan;0;0
30178;182116;836;61;36;4;32;.889;3588000;0
30178;67287;834;79;37;3;34;.919;3600000;0
30179;5663;833;51;21;3;18;.857;3600000;0
30179;-1;833;0;0;0;0;.00nan;0;0
30179;180287;847;95;59;5;54;.915;3527000;0
30179;89874;847;0;0;0;0;.00nan;0;0
30180;165582;848;73;22;1;21;.955;3600000;0
30180;68390;828;0;0;0;0;.00nan;0;0
30180;87603;848;0;0;0;0;.00nan;0;0
30180;147845;828;56;18;2;16;.889;3567000;0
30181;16588;832;49;32;6;26;.813;3043000;0
30181;47736;832;50;1;0;1;1.000;557000;0
30181;78223;839;54;29;3;26;.897;3600000;0
30181;148041;839;0;0;0;0;.00nan;0;0
30182;167824;834;0;0;0;0;.00nan;0;0
30182;13373;837;0;0;0;0;.00nan;0;0
30182;67287;834;65;38;5;33;.868;3895000;0
30182;78920;837;44;22;4;18;.818;3895000;0
30183;2410;838;0;0;0;0;.00nan;0;0
30183;174334;838;53;26;3;23;.885;3600000;0
30183;192688;831;93;26;0;26;1.000;3600000;0
30183;89190;831;0;0;0;0;.00nan;0;0
30184;165582;848;98;36;1;35;.972;3600000;0
30184;16838;830;78;36;3;33;.917;3586000;0
30184;47791;830;0;0;0;0;.00nan;0;0
30184;87603;848;0;0;0;0;.00nan;0;0
30185;26336;829;82;41;3;38;.927;3590000;0
30185;53867;829;0;0;0;0;.00nan;0;0
30185;78223;839;0;0;0;0;.00nan;0;0
30185;148041;839;71;24;2;22;.917;3600000;0
30186;5573;836;0;0;0;0;.00nan;0;0
30186;180287;847;97;60;4;56;.933;3600000;0
30186;182116;836;72;23;1;22;.957;3600000;0
30186;89874;847;0;0;0;0;.00nan;0;0
30187;5663;833;72;22;2;20;.909;3900000;0
30187;-1;833;0;0;0;0;.00nan;0;0
30187;68390;828;78;35;2;33;.943;3900000;0
30187;147845;828;0;0;0;0;.00nan;0;0
30188;5663;833;0;0;0;0;.00nan;0;0
30188;183545;842;0;0;0;0;.00nan;0;0
30188;23433;842;75;41;3;38;.927;3571000;0
30188;-1;833;57;16;2;14;.875;3600000;0
30189;165582;848;57;30;4;26;.867;3543000;0
30189;26336;829;0;0;0;0;.00nan;0;0
30189;53867;829;81;37;3;34;.919;3600000;0
30189;87603;848;0;0;0;0;.00nan;0;0
30190;167824;834;85;36;2;34;.944;3600000;0
30190;192688;831;37;31;6;25;.806;3600000;0
30190;67287;834;0;0;0;0;.00nan;0;0
30190;89190;831;0;0;0;0;.00nan;0;0
30191;16588;832;0;0;0;0;.00nan;0;0
30191;180287;847;0;0;0;0;.00nan;0;0
30191;47736;832;54;20;3;17;.850;3600000;0
30191;89874;847;78;48;5;43;.896;3580000;0
30192;16838;830;0;0;0;0;.00nan;0;0
30192;47791;830;75;29;2;27;.931;3600000;0
30192;68390;828;54;8;1;7;.875;661000;0
30192;147845;828;29;33;6;27;.818;2939000;0
30193;5573;836;0;0;0;0;.00nan;0;0
30193;182116;836;86;25;1;24;.960;3600000;0
30193;78223;839;0;0;0;0;.00nan;0;0
30193;148041;839;87;37;2;35;.946;3558000;0
30194;183545;842;96;48;1;47;.979;3600000;0
30194;16588;832;48;16;2;14;.875;3551000;0
30194;23433;842;0;0;0;0;.00nan;0;0
30194;47736;832;0;0;0;0;.00nan;0;0
30195;5573;836;0;0;0;0;.00nan;0;0
30195;13373;837;0;0;0;0;.00nan;0;0
30195;182116;836;99;50;2;48;.960;3600000;0
30195;78920;837;58;30;4;26;.867;3514000;0
30196;16838;830;69;28;3;25;.893;3600000;0
30196;180287;847;57;32;4;28;.875;3583000;0
30196;47791;830;0;0;0;0;.00nan;0;0
30196;89874;847;0;0;0;0;.00nan;0;0
30197;167824;834;71;30;2;28;.933;3600000;0
30197;165582;848;59;23;3;20;.870;3547000;0
30197;67287;834;0;0;0;0;.00nan;0;0
30197;87603;848;0;0;0;0;.00nan;0;0
30198;5663;833;35;21;4;17;.810;3563000;0
30198;-1;833;0;0;0;0;.00nan;0;0
30198;192688;831;80;35;3;32;.914;3600000;0
30198;89190;831;0;0;0;0;.00nan;0;0
30199;16588;832;0;0;0;0;.00nan;0;0
30199;26336;829;57;33;4;29;.879;3669000;0
30199;47736;832;42;29;5;24;.828;3676000;0
30199;53867;829;0;0;0;0;.00nan;0;0
30200;2410;838;79;34;2;32;.941;3600000;0
30200;16588;832;83;25;1;24;.960;3600000;0
30200;174334;838;0;0;0;0;.00nan;0;0
30200;47736;832;0;0;0;0;.00nan;0;0
30201;192688;831;0;0;0;0;.00nan;0;0
30201;68390;828;80;24;1;23;.958;3600000;0
30201;89190;831;67;28;3;25;.893;3537000;0
30201;147845;828;0;0;0;0;.00nan;0;0
30202;183545;842;0;0;0;0;.00nan;0;0
30202;165582;848;0;0;0;0;.00nan;0;0
30202;23433;842;50;27;4;23;.852;3557000;0
30202;87603;848;70;32;3;29;.906;3600000;0
30203;5663;833;0;0;0;0;.00nan;0;0
30203;26336;829;54;11;1;10;.909;1614000;0
30203;-1;833;74;18;1;17;.944;3600000;0
30203;53867;829;28;27;5;22;.815;1986000;0
30204;167824;834;0;0;0;0;.00nan;0;0
30204;180287;847;0;0;0;0;.00nan;0;0
30204;67287;834;98;53;3;50;.943;3587000;0
30204;89874;847;64;16;1;15;.938;3600000;0
30205;13373;837;73;36;3;33;.917;3544000;0
30205;78223;839;0;0;0;0;.00nan;0;0
30205;78920;837;0;0;0;0;.00nan;0;0
30205;148041;839;72;28;2;26;.929;3600000;0
30206;183545;842;83;57;5;52;.912;3600000;0
30206;23433;842;0;0;0;0;.00nan;0;0
30206;78223;839;58;19;2;17;.895;3600000;0
30206;148041;839;0;0;0;0;.00nan;0;0
30207;2410;838;0;0;0;0;.00nan;0;0
30207;174334;838;77;32;2;30;.938;3600000;0
30207;68390;828;0;0;0;0;.00nan;0;0
30207;147845;828;71;32;3;29;.906;3595000;0
30208;26336;829;83;27;1;26;.963;3600000;0
30208;192688;831;76;36;2;34;.944;3575000;0
30208;53867;829;0;0;0;0;.00nan;0;0
30208;89190;831;0;0;0;0;.00nan;0;0
30209;13373;837;0;0;0;0;.00nan;0;0
30209;16588;832;0;0;0;0;.00nan;0;0
30209;47736;832;26;26;6;20;.769;3600000;0
30209;78920;837;69;38;3;35;.921;3600000;0
30210;5663;833;53;32;4;28;.875;3600000;0
30210;16838;830;34;28;5;23;.821;3544000;0
30210;-1;833;0;0;0;0;.00nan;0;0
30210;47791;830;0;0;0;0;.00nan;0;0
30211;165582;848;56;35;4;31;.886;3523000;0
30211;78223;839;0;0;0;0;.00nan;0;0
30211;87603;848;0;0;0;0;.00nan;0;0
30211;148041;839;56;18;2;16;.889;3600000;0
30212;167824;834;80;27;3;24;.889;3544000;0
30212;183545;842;0;0;0;0;.00nan;0;0
30212;23433;842;90;33;1;32;.970;3600000;0
30212;67287;834;0;0;0;0;.00nan;0;0
30213;2410;838;16;20;6;14;.700;1829000;0
30213;174334;838;70;15;0;15;1.000;1771000;0
30213;180287;847;49;28;4;24;.857;3600000;0
30213;89874;847;0;0;0;0;.00nan;0;0
30214;26336;829;56;31;4;27;.871;3600000;0
30214;53867;829;0;0;0;0;.00nan;0;0
30214;68390;828;77;25;1;24;.960;3600000;0
30214;147845;828;0;0;0;0;.00nan;0;0
30215;2410;838;71;19;1;18;.947;3600000;0
30215;165582;848;89;35;2;33;.943;3600000;0
30215;174334;838;0;0;0;0;.00nan;0;0
30215;87603;848;0;0;0;0;.00nan;0;0
30216;180287;847;68;38;4;34;.895;3573000;0
30216;192688;831;60;26;3;23;.885;3600000;0
30216;89190;831;0;0;0;0;.00nan;0;0
30216;89874;847;0;0;0;0;.00nan;0;0
30217;183545;842;56;37;5;32;.865;3600000;0
30217;13373;837;70;20;1;19;.950;3600000;0
30217;23433;842;0;0;0;0;.00nan;0;0
30217;78920;837;0;0;0;0;.00nan;0;0
30218;5573;836;0;0;0;0;.00nan;0;0
30218;26336;829;0;0;0;0;.00nan;0;0
30218;182116;836;73;23;2;21;.913;3827000;0
30218;53867;829;81;35;3;32;.914;3827000;0
30219;16838;830;61;31;3;28;.903;3600000;0
30219;47791;830;0;0;0;0;.00nan;0;0
30219;78223;839;0;0;0;0;.00nan;0;0
30219;148041;839;38;21;4;17;.810;3584000;0
30220;5573;836;0;0;0;0;.00nan;0;0
30220;182116;836;100;31;0;31;1.000;3600000;0
30220;192688;831;49;29;4;25;.862;3600000;0
30220;89190;831;0;0;0;0;.00nan;0;0
30221;5663;833;36;30;5;25;.833;3600000;0
30221;167824;834;0;0;0;0;.00nan;0;0
30221;-1;833;0;0;0;0;.00nan;0;0
30221;67287;834;36;35;6;29;.829;3600000;0
30222;16588;832;86;15;0;15;1.000;3600000;0
30222;47736;832;0;0;0;0;.00nan;0;0
30222;68390;828;62;35;4;31;.886;2257000;0
30222;147845;828;72;15;0;15;1.000;1343000;0
30223;5663;833;66;27;3;24;.889;3534000;0
30223;13373;837;0;0;0;0;.00nan;0;0
30223;-1;833;0;0;0;0;.00nan;0;0
30223;78920;837;100;40;1;39;.975;3600000;0
30224;16588;832;0;0;0;0;.00nan;0;0
30224;16838;830;41;23;4;19;.826;3600000;0
30224;47736;832;62;35;5;30;.857;3600000;0
30224;47791;830;0;0;0;0;.00nan;0;0
30225;183545;842;0;0;0;0;.00nan;0;0
30225;23433;842;54;26;3;23;.885;3600000;0
30225;26336;829;0;0;0;0;.00nan;0;0
30225;53867;829;75;34;2;32;.941;3600000;0
30226;165582;848;91;28;1;27;.964;3600000;0
30226;192688;831;83;36;2;34;.944;3600000;0
30226;87603;848;0;0;0;0;.00nan;0;0
30226;89190;831;0;0;0;0;.00nan;0;0
30227;2410;838;0;0;0;0;.00nan;0;0
30227;167824;834;61;39;4;35;.897;3600000;0
30227;174334;838;65;32;3;29;.906;3600000;0
30227;67287;834;0;0;0;0;.00nan;0;0
30228;180287;847;98;56;2;54;.964;3570000;0
30228;78223;839;0;0;0;0;.00nan;0;0
30228;89874;847;0;0;0;0;.00nan;0;0
30228;148041;839;63;13;1;12;.923;3600000;0
30229;5573;836;0;0;0;0;.00nan;0;0
30229;182116;836;81;20;1;19;.950;3600000;0
30229;68390;828;74;39;4;35;.897;3600000;0
30229;147845;828;0;0;0;0;.00nan;0;0
30230;13373;837;67;17;1;16;.941;1395000;0
30230;16838;830;41;19;4;15;.789;2277000;0
30230;47791;830;75;16;0;16;1.000;1323000;0
30230;78920;837;41;27;5;22;.815;2121000;0
30231;5573;836;0;0;0;0;.00nan;0;0
30231;165582;848;53;39;6;33;.846;3257000;0
30231;182116;836;56;29;4;25;.862;3600000;0
30231;87603;848;53;3;0;3;1.000;343000;0
30232;183545;842;0;0;0;0;.00nan;0;0
30232;23433;842;100;37;0;37;1.000;3600000;0
30232;180287;847;64;24;2;22;.917;3600000;0
30232;89874;847;0;0;0;0;.00nan;0;0
30233;167824;834;0;0;0;0;.00nan;0;0
30233;67287;834;93;35;2;33;.943;3600000;0
30233;68390;828;52;29;4;25;.862;3578000;0
30233;147845;828;0;0;0;0;.00nan;0;0
30234;2410;838;71;33;3;30;.909;3536000;0
30234;174334;838;0;0;0;0;.00nan;0;0
30234;78223;839;0;0;0;0;.00nan;0;0
30234;148041;839;76;22;1;21;.955;3600000;0
30235;5663;833;76;31;2;29;.935;3900000;0
30235;16588;832;0;0;0;0;.00nan;0;0
30235;-1;833;0;0;0;0;.00nan;0;0
30235;47736;832;95;36;2;34;.944;3900000;0
30236;2410;838;0;0;0;0;.00nan;0;0
30236;174334;838;47;24;4;20;.833;3836000;0
30236;26336;829;51;34;5;29;.853;3836000;0
30236;53867;829;0;0;0;0;.00nan;0;0
30237;192688;831;77;36;3;33;.917;3900000;0
30237;78223;839;0;0;0;0;.00nan;0;0
30237;89190;831;0;0;0;0;.00nan;0;0
30237;148041;839;50;24;3;21;.875;3900000;0
30238;183545;842;0;0;0;0;.00nan;0;0
30238;16838;830;19;21;6;15;.714;3558000;0
30238;23433;842;89;48;5;43;.896;3600000;0
30238;47791;830;0;0;0;0;.00nan;0;0
30239;165582;848;100;35;0;35;1.000;3600000;0
30239;180287;847;55;43;6;37;.860;3600000;0
30239;87603;848;0;0;0;0;.00nan;0;0
30239;89874;847;0;0;0;0;.00nan;0;0
30240;167824;834;0;0;0;0;.00nan;0;0
30240;16588;832;58;23;3;20;.870;3584000;0
30240;47736;832;0;0;0;0;.00nan;0;0
30240;67287;834;85;38;2;36;.947;3600000;0
30241;5573;836;0;0;0;0;.00nan;0;0
30241;5663;833;0;0;0;0;.00nan;0;0
30241;-1;833;55;24;3;21;.875;3600000;0
30241;182116;836;54;33;4;29;.879;3550000;0
30242;13373;837;100;33;0;33;1.000;3600000;0
30242;165582;848;79;29;2;27;.931;3541000;0
30242;78920;837;0;0;0;0;.00nan;0;0
30242;87603;848;0;0;0;0;.00nan;0;0
30243;167824;834;47;36;6;30;.833;3600000;0
30243;16838;830;50;33;5;28;.848;3600000;0
30243;47791;830;0;0;0;0;.00nan;0;0
30243;67287;834;0;0;0;0;.00nan;0;0
30244;26336;829;95;18;0;18;1.000;3600000;0
30244;180287;847;69;32;3;29;.906;3600000;0
30244;53867;829;0;0;0;0;.00nan;0;0
30244;89874;847;0;0;0;0;.00nan;0;0
30245;2410;838;0;0;0;0;.00nan;0;0
30245;5573;836;0;0;0;0;.00nan;0;0
30245;174334;838;85;36;2;34;.944;3663000;0
30245;182116;836;55;16;3;13;.813;3663000;0
30246;5663;833;33;36;7;29;.806;3336000;0
30246;-1;833;49;1;0;1;1.000;185000;0
30246;78223;839;0;0;0;0;.00nan;0;0
30246;148041;839;36;24;5;19;.792;3600000;0
30247;16588;832;100;28;0;28;1.000;3600000;0
30247;192688;831;98;43;1;42;.977;3550000;0
30247;47736;832;0;0;0;0;.00nan;0;0
30247;89190;831;0;0;0;0;.00nan;0;0
30248;183545;842;0;0;0;0;.00nan;0;0
30248;23433;842;55;34;5;29;.853;3597000;0
30248;68390;828;62;26;3;23;.885;3600000;0
30248;147845;828;0;0;0;0;.00nan;0;0
30249;5573;836;0;0;0;0;.00nan;0;0
30249;183545;842;82;48;4;44;.917;3544000;0
30249;23433;842;0;0;0;0;.00nan;0;0
30249;182116;836;87;33;2;31;.939;3600000;0
30250;2410;838;0;0;0;0;.00nan;0;0
30250;5663;833;0;0;0;0;.00nan;0;0
30250;174334;838;81;39;3;36;.923;3540000;0
30250;-1;833;90;33;1;32;.970;3600000;0
30251;13373;837;85;31;2;29;.935;3600000;0
30251;192688;831;56;29;3;26;.897;3600000;0
30251;78920;837;0;0;0;0;.00nan;0;0
30251;89190;831;0;0;0;0;.00nan;0;0
30252;165582;848;100;43;0;43;1.000;3600000;0
30252;16588;832;66;20;2;18;.900;3513000;0
30252;47736;832;0;0;0;0;.00nan;0;0
30252;87603;848;0;0;0;0;.00nan;0;0
30253;16838;830;74;32;2;30;.938;3600000;0
30253;26336;829;40;23;5;18;.783;3600000;0
30253;47791;830;0;0;0;0;.00nan;0;0
30253;53867;829;0;0;0;0;.00nan;0;0
30254;180287;847;100;44;1;43;.977;3600000;0
30254;68390;828;39;18;3;15;.833;3516000;0
30254;89874;847;0;0;0;0;.00nan;0;0
30254;147845;828;0;0;0;0;.00nan;0;0
30255;13373;837;64;15;1;14;.933;3600000;0
30255;180287;847;0;0;0;0;.00nan;0;0
30255;78920;837;0;0;0;0;.00nan;0;0
30255;89874;847;69;33;3;30;.909;3587000;0
30256;16838;830;0;0;0;0;.00nan;0;0
30256;192688;831;0;0;0;0;.00nan;0;0
30256;47791;830;78;30;2;28;.933;3900000;0
30256;89190;831;92;42;2;40;.952;3900000;0
30257;2410;838;78;30;2;28;.933;3600000;0
30257;183545;842;80;26;0;26;1.000;3185000;0
30257;23433;842;26;7;3;4;.571;366000;0
30257;174334;838;0;0;0;0;.00nan;0;0
30258;167824;834;53;3;0;3;1.000;671000;0
30258;26336;829;61;33;4;29;.879;3600000;0
30258;53867;829;0;0;0;0;.00nan;0;0
30258;67287;834;41;31;6;25;.806;2840000;0
30259;5663;833;86;35;2;33;.943;3900000;0
30259;165582;848;73;32;2;30;.938;3900000;0
30259;-1;833;0;0;0;0;.00nan;0;0
30259;87603;848;0;0;0;0;.00nan;0;0
30260;68390;828;0;0;0;0;.00nan;0;0
30260;78223;839;0;0;0;0;.00nan;0;0
30260;147845;828;82;41;2;39;.951;3590000;0
30260;148041;839;66;17;1;16;.941;3600000;0
30261;5573;836;0;0;0;0;.00nan;0;0
30261;16588;832;0;0;0;0;.00nan;0;0
30261;182116;836;94;39;2;37;.949;3600000;0
30261;47736;832;43;29;4;25;.862;3577000;0
30262;167824;834;0;0;0;0;.00nan;0;0
30262;67287;834;95;44;2;42;.955;3900000;0
30262;78223;839;68;26;2;24;.923;3900000;0
30262;148041;839;0;0;0;0;.00nan;0;0
30263;2410;838;0;0;0;0;.00nan;0;0
30263;174334;838;51;31;4;27;.871;3600000;0
30263;192688;831;100;30;0;30;1.000;3600000;0
30263;89190;831;0;0;0;0;.00nan;0;0
30264;165582;848;100;33;1;32;.970;3600000;0
30264;16838;830;75;42;4;38;.905;3600000;0
30264;47791;830;0;0;0;0;.00nan;0;0
30264;87603;848;0;0;0;0;.00nan;0;0
30265;167824;834;0;0;0;0;.00nan;0;0
30265;13373;837;49;22;3;19;.864;3543000;0
30265;67287;834;95;42;1;41;.976;3600000;0
30265;78920;837;0;0;0;0;.00nan;0;0
30266;5573;836;0;0;0;0;.00nan;0;0
30266;180287;847;93;36;1;35;.972;3600000;0
30266;182116;836;64;27;2;25;.926;3600000;0
30266;89874;847;0;0;0;0;.00nan;0;0
30267;5663;833;77;27;2;25;.926;3900000;0
30267;-1;833;0;0;0;0;.00nan;0;0
30267;68390;828;95;45;2;43;.956;3900000;0
30267;147845;828;0;0;0;0;.00nan;0;0
30268;26336;829;53;38;5;33;.868;3600000;0
30268;53867;829;0;0;0;0;.00nan;0;0
30268;78223;839;0;0;0;0;.00nan;0;0
30268;148041;839;61;13;1;12;.923;3600000;0
30269;2410;838;95;58;5;53;.914;3600000;0
30269;13373;837;0;0;0;0;.00nan;0;0
30269;174334;838;0;0;0;0;.00nan;0;0
30269;78920;837;45;22;3;19;.864;3600000;0
30270;16838;830;0;0;0;0;.00nan;0;0
30270;47791;830;100;33;0;33;1.000;3600000;0
30270;68390;828;0;0;0;0;.00nan;0;0
30270;147845;828;48;31;4;27;.871;3600000;0
30271;165582;848;100;25;0;25;1.000;3600000;0
30271;26336;829;0;0;0;0;.00nan;0;0
30271;53867;829;55;34;4;30;.882;3600000;0
30271;87603;848;0;0;0;0;.00nan;0;0
30272;5573;836;62;38;4;34;.895;3600000;0
30272;182116;836;0;0;0;0;.00nan;0;0
30272;78223;839;52;22;3;19;.864;3600000;0
30272;148041;839;0;0;0;0;.00nan;0;0
30273;5663;833;0;0;0;0;.00nan;0;0
30273;183545;842;0;0;0;0;.00nan;0;0
30273;23433;842;97;48;2;46;.958;3600000;0
30273;-1;833;68;15;1;14;.933;3600000;0
30274;16588;832;0;0;0;0;.00nan;0;0
30274;180287;847;39;1;1;0;.000;406000;0
30274;47736;832;70;25;2;23;.920;3600000;0
30274;89874;847;26;33;6;27;.818;3194000;0
30275;167824;834;0;0;0;0;.00nan;0;0
30275;192688;831;46;29;5;24;.828;3555000;0
30275;67287;834;80;43;4;39;.907;3600000;0
30275;89190;831;0;0;0;0;.00nan;0;0
30276;183545;842;68;33;3;30;.909;3900000;0
30276;16588;832;61;24;3;21;.875;3900000;0
30276;23433;842;0;0;0;0;.00nan;0;0
30276;47736;832;0;0;0;0;.00nan;0;0
30277;5573;836;0;0;0;0;.00nan;0;0
30277;167824;834;0;0;0;0;.00nan;0;0
30277;182116;836;86;35;1;34;.971;3600000;0
30277;67287;834;77;40;4;36;.900;3600000;0
30278;5663;833;67;23;2;21;.913;3600000;0
30278;26336;829;81;49;3;46;.939;3600000;0
30278;-1;833;0;0;0;0;.00nan;0;0
30278;53867;829;0;0;0;0;.00nan;0;0
30279;2410;838;0;0;0;0;.00nan;0;0
30279;174334;838;41;33;6;27;.818;3600000;0
30279;68390;828;75;19;1;18;.947;3600000;0
30279;147845;828;0;0;0;0;.00nan;0;0
30280;5663;833;66;33;4;29;.879;3821000;0
30280;-1;833;0;0;0;0;.00nan;0;0
30280;192688;831;86;38;3;35;.921;3821000;0
30280;89190;831;0;0;0;0;.00nan;0;0
30281;167824;834;0;0;0;0;.00nan;0;0
30281;165582;848;78;35;3;32;.914;3600000;0
30281;67287;834;60;34;4;30;.882;3553000;0
30281;87603;848;0;0;0;0;.00nan;0;0
30282;16588;832;0;0;0;0;.00nan;0;0
30282;26336;829;0;0;0;0;.00nan;0;0
30282;47736;832;37;24;4;20;.833;3600000;0
30282;53867;829;88;36;2;34;.944;3600000;0
30283;16838;830;0;0;0;0;.00nan;0;0
30283;47742;847;100;30;0;30;1.000;3600000;0
30283;47791;830;38;28;5;23;.821;3600000;0
30283;89874;847;0;0;0;0;.00nan;0;0
30284;183545;842;0;0;0;0;.00nan;0;0
30284;23433;842;87;34;2;32;.941;3559000;0
30284;78223;839;0;0;0;0;.00nan;0;0
30284;148041;839;81;15;0;15;1.000;3600000;0
30285;13373;837;39;34;6;28;.824;3600000;0
30285;78223;839;0;0;0;0;.00nan;0;0
30285;78920;837;0;0;0;0;.00nan;0;0
30285;148041;839;76;37;3;34;.919;3600000;0
30286;5573;836;0;0;0;0;.00nan;0;0
30286;16838;830;73;25;2;23;.920;3600000;0
30286;182116;836;72;47;5;42;.894;3600000;0
30286;47791;830;0;0;0;0;.00nan;0;0
30287;183545;842;98;36;1;35;.972;3559000;0
30287;165582;848;96;17;0;17;1.000;3600000;0
30287;23433;842;0;0;0;0;.00nan;0;0
30287;87603;848;0;0;0;0;.00nan;0;0
30288;167824;834;0;0;0;0;.00nan;0;0
30288;180287;847;86;37;2;35;.946;3600000;0
30288;67287;834;88;29;1;28;.966;3600000;0
30288;89874;847;0;0;0;0;.00nan;0;0
30289;192688;831;49;15;2;13;.867;3858000;0
30289;68390;828;79;35;3;32;.914;3858000;0
30289;89190;831;0;0;0;0;.00nan;0;0
30289;147845;828;0;0;0;0;.00nan;0;0
30290;2410;838;80;44;4;40;.909;3527000;0
30290;16588;832;67;23;2;21;.913;3600000;0
30290;174334;838;0;0;0;0;.00nan;0;0
30290;47736;832;0;0;0;0;.00nan;0;0
30291;5573;836;0;0;0;0;.00nan;0;0
30291;13373;837;0;0;0;0;.00nan;0;0
30291;182116;836;65;40;4;36;.900;3867000;0
30291;78920;837;55;27;3;24;.889;3867000;0
30292;2410;838;0;0;0;0;.00nan;0;0
30292;16838;830;69;17;1;16;.941;3600000;0
30292;174334;838;64;42;4;38;.905;3600000;0
30292;47791;830;0;0;0;0;.00nan;0;0
30293;183545;842;59;11;1;10;.909;1408000;0
30293;23433;842;37;36;6;30;.833;2192000;0
30293;192688;831;77;20;1;19;.950;3600000;0
30293;89190;831;0;0;0;0;.00nan;0;0
30294;165582;848;90;33;2;31;.939;3600000;0
30294;68390;828;96;33;1;32;.970;3600000;0
30294;87603;848;0;0;0;0;.00nan;0;0
30294;147845;828;0;0;0;0;.00nan;0;0
30295;5573;836;0;0;0;0;.00nan;0;0
30295;26336;829;80;30;2;28;.933;3885000;0
30295;182116;836;83;36;3;33;.917;3885000;0
30295;53867;829;0;0;0;0;.00nan;0;0
30296;5663;833;70;19;1;18;.947;3600000;0
30296;-1;833;0;0;0;0;.00nan;0;0
30296;180287;847;60;39;5;34;.872;3600000;0
30296;89874;847;0;0;0;0;.00nan;0;0
30297;16588;832;0;0;0;0;.00nan;0;0
30297;47736;832;33;24;5;19;.792;3600000;0
30297;78223;839;59;23;2;21;.913;3600000;0
30297;148041;839;0;0;0;0;.00nan;0;0
30298;5573;836;0;0;0;0;.00nan;0;0
30298;13373;837;74;39;4;35;.897;3548000;0
30298;182116;836;89;42;3;39;.929;3600000;0
30298;78920;837;0;0;0;0;.00nan;0;0
30299;16588;832;59;26;3;23;.885;3520000;0
30299;16838;830;94;35;1;34;.971;3600000;0
30299;47736;832;0;0;0;0;.00nan;0;0
30299;47791;830;0;0;0;0;.00nan;0;0
30300;183545;842;0;0;0;0;.00nan;0;0
30300;23433;842;66;41;5;36;.878;3600000;0
30300;192688;831;97;27;1;26;.963;3600000;0
30300;89190;831;0;0;0;0;.00nan;0;0
30301;2410;838;0;0;0;0;.00nan;0;0
30301;5663;833;0;0;0;0;.00nan;0;0
30301;174334;838;89;47;3;44;.936;3515000;0
30301;-1;833;72;17;1;16;.941;3600000;0
30302;167824;834;0;0;0;0;.00nan;0;0
30302;180287;847;67;28;4;24;.857;3900000;0
30302;67287;834;66;35;4;31;.886;3900000;0
30302;89874;847;0;0;0;0;.00nan;0;0
30303;26336;829;54;32;4;28;.875;3544000;0
30303;53867;829;0;0;0;0;.00nan;0;0
30303;68390;828;59;26;3;23;.885;3600000;0
30303;147845;828;0;0;0;0;.00nan;0;0
30304;165582;848;77;40;3;37;.925;3564000;0
30304;78223;839;0;0;0;0;.00nan;0;0
30304;87603;848;0;0;0;0;.00nan;0;0
30304;148041;839;92;28;1;27;.964;3600000;0
30305;2410;838;83;45;3;42;.933;3600000;0
30305;174334;838;0;0;0;0;.00nan;0;0
30305;78223;839;76;12;0;12;1.000;3600000;0
30305;148041;839;0;0;0;0;.00nan;0;0
30306;180287;847;51;42;6;36;.857;3343000;0
30306;192688;831;58;18;2;16;.889;3600000;0
30306;89190;831;0;0;0;0;.00nan;0;0
30306;89874;847;48;0;0;0;.00nan;257000;0
30307;13373;837;0;0;0;0;.00nan;0;0
30307;165582;848;72;40;4;36;.900;3558000;0
30307;78920;837;66;21;2;19;.905;3600000;0
30307;87603;848;0;0;0;0;.00nan;0;0
30308;16838;830;35;27;5;22;.815;3600000;0
30308;26336;829;0;0;0;0;.00nan;0;0
30308;47791;830;0;0;0;0;.00nan;0;0
30308;53867;829;92;41;2;39;.951;3600000;0
30309;5573;836;0;0;0;0;.00nan;0;0
30309;5663;833;48;27;4;23;.852;3600000;0
30309;-1;833;0;0;0;0;.00nan;0;0
30309;182116;836;73;41;5;36;.878;3539000;0
30310;16588;832;0;0;0;0;.00nan;0;0
30310;47736;832;29;26;6;20;.769;3600000;0
30310;68390;828;0;0;0;0;.00nan;0;0
30310;147845;828;72;30;3;27;.900;3600000;0
30311;167824;834;0;0;0;0;.00nan;0;0
30311;183545;842;49;8;1;7;.875;972000;0
30311;23433;842;48;34;6;28;.824;2628000;0
30311;67287;834;45;25;4;21;.840;3600000;0
30312;2410;838;0;0;0;0;.00nan;0;0
30312;13373;837;0;0;0;0;.00nan;0;0
30312;174334;838;94;40;2;38;.950;3553000;0
30312;78920;837;100;27;0;27;1.000;3600000;0
30313;16838;830;64;17;1;16;.941;3600000;0
30313;192688;831;49;29;4;25;.862;3600000;0
30313;47791;830;0;0;0;0;.00nan;0;0
30313;89190;831;0;0;0;0;.00nan;0;0
30314;5573;836;0;0;0;0;.00nan;0;0
30314;180287;847;87;35;2;33;.943;3569000;0
30314;182116;836;76;20;1;19;.950;3600000;0
30314;89874;847;0;0;0;0;.00nan;0;0
30315;5663;833;0;0;0;0;.00nan;0;0
30315;16588;832;0;0;0;0;.00nan;0;0
30315;-1;833;49;16;3;13;.813;3600000;0
30315;47736;832;52;48;6;42;.875;3600000;0
30316;165582;848;46;13;2;11;.846;3600000;0
30316;68390;828;79;53;5;48;.906;3600000;0
30316;87603;848;0;0;0;0;.00nan;0;0
30316;147845;828;0;0;0;0;.00nan;0;0
30317;2410;838;0;0;0;0;.00nan;0;0
30317;5573;836;0;0;0;0;.00nan;0;0
30317;174334;838;79;35;4;31;.886;3855000;0
30317;182116;836;56;35;5;30;.857;3855000;0
30318;192688;831;0;0;0;0;.00nan;0;0
30318;78223;839;55;27;4;23;.852;3573000;0
30318;89190;831;86;43;2;41;.953;3600000;0
30318;148041;839;0;0;0;0;.00nan;0;0
30319;183545;842;0;0;0;0;.00nan;0;0
30319;165582;848;66;40;4;36;.900;3866000;0
30319;23433;842;82;42;3;39;.929;3866000;0
30319;87603;848;0;0;0;0;.00nan;0;0
30320;167824;834;0;0;0;0;.00nan;0;0
30320;16838;830;48;38;6;32;.842;2851000;0
30320;47791;830;57;7;0;7;1.000;692000;0
30320;67287;834;57;31;4;27;.871;3600000;0
30321;5663;833;50;28;4;24;.857;3554000;0
30321;26336;829;0;0;0;0;.00nan;0;0
30321;-1;833;0;0;0;0;.00nan;0;0
30321;53867;829;77;39;3;36;.923;3600000;0
30322;180287;847;75;31;3;28;.903;3552000;0
30322;68390;828;0;0;0;0;.00nan;0;0
30322;89874;847;0;0;0;0;.00nan;0;0
30322;147845;828;75;24;1;23;.958;3600000;0
30323;13373;837;0;0;0;0;.00nan;0;0
30323;16588;832;61;42;5;37;.881;3600000;0
30323;47736;832;0;0;0;0;.00nan;0;0
30323;78920;837;100;29;0;29;1.000;3600000;0
30324;183545;842;85;31;2;29;.935;3600000;0
30324;23433;842;0;0;0;0;.00nan;0;0
30324;26336;829;72;39;4;35;.897;3593000;0
30324;53867;829;0;0;0;0;.00nan;0;0
30325;167824;834;0;0;0;0;.00nan;0;0
30325;13373;837;0;0;0;0;.00nan;0;0
30325;67287;834;57;37;5;32;.865;3519000;0
30325;78920;837;55;22;3;19;.864;3600000;0
30326;16838;830;74;19;1;18;.947;3616000;0
30326;180287;847;93;34;2;32;.941;3616000;0
30326;47791;830;0;0;0;0;.00nan;0;0
30326;89874;847;0;0;0;0;.00nan;0;0
30327;2410;838;0;0;0;0;.00nan;0;0
30327;183545;842;79;35;2;33;.943;3900000;0
30327;23433;842;0;0;0;0;.00nan;0;0
30327;174334;838;79;35;2;33;.943;3900000;0
30328;5573;836;0;0;0;0;.00nan;0;0
30328;16588;832;0;0;0;0;.00nan;0;0
30328;182116;836;84;29;2;27;.931;3600000;0
30328;47736;832;86;48;3;45;.938;3580000;0
30329;5663;833;0;0;0;0;.00nan;0;0
30329;165582;848;51;28;3;25;.893;3600000;0
30329;-1;833;87;16;0;16;1.000;3600000;0
30329;87603;848;0;0;0;0;.00nan;0;0
30330;192688;831;67;26;2;24;.923;3544000;0
30330;68390;828;100;30;0;30;1.000;3600000;0
30330;89190;831;0;0;0;0;.00nan;0;0
30330;147845;828;0;0;0;0;.00nan;0;0
30331;26336;829;76;33;2;31;.939;3544000;0
30331;53867;829;0;0;0;0;.00nan;0;0
30331;78223;839;0;0;0;0;.00nan;0;0
30331;148041;839;88;18;0;18;1.000;3600000;0
30332;2410;838;79;31;2;29;.935;3600000;0
30332;174334;838;0;0;0;0;.00nan;0;0
30332;68390;828;46;32;5;27;.844;3600000;0
30332;147845;828;0;0;0;0;.00nan;0;0
30333;13373;837;0;0;0;0;.00nan;0;0
30333;192688;831;68;37;3;34;.919;3579000;0
30333;78920;837;56;19;2;17;.895;3600000;0
30333;89190;831;0;0;0;0;.00nan;0;0
30334;183545;842;0;0;0;0;.00nan;0;0
30334;16838;830;64;22;2;20;.909;3600000;0
30334;23433;842;61;41;5;36;.878;3600000;0
30334;47791;830;0;0;0;0;.00nan;0;0
30335;5663;833;0;0;0;0;.00nan;0;0
30335;167824;834;52;38;5;33;.868;3513000;0
30335;-1;833;62;26;3;23;.885;3600000;0
30335;67287;834;0;0;0;0;.00nan;0;0
30336;5573;836;0;0;0;0;.00nan;0;0
30336;26336;829;0;0;0;0;.00nan;0;0
30336;182116;836;43;42;6;36;.857;3600000;0
30336;53867;829;65;30;3;27;.900;3600000;0
30337;165582;848;63;28;3;25;.893;3545000;0
30337;180287;847;77;28;2;26;.929;3600000;0
30337;87603;848;0;0;0;0;.00nan;0;0
30337;89874;847;0;0;0;0;.00nan;0;0
30338;16588;832;58;21;2;19;.905;3562000;0
30338;47736;832;0;0;0;0;.00nan;0;0
30338;78223;839;0;0;0;0;.00nan;0;0
30338;148041;839;100;17;0;17;1.000;3600000;0
30339;16838;830;79;27;2;25;.926;3600000;0
30339;47791;830;0;0;0;0;.00nan;0;0
30339;78223;839;0;0;0;0;.00nan;0;0
30339;148041;839;34;28;5;23;.821;3600000;0
30340;165582;848;0;0;0;0;.00nan;0;0
30340;192688;831;100;35;0;35;1.000;3600000;0
30340;87603;848;66;28;3;25;.893;3600000;0
30340;89190;831;0;0;0;0;.00nan;0;0
30341;2410;838;0;0;0;0;.00nan;0;0
30341;174334;838;86;36;3;33;.917;3528000;0
30341;26336;829;0;0;0;0;.00nan;0;0
30341;53867;829;79;21;1;20;.952;3600000;0
30342;5663;833;0;0;0;0;.00nan;0;0
30342;13373;837;0;0;0;0;.00nan;0;0
30342;-1;833;80;31;2;29;.935;3600000;0
30342;78920;837;100;34;1;33;.971;3600000;0
30343;183545;842;50;26;4;22;.846;3518000;0
30343;23433;842;0;0;0;0;.00nan;0;0
30343;180287;847;91;39;2;37;.949;3600000;0
30343;89874;847;0;0;0;0;.00nan;0;0
30344;5573;836;0;0;0;0;.00nan;0;0
30344;182116;836;93;29;1;28;.966;3900000;0
30344;68390;828;87;31;1;30;.968;3900000;0
30344;147845;828;0;0;0;0;.00nan;0;0
30345;167824;834;0;0;0;0;.00nan;0;0
30345;16588;832;53;2;0;2;1.000;350000;0
30345;47736;832;28;22;6;16;.727;3250000;0
30345;67287;834;61;39;5;34;.872;3600000;0
30346;13373;837;97;22;0;22;1.000;3600000;0
30346;68390;828;98;46;2;44;.957;3575000;0
30346;78920;837;0;0;0;0;.00nan;0;0
30346;147845;828;0;0;0;0;.00nan;0;0
30347;2410;838;0;0;0;0;.00nan;0;0
30347;16588;832;60;19;2;17;.895;3600000;0
30347;174334;838;57;35;5;30;.857;3600000;0
30347;47736;832;0;0;0;0;.00nan;0;0
30348;26336;829;45;36;5;31;.861;3600000;0
30348;192688;831;80;21;1;20;.952;3600000;0
30348;53867;829;0;0;0;0;.00nan;0;0
30348;89190;831;0;0;0;0;.00nan;0;0
30349;5663;833;0;0;0;0;.00nan;0;0
30349;183545;842;75;51;5;46;.902;3600000;0
30349;23433;842;0;0;0;0;.00nan;0;0
30349;-1;833;82;19;1;18;.947;3600000;0
30350;167824;834;0;0;0;0;.00nan;0;0
30350;165582;848;81;20;1;19;.950;3600000;0
30350;67287;834;68;33;3;30;.909;3572000;0
30350;87603;848;0;0;0;0;.00nan;0;0
30351;5573;836;0;0;0;0;.00nan;0;0
30351;16838;830;79;38;3;35;.921;3558000;0
30351;182116;836;83;30;2;28;.933;3600000;0
30351;47791;830;0;0;0;0;.00nan;0;0
30352;180287;847;85;37;2;35;.946;3600000;0
30352;78223;839;0;0;0;0;.00nan;0;0
30352;89874;847;0;0;0;0;.00nan;0;0
30352;148041;839;58;28;3;25;.893;3545000;0
30353;5663;833;0;0;0;0;.00nan;0;0
30353;-1;833;59;22;2;20;.909;3600000;0
30353;68390;828;0;0;0;0;.00nan;0;0
30353;147845;828;57;40;5;35;.875;3600000;0
30354;183545;842;0;0;0;0;.00nan;0;0
30354;23433;842;91;50;3;47;.940;3600000;0
30354;78223;839;0;0;0;0;.00nan;0;0
30354;148041;839;88;20;0;20;1.000;3600000;0
30355;13373;837;75;22;1;21;.955;3600000;0
30355;26336;829;0;0;0;0;.00nan;0;0
30355;53867;829;75;27;3;24;.889;3600000;0
30355;78920;837;0;0;0;0;.00nan;0;0
30356;16588;832;0;0;0;0;.00nan;0;0
30356;192688;831;96;29;1;28;.966;3600000;0
30356;47736;832;61;30;3;27;.900;3549000;0
30356;89190;831;0;0;0;0;.00nan;0;0
30357;165582;848;90;39;2;37;.949;3600000;0
30357;16838;830;49;21;3;18;.857;3568000;0
30357;47791;830;0;0;0;0;.00nan;0;0
30357;87603;848;0;0;0;0;.00nan;0;0
30358;5573;836;0;0;0;0;.00nan;0;0
30358;167824;834;0;0;0;0;.00nan;0;0
30358;182116;836;53;37;5;32;.865;3600000;0
30358;67287;834;68;39;4;35;.897;3600000;0
30359;2410;838;0;0;0;0;.00nan;0;0
30359;174334;838;85;45;4;41;.911;3546000;0
30359;180287;847;76;33;3;30;.909;3600000;0
30359;89874;847;0;0;0;0;.00nan;0;0
30360;13373;837;0;0;0;0;.00nan;0;0
30360;16838;830;0;0;0;0;.00nan;0;0
30360;47791;830;48;40;6;34;.850;3600000;0
30360;78920;837;81;29;2;27;.931;3600000;0
30361;183545;842;0;0;0;0;.00nan;0;0
30361;23433;842;77;37;3;34;.919;3546000;0
30361;68390;828;69;26;2;24;.923;3600000;0
30361;147845;828;0;0;0;0;.00nan;0;0
30362;167824;834;0;0;0;0;.00nan;0;0
30362;26336;829;70;40;5;35;.875;3576000;0
30362;53867;829;0;0;0;0;.00nan;0;0
30362;67287;834;59;32;4;28;.875;3600000;0
30363;2410;838;58;36;4;32;.889;3582000;0
30363;174334;838;0;0;0;0;.00nan;0;0
30363;192688;831;68;22;2;20;.909;3600000;0
30363;89190;831;0;0;0;0;.00nan;0;0
30364;5573;836;0;0;0;0;.00nan;0;0
30364;165582;848;56;19;3;16;.842;3600000;0
30364;182116;836;52;28;4;24;.857;3600000;0
30364;87603;848;0;0;0;0;.00nan;0;0
30365;5663;833;0;0;0;0;.00nan;0;0
30365;-1;833;66;25;2;23;.920;3900000;0
30365;78223;839;0;0;0;0;.00nan;0;0
30365;148041;839;91;41;2;39;.951;3900000;0
30366;16588;832;0;0;0;0;.00nan;0;0
30366;180287;847;92;51;3;48;.941;3887000;0
30366;47736;832;79;32;2;30;.938;3887000;0
30366;89874;847;0;0;0;0;.00nan;0;0
30367;13373;837;0;0;0;0;.00nan;0;0
30367;180287;847;58;43;5;38;.884;3600000;0
30367;78920;837;95;32;2;30;.938;3600000;0
30367;89874;847;0;0;0;0;.00nan;0;0
30368;165582;848;53;21;3;18;.857;3573000;0
30368;26336;829;83;44;2;42;.955;3600000;0
30368;53867;829;0;0;0;0;.00nan;0;0
30368;87603;848;0;0;0;0;.00nan;0;0
30369;2410;838;0;0;0;0;.00nan;0;0
30369;167824;834;0;0;0;0;.00nan;0;0
30369;174334;838;100;33;0;33;1.000;3600000;0
30369;67287;834;51;40;5;35;.875;3600000;0
30370;5573;836;0;0;0;0;.00nan;0;0
30370;182116;836;80;31;2;29;.935;3900000;0
30370;192688;831;95;40;2;38;.950;3900000;0
30370;89190;831;0;0;0;0;.00nan;0;0
30371;5663;833;0;0;0;0;.00nan;0;0
30371;16838;830;73;32;3;29;.906;3600000;0
30371;-1;833;96;23;0;23;1.000;3600000;0
30371;47791;830;0;0;0;0;.00nan;0;0
30372;68390;828;64;32;3;29;.906;3600000;0
30372;78223;839;0;0;0;0;.00nan;0;0
30372;147845;828;0;0;0;0;.00nan;0;0
30372;148041;839;29;27;6;21;.778;3600000;0
30373;183545;842;0;0;0;0;.00nan;0;0
30373;16588;832;95;22;0;22;1.000;3600000;0
30373;23433;842;64;28;3;25;.893;3600000;0
30373;47736;832;0;0;0;0;.00nan;0;0
30374;2410;838;0;0;0;0;.00nan;0;0
30374;165582;848;57;12;2;10;.833;3600000;0
30374;174334;838;61;48;5;43;.896;3600000;0
30374;87603;848;0;0;0;0;.00nan;0;0
30375;167824;834;0;0;0;0;.00nan;0;0
30375;192688;831;0;0;0;0;.00nan;0;0
30375;67287;834;96;45;2;43;.956;3600000;0
30375;89190;831;61;26;3;23;.885;3561000;0
30376;16838;830;63;26;2;24;.923;3600000;0
30376;47791;830;0;0;0;0;.00nan;0;0
30376;68390;828;0;0;0;0;.00nan;0;0
30376;147845;828;58;47;6;41;.872;3600000;0
30377;16588;832;82;27;2;25;.926;3900000;0
30377;26336;829;71;28;2;26;.929;3900000;0
30377;47736;832;0;0;0;0;.00nan;0;0
30377;53867;829;0;0;0;0;.00nan;0;0
30378;5663;833;0;0;0;0;.00nan;0;0
30378;-1;833;43;21;4;17;.810;3570000;0
30378;180287;847;0;0;0;0;.00nan;0;0
30378;89874;847;85;40;3;37;.925;3600000;0
30379;5573;836;0;0;0;0;.00nan;0;0
30379;182116;836;82;44;4;40;.909;3529000;0
30379;78223;839;86;31;2;29;.935;3600000;0
30379;148041;839;0;0;0;0;.00nan;0;0
30380;2410;838;56;6;0;6;1.000;459000;0
30380;16838;830;41;22;4;18;.818;3600000;0
30380;174334;838;71;47;5;42;.894;3131000;0
30380;47791;830;0;0;0;0;.00nan;0;0
30381;5663;833;82;27;1;26;.963;3600000;0
30381;-1;833;0;0;0;0;.00nan;0;0
30381;192688;831;64;32;3;29;.906;3563000;0
30381;89190;831;0;0;0;0;.00nan;0;0
30382;167824;834;0;0;0;0;.00nan;0;0
30382;67287;834;79;25;1;24;.960;3600000;0
30382;68390;828;62;30;3;27;.900;3515000;0
30382;147845;828;0;0;0;0;.00nan;0;0
30383;26336;829;0;0;0;0;.00nan;0;0
30383;180287;847;45;32;5;27;.844;3554000;0
30383;53867;829;61;26;3;23;.885;3600000;0
30383;89874;847;0;0;0;0;.00nan;0;0
30384;13373;837;0;0;0;0;.00nan;0;0
30384;78223;839;0;0;0;0;.00nan;0;0
30384;78920;837;75;26;2;24;.923;3600000;0
30384;148041;839;55;38;5;33;.868;3600000;0
30385;13373;837;64;28;3;25;.893;3600000;0
30385;78223;839;71;35;4;31;.886;3581000;0
30385;78920;837;0;0;0;0;.00nan;0;0
30385;148041;839;0;0;0;0;.00nan;0;0
30386;2410;838;0;0;0;0;.00nan;0;0
30386;16838;830;73;20;1;19;.950;3600000;0
30386;174334;838;73;36;3;33;.917;3571000;0
30386;47791;830;0;0;0;0;.00nan;0;0
30387;5663;833;88;22;1;21;.955;3600000;0
30387;-1;833;0;0;0;0;.00nan;0;0
30387;192688;831;53;25;3;22;.880;3534000;0
30387;89190;831;0;0;0;0;.00nan;0;0
30388;167824;834;94;35;1;34;.971;3600000;0
30388;67287;834;0;0;0;0;.00nan;0;0
30388;68390;828;0;0;0;0;.00nan;0;0
30388;147845;828;85;42;3;39;.929;3533000;0
30389;165582;848;76;12;0;12;1.000;3600000;0
30389;16588;832;0;0;0;0;.00nan;0;0
30389;47736;832;89;42;2;40;.952;3568000;0
30389;87603;848;0;0;0;0;.00nan;0;0
30390;165582;848;44;17;3;14;.824;3589000;0
30390;16588;832;0;0;0;0;.00nan;0;0
30390;47736;832;90;40;2;38;.950;3600000;0
30390;87603;848;0;0;0;0;.00nan;0;0
30391;26336;829;42;26;4;22;.846;3593000;0
30391;180287;847;53;25;3;22;.880;3600000;0
30391;53867;829;0;0;0;0;.00nan;0;0
30391;89874;847;0;0;0;0;.00nan;0;0
30392;13373;837;0;0;0;0;.00nan;0;0
30392;26336;829;88;43;4;39;.907;3550000;0
30392;53867;829;0;0;0;0;.00nan;0;0
30392;78920;837;84;36;3;33;.917;3600000;0
30393;5573;836;0;0;0;0;.00nan;0;0
30393;183545;842;50;8;1;7;.875;521000;0
30393;23433;842;32;25;6;19;.760;3079000;0
30393;182116;836;92;31;1;30;.968;3600000;0
30394;5663;833;0;0;0;0;.00nan;0;0
30394;-1;833;83;36;2;34;.944;3600000;0
30394;68390;828;73;36;3;33;.917;3600000;0
30394;147845;828;0;0;0;0;.00nan;0;0
30395;2410;838;0;0;0;0;.00nan;0;0
30395;5663;833;46;19;3;16;.842;3600000;0
30395;174334;838;70;43;4;39;.907;3591000;0
30395;-1;833;0;0;0;0;.00nan;0;0
30396;183545;842;0;0;0;0;.00nan;0;0
30396;23433;842;99;44;2;42;.955;3600000;0
30396;192688;831;47;21;3;18;.857;3586000;0
30396;89190;831;0;0;0;0;.00nan;0;0
30397;165582;848;100;23;0;23;1.000;3600000;0
30397;78223;839;0;0;0;0;.00nan;0;0
30397;87603;848;0;0;0;0;.00nan;0;0
30397;148041;839;38;31;5;26;.839;3600000;0
30398;167824;834;0;0;0;0;.00nan;0;0
30398;180287;847;95;51;2;49;.961;3900000;0
30398;67287;834;72;24;2;22;.917;3900000;0
30398;89874;847;0;0;0;0;.00nan;0;0
30399;26336;829;50;22;3;19;.864;1770000;0
30399;53867;829;29;18;5;13;.722;1830000;0
30399;68390;828;52;27;4;23;.852;3600000;0
30399;147845;828;0;0;0;0;.00nan;0;0
30400;5573;836;0;0;0;0;.00nan;0;0
30400;13373;837;0;0;0;0;.00nan;0;0
30400;182116;836;84;37;3;34;.919;3600000;0
30400;78920;837;87;36;2;34;.944;3600000;0
30401;16588;832;89;31;1;30;.968;3600000;0
30401;16838;830;87;47;3;44;.936;3550000;0
30401;47736;832;0;0;0;0;.00nan;0;0
30401;47791;830;0;0;0;0;.00nan;0;0
30402;13373;837;86;37;2;35;.946;3600000;0
30402;165582;848;70;28;3;25;.893;3600000;0
30402;78920;837;0;0;0;0;.00nan;0;0
30402;87603;848;0;0;0;0;.00nan;0;0
30403;167824;834;85;25;1;24;.960;3600000;0
30403;183545;842;61;46;5;41;.891;3600000;0
30403;23433;842;0;0;0;0;.00nan;0;0
30403;67287;834;0;0;0;0;.00nan;0;0
30404;5573;836;0;0;0;0;.00nan;0;0
30404;5663;833;0;0;0;0;.00nan;0;0
30404;-1;833;66;16;1;15;.938;3600000;0
30404;182116;836;67;39;4;35;.897;3600000;0
30405;180287;847;94;44;3;41;.932;3600000;0
30405;192688;831;61;19;2;17;.895;3600000;0
30405;89190;831;0;0;0;0;.00nan;0;0
30405;89874;847;0;0;0;0;.00nan;0;0
30406;16588;832;0;0;0;0;.00nan;0;0
30406;47736;832;55;24;4;20;.833;3572000;0
30406;68390;828;0;0;0;0;.00nan;0;0
30406;147845;828;84;41;3;38;.927;3600000;0
30407;2410;838;0;0;0;0;.00nan;0;0
30407;174334;838;98;45;2;43;.956;3581000;0
30407;78223;839;92;18;0;18;1.000;3600000;0
30407;148041;839;0;0;0;0;.00nan;0;0
30408;16838;830;51;30;4;26;.867;3600000;0
30408;26336;829;30;27;6;21;.778;2093000;0
30408;47791;830;0;0;0;0;.00nan;0;0
30408;53867;829;30;12;3;9;.750;1507000;0
30409;2410;838;0;0;0;0;.00nan;0;0
30409;13373;837;0;0;0;0;.00nan;0;0
30409;174334;838;63;39;4;35;.897;3600000;0
30409;78920;837;70;20;1;19;.950;3600000;0
30410;16838;830;61;40;5;35;.875;3554000;0
30410;192688;831;53;30;4;26;.867;3600000;0
30410;47791;830;0;0;0;0;.00nan;0;0
30410;89190;831;0;0;0;0;.00nan;0;0
30411;165582;848;0;0;0;0;.00nan;0;0
30411;68390;828;84;39;3;36;.923;3827000;0
30411;87603;848;71;38;4;34;.895;3827000;0
30411;147845;828;0;0;0;0;.00nan;0;0
30412;167824;834;0;0;0;0;.00nan;0;0
30412;67287;834;82;31;3;28;.903;3900000;0
30412;78223;839;58;25;3;22;.880;3900000;0
30412;148041;839;0;0;0;0;.00nan;0;0
30413;183545;842;0;0;0;0;.00nan;0;0
30413;23433;842;83;32;2;30;.938;3600000;0
30413;26336;829;65;24;3;21;.875;3546000;0
30413;53867;829;0;0;0;0;.00nan;0;0
30414;5573;836;0;0;0;0;.00nan;0;0
30414;180287;847;100;40;0;40;1.000;3600000;0
30414;182116;836;41;30;5;25;.833;3600000;0
30414;89874;847;0;0;0;0;.00nan;0;0
30415;5663;833;100;26;0;26;1.000;3600000;0
30415;16588;832;0;0;0;0;.00nan;0;0
30415;-1;833;0;0;0;0;.00nan;0;0
30415;47736;832;90;38;2;36;.947;3600000;0
30416;2410;838;0;0;0;0;.00nan;0;0
30416;174334;838;80;32;2;30;.938;3600000;0
30416;26336;829;64;29;3;26;.897;3600000;0
30416;53867;829;0;0;0;0;.00nan;0;0
30417;165582;848;67;30;3;27;.900;3600000;0
30417;192688;831;100;36;0;36;1.000;3600000;0
30417;87603;848;0;0;0;0;.00nan;0;0
30417;89190;831;0;0;0;0;.00nan;0;0
30418;167824;834;0;0;0;0;.00nan;0;0
30418;16588;832;0;0;0;0;.00nan;0;0
30418;47736;832;62;26;3;23;.885;3577000;0
30418;67287;834;69;24;2;22;.917;3600000;0
30419;16838;830;94;32;3;29;.906;3900000;0
30419;47791;830;0;0;0;0;.00nan;0;0
30419;78223;839;0;0;0;0;.00nan;0;0
30419;148041;839;59;24;3;21;.875;3900000;0
30420;5573;836;0;0;0;0;.00nan;0;0
30420;16838;830;47;28;5;23;.821;3600000;0
30420;182116;836;81;42;2;40;.952;3600000;0
30420;47791;830;0;0;0;0;.00nan;0;0
30421;167824;834;86;27;1;26;.963;3600000;0
30421;165582;848;0;0;0;0;.00nan;0;0
30421;67287;834;0;0;0;0;.00nan;0;0
30421;87603;848;69;29;3;26;.897;3600000;0
30422;26336;829;0;0;0;0;.00nan;0;0
30422;192688;831;78;34;3;31;.912;3561000;0
30422;53867;829;86;40;2;38;.950;3600000;0
30422;89190;831;0;0;0;0;.00nan;0;0
30423;5663;833;91;14;0;14;1.000;3900000;0
30423;183545;842;0;0;0;0;.00nan;0;0
30423;23433;842;97;45;0;45;1.000;3900000;0
30423;-1;833;0;0;0;0;.00nan;0;0
30424;180287;847;55;38;5;33;.868;3561000;0
30424;78223;839;53;23;3;20;.870;3600000;0
30424;89874;847;0;0;0;0;.00nan;0;0
30424;148041;839;0;0;0;0;.00nan;0;0
30425;13373;837;0;0;0;0;.00nan;0;0
30425;68390;828;96;40;2;38;.950;3600000;0
30425;78920;837;44;27;4;23;.852;3551000;0
30425;147845;828;0;0;0;0;.00nan;0;0
30426;5663;833;78;39;4;35;.897;3600000;0
30426;13373;837;24;31;7;24;.774;3272000;0
30426;-1;833;0;0;0;0;.00nan;0;0
30426;78920;837;57;4;0;4;1.000;328000;0
30427;183545;842;79;36;3;33;.917;3519000;0
30427;23433;842;0;0;0;0;.00nan;0;0
30427;180287;847;84;28;1;27;.964;3600000;0
30427;89874;847;0;0;0;0;.00nan;0;0
30428;2410;838;0;0;0;0;.00nan;0;0
30428;16588;832;80;24;1;23;.958;3900000;0
30428;174334;838;95;28;1;27;.964;3900000;0
30428;47736;832;0;0;0;0;.00nan;0;0
30429;13373;837;0;0;0;0;.00nan;0;0
30429;68390;828;56;32;4;28;.875;3600000;0
30429;78920;837;100;32;1;31;.969;3600000;0
30429;147845;828;0;0;0;0;.00nan;0;0
30430;183545;842;63;29;3;26;.897;3579000;0
30430;-1;842;0;0;0;0;.00nan;0;0
30430;78223;839;0;0;0;0;.00nan;0;0
30430;148041;839;81;19;1;18;.947;3600000;0
30431;5573;836;0;0;0;0;.00nan;0;0
30431;16838;830;72;34;3;31;.912;3600000;0
30431;182116;836;48;39;6;33;.846;3600000;0
30431;47791;830;0;0;0;0;.00nan;0;0
30432;183545;842;83;33;2;31;.939;3900000;0
30432;-1;842;0;0;0;0;.00nan;0;0
30432;68390;828;0;0;0;0;.00nan;0;0
30432;147845;828;87;32;2;30;.938;3900000;0
30433;167824;834;0;0;0;0;.00nan;0;0
30433;67287;834;73;24;1;23;.958;3545000;0
30433;78223;839;80;10;0;10;1.000;3600000;0
30433;148041;839;0;0;0;0;.00nan;0;0
30434;2410;838;87;35;2;33;.943;3600000;0
30434;174334;838;0;0;0;0;.00nan;0;0
30434;180287;847;88;28;1;27;.964;3600000;0
30434;89874;847;0;0;0;0;.00nan;0;0
30435;165582;848;88;23;1;22;.957;3600000;0
30435;16838;830;0;0;0;0;.00nan;0;0
30435;23433;848;0;0;0;0;.00nan;0;0
30435;47791;830;55;24;3;21;.875;3581000;0
30436;13373;837;0;0;0;0;.00nan;0;0
30436;26336;829;0;0;0;0;.00nan;0;0
30436;53867;829;45;54;8;46;.852;3600000;0
30436;78920;837;95;21;0;21;1.000;3600000;0
30437;16588;832;92;27;1;26;.963;3600000;0
30437;192688;831;83;34;2;32;.941;3567000;0
30437;-1;832;0;0;0;0;.00nan;0;0
30437;89190;831;0;0;0;0;.00nan;0;0
30438;13373;837;0;0;0;0;.00nan;0;0
30438;16838;830;11;24;7;17;.708;2301000;0
30438;47791;830;40;23;4;19;.826;1299000;0
30438;78920;837;81;30;2;28;.933;3600000;0
30439;2410;838;88;28;1;27;.964;2487000;0
30439;174334;838;42;18;4;14;.778;1113000;0
30439;192688;831;0;0;0;0;.00nan;0;0
30439;89190;831;71;16;1;15;.938;3600000;0
30440;5573;836;0;0;0;0;.00nan;0;0
30440;165582;848;100;30;0;30;1.000;3600000;0
30440;23433;848;0;0;0;0;.00nan;0;0
30440;182116;836;97;42;1;41;.976;3570000;0
30441;167824;834;0;0;0;0;.00nan;0;0
30441;26336;829;48;33;5;28;.848;3600000;0
30441;53867;829;0;0;0;0;.00nan;0;0
30441;67287;834;87;38;3;35;.921;3600000;0
30442;16588;832;0;0;0;0;.00nan;0;0
30442;180287;847;0;0;0;0;.00nan;0;0
30442;-1;832;30;39;7;32;.821;3600000;0
30442;89874;847;79;33;3;30;.909;3600000;0
30443;5663;833;0;0;0;0;.00nan;0;0
30443;-1;833;64;17;1;16;.941;3600000;0
30443;78223;839;0;0;0;0;.00nan;0;0
30443;148041;839;76;41;3;38;.927;3523000;0
30444;5573;836;0;0;0;0;.00nan;0;0
30444;183545;842;80;30;2;28;.933;3577000;0
30444;182116;836;95;18;0;18;1.000;3600000;0
30444;-1;842;0;0;0;0;.00nan;0;0
30445;2410;838;0;0;0;0;.00nan;0;0
30445;13373;837;0;0;0;0;.00nan;0;0
30445;174334;838;76;26;2;24;.923;3600000;0
30445;78920;837;58;25;3;22;.880;3544000;0
30446;13373;837;39;24;5;19;.792;3600000;0
30446;16588;832;34;43;8;35;.814;3600000;0
30446;-1;832;0;0;0;0;.00nan;0;0
30446;78920;837;0;0;0;0;.00nan;0;0
30447;167824;834;0;0;0;0;.00nan;0;0
30447;16838;830;93;32;1;31;.969;3600000;0
30447;47791;830;0;0;0;0;.00nan;0;0
30447;67287;834;90;55;4;51;.927;3600000;0
30448;183545;842;0;0;0;0;.00nan;0;0
30448;165582;848;72;18;1;17;.944;3600000;0
30448;23433;848;0;0;0;0;.00nan;0;0
30448;-1;842;76;45;4;41;.911;3600000;0
30449;2410;838;0;0;0;0;.00nan;0;0
30449;5573;836;0;0;0;0;.00nan;0;0
30449;174334;838;84;38;3;35;.921;3521000;0
30449;182116;836;68;24;2;22;.917;3600000;0
30450;5663;833;50;18;4;14;.778;3900000;0
30450;26336;829;0;0;0;0;.00nan;0;0
30450;-1;833;0;0;0;0;.00nan;0;0
30450;53867;829;90;52;4;48;.923;3900000;0
30451;192688;831;89;48;4;44;.917;3560000;0
30451;78223;839;0;0;0;0;.00nan;0;0
30451;89190;831;0;0;0;0;.00nan;0;0
30451;148041;839;74;35;3;32;.914;3600000;0
30452;2410;838;71;23;2;21;.913;3568000;0
30452;183545;842;92;20;0;20;1.000;3600000;0
30452;174334;838;0;0;0;0;.00nan;0;0
30452;-1;842;0;0;0;0;.00nan;0;0
30453;192688;831;40;18;4;14;.778;3519000;0
30453;68390;828;82;38;2;36;.947;3600000;0
30453;89190;831;0;0;0;0;.00nan;0;0
30453;147845;828;0;0;0;0;.00nan;0;0
30454;5663;833;0;0;0;0;.00nan;0;0
30454;165582;848;84;40;2;38;.950;3900000;0
30454;23433;848;0;0;0;0;.00nan;0;0
30454;-1;833;54;12;2;10;.833;3900000;0
30455;167824;834;80;34;2;32;.941;3517000;0
30455;13373;837;0;0;0;0;.00nan;0;0
30455;67287;834;0;0;0;0;.00nan;0;0
30455;78920;837;100;28;0;28;1.000;3600000;0
30456;16838;830;0;0;0;0;.00nan;0;0
30456;180287;847;87;44;3;41;.932;3900000;0
30456;47791;830;78;32;3;29;.906;3900000;0
30456;89874;847;0;0;0;0;.00nan;0;0
30457;5573;836;0;0;0;0;.00nan;0;0
30457;16588;832;0;0;0;0;.00nan;0;0
30457;182116;836;68;39;4;35;.897;3525000;0
30457;-1;832;92;44;2;42;.955;3600000;0
30458;26336;829;0;0;0;0;.00nan;0;0
30458;53867;829;57;29;4;25;.862;3588000;0
30458;78223;839;0;0;0;0;.00nan;0;0
30458;148041;839;82;34;2;32;.941;3600000;0
30459;180287;847;0;0;0;0;.00nan;0;0
30459;68390;828;0;0;0;0;.00nan;0;0
30459;89874;847;81;45;4;41;.911;3600000;0
30459;147845;828;68;17;1;16;.941;3600000;0
30460;183545;842;51;32;4;28;.875;3551000;0
30460;13373;837;0;0;0;0;.00nan;0;0
30460;-1;842;0;0;0;0;.00nan;0;0
30460;78920;837;58;21;3;18;.857;3600000;0
30461;5573;836;64;16;1;15;.938;3600000;0
30461;182116;836;0;0;0;0;.00nan;0;0
30461;68390;828;78;47;5;42;.894;3600000;0
30461;147845;828;0;0;0;0;.00nan;0;0
30462;13373;837;0;0;0;0;.00nan;0;0
30462;192688;831;80;47;5;42;.894;3573000;0
30462;78920;837;65;34;4;30;.882;3600000;0
30462;89190;831;0;0;0;0;.00nan;0;0
30463;183545;842;81;47;4;43;.915;3900000;0
30463;16838;830;43;21;4;17;.810;3900000;0
30463;47791;830;0;0;0;0;.00nan;0;0
30463;-1;842;0;0;0;0;.00nan;0;0
30464;165582;848;83;29;1;28;.966;3600000;0
30464;23433;848;0;0;0;0;.00nan;0;0
30464;180287;847;64;33;4;29;.879;3600000;0
30464;89874;847;0;0;0;0;.00nan;0;0
30465;5663;833;27;25;6;19;.760;2076000;0
30465;167824;834;53;32;4;28;.875;2930000;0
30465;-1;833;32;10;3;7;.700;1472000;0
30465;67287;834;22;9;4;5;.556;670000;0
30466;2410;838;0;0;0;0;.00nan;0;0
30466;174334;838;100;33;1;32;.970;3600000;0
30466;68390;828;97;49;2;47;.959;3559000;0
30466;147845;828;0;0;0;0;.00nan;0;0
30467;16588;832;78;34;3;31;.912;3600000;0
30467;-1;832;0;0;0;0;.00nan;0;0
30467;78223;839;0;0;0;0;.00nan;0;0
30467;148041;839;82;32;2;30;.938;3600000;0
30468;2410;838;0;0;0;0;.00nan;0;0
30468;167824;834;0;0;0;0;.00nan;0;0
30468;174334;838;83;39;3;36;.923;3900000;0
30468;67287;834;54;27;3;24;.889;3900000;0
30469;5573;836;0;0;0;0;.00nan;0;0
30469;182116;836;35;30;6;24;.800;3600000;0
30469;192688;831;100;34;0;34;1.000;3600000;0
30469;89190;831;0;0;0;0;.00nan;0;0
30470;5663;833;0;0;0;0;.00nan;0;0
30470;16838;830;100;26;0;26;1.000;3600000;0
30470;-1;833;74;39;4;35;.897;3600000;0
30470;47791;830;0;0;0;0;.00nan;0;0
30471;183545;842;75;38;3;35;.921;3548000;0
30471;16588;832;51;12;2;10;.833;3600000;0
30471;-1;832;0;0;0;0;.00nan;0;0
30471;-1;842;0;0;0;0;.00nan;0;0
30472;165582;848;53;25;4;21;.840;3583000;0
30472;23433;848;0;0;0;0;.00nan;0;0
30472;26336;829;0;0;0;0;.00nan;0;0
30472;53867;829;89;43;3;40;.930;3600000;0
30473;13373;837;0;0;0;0;.00nan;0;0
30473;180287;847;64;41;4;37;.902;3550000;0
30473;78920;837;58;20;3;17;.850;3600000;0
30473;89874;847;0;0;0;0;.00nan;0;0
30474;68390;828;85;28;1;27;.964;3600000;0
30474;78223;839;41;22;5;17;.773;3600000;0
30474;147845;828;0;0;0;0;.00nan;0;0
30474;148041;839;0;0;0;0;.00nan;0;0
30475;183545;842;100;41;2;39;.951;3900000;0
30475;13373;837;0;0;0;0;.00nan;0;0
30475;-1;842;0;0;0;0;.00nan;0;0
30475;78920;837;73;27;2;25;.926;3900000;0
30476;2410;838;0;0;0;0;.00nan;0;0
30476;165582;848;97;35;2;33;.943;3900000;0
30476;23433;848;0;0;0;0;.00nan;0;0
30476;174334;838;100;50;2;48;.960;3900000;0
30477;167824;834;0;0;0;0;.00nan;0;0
30477;192688;831;93;48;3;45;.938;3546000;0
30477;67287;834;96;32;2;30;.938;3600000;0
30477;89190;831;0;0;0;0;.00nan;0;0
30478;5573;836;0;0;0;0;.00nan;0;0
30478;182116;836;86;33;1;32;.970;3600000;0
30478;78223;839;0;0;0;0;.00nan;0;0
30478;148041;839;64;32;3;29;.906;3584000;0
30479;5663;833;0;0;0;0;.00nan;0;0
30479;-1;833;57;20;3;17;.850;3600000;0
30479;180287;847;80;63;6;57;.905;3600000;0
30479;89874;847;0;0;0;0;.00nan;0;0
30480;16838;830;100;27;0;27;1.000;3600000;0
30480;47791;830;0;0;0;0;.00nan;0;0
30480;68390;828;24;34;7;27;.794;3600000;0
30480;147845;828;0;0;0;0;.00nan;0;0
30481;16588;832;94;29;1;28;.966;3600000;0
30481;26336;829;0;0;0;0;.00nan;0;0
30481;-1;832;0;0;0;0;.00nan;0;0
30481;53867;829;91;42;2;40;.952;3600000;0
30483;183545;842;96;41;2;39;.951;3600000;0
30483;23433;842;0;0;0;0;.00nan;0;0
30483;26336;829;50;29;4;25;.862;2242000;0
30483;53867;829;40;2;1;1;.500;1358000;0
30485;16588;836;0;0;0;0;.00nan;0;0
30485;182116;836;79;29;2;27;.931;3900000;0
30485;47742;848;0;0;0;0;.00nan;0;0
30485;87603;848;76;28;2;26;.929;3900000;0
30487;13373;837;0;0;0;0;.00nan;0;0
30487;78223;839;0;0;0;0;.00nan;0;0
30487;78920;837;73;38;4;34;.895;3638000;0
30487;148041;839;71;35;3;32;.914;3620000;0
30489;2410;838;88;40;2;38;.950;3521000;0
30489;174334;832;100;25;0;25;1.000;3600000;0
30489;47736;832;0;0;0;0;.00nan;0;0
30489;48141;838;0;0;0;0;.00nan;0;0
30491;16838;830;100;38;1;37;.974;3600000;0
30491;47791;830;0;0;0;0;.00nan;0;0
30491;68390;828;53;34;5;29;.853;3600000;0
30491;147845;828;0;0;0;0;.00nan;0;0
30493;5663;833;0;0;0;0;.00nan;0;0
30493;-1;833;47;31;5;26;.839;3539000;0
30493;185506;831;85;41;3;38;.927;3600000;0
30493;89190;831;0;0;0;0;.00nan;0;0
30495;167824;834;0;0;0;0;.00nan;0;0
30495;180287;847;81;44;4;40;.909;3608000;0
30495;67287;834;55;28;3;25;.893;3608000;0
30495;89874;847;0;0;0;0;.00nan;0;0
30497;16588;836;65;23;2;21;.913;3315000;0
30497;182116;836;13;5;4;1;.200;285000;0
30497;47742;848;75;18;1;17;.944;3600000;0
30497;87603;848;0;0;0;0;.00nan;0;0
30499;174334;832;83;37;3;34;.919;3527000;0
30499;185506;831;0;0;0;0;.00nan;0;0
30499;47736;832;0;0;0;0;.00nan;0;0
30499;89190;831;90;30;1;29;.967;3600000;0
30501;2410;838;0;0;0;0;.00nan;0;0
30501;48141;838;51;39;5;34;.872;3600000;0
30501;68390;828;0;0;0;0;.00nan;0;0
30501;147845;828;75;19;1;18;.947;3600000;0
30503;183545;842;0;0;0;0;.00nan;0;0
30503;23433;842;96;50;3;47;.940;3600000;0
30503;78223;839;60;30;4;26;.867;3600000;0
30503;148041;839;0;0;0;0;.00nan;0;0
30505;5663;833;63;18;2;16;.889;3900000;0
30505;16838;830;0;0;0;0;.00nan;0;0
30505;-1;833;0;0;0;0;.00nan;0;0
30505;47791;830;100;62;2;60;.968;3900000;0
30507;26336;829;100;46;1;45;.978;3600000;0
30507;180287;847;0;0;0;0;.00nan;0;0
30507;53867;829;0;0;0;0;.00nan;0;0
30507;89874;847;69;29;2;27;.931;3551000;0
30509;167824;834;48;36;5;31;.861;3600000;0
30509;13373;837;78;35;2;33;.943;3600000;0
30509;67287;834;0;0;0;0;.00nan;0;0
30509;78920;837;0;0;0;0;.00nan;0;0
30511;183545;842;100;41;0;41;1.000;3600000;0
30511;23433;842;0;0;0;0;.00nan;0;0
30511;185506;831;52;19;2;17;.895;3512000;0
30511;89190;831;0;0;0;0;.00nan;0;0
30513;167824;834;0;0;0;0;.00nan;0;0
30513;67287;834;48;32;5;27;.844;3554000;0
30513;68390;828;58;31;4;27;.871;3600000;0
30513;147845;828;0;0;0;0;.00nan;0;0
30515;13373;837;87;37;2;35;.946;3600000;0
30515;174334;832;28;7;3;4;.571;493000;0
30515;47736;832;64;30;3;27;.900;3107000;0
30515;78920;837;0;0;0;0;.00nan;0;0
30517;26336;829;64;33;4;29;.879;3600000;0
30517;53867;829;0;0;0;0;.00nan;0;0
30517;78223;839;0;0;0;0;.00nan;0;0
30517;148041;839;67;19;1;18;.947;3600000;0
30519;2410;838;76;39;4;35;.897;3900000;0
30519;16838;830;55;33;4;29;.879;3900000;0
30519;47791;830;0;0;0;0;.00nan;0;0
30519;48141;838;0;0;0;0;.00nan;0;0
30521;5663;833;59;16;2;14;.875;3600000;0
30521;-1;833;0;0;0;0;.00nan;0;0
30521;180287;847;97;61;3;58;.951;3560000;0
30521;89874;847;0;0;0;0;.00nan;0;0
30523;16588;836;0;0;0;0;.00nan;0;0
30523;182116;836;45;25;4;21;.840;3555000;0
30523;47742;848;0;0;0;0;.00nan;0;0
30523;87603;848;66;32;3;29;.906;3600000;0
30525;174334;832;56;37;5;32;.865;3600000;0
30525;26336;829;0;0;0;0;.00nan;0;0
30525;47736;832;0;0;0;0;.00nan;0;0
30525;53867;829;64;24;2;22;.917;3600000;0
30527;180287;847;0;0;0;0;.00nan;0;0
30527;47742;848;57;30;4;26;.867;3600000;0
30527;87603;848;0;0;0;0;.00nan;0;0
30527;89874;847;82;26;1;25;.962;3600000;0
30529;167824;834;63;24;2;22;.917;3600000;0
30529;183545;842;93;44;3;41;.932;3541000;0
30529;23433;842;0;0;0;0;.00nan;0;0
30529;67287;834;0;0;0;0;.00nan;0;0
30531;5663;833;0;0;0;0;.00nan;0;0
30531;-1;833;81;13;0;13;1.000;3600000;0
30531;78223;839;74;24;1;23;.958;3562000;0
30531;148041;839;0;0;0;0;.00nan;0;0
30533;16588;836;0;0;0;0;.00nan;0;0
30533;182116;836;81;35;2;33;.943;3600000;0
30533;68390;828;0;0;0;0;.00nan;0;0
30533;147845;828;71;41;5;36;.878;3600000;0
30535;2410;838;0;0;0;0;.00nan;0;0
30535;13373;837;0;0;0;0;.00nan;0;0
30535;48141;838;85;36;2;34;.944;3900000;0
30535;78920;837;87;29;2;27;.931;3900000;0
30537;16838;830;0;0;0;0;.00nan;0;0
30537;185506;831;0;0;0;0;.00nan;0;0
30537;47791;830;74;42;4;38;.905;3600000;0
30537;89190;831;80;24;1;23;.958;3600000;0
30539;174334;832;85;40;3;37;.925;3626000;0
30539;26336;829;83;34;2;32;.941;3626000;0
30539;47736;832;0;0;0;0;.00nan;0;0
30539;53867;829;0;0;0;0;.00nan;0;0
30541;2410;838;67;22;2;20;.909;3600000;0
30541;47742;848;0;0;0;0;.00nan;0;0
30541;48141;838;0;0;0;0;.00nan;0;0
30541;87603;848;76;39;3;36;.923;3551000;0
30543;16838;830;54;27;4;23;.852;3564000;0
30543;47791;830;0;0;0;0;.00nan;0;0
30543;68390;828;66;28;3;25;.893;3600000;0
30543;147845;828;0;0;0;0;.00nan;0;0
30545;180287;847;73;37;3;34;.919;3572000;0
30545;78223;839;0;0;0;0;.00nan;0;0
30545;89874;847;0;0;0;0;.00nan;0;0
30545;148041;839;74;22;1;21;.955;3600000;0
30547;13373;837;68;17;1;16;.941;3701000;0
30547;16588;836;0;0;0;0;.00nan;0;0
30547;182116;836;94;40;2;38;.950;3701000;0
30547;78920;837;0;0;0;0;.00nan;0;0
30549;167824;834;71;46;5;41;.891;3600000;0
30549;185506;831;46;26;4;22;.846;3600000;0
30549;67287;834;0;0;0;0;.00nan;0;0
30549;89190;831;0;0;0;0;.00nan;0;0
30551;5663;833;0;0;0;0;.00nan;0;0
30551;183545;842;0;0;0;0;.00nan;0;0
30551;23433;842;98;56;3;53;.946;3600000;0
30551;-1;833;81;13;0;13;1.000;3600000;0
30553;16838;830;67;25;2;23;.920;3900000;0
30553;47742;848;0;0;0;0;.00nan;0;0
30553;47791;830;0;0;0;0;.00nan;0;0
30553;87603;848;95;43;2;41;.953;3900000;0
30555;2410;838;0;0;0;0;.00nan;0;0
30555;13373;837;0;0;0;0;.00nan;0;0
30555;174334;838;65;43;5;38;.884;3600000;0
30555;78920;837;71;20;1;19;.950;3600000;0
30557;167824;834;55;16;2;14;.875;1430000;0
30557;26336;829;62;36;4;32;.889;3600000;0
30557;53867;829;0;0;0;0;.00nan;0;0
30557;67287;834;25;25;6;19;.760;2170000;0
30559;180287;847;92;34;2;32;.941;3539000;0
30559;68390;828;0;0;0;0;.00nan;0;0
30559;89874;847;0;0;0;0;.00nan;0;0
30559;147845;828;92;20;0;20;1.000;3600000;0
30561;16588;836;0;0;0;0;.00nan;0;0
30561;182116;836;77;11;0;11;1.000;3600000;0
30561;185506;831;32;34;7;27;.794;3600000;0
30561;89190;831;0;0;0;0;.00nan;0;0
30563;183545;842;60;34;4;30;.882;3585000;0
30563;23433;842;0;0;0;0;.00nan;0;0
30563;47736;832;0;0;0;0;.00nan;0;0
30563;147962;832;35;17;3;14;.824;3600000;0
30565;5663;833;0;0;0;0;.00nan;0;0
30565;-1;833;71;16;1;15;.938;3600000;0
30565;78223;839;0;0;0;0;.00nan;0;0
30565;148041;839;43;26;4;22;.846;3600000;0
30567;183545;842;0;0;0;0;.00nan;0;0
30567;23433;842;53;32;5;27;.844;3600000;0
30567;47736;832;76;22;1;21;.955;3600000;0
30567;147962;832;0;0;0;0;.00nan;0;0
30569;5663;833;63;14;1;13;.929;3600000;0
30569;26336;829;0;0;0;0;.00nan;0;0
30569;-1;833;0;0;0;0;.00nan;0;0
30569;53867;829;50;40;5;35;.875;3600000;0
30571;180287;847;0;0;0;0;.00nan;0;0
30571;68390;828;0;0;0;0;.00nan;0;0
30571;89874;847;64;21;2;19;.905;3600000;0
30571;147845;828;49;30;4;26;.867;3556000;0
30573;16588;836;0;0;0;0;.00nan;0;0
30573;182116;836;72;26;3;23;.885;3600000;0
30573;47742;848;71;44;4;40;.909;3545000;0
30573;87603;848;0;0;0;0;.00nan;0;0
30575;2410;838;67;36;4;32;.889;3900000;0
30575;13373;837;39;24;4;20;.833;3900000;0
30575;174334;838;0;0;0;0;.00nan;0;0
30575;78920;837;0;0;0;0;.00nan;0;0
30577;167824;834;0;0;0;0;.00nan;0;0
30577;67287;834;78;27;1;26;.963;3600000;0
30577;78223;839;0;0;0;0;.00nan;0;0
30577;148041;839;58;25;3;22;.880;3540000;0
30579;16838;830;0;0;0;0;.00nan;0;0
30579;185506;831;0;0;0;0;.00nan;0;0
30579;47791;830;75;45;4;41;.911;3600000;0
30579;89190;831;71;27;2;25;.926;3600000;0
1071;5573;836;0;0;0;0;.00nan;0;0
1071;182116;836;86;38;3;35;.921;3600000;0
1071;192688;831;72;38;4;34;.895;3600000;0
1071;89190;831;0;0;0;0;.00nan;0;0
1072;16588;832;77;37;3;34;.919;3600000;0
1072;-1;832;0;0;0;0;.00nan;0;0
1072;68390;828;60;34;4;30;.882;3563000;0
1072;147845;828;0;0;0;0;.00nan;0;0
1073;5573;836;0;0;0;0;.00nan;0;0
1073;182116;836;73;28;3;25;.893;3600000;0
1073;192688;831;54;41;6;35;.854;3600000;0
1073;89190;831;0;0;0;0;.00nan;0;0
1074;16588;832;69;23;2;21;.913;3600000;0
1074;-1;832;0;0;0;0;.00nan;0;0
1074;68390;828;55;31;4;27;.871;3547000;0
1074;147845;828;0;0;0;0;.00nan;0;0
1168;16588;832;62;27;3;24;.889;3600000;0
1168;192688;831;44;40;8;32;.800;3155000;0
1168;-1;832;0;0;0;0;.00nan;0;0
1168;89190;831;53;3;0;3;1.000;445000;0
1169;16588;832;67;38;4;34;.895;3600000;0
1169;192688;831;70;24;2;22;.917;3600000;0
1169;-1;832;0;0;0;0;.00nan;0;0
1169;89190;831;0;0;0;0;.00nan;0;0
1324;16588;832;100;37;0;37;1.000;3600000;0
1324;192688;831;63;21;2;19;.905;3600000;0
1324;-1;832;0;0;0;0;.00nan;0;0
1324;89190;831;0;0;0;0;.00nan;0;0
1408;13373;837;0;0;0;0;.00nan;0;0
1408;16588;832;34;31;6;25;.806;3600000;0
1408;-1;832;0;0;0;0;.00nan;0;0
1408;78920;837;51;27;4;23;.852;3600000;0
1409;165582;848;68;35;3;32;.914;4683000;0
1409;23433;848;0;0;0;0;.00nan;0;0
1409;78223;839;0;0;0;0;.00nan;0;0
1409;148041;839;83;38;2;36;.947;4683000;0
1410;167824;834;0;0;0;0;.00nan;0;0
1410;16838;830;81;25;2;23;.920;3600000;0
1410;47791;830;0;0;0;0;.00nan;0;0
1410;67287;834;72;36;3;33;.917;3560000;0
1411;5573;836;0;0;0;0;.00nan;0;0
1411;5663;833;72;27;2;25;.926;3600000;0
1411;-1;833;0;0;0;0;.00nan;0;0
1411;182116;836;93;49;3;46;.939;3557000;0
1412;13373;837;0;0;0;0;.00nan;0;0
1412;16588;832;88;39;3;36;.923;3844000;0
1412;-1;832;0;0;0;0;.00nan;0;0
1412;78920;837;64;27;2;25;.926;3844000;0
1413;165582;848;40;25;5;20;.800;3600000;0
1413;23433;848;0;0;0;0;.00nan;0;0
1413;78223;839;0;0;0;0;.00nan;0;0
1413;148041;839;60;25;2;23;.920;3600000;0
1414;167824;834;0;0;0;0;.00nan;0;0
1414;16838;830;78;47;4;43;.915;3540000;0
1414;47791;830;0;0;0;0;.00nan;0;0
1414;67287;834;75;30;2;28;.933;3600000;0
1415;5573;836;0;0;0;0;.00nan;0;0
1415;5663;833;58;36;4;32;.889;4592000;0
1415;-1;833;0;0;0;0;.00nan;0;0
1415;182116;836;82;53;5;48;.906;4592000;0
1416;13373;837;0;0;0;0;.00nan;0;0
1416;16588;832;100;28;0;28;1.000;3600000;0
1416;-1;832;0;0;0;0;.00nan;0;0
1416;78920;837;69;21;1;20;.952;3568000;0
1417;165582;848;55;17;2;15;.882;3600000;0
1417;23433;848;0;0;0;0;.00nan;0;0
1417;78223;839;0;0;0;0;.00nan;0;0
1417;148041;839;72;42;5;37;.881;3600000;0
1418;167824;834;0;0;0;0;.00nan;0;0
1418;16838;830;95;34;1;33;.971;3600000;0
1418;47791;830;0;0;0;0;.00nan;0;0
1418;67287;834;67;35;4;31;.886;3600000;0
1419;5573;836;0;0;0;0;.00nan;0;0
1419;5663;833;50;19;3;16;.842;3600000;0
1419;-1;833;0;0;0;0;.00nan;0;0
1419;182116;836;61;50;6;44;.880;3600000;0
1420;13373;837;0;0;0;0;.00nan;0;0
1420;16588;832;63;35;3;32;.914;4103000;0
1420;-1;832;0;0;0;0;.00nan;0;0
1420;78920;837;41;27;4;23;.852;4103000;0
1421;165582;848;45;17;3;14;.824;3600000;0
1421;23433;848;0;0;0;0;.00nan;0;0
1421;78223;839;0;0;0;0;.00nan;0;0
1421;148041;839;59;32;4;28;.875;3571000;0
1422;167824;834;0;0;0;0;.00nan;0;0
1422;16838;830;99;36;1;35;.972;3600000;0
1422;47791;830;0;0;0;0;.00nan;0;0
1422;67287;834;44;26;4;22;.846;3600000;0
1423;5573;836;0;0;0;0;.00nan;0;0
1423;5663;833;100;28;0;28;1.000;3600000;0
1423;-1;833;0;0;0;0;.00nan;0;0
1423;182116;836;40;37;6;31;.838;3600000;0
1630;13373;837;0;0;0;0;.00nan;0;0
1630;16588;832;95;43;2;41;.953;3600000;0
1630;-1;832;0;0;0;0;.00nan;0;0
1630;78920;837;36;19;4;15;.789;3570000;0
1631;165582;848;67;22;2;20;.909;3600000;0
1631;23433;848;0;0;0;0;.00nan;0;0
1631;78223;839;0;0;0;0;.00nan;0;0
1631;148041;839;49;31;4;27;.871;3537000;0
1632;167824;834;0;0;0;0;.00nan;0;0
1632;16838;830;29;27;6;21;.778;2809000;0
1632;47791;830;78;25;1;24;.960;1755000;0
1632;67287;834;12;32;8;24;.750;4568000;0
1702;13373;837;0;0;0;0;.00nan;0;0
1702;16588;832;36;26;5;21;.808;3514000;0
1702;-1;832;0;0;0;0;.00nan;0;0
1702;78920;837;72;34;3;31;.912;3600000;0
1703;165582;848;81;39;3;36;.923;4847000;0
1703;23433;848;0;0;0;0;.00nan;0;0
1703;78223;839;0;0;0;0;.00nan;0;0
1703;148041;839;67;30;4;26;.867;4847000;0
1830;13373;837;0;0;0;0;.00nan;0;0
1830;16588;832;31;15;3;12;.800;591000;0
1830;-1;832;50;29;4;25;.862;3009000;0
1830;78920;837;100;21;0;21;1.000;3600000;0
1834;13373;837;0;0;0;0;.00nan;0;0
1834;165582;848;78;25;1;24;.960;3600000;0
1834;23433;848;0;0;0;0;.00nan;0;0
1834;78920;837;62;22;2;20;.909;3593000;0
1835;5663;833;28;26;6;20;.769;2447000;0
1835;16838;830;47;33;5;28;.848;3600000;0
1835;-1;833;57;6;0;6;1.000;1113000;0
1835;47791;830;0;0;0;0;.00nan;0;0
1836;13373;837;0;0;0;0;.00nan;0;0
1836;165582;848;48;30;5;25;.833;3600000;0
1836;23433;848;0;0;0;0;.00nan;0;0
1836;78920;837;73;22;1;21;.955;3600000;0
1837;5663;833;0;0;0;0;.00nan;0;0
1837;16838;830;100;34;0;34;1.000;3600000;0
1837;-1;833;46;20;3;17;.850;3600000;0
1837;47791;830;0;0;0;0;.00nan;0;0
1838;13373;837;0;0;0;0;.00nan;0;0
1838;165582;848;58;22;3;19;.864;3584000;0
1838;23433;848;0;0;0;0;.00nan;0;0
1838;78920;837;83;34;2;32;.941;3600000;0
1839;5663;833;0;0;0;0;.00nan;0;0
1839;16838;830;83;40;3;37;.925;3600000;0
1839;-1;833;69;30;4;26;.867;3544000;0
1839;47791;830;0;0;0;0;.00nan;0;0
1840;13373;837;0;0;0;0;.00nan;0;0
1840;165582;848;79;36;3;33;.917;3543000;0
1840;23433;848;0;0;0;0;.00nan;0;0
1840;78920;837;67;21;2;19;.905;3600000;0
1841;5663;833;0;0;0;0;.00nan;0;0
1841;16838;830;89;37;2;35;.946;3600000;0
1841;-1;833;48;20;3;17;.850;3600000;0
1841;47791;830;0;0;0;0;.00nan;0;0
1992;13373;837;0;0;0;0;.00nan;0;0
1992;165582;848;98;36;1;35;.972;3600000;0
1992;23433;848;0;0;0;0;.00nan;0;0
1992;78920;837;93;19;0;19;1.000;3600000;0
2046;13373;837;0;0;0;0;.00nan;0;0
2046;16838;830;70;24;3;21;.875;3856000;0
2046;47791;830;0;0;0;0;.00nan;0;0
2046;78920;837;69;29;2;27;.931;3856000;0
2047;13373;837;0;0;0;0;.00nan;0;0
2047;16838;830;78;36;3;33;.917;3517000;0
2047;47791;830;0;0;0;0;.00nan;0;0
2047;78920;837;79;24;1;23;.958;3600000;0
2048;13373;837;0;0;0;0;.00nan;0;0
2048;16838;830;45;30;5;25;.833;3552000;0
2048;47791;830;0;0;0;0;.00nan;0;0
2048;78920;837;36;20;4;16;.800;3600000;0
2049;13373;837;0;0;0;0;.00nan;0;0
2049;16838;830;78;42;4;38;.905;3528000;0
2049;47791;830;0;0;0;0;.00nan;0;0
2049;78920;837;77;31;2;29;.935;3600000;0
30580;201174;798;56;25;3;22;.880;3600000;0
30580;207727;783;56;29;4;25;.862;3563000;0
30580;-1;783;0;0;0;0;.00nan;0;0
30580;148956;798;0;0;0;0;.00nan;0;0
30581;209571;780;0;0;0;0;.00nan;0;0
30581;-1;780;94;48;3;45;.938;3900000;0
30581;62060;794;0;0;0;0;.00nan;0;0
30581;152201;794;86;37;3;34;.919;3900000;0
30582;190702;784;53;31;4;27;.871;3600000;0
30582;-1;784;0;0;0;0;.00nan;0;0
30582;-1;776;0;0;0;0;.00nan;0;0
30582;95405;776;38;24;5;19;.792;3543000;0
30583;193859;796;0;0;0;0;.00nan;0;0
30583;-1;3737;38;37;6;31;.838;3061000;0
30583;192030;3737;44;4;1;3;.750;539000;0
30583;149847;796;62;18;2;16;.889;3600000;0
30584;165867;2182;85;26;1;25;.962;3600000;0
30584;171673;778;38;30;5;25;.833;3600000;0
30584;202497;778;0;0;0;0;.00nan;0;0
30584;64066;2182;0;0;0;0;.00nan;0;0
30585;183377;904;99;41;2;39;.951;3600000;0
30585;207726;777;47;27;5;22;.815;3600000;0
30585;-1;904;0;0;0;0;.00nan;0;0
30585;-1;777;0;0;0;0;.00nan;0;0
30586;193859;796;0;0;0;0;.00nan;0;0
30586;209571;780;0;0;0;0;.00nan;0;0
30586;-1;780;56;31;4;27;.871;3690000;0
30586;149847;796;88;39;3;36;.923;3690000;0
30587;171673;778;84;29;2;27;.931;3900000;0
30587;190702;784;79;40;2;38;.950;3900000;0
30587;202497;778;0;0;0;0;.00nan;0;0
30587;-1;784;0;0;0;0;.00nan;0;0
30588;201174;798;0;0;0;0;.00nan;0;0
30588;207726;777;40;19;3;16;.842;3550000;0
30588;-1;777;0;0;0;0;.00nan;0;0
30588;148956;798;90;29;1;28;.966;3600000;0
30589;207727;783;100;32;0;32;1.000;3600000;0
30589;-1;783;0;0;0;0;.00nan;0;0
30589;62060;794;0;0;0;0;.00nan;0;0
30589;152201;794;51;28;4;24;.857;3600000;0
30590;183377;904;42;27;5;22;.815;2317000;0
30590;165867;2182;67;21;2;19;.905;3600000;0
30590;-1;904;51;24;3;21;.875;1283000;0
30590;64066;2182;0;0;0;0;.00nan;0;0
30591;-1;3737;94;26;0;26;1.000;3600000;0
30591;192030;3737;0;0;0;0;.00nan;0;0
30591;-1;776;0;0;0;0;.00nan;0;0
30591;95405;776;84;44;3;41;.932;3600000;0
30592;165867;2182;74;37;3;34;.919;3555000;0
30592;207726;777;0;0;0;0;.00nan;0;0
30592;-1;777;75;29;2;27;.931;3600000;0
30592;64066;2182;0;0;0;0;.00nan;0;0
30593;193859;796;0;0;0;0;.00nan;0;0
30593;207727;783;78;35;2;33;.943;3900000;0
30593;-1;783;0;0;0;0;.00nan;0;0
30593;149847;796;72;30;2;28;.933;3900000;0
30594;201174;798;0;0;0;0;.00nan;0;0
30594;62060;794;0;0;0;0;.00nan;0;0
30594;148956;798;68;20;2;18;.900;3600000;0
30594;152201;794;59;36;4;32;.889;3600000;0
30595;209571;780;22;22;6;16;.727;2665000;0
30595;-1;776;0;0;0;0;.00nan;0;0
30595;-1;780;52;9;1;8;.889;935000;0
30595;95405;776;89;38;2;36;.947;3600000;0
30596;171673;778;97;35;1;34;.971;3865000;0
30596;202497;778;0;0;0;0;.00nan;0;0
30596;-1;3737;69;26;2;24;.923;3865000;0
30596;192030;3737;0;0;0;0;.00nan;0;0
30597;183377;904;60;40;4;36;.900;3900000;0
30597;190702;784;78;35;4;31;.886;3900000;0
30597;-1;784;0;0;0;0;.00nan;0;0
30597;-1;904;0;0;0;0;.00nan;0;0
30598;209571;780;0;0;0;0;.00nan;0;0
30598;171673;778;100;27;0;27;1.000;3600000;0
30598;202497;778;0;0;0;0;.00nan;0;0
30598;-1;780;74;26;1;25;.962;3600000;0
30599;190702;784;0;0;0;0;.00nan;0;0
30599;207726;777;61;12;1;11;.917;3600000;0
30599;-1;784;82;42;3;39;.929;3583000;0
30599;-1;777;0;0;0;0;.00nan;0;0
30600;165867;2182;100;35;1;34;.971;3600000;0
30600;201174;798;0;0;0;0;.00nan;0;0
30600;64066;2182;0;0;0;0;.00nan;0;0
30600;148956;798;79;38;3;35;.921;3515000;0
30601;207727;783;71;28;3;25;.893;3600000;0
30601;-1;776;0;0;0;0;.00nan;0;0
30601;-1;783;0;0;0;0;.00nan;0;0
30601;95405;776;57;40;6;34;.850;3600000;0
30602;183377;904;46;35;5;30;.857;3600000;0
30602;-1;3737;57;25;3;22;.880;3600000;0
30602;192030;3737;0;0;0;0;.00nan;0;0
30602;-1;904;0;0;0;0;.00nan;0;0
30603;193859;796;0;0;0;0;.00nan;0;0
30603;62060;794;0;0;0;0;.00nan;0;0
30603;149847;796;78;13;0;13;1.000;3600000;0
30603;152201;794;84;59;3;56;.949;3600000;0
30604;165867;2182;47;30;5;25;.833;3536000;0
30604;190702;784;57;24;3;21;.875;3600000;0
30604;-1;784;0;0;0;0;.00nan;0;0
30604;86344;2182;0;0;0;0;.00nan;0;0
30605;-1;776;0;0;0;0;.00nan;0;0
30605;62060;794;0;0;0;0;.00nan;0;0
30605;95405;776;68;17;1;16;.941;3600000;0
30605;152201;794;76;31;2;29;.935;3600000;0
30606;207726;777;59;32;4;28;.875;3600000;0
30606;-1;3737;75;31;2;29;.935;3600000;0
30606;192030;3737;0;0;0;0;.00nan;0;0
30606;-1;777;0;0;0;0;.00nan;0;0
30607;171673;778;60;21;2;19;.905;3600000;0
30607;207727;783;63;46;5;41;.891;3600000;0
30607;-1;783;0;0;0;0;.00nan;0;0
30607;76486;778;0;0;0;0;.00nan;0;0
30608;193859;796;0;0;0;0;.00nan;0;0
30608;201174;798;73;36;3;33;.917;3739000;0
30608;148956;798;0;0;0;0;.00nan;0;0
30608;149847;796;52;26;4;22;.846;3751000;0
30609;183377;904;99;42;2;40;.952;3900000;0
30609;209571;780;61;23;2;21;.913;3900000;0
30609;-1;780;0;0;0;0;.00nan;0;0
30609;-1;904;0;0;0;0;.00nan;0;0
30610;209571;780;0;0;0;0;.00nan;0;0
30610;207726;777;0;0;0;0;.00nan;0;0
30610;-1;780;98;46;1;45;.978;3560000;0
30610;-1;777;90;19;0;19;1.000;3600000;0
30611;171673;778;94;31;1;30;.968;3900000;0
30611;62060;794;0;0;0;0;.00nan;0;0
30611;76486;778;0;0;0;0;.00nan;0;0
30611;152201;794;94;27;1;26;.963;3900000;0
30612;201174;798;0;0;0;0;.00nan;0;0
30612;190702;784;0;0;0;0;.00nan;0;0
30612;-1;784;27;22;5;17;.773;3600000;0
30612;148956;798;74;30;2;28;.933;3600000;0
30613;183377;904;51;37;4;33;.892;3549000;0
30613;207727;783;59;22;2;20;.909;3600000;0
30613;-1;904;0;0;0;0;.00nan;0;0
30613;-1;783;0;0;0;0;.00nan;0;0
30614;165867;2182;97;32;1;31;.969;3900000;0
30614;-1;3737;0;0;0;0;.00nan;0;0
30614;192030;3737;89;24;1;23;.958;3900000;0
30614;86344;2182;0;0;0;0;.00nan;0;0
30615;193859;796;0;0;0;0;.00nan;0;0
30615;-1;776;0;0;0;0;.00nan;0;0
30615;95405;776;100;46;1;45;.978;3600000;0
30615;149847;796;70;26;2;24;.923;3599000;0
30616;209571;780;0;0;0;0;.00nan;0;0
30616;165867;2182;0;0;0;0;.00nan;0;0
30616;-1;780;72;35;4;31;.886;3574000;0
30616;86344;2182;61;25;3;22;.880;3600000;0
30617;207726;777;0;0;0;0;.00nan;0;0
30617;207727;783;71;33;3;30;.909;3600000;0
30617;-1;783;0;0;0;0;.00nan;0;0
30617;-1;777;55;22;4;18;.818;3600000;0
30618;183377;904;60;27;3;24;.889;3521000;0
30618;-1;904;0;0;0;0;.00nan;0;0
30618;62060;794;0;0;0;0;.00nan;0;0
30618;152201;794;86;26;1;25;.962;3600000;0
30619;201174;798;0;0;0;0;.00nan;0;0
30619;-1;776;0;0;0;0;.00nan;0;0
30619;95405;776;81;43;4;39;.907;3543000;0
30619;148956;798;70;30;3;27;.900;3600000;0
30620;190702;784;75;33;2;31;.939;3815000;0
30620;-1;3737;91;47;3;44;.936;3815000;0
30620;192030;3737;0;0;0;0;.00nan;0;0
30620;-1;784;0;0;0;0;.00nan;0;0
30621;193859;796;0;0;0;0;.00nan;0;0
30621;171673;778;93;54;4;50;.926;3600000;0
30621;76486;778;0;0;0;0;.00nan;0;0
30621;149847;796;77;20;1;19;.950;3600000;0
30622;207726;777;39;22;4;18;.818;3600000;0
30622;-1;777;0;0;0;0;.00nan;0;0
30622;62060;794;43;38;6;32;.842;2825000;0
30622;152201;794;44;6;1;5;.833;775000;0
30623;171673;778;60;26;3;23;.885;3563000;0
30623;-1;776;0;0;0;0;.00nan;0;0
30623;76486;778;0;0;0;0;.00nan;0;0
30623;95405;776;76;28;2;26;.929;3600000;0
30624;209571;780;77;28;2;26;.929;3600000;0
30624;190702;784;72;35;4;31;.886;3554000;0
30624;-1;784;0;0;0;0;.00nan;0;0
30624;-1;780;0;0;0;0;.00nan;0;0
30625;201174;798;0;0;0;0;.00nan;0;0
30625;-1;3737;86;39;2;37;.949;3600000;0
30625;192030;3737;0;0;0;0;.00nan;0;0
30625;148956;798;55;24;3;21;.875;3573000;0
30626;165867;2182;0;0;0;0;.00nan;0;0
30626;207727;783;46;31;5;26;.839;3600000;0
30626;-1;783;0;0;0;0;.00nan;0;0
30626;86344;2182;100;27;0;27;1.000;3600000;0
30627;193859;796;73;21;1;20;.952;3600000;0
30627;183377;904;37;43;6;37;.860;3600000;0
30627;-1;904;0;0;0;0;.00nan;0;0
30627;149847;796;0;0;0;0;.00nan;0;0
30628;165867;2182;0;0;0;0;.00nan;0;0
30628;62060;794;0;0;0;0;.00nan;0;0
30628;86344;2182;41;22;5;17;.773;3825000;0
30628;152201;794;76;41;4;37;.902;3825000;0
30629;209571;780;38;32;6;26;.813;2235000;0
30629;-1;3737;59;32;4;28;.875;3600000;0
30629;192030;3737;0;0;0;0;.00nan;0;0
30629;-1;780;54;9;1;8;.889;1365000;0
30630;190702;784;68;32;4;28;.875;3519000;0
30630;207727;783;87;33;2;31;.939;3600000;0
30630;-1;784;0;0;0;0;.00nan;0;0
30630;-1;783;0;0;0;0;.00nan;0;0
30631;171673;778;0;0;0;0;.00nan;0;0
30631;201174;798;87;43;3;40;.930;3690000;0
30631;76486;778;57;30;4;26;.867;3690000;0
30631;148956;798;0;0;0;0;.00nan;0;0
30632;193859;796;0;0;0;0;.00nan;0;0
30632;207726;777;0;0;0;0;.00nan;0;0
30632;-1;777;70;34;3;31;.912;3600000;0
30632;149847;796;32;22;4;18;.818;3575000;0
30633;183377;904;100;34;0;34;1.000;3600000;0
30633;-1;776;0;0;0;0;.00nan;0;0
30633;-1;904;0;0;0;0;.00nan;0;0
30633;95405;776;67;22;2;20;.909;3517000;0
30634;190702;784;68;34;3;31;.912;3600000;0
30634;-1;784;0;0;0;0;.00nan;0;0
30634;62060;794;0;0;0;0;.00nan;0;0
30634;152201;794;52;27;4;23;.852;3562000;0
30635;207726;777;57;26;3;23;.885;3600000;0
30635;-1;776;49;35;5;30;.857;3535000;0
30635;-1;777;0;0;0;0;.00nan;0;0
30635;95405;776;0;0;0;0;.00nan;0;0
30636;209571;780;0;0;0;0;.00nan;0;0
30636;201174;798;0;0;0;0;.00nan;0;0
30636;-1;780;82;30;1;29;.967;3600000;0
30636;148956;798;69;26;3;23;.885;3573000;0
30637;207727;783;0;0;0;0;.00nan;0;0
30637;-1;3737;47;32;5;27;.844;3600000;0
30637;192030;3737;0;0;0;0;.00nan;0;0
30637;-1;783;97;34;1;33;.971;3600000;0
30638;183377;904;87;38;2;36;.947;3600000;0
30638;171673;778;32;18;4;14;.778;3539000;0
30638;-1;904;0;0;0;0;.00nan;0;0
30638;76486;778;0;0;0;0;.00nan;0;0
30639;193859;796;0;0;0;0;.00nan;0;0
30639;165867;2182;37;27;5;22;.815;3600000;0
30639;86344;2182;0;0;0;0;.00nan;0;0
30639;149847;796;100;23;0;23;1.000;3600000;0
30640;209571;780;81;31;2;29;.935;3600000;0
30640;207727;783;67;38;4;34;.895;3519000;0
30640;-1;780;0;0;0;0;.00nan;0;0
30640;-1;783;0;0;0;0;.00nan;0;0
30641;165867;2182;0;0;0;0;.00nan;0;0
30641;-1;776;0;0;0;0;.00nan;0;0
30641;86344;2182;84;26;1;25;.962;3600000;0
30641;95405;776;79;33;2;31;.939;3600000;0
30642;183377;904;83;41;2;39;.951;3583000;0
30642;201174;798;0;0;0;0;.00nan;0;0
30642;-1;904;0;0;0;0;.00nan;0;0
30642;148956;798;81;15;0;15;1.000;3600000;0
30643;193859;796;0;0;0;0;.00nan;0;0
30643;190702;784;0;0;0;0;.00nan;0;0
30643;-1;784;54;35;5;30;.857;3592000;0
30643;149847;796;80;35;3;32;.914;3600000;0
30644;-1;3737;0;0;0;0;.00nan;0;0
30644;192030;3737;88;30;2;28;.933;3600000;0
30644;62060;794;0;0;0;0;.00nan;0;0
30644;152201;794;57;33;4;29;.879;3566000;0
30645;171673;778;66;35;4;31;.886;3600000;0
30645;207726;777;0;0;0;0;.00nan;0;0
30645;-1;777;82;25;1;24;.960;3600000;0
30645;76486;778;0;0;0;0;.00nan;0;0
30646;209571;780;66;11;0;11;1.000;1019000;0
30646;-1;780;14;21;6;15;.714;2581000;0
30646;62060;794;0;0;0;0;.00nan;0;0
30646;152201;794;77;36;3;33;.917;3600000;0
30647;190702;784;80;30;2;28;.933;3600000;0
30647;-1;784;0;0;0;0;.00nan;0;0
30647;-1;776;0;0;0;0;.00nan;0;0
30647;95405;776;77;38;3;35;.921;3600000;0
30648;201174;798;0;0;0;0;.00nan;0;0
30648;207727;783;100;28;0;28;1.000;3600000;0
30648;-1;783;0;0;0;0;.00nan;0;0
30648;148956;798;85;23;1;22;.957;3566000;0
30649;165867;2182;0;0;0;0;.00nan;0;0
30649;171673;778;0;0;0;0;.00nan;0;0
30649;76486;778;85;26;1;25;.962;3600000;0
30649;86344;2182;42;28;4;24;.857;3600000;0
30650;193859;796;0;0;0;0;.00nan;0;0
30650;-1;3737;58;37;4;33;.892;3579000;0
30650;192030;3737;0;0;0;0;.00nan;0;0
30650;149847;796;83;34;2;32;.941;3600000;0
30651;183377;904;35;14;3;11;.786;534000;0
30651;207726;777;63;11;1;10;.909;3600000;0
30651;-1;904;70;38;4;34;.895;3066000;0
30651;-1;777;0;0;0;0;.00nan;0;0
30652;193859;796;0;0;0;0;.00nan;0;0
30652;209571;780;97;33;2;31;.939;3900000;0
30652;-1;780;0;0;0;0;.00nan;0;0
30652;149847;796;100;41;2;39;.951;3900000;0
30653;207727;783;41;23;4;19;.826;3557000;0
30653;62060;794;0;0;0;0;.00nan;0;0
30653;86422;783;0;0;0;0;.00nan;0;0
30653;152201;794;98;39;2;37;.949;3600000;0
30654;201174;798;75;37;3;34;.919;3574000;0
30654;207726;777;0;0;0;0;.00nan;0;0
30654;-1;777;68;22;2;20;.909;3600000;0
30654;148956;798;0;0;0;0;.00nan;0;0
30655;-1;3737;24;6;3;3;.500;422000;0
30655;192030;3737;72;32;2;30;.938;3159000;0
30655;-1;776;0;0;0;0;.00nan;0;0
30655;95405;776;55;31;4;27;.871;3600000;0
30656;171673;778;86;28;1;27;.964;3600000;0
30656;190702;784;71;37;3;34;.919;3576000;0
30656;-1;784;0;0;0;0;.00nan;0;0
30656;76486;778;0;0;0;0;.00nan;0;0
30657;183377;904;27;39;8;31;.795;2995000;0
30657;165867;2182;0;0;0;0;.00nan;0;0
30657;-1;904;52;4;0;4;1.000;605000;0
30657;86344;2182;80;22;1;21;.955;3600000;0
30658;209571;780;0;0;0;0;.00nan;0;0
30658;-1;776;0;0;0;0;.00nan;0;0
30658;-1;780;62;33;3;30;.909;3600000;0
30658;95405;776;48;32;5;27;.844;3529000;0
30659;183377;904;34;40;7;33;.825;3244000;0
30659;190702;784;80;21;1;20;.952;3600000;0
30659;-1;784;0;0;0;0;.00nan;0;0
30659;-1;904;42;3;1;2;.667;356000;0
30660;201174;798;75;26;1;25;.962;3600000;0
30660;62060;794;0;0;0;0;.00nan;0;0
30660;148956;798;0;0;0;0;.00nan;0;0
30660;152201;794;98;41;2;39;.951;3552000;0
30661;193859;796;0;0;0;0;.00nan;0;0
30661;207727;783;0;0;0;0;.00nan;0;0
30661;86422;783;63;30;4;26;.867;3575000;0
30661;149847;796;57;26;3;23;.885;3600000;0
30662;165867;2182;67;28;3;25;.893;3576000;0
30662;207726;777;98;33;1;32;.970;3600000;0
30662;-1;777;0;0;0;0;.00nan;0;0
30662;86344;2182;0;0;0;0;.00nan;0;0
30663;171673;778;0;0;0;0;.00nan;0;0
30663;-1;3737;44;38;6;32;.842;3600000;0
30663;192030;3737;0;0;0;0;.00nan;0;0
30663;76486;778;83;30;2;28;.933;3600000;0
30664;165867;2182;0;0;0;0;.00nan;0;0
30664;201174;798;0;0;0;0;.00nan;0;0
30664;86344;2182;86;26;1;25;.962;3600000;0
30664;148956;798;68;24;2;22;.917;3544000;0
30665;193859;796;0;0;0;0;.00nan;0;0
30665;62060;794;0;0;0;0;.00nan;0;0
30665;149847;796;74;23;1;22;.957;3600000;0
30665;152201;794;69;39;3;36;.923;3570000;0
30666;207727;783;0;0;0;0;.00nan;0;0
30666;-1;776;0;0;0;0;.00nan;0;0
30666;86422;783;58;24;3;21;.875;3600000;0
30666;95405;776;45;30;5;25;.833;3563000;0
30667;190702;784;0;0;0;0;.00nan;0;0
30667;207726;777;0;0;0;0;.00nan;0;0
30667;-1;784;47;31;5;26;.839;3567000;0
30667;-1;777;56;25;3;22;.880;3600000;0
30668;209571;780;57;28;4;24;.857;3584000;0
30668;171673;778;68;27;2;25;.926;3600000;0
30668;-1;780;0;0;0;0;.00nan;0;0
30668;76486;778;0;0;0;0;.00nan;0;0
30669;183377;904;0;0;0;0;.00nan;0;0
30669;-1;3737;83;26;1;25;.962;3600000;0
30669;192030;3737;0;0;0;0;.00nan;0;0
30669;-1;904;52;32;4;28;.875;3600000;0
30670;183377;904;55;32;5;27;.844;3600000;0
30670;209571;780;0;0;0;0;.00nan;0;0
30670;-1;780;64;26;3;23;.885;3600000;0
30670;-1;904;0;0;0;0;.00nan;0;0
30671;-1;776;54;3;0;3;1.000;589000;0
30671;62060;794;0;0;0;0;.00nan;0;0
30671;95405;776;48;44;6;38;.864;3011000;0
30671;152201;794;91;33;1;32;.970;3600000;0
30672;165867;2182;95;35;1;34;.971;3600000;0
30672;190702;784;63;30;3;27;.900;3549000;0
30672;-1;784;0;0;0;0;.00nan;0;0
30672;86344;2182;0;0;0;0;.00nan;0;0
30673;193859;796;0;0;0;0;.00nan;0;0
30673;201174;798;0;0;0;0;.00nan;0;0
30673;148956;798;71;28;2;26;.929;3600000;0
30673;149847;796;55;25;3;22;.880;3545000;0
30674;207726;777;72;22;1;21;.955;3600000;0
30674;-1;3737;0;0;0;0;.00nan;0;0
30674;192030;3737;81;39;2;37;.949;3600000;0
30674;-1;777;0;0;0;0;.00nan;0;0
30675;171673;778;0;0;0;0;.00nan;0;0
30675;207727;783;0;0;0;0;.00nan;0;0
30675;76486;778;79;25;1;24;.960;3600000;0
30675;86422;783;46;35;5;30;.857;3600000;0
30676;165867;2182;0;0;0;0;.00nan;0;0
30676;-1;3737;65;18;1;17;.944;3600000;0
30676;192030;3737;0;0;0;0;.00nan;0;0
30676;86344;2182;56;32;4;28;.875;3600000;0
30677;209571;780;73;35;3;32;.914;3529000;0
30677;207726;777;82;26;1;25;.962;3600000;0
30677;-1;780;0;0;0;0;.00nan;0;0
30677;64066;777;0;0;0;0;.00nan;0;0
30678;193859;796;0;0;0;0;.00nan;0;0
30678;-1;776;69;12;0;12;1.000;1562000;0
30678;95405;776;13;18;6;12;.667;2038000;0
30678;149847;796;69;23;2;21;.913;3600000;0
30679;201174;798;54;30;3;27;.900;3539000;0
30679;190702;784;0;0;0;0;.00nan;0;0
30679;-1;784;74;25;1;24;.960;3600000;0
30679;148956;798;0;0;0;0;.00nan;0;0
30680;171673;778;71;20;1;19;.950;3600000;0
30680;62060;794;0;0;0;0;.00nan;0;0
30680;76486;778;0;0;0;0;.00nan;0;0
30680;152201;794;93;37;2;35;.946;3587000;0
30681;183377;904;49;25;4;21;.840;3546000;0
30681;207727;783;0;0;0;0;.00nan;0;0
30681;-1;904;0;0;0;0;.00nan;0;0
30681;86422;783;47;20;3;17;.850;3600000;0
30682;209571;780;0;0;0;0;.00nan;0;0
30682;165867;2182;92;29;1;28;.966;3600000;0
30682;-1;780;68;33;3;30;.909;3533000;0
30682;86344;2182;0;0;0;0;.00nan;0;0
30683;183377;904;81;55;5;50;.909;3600000;0
30683;-1;904;0;0;0;0;.00nan;0;0
30683;62060;794;78;20;1;19;.950;3600000;0
30683;152201;794;0;0;0;0;.00nan;0;0
30684;207726;777;0;0;0;0;.00nan;0;0
30684;207727;783;0;0;0;0;.00nan;0;0
30684;64066;777;92;33;1;32;.970;3600000;0
30684;86422;783;55;21;2;19;.905;3590000;0
30685;190702;784;53;32;5;27;.844;3558000;0
30685;-1;3737;72;37;3;34;.919;3600000;0
30685;192030;3737;0;0;0;0;.00nan;0;0
30685;-1;784;0;0;0;0;.00nan;0;0
30686;193859;796;91;19;0;19;1.000;3600000;0
30686;171673;778;0;0;0;0;.00nan;0;0
30686;76486;778;94;35;1;34;.971;3600000;0
30686;149847;796;0;0;0;0;.00nan;0;0
30687;201174;798;44;25;5;20;.800;3322000;0
30687;-1;776;0;0;0;0;.00nan;0;0
30687;95405;776;99;31;1;30;.968;3600000;0
30687;148956;798;49;1;0;1;1.000;278000;0
30688;207726;777;0;0;0;0;.00nan;0;0
30688;62060;794;0;0;0;0;.00nan;0;0
30688;64066;777;57;17;2;15;.882;3600000;0
30688;152201;794;62;36;4;32;.889;3563000;0
30689;209571;780;64;28;3;25;.893;3900000;0
30689;190702;784;81;42;3;39;.929;3900000;0
30689;-1;784;0;0;0;0;.00nan;0;0
30689;-1;780;0;0;0;0;.00nan;0;0
30690;207727;783;0;0;0;0;.00nan;0;0
30690;62884;2182;0;0;0;0;.00nan;0;0
30690;86344;2182;84;29;1;28;.966;3600000;0
30690;86422;783;62;31;3;28;.903;3600000;0
30691;201174;798;0;0;0;0;.00nan;0;0
30691;-1;3737;73;29;2;27;.931;3600000;0
30691;192030;3737;0;0;0;0;.00nan;0;0
30691;148956;798;69;37;5;32;.865;3600000;0
30692;171673;778;0;0;0;0;.00nan;0;0
30692;-1;776;0;0;0;0;.00nan;0;0
30692;76486;778;65;16;1;15;.938;3600000;0
30692;95405;776;67;36;4;32;.889;3600000;0
30693;193859;796;66;16;1;15;.938;3600000;0
30693;183377;904;97;52;2;50;.962;3585000;0
30693;-1;904;0;0;0;0;.00nan;0;0
30693;149847;796;0;0;0;0;.00nan;0;0
30694;165867;2182;41;20;4;16;.800;3600000;0
30694;62060;794;0;0;0;0;.00nan;0;0
30694;86344;2182;0;0;0;0;.00nan;0;0
30694;152201;794;64;47;5;42;.894;3556000;0
30695;190702;784;71;32;3;29;.906;3600000;0
30695;207727;783;0;0;0;0;.00nan;0;0
30695;-1;784;0;0;0;0;.00nan;0;0
30695;86422;783;75;40;4;36;.900;3552000;0
30696;209571;780;0;0;0;0;.00nan;0;0
30696;-1;3737;69;33;2;31;.939;3539000;0
30696;192030;3737;0;0;0;0;.00nan;0;0
30696;-1;780;93;22;0;22;1.000;3600000;0
30697;171673;778;0;0;0;0;.00nan;0;0
30697;201174;798;90;44;1;43;.977;3600000;0
30697;76486;778;41;18;3;15;.833;3600000;0
30697;148956;798;0;0;0;0;.00nan;0;0
30698;183377;904;77;55;5;50;.909;3600000;0
30698;-1;776;62;17;1;16;.941;3600000;0
30698;-1;904;0;0;0;0;.00nan;0;0
30698;95405;776;0;0;0;0;.00nan;0;0
30699;193859;796;0;0;0;0;.00nan;0;0
30699;207726;777;0;0;0;0;.00nan;0;0
30699;64066;777;50;20;3;17;.850;3590000;0
30699;149847;796;82;23;1;22;.957;3600000;0
30700;209571;780;0;0;0;0;.00nan;0;0
30700;201174;798;73;28;2;26;.929;3600000;0
30700;-1;780;81;39;3;36;.923;3555000;0
30700;148956;798;0;0;0;0;.00nan;0;0
30701;207726;777;0;0;0;0;.00nan;0;0
30701;-1;776;0;0;0;0;.00nan;0;0
30701;64066;777;48;29;4;25;.862;3600000;0
30701;95405;776;100;31;0;31;1.000;3600000;0
30702;190702;784;0;0;0;0;.00nan;0;0
30702;-1;784;68;24;2;22;.917;3600000;0
30702;62060;794;0;0;0;0;.00nan;0;0
30702;152201;794;59;27;3;24;.889;3598000;0
30703;193859;796;0;0;0;0;.00nan;0;0
30703;165867;2182;51;18;3;15;.833;3900000;0
30703;86344;2182;0;0;0;0;.00nan;0;0
30703;149847;796;96;53;3;50;.943;3900000;0
30704;207727;783;49;1;0;1;1.000;289000;0
30704;-1;3737;50;37;5;32;.865;3600000;0
30704;192030;3737;0;0;0;0;.00nan;0;0
30704;86422;783;18;21;6;15;.714;3311000;0
30705;183377;904;0;0;0;0;.00nan;0;0
30705;171673;778;0;0;0;0;.00nan;0;0
30705;-1;904;89;38;3;35;.921;3569000;0
30705;76486;778;64;21;2;19;.905;3600000;0
30706;209571;780;99;48;3;45;.938;3600000;0
30706;207727;783;0;0;0;0;.00nan;0;0
30706;-1;780;0;0;0;0;.00nan;0;0
30706;86422;783;46;21;4;17;.810;3584000;0
30707;-1;3737;66;29;3;26;.897;3600000;0
30707;192030;3737;0;0;0;0;.00nan;0;0
30707;62060;794;0;0;0;0;.00nan;0;0
30707;152201;794;70;43;4;39;.907;3600000;0
30708;165867;2182;0;0;0;0;.00nan;0;0
30708;-1;776;46;6;1;5;.833;862000;0
30708;86344;2182;58;25;3;22;.880;3600000;0
30708;95405;776;20;26;6;20;.769;2738000;0
30709;171673;778;0;0;0;0;.00nan;0;0
30709;207726;777;0;0;0;0;.00nan;0;0
30709;64066;777;63;23;2;21;.913;3600000;0
30709;76486;778;75;35;3;32;.914;3557000;0
30710;193859;796;0;0;0;0;.00nan;0;0
30710;190702;784;80;44;3;41;.932;3575000;0
30710;-1;784;0;0;0;0;.00nan;0;0
30710;149847;796;64;23;2;21;.913;3600000;0
30711;183377;904;79;42;3;39;.929;3600000;0
30711;201174;798;50;26;4;22;.846;3545000;0
30711;-1;904;0;0;0;0;.00nan;0;0
30711;148956;798;0;0;0;0;.00nan;0;0
30712;209571;780;0;0;0;0;.00nan;0;0
30712;-1;780;80;30;2;28;.933;3600000;0
30712;62060;794;52;2;0;2;1.000;707000;0
30712;152201;794;24;24;6;18;.750;2893000;0
30713;190702;784;77;22;1;21;.955;3600000;0
30713;-1;784;0;0;0;0;.00nan;0;0
30713;-1;776;0;0;0;0;.00nan;0;0
30713;95405;776;15;30;7;23;.767;3600000;0
30714;201174;798;0;0;0;0;.00nan;0;0
30714;207727;783;0;0;0;0;.00nan;0;0
30714;86422;783;57;19;2;17;.895;3600000;0
30714;148956;798;67;29;3;26;.897;3598000;0
30715;183377;904;49;31;5;26;.839;1743000;0
30715;207726;777;0;0;0;0;.00nan;0;0
30715;-1;904;44;18;3;15;.833;1857000;0
30715;64066;777;36;12;3;9;.750;3600000;0
30716;193859;796;0;0;0;0;.00nan;0;0
30716;-1;3737;70;38;4;34;.895;3536000;0
30716;192030;3737;0;0;0;0;.00nan;0;0
30716;149847;796;69;28;2;26;.929;3600000;0
30717;165867;2182;37;26;5;21;.808;3570000;0
30717;171673;778;0;0;0;0;.00nan;0;0
30717;76486;778;81;36;3;33;.917;3600000;0
30717;86344;2182;0;0;0;0;.00nan;0;0
30718;183377;904;37;44;8;36;.818;3600000;0
30718;165867;2182;0;0;0;0;.00nan;0;0
30718;-1;904;0;0;0;0;.00nan;0;0
30718;86344;2182;76;26;2;24;.923;3600000;0
30719;207727;783;0;0;0;0;.00nan;0;0
30719;62060;794;0;0;0;0;.00nan;0;0
30719;86422;783;67;29;3;26;.897;3600000;0
30719;152201;794;45;26;4;22;.846;3577000;0
30720;201174;798;0;0;0;0;.00nan;0;0
30720;207726;777;0;0;0;0;.00nan;0;0
30720;64066;777;68;19;1;18;.947;3600000;0
30720;148956;798;92;39;3;36;.923;3537000;0
30721;171673;778;0;0;0;0;.00nan;0;0
30721;190702;784;76;32;3;29;.906;3900000;0
30721;-1;784;0;0;0;0;.00nan;0;0
30721;76486;778;60;23;3;20;.870;3900000;0
30722;-1;3737;47;18;3;15;.833;3600000;0
30722;192030;3737;0;0;0;0;.00nan;0;0
30722;-1;776;0;0;0;0;.00nan;0;0
30722;95405;776;43;37;6;31;.838;3600000;0
30723;193859;796;64;21;2;19;.905;2513000;0
30723;209571;780;0;0;0;0;.00nan;0;0
30723;-1;780;61;31;3;28;.903;3600000;0
30723;149847;796;21;16;5;11;.688;1087000;0
30724;201174;798;89;30;1;29;.967;3600000;0
30724;62060;794;0;0;0;0;.00nan;0;0
30724;148956;798;0;0;0;0;.00nan;0;0
30724;152201;794;79;33;2;31;.939;3600000;0
30725;209571;780;34;33;6;27;.818;3591000;0
30725;-1;776;0;0;0;0;.00nan;0;0
30725;-1;780;0;0;0;0;.00nan;0;0
30725;95405;776;82;52;4;48;.923;3600000;0
30726;165867;2182;70;33;3;30;.909;3600000;0
30726;207726;777;0;0;0;0;.00nan;0;0
30726;64066;777;91;20;0;20;1.000;3600000;0
30726;86344;2182;0;0;0;0;.00nan;0;0
30727;171673;778;54;23;4;19;.826;3900000;0
30727;-1;3737;63;34;4;30;.882;3900000;0
30727;192030;3737;0;0;0;0;.00nan;0;0
30727;76486;778;0;0;0;0;.00nan;0;0
30728;193859;796;0;0;0;0;.00nan;0;0
30728;207727;783;0;0;0;0;.00nan;0;0
30728;86422;783;73;25;2;23;.920;3600000;0
30728;149847;796;54;28;4;24;.857;3538000;0
30729;183377;904;52;33;4;29;.879;3900000;0
30729;190702;784;24;18;4;14;.778;3900000;0
30729;-1;784;0;0;0;0;.00nan;0;0
30729;-1;904;0;0;0;0;.00nan;0;0
30730;171673;778;0;0;0;0;.00nan;0;0
30730;62060;794;0;0;0;0;.00nan;0;0
30730;76486;778;72;21;1;20;.952;3600000;0
30730;152201;794;66;39;4;35;.897;3600000;0
30731;209571;780;33;26;5;21;.808;3536000;0
30731;201174;798;0;0;0;0;.00nan;0;0
30731;-1;780;0;0;0;0;.00nan;0;0
30731;148956;798;88;48;3;45;.938;3600000;0
30732;207726;777;0;0;0;0;.00nan;0;0
30732;-1;776;0;0;0;0;.00nan;0;0
30732;64066;777;71;21;1;20;.952;3600000;0
30732;95405;776;39;27;5;22;.815;3600000;0
30733;207727;783;0;0;0;0;.00nan;0;0
30733;-1;3737;57;42;5;37;.881;3600000;0
30733;192030;3737;0;0;0;0;.00nan;0;0
30733;86422;783;27;23;6;17;.739;3561000;0
30734;193859;796;0;0;0;0;.00nan;0;0
30734;190702;784;95;28;1;27;.964;3600000;0
30734;-1;784;0;0;0;0;.00nan;0;0
30734;149847;796;55;20;2;18;.900;3597000;0
30735;183377;904;34;24;5;19;.792;2277000;0
30735;165867;2182;80;21;1;20;.952;3600000;0
30735;-1;904;47;15;2;13;.867;1323000;0
30735;86344;2182;0;0;0;0;.00nan;0;0
30736;165867;2182;0;0;0;0;.00nan;0;0
30736;207727;783;0;0;0;0;.00nan;0;0
30736;86344;2182;52;28;4;24;.857;3600000;0
30736;86422;783;89;36;1;35;.972;3600000;0
30737;209571;780;0;0;0;0;.00nan;0;0
30737;171673;778;85;24;1;23;.958;3600000;0
30737;-1;780;65;27;3;24;.889;3522000;0
30737;76486;778;0;0;0;0;.00nan;0;0
30738;201174;798;0;0;0;0;.00nan;0;0
30738;62060;794;0;0;0;0;.00nan;0;0
30738;148956;798;100;39;1;38;.974;3600000;0
30738;152201;794;61;27;2;25;.926;3576000;0
30739;190702;784;0;0;0;0;.00nan;0;0
30739;207726;777;0;0;0;0;.00nan;0;0
30739;-1;784;100;43;1;42;.977;3600000;0
30739;64066;777;41;23;4;19;.826;3600000;0
30740;183377;904;97;47;2;45;.957;3900000;0
30740;-1;3737;0;0;0;0;.00nan;0;0
30740;192030;3737;61;22;2;20;.909;3900000;0
30740;-1;904;0;0;0;0;.00nan;0;0
30741;193859;796;0;0;0;0;.00nan;0;0
30741;-1;776;0;0;0;0;.00nan;0;0
30741;95405;776;80;35;2;33;.943;3600000;0
30741;149847;796;56;31;4;27;.871;3588000;0
30742;209571;780;0;0;0;0;.00nan;0;0
30742;-1;780;81;29;1;28;.966;3600000;0
30742;62060;794;0;0;0;0;.00nan;0;0
30742;152201;794;50;28;4;24;.857;3600000;0
30743;190702;784;7;24;7;17;.708;2898000;0
30743;-1;784;41;6;2;4;.667;702000;0
30743;-1;776;48;24;3;21;.875;3600000;0
30743;95405;776;0;0;0;0;.00nan;0;0
30744;193859;796;62;4;0;4;1.000;1520000;0
30744;207726;777;0;0;0;0;.00nan;0;0
30744;64066;777;100;27;0;27;1.000;3600000;0
30744;149847;796;41;28;5;23;.821;2080000;0
30745;165867;2182;89;36;2;34;.944;3600000;0
30745;-1;3737;58;10;1;9;.900;3600000;0
30745;192030;3737;0;0;0;0;.00nan;0;0
30745;86344;2182;0;0;0;0;.00nan;0;0
30746;171673;778;0;0;0;0;.00nan;0;0
30746;201174;798;0;0;0;0;.00nan;0;0
30746;76486;778;58;19;2;17;.895;3600000;0
30746;148956;798;64;26;3;23;.885;3574000;0
30747;183377;904;0;0;0;0;.00nan;0;0
30747;207727;783;0;0;0;0;.00nan;0;0
30747;-1;904;75;40;4;36;.900;3600000;0
30747;86422;783;31;24;5;19;.792;3580000;0
30748;183377;904;60;37;4;33;.892;3840000;0
30748;165867;2182;59;26;3;23;.885;3840000;0
30748;-1;904;0;0;0;0;.00nan;0;0
30748;86344;2182;0;0;0;0;.00nan;0;0
30749;207727;783;78;40;3;37;.925;3600000;0
30749;-1;3737;47;22;4;18;.818;3559000;0
30749;192030;3737;0;0;0;0;.00nan;0;0
30749;86422;783;0;0;0;0;.00nan;0;0
30750;209571;780;42;32;5;27;.844;3600000;0
30750;201174;798;0;0;0;0;.00nan;0;0
30750;-1;780;0;0;0;0;.00nan;0;0
30750;148956;798;79;25;2;23;.920;3600000;0
30751;-1;776;0;0;0;0;.00nan;0;0
30751;64066;777;53;29;4;25;.862;3550000;0
30751;95405;776;93;43;2;41;.953;3600000;0
30751;149847;777;0;0;0;0;.00nan;0;0
30752;190702;784;63;31;3;28;.903;3600000;0
30752;-1;784;0;0;0;0;.00nan;0;0
30752;62884;796;65;23;2;21;.913;3600000;0
30752;66924;796;0;0;0;0;.00nan;0;0
30753;171673;778;76;35;3;32;.914;3600000;0
30753;62060;794;0;0;0;0;.00nan;0;0
30753;76486;778;0;0;0;0;.00nan;0;0
30753;152201;794;45;33;5;28;.848;3596000;0
30754;165867;2182;0;0;0;0;.00nan;0;0
30754;207727;783;0;0;0;0;.00nan;0;0
30754;86344;2182;65;15;1;14;.933;3600000;0
30754;86422;783;65;36;4;32;.889;3600000;0
30755;201174;798;0;0;0;0;.00nan;0;0
30755;62060;794;77;49;4;45;.918;3600000;0
30755;148956;798;77;21;1;20;.952;3600000;0
30755;152201;794;0;0;0;0;.00nan;0;0
30756;190702;784;98;41;2;39;.951;3900000;0
30756;-1;784;0;0;0;0;.00nan;0;0
30756;64066;777;0;0;0;0;.00nan;0;0
30756;149847;777;42;15;2;13;.867;3900000;0
30757;-1;776;0;0;0;0;.00nan;0;0
30757;62884;796;76;21;1;20;.952;3600000;0
30757;66924;796;0;0;0;0;.00nan;0;0
30757;95405;776;75;42;4;38;.905;3595000;0
30758;209571;780;0;0;0;0;.00nan;0;0
30758;171673;778;0;0;0;0;.00nan;0;0
30758;-1;780;82;46;3;43;.935;3900000;0
30758;76486;778;85;33;3;30;.909;3900000;0
30759;183377;904;34;37;6;31;.838;3561000;0
30759;-1;3737;26;19;5;14;.737;3600000;0
30759;192030;3737;0;0;0;0;.00nan;0;0
30759;-1;904;0;0;0;0;.00nan;0;0
30760;183377;904;52;24;3;21;.875;3900000;0
30760;207727;783;0;0;0;0;.00nan;0;0
30760;-1;904;0;0;0;0;.00nan;0;0
30760;86422;783;68;24;3;21;.875;3900000;0
30761;209571;780;70;19;1;18;.947;3600000;0
30761;-1;780;0;0;0;0;.00nan;0;0
30761;62060;794;0;0;0;0;.00nan;0;0
30761;152201;794;74;31;2;29;.935;3600000;0
30762;171673;778;62;28;3;25;.893;3563000;0
30762;201174;798;70;25;2;23;.920;3600000;0
30762;76486;778;0;0;0;0;.00nan;0;0
30762;148956;798;0;0;0;0;.00nan;0;0
30763;190702;784;0;0;0;0;.00nan;0;0
30763;-1;784;52;24;3;21;.875;3900000;0
30763;-1;776;0;0;0;0;.00nan;0;0
30763;95405;776;69;28;3;25;.893;3873000;0
30764;165867;2182;0;0;0;0;.00nan;0;0
30764;-1;3737;100;28;0;28;1.000;3600000;0
30764;192030;3737;0;0;0;0;.00nan;0;0
30764;86344;2182;59;31;3;28;.903;3600000;0
30765;62884;796;0;0;0;0;.00nan;0;0
30765;64066;777;0;0;0;0;.00nan;0;0
30765;66924;796;73;42;3;39;.929;3600000;0
30765;149847;777;47;32;5;27;.844;3569000;0
30766;209571;780;0;0;0;0;.00nan;0;0
30766;171673;778;0;0;0;0;.00nan;0;0
30766;-1;780;89;40;2;38;.950;3559000;0
30766;76486;778;100;30;0;30;1.000;3600000;0
30767;62060;794;0;0;0;0;.00nan;0;0
30767;62884;796;69;24;2;22;.917;3548000;0
30767;66924;796;0;0;0;0;.00nan;0;0
30767;152201;794;95;30;1;29;.967;3600000;0
30768;207727;783;0;0;0;0;.00nan;0;0
30768;-1;776;0;0;0;0;.00nan;0;0
30768;86422;783;61;20;2;18;.900;3588000;0
30768;95405;776;91;33;1;32;.970;3600000;0
30769;190702;784;66;47;5;42;.894;3600000;0
30769;-1;784;0;0;0;0;.00nan;0;0
30769;64066;777;0;0;0;0;.00nan;0;0
30769;149847;777;64;20;2;18;.900;3600000;0
30770;183377;904;43;32;5;27;.844;2346000;0
30770;-1;3737;54;14;2;12;.857;3600000;0
30770;192030;3737;0;0;0;0;.00nan;0;0
30770;-1;904;73;18;2;16;.889;1254000;0
30771;165867;2182;0;0;0;0;.00nan;0;0
30771;201174;798;0;0;0;0;.00nan;0;0
30771;86344;2182;55;34;4;30;.882;3544000;0
30771;148956;798;54;21;3;18;.857;3600000;0
30772;209564;776;0;0;0;0;.00nan;0;0
30772;62060;794;0;0;0;0;.00nan;0;0
30772;95405;776;84;26;1;25;.962;3600000;0
30772;152201;794;89;46;2;44;.957;3544000;0
30773;171673;778;69;33;3;30;.909;3600000;0
30773;-1;783;0;0;0;0;.00nan;0;0
30773;76486;778;0;0;0;0;.00nan;0;0
30773;86422;783;88;40;2;38;.950;3600000;0
30774;-1;3737;73;38;3;35;.921;3900000;0
30774;192030;3737;0;0;0;0;.00nan;0;0
30774;64066;777;0;0;0;0;.00nan;0;0
30774;149847;777;68;25;3;22;.880;3900000;0
30775;165867;2182;75;36;3;33;.917;3600000;0
30775;190702;784;75;43;4;39;.907;3589000;0
30775;-1;784;0;0;0;0;.00nan;0;0
30775;86344;2182;0;0;0;0;.00nan;0;0
30776;201174;798;0;0;0;0;.00nan;0;0
30776;62884;796;62;21;2;19;.905;3600000;0
30776;66924;796;0;0;0;0;.00nan;0;0
30776;148956;798;90;40;3;37;.925;3573000;0
30777;183377;904;0;0;0;0;.00nan;0;0
30777;209571;780;86;29;1;28;.966;3600000;0
30777;-1;780;0;0;0;0;.00nan;0;0
30777;-1;904;42;30;5;25;.833;3600000;0
30778;183377;904;89;37;2;35;.946;3900000;0
30778;-1;904;0;0;0;0;.00nan;0;0
30778;-1;783;0;0;0;0;.00nan;0;0
30778;86422;783;68;21;2;19;.905;3900000;0
30779;171673;778;0;0;0;0;.00nan;0;0
30779;62060;794;0;0;0;0;.00nan;0;0
30779;76486;778;56;19;2;17;.895;3600000;0
30779;152201;794;83;44;4;40;.909;3600000;0
30780;201174;798;0;0;0;0;.00nan;0;0
30780;190702;784;0;0;0;0;.00nan;0;0
30780;-1;784;53;26;4;22;.846;3600000;0
30780;148956;798;93;30;1;29;.967;3600000;0
30781;209571;780;0;0;0;0;.00nan;0;0
30781;-1;780;71;32;3;29;.906;3600000;0
30781;64066;777;0;0;0;0;.00nan;0;0
30781;149847;777;41;24;4;20;.833;3546000;0
30782;165867;2182;0;0;0;0;.00nan;0;0
30782;-1;3737;80;35;2;33;.943;3596000;0
30782;192030;3737;0;0;0;0;.00nan;0;0
30782;86344;2182;67;17;1;16;.941;3600000;0
30783;209564;776;0;0;0;0;.00nan;0;0
30783;62884;796;100;31;0;31;1.000;3600000;0
30783;66924;796;0;0;0;0;.00nan;0;0
30783;95405;776;67;23;2;21;.913;3521000;0
30784;209564;776;0;0;0;0;.00nan;0;0
30784;201174;798;0;0;0;0;.00nan;0;0
30784;95405;776;52;29;4;25;.862;3600000;0
30784;148956;798;72;25;1;24;.960;3600000;0
30785;190702;784;64;33;3;30;.909;3600000;0
30785;-1;3737;19;9;4;5;.556;976000;0
30785;192030;3737;86;22;0;22;1.000;2572000;0
30785;-1;784;0;0;0;0;.00nan;0;0
30786;165867;783;53;18;2;16;.889;3552000;0
30786;64066;777;0;0;0;0;.00nan;0;0
30786;86422;783;0;0;0;0;.00nan;0;0
30786;149847;777;90;30;1;29;.967;3600000;0
30787;209571;780;73;40;4;36;.900;3567000;0
30787;24177;2182;0;0;0;0;.00nan;0;0
30787;-1;780;0;0;0;0;.00nan;0;0
30787;86344;2182;92;45;2;43;.956;3600000;0
30788;171673;778;93;38;2;36;.947;3600000;0
30788;62884;796;39;33;6;27;.818;3238000;0
30788;66924;796;49;2;0;2;1.000;362000;0
30788;76486;778;0;0;0;0;.00nan;0;0
30789;183377;904;58;44;5;39;.886;3520000;0
30789;-1;904;0;0;0;0;.00nan;0;0
30789;62060;794;0;0;0;0;.00nan;0;0
30789;152201;794;73;34;3;31;.912;3600000;0
30790;165867;783;71;22;1;21;.955;3778000;0
30790;24177;2182;0;0;0;0;.00nan;0;0
30790;86344;2182;75;26;2;24;.923;3778000;0
30790;86422;783;0;0;0;0;.00nan;0;0
30791;209571;780;0;0;0;0;.00nan;0;0
30791;190702;784;35;23;5;18;.783;3587000;0
30791;-1;784;0;0;0;0;.00nan;0;0
30791;-1;780;51;27;4;23;.852;3600000;0
30792;201174;798;0;0;0;0;.00nan;0;0
30792;-1;3737;53;22;3;19;.864;3600000;0
30792;192030;3737;0;0;0;0;.00nan;0;0
30792;148956;798;91;34;1;33;.971;3600000;0
30793;62060;794;0;0;0;0;.00nan;0;0
30793;64066;777;0;0;0;0;.00nan;0;0
30793;149847;777;73;17;1;16;.941;3600000;0
30793;152201;794;92;41;2;39;.951;3545000;0
30794;209564;776;0;0;0;0;.00nan;0;0
30794;171673;778;0;0;0;0;.00nan;0;0
30794;76486;778;52;27;3;24;.889;3600000;0
30794;95405;776;97;23;0;23;1.000;3600000;0
30795;183377;904;41;50;8;42;.840;3600000;0
30795;-1;904;0;0;0;0;.00nan;0;0
30795;62884;796;0;0;0;0;.00nan;0;0
30795;66924;796;70;32;3;29;.906;3600000;0
30796;24177;2182;0;0;0;0;.00nan;0;0
30796;62060;794;0;0;0;0;.00nan;0;0
30796;86344;2182;68;27;2;25;.926;3546000;0
30796;152201;794;99;45;1;44;.978;3600000;0
30797;62884;796;0;0;0;0;.00nan;0;0
30797;64066;777;0;0;0;0;.00nan;0;0
30797;66924;796;84;27;1;26;.963;3600000;0
30797;149847;777;66;24;2;22;.917;3546000;0
30798;165867;783;46;28;4;24;.857;3557000;0
30798;190702;784;69;33;3;30;.909;3600000;0
30798;-1;784;0;0;0;0;.00nan;0;0
30798;86422;783;0;0;0;0;.00nan;0;0
30799;209571;780;0;0;0;0;.00nan;0;0
30799;-1;3737;85;34;1;33;.971;3600000;0
30799;192030;3737;0;0;0;0;.00nan;0;0
30799;-1;780;85;34;2;32;.941;3592000;0
30800;171673;778;97;37;1;36;.973;3600000;0
30800;201174;798;0;0;0;0;.00nan;0;0
30800;76486;778;0;0;0;0;.00nan;0;0
30800;148956;798;72;34;3;31;.912;3530000;0
30801;183377;904;66;39;5;34;.872;3600000;0
30801;-1;776;40;3;1;2;.667;463000;0
30801;-1;904;0;0;0;0;.00nan;0;0
30801;95405;776;31;26;6;20;.769;3136000;0
30802;190702;784;65;22;2;20;.909;3600000;0
30802;-1;784;0;0;0;0;.00nan;0;0
30802;62060;794;0;0;0;0;.00nan;0;0
30802;152201;794;27;27;6;21;.778;3600000;0
30803;209571;780;52;36;5;31;.861;3542000;0
30803;201174;798;75;34;3;31;.912;3600000;0
30803;-1;780;0;0;0;0;.00nan;0;0
30803;148956;798;0;0;0;0;.00nan;0;0
30804;165867;783;77;28;2;26;.929;3600000;0
30804;-1;3737;58;30;3;27;.900;3572000;0
30804;192030;3737;0;0;0;0;.00nan;0;0
30804;86422;783;0;0;0;0;.00nan;0;0
30805;-1;776;0;0;0;0;.00nan;0;0
30805;64066;777;0;0;0;0;.00nan;0;0
30805;95405;776;69;35;4;31;.886;3600000;0
30805;149847;777;100;37;0;37;1.000;3600000;0
30806;183377;904;26;6;3;3;.500;333000;0
30806;171673;778;0;0;0;0;.00nan;0;0
30806;-1;904;95;41;1;40;.976;3267000;0
30806;76486;778;92;25;1;24;.960;3600000;0
30807;24177;2182;0;0;0;0;.00nan;0;0
30807;62884;796;0;0;0;0;.00nan;0;0
30807;66924;796;77;37;2;35;.946;3600000;0
30807;86344;2182;85;44;3;41;.932;3544000;0
30808;24177;2182;0;0;0;0;.00nan;0;0
30808;-1;776;0;0;0;0;.00nan;0;0
30808;86344;2182;82;28;1;27;.964;3600000;0
30808;95405;776;58;34;4;30;.882;3600000;0
30809;209571;780;90;42;2;40;.952;3600000;0
30809;165867;783;58;27;4;23;.852;3600000;0
30809;-1;780;0;0;0;0;.00nan;0;0
30809;86422;783;0;0;0;0;.00nan;0;0
30810;171673;778;55;20;3;17;.850;3542000;0
30810;64066;777;0;0;0;0;.00nan;0;0
30810;76486;778;0;0;0;0;.00nan;0;0
30810;149847;777;89;32;2;30;.938;3600000;0
30811;190702;784;99;36;1;35;.972;3600000;0
30811;-1;784;0;0;0;0;.00nan;0;0
30811;62884;796;0;0;0;0;.00nan;0;0
30811;66924;796;79;34;2;32;.941;3550000;0
30812;-1;3737;38;15;3;12;.800;3600000;0
30812;192030;3737;0;0;0;0;.00nan;0;0
30812;62060;794;52;27;3;24;.889;1738000;0
30812;152201;794;19;22;6;16;.727;1862000;0
30813;183377;904;78;43;4;39;.907;3545000;0
30813;201174;798;0;0;0;0;.00nan;0;0
30813;-1;904;0;0;0;0;.00nan;0;0
30813;148956;798;64;27;3;24;.889;3600000;0
30814;209571;780;0;0;0;0;.00nan;0;0
30814;-1;780;81;25;1;24;.960;3600000;0
30814;62060;794;0;0;0;0;.00nan;0;0
30814;152201;794;94;42;2;40;.952;3600000;0
30815;190702;784;74;21;1;20;.952;3600000;0
30815;-1;784;0;0;0;0;.00nan;0;0
30815;-1;776;0;0;0;0;.00nan;0;0
30815;95405;776;66;39;4;35;.897;3600000;0
30816;165867;783;55;38;5;33;.868;3600000;0
30816;201174;798;0;0;0;0;.00nan;0;0
30816;86422;783;0;0;0;0;.00nan;0;0
30816;148956;798;92;39;2;37;.949;3600000;0
30817;183377;904;80;53;4;49;.925;3600000;0
30817;-1;904;0;0;0;0;.00nan;0;0
30817;64066;777;0;0;0;0;.00nan;0;0
30817;149847;777;83;15;0;15;1.000;3600000;0
30818;24177;2182;0;0;0;0;.00nan;0;0
30818;171673;778;91;27;1;26;.963;3600000;0
30818;76486;778;0;0;0;0;.00nan;0;0
30818;86344;2182;75;29;2;27;.931;3548000;0
30819;-1;3737;72;42;4;38;.905;3600000;0
30819;192030;3737;0;0;0;0;.00nan;0;0
30819;62884;796;99;31;1;30;.968;3600000;0
30819;66924;796;0;0;0;0;.00nan;0;0
30820;165867;783;70;24;2;22;.917;3600000;0
30820;62060;794;83;21;0;21;1.000;2884000;0
30820;86422;783;0;0;0;0;.00nan;0;0
30820;152201;794;24;12;4;8;.667;716000;0
30821;201174;798;0;0;0;0;.00nan;0;0
30821;64066;777;0;0;0;0;.00nan;0;0
30821;148956;798;90;55;4;51;.927;3600000;0
30821;149847;777;83;14;0;14;1.000;3600000;0
30822;-1;3737;20;24;6;18;.750;3330000;0
30822;192030;3737;55;4;0;4;1.000;270000;0
30822;-1;776;0;0;0;0;.00nan;0;0
30822;95405;776;90;29;1;28;.966;3600000;0
30823;171673;778;0;0;0;0;.00nan;0;0
30823;190702;784;66;35;3;32;.914;3587000;0
30823;-1;784;0;0;0;0;.00nan;0;0
30823;76486;778;65;21;2;19;.905;3600000;0
30824;209571;780;0;0;0;0;.00nan;0;0
30824;-1;780;72;38;4;34;.895;3600000;0
30824;62884;796;0;0;0;0;.00nan;0;0
30824;66924;796;100;36;0;36;1.000;3600000;0
30825;183377;904;30;32;6;26;.813;3600000;0
30825;24177;2182;0;0;0;0;.00nan;0;0
30825;-1;904;0;0;0;0;.00nan;0;0
30825;86344;2182;56;18;2;16;.889;3600000;0
30826;209571;780;87;31;1;30;.968;3600000;0
30826;-1;776;0;0;0;0;.00nan;0;0
30826;-1;780;0;0;0;0;.00nan;0;0
30826;95405;776;54;31;4;27;.871;3600000;0
30827;183377;904;60;45;5;40;.889;3600000;0
30827;190702;784;0;0;0;0;.00nan;0;0
30827;-1;784;73;23;1;22;.957;3600000;0
30827;-1;904;0;0;0;0;.00nan;0;0
30828;201174;798;0;0;0;0;.00nan;0;0
30828;62060;794;0;0;0;0;.00nan;0;0
30828;148956;798;100;40;1;39;.975;3600000;0
30828;152201;794;88;39;2;37;.949;3558000;0
30829;24177;2182;0;0;0;0;.00nan;0;0
30829;64066;777;0;0;0;0;.00nan;0;0
30829;86344;2182;66;36;4;32;.889;3600000;0
30829;149847;777;77;24;1;23;.958;3600000;0
30830;171673;778;71;25;3;22;.880;3568000;0
30830;-1;3737;0;0;0;0;.00nan;0;0
30830;192030;3737;86;30;1;29;.967;3600000;0
30830;76486;778;0;0;0;0;.00nan;0;0
30831;165867;783;37;20;4;16;.800;3900000;0
30831;62884;796;57;34;4;30;.882;3900000;0
30831;66924;796;0;0;0;0;.00nan;0;0
30831;86422;783;0;0;0;0;.00nan;0;0
30832;24177;2182;97;20;0;20;1.000;3600000;0
30832;201174;798;0;0;0;0;.00nan;0;0
30832;86344;2182;0;0;0;0;.00nan;0;0
30832;148956;798;73;30;2;28;.933;3581000;0
30833;190702;784;75;40;3;37;.925;3546000;0
30833;-1;784;0;0;0;0;.00nan;0;0
30833;64066;777;0;0;0;0;.00nan;0;0
30833;149847;777;85;26;1;25;.962;3600000;0
30834;165867;783;58;30;3;27;.900;3549000;0
30834;-1;776;93;32;1;31;.969;3600000;0
30834;86422;783;0;0;0;0;.00nan;0;0
30834;95405;776;0;0;0;0;.00nan;0;0
30835;209571;780;0;0;0;0;.00nan;0;0
30835;171673;778;0;0;0;0;.00nan;0;0
30835;-1;780;64;42;4;38;.905;3600000;0
30835;76486;778;87;28;1;27;.964;3600000;0
30836;62060;794;55;11;1;10;.909;1216000;0
30836;62884;796;0;0;0;0;.00nan;0;0
30836;66924;796;56;19;2;17;.895;3600000;0
30836;152201;794;24;27;6;21;.778;2384000;0
30837;183377;904;48;42;6;36;.857;3600000;0
30837;-1;3737;73;11;0;11;1.000;3600000;0
30837;192030;3737;0;0;0;0;.00nan;0;0
30837;-1;904;0;0;0;0;.00nan;0;0
30838;165867;783;89;39;2;37;.949;3600000;0
30838;171673;778;40;20;4;16;.800;3600000;0
30838;76486;778;0;0;0;0;.00nan;0;0
30838;86422;783;0;0;0;0;.00nan;0;0
30839;183377;904;24;11;4;7;.636;1010000;0
30839;209571;780;45;17;3;14;.824;3600000;0
30839;-1;780;0;0;0;0;.00nan;0;0
30839;-1;904;53;26;3;23;.885;2590000;0
30840;-1;776;0;0;0;0;.00nan;0;0
30840;62060;794;50;38;5;33;.868;3578000;0
30840;95405;776;48;26;4;22;.846;3600000;0
30840;152201;794;0;0;0;0;.00nan;0;0
30841;201174;798;50;29;4;25;.862;3571000;0
30841;62884;796;74;25;2;23;.920;3600000;0
30841;66924;796;0;0;0;0;.00nan;0;0
30841;148956;798;0;0;0;0;.00nan;0;0
30842;-1;3737;69;27;2;25;.926;3600000;0
30842;192030;3737;0;0;0;0;.00nan;0;0
30842;64066;777;0;0;0;0;.00nan;0;0
30842;149847;777;100;26;0;26;1.000;3600000;0
30843;24177;2182;91;19;0;19;1.000;3600000;0
30843;190702;784;77;32;2;30;.938;3534000;0
30843;-1;784;0;0;0;0;.00nan;0;0
30843;86344;2182;0;0;0;0;.00nan;0;0
30844;-1;776;0;0;0;0;.00nan;0;0
30844;62884;796;0;0;0;0;.00nan;0;0
30844;66924;796;62;14;1;13;.929;3600000;0
30844;95405;776;81;42;3;39;.929;3558000;0
30845;201174;798;0;0;0;0;.00nan;0;0
30845;190702;784;84;34;2;32;.941;3821000;0
30845;-1;784;0;0;0;0;.00nan;0;0
30845;148956;798;78;28;3;25;.893;3821000;0
30846;209571;780;63;47;5;42;.894;3600000;0
30846;-1;780;0;0;0;0;.00nan;0;0
30846;64066;777;0;0;0;0;.00nan;0;0
30846;149847;777;88;21;0;21;1.000;3600000;0
30847;24177;2182;68;22;2;20;.909;3600000;0
30847;-1;3737;84;46;4;42;.913;3600000;0
30847;192030;3737;0;0;0;0;.00nan;0;0
30847;86344;2182;0;0;0;0;.00nan;0;0
30848;171673;778;0;0;0;0;.00nan;0;0
30848;62060;794;0;0;0;0;.00nan;0;0
30848;76486;778;99;21;0;21;1.000;3600000;0
30848;152201;794;98;39;1;38;.974;3600000;0
30849;183377;904;0;0;0;0;.00nan;0;0
30849;165867;783;54;11;2;9;.818;3900000;0
30849;-1;904;79;32;2;30;.938;3900000;0
30849;86422;783;0;0;0;0;.00nan;0;0
30850;209571;780;0;0;0;0;.00nan;0;0
30850;24177;2182;0;0;0;0;.00nan;0;0
30850;-1;780;84;46;4;42;.913;3809000;0
30850;86344;2182;40;26;5;21;.808;3809000;0
30851;201174;798;45;29;6;23;.793;3751000;0
30851;-1;776;0;0;0;0;.00nan;0;0
30851;95405;776;60;39;5;34;.872;3751000;0
30851;148956;798;0;0;0;0;.00nan;0;0
30852;165867;783;69;43;4;39;.907;3586000;0
30852;64066;777;0;0;0;0;.00nan;0;0
30852;86422;783;0;0;0;0;.00nan;0;0
30852;149847;777;57;18;2;16;.889;3600000;0
30853;190702;784;65;45;5;40;.889;3599000;0
30853;-1;3737;30;16;4;12;.750;3600000;0
30853;192030;3737;0;0;0;0;.00nan;0;0
30853;-1;784;0;0;0;0;.00nan;0;0
30854;171673;778;56;29;4;25;.862;3516000;0
30854;62884;796;88;36;2;34;.944;3600000;0
30854;66924;796;0;0;0;0;.00nan;0;0
30854;76486;778;0;0;0;0;.00nan;0;0
30855;183377;904;51;40;5;35;.875;3600000;0
30855;-1;904;0;0;0;0;.00nan;0;0
30855;62060;794;0;0;0;0;.00nan;0;0
30855;152201;794;60;28;3;25;.893;3600000;0
30856;165867;783;23;24;6;18;.750;1650000;0
30856;24177;2182;0;0;0;0;.00nan;0;0
30856;86344;2182;68;32;3;29;.906;3600000;0
30856;86422;783;53;18;2;16;.889;1950000;0
30857;209571;780;86;26;1;25;.962;3600000;0
30857;190702;784;39;31;6;25;.806;3341000;0
30857;-1;784;50;2;0;2;1.000;259000;0
30857;-1;780;0;0;0;0;.00nan;0;0
30858;62060;794;0;0;0;0;.00nan;0;0
30858;64066;777;68;20;1;19;.950;3600000;0
30858;149847;777;0;0;0;0;.00nan;0;0
30858;152201;794;46;45;7;38;.844;3600000;0
30859;201174;798;0;0;0;0;.00nan;0;0
30859;-1;3737;60;24;3;21;.875;3600000;0
30859;192030;3737;0;0;0;0;.00nan;0;0
30859;148956;798;76;41;4;37;.902;3600000;0
30860;171673;778;0;0;0;0;.00nan;0;0
30860;-1;776;0;0;0;0;.00nan;0;0
30860;76486;778;80;31;2;29;.935;3600000;0
30860;95405;776;67;39;4;35;.897;3513000;0
30861;183377;904;65;38;5;33;.868;3600000;0
30861;-1;904;0;0;0;0;.00nan;0;0
30861;62884;796;0;0;0;0;.00nan;0;0
30861;66924;796;48;20;3;17;.850;3600000;0
30862;24177;2182;0;0;0;0;.00nan;0;0
30862;62060;794;0;0;0;0;.00nan;0;0
30862;86344;2182;56;22;4;18;.818;3900000;0
30862;152201;794;67;39;4;35;.897;3900000;0
30863;183377;904;82;35;2;33;.943;3549000;0
30863;-1;776;0;0;0;0;.00nan;0;0
30863;-1;904;0;0;0;0;.00nan;0;0
30863;95405;776;93;20;0;20;1.000;3600000;0
30864;171673;778;42;17;3;14;.824;3565000;0
30864;201174;798;93;36;1;35;.972;3600000;0
30864;76486;778;0;0;0;0;.00nan;0;0
30864;148956;798;0;0;0;0;.00nan;0;0
30865;165867;783;72;39;3;36;.923;3600000;0
30865;190702;784;29;21;5;16;.762;3590000;0
30865;-1;784;0;0;0;0;.00nan;0;0
30865;86422;783;0;0;0;0;.00nan;0;0
30866;62884;796;85;36;2;34;.944;3600000;0
30866;64066;777;0;0;0;0;.00nan;0;0
30866;66924;796;0;0;0;0;.00nan;0;0
30866;149847;777;57;25;3;22;.880;3571000;0
30867;209571;780;50;1;0;1;1.000;280000;0
30867;-1;3737;81;25;1;24;.960;3600000;0
30867;192030;3737;0;0;0;0;.00nan;0;0
30867;-1;780;17;24;6;18;.750;3320000;0
30868;-1;776;0;0;0;0;.00nan;0;0
30868;64066;777;0;0;0;0;.00nan;0;0
30868;95405;776;42;27;4;23;.852;3547000;0
30868;149847;777;70;28;3;25;.893;3600000;0
30869;209571;780;58;42;5;37;.881;3600000;0
30869;201174;798;65;29;3;26;.897;2324000;0
30869;-1;780;0;0;0;0;.00nan;0;0
30869;148956;798;30;15;4;11;.733;1198000;0
30870;24177;2182;0;0;0;0;.00nan;0;0
30870;62884;796;90;38;1;37;.974;3600000;0
30870;66924;796;0;0;0;0;.00nan;0;0
30870;86344;2182;72;24;2;22;.917;3560000;0
30871;190702;784;0;0;0;0;.00nan;0;0
30871;-1;784;97;24;0;24;1.000;3600000;0
30871;62060;794;0;0;0;0;.00nan;0;0
30871;152201;794;75;32;2;30;.938;3600000;0
30872;165867;783;47;31;5;26;.839;3560000;0
30872;-1;3737;58;31;3;28;.903;3600000;0
30872;192030;3737;0;0;0;0;.00nan;0;0
30872;86422;783;0;0;0;0;.00nan;0;0
30873;183377;904;71;31;3;28;.903;3600000;0
30873;171673;778;0;0;0;0;.00nan;0;0
30873;-1;904;0;0;0;0;.00nan;0;0
30873;76486;778;62;18;2;16;.889;3600000;0
30874;209571;780;0;0;0;0;.00nan;0;0
30874;165867;783;96;24;0;24;1.000;3600000;0
30874;-1;780;76;35;2;33;.943;3540000;0
30874;86422;783;0;0;0;0;.00nan;0;0
30875;171673;778;60;33;4;29;.879;3600000;0
30875;64066;777;0;0;0;0;.00nan;0;0
30875;76486;778;0;0;0;0;.00nan;0;0
30875;149847;777;95;31;1;30;.968;3600000;0
30876;-1;3737;100;27;0;27;1.000;3600000;0
30876;192030;3737;0;0;0;0;.00nan;0;0
30876;62060;794;21;32;7;25;.781;2826000;0
30876;152201;794;67;14;0;14;1.000;774000;0
30877;24177;2182;0;0;0;0;.00nan;0;0
30877;-1;776;0;0;0;0;.00nan;0;0
30877;86344;2182;81;14;0;14;1.000;3600000;0
30877;95405;776;70;51;6;45;.882;3600000;0
30878;190702;784;0;0;0;0;.00nan;0;0
30878;-1;784;67;29;2;27;.931;3737000;0
30878;62884;796;0;0;0;0;.00nan;0;0
30878;66924;796;60;33;3;30;.909;3737000;0
30879;183377;904;99;43;1;42;.977;3600000;0
30879;201174;798;0;0;0;0;.00nan;0;0
30879;-1;904;0;0;0;0;.00nan;0;0
30879;148956;798;81;31;2;29;.935;3600000;0
30881;171673;778;56;45;6;39;.867;3100000;0
30881;207726;777;53;14;2;12;.857;3600000;0
30881;202497;778;30;11;3;8;.727;500000;0
30881;-1;777;0;0;0;0;.00nan;0;0
30883;190702;784;0;0;0;0;.00nan;0;0
30883;-1;784;58;29;4;25;.862;3590000;0
30883;62060;794;0;0;0;0;.00nan;0;0
30883;152201;794;86;41;3;38;.927;3600000;0
30885;193859;796;0;0;0;0;.00nan;0;0
30885;207727;783;0;0;0;0;.00nan;0;0
30885;-1;783;83;26;1;25;.962;3600000;0
30885;149847;796;55;28;3;25;.893;3556000;0
30887;209571;780;48;31;4;27;.871;3600000;0
30887;165867;2182;80;27;2;25;.926;3600000;0
30887;-1;780;0;0;0;0;.00nan;0;0
30887;64066;2182;0;0;0;0;.00nan;0;0
30889;201174;798;100;36;0;36;1.000;3600000;0
30889;-1;776;0;0;0;0;.00nan;0;0
30889;95405;776;73;32;3;29;.906;3600000;0
30889;148956;798;0;0;0;0;.00nan;0;0
30891;183377;904;71;51;5;46;.902;3600000;0
30891;-1;3737;95;32;1;31;.969;3600000;0
30891;192030;3737;0;0;0;0;.00nan;0;0
30891;-1;904;0;0;0;0;.00nan;0;0
30893;201174;798;83;16;0;16;1.000;3600000;0
30893;207727;783;61;29;3;26;.897;3600000;0
30893;-1;783;0;0;0;0;.00nan;0;0
30893;148956;798;0;0;0;0;.00nan;0;0
30895;183377;904;87;51;3;48;.941;3900000;0
30895;-1;776;0;0;0;0;.00nan;0;0
30895;-1;904;0;0;0;0;.00nan;0;0
30895;95405;776;50;20;3;17;.850;3900000;0
30897;207726;777;0;0;0;0;.00nan;0;0
30897;-1;777;93;21;0;21;1.000;3600000;0
30897;62060;794;0;0;0;0;.00nan;0;0
30897;152201;794;90;38;2;36;.947;3533000;0
30899;209571;780;0;0;0;0;.00nan;0;0
30899;-1;3737;61;28;3;25;.893;3600000;0
30899;192030;3737;0;0;0;0;.00nan;0;0
30899;-1;780;29;31;6;25;.806;3600000;0
30901;193859;796;0;0;0;0;.00nan;0;0
30901;171673;778;55;37;4;33;.892;3600000;0
30901;202497;778;0;0;0;0;.00nan;0;0
30901;149847;796;60;21;2;19;.905;3600000;0
30903;165867;2182;78;31;2;29;.935;3596000;0
30903;190702;784;80;21;1;20;.952;3600000;0
30903;-1;784;0;0;0;0;.00nan;0;0
30903;64066;2182;0;0;0;0;.00nan;0;0
30905;207727;783;0;0;0;0;.00nan;0;0
30905;-1;783;84;32;1;31;.969;3900000;0
30905;62060;794;76;17;1;16;.941;3900000;0
30905;152201;794;0;0;0;0;.00nan;0;0
30907;209571;780;69;34;3;31;.912;3561000;0
30907;207726;777;0;0;0;0;.00nan;0;0
30907;-1;780;0;0;0;0;.00nan;0;0
30907;-1;777;90;36;2;34;.944;3600000;0
30909;183377;904;0;0;0;0;.00nan;0;0
30909;171673;778;77;25;1;24;.960;3600000;0
30909;202497;778;0;0;0;0;.00nan;0;0
30909;-1;904;39;34;6;28;.824;3600000;0
30911;-1;3737;0;0;0;0;.00nan;0;0
30911;192030;3737;32;22;5;17;.773;3518000;0
30911;-1;776;82;43;3;40;.930;3600000;0
30911;95405;776;0;0;0;0;.00nan;0;0
30913;193859;796;42;31;5;26;.839;3600000;0
30913;190702;784;0;0;0;0;.00nan;0;0
30913;-1;784;100;32;0;32;1.000;3600000;0
30913;149847;796;0;0;0;0;.00nan;0;0
30915;165867;2182;0;0;0;0;.00nan;0;0
30915;201174;798;73;29;2;27;.931;3900000;0
30915;64066;2182;74;29;2;27;.931;3900000;0
30915;148956;798;0;0;0;0;.00nan;0;0
30917;209571;780;100;26;0;26;1.000;3600000;0
30917;-1;780;0;0;0;0;.00nan;0;0
30917;62060;794;0;0;0;0;.00nan;0;0
30917;152201;794;61;45;5;40;.889;3600000;0
30919;183377;904;73;43;5;38;.884;3600000;0
30919;207726;777;88;18;0;18;1.000;3600000;0
30919;-1;904;0;0;0;0;.00nan;0;0
30919;-1;777;0;0;0;0;.00nan;0;0
30921;190702;784;0;0;0;0;.00nan;0;0
30921;-1;3737;0;0;0;0;.00nan;0;0
30921;192030;3737;49;28;5;23;.821;3578000;0
30921;-1;784;83;43;3;40;.930;3600000;0
30923;193859;796;0;0;0;0;.00nan;0;0
30923;-1;776;0;0;0;0;.00nan;0;0
30923;95405;776;96;42;2;40;.952;3600000;0
30923;149847;796;44;16;3;13;.813;3540000;0
30925;171673;778;100;43;2;41;.953;3889000;0
30925;201174;798;58;22;2;20;.909;3900000;0
30925;202497;778;0;0;0;0;.00nan;0;0
30925;148956;798;0;0;0;0;.00nan;0;0
30927;165867;2182;92;47;2;45;.957;3600000;0
30927;207727;783;57;41;5;36;.878;3600000;0
30927;-1;783;0;0;0;0;.00nan;0;0
30927;64066;2182;0;0;0;0;.00nan;0;0
30929;190702;784;72;28;2;26;.929;3600000;0
30929;207727;783;0;0;0;0;.00nan;0;0
30929;-1;784;0;0;0;0;.00nan;0;0
30929;-1;783;64;31;3;28;.903;3573000;0
30931;193859;796;67;38;3;35;.921;3600000;0
30931;-1;3737;63;18;2;16;.889;3600000;0
30931;192030;3737;0;0;0;0;.00nan;0;0
30931;149847;796;0;0;0;0;.00nan;0;0
30933;209571;780;82;27;1;26;.963;3600000;0
30933;171673;778;0;0;0;0;.00nan;0;0
30933;202497;778;75;43;4;39;.907;3600000;0
30933;-1;780;0;0;0;0;.00nan;0;0
30935;207726;777;67;17;1;16;.941;3600000;0
30935;-1;776;85;34;2;32;.941;3587000;0
30935;-1;777;0;0;0;0;.00nan;0;0
30935;95405;776;0;0;0;0;.00nan;0;0
30937;201174;798;0;0;0;0;.00nan;0;0
30937;62060;794;45;27;4;23;.852;3549000;0
30937;148956;798;71;28;2;26;.929;3600000;0
30937;152201;794;0;0;0;0;.00nan;0;0
30939;183377;904;0;0;0;0;.00nan;0;0
30939;165867;2182;0;0;0;0;.00nan;0;0
30939;-1;904;98;54;2;52;.963;3590000;0
30939;64066;2182;66;15;1;14;.933;3600000;0
30941;193859;796;0;0;0;0;.00nan;0;0
30941;183377;904;48;23;4;19;.826;3600000;0
30941;-1;904;0;0;0;0;.00nan;0;0
30941;149847;796;65;23;2;21;.913;3600000;0
30943;171673;778;77;35;3;32;.914;3544000;0
30943;202497;778;0;0;0;0;.00nan;0;0
30943;62060;794;0;0;0;0;.00nan;0;0
30943;152201;794;79;19;1;18;.947;3600000;0
30945;209571;780;0;0;0;0;.00nan;0;0
30945;-1;3737;54;33;4;29;.879;3547000;0
30945;192030;3737;0;0;0;0;.00nan;0;0
30945;-1;780;76;34;2;32;.941;3600000;0
30947;207726;777;0;0;0;0;.00nan;0;0
30947;-1;776;0;0;0;0;.00nan;0;0
30947;-1;777;62;15;1;14;.933;3600000;0
30947;95405;776;88;48;3;45;.938;3588000;0
30949;165867;2182;53;15;2;13;.867;3600000;0
30949;207727;783;34;38;7;31;.816;2640000;0
30949;-1;783;50;8;1;7;.875;960000;0
30949;64066;2182;0;0;0;0;.00nan;0;0
30951;201174;798;93;39;2;37;.949;3900000;0
30951;190702;784;0;0;0;0;.00nan;0;0
30951;-1;784;63;23;2;21;.913;3900000;0
30951;148956;798;0;0;0;0;.00nan;0;0
30953;165867;2182;0;0;0;0;.00nan;0;0
30953;207727;783;0;0;0;0;.00nan;0;0
30953;-1;783;63;39;4;35;.897;3600000;0
30953;64066;2182;78;23;1;22;.957;3600000;0
30955;193859;796;59;25;3;22;.880;3556000;0
30955;207726;777;93;34;2;32;.941;3600000;0
30955;-1;777;0;0;0;0;.00nan;0;0
30955;149847;796;0;0;0;0;.00nan;0;0
30957;209571;780;64;19;1;18;.947;3600000;0
30957;201174;798;0;0;0;0;.00nan;0;0
30957;-1;780;0;0;0;0;.00nan;0;0
30957;148956;798;66;29;3;26;.897;3522000;0
30959;183377;904;0;0;0;0;.00nan;0;0
30959;171673;778;0;0;0;0;.00nan;0;0
30959;202497;778;74;26;2;24;.923;3600000;0
30959;-1;904;65;30;3;27;.900;3549000;0
30961;190702;784;35;37;6;31;.838;3600000;0
30961;-1;3737;0;0;0;0;.00nan;0;0
30961;192030;3737;79;28;1;27;.964;3600000;0
30961;-1;784;0;0;0;0;.00nan;0;0
30963;-1;776;93;35;2;33;.943;3689000;0
30963;62060;794;82;40;3;37;.925;3719000;0
30963;95405;776;0;0;0;0;.00nan;0;0
30963;152201;794;0;0;0;0;.00nan;0;0
1047;165867;783;47;25;4;21;.840;3600000;0
1047;-1;776;0;0;0;0;.00nan;0;0
1047;86422;783;0;0;0;0;.00nan;0;0
1047;95405;776;44;39;6;33;.846;3567000;0
1048;209571;780;39;21;4;17;.810;3600000;0
1048;190702;784;100;49;1;48;.980;3600000;0
1048;-1;784;0;0;0;0;.00nan;0;0
1048;-1;780;0;0;0;0;.00nan;0;0
1049;165867;783;49;15;3;12;.800;3600000;0
1049;-1;776;0;0;0;0;.00nan;0;0
1049;86422;783;0;0;0;0;.00nan;0;0
1049;95405;776;73;35;2;33;.943;3600000;0
1050;209571;780;0;0;0;0;.00nan;0;0
1050;190702;784;69;29;3;26;.897;3878000;0
1050;-1;784;0;0;0;0;.00nan;0;0
1050;-1;780;77;41;2;39;.951;3878000;0
1170;165867;783;100;34;0;34;1.000;3600000;0
1170;-1;776;0;0;0;0;.00nan;0;0
1170;86422;783;0;0;0;0;.00nan;0;0
1170;95405;776;55;26;3;23;.885;3600000;0
1171;209571;780;0;0;0;0;.00nan;0;0
1171;190702;784;28;21;5;16;.762;1950000;0
1171;-1;784;72;13;0;13;1.000;1605000;0
1171;-1;780;49;31;4;27;.871;3600000;0
1250;209571;780;0;0;0;0;.00nan;0;0
1250;-1;780;47;33;4;29;.879;3600000;0
1250;64066;777;0;0;0;0;.00nan;0;0
1250;149847;777;73;21;1;20;.952;3600000;0
1251;201174;798;0;0;0;0;.00nan;0;0
1251;-1;3737;81;39;3;36;.923;3600000;0
1251;192030;3737;0;0;0;0;.00nan;0;0
1251;148956;798;61;36;5;31;.861;3572000;0
1252;24177;2182;0;0;0;0;.00nan;0;0
1252;171673;778;0;0;0;0;.00nan;0;0
1252;76486;778;83;11;0;11;1.000;3600000;0
1252;86344;2182;97;40;1;39;.975;3579000;0
1253;165867;783;70;32;3;29;.906;3580000;0
1253;62884;796;73;18;1;17;.944;3600000;0
1253;66924;796;0;0;0;0;.00nan;0;0
1253;86422;783;0;0;0;0;.00nan;0;0
1254;209571;780;0;0;0;0;.00nan;0;0
1254;-1;780;74;46;5;41;.891;3600000;0
1254;64066;777;0;0;0;0;.00nan;0;0
1254;149847;777;97;22;0;22;1.000;3600000;0
1255;201174;798;0;0;0;0;.00nan;0;0
1255;-1;3737;69;17;1;16;.941;3600000;0
1255;192030;3737;0;0;0;0;.00nan;0;0
1255;148956;798;60;28;3;25;.893;3600000;0
1256;24177;2182;0;0;0;0;.00nan;0;0
1256;171673;778;67;29;3;26;.897;3573000;0
1256;76486;778;0;0;0;0;.00nan;0;0
1256;86344;2182;58;20;2;18;.900;3600000;0
1257;165867;783;78;35;3;32;.914;4031000;0
1257;62884;796;68;25;2;23;.920;4031000;0
1257;66924;796;0;0;0;0;.00nan;0;0
1257;86422;783;0;0;0;0;.00nan;0;0
1258;209571;780;0;0;0;0;.00nan;0;0
1258;-1;780;81;53;5;48;.906;3600000;0
1258;64066;777;0;0;0;0;.00nan;0;0
1258;149847;777;73;21;1;20;.952;3600000;0
1259;201174;798;0;0;0;0;.00nan;0;0
1259;-1;3737;71;28;3;25;.893;3758000;0
1259;192030;3737;0;0;0;0;.00nan;0;0
1259;148956;798;70;37;4;33;.892;3748000;0
1260;24177;2182;0;0;0;0;.00nan;0;0
1260;171673;778;77;25;1;24;.960;3600000;0
1260;76486;778;0;0;0;0;.00nan;0;0
1260;86344;2182;75;35;3;32;.914;3554000;0
1261;165867;783;100;23;0;23;1.000;3600000;0
1261;62884;796;73;33;3;30;.909;3600000;0
1261;66924;796;0;0;0;0;.00nan;0;0
1261;86422;783;0;0;0;0;.00nan;0;0
1262;209571;780;0;0;0;0;.00nan;0;0
1262;-1;780;85;41;3;38;.927;3730000;0
1262;64066;777;0;0;0;0;.00nan;0;0
1262;149847;777;61;29;4;25;.862;3730000;0
1263;201174;798;0;0;0;0;.00nan;0;0
1263;-1;3737;89;21;1;20;.952;3600000;0
1263;192030;3737;0;0;0;0;.00nan;0;0
1263;148956;798;62;23;2;21;.913;3556000;0
1264;24177;2182;0;0;0;0;.00nan;0;0
1264;171673;778;78;24;1;23;.958;3600000;0
1264;76486;778;0;0;0;0;.00nan;0;0
1264;86344;2182;89;36;2;34;.944;3544000;0
1265;165867;783;85;33;2;31;.939;4200000;0
1265;62884;796;95;39;2;37;.949;4200000;0
1265;66924;796;0;0;0;0;.00nan;0;0
1265;86422;783;0;0;0;0;.00nan;0;0
1565;209571;780;0;0;0;0;.00nan;0;0
1565;-1;780;81;35;2;33;.943;3566000;0
1565;64066;777;0;0;0;0;.00nan;0;0
1565;149847;777;75;23;1;22;.957;3600000;0
1566;24177;2182;0;0;0;0;.00nan;0;0
1566;171673;778;45;28;5;23;.821;3560000;0
1566;76486;778;0;0;0;0;.00nan;0;0
1566;86344;2182;63;28;3;25;.893;3600000;0
1567;165867;783;66;45;5;40;.889;3600000;0
1567;62884;796;91;18;0;18;1.000;3600000;0
1567;66924;796;0;0;0;0;.00nan;0;0
1567;86422;783;0;0;0;0;.00nan;0;0
1598;24177;2182;0;0;0;0;.00nan;0;0
1598;171673;778;100;33;0;33;1.000;3600000;0
1598;76486;778;0;0;0;0;.00nan;0;0
1598;86344;2182;64;21;2;19;.905;3600000;0
1633;171673;778;81;47;4;43;.915;3600000;0
1633;64066;777;0;0;0;0;.00nan;0;0
1633;76486;778;0;0;0;0;.00nan;0;0
1633;149847;777;71;18;1;17;.944;3600000;0
1634;-1;3737;90;39;2;37;.949;3842000;0
1634;192030;3737;0;0;0;0;.00nan;0;0
1634;62884;796;99;36;1;35;.972;3842000;0
1634;66924;796;0;0;0;0;.00nan;0;0
1635;171673;778;45;27;4;23;.852;3530000;0
1635;64066;777;0;0;0;0;.00nan;0;0
1635;76486;778;0;0;0;0;.00nan;0;0
1635;149847;777;76;29;2;27;.931;3600000;0
1636;-1;3737;70;26;2;24;.923;3662000;0
1636;192030;3737;0;0;0;0;.00nan;0;0
1636;62884;796;82;29;1;28;.966;3662000;0
1636;66924;796;0;0;0;0;.00nan;0;0
1637;171673;778;78;26;2;24;.923;3600000;0
1637;64066;777;0;0;0;0;.00nan;0;0
1637;76486;778;0;0;0;0;.00nan;0;0
1637;149847;777;53;30;4;26;.867;3575000;0
1638;-1;3737;59;23;2;21;.913;3561000;0
1638;192030;3737;0;0;0;0;.00nan;0;0
1638;62884;796;100;24;0;24;1.000;3600000;0
1638;66924;796;0;0;0;0;.00nan;0;0
1639;171673;778;82;33;2;31;.939;3600000;0
1639;64066;777;0;0;0;0;.00nan;0;0
1639;76486;778;0;0;0;0;.00nan;0;0
1639;149847;777;60;36;4;32;.889;3530000;0
1640;-1;3737;80;39;3;36;.923;4200000;0
1640;192030;3737;0;0;0;0;.00nan;0;0
1640;62884;796;72;27;3;24;.889;4200000;0
1640;66924;796;0;0;0;0;.00nan;0;0
1904;171673;778;90;37;2;35;.946;3545000;0
1904;64066;777;0;0;0;0;.00nan;0;0
1904;76486;778;0;0;0;0;.00nan;0;0
1904;149847;777;71;21;1;20;.952;3600000;0
1909;171673;778;54;35;5;30;.857;3600000;0
1909;64066;777;42;3;1;2;.667;353000;0
1909;76486;778;0;0;0;0;.00nan;0;0
1909;149847;777;20;21;6;15;.714;3187000;0
1943;171673;778;90;29;1;28;.966;4009000;0
1943;64066;777;0;0;0;0;.00nan;0;0
1943;76486;778;0;0;0;0;.00nan;0;0
1943;149847;777;96;25;0;25;1.000;4009000;0
1973;62884;796;79;26;2;24;.923;3600000;0
1973;64066;777;0;0;0;0;.00nan;0;0
1973;66924;796;0;0;0;0;.00nan;0;0
1973;149847;777;59;27;3;24;.889;3581000;0
1974;62884;796;54;31;5;26;.839;3600000;0
1974;64066;777;0;0;0;0;.00nan;0;0
1974;66924;796;0;0;0;0;.00nan;0;0
1974;149847;777;89;32;2;30;.938;3600000;0
1975;62884;796;26;29;6;23;.793;3600000;0
1975;64066;777;0;0;0;0;.00nan;0;0
1975;66924;796;0;0;0;0;.00nan;0;0
1975;149847;777;72;28;3;25;.893;3600000;0
1976;62884;796;76;38;3;35;.921;3527000;0
1976;64066;777;0;0;0;0;.00nan;0;0
1976;66924;796;0;0;0;0;.00nan;0;0
1976;149847;777;91;30;1;29;.967;3600000;0
2189;62884;796;90;36;2;34;.944;3600000;0
2189;64066;777;0;0;0;0;.00nan;0;0
2189;66924;796;0;0;0;0;.00nan;0;0
2189;149847;777;22;26;6;20;.769;3600000;0
2275;62884;796;81;26;1;25;.962;3600000;0
2275;64066;777;0;0;0;0;.00nan;0;0
2275;66924;796;0;0;0;0;.00nan;0;0
2275;149847;777;57;18;2;16;.889;3563000;0
2302;62884;796;100;29;0;29;1.000;3600000;0
2302;64066;777;0;0;0;0;.00nan;0;0
2302;66924;796;0;0;0;0;.00nan;0;0
2302;149847;777;81;27;1;26;.963;3543000;0
30964;169615;554;50;24;4;20;.833;3697000;0
30964;196812;1423;82;46;3;43;.935;3697000;0
30964;-1;1423;0;0;0;0;.00nan;0;0
30964;85489;554;0;0;0;0;.00nan;0;0
30965;169615;554;81;23;1;22;.957;3600000;0
30965;-1;555;83;43;3;40;.930;3518000;0
30965;68961;555;0;0;0;0;.00nan;0;0
30965;85489;554;0;0;0;0;.00nan;0;0
30966;167061;2626;90;43;2;41;.953;3900000;0
30966;178911;552;61;17;2;15;.882;3900000;0
30966;28989;2626;0;0;0;0;.00nan;0;0
30966;77086;552;0;0;0;0;.00nan;0;0
30967;-1;561;0;0;0;0;.00nan;0;0
30967;65324;561;72;32;3;29;.906;3600000;0
30967;75764;558;0;0;0;0;.00nan;0;0
30967;85395;558;56;39;5;34;.872;3563000;0
30968;167061;2626;57;28;3;25;.893;3563000;0
30968;28989;2626;0;0;0;0;.00nan;0;0
30968;57172;556;86;32;1;31;.969;3600000;0
30968;85349;556;0;0;0;0;.00nan;0;0
30969;196812;1423;29;14;4;10;.714;838000;0
30969;-1;553;0;0;0;0;.00nan;0;0
30969;-1;1423;70;25;2;23;.920;2762000;0
30969;85984;553;85;26;1;25;.962;3600000;0
30970;167061;2626;24;5;3;2;.400;446000;0
30970;28989;2626;97;62;3;59;.952;3154000;0
30970;57172;556;70;27;2;25;.926;3600000;0
30970;85349;556;0;0;0;0;.00nan;0;0
30971;178911;552;32;16;4;12;.750;3649000;0
30971;-1;555;80;61;5;56;.918;3645000;0
30971;68961;555;0;0;0;0;.00nan;0;0
30971;77086;552;0;0;0;0;.00nan;0;0
30972;169615;554;55;27;3;24;.889;3552000;0
30972;-1;561;0;0;0;0;.00nan;0;0
30972;65324;561;96;36;1;35;.972;3600000;0
30972;85489;554;0;0;0;0;.00nan;0;0
30973;167061;2626;74;21;1;20;.952;3600000;0
30973;28989;2626;0;0;0;0;.00nan;0;0
30973;-1;555;0;0;0;0;.00nan;0;0
30973;68961;555;63;40;4;36;.900;3600000;0
30974;196812;1423;39;45;8;37;.822;3600000;0
30974;-1;1423;0;0;0;0;.00nan;0;0
30974;75764;558;0;0;0;0;.00nan;0;0
30974;85395;558;36;24;5;19;.792;3600000;0
30975;4379;560;72;26;1;25;.962;3600000;0
30975;-1;555;62;35;4;31;.886;3600000;0
30975;-1;560;0;0;0;0;.00nan;0;0
30975;68961;555;0;0;0;0;.00nan;0;0
30976;178911;552;66;24;2;22;.917;3600000;0
30976;-1;561;0;0;0;0;.00nan;0;0
30976;65324;561;47;40;6;34;.850;3600000;0
30976;77086;552;0;0;0;0;.00nan;0;0
30977;4379;560;57;42;5;37;.881;3600000;0
30977;-1;561;0;0;0;0;.00nan;0;0
30977;-1;560;0;0;0;0;.00nan;0;0
30977;65324;561;71;20;1;19;.950;3600000;0
30978;169615;554;69;20;1;19;.950;3600000;0
30978;196812;1423;34;30;6;24;.800;1900000;0
30978;-1;1423;46;18;3;15;.833;1700000;0
30978;85489;554;0;0;0;0;.00nan;0;0
30979;4379;560;31;52;9;43;.827;3600000;0
30979;-1;553;0;0;0;0;.00nan;0;0
30979;-1;560;0;0;0;0;.00nan;0;0
30979;85984;553;45;25;4;21;.840;3600000;0
30980;178911;552;0;0;0;0;.00nan;0;0
30980;57172;556;95;49;3;46;.939;3900000;0
30980;77086;552;54;21;3;18;.857;3900000;0
30980;85349;556;0;0;0;0;.00nan;0;0
30981;178911;552;60;33;4;29;.879;3581000;0
30981;75764;558;0;0;0;0;.00nan;0;0
30981;77086;552;0;0;0;0;.00nan;0;0
30981;85395;558;93;33;2;31;.939;3600000;0
30982;169615;554;100;28;0;28;1.000;3600000;0
30982;57172;556;98;43;2;41;.953;3600000;0
30982;85349;556;0;0;0;0;.00nan;0;0
30982;85489;554;0;0;0;0;.00nan;0;0
30983;-1;561;0;0;0;0;.00nan;0;0
30983;57172;556;60;22;2;20;.909;3600000;0
30983;65324;561;63;47;5;42;.894;3600000;0
30983;85349;556;0;0;0;0;.00nan;0;0
30984;169615;554;63;37;4;33;.892;3870000;0
30984;75764;558;0;0;0;0;.00nan;0;0
30984;85395;558;82;45;4;41;.911;3900000;0
30984;85489;554;0;0;0;0;.00nan;0;0
30985;167061;2626;81;29;2;27;.931;3600000;0
30985;28989;2626;0;0;0;0;.00nan;0;0
30985;-1;561;47;29;4;25;.862;3517000;0
30985;65324;561;0;0;0;0;.00nan;0;0
30986;4379;560;40;30;5;25;.833;3600000;0
30986;196812;1423;92;39;2;37;.949;3600000;0
30986;-1;560;0;0;0;0;.00nan;0;0
30986;-1;1423;0;0;0;0;.00nan;0;0
30987;-1;553;0;0;0;0;.00nan;0;0
30987;-1;555;47;46;7;39;.848;3539000;0
30987;68961;555;0;0;0;0;.00nan;0;0
30987;85984;553;35;29;5;24;.828;3600000;0
30988;178911;552;57;18;2;16;.889;1878000;0
30988;57172;556;23;3;3;0;.000;235000;0
30988;77086;552;23;22;6;16;.727;1696000;0
30988;85349;556;66;28;3;25;.893;3365000;0
30989;167061;2626;0;0;0;0;.00nan;0;0
30989;28989;2626;73;33;2;31;.939;3600000;0
30989;-1;561;0;0;0;0;.00nan;0;0
30989;65324;561;57;34;3;31;.912;3548000;0
30990;169615;554;62;37;4;33;.892;3571000;0
30990;-1;553;75;32;2;30;.938;3600000;0
30990;85489;554;0;0;0;0;.00nan;0;0
30990;85984;553;0;0;0;0;.00nan;0;0
30991;178911;552;84;35;2;33;.943;3900000;0
30991;-1;553;0;0;0;0;.00nan;0;0
30991;77086;552;0;0;0;0;.00nan;0;0
30991;85984;553;85;38;2;36;.947;3900000;0
30992;167061;2626;66;37;5;32;.865;3678000;0
30992;28989;2626;0;0;0;0;.00nan;0;0
30992;-1;553;42;22;4;18;.818;3678000;0
30992;85984;553;0;0;0;0;.00nan;0;0
30993;4379;560;89;51;5;46;.902;3600000;0
30993;-1;560;0;0;0;0;.00nan;0;0
30993;57172;556;72;22;1;21;.955;3600000;0
30993;85349;556;0;0;0;0;.00nan;0;0
30994;-1;555;88;58;4;54;.931;3600000;0
30994;68961;555;0;0;0;0;.00nan;0;0
30994;75764;558;0;0;0;0;.00nan;0;0
30994;85395;558;100;20;0;20;1.000;3600000;0
30995;4379;560;53;2;0;2;1.000;320000;0
30995;-1;560;33;39;8;31;.795;3280000;0
30995;57172;556;0;0;0;0;.00nan;0;0
30995;85349;556;77;23;1;22;.957;3600000;0
30996;169615;554;58;29;4;25;.862;3571000;0
30996;-1;553;0;0;0;0;.00nan;0;0
30996;85489;554;0;0;0;0;.00nan;0;0
30996;85984;553;72;27;2;25;.926;3600000;0
30997;-1;555;0;0;0;0;.00nan;0;0
30997;68961;555;81;38;2;36;.947;3600000;0
30997;75764;558;0;0;0;0;.00nan;0;0
30997;85395;558;69;20;1;19;.950;3600000;0
30998;178911;552;0;0;0;0;.00nan;0;0
30998;75764;558;0;0;0;0;.00nan;0;0
30998;77086;552;68;30;3;27;.900;3600000;0
30998;85395;558;35;31;5;26;.839;3583000;0
30999;-1;561;0;0;0;0;.00nan;0;0
30999;57172;556;85;28;1;27;.964;3600000;0
30999;65324;561;78;37;2;35;.946;3589000;0
30999;85349;556;0;0;0;0;.00nan;0;0
31000;167061;2626;25;5;3;2;.400;536000;0
31000;28989;2626;69;21;1;20;.952;3050000;0
31000;196812;1423;66;31;3;28;.903;3600000;0
31000;-1;1423;0;0;0;0;.00nan;0;0
31001;4379;560;68;24;2;22;.917;3600000;0
31001;-1;555;34;32;6;26;.813;2674000;0
31001;-1;560;0;0;0;0;.00nan;0;0
31001;68961;555;29;10;3;7;.700;926000;0
31002;196812;1423;100;32;0;32;1.000;3600000;0
31002;-1;1423;0;0;0;0;.00nan;0;0
31002;57172;556;0;0;0;0;.00nan;0;0
31002;85349;556;73;33;3;30;.909;3600000;0
31003;-1;553;34;28;5;23;.821;3600000;0
31003;75764;558;56;4;0;4;1.000;263000;0
31003;85395;558;51;34;6;28;.824;3318000;0
31003;85984;553;0;0;0;0;.00nan;0;0
31004;178911;552;0;0;0;0;.00nan;0;0
31004;-1;561;0;0;0;0;.00nan;0;0
31004;65324;561;47;31;5;26;.839;3600000;0
31004;77086;552;65;27;3;24;.889;3600000;0
31005;169615;554;77;26;1;25;.962;3600000;0
31005;-1;561;25;26;6;20;.769;2587000;0
31005;65324;561;54;11;1;10;.909;1013000;0
31005;85489;554;0;0;0;0;.00nan;0;0
31006;196812;1423;57;43;5;38;.884;3600000;0
31006;-1;1423;0;0;0;0;.00nan;0;0
31006;57172;556;75;24;1;23;.958;3600000;0
31006;85349;556;0;0;0;0;.00nan;0;0
31007;178911;552;72;29;2;27;.931;3900000;0
31007;75764;558;0;0;0;0;.00nan;0;0
31007;77086;552;0;0;0;0;.00nan;0;0
31007;85395;558;77;26;2;24;.923;3900000;0
31008;-1;553;0;0;0;0;.00nan;0;0
31008;-1;555;0;0;0;0;.00nan;0;0
31008;68961;555;97;55;3;52;.945;3560000;0
31008;85984;553;68;13;1;12;.923;3600000;0
31009;4379;560;0;0;0;0;.00nan;0;0
31009;195566;2626;0;0;0;0;.00nan;0;0
31009;28989;2626;88;20;0;20;1.000;3600000;0
31009;-1;560;72;34;3;31;.912;3600000;0
31010;167061;2626;0;0;0;0;.00nan;0;0
31010;28989;2626;72;37;4;33;.892;3793000;0
31010;-1;561;0;0;0;0;.00nan;0;0
31010;65324;561;56;24;3;21;.875;3793000;0
31011;4379;560;100;34;0;34;1.000;3600000;0
31011;-1;561;0;0;0;0;.00nan;0;0
31011;-1;560;0;0;0;0;.00nan;0;0
31011;65324;561;56;30;3;27;.900;3600000;0
31012;178911;552;100;30;0;30;1.000;3600000;0
31012;57172;556;68;30;3;27;.900;3600000;0
31012;77086;552;0;0;0;0;.00nan;0;0
31012;85349;556;0;0;0;0;.00nan;0;0
31013;-1;553;0;0;0;0;.00nan;0;0
31013;75764;558;26;33;7;26;.788;1847000;0
31013;85395;558;67;19;1;18;.947;1753000;0
31013;85984;553;99;18;0;18;1.000;3600000;0
31014;178911;552;56;25;3;22;.880;3579000;0
31014;-1;553;0;0;0;0;.00nan;0;0
31014;77086;552;0;0;0;0;.00nan;0;0
31014;85984;553;74;28;2;26;.929;3600000;0
31015;4379;560;85;36;2;34;.944;3558000;0
31015;-1;555;100;41;1;40;.976;3600000;0
31015;-1;560;0;0;0;0;.00nan;0;0
31015;68961;555;0;0;0;0;.00nan;0;0
31016;169615;554;0;0;0;0;.00nan;0;0
31016;196812;1423;63;30;3;27;.900;3900000;0
31016;-1;1423;0;0;0;0;.00nan;0;0
31016;85489;554;62;27;3;24;.889;3900000;0
31017;-1;555;83;37;2;35;.946;3546000;0
31017;68961;555;0;0;0;0;.00nan;0;0
31017;75764;558;0;0;0;0;.00nan;0;0
31017;85395;558;87;15;0;15;1.000;3600000;0
31018;196812;1423;72;38;3;35;.921;3645000;0
31018;-1;553;0;0;0;0;.00nan;0;0
31018;-1;1423;0;0;0;0;.00nan;0;0
31018;85984;553;64;32;4;28;.875;3645000;0
31019;-1;555;97;55;4;51;.927;3600000;0
31019;57172;556;58;15;2;13;.867;3600000;0
31019;68961;555;0;0;0;0;.00nan;0;0
31019;85349;556;0;0;0;0;.00nan;0;0
31020;4379;560;74;34;3;31;.912;3600000;0
31020;169615;554;70;19;1;18;.947;3600000;0
31020;-1;560;0;0;0;0;.00nan;0;0
31020;85489;554;0;0;0;0;.00nan;0;0
31021;196812;1423;90;37;2;35;.946;3554000;0
31021;-1;553;0;0;0;0;.00nan;0;0
31021;-1;1423;0;0;0;0;.00nan;0;0
31021;85984;553;83;31;1;30;.968;3600000;0
31022;-1;555;64;51;5;46;.902;3600000;0
31022;57172;556;67;18;1;17;.944;3600000;0
31022;68961;555;0;0;0;0;.00nan;0;0
31022;85349;556;0;0;0;0;.00nan;0;0
31023;4379;560;0;0;0;0;.00nan;0;0
31023;167061;2626;85;21;0;21;1.000;3900000;0
31023;28989;2626;0;0;0;0;.00nan;0;0
31023;-1;560;100;29;0;29;1.000;3900000;0
31024;169615;554;0;0;0;0;.00nan;0;0
31024;75764;558;0;0;0;0;.00nan;0;0
31024;85395;558;67;20;1;19;.950;3600000;0
31024;85489;554;59;27;3;24;.889;3526000;0
31025;196812;1423;99;36;2;34;.944;3600000;0
31025;-1;555;64;40;4;36;.900;3600000;0
31025;-1;1423;0;0;0;0;.00nan;0;0
31025;68961;555;0;0;0;0;.00nan;0;0
31026;167061;2626;71;33;3;30;.909;3574000;0
31026;28989;2626;0;0;0;0;.00nan;0;0
31026;57172;556;75;27;2;25;.926;3600000;0
31026;85349;556;0;0;0;0;.00nan;0;0
31027;4379;560;0;0;0;0;.00nan;0;0
31027;-1;560;84;27;2;25;.926;3600000;0
31027;75764;558;0;0;0;0;.00nan;0;0
31027;85395;558;72;31;3;28;.903;3586000;0
31028;196812;1423;79;25;2;23;.920;3900000;0
31028;-1;1423;0;0;0;0;.00nan;0;0
31028;57172;556;0;0;0;0;.00nan;0;0
31028;85349;556;88;37;2;35;.946;3900000;0
31029;167061;2626;0;0;0;0;.00nan;0;0
31029;28989;2626;63;36;4;32;.889;3575000;0
31029;-1;553;79;24;2;22;.917;3600000;0
31029;85984;553;0;0;0;0;.00nan;0;0
31030;-1;553;0;0;0;0;.00nan;0;0
31030;-1;561;0;0;0;0;.00nan;0;0
31030;65324;561;74;29;2;27;.931;3589000;0
31030;85984;553;63;15;1;14;.933;3600000;0
31031;167061;2626;66;32;4;28;.875;3600000;0
31031;28989;2626;0;0;0;0;.00nan;0;0
31031;75764;558;0;0;0;0;.00nan;0;0
31031;85395;558;57;40;6;34;.850;3600000;0
31032;169615;554;87;14;0;14;1.000;3600000;0
31032;-1;555;98;50;2;48;.960;3600000;0
31032;68961;555;0;0;0;0;.00nan;0;0
31032;85489;554;0;0;0;0;.00nan;0;0
31033;4379;560;100;43;1;42;.977;3616000;0
31033;178911;552;64;22;2;20;.909;3616000;0
31033;-1;560;0;0;0;0;.00nan;0;0
31033;77086;552;0;0;0;0;.00nan;0;0
31034;4379;560;51;40;5;35;.875;3588000;0
31034;-1;560;0;0;0;0;.00nan;0;0
31034;75764;558;0;0;0;0;.00nan;0;0
31034;85395;558;56;24;3;21;.875;3600000;0
31035;178911;552;86;32;1;31;.969;3600000;0
31035;-1;561;45;35;5;30;.857;3600000;0
31035;65324;561;0;0;0;0;.00nan;0;0
31035;77086;552;0;0;0;0;.00nan;0;0
31036;169615;554;75;23;1;22;.957;3600000;0
31036;57172;556;92;42;2;40;.952;3554000;0
31036;85349;556;0;0;0;0;.00nan;0;0
31036;85489;554;0;0;0;0;.00nan;0;0
31037;196812;1423;67;39;5;34;.872;3585000;0
31037;-1;553;0;0;0;0;.00nan;0;0
31037;-1;1423;0;0;0;0;.00nan;0;0
31037;85984;553;77;34;3;31;.912;3600000;0
31038;167061;2626;57;44;5;39;.886;3600000;0
31038;28989;2626;0;0;0;0;.00nan;0;0
31038;75764;558;0;0;0;0;.00nan;0;0
31038;85395;558;75;22;1;21;.955;3600000;0
31039;4379;560;80;29;2;27;.931;3600000;0
31039;169615;554;67;32;3;29;.906;3580000;0
31039;-1;560;0;0;0;0;.00nan;0;0
31039;85489;554;0;0;0;0;.00nan;0;0
31040;196812;1423;0;0;0;0;.00nan;0;0
31040;-1;561;0;0;0;0;.00nan;0;0
31040;-1;1423;33;32;5;27;.844;3600000;0
31040;65324;561;63;26;2;24;.923;3600000;0
31041;-1;553;0;0;0;0;.00nan;0;0
31041;-1;555;89;34;1;33;.971;3600000;0
31041;68961;555;0;0;0;0;.00nan;0;0
31041;85984;553;57;20;2;18;.900;3600000;0
31042;178911;552;0;0;0;0;.00nan;0;0
31042;57172;556;0;0;0;0;.00nan;0;0
31042;77086;552;86;31;2;29;.935;3600000;0
31042;85349;556;75;43;4;39;.907;3586000;0
31043;4379;560;0;0;0;0;.00nan;0;0
31043;178911;552;44;23;4;19;.826;3600000;0
31043;-1;560;100;39;1;38;.974;3600000;0
31043;77086;552;0;0;0;0;.00nan;0;0
31044;4379;560;55;41;5;36;.878;3600000;0
31044;196812;1423;58;20;2;18;.900;3600000;0
31044;-1;560;0;0;0;0;.00nan;0;0
31044;-1;1423;0;0;0;0;.00nan;0;0
31045;-1;561;0;0;0;0;.00nan;0;0
31045;57172;556;70;27;3;24;.889;3557000;0
31045;65324;561;68;20;1;19;.950;3600000;0
31045;85349;556;0;0;0;0;.00nan;0;0
31046;167061;2626;100;48;1;47;.979;3600000;0
31046;28989;2626;0;0;0;0;.00nan;0;0
31046;-1;553;0;0;0;0;.00nan;0;0
31046;85984;553;52;25;4;21;.840;3600000;0
31047;169615;554;56;19;2;17;.895;3583000;0
31047;-1;555;96;47;1;46;.979;3600000;0
31047;68961;555;0;0;0;0;.00nan;0;0
31047;85489;554;0;0;0;0;.00nan;0;0
31048;178911;552;0;0;0;0;.00nan;0;0
31048;196812;1423;99;45;1;44;.978;3600000;0
31048;-1;1423;0;0;0;0;.00nan;0;0
31048;77086;552;67;29;2;27;.931;3555000;0
31049;169615;554;0;0;0;0;.00nan;0;0
31049;-1;553;0;0;0;0;.00nan;0;0
31049;85489;554;49;35;6;29;.829;3600000;0
31049;85984;553;40;17;4;13;.765;3600000;0
31050;-1;561;79;30;3;27;.900;3591000;0
31050;65324;561;0;0;0;0;.00nan;0;0
31050;75764;558;0;0;0;0;.00nan;0;0
31050;85395;558;86;31;2;29;.935;3600000;0
31051;4379;560;94;24;0;24;1.000;3600000;0
31051;167061;2626;76;43;4;39;.907;3600000;0
31051;28989;2626;0;0;0;0;.00nan;0;0
31051;-1;560;0;0;0;0;.00nan;0;0
31052;4379;560;67;33;3;30;.909;3600000;0
31052;167061;2626;0;0;0;0;.00nan;0;0
31052;28989;2626;56;35;4;31;.886;3577000;0
31052;-1;560;0;0;0;0;.00nan;0;0
31053;-1;561;0;0;0;0;.00nan;0;0
31053;57172;556;70;27;2;25;.926;3733000;0
31053;65324;561;66;30;3;27;.900;3733000;0
31053;85349;556;0;0;0;0;.00nan;0;0
31054;196812;1423;75;34;3;31;.912;3580000;0
31054;-1;1423;0;0;0;0;.00nan;0;0
31054;75764;558;0;0;0;0;.00nan;0;0
31054;85395;558;89;33;2;31;.939;3600000;0
31055;178911;552;55;9;1;8;.889;3600000;0
31055;-1;555;66;74;6;68;.919;3600000;0
31055;68961;555;0;0;0;0;.00nan;0;0
31055;77086;552;0;0;0;0;.00nan;0;0
31056;169615;554;75;25;1;24;.960;3600000;0
31056;-1;553;48;6;1;5;.833;534000;0
31056;85489;554;0;0;0;0;.00nan;0;0
31056;85984;553;36;34;6;28;.824;3066000;0
31057;196812;1423;93;35;2;33;.943;3900000;0
31057;-1;1423;0;0;0;0;.00nan;0;0
31057;75764;558;0;0;0;0;.00nan;0;0
31057;85395;558;70;28;2;26;.929;3900000;0
31058;169615;554;0;0;0;0;.00nan;0;0
31058;57172;556;53;3;0;3;1.000;351000;0
31058;85349;556;48;44;6;38;.864;3249000;0
31058;85489;554;92;28;0;28;1.000;3600000;0
31059;-1;553;40;18;4;14;.778;3875000;0
31059;-1;561;62;43;5;38;.884;3875000;0
31059;65324;561;0;0;0;0;.00nan;0;0
31059;85984;553;0;0;0;0;.00nan;0;0
31060;178911;552;0;0;0;0;.00nan;0;0
31060;-1;555;0;0;0;0;.00nan;0;0
31060;68961;555;67;43;5;38;.884;3600000;0
31060;77086;552;83;25;1;24;.960;3600000;0
31061;4379;560;79;48;5;43;.896;3600000;0
31061;-1;553;100;37;1;36;.973;3600000;0
31061;-1;560;0;0;0;0;.00nan;0;0
31061;85984;553;0;0;0;0;.00nan;0;0
31062;-1;561;0;0;0;0;.00nan;0;0
31062;65324;561;95;37;2;35;.946;3600000;0
31062;75764;558;0;0;0;0;.00nan;0;0
31062;85395;558;71;27;3;24;.889;3591000;0
31063;196812;1423;46;16;3;13;.813;3600000;0
31063;-1;555;100;45;0;45;1.000;3600000;0
31063;-1;1423;0;0;0;0;.00nan;0;0
31063;68961;555;0;0;0;0;.00nan;0;0
31064;167061;2626;79;36;3;33;.917;3630000;0
31064;178911;552;67;27;2;25;.926;3630000;0
31064;28989;2626;0;0;0;0;.00nan;0;0
31064;77086;552;0;0;0;0;.00nan;0;0
31065;4379;560;52;41;5;36;.878;3600000;0
31065;-1;553;82;22;1;21;.955;3600000;0
31065;85984;553;0;0;0;0;.00nan;0;0
31065;157929;560;0;0;0;0;.00nan;0;0
31066;57172;556;78;36;3;33;.917;3900000;0
31066;75764;558;0;0;0;0;.00nan;0;0
31066;85349;556;0;0;0;0;.00nan;0;0
31066;85395;558;78;42;3;39;.929;3900000;0
31067;216525;1423;0;0;0;0;.00nan;0;0
31067;196812;1423;24;16;5;11;.688;3590000;0
31067;-1;555;85;41;4;37;.902;3600000;0
31067;68961;555;0;0;0;0;.00nan;0;0
31068;167061;2626;0;0;0;0;.00nan;0;0
31068;178911;552;0;0;0;0;.00nan;0;0
31068;28989;2626;79;47;4;43;.915;3600000;0
31068;77086;552;67;19;1;18;.947;3600000;0
31069;169615;554;0;0;0;0;.00nan;0;0
31069;-1;561;22;10;4;6;.600;853000;0
31069;65324;561;63;27;3;24;.889;2747000;0
31069;85489;554;63;27;3;24;.889;3600000;0
31070;216525;1423;0;0;0;0;.00nan;0;0
31070;196812;1423;16;24;7;17;.708;3600000;0
31070;-1;561;98;35;1;34;.971;3600000;0
31070;65324;561;0;0;0;0;.00nan;0;0
31071;-1;553;100;28;0;28;1.000;3600000;0
31071;57172;556;39;33;5;28;.848;3600000;0
31071;85349;556;0;0;0;0;.00nan;0;0
31071;85984;553;0;0;0;0;.00nan;0;0
31072;4379;560;45;43;6;37;.860;3600000;0
31072;75764;558;87;13;0;13;1.000;3600000;0
31072;85395;558;0;0;0;0;.00nan;0;0
31072;157929;560;0;0;0;0;.00nan;0;0
31073;167061;2626;37;23;4;19;.826;3600000;0
31073;28989;2626;0;0;0;0;.00nan;0;0
31073;-1;555;66;33;3;30;.909;3600000;0
31073;68961;555;0;0;0;0;.00nan;0;0
31074;169615;554;82;42;3;39;.929;3553000;0
31074;178911;552;95;30;1;29;.967;3600000;0
31074;77086;552;0;0;0;0;.00nan;0;0
31074;85489;554;0;0;0;0;.00nan;0;0
31075;216525;1423;0;0;0;0;.00nan;0;0
31075;196812;1423;40;30;5;25;.833;3552000;0
31075;-1;561;0;0;0;0;.00nan;0;0
31075;65324;561;84;44;3;41;.932;3600000;0
31076;-1;553;74;31;2;29;.935;3542000;0
31076;57172;556;0;0;0;0;.00nan;0;0
31076;85349;556;82;23;1;22;.957;3600000;0
31076;85984;553;0;0;0;0;.00nan;0;0
31077;167061;2626;0;0;0;0;.00nan;0;0
31077;28989;2626;85;26;1;25;.962;3900000;0
31077;-1;555;0;0;0;0;.00nan;0;0
31077;68961;555;95;46;1;45;.978;3900000;0
31078;169615;554;0;0;0;0;.00nan;0;0
31078;178911;552;0;0;0;0;.00nan;0;0
31078;77086;552;71;37;3;34;.919;3600000;0
31078;85489;554;47;31;5;26;.839;3593000;0
31079;4379;560;91;40;2;38;.950;3600000;0
31079;75764;558;42;18;3;15;.833;3560000;0
31079;85395;558;0;0;0;0;.00nan;0;0
31079;157929;560;0;0;0;0;.00nan;0;0
31080;4379;560;70;39;3;36;.923;3900000;0
31080;57172;556;69;26;3;23;.885;3900000;0
31080;85349;556;0;0;0;0;.00nan;0;0
31080;157929;560;0;0;0;0;.00nan;0;0
31081;178911;552;76;30;3;27;.900;3600000;0
31081;216525;1423;0;0;0;0;.00nan;0;0
31081;196812;1423;59;38;4;34;.895;3574000;0
31081;77086;552;0;0;0;0;.00nan;0;0
31082;-1;553;82;36;2;34;.944;3713000;0
31082;75764;558;0;0;0;0;.00nan;0;0
31082;85395;558;71;33;3;30;.909;3713000;0
31082;85984;553;0;0;0;0;.00nan;0;0
31083;-1;555;64;40;4;36;.900;3898000;0
31083;-1;561;0;0;0;0;.00nan;0;0
31083;65324;561;70;30;3;27;.900;3898000;0
31083;68961;555;0;0;0;0;.00nan;0;0
31084;167061;2626;79;51;4;47;.922;3567000;0
31084;169615;554;51;11;2;9;.818;3600000;0
31084;28989;2626;0;0;0;0;.00nan;0;0
31084;85489;554;0;0;0;0;.00nan;0;0
31085;-1;555;0;0;0;0;.00nan;0;0
31085;-1;561;100;35;0;35;1.000;3600000;0
31085;65324;561;0;0;0;0;.00nan;0;0
31085;68961;555;86;31;1;30;.968;3555000;0
31086;4379;560;91;38;1;37;.974;3600000;0
31086;57172;556;0;0;0;0;.00nan;0;0
31086;85349;556;50;18;3;15;.833;3533000;0
31086;157929;560;0;0;0;0;.00nan;0;0
31087;-1;553;89;36;2;34;.944;3900000;0
31087;75764;558;0;0;0;0;.00nan;0;0
31087;85395;558;63;20;2;18;.900;3898000;0
31087;85984;553;0;0;0;0;.00nan;0;0
31088;178911;552;0;0;0;0;.00nan;0;0
31088;216525;1423;0;0;0;0;.00nan;0;0
31088;196812;1423;57;36;5;31;.861;3600000;0
31088;77086;552;100;21;0;21;1.000;3600000;0
31089;167061;2626;75;33;2;31;.939;3600000;0
31089;169615;554;52;33;5;28;.848;3600000;0
31089;28989;2626;0;0;0;0;.00nan;0;0
31089;85489;554;0;0;0;0;.00nan;0;0
31090;57172;556;78;35;3;32;.914;3600000;0
31090;75764;558;0;0;0;0;.00nan;0;0
31090;85349;556;0;0;0;0;.00nan;0;0
31090;85395;558;58;38;5;33;.868;3527000;0
31091;169615;554;75;31;2;29;.935;3600000;0
31091;75764;558;0;0;0;0;.00nan;0;0
31091;85395;558;57;39;4;35;.897;3572000;0
31091;85489;554;0;0;0;0;.00nan;0;0
31092;4379;560;36;16;4;12;.750;798000;0
31092;-1;553;73;22;2;20;.909;3600000;0
31092;-1;560;86;31;1;30;.968;2802000;0
31092;85984;553;0;0;0;0;.00nan;0;0
31093;196812;1423;67;30;3;27;.900;3600000;0
31093;-1;1423;0;0;0;0;.00nan;0;0
31093;57172;556;100;33;0;33;1.000;3600000;0
31093;85349;556;0;0;0;0;.00nan;0;0
31094;167061;2626;72;35;3;32;.914;3600000;0
31094;28989;2626;0;0;0;0;.00nan;0;0
31094;-1;561;38;29;5;24;.828;3542000;0
31094;65324;561;0;0;0;0;.00nan;0;0
31095;178911;552;0;0;0;0;.00nan;0;0
31095;-1;555;5;22;7;15;.682;1458000;0
31095;68961;555;64;26;2;24;.923;2142000;0
31095;77086;552;48;21;3;18;.857;3600000;0
31096;169615;554;0;0;0;0;.00nan;0;0
31096;75764;558;30;9;3;6;.667;1014000;0
31096;85395;558;48;39;6;33;.846;2586000;0
31096;85489;554;100;40;1;39;.975;3600000;0
31097;4379;560;39;22;4;18;.818;3545000;0
31097;-1;561;0;0;0;0;.00nan;0;0
31097;-1;560;0;0;0;0;.00nan;0;0
31097;65324;561;68;27;2;25;.926;3600000;0
31098;167061;2626;49;34;5;29;.853;3512000;0
31098;28989;2626;0;0;0;0;.00nan;0;0
31098;196812;1423;44;17;3;14;.824;3600000;0
31098;-1;1423;0;0;0;0;.00nan;0;0
31099;178911;552;76;32;2;30;.938;3624000;0
31099;-1;553;66;26;3;23;.885;3624000;0
31099;77086;552;0;0;0;0;.00nan;0;0
31099;85984;553;0;0;0;0;.00nan;0;0
31100;-1;555;71;47;5;42;.894;3600000;0
31100;57172;556;75;24;1;23;.958;3600000;0
31100;68961;555;0;0;0;0;.00nan;0;0
31100;85349;556;0;0;0;0;.00nan;0;0
31101;4379;560;72;43;4;39;.907;3600000;0
31101;178911;552;47;18;3;15;.833;3600000;0
31101;-1;560;0;0;0;0;.00nan;0;0
31101;77086;552;0;0;0;0;.00nan;0;0
31102;4379;560;52;31;4;27;.871;3600000;0
31102;178911;552;0;0;0;0;.00nan;0;0
31102;-1;560;0;0;0;0;.00nan;0;0
31102;77086;552;86;29;1;28;.966;3600000;0
31103;57172;556;70;29;3;26;.897;3558000;0
31103;75764;558;0;0;0;0;.00nan;0;0
31103;85349;556;0;0;0;0;.00nan;0;0
31103;85395;558;62;24;2;22;.917;3600000;0
31104;-1;553;76;18;1;17;.944;3600000;0
31104;-1;555;71;38;4;34;.895;3600000;0
31104;68961;555;0;0;0;0;.00nan;0;0
31104;85984;553;0;0;0;0;.00nan;0;0
31105;167061;2626;53;31;4;27;.871;3600000;0
31105;169615;554;41;25;5;20;.800;3600000;0
31105;28989;2626;0;0;0;0;.00nan;0;0
31105;85489;554;0;0;0;0;.00nan;0;0
31106;196812;1423;37;20;4;16;.800;1988000;0
31106;-1;553;64;15;1;14;.933;3600000;0
31106;-1;1423;79;18;0;18;1.000;1612000;0
31106;85984;553;0;0;0;0;.00nan;0;0
31107;167061;2626;73;21;1;20;.952;3600000;0
31107;28989;2626;0;0;0;0;.00nan;0;0
31107;-1;555;0;0;0;0;.00nan;0;0
31107;68961;555;89;54;3;51;.944;3514000;0
31108;169615;554;0;0;0;0;.00nan;0;0
31108;57172;556;38;26;5;21;.808;3600000;0
31108;85349;556;0;0;0;0;.00nan;0;0
31108;85489;554;80;30;2;28;.933;3600000;0
31109;-1;561;0;0;0;0;.00nan;0;0
31109;57172;556;50;22;3;19;.864;3544000;0
31109;65324;561;90;42;2;40;.952;3600000;0
31109;85349;556;0;0;0;0;.00nan;0;0
31110;169615;554;50;30;4;26;.867;3600000;0
31110;-1;553;36;36;6;30;.833;3534000;0
31110;85489;554;0;0;0;0;.00nan;0;0
31110;85984;553;0;0;0;0;.00nan;0;0
31111;-1;555;65;35;4;31;.886;3600000;0
31111;68961;555;0;0;0;0;.00nan;0;0
31111;75764;558;0;0;0;0;.00nan;0;0
31111;85395;558;75;23;1;22;.957;3600000;0
31112;167061;2626;62;45;5;40;.889;3542000;0
31112;28989;2626;0;0;0;0;.00nan;0;0
31112;196812;1423;45;17;3;14;.824;3600000;0
31112;-1;1423;0;0;0;0;.00nan;0;0
31113;4379;560;64;40;4;36;.900;3600000;0
31113;178911;552;56;24;3;21;.875;3600000;0
31113;-1;560;0;0;0;0;.00nan;0;0
31113;77086;552;0;0;0;0;.00nan;0;0
31114;4379;560;71;24;2;22;.917;3600000;0
31114;196812;1423;0;0;0;0;.00nan;0;0
31114;-1;560;0;0;0;0;.00nan;0;0
31114;-1;1423;51;39;5;34;.872;3600000;0
31115;178911;552;0;0;0;0;.00nan;0;0
31115;57172;556;0;0;0;0;.00nan;0;0
31115;77086;552;92;43;2;41;.953;3600000;0
31115;85349;556;96;33;3;30;.909;3600000;0
31116;-1;555;52;9;1;8;.889;617000;0
31116;-1;561;54;23;3;20;.870;3600000;0
31116;65324;561;0;0;0;0;.00nan;0;0
31116;68961;555;34;30;6;24;.800;2983000;0
31117;167061;2626;96;23;0;23;1.000;3600000;0
31117;28989;2626;0;0;0;0;.00nan;0;0
31117;75764;558;0;0;0;0;.00nan;0;0
31117;85395;558;74;28;2;26;.929;3583000;0
31118;169615;554;0;0;0;0;.00nan;0;0
31118;-1;553;88;33;1;32;.970;3600000;0
31118;85489;554;58;28;3;25;.893;3516000;0
31118;85984;553;0;0;0;0;.00nan;0;0
31119;4379;560;0;0;0;0;.00nan;0;0
31119;196812;1423;100;42;0;42;1.000;3900000;0
31119;-1;560;89;28;0;28;1.000;3900000;0
31119;-1;1423;0;0;0;0;.00nan;0;0
31120;-1;555;44;43;6;37;.860;3600000;0
31120;-1;561;0;0;0;0;.00nan;0;0
31120;65324;561;65;20;1;19;.950;3600000;0
31120;68961;555;0;0;0;0;.00nan;0;0
31121;-1;553;30;28;6;22;.786;3600000;0
31121;57172;556;71;22;2;20;.909;3600000;0
31121;85349;556;0;0;0;0;.00nan;0;0
31121;85984;553;0;0;0;0;.00nan;0;0
31122;167061;2626;51;38;5;33;.868;3600000;0
31122;28989;2626;0;0;0;0;.00nan;0;0
31122;75764;558;0;0;0;0;.00nan;0;0
31122;85395;558;52;14;2;12;.857;3600000;0
31123;169615;554;97;35;1;34;.971;3600000;0
31123;178911;552;60;28;3;25;.893;3574000;0
31123;77086;552;0;0;0;0;.00nan;0;0
31123;85489;554;0;0;0;0;.00nan;0;0
31124;196812;1423;59;28;3;25;.893;3596000;0
31124;-1;1423;0;0;0;0;.00nan;0;0
31124;75764;558;0;0;0;0;.00nan;0;0
31124;85395;558;61;16;2;14;.875;3600000;0
31125;-1;553;48;26;4;22;.846;3830000;0
31125;-1;561;71;37;3;34;.919;3830000;0
31125;65324;561;0;0;0;0;.00nan;0;0
31125;85984;553;0;0;0;0;.00nan;0;0
31126;4379;560;0;0;0;0;.00nan;0;0
31126;-1;555;0;0;0;0;.00nan;0;0
31126;-1;560;100;30;0;30;1.000;3600000;0
31126;68961;555;80;30;1;29;.967;3600000;0
31127;167061;2626;0;0;0;0;.00nan;0;0
31127;178911;552;0;0;0;0;.00nan;0;0
31127;28989;2626;77;36;3;33;.917;3520000;0
31127;77086;552;81;26;1;25;.962;3600000;0
31128;169615;554;0;0;0;0;.00nan;0;0
31128;57172;556;97;42;2;40;.952;3778000;0
31128;85349;556;0;0;0;0;.00nan;0;0
31128;85489;554;68;34;3;31;.912;3778000;0
31129;169615;554;68;36;3;33;.917;3565000;0
31129;75764;558;81;32;2;30;.938;3600000;0
31129;85395;558;0;0;0;0;.00nan;0;0
31129;85489;554;0;0;0;0;.00nan;0;0
31130;4379;560;0;0;0;0;.00nan;0;0
31130;-1;561;0;0;0;0;.00nan;0;0
31130;-1;560;86;27;1;26;.963;3600000;0
31130;65324;561;83;43;2;41;.953;3559000;0
31131;-1;555;75;46;3;43;.935;3568000;0
31131;57172;556;46;11;2;9;.818;3600000;0
31131;68961;555;0;0;0;0;.00nan;0;0
31131;85349;556;0;0;0;0;.00nan;0;0
31132;167061;2626;82;54;5;49;.907;3600000;0
31132;28989;2626;0;0;0;0;.00nan;0;0
31132;-1;553;63;17;1;16;.941;3600000;0
31132;85984;553;0;0;0;0;.00nan;0;0
31133;178911;552;0;0;0;0;.00nan;0;0
31133;196812;1423;51;32;5;27;.844;3600000;0
31133;-1;1423;0;0;0;0;.00nan;0;0
31133;77086;552;33;28;6;22;.786;3546000;0
31134;169615;554;61;26;2;24;.923;2937000;0
31134;75764;558;0;0;0;0;.00nan;0;0
31134;85395;558;97;43;2;41;.953;3600000;0
31134;85489;554;29;15;4;11;.733;663000;0
31135;4379;560;55;30;3;27;.900;3568000;0
31135;-1;561;66;23;2;21;.913;3600000;0
31135;-1;560;0;0;0;0;.00nan;0;0
31135;65324;561;0;0;0;0;.00nan;0;0
31136;178911;552;64;38;4;34;.895;3600000;0
31136;196812;1423;99;35;1;34;.971;3600000;0
31136;-1;1423;0;0;0;0;.00nan;0;0
31136;77086;552;0;0;0;0;.00nan;0;0
31137;167061;2626;0;0;0;0;.00nan;0;0
31137;28989;2626;63;35;4;31;.886;3596000;0
31137;-1;553;0;0;0;0;.00nan;0;0
31137;85984;553;52;22;3;19;.864;3600000;0
31138;196812;1423;95;42;2;40;.952;3565000;0
31138;-1;561;0;0;0;0;.00nan;0;0
31138;-1;1423;0;0;0;0;.00nan;0;0
31138;65324;561;100;30;0;30;1.000;3600000;0
31139;178911;552;0;0;0;0;.00nan;0;0
31139;-1;553;88;38;2;36;.947;3900000;0
31139;77086;552;76;23;2;21;.913;3900000;0
31139;85984;553;0;0;0;0;.00nan;0;0
31140;4379;560;63;33;3;30;.909;3600000;0
31140;-1;560;0;0;0;0;.00nan;0;0
31140;75764;558;0;0;0;0;.00nan;0;0
31140;85395;558;97;26;0;26;1.000;3600000;0
31141;-1;555;67;29;2;27;.931;3589000;0
31141;57172;556;74;22;1;21;.955;3600000;0
31141;68961;555;0;0;0;0;.00nan;0;0
31141;85349;556;0;0;0;0;.00nan;0;0
31142;167061;2626;31;17;4;13;.765;661000;0
31142;169615;554;69;21;1;20;.952;3600000;0
31142;28989;2626;95;26;0;26;1.000;2939000;0
31142;85489;554;0;0;0;0;.00nan;0;0
31143;169615;554;43;18;3;15;.833;3600000;0
31143;196812;1423;67;49;5;44;.898;3593000;0
31143;-1;1423;0;0;0;0;.00nan;0;0
31143;85489;554;0;0;0;0;.00nan;0;0
31144;4379;560;0;0;0;0;.00nan;0;0
31144;-1;560;93;34;1;33;.971;3900000;0
31144;57172;556;0;0;0;0;.00nan;0;0
31144;85349;556;83;30;1;29;.967;3900000;0
31145;-1;553;29;24;6;18;.750;3900000;0
31145;-1;555;0;0;0;0;.00nan;0;0
31145;68961;555;82;68;6;62;.912;3886000;0
31145;85984;553;0;0;0;0;.00nan;0;0
31146;167061;2626;75;38;3;35;.921;3600000;0
31146;28989;2626;0;0;0;0;.00nan;0;0
31146;-1;561;0;0;0;0;.00nan;0;0
31146;65324;561;40;27;5;22;.815;3538000;0
31147;178911;552;100;26;0;26;1.000;3600000;0
31147;75764;558;0;0;0;0;.00nan;0;0
31147;77086;552;0;0;0;0;.00nan;0;0
31147;85395;558;50;37;5;32;.865;3600000;0
31148;-1;553;77;28;2;26;.929;3591000;0
31148;-1;561;84;30;1;29;.967;3600000;0
31148;65324;561;0;0;0;0;.00nan;0;0
31148;85984;553;0;0;0;0;.00nan;0;0
31149;196812;1423;70;35;4;31;.886;3600000;0
31149;-1;1423;0;0;0;0;.00nan;0;0
31149;75764;558;0;0;0;0;.00nan;0;0
31149;85395;558;52;39;6;33;.846;3541000;0
31150;178911;552;62;31;3;28;.903;3520000;0
31150;57172;556;81;33;2;31;.939;3600000;0
31150;77086;552;0;0;0;0;.00nan;0;0
31150;85349;556;0;0;0;0;.00nan;0;0
31151;169615;554;85;24;1;23;.958;3600000;0
31151;-1;555;75;54;4;50;.926;3600000;0
31151;68961;555;0;0;0;0;.00nan;0;0
31151;85489;554;0;0;0;0;.00nan;0;0
31152;196812;1423;74;28;2;26;.929;3900000;0
31152;-1;1423;0;0;0;0;.00nan;0;0
31152;75764;558;0;0;0;0;.00nan;0;0
31152;85395;558;64;24;2;22;.917;3900000;0
31153;196812;1423;91;17;0;17;1.000;3600000;0
31153;-1;555;54;37;5;32;.865;3600000;0
31153;-1;1423;0;0;0;0;.00nan;0;0
31153;68961;555;0;0;0;0;.00nan;0;0
31154;-1;553;91;36;2;34;.944;3600000;0
31154;-1;561;0;0;0;0;.00nan;0;0
31154;65324;561;55;32;6;26;.813;3600000;0
31154;85984;553;0;0;0;0;.00nan;0;0
31155;167061;2626;100;48;0;48;1.000;3600000;0
31155;28989;2626;0;0;0;0;.00nan;0;0
31155;57172;556;58;20;2;18;.900;3514000;0
31155;85349;556;0;0;0;0;.00nan;0;0
31156;169615;554;0;0;0;0;.00nan;0;0
31156;178911;552;89;35;1;34;.971;3600000;0
31156;77086;552;0;0;0;0;.00nan;0;0
31156;85489;554;49;42;6;36;.857;3600000;0
31157;4379;560;66;30;3;27;.900;3518000;0
31157;167061;2626;92;26;1;25;.962;3600000;0
31157;28989;2626;0;0;0;0;.00nan;0;0
31157;-1;560;0;0;0;0;.00nan;0;0
31158;-1;561;52;36;6;30;.833;2478000;0
31158;57172;556;84;16;0;16;1.000;3600000;0
31158;65324;561;55;13;1;12;.923;1122000;0
31158;85349;556;0;0;0;0;.00nan;0;0
31159;169615;554;91;16;0;16;1.000;3600000;0
31159;-1;555;0;0;0;0;.00nan;0;0
31159;68961;555;56;38;5;33;.868;3600000;0
31159;85489;554;0;0;0;0;.00nan;0;0
31160;178911;552;0;0;0;0;.00nan;0;0
31160;-1;553;0;0;0;0;.00nan;0;0
31160;77086;552;75;20;1;19;.950;3600000;0
31160;85984;553;62;37;4;33;.892;3600000;0
31161;167061;2626;35;42;7;35;.833;3188000;0
31161;28989;2626;44;5;1;4;.800;412000;0
31161;-1;553;86;29;1;28;.966;3600000;0
31161;85984;553;0;0;0;0;.00nan;0;0
31162;4379;560;67;37;3;34;.919;3584000;0
31162;-1;553;96;34;1;33;.971;3600000;0
31162;-1;560;0;0;0;0;.00nan;0;0
31162;85984;553;0;0;0;0;.00nan;0;0
31163;169615;554;43;23;4;19;.826;3600000;0
31163;-1;561;0;0;0;0;.00nan;0;0
31163;65324;561;70;46;5;41;.891;3575000;0
31163;85489;554;0;0;0;0;.00nan;0;0
31164;196812;1423;90;41;2;39;.951;3558000;0
31164;-1;1423;0;0;0;0;.00nan;0;0
31164;57172;556;73;22;1;21;.955;3600000;0
31164;85349;556;0;0;0;0;.00nan;0;0
31165;178911;552;100;33;1;32;.970;3600000;0
31165;75764;558;0;0;0;0;.00nan;0;0
31165;77086;552;0;0;0;0;.00nan;0;0
31165;85395;558;77;31;2;29;.935;3567000;0
31166;167061;2626;0;0;0;0;.00nan;0;0
31166;28989;2626;46;11;2;9;.818;3556000;0
31166;-1;555;97;38;1;37;.974;3600000;0
31166;68961;555;0;0;0;0;.00nan;0;0
31167;57172;556;56;22;3;19;.864;3600000;0
31167;75764;558;0;0;0;0;.00nan;0;0
31167;85349;556;0;0;0;0;.00nan;0;0
31167;85395;558;60;48;6;42;.875;3600000;0
31168;-1;555;61;29;3;26;.897;2840000;0
31168;-1;561;33;19;4;15;.789;3600000;0
31168;65324;561;0;0;0;0;.00nan;0;0
31168;68961;555;29;14;4;10;.714;760000;0
31169;4379;560;0;0;0;0;.00nan;0;0
31169;178911;552;0;0;0;0;.00nan;0;0
31169;-1;560;88;38;1;37;.974;3900000;0
31169;77086;552;95;29;1;28;.966;3900000;0
31170;169615;554;0;0;0;0;.00nan;0;0
31170;196812;1423;61;34;4;30;.882;3566000;0
31170;-1;1423;0;0;0;0;.00nan;0;0
31170;85489;554;72;31;3;28;.903;3600000;0
31171;4379;560;57;31;4;27;.871;3600000;0
31171;196812;1423;8;25;7;18;.720;3038000;0
31171;-1;560;0;0;0;0;.00nan;0;0
31171;-1;1423;33;12;3;9;.750;562000;0
31172;-1;555;19;24;6;18;.750;2336000;0
31172;-1;561;0;0;0;0;.00nan;0;0
31172;65324;561;58;16;2;14;.875;3600000;0
31172;68961;555;26;18;4;14;.778;1264000;0
31173;-1;553;67;25;2;23;.920;3514000;0
31173;75764;558;0;0;0;0;.00nan;0;0
31173;85395;558;100;28;0;28;1.000;3600000;0
31173;85984;553;0;0;0;0;.00nan;0;0
31174;167061;2626;70;27;2;25;.926;3573000;0
31174;28989;2626;0;0;0;0;.00nan;0;0
31174;57172;556;89;32;1;31;.969;3600000;0
31174;85349;556;0;0;0;0;.00nan;0;0
31175;4379;560;0;0;0;0;.00nan;0;0
31175;196812;1423;51;24;3;21;.875;3545000;0
31175;-1;560;78;19;1;18;.947;3600000;0
31175;-1;1423;0;0;0;0;.00nan;0;0
31176;-1;553;0;0;0;0;.00nan;0;0
31176;75764;558;0;0;0;0;.00nan;0;0
31176;85395;558;75;40;4;36;.900;3600000;0
31176;85984;553;48;39;5;34;.872;3542000;0
31177;178911;552;64;12;1;11;.917;3600000;0
31177;-1;561;52;31;4;27;.871;3600000;0
31177;65324;561;0;0;0;0;.00nan;0;0
31177;77086;552;0;0;0;0;.00nan;0;0
31178;167061;2626;35;25;5;20;.800;2309000;0
31178;169615;554;60;25;3;22;.880;3600000;0
31178;28989;2626;64;8;0;8;1.000;1243000;0
31178;85489;554;0;0;0;0;.00nan;0;0
31179;169615;554;0;0;0;0;.00nan;0;0
31179;57172;556;0;0;0;0;.00nan;0;0
31179;85349;556;79;31;2;29;.935;3600000;0
31179;85489;554;57;24;3;21;.875;3556000;0
31180;178911;552;0;0;0;0;.00nan;0;0
31180;-1;555;79;43;4;39;.907;3569000;0
31180;68961;555;0;0;0;0;.00nan;0;0
31180;77086;552;58;22;2;20;.909;3600000;0
31181;196812;1423;70;35;3;32;.914;3900000;0
31181;-1;561;0;0;0;0;.00nan;0;0
31181;-1;1423;0;0;0;0;.00nan;0;0
31181;65324;561;82;35;3;32;.914;3900000;0
31182;178911;552;49;12;2;10;.833;3600000;0
31182;-1;555;83;44;3;41;.932;3600000;0
31182;68961;555;0;0;0;0;.00nan;0;0
31182;77086;552;0;0;0;0;.00nan;0;0
31183;178911;552;59;19;2;17;.895;3900000;0
31183;-1;561;0;0;0;0;.00nan;0;0
31183;65324;561;83;44;2;42;.955;3900000;0
31183;77086;552;0;0;0;0;.00nan;0;0
31184;196812;1423;75;28;1;27;.964;3557000;0
31184;-1;553;100;23;0;23;1.000;3600000;0
31184;-1;1423;0;0;0;0;.00nan;0;0
31184;85984;553;0;0;0;0;.00nan;0;0
31185;167061;2626;72;26;2;24;.923;3600000;0
31185;28989;2626;0;0;0;0;.00nan;0;0
31185;75764;558;0;0;0;0;.00nan;0;0
31185;85395;558;55;24;3;21;.875;3544000;0
31186;4379;560;61;34;4;30;.882;3600000;0
31186;169615;554;93;38;1;37;.974;3600000;0
31186;-1;560;0;0;0;0;.00nan;0;0
31186;85489;554;0;0;0;0;.00nan;0;0
31187;196812;1423;47;36;5;31;.861;3600000;0
31187;-1;1423;0;0;0;0;.00nan;0;0
31187;57172;556;91;33;2;31;.939;3600000;0
31187;85349;556;0;0;0;0;.00nan;0;0
31188;-1;561;52;38;5;33;.868;3600000;0
31188;65324;561;0;0;0;0;.00nan;0;0
31188;75764;558;85;30;2;28;.933;3600000;0
31188;85395;558;0;0;0;0;.00nan;0;0
31189;167061;2626;0;0;0;0;.00nan;0;0
31189;28989;2626;54;23;3;20;.870;3600000;0
31189;-1;555;58;40;4;36;.900;3584000;0
31189;68961;555;0;0;0;0;.00nan;0;0
31190;4379;560;0;0;0;0;.00nan;0;0
31190;169615;554;0;0;0;0;.00nan;0;0
31190;-1;560;94;36;1;35;.972;3900000;0
31190;85489;554;87;28;1;27;.964;3900000;0
31191;178911;552;0;0;0;0;.00nan;0;0
31191;-1;553;64;27;3;24;.889;3600000;0
31191;77086;552;52;28;4;24;.857;3551000;0
31191;85984;553;0;0;0;0;.00nan;0;0
31192;4379;560;57;17;3;14;.824;3600000;0
31192;-1;555;61;29;4;25;.862;3593000;0
31192;-1;560;0;0;0;0;.00nan;0;0
31192;68961;555;0;0;0;0;.00nan;0;0
31193;-1;553;78;30;2;28;.933;3600000;0
31193;57172;556;55;31;3;28;.903;3543000;0
31193;85349;556;0;0;0;0;.00nan;0;0
31193;85984;553;0;0;0;0;.00nan;0;0
31194;167061;2626;92;34;1;33;.971;3557000;0
31194;28989;2626;0;0;0;0;.00nan;0;0
31194;196812;1423;100;29;0;29;1.000;3600000;0
31194;-1;1423;0;0;0;0;.00nan;0;0
31195;4379;560;0;0;0;0;.00nan;0;0
31195;-1;555;0;0;0;0;.00nan;0;0
31195;-1;560;72;24;1;23;.958;3600000;0
31195;68961;555;71;41;5;36;.878;3600000;0
31196;-1;553;0;0;0;0;.00nan;0;0
31196;-1;561;0;0;0;0;.00nan;0;0
31196;65324;561;94;42;1;41;.976;3600000;0
31196;85984;553;53;23;3;20;.870;3564000;0
31197;167061;2626;0;0;0;0;.00nan;0;0
31197;28989;2626;75;30;2;28;.933;3563000;0
31197;75764;558;0;0;0;0;.00nan;0;0
31197;85395;558;84;21;1;20;.952;3600000;0
31198;169615;554;86;41;3;38;.927;3600000;0
31198;178911;552;100;30;0;30;1.000;3600000;0
31198;77086;552;0;0;0;0;.00nan;0;0
31198;85489;554;0;0;0;0;.00nan;0;0
31199;-1;561;73;36;4;32;.889;3582000;0
31199;65324;561;0;0;0;0;.00nan;0;0
31199;75764;558;0;0;0;0;.00nan;0;0
31199;85395;558;82;29;2;27;.931;3600000;0
31200;169615;554;0;0;0;0;.00nan;0;0
31200;196812;1423;100;36;1;35;.972;3600000;0
31200;-1;1423;0;0;0;0;.00nan;0;0
31200;85489;554;69;24;2;22;.917;3559000;0
31201;169615;554;65;32;4;28;.875;3577000;0
31201;-1;561;0;0;0;0;.00nan;0;0
31201;65324;561;65;33;3;30;.909;3600000;0
31201;85489;554;0;0;0;0;.00nan;0;0
31202;-1;555;66;51;6;45;.882;3600000;0
31202;57172;556;49;8;1;7;.875;3600000;0
31202;68961;555;0;0;0;0;.00nan;0;0
31202;85349;556;0;0;0;0;.00nan;0;0
31203;57172;556;73;33;3;30;.909;3600000;0
31203;75764;558;0;0;0;0;.00nan;0;0
31203;85349;556;0;0;0;0;.00nan;0;0
31203;85395;558;54;29;4;25;.862;3587000;0
31204;4379;560;100;32;0;32;1.000;3600000;0
31204;-1;560;0;0;0;0;.00nan;0;0
31204;57172;556;0;0;0;0;.00nan;0;0
31204;85349;556;54;27;3;24;.889;3600000;0
31205;-1;555;39;37;6;31;.838;2670000;0
31205;68961;555;68;14;0;14;1.000;930000;0
31205;75764;558;0;0;0;0;.00nan;0;0
31205;85395;558;44;22;4;18;.818;3600000;0
31206;167061;2626;72;37;4;33;.892;3600000;0
31206;28989;2626;0;0;0;0;.00nan;0;0
31206;196812;1423;68;20;1;19;.950;3600000;0
31206;-1;1423;0;0;0;0;.00nan;0;0
31207;169615;554;42;22;4;18;.818;1749000;0
31207;178911;552;83;26;1;25;.962;3600000;0
31207;77086;552;0;0;0;0;.00nan;0;0
31207;85489;554;79;20;0;20;1.000;1851000;0
31208;178911;552;0;0;0;0;.00nan;0;0
31208;-1;561;0;0;0;0;.00nan;0;0
31208;65324;561;63;35;4;31;.886;3600000;0
31208;77086;552;60;44;6;38;.864;3534000;0
31209;167061;2626;0;0;0;0;.00nan;0;0
31209;28989;2626;59;29;3;26;.897;3647000;0
31209;196812;1423;0;0;0;0;.00nan;0;0
31209;-1;1423;68;31;2;29;.935;3647000;0
31210;4379;560;90;35;2;33;.943;3900000;0
31210;-1;553;75;25;2;23;.920;3900000;0
31210;-1;560;0;0;0;0;.00nan;0;0
31210;85984;553;0;0;0;0;.00nan;0;0
31211;169615;554;58;8;1;7;.875;3600000;0
31211;-1;555;55;11;1;10;.909;674000;0
31211;68961;555;43;40;6;34;.850;2926000;0
31211;85489;554;0;0;0;0;.00nan;0;0
31212;57172;556;60;35;4;31;.886;3528000;0
31212;75764;558;0;0;0;0;.00nan;0;0
31212;85349;556;0;0;0;0;.00nan;0;0
31212;85395;558;80;32;2;30;.938;3600000;0
31213;4379;560;71;28;2;26;.929;3600000;0
31213;-1;560;0;0;0;0;.00nan;0;0
31213;75764;558;0;0;0;0;.00nan;0;0
31213;85395;558;49;26;4;22;.846;3600000;0
31214;167061;2626;64;43;5;38;.884;3600000;0
31214;28989;2626;0;0;0;0;.00nan;0;0
31214;57172;556;0;0;0;0;.00nan;0;0
31214;85349;556;58;17;2;15;.882;3600000;0
31215;-1;553;80;9;0;9;1.000;3600000;0
31215;-1;555;74;51;5;46;.902;3600000;0
31215;68961;555;0;0;0;0;.00nan;0;0
31215;85984;553;0;0;0;0;.00nan;0;0
31216;178911;552;58;21;3;18;.857;3600000;0
31216;196812;1423;33;40;7;33;.825;3600000;0
31216;-1;1423;0;0;0;0;.00nan;0;0
31216;77086;552;0;0;0;0;.00nan;0;0
31217;169615;554;73;32;3;29;.906;3850000;0
31217;-1;561;0;0;0;0;.00nan;0;0
31217;65324;561;47;27;4;23;.852;3850000;0
31217;85489;554;0;0;0;0;.00nan;0;0
31218;4379;560;0;0;0;0;.00nan;0;0
31218;-1;561;55;32;4;28;.875;3600000;0
31218;-1;560;100;32;0;32;1.000;3600000;0
31218;65324;561;0;0;0;0;.00nan;0;0
31219;196812;1423;36;21;4;17;.810;3566000;0
31219;-1;555;0;0;0;0;.00nan;0;0
31219;-1;1423;0;0;0;0;.00nan;0;0
31219;68961;555;75;43;3;40;.930;3600000;0
31220;167061;2626;47;5;1;4;.800;484000;0
31220;169615;554;0;0;0;0;.00nan;0;0
31220;28989;2626;50;41;6;35;.854;3116000;0
31220;85489;554;74;28;2;26;.929;3600000;0
31221;178911;552;0;0;0;0;.00nan;0;0
31221;75764;558;0;0;0;0;.00nan;0;0
31221;77086;552;53;20;3;17;.850;3900000;0
31221;85395;558;68;35;3;32;.914;3900000;0
31222;167061;2626;36;34;6;28;.824;3178000;0
31222;28989;2626;48;0;0;0;.00nan;422000;0
31222;-1;561;0;0;0;0;.00nan;0;0
31222;65324;561;76;25;2;23;.920;3600000;0
31223;4379;560;0;0;0;0;.00nan;0;0
31223;169615;554;95;17;0;17;1.000;3600000;0
31223;-1;560;71;29;2;27;.931;3549000;0
31223;85489;554;0;0;0;0;.00nan;0;0
31224;4379;560;31;17;4;13;.765;1103000;0
31224;169615;554;79;24;1;23;.958;3600000;0
31224;-1;560;50;25;3;22;.880;2497000;0
31224;85489;554;0;0;0;0;.00nan;0;0
31225;196812;1423;100;28;0;28;1.000;3600000;0
31225;-1;561;0;0;0;0;.00nan;0;0
31225;-1;1423;0;0;0;0;.00nan;0;0
31225;65324;561;60;23;2;21;.913;3537000;0
31226;-1;553;75;27;3;24;.889;3600000;0
31226;57172;556;95;51;2;49;.961;3600000;0
31226;85349;556;0;0;0;0;.00nan;0;0
31226;85984;553;0;0;0;0;.00nan;0;0
31227;-1;555;78;49;4;45;.918;3600000;0
31227;68961;555;0;0;0;0;.00nan;0;0
31227;75764;558;0;0;0;0;.00nan;0;0
31227;85395;558;84;15;0;15;1.000;3600000;0
31228;167061;2626;49;34;5;29;.853;3540000;0
31228;178911;552;68;31;3;28;.903;3600000;0
31228;28989;2626;0;0;0;0;.00nan;0;0
31228;77086;552;0;0;0;0;.00nan;0;0
31229;196812;1423;73;24;1;23;.958;3600000;0
31229;-1;555;0;0;0;0;.00nan;0;0
31229;-1;1423;0;0;0;0;.00nan;0;0
31229;68961;555;89;49;3;46;.939;3549000;0
31230;-1;553;0;0;0;0;.00nan;0;0
31230;57172;556;0;0;0;0;.00nan;0;0
31230;85349;556;79;26;1;25;.962;3600000;0
31230;85984;553;65;41;4;37;.902;3600000;0
31231;-1;561;0;0;0;0;.00nan;0;0
31231;65324;561;50;37;5;32;.865;3600000;0
31231;75764;558;0;0;0;0;.00nan;0;0
31231;85395;558;75;22;1;21;.955;3600000;0
31232;167061;2626;0;0;0;0;.00nan;0;0
31232;178911;552;0;0;0;0;.00nan;0;0
31232;28989;2626;100;50;2;48;.960;3600000;0
31232;77086;552;60;21;3;18;.857;3557000;0
31233;4379;560;68;35;4;31;.886;3547000;0
31233;167061;2626;74;37;3;34;.919;3600000;0
31233;28989;2626;0;0;0;0;.00nan;0;0
31233;-1;560;0;0;0;0;.00nan;0;0
31247;-1;553;0;0;0;0;.00nan;0;0
31247;75764;558;0;0;0;0;.00nan;0;0
31247;85395;558;62;30;3;27;.900;3600000;0
31247;85984;553;50;33;5;28;.848;3529000;0
31255;-1;555;45;42;6;36;.857;3040000;0
31255;57172;556;59;11;1;10;.909;3600000;0
31255;68961;555;39;7;2;5;.714;560000;0
31255;85349;556;0;0;0;0;.00nan;0;0
31257;167061;2626;72;43;4;39;.907;3600000;0
31257;178911;552;70;19;1;18;.947;3600000;0
31257;28989;2626;0;0;0;0;.00nan;0;0
31257;77086;552;0;0;0;0;.00nan;0;0
31259;196812;1423;57;31;4;27;.871;3600000;0
31259;-1;1423;0;0;0;0;.00nan;0;0
31259;75764;558;0;0;0;0;.00nan;0;0
31259;85395;558;63;22;2;20;.909;3600000;0
31261;4379;560;97;41;1;40;.976;3661000;0
31261;-1;553;0;0;0;0;.00nan;0;0
31261;-1;560;0;0;0;0;.00nan;0;0
31261;85984;553;69;23;2;21;.913;3661000;0
31263;169615;554;0;0;0;0;.00nan;0;0
31263;-1;561;0;0;0;0;.00nan;0;0
31263;65324;561;85;32;1;31;.969;3600000;0
31263;85489;554;55;25;3;22;.880;3514000;0
31265;4379;560;54;43;5;38;.884;3600000;0
31265;-1;560;0;0;0;0;.00nan;0;0
31265;57172;556;53;16;2;14;.875;3600000;0
31265;85349;556;0;0;0;0;.00nan;0;0
31273;169615;554;68;17;1;16;.941;3600000;0
31273;-1;555;44;11;2;9;.818;1011000;0
31273;68961;555;20;29;7;22;.759;2589000;0
31273;85489;554;0;0;0;0;.00nan;0;0
31291;178911;552;0;0;0;0;.00nan;0;0
31291;196812;1423;98;47;2;45;.957;3900000;0
31291;-1;1423;0;0;0;0;.00nan;0;0
31291;77086;552;56;22;2;20;.909;3900000;0
31295;178911;552;73;20;1;19;.950;3600000;0
31295;57172;556;0;0;0;0;.00nan;0;0
31295;77086;552;0;0;0;0;.00nan;0;0
31295;85349;556;63;33;3;30;.909;3590000;0
31297;-1;555;60;30;3;27;.900;3566000;0
31297;68961;555;0;0;0;0;.00nan;0;0
31297;75764;558;0;0;0;0;.00nan;0;0
31297;85395;558;77;24;1;23;.958;3600000;0
31299;169615;554;0;0;0;0;.00nan;0;0
31299;-1;553;79;42;3;39;.929;3600000;0
31299;85489;554;50;31;4;27;.871;3583000;0
31299;85984;553;0;0;0;0;.00nan;0;0
31301;167061;2626;80;25;2;23;.920;3600000;0
31301;28989;2626;0;0;0;0;.00nan;0;0
31301;196812;1423;68;29;3;26;.897;2936000;0
31301;-1;1423;26;11;4;7;.636;664000;0
31303;4379;560;29;31;6;25;.806;2280000;0
31303;-1;561;62;23;2;21;.913;3600000;0
31303;-1;560;76;17;0;17;1.000;1320000;0
31303;65324;561;0;0;0;0;.00nan;0;0
2098;178911;552;55;25;3;22;.880;3600000;0
2098;196812;1423;73;33;3;30;.909;3600000;0
2098;-1;1423;0;0;0;0;.00nan;0;0
2098;77086;552;0;0;0;0;.00nan;0;0
2099;4379;560;47;36;5;31;.861;3356000;0
2099;-1;553;97;21;0;21;1.000;3600000;0
2099;-1;560;53;3;0;3;1.000;244000;0
2099;85984;553;0;0;0;0;.00nan;0;0
2100;-1;561;0;0;0;0;.00nan;0;0
2100;57172;556;78;34;3;31;.912;3600000;0
2100;65324;561;35;36;7;29;.806;3600000;0
2100;85349;556;0;0;0;0;.00nan;0;0
2101;169615;554;50;25;4;21;.840;3600000;0
2101;75764;558;0;0;0;0;.00nan;0;0
2101;85395;558;79;42;4;38;.905;3600000;0
2101;85489;554;0;0;0;0;.00nan;0;0
2102;178911;552;53;11;2;9;.818;3600000;0
2102;196812;1423;76;41;4;37;.902;3600000;0
2102;-1;1423;0;0;0;0;.00nan;0;0
2102;77086;552;0;0;0;0;.00nan;0;0
2103;4379;560;79;37;2;35;.946;3600000;0
2103;-1;553;52;13;2;11;.846;3600000;0
2103;-1;560;0;0;0;0;.00nan;0;0
2103;85984;553;0;0;0;0;.00nan;0;0
2104;-1;561;50;11;2;9;.818;1214000;0
2104;57172;556;72;39;4;35;.897;3600000;0
2104;65324;561;48;33;5;28;.848;2386000;0
2104;85349;556;0;0;0;0;.00nan;0;0
2105;169615;554;81;25;2;23;.920;3900000;0
2105;75764;558;0;0;0;0;.00nan;0;0
2105;85395;558;73;26;2;24;.923;3900000;0
2105;85489;554;0;0;0;0;.00nan;0;0
2190;178911;552;96;39;1;38;.974;3900000;0
2190;75764;558;0;0;0;0;.00nan;0;0
2190;77086;552;0;0;0;0;.00nan;0;0
2190;85395;558;91;29;1;28;.966;3900000;0
2191;-1;553;90;20;1;19;.950;3600000;0
2191;57172;556;86;44;4;40;.909;3600000;0
2191;85349;556;0;0;0;0;.00nan;0;0
2191;85984;553;0;0;0;0;.00nan;0;0
2297;-1;553;85;51;4;47;.922;3551000;0
2297;75764;558;0;0;0;0;.00nan;0;0
2297;85395;558;57;22;3;19;.864;3600000;0
2297;85984;553;0;0;0;0;.00nan;0;0
2298;178911;552;78;28;2;26;.929;3900000;0
2298;57172;556;97;50;2;48;.960;3900000;0
2298;77086;552;0;0;0;0;.00nan;0;0
2298;85349;556;0;0;0;0;.00nan;0;0
31304;200390;1096;0;0;0;0;.00nan;0;0
31304;189628;74;0;0;0;0;.00nan;0;0
31304;176136;74;100;43;1;42;.977;3600000;0
31304;-1;1096;53;28;3;25;.893;3593000;0
31305;-1;152;0;0;0;0;.00nan;0;0
31305;173874;158;0;0;0;0;.00nan;0;0
31305;189944;152;64;28;3;25;.893;3600000;0
31305;-1;158;49;36;5;31;.861;3584000;0
31306;173961;73;0;0;0;0;.00nan;0;0
31306;-1;73;39;33;5;28;.848;3600000;0
31306;64722;72;0;0;0;0;.00nan;0;0
31306;91212;72;65;20;1;19;.950;3600000;0
31307;170351;149;33;23;5;18;.783;3519000;0
31307;189885;4921;0;0;0;0;.00nan;0;0
31307;197912;4921;75;33;3;30;.909;3600000;0
31307;85546;149;0;0;0;0;.00nan;0;0
31308;194531;4920;81;27;1;26;.963;3600000;0
31308;194899;4245;0;0;0;0;.00nan;0;0
31308;196445;4245;59;26;3;23;.885;3559000;0
31308;202246;4920;0;0;0;0;.00nan;0;0
31309;-1;76;46;33;5;28;.848;3561000;0
31309;184175;76;0;0;0;0;.00nan;0;0
31309;171615;75;0;0;0;0;.00nan;0;0
31309;174407;75;69;37;4;33;.892;3600000;0
31310;192895;85;0;0;0;0;.00nan;0;0
31310;-1;67;0;0;0;0;.00nan;0;0
31310;191698;67;58;32;3;29;.906;3515000;0
31310;148573;85;100;47;1;46;.979;3600000;0
31311;196525;151;31;29;6;23;.793;2393000;0
31311;192629;80;0;0;0;0;.00nan;0;0
31311;85228;80;92;31;1;30;.968;3600000;0
31311;85636;151;71;12;0;12;1.000;1207000;0
31312;4487;4922;33;27;5;22;.815;3900000;0
31312;-1;76;39;25;5;20;.800;3900000;0
31312;184175;76;0;0;0;0;.00nan;0;0
31312;86472;4922;0;0;0;0;.00nan;0;0
31313;183755;69;94;44;2;42;.955;3600000;0
31313;185800;71;0;0;0;0;.00nan;0;0
31313;58054;71;47;26;4;22;.846;3557000;0
31313;58100;69;0;0;0;0;.00nan;0;0
31314;173961;73;75;36;3;33;.917;3600000;0
31314;-1;73;0;0;0;0;.00nan;0;0
31314;64722;72;0;0;0;0;.00nan;0;0
31314;91212;72;27;23;5;18;.783;3539000;0
31315;171615;75;55;4;0;4;1.000;529000;0
31315;174407;75;45;34;6;28;.824;3071000;0
31315;179344;82;85;28;1;27;.964;3600000;0
31315;197047;82;0;0;0;0;.00nan;0;0
31316;-1;152;0;0;0;0;.00nan;0;0
31316;173874;158;90;38;2;36;.947;3600000;0
31316;189944;152;38;19;3;16;.842;3545000;0
31316;-1;158;0;0;0;0;.00nan;0;0
31317;170351;149;55;5;0;5;1.000;391000;0
31317;189885;4921;63;39;4;35;.897;3600000;0
31317;197912;4921;0;0;0;0;.00nan;0;0
31317;85546;149;18;23;6;17;.739;3176000;0
31318;200390;1096;0;0;0;0;.00nan;0;0
31318;180873;77;83;40;3;37;.925;3900000;0
31318;-1;1096;61;27;3;24;.889;3900000;0
31318;85555;77;0;0;0;0;.00nan;0;0
31319;178394;1095;34;35;6;29;.829;3600000;0
31319;-1;1095;0;0;0;0;.00nan;0;0
31319;-1;2564;68;26;2;24;.923;3600000;0
31319;176060;2564;0;0;0;0;.00nan;0;0
31320;196525;151;22;4;3;1;.250;239000;0
31320;192629;80;0;0;0;0;.00nan;0;0
31320;85228;80;69;22;2;20;.909;3600000;0
31320;85636;151;67;35;3;32;.914;3361000;0
31321;192895;85;0;0;0;0;.00nan;0;0
31321;-1;67;65;24;2;22;.917;3900000;0
31321;191698;67;0;0;0;0;.00nan;0;0
31321;148573;85;99;38;2;36;.947;3900000;0
31322;194531;4920;0;0;0;0;.00nan;0;0
31322;194899;4245;68;34;3;31;.912;3600000;0
31322;196445;4245;0;0;0;0;.00nan;0;0
31322;202246;4920;63;33;4;29;.879;3560000;0
31323;184049;1097;71;18;1;17;.944;3600000;0
31323;189628;74;58;35;4;31;.886;3083000;0
31323;176136;74;27;7;3;4;.571;517000;0
31323;-1;1097;0;0;0;0;.00nan;0;0
31324;200572;157;0;0;0;0;.00nan;0;0
31324;174386;81;0;0;0;0;.00nan;0;0
31324;186451;81;94;35;1;34;.971;3600000;0
31324;77084;157;48;23;3;20;.870;3552000;0
31325;183737;78;86;42;3;39;.929;3568000;0
31325;176770;78;0;0;0;0;.00nan;0;0
31325;196414;4620;66;17;1;16;.941;3600000;0
31325;181341;4620;0;0;0;0;.00nan;0;0
31326;194531;4920;46;29;4;25;.862;3556000;0
31326;194899;4245;66;25;2;23;.920;3600000;0
31326;196445;4245;0;0;0;0;.00nan;0;0
31326;202246;4920;0;0;0;0;.00nan;0;0
31327;200572;157;0;0;0;0;.00nan;0;0
31327;174386;81;0;0;0;0;.00nan;0;0
31327;186451;81;54;17;2;15;.882;3600000;0
31327;77084;157;74;28;3;25;.893;3583000;0
31328;-1;67;0;0;0;0;.00nan;0;0
31328;196414;4620;0;0;0;0;.00nan;0;0
31328;181341;4620;67;36;4;32;.889;3900000;0
31328;191698;67;81;41;4;37;.902;3900000;0
31329;196525;151;0;0;0;0;.00nan;0;0
31329;192629;80;0;0;0;0;.00nan;0;0
31329;85228;80;82;37;3;34;.919;3665000;0
31329;85636;151;69;37;4;33;.892;3665000;0
31330;-1;2564;0;0;0;0;.00nan;0;0
31330;176060;2564;63;50;6;44;.880;3600000;0
31330;64722;72;0;0;0;0;.00nan;0;0
31330;91212;72;81;27;1;26;.963;3600000;0
31331;171615;75;99;46;2;44;.957;3600000;0
31331;174407;75;0;0;0;0;.00nan;0;0
31331;196414;4620;0;0;0;0;.00nan;0;0
31331;181341;4620;30;26;5;21;.808;3600000;0
31332;184049;1097;74;42;5;37;.881;3773000;0
31332;194899;4245;35;24;4;20;.833;3773000;0
31332;196445;4245;0;0;0;0;.00nan;0;0
31332;-1;1097;0;0;0;0;.00nan;0;0
31333;178394;1095;75;34;2;32;.941;3580000;0
31333;173961;73;68;20;1;19;.950;3600000;0
31333;-1;1095;0;0;0;0;.00nan;0;0
31333;-1;73;0;0;0;0;.00nan;0;0
31334;-1;76;49;18;3;15;.833;3592000;0
31334;184175;76;0;0;0;0;.00nan;0;0
31334;179344;82;0;0;0;0;.00nan;0;0
31334;197047;82;92;34;2;32;.941;3600000;0
31335;-1;2564;0;0;0;0;.00nan;0;0
31335;176060;2564;76;33;3;30;.909;3545000;0
31335;185800;71;0;0;0;0;.00nan;0;0
31335;58054;71;92;39;2;37;.949;3600000;0
31336;192895;85;0;0;0;0;.00nan;0;0
31336;183737;78;75;36;2;34;.944;3549000;0
31336;176770;78;0;0;0;0;.00nan;0;0
31336;148573;85;100;35;1;34;.971;3600000;0
31337;171615;75;0;0;0;0;.00nan;0;0
31337;174407;75;64;42;6;36;.857;3600000;0
31337;196414;4620;0;0;0;0;.00nan;0;0
31337;181341;4620;50;17;3;14;.824;3600000;0
31338;170351;149;0;0;0;0;.00nan;0;0
31338;196525;151;75;36;3;33;.917;3600000;0
31338;85546;149;100;24;0;24;1.000;3600000;0
31338;85636;151;0;0;0;0;.00nan;0;0
31339;200572;157;0;0;0;0;.00nan;0;0
31339;173874;158;58;27;3;24;.889;3571000;0
31339;-1;158;0;0;0;0;.00nan;0;0
31339;77084;157;89;35;2;33;.943;3600000;0
31340;183755;69;46;30;5;25;.833;3600000;0
31340;192629;80;0;0;0;0;.00nan;0;0
31340;58100;69;0;0;0;0;.00nan;0;0
31340;85228;80;40;39;6;33;.846;3576000;0
31341;192895;85;75;27;2;25;.926;3600000;0
31341;183737;78;0;0;0;0;.00nan;0;0
31341;176770;78;76;34;4;30;.882;3558000;0
31341;148573;85;0;0;0;0;.00nan;0;0
31342;4487;4922;49;30;4;26;.867;3514000;0
31342;-1;152;79;34;2;32;.941;3600000;0
31342;189944;152;0;0;0;0;.00nan;0;0
31342;86472;4922;0;0;0;0;.00nan;0;0
31343;200390;1096;58;13;2;11;.846;3600000;0
31343;180873;77;76;43;5;38;.884;3600000;0
31343;-1;1096;0;0;0;0;.00nan;0;0
31343;85555;77;0;0;0;0;.00nan;0;0
31344;173961;73;100;35;0;35;1.000;3600000;0
31344;185800;71;86;30;1;29;.967;3555000;0
31344;-1;73;0;0;0;0;.00nan;0;0
31344;58054;71;0;0;0;0;.00nan;0;0
31345;-1;2564;0;0;0;0;.00nan;0;0
31345;176060;2564;66;28;2;26;.929;3600000;0
31345;64722;72;0;0;0;0;.00nan;0;0
31345;91212;72;99;40;1;39;.975;3600000;0
31346;184049;1097;26;15;4;11;.733;937000;0
31346;194899;4245;0;0;0;0;.00nan;0;0
31346;196445;4245;48;19;3;16;.842;3600000;0
31346;-1;1097;69;28;2;26;.929;2663000;0
31347;170351;149;0;0;0;0;.00nan;0;0
31347;196525;151;96;48;3;45;.938;3600000;0
31347;85546;149;41;20;4;16;.800;3600000;0
31347;85636;151;0;0;0;0;.00nan;0;0
31348;194531;4920;42;27;5;22;.815;3580000;0
31348;-1;67;0;0;0;0;.00nan;0;0
31348;202246;4920;0;0;0;0;.00nan;0;0
31348;191698;67;52;32;4;28;.875;3600000;0
31349;183755;69;56;25;3;22;.880;2413000;0
31349;174386;81;75;27;2;25;.926;3600000;0
31349;186451;81;0;0;0;0;.00nan;0;0
31349;58100;69;42;26;4;22;.846;1187000;0
31350;200572;157;35;12;3;9;.750;3600000;0
31350;173874;158;93;37;2;35;.946;3600000;0
31350;-1;158;0;0;0;0;.00nan;0;0
31350;77084;157;0;0;0;0;.00nan;0;0
31351;189885;4921;59;20;2;18;.900;3546000;0
31351;192629;80;92;27;1;26;.963;3600000;0
31351;197912;4921;0;0;0;0;.00nan;0;0
31351;85228;80;0;0;0;0;.00nan;0;0
31352;4487;4922;69;42;5;37;.881;3600000;0
31352;-1;152;0;0;0;0;.00nan;0;0
31352;189944;152;79;28;2;26;.929;3600000;0
31352;86472;4922;0;0;0;0;.00nan;0;0
31353;184049;1097;86;53;3;50;.943;3600000;0
31353;194899;4245;60;22;2;20;.909;3600000;0
31353;196445;4245;0;0;0;0;.00nan;0;0
31353;-1;1097;0;0;0;0;.00nan;0;0
31354;171615;75;0;0;0;0;.00nan;0;0
31354;174407;75;74;43;4;39;.907;3591000;0
31354;196414;4620;0;0;0;0;.00nan;0;0
31354;181341;4620;54;23;3;20;.870;3600000;0
31355;189628;74;0;0;0;0;.00nan;0;0
31355;176136;74;88;30;1;29;.967;3600000;0
31355;180873;77;0;0;0;0;.00nan;0;0
31355;85555;77;90;42;2;40;.952;3582000;0
31356;194531;4920;0;0;0;0;.00nan;0;0
31356;-1;67;37;30;6;24;.800;2683000;0
31356;202246;4920;78;25;1;24;.960;3600000;0
31356;191698;67;52;9;1;8;.889;917000;0
31357;183755;69;54;29;3;26;.897;3516000;0
31357;174386;81;0;0;0;0;.00nan;0;0
31357;186451;81;65;21;1;20;.952;3600000;0
31357;58100;69;0;0;0;0;.00nan;0;0
31358;189885;4921;0;0;0;0;.00nan;0;0
31358;192629;80;0;0;0;0;.00nan;0;0
31358;197912;4921;74;41;4;37;.902;3558000;0
31358;85228;80;60;21;2;19;.905;3600000;0
31359;170351;149;0;0;0;0;.00nan;0;0
31359;196525;151;99;43;2;41;.953;3600000;0
31359;85546;149;48;39;5;34;.872;3600000;0
31359;85636;151;0;0;0;0;.00nan;0;0
31360;4487;4922;67;31;3;28;.903;3549000;0
31360;179344;82;83;38;2;36;.947;3600000;0
31360;197047;82;0;0;0;0;.00nan;0;0
31360;86472;4922;0;0;0;0;.00nan;0;0
31361;200390;1096;0;0;0;0;.00nan;0;0
31361;189628;74;0;0;0;0;.00nan;0;0
31361;176136;74;69;22;1;21;.955;3600000;0
31361;-1;1096;88;39;2;37;.949;3546000;0
31362;173874;158;0;0;0;0;.00nan;0;0
31362;-1;158;64;34;4;30;.882;3600000;0
31362;192629;80;0;0;0;0;.00nan;0;0
31362;85228;80;43;35;5;30;.857;3551000;0
31363;184049;1097;55;26;4;22;.846;3572000;0
31363;180873;77;93;45;2;43;.956;3600000;0
31363;-1;1097;0;0;0;0;.00nan;0;0
31363;85555;77;0;0;0;0;.00nan;0;0
31364;-1;152;0;0;0;0;.00nan;0;0
31364;174386;81;0;0;0;0;.00nan;0;0
31364;189944;152;98;58;3;55;.948;3516000;0
31364;186451;81;72;19;1;18;.947;3600000;0
31365;4487;4922;79;31;2;29;.935;3900000;0
31365;180873;77;0;0;0;0;.00nan;0;0
31365;85555;77;96;46;2;44;.957;3900000;0
31365;86472;4922;0;0;0;0;.00nan;0;0
31366;183755;69;74;28;2;26;.929;3542000;0
31366;189885;4921;0;0;0;0;.00nan;0;0
31366;197912;4921;74;21;1;20;.952;3600000;0
31366;58100;69;0;0;0;0;.00nan;0;0
31367;200390;1096;51;38;5;33;.868;3543000;0
31367;189628;74;0;0;0;0;.00nan;0;0
31367;176136;74;58;24;3;21;.875;3600000;0
31367;-1;1096;0;0;0;0;.00nan;0;0
31368;-1;76;62;20;2;18;.900;3754000;0
31368;184175;76;0;0;0;0;.00nan;0;0
31368;179344;82;100;38;1;37;.974;3754000;0
31368;197047;82;0;0;0;0;.00nan;0;0
31369;173874;158;70;35;3;32;.914;3547000;0
31369;-1;158;0;0;0;0;.00nan;0;0
31369;192629;80;0;0;0;0;.00nan;0;0
31369;85228;80;85;24;1;23;.958;3600000;0
31370;-1;2564;97;40;2;38;.950;3546000;0
31370;176060;2564;0;0;0;0;.00nan;0;0
31370;64722;72;0;0;0;0;.00nan;0;0
31370;91212;72;79;21;1;20;.952;3600000;0
31371;170351;149;0;0;0;0;.00nan;0;0
31371;196525;151;70;24;3;21;.875;3600000;0
31371;85546;149;76;49;4;45;.918;3600000;0
31371;85636;151;0;0;0;0;.00nan;0;0
31372;192895;85;0;0;0;0;.00nan;0;0
31372;171615;75;0;0;0;0;.00nan;0;0
31372;174407;75;76;33;3;30;.909;3591000;0
31372;148573;85;69;26;2;24;.923;3600000;0
31373;178394;1095;0;0;0;0;.00nan;0;0
31373;194531;4920;48;26;4;22;.846;3600000;0
31373;-1;1095;85;44;3;41;.932;3600000;0
31373;202246;4920;0;0;0;0;.00nan;0;0
31374;-1;67;0;0;0;0;.00nan;0;0
31374;194899;4245;0;0;0;0;.00nan;0;0
31374;196445;4245;50;22;3;19;.864;3600000;0
31374;191698;67;72;51;5;46;.902;3540000;0
31375;-1;152;63;40;4;36;.900;3557000;0
31375;174386;81;53;21;3;18;.857;3600000;0
31375;189944;152;0;0;0;0;.00nan;0;0
31375;186451;81;0;0;0;0;.00nan;0;0
31376;183737;78;67;30;3;27;.900;3900000;0
31376;176770;78;0;0;0;0;.00nan;0;0
31376;196414;4620;64;25;3;22;.880;3900000;0
31376;181341;4620;0;0;0;0;.00nan;0;0
31377;183755;69;0;0;0;0;.00nan;0;0
31377;189885;4921;69;29;2;27;.931;3600000;0
31377;197912;4921;0;0;0;0;.00nan;0;0
31377;58100;69;40;35;6;29;.829;3600000;0
31378;200390;1096;0;0;0;0;.00nan;0;0
31378;189628;74;63;29;3;26;.897;3600000;0
31378;176136;74;0;0;0;0;.00nan;0;0
31378;-1;1096;37;27;5;22;.815;3600000;0
31379;179344;82;0;0;0;0;.00nan;0;0
31379;180873;77;100;44;1;43;.977;3600000;0
31379;197047;82;60;38;4;34;.895;3600000;0
31379;85555;77;0;0;0;0;.00nan;0;0
31380;173874;158;0;0;0;0;.00nan;0;0
31380;-1;158;77;43;5;38;.884;3895000;0
31380;192629;80;39;30;5;25;.833;3900000;0
31380;85228;80;0;0;0;0;.00nan;0;0
31381;173961;73;85;29;1;28;.966;3600000;0
31381;-1;2564;0;0;0;0;.00nan;0;0
31381;176060;2564;100;38;0;38;1.000;3600000;0
31381;-1;73;0;0;0;0;.00nan;0;0
31382;170351;149;63;28;3;25;.893;3600000;0
31382;196525;151;52;34;5;29;.853;3600000;0
31382;85546;149;0;0;0;0;.00nan;0;0
31382;85636;151;0;0;0;0;.00nan;0;0
31383;192895;85;51;38;5;33;.868;3600000;0
31383;171615;75;71;25;2;23;.920;3600000;0
31383;174407;75;0;0;0;0;.00nan;0;0
31383;148573;85;0;0;0;0;.00nan;0;0
31384;-1;76;0;0;0;0;.00nan;0;0
31384;184049;1097;0;0;0;0;.00nan;0;0
31384;184175;76;60;40;5;35;.875;3600000;0
31384;-1;1097;98;24;0;24;1.000;3600000;0
31385;178394;1095;0;0;0;0;.00nan;0;0
31385;-1;1095;66;38;5;33;.868;3900000;0
31385;64722;72;64;43;5;38;.884;3900000;0
31385;91212;72;0;0;0;0;.00nan;0;0
31386;-1;67;92;46;3;43;.935;3892000;0
31386;194899;4245;75;25;2;23;.920;3892000;0
31386;196445;4245;0;0;0;0;.00nan;0;0
31386;191698;67;0;0;0;0;.00nan;0;0
31387;194531;4920;0;0;0;0;.00nan;0;0
31387;202246;4920;100;24;0;24;1.000;3600000;0
31387;185800;71;0;0;0;0;.00nan;0;0
31387;65014;71;80;43;4;39;.907;3600000;0
31388;183737;78;0;0;0;0;.00nan;0;0
31388;176770;78;74;38;4;34;.895;3576000;0
31388;196414;4620;0;0;0;0;.00nan;0;0
31388;181341;4620;38;15;3;12;.800;3600000;0
31389;4487;4922;0;0;0;0;.00nan;0;0
31389;184049;1097;0;0;0;0;.00nan;0;0
31389;-1;1097;92;42;2;40;.952;3600000;0
31389;86472;4922;71;38;3;35;.921;3600000;0
31390;192895;85;0;0;0;0;.00nan;0;0
31390;171615;75;0;0;0;0;.00nan;0;0
31390;174407;75;100;23;0;23;1.000;3600000;0
31390;148573;85;51;31;4;27;.871;3600000;0
31391;-1;76;54;25;3;22;.880;3524000;0
31391;184175;76;0;0;0;0;.00nan;0;0
31391;179344;82;100;53;1;52;.981;3600000;0
31391;197047;82;0;0;0;0;.00nan;0;0
31392;-1;67;0;0;0;0;.00nan;0;0
31392;194899;4245;0;0;0;0;.00nan;0;0
31392;191698;67;93;46;3;43;.935;3600000;0
31392;91398;4245;77;24;1;23;.958;3600000;0
31393;170351;149;0;0;0;0;.00nan;0;0
31393;174386;81;0;0;0;0;.00nan;0;0
31393;186451;81;85;41;3;38;.927;3600000;0
31393;85546;149;51;48;7;41;.854;3600000;0
31394;194531;4920;89;34;2;32;.941;3600000;0
31394;202246;4920;0;0;0;0;.00nan;0;0
31394;185800;71;0;0;0;0;.00nan;0;0
31394;65014;71;81;27;1;26;.963;3600000;0
31395;-1;152;0;0;0;0;.00nan;0;0
31395;189944;152;91;41;2;39;.951;3600000;0
31395;196525;151;0;0;0;0;.00nan;0;0
31395;85636;151;34;27;5;22;.815;3600000;0
31396;184049;1097;0;0;0;0;.00nan;0;0
31396;189628;74;0;0;0;0;.00nan;0;0
31396;176136;74;61;22;2;20;.909;3600000;0
31396;-1;1097;64;29;3;26;.897;3547000;0
31397;183737;78;78;45;4;41;.911;3527000;0
31397;176770;78;0;0;0;0;.00nan;0;0
31397;196414;4620;0;0;0;0;.00nan;0;0
31397;181341;4620;81;28;2;26;.929;3600000;0
31398;189885;4921;0;0;0;0;.00nan;0;0
31398;-1;2564;0;0;0;0;.00nan;0;0
31398;176060;2564;60;30;3;27;.900;3600000;0
31398;197912;4921;50;37;6;31;.838;3600000;0
31399;194531;4920;0;0;0;0;.00nan;0;0
31399;171615;75;0;0;0;0;.00nan;0;0
31399;174407;75;88;44;3;41;.932;3546000;0
31399;202246;4920;55;14;2;12;.857;3600000;0
31400;200572;157;0;0;0;0;.00nan;0;0
31400;192629;80;0;0;0;0;.00nan;0;0
31400;77084;157;67;28;2;26;.929;3900000;0
31400;85228;80;91;35;2;33;.943;3900000;0
31401;189885;4921;73;36;3;33;.917;3559000;0
31401;-1;2564;53;15;2;13;.867;3600000;0
31401;176060;2564;0;0;0;0;.00nan;0;0
31401;197912;4921;0;0;0;0;.00nan;0;0
31402;194899;4245;0;0;0;0;.00nan;0;0
31402;196414;4620;57;31;4;27;.871;3568000;0
31402;181341;4620;0;0;0;0;.00nan;0;0
31402;91398;4245;72;30;2;28;.933;3600000;0
31403;170351;149;0;0;0;0;.00nan;0;0
31403;174386;81;0;0;0;0;.00nan;0;0
31403;186451;81;99;41;1;40;.976;3600000;0
31403;85546;149;35;23;5;18;.783;3600000;0
31404;183737;78;0;0;0;0;.00nan;0;0
31404;171615;75;0;0;0;0;.00nan;0;0
31404;174407;75;66;28;2;26;.929;3600000;0
31404;176770;78;95;29;1;28;.966;3600000;0
31405;-1;152;0;0;0;0;.00nan;0;0
31405;189944;152;67;33;3;30;.909;3600000;0
31405;196525;151;62;21;2;19;.905;3600000;0
31405;85636;151;0;0;0;0;.00nan;0;0
31406;178394;1095;48;0;0;0;.00nan;357000;0
31406;-1;1095;45;38;6;32;.842;3243000;0
31406;173961;73;0;0;0;0;.00nan;0;0
31406;-1;73;80;28;1;27;.964;3600000;0
31407;200390;1096;68;38;4;34;.895;3552000;0
31407;179344;82;92;43;3;40;.930;3600000;0
31407;-1;1096;0;0;0;0;.00nan;0;0
31407;197047;82;0;0;0;0;.00nan;0;0
31408;183755;69;59;39;5;34;.872;3600000;0
31408;58100;69;0;0;0;0;.00nan;0;0
31408;64722;72;0;0;0;0;.00nan;0;0
31408;91212;72;79;26;1;25;.962;3600000;0
31409;192895;85;0;0;0;0;.00nan;0;0
31409;-1;67;0;0;0;0;.00nan;0;0
31409;191698;67;76;22;1;21;.955;3600000;0
31409;148573;85;62;29;4;25;.862;3600000;0
31410;194899;4245;0;0;0;0;.00nan;0;0
31410;196414;4620;0;0;0;0;.00nan;0;0
31410;181341;4620;51;17;2;15;.882;3600000;0
31410;91398;4245;100;33;1;32;.970;3600000;0
31411;170351;149;64;33;3;30;.909;3900000;0
31411;174386;81;65;31;3;28;.903;3900000;0
31411;186451;81;0;0;0;0;.00nan;0;0
31411;85546;149;0;0;0;0;.00nan;0;0
31412;-1;76;0;0;0;0;.00nan;0;0
31412;184175;76;79;31;2;29;.935;3600000;0
31412;189628;74;0;0;0;0;.00nan;0;0
31412;176136;74;60;24;3;21;.875;3600000;0
31413;4487;4922;100;40;1;39;.975;3600000;0
31413;184049;1097;0;0;0;0;.00nan;0;0
31413;-1;1097;68;31;2;29;.935;3560000;0
31413;86472;4922;0;0;0;0;.00nan;0;0
31414;200572;157;0;0;0;0;.00nan;0;0
31414;192629;80;0;0;0;0;.00nan;0;0
31414;77084;157;88;28;1;27;.964;3600000;0
31414;85228;80;80;29;2;27;.931;3574000;0
31415;173874;158;47;22;4;18;.818;3600000;0
31415;-1;158;0;0;0;0;.00nan;0;0
31415;185800;71;0;0;0;0;.00nan;0;0
31415;65014;71;100;23;0;23;1.000;3600000;0
31416;-1;152;68;28;3;25;.893;3600000;0
31416;189944;152;0;0;0;0;.00nan;0;0
31416;196525;151;42;39;6;33;.846;3600000;0
31416;85636;151;0;0;0;0;.00nan;0;0
31417;4487;4922;0;0;0;0;.00nan;0;0
31417;200390;1096;85;31;2;29;.935;3009000;0
31417;-1;1096;38;15;4;11;.733;891000;0
31417;86472;4922;52;41;6;35;.854;3892000;0
31418;183755;69;0;0;0;0;.00nan;0;0
31418;58100;69;73;43;4;39;.907;3600000;0
31418;64722;72;55;24;3;21;.875;3600000;0
31418;91212;72;0;0;0;0;.00nan;0;0
31419;179344;82;67;25;3;22;.880;3600000;0
31419;180873;77;36;29;6;23;.793;2688000;0
31419;197047;82;0;0;0;0;.00nan;0;0
31419;85555;77;52;8;1;7;.875;912000;0
31420;189885;4921;0;0;0;0;.00nan;0;0
31420;-1;2564;29;30;6;24;.800;3059000;0
31420;176060;2564;57;6;0;6;1.000;516000;0
31420;197912;4921;63;37;4;33;.892;3600000;0
31421;192895;85;58;30;3;27;.900;3900000;0
31421;183737;78;57;24;3;21;.875;3900000;0
31421;176770;78;0;0;0;0;.00nan;0;0
31421;148573;85;0;0;0;0;.00nan;0;0
31422;-1;76;71;38;3;35;.921;3600000;0
31422;184175;76;0;0;0;0;.00nan;0;0
31422;189628;74;76;43;4;39;.907;3573000;0
31422;176136;74;0;0;0;0;.00nan;0;0
31423;170351;149;0;0;0;0;.00nan;0;0
31423;174386;81;0;0;0;0;.00nan;0;0
31423;186451;81;64;31;3;28;.903;3600000;0
31423;85546;149;83;27;2;25;.926;3600000;0
31424;194531;4920;64;18;2;16;.889;3600000;0
31424;171615;75;0;0;0;0;.00nan;0;0
31424;174407;75;52;33;5;28;.848;3600000;0
31424;202246;4920;0;0;0;0;.00nan;0;0
31425;178394;1095;0;0;0;0;.00nan;0;0
31425;-1;1095;98;39;1;38;.974;3600000;0
31425;173961;73;68;34;3;31;.912;3591000;0
31425;-1;73;0;0;0;0;.00nan;0;0
31426;200572;157;52;42;6;36;.857;3600000;0
31426;192629;80;78;14;0;14;1.000;3600000;0
31426;77084;157;0;0;0;0;.00nan;0;0
31426;85228;80;0;0;0;0;.00nan;0;0
31427;173874;158;0;0;0;0;.00nan;0;0
31427;-1;158;62;40;4;36;.900;3600000;0
31427;185800;71;68;19;1;18;.947;3600000;0
31427;65014;71;0;0;0;0;.00nan;0;0
31428;183737;78;0;0;0;0;.00nan;0;0
31428;-1;67;0;0;0;0;.00nan;0;0
31428;176770;78;74;31;2;29;.935;3600000;0
31428;191698;67;56;30;4;26;.867;3543000;0
31429;-1;152;0;0;0;0;.00nan;0;0
31429;189944;152;94;36;1;35;.972;3744000;0
31429;196525;151;76;31;2;29;.935;3744000;0
31429;85636;151;0;0;0;0;.00nan;0;0
31430;4487;4922;90;44;3;41;.932;3600000;0
31430;200390;1096;0;0;0;0;.00nan;0;0
31430;-1;1096;41;21;4;17;.810;3570000;0
31430;86472;4922;0;0;0;0;.00nan;0;0
31431;179344;82;0;0;0;0;.00nan;0;0
31431;180873;77;0;0;0;0;.00nan;0;0
31431;197047;82;76;33;2;31;.939;3600000;0
31431;85555;77;57;28;3;25;.893;3565000;0
31432;194899;4245;0;0;0;0;.00nan;0;0
31432;196414;4620;0;0;0;0;.00nan;0;0
31432;181341;4620;91;39;2;37;.949;3555000;0
31432;91398;4245;76;21;1;20;.952;3600000;0
31433;178394;1095;0;0;0;0;.00nan;0;0
31433;-1;1095;77;35;3;32;.914;3600000;0
31433;173961;73;0;0;0;0;.00nan;0;0
31433;-1;73;44;26;4;22;.846;3583000;0
31434;173874;158;75;40;4;36;.900;3561000;0
31434;-1;158;0;0;0;0;.00nan;0;0
31434;185800;71;0;0;0;0;.00nan;0;0
31434;65014;71;61;23;3;20;.870;3600000;0
31435;4487;4922;85;23;1;22;.957;3600000;0
31435;179344;82;59;22;3;19;.864;3599000;0
31435;197047;82;0;0;0;0;.00nan;0;0
31435;86472;4922;0;0;0;0;.00nan;0;0
31436;183755;69;73;32;3;29;.906;3600000;0
31436;173961;73;0;0;0;0;.00nan;0;0
31436;-1;73;83;42;4;38;.905;3557000;0
31436;58100;69;0;0;0;0;.00nan;0;0
31437;200390;1096;73;27;3;24;.889;3600000;0
31437;189628;74;0;0;0;0;.00nan;0;0
31437;176136;74;61;41;5;36;.878;3600000;0
31437;-1;1096;0;0;0;0;.00nan;0;0
31438;-1;152;60;35;5;30;.857;3600000;0
31438;173874;158;87;36;2;34;.944;3600000;0
31438;189944;152;0;0;0;0;.00nan;0;0
31438;-1;158;0;0;0;0;.00nan;0;0
31439;200572;157;0;0;0;0;.00nan;0;0
31439;189885;4921;0;0;0;0;.00nan;0;0
31439;197912;4921;72;42;4;38;.905;3546000;0
31439;77084;157;57;28;3;25;.893;3600000;0
31440;184049;1097;93;51;2;49;.961;3600000;0
31440;180873;77;28;30;6;24;.800;3070000;0
31440;-1;1097;0;0;0;0;.00nan;0;0
31440;85555;77;53;3;0;3;1.000;530000;0
31441;178394;1095;0;0;0;0;.00nan;0;0
31441;-1;1095;95;37;2;35;.946;3600000;0
31441;185800;71;53;3;0;3;1.000;1042000;0
31441;65014;71;22;26;7;19;.731;2558000;0
31442;-1;76;66;25;2;23;.920;3600000;0
31442;184175;76;0;0;0;0;.00nan;0;0
31442;179344;82;73;46;5;41;.891;3600000;0
31442;197047;82;0;0;0;0;.00nan;0;0
31443;4487;4922;83;42;3;39;.929;3600000;0
31443;200390;1096;0;0;0;0;.00nan;0;0
31443;-1;1096;100;28;0;28;1.000;3600000;0
31443;86472;4922;0;0;0;0;.00nan;0;0
31444;-1;152;0;0;0;0;.00nan;0;0
31444;173874;158;81;37;3;34;.919;3590000;0
31444;189944;152;80;24;2;22;.917;3600000;0
31444;-1;158;0;0;0;0;.00nan;0;0
31445;185800;71;0;0;0;0;.00nan;0;0
31445;65014;71;67;30;3;27;.900;3900000;0
31445;85228;72;70;26;3;23;.885;3900000;0
31445;91212;72;0;0;0;0;.00nan;0;0
31446;200572;157;53;19;2;17;.895;3015000;0
31446;189885;4921;91;26;1;25;.962;3600000;0
31446;197912;4921;0;0;0;0;.00nan;0;0
31446;77084;157;36;12;3;9;.750;585000;0
31447;179344;82;0;0;0;0;.00nan;0;0
31447;180873;77;72;30;2;28;.933;3540000;0
31447;197047;82;87;30;1;29;.967;3600000;0
31447;85555;77;0;0;0;0;.00nan;0;0
31448;183737;78;0;0;0;0;.00nan;0;0
31448;171615;75;0;0;0;0;.00nan;0;0
31448;174407;75;64;30;4;26;.867;3600000;0
31448;176770;78;65;26;3;23;.885;3600000;0
31449;194531;4920;0;0;0;0;.00nan;0;0
31449;194899;4245;0;0;0;0;.00nan;0;0
31449;202246;4920;93;24;0;24;1.000;3600000;0
31449;91398;4245;86;39;3;36;.923;3600000;0
31450;-1;76;0;0;0;0;.00nan;0;0
31450;184049;1097;78;34;2;32;.941;3600000;0
31450;184175;76;17;26;7;19;.731;3600000;0
31450;-1;1097;0;0;0;0;.00nan;0;0
31451;178394;1095;0;0;0;0;.00nan;0;0
31451;-1;1095;60;31;4;27;.871;3535000;0
31451;-1;2564;0;0;0;0;.00nan;0;0
31451;176060;2564;81;32;2;30;.938;3600000;0
31452;192895;85;0;0;0;0;.00nan;0;0
31452;-1;67;0;0;0;0;.00nan;0;0
31452;191698;67;100;38;0;38;1.000;3600000;0
31452;148573;85;51;41;6;35;.854;3600000;0
31453;174386;81;56;5;0;5;1.000;455000;0
31453;196525;151;62;31;4;27;.871;3600000;0
31453;186451;81;26;29;7;22;.759;3145000;0
31453;85636;151;0;0;0;0;.00nan;0;0
31454;170351;149;0;0;0;0;.00nan;0;0
31454;170598;80;0;0;0;0;.00nan;0;0
31454;192629;80;38;20;4;16;.800;3600000;0
31454;85546;149;87;29;1;28;.966;3600000;0
31455;183755;69;76;46;4;42;.913;3600000;0
31455;196414;4620;79;32;2;30;.938;3600000;0
31455;181341;4620;0;0;0;0;.00nan;0;0
31455;58100;69;0;0;0;0;.00nan;0;0
31456;4487;4922;0;0;0;0;.00nan;0;0
31456;200390;1096;0;0;0;0;.00nan;0;0
31456;-1;1096;55;28;3;25;.893;3717000;0
31456;86472;4922;65;36;4;32;.889;3717000;0
31457;178394;1095;0;0;0;0;.00nan;0;0
31457;-1;1095;59;34;5;29;.853;3600000;0
31457;173961;73;84;18;0;18;1.000;3600000;0
31457;-1;73;0;0;0;0;.00nan;0;0
31458;-1;152;38;39;7;32;.821;3600000;0
31458;173874;158;0;0;0;0;.00nan;0;0
31458;189944;152;0;0;0;0;.00nan;0;0
31458;-1;158;80;29;2;27;.931;3600000;0
31459;-1;2564;72;37;4;33;.892;3518000;0
31459;176060;2564;0;0;0;0;.00nan;0;0
31459;85228;72;48;14;2;12;.857;3600000;0
31459;91212;72;0;0;0;0;.00nan;0;0
31460;200572;157;0;0;0;0;.00nan;0;0
31460;189885;4921;40;25;4;21;.840;1736000;0
31460;197912;4921;21;23;6;17;.739;1864000;0
31460;77084;157;25;24;6;18;.750;3600000;0
31461;179344;82;69;33;3;30;.909;3600000;0
31461;180873;77;0;0;0;0;.00nan;0;0
31461;197047;82;0;0;0;0;.00nan;0;0
31461;85555;77;93;22;0;22;1.000;3600000;0
31462;194531;4920;64;41;4;37;.902;3900000;0
31462;194899;4245;0;0;0;0;.00nan;0;0
31462;202246;4920;0;0;0;0;.00nan;0;0
31462;91398;4245;61;32;4;28;.875;3900000;0
31463;-1;76;49;33;4;29;.879;3578000;0
31463;184175;76;0;0;0;0;.00nan;0;0
31463;189628;74;0;0;0;0;.00nan;0;0
31463;176136;74;83;33;2;31;.939;3600000;0
31464;192895;85;55;29;4;25;.862;3600000;0
31464;-1;67;0;0;0;0;.00nan;0;0
31464;191698;67;91;29;1;28;.966;3600000;0
31464;148573;85;0;0;0;0;.00nan;0;0
31465;174386;81;63;33;4;29;.879;3600000;0
31465;196525;151;25;27;6;21;.778;2888000;0
31465;186451;81;0;0;0;0;.00nan;0;0
31465;85636;151;47;11;2;9;.818;712000;0
31466;170351;149;70;36;4;32;.889;3520000;0
31466;170598;80;78;29;2;27;.931;3600000;0
31466;192629;80;0;0;0;0;.00nan;0;0
31466;85546;149;0;0;0;0;.00nan;0;0
31467;183755;69;48;0;0;0;.00nan;352000;0
31467;196414;4620;0;0;0;0;.00nan;0;0
31467;181341;4620;68;24;2;22;.917;3600000;0
31467;58100;69;47;41;7;34;.829;3248000;0
31468;173961;73;76;31;2;29;.935;3599000;0
31468;185800;71;0;0;0;0;.00nan;0;0
31468;-1;73;0;0;0;0;.00nan;0;0
31468;65014;71;88;35;1;34;.971;3600000;0
31469;178394;1095;81;45;3;42;.933;3900000;0
31469;-1;1095;0;0;0;0;.00nan;0;0
31469;85228;72;52;27;3;24;.889;3887000;0
31469;91212;72;0;0;0;0;.00nan;0;0
31470;183737;78;0;0;0;0;.00nan;0;0
31470;171615;75;0;0;0;0;.00nan;0;0
31470;174407;75;100;27;0;27;1.000;3600000;0
31470;176770;78;53;22;3;19;.864;3600000;0
31471;184049;1097;58;19;2;17;.895;3600000;0
31471;189628;74;79;45;4;41;.911;3586000;0
31471;176136;74;0;0;0;0;.00nan;0;0
31471;-1;1097;0;0;0;0;.00nan;0;0
31472;170351;149;0;0;0;0;.00nan;0;0
31472;170598;80;74;24;1;23;.958;3600000;0
31472;192629;80;0;0;0;0;.00nan;0;0
31472;85546;149;86;47;4;43;.915;3600000;0
31473;192895;85;0;0;0;0;.00nan;0;0
31473;196414;4620;65;17;1;16;.941;3864000;0
31473;181341;4620;0;0;0;0;.00nan;0;0
31473;148573;85;94;54;1;53;.981;3900000;0
31474;183737;78;12;33;8;25;.758;3186000;0
31474;194531;4920;0;0;0;0;.00nan;0;0
31474;176770;78;56;5;0;5;1.000;414000;0
31474;202246;4920;71;30;3;27;.900;3600000;0
31475;4487;4922;99;34;1;33;.971;3600000;0
31475;179344;82;56;31;4;27;.871;3600000;0
31475;197047;82;0;0;0;0;.00nan;0;0
31475;86472;4922;0;0;0;0;.00nan;0;0
31476;183755;69;70;27;2;25;.926;3600000;0
31476;58100;69;0;0;0;0;.00nan;0;0
31476;85228;72;54;23;3;20;.870;3546000;0
31476;91212;72;0;0;0;0;.00nan;0;0
31477;184049;1097;65;37;4;33;.892;3600000;0
31477;180873;77;0;0;0;0;.00nan;0;0
31477;-1;1097;0;0;0;0;.00nan;0;0
31477;85555;77;69;31;3;28;.903;3600000;0
31478;189885;4921;87;47;3;44;.936;3600000;0
31478;-1;2564;0;0;0;0;.00nan;0;0
31478;176060;2564;60;17;2;15;.882;3600000;0
31478;197912;4921;0;0;0;0;.00nan;0;0
31479;-1;67;0;0;0;0;.00nan;0;0
31479;171615;75;0;0;0;0;.00nan;0;0
31479;174407;75;79;26;1;25;.962;3600000;0
31479;191698;67;60;25;3;22;.880;3545000;0
31480;-1;76;49;31;5;26;.839;3568000;0
31480;184175;76;0;0;0;0;.00nan;0;0
31480;189628;74;0;0;0;0;.00nan;0;0
31480;176136;74;93;52;4;48;.923;3600000;0
31481;173874;158;60;31;4;27;.871;3600000;0
31481;170351;149;0;0;0;0;.00nan;0;0
31481;-1;158;0;0;0;0;.00nan;0;0
31481;85546;149;100;27;0;27;1.000;3600000;0
31482;174386;81;0;0;0;0;.00nan;0;0
31482;196525;151;28;29;6;23;.793;3600000;0
31482;186451;81;61;31;4;27;.871;3600000;0
31482;85636;151;0;0;0;0;.00nan;0;0
31483;200572;157;0;0;0;0;.00nan;0;0
31483;194899;4245;0;0;0;0;.00nan;0;0
31483;77084;157;62;42;5;37;.881;3600000;0
31483;91398;4245;65;22;2;20;.909;3600000;0
31484;178394;1095;0;0;0;0;.00nan;0;0
31484;-1;1095;62;37;4;33;.892;3600000;0
31484;185800;71;87;27;1;26;.963;3600000;0
31484;65014;71;0;0;0;0;.00nan;0;0
31485;-1;152;0;0;0;0;.00nan;0;0
31485;170598;80;91;38;2;36;.947;3642000;0
31485;189944;152;77;33;3;30;.909;3642000;0
31485;192629;80;0;0;0;0;.00nan;0;0
31486;173961;73;0;0;0;0;.00nan;0;0
31486;189885;4921;0;0;0;0;.00nan;0;0
31486;-1;73;66;15;1;14;.933;3600000;0
31486;197912;4921;80;44;4;40;.909;3600000;0
31487;183737;78;41;11;2;9;.818;971000;0
31487;176770;78;20;24;6;18;.750;2629000;0
31487;196414;4620;0;0;0;0;.00nan;0;0
31487;181341;4620;74;36;4;32;.889;3600000;0
31488;4487;4922;55;46;7;39;.848;3600000;0
31488;-1;76;79;26;2;24;.923;3600000;0
31488;184175;76;0;0;0;0;.00nan;0;0
31488;86472;4922;0;0;0;0;.00nan;0;0
31489;183755;69;52;25;3;22;.880;3584000;0
31489;185800;71;0;0;0;0;.00nan;0;0
31489;58100;69;0;0;0;0;.00nan;0;0
31489;65014;71;79;27;2;25;.926;3600000;0
31490;173961;73;51;38;6;32;.842;3600000;0
31490;-1;73;0;0;0;0;.00nan;0;0
31490;85228;72;47;14;2;12;.857;3600000;0
31490;91212;72;0;0;0;0;.00nan;0;0
31491;200390;1096;51;26;4;22;.846;3574000;0
31491;180873;77;78;40;3;37;.925;3600000;0
31491;-1;1096;0;0;0;0;.00nan;0;0
31491;85555;77;0;0;0;0;.00nan;0;0
31492;170598;80;50;24;3;21;.875;3600000;0
31492;196525;151;33;11;3;8;.727;498000;0
31492;192629;80;0;0;0;0;.00nan;0;0
31492;85636;151;64;44;5;39;.886;3102000;0
31493;192895;85;0;0;0;0;.00nan;0;0
31493;194531;4920;35;19;4;15;.789;3600000;0
31493;202246;4920;0;0;0;0;.00nan;0;0
31493;148573;85;94;30;1;29;.967;3600000;0
31494;-1;67;0;0;0;0;.00nan;0;0
31494;171615;75;0;0;0;0;.00nan;0;0
31494;174407;75;68;26;2;24;.923;3600000;0
31494;191698;67;71;45;5;40;.889;3600000;0
31495;173874;158;35;38;7;31;.816;3340000;0
31495;170351;149;0;0;0;0;.00nan;0;0
31495;-1;158;53;3;0;3;1.000;260000;0
31495;85546;149;78;16;1;15;.938;3600000;0
31496;184049;1097;0;0;0;0;.00nan;0;0
31496;179344;82;89;44;2;42;.955;3600000;0
31496;-1;1097;96;22;0;22;1.000;3600000;0
31496;197047;82;0;0;0;0;.00nan;0;0
31497;178394;1095;67;12;0;12;1.000;736000;0
31497;-1;1095;22;24;6;18;.750;2864000;0
31497;-1;2564;0;0;0;0;.00nan;0;0
31497;176060;2564;54;21;3;18;.857;3600000;0
31498;-1;152;0;0;0;0;.00nan;0;0
31498;174386;81;0;0;0;0;.00nan;0;0
31498;189944;152;96;49;3;46;.939;3600000;0
31498;186451;81;88;15;0;15;1.000;3600000;0
31499;200572;157;74;34;4;30;.882;3600000;0
31499;194899;4245;0;0;0;0;.00nan;0;0
31499;77084;157;0;0;0;0;.00nan;0;0
31499;91398;4245;77;28;1;27;.964;3600000;0
31500;183737;78;70;35;4;31;.886;3550000;0
31500;176770;78;0;0;0;0;.00nan;0;0
31500;196414;4620;83;36;2;34;.944;3600000;0
31500;181341;4620;0;0;0;0;.00nan;0;0
31501;4487;4922;0;0;0;0;.00nan;0;0
31501;179344;82;0;0;0;0;.00nan;0;0
31501;197047;82;96;46;1;45;.978;3900000;0
31501;86472;4922;77;21;1;20;.952;3900000;0
31502;178394;1095;68;44;5;39;.886;3515000;0
31502;-1;1095;0;0;0;0;.00nan;0;0
31502;173961;73;0;0;0;0;.00nan;0;0
31502;-1;73;55;21;3;18;.857;3600000;0
31503;-1;76;0;0;0;0;.00nan;0;0
31503;184175;76;76;32;3;29;.906;3600000;0
31503;180873;77;0;0;0;0;.00nan;0;0
31503;85555;77;59;41;5;36;.878;3566000;0
31504;183755;69;0;0;0;0;.00nan;0;0
31504;-1;2564;69;17;1;16;.941;3600000;0
31504;176060;2564;0;0;0;0;.00nan;0;0
31504;58100;69;90;44;2;42;.955;3581000;0
31505;170598;80;60;35;5;30;.857;3600000;0
31505;196525;151;46;37;6;31;.838;3559000;0
31505;192629;80;0;0;0;0;.00nan;0;0
31505;85636;151;0;0;0;0;.00nan;0;0
31506;192895;85;87;35;2;33;.943;3900000;0
31506;194531;4920;0;0;0;0;.00nan;0;0
31506;202246;4920;70;26;2;24;.923;3894000;0
31506;148573;85;0;0;0;0;.00nan;0;0
31507;-1;67;41;20;4;16;.800;3600000;0
31507;171615;75;83;22;1;21;.955;3600000;0
31507;174407;75;0;0;0;0;.00nan;0;0
31507;191698;67;0;0;0;0;.00nan;0;0
31508;200390;1096;0;0;0;0;.00nan;0;0
31508;189628;74;0;0;0;0;.00nan;0;0
31508;176136;74;90;31;2;29;.935;3600000;0
31508;-1;1096;58;36;4;32;.889;3586000;0
31509;173874;158;0;0;0;0;.00nan;0;0
31509;170351;149;58;28;3;25;.893;3546000;0
31509;-1;158;90;31;2;29;.935;3600000;0
31509;85546;149;0;0;0;0;.00nan;0;0
31510;-1;152;97;45;3;42;.933;3600000;0
31510;174386;81;0;0;0;0;.00nan;0;0
31510;189944;152;0;0;0;0;.00nan;0;0
31510;186451;81;52;17;2;15;.882;3600000;0
31511;200572;157;0;0;0;0;.00nan;0;0
31511;194899;4245;50;20;3;17;.850;3560000;0
31511;77084;157;67;24;2;22;.917;3600000;0
31511;91398;4245;0;0;0;0;.00nan;0;0
31512;189885;4921;0;0;0;0;.00nan;0;0
31512;185800;71;66;29;3;26;.897;3544000;0
31512;197912;4921;83;36;2;34;.944;3600000;0
31512;65014;71;0;0;0;0;.00nan;0;0
31513;-1;2564;0;0;0;0;.00nan;0;0
31513;176060;2564;67;30;3;27;.900;3900000;0
31513;85228;72;85;45;3;42;.933;3900000;0
31513;91212;72;0;0;0;0;.00nan;0;0
31514;-1;76;100;20;0;20;1.000;3600000;0
31514;184175;76;0;0;0;0;.00nan;0;0
31514;189628;74;77;42;4;38;.905;3600000;0
31514;176136;74;0;0;0;0;.00nan;0;0
31515;170598;80;85;31;1;30;.968;3900000;0
31515;174386;81;91;37;1;36;.973;3900000;0
31515;186451;81;0;0;0;0;.00nan;0;0
31515;192629;80;0;0;0;0;.00nan;0;0
31516;189885;4921;69;34;2;32;.941;3556000;0
31516;185800;71;0;0;0;0;.00nan;0;0
31516;197912;4921;0;0;0;0;.00nan;0;0
31516;65014;71;100;29;0;29;1.000;3600000;0
31517;183737;78;0;0;0;0;.00nan;0;0
31517;200390;1096;61;29;3;26;.897;3600000;0
31517;176770;78;54;31;4;27;.871;3548000;0
31517;-1;1096;0;0;0;0;.00nan;0;0
31518;194899;4245;0;0;0;0;.00nan;0;0
31518;173874;158;70;37;4;33;.892;3600000;0
31518;-1;158;0;0;0;0;.00nan;0;0
31518;91398;4245;73;20;2;18;.900;3600000;0
31519;185800;71;0;0;0;0;.00nan;0;0
31519;65014;71;60;47;6;41;.872;3600000;0
31519;85228;72;63;18;2;16;.889;3600000;0
31519;91212;72;0;0;0;0;.00nan;0;0
31520;189628;74;0;0;0;0;.00nan;0;0
31520;176136;74;63;31;3;28;.903;3562000;0
31520;180873;77;0;0;0;0;.00nan;0;0
31520;85555;77;100;45;2;43;.956;3598000;0
31521;-1;67;55;5;0;5;1.000;670000;0
31521;184049;1097;0;0;0;0;.00nan;0;0
31521;-1;1097;79;28;2;26;.929;3600000;0
31521;191698;67;39;35;6;29;.829;2930000;0
31522;170598;80;56;30;4;26;.867;3517000;0
31522;174386;81;0;0;0;0;.00nan;0;0
31522;186451;81;74;32;2;30;.938;3600000;0
31522;192629;80;0;0;0;0;.00nan;0;0
31523;196414;4620;0;0;0;0;.00nan;0;0
31523;196525;151;62;37;4;33;.892;3600000;0
31523;181341;4620;100;30;0;30;1.000;3600000;0
31523;85636;151;0;0;0;0;.00nan;0;0
31524;-1;76;67;42;4;38;.905;3527000;0
31524;-1;67;74;22;2;20;.909;3600000;0
31524;184175;76;0;0;0;0;.00nan;0;0
31524;191698;67;0;0;0;0;.00nan;0;0
31525;183737;78;0;0;0;0;.00nan;0;0
31525;200390;1096;0;0;0;0;.00nan;0;0
31525;176770;78;100;28;0;28;1.000;3600000;0
31525;-1;1096;48;20;3;17;.850;3600000;0
31526;-1;152;0;0;0;0;.00nan;0;0
31526;200572;157;0;0;0;0;.00nan;0;0
31526;189944;152;78;39;2;37;.949;3544000;0
31526;77084;157;91;25;1;24;.960;3600000;0
31527;183755;69;14;18;6;12;.667;2718000;0
31527;189885;4921;0;0;0;0;.00nan;0;0
31527;197912;4921;95;40;2;38;.950;3600000;0
31527;58100;69;48;8;1;7;.875;882000;0
31528;173961;73;0;0;0;0;.00nan;0;0
31528;-1;73;67;21;2;19;.905;3600000;0
31528;85228;72;27;29;6;23;.793;3358000;0
31528;91212;72;50;1;0;1;1.000;242000;0
31529;4487;4922;88;35;2;33;.943;3900000;0
31529;179344;82;67;30;2;28;.933;3900000;0
31529;197047;82;0;0;0;0;.00nan;0;0
31529;86472;4922;0;0;0;0;.00nan;0;0
31530;194899;4245;0;0;0;0;.00nan;0;0
31530;173874;158;0;0;0;0;.00nan;0;0
31530;-1;158;94;42;2;40;.952;3600000;0
31530;91398;4245;49;21;4;17;.810;3533000;0
31531;192895;85;0;0;0;0;.00nan;0;0
31531;196525;151;56;39;5;34;.872;3600000;0
31531;85636;151;0;0;0;0;.00nan;0;0
31531;148573;85;57;25;3;22;.880;3600000;0
31532;189628;74;0;0;0;0;.00nan;0;0
31532;176136;74;76;26;2;24;.923;3600000;0
31532;180873;77;63;38;4;34;.895;3595000;0
31532;85555;77;0;0;0;0;.00nan;0;0
31533;194531;4920;77;45;4;41;.911;3900000;0
31533;176060;2564;43;26;4;22;.846;3900000;0
31533;202246;4920;0;0;0;0;.00nan;0;0
31533;79141;2564;0;0;0;0;.00nan;0;0
31534;-1;76;0;0;0;0;.00nan;0;0
31534;184049;1097;39;31;5;26;.839;3600000;0
31534;184175;76;78;36;3;33;.917;3600000;0
31534;-1;1097;0;0;0;0;.00nan;0;0
31535;178394;1095;0;0;0;0;.00nan;0;0
31535;-1;1095;39;28;5;23;.821;3600000;0
31535;185800;71;0;0;0;0;.00nan;0;0
31535;65014;71;84;28;1;27;.964;3600000;0
31536;171615;75;0;0;0;0;.00nan;0;0
31536;174407;75;61;44;6;38;.864;3600000;0
31536;196414;4620;0;0;0;0;.00nan;0;0
31536;181341;4620;99;32;1;31;.969;3600000;0
31537;183737;78;0;0;0;0;.00nan;0;0
31537;200390;1096;45;40;6;34;.850;3600000;0
31537;176770;78;50;20;3;17;.850;3600000;0
31537;-1;1096;0;0;0;0;.00nan;0;0
31538;-1;152;0;0;0;0;.00nan;0;0
31538;170598;80;27;24;5;19;.792;3900000;0
31538;189944;152;66;49;5;44;.898;3900000;0
31538;192629;80;0;0;0;0;.00nan;0;0
31539;4487;4922;0;0;0;0;.00nan;0;0
31539;-1;76;47;31;5;26;.839;3600000;0
31539;184175;76;0;0;0;0;.00nan;0;0
31539;86472;4922;84;35;2;33;.943;3600000;0
31540;183755;69;0;0;0;0;.00nan;0;0
31540;173961;73;72;29;2;27;.931;3600000;0
31540;-1;73;0;0;0;0;.00nan;0;0
31540;58100;69;61;45;5;40;.889;3600000;0
31541;184049;1097;0;0;0;0;.00nan;0;0
31541;179344;82;0;0;0;0;.00nan;0;0
31541;-1;1097;30;15;4;11;.733;3531000;0
31541;197047;82;84;37;2;35;.946;3600000;0
31542;194899;4245;65;14;1;13;.929;3600000;0
31542;173874;158;70;34;4;30;.882;3600000;0
31542;-1;158;0;0;0;0;.00nan;0;0
31542;91398;4245;0;0;0;0;.00nan;0;0
31543;185800;71;47;27;4;23;.852;3543000;0
31543;65014;71;0;0;0;0;.00nan;0;0
31543;85228;72;0;0;0;0;.00nan;0;0
31543;91212;72;84;36;2;34;.944;3600000;0
31544;-1;67;0;0;0;0;.00nan;0;0
31544;180873;77;0;0;0;0;.00nan;0;0
31544;191698;67;68;25;2;23;.920;3600000;0
31544;85555;77;79;43;3;40;.930;3600000;0
31545;192895;85;72;28;2;26;.929;3600000;0
31545;196525;151;0;0;0;0;.00nan;0;0
31545;85636;151;67;29;3;26;.897;3585000;0
31545;148573;85;0;0;0;0;.00nan;0;0
31546;194531;4920;0;0;0;0;.00nan;0;0
31546;176060;2564;0;0;0;0;.00nan;0;0
31546;202246;4920;43;32;5;27;.844;3600000;0
31546;79141;2564;78;31;2;29;.935;3600000;0
31547;178394;1095;60;26;3;23;.885;3900000;0
31547;-1;1095;0;0;0;0;.00nan;0;0
31547;189885;4921;54;25;3;22;.880;3900000;0
31547;197912;4921;0;0;0;0;.00nan;0;0
31548;200572;157;45;23;4;19;.826;3551000;0
31548;174386;81;0;0;0;0;.00nan;0;0
31548;186451;81;69;30;3;27;.900;3600000;0
31548;77084;157;0;0;0;0;.00nan;0;0
31549;171615;75;71;39;3;36;.923;3600000;0
31549;174407;75;0;0;0;0;.00nan;0;0
31549;196414;4620;97;22;0;22;1.000;3600000;0
31549;181341;4620;0;0;0;0;.00nan;0;0
31550;4487;4922;94;38;2;36;.947;3556000;0
31550;189628;74;0;0;0;0;.00nan;0;0
31550;176136;74;80;26;1;25;.962;3600000;0
31550;86472;4922;0;0;0;0;.00nan;0;0
31551;173961;73;0;0;0;0;.00nan;0;0
31551;-1;73;68;38;4;34;.895;3600000;0
31551;85228;72;76;24;1;23;.958;3600000;0
31551;91212;72;0;0;0;0;.00nan;0;0
31552;-1;67;19;22;6;16;.727;2508000;0
31552;184049;1097;44;28;5;23;.821;3600000;0
31552;-1;1097;0;0;0;0;.00nan;0;0
31552;191698;67;52;10;1;9;.900;1065000;0
31553;178394;1095;44;27;4;23;.852;2631000;0
31553;-1;1095;17;8;4;4;.500;969000;0
31553;189885;4921;0;0;0;0;.00nan;0;0
31553;197912;4921;63;20;2;18;.900;3600000;0
31554;200572;157;0;0;0;0;.00nan;0;0
31554;174386;81;87;25;1;24;.960;3600000;0
31554;186451;81;0;0;0;0;.00nan;0;0
31554;77084;157;59;28;3;25;.893;3600000;0
31555;176060;2564;44;31;5;26;.839;3847000;0
31555;185800;71;0;0;0;0;.00nan;0;0
31555;65014;71;50;18;4;14;.778;3847000;0
31555;79141;2564;0;0;0;0;.00nan;0;0
31556;170351;149;0;0;0;0;.00nan;0;0
31556;170598;80;0;0;0;0;.00nan;0;0
31556;192629;80;100;38;1;37;.974;3600000;0
31556;85546;149;82;32;2;30;.938;3600000;0
31557;-1;76;71;26;2;24;.923;3600000;0
31557;184175;76;0;0;0;0;.00nan;0;0
31557;180873;77;79;40;3;37;.925;3544000;0
31557;85555;77;0;0;0;0;.00nan;0;0
31558;183737;78;94;44;2;42;.955;3600000;0
31558;194531;4920;0;0;0;0;.00nan;0;0
31558;176770;78;0;0;0;0;.00nan;0;0
31558;202246;4920;59;32;4;28;.875;3555000;0
31559;200390;1096;68;33;3;30;.909;3900000;0
31559;184049;1097;79;39;3;36;.923;3900000;0
31559;-1;1097;0;0;0;0;.00nan;0;0
31559;-1;1096;0;0;0;0;.00nan;0;0
31560;183755;69;56;18;2;16;.889;3600000;0
31560;179344;82;0;0;0;0;.00nan;0;0
31560;197047;82;96;60;4;56;.933;3548000;0
31560;58100;69;0;0;0;0;.00nan;0;0
31561;173874;158;0;0;0;0;.00nan;0;0
31561;-1;158;66;47;5;42;.894;3582000;0
31561;196525;151;62;37;4;33;.892;3600000;0
31561;85636;151;0;0;0;0;.00nan;0;0
31562;178394;1095;0;0;0;0;.00nan;0;0
31562;-1;1095;76;41;3;38;.927;3600000;0
31562;176060;2564;32;20;4;16;.800;3577000;0
31562;79141;2564;0;0;0;0;.00nan;0;0
31563;192895;85;0;0;0;0;.00nan;0;0
31563;-1;67;0;0;0;0;.00nan;0;0
31563;191698;67;25;38;8;30;.789;3600000;0
31563;148573;85;63;23;2;21;.913;3600000;0
31564;-1;152;0;0;0;0;.00nan;0;0
31564;200572;157;0;0;0;0;.00nan;0;0
31564;189944;152;92;31;1;30;.968;3600000;0
31564;77084;157;64;23;2;21;.913;3543000;0
31565;170351;149;0;0;0;0;.00nan;0;0
31565;170598;80;0;0;0;0;.00nan;0;0
31565;192629;80;86;28;1;27;.964;3774000;0
31565;85546;149;74;29;2;27;.931;3774000;0
31566;200390;1096;0;0;0;0;.00nan;0;0
31566;184049;1097;45;7;1;6;.857;850000;0
31566;-1;1097;21;23;6;17;.739;2750000;0
31566;-1;1096;74;40;4;36;.900;3600000;0
31567;173961;73;98;35;1;34;.971;3600000;0
31567;174386;81;0;0;0;0;.00nan;0;0
31567;186451;81;82;39;3;36;.923;3600000;0
31567;-1;73;0;0;0;0;.00nan;0;0
31568;185800;71;0;0;0;0;.00nan;0;0
31568;65014;71;71;36;3;33;.917;3586000;0
31568;85228;72;0;0;0;0;.00nan;0;0
31568;91212;72;68;15;1;14;.933;3600000;0
31569;189885;4921;0;0;0;0;.00nan;0;0
31569;176060;2564;77;28;2;26;.929;3600000;0
31569;197912;4921;53;33;5;28;.848;3600000;0
31569;79141;2564;0;0;0;0;.00nan;0;0
31570;173874;158;83;35;2;33;.943;3600000;0
31570;-1;158;0;0;0;0;.00nan;0;0
31570;196525;151;51;24;3;21;.875;3585000;0
31570;85636;151;0;0;0;0;.00nan;0;0
31571;192895;85;0;0;0;0;.00nan;0;0
31571;194899;4245;0;0;0;0;.00nan;0;0
31571;91398;4245;94;18;0;18;1.000;3600000;0
31571;148573;85;88;43;4;39;.907;3600000;0
31572;171615;75;0;0;0;0;.00nan;0;0
31572;174407;75;100;30;0;30;1.000;3600000;0
31572;180873;77;85;35;2;33;.943;3532000;0
31572;85555;77;0;0;0;0;.00nan;0;0
31573;189628;74;0;0;0;0;.00nan;0;0
31573;179344;82;0;0;0;0;.00nan;0;0
31573;176136;74;33;26;5;21;.808;3550000;0
31573;197047;82;62;28;3;25;.893;3600000;0
31574;170351;149;56;26;3;23;.885;3600000;0
31574;170598;80;27;28;6;22;.786;2286000;0
31574;192629;80;76;12;0;12;1.000;1314000;0
31574;85546;149;0;0;0;0;.00nan;0;0
31575;194531;4920;0;0;0;0;.00nan;0;0
31575;-1;67;0;0;0;0;.00nan;0;0
31575;202246;4920;75;27;2;25;.926;3600000;0
31575;191698;67;61;33;3;30;.909;3600000;0
31576;4487;4922;82;41;3;38;.927;3600000;0
31576;-1;76;0;0;0;0;.00nan;0;0
31576;184175;76;69;23;2;21;.913;3600000;0
31576;86472;4922;0;0;0;0;.00nan;0;0
31577;183755;69;82;25;1;24;.960;3600000;0
31577;178394;1095;0;0;0;0;.00nan;0;0
31577;-1;1095;52;38;5;33;.868;3600000;0
31577;58100;69;0;0;0;0;.00nan;0;0
31578;-1;152;0;0;0;0;.00nan;0;0
31578;200572;157;0;0;0;0;.00nan;0;0
31578;189944;152;84;27;1;26;.963;3900000;0
31578;77084;157;62;13;1;12;.923;3900000;0
31579;183737;78;0;0;0;0;.00nan;0;0
31579;176770;78;49;25;4;21;.840;3536000;0
31579;196414;4620;66;25;2;23;.920;3600000;0
31579;181341;4620;0;0;0;0;.00nan;0;0
31580;183755;69;0;0;0;0;.00nan;0;0
31580;178394;1095;49;36;5;31;.861;3600000;0
31580;-1;1095;0;0;0;0;.00nan;0;0
31580;58100;69;69;23;2;21;.913;3600000;0
31581;200390;1096;15;21;6;15;.714;3600000;0
31581;184049;1097;70;34;3;31;.912;3600000;0
31581;-1;1097;0;0;0;0;.00nan;0;0
31581;-1;1096;0;0;0;0;.00nan;0;0
31582;173961;73;0;0;0;0;.00nan;0;0
31582;-1;73;83;33;2;31;.939;3900000;0
31582;85228;72;69;25;2;23;.920;3900000;0
31582;91212;72;0;0;0;0;.00nan;0;0
31583;189885;4921;66;20;1;19;.950;3600000;0
31583;176060;2564;0;0;0;0;.00nan;0;0
31583;197912;4921;0;0;0;0;.00nan;0;0
31583;79141;2564;90;24;0;24;1.000;3600000;0
31584;173874;158;0;0;0;0;.00nan;0;0
31584;-1;158;56;16;1;15;.938;3579000;0
31584;196525;151;0;0;0;0;.00nan;0;0
31584;85636;151;100;31;0;31;1.000;3600000;0
31585;192895;85;79;38;3;35;.921;3524000;0
31585;194899;4245;0;0;0;0;.00nan;0;0
31585;91398;4245;100;33;1;32;.970;3600000;0
31585;148573;85;0;0;0;0;.00nan;0;0
31586;171615;75;0;0;0;0;.00nan;0;0
31586;174407;75;72;26;2;24;.923;3600000;0
31586;180873;77;0;0;0;0;.00nan;0;0
31586;85555;77;76;43;4;39;.907;3551000;0
31587;4487;4922;57;7;0;7;1.000;459000;0
31587;189628;74;86;33;2;31;.939;3600000;0
31587;176136;74;0;0;0;0;.00nan;0;0
31587;86472;4922;41;37;6;31;.838;3141000;0
31588;170351;149;0;0;0;0;.00nan;0;0
31588;170598;80;0;0;0;0;.00nan;0;0
31588;192629;80;71;20;1;19;.950;3600000;0
31588;85546;149;88;45;2;43;.956;3592000;0
31589;194531;4920;0;0;0;0;.00nan;0;0
31589;-1;67;87;39;2;37;.949;3600000;0
31589;202246;4920;32;23;5;18;.783;3600000;0
31589;191698;67;0;0;0;0;.00nan;0;0
31590;-1;76;58;29;3;26;.897;3600000;0
31590;184175;76;0;0;0;0;.00nan;0;0
31590;179344;82;0;0;0;0;.00nan;0;0
31590;197047;82;82;25;2;23;.920;3600000;0
31591;-1;152;88;49;3;46;.939;3600000;0
31591;200572;157;81;20;1;19;.950;3600000;0
31591;189944;152;0;0;0;0;.00nan;0;0
31591;77084;157;0;0;0;0;.00nan;0;0
31592;174386;81;47;19;3;16;.842;3600000;0
31592;185800;71;43;26;4;22;.846;3572000;0
31592;186451;81;0;0;0;0;.00nan;0;0
31592;65014;71;0;0;0;0;.00nan;0;0
31593;183737;78;55;41;6;35;.854;3138000;0
31593;176770;78;46;6;1;5;.833;462000;0
31593;196414;4620;0;0;0;0;.00nan;0;0
31593;181341;4620;61;20;1;19;.950;3600000;0
31594;173961;73;67;22;2;20;.909;3600000;0
31594;189885;4921;0;0;0;0;.00nan;0;0
31594;-1;73;0;0;0;0;.00nan;0;0
31594;197912;4921;52;39;5;34;.872;3600000;0
31595;-1;76;0;0;0;0;.00nan;0;0
31595;184175;76;67;20;2;18;.900;3635000;0
31595;179344;82;0;0;0;0;.00nan;0;0
31595;197047;82;86;37;3;34;.919;3635000;0
31596;183755;69;78;33;3;30;.909;3900000;0
31596;176060;2564;71;32;3;29;.906;3896000;0
31596;58100;69;0;0;0;0;.00nan;0;0
31596;79141;2564;0;0;0;0;.00nan;0;0
31597;192895;85;0;0;0;0;.00nan;0;0
31597;194899;4245;83;32;2;30;.938;3729000;0
31597;91398;4245;0;0;0;0;.00nan;0;0
31597;148573;85;94;49;3;46;.939;3729000;0
31598;4487;4922;81;29;2;27;.931;3580000;0
31598;189628;74;0;0;0;0;.00nan;0;0
31598;176136;74;90;35;1;34;.971;3600000;0
31598;86472;4922;0;0;0;0;.00nan;0;0
31599;174386;81;0;0;0;0;.00nan;0;0
31599;185800;71;0;0;0;0;.00nan;0;0
31599;186451;81;52;30;4;26;.867;3600000;0
31599;65014;71;100;37;0;37;1.000;3600000;0
31600;183737;78;0;0;0;0;.00nan;0;0
31600;194899;4245;0;0;0;0;.00nan;0;0
31600;176770;78;77;56;4;52;.929;3706000;0
31600;91398;4245;65;31;3;28;.903;3706000;0
31601;183755;69;70;30;2;28;.933;3600000;0
31601;200572;157;0;0;0;0;.00nan;0;0
31601;58100;69;0;0;0;0;.00nan;0;0
31601;77084;157;35;19;4;15;.789;3595000;0
31602;4487;4922;100;25;0;25;1.000;3600000;0
31602;179344;82;0;0;0;0;.00nan;0;0
31602;197047;82;91;31;1;30;.968;3600000;0
31602;86472;4922;0;0;0;0;.00nan;0;0
31603;173874;158;77;41;4;37;.902;3700000;0
31603;170351;149;0;0;0;0;.00nan;0;0
31603;-1;158;0;0;0;0;.00nan;0;0
31603;85546;149;56;23;3;20;.870;3700000;0
31604;-1;152;0;0;0;0;.00nan;0;0
31604;189944;152;80;50;5;45;.900;3600000;0
31604;196525;151;0;0;0;0;.00nan;0;0
31604;85636;151;79;36;3;33;.917;3600000;0
31605;-1;67;83;28;1;27;.964;3600000;0
31605;171615;75;0;0;0;0;.00nan;0;0
31605;174407;75;60;20;2;18;.900;3552000;0
31605;191698;67;0;0;0;0;.00nan;0;0
31606;-1;76;72;26;1;25;.962;3600000;0
31606;184175;76;0;0;0;0;.00nan;0;0
31606;180873;77;33;26;6;20;.769;2142000;0
31606;85555;77;50;27;4;23;.852;1458000;0
31607;183737;78;0;0;0;0;.00nan;0;0
31607;194899;4245;0;0;0;0;.00nan;0;0
31607;176770;78;80;51;4;47;.922;3900000;0
31607;91398;4245;62;34;4;30;.882;3900000;0
31608;4487;4922;29;30;6;24;.800;3248000;0
31608;180873;77;0;0;0;0;.00nan;0;0
31608;85555;77;73;27;2;25;.926;3600000;0
31608;86472;4922;55;5;0;5;1.000;352000;0
31609;183755;69;0;0;0;0;.00nan;0;0
31609;176060;2564;40;23;4;19;.826;3559000;0
31609;58100;69;91;51;3;48;.941;3600000;0
31609;79141;2564;0;0;0;0;.00nan;0;0
31610;200572;157;50;8;1;7;.875;720000;0
31610;173961;73;36;18;4;14;.778;3600000;0
31610;-1;73;0;0;0;0;.00nan;0;0
31610;77084;157;31;28;6;22;.786;2880000;0
31611;173874;158;100;36;1;35;.972;3694000;0
31611;170351;149;0;0;0;0;.00nan;0;0
31611;-1;158;0;0;0;0;.00nan;0;0
31611;85546;149;69;26;2;24;.923;3694000;0
31612;178394;1095;0;0;0;0;.00nan;0;0
31612;-1;1095;57;24;3;21;.875;3582000;0
31612;189885;4921;0;0;0;0;.00nan;0;0
31612;197912;4921;68;25;2;23;.920;3600000;0
31613;-1;152;73;21;1;20;.952;3600000;0
31613;189944;152;0;0;0;0;.00nan;0;0
31613;196525;151;91;43;2;41;.953;3546000;0
31613;85636;151;0;0;0;0;.00nan;0;0
31614;200390;1096;0;0;0;0;.00nan;0;0
31614;189628;74;0;0;0;0;.00nan;0;0
31614;176136;74;58;34;5;29;.853;3600000;0
31614;-1;1096;65;35;4;31;.886;3600000;0
31615;194531;4920;0;0;0;0;.00nan;0;0
31615;196414;4620;0;0;0;0;.00nan;0;0
31615;181341;4620;76;36;3;33;.917;3564000;0
31615;202246;4920;79;25;1;24;.960;3600000;0
31616;184049;1097;55;10;1;9;.900;3600000;0
31616;179344;82;0;0;0;0;.00nan;0;0
31616;-1;1097;0;0;0;0;.00nan;0;0
31616;197047;82;64;42;5;37;.881;3600000;0
31617;-1;67;0;0;0;0;.00nan;0;0
31617;171615;75;0;0;0;0;.00nan;0;0
31617;174407;75;63;42;5;37;.881;3613000;0
31617;191698;67;58;31;4;27;.871;3613000;0
31618;185800;71;0;0;0;0;.00nan;0;0
31618;65014;71;86;35;2;33;.943;3514000;0
31618;85228;72;0;0;0;0;.00nan;0;0
31618;91212;72;94;17;0;17;1.000;3600000;0
31619;183737;78;56;31;4;27;.871;3600000;0
31619;176770;78;0;0;0;0;.00nan;0;0
31619;196414;4620;86;28;1;27;.964;3600000;0
31619;181341;4620;0;0;0;0;.00nan;0;0
31620;4487;4922;81;34;2;32;.941;3600000;0
31620;179344;82;0;0;0;0;.00nan;0;0
31620;197047;82;70;45;5;40;.889;3600000;0
31620;86472;4922;0;0;0;0;.00nan;0;0
31621;200390;1096;82;27;1;26;.963;3600000;0
31621;189628;74;42;20;4;16;.800;3600000;0
31621;176136;74;0;0;0;0;.00nan;0;0
31621;-1;1096;0;0;0;0;.00nan;0;0
31622;200572;157;38;32;6;26;.813;3250000;0
31622;173961;73;0;0;0;0;.00nan;0;0
31622;-1;73;72;20;1;19;.950;3600000;0
31622;77084;157;59;8;0;8;1.000;350000;0
31623;173874;158;0;0;0;0;.00nan;0;0
31623;170351;149;0;0;0;0;.00nan;0;0
31623;-1;158;20;40;8;32;.800;3600000;0
31623;85546;149;64;25;2;23;.920;3600000;0
31624;176060;2564;0;0;0;0;.00nan;0;0
31624;79141;2564;74;35;3;32;.914;3600000;0
31624;85228;72;75;30;2;28;.933;3600000;0
31624;91212;72;0;0;0;0;.00nan;0;0
31625;178394;1095;0;0;0;0;.00nan;0;0
31625;-1;1095;65;20;2;18;.900;3600000;0
31625;189885;4921;71;42;5;37;.881;3600000;0
31625;197912;4921;0;0;0;0;.00nan;0;0
31626;-1;76;82;22;1;21;.955;3600000;0
31626;184175;76;0;0;0;0;.00nan;0;0
31626;180873;77;46;42;6;36;.857;3600000;0
31626;85555;77;0;0;0;0;.00nan;0;0
31627;-1;152;0;0;0;0;.00nan;0;0
31627;189944;152;54;29;4;25;.862;3600000;0
31627;196525;151;0;0;0;0;.00nan;0;0
31627;85636;151;100;22;0;22;1.000;3600000;0
31628;192895;85;0;0;0;0;.00nan;0;0
31628;194899;4245;78;27;1;26;.963;3600000;0
31628;91398;4245;0;0;0;0;.00nan;0;0
31628;148573;85;72;30;2;28;.933;3568000;0
31629;-1;67;85;39;3;36;.923;3900000;0
31629;171615;75;0;0;0;0;.00nan;0;0
31629;174407;75;76;35;3;32;.914;3900000;0
31629;191698;67;0;0;0;0;.00nan;0;0
31630;183755;69;72;27;2;25;.926;3600000;0
31630;185800;71;73;32;3;29;.906;3558000;0
31630;58100;69;0;0;0;0;.00nan;0;0
31630;65014;71;0;0;0;0;.00nan;0;0
31631;200572;157;0;0;0;0;.00nan;0;0
31631;173961;73;45;16;3;13;.813;3547000;0
31631;-1;73;0;0;0;0;.00nan;0;0
31631;77084;157;74;26;2;24;.923;3600000;0
31632;178394;1095;89;25;1;24;.960;3600000;0
31632;-1;1095;0;0;0;0;.00nan;0;0
31632;189885;4921;0;0;0;0;.00nan;0;0
31632;197912;4921;42;28;5;23;.821;3600000;0
31633;192895;85;56;33;5;28;.848;3553000;0
31633;183737;78;0;0;0;0;.00nan;0;0
31633;176770;78;53;30;4;26;.867;3600000;0
31633;148573;85;0;0;0;0;.00nan;0;0
31634;-1;76;0;0;0;0;.00nan;0;0
31634;184175;76;76;10;0;10;1.000;3600000;0
31634;179344;82;0;0;0;0;.00nan;0;0
31634;197047;82;95;45;2;43;.956;3600000;0
31635;170598;80;17;34;7;27;.794;3268000;0
31635;174386;81;100;38;1;37;.974;3600000;0
31635;186451;81;0;0;0;0;.00nan;0;0
31635;192629;80;61;8;0;8;1.000;332000;0
31636;-1;152;65;33;3;30;.909;3600000;0
31636;170351;149;0;0;0;0;.00nan;0;0
31636;189944;152;0;0;0;0;.00nan;0;0
31636;85546;149;75;30;2;28;.933;3600000;0
31637;4487;4922;61;23;2;21;.913;3542000;0
31637;179344;82;0;0;0;0;.00nan;0;0
31637;197047;82;100;30;0;30;1.000;3600000;0
31637;86472;4922;0;0;0;0;.00nan;0;0
31638;200390;1096;0;0;0;0;.00nan;0;0
31638;180873;77;0;0;0;0;.00nan;0;0
31638;-1;1096;76;26;1;25;.962;3600000;0
31638;85555;77;68;40;4;36;.900;3600000;0
31639;174386;81;0;0;0;0;.00nan;0;0
31639;196525;151;0;0;0;0;.00nan;0;0
31639;186451;81;99;34;1;33;.971;3600000;0
31639;85636;151;93;37;2;35;.946;3551000;0
31640;194531;4920;0;0;0;0;.00nan;0;0
31640;171615;75;69;37;4;33;.892;3600000;0
31640;174407;75;0;0;0;0;.00nan;0;0
31640;202246;4920;61;13;1;12;.923;3600000;0
31641;183737;78;0;0;0;0;.00nan;0;0
31641;-1;67;53;27;4;23;.852;3556000;0
31641;176770;78;83;30;2;28;.933;3600000;0
31641;191698;67;0;0;0;0;.00nan;0;0
31642;173961;73;47;33;5;28;.848;3560000;0
31642;189885;4921;0;0;0;0;.00nan;0;0
31642;-1;73;0;0;0;0;.00nan;0;0
31642;197912;4921;60;33;4;29;.879;3600000;0
31643;-1;76;0;0;0;0;.00nan;0;0
31643;184175;76;48;19;3;16;.842;3550000;0
31643;189628;74;0;0;0;0;.00nan;0;0
31643;176136;74;94;45;2;43;.956;3600000;0
31644;192895;85;0;0;0;0;.00nan;0;0
31644;183737;78;0;0;0;0;.00nan;0;0
31644;176770;78;75;29;3;26;.897;3566000;0
31644;148573;85;70;31;2;29;.935;3600000;0
31645;-1;152;0;0;0;0;.00nan;0;0
31645;170351;149;0;0;0;0;.00nan;0;0
31645;189944;152;100;41;1;40;.976;3600000;0
31645;85546;149;57;26;3;23;.885;3516000;0
31646;183755;69;53;44;6;38;.864;3600000;0
31646;185800;71;0;0;0;0;.00nan;0;0
31646;58100;69;0;0;0;0;.00nan;0;0
31646;65014;71;70;22;1;21;.955;3600000;0
31647;189628;74;27;27;6;21;.778;3600000;0
31647;179344;82;74;27;2;25;.926;3600000;0
31647;176136;74;0;0;0;0;.00nan;0;0
31647;197047;82;0;0;0;0;.00nan;0;0
31648;200572;157;0;0;0;0;.00nan;0;0
31648;173874;158;95;35;0;35;1.000;3900000;0
31648;-1;158;0;0;0;0;.00nan;0;0
31648;77084;157;85;16;0;16;1.000;3900000;0
31649;173961;73;0;0;0;0;.00nan;0;0
31649;189885;4921;88;32;1;31;.969;3600000;0
31649;-1;73;45;20;3;17;.850;3536000;0
31649;197912;4921;0;0;0;0;.00nan;0;0
31650;184049;1097;20;21;6;15;.714;3900000;0
31650;180873;77;49;37;6;31;.838;2828000;0
31650;-1;1097;0;0;0;0;.00nan;0;0
31650;85555;77;85;19;0;19;1.000;1072000;0
31651;176060;2564;84;29;2;27;.931;3900000;0
31651;79141;2564;0;0;0;0;.00nan;0;0
31651;85228;72;90;33;2;31;.939;3900000;0
31651;91212;72;0;0;0;0;.00nan;0;0
31652;194531;4920;0;0;0;0;.00nan;0;0
31652;171615;75;0;0;0;0;.00nan;0;0
31652;174407;75;79;41;3;38;.927;3600000;0
31652;202246;4920;100;27;0;27;1.000;3600000;0
31653;-1;76;72;29;2;27;.931;3561000;0
31653;200390;1096;0;0;0;0;.00nan;0;0
31653;184175;76;0;0;0;0;.00nan;0;0
31653;-1;1096;63;15;1;14;.933;3600000;0
31654;174386;81;89;19;0;19;1.000;3600000;0
31654;196525;151;62;43;5;38;.884;3600000;0
31654;186451;81;0;0;0;0;.00nan;0;0
31654;85636;151;0;0;0;0;.00nan;0;0
31655;-1;67;64;9;0;9;1.000;1021000;0
31655;196414;4620;0;0;0;0;.00nan;0;0
31655;181341;4620;48;31;5;26;.839;3600000;0
31655;191698;67;37;43;7;36;.837;2579000;0
31656;183737;78;82;26;1;25;.962;3600000;0
31656;-1;67;38;15;3;12;.800;574000;0
31656;176770;78;0;0;0;0;.00nan;0;0
31656;191698;67;80;22;0;22;1.000;3026000;0
31657;-1;152;93;44;2;42;.955;3900000;0
31657;170351;149;0;0;0;0;.00nan;0;0
31657;189944;152;0;0;0;0;.00nan;0;0
31657;85546;149;81;32;2;30;.938;3900000;0
31658;4487;4922;55;19;2;17;.895;3600000;0
31658;189628;74;0;0;0;0;.00nan;0;0
31658;176136;74;68;39;4;35;.897;3587000;0
31658;86472;4922;0;0;0;0;.00nan;0;0
31659;-1;76;0;0;0;0;.00nan;0;0
31659;184175;76;81;27;1;26;.963;3600000;0
31659;179344;82;0;0;0;0;.00nan;0;0
31659;197047;82;55;34;4;30;.882;3600000;0
31660;173961;73;57;36;4;32;.889;3600000;0
31660;189885;4921;0;0;0;0;.00nan;0;0
31660;-1;73;0;0;0;0;.00nan;0;0
31660;197912;4921;49;23;3;20;.870;3600000;0
31661;176060;2564;0;0;0;0;.00nan;0;0
31661;79141;2564;86;40;2;38;.950;3600000;0
31661;85228;72;0;0;0;0;.00nan;0;0
31661;91212;72;77;21;1;20;.952;3600000;0
31662;194531;4920;0;0;0;0;.00nan;0;0
31662;171615;75;0;0;0;0;.00nan;0;0
31662;174407;75;67;43;5;38;.884;3550000;0
31662;202246;4920;50;20;3;17;.850;3600000;0
31663;200390;1096;81;36;2;34;.944;3760000;0
31663;184049;1097;0;0;0;0;.00nan;0;0
31663;-1;1097;56;27;3;24;.889;3760000;0
31663;-1;1096;0;0;0;0;.00nan;0;0
31664;183755;69;0;0;0;0;.00nan;0;0
31664;178394;1095;46;20;3;17;.850;3543000;0
31664;-1;1095;0;0;0;0;.00nan;0;0
31664;58100;69;81;32;2;30;.938;3600000;0
31665;200572;157;0;0;0;0;.00nan;0;0
31665;173874;158;54;25;3;22;.880;3600000;0
31665;-1;158;0;0;0;0;.00nan;0;0
31665;77084;157;67;16;1;15;.938;3600000;0
31666;170598;80;0;0;0;0;.00nan;0;0
31666;174386;81;0;0;0;0;.00nan;0;0
31666;186451;81;100;28;0;28;1.000;3600000;0
31666;192629;80;96;50;2;48;.960;3536000;0
31667;192895;85;64;32;4;28;.875;3600000;0
31667;196414;4620;87;19;0;19;1.000;3600000;0
31667;181341;4620;0;0;0;0;.00nan;0;0
31667;148573;85;0;0;0;0;.00nan;0;0
31668;185800;71;0;0;0;0;.00nan;0;0
31668;65014;71;89;35;2;33;.943;3552000;0
31668;85228;72;78;24;1;23;.958;3600000;0
31668;91212;72;0;0;0;0;.00nan;0;0
31669;173961;73;87;17;0;17;1.000;3600000;0
31669;176060;2564;71;27;2;25;.926;3554000;0
31669;-1;73;0;0;0;0;.00nan;0;0
31669;79141;2564;0;0;0;0;.00nan;0;0
31670;183755;69;71;37;4;33;.892;3520000;0
31670;-1;1095;0;0;0;0;.00nan;0;0
31670;58100;69;0;0;0;0;.00nan;0;0
31670;78479;1095;59;22;2;20;.909;3600000;0
31671;-1;67;0;0;0;0;.00nan;0;0
31671;194899;4245;0;0;0;0;.00nan;0;0
31671;191698;67;86;44;3;41;.932;3600000;0
31671;91398;4245;84;37;5;32;.865;3560000;0
31672;192895;85;0;0;0;0;.00nan;0;0
31672;196414;4620;67;27;2;25;.926;3572000;0
31672;181341;4620;0;0;0;0;.00nan;0;0
31672;148573;85;99;46;1;45;.978;3600000;0
31673;183755;69;0;0;0;0;.00nan;0;0
31673;180873;77;0;0;0;0;.00nan;0;0
31673;58100;69;54;38;5;33;.868;3511000;0
31673;85555;77;71;30;3;27;.900;3600000;0
31674;200390;1096;0;0;0;0;.00nan;0;0
31674;179344;82;80;43;3;40;.930;3600000;0
31674;-1;1096;47;12;2;10;.833;3600000;0
31674;197047;82;0;0;0;0;.00nan;0;0
31675;184049;1097;55;37;5;32;.865;3562000;0
31675;189628;74;0;0;0;0;.00nan;0;0
31675;176136;74;63;36;4;32;.889;3600000;0
31675;-1;1097;0;0;0;0;.00nan;0;0
31676;-1;152;0;0;0;0;.00nan;0;0
31676;173874;158;54;24;4;20;.833;3600000;0
31676;189944;152;98;46;1;45;.978;3600000;0
31676;-1;158;0;0;0;0;.00nan;0;0
31677;4487;4922;0;0;0;0;.00nan;0;0
31677;-1;76;0;0;0;0;.00nan;0;0
31677;184175;76;62;37;4;33;.892;3598000;0
31677;86472;4922;90;46;3;43;.935;3600000;0
31678;200390;1096;36;21;4;17;.810;3623000;0
31678;179344;82;0;0;0;0;.00nan;0;0
31678;-1;1096;0;0;0;0;.00nan;0;0
31678;197047;82;68;43;5;38;.884;3623000;0
31679;173961;73;38;23;4;19;.826;3600000;0
31679;171615;75;0;0;0;0;.00nan;0;0
31679;174407;75;89;34;2;32;.941;3600000;0
31679;-1;73;0;0;0;0;.00nan;0;0
31680;180873;77;62;37;4;33;.892;3900000;0
31680;85228;72;0;0;0;0;.00nan;0;0
31680;85555;77;0;0;0;0;.00nan;0;0
31680;91212;72;64;28;4;24;.857;3900000;0
31681;-1;1095;30;29;6;23;.793;3543000;0
31681;176060;2564;38;8;3;5;.625;396000;0
31681;78479;1095;0;0;0;0;.00nan;0;0
31681;79141;2564;76;24;2;22;.917;3204000;0
31682;192895;85;0;0;0;0;.00nan;0;0
31682;183737;78;0;0;0;0;.00nan;0;0
31682;176770;78;59;30;3;27;.900;3782000;0
31682;148573;85;98;40;2;38;.950;3782000;0
31683;184049;1097;0;0;0;0;.00nan;0;0
31683;189628;74;65;42;5;37;.881;3600000;0
31683;176136;74;0;0;0;0;.00nan;0;0
31683;-1;1097;91;31;1;30;.968;3600000;0
31684;163989;149;100;29;0;29;1.000;3600000;0
31684;189885;4921;0;0;0;0;.00nan;0;0
31684;197912;4921;97;43;1;42;.977;3555000;0
31684;85546;149;0;0;0;0;.00nan;0;0
31685;194531;4920;70;29;2;27;.931;3600000;0
31685;196414;4620;0;0;0;0;.00nan;0;0
31685;181341;4620;72;44;4;40;.909;3600000;0
31685;202246;4920;0;0;0;0;.00nan;0;0
31686;-1;67;63;32;3;29;.906;3578000;0
31686;194899;4245;0;0;0;0;.00nan;0;0
31686;191698;67;0;0;0;0;.00nan;0;0
31686;91398;4245;86;35;2;33;.943;3600000;0
31687;200572;157;0;0;0;0;.00nan;0;0
31687;174386;81;0;0;0;0;.00nan;0;0
31687;186451;81;100;28;0;28;1.000;3600000;0
31687;77084;157;76;30;2;28;.933;3548000;0
31688;170598;80;0;0;0;0;.00nan;0;0
31688;196525;151;86;27;1;26;.963;3600000;0
31688;192629;80;70;21;2;19;.905;3600000;0
31688;85636;151;0;0;0;0;.00nan;0;0
31689;183737;78;67;25;2;23;.920;3900000;0
31689;194899;4245;77;27;2;25;.926;3900000;0
31689;176770;78;0;0;0;0;.00nan;0;0
31689;91398;4245;0;0;0;0;.00nan;0;0
31690;-1;152;78;31;3;28;.903;3600000;0
31690;173874;158;0;0;0;0;.00nan;0;0
31690;189944;152;0;0;0;0;.00nan;0;0
31690;-1;158;61;23;2;21;.913;3600000;0
31691;4487;4922;30;33;6;27;.818;3586000;0
31691;-1;76;72;36;4;32;.889;3600000;0
31691;184175;76;0;0;0;0;.00nan;0;0
31691;86472;4922;0;0;0;0;.00nan;0;0
31692;173961;73;0;0;0;0;.00nan;0;0
31692;-1;73;88;39;2;37;.949;3549000;0
31692;85228;72;98;26;0;26;1.000;3600000;0
31692;91212;72;0;0;0;0;.00nan;0;0
31693;192895;85;92;33;1;32;.970;3600000;0
31693;-1;67;0;0;0;0;.00nan;0;0
31693;191698;67;61;26;3;23;.885;3560000;0
31693;148573;85;0;0;0;0;.00nan;0;0
31694;163989;149;52;25;4;21;.840;3520000;0
31694;189885;4921;73;34;2;32;.941;3600000;0
31694;197912;4921;0;0;0;0;.00nan;0;0
31694;85546;149;0;0;0;0;.00nan;0;0
31695;194531;4920;0;0;0;0;.00nan;0;0
31695;196414;4620;58;43;6;37;.860;3600000;0
31695;181341;4620;0;0;0;0;.00nan;0;0
31695;202246;4920;97;36;2;34;.944;3600000;0
31696;184049;1097;58;27;4;23;.852;3864000;0
31696;189628;74;0;0;0;0;.00nan;0;0
31696;176136;74;78;48;4;44;.917;3900000;0
31696;-1;1097;0;0;0;0;.00nan;0;0
31697;183755;69;50;31;4;27;.871;3600000;0
31697;-1;1095;76;27;1;26;.963;3600000;0
31697;58100;69;0;0;0;0;.00nan;0;0
31697;78479;1095;0;0;0;0;.00nan;0;0
31698;200572;157;91;36;2;34;.944;3600000;0
31698;174386;81;0;0;0;0;.00nan;0;0
31698;186451;81;55;30;4;26;.867;3600000;0
31698;77084;157;0;0;0;0;.00nan;0;0
31699;171615;75;0;0;0;0;.00nan;0;0
31699;174407;75;100;42;1;41;.976;3600000;0
31699;185800;71;0;0;0;0;.00nan;0;0
31699;65014;71;61;21;2;19;.905;3547000;0
31700;170598;80;73;38;3;35;.921;3751000;0
31700;196525;151;0;0;0;0;.00nan;0;0
31700;192629;80;0;0;0;0;.00nan;0;0
31700;85636;151;58;28;4;24;.857;3751000;0
31701;183737;78;0;0;0;0;.00nan;0;0
31701;194899;4245;0;0;0;0;.00nan;0;0
31701;176770;78;47;34;5;29;.853;3600000;0
31701;91398;4245;82;25;1;24;.960;3600000;0
31702;-1;152;0;0;0;0;.00nan;0;0
31702;173874;158;69;21;1;20;.952;3600000;0
31702;189944;152;70;39;4;35;.897;3600000;0
31702;-1;158;0;0;0;0;.00nan;0;0
31703;183755;69;0;0;0;0;.00nan;0;0
31703;180873;77;0;0;0;0;.00nan;0;0
31703;58100;69;77;29;2;27;.931;3600000;0
31703;85555;77;66;27;3;24;.889;3570000;0
31704;-1;1095;0;0;0;0;.00nan;0;0
31704;173961;73;100;44;2;42;.955;3803000;0
31704;-1;73;0;0;0;0;.00nan;0;0
31704;78479;1095;58;20;3;17;.850;3803000;0
31705;200390;1096;38;13;3;10;.769;1586000;0
31705;179344;82;68;36;4;32;.889;3600000;0
31705;-1;1096;18;15;5;10;.667;2014000;0
31705;197047;82;0;0;0;0;.00nan;0;0
31706;176060;2564;43;38;6;32;.842;3160000;0
31706;79141;2564;51;2;0;2;1.000;384000;0
31706;85228;72;45;31;5;26;.839;3600000;0
31706;91212;72;0;0;0;0;.00nan;0;0
31707;170598;80;36;21;4;17;.810;3900000;0
31707;196525;151;75;37;4;33;.892;3900000;0
31707;192629;80;0;0;0;0;.00nan;0;0
31707;85636;151;0;0;0;0;.00nan;0;0
31708;163989;149;59;47;6;41;.872;3598000;0
31708;189885;4921;0;0;0;0;.00nan;0;0
31708;197912;4921;49;33;5;28;.848;3600000;0
31708;85546;149;0;0;0;0;.00nan;0;0
31709;194531;4920;49;25;3;22;.880;3578000;0
31709;196414;4620;0;0;0;0;.00nan;0;0
31709;181341;4620;100;31;1;30;.968;3600000;0
31709;202246;4920;0;0;0;0;.00nan;0;0
31710;4487;4922;45;18;3;15;.833;1742000;0
31710;-1;76;0;0;0;0;.00nan;0;0
31710;184175;76;65;14;1;13;.929;3600000;0
31710;86472;4922;25;17;5;12;.706;1858000;0
31711;200572;157;0;0;0;0;.00nan;0;0
31711;174386;81;93;22;0;22;1.000;3600000;0
31711;186451;81;0;0;0;0;.00nan;0;0
31711;77084;157;25;20;5;15;.750;3600000;0
31712;171615;75;0;0;0;0;.00nan;0;0
31712;174407;75;79;44;4;40;.909;3523000;0
31712;185800;71;51;15;2;13;.867;3600000;0
31712;65014;71;0;0;0;0;.00nan;0;0
31713;-1;152;0;0;0;0;.00nan;0;0
31713;174386;81;80;15;0;15;1.000;3600000;0
31713;189944;152;92;43;2;41;.953;3516000;0
31713;186451;81;0;0;0;0;.00nan;0;0
31714;4487;4922;40;32;6;26;.813;3600000;0
31714;200390;1096;0;0;0;0;.00nan;0;0
31714;-1;1096;59;21;2;19;.905;3600000;0
31714;86472;4922;0;0;0;0;.00nan;0;0
31715;194531;4920;0;0;0;0;.00nan;0;0
31715;173874;158;0;0;0;0;.00nan;0;0
31715;-1;158;84;43;3;40;.930;3600000;0
31715;202246;4920;100;17;0;17;1.000;3600000;0
31716;189628;74;0;0;0;0;.00nan;0;0
31716;176136;74;85;31;2;29;.935;3600000;0
31716;180873;77;0;0;0;0;.00nan;0;0
31716;85555;77;74;32;3;29;.906;3600000;0
31717;173961;73;64;42;4;38;.905;3600000;0
31717;176060;2564;0;0;0;0;.00nan;0;0
31717;-1;73;0;0;0;0;.00nan;0;0
31717;79141;2564;80;40;3;37;.925;3600000;0
31718;183737;78;0;0;0;0;.00nan;0;0
31718;-1;67;0;0;0;0;.00nan;0;0
31718;176770;78;76;24;2;22;.917;3589000;0
31718;191698;67;100;39;0;39;1.000;3600000;0
31719;192895;85;0;0;0;0;.00nan;0;0
31719;183737;78;0;0;0;0;.00nan;0;0
31719;176770;78;57;14;2;12;.857;3600000;0
31719;148573;85;74;37;3;34;.919;3552000;0
31720;4487;4922;87;26;1;25;.962;3754000;0
31720;200390;1096;0;0;0;0;.00nan;0;0
31720;-1;1096;82;15;0;15;1.000;3754000;0
31720;86472;4922;0;0;0;0;.00nan;0;0
31721;184049;1097;61;24;3;21;.875;3600000;0
31721;179344;82;0;0;0;0;.00nan;0;0
31721;-1;1097;0;0;0;0;.00nan;0;0
31721;197047;82;37;35;6;29;.829;3600000;0
31722;194531;4920;0;0;0;0;.00nan;0;0
31722;173874;158;52;30;4;26;.867;3546000;0
31722;-1;158;0;0;0;0;.00nan;0;0
31722;202246;4920;82;31;2;29;.935;3600000;0
31723;-1;76;0;0;0;0;.00nan;0;0
31723;184175;76;54;24;3;21;.875;3600000;0
31723;180873;77;26;29;6;23;.793;3144000;0
31723;85555;77;55;4;0;4;1.000;456000;0
31724;183755;69;84;31;2;29;.935;3600000;0
31724;176060;2564;0;0;0;0;.00nan;0;0
31724;58100;69;0;0;0;0;.00nan;0;0
31724;79141;2564;40;30;5;25;.833;3600000;0
31725;200572;157;0;0;0;0;.00nan;0;0
31725;194899;4245;0;0;0;0;.00nan;0;0
31725;77084;157;84;35;3;32;.914;3577000;0
31725;91398;4245;59;22;2;20;.909;3600000;0
31726;171615;75;0;0;0;0;.00nan;0;0
31726;174407;75;64;45;5;40;.889;3600000;0
31726;85228;72;78;29;1;28;.966;3600000;0
31726;91212;72;0;0;0;0;.00nan;0;0
31727;189628;74;0;0;0;0;.00nan;0;0
31727;176136;74;100;33;0;33;1.000;3600000;0
31727;185800;71;0;0;0;0;.00nan;0;0
31727;65014;71;78;25;1;24;.960;3583000;0
31728;-1;1095;100;36;1;35;.972;3600000;0
31728;173961;73;49;17;3;14;.824;3600000;0
31728;-1;73;0;0;0;0;.00nan;0;0
31728;78479;1095;0;0;0;0;.00nan;0;0
31729;163989;149;100;30;0;30;1.000;3600000;0
31729;174386;81;77;28;2;26;.929;3534000;0
31729;186451;81;0;0;0;0;.00nan;0;0
31729;85546;149;0;0;0;0;.00nan;0;0
31730;-1;152;0;0;0;0;.00nan;0;0
31730;170598;80;0;0;0;0;.00nan;0;0
31730;189944;152;59;32;4;28;.875;3600000;0
31730;192629;80;89;25;1;24;.960;3600000;0
31731;-1;67;0;0;0;0;.00nan;0;0
31731;196414;4620;0;0;0;0;.00nan;0;0
31731;181341;4620;82;17;0;17;1.000;3600000;0
31731;191698;67;64;39;5;34;.872;3600000;0
31732;183755;69;0;0;0;0;.00nan;0;0
31732;-1;1095;0;0;0;0;.00nan;0;0
31732;58100;69;100;26;0;26;1.000;3600000;0
31732;78479;1095;69;35;4;31;.886;3600000;0
31733;173961;73;0;0;0;0;.00nan;0;0
31733;189885;4921;0;0;0;0;.00nan;0;0
31733;-1;73;56;32;4;28;.875;3600000;0
31733;197912;4921;92;43;1;42;.977;3600000;0
31734;200390;1096;0;0;0;0;.00nan;0;0
31734;179344;82;72;28;2;26;.929;3521000;0
31734;-1;1096;100;33;0;33;1.000;3600000;0
31734;197047;82;0;0;0;0;.00nan;0;0
31735;194531;4920;52;16;2;14;.875;3600000;0
31735;173874;158;0;0;0;0;.00nan;0;0
31735;-1;158;74;36;3;33;.917;3600000;0
31735;202246;4920;0;0;0;0;.00nan;0;0
31736;192895;85;74;30;3;27;.900;3597000;0
31736;183737;78;82;35;2;33;.943;3600000;0
31736;176770;78;0;0;0;0;.00nan;0;0
31736;148573;85;0;0;0;0;.00nan;0;0
31737;200572;157;62;32;4;28;.875;3600000;0
31737;194899;4245;71;25;2;23;.920;3600000;0
31737;77084;157;0;0;0;0;.00nan;0;0
31737;91398;4245;0;0;0;0;.00nan;0;0
31738;171615;75;41;35;6;29;.829;3262000;0
31738;174407;75;53;2;0;2;1.000;338000;0
31738;85228;72;0;0;0;0;.00nan;0;0
31738;91212;72;76;23;2;21;.913;3600000;0
31739;189628;74;0;0;0;0;.00nan;0;0
31739;176136;74;63;33;4;29;.879;3600000;0
31739;185800;71;26;12;4;8;.667;646000;0
31739;65014;71;54;18;2;16;.889;2940000;0
31740;-1;76;83;23;1;22;.957;3600000;0
31740;184175;76;0;0;0;0;.00nan;0;0
31740;180873;77;58;6;0;6;1.000;826000;0
31740;85555;77;56;40;6;34;.850;2774000;0
31741;4487;4922;90;57;5;52;.912;3569000;0
31741;184049;1097;0;0;0;0;.00nan;0;0
31741;-1;1097;64;29;3;26;.897;3600000;0
31741;86472;4922;0;0;0;0;.00nan;0;0
31742;163989;149;84;42;4;38;.905;3657000;0
31742;174386;81;0;0;0;0;.00nan;0;0
31742;186451;81;61;19;3;16;.842;3657000;0
31742;85546;149;0;0;0;0;.00nan;0;0
31743;-1;152;78;51;4;47;.922;3600000;0
31743;170598;80;56;13;1;12;.923;3600000;0
31743;189944;152;0;0;0;0;.00nan;0;0
31743;192629;80;0;0;0;0;.00nan;0;0
31744;-1;67;70;21;1;20;.952;3600000;0
31744;196414;4620;0;0;0;0;.00nan;0;0
31744;181341;4620;65;31;3;28;.903;3578000;0
31744;191698;67;0;0;0;0;.00nan;0;0
31745;183737;78;0;0;0;0;.00nan;0;0
31745;-1;67;0;0;0;0;.00nan;0;0
31745;176770;78;95;42;3;39;.929;3703000;0
31745;191698;67;58;34;4;30;.882;3703000;0
31746;4487;4922;75;38;3;35;.921;3560000;0
31746;180873;77;79;23;2;21;.913;3600000;0
31746;85555;77;0;0;0;0;.00nan;0;0
31746;86472;4922;0;0;0;0;.00nan;0;0
31747;173961;73;69;25;2;23;.920;3600000;0
31747;189885;4921;55;35;5;30;.857;3600000;0
31747;-1;73;0;0;0;0;.00nan;0;0
31747;197912;4921;0;0;0;0;.00nan;0;0
31748;192895;85;60;16;2;14;.875;664000;0
31748;196414;4620;38;17;4;13;.765;3600000;0
31748;181341;4620;0;0;0;0;.00nan;0;0
31748;148573;85;35;34;6;28;.824;2936000;0
31749;200572;157;0;0;0;0;.00nan;0;0
31749;194899;4245;0;0;0;0;.00nan;0;0
31749;77084;157;73;33;3;30;.909;3600000;0
31749;91398;4245;100;22;0;22;1.000;3600000;0
31750;171615;75;0;0;0;0;.00nan;0;0
31750;174407;75;89;39;2;37;.949;3581000;0
31750;85228;72;78;21;1;20;.952;3600000;0
31750;91212;72;0;0;0;0;.00nan;0;0
31751;189628;74;80;36;2;34;.944;3571000;0
31751;176136;74;0;0;0;0;.00nan;0;0
31751;185800;71;73;25;1;24;.960;3600000;0
31751;65014;71;0;0;0;0;.00nan;0;0
31752;184049;1097;81;37;3;34;.919;3600000;0
31752;179344;82;0;0;0;0;.00nan;0;0
31752;-1;1097;0;0;0;0;.00nan;0;0
31752;197047;82;58;35;5;30;.857;3573000;0
31753;183755;69;0;0;0;0;.00nan;0;0
31753;-1;1095;79;41;3;38;.927;3600000;0
31753;58100;69;67;30;4;26;.867;3571000;0
31753;78479;1095;0;0;0;0;.00nan;0;0
31754;163989;149;97;44;2;42;.955;3600000;0
31754;174386;81;53;29;4;25;.862;3540000;0
31754;186451;81;0;0;0;0;.00nan;0;0
31754;85546;149;0;0;0;0;.00nan;0;0
31755;-1;152;0;0;0;0;.00nan;0;0
31755;170598;80;0;0;0;0;.00nan;0;0
31755;189944;152;83;53;5;48;.906;3600000;0
31755;192629;80;55;17;2;15;.882;3600000;0
31756;-1;152;78;40;3;37;.925;3578000;0
31756;200572;157;0;0;0;0;.00nan;0;0
31756;189944;152;0;0;0;0;.00nan;0;0
31756;77084;157;92;34;2;32;.941;3600000;0
31757;-1;76;0;0;0;0;.00nan;0;0
31757;200390;1096;0;0;0;0;.00nan;0;0
31757;184175;76;74;37;2;35;.946;3544000;0
31757;-1;1096;80;26;1;25;.962;3600000;0
31758;189628;74;0;0;0;0;.00nan;0;0
31758;179344;82;71;34;3;31;.912;3900000;0
31758;176136;74;53;21;3;18;.857;3900000;0
31758;197047;82;0;0;0;0;.00nan;0;0
31759;173874;158;93;35;2;33;.943;3600000;0
31759;-1;158;0;0;0;0;.00nan;0;0
31759;196525;151;33;25;6;19;.760;2453000;0
31759;85636;151;58;13;1;12;.923;1147000;0
31760;-1;1095;0;0;0;0;.00nan;0;0
31760;78479;1095;83;43;3;40;.930;3600000;0
31760;85228;72;95;16;0;16;1.000;3600000;0
31760;91212;72;0;0;0;0;.00nan;0;0
31761;192895;85;0;0;0;0;.00nan;0;0
31761;-1;67;49;28;4;24;.857;3556000;0
31761;191698;67;0;0;0;0;.00nan;0;0
31761;148573;85;95;33;2;31;.939;3600000;0
31762;163989;149;69;28;3;25;.893;3600000;0
31762;173961;73;48;23;4;19;.826;3600000;0
31762;-1;73;0;0;0;0;.00nan;0;0
31762;85546;149;0;0;0;0;.00nan;0;0
31763;183737;78;0;0;0;0;.00nan;0;0
31763;194899;4245;0;0;0;0;.00nan;0;0
31763;176770;78;85;33;2;31;.939;3600000;0
31763;91398;4245;66;26;3;23;.885;3572000;0
31764;-1;152;95;26;0;26;1.000;3900000;0
31764;200572;157;0;0;0;0;.00nan;0;0
31764;189944;152;0;0;0;0;.00nan;0;0
31764;77084;157;97;27;0;27;1.000;3900000;0
31765;-1;76;0;0;0;0;.00nan;0;0
31765;200390;1096;0;0;0;0;.00nan;0;0
31765;184175;76;51;28;4;24;.857;3590000;0
31765;-1;1096;77;34;2;32;.941;3600000;0
31766;189628;74;0;0;0;0;.00nan;0;0
31766;179344;82;0;0;0;0;.00nan;0;0
31766;176136;74;75;28;2;26;.929;3547000;0
31766;197047;82;100;39;1;38;.974;3600000;0
31767;173874;158;35;26;6;20;.769;3516000;0
31767;-1;158;0;0;0;0;.00nan;0;0
31767;196525;151;57;33;4;29;.879;3600000;0
31767;85636;151;0;0;0;0;.00nan;0;0
31768;184049;1097;62;25;3;22;.880;3600000;0
31768;180873;77;0;0;0;0;.00nan;0;0
31768;-1;1097;0;0;0;0;.00nan;0;0
31768;85555;77;53;49;7;42;.857;3600000;0
31769;-1;1095;64;51;6;45;.882;3350000;0
31769;176060;2564;0;0;0;0;.00nan;0;0
31769;78479;1095;47;5;1;4;.800;250000;0
31769;79141;2564;59;17;2;15;.882;3600000;0
31770;163989;149;64;30;3;27;.900;3600000;0
31770;173961;73;47;26;4;22;.846;3559000;0
31770;-1;73;0;0;0;0;.00nan;0;0
31770;85546;149;0;0;0;0;.00nan;0;0
31771;192895;85;0;0;0;0;.00nan;0;0
31771;194531;4920;0;0;0;0;.00nan;0;0
31771;202246;4920;60;14;1;13;.929;3600000;0
31771;148573;85;82;38;2;36;.947;3600000;0
31772;4487;4922;38;31;6;25;.806;2633000;0
31772;-1;67;0;0;0;0;.00nan;0;0
31772;191698;67;39;15;3;12;.800;3600000;0
31772;86472;4922;52;17;2;15;.882;967000;0
31773;189885;4921;0;0;0;0;.00nan;0;0
31773;174386;81;0;0;0;0;.00nan;0;0
31773;186451;81;74;34;3;31;.912;3600000;0
31773;197912;4921;50;31;4;27;.871;3551000;0
31774;185800;71;0;0;0;0;.00nan;0;0
31774;65014;71;73;16;1;15;.938;3600000;0
31774;85228;72;55;37;5;32;.865;3600000;0
31774;91212;72;0;0;0;0;.00nan;0;0
31775;183755;69;29;30;6;24;.800;3553000;0
31775;170598;80;79;44;4;40;.909;3600000;0
31775;192629;80;0;0;0;0;.00nan;0;0
31775;58100;69;0;0;0;0;.00nan;0;0
31776;171615;75;0;0;0;0;.00nan;0;0
31776;174407;75;53;37;6;31;.838;3600000;0
31776;196414;4620;0;0;0;0;.00nan;0;0
31776;181341;4620;77;22;1;21;.955;3600000;0
31777;-1;152;68;28;2;26;.929;1771000;0
31777;200572;157;0;0;0;0;.00nan;0;0
31777;189944;152;24;11;4;7;.636;1829000;0
31777;77084;157;69;25;2;23;.920;3600000;0
31778;-1;76;43;29;4;25;.862;3584000;0
31778;200390;1096;81;37;3;34;.919;3600000;0
31778;184175;76;0;0;0;0;.00nan;0;0
31778;-1;1096;0;0;0;0;.00nan;0;0
31779;173874;158;0;0;0;0;.00nan;0;0
31779;-1;158;51;31;4;27;.871;3600000;0
31779;196525;151;0;0;0;0;.00nan;0;0
31779;85636;151;89;25;1;24;.960;3600000;0
31780;179344;82;99;42;1;41;.976;3600000;0
31780;180873;77;70;33;3;30;.909;3600000;0
31780;197047;82;0;0;0;0;.00nan;0;0
31780;85555;77;0;0;0;0;.00nan;0;0
31781;183737;78;0;0;0;0;.00nan;0;0
31781;194899;4245;0;0;0;0;.00nan;0;0
31781;176770;78;76;31;3;28;.903;3884000;0
31781;91398;4245;61;17;2;15;.882;3884000;0
31782;163989;149;57;23;2;21;.913;3644000;0
31782;173961;73;0;0;0;0;.00nan;0;0
31782;-1;73;70;31;3;28;.903;3642000;0
31782;85546;149;0;0;0;0;.00nan;0;0
31783;192895;85;0;0;0;0;.00nan;0;0
31783;194531;4920;28;8;3;5;.625;263000;0
31783;202246;4920;69;22;2;20;.909;3637000;0
31783;148573;85;80;48;5;43;.896;3900000;0
31784;184049;1097;0;0;0;0;.00nan;0;0
31784;189628;74;0;0;0;0;.00nan;0;0
31784;176136;74;87;35;3;32;.914;3600000;0
31784;-1;1097;57;40;5;35;.875;3596000;0
31785;-1;1095;0;0;0;0;.00nan;0;0
31785;176060;2564;59;18;3;15;.833;3900000;0
31785;78479;1095;61;32;3;29;.906;3900000;0
31785;79141;2564;0;0;0;0;.00nan;0;0
31786;4487;4922;0;0;0;0;.00nan;0;0
31786;-1;67;55;24;3;21;.875;3900000;0
31786;191698;67;0;0;0;0;.00nan;0;0
31786;86472;4922;56;31;3;28;.903;3900000;0
31787;189885;4921;60;24;3;21;.875;3900000;0
31787;174386;81;76;36;3;33;.917;3900000;0
31787;186451;81;0;0;0;0;.00nan;0;0
31787;197912;4921;0;0;0;0;.00nan;0;0
31788;185800;71;74;36;3;33;.917;3600000;0
31788;65014;71;0;0;0;0;.00nan;0;0
31788;85228;72;0;0;0;0;.00nan;0;0
31788;91212;72;19;16;5;11;.688;3600000;0
31789;183755;69;0;0;0;0;.00nan;0;0
31789;170598;80;0;0;0;0;.00nan;0;0
31789;192629;80;51;24;4;20;.833;3553000;0
31789;58100;69;70;33;3;30;.909;3600000;0
31790;171615;75;45;27;4;23;.852;3600000;0
31790;174407;75;0;0;0;0;.00nan;0;0
31790;196414;4620;27;26;6;20;.769;3297000;0
31790;181341;4620;57;3;0;3;1.000;216000;0
31791;183737;78;87;44;4;40;.909;3900000;0
31791;194899;4245;46;27;4;23;.852;3900000;0
31791;176770;78;0;0;0;0;.00nan;0;0
31791;91398;4245;0;0;0;0;.00nan;0;0
31792;184049;1097;90;24;1;23;.958;3600000;0
31792;180873;77;0;0;0;0;.00nan;0;0
31792;-1;1097;0;0;0;0;.00nan;0;0
31792;85555;77;88;52;3;49;.942;3580000;0
31793;-1;1095;75;38;3;35;.921;3600000;0
31793;78479;1095;0;0;0;0;.00nan;0;0
31793;85228;72;23;30;7;23;.767;3600000;0
31793;91212;72;0;0;0;0;.00nan;0;0
31794;176060;2564;0;0;0;0;.00nan;0;0
31794;185800;71;0;0;0;0;.00nan;0;0
31794;65014;71;47;19;3;16;.842;3600000;0
31794;79141;2564;39;31;5;26;.839;3535000;0
31795;200572;157;0;0;0;0;.00nan;0;0
31795;170598;80;78;25;2;23;.920;3900000;0
31795;192629;80;0;0;0;0;.00nan;0;0
31795;77084;157;80;36;2;34;.944;3900000;0
31796;171615;75;0;0;0;0;.00nan;0;0
31796;174407;75;96;41;2;39;.951;3600000;0
31796;196414;4620;0;0;0;0;.00nan;0;0
31796;181341;4620;66;29;3;26;.897;3547000;0
31797;-1;152;0;0;0;0;.00nan;0;0
31797;174386;81;0;0;0;0;.00nan;0;0
31797;189944;152;67;45;5;40;.889;3600000;0
31797;186451;81;73;9;0;9;1.000;3600000;0
31798;183755;69;59;39;4;35;.897;3543000;0
31798;189885;4921;0;0;0;0;.00nan;0;0
31798;197912;4921;88;46;3;43;.935;3600000;0
31798;58100;69;0;0;0;0;.00nan;0;0
31799;192895;85;0;0;0;0;.00nan;0;0
31799;194531;4920;0;0;0;0;.00nan;0;0
31799;202246;4920;86;39;2;37;.949;3600000;0
31799;148573;85;39;39;7;32;.821;3600000;0
31800;4487;4922;82;35;2;33;.943;3600000;0
31800;180873;77;0;0;0;0;.00nan;0;0
31800;85555;77;56;25;3;22;.880;3548000;0
31800;86472;4922;0;0;0;0;.00nan;0;0
31801;187699;1095;33;31;6;25;.806;3600000;0
31801;183755;69;47;18;3;15;.833;3600000;0
31801;-1;1095;0;0;0;0;.00nan;0;0
31801;58100;69;0;0;0;0;.00nan;0;0
31802;173961;73;67;27;3;24;.889;3541000;0
31802;196414;4620;0;0;0;0;.00nan;0;0
31802;181341;4620;64;15;2;13;.867;3600000;0
31802;-1;73;0;0;0;0;.00nan;0;0
31803;176060;2564;55;5;0;5;1.000;703000;0
31803;79141;2564;49;35;6;29;.829;3162000;0
31803;85228;72;40;29;6;23;.793;3900000;0
31803;91212;72;0;0;0;0;.00nan;0;0
31804;189885;4921;0;0;0;0;.00nan;0;0
31804;185800;71;0;0;0;0;.00nan;0;0
31804;197912;4921;82;38;3;35;.921;3584000;0
31804;65014;71;77;29;2;27;.931;3600000;0
31805;200572;157;0;0;0;0;.00nan;0;0
31805;196525;151;55;29;4;25;.862;3572000;0
31805;77084;157;74;24;2;22;.917;3600000;0
31805;85636;151;0;0;0;0;.00nan;0;0
31806;192895;85;0;0;0;0;.00nan;0;0
31806;194531;4920;0;0;0;0;.00nan;0;0
31806;202246;4920;89;25;1;24;.960;3600000;0
31806;148573;85;72;42;4;38;.905;3600000;0
31807;194899;4245;0;0;0;0;.00nan;0;0
31807;171615;75;0;0;0;0;.00nan;0;0
31807;174407;75;87;38;2;36;.947;3600000;0
31807;91398;4245;60;29;3;26;.897;3558000;0
31808;200390;1096;0;0;0;0;.00nan;0;0
31808;189628;74;0;0;0;0;.00nan;0;0
31808;176136;74;59;29;4;25;.862;3643000;0
31808;-1;1096;75;31;3;28;.903;3643000;0
31809;163989;149;41;20;4;16;.800;3600000;0
31809;173874;158;50;42;6;36;.857;3518000;0
31809;-1;158;0;0;0;0;.00nan;0;0
31809;85546;149;0;0;0;0;.00nan;0;0
31810;184049;1097;64;20;1;19;.950;3600000;0
31810;179344;82;0;0;0;0;.00nan;0;0
31810;-1;1097;0;0;0;0;.00nan;0;0
31810;197047;82;97;64;2;62;.969;3600000;0
31811;183737;78;0;0;0;0;.00nan;0;0
31811;-1;67;0;0;0;0;.00nan;0;0
31811;176770;78;74;30;3;27;.900;3547000;0
31811;191698;67;64;24;2;22;.917;3600000;0
31812;170598;80;0;0;0;0;.00nan;0;0
31812;174386;81;0;0;0;0;.00nan;0;0
31812;186451;81;73;30;2;28;.933;3571000;0
31812;192629;80;100;28;0;28;1.000;3600000;0
31813;4487;4922;0;0;0;0;.00nan;0;0
31813;184049;1097;0;0;0;0;.00nan;0;0
31813;-1;1097;81;32;2;30;.938;3600000;0
31813;86472;4922;51;46;6;40;.870;3600000;0
31814;173961;73;0;0;0;0;.00nan;0;0
31814;196414;4620;85;37;3;34;.919;3900000;0
31814;181341;4620;0;0;0;0;.00nan;0;0
31814;-1;73;66;29;3;26;.897;3900000;0
31815;179344;82;0;0;0;0;.00nan;0;0
31815;180873;77;88;32;1;31;.969;3600000;0
31815;197047;82;62;32;3;29;.906;3537000;0
31815;85555;77;0;0;0;0;.00nan;0;0
31816;187699;1095;0;0;0;0;.00nan;0;0
31816;-1;1095;77;44;4;40;.909;3600000;0
31816;85228;72;0;0;0;0;.00nan;0;0
31816;91212;72;72;16;1;15;.938;3600000;0
31817;189885;4921;76;41;3;38;.927;3592000;0
31817;185800;71;69;26;2;24;.923;3600000;0
31817;197912;4921;0;0;0;0;.00nan;0;0
31817;65014;71;0;0;0;0;.00nan;0;0
31818;183755;69;0;0;0;0;.00nan;0;0
31818;176060;2564;42;28;5;23;.821;3600000;0
31818;58100;69;79;31;2;29;.935;3600000;0
31818;79141;2564;0;0;0;0;.00nan;0;0
31819;200572;157;0;0;0;0;.00nan;0;0
31819;196525;151;0;0;0;0;.00nan;0;0
31819;77084;157;100;37;1;36;.973;3900000;0
31819;85636;151;81;26;1;25;.962;3900000;0
31820;192895;85;60;45;5;40;.889;3600000;0
31820;194531;4920;90;18;0;18;1.000;3600000;0
31820;202246;4920;0;0;0;0;.00nan;0;0
31820;148573;85;0;0;0;0;.00nan;0;0
31821;194899;4245;72;29;2;27;.931;3600000;0
31821;171615;75;97;35;1;34;.971;3600000;0
31821;174407;75;0;0;0;0;.00nan;0;0
31821;91398;4245;0;0;0;0;.00nan;0;0
31822;163989;149;77;22;1;21;.955;3600000;0
31822;173874;158;0;0;0;0;.00nan;0;0
31822;-1;158;57;42;5;37;.881;3600000;0
31822;85546;149;0;0;0;0;.00nan;0;0
31823;-1;76;0;0;0;0;.00nan;0;0
31823;200390;1096;37;31;5;26;.839;3600000;0
31823;184175;76;66;26;2;24;.923;3600000;0
31823;-1;1096;0;0;0;0;.00nan;0;0
31824;183737;78;32;32;6;26;.813;3600000;0
31824;-1;67;97;30;0;30;1.000;3600000;0
31824;176770;78;0;0;0;0;.00nan;0;0
31824;191698;67;0;0;0;0;.00nan;0;0
31825;173961;73;30;26;6;20;.769;3134000;0
31825;196414;4620;0;0;0;0;.00nan;0;0
31825;181341;4620;71;22;1;21;.955;3600000;0
31825;-1;73;51;2;0;2;1.000;466000;0
31826;179344;82;73;32;2;30;.938;3513000;0
31826;180873;77;0;0;0;0;.00nan;0;0
31826;197047;82;0;0;0;0;.00nan;0;0
31826;85555;77;91;20;0;20;1.000;3600000;0
31827;192895;85;0;0;0;0;.00nan;0;0
31827;194531;4920;68;19;1;18;.947;3600000;0
31827;202246;4920;0;0;0;0;.00nan;0;0
31827;148573;85;85;41;3;38;.927;3520000;0
31828;194899;4245;0;0;0;0;.00nan;0;0
31828;171615;75;0;0;0;0;.00nan;0;0
31828;174407;75;80;38;3;35;.921;3590000;0
31828;91398;4245;74;26;1;25;.962;3600000;0
31829;-1;76;61;14;1;13;.929;3600000;0
31829;200390;1096;49;1;0;1;1.000;294000;0
31829;184175;76;0;0;0;0;.00nan;0;0
31829;-1;1096;43;38;6;32;.842;3306000;0
31830;184049;1097;93;36;1;35;.972;3600000;0
31830;189628;74;0;0;0;0;.00nan;0;0
31830;176136;74;59;37;4;33;.892;3600000;0
31830;-1;1097;0;0;0;0;.00nan;0;0
31831;183755;69;0;0;0;0;.00nan;0;0
31831;189885;4921;0;0;0;0;.00nan;0;0
31831;197912;4921;34;28;5;23;.821;3541000;0
31831;58100;69;69;31;3;28;.903;3600000;0
31832;4487;4922;90;28;1;27;.964;3600000;0
31832;200390;1096;0;0;0;0;.00nan;0;0
31832;-1;1096;86;31;2;29;.935;3592000;0
31832;86472;4922;0;0;0;0;.00nan;0;0
31833;-1;152;0;0;0;0;.00nan;0;0
31833;189944;152;29;30;6;24;.800;3585000;0
31833;196525;151;84;48;4;44;.917;3600000;0
31833;85636;151;0;0;0;0;.00nan;0;0
31834;194899;4245;0;0;0;0;.00nan;0;0
31834;171615;75;0;0;0;0;.00nan;0;0
31834;174407;75;91;40;2;38;.950;3541000;0
31834;91398;4245;74;24;1;23;.958;3600000;0
31835;194531;4920;0;0;0;0;.00nan;0;0
31835;202246;4920;81;36;2;34;.944;3600000;0
31835;185800;71;0;0;0;0;.00nan;0;0
31835;65014;71;73;26;1;25;.962;3600000;0
31836;163989;149;36;23;5;18;.783;3524000;0
31836;200572;157;0;0;0;0;.00nan;0;0
31836;77084;157;60;31;3;28;.903;3600000;0
31836;85546;149;0;0;0;0;.00nan;0;0
31837;-1;76;0;0;0;0;.00nan;0;0
31837;184175;76;80;42;3;39;.929;3882000;0
31837;189628;74;0;0;0;0;.00nan;0;0
31837;176136;74;76;38;3;35;.921;3900000;0
31838;183737;78;100;39;1;38;.974;3600000;0
31838;194899;4245;0;0;0;0;.00nan;0;0
31838;176770;78;0;0;0;0;.00nan;0;0
31838;91398;4245;67;21;2;19;.905;3543000;0
31839;187699;1095;53;33;5;28;.848;3575000;0
31839;183755;69;0;0;0;0;.00nan;0;0
31839;-1;1095;0;0;0;0;.00nan;0;0
31839;58100;69;52;28;4;24;.857;3600000;0
31840;200390;1096;0;0;0;0;.00nan;0;0
31840;179344;82;0;0;0;0;.00nan;0;0
31840;-1;1096;57;22;2;20;.909;3555000;0
31840;197047;82;82;26;1;25;.962;3600000;0
31841;189885;4921;0;0;0;0;.00nan;0;0
31841;197912;4921;70;33;3;30;.909;3600000;0
31841;85228;72;89;25;1;24;.960;3600000;0
31841;91212;72;0;0;0;0;.00nan;0;0
31842;173961;73;0;0;0;0;.00nan;0;0
31842;176060;2564;0;0;0;0;.00nan;0;0
31842;-1;73;57;33;4;29;.879;3548000;0
31842;79141;2564;80;39;2;37;.949;3600000;0
31843;-1;152;0;0;0;0;.00nan;0;0
31843;189944;152;83;28;2;26;.929;3900000;0
31843;196525;151;73;28;2;26;.929;3900000;0
31843;85636;151;0;0;0;0;.00nan;0;0
31844;4487;4922;75;37;3;34;.919;3900000;0
31844;189628;74;67;27;3;24;.889;3900000;0
31844;176136;74;0;0;0;0;.00nan;0;0
31844;86472;4922;0;0;0;0;.00nan;0;0
31845;194531;4920;0;0;0;0;.00nan;0;0
31845;202246;4920;51;23;3;20;.870;3583000;0
31845;185800;71;0;0;0;0;.00nan;0;0
31845;65014;71;67;25;2;23;.920;3600000;0
31846;-1;76;81;27;1;26;.963;3600000;0
31846;184175;76;0;0;0;0;.00nan;0;0
31846;180873;77;97;43;2;41;.953;3546000;0
31846;85555;77;0;0;0;0;.00nan;0;0
31847;184049;1097;49;29;5;24;.828;3600000;0
31847;170598;80;88;39;3;36;.923;3600000;0
31847;-1;1097;0;0;0;0;.00nan;0;0
31847;192629;80;0;0;0;0;.00nan;0;0
31848;192895;85;29;7;3;4;.571;830000;0
31848;-1;67;84;22;2;20;.909;3600000;0
31848;191698;67;0;0;0;0;.00nan;0;0
31848;148573;85;17;24;7;17;.708;2770000;0
31849;173874;158;83;42;2;40;.952;3900000;0
31849;174386;81;82;27;2;25;.926;3900000;0
31849;-1;158;0;0;0;0;.00nan;0;0
31849;186451;81;0;0;0;0;.00nan;0;0
31850;163989;149;58;26;3;23;.885;3900000;0
31850;200572;157;0;0;0;0;.00nan;0;0
31850;77084;157;70;33;3;30;.909;3900000;0
31850;85546;149;0;0;0;0;.00nan;0;0
31851;171615;75;0;0;0;0;.00nan;0;0
31851;174407;75;98;43;1;42;.977;3568000;0
31851;196414;4620;0;0;0;0;.00nan;0;0
31851;181341;4620;100;24;0;24;1.000;3600000;0
31852;183737;78;0;0;0;0;.00nan;0;0
31852;-1;67;0;0;0;0;.00nan;0;0
31852;176770;78;67;25;2;23;.920;3600000;0
31852;191698;67;65;31;3;28;.903;3565000;0
31853;183755;69;14;14;5;9;.643;1122000;0
31853;173961;73;64;22;2;20;.909;3600000;0
31853;-1;73;0;0;0;0;.00nan;0;0
31853;58100;69;74;16;0;16;1.000;2478000;0
31854;200390;1096;64;16;1;15;.938;3600000;0
31854;179344;82;78;47;4;43;.915;3600000;0
31854;-1;1096;0;0;0;0;.00nan;0;0
31854;197047;82;0;0;0;0;.00nan;0;0
31855;189885;4921;66;47;5;42;.894;3600000;0
31855;197912;4921;0;0;0;0;.00nan;0;0
31855;85228;72;69;16;1;15;.938;3177000;0
31855;91212;72;29;8;3;5;.625;423000;0
31856;-1;152;84;34;2;32;.941;3600000;0
31856;189944;152;0;0;0;0;.00nan;0;0
31856;196525;151;0;0;0;0;.00nan;0;0
31856;85636;151;47;31;5;26;.839;3600000;0
31857;192895;85;0;0;0;0;.00nan;0;0
31857;194899;4245;0;0;0;0;.00nan;0;0
31857;91398;4245;100;26;0;26;1.000;3600000;0
31857;148573;85;91;35;2;33;.943;3525000;0
31858;4487;4922;0;0;0;0;.00nan;0;0
31858;189628;74;0;0;0;0;.00nan;0;0
31858;176136;74;100;33;0;33;1.000;3600000;0
31858;86472;4922;59;20;3;17;.850;3600000;0
31859;194531;4920;55;26;3;23;.885;3900000;0
31859;202246;4920;0;0;0;0;.00nan;0;0
31859;185800;71;67;28;3;25;.893;3900000;0
31859;65014;71;0;0;0;0;.00nan;0;0
31860;-1;76;0;0;0;0;.00nan;0;0
31860;184175;76;51;21;3;18;.857;3600000;0
31860;180873;77;63;29;3;26;.897;2762000;0
31860;85555;77;28;15;4;11;.733;838000;0
31861;184049;1097;0;0;0;0;.00nan;0;0
31861;170598;80;0;0;0;0;.00nan;0;0
31861;-1;1097;54;43;6;37;.860;3600000;0
31861;192629;80;80;30;2;28;.933;3600000;0
31862;187699;1095;0;0;0;0;.00nan;0;0
31862;-1;1095;97;42;1;41;.976;3600000;0
31862;176060;2564;74;37;3;34;.919;3515000;0
31862;79141;2564;0;0;0;0;.00nan;0;0
31863;173874;158;53;39;5;34;.872;3547000;0
31863;174386;81;0;0;0;0;.00nan;0;0
31863;-1;158;0;0;0;0;.00nan;0;0
31863;186451;81;64;25;3;22;.880;3600000;0
31864;163989;149;88;37;2;35;.946;3749000;0
31864;200572;157;74;30;3;27;.900;3749000;0
31864;77084;157;0;0;0;0;.00nan;0;0
31864;85546;149;0;0;0;0;.00nan;0;0
31865;171615;75;48;39;6;33;.846;2563000;0
31865;174407;75;43;4;1;3;.750;1037000;0
31865;196414;4620;0;0;0;0;.00nan;0;0
31865;181341;4620;74;20;1;19;.950;3600000;0
31866;183737;78;65;27;2;25;.926;3600000;0
31866;171615;75;0;0;0;0;.00nan;0;0
31866;174407;75;71;32;3;29;.906;3592000;0
31866;176770;78;0;0;0;0;.00nan;0;0
31867;176060;2564;0;0;0;0;.00nan;0;0
31867;79141;2564;92;49;3;46;.939;3788000;0
31867;85228;72;0;0;0;0;.00nan;0;0
31867;91212;72;64;19;2;17;.895;3788000;0
31868;192895;85;71;34;3;31;.912;3575000;0
31868;194899;4245;0;0;0;0;.00nan;0;0
31868;91398;4245;71;26;2;24;.923;3600000;0
31868;148573;85;0;0;0;0;.00nan;0;0
31869;184049;1097;70;25;2;23;.920;3600000;0
31869;170598;80;90;41;3;38;.927;3570000;0
31869;-1;1097;0;0;0;0;.00nan;0;0
31869;192629;80;0;0;0;0;.00nan;0;0
31870;187699;1095;52;43;6;37;.860;3514000;0
31870;183755;69;87;46;4;42;.913;3600000;0
31870;-1;1095;0;0;0;0;.00nan;0;0
31870;58100;69;0;0;0;0;.00nan;0;0
31871;173874;158;0;0;0;0;.00nan;0;0
31871;174386;81;43;34;5;29;.853;3338000;0
31871;-1;158;49;26;4;22;.846;3600000;0
31871;186451;81;50;1;0;1;1.000;245000;0
31872;-1;67;42;29;5;24;.828;3011000;0
31872;196414;4620;70;18;1;17;.944;3600000;0
31872;181341;4620;0;0;0;0;.00nan;0;0
31872;191698;67;50;5;1;4;.800;589000;0
31873;200572;157;0;0;0;0;.00nan;0;0
31873;196525;151;79;41;3;38;.927;3591000;0
31873;77084;157;90;36;2;34;.944;3600000;0
31873;85636;151;0;0;0;0;.00nan;0;0
31874;183755;69;85;44;3;41;.932;3748000;0
31874;185800;71;0;0;0;0;.00nan;0;0
31874;58100;69;0;0;0;0;.00nan;0;0
31874;65014;71;54;30;4;26;.867;3748000;0
31875;-1;152;0;0;0;0;.00nan;0;0
31875;173874;158;53;30;4;26;.867;3552000;0
31875;189944;152;49;22;3;19;.864;3600000;0
31875;-1;158;0;0;0;0;.00nan;0;0
31876;200390;1096;0;0;0;0;.00nan;0;0
31876;180873;77;0;0;0;0;.00nan;0;0
31876;-1;1096;37;34;6;28;.824;3538000;0
31876;85555;77;67;33;4;29;.879;3600000;0
31877;183737;78;48;26;4;22;.846;3543000;0
31877;194531;4920;0;0;0;0;.00nan;0;0
31877;176770;78;0;0;0;0;.00nan;0;0
31877;202246;4920;51;13;2;11;.846;3600000;0
31878;183755;69;62;34;5;29;.853;3600000;0
31878;173961;73;0;0;0;0;.00nan;0;0
31878;-1;73;82;33;2;31;.939;3600000;0
31878;58100;69;0;0;0;0;.00nan;0;0
31879;184049;1097;58;24;2;22;.917;3600000;0
31879;179344;82;0;0;0;0;.00nan;0;0
31879;-1;1097;0;0;0;0;.00nan;0;0
31879;197047;82;61;29;3;26;.897;3600000;0
31880;-1;152;0;0;0;0;.00nan;0;0
31880;173874;158;36;31;6;25;.806;3600000;0
31880;189944;152;71;25;2;23;.920;3600000;0
31880;-1;158;0;0;0;0;.00nan;0;0
31881;4487;4922;76;38;3;35;.921;3600000;0
31881;180873;77;86;15;0;15;1.000;3600000;0
31881;85555;77;0;0;0;0;.00nan;0;0
31881;86472;4922;0;0;0;0;.00nan;0;0
31882;189885;4921;0;0;0;0;.00nan;0;0
31882;176060;2564;0;0;0;0;.00nan;0;0
31882;197912;4921;89;33;1;32;.970;3600000;0
31882;79141;2564;45;17;3;14;.824;3594000;0
31883;192895;85;0;0;0;0;.00nan;0;0
31883;163989;149;95;38;1;37;.974;3600000;0
31883;85546;149;0;0;0;0;.00nan;0;0
31883;148573;85;82;40;3;37;.925;3548000;0
31884;194899;4245;0;0;0;0;.00nan;0;0
31884;85228;72;0;0;0;0;.00nan;0;0
31884;91212;72;64;29;3;26;.897;3560000;0
31884;91398;4245;65;22;2;20;.909;3600000;0
31885;-1;76;0;0;0;0;.00nan;0;0
31885;200390;1096;0;0;0;0;.00nan;0;0
31885;184175;76;76;27;2;25;.926;3600000;0
31885;-1;1096;64;45;5;40;.889;3600000;0
31886;187699;1095;50;1;0;1;1.000;443000;0
31886;-1;1095;16;22;6;16;.727;3116000;0
31886;171615;75;0;0;0;0;.00nan;0;0
31886;174407;75;69;35;4;31;.886;3600000;0
31887;-1;67;0;0;0;0;.00nan;0;0
31887;196414;4620;0;0;0;0;.00nan;0;0
31887;181341;4620;36;35;6;29;.829;3600000;0
31887;191698;67;62;27;3;24;.889;3600000;0
31888;200572;157;52;3;0;3;1.000;367000;0
31888;174386;81;0;0;0;0;.00nan;0;0
31888;186451;81;81;35;2;33;.943;3600000;0
31888;77084;157;30;29;6;23;.793;3233000;0
31889;189628;74;0;0;0;0;.00nan;0;0
31889;176136;74;79;30;2;28;.933;3600000;0
31889;185800;71;0;0;0;0;.00nan;0;0
31889;65014;71;63;31;4;27;.871;3541000;0
31890;170598;80;0;0;0;0;.00nan;0;0
31890;196525;151;53;10;1;9;.900;3900000;0
31890;192629;80;93;32;1;31;.969;3900000;0
31890;85636;151;0;0;0;0;.00nan;0;0
31891;4487;4922;0;0;0;0;.00nan;0;0
31891;184049;1097;0;0;0;0;.00nan;0;0
31891;-1;1097;86;18;0;18;1.000;3600000;0
31891;86472;4922;59;42;5;37;.881;3600000;0
31892;183755;69;0;0;0;0;.00nan;0;0
31892;173961;73;34;32;6;26;.813;2850000;0
31892;-1;73;51;5;1;4;.800;750000;0
31892;58100;69;75;27;2;25;.926;3600000;0
31893;179344;82;51;30;4;26;.867;3516000;0
31893;180873;77;0;0;0;0;.00nan;0;0
31893;197047;82;0;0;0;0;.00nan;0;0
31893;85555;77;63;20;2;18;.900;3600000;0
31894;-1;152;89;36;3;33;.917;3878000;0
31894;173874;158;0;0;0;0;.00nan;0;0
31894;189944;152;0;0;0;0;.00nan;0;0
31894;-1;158;68;31;3;28;.903;3900000;0
31895;189885;4921;94;47;2;45;.957;3561000;0
31895;176060;2564;73;23;1;22;.957;3600000;0
31895;197912;4921;0;0;0;0;.00nan;0;0
31895;79141;2564;0;0;0;0;.00nan;0;0
31896;170598;80;36;22;4;18;.818;3592000;0
31896;196525;151;0;0;0;0;.00nan;0;0
31896;192629;80;0;0;0;0;.00nan;0;0
31896;85636;151;70;39;3;36;.923;3600000;0
31897;192895;85;68;38;4;34;.895;3600000;0
31897;163989;149;74;33;3;30;.909;3600000;0
31897;85546;149;0;0;0;0;.00nan;0;0
31897;148573;85;0;0;0;0;.00nan;0;0
31898;194899;4245;81;34;2;32;.941;3536000;0
31898;85228;72;100;32;0;32;1.000;3600000;0
31898;91212;72;0;0;0;0;.00nan;0;0
31898;91398;4245;0;0;0;0;.00nan;0;0
31899;183737;78;0;0;0;0;.00nan;0;0
31899;194531;4920;79;28;1;27;.964;3600000;0
31899;176770;78;70;28;4;24;.857;3600000;0
31899;202246;4920;0;0;0;0;.00nan;0;0
31900;-1;76;88;46;3;43;.935;3576000;0
31900;200390;1096;94;27;1;26;.963;3600000;0
31900;184175;76;0;0;0;0;.00nan;0;0
31900;-1;1096;0;0;0;0;.00nan;0;0
31901;187699;1095;79;27;2;25;.926;3900000;0
31901;-1;1095;0;0;0;0;.00nan;0;0
31901;171615;75;76;30;2;28;.933;3900000;0
31901;174407;75;0;0;0;0;.00nan;0;0
31902;-1;67;66;32;3;29;.906;3545000;0
31902;196414;4620;56;20;2;18;.900;3600000;0
31902;181341;4620;0;0;0;0;.00nan;0;0
31902;191698;67;0;0;0;0;.00nan;0;0
31903;200572;157;0;0;0;0;.00nan;0;0
31903;174386;81;52;34;5;29;.853;3600000;0
31903;186451;81;0;0;0;0;.00nan;0;0
31903;77084;157;70;23;2;21;.913;3600000;0
31904;189628;74;90;44;3;41;.932;3600000;0
31904;176136;74;0;0;0;0;.00nan;0;0
31904;185800;71;84;16;0;16;1.000;3600000;0
31904;65014;71;0;0;0;0;.00nan;0;0
31905;4487;4922;70;33;3;30;.909;3600000;0
31905;184049;1097;0;0;0;0;.00nan;0;0
31905;-1;1097;59;36;4;32;.889;3553000;0
31905;86472;4922;0;0;0;0;.00nan;0;0
31906;173961;73;0;0;0;0;.00nan;0;0
31906;176060;2564;0;0;0;0;.00nan;0;0
31906;-1;73;72;31;2;29;.935;3726000;0
31906;79141;2564;45;20;3;17;.850;3726000;0
31907;-1;76;0;0;0;0;.00nan;0;0
31907;184175;76;64;24;2;22;.917;3600000;0
31907;179344;82;0;0;0;0;.00nan;0;0
31907;197047;82;68;35;3;32;.914;3560000;0
31908;192895;85;0;0;0;0;.00nan;0;0
31908;163989;149;60;32;4;28;.875;3900000;0
31908;85546;149;0;0;0;0;.00nan;0;0
31908;148573;85;70;37;4;33;.892;3894000;0
31909;194899;4245;0;0;0;0;.00nan;0;0
31909;85228;72;50;27;4;23;.852;3560000;0
31909;91212;72;0;0;0;0;.00nan;0;0
31909;91398;4245;60;21;3;18;.857;3600000;0
31910;183737;78;100;38;1;37;.974;3600000;0
31910;194531;4920;0;0;0;0;.00nan;0;0
31910;176770;78;0;0;0;0;.00nan;0;0
31910;202246;4920;36;18;4;14;.778;3600000;0
31911;187699;1095;0;0;0;0;.00nan;0;0
31911;-1;1095;55;34;5;29;.853;3600000;0
31911;171615;75;41;2;1;1;.500;248000;0
31911;174407;75;52;41;6;35;.854;3301000;0
31912;200572;157;49;1;0;1;1.000;332000;0
31912;174386;81;0;0;0;0;.00nan;0;0
31912;186451;81;58;30;4;26;.867;3600000;0
31912;77084;157;44;35;6;29;.829;3232000;0
31913;189628;74;0;0;0;0;.00nan;0;0
31913;176136;74;93;41;1;40;.976;3600000;0
31913;185800;71;95;18;0;18;1.000;3600000;0
31913;65014;71;0;0;0;0;.00nan;0;0
31914;170598;80;0;0;0;0;.00nan;0;0
31914;196525;151;59;34;4;30;.882;3600000;0
31914;192629;80;100;28;0;28;1.000;3600000;0
31914;85636;151;0;0;0;0;.00nan;0;0
31915;194531;4920;0;0;0;0;.00nan;0;0
31915;202246;4920;67;27;2;25;.926;3571000;0
31915;185800;71;100;28;0;28;1.000;3600000;0
31915;65014;71;0;0;0;0;.00nan;0;0
31916;-1;152;0;0;0;0;.00nan;0;0
31916;174386;81;0;0;0;0;.00nan;0;0
31916;189944;152;39;31;6;25;.806;3600000;0
31916;186451;81;82;23;1;22;.957;3600000;0
31917;183737;78;0;0;0;0;.00nan;0;0
31917;200390;1096;0;0;0;0;.00nan;0;0
31917;176770;78;38;30;6;24;.800;3600000;0
31917;-1;1096;52;21;3;18;.857;3600000;0
31918;189885;4921;0;0;0;0;.00nan;0;0
31918;176060;2564;47;32;5;27;.844;3600000;0
31918;197912;4921;89;42;2;40;.952;3600000;0
31918;79141;2564;0;0;0;0;.00nan;0;0
31919;189628;74;0;0;0;0;.00nan;0;0
31919;176136;74;86;30;2;28;.933;3600000;0
31919;180873;77;60;34;3;31;.912;3588000;0
31919;85555;77;0;0;0;0;.00nan;0;0
31920;173961;73;59;22;3;19;.864;3562000;0
31920;196525;151;66;28;2;26;.929;3600000;0
31920;-1;73;0;0;0;0;.00nan;0;0
31920;85636;151;0;0;0;0;.00nan;0;0
31921;4487;4922;96;48;4;44;.917;3600000;0
31921;85228;72;0;0;0;0;.00nan;0;0
31921;86472;4922;0;0;0;0;.00nan;0;0
31921;91212;72;65;15;1;14;.933;3600000;0
31922;194899;4245;0;0;0;0;.00nan;0;0
31922;179344;82;0;0;0;0;.00nan;0;0
31922;197047;82;83;47;4;43;.915;3600000;0
31922;91398;4245;71;17;1;16;.941;3600000;0
31923;-1;76;0;0;0;0;.00nan;0;0
31923;184049;1097;58;26;3;23;.885;3600000;0
31923;184175;76;100;25;0;25;1.000;3600000;0
31923;-1;1097;0;0;0;0;.00nan;0;0
31924;173961;73;0;0;0;0;.00nan;0;0
31924;170598;80;63;22;2;20;.909;3600000;0
31924;-1;73;79;47;4;43;.915;3551000;0
31924;192629;80;0;0;0;0;.00nan;0;0
31925;-1;152;0;0;0;0;.00nan;0;0
31925;174386;81;0;0;0;0;.00nan;0;0
31925;189944;152;74;22;1;21;.955;3600000;0
31925;186451;81;68;31;3;28;.903;3573000;0
31926;183737;78;0;0;0;0;.00nan;0;0
31926;200390;1096;0;0;0;0;.00nan;0;0
31926;176770;78;63;31;4;27;.871;3900000;0
31926;-1;1096;64;33;4;29;.879;3900000;0
31927;4487;4922;0;0;0;0;.00nan;0;0
31927;85228;72;44;22;4;18;.818;3600000;0
31927;86472;4922;91;29;1;28;.966;3600000;0
31927;91212;72;0;0;0;0;.00nan;0;0
31928;183755;69;38;23;5;18;.783;3736000;0
31928;189885;4921;0;0;0;0;.00nan;0;0
31928;197912;4921;58;33;4;29;.879;3736000;0
31928;58100;69;0;0;0;0;.00nan;0;0
31929;194899;4245;0;0;0;0;.00nan;0;0
31929;179344;82;97;56;4;52;.929;3600000;0
31929;197047;82;0;0;0;0;.00nan;0;0
31929;91398;4245;64;15;1;14;.933;3600000;0
31930;-1;67;0;0;0;0;.00nan;0;0
31930;171615;75;0;0;0;0;.00nan;0;0
31930;174407;75;77;22;1;21;.955;3600000;0
31930;191698;67;70;36;4;32;.889;3600000;0
31931;189628;74;0;0;0;0;.00nan;0;0
31931;176136;74;72;40;4;36;.900;3592000;0
31931;180873;77;76;28;2;26;.929;3600000;0
31931;85555;77;0;0;0;0;.00nan;0;0
31932;163989;149;90;29;1;28;.966;3583000;0
31932;196525;151;100;40;0;40;1.000;3600000;0
31932;85546;149;0;0;0;0;.00nan;0;0
31932;85636;151;0;0;0;0;.00nan;0;0
31933;-1;76;70;37;4;33;.892;3682000;0
31933;184049;1097;0;0;0;0;.00nan;0;0
31933;184175;76;0;0;0;0;.00nan;0;0
31933;-1;1097;72;47;5;42;.894;3682000;0
31934;187699;1095;67;34;3;31;.912;3600000;0
31934;-1;1095;0;0;0;0;.00nan;0;0
31934;176060;2564;70;24;2;22;.917;3600000;0
31934;79141;2564;0;0;0;0;.00nan;0;0
31935;200572;157;63;33;4;29;.879;3600000;0
31935;173874;158;45;36;5;31;.861;3561000;0
31935;-1;158;0;0;0;0;.00nan;0;0
31935;77084;157;0;0;0;0;.00nan;0;0
31936;194531;4920;0;0;0;0;.00nan;0;0
31936;202246;4920;74;27;2;25;.926;3900000;0
31936;185800;71;51;17;2;15;.882;3900000;0
31936;65014;71;0;0;0;0;.00nan;0;0
31937;192895;85;0;0;0;0;.00nan;0;0
31937;196414;4620;0;0;0;0;.00nan;0;0
31937;181341;4620;100;27;0;27;1.000;3600000;0
31937;148573;85;54;43;5;38;.884;3600000;0
31938;-1;152;79;35;2;33;.943;3600000;0
31938;174386;81;41;25;4;21;.840;3569000;0
31938;189944;152;0;0;0;0;.00nan;0;0
31938;186451;81;0;0;0;0;.00nan;0;0
31939;183737;78;63;40;4;36;.900;3600000;0
31939;200390;1096;69;18;1;17;.944;3600000;0
31939;176770;78;0;0;0;0;.00nan;0;0
31939;-1;1096;0;0;0;0;.00nan;0;0
31940;200572;157;0;0;0;0;.00nan;0;0
31940;173874;158;0;0;0;0;.00nan;0;0
31940;-1;158;79;30;2;28;.933;3600000;0
31940;77084;157;54;27;4;23;.852;3551000;0
31941;4487;4922;22;27;6;21;.778;2435000;0
31941;85228;72;0;0;0;0;.00nan;0;0
31941;86472;4922;8;17;6;11;.647;1165000;0
31941;91212;72;81;22;1;21;.955;3600000;0
31942;183755;69;0;0;0;0;.00nan;0;0
31942;189885;4921;57;17;2;15;.882;3600000;0
31942;197912;4921;0;0;0;0;.00nan;0;0
31942;58100;69;91;40;1;39;.975;3600000;0
31943;189628;74;51;18;3;15;.833;3900000;0
31943;176136;74;0;0;0;0;.00nan;0;0
31943;180873;77;0;0;0;0;.00nan;0;0
31943;85555;77;80;33;3;30;.909;3900000;0
31944;187699;1095;0;0;0;0;.00nan;0;0
31944;-1;1095;83;40;3;37;.925;3600000;0
31944;176060;2564;0;0;0;0;.00nan;0;0
31944;79141;2564;75;35;4;31;.886;3595000;0
31945;194899;4245;76;22;1;21;.955;3600000;0
31945;179344;82;42;4;1;3;.750;629000;0
31945;197047;82;42;43;7;36;.837;2971000;0
31945;91398;4245;0;0;0;0;.00nan;0;0
31946;-1;67;0;0;0;0;.00nan;0;0
31946;171615;75;42;36;6;30;.833;3600000;0
31946;174407;75;0;0;0;0;.00nan;0;0
31946;191698;67;55;20;3;17;.850;3600000;0
31947;163989;149;100;32;0;32;1.000;3600000;0
31947;196525;151;80;32;1;31;.969;3570000;0
31947;85546;149;0;0;0;0;.00nan;0;0
31947;85636;151;0;0;0;0;.00nan;0;0
31948;-1;76;0;0;0;0;.00nan;0;0
31948;184049;1097;58;35;5;30;.857;3600000;0
31948;184175;76;45;36;6;30;.833;3558000;0
31948;-1;1097;0;0;0;0;.00nan;0;0
31949;194531;4920;70;35;3;32;.914;3550000;0
31949;202246;4920;0;0;0;0;.00nan;0;0
31949;185800;71;0;0;0;0;.00nan;0;0
31949;65014;71;85;32;2;30;.938;3600000;0
31950;173961;73;0;0;0;0;.00nan;0;0
31950;170598;80;0;0;0;0;.00nan;0;0
31950;-1;73;63;47;6;41;.872;3600000;0
31950;192629;80;61;16;1;15;.938;3600000;0
31951;192895;85;55;45;6;39;.867;3318000;0
31951;196414;4620;0;0;0;0;.00nan;0;0
31951;181341;4620;62;27;3;24;.889;3600000;0
31951;148573;85;50;2;0;2;1.000;282000;0
31952;4487;4922;63;41;5;36;.878;3564000;0
31952;184049;1097;0;0;0;0;.00nan;0;0
31952;-1;1097;47;29;4;25;.862;3600000;0
31952;86472;4922;0;0;0;0;.00nan;0;0
31953;-1;152;0;0;0;0;.00nan;0;0
31953;170598;80;61;35;4;31;.886;3558000;0
31953;189944;152;63;30;3;27;.900;3600000;0
31953;192629;80;0;0;0;0;.00nan;0;0
31954;189885;4921;0;0;0;0;.00nan;0;0
31954;197912;4921;73;31;3;28;.903;3600000;0
31954;85228;72;40;20;4;16;.800;3580000;0
31954;91212;72;0;0;0;0;.00nan;0;0
31955;163989;149;83;28;2;26;.929;3600000;0
31955;173874;158;67;40;4;36;.900;3557000;0
31955;-1;158;0;0;0;0;.00nan;0;0
31955;85546;149;0;0;0;0;.00nan;0;0
31956;174386;81;0;0;0;0;.00nan;0;0
31956;196525;151;68;41;5;36;.878;3562000;0
31956;186451;81;52;21;3;18;.857;3600000;0
31956;85636;151;0;0;0;0;.00nan;0;0
31957;183737;78;87;27;1;26;.963;3600000;0
31957;194531;4920;0;0;0;0;.00nan;0;0
31957;176770;78;0;0;0;0;.00nan;0;0
31957;202246;4920;53;39;5;34;.872;3600000;0
31958;4487;4922;96;60;2;58;.967;3900000;0
31958;-1;76;69;18;2;16;.889;3900000;0
31958;184175;76;0;0;0;0;.00nan;0;0
31958;86472;4922;0;0;0;0;.00nan;0;0
31959;187699;1095;0;0;0;0;.00nan;0;0
31959;183755;69;76;36;3;33;.917;3900000;0
31959;-1;1095;93;45;3;42;.933;3900000;0
31959;58100;69;0;0;0;0;.00nan;0;0
31960;184049;1097;0;0;0;0;.00nan;0;0
31960;179344;82;99;45;2;43;.956;3600000;0
31960;-1;1097;53;25;3;22;.880;3555000;0
31960;197047;82;0;0;0;0;.00nan;0;0
31961;189885;4921;75;37;3;34;.919;3568000;0
31961;197912;4921;0;0;0;0;.00nan;0;0
31961;85228;72;59;23;2;21;.913;3600000;0
31961;91212;72;0;0;0;0;.00nan;0;0
31962;200390;1096;72;17;1;16;.941;3600000;0
31962;180873;77;54;26;3;23;.885;1969000;0
31962;-1;1096;0;0;0;0;.00nan;0;0
31962;85555;77;9;18;6;12;.667;1631000;0
31963;173961;73;0;0;0;0;.00nan;0;0
31963;176060;2564;63;24;2;22;.917;3600000;0
31963;-1;73;68;34;3;31;.912;3564000;0
31963;79141;2564;0;0;0;0;.00nan;0;0
31964;192895;85;0;0;0;0;.00nan;0;0
31964;171615;75;0;0;0;0;.00nan;0;0
31964;174407;75;61;20;2;18;.900;3576000;0
31964;148573;85;84;30;1;29;.967;3600000;0
31965;189628;74;0;0;0;0;.00nan;0;0
31965;176136;74;81;29;2;27;.931;3543000;0
31965;196414;4620;0;0;0;0;.00nan;0;0
31965;181341;4620;75;19;1;18;.947;3600000;0
31966;163989;149;66;19;1;18;.947;3900000;0
31966;173874;158;90;37;1;36;.973;3900000;0
31966;-1;158;0;0;0;0;.00nan;0;0
31966;85546;149;0;0;0;0;.00nan;0;0
31967;-1;152;0;0;0;0;.00nan;0;0
31967;174386;81;0;0;0;0;.00nan;0;0
31967;189944;152;51;27;4;23;.852;3638000;0
31967;186451;81;84;40;3;37;.925;3638000;0
31968;200572;157;0;0;0;0;.00nan;0;0
31968;185800;71;43;32;5;27;.844;3600000;0
31968;65014;71;0;0;0;0;.00nan;0;0
31968;77084;157;88;36;2;34;.944;3600000;0
31969;170598;80;0;0;0;0;.00nan;0;0
31969;196525;151;64;37;4;33;.892;3581000;0
31969;192629;80;74;21;2;19;.905;3600000;0
31969;85636;151;0;0;0;0;.00nan;0;0
31970;183737;78;0;0;0;0;.00nan;0;0
31970;176770;78;61;25;3;22;.880;3600000;0
31970;191698;67;45;26;4;22;.846;2008000;0
31970;85336;67;66;18;1;17;.944;1592000;0
31971;-1;152;71;26;2;24;.923;3600000;0
31971;174386;81;56;36;5;31;.861;3600000;0
31971;189944;152;0;0;0;0;.00nan;0;0
31971;186451;81;0;0;0;0;.00nan;0;0
31972;183755;69;47;7;1;6;.857;911000;0
31972;173961;73;100;36;0;36;1.000;3600000;0
31972;-1;73;0;0;0;0;.00nan;0;0
31972;58100;69;22;24;6;18;.750;2689000;0
31973;4487;4922;99;36;2;34;.944;3600000;0
31973;179344;82;0;0;0;0;.00nan;0;0
31973;197047;82;62;28;3;25;.893;3600000;0
31973;86472;4922;0;0;0;0;.00nan;0;0
31974;189885;4921;0;0;0;0;.00nan;0;0
31974;197912;4921;89;41;2;39;.951;3600000;0
31974;85228;72;0;0;0;0;.00nan;0;0
31974;91212;72;61;31;3;28;.903;3562000;0
31975;-1;76;54;20;2;18;.900;1400000;0
31975;184175;76;52;29;4;25;.862;2200000;0
31975;180873;77;65;35;3;32;.914;3600000;0
31975;85555;77;0;0;0;0;.00nan;0;0
31976;187699;1095;69;15;1;14;.933;3600000;0
31976;-1;1095;0;0;0;0;.00nan;0;0
31976;176060;2564;0;0;0;0;.00nan;0;0
31976;79141;2564;97;48;3;45;.938;3553000;0
31977;170598;80;55;26;3;23;.885;3900000;0
31977;196525;151;0;0;0;0;.00nan;0;0
31977;192629;80;0;0;0;0;.00nan;0;0
31977;85636;151;94;40;3;37;.925;3900000;0
31978;192895;85;85;42;2;40;.952;3600000;0
31978;171615;75;0;0;0;0;.00nan;0;0
31978;174407;75;61;28;3;25;.893;3600000;0
31978;148573;85;0;0;0;0;.00nan;0;0
31979;189628;74;30;9;3;6;.667;591000;0
31979;176136;74;87;27;1;26;.963;3009000;0
31979;196414;4620;74;18;1;17;.944;3600000;0
31979;181341;4620;0;0;0;0;.00nan;0;0
31980;163989;149;75;16;1;15;.938;3600000;0
31980;173874;158;0;0;0;0;.00nan;0;0
31980;-1;158;32;34;7;27;.794;3600000;0
31980;85546;149;0;0;0;0;.00nan;0;0
31981;194531;4920;23;13;4;9;.692;832000;0
31981;-1;4245;0;0;0;0;.00nan;0;0
31981;202246;4920;69;30;2;28;.933;2768000;0
31981;91398;4245;99;43;2;41;.953;3600000;0
31982;200390;1096;39;8;2;6;.750;1339000;0
31982;184049;1097;79;37;2;35;.946;3600000;0
31982;-1;1097;0;0;0;0;.00nan;0;0
31982;-1;1096;37;30;6;24;.800;2261000;0
31983;200572;157;40;28;5;23;.821;3900000;0
31983;185800;71;0;0;0;0;.00nan;0;0
31983;65014;71;36;23;5;18;.783;3900000;0
31983;77084;157;0;0;0;0;.00nan;0;0
31984;4487;4922;0;0;0;0;.00nan;0;0
31984;179344;82;86;31;2;29;.935;3694000;0
31984;197047;82;0;0;0;0;.00nan;0;0
31984;86472;4922;60;10;1;9;.900;3694000;0
31985;183755;69;42;28;5;23;.821;3600000;0
31985;173961;73;73;29;2;27;.931;3600000;0
31985;-1;73;0;0;0;0;.00nan;0;0
31985;58100;69;0;0;0;0;.00nan;0;0
31986;-1;76;50;22;3;19;.864;3600000;0
31986;184175;76;0;0;0;0;.00nan;0;0
31986;180873;77;0;0;0;0;.00nan;0;0
31986;85555;77;55;31;4;27;.871;3563000;0
31987;192895;85;0;0;0;0;.00nan;0;0
31987;171615;75;0;0;0;0;.00nan;0;0
31987;174407;75;100;33;1;32;.970;3600000;0
31987;148573;85;71;25;2;23;.920;3586000;0
31988;189628;74;0;0;0;0;.00nan;0;0
31988;176136;74;89;53;4;49;.925;3587000;0
31988;196414;4620;0;0;0;0;.00nan;0;0
31988;181341;4620;47;17;3;14;.824;3600000;0
31989;200390;1096;0;0;0;0;.00nan;0;0
31989;184049;1097;0;0;0;0;.00nan;0;0
31989;-1;1097;74;25;1;24;.960;3568000;0
31989;-1;1096;100;27;0;27;1.000;3600000;0
31990;170598;80;61;15;1;14;.933;3600000;0
31990;174386;81;0;0;0;0;.00nan;0;0
31990;186451;81;73;37;3;34;.919;3600000;0
31990;192629;80;0;0;0;0;.00nan;0;0
31991;194531;4920;0;0;0;0;.00nan;0;0
31991;-1;4245;0;0;0;0;.00nan;0;0
31991;202246;4920;83;41;3;38;.927;3600000;0
31991;91398;4245;100;25;0;25;1.000;3600000;0
31992;200572;157;0;0;0;0;.00nan;0;0
31992;185800;71;75;26;2;24;.923;3600000;0
31992;65014;71;0;0;0;0;.00nan;0;0
31992;77084;157;47;20;4;16;.800;3563000;0
31993;200390;1096;0;0;0;0;.00nan;0;0
31993;196414;4620;0;0;0;0;.00nan;0;0
31993;181341;4620;79;26;2;24;.923;3600000;0
31993;-1;1096;71;30;3;27;.900;3544000;0
31994;170598;80;78;27;1;26;.963;3600000;0
31994;189885;4921;93;22;0;22;1.000;3600000;0
31994;192629;80;0;0;0;0;.00nan;0;0
31994;197912;4921;0;0;0;0;.00nan;0;0
31995;192895;85;0;0;0;0;.00nan;0;0
31995;176060;2564;58;26;4;22;.846;3577000;0
31995;79141;2564;0;0;0;0;.00nan;0;0
31995;148573;85;93;38;2;36;.947;3600000;0
31996;194531;4920;0;0;0;0;.00nan;0;0
31996;-1;4245;0;0;0;0;.00nan;0;0
31996;202246;4920;62;25;3;22;.880;3600000;0
31996;91398;4245;55;30;5;25;.833;3523000;0
31997;4487;4922;97;50;3;47;.940;3549000;0
31997;184049;1097;0;0;0;0;.00nan;0;0
31997;-1;1097;96;36;1;35;.972;3600000;0
31997;86472;4922;0;0;0;0;.00nan;0;0
31998;163989;149;51;21;4;17;.810;3600000;0
31998;179344;82;54;5;0;5;1.000;425000;0
31998;197047;82;62;33;5;28;.848;3127000;0
31998;85546;149;0;0;0;0;.00nan;0;0
31999;183737;78;99;25;0;25;1.000;3600000;0
31999;194531;4920;0;0;0;0;.00nan;0;0
31999;176770;78;0;0;0;0;.00nan;0;0
31999;202246;4920;79;28;1;27;.964;3580000;0
32000;183755;69;81;35;2;33;.943;3600000;0
32000;189885;4921;81;39;3;36;.923;3555000;0
32000;197912;4921;0;0;0;0;.00nan;0;0
32000;78479;69;0;0;0;0;.00nan;0;0
32001;200390;1096;0;0;0;0;.00nan;0;0
32001;196414;4620;0;0;0;0;.00nan;0;0
32001;180873;4620;73;19;1;18;.947;3600000;0
32001;-1;1096;59;44;5;39;.886;3600000;0
32002;170598;80;70;26;2;24;.923;3600000;0
32002;192629;80;0;0;0;0;.00nan;0;0
32002;85228;72;79;26;1;25;.962;3600000;0
32002;91212;72;0;0;0;0;.00nan;0;0
32003;200572;157;63;11;0;11;1.000;1106000;0
32003;196525;151;59;28;4;24;.857;3600000;0
32003;77084;157;29;30;6;24;.800;2454000;0
32003;85636;151;0;0;0;0;.00nan;0;0
32004;184049;1097;0;0;0;0;.00nan;0;0
32004;171615;75;0;0;0;0;.00nan;0;0
32004;174407;75;92;44;3;41;.932;3600000;0
32004;-1;1097;30;28;5;23;.821;3557000;0
32005;199437;77;69;36;4;32;.889;3566000;0
32005;189628;74;0;0;0;0;.00nan;0;0
32005;176136;74;80;29;2;27;.931;3600000;0
32005;85555;77;0;0;0;0;.00nan;0;0
32006;4487;4922;86;36;2;34;.944;3600000;0
32006;-1;76;0;0;0;0;.00nan;0;0
32006;184175;76;70;36;3;33;.917;3580000;0
32006;86472;4922;0;0;0;0;.00nan;0;0
32007;192895;85;0;0;0;0;.00nan;0;0
32007;187699;1095;0;0;0;0;.00nan;0;0
32007;-1;1095;38;28;5;23;.821;3600000;0
32007;148573;85;91;40;4;36;.900;3600000;0
32008;-1;4245;0;0;0;0;.00nan;0;0
32008;191698;67;52;17;2;15;.882;2513000;0
32008;85336;67;29;15;4;11;.733;1046000;0
32008;91398;4245;55;27;4;23;.852;3600000;0
32009;173874;158;93;21;0;21;1.000;3600000;0
32009;174386;81;0;0;0;0;.00nan;0;0
32009;-1;158;0;0;0;0;.00nan;0;0
32009;186451;81;77;35;3;32;.914;3600000;0
32010;173961;73;61;40;5;35;.875;3600000;0
32010;185800;71;76;33;2;31;.939;3600000;0
32010;-1;73;0;0;0;0;.00nan;0;0
32010;65014;71;0;0;0;0;.00nan;0;0
32011;183737;78;0;0;0;0;.00nan;0;0
32011;194531;4920;60;30;3;27;.900;3600000;0
32011;176770;78;100;40;0;40;1.000;3600000;0
32011;202246;4920;0;0;0;0;.00nan;0;0
32012;183755;69;50;1;0;1;1.000;243000;0
32012;189885;4921;0;0;0;0;.00nan;0;0
32012;197912;4921;64;33;4;29;.879;3600000;0
32012;78479;69;36;36;7;29;.806;3357000;0
32013;200390;1096;95;34;1;33;.971;3900000;0
32013;196414;4620;0;0;0;0;.00nan;0;0
32013;180873;4620;82;29;1;28;.966;3900000;0
32013;-1;1096;0;0;0;0;.00nan;0;0
32014;179344;82;76;38;4;34;.895;3550000;0
32014;181341;149;57;19;2;17;.895;3600000;0
32014;197047;82;0;0;0;0;.00nan;0;0
32014;85546;149;0;0;0;0;.00nan;0;0
32015;170598;80;0;0;0;0;.00nan;0;0
32015;192629;80;72;33;3;30;.909;3900000;0
32015;85228;72;0;0;0;0;.00nan;0;0
32015;91212;72;93;41;3;38;.927;3900000;0
32016;200572;157;50;23;3;20;.870;3600000;0
32016;196525;151;66;32;3;29;.906;3169000;0
32016;77084;157;0;0;0;0;.00nan;0;0
32016;85636;151;29;8;3;5;.625;431000;0
32017;184049;1097;53;24;3;21;.875;3600000;0
32017;171615;75;53;28;4;24;.857;3600000;0
32017;174407;75;0;0;0;0;.00nan;0;0
32017;-1;1097;0;0;0;0;.00nan;0;0
32018;4487;4922;0;0;0;0;.00nan;0;0
32018;189628;74;68;44;5;39;.886;3600000;0
32018;176136;74;0;0;0;0;.00nan;0;0
32018;86472;4922;64;37;4;33;.892;3600000;0
32019;199437;77;18;25;6;19;.760;2974000;0
32019;-1;76;54;18;2;16;.889;3600000;0
32019;184175;76;0;0;0;0;.00nan;0;0
32019;85555;77;56;5;0;5;1.000;626000;0
32020;192895;85;98;40;1;39;.975;3900000;0
32020;187699;1095;82;30;1;29;.967;3900000;0
32020;-1;1095;0;0;0;0;.00nan;0;0
32020;148573;85;0;0;0;0;.00nan;0;0
32021;-1;4245;0;0;0;0;.00nan;0;0
32021;191698;67;0;0;0;0;.00nan;0;0
32021;85336;67;38;18;4;14;.778;3556000;0
32021;91398;4245;57;31;3;28;.903;3600000;0
32022;173874;158;95;38;1;37;.974;3600000;0
32022;174386;81;70;27;2;25;.926;3600000;0
32022;-1;158;0;0;0;0;.00nan;0;0
32022;186451;81;0;0;0;0;.00nan;0;0
32023;176060;2564;61;49;5;44;.898;3554000;0
32023;185800;71;0;0;0;0;.00nan;0;0
32023;79141;2564;0;0;0;0;.00nan;0;0
32023;86485;71;52;29;4;25;.862;3600000;0
32024;192895;85;0;0;0;0;.00nan;0;0
32024;183755;69;24;9;4;5;.556;762000;0
32024;78479;69;70;21;1;20;.952;2822000;0
32024;148573;85;64;32;4;28;.875;3600000;0
32025;179344;82;0;0;0;0;.00nan;0;0
32025;181341;149;78;25;1;24;.960;3600000;0
32025;197047;82;61;46;6;40;.870;3600000;0
32025;85546;149;0;0;0;0;.00nan;0;0
32026;200572;157;0;0;0;0;.00nan;0;0
32026;196525;151;0;0;0;0;.00nan;0;0
32026;77084;157;52;22;3;19;.864;3600000;0
32026;85636;151;57;36;4;32;.889;3582000;0
32027;4487;4922;50;50;7;43;.860;3600000;0
32027;189628;74;0;0;0;0;.00nan;0;0
32027;176136;74;61;31;4;27;.871;3600000;0
32027;86472;4922;0;0;0;0;.00nan;0;0
32028;187699;1095;0;0;0;0;.00nan;0;0
32028;-1;1095;90;58;5;53;.914;3600000;0
32028;173961;73;0;0;0;0;.00nan;0;0
32028;-1;73;40;21;4;17;.810;3600000;0
32029;173874;158;0;0;0;0;.00nan;0;0
32029;174386;81;0;0;0;0;.00nan;0;0
32029;-1;158;67;32;3;29;.906;3600000;0
32029;186451;81;61;20;2;18;.900;3600000;0
32030;176060;2564;0;0;0;0;.00nan;0;0
32030;185800;71;76;32;2;30;.938;3600000;0
32030;79141;2564;54;32;5;27;.844;3600000;0
32030;86485;71;0;0;0;0;.00nan;0;0
32031;4487;4922;95;19;0;19;1.000;3600000;0
32031;199437;77;88;29;1;28;.966;3598000;0
32031;85555;77;0;0;0;0;.00nan;0;0
32031;86472;4922;0;0;0;0;.00nan;0;0
32032;183755;69;60;42;5;37;.881;3550000;0
32032;78479;69;0;0;0;0;.00nan;0;0
32032;85228;72;0;0;0;0;.00nan;0;0
32032;91212;72;71;30;3;27;.900;3600000;0
32033;200572;157;24;11;4;7;.636;991000;0
32033;170728;158;0;0;0;0;.00nan;0;0
32033;-1;158;85;31;2;29;.935;3600000;0
32033;77084;157;48;18;3;15;.833;2609000;0
32034;171615;75;0;0;0;0;.00nan;0;0
32034;174407;75;65;28;3;25;.893;3558000;0
32034;176770;78;94;41;2;39;.951;3600000;0
32034;181102;78;0;0;0;0;.00nan;0;0
32035;-1;76;0;0;0;0;.00nan;0;0
32035;184175;76;99;43;1;42;.977;3600000;0
32035;181341;149;73;24;2;22;.917;3553000;0
32035;85546;149;0;0;0;0;.00nan;0;0
32036;194531;4920;0;0;0;0;.00nan;0;0
32036;202246;4920;48;32;5;27;.844;3600000;0
32036;185800;71;58;28;4;24;.857;3600000;0
32036;86485;71;0;0;0;0;.00nan;0;0
32037;-1;152;52;16;2;14;.875;1315000;0
32037;174386;81;0;0;0;0;.00nan;0;0
32037;189944;152;18;20;6;14;.700;2285000;0
32037;186451;81;72;19;1;18;.947;3600000;0
32038;183755;69;90;29;1;28;.966;3726000;0
32038;185800;71;82;30;2;28;.933;3726000;0
32038;78479;69;0;0;0;0;.00nan;0;0
32038;86485;71;0;0;0;0;.00nan;0;0
32039;200572;157;0;0;0;0;.00nan;0;0
32039;170728;158;0;0;0;0;.00nan;0;0
32039;-1;158;47;30;5;25;.833;3600000;0
32039;77084;157;93;18;0;18;1.000;3600000;0
32040;189885;4921;0;0;0;0;.00nan;0;0
32040;197912;4921;50;31;4;27;.871;3582000;0
32040;85228;72;68;24;2;22;.917;3600000;0
32040;91212;72;0;0;0;0;.00nan;0;0
32041;173874;80;66;26;2;24;.923;3600000;0
32041;196525;151;70;47;5;42;.894;3600000;0
32041;192629;80;0;0;0;0;.00nan;0;0
32041;85636;151;0;0;0;0;.00nan;0;0
32042;-1;4245;0;0;0;0;.00nan;0;0
32042;176060;2564;60;38;4;34;.895;3600000;0
32042;79141;2564;0;0;0;0;.00nan;0;0
32042;91398;4245;67;19;1;18;.947;3600000;0
32043;192895;85;0;0;0;0;.00nan;0;0
32043;171615;75;0;0;0;0;.00nan;0;0
32043;174407;75;47;24;4;20;.833;3900000;0
32043;148573;85;70;38;4;34;.895;3900000;0
32044;200390;1096;0;0;0;0;.00nan;0;0
32044;189628;74;0;0;0;0;.00nan;0;0
32044;176136;74;100;43;0;43;1.000;3600000;0
32044;-1;1096;79;27;1;26;.963;3545000;0
32045;-1;76;80;40;3;37;.925;3600000;0
32045;184175;76;0;0;0;0;.00nan;0;0
32045;181341;149;39;27;5;22;.815;3576000;0
32045;85546;149;0;0;0;0;.00nan;0;0
32046;194531;4920;0;0;0;0;.00nan;0;0
32046;176770;78;59;15;1;14;.933;1265000;0
32046;181102;78;4;25;8;17;.680;2335000;0
32046;202246;4920;88;16;0;16;1.000;3600000;0
32047;199437;77;100;31;0;31;1.000;3600000;0
32047;184049;1097;0;0;0;0;.00nan;0;0
32047;-1;1097;65;21;1;20;.952;3545000;0
32047;85555;77;0;0;0;0;.00nan;0;0
32048;187699;1095;0;0;0;0;.00nan;0;0
32048;-1;1095;57;25;3;22;.880;3770000;0
32048;173961;73;62;33;4;29;.879;3770000;0
32048;-1;73;0;0;0;0;.00nan;0;0
32049;4487;4922;76;29;3;26;.897;3589000;0
32049;179344;82;0;0;0;0;.00nan;0;0
32049;197047;82;58;19;2;17;.895;3600000;0
32049;86472;4922;0;0;0;0;.00nan;0;0
32050;183755;69;0;0;0;0;.00nan;0;0
32050;78479;69;65;37;4;33;.892;3600000;0
32050;85228;72;0;0;0;0;.00nan;0;0
32050;91212;72;80;31;3;28;.903;3600000;0
32051;173961;73;0;0;0;0;.00nan;0;0
32051;185800;71;0;0;0;0;.00nan;0;0
32051;-1;73;82;31;2;29;.935;3600000;0
32051;86485;71;61;25;3;22;.880;3553000;0
32052;200572;157;71;27;2;25;.926;3600000;0
32052;170728;158;62;29;4;25;.862;3545000;0
32052;-1;158;0;0;0;0;.00nan;0;0
32052;77084;157;0;0;0;0;.00nan;0;0
32053;199437;77;93;36;1;35;.972;3600000;0
32053;189628;74;0;0;0;0;.00nan;0;0
32053;176136;74;68;37;3;34;.919;3549000;0
32053;85555;77;0;0;0;0;.00nan;0;0
32054;-1;4245;0;0;0;0;.00nan;0;0
32054;176060;2564;0;0;0;0;.00nan;0;0
32054;79141;2564;69;28;2;26;.929;3600000;0
32054;91398;4245;35;21;4;17;.810;3513000;0
32055;192895;85;35;37;7;30;.811;3032000;0
32055;171615;75;41;27;5;22;.815;3600000;0
32055;174407;75;0;0;0;0;.00nan;0;0
32055;148573;85;58;6;0;6;1.000;482000;0
32056;-1;76;0;0;0;0;.00nan;0;0
32056;184175;76;89;32;2;30;.938;3600000;0
32056;181341;149;50;31;4;27;.871;3598000;0
32056;85546;149;0;0;0;0;.00nan;0;0
32057;194531;4920;0;0;0;0;.00nan;0;0
32057;176770;78;0;0;0;0;.00nan;0;0
32057;181102;78;36;33;6;27;.818;3589000;0
32057;202246;4920;60;31;4;27;.871;3600000;0
32058;200390;1096;54;29;4;25;.862;3600000;0
32058;184049;1097;58;17;2;15;.882;3600000;0
32058;-1;1097;0;0;0;0;.00nan;0;0
32058;-1;1096;0;0;0;0;.00nan;0;0
32059;187699;1095;75;43;3;40;.930;3900000;0
32059;-1;1095;0;0;0;0;.00nan;0;0
32059;189885;4921;50;21;3;18;.857;3900000;0
32059;197912;4921;0;0;0;0;.00nan;0;0
32060;174386;81;71;28;2;26;.929;3600000;0
32060;196525;151;73;39;3;36;.923;3592000;0
32060;186451;81;0;0;0;0;.00nan;0;0
32060;85636;151;0;0;0;0;.00nan;0;0
32061;-1;152;87;29;1;28;.966;3600000;0
32061;173874;80;67;32;3;29;.906;3527000;0
32061;189944;152;0;0;0;0;.00nan;0;0
32061;192629;80;0;0;0;0;.00nan;0;0
32062;196414;4620;67;27;2;25;.926;3600000;0
32062;180873;4620;0;0;0;0;.00nan;0;0
32062;191698;67;54;35;4;31;.886;3582000;0
32062;85336;67;0;0;0;0;.00nan;0;0
32063;173874;80;49;20;3;17;.850;3559000;0
32063;189944;152;84;36;2;34;.944;3600000;0
32063;196414;152;0;0;0;0;.00nan;0;0
32063;192629;80;0;0;0;0;.00nan;0;0
32064;4487;4922;0;0;0;0;.00nan;0;0
32064;179344;82;51;25;4;21;.840;3515000;0
32064;197047;82;0;0;0;0;.00nan;0;0
32064;86472;4922;91;39;2;37;.949;3600000;0
32065;173961;73;87;37;2;35;.946;3600000;0
32065;-1;73;0;0;0;0;.00nan;0;0
32065;85228;72;59;27;3;24;.889;3574000;0
32065;91212;72;0;0;0;0;.00nan;0;0
32066;199437;77;76;34;4;30;.882;3576000;0
32066;189628;74;0;0;0;0;.00nan;0;0
32066;176136;74;71;28;2;26;.929;3600000;0
32066;85555;77;0;0;0;0;.00nan;0;0
32067;-1;4245;38;20;4;16;.800;3632000;0
32067;176060;2564;53;38;5;33;.868;3632000;0
32067;79141;2564;0;0;0;0;.00nan;0;0
32067;91398;4245;0;0;0;0;.00nan;0;0
32068;200390;1096;49;15;2;13;.867;1282000;0
32068;184049;1097;0;0;0;0;.00nan;0;0
32068;-1;1097;68;24;2;22;.917;3600000;0
32068;-1;1096;27;22;5;17;.773;2318000;0
32069;187699;1095;0;0;0;0;.00nan;0;0
32069;-1;1095;100;33;0;33;1.000;3600000;0
32069;189885;4921;0;0;0;0;.00nan;0;0
32069;197912;4921;97;52;3;49;.942;3600000;0
32070;174386;81;0;0;0;0;.00nan;0;0
32070;196525;151;41;24;4;20;.833;3586000;0
32070;186451;81;75;34;3;31;.912;3600000;0
32070;85636;151;0;0;0;0;.00nan;0;0
32071;183755;69;82;47;4;43;.915;3526000;0
32071;185800;71;89;36;2;34;.944;3600000;0
32071;78479;69;0;0;0;0;.00nan;0;0
32071;86485;71;0;0;0;0;.00nan;0;0
32072;200233;4620;0;0;0;0;.00nan;0;0
32072;180873;4620;50;23;3;20;.870;3600000;0
32072;191698;67;0;0;0;0;.00nan;0;0
32072;85336;67;77;47;4;43;.915;3600000;0
32073;192895;85;0;0;0;0;.00nan;0;0
32073;200233;4620;61;37;4;33;.892;3900000;0
32073;180873;4620;0;0;0;0;.00nan;0;0
32073;148573;85;75;41;4;37;.902;3900000;0
32074;199437;77;46;35;6;29;.829;3600000;0
32074;200390;1096;0;0;0;0;.00nan;0;0
32074;-1;1096;76;26;1;25;.962;3600000;0
32074;85555;77;0;0;0;0;.00nan;0;0
32075;194531;4920;91;25;0;25;1.000;3600000;0
32075;-1;4920;0;0;0;0;.00nan;0;0
32075;57953;75;0;0;0;0;.00nan;0;0
32075;85050;75;84;46;3;43;.935;3600000;0
32076;176770;78;53;8;1;7;.875;969000;0
32076;181102;78;27;32;7;25;.781;2631000;0
32076;-1;67;48;29;5;24;.828;3600000;0
32076;85336;67;0;0;0;0;.00nan;0;0
32077;173874;80;58;25;3;22;.880;3600000;0
32077;174386;81;0;0;0;0;.00nan;0;0
32077;186451;81;66;36;4;32;.889;3551000;0
32077;192629;80;0;0;0;0;.00nan;0;0
32078;189944;152;30;27;5;22;.815;3600000;0
32078;196414;152;0;0;0;0;.00nan;0;0
32078;196525;151;81;26;1;25;.962;3600000;0
32078;85636;151;0;0;0;0;.00nan;0;0
32079;200390;1096;50;24;3;21;.875;3557000;0
32079;189628;74;0;0;0;0;.00nan;0;0
32079;176136;74;85;33;2;31;.939;3600000;0
32079;-1;1096;0;0;0;0;.00nan;0;0
32080;173961;73;0;0;0;0;.00nan;0;0
32080;202246;73;51;35;5;30;.857;3600000;0
32080;185800;71;98;24;0;24;1.000;3600000;0
32080;86485;71;0;0;0;0;.00nan;0;0
32081;176060;2564;0;0;0;0;.00nan;0;0
32081;79141;2564;28;22;5;17;.773;3531000;0
32081;85228;72;0;0;0;0;.00nan;0;0
32081;91212;72;71;30;3;27;.900;3600000;0
32082;192895;85;0;0;0;0;.00nan;0;0
32082;176770;78;0;0;0;0;.00nan;0;0
32082;181102;78;66;30;3;27;.900;3600000;0
32082;148573;85;51;32;4;28;.875;3566000;0
32083;-1;4245;0;0;0;0;.00nan;0;0
32083;170728;158;0;0;0;0;.00nan;0;0
32083;-1;158;42;43;7;36;.837;3600000;0
32083;91398;4245;100;26;0;26;1.000;3600000;0
32084;194531;4920;91;26;1;25;.962;3600000;0
32084;-1;4920;0;0;0;0;.00nan;0;0
32084;57953;75;83;36;3;33;.917;3514000;0
32084;85050;75;0;0;0;0;.00nan;0;0
32085;-1;76;61;19;2;17;.895;3600000;0
32085;184175;76;0;0;0;0;.00nan;0;0
32085;179344;82;0;0;0;0;.00nan;0;0
32085;197047;82;52;48;6;42;.875;3600000;0
32086;4487;4922;100;45;2;43;.956;3900000;0
32086;184049;1097;59;23;2;21;.913;3900000;0
32086;191698;1097;0;0;0;0;.00nan;0;0
32086;86472;4922;0;0;0;0;.00nan;0;0
32087;187699;1095;0;0;0;0;.00nan;0;0
32087;183755;69;68;25;2;23;.920;3600000;0
32087;-1;1095;69;26;3;23;.885;3558000;0
32087;78479;69;0;0;0;0;.00nan;0;0
32088;200233;4620;0;0;0;0;.00nan;0;0
32088;180873;4620;65;26;3;23;.885;3600000;0
32088;-1;67;72;50;6;44;.880;3600000;0
32088;85336;67;0;0;0;0;.00nan;0;0
32089;200572;157;0;0;0;0;.00nan;0;0
32089;174407;157;54;37;5;32;.865;3585000;0
32089;181341;149;44;23;4;19;.826;3600000;0
32089;85546;149;0;0;0;0;.00nan;0;0
32090;173874;80;45;21;4;17;.810;3600000;0
32090;189885;4921;0;0;0;0;.00nan;0;0
32090;192629;80;0;0;0;0;.00nan;0;0
32090;197912;4921;72;41;5;36;.878;3537000;0
32091;192895;85;46;24;4;20;.833;3527000;0
32091;176770;78;0;0;0;0;.00nan;0;0
32091;181102;78;94;40;2;38;.950;3600000;0
32091;148573;85;0;0;0;0;.00nan;0;0
32092;189944;152;0;0;0;0;.00nan;0;0
32092;196414;152;83;48;3;45;.938;3588000;0
32092;196525;151;91;28;1;27;.964;3600000;0
32092;85636;151;0;0;0;0;.00nan;0;0
32093;200390;1096;0;0;0;0;.00nan;0;0
32093;189628;74;62;36;4;32;.889;3549000;0
32093;176136;74;0;0;0;0;.00nan;0;0
32093;-1;1096;61;33;3;30;.909;3600000;0
32094;173961;73;0;0;0;0;.00nan;0;0
32094;202246;73;55;46;6;40;.870;3600000;0
32094;185800;71;59;20;2;18;.900;3600000;0
32094;86485;71;0;0;0;0;.00nan;0;0
32095;-1;4245;0;0;0;0;.00nan;0;0
32095;170728;158;94;53;3;50;.943;3600000;0
32095;-1;158;0;0;0;0;.00nan;0;0
32095;91398;4245;81;12;0;12;1.000;3600000;0
32096;194531;4920;93;18;0;18;1.000;3600000;0
32096;-1;4920;0;0;0;0;.00nan;0;0
32096;57953;75;0;0;0;0;.00nan;0;0
32096;85050;75;74;31;2;29;.935;3518000;0
32097;-1;76;0;0;0;0;.00nan;0;0
32097;184049;1097;0;0;0;0;.00nan;0;0
32097;184175;76;45;37;5;32;.865;3900000;0
32097;191698;1097;37;26;5;21;.808;3900000;0
32098;187699;1095;100;30;0;30;1.000;3600000;0
32098;-1;1095;0;0;0;0;.00nan;0;0
32098;176060;2564;32;24;4;20;.833;3600000;0
32098;79141;2564;0;0;0;0;.00nan;0;0
32099;200233;4620;76;22;1;21;.955;3600000;0
32099;180873;4620;0;0;0;0;.00nan;0;0
32099;-1;67;0;0;0;0;.00nan;0;0
32099;85336;67;89;39;2;37;.949;3569000;0
32100;200572;157;0;0;0;0;.00nan;0;0
32100;174407;157;59;37;4;33;.892;3600000;0
32100;181341;149;60;24;3;21;.875;3600000;0
32100;85546;149;0;0;0;0;.00nan;0;0
32101;173874;80;97;40;2;38;.950;3600000;0
32101;189885;4921;17;13;5;8;.615;900000;0
32101;192629;80;0;0;0;0;.00nan;0;0
32101;197912;4921;82;27;2;25;.926;2700000;0
32102;174386;81;0;0;0;0;.00nan;0;0
32102;189944;152;71;44;5;39;.886;3600000;0
32102;196414;152;0;0;0;0;.00nan;0;0
32102;186451;81;81;17;0;17;1.000;3600000;0
32103;4487;4922;90;40;3;37;.925;3900000;0
32103;184049;1097;52;25;3;22;.880;3900000;0
32103;191698;1097;0;0;0;0;.00nan;0;0
32103;86472;4922;0;0;0;0;.00nan;0;0
32104;173961;73;0;0;0;0;.00nan;0;0
32104;202246;73;98;37;1;36;.973;3600000;0
32104;85228;72;62;34;4;30;.882;3600000;0
32104;91212;72;0;0;0;0;.00nan;0;0
32105;187699;1095;82;46;5;41;.891;3600000;0
32105;-1;1095;0;0;0;0;.00nan;0;0
32105;176060;2564;0;0;0;0;.00nan;0;0
32105;79141;2564;25;32;7;25;.781;3567000;0
32106;-1;4245;0;0;0;0;.00nan;0;0
32106;170728;158;0;0;0;0;.00nan;0;0
32106;-1;158;57;41;6;35;.854;3600000;0
32106;91398;4245;64;28;3;25;.893;3600000;0
32107;199437;77;86;25;1;24;.960;3567000;0
32107;189628;74;0;0;0;0;.00nan;0;0
32107;176136;74;100;27;0;27;1.000;3600000;0
32107;85555;77;0;0;0;0;.00nan;0;0
32108;173874;80;86;28;3;25;.893;3592000;0
32108;196525;151;94;37;2;35;.946;3600000;0
32108;192629;80;0;0;0;0;.00nan;0;0
32108;85636;151;0;0;0;0;.00nan;0;0
32109;200572;157;0;0;0;0;.00nan;0;0
32109;174407;157;88;36;1;35;.972;3600000;0
32109;181341;149;45;21;3;18;.857;3572000;0
32109;85546;149;0;0;0;0;.00nan;0;0
32110;189885;4921;0;0;0;0;.00nan;0;0
32110;191574;71;53;22;2;20;.909;3549000;0
32110;197912;4921;100;46;1;45;.978;3600000;0
32110;86485;71;0;0;0;0;.00nan;0;0
32111;187699;1095;0;0;0;0;.00nan;0;0
32111;-1;1095;75;36;2;34;.944;3546000;0
32111;184049;1097;79;23;1;22;.957;3600000;0
32111;191698;1097;0;0;0;0;.00nan;0;0
32112;170728;158;0;0;0;0;.00nan;0;0
32112;-1;158;57;28;3;25;.893;3600000;0
32112;-1;67;100;27;0;27;1.000;3600000;0
32112;85336;67;0;0;0;0;.00nan;0;0
32113;173874;80;67;27;2;25;.926;3725000;0
32113;174386;81;0;0;0;0;.00nan;0;0
32113;186451;81;77;32;3;29;.906;3725000;0
32113;192629;80;0;0;0;0;.00nan;0;0
32114;200233;4620;0;0;0;0;.00nan;0;0
32114;194531;4920;65;37;4;33;.892;3572000;0
32114;180873;4620;67;23;2;21;.913;3600000;0
32114;-1;4920;0;0;0;0;.00nan;0;0
32115;183755;69;66;24;2;22;.917;3600000;0
32115;173961;73;0;0;0;0;.00nan;0;0
32115;202246;73;68;35;3;32;.914;3544000;0
32115;78479;69;0;0;0;0;.00nan;0;0
32116;187699;1095;0;0;0;0;.00nan;0;0
32116;-1;1095;98;37;1;36;.973;3819000;0
32116;179344;82;92;36;2;34;.944;3819000;0
32116;197047;82;0;0;0;0;.00nan;0;0
32117;174386;81;24;25;6;19;.760;2504000;0
32117;186451;81;10;19;6;13;.684;1096000;0
32117;85228;72;37;10;3;7;.700;509000;0
32117;91212;72;45;24;4;20;.833;3091000;0
32118;189885;4921;0;0;0;0;.00nan;0;0
32118;191574;71;49;19;3;16;.842;3600000;0
32118;197912;4921;55;39;5;34;.872;3572000;0
32118;86485;71;0;0;0;0;.00nan;0;0
32119;199437;77;57;27;3;24;.889;3544000;0
32119;200390;1096;76;38;2;36;.947;3600000;0
32119;-1;1096;0;0;0;0;.00nan;0;0
32119;85555;77;0;0;0;0;.00nan;0;0
32120;189944;152;75;35;4;31;.886;3600000;0
32120;176060;2564;76;23;1;22;.957;3600000;0
32120;196414;152;0;0;0;0;.00nan;0;0
32120;79141;2564;0;0;0;0;.00nan;0;0
32121;196525;151;77;34;2;32;.941;3600000;0
32121;181341;149;41;28;6;22;.786;3600000;0
32121;85546;149;0;0;0;0;.00nan;0;0
32121;85636;151;0;0;0;0;.00nan;0;0
32122;192895;85;0;0;0;0;.00nan;0;0
32122;176770;78;0;0;0;0;.00nan;0;0
32122;181102;78;82;27;1;26;.963;3600000;0
32122;148573;85;71;33;3;30;.909;3558000;0
32123;4487;4922;55;38;5;33;.868;3586000;0
32123;-1;76;66;30;3;27;.900;3600000;0
32123;184175;76;0;0;0;0;.00nan;0;0
32123;86472;4922;0;0;0;0;.00nan;0;0
32124;184049;1097;0;0;0;0;.00nan;0;0
32124;189628;74;0;0;0;0;.00nan;0;0
32124;176136;74;69;46;5;41;.891;3600000;0
32124;191698;1097;90;33;1;32;.970;3600000;0
32125;170728;158;74;23;1;22;.957;3600000;0
32125;-1;158;0;0;0;0;.00nan;0;0
32125;-1;67;0;0;0;0;.00nan;0;0
32125;85336;67;56;34;5;29;.853;3600000;0
32126;200572;157;0;0;0;0;.00nan;0;0
32126;174407;157;88;33;2;31;.939;3600000;0
32126;57953;75;0;0;0;0;.00nan;0;0
32126;85050;75;46;27;4;23;.852;3541000;0
32127;200233;4620;53;33;5;28;.848;3600000;0
32127;194531;4920;87;35;2;33;.943;3600000;0
32127;180873;4620;0;0;0;0;.00nan;0;0
32127;-1;4920;0;0;0;0;.00nan;0;0
32128;183755;69;0;0;0;0;.00nan;0;0
32128;173961;73;0;0;0;0;.00nan;0;0
32128;202246;73;89;44;3;41;.932;3573000;0
32128;78479;69;70;22;2;20;.909;3600000;0
32129;187699;1095;0;0;0;0;.00nan;0;0
32129;-1;1095;71;37;3;34;.919;3791000;0
32129;179344;82;0;0;0;0;.00nan;0;0
32129;197047;82;46;22;4;18;.818;3791000;0
32130;174386;81;0;0;0;0;.00nan;0;0
32130;186451;81;71;22;1;21;.955;3600000;0
32130;85228;72;65;38;4;34;.895;3600000;0
32130;91212;72;0;0;0;0;.00nan;0;0
32131;189885;4921;72;34;4;30;.882;3900000;0
32131;191574;71;57;32;4;28;.875;3900000;0
32131;197912;4921;0;0;0;0;.00nan;0;0
32131;86485;71;0;0;0;0;.00nan;0;0
32132;199437;77;88;45;2;43;.956;3887000;0
32132;184049;1097;63;23;2;21;.913;3900000;0
32132;191698;1097;0;0;0;0;.00nan;0;0
32132;85555;77;0;0;0;0;.00nan;0;0
32133;189944;152;0;0;0;0;.00nan;0;0
32133;176060;2564;0;0;0;0;.00nan;0;0
32133;196414;152;74;47;4;43;.915;3900000;0
32133;79141;2564;47;24;4;20;.833;3900000;0
32134;196525;151;69;43;4;39;.907;3900000;0
32134;181341;149;57;31;4;27;.871;3900000;0
32134;85546;149;0;0;0;0;.00nan;0;0
32134;85636;151;0;0;0;0;.00nan;0;0
32135;192895;85;100;42;0;42;1.000;3600000;0
32135;194531;4920;68;19;1;18;.947;3561000;0
32135;-1;4920;0;0;0;0;.00nan;0;0
32135;148573;85;0;0;0;0;.00nan;0;0
32136;200390;1096;0;0;0;0;.00nan;0;0
32136;189628;74;75;45;4;41;.911;3564000;0
32136;176136;74;0;0;0;0;.00nan;0;0
32136;-1;1096;70;20;1;19;.950;3600000;0
32137;4487;4922;0;0;0;0;.00nan;0;0
32137;-1;76;92;23;0;23;1.000;3600000;0
32137;184175;76;0;0;0;0;.00nan;0;0
32137;86472;4922;68;42;5;37;.881;3600000;0
32138;170728;158;0;0;0;0;.00nan;0;0
32138;-1;158;53;33;4;29;.879;3600000;0
32138;-1;67;32;24;5;19;.792;2228000;0
32138;85336;67;35;5;2;3;.600;1372000;0
32139;200572;157;0;0;0;0;.00nan;0;0
32139;174407;157;72;24;2;22;.917;3600000;0
32139;57953;75;81;30;1;29;.967;3600000;0
32139;85050;75;0;0;0;0;.00nan;0;0
32140;200233;4620;0;0;0;0;.00nan;0;0
32140;176770;78;0;0;0;0;.00nan;0;0
32140;180873;4620;68;23;3;20;.870;3869000;0
32140;181102;78;85;45;3;42;.933;3900000;0
32141;187699;1095;72;34;3;31;.912;3600000;0
32141;4487;4922;100;32;0;32;1.000;3600000;0
32141;-1;1095;0;0;0;0;.00nan;0;0
32141;86472;4922;0;0;0;0;.00nan;0;0
32142;183755;69;30;30;6;24;.800;2599000;0
32142;78479;69;65;10;0;10;1.000;1001000;0
32142;85228;72;0;0;0;0;.00nan;0;0
32142;91212;72;73;25;2;23;.920;3600000;0
32143;199437;77;81;25;1;24;.960;3600000;0
32143;179344;82;95;42;2;40;.952;3600000;0
32143;197047;82;0;0;0;0;.00nan;0;0
32143;85555;77;0;0;0;0;.00nan;0;0
32144;189944;152;59;43;6;37;.860;3600000;0
32144;176060;2564;63;28;3;25;.893;3600000;0
32144;196414;152;0;0;0;0;.00nan;0;0
32144;79141;2564;0;0;0;0;.00nan;0;0
32145;192895;85;90;37;2;35;.946;3900000;0
32145;194531;4920;0;0;0;0;.00nan;0;0
32145;-1;4920;75;29;2;27;.931;3900000;0
32145;148573;85;0;0;0;0;.00nan;0;0
32146;200390;1096;68;29;2;27;.931;3547000;0
32146;189628;74;0;0;0;0;.00nan;0;0
32146;176136;74;84;27;1;26;.963;3600000;0
32146;-1;1096;0;0;0;0;.00nan;0;0
32147;-1;76;50;27;4;23;.852;3900000;0
32147;184049;1097;0;0;0;0;.00nan;0;0
32147;184175;76;0;0;0;0;.00nan;0;0
32147;191698;1097;58;34;4;30;.882;3900000;0
32148;200572;157;0;0;0;0;.00nan;0;0
32148;174407;157;43;20;4;16;.800;3600000;0
32148;57953;75;0;0;0;0;.00nan;0;0
32148;85050;75;84;31;2;29;.935;3600000;0
32149;191574;71;53;31;4;27;.871;3776000;0
32149;85228;72;84;37;3;34;.919;3776000;0
32149;86485;71;0;0;0;0;.00nan;0;0
32149;91212;72;0;0;0;0;.00nan;0;0
32150;200233;4620;54;23;3;20;.870;3600000;0
32150;176770;78;0;0;0;0;.00nan;0;0
32150;180873;4620;0;0;0;0;.00nan;0;0
32150;181102;78;100;41;0;41;1.000;3600000;0
32151;189944;152;0;0;0;0;.00nan;0;0
32151;196414;152;77;46;4;42;.913;3600000;0
32151;196525;151;89;18;0;18;1.000;3600000;0
32151;85636;151;0;0;0;0;.00nan;0;0
32152;187699;1095;0;0;0;0;.00nan;0;0
32152;183755;69;89;33;1;32;.970;3600000;0
32152;-1;1095;63;43;5;38;.884;3600000;0
32152;78479;69;0;0;0;0;.00nan;0;0
32153;-1;76;0;0;0;0;.00nan;0;0
32153;200390;1096;0;0;0;0;.00nan;0;0
32153;184175;76;78;18;1;17;.944;3900000;0
32153;-1;1096;83;34;1;33;.971;3900000;0
32154;173961;73;0;0;0;0;.00nan;0;0
32154;176060;2564;72;29;2;27;.931;3900000;0
32154;202246;73;63;25;2;23;.920;3900000;0
32154;79141;2564;0;0;0;0;.00nan;0;0
32155;170728;158;52;36;5;31;.861;3573000;0
32155;174386;81;86;21;0;21;1.000;2789000;0
32155;-1;158;0;0;0;0;.00nan;0;0
32155;186451;81;14;4;4;0;.000;811000;0
32156;199437;77;93;29;1;28;.966;3600000;0
32156;-1;67;0;0;0;0;.00nan;0;0
32156;85336;67;40;26;5;21;.808;3600000;0
32156;85555;77;0;0;0;0;.00nan;0;0
32157;176770;78;0;0;0;0;.00nan;0;0
32157;181102;78;91;30;2;28;.933;3600000;0
32157;57953;75;0;0;0;0;.00nan;0;0
32157;85050;75;55;33;4;29;.879;3561000;0
32158;189944;152;0;0;0;0;.00nan;0;0
32158;196414;152;69;29;3;26;.897;3600000;0
32158;196525;151;62;38;4;34;.895;3581000;0
32158;85636;151;0;0;0;0;.00nan;0;0
32159;4487;4922;91;33;2;31;.939;3600000;0
32159;-1;67;39;38;6;32;.842;3600000;0
32159;85336;67;0;0;0;0;.00nan;0;0
32159;86472;4922;0;0;0;0;.00nan;0;0
32160;-1;76;82;25;1;24;.960;3600000;0
32160;200390;1096;80;36;3;33;.917;3585000;0
32160;184175;76;0;0;0;0;.00nan;0;0
32160;-1;1096;0;0;0;0;.00nan;0;0
32161;170728;158;97;22;0;22;1.000;3600000;0
32161;174386;81;0;0;0;0;.00nan;0;0
32161;-1;158;0;0;0;0;.00nan;0;0
32161;186451;81;69;37;4;33;.892;3600000;0
32162;183755;69;22;32;7;25;.781;2725000;0
32162;78479;69;65;12;0;12;1.000;875000;0
32162;85228;72;0;0;0;0;.00nan;0;0
32162;91212;72;99;22;0;22;1.000;3600000;0
32163;173874;80;55;19;2;17;.895;3551000;0
32163;189885;4921;0;0;0;0;.00nan;0;0
32163;192629;80;0;0;0;0;.00nan;0;0
32163;197912;4921;97;43;1;42;.977;3600000;0
32164;199437;77;61;18;1;17;.944;3600000;0
32164;179344;82;68;40;4;36;.900;3600000;0
32164;197047;82;0;0;0;0;.00nan;0;0
32164;85555;77;0;0;0;0;.00nan;0;0
32165;192895;85;68;39;4;35;.897;3600000;0
32165;-1;4245;0;0;0;0;.00nan;0;0
32165;91398;4245;83;23;1;22;.957;3600000;0
32165;148573;85;0;0;0;0;.00nan;0;0
32166;200572;157;0;0;0;0;.00nan;0;0
32166;174407;157;79;39;3;36;.923;3600000;0
32166;181341;149;88;21;0;21;1.000;3600000;0
32166;85546;149;0;0;0;0;.00nan;0;0
32167;200233;4620;80;35;2;33;.943;3600000;0
32167;194531;4920;0;0;0;0;.00nan;0;0
32167;180873;4620;0;0;0;0;.00nan;0;0
32167;-1;4920;62;34;4;30;.882;3545000;0
32168;184049;1097;64;24;1;23;.958;3600000;0
32168;189628;74;0;0;0;0;.00nan;0;0
32168;176136;74;71;40;5;35;.875;3600000;0
32168;191698;1097;0;0;0;0;.00nan;0;0
32169;187699;1095;0;0;0;0;.00nan;0;0
32169;-1;1095;93;53;5;48;.906;3600000;0
32169;173961;73;0;0;0;0;.00nan;0;0
32169;202246;73;87;20;0;20;1.000;3600000;0
32170;176060;2564;68;30;3;27;.900;3536000;0
32170;191574;71;0;0;0;0;.00nan;0;0
32170;79141;2564;0;0;0;0;.00nan;0;0
32170;86485;71;86;30;1;29;.967;3600000;0
32171;176770;78;0;0;0;0;.00nan;0;0
32171;181102;78;45;27;4;23;.852;3561000;0
32171;57953;75;81;31;2;29;.935;3600000;0
32171;85050;75;0;0;0;0;.00nan;0;0
32172;189944;152;95;32;1;31;.969;3600000;0
32172;196414;152;0;0;0;0;.00nan;0;0
32172;196525;151;53;31;4;27;.871;3600000;0
32172;85636;151;0;0;0;0;.00nan;0;0
32173;4487;4922;100;38;0;38;1.000;3600000;0
32173;189628;74;0;0;0;0;.00nan;0;0
32173;176136;74;86;31;2;29;.935;3525000;0
32173;86472;4922;0;0;0;0;.00nan;0;0
32174;183755;69;0;0;0;0;.00nan;0;0
32174;176060;2564;0;0;0;0;.00nan;0;0
32174;78479;69;90;26;1;25;.962;3600000;0
32174;79141;2564;52;30;4;26;.867;3600000;0
32175;-1;76;0;0;0;0;.00nan;0;0
32175;200390;1096;0;0;0;0;.00nan;0;0
32175;184175;76;54;25;3;22;.880;3900000;0
32175;-1;1096;76;34;3;31;.912;3900000;0
32176;170728;158;20;32;7;25;.781;3157000;0
32176;174386;81;78;28;2;26;.929;3600000;0
32176;-1;158;50;1;0;1;1.000;443000;0
32176;186451;81;0;0;0;0;.00nan;0;0
32177;187699;1095;68;46;6;40;.870;3600000;0
32177;-1;1095;0;0;0;0;.00nan;0;0
32177;85228;72;58;19;2;17;.895;3600000;0
32177;91212;72;0;0;0;0;.00nan;0;0
32178;173874;80;31;33;6;27;.818;3516000;0
32178;189885;4921;78;44;4;40;.909;3600000;0
32178;192629;80;0;0;0;0;.00nan;0;0
32178;197912;4921;0;0;0;0;.00nan;0;0
32179;199437;77;77;24;2;22;.917;3900000;0
32179;179344;82;0;0;0;0;.00nan;0;0
32179;197047;82;100;40;2;38;.950;3900000;0
32179;85555;77;0;0;0;0;.00nan;0;0
32180;192895;85;0;0;0;0;.00nan;0;0
32180;-1;4245;0;0;0;0;.00nan;0;0
32180;91398;4245;43;32;5;27;.844;3660000;0
32180;148573;85;67;51;6;45;.882;3660000;0
32181;200572;157;0;0;0;0;.00nan;0;0
32181;174407;157;59;40;5;35;.875;3600000;0
32181;181341;149;58;19;2;17;.895;3600000;0
32181;85546;149;0;0;0;0;.00nan;0;0
32182;200233;4620;66;27;2;25;.926;3600000;0
32182;194531;4920;61;8;0;8;1.000;478000;0
32182;180873;4620;0;0;0;0;.00nan;0;0
32182;-1;4920;42;36;6;30;.833;3122000;0
32183;184049;1097;0;0;0;0;.00nan;0;0
32183;-1;67;0;0;0;0;.00nan;0;0
32183;191698;1097;90;33;2;31;.939;3600000;0
32183;85336;67;73;44;5;39;.886;3600000;0
32184;173961;73;0;0;0;0;.00nan;0;0
32184;202246;73;99;35;1;34;.971;3600000;0
32184;191574;71;66;30;3;27;.900;3541000;0
32184;86485;71;0;0;0;0;.00nan;0;0
32185;176770;78;0;0;0;0;.00nan;0;0
32185;181102;78;64;31;4;27;.871;3549000;0
32185;57953;75;0;0;0;0;.00nan;0;0
32185;85050;75;61;25;3;22;.880;3600000;0
32186;176060;2564;24;26;6;20;.769;3027000;0
32186;79141;2564;67;12;0;12;1.000;573000;0
32186;85228;72;0;0;0;0;.00nan;0;0
32186;91212;72;86;27;1;26;.963;3600000;0
32187;173874;80;93;31;1;30;.968;3900000;0
32187;189885;4921;0;0;0;0;.00nan;0;0
32187;192629;80;0;0;0;0;.00nan;0;0
32187;197912;4921;84;30;1;29;.967;3900000;0
32188;192895;85;33;30;6;24;.800;2483000;0
32188;-1;4245;0;0;0;0;.00nan;0;0
32188;91398;4245;60;24;3;21;.875;3600000;0
32188;148573;85;70;12;0;12;1.000;1117000;0
32189;200572;157;0;0;0;0;.00nan;0;0
32189;174407;157;59;22;3;19;.864;3600000;0
32189;181341;149;43;28;4;24;.857;3600000;0
32189;85546;149;0;0;0;0;.00nan;0;0
32190;200233;4620;47;19;3;16;.842;3600000;0
32190;194531;4920;0;0;0;0;.00nan;0;0
32190;180873;4620;0;0;0;0;.00nan;0;0
32190;-1;4920;100;50;2;48;.960;3600000;0
32191;184049;1097;71;32;2;30;.938;3600000;0
32191;-1;67;72;39;4;35;.897;3600000;0
32191;191698;1097;0;0;0;0;.00nan;0;0
32191;85336;67;0;0;0;0;.00nan;0;0
32192;183755;69;100;42;0;42;1.000;3600000;0
32192;191574;71;0;0;0;0;.00nan;0;0
32192;78479;69;0;0;0;0;.00nan;0;0
32192;86485;71;77;26;1;25;.962;3543000;0
32193;187699;1095;0;0;0;0;.00nan;0;0
32193;-1;1095;94;51;3;48;.941;3600000;0
32193;85228;72;62;19;2;17;.895;3600000;0
32193;91212;72;0;0;0;0;.00nan;0;0
32194;189885;4921;0;0;0;0;.00nan;0;0
32194;196525;151;81;22;1;21;.955;3600000;0
32194;197912;4921;42;19;4;15;.789;3600000;0
32194;85636;151;0;0;0;0;.00nan;0;0
32195;189944;152;73;42;4;38;.905;3600000;0
32195;196414;152;0;0;0;0;.00nan;0;0
32195;181341;149;39;24;5;19;.792;3545000;0
32195;85546;149;0;0;0;0;.00nan;0;0
32196;194531;4920;0;0;0;0;.00nan;0;0
32196;-1;67;0;0;0;0;.00nan;0;0
32196;-1;4920;68;20;1;19;.950;3600000;0
32196;85336;67;98;63;2;61;.968;3600000;0
32197;200572;157;0;0;0;0;.00nan;0;0
32197;170728;158;74;36;3;33;.917;3600000;0
32197;174407;157;82;27;1;26;.963;3600000;0
32197;-1;158;0;0;0;0;.00nan;0;0
32198;200233;4620;54;33;5;28;.848;3600000;0
32198;-1;4245;0;0;0;0;.00nan;0;0
32198;180873;4620;0;0;0;0;.00nan;0;0
32198;91398;4245;100;33;1;32;.970;3600000;0
32199;-1;76;84;26;1;25;.962;3600000;0
32199;184175;76;0;0;0;0;.00nan;0;0
32199;179344;82;0;0;0;0;.00nan;0;0
32199;197047;82;65;36;4;32;.889;3600000;0
32200;199437;77;97;33;1;32;.970;3600000;0
32200;189628;74;0;0;0;0;.00nan;0;0
32200;176136;74;51;20;3;17;.850;3595000;0
32200;85555;77;0;0;0;0;.00nan;0;0
32201;194531;4920;0;0;0;0;.00nan;0;0
32201;176770;78;0;0;0;0;.00nan;0;0
32201;181102;78;63;31;4;27;.871;3569000;0
32201;-1;4920;78;25;2;23;.920;3600000;0
32202;199437;77;69;28;2;26;.929;3600000;0
32202;200390;1096;25;6;3;3;.500;564000;0
32202;-1;1096;45;14;2;12;.857;3036000;0
32202;85555;77;0;0;0;0;.00nan;0;0
32203;173961;73;0;0;0;0;.00nan;0;0
32203;202246;73;61;27;3;24;.889;3600000;0
32203;85228;72;71;43;4;39;.907;3570000;0
32203;91212;72;0;0;0;0;.00nan;0;0
32204;184049;1097;57;26;3;23;.885;3564000;0
32204;179344;82;88;36;2;34;.944;3600000;0
32204;197047;82;0;0;0;0;.00nan;0;0
32204;191698;1097;0;0;0;0;.00nan;0;0
32205;183755;69;85;39;2;37;.949;3849000;0
32205;176060;2564;91;37;1;36;.973;3849000;0
32205;78479;69;0;0;0;0;.00nan;0;0
32205;79141;2564;0;0;0;0;.00nan;0;0
32206;189885;4921;0;0;0;0;.00nan;0;0
32206;196525;151;68;29;3;26;.897;3900000;0
32206;197912;4921;76;33;3;30;.909;3900000;0
32206;85636;151;0;0;0;0;.00nan;0;0
32207;4487;4922;69;44;5;39;.886;3555000;0
32207;57953;75;64;23;3;20;.870;3600000;0
32207;85050;75;0;0;0;0;.00nan;0;0
32207;86472;4922;0;0;0;0;.00nan;0;0
32208;189944;152;64;39;4;35;.897;3035000;0
32208;196414;152;30;9;3;6;.667;565000;0
32208;181341;149;100;25;0;25;1.000;3600000;0
32208;85546;149;0;0;0;0;.00nan;0;0
32209;-1;76;0;0;0;0;.00nan;0;0
32209;184175;76;90;31;2;29;.935;3600000;0
32209;189628;74;0;0;0;0;.00nan;0;0
32209;176136;74;58;34;4;30;.882;3569000;0
32210;187699;1095;0;0;0;0;.00nan;0;0
32210;-1;1095;89;39;3;36;.923;3600000;0
32210;191574;71;40;18;4;14;.778;3563000;0
32210;86485;71;0;0;0;0;.00nan;0;0
32211;192895;85;0;0;0;0;.00nan;0;0
32211;-1;67;100;38;2;36;.947;3900000;0
32211;85336;67;0;0;0;0;.00nan;0;0
32211;148573;85;80;40;2;38;.950;3900000;0
32212;173874;80;52;29;4;25;.862;3600000;0
32212;174386;81;0;0;0;0;.00nan;0;0
32212;186451;81;60;40;5;35;.875;3591000;0
32212;192629;80;0;0;0;0;.00nan;0;0
32213;200572;157;0;0;0;0;.00nan;0;0
32213;170728;158;83;34;2;32;.941;3565000;0
32213;174407;157;85;16;0;16;1.000;3600000;0
32213;-1;158;0;0;0;0;.00nan;0;0
32214;200233;4620;0;0;0;0;.00nan;0;0
32214;-1;4245;0;0;0;0;.00nan;0;0
32214;180873;4620;77;17;1;16;.941;3600000;0
32214;91398;4245;59;32;4;28;.875;3600000;0
32215;194531;4920;0;0;0;0;.00nan;0;0
32215;176770;78;0;0;0;0;.00nan;0;0
32215;181102;78;87;44;3;41;.932;3900000;0
32215;-1;4920;80;41;3;38;.927;3900000;0
32216;183755;69;0;0;0;0;.00nan;0;0
32216;191574;71;40;28;5;23;.821;3900000;0
32216;78479;69;56;37;5;32;.865;3881000;0
32216;86485;71;0;0;0;0;.00nan;0;0
32217;199437;77;58;33;4;29;.879;3600000;0
32217;200390;1096;34;25;5;20;.800;3548000;0
32217;-1;1096;0;0;0;0;.00nan;0;0
32217;85555;77;0;0;0;0;.00nan;0;0
32218;173961;73;44;21;3;18;.857;1351000;0
32218;176060;2564;0;0;0;0;.00nan;0;0
32218;202246;73;33;24;5;19;.792;2249000;0
32218;79141;2564;66;29;3;26;.897;3600000;0
32219;189885;4921;100;39;0;39;1.000;3600000;0
32219;196525;151;67;36;3;33;.917;3600000;0
32219;197912;4921;0;0;0;0;.00nan;0;0
32219;85636;151;0;0;0;0;.00nan;0;0
32220;4487;4922;0;0;0;0;.00nan;0;0
32220;57953;75;0;0;0;0;.00nan;0;0
32220;85050;75;76;24;1;23;.958;3600000;0
32220;86472;4922;88;41;2;39;.951;3557000;0
32221;-1;76;32;25;5;20;.800;3546000;0
32221;184175;76;0;0;0;0;.00nan;0;0
32221;189628;74;66;34;4;30;.882;3600000;0
32221;176136;74;0;0;0;0;.00nan;0;0
32222;189944;152;0;0;0;0;.00nan;0;0
32222;196414;152;76;33;2;31;.939;3600000;0
32222;181341;149;35;23;4;19;.826;3532000;0
32222;85546;149;0;0;0;0;.00nan;0;0
32223;184049;1097;0;0;0;0;.00nan;0;0
32223;179344;82;0;0;0;0;.00nan;0;0
32223;197047;82;89;49;4;45;.918;3595000;0
32223;191698;1097;57;21;2;19;.905;3600000;0
32224;187699;1095;98;72;4;68;.944;3600000;0
32224;-1;1095;0;0;0;0;.00nan;0;0
32224;85228;72;0;0;0;0;.00nan;0;0
32224;91212;72;56;17;2;15;.882;3600000;0
32225;192895;85;41;31;5;26;.839;3570000;0
32225;-1;67;0;0;0;0;.00nan;0;0
32225;85336;67;86;33;2;31;.939;3600000;0
32225;148573;85;0;0;0;0;.00nan;0;0
32226;200572;157;0;0;0;0;.00nan;0;0
32226;170728;158;0;0;0;0;.00nan;0;0
32226;174407;157;99;43;2;41;.953;3600000;0
32226;-1;158;51;29;4;25;.862;3536000;0
32227;173874;80;84;12;0;12;1.000;3600000;0
32227;174386;81;69;39;4;35;.897;3600000;0
32227;186451;81;0;0;0;0;.00nan;0;0
32227;192629;80;0;0;0;0;.00nan;0;0
32228;200233;4620;71;16;1;15;.938;3600000;0
32228;-1;4245;0;0;0;0;.00nan;0;0
32228;180873;4620;0;0;0;0;.00nan;0;0
32228;91398;4245;72;32;3;29;.906;3540000;0
32229;183755;69;60;40;4;36;.900;3600000;0
32229;176060;2564;27;26;5;21;.808;3600000;0
32229;78479;69;0;0;0;0;.00nan;0;0
32229;79141;2564;0;0;0;0;.00nan;0;0
32230;170728;158;59;27;3;24;.889;3600000;0
32230;-1;158;0;0;0;0;.00nan;0;0
32230;181341;149;61;34;4;30;.882;3569000;0
32230;85546;149;0;0;0;0;.00nan;0;0
32231;191574;71;58;42;6;36;.857;3676000;0
32231;85228;72;0;0;0;0;.00nan;0;0
32231;86485;71;0;0;0;0;.00nan;0;0
32231;91212;72;50;35;5;30;.857;3676000;0
32232;187699;1095;0;0;0;0;.00nan;0;0
32232;-1;1095;43;43;7;36;.837;3600000;0
32232;189885;4921;79;21;1;20;.952;3600000;0
32232;197912;4921;0;0;0;0;.00nan;0;0
32233;194531;4920;0;0;0;0;.00nan;0;0
32233;-1;4920;77;36;3;33;.917;3600000;0
32233;57953;75;68;38;4;34;.895;3572000;0
32233;85050;75;0;0;0;0;.00nan;0;0
32234;192895;85;0;0;0;0;.00nan;0;0
32234;-1;67;100;42;1;41;.976;3600000;0
32234;85336;67;0;0;0;0;.00nan;0;0
32234;148573;85;66;23;3;20;.870;3583000;0
32235;200572;157;0;0;0;0;.00nan;0;0
32235;174407;157;78;39;3;36;.923;3600000;0
32235;196525;151;72;38;4;34;.895;3566000;0
32235;85636;151;0;0;0;0;.00nan;0;0
32236;173874;80;92;34;2;32;.941;3600000;0
32236;189944;152;62;37;4;33;.892;3549000;0
32236;196414;152;0;0;0;0;.00nan;0;0
32236;192629;80;0;0;0;0;.00nan;0;0
32237;4487;4922;31;15;4;11;.733;795000;0
32237;200390;1096;74;27;1;26;.963;3600000;0
32237;-1;1096;0;0;0;0;.00nan;0;0
32237;86472;4922;96;34;1;33;.971;2805000;0
32238;-1;76;83;40;2;38;.950;3600000;0
32238;184049;1097;0;0;0;0;.00nan;0;0
32238;184175;76;0;0;0;0;.00nan;0;0
32238;191698;1097;82;24;1;23;.958;3600000;0
32239;189944;152;90;31;1;30;.968;3900000;0
32239;176770;78;0;0;0;0;.00nan;0;0
32239;196414;152;0;0;0;0;.00nan;0;0
32239;181102;78;73;17;1;16;.941;3900000;0
32240;4487;4922;87;39;3;36;.923;3900000;0
32240;200390;1096;0;0;0;0;.00nan;0;0
32240;-1;1096;57;18;3;15;.833;3900000;0
32240;86472;4922;0;0;0;0;.00nan;0;0
32241;183755;69;92;44;3;41;.932;3688000;0
32241;176060;2564;53;15;2;13;.867;3688000;0
32241;78479;69;0;0;0;0;.00nan;0;0
32241;79141;2564;0;0;0;0;.00nan;0;0
32242;170728;158;90;54;4;50;.926;3569000;0
32242;-1;158;0;0;0;0;.00nan;0;0
32242;181341;149;58;22;2;20;.909;3600000;0
32242;85546;149;0;0;0;0;.00nan;0;0
32243;187699;1095;0;0;0;0;.00nan;0;0
32243;-1;1095;93;44;3;41;.932;3786000;0
32243;189885;4921;0;0;0;0;.00nan;0;0
32243;197912;4921;62;27;4;23;.852;3786000;0
32244;192895;85;0;0;0;0;.00nan;0;0
32244;200233;4620;94;23;0;23;1.000;3600000;0
32244;180873;4620;0;0;0;0;.00nan;0;0
32244;148573;85;71;43;4;39;.907;3600000;0
32245;-1;4245;0;0;0;0;.00nan;0;0
32245;-1;67;97;41;3;38;.927;2956000;0
32245;85336;67;17;7;4;3;.429;644000;0
32245;91398;4245;85;29;1;28;.966;3600000;0
32246;194531;4920;0;0;0;0;.00nan;0;0
32246;-1;4920;62;33;3;30;.909;3588000;0
32246;57953;75;0;0;0;0;.00nan;0;0
32246;85050;75;86;38;2;36;.947;3600000;0
32247;189628;74;0;0;0;0;.00nan;0;0
32247;179344;82;0;0;0;0;.00nan;0;0
32247;176136;74;63;24;2;22;.917;3600000;0
32247;197047;82;64;37;4;33;.892;3527000;0
32248;-1;76;49;1;0;1;1.000;313000;0
32248;184049;1097;51;40;6;34;.850;3600000;0
32248;184175;76;56;49;7;42;.857;3250000;0
32248;191698;1097;0;0;0;0;.00nan;0;0
32249;173874;80;56;27;3;24;.889;3585000;0
32249;174386;81;0;0;0;0;.00nan;0;0
32249;186451;81;78;26;1;25;.962;3600000;0
32249;192629;80;0;0;0;0;.00nan;0;0
32250;200572;157;0;0;0;0;.00nan;0;0
32250;174407;157;80;29;2;27;.931;3600000;0
32250;196525;151;49;20;3;17;.850;3588000;0
32250;85636;151;0;0;0;0;.00nan;0;0
32251;173961;73;0;0;0;0;.00nan;0;0
32251;202246;73;59;34;4;30;.882;3524000;0
32251;191574;71;82;37;2;35;.946;3600000;0
32251;86485;71;0;0;0;0;.00nan;0;0
32252;189944;152;0;0;0;0;.00nan;0;0
32252;176770;78;0;0;0;0;.00nan;0;0
32252;196414;152;89;42;3;39;.929;3555000;0
32252;181102;78;76;24;2;22;.917;3600000;0
32253;173961;73;0;0;0;0;.00nan;0;0
32253;202246;73;66;40;5;35;.875;3600000;0
32253;85228;72;52;23;3;20;.870;2948000;0
32253;91212;72;13;5;4;1;.200;640000;0
32254;170728;158;0;0;0;0;.00nan;0;0
32254;-1;158;81;36;2;34;.944;3561000;0
32254;181341;149;73;25;1;24;.960;3600000;0
32254;85546;149;0;0;0;0;.00nan;0;0
32255;187699;1095;97;40;3;37;.925;3600000;0
32255;-1;1095;0;0;0;0;.00nan;0;0
32255;189885;4921;80;47;4;43;.915;3576000;0
32255;197912;4921;0;0;0;0;.00nan;0;0
32256;183755;69;0;0;0;0;.00nan;0;0
32256;176060;2564;0;0;0;0;.00nan;0;0
32256;78479;69;54;45;5;40;.889;3900000;0
32256;79141;2564;50;33;5;28;.848;3900000;0
32257;-1;4245;0;0;0;0;.00nan;0;0
32257;-1;67;0;0;0;0;.00nan;0;0
32257;85336;67;83;37;2;35;.946;3600000;0
32257;91398;4245;41;18;4;14;.778;3520000;0
32258;194531;4920;0;0;0;0;.00nan;0;0
32258;-1;4920;98;32;1;31;.969;3555000;0
32258;57953;75;100;41;0;41;1.000;3600000;0
32258;85050;75;0;0;0;0;.00nan;0;0
32259;189628;74;0;0;0;0;.00nan;0;0
32259;179344;82;74;40;3;37;.925;3564000;0
32259;176136;74;63;18;1;17;.944;3600000;0
32259;197047;82;0;0;0;0;.00nan;0;0
32260;-1;76;43;32;5;27;.844;3600000;0
32260;200390;1096;68;36;4;32;.889;3600000;0
32260;184175;76;0;0;0;0;.00nan;0;0
32260;-1;1096;0;0;0;0;.00nan;0;0
32261;199437;77;85;35;2;33;.943;3600000;0
32261;184049;1097;62;7;0;7;1.000;524000;0
32261;191698;1097;16;19;6;13;.684;3076000;0
32261;85555;77;0;0;0;0;.00nan;0;0
32262;200572;157;0;0;0;0;.00nan;0;0
32262;174407;157;68;32;4;28;.875;3600000;0
32262;196525;151;100;29;0;29;1.000;3600000;0
32262;85636;151;0;0;0;0;.00nan;0;0
32263;173874;80;60;20;3;17;.850;3746000;0
32263;174386;81;80;24;2;22;.917;3746000;0
32263;186451;81;0;0;0;0;.00nan;0;0
32263;192629;80;0;0;0;0;.00nan;0;0
32264;192895;85;61;33;4;29;.879;3600000;0
32264;200233;4620;35;26;5;21;.808;3600000;0
32264;180873;4620;0;0;0;0;.00nan;0;0
32264;148573;85;0;0;0;0;.00nan;0;0
32265;189944;152;89;45;4;41;.911;3600000;0
32265;176770;78;0;0;0;0;.00nan;0;0
32265;196414;152;0;0;0;0;.00nan;0;0
32265;181102;78;30;25;5;20;.800;3545000;0
32266;4487;4922;27;8;3;5;.625;282000;0
32266;199437;77;57;19;2;17;.895;3600000;0
32266;85555;77;0;0;0;0;.00nan;0;0
32266;86472;4922;54;28;3;25;.893;3318000;0
32267;173961;73;0;0;0;0;.00nan;0;0
32267;176060;2564;81;36;3;33;.917;3600000;0
32267;202246;73;42;35;5;30;.857;3528000;0
32267;79141;2564;0;0;0;0;.00nan;0;0
32268;-1;4245;0;0;0;0;.00nan;0;0
32268;-1;67;94;56;4;52;.929;3600000;0
32268;85336;67;0;0;0;0;.00nan;0;0
32268;91398;4245;90;28;1;27;.964;3600000;0
32269;189628;74;67;19;1;18;.947;3575000;0
32269;179344;82;0;0;0;0;.00nan;0;0
32269;176136;74;0;0;0;0;.00nan;0;0
32269;197047;82;100;26;0;26;1.000;3600000;0
32270;191574;71;63;24;2;22;.917;3600000;0
32270;85228;72;0;0;0;0;.00nan;0;0
32270;86485;71;0;0;0;0;.00nan;0;0
32270;91212;72;25;29;6;23;.793;3600000;0
32271;173874;80;55;34;5;29;.853;3600000;0
32271;174386;81;0;0;0;0;.00nan;0;0
32271;186451;81;66;24;2;22;.917;3600000;0
32271;192629;80;0;0;0;0;.00nan;0;0
32272;192895;85;0;0;0;0;.00nan;0;0
32272;200233;4620;0;0;0;0;.00nan;0;0
32272;180873;4620;42;16;3;13;.813;3544000;0
32272;148573;85;100;60;2;58;.967;3600000;0
32273;183755;69;91;31;1;30;.968;3600000;0
32273;196525;151;47;28;4;24;.857;3600000;0
32273;78479;69;0;0;0;0;.00nan;0;0
32273;85636;151;0;0;0;0;.00nan;0;0
32274;199437;77;69;32;3;29;.906;3900000;0
32274;200390;1096;79;38;3;35;.921;3900000;0
32274;-1;1096;0;0;0;0;.00nan;0;0
32274;85555;77;0;0;0;0;.00nan;0;0
32275;189885;4921;0;0;0;0;.00nan;0;0
32275;176060;2564;63;23;3;20;.870;3600000;0
32275;197912;4921;83;43;4;39;.907;3543000;0
32275;79141;2564;0;0;0;0;.00nan;0;0
32276;183755;69;0;0;0;0;.00nan;0;0
32276;196525;151;0;0;0;0;.00nan;0;0
32276;78479;69;70;39;4;35;.897;3554000;0
32276;85636;151;85;38;3;35;.921;3600000;0
32277;-1;4245;0;0;0;0;.00nan;0;0
32277;57953;75;80;60;6;54;.900;3561000;0
32277;85050;75;0;0;0;0;.00nan;0;0
32277;91398;4245;55;26;4;22;.846;3600000;0
32278;173874;80;83;49;4;45;.918;3600000;0
32278;181341;149;52;17;2;15;.882;3600000;0
32278;192629;80;0;0;0;0;.00nan;0;0
32278;85546;149;0;0;0;0;.00nan;0;0
32279;200390;1096;0;0;0;0;.00nan;0;0
32279;184049;1097;74;31;3;28;.903;3900000;0
32279;-1;1096;62;29;3;26;.897;3900000;0
32279;191698;1097;0;0;0;0;.00nan;0;0
32280;173961;73;0;0;0;0;.00nan;0;0
32280;202246;73;76;30;2;28;.933;3600000;0
32280;85228;72;44;28;4;24;.857;3574000;0
32280;91212;72;0;0;0;0;.00nan;0;0
32281;4487;4922;96;31;1;30;.968;3600000;0
32281;179344;82;0;0;0;0;.00nan;0;0
32281;197047;82;73;39;4;35;.897;3600000;0
32281;86472;4922;0;0;0;0;.00nan;0;0
32282;200572;157;0;0;0;0;.00nan;0;0
32282;170728;158;84;33;3;30;.909;3600000;0
32282;174407;157;63;37;5;32;.865;3520000;0
32282;-1;158;0;0;0;0;.00nan;0;0
32283;189885;4921;0;0;0;0;.00nan;0;0
32283;176060;2564;83;30;1;29;.967;3600000;0
32283;197912;4921;85;36;2;34;.944;3557000;0
32283;79141;2564;0;0;0;0;.00nan;0;0
32284;199437;77;86;39;2;37;.949;3600000;0
32284;-1;76;57;30;4;26;.867;3549000;0
32284;184175;76;0;0;0;0;.00nan;0;0
32284;85555;77;0;0;0;0;.00nan;0;0
32285;192895;85;0;0;0;0;.00nan;0;0
32285;176770;78;0;0;0;0;.00nan;0;0
32285;181102;78;87;40;2;38;.950;3584000;0
32285;148573;85;100;27;0;27;1.000;3600000;0
32286;173874;80;75;23;2;21;.913;3600000;0
32286;181341;149;50;33;5;28;.848;3600000;0
32286;192629;80;0;0;0;0;.00nan;0;0
32286;85546;149;0;0;0;0;.00nan;0;0
32287;194531;4920;0;0;0;0;.00nan;0;0
32287;189628;74;0;0;0;0;.00nan;0;0
32287;176136;74;86;42;3;39;.929;3570000;0
32287;-1;4920;65;18;2;16;.889;3600000;0
32288;200233;4620;26;16;5;11;.688;3664000;0
32288;180873;4620;0;0;0;0;.00nan;0;0
32288;-1;67;0;0;0;0;.00nan;0;0
32288;85336;67;80;47;4;43;.915;3664000;0
32289;174386;81;0;0;0;0;.00nan;0;0
32289;189944;152;100;26;0;26;1.000;3600000;0
32289;196414;152;0;0;0;0;.00nan;0;0
32289;186451;81;72;23;1;22;.957;3544000;0
32290;187699;1095;0;0;0;0;.00nan;0;0
32290;-1;1095;60;36;4;32;.889;3696000;0
32290;187118;71;58;33;5;28;.848;3696000;0
32290;191574;71;0;0;0;0;.00nan;0;0
32291;192895;85;0;0;0;0;.00nan;0;0
32291;176770;78;0;0;0;0;.00nan;0;0
32291;181102;78;79;28;2;26;.929;3900000;0
32291;148573;85;83;37;2;35;.946;3900000;0
32292;174386;81;73;29;2;27;.931;3600000;0
32292;189944;152;63;27;3;24;.889;3600000;0
32292;196414;152;0;0;0;0;.00nan;0;0
32292;186451;81;0;0;0;0;.00nan;0;0
32293;200390;1096;70;32;3;29;.906;3600000;0
32293;184049;1097;0;0;0;0;.00nan;0;0
32293;-1;1096;0;0;0;0;.00nan;0;0
32293;191698;1097;45;28;4;24;.857;3574000;0
32294;200572;157;0;0;0;0;.00nan;0;0
32294;170728;158;0;0;0;0;.00nan;0;0
32294;174407;157;88;32;1;31;.969;3592000;0
32294;-1;158;100;27;0;27;1.000;3600000;0
32295;176060;2564;54;17;2;15;.882;1292000;0
32295;79141;2564;30;24;6;18;.750;2308000;0
32295;85228;72;0;0;0;0;.00nan;0;0
32295;91212;72;61;38;5;33;.868;3600000;0
32296;189885;4921;42;35;6;29;.829;3600000;0
32296;196525;151;80;27;3;24;.889;3600000;0
32296;197912;4921;0;0;0;0;.00nan;0;0
32296;85636;151;0;0;0;0;.00nan;0;0
32297;4487;4922;89;43;3;40;.930;3600000;0
32297;199437;77;43;24;4;20;.833;3549000;0
32297;85555;77;0;0;0;0;.00nan;0;0
32297;86472;4922;0;0;0;0;.00nan;0;0
32298;-1;4245;0;0;0;0;.00nan;0;0
32298;57953;75;0;0;0;0;.00nan;0;0
32298;85050;75;65;32;3;29;.906;3527000;0
32298;91398;4245;66;16;1;15;.938;3600000;0
32299;173874;80;84;22;1;21;.955;3900000;0
32299;181341;149;81;29;1;28;.966;3900000;0
32299;192629;80;0;0;0;0;.00nan;0;0
32299;85546;149;0;0;0;0;.00nan;0;0
32300;194531;4920;0;0;0;0;.00nan;0;0
32300;189628;74;75;50;5;45;.900;3600000;0
32300;176136;74;0;0;0;0;.00nan;0;0
32300;-1;4920;76;24;1;23;.958;3600000;0
32301;-1;76;0;0;0;0;.00nan;0;0
32301;184175;76;43;15;3;12;.800;3600000;0
32301;179344;82;32;37;7;30;.811;2932000;0
32301;197047;82;66;16;1;15;.938;668000;0
32302;187699;1095;64;30;3;27;.900;3600000;0
32302;-1;1095;0;0;0;0;.00nan;0;0
32302;173961;73;64;16;1;15;.938;2515000;0
32302;202246;73;35;15;4;11;.733;1040000;0
32303;200233;4620;0;0;0;0;.00nan;0;0
32303;180873;4620;54;25;2;23;.920;3600000;0
32303;-1;67;85;49;4;45;.918;3580000;0
32303;85336;67;0;0;0;0;.00nan;0;0
32304;183755;69;80;36;3;33;.917;3600000;0
32304;187118;71;84;24;1;23;.958;3600000;0
32304;191574;71;0;0;0;0;.00nan;0;0
32304;78479;69;0;0;0;0;.00nan;0;0
32305;192895;85;44;33;6;27;.818;3871000;0
32305;176770;78;0;0;0;0;.00nan;0;0
32305;181102;78;48;34;5;29;.853;3871000;0
32305;148573;85;0;0;0;0;.00nan;0;0
32306;174386;81;0;0;0;0;.00nan;0;0
32306;189944;152;0;0;0;0;.00nan;0;0
32306;196414;152;81;26;1;25;.962;3600000;0
32306;186451;81;74;33;2;31;.939;3600000;0
32307;187699;1095;0;0;0;0;.00nan;0;0
32307;-1;1095;61;28;3;25;.893;3859000;0
32307;173961;73;0;0;0;0;.00nan;0;0
32307;202246;73;73;44;4;40;.909;3859000;0
32308;-1;76;50;21;3;18;.857;3600000;0
32308;184175;76;0;0;0;0;.00nan;0;0
32308;179344;82;0;0;0;0;.00nan;0;0
32308;197047;82;47;24;4;20;.833;3566000;0
32309;4487;4922;69;11;0;11;1.000;695000;0
32309;199437;77;60;24;3;21;.875;3600000;0
32309;85555;77;0;0;0;0;.00nan;0;0
32309;86472;4922;23;26;6;20;.769;2905000;0
32310;-1;4245;0;0;0;0;.00nan;0;0
32310;57953;75;96;39;1;38;.974;3900000;0
32310;85050;75;0;0;0;0;.00nan;0;0
32310;91398;4245;93;30;1;29;.967;3900000;0
32311;200233;4620;67;26;2;24;.923;3600000;0
32311;180873;4620;0;0;0;0;.00nan;0;0
32311;-1;67;69;13;0;13;1.000;1554000;0
32311;85336;67;59;32;4;28;.875;1967000;0
32313;4487;4922;41;27;5;22;.815;3600000;0
32313;189885;4921;32;44;7;37;.841;3556000;0
32313;197912;4921;0;0;0;0;.00nan;0;0
32313;86472;4922;0;0;0;0;.00nan;0;0
32315;178394;1095;90;27;1;26;.963;3600000;0
32315;-1;152;0;0;0;0;.00nan;0;0
32315;-1;1095;0;0;0;0;.00nan;0;0
32315;189944;152;88;35;2;33;.943;3574000;0
32317;184049;1097;41;30;5;25;.833;3573000;0
32317;173961;73;60;35;4;31;.886;3600000;0
32317;-1;1097;0;0;0;0;.00nan;0;0
32317;-1;73;0;0;0;0;.00nan;0;0
32319;192895;85;0;0;0;0;.00nan;0;0
32319;200572;157;0;0;0;0;.00nan;0;0
32319;77084;157;67;33;4;29;.879;3600000;0
32319;148573;85;39;24;5;19;.792;3598000;0
32321;-1;76;78;41;3;38;.927;3582000;0
32321;184175;76;0;0;0;0;.00nan;0;0
32321;174386;81;0;0;0;0;.00nan;0;0
32321;186451;81;78;22;1;21;.955;3600000;0
32323;-1;67;32;17;4;13;.765;1028000;0
32323;200390;1096;52;24;4;20;.833;3600000;0
32323;-1;1096;0;0;0;0;.00nan;0;0
32323;191698;67;48;23;4;19;.826;2572000;0
32325;194531;4920;100;28;0;28;1.000;3600000;0
32325;196525;151;60;29;3;26;.897;3600000;0
32325;202246;4920;0;0;0;0;.00nan;0;0
32325;85636;151;0;0;0;0;.00nan;0;0
32327;171615;75;38;7;2;5;.714;592000;0
32327;174407;75;45;40;6;34;.850;3008000;0
32327;64722;72;0;0;0;0;.00nan;0;0
32327;91212;72;48;13;2;11;.846;3600000;0
32329;170351;149;0;0;0;0;.00nan;0;0
32329;196414;4620;0;0;0;0;.00nan;0;0
32329;181341;4620;61;33;4;29;.879;3556000;0
32329;85546;149;71;26;2;24;.923;3600000;0
32331;179344;82;0;0;0;0;.00nan;0;0
32331;185800;71;0;0;0;0;.00nan;0;0
32331;197047;82;91;57;3;54;.947;3600000;0
32331;58054;71;76;26;2;24;.923;3600000;0
32333;183755;69;31;27;6;21;.778;3600000;0
32333;192629;80;0;0;0;0;.00nan;0;0
32333;58100;69;0;0;0;0;.00nan;0;0
32333;85228;80;91;38;3;35;.921;3600000;0
32335;194899;4245;34;27;5;22;.815;3537000;0
32335;-1;2564;73;38;4;34;.895;3600000;0
32335;176060;2564;0;0;0;0;.00nan;0;0
32335;196445;4245;0;0;0;0;.00nan;0;0
32337;189628;74;0;0;0;0;.00nan;0;0
32337;176136;74;51;29;4;25;.862;3516000;0
32337;180873;77;0;0;0;0;.00nan;0;0
32337;85555;77;80;30;2;28;.933;3600000;0
32339;183737;78;79;31;2;29;.935;3600000;0
32339;173874;158;61;25;3;22;.880;3600000;0
32339;176770;78;0;0;0;0;.00nan;0;0
32339;-1;158;0;0;0;0;.00nan;0;0
2218;-1;4245;0;0;0;0;.00nan;0;0
2218;176770;78;62;28;4;24;.857;3032000;0
2218;181102;78;26;8;3;5;.625;568000;0
2218;91398;4245;76;22;1;21;.955;3600000;0
2219;200233;4620;70;42;4;38;.905;3593000;0
2219;194531;4920;0;0;0;0;.00nan;0;0
2219;180873;4620;0;0;0;0;.00nan;0;0
2219;-1;4920;80;37;2;35;.946;3600000;0
2220;184049;1097;0;0;0;0;.00nan;0;0
2220;189628;74;0;0;0;0;.00nan;0;0
2220;176136;74;64;24;2;22;.917;3600000;0
2220;191698;1097;77;24;1;23;.958;3600000;0
2221;-1;76;47;24;4;20;.833;3619000;0
2221;200390;1096;0;0;0;0;.00nan;0;0
2221;184175;76;0;0;0;0;.00nan;0;0
2221;-1;1096;46;30;5;25;.833;3619000;0
2222;176060;2564;75;28;2;26;.929;3600000;0
2222;79141;2564;0;0;0;0;.00nan;0;0
2222;85228;72;25;11;4;7;.636;1032000;0
2222;91212;72;63;12;1;11;.917;2568000;0
2223;183755;69;76;32;4;28;.875;3564000;0
2223;187118;71;78;29;2;27;.931;3600000;0
2223;191574;71;0;0;0;0;.00nan;0;0
2223;78479;69;0;0;0;0;.00nan;0;0
2224;200572;157;0;0;0;0;.00nan;0;0
2224;174386;81;0;0;0;0;.00nan;0;0
2224;174407;157;38;38;6;32;.842;3600000;0
2224;186451;81;76;32;2;30;.938;3600000;0
2225;173874;80;94;29;1;28;.966;3600000;0
2225;181341;149;33;31;6;25;.806;3187000;0
2225;192629;80;0;0;0;0;.00nan;0;0
2225;85546;149;42;4;1;3;.750;413000;0
2226;-1;4245;0;0;0;0;.00nan;0;0
2226;176770;78;0;0;0;0;.00nan;0;0
2226;181102;78;43;25;4;21;.840;3552000;0
2226;91398;4245;76;29;2;27;.931;3600000;0
2227;200233;4620;76;20;1;19;.950;3600000;0
2227;194531;4920;0;0;0;0;.00nan;0;0
2227;180873;4620;0;0;0;0;.00nan;0;0
2227;-1;4920;48;42;6;36;.857;3600000;0
2228;184049;1097;0;0;0;0;.00nan;0;0
2228;189628;74;0;0;0;0;.00nan;0;0
2228;176136;74;77;32;2;30;.938;4043000;0
2228;191698;1097;86;44;3;41;.932;4043000;0
2229;-1;76;73;27;3;24;.889;3515000;0
2229;200390;1096;0;0;0;0;.00nan;0;0
2229;184175;76;0;0;0;0;.00nan;0;0
2229;-1;1096;77;25;1;24;.960;3600000;0
2230;176060;2564;66;43;5;38;.884;3600000;0
2230;79141;2564;0;0;0;0;.00nan;0;0
2230;85228;72;64;16;2;14;.875;3600000;0
2230;91212;72;0;0;0;0;.00nan;0;0
2231;183755;69;72;33;3;30;.909;3600000;0
2231;187118;71;49;26;4;22;.846;3566000;0
2231;191574;71;0;0;0;0;.00nan;0;0
2231;78479;69;0;0;0;0;.00nan;0;0
2232;200572;157;0;0;0;0;.00nan;0;0
2232;174386;81;0;0;0;0;.00nan;0;0
2232;174407;157;63;29;3;26;.897;3600000;0
2232;186451;81;100;32;0;32;1.000;3600000;0
2233;173874;80;74;36;4;32;.889;3873000;0
2233;181341;149;50;37;5;32;.865;3873000;0
2233;192629;80;0;0;0;0;.00nan;0;0
2233;85546;149;0;0;0;0;.00nan;0;0
2234;-1;4245;0;0;0;0;.00nan;0;0
2234;176770;78;0;0;0;0;.00nan;0;0
2234;181102;78;91;51;3;48;.941;4972000;0
2234;91398;4245;91;35;2;33;.943;4972000;0
2235;200233;4620;36;23;5;18;.783;4079000;0
2235;194531;4920;0;0;0;0;.00nan;0;0
2235;180873;4620;0;0;0;0;.00nan;0;0
2235;-1;4920;66;50;6;44;.880;4080000;0
2236;184049;1097;0;0;0;0;.00nan;0;0
2236;189628;74;0;0;0;0;.00nan;0;0
2236;176136;74;70;49;5;44;.898;3973000;0
2236;191698;1097;40;23;4;19;.826;3973000;0
2237;-1;76;91;32;1;31;.969;3600000;0
2237;200390;1096;0;0;0;0;.00nan;0;0
2237;184175;76;0;0;0;0;.00nan;0;0
2237;-1;1096;51;31;4;27;.871;3600000;0
2238;176060;2564;27;30;7;23;.767;2281000;0
2238;79141;2564;66;8;0;8;1.000;1319000;0
2238;85228;72;84;37;2;35;.946;3600000;0
2238;91212;72;0;0;0;0;.00nan;0;0
2239;183755;69;78;35;2;33;.943;3600000;0
2239;187118;71;68;30;3;27;.900;3583000;0
2239;191574;71;0;0;0;0;.00nan;0;0
2239;78479;69;0;0;0;0;.00nan;0;0
2240;200572;157;0;0;0;0;.00nan;0;0
2240;174386;81;0;0;0;0;.00nan;0;0
2240;174407;157;55;22;3;19;.864;3600000;0
2240;186451;81;100;40;2;38;.950;3600000;0
2241;173874;80;86;33;2;31;.939;4360000;0
2241;181341;149;79;39;3;36;.923;4360000;0
2241;192629;80;0;0;0;0;.00nan;0;0
2241;85546;149;0;0;0;0;.00nan;0;0
2242;-1;4245;0;0;0;0;.00nan;0;0
2242;176770;78;0;0;0;0;.00nan;0;0
2242;181102;78;68;40;5;35;.875;3600000;0
2242;91398;4245;61;44;6;38;.864;3558000;0
2243;200233;4620;95;38;1;37;.974;3600000;0
2243;194531;4920;0;0;0;0;.00nan;0;0
2243;180873;4620;0;0;0;0;.00nan;0;0
2243;-1;4920;72;32;4;28;.875;3600000;0
2244;184049;1097;0;0;0;0;.00nan;0;0
2244;189628;74;0;0;0;0;.00nan;0;0
2244;176136;74;84;27;2;25;.926;3573000;0
2244;191698;1097;84;29;1;28;.966;3600000;0
2245;-1;76;9;16;6;10;.625;2935000;0
2245;200390;1096;0;0;0;0;.00nan;0;0
2245;184175;76;48;7;1;6;.857;665000;0
2245;-1;1096;93;53;4;49;.925;3600000;0
2246;176060;2564;50;32;5;27;.844;3556000;0
2246;79141;2564;0;0;0;0;.00nan;0;0
2246;85228;72;60;29;4;25;.862;3600000;0
2246;91212;72;0;0;0;0;.00nan;0;0
2247;183755;69;26;6;3;3;.500;519000;0
2247;187118;71;50;34;5;29;.853;3609000;0
2247;191574;71;0;0;0;0;.00nan;0;0
2247;78479;69;73;34;3;31;.912;3134000;0
2248;200572;157;0;0;0;0;.00nan;0;0
2248;174386;81;0;0;0;0;.00nan;0;0
2248;174407;157;92;35;1;34;.971;3600000;0
2248;186451;81;69;31;2;29;.935;3600000;0
2249;173874;80;89;44;2;42;.955;5186000;0
2249;181341;149;64;38;3;35;.921;5186000;0
2249;192629;80;0;0;0;0;.00nan;0;0
2249;85546;149;0;0;0;0;.00nan;0;0
2446;-1;4245;0;0;0;0;.00nan;0;0
2446;176770;78;0;0;0;0;.00nan;0;0
2446;181102;78;70;37;4;33;.892;3548000;0
2446;91398;4245;70;31;3;28;.903;3600000;0
2447;200233;4620;47;28;5;23;.821;1892000;0
2447;194531;4920;0;0;0;0;.00nan;0;0
2447;180873;4620;63;22;2;20;.909;1708000;0
2447;-1;4920;67;32;4;28;.875;3600000;0
2448;184049;1097;0;0;0;0;.00nan;0;0
2448;189628;74;0;0;0;0;.00nan;0;0
2448;176136;74;81;39;3;36;.923;3641000;0
2448;191698;1097;60;17;2;15;.882;3641000;0
2449;-1;76;0;0;0;0;.00nan;0;0
2449;200390;1096;0;0;0;0;.00nan;0;0
2449;184175;76;69;25;2;23;.920;4136000;0
2449;-1;1096;70;35;3;32;.914;4136000;0
2450;176060;2564;100;28;0;28;1.000;3600000;0
2450;79141;2564;0;0;0;0;.00nan;0;0
2450;85228;72;89;27;1;26;.963;3546000;0
2450;91212;72;0;0;0;0;.00nan;0;0
2451;183755;69;56;31;4;27;.871;3840000;0
2451;187118;71;64;43;5;38;.884;3840000;0
2451;191574;71;0;0;0;0;.00nan;0;0
2451;78479;69;0;0;0;0;.00nan;0;0
2452;200572;157;0;0;0;0;.00nan;0;0
2452;174386;81;0;0;0;0;.00nan;0;0
2452;174407;157;69;37;4;33;.892;3660000;0
2452;186451;81;34;20;5;15;.750;3660000;0
2465;200233;4620;97;42;3;39;.929;3600000;0
2465;194531;4920;0;0;0;0;.00nan;0;0
2465;180873;4620;0;0;0;0;.00nan;0;0
2465;-1;4920;45;22;4;18;.818;3577000;0
2466;-1;76;0;0;0;0;.00nan;0;0
2466;200390;1096;50;1;0;1;1.000;340000;0
2466;184175;76;60;35;4;31;.886;3600000;0
2466;-1;1096;41;29;6;23;.793;3255000;0
2467;176060;2564;23;28;6;22;.786;2356000;0
2467;79141;2564;54;12;1;11;.917;1244000;0
2467;85228;72;66;22;2;20;.909;3600000;0
2467;91212;72;0;0;0;0;.00nan;0;0
2468;183755;69;94;43;2;41;.953;3956000;0
2468;187118;71;68;21;1;20;.952;3956000;0
2468;191574;71;0;0;0;0;.00nan;0;0
2468;78479;69;0;0;0;0;.00nan;0;0
2469;200572;157;0;0;0;0;.00nan;0;0
2469;174386;81;0;0;0;0;.00nan;0;0
2469;174407;157;99;40;1;39;.975;3600000;0
2469;186451;81;64;29;3;26;.897;3564000;0
2501;183755;69;69;44;5;39;.886;3600000;0
2501;187118;71;69;23;2;21;.913;3600000;0
2501;191574;71;0;0;0;0;.00nan;0;0
2501;78479;69;0;0;0;0;.00nan;0;0
2502;200572;157;0;0;0;0;.00nan;0;0
2502;174386;81;0;0;0;0;.00nan;0;0
2502;174407;157;73;36;4;32;.889;3600000;0
2502;186451;81;81;31;2;29;.935;3600000;0
2513;200233;4620;58;30;4;26;.867;3764000;0
2513;-1;4245;0;0;0;0;.00nan;0;0
2513;180873;4620;0;0;0;0;.00nan;0;0
2513;91398;4245;64;37;5;32;.865;3764000;0
2514;-1;76;0;0;0;0;.00nan;0;0
2514;184049;1097;0;0;0;0;.00nan;0;0
2514;184175;76;70;31;3;28;.903;3789000;0
2514;191698;1097;85;33;2;31;.939;3789000;0
2515;187118;71;33;22;5;17;.773;3600000;0
2515;191574;71;0;0;0;0;.00nan;0;0
2515;85228;72;61;26;2;24;.923;3600000;0
2515;91212;72;0;0;0;0;.00nan;0;0
2516;173874;80;54;31;5;26;.839;3600000;0
2516;174386;81;0;0;0;0;.00nan;0;0
2516;186451;81;57;17;2;15;.882;3600000;0
2516;192629;80;0;0;0;0;.00nan;0;0
2517;200233;4620;51;26;4;22;.846;3600000;0
2517;-1;4245;0;0;0;0;.00nan;0;0
2517;180873;4620;0;0;0;0;.00nan;0;0
2517;91398;4245;32;29;6;23;.793;3562000;0
2518;-1;76;99;33;1;32;.970;3600000;0
2518;184049;1097;0;0;0;0;.00nan;0;0
2518;184175;76;0;0;0;0;.00nan;0;0
2518;191698;1097;44;17;3;14;.824;3518000;0
2519;187118;71;60;38;5;33;.868;4309000;0
2519;191574;71;0;0;0;0;.00nan;0;0
2519;85228;72;62;47;4;43;.915;4339000;0
2519;91212;72;0;0;0;0;.00nan;0;0
2520;173874;80;94;39;3;36;.923;3559000;0
2520;174386;81;0;0;0;0;.00nan;0;0
2520;186451;81;88;35;2;33;.943;3600000;0
2520;192629;80;0;0;0;0;.00nan;0;0
2521;200233;4620;70;34;4;30;.882;3965000;0
2521;-1;4245;0;0;0;0;.00nan;0;0
2521;180873;4620;0;0;0;0;.00nan;0;0
2521;91398;4245;66;44;5;39;.886;3965000;0
2522;-1;76;71;30;3;27;.900;3720000;0
2522;184049;1097;0;0;0;0;.00nan;0;0
2522;184175;76;0;0;0;0;.00nan;0;0
2522;191698;1097;70;23;2;21;.913;3720000;0
2523;187118;71;69;38;5;33;.868;3600000;0
2523;191574;71;0;0;0;0;.00nan;0;0
2523;85228;72;57;31;4;27;.871;3600000;0
2523;91212;72;0;0;0;0;.00nan;0;0
2524;173874;80;69;25;2;23;.920;3600000;0
2524;174386;81;0;0;0;0;.00nan;0;0
2524;186451;81;78;40;3;37;.925;3600000;0
2524;192629;80;0;0;0;0;.00nan;0;0
2525;200233;4620;64;20;2;18;.900;3600000;0
2525;-1;4245;0;0;0;0;.00nan;0;0
2525;180873;4620;0;0;0;0;.00nan;0;0
2525;91398;4245;81;42;4;38;.905;3584000;0
2526;-1;76;74;34;3;31;.912;3534000;0
2526;184049;1097;0;0;0;0;.00nan;0;0
2526;184175;76;0;0;0;0;.00nan;0;0
2526;191698;1097;70;18;1;17;.944;3600000;0
2527;187118;71;83;36;3;33;.917;3600000;0
2527;191574;71;0;0;0;0;.00nan;0;0
2527;85228;72;1;32;9;23;.719;3600000;0
2527;91212;72;0;0;0;0;.00nan;0;0
2528;173874;80;75;34;3;31;.912;5027000;0
2528;174386;81;0;0;0;0;.00nan;0;0
2528;186451;81;94;54;4;50;.926;5046000;0
2528;192629;80;0;0;0;0;.00nan;0;0
2697;-1;76;54;30;4;26;.867;3555000;0
2697;184049;1097;0;0;0;0;.00nan;0;0
2697;184175;76;0;0;0;0;.00nan;0;0
2697;191698;1097;88;32;2;30;.938;3600000;0
2698;187118;71;59;27;3;24;.889;3600000;0
2698;191574;71;0;0;0;0;.00nan;0;0
2698;85228;72;26;5;3;2;.400;308000;0
2698;91212;72;92;36;1;35;.972;3292000;0
2699;173874;80;73;30;2;28;.933;3573000;0
2699;174386;81;0;0;0;0;.00nan;0;0
2699;186451;81;100;36;0;36;1.000;3600000;0
2699;192629;80;0;0;0;0;.00nan;0;0
2702;187118;71;38;28;5;23;.821;3548000;0
2702;191574;71;0;0;0;0;.00nan;0;0
2702;85228;72;54;28;4;24;.857;3600000;0
2702;91212;72;0;0;0;0;.00nan;0;0
2703;173874;80;78;26;2;24;.923;3600000;0
2703;174386;81;61;24;2;22;.917;1568000;0
2703;186451;81;16;19;6;13;.684;2032000;0
2703;192629;80;0;0;0;0;.00nan;0;0
2711;173874;80;48;19;3;16;.842;3551000;0
2711;174386;81;65;21;2;19;.905;3600000;0
2711;186451;81;0;0;0;0;.00nan;0;0
2711;192629;80;0;0;0;0;.00nan;0;0
2721;200233;4620;86;16;0;16;1.000;3600000;0
2721;184049;1097;0;0;0;0;.00nan;0;0
2721;180873;4620;0;0;0;0;.00nan;0;0
2721;191698;1097;44;41;6;35;.854;3600000;0
2722;174386;81;43;36;6;30;.833;2952000;0
2722;186451;81;49;6;1;5;.833;648000;0
2722;85228;72;88;31;1;30;.968;3600000;0
2722;91212;72;0;0;0;0;.00nan;0;0
2723;200233;4620;56;19;2;17;.895;3564000;0
2723;184049;1097;0;0;0;0;.00nan;0;0
2723;180873;4620;0;0;0;0;.00nan;0;0
2723;191698;1097;81;21;1;20;.952;3600000;0
2724;174386;81;0;0;0;0;.00nan;0;0
2724;186451;81;37;29;6;23;.793;3600000;0
2724;85228;72;81;30;2;28;.933;3600000;0
2724;91212;72;0;0;0;0;.00nan;0;0
2725;200233;4620;73;16;1;15;.938;3600000;0
2725;184049;1097;0;0;0;0;.00nan;0;0
2725;180873;4620;0;0;0;0;.00nan;0;0
2725;191698;1097;82;38;2;36;.947;3592000;0
2726;174386;81;0;0;0;0;.00nan;0;0
2726;186451;81;78;53;5;48;.906;4269000;0
2726;85228;72;53;33;4;29;.879;4269000;0
2726;91212;72;0;0;0;0;.00nan;0;0
2727;200233;4620;58;31;4;27;.871;4211000;0
2727;184049;1097;0;0;0;0;.00nan;0;0
2727;180873;4620;0;0;0;0;.00nan;0;0
2727;191698;1097;84;54;5;49;.907;4211000;0
2728;174386;81;0;0;0;0;.00nan;0;0
2728;186451;81;47;26;4;22;.846;3600000;0
2728;85228;72;62;19;1;18;.947;3600000;0
2728;91212;72;0;0;0;0;.00nan;0;0
2761;200233;4620;28;23;5;18;.783;3600000;0
2761;184049;1097;0;0;0;0;.00nan;0;0
2761;180873;4620;0;0;0;0;.00nan;0;0
2761;191698;1097;90;30;1;29;.967;3600000;0
2764;200233;4620;53;25;3;22;.880;3558000;0
2764;184049;1097;0;0;0;0;.00nan;0;0
2764;180873;4620;0;0;0;0;.00nan;0;0
2764;191698;1097;87;32;2;30;.938;3600000;0
2766;200233;4620;58;22;3;19;.864;3600000;0
2766;184049;1097;0;0;0;0;.00nan;0;0
2766;180873;4620;0;0;0;0;.00nan;0;0
2766;191698;1097;53;47;6;41;.872;3600000;0
2771;200233;4620;47;19;3;16;.842;3600000;0
2771;180873;4620;0;0;0;0;.00nan;0;0
2771;85228;72;78;24;1;23;.958;3600000;0
2771;91212;72;0;0;0;0;.00nan;0;0
2772;200233;4620;39;24;4;20;.833;3581000;0
2772;180873;4620;0;0;0;0;.00nan;0;0
2772;85228;72;69;27;3;24;.889;3600000;0
2772;91212;72;0;0;0;0;.00nan;0;0
2773;200233;4620;49;26;4;22;.846;3654000;0
2773;180873;4620;0;0;0;0;.00nan;0;0
2773;85228;72;81;34;3;31;.912;3654000;0
2773;91212;72;0;0;0;0;.00nan;0;0
2774;200233;4620;72;23;1;22;.957;3600000;0
2774;180873;4620;0;0;0;0;.00nan;0;0
2774;85228;72;88;36;2;34;.944;3572000;0
2774;91212;72;0;0;0;0;.00nan;0;0
2791;200233;4620;99;38;1;37;.974;4049000;0
2791;180873;4620;0;0;0;0;.00nan;0;0
2791;85228;72;92;44;2;42;.955;4049000;0
2791;91212;72;0;0;0;0;.00nan;0;0
2792;200233;4620;35;20;4;16;.800;2022000;0
2792;180873;4620;53;9;1;8;.889;1555000;0
2792;85228;72;65;30;3;27;.900;3600000;0
2792;91212;72;0;0;0;0;.00nan;0;0
32340;213845;113;47;28;4;24;.857;3600000;0
32340;210765;113;0;0;0;0;.00nan;0;0
32340;207504;114;39;34;6;28;.824;2524000;0
32340;212783;114;55;9;1;8;.889;1076000;0
32341;213692;112;35;29;5;24;.828;3600000;0
32341;208620;112;0;0;0;0;.00nan;0;0
32341;204630;109;99;36;1;35;.972;3600000;0
32341;205458;109;0;0;0;0;.00nan;0;0
32342;213692;112;0;0;0;0;.00nan;0;0
32342;208620;112;46;38;6;32;.842;3600000;0
32342;220301;110;0;0;0;0;.00nan;0;0
32342;215968;110;69;28;3;25;.893;3600000;0
32343;204630;109;53;32;4;28;.875;3600000;0
32343;205458;109;0;0;0;0;.00nan;0;0
32343;207535;108;0;0;0;0;.00nan;0;0
32343;-1;108;84;15;0;15;1.000;3600000;0
32344;203412;117;0;0;0;0;.00nan;0;0
32344;204894;121;0;0;0;0;.00nan;0;0
32344;207493;121;44;27;4;23;.852;3600000;0
32344;213504;117;85;28;1;27;.964;3600000;0
32345;213845;113;64;32;3;29;.906;3600000;0
32345;210765;113;0;0;0;0;.00nan;0;0
32345;207504;114;45;27;4;23;.852;3577000;0
32345;212783;114;0;0;0;0;.00nan;0;0
32346;204711;119;0;0;0;0;.00nan;0;0
32346;210785;123;97;50;2;48;.960;3600000;0
32346;218853;119;50;29;3;26;.897;3552000;0
32346;-1;123;0;0;0;0;.00nan;0;0
32347;220341;116;0;0;0;0;.00nan;0;0
32347;216028;116;76;37;3;34;.919;3600000;0
32347;212683;118;0;0;0;0;.00nan;0;0
32347;218830;118;38;29;5;24;.828;3600000;0
32348;210773;111;45;35;6;29;.829;3250000;0
32348;222436;115;0;0;0;0;.00nan;0;0
32348;207439;115;24;38;7;31;.816;3853000;0
32348;-1;111;54;7;0;7;1.000;603000;0
32349;221235;126;0;0;0;0;.00nan;0;0
32349;212039;126;16;32;7;25;.781;3528000;0
32349;212052;127;80;51;5;46;.902;3600000;0
32349;206864;127;0;0;0;0;.00nan;0;0
32350;208652;124;57;15;1;14;.933;2410000;0
32350;204618;125;0;0;0;0;.00nan;0;0
32350;206731;124;20;9;4;5;.556;1190000;0
32350;-1;125;78;35;2;33;.943;3600000;0
32351;205469;122;22;25;6;19;.760;2705000;0
32351;212681;122;55;13;1;12;.923;895000;0
32351;207600;120;0;0;0;0;.00nan;0;0
32351;213613;120;57;21;2;19;.905;3600000;0
32352;220341;116;0;0;0;0;.00nan;0;0
32352;216028;116;66;47;5;42;.894;3600000;0
32352;212683;118;89;26;1;25;.962;3600000;0
32352;218830;118;0;0;0;0;.00nan;0;0
32353;208652;124;0;0;0;0;.00nan;0;0
32353;204711;119;87;41;2;39;.951;3600000;0
32353;206731;124;58;26;3;23;.885;3563000;0
32353;218853;119;0;0;0;0;.00nan;0;0
32354;203412;117;60;15;1;14;.933;1832000;0
32354;204894;121;0;0;0;0;.00nan;0;0
32354;207493;121;50;21;3;18;.857;3600000;0
32354;213504;117;21;17;5;12;.706;1768000;0
32355;205469;122;57;21;2;19;.905;3600000;0
32355;212681;122;0;0;0;0;.00nan;0;0
32355;207504;114;72;37;3;34;.919;3549000;0
32355;212783;114;0;0;0;0;.00nan;0;0
32356;212052;127;0;0;0;0;.00nan;0;0
32356;206864;127;66;50;5;45;.900;3600000;0
32356;207600;120;52;18;2;16;.889;3600000;0
32356;213613;120;0;0;0;0;.00nan;0;0
32357;210785;123;91;46;3;43;.935;3600000;0
32357;221235;126;0;0;0;0;.00nan;0;0
32357;212039;126;59;36;5;31;.861;3566000;0
32357;-1;123;0;0;0;0;.00nan;0;0
32358;204618;125;63;33;4;29;.879;3570000;0
32358;210773;111;0;0;0;0;.00nan;0;0
32358;-1;111;68;28;2;26;.929;3600000;0
32358;-1;125;0;0;0;0;.00nan;0;0
32359;213845;113;77;36;2;34;.944;3600000;0
32359;210765;113;0;0;0;0;.00nan;0;0
32359;222436;115;0;0;0;0;.00nan;0;0
32359;207439;115;58;24;3;21;.875;3577000;0
32360;213692;112;0;0;0;0;.00nan;0;0
32360;208620;112;66;30;3;27;.900;3600000;0
32360;220301;110;0;0;0;0;.00nan;0;0
32360;215968;110;26;21;5;16;.762;3600000;0
32361;204711;119;60;31;4;27;.871;3600000;0
32361;221235;126;56;4;0;4;1.000;239000;0
32361;212039;126;39;36;6;30;.833;3294000;0
32361;218853;119;0;0;0;0;.00nan;0;0
32362;204618;125;31;10;3;7;.700;348000;0
32362;212683;118;0;0;0;0;.00nan;0;0
32362;218830;118;98;19;0;19;1.000;3600000;0
32362;-1;125;83;47;4;43;.915;3252000;0
32363;203412;117;80;31;2;29;.935;3600000;0
32363;220341;116;0;0;0;0;.00nan;0;0
32363;216028;116;60;25;3;22;.880;3600000;0
32363;213504;117;0;0;0;0;.00nan;0;0
32364;204630;109;33;27;6;21;.778;2671000;0
32364;205458;109;54;5;0;5;1.000;1229000;0
32364;222436;115;64;7;0;7;1.000;1303000;0
32364;207439;115;24;24;6;18;.750;2597000;0
32365;213845;113;43;20;3;17;.850;3600000;0
32365;210765;113;0;0;0;0;.00nan;0;0
32365;212052;127;0;0;0;0;.00nan;0;0
32365;206864;127;33;40;7;33;.825;3600000;0
32366;213692;112;0;0;0;0;.00nan;0;0
32366;208620;112;68;27;2;25;.926;3900000;0
32366;222436;115;0;0;0;0;.00nan;0;0
32366;207439;115;76;34;2;32;.941;3900000;0
32367;204711;119;40;22;4;18;.818;3600000;0
32367;205469;122;17;44;10;34;.773;3600000;0
32367;212681;122;0;0;0;0;.00nan;0;0
32367;218853;119;0;0;0;0;.00nan;0;0
32368;213845;113;48;34;4;30;.882;3555000;0
32368;210765;113;0;0;0;0;.00nan;0;0
32368;212683;118;0;0;0;0;.00nan;0;0
32368;218830;118;69;25;2;23;.920;3600000;0
32369;204618;125;64;38;4;34;.895;2284000;0
32369;221235;126;0;0;0;0;.00nan;0;0
32369;212039;126;61;18;2;16;.889;3600000;0
32369;-1;125;45;20;3;17;.850;1316000;0
32370;204894;121;0;0;0;0;.00nan;0;0
32370;207493;121;61;21;2;19;.905;3900000;0
32370;207600;120;0;0;0;0;.00nan;0;0
32370;213613;120;90;37;2;35;.946;3900000;0
32371;203412;117;0;0;0;0;.00nan;0;0
32371;220301;110;40;23;4;19;.826;2151000;0
32371;215968;110;56;5;0;5;1.000;1381000;0
32371;213504;117;72;27;2;25;.926;3600000;0
32372;222436;115;64;40;4;36;.900;3586000;0
32372;207439;115;0;0;0;0;.00nan;0;0
32372;207535;108;0;0;0;0;.00nan;0;0
32372;-1;108;55;18;2;16;.889;3600000;0
32373;221235;126;14;25;7;18;.720;2889000;0
32373;212039;126;51;2;0;2;1.000;851000;0
32373;212052;127;0;0;0;0;.00nan;0;0
32373;206864;127;26;38;8;30;.789;3788000;0
32374;220301;110;0;0;0;0;.00nan;0;0
32374;210773;111;0;0;0;0;.00nan;0;0
32374;215968;110;53;37;5;32;.865;3600000;0
32374;-1;111;77;30;2;28;.933;3600000;0
32375;208652;124;63;21;1;20;.952;3600000;0
32375;204618;125;75;40;3;37;.925;3579000;0
32375;206731;124;0;0;0;0;.00nan;0;0
32375;-1;125;0;0;0;0;.00nan;0;0
32376;204894;121;60;26;3;23;.885;3768000;0
32376;205469;122;0;0;0;0;.00nan;0;0
32376;212681;122;53;27;4;23;.852;3734000;0
32376;207493;121;0;0;0;0;.00nan;0;0
32377;212683;118;68;27;2;25;.926;3600000;0
32377;207600;120;44;46;7;39;.848;3600000;0
32377;213613;120;0;0;0;0;.00nan;0;0
32377;218830;118;0;0;0;0;.00nan;0;0
32378;204711;119;0;0;0;0;.00nan;0;0
32378;210785;123;67;29;2;27;.931;3600000;0
32378;218853;119;79;34;3;31;.912;3575000;0
32378;-1;123;0;0;0;0;.00nan;0;0
32379;220341;116;0;0;0;0;.00nan;0;0
32379;216028;116;35;27;6;21;.778;3534000;0
32379;207504;114;56;39;4;35;.897;3600000;0
32379;212783;114;0;0;0;0;.00nan;0;0
32380;213692;112;100;41;0;41;1.000;3600000;0
32380;208620;112;0;0;0;0;.00nan;0;0
32380;207535;108;38;29;6;23;.793;3600000;0
32380;-1;108;0;0;0;0;.00nan;0;0
32381;203412;117;59;30;4;26;.867;3600000;0
32381;210773;111;0;0;0;0;.00nan;0;0
32381;213504;117;0;0;0;0;.00nan;0;0
32381;-1;111;47;22;3;19;.864;3600000;0
32382;213845;113;55;35;4;31;.886;3600000;0
32382;205469;122;38;39;7;32;.821;3307000;0
32382;210765;113;0;0;0;0;.00nan;0;0
32382;212681;122;49;2;0;2;1.000;293000;0
32383;204618;125;0;0;0;0;.00nan;0;0
32383;212052;127;88;27;1;26;.963;3600000;0
32383;206864;127;0;0;0;0;.00nan;0;0
32383;-1;125;62;25;3;22;.880;3561000;0
32384;208652;124;0;0;0;0;.00nan;0;0
32384;210785;123;82;31;1;30;.968;3600000;0
32384;206731;124;38;28;5;23;.821;3600000;0
32384;-1;123;0;0;0;0;.00nan;0;0
32385;213845;113;29;21;5;16;.762;3600000;0
32385;210765;113;0;0;0;0;.00nan;0;0
32385;207535;108;0;0;0;0;.00nan;0;0
32385;-1;108;78;34;2;32;.941;3600000;0
32386;220341;116;0;0;0;0;.00nan;0;0
32386;204894;121;0;0;0;0;.00nan;0;0
32386;216028;116;91;42;1;41;.976;3600000;0
32386;207493;121;54;22;3;19;.864;3555000;0
32387;204630;109;74;30;2;28;.933;3600000;0
32387;205458;109;0;0;0;0;.00nan;0;0
32387;212683;118;0;0;0;0;.00nan;0;0
32387;218830;118;100;27;0;27;1.000;3600000;0
32388;213692;112;0;0;0;0;.00nan;0;0
32388;208620;112;28;19;4;15;.789;3895000;0
32388;212052;127;0;0;0;0;.00nan;0;0
32388;206864;127;85;46;4;42;.913;3900000;0
32389;204630;109;0;0;0;0;.00nan;0;0
32389;205458;109;47;36;5;31;.861;3517000;0
32389;210773;111;58;28;3;25;.893;3600000;0
32389;-1;111;0;0;0;0;.00nan;0;0
32390;204711;119;52;29;5;24;.828;3600000;0
32390;207504;114;35;34;6;28;.824;3587000;0
32390;212783;114;0;0;0;0;.00nan;0;0
32390;218853;119;0;0;0;0;.00nan;0;0
32391;213692;112;80;42;3;39;.929;3600000;0
32391;208620;112;0;0;0;0;.00nan;0;0
32391;212683;118;0;0;0;0;.00nan;0;0
32391;218830;118;42;28;4;24;.857;3544000;0
32392;205469;122;48;34;5;29;.853;3600000;0
32392;222436;115;0;0;0;0;.00nan;0;0
32392;212681;122;0;0;0;0;.00nan;0;0
32392;207439;115;97;27;0;27;1.000;3600000;0
32393;208652;124;0;0;0;0;.00nan;0;0
32393;221235;126;0;0;0;0;.00nan;0;0
32393;206731;124;96;34;1;33;.971;3900000;0
32393;212039;126;74;25;1;24;.960;3900000;0
32394;204618;125;0;0;0;0;.00nan;0;0
32394;207535;108;45;13;2;11;.846;3600000;0
32394;-1;108;0;0;0;0;.00nan;0;0
32394;-1;125;73;50;5;45;.900;3600000;0
32395;203412;117;0;0;0;0;.00nan;0;0
32395;207600;120;0;0;0;0;.00nan;0;0
32395;213504;117;89;43;2;41;.953;3544000;0
32395;213613;120;73;26;1;25;.962;3600000;0
32396;220301;110;0;0;0;0;.00nan;0;0
32396;210785;123;68;40;4;36;.900;3547000;0
32396;215968;110;85;41;3;38;.927;3600000;0
32396;-1;123;0;0;0;0;.00nan;0;0
32397;203412;117;90;38;1;37;.974;3900000;0
32397;210785;123;89;36;1;35;.972;3900000;0
32397;213504;117;0;0;0;0;.00nan;0;0
32397;-1;123;0;0;0;0;.00nan;0;0
32398;213692;112;50;30;4;26;.867;3369000;0
32398;208620;112;23;4;3;1;.250;231000;0
32398;220341;116;0;0;0;0;.00nan;0;0
32398;216028;116;69;28;2;26;.929;3600000;0
32399;208652;124;87;38;2;36;.947;3600000;0
32399;206731;124;0;0;0;0;.00nan;0;0
32399;207600;120;41;25;4;21;.840;3539000;0
32399;213613;120;0;0;0;0;.00nan;0;0
32400;204894;121;56;17;2;15;.882;3600000;0
32400;212052;127;12;17;6;11;.647;1703000;0
32400;206864;127;47;33;5;28;.848;1897000;0
32400;207493;121;0;0;0;0;.00nan;0;0
32401;204630;109;93;43;3;40;.930;3600000;0
32401;205458;109;0;0;0;0;.00nan;0;0
32401;210773;111;0;0;0;0;.00nan;0;0
32401;-1;111;34;26;5;21;.808;3528000;0
32402;221235;126;20;28;7;21;.750;3128000;0
32402;212039;126;53;3;0;3;1.000;390000;0
32402;212683;118;51;37;5;32;.865;3600000;0
32402;218830;118;0;0;0;0;.00nan;0;0
32403;204618;125;24;30;7;23;.767;3600000;0
32403;205469;122;0;0;0;0;.00nan;0;0
32403;212681;122;55;24;3;21;.875;3600000;0
32403;-1;125;0;0;0;0;.00nan;0;0
32404;220301;110;83;32;1;31;.969;3600000;0
32404;215968;110;0;0;0;0;.00nan;0;0
32404;207504;114;0;0;0;0;.00nan;0;0
32404;212783;114;41;24;4;20;.833;3600000;0
32405;204711;119;0;0;0;0;.00nan;0;0
32405;212052;127;27;8;3;5;.625;474000;0
32405;206864;127;46;43;7;36;.837;3126000;0
32405;218853;119;61;11;1;10;.909;3600000;0
32406;222436;115;0;0;0;0;.00nan;0;0
32406;207439;115;68;32;3;29;.906;3600000;0
32406;207535;108;0;0;0;0;.00nan;0;0
32406;-1;108;70;46;5;41;.891;3581000;0
32407;203412;117;0;0;0;0;.00nan;0;0
32407;204894;121;0;0;0;0;.00nan;0;0
32407;207493;121;50;26;4;22;.846;3600000;0
32407;213504;117;80;43;3;40;.930;3600000;0
32408;213845;113;9;16;6;10;.625;1656000;0
32408;220301;110;0;0;0;0;.00nan;0;0
32408;210765;113;62;8;0;8;1.000;1944000;0
32408;215968;110;67;29;3;26;.897;3600000;0
32409;210773;111;72;34;3;31;.912;3573000;0
32409;212683;118;0;0;0;0;.00nan;0;0
32409;-1;111;0;0;0;0;.00nan;0;0
32409;218830;118;64;25;2;23;.920;3600000;0
32410;220341;116;25;6;3;3;.500;546000;0
32410;204711;119;72;32;3;29;.906;3600000;0
32410;216028;116;18;24;6;18;.750;3054000;0
32410;218853;119;0;0;0;0;.00nan;0;0
32411;203412;117;31;29;6;23;.793;3600000;0
32411;222436;115;0;0;0;0;.00nan;0;0
32411;207439;115;67;15;1;14;.933;3600000;0
32411;213504;117;0;0;0;0;.00nan;0;0
32412;204618;125;64;5;0;5;1.000;957000;0
32412;204630;109;77;29;1;28;.966;3600000;0
32412;205458;109;0;0;0;0;.00nan;0;0
32412;-1;125;33;26;6;20;.769;2643000;0
32413;208652;124;0;0;0;0;.00nan;0;0
32413;206731;124;47;43;6;37;.860;3600000;0
32413;207504;114;76;33;3;30;.909;3600000;0
32413;212783;114;0;0;0;0;.00nan;0;0
32414;213845;113;0;0;0;0;.00nan;0;0
32414;203412;117;55;18;2;16;.889;1257000;0
32414;210765;113;42;34;6;28;.824;3600000;0
32414;213504;117;40;31;5;26;.839;2327000;0
32415;213692;112;71;22;1;21;.955;3600000;0
32415;208620;112;0;0;0;0;.00nan;0;0
32415;204618;125;61;27;3;24;.889;3594000;0
32415;-1;125;0;0;0;0;.00nan;0;0
32416;204630;109;0;0;0;0;.00nan;0;0
32416;205458;109;53;40;5;35;.875;3591000;0
32416;207535;108;0;0;0;0;.00nan;0;0
32416;-1;108;61;34;4;30;.882;3600000;0
32417;220341;116;0;0;0;0;.00nan;0;0
32417;221235;126;0;0;0;0;.00nan;0;0
32417;216028;116;91;40;3;37;.925;3600000;0
32417;212039;126;35;21;4;17;.810;3571000;0
32418;204711;119;71;20;1;19;.950;3600000;0
32418;205469;122;44;42;7;35;.833;3600000;0
32418;212681;122;0;0;0;0;.00nan;0;0
32418;218853;119;0;0;0;0;.00nan;0;0
32419;204894;121;50;1;0;1;1.000;460000;0
32419;212683;118;0;0;0;0;.00nan;0;0
32419;207493;121;32;31;6;25;.806;3140000;0
32419;218830;118;72;40;4;36;.900;3600000;0
32420;208652;124;24;30;7;23;.767;3107000;0
32420;206731;124;42;3;1;2;.667;493000;0
32420;222436;115;0;0;0;0;.00nan;0;0
32420;207439;115;77;45;4;41;.911;3600000;0
32421;207504;114;98;46;1;45;.978;3548000;0
32421;212783;114;0;0;0;0;.00nan;0;0
32421;207600;120;0;0;0;0;.00nan;0;0
32421;213613;120;90;19;0;19;1.000;3600000;0
32422;220301;110;0;0;0;0;.00nan;0;0
32422;210773;111;0;0;0;0;.00nan;0;0
32422;215968;110;82;45;3;42;.933;3600000;0
32422;-1;111;36;22;4;18;.818;3564000;0
32423;203412;117;56;38;5;33;.868;3600000;0
32423;204711;119;0;0;0;0;.00nan;0;0
32423;213504;117;0;0;0;0;.00nan;0;0
32423;218853;119;85;35;2;33;.943;3600000;0
32424;204894;121;59;28;3;25;.893;3600000;0
32424;221235;126;0;0;0;0;.00nan;0;0
32424;212039;126;72;39;4;35;.897;3600000;0
32424;207493;121;0;0;0;0;.00nan;0;0
32425;213692;112;0;0;0;0;.00nan;0;0
32425;208620;112;30;17;4;13;.765;3558000;0
32425;207600;120;0;0;0;0;.00nan;0;0
32425;213613;120;58;25;3;22;.880;3600000;0
32426;205469;122;0;0;0;0;.00nan;0;0
32426;210773;111;52;37;5;32;.865;3900000;0
32426;212681;122;72;40;5;35;.875;3900000;0
32426;-1;111;0;0;0;0;.00nan;0;0
32427;220301;110;0;0;0;0;.00nan;0;0
32427;204630;109;48;51;8;43;.843;3600000;0
32427;205458;109;0;0;0;0;.00nan;0;0
32427;215968;110;87;26;1;25;.962;3600000;0
32428;210785;123;53;35;5;30;.857;3600000;0
32428;212052;127;79;33;2;31;.939;3600000;0
32428;206864;127;0;0;0;0;.00nan;0;0
32428;-1;123;0;0;0;0;.00nan;0;0
32429;222436;115;44;37;6;31;.838;3050000;0
32429;207439;115;40;8;2;6;.750;550000;0
32429;207504;114;76;41;4;37;.902;3600000;0
32429;212783;114;0;0;0;0;.00nan;0;0
32430;204618;125;50;25;4;21;.840;3600000;0
32430;207535;108;0;0;0;0;.00nan;0;0
32430;-1;108;71;24;1;23;.958;3600000;0
32430;-1;125;0;0;0;0;.00nan;0;0
32431;213845;113;27;7;3;4;.571;337000;0
32431;208652;124;58;12;1;11;.917;856000;0
32431;210765;113;65;23;1;22;.957;3263000;0
32431;206731;124;14;30;8;22;.733;2744000;0
32432;213692;112;50;39;5;34;.872;3600000;0
32432;208620;112;0;0;0;0;.00nan;0;0
32432;205469;122;73;26;1;25;.962;3600000;0
32432;212681;122;0;0;0;0;.00nan;0;0
32433;220341;116;0;0;0;0;.00nan;0;0
32433;204894;121;0;0;0;0;.00nan;0;0
32433;216028;116;35;28;5;23;.821;3542000;0
32433;207493;121;70;37;3;34;.919;3600000;0
32434;210785;123;0;0;0;0;.00nan;0;0
32434;212683;118;0;0;0;0;.00nan;0;0
32434;218830;118;36;26;5;21;.808;3600000;0
32434;-1;123;79;44;4;40;.909;3600000;0
32435;220301;110;57;22;3;19;.864;3600000;0
32435;215968;110;0;0;0;0;.00nan;0;0
32435;207600;120;43;30;5;25;.833;3515000;0
32435;213613;120;0;0;0;0;.00nan;0;0
32436;204711;119;88;32;1;31;.969;3600000;0
32436;221235;126;0;0;0;0;.00nan;0;0
32436;212039;126;76;31;2;29;.935;3544000;0
32436;218853;119;0;0;0;0;.00nan;0;0
32437;208652;124;0;0;0;0;.00nan;0;0
32437;204618;125;63;38;4;34;.895;3600000;0
32437;206731;124;54;24;3;21;.875;3600000;0
32437;-1;125;0;0;0;0;.00nan;0;0
32438;204894;121;0;0;0;0;.00nan;0;0
32438;207424;114;83;30;2;28;.933;3600000;0
32438;207493;121;38;29;5;24;.828;3600000;0
32438;212783;114;0;0;0;0;.00nan;0;0
32439;213845;113;42;33;5;28;.848;3555000;0
32439;210765;113;0;0;0;0;.00nan;0;0
32439;207600;120;0;0;0;0;.00nan;0;0
32439;213613;120;50;21;3;18;.857;3600000;0
32440;212052;127;0;0;0;0;.00nan;0;0
32440;206864;127;52;33;4;29;.879;3600000;0
32440;207535;108;0;0;0;0;.00nan;0;0
32440;-1;108;55;11;1;10;.909;3600000;0
32441;213845;113;87;31;1;30;.968;3600000;0
32441;210765;113;0;0;0;0;.00nan;0;0
32441;210773;111;0;0;0;0;.00nan;0;0
32441;-1;111;50;31;4;27;.871;3600000;0
32442;213692;112;0;0;0;0;.00nan;0;0
32442;208620;112;54;26;4;22;.846;3531000;0
32442;220301;110;0;0;0;0;.00nan;0;0
32442;215968;110;65;22;2;20;.909;3600000;0
32443;203412;117;0;0;0;0;.00nan;0;0
32443;207424;114;0;0;0;0;.00nan;0;0
32443;212783;114;55;21;2;19;.905;3600000;0
32443;213504;117;49;30;4;26;.867;3525000;0
32444;204630;109;21;36;7;29;.806;3068000;0
32444;220341;116;58;19;2;17;.895;3600000;0
32444;205458;109;36;12;3;9;.750;532000;0
32444;216028;116;0;0;0;0;.00nan;0;0
32445;204711;119;60;7;0;7;1.000;839000;0
32445;204894;121;66;27;2;25;.926;3600000;0
32445;207493;121;0;0;0;0;.00nan;0;0
32445;218853;119;15;30;7;23;.767;2761000;0
32446;212683;118;0;0;0;0;.00nan;0;0
32446;207535;108;54;27;3;24;.889;3565000;0
32446;-1;108;0;0;0;0;.00nan;0;0
32446;218830;118;71;27;2;25;.926;3600000;0
32447;222436;115;0;0;0;0;.00nan;0;0
32447;207439;115;71;38;3;35;.921;3793000;0
32447;207600;120;81;39;4;35;.897;3793000;0
32447;213613;120;0;0;0;0;.00nan;0;0
32448;221235;126;0;0;0;0;.00nan;0;0
32448;212039;126;62;20;2;18;.900;3600000;0
32448;212052;127;31;19;4;15;.789;1110000;0
32448;206864;127;35;37;7;30;.811;2490000;0
32449;204618;125;43;34;6;28;.824;2199000;0
32449;210785;123;83;30;2;28;.933;3600000;0
32449;207504;123;0;0;0;0;.00nan;0;0
32449;-1;125;84;28;1;27;.964;1401000;0
32450;213692;112;55;25;4;21;.840;3900000;0
32450;208620;112;0;0;0;0;.00nan;0;0
32450;203412;117;74;40;4;36;.900;3900000;0
32450;213504;117;0;0;0;0;.00nan;0;0
32451;204711;119;40;23;4;19;.826;3600000;0
32451;205469;122;0;0;0;0;.00nan;0;0
32451;212681;122;99;32;1;31;.969;3600000;0
32451;218853;119;0;0;0;0;.00nan;0;0
32452;208652;124;75;29;2;27;.931;3600000;0
32452;204618;125;98;54;4;50;.926;3570000;0
32452;206731;124;0;0;0;0;.00nan;0;0
32452;-1;125;0;0;0;0;.00nan;0;0
32453;204630;109;0;0;0;0;.00nan;0;0
32453;204894;121;0;0;0;0;.00nan;0;0
32453;205458;109;50;40;6;34;.850;3600000;0
32453;207493;121;62;13;1;12;.923;3600000;0
32454;220341;116;0;0;0;0;.00nan;0;0
32454;216028;116;38;23;4;19;.826;3600000;0
32454;212052;127;48;0;0;0;.00nan;260000;0
32454;206864;127;59;54;6;48;.889;3313000;0
32455;210785;123;76;23;1;22;.957;3600000;0
32455;221235;126;0;0;0;0;.00nan;0;0
32455;212039;126;48;32;5;27;.844;3600000;0
32455;207504;123;0;0;0;0;.00nan;0;0
32456;210773;111;54;35;4;31;.886;3600000;0
32456;207424;114;0;0;0;0;.00nan;0;0
32456;212783;114;49;34;5;29;.853;3575000;0
32456;-1;111;0;0;0;0;.00nan;0;0
32457;213845;113;0;0;0;0;.00nan;0;0
32457;210765;113;74;41;4;37;.902;3600000;0
32457;222436;115;0;0;0;0;.00nan;0;0
32457;207439;115;51;40;6;34;.850;3600000;0
32458;207535;108;0;0;0;0;.00nan;0;0
32458;207600;120;0;0;0;0;.00nan;0;0
32458;-1;108;95;39;2;37;.949;3600000;0
32458;213613;120;44;32;5;27;.844;3600000;0
32459;220341;116;0;0;0;0;.00nan;0;0
32459;221235;126;41;28;5;23;.821;3588000;0
32459;216028;116;70;35;3;32;.914;3600000;0
32459;212039;126;0;0;0;0;.00nan;0;0
32460;208652;124;0;0;0;0;.00nan;0;0
32460;210785;123;0;0;0;0;.00nan;0;0
32460;206731;124;68;29;3;26;.897;3600000;0
32460;207504;123;52;30;4;26;.867;3600000;0
32461;220301;110;0;0;0;0;.00nan;0;0
32461;205469;122;28;27;6;21;.778;3174000;0
32461;215968;110;51;35;5;30;.857;3600000;0
32461;212681;122;43;4;1;3;.750;386000;0
32462;210773;111;0;0;0;0;.00nan;0;0
32462;207600;120;0;0;0;0;.00nan;0;0
32462;-1;111;85;31;1;30;.968;3600000;0
32462;213613;120;69;29;2;27;.931;3558000;0
32463;208652;124;0;0;0;0;.00nan;0;0
32463;205469;122;0;0;0;0;.00nan;0;0
32463;206731;124;57;42;6;36;.857;3600000;0
32463;212681;122;82;25;1;24;.960;3600000;0
32464;213845;113;82;33;2;31;.939;3600000;0
32464;210765;113;0;0;0;0;.00nan;0;0
32464;222436;115;0;0;0;0;.00nan;0;0
32464;207439;115;82;35;3;32;.914;3558000;0
32465;220301;110;0;0;0;0;.00nan;0;0
32465;204630;109;79;38;3;35;.921;3600000;0
32465;205458;109;0;0;0;0;.00nan;0;0
32465;215968;110;25;22;5;17;.773;3589000;0
32466;204711;119;45;10;2;8;.800;3600000;0
32466;212052;127;23;38;7;31;.816;3600000;0
32466;206864;127;0;0;0;0;.00nan;0;0
32466;218853;119;0;0;0;0;.00nan;0;0
32467;204894;121;0;0;0;0;.00nan;0;0
32467;210785;123;67;33;3;30;.909;3536000;0
32467;207493;121;94;39;1;38;.974;3600000;0
32467;207504;123;0;0;0;0;.00nan;0;0
32468;213692;112;0;0;0;0;.00nan;0;0
32468;208620;112;73;20;1;19;.950;3600000;0
32468;207424;114;52;28;3;25;.893;3566000;0
32468;212783;114;0;0;0;0;.00nan;0;0
32469;207535;108;64;20;2;18;.900;2390000;0
32469;207600;120;41;25;5;20;.800;3600000;0
32469;-1;108;22;12;4;8;.667;1172000;0
32469;213613;120;0;0;0;0;.00nan;0;0
32470;208652;124;0;0;0;0;.00nan;0;0
32470;204894;121;68;27;2;25;.926;3600000;0
32470;206731;124;67;36;4;32;.889;3596000;0
32470;207493;121;0;0;0;0;.00nan;0;0
32471;213845;113;59;26;3;23;.885;3600000;0
32471;204711;119;0;0;0;0;.00nan;0;0
32471;210765;113;0;0;0;0;.00nan;0;0
32471;218853;119;71;47;4;43;.915;3561000;0
32472;210773;111;27;8;3;5;.625;474000;0
32472;212683;118;0;0;0;0;.00nan;0;0
32472;-1;111;56;32;4;28;.875;3126000;0
32472;218830;118;78;29;1;28;.966;3600000;0
32473;220341;116;0;0;0;0;.00nan;0;0
32473;216028;116;72;31;3;28;.903;3600000;0
32473;222436;115;0;0;0;0;.00nan;0;0
32473;207439;115;47;29;5;24;.828;3581000;0
32474;205469;122;28;37;7;30;.811;3575000;0
32474;221235;126;46;4;1;3;.750;408000;0
32474;212039;126;57;29;4;25;.862;3192000;0
32474;212681;122;0;0;0;0;.00nan;0;0
32475;203412;117;0;0;0;0;.00nan;0;0
32475;210785;123;60;27;3;24;.889;3558000;0
32475;207504;123;0;0;0;0;.00nan;0;0
32475;213504;117;76;30;2;28;.933;3600000;0
32476;220301;110;46;32;4;28;.875;3886000;0
32476;204630;109;55;33;4;29;.879;3900000;0
32476;205458;109;0;0;0;0;.00nan;0;0
32476;215968;110;0;0;0;0;.00nan;0;0
32477;213692;112;79;34;2;32;.941;3900000;0
32477;208620;112;0;0;0;0;.00nan;0;0
32477;207600;120;0;0;0;0;.00nan;0;0
32477;213613;120;52;22;2;20;.909;3892000;0
32478;213845;113;53;2;0;2;1.000;791000;0
32478;220341;116;31;8;3;5;.625;337000;0
32478;210765;113;26;27;6;21;.778;2809000;0
32478;216028;116;38;33;7;26;.788;3263000;0
32479;203412;117;39;21;4;17;.810;3600000;0
32479;208652;124;67;46;5;41;.891;3563000;0
32479;206731;124;0;0;0;0;.00nan;0;0
32479;213504;117;0;0;0;0;.00nan;0;0
32480;205469;122;0;0;0;0;.00nan;0;0
32480;212681;122;48;36;5;31;.861;3600000;0
32480;212683;118;41;16;3;13;.813;3600000;0
32480;218830;118;0;0;0;0;.00nan;0;0
32481;204618;125;54;32;4;28;.875;3600000;0
32481;212052;127;38;9;2;7;.778;327000;0
32481;206864;127;1;26;9;17;.654;3273000;0
32481;-1;125;0;0;0;0;.00nan;0;0
32482;207424;114;73;32;3;29;.906;3600000;0
32482;207535;108;0;0;0;0;.00nan;0;0
32482;212783;114;0;0;0;0;.00nan;0;0
32482;-1;108;31;23;5;18;.783;3600000;0
32483;204894;121;0;0;0;0;.00nan;0;0
32483;221235;126;0;0;0;0;.00nan;0;0
32483;212039;126;100;32;0;32;1.000;3900000;0
32483;207493;121;86;27;0;27;1.000;3900000;0
32484;204618;125;0;0;0;0;.00nan;0;0
32484;212052;127;40;32;5;27;.844;3600000;0
32484;206864;127;0;0;0;0;.00nan;0;0
32484;-1;125;74;24;2;22;.917;3600000;0
32485;204711;119;81;32;2;30;.938;3600000;0
32485;212683;118;0;0;0;0;.00nan;0;0
32485;218830;118;62;37;4;33;.892;3600000;0
32485;218853;119;0;0;0;0;.00nan;0;0
32486;220301;110;0;0;0;0;.00nan;0;0
32486;210773;111;39;15;3;12;.800;1253000;0
32486;215968;110;70;28;2;26;.929;3600000;0
32486;-1;111;21;29;7;22;.759;2347000;0
32487;210785;123;61;36;4;32;.889;3523000;0
32487;221235;126;0;0;0;0;.00nan;0;0
32487;212039;126;62;19;2;17;.895;3600000;0
32487;207504;123;0;0;0;0;.00nan;0;0
32488;204711;119;0;0;0;0;.00nan;0;0
32488;205469;122;0;0;0;0;.00nan;0;0
32488;212681;122;53;35;5;30;.857;3554000;0
32488;218853;119;60;24;3;21;.875;3600000;0
32489;208652;124;0;0;0;0;.00nan;0;0
32489;210785;123;40;2;1;1;.500;615000;0
32489;206731;124;67;33;4;29;.879;3600000;0
32489;207504;123;39;40;6;34;.850;2985000;0
32490;213692;112;0;0;0;0;.00nan;0;0
32490;208620;112;96;25;0;25;1.000;3600000;0
32490;207424;114;5;23;7;16;.696;3600000;0
32490;212783;114;0;0;0;0;.00nan;0;0
32491;213845;113;34;17;5;12;.706;3600000;0
32491;204618;125;47;46;6;40;.870;3128000;0
32491;210765;113;0;0;0;0;.00nan;0;0
32491;-1;125;48;8;1;7;.875;459000;0
32492;220341;116;0;0;0;0;.00nan;0;0
32492;216028;116;50;33;4;29;.879;3600000;0
32492;222436;115;0;0;0;0;.00nan;0;0
32492;207439;115;98;37;1;36;.973;3600000;0
32493;204630;109;52;31;4;27;.871;3571000;0
32493;205458;109;0;0;0;0;.00nan;0;0
32493;221235;126;0;0;0;0;.00nan;0;0
32493;212039;126;77;41;3;38;.927;3600000;0
32494;212052;127;0;0;0;0;.00nan;0;0
32494;206864;127;68;45;4;41;.911;3600000;0
32494;212683;118;0;0;0;0;.00nan;0;0
32494;218830;118;35;12;3;9;.750;3600000;0
32495;220341;116;0;0;0;0;.00nan;0;0
32495;210773;111;52;19;3;16;.842;3600000;0
32495;216028;116;57;32;4;28;.875;3559000;0
32495;-1;111;0;0;0;0;.00nan;0;0
32496;213692;112;0;0;0;0;.00nan;0;0
32496;208620;112;43;29;4;25;.862;3575000;0
32496;221235;126;76;30;2;28;.933;3600000;0
32496;212039;126;0;0;0;0;.00nan;0;0
32497;220301;110;0;0;0;0;.00nan;0;0
32497;215968;110;54;36;5;31;.861;3600000;0
32497;207535;108;0;0;0;0;.00nan;0;0
32497;-1;108;84;29;1;28;.966;3600000;0
32498;203412;117;0;0;0;0;.00nan;0;0
32498;207424;114;0;0;0;0;.00nan;0;0
32498;212783;114;75;39;3;36;.923;3546000;0
32498;213504;117;52;15;2;13;.867;3600000;0
32499;204894;121;0;0;0;0;.00nan;0;0
32499;222436;115;49;32;6;26;.813;2812000;0
32499;207439;115;30;15;4;11;.733;788000;0
32499;207493;121;67;23;2;21;.913;3600000;0
32500;204630;109;66;35;4;31;.886;3900000;0
32500;204711;119;0;0;0;0;.00nan;0;0
32500;205458;109;0;0;0;0;.00nan;0;0
32500;218853;119;48;26;4;22;.846;3900000;0
32501;205469;122;3;35;9;26;.743;3336000;0
32501;212681;122;48;0;0;0;.00nan;264000;0
32501;212683;118;69;33;3;30;.909;3600000;0
32501;218830;118;0;0;0;0;.00nan;0;0
32502;208652;124;24;8;3;5;.625;639000;0
32502;206731;124;33;29;6;23;.793;2961000;0
32502;207600;120;0;0;0;0;.00nan;0;0
32502;213613;120;63;34;3;31;.912;3600000;0
32503;210773;111;0;0;0;0;.00nan;0;0
32503;222436;115;0;0;0;0;.00nan;0;0
32503;207439;115;31;20;5;15;.750;3600000;0
32503;-1;111;43;36;6;30;.833;3568000;0
32504;204618;125;55;44;6;38;.864;3600000;0
32504;220341;116;0;0;0;0;.00nan;0;0
32504;216028;116;86;33;2;31;.939;3600000;0
32504;-1;125;0;0;0;0;.00nan;0;0
32505;208652;124;45;29;5;24;.828;3600000;0
32505;204894;121;88;21;0;21;1.000;3600000;0
32505;206731;124;0;0;0;0;.00nan;0;0
32505;207493;121;0;0;0;0;.00nan;0;0
32506;203412;117;61;38;5;33;.868;3600000;0
32506;205469;122;0;0;0;0;.00nan;0;0
32506;212681;122;74;27;2;25;.926;3600000;0
32506;213504;117;0;0;0;0;.00nan;0;0
32507;212683;118;0;0;0;0;.00nan;0;0
32507;207600;120;70;32;2;30;.938;3600000;0
32507;213613;120;0;0;0;0;.00nan;0;0
32507;218830;118;38;33;6;27;.818;3600000;0
32508;220301;110;63;31;3;28;.903;3554000;0
32508;215968;110;0;0;0;0;.00nan;0;0
32508;207535;108;73;32;2;30;.938;3600000;0
32508;-1;108;0;0;0;0;.00nan;0;0
32509;210785;123;61;24;3;21;.875;3600000;0
32509;212052;127;42;38;6;32;.842;3600000;0
32509;206864;127;0;0;0;0;.00nan;0;0
32509;207504;123;0;0;0;0;.00nan;0;0
32510;213845;113;83;25;1;24;.960;3600000;0
32510;210765;113;0;0;0;0;.00nan;0;0
32510;207424;114;68;33;3;30;.909;3517000;0
32510;212783;114;0;0;0;0;.00nan;0;0
32511;221235;126;0;0;0;0;.00nan;0;0
32511;212039;126;54;43;6;37;.860;3600000;0
32511;207535;108;0;0;0;0;.00nan;0;0
32511;-1;108;34;22;5;17;.773;3600000;0
32512;204618;125;0;0;0;0;.00nan;0;0
32512;204711;119;63;24;2;22;.917;3600000;0
32512;-1;125;78;47;3;44;.936;3564000;0
32512;218853;119;0;0;0;0;.00nan;0;0
32513;204630;109;82;33;2;31;.939;3600000;0
32513;205458;109;0;0;0;0;.00nan;0;0
32513;210773;111;35;31;6;25;.806;3183000;0
32513;-1;111;57;7;0;7;1.000;417000;0
32514;210785;123;0;0;0;0;.00nan;0;0
32514;212052;127;0;0;0;0;.00nan;0;0
32514;206864;127;54;39;5;34;.872;3600000;0
32514;207504;123;70;21;2;19;.905;3600000;0
32515;213692;112;54;30;5;25;.833;3520000;0
32515;208620;112;0;0;0;0;.00nan;0;0
32515;220301;110;0;0;0;0;.00nan;0;0
32515;215968;110;98;50;3;47;.940;3600000;0
32516;213692;112;0;0;0;0;.00nan;0;0
32516;208620;112;69;31;3;28;.903;3600000;0
32516;207535;108;0;0;0;0;.00nan;0;0
32516;-1;108;32;23;5;18;.783;3551000;0
32517;212683;118;39;6;2;4;.667;598000;0
32517;207600;120;0;0;0;0;.00nan;0;0
32517;213613;120;55;34;4;30;.882;3600000;0
32517;218830;118;45;25;4;21;.840;2959000;0
32518;210773;111;0;0;0;0;.00nan;0;0
32518;221235;126;0;0;0;0;.00nan;0;0
32518;212039;126;76;26;2;24;.923;3600000;0
32518;-1;111;41;19;4;15;.789;3515000;0
32519;204618;125;32;17;4;13;.765;3586000;0
32519;222436;115;0;0;0;0;.00nan;0;0
32519;207439;115;65;26;2;24;.923;3600000;0
32519;-1;125;0;0;0;0;.00nan;0;0
32520;213845;113;0;0;0;0;.00nan;0;0
32520;204630;109;51;42;6;36;.857;3600000;0
32520;205458;109;0;0;0;0;.00nan;0;0
32520;210765;113;50;23;3;20;.870;3600000;0
32521;220341;116;0;0;0;0;.00nan;0;0
32521;216028;116;54;18;2;16;.889;3600000;0
32521;207424;114;84;32;1;31;.969;3600000;0
32521;212783;114;0;0;0;0;.00nan;0;0
32522;205469;122;0;0;0;0;.00nan;0;0
32522;212052;127;66;33;3;30;.909;3524000;0
32522;206864;127;0;0;0;0;.00nan;0;0
32522;212681;122;99;33;1;32;.970;3600000;0
32523;213692;112;57;24;3;21;.875;3681000;0
32523;208620;112;0;0;0;0;.00nan;0;0
32523;203412;117;0;0;0;0;.00nan;0;0
32523;213504;117;50;30;4;26;.867;3681000;0
32524;210773;111;0;0;0;0;.00nan;0;0
32524;207535;108;0;0;0;0;.00nan;0;0
32524;-1;111;39;23;5;18;.783;3600000;0
32524;-1;108;73;28;2;26;.929;3600000;0
32525;204894;121;77;21;1;20;.952;3600000;0
32525;210785;123;65;35;4;31;.886;3600000;0
32525;207493;121;0;0;0;0;.00nan;0;0
32525;207504;123;0;0;0;0;.00nan;0;0
32526;204711;119;0;0;0;0;.00nan;0;0
32526;212052;127;0;0;0;0;.00nan;0;0
32526;206864;127;92;43;2;41;.953;3600000;0
32526;218853;119;54;28;3;25;.893;3545000;0
32527;208652;124;95;55;3;52;.945;3600000;0
32527;206731;124;0;0;0;0;.00nan;0;0
32527;212683;118;84;11;0;11;1.000;3600000;0
32527;218830;118;0;0;0;0;.00nan;0;0
32528;204630;109;86;29;2;27;.931;3600000;0
32528;205458;109;0;0;0;0;.00nan;0;0
32528;222436;115;0;0;0;0;.00nan;0;0
32528;207439;115;66;27;3;24;.889;3550000;0
32529;205469;122;55;27;3;24;.889;3900000;0
32529;221235;126;0;0;0;0;.00nan;0;0
32529;212039;126;54;25;3;22;.880;3900000;0
32529;212681;122;0;0;0;0;.00nan;0;0
32530;213845;113;67;27;3;24;.889;3600000;0
32530;204618;125;71;43;4;39;.907;3591000;0
32530;210765;113;0;0;0;0;.00nan;0;0
32530;-1;125;0;0;0;0;.00nan;0;0
32531;220341;116;65;10;0;10;1.000;575000;0
32531;216028;116;14;21;6;15;.714;3025000;0
32531;207600;120;61;36;4;32;.889;3600000;0
32531;213613;120;0;0;0;0;.00nan;0;0
32532;203412;117;30;37;7;30;.811;3600000;0
32532;207535;108;50;15;2;13;.867;3600000;0
32532;213504;117;0;0;0;0;.00nan;0;0
32532;-1;108;0;0;0;0;.00nan;0;0
32533;213692;112;0;0;0;0;.00nan;0;0
32533;208620;112;99;46;2;44;.957;3600000;0
32533;210773;111;63;24;3;21;.875;3600000;0
32533;-1;111;0;0;0;0;.00nan;0;0
32534;220341;116;43;3;1;2;.667;816000;0
32534;210785;123;43;27;5;22;.815;3600000;0
32534;216028;116;16;28;7;21;.750;2784000;0
32534;207504;123;0;0;0;0;.00nan;0;0
32535;208652;124;0;0;0;0;.00nan;0;0
32535;205469;122;75;35;2;33;.943;3600000;0
32535;206731;124;83;42;3;39;.929;3543000;0
32535;212681;122;0;0;0;0;.00nan;0;0
32536;204894;121;41;4;1;3;.750;302000;0
32536;212683;118;53;27;4;23;.852;3600000;0
32536;207493;121;14;30;7;23;.767;3298000;0
32536;218830;118;0;0;0;0;.00nan;0;0
32537;204711;119;63;15;1;14;.933;3600000;0
32537;212052;127;0;0;0;0;.00nan;0;0
32537;206864;127;37;35;7;28;.800;3600000;0
32537;218853;119;0;0;0;0;.00nan;0;0
32538;207424;114;52;30;3;27;.900;3585000;0
32538;212783;114;0;0;0;0;.00nan;0;0
32538;207600;120;0;0;0;0;.00nan;0;0
32538;213613;120;78;26;2;24;.923;3600000;0
32539;213845;113;70;29;2;27;.931;3600000;0
32539;210765;113;0;0;0;0;.00nan;0;0
32539;222436;115;0;0;0;0;.00nan;0;0
32539;207439;115;54;31;5;26;.839;3600000;0
32540;220301;110;0;0;0;0;.00nan;0;0
32540;204630;109;61;44;5;39;.886;3600000;0
32540;205458;109;0;0;0;0;.00nan;0;0
32540;215968;110;79;29;1;28;.966;3600000;0
32541;208652;124;100;39;0;39;1.000;3600000;0
32541;221235;126;0;0;0;0;.00nan;0;0
32541;206731;124;0;0;0;0;.00nan;0;0
32541;212039;126;57;18;2;16;.889;3528000;0
32542;204711;119;82;43;3;40;.930;3900000;0
32542;204894;121;0;0;0;0;.00nan;0;0
32542;207493;121;88;46;3;43;.935;3900000;0
32542;218853;119;0;0;0;0;.00nan;0;0
32543;208652;124;69;28;2;26;.929;3600000;0
32543;210785;123;18;9;4;5;.556;274000;0
32543;206731;124;0;0;0;0;.00nan;0;0
32543;207504;123;63;33;3;30;.909;3326000;0
32544;205469;122;0;0;0;0;.00nan;0;0
32544;212681;122;76;31;3;28;.903;3600000;0
32544;207424;114;29;29;6;23;.793;2158000;0
32544;212783;114;69;26;2;24;.923;1442000;0
32545;213845;113;0;0;0;0;.00nan;0;0
32545;210765;113;88;32;1;31;.969;3600000;0
32545;212683;118;69;40;4;36;.900;3600000;0
32545;218830;118;0;0;0;0;.00nan;0;0
32546;220341;116;0;0;0;0;.00nan;0;0
32546;210773;111;0;0;0;0;.00nan;0;0
32546;216028;116;29;26;6;20;.769;3580000;0
32546;-1;111;24;20;5;15;.750;3600000;0
32547;204618;125;89;36;2;34;.944;2429000;0
32547;204894;121;44;29;5;24;.828;3625000;0
32547;207493;121;0;0;0;0;.00nan;0;0
32547;-1;125;30;17;4;13;.765;1196000;0
32548;204630;109;82;24;1;23;.958;3600000;0
32548;205458;109;0;0;0;0;.00nan;0;0
32548;212052;127;77;34;2;32;.941;3600000;0
32548;206864;127;0;0;0;0;.00nan;0;0
32549;204618;125;0;0;0;0;.00nan;0;0
32549;210773;111;36;19;4;15;.789;3600000;0
32549;-1;111;0;0;0;0;.00nan;0;0
32549;-1;125;37;52;9;43;.827;3600000;0
32550;213692;112;0;0;0;0;.00nan;0;0
32550;208620;112;60;18;2;16;.889;3600000;0
32550;212052;127;0;0;0;0;.00nan;0;0
32550;206864;127;52;42;6;36;.857;3600000;0
32551;203412;117;40;20;3;17;.850;2738000;0
32551;204630;109;35;24;5;19;.792;3600000;0
32551;205458;109;0;0;0;0;.00nan;0;0
32551;213504;117;22;9;4;5;.556;793000;0
32552;204711;119;0;0;0;0;.00nan;0;0
32552;205469;122;69;34;4;30;.882;3844000;0
32552;212681;122;0;0;0;0;.00nan;0;0
32552;218853;119;45;31;4;27;.871;3900000;0
32553;222436;115;0;0;0;0;.00nan;0;0
32553;212683;118;0;0;0;0;.00nan;0;0
32553;207439;115;85;45;3;42;.933;3586000;0
32553;218830;118;52;18;2;16;.889;3600000;0
32554;213845;113;93;41;3;38;.927;3600000;0
32554;210765;113;0;0;0;0;.00nan;0;0
32554;207600;120;0;0;0;0;.00nan;0;0
32554;213613;120;69;30;2;28;.933;3600000;0
32555;220301;110;0;0;0;0;.00nan;0;0
32555;215968;110;64;23;2;21;.913;3600000;0
32555;207535;108;0;0;0;0;.00nan;0;0
32555;-1;108;25;37;8;29;.784;3600000;0
32556;220301;110;57;34;5;29;.853;3600000;0
32556;215968;110;0;0;0;0;.00nan;0;0
32556;207535;108;73;22;1;21;.955;3600000;0
32556;-1;108;0;0;0;0;.00nan;0;0
32557;204711;119;78;44;4;40;.909;3600000;0
32557;207600;120;87;13;0;13;1.000;3600000;0
32557;213613;120;0;0;0;0;.00nan;0;0
32557;218853;119;0;0;0;0;.00nan;0;0
32558;208652;124;0;0;0;0;.00nan;0;0
32558;220341;116;0;0;0;0;.00nan;0;0
32558;216028;116;82;28;2;26;.929;3600000;0
32558;206731;124;58;30;4;26;.867;3518000;0
32559;203412;117;0;0;0;0;.00nan;0;0
32559;204894;121;0;0;0;0;.00nan;0;0
32559;207493;121;53;27;3;24;.889;3628000;0
32559;213504;117;72;48;4;44;.917;3628000;0
32560;213845;113;99;38;1;37;.974;3600000;0
32560;205469;122;0;0;0;0;.00nan;0;0
32560;210765;113;0;0;0;0;.00nan;0;0
32560;212681;122;19;41;8;33;.805;3600000;0
32561;210785;123;76;41;4;37;.902;3552000;0
32561;221235;126;0;0;0;0;.00nan;0;0
32561;212039;126;92;42;3;39;.929;3600000;0
32561;207504;123;0;0;0;0;.00nan;0;0
32562;212683;118;71;37;3;34;.919;3547000;0
32562;207424;114;82;41;2;39;.951;3600000;0
32562;212783;114;0;0;0;0;.00nan;0;0
32562;218830;118;0;0;0;0;.00nan;0;0
32563;213692;112;77;27;2;25;.926;3600000;0
32563;208620;112;0;0;0;0;.00nan;0;0
32563;210773;111;0;0;0;0;.00nan;0;0
32563;-1;111;56;31;4;27;.871;3540000;0
32564;212052;127;18;28;7;21;.750;1997000;0
32564;206864;127;77;18;0;18;1.000;1603000;0
32564;207535;108;0;0;0;0;.00nan;0;0
32564;-1;108;72;22;2;20;.909;3600000;0
32565;221235;126;86;29;1;28;.966;3600000;0
32565;212039;126;0;0;0;0;.00nan;0;0
32565;207600;120;71;32;2;30;.938;3545000;0
32565;213613;120;0;0;0;0;.00nan;0;0
32566;203412;117;92;32;1;31;.969;3600000;0
32566;204618;125;71;26;2;24;.923;3576000;0
32566;213504;117;0;0;0;0;.00nan;0;0
32566;-1;125;0;0;0;0;.00nan;0;0
32567;208652;124;21;23;6;17;.739;2847000;0
32567;204711;119;63;40;4;36;.900;3600000;0
32567;206731;124;45;5;1;4;.800;753000;0
32567;218853;119;0;0;0;0;.00nan;0;0
32568;220341;116;0;0;0;0;.00nan;0;0
32568;210785;123;84;29;2;27;.931;3900000;0
32568;216028;116;92;30;2;28;.933;3900000;0
32568;207504;123;0;0;0;0;.00nan;0;0
32569;220301;110;0;0;0;0;.00nan;0;0
32569;215968;110;76;43;4;39;.907;3554000;0
32569;222436;115;0;0;0;0;.00nan;0;0
32569;207439;115;71;32;3;29;.906;3600000;0
32570;204630;109;82;34;2;32;.941;3725000;0
32570;205458;109;0;0;0;0;.00nan;0;0
32570;222436;115;81;34;3;31;.912;3725000;0
32570;207439;115;0;0;0;0;.00nan;0;0
32571;213692;112;42;34;5;29;.853;3827000;0
32571;208620;112;0;0;0;0;.00nan;0;0
32571;207535;108;0;0;0;0;.00nan;0;0
32571;-1;108;66;33;4;29;.879;3827000;0
32572;203412;117;0;0;0;0;.00nan;0;0
32572;207600;120;65;28;3;25;.893;3900000;0
32572;213504;117;56;30;3;27;.900;3900000;0
32572;213613;120;0;0;0;0;.00nan;0;0
32573;220341;116;0;0;0;0;.00nan;0;0
32573;210773;111;0;0;0;0;.00nan;0;0
32573;216028;116;65;33;4;29;.879;3573000;0
32573;-1;111;73;27;2;25;.926;3600000;0
32574;204711;119;89;33;1;32;.970;3600000;0
32574;204894;121;57;33;4;29;.879;3600000;0
32574;207493;121;0;0;0;0;.00nan;0;0
32574;218853;119;0;0;0;0;.00nan;0;0
32575;204618;125;0;0;0;0;.00nan;0;0
32575;210785;123;88;31;1;30;.968;3600000;0
32575;207504;123;0;0;0;0;.00nan;0;0
32575;-1;125;55;47;6;41;.872;3600000;0
32576;212052;127;0;0;0;0;.00nan;0;0
32576;206864;127;61;33;4;29;.879;3600000;0
32576;207424;114;55;10;1;9;.900;3600000;0
32576;212783;114;0;0;0;0;.00nan;0;0
32577;208652;124;0;0;0;0;.00nan;0;0
32577;204630;109;59;21;2;19;.905;3600000;0
32577;205458;109;0;0;0;0;.00nan;0;0
32577;206731;124;56;33;4;29;.879;3575000;0
32578;213692;112;0;0;0;0;.00nan;0;0
32578;213845;113;59;32;4;28;.875;3900000;0
32578;208620;112;56;37;4;33;.892;3900000;0
32578;210765;113;0;0;0;0;.00nan;0;0
32579;220341;116;0;0;0;0;.00nan;0;0
32579;204711;119;63;35;5;30;.857;3600000;0
32579;216028;116;47;36;6;30;.833;3600000;0
32579;218853;119;0;0;0;0;.00nan;0;0
32580;203412;117;50;31;5;26;.839;1713000;0
32580;212683;118;0;0;0;0;.00nan;0;0
32580;213504;117;43;31;5;26;.839;1887000;0
32580;218830;118;34;26;5;21;.808;3600000;0
32581;222436;115;0;0;0;0;.00nan;0;0
32581;207424;114;78;25;1;24;.960;3600000;0
32581;207439;115;82;47;3;44;.936;3600000;0
32581;212783;114;0;0;0;0;.00nan;0;0
32582;210773;111;64;11;0;11;1.000;804000;0
32582;221235;126;0;0;0;0;.00nan;0;0
32582;212039;126;73;32;3;29;.906;3600000;0
32582;-1;111;8;28;8;20;.714;2796000;0
32583;204618;125;84;35;2;33;.943;3600000;0
32583;210785;123;65;34;3;31;.912;3600000;0
32583;207504;123;0;0;0;0;.00nan;0;0
32583;-1;125;0;0;0;0;.00nan;0;0
32584;212052;127;52;29;4;25;.862;3560000;0
32584;206864;127;0;0;0;0;.00nan;0;0
32584;207600;120;63;19;2;17;.895;3600000;0
32584;213613;120;0;0;0;0;.00nan;0;0
32585;208652;124;57;38;4;34;.895;3561000;0
32585;206731;124;0;0;0;0;.00nan;0;0
32585;207535;108;0;0;0;0;.00nan;0;0
32585;-1;108;45;19;3;16;.842;3600000;0
32586;220301;110;0;0;0;0;.00nan;0;0
32586;210773;111;57;38;4;34;.895;3587000;0
32586;215968;110;65;23;2;21;.913;3600000;0
32586;-1;111;0;0;0;0;.00nan;0;0
32587;204894;121;27;5;3;2;.400;544000;0
32587;205469;122;44;38;6;32;.842;3723000;0
32587;212681;122;0;0;0;0;.00nan;0;0
32587;207493;121;53;15;2;13;.867;3179000;0
32588;213845;113;40;33;6;27;.818;3288000;0
32588;204630;109;95;45;2;43;.956;3600000;0
32588;205458;109;0;0;0;0;.00nan;0;0
32588;210765;113;39;1;1;0;.000;312000;0
32589;210785;123;0;0;0;0;.00nan;0;0
32589;212683;118;72;32;2;30;.938;3600000;0
32589;207504;123;74;45;4;41;.911;3600000;0
32589;218830;118;0;0;0;0;.00nan;0;0
32590;204618;125;0;0;0;0;.00nan;0;0
32590;207424;114;52;24;3;21;.875;3600000;0
32590;212783;114;0;0;0;0;.00nan;0;0
32590;-1;125;45;32;5;27;.844;3514000;0
32591;213692;112;28;24;5;19;.792;3600000;0
32591;208620;112;0;0;0;0;.00nan;0;0
32591;208652;124;42;6;1;5;.833;530000;0
32591;206731;124;30;35;7;28;.800;3070000;0
32592;213845;113;51;22;3;19;.864;3600000;0
32592;210765;113;0;0;0;0;.00nan;0;0
32592;207535;108;59;39;5;34;.872;3511000;0
32592;-1;108;0;0;0;0;.00nan;0;0
32593;203412;117;0;0;0;0;.00nan;0;0
32593;222436;115;0;0;0;0;.00nan;0;0
32593;207439;115;44;34;6;28;.824;3600000;0
32593;213504;117;92;25;0;25;1.000;3600000;0
32594;204630;109;25;14;4;10;.714;807000;0
32594;220341;116;0;0;0;0;.00nan;0;0
32594;205458;109;30;19;5;14;.737;2793000;0
32594;216028;116;76;35;3;32;.914;3600000;0
32595;220301;110;99;21;0;21;1.000;3600000;0
32595;215968;110;0;0;0;0;.00nan;0;0
32595;207600;120;75;33;3;30;.909;3600000;0
32595;213613;120;0;0;0;0;.00nan;0;0
32596;204894;121;81;29;2;27;.931;3600000;0
32596;205469;122;0;0;0;0;.00nan;0;0
32596;212681;122;95;47;3;44;.936;3600000;0
32596;207493;121;0;0;0;0;.00nan;0;0
32597;204711;119;64;30;3;27;.900;3538000;0
32597;221235;126;0;0;0;0;.00nan;0;0
32597;212039;126;91;30;1;29;.967;3600000;0
32597;218853;119;0;0;0;0;.00nan;0;0
32598;204711;119;36;33;5;28;.848;3600000;0
32598;207600;120;25;6;3;3;.500;520000;0
32598;213613;120;42;26;4;22;.846;3013000;0
32598;218853;119;0;0;0;0;.00nan;0;0
32599;221235;126;0;0;0;0;.00nan;0;0
32599;212039;126;37;33;6;27;.818;3600000;0
32599;212683;118;0;0;0;0;.00nan;0;0
32599;218830;118;45;27;4;23;.852;3600000;0
32600;220301;110;43;25;4;21;.840;3593000;0
32600;215968;110;0;0;0;0;.00nan;0;0
32600;207535;108;0;0;0;0;.00nan;0;0
32600;-1;108;80;32;2;30;.938;3600000;0
32601;204618;125;48;42;6;36;.857;3600000;0
32601;222436;115;0;0;0;0;.00nan;0;0
32601;207439;115;82;14;0;14;1.000;3600000;0
32601;-1;125;0;0;0;0;.00nan;0;0
32602;221235;126;0;0;0;0;.00nan;0;0
32602;212039;126;89;22;0;22;1.000;3600000;0
32602;207424;114;25;30;6;24;.800;3183000;0
32602;212783;114;35;4;2;2;.500;417000;0
32603;213692;112;0;0;0;0;.00nan;0;0
32603;213845;113;0;0;0;0;.00nan;0;0
32603;208620;112;79;40;3;37;.925;3600000;0
32603;210765;113;48;37;5;32;.865;3564000;0
32604;220341;116;0;0;0;0;.00nan;0;0
32604;204894;121;49;22;3;19;.864;2826000;0
32604;216028;116;87;38;2;36;.947;3600000;0
32604;207493;121;27;16;4;12;.750;774000;0
32605;204630;109;88;27;2;25;.926;3600000;0
32605;205458;109;0;0;0;0;.00nan;0;0
32605;210773;111;38;27;5;22;.815;3175000;0
32605;-1;111;34;10;3;7;.700;425000;0
32606;212052;127;0;0;0;0;.00nan;0;0
32606;206864;127;54;31;4;27;.871;3600000;0
32606;207424;114;26;23;5;18;.783;3557000;0
32606;212783;114;0;0;0;0;.00nan;0;0
32607;204630;109;61;34;4;30;.882;3600000;0
32607;205458;109;0;0;0;0;.00nan;0;0
32607;207535;108;66;34;3;31;.912;3600000;0
32607;-1;108;0;0;0;0;.00nan;0;0
32608;213845;113;74;33;3;30;.909;3600000;0
32608;203412;117;0;0;0;0;.00nan;0;0
32608;210765;113;0;0;0;0;.00nan;0;0
32608;213504;117;44;26;4;22;.846;3558000;0
32609;204711;119;49;23;3;20;.870;3600000;0
32609;210773;111;0;0;0;0;.00nan;0;0
32609;-1;111;66;43;5;38;.884;3538000;0
32609;218853;119;0;0;0;0;.00nan;0;0
32610;210785;123;85;53;4;49;.925;3600000;0
32610;212683;118;0;0;0;0;.00nan;0;0
32610;207504;123;0;0;0;0;.00nan;0;0
32610;218830;118;64;17;2;15;.882;3600000;0
32611;220341;116;0;0;0;0;.00nan;0;0
32611;216028;116;62;21;2;19;.905;3600000;0
32611;222436;115;0;0;0;0;.00nan;0;0
32611;207439;115;60;34;4;30;.882;3516000;0
32612;213692;112;99;29;0;29;1.000;3600000;0
32612;208620;112;0;0;0;0;.00nan;0;0
32612;204618;125;46;37;6;31;.838;2894000;0
32612;-1;125;37;8;2;6;.750;706000;0
32613;205469;122;61;28;3;25;.893;3600000;0
32613;212681;122;0;0;0;0;.00nan;0;0
32613;207600;120;0;0;0;0;.00nan;0;0
32613;213613;120;21;27;6;21;.778;3600000;0
32614;204711;119;29;35;6;29;.829;3575000;0
32614;210773;111;48;34;5;29;.853;3600000;0
32614;-1;111;0;0;0;0;.00nan;0;0
32614;218853;119;0;0;0;0;.00nan;0;0
32615;208652;124;56;29;3;26;.897;3600000;0
32615;210785;123;0;0;0;0;.00nan;0;0
32615;206731;124;0;0;0;0;.00nan;0;0
32615;207504;123;70;41;4;37;.902;3579000;0
32616;204894;121;0;0;0;0;.00nan;0;0
32616;207493;121;56;25;3;22;.880;3600000;0
32616;207600;120;43;35;5;30;.857;3563000;0
32616;213613;120;0;0;0;0;.00nan;0;0
32617;205469;122;0;0;0;0;.00nan;0;0
32617;221235;126;0;0;0;0;.00nan;0;0
32617;212039;126;60;24;3;21;.875;3622000;0
32617;212681;122;82;32;2;30;.938;3622000;0
32618;220301;110;0;0;0;0;.00nan;0;0
32618;215968;110;49;20;3;17;.850;3600000;0
32618;212052;127;90;46;2;44;.957;3600000;0
32618;206864;127;0;0;0;0;.00nan;0;0
32619;203412;117;32;36;7;29;.806;3600000;0
32619;207424;114;0;0;0;0;.00nan;0;0
32619;212783;114;55;27;4;23;.852;3600000;0
32619;213504;117;0;0;0;0;.00nan;0;0
32620;204630;109;100;43;0;43;1.000;3600000;0
32620;205458;109;0;0;0;0;.00nan;0;0
32620;207535;108;0;0;0;0;.00nan;0;0
32620;-1;108;58;24;2;22;.917;3560000;0
32621;213692;112;0;0;0;0;.00nan;0;0
32621;208620;112;49;34;5;29;.853;3607000;0
32621;222436;115;0;0;0;0;.00nan;0;0
32621;207439;115;50;29;4;25;.862;3607000;0
32622;220301;110;24;13;4;9;.692;945000;0
32622;215968;110;48;19;3;16;.842;2655000;0
32622;221235;126;52;33;4;29;.879;2580000;0
32622;212039;126;25;9;4;5;.556;985000;0
32623;204618;125;28;19;4;15;.789;1045000;0
32623;212683;118;56;17;2;15;.882;3600000;0
32623;218830;118;0;0;0;0;.00nan;0;0
32623;-1;125;67;34;3;31;.912;2555000;0
32624;203412;117;0;0;0;0;.00nan;0;0
32624;220341;116;0;0;0;0;.00nan;0;0
32624;216028;116;43;30;5;25;.833;3600000;0
32624;213504;117;56;23;3;20;.870;3600000;0
32625;204711;119;0;0;0;0;.00nan;0;0
32625;207600;120;0;0;0;0;.00nan;0;0
32625;213613;120;45;37;5;32;.865;3600000;0
32625;218853;119;83;36;2;34;.944;3600000;0
32626;208652;124;68;15;0;15;1.000;1763000;0
32626;206731;124;12;21;6;15;.714;1837000;0
32626;212052;127;0;0;0;0;.00nan;0;0
32626;206864;127;39;53;8;45;.849;3548000;0
32627;213845;113;54;19;3;16;.842;3600000;0
32627;204618;125;100;39;0;39;1.000;3600000;0
32627;210765;113;0;0;0;0;.00nan;0;0
32627;-1;125;0;0;0;0;.00nan;0;0
32628;205469;122;29;28;5;23;.821;3586000;0
32628;212681;122;0;0;0;0;.00nan;0;0
32628;207600;120;59;36;4;32;.889;3600000;0
32628;213613;120;0;0;0;0;.00nan;0;0
32629;203412;117;0;0;0;0;.00nan;0;0
32629;220301;110;0;0;0;0;.00nan;0;0
32629;215968;110;38;24;6;18;.750;3576000;0
32629;213504;117;47;28;5;23;.821;3600000;0
32630;220341;116;0;0;0;0;.00nan;0;0
32630;216028;116;81;31;2;29;.935;3600000;0
32630;207535;108;57;26;3;23;.885;3549000;0
32630;-1;108;0;0;0;0;.00nan;0;0
32631;213692;112;34;28;5;23;.821;3555000;0
32631;208620;112;0;0;0;0;.00nan;0;0
32631;204630;109;55;30;4;26;.867;3600000;0
32631;205458;109;0;0;0;0;.00nan;0;0
32632;212052;127;98;58;4;54;.931;3600000;0
32632;206864;127;0;0;0;0;.00nan;0;0
32632;212683;118;0;0;0;0;.00nan;0;0
32632;218830;118;70;6;0;6;1.000;3600000;0
32633;208652;124;0;0;0;0;.00nan;0;0
32633;210785;123;92;45;2;43;.956;3600000;0
32633;206731;124;42;37;6;31;.838;3600000;0
32633;207504;123;0;0;0;0;.00nan;0;0
32634;210773;111;59;33;4;29;.879;3550000;0
32634;207424;114;78;30;2;28;.933;3600000;0
32634;212783;114;0;0;0;0;.00nan;0;0
32634;-1;111;0;0;0;0;.00nan;0;0
32635;213692;112;0;0;0;0;.00nan;0;0
32635;208620;112;75;29;2;27;.931;3587000;0
32635;220341;116;0;0;0;0;.00nan;0;0
32635;216028;116;100;25;0;25;1.000;3600000;0
32636;203412;117;79;36;2;34;.944;3659000;0
32636;220301;110;0;0;0;0;.00nan;0;0
32636;215968;110;62;21;3;18;.857;3659000;0
32636;213504;117;0;0;0;0;.00nan;0;0
32637;208652;124;48;35;5;30;.857;3544000;0
32637;206731;124;0;0;0;0;.00nan;0;0
32637;222436;115;0;0;0;0;.00nan;0;0
32637;207439;115;51;28;4;24;.857;3600000;0
32638;213845;113;55;28;3;25;.893;3567000;0
32638;204894;121;0;0;0;0;.00nan;0;0
32638;210765;113;0;0;0;0;.00nan;0;0
32638;207493;121;88;47;2;45;.957;3600000;0
32639;204618;125;73;49;4;45;.918;3600000;0
32639;204711;119;83;27;1;26;.963;3600000;0
32639;-1;125;0;0;0;0;.00nan;0;0
32639;218853;119;0;0;0;0;.00nan;0;0
32640;205469;122;0;0;0;0;.00nan;0;0
32640;212681;122;80;41;4;37;.902;3765000;0
32640;212683;118;0;0;0;0;.00nan;0;0
32640;218830;118;63;27;3;24;.889;3765000;0
32641;210785;123;38;32;5;27;.844;3600000;0
32641;221235;126;0;0;0;0;.00nan;0;0
32641;212039;126;74;20;1;19;.950;3600000;0
32641;207504;123;0;0;0;0;.00nan;0;0
32642;204630;109;60;34;4;30;.882;3600000;0
32642;205458;109;0;0;0;0;.00nan;0;0
32642;207600;120;89;25;1;24;.960;3600000;0
32642;213613;120;0;0;0;0;.00nan;0;0
32643;204618;125;0;0;0;0;.00nan;0;0
32643;207600;120;0;0;0;0;.00nan;0;0
32643;213613;120;48;26;4;22;.846;3579000;0
32643;-1;125;74;31;3;28;.903;3600000;0
32644;213845;113;75;12;0;12;1.000;3600000;0
32644;220341;116;0;0;0;0;.00nan;0;0
32644;210765;113;0;0;0;0;.00nan;0;0
32644;216028;116;79;36;3;33;.917;3600000;0
32645;208652;124;0;0;0;0;.00nan;0;0
32645;221235;126;0;0;0;0;.00nan;0;0
32645;206731;124;69;31;2;29;.935;3600000;0
32645;212039;126;57;39;5;34;.872;3600000;0
32646;204894;121;73;35;3;32;.914;3600000;0
32646;207493;121;0;0;0;0;.00nan;0;0
32646;207535;108;52;29;3;26;.897;2563000;0
32646;-1;108;27;15;4;11;.733;1037000;0
32647;205469;122;77;30;2;28;.933;3600000;0
32647;212052;127;0;0;0;0;.00nan;0;0
32647;206864;127;92;51;3;48;.941;3587000;0
32647;212681;122;0;0;0;0;.00nan;0;0
32648;210785;123;69;40;3;37;.925;3600000;0
32648;222436;115;52;30;4;26;.867;3588000;0
32648;207439;115;0;0;0;0;.00nan;0;0
32648;207504;123;0;0;0;0;.00nan;0;0
32649;204711;119;0;0;0;0;.00nan;0;0
32649;207424;114;89;30;1;29;.967;3600000;0
32649;212783;114;0;0;0;0;.00nan;0;0
32649;218853;119;62;30;3;27;.900;3519000;0
32650;213692;112;0;0;0;0;.00nan;0;0
32650;208620;112;81;41;3;38;.927;3600000;0
32650;210773;111;0;0;0;0;.00nan;0;0
32650;-1;111;37;23;4;19;.826;3577000;0
32651;203412;117;0;0;0;0;.00nan;0;0
32651;207535;108;0;0;0;0;.00nan;0;0
32651;213504;117;66;38;4;34;.895;3600000;0
32651;-1;108;1;27;8;19;.704;3600000;0
32652;222436;115;0;0;0;0;.00nan;0;0
32652;212683;118;69;28;2;26;.929;3569000;0
32652;207439;115;100;47;1;46;.979;3600000;0
32652;218830;118;0;0;0;0;.00nan;0;0
32653;220301;110;57;12;1;11;.917;1235000;0
32653;204630;109;91;42;2;40;.952;3600000;0
32653;205458;109;0;0;0;0;.00nan;0;0
32653;215968;110;40;32;5;27;.844;2365000;0
32654;213692;112;68;20;1;19;.950;3600000;0
32654;208620;112;0;0;0;0;.00nan;0;0
32654;221211;109;81;31;2;29;.935;3600000;0
32654;217277;109;0;0;0;0;.00nan;0;0
32655;222436;115;0;0;0;0;.00nan;0;0
32655;207424;114;60;36;5;31;.861;3600000;0
32655;207439;115;19;25;6;19;.760;3600000;0
32655;212783;114;0;0;0;0;.00nan;0;0
32656;203412;117;0;0;0;0;.00nan;0;0
32656;212052;127;100;50;2;48;.960;3600000;0
32656;206864;127;0;0;0;0;.00nan;0;0
32656;213504;117;44;16;3;13;.813;3582000;0
32657;213845;113;72;26;2;24;.923;3600000;0
32657;210765;113;0;0;0;0;.00nan;0;0
32657;207535;108;22;26;6;20;.769;2508000;0
32657;-1;108;44;16;3;13;.813;1092000;0
32658;204894;121;43;23;4;19;.826;3544000;0
32658;207493;121;0;0;0;0;.00nan;0;0
32658;207600;120;99;48;2;46;.958;3600000;0
32658;213613;120;0;0;0;0;.00nan;0;0
32659;220341;116;0;0;0;0;.00nan;0;0
32659;205469;122;0;0;0;0;.00nan;0;0
32659;216028;116;57;25;4;21;.840;3900000;0
32659;212681;122;59;33;4;29;.879;3900000;0
32660;220301;110;0;0;0;0;.00nan;0;0
32660;210773;111;67;21;1;20;.952;1301000;0
32660;215968;110;77;29;2;27;.931;3600000;0
32660;-1;111;35;31;6;25;.806;2299000;0
32661;221235;126;0;0;0;0;.00nan;0;0
32661;212039;126;89;34;2;32;.941;3600000;0
32661;212683;118;0;0;0;0;.00nan;0;0
32661;218830;118;47;28;4;24;.857;3572000;0
32662;204618;125;95;45;2;43;.956;3900000;0
32662;211935;123;61;21;2;19;.905;3900000;0
32662;207504;123;0;0;0;0;.00nan;0;0
32662;-1;125;0;0;0;0;.00nan;0;0
32663;203412;117;68;38;5;33;.868;3600000;0
32663;221211;109;28;15;4;11;.733;934000;0
32663;217277;109;64;25;3;22;.880;2580000;0
32663;213504;117;0;0;0;0;.00nan;0;0
32664;208652;124;56;38;5;33;.868;3600000;0
32664;204711;119;49;39;6;33;.846;3574000;0
32664;206731;124;0;0;0;0;.00nan;0;0
32664;218853;119;0;0;0;0;.00nan;0;0
32665;221235;126;0;0;0;0;.00nan;0;0
32665;212039;126;57;35;5;30;.857;3600000;0
32665;212683;118;74;27;2;25;.926;3600000;0
32665;218830;118;0;0;0;0;.00nan;0;0
32666;213845;113;59;26;3;23;.885;3600000;0
32666;210765;113;0;0;0;0;.00nan;0;0
32666;222436;115;35;12;3;9;.750;462000;0
32666;207439;115;59;34;4;30;.882;3138000;0
32667;213692;112;0;0;0;0;.00nan;0;0
32667;208620;112;72;21;1;20;.952;3600000;0
32667;207535;108;0;0;0;0;.00nan;0;0
32667;-1;108;76;33;2;31;.939;3600000;0
32668;210773;111;83;45;3;42;.933;3589000;0
32668;207424;114;85;32;2;30;.938;3600000;0
32668;212783;114;0;0;0;0;.00nan;0;0
32668;-1;111;0;0;0;0;.00nan;0;0
32669;208652;124;47;7;1;6;.857;589000;0
32669;206731;124;35;32;6;26;.813;3011000;0
32669;207600;120;72;39;3;36;.923;3600000;0
32669;213613;120;0;0;0;0;.00nan;0;0
32670;220341;116;0;0;0;0;.00nan;0;0
32670;204894;121;0;0;0;0;.00nan;0;0
32670;216028;116;47;33;5;28;.848;3600000;0
32670;207493;121;64;25;3;22;.880;3600000;0
32671;204711;119;0;0;0;0;.00nan;0;0
32671;205469;122;76;28;2;26;.929;3600000;0
32671;212681;122;0;0;0;0;.00nan;0;0
32671;218853;119;42;30;5;25;.833;3600000;0
32672;211935;123;0;0;0;0;.00nan;0;0
32672;212052;127;52;8;1;7;.875;1405000;0
32672;206864;127;17;20;6;14;.700;2195000;0
32672;207504;123;79;30;1;29;.967;3600000;0
32673;204618;125;48;38;5;33;.868;3600000;0
32673;222436;115;4;31;8;23;.742;3224000;0
32673;207439;115;41;2;1;1;.500;376000;0
32673;-1;125;0;0;0;0;.00nan;0;0
32674;213845;113;0;0;0;0;.00nan;0;0
32674;220301;110;0;0;0;0;.00nan;0;0
32674;210765;113;34;19;4;15;.789;3600000;0
32674;215968;110;74;43;5;38;.884;3571000;0
32675;203412;117;0;0;0;0;.00nan;0;0
32675;221211;109;53;35;4;31;.886;3600000;0
32675;217277;109;0;0;0;0;.00nan;0;0
32675;213504;117;94;30;1;29;.967;3600000;0
32676;221235;126;0;0;0;0;.00nan;0;0
32676;212039;126;36;16;3;13;.813;3600000;0
32676;212052;127;39;16;4;12;.750;976000;0
32676;206864;127;98;42;1;41;.976;2622000;0
32677;204618;125;0;0;0;0;.00nan;0;0
32677;211935;123;72;19;2;17;.895;3900000;0
32677;207504;123;0;0;0;0;.00nan;0;0
32677;-1;125;89;37;2;35;.946;3900000;0
32678;204894;121;54;14;2;12;.857;3600000;0
32678;210773;111;0;0;0;0;.00nan;0;0
32678;207493;121;0;0;0;0;.00nan;0;0
32678;-1;111;62;52;6;46;.885;3600000;0
32679;208652;124;10;35;8;27;.771;3058000;0
32679;206731;124;47;11;2;9;.818;542000;0
32679;212683;118;0;0;0;0;.00nan;0;0
32679;218830;118;90;20;0;20;1.000;3600000;0
32680;220341;116;14;31;8;23;.742;3600000;0
32680;216028;116;0;0;0;0;.00nan;0;0
32680;207600;120;0;0;0;0;.00nan;0;0
32680;213613;120;66;35;4;31;.886;3600000;0
32681;205469;122;0;0;0;0;.00nan;0;0
32681;212681;122;34;39;8;31;.795;3600000;0
32681;207424;114;73;40;4;36;.900;3600000;0
32681;212783;114;0;0;0;0;.00nan;0;0
32682;220301;110;99;40;1;39;.975;3600000;0
32682;204711;119;26;24;6;18;.750;3359000;0
32682;215968;110;0;0;0;0;.00nan;0;0
32682;218853;119;37;8;2;6;.750;241000;0
32683;213692;112;0;0;0;0;.00nan;0;0
32683;208620;112;51;19;3;16;.842;3544000;0
32683;207535;108;0;0;0;0;.00nan;0;0
32683;-1;108;80;37;2;35;.946;3600000;0
32684;204894;121;0;0;0;0;.00nan;0;0
32684;212683;118;0;0;0;0;.00nan;0;0
32684;207493;121;14;19;6;13;.684;3559000;0
32684;218830;118;43;32;5;27;.844;3600000;0
32685;220301;110;0;0;0;0;.00nan;0;0
32685;204618;125;73;30;3;27;.900;3570000;0
32685;215968;110;78;31;2;29;.935;3600000;0
32685;-1;125;0;0;0;0;.00nan;0;0
32686;221211;109;69;37;4;33;.892;3600000;0
32686;221235;126;88;20;0;20;1.000;3600000;0
32686;212039;126;0;0;0;0;.00nan;0;0
32686;217277;109;0;0;0;0;.00nan;0;0
32687;208652;124;53;28;4;24;.857;3900000;0
32687;206731;124;0;0;0;0;.00nan;0;0
32687;212052;127;0;0;0;0;.00nan;0;0
32687;206864;127;72;43;4;39;.907;3900000;0
32688;221235;126;70;41;4;37;.902;3624000;0
32688;212039;126;0;0;0;0;.00nan;0;0
32688;207424;114;50;23;3;20;.870;3624000;0
32688;212783;114;0;0;0;0;.00nan;0;0
32689;213845;113;32;18;4;14;.778;3600000;0
32689;210765;113;0;0;0;0;.00nan;0;0
32689;210773;111;0;0;0;0;.00nan;0;0
32689;-1;111;80;49;5;44;.898;3572000;0
32690;204894;121;62;22;2;20;.909;3600000;0
32690;205469;122;30;28;7;21;.750;3311000;0
32690;212681;122;41;2;1;1;.500;289000;0
32690;207493;121;0;0;0;0;.00nan;0;0
32691;204711;119;74;34;2;32;.941;3900000;0
32691;211935;123;0;0;0;0;.00nan;0;0
32691;207504;123;75;29;2;27;.931;3900000;0
32691;218853;119;0;0;0;0;.00nan;0;0
32692;213692;112;0;0;0;0;.00nan;0;0
32692;208620;112;54;26;3;23;.885;3600000;0
32692;203412;117;0;0;0;0;.00nan;0;0
32692;213504;117;25;27;6;21;.778;3600000;0
32693;213845;113;0;0;0;0;.00nan;0;0
32693;210765;113;71;26;2;24;.923;3552000;0
32693;207535;108;91;36;1;35;.972;3600000;0
32693;-1;108;0;0;0;0;.00nan;0;0
32694;220341;116;0;0;0;0;.00nan;0;0
32694;205469;122;0;0;0;0;.00nan;0;0
32694;216028;116;41;33;5;28;.848;3585000;0
32694;212681;122;65;33;4;29;.879;3600000;0
32695;208652;124;0;0;0;0;.00nan;0;0
32695;221211;109;63;26;2;24;.923;3600000;0
32695;206731;124;68;38;4;34;.895;3600000;0
32695;217277;109;0;0;0;0;.00nan;0;0
32696;212683;118;0;0;0;0;.00nan;0;0
32696;207424;114;77;39;3;36;.923;3600000;0
32696;212783;114;0;0;0;0;.00nan;0;0
32696;218830;118;46;28;4;24;.857;3564000;0
32697;210773;111;25;6;3;3;.500;549000;0
32697;222436;115;0;0;0;0;.00nan;0;0
32697;207439;115;86;30;2;28;.933;3600000;0
32697;-1;111;25;34;7;27;.794;3051000;0
32698;204618;125;85;45;3;42;.933;3854000;0
32698;207600;120;70;27;2;25;.926;3854000;0
32698;213613;120;0;0;0;0;.00nan;0;0
32698;-1;125;0;0;0;0;.00nan;0;0
32699;213692;112;56;20;3;17;.850;3553000;0
32699;208620;112;0;0;0;0;.00nan;0;0
32699;207535;108;0;0;0;0;.00nan;0;0
32699;-1;108;93;33;2;31;.939;3600000;0
32700;203412;117;23;32;7;25;.781;2686000;0
32700;212683;118;68;33;4;29;.879;3600000;0
32700;213504;117;43;5;1;4;.800;914000;0
32700;218830;118;0;0;0;0;.00nan;0;0
32701;208652;124;81;46;3;43;.935;3553000;0
32701;220301;110;0;0;0;0;.00nan;0;0
32701;215968;110;72;32;2;30;.938;3600000;0
32701;206731;124;0;0;0;0;.00nan;0;0
32702;204894;121;0;0;0;0;.00nan;0;0
32702;212052;127;37;34;6;28;.824;2758000;0
32702;206864;127;38;9;2;7;.778;842000;0
32702;207493;121;46;16;2;14;.875;3600000;0
32703;205469;122;60;49;5;44;.898;3600000;0
32703;212681;122;0;0;0;0;.00nan;0;0
32703;207600;120;0;0;0;0;.00nan;0;0
32703;213613;120;45;21;3;18;.857;3600000;0
32704;204711;119;83;29;1;28;.966;3600000;0
32704;222436;115;48;25;4;21;.840;1919000;0
32704;207439;115;14;18;6;12;.667;1681000;0
32704;218853;119;0;0;0;0;.00nan;0;0
32705;221211;109;0;0;0;0;.00nan;0;0
32705;211935;123;47;28;4;24;.857;3643000;0
32705;217277;109;79;34;3;31;.912;3643000;0
32705;207504;123;0;0;0;0;.00nan;0;0
32706;204618;125;0;0;0;0;.00nan;0;0
32706;207424;114;0;0;0;0;.00nan;0;0
32706;212783;114;76;35;3;32;.914;3600000;0
32706;-1;125;54;37;4;33;.892;3600000;0
32707;203412;117;0;0;0;0;.00nan;0;0
32707;210773;111;0;0;0;0;.00nan;0;0
32707;213504;117;59;37;4;33;.892;3600000;0
32707;-1;111;69;22;1;21;.955;3600000;0
32708;213845;113;98;24;0;24;1.000;3600000;0
32708;204711;119;60;11;1;10;.909;1336000;0
32708;210765;113;0;0;0;0;.00nan;0;0
32708;218853;119;12;28;7;21;.750;2264000;0
32709;220341;116;0;0;0;0;.00nan;0;0
32709;216028;116;62;24;3;21;.875;3600000;0
32709;212052;127;0;0;0;0;.00nan;0;0
32709;206864;127;69;43;4;39;.907;3600000;0
32710;221235;126;0;0;0;0;.00nan;0;0
32710;212039;126;71;28;2;26;.929;3600000;0
32710;207600;120;59;27;3;24;.889;3576000;0
32710;213613;120;0;0;0;0;.00nan;0;0
32711;220301;110;0;0;0;0;.00nan;0;0
32711;215968;110;72;39;4;35;.897;3600000;0
32711;211935;123;0;0;0;0;.00nan;0;0
32711;207504;123;35;38;6;32;.842;3574000;0
32712;208652;124;80;37;3;34;.919;3596000;0
32712;205469;122;0;0;0;0;.00nan;0;0
32712;206731;124;0;0;0;0;.00nan;0;0
32712;212681;122;79;30;2;28;.933;3600000;0
32713;204894;121;0;0;0;0;.00nan;0;0
32713;207424;114;39;40;6;34;.850;3729000;0
32713;207493;121;33;20;5;15;.750;3729000;0
32713;212783;114;0;0;0;0;.00nan;0;0
32714;203412;117;35;33;6;27;.818;3600000;0
32714;222436;115;0;0;0;0;.00nan;0;0
32714;207439;115;17;32;7;25;.781;3581000;0
32714;213504;117;0;0;0;0;.00nan;0;0
32715;221235;126;48;0;0;0;.00nan;395000;0
32715;212039;126;30;28;6;22;.786;3205000;0
32715;212683;118;0;0;0;0;.00nan;0;0
32715;218830;118;76;26;1;25;.962;3600000;0
32716;210785;123;49;32;5;27;.844;3600000;0
32716;212052;127;70;30;3;27;.900;3600000;0
32716;206864;127;0;0;0;0;.00nan;0;0
32716;207504;123;0;0;0;0;.00nan;0;0
32717;213845;113;42;25;4;21;.840;3600000;0
32717;203412;117;0;0;0;0;.00nan;0;0
32717;210765;113;0;0;0;0;.00nan;0;0
32717;213504;117;44;36;5;31;.861;3598000;0
32718;220341;116;0;0;0;0;.00nan;0;0
32718;216028;116;66;22;2;20;.909;3600000;0
32718;207424;114;65;34;3;31;.912;3577000;0
32718;212783;114;0;0;0;0;.00nan;0;0
32719;213692;112;0;0;0;0;.00nan;0;0
32719;208620;112;66;25;2;23;.920;3600000;0
32719;204630;109;86;49;4;45;.918;3535000;0
32719;221211;109;0;0;0;0;.00nan;0;0
32720;210773;111;0;0;0;0;.00nan;0;0
32720;207535;108;0;0;0;0;.00nan;0;0
32720;-1;111;53;32;5;27;.844;3584000;0
32720;-1;108;76;28;2;26;.929;3600000;0
32721;213692;112;90;29;2;27;.931;3600000;0
32721;208620;112;0;0;0;0;.00nan;0;0
32721;220301;110;0;0;0;0;.00nan;0;0
32721;215968;110;21;21;6;15;.714;3600000;0
32722;208652;124;55;22;2;20;.909;3045000;0
32722;220341;116;96;25;0;25;1.000;3600000;0
32722;216028;116;0;0;0;0;.00nan;0;0
32722;206731;124;33;9;3;6;.667;555000;0
32723;204711;119;64;33;3;30;.909;3600000;0
32723;204894;121;0;0;0;0;.00nan;0;0
32723;207493;121;53;37;5;32;.865;3567000;0
32723;218853;119;0;0;0;0;.00nan;0;0
32724;210785;123;43;33;5;28;.848;3600000;0
32724;212683;118;84;26;1;25;.962;3600000;0
32724;207504;123;0;0;0;0;.00nan;0;0
32724;218830;118;0;0;0;0;.00nan;0;0
32725;221235;126;0;0;0;0;.00nan;0;0
32725;212039;126;60;34;4;30;.882;3585000;0
32725;222436;115;0;0;0;0;.00nan;0;0
32725;207439;115;88;39;2;37;.949;3600000;0
32726;204618;125;87;54;3;51;.944;3900000;0
32726;207600;120;66;33;3;30;.909;3900000;0
32726;213613;120;0;0;0;0;.00nan;0;0
32726;-1;125;0;0;0;0;.00nan;0;0
32727;205469;122;53;31;4;27;.871;3537000;0
32727;212681;122;0;0;0;0;.00nan;0;0
32727;207535;108;60;20;2;18;.900;3600000;0
32727;-1;108;0;0;0;0;.00nan;0;0
32728;208652;124;53;16;2;14;.875;1648000;0
32728;204894;121;83;26;2;24;.923;3600000;0
32728;206731;124;50;24;4;20;.833;1952000;0
32728;207493;121;0;0;0;0;.00nan;0;0
32729;220301;110;53;34;6;28;.824;3600000;0
32729;204630;109;85;44;3;41;.932;3600000;0
32729;221211;109;0;0;0;0;.00nan;0;0
32729;215968;110;0;0;0;0;.00nan;0;0
32730;212052;127;0;0;0;0;.00nan;0;0
32730;206864;127;66;24;2;22;.917;3600000;0
32730;222436;115;74;39;4;35;.897;3513000;0
32730;207439;115;0;0;0;0;.00nan;0;0
32731;210785;123;79;43;3;40;.930;3900000;0
32731;207504;123;0;0;0;0;.00nan;0;0
32731;207600;120;0;0;0;0;.00nan;0;0
32731;213613;120;65;36;3;33;.917;3900000;0
32732;213845;113;77;31;2;29;.935;3600000;0
32732;204618;125;0;0;0;0;.00nan;0;0
32732;210765;113;0;0;0;0;.00nan;0;0
32732;-1;125;34;32;6;26;.813;3600000;0
32733;210773;111;60;23;2;21;.913;3600000;0
32733;207424;114;39;33;5;28;.848;3600000;0
32733;212783;114;0;0;0;0;.00nan;0;0
32733;-1;111;0;0;0;0;.00nan;0;0
32734;203412;117;63;23;2;21;.913;3533000;0
32734;221235;126;0;0;0;0;.00nan;0;0
32734;212039;126;100;33;0;33;1.000;3600000;0
32734;213504;117;0;0;0;0;.00nan;0;0
32735;204711;119;56;20;3;17;.850;3695000;0
32735;207535;108;0;0;0;0;.00nan;0;0
32735;-1;108;69;23;2;21;.913;3661000;0
32735;218853;119;0;0;0;0;.00nan;0;0
32736;205469;122;56;34;5;29;.853;3600000;0
32736;212681;122;0;0;0;0;.00nan;0;0
32736;212683;118;0;0;0;0;.00nan;0;0
32736;218830;118;75;23;1;22;.957;3600000;0
32737;213692;112;0;0;0;0;.00nan;0;0
32737;208620;112;67;24;2;22;.917;3600000;0
32737;220301;110;0;0;0;0;.00nan;0;0
32737;215968;110;58;42;5;37;.881;3600000;0
32738;204894;121;0;0;0;0;.00nan;0;0
32738;221235;126;0;0;0;0;.00nan;0;0
32738;212039;126;54;40;5;35;.875;3900000;0
32738;207493;121;34;25;5;20;.800;3896000;0
32739;204711;119;12;19;6;13;.684;2069000;0
32739;207600;120;0;0;0;0;.00nan;0;0
32739;213613;120;41;23;4;19;.826;3600000;0
32739;218853;119;43;17;3;14;.824;1531000;0
32740;220301;110;0;0;0;0;.00nan;0;0
32740;210773;111;0;0;0;0;.00nan;0;0
32740;215968;110;77;29;2;27;.931;3543000;0
32740;-1;111;65;13;1;12;.923;3600000;0
32741;222436;115;0;0;0;0;.00nan;0;0
32741;207424;114;40;21;4;17;.810;3600000;0
32741;207439;115;54;38;5;33;.868;3546000;0
32741;212783;114;0;0;0;0;.00nan;0;0
32742;213845;113;30;28;6;22;.786;3186000;0
32742;204894;121;0;0;0;0;.00nan;0;0
32742;210765;113;52;3;0;3;1.000;381000;0
32742;207493;121;51;39;5;34;.872;3600000;0
32743;203412;117;0;0;0;0;.00nan;0;0
32743;220341;116;59;26;3;23;.885;3600000;0
32743;216028;116;0;0;0;0;.00nan;0;0
32743;213504;117;61;44;5;39;.886;3579000;0
32744;204630;109;55;34;4;30;.882;3600000;0
32744;205469;122;97;33;1;32;.970;3600000;0
32744;221211;109;0;0;0;0;.00nan;0;0
32744;212681;122;0;0;0;0;.00nan;0;0
32745;204618;125;0;0;0;0;.00nan;0;0
32745;212052;127;0;0;0;0;.00nan;0;0
32745;206864;127;49;25;4;21;.840;3600000;0
32745;-1;125;11;26;7;19;.731;3600000;0
32746;213692;112;34;21;5;16;.762;3535000;0
32746;208620;112;0;0;0;0;.00nan;0;0
32746;205469;122;0;0;0;0;.00nan;0;0
32746;212681;122;77;39;3;36;.923;3600000;0
32747;210785;123;72;43;4;39;.907;3530000;0
32747;207504;123;0;0;0;0;.00nan;0;0
32747;207535;108;0;0;0;0;.00nan;0;0
32747;-1;108;53;16;2;14;.875;3600000;0
32748;213845;113;0;0;0;0;.00nan;0;0
32748;203412;117;96;33;1;32;.970;3600000;0
32748;210765;113;77;37;2;35;.946;3560000;0
32748;213504;117;0;0;0;0;.00nan;0;0
32749;204711;119;0;0;0;0;.00nan;0;0
32749;212683;118;0;0;0;0;.00nan;0;0
32749;218830;118;23;19;5;14;.737;3600000;0
32749;218853;119;77;32;2;30;.938;3600000;0
32750;204894;121;89;30;1;29;.967;3600000;0
32750;222436;115;51;34;5;29;.853;3600000;0
32750;207439;115;0;0;0;0;.00nan;0;0
32750;207493;121;0;0;0;0;.00nan;0;0
32751;204618;125;71;31;3;28;.903;3529000;0
32751;221235;126;0;0;0;0;.00nan;0;0
32751;212039;126;69;21;1;20;.952;3600000;0
32751;-1;125;0;0;0;0;.00nan;0;0
32752;208652;124;23;21;6;15;.714;2304000;0
32752;206731;124;60;19;2;17;.895;1296000;0
32752;207600;120;84;39;2;37;.949;3600000;0
32752;213613;120;0;0;0;0;.00nan;0;0
32753;220301;110;0;0;0;0;.00nan;0;0
32753;204630;109;64;38;5;33;.868;3600000;0
32753;221211;109;0;0;0;0;.00nan;0;0
32753;215968;110;90;32;2;30;.938;3600000;0
32754;210773;111;0;0;0;0;.00nan;0;0
32754;212052;127;62;44;4;40;.909;3900000;0
32754;206864;127;0;0;0;0;.00nan;0;0
32754;-1;111;58;32;4;28;.875;3900000;0
32755;204711;119;88;32;1;31;.969;3600000;0
32755;212683;118;53;31;4;27;.871;3600000;0
32755;218830;118;0;0;0;0;.00nan;0;0
32755;218853;119;0;0;0;0;.00nan;0;0
32756;208652;124;80;29;1;28;.966;3600000;0
32756;221235;126;0;0;0;0;.00nan;0;0
32756;206731;124;0;0;0;0;.00nan;0;0
32756;212039;126;58;45;5;40;.889;3600000;0
32757;204630;109;71;28;2;26;.929;3600000;0
32757;210785;123;38;12;3;9;.750;542000;0
32757;221211;109;0;0;0;0;.00nan;0;0
32757;207504;123;64;26;2;24;.923;3058000;0
32758;220341;116;0;0;0;0;.00nan;0;0
32758;216028;116;54;30;4;26;.867;3521000;0
32758;207424;114;56;18;2;16;.889;3600000;0
32758;212783;114;0;0;0;0;.00nan;0;0
32759;213692;112;0;0;0;0;.00nan;0;0
32759;208620;112;45;27;4;23;.852;3893000;0
32759;210785;123;70;35;4;31;.886;3900000;0
32759;207504;123;0;0;0;0;.00nan;0;0
32760;205469;122;30;10;3;7;.700;462000;0
32760;212681;122;62;31;3;28;.903;3138000;0
32760;207535;108;66;22;2;20;.909;3600000;0
32760;-1;108;0;0;0;0;.00nan;0;0
32761;203412;117;45;25;4;21;.840;1039000;0
32761;210773;111;60;31;3;28;.903;3600000;0
32761;213504;117;44;25;4;21;.840;2561000;0
32761;-1;111;0;0;0;0;.00nan;0;0
32762;213845;113;71;18;1;17;.944;3600000;0
32762;220341;116;45;37;5;32;.865;3600000;0
32762;210765;113;0;0;0;0;.00nan;0;0
32762;216028;116;0;0;0;0;.00nan;0;0
32763;222436;115;0;0;0;0;.00nan;0;0
32763;207424;114;73;23;1;22;.957;3600000;0
32763;207439;115;45;30;4;26;.867;3600000;0
32763;212783;114;0;0;0;0;.00nan;0;0
32764;204618;125;77;44;4;40;.909;3600000;0
32764;204894;121;0;0;0;0;.00nan;0;0
32764;207493;121;71;24;2;22;.917;3600000;0
32764;-1;125;0;0;0;0;.00nan;0;0
32765;220301;110;0;0;0;0;.00nan;0;0
32765;215968;110;52;15;2;13;.867;3600000;0
32765;212052;127;57;13;1;12;.923;471000;0
32765;206864;127;41;36;6;30;.833;3129000;0
32766;205469;122;72;46;4;42;.913;3600000;0
32766;212681;122;0;0;0;0;.00nan;0;0
32766;207424;114;70;28;2;26;.929;3600000;0
32766;212783;114;0;0;0;0;.00nan;0;0
32767;213845;113;25;32;6;26;.813;3110000;0
32767;210765;113;48;1;0;1;1.000;790000;0
32767;222436;115;63;21;2;19;.905;2981000;0
32767;207439;115;30;13;4;9;.692;919000;0
32768;220341;116;0;0;0;0;.00nan;0;0
32768;210773;111;0;0;0;0;.00nan;0;0
32768;216028;116;99;38;1;37;.974;3600000;0
32768;-1;111;57;36;5;31;.861;3600000;0
32769;204630;109;92;45;2;43;.956;3848000;0
32769;221211;109;0;0;0;0;.00nan;0;0
32769;207535;108;0;0;0;0;.00nan;0;0
32769;-1;108;62;18;1;17;.944;3848000;0
32770;210785;123;76;30;2;28;.933;3600000;0
32770;212052;127;41;34;6;28;.824;3600000;0
32770;206864;127;0;0;0;0;.00nan;0;0
32770;207504;123;0;0;0;0;.00nan;0;0
32771;213692;112;78;44;4;40;.909;3600000;0
32771;208620;112;0;0;0;0;.00nan;0;0
32771;220341;116;34;25;5;20;.800;3600000;0
32771;216028;116;0;0;0;0;.00nan;0;0
32772;203412;117;0;0;0;0;.00nan;0;0
32772;208652;124;0;0;0;0;.00nan;0;0
32772;206731;124;62;25;3;22;.880;3600000;0
32772;213504;117;26;15;4;11;.733;3588000;0
32773;204630;109;88;41;3;38;.927;3600000;0
32773;221211;109;0;0;0;0;.00nan;0;0
32773;212683;118;0;0;0;0;.00nan;0;0
32773;218830;118;75;26;2;24;.923;3600000;0
32774;213845;113;0;0;0;0;.00nan;0;0
32774;210765;113;40;30;5;25;.833;3547000;0
32774;222436;115;0;0;0;0;.00nan;0;0
32774;207439;115;47;26;4;22;.846;3600000;0
32775;204618;125;84;37;2;35;.946;3900000;0
32775;204711;119;67;24;2;22;.917;3900000;0
32775;-1;125;0;0;0;0;.00nan;0;0
32775;218853;119;0;0;0;0;.00nan;0;0
32776;221235;126;0;0;0;0;.00nan;0;0
32776;212039;126;69;40;4;36;.900;3583000;0
32776;207600;120;66;30;3;27;.900;3600000;0
32776;213613;120;0;0;0;0;.00nan;0;0
32777;220301;110;0;0;0;0;.00nan;0;0
32777;204894;121;0;0;0;0;.00nan;0;0
32777;215968;110;59;49;6;43;.878;3559000;0
32777;207493;121;35;23;5;18;.783;3600000;0
32778;220341;116;0;0;0;0;.00nan;0;0
32778;216028;116;85;36;3;33;.917;3900000;0
32778;207535;108;0;0;0;0;.00nan;0;0
32778;-1;108;62;25;3;22;.880;3900000;0
32779;213692;112;0;0;0;0;.00nan;0;0
32779;208620;112;79;43;3;40;.930;3599000;0
32779;210773;111;0;0;0;0;.00nan;0;0
32779;-1;111;74;30;2;28;.933;3600000;0
32780;204894;121;57;30;4;26;.867;3600000;0
32780;212683;118;61;14;1;13;.929;3600000;0
32780;207493;121;0;0;0;0;.00nan;0;0
32780;218830;118;0;0;0;0;.00nan;0;0
32781;208652;124;71;28;2;26;.929;3600000;0
32781;205469;122;0;0;0;0;.00nan;0;0
32781;206731;124;0;0;0;0;.00nan;0;0
32781;212681;122;52;43;6;37;.860;3600000;0
32782;204630;109;96;27;1;26;.963;3600000;0
32782;221211;109;0;0;0;0;.00nan;0;0
32782;212052;127;0;0;0;0;.00nan;0;0
32782;206864;127;74;31;2;29;.935;3564000;0
32783;204711;119;0;0;0;0;.00nan;0;0
32783;210785;123;46;33;5;28;.848;3600000;0
32783;207504;123;0;0;0;0;.00nan;0;0
32783;218853;119;63;33;3;30;.909;3600000;0
32784;220301;110;0;0;0;0;.00nan;0;0
32784;215968;110;50;28;4;24;.857;3900000;0
32784;207424;114;58;33;4;29;.879;3900000;0
32784;212783;114;0;0;0;0;.00nan;0;0
32785;203412;117;0;0;0;0;.00nan;0;0
32785;210773;111;85;31;1;30;.968;3600000;0
32785;213504;117;82;28;2;26;.929;3579000;0
32785;-1;111;0;0;0;0;.00nan;0;0
32786;213845;113;49;39;5;34;.872;3900000;0
32786;210765;113;0;0;0;0;.00nan;0;0
32786;207424;114;62;43;5;38;.884;3900000;0
32786;212783;114;0;0;0;0;.00nan;0;0
32787;205469;122;39;28;5;23;.821;3546000;0
32787;212681;122;0;0;0;0;.00nan;0;0
32787;207600;120;60;38;4;34;.895;3600000;0
32787;213613;120;0;0;0;0;.00nan;0;0
32788;204618;125;28;15;4;11;.733;907000;0
32788;221235;126;0;0;0;0;.00nan;0;0
32788;212039;126;91;34;2;32;.941;3600000;0
32788;-1;125;75;21;1;20;.952;2693000;0
32789;210785;123;0;0;0;0;.00nan;0;0
32789;212052;127;97;55;3;52;.945;3582000;0
32789;206864;127;0;0;0;0;.00nan;0;0
32789;207504;123;66;15;1;14;.933;3600000;0
32790;220301;110;25;25;6;19;.760;3025000;0
32790;215968;110;62;10;0;10;1.000;575000;0
32790;207535;108;59;31;3;28;.903;3600000;0
32790;-1;108;0;0;0;0;.00nan;0;0
32791;204711;119;43;26;4;22;.846;3578000;0
32791;212683;118;88;31;2;29;.935;3600000;0
32791;218830;118;0;0;0;0;.00nan;0;0
32791;218853;119;0;0;0;0;.00nan;0;0
32792;205469;122;43;23;4;19;.826;3090000;0
32792;212681;122;33;13;3;10;.769;464000;0
32792;207424;114;34;17;4;13;.765;2120000;0
32792;212783;114;45;14;2;12;.857;1480000;0
32793;204618;125;47;31;4;27;.871;3545000;0
32793;210785;123;69;33;3;30;.909;3600000;0
32793;207504;123;0;0;0;0;.00nan;0;0
32793;-1;125;0;0;0;0;.00nan;0;0
32794;204894;121;0;0;0;0;.00nan;0;0
32794;207493;121;56;22;3;19;.864;3600000;0
32794;207600;120;45;30;5;25;.833;3600000;0
32794;213613;120;0;0;0;0;.00nan;0;0
32795;213845;113;52;25;4;21;.840;3900000;0
32795;203412;117;0;0;0;0;.00nan;0;0
32795;210765;113;0;0;0;0;.00nan;0;0
32795;213504;117;82;48;4;44;.917;3900000;0
32796;220341;116;0;0;0;0;.00nan;0;0
32796;216028;116;100;25;0;25;1.000;3600000;0
32796;222436;115;0;0;0;0;.00nan;0;0
32796;207439;115;72;44;4;40;.909;3600000;0
32797;220301;110;0;0;0;0;.00nan;0;0
32797;204630;109;92;39;2;37;.949;3600000;0
32797;221211;109;0;0;0;0;.00nan;0;0
32797;215968;110;60;32;3;29;.906;3600000;0
32798;221235;126;0;0;0;0;.00nan;0;0
32798;212039;126;59;17;2;15;.882;3600000;0
32798;212052;127;41;16;3;13;.813;1231000;0
32798;206864;127;31;16;4;12;.750;2369000;0
32799;210773;111;0;0;0;0;.00nan;0;0
32799;222436;115;67;20;1;19;.950;3600000;0
32799;207439;115;0;0;0;0;.00nan;0;0
32799;-1;111;78;33;2;31;.939;3546000;0
32800;213692;112;0;0;0;0;.00nan;0;0
32800;208620;112;47;29;5;24;.828;3600000;0
32800;220301;110;87;30;1;29;.967;3600000;0
32800;215968;110;0;0;0;0;.00nan;0;0
32801;208652;124;38;34;5;29;.853;2694000;0
32801;206731;124;21;10;4;6;.600;906000;0
32801;207424;114;55;26;4;22;.846;3600000;0
32801;212783;114;0;0;0;0;.00nan;0;0
32802;204711;119;0;0;0;0;.00nan;0;0
32802;207600;120;0;0;0;0;.00nan;0;0
32802;213613;120;63;33;3;30;.909;3600000;0
32802;218853;119;67;36;4;32;.889;3600000;0
32803;204894;121;89;30;1;29;.967;3600000;0
32803;212683;118;0;0;0;0;.00nan;0;0
32803;207493;121;0;0;0;0;.00nan;0;0
32803;218830;118;67;31;2;29;.935;3545000;0
32804;221235;126;54;4;0;4;1.000;1102000;0
32804;212039;126;43;36;6;30;.833;2452000;0
32804;207535;108;0;0;0;0;.00nan;0;0
32804;-1;108;39;21;4;17;.810;3600000;0
32805;203412;117;77;23;1;22;.957;3600000;0
32805;204618;125;44;22;3;19;.864;2407000;0
32805;213504;117;0;0;0;0;.00nan;0;0
32805;-1;125;27;16;4;12;.750;1193000;0
32806;213845;113;76;33;3;30;.909;3600000;0
32806;210765;113;0;0;0;0;.00nan;0;0
32806;210773;111;22;31;6;25;.806;3322000;0
32806;-1;111;48;6;1;5;.833;278000;0
32807;208652;124;0;0;0;0;.00nan;0;0
32807;206731;124;82;29;2;27;.931;3600000;0
32807;207535;108;61;42;4;38;.905;3513000;0
32807;-1;108;0;0;0;0;.00nan;0;0
32808;204711;119;63;29;3;26;.897;3600000;0
32808;204894;121;0;0;0;0;.00nan;0;0
32808;207493;121;60;20;2;18;.900;3600000;0
32808;218853;119;0;0;0;0;.00nan;0;0
32809;205469;122;77;48;4;44;.917;3576000;0
32809;212681;122;0;0;0;0;.00nan;0;0
32809;212683;118;72;30;3;27;.900;3600000;0
32809;218830;118;0;0;0;0;.00nan;0;0
32810;204630;109;83;33;2;31;.939;3600000;0
32810;220341;116;0;0;0;0;.00nan;0;0
32810;221211;109;0;0;0;0;.00nan;0;0
32810;216028;116;47;24;4;20;.833;3522000;0
32811;210785;123;56;33;4;29;.879;3600000;0
32811;207424;114;0;0;0;0;.00nan;0;0
32811;207504;123;0;0;0;0;.00nan;0;0
32811;212783;114;32;31;5;26;.839;3565000;0
32812;213692;112;0;0;0;0;.00nan;0;0
32812;208620;112;41;15;3;12;.800;3600000;0
32812;204630;109;39;37;6;31;.838;2596000;0
32812;221211;109;55;12;1;11;.917;1004000;0
32813;203412;117;75;28;2;26;.929;3600000;0
32813;222436;115;0;0;0;0;.00nan;0;0
32813;207439;115;51;27;4;23;.852;3564000;0
32813;213504;117;0;0;0;0;.00nan;0;0
32814;213845;113;0;0;0;0;.00nan;0;0
32814;220341;116;0;0;0;0;.00nan;0;0
32814;210765;113;88;30;1;29;.967;3600000;0
32814;216028;116;77;32;2;30;.938;3557000;0
32815;212683;118;0;0;0;0;.00nan;0;0
32815;207600;120;66;35;3;32;.914;3565000;0
32815;213613;120;0;0;0;0;.00nan;0;0
32815;218830;118;72;24;2;22;.917;3600000;0
32816;210785;123;44;33;5;28;.848;3600000;0
32816;207504;123;0;0;0;0;.00nan;0;0
32816;207535;108;0;0;0;0;.00nan;0;0
32816;-1;108;82;13;0;13;1.000;3600000;0
32817;220301;110;0;0;0;0;.00nan;0;0
32817;210773;111;0;0;0;0;.00nan;0;0
32817;215968;110;26;21;5;16;.762;3548000;0
32817;-1;111;58;36;4;32;.889;3600000;0
32818;221235;126;0;0;0;0;.00nan;0;0
32818;212039;126;65;24;3;21;.875;3531000;0
32818;212052;127;96;32;1;31;.969;3600000;0
32818;206864;127;0;0;0;0;.00nan;0;0
32819;213692;112;0;0;0;0;.00nan;0;0
32819;208620;112;71;15;1;14;.933;3600000;0
32819;220301;110;0;0;0;0;.00nan;0;0
32819;215968;110;72;41;4;37;.902;3600000;0
32820;208652;124;66;48;6;42;.875;3308000;0
32820;206731;124;54;5;0;5;1.000;271000;0
32820;212683;118;35;24;5;19;.792;3600000;0
32820;218830;118;0;0;0;0;.00nan;0;0
32821;205469;122;18;23;6;17;.739;3116000;0
32821;221235;126;0;0;0;0;.00nan;0;0
32821;212039;126;65;34;4;30;.882;3600000;0
32821;212681;122;53;3;0;3;1.000;472000;0
32822;204618;125;84;51;4;47;.922;3600000;0
32822;222436;115;0;0;0;0;.00nan;0;0
32822;207439;115;31;28;5;23;.821;3577000;0
32822;-1;125;0;0;0;0;.00nan;0;0
32823;213845;113;76;39;3;36;.923;3900000;0
32823;220341;116;0;0;0;0;.00nan;0;0
32823;210765;113;0;0;0;0;.00nan;0;0
32823;216028;116;69;32;3;29;.906;3900000;0
32824;203412;117;37;38;6;32;.842;3515000;0
32824;204630;109;48;20;4;16;.800;3600000;0
32824;221211;109;0;0;0;0;.00nan;0;0
32824;213504;117;0;0;0;0;.00nan;0;0
32825;204894;121;0;0;0;0;.00nan;0;0
32825;212052;127;43;14;3;11;.786;1483000;0
32825;206864;127;29;33;6;27;.818;2117000;0
32825;207493;121;71;24;1;23;.958;3600000;0
32826;213692;112;74;50;5;45;.900;3600000;0
32826;208620;112;0;0;0;0;.00nan;0;0
32826;204711;119;100;20;0;20;1.000;3600000;0
32826;218853;119;0;0;0;0;.00nan;0;0
32827;204630;109;82;42;3;39;.929;3561000;0
32827;221211;109;0;0;0;0;.00nan;0;0
32827;207535;108;0;0;0;0;.00nan;0;0
32827;-1;108;63;20;2;18;.900;3600000;0
32828;203412;117;0;0;0;0;.00nan;0;0
32828;207424;114;52;30;4;26;.867;3600000;0
32828;212783;114;0;0;0;0;.00nan;0;0
32828;213504;117;92;36;1;35;.972;3600000;0
32829;212052;127;56;40;5;35;.875;3600000;0
32829;206864;127;0;0;0;0;.00nan;0;0
32829;212683;118;0;0;0;0;.00nan;0;0
32829;218830;118;70;23;2;21;.913;3600000;0
32830;220341;116;0;0;0;0;.00nan;0;0
32830;216028;116;55;25;4;21;.840;3600000;0
32830;222436;115;0;0;0;0;.00nan;0;0
32830;207439;115;78;27;1;26;.963;3600000;0
32831;204894;121;40;27;4;23;.852;3524000;0
32831;221235;126;0;0;0;0;.00nan;0;0
32831;212039;126;76;30;2;28;.933;3600000;0
32831;207493;121;0;0;0;0;.00nan;0;0
32832;205469;122;41;26;5;21;.808;3600000;0
32832;210785;123;99;45;2;43;.956;3600000;0
32832;212681;122;0;0;0;0;.00nan;0;0
32832;207504;123;0;0;0;0;.00nan;0;0
32833;210773;111;0;0;0;0;.00nan;0;0
32833;207600;120;42;36;6;30;.833;3600000;0
32833;-1;111;80;35;2;33;.943;3600000;0
32833;213613;120;0;0;0;0;.00nan;0;0
32834;208652;124;0;0;0;0;.00nan;0;0
32834;220301;110;0;0;0;0;.00nan;0;0
32834;215968;110;56;37;4;33;.892;3789000;0
32834;206731;124;60;30;3;27;.900;3789000;0
32835;204711;119;59;35;5;30;.857;3536000;0
32835;207535;108;55;27;4;23;.852;3600000;0
32835;-1;108;0;0;0;0;.00nan;0;0
32835;218853;119;0;0;0;0;.00nan;0;0
32836;208652;124;72;31;2;29;.935;3600000;0
32836;210773;111;52;29;4;25;.862;3600000;0
32836;206731;124;0;0;0;0;.00nan;0;0
32836;-1;111;0;0;0;0;.00nan;0;0
32837;221235;126;0;0;0;0;.00nan;0;0
32837;212039;126;91;34;1;33;.971;3600000;0
32837;207600;120;68;10;0;10;1.000;1634000;0
32837;213613;120;36;22;4;18;.818;1966000;0
32838;205469;122;0;0;0;0;.00nan;0;0
32838;212052;127;0;0;0;0;.00nan;0;0
32838;206864;127;100;46;1;45;.978;3600000;0
32838;212681;122;40;16;3;13;.813;3515000;0
32839;204894;121;0;0;0;0;.00nan;0;0
32839;210785;123;51;30;4;26;.867;2110000;0
32839;207493;121;45;27;5;22;.815;3600000;0
32839;207504;123;64;22;2;20;.909;1476000;0
32840;204618;125;36;16;4;12;.750;1166000;0
32840;220341;116;0;0;0;0;.00nan;0;0
32840;216028;116;73;30;4;26;.867;3600000;0
32840;-1;125;54;16;1;15;.938;2399000;0
32841;213692;112;0;0;0;0;.00nan;0;0
32841;208620;112;84;35;2;33;.943;3600000;0
32841;207424;114;0;0;0;0;.00nan;0;0
32841;212783;114;47;23;3;20;.870;3550000;0
32842;204630;109;49;32;4;28;.875;3560000;0
32842;210773;111;0;0;0;0;.00nan;0;0
32842;221211;109;0;0;0;0;.00nan;0;0
32842;-1;111;57;28;3;25;.893;3600000;0
32843;203412;117;41;19;4;15;.789;3600000;0
32843;222436;115;63;42;5;37;.881;3000000;0
32843;207439;115;27;7;3;4;.571;600000;0
32843;213504;117;0;0;0;0;.00nan;0;0
32844;220301;110;65;36;3;33;.917;2818000;0
32844;215968;110;33;18;4;14;.778;782000;0
32844;212683;118;68;18;2;16;.889;3600000;0
32844;218830;118;0;0;0;0;.00nan;0;0
32845;204618;125;47;31;5;26;.839;3545000;0
32845;210785;123;67;34;4;30;.882;3600000;0
32845;207504;123;0;0;0;0;.00nan;0;0
32845;-1;125;0;0;0;0;.00nan;0;0
32846;213692;112;0;0;0;0;.00nan;0;0
32846;213845;113;73;26;2;24;.923;3900000;0
32846;208620;112;100;42;2;40;.952;3900000;0
32846;210765;113;0;0;0;0;.00nan;0;0
32847;204711;119;91;38;2;36;.947;3600000;0
32847;207600;120;51;28;3;25;.893;3558000;0
32847;213613;120;0;0;0;0;.00nan;0;0
32847;218853;119;0;0;0;0;.00nan;0;0
32848;220301;110;0;0;0;0;.00nan;0;0
32848;205469;122;0;0;0;0;.00nan;0;0
32848;215968;110;88;45;3;42;.933;3547000;0
32848;212681;122;86;25;1;24;.960;3600000;0
32849;213692;112;0;0;0;0;.00nan;0;0
32849;208620;112;99;34;2;32;.941;3900000;0
32849;207535;108;0;0;0;0;.00nan;0;0
32849;-1;108;71;30;2;28;.933;3900000;0
32850;208652;124;53;21;3;18;.857;3900000;0
32850;221235;126;0;0;0;0;.00nan;0;0
32850;206731;124;0;0;0;0;.00nan;0;0
32850;212039;126;83;37;3;34;.919;3900000;0
32851;220341;116;0;0;0;0;.00nan;0;0
32851;204894;121;0;0;0;0;.00nan;0;0
32851;216028;116;63;35;4;31;.886;3582000;0
32851;207493;121;59;25;3;22;.880;3600000;0
32852;210773;111;0;0;0;0;.00nan;0;0
32852;212052;127;27;14;4;10;.714;689000;0
32852;206864;127;85;35;2;33;.943;2911000;0
32852;-1;111;49;12;2;10;.833;3600000;0
32853;204618;125;0;0;0;0;.00nan;0;0
32853;222436;115;0;0;0;0;.00nan;0;0
32853;207439;115;100;27;0;27;1.000;3600000;0
32853;-1;125;82;45;3;42;.933;3600000;0
32854;210785;123;49;30;4;26;.867;3564000;0
32854;207424;114;58;28;3;25;.893;3600000;0
32854;207504;123;0;0;0;0;.00nan;0;0
32854;212783;114;0;0;0;0;.00nan;0;0
32855;204630;109;40;39;6;33;.846;3195000;0
32855;221211;109;52;2;0;2;1.000;405000;0
32855;207600;120;73;26;2;24;.923;3600000;0
32855;213613;120;0;0;0;0;.00nan;0;0
32856;205469;122;0;0;0;0;.00nan;0;0
32856;210773;111;45;4;1;3;.750;1000000;0
32856;212681;122;44;26;4;22;.846;3600000;0
32856;-1;111;22;23;6;17;.739;2600000;0
32857;213692;112;79;35;3;32;.914;3600000;0
32857;208620;112;0;0;0;0;.00nan;0;0
32857;204630;109;56;30;4;26;.867;3600000;0
32857;221211;109;0;0;0;0;.00nan;0;0
32858;213845;113;58;27;3;24;.889;3600000;0
32858;210765;113;0;0;0;0;.00nan;0;0
32858;207535;108;0;0;0;0;.00nan;0;0
32858;-1;108;43;27;4;23;.852;3559000;0
32859;220301;110;0;0;0;0;.00nan;0;0
32859;220341;116;0;0;0;0;.00nan;0;0
32859;215968;110;70;43;5;38;.884;3600000;0
32859;216028;116;66;24;2;22;.917;3600000;0
32860;203412;117;0;0;0;0;.00nan;0;0
32860;204711;119;64;27;3;24;.889;3900000;0
32860;213504;117;48;30;3;27;.900;3900000;0
32860;218853;119;0;0;0;0;.00nan;0;0
32861;204618;125;93;50;3;47;.940;3600000;0
32861;212683;118;60;12;1;11;.917;3600000;0
32861;218830;118;0;0;0;0;.00nan;0;0
32861;-1;125;0;0;0;0;.00nan;0;0
32862;210785;123;59;25;3;22;.880;3600000;0
32862;222436;115;0;0;0;0;.00nan;0;0
32862;207439;115;47;28;4;24;.857;3546000;0
32862;207504;123;0;0;0;0;.00nan;0;0
32863;208652;124;59;21;2;19;.905;1597000;0
32863;221235;126;0;0;0;0;.00nan;0;0
32863;206731;124;30;28;6;22;.786;2003000;0
32863;212039;126;61;30;3;27;.900;3600000;0
32864;204894;121;52;11;1;10;.909;1257000;0
32864;207493;121;28;23;6;17;.739;2258000;0
32864;207600;120;0;0;0;0;.00nan;0;0
32864;213613;120;45;30;5;25;.833;3600000;0
32865;213692;112;0;0;0;0;.00nan;0;0
32865;208620;112;80;24;1;23;.958;3600000;0
32865;203412;117;75;40;3;37;.925;3600000;0
32865;213504;117;0;0;0;0;.00nan;0;0
32866;208652;124;79;24;1;23;.958;3600000;0
32866;206731;124;0;0;0;0;.00nan;0;0
32866;212052;127;0;0;0;0;.00nan;0;0
32866;206864;127;98;51;3;48;.941;3600000;0
32867;220301;110;75;48;5;43;.896;3600000;0
32867;204894;121;20;22;6;16;.727;3543000;0
32867;215968;110;0;0;0;0;.00nan;0;0
32867;207493;121;0;0;0;0;.00nan;0;0
32868;205469;122;69;31;3;28;.903;3600000;0
32868;212681;122;0;0;0;0;.00nan;0;0
32868;212683;118;0;0;0;0;.00nan;0;0
32868;218830;118;51;26;4;22;.846;3596000;0
32869;207424;114;65;23;2;21;.913;3600000;0
32869;207535;108;34;31;6;25;.806;3600000;0
32869;212783;114;0;0;0;0;.00nan;0;0
32869;-1;108;0;0;0;0;.00nan;0;0
32870;213845;113;0;0;0;0;.00nan;0;0
32870;210765;113;60;28;3;25;.893;3600000;0
32870;210785;123;17;34;7;27;.794;3175000;0
32870;207504;123;51;2;0;2;1.000;425000;0
32871;220341;116;0;0;0;0;.00nan;0;0
32871;210773;111;61;6;0;6;1.000;392000;0
32871;216028;116;85;35;1;34;.971;3600000;0
32871;-1;111;14;28;8;20;.714;3208000;0
32872;204711;119;73;28;2;26;.929;3600000;0
32872;222436;115;0;0;0;0;.00nan;0;0
32872;207439;115;82;56;3;53;.946;3564000;0
32872;218853;119;0;0;0;0;.00nan;0;0
32873;204618;125;0;0;0;0;.00nan;0;0
32873;212052;127;67;27;2;25;.926;3600000;0
32873;206864;127;0;0;0;0;.00nan;0;0
32873;-1;125;60;23;3;20;.870;3600000;0
32874;204894;121;0;0;0;0;.00nan;0;0
32874;210773;111;75;31;2;29;.935;3851000;0
32874;207493;121;79;26;1;25;.962;3851000;0
32874;-1;111;0;0;0;0;.00nan;0;0
32875;213692;112;0;0;0;0;.00nan;0;0
32875;208620;112;70;32;3;29;.906;3546000;0
32875;207424;114;99;41;2;39;.951;3600000;0
32875;212783;114;0;0;0;0;.00nan;0;0
32876;213845;113;30;32;6;26;.813;3056000;0
32876;210765;113;52;3;0;3;1.000;544000;0
32876;207535;108;70;27;2;25;.926;3600000;0
32876;-1;108;0;0;0;0;.00nan;0;0
32877;203412;117;45;25;4;21;.840;3600000;0
32877;205469;122;0;0;0;0;.00nan;0;0
32877;212681;122;47;35;5;30;.857;3600000;0
32877;213504;117;0;0;0;0;.00nan;0;0
32878;222436;115;92;32;1;31;.969;3600000;0
32878;207439;115;0;0;0;0;.00nan;0;0
32878;207600;120;45;13;2;11;.846;3572000;0
32878;213613;120;0;0;0;0;.00nan;0;0
32879;212052;127;46;6;1;5;.833;429000;0
32879;206864;127;57;53;6;47;.887;3171000;0
32879;212683;118;58;13;1;12;.923;3600000;0
32879;218830;118;0;0;0;0;.00nan;0;0
32880;220301;110;0;0;0;0;.00nan;0;0
32880;220341;116;0;0;0;0;.00nan;0;0
32880;215968;110;61;32;3;29;.906;3600000;0
32880;216028;116;50;30;4;26;.867;3551000;0
32881;204630;109;100;37;1;36;.973;3600000;0
32881;204711;119;0;0;0;0;.00nan;0;0
32881;221211;109;0;0;0;0;.00nan;0;0
32881;218853;119;81;37;2;35;.946;3550000;0
32882;204618;125;68;58;7;51;.879;3230000;0
32882;221235;126;0;0;0;0;.00nan;0;0
32882;212039;126;49;6;1;5;.833;3600000;0
32882;-1;125;57;8;0;8;1.000;370000;0
32883;205469;122;60;32;4;28;.875;3558000;0
32883;212681;122;0;0;0;0;.00nan;0;0
32883;207424;114;74;33;3;30;.909;3600000;0
32883;212783;114;0;0;0;0;.00nan;0;0
32884;208652;124;0;0;0;0;.00nan;0;0
32884;210785;123;75;40;3;37;.925;3600000;0
32884;206731;124;77;38;4;34;.895;3571000;0
32884;207504;123;0;0;0;0;.00nan;0;0
32885;213692;112;67;47;4;43;.915;3900000;0
32885;208620;112;0;0;0;0;.00nan;0;0
32885;212683;118;34;15;4;11;.733;3900000;0
32885;218830;118;0;0;0;0;.00nan;0;0
32886;220301;110;0;0;0;0;.00nan;0;0
32886;215968;110;28;34;6;28;.824;3600000;0
32886;207535;108;62;30;3;27;.900;3600000;0
32886;-1;108;0;0;0;0;.00nan;0;0
32887;203412;117;57;29;4;25;.862;3544000;0
32887;220341;116;0;0;0;0;.00nan;0;0
32887;216028;116;81;39;3;36;.923;3600000;0
32887;213504;117;0;0;0;0;.00nan;0;0
32888;208652;124;60;32;3;29;.906;3580000;0
32888;210773;111;0;0;0;0;.00nan;0;0
32888;206731;124;0;0;0;0;.00nan;0;0
32888;-1;111;85;41;2;39;.951;3600000;0
32889;204711;119;61;29;3;26;.897;3900000;0
32889;221235;126;0;0;0;0;.00nan;0;0
32889;212039;126;76;36;3;33;.917;3900000;0
32889;218853;119;0;0;0;0;.00nan;0;0
32890;204630;109;57;38;6;32;.842;3518000;0
32890;221211;109;0;0;0;0;.00nan;0;0
32890;222436;115;0;0;0;0;.00nan;0;0
32890;207439;115;51;28;4;24;.857;3600000;0
32891;213845;113;92;22;0;22;1.000;3600000;0
32891;210765;113;0;0;0;0;.00nan;0;0
32891;210785;123;39;40;6;34;.850;3600000;0
32891;207504;123;0;0;0;0;.00nan;0;0
32892;212052;127;56;41;6;35;.854;2990000;0
32892;206864;127;48;6;1;5;.833;610000;0
32892;207600;120;90;25;1;24;.960;3600000;0
32892;213613;120;0;0;0;0;.00nan;0;0
32893;212683;118;0;0;0;0;.00nan;0;0
32893;207535;108;0;0;0;0;.00nan;0;0
32893;-1;108;50;42;6;36;.857;3636000;0
32893;218830;118;49;30;5;25;.833;3625000;0
32894;213692;112;0;0;0;0;.00nan;0;0
32894;208620;112;75;27;2;25;.926;3600000;0
32894;220341;116;0;0;0;0;.00nan;0;0
32894;216028;116;56;33;4;29;.879;3586000;0
32895;213845;113;69;36;4;32;.889;3589000;0
32895;208652;124;0;0;0;0;.00nan;0;0
32895;210765;113;0;0;0;0;.00nan;0;0
32895;206731;124;76;36;3;33;.917;3600000;0
32896;204894;121;0;0;0;0;.00nan;0;0
32896;207493;121;83;38;2;36;.947;3600000;0
32896;207600;120;0;0;0;0;.00nan;0;0
32896;213613;120;64;28;3;25;.893;3542000;0
32897;205469;122;36;33;6;27;.818;3600000;0
32897;212052;127;0;0;0;0;.00nan;0;0
32897;206864;127;65;21;2;19;.905;3600000;0
32897;212681;122;0;0;0;0;.00nan;0;0
32898;210773;111;39;30;5;25;.833;3600000;0
32898;210785;123;42;36;6;30;.833;3584000;0
32898;207504;123;0;0;0;0;.00nan;0;0
32898;-1;111;0;0;0;0;.00nan;0;0
32899;204618;125;0;0;0;0;.00nan;0;0
32899;204630;109;58;26;4;22;.846;3600000;0
32899;221211;109;0;0;0;0;.00nan;0;0
32899;-1;125;31;36;6;30;.833;3591000;0
32900;203412;117;0;0;0;0;.00nan;0;0
32900;207424;114;51;20;3;17;.850;3600000;0
32900;212783;114;0;0;0;0;.00nan;0;0
32900;213504;117;58;41;5;36;.878;3583000;0
32901;213845;113;0;0;0;0;.00nan;0;0
32901;210765;113;55;26;3;23;.885;3591000;0
32901;221235;126;0;0;0;0;.00nan;0;0
32901;212039;126;83;35;2;33;.943;3600000;0
32902;204618;125;97;50;3;47;.940;3729000;0
32902;204711;119;43;21;4;17;.810;3729000;0
32902;-1;125;0;0;0;0;.00nan;0;0
32902;218853;119;0;0;0;0;.00nan;0;0
32903;203412;117;59;39;5;34;.872;3590000;0
32903;222436;115;0;0;0;0;.00nan;0;0
32903;207439;115;52;24;4;20;.833;3600000;0
32903;213504;117;0;0;0;0;.00nan;0;0
32904;213692;112;0;0;0;0;.00nan;0;0
32904;208620;112;87;49;4;45;.918;3588000;0
32904;204894;121;64;23;2;21;.913;3600000;0
32904;207493;121;0;0;0;0;.00nan;0;0
32905;220301;110;0;0;0;0;.00nan;0;0
32905;215968;110;52;28;3;25;.893;3600000;0
32905;207424;114;80;34;2;32;.941;3600000;0
32905;212783;114;0;0;0;0;.00nan;0;0
32906;220301;110;0;0;0;0;.00nan;0;0
32906;215968;110;48;23;4;19;.826;3600000;0
32906;212683;118;0;0;0;0;.00nan;0;0
32906;218830;118;67;18;1;17;.944;3600000;0
32907;222436;115;0;0;0;0;.00nan;0;0
32907;207424;114;64;28;3;25;.893;3538000;0
32907;207439;115;97;36;1;35;.972;3600000;0
32907;212783;114;0;0;0;0;.00nan;0;0
32908;213845;113;62;27;3;24;.889;3560000;0
32908;210765;113;0;0;0;0;.00nan;0;0
32908;221235;126;0;0;0;0;.00nan;0;0
32908;212039;126;80;31;2;29;.935;3600000;0
32909;220341;116;0;0;0;0;.00nan;0;0
32909;216028;116;93;43;3;40;.930;3600000;0
32909;207535;108;0;0;0;0;.00nan;0;0
32909;-1;108;57;16;2;14;.875;3600000;0
32910;204630;109;98;68;4;64;.941;3551000;0
32910;204894;121;0;0;0;0;.00nan;0;0
32910;221211;109;0;0;0;0;.00nan;0;0
32910;207493;121;64;23;3;20;.870;3600000;0
32911;208652;124;0;0;0;0;.00nan;0;0
32911;206731;124;54;15;2;13;.867;3600000;0
32911;212052;127;49;24;3;21;.875;1344000;0
32911;206864;127;30;24;5;19;.792;2256000;0
32912;210773;111;0;0;0;0;.00nan;0;0
32912;210785;123;50;27;4;23;.852;3599000;0
32912;207504;123;0;0;0;0;.00nan;0;0
32912;-1;111;52;22;3;19;.864;3600000;0
32913;213692;112;59;27;3;24;.889;3557000;0
32913;208620;112;0;0;0;0;.00nan;0;0
32913;204894;121;0;0;0;0;.00nan;0;0
32913;207493;121;78;24;1;23;.958;3600000;0
32914;203412;117;0;0;0;0;.00nan;0;0
32914;207535;108;55;28;3;25;.893;3900000;0
32914;213504;117;58;31;3;28;.903;3900000;0
32914;-1;108;0;0;0;0;.00nan;0;0
32915;208652;124;60;26;3;23;.885;3600000;0
32915;206731;124;0;0;0;0;.00nan;0;0
32915;212052;127;30;16;4;12;.750;750000;0
32915;206864;127;75;41;4;37;.902;2850000;0
32916;204711;119;54;49;6;43;.878;3600000;0
32916;212683;118;42;4;1;3;.750;1335000;0
32916;218830;118;32;26;6;20;.769;2213000;0
32916;218853;119;0;0;0;0;.00nan;0;0
32917;221235;126;0;0;0;0;.00nan;0;0
32917;212039;126;63;42;5;37;.881;3600000;0
32917;222436;115;0;0;0;0;.00nan;0;0
32917;207439;115;90;31;1;30;.968;3600000;0
32918;220301;110;0;0;0;0;.00nan;0;0
32918;204618;125;86;51;4;47;.922;3900000;0
32918;215968;110;63;35;4;31;.886;3900000;0
32918;-1;125;0;0;0;0;.00nan;0;0
32919;205469;122;50;43;6;37;.860;3600000;0
32919;212681;122;0;0;0;0;.00nan;0;0
32919;207600;120;100;31;0;31;1.000;3600000;0
32919;213613;120;0;0;0;0;.00nan;0;0
32920;213692;112;0;0;0;0;.00nan;0;0
32920;208620;112;60;26;2;24;.923;3600000;0
32920;210773;111;49;44;6;38;.864;3600000;0
32920;-1;111;0;0;0;0;.00nan;0;0
32921;208652;124;0;0;0;0;.00nan;0;0
32921;206731;124;78;52;5;47;.904;3600000;0
32921;212683;118;24;25;6;19;.760;2945000;0
32921;218830;118;58;6;0;6;1.000;607000;0
32922;205469;122;0;0;0;0;.00nan;0;0
32922;210785;123;0;0;0;0;.00nan;0;0
32922;212681;122;41;24;4;20;.833;3600000;0
32922;207504;123;41;40;6;34;.850;3600000;0
32923;220301;110;57;52;6;46;.885;3600000;0
32923;215968;110;0;0;0;0;.00nan;0;0
32923;222436;115;25;38;7;31;.816;3600000;0
32923;207439;115;0;0;0;0;.00nan;0;0
32924;220341;116;0;0;0;0;.00nan;0;0
32924;216028;116;60;28;3;25;.893;3600000;0
32924;207424;114;71;33;2;31;.939;3600000;0
32924;212783;114;0;0;0;0;.00nan;0;0
32925;204894;121;0;0;0;0;.00nan;0;0
32925;207493;121;81;34;2;32;.941;3694000;0
32925;207535;108;0;0;0;0;.00nan;0;0
32925;-1;108;52;21;3;18;.857;3694000;0
32926;213845;113;53;17;2;15;.882;3600000;0
32926;220341;116;0;0;0;0;.00nan;0;0
32926;210765;113;0;0;0;0;.00nan;0;0
32926;216028;116;55;36;5;31;.861;3600000;0
32927;210785;123;53;39;6;33;.846;3600000;0
32927;207504;123;0;0;0;0;.00nan;0;0
32927;207600;120;53;24;4;20;.833;3600000;0
32927;213613;120;0;0;0;0;.00nan;0;0
32928;213692;112;41;29;5;24;.828;3600000;0
32928;208620;112;0;0;0;0;.00nan;0;0
32928;204711;119;0;0;0;0;.00nan;0;0
32928;218853;119;81;26;1;25;.962;3600000;0
32929;204618;125;0;0;0;0;.00nan;0;0
32929;221235;126;0;0;0;0;.00nan;0;0
32929;212039;126;34;22;5;17;.773;3539000;0
32929;-1;125;77;34;3;31;.912;3600000;0
32930;203412;117;0;0;0;0;.00nan;0;0
32930;212052;127;0;0;0;0;.00nan;0;0
32930;206864;127;63;44;5;39;.886;3600000;0
32930;213504;117;63;20;2;18;.900;3600000;0
32931;204630;109;39;30;5;25;.833;3600000;0
32931;205469;122;79;33;2;31;.939;3600000;0
32931;221211;109;0;0;0;0;.00nan;0;0
32931;212681;122;0;0;0;0;.00nan;0;0
32932;220301;110;0;0;0;0;.00nan;0;0
32932;215968;110;81;44;4;40;.909;3600000;0
32932;207535;108;0;0;0;0;.00nan;0;0
32932;-1;108;35;24;5;19;.792;3565000;0
32933;204630;109;0;0;0;0;.00nan;0;0
32933;221211;109;98;25;0;25;1.000;3600000;0
32933;207424;114;25;29;6;23;.793;3207000;0
32933;212783;114;40;3;1;2;.667;393000;0
32934;203412;117;78;42;4;38;.905;3673000;0
32934;210773;111;64;27;3;24;.889;3673000;0
32934;213504;117;0;0;0;0;.00nan;0;0
32934;-1;111;0;0;0;0;.00nan;0;0
32935;212683;118;0;0;0;0;.00nan;0;0
32935;207600;120;0;0;0;0;.00nan;0;0
32935;213613;120;39;29;5;24;.828;3695000;0
32935;218830;118;55;34;4;30;.882;3695000;0
32936;208652;124;0;0;0;0;.00nan;0;0
32936;210785;123;45;34;5;29;.853;3600000;0
32936;206731;124;68;26;2;24;.923;3600000;0
32936;207504;123;0;0;0;0;.00nan;0;0
32937;204711;119;37;38;6;32;.842;3600000;0
32937;205469;122;15;9;4;5;.556;496000;0
32937;212681;122;54;27;3;24;.889;3064000;0
32937;218853;119;0;0;0;0;.00nan;0;0
32938;204618;125;92;30;1;29;.967;3600000;0
32938;222436;115;0;0;0;0;.00nan;0;0
32938;207439;115;63;41;4;37;.902;3600000;0
32938;-1;125;0;0;0;0;.00nan;0;0
32939;203412;117;0;0;0;0;.00nan;0;0
32939;207424;114;0;0;0;0;.00nan;0;0
32939;212783;114;23;17;5;12;.706;3600000;0
32939;213504;117;64;31;3;28;.903;3600000;0
32940;213845;113;85;34;2;32;.941;3600000;0
32940;210765;113;0;0;0;0;.00nan;0;0
32940;212052;127;0;0;0;0;.00nan;0;0
32940;206864;127;87;45;4;41;.911;3566000;0
32941;204630;109;53;5;0;5;1.000;1293000;0
32941;221211;109;51;39;5;34;.872;2307000;0
32941;207535;108;0;0;0;0;.00nan;0;0
32941;-1;108;70;29;3;26;.897;3600000;0
32942;220301;110;0;0;0;0;.00nan;0;0
32942;210773;111;0;0;0;0;.00nan;0;0
32942;215968;110;96;49;1;48;.980;3900000;0
32942;-1;111;58;10;1;9;.900;3900000;0
32943;220341;116;0;0;0;0;.00nan;0;0
32943;216028;116;75;33;2;31;.939;3600000;0
32943;207535;108;40;20;3;17;.850;3584000;0
32943;-1;108;0;0;0;0;.00nan;0;0
32944;208652;124;0;0;0;0;.00nan;0;0
32944;204711;119;86;38;2;36;.947;3600000;0
32944;206731;124;41;24;4;20;.833;3531000;0
32944;218853;119;0;0;0;0;.00nan;0;0
32945;221235;126;53;10;1;9;.900;687000;0
32945;212039;126;15;25;7;18;.720;2913000;0
32945;212683;118;0;0;0;0;.00nan;0;0
32945;218830;118;73;27;2;25;.926;3600000;0
32946;212052;127;80;45;4;41;.911;3600000;0
32946;206864;127;0;0;0;0;.00nan;0;0
32946;222436;115;0;0;0;0;.00nan;0;0
32946;207439;115;66;23;2;21;.913;3600000;0
32947;213692;112;0;0;0;0;.00nan;0;0
32947;208620;112;63;31;3;28;.903;3600000;0
32947;210785;123;63;16;1;15;.938;1778000;0
32947;207504;123;11;19;6;13;.684;1822000;0
32948;204618;125;59;16;1;15;.938;1119000;0
32948;207600;120;38;24;5;19;.792;3600000;0
32948;213613;120;0;0;0;0;.00nan;0;0
32948;-1;125;54;39;6;33;.846;2461000;0
32949;204711;119;63;35;4;31;.886;3900000;0
32949;212683;118;46;23;4;19;.826;3900000;0
32949;218830;118;0;0;0;0;.00nan;0;0
32949;218853;119;0;0;0;0;.00nan;0;0
32950;213692;112;23;24;6;18;.750;1834000;0
32950;208620;112;98;21;0;21;1.000;1766000;0
32950;208652;124;96;33;1;32;.970;3600000;0
32950;206731;124;0;0;0;0;.00nan;0;0
32951;204894;121;0;0;0;0;.00nan;0;0
32951;205469;122;57;37;4;33;.892;3581000;0
32951;212681;122;0;0;0;0;.00nan;0;0
32951;207493;121;69;25;2;23;.920;3600000;0
32952;204630;109;59;33;4;29;.879;3578000;0
32952;220341;116;0;0;0;0;.00nan;0;0
32952;221211;109;0;0;0;0;.00nan;0;0
32952;216028;116;82;39;2;37;.949;3600000;0
32953;210785;123;0;0;0;0;.00nan;0;0
32953;207504;123;66;42;4;38;.905;3675000;0
32953;207600;120;0;0;0;0;.00nan;0;0
32953;213613;120;46;19;3;16;.842;3675000;0
32954;204618;125;55;25;3;22;.880;3600000;0
32954;212052;127;0;0;0;0;.00nan;0;0
32954;206864;127;45;29;5;24;.828;3600000;0
32954;-1;125;0;0;0;0;.00nan;0;0
32955;213845;113;53;34;4;30;.882;3572000;0
32955;210765;113;0;0;0;0;.00nan;0;0
32955;207424;114;75;36;3;33;.917;3600000;0
32955;212783;114;0;0;0;0;.00nan;0;0
32956;203412;117;6;13;6;7;.538;1052000;0
32956;207535;108;0;0;0;0;.00nan;0;0
32956;213504;117;80;22;0;22;1.000;2510000;0
32956;-1;108;40;22;5;17;.773;3600000;0
32957;213845;113;0;0;0;0;.00nan;0;0
32957;210765;113;88;36;2;34;.944;3862000;0
32957;222436;115;0;0;0;0;.00nan;0;0
32957;207439;115;77;31;3;28;.903;3862000;0
32958;213692;112;0;0;0;0;.00nan;0;0
32958;208620;112;61;12;1;11;.917;3600000;0
32958;221235;126;76;40;3;37;.925;3521000;0
32958;212039;126;0;0;0;0;.00nan;0;0
32959;204630;109;0;0;0;0;.00nan;0;0
32959;210773;111;0;0;0;0;.00nan;0;0
32959;221211;109;48;34;5;29;.853;3648000;0
32959;-1;111;57;33;4;29;.879;3648000;0
32960;204894;121;85;36;2;34;.944;3600000;0
32960;205469;122;0;0;0;0;.00nan;0;0
32960;212681;122;65;30;3;27;.900;3577000;0
32960;207493;121;0;0;0;0;.00nan;0;0
32961;220301;110;0;0;0;0;.00nan;0;0
32961;215968;110;60;33;4;29;.879;3600000;0
32961;207424;114;58;45;6;39;.867;3545000;0
32961;212783;114;0;0;0;0;.00nan;0;0
32962;207424;114;83;49;3;46;.939;3600000;0
32962;207535;108;0;0;0;0;.00nan;0;0
32962;212783;114;0;0;0;0;.00nan;0;0
32962;-1;108;88;27;1;26;.963;3600000;0
32963;203412;117;0;0;0;0;.00nan;0;0
32963;220301;110;0;0;0;0;.00nan;0;0
32963;215968;110;31;26;5;21;.808;3548000;0
32963;213504;117;63;35;4;31;.886;3600000;0
32964;208652;124;0;0;0;0;.00nan;0;0
32964;204618;125;26;11;4;7;.636;673000;0
32964;206731;124;54;29;4;25;.862;3600000;0
32964;-1;125;57;28;3;25;.893;2927000;0
32965;204894;121;0;0;0;0;.00nan;0;0
32965;212683;118;57;30;3;27;.900;3541000;0
32965;207493;121;84;36;2;34;.944;3600000;0
32965;218830;118;0;0;0;0;.00nan;0;0
32966;213692;112;0;0;0;0;.00nan;0;0
32966;208620;112;74;27;2;25;.926;3600000;0
32966;204630;109;40;30;6;24;.800;3600000;0
32966;221211;109;0;0;0;0;.00nan;0;0
32967;203412;117;53;34;5;29;.853;3600000;0
32967;221235;126;0;0;0;0;.00nan;0;0
32967;212039;126;93;31;1;30;.968;3600000;0
32967;213504;117;0;0;0;0;.00nan;0;0
32968;207424;114;77;29;2;27;.931;3600000;0
32968;207535;108;0;0;0;0;.00nan;0;0
32968;212783;114;0;0;0;0;.00nan;0;0
32968;-1;108;37;28;5;23;.821;3600000;0
32969;213845;113;55;24;3;21;.875;3600000;0
32969;210765;113;0;0;0;0;.00nan;0;0
32969;210773;111;94;24;0;24;1.000;3600000;0
32969;-1;111;0;0;0;0;.00nan;0;0
32970;220341;116;0;0;0;0;.00nan;0;0
32970;204894;121;0;0;0;0;.00nan;0;0
32970;216028;116;42;23;4;19;.826;3587000;0
32970;207493;121;45;20;3;17;.850;3600000;0
32971;212052;127;0;0;0;0;.00nan;0;0
32971;206864;127;72;39;4;35;.897;3564000;0
32971;207600;120;69;24;2;22;.917;3600000;0
32971;213613;120;0;0;0;0;.00nan;0;0
32972;213692;112;14;20;6;14;.700;3566000;0
32972;208620;112;0;0;0;0;.00nan;0;0
32972;204630;109;84;41;4;37;.902;3600000;0
32972;221211;109;0;0;0;0;.00nan;0;0
32973;203412;117;0;0;0;0;.00nan;0;0
32973;220341;116;0;0;0;0;.00nan;0;0
32973;216028;116;60;26;3;23;.885;3643000;0
32973;213504;117;80;30;2;28;.933;3643000;0
32974;204711;119;0;0;0;0;.00nan;0;0
32974;205469;122;36;24;4;20;.833;3205000;0
32974;212681;122;35;4;2;2;.500;547000;0
32974;218853;119;56;38;5;33;.868;3752000;0
32975;204618;125;41;35;6;29;.829;2753000;0
32975;212683;118;0;0;0;0;.00nan;0;0
32975;218830;118;66;12;1;11;.917;3600000;0
32975;-1;125;75;18;0;18;1.000;847000;0
32976;220301;110;0;0;0;0;.00nan;0;0
32976;215968;110;100;23;0;23;1.000;3600000;0
32976;222436;115;48;30;4;26;.867;3600000;0
32976;207439;115;0;0;0;0;.00nan;0;0
32977;208652;124;0;0;0;0;.00nan;0;0
32977;221235;126;0;0;0;0;.00nan;0;0
32977;206731;124;66;32;3;29;.906;3600000;0
32977;212039;126;48;29;4;25;.862;3551000;0
32978;210785;123;96;46;2;44;.957;3900000;0
32978;207504;123;0;0;0;0;.00nan;0;0
32978;207600;120;0;0;0;0;.00nan;0;0
32978;213613;120;76;26;2;24;.923;3900000;0
32979;210773;111;45;31;5;26;.839;3600000;0
32979;207535;108;0;0;0;0;.00nan;0;0
32979;-1;111;0;0;0;0;.00nan;0;0
32979;-1;108;61;17;1;16;.941;3600000;0
32980;208652;124;80;30;2;28;.933;3600000;0
32980;206731;124;0;0;0;0;.00nan;0;0
32980;212052;127;52;17;2;15;.882;609000;0
32980;206864;127;48;40;6;34;.850;2991000;0
32981;204894;121;0;0;0;0;.00nan;0;0
32981;210785;123;0;0;0;0;.00nan;0;0
32981;207493;121;75;27;3;24;.889;3543000;0
32981;207504;123;65;26;2;24;.923;3600000;0
32982;204618;125;0;0;0;0;.00nan;0;0
32982;205469;122;0;0;0;0;.00nan;0;0
32982;212681;122;57;23;3;20;.870;3857000;0
32982;-1;125;56;30;4;26;.867;3857000;0
32983;213845;113;61;31;3;28;.903;3584000;0
32983;204630;109;0;0;0;0;.00nan;0;0
32983;210765;113;0;0;0;0;.00nan;0;0
32983;221211;109;78;32;1;31;.969;3600000;0
32984;222436;115;0;0;0;0;.00nan;0;0
32984;207424;114;58;24;2;22;.917;3600000;0
32984;207439;115;44;36;6;30;.833;3600000;0
32984;212783;114;0;0;0;0;.00nan;0;0
32985;203412;117;55;30;4;26;.867;3790000;0
32985;210773;111;0;0;0;0;.00nan;0;0
32985;213504;117;0;0;0;0;.00nan;0;0
32985;-1;111;60;33;3;30;.909;3790000;0
32986;213692;112;74;10;0;10;1.000;680000;0
32986;213845;113;0;0;0;0;.00nan;0;0
32986;208620;112;28;27;6;21;.778;2914000;0
32986;210765;113;32;26;5;21;.808;3600000;0
32987;220341;116;0;0;0;0;.00nan;0;0
32987;216028;116;51;31;4;27;.871;3600000;0
32987;207424;114;36;30;5;25;.833;3557000;0
32987;212783;114;0;0;0;0;.00nan;0;0
32988;204711;119;83;33;3;30;.909;3600000;0
32988;207600;120;83;32;1;31;.969;3600000;0
32988;213613;120;0;0;0;0;.00nan;0;0
32988;218853;119;0;0;0;0;.00nan;0;0
32989;205469;122;58;27;3;24;.889;3600000;0
32989;222436;115;38;27;5;22;.815;3586000;0
32989;212681;122;0;0;0;0;.00nan;0;0
32989;207439;115;0;0;0;0;.00nan;0;0
32990;212052;127;86;37;3;34;.919;3582000;0
32990;206864;127;0;0;0;0;.00nan;0;0
32990;212683;118;72;20;1;19;.950;3600000;0
32990;218830;118;0;0;0;0;.00nan;0;0
32991;220301;110;0;0;0;0;.00nan;0;0
32991;215968;110;54;26;4;22;.846;3900000;0
32991;221235;126;0;0;0;0;.00nan;0;0
32991;212039;126;53;31;4;27;.871;3900000;0
32992;204711;119;97;35;2;33;.943;3593000;0
32992;207600;120;98;34;1;33;.971;3600000;0
32992;213613;120;0;0;0;0;.00nan;0;0
32992;218853;119;0;0;0;0;.00nan;0;0
32993;220341;116;0;0;0;0;.00nan;0;0
32993;210773;111;0;0;0;0;.00nan;0;0
32993;216028;116;77;26;1;25;.962;3600000;0
32993;-1;111;57;27;3;24;.889;3583000;0
32994;213845;113;55;25;3;22;.880;3600000;0
32994;210765;113;0;0;0;0;.00nan;0;0
32994;207424;114;79;35;2;33;.943;3600000;0
32994;212783;114;0;0;0;0;.00nan;0;0
32995;208652;124;56;43;5;38;.884;3600000;0
32995;204894;121;0;0;0;0;.00nan;0;0
32995;206731;124;0;0;0;0;.00nan;0;0
32995;207493;121;48;24;4;20;.833;3600000;0
32996;204618;125;67;29;3;26;.897;3565000;0
32996;221235;126;0;0;0;0;.00nan;0;0
32996;212039;126;70;22;2;20;.909;3600000;0
32996;-1;125;0;0;0;0;.00nan;0;0
32997;203412;117;0;0;0;0;.00nan;0;0
32997;220341;116;41;35;6;29;.829;2894000;0
32997;216028;116;59;7;0;7;1.000;706000;0
32997;213504;117;72;29;2;27;.931;3600000;0
32998;205469;122;70;41;4;37;.902;3600000;0
32998;212681;122;0;0;0;0;.00nan;0;0
32998;207600;120;76;22;1;21;.955;3600000;0
32998;213613;120;0;0;0;0;.00nan;0;0
32999;204630;109;69;31;3;28;.903;3529000;0
32999;221211;109;0;0;0;0;.00nan;0;0
32999;207535;108;0;0;0;0;.00nan;0;0
32999;-1;108;76;24;1;23;.958;3600000;0
33000;204894;121;0;0;0;0;.00nan;0;0
33000;212052;127;56;43;6;37;.860;3600000;0
33000;206864;127;0;0;0;0;.00nan;0;0
33000;207493;121;51;14;2;12;.857;3600000;0
33001;213692;112;0;0;0;0;.00nan;0;0
33001;208620;112;60;49;7;42;.857;3525000;0
33001;207535;108;44;22;4;18;.818;2315000;0
33001;-1;108;56;9;1;8;.889;1285000;0
33002;213845;113;44;20;3;17;.850;3600000;0
33002;203412;117;36;28;5;23;.821;3570000;0
33002;210765;113;0;0;0;0;.00nan;0;0
33002;213504;117;0;0;0;0;.00nan;0;0
33003;220301;110;0;0;0;0;.00nan;0;0
33003;204711;119;0;0;0;0;.00nan;0;0
33003;215968;110;100;32;0;32;1.000;3600000;0
33003;218853;119;45;23;4;19;.826;3600000;0
33004;212052;127;0;0;0;0;.00nan;0;0
33004;206864;127;78;46;4;42;.913;3600000;0
33004;212683;118;0;0;0;0;.00nan;0;0
33004;218830;118;92;18;0;18;1.000;3600000;0
33005;222436;115;0;0;0;0;.00nan;0;0
33005;207424;114;72;32;3;29;.906;3600000;0
33005;207439;115;60;36;4;32;.889;3547000;0
33005;212783;114;0;0;0;0;.00nan;0;0
33006;210785;123;64;32;3;29;.906;3816000;0
33006;221235;126;0;0;0;0;.00nan;0;0
33006;212039;126;75;40;4;36;.900;3816000;0
33006;207504;123;0;0;0;0;.00nan;0;0
33007;208652;124;100;32;0;32;1.000;3600000;0
33007;204618;125;93;37;1;36;.973;3600000;0
33007;206731;124;0;0;0;0;.00nan;0;0
33007;-1;125;0;0;0;0;.00nan;0;0
33008;205469;122;0;0;0;0;.00nan;0;0
33008;212681;122;61;38;4;34;.895;3600000;0
33008;207600;120;72;21;1;20;.952;3600000;0
33008;213613;120;0;0;0;0;.00nan;0;0
33009;213692;112;85;31;1;30;.968;3600000;0
33009;208620;112;0;0;0;0;.00nan;0;0
33009;210773;111;62;25;2;23;.920;3567000;0
33009;-1;111;0;0;0;0;.00nan;0;0
33010;220341;116;0;0;0;0;.00nan;0;0
33010;216028;116;63;33;4;29;.879;3563000;0
33010;222436;115;67;31;3;28;.903;3600000;0
33010;207439;115;0;0;0;0;.00nan;0;0
33011;208652;124;5;27;8;19;.704;3254000;0
33011;221235;126;0;0;0;0;.00nan;0;0
33011;206731;124;50;1;0;1;1.000;346000;0
33011;212039;126;67;26;2;24;.923;3600000;0
33012;204711;119;84;34;3;31;.912;3534000;0
33012;204894;121;0;0;0;0;.00nan;0;0
33012;207493;121;72;29;2;27;.931;3600000;0
33012;218853;119;0;0;0;0;.00nan;0;0
33013;210785;123;0;0;0;0;.00nan;0;0
33013;212052;127;42;36;6;30;.833;2995000;0
33013;206864;127;38;9;2;7;.778;605000;0
33013;207504;123;73;22;1;21;.955;3600000;0
33014;204630;109;83;26;1;25;.962;3600000;0
33014;221211;109;0;0;0;0;.00nan;0;0
33014;207424;114;0;0;0;0;.00nan;0;0
33014;212783;114;77;29;2;27;.931;3545000;0
33015;210773;111;0;0;0;0;.00nan;0;0
33015;207535;108;0;0;0;0;.00nan;0;0
33015;-1;111;84;40;3;37;.925;3600000;0
33015;-1;108;39;28;5;23;.821;3562000;0
33016;213845;113;68;19;1;18;.947;3600000;0
33016;204630;109;0;0;0;0;.00nan;0;0
33016;210765;113;0;0;0;0;.00nan;0;0
33016;221211;109;69;51;6;45;.882;3600000;0
33017;204618;125;91;43;1;42;.977;3600000;0
33017;210785;123;57;24;3;21;.875;3600000;0
33017;207504;123;0;0;0;0;.00nan;0;0
33017;-1;125;0;0;0;0;.00nan;0;0
33018;212683;118;0;0;0;0;.00nan;0;0
33018;207600;120;0;0;0;0;.00nan;0;0
33018;213613;120;38;28;5;23;.821;3587000;0
33018;218830;118;38;17;4;13;.765;3600000;0
33019;220301;110;0;0;0;0;.00nan;0;0
33019;215968;110;40;35;7;28;.800;3663000;0
33019;222436;115;0;0;0;0;.00nan;0;0
33019;207439;115;61;47;6;41;.872;3663000;0
33021;220341;116;54;18;3;15;.833;3600000;0
33021;205469;122;0;0;0;0;.00nan;0;0
33021;216028;116;0;0;0;0;.00nan;0;0
33021;212681;122;62;34;4;30;.882;3589000;0
33023;203412;117;90;48;3;45;.938;3571000;0
33023;204894;121;0;0;0;0;.00nan;0;0
33023;207493;121;54;11;2;9;.818;3600000;0
33023;213504;117;0;0;0;0;.00nan;0;0
33025;213692;112;48;24;4;20;.833;3556000;0
33025;208620;112;0;0;0;0;.00nan;0;0
33025;204711;119;78;38;3;35;.921;3600000;0
33025;218853;119;0;0;0;0;.00nan;0;0
33027;208652;124;48;26;4;22;.846;3562000;0
33027;210785;123;77;41;3;38;.927;3600000;0
33027;206731;124;0;0;0;0;.00nan;0;0
33027;-1;123;0;0;0;0;.00nan;0;0
33029;220301;110;0;0;0;0;.00nan;0;0
33029;210773;111;30;9;3;6;.667;468000;0
33029;215968;110;74;9;0;9;1.000;3600000;0
33029;-1;111;90;29;0;29;1.000;3132000;0
33031;204630;109;52;31;4;27;.871;3900000;0
33031;205458;109;0;0;0;0;.00nan;0;0
33031;207600;120;0;0;0;0;.00nan;0;0
33031;213613;120;33;24;4;20;.833;3900000;0
33033;213845;113;64;24;3;21;.875;3900000;0
33033;210765;113;0;0;0;0;.00nan;0;0
33033;221235;126;0;0;0;0;.00nan;0;0
33033;212039;126;88;34;3;31;.912;3900000;0
33035;204618;125;62;35;4;31;.886;3091000;0
33035;207535;108;0;0;0;0;.00nan;0;0
33035;-1;108;32;22;5;17;.773;3600000;0
33035;-1;125;23;11;4;7;.636;509000;0
33037;212052;127;0;0;0;0;.00nan;0;0
33037;206864;127;93;47;3;44;.936;3887000;0
33037;207504;114;44;17;4;13;.765;3887000;0
33037;212783;114;0;0;0;0;.00nan;0;0
33039;222436;115;86;42;3;39;.929;3600000;0
33039;212683;118;55;20;2;18;.900;3600000;0
33039;207439;115;0;0;0;0;.00nan;0;0
33039;218830;118;0;0;0;0;.00nan;0;0
33041;204711;119;0;0;0;0;.00nan;0;0
33041;207600;120;78;23;1;22;.957;3600000;0
33041;213613;120;0;0;0;0;.00nan;0;0
33041;218853;119;48;33;4;29;.879;3600000;0
33043;204618;125;0;0;0;0;.00nan;0;0
33043;220341;116;0;0;0;0;.00nan;0;0
33043;216028;116;99;33;1;32;.970;3600000;0
33043;-1;125;75;33;3;30;.909;3563000;0
33045;221235;126;31;19;5;14;.737;3537000;0
33045;212039;126;0;0;0;0;.00nan;0;0
33045;207504;114;0;0;0;0;.00nan;0;0
33045;212783;114;64;31;3;28;.903;3600000;0
33047;203412;117;0;0;0;0;.00nan;0;0
33047;205469;122;32;32;6;26;.813;3600000;0
33047;212681;122;0;0;0;0;.00nan;0;0
33047;213504;117;70;28;2;26;.929;3600000;0
33049;213692;112;0;0;0;0;.00nan;0;0
33049;208620;112;88;46;3;43;.935;3600000;0
33049;204894;121;38;22;4;18;.818;3554000;0
33049;207493;121;0;0;0;0;.00nan;0;0
33051;208652;124;0;0;0;0;.00nan;0;0
33051;220301;110;0;0;0;0;.00nan;0;0
33051;215968;110;52;39;5;34;.872;3577000;0
33051;206731;124;45;18;3;15;.833;3600000;0
33053;212052;127;42;37;5;32;.865;2321000;0
33053;206864;127;55;13;1;12;.923;1279000;0
33053;207535;108;57;11;1;10;.909;3600000;0
33053;-1;108;0;0;0;0;.00nan;0;0
33055;210773;111;97;59;4;55;.932;3600000;0
33055;212683;118;0;0;0;0;.00nan;0;0
33055;-1;111;0;0;0;0;.00nan;0;0
33055;218830;118;23;26;6;20;.769;3527000;0
33057;213845;113;0;0;0;0;.00nan;0;0
33057;210765;113;63;31;3;28;.903;3555000;0
33057;222436;115;0;0;0;0;.00nan;0;0
33057;207439;115;55;18;2;16;.889;3600000;0
33059;204630;109;0;0;0;0;.00nan;0;0
33059;205458;109;77;34;3;31;.912;3600000;0
33059;210785;123;0;0;0;0;.00nan;0;0
33059;-1;123;31;30;6;24;.800;3600000;0
33061;213692;112;91;35;1;34;.971;3600000;0
33061;208620;112;0;0;0;0;.00nan;0;0
33061;204894;121;0;0;0;0;.00nan;0;0
33061;207493;121;49;14;2;12;.857;3555000;0
33063;204618;125;53;30;4;26;.867;3600000;0
33063;205469;122;68;19;1;18;.947;3600000;0
33063;212681;122;0;0;0;0;.00nan;0;0
33063;-1;125;0;0;0;0;.00nan;0;0
33065;204630;109;51;27;3;24;.889;3576000;0
33065;205458;109;0;0;0;0;.00nan;0;0
33065;221235;126;0;0;0;0;.00nan;0;0
33065;212039;126;66;30;3;27;.900;3600000;0
33067;210773;111;0;0;0;0;.00nan;0;0
33067;207600;120;0;0;0;0;.00nan;0;0
33067;-1;111;90;41;2;39;.951;3816000;0
33067;213613;120;73;31;3;28;.903;3816000;0
33069;213845;113;70;34;3;31;.912;3600000;0
33069;203412;117;34;24;5;19;.792;3549000;0
33069;210765;113;0;0;0;0;.00nan;0;0
33069;213504;117;0;0;0;0;.00nan;0;0
33071;220341;116;52;2;0;2;1.000;446000;0
33071;204711;119;52;18;2;16;.889;3600000;0
33071;216028;116;39;32;5;27;.844;3154000;0
33071;218853;119;0;0;0;0;.00nan;0;0
33073;210785;123;86;46;3;43;.935;3600000;0
33073;212683;118;55;16;2;14;.875;3600000;0
33073;218830;118;0;0;0;0;.00nan;0;0
33073;-1;123;0;0;0;0;.00nan;0;0
33075;222436;115;0;0;0;0;.00nan;0;0
33075;207439;115;47;29;4;25;.862;3600000;0
33075;207504;114;0;0;0;0;.00nan;0;0
33075;212783;114;81;30;1;29;.967;3600000;0
33077;208652;124;59;32;4;28;.875;3600000;0
33077;206731;124;0;0;0;0;.00nan;0;0
33077;212052;127;26;37;7;30;.811;3600000;0
33077;206864;127;0;0;0;0;.00nan;0;0
33079;220301;110;79;40;3;37;.925;3600000;0
33079;215968;110;0;0;0;0;.00nan;0;0
33079;207535;108;0;0;0;0;.00nan;0;0
33079;-1;108;49;23;4;19;.826;3600000;0
33081;213692;112;0;0;0;0;.00nan;0;0
33081;208620;112;91;41;2;39;.951;3600000;0
33081;210773;111;62;29;3;26;.897;3600000;0
33081;-1;111;0;0;0;0;.00nan;0;0
33083;204711;119;0;0;0;0;.00nan;0;0
33083;222436;115;24;13;4;9;.692;799000;0
33083;207439;115;52;27;3;24;.889;2801000;0
33083;218853;119;79;26;1;25;.962;3600000;0
33085;220301;110;0;0;0;0;.00nan;0;0
33085;204894;121;65;18;2;16;.889;3600000;0
33085;215968;110;34;32;6;26;.813;3600000;0
33085;207493;121;0;0;0;0;.00nan;0;0
33087;204618;125;0;0;0;0;.00nan;0;0
33087;207535;108;63;14;1;13;.929;3600000;0
33087;-1;108;0;0;0;0;.00nan;0;0
33087;-1;125;46;33;5;28;.848;3600000;0
33089;213845;113;0;0;0;0;.00nan;0;0
33089;210765;113;60;12;1;11;.917;3600000;0
33089;221235;126;67;46;5;41;.891;3600000;0
33089;212039;126;0;0;0;0;.00nan;0;0
33091;203412;117;0;0;0;0;.00nan;0;0
33091;220341;116;69;33;3;30;.909;3517000;0
33091;216028;116;0;0;0;0;.00nan;0;0
33091;213504;117;73;24;1;23;.958;3600000;0
33093;205469;122;52;2;0;2;1.000;249000;0
33093;212681;122;35;40;7;33;.825;3351000;0
33093;207600;120;46;20;3;17;.850;3600000;0
33093;213613;120;0;0;0;0;.00nan;0;0
33095;212052;127;0;0;0;0;.00nan;0;0
33095;206864;127;70;39;3;36;.923;3568000;0
33095;207504;114;56;14;2;12;.857;3600000;0
33095;212783;114;0;0;0;0;.00nan;0;0
33097;204630;109;0;0;0;0;.00nan;0;0
33097;205458;109;50;31;4;27;.871;3600000;0
33097;210785;123;0;0;0;0;.00nan;0;0
33097;-1;123;35;24;5;19;.792;3600000;0
33099;208652;124;0;0;0;0;.00nan;0;0
33099;206731;124;73;36;3;33;.917;3570000;0
33099;212683;118;0;0;0;0;.00nan;0;0
33099;218830;118;78;34;2;32;.941;3600000;0
33101;203412;117;54;25;3;22;.880;3562000;0
33101;208652;124;91;39;2;37;.949;3600000;0
33101;206731;124;0;0;0;0;.00nan;0;0
33101;213504;117;0;0;0;0;.00nan;0;0
33103;220341;116;0;0;0;0;.00nan;0;0
33103;221235;126;0;0;0;0;.00nan;0;0
33103;216028;116;100;30;0;30;1.000;3600000;0
33103;212039;126;53;27;4;23;.852;3600000;0
33105;207504;114;60;30;3;27;.900;3517000;0
33105;212783;114;0;0;0;0;.00nan;0;0
33105;207600;120;0;0;0;0;.00nan;0;0
33105;213613;120;80;24;1;23;.958;3600000;0
33107;213692;112;69;24;2;22;.917;3600000;0
33107;208620;112;0;0;0;0;.00nan;0;0
33107;212052;127;90;49;4;45;.918;3539000;0
33107;206864;127;0;0;0;0;.00nan;0;0
33109;220301;110;47;25;4;21;.840;1635000;0
33109;215968;110;43;15;3;12;.800;1965000;0
33109;207535;108;0;0;0;0;.00nan;0;0
33109;-1;108;73;19;1;18;.947;3600000;0
33111;205469;122;78;53;5;48;.906;3600000;0
33111;212681;122;0;0;0;0;.00nan;0;0
33111;212683;118;85;15;0;15;1.000;3600000;0
33111;218830;118;0;0;0;0;.00nan;0;0
33113;204630;109;90;29;1;28;.966;3600000;0
33113;205458;109;0;0;0;0;.00nan;0;0
33113;210773;111;0;0;0;0;.00nan;0;0
33113;-1;111;43;22;4;18;.818;3600000;0
33115;204894;121;0;0;0;0;.00nan;0;0
33115;222436;115;0;0;0;0;.00nan;0;0
33115;207439;115;74;37;3;34;.919;3561000;0
33115;207493;121;83;28;1;27;.964;3600000;0
33117;213845;113;16;29;7;22;.759;3600000;0
33117;204618;125;64;31;3;28;.903;3600000;0
33117;210765;113;0;0;0;0;.00nan;0;0
33117;-1;125;0;0;0;0;.00nan;0;0
33119;204711;119;52;21;3;18;.857;3524000;0
33119;210785;123;98;41;1;40;.976;3600000;0
33119;218853;119;0;0;0;0;.00nan;0;0
33119;-1;123;0;0;0;0;.00nan;0;0
33121;213845;113;0;0;0;0;.00nan;0;0
33121;210765;113;59;20;2;18;.900;3600000;0
33121;207535;108;52;35;4;31;.886;3590000;0
33121;-1;108;0;0;0;0;.00nan;0;0
33123;212052;127;0;0;0;0;.00nan;0;0
33123;206864;127;59;34;4;30;.882;3600000;0
33123;212683;118;0;0;0;0;.00nan;0;0
33123;218830;118;50;9;1;8;.889;3600000;0
33125;204711;119;0;0;0;0;.00nan;0;0
33125;204894;121;71;21;1;20;.952;3600000;0
33125;207493;121;0;0;0;0;.00nan;0;0
33125;218853;119;35;32;6;26;.813;3600000;0
33127;204618;125;0;0;0;0;.00nan;0;0
33127;210773;111;62;17;1;16;.941;3600000;0
33127;-1;111;0;0;0;0;.00nan;0;0
33127;-1;125;91;46;3;43;.935;3600000;0
33129;208652;124;0;0;0;0;.00nan;0;0
33129;206731;124;91;37;2;35;.946;3600000;0
33129;222436;115;72;33;3;30;.909;3554000;0
33129;207439;115;0;0;0;0;.00nan;0;0
33131;220341;116;0;0;0;0;.00nan;0;0
33131;210785;123;0;0;0;0;.00nan;0;0
33131;216028;116;60;30;4;26;.867;3900000;0
33131;-1;123;75;38;4;34;.895;3900000;0
33133;220301;110;70;27;2;25;.926;3600000;0
33133;204630;109;0;0;0;0;.00nan;0;0
33133;205458;109;88;41;3;38;.927;3551000;0
33133;215968;110;0;0;0;0;.00nan;0;0
33135;203412;117;0;0;0;0;.00nan;0;0
33135;207600;120;60;25;2;23;.920;3599000;0
33135;213504;117;68;24;1;23;.958;3600000;0
33135;213613;120;0;0;0;0;.00nan;0;0
33137;221235;126;48;29;5;24;.828;3900000;0
33137;212039;126;0;0;0;0;.00nan;0;0
33137;207504;114;0;0;0;0;.00nan;0;0
33137;212783;114;75;41;5;36;.878;3900000;0
33139;213692;112;0;0;0;0;.00nan;0;0
33139;208620;112;60;23;2;21;.913;3600000;0
33139;205469;122;0;0;0;0;.00nan;0;0
33139;212681;122;49;38;6;32;.842;3600000;0
33141;208652;124;0;0;0;0;.00nan;0;0
33141;220301;110;49;6;1;5;.833;1424000;0
33141;215968;110;34;16;4;12;.750;2092000;0
33141;206731;124;73;34;3;31;.912;3600000;0
33143;204630;109;56;45;6;39;.867;3600000;0
33143;204894;121;0;0;0;0;.00nan;0;0
33143;205458;109;0;0;0;0;.00nan;0;0
33143;207493;121;65;29;3;26;.897;3600000;0
33145;204711;119;81;33;1;32;.970;3557000;0
33145;207535;108;0;0;0;0;.00nan;0;0
33145;-1;108;100;22;0;22;1.000;3600000;0
33145;218853;119;0;0;0;0;.00nan;0;0
33147;213845;113;62;21;2;19;.905;3600000;0
33147;210765;113;0;0;0;0;.00nan;0;0
33147;212052;127;68;50;6;44;.880;3600000;0
33147;206864;127;0;0;0;0;.00nan;0;0
33149;205469;122;28;27;6;21;.778;2849000;0
33149;222436;115;0;0;0;0;.00nan;0;0
33149;212681;122;52;10;1;9;.900;751000;0
33149;207439;115;62;22;2;20;.909;3600000;0
33151;210773;111;33;29;5;24;.828;3600000;0
33151;221235;126;0;0;0;0;.00nan;0;0
33151;212039;126;89;32;2;30;.938;3600000;0
33151;-1;111;0;0;0;0;.00nan;0;0
33153;204618;125;31;35;7;28;.800;2543000;0
33153;212683;118;61;20;2;18;.900;3600000;0
33153;218830;118;0;0;0;0;.00nan;0;0
33153;-1;125;34;18;4;14;.778;1057000;0
33155;210785;123;90;56;5;51;.911;3600000;0
33155;207600;120;0;0;0;0;.00nan;0;0
33155;213613;120;59;19;2;17;.895;3600000;0
33155;-1;123;0;0;0;0;.00nan;0;0
33157;213692;112;57;29;4;25;.862;3600000;0
33157;208620;112;0;0;0;0;.00nan;0;0
33157;220341;116;0;0;0;0;.00nan;0;0
33157;216028;116;33;28;5;23;.821;3578000;0
33159;203412;117;74;26;1;25;.962;3600000;0
33159;207504;114;66;20;2;18;.900;3569000;0
33159;212783;114;0;0;0;0;.00nan;0;0
33159;213504;117;0;0;0;0;.00nan;0;0
1704;213845;113;60;29;3;26;.897;3600000;0
1704;203412;117;0;0;0;0;.00nan;0;0
1704;210765;113;0;0;0;0;.00nan;0;0
1704;213504;117;51;33;4;29;.879;3595000;0
1705;210773;111;0;0;0;0;.00nan;0;0
1705;207535;108;0;0;0;0;.00nan;0;0
1705;-1;111;21;27;6;21;.778;3569000;0
1705;-1;108;37;19;4;15;.789;3600000;0
1706;220341;116;0;0;0;0;.00nan;0;0
1706;216028;116;23;32;8;24;.750;3600000;0
1706;207424;114;79;30;1;29;.967;3600000;0
1706;212783;114;0;0;0;0;.00nan;0;0
1707;213692;112;0;0;0;0;.00nan;0;0
1707;208620;112;85;37;3;34;.919;3544000;0
1707;220301;110;0;0;0;0;.00nan;0;0
1707;215968;110;100;39;2;37;.949;3600000;0
1708;204894;121;0;0;0;0;.00nan;0;0
1708;205469;122;74;41;4;37;.902;3520000;0
1708;212681;122;0;0;0;0;.00nan;0;0
1708;207493;121;64;22;2;20;.909;3600000;0
1709;208652;124;0;0;0;0;.00nan;0;0
1709;221235;126;53;12;1;11;.917;1828000;0
1709;206731;124;56;35;5;30;.857;4077000;0
1709;212039;126;47;34;5;29;.853;2249000;0
1710;210785;123;43;46;7;39;.848;3600000;0
1710;212683;118;0;0;0;0;.00nan;0;0
1710;207504;123;0;0;0;0;.00nan;0;0
1710;218830;118;58;26;3;23;.885;3600000;0
1711;204711;119;87;36;2;34;.944;3600000;0
1711;207600;120;70;21;1;20;.952;3600000;0
1711;213613;120;0;0;0;0;.00nan;0;0
1711;218853;119;0;0;0;0;.00nan;0;0
1712;213845;113;52;33;4;29;.879;3600000;0
1712;203412;117;66;17;0;17;1.000;1663000;0
1712;210765;113;0;0;0;0;.00nan;0;0
1712;213504;117;16;20;6;14;.700;1895000;0
1713;210773;111;0;0;0;0;.00nan;0;0
1713;207535;108;41;9;2;7;.778;1462000;0
1713;-1;111;39;36;6;30;.833;3600000;0
1713;-1;108;11;17;6;11;.647;2049000;0
1714;220341;116;0;0;0;0;.00nan;0;0
1714;216028;116;86;35;2;33;.943;3551000;0
1714;207424;114;88;33;1;32;.970;3600000;0
1714;212783;114;0;0;0;0;.00nan;0;0
1715;213692;112;0;0;0;0;.00nan;0;0
1715;208620;112;36;20;4;16;.800;3536000;0
1715;220301;110;0;0;0;0;.00nan;0;0
1715;215968;110;74;27;2;25;.926;3600000;0
1716;204894;121;0;0;0;0;.00nan;0;0
1716;205469;122;70;38;4;34;.895;3600000;0
1716;212681;122;0;0;0;0;.00nan;0;0
1716;207493;121;80;34;2;32;.941;3600000;0
1717;208652;124;0;0;0;0;.00nan;0;0
1717;221235;126;0;0;0;0;.00nan;0;0
1717;206731;124;77;23;1;22;.957;3600000;0
1717;212039;126;66;39;4;35;.897;3600000;0
1718;210785;123;100;45;1;44;.978;3600000;0
1718;212683;118;0;0;0;0;.00nan;0;0
1718;207504;123;0;0;0;0;.00nan;0;0
1718;218830;118;43;26;4;22;.846;3600000;0
1719;204711;119;55;36;5;31;.861;3546000;0
1719;207600;120;66;33;4;29;.879;3600000;0
1719;213613;120;0;0;0;0;.00nan;0;0
1719;218853;119;0;0;0;0;.00nan;0;0
1720;213845;113;100;34;0;34;1.000;3600000;0
1720;203412;117;0;0;0;0;.00nan;0;0
1720;210765;113;0;0;0;0;.00nan;0;0
1720;213504;117;58;32;4;28;.875;3600000;0
1721;210773;111;0;0;0;0;.00nan;0;0
1721;207535;108;0;0;0;0;.00nan;0;0
1721;-1;111;88;19;0;19;1.000;3600000;0
1721;-1;108;49;21;3;18;.857;3600000;0
1722;220341;116;62;14;1;13;.929;1949000;0
1722;216028;116;24;22;6;16;.727;1651000;0
1722;207424;114;96;32;0;32;1.000;3600000;0
1722;212783;114;0;0;0;0;.00nan;0;0
1723;213692;112;0;0;0;0;.00nan;0;0
1723;208620;112;63;26;3;23;.885;3600000;0
1723;220301;110;0;0;0;0;.00nan;0;0
1723;215968;110;63;43;5;38;.884;3541000;0
1724;204894;121;0;0;0;0;.00nan;0;0
1724;205469;122;42;29;5;24;.828;3600000;0
1724;212681;122;0;0;0;0;.00nan;0;0
1724;207493;121;71;26;2;24;.923;3600000;0
1725;208652;124;0;0;0;0;.00nan;0;0
1725;221235;126;57;6;0;6;1.000;587000;0
1725;206731;124;100;29;0;29;1.000;3600000;0
1725;212039;126;44;39;6;33;.846;3013000;0
1726;210785;123;46;53;8;45;.849;3600000;0
1726;212683;118;0;0;0;0;.00nan;0;0
1726;207504;123;0;0;0;0;.00nan;0;0
1726;218830;118;43;27;5;22;.815;3600000;0
1727;204711;119;38;44;7;37;.841;3600000;0
1727;207600;120;69;23;2;21;.913;3600000;0
1727;213613;120;0;0;0;0;.00nan;0;0
1727;218853;119;0;0;0;0;.00nan;0;0
1728;213845;113;51;18;2;16;.889;3600000;0
1728;203412;117;0;0;0;0;.00nan;0;0
1728;210765;113;0;0;0;0;.00nan;0;0
1728;213504;117;38;26;4;22;.846;3571000;0
1729;210773;111;0;0;0;0;.00nan;0;0
1729;207535;108;0;0;0;0;.00nan;0;0
1729;-1;111;69;27;2;25;.926;3600000;0
1729;-1;108;57;29;3;26;.897;3596000;0
1730;220341;116;0;0;0;0;.00nan;0;0
1730;216028;116;56;37;5;32;.865;3600000;0
1730;207424;114;68;23;1;22;.957;3600000;0
1730;212783;114;0;0;0;0;.00nan;0;0
1731;213692;112;48;0;0;0;.00nan;227000;0
1731;208620;112;22;24;6;18;.750;3340000;0
1731;220301;110;0;0;0;0;.00nan;0;0
1731;215968;110;54;32;5;27;.844;3600000;0
1732;204894;121;0;0;0;0;.00nan;0;0
1732;205469;122;21;11;4;7;.636;751000;0
1732;212681;122;54;35;4;31;.886;2849000;0
1732;207493;121;45;33;5;28;.848;3600000;0
1733;208652;124;0;0;0;0;.00nan;0;0
1733;221235;126;0;0;0;0;.00nan;0;0
1733;206731;124;87;43;4;39;.907;4416000;0
1733;212039;126;73;43;3;40;.930;4416000;0
1734;210785;123;57;48;6;42;.875;3600000;0
1734;212683;118;0;0;0;0;.00nan;0;0
1734;207504;123;0;0;0;0;.00nan;0;0
1734;218830;118;50;20;3;17;.850;3600000;0
1735;204711;119;47;47;7;40;.851;3572000;0
1735;207600;120;38;28;5;23;.821;3600000;0
1735;213613;120;0;0;0;0;.00nan;0;0
1735;218853;119;0;0;0;0;.00nan;0;0
1922;210773;111;0;0;0;0;.00nan;0;0
1922;207535;108;0;0;0;0;.00nan;0;0
1922;-1;111;64;39;4;35;.897;3600000;0
1922;-1;108;83;32;1;31;.969;3600000;0
1923;213692;112;0;0;0;0;.00nan;0;0
1923;208620;112;44;25;4;21;.840;3584000;0
1923;220301;110;0;0;0;0;.00nan;0;0
1923;215968;110;83;32;2;30;.938;3600000;0
1924;208652;124;0;0;0;0;.00nan;0;0
1924;221235;126;0;0;0;0;.00nan;0;0
1924;206731;124;62;23;3;20;.870;3600000;0
1924;212039;126;72;40;4;36;.900;3599000;0
1925;210785;123;87;48;4;44;.917;3600000;0
1925;212683;118;46;4;1;3;.750;904000;0
1925;207504;123;0;0;0;0;.00nan;0;0
1925;218830;118;19;24;6;18;.750;2696000;0
1962;210773;111;0;0;0;0;.00nan;0;0
1962;207535;108;0;0;0;0;.00nan;0;0
1962;-1;111;88;39;3;36;.923;3600000;0
1962;-1;108;27;41;8;33;.805;3600000;0
1963;210785;123;68;37;3;34;.919;3600000;0
1963;212683;118;0;0;0;0;.00nan;0;0
1963;207504;123;0;0;0;0;.00nan;0;0
1963;218830;118;39;18;4;14;.778;3600000;0
1993;210785;123;86;57;5;52;.912;3805000;0
1993;212683;118;0;0;0;0;.00nan;0;0
1993;207504;123;0;0;0;0;.00nan;0;0
1993;218830;118;46;29;4;25;.862;3805000;0
2106;213845;113;97;31;1;30;.968;3612000;0
2106;210765;113;0;0;0;0;.00nan;0;0
2106;210773;111;0;0;0;0;.00nan;0;0
2106;-1;111;85;34;2;32;.941;3612000;0
2107;220301;110;51;3;0;3;1.000;745000;0
2107;215968;110;29;27;6;21;.778;2855000;0
2107;207424;114;53;24;3;21;.875;3600000;0
2107;212783;114;0;0;0;0;.00nan;0;0
2108;208652;124;49;6;1;5;.833;348000;0
2108;204894;121;0;0;0;0;.00nan;0;0
2108;206731;124;22;26;6;20;.769;3252000;0
2108;207493;121;49;30;5;25;.833;3600000;0
2109;212683;118;0;0;0;0;.00nan;0;0
2109;207600;120;29;29;6;23;.793;2673000;0
2109;213613;120;56;11;1;10;.909;927000;0
2109;218830;118;78;23;2;21;.913;3600000;0
2110;213845;113;58;19;2;17;.895;3600000;0
2110;210765;113;0;0;0;0;.00nan;0;0
2110;210773;111;0;0;0;0;.00nan;0;0
2110;-1;111;70;32;3;29;.906;3600000;0
2111;220301;110;0;0;0;0;.00nan;0;0
2111;215968;110;86;35;2;33;.943;3600000;0
2111;207424;114;44;28;4;24;.857;3515000;0
2111;212783;114;0;0;0;0;.00nan;0;0
2112;208652;124;58;10;1;9;.900;1037000;0
2112;204894;121;0;0;0;0;.00nan;0;0
2112;206731;124;19;22;6;16;.727;2563000;0
2112;207493;121;69;19;1;18;.947;3600000;0
2113;212683;118;0;0;0;0;.00nan;0;0
2113;207600;120;55;22;3;19;.864;1781000;0
2113;213613;120;29;25;6;19;.760;1819000;0
2113;218830;118;76;18;1;17;.944;3600000;0
2114;213845;113;59;24;2;22;.917;3600000;0
2114;210765;113;0;0;0;0;.00nan;0;0
2114;210773;111;0;0;0;0;.00nan;0;0
2114;-1;111;82;28;1;27;.964;3600000;0
2115;220301;110;0;0;0;0;.00nan;0;0
2115;215968;110;72;32;3;29;.906;3600000;0
2115;207424;114;11;18;6;12;.667;1908000;0
2115;212783;114;52;15;2;13;.867;1692000;0
2116;208652;124;0;0;0;0;.00nan;0;0
2116;204894;121;0;0;0;0;.00nan;0;0
2116;206731;124;80;28;1;27;.964;3600000;0
2116;207493;121;64;18;2;16;.889;3600000;0
2117;212683;118;0;0;0;0;.00nan;0;0
2117;207600;120;0;0;0;0;.00nan;0;0
2117;213613;120;85;32;1;31;.969;3600000;0
2117;218830;118;73;24;2;22;.917;3580000;0
2118;213845;113;83;32;2;30;.938;3600000;0
2118;210765;113;0;0;0;0;.00nan;0;0
2118;210773;111;0;0;0;0;.00nan;0;0
2118;-1;111;52;29;4;25;.862;3536000;0
2119;220301;110;0;0;0;0;.00nan;0;0
2119;215968;110;96;30;1;29;.967;3600000;0
2119;207424;114;76;32;2;30;.938;3560000;0
2119;212783;114;0;0;0;0;.00nan;0;0
2120;208652;124;0;0;0;0;.00nan;0;0
2120;204894;121;0;0;0;0;.00nan;0;0
2120;206731;124;76;28;2;26;.929;3600000;0
2120;207493;121;62;30;3;27;.900;3590000;0
2121;212683;118;0;0;0;0;.00nan;0;0
2121;207600;120;0;0;0;0;.00nan;0;0
2121;213613;120;49;34;5;29;.853;3582000;0
2121;218830;118;58;21;3;18;.857;3600000;0
2303;213845;113;52;28;4;24;.857;3588000;0
2303;210765;113;0;0;0;0;.00nan;0;0
2303;210773;111;0;0;0;0;.00nan;0;0
2303;-1;111;84;39;3;36;.923;3600000;0
2304;220301;110;0;0;0;0;.00nan;0;0
2304;215968;110;48;36;5;31;.861;3600000;0
2304;207424;114;73;25;2;23;.920;3600000;0
2304;212783;114;0;0;0;0;.00nan;0;0
2305;208652;124;56;20;2;18;.900;1552000;0
2305;204894;121;0;0;0;0;.00nan;0;0
2305;206731;124;26;33;7;26;.788;2048000;0
2305;207493;121;30;21;5;16;.762;3600000;0
2306;212683;118;0;0;0;0;.00nan;0;0
2306;207600;120;0;0;0;0;.00nan;0;0
2306;213613;120;53;29;4;25;.862;3572000;0
2306;218830;118;73;34;3;31;.912;3600000;0
2367;213845;113;46;32;5;27;.844;3600000;0
2367;210765;113;0;0;0;0;.00nan;0;0
2367;210773;111;0;0;0;0;.00nan;0;0
2367;-1;111;100;39;2;37;.949;3600000;0
2368;220301;110;54;2;0;2;1.000;278000;0
2368;215968;110;39;29;6;23;.793;3322000;0
2368;207424;114;27;12;4;8;.667;940000;0
2368;212783;114;65;27;3;24;.889;2624000;0
2369;208652;124;65;40;4;36;.900;3571000;0
2369;204894;121;0;0;0;0;.00nan;0;0
2369;206731;124;0;0;0;0;.00nan;0;0
2369;207493;121;54;26;3;23;.885;3600000;0
2418;213845;113;80;39;3;36;.923;3535000;0
2418;210765;113;0;0;0;0;.00nan;0;0
2418;210773;111;0;0;0;0;.00nan;0;0
2418;-1;111;81;27;1;26;.963;3600000;0
2429;220301;110;0;0;0;0;.00nan;0;0
2429;210773;111;0;0;0;0;.00nan;0;0
2429;215968;110;66;27;3;24;.889;3600000;0
2429;-1;111;42;27;4;23;.852;3540000;0
2430;204894;121;0;0;0;0;.00nan;0;0
2430;212683;118;0;0;0;0;.00nan;0;0
2430;207493;121;66;36;3;33;.917;3600000;0
2430;218830;118;77;18;0;18;1.000;3600000;0
2431;220301;110;0;0;0;0;.00nan;0;0
2431;210773;111;92;31;1;30;.968;3036000;0
2431;215968;110;82;25;1;24;.960;3600000;0
2431;-1;111;26;7;3;4;.571;564000;0
2432;204894;121;0;0;0;0;.00nan;0;0
2432;212683;118;0;0;0;0;.00nan;0;0
2432;207493;121;39;32;5;27;.844;3567000;0
2432;218830;118;58;29;3;26;.897;3600000;0
2433;220301;110;0;0;0;0;.00nan;0;0
2433;210773;111;55;31;4;27;.871;4021000;0
2433;215968;110;76;35;3;32;.914;4021000;0
2433;-1;111;0;0;0;0;.00nan;0;0
2434;204894;121;0;0;0;0;.00nan;0;0
2434;212683;118;0;0;0;0;.00nan;0;0
2434;207493;121;20;20;5;15;.750;3600000;0
2434;218830;118;69;29;2;27;.931;3600000;0
2435;220301;110;0;0;0;0;.00nan;0;0
2435;210773;111;61;28;3;25;.893;3713000;0
2435;215968;110;71;29;2;27;.931;3713000;0
2435;-1;111;0;0;0;0;.00nan;0;0
2436;204894;121;0;0;0;0;.00nan;0;0
2436;212683;118;0;0;0;0;.00nan;0;0
2436;207493;121;50;43;6;37;.860;3600000;0
2436;218830;118;89;34;1;33;.971;3600000;0
2543;220301;110;51;24;3;21;.875;2548000;0
2543;215968;110;31;13;4;9;.692;1052000;0
2543;212683;118;0;0;0;0;.00nan;0;0
2543;218830;118;79;21;1;20;.952;3600000;0
2544;220301;110;52;11;1;10;.909;681000;0
2544;215968;110;27;23;6;17;.739;2919000;0
2544;212683;118;0;0;0;0;.00nan;0;0
2544;218830;118;90;42;3;39;.929;3600000;0
2545;220301;110;0;0;0;0;.00nan;0;0
2545;215968;110;60;26;4;22;.846;3600000;0
2545;212683;118;0;0;0;0;.00nan;0;0
2545;218830;118;81;25;2;23;.920;3600000;0
2546;220301;110;0;0;0;0;.00nan;0;0
2546;215968;110;87;42;2;40;.952;3600000;0
2546;212683;118;0;0;0;0;.00nan;0;0
2546;218830;118;54;22;3;19;.864;3580000;0
2700;220301;110;0;0;0;0;.00nan;0;0
2700;215968;110;69;61;7;54;.885;3600000;0
2700;212683;118;0;0;0;0;.00nan;0;0
2700;218830;118;60;13;1;12;.923;3600000;0
33160;210222;90;34;16;4;12;.750;3794000;0
33160;205124;89;0;0;0;0;.00nan;0;0
33160;207239;90;0;0;0;0;.00nan;0;0
33160;-1;89;64;41;5;36;.878;3794000;0
33161;209784;91;0;0;0;0;.00nan;0;0
33161;205318;97;90;35;2;33;.943;3600000;0
33161;205429;91;40;27;4;23;.852;3600000;0
33161;212354;97;0;0;0;0;.00nan;0;0
33162;215735;93;0;0;0;0;.00nan;0;0
33162;212343;96;0;0;0;0;.00nan;0;0
33162;-1;96;72;30;3;27;.900;3600000;0
33162;-1;93;52;27;4;23;.852;3564000;0
33163;205076;87;56;33;4;29;.879;3900000;0
33163;217437;88;72;40;4;36;.900;3900000;0
33163;-1;88;0;0;0;0;.00nan;0;0
33163;-1;87;0;0;0;0;.00nan;0;0
33164;212487;95;0;0;0;0;.00nan;0;0
33164;-1;95;74;45;4;41;.911;3538000;0
33164;-1;92;77;30;2;28;.933;3600000;0
33164;-1;92;0;0;0;0;.00nan;0;0
33165;215785;94;68;26;2;24;.923;3600000;0
33165;210923;102;44;34;6;28;.824;3600000;0
33165;-1;94;0;0;0;0;.00nan;0;0
33165;-1;102;0;0;0;0;.00nan;0;0
33166;210428;103;74;50;5;45;.900;3600000;0
33166;215575;100;21;25;6;19;.760;3300000;0
33166;212368;100;50;1;0;1;1.000;245000;0
33166;-1;103;0;0;0;0;.00nan;0;0
33167;205015;105;0;0;0;0;.00nan;0;0
33167;205112;105;62;24;2;22;.917;3597000;0
33167;205119;106;0;0;0;0;.00nan;0;0
33167;210368;106;89;28;1;27;.964;3600000;0
33168;210439;98;91;40;1;39;.975;3900000;0
33168;215733;99;0;0;0;0;.00nan;0;0
33168;207118;98;0;0;0;0;.00nan;0;0
33168;-1;99;68;18;1;17;.944;3900000;0
33169;209784;91;37;36;6;30;.833;3600000;0
33169;205318;97;75;30;2;28;.933;3600000;0
33169;205429;91;0;0;0;0;.00nan;0;0
33169;212354;97;0;0;0;0;.00nan;0;0
33170;210222;90;41;24;4;20;.833;2311000;0
33170;217437;88;0;0;0;0;.00nan;0;0
33170;207239;90;36;13;3;10;.769;1289000;0
33170;-1;88;95;47;2;45;.957;3600000;0
33171;210428;103;99;41;1;40;.976;3600000;0
33171;215575;100;0;0;0;0;.00nan;0;0
33171;212368;100;42;16;3;13;.813;3516000;0
33171;-1;103;0;0;0;0;.00nan;0;0
33172;205124;89;74;33;2;31;.939;3543000;0
33172;205799;86;75;27;1;26;.963;3600000;0
33172;-1;86;0;0;0;0;.00nan;0;0
33172;-1;89;0;0;0;0;.00nan;0;0
33173;215735;93;0;0;0;0;.00nan;0;0
33173;212343;96;0;0;0;0;.00nan;0;0
33173;-1;96;37;29;5;24;.828;3821000;0
33173;-1;93;45;24;4;20;.833;3821000;0
33174;205119;106;0;0;0;0;.00nan;0;0
33174;210368;106;65;27;2;25;.926;3900000;0
33174;210603;104;99;43;2;41;.953;3900000;0
33174;208300;104;0;0;0;0;.00nan;0;0
33175;212487;95;0;0;0;0;.00nan;0;0
33175;-1;95;56;18;3;15;.833;3756000;0
33175;-1;92;100;44;2;42;.955;3756000;0
33175;-1;92;0;0;0;0;.00nan;0;0
33176;209796;107;74;12;0;12;1.000;3600000;0
33176;220816;107;0;0;0;0;.00nan;0;0
33176;210439;98;0;0;0;0;.00nan;0;0
33176;207118;98;58;39;4;35;.897;3600000;0
33177;208417;101;78;31;4;27;.871;3600000;0
33177;205015;105;60;30;3;27;.900;3005000;0
33177;205112;105;31;10;3;7;.700;509000;0
33177;220873;101;0;0;0;0;.00nan;0;0
33178;205076;87;54;42;5;37;.881;3555000;0
33178;205799;86;55;29;4;25;.862;3600000;0
33178;-1;86;0;0;0;0;.00nan;0;0
33178;-1;87;0;0;0;0;.00nan;0;0
33179;209796;107;47;36;5;31;.861;3600000;0
33179;220816;107;0;0;0;0;.00nan;0;0
33179;215785;94;93;31;1;30;.968;3600000;0
33179;-1;94;0;0;0;0;.00nan;0;0
33180;205076;87;94;20;0;20;1.000;3600000;0
33180;210222;90;25;5;3;2;.400;376000;0
33180;207239;90;97;43;1;42;.977;3224000;0
33180;-1;87;0;0;0;0;.00nan;0;0
33181;205124;89;53;27;4;23;.852;3575000;0
33181;217437;88;71;35;3;32;.914;3600000;0
33181;-1;88;0;0;0;0;.00nan;0;0
33181;-1;89;0;0;0;0;.00nan;0;0
33182;210222;90;72;32;2;30;.938;3600000;0
33182;217437;88;72;46;4;42;.913;3268000;0
33182;207239;90;0;0;0;0;.00nan;0;0
33182;-1;88;51;2;0;2;1.000;289000;0
33183;205076;87;69;29;3;26;.897;3537000;0
33183;205124;89;0;0;0;0;.00nan;0;0
33183;-1;89;82;23;1;22;.957;3600000;0
33183;-1;87;0;0;0;0;.00nan;0;0
33184;209784;91;72;45;4;41;.911;3583000;0
33184;205429;91;0;0;0;0;.00nan;0;0
33184;-1;92;60;26;3;23;.885;3600000;0
33184;-1;92;0;0;0;0;.00nan;0;0
33185;205318;97;0;0;0;0;.00nan;0;0
33185;212343;96;63;34;3;31;.912;3556000;0
33185;212354;97;88;24;1;23;.958;3600000;0
33185;-1;96;0;0;0;0;.00nan;0;0
33186;215735;93;0;0;0;0;.00nan;0;0
33186;212487;95;86;16;0;16;1.000;3600000;0
33186;-1;93;28;30;7;23;.767;3600000;0
33186;-1;95;0;0;0;0;.00nan;0;0
33187;215733;99;0;0;0;0;.00nan;0;0
33187;210923;102;59;30;5;25;.833;3652000;0
33187;-1;99;36;28;6;22;.786;3652000;0
33187;-1;102;0;0;0;0;.00nan;0;0
33188;209796;107;100;45;2;43;.956;3900000;0
33188;205119;106;0;0;0;0;.00nan;0;0
33188;210368;106;73;32;2;30;.938;3900000;0
33188;220816;107;0;0;0;0;.00nan;0;0
33189;210439;98;0;0;0;0;.00nan;0;0
33189;215575;100;47;24;4;20;.833;3600000;0
33189;212368;100;0;0;0;0;.00nan;0;0
33189;207118;98;49;42;6;36;.857;3571000;0
33190;210222;90;0;0;0;0;.00nan;0;0
33190;212343;96;0;0;0;0;.00nan;0;0
33190;207239;90;56;46;5;41;.891;3600000;0
33190;-1;96;100;30;0;30;1.000;3600000;0
33191;209784;91;48;0;0;0;.00nan;371000;0
33191;205429;91;39;40;6;34;.850;3229000;0
33191;205799;86;76;23;1;22;.957;3600000;0
33191;-1;86;0;0;0;0;.00nan;0;0
33192;205124;89;25;24;5;19;.792;3900000;0
33192;217437;88;0;0;0;0;.00nan;0;0
33192;-1;88;64;38;5;33;.868;3900000;0
33192;-1;89;0;0;0;0;.00nan;0;0
33193;205015;105;0;0;0;0;.00nan;0;0
33193;205112;105;47;29;4;25;.862;3554000;0
33193;210603;104;88;37;2;35;.946;3600000;0
33193;208300;104;0;0;0;0;.00nan;0;0
33194;210428;103;44;30;5;25;.833;3600000;0
33194;215785;94;100;26;0;26;1.000;3600000;0
33194;-1;94;0;0;0;0;.00nan;0;0
33194;-1;103;0;0;0;0;.00nan;0;0
33195;209796;107;75;18;1;17;.944;3600000;0
33195;220816;107;0;0;0;0;.00nan;0;0
33195;210923;102;30;29;6;23;.793;2158000;0
33195;-1;102;35;14;3;11;.786;1442000;0
33196;210439;98;0;0;0;0;.00nan;0;0
33196;215575;100;0;0;0;0;.00nan;0;0
33196;212368;100;56;32;5;27;.844;3540000;0
33196;207118;98;72;28;3;25;.893;3600000;0
33197;208417;101;0;0;0;0;.00nan;0;0
33197;205119;106;50;36;5;31;.861;3600000;0
33197;210368;106;0;0;0;0;.00nan;0;0
33197;220873;101;68;33;2;31;.939;3600000;0
33198;205318;97;63;31;4;27;.871;3600000;0
33198;205799;86;51;17;3;14;.824;2047000;0
33198;212354;97;0;0;0;0;.00nan;0;0
33198;-1;86;19;23;6;17;.739;1553000;0
33199;215735;93;0;0;0;0;.00nan;0;0
33199;212487;95;0;0;0;0;.00nan;0;0
33199;-1;93;48;27;4;23;.852;3600000;0
33199;-1;95;72;22;1;21;.955;3600000;0
33200;205119;106;0;0;0;0;.00nan;0;0
33200;210368;106;39;32;5;27;.844;3600000;0
33200;215733;99;0;0;0;0;.00nan;0;0
33200;-1;99;67;22;1;21;.955;3600000;0
33201;205076;87;0;0;0;0;.00nan;0;0
33201;212487;95;38;30;6;24;.800;3600000;0
33201;-1;95;0;0;0;0;.00nan;0;0
33201;-1;87;91;34;1;33;.971;3600000;0
33202;208417;101;0;0;0;0;.00nan;0;0
33202;220873;101;79;26;2;24;.923;3554000;0
33202;215575;100;95;22;0;22;1.000;3600000;0
33202;212368;100;0;0;0;0;.00nan;0;0
33203;210222;90;51;30;4;26;.867;3600000;0
33203;212343;96;0;0;0;0;.00nan;0;0
33203;207239;90;0;0;0;0;.00nan;0;0
33203;-1;96;32;28;5;23;.821;3566000;0
33204;209784;91;67;38;3;35;.921;3579000;0
33204;205124;89;0;0;0;0;.00nan;0;0
33204;205429;91;0;0;0;0;.00nan;0;0
33204;-1;89;80;24;1;23;.958;3600000;0
33205;205799;86;28;25;6;19;.760;3553000;0
33205;212487;95;0;0;0;0;.00nan;0;0
33205;-1;86;0;0;0;0;.00nan;0;0
33205;-1;95;41;28;5;23;.821;3600000;0
33206;208417;101;54;19;2;17;.895;3544000;0
33206;220873;101;0;0;0;0;.00nan;0;0
33206;215575;100;0;0;0;0;.00nan;0;0
33206;212368;100;92;29;1;28;.966;3600000;0
33207;215735;93;54;33;4;29;.879;3900000;0
33207;217437;88;82;48;4;44;.917;3900000;0
33207;-1;88;0;0;0;0;.00nan;0;0
33207;-1;93;0;0;0;0;.00nan;0;0
33208;205076;87;83;46;3;43;.935;3600000;0
33208;-1;92;0;0;0;0;.00nan;0;0
33208;-1;87;0;0;0;0;.00nan;0;0
33208;-1;92;68;40;4;36;.900;3599000;0
33209;209784;91;0;0;0;0;.00nan;0;0
33209;205429;91;87;31;1;30;.968;3600000;0
33209;212343;96;68;47;5;42;.894;3153000;0
33209;-1;96;43;5;1;4;.800;447000;0
33210;210439;98;0;0;0;0;.00nan;0;0
33210;210923;102;100;25;0;25;1.000;3600000;0
33210;207118;98;81;33;2;31;.939;3600000;0
33210;-1;102;0;0;0;0;.00nan;0;0
33211;209796;107;55;16;2;14;.875;3600000;0
33211;205015;105;58;34;4;30;.882;3574000;0
33211;205112;105;0;0;0;0;.00nan;0;0
33211;220816;107;0;0;0;0;.00nan;0;0
33212;205119;106;0;0;0;0;.00nan;0;0
33212;210368;106;44;25;4;21;.840;3600000;0
33212;215575;100;0;0;0;0;.00nan;0;0
33212;212368;100;100;26;0;26;1.000;3600000;0
33213;210603;104;100;33;0;33;1.000;3600000;0
33213;215785;94;79;25;1;24;.960;3588000;0
33213;208300;104;0;0;0;0;.00nan;0;0
33213;-1;94;0;0;0;0;.00nan;0;0
33214;210222;90;100;30;0;30;1.000;3600000;0
33214;205318;97;51;47;6;41;.872;3600000;0
33214;212354;97;0;0;0;0;.00nan;0;0
33214;207239;90;0;0;0;0;.00nan;0;0
33215;209784;91;80;29;1;28;.966;3600000;0
33215;205429;91;0;0;0;0;.00nan;0;0
33215;217437;88;0;0;0;0;.00nan;0;0
33215;-1;88;74;36;3;33;.917;3523000;0
33216;205015;105;0;0;0;0;.00nan;0;0
33216;205112;105;64;29;2;27;.931;3900000;0
33216;215733;99;0;0;0;0;.00nan;0;0
33216;-1;99;70;23;2;21;.913;3900000;0
33217;205119;106;29;22;6;16;.727;3600000;0
33217;210368;106;0;0;0;0;.00nan;0;0
33217;215575;100;62;48;6;42;.875;3165000;0
33217;212368;100;41;9;2;7;.778;351000;0
33218;215735;93;0;0;0;0;.00nan;0;0
33218;-1;93;49;37;5;32;.865;3570000;0
33218;-1;92;78;41;4;37;.902;3600000;0
33218;-1;92;0;0;0;0;.00nan;0;0
33219;205124;89;0;0;0;0;.00nan;0;0
33219;205799;86;53;35;5;30;.857;3571000;0
33219;-1;86;0;0;0;0;.00nan;0;0
33219;-1;89;76;35;3;32;.914;3600000;0
33220;205076;87;0;0;0;0;.00nan;0;0
33220;212487;95;0;0;0;0;.00nan;0;0
33220;-1;95;77;25;1;24;.960;3600000;0
33220;-1;87;58;35;4;31;.886;3600000;0
33221;209796;107;30;29;6;23;.793;2946000;0
33221;220816;107;46;5;1;4;.800;654000;0
33221;210428;103;62;30;3;27;.900;3600000;0
33221;-1;103;0;0;0;0;.00nan;0;0
33222;208417;101;0;0;0;0;.00nan;0;0
33222;220873;101;64;16;1;15;.938;3832000;0
33222;215785;94;69;25;2;23;.920;3832000;0
33222;-1;94;0;0;0;0;.00nan;0;0
33223;205119;106;0;0;0;0;.00nan;0;0
33223;210368;106;81;46;3;43;.935;3600000;0
33223;210923;102;69;29;2;27;.931;3600000;0
33223;-1;102;0;0;0;0;.00nan;0;0
33224;208417;101;57;19;2;17;.895;3600000;0
33224;220873;101;0;0;0;0;.00nan;0;0
33224;210439;98;45;36;6;30;.833;3600000;0
33224;207118;98;0;0;0;0;.00nan;0;0
33225;215735;93;0;0;0;0;.00nan;0;0
33225;212487;95;65;31;4;27;.871;3596000;0
33225;-1;93;77;35;3;32;.914;3600000;0
33225;-1;95;0;0;0;0;.00nan;0;0
33226;205318;97;91;34;2;32;.941;3900000;0
33226;212354;97;0;0;0;0;.00nan;0;0
33226;217437;88;87;36;2;34;.944;3900000;0
33226;-1;88;0;0;0;0;.00nan;0;0
33227;210222;90;61;45;5;40;.889;3600000;0
33227;215735;93;79;26;1;25;.962;3600000;0
33227;207239;90;0;0;0;0;.00nan;0;0
33227;-1;93;0;0;0;0;.00nan;0;0
33228;205124;89;57;23;3;20;.870;3600000;0
33228;205318;97;24;33;7;26;.788;3600000;0
33228;212354;97;0;0;0;0;.00nan;0;0
33228;-1;89;0;0;0;0;.00nan;0;0
33229;215575;100;0;0;0;0;.00nan;0;0
33229;212343;96;0;0;0;0;.00nan;0;0
33229;212368;100;68;23;2;21;.913;3570000;0
33229;-1;96;99;27;0;27;1.000;3600000;0
33230;215785;94;29;15;4;11;.733;3600000;0
33230;210923;102;75;41;3;38;.927;3600000;0
33230;-1;94;0;0;0;0;.00nan;0;0
33230;-1;102;0;0;0;0;.00nan;0;0
33231;215735;93;0;0;0;0;.00nan;0;0
33231;217437;88;91;20;0;20;1.000;3600000;0
33231;-1;88;0;0;0;0;.00nan;0;0
33231;-1;93;98;42;1;41;.976;3600000;0
33232;205076;87;65;33;4;29;.879;3629000;0
33232;205318;97;48;34;5;29;.853;3629000;0
33232;212354;97;0;0;0;0;.00nan;0;0
33232;-1;87;0;0;0;0;.00nan;0;0
33233;205124;89;0;0;0;0;.00nan;0;0
33233;-1;89;33;32;6;26;.813;3600000;0
33233;-1;92;98;41;2;39;.951;3600000;0
33233;-1;92;0;0;0;0;.00nan;0;0
33234;205015;105;65;34;3;31;.912;3600000;0
33234;205112;105;0;0;0;0;.00nan;0;0
33234;210923;102;44;25;4;21;.840;3574000;0
33234;-1;102;0;0;0;0;.00nan;0;0
33235;215733;99;65;14;1;13;.929;3600000;0
33235;212343;96;0;0;0;0;.00nan;0;0
33235;-1;96;48;46;7;39;.848;3600000;0
33235;-1;99;0;0;0;0;.00nan;0;0
33236;208417;101;36;18;4;14;.778;3542000;0
33236;220873;101;0;0;0;0;.00nan;0;0
33236;215575;100;85;33;2;31;.939;3600000;0
33236;212368;100;0;0;0;0;.00nan;0;0
33237;205119;106;0;0;0;0;.00nan;0;0
33237;210368;106;72;31;2;29;.935;3600000;0
33237;210603;104;82;36;3;33;.917;3556000;0
33237;208300;104;0;0;0;0;.00nan;0;0
33238;210222;90;21;22;6;16;.727;2392000;0
33238;210428;103;74;29;2;27;.931;3600000;0
33238;207239;90;63;8;0;8;1.000;1208000;0
33238;-1;103;0;0;0;0;.00nan;0;0
33239;209796;107;53;25;3;22;.880;3900000;0
33239;220816;107;0;0;0;0;.00nan;0;0
33239;210439;98;0;0;0;0;.00nan;0;0
33239;207118;98;76;43;3;40;.930;3900000;0
33240;205076;87;0;0;0;0;.00nan;0;0
33240;217437;88;22;20;6;14;.700;3000000;0
33240;-1;88;40;2;1;1;.500;600000;0
33240;-1;87;72;26;2;24;.923;3600000;0
33241;205124;89;52;22;3;19;.864;3600000;0
33241;215735;93;30;40;7;33;.825;3357000;0
33241;-1;93;39;1;1;0;.000;243000;0
33241;-1;89;0;0;0;0;.00nan;0;0
33242;205318;97;0;0;0;0;.00nan;0;0
33242;205799;86;71;16;1;15;.938;3600000;0
33242;212354;97;76;50;4;46;.920;3600000;0
33242;-1;86;0;0;0;0;.00nan;0;0
33243;210222;90;74;31;2;29;.935;3312000;0
33243;215785;94;58;22;3;19;.864;3600000;0
33243;207239;90;22;4;3;1;.250;288000;0
33243;-1;94;0;0;0;0;.00nan;0;0
33244;210428;103;0;0;0;0;.00nan;0;0
33244;210923;102;85;39;2;37;.949;3545000;0
33244;-1;103;81;29;1;28;.966;3600000;0
33244;-1;102;0;0;0;0;.00nan;0;0
33245;210439;98;100;38;0;38;1.000;3600000;0
33245;212343;96;54;29;4;25;.862;2900000;0
33245;207118;98;0;0;0;0;.00nan;0;0
33245;-1;96;63;9;0;9;1.000;700000;0
33246;208417;101;0;0;0;0;.00nan;0;0
33246;209784;91;58;13;1;12;.923;1367000;0
33246;220873;101;96;28;1;27;.964;3600000;0
33246;205429;91;29;22;5;17;.773;2233000;0
33247;212487;95;100;36;3;33;.917;3600000;0
33247;-1;95;0;0;0;0;.00nan;0;0
33247;-1;92;21;18;5;13;.722;1932000;0
33247;-1;92;58;14;1;13;.929;1668000;0
33248;205015;105;0;0;0;0;.00nan;0;0
33248;205112;105;72;29;3;26;.897;3566000;0
33248;210428;103;73;34;2;32;.941;3600000;0
33248;-1;103;0;0;0;0;.00nan;0;0
33249;205076;87;38;25;5;20;.800;3600000;0
33249;205799;86;0;0;0;0;.00nan;0;0
33249;-1;86;56;25;3;22;.880;3600000;0
33249;-1;87;0;0;0;0;.00nan;0;0
33250;205124;89;0;0;0;0;.00nan;0;0
33250;217437;88;99;32;1;31;.969;3600000;0
33250;-1;88;0;0;0;0;.00nan;0;0
33250;-1;89;64;28;3;25;.893;3545000;0
33251;212487;95;0;0;0;0;.00nan;0;0
33251;-1;95;54;31;4;27;.871;3571000;0
33251;-1;92;0;0;0;0;.00nan;0;0
33251;-1;92;65;28;2;26;.929;3600000;0
33252;210923;102;48;22;3;19;.864;3553000;0
33252;212343;96;0;0;0;0;.00nan;0;0
33252;-1;96;93;44;2;42;.955;3600000;0
33252;-1;102;0;0;0;0;.00nan;0;0
33253;210222;90;57;25;3;22;.880;3524000;0
33253;210603;104;100;40;1;39;.975;3600000;0
33253;207239;90;0;0;0;0;.00nan;0;0
33253;208300;104;0;0;0;0;.00nan;0;0
33254;209784;91;40;24;4;20;.833;3600000;0
33254;210439;98;23;33;7;26;.788;3600000;0
33254;205429;91;0;0;0;0;.00nan;0;0
33254;207118;98;0;0;0;0;.00nan;0;0
33255;205318;97;39;30;5;25;.833;3560000;0
33255;215735;93;47;25;4;21;.840;3600000;0
33255;212354;97;0;0;0;0;.00nan;0;0
33255;-1;93;0;0;0;0;.00nan;0;0
33256;205015;105;0;0;0;0;.00nan;0;0
33256;210222;90;0;0;0;0;.00nan;0;0
33256;205112;105;54;13;1;12;.923;3600000;0
33256;207239;90;47;33;5;28;.848;3600000;0
33257;209784;91;0;0;0;0;.00nan;0;0
33257;205429;91;79;53;5;48;.906;3600000;0
33257;215733;99;0;0;0;0;.00nan;0;0
33257;-1;99;62;17;2;15;.882;3600000;0
33258;208417;101;0;0;0;0;.00nan;0;0
33258;220873;101;69;24;1;23;.958;3600000;0
33258;212343;96;78;39;3;36;.923;3565000;0
33258;-1;96;0;0;0;0;.00nan;0;0
33259;205119;106;0;0;0;0;.00nan;0;0
33259;210368;106;78;28;2;26;.929;3600000;0
33259;210428;103;69;36;4;32;.889;3600000;0
33259;-1;103;0;0;0;0;.00nan;0;0
33260;205799;86;100;26;0;26;1.000;3600000;0
33260;212487;95;71;34;3;31;.912;3600000;0
33260;-1;86;0;0;0;0;.00nan;0;0
33260;-1;95;0;0;0;0;.00nan;0;0
33261;205318;97;73;31;3;28;.903;3600000;0
33261;210603;104;49;46;7;39;.848;3600000;0
33261;212354;97;0;0;0;0;.00nan;0;0
33261;208300;104;0;0;0;0;.00nan;0;0
33262;215735;93;0;0;0;0;.00nan;0;0
33262;-1;93;94;45;3;42;.933;3600000;0
33262;-1;92;26;12;4;8;.667;1031000;0
33262;-1;92;57;28;3;25;.893;2569000;0
33263;205076;87;66;29;3;26;.897;3600000;0
33263;205124;89;62;8;0;8;1.000;363000;0
33263;-1;89;29;28;6;22;.786;3237000;0
33263;-1;87;0;0;0;0;.00nan;0;0
33264;209784;91;0;0;0;0;.00nan;0;0
33264;205429;91;70;35;3;32;.914;3900000;0
33264;210923;102;59;33;3;30;.909;3900000;0
33264;-1;102;0;0;0;0;.00nan;0;0
33265;205119;106;0;0;0;0;.00nan;0;0
33265;210368;106;71;43;4;39;.907;3588000;0
33265;215733;99;0;0;0;0;.00nan;0;0
33265;-1;99;70;20;2;18;.900;3600000;0
33266;208417;101;0;0;0;0;.00nan;0;0
33266;220873;101;92;14;0;14;1.000;3600000;0
33266;210428;103;61;45;6;39;.867;3600000;0
33266;-1;103;0;0;0;0;.00nan;0;0
33267;209796;107;82;27;1;26;.963;3600000;0
33267;210222;90;79;44;4;40;.909;3600000;0
33267;220816;107;0;0;0;0;.00nan;0;0
33267;207239;90;0;0;0;0;.00nan;0;0
33268;210439;98;0;0;0;0;.00nan;0;0
33268;215785;94;42;32;5;27;.844;3553000;0
33268;207118;98;72;37;4;33;.892;3600000;0
33268;-1;94;0;0;0;0;.00nan;0;0
33269;205076;87;0;0;0;0;.00nan;0;0
33269;217437;88;85;42;2;40;.952;3600000;0
33269;-1;88;0;0;0;0;.00nan;0;0
33269;-1;87;57;38;5;33;.868;3600000;0
33270;215575;100;0;0;0;0;.00nan;0;0
33270;210923;102;38;41;7;34;.829;3259000;0
33270;212368;100;72;32;3;29;.906;3600000;0
33270;-1;102;57;4;0;4;1.000;341000;0
33271;205799;86;73;26;1;25;.962;3600000;0
33271;-1;86;0;0;0;0;.00nan;0;0
33271;-1;92;85;36;2;34;.944;3577000;0
33271;-1;92;0;0;0;0;.00nan;0;0
33272;210222;90;0;0;0;0;.00nan;0;0
33272;205119;106;67;33;3;30;.909;3542000;0
33272;210368;106;0;0;0;0;.00nan;0;0
33272;207239;90;84;37;2;35;.946;3600000;0
33273;209796;107;0;0;0;0;.00nan;0;0
33273;205015;105;0;0;0;0;.00nan;0;0
33273;205112;105;76;31;2;29;.935;3600000;0
33273;220816;107;77;34;3;31;.912;3562000;0
33274;210439;98;62;40;5;35;.875;3600000;0
33274;215785;94;97;19;0;19;1.000;3600000;0
33274;207118;98;0;0;0;0;.00nan;0;0
33274;-1;94;0;0;0;0;.00nan;0;0
33275;208417;101;0;0;0;0;.00nan;0;0
33275;220873;101;59;21;2;19;.905;3600000;0
33275;215733;99;0;0;0;0;.00nan;0;0
33275;-1;99;49;24;3;21;.875;3546000;0
33276;205318;97;0;0;0;0;.00nan;0;0
33276;215735;93;100;33;0;33;1.000;3600000;0
33276;212354;97;57;20;2;18;.900;3537000;0
33276;-1;93;0;0;0;0;.00nan;0;0
33277;205124;89;25;27;6;21;.778;3600000;0
33277;212343;96;0;0;0;0;.00nan;0;0
33277;-1;96;80;37;3;34;.919;3600000;0
33277;-1;89;0;0;0;0;.00nan;0;0
33278;210603;104;30;27;6;21;.778;1903000;0
33278;212487;95;0;0;0;0;.00nan;0;0
33278;-1;95;47;12;2;10;.833;3600000;0
33278;208300;104;85;32;1;31;.969;1697000;0
33279;215733;99;63;24;2;22;.917;3600000;0
33279;215785;94;45;35;6;29;.829;3600000;0
33279;-1;99;0;0;0;0;.00nan;0;0
33279;-1;94;0;0;0;0;.00nan;0;0
33280;209796;107;98;26;0;26;1.000;3600000;0
33280;220816;107;0;0;0;0;.00nan;0;0
33280;210428;103;59;27;3;24;.889;3600000;0
33280;-1;103;0;0;0;0;.00nan;0;0
33281;209784;91;0;0;0;0;.00nan;0;0
33281;215575;100;36;27;5;22;.815;3570000;0
33281;205429;91;68;35;4;31;.886;3600000;0
33281;212368;100;0;0;0;0;.00nan;0;0
33282;210603;104;59;38;4;34;.895;3600000;0
33282;208300;104;0;0;0;0;.00nan;0;0
33282;-1;92;0;0;0;0;.00nan;0;0
33282;-1;92;92;30;1;29;.967;3600000;0
33283;205799;86;63;21;2;19;.905;3600000;0
33283;217437;88;86;43;3;40;.930;3575000;0
33283;-1;86;0;0;0;0;.00nan;0;0
33283;-1;88;0;0;0;0;.00nan;0;0
33284;205119;106;0;0;0;0;.00nan;0;0
33284;210368;106;67;25;3;22;.880;3600000;0
33284;210923;102;58;37;5;32;.865;3554000;0
33284;-1;102;0;0;0;0;.00nan;0;0
33285;215735;93;81;16;0;16;1.000;3600000;0
33285;210603;104;0;0;0;0;.00nan;0;0
33285;-1;93;0;0;0;0;.00nan;0;0
33285;208300;104;65;51;6;45;.882;3600000;0
33286;205076;87;69;27;2;25;.926;3600000;0
33286;212343;96;64;36;4;32;.889;3590000;0
33286;-1;96;0;0;0;0;.00nan;0;0
33286;-1;87;0;0;0;0;.00nan;0;0
33287;208417;101;59;22;2;20;.909;3600000;0
33287;220873;101;0;0;0;0;.00nan;0;0
33287;210439;98;0;0;0;0;.00nan;0;0
33287;207118;98;69;41;4;37;.902;3576000;0
33288;209796;107;39;23;4;19;.826;3900000;0
33288;220816;107;0;0;0;0;.00nan;0;0
33288;210428;103;73;35;4;31;.886;3877000;0
33288;-1;103;0;0;0;0;.00nan;0;0
33289;210222;90;84;28;2;26;.929;3600000;0
33289;217437;88;55;27;4;23;.852;3551000;0
33289;207239;90;0;0;0;0;.00nan;0;0
33289;-1;88;0;0;0;0;.00nan;0;0
33290;205318;97;93;27;1;26;.963;3600000;0
33290;215735;93;62;30;3;27;.900;3514000;0
33290;212354;97;0;0;0;0;.00nan;0;0
33290;-1;93;0;0;0;0;.00nan;0;0
33291;209784;91;51;27;3;24;.889;3526000;0
33291;205429;91;0;0;0;0;.00nan;0;0
33291;212487;95;0;0;0;0;.00nan;0;0
33291;-1;95;63;18;1;17;.944;3600000;0
33292;205015;105;0;0;0;0;.00nan;0;0
33292;205112;105;71;27;2;25;.926;3600000;0
33292;-1;92;28;32;6;26;.813;3600000;0
33292;-1;92;0;0;0;0;.00nan;0;0
33293;205124;89;45;43;6;37;.860;3559000;0
33293;205799;86;38;29;5;24;.828;3600000;0
33293;-1;86;0;0;0;0;.00nan;0;0
33293;-1;89;0;0;0;0;.00nan;0;0
33294;210603;104;72;35;4;31;.886;3600000;0
33294;212343;96;0;0;0;0;.00nan;0;0
33294;-1;96;54;33;5;28;.848;3543000;0
33294;208300;104;0;0;0;0;.00nan;0;0
33295;210428;103;100;29;0;29;1.000;3600000;0
33295;210923;102;74;27;1;26;.963;3583000;0
33295;-1;103;0;0;0;0;.00nan;0;0
33295;-1;102;0;0;0;0;.00nan;0;0
33296;210439;98;86;51;4;47;.922;3600000;0
33296;215733;99;0;0;0;0;.00nan;0;0
33296;207118;98;0;0;0;0;.00nan;0;0
33296;-1;99;93;28;1;27;.964;3600000;0
33297;208417;101;0;0;0;0;.00nan;0;0
33297;220873;101;79;27;1;26;.963;3900000;0
33297;215785;94;95;36;1;35;.972;3900000;0
33297;-1;94;0;0;0;0;.00nan;0;0
33298;209796;107;68;24;2;22;.917;3600000;0
33298;205119;106;0;0;0;0;.00nan;0;0
33298;210368;106;25;20;6;14;.700;3600000;0
33298;220816;107;0;0;0;0;.00nan;0;0
33299;210222;90;100;50;3;47;.940;3900000;0
33299;205799;86;57;25;3;22;.880;3900000;0
33299;207239;90;0;0;0;0;.00nan;0;0
33299;-1;86;0;0;0;0;.00nan;0;0
33300;205318;97;0;0;0;0;.00nan;0;0
33300;212354;97;50;26;4;22;.846;3600000;0
33300;-1;92;0;0;0;0;.00nan;0;0
33300;-1;92;56;29;3;26;.897;3600000;0
33301;210428;103;34;30;6;24;.800;3256000;0
33301;210923;102;31;19;4;15;.789;3600000;0
33301;-1;103;49;2;0;2;1.000;331000;0
33301;-1;102;0;0;0;0;.00nan;0;0
33302;209784;91;0;0;0;0;.00nan;0;0
33302;205429;91;55;24;3;21;.875;3593000;0
33302;210603;104;0;0;0;0;.00nan;0;0
33302;208300;104;78;28;2;26;.929;3600000;0
33303;215575;100;21;19;5;14;.737;3582000;0
33303;212368;100;0;0;0;0;.00nan;0;0
33303;217437;88;70;40;4;36;.900;3600000;0
33303;-1;88;0;0;0;0;.00nan;0;0
33304;205076;87;70;34;3;31;.912;3570000;0
33304;212343;96;82;34;2;32;.941;3600000;0
33304;-1;96;0;0;0;0;.00nan;0;0
33304;-1;87;0;0;0;0;.00nan;0;0
33305;208417;101;40;32;5;27;.844;3600000;0
33305;205119;106;80;31;2;29;.935;3600000;0
33305;210368;106;0;0;0;0;.00nan;0;0
33305;220873;101;0;0;0;0;.00nan;0;0
33306;205015;105;78;35;3;32;.914;3600000;0
33306;205112;105;0;0;0;0;.00nan;0;0
33306;212487;95;52;33;4;29;.879;3548000;0
33306;-1;95;0;0;0;0;.00nan;0;0
33307;209796;107;45;26;4;22;.846;3600000;0
33307;220816;107;0;0;0;0;.00nan;0;0
33307;215785;94;0;0;0;0;.00nan;0;0
33307;-1;94;51;22;3;19;.864;3600000;0
33308;210439;98;0;0;0;0;.00nan;0;0
33308;215733;99;0;0;0;0;.00nan;0;0
33308;207118;98;100;50;2;48;.960;3600000;0
33308;-1;99;62;25;3;22;.880;3600000;0
33309;205076;87;0;0;0;0;.00nan;0;0
33309;217437;88;0;0;0;0;.00nan;0;0
33309;-1;88;25;36;7;29;.806;3600000;0
33309;-1;87;59;34;4;30;.882;3600000;0
33310;205124;89;0;0;0;0;.00nan;0;0
33310;215575;100;0;0;0;0;.00nan;0;0
33310;212368;100;68;27;3;24;.889;3527000;0
33310;-1;89;94;31;1;30;.968;3600000;0
33311;215733;99;63;28;3;25;.893;3600000;0
33311;210923;102;52;41;6;35;.854;3600000;0
33311;-1;99;0;0;0;0;.00nan;0;0
33311;-1;102;0;0;0;0;.00nan;0;0
33312;205015;105;0;0;0;0;.00nan;0;0
33312;205112;105;74;19;1;18;.947;3600000;0
33312;205318;97;65;33;3;30;.909;3542000;0
33312;212354;97;0;0;0;0;.00nan;0;0
33313;210222;90;95;52;4;48;.923;3600000;0
33313;215575;100;0;0;0;0;.00nan;0;0
33313;212368;100;100;32;0;32;1.000;3600000;0
33313;207239;90;0;0;0;0;.00nan;0;0
33314;209796;107;77;30;3;27;.900;3623000;0
33314;220816;107;0;0;0;0;.00nan;0;0
33314;215735;93;0;0;0;0;.00nan;0;0
33314;-1;93;63;29;4;25;.862;3623000;0
33315;209784;91;0;0;0;0;.00nan;0;0
33315;205015;105;55;34;4;30;.882;3548000;0
33315;205112;105;0;0;0;0;.00nan;0;0
33315;205429;91;68;30;3;27;.900;3600000;0
33316;205076;87;100;25;0;25;1.000;3600000;0
33316;205124;89;0;0;0;0;.00nan;0;0
33316;-1;89;70;36;3;33;.917;3600000;0
33316;-1;87;0;0;0;0;.00nan;0;0
33317;210428;103;80;36;2;34;.944;3600000;0
33317;215733;99;0;0;0;0;.00nan;0;0
33317;-1;99;35;31;6;25;.806;3600000;0
33317;-1;103;0;0;0;0;.00nan;0;0
33318;205076;87;60;50;5;45;.900;3600000;0
33318;205799;86;70;26;2;24;.923;3600000;0
33318;-1;86;0;0;0;0;.00nan;0;0
33318;-1;87;0;0;0;0;.00nan;0;0
33319;209796;107;53;30;4;26;.867;3582000;0
33319;220816;107;0;0;0;0;.00nan;0;0
33319;205318;97;51;25;3;22;.880;3600000;0
33319;212354;97;0;0;0;0;.00nan;0;0
33320;209784;91;74;37;3;34;.919;3833000;0
33320;205429;91;0;0;0;0;.00nan;0;0
33320;215735;93;56;22;2;20;.909;3833000;0
33320;-1;93;0;0;0;0;.00nan;0;0
33321;210222;90;66;26;2;24;.923;3600000;0
33321;205124;89;71;32;3;29;.906;3585000;0
33321;207239;90;0;0;0;0;.00nan;0;0
33321;-1;89;0;0;0;0;.00nan;0;0
33322;215575;100;0;0;0;0;.00nan;0;0
33322;205799;86;0;0;0;0;.00nan;0;0
33322;212368;100;44;43;7;36;.837;3600000;0
33322;-1;86;65;25;2;23;.920;3600000;0
33323;205015;105;50;17;2;15;.882;2554000;0
33323;205112;105;30;15;4;11;.733;1046000;0
33323;212343;96;64;29;3;26;.897;3600000;0
33323;-1;96;0;0;0;0;.00nan;0;0
33324;212487;95;0;0;0;0;.00nan;0;0
33324;217437;88;90;36;2;34;.944;3550000;0
33324;-1;88;0;0;0;0;.00nan;0;0
33324;-1;95;72;21;1;20;.952;3600000;0
33325;203179;102;70;27;2;25;.926;3558000;0
33325;210923;102;0;0;0;0;.00nan;0;0
33325;-1;92;100;24;0;24;1.000;3600000;0
33325;-1;92;0;0;0;0;.00nan;0;0
33326;205119;106;0;0;0;0;.00nan;0;0
33326;210368;106;56;26;4;22;.846;3639000;0
33326;215733;99;0;0;0;0;.00nan;0;0
33326;-1;99;69;32;3;29;.906;3639000;0
33327;208417;101;0;0;0;0;.00nan;0;0
33327;220873;101;85;16;0;16;1.000;3600000;0
33327;210439;98;51;19;3;16;.842;3600000;0
33327;207118;98;0;0;0;0;.00nan;0;0
33328;210603;104;60;29;3;26;.897;3900000;0
33328;215785;94;82;34;3;31;.912;3900000;0
33328;208300;104;0;0;0;0;.00nan;0;0
33328;-1;94;0;0;0;0;.00nan;0;0
33329;205015;105;0;0;0;0;.00nan;0;0
33329;205112;105;50;23;3;20;.870;3584000;0
33329;215735;93;0;0;0;0;.00nan;0;0
33329;-1;93;100;40;1;39;.975;3600000;0
33330;209784;91;0;0;0;0;.00nan;0;0
33330;209796;107;50;1;0;1;1.000;609000;0
33330;220816;107;25;26;6;20;.769;2908000;0
33330;205429;91;56;29;4;25;.862;3600000;0
33331;205076;87;0;0;0;0;.00nan;0;0
33331;215575;100;34;30;6;24;.800;3323000;0
33331;212368;100;51;2;0;2;1.000;277000;0
33331;-1;87;54;16;2;14;.875;3600000;0
33332;205119;106;82;29;2;27;.931;3600000;0
33332;210368;106;0;0;0;0;.00nan;0;0
33332;210439;98;0;0;0;0;.00nan;0;0
33332;207118;98;23;33;7;26;.788;3600000;0
33333;210428;103;84;29;1;28;.966;3600000;0
33333;215785;94;70;33;3;30;.909;3542000;0
33333;-1;94;0;0;0;0;.00nan;0;0
33333;-1;103;0;0;0;0;.00nan;0;0
33334;203179;102;0;0;0;0;.00nan;0;0
33334;215733;99;45;34;6;28;.824;2986000;0
33334;210923;102;57;23;3;20;.870;3600000;0
33334;-1;99;55;3;0;3;1.000;614000;0
33335;208417;101;0;0;0;0;.00nan;0;0
33335;220873;101;54;28;3;25;.893;3570000;0
33335;-1;92;100;36;1;35;.972;3600000;0
33335;-1;92;0;0;0;0;.00nan;0;0
33336;205124;89;21;9;4;5;.556;903000;0
33336;205799;86;65;21;2;19;.905;3600000;0
33336;-1;86;0;0;0;0;.00nan;0;0
33336;-1;89;60;44;6;38;.864;2697000;0
33337;209796;107;87;41;3;38;.927;3641000;0
33337;220816;107;0;0;0;0;.00nan;0;0
33337;212343;96;82;36;2;34;.944;3641000;0
33337;-1;96;0;0;0;0;.00nan;0;0
33338;205318;97;0;0;0;0;.00nan;0;0
33338;212354;97;94;34;1;33;.971;3600000;0
33338;217437;88;88;45;2;43;.956;3546000;0
33338;-1;88;0;0;0;0;.00nan;0;0
33339;209784;91;54;47;6;41;.872;3600000;0
33339;205429;91;0;0;0;0;.00nan;0;0
33339;212487;95;0;0;0;0;.00nan;0;0
33339;-1;95;82;10;0;10;1.000;3600000;0
33340;208417;101;0;0;0;0;.00nan;0;0
33340;220873;101;35;28;5;23;.821;3900000;0
33340;210428;103;72;48;5;43;.896;3900000;0
33340;-1;103;0;0;0;0;.00nan;0;0
33341;210439;98;34;34;6;28;.824;1920000;0
33341;207118;98;73;19;1;18;.947;1680000;0
33341;-1;92;73;21;1;20;.952;3600000;0
33341;-1;92;0;0;0;0;.00nan;0;0
33342;205124;89;39;34;5;29;.853;3557000;0
33342;205799;86;48;29;4;25;.862;3600000;0
33342;-1;86;0;0;0;0;.00nan;0;0
33342;-1;89;0;0;0;0;.00nan;0;0
33343;205119;106;0;0;0;0;.00nan;0;0
33343;210368;106;100;33;0;33;1.000;3600000;0
33343;212343;96;0;0;0;0;.00nan;0;0
33343;-1;96;72;41;3;38;.927;3600000;0
33344;205076;87;52;29;4;25;.862;3600000;0
33344;215735;93;26;31;6;25;.806;3258000;0
33344;-1;93;51;4;0;4;1.000;272000;0
33344;-1;87;0;0;0;0;.00nan;0;0
33345;203179;102;0;0;0;0;.00nan;0;0
33345;205015;105;92;36;1;35;.972;3600000;0
33345;205112;105;0;0;0;0;.00nan;0;0
33345;210923;102;49;28;4;24;.857;3600000;0
33346;215733;99;0;0;0;0;.00nan;0;0
33346;-1;92;0;0;0;0;.00nan;0;0
33346;-1;99;45;24;4;20;.833;3900000;0
33346;-1;92;61;38;4;34;.895;3900000;0
33347;210222;90;43;30;6;24;.800;2426000;0
33347;217437;88;53;26;4;22;.846;3600000;0
33347;207239;90;33;9;3;6;.667;1174000;0
33347;-1;88;0;0;0;0;.00nan;0;0
33348;209784;91;0;0;0;0;.00nan;0;0
33348;205429;91;53;32;4;28;.875;3584000;0
33348;217437;88;0;0;0;0;.00nan;0;0
33348;-1;88;71;32;3;29;.906;3600000;0
33349;205799;86;64;24;2;22;.917;3600000;0
33349;212343;96;67;34;3;31;.912;3590000;0
33349;-1;86;0;0;0;0;.00nan;0;0
33349;-1;96;0;0;0;0;.00nan;0;0
33350;205318;97;87;39;3;36;.923;3562000;0
33350;212354;97;0;0;0;0;.00nan;0;0
33350;212487;95;0;0;0;0;.00nan;0;0
33350;-1;95;95;34;2;32;.941;3600000;0
33351;205119;106;0;0;0;0;.00nan;0;0
33351;210368;106;51;31;4;27;.871;3600000;0
33351;215735;93;0;0;0;0;.00nan;0;0
33351;-1;93;99;37;1;36;.973;3600000;0
33352;215575;100;68;30;3;27;.900;3694000;0
33352;212368;100;0;0;0;0;.00nan;0;0
33352;-1;92;59;31;4;27;.871;3694000;0
33352;-1;92;0;0;0;0;.00nan;0;0
33353;205015;105;0;0;0;0;.00nan;0;0
33353;205112;105;61;27;3;24;.889;3574000;0
33353;215733;99;0;0;0;0;.00nan;0;0
33353;-1;99;72;27;2;25;.926;3600000;0
33354;205076;87;64;33;5;28;.848;3900000;0
33354;215785;94;67;40;5;35;.875;3900000;0
33354;-1;87;0;0;0;0;.00nan;0;0
33354;-1;94;0;0;0;0;.00nan;0;0
33355;203179;102;0;0;0;0;.00nan;0;0
33355;210428;103;65;33;3;30;.909;3600000;0
33355;210923;102;49;37;5;32;.865;3571000;0
33355;-1;103;0;0;0;0;.00nan;0;0
33356;208417;101;0;0;0;0;.00nan;0;0
33356;209796;107;58;22;2;20;.909;3600000;0
33356;220816;107;0;0;0;0;.00nan;0;0
33356;220873;101;38;29;5;24;.828;3600000;0
33357;210439;98;0;0;0;0;.00nan;0;0
33357;210603;104;81;42;3;39;.929;3563000;0
33357;207118;98;76;27;1;26;.963;3600000;0
33357;208300;104;0;0;0;0;.00nan;0;0
33358;210222;90;0;0;0;0;.00nan;0;0
33358;205124;89;69;39;3;36;.923;3600000;0
33358;207239;90;79;30;2;28;.933;3600000;0
33358;-1;89;0;0;0;0;.00nan;0;0
33359;209784;91;76;39;3;36;.923;3595000;0
33359;205119;106;74;31;2;29;.935;3600000;0
33359;210368;106;0;0;0;0;.00nan;0;0
33359;205429;91;0;0;0;0;.00nan;0;0
33360;205318;97;65;45;6;39;.867;3600000;0
33360;212354;97;0;0;0;0;.00nan;0;0
33360;212487;95;63;16;1;15;.938;3600000;0
33360;-1;95;0;0;0;0;.00nan;0;0
33361;210439;98;85;38;2;36;.947;3600000;0
33361;210603;104;46;28;4;24;.857;3389000;0
33361;207118;98;0;0;0;0;.00nan;0;0
33361;208300;104;30;6;3;3;.500;211000;0
33362;203179;102;0;0;0;0;.00nan;0;0
33362;215785;94;100;44;0;44;1.000;3600000;0
33362;210923;102;93;37;1;36;.973;3600000;0
33362;-1;94;0;0;0;0;.00nan;0;0
33363;205076;87;0;0;0;0;.00nan;0;0
33363;210428;103;0;0;0;0;.00nan;0;0
33363;-1;87;77;28;1;27;.964;3600000;0
33363;-1;103;16;30;7;23;.767;3600000;0
33364;209796;107;0;0;0;0;.00nan;0;0
33364;220816;107;40;22;4;18;.818;3900000;0
33364;215733;99;60;33;4;29;.879;3900000;0
33364;-1;99;0;0;0;0;.00nan;0;0
33365;210222;90;62;33;4;29;.879;3600000;0
33365;205124;89;0;0;0;0;.00nan;0;0
33365;207239;90;0;0;0;0;.00nan;0;0
33365;-1;89;80;26;1;25;.962;3600000;0
33366;208417;101;54;9;1;8;.889;3600000;0
33366;220873;101;0;0;0;0;.00nan;0;0
33366;210439;98;0;0;0;0;.00nan;0;0
33366;207118;98;73;40;3;37;.925;3600000;0
33367;205799;86;88;14;0;14;1.000;3600000;0
33367;217437;88;49;46;6;40;.870;3600000;0
33367;-1;86;0;0;0;0;.00nan;0;0
33367;-1;88;0;0;0;0;.00nan;0;0
33368;209784;91;0;0;0;0;.00nan;0;0
33368;205429;91;60;37;5;32;.865;3556000;0
33368;212343;96;0;0;0;0;.00nan;0;0
33368;-1;96;72;35;3;32;.914;3600000;0
33369;215575;100;0;0;0;0;.00nan;0;0
33369;215733;99;0;0;0;0;.00nan;0;0
33369;212368;100;70;32;3;29;.906;3575000;0
33369;-1;99;83;35;2;33;.943;3600000;0
33370;205076;87;39;23;4;19;.826;3600000;0
33370;210603;104;0;0;0;0;.00nan;0;0
33370;208300;104;100;53;2;51;.962;3600000;0
33370;-1;87;0;0;0;0;.00nan;0;0
33371;208417;101;0;0;0;0;.00nan;0;0
33371;220873;101;65;24;2;22;.917;3600000;0
33371;210439;98;0;0;0;0;.00nan;0;0
33371;207118;98;89;42;3;39;.929;3567000;0
33372;205124;89;72;42;4;38;.905;3600000;0
33372;212487;95;0;0;0;0;.00nan;0;0
33372;-1;89;0;0;0;0;.00nan;0;0
33372;-1;95;66;40;5;35;.875;3544000;0
33373;205119;106;0;0;0;0;.00nan;0;0
33373;210368;106;85;19;0;19;1.000;3600000;0
33373;210428;103;3;14;6;8;.571;2111000;0
33373;-1;103;38;14;3;11;.786;1489000;0
33374;215575;100;89;37;2;35;.946;3900000;0
33374;215733;99;75;26;2;24;.923;3900000;0
33374;212368;100;0;0;0;0;.00nan;0;0
33374;-1;99;0;0;0;0;.00nan;0;0
33375;209796;107;92;43;2;41;.953;3513000;0
33375;205076;87;0;0;0;0;.00nan;0;0
33375;220816;107;0;0;0;0;.00nan;0;0
33375;-1;87;98;28;0;28;1.000;3600000;0
33376;210222;90;55;32;4;28;.875;3600000;0
33376;212487;95;0;0;0;0;.00nan;0;0
33376;207239;90;0;0;0;0;.00nan;0;0
33376;-1;95;83;27;1;26;.963;3600000;0
33377;205799;86;100;28;0;28;1.000;3600000;0
33377;217437;88;89;49;1;48;.980;3563000;0
33377;-1;86;0;0;0;0;.00nan;0;0
33377;-1;88;0;0;0;0;.00nan;0;0
33378;205124;89;0;0;0;0;.00nan;0;0
33378;212343;96;0;0;0;0;.00nan;0;0
33378;-1;96;44;37;5;32;.865;3900000;0
33378;-1;89;60;40;5;35;.875;3900000;0
33379;205318;97;73;38;3;35;.921;3841000;0
33379;212354;97;0;0;0;0;.00nan;0;0
33379;-1;92;95;38;2;36;.947;3841000;0
33379;-1;92;0;0;0;0;.00nan;0;0
33380;205015;105;76;27;1;26;.963;3600000;0
33380;205076;87;0;0;0;0;.00nan;0;0
33380;205112;105;0;0;0;0;.00nan;0;0
33380;-1;87;67;29;3;26;.897;3539000;0
33381;215575;100;0;0;0;0;.00nan;0;0
33381;215733;99;0;0;0;0;.00nan;0;0
33381;212368;100;65;30;3;27;.900;3600000;0
33381;-1;99;61;36;5;31;.861;3525000;0
33382;205119;106;0;0;0;0;.00nan;0;0
33382;210368;106;60;21;2;19;.905;3600000;0
33382;210428;103;38;41;7;34;.829;3600000;0
33382;-1;103;0;0;0;0;.00nan;0;0
33383;209796;107;53;31;4;27;.871;3600000;0
33383;220816;107;0;0;0;0;.00nan;0;0
33383;210603;104;65;52;6;46;.885;3287000;0
33383;208300;104;51;2;0;2;1.000;230000;0
33384;210439;98;83;37;2;35;.946;3580000;0
33384;215735;93;0;0;0;0;.00nan;0;0
33384;207118;98;0;0;0;0;.00nan;0;0
33384;-1;93;64;16;1;15;.938;3600000;0
33385;209784;91;0;0;0;0;.00nan;0;0
33385;210222;90;0;0;0;0;.00nan;0;0
33385;205429;91;76;30;2;28;.933;3600000;0
33385;207239;90;51;36;4;32;.889;3600000;0
33386;205799;86;84;28;1;27;.964;3600000;0
33386;212343;96;68;30;3;27;.900;3600000;0
33386;-1;86;0;0;0;0;.00nan;0;0
33386;-1;96;0;0;0;0;.00nan;0;0
33387;205318;97;31;36;7;29;.806;3600000;0
33387;212354;97;0;0;0;0;.00nan;0;0
33387;-1;92;0;0;0;0;.00nan;0;0
33387;-1;92;82;14;0;14;1.000;3600000;0
33388;209796;107;0;0;0;0;.00nan;0;0
33388;220816;107;46;33;5;28;.848;3611000;0
33388;210603;104;0;0;0;0;.00nan;0;0
33388;208300;104;77;38;4;34;.895;3611000;0
33389;205119;106;17;6;4;2;.333;727000;0
33389;210368;106;81;21;1;20;.952;3173000;0
33389;215785;94;59;43;5;38;.884;3900000;0
33389;-1;94;0;0;0;0;.00nan;0;0
33390;212487;95;49;37;4;33;.892;3560000;0
33390;217437;88;0;0;0;0;.00nan;0;0
33390;-1;88;81;37;3;34;.919;3600000;0
33390;-1;95;0;0;0;0;.00nan;0;0
33391;215733;99;64;22;2;20;.909;3547000;0
33391;215735;93;90;35;1;34;.971;3600000;0
33391;-1;93;0;0;0;0;.00nan;0;0
33391;-1;99;0;0;0;0;.00nan;0;0
33392;208417;101;0;0;0;0;.00nan;0;0
33392;220873;101;68;25;2;23;.920;3553000;0
33392;215575;100;90;36;1;35;.972;3600000;0
33392;212368;100;0;0;0;0;.00nan;0;0
33393;205076;87;82;29;1;28;.966;3600000;0
33393;205119;106;79;30;2;28;.933;3543000;0
33393;210368;106;0;0;0;0;.00nan;0;0
33393;-1;87;0;0;0;0;.00nan;0;0
33394;209796;107;71;23;2;21;.913;3575000;0
33394;205015;105;0;0;0;0;.00nan;0;0
33394;205112;105;82;28;1;27;.964;3600000;0
33394;220816;107;0;0;0;0;.00nan;0;0
33395;203179;102;0;0;0;0;.00nan;0;0
33395;215785;94;0;0;0;0;.00nan;0;0
33395;210923;102;81;33;2;31;.939;3600000;0
33395;-1;94;65;29;3;26;.897;3600000;0
33396;205119;106;0;0;0;0;.00nan;0;0
33396;210368;106;45;27;4;23;.852;3544000;0
33396;205799;86;79;41;3;38;.927;3600000;0
33396;-1;86;0;0;0;0;.00nan;0;0
33397;208417;101;0;0;0;0;.00nan;0;0
33397;220873;101;46;24;4;20;.833;3648000;0
33397;215735;93;0;0;0;0;.00nan;0;0
33397;-1;93;43;35;5;30;.857;3693000;0
33398;210428;103;70;31;3;28;.903;3900000;0
33398;210603;104;79;33;3;30;.909;3900000;0
33398;208300;104;0;0;0;0;.00nan;0;0
33398;-1;103;0;0;0;0;.00nan;0;0
33399;209796;107;85;31;1;30;.968;3600000;0
33399;220816;107;0;0;0;0;.00nan;0;0
33399;205799;86;55;6;0;6;1.000;842000;0
33399;-1;86;15;25;6;19;.760;2758000;0
33400;209784;91;32;30;6;24;.800;3600000;0
33400;205124;89;60;30;3;27;.900;3600000;0
33400;205429;91;0;0;0;0;.00nan;0;0
33400;-1;89;0;0;0;0;.00nan;0;0
33401;210222;90;48;21;3;18;.857;3775000;0
33401;212487;95;0;0;0;0;.00nan;0;0
33401;207239;90;0;0;0;0;.00nan;0;0
33401;-1;95;86;46;4;42;.913;3775000;0
33402;203179;102;0;0;0;0;.00nan;0;0
33402;215735;93;83;33;2;31;.939;3600000;0
33402;210923;102;40;35;6;29;.829;3600000;0
33402;-1;93;0;0;0;0;.00nan;0;0
33403;205015;105;0;0;0;0;.00nan;0;0
33403;205112;105;93;19;0;19;1.000;3600000;0
33403;210439;98;0;0;0;0;.00nan;0;0
33403;207118;98;95;49;3;46;.939;3600000;0
33404;208417;101;77;13;0;13;1.000;3600000;0
33404;220873;101;0;0;0;0;.00nan;0;0
33404;210603;104;0;0;0;0;.00nan;0;0
33404;208300;104;89;59;5;54;.915;3600000;0
33405;215733;99;0;0;0;0;.00nan;0;0
33405;215785;94;67;21;1;20;.952;3600000;0
33405;-1;99;54;34;4;30;.882;3600000;0
33405;-1;94;0;0;0;0;.00nan;0;0
33406;212343;96;0;0;0;0;.00nan;0;0
33406;217437;88;49;40;5;35;.875;3576000;0
33406;-1;88;0;0;0;0;.00nan;0;0
33406;-1;96;65;33;3;30;.909;3600000;0
33407;210222;90;45;27;5;22;.815;3600000;0
33407;207239;90;0;0;0;0;.00nan;0;0
33407;-1;92;0;0;0;0;.00nan;0;0
33407;-1;92;92;31;1;30;.968;3600000;0
33408;205124;89;54;28;4;24;.857;3600000;0
33408;212487;95;97;35;1;34;.971;3600000;0
33408;-1;89;0;0;0;0;.00nan;0;0
33408;-1;95;0;0;0;0;.00nan;0;0
33409;203179;102;0;0;0;0;.00nan;0;0
33409;215733;99;0;0;0;0;.00nan;0;0
33409;210923;102;79;34;2;32;.941;3600000;0
33409;-1;99;53;24;3;21;.875;3536000;0
33410;215575;100;58;31;4;27;.871;3600000;0
33410;215735;93;0;0;0;0;.00nan;0;0
33410;212368;100;0;0;0;0;.00nan;0;0
33410;-1;93;27;38;7;31;.816;3590000;0
33411;205119;106;0;0;0;0;.00nan;0;0
33411;210368;106;45;28;4;24;.857;3537000;0
33411;215785;94;90;43;2;41;.953;3600000;0
33411;-1;94;0;0;0;0;.00nan;0;0
33412;210603;104;45;46;7;39;.848;3600000;0
33412;205799;86;85;21;1;20;.952;3600000;0
33412;-1;86;0;0;0;0;.00nan;0;0
33412;208300;104;0;0;0;0;.00nan;0;0
33413;210428;103;80;25;1;24;.960;3600000;0
33413;210439;98;95;43;2;41;.953;3600000;0
33413;207118;98;0;0;0;0;.00nan;0;0
33413;-1;103;0;0;0;0;.00nan;0;0
33414;209796;107;55;31;4;27;.871;3600000;0
33414;205015;105;0;0;0;0;.00nan;0;0
33414;205112;105;53;35;5;30;.857;3600000;0
33414;220816;107;0;0;0;0;.00nan;0;0
33415;205076;87;45;33;5;28;.848;3565000;0
33415;217437;88;0;0;0;0;.00nan;0;0
33415;-1;88;63;33;4;29;.879;3600000;0
33415;-1;87;0;0;0;0;.00nan;0;0
33416;205318;97;58;33;4;29;.879;3592000;0
33416;212354;97;0;0;0;0;.00nan;0;0
33416;212487;95;0;0;0;0;.00nan;0;0
33416;-1;95;69;26;3;23;.885;3600000;0
33417;203179;102;71;27;2;25;.926;3600000;0
33417;209796;107;0;0;0;0;.00nan;0;0
33417;220816;107;42;25;4;21;.840;3581000;0
33417;210923;102;0;0;0;0;.00nan;0;0
33418;209784;91;77;34;2;32;.941;3697000;0
33418;210222;90;0;0;0;0;.00nan;0;0
33418;205429;91;0;0;0;0;.00nan;0;0
33418;207239;90;64;32;3;29;.906;3697000;0
33419;205015;105;55;31;4;27;.871;3600000;0
33419;205112;105;0;0;0;0;.00nan;0;0
33419;205799;86;0;0;0;0;.00nan;0;0
33419;-1;86;83;40;3;37;.925;3600000;0
33420;205124;89;0;0;0;0;.00nan;0;0
33420;-1;89;59;32;4;28;.875;3900000;0
33420;-1;92;52;35;4;31;.886;3883000;0
33420;-1;92;0;0;0;0;.00nan;0;0
33421;210439;98;0;0;0;0;.00nan;0;0
33421;215785;94;23;20;6;14;.700;2169000;0
33421;207118;98;61;38;5;33;.868;3600000;0
33421;-1;94;37;7;2;5;.714;1431000;0
33422;210428;103;0;0;0;0;.00nan;0;0
33422;215733;99;61;26;3;23;.885;3600000;0
33422;-1;99;0;0;0;0;.00nan;0;0
33422;-1;103;52;34;4;30;.882;3562000;0
33423;208417;101;42;27;4;23;.852;3596000;0
33423;220873;101;0;0;0;0;.00nan;0;0
33423;210603;104;0;0;0;0;.00nan;0;0
33423;208300;104;100;52;3;49;.942;3600000;0
33424;205076;87;0;0;0;0;.00nan;0;0
33424;210222;90;72;42;4;38;.905;3528000;0
33424;207239;90;0;0;0;0;.00nan;0;0
33424;-1;87;73;26;2;24;.923;3600000;0
33425;205015;105;0;0;0;0;.00nan;0;0
33425;205112;105;70;28;2;26;.929;3900000;0
33425;215785;94;71;30;2;28;.933;3900000;0
33425;-1;94;0;0;0;0;.00nan;0;0
33426;209796;107;63;44;4;40;.909;3600000;0
33426;220816;107;0;0;0;0;.00nan;0;0
33426;215575;100;0;0;0;0;.00nan;0;0
33426;212368;100;89;28;1;27;.964;3600000;0
33427;212343;96;51;39;5;34;.872;3600000;0
33427;217437;88;79;24;1;23;.958;3600000;0
33427;-1;88;0;0;0;0;.00nan;0;0
33427;-1;96;0;0;0;0;.00nan;0;0
33428;205318;97;54;27;4;23;.852;3571000;0
33428;212354;97;0;0;0;0;.00nan;0;0
33428;-1;92;91;41;3;38;.927;3600000;0
33428;-1;92;0;0;0;0;.00nan;0;0
33429;209796;107;74;16;0;16;1.000;1483000;0
33429;220816;107;19;18;6;12;.667;2117000;0
33429;215575;100;74;27;2;25;.926;3600000;0
33429;212368;100;0;0;0;0;.00nan;0;0
33430;210428;103;87;47;4;43;.915;3581000;0
33430;205799;86;68;28;3;25;.893;3600000;0
33430;-1;86;0;0;0;0;.00nan;0;0
33430;-1;103;0;0;0;0;.00nan;0;0
33431;203179;102;0;0;0;0;.00nan;0;0
33431;210439;98;80;37;2;35;.946;3900000;0
33431;210923;102;73;29;2;27;.931;3900000;0
33431;207118;98;0;0;0;0;.00nan;0;0
33432;209784;91;0;0;0;0;.00nan;0;0
33432;205429;91;99;40;1;39;.975;3600000;0
33432;212343;96;0;0;0;0;.00nan;0;0
33432;-1;96;73;33;3;30;.909;3581000;0
33433;205318;97;0;0;0;0;.00nan;0;0
33433;215735;93;0;0;0;0;.00nan;0;0
33433;212354;97;59;13;1;12;.923;3600000;0
33433;-1;93;68;30;2;28;.933;3575000;0
33434;208417;101;0;0;0;0;.00nan;0;0
33434;205119;106;0;0;0;0;.00nan;0;0
33434;210368;106;76;39;3;36;.923;3571000;0
33434;220873;101;83;34;1;33;.971;3600000;0
33435;215785;94;27;7;3;4;.571;523000;0
33435;205799;86;0;0;0;0;.00nan;0;0
33435;-1;86;78;25;2;23;.920;3600000;0
33435;-1;94;52;36;6;30;.833;3077000;0
33436;203179;102;48;35;5;30;.857;3600000;0
33436;210439;98;0;0;0;0;.00nan;0;0
33436;210923;102;0;0;0;0;.00nan;0;0
33436;207118;98;100;42;1;41;.976;3600000;0
33437;210222;90;100;36;0;36;1.000;3600000;0
33437;205124;89;64;31;4;27;.871;3600000;0
33437;207239;90;0;0;0;0;.00nan;0;0
33437;-1;89;0;0;0;0;.00nan;0;0
33438;205076;87;61;32;3;29;.906;3600000;0
33438;212343;96;100;42;1;41;.976;3600000;0
33438;-1;96;0;0;0;0;.00nan;0;0
33438;-1;87;0;0;0;0;.00nan;0;0
33439;215735;93;80;36;3;33;.917;3900000;0
33439;205799;86;66;32;3;29;.906;3900000;0
33439;-1;86;0;0;0;0;.00nan;0;0
33439;-1;93;0;0;0;0;.00nan;0;0
33440;209784;91;62;27;3;24;.889;3600000;0
33440;205318;97;0;0;0;0;.00nan;0;0
33440;205429;91;0;0;0;0;.00nan;0;0
33440;212354;97;49;36;5;31;.861;3552000;0
33441;217437;88;80;34;2;32;.941;3545000;0
33441;-1;88;0;0;0;0;.00nan;0;0
33441;-1;92;0;0;0;0;.00nan;0;0
33441;-1;92;71;22;1;21;.955;3600000;0
33442;209796;107;76;37;3;34;.919;3600000;0
33442;220816;107;0;0;0;0;.00nan;0;0
33442;212487;95;0;0;0;0;.00nan;0;0
33442;-1;95;58;31;4;27;.871;3572000;0
33443;203179;102;0;0;0;0;.00nan;0;0
33443;210439;98;90;32;1;31;.969;3600000;0
33443;210923;102;45;27;4;23;.852;3600000;0
33443;207118;98;0;0;0;0;.00nan;0;0
33444;205015;105;0;0;0;0;.00nan;0;0
33444;205112;105;52;24;3;21;.875;3600000;0
33444;205119;106;0;0;0;0;.00nan;0;0
33444;210368;106;84;34;2;32;.941;3600000;0
33445;208417;101;0;0;0;0;.00nan;0;0
33445;220873;101;90;14;0;14;1.000;3600000;0
33445;215733;99;0;0;0;0;.00nan;0;0
33445;-1;99;85;33;2;31;.939;3574000;0
33446;210428;103;56;26;3;23;.885;3559000;0
33446;215575;100;66;21;2;19;.905;3600000;0
33446;212368;100;0;0;0;0;.00nan;0;0
33446;-1;103;0;0;0;0;.00nan;0;0
33447;205124;89;0;0;0;0;.00nan;0;0
33447;212343;96;0;0;0;0;.00nan;0;0
33447;-1;96;70;37;3;34;.919;3900000;0
33447;-1;89;58;25;3;22;.880;3900000;0
33448;209784;91;47;36;5;31;.861;3273000;0
33448;205076;87;0;0;0;0;.00nan;0;0
33448;205429;91;19;8;4;4;.500;327000;0
33448;-1;87;57;23;2;21;.913;3600000;0
33449;205015;105;84;41;3;38;.927;3600000;0
33449;205112;105;0;0;0;0;.00nan;0;0
33449;205119;106;39;21;4;17;.810;3588000;0
33449;210368;106;0;0;0;0;.00nan;0;0
33450;209796;107;71;34;2;32;.941;3570000;0
33450;220816;107;0;0;0;0;.00nan;0;0
33450;-1;92;100;27;0;27;1.000;3600000;0
33450;-1;92;0;0;0;0;.00nan;0;0
33451;208417;101;0;0;0;0;.00nan;0;0
33451;220873;101;57;27;3;24;.889;3900000;0
33451;210603;104;77;41;3;38;.927;3900000;0
33451;208300;104;0;0;0;0;.00nan;0;0
33452;215575;100;0;0;0;0;.00nan;0;0
33452;215785;94;50;43;6;37;.860;3522000;0
33452;212368;100;58;33;4;29;.879;3600000;0
33452;-1;94;0;0;0;0;.00nan;0;0
33453;210428;103;62;45;6;39;.867;3600000;0
33453;215733;99;51;27;5;22;.815;3600000;0
33453;-1;99;0;0;0;0;.00nan;0;0
33453;-1;103;0;0;0;0;.00nan;0;0
33454;203179;102;40;22;4;18;.818;3544000;0
33454;210439;98;0;0;0;0;.00nan;0;0
33454;210923;102;0;0;0;0;.00nan;0;0
33454;207118;98;76;39;3;36;.923;3600000;0
33455;205076;87;95;49;3;46;.939;3900000;0
33455;205318;97;57;27;3;24;.889;3900000;0
33455;212354;97;0;0;0;0;.00nan;0;0
33455;-1;87;0;0;0;0;.00nan;0;0
33456;212487;95;64;34;4;30;.882;3548000;0
33456;217437;88;80;33;3;30;.909;3600000;0
33456;-1;88;0;0;0;0;.00nan;0;0
33456;-1;95;0;0;0;0;.00nan;0;0
33457;205119;106;0;0;0;0;.00nan;0;0
33457;210368;106;67;25;2;23;.920;3600000;0
33457;210428;103;0;0;0;0;.00nan;0;0
33457;-1;103;88;62;5;57;.919;3600000;0
33458;205015;105;0;0;0;0;.00nan;0;0
33458;205112;105;100;28;0;28;1.000;3600000;0
33458;215575;100;63;35;4;31;.886;3600000;0
33458;212368;100;0;0;0;0;.00nan;0;0
33459;215733;99;0;0;0;0;.00nan;0;0
33459;215785;94;34;34;6;28;.824;3298000;0
33459;-1;99;89;26;2;24;.923;3600000;0
33459;-1;94;44;4;1;3;.750;302000;0
33460;210222;90;52;27;4;23;.852;3600000;0
33460;207239;90;0;0;0;0;.00nan;0;0
33460;-1;92;75;25;1;24;.960;3600000;0
33460;-1;92;0;0;0;0;.00nan;0;0
33461;210439;98;23;23;6;17;.739;2471000;0
33461;210603;104;89;37;2;35;.946;3600000;0
33461;207118;98;57;7;0;7;1.000;1129000;0
33461;208300;104;0;0;0;0;.00nan;0;0
33462;217437;88;73;31;2;29;.935;3900000;0
33462;-1;88;0;0;0;0;.00nan;0;0
33462;-1;92;0;0;0;0;.00nan;0;0
33462;-1;92;83;32;2;30;.938;3900000;0
33463;205318;97;0;0;0;0;.00nan;0;0
33463;212343;96;0;0;0;0;.00nan;0;0
33463;212354;97;76;29;2;27;.931;3600000;0
33463;-1;96;80;41;4;37;.902;3596000;0
33464;210222;90;44;20;3;17;.850;3600000;0
33464;217437;88;65;52;7;45;.865;3600000;0
33464;207239;90;0;0;0;0;.00nan;0;0
33464;-1;88;0;0;0;0;.00nan;0;0
33465;205076;87;74;32;3;29;.906;3600000;0
33465;205318;97;54;34;5;29;.853;3558000;0
33465;212354;97;0;0;0;0;.00nan;0;0
33465;-1;87;0;0;0;0;.00nan;0;0
33466;203179;102;71;33;3;30;.909;3580000;0
33466;205124;89;76;26;2;24;.923;3600000;0
33466;210923;102;0;0;0;0;.00nan;0;0
33466;-1;89;0;0;0;0;.00nan;0;0
33467;205799;86;42;22;4;18;.818;3600000;0
33467;-1;86;0;0;0;0;.00nan;0;0
33467;-1;92;78;52;5;47;.904;3596000;0
33467;-1;92;0;0;0;0;.00nan;0;0
33468;215735;93;0;0;0;0;.00nan;0;0
33468;212343;96;44;42;6;36;.857;3600000;0
33468;-1;96;0;0;0;0;.00nan;0;0
33468;-1;93;60;24;3;21;.875;3600000;0
33469;209784;91;40;31;6;25;.806;3600000;0
33469;205429;91;0;0;0;0;.00nan;0;0
33469;212487;95;67;22;2;20;.909;3600000;0
33469;-1;95;0;0;0;0;.00nan;0;0
33470;205015;105;0;0;0;0;.00nan;0;0
33470;205112;105;95;42;3;39;.929;3900000;0
33470;215785;94;49;19;3;16;.842;3900000;0
33470;-1;94;0;0;0;0;.00nan;0;0
33471;210439;98;0;0;0;0;.00nan;0;0
33471;215575;100;0;0;0;0;.00nan;0;0
33471;212368;100;98;23;0;23;1.000;3600000;0
33471;207118;98;55;34;4;30;.882;3600000;0
33472;210428;103;64;26;3;23;.885;3561000;0
33472;210603;104;78;32;2;30;.938;3600000;0
33472;222835;103;0;0;0;0;.00nan;0;0
33472;208300;104;0;0;0;0;.00nan;0;0
33473;209796;107;73;22;1;21;.955;3600000;0
33473;220816;107;0;0;0;0;.00nan;0;0
33473;215733;99;0;0;0;0;.00nan;0;0
33473;-1;99;68;34;4;30;.882;3600000;0
33474;203179;102;0;0;0;0;.00nan;0;0
33474;210222;90;0;0;0;0;.00nan;0;0
33474;210923;102;53;26;3;23;.885;3814000;0
33474;207239;90;45;28;4;24;.857;3845000;0
33475;205799;86;0;0;0;0;.00nan;0;0
33475;217437;88;0;0;0;0;.00nan;0;0
33475;-1;86;66;25;2;23;.920;3600000;0
33475;-1;88;72;53;6;47;.887;3600000;0
33476;205076;87;0;0;0;0;.00nan;0;0
33476;-1;92;0;0;0;0;.00nan;0;0
33476;-1;87;67;24;2;22;.917;3600000;0
33476;-1;92;28;35;7;28;.800;3600000;0
33477;208417;101;0;0;0;0;.00nan;0;0
33477;205124;89;0;0;0;0;.00nan;0;0
33477;220873;101;67;24;2;22;.917;3600000;0
33477;-1;89;69;39;3;36;.923;3600000;0
33478;215735;93;45;27;5;22;.815;2360000;0
33478;212343;96;0;0;0;0;.00nan;0;0
33478;-1;96;93;30;1;29;.967;3600000;0
33478;-1;93;60;13;1;12;.923;1240000;0
33479;205015;105;53;22;3;19;.864;3600000;0
33479;205112;105;0;0;0;0;.00nan;0;0
33479;210603;104;0;0;0;0;.00nan;0;0
33479;208300;104;73;42;4;38;.905;3564000;0
33480;210439;98;54;26;4;22;.846;3550000;0
33480;215575;100;0;0;0;0;.00nan;0;0
33480;212368;100;62;30;3;27;.900;3600000;0
33480;207118;98;0;0;0;0;.00nan;0;0
33481;209784;91;0;0;0;0;.00nan;0;0
33481;205429;91;59;44;5;39;.886;3600000;0
33481;212487;95;0;0;0;0;.00nan;0;0
33481;-1;95;76;26;2;24;.923;3600000;0
33482;205119;106;0;0;0;0;.00nan;0;0
33482;210368;106;61;24;3;21;.875;3617000;0
33482;210428;103;0;0;0;0;.00nan;0;0
33482;222835;103;88;41;2;39;.951;3617000;0
33483;209796;107;63;40;4;36;.900;3530000;0
33483;220816;107;0;0;0;0;.00nan;0;0
33483;215733;99;67;24;2;22;.917;3600000;0
33483;-1;99;0;0;0;0;.00nan;0;0
33484;205318;97;0;0;0;0;.00nan;0;0
33484;205799;86;86;35;3;32;.914;3900000;0
33484;212354;97;100;60;3;57;.950;3900000;0
33484;-1;86;0;0;0;0;.00nan;0;0
33485;209796;107;62;25;3;22;.880;3600000;0
33485;205015;105;63;8;0;8;1.000;282000;0
33485;205112;105;32;37;8;29;.784;3318000;0
33485;220816;107;0;0;0;0;.00nan;0;0
33486;205119;106;25;23;6;17;.739;2572000;0
33486;210368;106;61;8;0;8;1.000;964000;0
33486;215785;94;51;33;4;29;.879;3600000;0
33486;-1;94;0;0;0;0;.00nan;0;0
33487;208417;101;0;0;0;0;.00nan;0;0
33487;220873;101;89;14;0;14;1.000;3600000;0
33487;217437;88;77;30;2;28;.933;3575000;0
33487;-1;88;0;0;0;0;.00nan;0;0
33488;203179;102;0;0;0;0;.00nan;0;0
33488;205076;87;85;35;2;33;.943;3619000;0
33488;210923;102;74;35;3;32;.914;3619000;0
33488;-1;87;0;0;0;0;.00nan;0;0
33489;208417;101;0;0;0;0;.00nan;0;0
33489;210222;90;48;32;5;27;.844;3600000;0
33489;220873;101;95;19;0;19;1.000;3600000;0
33489;207239;90;0;0;0;0;.00nan;0;0
33490;203179;102;96;44;2;42;.955;3600000;0
33490;205799;86;45;26;4;22;.846;3553000;0
33490;210923;102;0;0;0;0;.00nan;0;0
33490;-1;86;0;0;0;0;.00nan;0;0
33491;205318;97;74;42;4;38;.905;3600000;0
33491;212354;97;0;0;0;0;.00nan;0;0
33491;-1;92;55;37;5;32;.865;3600000;0
33491;-1;92;0;0;0;0;.00nan;0;0
33492;209784;91;57;45;5;40;.889;3600000;0
33492;205429;91;0;0;0;0;.00nan;0;0
33492;215735;93;0;0;0;0;.00nan;0;0
33492;-1;93;99;24;0;24;1.000;3600000;0
33493;205015;105;0;0;0;0;.00nan;0;0
33493;205112;105;71;50;5;45;.900;3521000;0
33493;205119;106;0;0;0;0;.00nan;0;0
33493;210368;106;57;25;3;22;.880;3600000;0
33494;210603;104;73;39;3;36;.923;3582000;0
33494;215785;94;60;23;2;21;.913;3600000;0
33494;208300;104;0;0;0;0;.00nan;0;0
33494;-1;94;0;0;0;0;.00nan;0;0
33495;209796;107;55;29;4;25;.862;3600000;0
33495;220816;107;0;0;0;0;.00nan;0;0
33495;215575;100;68;29;3;26;.897;3600000;0
33495;212368;100;0;0;0;0;.00nan;0;0
33496;212343;96;0;0;0;0;.00nan;0;0
33496;-1;96;54;16;3;13;.813;3600000;0
33496;-1;92;53;2;0;2;1.000;296000;0
33496;-1;92;59;48;6;42;.875;3304000;0
33497;203179;102;0;0;0;0;.00nan;0;0
33497;210923;102;93;35;1;34;.971;3600000;0
33497;217437;88;37;33;6;27;.818;3274000;0
33497;-1;88;44;4;1;3;.750;326000;0
33498;208417;101;0;0;0;0;.00nan;0;0
33498;205076;87;85;36;2;34;.944;3600000;0
33498;220873;101;58;38;5;33;.868;3600000;0
33498;-1;87;0;0;0;0;.00nan;0;0
33499;209784;91;0;0;0;0;.00nan;0;0
33499;205318;97;0;0;0;0;.00nan;0;0
33499;205429;91;64;42;6;36;.857;3600000;0
33499;212354;97;94;48;2;46;.958;3600000;0
33500;205124;89;59;24;2;22;.917;3572000;0
33500;215735;93;0;0;0;0;.00nan;0;0
33500;-1;93;97;36;1;35;.972;3600000;0
33500;-1;89;0;0;0;0;.00nan;0;0
33501;212343;96;56;37;5;32;.865;3600000;0
33501;212487;95;0;0;0;0;.00nan;0;0
33501;-1;96;0;0;0;0;.00nan;0;0
33501;-1;95;94;28;1;27;.964;3600000;0
33502;205119;106;0;0;0;0;.00nan;0;0
33502;210368;106;32;23;5;18;.783;3600000;0
33502;215575;100;94;45;2;43;.956;3600000;0
33502;212368;100;0;0;0;0;.00nan;0;0
33503;215733;99;0;0;0;0;.00nan;0;0
33503;210603;104;48;39;6;33;.846;2807000;0
33503;208300;104;47;7;1;6;.857;753000;0
33503;-1;99;47;29;5;24;.828;3600000;0
33504;205015;105;0;0;0;0;.00nan;0;0
33504;205112;105;53;25;3;22;.880;3600000;0
33504;215785;94;48;28;5;23;.821;3580000;0
33504;-1;94;0;0;0;0;.00nan;0;0
33505;210428;103;80;38;3;35;.921;3600000;0
33505;210439;98;0;0;0;0;.00nan;0;0
33505;207118;98;43;33;5;28;.848;3517000;0
33505;222835;103;0;0;0;0;.00nan;0;0
33506;210222;90;64;31;4;27;.871;3600000;0
33506;217437;88;0;0;0;0;.00nan;0;0
33506;207239;90;0;0;0;0;.00nan;0;0
33506;-1;88;23;25;6;19;.760;3573000;0
33507;208417;101;85;35;2;33;.943;3600000;0
33507;220873;101;0;0;0;0;.00nan;0;0
33507;205799;86;79;20;1;19;.950;3600000;0
33507;-1;86;0;0;0;0;.00nan;0;0
33508;209784;91;69;35;3;32;.914;3677000;0
33508;205429;91;0;0;0;0;.00nan;0;0
33508;215735;93;73;39;4;35;.897;3654000;0
33508;-1;93;0;0;0;0;.00nan;0;0
33509;205015;105;73;43;4;39;.907;3900000;0
33509;205112;105;0;0;0;0;.00nan;0;0
33509;215785;94;0;0;0;0;.00nan;0;0
33509;-1;94;57;24;4;20;.833;3900000;0
33510;205124;89;0;0;0;0;.00nan;0;0
33510;-1;89;60;32;4;28;.875;3600000;0
33510;-1;92;46;33;5;28;.848;3600000;0
33510;-1;92;0;0;0;0;.00nan;0;0
33511;209796;107;63;20;2;18;.900;3600000;0
33511;220816;107;0;0;0;0;.00nan;0;0
33511;210603;104;0;0;0;0;.00nan;0;0
33511;208300;104;44;36;5;31;.861;3600000;0
33512;210428;103;0;0;0;0;.00nan;0;0
33512;210439;98;70;35;3;32;.914;3600000;0
33512;207118;98;0;0;0;0;.00nan;0;0
33512;222835;103;78;31;2;29;.935;3600000;0
33513;215575;100;54;10;1;9;.900;1249000;0
33513;215733;99;53;32;5;27;.844;3600000;0
33513;212368;100;32;27;6;21;.778;2268000;0
33513;-1;99;0;0;0;0;.00nan;0;0
33514;205318;97;68;21;1;20;.952;3600000;0
33514;212343;96;46;39;6;33;.846;2873000;0
33514;212354;97;0;0;0;0;.00nan;0;0
33514;-1;96;58;7;0;7;1.000;727000;0
33515;205124;89;73;43;4;39;.907;3547000;0
33515;212487;95;70;23;2;21;.913;3600000;0
33515;-1;89;0;0;0;0;.00nan;0;0
33515;-1;95;0;0;0;0;.00nan;0;0
33516;209796;107;73;37;3;34;.919;3600000;0
33516;205119;106;0;0;0;0;.00nan;0;0
33516;210368;106;72;29;2;27;.931;3600000;0
33516;220816;107;0;0;0;0;.00nan;0;0
33517;215733;99;0;0;0;0;.00nan;0;0
33517;210603;104;28;6;3;3;.500;292000;0
33517;208300;104;81;48;4;44;.917;3308000;0
33517;-1;99;47;16;3;13;.813;3600000;0
33518;210222;90;74;48;5;43;.896;3546000;0
33518;205124;89;56;28;4;24;.857;3600000;0
33518;207239;90;0;0;0;0;.00nan;0;0
33518;-1;89;0;0;0;0;.00nan;0;0
33519;205076;87;53;33;5;28;.848;3600000;0
33519;205121;86;99;41;1;40;.976;3600000;0
33519;-1;86;0;0;0;0;.00nan;0;0
33519;-1;87;0;0;0;0;.00nan;0;0
33520;215735;93;0;0;0;0;.00nan;0;0
33520;212343;96;45;36;6;30;.833;3600000;0
33520;-1;96;0;0;0;0;.00nan;0;0
33520;-1;93;56;20;3;17;.850;3600000;0
33521;209784;91;0;0;0;0;.00nan;0;0
33521;205429;91;63;39;5;34;.872;3684000;0
33521;-1;92;64;43;4;39;.907;3684000;0
33521;-1;92;0;0;0;0;.00nan;0;0
33522;208417;101;0;0;0;0;.00nan;0;0
33522;203179;102;0;0;0;0;.00nan;0;0
33522;220873;101;75;24;2;22;.917;3900000;0
33522;210923;102;87;31;2;29;.935;3900000;0
33523;215575;100;77;38;4;34;.895;3517000;0
33523;212368;100;0;0;0;0;.00nan;0;0
33523;212487;95;77;28;2;26;.929;3600000;0
33523;-1;95;0;0;0;0;.00nan;0;0
33524;210439;98;0;0;0;0;.00nan;0;0
33524;215733;99;0;0;0;0;.00nan;0;0
33524;207118;98;61;50;5;45;.900;3600000;0
33524;-1;99;100;22;0;22;1.000;3600000;0
33525;205119;106;0;0;0;0;.00nan;0;0
33525;210368;106;81;32;2;30;.938;3600000;0
33525;215785;94;68;42;4;38;.905;3512000;0
33525;-1;94;0;0;0;0;.00nan;0;0
33526;205015;105;0;0;0;0;.00nan;0;0
33526;205112;105;56;20;3;17;.850;3600000;0
33526;205276;103;0;0;0;0;.00nan;0;0
33526;222835;103;55;33;4;29;.879;3545000;0
33527;205119;106;73;41;4;37;.902;3900000;0
33527;210368;106;0;0;0;0;.00nan;0;0
33527;210439;98;74;42;4;38;.905;3900000;0
33527;207118;98;0;0;0;0;.00nan;0;0
33528;205015;105;73;29;2;27;.931;3600000;0
33528;205112;105;0;0;0;0;.00nan;0;0
33528;210603;104;63;46;6;40;.870;3600000;0
33528;208300;104;0;0;0;0;.00nan;0;0
33529;215575;100;0;0;0;0;.00nan;0;0
33529;205318;97;86;29;1;28;.966;3600000;0
33529;212354;97;0;0;0;0;.00nan;0;0
33529;212368;100;60;31;3;28;.903;3574000;0
33530;210222;90;60;46;7;39;.848;3349000;0
33530;205121;86;17;22;6;16;.727;3157000;0
33530;207239;90;54;4;0;4;1.000;551000;0
33530;-1;86;42;6;1;5;.833;743000;0
33531;205124;89;0;0;0;0;.00nan;0;0
33531;217437;88;85;39;2;37;.949;3900000;0
33531;-1;88;0;0;0;0;.00nan;0;0
33531;-1;89;86;40;2;38;.950;3900000;0
33532;215735;93;0;0;0;0;.00nan;0;0
33532;-1;93;82;43;4;39;.907;3595000;0
33532;-1;92;58;24;3;21;.875;3600000;0
33532;-1;92;0;0;0;0;.00nan;0;0
33533;209784;91;55;27;3;24;.889;3600000;0
33533;205429;91;0;0;0;0;.00nan;0;0
33533;212343;96;0;0;0;0;.00nan;0;0
33533;-1;96;63;38;5;33;.868;3536000;0
33534;215733;99;0;0;0;0;.00nan;0;0
33534;212487;95;0;0;0;0;.00nan;0;0
33534;-1;95;73;33;3;30;.909;3600000;0
33534;-1;99;49;25;4;21;.840;3579000;0
33535;208417;101;0;0;0;0;.00nan;0;0
33535;203179;102;59;34;4;30;.882;3600000;0
33535;220873;101;82;34;2;32;.941;3600000;0
33535;210923;102;0;0;0;0;.00nan;0;0
33536;205076;87;68;37;4;33;.892;3600000;0
33536;217437;88;0;0;0;0;.00nan;0;0
33536;-1;88;100;37;0;37;1.000;3600000;0
33536;-1;87;0;0;0;0;.00nan;0;0
33537;210222;90;0;0;0;0;.00nan;0;0
33537;205124;89;76;37;4;33;.892;3600000;0
33537;207239;90;21;26;7;19;.731;3600000;0
33537;-1;89;0;0;0;0;.00nan;0;0
33538;212343;96;89;39;2;37;.949;3810000;0
33538;-1;96;0;0;0;0;.00nan;0;0
33538;-1;92;0;0;0;0;.00nan;0;0
33538;-1;92;72;32;3;29;.906;3810000;0
33539;203179;102;0;0;0;0;.00nan;0;0
33539;215575;100;59;34;4;30;.882;3600000;0
33539;210923;102;96;22;0;22;1.000;3600000;0
33539;212368;100;0;0;0;0;.00nan;0;0
33540;209784;91;0;0;0;0;.00nan;0;0
33540;205429;91;34;31;6;25;.806;3600000;0
33540;215735;93;56;29;3;26;.897;3600000;0
33540;-1;93;0;0;0;0;.00nan;0;0
33541;209796;107;56;32;4;28;.875;3600000;0
33541;220816;107;0;0;0;0;.00nan;0;0
33541;210603;104;63;6;0;6;1.000;336000;0
33541;208300;104;35;32;6;26;.813;3264000;0
33542;205276;103;0;0;0;0;.00nan;0;0
33542;215785;94;76;31;3;28;.903;3900000;0
33542;222835;103;68;32;3;29;.906;3900000;0
33542;-1;94;0;0;0;0;.00nan;0;0
33543;210439;98;0;0;0;0;.00nan;0;0
33543;207118;98;61;42;5;37;.881;3600000;0
33543;212487;95;75;24;1;23;.958;3600000;0
33543;-1;95;0;0;0;0;.00nan;0;0
33544;208417;101;72;20;1;19;.950;3600000;0
33544;220873;101;0;0;0;0;.00nan;0;0
33544;205318;97;86;40;2;38;.950;3599000;0
33544;212354;97;0;0;0;0;.00nan;0;0
33545;205119;106;0;0;0;0;.00nan;0;0
33545;210368;106;48;21;3;18;.857;3756000;0
33545;210603;104;89;33;2;31;.939;3756000;0
33545;208300;104;0;0;0;0;.00nan;0;0
33546;205015;105;0;0;0;0;.00nan;0;0
33546;205112;105;22;33;7;26;.788;3600000;0
33546;215733;99;0;0;0;0;.00nan;0;0
33546;-1;99;70;24;1;23;.958;3600000;0
33547;205276;103;53;33;4;29;.879;3520000;0
33547;215785;94;76;34;2;32;.941;3600000;0
33547;222835;103;0;0;0;0;.00nan;0;0
33547;-1;94;0;0;0;0;.00nan;0;0
33548;205124;89;40;33;5;28;.848;3600000;0
33548;217437;88;0;0;0;0;.00nan;0;0
33548;-1;88;87;33;2;31;.939;3600000;0
33548;-1;89;0;0;0;0;.00nan;0;0
33549;210222;90;54;44;6;38;.864;3600000;0
33549;205121;86;70;28;2;26;.929;3600000;0
33549;207239;90;0;0;0;0;.00nan;0;0
33549;-1;86;0;0;0;0;.00nan;0;0
33550;210439;98;0;0;0;0;.00nan;0;0
33550;205318;97;0;0;0;0;.00nan;0;0
33550;212354;97;72;35;3;32;.914;3600000;0
33550;207118;98;54;36;4;32;.889;3600000;0
33551;209796;107;65;26;2;24;.923;3600000;0
33551;220816;107;0;0;0;0;.00nan;0;0
33551;212487;95;0;0;0;0;.00nan;0;0
33551;-1;95;78;56;6;50;.893;3600000;0
33552;209784;91;14;14;5;9;.643;2218000;0
33552;205429;91;61;16;1;15;.938;1382000;0
33552;-1;92;83;38;3;35;.921;3600000;0
33552;-1;92;0;0;0;0;.00nan;0;0
33553;215735;93;0;0;0;0;.00nan;0;0
33553;212343;96;0;0;0;0;.00nan;0;0
33553;-1;96;64;24;2;22;.917;3600000;0
33553;-1;93;60;29;3;26;.897;3600000;0
33554;205119;106;0;0;0;0;.00nan;0;0
33554;210368;106;75;34;5;29;.853;3714000;0
33554;215575;100;60;31;4;27;.871;3714000;0
33554;212368;100;0;0;0;0;.00nan;0;0
33555;203179;102;0;0;0;0;.00nan;0;0
33555;210923;102;55;30;4;26;.867;3600000;0
33555;212487;95;0;0;0;0;.00nan;0;0
33555;-1;95;88;30;1;29;.967;3600000;0
33556;205318;97;77;37;3;34;.919;3543000;0
33556;215733;99;0;0;0;0;.00nan;0;0
33556;212354;97;0;0;0;0;.00nan;0;0
33556;-1;99;89;34;2;32;.941;3600000;0
33557;205076;87;95;59;4;55;.932;3900000;0
33557;217437;88;40;27;4;23;.852;3900000;0
33557;-1;88;0;0;0;0;.00nan;0;0
33557;-1;87;0;0;0;0;.00nan;0;0
33558;205121;86;45;43;7;36;.837;3572000;0
33558;205124;89;0;0;0;0;.00nan;0;0
33558;-1;86;0;0;0;0;.00nan;0;0
33558;-1;89;48;33;5;28;.848;3600000;0
33559;215785;94;43;27;5;22;.815;3600000;0
33559;212343;96;44;48;7;41;.854;3600000;0
33559;-1;96;0;0;0;0;.00nan;0;0
33559;-1;94;0;0;0;0;.00nan;0;0
33560;205276;103;0;0;0;0;.00nan;0;0
33560;215735;93;0;0;0;0;.00nan;0;0
33560;222835;103;77;45;3;42;.933;3900000;0
33560;-1;93;48;21;3;18;.857;3900000;0
33561;209784;91;0;0;0;0;.00nan;0;0
33561;205429;91;64;18;1;17;.944;3600000;0
33561;-1;92;54;37;5;32;.865;3600000;0
33561;-1;92;0;0;0;0;.00nan;0;0
33562;203179;102;72;42;4;38;.905;3576000;0
33562;205318;97;0;0;0;0;.00nan;0;0
33562;210923;102;0;0;0;0;.00nan;0;0
33562;212354;97;66;21;2;19;.905;3600000;0
33563;209796;107;28;28;6;22;.786;2913000;0
33563;205015;105;60;20;1;19;.950;1525000;0
33563;205112;105;17;28;7;21;.750;2017000;0
33563;220816;107;62;7;0;7;1.000;687000;0
33564;208417;101;0;0;0;0;.00nan;0;0
33564;220873;101;97;24;0;24;1.000;3600000;0
33564;212487;95;0;0;0;0;.00nan;0;0
33564;-1;95;57;23;2;21;.913;3585000;0
33565;215575;100;0;0;0;0;.00nan;0;0
33565;210603;104;94;54;4;50;.926;3600000;0
33565;212368;100;27;24;5;19;.792;3600000;0
33565;208300;104;0;0;0;0;.00nan;0;0
33566;210222;90;26;26;6;20;.769;3258000;0
33566;215733;99;71;22;1;21;.955;3010000;0
33566;207239;90;52;4;0;4;1.000;261000;0
33566;-1;99;46;16;3;13;.813;590000;0
33567;205076;87;0;0;0;0;.00nan;0;0
33567;205121;86;38;32;5;27;.844;3515000;0
33567;-1;86;0;0;0;0;.00nan;0;0
33567;-1;87;95;44;3;41;.932;3600000;0
33568;205124;89;67;24;2;22;.917;3600000;0
33568;210439;98;0;0;0;0;.00nan;0;0
33568;207118;98;82;52;5;47;.904;3600000;0
33568;-1;89;0;0;0;0;.00nan;0;0
33569;212343;96;71;21;1;20;.952;2440000;0
33569;217437;88;0;0;0;0;.00nan;0;0
33569;-1;88;63;27;3;24;.889;3600000;0
33569;-1;96;29;19;4;15;.789;1125000;0
33570;209784;91;43;35;5;30;.857;3600000;0
33570;205276;103;0;0;0;0;.00nan;0;0
33570;205429;91;0;0;0;0;.00nan;0;0
33570;222835;103;86;35;2;33;.943;3600000;0
33571;205015;105;0;0;0;0;.00nan;0;0
33571;205112;105;44;26;4;22;.846;3600000;0
33571;215575;100;32;23;5;18;.783;3583000;0
33571;212368;100;0;0;0;0;.00nan;0;0
33572;208417;101;0;0;0;0;.00nan;0;0
33572;205119;106;0;0;0;0;.00nan;0;0
33572;210368;106;69;34;3;31;.912;3600000;0
33572;220873;101;38;27;5;22;.815;3535000;0
33573;209796;107;62;18;1;17;.944;3600000;0
33573;220816;107;0;0;0;0;.00nan;0;0
33573;210603;104;84;51;4;47;.922;3600000;0
33573;208300;104;0;0;0;0;.00nan;0;0
33574;205318;97;0;0;0;0;.00nan;0;0
33574;212354;97;51;27;5;22;.815;3547000;0
33574;212487;95;0;0;0;0;.00nan;0;0
33574;-1;95;57;35;4;31;.886;3600000;0
33575;209784;91;0;0;0;0;.00nan;0;0
33575;205429;91;54;42;7;35;.833;3600000;0
33575;215785;94;78;24;2;22;.917;3600000;0
33575;-1;94;0;0;0;0;.00nan;0;0
33576;209796;107;34;28;5;23;.821;3600000;0
33576;220816;107;0;0;0;0;.00nan;0;0
33576;215575;100;0;0;0;0;.00nan;0;0
33576;212368;100;99;35;1;34;.971;3600000;0
33577;210222;90;55;35;5;30;.857;3543000;0
33577;210439;98;71;40;4;36;.900;3600000;0
33577;207118;98;0;0;0;0;.00nan;0;0
33577;207239;90;0;0;0;0;.00nan;0;0
33578;205076;87;67;33;3;30;.909;3552000;0
33578;215733;99;0;0;0;0;.00nan;0;0
33578;-1;99;79;26;2;24;.923;3600000;0
33578;-1;87;0;0;0;0;.00nan;0;0
33579;215735;93;0;0;0;0;.00nan;0;0
33579;215785;94;80;36;2;34;.944;3600000;0
33579;-1;93;32;27;5;22;.815;3600000;0
33579;-1;94;0;0;0;0;.00nan;0;0
33580;210428;103;24;27;6;21;.778;3600000;0
33580;212343;96;0;0;0;0;.00nan;0;0
33580;222835;103;0;0;0;0;.00nan;0;0
33580;-1;96;39;27;5;22;.815;3600000;0
33581;210439;98;0;0;0;0;.00nan;0;0
33581;207118;98;92;40;1;39;.975;3600000;0
33581;217437;88;49;28;4;24;.857;3600000;0
33581;-1;88;0;0;0;0;.00nan;0;0
33582;205121;86;0;0;0;0;.00nan;0;0
33582;215733;99;36;38;6;32;.842;3600000;0
33582;205799;86;68;17;1;16;.941;3600000;0
33582;-1;99;0;0;0;0;.00nan;0;0
33583;215785;94;86;41;2;39;.951;3564000;0
33583;221137;92;0;0;0;0;.00nan;0;0
33583;-1;92;87;18;0;18;1.000;3600000;0
33583;-1;94;0;0;0;0;.00nan;0;0
33584;208417;101;0;0;0;0;.00nan;0;0
33584;220873;101;87;17;0;17;1.000;3600000;0
33584;210603;104;35;41;7;34;.829;3107000;0
33584;208300;104;53;2;0;2;1.000;493000;0
33585;210428;103;0;0;0;0;.00nan;0;0
33585;212487;95;52;16;2;14;.875;3555000;0
33585;222835;103;99;45;1;44;.978;3600000;0
33585;-1;95;0;0;0;0;.00nan;0;0
33586;205318;97;0;0;0;0;.00nan;0;0
33586;215785;94;56;25;4;21;.840;3600000;0
33586;212354;97;35;26;5;21;.808;3573000;0
33586;-1;94;0;0;0;0;.00nan;0;0
33587;210222;90;79;27;2;25;.926;3558000;0
33587;212343;96;93;30;1;29;.967;3600000;0
33587;207239;90;0;0;0;0;.00nan;0;0
33587;-1;96;0;0;0;0;.00nan;0;0
33588;205076;87;80;27;1;26;.963;3600000;0
33588;210439;98;66;19;1;18;.947;2748000;0
33588;207118;98;21;8;4;4;.500;852000;0
33588;-1;87;0;0;0;0;.00nan;0;0
33589;205124;89;63;22;1;21;.955;3600000;0
33589;215733;99;0;0;0;0;.00nan;0;0
33589;-1;89;0;0;0;0;.00nan;0;0
33589;-1;99;57;26;3;23;.885;3563000;0
33590;209784;91;0;0;0;0;.00nan;0;0
33590;205429;91;91;40;3;37;.925;3600000;0
33590;215735;93;71;26;2;24;.923;3600000;0
33590;-1;93;0;0;0;0;.00nan;0;0
33591;210428;103;86;46;4;42;.913;3600000;0
33591;221137;92;0;0;0;0;.00nan;0;0
33591;222835;103;0;0;0;0;.00nan;0;0
33591;-1;92;75;30;2;28;.933;3600000;0
33592;203179;102;0;0;0;0;.00nan;0;0
33592;209796;107;68;26;2;24;.923;3600000;0
33592;210923;102;61;44;5;39;.886;3600000;0
33592;217421;107;0;0;0;0;.00nan;0;0
33593;208417;101;0;0;0;0;.00nan;0;0
33593;220873;101;37;28;5;23;.821;3600000;0
33593;215575;100;75;40;3;37;.925;3600000;0
33593;212368;100;0;0;0;0;.00nan;0;0
33594;205015;105;0;0;0;0;.00nan;0;0
33594;205112;105;71;19;1;18;.947;3600000;0
33594;210603;104;0;0;0;0;.00nan;0;0
33594;208300;104;92;50;3;47;.940;3564000;0
33595;215733;99;43;33;5;28;.848;3600000;0
33595;217437;88;69;26;2;24;.923;3600000;0
33595;-1;88;0;0;0;0;.00nan;0;0
33595;-1;99;0;0;0;0;.00nan;0;0
33596;205076;87;0;0;0;0;.00nan;0;0
33596;205124;89;0;0;0;0;.00nan;0;0
33596;-1;89;78;37;3;34;.919;3600000;0
33596;-1;87;65;42;5;37;.881;3568000;0
33597;205121;86;0;0;0;0;.00nan;0;0
33597;210439;98;0;0;0;0;.00nan;0;0
33597;205799;86;82;15;0;15;1.000;3600000;0
33597;207118;98;57;39;5;34;.872;3600000;0
33598;209784;91;54;41;6;35;.854;3600000;0
33598;205429;91;0;0;0;0;.00nan;0;0
33598;215735;93;0;0;0;0;.00nan;0;0
33598;-1;93;96;35;1;34;.971;3600000;0
33599;205015;105;51;15;2;13;.867;3600000;0
33599;205112;105;0;0;0;0;.00nan;0;0
33599;210603;104;49;46;7;39;.848;3600000;0
33599;208300;104;0;0;0;0;.00nan;0;0
33600;208417;101;58;35;4;31;.886;3600000;0
33600;220873;101;0;0;0;0;.00nan;0;0
33600;215575;100;0;0;0;0;.00nan;0;0
33600;212368;100;93;35;1;34;.971;3600000;0
33601;221137;92;70;23;2;21;.913;3600000;0
33601;212487;95;0;0;0;0;.00nan;0;0
33601;-1;95;62;44;5;39;.886;3600000;0
33601;-1;92;0;0;0;0;.00nan;0;0
33602;203179;102;83;27;2;25;.926;3600000;0
33602;209796;107;77;38;3;35;.921;3552000;0
33602;210923;102;0;0;0;0;.00nan;0;0
33602;217421;107;0;0;0;0;.00nan;0;0
33603;205076;87;79;50;5;45;.900;3600000;0
33603;210222;90;0;0;0;0;.00nan;0;0
33603;207239;90;74;21;1;20;.952;3600000;0
33603;-1;87;0;0;0;0;.00nan;0;0
33604;210428;103;0;0;0;0;.00nan;0;0
33604;205318;97;33;26;5;21;.808;3572000;0
33604;212354;97;0;0;0;0;.00nan;0;0
33604;222835;103;63;28;3;25;.893;3600000;0
33605;205121;86;0;0;0;0;.00nan;0;0
33605;205124;89;74;47;4;43;.915;3600000;0
33605;205799;86;76;22;1;21;.955;3600000;0
33605;-1;89;0;0;0;0;.00nan;0;0
33606;215785;94;58;24;2;22;.917;3600000;0
33606;212487;95;72;53;5;48;.906;3600000;0
33606;-1;95;0;0;0;0;.00nan;0;0
33606;-1;94;0;0;0;0;.00nan;0;0
33607;209796;107;43;33;5;28;.848;3600000;0
33607;205119;106;0;0;0;0;.00nan;0;0
33607;210368;106;58;34;4;30;.882;3600000;0
33607;217421;107;0;0;0;0;.00nan;0;0
33608;203179;102;0;0;0;0;.00nan;0;0
33608;205015;105;0;0;0;0;.00nan;0;0
33608;205112;105;100;24;0;24;1.000;3600000;0
33608;210923;102;69;41;4;37;.902;3600000;0
33609;209784;91;0;0;0;0;.00nan;0;0
33609;205429;91;69;29;2;27;.931;3600000;0
33609;212343;96;0;0;0;0;.00nan;0;0
33609;-1;96;65;34;3;31;.912;3551000;0
33610;203179;102;58;49;6;43;.878;3567000;0
33610;205119;106;67;37;4;33;.892;3600000;0
33610;210368;106;0;0;0;0;.00nan;0;0
33610;210923;102;0;0;0;0;.00nan;0;0
33611;215735;93;0;0;0;0;.00nan;0;0
33611;217437;88;63;22;2;20;.909;3662000;0
33611;-1;88;0;0;0;0;.00nan;0;0
33611;-1;93;82;41;3;38;.927;3662000;0
33612;205121;86;0;0;0;0;.00nan;0;0
33612;221137;92;59;30;3;27;.900;3600000;0
33612;205799;86;49;34;4;30;.882;3562000;0
33612;-1;92;0;0;0;0;.00nan;0;0
33613;208417;101;0;0;0;0;.00nan;0;0
33613;205015;105;0;0;0;0;.00nan;0;0
33613;205112;105;54;17;2;15;.882;3600000;0
33613;220873;101;74;36;3;33;.917;3545000;0
33614;205124;89;51;30;4;26;.867;3600000;0
33614;215735;93;0;0;0;0;.00nan;0;0
33614;-1;93;57;40;5;35;.875;3559000;0
33614;-1;89;0;0;0;0;.00nan;0;0
33615;212343;96;88;32;1;31;.969;3631000;0
33615;217437;88;61;21;2;19;.905;3631000;0
33615;-1;88;0;0;0;0;.00nan;0;0
33615;-1;96;0;0;0;0;.00nan;0;0
33616;205121;86;0;0;0;0;.00nan;0;0
33616;205318;97;51;7;1;6;.857;361000;0
33616;205799;86;79;32;2;30;.938;3600000;0
33616;212354;97;51;36;6;30;.833;3239000;0
33617;209784;91;37;40;7;33;.825;3600000;0
33617;205429;91;0;0;0;0;.00nan;0;0
33617;221137;92;65;34;3;31;.912;3600000;0
33617;-1;92;0;0;0;0;.00nan;0;0
33618;205015;105;0;0;0;0;.00nan;0;0
33618;205112;105;64;26;3;23;.885;3600000;0
33618;215575;100;0;0;0;0;.00nan;0;0
33618;212368;100;43;24;4;20;.833;3559000;0
33619;205076;87;99;43;2;41;.953;3600000;0
33619;212487;95;0;0;0;0;.00nan;0;0
33619;-1;95;49;27;4;23;.852;3600000;0
33619;-1;87;0;0;0;0;.00nan;0;0
33620;208417;101;0;0;0;0;.00nan;0;0
33620;220873;101;61;29;3;26;.897;3600000;0
33620;215733;99;0;0;0;0;.00nan;0;0
33620;-1;99;35;18;4;14;.778;3592000;0
33621;209796;107;37;21;4;17;.810;1197000;0
33621;215785;94;31;24;5;19;.792;3600000;0
33621;217421;107;31;17;4;13;.765;2403000;0
33621;-1;94;0;0;0;0;.00nan;0;0
33622;210428;103;66;37;4;33;.892;3600000;0
33622;210603;104;81;36;3;33;.917;3600000;0
33622;222835;103;0;0;0;0;.00nan;0;0
33622;208300;104;0;0;0;0;.00nan;0;0
33623;203179;102;71;37;4;33;.892;3900000;0
33623;210439;98;0;0;0;0;.00nan;0;0
33623;210923;102;0;0;0;0;.00nan;0;0
33623;207118;98;77;40;4;36;.900;3900000;0
33624;210222;90;50;32;5;27;.844;3600000;0
33624;215735;93;24;22;6;16;.727;2360000;0
33624;207239;90;0;0;0;0;.00nan;0;0
33624;-1;93;53;16;2;14;.875;1240000;0
33625;212343;96;0;0;0;0;.00nan;0;0
33625;217437;88;0;0;0;0;.00nan;0;0
33625;-1;88;66;35;3;32;.914;3600000;0
33625;-1;96;45;32;5;27;.844;3561000;0
33626;209784;91;0;0;0;0;.00nan;0;0
33626;205124;89;0;0;0;0;.00nan;0;0
33626;205429;91;80;33;2;31;.939;3600000;0
33626;-1;89;44;25;4;21;.840;3568000;0
33627;205015;105;76;26;2;24;.923;3900000;0
33627;205112;105;0;0;0;0;.00nan;0;0
33627;215575;100;0;0;0;0;.00nan;0;0
33627;212368;100;80;32;2;30;.938;3900000;0
33628;205076;87;0;0;0;0;.00nan;0;0
33628;221137;92;69;23;2;21;.913;3600000;0
33628;-1;92;0;0;0;0;.00nan;0;0
33628;-1;87;74;35;3;32;.914;3553000;0
33629;205119;106;0;0;0;0;.00nan;0;0
33629;210368;106;67;28;3;25;.893;3900000;0
33629;215785;94;74;33;3;30;.909;3900000;0
33629;-1;94;0;0;0;0;.00nan;0;0
33630;210428;103;0;0;0;0;.00nan;0;0
33630;210603;104;37;28;5;23;.821;3600000;0
33630;222835;103;54;27;4;23;.852;3600000;0
33630;208300;104;0;0;0;0;.00nan;0;0
33631;208417;101;36;30;6;24;.800;3600000;0
33631;220873;101;0;0;0;0;.00nan;0;0
33631;215733;99;64;30;3;27;.900;3600000;0
33631;-1;99;0;0;0;0;.00nan;0;0
33632;209784;91;78;46;3;43;.935;3600000;0
33632;210222;90;0;0;0;0;.00nan;0;0
33632;205429;91;0;0;0;0;.00nan;0;0
33632;207239;90;100;27;0;27;1.000;3600000;0
33633;205076;87;95;43;2;41;.953;3900000;0
33633;205318;97;83;29;2;27;.931;3900000;0
33633;212354;97;0;0;0;0;.00nan;0;0
33633;-1;87;0;0;0;0;.00nan;0;0
33634;205121;86;0;0;0;0;.00nan;0;0
33634;205799;86;68;34;4;30;.882;3600000;0
33634;212487;95;93;34;1;33;.971;3600000;0
33634;-1;95;0;0;0;0;.00nan;0;0
33635;203179;102;0;0;0;0;.00nan;0;0
33635;210439;98;33;37;7;30;.811;3600000;0
33635;210923;102;97;22;0;22;1.000;3600000;0
33635;207118;98;0;0;0;0;.00nan;0;0
33636;209796;107;67;24;2;22;.917;3600000;0
33636;210428;103;69;31;4;27;.871;3593000;0
33636;217421;107;0;0;0;0;.00nan;0;0
33636;222835;103;0;0;0;0;.00nan;0;0
33637;205119;106;50;32;5;27;.844;3900000;0
33637;210368;106;0;0;0;0;.00nan;0;0
33637;210603;104;0;0;0;0;.00nan;0;0
33637;208300;104;58;44;5;39;.886;3900000;0
33638;205119;106;0;0;0;0;.00nan;0;0
33638;210368;106;81;27;1;26;.963;3600000;0
33638;210428;103;0;0;0;0;.00nan;0;0
33638;222835;103;39;31;5;26;.839;3600000;0
33639;208417;101;0;0;0;0;.00nan;0;0
33639;209796;107;55;31;4;27;.871;3600000;0
33639;220873;101;100;31;0;31;1.000;3600000;0
33639;217421;107;0;0;0;0;.00nan;0;0
33640;209784;91;0;0;0;0;.00nan;0;0
33640;205429;91;65;36;4;32;.889;3567000;0
33640;217437;88;84;39;3;36;.923;3600000;0
33640;-1;88;0;0;0;0;.00nan;0;0
33641;205076;87;90;35;2;33;.943;3568000;0
33641;205121;86;0;0;0;0;.00nan;0;0
33641;205799;86;100;27;0;27;1.000;3600000;0
33641;-1;87;0;0;0;0;.00nan;0;0
33642;210222;90;98;40;1;39;.975;3600000;0
33642;205318;97;51;22;3;19;.864;3517000;0
33642;212354;97;0;0;0;0;.00nan;0;0
33642;207239;90;0;0;0;0;.00nan;0;0
33643;205124;89;53;27;4;23;.852;3600000;0
33643;215735;93;0;0;0;0;.00nan;0;0
33643;-1;93;36;27;5;22;.815;3594000;0
33643;-1;89;0;0;0;0;.00nan;0;0
33644;221137;92;73;20;2;18;.900;3742000;0
33644;212487;95;87;40;3;37;.925;3742000;0
33644;-1;95;0;0;0;0;.00nan;0;0
33644;-1;92;0;0;0;0;.00nan;0;0
33645;205119;106;0;0;0;0;.00nan;0;0
33645;210368;106;63;23;3;20;.870;3600000;0
33645;210603;104;27;26;6;20;.769;3277000;0
33645;208300;104;41;2;1;1;.500;323000;0
33646;210439;98;0;0;0;0;.00nan;0;0
33646;215733;99;0;0;0;0;.00nan;0;0
33646;207118;98;53;46;7;39;.848;3600000;0
33646;-1;99;91;18;0;18;1.000;3600000;0
33647;208417;101;0;0;0;0;.00nan;0;0
33647;203179;102;0;0;0;0;.00nan;0;0
33647;220873;101;76;20;1;19;.950;3900000;0
33647;210923;102;94;34;1;33;.971;3900000;0
33648;215575;100;48;0;0;0;.00nan;390000;0
33648;215785;94;63;30;3;27;.900;3600000;0
33648;212368;100;49;34;6;28;.824;3210000;0
33648;-1;94;0;0;0;0;.00nan;0;0
33649;205015;105;0;0;0;0;.00nan;0;0
33649;205112;105;77;12;0;12;1.000;3600000;0
33649;210428;103;0;0;0;0;.00nan;0;0
33649;222835;103;48;29;4;25;.862;3600000;0
33650;205076;87;0;0;0;0;.00nan;0;0
33650;205121;86;0;0;0;0;.00nan;0;0
33650;205799;86;87;37;2;35;.946;3642000;0
33650;-1;87;83;39;3;36;.923;3642000;0
33651;208417;101;47;24;4;20;.833;3600000;0
33651;203179;102;59;40;5;35;.875;3551000;0
33651;220873;101;0;0;0;0;.00nan;0;0
33651;210923;102;0;0;0;0;.00nan;0;0
33652;209784;91;60;38;4;34;.895;3573000;0
33652;205429;91;0;0;0;0;.00nan;0;0
33652;217437;88;0;0;0;0;.00nan;0;0
33652;-1;88;68;34;3;31;.912;3600000;0
33653;210222;90;0;0;0;0;.00nan;0;0
33653;221137;92;34;24;5;19;.792;3548000;0
33653;207239;90;56;32;4;28;.875;3600000;0
33653;-1;92;0;0;0;0;.00nan;0;0
33654;209796;107;41;47;7;40;.851;3600000;0
33654;210603;104;0;0;0;0;.00nan;0;0
33654;217421;107;0;0;0;0;.00nan;0;0
33654;208300;104;81;36;3;33;.917;3600000;0
33655;205015;105;0;0;0;0;.00nan;0;0
33655;205112;105;68;31;3;28;.903;3600000;0
33655;215785;94;0;0;0;0;.00nan;0;0
33655;-1;94;16;25;6;19;.760;3600000;0
33656;210428;103;86;33;2;31;.939;3600000;0
33656;215575;100;0;0;0;0;.00nan;0;0
33656;212368;100;46;20;3;17;.850;3578000;0
33656;222835;103;0;0;0;0;.00nan;0;0
33657;210439;98;69;46;5;41;.891;3568000;0
33657;215733;99;0;0;0;0;.00nan;0;0
33657;207118;98;0;0;0;0;.00nan;0;0
33657;-1;99;72;39;4;35;.897;3600000;0
33658;205124;89;0;0;0;0;.00nan;0;0
33658;205318;97;0;0;0;0;.00nan;0;0
33658;212354;97;100;37;0;37;1.000;3600000;0
33658;-1;89;66;25;2;23;.920;3523000;0
33659;205121;86;63;14;1;13;.929;3600000;0
33659;205799;86;0;0;0;0;.00nan;0;0
33659;212343;96;38;33;6;27;.818;2093000;0
33659;-1;96;79;21;0;21;1.000;1507000;0
33660;210222;90;60;39;5;34;.872;3564000;0
33660;212487;95;0;0;0;0;.00nan;0;0
33660;207239;90;0;0;0;0;.00nan;0;0
33660;-1;95;62;26;3;23;.885;3600000;0
33661;210439;98;44;5;1;4;.800;402000;0
33661;215733;99;94;23;0;23;1.000;3600000;0
33661;207118;98;37;38;7;31;.816;3198000;0
33661;-1;99;0;0;0;0;.00nan;0;0
33662;205119;106;56;27;4;23;.852;3600000;0
33662;210368;106;0;0;0;0;.00nan;0;0
33662;215575;100;0;0;0;0;.00nan;0;0
33662;212368;100;19;21;6;15;.714;3584000;0
33663;215735;93;0;0;0;0;.00nan;0;0
33663;212487;95;0;0;0;0;.00nan;0;0
33663;-1;93;100;26;0;26;1.000;3600000;0
33663;-1;95;80;24;1;23;.958;3600000;0
33664;215575;100;68;33;3;30;.909;3526000;0
33664;210603;104;98;32;1;31;.969;3600000;0
33664;212368;100;0;0;0;0;.00nan;0;0
33664;208300;104;0;0;0;0;.00nan;0;0
33665;209796;107;63;28;3;25;.893;3900000;0
33665;215785;94;72;35;3;32;.914;3900000;0
33665;217421;107;0;0;0;0;.00nan;0;0
33665;-1;94;0;0;0;0;.00nan;0;0
33666;205076;87;89;42;4;38;.905;3900000;0
33666;221137;92;39;19;4;15;.789;3900000;0
33666;-1;92;0;0;0;0;.00nan;0;0
33666;-1;87;0;0;0;0;.00nan;0;0
33667;205121;86;0;0;0;0;.00nan;0;0
33667;205124;89;55;33;4;29;.879;3600000;0
33667;205799;86;100;34;1;33;.971;3600000;0
33667;-1;89;0;0;0;0;.00nan;0;0
33668;215735;93;0;0;0;0;.00nan;0;0
33668;212343;96;0;0;0;0;.00nan;0;0
33668;-1;96;88;23;0;23;1.000;3600000;0
33668;-1;93;90;47;3;44;.936;3600000;0
33669;209796;107;60;23;2;21;.913;3600000;0
33669;210428;103;0;0;0;0;.00nan;0;0
33669;217421;107;0;0;0;0;.00nan;0;0
33669;222835;103;70;36;3;33;.917;3600000;0
33670;208417;101;0;0;0;0;.00nan;0;0
33670;205015;105;0;0;0;0;.00nan;0;0
33670;205112;105;79;39;3;36;.923;3570000;0
33670;220873;101;70;23;2;21;.913;3600000;0
33671;210222;90;99;50;1;49;.980;3600000;0
33671;221137;92;53;20;3;17;.850;3554000;0
33671;207239;90;0;0;0;0;.00nan;0;0
33671;-1;92;0;0;0;0;.00nan;0;0
33672;205076;87;77;41;3;38;.927;3569000;0
33672;217437;88;0;0;0;0;.00nan;0;0
33672;-1;88;71;23;1;22;.957;3600000;0
33672;-1;87;0;0;0;0;.00nan;0;0
33673;205124;89;0;0;0;0;.00nan;0;0
33673;212343;96;0;0;0;0;.00nan;0;0
33673;-1;96;62;27;3;24;.889;3555000;0
33673;-1;89;86;39;2;37;.949;3600000;0
33674;209784;91;0;0;0;0;.00nan;0;0
33674;205121;86;0;0;0;0;.00nan;0;0
33674;205429;91;66;29;2;27;.931;3600000;0
33674;205799;86;54;29;4;25;.862;3515000;0
33675;205318;97;0;0;0;0;.00nan;0;0
33675;212354;97;45;24;3;21;.875;3600000;0
33675;212487;95;44;30;5;25;.833;3530000;0
33675;-1;95;0;0;0;0;.00nan;0;0
33676;203179;102;0;0;0;0;.00nan;0;0
33676;205119;106;0;0;0;0;.00nan;0;0
33676;210368;106;75;28;3;25;.893;3560000;0
33676;210923;102;94;38;2;36;.947;3600000;0
33677;208417;101;67;12;0;12;1.000;525000;0
33677;205015;105;0;0;0;0;.00nan;0;0
33677;205112;105;56;18;3;15;.833;3600000;0
33677;220873;101;32;36;7;29;.806;3075000;0
33678;215575;100;66;37;4;33;.892;3570000;0
33678;215733;99;71;28;2;26;.929;3600000;0
33678;212368;100;0;0;0;0;.00nan;0;0
33678;-1;99;0;0;0;0;.00nan;0;0
33679;209796;107;60;30;3;27;.900;3745000;0
33679;215785;94;61;34;4;30;.882;3745000;0
33679;217421;107;0;0;0;0;.00nan;0;0
33679;-1;94;0;0;0;0;.00nan;0;0
33680;210439;98;59;27;3;24;.889;3600000;0
33680;210603;104;30;24;5;19;.792;3600000;0
33680;207118;98;0;0;0;0;.00nan;0;0
33680;208300;104;0;0;0;0;.00nan;0;0
33681;205318;97;99;41;1;40;.976;3600000;0
33681;215735;93;75;33;2;31;.939;3555000;0
33681;212354;97;0;0;0;0;.00nan;0;0
33681;-1;93;0;0;0;0;.00nan;0;0
33682;221137;92;55;28;3;25;.893;3600000;0
33682;217437;88;37;35;6;29;.829;3600000;0
33682;-1;88;0;0;0;0;.00nan;0;0
33682;-1;92;0;0;0;0;.00nan;0;0
33683;209784;91;66;18;1;17;.944;3600000;0
33683;205076;87;0;0;0;0;.00nan;0;0
33683;205429;91;0;0;0;0;.00nan;0;0
33683;-1;87;87;47;3;44;.936;3600000;0
33684;210222;90;0;0;0;0;.00nan;0;0
33684;212343;96;43;34;5;29;.853;3594000;0
33684;207239;90;60;33;4;29;.879;3600000;0
33684;-1;96;0;0;0;0;.00nan;0;0
33685;205015;105;0;0;0;0;.00nan;0;0
33685;205112;105;100;27;0;27;1.000;3600000;0
33685;210603;104;28;26;6;20;.769;2385000;0
33685;208300;104;41;17;3;14;.824;1215000;0
33686;210428;103;69;24;2;22;.917;3520000;0
33686;215785;94;100;26;0;26;1.000;3600000;0
33686;222835;103;0;0;0;0;.00nan;0;0
33686;-1;94;0;0;0;0;.00nan;0;0
33687;209796;107;0;0;0;0;.00nan;0;0
33687;215733;99;0;0;0;0;.00nan;0;0
33687;217421;107;72;25;2;23;.920;3600000;0
33687;-1;99;43;33;5;28;.848;3600000;0
33688;203179;102;0;0;0;0;.00nan;0;0
33688;215575;100;0;0;0;0;.00nan;0;0
33688;210923;102;90;40;2;38;.950;3600000;0
33688;212368;100;47;26;4;22;.846;3558000;0
33689;205124;89;55;37;4;33;.892;3900000;0
33689;221137;92;69;37;4;33;.892;2933000;0
33689;-1;89;0;0;0;0;.00nan;0;0
33689;-1;92;63;7;0;7;1.000;967000;0
33690;210222;90;71;46;4;42;.913;3900000;0
33690;205121;86;0;0;0;0;.00nan;0;0
33690;205799;86;57;34;4;30;.882;3900000;0
33690;207239;90;0;0;0;0;.00nan;0;0
33691;205318;97;65;34;3;31;.912;2556000;0
33691;212354;97;17;8;4;4;.500;1044000;0
33691;212487;95;0;0;0;0;.00nan;0;0
33691;-1;95;73;26;2;24;.923;3600000;0
33692;209796;107;30;7;3;4;.571;503000;0
33692;205119;106;48;22;4;18;.818;3599000;0
33692;210368;106;0;0;0;0;.00nan;0;0
33692;217421;107;100;42;0;42;1.000;3097000;0
33693;205015;105;0;0;0;0;.00nan;0;0
33693;205112;105;76;18;1;17;.944;3600000;0
33693;210428;103;51;22;3;19;.864;2436000;0
33693;222835;103;28;12;4;8;.667;1164000;0
33694;210439;98;50;9;1;8;.889;1419000;0
33694;210603;104;0;0;0;0;.00nan;0;0
33694;207118;98;21;29;7;22;.759;2181000;0
33694;208300;104;49;23;4;19;.826;3600000;0
33695;208417;101;0;0;0;0;.00nan;0;0
33695;220873;101;86;26;1;25;.962;3600000;0
33695;215785;94;53;29;3;26;.897;3582000;0
33695;-1;94;0;0;0;0;.00nan;0;0
33696;212487;95;0;0;0;0;.00nan;0;0
33696;217437;88;82;35;3;32;.914;3600000;0
33696;-1;88;0;0;0;0;.00nan;0;0
33696;-1;95;52;35;5;30;.857;3514000;0
33697;205121;86;0;0;0;0;.00nan;0;0
33697;215735;93;0;0;0;0;.00nan;0;0
33697;205799;86;84;15;0;15;1.000;3600000;0
33697;-1;93;67;35;4;31;.886;3600000;0
33698;221137;92;71;33;3;30;.909;3523000;0
33698;212343;96;71;23;1;22;.957;3600000;0
33698;-1;96;0;0;0;0;.00nan;0;0
33698;-1;92;0;0;0;0;.00nan;0;0
33699;209784;91;0;0;0;0;.00nan;0;0
33699;205124;89;69;22;1;21;.955;1733000;0
33699;205429;91;42;21;4;17;.810;3600000;0
33699;-1;89;36;26;5;21;.808;1796000;0
33700;210222;90;90;56;4;52;.929;3600000;0
33700;212487;95;99;25;0;25;1.000;3600000;0
33700;207239;90;0;0;0;0;.00nan;0;0
33700;-1;95;0;0;0;0;.00nan;0;0
33701;205124;89;0;0;0;0;.00nan;0;0
33701;205318;97;70;32;3;29;.906;3808000;0
33701;212354;97;0;0;0;0;.00nan;0;0
33701;-1;89;59;23;2;21;.913;3808000;0
33702;205119;106;0;0;0;0;.00nan;0;0
33702;210368;106;50;34;5;29;.853;3600000;0
33702;210428;103;0;0;0;0;.00nan;0;0
33702;222835;103;56;20;2;18;.900;3600000;0
33703;203179;102;0;0;0;0;.00nan;0;0
33703;210603;104;98;47;1;46;.979;3553000;0
33703;210923;102;99;16;0;16;1.000;3600000;0
33703;208300;104;0;0;0;0;.00nan;0;0
33704;205076;87;70;49;6;43;.878;3311000;0
33704;215735;93;71;26;2;24;.923;3600000;0
33704;-1;93;0;0;0;0;.00nan;0;0
33704;-1;87;58;6;0;6;1.000;289000;0
33705;208417;101;0;0;0;0;.00nan;0;0
33705;220873;101;59;12;1;11;.917;3600000;0
33705;210439;98;67;36;3;33;.917;3600000;0
33705;207118;98;0;0;0;0;.00nan;0;0
33706;210222;90;66;29;3;26;.897;3600000;0
33706;215735;93;0;0;0;0;.00nan;0;0
33706;207239;90;0;0;0;0;.00nan;0;0
33706;-1;93;75;40;4;36;.900;3544000;0
33707;205076;87;43;44;6;38;.864;3600000;0
33707;205121;86;0;0;0;0;.00nan;0;0
33707;205799;86;95;37;1;36;.973;3600000;0
33707;-1;87;0;0;0;0;.00nan;0;0
33708;212343;96;0;0;0;0;.00nan;0;0
33708;212487;95;93;37;1;36;.973;3600000;0
33708;-1;96;70;27;2;25;.926;3572000;0
33708;-1;95;0;0;0;0;.00nan;0;0
33709;209784;91;0;0;0;0;.00nan;0;0
33709;205318;97;0;0;0;0;.00nan;0;0
33709;205429;91;75;25;2;23;.920;3900000;0
33709;212354;97;97;53;2;51;.962;3900000;0
33710;221137;92;37;26;5;21;.808;3600000;0
33710;217437;88;46;45;6;39;.867;3574000;0
33710;-1;88;0;0;0;0;.00nan;0;0
33710;-1;92;0;0;0;0;.00nan;0;0
33711;208417;101;45;6;1;5;.833;1820000;0
33711;203179;102;0;0;0;0;.00nan;0;0
33711;220873;101;8;15;6;9;.600;1780000;0
33711;210923;102;91;54;4;50;.926;3600000;0
33712;210439;98;35;29;5;24;.828;3600000;0
33712;215575;100;55;30;4;26;.867;3600000;0
33712;212368;100;0;0;0;0;.00nan;0;0
33712;207118;98;0;0;0;0;.00nan;0;0
33713;209796;107;80;40;3;37;.925;3600000;0
33713;205119;106;48;32;4;28;.875;3562000;0
33713;210368;106;0;0;0;0;.00nan;0;0
33713;217421;107;0;0;0;0;.00nan;0;0
33714;215733;99;0;0;0;0;.00nan;0;0
33714;210603;104;64;43;5;38;.884;3600000;0
33714;208300;104;0;0;0;0;.00nan;0;0
33714;-1;99;71;28;2;26;.929;3600000;0
33715;210428;103;75;38;4;34;.895;3562000;0
33715;215785;94;45;14;2;12;.857;3600000;0
33715;222835;103;0;0;0;0;.00nan;0;0
33715;-1;94;0;0;0;0;.00nan;0;0
33716;205318;97;83;48;4;44;.917;3600000;0
33716;212354;97;0;0;0;0;.00nan;0;0
33716;217437;88;0;0;0;0;.00nan;0;0
33716;-1;88;35;24;5;19;.792;3560000;0
33717;205076;87;0;0;0;0;.00nan;0;0
33717;210222;90;0;0;0;0;.00nan;0;0
33717;207239;90;54;23;3;20;.870;3600000;0
33717;-1;87;53;33;4;29;.879;3567000;0
33718;205124;89;43;16;3;13;.813;3600000;0
33718;212487;95;0;0;0;0;.00nan;0;0
33718;-1;89;0;0;0;0;.00nan;0;0
33718;-1;95;61;37;5;32;.865;3564000;0
33719;205121;86;29;22;5;17;.773;3600000;0
33719;205799;86;0;0;0;0;.00nan;0;0
33719;212343;96;30;27;6;21;.778;2194000;0
33719;-1;96;42;20;3;17;.850;1406000;0
33720;209784;91;51;15;2;13;.867;3600000;0
33720;205429;91;0;0;0;0;.00nan;0;0
33720;221137;92;76;38;3;35;.921;3572000;0
33720;-1;92;0;0;0;0;.00nan;0;0
33721;205015;105;0;0;0;0;.00nan;0;0
33721;205112;105;92;34;2;32;.941;3600000;0
33721;210603;104;56;42;6;36;.857;3204000;0
33721;208300;104;53;8;1;7;.875;396000;0
33722;210439;98;0;0;0;0;.00nan;0;0
33722;215575;100;0;0;0;0;.00nan;0;0
33722;212368;100;65;32;3;29;.906;3600000;0
33722;207118;98;56;39;5;34;.872;3600000;0
33723;209796;107;0;0;0;0;.00nan;0;0
33723;215785;94;76;30;2;28;.933;3600000;0
33723;217421;107;77;38;3;35;.921;3571000;0
33723;-1;94;0;0;0;0;.00nan;0;0
33724;205119;106;0;0;0;0;.00nan;0;0
33724;210368;106;78;40;4;36;.900;3900000;0
33724;215733;99;62;35;4;31;.886;3900000;0
33724;-1;99;0;0;0;0;.00nan;0;0
33725;208417;101;0;0;0;0;.00nan;0;0
33725;203179;102;50;25;4;21;.840;3542000;0
33725;220873;101;54;18;2;16;.889;3600000;0
33725;210923;102;0;0;0;0;.00nan;0;0
33726;209784;91;60;34;4;30;.882;3572000;0
33726;205124;89;0;0;0;0;.00nan;0;0
33726;205429;91;0;0;0;0;.00nan;0;0
33726;-1;89;62;29;3;26;.897;3600000;0
33727;205318;97;55;4;0;4;1.000;991000;0
33727;221137;92;36;20;5;15;.750;3600000;0
33727;212354;97;34;33;6;27;.818;2563000;0
33727;-1;92;0;0;0;0;.00nan;0;0
33728;209796;107;78;24;1;23;.958;3600000;0
33728;205015;105;57;5;0;5;1.000;717000;0
33728;205112;105;34;36;6;30;.833;2883000;0
33728;217421;107;0;0;0;0;.00nan;0;0
33729;208417;101;0;0;0;0;.00nan;0;0
33729;220873;101;63;34;4;30;.882;3576000;0
33729;215785;94;63;20;2;18;.900;3600000;0
33729;-1;94;0;0;0;0;.00nan;0;0
33730;210428;103;61;25;2;23;.920;3600000;0
33730;210603;104;75;37;3;34;.919;3600000;0
33730;222835;103;0;0;0;0;.00nan;0;0
33730;208300;104;0;0;0;0;.00nan;0;0
33731;215735;93;0;0;0;0;.00nan;0;0
33731;212343;96;0;0;0;0;.00nan;0;0
33731;-1;96;74;26;3;23;.885;3900000;0
33731;-1;93;73;32;3;29;.906;3882000;0
33732;205119;106;0;0;0;0;.00nan;0;0
33732;210368;106;60;27;3;24;.889;3558000;0
33732;210603;104;0;0;0;0;.00nan;0;0
33732;208300;104;68;23;2;21;.913;3600000;0
33733;210439;98;0;0;0;0;.00nan;0;0
33733;215733;99;0;0;0;0;.00nan;0;0
33733;207118;98;66;37;3;34;.919;3600000;0
33733;-1;99;33;31;6;25;.806;3600000;0
33734;210222;90;26;7;3;4;.571;513000;0
33734;217437;88;65;34;4;30;.882;3600000;0
33734;207239;90;60;25;2;23;.920;3077000;0
33734;-1;88;0;0;0;0;.00nan;0;0
33735;210222;90;61;40;4;36;.900;3522000;0
33735;205318;97;76;24;2;22;.917;3600000;0
33735;212354;97;0;0;0;0;.00nan;0;0
33735;207239;90;0;0;0;0;.00nan;0;0
33736;205124;89;0;0;0;0;.00nan;0;0
33736;212343;96;63;31;4;27;.871;3520000;0
33736;-1;96;0;0;0;0;.00nan;0;0
33736;-1;89;81;35;2;33;.943;3600000;0
33737;205121;86;0;0;0;0;.00nan;0;0
33737;215735;93;0;0;0;0;.00nan;0;0
33737;205799;86;73;21;1;20;.952;3600000;0
33737;-1;93;41;39;6;33;.846;3600000;0
33738;209784;91;0;0;0;0;.00nan;0;0
33738;205076;87;67;40;4;36;.900;3545000;0
33738;205429;91;61;29;3;26;.897;3600000;0
33738;-1;87;0;0;0;0;.00nan;0;0
33739;221137;92;54;28;4;24;.857;3587000;0
33739;212487;95;77;31;2;29;.935;3600000;0
33739;-1;95;0;0;0;0;.00nan;0;0
33739;-1;92;0;0;0;0;.00nan;0;0
33740;203179;102;0;0;0;0;.00nan;0;0
33740;215575;100;91;17;0;17;1.000;3600000;0
33740;210923;102;83;33;1;32;.970;3565000;0
33740;212368;100;0;0;0;0;.00nan;0;0
33741;209796;107;57;41;4;37;.902;3900000;0
33741;205119;106;39;23;4;19;.826;3900000;0
33741;210368;106;0;0;0;0;.00nan;0;0
33741;217421;107;0;0;0;0;.00nan;0;0
33742;205015;105;0;0;0;0;.00nan;0;0
33742;205112;105;75;29;2;27;.931;3560000;0
33742;215733;99;0;0;0;0;.00nan;0;0
33742;-1;99;74;23;1;22;.957;3600000;0
33743;210428;103;95;50;3;47;.940;3555000;0
33743;215785;94;69;15;1;14;.933;3600000;0
33743;222835;103;0;0;0;0;.00nan;0;0
33743;-1;94;0;0;0;0;.00nan;0;0
33744;208417;101;0;0;0;0;.00nan;0;0
33744;220873;101;43;25;4;21;.840;3900000;0
33744;210439;98;55;36;4;32;.889;3900000;0
33744;207118;98;0;0;0;0;.00nan;0;0
33745;205076;87;87;42;4;38;.905;3600000;0
33745;215735;93;57;28;3;25;.893;3600000;0
33745;-1;93;0;0;0;0;.00nan;0;0
33745;-1;87;0;0;0;0;.00nan;0;0
33746;205318;97;0;0;0;0;.00nan;0;0
33746;212354;97;47;41;7;34;.829;3648000;0
33746;217437;88;35;35;6;29;.829;3648000;0
33746;-1;88;0;0;0;0;.00nan;0;0
33747;205124;89;0;0;0;0;.00nan;0;0
33747;212343;96;0;0;0;0;.00nan;0;0
33747;-1;96;61;39;4;35;.897;3586000;0
33747;-1;89;74;25;2;23;.920;3600000;0
33748;203179;102;100;27;0;27;1.000;3600000;0
33748;215575;100;31;11;3;8;.727;3600000;0
33748;210923;102;0;0;0;0;.00nan;0;0
33748;212368;100;0;0;0;0;.00nan;0;0
33749;209784;91;96;35;1;34;.971;3600000;0
33749;205121;86;65;37;3;34;.919;3526000;0
33749;205429;91;0;0;0;0;.00nan;0;0
33749;205799;86;0;0;0;0;.00nan;0;0
33750;205015;105;53;27;3;24;.889;3713000;0
33750;205112;105;0;0;0;0;.00nan;0;0
33750;215733;99;60;34;4;30;.882;3713000;0
33750;-1;99;0;0;0;0;.00nan;0;0
33751;221137;92;15;20;6;14;.700;2528000;0
33751;212487;95;0;0;0;0;.00nan;0;0
33751;-1;95;77;38;3;35;.921;3600000;0
33751;-1;92;53;8;1;7;.875;1072000;0
33752;210428;103;0;0;0;0;.00nan;0;0
33752;215785;94;0;0;0;0;.00nan;0;0
33752;222835;103;49;31;4;27;.871;3600000;0
33752;-1;94;61;15;1;14;.933;3600000;0
33753;209796;107;0;0;0;0;.00nan;0;0
33753;210603;104;25;12;4;8;.667;909000;0
33753;217421;107;70;35;3;32;.914;3600000;0
33753;208300;104;27;23;5;18;.783;2691000;0
33754;208417;101;44;28;4;24;.857;3600000;0
33754;220873;101;0;0;0;0;.00nan;0;0
33754;210439;98;0;0;0;0;.00nan;0;0
33754;207118;98;88;36;1;35;.972;3600000;0
33755;209796;107;88;39;2;37;.949;3816000;0
33755;205015;105;0;0;0;0;.00nan;0;0
33755;205112;105;68;27;3;24;.889;3816000;0
33755;217421;107;0;0;0;0;.00nan;0;0
33756;210222;90;45;33;6;27;.818;3600000;0
33756;205121;86;0;0;0;0;.00nan;0;0
33756;205799;86;47;22;3;19;.864;3600000;0
33756;207239;90;0;0;0;0;.00nan;0;0
33757;205124;89;0;0;0;0;.00nan;0;0
33757;205318;97;38;8;2;6;.750;797000;0
33757;212354;97;20;29;6;23;.793;2803000;0
33757;-1;89;67;19;1;18;.947;3600000;0
33758;215735;93;0;0;0;0;.00nan;0;0
33758;221137;92;21;22;6;16;.727;2099000;0
33758;-1;93;76;27;2;25;.926;3600000;0
33758;-1;92;51;11;2;9;.818;1501000;0
33759;209784;91;0;0;0;0;.00nan;0;0
33759;205429;91;64;29;2;27;.931;3600000;0
33759;212487;95;29;24;6;18;.750;3600000;0
33759;-1;95;0;0;0;0;.00nan;0;0
33760;203179;102;0;0;0;0;.00nan;0;0
33760;210439;98;59;44;6;38;.864;3600000;0
33760;210923;102;76;8;0;8;1.000;3600000;0
33760;207118;98;0;0;0;0;.00nan;0;0
33761;215733;99;0;0;0;0;.00nan;0;0
33761;215785;94;69;35;4;31;.886;3545000;0
33761;-1;99;74;24;2;22;.917;3600000;0
33761;-1;94;0;0;0;0;.00nan;0;0
33762;208417;101;0;0;0;0;.00nan;0;0
33762;220873;101;58;23;3;20;.870;3600000;0
33762;210428;103;0;0;0;0;.00nan;0;0
33762;222835;103;32;28;6;22;.786;3600000;0
33763;215575;100;0;0;0;0;.00nan;0;0
33763;210603;104;60;35;4;31;.886;3577000;0
33763;212368;100;79;26;2;24;.923;3600000;0
33763;208300;104;0;0;0;0;.00nan;0;0
33764;212343;96;75;40;4;36;.900;3600000;0
33764;217437;88;72;21;1;20;.952;3600000;0
33764;-1;88;0;0;0;0;.00nan;0;0
33764;-1;96;0;0;0;0;.00nan;0;0
33765;205119;106;0;0;0;0;.00nan;0;0
33765;210368;106;94;36;2;34;.944;3600000;0
33765;215785;94;72;32;3;29;.906;3600000;0
33765;-1;94;0;0;0;0;.00nan;0;0
33766;215575;100;70;36;4;32;.889;3600000;0
33766;210603;104;49;1;0;1;1.000;261000;0
33766;212368;100;0;0;0;0;.00nan;0;0
33766;208300;104;33;31;6;25;.806;3313000;0
33767;205318;97;0;0;0;0;.00nan;0;0
33767;212354;97;45;34;5;29;.853;3600000;0
33767;212487;95;0;0;0;0;.00nan;0;0
33767;-1;95;64;16;1;15;.938;3600000;0
33768;215735;93;0;0;0;0;.00nan;0;0
33768;217437;88;48;19;3;16;.842;3600000;0
33768;-1;88;0;0;0;0;.00nan;0;0
33768;-1;93;26;33;7;26;.788;3600000;0
33769;205076;87;58;31;4;27;.871;3600000;0
33769;210222;90;95;32;1;31;.969;3600000;0
33769;207239;90;0;0;0;0;.00nan;0;0
33769;-1;87;0;0;0;0;.00nan;0;0
33770;210222;90;0;0;0;0;.00nan;0;0
33770;205121;86;0;0;0;0;.00nan;0;0
33770;205799;86;71;18;1;17;.944;3600000;0
33770;207239;90;68;42;4;38;.905;3600000;0
33771;209784;91;0;0;0;0;.00nan;0;0
33771;205429;91;77;33;2;31;.939;3600000;0
33771;212343;96;0;0;0;0;.00nan;0;0
33771;-1;96;87;38;3;35;.921;3548000;0
33772;205119;106;0;0;0;0;.00nan;0;0
33772;210368;106;91;35;1;34;.971;3600000;0
33772;205318;97;63;31;3;28;.903;3559000;0
33772;212354;97;0;0;0;0;.00nan;0;0
33773;215735;93;0;0;0;0;.00nan;0;0
33773;212487;95;59;43;4;39;.907;3600000;0
33773;-1;93;86;33;1;32;.970;3600000;0
33773;-1;95;0;0;0;0;.00nan;0;0
33774;203179;102;0;0;0;0;.00nan;0;0
33774;215575;100;0;0;0;0;.00nan;0;0
33774;210923;102;48;30;5;25;.833;3862000;0
33774;212368;100;65;37;4;33;.892;3862000;0
33775;208417;101;0;0;0;0;.00nan;0;0
33775;220873;101;50;15;2;13;.867;3600000;0
33775;215733;99;0;0;0;0;.00nan;0;0
33775;-1;99;90;44;3;41;.932;3559000;0
33776;205124;89;0;0;0;0;.00nan;0;0
33776;215785;94;79;36;3;33;.917;3600000;0
33776;-1;89;37;43;7;36;.837;3600000;0
33776;-1;94;0;0;0;0;.00nan;0;0
33777;210428;103;0;0;0;0;.00nan;0;0
33777;217437;88;27;12;4;8;.667;700000;0
33777;222835;103;79;22;1;21;.955;3600000;0
33777;-1;88;77;24;1;23;.958;2900000;0
33778;205015;105;0;0;0;0;.00nan;0;0
33778;205112;105;34;24;5;19;.792;3600000;0
33778;210439;98;0;0;0;0;.00nan;0;0
33778;207118;98;52;49;6;43;.878;3600000;0
33779;205076;87;74;35;3;32;.914;3552000;0
33779;210222;90;74;28;2;26;.929;3600000;0
33779;207239;90;0;0;0;0;.00nan;0;0
33779;-1;87;0;0;0;0;.00nan;0;0
33780;209784;91;72;23;1;22;.957;3600000;0
33780;205429;91;0;0;0;0;.00nan;0;0
33780;212343;96;81;35;2;33;.943;3600000;0
33780;-1;96;0;0;0;0;.00nan;0;0
33781;205119;106;94;35;2;33;.943;3900000;0
33781;210368;106;0;0;0;0;.00nan;0;0
33781;221137;92;78;33;2;31;.939;3900000;0
33781;-1;92;0;0;0;0;.00nan;0;0
33782;209796;107;31;22;5;17;.773;3900000;0
33782;210603;104;77;45;5;40;.889;3900000;0
33782;217421;107;0;0;0;0;.00nan;0;0
33782;208300;104;0;0;0;0;.00nan;0;0
33783;215785;94;50;33;4;29;.879;3600000;0
33783;217437;88;86;31;1;30;.968;3600000;0
33783;-1;88;0;0;0;0;.00nan;0;0
33783;-1;94;0;0;0;0;.00nan;0;0
33784;205124;89;0;0;0;0;.00nan;0;0
33784;210428;103;50;33;5;28;.848;3900000;0
33784;222835;103;0;0;0;0;.00nan;0;0
33784;-1;89;44;29;5;24;.828;3900000;0
33785;205015;105;0;0;0;0;.00nan;0;0
33785;205112;105;40;24;4;20;.833;3900000;0
33785;210439;98;56;34;4;30;.882;3900000;0
33785;207118;98;0;0;0;0;.00nan;0;0
33786;203179;102;71;32;3;29;.906;3550000;0
33786;215733;99;74;27;2;25;.926;3600000;0
33786;210923;102;0;0;0;0;.00nan;0;0
33786;-1;99;0;0;0;0;.00nan;0;0
33787;208417;101;37;19;3;16;.842;3900000;0
33787;220873;101;0;0;0;0;.00nan;0;0
33787;215575;100;72;36;3;33;.917;3900000;0
33787;212368;100;0;0;0;0;.00nan;0;0
33788;205318;97;0;0;0;0;.00nan;0;0
33788;215735;93;18;15;6;9;.600;2683000;0
33788;212354;97;98;41;3;38;.927;3600000;0
33788;-1;93;32;7;3;4;.571;917000;0
33789;205119;106;0;0;0;0;.00nan;0;0
33789;210368;106;77;41;4;37;.902;3802000;0
33789;212487;95;0;0;0;0;.00nan;0;0
33789;-1;95;60;31;3;28;.903;3802000;0
33790;203179;102;0;0;0;0;.00nan;0;0
33790;210603;104;0;0;0;0;.00nan;0;0
33790;210923;102;69;33;3;30;.909;3600000;0
33790;208300;104;42;31;5;26;.839;3513000;0
33791;205121;86;0;0;0;0;.00nan;0;0
33791;221137;92;83;42;4;38;.905;3600000;0
33791;205799;86;81;31;2;29;.935;3600000;0
33791;-1;92;0;0;0;0;.00nan;0;0
33792;205124;89;0;0;0;0;.00nan;0;0
33792;210603;104;51;46;7;39;.848;3600000;0
33792;-1;89;78;36;3;33;.917;3600000;0
33792;208300;104;0;0;0;0;.00nan;0;0
33793;205318;97;100;29;0;29;1.000;3600000;0
33793;212354;97;0;0;0;0;.00nan;0;0
33793;212487;95;76;31;2;29;.935;3581000;0
33793;-1;95;0;0;0;0;.00nan;0;0
33794;205076;87;70;35;3;32;.914;3623000;0
33794;221137;92;77;26;2;24;.923;3623000;0
33794;-1;92;0;0;0;0;.00nan;0;0
33794;-1;87;0;0;0;0;.00nan;0;0
33795;205119;106;54;31;4;27;.871;3547000;0
33795;205124;89;0;0;0;0;.00nan;0;0
33795;210368;106;0;0;0;0;.00nan;0;0
33795;-1;89;72;31;2;29;.935;3600000;0
33796;203179;102;59;10;1;9;.900;1370000;0
33796;215785;94;83;31;2;29;.935;3600000;0
33796;210923;102;15;22;6;16;.727;2230000;0
33796;-1;94;0;0;0;0;.00nan;0;0
33797;205015;105;0;0;0;0;.00nan;0;0
33797;205112;105;76;31;2;29;.935;3600000;0
33797;217437;88;61;37;4;33;.892;3556000;0
33797;-1;88;0;0;0;0;.00nan;0;0
33798;205076;87;30;44;7;37;.841;3600000;0
33798;210222;90;60;17;2;15;.882;3600000;0
33798;207239;90;0;0;0;0;.00nan;0;0
33798;-1;87;0;0;0;0;.00nan;0;0
33799;205121;86;0;0;0;0;.00nan;0;0
33799;215735;93;0;0;0;0;.00nan;0;0
33799;205799;86;59;32;4;28;.875;3696000;0
33799;-1;93;52;35;5;30;.857;3696000;0
33800;209784;91;0;0;0;0;.00nan;0;0
33800;205429;91;58;22;3;19;.864;3543000;0
33800;212487;95;0;0;0;0;.00nan;0;0
33800;-1;95;99;37;2;35;.946;3600000;0
33801;221137;92;40;25;4;21;.840;3561000;0
33801;212343;96;0;0;0;0;.00nan;0;0
33801;-1;96;67;26;2;24;.923;3600000;0
33801;-1;92;0;0;0;0;.00nan;0;0
33802;203179;102;0;0;0;0;.00nan;0;0
33802;210603;104;0;0;0;0;.00nan;0;0
33802;210923;102;90;15;0;15;1.000;3600000;0
33802;208300;104;94;31;1;30;.968;3590000;0
33803;205015;105;0;0;0;0;.00nan;0;0
33803;205112;105;73;23;1;22;.957;3600000;0
33803;205124;89;63;8;0;8;1.000;839000;0
33803;-1;89;26;28;6;22;.786;2761000;0
33804;215575;100;0;0;0;0;.00nan;0;0
33804;215785;94;99;36;1;35;.972;3611000;0
33804;212368;100;54;16;2;14;.875;3611000;0
33804;-1;94;0;0;0;0;.00nan;0;0
33805;208417;101;0;0;0;0;.00nan;0;0
33805;220873;101;65;33;3;30;.909;3590000;0
33805;218786;99;0;0;0;0;.00nan;0;0
33805;-1;99;52;14;2;12;.857;3600000;0
33806;210428;103;0;0;0;0;.00nan;0;0
33806;210439;98;0;0;0;0;.00nan;0;0
33806;207118;98;40;41;7;34;.829;3600000;0
33806;222835;103;57;24;3;21;.875;3600000;0
33807;209796;107;92;26;0;26;1.000;3600000;0
33807;217421;107;0;0;0;0;.00nan;0;0
33807;217437;88;63;32;5;27;.844;3600000;0
33807;-1;88;0;0;0;0;.00nan;0;0
33808;210222;90;56;12;1;11;.917;1220000;0
33808;205121;86;70;27;2;25;.926;3600000;0
33808;205799;86;0;0;0;0;.00nan;0;0
33808;207239;90;50;30;5;25;.833;2380000;0
33809;205076;87;0;0;0;0;.00nan;0;0
33809;215735;93;49;22;3;19;.864;3600000;0
33809;-1;93;0;0;0;0;.00nan;0;0
33809;-1;87;14;40;9;31;.775;3600000;0
33810;203179;102;0;0;0;0;.00nan;0;0
33810;210923;102;61;25;3;22;.880;3600000;0
33810;218786;99;53;28;4;24;.857;3591000;0
33810;-1;99;0;0;0;0;.00nan;0;0
33811;205015;105;0;0;0;0;.00nan;0;0
33811;205112;105;96;31;2;29;.935;3600000;0
33811;210439;98;63;50;6;44;.880;3600000;0
33811;207118;98;0;0;0;0;.00nan;0;0
33812;215575;100;25;22;5;17;.773;2327000;0
33812;215785;94;75;26;2;24;.923;3600000;0
33812;212368;100;64;16;1;15;.938;1273000;0
33812;-1;94;0;0;0;0;.00nan;0;0
33813;205318;97;69;30;3;27;.900;3600000;0
33813;221137;92;44;35;5;30;.857;3555000;0
33813;212354;97;0;0;0;0;.00nan;0;0
33813;-1;92;0;0;0;0;.00nan;0;0
33814;212343;96;0;0;0;0;.00nan;0;0
33814;212487;95;89;44;2;42;.955;3600000;0
33814;-1;96;39;31;5;26;.839;3600000;0
33814;-1;95;0;0;0;0;.00nan;0;0
33815;210603;104;96;38;1;37;.974;3600000;0
33815;217437;88;0;0;0;0;.00nan;0;0
33815;-1;88;65;28;3;25;.893;3592000;0
33815;208300;104;0;0;0;0;.00nan;0;0
33816;208417;101;42;24;4;20;.833;3600000;0
33816;220873;101;0;0;0;0;.00nan;0;0
33816;210428;103;97;37;1;36;.973;3600000;0
33816;222835;103;0;0;0;0;.00nan;0;0
33817;209796;107;52;24;3;21;.875;3548000;0
33817;205124;89;71;30;2;28;.933;3600000;0
33817;217421;107;0;0;0;0;.00nan;0;0
33817;-1;89;0;0;0;0;.00nan;0;0
33818;209784;91;51;15;2;13;.867;3789000;0
33818;205318;97;0;0;0;0;.00nan;0;0
33818;205429;91;0;0;0;0;.00nan;0;0
33818;212354;97;86;32;1;31;.969;3789000;0
33819;205119;106;0;0;0;0;.00nan;0;0
33819;210368;106;96;25;0;25;1.000;3600000;0
33819;217437;88;69;38;3;35;.921;3600000;0
33819;-1;88;0;0;0;0;.00nan;0;0
33820;210603;104;0;0;0;0;.00nan;0;0
33820;218786;99;0;0;0;0;.00nan;0;0
33820;208300;104;62;46;5;41;.891;3600000;0
33820;-1;99;67;20;2;18;.900;3600000;0
33821;209784;91;0;0;0;0;.00nan;0;0
33821;210222;90;71;33;3;30;.909;3588000;0
33821;205429;91;46;13;2;11;.846;3600000;0
33821;207239;90;0;0;0;0;.00nan;0;0
33822;210439;98;66;33;3;30;.909;3600000;0
33822;215785;94;43;22;4;18;.818;3524000;0
33822;207118;98;0;0;0;0;.00nan;0;0
33822;-1;94;0;0;0;0;.00nan;0;0
33823;212343;96;81;34;2;32;.941;3600000;0
33823;212487;95;75;41;4;37;.902;3540000;0
33823;-1;96;0;0;0;0;.00nan;0;0
33823;-1;95;0;0;0;0;.00nan;0;0
33824;210222;90;0;0;0;0;.00nan;0;0
33824;205318;97;46;26;4;22;.846;3598000;0
33824;212354;97;0;0;0;0;.00nan;0;0
33824;207239;90;80;29;2;27;.931;3600000;0
33825;209784;91;84;45;3;42;.933;3900000;0
33825;205429;91;0;0;0;0;.00nan;0;0
33825;215735;93;0;0;0;0;.00nan;0;0
33825;-1;93;59;26;3;23;.885;3900000;0
33826;203179;102;0;0;0;0;.00nan;0;0
33826;205015;105;0;0;0;0;.00nan;0;0
33826;205112;105;67;32;3;29;.906;3552000;0
33826;210923;102;63;22;2;20;.909;3600000;0
33827;208417;101;0;0;0;0;.00nan;0;0
33827;220873;101;94;29;0;29;1.000;3600000;0
33827;210428;103;0;0;0;0;.00nan;0;0
33827;222835;103;75;45;5;40;.889;3600000;0
33828;205124;89;0;0;0;0;.00nan;0;0
33828;217437;88;79;35;3;32;.914;3600000;0
33828;-1;88;0;0;0;0;.00nan;0;0
33828;-1;89;72;27;2;25;.926;3600000;0
33829;205076;87;64;43;4;39;.907;3600000;0
33829;212487;95;0;0;0;0;.00nan;0;0
33829;-1;95;100;25;0;25;1.000;3600000;0
33829;-1;87;0;0;0;0;.00nan;0;0
33830;209784;91;0;0;0;0;.00nan;0;0
33830;205121;86;0;0;0;0;.00nan;0;0
33830;205429;91;75;38;4;34;.895;3577000;0
33830;205799;86;69;23;2;21;.913;3600000;0
33831;205318;97;98;45;2;43;.956;3900000;0
33831;221137;92;72;30;2;28;.933;3900000;0
33831;212354;97;0;0;0;0;.00nan;0;0
33831;-1;92;0;0;0;0;.00nan;0;0
33832;210222;90;46;41;6;35;.854;3600000;0
33832;215735;93;0;0;0;0;.00nan;0;0
33832;207239;90;0;0;0;0;.00nan;0;0
33832;-1;93;60;17;2;15;.882;3600000;0
33833;215575;100;55;24;4;20;.833;3600000;0
33833;212368;100;0;0;0;0;.00nan;0;0
33833;218786;99;83;23;1;22;.957;3600000;0
33833;-1;99;0;0;0;0;.00nan;0;0
33834;208417;101;0;0;0;0;.00nan;0;0
33834;203179;102;0;0;0;0;.00nan;0;0
33834;220873;101;55;26;3;23;.885;3548000;0
33834;210923;102;75;32;2;30;.938;3600000;0
33835;210603;104;68;34;2;32;.941;3571000;0
33835;215785;94;75;22;1;21;.955;3600000;0
33835;208300;104;0;0;0;0;.00nan;0;0
33835;-1;94;0;0;0;0;.00nan;0;0
33836;205119;106;0;0;0;0;.00nan;0;0
33836;210368;106;49;22;4;18;.818;3516000;0
33836;210428;103;0;0;0;0;.00nan;0;0
33836;222835;103;89;42;2;40;.952;3600000;0
33837;209796;107;64;27;3;24;.889;3600000;0
33837;210439;98;75;55;5;50;.909;3600000;0
33837;207118;98;0;0;0;0;.00nan;0;0
33837;217421;107;0;0;0;0;.00nan;0;0
33838;215735;93;98;41;1;40;.976;3600000;0
33838;217437;88;11;24;7;17;.708;3096000;0
33838;-1;88;57;5;0;5;1.000;504000;0
33838;-1;93;0;0;0;0;.00nan;0;0
33839;209784;91;87;29;1;28;.966;3600000;0
33839;205076;87;69;39;4;35;.897;3600000;0
33839;205429;91;0;0;0;0;.00nan;0;0
33839;-1;87;0;0;0;0;.00nan;0;0
33840;205121;86;50;25;3;22;.880;3600000;0
33840;205799;86;0;0;0;0;.00nan;0;0
33840;212487;95;0;0;0;0;.00nan;0;0
33840;-1;95;78;28;2;26;.929;3600000;0
33841;210222;90;34;33;6;27;.818;3028000;0
33841;212343;96;47;10;2;8;.800;2700000;0
33841;207239;90;60;8;0;8;1.000;872000;0
33841;-1;96;20;10;4;6;.600;1200000;0
33842;208417;101;69;29;2;27;.931;3900000;0
33842;203179;102;0;0;0;0;.00nan;0;0
33842;220873;101;0;0;0;0;.00nan;0;0
33842;210923;102;91;36;2;34;.944;3900000;0
33843;205015;105;0;0;0;0;.00nan;0;0
33843;205112;105;34;32;6;26;.813;3579000;0
33843;205119;106;79;40;4;36;.900;3600000;0
33843;210368;106;0;0;0;0;.00nan;0;0
33844;215575;100;0;0;0;0;.00nan;0;0
33844;212368;100;56;36;4;32;.889;3540000;0
33844;218786;99;0;0;0;0;.00nan;0;0
33844;-1;99;78;33;2;31;.939;3600000;0
33845;205318;97;0;0;0;0;.00nan;0;0
33845;221137;92;90;20;0;20;1.000;3600000;0
33845;212354;97;58;32;3;29;.906;3600000;0
33845;-1;92;0;0;0;0;.00nan;0;0
33846;210603;104;0;0;0;0;.00nan;0;0
33846;215785;94;0;0;0;0;.00nan;0;0
33846;208300;104;59;48;5;43;.896;3600000;0
33846;-1;94;80;27;1;26;.963;3600000;0
33847;209796;107;0;0;0;0;.00nan;0;0
33847;210439;98;0;0;0;0;.00nan;0;0
33847;207118;98;66;35;4;31;.886;3562000;0
33847;217421;107;53;24;3;21;.875;3600000;0
33848;210428;103;0;0;0;0;.00nan;0;0
33848;210603;104;55;42;6;36;.857;3600000;0
33848;222835;103;60;20;2;18;.900;3600000;0
33848;208300;104;0;0;0;0;.00nan;0;0
33849;205076;87;78;26;1;25;.962;3600000;0
33849;212343;96;0;0;0;0;.00nan;0;0
33849;-1;96;47;31;5;26;.839;3600000;0
33849;-1;87;0;0;0;0;.00nan;0;0
33850;210222;90;45;35;5;30;.857;3600000;0
33850;205121;86;0;0;0;0;.00nan;0;0
33850;205799;86;66;19;2;17;.895;3600000;0
33850;207239;90;0;0;0;0;.00nan;0;0
33851;210428;103;0;0;0;0;.00nan;0;0
33851;222835;103;61;38;4;34;.895;3644000;0
33851;218786;99;0;0;0;0;.00nan;0;0
33851;-1;99;43;12;3;9;.750;3644000;0
33852;205015;105;60;7;0;7;1.000;1268000;0
33852;205112;105;33;30;6;24;.800;2332000;0
33852;215785;94;80;21;1;20;.952;3600000;0
33852;-1;94;0;0;0;0;.00nan;0;0
33853;215735;93;0;0;0;0;.00nan;0;0
33853;212487;95;0;0;0;0;.00nan;0;0
33853;-1;93;71;31;3;28;.903;3547000;0
33853;-1;95;75;24;1;23;.958;3600000;0
33854;208417;101;0;0;0;0;.00nan;0;0
33854;220873;101;36;13;3;10;.769;3600000;0
33854;215575;100;22;27;6;21;.778;3600000;0
33854;212368;100;0;0;0;0;.00nan;0;0
33855;215735;93;53;32;4;28;.875;3600000;0
33855;221137;92;80;28;1;27;.964;3600000;0
33855;-1;93;0;0;0;0;.00nan;0;0
33855;-1;92;0;0;0;0;.00nan;0;0
33856;205076;87;26;35;7;28;.800;3355000;0
33856;205124;89;0;0;0;0;.00nan;0;0
33856;-1;89;54;31;4;27;.871;3600000;0
33856;-1;87;51;2;0;2;1.000;245000;0
33857;205121;86;0;0;0;0;.00nan;0;0
33857;205799;86;73;24;1;23;.958;3600000;0
33857;217437;88;42;29;5;24;.828;2337000;0
33857;-1;88;49;14;2;12;.857;1263000;0
33858;209784;91;0;0;0;0;.00nan;0;0
33858;205429;91;59;29;3;26;.897;3575000;0
33858;212343;96;88;39;2;37;.949;3600000;0
33858;-1;96;0;0;0;0;.00nan;0;0
33859;205318;97;71;32;3;29;.906;3532000;0
33859;212354;97;0;0;0;0;.00nan;0;0
33859;212487;95;75;28;1;27;.964;3600000;0
33859;-1;95;0;0;0;0;.00nan;0;0
33860;205015;105;0;0;0;0;.00nan;0;0
33860;205112;105;93;31;1;30;.968;3600000;0
33860;210428;103;61;17;1;16;.941;1347000;0
33860;222835;103;41;27;4;23;.852;2253000;0
33861;205119;106;0;0;0;0;.00nan;0;0
33861;210368;106;86;32;1;31;.969;3544000;0
33861;215785;94;88;16;0;16;1.000;3600000;0
33861;-1;94;0;0;0;0;.00nan;0;0
33862;203179;102;0;0;0;0;.00nan;0;0
33862;210923;102;93;38;2;36;.947;3900000;0
33862;218786;99;73;26;2;24;.923;3900000;0
33862;-1;99;0;0;0;0;.00nan;0;0
33863;208417;101;0;0;0;0;.00nan;0;0
33863;209796;107;48;40;5;35;.875;3587000;0
33863;220873;101;41;23;4;19;.826;3600000;0
33863;217421;107;0;0;0;0;.00nan;0;0
33864;210439;98;96;51;3;48;.941;3600000;0
33864;215575;100;50;15;2;13;.867;944000;0
33864;212368;100;24;26;6;20;.769;2656000;0
33864;207118;98;0;0;0;0;.00nan;0;0
33865;205076;87;0;0;0;0;.00nan;0;0
33865;210222;90;60;29;4;25;.862;3574000;0
33865;207239;90;0;0;0;0;.00nan;0;0
33865;-1;87;63;31;3;28;.903;3600000;0
33866;203179;102;0;0;0;0;.00nan;0;0
33866;210923;102;87;37;2;35;.946;3600000;0
33866;218786;99;0;0;0;0;.00nan;0;0
33866;-1;99;53;23;3;20;.870;3572000;0
33867;209784;91;74;27;2;25;.926;3600000;0
33867;205429;91;0;0;0;0;.00nan;0;0
33867;212343;96;0;0;0;0;.00nan;0;0
33867;-1;96;34;35;5;30;.857;3600000;0
33868;205121;86;74;30;2;28;.933;3600000;0
33868;205799;86;0;0;0;0;.00nan;0;0
33868;217437;88;77;39;4;35;.897;3577000;0
33868;-1;88;0;0;0;0;.00nan;0;0
33869;215735;93;0;0;0;0;.00nan;0;0
33869;221137;92;76;24;1;23;.958;3600000;0
33869;-1;93;47;32;5;27;.844;3600000;0
33869;-1;92;0;0;0;0;.00nan;0;0
33870;205015;105;0;0;0;0;.00nan;0;0
33870;205112;105;62;20;2;18;.900;3600000;0
33870;205119;106;42;36;6;30;.833;3600000;0
33870;210368;106;0;0;0;0;.00nan;0;0
33871;210428;103;0;0;0;0;.00nan;0;0
33871;215785;94;12;25;7;18;.720;3600000;0
33871;222835;103;76;36;4;32;.889;3600000;0
33871;-1;94;0;0;0;0;.00nan;0;0
33872;210439;98;0;0;0;0;.00nan;0;0
33872;215575;100;80;24;1;23;.958;3600000;0
33872;212368;100;0;0;0;0;.00nan;0;0
33872;207118;98;84;46;4;42;.913;3600000;0
33873;208417;101;69;41;5;36;.878;3106000;0
33873;209796;107;0;0;0;0;.00nan;0;0
33873;220873;101;51;2;0;2;1.000;494000;0
33873;217421;107;67;19;2;17;.895;3600000;0
33874;205318;97;68;19;1;18;.947;3600000;0
33874;215735;93;30;31;6;25;.806;2422000;0
33874;212354;97;0;0;0;0;.00nan;0;0
33874;-1;93;48;9;2;7;.778;1178000;0
33875;205124;89;0;0;0;0;.00nan;0;0
33875;217437;88;0;0;0;0;.00nan;0;0
33875;-1;88;60;42;5;37;.881;3600000;0
33875;-1;89;66;15;1;14;.933;3600000;0
33876;215575;100;0;0;0;0;.00nan;0;0
33876;212368;100;81;26;1;25;.962;3600000;0
33876;218786;99;51;37;5;32;.865;3600000;0
33876;-1;99;0;0;0;0;.00nan;0;0
33877;212343;96;52;35;5;30;.857;3600000;0
33877;212487;95;0;0;0;0;.00nan;0;0
33877;-1;96;0;0;0;0;.00nan;0;0
33877;-1;95;100;20;0;20;1.000;3600000;0
33878;205015;105;38;35;6;29;.829;3356000;0
33878;205112;105;53;2;0;2;1.000;244000;0
33878;210603;104;100;27;0;27;1.000;3600000;0
33878;208300;104;0;0;0;0;.00nan;0;0
33879;205119;106;0;0;0;0;.00nan;0;0
33879;210368;106;65;31;4;27;.871;3600000;0
33879;215785;94;0;0;0;0;.00nan;0;0
33879;-1;94;62;47;6;41;.872;3561000;0
33880;203179;102;0;0;0;0;.00nan;0;0
33880;210603;104;100;47;1;46;.979;3600000;0
33880;210923;102;79;30;2;28;.933;3565000;0
33880;208300;104;0;0;0;0;.00nan;0;0
33881;205076;87;47;45;6;39;.867;3600000;0
33881;205124;89;0;0;0;0;.00nan;0;0
33881;-1;89;60;26;3;23;.885;3600000;0
33881;-1;87;0;0;0;0;.00nan;0;0
33882;205121;86;0;0;0;0;.00nan;0;0
33882;205318;97;34;17;4;13;.765;997000;0
33882;205799;86;59;29;4;25;.862;3600000;0
33882;212354;97;75;21;1;20;.952;2586000;0
33883;221137;92;81;17;1;16;.941;3600000;0
33883;212343;96;0;0;0;0;.00nan;0;0
33883;-1;96;73;32;3;29;.906;3524000;0
33883;-1;92;0;0;0;0;.00nan;0;0
33884;205119;106;0;0;0;0;.00nan;0;0
33884;210368;106;100;26;0;26;1.000;3600000;0
33884;210439;98;0;0;0;0;.00nan;0;0
33884;207118;98;84;52;4;48;.923;3600000;0
33885;210222;90;89;33;2;31;.939;3600000;0
33885;217437;88;49;22;3;19;.864;3600000;0
33885;207239;90;0;0;0;0;.00nan;0;0
33885;-1;88;0;0;0;0;.00nan;0;0
33886;209784;91;0;0;0;0;.00nan;0;0
33886;205429;91;80;45;4;41;.911;3600000;0
33886;215735;93;30;27;6;21;.778;2935000;0
33886;-1;93;32;3;2;1;.333;665000;0
33887;205076;87;80;39;3;36;.923;3600000;0
33887;205121;86;0;0;0;0;.00nan;0;0
33887;205799;86;86;19;0;19;1.000;3600000;0
33887;-1;87;0;0;0;0;.00nan;0;0
33888;210222;90;0;0;0;0;.00nan;0;0
33888;205124;89;0;0;0;0;.00nan;0;0
33888;207239;90;45;36;6;30;.833;3600000;0
33888;-1;89;80;34;2;32;.941;3600000;0
33889;205318;97;66;36;4;32;.889;3531000;0
33889;212343;96;82;30;2;28;.933;3600000;0
33889;212354;97;0;0;0;0;.00nan;0;0
33889;-1;96;0;0;0;0;.00nan;0;0
33890;203179;102;0;0;0;0;.00nan;0;0
33890;215575;100;60;30;4;26;.867;3900000;0
33890;210923;102;65;28;4;24;.857;3900000;0
33890;212368;100;0;0;0;0;.00nan;0;0
33891;208417;101;44;4;1;3;.750;385000;0
33891;220873;101;36;27;6;21;.778;3215000;0
33891;218786;99;0;0;0;0;.00nan;0;0
33891;-1;99;47;30;4;26;.867;3600000;0
33892;210603;104;32;16;4;12;.750;959000;0
33892;215785;94;58;33;4;29;.879;3600000;0
33892;208300;104;81;28;1;27;.964;2601000;0
33892;-1;94;0;0;0;0;.00nan;0;0
33893;205015;105;0;0;0;0;.00nan;0;0
33893;205112;105;62;38;4;34;.895;3600000;0
33893;210428;103;0;0;0;0;.00nan;0;0
33893;222835;103;71;25;1;24;.960;3600000;0
33894;205119;106;0;0;0;0;.00nan;0;0
33894;210368;106;57;23;3;20;.870;3543000;0
33894;210439;98;86;36;2;34;.944;3600000;0
33894;207118;98;0;0;0;0;.00nan;0;0
33895;209784;91;71;34;3;31;.912;3600000;0
33895;205429;91;0;0;0;0;.00nan;0;0
33895;215735;93;0;0;0;0;.00nan;0;0
33895;-1;93;40;29;5;24;.828;3535000;0
33896;205124;89;59;40;5;35;.875;3574000;0
33896;217437;88;52;19;3;16;.842;3600000;0
33896;-1;88;0;0;0;0;.00nan;0;0
33896;-1;89;0;0;0;0;.00nan;0;0
33897;205015;105;0;0;0;0;.00nan;0;0
33897;205112;105;28;21;5;16;.762;3588000;0
33897;210603;104;87;30;3;27;.900;3600000;0
33897;208300;104;0;0;0;0;.00nan;0;0
33898;203179;102;0;0;0;0;.00nan;0;0
33898;215575;100;0;0;0;0;.00nan;0;0
33898;210923;102;83;35;2;33;.943;3537000;0
33898;212368;100;100;26;0;26;1.000;3600000;0
33899;221137;92;83;35;2;33;.943;3600000;0
33899;212487;95;0;0;0;0;.00nan;0;0
33899;-1;95;51;29;4;25;.862;3544000;0
33899;-1;92;0;0;0;0;.00nan;0;0
33900;205076;87;70;39;3;36;.923;3584000;0
33900;205121;86;0;0;0;0;.00nan;0;0
33900;205799;86;78;25;1;24;.960;3600000;0
33900;-1;87;0;0;0;0;.00nan;0;0
33901;210428;103;87;55;5;50;.909;3600000;0
33901;215785;94;80;28;2;26;.929;3600000;0
33901;222835;103;0;0;0;0;.00nan;0;0
33901;-1;94;0;0;0;0;.00nan;0;0
33902;209796;107;38;28;5;23;.821;3600000;0
33902;205119;106;82;30;2;28;.933;3600000;0
33902;210368;106;0;0;0;0;.00nan;0;0
33902;217421;107;0;0;0;0;.00nan;0;0
33903;208417;101;36;16;4;12;.750;2329000;0
33903;220873;101;65;8;0;8;1.000;1271000;0
33903;218786;99;29;24;5;19;.792;3571000;0
33903;-1;99;0;0;0;0;.00nan;0;0
33904;205318;97;75;29;3;26;.897;3555000;0
33904;212343;96;0;0;0;0;.00nan;0;0
33904;212354;97;0;0;0;0;.00nan;0;0
33904;-1;96;85;36;2;34;.944;3600000;0
33905;221137;92;90;30;1;29;.967;3600000;0
33905;212487;95;63;22;2;20;.909;3583000;0
33905;-1;95;0;0;0;0;.00nan;0;0
33905;-1;92;0;0;0;0;.00nan;0;0
33906;209796;107;0;0;0;0;.00nan;0;0
33906;210428;103;0;0;0;0;.00nan;0;0
33906;217421;107;98;28;0;28;1.000;3600000;0
33906;222835;103;29;39;7;32;.821;3600000;0
33907;205015;105;33;17;3;14;.824;3900000;0
33907;205112;105;0;0;0;0;.00nan;0;0
33907;210603;104;0;0;0;0;.00nan;0;0
33907;208300;104;86;38;3;35;.921;3899000;0
33909;208417;101;0;0;0;0;.00nan;0;0
33909;220873;101;92;21;0;21;1.000;3600000;0
33909;215575;100;0;0;0;0;.00nan;0;0
33909;212368;100;34;17;4;13;.765;3600000;0
33911;209784;91;71;43;4;39;.907;3600000;0
33911;205076;87;64;25;2;23;.920;3600000;0
33911;205429;91;0;0;0;0;.00nan;0;0
33911;-1;87;0;0;0;0;.00nan;0;0
33913;210439;98;0;0;0;0;.00nan;0;0
33913;207118;98;93;40;1;39;.975;3600000;0
33913;217437;88;24;5;3;2;.400;220000;0
33913;-1;88;50;13;2;11;.846;3380000;0
33915;215735;93;68;36;3;33;.917;3600000;0
33915;212343;96;0;0;0;0;.00nan;0;0
33915;-1;96;44;26;4;22;.846;3547000;0
33915;-1;93;0;0;0;0;.00nan;0;0
33917;205015;105;74;42;3;39;.929;3529000;0
33917;205112;105;0;0;0;0;.00nan;0;0
33917;205318;97;78;25;1;24;.960;3600000;0
33917;212354;97;0;0;0;0;.00nan;0;0
33919;205124;89;0;0;0;0;.00nan;0;0
33919;215733;99;0;0;0;0;.00nan;0;0
33919;-1;89;64;46;5;41;.891;3900000;0
33919;-1;99;35;30;5;25;.833;3900000;0
33921;215785;94;44;24;3;21;.875;3570000;0
33921;212487;95;78;31;2;29;.935;3600000;0
33921;-1;95;0;0;0;0;.00nan;0;0
33921;-1;94;0;0;0;0;.00nan;0;0
33923;210428;103;45;21;4;17;.810;3600000;0
33923;210603;104;99;26;0;26;1.000;3600000;0
33923;208300;104;0;0;0;0;.00nan;0;0
33923;-1;103;0;0;0;0;.00nan;0;0
33925;209796;107;50;35;5;30;.857;3600000;0
33925;220816;107;0;0;0;0;.00nan;0;0
33925;210923;102;100;44;2;42;.955;3600000;0
33925;-1;102;0;0;0;0;.00nan;0;0
33927;210222;90;84;26;1;25;.962;3600000;0
33927;205119;106;0;0;0;0;.00nan;0;0
33927;210368;106;59;24;3;21;.875;3560000;0
33927;207239;90;0;0;0;0;.00nan;0;0
33929;205799;86;71;30;2;28;.933;3600000;0
33929;-1;86;0;0;0;0;.00nan;0;0
33929;-1;92;46;25;4;21;.840;3513000;0
33929;-1;92;0;0;0;0;.00nan;0;0
33931;205015;105;0;0;0;0;.00nan;0;0
33931;205112;105;42;25;5;20;.800;3573000;0
33931;-1;92;75;39;3;36;.923;3600000;0
33931;-1;92;0;0;0;0;.00nan;0;0
33933;209784;91;44;42;6;36;.857;3600000;0
33933;205429;91;0;0;0;0;.00nan;0;0
33933;212487;95;0;0;0;0;.00nan;0;0
33933;-1;95;77;31;2;29;.935;3600000;0
33935;205124;89;84;46;3;43;.935;3900000;0
33935;205318;97;0;0;0;0;.00nan;0;0
33935;212354;97;60;22;3;19;.864;3900000;0
33935;-1;89;0;0;0;0;.00nan;0;0
33937;210923;102;39;21;4;17;.810;3600000;0
33937;217437;88;30;22;5;17;.773;3594000;0
33937;-1;88;0;0;0;0;.00nan;0;0
33937;-1;102;0;0;0;0;.00nan;0;0
33939;205119;106;32;14;3;11;.786;3600000;0
33939;210368;106;0;0;0;0;.00nan;0;0
33939;210603;104;55;43;5;38;.884;3568000;0
33939;208300;104;0;0;0;0;.00nan;0;0
33941;215735;93;0;0;0;0;.00nan;0;0
33941;205799;86;78;30;2;28;.933;3600000;0
33941;-1;86;0;0;0;0;.00nan;0;0
33941;-1;93;57;40;5;35;.875;3600000;0
33943;215785;94;0;0;0;0;.00nan;0;0
33943;212343;96;44;33;5;28;.848;3600000;0
33943;-1;96;0;0;0;0;.00nan;0;0
33943;-1;94;75;33;2;31;.939;3600000;0
33945;208417;101;0;0;0;0;.00nan;0;0
33945;205076;87;40;2;1;1;.500;367000;0
33945;220873;101;70;28;2;26;.929;3600000;0
33945;-1;87;55;35;5;30;.857;3233000;0
33947;210439;98;53;45;6;39;.867;2515000;0
33947;215733;99;53;20;3;17;.850;3600000;0
33947;207118;98;40;17;3;14;.824;1085000;0
33947;-1;99;0;0;0;0;.00nan;0;0
33949;209796;107;63;29;4;25;.862;3544000;0
33949;220816;107;0;0;0;0;.00nan;0;0
33949;215575;100;0;0;0;0;.00nan;0;0
33949;212368;100;87;41;3;38;.927;3600000;0
33951;210222;90;16;26;7;19;.731;3600000;0
33951;210428;103;55;32;4;28;.875;3600000;0
33951;207239;90;0;0;0;0;.00nan;0;0
33951;-1;103;0;0;0;0;.00nan;0;0
33953;205076;87;61;32;2;30;.938;3900000;0
33953;212343;96;0;0;0;0;.00nan;0;0
33953;-1;96;70;27;2;25;.926;3900000;0
33953;-1;87;0;0;0;0;.00nan;0;0
33955;210439;98;0;0;0;0;.00nan;0;0
33955;207118;98;44;48;6;42;.875;3600000;0
33955;-1;92;0;0;0;0;.00nan;0;0
33955;-1;92;74;23;1;22;.957;3600000;0
33957;215575;100;65;28;3;25;.893;3600000;0
33957;205799;86;0;0;0;0;.00nan;0;0
33957;212368;100;0;0;0;0;.00nan;0;0
33957;-1;86;54;34;4;30;.882;3551000;0
33959;205124;89;0;0;0;0;.00nan;0;0
33959;205318;97;79;23;1;22;.957;3600000;0
33959;212354;97;0;0;0;0;.00nan;0;0
33959;-1;89;83;32;2;30;.938;3600000;0
33961;205119;106;0;0;0;0;.00nan;0;0
33961;210368;106;64;24;2;22;.917;3600000;0
33961;217437;88;0;0;0;0;.00nan;0;0
33961;-1;88;49;27;4;23;.852;3546000;0
33963;210222;90;0;0;0;0;.00nan;0;0
33963;215785;94;76;22;1;21;.955;3600000;0
33963;207239;90;62;28;3;25;.893;3562000;0
33963;-1;94;0;0;0;0;.00nan;0;0
33965;209796;107;0;0;0;0;.00nan;0;0
33965;220816;107;44;28;4;24;.857;3537000;0
33965;210428;103;0;0;0;0;.00nan;0;0
33965;-1;103;78;38;2;36;.947;3600000;0
33967;209784;91;0;0;0;0;.00nan;0;0
33967;205429;91;69;27;2;25;.926;3900000;0
33967;210603;104;0;0;0;0;.00nan;0;0
33967;208300;104;71;28;2;26;.929;3900000;0
33969;205015;105;71;19;1;18;.947;3600000;0
33969;205112;105;0;0;0;0;.00nan;0;0
33969;210923;102;0;0;0;0;.00nan;0;0
33969;-1;102;60;27;3;24;.889;3527000;0
33971;215733;99;0;0;0;0;.00nan;0;0
33971;215735;93;67;31;3;28;.903;3600000;0
33971;-1;93;0;0;0;0;.00nan;0;0
33971;-1;99;21;19;5;14;.737;3552000;0
33973;208417;101;43;21;4;17;.810;2053000;0
33973;220873;101;59;4;0;4;1.000;1527000;0
33973;212487;95;66;30;3;27;.900;3600000;0
33973;-1;95;0;0;0;0;.00nan;0;0
33975;205015;105;0;0;0;0;.00nan;0;0
33975;205076;87;0;0;0;0;.00nan;0;0
33975;205112;105;21;29;6;23;.793;3600000;0
33975;-1;87;57;31;3;28;.903;3600000;0
33977;208417;101;38;25;5;20;.800;3600000;0
33977;220873;101;0;0;0;0;.00nan;0;0
33977;215735;93;0;0;0;0;.00nan;0;0
33977;-1;93;81;30;2;28;.933;3600000;0
33979;205799;86;100;45;3;42;.933;3600000;0
33979;212487;95;0;0;0;0;.00nan;0;0
33979;-1;86;0;0;0;0;.00nan;0;0
33979;-1;95;44;23;4;19;.826;3600000;0
33981;210428;103;73;33;3;30;.909;3900000;0
33981;-1;92;64;26;3;23;.885;3900000;0
33981;-1;92;0;0;0;0;.00nan;0;0
33981;-1;103;0;0;0;0;.00nan;0;0
33983;209796;107;59;27;3;24;.889;3548000;0
33983;210222;90;61;25;2;23;.920;3600000;0
33983;220816;107;0;0;0;0;.00nan;0;0
33983;207239;90;0;0;0;0;.00nan;0;0
33985;215575;100;70;23;1;22;.957;3600000;0
33985;215785;94;41;43;7;36;.837;3600000;0
33985;212368;100;0;0;0;0;.00nan;0;0
33985;-1;94;0;0;0;0;.00nan;0;0
33987;205124;89;0;0;0;0;.00nan;0;0
33987;215733;99;0;0;0;0;.00nan;0;0
33987;-1;89;79;48;4;44;.917;3600000;0
33987;-1;99;65;20;1;19;.950;3600000;0
33989;210439;98;88;38;2;36;.947;3900000;0
33989;212343;96;69;22;2;20;.909;3900000;0
33989;207118;98;0;0;0;0;.00nan;0;0
33989;-1;96;0;0;0;0;.00nan;0;0
33991;210603;104;35;26;5;21;.808;3569000;0
33991;217437;88;57;30;4;26;.867;3600000;0
33991;-1;88;0;0;0;0;.00nan;0;0
33991;208300;104;0;0;0;0;.00nan;0;0
33993;209784;91;19;20;6;14;.700;3598000;0
33993;205318;97;0;0;0;0;.00nan;0;0
33993;205429;91;0;0;0;0;.00nan;0;0
33993;212354;97;56;38;4;34;.895;3600000;0
33995;205119;106;76;27;2;25;.926;3600000;0
33995;210368;106;0;0;0;0;.00nan;0;0
33995;210923;102;49;34;5;29;.853;3600000;0
33995;-1;102;0;0;0;0;.00nan;0;0
33997;209796;107;0;0;0;0;.00nan;0;0
33997;220816;107;90;20;0;20;1.000;3600000;0
33997;210428;103;0;0;0;0;.00nan;0;0
33997;-1;103;44;40;6;34;.850;3600000;0
33999;215575;100;0;0;0;0;.00nan;0;0
33999;205799;86;0;0;0;0;.00nan;0;0
33999;212368;100;100;41;1;40;.976;3900000;0
33999;-1;86;58;21;1;20;.952;3900000;0
34001;205318;97;53;34;5;29;.853;3569000;0
34001;215785;94;0;0;0;0;.00nan;0;0
34001;212354;97;0;0;0;0;.00nan;0;0
34001;-1;94;69;18;2;16;.889;3600000;0
34003;210603;104;0;0;0;0;.00nan;0;0
34003;212487;95;70;29;2;27;.931;3900000;0
34003;-1;95;0;0;0;0;.00nan;0;0
34003;208300;104;78;26;2;24;.923;3900000;0
34005;205015;105;74;36;2;34;.944;3900000;0
34005;205112;105;0;0;0;0;.00nan;0;0
34005;215735;93;88;39;2;37;.949;3900000;0
34005;-1;93;0;0;0;0;.00nan;0;0
34007;215733;99;45;26;4;22;.846;3600000;0
34007;-1;92;0;0;0;0;.00nan;0;0
34007;-1;99;0;0;0;0;.00nan;0;0
34007;-1;92;44;32;5;27;.844;3546000;0
34009;205119;106;0;0;0;0;.00nan;0;0
34009;210368;106;60;28;4;24;.857;3600000;0
34009;217437;88;44;9;2;7;.778;552000;0
34009;-1;88;27;26;6;20;.769;3048000;0
34011;205124;89;74;27;2;25;.926;3628000;0
34011;212343;96;0;0;0;0;.00nan;0;0
34011;-1;96;80;33;3;30;.909;3628000;0
34011;-1;89;0;0;0;0;.00nan;0;0
34013;209784;91;0;0;0;0;.00nan;0;0
34013;205429;91;52;28;4;24;.857;3600000;0
34013;210923;102;0;0;0;0;.00nan;0;0
34013;-1;102;34;27;5;22;.815;3600000;0
34015;210222;90;0;0;0;0;.00nan;0;0
34015;210439;98;0;0;0;0;.00nan;0;0
34015;207118;98;84;37;3;34;.919;3656000;0
34015;207239;90;61;26;2;24;.923;3656000;0
34017;208417;101;0;0;0;0;.00nan;0;0
34017;205076;87;43;28;5;23;.821;3555000;0
34017;220873;101;51;27;4;23;.852;3600000;0
34017;-1;87;0;0;0;0;.00nan;0;0
34019;212487;95;0;0;0;0;.00nan;0;0
34019;-1;95;47;29;5;24;.828;3600000;0
34019;-1;92;24;31;7;24;.774;3549000;0
34019;-1;92;0;0;0;0;.00nan;0;0
34021;209784;91;83;31;1;30;.968;3589000;0
34021;205429;91;0;0;0;0;.00nan;0;0
34021;212343;96;87;16;0;16;1.000;3600000;0
34021;-1;96;0;0;0;0;.00nan;0;0
34023;210222;90;69;38;4;34;.895;3820000;0
34023;215735;93;0;0;0;0;.00nan;0;0
34023;207239;90;0;0;0;0;.00nan;0;0
34023;-1;93;54;32;5;27;.844;3820000;0
34025;210428;103;67;42;4;38;.905;3900000;0
34025;215575;100;0;0;0;0;.00nan;0;0
34025;212368;100;43;21;4;17;.810;3900000;0
34025;-1;103;0;0;0;0;.00nan;0;0
34027;209796;107;0;0;0;0;.00nan;0;0
34027;220816;107;49;22;3;19;.864;3900000;0
34027;217437;88;77;35;3;32;.914;3890000;0
34027;-1;88;0;0;0;0;.00nan;0;0
34029;205119;106;54;26;3;23;.885;3900000;0
34029;210368;106;0;0;0;0;.00nan;0;0
34029;205318;97;0;0;0;0;.00nan;0;0
34029;212354;97;59;27;3;24;.889;3900000;0
34031;215785;94;65;30;4;26;.867;3600000;0
34031;205799;86;28;13;4;9;.692;1107000;0
34031;-1;86;70;17;1;16;.941;2481000;0
34031;-1;94;0;0;0;0;.00nan;0;0
34033;205124;89;0;0;0;0;.00nan;0;0
34033;215733;99;0;0;0;0;.00nan;0;0
34033;-1;89;77;44;3;41;.932;3600000;0
34033;-1;99;46;21;4;17;.810;3573000;0
34035;205015;105;0;0;0;0;.00nan;0;0
34035;205076;87;45;5;1;4;.800;315000;0
34035;205112;105;76;27;2;25;.926;3600000;0
34035;-1;87;40;39;7;32;.821;3285000;0
34037;210439;98;51;37;5;32;.865;3600000;0
34037;210923;102;76;25;2;23;.920;3600000;0
34037;207118;98;0;0;0;0;.00nan;0;0
34037;-1;102;0;0;0;0;.00nan;0;0
34039;208417;101;60;13;1;12;.923;3900000;0
34039;220873;101;0;0;0;0;.00nan;0;0
34039;210603;104;97;46;1;45;.978;3900000;0
34039;208300;104;0;0;0;0;.00nan;0;0
34041;205015;105;76;24;1;23;.958;3600000;0
34041;205112;105;0;0;0;0;.00nan;0;0
34041;205119;106;0;0;0;0;.00nan;0;0
34041;210368;106;53;19;3;16;.842;3519000;0
34043;210428;103;0;0;0;0;.00nan;0;0
34043;215575;100;59;16;2;14;.875;3673000;0
34043;212368;100;0;0;0;0;.00nan;0;0
34043;-1;103;61;26;3;23;.885;3673000;0
34045;205076;87;69;55;6;49;.891;3600000;0
34045;215733;99;85;42;3;39;.929;3600000;0
34045;-1;99;0;0;0;0;.00nan;0;0
34045;-1;87;0;0;0;0;.00nan;0;0
34047;209796;107;52;29;3;26;.897;3900000;0
34047;220816;107;0;0;0;0;.00nan;0;0
34047;217437;88;0;0;0;0;.00nan;0;0
34047;-1;88;95;43;3;40;.930;3900000;0
34049;210439;98;0;0;0;0;.00nan;0;0
34049;207118;98;46;34;5;29;.853;3553000;0
34049;212487;95;56;21;3;18;.857;3600000;0
34049;-1;95;0;0;0;0;.00nan;0;0
34051;210222;90;58;26;3;23;.885;3544000;0
34051;210603;104;0;0;0;0;.00nan;0;0
34051;207239;90;0;0;0;0;.00nan;0;0
34051;208300;104;57;14;2;12;.857;3600000;0
34053;215785;94;0;0;0;0;.00nan;0;0
34053;212343;96;0;0;0;0;.00nan;0;0
34053;-1;96;38;27;4;23;.852;3600000;0
34053;-1;94;72;18;1;17;.944;3600000;0
34055;209784;91;0;0;0;0;.00nan;0;0
34055;205124;89;41;21;4;17;.810;3520000;0
34055;205429;91;67;32;2;30;.938;3600000;0
34055;-1;89;0;0;0;0;.00nan;0;0
34057;208417;101;0;0;0;0;.00nan;0;0
34057;220873;101;73;19;1;18;.947;3600000;0
34057;215735;93;66;33;3;30;.909;3541000;0
34057;-1;93;0;0;0;0;.00nan;0;0
34059;205318;97;69;38;3;35;.921;3900000;0
34059;212354;97;0;0;0;0;.00nan;0;0
34059;-1;92;0;0;0;0;.00nan;0;0
34059;-1;92;86;39;3;36;.923;3900000;0
34061;205799;86;73;30;2;28;.933;3600000;0
34061;210923;102;0;0;0;0;.00nan;0;0
34061;-1;86;0;0;0;0;.00nan;0;0
34061;-1;102;71;29;3;26;.897;3582000;0
1736;205121;86;0;0;0;0;.00nan;0;0
1736;205318;97;80;42;4;38;.905;3572000;0
1736;205799;86;69;23;2;21;.913;3600000;0
1736;212354;97;0;0;0;0;.00nan;0;0
1737;205124;89;0;0;0;0;.00nan;0;0
1737;217437;88;79;42;4;38;.905;3552000;0
1737;-1;88;0;0;0;0;.00nan;0;0
1737;-1;89;70;30;3;27;.900;3600000;0
1738;215735;93;0;0;0;0;.00nan;0;0
1738;221137;92;41;16;3;13;.813;3564000;0
1738;-1;93;76;31;2;29;.935;3600000;0
1738;-1;92;0;0;0;0;.00nan;0;0
1739;209784;91;63;42;5;37;.881;3545000;0
1739;205429;91;0;0;0;0;.00nan;0;0
1739;212487;95;0;0;0;0;.00nan;0;0
1739;-1;95;50;30;4;26;.867;3600000;0
1740;203179;102;67;31;3;28;.903;3584000;0
1740;210923;102;0;0;0;0;.00nan;0;0
1740;218786;99;0;0;0;0;.00nan;0;0
1740;-1;99;79;31;1;30;.968;3600000;0
1741;208417;101;0;0;0;0;.00nan;0;0
1741;220873;101;67;23;2;21;.913;3563000;0
1741;215575;100;0;0;0;0;.00nan;0;0
1741;212368;100;88;31;1;30;.968;3600000;0
1742;205119;106;0;0;0;0;.00nan;0;0
1742;210368;106;60;22;2;20;.909;3600000;0
1742;215785;94;100;34;0;34;1.000;3600000;0
1742;-1;94;0;0;0;0;.00nan;0;0
1743;209796;107;0;0;0;0;.00nan;0;0
1743;205015;105;60;12;1;11;.917;1188000;0
1743;205112;105;37;22;4;18;.818;2362000;0
1743;217421;107;54;27;4;23;.852;3600000;0
1744;205121;86;0;0;0;0;.00nan;0;0
1744;205318;97;88;34;2;32;.941;3600000;0
1744;205799;86;60;27;3;24;.889;3577000;0
1744;212354;97;0;0;0;0;.00nan;0;0
1745;205124;89;0;0;0;0;.00nan;0;0
1745;217437;88;52;34;6;28;.824;3600000;0
1745;-1;88;0;0;0;0;.00nan;0;0
1745;-1;89;83;24;1;23;.958;3600000;0
1746;215735;93;0;0;0;0;.00nan;0;0
1746;221137;92;22;10;4;6;.600;1114000;0
1746;-1;93;84;34;2;32;.941;3600000;0
1746;-1;92;39;15;3;12;.800;2486000;0
1747;209784;91;60;9;0;9;1.000;828000;0
1747;205429;91;25;35;7;28;.800;2772000;0
1747;212487;95;0;0;0;0;.00nan;0;0
1747;-1;95;46;15;3;12;.800;3600000;0
1748;203179;102;56;41;5;36;.878;3600000;0
1748;210923;102;0;0;0;0;.00nan;0;0
1748;218786;99;0;0;0;0;.00nan;0;0
1748;-1;99;90;19;0;19;1.000;3600000;0
1749;208417;101;0;0;0;0;.00nan;0;0
1749;220873;101;42;23;4;19;.826;3600000;0
1749;215575;100;0;0;0;0;.00nan;0;0
1749;212368;100;60;35;5;30;.857;3551000;0
1750;205119;106;42;3;1;2;.667;753000;0
1750;210368;106;31;29;6;23;.793;2847000;0
1750;215785;94;58;26;3;23;.885;3600000;0
1750;-1;94;0;0;0;0;.00nan;0;0
1751;209796;107;59;32;3;29;.906;3560000;0
1751;205015;105;0;0;0;0;.00nan;0;0
1751;205112;105;75;30;2;28;.933;3600000;0
1751;217421;107;0;0;0;0;.00nan;0;0
1752;205121;86;0;0;0;0;.00nan;0;0
1752;205318;97;42;39;6;33;.846;3132000;0
1752;205799;86;58;25;4;21;.840;3600000;0
1752;212354;97;49;1;0;1;1.000;437000;0
1753;205124;89;0;0;0;0;.00nan;0;0
1753;217437;88;60;42;5;37;.881;3556000;0
1753;-1;88;0;0;0;0;.00nan;0;0
1753;-1;89;32;22;4;18;.818;3600000;0
1754;215735;93;0;0;0;0;.00nan;0;0
1754;221137;92;75;32;2;30;.938;3600000;0
1754;-1;93;78;52;4;48;.923;3600000;0
1754;-1;92;0;0;0;0;.00nan;0;0
1755;209784;91;0;0;0;0;.00nan;0;0
1755;205429;91;100;25;0;25;1.000;3600000;0
1755;212487;95;49;1;0;1;1.000;343000;0
1755;-1;95;15;25;7;18;.720;3257000;0
1756;203179;102;53;43;6;37;.860;3572000;0
1756;210923;102;0;0;0;0;.00nan;0;0
1756;218786;99;0;0;0;0;.00nan;0;0
1756;-1;99;53;27;4;23;.852;3600000;0
1757;208417;101;0;0;0;0;.00nan;0;0
1757;220873;101;72;27;2;25;.926;3553000;0
1757;215575;100;0;0;0;0;.00nan;0;0
1757;212368;100;100;28;0;28;1.000;3600000;0
1758;205119;106;0;0;0;0;.00nan;0;0
1758;210368;106;96;21;0;21;1.000;3600000;0
1758;215785;94;80;27;1;26;.963;3565000;0
1758;-1;94;0;0;0;0;.00nan;0;0
1759;209796;107;80;33;2;31;.939;3600000;0
1759;205015;105;0;0;0;0;.00nan;0;0
1759;205112;105;58;36;5;31;.861;3600000;0
1759;217421;107;0;0;0;0;.00nan;0;0
1760;205121;86;0;0;0;0;.00nan;0;0
1760;205318;97;75;28;2;26;.929;3600000;0
1760;205799;86;76;39;4;35;.897;3517000;0
1760;212354;97;0;0;0;0;.00nan;0;0
1761;205124;89;0;0;0;0;.00nan;0;0
1761;217437;88;84;37;3;34;.919;3600000;0
1761;-1;88;0;0;0;0;.00nan;0;0
1761;-1;89;83;28;1;27;.964;3600000;0
1762;215735;93;55;6;0;6;1.000;430000;0
1762;221137;92;70;18;2;16;.889;3600000;0
1762;-1;93;26;25;6;19;.760;3170000;0
1762;-1;92;0;0;0;0;.00nan;0;0
1763;209784;91;0;0;0;0;.00nan;0;0
1763;205429;91;85;30;1;29;.967;3600000;0
1763;212487;95;0;0;0;0;.00nan;0;0
1763;-1;95;62;31;3;28;.903;3568000;0
1764;203179;102;71;37;2;35;.946;4402000;0
1764;210923;102;0;0;0;0;.00nan;0;0
1764;218786;99;0;0;0;0;.00nan;0;0
1764;-1;99;61;29;3;26;.897;4402000;0
1765;208417;101;0;0;0;0;.00nan;0;0
1765;220873;101;55;28;4;24;.857;3600000;0
1765;215575;100;0;0;0;0;.00nan;0;0
1765;212368;100;73;19;1;18;.947;3600000;0
1766;205119;106;0;0;0;0;.00nan;0;0
1766;210368;106;71;32;2;30;.938;3524000;0
1766;215785;94;100;33;0;33;1.000;3600000;0
1766;-1;94;0;0;0;0;.00nan;0;0
1767;209796;107;85;33;3;30;.909;3527000;0
1767;205015;105;0;0;0;0;.00nan;0;0
1767;205112;105;78;26;1;25;.962;3600000;0
1767;217421;107;0;0;0;0;.00nan;0;0
1926;205121;86;0;0;0;0;.00nan;0;0
1926;205318;97;69;50;6;44;.880;3226000;0
1926;205799;86;77;35;3;32;.914;3600000;0
1926;212354;97;41;3;1;2;.667;374000;0
1927;215735;93;0;0;0;0;.00nan;0;0
1927;221137;92;55;28;3;25;.893;3600000;0
1927;-1;93;43;42;6;36;.857;3600000;0
1927;-1;92;0;0;0;0;.00nan;0;0
1928;209784;91;0;0;0;0;.00nan;0;0
1928;205429;91;63;31;3;28;.903;3600000;0
1928;212487;95;0;0;0;0;.00nan;0;0
1928;-1;95;71;28;2;26;.929;3600000;0
1929;203179;102;94;34;1;33;.971;3600000;0
1929;210923;102;0;0;0;0;.00nan;0;0
1929;218786;99;0;0;0;0;.00nan;0;0
1929;-1;99;53;25;3;22;.880;3533000;0
1930;208417;101;0;0;0;0;.00nan;0;0
1930;220873;101;71;39;3;36;.923;3600000;0
1930;215575;100;0;0;0;0;.00nan;0;0
1930;212368;100;100;30;0;30;1.000;3600000;0
1931;205119;106;0;0;0;0;.00nan;0;0
1931;210368;106;58;41;6;35;.854;3600000;0
1931;215785;94;100;31;0;31;1.000;3600000;0
1931;-1;94;0;0;0;0;.00nan;0;0
1932;209796;107;62;18;1;17;.944;3773000;0
1932;205015;105;0;0;0;0;.00nan;0;0
1932;205112;105;67;22;2;20;.909;3799000;0
1932;217421;107;0;0;0;0;.00nan;0;0
1964;205121;86;0;0;0;0;.00nan;0;0
1964;205318;97;51;33;6;27;.818;3600000;0
1964;205799;86;78;39;3;36;.923;3600000;0
1964;212354;97;0;0;0;0;.00nan;0;0
1965;215735;93;54;5;0;5;1.000;276000;0
1965;221137;92;72;26;2;24;.923;3600000;0
1965;-1;93;17;32;7;25;.781;3324000;0
1965;-1;92;0;0;0;0;.00nan;0;0
1966;209784;91;0;0;0;0;.00nan;0;0
1966;205429;91;66;20;2;18;.900;3579000;0
1966;212487;95;0;0;0;0;.00nan;0;0
1966;-1;95;97;38;1;37;.974;3600000;0
1967;203179;102;57;40;5;35;.875;3600000;0
1967;210923;102;0;0;0;0;.00nan;0;0
1967;218786;99;0;0;0;0;.00nan;0;0
1967;-1;99;57;14;1;13;.929;3600000;0
1968;209796;107;96;33;1;32;.970;3600000;0
1968;205015;105;0;0;0;0;.00nan;0;0
1968;205112;105;69;32;3;29;.906;3555000;0
1968;217421;107;0;0;0;0;.00nan;0;0
1994;205121;86;0;0;0;0;.00nan;0;0
1994;205124;89;0;0;0;0;.00nan;0;0
1994;205799;86;86;27;1;26;.963;3600000;0
1994;-1;89;43;30;5;25;.833;3600000;0
1995;221137;92;47;35;5;30;.857;3600000;0
1995;212487;95;0;0;0;0;.00nan;0;0
1995;-1;95;84;30;1;29;.967;3600000;0
1995;-1;92;0;0;0;0;.00nan;0;0
1996;215575;100;0;0;0;0;.00nan;0;0
1996;212368;100;62;21;2;19;.905;3813000;0
1996;218786;99;0;0;0;0;.00nan;0;0
1996;-1;99;88;30;1;29;.967;3856000;0
1997;209796;107;46;36;6;30;.833;3600000;0
1997;215785;94;26;6;3;3;.500;367000;0
1997;217421;107;0;0;0;0;.00nan;0;0
1997;-1;94;67;36;4;32;.889;3193000;0
1998;205121;86;0;0;0;0;.00nan;0;0
1998;205124;89;65;23;1;22;.957;910000;0
1998;205799;86;57;19;2;17;.895;3600000;0
1998;-1;89;26;30;6;24;.800;2690000;0
1999;221137;92;55;33;4;29;.879;3563000;0
1999;212487;95;0;0;0;0;.00nan;0;0
1999;-1;95;66;23;2;21;.913;3600000;0
1999;-1;92;0;0;0;0;.00nan;0;0
2000;215575;100;0;0;0;0;.00nan;0;0
2000;212368;100;100;33;0;33;1.000;3600000;0
2000;218786;99;0;0;0;0;.00nan;0;0
2000;-1;99;75;25;2;23;.920;3600000;0
2001;209796;107;64;27;3;24;.889;4014000;0
2001;215785;94;58;19;2;17;.895;4014000;0
2001;217421;107;0;0;0;0;.00nan;0;0
2001;-1;94;0;0;0;0;.00nan;0;0
2002;205121;86;0;0;0;0;.00nan;0;0
2002;205124;89;51;25;3;22;.880;3560000;0
2002;205799;86;69;26;2;24;.923;3600000;0
2002;-1;89;0;0;0;0;.00nan;0;0
2003;221137;92;56;47;5;42;.894;4275000;0
2003;212487;95;0;0;0;0;.00nan;0;0
2003;-1;95;47;25;4;21;.840;4275000;0
2003;-1;92;0;0;0;0;.00nan;0;0
2004;215575;100;0;0;0;0;.00nan;0;0
2004;212368;100;59;36;5;31;.861;3600000;0
2004;218786;99;0;0;0;0;.00nan;0;0
2004;-1;99;73;29;2;27;.931;3600000;0
2005;209796;107;60;38;5;33;.868;3600000;0
2005;215785;94;88;31;2;29;.935;3600000;0
2005;217421;107;0;0;0;0;.00nan;0;0
2005;-1;94;0;0;0;0;.00nan;0;0
2006;205121;86;0;0;0;0;.00nan;0;0
2006;205124;89;76;29;1;28;.966;3600000;0
2006;205799;86;24;27;6;21;.778;3600000;0
2006;-1;89;0;0;0;0;.00nan;0;0
2007;221137;92;64;31;3;28;.903;3600000;0
2007;212487;95;0;0;0;0;.00nan;0;0
2007;-1;95;45;29;5;24;.828;3600000;0
2007;-1;92;0;0;0;0;.00nan;0;0
2008;215575;100;0;0;0;0;.00nan;0;0
2008;212368;100;81;39;3;36;.923;3547000;0
2008;218786;99;0;0;0;0;.00nan;0;0
2008;-1;99;68;26;2;24;.923;3600000;0
2009;209796;107;73;33;2;31;.939;3600000;0
2009;215785;94;63;36;4;32;.889;2336000;0
2009;217421;107;0;0;0;0;.00nan;0;0
2009;-1;94;63;14;1;13;.929;1264000;0
2276;205121;86;0;0;0;0;.00nan;0;0
2276;205124;89;65;35;3;32;.914;3600000;0
2276;205799;86;100;32;0;32;1.000;3600000;0
2276;-1;89;0;0;0;0;.00nan;0;0
2277;221137;92;70;32;3;29;.906;3600000;0
2277;212487;95;0;0;0;0;.00nan;0;0
2277;-1;95;50;30;5;25;.833;3600000;0
2277;-1;92;0;0;0;0;.00nan;0;0
2278;215575;100;0;0;0;0;.00nan;0;0
2278;212368;100;63;19;2;17;.895;3600000;0
2278;218786;99;0;0;0;0;.00nan;0;0
2278;-1;99;46;30;5;25;.833;3600000;0
2279;209796;107;89;27;1;26;.963;3551000;0
2279;215785;94;100;38;0;38;1.000;3600000;0
2279;217421;107;0;0;0;0;.00nan;0;0
2279;-1;94;0;0;0;0;.00nan;0;0
2307;221137;92;90;34;1;33;.971;3600000;0
2307;212487;95;0;0;0;0;.00nan;0;0
2307;-1;95;71;30;3;27;.900;3535000;0
2307;-1;92;0;0;0;0;.00nan;0;0
2308;215575;100;0;0;0;0;.00nan;0;0
2308;212368;100;61;21;2;19;.905;3600000;0
2308;218786;99;0;0;0;0;.00nan;0;0
2308;-1;99;53;28;3;25;.893;3561000;0
2309;209796;107;28;19;4;15;.789;3568000;0
2309;215785;94;100;49;3;46;.939;3600000;0
2309;217421;107;0;0;0;0;.00nan;0;0
2309;-1;94;0;0;0;0;.00nan;0;0
2370;221137;92;75;29;2;27;.931;3600000;0
2370;212487;95;0;0;0;0;.00nan;0;0
2370;-1;95;54;29;4;25;.862;3576000;0
2370;-1;92;0;0;0;0;.00nan;0;0
2371;215575;100;0;0;0;0;.00nan;0;0
2371;212368;100;100;27;0;27;1.000;3600000;0
2371;218786;99;0;0;0;0;.00nan;0;0
2371;-1;99;20;26;6;20;.769;3600000;0
2419;205121;86;0;0;0;0;.00nan;0;0
2419;221137;92;79;32;1;31;.969;3986000;0
2419;205799;86;83;36;2;34;.944;3986000;0
2419;-1;92;0;0;0;0;.00nan;0;0
2420;215575;100;0;0;0;0;.00nan;0;0
2420;215785;94;62;28;3;25;.893;3600000;0
2420;212368;100;45;28;5;23;.821;3545000;0
2420;-1;94;0;0;0;0;.00nan;0;0
2421;205121;86;0;0;0;0;.00nan;0;0
2421;221137;92;79;34;2;32;.941;3600000;0
2421;205799;86;64;30;3;27;.900;3600000;0
2421;-1;92;0;0;0;0;.00nan;0;0
2422;215575;100;0;0;0;0;.00nan;0;0
2422;215785;94;53;35;5;30;.857;3536000;0
2422;212368;100;71;30;3;27;.900;3600000;0
2422;-1;94;0;0;0;0;.00nan;0;0
2423;205121;86;0;0;0;0;.00nan;0;0
2423;221137;92;85;47;4;43;.915;4003000;0
2423;205799;86;60;29;3;26;.897;4003000;0
2423;-1;92;0;0;0;0;.00nan;0;0
2424;215575;100;0;0;0;0;.00nan;0;0
2424;215785;94;66;38;4;34;.895;3567000;0
2424;212368;100;69;26;2;24;.923;3600000;0
2424;-1;94;0;0;0;0;.00nan;0;0
2425;205121;86;0;0;0;0;.00nan;0;0
2425;221137;92;21;12;4;8;.667;600000;0
2425;205799;86;96;33;1;32;.970;3600000;0
2425;-1;92;87;32;2;30;.938;3000000;0
2426;215575;100;0;0;0;0;.00nan;0;0
2426;215785;94;19;10;4;6;.600;1066000;0
2426;212368;100;83;26;1;25;.962;3600000;0
2426;-1;94;64;23;2;21;.913;2534000;0
2535;205121;86;0;0;0;0;.00nan;0;0
2535;221137;92;43;40;6;34;.850;3600000;0
2535;205799;86;86;27;1;26;.963;3600000;0
2535;-1;92;0;0;0;0;.00nan;0;0
2536;215575;100;0;0;0;0;.00nan;0;0
2536;215785;94;72;34;3;31;.912;3600000;0
2536;212368;100;40;26;5;21;.808;3558000;0
2536;-1;94;0;0;0;0;.00nan;0;0
2554;205121;86;0;0;0;0;.00nan;0;0
2554;221137;92;52;28;5;23;.821;3600000;0
2554;205799;86;62;20;2;18;.900;3600000;0
2554;-1;92;0;0;0;0;.00nan;0;0
2555;215575;100;0;0;0;0;.00nan;0;0
2555;215785;94;79;23;1;22;.957;3600000;0
2555;212368;100;62;24;2;22;.917;3591000;0
2555;-1;94;0;0;0;0;.00nan;0;0
2631;215575;100;0;0;0;0;.00nan;0;0
2631;215785;94;23;39;8;31;.795;3600000;0
2631;212368;100;69;27;3;24;.889;3600000;0
2631;-1;94;0;0;0;0;.00nan;0;0
2668;205121;86;0;0;0;0;.00nan;0;0
2668;215575;100;0;0;0;0;.00nan;0;0
2668;205799;86;98;33;2;31;.939;3600000;0
2668;212368;100;41;35;6;29;.829;3600000;0
2669;205121;86;0;0;0;0;.00nan;0;0
2669;215575;100;0;0;0;0;.00nan;0;0
2669;205799;86;77;28;2;26;.929;3563000;0
2669;212368;100;90;30;1;29;.967;3600000;0
2670;205121;86;0;0;0;0;.00nan;0;0
2670;215575;100;0;0;0;0;.00nan;0;0
2670;205799;86;76;17;1;16;.941;3600000;0
2670;212368;100;83;39;3;36;.923;3581000;0
2671;205121;86;0;0;0;0;.00nan;0;0
2671;215575;100;0;0;0;0;.00nan;0;0
2671;205799;86;85;23;1;22;.957;3600000;0
2671;212368;100;67;48;5;43;.896;3600000;0
2729;205121;86;0;0;0;0;.00nan;0;0
2729;215575;100;0;0;0;0;.00nan;0;0
2729;205799;86;46;29;5;24;.828;3740000;0
2729;212368;100;67;33;4;29;.879;3740000;0
2745;205121;86;0;0;0;0;.00nan;0;0
2745;215575;100;0;0;0;0;.00nan;0;0
2745;205799;86;65;32;3;29;.906;3701000;0
2745;212368;100;83;42;4;38;.905;3701000;0
34062;208575;142;43;3;1;2;.667;310000;0
34062;204668;140;39;17;4;13;.765;3600000;0
34062;204881;140;0;0;0;0;.00nan;0;0
34062;217769;142;33;30;6;24;.800;3290000;0
34063;203276;139;38;30;5;25;.833;3600000;0
34063;204815;144;0;0;0;0;.00nan;0;0
34063;205653;139;0;0;0;0;.00nan;0;0
34063;206778;144;75;31;2;29;.935;3600000;0
34064;215128;141;0;0;0;0;.00nan;0;0
34064;210004;141;55;28;4;24;.857;3516000;0
34064;204949;143;100;46;2;44;.957;3600000;0
34064;208201;143;0;0;0;0;.00nan;0;0
34065;210060;137;0;0;0;0;.00nan;0;0
34065;210213;134;60;26;3;23;.885;3600000;0
34065;210876;134;0;0;0;0;.00nan;0;0
34065;-1;137;67;44;5;39;.886;3517000;0
34066;208609;131;77;32;2;30;.938;3600000;0
34066;204873;129;53;41;6;35;.854;3160000;0
34066;209998;129;54;3;0;3;1.000;440000;0
34066;206789;131;0;0;0;0;.00nan;0;0
34067;207304;130;0;0;0;0;.00nan;0;0
34067;207313;132;0;0;0;0;.00nan;0;0
34067;-1;132;62;27;3;24;.889;3546000;0
34067;-1;130;74;24;2;22;.917;3600000;0
34068;203288;135;72;31;3;28;.903;3600000;0
34068;208556;135;0;0;0;0;.00nan;0;0
34068;204779;136;0;0;0;0;.00nan;0;0
34068;-1;136;67;34;2;32;.941;3600000;0
34069;219003;133;0;0;0;0;.00nan;0;0
34069;204779;136;53;36;5;31;.861;2952000;0
34069;-1;133;57;38;5;33;.868;3600000;0
34069;-1;136;20;16;5;11;.688;648000;0
34070;215217;1340;42;27;5;22;.815;3831000;0
34070;212019;1340;0;0;0;0;.00nan;0;0
34070;-1;128;54;27;4;23;.852;3831000;0
34070;-1;128;0;0;0;0;.00nan;0;0
34071;220566;138;0;0;0;0;.00nan;0;0
34071;207304;130;14;40;9;31;.775;3600000;0
34071;223929;138;35;27;5;22;.815;3600000;0
34071;-1;130;0;0;0;0;.00nan;0;0
34072;203276;139;48;33;5;28;.848;3707000;0
34072;204815;144;44;33;6;27;.818;3707000;0
34072;205653;139;0;0;0;0;.00nan;0;0
34072;206778;144;0;0;0;0;.00nan;0;0
34073;215128;141;0;0;0;0;.00nan;0;0
34073;210004;141;82;31;1;30;.968;3600000;0
34073;204949;143;0;0;0;0;.00nan;0;0
34073;208201;143;44;27;4;23;.852;3600000;0
34074;208575;142;0;0;0;0;.00nan;0;0
34074;204668;140;42;15;3;12;.800;3600000;0
34074;204881;140;0;0;0;0;.00nan;0;0
34074;217769;142;68;45;4;41;.911;3600000;0
34075;219003;133;0;0;0;0;.00nan;0;0
34075;210213;134;91;36;1;35;.972;3600000;0
34075;210876;134;0;0;0;0;.00nan;0;0
34075;-1;133;31;21;5;16;.762;3600000;0
34076;220566;138;43;33;5;28;.848;3600000;0
34076;207313;132;0;0;0;0;.00nan;0;0
34076;223929;138;0;0;0;0;.00nan;0;0
34076;-1;132;54;16;2;14;.875;3600000;0
34077;215217;1340;87;22;1;21;.955;3600000;0
34077;212019;1340;0;0;0;0;.00nan;0;0
34077;-1;128;0;0;0;0;.00nan;0;0
34077;-1;128;42;31;5;26;.839;3600000;0
34078;203288;135;52;44;6;38;.864;3114000;0
34078;208556;135;45;5;1;4;.800;486000;0
34078;204873;129;78;27;1;26;.963;3600000;0
34078;209998;129;0;0;0;0;.00nan;0;0
34079;208609;131;56;40;6;34;.850;3171000;0
34079;210060;137;41;25;4;21;.840;3600000;0
34079;206789;131;63;5;0;5;1.000;429000;0
34079;-1;137;0;0;0;0;.00nan;0;0
34080;204668;140;45;33;5;28;.848;3561000;0
34080;204815;144;0;0;0;0;.00nan;0;0
34080;204881;140;0;0;0;0;.00nan;0;0
34080;206778;144;39;22;4;18;.818;3600000;0
34081;203276;139;63;34;5;29;.853;3900000;0
34081;215128;141;0;0;0;0;.00nan;0;0
34081;210004;141;49;30;5;25;.833;3900000;0
34081;205653;139;0;0;0;0;.00nan;0;0
34082;204779;136;0;0;0;0;.00nan;0;0
34082;210213;134;17;9;4;5;.556;969000;0
34082;210876;134;33;19;4;15;.789;2631000;0
34082;-1;136;98;37;1;36;.973;3600000;0
34083;204873;129;67;25;2;23;.920;3600000;0
34083;209998;129;0;0;0;0;.00nan;0;0
34083;215217;1340;64;33;3;30;.909;3543000;0
34083;212019;1340;0;0;0;0;.00nan;0;0
34084;220566;138;0;0;0;0;.00nan;0;0
34084;223929;138;61;35;4;31;.886;3582000;0
34084;-1;128;0;0;0;0;.00nan;0;0
34084;-1;128;58;26;3;23;.885;3600000;0
34085;203288;135;30;24;5;19;.792;3588000;0
34085;208556;135;0;0;0;0;.00nan;0;0
34085;210060;137;56;34;4;30;.882;3600000;0
34085;-1;137;0;0;0;0;.00nan;0;0
34086;208609;131;71;35;3;32;.914;3523000;0
34086;206789;131;0;0;0;0;.00nan;0;0
34086;207304;130;0;0;0;0;.00nan;0;0
34086;-1;130;83;23;1;22;.957;3600000;0
34087;219003;133;0;0;0;0;.00nan;0;0
34087;207313;132;0;0;0;0;.00nan;0;0
34087;-1;132;52;39;5;34;.872;3571000;0
34087;-1;133;74;43;4;39;.907;3600000;0
34088;204779;136;86;40;3;37;.925;3732000;0
34088;210213;134;71;36;4;32;.889;3732000;0
34088;210876;134;0;0;0;0;.00nan;0;0
34088;-1;136;0;0;0;0;.00nan;0;0
34089;204873;129;0;0;0;0;.00nan;0;0
34089;209998;129;57;44;5;39;.886;3557000;0
34089;-1;128;0;0;0;0;.00nan;0;0
34089;-1;128;45;26;4;22;.846;3600000;0
34090;203276;139;0;0;0;0;.00nan;0;0
34090;204949;143;40;35;6;29;.829;3267000;0
34090;205653;139;68;35;3;32;.914;3600000;0
34090;208201;143;53;3;0;3;1.000;333000;0
34091;208575;142;0;0;0;0;.00nan;0;0
34091;215128;141;79;25;1;24;.960;3600000;0
34091;210004;141;0;0;0;0;.00nan;0;0
34091;217769;142;53;28;3;25;.893;3600000;0
34092;204668;140;0;0;0;0;.00nan;0;0
34092;204815;144;27;32;6;26;.813;2775000;0
34092;204881;140;64;22;2;20;.909;3600000;0
34092;206778;144;53;20;2;18;.900;825000;0
34093;220566;138;44;25;4;21;.840;3600000;0
34093;215217;1340;68;19;1;18;.947;1940000;0
34093;212019;1340;13;28;7;21;.750;1660000;0
34093;223929;138;0;0;0;0;.00nan;0;0
34094;208575;142;85;36;3;33;.917;3600000;0
34094;204949;143;0;0;0;0;.00nan;0;0
34094;217769;142;0;0;0;0;.00nan;0;0
34094;208201;143;48;33;4;29;.879;3570000;0
34095;208609;131;33;29;6;23;.793;2645000;0
34095;206789;131;56;12;1;11;.917;955000;0
34095;207304;130;0;0;0;0;.00nan;0;0
34095;-1;130;53;21;3;18;.857;3600000;0
34096;203288;135;0;0;0;0;.00nan;0;0
34096;219003;133;0;0;0;0;.00nan;0;0
34096;208556;135;70;32;3;29;.906;3546000;0
34096;-1;133;61;21;2;19;.905;3600000;0
34097;210060;137;47;33;5;28;.848;3588000;0
34097;207313;132;0;0;0;0;.00nan;0;0
34097;-1;132;77;34;3;31;.912;3600000;0
34097;-1;137;0;0;0;0;.00nan;0;0
34098;208575;142;0;0;0;0;.00nan;0;0
34098;215128;141;0;0;0;0;.00nan;0;0
34098;210004;141;93;28;1;27;.964;3600000;0
34098;217769;142;70;46;4;42;.913;3600000;0
34099;204815;144;0;0;0;0;.00nan;0;0
34099;204949;143;41;42;6;36;.857;3600000;0
34099;206778;144;82;30;2;28;.933;3600000;0
34099;208201;143;0;0;0;0;.00nan;0;0
34100;210213;134;0;0;0;0;.00nan;0;0
34100;210876;134;100;37;1;36;.973;3600000;0
34100;207313;132;0;0;0;0;.00nan;0;0
34100;-1;132;70;28;2;26;.929;3600000;0
34101;208609;131;81;42;3;39;.929;3600000;0
34101;215217;1340;69;25;2;23;.920;3600000;0
34101;212019;1340;0;0;0;0;.00nan;0;0
34101;206789;131;0;0;0;0;.00nan;0;0
34102;203288;135;53;29;4;25;.862;3600000;0
34102;208556;135;0;0;0;0;.00nan;0;0
34102;204779;136;0;0;0;0;.00nan;0;0
34102;-1;136;78;21;1;20;.952;3600000;0
34103;203276;139;39;23;4;19;.826;2191000;0
34103;210060;137;0;0;0;0;.00nan;0;0
34103;205653;139;56;13;1;12;.923;1409000;0
34103;-1;137;45;27;4;23;.852;3600000;0
34104;204873;129;83;28;1;27;.964;3600000;0
34104;209998;129;0;0;0;0;.00nan;0;0
34104;215217;1340;0;0;0;0;.00nan;0;0
34104;212019;1340;36;25;4;21;.840;3600000;0
34105;208575;142;66;49;5;44;.898;3528000;0
34105;204668;140;62;25;3;22;.880;3600000;0
34105;204881;140;0;0;0;0;.00nan;0;0
34105;217769;142;0;0;0;0;.00nan;0;0
34106;204815;144;48;0;0;0;.00nan;384000;0
34106;206778;144;34;39;6;33;.846;3216000;0
34106;207313;132;0;0;0;0;.00nan;0;0
34106;-1;132;42;26;4;22;.846;3600000;0
34107;210060;137;34;31;5;26;.839;3600000;0
34107;204949;143;65;18;2;16;.889;3600000;0
34107;208201;143;0;0;0;0;.00nan;0;0
34107;-1;137;0;0;0;0;.00nan;0;0
34108;219003;133;65;27;3;24;.889;3600000;0
34108;-1;128;21;29;7;22;.759;3600000;0
34108;-1;128;0;0;0;0;.00nan;0;0
34108;-1;133;0;0;0;0;.00nan;0;0
34109;204779;136;0;0;0;0;.00nan;0;0
34109;215128;141;0;0;0;0;.00nan;0;0
34109;210004;141;77;47;5;42;.894;3600000;0
34109;-1;136;65;24;2;22;.917;3600000;0
34110;210213;134;0;0;0;0;.00nan;0;0
34110;210876;134;68;29;2;27;.931;3600000;0
34110;207304;130;0;0;0;0;.00nan;0;0
34110;-1;130;46;38;5;33;.868;3600000;0
34111;203288;135;46;28;4;24;.857;3521000;0
34111;208556;135;0;0;0;0;.00nan;0;0
34111;220566;138;85;39;2;37;.949;3600000;0
34111;223929;138;0;0;0;0;.00nan;0;0
34112;208609;131;86;46;3;43;.935;3600000;0
34112;204873;129;0;0;0;0;.00nan;0;0
34112;209998;129;65;15;1;14;.933;3600000;0
34112;206789;131;0;0;0;0;.00nan;0;0
34113;219003;133;0;0;0;0;.00nan;0;0
34113;-1;128;0;0;0;0;.00nan;0;0
34113;-1;128;79;42;4;38;.905;3600000;0
34113;-1;133;71;30;2;28;.933;3600000;0
34114;203288;135;0;0;0;0;.00nan;0;0
34114;208556;135;53;34;4;30;.882;3600000;0
34114;215128;141;51;37;5;32;.865;3596000;0
34114;210004;141;0;0;0;0;.00nan;0;0
34115;220566;138;48;0;0;0;.00nan;421000;0
34115;215217;1340;33;31;6;25;.806;3600000;0
34115;212019;1340;0;0;0;0;.00nan;0;0
34115;223929;138;29;40;8;32;.800;3122000;0
34116;204949;143;43;4;1;3;.750;495000;0
34116;207313;132;90;35;2;33;.943;3600000;0
34116;208201;143;22;31;7;24;.774;3105000;0
34116;-1;132;0;0;0;0;.00nan;0;0
34117;203276;139;66;38;3;35;.921;3546000;0
34117;204668;140;0;0;0;0;.00nan;0;0
34117;204881;140;77;23;1;22;.957;3600000;0
34117;205653;139;0;0;0;0;.00nan;0;0
34118;208575;142;0;0;0;0;.00nan;0;0
34118;210213;134;0;0;0;0;.00nan;0;0
34118;210876;134;65;29;2;27;.931;3563000;0
34118;217769;142;91;35;1;34;.971;3600000;0
34119;204815;144;49;28;4;24;.857;3600000;0
34119;210060;137;42;32;5;27;.844;3572000;0
34119;206778;144;0;0;0;0;.00nan;0;0
34119;-1;137;0;0;0;0;.00nan;0;0
34120;208609;131;0;0;0;0;.00nan;0;0
34120;204779;136;0;0;0;0;.00nan;0;0
34120;206789;131;71;23;1;22;.957;3600000;0
34120;-1;136;62;31;3;28;.903;3582000;0
34121;204873;129;0;0;0;0;.00nan;0;0
34121;209998;129;75;39;3;36;.923;3600000;0
34121;207304;130;41;33;6;27;.818;3600000;0
34121;-1;130;0;0;0;0;.00nan;0;0
34122;203276;139;53;29;4;25;.862;3204000;0
34122;205653;139;28;5;3;2;.400;396000;0
34122;207313;132;0;0;0;0;.00nan;0;0
34122;-1;132;73;16;1;15;.938;3600000;0
34123;215128;141;0;0;0;0;.00nan;0;0
34123;210004;141;84;43;3;40;.930;3600000;0
34123;210213;134;57;46;6;40;.870;3600000;0
34123;210876;134;0;0;0;0;.00nan;0;0
34124;208609;131;51;34;4;30;.882;3600000;0
34124;204779;136;0;0;0;0;.00nan;0;0
34124;206789;131;0;0;0;0;.00nan;0;0
34124;-1;136;74;24;1;23;.958;3600000;0
34125;215217;1340;0;0;0;0;.00nan;0;0
34125;212019;1340;82;25;1;24;.960;3600000;0
34125;-1;128;61;28;3;25;.893;3515000;0
34125;-1;128;0;0;0;0;.00nan;0;0
34126;220566;138;0;0;0;0;.00nan;0;0
34126;207304;130;0;0;0;0;.00nan;0;0
34126;223929;138;54;21;3;18;.857;3600000;0
34126;-1;130;75;58;5;53;.914;3556000;0
34127;203276;139;53;19;3;16;.842;3555000;0
34127;204873;129;95;37;2;35;.946;3600000;0
34127;209998;129;0;0;0;0;.00nan;0;0
34127;205653;139;0;0;0;0;.00nan;0;0
34128;204779;136;0;0;0;0;.00nan;0;0
34128;204949;143;41;30;5;25;.833;3583000;0
34128;208201;143;0;0;0;0;.00nan;0;0
34128;-1;136;76;38;4;34;.895;3600000;0
34129;208609;131;0;0;0;0;.00nan;0;0
34129;204815;144;0;0;0;0;.00nan;0;0
34129;206778;144;53;29;4;25;.862;3600000;0
34129;206789;131;38;29;5;24;.828;3566000;0
34130;204668;140;87;32;1;31;.969;3607000;0
34130;204881;140;0;0;0;0;.00nan;0;0
34130;207313;132;0;0;0;0;.00nan;0;0
34130;-1;132;100;34;0;34;1.000;3607000;0
34131;219003;133;0;0;0;0;.00nan;0;0
34131;207304;130;0;0;0;0;.00nan;0;0
34131;-1;133;93;32;1;31;.969;3600000;0
34131;-1;130;49;31;5;26;.839;3600000;0
34132;215128;141;0;0;0;0;.00nan;0;0
34132;204873;129;41;17;3;14;.824;934000;0
34132;209998;129;50;43;6;37;.860;2666000;0
34132;210004;141;76;28;3;25;.893;3600000;0
34133;208575;142;28;32;6;26;.813;3600000;0
34133;210213;134;71;27;2;25;.926;3600000;0
34133;210876;134;0;0;0;0;.00nan;0;0
34133;217769;142;0;0;0;0;.00nan;0;0
34134;219003;133;36;33;6;27;.818;3020000;0
34134;220566;138;60;25;4;21;.840;3600000;0
34134;223929;138;0;0;0;0;.00nan;0;0
34134;-1;133;47;7;1;6;.857;580000;0
34135;208609;131;68;44;6;38;.864;3600000;0
34135;210060;137;81;26;1;25;.962;3600000;0
34135;206789;131;0;0;0;0;.00nan;0;0
34135;-1;137;0;0;0;0;.00nan;0;0
34136;203288;135;63;32;3;29;.906;3556000;0
34136;208556;135;0;0;0;0;.00nan;0;0
34136;204949;143;0;0;0;0;.00nan;0;0
34136;208201;143;99;44;2;42;.955;3600000;0
34137;208575;142;0;0;0;0;.00nan;0;0
34137;204873;129;41;31;5;26;.839;3558000;0
34137;209998;129;0;0;0;0;.00nan;0;0
34137;217769;142;50;17;3;14;.824;3600000;0
34138;204668;140;55;21;3;18;.857;3600000;0
34138;204881;140;0;0;0;0;.00nan;0;0
34138;-1;128;0;0;0;0;.00nan;0;0
34138;-1;128;37;29;5;24;.828;3577000;0
34139;204779;136;0;0;0;0;.00nan;0;0
34139;207304;130;30;31;6;25;.806;2767000;0
34139;-1;136;72;26;2;24;.923;3600000;0
34139;-1;130;56;12;1;11;.917;833000;0
34140;203276;139;62;39;4;35;.897;3600000;0
34140;215128;141;74;52;5;47;.904;3580000;0
34140;210004;141;0;0;0;0;.00nan;0;0
34140;205653;139;0;0;0;0;.00nan;0;0
34141;204815;144;0;0;0;0;.00nan;0;0
34141;215217;1340;49;28;4;24;.857;3600000;0
34141;212019;1340;0;0;0;0;.00nan;0;0
34141;206778;144;100;38;1;37;.974;3600000;0
34142;203288;135;75;38;3;35;.921;3900000;0
34142;219003;133;0;0;0;0;.00nan;0;0
34142;208556;135;0;0;0;0;.00nan;0;0
34142;-1;133;84;41;3;38;.927;3900000;0
34143;204949;143;48;25;4;21;.840;3557000;0
34143;210213;134;0;0;0;0;.00nan;0;0
34143;210876;134;70;27;2;25;.926;3600000;0
34143;208201;143;0;0;0;0;.00nan;0;0
34144;204815;144;9;25;7;18;.720;3600000;0
34144;206778;144;0;0;0;0;.00nan;0;0
34144;-1;128;75;34;2;32;.941;3600000;0
34144;-1;128;0;0;0;0;.00nan;0;0
34145;208609;131;81;50;3;47;.940;3600000;0
34145;206789;131;0;0;0;0;.00nan;0;0
34145;207313;132;0;0;0;0;.00nan;0;0
34145;-1;132;75;12;0;12;1.000;3600000;0
34146;220566;138;0;0;0;0;.00nan;0;0
34146;207304;130;0;0;0;0;.00nan;0;0
34146;223929;138;84;36;2;34;.944;3600000;0
34146;-1;130;55;31;4;27;.871;3513000;0
34147;203276;139;0;0;0;0;.00nan;0;0
34147;208575;142;74;48;5;43;.896;3516000;0
34147;205653;139;65;29;3;26;.897;3600000;0
34147;217769;142;0;0;0;0;.00nan;0;0
34148;204668;140;0;0;0;0;.00nan;0;0
34148;204881;140;42;34;6;28;.824;3600000;0
34148;215217;1340;0;0;0;0;.00nan;0;0
34148;212019;1340;79;29;2;27;.931;3600000;0
34149;204779;136;78;35;2;33;.943;3580000;0
34149;210060;137;0;0;0;0;.00nan;0;0
34149;-1;136;0;0;0;0;.00nan;0;0
34149;-1;137;79;25;1;24;.960;3600000;0
34150;219003;133;0;0;0;0;.00nan;0;0
34150;207313;132;0;0;0;0;.00nan;0;0
34150;-1;132;91;35;1;34;.971;3600000;0
34150;-1;133;86;35;2;33;.943;3600000;0
34151;208609;131;0;0;0;0;.00nan;0;0
34151;220566;138;51;23;3;20;.870;3588000;0
34151;206789;131;93;47;2;45;.957;3600000;0
34151;223929;138;0;0;0;0;.00nan;0;0
34152;208575;142;76;47;3;44;.936;3900000;0
34152;204815;144;0;0;0;0;.00nan;0;0
34152;206778;144;46;14;3;11;.786;3900000;0
34152;217769;142;0;0;0;0;.00nan;0;0
34153;215128;141;0;0;0;0;.00nan;0;0
34153;210004;141;97;34;1;33;.971;3600000;0
34153;215217;1340;82;34;2;32;.941;3542000;0
34153;212019;1340;0;0;0;0;.00nan;0;0
34154;204873;129;0;0;0;0;.00nan;0;0
34154;209998;129;72;37;3;34;.919;3900000;0
34154;210060;137;0;0;0;0;.00nan;0;0
34154;-1;137;53;24;3;21;.875;3900000;0
34155;203288;135;64;42;5;37;.881;3883000;0
34155;208556;135;0;0;0;0;.00nan;0;0
34155;210213;134;91;50;4;46;.920;3883000;0
34155;210876;134;0;0;0;0;.00nan;0;0
34156;204815;144;61;24;1;23;.958;3900000;0
34156;206778;144;0;0;0;0;.00nan;0;0
34156;-1;128;0;0;0;0;.00nan;0;0
34156;-1;128;94;27;1;26;.963;3900000;0
34157;215217;1340;50;15;2;13;.867;827000;0
34157;204949;143;57;21;2;19;.905;3600000;0
34157;212019;1340;23;27;6;21;.778;2773000;0
34157;208201;143;0;0;0;0;.00nan;0;0
34158;219003;133;0;0;0;0;.00nan;0;0
34158;210213;134;0;0;0;0;.00nan;0;0
34158;210876;134;30;43;8;35;.814;3600000;0
34158;-1;133;80;24;1;23;.958;3600000;0
34159;204779;136;0;0;0;0;.00nan;0;0
34159;220566;138;0;0;0;0;.00nan;0;0
34159;223929;138;55;28;4;24;.857;3600000;0
34159;-1;136;99;45;2;43;.956;3600000;0
34160;208609;131;66;26;3;23;.885;3600000;0
34160;206789;131;0;0;0;0;.00nan;0;0
34160;207304;130;100;44;1;43;.977;3600000;0
34160;-1;130;0;0;0;0;.00nan;0;0
34161;204873;129;34;16;4;12;.750;775000;0
34161;209998;129;86;27;1;26;.963;2825000;0
34161;207313;132;0;0;0;0;.00nan;0;0
34161;-1;132;88;33;2;31;.939;3600000;0
34162;208575;142;0;0;0;0;.00nan;0;0
34162;215128;141;0;0;0;0;.00nan;0;0
34162;210004;141;50;26;4;22;.846;3578000;0
34162;217769;142;80;39;3;36;.923;3600000;0
34163;219003;133;70;35;4;31;.886;3600000;0
34163;210060;137;46;27;5;22;.815;3543000;0
34163;-1;133;0;0;0;0;.00nan;0;0
34163;-1;137;0;0;0;0;.00nan;0;0
34164;203288;135;70;39;4;35;.897;3750000;0
34164;208556;135;0;0;0;0;.00nan;0;0
34164;220566;138;43;28;5;23;.821;3750000;0
34164;223929;138;0;0;0;0;.00nan;0;0
34165;204949;143;0;0;0;0;.00nan;0;0
34165;208201;143;60;28;3;25;.893;3600000;0
34165;-1;128;59;34;4;30;.882;3600000;0
34165;-1;128;0;0;0;0;.00nan;0;0
34166;203276;139;23;11;4;7;.636;1166000;0
34166;204668;140;42;20;4;16;.800;3600000;0
34166;204881;140;0;0;0;0;.00nan;0;0
34166;205653;139;67;34;4;30;.882;2434000;0
34167;204815;144;0;0;0;0;.00nan;0;0
34167;215217;1340;65;30;3;27;.900;3722000;0
34167;212019;1340;0;0;0;0;.00nan;0;0
34167;206778;144;80;33;2;31;.939;3722000;0
34168;208575;142;92;40;2;38;.950;3600000;0
34168;204668;140;0;0;0;0;.00nan;0;0
34168;204881;140;42;35;5;30;.857;3600000;0
34168;217769;142;0;0;0;0;.00nan;0;0
34169;208609;131;0;0;0;0;.00nan;0;0
34169;206789;131;27;33;7;26;.788;3600000;0
34169;207313;132;0;0;0;0;.00nan;0;0
34169;-1;132;63;17;1;16;.941;3600000;0
34170;203276;139;54;34;5;29;.853;3550000;0
34170;205653;139;0;0;0;0;.00nan;0;0
34170;-1;128;0;0;0;0;.00nan;0;0
34170;-1;128;57;36;4;32;.889;3600000;0
34171;203288;135;0;0;0;0;.00nan;0;0
34171;208556;135;71;41;3;38;.927;3600000;0
34171;204779;136;0;0;0;0;.00nan;0;0
34171;-1;136;60;20;2;18;.900;3600000;0
34172;204873;129;0;0;0;0;.00nan;0;0
34172;209998;129;100;31;0;31;1.000;3600000;0
34172;207304;130;61;7;0;7;1.000;1077000;0
34172;-1;130;29;28;6;22;.786;2523000;0
34173;210060;137;0;0;0;0;.00nan;0;0
34173;210213;134;0;0;0;0;.00nan;0;0
34173;210876;134;83;27;1;26;.963;3600000;0
34173;-1;137;85;25;2;23;.920;3551000;0
34174;203276;139;38;30;5;25;.833;3600000;0
34174;204949;143;100;27;0;27;1.000;3600000;0
34174;205653;139;0;0;0;0;.00nan;0;0
34174;208201;143;0;0;0;0;.00nan;0;0
34175;204779;136;0;0;0;0;.00nan;0;0
34175;210060;137;0;0;0;0;.00nan;0;0
34175;-1;136;53;28;5;23;.821;3589000;0
34175;-1;137;62;33;4;29;.879;3600000;0
34176;203288;135;56;32;4;28;.875;3600000;0
34176;208556;135;0;0;0;0;.00nan;0;0
34176;210213;134;77;22;1;21;.955;3600000;0
34176;210876;134;0;0;0;0;.00nan;0;0
34177;204668;140;43;30;4;26;.867;3600000;0
34177;215128;141;0;0;0;0;.00nan;0;0
34177;204881;140;0;0;0;0;.00nan;0;0
34177;210004;141;32;25;5;20;.800;3569000;0
34178;204815;144;0;0;0;0;.00nan;0;0
34178;204873;129;29;30;7;23;.767;2572000;0
34178;209998;129;41;3;1;2;.667;1028000;0
34178;206778;144;75;32;2;30;.938;3600000;0
34179;203276;139;0;0;0;0;.00nan;0;0
34179;204668;140;69;23;2;21;.913;3600000;0
34179;204881;140;0;0;0;0;.00nan;0;0
34179;205653;139;61;40;5;35;.875;3600000;0
34180;219003;133;0;0;0;0;.00nan;0;0
34180;208575;142;55;5;0;5;1.000;649000;0
34180;217769;142;41;37;6;31;.838;2951000;0
34180;-1;133;77;19;1;18;.947;3600000;0
34181;215128;141;69;30;2;28;.933;3542000;0
34181;210004;141;0;0;0;0;.00nan;0;0
34181;204949;143;79;26;1;25;.962;3600000;0
34181;208201;143;0;0;0;0;.00nan;0;0
34182;204779;136;0;0;0;0;.00nan;0;0
34182;210213;134;52;34;5;29;.853;3863000;0
34182;210876;134;0;0;0;0;.00nan;0;0
34182;-1;136;63;30;4;26;.867;3863000;0
34183;208609;131;86;47;3;44;.936;3600000;0
34183;215217;1340;38;34;6;28;.824;3600000;0
34183;212019;1340;0;0;0;0;.00nan;0;0
34183;206789;131;0;0;0;0;.00nan;0;0
34184;220566;138;0;0;0;0;.00nan;0;0
34184;210060;137;53;37;5;32;.865;3900000;0
34184;223929;138;41;35;5;30;.857;3900000;0
34184;-1;137;0;0;0;0;.00nan;0;0
34185;204815;144;57;39;5;34;.872;3600000;0
34185;206778;144;0;0;0;0;.00nan;0;0
34185;207304;130;100;28;0;28;1.000;3600000;0
34185;-1;130;0;0;0;0;.00nan;0;0
34186;203288;135;70;45;4;41;.911;3896000;0
34186;208556;135;0;0;0;0;.00nan;0;0
34186;207313;132;0;0;0;0;.00nan;0;0
34186;-1;132;58;24;3;21;.875;3896000;0
34187;208575;142;65;42;4;38;.905;3568000;0
34187;204949;143;0;0;0;0;.00nan;0;0
34187;217769;142;0;0;0;0;.00nan;0;0
34187;208201;143;59;30;3;27;.900;3600000;0
34188;204779;136;0;0;0;0;.00nan;0;0
34188;210213;134;0;0;0;0;.00nan;0;0
34188;210876;134;63;34;4;30;.882;3651000;0
34188;-1;136;62;27;3;24;.889;3651000;0
34189;208609;131;0;0;0;0;.00nan;0;0
34189;206789;131;59;32;4;28;.875;3600000;0
34189;-1;128;48;41;6;35;.854;3600000;0
34189;-1;128;0;0;0;0;.00nan;0;0
34190;204815;144;0;0;0;0;.00nan;0;0
34190;206778;144;46;32;5;27;.844;3600000;0
34190;207313;132;75;26;1;25;.962;3600000;0
34190;-1;132;0;0;0;0;.00nan;0;0
34191;220566;138;54;24;3;21;.875;3600000;0
34191;210060;137;0;0;0;0;.00nan;0;0
34191;223929;138;0;0;0;0;.00nan;0;0
34191;-1;137;60;38;4;34;.895;3560000;0
34192;203288;135;0;0;0;0;.00nan;0;0
34192;208556;135;40;35;5;30;.857;3600000;0
34192;207304;130;64;16;1;15;.938;3600000;0
34192;-1;130;0;0;0;0;.00nan;0;0
34193;203276;139;30;30;6;24;.800;2725000;0
34193;219003;133;0;0;0;0;.00nan;0;0
34193;205653;139;34;5;2;3;.600;875000;0
34193;-1;133;96;30;1;29;.967;3600000;0
34194;204873;129;0;0;0;0;.00nan;0;0
34194;209998;129;59;19;2;17;.895;3600000;0
34194;215217;1340;0;0;0;0;.00nan;0;0
34194;212019;1340;40;23;4;19;.826;3514000;0
34195;219003;133;0;0;0;0;.00nan;0;0
34195;204668;140;50;14;2;12;.857;3600000;0
34195;204881;140;0;0;0;0;.00nan;0;0
34195;-1;133;65;30;3;27;.900;3587000;0
34196;204873;129;64;34;4;30;.882;3600000;0
34196;209998;129;0;0;0;0;.00nan;0;0
34196;-1;128;0;0;0;0;.00nan;0;0
34196;-1;128;27;26;6;20;.769;3579000;0
34197;208575;142;68;40;4;36;.900;3892000;0
34197;204949;143;53;34;4;30;.882;3900000;0
34197;217769;142;0;0;0;0;.00nan;0;0
34197;208201;143;0;0;0;0;.00nan;0;0
34198;208609;131;60;35;4;31;.886;3600000;0
34198;215128;141;0;0;0;0;.00nan;0;0
34198;210004;141;78;20;1;19;.950;3600000;0
34198;206789;131;0;0;0;0;.00nan;0;0
34199;203276;139;27;11;4;7;.636;900000;0
34199;205653;139;79;21;1;20;.952;2616000;0
34199;-1;128;82;35;3;32;.914;3600000;0
34199;-1;128;0;0;0;0;.00nan;0;0
34200;204779;136;0;0;0;0;.00nan;0;0
34200;220566;138;0;0;0;0;.00nan;0;0
34200;223929;138;35;26;5;21;.808;3600000;0
34200;-1;136;38;51;8;43;.843;3600000;0
34201;203288;135;99;54;2;52;.963;3600000;0
34201;208556;135;0;0;0;0;.00nan;0;0
34201;207313;132;0;0;0;0;.00nan;0;0
34201;-1;132;43;26;4;22;.846;3539000;0
34202;204815;144;0;0;0;0;.00nan;0;0
34202;206778;144;69;34;3;31;.912;3900000;0
34202;207304;130;84;46;3;43;.935;3900000;0
34202;-1;130;0;0;0;0;.00nan;0;0
34203;203276;139;49;37;6;31;.838;3637000;0
34203;215217;1340;37;22;5;17;.773;3659000;0
34203;205653;139;0;0;0;0;.00nan;0;0
34203;212019;1340;0;0;0;0;.00nan;0;0
34204;204949;143;65;31;2;29;.935;3566000;0
34204;210213;134;99;35;1;34;.971;3600000;0
34204;210876;134;0;0;0;0;.00nan;0;0
34204;208201;143;0;0;0;0;.00nan;0;0
34205;208575;142;39;38;6;32;.842;2454000;0
34205;204668;140;48;17;3;14;.824;3600000;0
34205;204881;140;0;0;0;0;.00nan;0;0
34205;217769;142;52;14;2;12;.857;1146000;0
34206;219003;133;22;27;6;21;.778;3121000;0
34206;220566;138;47;25;3;22;.880;3600000;0
34206;223929;138;0;0;0;0;.00nan;0;0
34206;-1;133;61;7;0;7;1.000;479000;0
34207;215128;141;0;0;0;0;.00nan;0;0
34207;210004;141;62;30;3;27;.900;3600000;0
34207;215217;1340;0;0;0;0;.00nan;0;0
34207;212019;1340;42;27;5;22;.815;3534000;0
34208;204873;129;0;0;0;0;.00nan;0;0
34208;209998;129;85;38;3;35;.921;3600000;0
34208;210060;137;30;34;7;27;.794;3600000;0
34208;-1;137;0;0;0;0;.00nan;0;0
34209;204779;136;0;0;0;0;.00nan;0;0
34209;207313;132;0;0;0;0;.00nan;0;0
34209;-1;132;54;26;4;22;.846;3811000;0
34209;-1;136;99;50;3;47;.940;3811000;0
34210;208575;142;0;0;0;0;.00nan;0;0
34210;204668;140;82;29;2;27;.931;3600000;0
34210;204881;140;0;0;0;0;.00nan;0;0
34210;217769;142;95;51;3;48;.941;3593000;0
34211;203288;135;39;35;6;29;.829;3533000;0
34211;208556;135;0;0;0;0;.00nan;0;0
34211;210060;137;0;0;0;0;.00nan;0;0
34211;-1;137;56;28;4;24;.857;3600000;0
34212;203276;139;63;27;3;24;.889;3571000;0
34212;208609;131;87;35;2;33;.943;3600000;0
34212;205653;139;0;0;0;0;.00nan;0;0
34212;206789;131;0;0;0;0;.00nan;0;0
34213;215128;141;0;0;0;0;.00nan;0;0
34213;210004;141;81;26;1;25;.962;3600000;0
34213;-1;128;0;0;0;0;.00nan;0;0
34213;-1;128;54;28;4;24;.857;3600000;0
34214;204779;136;49;35;5;30;.857;3600000;0
34214;207313;132;98;38;1;37;.974;3600000;0
34214;-1;132;0;0;0;0;.00nan;0;0
34214;-1;136;0;0;0;0;.00nan;0;0
34215;204873;129;36;25;5;20;.800;3600000;0
34215;209998;129;0;0;0;0;.00nan;0;0
34215;220566;138;0;0;0;0;.00nan;0;0
34215;223929;138;73;27;2;25;.926;3600000;0
34216;204949;143;0;0;0;0;.00nan;0;0
34216;207304;130;0;0;0;0;.00nan;0;0
34216;208201;143;71;49;5;44;.898;3600000;0
34216;-1;130;83;18;0;18;1.000;3600000;0
34217;204815;144;0;0;0;0;.00nan;0;0
34217;210213;134;72;21;1;20;.952;2511000;0
34217;210876;134;20;10;4;6;.600;1058000;0
34217;206778;144;60;25;3;22;.880;3600000;0
34218;204668;140;0;0;0;0;.00nan;0;0
34218;204881;140;84;29;1;28;.966;3600000;0
34218;207304;130;0;0;0;0;.00nan;0;0
34218;-1;130;79;31;2;29;.935;3552000;0
34219;203288;135;0;0;0;0;.00nan;0;0
34219;219003;133;44;3;1;2;.667;297000;0
34219;208556;135;57;45;5;40;.889;3600000;0
34219;-1;133;15;27;7;20;.741;3303000;0
34220;219003;133;0;0;0;0;.00nan;0;0
34220;215217;1340;51;41;5;36;.878;3600000;0
34220;212019;1340;0;0;0;0;.00nan;0;0
34220;-1;133;34;18;4;14;.778;3600000;0
34221;203288;135;44;34;6;28;.824;2378000;0
34221;208556;135;59;16;1;15;.938;1222000;0
34221;204779;136;0;0;0;0;.00nan;0;0
34221;-1;136;39;24;4;20;.833;3600000;0
34222;204873;129;0;0;0;0;.00nan;0;0
34222;209998;129;43;36;6;30;.833;3600000;0
34222;210213;134;0;0;0;0;.00nan;0;0
34222;210876;134;78;28;1;27;.964;3600000;0
34223;203276;139;0;0;0;0;.00nan;0;0
34223;215128;141;0;0;0;0;.00nan;0;0
34223;210004;141;68;41;4;37;.902;3900000;0
34223;205653;139;42;21;4;17;.810;3900000;0
34224;204815;144;65;20;2;18;.900;3600000;0
34224;220566;138;0;0;0;0;.00nan;0;0
34224;206778;144;0;0;0;0;.00nan;0;0
34224;223929;138;69;32;3;29;.906;3600000;0
34225;204668;140;69;24;2;22;.917;3600000;0
34225;204881;140;0;0;0;0;.00nan;0;0
34225;204949;143;43;29;5;24;.828;2189000;0
34225;208201;143;47;14;2;12;.857;1411000;0
34226;215217;1340;50;36;5;31;.861;3669000;0
34226;210213;134;69;31;4;27;.871;3669000;0
34226;210876;134;0;0;0;0;.00nan;0;0
34226;212019;1340;0;0;0;0;.00nan;0;0
34227;219003;133;0;0;0;0;.00nan;0;0
34227;208609;131;69;42;5;37;.881;3600000;0
34227;206789;131;0;0;0;0;.00nan;0;0
34227;-1;133;75;28;2;26;.929;3600000;0
34228;204779;136;0;0;0;0;.00nan;0;0
34228;204873;129;87;43;3;40;.930;3600000;0
34228;209998;129;0;0;0;0;.00nan;0;0
34228;-1;136;92;36;2;34;.944;3600000;0
34229;210060;137;64;33;4;29;.879;3573000;0
34229;207304;130;0;0;0;0;.00nan;0;0
34229;-1;137;0;0;0;0;.00nan;0;0
34229;-1;130;93;38;2;36;.947;3600000;0
34230;203288;135;72;26;2;24;.923;3600000;0
34230;208556;135;0;0;0;0;.00nan;0;0
34230;-1;128;0;0;0;0;.00nan;0;0
34230;-1;128;78;31;3;28;.903;3584000;0
34231;208575;142;65;24;2;22;.917;2111000;0
34231;207313;132;0;0;0;0;.00nan;0;0
34231;217769;142;16;23;6;17;.739;1489000;0
34231;-1;132;58;21;2;19;.905;3600000;0
34232;203288;135;0;0;0;0;.00nan;0;0
34232;208556;135;62;33;4;29;.879;3552000;0
34232;-1;128;67;22;2;20;.909;3600000;0
34232;-1;128;0;0;0;0;.00nan;0;0
34233;215217;1340;0;0;0;0;.00nan;0;0
34233;210213;134;37;33;7;26;.788;3600000;0
34233;210876;134;0;0;0;0;.00nan;0;0
34233;212019;1340;57;28;3;25;.893;3600000;0
34234;219003;133;50;14;2;12;.857;3600000;0
34234;208609;131;66;6;0;6;1.000;598000;0
34234;206789;131;34;38;6;32;.842;3002000;0
34234;-1;133;0;0;0;0;.00nan;0;0
34235;208575;142;0;0;0;0;.00nan;0;0
34235;210060;137;0;0;0;0;.00nan;0;0
34235;217769;142;45;26;4;22;.846;3570000;0
34235;-1;137;49;19;3;16;.842;3600000;0
34236;204873;129;74;31;2;29;.935;3600000;0
34236;209998;129;0;0;0;0;.00nan;0;0
34236;207313;132;0;0;0;0;.00nan;0;0
34236;-1;132;42;25;4;21;.840;3513000;0
34237;220566;138;63;16;1;15;.938;3600000;0
34237;204949;143;30;37;7;30;.811;2465000;0
34237;223929;138;0;0;0;0;.00nan;0;0
34237;208201;143;69;16;0;16;1.000;1135000;0
34238;204815;144;0;0;0;0;.00nan;0;0
34238;204949;143;0;0;0;0;.00nan;0;0
34238;206778;144;52;19;2;17;.895;3600000;0
34238;208201;143;91;55;3;52;.945;3600000;0
34239;204668;140;64;32;3;29;.906;3600000;0
34239;215128;141;0;0;0;0;.00nan;0;0
34239;204881;140;0;0;0;0;.00nan;0;0
34239;210004;141;83;44;4;40;.909;3600000;0
34240;208609;131;44;26;4;22;.846;3600000;0
34240;206789;131;0;0;0;0;.00nan;0;0
34240;207313;132;100;25;0;25;1.000;3600000;0
34240;-1;132;0;0;0;0;.00nan;0;0
34241;208575;142;39;35;6;29;.829;2496000;0
34241;207304;130;46;24;4;20;.833;3600000;0
34241;217769;142;50;8;1;7;.875;1104000;0
34241;-1;130;0;0;0;0;.00nan;0;0
34242;203276;139;47;31;5;26;.839;3551000;0
34242;220566;138;0;0;0;0;.00nan;0;0
34242;205653;139;0;0;0;0;.00nan;0;0
34242;223929;138;61;36;4;32;.889;3600000;0
34243;204779;136;0;0;0;0;.00nan;0;0
34243;-1;128;0;0;0;0;.00nan;0;0
34243;-1;128;70;31;3;28;.903;3758000;0
34243;-1;136;57;35;4;31;.886;3758000;0
34244;204668;140;87;39;2;37;.949;3600000;0
34244;204815;144;55;30;4;26;.867;3552000;0
34244;204881;140;0;0;0;0;.00nan;0;0
34244;206778;144;0;0;0;0;.00nan;0;0
34245;204815;144;60;9;0;9;1.000;991000;0
34245;215128;141;0;0;0;0;.00nan;0;0
34245;210004;141;81;28;1;27;.964;3600000;0
34245;206778;144;36;36;6;30;.833;2609000;0
34246;203276;139;55;29;4;25;.862;3608000;0
34246;208575;142;0;0;0;0;.00nan;0;0
34246;205653;139;0;0;0;0;.00nan;0;0
34246;217769;142;68;33;3;30;.909;3608000;0
34247;204668;140;67;27;2;25;.926;3600000;0
34247;204779;136;38;7;2;5;.714;399000;0
34247;204881;140;0;0;0;0;.00nan;0;0
34247;-1;136;35;36;6;30;.833;3201000;0
34248;210213;134;0;0;0;0;.00nan;0;0
34248;210876;134;56;36;5;31;.861;3600000;0
34248;207304;130;0;0;0;0;.00nan;0;0
34248;-1;130;61;18;2;16;.889;3600000;0
34249;203288;135;98;44;2;42;.955;3600000;0
34249;208556;135;0;0;0;0;.00nan;0;0
34249;208609;131;0;0;0;0;.00nan;0;0
34249;206789;131;73;40;4;36;.900;3600000;0
34250;215128;141;0;0;0;0;.00nan;0;0
34250;210004;141;80;42;4;38;.905;3900000;0
34250;204949;143;47;30;4;26;.867;3900000;0
34250;208201;143;0;0;0;0;.00nan;0;0
34251;219003;133;0;0;0;0;.00nan;0;0
34251;207304;130;82;23;1;22;.957;3600000;0
34251;-1;133;59;40;5;35;.875;3600000;0
34251;-1;130;0;0;0;0;.00nan;0;0
34252;204873;129;0;0;0;0;.00nan;0;0
34252;209998;129;61;35;4;31;.886;3587000;0
34252;215217;1340;72;31;3;28;.903;3600000;0
34252;212019;1340;0;0;0;0;.00nan;0;0
34253;207313;132;31;26;5;21;.808;3600000;0
34253;-1;128;0;0;0;0;.00nan;0;0
34253;-1;132;0;0;0;0;.00nan;0;0
34253;-1;128;90;33;1;32;.970;3600000;0
34254;220566;138;0;0;0;0;.00nan;0;0
34254;210060;137;55;38;4;34;.895;3777000;0
34254;223929;138;62;33;3;30;.909;3777000;0
34254;-1;137;0;0;0;0;.00nan;0;0
34255;203288;135;58;7;0;7;1.000;346000;0
34255;208556;135;55;29;4;25;.862;3254000;0
34255;204668;140;76;22;1;21;.955;3600000;0
34255;204881;140;0;0;0;0;.00nan;0;0
34256;208609;131;77;29;2;27;.931;3600000;0
34256;204779;136;69;8;0;8;1.000;1118000;0
34256;206789;131;0;0;0;0;.00nan;0;0
34256;-1;136;27;23;6;17;.739;2482000;0
34257;204873;129;92;45;3;42;.933;3900000;0
34257;209998;129;0;0;0;0;.00nan;0;0
34257;-1;128;66;31;3;28;.903;3900000;0
34257;-1;128;0;0;0;0;.00nan;0;0
34258;220566;138;69;34;3;31;.912;3577000;0
34258;210060;137;80;34;2;32;.941;3600000;0
34258;223929;138;0;0;0;0;.00nan;0;0
34258;-1;137;0;0;0;0;.00nan;0;0
34259;219003;133;85;35;2;33;.943;3600000;0
34259;207304;130;0;0;0;0;.00nan;0;0
34259;-1;133;0;0;0;0;.00nan;0;0
34259;-1;130;62;32;3;29;.906;3600000;0
34260;208575;142;45;5;1;4;.800;581000;0
34260;204949;143;0;0;0;0;.00nan;0;0
34260;217769;142;31;26;6;20;.769;2980000;0
34260;208201;143;32;32;6;26;.813;3600000;0
34261;203276;139;49;31;5;26;.839;3544000;0
34261;204815;144;0;0;0;0;.00nan;0;0
34261;205653;139;0;0;0;0;.00nan;0;0
34261;206778;144;68;32;3;29;.906;3600000;0
34262;204815;144;44;28;5;23;.821;3600000;0
34262;215128;141;22;5;3;2;.400;1208000;0
34262;210004;141;38;18;4;14;.778;2342000;0
34262;206778;144;0;0;0;0;.00nan;0;0
34263;204668;140;78;22;1;21;.955;3600000;0
34263;204881;140;0;0;0;0;.00nan;0;0
34263;210213;134;73;35;3;32;.914;3563000;0
34263;210876;134;0;0;0;0;.00nan;0;0
34264;208609;131;0;0;0;0;.00nan;0;0
34264;204779;136;64;31;2;29;.935;3900000;0
34264;206789;131;82;30;2;28;.933;3900000;0
34264;-1;136;0;0;0;0;.00nan;0;0
34265;215217;1340;100;33;1;32;.970;3900000;0
34265;212019;1340;0;0;0;0;.00nan;0;0
34265;207313;132;0;0;0;0;.00nan;0;0
34265;-1;132;76;29;1;28;.966;3900000;0
34266;219003;133;0;0;0;0;.00nan;0;0
34266;204873;129;37;34;6;28;.824;3600000;0
34266;209998;129;0;0;0;0;.00nan;0;0
34266;-1;133;79;42;4;38;.905;3600000;0
34267;204779;136;0;0;0;0;.00nan;0;0
34267;215128;141;0;0;0;0;.00nan;0;0
34267;210004;141;77;40;5;35;.875;3600000;0
34267;-1;136;37;33;6;27;.818;3566000;0
34268;210213;134;49;2;0;2;1.000;317000;0
34268;210876;134;26;27;6;21;.778;3271000;0
34268;-1;128;0;0;0;0;.00nan;0;0
34268;-1;128;63;35;4;31;.886;3600000;0
34269;203276;139;73;35;4;31;.886;3600000;0
34269;215128;141;0;0;0;0;.00nan;0;0
34269;210004;141;51;37;5;32;.865;3551000;0
34269;205653;139;0;0;0;0;.00nan;0;0
34270;204779;136;61;40;5;35;.875;3557000;0
34270;204949;143;0;0;0;0;.00nan;0;0
34270;208201;143;52;31;4;27;.871;3600000;0
34270;-1;136;0;0;0;0;.00nan;0;0
34271;203288;135;61;39;4;35;.897;3806000;0
34271;219003;133;0;0;0;0;.00nan;0;0
34271;208556;135;0;0;0;0;.00nan;0;0
34271;-1;133;53;34;5;29;.853;3849000;0
34272;208609;131;56;31;5;26;.839;3600000;0
34272;206789;131;0;0;0;0;.00nan;0;0
34272;207304;130;82;30;1;29;.967;3600000;0
34272;-1;130;0;0;0;0;.00nan;0;0
34273;204873;129;0;0;0;0;.00nan;0;0
34273;209998;129;32;33;6;27;.818;3600000;0
34273;207313;132;0;0;0;0;.00nan;0;0
34273;-1;132;69;20;1;19;.950;3600000;0
34274;203276;139;0;0;0;0;.00nan;0;0
34274;215217;1340;56;34;5;29;.853;3600000;0
34274;205653;139;39;36;6;30;.833;3568000;0
34274;212019;1340;0;0;0;0;.00nan;0;0
34275;208575;142;45;23;3;20;.870;3583000;0
34275;217769;142;0;0;0;0;.00nan;0;0
34275;-1;128;0;0;0;0;.00nan;0;0
34275;-1;128;78;32;2;30;.938;3600000;0
34276;204815;144;0;0;0;0;.00nan;0;0
34276;204949;143;0;0;0;0;.00nan;0;0
34276;206778;144;44;17;3;14;.824;3574000;0
34276;208201;143;92;37;1;36;.973;3600000;0
34277;208609;131;0;0;0;0;.00nan;0;0
34277;210060;137;85;30;1;29;.967;3600000;0
34277;206789;131;77;38;3;35;.921;3580000;0
34277;-1;137;0;0;0;0;.00nan;0;0
34278;220566;138;0;0;0;0;.00nan;0;0
34278;210213;134;45;43;7;36;.837;3327000;0
34278;210876;134;54;6;0;6;1.000;273000;0
34278;223929;138;45;18;3;15;.833;3600000;0
34279;203288;135;0;0;0;0;.00nan;0;0
34279;208556;135;91;44;3;41;.932;3600000;0
34279;207313;132;75;29;2;27;.931;3600000;0
34279;-1;132;0;0;0;0;.00nan;0;0
34280;210060;137;0;0;0;0;.00nan;0;0
34280;207304;130;46;38;5;33;.868;2186000;0
34280;-1;137;50;21;3;18;.857;3600000;0
34280;-1;130;71;13;0;13;1.000;1330000;0
34281;204779;136;0;0;0;0;.00nan;0;0
34281;204815;144;68;29;3;26;.897;3600000;0
34281;206778;144;0;0;0;0;.00nan;0;0
34281;-1;136;64;50;5;45;.900;3576000;0
34282;215128;141;0;0;0;0;.00nan;0;0
34282;210004;141;71;19;1;18;.947;3600000;0
34282;-1;128;0;0;0;0;.00nan;0;0
34282;-1;128;35;39;6;33;.846;3600000;0
34283;204668;140;95;24;0;24;1.000;3600000;0
34283;204881;140;0;0;0;0;.00nan;0;0
34283;215217;1340;81;38;2;36;.947;3295000;0
34283;212019;1340;30;7;3;4;.571;305000;0
34284;208575;142;0;0;0;0;.00nan;0;0
34284;215217;1340;0;0;0;0;.00nan;0;0
34284;212019;1340;47;24;4;20;.833;3596000;0
34284;217769;142;64;25;2;23;.920;3600000;0
34285;204668;140;62;27;3;24;.889;3543000;0
34285;204881;140;0;0;0;0;.00nan;0;0
34285;-1;128;0;0;0;0;.00nan;0;0
34285;-1;128;73;32;2;30;.938;3600000;0
34286;207304;130;68;24;2;22;.917;2453000;0
34286;207313;132;0;0;0;0;.00nan;0;0
34286;-1;132;75;43;4;39;.907;3600000;0
34286;-1;130;38;21;4;17;.810;1147000;0
34287;203276;139;71;42;5;37;.881;3587000;0
34287;204949;143;89;23;0;23;1.000;2689000;0
34287;205653;139;0;0;0;0;.00nan;0;0
34287;208201;143;19;9;4;5;.556;911000;0
34288;203288;135;54;25;3;22;.880;3642000;0
34288;208556;135;0;0;0;0;.00nan;0;0
34288;210213;134;0;0;0;0;.00nan;0;0
34288;210876;134;79;37;4;33;.892;3642000;0
34289;204873;129;27;36;7;29;.806;3600000;0
34289;209998;129;0;0;0;0;.00nan;0;0
34289;220566;138;0;0;0;0;.00nan;0;0
34289;223929;138;66;30;3;27;.900;3600000;0
34290;219003;133;33;4;2;2;.500;832000;0
34290;210060;137;62;26;2;24;.923;3600000;0
34290;-1;133;40;44;7;37;.841;2768000;0
34290;-1;137;0;0;0;0;.00nan;0;0
34291;208575;142;100;26;0;26;1.000;3600000;0
34291;204815;144;0;0;0;0;.00nan;0;0
34291;206778;144;79;32;2;30;.938;3515000;0
34291;217769;142;0;0;0;0;.00nan;0;0
34292;203288;135;44;23;4;19;.826;2165000;0
34292;208556;135;48;20;3;17;.850;1435000;0
34292;210213;134;63;37;4;33;.892;3600000;0
34292;210876;134;0;0;0;0;.00nan;0;0
34293;204949;143;41;2;1;1;.500;630000;0
34293;207313;132;69;18;1;17;.944;3600000;0
34293;208201;143;41;33;6;27;.818;2970000;0
34293;-1;132;0;0;0;0;.00nan;0;0
34294;203276;139;0;0;0;0;.00nan;0;0
34294;204668;140;78;30;2;28;.933;3600000;0
34294;204881;140;0;0;0;0;.00nan;0;0
34294;205653;139;59;28;3;25;.893;3575000;0
34295;220566;138;0;0;0;0;.00nan;0;0
34295;210060;137;0;0;0;0;.00nan;0;0
34295;223929;138;60;27;3;24;.889;3600000;0
34295;-1;137;33;24;5;19;.792;3560000;0
34296;208609;131;57;42;5;37;.881;3524000;0
34296;204873;129;0;0;0;0;.00nan;0;0
34296;209998;129;54;19;3;16;.842;3600000;0
34296;206789;131;0;0;0;0;.00nan;0;0
34297;215128;141;0;0;0;0;.00nan;0;0
34297;210004;141;98;33;1;32;.970;3600000;0
34297;207304;130;47;24;4;20;.833;3600000;0
34297;-1;130;0;0;0;0;.00nan;0;0
34298;203288;135;47;33;5;28;.848;3600000;0
34298;208556;135;0;0;0;0;.00nan;0;0
34298;208575;142;83;37;2;35;.946;3600000;0
34298;217769;142;0;0;0;0;.00nan;0;0
34299;204779;136;0;0;0;0;.00nan;0;0
34299;207313;132;0;0;0;0;.00nan;0;0
34299;-1;132;32;47;7;40;.851;3600000;0
34299;-1;136;60;26;4;22;.846;3600000;0
34300;208609;131;0;0;0;0;.00nan;0;0
34300;210213;134;0;0;0;0;.00nan;0;0
34300;210876;134;37;21;4;17;.810;3600000;0
34300;206789;131;59;45;5;40;.889;3544000;0
34301;204949;143;0;0;0;0;.00nan;0;0
34301;208201;143;58;32;3;29;.906;3900000;0
34301;-1;128;0;0;0;0;.00nan;0;0
34301;-1;128;62;23;3;20;.870;3900000;0
34302;215128;141;47;40;6;34;.850;3600000;0
34302;210004;141;0;0;0;0;.00nan;0;0
34302;220566;138;68;26;2;24;.923;3600000;0
34302;223929;138;0;0;0;0;.00nan;0;0
34303;204873;129;46;34;5;29;.853;3600000;0
34303;209998;129;0;0;0;0;.00nan;0;0
34303;207304;130;0;0;0;0;.00nan;0;0
34303;-1;130;65;32;4;28;.875;3600000;0
34304;219003;133;31;11;3;8;.727;353000;0
34304;215128;141;0;0;0;0;.00nan;0;0
34304;210004;141;78;42;3;39;.929;3600000;0
34304;-1;133;49;20;3;17;.850;3247000;0
34305;204779;136;41;22;4;18;.818;941000;0
34305;207313;132;46;34;5;29;.853;3600000;0
34305;-1;132;0;0;0;0;.00nan;0;0
34305;-1;136;40;29;5;24;.828;2659000;0
34306;208609;131;88;44;4;40;.909;3583000;0
34306;210213;134;70;32;3;29;.906;3600000;0
34306;210876;134;0;0;0;0;.00nan;0;0
34306;206789;131;0;0;0;0;.00nan;0;0
34307;210060;137;44;26;4;22;.846;3600000;0
34307;-1;128;91;35;1;34;.971;3600000;0
34307;-1;128;0;0;0;0;.00nan;0;0
34307;-1;137;0;0;0;0;.00nan;0;0
34308;220566;138;0;0;0;0;.00nan;0;0
34308;207304;130;91;48;4;44;.917;3900000;0
34308;223929;138;39;26;4;22;.846;3900000;0
34308;-1;130;0;0;0;0;.00nan;0;0
34309;203276;139;62;22;2;20;.909;3600000;0
34309;203288;135;0;0;0;0;.00nan;0;0
34309;208556;135;59;39;5;34;.872;3600000;0
34309;205653;139;0;0;0;0;.00nan;0;0
34310;204668;140;54;28;4;24;.857;3587000;0
34310;204815;144;0;0;0;0;.00nan;0;0
34310;204881;140;0;0;0;0;.00nan;0;0
34310;206778;144;63;27;3;24;.889;3600000;0
34311;215217;1340;62;29;4;25;.862;3600000;0
34311;204949;143;59;15;1;14;.933;781000;0
34311;212019;1340;0;0;0;0;.00nan;0;0
34311;208201;143;25;28;6;22;.786;2819000;0
34312;208575;142;0;0;0;0;.00nan;0;0
34312;204815;144;56;17;2;15;.882;3698000;0
34312;206778;144;0;0;0;0;.00nan;0;0
34312;217769;142;92;50;3;47;.940;3698000;0
34313;203288;135;64;31;3;28;.903;3600000;0
34313;208556;135;0;0;0;0;.00nan;0;0
34313;204668;140;0;0;0;0;.00nan;0;0
34313;204881;140;60;28;4;24;.857;3582000;0
34314;215217;1340;0;0;0;0;.00nan;0;0
34314;210060;137;0;0;0;0;.00nan;0;0
34314;212019;1340;76;41;4;37;.902;3600000;0
34314;-1;137;47;34;5;29;.853;3552000;0
34315;219003;133;46;24;4;20;.833;3600000;0
34315;204873;129;0;0;0;0;.00nan;0;0
34315;209998;129;49;42;6;36;.857;3592000;0
34315;-1;133;0;0;0;0;.00nan;0;0
34316;204815;144;0;0;0;0;.00nan;0;0
34316;215128;141;0;0;0;0;.00nan;0;0
34316;210004;141;89;40;2;38;.950;3600000;0
34316;206778;144;32;28;5;23;.821;3600000;0
34317;204668;140;69;18;1;17;.944;3600000;0
34317;204873;129;0;0;0;0;.00nan;0;0
34317;204881;140;0;0;0;0;.00nan;0;0
34317;209998;129;63;33;3;30;.909;3574000;0
34318;219003;133;0;0;0;0;.00nan;0;0
34318;208575;142;44;6;1;5;.833;489000;0
34318;217769;142;22;35;7;28;.800;3111000;0
34318;-1;133;63;30;3;27;.900;3600000;0
34319;210060;137;0;0;0;0;.00nan;0;0
34319;-1;128;0;0;0;0;.00nan;0;0
34319;-1;128;70;31;3;28;.903;3600000;0
34319;-1;137;55;39;5;34;.872;3574000;0
34320;204873;129;78;27;1;26;.963;3600000;0
34320;209998;129;0;0;0;0;.00nan;0;0
34320;204949;143;0;0;0;0;.00nan;0;0
34320;208201;143;64;34;4;30;.882;3600000;0
34321;208609;131;55;53;7;46;.868;3600000;0
34321;215128;141;0;0;0;0;.00nan;0;0
34321;210004;141;80;27;1;26;.963;3600000;0
34321;206789;131;0;0;0;0;.00nan;0;0
34322;220566;138;0;0;0;0;.00nan;0;0
34322;210213;134;0;0;0;0;.00nan;0;0
34322;210876;134;88;42;3;39;.929;3592000;0
34322;223929;138;73;27;2;25;.926;3600000;0
34323;203276;139;71;29;2;27;.931;3600000;0
34323;205653;139;0;0;0;0;.00nan;0;0
34323;207304;130;0;0;0;0;.00nan;0;0
34323;-1;130;45;33;5;28;.848;3600000;0
34324;208609;131;0;0;0;0;.00nan;0;0
34324;204949;143;0;0;0;0;.00nan;0;0
34324;206789;131;67;16;1;15;.938;3600000;0
34324;208201;143;74;39;4;35;.897;3600000;0
34325;204668;140;13;30;8;22;.733;3819000;0
34325;215128;141;25;37;7;30;.811;3843000;0
34325;204881;140;0;0;0;0;.00nan;0;0
34325;210004;141;0;0;0;0;.00nan;0;0
34326;203276;139;0;0;0;0;.00nan;0;0
34326;219003;133;45;29;4;25;.862;3589000;0
34326;205653;139;79;36;3;33;.917;3600000;0
34326;-1;133;0;0;0;0;.00nan;0;0
34327;208575;142;22;24;6;18;.750;2497000;0
34327;204779;136;0;0;0;0;.00nan;0;0
34327;217769;142;66;18;1;17;.944;1103000;0
34327;-1;136;50;20;3;17;.850;3600000;0
34328;207304;130;82;28;1;27;.964;3748000;0
34328;-1;128;0;0;0;0;.00nan;0;0
34328;-1;128;81;35;2;33;.943;3748000;0
34328;-1;130;0;0;0;0;.00nan;0;0
34329;215217;1340;72;28;2;26;.929;3586000;0
34329;212019;1340;0;0;0;0;.00nan;0;0
34329;207313;132;65;17;1;16;.941;3600000;0
34329;-1;132;0;0;0;0;.00nan;0;0
34330;203288;135;27;13;4;9;.692;2309000;0
34330;208556;135;30;14;4;10;.714;1291000;0
34330;208575;142;0;0;0;0;.00nan;0;0
34330;217769;142;59;38;5;33;.868;3600000;0
34331;219003;133;0;0;0;0;.00nan;0;0
34331;210213;134;68;43;5;38;.884;3829000;0
34331;210876;134;0;0;0;0;.00nan;0;0
34331;-1;133;55;31;4;27;.871;3829000;0
34332;207313;132;0;0;0;0;.00nan;0;0
34332;-1;128;67;36;3;33;.917;3564000;0
34332;-1;132;74;26;2;24;.923;3600000;0
34332;-1;128;0;0;0;0;.00nan;0;0
34333;203276;139;51;30;3;27;.900;3600000;0
34333;220566;138;0;0;0;0;.00nan;0;0
34333;205653;139;0;0;0;0;.00nan;0;0
34333;223929;138;94;45;2;43;.956;3600000;0
34334;215217;1340;0;0;0;0;.00nan;0;0
34334;210060;137;58;13;1;12;.923;3600000;0
34334;212019;1340;76;31;2;29;.935;3561000;0
34334;-1;137;0;0;0;0;.00nan;0;0
34335;204815;144;71;26;1;25;.962;3600000;0
34335;204873;129;0;0;0;0;.00nan;0;0
34335;209998;129;77;50;5;45;.900;3600000;0
34335;206778;144;0;0;0;0;.00nan;0;0
34336;204668;140;62;31;3;28;.903;3600000;0
34336;204881;140;0;0;0;0;.00nan;0;0
34336;204949;143;55;35;4;31;.886;3600000;0
34336;208201;143;0;0;0;0;.00nan;0;0
34337;208609;131;89;32;1;31;.969;3600000;0
34337;204815;144;0;0;0;0;.00nan;0;0
34337;206778;144;33;15;4;11;.733;3600000;0
34337;206789;131;0;0;0;0;.00nan;0;0
34338;210060;137;48;6;1;5;.833;469000;0
34338;207304;130;45;33;5;28;.848;3600000;0
34338;-1;137;28;31;6;25;.806;3090000;0
34338;-1;130;0;0;0;0;.00nan;0;0
34339;203288;135;66;33;4;29;.879;3722000;0
34339;208556;135;0;0;0;0;.00nan;0;0
34339;204779;136;0;0;0;0;.00nan;0;0
34339;-1;136;55;37;5;32;.865;3722000;0
34340;220566;138;54;31;4;27;.871;3600000;0
34340;215217;1340;19;22;6;16;.727;1807000;0
34340;212019;1340;53;17;2;15;.882;1793000;0
34340;223929;138;0;0;0;0;.00nan;0;0
34341;208575;142;97;38;1;37;.974;3584000;0
34341;204949;143;0;0;0;0;.00nan;0;0
34341;217769;142;0;0;0;0;.00nan;0;0
34341;208201;143;87;16;0;16;1.000;3600000;0
34342;215217;1340;37;19;4;15;.789;3600000;0
34342;212019;1340;0;0;0;0;.00nan;0;0
34342;-1;128;0;0;0;0;.00nan;0;0
34342;-1;128;100;28;0;28;1.000;3600000;0
34343;220566;138;0;0;0;0;.00nan;0;0
34343;210213;134;0;0;0;0;.00nan;0;0
34343;210876;134;57;46;6;40;.870;3600000;0
34343;223929;138;35;18;4;14;.778;3600000;0
34344;203288;135;35;36;6;30;.833;3049000;0
34344;219003;133;0;0;0;0;.00nan;0;0
34344;208556;135;40;2;1;1;.500;551000;0
34344;-1;133;48;23;4;19;.826;3600000;0
34345;203276;139;63;30;3;27;.900;3600000;0
34345;208575;142;44;33;5;28;.848;3219000;0
34345;205653;139;0;0;0;0;.00nan;0;0
34345;217769;142;25;5;3;2;.400;381000;0
34346;204668;140;86;31;1;30;.968;3600000;0
34346;204881;140;0;0;0;0;.00nan;0;0
34346;204949;143;0;0;0;0;.00nan;0;0
34346;208201;143;54;30;3;27;.900;3585000;0
34347;204815;144;0;0;0;0;.00nan;0;0
34347;215128;141;0;0;0;0;.00nan;0;0
34347;210004;141;72;32;2;30;.938;3600000;0
34347;206778;144;63;30;3;27;.900;3549000;0
34348;219003;133;61;23;2;21;.913;3600000;0
34348;204779;136;0;0;0;0;.00nan;0;0
34348;-1;133;0;0;0;0;.00nan;0;0
34348;-1;136;57;29;3;26;.897;3565000;0
34349;215217;1340;50;39;5;34;.872;3553000;0
34349;212019;1340;0;0;0;0;.00nan;0;0
34349;207304;130;0;0;0;0;.00nan;0;0
34349;-1;130;59;29;3;26;.897;3600000;0
34350;203288;135;61;34;4;30;.882;3900000;0
34350;208556;135;0;0;0;0;.00nan;0;0
34350;208609;131;65;36;4;32;.889;3900000;0
34350;206789;131;0;0;0;0;.00nan;0;0
34351;207313;132;64;26;3;23;.885;3550000;0
34351;-1;128;0;0;0;0;.00nan;0;0
34351;-1;132;0;0;0;0;.00nan;0;0
34351;-1;128;91;40;2;38;.950;3600000;0
34352;204873;129;60;32;4;28;.875;3600000;0
34352;209998;129;0;0;0;0;.00nan;0;0
34352;210213;134;100;28;0;28;1.000;3600000;0
34352;210876;134;0;0;0;0;.00nan;0;0
34353;220566;138;55;5;0;5;1.000;1213000;0
34353;210060;137;59;31;4;27;.871;3600000;0
34353;223929;138;43;34;6;28;.824;2387000;0
34353;-1;137;0;0;0;0;.00nan;0;0
34354;219003;133;0;0;0;0;.00nan;0;0
34354;204779;136;40;31;6;25;.806;3600000;0
34354;-1;133;89;43;3;40;.930;3600000;0
34354;-1;136;0;0;0;0;.00nan;0;0
34355;208609;131;76;24;2;22;.917;2539000;0
34355;220566;138;22;17;5;12;.706;2368000;0
34355;206789;131;31;14;4;10;.714;1061000;0
34355;223929;138;40;8;2;6;.750;1196000;0
34356;207304;130;92;31;1;30;.968;3600000;0
34356;-1;128;31;39;7;32;.821;2902000;0
34356;-1;128;46;7;1;6;.857;698000;0
34356;-1;130;0;0;0;0;.00nan;0;0
34357;203288;135;0;0;0;0;.00nan;0;0
34357;208556;135;41;28;5;23;.821;3563000;0
34357;204873;129;0;0;0;0;.00nan;0;0
34357;209998;129;53;28;4;24;.857;3600000;0
34358;210060;137;0;0;0;0;.00nan;0;0
34358;210213;134;51;33;4;29;.879;3544000;0
34358;210876;134;0;0;0;0;.00nan;0;0
34358;-1;137;63;30;3;27;.900;3600000;0
34359;203276;139;0;0;0;0;.00nan;0;0
34359;204815;144;39;34;6;28;.824;3829000;0
34359;205653;139;49;33;5;28;.848;3829000;0
34359;206778;144;0;0;0;0;.00nan;0;0
34360;208575;142;0;0;0;0;.00nan;0;0
34360;215128;141;63;17;1;16;.941;3600000;0
34360;210004;141;0;0;0;0;.00nan;0;0
34360;217769;142;82;46;3;43;.935;3562000;0
34361;204668;140;56;11;2;9;.818;3600000;0
34361;204881;140;0;0;0;0;.00nan;0;0
34361;204949;143;89;57;4;53;.930;3600000;0
34361;208201;143;0;0;0;0;.00nan;0;0
34362;215217;1340;0;0;0;0;.00nan;0;0
34362;212019;1340;55;31;4;27;.871;3534000;0
34362;207313;132;0;0;0;0;.00nan;0;0
34362;-1;132;87;33;2;31;.939;3600000;0
34363;203276;139;49;35;5;30;.857;3570000;0
34363;208575;142;0;0;0;0;.00nan;0;0
34363;205653;139;0;0;0;0;.00nan;0;0
34363;217769;142;79;33;3;30;.909;3600000;0
34364;204668;140;29;18;4;14;.778;3568000;0
34364;204815;144;0;0;0;0;.00nan;0;0
34364;204881;140;0;0;0;0;.00nan;0;0
34364;206778;144;99;37;1;36;.973;3600000;0
34365;215128;141;77;28;2;26;.929;3600000;0
34365;204949;143;59;41;5;36;.878;3600000;0
34365;208201;143;0;0;0;0;.00nan;0;0
34365;-1;141;0;0;0;0;.00nan;0;0
34366;219003;133;0;0;0;0;.00nan;0;0
34366;207304;130;0;0;0;0;.00nan;0;0
34366;-1;133;57;20;2;18;.900;3600000;0
34366;-1;130;67;46;5;41;.891;3600000;0
34367;210060;137;78;25;1;24;.960;3600000;0
34367;210213;134;0;0;0;0;.00nan;0;0
34367;210876;134;91;46;3;43;.935;3580000;0
34367;-1;137;0;0;0;0;.00nan;0;0
34368;208609;131;37;26;5;21;.808;3900000;0
34368;215217;1340;82;52;5;47;.904;3900000;0
34368;212019;1340;0;0;0;0;.00nan;0;0
34368;206789;131;0;0;0;0;.00nan;0;0
34369;204779;136;46;6;1;5;.833;400000;0
34369;220566;138;0;0;0;0;.00nan;0;0
34369;223929;138;90;39;3;36;.923;3600000;0
34369;-1;136;18;27;7;20;.741;3200000;0
34370;203288;135;69;37;4;33;.892;3600000;0
34370;208556;135;0;0;0;0;.00nan;0;0
34370;204873;129;84;23;1;22;.957;3600000;0
34370;209998;129;0;0;0;0;.00nan;0;0
34371;208575;142;42;40;6;34;.850;3287000;0
34371;215128;141;0;0;0;0;.00nan;0;0
34371;217769;142;40;2;1;1;.500;313000;0
34371;-1;141;70;21;1;20;.952;3600000;0
34372;208609;131;0;0;0;0;.00nan;0;0
34372;220566;138;70;29;2;27;.931;3600000;0
34372;206789;131;79;43;4;39;.907;3535000;0
34372;223929;138;0;0;0;0;.00nan;0;0
34373;204815;144;74;39;3;36;.923;3600000;0
34373;204949;143;100;26;0;26;1.000;3600000;0
34373;206778;144;0;0;0;0;.00nan;0;0
34373;208201;143;0;0;0;0;.00nan;0;0
34374;203288;135;56;53;7;46;.868;3600000;0
34374;208556;135;0;0;0;0;.00nan;0;0
34374;204779;136;0;0;0;0;.00nan;0;0
34374;-1;136;76;23;2;21;.913;3600000;0
34375;219003;133;0;0;0;0;.00nan;0;0
34375;210213;134;88;39;2;37;.949;3600000;0
34375;210876;134;0;0;0;0;.00nan;0;0
34375;-1;133;69;28;3;25;.893;3557000;0
34376;215217;1340;50;39;6;33;.846;3709000;0
34376;212019;1340;0;0;0;0;.00nan;0;0
34376;-1;128;63;14;1;13;.929;1235000;0
34376;-1;128;23;27;6;21;.778;2474000;0
34377;204873;129;75;24;1;23;.958;1749000;0
34377;209998;129;24;23;6;17;.739;1833000;0
34377;207313;132;39;34;6;28;.824;3284000;0
34377;-1;132;50;0;0;0;.00nan;316000;0
34378;210060;137;0;0;0;0;.00nan;0;0
34378;207304;130;27;36;7;29;.806;3600000;0
34378;-1;137;74;33;3;30;.909;3600000;0
34378;-1;130;0;0;0;0;.00nan;0;0
34379;203276;139;58;13;1;12;.923;3600000;0
34379;204668;140;71;43;5;38;.884;3600000;0
34379;204881;140;0;0;0;0;.00nan;0;0
34379;205653;139;0;0;0;0;.00nan;0;0
34380;204815;144;0;0;0;0;.00nan;0;0
34380;204949;143;44;29;5;24;.828;3900000;0
34380;206778;144;56;35;5;30;.857;3900000;0
34380;208201;143;0;0;0;0;.00nan;0;0
34381;208575;142;65;22;1;21;.955;3600000;0
34381;204668;140;97;24;0;24;1.000;3600000;0
34381;204881;140;0;0;0;0;.00nan;0;0
34381;217769;142;0;0;0;0;.00nan;0;0
34382;219003;133;73;21;1;20;.952;3600000;0
34382;210213;134;0;0;0;0;.00nan;0;0
34382;210876;134;66;47;4;43;.915;3600000;0
34382;-1;133;0;0;0;0;.00nan;0;0
34383;203288;135;0;0;0;0;.00nan;0;0
34383;208556;135;59;50;6;44;.880;3600000;0
34383;204779;136;56;23;3;20;.870;3600000;0
34383;-1;136;0;0;0;0;.00nan;0;0
34384;215217;1340;0;0;0;0;.00nan;0;0
34384;212019;1340;99;51;1;50;.980;3600000;0
34384;-1;128;0;0;0;0;.00nan;0;0
34384;-1;128;66;26;3;23;.885;3512000;0
34385;204873;129;70;38;5;33;.868;3600000;0
34385;209998;129;0;0;0;0;.00nan;0;0
34385;220566;138;0;0;0;0;.00nan;0;0
34385;223929;138;67;19;1;18;.947;3600000;0
34386;208609;131;88;50;3;47;.940;3600000;0
34386;210060;137;74;17;1;16;.941;3600000;0
34386;206789;131;0;0;0;0;.00nan;0;0
34386;-1;137;0;0;0;0;.00nan;0;0
34387;207304;130;68;23;1;22;.957;3600000;0
34387;207313;132;0;0;0;0;.00nan;0;0
34387;-1;132;69;33;3;30;.909;3566000;0
34387;-1;130;0;0;0;0;.00nan;0;0
34388;203276;139;0;0;0;0;.00nan;0;0
34388;215128;141;48;26;4;22;.846;3600000;0
34388;205653;139;1;27;9;18;.667;3600000;0
34388;-1;141;0;0;0;0;.00nan;0;0
34389;208575;142;0;0;0;0;.00nan;0;0
34389;204949;143;77;37;2;35;.946;3558000;0
34389;217769;142;87;34;1;33;.971;3600000;0
34389;208201;143;0;0;0;0;.00nan;0;0
34390;208609;131;60;25;3;22;.880;3622000;0
34390;210060;137;0;0;0;0;.00nan;0;0
34390;206789;131;0;0;0;0;.00nan;0;0
34390;-1;137;88;32;2;30;.938;3622000;0
34391;207313;132;42;22;4;18;.818;3600000;0
34391;-1;128;0;0;0;0;.00nan;0;0
34391;-1;132;0;0;0;0;.00nan;0;0
34391;-1;128;35;30;5;25;.833;3567000;0
34392;219003;133;0;0;0;0;.00nan;0;0
34392;204873;129;55;33;4;29;.879;3559000;0
34392;209998;129;0;0;0;0;.00nan;0;0
34392;-1;133;50;20;3;17;.850;3600000;0
34393;203288;135;41;22;4;18;.818;1822000;0
34393;208556;135;27;18;5;13;.722;1734000;0
34393;210213;134;30;10;3;7;.700;518000;0
34393;210876;134;29;23;5;18;.783;3082000;0
34394;204668;140;61;32;4;28;.875;3340000;0
34394;215128;141;64;43;5;38;.884;3659000;0
34394;204881;140;55;4;0;4;1.000;319000;0
34394;-1;141;0;0;0;0;.00nan;0;0
34395;204779;136;0;0;0;0;.00nan;0;0
34395;207304;130;64;46;5;41;.891;3600000;0
34395;-1;136;55;55;7;48;.873;3564000;0
34395;-1;130;0;0;0;0;.00nan;0;0
34396;204815;144;41;18;3;15;.833;1654000;0
34396;220566;138;0;0;0;0;.00nan;0;0
34396;206778;144;33;19;5;14;.737;1946000;0
34396;223929;138;81;23;1;22;.957;3600000;0
34397;204668;140;56;43;7;36;.837;3600000;0
34397;215128;141;0;0;0;0;.00nan;0;0
34397;204881;140;0;0;0;0;.00nan;0;0
34397;-1;141;80;31;2;29;.935;3600000;0
34398;219003;133;0;0;0;0;.00nan;0;0
34398;204815;144;0;0;0;0;.00nan;0;0
34398;206778;144;78;42;4;38;.905;3801000;0
34398;-1;133;33;23;5;18;.783;3801000;0
34399;215217;1340;69;29;2;27;.931;3900000;0
34399;212019;1340;0;0;0;0;.00nan;0;0
34399;207313;132;77;33;2;31;.939;3900000;0
34399;-1;132;0;0;0;0;.00nan;0;0
34400;208609;131;100;23;0;23;1.000;3600000;0
34400;206789;131;0;0;0;0;.00nan;0;0
34400;-1;128;0;0;0;0;.00nan;0;0
34400;-1;128;74;19;1;18;.947;3578000;0
34401;208575;142;51;42;5;37;.881;3549000;0
34401;220566;138;54;21;3;18;.857;3600000;0
34401;217769;142;0;0;0;0;.00nan;0;0
34401;223929;138;0;0;0;0;.00nan;0;0
34402;204873;129;70;35;3;32;.914;3546000;0
34402;209998;129;0;0;0;0;.00nan;0;0
34402;210060;137;67;19;1;18;.947;3600000;0
34402;-1;137;0;0;0;0;.00nan;0;0
34403;203288;135;89;40;3;37;.925;3600000;0
34403;208556;135;0;0;0;0;.00nan;0;0
34403;207304;130;42;31;5;26;.839;3555000;0
34403;-1;130;0;0;0;0;.00nan;0;0
34404;204779;136;0;0;0;0;.00nan;0;0
34404;220575;134;56;35;4;31;.886;3572000;0
34404;210876;134;0;0;0;0;.00nan;0;0
34404;-1;136;54;24;3;21;.875;3600000;0
34405;212529;128;0;0;0;0;.00nan;0;0
34405;207313;132;0;0;0;0;.00nan;0;0
34405;-1;132;55;27;4;23;.852;3900000;0
34405;-1;128;69;33;4;29;.879;3900000;0
34406;204815;144;35;18;4;14;.778;1102000;0
34406;210060;137;0;0;0;0;.00nan;0;0
34406;206778;144;62;27;2;25;.926;2498000;0
34406;-1;137;57;18;2;16;.889;3600000;0
34407;208575;142;0;0;0;0;.00nan;0;0
34407;204873;129;0;0;0;0;.00nan;0;0
34407;209998;129;54;20;3;17;.850;3600000;0
34407;217769;142;100;34;0;34;1.000;3600000;0
34408;203276;139;51;29;4;25;.862;3600000;0
34408;204949;143;77;32;2;30;.938;3600000;0
34408;208201;143;0;0;0;0;.00nan;0;0
34408;-1;139;0;0;0;0;.00nan;0;0
34409;208609;131;61;30;3;27;.900;3567000;0
34409;215217;1340;0;0;0;0;.00nan;0;0
34409;212019;1340;91;36;1;35;.972;3600000;0
34409;206789;131;0;0;0;0;.00nan;0;0
34410;215128;141;66;27;2;25;.926;3600000;0
34410;204949;143;0;0;0;0;.00nan;0;0
34410;208201;143;82;49;4;45;.918;3552000;0
34410;-1;141;0;0;0;0;.00nan;0;0
34411;203276;139;0;0;0;0;.00nan;0;0
34411;204668;140;63;30;4;26;.867;3900000;0
34411;204881;140;0;0;0;0;.00nan;0;0
34411;-1;139;77;44;4;40;.909;3900000;0
34412;219003;133;0;0;0;0;.00nan;0;0
34412;220566;138;0;0;0;0;.00nan;0;0
34412;223929;138;77;39;3;36;.923;3514000;0
34412;-1;133;94;29;1;28;.966;3600000;0
34413;204779;136;83;18;0;18;1.000;3600000;0
34413;220575;134;64;33;3;30;.909;3600000;0
34413;210876;134;0;0;0;0;.00nan;0;0
34413;-1;136;0;0;0;0;.00nan;0;0
34414;203288;135;88;29;1;28;.966;3600000;0
34414;208556;135;0;0;0;0;.00nan;0;0
34414;207304;130;30;23;5;18;.783;3600000;0
34414;-1;130;0;0;0;0;.00nan;0;0
34415;215217;1340;55;36;5;31;.861;3538000;0
34415;212019;1340;0;0;0;0;.00nan;0;0
34415;212529;128;0;0;0;0;.00nan;0;0
34415;-1;128;73;34;3;31;.912;3600000;0
34416;203276;139;0;0;0;0;.00nan;0;0
34416;208575;142;43;18;3;15;.833;1803000;0
34416;217769;142;36;36;6;30;.833;1797000;0
34416;-1;139;60;30;3;27;.900;3600000;0
34417;208609;131;0;0;0;0;.00nan;0;0
34417;206789;131;67;31;3;28;.903;3600000;0
34417;207313;132;42;22;4;18;.818;3590000;0
34417;-1;132;0;0;0;0;.00nan;0;0
34418;219003;133;0;0;0;0;.00nan;0;0
34418;204815;144;51;39;5;34;.872;3600000;0
34418;206778;144;0;0;0;0;.00nan;0;0
34418;-1;133;90;35;2;33;.943;3600000;0
34419;215128;141;0;0;0;0;.00nan;0;0
34419;210004;141;39;33;6;27;.818;3600000;0
34419;210060;137;80;39;3;36;.923;3600000;0
34419;-1;137;0;0;0;0;.00nan;0;0
34420;204668;140;70;21;1;20;.952;3600000;0
34420;204881;140;0;0;0;0;.00nan;0;0
34420;220575;134;69;53;6;47;.887;3600000;0
34420;210876;134;0;0;0;0;.00nan;0;0
34421;208575;142;76;33;3;30;.909;3900000;0
34421;210060;137;52;18;3;15;.833;3896000;0
34421;217769;142;0;0;0;0;.00nan;0;0
34421;-1;137;0;0;0;0;.00nan;0;0
34422;215128;141;56;20;3;17;.850;3600000;0
34422;210004;141;0;0;0;0;.00nan;0;0
34422;220575;134;42;37;6;31;.838;3600000;0
34422;210876;134;0;0;0;0;.00nan;0;0
34423;208609;131;49;28;4;24;.857;3585000;0
34423;206789;131;0;0;0;0;.00nan;0;0
34423;212529;128;0;0;0;0;.00nan;0;0
34423;-1;128;62;20;2;18;.900;3600000;0
34424;204873;129;72;36;4;32;.889;3600000;0
34424;209998;129;0;0;0;0;.00nan;0;0
34424;207313;132;33;26;6;20;.769;3331000;0
34424;-1;132;59;4;0;4;1.000;205000;0
34425;220566;138;0;0;0;0;.00nan;0;0
34425;207304;130;85;34;1;33;.971;3600000;0
34425;223929;138;65;25;2;23;.920;3570000;0
34425;-1;130;0;0;0;0;.00nan;0;0
34426;203288;135;69;32;3;29;.906;3600000;0
34426;208556;135;0;0;0;0;.00nan;0;0
34426;215217;1340;39;37;6;31;.838;3600000;0
34426;212019;1340;0;0;0;0;.00nan;0;0
34427;203288;135;43;3;1;2;.667;355000;0
34427;208556;135;54;40;6;34;.850;3245000;0
34427;207313;132;0;0;0;0;.00nan;0;0
34427;-1;132;68;31;3;28;.903;3600000;0
34428;204779;136;70;35;3;32;.914;3575000;0
34428;215217;1340;86;39;1;38;.974;3600000;0
34428;212019;1340;0;0;0;0;.00nan;0;0
34428;-1;136;0;0;0;0;.00nan;0;0
34429;204873;129;0;0;0;0;.00nan;0;0
34429;209998;129;64;36;4;32;.889;3600000;0
34429;212529;128;45;38;5;33;.868;3600000;0
34429;-1;128;0;0;0;0;.00nan;0;0
34430;203276;139;52;22;3;19;.864;3100000;0
34430;220575;134;62;36;4;32;.889;3600000;0
34430;210876;134;0;0;0;0;.00nan;0;0
34430;-1;139;30;10;3;7;.700;470000;0
34431;219003;133;0;0;0;0;.00nan;0;0
34431;204949;143;80;35;2;33;.943;3600000;0
34431;208201;143;0;0;0;0;.00nan;0;0
34431;-1;133;58;25;3;22;.880;3564000;0
34432;204668;140;75;25;2;23;.920;3600000;0
34432;204881;140;0;0;0;0;.00nan;0;0
34432;210060;137;0;0;0;0;.00nan;0;0
34432;-1;137;51;36;4;32;.889;3600000;0
34433;208575;142;0;0;0;0;.00nan;0;0
34433;204815;144;0;0;0;0;.00nan;0;0
34433;206778;144;67;28;2;26;.929;3600000;0
34433;217769;142;72;47;6;41;.872;3600000;0
34434;219003;133;76;26;1;25;.962;3600000;0
34434;215128;141;0;0;0;0;.00nan;0;0
34434;210004;141;82;31;2;29;.935;3551000;0
34434;-1;133;0;0;0;0;.00nan;0;0
34435;204873;129;99;36;1;35;.972;3600000;0
34435;209998;129;0;0;0;0;.00nan;0;0
34435;207304;130;0;0;0;0;.00nan;0;0
34435;-1;130;39;21;4;17;.810;3600000;0
34436;203276;139;0;0;0;0;.00nan;0;0
34436;204949;143;0;0;0;0;.00nan;0;0
34436;208201;143;65;25;2;23;.920;3548000;0
34436;-1;139;100;37;1;36;.973;3600000;0
34437;204779;136;0;0;0;0;.00nan;0;0
34437;215217;1340;47;6;1;5;.833;1078000;0
34437;212019;1340;29;29;6;23;.793;2522000;0
34437;-1;136;55;25;3;22;.880;3600000;0
34438;208609;131;0;0;0;0;.00nan;0;0
34438;220566;138;0;0;0;0;.00nan;0;0
34438;206789;131;75;31;3;28;.903;3900000;0
34438;223929;138;69;32;3;29;.906;3900000;0
34439;204668;140;81;30;2;28;.933;3600000;0
34439;215128;141;0;0;0;0;.00nan;0;0
34439;204881;140;0;0;0;0;.00nan;0;0
34439;210004;141;59;39;5;34;.872;3600000;0
34440;203276;139;74;25;1;24;.960;3600000;0
34440;207313;132;0;0;0;0;.00nan;0;0
34440;-1;139;0;0;0;0;.00nan;0;0
34440;-1;132;64;31;3;28;.903;3591000;0
34441;203288;135;31;41;8;33;.805;3600000;0
34441;208556;135;0;0;0;0;.00nan;0;0
34441;204815;144;76;32;2;30;.938;3600000;0
34441;206778;144;0;0;0;0;.00nan;0;0
34442;208575;142;33;12;3;9;.750;2535000;0
34442;204949;143;77;31;2;29;.935;3600000;0
34442;217769;142;33;18;5;13;.722;1065000;0
34442;208201;143;0;0;0;0;.00nan;0;0
34443;204668;140;44;24;4;20;.833;2366000;0
34443;204881;140;30;9;3;6;.667;1234000;0
34443;220566;138;0;0;0;0;.00nan;0;0
34443;223929;138;80;40;4;36;.900;3600000;0
34444;204779;136;66;19;2;17;.895;3600000;0
34444;215217;1340;57;34;4;30;.882;3588000;0
34444;212019;1340;0;0;0;0;.00nan;0;0
34444;-1;136;0;0;0;0;.00nan;0;0
34445;203276;139;0;0;0;0;.00nan;0;0
34445;210060;137;54;31;4;27;.871;3538000;0
34445;-1;139;87;42;3;39;.929;3600000;0
34445;-1;137;0;0;0;0;.00nan;0;0
34446;208609;131;89;37;3;34;.919;3668000;0
34446;206789;131;0;0;0;0;.00nan;0;0
34446;207304;130;67;29;4;25;.862;3668000;0
34446;-1;130;0;0;0;0;.00nan;0;0
34447;215128;141;0;0;0;0;.00nan;0;0
34447;210004;141;61;33;4;29;.879;3518000;0
34447;220566;138;90;40;2;38;.950;3600000;0
34447;223929;138;0;0;0;0;.00nan;0;0
34448;204873;129;67;25;2;23;.920;3600000;0
34448;209998;129;0;0;0;0;.00nan;0;0
34448;220575;134;57;42;5;37;.881;3600000;0
34448;210876;134;0;0;0;0;.00nan;0;0
34449;204779;136;63;15;1;14;.933;2050000;0
34449;212529;128;0;0;0;0;.00nan;0;0
34449;-1;128;77;23;1;22;.957;3600000;0
34449;-1;136;25;13;4;9;.692;1550000;0
34450;219003;133;49;1;0;1;1.000;488000;0
34450;207313;132;0;0;0;0;.00nan;0;0
34450;-1;132;62;26;3;23;.885;3600000;0
34450;-1;133;49;44;7;37;.841;3112000;0
34451;203276;139;0;0;0;0;.00nan;0;0
34451;220575;134;50;43;6;37;.860;3600000;0
34451;210876;134;0;0;0;0;.00nan;0;0
34451;-1;139;59;25;3;22;.880;3600000;0
34452;208609;131;62;32;3;29;.906;3600000;0
34452;215217;1340;100;37;0;37;1.000;3600000;0
34452;212019;1340;0;0;0;0;.00nan;0;0
34452;206789;131;0;0;0;0;.00nan;0;0
34453;204779;136;26;24;5;19;.792;2241000;0
34453;212529;128;85;33;2;31;.939;3600000;0
34453;-1;128;0;0;0;0;.00nan;0;0
34453;-1;136;14;11;5;6;.545;1359000;0
34454;210060;137;0;0;0;0;.00nan;0;0
34454;207304;130;0;0;0;0;.00nan;0;0
34454;-1;137;46;24;4;20;.833;3581000;0
34454;-1;130;73;27;2;25;.926;3600000;0
34455;208575;142;51;28;4;24;.857;3600000;0
34455;220566;138;0;0;0;0;.00nan;0;0
34455;217769;142;0;0;0;0;.00nan;0;0
34455;223929;138;83;28;1;27;.964;3600000;0
34456;204668;140;75;20;1;19;.950;3600000;0
34456;204815;144;48;0;0;0;.00nan;285000;0
34456;204881;140;0;0;0;0;.00nan;0;0
34456;206778;144;24;46;7;39;.848;3315000;0
34457;203288;135;58;28;4;24;.857;3568000;0
34457;208556;135;0;0;0;0;.00nan;0;0
34457;204949;143;70;30;3;27;.900;3600000;0
34457;208201;143;0;0;0;0;.00nan;0;0
34458;204815;144;65;23;1;22;.957;3600000;0
34458;204949;143;0;0;0;0;.00nan;0;0
34458;206778;144;0;0;0;0;.00nan;0;0
34458;208201;143;61;43;5;38;.884;3600000;0
34459;203288;135;0;0;0;0;.00nan;0;0
34459;208556;135;73;49;4;45;.918;3709000;0
34459;215128;141;0;0;0;0;.00nan;0;0
34459;210004;141;67;34;3;31;.912;3709000;0
34460;219003;133;0;0;0;0;.00nan;0;0
34460;204873;129;54;4;0;4;1.000;565000;0
34460;209998;129;59;45;6;39;.867;3035000;0
34460;-1;133;57;24;3;21;.875;3600000;0
34461;208609;131;0;0;0;0;.00nan;0;0
34461;206789;131;70;39;3;36;.923;3600000;0
34461;207313;132;0;0;0;0;.00nan;0;0
34461;-1;132;89;35;1;34;.971;3600000;0
34462;215217;1340;79;32;2;30;.938;3600000;0
34462;212019;1340;0;0;0;0;.00nan;0;0
34462;207304;130;57;25;3;22;.880;3598000;0
34462;-1;130;0;0;0;0;.00nan;0;0
34463;208575;142;0;0;0;0;.00nan;0;0
34463;207304;130;64;28;3;25;.893;3600000;0
34463;217769;142;72;43;4;39;.907;3574000;0
34463;-1;130;0;0;0;0;.00nan;0;0
34464;203276;139;64;29;3;26;.897;3600000;0
34464;204815;144;0;0;0;0;.00nan;0;0
34464;206778;144;54;28;4;24;.857;3549000;0
34464;-1;139;0;0;0;0;.00nan;0;0
34465;215128;141;0;0;0;0;.00nan;0;0
34465;210004;141;38;22;5;17;.773;3545000;0
34465;204949;143;69;29;3;26;.897;3600000;0
34465;208201;143;0;0;0;0;.00nan;0;0
34466;203288;135;66;25;2;23;.920;3900000;0
34466;208556;135;0;0;0;0;.00nan;0;0
34466;204779;136;0;0;0;0;.00nan;0;0
34466;-1;136;69;25;2;23;.920;3900000;0
34467;208609;131;90;26;1;25;.962;3600000;0
34467;204873;129;64;31;3;28;.903;3546000;0
34467;209998;129;0;0;0;0;.00nan;0;0
34467;206789;131;0;0;0;0;.00nan;0;0
34468;220575;134;70;38;4;34;.895;3561000;0
34468;210876;134;0;0;0;0;.00nan;0;0
34468;212529;128;0;0;0;0;.00nan;0;0
34468;-1;128;61;29;3;26;.897;3600000;0
34469;204668;140;64;31;3;28;.903;3580000;0
34469;204881;140;0;0;0;0;.00nan;0;0
34469;220566;138;0;0;0;0;.00nan;0;0
34469;223929;138;81;33;2;31;.939;3600000;0
34470;210060;137;66;28;2;26;.929;3600000;0
34470;207313;132;0;0;0;0;.00nan;0;0
34470;-1;132;83;45;3;42;.933;3542000;0
34470;-1;137;0;0;0;0;.00nan;0;0
34471;219003;133;0;0;0;0;.00nan;0;0
34471;204779;136;26;27;6;21;.778;2136000;0
34471;-1;133;16;22;6;16;.727;3600000;0
34471;-1;136;49;7;1;6;.857;1451000;0
34472;220566;138;61;33;4;29;.879;3600000;0
34472;207313;132;50;42;6;36;.857;3576000;0
34472;223929;138;0;0;0;0;.00nan;0;0
34472;-1;132;0;0;0;0;.00nan;0;0
34473;204668;140;53;13;1;12;.923;3600000;0
34473;204881;140;0;0;0;0;.00nan;0;0
34473;210060;137;50;10;1;9;.900;1173000;0
34473;-1;137;34;35;6;29;.829;2427000;0
34474;215128;141;83;26;1;25;.962;3600000;0
34474;210004;141;0;0;0;0;.00nan;0;0
34474;207304;130;0;0;0;0;.00nan;0;0
34474;-1;130;73;44;4;40;.909;3600000;0
34475;220575;134;72;37;3;34;.919;3600000;0
34475;215217;1340;34;23;5;18;.783;3600000;0
34475;210876;134;0;0;0;0;.00nan;0;0
34475;212019;1340;0;0;0;0;.00nan;0;0
34476;208575;142;0;0;0;0;.00nan;0;0
34476;215128;141;0;0;0;0;.00nan;0;0
34476;210004;141;99;24;0;24;1.000;3600000;0
34476;217769;142;36;39;6;33;.846;3600000;0
34477;204815;144;0;0;0;0;.00nan;0;0
34477;204949;143;48;30;5;25;.833;3563000;0
34477;206778;144;42;25;4;21;.840;3600000;0
34477;208201;143;0;0;0;0;.00nan;0;0
34478;208609;131;75;29;2;27;.931;3900000;0
34478;204668;140;89;40;2;38;.950;3900000;0
34478;204881;140;0;0;0;0;.00nan;0;0
34478;206789;131;0;0;0;0;.00nan;0;0
34479;220575;134;37;26;5;21;.808;3600000;0
34479;210876;134;0;0;0;0;.00nan;0;0
34479;212529;128;0;0;0;0;.00nan;0;0
34479;-1;128;65;26;2;24;.923;3600000;0
34480;203276;139;91;46;2;44;.957;3600000;0
34480;207304;130;25;25;6;19;.760;3600000;0
34480;-1;139;0;0;0;0;.00nan;0;0
34480;-1;130;0;0;0;0;.00nan;0;0
34481;203288;135;75;38;3;35;.921;3600000;0
34481;219003;133;25;36;7;29;.806;3312000;0
34481;208556;135;0;0;0;0;.00nan;0;0
34481;-1;133;41;4;1;3;.750;288000;0
34482;220566;138;0;0;0;0;.00nan;0;0
34482;215217;1340;91;33;1;32;.970;3730000;0
34482;212019;1340;0;0;0;0;.00nan;0;0
34482;223929;138;99;24;0;24;1.000;3730000;0
34483;219003;133;0;0;0;0;.00nan;0;0
34483;208609;131;64;28;2;26;.929;3600000;0
34483;206789;131;0;0;0;0;.00nan;0;0
34483;-1;133;38;26;5;21;.808;3600000;0
34484;220566;138;41;2;1;1;.500;358000;0
34484;212529;128;0;0;0;0;.00nan;0;0
34484;223929;138;20;29;6;23;.793;3242000;0
34484;-1;128;77;25;1;24;.960;3600000;0
34485;215217;1340;43;39;6;33;.846;3600000;0
34485;212019;1340;0;0;0;0;.00nan;0;0
34485;207313;132;0;0;0;0;.00nan;0;0
34485;-1;132;75;22;1;21;.955;3600000;0
34486;204779;136;0;0;0;0;.00nan;0;0
34486;204873;129;0;0;0;0;.00nan;0;0
34486;209998;129;56;27;3;24;.889;3552000;0
34486;-1;136;83;34;2;32;.941;3600000;0
34487;210060;137;77;34;2;32;.941;3640000;0
34487;204949;143;0;0;0;0;.00nan;0;0
34487;208201;143;86;42;3;39;.929;3640000;0
34487;-1;137;0;0;0;0;.00nan;0;0
34488;203288;135;0;0;0;0;.00nan;0;0
34488;208556;135;70;26;2;24;.923;3600000;0
34488;208609;131;0;0;0;0;.00nan;0;0
34488;206789;131;60;32;4;28;.875;3548000;0
34489;208575;142;0;0;0;0;.00nan;0;0
34489;204668;140;64;21;2;19;.905;3600000;0
34489;204881;140;0;0;0;0;.00nan;0;0
34489;217769;142;78;53;5;48;.906;3600000;0
34490;204815;144;75;27;2;25;.926;3600000;0
34490;215128;141;0;0;0;0;.00nan;0;0
34490;210004;141;49;30;4;26;.867;3600000;0
34490;206778;144;0;0;0;0;.00nan;0;0
34491;219003;133;0;0;0;0;.00nan;0;0
34491;204779;136;34;40;7;33;.825;3600000;0
34491;-1;133;72;27;2;25;.926;3600000;0
34491;-1;136;0;0;0;0;.00nan;0;0
34492;204873;129;75;23;1;22;.957;3600000;0
34492;209998;129;0;0;0;0;.00nan;0;0
34492;204949;143;0;0;0;0;.00nan;0;0
34492;208201;143;64;25;2;23;.920;3563000;0
34493;215217;1340;37;29;5;24;.828;3600000;0
34493;210060;137;0;0;0;0;.00nan;0;0
34493;212019;1340;0;0;0;0;.00nan;0;0
34493;-1;137;56;18;2;16;.889;3600000;0
34494;212529;128;0;0;0;0;.00nan;0;0
34494;207304;130;0;0;0;0;.00nan;0;0
34494;-1;128;75;36;3;33;.917;3600000;0
34494;-1;130;68;40;4;36;.900;3568000;0
34495;219003;133;66;37;3;34;.919;3600000;0
34495;204779;136;0;0;0;0;.00nan;0;0
34495;-1;133;0;0;0;0;.00nan;0;0
34495;-1;136;62;38;4;34;.895;3600000;0
34496;208609;131;93;31;1;30;.968;3600000;0
34496;206789;131;0;0;0;0;.00nan;0;0
34496;212529;128;48;22;3;19;.864;3534000;0
34496;-1;128;0;0;0;0;.00nan;0;0
34497;220575;134;63;26;3;23;.885;3572000;0
34497;210876;134;0;0;0;0;.00nan;0;0
34497;207313;132;66;27;2;25;.926;3600000;0
34497;-1;132;0;0;0;0;.00nan;0;0
34498;220566;138;61;29;4;25;.862;3600000;0
34498;204949;143;0;0;0;0;.00nan;0;0
34498;223929;138;0;0;0;0;.00nan;0;0
34498;208201;143;29;32;6;26;.813;3600000;0
34499;203276;139;66;33;3;30;.909;3600000;0
34499;208575;142;60;43;5;38;.884;3600000;0
34499;217769;142;0;0;0;0;.00nan;0;0
34499;-1;139;0;0;0;0;.00nan;0;0
34500;204815;144;0;0;0;0;.00nan;0;0
34500;215128;141;70;36;3;33;.917;3821000;0
34500;210004;141;0;0;0;0;.00nan;0;0
34500;206778;144;71;27;2;25;.926;3821000;0
34501;220575;134;40;32;6;26;.813;1905000;0
34501;210876;134;63;14;1;13;.929;1695000;0
34501;207313;132;0;0;0;0;.00nan;0;0
34501;-1;132;60;21;2;19;.905;3600000;0
34502;215217;1340;28;27;6;21;.778;2781000;0
34502;212019;1340;34;6;2;4;.667;819000;0
34502;207304;130;0;0;0;0;.00nan;0;0
34502;-1;130;54;32;4;28;.875;3600000;0
34503;203276;139;0;0;0;0;.00nan;0;0
34503;204668;140;63;33;3;30;.909;3600000;0
34503;204881;140;0;0;0;0;.00nan;0;0
34503;-1;139;51;39;5;34;.872;3585000;0
34504;203288;135;34;32;6;26;.813;3600000;0
34504;208556;135;0;0;0;0;.00nan;0;0
34504;220566;138;0;0;0;0;.00nan;0;0
34504;223929;138;63;21;2;19;.905;3600000;0
34505;204873;129;0;0;0;0;.00nan;0;0
34505;209998;129;75;36;3;33;.917;3594000;0
34505;210060;137;63;25;2;23;.920;3600000;0
34505;-1;137;0;0;0;0;.00nan;0;0
34506;208575;142;54;17;2;15;.882;1975000;0
34506;208609;131;20;22;6;16;.727;2398000;0
34506;206789;131;63;12;0;12;1.000;1430000;0
34506;217769;142;33;21;5;16;.762;1853000;0
34507;203276;139;46;22;3;19;.864;3543000;0
34507;204779;136;0;0;0;0;.00nan;0;0
34507;-1;139;0;0;0;0;.00nan;0;0
34507;-1;136;93;36;2;34;.944;3600000;0
34508;204815;144;0;0;0;0;.00nan;0;0
34508;220575;134;77;32;3;29;.906;3881000;0
34508;210876;134;0;0;0;0;.00nan;0;0
34508;206778;144;58;22;3;19;.864;3900000;0
34509;204668;140;67;22;2;20;.909;3600000;0
34509;204881;140;0;0;0;0;.00nan;0;0
34509;204949;143;0;0;0;0;.00nan;0;0
34509;208201;143;69;44;5;39;.886;3600000;0
34510;208575;142;0;0;0;0;.00nan;0;0
34510;215217;1340;0;0;0;0;.00nan;0;0
34510;212019;1340;50;39;5;34;.872;3585000;0
34510;217769;142;64;28;3;25;.893;3600000;0
34511;210060;137;67;34;4;30;.882;3557000;0
34511;207313;132;0;0;0;0;.00nan;0;0
34511;-1;132;79;32;2;30;.938;3600000;0
34511;-1;137;0;0;0;0;.00nan;0;0
34512;204668;140;83;43;4;39;.907;3600000;0
34512;215128;141;0;0;0;0;.00nan;0;0
34512;204881;140;0;0;0;0;.00nan;0;0
34512;210004;141;52;41;6;35;.854;3514000;0
34513;204779;136;0;0;0;0;.00nan;0;0
34513;204815;144;56;19;3;16;.842;3600000;0
34513;206778;144;0;0;0;0;.00nan;0;0
34513;-1;136;73;47;5;42;.894;3586000;0
34514;208609;131;55;18;2;16;.889;3600000;0
34514;220575;134;37;31;6;25;.806;2324000;0
34514;210876;134;56;10;1;9;.900;1276000;0
34514;206789;131;0;0;0;0;.00nan;0;0
34515;208575;142;85;38;2;36;.947;3600000;0
34515;212529;128;0;0;0;0;.00nan;0;0
34515;217769;142;0;0;0;0;.00nan;0;0
34515;-1;128;65;29;3;26;.897;3558000;0
34516;204873;129;76;43;5;38;.884;3600000;0
34516;209998;129;0;0;0;0;.00nan;0;0
34516;220566;138;0;0;0;0;.00nan;0;0
34516;223929;138;82;22;1;21;.955;3600000;0
34517;219003;133;0;0;0;0;.00nan;0;0
34517;207304;130;65;22;2;20;.909;3007000;0
34517;-1;133;76;30;2;28;.933;3600000;0
34517;-1;130;29;8;3;5;.625;593000;0
34518;203276;139;74;26;2;24;.923;1846000;0
34518;203288;135;76;32;4;28;.875;3600000;0
34518;208556;135;0;0;0;0;.00nan;0;0
34518;-1;139;14;16;6;10;.625;1754000;0
34519;203288;135;0;0;0;0;.00nan;0;0
34519;208556;135;68;29;3;26;.897;3600000;0
34519;204815;144;0;0;0;0;.00nan;0;0
34519;206778;144;75;28;2;26;.929;3600000;0
34520;208609;131;0;0;0;0;.00nan;0;0
34520;220575;134;76;48;4;44;.917;3547000;0
34520;210876;134;0;0;0;0;.00nan;0;0
34520;206789;131;51;26;3;23;.885;3600000;0
34521;210060;137;75;24;2;22;.917;3600000;0
34521;212529;128;42;27;5;22;.815;3353000;0
34521;-1;128;48;0;0;0;.00nan;247000;0
34521;-1;137;0;0;0;0;.00nan;0;0
34522;207304;130;0;0;0;0;.00nan;0;0
34522;207313;132;71;26;2;24;.923;3576000;0
34522;-1;132;0;0;0;0;.00nan;0;0
34522;-1;130;77;24;1;23;.958;3600000;0
34523;203276;139;65;33;3;30;.909;3600000;0
34523;204873;129;0;0;0;0;.00nan;0;0
34523;209998;129;26;34;7;27;.794;3600000;0
34523;-1;139;0;0;0;0;.00nan;0;0
34524;215128;141;99;55;3;52;.945;3900000;0
34524;210004;141;0;0;0;0;.00nan;0;0
34524;204949;143;0;0;0;0;.00nan;0;0
34524;208201;143;76;35;3;32;.914;3900000;0
34525;219003;133;0;0;0;0;.00nan;0;0
34525;220566;138;95;28;1;27;.964;3600000;0
34525;223929;138;0;0;0;0;.00nan;0;0
34525;-1;133;86;42;3;39;.929;3600000;0
34526;215217;1340;98;40;1;39;.975;3600000;0
34526;210060;137;0;0;0;0;.00nan;0;0
34526;212019;1340;0;0;0;0;.00nan;0;0
34526;-1;137;72;33;2;31;.939;3593000;0
34527;203288;135;77;36;3;33;.917;3600000;0
34527;219003;133;0;0;0;0;.00nan;0;0
34527;208556;135;0;0;0;0;.00nan;0;0
34527;-1;133;69;17;1;16;.941;3600000;0
34528;203276;139;40;16;3;13;.813;582000;0
34528;204815;144;70;31;3;28;.903;3600000;0
34528;206778;144;0;0;0;0;.00nan;0;0
34528;-1;139;64;21;2;19;.905;2935000;0
34529;204668;140;84;35;3;32;.914;3653000;0
34529;204881;140;0;0;0;0;.00nan;0;0
34529;207313;132;0;0;0;0;.00nan;0;0
34529;-1;132;74;42;4;38;.905;3653000;0
34530;204873;129;47;24;4;20;.833;3600000;0
34530;209998;129;0;0;0;0;.00nan;0;0
34530;212529;128;0;0;0;0;.00nan;0;0
34530;-1;128;95;23;0;23;1.000;3600000;0
34531;220575;134;60;37;4;33;.892;3540000;0
34531;210876;134;0;0;0;0;.00nan;0;0
34531;207304;130;54;20;2;18;.900;3600000;0
34531;-1;130;0;0;0;0;.00nan;0;0
34532;203288;135;85;42;3;39;.929;3600000;0
34532;208556;135;0;0;0;0;.00nan;0;0
34532;220566;138;0;0;0;0;.00nan;0;0
34532;223929;138;38;23;4;19;.826;3545000;0
34533;203276;139;0;0;0;0;.00nan;0;0
34533;208609;131;55;40;6;34;.850;2969000;0
34533;206789;131;45;5;1;4;.800;631000;0
34533;-1;139;94;26;1;25;.962;3600000;0
34534;208575;142;0;0;0;0;.00nan;0;0
34534;207313;132;27;24;6;18;.750;3600000;0
34534;217769;142;75;37;3;34;.919;3600000;0
34534;-1;132;0;0;0;0;.00nan;0;0
34535;204815;144;0;0;0;0;.00nan;0;0
34535;204949;143;42;3;1;2;.667;533000;0
34535;206778;144;99;27;0;27;1.000;3600000;0
34535;208201;143;76;58;6;52;.897;3067000;0
34536;204779;136;0;0;0;0;.00nan;0;0
34536;220566;138;57;34;4;30;.882;3530000;0
34536;223929;138;0;0;0;0;.00nan;0;0
34536;-1;136;69;25;2;23;.920;3600000;0
34537;219003;133;0;0;0;0;.00nan;0;0
34537;215217;1340;57;43;6;37;.860;3600000;0
34537;212019;1340;0;0;0;0;.00nan;0;0
34537;-1;133;42;29;5;24;.828;3600000;0
34538;210060;137;60;32;3;29;.906;3600000;0
34538;212529;128;0;0;0;0;.00nan;0;0
34538;-1;128;41;27;4;23;.852;3577000;0
34538;-1;137;0;0;0;0;.00nan;0;0
34539;204873;129;71;10;0;10;1.000;1468000;0
34539;209998;129;18;21;6;15;.714;2132000;0
34539;207304;130;0;0;0;0;.00nan;0;0
34539;-1;130;89;34;2;32;.941;3600000;0
34540;203288;135;69;39;4;35;.897;3600000;0
34540;208556;135;0;0;0;0;.00nan;0;0
34540;220575;134;87;39;2;37;.949;3600000;0
34540;210876;134;0;0;0;0;.00nan;0;0
34541;215128;141;0;0;0;0;.00nan;0;0
34541;210004;141;36;20;4;16;.800;3544000;0
34541;207313;132;0;0;0;0;.00nan;0;0
34541;-1;132;82;39;3;36;.923;3600000;0
34542;208609;131;0;0;0;0;.00nan;0;0
34542;204668;140;93;33;1;32;.970;3600000;0
34542;204881;140;0;0;0;0;.00nan;0;0
34542;206789;131;80;35;3;32;.914;3552000;0
34543;219003;133;41;21;4;17;.810;2037000;0
34543;215217;1340;64;7;0;7;1.000;929000;0
34543;212019;1340;35;33;6;27;.818;2659000;0
34543;-1;133;70;9;0;9;1.000;1563000;0
34544;208575;142;100;26;0;26;1.000;3600000;0
34544;208609;131;96;45;3;42;.933;3600000;0
34544;206789;131;0;0;0;0;.00nan;0;0
34544;217769;142;0;0;0;0;.00nan;0;0
34545;203276;139;39;32;6;26;.813;3200000;0
34545;204949;143;0;0;0;0;.00nan;0;0
34545;208201;143;84;34;3;31;.912;3600000;0
34545;-1;139;53;2;0;2;1.000;400000;0
34546;220575;134;98;43;3;40;.930;3567000;0
34546;210876;134;0;0;0;0;.00nan;0;0
34546;207304;130;0;0;0;0;.00nan;0;0
34546;-1;130;71;21;1;20;.952;3600000;0
34547;219003;133;0;0;0;0;.00nan;0;0
34547;212529;128;0;0;0;0;.00nan;0;0
34547;-1;128;53;26;4;22;.846;3557000;0
34547;-1;133;63;27;2;25;.926;3600000;0
34548;204873;129;59;53;6;47;.887;3600000;0
34548;209998;129;0;0;0;0;.00nan;0;0
34548;220566;138;0;0;0;0;.00nan;0;0
34548;223929;138;87;26;1;25;.962;3600000;0
34549;204779;136;0;0;0;0;.00nan;0;0
34549;210060;137;100;25;0;25;1.000;3600000;0
34549;-1;136;90;38;3;35;.921;3600000;0
34549;-1;137;0;0;0;0;.00nan;0;0
34550;203276;139;0;0;0;0;.00nan;0;0
34550;204949;143;0;0;0;0;.00nan;0;0
34550;208201;143;42;42;6;36;.857;3600000;0
34550;-1;139;55;29;4;25;.862;3600000;0
34551;208575;142;81;36;2;34;.944;3591000;0
34551;215128;141;0;0;0;0;.00nan;0;0
34551;210004;141;71;24;1;23;.958;3600000;0
34551;217769;142;0;0;0;0;.00nan;0;0
34552;204668;140;55;26;3;23;.885;3570000;0
34552;204815;144;0;0;0;0;.00nan;0;0
34552;204881;140;0;0;0;0;.00nan;0;0
34552;206778;144;81;27;1;26;.963;3600000;0
34553;203276;139;0;0;0;0;.00nan;0;0
34553;208575;142;0;0;0;0;.00nan;0;0
34553;217769;142;52;44;6;38;.864;3600000;0
34553;-1;139;62;29;4;25;.862;3600000;0
34554;204779;136;0;0;0;0;.00nan;0;0
34554;210060;137;46;39;6;33;.846;3600000;0
34554;-1;136;77;32;3;29;.906;3600000;0
34554;-1;137;0;0;0;0;.00nan;0;0
34555;208609;131;79;39;3;36;.923;3600000;0
34555;206789;131;0;0;0;0;.00nan;0;0
34555;207313;132;0;0;0;0;.00nan;0;0
34555;-1;132;32;33;6;27;.818;3600000;0
34556;215217;1340;91;42;2;40;.952;3600000;0
34556;212019;1340;0;0;0;0;.00nan;0;0
34556;212529;128;0;0;0;0;.00nan;0;0
34556;-1;128;44;24;4;20;.833;3600000;0
34557;204949;143;81;45;4;41;.911;3600000;0
34557;207304;130;0;0;0;0;.00nan;0;0
34557;208201;143;0;0;0;0;.00nan;0;0
34557;-1;130;79;22;1;21;.955;3600000;0
34558;203288;135;71;32;3;29;.906;3880000;0
34558;208556;135;0;0;0;0;.00nan;0;0
34558;220575;134;86;39;2;37;.949;3880000;0
34558;210876;134;0;0;0;0;.00nan;0;0
34559;219003;133;0;0;0;0;.00nan;0;0
34559;204668;140;71;22;3;19;.864;3600000;0
34559;204881;140;0;0;0;0;.00nan;0;0
34559;-1;133;100;52;0;52;1.000;3600000;0
34560;208609;131;0;0;0;0;.00nan;0;0
34560;204949;143;0;0;0;0;.00nan;0;0
34560;206789;131;53;30;5;25;.833;3900000;0
34560;208201;143;51;35;5;30;.857;3899000;0
34561;204873;129;33;35;7;28;.800;2501000;0
34561;209998;129;28;16;4;12;.750;1099000;0
34561;220566;138;0;0;0;0;.00nan;0;0
34561;223929;138;66;34;3;31;.912;3600000;0
34562;203288;135;53;36;4;32;.889;3283000;0
34562;208556;135;28;8;3;5;.625;317000;0
34562;210060;137;100;28;0;28;1.000;3600000;0
34562;-1;137;0;0;0;0;.00nan;0;0
34563;204779;136;0;0;0;0;.00nan;0;0
34563;220575;134;52;44;5;39;.886;3600000;0
34563;210876;134;0;0;0;0;.00nan;0;0
34563;-1;136;67;20;2;18;.900;3600000;0
34564;215217;1340;81;42;4;38;.905;3524000;0
34564;212019;1340;0;0;0;0;.00nan;0;0
34564;207313;132;71;27;2;25;.926;3600000;0
34564;-1;132;0;0;0;0;.00nan;0;0
34565;204668;140;61;32;4;28;.875;3600000;0
34565;204873;129;0;0;0;0;.00nan;0;0
34565;204881;140;0;0;0;0;.00nan;0;0
34565;209998;129;59;45;5;40;.889;3600000;0
34566;212529;128;77;36;2;34;.944;2883000;0
34566;207304;130;0;0;0;0;.00nan;0;0
34566;-1;128;20;8;4;4;.500;686000;0
34566;-1;130;29;15;4;11;.733;3600000;0
34567;203276;139;0;0;0;0;.00nan;0;0
34567;215128;141;0;0;0;0;.00nan;0;0
34567;210004;141;22;25;6;19;.760;3583000;0
34567;-1;139;61;43;5;38;.884;3600000;0
34568;208575;142;40;33;6;27;.818;3185000;0
34568;204815;144;49;29;4;25;.862;3600000;0
34568;206778;144;0;0;0;0;.00nan;0;0
34568;217769;142;49;6;1;5;.833;415000;0
34569;208575;142;0;0;0;0;.00nan;0;0
34569;204815;144;0;0;0;0;.00nan;0;0
34569;206778;144;59;29;3;26;.897;3544000;0
34569;217769;142;82;34;2;32;.941;3600000;0
34570;203276;139;75;37;3;34;.919;3600000;0
34570;215128;141;80;36;2;34;.944;3600000;0
34570;210004;141;0;0;0;0;.00nan;0;0
34570;-1;139;0;0;0;0;.00nan;0;0
34571;219003;133;0;0;0;0;.00nan;0;0
34571;204949;143;37;8;2;6;.750;734000;0
34571;208201;143;38;39;7;32;.821;2866000;0
34571;-1;133;78;40;3;37;.925;3600000;0
34572;212529;128;0;0;0;0;.00nan;0;0
34572;207313;132;0;0;0;0;.00nan;0;0
34572;-1;132;47;35;6;29;.829;3600000;0
34572;-1;128;83;33;2;31;.939;3600000;0
34573;204668;140;75;24;2;22;.917;3600000;0
34573;204881;140;0;0;0;0;.00nan;0;0
34573;207304;130;56;42;6;36;.857;3600000;0
34573;-1;130;0;0;0;0;.00nan;0;0
34574;204779;136;75;32;3;29;.906;3878000;0
34574;220575;134;63;33;4;29;.879;3878000;0
34574;210876;134;0;0;0;0;.00nan;0;0
34574;-1;136;0;0;0;0;.00nan;0;0
34575;220566;138;65;26;2;24;.923;3715000;0
34575;210060;137;92;53;3;50;.943;3715000;0
34575;223929;138;0;0;0;0;.00nan;0;0
34575;-1;137;0;0;0;0;.00nan;0;0
34576;204873;129;74;35;3;32;.914;3562000;0
34576;209998;129;0;0;0;0;.00nan;0;0
34576;215217;1340;77;23;1;22;.957;3600000;0
34576;212019;1340;0;0;0;0;.00nan;0;0
34577;204815;144;0;0;0;0;.00nan;0;0
34577;204949;143;80;52;5;47;.904;3600000;0
34577;206778;144;58;21;2;19;.905;3600000;0
34577;208201;143;0;0;0;0;.00nan;0;0
34578;203288;135;78;28;2;26;.929;3600000;0
34578;208556;135;0;0;0;0;.00nan;0;0
34578;208609;131;33;38;7;31;.816;3600000;0
34578;206789;131;0;0;0;0;.00nan;0;0
34579;215128;141;0;0;0;0;.00nan;0;0
34579;210004;141;72;40;4;36;.900;3600000;0
34579;207313;132;0;0;0;0;.00nan;0;0
34579;-1;132;70;28;2;26;.929;3600000;0
34580;219003;133;0;0;0;0;.00nan;0;0
34580;210060;137;0;0;0;0;.00nan;0;0
34580;-1;133;69;29;3;26;.897;3600000;0
34580;-1;137;42;35;5;30;.857;3536000;0
34581;203276;139;0;0;0;0;.00nan;0;0
34581;204779;136;0;0;0;0;.00nan;0;0
34581;-1;139;54;31;4;27;.871;3525000;0
34581;-1;136;82;40;2;38;.950;3600000;0
34582;208575;142;0;0;0;0;.00nan;0;0
34582;204949;143;0;0;0;0;.00nan;0;0
34582;217769;142;75;38;4;34;.895;3600000;0
34582;208201;143;85;35;2;33;.943;3600000;0
34583;220566;138;0;0;0;0;.00nan;0;0
34583;212529;128;0;0;0;0;.00nan;0;0
34583;223929;138;99;25;0;25;1.000;3600000;0
34583;-1;128;29;36;7;29;.806;3600000;0
34584;204668;140;0;0;0;0;.00nan;0;0
34584;204779;136;0;0;0;0;.00nan;0;0
34584;204881;140;84;33;3;30;.909;3600000;0
34584;-1;136;63;41;5;36;.878;3600000;0
34585;203288;135;73;27;2;25;.926;3600000;0
34585;208556;135;0;0;0;0;.00nan;0;0
34585;215217;1340;36;42;7;35;.833;3600000;0
34585;212019;1340;0;0;0;0;.00nan;0;0
34586;208609;131;100;23;0;23;1.000;3600000;0
34586;206789;131;0;0;0;0;.00nan;0;0
34586;212529;128;46;33;5;28;.848;3600000;0
34586;-1;128;0;0;0;0;.00nan;0;0
34587;220566;138;0;0;0;0;.00nan;0;0
34587;207304;130;0;0;0;0;.00nan;0;0
34587;223929;138;79;40;3;37;.925;3900000;0
34587;-1;130;92;45;3;42;.933;3900000;0
34588;215128;141;0;0;0;0;.00nan;0;0
34588;204873;129;79;37;3;34;.919;3900000;0
34588;209998;129;0;0;0;0;.00nan;0;0
34588;210004;141;54;22;3;19;.864;3900000;0
34589;210060;137;56;43;5;38;.884;3589000;0
34589;207313;132;0;0;0;0;.00nan;0;0
34589;-1;132;39;20;4;16;.800;3600000;0
34589;-1;137;0;0;0;0;.00nan;0;0
34590;208575;142;0;0;0;0;.00nan;0;0
34590;204779;136;0;0;0;0;.00nan;0;0
34590;217769;142;74;32;3;29;.906;3600000;0
34590;-1;136;54;30;4;26;.867;3568000;0
34591;219003;133;0;0;0;0;.00nan;0;0
34591;220575;134;67;17;1;16;.941;1293000;0
34591;210876;134;19;25;6;19;.760;2307000;0
34591;-1;133;70;16;1;15;.938;3600000;0
34592;208609;131;60;31;3;28;.903;3900000;0
34592;206789;131;0;0;0;0;.00nan;0;0
34592;207313;132;59;28;3;25;.893;3900000;0
34592;-1;132;0;0;0;0;.00nan;0;0
34593;215128;141;53;16;2;14;.875;3600000;0
34593;210004;141;0;0;0;0;.00nan;0;0
34593;210060;137;0;0;0;0;.00nan;0;0
34593;-1;137;44;31;5;26;.839;3600000;0
34594;203276;139;78;28;2;26;.929;3600000;0
34594;204815;144;0;0;0;0;.00nan;0;0
34594;206778;144;25;28;6;22;.786;3600000;0
34594;-1;139;0;0;0;0;.00nan;0;0
34595;204668;140;88;28;1;27;.964;3600000;0
34595;204881;140;0;0;0;0;.00nan;0;0
34595;204949;143;51;27;4;23;.852;3600000;0
34595;208201;143;0;0;0;0;.00nan;0;0
34596;203288;135;0;0;0;0;.00nan;0;0
34596;208556;135;40;31;6;25;.806;3571000;0
34596;215217;1340;40;25;5;20;.800;3600000;0
34596;212019;1340;0;0;0;0;.00nan;0;0
34597;208575;142;37;9;3;6;.667;432000;0
34597;204815;144;46;24;4;20;.833;3600000;0
34597;206778;144;0;0;0;0;.00nan;0;0
34597;217769;142;77;31;2;29;.935;3123000;0
34598;220566;138;48;21;4;17;.810;3600000;0
34598;220575;134;59;40;6;34;.850;3177000;0
34598;210876;134;51;2;0;2;1.000;348000;0
34598;223929;138;0;0;0;0;.00nan;0;0
34599;203288;135;58;38;5;33;.868;3600000;0
34599;208556;135;0;0;0;0;.00nan;0;0
34599;212529;128;0;0;0;0;.00nan;0;0
34599;-1;128;85;28;1;27;.964;3600000;0
34600;204873;129;0;0;0;0;.00nan;0;0
34600;209998;129;52;31;4;27;.871;3567000;0
34600;207304;130;0;0;0;0;.00nan;0;0
34600;-1;130;68;34;3;31;.912;3600000;0
34601;203276;139;0;0;0;0;.00nan;0;0
34601;204668;140;100;30;0;30;1.000;3600000;0
34601;204881;140;0;0;0;0;.00nan;0;0
34601;-1;139;39;32;5;27;.844;3600000;0
34602;204815;144;0;0;0;0;.00nan;0;0
34602;215128;141;0;0;0;0;.00nan;0;0
34602;210004;141;71;36;4;32;.889;3900000;0
34602;206778;144;54;31;4;27;.871;3900000;0
34603;219003;133;0;0;0;0;.00nan;0;0
34603;210060;137;52;27;3;24;.889;3580000;0
34603;-1;133;83;27;2;25;.926;3600000;0
34603;-1;137;0;0;0;0;.00nan;0;0
34604;204779;136;0;0;0;0;.00nan;0;0
34604;204873;129;0;0;0;0;.00nan;0;0
34604;209998;129;26;19;5;14;.737;3574000;0
34604;-1;136;90;45;4;41;.911;3600000;0
34605;215217;1340;92;46;3;43;.935;3900000;0
34605;212019;1340;0;0;0;0;.00nan;0;0
34605;212529;128;0;0;0;0;.00nan;0;0
34605;-1;128;68;28;3;25;.893;3900000;0
34606;207304;130;0;0;0;0;.00nan;0;0
34606;207313;132;0;0;0;0;.00nan;0;0
34606;-1;132;76;17;1;16;.941;3600000;0
34606;-1;130;85;35;3;32;.914;3589000;0
34607;204668;140;33;27;6;21;.778;3305000;0
34607;204815;144;27;14;4;10;.714;946000;0
34607;204881;140;40;3;1;2;.667;295000;0
34607;206778;144;62;22;2;20;.909;2654000;0
34608;208575;142;61;22;2;20;.909;3000000;0
34608;204949;143;0;0;0;0;.00nan;0;0
34608;217769;142;27;7;3;4;.571;562000;0
34608;208201;143;53;31;4;27;.871;3600000;0
34609;219003;133;0;0;0;0;.00nan;0;0
34609;208609;131;0;0;0;0;.00nan;0;0
34609;206789;131;69;32;3;29;.906;3520000;0
34609;-1;133;82;23;1;22;.957;3600000;0
34610;220575;134;63;45;5;40;.889;3600000;0
34610;210876;134;0;0;0;0;.00nan;0;0
34610;207313;132;24;11;4;7;.636;3600000;0
34610;-1;132;0;0;0;0;.00nan;0;0
34611;212529;128;0;0;0;0;.00nan;0;0
34611;207304;130;0;0;0;0;.00nan;0;0
34611;-1;128;73;36;3;33;.917;3600000;0
34611;-1;130;64;15;1;14;.933;3600000;0
34612;204873;129;68;29;2;27;.931;3600000;0
34612;209998;129;0;0;0;0;.00nan;0;0
34612;210060;137;62;35;4;31;.886;3599000;0
34612;-1;137;0;0;0;0;.00nan;0;0
34613;219003;133;66;35;4;31;.886;3593000;0
34613;208609;131;49;33;5;28;.848;3600000;0
34613;206789;131;0;0;0;0;.00nan;0;0
34613;-1;133;0;0;0;0;.00nan;0;0
34614;203288;135;67;44;5;39;.886;3600000;0
34614;208556;135;0;0;0;0;.00nan;0;0
34614;204779;136;0;0;0;0;.00nan;0;0
34614;-1;136;86;28;1;27;.964;3600000;0
34615;220575;134;21;18;5;13;.722;869000;0
34615;210876;134;77;22;1;21;.955;2731000;0
34615;207313;132;0;0;0;0;.00nan;0;0
34615;-1;132;43;26;4;22;.846;3600000;0
34616;220566;138;0;0;0;0;.00nan;0;0
34616;212529;128;91;41;3;38;.927;3600000;0
34616;223929;138;28;25;6;19;.760;3600000;0
34616;-1;128;0;0;0;0;.00nan;0;0
34617;204668;140;68;24;3;21;.875;3900000;0
34617;204815;144;79;30;3;27;.900;3900000;0
34617;204881;140;0;0;0;0;.00nan;0;0
34617;206778;144;0;0;0;0;.00nan;0;0
34618;203276;139;52;38;5;33;.868;3552000;0
34618;215128;141;0;0;0;0;.00nan;0;0
34618;210004;141;64;38;4;34;.895;3600000;0
34618;-1;139;0;0;0;0;.00nan;0;0
34619;215217;1340;60;29;3;26;.897;3600000;0
34619;212019;1340;0;0;0;0;.00nan;0;0
34619;207304;130;0;0;0;0;.00nan;0;0
34619;-1;130;80;32;2;30;.938;3600000;0
34620;208575;142;0;0;0;0;.00nan;0;0
34620;215128;141;57;26;4;22;.846;3600000;0
34620;210004;141;0;0;0;0;.00nan;0;0
34620;217769;142;90;27;1;26;.963;3600000;0
34621;203276;139;0;0;0;0;.00nan;0;0
34621;204949;143;43;37;6;31;.838;3600000;0
34621;208201;143;0;0;0;0;.00nan;0;0
34621;-1;139;100;30;0;30;1.000;3600000;0
34622;203288;135;0;0;0;0;.00nan;0;0
34622;208556;135;95;36;1;35;.972;3600000;0
34622;204779;136;0;0;0;0;.00nan;0;0
34622;-1;136;62;42;5;37;.881;3600000;0
34623;220566;138;57;35;3;32;.914;3600000;0
34623;215217;1340;78;53;5;48;.906;3572000;0
34623;212019;1340;0;0;0;0;.00nan;0;0
34623;223929;138;0;0;0;0;.00nan;0;0
34624;204873;129;0;0;0;0;.00nan;0;0
34624;209998;129;53;18;2;16;.889;3600000;0
34624;210060;137;71;34;3;31;.912;3571000;0
34624;-1;137;0;0;0;0;.00nan;0;0
34625;219003;133;0;0;0;0;.00nan;0;0
34625;204779;136;0;0;0;0;.00nan;0;0
34625;-1;133;61;34;4;30;.882;3600000;0
34625;-1;136;88;40;2;38;.950;3600000;0
34626;203288;135;15;23;6;17;.739;3251000;0
34626;208556;135;56;10;0;10;1.000;649000;0
34626;220575;134;54;38;6;32;.842;3345000;0
34626;210876;134;55;3;0;3;1.000;555000;0
34627;204873;129;0;0;0;0;.00nan;0;0
34627;209998;129;31;16;4;12;.750;3550000;0
34627;212529;128;0;0;0;0;.00nan;0;0
34627;-1;128;80;46;3;43;.935;3600000;0
34628;215217;1340;2;13;6;7;.538;1580000;0
34628;210060;137;32;31;6;25;.806;3600000;0
34628;212019;1340;58;16;2;14;.875;2007000;0
34628;-1;137;0;0;0;0;.00nan;0;0
34629;203276;139;0;0;0;0;.00nan;0;0
34629;204815;144;0;0;0;0;.00nan;0;0
34629;206778;144;80;31;3;28;.903;3859000;0
34629;-1;139;78;35;2;33;.943;3859000;0
34630;215128;141;0;0;0;0;.00nan;0;0
34630;210004;141;65;33;3;30;.909;3600000;0
34630;204949;143;0;0;0;0;.00nan;0;0
34630;208201;143;44;33;5;28;.848;3535000;0
34631;208575;142;0;0;0;0;.00nan;0;0
34631;204668;140;64;15;1;14;.933;3600000;0
34631;204881;140;0;0;0;0;.00nan;0;0
34631;217769;142;81;38;2;36;.947;3600000;0
34632;220566;138;0;0;0;0;.00nan;0;0
34632;215217;1340;60;15;2;13;.867;3600000;0
34632;212019;1340;0;0;0;0;.00nan;0;0
34632;223929;138;77;42;4;38;.905;3518000;0
34633;210060;137;0;0;0;0;.00nan;0;0
34633;207304;130;44;21;4;17;.810;3567000;0
34633;-1;137;97;50;3;47;.940;3600000;0
34633;-1;130;0;0;0;0;.00nan;0;0
34634;220566;138;66;31;2;29;.935;3600000;0
34634;212529;128;0;0;0;0;.00nan;0;0
34634;223929;138;0;0;0;0;.00nan;0;0
34634;-1;128;58;25;3;22;.880;3578000;0
34635;220575;134;54;44;6;38;.864;3600000;0
34635;210876;134;0;0;0;0;.00nan;0;0
34635;207304;130;0;0;0;0;.00nan;0;0
34635;-1;130;87;33;2;31;.939;3600000;0
34636;203288;135;81;31;3;28;.903;3600000;0
34636;219003;133;0;0;0;0;.00nan;0;0
34636;208556;135;0;0;0;0;.00nan;0;0
34636;-1;133;52;24;4;20;.833;3588000;0
34637;204873;129;89;47;3;44;.936;3638000;0
34637;209998;129;0;0;0;0;.00nan;0;0
34637;207313;132;0;0;0;0;.00nan;0;0
34637;-1;132;57;29;4;25;.862;3638000;0
34638;208575;142;0;0;0;0;.00nan;0;0
34638;204815;144;0;0;0;0;.00nan;0;0
34638;206778;144;77;25;2;23;.920;3600000;0
34638;217769;142;53;37;5;32;.865;3600000;0
34639;219003;133;36;22;4;18;.818;3600000;0
34639;204779;136;0;0;0;0;.00nan;0;0
34639;-1;133;0;0;0;0;.00nan;0;0
34639;-1;136;48;44;6;38;.864;3549000;0
34640;208609;131;70;25;2;23;.920;3600000;0
34640;215217;1340;67;47;5;42;.894;3600000;0
34640;212019;1340;0;0;0;0;.00nan;0;0
34640;206789;131;0;0;0;0;.00nan;0;0
34641;212529;128;50;37;5;32;.865;3600000;0
34641;207313;132;79;32;2;30;.938;3600000;0
34641;-1;132;0;0;0;0;.00nan;0;0
34641;-1;128;0;0;0;0;.00nan;0;0
34642;204873;129;0;0;0;0;.00nan;0;0
34642;209998;129;67;29;3;26;.897;3600000;0
34642;220575;134;28;21;5;16;.762;3580000;0
34642;210876;134;0;0;0;0;.00nan;0;0
34643;203276;139;76;38;3;35;.921;3900000;0
34643;204949;143;58;33;3;30;.909;3900000;0
34643;208201;143;0;0;0;0;.00nan;0;0
34643;-1;139;0;0;0;0;.00nan;0;0
34644;204668;140;53;33;4;29;.879;3552000;0
34644;215128;141;0;0;0;0;.00nan;0;0
34644;204881;140;0;0;0;0;.00nan;0;0
34644;210004;141;80;38;3;35;.921;3600000;0
34645;204668;140;67;7;0;7;1.000;1401000;0
34645;215128;141;21;20;5;15;.750;3573000;0
34645;204881;140;43;23;4;19;.826;2199000;0
34645;210004;141;0;0;0;0;.00nan;0;0
34646;208609;131;0;0;0;0;.00nan;0;0
34646;220566;138;59;29;3;26;.897;3517000;0
34646;206789;131;89;32;1;31;.969;3600000;0
34646;223929;138;0;0;0;0;.00nan;0;0
34647;204779;136;0;0;0;0;.00nan;0;0
34647;207304;130;0;0;0;0;.00nan;0;0
34647;-1;136;84;31;1;30;.968;3600000;0
34647;-1;130;66;31;3;28;.903;3581000;0
34648;203276;139;0;0;0;0;.00nan;0;0
34648;204815;144;58;43;5;38;.884;3900000;0
34648;206778;144;0;0;0;0;.00nan;0;0
34648;-1;139;51;41;5;36;.878;3900000;0
34649;203288;135;70;39;4;35;.897;3600000;0
34649;208556;135;0;0;0;0;.00nan;0;0
34649;210060;137;10;16;6;10;.625;3523000;0
34649;-1;137;0;0;0;0;.00nan;0;0
34650;204873;129;70;31;2;29;.935;3600000;0
34650;209998;129;0;0;0;0;.00nan;0;0
34650;207304;130;0;0;0;0;.00nan;0;0
34650;-1;130;60;29;4;25;.862;3544000;0
34651;208575;142;0;0;0;0;.00nan;0;0
34651;215128;141;0;0;0;0;.00nan;0;0
34651;210004;141;50;33;5;28;.848;3528000;0
34651;217769;142;55;23;3;20;.870;3600000;0
34652;203276;139;45;33;5;28;.848;3586000;0
34652;204668;140;54;29;4;25;.862;3600000;0
34652;204881;140;0;0;0;0;.00nan;0;0
34652;-1;139;0;0;0;0;.00nan;0;0
34653;219003;133;0;0;0;0;.00nan;0;0
34653;207313;132;50;41;6;35;.854;3600000;0
34653;-1;132;0;0;0;0;.00nan;0;0
34653;-1;133;83;30;2;28;.933;3600000;0
34654;215217;1340;44;30;5;25;.833;3600000;0
34654;212019;1340;0;0;0;0;.00nan;0;0
34654;212529;128;0;0;0;0;.00nan;0;0
34654;-1;128;94;34;1;33;.971;3600000;0
34655;220566;138;0;0;0;0;.00nan;0;0
34655;210060;137;76;25;1;24;.960;3555000;0
34655;223929;138;94;21;0;21;1.000;3600000;0
34655;-1;137;0;0;0;0;.00nan;0;0
34656;220566;138;0;0;0;0;.00nan;0;0
34656;207313;132;0;0;0;0;.00nan;0;0
34656;223929;138;72;41;4;37;.902;3600000;0
34656;-1;132;38;38;7;31;.816;3600000;0
34657;203276;139;47;11;2;9;.818;3600000;0
34657;208575;142;0;0;0;0;.00nan;0;0
34657;217769;142;58;33;4;29;.879;3600000;0
34657;-1;139;0;0;0;0;.00nan;0;0
34658;204668;140;82;34;3;31;.912;3900000;0
34658;204881;140;0;0;0;0;.00nan;0;0
34658;204949;143;60;34;3;31;.912;3900000;0
34658;208201;143;0;0;0;0;.00nan;0;0
34659;204815;144;32;25;5;20;.800;3570000;0
34659;215128;141;0;0;0;0;.00nan;0;0
34659;210004;141;66;35;4;31;.886;3600000;0
34659;206778;144;0;0;0;0;.00nan;0;0
34660;204779;136;0;0;0;0;.00nan;0;0
34660;207304;130;50;10;1;9;.900;1223000;0
34660;-1;136;74;35;3;32;.914;3600000;0
34660;-1;130;37;32;6;26;.813;2377000;0
34661;219003;133;0;0;0;0;.00nan;0;0
34661;220575;134;30;9;3;6;.667;327000;0
34661;210876;134;82;40;3;37;.925;3273000;0
34661;-1;133;84;33;2;31;.939;3600000;0
34662;215217;1340;49;40;5;35;.875;3600000;0
34662;210060;137;68;26;2;24;.923;3600000;0
34662;212019;1340;0;0;0;0;.00nan;0;0
34662;-1;137;0;0;0;0;.00nan;0;0
34663;208609;131;49;16;3;13;.813;3600000;0
34663;206789;131;0;0;0;0;.00nan;0;0
34663;212529;128;0;0;0;0;.00nan;0;0
34663;-1;128;87;38;2;36;.947;3600000;0
34664;203288;135;0;0;0;0;.00nan;0;0
34664;208556;135;54;35;4;31;.886;3554000;0
34664;204873;129;62;28;3;25;.893;3600000;0
34664;209998;129;0;0;0;0;.00nan;0;0
34665;203276;139;0;0;0;0;.00nan;0;0
34665;208575;142;85;39;3;36;.923;3845000;0
34665;217769;142;0;0;0;0;.00nan;0;0
34665;-1;139;70;24;2;22;.917;3838000;0
34666;204815;144;0;0;0;0;.00nan;0;0
34666;215128;141;65;40;6;34;.850;3600000;0
34666;210004;141;0;0;0;0;.00nan;0;0
34666;206778;144;71;38;3;35;.921;3600000;0
34667;204668;140;0;0;0;0;.00nan;0;0
34667;204881;140;57;22;2;20;.909;3600000;0
34667;204949;143;64;12;0;12;1.000;875000;0
34667;208201;143;43;41;6;35;.854;2725000;0
34668;219003;133;52;25;4;21;.840;3761000;0
34668;220575;134;66;32;3;29;.906;3761000;0
34668;210876;134;0;0;0;0;.00nan;0;0
34668;-1;133;0;0;0;0;.00nan;0;0
34669;203288;135;83;34;2;32;.941;3600000;0
34669;208556;135;0;0;0;0;.00nan;0;0
34669;207304;130;0;0;0;0;.00nan;0;0
34669;-1;130;67;36;4;32;.889;3565000;0
34670;204779;136;62;18;1;17;.944;3600000;0
34670;204873;129;0;0;0;0;.00nan;0;0
34670;209998;129;89;39;2;37;.949;3586000;0
34670;-1;136;0;0;0;0;.00nan;0;0
34671;208609;131;0;0;0;0;.00nan;0;0
34671;215217;1340;0;0;0;0;.00nan;0;0
34671;212019;1340;78;39;3;36;.923;3550000;0
34671;206789;131;61;23;2;21;.913;3600000;0
34672;210060;137;0;0;0;0;.00nan;0;0
34672;212529;128;57;33;4;29;.879;3600000;0
34672;-1;128;0;0;0;0;.00nan;0;0
34672;-1;137;100;28;0;28;1.000;3600000;0
34673;220566;138;83;22;1;21;.955;3600000;0
34673;207313;132;67;42;5;37;.881;3600000;0
34673;223929;138;0;0;0;0;.00nan;0;0
34673;-1;132;0;0;0;0;.00nan;0;0
34675;203276;139;56;21;2;19;.905;3588000;0
34675;204949;143;88;31;1;30;.968;3600000;0
34675;205653;139;0;0;0;0;.00nan;0;0
34675;208201;143;0;0;0;0;.00nan;0;0
34677;208575;142;0;0;0;0;.00nan;0;0
34677;204815;144;0;0;0;0;.00nan;0;0
34677;206778;144;61;21;3;18;.857;3548000;0
34677;217769;142;78;35;2;33;.943;3600000;0
34679;204668;140;100;19;0;19;1.000;3600000;0
34679;204881;140;0;0;0;0;.00nan;0;0
34679;-1;128;45;37;6;31;.838;3600000;0
34679;-1;128;0;0;0;0;.00nan;0;0
34681;203288;135;24;24;6;18;.750;2714000;0
34681;208556;135;65;9;0;9;1.000;886000;0
34681;207304;130;0;0;0;0;.00nan;0;0
34681;-1;130;70;23;2;21;.913;3600000;0
34683;208609;131;61;36;4;32;.889;3900000;0
34683;206789;131;0;0;0;0;.00nan;0;0
34683;207313;132;44;25;4;21;.840;3900000;0
34683;-1;132;0;0;0;0;.00nan;0;0
34685;204779;136;44;24;4;20;.833;3575000;0
34685;210213;134;0;0;0;0;.00nan;0;0
34685;210876;134;59;27;3;24;.889;3600000;0
34685;-1;136;0;0;0;0;.00nan;0;0
34687;215128;141;0;0;0;0;.00nan;0;0
34687;210004;141;61;28;3;25;.893;3600000;0
34687;210060;137;82;30;2;28;.933;3600000;0
34687;-1;137;0;0;0;0;.00nan;0;0
34689;219003;133;0;0;0;0;.00nan;0;0
34689;220566;138;40;29;5;24;.828;3600000;0
34689;223929;138;0;0;0;0;.00nan;0;0
34689;-1;133;70;29;2;27;.931;3600000;0
34691;204873;129;71;40;3;37;.925;3565000;0
34691;209998;129;0;0;0;0;.00nan;0;0
34691;215217;1340;55;11;1;10;.909;3600000;0
34691;212019;1340;0;0;0;0;.00nan;0;0
34693;203288;135;60;24;3;21;.875;3900000;0
34693;208556;135;0;0;0;0;.00nan;0;0
34693;208609;131;0;0;0;0;.00nan;0;0
34693;206789;131;51;27;3;24;.889;3900000;0
34695;203276;139;48;25;4;21;.840;3600000;0
34695;210060;137;0;0;0;0;.00nan;0;0
34695;205653;139;0;0;0;0;.00nan;0;0
34695;-1;137;92;38;3;35;.921;3600000;0
34697;215128;141;0;0;0;0;.00nan;0;0
34697;210004;141;61;38;4;34;.895;3600000;0
34697;204949;143;26;20;5;15;.750;3570000;0
34697;208201;143;0;0;0;0;.00nan;0;0
34699;220566;138;70;20;1;19;.950;3600000;0
34699;215217;1340;0;0;0;0;.00nan;0;0
34699;212019;1340;59;40;5;35;.875;3600000;0
34699;223929;138;0;0;0;0;.00nan;0;0
34701;204873;129;0;0;0;0;.00nan;0;0
34701;209998;129;75;39;3;36;.923;3600000;0
34701;-1;128;56;34;4;30;.882;3600000;0
34701;-1;128;0;0;0;0;.00nan;0;0
34703;219003;133;31;19;4;15;.789;3900000;0
34703;210213;134;82;45;4;41;.911;3900000;0
34703;210876;134;0;0;0;0;.00nan;0;0
34703;-1;133;0;0;0;0;.00nan;0;0
34705;204668;140;89;33;1;32;.970;3600000;0
34705;204881;140;0;0;0;0;.00nan;0;0
34705;207304;130;26;22;5;17;.773;3600000;0
34705;-1;130;0;0;0;0;.00nan;0;0
34707;208575;142;86;50;5;45;.900;3621000;0
34707;204815;144;0;0;0;0;.00nan;0;0
34707;206778;144;38;17;4;13;.765;3675000;0
34707;217769;142;0;0;0;0;.00nan;0;0
34709;204779;136;52;26;3;23;.885;3542000;0
34709;207313;132;0;0;0;0;.00nan;0;0
34709;-1;132;66;16;1;15;.938;3600000;0
34709;-1;136;0;0;0;0;.00nan;0;0
34711;203276;139;0;0;0;0;.00nan;0;0
34711;210060;137;68;29;2;27;.931;3600000;0
34711;205653;139;76;30;3;27;.900;3600000;0
34711;-1;137;0;0;0;0;.00nan;0;0
34713;208575;142;0;0;0;0;.00nan;0;0
34713;220566;138;0;0;0;0;.00nan;0;0
34713;217769;142;64;36;4;32;.889;3600000;0
34713;223929;138;91;27;0;27;1.000;3600000;0
34715;203288;135;39;8;2;6;.750;1526000;0
34715;208556;135;36;27;6;21;.778;2074000;0
34715;-1;128;0;0;0;0;.00nan;0;0
34715;-1;128;63;20;1;19;.950;3600000;0
34717;215128;141;57;26;3;23;.885;3600000;0
34717;210004;141;0;0;0;0;.00nan;0;0
34717;207313;132;30;24;6;18;.750;2112000;0
34717;-1;132;49;18;2;16;.889;1488000;0
34719;204668;140;0;0;0;0;.00nan;0;0
34719;204881;140;52;36;6;30;.833;3874000;0
34719;207304;130;0;0;0;0;.00nan;0;0
34719;-1;130;40;32;5;27;.844;3874000;0
34721;219003;133;0;0;0;0;.00nan;0;0
34721;204949;143;0;0;0;0;.00nan;0;0
34721;208201;143;82;42;3;39;.929;3600000;0
34721;-1;133;60;33;4;29;.879;3581000;0
34723;208609;131;62;33;4;29;.879;3547000;0
34723;215217;1340;65;28;3;25;.893;3600000;0
34723;212019;1340;0;0;0;0;.00nan;0;0
34723;206789;131;0;0;0;0;.00nan;0;0
34725;204815;144;68;27;2;25;.926;3600000;0
34725;204873;129;73;40;3;37;.925;3577000;0
34725;209998;129;0;0;0;0;.00nan;0;0
34725;206778;144;0;0;0;0;.00nan;0;0
34727;204779;136;0;0;0;0;.00nan;0;0
34727;210213;134;0;0;0;0;.00nan;0;0
34727;210876;134;68;35;3;32;.914;3600000;0
34727;-1;136;63;39;5;34;.872;3582000;0
34729;208575;142;64;45;5;40;.889;3600000;0
34729;204668;140;61;16;1;15;.938;3600000;0
34729;204881;140;0;0;0;0;.00nan;0;0
34729;217769;142;0;0;0;0;.00nan;0;0
34731;204779;136;48;27;4;23;.852;3600000;0
34731;207304;130;0;0;0;0;.00nan;0;0
34731;-1;136;0;0;0;0;.00nan;0;0
34731;-1;130;27;34;6;28;.824;3600000;0
34733;215217;1340;73;33;3;30;.909;3600000;0
34733;204949;143;64;41;4;37;.902;3600000;0
34733;212019;1340;0;0;0;0;.00nan;0;0
34733;208201;143;0;0;0;0;.00nan;0;0
34735;203288;135;86;38;2;36;.947;3900000;0
34735;208556;135;0;0;0;0;.00nan;0;0
34735;204815;144;0;0;0;0;.00nan;0;0
34735;206778;144;74;28;2;26;.929;3900000;0
34737;203276;139;45;29;4;25;.862;3600000;0
34737;205653;139;0;0;0;0;.00nan;0;0
34737;207313;132;0;0;0;0;.00nan;0;0
34737;-1;132;85;23;1;22;.957;3600000;0
34739;204873;129;0;0;0;0;.00nan;0;0
34739;209998;129;56;42;5;37;.881;3600000;0
34739;-1;128;0;0;0;0;.00nan;0;0
34739;-1;128;65;25;2;23;.920;3600000;0
34741;215128;141;0;0;0;0;.00nan;0;0
34741;210004;141;24;20;5;15;.750;3520000;0
34741;210060;137;0;0;0;0;.00nan;0;0
34741;-1;137;60;32;4;28;.875;3600000;0
34743;220566;138;0;0;0;0;.00nan;0;0
34743;210213;134;0;0;0;0;.00nan;0;0
34743;210876;134;71;33;2;31;.939;3512000;0
34743;223929;138;90;19;0;19;1.000;3600000;0
34745;219003;133;0;0;0;0;.00nan;0;0
34745;208609;131;0;0;0;0;.00nan;0;0
34745;206789;131;48;35;5;30;.857;3600000;0
34745;-1;133;61;30;4;26;.867;3600000;0
34747;219003;133;46;29;4;25;.862;3545000;0
34747;204668;140;0;0;0;0;.00nan;0;0
34747;204881;140;57;22;3;19;.864;3600000;0
34747;-1;133;0;0;0;0;.00nan;0;0
34749;207304;130;78;36;3;33;.917;3600000;0
34749;-1;128;38;25;5;20;.800;3600000;0
34749;-1;128;0;0;0;0;.00nan;0;0
34749;-1;130;0;0;0;0;.00nan;0;0
34751;208609;131;89;30;1;29;.967;3600000;0
34751;210213;134;13;13;5;8;.615;2187000;0
34751;210876;134;41;12;2;10;.833;1413000;0
34751;206789;131;0;0;0;0;.00nan;0;0
34753;204873;129;44;37;5;32;.865;3600000;0
34753;209998;129;0;0;0;0;.00nan;0;0
34753;215217;1340;0;0;0;0;.00nan;0;0
34753;212019;1340;60;21;2;19;.905;3600000;0
34755;203276;139;0;0;0;0;.00nan;0;0
34755;203288;135;64;40;5;35;.875;3519000;0
34755;208556;135;0;0;0;0;.00nan;0;0
34755;205653;139;58;24;3;21;.875;3600000;0
34757;204815;144;72;44;4;40;.909;3900000;0
34757;215128;141;54;32;4;28;.875;3900000;0
34757;210004;141;0;0;0;0;.00nan;0;0
34757;206778;144;0;0;0;0;.00nan;0;0
34759;208575;142;0;0;0;0;.00nan;0;0
34759;220566;138;79;8;0;8;1.000;3600000;0
34759;217769;142;69;54;6;48;.889;3600000;0
34759;223929;138;0;0;0;0;.00nan;0;0
34761;210060;137;36;26;5;21;.808;3600000;0
34761;207313;132;70;28;2;26;.929;3600000;0
34761;-1;132;0;0;0;0;.00nan;0;0
34761;-1;137;0;0;0;0;.00nan;0;0
34763;204779;136;0;0;0;0;.00nan;0;0
34763;204949;143;0;0;0;0;.00nan;0;0
34763;208201;143;74;41;4;37;.902;3538000;0
34763;-1;136;63;22;2;20;.909;3600000;0
34765;215217;1340;56;48;6;42;.875;3600000;0
34765;212019;1340;0;0;0;0;.00nan;0;0
34765;207304;130;0;0;0;0;.00nan;0;0
34765;-1;130;41;15;3;12;.800;3600000;0
34767;219003;133;0;0;0;0;.00nan;0;0
34767;210213;134;42;44;7;37;.841;2954000;0
34767;210876;134;37;8;2;6;.750;646000;0
34767;-1;133;61;24;2;22;.917;3600000;0
34769;204779;136;56;5;0;5;1.000;357000;0
34769;207313;132;0;0;0;0;.00nan;0;0
34769;-1;132;70;17;1;16;.941;3600000;0
34769;-1;136;58;45;6;39;.867;3243000;0
34771;208575;142;0;0;0;0;.00nan;0;0
34771;208609;131;0;0;0;0;.00nan;0;0
34771;206789;131;58;27;3;24;.889;3600000;0
34771;217769;142;74;28;2;26;.929;3600000;0
34773;203288;135;80;35;2;33;.943;3595000;0
34773;208556;135;0;0;0;0;.00nan;0;0
34773;-1;128;92;25;0;25;1.000;3600000;0
34773;-1;128;0;0;0;0;.00nan;0;0
34775;203276;139;60;39;5;34;.872;3577000;0
34775;215128;141;0;0;0;0;.00nan;0;0
34775;210004;141;60;25;3;22;.880;3600000;0
34775;205653;139;0;0;0;0;.00nan;0;0
34777;204815;144;0;0;0;0;.00nan;0;0
34777;220566;138;0;0;0;0;.00nan;0;0
34777;206778;144;93;35;2;33;.943;3600000;0
34777;223929;138;54;32;4;28;.875;3516000;0
34779;204668;140;76;31;1;30;.968;3600000;0
34779;204881;140;0;0;0;0;.00nan;0;0
34779;210060;137;0;0;0;0;.00nan;0;0
34779;-1;137;48;31;4;27;.871;3600000;0
34781;204873;129;0;0;0;0;.00nan;0;0
34781;209998;129;47;42;6;36;.857;3600000;0
34781;204949;143;80;23;1;22;.957;3600000;0
34781;208201;143;0;0;0;0;.00nan;0;0
34783;204949;143;0;0;0;0;.00nan;0;0
34783;208201;143;92;42;3;39;.929;3900000;0
34783;-1;128;49;26;3;23;.885;3900000;0
34783;-1;128;0;0;0;0;.00nan;0;0
34785;204873;129;32;32;6;26;.813;3600000;0
34785;209998;129;0;0;0;0;.00nan;0;0
34785;220566;138;58;20;2;18;.900;3600000;0
34785;223929;138;0;0;0;0;.00nan;0;0
34787;219003;133;45;29;4;25;.862;3600000;0
34787;204668;140;35;30;5;25;.833;3574000;0
34787;204881;140;0;0;0;0;.00nan;0;0
34787;-1;133;0;0;0;0;.00nan;0;0
34789;215217;1340;0;0;0;0;.00nan;0;0
34789;210213;134;0;0;0;0;.00nan;0;0
34789;210876;134;74;39;4;35;.897;3900000;0
34789;212019;1340;51;27;4;23;.852;3900000;0
34791;210060;137;93;38;2;36;.947;3600000;0
34791;207304;130;52;21;3;18;.857;3557000;0
34791;-1;137;0;0;0;0;.00nan;0;0
34791;-1;130;0;0;0;0;.00nan;0;0
34793;208575;142;67;39;4;35;.897;3562000;0
34793;215128;141;64;30;3;27;.900;3600000;0
34793;210004;141;0;0;0;0;.00nan;0;0
34793;217769;142;0;0;0;0;.00nan;0;0
34795;204779;136;46;31;5;26;.839;3600000;0
34795;207313;132;72;24;2;22;.917;3600000;0
34795;-1;132;0;0;0;0;.00nan;0;0
34795;-1;136;0;0;0;0;.00nan;0;0
34797;208609;131;20;31;7;24;.774;3600000;0
34797;204815;144;63;29;3;26;.897;3600000;0
34797;206778;144;0;0;0;0;.00nan;0;0
34797;206789;131;0;0;0;0;.00nan;0;0
34799;203276;139;0;0;0;0;.00nan;0;0
34799;203288;135;100;35;1;34;.971;3600000;0
34799;208556;135;0;0;0;0;.00nan;0;0
34799;205653;139;49;30;4;26;.867;3600000;0
1655;204668;140;62;15;1;14;.933;3600000;0
1655;204881;140;0;0;0;0;.00nan;0;0
1655;220575;134;58;26;3;23;.885;3591000;0
1655;210876;134;0;0;0;0;.00nan;0;0
1656;203288;135;75;48;5;43;.896;3600000;0
1656;208556;135;0;0;0;0;.00nan;0;0
1656;220566;138;0;0;0;0;.00nan;0;0
1656;223929;138;87;26;1;25;.962;3600000;0
1657;215217;1340;100;26;0;26;1.000;3600000;0
1657;212019;1340;0;0;0;0;.00nan;0;0
1657;207313;132;0;0;0;0;.00nan;0;0
1657;-1;132;70;27;2;25;.926;3593000;0
1658;219003;133;0;0;0;0;.00nan;0;0
1658;204873;129;53;32;4;28;.875;3600000;0
1658;209998;129;0;0;0;0;.00nan;0;0
1658;-1;133;78;32;2;30;.938;3600000;0
1659;208609;131;100;41;1;40;.976;3600000;0
1659;204815;144;0;0;0;0;.00nan;0;0
1659;206778;144;71;31;2;29;.935;3568000;0
1659;206789;131;0;0;0;0;.00nan;0;0
1660;203276;139;79;35;2;33;.943;3586000;0
1660;215128;141;0;0;0;0;.00nan;0;0
1660;210004;141;93;35;1;34;.971;3600000;0
1660;-1;139;0;0;0;0;.00nan;0;0
1661;204779;136;0;0;0;0;.00nan;0;0
1661;212529;128;0;0;0;0;.00nan;0;0
1661;-1;128;66;42;4;38;.905;4079000;0
1661;-1;136;79;36;3;33;.917;4079000;0
1662;210060;137;0;0;0;0;.00nan;0;0
1662;207304;130;65;25;3;22;.880;3600000;0
1662;-1;137;40;24;4;20;.833;3553000;0
1662;-1;130;0;0;0;0;.00nan;0;0
1663;204668;140;49;19;3;16;.842;3600000;0
1663;204881;140;0;0;0;0;.00nan;0;0
1663;220575;134;58;42;6;36;.857;3074000;0
1663;210876;134;46;6;1;5;.833;526000;0
1664;203288;135;52;47;6;41;.872;3600000;0
1664;208556;135;0;0;0;0;.00nan;0;0
1664;220566;138;87;38;2;36;.947;3600000;0
1664;223929;138;0;0;0;0;.00nan;0;0
1665;215217;1340;50;41;6;35;.854;3600000;0
1665;212019;1340;0;0;0;0;.00nan;0;0
1665;207313;132;0;0;0;0;.00nan;0;0
1665;-1;132;58;17;2;15;.882;3600000;0
1666;219003;133;0;0;0;0;.00nan;0;0
1666;204873;129;78;41;5;36;.878;4439000;0
1666;209998;129;0;0;0;0;.00nan;0;0
1666;-1;133;46;41;6;35;.854;4440000;0
1667;208609;131;83;44;3;41;.932;3600000;0
1667;204815;144;0;0;0;0;.00nan;0;0
1667;206778;144;41;29;4;25;.862;3584000;0
1667;206789;131;0;0;0;0;.00nan;0;0
1668;203276;139;51;24;3;21;.875;3600000;0
1668;215128;141;0;0;0;0;.00nan;0;0
1668;210004;141;60;43;5;38;.884;3550000;0
1668;-1;139;0;0;0;0;.00nan;0;0
1669;204779;136;0;0;0;0;.00nan;0;0
1669;212529;128;0;0;0;0;.00nan;0;0
1669;-1;128;66;35;4;31;.886;3600000;0
1669;-1;136;100;28;0;28;1.000;3600000;0
1670;210060;137;67;39;5;34;.872;4529000;0
1670;207304;130;67;43;4;39;.907;4529000;0
1670;-1;137;0;0;0;0;.00nan;0;0
1670;-1;130;0;0;0;0;.00nan;0;0
1671;204668;140;55;14;2;12;.857;3600000;0
1671;204881;140;0;0;0;0;.00nan;0;0
1671;220575;134;66;39;5;34;.872;3600000;0
1671;210876;134;0;0;0;0;.00nan;0;0
1672;203288;135;83;29;2;27;.931;3600000;0
1672;208556;135;0;0;0;0;.00nan;0;0
1672;220566;138;56;28;3;25;.893;3600000;0
1672;223929;138;0;0;0;0;.00nan;0;0
1673;215217;1340;44;29;4;25;.862;3600000;0
1673;212019;1340;0;0;0;0;.00nan;0;0
1673;207313;132;0;0;0;0;.00nan;0;0
1673;-1;132;77;26;1;25;.962;3600000;0
1674;219003;133;0;0;0;0;.00nan;0;0
1674;204873;129;100;22;0;22;1.000;3600000;0
1674;209998;129;0;0;0;0;.00nan;0;0
1674;-1;133;76;28;2;26;.929;3557000;0
1675;208609;131;73;34;3;31;.912;3600000;0
1675;204815;144;0;0;0;0;.00nan;0;0
1675;206778;144;45;30;5;25;.833;3549000;0
1675;206789;131;0;0;0;0;.00nan;0;0
1676;203276;139;57;42;5;37;.881;3600000;0
1676;215128;141;0;0;0;0;.00nan;0;0
1676;210004;141;99;24;0;24;1.000;3600000;0
1676;-1;139;0;0;0;0;.00nan;0;0
1677;204779;136;0;0;0;0;.00nan;0;0
1677;212529;128;0;0;0;0;.00nan;0;0
1677;-1;128;57;35;4;31;.886;3548000;0
1677;-1;136;62;20;2;18;.900;3600000;0
1678;210060;137;29;35;7;28;.800;3600000;0
1678;207304;130;67;23;2;21;.913;3600000;0
1678;-1;137;0;0;0;0;.00nan;0;0
1678;-1;130;0;0;0;0;.00nan;0;0
1679;204668;140;77;12;0;12;1.000;3600000;0
1679;204881;140;0;0;0;0;.00nan;0;0
1679;220575;134;21;14;4;10;.714;1139000;0
1679;210876;134;72;29;2;27;.931;2461000;0
1680;203288;135;90;39;2;37;.949;3600000;0
1680;208556;135;0;0;0;0;.00nan;0;0
1680;220566;138;35;29;5;24;.828;3600000;0
1680;223929;138;0;0;0;0;.00nan;0;0
1681;215217;1340;47;25;4;21;.840;2090000;0
1681;212019;1340;41;20;3;17;.850;1510000;0
1681;207313;132;0;0;0;0;.00nan;0;0
1681;-1;132;71;19;1;18;.947;3600000;0
1682;219003;133;0;0;0;0;.00nan;0;0
1682;204873;129;81;36;3;33;.917;3814000;0
1682;209998;129;0;0;0;0;.00nan;0;0
1682;-1;133;84;33;2;31;.939;3814000;0
1683;208609;131;79;45;4;41;.911;3592000;0
1683;204815;144;0;0;0;0;.00nan;0;0
1683;206778;144;40;14;3;11;.786;3600000;0
1683;206789;131;0;0;0;0;.00nan;0;0
1684;203276;139;37;37;7;30;.811;3554000;0
1684;215128;141;0;0;0;0;.00nan;0;0
1684;210004;141;44;32;5;27;.844;3600000;0
1684;-1;139;0;0;0;0;.00nan;0;0
1685;204779;136;0;0;0;0;.00nan;0;0
1685;212529;128;0;0;0;0;.00nan;0;0
1685;-1;128;74;38;3;35;.921;3868000;0
1685;-1;136;65;32;4;28;.875;3868000;0
1686;210060;137;63;36;3;33;.917;3550000;0
1686;207304;130;74;26;2;24;.923;3600000;0
1686;-1;137;0;0;0;0;.00nan;0;0
1686;-1;130;0;0;0;0;.00nan;0;0
1910;203288;135;46;35;6;29;.829;2897000;0
1910;208556;135;65;11;0;11;1.000;703000;0
1910;220566;138;46;17;3;14;.824;3600000;0
1910;223929;138;0;0;0;0;.00nan;0;0
1911;215217;1340;67;33;3;30;.909;3600000;0
1911;212019;1340;0;0;0;0;.00nan;0;0
1911;207313;132;0;0;0;0;.00nan;0;0
1911;-1;132;40;25;5;20;.800;3568000;0
1912;219003;133;0;0;0;0;.00nan;0;0
1912;204873;129;93;43;2;41;.953;5899000;0
1912;209998;129;0;0;0;0;.00nan;0;0
1912;-1;133;99;55;1;54;.982;5899000;0
1913;208609;131;63;38;5;33;.868;3728000;0
1913;204815;144;0;0;0;0;.00nan;0;0
1913;206778;144;50;29;4;25;.862;3728000;0
1913;206789;131;0;0;0;0;.00nan;0;0
1914;203276;139;35;36;7;29;.806;2503000;0
1914;215128;141;0;0;0;0;.00nan;0;0
1914;210004;141;79;25;1;24;.960;3600000;0
1914;-1;139;67;13;0;13;1.000;1097000;0
1915;204779;136;0;0;0;0;.00nan;0;0
1915;212529;128;0;0;0;0;.00nan;0;0
1915;-1;128;71;31;3;28;.903;3643000;0
1915;-1;136;74;27;2;25;.926;3643000;0
1944;203288;135;80;36;2;34;.944;3600000;0
1944;208556;135;0;0;0;0;.00nan;0;0
1944;220566;138;25;27;6;21;.778;3600000;0
1944;223929;138;0;0;0;0;.00nan;0;0
1945;215217;1340;71;45;4;41;.911;3576000;0
1945;212019;1340;0;0;0;0;.00nan;0;0
1945;207313;132;0;0;0;0;.00nan;0;0
1945;-1;132;77;25;2;23;.920;3600000;0
1946;219003;133;0;0;0;0;.00nan;0;0
1946;204873;129;74;30;2;28;.933;3845000;0
1946;209998;129;0;0;0;0;.00nan;0;0
1946;-1;133;86;40;3;37;.925;3845000;0
1947;208609;131;93;32;1;31;.969;3600000;0
1947;204815;144;0;0;0;0;.00nan;0;0
1947;206778;144;51;22;3;19;.864;3553000;0
1947;206789;131;0;0;0;0;.00nan;0;0
1977;203288;135;83;33;2;31;.939;3600000;0
1977;208556;135;0;0;0;0;.00nan;0;0
1977;220566;138;26;32;7;25;.781;3600000;0
1977;223929;138;0;0;0;0;.00nan;0;0
1978;219003;133;0;0;0;0;.00nan;0;0
1978;204873;129;65;31;3;28;.903;3747000;0
1978;209998;129;0;0;0;0;.00nan;0;0
1978;-1;133;67;32;4;28;.875;3747000;0
2050;203288;135;85;40;3;37;.925;3546000;0
2050;208556;135;0;0;0;0;.00nan;0;0
2050;204668;140;66;22;2;20;.909;3600000;0
2050;204881;140;0;0;0;0;.00nan;0;0
2051;208609;131;70;49;5;44;.898;3600000;0
2051;215128;141;0;0;0;0;.00nan;0;0
2051;210004;141;95;20;0;20;1.000;3600000;0
2051;206789;131;0;0;0;0;.00nan;0;0
2052;204779;136;0;0;0;0;.00nan;0;0
2052;207304;130;28;28;6;22;.786;2994000;0
2052;-1;136;55;26;3;23;.885;3600000;0
2052;-1;130;55;5;0;5;1.000;606000;0
2053;204873;129;49;31;5;26;.839;3555000;0
2053;209998;129;0;0;0;0;.00nan;0;0
2053;207313;132;0;0;0;0;.00nan;0;0
2053;-1;132;47;27;4;23;.852;3600000;0
2054;203288;135;42;38;6;32;.842;3600000;0
2054;208556;135;0;0;0;0;.00nan;0;0
2054;204668;140;70;21;1;20;.952;3600000;0
2054;204881;140;0;0;0;0;.00nan;0;0
2055;208609;131;100;34;1;33;.971;3711000;0
2055;215128;141;0;0;0;0;.00nan;0;0
2055;210004;141;60;19;2;17;.895;3711000;0
2055;206789;131;0;0;0;0;.00nan;0;0
2056;204779;136;0;0;0;0;.00nan;0;0
2056;207304;130;42;22;4;18;.818;3600000;0
2056;-1;136;47;33;5;28;.848;3570000;0
2056;-1;130;0;0;0;0;.00nan;0;0
2057;204873;129;92;36;1;35;.972;4303000;0
2057;209998;129;0;0;0;0;.00nan;0;0
2057;207313;132;0;0;0;0;.00nan;0;0
2057;-1;132;71;34;2;32;.941;4303000;0
2058;203288;135;76;44;4;40;.909;3527000;0
2058;208556;135;0;0;0;0;.00nan;0;0
2058;204668;140;65;19;2;17;.895;3600000;0
2058;204881;140;0;0;0;0;.00nan;0;0
2059;208609;131;67;38;4;34;.895;3600000;0
2059;215128;141;0;0;0;0;.00nan;0;0
2059;210004;141;89;16;0;16;1.000;3600000;0
2059;206789;131;0;0;0;0;.00nan;0;0
2060;204779;136;0;0;0;0;.00nan;0;0
2060;207304;130;36;12;3;9;.750;3600000;0
2060;-1;136;64;52;6;46;.885;3600000;0
2060;-1;130;0;0;0;0;.00nan;0;0
2061;204873;129;77;33;3;30;.909;3600000;0
2061;209998;129;0;0;0;0;.00nan;0;0
2061;207313;132;0;0;0;0;.00nan;0;0
2061;-1;132;90;19;0;19;1.000;3600000;0
2062;203288;135;87;36;2;34;.944;3600000;0
2062;208556;135;0;0;0;0;.00nan;0;0
2062;204668;140;79;23;1;22;.957;3600000;0
2062;204881;140;0;0;0;0;.00nan;0;0
2063;208609;131;45;26;4;22;.846;3600000;0
2063;215128;141;0;0;0;0;.00nan;0;0
2063;210004;141;81;24;1;23;.958;3600000;0
2063;206789;131;0;0;0;0;.00nan;0;0
2064;204779;136;0;0;0;0;.00nan;0;0
2064;207304;130;53;37;5;32;.865;4457000;0
2064;-1;136;47;51;6;45;.882;4457000;0
2064;-1;130;0;0;0;0;.00nan;0;0
2065;204873;129;81;36;2;34;.944;3855000;0
2065;209998;129;0;0;0;0;.00nan;0;0
2065;207313;132;0;0;0;0;.00nan;0;0
2065;-1;132;82;26;1;25;.962;3855000;0
2299;208609;131;50;31;4;27;.871;3587000;0
2299;215128;141;0;0;0;0;.00nan;0;0
2299;210004;141;64;23;2;21;.913;3600000;0
2299;206789;131;0;0;0;0;.00nan;0;0
2300;204779;136;0;0;0;0;.00nan;0;0
2300;207304;130;47;35;5;30;.857;3560000;0
2300;-1;136;44;24;4;20;.833;3600000;0
2300;-1;130;0;0;0;0;.00nan;0;0
2301;204873;129;72;34;3;31;.912;3600000;0
2301;209998;129;0;0;0;0;.00nan;0;0
2301;207313;132;0;0;0;0;.00nan;0;0
2301;-1;132;72;29;2;27;.931;3600000;0
2366;204779;136;0;0;0;0;.00nan;0;0
2366;207304;130;42;36;6;30;.833;3600000;0
2366;-1;136;80;35;3;32;.914;3600000;0
2366;-1;130;0;0;0;0;.00nan;0;0
2391;204779;136;0;0;0;0;.00nan;0;0
2391;207304;130;61;42;5;37;.881;3600000;0
2391;-1;136;92;25;1;24;.960;3600000;0
2391;-1;130;0;0;0;0;.00nan;0;0
2437;204668;140;100;23;0;23;1.000;3600000;0
2437;204779;136;0;0;0;0;.00nan;0;0
2437;204881;140;0;0;0;0;.00nan;0;0
2437;-1;136;81;38;2;36;.947;3529000;0
2438;215128;141;0;0;0;0;.00nan;0;0
2438;210004;141;83;32;2;30;.938;3667000;0
2438;207313;132;0;0;0;0;.00nan;0;0
2438;-1;132;78;35;3;32;.914;3667000;0
2439;204668;140;63;17;1;16;.941;3600000;0
2439;204779;136;0;0;0;0;.00nan;0;0
2439;204881;140;0;0;0;0;.00nan;0;0
2439;-1;136;75;30;3;27;.900;3577000;0
2440;215128;141;0;0;0;0;.00nan;0;0
2440;210004;141;90;43;2;41;.953;3752000;0
2440;207313;132;0;0;0;0;.00nan;0;0
2440;-1;132;95;35;1;34;.971;3752000;0
2441;204668;140;61;18;2;16;.889;3600000;0
2441;204779;136;0;0;0;0;.00nan;0;0
2441;204881;140;0;0;0;0;.00nan;0;0
2441;-1;136;45;44;6;38;.864;3600000;0
2442;215128;141;0;0;0;0;.00nan;0;0
2442;210004;141;70;31;4;27;.871;3600000;0
2442;207313;132;58;36;4;32;.889;3192000;0
2442;-1;132;26;5;3;2;.400;408000;0
2443;204668;140;73;24;2;22;.917;3600000;0
2443;204779;136;0;0;0;0;.00nan;0;0
2443;204881;140;0;0;0;0;.00nan;0;0
2443;-1;136;59;30;3;27;.900;3551000;0
2444;215128;141;0;0;0;0;.00nan;0;0
2444;210004;141;58;31;5;26;.839;3600000;0
2444;207313;132;0;0;0;0;.00nan;0;0
2444;-1;132;92;17;0;17;1.000;3600000;0
2547;215128;141;0;0;0;0;.00nan;0;0
2547;210004;141;76;32;3;29;.906;3600000;0
2547;207313;132;0;0;0;0;.00nan;0;0
2547;-1;132;84;32;2;30;.938;3600000;0
2612;215128;141;0;0;0;0;.00nan;0;0
2612;210004;141;77;35;3;32;.914;3563000;0
2612;207313;132;0;0;0;0;.00nan;0;0
2612;-1;132;79;27;1;26;.963;3600000;0
2632;204668;140;37;25;5;20;.800;3600000;0
2632;204881;140;0;0;0;0;.00nan;0;0
2632;207313;132;0;0;0;0;.00nan;0;0
2632;-1;132;37;44;7;37;.841;3579000;0
2633;204668;140;45;30;4;26;.867;3600000;0
2633;204881;140;0;0;0;0;.00nan;0;0
2633;207313;132;63;20;1;19;.950;1619000;0
2633;-1;132;38;23;4;19;.826;1981000;0
2634;204668;140;49;12;2;10;.833;3600000;0
2634;204881;140;0;0;0;0;.00nan;0;0
2634;207313;132;34;30;6;24;.800;3344000;0
2634;-1;132;54;5;0;5;1.000;256000;0
2635;204668;140;67;19;2;17;.895;3577000;0
2635;204881;140;0;0;0;0;.00nan;0;0
2635;207313;132;99;37;1;36;.973;3600000;0
2635;-1;132;0;0;0;0;.00nan;0;0
2712;204668;140;63;28;3;25;.893;3600000;0
2712;204881;140;0;0;0;0;.00nan;0;0
2712;207313;132;60;40;5;35;.875;3543000;0
2712;-1;132;0;0;0;0;.00nan;0;0
35023;-1;189;59;33;4;29;.879;3211000;0
35023;192547;190;70;30;3;27;.900;3600000;0
35023;-1;190;0;0;0;0;.00nan;0;0
35023;-1;189;32;11;3;8;.727;389000;0
34834;206800;225;52;35;5;30;.857;3578000;0
34834;180377;228;0;0;0;0;.00nan;0;0
34834;-1;225;0;0;0;0;.00nan;0;0
34834;208044;228;70;30;3;27;.900;3600000;0
34818;205788;207;83;41;3;38;.927;3600000;0
34818;-1;199;0;0;0;0;.00nan;0;0
34818;197853;207;0;0;0;0;.00nan;0;0
34818;-1;199;41;32;5;27;.844;3541000;0
34833;187689;230;66;30;4;26;.867;3600000;0
34833;183678;230;0;0;0;0;.00nan;0;0
34833;183695;232;31;29;6;23;.793;2755000;0
34833;-1;232;53;10;1;9;.900;845000;0
34829;200437;201;76;36;3;33;.917;3537000;0
34829;205681;226;0;0;0;0;.00nan;0;0
34829;208048;201;0;0;0;0;.00nan;0;0
34829;-1;226;63;16;1;15;.938;3600000;0
34820;192862;187;76;25;1;24;.960;3713000;0
34820;210504;193;79;31;2;29;.935;3713000;0
34820;189529;193;0;0;0;0;.00nan;0;0
34820;-1;187;0;0;0;0;.00nan;0;0
34831;191130;186;86;31;1;30;.968;3600000;0
34831;-1;180;39;33;6;27;.818;3600000;0
34831;213507;186;0;0;0;0;.00nan;0;0
34831;208383;180;0;0;0;0;.00nan;0;0
34853;192915;179;55;26;3;23;.885;3515000;0
34853;196571;177;83;25;1;24;.960;3600000;0
34853;187355;179;0;0;0;0;.00nan;0;0
34853;-1;177;0;0;0;0;.00nan;0;0
34923;201525;203;92;41;3;38;.927;3600000;0
34923;201560;202;57;40;5;35;.875;3549000;0
34923;212028;202;0;0;0;0;.00nan;0;0
34923;206772;203;0;0;0;0;.00nan;0;0
34981;194219;4960;100;38;1;37;.974;3600000;0
34981;209915;231;0;0;0;0;.00nan;0;0
34981;189773;231;59;29;3;26;.897;3578000;0
34981;206971;4960;0;0;0;0;.00nan;0;0
35064;192939;208;81;24;1;23;.958;3600000;0
35064;196283;206;0;0;0;0;.00nan;0;0
35064;-1;208;0;0;0;0;.00nan;0;0
35064;202998;206;71;34;2;32;.941;3577000;0
34984;200333;194;0;0;0;0;.00nan;0;0
34984;201585;197;72;33;3;30;.909;3515000;0
34984;206822;197;0;0;0;0;.00nan;0;0
34984;196352;194;91;23;1;22;.957;3600000;0
34900;190164;4959;38;36;6;30;.833;3600000;0
34900;206801;176;90;12;0;12;1.000;3600000;0
34900;-1;4959;0;0;0;0;.00nan;0;0
34900;203099;176;0;0;0;0;.00nan;0;0
34870;192929;222;77;24;1;23;.958;3600000;0
34870;191120;223;0;0;0;0;.00nan;0;0
34870;187118;223;94;40;2;38;.950;3564000;0
34870;213560;222;0;0;0;0;.00nan;0;0
34880;-1;192;50;18;3;15;.833;3900000;0
34880;207398;192;0;0;0;0;.00nan;0;0
34880;191118;196;0;0;0;0;.00nan;0;0
34880;202830;196;70;36;3;33;.917;3900000;0
34878;190038;181;99;26;0;26;1.000;3600000;0
34878;191518;214;70;34;3;31;.912;3600000;0
34878;192552;181;0;0;0;0;.00nan;0;0
34878;202914;214;0;0;0;0;.00nan;0;0
35101;201495;213;82;41;2;39;.951;3578000;0
35101;-1;213;0;0;0;0;.00nan;0;0
35101;197672;210;73;20;1;19;.950;3600000;0
35101;-1;210;0;0;0;0;.00nan;0;0
34800;200452;221;46;31;5;26;.839;3566000;0
34800;201514;227;63;27;3;24;.889;3600000;0
34800;213280;227;0;0;0;0;.00nan;0;0
34800;-1;221;0;0;0;0;.00nan;0;0
34805;182467;185;76;45;3;42;.933;3587000;0
34805;-1;220;0;0;0;0;.00nan;0;0
34805;-1;220;72;21;1;20;.952;3600000;0
34805;-1;185;0;0;0;0;.00nan;0;0
34811;205769;200;0;0;0;0;.00nan;0;0
34811;195238;200;87;29;1;28;.966;3600000;0
34811;201524;205;0;0;0;0;.00nan;0;0
34811;-1;205;71;50;5;45;.900;3600000;0
34802;-1;209;0;0;0;0;.00nan;0;0
34802;-1;2620;0;0;0;0;.00nan;0;0
34802;213550;2620;51;18;3;15;.833;3900000;0
34802;213590;209;64;32;3;29;.906;3900000;0
34808;195251;4949;61;25;2;23;.920;3600000;0
34808;213399;216;70;34;3;31;.912;3600000;0
34808;-1;4949;0;0;0;0;.00nan;0;0
34808;-1;216;0;0;0;0;.00nan;0;0
34803;188977;215;0;0;0;0;.00nan;0;0
34803;210794;215;80;38;3;35;.921;3514000;0
34803;191063;211;0;0;0;0;.00nan;0;0
34803;-1;211;100;38;1;37;.974;3600000;0
34816;211942;183;68;40;3;37;.925;3552000;0
34816;196237;183;0;0;0;0;.00nan;0;0
34816;-1;178;0;0;0;0;.00nan;0;0
34816;-1;178;72;27;2;25;.926;3600000;0
34814;195164;218;57;34;4;30;.882;3573000;0
34814;184874;212;0;0;0;0;.00nan;0;0
34814;-1;212;72;36;3;33;.917;3600000;0
34814;208051;218;0;0;0;0;.00nan;0;0
34806;200444;224;47;26;4;22;.846;3872000;0
34806;210998;229;0;0;0;0;.00nan;0;0
34806;185960;229;67;52;5;47;.904;3872000;0
34806;208372;224;0;0;0;0;.00nan;0;0
34807;209840;184;0;0;0;0;.00nan;0;0
34807;205837;184;52;27;4;23;.852;3523000;0
34807;-1;1371;81;30;2;28;.933;3600000;0
34807;-1;1371;0;0;0;0;.00nan;0;0
34958;194219;4960;90;21;0;21;1.000;3600000;0
34958;206971;4960;0;0;0;0;.00nan;0;0
34958;191120;223;0;0;0;0;.00nan;0;0
34958;187118;223;95;42;2;40;.952;3565000;0
35045;194893;191;12;18;6;12;.667;1706000;0
35045;201585;197;85;49;4;45;.918;3600000;0
35045;206822;197;0;0;0;0;.00nan;0;0
35045;201892;191;55;11;1;10;.909;1894000;0
34895;201495;213;63;39;4;35;.897;3600000;0
34895;211942;183;68;16;1;15;.938;3600000;0
34895;196237;183;0;0;0;0;.00nan;0;0
34895;-1;213;0;0;0;0;.00nan;0;0
36185;195251;4949;53;28;4;24;.857;3600000;0
36185;197672;210;80;25;1;24;.960;3600000;0
36185;-1;4949;0;0;0;0;.00nan;0;0
36185;-1;210;0;0;0;0;.00nan;0;0
36184;187689;230;52;22;3;19;.864;3600000;0
36184;183678;230;0;0;0;0;.00nan;0;0
36184;200444;224;37;31;5;26;.839;3581000;0
36184;208372;224;0;0;0;0;.00nan;0;0
34993;-1;219;84;17;0;17;1.000;3600000;0
34993;-1;219;0;0;0;0;.00nan;0;0
34993;191130;186;0;0;0;0;.00nan;0;0
34993;213507;186;73;49;3;46;.939;3600000;0
34912;210134;1505;52;23;3;20;.870;3600000;0
34912;-1;178;53;8;1;7;.875;681000;0
34912;-1;1505;0;0;0;0;.00nan;0;0
34912;-1;178;53;43;6;37;.860;2919000;0
34874;198149;188;0;0;0;0;.00nan;0;0
34874;184409;188;70;25;2;23;.920;3900000;0
34874;191118;196;86;39;2;37;.949;3900000;0
34874;202830;196;0;0;0;0;.00nan;0;0
34885;210504;193;79;12;0;12;1.000;3600000;0
34885;189529;193;0;0;0;0;.00nan;0;0
34885;184788;198;0;0;0;0;.00nan;0;0
34885;212143;198;67;41;4;37;.902;3600000;0
34871;206801;176;89;35;2;33;.943;3600000;0
34871;-1;2620;53;46;6;40;.870;3600000;0
34871;203099;176;0;0;0;0;.00nan;0;0
34871;213550;2620;0;0;0;0;.00nan;0;0
34801;182467;185;87;30;1;29;.967;3600000;0
34801;190038;181;0;0;0;0;.00nan;0;0
34801;-1;185;0;0;0;0;.00nan;0;0
34801;192552;181;89;36;2;34;.944;3600000;0
36188;200306;182;84;27;1;26;.963;3600000;0
36188;185810;182;0;0;0;0;.00nan;0;0
36188;-1;1371;77;38;3;35;.921;3584000;0
36188;-1;1371;0;0;0;0;.00nan;0;0
34830;184874;212;0;0;0;0;.00nan;0;0
34830;191063;211;0;0;0;0;.00nan;0;0
34830;-1;212;78;23;1;22;.957;3600000;0
34830;-1;211;84;54;4;50;.926;3600000;0
34851;184788;198;0;0;0;0;.00nan;0;0
34851;-1;192;57;20;3;17;.850;3600000;0
34851;212143;198;48;27;4;23;.852;3549000;0
34851;207398;192;0;0;0;0;.00nan;0;0
34859;192862;187;0;0;0;0;.00nan;0;0
34859;207061;195;66;33;3;30;.909;3563000;0
34859;196465;195;0;0;0;0;.00nan;0;0
34859;-1;187;86;39;2;37;.949;3600000;0
34849;201524;205;0;0;0;0;.00nan;0;0
34849;201560;202;53;33;4;29;.879;3600000;0
34849;212028;202;0;0;0;0;.00nan;0;0
34849;-1;205;86;32;1;31;.969;3600000;0
34850;194893;191;71;19;1;18;.947;3600000;0
34850;201892;191;0;0;0;0;.00nan;0;0
34850;192547;190;73;43;4;39;.907;3600000;0
34850;-1;190;0;0;0;0;.00nan;0;0
36196;195164;218;96;42;2;40;.952;3900000;0
36196;-1;219;99;41;2;39;.951;3900000;0
36196;-1;219;0;0;0;0;.00nan;0;0
36196;208051;218;0;0;0;0;.00nan;0;0
35220;209840;184;51;20;3;17;.850;1535000;0
35220;200306;182;0;0;0;0;.00nan;0;0
35220;205837;184;9;16;6;10;.625;2065000;0
35220;185810;182;57;27;3;24;.889;3600000;0
34826;209915;231;0;0;0;0;.00nan;0;0
34826;210998;229;0;0;0;0;.00nan;0;0
34826;189773;231;50;38;5;33;.868;3600000;0
34826;185960;229;74;28;2;26;.929;3600000;0
34824;192939;208;75;37;3;34;.919;3677000;0
34824;201525;203;71;44;4;40;.909;3658000;0
34824;206772;203;0;0;0;0;.00nan;0;0
34824;-1;208;0;0;0;0;.00nan;0;0
34924;192915;179;95;22;0;22;1.000;3600000;0
34924;210134;1505;0;0;0;0;.00nan;0;0
34924;187355;179;0;0;0;0;.00nan;0;0
34924;-1;1505;78;20;1;19;.950;3555000;0
34823;-1;220;0;0;0;0;.00nan;0;0
34823;-1;220;73;30;2;28;.933;3579000;0
34823;191518;214;100;30;0;30;1.000;3600000;0
34823;202914;214;0;0;0;0;.00nan;0;0
34822;205788;207;0;0;0;0;.00nan;0;0
34822;-1;199;0;0;0;0;.00nan;0;0
34822;197853;207;72;27;2;25;.926;3600000;0
34822;-1;199;42;30;5;25;.833;3600000;0
34815;188977;215;0;0;0;0;.00nan;0;0
34815;210794;215;59;39;4;35;.897;3600000;0
34815;190034;217;74;23;1;22;.957;3600000;0
34815;190041;217;0;0;0;0;.00nan;0;0
34821;196571;177;62;27;4;23;.852;3600000;0
34821;213399;216;0;0;0;0;.00nan;0;0
34821;-1;216;99;22;0;22;1.000;3600000;0
34821;-1;177;0;0;0;0;.00nan;0;0
34819;205681;226;0;0;0;0;.00nan;0;0
34819;205769;200;0;0;0;0;.00nan;0;0
34819;195238;200;58;32;4;28;.875;3600000;0
34819;-1;226;69;11;1;10;.909;3600000;0
34901;206800;225;0;0;0;0;.00nan;0;0
34901;180377;228;89;36;3;33;.917;3900000;0
34901;-1;225;57;28;3;25;.893;3900000;0
34901;208044;228;0;0;0;0;.00nan;0;0
34838;200437;201;85;36;2;34;.944;3900000;0
34838;189902;204;70;27;2;25;.926;3900000;0
34838;208048;201;0;0;0;0;.00nan;0;0
34838;203120;204;0;0;0;0;.00nan;0;0
34810;183695;232;58;34;4;30;.882;3538000;0
34810;200452;221;87;36;2;34;.944;3600000;0
34810;-1;221;0;0;0;0;.00nan;0;0
34810;-1;232;0;0;0;0;.00nan;0;0
34869;198149;188;0;0;0;0;.00nan;0;0
34869;200333;194;100;26;0;26;1.000;3600000;0
34869;184409;188;37;33;6;27;.818;3600000;0
34869;196352;194;0;0;0;0;.00nan;0;0
34839;190164;4959;0;0;0;0;.00nan;0;0
34839;-1;209;97;35;1;34;.971;3900000;0
34839;-1;4959;86;31;1;30;.968;3900000;0
34839;213590;209;0;0;0;0;.00nan;0;0
34844;192929;222;0;0;0;0;.00nan;0;0
34844;201514;227;65;32;3;29;.906;3600000;0
34844;213280;227;0;0;0;0;.00nan;0;0
34844;213560;222;41;36;5;31;.861;3563000;0
34991;206801;176;60;24;2;22;.917;3600000;0
34991;-1;2620;60;35;4;31;.886;3528000;0
34991;203099;176;0;0;0;0;.00nan;0;0
34991;213550;2620;0;0;0;0;.00nan;0;0
36067;196283;206;0;0;0;0;.00nan;0;0
36067;-1;199;55;35;4;31;.886;3600000;0
36067;-1;199;0;0;0;0;.00nan;0;0
36067;202998;206;65;13;1;12;.923;3600000;0
35294;211942;183;0;0;0;0;.00nan;0;0
35294;196237;183;54;18;2;16;.889;3600000;0
35294;197672;210;0;0;0;0;.00nan;0;0
35294;-1;210;39;29;5;24;.828;3600000;0
35211;192862;187;70;24;2;22;.917;3575000;0
35211;191118;196;77;25;1;24;.960;3600000;0
35211;-1;187;0;0;0;0;.00nan;0;0
35211;202830;196;0;0;0;0;.00nan;0;0
34919;205788;207;0;0;0;0;.00nan;0;0
34919;189902;204;23;26;7;19;.731;3627000;0
34919;197853;207;38;36;6;30;.833;3627000;0
34919;203120;204;0;0;0;0;.00nan;0;0
35252;194219;4960;90;18;0;18;1.000;3900000;0
35252;210998;229;96;42;0;42;1.000;3900000;0
35252;206971;4960;0;0;0;0;.00nan;0;0
35252;185960;229;0;0;0;0;.00nan;0;0
34893;210504;193;76;30;2;28;.933;3600000;0
34893;189529;193;0;0;0;0;.00nan;0;0
34893;207061;195;56;31;4;27;.871;3577000;0
34893;196465;195;0;0;0;0;.00nan;0;0
34881;201495;213;0;0;0;0;.00nan;0;0
34881;196571;177;0;0;0;0;.00nan;0;0
34881;-1;213;86;39;2;37;.949;3600000;0
34881;-1;177;46;25;4;21;.840;3515000;0
34835;184874;212;0;0;0;0;.00nan;0;0
34835;191063;211;84;38;2;36;.947;3600000;0
34835;-1;212;38;22;5;17;.773;3600000;0
34835;-1;211;0;0;0;0;.00nan;0;0
34855;-1;189;0;0;0;0;.00nan;0;0
34855;192547;190;0;0;0;0;.00nan;0;0
34855;-1;190;90;30;1;29;.967;3600000;0
34855;-1;189;52;29;4;25;.862;3600000;0
34840;192929;222;0;0;0;0;.00nan;0;0
34840;187689;230;0;0;0;0;.00nan;0;0
34840;183678;230;50;18;3;15;.833;3900000;0
34840;213560;222;78;42;3;39;.929;3900000;0
34857;200437;201;0;0;0;0;.00nan;0;0
34857;201524;205;0;0;0;0;.00nan;0;0
34857;208048;201;78;39;3;36;.923;3600000;0
34857;-1;205;40;26;5;21;.808;3516000;0
34957;205681;226;0;0;0;0;.00nan;0;0
34957;196283;206;73;49;5;44;.898;3600000;0
34957;-1;226;71;30;3;27;.900;3600000;0
34957;202998;206;0;0;0;0;.00nan;0;0
35345;190164;4959;0;0;0;0;.00nan;0;0
35345;-1;4959;80;41;3;38;.927;3600000;0
35345;-1;2620;0;0;0;0;.00nan;0;0
35345;213550;2620;48;37;5;32;.865;3542000;0
34882;191518;214;71;39;5;34;.872;3600000;0
34882;202914;214;0;0;0;0;.00nan;0;0
34882;-1;1371;0;0;0;0;.00nan;0;0
34882;-1;1371;62;34;4;30;.882;3600000;0
34836;184874;212;77;37;4;33;.892;3600000;0
34836;191130;186;0;0;0;0;.00nan;0;0
34836;-1;212;0;0;0;0;.00nan;0;0
34836;213507;186;60;41;5;36;.878;3600000;0
34809;182467;185;0;0;0;0;.00nan;0;0
34809;190038;181;0;0;0;0;.00nan;0;0
34809;-1;185;92;40;3;37;.925;3562000;0
34809;192552;181;56;15;2;13;.867;3600000;0
34832;200306;182;0;0;0;0;.00nan;0;0
34832;-1;220;0;0;0;0;.00nan;0;0
34832;-1;220;84;38;2;36;.947;3600000;0
34832;185810;182;55;26;3;23;.885;3564000;0
34837;209915;231;0;0;0;0;.00nan;0;0
34837;189773;231;73;17;1;16;.941;3600000;0
34837;206800;225;0;0;0;0;.00nan;0;0
34837;-1;225;80;47;4;43;.915;3600000;0
34812;200444;224;0;0;0;0;.00nan;0;0
34812;200452;221;83;44;3;41;.932;3594000;0
34812;208372;224;81;26;1;25;.962;3600000;0
34812;-1;221;0;0;0;0;.00nan;0;0
34817;188977;215;78;42;3;39;.929;3600000;0
34817;210794;215;0;0;0;0;.00nan;0;0
34817;-1;180;81;20;2;18;.900;3600000;0
34817;208383;180;0;0;0;0;.00nan;0;0
35079;194219;4960;34;24;5;19;.792;3111000;0
35079;183695;232;0;0;0;0;.00nan;0;0
35079;206971;4960;49;2;0;2;1.000;489000;0
35079;-1;232;91;31;1;30;.968;3600000;0
34842;187689;230;79;24;1;23;.958;3600000;0
34842;183678;230;0;0;0;0;.00nan;0;0
34842;180377;228;98;50;2;48;.960;3600000;0
34842;208044;228;0;0;0;0;.00nan;0;0
35011;206801;176;89;31;1;30;.968;3600000;0
35011;186332;4864;0;0;0;0;.00nan;0;0
35011;202801;4864;51;36;5;31;.861;3600000;0
35011;203099;176;0;0;0;0;.00nan;0;0
34899;192915;179;69;29;2;27;.931;3600000;0
34899;187355;179;0;0;0;0;.00nan;0;0
34899;213399;216;0;0;0;0;.00nan;0;0
34899;-1;216;46;24;5;19;.792;3600000;0
34972;201585;197;77;36;3;33;.917;3558000;0
34972;206822;197;0;0;0;0;.00nan;0;0
34972;-1;192;63;22;2;20;.909;3600000;0
34972;207398;192;0;0;0;0;.00nan;0;0
34804;205769;200;0;0;0;0;.00nan;0;0
34804;195238;200;69;24;2;22;.917;3600000;0
34804;201525;203;0;0;0;0;.00nan;0;0
34804;206772;203;51;35;5;30;.857;3600000;0
34847;192939;208;79;30;1;29;.967;3600000;0
34847;201560;202;73;30;2;28;.933;3545000;0
34847;212028;202;0;0;0;0;.00nan;0;0
34847;-1;208;0;0;0;0;.00nan;0;0
34858;201514;227;0;0;0;0;.00nan;0;0
34858;191120;223;0;0;0;0;.00nan;0;0
34858;187118;223;99;46;1;45;.978;3600000;0
34858;213280;227;53;18;2;16;.889;3568000;0
36141;200333;194;67;31;3;28;.903;3567000;0
36141;184788;198;0;0;0;0;.00nan;0;0
36141;212143;198;80;26;1;25;.962;3600000;0
36141;196352;194;0;0;0;0;.00nan;0;0
34956;201495;213;89;48;4;44;.917;3600000;0
34956;211942;183;70;20;1;19;.950;3600000;0
34956;196237;183;0;0;0;0;.00nan;0;0
34956;-1;213;0;0;0;0;.00nan;0;0
34921;195251;4949;100;32;0;32;1.000;3600000;0
34921;-1;178;0;0;0;0;.00nan;0;0
34921;-1;4949;0;0;0;0;.00nan;0;0
34921;-1;178;70;38;4;34;.895;3600000;0
36001;192915;179;0;0;0;0;.00nan;0;0
36001;196571;177;91;18;0;18;1.000;3600000;0
36001;187355;179;67;40;4;36;.900;3600000;0
36001;-1;177;0;0;0;0;.00nan;0;0
34930;-1;192;0;0;0;0;.00nan;0;0
34930;207398;192;76;34;2;32;.941;3600000;0
34930;-1;189;0;0;0;0;.00nan;0;0
34930;-1;189;65;35;4;31;.886;3535000;0
34918;192862;187;0;0;0;0;.00nan;0;0
34918;210504;193;0;0;0;0;.00nan;0;0
34918;189529;193;61;27;3;24;.889;3600000;0
34918;-1;187;78;48;5;43;.896;3567000;0
34927;205681;226;72;22;1;21;.955;3600000;0
34927;189902;204;0;0;0;0;.00nan;0;0
34927;-1;226;0;0;0;0;.00nan;0;0
34927;203120;204;74;35;2;33;.943;3584000;0
35320;182467;185;100;28;0;28;1.000;3600000;0
35320;-1;220;64;33;3;30;.909;3539000;0
35320;-1;220;0;0;0;0;.00nan;0;0
35320;-1;185;0;0;0;0;.00nan;0;0
34973;184788;198;58;13;1;12;.923;3600000;0
34973;201585;197;98;46;3;43;.935;3600000;0
34973;206822;197;0;0;0;0;.00nan;0;0
34973;212143;198;0;0;0;0;.00nan;0;0
34813;209840;184;80;30;2;28;.933;3558000;0
34813;205837;184;0;0;0;0;.00nan;0;0
34813;190038;181;0;0;0;0;.00nan;0;0
34813;192552;181;97;23;0;23;1.000;3600000;0
34843;200437;201;74;22;1;21;.955;3600000;0
34843;205769;200;58;35;4;31;.886;3600000;0
34843;195238;200;0;0;0;0;.00nan;0;0
34843;208048;201;0;0;0;0;.00nan;0;0
34922;205788;207;0;0;0;0;.00nan;0;0
34922;-1;199;0;0;0;0;.00nan;0;0
34922;197853;207;57;35;4;31;.886;3600000;0
34922;-1;199;100;24;0;24;1.000;3600000;0
34867;200444;224;92;37;2;35;.946;3900000;0
34867;201514;227;72;26;2;24;.923;3900000;0
34867;213280;227;0;0;0;0;.00nan;0;0
34867;208372;224;0;0;0;0;.00nan;0;0
36187;200333;194;88;43;1;42;.977;3574000;0
36187;196352;194;0;0;0;0;.00nan;0;0
36187;191118;196;92;26;0;26;1.000;3600000;0
36187;202830;196;0;0;0;0;.00nan;0;0
35037;195164;218;0;0;0;0;.00nan;0;0
35037;191063;211;0;0;0;0;.00nan;0;0
35037;208051;218;61;21;2;19;.905;3600000;0
35037;-1;211;88;42;3;39;.929;3600000;0
34894;190034;217;76;22;1;21;.955;3600000;0
34894;190041;217;0;0;0;0;.00nan;0;0
34894;191130;186;0;0;0;0;.00nan;0;0
34894;213507;186;84;53;4;49;.925;3600000;0
34877;207061;195;0;0;0;0;.00nan;0;0
34877;196465;195;77;25;2;23;.920;3600000;0
34877;192547;190;51;39;5;34;.872;3600000;0
34877;-1;190;0;0;0;0;.00nan;0;0
34863;186332;4864;73;28;2;26;.929;3600000;0
34863;-1;209;18;9;4;5;.556;614000;0
34863;202801;4864;0;0;0;0;.00nan;0;0
34863;213590;209;92;31;1;30;.968;2986000;0
34866;209915;231;0;0;0;0;.00nan;0;0
34866;210998;229;0;0;0;0;.00nan;0;0
34866;189773;231;68;21;1;20;.952;3600000;0
34866;185960;229;89;54;2;52;.963;3600000;0
34876;-1;219;65;39;4;35;.897;3600000;0
34876;-1;219;0;0;0;0;.00nan;0;0
34876;-1;180;0;0;0;0;.00nan;0;0
34876;208383;180;100;26;0;26;1.000;3600000;0
35139;200306;182;0;0;0;0;.00nan;0;0
35139;185810;182;41;25;4;21;.840;3600000;0
35139;-1;1371;86;27;1;26;.963;3600000;0
35139;-1;1371;0;0;0;0;.00nan;0;0
35024;183695;232;86;33;2;31;.939;3900000;0
35024;206800;225;0;0;0;0;.00nan;0;0
35024;-1;225;82;39;2;37;.949;3900000;0
35024;-1;232;0;0;0;0;.00nan;0;0
34845;192929;222;0;0;0;0;.00nan;0;0
34845;180377;228;75;36;2;34;.944;3768000;0
34845;208044;228;0;0;0;0;.00nan;0;0
34845;213560;222;53;24;3;21;.875;3768000;0
34828;201525;203;92;37;1;36;.973;3600000;0
34828;201560;202;85;29;2;27;.931;3565000;0
34828;212028;202;0;0;0;0;.00nan;0;0
34828;206772;203;0;0;0;0;.00nan;0;0
34841;209840;184;0;0;0;0;.00nan;0;0
34841;205837;184;45;24;4;20;.833;3588000;0
34841;191518;214;64;30;3;27;.900;3600000;0
34841;202914;214;0;0;0;0;.00nan;0;0
34827;195251;4949;96;43;2;41;.953;3731000;0
34827;196571;177;70;28;3;25;.893;3731000;0
34827;-1;4949;0;0;0;0;.00nan;0;0
34827;-1;177;0;0;0;0;.00nan;0;0
36125;192939;208;0;0;0;0;.00nan;0;0
36125;205788;207;80;41;3;38;.927;3600000;0
36125;197853;207;0;0;0;0;.00nan;0;0
36125;-1;208;52;17;2;15;.882;3600000;0
34926;196283;206;0;0;0;0;.00nan;0;0
34926;-1;199;42;12;2;10;.833;1260000;0
34926;-1;199;36;29;6;23;.793;2340000;0
34926;202998;206;54;23;2;21;.913;3600000;0
36027;210998;229;41;13;3;10;.769;589000;0
36027;185960;229;62;25;3;22;.880;3004000;0
36027;191120;223;0;0;0;0;.00nan;0;0
36027;187118;223;47;31;5;26;.839;3600000;0
34939;210134;1505;0;0;0;0;.00nan;0;0
34939;-1;178;0;0;0;0;.00nan;0;0
34939;-1;1505;52;7;1;6;.857;3600000;0
34939;-1;178;93;54;4;50;.926;3600000;0
34898;195164;218;92;46;2;44;.957;3600000;0
34898;190034;217;0;0;0;0;.00nan;0;0
34898;190041;217;78;28;1;27;.964;3600000;0
34898;208051;218;0;0;0;0;.00nan;0;0
34891;190164;4959;0;0;0;0;.00nan;0;0
34891;-1;209;98;22;0;22;1.000;3600000;0
34891;-1;4959;83;41;3;38;.927;3600000;0
34891;213590;209;0;0;0;0;.00nan;0;0
36023;207061;195;58;21;2;19;.905;3600000;0
36023;196465;195;0;0;0;0;.00nan;0;0
36023;192547;190;74;38;4;34;.895;2665000;0
36023;-1;190;17;8;4;4;.500;935000;0
34995;213399;216;0;0;0;0;.00nan;0;0
34995;197672;210;100;26;0;26;1.000;3600000;0
34995;-1;210;0;0;0;0;.00nan;0;0
34995;-1;216;64;34;3;31;.912;3600000;0
34846;187689;230;0;0;0;0;.00nan;0;0
34846;183678;230;83;25;1;24;.960;3600000;0
34846;200452;221;86;36;2;34;.944;3600000;0
34846;-1;221;0;0;0;0;.00nan;0;0
34974;191118;196;73;28;2;26;.929;3515000;0
34974;-1;189;100;31;0;31;1.000;3600000;0
34974;202830;196;0;0;0;0;.00nan;0;0
34974;-1;189;0;0;0;0;.00nan;0;0
34888;198149;188;90;54;4;50;.926;3600000;0
34888;194893;191;69;20;1;19;.950;3600000;0
34888;184409;188;0;0;0;0;.00nan;0;0
34888;201892;191;0;0;0;0;.00nan;0;0
35985;194219;4960;0;0;0;0;.00nan;0;0
35985;206971;4960;69;22;2;20;.909;3600000;0
35985;180377;228;0;0;0;0;.00nan;0;0
35985;208044;228;51;35;5;30;.857;3600000;0
35977;192939;208;73;20;1;19;.950;3600000;0
35977;200437;201;88;52;4;48;.923;3600000;0
35977;208048;201;0;0;0;0;.00nan;0;0
35977;-1;208;0;0;0;0;.00nan;0;0
36024;188977;215;0;0;0;0;.00nan;0;0
36024;210794;215;41;34;5;29;.853;3600000;0
36024;191130;186;80;26;1;25;.962;3600000;0
36024;213507;186;0;0;0;0;.00nan;0;0
34825;182467;185;27;7;3;4;.571;559000;0
34825;-1;220;0;0;0;0;.00nan;0;0
34825;-1;220;43;18;4;14;.778;3600000;0
34825;-1;185;77;31;2;29;.935;3041000;0
34989;200444;224;0;0;0;0;.00nan;0;0
34989;191120;223;85;34;2;32;.941;3600000;0
34989;187118;223;0;0;0;0;.00nan;0;0
34989;208372;224;59;29;3;26;.897;3557000;0
36179;201495;213;0;0;0;0;.00nan;0;0
36179;213399;216;74;22;1;21;.955;3600000;0
36179;-1;213;92;37;2;35;.946;3558000;0
36179;-1;216;0;0;0;0;.00nan;0;0
35190;201524;205;0;0;0;0;.00nan;0;0
35190;196283;206;69;40;4;36;.900;3551000;0
35190;-1;205;86;30;2;28;.933;3600000;0
35190;202998;206;0;0;0;0;.00nan;0;0
35008;190164;4959;55;18;2;16;.889;3600000;0
35008;186332;4864;77;19;1;18;.947;3600000;0
35008;202801;4864;0;0;0;0;.00nan;0;0
35008;-1;4959;0;0;0;0;.00nan;0;0
34879;192915;179;67;25;3;22;.880;3570000;0
34879;195251;4949;85;34;2;32;.941;3600000;0
34879;187355;179;0;0;0;0;.00nan;0;0
34879;-1;4949;0;0;0;0;.00nan;0;0
34883;-1;219;46;32;5;27;.844;3584000;0
34883;-1;219;0;0;0;0;.00nan;0;0
34883;-1;180;61;24;3;21;.875;3600000;0
34883;208383;180;0;0;0;0;.00nan;0;0
36168;205681;226;0;0;0;0;.00nan;0;0
36168;205769;200;0;0;0;0;.00nan;0;0
36168;195238;200;63;38;4;34;.895;3600000;0
36168;-1;226;41;27;5;22;.815;3542000;0
35009;184788;198;0;0;0;0;.00nan;0;0
35009;-1;192;0;0;0;0;.00nan;0;0
35009;212143;198;65;23;2;21;.913;3600000;0
35009;207398;192;77;37;3;34;.919;3557000;0
34950;186332;4864;55;17;2;15;.882;3600000;0
34950;-1;209;51;37;5;32;.865;3600000;0
34950;202801;4864;0;0;0;0;.00nan;0;0
34950;213590;209;0;0;0;0;.00nan;0;0
34952;192862;187;74;19;1;18;.947;3600000;0
34952;192547;190;69;27;2;25;.926;3546000;0
34952;-1;190;0;0;0;0;.00nan;0;0
34952;-1;187;0;0;0;0;.00nan;0;0
35077;210134;1505;0;0;0;0;.00nan;0;0
35077;-1;1505;62;26;3;23;.885;3575000;0
35077;197672;210;80;30;1;29;.967;3600000;0
35077;-1;210;0;0;0;0;.00nan;0;0
35241;183695;232;0;0;0;0;.00nan;0;0
35241;210998;229;0;0;0;0;.00nan;0;0
35241;185960;229;65;37;4;33;.892;3516000;0
35241;-1;232;84;37;2;35;.946;3600000;0
35107;188977;215;57;25;3;22;.880;3600000;0
35107;210794;215;0;0;0;0;.00nan;0;0
35107;191063;211;0;0;0;0;.00nan;0;0
35107;-1;211;80;48;4;44;.917;3585000;0
35115;190034;217;45;17;3;14;.824;3570000;0
35115;190041;217;0;0;0;0;.00nan;0;0
35115;191130;186;0;0;0;0;.00nan;0;0
35115;213507;186;76;33;2;31;.939;3600000;0
34966;205788;207;0;0;0;0;.00nan;0;0
34966;201525;203;96;39;2;37;.949;3600000;0
34966;206772;203;0;0;0;0;.00nan;0;0
34966;197853;207;58;34;3;31;.912;3543000;0
35669;194893;191;78;11;0;11;1.000;3600000;0
35669;201892;191;0;0;0;0;.00nan;0;0
35669;191118;196;98;53;3;50;.943;3600000;0
35669;202830;196;0;0;0;0;.00nan;0;0
36148;200437;201;0;0;0;0;.00nan;0;0
36148;208048;201;92;32;1;31;.969;3600000;0
36148;-1;199;45;22;3;19;.864;3588000;0
36148;-1;199;0;0;0;0;.00nan;0;0
34868;190038;181;0;0;0;0;.00nan;0;0
34868;192552;181;72;29;3;26;.897;3600000;0
34868;-1;1371;0;0;0;0;.00nan;0;0
34868;-1;1371;98;24;0;24;1.000;3600000;0
36106;209840;184;100;25;0;25;1.000;3600000;0
36106;200306;182;0;0;0;0;.00nan;0;0
36106;205837;184;0;0;0;0;.00nan;0;0
36106;185810;182;34;18;4;14;.778;3600000;0
36088;200333;194;0;0;0;0;.00nan;0;0
36088;196352;194;43;32;5;27;.844;3600000;0
36088;-1;189;74;32;2;30;.938;3600000;0
36088;-1;189;0;0;0;0;.00nan;0;0
34938;198149;188;0;0;0;0;.00nan;0;0
34938;184409;188;63;42;5;37;.881;3600000;0
34938;207061;195;89;21;0;21;1.000;3600000;0
34938;196465;195;0;0;0;0;.00nan;0;0
34864;200452;221;73;26;1;25;.962;3600000;0
34864;206800;225;0;0;0;0;.00nan;0;0
34864;-1;225;84;48;4;44;.917;3600000;0
34864;-1;221;0;0;0;0;.00nan;0;0
34865;205681;226;30;38;6;32;.842;3600000;0
34865;201560;202;66;33;3;30;.909;3600000;0
34865;212028;202;0;0;0;0;.00nan;0;0
34865;-1;226;0;0;0;0;.00nan;0;0
36147;211942;183;78;28;1;27;.964;3600000;0
36147;196237;183;0;0;0;0;.00nan;0;0
36147;196571;177;0;0;0;0;.00nan;0;0
36147;-1;177;66;33;3;30;.909;3581000;0
34873;187689;230;54;28;4;24;.857;3568000;0
34873;183678;230;0;0;0;0;.00nan;0;0
34873;194219;4960;98;43;2;41;.953;3600000;0
34873;206971;4960;0;0;0;0;.00nan;0;0
34932;209915;231;0;0;0;0;.00nan;0;0
34932;189773;231;63;20;2;18;.900;3553000;0
34932;201514;227;0;0;0;0;.00nan;0;0
34932;213280;227;91;40;1;39;.975;3600000;0
34908;200333;194;56;39;4;35;.897;3587000;0
34908;196352;194;0;0;0;0;.00nan;0;0
34908;192547;190;0;0;0;0;.00nan;0;0
34908;-1;190;62;27;3;24;.889;3600000;0
34928;192915;179;100;25;0;25;1.000;3600000;0
34928;187355;179;0;0;0;0;.00nan;0;0
34928;213399;216;0;0;0;0;.00nan;0;0
34928;-1;216;56;18;2;16;.889;3560000;0
34897;182467;185;66;44;5;39;.886;3600000;0
34897;-1;185;0;0;0;0;.00nan;0;0
34897;-1;1371;82;36;2;34;.944;3600000;0
34897;-1;1371;0;0;0;0;.00nan;0;0
34916;183695;232;57;20;2;18;.900;3600000;0
34916;201514;227;75;31;1;30;.968;3600000;0
34916;213280;227;0;0;0;0;.00nan;0;0
34916;-1;232;0;0;0;0;.00nan;0;0
34911;200306;182;89;20;0;20;1.000;3600000;0
34911;185810;182;0;0;0;0;.00nan;0;0
34911;191518;214;74;42;3;39;.929;3600000;0
34911;202914;214;0;0;0;0;.00nan;0;0
34976;205788;207;90;41;3;38;.927;3581000;0
34976;201524;205;0;0;0;0;.00nan;0;0
34976;197853;207;0;0;0;0;.00nan;0;0
34976;-1;205;76;27;2;25;.926;3600000;0
34872;195164;218;74;32;3;29;.906;3600000;0
34872;184874;212;55;4;0;4;1.000;1230000;0
34872;-1;212;23;21;5;16;.762;2297000;0
34872;208051;218;0;0;0;0;.00nan;0;0
35036;190164;4959;0;0;0;0;.00nan;0;0
35036;-1;4959;67;27;2;25;.926;3600000;0
35036;-1;2620;0;0;0;0;.00nan;0;0
35036;213550;2620;55;25;3;22;.880;3572000;0
34848;192939;208;0;0;0;0;.00nan;0;0
34848;205769;200;60;30;3;27;.900;3600000;0
34848;195238;200;0;0;0;0;.00nan;0;0
34848;-1;208;40;34;6;28;.824;3600000;0
34887;209915;231;0;0;0;0;.00nan;0;0
34887;189773;231;91;19;0;19;1.000;3600000;0
34887;180377;228;94;42;3;39;.929;3600000;0
34887;208044;228;0;0;0;0;.00nan;0;0
35071;209840;184;0;0;0;0;.00nan;0;0
35071;205837;184;85;44;4;40;.909;3600000;0
35071;-1;220;0;0;0;0;.00nan;0;0
35071;-1;220;84;27;1;26;.963;3600000;0
35015;211942;183;0;0;0;0;.00nan;0;0
35015;196237;183;84;16;0;16;1.000;3600000;0
35015;196571;177;71;27;2;25;.926;3585000;0
35015;-1;177;0;0;0;0;.00nan;0;0
35426;189902;204;68;27;2;25;.926;3600000;0
35426;201560;202;0;0;0;0;.00nan;0;0
35426;212028;202;48;32;5;27;.844;3600000;0
35426;203120;204;0;0;0;0;.00nan;0;0
34862;200444;224;83;34;2;32;.941;3600000;0
34862;200452;221;0;0;0;0;.00nan;0;0
34862;208372;224;0;0;0;0;.00nan;0;0
34862;-1;221;65;46;6;40;.870;3600000;0
35082;190034;217;0;0;0;0;.00nan;0;0
35082;190041;217;50;19;3;16;.842;3600000;0
35082;191063;211;37;45;8;37;.822;3600000;0
35082;-1;211;0;0;0;0;.00nan;0;0
34910;192862;187;0;0;0;0;.00nan;0;0
34910;207061;195;39;19;3;16;.842;3854000;0
34910;196465;195;0;0;0;0;.00nan;0;0
34910;-1;187;69;37;4;33;.892;3854000;0
34942;210504;193;37;21;4;17;.810;3600000;0
34942;189529;193;0;0;0;0;.00nan;0;0
34942;-1;192;92;37;1;36;.973;3600000;0
34942;207398;192;0;0;0;0;.00nan;0;0
36061;194893;191;49;16;3;13;.813;3600000;0
36061;201585;197;89;47;4;43;.915;3573000;0
36061;206822;197;0;0;0;0;.00nan;0;0
36061;201892;191;0;0;0;0;.00nan;0;0
34963;-1;219;0;0;0;0;.00nan;0;0
34963;-1;219;91;32;2;30;.938;3600000;0
34963;-1;180;41;16;3;13;.813;3549000;0
34963;208383;180;0;0;0;0;.00nan;0;0
34969;187689;230;0;0;0;0;.00nan;0;0
34969;183678;230;51;24;3;21;.875;3600000;0
34969;191120;223;0;0;0;0;.00nan;0;0
34969;187118;223;42;40;6;34;.850;3600000;0
34946;195251;4949;62;23;3;20;.870;3600000;0
34946;201495;213;77;68;7;61;.897;3600000;0
34946;-1;213;0;0;0;0;.00nan;0;0
34946;-1;4949;0;0;0;0;.00nan;0;0
34948;198149;188;67;48;5;43;.896;3600000;0
34948;184409;188;0;0;0;0;.00nan;0;0
34948;184788;198;84;25;1;24;.960;3600000;0
34948;212143;198;0;0;0;0;.00nan;0;0
36000;186332;4864;82;37;2;35;.946;3566000;0
36000;-1;209;99;23;0;23;1.000;3600000;0
36000;202801;4864;0;0;0;0;.00nan;0;0
36000;213590;209;0;0;0;0;.00nan;0;0
34854;-1;220;58;29;4;25;.862;3592000;0
34854;-1;220;0;0;0;0;.00nan;0;0
34854;191518;214;0;0;0;0;.00nan;0;0
34854;202914;214;69;35;3;32;.914;3600000;0
35042;188977;215;0;0;0;0;.00nan;0;0
35042;210794;215;59;37;4;33;.892;3545000;0
35042;191130;186;0;0;0;0;.00nan;0;0
35042;213507;186;63;29;3;26;.897;3600000;0
34949;196283;206;0;0;0;0;.00nan;0;0
34949;-1;199;0;0;0;0;.00nan;0;0
34949;-1;199;66;41;5;36;.878;3579000;0
34949;202998;206;63;29;3;26;.897;3600000;0
34852;200437;201;94;26;1;25;.962;3600000;0
34852;205769;200;0;0;0;0;.00nan;0;0
34852;195238;200;86;36;4;32;.889;3600000;0
34852;208048;201;0;0;0;0;.00nan;0;0
34970;-1;219;89;41;2;39;.951;3571000;0
34970;-1;219;0;0;0;0;.00nan;0;0
34970;-1;180;0;0;0;0;.00nan;0;0
34970;208383;180;69;22;1;21;.955;3600000;0
36161;190164;4959;44;32;5;27;.844;2383000;0
36161;206801;176;68;15;1;14;.933;3600000;0
36161;-1;4959;54;16;2;14;.875;1217000;0
36161;203099;176;0;0;0;0;.00nan;0;0
35133;189902;204;49;27;5;22;.815;3600000;0
35133;196283;206;91;33;1;32;.970;3600000;0
35133;202998;206;0;0;0;0;.00nan;0;0
35133;203120;204;0;0;0;0;.00nan;0;0
34884;192929;222;79;24;2;22;.917;3600000;0
34884;200444;224;0;0;0;0;.00nan;0;0
34884;213560;222;0;0;0;0;.00nan;0;0
34884;208372;224;100;40;0;40;1.000;3600000;0
35060;206801;176;72;42;4;38;.905;3600000;0
35060;186332;4864;0;0;0;0;.00nan;0;0
35060;202801;4864;69;22;1;21;.955;3600000;0
35060;203099;176;0;0;0;0;.00nan;0;0
34860;192939;208;48;14;2;12;.857;3600000;0
34860;200437;201;57;7;1;6;.857;668000;0
34860;208048;201;53;55;7;48;.873;2932000;0
34860;-1;208;0;0;0;0;.00nan;0;0
34886;200452;221;38;26;4;22;.846;3600000;0
34886;180377;228;74;37;3;34;.919;3600000;0
34886;208044;228;0;0;0;0;.00nan;0;0
34886;-1;221;0;0;0;0;.00nan;0;0
34861;182467;185;71;31;2;29;.935;3600000;0
34861;190038;181;99;34;1;33;.971;3600000;0
34861;-1;185;0;0;0;0;.00nan;0;0
34861;192552;181;0;0;0;0;.00nan;0;0
35088;200333;194;79;34;3;31;.912;3561000;0
35088;196352;194;0;0;0;0;.00nan;0;0
35088;-1;189;0;0;0;0;.00nan;0;0
35088;-1;189;79;25;1;24;.960;3600000;0
35276;209840;184;74;33;2;31;.939;3590000;0
35276;200306;182;74;21;1;20;.952;3600000;0
35276;205837;184;0;0;0;0;.00nan;0;0
35276;185810;182;0;0;0;0;.00nan;0;0
34940;210504;193;70;21;2;19;.905;3600000;0
34940;189529;193;0;0;0;0;.00nan;0;0
34940;184788;198;0;0;0;0;.00nan;0;0
34940;212143;198;79;40;3;37;.925;3534000;0
35096;194893;191;54;11;1;10;.909;3600000;0
35096;201892;191;0;0;0;0;.00nan;0;0
35096;191118;196;98;52;2;50;.962;3570000;0
35096;202830;196;0;0;0;0;.00nan;0;0
34875;205681;226;0;0;0;0;.00nan;0;0
34875;201525;203;75;44;5;39;.886;3600000;0
34875;206772;203;0;0;0;0;.00nan;0;0
34875;-1;226;92;24;0;24;1.000;3600000;0
34979;198149;188;0;0;0;0;.00nan;0;0
34979;184409;188;100;30;0;30;1.000;3600000;0
34979;201585;197;70;29;3;26;.897;3600000;0
34979;206822;197;0;0;0;0;.00nan;0;0
34934;194219;4960;91;32;2;30;.938;3900000;0
34934;201514;227;0;0;0;0;.00nan;0;0
34934;206971;4960;0;0;0;0;.00nan;0;0
34934;213280;227;79;30;2;28;.933;3900000;0
34986;192862;187;70;37;4;33;.892;3600000;0
34986;-1;192;78;24;1;23;.958;3600000;0
34986;207398;192;0;0;0;0;.00nan;0;0
34986;-1;187;0;0;0;0;.00nan;0;0
34947;195251;4949;72;28;2;26;.929;3600000;0
34947;211942;183;0;0;0;0;.00nan;0;0
34947;196237;183;60;24;3;21;.875;3548000;0
34947;-1;4949;0;0;0;0;.00nan;0;0
35234;201524;205;76;45;4;41;.911;3600000;0
35234;201560;202;75;20;1;19;.950;3600000;0
35234;212028;202;0;0;0;0;.00nan;0;0
35234;-1;205;0;0;0;0;.00nan;0;0
34907;195164;218;83;35;2;33;.943;3600000;0
34907;184874;212;43;4;1;3;.750;245000;0
34907;-1;212;19;31;7;24;.774;3355000;0
34907;208051;218;0;0;0;0;.00nan;0;0
35041;201495;213;64;20;3;17;.850;3549000;0
35041;213399;216;0;0;0;0;.00nan;0;0
35041;-1;213;0;0;0;0;.00nan;0;0
35041;-1;216;58;22;2;20;.909;3600000;0
34962;196571;177;65;18;1;17;.944;3600000;0
34962;197672;210;76;32;2;30;.938;3566000;0
34962;-1;210;0;0;0;0;.00nan;0;0
34962;-1;177;0;0;0;0;.00nan;0;0
34904;-1;209;63;41;5;36;.878;3554000;0
34904;-1;2620;0;0;0;0;.00nan;0;0
34904;213550;2620;46;25;4;21;.840;3600000;0
34904;213590;209;0;0;0;0;.00nan;0;0
34903;187689;230;74;38;4;34;.895;3900000;0
34903;183678;230;0;0;0;0;.00nan;0;0
34903;206800;225;53;30;4;26;.867;3900000;0
34903;-1;225;0;0;0;0;.00nan;0;0
34925;209915;231;0;0;0;0;.00nan;0;0
34925;189773;231;55;9;1;8;.889;3600000;0
34925;206800;225;0;0;0;0;.00nan;0;0
34925;-1;225;88;69;6;63;.913;3600000;0
34917;192939;208;0;0;0;0;.00nan;0;0
34917;201524;205;0;0;0;0;.00nan;0;0
34917;-1;208;46;33;5;28;.848;3600000;0
34917;-1;205;99;35;1;34;.971;3600000;0
36113;192862;187;0;0;0;0;.00nan;0;0
36113;198149;188;0;0;0;0;.00nan;0;0
36113;184409;188;72;45;5;40;.889;3600000;0
36113;-1;187;83;16;0;16;1.000;3600000;0
34944;210504;193;0;0;0;0;.00nan;0;0
34944;194893;191;83;34;3;31;.912;3555000;0
34944;189529;193;69;31;2;29;.935;3600000;0
34944;201892;191;0;0;0;0;.00nan;0;0
34933;192915;179;72;35;3;32;.914;3600000;0
34933;187355;179;0;0;0;0;.00nan;0;0
34933;-1;178;0;0;0;0;.00nan;0;0
34933;-1;178;50;34;4;30;.882;3544000;0
35025;191130;186;77;24;1;23;.958;3600000;0
35025;-1;180;0;0;0;0;.00nan;0;0
35025;213507;186;0;0;0;0;.00nan;0;0
35025;208383;180;68;32;3;29;.906;3519000;0
34935;183695;232;20;40;8;32;.800;3600000;0
34935;200444;224;29;8;3;5;.625;591000;0
34935;208372;224;73;14;0;14;1.000;3009000;0
34935;-1;232;0;0;0;0;.00nan;0;0
36176;200452;221;0;0;0;0;.00nan;0;0
36176;210998;229;0;0;0;0;.00nan;0;0
36176;185960;229;95;21;0;21;1.000;3600000;0
36176;-1;221;74;24;1;23;.958;3600000;0
35261;180377;228;0;0;0;0;.00nan;0;0
35261;191120;223;0;0;0;0;.00nan;0;0
35261;187118;223;100;23;0;23;1.000;3600000;0
35261;208044;228;73;34;3;31;.912;3600000;0
34890;192929;222;0;0;0;0;.00nan;0;0
34890;194219;4960;0;0;0;0;.00nan;0;0
34890;206971;4960;65;34;4;30;.882;3900000;0
34890;213560;222;61;29;4;25;.862;3900000;0
34990;195164;218;0;0;0;0;.00nan;0;0
34990;190034;217;45;21;3;18;.857;3583000;0
34990;190041;217;0;0;0;0;.00nan;0;0
34990;208051;218;85;33;1;32;.970;3600000;0
35001;207061;195;68;17;1;16;.941;3600000;0
35001;196465;195;0;0;0;0;.00nan;0;0
35001;191118;196;0;0;0;0;.00nan;0;0
35001;202830;196;83;53;5;48;.906;3600000;0
34953;205769;200;64;28;3;25;.893;3539000;0
34953;195238;200;0;0;0;0;.00nan;0;0
34953;201525;203;88;28;1;27;.964;3600000;0
34953;206772;203;0;0;0;0;.00nan;0;0
35110;211942;183;100;31;0;31;1.000;3600000;0
35110;196237;183;0;0;0;0;.00nan;0;0
35110;197672;210;0;0;0;0;.00nan;0;0
35110;-1;210;54;24;3;21;.875;3600000;0
34936;-1;220;0;0;0;0;.00nan;0;0
34936;-1;220;84;32;2;30;.938;3557000;0
34936;191518;214;100;32;1;31;.969;3600000;0
34936;202914;214;0;0;0;0;.00nan;0;0
35256;-1;219;75;38;2;36;.947;3765000;0
35256;-1;219;0;0;0;0;.00nan;0;0
35256;191063;211;0;0;0;0;.00nan;0;0
35256;-1;211;82;37;3;34;.919;3765000;0
34983;201585;197;0;0;0;0;.00nan;0;0
34983;206822;197;88;32;1;31;.969;3600000;0
34983;-1;189;46;26;4;22;.846;3600000;0
34983;-1;189;0;0;0;0;.00nan;0;0
35191;205788;207;0;0;0;0;.00nan;0;0
35191;196283;206;0;0;0;0;.00nan;0;0
35191;197853;207;84;24;2;22;.917;3600000;0
35191;202998;206;78;28;1;27;.964;3600000;0
35536;189902;204;100;31;0;31;1.000;3600000;0
35536;-1;199;0;0;0;0;.00nan;0;0
35536;-1;199;81;26;1;25;.962;3569000;0
35536;203120;204;0;0;0;0;.00nan;0;0
35033;210134;1505;74;27;2;25;.926;3554000;0
35033;196571;177;77;27;1;26;.963;3600000;0
35033;-1;1505;0;0;0;0;.00nan;0;0
35033;-1;177;0;0;0;0;.00nan;0;0
36079;191063;211;62;25;3;22;.880;3600000;0
36079;191130;186;0;0;0;0;.00nan;0;0
36079;-1;211;0;0;0;0;.00nan;0;0
36079;213507;186;69;19;1;18;.947;3600000;0
35180;187689;230;79;48;4;44;.917;3600000;0
35180;183678;230;0;0;0;0;.00nan;0;0
35180;209915;231;0;0;0;0;.00nan;0;0
35180;189773;231;75;17;1;16;.941;3600000;0
36207;210998;229;0;0;0;0;.00nan;0;0
36207;201514;227;30;9;3;6;.667;565000;0
36207;185960;229;70;38;3;35;.921;3600000;0
36207;213280;227;59;20;2;18;.900;2962000;0
34889;190038;181;0;0;0;0;.00nan;0;0
34889;192552;181;50;25;3;22;.880;3900000;0
34889;-1;1371;65;37;3;34;.919;3900000;0
34889;-1;1371;0;0;0;0;.00nan;0;0
34951;195251;4949;68;18;1;17;.944;3578000;0
34951;201495;213;0;0;0;0;.00nan;0;0
34951;-1;213;100;55;0;55;1.000;3600000;0
34951;-1;4949;0;0;0;0;.00nan;0;0
34985;190164;4959;0;0;0;0;.00nan;0;0
34985;-1;209;100;38;0;38;1.000;3600000;0
34985;-1;4959;59;30;4;26;.867;3600000;0
34985;213590;209;0;0;0;0;.00nan;0;0
34906;188977;215;0;0;0;0;.00nan;0;0
34906;210794;215;86;37;2;35;.946;3900000;0
34906;184874;212;69;29;2;27;.931;3900000;0
34906;-1;212;0;0;0;0;.00nan;0;0
34896;200437;201;70;42;4;38;.905;3600000;0
34896;205681;226;0;0;0;0;.00nan;0;0
34896;208048;201;0;0;0;0;.00nan;0;0
34896;-1;226;72;14;1;13;.929;3600000;0
34902;182467;185;0;0;0;0;.00nan;0;0
34902;200306;182;0;0;0;0;.00nan;0;0
34902;185810;182;84;30;1;29;.967;3600000;0
34902;-1;185;59;24;2;22;.917;3591000;0
36102;189902;204;37;27;5;22;.815;3549000;0
36102;201560;202;71;30;3;27;.900;3600000;0
36102;212028;202;0;0;0;0;.00nan;0;0
36102;203120;204;0;0;0;0;.00nan;0;0
36090;183695;232;0;0;0;0;.00nan;0;0
36090;180377;228;56;19;2;17;.895;3600000;0
36090;208044;228;0;0;0;0;.00nan;0;0
36090;-1;232;60;32;3;29;.906;3597000;0
34943;192915;179;0;0;0;0;.00nan;0;0
34943;210134;1505;0;0;0;0;.00nan;0;0
34943;187355;179;40;25;5;20;.800;3600000;0
34943;-1;1505;56;24;4;20;.833;3600000;0
35080;192929;222;57;35;4;31;.886;3600000;0
35080;191120;223;0;0;0;0;.00nan;0;0
35080;187118;223;22;22;5;17;.773;3547000;0
35080;213560;222;0;0;0;0;.00nan;0;0
36138;207061;195;0;0;0;0;.00nan;0;0
36138;196465;195;64;14;1;13;.929;3600000;0
36138;191118;196;75;40;4;36;.900;3600000;0
36138;202830;196;0;0;0;0;.00nan;0;0
35194;200333;194;58;35;4;31;.886;3600000;0
35194;196352;194;0;0;0;0;.00nan;0;0
35194;-1;189;0;0;0;0;.00nan;0;0
35194;-1;189;19;25;6;19;.760;3598000;0
35260;206801;176;94;40;2;38;.950;3600000;0
35260;-1;2620;60;39;5;34;.872;3600000;0
35260;203099;176;0;0;0;0;.00nan;0;0
35260;213550;2620;0;0;0;0;.00nan;0;0
35209;-1;178;0;0;0;0;.00nan;0;0
35209;213399;216;33;21;4;17;.810;3591000;0
35209;-1;178;97;44;2;42;.955;3600000;0
35209;-1;216;0;0;0;0;.00nan;0;0
35007;201585;197;57;31;4;27;.871;3598000;0
35007;206822;197;0;0;0;0;.00nan;0;0
35007;192547;190;77;27;2;25;.926;3600000;0
35007;-1;190;0;0;0;0;.00nan;0;0
35028;190164;4959;91;50;2;48;.960;3600000;0
35028;186332;4864;48;22;4;18;.818;3518000;0
35028;202801;4864;0;0;0;0;.00nan;0;0
35028;-1;4959;0;0;0;0;.00nan;0;0
36205;192939;208;36;12;3;9;.750;3600000;0
36205;201524;205;0;0;0;0;.00nan;0;0
36205;-1;208;0;0;0;0;.00nan;0;0
36205;-1;205;79;43;5;38;.884;3517000;0
36198;190038;181;84;34;2;32;.941;3569000;0
36198;192552;181;0;0;0;0;.00nan;0;0
36198;-1;1371;0;0;0;0;.00nan;0;0
36198;-1;1371;100;36;0;36;1.000;3600000;0
35014;192862;187;0;0;0;0;.00nan;0;0
35014;-1;192;55;39;5;34;.872;3600000;0
35014;207398;192;0;0;0;0;.00nan;0;0
35014;-1;187;77;17;1;16;.941;3600000;0
35171;201495;213;0;0;0;0;.00nan;0;0
35171;-1;178;98;26;1;25;.962;3600000;0
35171;-1;213;79;26;2;24;.923;3597000;0
35171;-1;178;0;0;0;0;.00nan;0;0
34987;184874;212;0;0;0;0;.00nan;0;0
34987;191063;211;47;5;1;4;.800;939000;0
34987;-1;212;67;32;3;29;.906;3600000;0
34987;-1;211;68;57;6;51;.895;2661000;0
35546;-1;189;78;31;1;30;.968;3600000;0
35546;192547;190;0;0;0;0;.00nan;0;0
35546;-1;190;72;40;4;36;.900;3600000;0
35546;-1;189;0;0;0;0;.00nan;0;0
34988;200452;221;49;40;6;34;.850;3361000;0
34988;210998;229;51;22;3;19;.864;3600000;0
34988;185960;229;0;0;0;0;.00nan;0;0
34988;-1;221;52;2;0;2;1.000;239000;0
35538;182467;185;82;43;3;40;.930;3544000;0
35538;209840;184;0;0;0;0;.00nan;0;0
35538;205837;184;59;16;2;14;.875;3600000;0
35538;-1;185;0;0;0;0;.00nan;0;0
35227;190034;217;100;31;0;31;1.000;3600000;0
35227;190041;217;0;0;0;0;.00nan;0;0
35227;191130;186;0;0;0;0;.00nan;0;0
35227;213507;186;48;44;6;38;.864;3600000;0
34856;200306;182;0;0;0;0;.00nan;0;0
34856;-1;220;0;0;0;0;.00nan;0;0
34856;-1;220;53;37;3;34;.919;3900000;0
34856;185810;182;72;31;3;28;.903;3900000;0
35050;195164;218;66;41;4;37;.902;3600000;0
35050;-1;180;54;21;3;18;.857;3600000;0
35050;208051;218;0;0;0;0;.00nan;0;0
35050;208383;180;0;0;0;0;.00nan;0;0
35135;194893;191;91;17;0;17;1.000;3600000;0
35135;184788;198;65;19;1;18;.947;1025000;0
35135;212143;198;36;35;6;29;.829;2575000;0
35135;201892;191;0;0;0;0;.00nan;0;0
35021;194219;4960;0;0;0;0;.00nan;0;0
35021;200444;224;78;45;2;43;.956;3900000;0
35021;206971;4960;83;27;2;25;.926;3856000;0
35021;208372;224;0;0;0;0;.00nan;0;0
36149;187689;230;0;0;0;0;.00nan;0;0
36149;183678;230;26;21;5;16;.762;3545000;0
36149;201514;227;87;40;3;37;.925;3600000;0
36149;213280;227;0;0;0;0;.00nan;0;0
34913;200437;201;0;0;0;0;.00nan;0;0
34913;196283;206;0;0;0;0;.00nan;0;0
34913;208048;201;65;34;3;31;.912;3571000;0
34913;202998;206;72;24;2;22;.917;3600000;0
35098;205769;200;0;0;0;0;.00nan;0;0
35098;195238;200;83;36;2;34;.944;3900000;0
35098;201525;203;68;21;2;19;.905;3900000;0
35098;206772;203;0;0;0;0;.00nan;0;0
35118;184788;198;70;41;3;38;.927;3566000;0
35118;212143;198;0;0;0;0;.00nan;0;0
35118;207061;195;51;17;2;15;.882;3600000;0
35118;196465;195;0;0;0;0;.00nan;0;0
35213;201495;213;82;39;2;37;.949;3600000;0
35213;-1;213;0;0;0;0;.00nan;0;0
35213;197672;210;86;26;1;25;.962;3600000;0
35213;-1;210;0;0;0;0;.00nan;0;0
35087;205788;207;60;32;3;29;.906;3600000;0
35087;201525;203;82;37;2;35;.946;3600000;0
35087;206772;203;0;0;0;0;.00nan;0;0
35087;197853;207;0;0;0;0;.00nan;0;0
35000;200444;224;0;0;0;0;.00nan;0;0
35000;210998;229;0;0;0;0;.00nan;0;0
35000;185960;229;97;41;2;39;.951;3900000;0
35000;208372;224;66;26;2;24;.923;3900000;0
35121;209915;231;0;0;0;0;.00nan;0;0
35121;189773;231;71;17;1;16;.941;3600000;0
35121;191120;223;0;0;0;0;.00nan;0;0
35121;187118;223;62;33;4;29;.879;3600000;0
35175;198149;188;0;0;0;0;.00nan;0;0
35175;194893;191;40;20;4;16;.800;3600000;0
35175;184409;188;50;48;8;40;.833;3600000;0
35175;201892;191;0;0;0;0;.00nan;0;0
34997;205769;200;64;26;3;23;.885;3721000;0
34997;195238;200;0;0;0;0;.00nan;0;0
34997;-1;199;75;45;4;41;.911;3721000;0
34997;-1;199;0;0;0;0;.00nan;0;0
35161;190034;217;80;38;2;36;.947;3600000;0
35161;190041;217;0;0;0;0;.00nan;0;0
35161;-1;180;0;0;0;0;.00nan;0;0
35161;208383;180;55;24;3;21;.875;3555000;0
35185;186332;4864;69;35;3;32;.914;3766000;0
35185;202801;4864;0;0;0;0;.00nan;0;0
35185;-1;2620;0;0;0;0;.00nan;0;0
35185;213550;2620;57;30;4;26;.867;3766000;0
34982;192915;179;91;38;2;36;.947;3900000;0
34982;195251;4949;0;0;0;0;.00nan;0;0
34982;187355;179;0;0;0;0;.00nan;0;0
34982;-1;4949;73;32;2;30;.938;3900000;0
35027;206801;176;70;22;2;20;.909;3568000;0
35027;-1;209;94;36;1;35;.972;3600000;0
35027;203099;176;0;0;0;0;.00nan;0;0
35027;213590;209;0;0;0;0;.00nan;0;0
34941;200437;201;82;26;1;25;.962;3600000;0
34941;196283;206;44;30;5;25;.833;3600000;0
34941;208048;201;0;0;0;0;.00nan;0;0
34941;202998;206;0;0;0;0;.00nan;0;0
34892;192929;222;0;0;0;0;.00nan;0;0
34892;200452;221;0;0;0;0;.00nan;0;0
34892;213560;222;48;22;3;19;.864;3600000;0
34892;-1;221;65;38;5;33;.868;3544000;0
35055;195164;218;0;0;0;0;.00nan;0;0
35055;191130;186;67;28;3;25;.893;3514000;0
35055;208051;218;78;26;1;25;.962;3600000;0
35055;213507;186;0;0;0;0;.00nan;0;0
35022;187689;230;100;33;0;33;1.000;3600000;0
35022;183678;230;0;0;0;0;.00nan;0;0
35022;201514;227;0;0;0;0;.00nan;0;0
35022;213280;227;89;31;1;30;.968;3563000;0
36170;-1;219;72;27;2;25;.926;3701000;0
36170;-1;219;0;0;0;0;.00nan;0;0
36170;191063;211;74;37;3;34;.919;3701000;0
36170;-1;211;0;0;0;0;.00nan;0;0
34937;200306;182;72;30;2;28;.933;3564000;0
34937;185810;182;0;0;0;0;.00nan;0;0
34937;191518;214;95;33;1;32;.970;3600000;0
34937;202914;214;0;0;0;0;.00nan;0;0
35047;210134;1505;0;0;0;0;.00nan;0;0
35047;211942;183;100;35;0;35;1.000;3600000;0
35047;196237;183;0;0;0;0;.00nan;0;0
35047;-1;1505;46;31;5;26;.839;3600000;0
34931;188977;215;0;0;0;0;.00nan;0;0
34931;210794;215;57;31;4;27;.871;3600000;0
34931;184874;212;0;0;0;0;.00nan;0;0
34931;-1;212;40;27;5;22;.815;3578000;0
34929;192939;208;57;20;2;18;.900;3900000;0
34929;189902;204;0;0;0;0;.00nan;0;0
34929;-1;208;0;0;0;0;.00nan;0;0
34929;203120;204;99;43;2;41;.953;3900000;0
34945;-1;220;56;26;3;23;.885;3580000;0
34945;-1;220;0;0;0;0;.00nan;0;0
34945;-1;1371;0;0;0;0;.00nan;0;0
34945;-1;1371;79;33;2;31;.939;3600000;0
35017;192862;187;78;27;2;25;.926;3600000;0
35017;201585;197;80;34;3;31;.912;3551000;0
35017;206822;197;0;0;0;0;.00nan;0;0
35017;-1;187;0;0;0;0;.00nan;0;0
34975;206800;225;0;0;0;0;.00nan;0;0
34975;180377;228;44;22;3;19;.864;3543000;0
34975;-1;225;80;32;2;30;.938;3600000;0
34975;208044;228;0;0;0;0;.00nan;0;0
35069;200333;194;94;35;1;34;.971;3021000;0
35069;-1;192;0;0;0;0;.00nan;0;0
35069;196352;194;26;6;3;3;.500;579000;0
35069;207398;192;62;10;1;9;.900;3600000;0
34909;205681;226;0;0;0;0;.00nan;0;0
34909;201524;205;43;11;2;9;.818;883000;0
34909;-1;226;42;29;5;24;.828;3600000;0
34909;-1;205;30;31;6;25;.806;2717000;0
34968;209840;184;73;32;2;30;.938;3759000;0
34968;205837;184;0;0;0;0;.00nan;0;0
34968;190038;181;0;0;0;0;.00nan;0;0
34968;192552;181;81;26;1;25;.962;3759000;0
34954;196571;177;70;27;2;25;.926;3600000;0
34954;213399;216;0;0;0;0;.00nan;0;0
34954;-1;216;76;43;4;39;.907;3590000;0
34954;-1;177;0;0;0;0;.00nan;0;0
34964;210504;193;94;19;0;19;1.000;3600000;0
34964;189529;193;0;0;0;0;.00nan;0;0
34964;191118;196;68;36;3;33;.917;3600000;0
34964;202830;196;0;0;0;0;.00nan;0;0
36195;194219;4960;74;21;1;20;.952;3543000;0
36195;183695;232;97;28;0;28;1.000;3600000;0
36195;206971;4960;0;0;0;0;.00nan;0;0
36195;-1;232;0;0;0;0;.00nan;0;0
36060;192915;179;54;11;1;10;.909;1111000;0
36060;196571;177;0;0;0;0;.00nan;0;0
36060;187355;179;22;25;6;19;.760;2489000;0
36060;-1;177;84;31;2;29;.935;3600000;0
35569;205788;207;0;0;0;0;.00nan;0;0
35569;201560;202;84;31;1;30;.968;3600000;0
35569;212028;202;0;0;0;0;.00nan;0;0
35569;197853;207;87;48;4;44;.917;3600000;0
35029;-1;209;0;0;0;0;.00nan;0;0
35029;-1;2620;75;21;1;20;.952;3572000;0
35029;213550;2620;0;0;0;0;.00nan;0;0
35029;213590;209;100;31;0;31;1.000;3600000;0
35127;200333;194;71;28;2;26;.929;3600000;0
35127;207061;195;50;22;3;19;.864;3544000;0
35127;196352;194;0;0;0;0;.00nan;0;0
35127;196465;195;0;0;0;0;.00nan;0;0
35104;190034;217;0;0;0;0;.00nan;0;0
35104;190041;217;69;29;3;26;.897;3821000;0
35104;-1;219;100;51;2;49;.961;3821000;0
35104;-1;219;0;0;0;0;.00nan;0;0
34994;194219;4960;0;0;0;0;.00nan;0;0
34994;206971;4960;63;13;1;12;.923;3600000;0
34994;180377;228;66;42;4;38;.905;3600000;0
34994;208044;228;0;0;0;0;.00nan;0;0
35044;190164;4959;0;0;0;0;.00nan;0;0
35044;206801;176;75;26;2;24;.923;3900000;0
35044;-1;4959;77;29;2;27;.931;3891000;0
35044;203099;176;0;0;0;0;.00nan;0;0
36043;210134;1505;0;0;0;0;.00nan;0;0
36043;201495;213;100;45;1;44;.978;3740000;0
36043;-1;1505;51;13;2;11;.846;3740000;0
36043;-1;213;0;0;0;0;.00nan;0;0
35010;192862;187;0;0;0;0;.00nan;0;0
35010;-1;189;0;0;0;0;.00nan;0;0
35010;-1;187;73;25;2;23;.920;3900000;0
35010;-1;189;83;32;2;30;.938;3900000;0
35038;209915;231;0;0;0;0;.00nan;0;0
35038;200444;224;0;0;0;0;.00nan;0;0
35038;189773;231;77;30;2;28;.933;3543000;0
35038;208372;224;96;33;1;32;.970;3600000;0
34960;210504;193;96;35;2;33;.943;3600000;0
34960;189529;193;0;0;0;0;.00nan;0;0
34960;201585;197;40;31;6;25;.806;3600000;0
34960;206822;197;0;0;0;0;.00nan;0;0
35202;201524;205;0;0;0;0;.00nan;0;0
35202;196283;206;0;0;0;0;.00nan;0;0
35202;-1;205;59;18;2;16;.889;3600000;0
35202;202998;206;46;40;6;34;.850;3600000;0
34955;200437;201;0;0;0;0;.00nan;0;0
34955;189902;204;60;32;4;28;.875;3600000;0
34955;208048;201;39;36;5;31;.861;3600000;0
34955;203120;204;0;0;0;0;.00nan;0;0
35114;213399;216;0;0;0;0;.00nan;0;0
35114;197672;210;58;21;2;19;.905;3828000;0
35114;-1;210;0;0;0;0;.00nan;0;0
35114;-1;216;82;39;3;36;.923;3828000;0
35062;191063;211;0;0;0;0;.00nan;0;0
35062;-1;180;4;15;6;9;.600;1940000;0
35062;-1;211;66;36;4;32;.889;3600000;0
35062;208383;180;37;14;3;11;.786;1660000;0
34971;187689;230;70;24;1;23;.958;3600000;0
34971;183678;230;0;0;0;0;.00nan;0;0
34971;191120;223;0;0;0;0;.00nan;0;0
34971;187118;223;40;36;6;30;.833;3600000;0
34915;200306;182;73;32;2;30;.938;2520000;0
34915;190038;181;0;0;0;0;.00nan;0;0
34915;185810;182;26;12;4;8;.667;1080000;0
34915;192552;181;76;26;2;24;.923;3600000;0
34978;192929;222;31;31;6;25;.806;3198000;0
34978;206800;225;0;0;0;0;.00nan;0;0
34978;-1;225;100;28;0;28;1.000;3600000;0
34978;213560;222;42;3;1;2;.667;402000;0
35119;-1;192;74;36;4;32;.889;3600000;0
35119;207398;192;0;0;0;0;.00nan;0;0
35119;192547;190;84;29;1;28;.966;3600000;0
35119;-1;190;0;0;0;0;.00nan;0;0
34914;205681;226;0;0;0;0;.00nan;0;0
34914;201560;202;0;0;0;0;.00nan;0;0
34914;212028;202;80;42;2;40;.952;3600000;0
34914;-1;226;27;14;4;10;.714;3589000;0
34998;195251;4949;63;48;7;41;.854;3600000;0
34998;211942;183;48;14;2;12;.857;3600000;0
34998;196237;183;0;0;0;0;.00nan;0;0
34998;-1;4949;0;0;0;0;.00nan;0;0
35359;188977;215;65;33;3;30;.909;3600000;0
35359;210794;215;0;0;0;0;.00nan;0;0
35359;191130;186;53;3;0;3;1.000;304000;0
35359;213507;186;27;34;7;27;.794;3296000;0
34992;182467;185;78;21;1;20;.952;3600000;0
34992;-1;185;0;0;0;0;.00nan;0;0
34992;191518;214;79;36;2;34;.944;3563000;0
34992;202914;214;0;0;0;0;.00nan;0;0
35006;183695;232;70;32;2;30;.938;3589000;0
35006;200452;221;97;35;1;34;.971;3600000;0
35006;-1;221;0;0;0;0;.00nan;0;0
35006;-1;232;0;0;0;0;.00nan;0;0
35099;201525;203;74;24;1;23;.958;3600000;0
35099;206772;203;0;0;0;0;.00nan;0;0
35099;-1;199;0;0;0;0;.00nan;0;0
35099;-1;199;57;41;5;36;.878;3600000;0
34920;-1;220;0;0;0;0;.00nan;0;0
34920;-1;220;83;54;4;50;.926;3900000;0
34920;-1;1371;45;28;4;24;.857;3900000;0
34920;-1;1371;0;0;0;0;.00nan;0;0
35051;180377;228;0;0;0;0;.00nan;0;0
35051;191120;223;0;0;0;0;.00nan;0;0
35051;187118;223;60;23;2;21;.913;3600000;0
35051;208044;228;74;24;1;23;.958;3600000;0
35053;195164;218;42;32;6;26;.813;2341000;0
35053;-1;219;58;10;0;10;1.000;1065000;0
35053;-1;219;47;37;6;31;.838;2835000;0
35053;208051;218;79;17;0;17;1.000;1559000;0
35012;192915;179;67;42;4;38;.905;3900000;0
35012;211942;183;0;0;0;0;.00nan;0;0
35012;196237;183;43;23;4;19;.826;3900000;0
35012;187355;179;0;0;0;0;.00nan;0;0
36135;191130;186;56;37;5;32;.865;3574000;0
36135;-1;180;41;22;4;18;.818;3600000;0
36135;213507;186;0;0;0;0;.00nan;0;0
36135;208383;180;0;0;0;0;.00nan;0;0
36154;192862;187;80;32;2;30;.938;3513000;0
36154;194893;191;93;18;0;18;1.000;3600000;0
36154;201892;191;0;0;0;0;.00nan;0;0
36154;-1;187;0;0;0;0;.00nan;0;0
35132;192939;208;0;0;0;0;.00nan;0;0
35132;205788;207;50;43;6;37;.860;3600000;0
35132;197853;207;0;0;0;0;.00nan;0;0
35132;-1;208;100;25;0;25;1.000;3600000;0
35159;196571;177;84;27;1;26;.963;3600000;0
35159;-1;178;0;0;0;0;.00nan;0;0
35159;-1;178;59;37;4;33;.892;3600000;0
35159;-1;177;0;0;0;0;.00nan;0;0
36164;200306;182;0;0;0;0;.00nan;0;0
36164;-1;220;65;38;5;33;.868;3600000;0
36164;-1;220;0;0;0;0;.00nan;0;0
36164;185810;182;99;23;0;23;1.000;3600000;0
35086;184874;212;0;0;0;0;.00nan;0;0
35086;191063;211;97;70;4;66;.943;3556000;0
35086;-1;212;60;16;2;14;.875;3600000;0
35086;-1;211;0;0;0;0;.00nan;0;0
35057;190164;4959;61;31;3;28;.903;3900000;0
35057;186332;4864;68;28;3;25;.893;3900000;0
35057;202801;4864;0;0;0;0;.00nan;0;0
35057;-1;4959;0;0;0;0;.00nan;0;0
35093;210134;1505;77;25;2;23;.920;3573000;0
35093;213399;216;87;34;1;33;.971;3600000;0
35093;-1;1505;0;0;0;0;.00nan;0;0
35093;-1;216;0;0;0;0;.00nan;0;0
34965;194219;4960;86;30;1;29;.967;3600000;0
34965;201514;227;100;25;0;25;1.000;3600000;0
34965;206971;4960;0;0;0;0;.00nan;0;0
34965;213280;227;0;0;0;0;.00nan;0;0
35654;207061;195;0;0;0;0;.00nan;0;0
35654;196465;195;35;23;5;18;.783;3600000;0
35654;192547;190;0;0;0;0;.00nan;0;0
35654;-1;190;100;44;2;42;.955;3600000;0
35040;-1;209;0;0;0;0;.00nan;0;0
35040;-1;2620;71;21;1;20;.952;3600000;0
35040;213550;2620;0;0;0;0;.00nan;0;0
35040;213590;209;62;43;5;38;.884;3600000;0
35495;187689;230;0;0;0;0;.00nan;0;0
35495;183678;230;61;27;3;24;.889;3573000;0
35495;210998;229;93;29;1;28;.966;3600000;0
35495;185960;229;0;0;0;0;.00nan;0;0
35031;198149;188;0;0;0;0;.00nan;0;0
35031;184409;188;72;17;1;16;.941;3600000;0
35031;201585;197;0;0;0;0;.00nan;0;0
35031;206822;197;94;40;2;38;.950;3600000;0
35268;191118;196;69;22;1;21;.955;3600000;0
35268;-1;189;98;50;2;48;.960;3573000;0
35268;202830;196;0;0;0;0;.00nan;0;0
35268;-1;189;0;0;0;0;.00nan;0;0
35032;192929;222;0;0;0;0;.00nan;0;0
35032;209915;231;0;0;0;0;.00nan;0;0
35032;189773;231;58;18;2;16;.889;3600000;0
35032;213560;222;80;39;4;35;.897;3596000;0
34961;205681;226;0;0;0;0;.00nan;0;0
34961;201524;205;85;50;5;45;.900;3610000;0
34961;-1;226;41;22;4;18;.818;3605000;0
34961;-1;205;0;0;0;0;.00nan;0;0
34905;191518;214;0;0;0;0;.00nan;0;0
34905;202914;214;52;15;2;13;.867;3600000;0
34905;-1;1371;0;0;0;0;.00nan;0;0
34905;-1;1371;63;35;4;31;.886;3600000;0
35013;205769;200;0;0;0;0;.00nan;0;0
35013;195238;200;77;24;1;23;.958;3600000;0
35013;-1;199;73;44;4;40;.909;3600000;0
35013;-1;199;0;0;0;0;.00nan;0;0
35146;182467;185;0;0;0;0;.00nan;0;0
35146;209840;184;0;0;0;0;.00nan;0;0
35146;205837;184;55;40;4;36;.900;3600000;0
35146;-1;185;97;31;1;30;.968;3600000;0
35123;200333;194;0;0;0;0;.00nan;0;0
35123;184788;198;66;18;1;17;.944;3600000;0
35123;212143;198;0;0;0;0;.00nan;0;0
35123;196352;194;79;39;3;36;.923;3600000;0
36145;205788;207;0;0;0;0;.00nan;0;0
36145;196283;206;0;0;0;0;.00nan;0;0
36145;197853;207;69;50;5;45;.900;3600000;0
36145;202998;206;69;18;2;16;.889;3600000;0
34977;210504;193;69;26;2;24;.923;3543000;0
34977;194893;191;80;31;1;30;.968;3600000;0
34977;189529;193;0;0;0;0;.00nan;0;0
34977;201892;191;0;0;0;0;.00nan;0;0
35052;198149;188;77;31;2;29;.935;3600000;0
35052;184409;188;0;0;0;0;.00nan;0;0
35052;191118;196;0;0;0;0;.00nan;0;0
35052;202830;196;71;17;1;16;.941;3600000;0
36124;209840;184;73;19;1;18;.947;3600000;0
36124;205837;184;0;0;0;0;.00nan;0;0
36124;190038;181;0;0;0;0;.00nan;0;0
36124;192552;181;100;33;0;33;1.000;3600000;0
35018;192939;208;0;0;0;0;.00nan;0;0
35018;189902;204;73;40;3;37;.925;3900000;0
35018;-1;208;54;24;3;21;.875;3900000;0
35018;203120;204;0;0;0;0;.00nan;0;0
36039;206801;176;13;20;6;14;.700;3148000;0
36039;-1;209;78;35;3;32;.914;3600000;0
36039;203099;176;49;7;1;6;.857;452000;0
36039;213590;209;0;0;0;0;.00nan;0;0
36121;183695;232;56;32;3;29;.906;3552000;0
36121;210998;229;0;0;0;0;.00nan;0;0
36121;185960;229;80;33;2;31;.939;3600000;0
36121;-1;232;0;0;0;0;.00nan;0;0
36105;200437;201;52;31;4;27;.871;3513000;0
36105;201560;202;0;0;0;0;.00nan;0;0
36105;212028;202;71;24;2;22;.917;3600000;0
36105;208048;201;0;0;0;0;.00nan;0;0
35100;201495;213;0;0;0;0;.00nan;0;0
35100;-1;178;0;0;0;0;.00nan;0;0
35100;-1;213;94;36;1;35;.972;3600000;0
35100;-1;178;75;28;2;26;.929;3545000;0
36162;190034;217;81;32;2;30;.938;3600000;0
36162;190041;217;0;0;0;0;.00nan;0;0
36162;184874;212;0;0;0;0;.00nan;0;0
36162;-1;212;53;32;5;27;.844;3600000;0
35002;201514;227;80;25;2;23;.920;3600000;0
35002;206800;225;0;0;0;0;.00nan;0;0
35002;-1;225;89;41;3;38;.927;3549000;0
35002;213280;227;0;0;0;0;.00nan;0;0
35355;210134;1505;59;18;2;16;.889;3600000;0
35355;-1;1505;0;0;0;0;.00nan;0;0
35355;197672;210;96;51;3;48;.941;3542000;0
35355;-1;210;0;0;0;0;.00nan;0;0
36118;200452;221;61;29;3;26;.897;3552000;0
36118;206800;225;71;27;2;25;.926;3600000;0
36118;-1;225;0;0;0;0;.00nan;0;0
36118;-1;221;0;0;0;0;.00nan;0;0
36016;200444;224;64;23;2;21;.913;3600000;0
36016;180377;228;47;30;4;26;.867;3600000;0
36016;208044;228;0;0;0;0;.00nan;0;0
36016;208372;224;0;0;0;0;.00nan;0;0
36132;207061;195;64;16;1;15;.938;3600000;0
36132;196465;195;0;0;0;0;.00nan;0;0
36132;-1;189;49;1;0;1;1.000;315000;0
36132;-1;189;38;40;7;33;.825;3285000;0
35035;192915;179;91;39;2;37;.949;3550000;0
35035;195251;4949;77;18;1;17;.944;3600000;0
35035;187355;179;0;0;0;0;.00nan;0;0
35035;-1;4949;0;0;0;0;.00nan;0;0
36107;200333;194;58;23;2;21;.913;3560000;0
36107;201585;197;91;34;1;33;.971;3600000;0
36107;206822;197;0;0;0;0;.00nan;0;0
36107;196352;194;0;0;0;0;.00nan;0;0
36157;196571;177;69;25;2;23;.920;3900000;0
36157;213399;216;0;0;0;0;.00nan;0;0
36157;-1;216;83;33;2;31;.939;3900000;0
36157;-1;177;0;0;0;0;.00nan;0;0
36065;189902;204;0;0;0;0;.00nan;0;0
36065;201525;203;66;41;4;37;.902;3600000;0
36065;206772;203;0;0;0;0;.00nan;0;0
36065;203120;204;66;33;3;30;.909;3600000;0
35113;190164;4959;0;0;0;0;.00nan;0;0
35113;186332;4864;64;22;2;20;.909;3600000;0
35113;202801;4864;0;0;0;0;.00nan;0;0
35113;-1;4959;68;37;4;33;.892;3577000;0
35203;188977;215;0;0;0;0;.00nan;0;0
35203;210794;215;95;48;2;46;.958;3600000;0
35203;-1;219;76;23;1;22;.957;3600000;0
35203;-1;219;0;0;0;0;.00nan;0;0
35067;192915;179;83;39;3;36;.923;3600000;0
35067;196571;177;0;0;0;0;.00nan;0;0
35067;187355;179;0;0;0;0;.00nan;0;0
35067;-1;177;100;26;0;26;1.000;3600000;0
35197;209915;231;0;0;0;0;.00nan;0;0
35197;189773;231;75;21;1;20;.952;3600000;0
35197;180377;228;0;0;0;0;.00nan;0;0
35197;208044;228;78;54;4;50;.926;3600000;0
35020;192929;222;76;26;1;25;.962;3600000;0
35020;194219;4960;0;0;0;0;.00nan;0;0
35020;206971;4960;55;26;3;23;.885;3522000;0
35020;213560;222;0;0;0;0;.00nan;0;0
35311;190034;217;74;19;1;18;.947;3600000;0
35311;190041;217;0;0;0;0;.00nan;0;0
35311;191063;211;0;0;0;0;.00nan;0;0
35311;-1;211;90;38;2;36;.947;3553000;0
35172;191130;186;0;0;0;0;.00nan;0;0
35172;-1;180;83;36;2;34;.944;3600000;0
35172;213507;186;69;32;3;29;.906;3600000;0
35172;208383;180;0;0;0;0;.00nan;0;0
35188;192862;187;0;0;0;0;.00nan;0;0
35188;184788;198;60;29;3;26;.897;3600000;0
35188;212143;198;0;0;0;0;.00nan;0;0
35188;-1;187;68;34;4;30;.882;3584000;0
35153;-1;220;61;8;0;8;1.000;1388000;0
35153;-1;220;16;18;6;12;.667;2212000;0
35153;-1;1371;100;27;0;27;1.000;3600000;0
35153;-1;1371;0;0;0;0;.00nan;0;0
34996;210504;193;79;22;1;21;.955;3600000;0
34996;189529;193;0;0;0;0;.00nan;0;0
34996;191118;196;71;40;4;36;.900;3600000;0
34996;202830;196;0;0;0;0;.00nan;0;0
35058;201514;227;0;0;0;0;.00nan;0;0
35058;191120;223;0;0;0;0;.00nan;0;0
35058;187118;223;70;32;3;29;.906;3574000;0
35058;213280;227;66;26;2;24;.923;3600000;0
35148;192939;208;76;26;2;24;.923;3550000;0
35148;205788;207;0;0;0;0;.00nan;0;0
35148;197853;207;92;31;1;30;.968;3600000;0
35148;-1;208;0;0;0;0;.00nan;0;0
35072;-1;209;42;35;5;30;.857;3600000;0
35072;-1;2620;73;30;3;27;.900;3600000;0
35072;213550;2620;0;0;0;0;.00nan;0;0
35072;213590;209;0;0;0;0;.00nan;0;0
35223;211942;183;76;21;1;20;.952;3600000;0
35223;196237;183;0;0;0;0;.00nan;0;0
35223;-1;178;84;37;2;35;.946;3600000;0
35223;-1;178;0;0;0;0;.00nan;0;0
34999;182467;185;75;34;3;31;.912;3598000;0
34999;200306;182;0;0;0;0;.00nan;0;0
34999;185810;182;68;26;2;24;.923;3600000;0
34999;-1;185;0;0;0;0;.00nan;0;0
35039;195251;4949;68;19;1;18;.947;3600000;0
35039;201495;213;76;37;2;35;.946;3556000;0
35039;-1;213;0;0;0;0;.00nan;0;0
35039;-1;4949;0;0;0;0;.00nan;0;0
35109;195164;218;77;27;2;25;.926;3600000;0
35109;-1;219;0;0;0;0;.00nan;0;0
35109;-1;219;78;46;4;42;.913;3570000;0
35109;208051;218;0;0;0;0;.00nan;0;0
35030;200437;201;95;34;1;33;.971;3600000;0
35030;201560;202;63;32;3;29;.906;3568000;0
35030;212028;202;0;0;0;0;.00nan;0;0
35030;208048;201;0;0;0;0;.00nan;0;0
35156;-1;192;68;45;5;40;.889;3554000;0
35156;207398;192;0;0;0;0;.00nan;0;0
35156;192547;190;68;36;4;32;.889;3600000;0
35156;-1;190;0;0;0;0;.00nan;0;0
35337;205769;200;0;0;0;0;.00nan;0;0
35337;195238;200;89;32;1;31;.969;3564000;0
35337;201524;205;0;0;0;0;.00nan;0;0
35337;-1;205;100;37;0;37;1.000;3600000;0
35196;191063;211;89;30;1;29;.967;3600000;0
35196;191130;186;71;30;3;27;.900;3600000;0
35196;-1;211;0;0;0;0;.00nan;0;0
35196;213507;186;0;0;0;0;.00nan;0;0
35059;205681;226;0;0;0;0;.00nan;0;0
35059;201524;205;0;0;0;0;.00nan;0;0
35059;-1;226;80;16;0;16;1.000;3600000;0
35059;-1;205;39;37;6;31;.838;3600000;0
35208;-1;178;0;0;0;0;.00nan;0;0
35208;197672;210;67;16;1;15;.938;3600000;0
35208;-1;178;53;48;6;42;.875;3600000;0
35208;-1;210;0;0;0;0;.00nan;0;0
35116;192929;222;0;0;0;0;.00nan;0;0
35116;183695;232;100;27;0;27;1.000;3600000;0
35116;213560;222;85;28;1;27;.964;3592000;0
35116;-1;232;0;0;0;0;.00nan;0;0
35108;210998;229;0;0;0;0;.00nan;0;0
35108;201514;227;37;26;5;21;.808;3900000;0
35108;185960;229;68;48;5;43;.896;3900000;0
35108;213280;227;0;0;0;0;.00nan;0;0
35066;201585;197;76;43;4;39;.907;3576000;0
35066;206822;197;0;0;0;0;.00nan;0;0
35066;-1;189;0;0;0;0;.00nan;0;0
35066;-1;189;67;18;2;16;.889;3600000;0
35103;205769;200;49;28;4;24;.857;3600000;0
35103;205788;207;99;40;1;39;.975;3600000;0
35103;195238;200;0;0;0;0;.00nan;0;0
35103;197853;207;0;0;0;0;.00nan;0;0
34967;182467;185;0;0;0;0;.00nan;0;0
34967;-1;220;0;0;0;0;.00nan;0;0
34967;-1;220;69;23;3;20;.870;3600000;0
34967;-1;185;47;37;5;32;.865;3571000;0
35004;200444;224;93;18;0;18;1.000;3600000;0
35004;206800;225;0;0;0;0;.00nan;0;0
35004;-1;225;69;30;3;27;.900;3600000;0
35004;208372;224;0;0;0;0;.00nan;0;0
36038;210134;1505;0;0;0;0;.00nan;0;0
36038;211942;183;0;0;0;0;.00nan;0;0
36038;196237;183;71;32;2;30;.938;3638000;0
36038;-1;1505;78;25;1;24;.960;3638000;0
35122;206801;176;52;8;1;7;.875;3600000;0
35122;186332;4864;0;0;0;0;.00nan;0;0
35122;202801;4864;93;54;5;49;.907;3600000;0
35122;203099;176;0;0;0;0;.00nan;0;0
35003;209840;184;0;0;0;0;.00nan;0;0
35003;205837;184;44;26;4;22;.846;3514000;0
35003;191518;214;100;46;2;44;.957;3600000;0
35003;202914;214;0;0;0;0;.00nan;0;0
35019;210504;193;0;0;0;0;.00nan;0;0
35019;189529;193;76;27;2;25;.926;3600000;0
35019;192547;190;0;0;0;0;.00nan;0;0
35019;-1;190;73;45;4;41;.911;3592000;0
35129;201495;213;0;0;0;0;.00nan;0;0
35129;213399;216;0;0;0;0;.00nan;0;0
35129;-1;213;84;28;1;27;.964;3600000;0
35129;-1;216;57;36;4;32;.889;3600000;0
35016;200437;201;0;0;0;0;.00nan;0;0
35016;189902;204;85;29;1;28;.966;3900000;0
35016;208048;201;87;26;1;25;.962;3900000;0
35016;203120;204;0;0;0;0;.00nan;0;0
35073;188977;215;0;0;0;0;.00nan;0;0
35073;210794;215;57;29;4;25;.862;3587000;0
35073;195164;218;0;0;0;0;.00nan;0;0
35073;208051;218;62;20;2;18;.900;3600000;0
35095;-1;209;0;0;0;0;.00nan;0;0
35095;-1;2620;0;0;0;0;.00nan;0;0
35095;213550;2620;62;30;3;27;.900;3515000;0
35095;213590;209;99;38;1;37;.974;3600000;0
35169;201525;203;67;28;2;26;.929;3900000;0
35169;206772;203;0;0;0;0;.00nan;0;0
35169;-1;199;0;0;0;0;.00nan;0;0
35169;-1;199;96;35;2;33;.943;3900000;0
36146;-1;192;0;0;0;0;.00nan;0;0
36146;207061;195;56;26;3;23;.885;3900000;0
36146;196465;195;0;0;0;0;.00nan;0;0
36146;207398;192;75;37;3;34;.919;3900000;0
35134;190034;217;0;0;0;0;.00nan;0;0
35134;190041;217;77;34;3;31;.912;3900000;0
35134;184874;212;41;24;3;21;.875;3900000;0
35134;-1;212;0;0;0;0;.00nan;0;0
34980;200306;182;52;30;4;26;.867;3900000;0
34980;190038;181;0;0;0;0;.00nan;0;0
34980;185810;182;0;0;0;0;.00nan;0;0
34980;192552;181;67;33;4;29;.879;3900000;0
35167;198149;188;0;0;0;0;.00nan;0;0
35167;200333;194;44;29;5;24;.828;2905000;0
35167;184409;188;60;19;2;17;.895;3600000;0
35167;196352;194;58;13;1;12;.923;695000;0
35330;201560;202;0;0;0;0;.00nan;0;0
35330;212028;202;38;22;4;18;.818;3523000;0
35330;196283;206;0;0;0;0;.00nan;0;0
35330;202998;206;72;24;2;22;.917;3600000;0
35056;194219;4960;62;24;2;22;.917;3600000;0
35056;200452;221;63;38;4;34;.895;3542000;0
35056;206971;4960;0;0;0;0;.00nan;0;0
35056;-1;221;0;0;0;0;.00nan;0;0
35049;192862;187;0;0;0;0;.00nan;0;0
35049;194893;191;55;23;3;20;.870;3600000;0
35049;201892;191;0;0;0;0;.00nan;0;0
35049;-1;187;70;36;4;32;.889;3597000;0
35124;184874;212;0;0;0;0;.00nan;0;0
35124;-1;212;73;25;1;24;.960;3600000;0
35124;-1;180;0;0;0;0;.00nan;0;0
35124;208383;180;48;26;4;22;.846;3600000;0
35063;183695;232;76;26;2;24;.923;3600000;0
35063;200452;221;0;0;0;0;.00nan;0;0
35063;-1;221;63;36;4;32;.889;3580000;0
35063;-1;232;0;0;0;0;.00nan;0;0
35034;201585;197;0;0;0;0;.00nan;0;0
35034;206822;197;74;40;4;36;.900;3600000;0
35034;-1;189;0;0;0;0;.00nan;0;0
35034;-1;189;79;25;1;24;.960;3600000;0
35074;198149;188;0;0;0;0;.00nan;0;0
35074;184409;188;87;33;1;32;.970;3600000;0
35074;184788;198;0;0;0;0;.00nan;0;0
35074;212143;198;69;24;2;22;.917;3600000;0
35141;186332;4864;49;43;5;38;.884;3570000;0
35141;202801;4864;0;0;0;0;.00nan;0;0
35141;-1;2620;52;24;3;21;.875;3600000;0
35141;213550;2620;0;0;0;0;.00nan;0;0
35446;201524;205;0;0;0;0;.00nan;0;0
35446;196283;206;0;0;0;0;.00nan;0;0
35446;-1;205;82;13;0;13;1.000;3600000;0
35446;202998;206;64;41;4;37;.902;3600000;0
35102;201514;227;0;0;0;0;.00nan;0;0
35102;180377;228;100;43;1;42;.977;3900000;0
35102;213280;227;71;24;1;23;.958;3900000;0
35102;208044;228;0;0;0;0;.00nan;0;0
35105;189902;204;96;46;2;44;.957;3600000;0
35105;201525;203;82;35;3;32;.914;3566000;0
35105;206772;203;0;0;0;0;.00nan;0;0
35105;203120;204;0;0;0;0;.00nan;0;0
35571;191118;196;82;28;2;26;.929;3600000;0
35571;192547;190;71;34;3;31;.912;3557000;0
35571;-1;190;0;0;0;0;.00nan;0;0
35571;202830;196;0;0;0;0;.00nan;0;0
35225;210134;1505;0;0;0;0;.00nan;0;0
35225;-1;178;0;0;0;0;.00nan;0;0
35225;-1;1505;71;26;2;24;.923;3600000;0
35225;-1;178;100;27;0;27;1.000;3600000;0
35323;190034;217;57;24;2;22;.917;3600000;0
35323;190041;217;0;0;0;0;.00nan;0;0
35323;191130;186;0;0;0;0;.00nan;0;0
35323;213507;186;56;26;3;23;.885;3600000;0
35151;195251;4949;84;35;2;33;.943;3600000;0
35151;196571;177;0;0;0;0;.00nan;0;0
35151;-1;4949;0;0;0;0;.00nan;0;0
35151;-1;177;61;28;3;25;.893;3585000;0
35284;192862;187;30;33;6;27;.818;2856000;0
35284;207061;195;0;0;0;0;.00nan;0;0
35284;196465;195;48;25;4;21;.840;3600000;0
35284;-1;187;49;9;1;8;.889;744000;0
35048;194219;4960;0;0;0;0;.00nan;0;0
35048;206800;225;58;37;5;32;.865;3556000;0
35048;206971;4960;53;21;3;18;.857;3600000;0
35048;-1;225;0;0;0;0;.00nan;0;0
34959;190038;181;60;17;2;15;.882;3575000;0
34959;-1;220;0;0;0;0;.00nan;0;0
34959;-1;220;98;36;1;35;.972;3600000;0
34959;192552;181;0;0;0;0;.00nan;0;0
35314;192939;208;75;38;4;34;.895;3556000;0
35314;205681;226;0;0;0;0;.00nan;0;0
35314;-1;226;91;39;3;36;.923;3600000;0
35314;-1;208;0;0;0;0;.00nan;0;0
35198;209840;184;0;0;0;0;.00nan;0;0
35198;205837;184;59;22;2;20;.909;3600000;0
35198;191518;214;67;31;3;28;.903;3546000;0
35198;202914;214;0;0;0;0;.00nan;0;0
35325;201495;213;61;41;5;36;.878;3600000;0
35325;-1;213;0;0;0;0;.00nan;0;0
35325;197672;210;57;25;3;22;.880;3600000;0
35325;-1;210;0;0;0;0;.00nan;0;0
35182;200333;194;91;60;5;55;.917;3600000;0
35182;194893;191;0;0;0;0;.00nan;0;0
35182;201892;191;100;23;0;23;1.000;3600000;0
35182;196352;194;0;0;0;0;.00nan;0;0
35126;206801;176;75;23;1;22;.957;3600000;0
35126;-1;209;83;51;4;47;.922;3600000;0
35126;203099;176;0;0;0;0;.00nan;0;0
35126;213590;209;0;0;0;0;.00nan;0;0
35163;188977;215;0;0;0;0;.00nan;0;0
35163;210794;215;75;40;3;37;.925;3600000;0
35163;-1;180;51;35;5;30;.857;3525000;0
35163;208383;180;0;0;0;0;.00nan;0;0
35075;192915;179;79;63;5;58;.921;3600000;0
35075;211942;183;67;24;2;22;.917;3600000;0
35075;196237;183;0;0;0;0;.00nan;0;0
35075;187355;179;0;0;0;0;.00nan;0;0
35081;200444;224;50;36;4;32;.889;3600000;0
35081;191120;223;0;0;0;0;.00nan;0;0
35081;187118;223;100;43;1;42;.977;3600000;0
35081;208372;224;0;0;0;0;.00nan;0;0
35076;200437;201;81;33;2;31;.939;3646000;0
35076;208048;201;0;0;0;0;.00nan;0;0
35076;-1;199;0;0;0;0;.00nan;0;0
35076;-1;199;57;25;3;22;.880;3646000;0
35070;192915;179;50;41;5;36;.878;3600000;0
35070;210134;1505;80;15;0;15;1.000;3600000;0
35070;187355;179;0;0;0;0;.00nan;0;0
35070;-1;1505;0;0;0;0;.00nan;0;0
35313;210998;229;0;0;0;0;.00nan;0;0
35313;180377;228;0;0;0;0;.00nan;0;0
35313;185960;229;76;22;1;21;.955;3600000;0
35313;208044;228;69;39;4;35;.897;3600000;0
35398;205769;200;0;0;0;0;.00nan;0;0
35398;195238;200;75;33;2;31;.939;3600000;0
35398;196283;206;39;38;6;32;.842;3600000;0
35398;202998;206;0;0;0;0;.00nan;0;0
36028;206801;176;0;0;0;0;.00nan;0;0
36028;186332;4864;0;0;0;0;.00nan;0;0
36028;202801;4864;59;39;5;34;.872;3600000;0
36028;203099;176;65;25;2;23;.920;3600000;0
36101;198149;188;0;0;0;0;.00nan;0;0
36101;184409;188;60;14;1;13;.929;3600000;0
36101;201585;197;0;0;0;0;.00nan;0;0
36101;206822;197;56;41;5;36;.878;3600000;0
35178;-1;192;46;37;6;31;.838;3224000;0
35178;207398;192;50;1;0;1;1.000;376000;0
35178;-1;189;58;23;3;20;.870;3600000;0
35178;-1;189;0;0;0;0;.00nan;0;0
36092;182467;185;89;33;1;32;.970;3900000;0
36092;209840;184;100;45;1;44;.978;3900000;0
36092;205837;184;0;0;0;0;.00nan;0;0
36092;-1;185;0;0;0;0;.00nan;0;0
36165;196571;177;62;26;2;24;.923;3559000;0
36165;-1;178;0;0;0;0;.00nan;0;0
36165;-1;178;100;47;1;46;.979;3600000;0
36165;-1;177;0;0;0;0;.00nan;0;0
35131;211942;183;0;0;0;0;.00nan;0;0
35131;196237;183;80;31;2;29;.935;3600000;0
35131;213399;216;0;0;0;0;.00nan;0;0
35131;-1;216;57;32;4;28;.875;3564000;0
35150;201525;203;78;36;3;33;.917;3562000;0
35150;201560;202;100;44;1;43;.977;3600000;0
35150;212028;202;0;0;0;0;.00nan;0;0
35150;206772;203;0;0;0;0;.00nan;0;0
36110;191063;211;0;0;0;0;.00nan;0;0
36110;191130;186;79;38;3;35;.921;3596000;0
36110;-1;211;82;30;2;28;.933;3600000;0
36110;213507;186;0;0;0;0;.00nan;0;0
35137;195164;218;100;26;0;26;1.000;3600000;0
35137;-1;219;35;20;4;16;.800;3600000;0
35137;-1;219;0;0;0;0;.00nan;0;0
35137;208051;218;0;0;0;0;.00nan;0;0
35065;191518;214;69;15;0;15;1.000;697000;0
35065;202914;214;27;34;6;28;.824;2903000;0
35065;-1;1371;59;26;3;23;.885;3600000;0
35065;-1;1371;0;0;0;0;.00nan;0;0
35005;200306;182;0;0;0;0;.00nan;0;0
35005;190038;181;0;0;0;0;.00nan;0;0
35005;185810;182;62;32;3;29;.906;3600000;0
35005;192552;181;99;23;0;23;1.000;3600000;0
35210;205788;207;0;0;0;0;.00nan;0;0
35210;189902;204;0;0;0;0;.00nan;0;0
35210;197853;207;91;22;0;22;1.000;3600000;0
35210;203120;204;81;36;2;34;.944;3566000;0
35112;209915;231;0;0;0;0;.00nan;0;0
35112;200444;224;0;0;0;0;.00nan;0;0
35112;189773;231;89;19;0;19;1.000;3600000;0
35112;208372;224;80;37;3;34;.919;3600000;0
35189;200333;194;0;0;0;0;.00nan;0;0
35189;184788;198;56;12;1;11;.917;3600000;0
35189;212143;198;0;0;0;0;.00nan;0;0
35189;196352;194;81;55;4;51;.927;3600000;0
36056;190164;4959;76;32;3;29;.906;3783000;0
36056;-1;4959;0;0;0;0;.00nan;0;0
36056;-1;2620;0;0;0;0;.00nan;0;0
36056;213550;2620;73;39;4;35;.897;3783000;0
35147;200452;221;100;28;0;28;1.000;3600000;0
35147;191120;223;0;0;0;0;.00nan;0;0
35147;187118;223;97;45;1;44;.978;3554000;0
35147;-1;221;0;0;0;0;.00nan;0;0
36153;192862;187;0;0;0;0;.00nan;0;0
36153;192547;190;73;29;2;27;.931;3600000;0
36153;-1;190;0;0;0;0;.00nan;0;0
36153;-1;187;72;32;3;29;.906;3545000;0
35259;209915;231;0;0;0;0;.00nan;0;0
35259;200452;221;97;32;1;31;.969;3600000;0
35259;189773;231;57;26;4;22;.846;3600000;0
35259;-1;221;0;0;0;0;.00nan;0;0
35265;187689;230;84;17;0;17;1.000;3600000;0
35265;183678;230;0;0;0;0;.00nan;0;0
35265;206800;225;0;0;0;0;.00nan;0;0
35265;-1;225;93;37;2;35;.946;3574000;0
36159;190164;4959;0;0;0;0;.00nan;0;0
36159;-1;209;75;30;2;28;.933;3900000;0
36159;-1;4959;71;25;2;23;.920;3900000;0
36159;213590;209;0;0;0;0;.00nan;0;0
36203;184788;198;0;0;0;0;.00nan;0;0
36203;212143;198;97;26;0;26;1.000;3600000;0
36203;-1;189;0;0;0;0;.00nan;0;0
36203;-1;189;74;43;4;39;.907;3600000;0
36104;205769;200;77;27;2;25;.926;3600000;0
36104;195238;200;0;0;0;0;.00nan;0;0
36104;201524;205;0;0;0;0;.00nan;0;0
36104;-1;205;60;46;6;40;.870;3600000;0
35619;-1;219;0;0;0;0;.00nan;0;0
35619;-1;219;65;21;2;19;.905;3600000;0
35619;191063;211;50;41;5;36;.878;3600000;0
35619;-1;211;0;0;0;0;.00nan;0;0
35046;210504;193;100;26;0;26;1.000;3600000;0
35046;189529;193;0;0;0;0;.00nan;0;0
35046;207061;195;66;22;2;20;.909;3600000;0
35046;196465;195;0;0;0;0;.00nan;0;0
35364;213399;216;39;32;5;27;.844;3554000;0
35364;197672;210;65;27;3;24;.889;3600000;0
35364;-1;210;0;0;0;0;.00nan;0;0
35364;-1;216;0;0;0;0;.00nan;0;0
35092;192929;222;78;34;2;32;.941;3790000;0
35092;183695;232;0;0;0;0;.00nan;0;0
35092;213560;222;0;0;0;0;.00nan;0;0
35092;-1;232;84;31;1;30;.968;3790000;0
35084;201585;197;0;0;0;0;.00nan;0;0
35084;206822;197;62;52;6;46;.885;3600000;0
35084;191118;196;88;25;1;24;.960;3600000;0
35084;202830;196;0;0;0;0;.00nan;0;0
35160;188977;215;0;0;0;0;.00nan;0;0
35160;210794;215;76;40;4;36;.900;3600000;0
35160;184874;212;0;0;0;0;.00nan;0;0
35160;-1;212;54;11;1;10;.909;3600000;0
35177;205681;226;0;0;0;0;.00nan;0;0
35177;-1;226;70;19;1;18;.947;3600000;0
35177;-1;199;0;0;0;0;.00nan;0;0
35177;-1;199;74;44;4;40;.909;3600000;0
35083;182467;185;57;32;3;29;.906;3049000;0
35083;-1;185;41;13;3;10;.769;551000;0
35083;-1;1371;0;0;0;0;.00nan;0;0
35083;-1;1371;61;27;3;24;.889;3600000;0
36177;200306;182;0;0;0;0;.00nan;0;0
36177;185810;182;99;33;1;32;.970;3600000;0
36177;191518;214;72;35;4;31;.886;3600000;0
36177;202914;214;0;0;0;0;.00nan;0;0
36086;189902;204;74;34;3;31;.912;3600000;0
36086;196283;206;0;0;0;0;.00nan;0;0
36086;202998;206;51;27;5;22;.815;3533000;0
36086;203120;204;0;0;0;0;.00nan;0;0
35310;198149;188;0;0;0;0;.00nan;0;0
35310;184409;188;82;33;1;32;.970;3900000;0
35310;-1;192;0;0;0;0;.00nan;0;0
35310;207398;192;79;31;1;30;.968;3900000;0
35130;210134;1505;33;19;4;15;.789;3900000;0
35130;195251;4949;62;35;4;31;.886;3900000;0
35130;-1;1505;0;0;0;0;.00nan;0;0
35130;-1;4949;0;0;0;0;.00nan;0;0
35193;194893;191;0;0;0;0;.00nan;0;0
35193;201892;191;67;30;3;27;.900;3600000;0
35193;207061;195;0;0;0;0;.00nan;0;0
35193;196465;195;41;27;5;22;.815;3520000;0
35232;206801;176;79;33;2;31;.939;3600000;0
35232;186332;4864;61;29;3;26;.897;3587000;0
35232;202801;4864;0;0;0;0;.00nan;0;0
35232;203099;176;0;0;0;0;.00nan;0;0
35577;187689;230;77;28;1;27;.964;3600000;0
35577;183678;230;0;0;0;0;.00nan;0;0
35577;210998;229;0;0;0;0;.00nan;0;0
35577;185960;229;98;51;2;49;.961;3600000;0
35340;-1;219;82;37;2;35;.946;3600000;0
35340;-1;219;0;0;0;0;.00nan;0;0
35340;191130;186;0;0;0;0;.00nan;0;0
35340;213507;186;38;28;5;23;.821;3600000;0
35173;200437;201;76;34;2;32;.941;3600000;0
35173;201560;202;83;37;3;34;.919;3600000;0
35173;212028;202;0;0;0;0;.00nan;0;0
35173;208048;201;0;0;0;0;.00nan;0;0
35288;190164;4959;0;0;0;0;.00nan;0;0
35288;-1;4959;72;33;2;31;.939;3532000;0
35288;-1;2620;100;34;0;34;1.000;3600000;0
35288;213550;2620;0;0;0;0;.00nan;0;0
35236;184788;198;0;0;0;0;.00nan;0;0
35236;212143;198;67;16;1;15;.938;3600000;0
35236;-1;189;62;32;4;28;.875;3600000;0
35236;-1;189;0;0;0;0;.00nan;0;0
35218;190034;217;57;21;2;19;.905;3551000;0
35218;190041;217;0;0;0;0;.00nan;0;0
35218;-1;180;75;22;1;21;.955;3600000;0
35218;208383;180;0;0;0;0;.00nan;0;0
35389;201524;205;49;9;1;8;.889;689000;0
35389;201525;203;0;0;0;0;.00nan;0;0
35389;206772;203;72;25;2;23;.920;3600000;0
35389;-1;205;34;26;6;20;.769;2911000;0
35061;210504;193;52;23;3;20;.870;3600000;0
35061;189529;193;0;0;0;0;.00nan;0;0
35061;201585;197;0;0;0;0;.00nan;0;0
35061;206822;197;86;52;5;47;.904;3600000;0
35221;192939;208;0;0;0;0;.00nan;0;0
35221;-1;199;63;34;3;31;.912;3900000;0
35221;-1;208;51;21;3;18;.857;3900000;0
35221;-1;199;0;0;0;0;.00nan;0;0
35078;209915;231;100;26;0;26;1.000;3600000;0
35078;200452;221;73;44;4;40;.909;3600000;0
35078;189773;231;0;0;0;0;.00nan;0;0
35078;-1;221;0;0;0;0;.00nan;0;0
35570;-1;192;88;31;1;30;.968;3900000;0
35570;207398;192;0;0;0;0;.00nan;0;0
35570;191118;196;84;33;1;32;.970;3900000;0
35570;202830;196;0;0;0;0;.00nan;0;0
35309;210134;1505;0;0;0;0;.00nan;0;0
35309;213399;216;0;0;0;0;.00nan;0;0
35309;-1;1505;86;26;1;25;.962;3600000;0
35309;-1;216;55;23;3;20;.870;3560000;0
36140;182467;185;66;32;3;29;.906;3513000;0
36140;209840;184;75;23;1;22;.957;3600000;0
36140;205837;184;0;0;0;0;.00nan;0;0
36140;-1;185;0;0;0;0;.00nan;0;0
35255;201514;227;82;27;1;26;.963;3600000;0
35255;191120;223;0;0;0;0;.00nan;0;0
35255;187118;223;72;39;4;35;.897;3600000;0
35255;213280;227;0;0;0;0;.00nan;0;0
35117;194219;4960;90;22;0;22;1.000;3600000;0
35117;200444;224;0;0;0;0;.00nan;0;0
35117;206971;4960;0;0;0;0;.00nan;0;0
35117;208372;224;77;33;3;30;.909;3600000;0
35106;192915;179;0;0;0;0;.00nan;0;0
35106;187355;179;96;38;2;36;.947;3900000;0
35106;197672;210;62;22;2;20;.909;3900000;0
35106;-1;210;0;0;0;0;.00nan;0;0
35262;198149;188;75;31;2;29;.935;3893000;0
35262;200333;194;64;23;2;21;.913;3900000;0
35262;184409;188;0;0;0;0;.00nan;0;0
35262;196352;194;0;0;0;0;.00nan;0;0
36197;201495;213;94;39;1;38;.974;3600000;0
36197;211942;183;52;22;3;19;.864;3516000;0
36197;196237;183;0;0;0;0;.00nan;0;0
36197;-1;213;0;0;0;0;.00nan;0;0
35097;-1;220;38;29;5;24;.828;3562000;0
35097;-1;220;0;0;0;0;.00nan;0;0
35097;-1;1371;35;19;4;15;.789;3600000;0
35097;-1;1371;0;0;0;0;.00nan;0;0
36192;196571;177;86;20;0;20;1.000;3600000;0
36192;-1;178;0;0;0;0;.00nan;0;0
36192;-1;178;58;41;5;36;.878;3600000;0
36192;-1;177;0;0;0;0;.00nan;0;0
35085;190038;181;0;0;0;0;.00nan;0;0
35085;191518;214;0;0;0;0;.00nan;0;0
35085;192552;181;74;19;1;18;.947;3600000;0
35085;202914;214;67;46;4;42;.913;3600000;0
36199;205681;226;0;0;0;0;.00nan;0;0
36199;205769;200;0;0;0;0;.00nan;0;0
36199;195238;200;42;26;5;21;.808;3600000;0
36199;-1;226;99;32;1;31;.969;3600000;0
35207;200333;194;71;17;0;17;1.000;817000;0
35207;196352;194;29;31;6;25;.806;2783000;0
35207;192547;190;56;26;3;23;.885;3600000;0
35207;-1;190;0;0;0;0;.00nan;0;0
35120;192915;179;87;41;3;38;.927;3564000;0
35120;195251;4949;62;20;2;18;.900;3600000;0
35120;187355;179;0;0;0;0;.00nan;0;0
35120;-1;4949;0;0;0;0;.00nan;0;0
35183;194219;4960;61;23;3;20;.870;3600000;0
35183;201514;227;0;0;0;0;.00nan;0;0
35183;206971;4960;0;0;0;0;.00nan;0;0
35183;213280;227;100;23;0;23;1.000;3600000;0
35212;205788;207;0;0;0;0;.00nan;0;0
35212;201524;205;0;0;0;0;.00nan;0;0
35212;197853;207;65;34;3;31;.912;3590000;0
35212;-1;205;70;23;2;21;.913;3600000;0
35054;192862;187;70;38;4;34;.895;3600000;0
35054;210504;193;45;37;5;32;.865;3558000;0
35054;189529;193;0;0;0;0;.00nan;0;0
35054;-1;187;0;0;0;0;.00nan;0;0
35125;192929;222;0;0;0;0;.00nan;0;0
35125;180377;228;72;18;2;16;.889;3600000;0
35125;208044;228;0;0;0;0;.00nan;0;0
35125;213560;222;68;34;3;31;.912;3597000;0
35271;201495;213;0;0;0;0;.00nan;0;0
35271;-1;178;81;25;1;24;.960;3600000;0
35271;-1;213;78;27;2;25;.926;3581000;0
35271;-1;178;0;0;0;0;.00nan;0;0
35684;205769;200;53;31;4;27;.871;3595000;0
35684;195238;200;0;0;0;0;.00nan;0;0
35684;196283;206;0;0;0;0;.00nan;0;0
35684;202998;206;70;32;3;29;.906;3600000;0
35257;205681;226;71;23;2;21;.913;3561000;0
35257;201560;202;0;0;0;0;.00nan;0;0
35257;212028;202;93;41;1;40;.976;3600000;0
35257;-1;226;0;0;0;0;.00nan;0;0
35341;190034;217;0;0;0;0;.00nan;0;0
35341;190041;217;86;35;2;33;.943;3600000;0
35341;-1;219;0;0;0;0;.00nan;0;0
35341;-1;219;70;59;6;53;.898;3600000;0
35214;194893;191;72;21;1;20;.952;3600000;0
35214;201892;191;0;0;0;0;.00nan;0;0
35214;-1;189;0;0;0;0;.00nan;0;0
35214;-1;189;65;46;6;40;.870;3600000;0
35375;196571;177;42;29;5;24;.828;3600000;0
35375;197672;210;0;0;0;0;.00nan;0;0
35375;-1;210;70;22;2;20;.909;3600000;0
35375;-1;177;0;0;0;0;.00nan;0;0
35440;209840;184;0;0;0;0;.00nan;0;0
35440;205837;184;69;26;2;24;.923;3576000;0
35440;-1;1371;0;0;0;0;.00nan;0;0
35440;-1;1371;74;21;1;20;.952;3600000;0
35179;186332;4864;68;32;3;29;.906;3577000;0
35179;-1;209;67;26;2;24;.923;3600000;0
35179;202801;4864;0;0;0;0;.00nan;0;0
35179;213590;209;0;0;0;0;.00nan;0;0
35476;192939;208;50;26;3;23;.885;3552000;0
35476;-1;199;0;0;0;0;.00nan;0;0
35476;-1;208;0;0;0;0;.00nan;0;0
35476;-1;199;100;36;1;35;.972;3600000;0
35222;187689;230;0;0;0;0;.00nan;0;0
35222;183678;230;69;24;2;22;.917;3600000;0
35222;191120;223;0;0;0;0;.00nan;0;0
35222;187118;223;56;40;5;35;.875;3600000;0
35186;184788;198;72;36;3;33;.917;3600000;0
35186;212143;198;0;0;0;0;.00nan;0;0
35186;207061;195;83;23;1;22;.957;3600000;0
35186;196465;195;0;0;0;0;.00nan;0;0
35144;188977;215;22;5;3;2;.400;267000;0
35144;210794;215;49;27;4;23;.852;3333000;0
35144;195164;218;63;20;2;18;.900;3600000;0
35144;208051;218;0;0;0;0;.00nan;0;0
35164;184874;212;0;0;0;0;.00nan;0;0
35164;191063;211;0;0;0;0;.00nan;0;0
35164;-1;212;68;17;1;16;.941;3600000;0
35164;-1;211;74;42;4;38;.905;3600000;0
35154;189902;204;31;29;6;23;.793;2865000;0
35154;201525;203;67;31;3;28;.903;3600000;0
35154;206772;203;0;0;0;0;.00nan;0;0
35154;203120;204;55;13;1;12;.923;735000;0
35043;182467;185;0;0;0;0;.00nan;0;0
35043;200306;182;0;0;0;0;.00nan;0;0
35043;185810;182;45;24;4;20;.833;3900000;0
35043;-1;185;77;46;4;42;.913;3900000;0
35155;190038;181;56;22;3;19;.864;3519000;0
35155;-1;220;0;0;0;0;.00nan;0;0
35155;-1;220;80;24;1;23;.958;3600000;0
35155;192552;181;0;0;0;0;.00nan;0;0
35128;200444;224;88;26;1;25;.962;3600000;0
35128;210998;229;35;25;5;20;.800;3600000;0
35128;185960;229;0;0;0;0;.00nan;0;0
35128;208372;224;0;0;0;0;.00nan;0;0
35275;209915;231;0;0;0;0;.00nan;0;0
35275;189773;231;80;20;1;19;.950;3600000;0
35275;206800;225;0;0;0;0;.00nan;0;0
35275;-1;225;69;58;7;51;.879;3600000;0
35702;192862;187;0;0;0;0;.00nan;0;0
35702;191118;196;80;47;3;44;.936;3581000;0
35702;-1;187;72;25;2;23;.920;3600000;0
35702;202830;196;0;0;0;0;.00nan;0;0
35158;200437;201;0;0;0;0;.00nan;0;0
35158;196283;206;46;35;6;29;.829;3066000;0
35158;208048;201;56;28;4;24;.857;3600000;0
35158;202998;206;43;4;1;3;.750;534000;0
35272;192929;222;39;39;6;33;.846;3600000;0
35272;183695;232;64;24;2;22;.917;3600000;0
35272;213560;222;0;0;0;0;.00nan;0;0
35272;-1;232;0;0;0;0;.00nan;0;0
35235;194893;191;0;0;0;0;.00nan;0;0
35235;201892;191;73;29;3;26;.897;3849000;0
35235;192547;190;0;0;0;0;.00nan;0;0
35235;-1;190;88;46;3;43;.935;3900000;0
35168;184874;212;40;25;4;21;.840;3600000;0
35168;-1;212;0;0;0;0;.00nan;0;0
35168;-1;180;67;31;3;28;.903;3600000;0
35168;208383;180;0;0;0;0;.00nan;0;0
35245;190164;4959;0;0;0;0;.00nan;0;0
35245;186332;4864;0;0;0;0;.00nan;0;0
35245;202801;4864;58;26;3;23;.885;3573000;0
35245;-1;4959;72;27;2;25;.926;3600000;0
35233;198149;188;0;0;0;0;.00nan;0;0
35233;184409;188;82;49;4;45;.918;3595000;0
35233;207061;195;0;0;0;0;.00nan;0;0
35233;196465;195;52;13;2;11;.846;3600000;0
35143;188977;215;51;2;0;2;1.000;299000;0
35143;210794;215;71;52;6;46;.885;3301000;0
35143;195164;218;69;20;1;19;.950;3600000;0
35143;208051;218;0;0;0;0;.00nan;0;0
35136;200437;201;76;34;3;31;.912;3600000;0
35136;201524;205;89;35;2;33;.943;3600000;0
35136;208048;201;0;0;0;0;.00nan;0;0
35136;-1;205;0;0;0;0;.00nan;0;0
35068;198149;188;52;44;6;38;.864;3600000;0
35068;210504;193;85;19;0;19;1.000;3600000;0
35068;189529;193;0;0;0;0;.00nan;0;0
35068;184409;188;0;0;0;0;.00nan;0;0
35138;195251;4949;0;0;0;0;.00nan;0;0
35138;211942;183;94;29;1;28;.966;3600000;0
35138;196237;183;0;0;0;0;.00nan;0;0
35138;-1;4949;74;26;2;24;.923;3600000;0
35251;210134;1505;55;29;3;26;.897;3547000;0
35251;213399;216;0;0;0;0;.00nan;0;0
35251;-1;1505;0;0;0;0;.00nan;0;0
35251;-1;216;75;29;2;27;.931;3600000;0
35331;209840;184;91;35;2;33;.943;3900000;0
35331;205837;184;0;0;0;0;.00nan;0;0
35331;-1;220;0;0;0;0;.00nan;0;0
35331;-1;220;60;25;2;23;.920;3896000;0
35390;201495;213;100;30;0;30;1.000;3600000;0
35390;196571;177;58;36;4;32;.889;3600000;0
35390;-1;213;0;0;0;0;.00nan;0;0
35390;-1;177;0;0;0;0;.00nan;0;0
35149;201585;197;0;0;0;0;.00nan;0;0
35149;206822;197;80;39;3;36;.923;3582000;0
35149;-1;192;56;12;1;11;.917;3600000;0
35149;207398;192;0;0;0;0;.00nan;0;0
35402;192939;208;98;19;0;19;1.000;3600000;0
35402;-1;199;0;0;0;0;.00nan;0;0
35402;-1;208;0;0;0;0;.00nan;0;0
35402;-1;199;84;45;3;42;.933;3600000;0
35290;-1;178;65;10;0;10;1.000;1390000;0
35290;197672;210;71;31;2;29;.935;3600000;0
35290;-1;178;47;37;6;31;.838;2210000;0
35290;-1;210;0;0;0;0;.00nan;0;0
35293;187689;230;19;27;6;21;.778;3600000;0
35293;183678;230;0;0;0;0;.00nan;0;0
35293;200452;221;100;34;0;34;1.000;3600000;0
35293;-1;221;0;0;0;0;.00nan;0;0
35242;209915;231;0;0;0;0;.00nan;0;0
35242;189773;231;42;24;4;20;.833;3534000;0
35242;191120;223;0;0;0;0;.00nan;0;0
35242;187118;223;100;49;2;47;.959;3600000;0
35181;191063;211;0;0;0;0;.00nan;0;0
35181;-1;180;0;0;0;0;.00nan;0;0
35181;-1;211;85;45;3;42;.933;3577000;0
35181;208383;180;55;12;1;11;.917;3600000;0
35089;182467;185;91;28;1;27;.964;3600000;0
35089;200306;182;0;0;0;0;.00nan;0;0
35089;185810;182;61;31;3;28;.903;3518000;0
35089;-1;185;0;0;0;0;.00nan;0;0
35166;206801;176;61;30;3;27;.900;3650000;0
35166;-1;209;67;38;4;34;.895;3650000;0
35166;203099;176;0;0;0;0;.00nan;0;0
35166;213590;209;0;0;0;0;.00nan;0;0
35162;194219;4960;86;43;2;41;.953;3900000;0
35162;206971;4960;0;0;0;0;.00nan;0;0
35162;180377;228;76;29;2;27;.931;3900000;0
35162;208044;228;0;0;0;0;.00nan;0;0
36127;205769;200;0;0;0;0;.00nan;0;0
36127;195238;200;60;34;4;30;.882;3900000;0
36127;201560;202;44;20;4;16;.800;3900000;0
36127;212028;202;0;0;0;0;.00nan;0;0
35292;205681;226;0;0;0;0;.00nan;0;0
35292;189902;204;87;46;3;43;.935;3600000;0
35292;-1;226;96;20;0;20;1.000;3600000;0
35292;203120;204;0;0;0;0;.00nan;0;0
36072;210134;1505;0;0;0;0;.00nan;0;0
36072;196571;177;0;0;0;0;.00nan;0;0
36072;-1;1505;49;27;4;23;.852;3545000;0
36072;-1;177;76;28;3;25;.893;3600000;0
35170;184874;212;0;0;0;0;.00nan;0;0
35170;-1;219;62;31;4;27;.871;3582000;0
35170;-1;219;0;0;0;0;.00nan;0;0
35170;-1;212;70;28;3;25;.893;3600000;0
35357;-1;192;51;11;1;10;.909;1494000;0
35357;207398;192;41;24;4;20;.833;2023000;0
35357;-1;189;74;29;3;26;.897;3600000;0
35357;-1;189;0;0;0;0;.00nan;0;0
35404;207061;195;69;24;2;22;.917;3600000;0
35404;196465;195;0;0;0;0;.00nan;0;0
35404;191118;196;81;37;3;34;.919;3600000;0
35404;202830;196;0;0;0;0;.00nan;0;0
35140;192915;179;0;0;0;0;.00nan;0;0
35140;211942;183;0;0;0;0;.00nan;0;0
35140;196237;183;57;21;3;18;.857;3600000;0
35140;187355;179;63;43;5;38;.884;3519000;0
35157;182467;185;0;0;0;0;.00nan;0;0
35157;-1;185;80;35;2;33;.943;3600000;0
35157;191518;214;39;20;4;16;.800;3584000;0
35157;202914;214;0;0;0;0;.00nan;0;0
35507;209840;184;0;0;0;0;.00nan;0;0
35507;205837;184;72;34;3;31;.912;3564000;0
35507;-1;1371;67;28;2;26;.929;3600000;0
35507;-1;1371;0;0;0;0;.00nan;0;0
35473;183695;232;81;14;0;14;1.000;3600000;0
35473;180377;228;59;33;4;29;.879;2920000;0
35473;208044;228;24;12;4;8;.667;680000;0
35473;-1;232;0;0;0;0;.00nan;0;0
35711;201525;203;61;19;2;17;.895;3600000;0
35711;206772;203;0;0;0;0;.00nan;0;0
35711;196283;206;48;0;0;0;.00nan;300000;0
35711;202998;206;39;27;5;22;.815;3300000;0
35215;205788;207;73;37;3;34;.919;3545000;0
35215;201560;202;0;0;0;0;.00nan;0;0
35215;212028;202;82;32;2;30;.938;3600000;0
35215;197853;207;0;0;0;0;.00nan;0;0
35254;200333;194;71;38;3;35;.921;3600000;0
35254;196352;194;0;0;0;0;.00nan;0;0
35254;192547;190;48;26;4;22;.846;3597000;0
35254;-1;190;0;0;0;0;.00nan;0;0
35287;192929;222;0;0;0;0;.00nan;0;0
35287;201514;227;0;0;0;0;.00nan;0;0
35287;213280;227;65;23;2;21;.913;3600000;0
35287;213560;222;67;44;5;39;.886;3600000;0
35285;190164;4959;98;32;1;31;.969;3600000;0
35285;-1;4959;0;0;0;0;.00nan;0;0
35285;-1;2620;80;33;2;31;.939;3564000;0
35285;213550;2620;0;0;0;0;.00nan;0;0
35238;192862;187;0;0;0;0;.00nan;0;0
35238;194893;191;66;18;1;17;.944;3600000;0
35238;201892;191;0;0;0;0;.00nan;0;0
35238;-1;187;88;46;2;44;.957;3600000;0
35247;188977;215;70;32;3;29;.906;3838000;0
35247;210794;215;0;0;0;0;.00nan;0;0
35247;190034;217;79;31;2;29;.935;3838000;0
35247;190041;217;0;0;0;0;.00nan;0;0
35174;206801;176;97;23;0;23;1.000;3600000;0
35174;-1;209;96;36;3;33;.917;3600000;0
35174;203099;176;0;0;0;0;.00nan;0;0
35174;213590;209;0;0;0;0;.00nan;0;0
36098;184874;212;61;19;2;17;.895;3600000;0
36098;-1;219;0;0;0;0;.00nan;0;0
36098;-1;219;57;34;4;30;.882;3542000;0
36098;-1;212;0;0;0;0;.00nan;0;0
35302;210998;229;0;0;0;0;.00nan;0;0
35302;206800;225;44;34;5;29;.853;3600000;0
35302;-1;225;0;0;0;0;.00nan;0;0
35302;185960;229;89;32;1;31;.969;3600000;0
35409;209915;231;0;0;0;0;.00nan;0;0
35409;189773;231;64;20;2;18;.900;3600000;0
35409;191120;223;0;0;0;0;.00nan;0;0
35409;187118;223;72;46;4;42;.913;3552000;0
36189;207061;195;0;0;0;0;.00nan;0;0
36189;196465;195;62;19;2;17;.895;3600000;0
36189;-1;189;0;0;0;0;.00nan;0;0
36189;-1;189;75;45;5;40;.889;3600000;0
36142;192862;187;61;16;1;15;.938;3563000;0
36142;191118;196;0;0;0;0;.00nan;0;0
36142;-1;187;0;0;0;0;.00nan;0;0
36142;202830;196;100;41;0;41;1.000;3600000;0
35301;-1;178;0;0;0;0;.00nan;0;0
35301;213399;216;0;0;0;0;.00nan;0;0
35301;-1;178;68;32;3;29;.906;3583000;0
35301;-1;216;57;9;1;8;.889;3600000;0
35142;200444;224;56;20;2;18;.900;3578000;0
35142;200452;221;100;25;0;25;1.000;3600000;0
35142;208372;224;0;0;0;0;.00nan;0;0
35142;-1;221;0;0;0;0;.00nan;0;0
35226;184788;198;92;32;1;31;.969;3600000;0
35226;201585;197;0;0;0;0;.00nan;0;0
35226;206822;197;56;20;2;18;.900;3581000;0
35226;212143;198;0;0;0;0;.00nan;0;0
35806;195164;218;88;27;1;26;.963;3600000;0
35806;-1;180;53;41;5;36;.878;3600000;0
35806;208051;218;0;0;0;0;.00nan;0;0
35806;208383;180;0;0;0;0;.00nan;0;0
35532;205681;226;0;0;0;0;.00nan;0;0
35532;205769;200;0;0;0;0;.00nan;0;0
35532;195238;200;80;50;5;45;.900;3538000;0
35532;-1;226;44;15;3;12;.800;3600000;0
36193;192939;208;48;17;3;14;.824;3652000;0
36193;201525;203;0;0;0;0;.00nan;0;0
36193;206772;203;72;43;4;39;.907;3652000;0
36193;-1;208;0;0;0;0;.00nan;0;0
35963;190038;181;0;0;0;0;.00nan;0;0
35963;192552;181;98;30;1;29;.967;3600000;0
35963;-1;1371;0;0;0;0;.00nan;0;0
35963;-1;1371;58;28;3;25;.893;3586000;0
35425;210134;1505;0;0;0;0;.00nan;0;0
35425;201495;213;82;36;2;34;.944;3794000;0
35425;-1;1505;42;17;3;14;.824;3794000;0
35425;-1;213;0;0;0;0;.00nan;0;0
35328;206801;176;0;0;0;0;.00nan;0;0
35328;-1;2620;83;34;2;32;.941;3600000;0
35328;203099;176;62;28;3;25;.893;3567000;0
35328;213550;2620;0;0;0;0;.00nan;0;0
35216;205788;207;0;0;0;0;.00nan;0;0
35216;189902;204;65;26;2;24;.923;3598000;0
35216;197853;207;84;30;1;29;.967;3600000;0
35216;203120;204;0;0;0;0;.00nan;0;0
35339;187689;230;52;15;2;13;.867;3600000;0
35339;183678;230;0;0;0;0;.00nan;0;0
35339;206800;225;0;0;0;0;.00nan;0;0
35339;-1;225;75;64;6;58;.906;3600000;0
36111;194219;4960;81;32;2;30;.938;3600000;0
36111;206971;4960;0;0;0;0;.00nan;0;0
36111;180377;228;57;35;4;31;.886;3542000;0
36111;208044;228;0;0;0;0;.00nan;0;0
36084;213399;216;58;35;4;31;.886;3600000;0
36084;197672;210;87;25;1;24;.960;3600000;0
36084;-1;210;0;0;0;0;.00nan;0;0
36084;-1;216;0;0;0;0;.00nan;0;0
36152;183695;232;64;31;4;27;.871;3900000;0
36152;200444;224;0;0;0;0;.00nan;0;0
36152;208372;224;63;30;4;26;.867;3900000;0
36152;-1;232;0;0;0;0;.00nan;0;0
35026;200306;182;0;0;0;0;.00nan;0;0
35026;185810;182;64;32;3;29;.906;3600000;0
35026;191518;214;56;33;5;28;.848;3528000;0
35026;202914;214;0;0;0;0;.00nan;0;0
35145;195164;218;0;0;0;0;.00nan;0;0
35145;191063;211;68;19;1;18;.947;3600000;0
35145;208051;218;94;35;2;33;.943;3600000;0
35145;-1;211;0;0;0;0;.00nan;0;0
35219;195251;4949;79;38;3;35;.921;3543000;0
35219;211942;183;81;34;2;32;.941;3600000;0
35219;196237;183;0;0;0;0;.00nan;0;0
35219;-1;4949;0;0;0;0;.00nan;0;0
36181;201585;197;96;36;1;35;.972;3900000;0
36181;206822;197;0;0;0;0;.00nan;0;0
36181;192547;190;85;24;1;23;.958;3900000;0
36181;-1;190;0;0;0;0;.00nan;0;0
35315;192929;222;78;34;2;32;.941;3600000;0
35315;210998;229;58;28;3;25;.893;3586000;0
35315;185960;229;0;0;0;0;.00nan;0;0
35315;213560;222;0;0;0;0;.00nan;0;0
35246;-1;219;75;41;4;37;.902;3553000;0
35246;-1;219;0;0;0;0;.00nan;0;0
35246;-1;180;81;30;2;28;.933;3600000;0
35246;208383;180;0;0;0;0;.00nan;0;0
35224;194219;4960;0;0;0;0;.00nan;0;0
35224;206971;4960;65;23;2;21;.913;3589000;0
35224;191120;223;0;0;0;0;.00nan;0;0
35224;187118;223;96;38;1;37;.974;3600000;0
35724;192939;208;58;41;5;36;.878;3600000;0
35724;201524;205;0;0;0;0;.00nan;0;0
35724;-1;208;0;0;0;0;.00nan;0;0
35724;-1;205;79;31;2;29;.935;3600000;0
35205;192915;179;43;30;5;25;.833;3600000;0
35205;211942;183;0;0;0;0;.00nan;0;0
35205;196237;183;64;22;2;20;.909;3600000;0
35205;187355;179;0;0;0;0;.00nan;0;0
35201;209840;184;70;26;2;24;.923;3900000;0
35201;205837;184;0;0;0;0;.00nan;0;0
35201;191518;214;0;0;0;0;.00nan;0;0
35201;202914;214;66;26;2;24;.923;3900000;0
35217;205769;200;73;23;1;22;.957;3600000;0
35217;195238;200;0;0;0;0;.00nan;0;0
35217;189902;204;0;0;0;0;.00nan;0;0
35217;203120;204;67;29;3;26;.897;3519000;0
35199;186332;4864;49;18;3;15;.833;3900000;0
35199;-1;209;89;40;3;37;.925;3900000;0
35199;202801;4864;0;0;0;0;.00nan;0;0
35199;213590;209;0;0;0;0;.00nan;0;0
35429;209915;231;0;0;0;0;.00nan;0;0
35429;189773;231;72;21;1;20;.952;3600000;0
35429;201514;227;88;43;3;40;.930;3579000;0
35429;213280;227;0;0;0;0;.00nan;0;0
35996;192929;222;0;0;0;0;.00nan;0;0
35996;200452;221;54;32;5;27;.844;3600000;0
35996;213560;222;73;21;2;19;.905;3600000;0
35996;-1;221;0;0;0;0;.00nan;0;0
35195;190034;217;80;41;3;38;.927;3600000;0
35195;190041;217;0;0;0;0;.00nan;0;0
35195;184874;212;46;10;2;8;.800;1206000;0
35195;-1;212;26;22;5;17;.773;2394000;0
35348;196571;177;58;31;4;27;.871;3544000;0
35348;-1;178;0;0;0;0;.00nan;0;0
35348;-1;178;83;44;3;41;.932;3600000;0
35348;-1;177;0;0;0;0;.00nan;0;0
35280;194893;191;88;18;0;18;1.000;3600000;0
35280;184788;198;56;13;1;12;.923;1481000;0
35280;212143;198;48;32;5;27;.844;2119000;0
35280;201892;191;0;0;0;0;.00nan;0;0
35248;195251;4949;0;0;0;0;.00nan;0;0
35248;197672;210;0;0;0;0;.00nan;0;0
35248;-1;4949;41;22;4;18;.818;3600000;0
35248;-1;210;78;27;1;26;.963;3600000;0
35376;201525;203;48;22;3;19;.864;3600000;0
35376;201560;202;55;33;4;29;.879;3589000;0
35376;212028;202;0;0;0;0;.00nan;0;0
35376;206772;203;0;0;0;0;.00nan;0;0
35371;191063;211;0;0;0;0;.00nan;0;0
35371;191130;186;0;0;0;0;.00nan;0;0
35371;-1;211;57;41;5;36;.878;3600000;0
35371;213507;186;69;24;2;22;.917;3600000;0
35090;210504;193;65;25;2;23;.920;3579000;0
35090;189529;193;0;0;0;0;.00nan;0;0
35090;-1;192;95;28;0;28;1.000;3600000;0
35090;207398;192;0;0;0;0;.00nan;0;0
35111;200306;182;42;22;4;18;.818;3569000;0
35111;-1;220;0;0;0;0;.00nan;0;0
35111;-1;220;77;41;3;38;.927;3600000;0
35111;185810;182;0;0;0;0;.00nan;0;0
35453;-1;219;0;0;0;0;.00nan;0;0
35453;-1;219;94;22;0;22;1.000;3600000;0
35453;191130;186;80;34;2;32;.941;3554000;0
35453;213507;186;0;0;0;0;.00nan;0;0
35258;195164;218;60;43;5;38;.884;3545000;0
35258;190034;217;0;0;0;0;.00nan;0;0
35258;190041;217;48;23;4;19;.826;3600000;0
35258;208051;218;0;0;0;0;.00nan;0;0
35374;200333;194;88;59;4;55;.932;3600000;0
35374;207061;195;65;15;1;14;.933;3600000;0
35374;196352;194;0;0;0;0;.00nan;0;0
35374;196465;195;0;0;0;0;.00nan;0;0
35648;192939;208;0;0;0;0;.00nan;0;0
35648;196283;206;0;0;0;0;.00nan;0;0
35648;-1;208;70;28;3;25;.893;3600000;0
35648;202998;206;60;41;4;37;.902;3574000;0
35253;206801;176;57;25;3;22;.880;3530000;0
35253;-1;209;0;0;0;0;.00nan;0;0
35253;203099;176;0;0;0;0;.00nan;0;0
35253;213590;209;96;36;1;35;.972;3600000;0
35412;201525;203;0;0;0;0;.00nan;0;0
35412;201560;202;0;0;0;0;.00nan;0;0
35412;212028;202;97;49;3;46;.939;3534000;0
35412;206772;203;64;20;1;19;.950;3600000;0
35204;188977;215;0;0;0;0;.00nan;0;0
35204;210794;215;82;35;2;33;.943;3726000;0
35204;184874;212;0;0;0;0;.00nan;0;0
35204;-1;212;80;34;3;31;.912;3726000;0
35228;182467;185;63;26;3;23;.885;3900000;0
35228;209840;184;0;0;0;0;.00nan;0;0
35228;205837;184;51;28;3;25;.893;3900000;0
35228;-1;185;0;0;0;0;.00nan;0;0
35518;190038;181;0;0;0;0;.00nan;0;0
35518;192552;181;83;34;2;32;.941;3677000;0
35518;-1;1371;82;29;1;28;.966;3677000;0
35518;-1;1371;0;0;0;0;.00nan;0;0
35249;194893;191;44;17;3;14;.824;3582000;0
35249;-1;192;0;0;0;0;.00nan;0;0
35249;201892;191;0;0;0;0;.00nan;0;0
35249;207398;192;100;57;2;55;.965;3600000;0
35584;186332;4864;0;0;0;0;.00nan;0;0
35584;202801;4864;61;21;3;18;.857;3600000;0
35584;-1;2620;42;30;5;25;.833;3600000;0
35584;213550;2620;0;0;0;0;.00nan;0;0
36158;198149;188;0;0;0;0;.00nan;0;0
36158;184409;188;49;29;4;25;.862;3594000;0
36158;184788;198;73;30;3;27;.900;3600000;0
36158;212143;198;0;0;0;0;.00nan;0;0
35464;192862;187;0;0;0;0;.00nan;0;0
35464;-1;189;0;0;0;0;.00nan;0;0
35464;-1;187;36;36;6;30;.833;3600000;0
35464;-1;189;76;27;2;25;.926;3600000;0
35316;210998;229;0;0;0;0;.00nan;0;0
35316;201514;227;0;0;0;0;.00nan;0;0
35316;185960;229;62;35;4;31;.886;3525000;0
35316;213280;227;71;25;2;23;.920;3600000;0
35206;192915;179;0;0;0;0;.00nan;0;0
35206;201495;213;0;0;0;0;.00nan;0;0
35206;187355;179;100;40;0;40;1.000;3900000;0
35206;-1;213;95;34;0;34;1.000;3900000;0
35152;187689;230;0;0;0;0;.00nan;0;0
35152;183678;230;97;43;2;41;.953;3900000;0
35152;200444;224;83;35;2;33;.943;3900000;0
35152;208372;224;0;0;0;0;.00nan;0;0
35304;200452;221;27;6;3;3;.500;292000;0
35304;180377;228;78;35;2;33;.943;3600000;0
35304;208044;228;0;0;0;0;.00nan;0;0
35304;-1;221;55;19;3;16;.842;3308000;0
35187;210504;193;51;35;5;30;.857;3600000;0
35187;189529;193;0;0;0;0;.00nan;0;0
35187;192547;190;85;34;1;33;.971;3600000;0
35187;-1;190;0;0;0;0;.00nan;0;0
35510;201524;205;0;0;0;0;.00nan;0;0
35510;-1;199;0;0;0;0;.00nan;0;0
35510;-1;199;65;34;3;31;.912;3600000;0
35510;-1;205;71;25;2;23;.920;3600000;0
35244;205681;226;0;0;0;0;.00nan;0;0
35244;205788;207;100;48;2;46;.958;3900000;0
35244;-1;226;64;23;2;21;.913;3900000;0
35244;197853;207;0;0;0;0;.00nan;0;0
36175;205681;226;80;28;1;27;.964;3600000;0
36175;189902;204;64;44;5;39;.886;3600000;0
36175;-1;226;0;0;0;0;.00nan;0;0
36175;203120;204;0;0;0;0;.00nan;0;0
35627;201495;213;0;0;0;0;.00nan;0;0
35627;213399;216;0;0;0;0;.00nan;0;0
35627;-1;213;76;22;1;21;.955;3900000;0
35627;-1;216;84;22;1;21;.955;3900000;0
35452;192862;187;70;23;1;22;.957;3600000;0
35452;192547;190;0;0;0;0;.00nan;0;0
35452;-1;190;74;24;2;22;.917;3573000;0
35452;-1;187;0;0;0;0;.00nan;0;0
35487;210134;1505;77;32;2;30;.938;3900000;0
35487;-1;1505;0;0;0;0;.00nan;0;0
35487;197672;210;95;40;2;38;.950;3900000;0
35487;-1;210;0;0;0;0;.00nan;0;0
35250;211942;183;90;15;0;15;1.000;3600000;0
35250;196237;183;0;0;0;0;.00nan;0;0
35250;-1;178;0;0;0;0;.00nan;0;0
35250;-1;178;69;41;4;37;.902;3600000;0
35094;182467;185;0;0;0;0;.00nan;0;0
35094;200306;182;0;0;0;0;.00nan;0;0
35094;185810;182;100;23;0;23;1.000;3600000;0
35094;-1;185;49;45;6;39;.867;3600000;0
35269;188977;215;90;35;2;33;.943;3600000;0
35269;210794;215;0;0;0;0;.00nan;0;0
35269;-1;180;71;30;3;27;.900;3594000;0
35269;208383;180;0;0;0;0;.00nan;0;0
35231;200333;194;0;0;0;0;.00nan;0;0
35231;201585;197;0;0;0;0;.00nan;0;0
35231;206822;197;73;30;2;28;.933;3598000;0
35231;196352;194;79;25;1;24;.960;3600000;0
36069;192929;222;66;31;3;28;.903;3600000;0
36069;183695;232;65;38;4;34;.895;3600000;0
36069;213560;222;0;0;0;0;.00nan;0;0
36069;-1;232;0;0;0;0;.00nan;0;0
35184;-1;220;0;0;0;0;.00nan;0;0
35184;-1;220;53;28;3;25;.893;3600000;0
35184;191518;214;50;46;6;40;.870;3600000;0
35184;202914;214;0;0;0;0;.00nan;0;0
35740;-1;219;0;0;0;0;.00nan;0;0
35740;-1;219;81;28;1;27;.964;3600000;0
35740;191063;211;65;22;2;20;.909;3556000;0
35740;-1;211;0;0;0;0;.00nan;0;0
35264;211942;183;0;0;0;0;.00nan;0;0
35264;196237;183;54;20;2;18;.900;3570000;0
35264;197672;210;0;0;0;0;.00nan;0;0
35264;-1;210;92;37;1;36;.973;3600000;0
35240;194219;4960;57;26;3;23;.885;3600000;0
35240;206800;225;0;0;0;0;.00nan;0;0
35240;206971;4960;0;0;0;0;.00nan;0;0
35240;-1;225;65;44;5;39;.886;3515000;0
35243;200437;201;84;45;3;42;.933;3568000;0
35243;205769;200;0;0;0;0;.00nan;0;0
35243;195238;200;58;19;2;17;.895;3600000;0
35243;208048;201;0;0;0;0;.00nan;0;0
35334;210998;229;0;0;0;0;.00nan;0;0
35334;180377;228;79;30;2;28;.933;3900000;0
35334;185960;229;62;16;2;14;.875;3900000;0
35334;208044;228;0;0;0;0;.00nan;0;0
35362;206801;176;87;18;0;18;1.000;3600000;0
35362;-1;2620;0;0;0;0;.00nan;0;0
35362;203099;176;0;0;0;0;.00nan;0;0
35362;213550;2620;79;25;1;24;.960;3590000;0
35723;196571;177;88;32;1;31;.969;3600000;0
35723;213399;216;86;48;2;46;.958;3558000;0
35723;-1;216;0;0;0;0;.00nan;0;0
35723;-1;177;0;0;0;0;.00nan;0;0
35229;195251;4949;72;19;1;18;.947;3600000;0
35229;-1;178;98;53;2;51;.962;3600000;0
35229;-1;4949;0;0;0;0;.00nan;0;0
35229;-1;178;0;0;0;0;.00nan;0;0
35286;192915;179;0;0;0;0;.00nan;0;0
35286;210134;1505;0;0;0;0;.00nan;0;0
35286;187355;179;73;40;4;36;.900;3600000;0
35286;-1;1505;71;17;1;16;.941;3600000;0
35303;201585;197;100;22;0;22;1.000;3600000;0
35303;206822;197;0;0;0;0;.00nan;0;0
35303;-1;192;54;17;2;15;.882;3559000;0
35303;207398;192;0;0;0;0;.00nan;0;0
35583;192939;208;76;27;2;25;.926;3900000;0
35583;201525;203;95;41;2;39;.951;3900000;0
35583;206772;203;0;0;0;0;.00nan;0;0
35583;-1;208;0;0;0;0;.00nan;0;0
35299;205788;207;0;0;0;0;.00nan;0;0
35299;196283;206;0;0;0;0;.00nan;0;0
35299;197853;207;85;31;1;30;.968;3600000;0
35299;202998;206;71;28;2;26;.929;3563000;0
35165;200306;182;0;0;0;0;.00nan;0;0
35165;190038;181;0;0;0;0;.00nan;0;0
35165;185810;182;57;23;3;20;.870;3570000;0
35165;192552;181;82;28;2;26;.929;3600000;0
35281;194893;191;72;18;1;17;.944;3600000;0
35281;201892;191;0;0;0;0;.00nan;0;0
35281;207061;195;0;0;0;0;.00nan;0;0
35281;196465;195;97;38;2;36;.947;3546000;0
35176;200444;224;44;29;5;24;.828;3600000;0
35176;201514;227;100;29;0;29;1.000;3600000;0
35176;213280;227;0;0;0;0;.00nan;0;0
35176;208372;224;0;0;0;0;.00nan;0;0
35305;190164;4959;0;0;0;0;.00nan;0;0
35305;-1;209;61;24;2;22;.917;3900000;0
35305;-1;4959;79;27;2;25;.926;3900000;0
35305;213590;209;0;0;0;0;.00nan;0;0
35799;198149;188;0;0;0;0;.00nan;0;0
35799;184409;188;78;37;2;35;.946;3514000;0
35799;-1;189;97;25;0;25;1.000;3600000;0
35799;-1;189;0;0;0;0;.00nan;0;0
35237;195164;218;48;30;4;26;.867;3600000;0
35237;190034;217;88;30;1;29;.967;3600000;0
35237;190041;217;0;0;0;0;.00nan;0;0
35237;208051;218;0;0;0;0;.00nan;0;0
35291;184788;198;0;0;0;0;.00nan;0;0
35291;212143;198;70;23;1;22;.957;3600000;0
35291;191118;196;0;0;0;0;.00nan;0;0
35291;202830;196;76;42;4;38;.905;3600000;0
35091;210504;193;63;31;3;28;.903;3600000;0
35091;189529;193;0;0;0;0;.00nan;0;0
35091;184788;198;0;0;0;0;.00nan;0;0
35091;212143;198;57;38;5;33;.868;3549000;0
35456;198149;188;73;22;2;20;.909;3600000;0
35456;200333;194;59;28;3;25;.893;3543000;0
35456;184409;188;0;0;0;0;.00nan;0;0
35456;196352;194;0;0;0;0;.00nan;0;0
35407;192929;222;0;0;0;0;.00nan;0;0
35407;187689;230;46;21;3;18;.857;3580000;0
35407;183678;230;0;0;0;0;.00nan;0;0
35407;213560;222;94;43;2;41;.953;3600000;0
35278;195164;218;0;0;0;0;.00nan;0;0
35278;191130;186;0;0;0;0;.00nan;0;0
35278;208051;218;88;30;1;29;.967;3600000;0
35278;213507;186;46;34;5;29;.853;3600000;0
35343;209915;231;0;0;0;0;.00nan;0;0
35343;210998;229;90;60;3;57;.950;3788000;0
35343;189773;231;55;16;2;14;.875;3788000;0
35343;185960;229;0;0;0;0;.00nan;0;0
35356;209840;184;0;0;0;0;.00nan;0;0
35356;205837;184;50;23;4;19;.826;3600000;0
35356;-1;220;47;39;6;33;.846;3007000;0
35356;-1;220;51;3;0;3;1.000;511000;0
35319;205681;226;0;0;0;0;.00nan;0;0
35319;205788;207;79;50;4;46;.920;3600000;0
35319;-1;226;70;21;1;20;.952;3600000;0
35319;197853;207;0;0;0;0;.00nan;0;0
35273;182467;185;79;35;3;32;.914;3600000;0
35273;-1;185;0;0;0;0;.00nan;0;0
35273;191518;214;0;0;0;0;.00nan;0;0
35273;202914;214;50;23;4;19;.826;3560000;0
36156;192862;187;77;32;2;30;.938;3600000;0
36156;-1;192;0;0;0;0;.00nan;0;0
36156;207398;192;61;35;4;31;.886;3600000;0
36156;-1;187;0;0;0;0;.00nan;0;0
35594;191118;196;97;47;2;45;.957;3900000;0
35594;-1;189;91;40;2;38;.950;3900000;0
35594;202830;196;0;0;0;0;.00nan;0;0
35594;-1;189;0;0;0;0;.00nan;0;0
35642;188977;215;0;0;0;0;.00nan;0;0
35642;210794;215;86;39;3;36;.923;3556000;0
35642;190034;217;0;0;0;0;.00nan;0;0
35642;190041;217;54;21;2;19;.905;3600000;0
35270;184874;212;0;0;0;0;.00nan;0;0
35270;-1;212;84;27;1;26;.963;3600000;0
35270;-1;180;83;47;4;43;.915;3600000;0
35270;208383;180;0;0;0;0;.00nan;0;0
35230;200437;201;0;0;0;0;.00nan;0;0
35230;201560;202;0;0;0;0;.00nan;0;0
35230;212028;202;56;23;3;20;.870;3581000;0
35230;208048;201;83;30;1;29;.967;3600000;0
35298;200452;221;96;44;1;43;.977;3900000;0
35298;206800;225;92;40;1;39;.975;3900000;0
35298;-1;225;0;0;0;0;.00nan;0;0
35298;-1;221;0;0;0;0;.00nan;0;0
35307;190164;4959;62;36;4;32;.889;3600000;0
35307;186332;4864;81;30;1;29;.967;3600000;0
35307;202801;4864;0;0;0;0;.00nan;0;0
35307;-1;4959;0;0;0;0;.00nan;0;0
35192;200444;224;0;0;0;0;.00nan;0;0
35192;191120;223;0;0;0;0;.00nan;0;0
35192;187118;223;89;34;1;33;.971;3900000;0
35192;208372;224;86;36;1;35;.972;3900000;0
35297;205769;200;60;31;4;27;.871;3900000;0
35297;195238;200;0;0;0;0;.00nan;0;0
35297;189902;204;66;36;4;32;.889;3900000;0
35297;203120;204;0;0;0;0;.00nan;0;0
35332;183695;232;0;0;0;0;.00nan;0;0
35332;180377;228;0;0;0;0;.00nan;0;0
35332;208044;228;61;33;4;29;.879;3780000;0
35332;-1;232;47;35;5;30;.857;3780000;0
35369;205681;226;0;0;0;0;.00nan;0;0
35369;-1;226;84;17;0;17;1.000;3600000;0
35369;-1;199;82;29;1;28;.966;3580000;0
35369;-1;199;0;0;0;0;.00nan;0;0
35344;189902;204;0;0;0;0;.00nan;0;0
35344;201524;205;0;0;0;0;.00nan;0;0
35344;-1;205;85;19;0;19;1.000;3600000;0
35344;203120;204;70;39;4;35;.897;3600000;0
35282;210134;1505;49;36;5;31;.861;3600000;0
35282;195251;4949;69;23;2;21;.913;3600000;0
35282;-1;1505;0;0;0;0;.00nan;0;0
35282;-1;4949;0;0;0;0;.00nan;0;0
36035;186332;4864;0;0;0;0;.00nan;0;0
36035;202801;4864;56;49;7;42;.857;3600000;0
36035;-1;2620;67;35;4;31;.886;3600000;0
36035;213550;2620;0;0;0;0;.00nan;0;0
35663;190038;181;54;34;5;29;.853;3542000;0
35663;192552;181;0;0;0;0;.00nan;0;0
35663;-1;1371;81;46;4;42;.913;3600000;0
35663;-1;1371;0;0;0;0;.00nan;0;0
35317;209915;231;80;16;0;16;1.000;3600000;0
35317;200452;221;43;21;4;17;.810;2148000;0
35317;189773;231;0;0;0;0;.00nan;0;0
35317;-1;221;88;22;0;22;1.000;1452000;0
36166;196571;177;57;23;3;20;.870;3600000;0
36166;197672;210;78;46;4;42;.913;3600000;0
36166;-1;210;0;0;0;0;.00nan;0;0
36166;-1;177;0;0;0;0;.00nan;0;0
36173;201560;202;66;32;3;29;.906;3841000;0
36173;212028;202;0;0;0;0;.00nan;0;0
36173;196283;206;0;0;0;0;.00nan;0;0
36173;202998;206;78;39;4;35;.897;3841000;0
35451;187689;230;0;0;0;0;.00nan;0;0
35451;183678;230;74;38;3;35;.921;3600000;0
35451;194219;4960;48;28;4;24;.857;3600000;0
35451;206971;4960;0;0;0;0;.00nan;0;0
35460;201585;197;0;0;0;0;.00nan;0;0
35460;206822;197;56;44;6;38;.864;3600000;0
35460;207061;195;91;17;0;17;1.000;3600000;0
35460;196465;195;0;0;0;0;.00nan;0;0
35387;190164;4959;0;0;0;0;.00nan;0;0
35387;206801;176;92;32;1;31;.969;3600000;0
35387;-1;4959;66;27;2;25;.926;3551000;0
35387;203099;176;0;0;0;0;.00nan;0;0
35380;200437;201;70;34;4;30;.882;3900000;0
35380;208048;201;0;0;0;0;.00nan;0;0
35380;-1;199;0;0;0;0;.00nan;0;0
35380;-1;199;72;41;4;37;.902;3900000;0
35306;188977;215;0;0;0;0;.00nan;0;0
35306;210794;215;69;30;3;27;.900;3600000;0
35306;191063;211;0;0;0;0;.00nan;0;0
35306;-1;211;54;36;5;31;.861;3535000;0
36036;192862;187;0;0;0;0;.00nan;0;0
36036;191118;196;96;38;1;37;.974;3600000;0
36036;-1;187;66;30;2;28;.933;3577000;0
36036;202830;196;0;0;0;0;.00nan;0;0
35289;206800;225;0;0;0;0;.00nan;0;0
35289;-1;225;94;39;2;37;.949;3600000;0
35289;191120;223;0;0;0;0;.00nan;0;0
35289;187118;223;32;35;7;28;.800;3600000;0
35793;201495;213;85;33;2;31;.939;3800000;0
35793;213399;216;0;0;0;0;.00nan;0;0
35793;-1;213;0;0;0;0;.00nan;0;0
35793;-1;216;79;25;1;24;.960;3800000;0
35457;198149;188;0;0;0;0;.00nan;0;0
35457;184409;188;84;49;3;46;.939;3600000;0
35457;192547;190;88;15;0;15;1.000;3600000;0
35457;-1;190;0;0;0;0;.00nan;0;0
36167;-1;192;76;29;2;27;.931;3600000;0
36167;207398;192;0;0;0;0;.00nan;0;0
36167;-1;189;0;0;0;0;.00nan;0;0
36167;-1;189;61;31;3;28;.903;3560000;0
35295;195164;218;100;36;0;36;1.000;3600000;0
35295;184874;212;0;0;0;0;.00nan;0;0
35295;-1;212;65;18;1;17;.944;3557000;0
35295;208051;218;0;0;0;0;.00nan;0;0
35296;192915;179;0;0;0;0;.00nan;0;0
35296;196571;177;35;31;5;26;.839;3600000;0
35296;187355;179;86;26;1;25;.962;3600000;0
35296;-1;177;0;0;0;0;.00nan;0;0
35419;188977;215;100;36;0;36;1.000;3600000;0
35419;210794;215;0;0;0;0;.00nan;0;0
35419;-1;180;56;27;3;24;.889;3600000;0
35419;208383;180;0;0;0;0;.00nan;0;0
35408;206801;176;37;12;3;9;.750;1255000;0
35408;186332;4864;100;27;0;27;1.000;3600000;0
35408;202801;4864;0;0;0;0;.00nan;0;0
35408;203099;176;33;29;6;23;.793;2345000;0
36091;210134;1505;68;17;1;16;.941;3600000;0
36091;213399;216;76;31;2;29;.935;3564000;0
36091;-1;1505;0;0;0;0;.00nan;0;0
36091;-1;216;0;0;0;0;.00nan;0;0
35367;182467;185;47;33;5;28;.848;3718000;0
35367;209840;184;37;20;4;16;.800;3718000;0
35367;205837;184;0;0;0;0;.00nan;0;0
35367;-1;185;0;0;0;0;.00nan;0;0
35300;210504;193;94;20;0;20;1.000;3600000;0
35300;189529;193;0;0;0;0;.00nan;0;0
35300;184788;198;0;0;0;0;.00nan;0;0
35300;212143;198;87;36;3;33;.917;3600000;0
35448;210998;229;0;0;0;0;.00nan;0;0
35448;201514;227;71;29;3;26;.897;3854000;0
35448;185960;229;68;32;4;28;.875;3854000;0
35448;213280;227;0;0;0;0;.00nan;0;0
35333;200306;182;0;0;0;0;.00nan;0;0
35333;185810;182;66;22;1;21;.955;3600000;0
35333;-1;1371;0;0;0;0;.00nan;0;0
35333;-1;1371;75;33;2;31;.939;3569000;0
35459;200333;194;0;0;0;0;.00nan;0;0
35459;207061;195;53;7;1;6;.857;3600000;0
35459;196352;194;88;45;3;42;.933;3551000;0
35459;196465;195;0;0;0;0;.00nan;0;0
35399;187689;230;0;0;0;0;.00nan;0;0
35399;183678;230;100;41;1;40;.976;3670000;0
35399;209915;231;92;42;2;40;.952;3670000;0
35399;189773;231;0;0;0;0;.00nan;0;0
35386;-1;220;0;0;0;0;.00nan;0;0
35386;-1;220;93;31;1;30;.968;3600000;0
35386;191518;214;24;26;6;20;.769;2735000;0
35386;202914;214;40;8;2;6;.750;865000;0
35525;198149;188;0;0;0;0;.00nan;0;0
35525;184409;188;40;36;6;30;.833;3600000;0
35525;192547;190;90;28;1;27;.964;3600000;0
35525;-1;190;0;0;0;0;.00nan;0;0
35346;195251;4949;94;37;1;36;.973;3900000;0
35346;-1;178;0;0;0;0;.00nan;0;0
35346;-1;4949;0;0;0;0;.00nan;0;0
35346;-1;178;82;30;1;29;.967;3900000;0
35542;189902;204;33;28;6;22;.786;2918000;0
35542;201525;203;67;36;4;32;.889;3600000;0
35542;206772;203;0;0;0;0;.00nan;0;0
35542;203120;204;57;5;0;5;1.000;611000;0
35604;191063;211;0;0;0;0;.00nan;0;0
35604;-1;180;53;17;3;14;.824;3514000;0
35604;-1;211;99;32;1;31;.969;3600000;0
35604;208383;180;0;0;0;0;.00nan;0;0
35326;209840;184;0;0;0;0;.00nan;0;0
35326;205837;184;73;33;2;31;.939;3591000;0
35326;191518;214;0;0;0;0;.00nan;0;0
35326;202914;214;99;27;0;27;1.000;3600000;0
35267;200306;182;69;24;2;22;.917;3600000;0
35267;-1;220;22;13;5;8;.615;1122000;0
35267;-1;220;69;30;3;27;.900;2478000;0
35267;185810;182;0;0;0;0;.00nan;0;0
35324;182467;185;0;0;0;0;.00nan;0;0
35324;-1;185;67;28;3;25;.893;3600000;0
35324;-1;1371;100;24;0;24;1.000;3600000;0
35324;-1;1371;0;0;0;0;.00nan;0;0
35200;200444;224;88;38;2;36;.947;3600000;0
35200;206800;225;0;0;0;0;.00nan;0;0
35200;-1;225;78;42;4;38;.905;3570000;0
35200;208372;224;0;0;0;0;.00nan;0;0
35632;201560;202;60;23;3;20;.870;3600000;0
35632;212028;202;0;0;0;0;.00nan;0;0
35632;-1;199;0;0;0;0;.00nan;0;0
35632;-1;199;62;44;5;39;.886;3570000;0
36097;209915;231;0;0;0;0;.00nan;0;0
36097;189773;231;66;23;3;20;.870;3568000;0
36097;180377;228;99;46;2;44;.957;3600000;0
36097;208044;228;0;0;0;0;.00nan;0;0
35308;194893;191;36;17;3;14;.824;3600000;0
35308;-1;192;46;5;1;4;.800;501000;0
35308;201892;191;0;0;0;0;.00nan;0;0
35308;207398;192;61;52;6;46;.885;3099000;0
35600;190164;4959;0;0;0;0;.00nan;0;0
35600;186332;4864;77;26;2;24;.923;3886000;0
35600;202801;4864;0;0;0;0;.00nan;0;0
35600;-1;4959;77;36;3;33;.917;3886000;0
35239;210504;193;46;29;5;24;.828;3600000;0
35239;189529;193;0;0;0;0;.00nan;0;0
35239;-1;189;54;41;6;35;.854;3245000;0
35239;-1;189;65;7;0;7;1.000;355000;0
35318;192915;179;94;26;0;26;1.000;3600000;0
35318;187355;179;0;0;0;0;.00nan;0;0
35318;-1;178;80;26;2;24;.923;3513000;0
35318;-1;178;0;0;0;0;.00nan;0;0
35347;190034;217;64;40;4;36;.900;3600000;0
35347;190041;217;0;0;0;0;.00nan;0;0
35347;-1;219;90;40;1;39;.975;3600000;0
35347;-1;219;0;0;0;0;.00nan;0;0
35428;183695;232;30;30;6;24;.800;3090000;0
35428;191120;223;0;0;0;0;.00nan;0;0
35428;187118;223;70;38;3;35;.921;3600000;0
35428;-1;232;40;3;1;2;.667;510000;0
35439;192862;187;50;25;4;21;.840;3771000;0
35439;201585;197;76;36;3;33;.917;3771000;0
35439;206822;197;0;0;0;0;.00nan;0;0
35439;-1;187;0;0;0;0;.00nan;0;0
35352;205769;200;0;0;0;0;.00nan;0;0
35352;205788;207;0;0;0;0;.00nan;0;0
35352;195238;200;87;28;1;27;.964;3600000;0
35352;197853;207;44;37;6;31;.838;3600000;0
35384;200437;201;0;0;0;0;.00nan;0;0
35384;201524;205;0;0;0;0;.00nan;0;0
35384;208048;201;51;30;4;26;.867;3547000;0
35384;-1;205;60;24;3;21;.875;3600000;0
35370;-1;209;78;23;1;22;.957;3600000;0
35370;-1;2620;0;0;0;0;.00nan;0;0
35370;213550;2620;76;30;2;28;.933;3544000;0
35370;213590;209;0;0;0;0;.00nan;0;0
35342;210134;1505;48;0;0;0;.00nan;242000;0
35342;195251;4949;0;0;0;0;.00nan;0;0
35342;-1;1505;32;26;6;20;.769;3358000;0
35342;-1;4949;76;39;2;37;.949;3600000;0
35350;200452;221;68;28;2;26;.929;3600000;0
35350;201514;227;0;0;0;0;.00nan;0;0
35350;213280;227;47;18;3;15;.833;3593000;0
35350;-1;221;0;0;0;0;.00nan;0;0
35349;184788;198;76;27;1;26;.963;3600000;0
35349;212143;198;0;0;0;0;.00nan;0;0
35349;191118;196;94;41;2;39;.951;3570000;0
35349;202830;196;0;0;0;0;.00nan;0;0
35335;201495;213;0;0;0;0;.00nan;0;0
35335;211942;183;58;30;3;27;.900;3627000;0
35335;196237;183;0;0;0;0;.00nan;0;0
35335;-1;213;98;44;2;42;.955;3627000;0
35361;188977;215;100;34;0;34;1.000;3600000;0
35361;210794;215;0;0;0;0;.00nan;0;0
35361;-1;219;0;0;0;0;.00nan;0;0
35361;-1;219;67;30;3;27;.900;3600000;0
35360;206801;176;73;25;1;24;.960;3600000;0
35360;-1;209;0;0;0;0;.00nan;0;0
35360;203099;176;0;0;0;0;.00nan;0;0
35360;213590;209;98;39;2;37;.949;3561000;0
35519;187689;230;63;12;1;11;.917;3600000;0
35519;183678;230;0;0;0;0;.00nan;0;0
35519;183695;232;0;0;0;0;.00nan;0;0
35519;-1;232;69;48;5;43;.896;3600000;0
35511;194219;4960;67;24;3;21;.875;3600000;0
35511;200452;221;46;33;5;28;.848;3600000;0
35511;206971;4960;0;0;0;0;.00nan;0;0
35511;-1;221;0;0;0;0;.00nan;0;0
35432;205769;200;79;25;1;24;.960;3600000;0
35432;195238;200;0;0;0;0;.00nan;0;0
35432;189902;204;0;0;0;0;.00nan;0;0
35432;203120;204;57;34;4;30;.882;3600000;0
35322;192929;222;0;0;0;0;.00nan;0;0
35322;191120;223;0;0;0;0;.00nan;0;0
35322;187118;223;87;42;3;39;.929;3900000;0
35322;213560;222;78;36;3;33;.917;3900000;0
35263;200437;201;41;34;5;29;.853;3578000;0
35263;201560;202;0;0;0;0;.00nan;0;0
35263;212028;202;40;16;4;12;.750;3600000;0
35263;208048;201;0;0;0;0;.00nan;0;0
35329;184874;212;82;36;2;34;.944;3600000;0
35329;191130;186;50;32;4;28;.875;3522000;0
35329;-1;212;0;0;0;0;.00nan;0;0
35329;213507;186;0;0;0;0;.00nan;0;0
35321;184788;198;0;0;0;0;.00nan;0;0
35321;-1;192;67;24;2;22;.917;3600000;0
35321;212143;198;59;39;5;34;.872;3600000;0
35321;207398;192;0;0;0;0;.00nan;0;0
35392;192939;208;64;17;1;16;.941;3600000;0
35392;205788;207;0;0;0;0;.00nan;0;0
35392;197853;207;71;36;3;33;.917;3565000;0
35392;-1;208;0;0;0;0;.00nan;0;0
35283;211942;183;81;21;1;20;.952;3600000;0
35283;196237;183;0;0;0;0;.00nan;0;0
35283;213399;216;0;0;0;0;.00nan;0;0
35283;-1;216;57;24;3;21;.875;3553000;0
35277;190034;217;86;18;0;18;1.000;3600000;0
35277;190041;217;0;0;0;0;.00nan;0;0
35277;184874;212;0;0;0;0;.00nan;0;0
35277;-1;212;84;40;2;38;.950;3600000;0
35444;194219;4960;46;19;3;16;.842;3680000;0
35444;206800;225;0;0;0;0;.00nan;0;0
35444;206971;4960;0;0;0;0;.00nan;0;0
35444;-1;225;68;37;4;33;.892;3680000;0
35849;200333;194;0;0;0;0;.00nan;0;0
35849;196352;194;66;32;3;29;.906;3600000;0
35849;-1;189;0;0;0;0;.00nan;0;0
35849;-1;189;65;16;2;14;.875;3600000;0
35366;195164;218;67;14;1;13;.929;3600000;0
35366;191130;186;0;0;0;0;.00nan;0;0
35366;208051;218;0;0;0;0;.00nan;0;0
35366;213507;186;69;49;5;44;.898;3600000;0
35381;210504;193;63;22;2;20;.909;3600000;0
35381;189529;193;0;0;0;0;.00nan;0;0
35381;191118;196;68;37;4;33;.892;3540000;0
35381;202830;196;0;0;0;0;.00nan;0;0
35338;200306;182;0;0;0;0;.00nan;0;0
35338;185810;182;45;19;2;17;.895;3900000;0
35338;191518;214;0;0;0;0;.00nan;0;0
35338;202914;214;76;39;2;37;.949;3900000;0
35403;192915;179;62;21;2;19;.905;3900000;0
35403;201495;213;73;28;2;26;.929;3900000;0
35403;187355;179;0;0;0;0;.00nan;0;0
35403;-1;213;0;0;0;0;.00nan;0;0
35414;-1;178;0;0;0;0;.00nan;0;0
35414;197672;210;100;34;1;33;.971;3900000;0
35414;-1;178;97;40;1;39;.975;3900000;0
35414;-1;210;0;0;0;0;.00nan;0;0
35312;192862;187;68;40;4;36;.900;3600000;0
35312;194893;191;90;18;0;18;1.000;3600000;0
35312;201892;191;0;0;0;0;.00nan;0;0
35312;-1;187;0;0;0;0;.00nan;0;0
35474;201585;197;55;3;0;3;1.000;387000;0
35474;206822;197;40;40;7;33;.825;3213000;0
35474;207061;195;63;16;1;15;.938;3600000;0
35474;196465;195;0;0;0;0;.00nan;0;0
35618;209840;184;78;29;1;28;.966;3549000;0
35618;205837;184;0;0;0;0;.00nan;0;0
35618;-1;1371;100;37;0;37;1.000;3600000;0
35618;-1;1371;0;0;0;0;.00nan;0;0
35430;190164;4959;0;0;0;0;.00nan;0;0
35430;206801;176;59;29;3;26;.897;2787000;0
35430;-1;4959;59;23;3;20;.870;3600000;0
35430;203099;176;31;16;4;12;.750;813000;0
35420;205681;226;0;0;0;0;.00nan;0;0
35420;201525;203;63;31;4;27;.871;3600000;0
35420;206772;203;0;0;0;0;.00nan;0;0
35420;-1;226;69;24;2;22;.917;3600000;0
35266;192929;222;72;48;5;43;.896;3600000;0
35266;200444;224;27;26;6;20;.769;3543000;0
35266;213560;222;0;0;0;0;.00nan;0;0
35266;208372;224;0;0;0;0;.00nan;0;0
35401;190038;181;98;26;0;26;1.000;2505000;0
35401;-1;220;0;0;0;0;.00nan;0;0
35401;-1;220;45;17;3;14;.824;3600000;0
35401;192552;181;35;15;4;11;.733;1074000;0
35410;209915;231;0;0;0;0;.00nan;0;0
35410;189773;231;58;17;2;15;.882;3600000;0
35410;201514;227;84;40;3;37;.925;3600000;0
35410;213280;227;0;0;0;0;.00nan;0;0
35336;194893;191;45;22;4;18;.818;3542000;0
35336;201892;191;0;0;0;0;.00nan;0;0
35336;-1;189;74;41;3;38;.927;3600000;0
35336;-1;189;0;0;0;0;.00nan;0;0
35989;187689;230;0;0;0;0;.00nan;0;0
35989;183678;230;36;25;5;20;.800;3600000;0
35989;180377;228;98;33;1;32;.970;3600000;0
35989;208044;228;0;0;0;0;.00nan;0;0
35373;-1;209;98;33;1;32;.970;3600000;0
35373;-1;2620;71;24;2;22;.917;3555000;0
35373;213550;2620;0;0;0;0;.00nan;0;0
35373;213590;209;0;0;0;0;.00nan;0;0
35279;190034;217;88;29;1;28;.966;3600000;0
35279;190041;217;0;0;0;0;.00nan;0;0
35279;-1;180;45;38;6;32;.842;3600000;0
35279;208383;180;0;0;0;0;.00nan;0;0
35418;188977;215;71;31;2;29;.935;3600000;0
35418;210794;215;0;0;0;0;.00nan;0;0
35418;-1;219;42;26;4;22;.846;3514000;0
35418;-1;219;0;0;0;0;.00nan;0;0
35327;198149;188;0;0;0;0;.00nan;0;0
35327;184409;188;71;37;3;34;.919;3600000;0
35327;-1;192;0;0;0;0;.00nan;0;0
35327;207398;192;53;31;4;27;.871;3592000;0
35391;192939;208;0;0;0;0;.00nan;0;0
35391;200437;201;0;0;0;0;.00nan;0;0
35391;208048;201;88;53;4;49;.925;3673000;0
35391;-1;208;57;27;3;24;.889;3673000;0
35406;182467;185;30;15;4;11;.733;3600000;0
35406;190038;181;0;0;0;0;.00nan;0;0
35406;-1;185;0;0;0;0;.00nan;0;0
35406;192552;181;100;41;0;41;1.000;3600000;0
35405;205681;226;82;25;1;24;.960;3600000;0
35405;205788;207;65;32;3;29;.906;3565000;0
35405;-1;226;0;0;0;0;.00nan;0;0
35405;197853;207;0;0;0;0;.00nan;0;0
35469;210998;229;0;0;0;0;.00nan;0;0
35469;185960;229;45;32;5;27;.844;3600000;0
35469;191120;223;0;0;0;0;.00nan;0;0
35469;187118;223;100;37;0;37;1.000;3600000;0
35498;196571;177;85;47;4;43;.915;3566000;0
35498;197672;210;0;0;0;0;.00nan;0;0
35498;-1;210;70;36;3;33;.917;3600000;0
35498;-1;177;0;0;0;0;.00nan;0;0
35701;201560;202;87;38;1;37;.974;3900000;0
35701;212028;202;0;0;0;0;.00nan;0;0
35701;-1;199;88;39;1;38;.974;3900000;0
35701;-1;199;0;0;0;0;.00nan;0;0
35760;183695;232;67;32;3;29;.906;3900000;0
35760;180377;228;0;0;0;0;.00nan;0;0
35760;208044;228;76;38;3;35;.921;3900000;0
35760;-1;232;0;0;0;0;.00nan;0;0
35388;195164;218;70;37;3;34;.919;3572000;0
35388;191130;186;0;0;0;0;.00nan;0;0
35388;208051;218;0;0;0;0;.00nan;0;0
35388;213507;186;83;27;1;26;.963;3600000;0
35450;200452;221;100;23;0;23;1.000;3900000;0
35450;210998;229;96;42;0;42;1.000;3900000;0
35450;185960;229;0;0;0;0;.00nan;0;0
35450;-1;221;0;0;0;0;.00nan;0;0
35496;189902;204;76;31;2;29;.935;3557000;0
35496;201524;205;0;0;0;0;.00nan;0;0
35496;-1;205;68;18;1;17;.944;3600000;0
35496;203120;204;0;0;0;0;.00nan;0;0
35596;200333;194;91;46;2;44;.957;3900000;0
35596;196352;194;0;0;0;0;.00nan;0;0
35596;191118;196;64;22;2;20;.909;3900000;0
35596;202830;196;0;0;0;0;.00nan;0;0
35435;192929;222;0;0;0;0;.00nan;0;0
35435;206800;225;0;0;0;0;.00nan;0;0
35435;-1;225;63;30;3;27;.900;3900000;0
35435;213560;222;82;40;3;37;.925;3900000;0
35413;195251;4949;72;34;3;31;.912;3900000;0
35413;201495;213;0;0;0;0;.00nan;0;0
35413;-1;213;71;40;3;37;.925;3900000;0
35413;-1;4949;0;0;0;0;.00nan;0;0
35462;192862;187;0;0;0;0;.00nan;0;0
35462;201585;197;0;0;0;0;.00nan;0;0
35462;206822;197;74;27;2;25;.926;3532000;0
35462;-1;187;92;25;0;25;1.000;3600000;0
35521;198149;188;45;40;6;34;.850;2261000;0
35521;184409;188;60;22;2;20;.909;1339000;0
35521;207061;195;61;10;1;9;.900;3600000;0
35521;196465;195;0;0;0;0;.00nan;0;0
35358;210134;1505;46;35;5;30;.857;3628000;0
35358;211942;183;28;27;6;21;.778;3628000;0
35358;196237;183;0;0;0;0;.00nan;0;0
35358;-1;1505;0;0;0;0;.00nan;0;0
36136;186332;4864;70;26;1;25;.962;3600000;0
36136;-1;209;20;20;6;14;.700;2956000;0
36136;202801;4864;0;0;0;0;.00nan;0;0
36136;213590;209;52;3;0;3;1.000;644000;0
36070;196571;177;0;0;0;0;.00nan;0;0
36070;213399;216;0;0;0;0;.00nan;0;0
36070;-1;216;68;28;2;26;.929;3900000;0
36070;-1;177;69;29;2;27;.931;3900000;0
35549;201525;203;68;20;1;19;.950;3600000;0
35549;206772;203;0;0;0;0;.00nan;0;0
35549;-1;199;0;0;0;0;.00nan;0;0
35549;-1;199;64;39;4;35;.897;3600000;0
35274;209915;231;0;0;0;0;.00nan;0;0
35274;200444;224;0;0;0;0;.00nan;0;0
35274;189773;231;92;37;2;35;.946;3547000;0
35274;208372;224;100;28;0;28;1.000;3600000;0
35904;194219;4960;0;0;0;0;.00nan;0;0
35904;206971;4960;28;16;5;11;.688;3735000;0
35904;191120;223;0;0;0;0;.00nan;0;0
35904;187118;223;75;55;6;49;.891;3735000;0
35545;190164;4959;0;0;0;0;.00nan;0;0
35545;-1;4959;88;23;1;22;.957;3600000;0
35545;-1;2620;0;0;0;0;.00nan;0;0
35545;213550;2620;62;25;3;22;.880;3600000;0
36169;182467;185;80;49;4;45;.918;3600000;0
36169;190038;181;0;0;0;0;.00nan;0;0
36169;-1;185;0;0;0;0;.00nan;0;0
36169;192552;181;71;22;1;21;.955;3600000;0
35416;192939;208;0;0;0;0;.00nan;0;0
35416;205769;200;0;0;0;0;.00nan;0;0
35416;195238;200;95;38;0;38;1.000;3900000;0
35416;-1;208;88;20;0;20;1.000;3900000;0
35447;205681;226;0;0;0;0;.00nan;0;0
35447;201524;205;0;0;0;0;.00nan;0;0
35447;-1;226;79;25;1;24;.960;3600000;0
35447;-1;205;70;35;4;31;.886;3600000;0
35567;210134;1505;0;0;0;0;.00nan;0;0
35567;-1;1505;61;25;3;22;.880;3852000;0
35567;197672;210;63;32;4;28;.875;3852000;0
35567;-1;210;0;0;0;0;.00nan;0;0
35383;211942;183;0;0;0;0;.00nan;0;0
35383;196237;183;53;28;3;25;.893;3600000;0
35383;197672;210;0;0;0;0;.00nan;0;0
35383;-1;210;49;12;2;10;.833;3600000;0
35434;210504;193;78;35;3;32;.914;3900000;0
35434;189529;193;0;0;0;0;.00nan;0;0
35434;207061;195;58;29;3;26;.897;3900000;0
35434;196465;195;0;0;0;0;.00nan;0;0
36186;186332;4864;0;0;0;0;.00nan;0;0
36186;202801;4864;54;36;4;32;.889;3574000;0
36186;-1;2620;79;39;3;36;.923;3600000;0
36186;213550;2620;0;0;0;0;.00nan;0;0
35365;194893;191;88;19;0;19;1.000;3600000;0
35365;-1;192;79;52;5;47;.904;3600000;0
35365;201892;191;0;0;0;0;.00nan;0;0
35365;207398;192;0;0;0;0;.00nan;0;0
35483;192929;222;82;54;4;50;.926;3600000;0
35483;187689;230;58;20;2;18;.900;3600000;0
35483;183678;230;0;0;0;0;.00nan;0;0
35483;213560;222;0;0;0;0;.00nan;0;0
35484;200444;224;0;0;0;0;.00nan;0;0
35484;180377;228;84;31;2;29;.935;3900000;0
35484;208044;228;0;0;0;0;.00nan;0;0
35484;208372;224;50;21;2;19;.905;3900000;0
35353;188977;215;0;0;0;0;.00nan;0;0
35353;210794;215;56;39;5;34;.872;3600000;0
35353;190034;217;65;21;2;19;.905;3600000;0
35353;190041;217;0;0;0;0;.00nan;0;0
35478;200437;201;48;33;5;28;.848;3239000;0
35478;205769;200;0;0;0;0;.00nan;0;0
35478;195238;200;71;28;2;26;.929;3600000;0
35478;208048;201;55;3;0;3;1.000;361000;0
35427;190038;181;70;28;2;26;.929;3600000;0
35427;191518;214;68;44;6;38;.864;3600000;0
35427;192552;181;0;0;0;0;.00nan;0;0
35427;202914;214;0;0;0;0;.00nan;0;0
35351;198149;188;0;0;0;0;.00nan;0;0
35351;184409;188;61;35;3;32;.914;3558000;0
35351;184788;198;80;26;2;24;.923;3600000;0
35351;212143;198;0;0;0;0;.00nan;0;0
35378;206801;176;34;10;3;7;.700;583000;0
35378;-1;209;49;38;6;32;.842;2107000;0
35378;203099;176;46;18;3;15;.833;3017000;0
35378;213590;209;56;19;2;17;.895;1456000;0
35666;209840;184;0;0;0;0;.00nan;0;0
35666;200306;182;0;0;0;0;.00nan;0;0
35666;205837;184;72;29;3;26;.897;3526000;0
35666;185810;182;71;17;1;16;.941;3600000;0
35394;195164;218;93;28;1;27;.964;3600000;0
35394;191063;211;95;39;2;37;.949;3544000;0
35394;208051;218;0;0;0;0;.00nan;0;0
35394;-1;211;0;0;0;0;.00nan;0;0
35562;205788;207;0;0;0;0;.00nan;0;0
35562;196283;206;0;0;0;0;.00nan;0;0
35562;197853;207;78;33;2;31;.939;3600000;0
35562;202998;206;48;25;3;22;.880;3600000;0
35471;183695;232;88;59;5;54;.915;3600000;0
35471;209915;231;0;0;0;0;.00nan;0;0
35471;189773;231;100;33;0;33;1.000;3600000;0
35471;-1;232;0;0;0;0;.00nan;0;0
35560;192862;187;0;0;0;0;.00nan;0;0
35560;200333;194;57;48;6;42;.875;3131000;0
35560;196352;194;47;6;1;5;.833;469000;0
35560;-1;187;55;20;3;17;.850;3600000;0
35537;205681;226;76;31;2;29;.935;3721000;0
35537;201525;203;78;27;1;26;.963;3721000;0
35537;206772;203;0;0;0;0;.00nan;0;0
35537;-1;226;0;0;0;0;.00nan;0;0
35463;195251;4949;30;15;4;11;.733;3546000;0
35463;213399;216;77;36;3;33;.917;3600000;0
35463;-1;4949;0;0;0;0;.00nan;0;0
35463;-1;216;0;0;0;0;.00nan;0;0
35421;210504;193;0;0;0;0;.00nan;0;0
35421;189529;193;75;39;3;36;.923;3900000;0
35421;191118;196;82;37;3;34;.919;3900000;0
35421;202830;196;0;0;0;0;.00nan;0;0
35480;182467;185;42;33;5;28;.848;3600000;0
35480;-1;185;0;0;0;0;.00nan;0;0
35480;-1;1371;81;26;1;25;.962;3600000;0
35480;-1;1371;0;0;0;0;.00nan;0;0
35422;195251;4949;0;0;0;0;.00nan;0;0
35422;-1;178;0;0;0;0;.00nan;0;0
35422;-1;4949;45;37;6;31;.838;3578000;0
35422;-1;178;63;38;4;34;.895;3600000;0
35612;190034;217;0;0;0;0;.00nan;0;0
35612;190041;217;82;55;5;50;.909;3572000;0
35612;-1;180;54;23;4;19;.826;3600000;0
35612;208383;180;0;0;0;0;.00nan;0;0
35385;192915;179;65;38;4;34;.895;3600000;0
35385;211942;183;63;24;2;22;.917;3600000;0
35385;196237;183;0;0;0;0;.00nan;0;0
35385;187355;179;0;0;0;0;.00nan;0;0
35485;194219;4960;62;19;2;17;.895;3600000;0
35485;206971;4960;0;0;0;0;.00nan;0;0
35485;191120;223;0;0;0;0;.00nan;0;0
35485;187118;223;97;24;0;24;1.000;3600000;0
35512;210998;229;0;0;0;0;.00nan;0;0
35512;180377;228;0;0;0;0;.00nan;0;0
35512;185960;229;51;19;3;16;.842;3600000;0
35512;208044;228;61;35;4;31;.886;3591000;0
35543;210134;1505;69;21;1;20;.952;3600000;0
35543;201495;213;58;28;4;24;.857;3600000;0
35543;-1;1505;0;0;0;0;.00nan;0;0
35543;-1;213;0;0;0;0;.00nan;0;0
35605;187689;230;0;0;0;0;.00nan;0;0
35605;183678;230;54;22;3;19;.864;3545000;0
35605;200452;221;83;35;2;33;.943;3600000;0
35605;-1;221;0;0;0;0;.00nan;0;0
35382;200444;224;88;34;2;32;.941;3600000;0
35382;201514;227;0;0;0;0;.00nan;0;0
35382;213280;227;42;29;4;25;.862;3570000;0
35382;208372;224;0;0;0;0;.00nan;0;0
35395;198149;188;88;46;3;43;.935;3568000;0
35395;194893;191;63;23;2;21;.913;3600000;0
35395;184409;188;0;0;0;0;.00nan;0;0
35395;201892;191;0;0;0;0;.00nan;0;0
35363;184874;212;0;0;0;0;.00nan;0;0
35363;191130;186;0;0;0;0;.00nan;0;0
35363;-1;212;67;18;1;17;.944;3600000;0
35363;213507;186;74;32;2;30;.938;3556000;0
35883;201585;197;75;37;4;33;.892;3600000;0
35883;206822;197;0;0;0;0;.00nan;0;0
35883;-1;189;35;30;5;25;.833;3526000;0
35883;-1;189;0;0;0;0;.00nan;0;0
35438;206801;176;93;34;1;33;.971;3900000;0
35438;186332;4864;72;23;1;22;.957;3900000;0
35438;202801;4864;0;0;0;0;.00nan;0;0
35438;203099;176;0;0;0;0;.00nan;0;0
35590;190164;4959;0;0;0;0;.00nan;0;0
35590;-1;4959;87;26;1;25;.962;3776000;0
35590;-1;2620;0;0;0;0;.00nan;0;0
35590;213550;2620;98;25;0;25;1.000;3776000;0
35354;184788;198;0;0;0;0;.00nan;0;0
35354;-1;192;0;0;0;0;.00nan;0;0
35354;212143;198;48;27;3;24;.889;3553000;0
35354;207398;192;82;34;2;32;.941;3600000;0
35466;200437;201;0;0;0;0;.00nan;0;0
35466;201560;202;83;15;0;15;1.000;3600000;0
35466;212028;202;0;0;0;0;.00nan;0;0
35466;208048;201;51;49;6;43;.878;3600000;0
35499;192939;208;0;0;0;0;.00nan;0;0
35499;189902;204;83;38;3;35;.921;3558000;0
35499;-1;208;73;20;1;19;.950;3600000;0
35499;203120;204;0;0;0;0;.00nan;0;0
35393;188977;215;0;0;0;0;.00nan;0;0
35393;210794;215;73;22;1;21;.955;3600000;0
35393;191130;186;31;31;6;25;.806;3600000;0
35393;213507;186;0;0;0;0;.00nan;0;0
35431;195164;218;84;38;3;35;.921;3600000;0
35431;-1;180;0;0;0;0;.00nan;0;0
35431;208051;218;0;0;0;0;.00nan;0;0
35431;208383;180;40;28;4;24;.857;3600000;0
35442;192915;179;0;0;0;0;.00nan;0;0
35442;187355;179;95;39;2;37;.949;3600000;0
35442;-1;178;32;18;4;14;.778;3571000;0
35442;-1;178;0;0;0;0;.00nan;0;0
35726;210134;1505;0;0;0;0;.00nan;0;0
35726;213399;216;0;0;0;0;.00nan;0;0
35726;-1;1505;76;22;1;21;.955;3600000;0
35726;-1;216;57;36;4;32;.889;3600000;0
35603;183695;232;76;38;3;35;.921;3600000;0
35603;210998;229;46;29;4;25;.862;3600000;0
35603;185960;229;0;0;0;0;.00nan;0;0
35603;-1;232;0;0;0;0;.00nan;0;0
35520;200306;182;0;0;0;0;.00nan;0;0
35520;185810;182;86;22;1;21;.955;3600000;0
35520;-1;1371;0;0;0;0;.00nan;0;0
35520;-1;1371;89;42;2;40;.952;3600000;0
35647;189902;204;0;0;0;0;.00nan;0;0
35647;201524;205;0;0;0;0;.00nan;0;0
35647;-1;205;49;31;5;26;.839;3600000;0
35647;203120;204;47;45;6;39;.867;3574000;0
36182;182467;185;0;0;0;0;.00nan;0;0
36182;-1;185;69;34;3;31;.912;3600000;0
36182;191518;214;46;33;5;28;.848;3526000;0
36182;202914;214;0;0;0;0;.00nan;0;0
35417;190038;181;0;0;0;0;.00nan;0;0
35417;-1;220;0;0;0;0;.00nan;0;0
35417;-1;220;84;39;2;37;.949;3900000;0
35417;192552;181;89;35;2;33;.943;3900000;0
35574;194219;4960;43;25;4;21;.840;3600000;0
35574;206800;225;0;0;0;0;.00nan;0;0
35574;206971;4960;0;0;0;0;.00nan;0;0
35574;-1;225;61;48;5;43;.896;3585000;0
35449;211942;183;0;0;0;0;.00nan;0;0
35449;196237;183;47;33;4;29;.879;3900000;0
35449;213399;216;52;33;4;29;.879;3900000;0
35449;-1;216;0;0;0;0;.00nan;0;0
35437;200437;201;62;30;3;27;.900;3622000;0
35437;201524;205;80;31;2;29;.935;3622000;0
35437;208048;201;0;0;0;0;.00nan;0;0
35437;-1;205;0;0;0;0;.00nan;0;0
35468;195251;4949;0;0;0;0;.00nan;0;0
35468;201495;213;0;0;0;0;.00nan;0;0
35468;-1;213;43;28;4;24;.857;3900000;0
35468;-1;4949;65;36;4;32;.889;3900000;0
35443;206801;176;65;35;4;31;.886;3600000;0
35443;-1;2620;0;0;0;0;.00nan;0;0
35443;203099;176;0;0;0;0;.00nan;0;0
35443;213550;2620;100;31;0;31;1.000;3600000;0
35461;190164;4959;0;0;0;0;.00nan;0;0
35461;-1;209;60;47;6;41;.872;3600000;0
35461;-1;4959;58;26;3;23;.885;3600000;0
35461;213590;209;0;0;0;0;.00nan;0;0
35710;201525;203;100;30;0;30;1.000;3600000;0
35710;206772;203;0;0;0;0;.00nan;0;0
35710;-1;199;0;0;0;0;.00nan;0;0
35710;-1;199;77;38;3;35;.921;3600000;0
35472;209915;231;0;0;0;0;.00nan;0;0
35472;189773;231;64;22;2;20;.909;3600000;0
35472;201514;227;66;32;3;29;.906;3549000;0
35472;213280;227;0;0;0;0;.00nan;0;0
35505;200306;182;72;22;2;20;.909;3600000;0
35505;190038;181;64;36;4;32;.889;3559000;0
35505;185810;182;0;0;0;0;.00nan;0;0
35505;192552;181;0;0;0;0;.00nan;0;0
35488;192939;208;0;0;0;0;.00nan;0;0
35488;201560;202;71;41;4;37;.902;3579000;0
35488;212028;202;0;0;0;0;.00nan;0;0
35488;-1;208;93;35;2;33;.943;3600000;0
35502;192862;187;44;5;1;4;.800;1075000;0
35502;200333;194;0;0;0;0;.00nan;0;0
35502;196352;194;68;24;2;22;.917;3600000;0
35502;-1;187;10;26;7;19;.731;2525000;0
35551;192929;222;0;0;0;0;.00nan;0;0
35551;200452;221;0;0;0;0;.00nan;0;0
35551;213560;222;81;38;3;35;.921;3600000;0
35551;-1;221;69;48;5;43;.896;3569000;0
35372;184874;212;0;0;0;0;.00nan;0;0
35372;-1;219;43;36;6;30;.833;3239000;0
35372;-1;219;50;1;0;1;1.000;361000;0
35372;-1;212;100;40;0;40;1.000;3600000;0
35368;194893;191;93;19;0;19;1.000;3600000;0
35368;201892;191;0;0;0;0;.00nan;0;0
35368;192547;190;52;38;6;32;.842;3072000;0
35368;-1;190;47;6;1;5;.833;528000;0
35411;188977;215;47;37;6;31;.838;3585000;0
35411;210794;215;0;0;0;0;.00nan;0;0
35411;190034;217;50;27;4;23;.852;3600000;0
35411;190041;217;0;0;0;0;.00nan;0;0
35559;207061;195;0;0;0;0;.00nan;0;0
35559;196465;195;74;30;3;27;.900;3600000;0
35559;-1;189;0;0;0;0;.00nan;0;0
35559;-1;189;64;48;5;43;.896;3600000;0
35541;194219;4960;44;26;4;22;.846;3571000;0
35541;209915;231;0;0;0;0;.00nan;0;0
35541;189773;231;88;29;2;27;.931;3600000;0
35541;206971;4960;0;0;0;0;.00nan;0;0
35455;195164;218;50;28;3;25;.893;3564000;0
35455;-1;219;0;0;0;0;.00nan;0;0
35455;-1;219;99;42;2;40;.952;3600000;0
35455;208051;218;0;0;0;0;.00nan;0;0
35656;205788;207;0;0;0;0;.00nan;0;0
35656;201560;202;0;0;0;0;.00nan;0;0
35656;212028;202;67;33;3;30;.909;3578000;0
35656;197853;207;99;42;2;40;.952;3600000;0
35400;209840;184;90;35;1;34;.971;3591000;0
35400;205837;184;0;0;0;0;.00nan;0;0
35400;191518;214;100;36;0;36;1.000;3600000;0
35400;202914;214;0;0;0;0;.00nan;0;0
35491;186332;4864;72;24;1;23;.958;3900000;0
35491;-1;209;0;0;0;0;.00nan;0;0
35491;202801;4864;0;0;0;0;.00nan;0;0
35491;213590;209;78;32;1;31;.969;3900000;0
35482;210134;1505;93;23;0;23;1.000;3600000;0
35482;-1;178;0;0;0;0;.00nan;0;0
35482;-1;1505;0;0;0;0;.00nan;0;0
35482;-1;178;82;32;2;30;.938;3539000;0
35649;187689;230;75;24;1;23;.958;3600000;0
35649;183678;230;0;0;0;0;.00nan;0;0
35649;210998;229;0;0;0;0;.00nan;0;0
35649;185960;229;85;44;3;41;.932;3565000;0
35672;191063;211;0;0;0;0;.00nan;0;0
35672;-1;180;64;18;1;17;.944;3600000;0
35672;-1;211;98;53;3;50;.943;3600000;0
35672;208383;180;0;0;0;0;.00nan;0;0
35436;198149;188;0;0;0;0;.00nan;0;0
35436;184409;188;51;35;5;30;.857;3600000;0
35436;-1;192;62;27;2;25;.926;3600000;0
35436;207398;192;0;0;0;0;.00nan;0;0
35423;192915;179;78;25;1;24;.960;3578000;0
35423;187355;179;0;0;0;0;.00nan;0;0
35423;197672;210;100;29;0;29;1.000;3600000;0
35423;-1;210;0;0;0;0;.00nan;0;0
35575;183695;232;77;26;2;24;.923;3600000;0
35575;191120;223;0;0;0;0;.00nan;0;0
35575;187118;223;74;34;3;31;.912;3549000;0
35575;-1;232;0;0;0;0;.00nan;0;0
35719;189902;204;50;34;5;29;.853;3600000;0
35719;-1;199;70;23;2;21;.913;3600000;0
35719;-1;199;0;0;0;0;.00nan;0;0
35719;203120;204;0;0;0;0;.00nan;0;0
35486;201514;227;0;0;0;0;.00nan;0;0
35486;180377;228;89;45;3;42;.933;3707000;0
35486;213280;227;60;23;2;21;.913;3707000;0
35486;208044;228;0;0;0;0;.00nan;0;0
35693;200452;221;87;30;1;29;.967;3600000;0
35693;206800;225;0;0;0;0;.00nan;0;0
35693;-1;225;90;36;2;34;.944;3600000;0
35693;-1;221;0;0;0;0;.00nan;0;0
35788;205769;200;89;43;3;40;.930;3562000;0
35788;195238;200;0;0;0;0;.00nan;0;0
35788;201525;203;92;38;2;36;.947;3600000;0
35788;206772;203;0;0;0;0;.00nan;0;0
35528;182467;185;53;32;4;28;.875;1902000;0
35528;-1;220;0;0;0;0;.00nan;0;0
35528;-1;220;68;27;3;24;.889;3600000;0
35528;-1;185;53;21;3;18;.857;1698000;0
36200;187689;230;0;0;0;0;.00nan;0;0
36200;183678;230;27;18;5;13;.722;3600000;0
36200;183695;232;0;0;0;0;.00nan;0;0
36200;-1;232;99;37;1;36;.973;3600000;0
35513;192929;222;72;37;3;34;.919;3590000;0
35513;200444;224;0;0;0;0;.00nan;0;0
35513;213560;222;0;0;0;0;.00nan;0;0
35513;208372;224;63;22;2;20;.909;3600000;0
35665;205681;226;0;0;0;0;.00nan;0;0
35665;196283;206;0;0;0;0;.00nan;0;0
35665;-1;226;98;28;0;28;1.000;3600000;0
35665;202998;206;78;30;2;28;.933;3588000;0
35377;184874;212;0;0;0;0;.00nan;0;0
35377;191063;211;60;31;4;27;.871;3564000;0
35377;-1;212;70;26;2;24;.923;3600000;0
35377;-1;211;0;0;0;0;.00nan;0;0
35558;205769;200;0;0;0;0;.00nan;0;0
35558;195238;200;69;20;1;19;.950;3600000;0
35558;201524;205;0;0;0;0;.00nan;0;0
35558;-1;205;83;38;3;35;.921;3566000;0
36131;210134;1505;0;0;0;0;.00nan;0;0
36131;196571;177;61;24;3;21;.875;3600000;0
36131;-1;1505;66;46;5;41;.891;3557000;0
36131;-1;177;0;0;0;0;.00nan;0;0
35397;210504;193;65;34;3;31;.912;3600000;0
35397;189529;193;0;0;0;0;.00nan;0;0
35397;192547;190;47;28;4;24;.857;3585000;0
35397;-1;190;0;0;0;0;.00nan;0;0
35606;201495;213;71;41;5;36;.878;3556000;0
35606;-1;213;0;0;0;0;.00nan;0;0
35606;197672;210;69;36;4;32;.889;3600000;0
35606;-1;210;0;0;0;0;.00nan;0;0
35628;200333;194;34;17;4;13;.765;1959000;0
35628;196352;194;21;18;5;13;.722;1641000;0
35628;191118;196;70;35;3;32;.914;3600000;0
35628;202830;196;0;0;0;0;.00nan;0;0
35610;190164;4959;0;0;0;0;.00nan;0;0
35610;186332;4864;0;0;0;0;.00nan;0;0
35610;202801;4864;70;22;1;21;.955;3600000;0
35610;-1;4959;75;32;3;29;.906;3550000;0
35441;182467;185;78;29;2;27;.931;3600000;0
35441;-1;185;0;0;0;0;.00nan;0;0
35441;191518;214;26;27;6;21;.778;2973000;0
35441;202914;214;53;3;0;3;1.000;627000;0
35568;-1;220;78;33;2;31;.939;3662000;0
35568;-1;220;0;0;0;0;.00nan;0;0
35568;-1;1371;82;35;3;32;.914;3662000;0
35568;-1;1371;0;0;0;0;.00nan;0;0
35490;184788;198;39;18;4;14;.778;3562000;0
35490;212143;198;0;0;0;0;.00nan;0;0
35490;192547;190;0;0;0;0;.00nan;0;0
35490;-1;190;85;38;3;35;.921;3600000;0
35673;205681;226;0;0;0;0;.00nan;0;0
35673;196283;206;53;36;4;32;.889;3600000;0
35673;-1;226;68;20;1;19;.950;3600000;0
35673;202998;206;0;0;0;0;.00nan;0;0
35759;201585;197;34;16;4;12;.750;1106000;0
35759;206822;197;62;22;2;20;.909;2494000;0
35759;191118;196;0;0;0;0;.00nan;0;0
35759;202830;196;63;17;2;15;.882;3600000;0
35676;206800;225;68;23;1;22;.957;3600000;0
35676;-1;225;0;0;0;0;.00nan;0;0
35676;191120;223;0;0;0;0;.00nan;0;0
35676;187118;223;100;29;0;29;1.000;3600000;0
35523;192939;208;0;0;0;0;.00nan;0;0
35523;205788;207;90;47;3;44;.936;3590000;0
35523;197853;207;0;0;0;0;.00nan;0;0
35523;-1;208;57;18;2;16;.889;3600000;0
36089;-1;219;57;31;4;27;.871;3595000;0
36089;-1;219;0;0;0;0;.00nan;0;0
36089;191130;186;0;0;0;0;.00nan;0;0
36089;213507;186;68;35;3;32;.914;3600000;0
35553;192862;187;93;48;3;45;.938;3541000;0
35553;207061;195;69;20;1;19;.950;3600000;0
35553;196465;195;0;0;0;0;.00nan;0;0
35553;-1;187;0;0;0;0;.00nan;0;0
36183;190034;217;81;29;1;28;.966;3600000;0
36183;190041;217;0;0;0;0;.00nan;0;0
36183;191063;211;0;0;0;0;.00nan;0;0
36183;-1;211;56;27;3;24;.889;3587000;0
35475;210504;193;93;23;0;23;1.000;3600000;0
35475;194893;191;43;35;5;30;.857;3600000;0
35475;189529;193;0;0;0;0;.00nan;0;0
35475;201892;191;0;0;0;0;.00nan;0;0
35514;192929;222;0;0;0;0;.00nan;0;0
35514;201514;227;96;20;0;20;1.000;3600000;0
35514;213280;227;0;0;0;0;.00nan;0;0
35514;213560;222;51;20;2;18;.900;3521000;0
35531;200444;224;0;0;0;0;.00nan;0;0
35531;191120;223;0;0;0;0;.00nan;0;0
35531;187118;223;58;35;4;31;.886;3574000;0
35531;208372;224;74;30;2;28;.933;3600000;0
35561;198149;188;0;0;0;0;.00nan;0;0
35561;184409;188;48;30;5;25;.833;3600000;0
35561;-1;189;92;33;2;31;.939;3600000;0
35561;-1;189;0;0;0;0;.00nan;0;0
35465;206801;176;75;24;1;23;.958;3600000;0
35465;-1;2620;0;0;0;0;.00nan;0;0
35465;203099;176;0;0;0;0;.00nan;0;0
35465;213550;2620;75;33;3;30;.909;3515000;0
35433;188977;215;0;0;0;0;.00nan;0;0
35433;210794;215;59;37;4;33;.892;3536000;0
35433;-1;219;0;0;0;0;.00nan;0;0
35433;-1;219;65;25;2;23;.920;3600000;0
35762;182467;185;58;40;5;35;.875;3600000;0
35762;-1;185;0;0;0;0;.00nan;0;0
35762;-1;1371;0;0;0;0;.00nan;0;0
35762;-1;1371;82;23;1;22;.957;3600000;0
35379;184874;212;0;0;0;0;.00nan;0;0
35379;191130;186;43;36;6;30;.833;3600000;0
35379;-1;212;66;19;1;18;.947;3600000;0
35379;213507;186;0;0;0;0;.00nan;0;0
35843;210134;1505;84;25;1;24;.960;3600000;0
35843;201495;213;50;31;5;26;.839;3600000;0
35843;-1;1505;0;0;0;0;.00nan;0;0
35843;-1;213;0;0;0;0;.00nan;0;0
35547;195251;4949;80;28;2;26;.929;3600000;0
35547;196571;177;47;20;3;17;.850;3600000;0
35547;-1;4949;0;0;0;0;.00nan;0;0
35547;-1;177;0;0;0;0;.00nan;0;0
35586;200437;201;73;45;5;40;.889;3600000;0
35586;201525;203;78;24;1;23;.958;3600000;0
35586;206772;203;0;0;0;0;.00nan;0;0
35586;208048;201;0;0;0;0;.00nan;0;0
35548;200333;194;96;57;3;54;.947;3600000;0
35548;-1;192;51;16;2;14;.875;3600000;0
35548;196352;194;0;0;0;0;.00nan;0;0
35548;207398;192;0;0;0;0;.00nan;0;0
35624;194219;4960;91;34;1;33;.971;3600000;0
35624;200452;221;69;32;3;29;.906;3566000;0
35624;206971;4960;0;0;0;0;.00nan;0;0
35624;-1;221;0;0;0;0;.00nan;0;0
35589;195164;218;71;41;5;36;.878;3600000;0
35589;-1;180;100;22;0;22;1.000;3600000;0
35589;208051;218;0;0;0;0;.00nan;0;0
35589;208383;180;0;0;0;0;.00nan;0;0
35492;186332;4864;77;32;2;30;.938;3900000;0
35492;-1;209;77;30;2;28;.933;3900000;0
35492;202801;4864;0;0;0;0;.00nan;0;0
35492;213590;209;0;0;0;0;.00nan;0;0
35826;205769;200;100;44;1;43;.977;3600000;0
35826;195238;200;0;0;0;0;.00nan;0;0
35826;-1;199;0;0;0;0;.00nan;0;0
35826;-1;199;91;38;2;36;.947;3600000;0
35477;190164;4959;0;0;0;0;.00nan;0;0
35477;206801;176;0;0;0;0;.00nan;0;0
35477;-1;4959;95;31;1;30;.968;3600000;0
35477;203099;176;75;33;2;31;.939;3553000;0
35396;194893;191;0;0;0;0;.00nan;0;0
35396;201892;191;50;23;3;20;.870;3600000;0
35396;192547;190;67;44;5;39;.886;3575000;0
35396;-1;190;0;0;0;0;.00nan;0;0
35445;188977;215;91;18;0;18;1.000;3600000;0
35445;210794;215;0;0;0;0;.00nan;0;0
35445;191063;211;43;24;4;20;.833;2316000;0
35445;-1;211;68;14;0;14;1.000;1284000;0
35454;192915;179;0;0;0;0;.00nan;0;0
35454;211942;183;82;27;1;26;.963;3600000;0
35454;196237;183;0;0;0;0;.00nan;0;0
35454;187355;179;100;40;0;40;1.000;3600000;0
35747;210134;1505;0;0;0;0;.00nan;0;0
35747;196571;177;0;0;0;0;.00nan;0;0
35747;-1;1505;77;32;2;30;.938;3900000;0
35747;-1;177;73;26;2;24;.923;3900000;0
35725;200437;201;0;0;0;0;.00nan;0;0
35725;205769;200;0;0;0;0;.00nan;0;0
35725;195238;200;50;30;4;26;.867;3600000;0
35725;208048;201;71;37;3;34;.919;3600000;0
35506;200306;182;0;0;0;0;.00nan;0;0
35506;190038;181;0;0;0;0;.00nan;0;0
35506;185810;182;74;30;3;27;.900;3559000;0
35506;192552;181;98;32;1;31;.969;3600000;0
35516;198149;188;95;46;2;44;.957;3545000;0
35516;210504;193;69;15;1;14;.933;3600000;0
35516;189529;193;0;0;0;0;.00nan;0;0
35516;184409;188;0;0;0;0;.00nan;0;0
35637;194219;4960;81;31;2;29;.935;3600000;0
35637;210998;229;0;0;0;0;.00nan;0;0
35637;206971;4960;0;0;0;0;.00nan;0;0
35637;185960;229;94;46;3;43;.935;3586000;0
35580;205788;207;0;0;0;0;.00nan;0;0
35580;201524;205;0;0;0;0;.00nan;0;0
35580;197853;207;87;25;1;24;.960;3559000;0
35580;-1;205;89;18;0;18;1.000;3600000;0
35608;209915;231;0;0;0;0;.00nan;0;0
35608;200452;221;98;52;2;50;.962;3567000;0
35608;189773;231;53;11;1;10;.909;3600000;0
35608;-1;221;0;0;0;0;.00nan;0;0
35615;190034;217;0;0;0;0;.00nan;0;0
35615;190041;217;70;19;1;18;.947;3600000;0
35615;184874;212;63;31;3;28;.903;3573000;0
35615;-1;212;0;0;0;0;.00nan;0;0
35621;200333;194;0;0;0;0;.00nan;0;0
35621;-1;192;0;0;0;0;.00nan;0;0
35621;196352;194;97;46;1;45;.978;3900000;0
35621;207398;192;87;20;1;19;.950;3900000;0
35529;192929;222;93;33;1;32;.970;3900000;0
35529;180377;228;93;32;1;31;.969;3900000;0
35529;208044;228;0;0;0;0;.00nan;0;0
35529;213560;222;0;0;0;0;.00nan;0;0
35599;-1;209;82;40;2;38;.950;3900000;0
35599;-1;2620;63;24;2;22;.917;3900000;0
35599;213550;2620;0;0;0;0;.00nan;0;0
35599;213590;209;0;0;0;0;.00nan;0;0
35657;189902;204;71;35;4;31;.886;3858000;0
35657;201560;202;53;27;4;23;.852;3300000;0
35657;212028;202;48;5;1;4;.800;558000;0
35657;203120;204;0;0;0;0;.00nan;0;0
35650;209840;184;0;0;0;0;.00nan;0;0
35650;205837;184;84;25;1;24;.960;3600000;0
35650;-1;1371;94;47;2;45;.957;3543000;0
35650;-1;1371;0;0;0;0;.00nan;0;0
35557;192939;208;0;0;0;0;.00nan;0;0
35557;205681;226;0;0;0;0;.00nan;0;0
35557;-1;226;76;30;2;28;.933;3586000;0
35557;-1;208;91;32;1;31;.969;3600000;0
35503;-1;178;0;0;0;0;.00nan;0;0
35503;213399;216;0;0;0;0;.00nan;0;0
35503;-1;178;59;29;3;26;.897;3900000;0
35503;-1;216;77;33;3;30;.909;3900000;0
35494;183695;232;46;44;7;37;.841;3600000;0
35494;201514;227;0;0;0;0;.00nan;0;0
35494;213280;227;59;18;2;16;.889;3600000;0
35494;-1;232;0;0;0;0;.00nan;0;0
35578;184788;198;61;21;2;19;.905;3600000;0
35578;201585;197;0;0;0;0;.00nan;0;0
35578;206822;197;89;60;5;55;.917;3600000;0
35578;212143;198;0;0;0;0;.00nan;0;0
35616;190038;181;90;28;1;27;.964;3713000;0
35616;-1;220;0;0;0;0;.00nan;0;0
35616;-1;220;68;24;2;22;.917;3713000;0
35616;192552;181;0;0;0;0;.00nan;0;0
35415;184788;198;0;0;0;0;.00nan;0;0
35415;212143;198;68;29;3;26;.897;3542000;0
35415;192547;190;100;45;2;43;.956;3600000;0
35415;-1;190;0;0;0;0;.00nan;0;0
35869;189902;204;50;23;3;20;.870;3600000;0
35869;196283;206;0;0;0;0;.00nan;0;0
35869;202998;206;59;32;4;28;.875;3544000;0
35869;203120;204;0;0;0;0;.00nan;0;0
35497;-1;178;0;0;0;0;.00nan;0;0
35497;197672;210;61;19;3;16;.842;3600000;0
35497;-1;178;83;46;4;42;.913;3598000;0
35497;-1;210;0;0;0;0;.00nan;0;0
35643;209915;231;0;0;0;0;.00nan;0;0
35643;210998;229;0;0;0;0;.00nan;0;0
35643;189773;231;87;31;2;29;.935;3661000;0
35643;185960;229;99;44;1;43;.977;3661000;0
35795;192862;187;0;0;0;0;.00nan;0;0
35795;-1;189;0;0;0;0;.00nan;0;0
35795;-1;187;100;24;0;24;1.000;3600000;0
35795;-1;189;63;42;5;37;.881;3600000;0
35671;201524;205;0;0;0;0;.00nan;0;0
35671;201560;202;0;0;0;0;.00nan;0;0
35671;212028;202;82;42;3;39;.929;3600000;0
35671;-1;205;43;23;4;19;.826;3544000;0
35623;192939;208;0;0;0;0;.00nan;0;0
35623;205788;207;73;33;2;31;.939;3600000;0
35623;197853;207;0;0;0;0;.00nan;0;0
35623;-1;208;35;19;4;15;.789;3516000;0
35622;206800;225;0;0;0;0;.00nan;0;0
35622;180377;228;60;32;4;28;.875;3591000;0
35622;-1;225;67;23;2;21;.913;3600000;0
35622;208044;228;0;0;0;0;.00nan;0;0
35670;210134;1505;0;0;0;0;.00nan;0;0
35670;201495;213;0;0;0;0;.00nan;0;0
35670;-1;1505;98;44;2;42;.955;3600000;0
35670;-1;213;68;15;1;14;.933;3600000;0
35493;190164;4959;0;0;0;0;.00nan;0;0
35493;-1;209;62;44;5;39;.886;3600000;0
35493;-1;4959;69;17;1;16;.941;3600000;0
35493;213590;209;0;0;0;0;.00nan;0;0
35458;200306;182;0;0;0;0;.00nan;0;0
35458;185810;182;48;27;4;23;.852;3600000;0
35458;191518;214;23;23;6;17;.739;2329000;0
35458;202914;214;32;23;5;18;.783;1271000;0
35579;192915;179;0;0;0;0;.00nan;0;0
35579;187355;179;60;26;3;23;.885;3600000;0
35579;197672;210;0;0;0;0;.00nan;0;0
35579;-1;210;64;42;4;38;.905;3534000;0
35678;205681;226;0;0;0;0;.00nan;0;0
35678;-1;226;85;32;1;31;.969;3600000;0
35678;-1;199;49;36;5;31;.861;3600000;0
35678;-1;199;0;0;0;0;.00nan;0;0
35644;191063;211;0;0;0;0;.00nan;0;0
35644;-1;180;68;28;3;25;.893;3600000;0
35644;-1;211;76;38;4;34;.895;3565000;0
35644;208383;180;0;0;0;0;.00nan;0;0
35781;207061;195;98;19;0;19;1.000;3600000;0
35781;196465;195;0;0;0;0;.00nan;0;0
35781;191118;196;95;51;2;49;.961;3516000;0
35781;202830;196;0;0;0;0;.00nan;0;0
35675;209840;184;69;29;3;26;.897;3600000;0
35675;205837;184;0;0;0;0;.00nan;0;0
35675;-1;220;84;34;2;32;.941;3600000;0
35675;-1;220;0;0;0;0;.00nan;0;0
35424;188977;215;83;39;3;36;.923;3600000;0
35424;210794;215;0;0;0;0;.00nan;0;0
35424;195164;218;94;33;2;31;.939;3600000;0
35424;208051;218;0;0;0;0;.00nan;0;0
35634;184874;212;0;0;0;0;.00nan;0;0
35634;-1;219;75;43;4;39;.907;3585000;0
35634;-1;219;0;0;0;0;.00nan;0;0
35634;-1;212;57;22;2;20;.909;3600000;0
35595;200437;201;95;40;2;38;.950;3600000;0
35595;196283;206;0;0;0;0;.00nan;0;0
35595;208048;201;0;0;0;0;.00nan;0;0
35595;202998;206;59;26;3;23;.885;3600000;0
35659;190034;217;54;21;3;18;.857;3600000;0
35659;190041;217;0;0;0;0;.00nan;0;0
35659;191130;186;0;0;0;0;.00nan;0;0
35659;213507;186;54;30;4;26;.867;3600000;0
35530;206801;176;57;35;4;31;.886;3600000;0
35530;-1;2620;0;0;0;0;.00nan;0;0
35530;203099;176;0;0;0;0;.00nan;0;0
35530;213550;2620;99;51;1;50;.980;3600000;0
35522;195251;4949;80;49;4;45;.918;3900000;0
35522;211942;183;0;0;0;0;.00nan;0;0
35522;196237;183;67;34;4;30;.882;3900000;0
35522;-1;4949;0;0;0;0;.00nan;0;0
36202;182467;185;56;31;5;26;.839;3600000;0
36202;-1;185;0;0;0;0;.00nan;0;0
36202;-1;1371;0;0;0;0;.00nan;0;0
36202;-1;1371;85;32;2;30;.938;3600000;0
35708;201524;205;0;0;0;0;.00nan;0;0
35708;-1;199;0;0;0;0;.00nan;0;0
35708;-1;199;82;35;2;33;.943;3900000;0
35708;-1;205;62;24;2;22;.917;3900000;0
35613;192939;208;0;0;0;0;.00nan;0;0
35613;189902;204;54;34;5;29;.853;3600000;0
35613;-1;208;86;34;2;32;.941;3600000;0
35613;203120;204;0;0;0;0;.00nan;0;0
35526;183695;232;0;0;0;0;.00nan;0;0
35526;200444;224;92;37;2;35;.946;3600000;0
35526;208372;224;0;0;0;0;.00nan;0;0
35526;-1;232;59;37;5;32;.865;3600000;0
35812;194219;4960;0;0;0;0;.00nan;0;0
35812;200452;221;82;26;1;25;.962;3600000;0
35812;206971;4960;70;32;3;29;.906;3542000;0
35812;-1;221;0;0;0;0;.00nan;0;0
35517;200306;182;70;24;2;22;.917;3600000;0
35517;185810;182;0;0;0;0;.00nan;0;0
35517;191518;214;91;34;1;33;.971;3600000;0
35517;202914;214;0;0;0;0;.00nan;0;0
35662;205769;200;76;33;2;31;.939;3600000;0
35662;195238;200;0;0;0;0;.00nan;0;0
35662;201560;202;55;29;4;25;.862;3580000;0
35662;212028;202;0;0;0;0;.00nan;0;0
35796;-1;192;62;21;3;18;.857;3600000;0
35796;207398;192;0;0;0;0;.00nan;0;0
35796;191118;196;0;0;0;0;.00nan;0;0
35796;202830;196;68;40;4;36;.900;3552000;0
35582;198149;188;0;0;0;0;.00nan;0;0
35582;184409;188;58;31;4;27;.871;3600000;0
35582;-1;189;0;0;0;0;.00nan;0;0
35582;-1;189;37;23;5;18;.783;3564000;0
35677;180377;228;77;38;3;35;.921;3542000;0
35677;191120;223;0;0;0;0;.00nan;0;0
35677;187118;223;79;23;1;22;.957;3600000;0
35677;208044;228;0;0;0;0;.00nan;0;0
35731;190164;4959;67;39;4;35;.897;3626000;0
35731;186332;4864;55;21;3;18;.857;3626000;0
35731;202801;4864;0;0;0;0;.00nan;0;0
35731;-1;4959;0;0;0;0;.00nan;0;0
35479;194893;191;81;20;1;19;.950;3600000;0
35479;201585;197;61;7;0;7;1.000;401000;0
35479;206822;197;80;60;6;54;.900;3199000;0
35479;201892;191;0;0;0;0;.00nan;0;0
35470;192915;179;78;39;3;36;.923;3514000;0
35470;187355;179;0;0;0;0;.00nan;0;0
35470;-1;178;0;0;0;0;.00nan;0;0
35470;-1;178;71;28;1;27;.964;3600000;0
35686;190034;217;0;0;0;0;.00nan;0;0
35686;190041;217;59;29;3;26;.897;3551000;0
35686;-1;219;0;0;0;0;.00nan;0;0
35686;-1;219;90;34;1;33;.971;3600000;0
35565;201495;213;56;44;5;39;.886;3600000;0
35565;211942;183;69;19;1;18;.947;3600000;0
35565;196237;183;0;0;0;0;.00nan;0;0
35565;-1;213;0;0;0;0;.00nan;0;0
35467;184788;198;0;0;0;0;.00nan;0;0
35467;212143;198;81;31;2;29;.935;3600000;0
35467;192547;190;58;30;3;27;.900;3551000;0
35467;-1;190;0;0;0;0;.00nan;0;0
35563;195251;4949;0;0;0;0;.00nan;0;0
35563;213399;216;0;0;0;0;.00nan;0;0
35563;-1;4949;59;30;3;27;.900;3735000;0
35563;-1;216;72;40;4;36;.900;3735000;0
35955;201525;203;64;20;2;18;.900;3566000;0
35955;206772;203;0;0;0;0;.00nan;0;0
35955;196283;206;0;0;0;0;.00nan;0;0
35955;202998;206;100;49;1;48;.980;3600000;0
35888;187689;230;87;20;0;20;1.000;2412000;0
35888;183678;230;41;20;4;16;.800;1188000;0
35888;209915;231;0;0;0;0;.00nan;0;0
35888;189773;231;100;36;1;35;.972;3600000;0
35687;210998;229;0;0;0;0;.00nan;0;0
35687;185960;229;54;22;3;19;.864;3549000;0
35687;191120;223;0;0;0;0;.00nan;0;0
35687;187118;223;69;29;2;27;.931;3600000;0
35730;209840;184;0;0;0;0;.00nan;0;0
35730;205837;184;76;34;3;31;.912;3579000;0
35730;-1;1371;100;31;0;31;1.000;3600000;0
35730;-1;1371;0;0;0;0;.00nan;0;0
35814;182467;185;70;33;4;29;.879;3900000;0
35814;-1;220;0;0;0;0;.00nan;0;0
35814;-1;220;57;36;4;32;.889;3900000;0
35814;-1;185;0;0;0;0;.00nan;0;0
36190;186332;4864;0;0;0;0;.00nan;0;0
36190;202801;4864;61;29;3;26;.897;3600000;0
36190;-1;2620;0;0;0;0;.00nan;0;0
36190;213550;2620;72;26;2;24;.923;3600000;0
35509;201514;227;93;30;1;29;.967;3600000;0
35509;206800;225;0;0;0;0;.00nan;0;0
35509;-1;225;83;31;2;29;.935;3574000;0
35509;213280;227;0;0;0;0;.00nan;0;0
35772;205681;226;0;0;0;0;.00nan;0;0
35772;205788;207;0;0;0;0;.00nan;0;0
35772;-1;226;61;19;2;17;.895;3600000;0
35772;197853;207;63;44;5;39;.886;3600000;0
35501;195164;218;23;34;7;27;.794;3107000;0
35501;-1;180;82;30;1;29;.967;3600000;0
35501;208051;218;58;6;0;6;1.000;493000;0
35501;208383;180;0;0;0;0;.00nan;0;0
35524;183695;232;54;27;3;24;.889;3600000;0
35524;200444;224;0;0;0;0;.00nan;0;0
35524;208372;224;98;20;0;20;1.000;3600000;0
35524;-1;232;0;0;0;0;.00nan;0;0
35819;201585;197;86;44;3;41;.932;3545000;0
35819;206822;197;0;0;0;0;.00nan;0;0
35819;191118;196;84;28;1;27;.964;3600000;0
35819;202830;196;0;0;0;0;.00nan;0;0
36194;190164;4959;0;0;0;0;.00nan;0;0
36194;206801;176;44;26;4;22;.846;3561000;0
36194;-1;4959;82;39;3;36;.923;3600000;0
36194;203099;176;0;0;0;0;.00nan;0;0
35641;196571;177;97;42;1;41;.976;3900000;0
35641;197672;210;96;31;1;30;.968;3900000;0
35641;-1;210;0;0;0;0;.00nan;0;0
35641;-1;177;0;0;0;0;.00nan;0;0
35597;192929;222;0;0;0;0;.00nan;0;0
35597;206800;225;41;36;7;29;.806;2731000;0
35597;-1;225;50;16;2;14;.875;869000;0
35597;213560;222;100;32;0;32;1.000;3600000;0
35481;200333;194;69;46;5;41;.891;3600000;0
35481;210504;193;77;23;1;22;.957;3600000;0
35481;189529;193;0;0;0;0;.00nan;0;0
35481;196352;194;0;0;0;0;.00nan;0;0
35591;190038;181;0;0;0;0;.00nan;0;0
35591;191518;214;35;28;5;23;.821;3600000;0
35591;192552;181;85;24;1;23;.958;3600000;0
35591;202914;214;0;0;0;0;.00nan;0;0
35742;-1;219;65;16;1;15;.938;3600000;0
35742;-1;219;0;0;0;0;.00nan;0;0
35742;191063;211;0;0;0;0;.00nan;0;0
35742;-1;211;62;33;3;30;.909;3570000;0
35544;187689;230;0;0;0;0;.00nan;0;0
35544;183678;230;61;21;2;19;.905;3600000;0
35544;201514;227;0;0;0;0;.00nan;0;0
35544;213280;227;78;44;3;41;.932;3600000;0
36095;201585;197;0;0;0;0;.00nan;0;0
36095;206822;197;91;40;4;36;.900;3900000;0
36095;191118;196;0;0;0;0;.00nan;0;0
36095;202830;196;71;37;4;33;.892;3900000;0
35721;194219;4960;67;39;3;36;.923;3900000;0
35721;209915;231;0;0;0;0;.00nan;0;0
35721;189773;231;79;32;3;29;.906;3900000;0
35721;206971;4960;0;0;0;0;.00nan;0;0
35515;210504;193;0;0;0;0;.00nan;0;0
35515;189529;193;67;29;2;27;.931;3882000;0
35515;192547;190;60;28;3;25;.893;3882000;0
35515;-1;190;0;0;0;0;.00nan;0;0
35874;189902;204;100;21;0;21;1.000;3600000;0
35874;196283;206;0;0;0;0;.00nan;0;0
35874;202998;206;84;42;3;39;.929;3600000;0
35874;203120;204;0;0;0;0;.00nan;0;0
35564;195251;4949;81;24;1;23;.958;3600000;0
35564;213399;216;0;0;0;0;.00nan;0;0
35564;-1;4949;0;0;0;0;.00nan;0;0
35564;-1;216;63;22;2;20;.909;3545000;0
35504;211942;183;48;28;4;24;.857;3600000;0
35504;196237;183;0;0;0;0;.00nan;0;0
35504;-1;178;43;39;6;33;.846;3520000;0
35504;-1;178;0;0;0;0;.00nan;0;0
35625;-1;209;70;25;2;23;.920;3600000;0
35625;-1;2620;41;30;5;25;.833;3600000;0
35625;213550;2620;0;0;0;0;.00nan;0;0
35625;213590;209;0;0;0;0;.00nan;0;0
35638;192939;208;0;0;0;0;.00nan;0;0
35638;205681;226;0;0;0;0;.00nan;0;0
35638;-1;226;74;20;1;19;.950;3600000;0
35638;-1;208;86;42;3;39;.929;3555000;0
35598;192929;222;100;33;0;33;1.000;3600000;0
35598;200452;221;44;20;3;17;.850;3600000;0
35598;213560;222;0;0;0;0;.00nan;0;0
35598;-1;221;0;0;0;0;.00nan;0;0
35859;190038;181;91;40;2;38;.950;3600000;0
35859;-1;220;0;0;0;0;.00nan;0;0
35859;-1;220;48;20;3;17;.850;3560000;0
35859;192552;181;0;0;0;0;.00nan;0;0
35500;188977;215;0;0;0;0;.00nan;0;0
35500;210794;215;56;32;4;28;.875;3559000;0
35500;190034;217;65;27;3;24;.889;3600000;0
35500;190041;217;0;0;0;0;.00nan;0;0
35798;205788;207;77;41;4;37;.902;3751000;0
35798;201525;203;80;32;3;29;.906;3751000;0
35798;206772;203;0;0;0;0;.00nan;0;0
35798;197853;207;0;0;0;0;.00nan;0;0
35489;194893;191;76;23;1;22;.957;3600000;0
35489;201892;191;0;0;0;0;.00nan;0;0
35489;207061;195;54;33;4;29;.879;3600000;0
35489;196465;195;0;0;0;0;.00nan;0;0
35790;205769;200;0;0;0;0;.00nan;0;0
35790;195238;200;66;36;4;32;.889;3532000;0
35790;-1;199;80;36;2;34;.944;3600000;0
35790;-1;199;0;0;0;0;.00nan;0;0
36034;-1;219;0;0;0;0;.00nan;0;0
36034;-1;219;100;38;1;37;.974;3600000;0
36034;-1;180;57;21;2;19;.905;3600000;0
36034;208383;180;0;0;0;0;.00nan;0;0
35587;200333;194;53;3;0;3;1.000;585000;0
35587;184788;198;68;30;3;27;.900;3600000;0
35587;212143;198;0;0;0;0;.00nan;0;0
35587;196352;194;34;34;6;28;.824;3015000;0
35617;195164;218;41;38;6;32;.842;3600000;0
35617;184874;212;0;0;0;0;.00nan;0;0
35617;-1;212;66;16;2;14;.875;3600000;0
35617;208051;218;0;0;0;0;.00nan;0;0
35651;201495;213;39;38;6;32;.842;3359000;0
35651;-1;213;54;4;0;4;1.000;228000;0
35651;197672;210;0;0;0;0;.00nan;0;0
35651;-1;210;34;26;5;21;.808;3600000;0
35791;206800;225;0;0;0;0;.00nan;0;0
35791;-1;225;75;41;4;37;.902;3600000;0
35791;191120;223;0;0;0;0;.00nan;0;0
35791;187118;223;66;21;1;20;.952;3600000;0
35674;205681;226;0;0;0;0;.00nan;0;0
35674;201560;202;0;0;0;0;.00nan;0;0
35674;212028;202;65;28;3;25;.893;3600000;0
35674;-1;226;100;31;0;31;1.000;3600000;0
35645;209840;184;77;16;1;15;.938;3600000;0
35645;205837;184;0;0;0;0;.00nan;0;0
35645;191518;214;42;33;5;28;.848;3600000;0
35645;202914;214;0;0;0;0;.00nan;0;0
35797;201495;213;0;0;0;0;.00nan;0;0
35797;196571;177;50;18;3;15;.833;3600000;0
35797;-1;213;54;41;6;35;.854;3600000;0
35797;-1;177;0;0;0;0;.00nan;0;0
35839;205788;207;0;0;0;0;.00nan;0;0
35839;196283;206;0;0;0;0;.00nan;0;0
35839;197853;207;59;24;3;21;.875;3600000;0
35839;202998;206;66;38;4;34;.895;3587000;0
35660;201524;205;0;0;0;0;.00nan;0;0
35660;201525;203;0;0;0;0;.00nan;0;0
35660;206772;203;78;30;2;28;.933;3900000;0
35660;-1;205;74;28;2;26;.929;3900000;0
35535;192915;179;0;0;0;0;.00nan;0;0
35535;187355;179;34;19;4;15;.789;3545000;0
35535;-1;178;0;0;0;0;.00nan;0;0
35535;-1;178;95;42;2;40;.952;3600000;0
35664;186332;4864;70;24;1;23;.958;3600000;0
35664;-1;209;0;0;0;0;.00nan;0;0
35664;202801;4864;0;0;0;0;.00nan;0;0
35664;213590;209;39;30;5;25;.833;3600000;0
35588;183695;232;81;34;2;32;.941;3900000;0
35588;201514;227;73;27;2;25;.926;3900000;0
35588;213280;227;0;0;0;0;.00nan;0;0
35588;-1;232;0;0;0;0;.00nan;0;0
35527;194893;191;81;26;1;25;.962;3600000;0
35527;184788;198;42;3;1;2;.667;278000;0
35527;212143;198;47;32;5;27;.844;3322000;0
35527;201892;191;0;0;0;0;.00nan;0;0
35718;200306;182;0;0;0;0;.00nan;0;0
35718;185810;182;84;35;2;33;.943;3584000;0
35718;-1;1371;100;35;1;34;.971;3600000;0
35718;-1;1371;0;0;0;0;.00nan;0;0
35722;190034;217;0;0;0;0;.00nan;0;0
35722;190041;217;66;16;1;15;.938;3600000;0
35722;191063;211;0;0;0;0;.00nan;0;0
35722;-1;211;67;34;4;30;.882;3600000;0
35876;194219;4960;0;0;0;0;.00nan;0;0
35876;209915;231;0;0;0;0;.00nan;0;0
35876;189773;231;84;25;1;24;.960;3600000;0
35876;206971;4960;78;36;3;33;.917;3558000;0
35533;188977;215;54;29;5;24;.828;3864000;0
35533;210794;215;0;0;0;0;.00nan;0;0
35533;195164;218;52;32;5;27;.844;3900000;0
35533;208051;218;0;0;0;0;.00nan;0;0
35593;206801;176;24;25;6;19;.760;3565000;0
35593;-1;2620;0;0;0;0;.00nan;0;0
35593;203099;176;0;0;0;0;.00nan;0;0
35593;213550;2620;74;41;4;37;.902;3600000;0
35539;200444;224;0;0;0;0;.00nan;0;0
35539;210998;229;0;0;0;0;.00nan;0;0
35539;185960;229;76;34;3;31;.912;3900000;0
35539;208372;224;53;26;3;23;.885;3900000;0
35639;192939;208;0;0;0;0;.00nan;0;0
35639;205769;200;92;36;1;35;.972;3600000;0
35639;195238;200;0;0;0;0;.00nan;0;0
35639;-1;208;72;31;3;28;.903;3600000;0
35778;192862;187;0;0;0;0;.00nan;0;0
35778;198149;188;0;0;0;0;.00nan;0;0
35778;184409;188;52;22;3;19;.864;3600000;0
35778;-1;187;39;26;5;21;.808;3543000;0
35962;210134;1505;0;0;0;0;.00nan;0;0
35962;211942;183;0;0;0;0;.00nan;0;0
35962;196237;183;68;19;1;18;.947;3600000;0
35962;-1;1505;64;36;4;32;.889;3600000;0
35845;200437;201;76;17;1;16;.941;3600000;0
35845;189902;204;90;53;2;51;.962;3550000;0
35845;208048;201;0;0;0;0;.00nan;0;0
35845;203120;204;0;0;0;0;.00nan;0;0
35685;184874;212;0;0;0;0;.00nan;0;0
35685;191130;186;0;0;0;0;.00nan;0;0
35685;-1;212;75;23;1;22;.957;3600000;0
35685;213507;186;66;40;4;36;.900;3600000;0
35774;182467;185;90;32;1;31;.969;3600000;0
35774;209840;184;0;0;0;0;.00nan;0;0
35774;205837;184;100;36;0;36;1.000;3600000;0
35774;-1;185;0;0;0;0;.00nan;0;0
35766;198149;188;36;28;5;23;.821;3600000;0
35766;184409;188;0;0;0;0;.00nan;0;0
35766;191118;196;93;36;2;34;.944;3600000;0
35766;202830;196;0;0;0;0;.00nan;0;0
35842;-1;192;100;33;0;33;1.000;3600000;0
35842;207061;195;72;30;2;28;.933;3570000;0
35842;196465;195;0;0;0;0;.00nan;0;0
35842;207398;192;0;0;0;0;.00nan;0;0
35697;200452;221;79;46;5;41;.891;3600000;0
35697;191120;223;49;43;6;37;.860;3551000;0
35697;187118;223;0;0;0;0;.00nan;0;0
35697;-1;221;0;0;0;0;.00nan;0;0
35581;210134;1505;73;41;4;37;.902;3600000;0
35581;195251;4949;0;0;0;0;.00nan;0;0
35581;-1;1505;0;0;0;0;.00nan;0;0
35581;-1;4949;81;29;2;27;.931;3600000;0
35940;200437;201;0;0;0;0;.00nan;0;0
35940;201525;203;98;44;2;42;.955;3519000;0
35940;206772;203;0;0;0;0;.00nan;0;0
35940;208048;201;99;25;0;25;1.000;3600000;0
35692;192929;222;0;0;0;0;.00nan;0;0
35692;209915;231;0;0;0;0;.00nan;0;0
35692;189773;231;44;15;2;13;.867;3600000;0
35692;213560;222;59;42;5;37;.881;3600000;0
35658;201495;213;62;34;4;30;.882;3600000;0
35658;-1;213;0;0;0;0;.00nan;0;0
35658;197672;210;100;21;0;21;1.000;3600000;0
35658;-1;210;0;0;0;0;.00nan;0;0
35555;210504;193;63;17;2;15;.882;3600000;0
35555;189529;193;0;0;0;0;.00nan;0;0
35555;-1;189;0;0;0;0;.00nan;0;0
35555;-1;189;65;33;3;30;.909;3598000;0
35566;200333;194;85;52;3;49;.942;3590000;0
35566;194893;191;53;10;1;9;.900;3600000;0
35566;201892;191;0;0;0;0;.00nan;0;0
35566;196352;194;0;0;0;0;.00nan;0;0
35556;201585;197;95;27;1;26;.963;3600000;0
35556;206822;197;0;0;0;0;.00nan;0;0
35556;192547;190;74;38;3;35;.921;3578000;0
35556;-1;190;0;0;0;0;.00nan;0;0
35552;187689;230;83;22;1;21;.955;3600000;0
35552;183678;230;0;0;0;0;.00nan;0;0
35552;201514;227;56;22;3;19;.864;1083000;0
35552;213280;227;39;34;6;28;.824;2517000;0
35709;-1;220;0;0;0;0;.00nan;0;0
35709;-1;220;66;22;1;21;.955;3885000;0
35709;191518;214;91;47;2;45;.957;3885000;0
35709;202914;214;0;0;0;0;.00nan;0;0
35508;-1;178;0;0;0;0;.00nan;0;0
35508;213399;216;73;33;3;30;.909;3714000;0
35508;-1;178;72;25;2;23;.920;3714000;0
35508;-1;216;0;0;0;0;.00nan;0;0
35705;200452;221;0;0;0;0;.00nan;0;0
35705;210998;229;0;0;0;0;.00nan;0;0
35705;185960;229;62;28;3;25;.893;3627000;0
35705;-1;221;75;26;2;24;.923;3627000;0
35690;201524;205;99;33;1;32;.970;3600000;0
35690;201560;202;59;29;3;26;.897;3535000;0
35690;212028;202;0;0;0;0;.00nan;0;0
35690;-1;205;0;0;0;0;.00nan;0;0
35602;188977;215;0;0;0;0;.00nan;0;0
35602;210794;215;68;35;3;32;.914;3529000;0
35602;190034;217;74;23;1;22;.957;3600000;0
35602;190041;217;0;0;0;0;.00nan;0;0
35767;194219;4960;55;33;5;28;.848;3573000;0
35767;200444;224;38;22;4;18;.818;2198000;0
35767;206971;4960;0;0;0;0;.00nan;0;0
35767;208372;224;67;10;0;10;1.000;1402000;0
35626;190164;4959;51;2;0;2;1.000;672000;0
35626;206801;176;82;33;1;32;.970;3600000;0
35626;-1;4959;6;21;7;14;.667;2928000;0
35626;203099;176;0;0;0;0;.00nan;0;0
35652;200306;182;0;0;0;0;.00nan;0;0
35652;190038;181;0;0;0;0;.00nan;0;0
35652;185810;182;99;22;0;22;1.000;3600000;0
35652;192552;181;71;32;3;29;.906;3600000;0
35646;186332;4864;0;0;0;0;.00nan;0;0
35646;202801;4864;66;20;1;19;.950;3600000;0
35646;-1;2620;73;50;6;44;.880;3600000;0
35646;213550;2620;0;0;0;0;.00nan;0;0
35620;195251;4949;76;33;2;31;.939;3587000;0
35620;196571;177;99;33;1;32;.970;3600000;0
35620;-1;4949;0;0;0;0;.00nan;0;0
35620;-1;177;0;0;0;0;.00nan;0;0
35609;183695;232;0;0;0;0;.00nan;0;0
35609;206800;225;0;0;0;0;.00nan;0;0
35609;-1;225;77;34;2;32;.941;3900000;0
35609;-1;232;82;30;2;28;.933;3900000;0
35761;191130;186;54;32;4;28;.875;2267000;0
35761;-1;180;74;25;2;23;.920;3600000;0
35761;213507;186;79;18;0;18;1.000;1252000;0
35761;208383;180;0;0;0;0;.00nan;0;0
35614;192929;222;54;25;3;22;.880;3600000;0
35614;187689;230;0;0;0;0;.00nan;0;0
35614;183678;230;82;24;1;23;.958;3600000;0
35614;213560;222;0;0;0;0;.00nan;0;0
35630;190164;4959;38;29;5;24;.828;3600000;0
35630;206801;176;0;0;0;0;.00nan;0;0
35630;-1;4959;0;0;0;0;.00nan;0;0
35630;203099;176;90;38;2;36;.947;3600000;0
35879;200437;201;84;30;1;29;.967;3600000;0
35879;205788;207;59;29;3;26;.897;3600000;0
35879;208048;201;0;0;0;0;.00nan;0;0
35879;197853;207;0;0;0;0;.00nan;0;0
35838;190038;181;69;21;1;20;.952;3600000;0
35838;191518;214;0;0;0;0;.00nan;0;0
35838;192552;181;0;0;0;0;.00nan;0;0
35838;202914;214;70;33;3;30;.909;3574000;0
35534;200333;194;0;0;0;0;.00nan;0;0
35534;210504;193;0;0;0;0;.00nan;0;0
35534;189529;193;54;23;3;20;.870;3900000;0
35534;196352;194;59;28;3;25;.893;3900000;0
35892;-1;192;82;31;2;29;.935;3600000;0
35892;207398;192;0;0;0;0;.00nan;0;0
35892;191118;196;63;27;3;24;.889;3550000;0
35892;202830;196;0;0;0;0;.00nan;0;0
35694;200444;224;70;15;1;14;.933;3600000;0
35694;206800;225;76;48;4;44;.917;3600000;0
35694;-1;225;0;0;0;0;.00nan;0;0
35694;208372;224;0;0;0;0;.00nan;0;0
35753;192915;179;0;0;0;0;.00nan;0;0
35753;187355;179;63;40;4;36;.900;3557000;0
35753;197672;210;50;18;3;15;.833;3600000;0
35753;-1;210;0;0;0;0;.00nan;0;0
35739;184874;212;0;0;0;0;.00nan;0;0
35739;191063;211;0;0;0;0;.00nan;0;0
35739;-1;212;53;20;2;18;.900;3600000;0
35739;-1;211;65;31;3;28;.903;3571000;0
35782;182467;185;90;35;2;33;.943;3600000;0
35782;209840;184;0;0;0;0;.00nan;0;0
35782;205837;184;68;42;5;37;.881;3600000;0
35782;-1;185;0;0;0;0;.00nan;0;0
35765;205681;226;0;0;0;0;.00nan;0;0
35765;-1;226;71;22;2;20;.909;3600000;0
35765;-1;199;86;51;3;48;.941;3581000;0
35765;-1;199;0;0;0;0;.00nan;0;0
35809;192862;187;51;31;5;26;.839;3600000;0
35809;198149;188;0;0;0;0;.00nan;0;0
35809;184409;188;50;39;6;33;.846;3549000;0
35809;-1;187;0;0;0;0;.00nan;0;0
35679;183695;232;56;16;2;14;.875;3550000;0
35679;210998;229;87;32;1;31;.969;3600000;0
35679;185960;229;0;0;0;0;.00nan;0;0
35679;-1;232;0;0;0;0;.00nan;0;0
35754;189902;204;88;37;2;35;.946;3600000;0
35754;201524;205;0;0;0;0;.00nan;0;0
35754;-1;205;18;27;7;20;.741;3600000;0
35754;203120;204;0;0;0;0;.00nan;0;0
35755;200306;182;0;0;0;0;.00nan;0;0
35755;185810;182;65;32;3;29;.906;3900000;0
35755;-1;1371;81;39;3;36;.923;3900000;0
35755;-1;1371;0;0;0;0;.00nan;0;0
35890;196283;206;0;0;0;0;.00nan;0;0
35890;-1;199;0;0;0;0;.00nan;0;0
35890;-1;199;38;25;5;20;.800;3600000;0
35890;202998;206;76;26;2;24;.923;3600000;0
35850;198149;188;63;48;6;42;.875;3312000;0
35850;184409;188;55;5;0;5;1.000;288000;0
35850;-1;189;65;22;2;20;.909;3600000;0
35850;-1;189;0;0;0;0;.00nan;0;0
35636;192939;208;0;0;0;0;.00nan;0;0
35636;201560;202;54;28;3;25;.893;3558000;0
35636;212028;202;0;0;0;0;.00nan;0;0
35636;-1;208;67;25;2;23;.920;3600000;0
35631;192915;179;83;25;1;24;.960;3600000;0
35631;187355;179;0;0;0;0;.00nan;0;0
35631;213399;216;0;0;0;0;.00nan;0;0
35631;-1;216;64;32;3;29;.906;3519000;0
35868;-1;220;0;0;0;0;.00nan;0;0
35868;-1;220;100;42;2;40;.952;3700000;0
35868;-1;1371;0;0;0;0;.00nan;0;0
35868;-1;1371;53;24;3;21;.875;3700000;0
35611;195164;218;52;36;5;31;.861;3571000;0
35611;191130;186;0;0;0;0;.00nan;0;0
35611;208051;218;0;0;0;0;.00nan;0;0
35611;213507;186;58;28;3;25;.893;3600000;0
35585;184788;198;41;38;5;33;.868;3545000;0
35585;212143;198;0;0;0;0;.00nan;0;0
35585;192547;190;66;40;4;36;.900;3600000;0
35585;-1;190;0;0;0;0;.00nan;0;0
36130;192862;187;0;0;0;0;.00nan;0;0
36130;201585;197;70;33;3;30;.909;3513000;0
36130;206822;197;0;0;0;0;.00nan;0;0
36130;-1;187;58;9;1;8;.889;3600000;0
35576;211942;183;56;36;5;31;.861;3559000;0
35576;196237;183;0;0;0;0;.00nan;0;0
35576;196571;177;68;35;4;31;.886;3600000;0
35576;-1;177;0;0;0;0;.00nan;0;0
35763;-1;219;78;21;1;20;.952;3600000;0
35763;-1;219;0;0;0;0;.00nan;0;0
35763;191063;211;63;35;4;31;.886;3600000;0
35763;-1;211;0;0;0;0;.00nan;0;0
35683;190164;4959;0;0;0;0;.00nan;0;0
35683;-1;209;55;25;4;21;.840;3536000;0
35683;-1;4959;78;31;2;29;.935;3600000;0
35683;213590;209;0;0;0;0;.00nan;0;0
35925;-1;192;100;41;1;40;.976;3600000;0
35925;207061;195;49;24;3;21;.875;3518000;0
35925;196465;195;0;0;0;0;.00nan;0;0
35925;207398;192;0;0;0;0;.00nan;0;0
35970;209840;184;62;22;2;20;.909;3574000;0
35970;205837;184;0;0;0;0;.00nan;0;0
35970;-1;220;84;23;1;22;.957;3600000;0
35970;-1;220;0;0;0;0;.00nan;0;0
36083;180377;228;94;43;2;41;.953;3600000;0
36083;191120;223;0;0;0;0;.00nan;0;0
36083;187118;223;68;34;3;31;.912;3588000;0
36083;208044;228;0;0;0;0;.00nan;0;0
35743;183695;232;68;37;4;33;.892;3600000;0
35743;206800;225;0;0;0;0;.00nan;0;0
35743;-1;225;90;28;1;27;.964;3600000;0
35743;-1;232;0;0;0;0;.00nan;0;0
35897;205788;207;57;32;4;28;.875;3556000;0
35897;-1;199;69;30;2;28;.933;3600000;0
35897;197853;207;0;0;0;0;.00nan;0;0
35897;-1;199;0;0;0;0;.00nan;0;0
35756;192915;179;0;0;0;0;.00nan;0;0
35756;211942;183;59;23;3;20;.870;3600000;0
35756;196237;183;0;0;0;0;.00nan;0;0
35756;187355;179;74;39;4;35;.897;3600000;0
35770;-1;219;0;0;0;0;.00nan;0;0
35770;-1;219;78;26;1;25;.962;3600000;0
35770;191130;186;0;0;0;0;.00nan;0;0
35770;213507;186;54;33;4;29;.879;3600000;0
35735;195251;4949;0;0;0;0;.00nan;0;0
35735;197672;210;0;0;0;0;.00nan;0;0
35735;-1;4949;78;24;1;23;.958;3600000;0
35735;-1;210;62;28;3;25;.893;3533000;0
35550;200333;194;88;37;2;35;.946;3600000;0
35550;210504;193;82;17;0;17;1.000;3600000;0
35550;189529;193;0;0;0;0;.00nan;0;0
35550;196352;194;0;0;0;0;.00nan;0;0
35635;192862;187;0;0;0;0;.00nan;0;0
35635;184788;198;72;18;1;17;.944;3600000;0
35635;212143;198;0;0;0;0;.00nan;0;0
35635;-1;187;61;44;6;38;.864;3600000;0
35720;207061;195;0;0;0;0;.00nan;0;0
35720;196465;195;99;34;1;33;.971;3600000;0
35720;192547;190;78;38;3;35;.921;3528000;0
35720;-1;190;0;0;0;0;.00nan;0;0
35752;201560;202;0;0;0;0;.00nan;0;0
35752;212028;202;94;20;0;20;1.000;3600000;0
35752;196283;206;0;0;0;0;.00nan;0;0
35752;202998;206;98;47;2;45;.957;3572000;0
36049;210134;1505;0;0;0;0;.00nan;0;0
36049;196571;177;73;34;2;32;.941;3600000;0
36049;-1;1505;73;19;1;18;.947;3600000;0
36049;-1;177;0;0;0;0;.00nan;0;0
35808;201524;205;0;0;0;0;.00nan;0;0
35808;201525;203;55;29;3;26;.897;3558000;0
35808;206772;203;0;0;0;0;.00nan;0;0
35808;-1;205;70;23;1;22;.957;3600000;0
35737;200452;221;58;31;4;27;.871;3554000;0
35737;180377;228;87;37;2;35;.946;3600000;0
35737;208044;228;0;0;0;0;.00nan;0;0
35737;-1;221;0;0;0;0;.00nan;0;0
36045;209915;231;0;0;0;0;.00nan;0;0
36045;189773;231;62;18;2;16;.889;3600000;0
36045;191120;223;0;0;0;0;.00nan;0;0
36045;187118;223;85;46;3;43;.935;3600000;0
35572;194893;191;64;14;1;13;.929;3600000;0
35572;201892;191;0;0;0;0;.00nan;0;0
35572;-1;189;98;46;3;43;.935;3515000;0
35572;-1;189;0;0;0;0;.00nan;0;0
35661;190164;4959;73;47;4;43;.915;3600000;0
35661;-1;4959;0;0;0;0;.00nan;0;0
35661;-1;2620;0;0;0;0;.00nan;0;0
35661;213550;2620;83;29;1;28;.966;3600000;0
35794;211942;183;0;0;0;0;.00nan;0;0
35794;196237;183;75;31;3;28;.903;3600000;0
35794;197672;210;90;21;0;21;1.000;3600000;0
35794;-1;210;0;0;0;0;.00nan;0;0
35700;201514;227;45;30;4;26;.867;3600000;0
35700;206800;225;49;38;5;33;.868;3593000;0
35700;-1;225;0;0;0;0;.00nan;0;0
35700;213280;227;0;0;0;0;.00nan;0;0
35573;198149;188;0;0;0;0;.00nan;0;0
35573;194893;191;54;14;2;12;.857;3600000;0
35573;184409;188;86;45;3;42;.933;3589000;0
35573;201892;191;0;0;0;0;.00nan;0;0
35667;210504;193;66;20;1;19;.950;3600000;0
35667;189529;193;0;0;0;0;.00nan;0;0
35667;-1;192;69;38;4;34;.895;3600000;0
35667;207398;192;0;0;0;0;.00nan;0;0
35592;184788;198;0;0;0;0;.00nan;0;0
35592;212143;198;85;36;2;34;.944;3600000;0
35592;-1;189;0;0;0;0;.00nan;0;0
35592;-1;189;50;18;3;15;.833;3563000;0
35696;183695;232;0;0;0;0;.00nan;0;0
35696;200452;221;0;0;0;0;.00nan;0;0
35696;-1;221;95;33;1;32;.970;3600000;0
35696;-1;232;49;27;4;23;.852;3600000;0
35540;195251;4949;53;25;3;22;.880;3600000;0
35540;-1;178;33;27;5;22;.815;2509000;0
35540;-1;4949;0;0;0;0;.00nan;0;0
35540;-1;178;34;16;4;12;.750;1091000;0
35633;187689;230;69;16;1;15;.938;3600000;0
35633;183678;230;0;0;0;0;.00nan;0;0
35633;200444;224;0;0;0;0;.00nan;0;0
35633;208372;224;71;27;2;25;.926;3600000;0
35680;188977;215;0;0;0;0;.00nan;0;0
35680;210794;215;78;22;1;21;.955;3600000;0
35680;191063;211;56;4;0;4;1.000;582000;0
35680;-1;211;28;26;6;20;.769;3018000;0
35640;206801;176;64;29;4;25;.862;3900000;0
35640;186332;4864;0;0;0;0;.00nan;0;0
35640;202801;4864;66;40;4;36;.900;3900000;0
35640;203099;176;0;0;0;0;.00nan;0;0
35787;191130;186;68;36;3;33;.917;3900000;0
35787;-1;180;84;34;3;31;.912;3900000;0
35787;213507;186;0;0;0;0;.00nan;0;0
35787;208383;180;0;0;0;0;.00nan;0;0
35930;182467;185;54;17;2;15;.882;3600000;0
35930;-1;185;0;0;0;0;.00nan;0;0
35930;191518;214;88;46;3;43;.935;3600000;0
35930;202914;214;0;0;0;0;.00nan;0;0
35712;192929;222;0;0;0;0;.00nan;0;0
35712;209915;231;0;0;0;0;.00nan;0;0
35712;189773;231;64;18;1;17;.944;3600000;0
35712;213560;222;86;59;4;55;.932;3600000;0
35805;209840;184;65;24;2;22;.917;3600000;0
35805;205837;184;0;0;0;0;.00nan;0;0
35805;190038;181;53;21;3;18;.857;3600000;0
35805;192552;181;0;0;0;0;.00nan;0;0
35688;192939;208;46;43;6;37;.860;3282000;0
35688;205681;226;0;0;0;0;.00nan;0;0
35688;-1;226;44;20;4;16;.800;3600000;0
35688;-1;208;61;8;0;8;1.000;310000;0
35706;194219;4960;75;31;2;29;.935;3584000;0
35706;210998;229;0;0;0;0;.00nan;0;0
35706;206971;4960;0;0;0;0;.00nan;0;0
35706;185960;229;88;24;1;23;.958;3600000;0
36150;205769;200;0;0;0;0;.00nan;0;0
36150;195238;200;40;29;5;24;.828;3538000;0
36150;-1;199;0;0;0;0;.00nan;0;0
36150;-1;199;86;42;3;39;.929;3600000;0
35824;195164;218;79;35;2;33;.943;3600000;0
35824;184874;212;0;0;0;0;.00nan;0;0
35824;-1;212;64;33;3;30;.909;3592000;0
35824;208051;218;0;0;0;0;.00nan;0;0
35804;201524;205;85;27;2;25;.926;3600000;0
35804;196283;206;0;0;0;0;.00nan;0;0
35804;-1;205;0;0;0;0;.00nan;0;0
35804;202998;206;65;40;4;36;.900;3544000;0
35738;200306;182;0;0;0;0;.00nan;0;0
35738;-1;220;0;0;0;0;.00nan;0;0
35738;-1;220;92;40;3;37;.925;3658000;0
35738;185810;182;73;25;2;23;.920;3658000;0
35629;192915;179;81;41;3;38;.927;3593000;0
35629;210134;1505;0;0;0;0;.00nan;0;0
35629;187355;179;0;0;0;0;.00nan;0;0
35629;-1;1505;74;18;1;17;.944;3600000;0
35554;201495;213;34;20;4;16;.800;867000;0
35554;-1;178;0;0;0;0;.00nan;0;0
35554;-1;213;34;24;5;19;.792;2733000;0
35554;-1;178;77;34;3;31;.912;3600000;0
35736;191118;196;61;38;5;33;.868;3600000;0
35736;192547;190;7;15;6;9;.600;2055000;0
35736;-1;190;57;6;0;6;1.000;1502000;0
35736;202830;196;0;0;0;0;.00nan;0;0
35830;194219;4960;0;0;0;0;.00nan;0;0
35830;210998;229;72;45;4;41;.911;3900000;0
35830;206971;4960;55;27;4;23;.852;3900000;0
35830;185960;229;0;0;0;0;.00nan;0;0
35785;-1;220;75;37;3;34;.919;3515000;0
35785;-1;220;0;0;0;0;.00nan;0;0
35785;-1;1371;88;31;1;30;.968;3600000;0
35785;-1;1371;0;0;0;0;.00nan;0;0
35607;188977;215;51;29;5;24;.828;3600000;0
35607;210794;215;0;0;0;0;.00nan;0;0
35607;190034;217;54;29;4;25;.862;3600000;0
35607;190041;217;0;0;0;0;.00nan;0;0
35682;206801;176;0;0;0;0;.00nan;0;0
35682;186332;4864;57;24;3;21;.875;3600000;0
35682;202801;4864;0;0;0;0;.00nan;0;0
35682;203099;176;57;31;4;27;.871;3584000;0
35695;192939;208;0;0;0;0;.00nan;0;0
35695;201560;202;0;0;0;0;.00nan;0;0
35695;212028;202;97;59;3;56;.949;3549000;0
35695;-1;208;71;28;2;26;.929;3600000;0
35848;184874;212;0;0;0;0;.00nan;0;0
35848;-1;212;85;32;1;31;.969;3600000;0
35848;-1;180;53;25;4;21;.840;3600000;0
35848;208383;180;0;0;0;0;.00nan;0;0
35699;200333;194;97;68;2;66;.971;3600000;0
35699;194893;191;53;18;3;15;.833;3557000;0
35699;201892;191;0;0;0;0;.00nan;0;0
35699;196352;194;0;0;0;0;.00nan;0;0
35681;198149;188;0;0;0;0;.00nan;0;0
35681;210504;193;61;16;2;14;.875;3600000;0
35681;189529;193;0;0;0;0;.00nan;0;0
35681;184409;188;83;53;5;48;.906;3600000;0
35974;191518;214;66;48;5;43;.896;3600000;0
35974;202914;214;0;0;0;0;.00nan;0;0
35974;-1;1371;0;0;0;0;.00nan;0;0
35974;-1;1371;82;35;2;33;.943;3600000;0
35973;210134;1505;69;32;3;29;.906;3585000;0
35973;211942;183;56;16;2;14;.875;3600000;0
35973;196237;183;0;0;0;0;.00nan;0;0
35973;-1;1505;0;0;0;0;.00nan;0;0
35952;201585;197;0;0;0;0;.00nan;0;0
35952;206822;197;77;44;3;41;.932;3900000;0
35952;207061;195;49;19;3;16;.842;3900000;0
35952;196465;195;0;0;0;0;.00nan;0;0
35896;183695;232;65;47;5;42;.894;3600000;0
35896;209915;231;0;0;0;0;.00nan;0;0
35896;189773;231;87;31;2;29;.935;3600000;0
35896;-1;232;0;0;0;0;.00nan;0;0
35777;201514;227;0;0;0;0;.00nan;0;0
35777;180377;228;22;4;3;1;.250;381000;0
35777;213280;227;83;24;1;23;.958;3600000;0
35777;208044;228;55;30;3;27;.900;3219000;0
35920;200452;221;53;31;4;27;.871;3600000;0
35920;191120;223;0;0;0;0;.00nan;0;0
35920;187118;223;95;24;0;24;1.000;3600000;0
35920;-1;221;0;0;0;0;.00nan;0;0
35860;192862;187;0;0;0;0;.00nan;0;0
35860;-1;189;95;31;1;30;.968;3649000;0
35860;-1;187;82;33;2;31;.939;3649000;0
35860;-1;189;0;0;0;0;.00nan;0;0
35800;192915;179;61;24;3;21;.875;3522000;0
35800;201495;213;85;26;1;25;.962;3600000;0
35800;187355;179;0;0;0;0;.00nan;0;0
35800;-1;213;0;0;0;0;.00nan;0;0
35775;205681;226;0;0;0;0;.00nan;0;0
35775;-1;226;61;13;1;12;.923;3600000;0
35775;-1;199;83;55;5;50;.909;3600000;0
35775;-1;199;0;0;0;0;.00nan;0;0
35746;187689;230;0;0;0;0;.00nan;0;0
35746;183678;230;74;22;1;21;.955;3600000;0
35746;200444;224;0;0;0;0;.00nan;0;0
35746;208372;224;64;38;5;33;.868;3600000;0
35885;200437;201;45;25;3;22;.880;3752000;0
35885;205788;207;0;0;0;0;.00nan;0;0
35885;208048;201;0;0;0;0;.00nan;0;0
35885;197853;207;84;39;2;37;.949;3752000;0
35784;-1;192;67;15;1;14;.933;869000;0
35784;207398;192;57;43;6;37;.860;2731000;0
35784;192547;190;78;25;1;24;.960;3600000;0
35784;-1;190;0;0;0;0;.00nan;0;0
35728;190164;4959;0;0;0;0;.00nan;0;0
35728;-1;4959;70;28;2;26;.929;3900000;0
35728;-1;2620;0;0;0;0;.00nan;0;0
35728;213550;2620;97;44;2;42;.955;3900000;0
35764;200306;182;0;0;0;0;.00nan;0;0
35764;190038;181;0;0;0;0;.00nan;0;0
35764;185810;182;20;31;7;24;.774;3600000;0
35764;192552;181;91;32;1;31;.969;3600000;0
35855;201525;203;83;39;2;37;.949;3578000;0
35855;201560;202;70;23;1;22;.957;3600000;0
35855;212028;202;0;0;0;0;.00nan;0;0
35855;206772;203;0;0;0;0;.00nan;0;0
35825;213399;216;0;0;0;0;.00nan;0;0
35825;197672;210;67;25;2;23;.920;3600000;0
35825;-1;210;0;0;0;0;.00nan;0;0
35825;-1;216;71;41;4;37;.902;3579000;0
35716;195164;218;56;18;2;16;.889;3548000;0
35716;191063;211;94;35;1;34;.971;3600000;0
35716;208051;218;0;0;0;0;.00nan;0;0
35716;-1;211;0;0;0;0;.00nan;0;0
35714;192929;222;35;18;4;14;.778;3600000;0
35714;206800;225;79;31;1;30;.968;2523000;0
35714;-1;225;30;14;4;10;.714;1058000;0
35714;213560;222;0;0;0;0;.00nan;0;0
35966;205769;200;78;31;2;29;.935;3900000;0
35966;195238;200;0;0;0;0;.00nan;0;0
35966;196283;206;0;0;0;0;.00nan;0;0
35966;202998;206;77;37;2;35;.946;3900000;0
35844;200333;194;45;13;2;11;.846;1503000;0
35844;196352;194;36;33;6;27;.818;2097000;0
35844;191118;196;62;28;3;25;.893;3600000;0
35844;202830;196;0;0;0;0;.00nan;0;0
35757;190034;217;61;30;4;26;.867;3600000;0
35757;190041;217;0;0;0;0;.00nan;0;0
35757;191063;211;0;0;0;0;.00nan;0;0
35757;-1;211;100;28;0;28;1.000;3600000;0
35653;195164;218;96;22;0;22;1.000;3600000;0
35653;-1;219;74;30;2;28;.933;3600000;0
35653;-1;219;0;0;0;0;.00nan;0;0
35653;208051;218;0;0;0;0;.00nan;0;0
35601;196571;177;0;0;0;0;.00nan;0;0
35601;-1;178;0;0;0;0;.00nan;0;0
35601;-1;178;57;40;5;35;.875;3600000;0
35601;-1;177;67;21;2;19;.905;3600000;0
36051;201514;227;56;21;2;19;.905;3516000;0
36051;191120;223;0;0;0;0;.00nan;0;0
36051;187118;223;100;30;0;30;1.000;3600000;0
36051;213280;227;0;0;0;0;.00nan;0;0
35810;201524;205;0;0;0;0;.00nan;0;0
35810;-1;199;0;0;0;0;.00nan;0;0
35810;-1;199;100;36;0;36;1.000;3600000;0
35810;-1;205;65;30;3;27;.900;3600000;0
35823;-1;209;89;24;1;23;.958;3600000;0
35823;-1;2620;81;40;3;37;.925;3584000;0
35823;213550;2620;0;0;0;0;.00nan;0;0
35823;213590;209;0;0;0;0;.00nan;0;0
35655;192862;187;88;27;1;26;.963;3600000;0
35655;184788;198;0;0;0;0;.00nan;0;0
35655;212143;198;35;28;5;23;.821;3600000;0
35655;-1;187;0;0;0;0;.00nan;0;0
35704;188977;215;0;0;0;0;.00nan;0;0
35704;210794;215;57;43;6;37;.860;3569000;0
35704;191130;186;71;26;2;24;.923;3411000;0
35704;213507;186;29;7;3;4;.571;189000;0
35691;206801;176;53;21;3;18;.857;3900000;0
35691;186332;4864;75;36;3;33;.917;3900000;0
35691;202801;4864;0;0;0;0;.00nan;0;0
35691;203099;176;0;0;0;0;.00nan;0;0
35862;182467;185;60;18;2;16;.889;3600000;0
35862;190038;181;98;55;3;52;.945;3553000;0
35862;-1;185;0;0;0;0;.00nan;0;0
35862;192552;181;0;0;0;0;.00nan;0;0
35698;192939;208;0;0;0;0;.00nan;0;0
35698;205769;200;0;0;0;0;.00nan;0;0
35698;195238;200;85;39;3;36;.923;3706000;0
35698;-1;208;78;30;2;28;.933;3706000;0
35786;209840;184;0;0;0;0;.00nan;0;0
35786;205837;184;75;25;2;23;.920;3600000;0
35786;-1;220;0;0;0;0;.00nan;0;0
35786;-1;220;57;29;3;26;.897;3563000;0
35909;198149;188;71;37;3;34;.919;3595000;0
35909;184409;188;0;0;0;0;.00nan;0;0
35909;-1;192;71;27;2;25;.926;3600000;0
35909;207398;192;0;0;0;0;.00nan;0;0
35905;205681;226;0;0;0;0;.00nan;0;0
35905;201525;203;0;0;0;0;.00nan;0;0
35905;206772;203;82;44;4;40;.909;3900000;0
35905;-1;226;64;29;4;25;.862;3900000;0
35907;200437;201;0;0;0;0;.00nan;0;0
35907;205788;207;55;20;2;18;.900;3555000;0
35907;208048;201;82;29;1;28;.966;3600000;0
35907;197853;207;0;0;0;0;.00nan;0;0
35776;187689;230;64;25;2;23;.920;3600000;0
35776;183678;230;0;0;0;0;.00nan;0;0
35776;180377;228;75;46;4;42;.913;3565000;0
35776;208044;228;0;0;0;0;.00nan;0;0
35851;194219;4960;38;28;5;23;.821;3600000;0
35851;200444;224;100;29;0;29;1.000;3600000;0
35851;206971;4960;0;0;0;0;.00nan;0;0
35851;208372;224;0;0;0;0;.00nan;0;0
35984;182467;185;69;35;4;31;.886;3829000;0
35984;-1;185;0;0;0;0;.00nan;0;0
35984;191518;214;65;42;5;37;.881;3837000;0
35984;202914;214;0;0;0;0;.00nan;0;0
35703;190164;4959;0;0;0;0;.00nan;0;0
35703;-1;209;0;0;0;0;.00nan;0;0
35703;-1;4959;48;12;2;10;.833;3600000;0
35703;213590;209;49;27;4;23;.852;3600000;0
35866;201495;213;0;0;0;0;.00nan;0;0
35866;213399;216;0;0;0;0;.00nan;0;0
35866;-1;213;58;24;3;21;.875;3600000;0
35866;-1;216;87;34;1;33;.971;3600000;0
35815;190034;217;0;0;0;0;.00nan;0;0
35815;190041;217;90;42;2;40;.952;3600000;0
35815;-1;180;52;18;3;15;.833;3556000;0
35815;208383;180;0;0;0;0;.00nan;0;0
35913;184874;212;0;0;0;0;.00nan;0;0
35913;-1;219;0;0;0;0;.00nan;0;0
35913;-1;219;74;42;4;38;.905;3555000;0
35913;-1;212;45;17;3;14;.824;3600000;0
35768;192929;222;0;0;0;0;.00nan;0;0
35768;210998;229;0;0;0;0;.00nan;0;0
35768;185960;229;57;34;4;30;.882;3541000;0
35768;213560;222;81;31;2;29;.935;3600000;0
35713;195251;4949;0;0;0;0;.00nan;0;0
35713;196571;177;60;25;3;22;.880;3560000;0
35713;-1;4949;91;35;2;33;.943;3600000;0
35713;-1;177;0;0;0;0;.00nan;0;0
35789;209840;184;93;42;2;40;.952;3571000;0
35789;200306;182;0;0;0;0;.00nan;0;0
35789;205837;184;0;0;0;0;.00nan;0;0
35789;185810;182;97;26;0;26;1.000;3600000;0
35994;205769;200;97;48;2;46;.958;3900000;0
35994;195238;200;0;0;0;0;.00nan;0;0
35994;189902;204;96;39;2;37;.949;3900000;0
35994;203120;204;0;0;0;0;.00nan;0;0
35980;187689;230;0;0;0;0;.00nan;0;0
35980;183678;230;66;20;1;19;.950;3600000;0
35980;206800;225;0;0;0;0;.00nan;0;0
35980;-1;225;98;48;2;46;.958;3598000;0
35807;209840;184;0;0;0;0;.00nan;0;0
35807;205837;184;91;35;1;34;.971;3600000;0
35807;-1;1371;54;24;4;20;.833;3600000;0
35807;-1;1371;0;0;0;0;.00nan;0;0
35792;200444;224;0;0;0;0;.00nan;0;0
35792;180377;228;98;36;1;35;.972;3573000;0
35792;208044;228;0;0;0;0;.00nan;0;0
35792;208372;224;100;27;0;27;1.000;3600000;0
35811;184874;212;0;0;0;0;.00nan;0;0
35811;191063;211;0;0;0;0;.00nan;0;0
35811;-1;212;63;29;3;26;.897;3600000;0
35811;-1;211;74;45;4;41;.911;3546000;0
36022;205769;200;0;0;0;0;.00nan;0;0
36022;205788;207;0;0;0;0;.00nan;0;0
36022;195238;200;52;26;3;23;.885;3562000;0
36022;197853;207;81;33;2;31;.939;3600000;0
35744;192915;179;70;29;2;27;.931;3900000;0
35744;195251;4949;86;33;2;31;.939;3900000;0
35744;187355;179;0;0;0;0;.00nan;0;0
35744;-1;4949;0;0;0;0;.00nan;0;0
35858;211942;183;49;22;3;19;.864;3600000;0
35858;196237;183;0;0;0;0;.00nan;0;0
35858;197672;210;52;30;4;26;.867;3600000;0
35858;-1;210;0;0;0;0;.00nan;0;0
35846;191118;196;51;38;6;32;.842;2581000;0
35846;192547;190;76;23;1;22;.957;3600000;0
35846;-1;190;0;0;0;0;.00nan;0;0
35846;202830;196;64;11;0;11;1.000;1019000;0
35882;192862;187;0;0;0;0;.00nan;0;0
35882;198149;188;0;0;0;0;.00nan;0;0
35882;184409;188;92;42;1;41;.976;3657000;0
35882;-1;187;99;22;0;22;1.000;3657000;0
35884;184788;198;55;30;4;26;.867;3600000;0
35884;201585;197;50;1;0;1;1.000;168000;0
35884;206822;197;29;31;6;25;.806;3347000;0
35884;212143;198;0;0;0;0;.00nan;0;0
36163;192929;222;98;45;1;44;.978;3556000;0
36163;194219;4960;98;25;0;25;1.000;3600000;0
36163;206971;4960;0;0;0;0;.00nan;0;0
36163;213560;222;0;0;0;0;.00nan;0;0
35914;201524;205;0;0;0;0;.00nan;0;0
35914;201525;203;100;38;0;38;1.000;3600000;0
35914;206772;203;0;0;0;0;.00nan;0;0
35914;-1;205;74;24;2;22;.917;3540000;0
35727;210504;193;87;32;1;31;.969;3600000;0
35727;189529;193;0;0;0;0;.00nan;0;0
35727;-1;192;34;29;6;23;.793;3600000;0
35727;207398;192;0;0;0;0;.00nan;0;0
35910;195164;218;62;31;4;27;.871;3562000;0
35910;-1;180;64;25;3;22;.880;3600000;0
35910;208051;218;0;0;0;0;.00nan;0;0
35910;208383;180;0;0;0;0;.00nan;0;0
36204;201495;213;65;33;4;29;.879;3600000;0
36204;213399;216;0;0;0;0;.00nan;0;0
36204;-1;213;0;0;0;0;.00nan;0;0
36204;-1;216;56;21;3;18;.857;3600000;0
35748;206801;176;55;26;3;23;.885;3545000;0
35748;-1;209;100;45;2;43;.956;3600000;0
35748;203099;176;0;0;0;0;.00nan;0;0
35748;213590;209;0;0;0;0;.00nan;0;0
35834;201560;202;74;20;1;19;.950;3600000;0
35834;212028;202;0;0;0;0;.00nan;0;0
35834;-1;199;92;59;4;55;.932;3600000;0
35834;-1;199;0;0;0;0;.00nan;0;0
36122;182467;185;95;35;2;33;.943;3600000;0
36122;190038;181;0;0;0;0;.00nan;0;0
36122;-1;185;0;0;0;0;.00nan;0;0
36122;192552;181;67;35;4;31;.886;3578000;0
35837;190034;217;75;30;2;28;.933;3600000;0
35837;190041;217;0;0;0;0;.00nan;0;0
35837;-1;219;52;32;4;28;.875;3516000;0
35837;-1;219;0;0;0;0;.00nan;0;0
35689;184788;198;0;0;0;0;.00nan;0;0
35689;212143;198;59;44;5;39;.886;3600000;0
35689;207061;195;85;20;0;20;1.000;3600000;0
35689;196465;195;0;0;0;0;.00nan;0;0
35833;-1;192;0;0;0;0;.00nan;0;0
35833;207398;192;70;45;5;40;.889;3578000;0
35833;192547;190;0;0;0;0;.00nan;0;0
35833;-1;190;50;29;4;25;.862;3600000;0
35982;190038;181;78;36;3;33;.917;3892000;0
35982;191518;214;58;28;3;25;.893;3900000;0
35982;192552;181;0;0;0;0;.00nan;0;0
35982;202914;214;0;0;0;0;.00nan;0;0
35831;189902;204;71;31;2;29;.935;3593000;0
35831;201524;205;86;28;1;27;.964;3600000;0
35831;-1;205;0;0;0;0;.00nan;0;0
35831;203120;204;0;0;0;0;.00nan;0;0
35707;192939;208;59;28;3;25;.893;3600000;0
35707;201525;203;97;74;4;70;.946;3547000;0
35707;206772;203;0;0;0;0;.00nan;0;0
35707;-1;208;0;0;0;0;.00nan;0;0
35832;190034;217;0;0;0;0;.00nan;0;0
35832;190041;217;50;20;3;17;.850;3600000;0
35832;191063;211;28;24;6;18;.750;2335000;0
35832;-1;211;61;15;2;13;.867;1265000;0
35847;210134;1505;0;0;0;0;.00nan;0;0
35847;195251;4949;0;0;0;0;.00nan;0;0
35847;-1;1505;72;33;3;30;.909;3596000;0
35847;-1;4949;78;31;2;29;.935;3600000;0
35861;191130;186;88;34;2;32;.941;3600000;0
35861;-1;180;0;0;0;0;.00nan;0;0
35861;213507;186;0;0;0;0;.00nan;0;0
35861;208383;180;79;38;3;35;.921;3589000;0
35668;196571;177;54;23;3;20;.870;3600000;0
35668;-1;178;0;0;0;0;.00nan;0;0
35668;-1;178;64;42;5;37;.881;3600000;0
35668;-1;177;0;0;0;0;.00nan;0;0
35854;205681;226;0;0;0;0;.00nan;0;0
35854;196283;206;0;0;0;0;.00nan;0;0
35854;-1;226;61;24;2;22;.917;3600000;0
35854;202998;206;59;30;3;27;.900;3600000;0
36201;182467;185;98;41;2;39;.951;3900000;0
36201;-1;220;0;0;0;0;.00nan;0;0
36201;-1;220;81;37;2;35;.946;3900000;0
36201;-1;185;0;0;0;0;.00nan;0;0
35857;211942;183;0;0;0;0;.00nan;0;0
35857;196237;183;51;24;3;21;.875;3600000;0
35857;197672;210;0;0;0;0;.00nan;0;0
35857;-1;210;54;31;4;27;.871;3600000;0
36032;192929;222;49;1;0;1;1.000;348000;0
36032;191120;223;0;0;0;0;.00nan;0;0
36032;187118;223;84;24;1;23;.958;3600000;0
36032;213560;222;51;51;6;45;.882;3252000;0
35729;210504;193;0;0;0;0;.00nan;0;0
35729;189529;193;53;18;2;16;.889;3688000;0
35729;201585;197;93;55;3;52;.945;3688000;0
35729;206822;197;0;0;0;0;.00nan;0;0
35817;187689;230;48;24;4;20;.833;3359000;0
35817;183678;230;47;1;0;1;1.000;541000;0
35817;183695;232;23;3;3;0;.000;355000;0
35817;-1;232;94;36;1;35;.972;3545000;0
35976;200306;182;0;0;0;0;.00nan;0;0
35976;185810;182;52;33;5;28;.848;3517000;0
35976;-1;1371;0;0;0;0;.00nan;0;0
35976;-1;1371;85;39;3;36;.923;3600000;0
35745;200333;194;61;47;6;41;.872;2454000;0
35745;194893;191;65;15;1;14;.933;3600000;0
35745;201892;191;0;0;0;0;.00nan;0;0
35745;196352;194;20;16;5;11;.688;1146000;0
35769;188977;215;0;0;0;0;.00nan;0;0
35769;210794;215;81;27;3;24;.889;3900000;0
35769;-1;219;0;0;0;0;.00nan;0;0
35769;-1;219;93;49;3;46;.939;3900000;0
35926;198149;188;0;0;0;0;.00nan;0;0
35926;184409;188;88;49;2;47;.959;3551000;0
35926;191118;196;0;0;0;0;.00nan;0;0
35926;202830;196;83;15;0;15;1.000;3600000;0
35967;200452;221;52;31;4;27;.871;3513000;0
35967;201514;227;0;0;0;0;.00nan;0;0
35967;213280;227;64;26;2;24;.923;3600000;0
35967;-1;221;0;0;0;0;.00nan;0;0
35818;210998;229;0;0;0;0;.00nan;0;0
35818;180377;228;45;26;5;21;.808;3600000;0
35818;185960;229;88;28;1;27;.964;3600000;0
35818;208044;228;0;0;0;0;.00nan;0;0
35912;200437;201;71;26;2;24;.923;3600000;0
35912;208048;201;0;0;0;0;.00nan;0;0
35912;-1;199;0;0;0;0;.00nan;0;0
35912;-1;199;83;38;3;35;.921;3569000;0
35751;190164;4959;47;32;4;28;.875;3600000;0
35751;186332;4864;77;28;1;27;.964;3600000;0
35751;202801;4864;0;0;0;0;.00nan;0;0
35751;-1;4959;0;0;0;0;.00nan;0;0
35941;209915;231;0;0;0;0;.00nan;0;0
35941;200444;224;57;32;4;28;.875;3585000;0
35941;189773;231;76;26;2;24;.923;3600000;0
35941;208372;224;0;0;0;0;.00nan;0;0
35852;210134;1505;70;34;3;31;.912;3600000;0
35852;213399;216;0;0;0;0;.00nan;0;0
35852;-1;1505;0;0;0;0;.00nan;0;0
35852;-1;216;98;38;2;36;.947;3600000;0
35773;194893;191;95;38;1;37;.974;3600000;0
35773;201892;191;0;0;0;0;.00nan;0;0
35773;207061;195;0;0;0;0;.00nan;0;0
35773;196465;195;72;31;3;28;.903;3559000;0
36004;205788;207;94;32;1;31;.969;3600000;0
36004;189902;204;69;31;2;29;.935;3571000;0
36004;197853;207;0;0;0;0;.00nan;0;0
36004;203120;204;0;0;0;0;.00nan;0;0
35801;192915;179;89;45;3;42;.933;3803000;0
35801;187355;179;0;0;0;0;.00nan;0;0
35801;-1;178;54;31;4;27;.871;3803000;0
35801;-1;178;0;0;0;0;.00nan;0;0
35802;209915;231;0;0;0;0;.00nan;0;0
35802;189773;231;52;17;2;15;.882;3600000;0
35802;206800;225;93;66;4;62;.939;3527000;0
35802;-1;225;0;0;0;0;.00nan;0;0
35732;186332;4864;0;0;0;0;.00nan;0;0
35732;202801;4864;95;34;1;33;.971;3600000;0
35732;-1;2620;0;0;0;0;.00nan;0;0
35732;213550;2620;54;29;4;25;.862;3600000;0
35918;194219;4960;89;33;2;31;.939;3560000;0
35918;183695;232;95;25;0;25;1.000;3600000;0
35918;206971;4960;0;0;0;0;.00nan;0;0
35918;-1;232;0;0;0;0;.00nan;0;0
35875;209840;184;58;38;5;33;.868;3600000;0
35875;205837;184;0;0;0;0;.00nan;0;0
35875;-1;220;76;30;2;28;.933;3600000;0
35875;-1;220;0;0;0;0;.00nan;0;0
35898;190164;4959;0;0;0;0;.00nan;0;0
35898;206801;176;71;25;2;23;.920;3900000;0
35898;-1;4959;82;37;2;35;.946;3900000;0
35898;203099;176;0;0;0;0;.00nan;0;0
35717;188977;215;82;40;3;37;.925;3541000;0
35717;210794;215;0;0;0;0;.00nan;0;0
35717;184874;212;70;18;1;17;.944;3600000;0
35717;-1;212;0;0;0;0;.00nan;0;0
35915;195164;218;74;28;2;26;.929;3600000;0
35915;191130;186;0;0;0;0;.00nan;0;0
35915;208051;218;0;0;0;0;.00nan;0;0
35915;213507;186;43;29;4;25;.862;3600000;0
36155;200452;221;0;0;0;0;.00nan;0;0
36155;201514;227;48;28;4;24;.857;3900000;0
36155;213280;227;0;0;0;0;.00nan;0;0
36155;-1;221;38;23;4;19;.826;3900000;0
36160;210998;229;91;41;2;39;.951;3600000;0
36160;185960;229;0;0;0;0;.00nan;0;0
36160;191120;223;0;0;0;0;.00nan;0;0
36160;187118;223;59;29;3;26;.897;3554000;0
35741;192939;208;0;0;0;0;.00nan;0;0
35741;196283;206;88;58;3;55;.948;3585000;0
35741;-1;208;78;28;2;26;.929;3600000;0
35741;202998;206;0;0;0;0;.00nan;0;0
35758;210504;193;97;41;0;41;1.000;3900000;0
35758;194893;191;100;26;0;26;1.000;3900000;0
35758;189529;193;0;0;0;0;.00nan;0;0
35758;201892;191;0;0;0;0;.00nan;0;0
36174;200452;221;65;39;5;34;.872;3600000;0
36174;191120;223;0;0;0;0;.00nan;0;0
36174;187118;223;88;38;2;36;.947;3600000;0
36174;-1;221;0;0;0;0;.00nan;0;0
36129;-1;192;62;29;3;26;.897;3600000;0
36129;207061;195;46;28;4;24;.857;3551000;0
36129;196465;195;0;0;0;0;.00nan;0;0
36129;207398;192;0;0;0;0;.00nan;0;0
36151;205769;200;0;0;0;0;.00nan;0;0
36151;205788;207;0;0;0;0;.00nan;0;0
36151;195238;200;100;26;0;26;1.000;3600000;0
36151;197853;207;87;42;3;39;.929;3600000;0
35749;192939;208;0;0;0;0;.00nan;0;0
35749;200437;201;0;0;0;0;.00nan;0;0
35749;208048;201;29;31;6;25;.806;3578000;0
35749;-1;208;66;29;3;26;.897;3600000;0
35715;192862;187;0;0;0;0;.00nan;0;0
35715;184788;198;0;0;0;0;.00nan;0;0
35715;212143;198;61;30;3;27;.900;3600000;0
35715;-1;187;44;38;6;32;.842;3600000;0
36087;-1;178;0;0;0;0;.00nan;0;0
36087;197672;210;83;26;2;24;.923;3600000;0
36087;-1;178;54;36;4;32;.889;3539000;0
36087;-1;210;0;0;0;0;.00nan;0;0
36068;-1;220;0;0;0;0;.00nan;0;0
36068;-1;220;88;31;2;29;.935;3600000;0
36068;191518;214;51;33;5;28;.848;3600000;0
36068;202914;214;0;0;0;0;.00nan;0;0
35803;190164;4959;0;0;0;0;.00nan;0;0
35803;186332;4864;62;27;2;25;.926;3900000;0
35803;202801;4864;0;0;0;0;.00nan;0;0
35803;-1;4959;63;27;2;25;.926;3900000;0
36099;191118;196;64;15;1;14;.933;1778000;0
36099;-1;189;84;26;1;25;.962;3600000;0
36099;202830;196;38;30;5;25;.833;1822000;0
36099;-1;189;0;0;0;0;.00nan;0;0
35835;192929;222;0;0;0;0;.00nan;0;0
35835;209915;231;0;0;0;0;.00nan;0;0
35835;189773;231;77;24;1;23;.958;3600000;0
35835;213560;222;98;45;2;43;.956;3600000;0
35900;-1;2620;0;0;0;0;.00nan;0;0
35900;203099;176;0;0;0;0;.00nan;0;0
35900;213533;176;29;37;7;30;.811;3600000;0
35900;213550;2620;75;21;1;20;.952;3600000;0
35856;201495;213;63;31;4;27;.871;2082000;0
35856;196571;177;43;26;4;22;.846;3900000;0
35856;-1;213;69;14;0;14;1.000;1818000;0
35856;-1;177;0;0;0;0;.00nan;0;0
35968;198149;188;0;0;0;0;.00nan;0;0
35968;184409;188;80;46;4;42;.913;3900000;0
35968;192547;190;32;7;3;4;.571;565000;0
35968;-1;190;89;31;1;30;.968;3335000;0
35965;209840;184;0;0;0;0;.00nan;0;0
35965;200306;182;0;0;0;0;.00nan;0;0
35965;205837;184;86;41;3;38;.927;3582000;0
35965;185810;182;70;26;2;24;.923;3600000;0
35871;188977;215;0;0;0;0;.00nan;0;0
35871;210794;215;54;41;5;36;.878;3600000;0
35871;195164;218;0;0;0;0;.00nan;0;0
35871;208051;218;81;35;2;33;.943;3600000;0
35999;201560;202;100;26;0;26;1.000;3600000;0
35999;212028;202;0;0;0;0;.00nan;0;0
35999;-1;199;0;0;0;0;.00nan;0;0
35999;-1;199;87;42;3;39;.929;3600000;0
35986;187689;230;75;19;1;18;.947;3600000;0
35986;183678;230;0;0;0;0;.00nan;0;0
35986;194219;4960;20;13;4;9;.692;1199000;0
35986;206971;4960;60;30;3;27;.900;2401000;0
35877;200333;194;95;34;1;33;.971;3600000;0
35877;201585;197;0;0;0;0;.00nan;0;0
35877;206822;197;67;29;3;26;.897;3518000;0
35877;196352;194;0;0;0;0;.00nan;0;0
35821;183695;232;77;35;3;32;.914;3600000;0
35821;206800;225;0;0;0;0;.00nan;0;0
35821;-1;225;55;32;4;28;.875;3561000;0
35821;-1;232;0;0;0;0;.00nan;0;0
35880;190034;217;81;34;3;31;.912;3600000;0
35880;190041;217;0;0;0;0;.00nan;0;0
35880;-1;180;31;32;6;26;.813;3600000;0
35880;208383;180;0;0;0;0;.00nan;0;0
35889;192915;179;0;0;0;0;.00nan;0;0
35889;187355;179;75;30;2;28;.933;3600000;0
35889;213399;216;0;0;0;0;.00nan;0;0
35889;-1;216;73;38;4;34;.895;3600000;0
35873;201524;205;0;0;0;0;.00nan;0;0
35873;196283;206;0;0;0;0;.00nan;0;0
35873;-1;205;83;35;3;32;.914;3600000;0
35873;202998;206;45;35;5;30;.857;3582000;0
35951;189902;204;45;31;5;26;.839;3564000;0
35951;201525;203;67;30;3;27;.900;3600000;0
35951;206772;203;0;0;0;0;.00nan;0;0
35951;203120;204;0;0;0;0;.00nan;0;0
35946;190038;181;0;0;0;0;.00nan;0;0
35946;192552;181;68;30;3;27;.900;3535000;0
35946;-1;1371;82;30;1;29;.967;3600000;0
35946;-1;1371;0;0;0;0;.00nan;0;0
35820;-1;219;21;27;6;21;.778;3590000;0
35820;-1;219;0;0;0;0;.00nan;0;0
35820;191130;186;0;0;0;0;.00nan;0;0
35820;213507;186;58;29;4;25;.862;3600000;0
35934;210134;1505;0;0;0;0;.00nan;0;0
35934;195251;4949;64;17;1;16;.941;1897000;0
35934;-1;1505;67;18;1;17;.944;3600000;0
35934;-1;4949;43;28;5;23;.821;1703000;0
35828;201514;227;0;0;0;0;.00nan;0;0
35828;180377;228;79;39;3;36;.923;3600000;0
35828;213280;227;95;24;0;24;1.000;3600000;0
35828;208044;228;0;0;0;0;.00nan;0;0
35939;210998;229;0;0;0;0;.00nan;0;0
35939;206800;225;25;21;5;16;.762;1762000;0
35939;-1;225;68;19;1;18;.947;1838000;0
35939;185960;229;58;22;2;20;.909;3600000;0
36062;205769;200;0;0;0;0;.00nan;0;0
36062;195238;200;93;20;0;20;1.000;3600000;0
36062;201560;202;79;22;1;21;.955;3600000;0
36062;212028;202;0;0;0;0;.00nan;0;0
35903;194893;191;81;26;1;25;.962;3600000;0
35903;-1;192;0;0;0;0;.00nan;0;0
35903;201892;191;0;0;0;0;.00nan;0;0
35903;207398;192;78;29;2;27;.931;3593000;0
35829;186332;4864;0;0;0;0;.00nan;0;0
35829;202801;4864;71;40;4;36;.900;3851000;0
35829;203099;176;0;0;0;0;.00nan;0;0
35829;213533;176;49;33;5;28;.848;3851000;0
35813;201495;213;56;29;3;26;.897;2165000;0
35813;196571;177;0;0;0;0;.00nan;0;0
35813;-1;213;13;17;6;11;.647;1435000;0
35813;-1;177;100;25;0;25;1.000;3600000;0
35864;195251;4949;99;36;2;34;.944;3600000;0
35864;213399;216;59;29;3;26;.897;3570000;0
35864;-1;4949;0;0;0;0;.00nan;0;0
35864;-1;216;0;0;0;0;.00nan;0;0
35990;205681;226;65;17;1;16;.941;3600000;0
35990;-1;226;0;0;0;0;.00nan;0;0
35990;-1;199;14;17;6;11;.647;1717000;0
35990;-1;199;48;29;4;25;.862;1883000;0
35908;190164;4959;97;38;2;36;.947;3900000;0
35908;-1;4959;0;0;0;0;.00nan;0;0
35908;-1;2620;63;22;2;20;.909;3900000;0
35908;213550;2620;0;0;0;0;.00nan;0;0
36015;182467;185;62;48;6;42;.875;3133000;0
36015;200306;182;0;0;0;0;.00nan;0;0
36015;185810;182;77;22;1;21;.955;3600000;0
36015;-1;185;62;8;0;8;1.000;467000;0
35981;183695;232;0;0;0;0;.00nan;0;0
35981;191120;223;0;0;0;0;.00nan;0;0
35981;187118;223;63;34;4;30;.882;3600000;0
35981;-1;232;100;41;1;40;.976;3600000;0
36094;195164;218;69;24;2;22;.917;3600000;0
36094;-1;219;96;53;3;50;.943;3555000;0
36094;-1;219;0;0;0;0;.00nan;0;0
36094;208051;218;0;0;0;0;.00nan;0;0
35733;192915;179;58;36;5;31;.861;3567000;0
35733;187355;179;0;0;0;0;.00nan;0;0
35733;-1;178;0;0;0;0;.00nan;0;0
35733;-1;178;67;32;4;28;.875;3600000;0
36050;191518;214;93;41;2;39;.951;3600000;0
36050;202914;214;0;0;0;0;.00nan;0;0
36050;-1;1371;63;16;1;15;.938;3600000;0
36050;-1;1371;0;0;0;0;.00nan;0;0
35734;192862;187;79;32;3;29;.906;3556000;0
35734;210504;193;58;18;2;16;.889;3600000;0
35734;189529;193;0;0;0;0;.00nan;0;0
35734;-1;187;0;0;0;0;.00nan;0;0
35916;189902;204;96;39;1;38;.974;3600000;0
35916;201525;203;0;0;0;0;.00nan;0;0
35916;206772;203;76;42;3;39;.929;3514000;0
35916;203120;204;0;0;0;0;.00nan;0;0
35921;201585;197;70;31;2;29;.935;3600000;0
35921;206822;197;0;0;0;0;.00nan;0;0
35921;192547;190;100;23;0;23;1.000;3600000;0
35921;-1;190;0;0;0;0;.00nan;0;0
35936;184788;198;64;32;3;29;.906;3600000;0
35936;212143;198;0;0;0;0;.00nan;0;0
35936;-1;189;0;0;0;0;.00nan;0;0
35936;-1;189;33;32;6;26;.813;3600000;0
36037;187689;230;0;0;0;0;.00nan;0;0
36037;183678;230;95;13;0;13;1.000;3600000;0
36037;210998;229;74;53;5;48;.906;3600000;0
36037;185960;229;0;0;0;0;.00nan;0;0
35771;192939;208;0;0;0;0;.00nan;0;0
35771;196283;206;59;12;1;11;.917;1170000;0
35771;-1;208;80;34;2;32;.941;3600000;0
35771;202998;206;11;25;7;18;.720;2430000;0
35964;200444;224;57;24;3;21;.875;3600000;0
35964;201514;227;57;36;4;32;.889;3597000;0
35964;213280;227;0;0;0;0;.00nan;0;0
35964;208372;224;0;0;0;0;.00nan;0;0
35865;191063;211;0;0;0;0;.00nan;0;0
35865;191130;186;96;23;0;23;1.000;3600000;0
35865;-1;211;68;36;4;32;.889;3600000;0
35865;213507;186;0;0;0;0;.00nan;0;0
35917;200437;201;69;25;3;22;.880;3570000;0
35917;205788;207;82;33;2;31;.939;3600000;0
35917;208048;201;0;0;0;0;.00nan;0;0
35917;197853;207;0;0;0;0;.00nan;0;0
35840;192929;222;55;30;4;26;.867;3600000;0
35840;180377;228;98;20;0;20;1.000;3600000;0
35840;208044;228;0;0;0;0;.00nan;0;0
35840;213560;222;0;0;0;0;.00nan;0;0
35870;188977;215;0;0;0;0;.00nan;0;0
35870;210794;215;81;25;1;24;.960;3600000;0
35870;-1;180;50;24;4;20;.833;3600000;0
35870;208383;180;0;0;0;0;.00nan;0;0
35924;184788;198;0;0;0;0;.00nan;0;0
35924;212143;198;61;32;3;29;.906;3545000;0
35924;207061;195;92;34;2;32;.941;3600000;0
35924;196465;195;0;0;0;0;.00nan;0;0
35983;192862;187;0;0;0;0;.00nan;0;0
35983;200333;194;36;39;7;32;.821;3600000;0
35983;196352;194;0;0;0;0;.00nan;0;0
35983;-1;187;51;16;2;14;.875;3600000;0
35922;-1;209;69;42;5;37;.881;3570000;0
35922;203099;176;0;0;0;0;.00nan;0;0
35922;213533;176;49;22;3;19;.864;3600000;0
35922;213590;209;0;0;0;0;.00nan;0;0
35988;184874;212;59;5;0;5;1.000;1106000;0
35988;-1;212;31;33;6;27;.818;2494000;0
35988;-1;180;73;30;2;28;.933;3600000;0
35988;208383;180;0;0;0;0;.00nan;0;0
36119;-1;220;0;0;0;0;.00nan;0;0
36119;-1;220;68;20;1;19;.950;3600000;0
36119;191518;214;0;0;0;0;.00nan;0;0
36119;202914;214;49;29;4;25;.862;3600000;0
36040;209840;184;0;0;0;0;.00nan;0;0
36040;200306;182;73;25;1;24;.960;3572000;0
36040;205837;184;92;23;0;23;1.000;3600000;0
36040;185810;182;0;0;0;0;.00nan;0;0
35841;210134;1505;0;0;0;0;.00nan;0;0
35841;-1;178;50;39;6;33;.846;3009000;0
35841;-1;1505;47;10;2;8;.800;3600000;0
35841;-1;178;55;4;0;4;1.000;591000;0
35906;192929;222;40;23;4;19;.826;2768000;0
35906;194219;4960;70;23;2;21;.913;3600000;0
35906;206971;4960;0;0;0;0;.00nan;0;0
35906;213560;222;28;15;4;11;.733;832000;0
36133;211942;183;69;21;1;20;.952;3600000;0
36133;196237;183;0;0;0;0;.00nan;0;0
36133;213399;216;0;0;0;0;.00nan;0;0
36133;-1;216;54;39;5;34;.872;3600000;0
35783;188977;215;50;34;5;29;.853;3566000;0
35783;210794;215;0;0;0;0;.00nan;0;0
35783;191130;186;54;19;3;16;.842;3600000;0
35783;213507;186;0;0;0;0;.00nan;0;0
35891;201524;205;0;0;0;0;.00nan;0;0
35891;196283;206;0;0;0;0;.00nan;0;0
35891;-1;205;53;30;4;26;.867;3548000;0
35891;202998;206;63;30;3;27;.900;3600000;0
35750;195251;4949;78;29;2;27;.931;3591000;0
35750;196571;177;0;0;0;0;.00nan;0;0
35750;-1;4949;0;0;0;0;.00nan;0;0
35750;-1;177;83;30;1;29;.967;3600000;0
35902;190164;4959;0;0;0;0;.00nan;0;0
35902;-1;209;0;0;0;0;.00nan;0;0
35902;-1;4959;92;20;0;20;1.000;3600000;0
35902;213590;209;88;34;1;33;.971;3600000;0
35779;210504;193;61;39;4;35;.897;3577000;0
35779;189529;193;0;0;0;0;.00nan;0;0
35779;207061;195;0;0;0;0;.00nan;0;0
35779;196465;195;75;28;2;26;.929;3600000;0
35971;200437;201;0;0;0;0;.00nan;0;0
35971;201525;203;74;35;4;31;.886;3900000;0
35971;206772;203;0;0;0;0;.00nan;0;0
35971;208048;201;54;35;4;31;.886;3900000;0
35780;192939;208;0;0;0;0;.00nan;0;0
35780;205681;226;0;0;0;0;.00nan;0;0
35780;-1;226;86;30;2;28;.933;3900000;0
35780;-1;208;88;36;2;34;.944;3900000;0
35932;189902;204;79;33;2;31;.939;3777000;0
35932;-1;199;0;0;0;0;.00nan;0;0
35932;-1;199;99;41;1;40;.976;3777000;0
35932;203120;204;0;0;0;0;.00nan;0;0
36077;187689;230;80;19;1;18;.947;3600000;0
36077;183678;230;0;0;0;0;.00nan;0;0
36077;194219;4960;0;0;0;0;.00nan;0;0
36077;206971;4960;79;41;3;38;.927;3521000;0
36063;182467;185;87;33;2;31;.939;3600000;0
36063;-1;185;0;0;0;0;.00nan;0;0
36063;-1;1371;99;38;1;37;.974;3600000;0
36063;-1;1371;0;0;0;0;.00nan;0;0
36066;195164;218;100;36;0;36;1.000;3600000;0
36066;190034;217;98;37;1;36;.973;3546000;0
36066;190041;217;0;0;0;0;.00nan;0;0
36066;208051;218;0;0;0;0;.00nan;0;0
35997;209840;184;72;29;2;27;.931;3760000;0
35997;205837;184;0;0;0;0;.00nan;0;0
35997;190038;181;0;0;0;0;.00nan;0;0
35997;192552;181;92;31;1;30;.968;3760000;0
35886;210998;229;0;0;0;0;.00nan;0;0
35886;206800;225;0;0;0;0;.00nan;0;0
35886;-1;225;89;43;1;42;.977;3900000;0
35886;185960;229;84;25;1;24;.960;3900000;0
36005;-1;189;43;4;1;3;.750;473000;0
36005;192547;190;61;28;3;25;.893;3600000;0
36005;-1;190;0;0;0;0;.00nan;0;0
36005;-1;189;42;37;6;31;.838;3127000;0
35867;192915;179;68;44;4;40;.909;3529000;0
35867;187355;179;0;0;0;0;.00nan;0;0
35867;197672;210;98;41;2;39;.951;3600000;0
35867;-1;210;0;0;0;0;.00nan;0;0
35878;209915;231;0;0;0;0;.00nan;0;0
35878;189773;231;51;15;2;13;.867;3600000;0
35878;180377;228;98;55;3;52;.945;3573000;0
35878;208044;228;0;0;0;0;.00nan;0;0
35943;194893;191;48;18;2;16;.889;3900000;0
35943;201585;197;100;38;2;36;.947;3900000;0
35943;206822;197;0;0;0;0;.00nan;0;0
35943;201892;191;0;0;0;0;.00nan;0;0
35895;211942;183;0;0;0;0;.00nan;0;0
35895;196237;183;66;24;2;22;.917;3900000;0
35895;213399;216;100;41;2;39;.951;3900000;0
35895;-1;216;0;0;0;0;.00nan;0;0
35836;186332;4864;84;30;2;28;.933;3600000;0
35836;202801;4864;0;0;0;0;.00nan;0;0
35836;-1;2620;0;0;0;0;.00nan;0;0
35836;213550;2620;67;32;4;28;.875;3524000;0
36206;190034;217;61;9;0;9;1.000;907000;0
36206;190041;217;11;23;7;16;.696;2693000;0
36206;-1;219;100;31;0;31;1.000;3600000;0
36206;-1;219;0;0;0;0;.00nan;0;0
36026;189902;204;59;39;5;34;.872;3600000;0
36026;201560;202;63;26;2;24;.923;3600000;0
36026;212028;202;0;0;0;0;.00nan;0;0
36026;203120;204;0;0;0;0;.00nan;0;0
35827;192939;208;96;36;1;35;.972;3576000;0
35827;201524;205;0;0;0;0;.00nan;0;0
35827;-1;208;0;0;0;0;.00nan;0;0
35827;-1;205;100;19;0;19;1.000;3600000;0
36006;190038;181;54;49;7;42;.857;3600000;0
36006;192552;181;0;0;0;0;.00nan;0;0
36006;-1;1371;0;0;0;0;.00nan;0;0
36006;-1;1371;63;31;4;27;.871;3600000;0
35853;186332;4864;0;0;0;0;.00nan;0;0
35853;202801;4864;81;29;2;27;.931;3600000;0
35853;-1;2620;67;28;3;25;.893;3556000;0
35853;213550;2620;0;0;0;0;.00nan;0;0
35816;182467;185;53;27;4;23;.852;3900000;0
35816;200306;182;0;0;0;0;.00nan;0;0
35816;185810;182;63;32;4;28;.875;3900000;0
35816;-1;185;0;0;0;0;.00nan;0;0
36126;198149;188;0;0;0;0;.00nan;0;0
36126;184409;188;94;46;3;43;.935;3743000;0
36126;192547;190;0;0;0;0;.00nan;0;0
36126;-1;190;71;31;2;29;.935;3743000;0
35949;206800;225;90;33;1;32;.970;3600000;0
35949;-1;225;0;0;0;0;.00nan;0;0
35949;191120;223;0;0;0;0;.00nan;0;0
35949;187118;223;97;36;2;34;.944;3600000;0
35958;205788;207;72;30;2;28;.933;3554000;0
35958;196283;206;0;0;0;0;.00nan;0;0
35958;197853;207;0;0;0;0;.00nan;0;0
35958;202998;206;81;25;1;24;.960;3600000;0
35923;192929;222;0;0;0;0;.00nan;0;0
35923;201514;227;0;0;0;0;.00nan;0;0
35923;213280;227;59;23;2;21;.913;3563000;0
35923;213560;222;100;34;0;34;1.000;3600000;0
35992;200444;224;60;21;2;19;.905;1446000;0
35992;200452;221;51;18;3;15;.833;3600000;0
35992;208372;224;45;36;6;30;.833;2154000;0
35992;-1;221;0;0;0;0;.00nan;0;0
35998;191063;211;0;0;0;0;.00nan;0;0
35998;-1;180;36;25;5;20;.800;3600000;0
35998;-1;211;87;35;2;33;.943;3600000;0
35998;208383;180;0;0;0;0;.00nan;0;0
35822;194893;191;89;29;1;28;.966;3600000;0
35822;201892;191;0;0;0;0;.00nan;0;0
35822;191118;196;85;50;5;45;.900;3600000;0
35822;202830;196;0;0;0;0;.00nan;0;0
35894;188977;215;62;7;0;7;1.000;855000;0
35894;210794;215;38;37;6;31;.838;2745000;0
35894;184874;212;0;0;0;0;.00nan;0;0
35894;-1;212;57;26;3;23;.885;3600000;0
36018;183695;232;99;48;3;45;.938;3600000;0
36018;209915;231;0;0;0;0;.00nan;0;0
36018;189773;231;57;29;4;25;.862;3548000;0
36018;-1;232;0;0;0;0;.00nan;0;0
35881;201495;213;63;34;4;30;.882;3600000;0
35881;-1;213;0;0;0;0;.00nan;0;0
35881;197672;210;42;16;3;13;.813;3600000;0
35881;-1;210;0;0;0;0;.00nan;0;0
35929;210504;193;34;18;4;14;.778;3600000;0
35929;189529;193;0;0;0;0;.00nan;0;0
35929;201585;197;30;9;3;6;.667;485000;0
35929;206822;197;86;38;2;36;.947;3088000;0
36012;183695;232;0;0;0;0;.00nan;0;0
36012;191120;223;0;0;0;0;.00nan;0;0
36012;187118;223;86;29;2;27;.931;3600000;0
36012;-1;232;76;33;3;30;.909;3589000;0
35937;201524;205;0;0;0;0;.00nan;0;0
35937;-1;199;0;0;0;0;.00nan;0;0
35937;-1;199;96;41;2;39;.951;3600000;0
35937;-1;205;47;21;3;18;.857;3567000;0
35948;-1;209;73;40;4;36;.900;3599000;0
35948;203099;176;0;0;0;0;.00nan;0;0
35948;213533;176;62;19;2;17;.895;3600000;0
35948;213590;209;0;0;0;0;.00nan;0;0
36082;195164;218;80;23;1;22;.957;3600000;0
36082;191063;211;0;0;0;0;.00nan;0;0
36082;208051;218;0;0;0;0;.00nan;0;0
36082;-1;211;66;45;5;40;.889;3600000;0
36123;205769;200;0;0;0;0;.00nan;0;0
36123;195238;200;60;30;4;26;.867;3600000;0
36123;201560;202;0;0;0;0;.00nan;0;0
36123;212028;202;84;25;1;24;.960;3600000;0
35950;210134;1505;69;27;2;25;.926;3600000;0
35950;195251;4949;60;29;4;25;.862;3522000;0
35950;-1;1505;0;0;0;0;.00nan;0;0
35950;-1;4949;0;0;0;0;.00nan;0;0
35911;200333;194;0;0;0;0;.00nan;0;0
35911;207061;195;99;23;0;23;1.000;3600000;0
35911;196352;194;94;56;3;53;.946;3600000;0
35911;196465;195;0;0;0;0;.00nan;0;0
35863;196571;177;63;33;4;29;.879;3600000;0
35863;-1;178;0;0;0;0;.00nan;0;0
35863;-1;178;58;42;6;36;.857;3537000;0
35863;-1;177;0;0;0;0;.00nan;0;0
35975;184874;212;72;30;3;27;.900;3546000;0
35975;191130;186;0;0;0;0;.00nan;0;0
35975;-1;212;0;0;0;0;.00nan;0;0
35975;213507;186;79;33;2;31;.939;3600000;0
36013;210134;1505;0;0;0;0;.00nan;0;0
36013;-1;1505;56;29;4;25;.862;3554000;0
36013;197672;210;87;37;2;35;.946;3600000;0
36013;-1;210;0;0;0;0;.00nan;0;0
36128;210504;193;59;21;2;19;.905;3600000;0
36128;189529;193;0;0;0;0;.00nan;0;0
36128;-1;189;66;47;5;42;.894;3600000;0
36128;-1;189;0;0;0;0;.00nan;0;0
36020;184788;198;86;30;1;29;.967;3600000;0
36020;212143;198;0;0;0;0;.00nan;0;0
36020;191118;196;44;25;4;21;.840;3600000;0
36020;202830;196;0;0;0;0;.00nan;0;0
36030;190038;181;0;0;0;0;.00nan;0;0
36030;191518;214;90;18;0;18;1.000;3600000;0
36030;192552;181;65;32;4;28;.875;3600000;0
36030;202914;214;0;0;0;0;.00nan;0;0
35919;200437;201;98;54;3;51;.944;3570000;0
35919;205681;226;0;0;0;0;.00nan;0;0
35919;208048;201;0;0;0;0;.00nan;0;0
35919;-1;226;63;13;1;12;.923;3600000;0
35928;192915;179;0;0;0;0;.00nan;0;0
35928;201495;213;0;0;0;0;.00nan;0;0
35928;187355;179;72;18;1;17;.944;3600000;0
35928;-1;213;97;44;2;42;.955;3600000;0
36007;192862;187;69;18;1;17;.944;3600000;0
36007;200333;194;43;51;9;42;.824;3600000;0
36007;196352;194;0;0;0;0;.00nan;0;0
36007;-1;187;0;0;0;0;.00nan;0;0
36114;187689;230;73;30;2;28;.933;3600000;0
36114;183678;230;0;0;0;0;.00nan;0;0
36114;209915;231;41;39;6;33;.846;3600000;0
36114;189773;231;0;0;0;0;.00nan;0;0
35945;-1;2620;0;0;0;0;.00nan;0;0
35945;203099;176;0;0;0;0;.00nan;0;0
35945;213533;176;93;35;1;34;.971;3600000;0
35945;213550;2620;72;36;3;33;.917;3600000;0
36048;184874;212;0;0;0;0;.00nan;0;0
36048;-1;212;100;24;0;24;1.000;3600000;0
36048;-1;180;42;34;5;29;.853;3600000;0
36048;208383;180;0;0;0;0;.00nan;0;0
36019;198149;188;0;0;0;0;.00nan;0;0
36019;184409;188;84;26;1;25;.962;3600000;0
36019;201585;197;0;0;0;0;.00nan;0;0
36019;206822;197;80;33;2;31;.939;3565000;0
36172;195164;218;66;17;1;16;.941;3600000;0
36172;191063;211;62;10;0;10;1.000;436000;0
36172;208051;218;0;0;0;0;.00nan;0;0
36172;-1;211;56;43;5;38;.884;3164000;0
36180;183695;232;62;41;4;37;.902;3600000;0
36180;209915;231;0;0;0;0;.00nan;0;0
36180;189773;231;73;22;1;21;.955;3600000;0
36180;-1;232;0;0;0;0;.00nan;0;0
35933;200444;224;76;39;2;37;.949;3900000;0
35933;180377;228;90;38;2;36;.947;3900000;0
35933;208044;228;0;0;0;0;.00nan;0;0
35933;208372;224;0;0;0;0;.00nan;0;0
36076;201495;213;99;48;3;45;.938;3600000;0
36076;-1;178;0;0;0;0;.00nan;0;0
36076;-1;213;0;0;0;0;.00nan;0;0
36076;-1;178;46;28;5;23;.821;3539000;0
36120;187689;230;0;0;0;0;.00nan;0;0
36120;183678;230;54;22;3;19;.864;3717000;0
36120;200452;221;72;39;4;35;.897;3683000;0
36120;-1;221;0;0;0;0;.00nan;0;0
35995;201525;203;66;34;3;31;.912;3572000;0
35995;206772;203;0;0;0;0;.00nan;0;0
35995;196283;206;0;0;0;0;.00nan;0;0
35995;202998;206;100;45;2;43;.956;3600000;0
36008;210998;229;0;0;0;0;.00nan;0;0
36008;206800;225;0;0;0;0;.00nan;0;0
36008;-1;225;100;31;0;31;1.000;3600000;0
36008;185960;229;84;33;2;31;.939;3518000;0
35959;189902;204;87;35;1;34;.971;3600000;0
35959;201524;205;49;18;2;16;.889;3600000;0
35959;-1;205;0;0;0;0;.00nan;0;0
35959;203120;204;0;0;0;0;.00nan;0;0
35931;188977;215;0;0;0;0;.00nan;0;0
35931;210794;215;100;30;0;30;1.000;3600000;0
35931;191063;211;81;25;1;24;.960;3587000;0
35931;-1;211;0;0;0;0;.00nan;0;0
35887;195251;4949;99;30;1;29;.967;3600000;0
35887;196571;177;0;0;0;0;.00nan;0;0
35887;-1;4949;0;0;0;0;.00nan;0;0
35887;-1;177;34;24;5;19;.792;3600000;0
35872;184874;212;0;0;0;0;.00nan;0;0
35872;-1;219;59;20;2;18;.900;3599000;0
35872;-1;219;0;0;0;0;.00nan;0;0
35872;-1;212;76;25;1;24;.960;3600000;0
36178;195164;218;85;48;4;44;.917;3600000;0
36178;190034;217;66;17;1;16;.941;3600000;0
36178;190041;217;0;0;0;0;.00nan;0;0
36178;208051;218;0;0;0;0;.00nan;0;0
35927;186332;4864;72;33;3;30;.909;3600000;0
35927;202801;4864;0;0;0;0;.00nan;0;0
35927;-1;2620;57;35;4;31;.886;3599000;0
35927;213550;2620;0;0;0;0;.00nan;0;0
35957;207061;195;66;22;2;20;.909;3600000;0
35957;196465;195;0;0;0;0;.00nan;0;0
35957;-1;189;41;2;1;1;.500;421000;0
35957;-1;189;42;38;6;32;.842;3179000;0
36003;189902;204;56;29;4;25;.862;3722000;0
36003;-1;199;0;0;0;0;.00nan;0;0
36003;-1;199;68;31;3;28;.903;3722000;0
36003;203120;204;0;0;0;0;.00nan;0;0
36046;209840;184;0;0;0;0;.00nan;0;0
36046;200306;182;0;0;0;0;.00nan;0;0
36046;205837;184;96;36;1;35;.972;3900000;0
36046;185810;182;91;32;1;31;.969;3900000;0
36042;194893;191;26;13;4;9;.692;3600000;0
36042;184788;198;87;33;2;31;.939;1665000;0
36042;212143;198;35;28;6;22;.786;1935000;0
36042;201892;191;0;0;0;0;.00nan;0;0
35972;200437;201;0;0;0;0;.00nan;0;0
35972;205681;226;0;0;0;0;.00nan;0;0
35972;208048;201;45;29;4;25;.862;3600000;0
35972;-1;226;63;15;1;14;.933;3600000;0
36096;191118;196;39;35;6;29;.829;3584000;0
36096;192547;190;56;20;3;17;.850;3600000;0
36096;-1;190;0;0;0;0;.00nan;0;0
36096;202830;196;0;0;0;0;.00nan;0;0
36057;205788;207;0;0;0;0;.00nan;0;0
36057;201525;203;0;0;0;0;.00nan;0;0
36057;206772;203;51;17;3;14;.824;3600000;0
36057;197853;207;34;35;6;29;.829;3600000;0
35991;192915;179;38;22;4;18;.818;1160000;0
35991;187355;179;58;34;4;30;.882;2440000;0
35991;213399;216;0;0;0;0;.00nan;0;0
35991;-1;216;84;23;1;22;.957;3600000;0
36108;191518;214;48;31;5;26;.839;3550000;0
36108;202914;214;0;0;0;0;.00nan;0;0
36108;-1;1371;0;0;0;0;.00nan;0;0
36108;-1;1371;62;25;3;22;.880;3600000;0
35961;192929;222;0;0;0;0;.00nan;0;0
35961;200444;224;0;0;0;0;.00nan;0;0
35961;213560;222;55;21;3;18;.857;3591000;0
35961;208372;224;86;41;2;39;.951;3600000;0
36029;191130;186;0;0;0;0;.00nan;0;0
36029;-1;180;0;0;0;0;.00nan;0;0
36029;213507;186;90;33;2;31;.939;3600000;0
36029;208383;180;54;20;3;17;.850;3542000;0
36031;190038;181;0;0;0;0;.00nan;0;0
36031;-1;220;0;0;0;0;.00nan;0;0
36031;-1;220;74;30;1;29;.967;3900000;0
36031;192552;181;100;42;1;41;.976;3900000;0
35944;200452;221;0;0;0;0;.00nan;0;0
35944;180377;228;54;24;3;21;.875;3194000;0
35944;208044;228;23;4;3;1;.250;406000;0
35944;-1;221;59;20;3;17;.850;3600000;0
36115;194219;4960;63;19;1;18;.947;3900000;0
36115;201514;227;81;32;2;30;.938;3900000;0
36115;206971;4960;0;0;0;0;.00nan;0;0
36115;213280;227;0;0;0;0;.00nan;0;0
36011;205769;200;0;0;0;0;.00nan;0;0
36011;195238;200;69;21;2;19;.905;3594000;0
36011;196283;206;99;32;1;31;.969;3600000;0
36011;202998;206;0;0;0;0;.00nan;0;0
36009;211942;183;84;17;0;17;1.000;3600000;0
36009;196237;183;0;0;0;0;.00nan;0;0
36009;-1;178;0;0;0;0;.00nan;0;0
36009;-1;178;83;43;3;40;.930;3600000;0
36033;201585;197;63;35;4;31;.886;3559000;0
36033;206822;197;0;0;0;0;.00nan;0;0
36033;-1;192;50;22;3;19;.864;3600000;0
36033;207398;192;0;0;0;0;.00nan;0;0
36144;194219;4960;0;0;0;0;.00nan;0;0
36144;183695;232;23;21;6;15;.714;2421000;0
36144;206971;4960;73;30;2;28;.933;3600000;0
36144;-1;232;76;18;0;18;1.000;1179000;0
36044;210134;1505;63;9;0;9;1.000;1640000;0
36044;213399;216;79;44;4;40;.909;3900000;0
36044;-1;1505;43;19;4;15;.789;2260000;0
36044;-1;216;0;0;0;0;.00nan;0;0
36074;209840;184;84;36;2;34;.944;3900000;0
36074;205837;184;0;0;0;0;.00nan;0;0
36074;190038;181;0;0;0;0;.00nan;0;0
36074;192552;181;73;25;2;23;.920;3900000;0
35899;188977;215;0;0;0;0;.00nan;0;0
35899;210794;215;64;31;3;28;.903;3564000;0
35899;-1;219;71;30;2;28;.933;3600000;0
35899;-1;219;0;0;0;0;.00nan;0;0
36058;200444;224;35;39;7;32;.821;3600000;0
36058;206800;225;0;0;0;0;.00nan;0;0
36058;-1;225;84;26;1;25;.962;3600000;0
36058;208372;224;0;0;0;0;.00nan;0;0
36021;205769;200;0;0;0;0;.00nan;0;0
36021;195238;200;56;20;3;17;.850;3565000;0
36021;-1;199;0;0;0;0;.00nan;0;0
36021;-1;199;100;35;2;33;.943;3600000;0
36041;190034;217;66;31;3;28;.903;3600000;0
36041;190041;217;0;0;0;0;.00nan;0;0
36041;191130;186;59;32;4;28;.875;3544000;0
36041;213507;186;0;0;0;0;.00nan;0;0
36055;190164;4959;0;0;0;0;.00nan;0;0
36055;-1;4959;82;28;2;26;.929;3600000;0
36055;-1;2620;0;0;0;0;.00nan;0;0
36055;213550;2620;84;38;4;34;.895;3573000;0
36047;195251;4949;49;27;4;23;.852;3572000;0
36047;197672;210;83;32;2;30;.938;3600000;0
36047;-1;4949;0;0;0;0;.00nan;0;0
36047;-1;210;0;0;0;0;.00nan;0;0
36002;194893;191;0;0;0;0;.00nan;0;0
36002;201892;191;75;24;1;23;.958;3600000;0
36002;-1;189;70;47;4;43;.915;3600000;0
36002;-1;189;0;0;0;0;.00nan;0;0
36054;201560;202;65;20;2;18;.900;3600000;0
36054;212028;202;0;0;0;0;.00nan;0;0
36054;196283;206;0;0;0;0;.00nan;0;0
36054;202998;206;64;51;6;45;.882;3600000;0
36078;200306;182;0;0;0;0;.00nan;0;0
36078;-1;220;39;35;6;29;.829;2698000;0
36078;-1;220;42;9;2;7;.778;902000;0
36078;185810;182;67;29;3;26;.897;3600000;0
35901;200333;194;59;32;3;29;.906;3528000;0
35901;210504;193;61;23;2;21;.913;3600000;0
35901;189529;193;0;0;0;0;.00nan;0;0
35901;196352;194;0;0;0;0;.00nan;0;0
36143;192862;187;33;30;6;24;.800;2906000;0
36143;-1;192;49;34;6;28;.824;3600000;0
36143;207398;192;0;0;0;0;.00nan;0;0
36143;-1;187;53;10;1;9;.900;639000;0
35938;192929;222;24;27;6;21;.778;3215000;0
35938;210998;229;0;0;0;0;.00nan;0;0
35938;185960;229;70;22;2;20;.909;3600000;0
35938;213560;222;49;2;0;2;1.000;385000;0
35960;201585;197;90;53;5;48;.906;3600000;0
35960;206822;197;0;0;0;0;.00nan;0;0
35960;207061;195;56;12;1;11;.917;3600000;0
35960;196465;195;0;0;0;0;.00nan;0;0
36017;183695;232;0;0;0;0;.00nan;0;0
36017;201514;227;0;0;0;0;.00nan;0;0
36017;213280;227;67;17;1;16;.941;3600000;0
36017;-1;232;61;29;3;26;.897;3570000;0
35954;187689;230;60;13;1;12;.923;3600000;0
35954;183678;230;0;0;0;0;.00nan;0;0
35954;180377;228;64;58;6;52;.897;2850000;0
35954;208044;228;57;9;0;9;1.000;750000;0
35979;200437;201;92;44;3;41;.932;3600000;0
35979;201525;203;55;29;4;25;.862;3580000;0
35979;206772;203;0;0;0;0;.00nan;0;0
35979;208048;201;0;0;0;0;.00nan;0;0
35942;186332;4864;75;26;1;25;.962;3731000;0
35942;-1;209;91;33;2;31;.939;3731000;0
35942;202801;4864;0;0;0;0;.00nan;0;0
35942;213590;209;0;0;0;0;.00nan;0;0
35947;211942;183;66;25;3;22;.880;3600000;0
35947;196237;183;0;0;0;0;.00nan;0;0
35947;196571;177;8;10;5;5;.500;1098000;0
35947;-1;177;80;21;0;21;1.000;2453000;0
36085;182467;185;0;0;0;0;.00nan;0;0
36085;-1;185;55;19;2;17;.895;3900000;0
36085;191518;214;89;42;2;40;.952;3900000;0
36085;202914;214;0;0;0;0;.00nan;0;0
36014;-1;178;0;0;0;0;.00nan;0;0
36014;213399;216;0;0;0;0;.00nan;0;0
36014;-1;178;70;23;1;22;.957;3600000;0
36014;-1;216;79;33;2;31;.939;3600000;0
36052;195251;4949;0;0;0;0;.00nan;0;0
36052;197672;210;0;0;0;0;.00nan;0;0
36052;-1;4949;73;37;4;33;.892;3900000;0
36052;-1;210;62;39;4;35;.897;3900000;0
36134;205788;207;0;0;0;0;.00nan;0;0
36134;201524;205;0;0;0;0;.00nan;0;0
36134;197853;207;93;23;0;23;1.000;3600000;0
36134;-1;205;34;28;5;23;.821;3600000;0
36103;-1;220;0;0;0;0;.00nan;0;0
36103;-1;220;89;29;1;28;.966;3600000;0
36103;-1;1371;69;41;4;37;.902;3600000;0
36103;-1;1371;0;0;0;0;.00nan;0;0
36117;210504;193;34;30;5;25;.833;3600000;0
36117;189529;193;0;0;0;0;.00nan;0;0
36117;-1;189;0;0;0;0;.00nan;0;0
36117;-1;189;74;30;2;28;.933;3600000;0
35956;200333;194;68;11;0;11;1.000;939000;0
35956;196352;194;30;27;6;21;.778;2661000;0
35956;192547;190;78;20;1;19;.950;3600000;0
35956;-1;190;0;0;0;0;.00nan;0;0
36112;195164;218;60;29;3;26;.897;3523000;0
36112;-1;219;0;0;0;0;.00nan;0;0
36112;-1;219;89;31;1;30;.968;3600000;0
36112;208051;218;0;0;0;0;.00nan;0;0
35969;186332;4864;0;0;0;0;.00nan;0;0
35969;-1;209;0;0;0;0;.00nan;0;0
35969;202801;4864;78;33;2;31;.939;3600000;0
35969;213590;209;49;35;5;30;.857;3600000;0
36071;191063;211;0;0;0;0;.00nan;0;0
36071;191130;186;0;0;0;0;.00nan;0;0
36071;-1;211;100;28;0;28;1.000;3600000;0
36071;213507;186;74;22;1;21;.955;3556000;0
35987;198149;188;0;0;0;0;.00nan;0;0
35987;184409;188;59;29;3;26;.897;3600000;0
35987;207061;195;66;24;2;22;.917;3600000;0
35987;196465;195;0;0;0;0;.00nan;0;0
36073;200437;201;0;0;0;0;.00nan;0;0
36073;205769;200;73;22;1;21;.955;3600000;0
36073;195238;200;0;0;0;0;.00nan;0;0
36073;208048;201;69;38;4;34;.895;3600000;0
36080;190034;217;0;0;0;0;.00nan;0;0
36080;190041;217;64;41;4;37;.902;3588000;0
36080;184874;212;0;0;0;0;.00nan;0;0
36080;-1;212;62;23;2;21;.913;3600000;0
36064;184788;198;72;24;1;23;.958;3600000;0
36064;212143;198;0;0;0;0;.00nan;0;0
36064;191118;196;39;24;5;19;.792;3600000;0
36064;202830;196;0;0;0;0;.00nan;0;0
35978;192929;222;0;0;0;0;.00nan;0;0
35978;210998;229;42;34;6;28;.824;3600000;0
35978;185960;229;0;0;0;0;.00nan;0;0
35978;213560;222;83;26;1;25;.962;3600000;0
35893;192939;208;0;0;0;0;.00nan;0;0
35893;205681;226;0;0;0;0;.00nan;0;0
35893;-1;226;77;25;1;24;.960;3600000;0
35893;-1;208;76;32;2;30;.938;3560000;0
36100;190164;4959;79;29;2;27;.931;3600000;0
36100;-1;4959;0;0;0;0;.00nan;0;0
36100;203099;176;0;0;0;0;.00nan;0;0
36100;213533;176;57;30;3;27;.900;3562000;0
36075;209840;184;0;0;0;0;.00nan;0;0
36075;205837;184;73;31;2;29;.935;3600000;0
36075;190038;181;72;35;4;31;.886;3520000;0
36075;192552;181;0;0;0;0;.00nan;0;0
36171;205788;207;0;0;0;0;.00nan;0;0
36171;201560;202;69;7;0;7;1.000;3600000;0
36171;212028;202;0;0;0;0;.00nan;0;0
36171;197853;207;85;41;3;38;.927;3600000;0
36010;205681;226;0;0;0;0;.00nan;0;0
36010;189902;204;92;53;4;49;.925;3600000;0
36010;-1;226;86;25;1;24;.960;3600000;0
36010;203120;204;0;0;0;0;.00nan;0;0
36081;192939;208;70;34;3;31;.912;3600000;0
36081;-1;199;72;51;5;46;.902;3572000;0
36081;-1;208;0;0;0;0;.00nan;0;0
36081;-1;199;0;0;0;0;.00nan;0;0
35993;188977;215;0;0;0;0;.00nan;0;0
35993;210794;215;59;39;5;34;.872;3568000;0
35993;-1;180;42;23;4;19;.826;3600000;0
35993;208383;180;0;0;0;0;.00nan;0;0
36139;187689;230;63;15;1;14;.933;3600000;0
36139;183678;230;0;0;0;0;.00nan;0;0
36139;191120;223;0;0;0;0;.00nan;0;0
36139;187118;223;86;55;5;50;.909;3600000;0
36025;201514;227;69;28;2;26;.929;3600000;0
36025;206800;225;0;0;0;0;.00nan;0;0
36025;-1;225;100;41;1;40;.976;3600000;0
36025;213280;227;0;0;0;0;.00nan;0;0
35935;198149;188;0;0;0;0;.00nan;0;0
35935;210504;193;73;20;1;19;.950;3600000;0
35935;189529;193;0;0;0;0;.00nan;0;0
35935;184409;188;87;45;3;42;.933;3540000;0
36109;192862;187;79;22;1;21;.955;3600000;0
36109;192547;190;40;33;6;27;.818;2674000;0
36109;-1;190;58;3;0;3;1.000;926000;0
36109;-1;187;0;0;0;0;.00nan;0;0
36053;200333;194;95;44;3;41;.932;3600000;0
36053;-1;192;86;20;0;20;1.000;3600000;0
36053;196352;194;0;0;0;0;.00nan;0;0
36053;207398;192;0;0;0;0;.00nan;0;0
36137;192915;179;43;27;6;21;.778;3061000;0
36137;201495;213;44;29;5;24;.828;2043000;0
36137;187355;179;48;5;1;4;.800;636000;0
36137;-1;213;56;19;3;16;.842;1654000;0
36191;201525;203;79;31;2;29;.935;3705000;0
36191;206772;203;0;0;0;0;.00nan;0;0
36191;196283;206;0;0;0;0;.00nan;0;0
36191;202998;206;71;31;3;28;.903;3705000;0
36116;191518;214;78;32;3;29;.906;3600000;0
36116;202914;214;0;0;0;0;.00nan;0;0
36116;-1;1371;0;0;0;0;.00nan;0;0
36116;-1;1371;41;30;5;25;.833;3540000;0
35953;211942;183;67;19;1;18;.947;3600000;0
35953;196237;183;0;0;0;0;.00nan;0;0
35953;196571;177;90;51;2;49;.961;3600000;0
35953;-1;177;0;0;0;0;.00nan;0;0
36093;194893;191;66;24;1;23;.958;3900000;0
36093;201892;191;0;0;0;0;.00nan;0;0
36093;191118;196;100;42;1;41;.976;3900000;0
36093;202830;196;0;0;0;0;.00nan;0;0
36059;190164;4959;0;0;0;0;.00nan;0;0
36059;-1;209;42;32;5;27;.844;3561000;0
36059;-1;4959;49;27;4;23;.852;3600000;0
36059;213590;209;0;0;0;0;.00nan;0;0
36209;195251;4949;45;22;4;18;.818;3900000;0
36209;201495;213;78;50;4;46;.920;3900000;0
36209;-1;4949;0;0;0;0;.00nan;0;0
36209;213498;213;0;0;0;0;.00nan;0;0
36211;209915;231;0;0;0;0;.00nan;0;0
36211;200452;221;54;36;5;31;.861;3892000;0
36211;189773;231;31;16;4;12;.750;3892000;0
36211;-1;221;0;0;0;0;.00nan;0;0
36213;201525;203;51;38;5;33;.868;3600000;0
36213;206772;203;0;0;0;0;.00nan;0;0
36213;192547;190;61;27;3;24;.889;3600000;0
36213;-1;190;0;0;0;0;.00nan;0;0
36215;198149;188;0;0;0;0;.00nan;0;0
36215;184409;188;60;34;4;30;.882;3513000;0
36215;201560;202;0;0;0;0;.00nan;0;0
36215;212028;202;69;27;2;25;.926;3600000;0
36217;206801;176;68;42;5;37;.881;3600000;0
36217;-1;2620;0;0;0;0;.00nan;0;0
36217;203099;176;0;0;0;0;.00nan;0;0
36217;213550;2620;94;34;1;33;.971;3600000;0
36219;205769;200;0;0;0;0;.00nan;0;0
36219;195238;200;79;41;3;38;.927;3511000;0
36219;189902;204;81;25;1;24;.960;3600000;0
36219;203120;204;0;0;0;0;.00nan;0;0
36221;182467;185;83;34;2;32;.941;3600000;0
36221;210134;1505;0;0;0;0;.00nan;0;0
36221;-1;185;0;0;0;0;.00nan;0;0
36221;-1;1505;66;31;3;28;.903;3542000;0
36223;192939;208;0;0;0;0;.00nan;0;0
36223;-1;192;26;21;5;16;.762;3539000;0
36223;207398;192;0;0;0;0;.00nan;0;0
36223;-1;208;57;24;3;21;.875;3600000;0
36225;200444;224;0;0;0;0;.00nan;0;0
36225;-1;220;57;9;0;9;1.000;720000;0
36225;-1;220;32;32;6;26;.813;2880000;0
36225;208372;224;76;21;1;20;.952;3600000;0
36227;200333;194;0;0;0;0;.00nan;0;0
36227;196352;194;78;34;2;32;.941;3900000;0
36227;-1;199;94;36;2;34;.944;3900000;0
36227;-1;199;0;0;0;0;.00nan;0;0
36229;210998;229;0;0;0;0;.00nan;0;0
36229;190034;217;96;26;0;26;1.000;3600000;0
36229;190041;217;0;0;0;0;.00nan;0;0
36229;185960;229;77;30;2;28;.933;3577000;0
36231;192915;179;0;0;0;0;.00nan;0;0
36231;211942;183;82;27;1;26;.963;3600000;0
36231;196237;183;0;0;0;0;.00nan;0;0
36231;187355;179;85;38;2;36;.947;3600000;0
36233;188977;215;0;0;0;0;.00nan;0;0
36233;210504;193;96;17;0;17;1.000;3600000;0
36233;189529;193;0;0;0;0;.00nan;0;0
36233;210794;215;97;42;2;40;.952;3563000;0
36235;200306;182;0;0;0;0;.00nan;0;0
36235;201585;197;100;35;1;34;.971;3900000;0
36235;206822;197;0;0;0;0;.00nan;0;0
36235;185810;182;96;35;1;34;.971;3900000;0
36237;209840;184;0;0;0;0;.00nan;0;0
36237;205837;184;100;26;0;26;1.000;3600000;0
36237;191063;211;0;0;0;0;.00nan;0;0
36237;-1;211;65;39;4;35;.897;3600000;0
36239;200437;201;85;38;3;35;.921;3600000;0
36239;196571;177;59;34;5;29;.853;3535000;0
36239;208048;201;0;0;0;0;.00nan;0;0
36239;-1;177;0;0;0;0;.00nan;0;0
36241;187689;230;0;0;0;0;.00nan;0;0
36241;183678;230;59;19;2;17;.895;3600000;0
36241;195164;218;44;37;6;31;.838;3600000;0
36241;208051;218;0;0;0;0;.00nan;0;0
36243;186332;4864;89;31;1;30;.968;3900000;0
36243;202801;4864;0;0;0;0;.00nan;0;0
36243;197672;210;91;30;1;29;.967;3900000;0
36243;-1;210;0;0;0;0;.00nan;0;0
36245;190038;181;0;0;0;0;.00nan;0;0
36245;196283;206;0;0;0;0;.00nan;0;0
36245;192552;181;72;26;2;24;.923;3600000;0
36245;202998;206;66;33;3;30;.909;3551000;0
36247;-1;189;85;27;1;26;.963;3600000;0
36247;191518;214;51;42;6;36;.857;3600000;0
36247;-1;189;0;0;0;0;.00nan;0;0
36247;202914;214;0;0;0;0;.00nan;0;0
36249;183695;232;92;25;0;25;1.000;3600000;0
36249;184874;212;0;0;0;0;.00nan;0;0
36249;-1;212;61;27;3;24;.889;3600000;0
36249;-1;232;0;0;0;0;.00nan;0;0
36251;191118;196;91;15;0;15;1.000;3600000;0
36251;-1;178;0;0;0;0;.00nan;0;0
36251;202830;196;0;0;0;0;.00nan;0;0
36251;-1;178;76;42;2;40;.952;3573000;0
36253;205788;207;0;0;0;0;.00nan;0;0
36253;213399;216;0;0;0;0;.00nan;0;0
36253;197853;207;85;35;2;33;.943;3600000;0
36253;-1;216;56;33;4;29;.879;3536000;0
36255;194893;191;70;25;2;23;.920;3600000;0
36255;201524;205;0;0;0;0;.00nan;0;0
36255;201892;191;0;0;0;0;.00nan;0;0
36255;-1;205;90;47;3;44;.936;3567000;0
36257;194219;4960;29;16;4;12;.750;3528000;0
36257;212304;4960;0;0;0;0;.00nan;0;0
36257;203063;209;0;0;0;0;.00nan;0;0
36257;213590;209;85;36;2;34;.944;3600000;0
36259;190164;4959;23;4;3;1;.250;201000;0
36259;-1;4959;62;39;4;35;.897;3385000;0
36259;-1;1371;0;0;0;0;.00nan;0;0
36259;-1;1371;49;33;5;28;.848;3600000;0
36261;184788;198;0;0;0;0;.00nan;0;0
36261;206800;225;63;53;6;47;.887;3600000;0
36261;212143;198;100;23;0;23;1.000;3600000;0
36261;-1;225;0;0;0;0;.00nan;0;0
36263;191130;186;0;0;0;0;.00nan;0;0
36263;-1;180;83;26;1;25;.962;3552000;0
36263;213507;186;84;18;0;18;1.000;3600000;0
36263;208383;180;0;0;0;0;.00nan;0;0
36265;192862;187;53;24;3;21;.875;3600000;0
36265;192929;222;0;0;0;0;.00nan;0;0
36265;-1;187;0;0;0;0;.00nan;0;0
36265;213560;222;76;48;4;44;.917;3564000;0
36267;205681;226;0;0;0;0;.00nan;0;0
36267;207061;195;67;17;1;16;.941;3600000;0
36267;196465;195;0;0;0;0;.00nan;0;0
36267;-1;226;96;46;3;43;.935;3561000;0
36269;180377;228;0;0;0;0;.00nan;0;0
36269;191120;223;0;0;0;0;.00nan;0;0
36269;187118;223;70;22;1;21;.955;3600000;0
36269;208044;228;52;44;6;38;.864;3600000;0
36271;201514;227;67;28;2;26;.929;3900000;0
36271;-1;219;92;36;2;34;.944;3900000;0
36271;-1;219;0;0;0;0;.00nan;0;0
36271;213280;227;0;0;0;0;.00nan;0;0
36273;189902;204;0;0;0;0;.00nan;0;0
36273;191063;211;99;40;1;39;.975;3600000;0
36273;-1;211;0;0;0;0;.00nan;0;0
36273;203120;204;75;43;4;39;.907;3600000;0
36275;201514;227;0;0;0;0;.00nan;0;0
36275;191120;223;67;27;3;24;.889;3600000;0
36275;187118;223;0;0;0;0;.00nan;0;0
36275;213280;227;84;45;4;41;.911;3544000;0
36277;186332;4864;0;0;0;0;.00nan;0;0
36277;191518;214;0;0;0;0;.00nan;0;0
36277;202801;4864;78;21;1;20;.952;3600000;0
36277;202914;214;82;42;2;40;.952;3566000;0
36279;205681;226;75;24;1;23;.958;3600000;0
36279;213399;216;60;32;4;28;.875;3600000;0
36279;-1;226;0;0;0;0;.00nan;0;0
36279;-1;216;0;0;0;0;.00nan;0;0
36281;198149;188;90;52;3;49;.942;3600000;0
36281;187689;230;70;26;2;24;.923;3600000;0
36281;183678;230;0;0;0;0;.00nan;0;0
36281;184409;188;0;0;0;0;.00nan;0;0
36283;194219;4960;0;0;0;0;.00nan;0;0
36283;201524;205;64;30;3;27;.900;3900000;0
36283;212304;4960;50;19;3;16;.842;3900000;0
36283;-1;205;0;0;0;0;.00nan;0;0
36285;206801;176;0;0;0;0;.00nan;0;0
36285;-1;1371;72;39;4;35;.897;3575000;0
36285;203099;176;64;23;2;21;.913;3600000;0
36285;-1;1371;0;0;0;0;.00nan;0;0
36287;192862;187;0;0;0;0;.00nan;0;0
36287;180377;228;100;21;0;21;1.000;3600000;0
36287;208044;228;0;0;0;0;.00nan;0;0
36287;-1;187;67;22;2;20;.909;3514000;0
36289;209915;231;73;23;1;22;.957;3600000;0
36289;189773;231;0;0;0;0;.00nan;0;0
36289;201560;202;87;42;2;40;.952;3585000;0
36289;212028;202;0;0;0;0;.00nan;0;0
36291;205788;207;99;46;1;45;.978;3600000;0
36291;-1;192;0;0;0;0;.00nan;0;0
36291;207398;192;56;25;3;22;.880;3543000;0
36291;197853;207;0;0;0;0;.00nan;0;0
36293;210504;193;72;27;2;25;.926;3729000;0
36293;189529;193;0;0;0;0;.00nan;0;0
36293;205769;200;100;49;1;48;.980;3729000;0
36293;195238;200;0;0;0;0;.00nan;0;0
36295;209840;184;0;0;0;0;.00nan;0;0
36295;205837;184;99;41;1;40;.976;3600000;0
36295;-1;180;0;0;0;0;.00nan;0;0
36295;208383;180;60;21;2;19;.905;3548000;0
36297;-1;178;97;41;2;39;.951;3900000;0
36297;-1;199;0;0;0;0;.00nan;0;0
36297;-1;199;75;28;2;26;.929;3900000;0
36297;-1;178;0;0;0;0;.00nan;0;0
36299;201495;213;0;0;0;0;.00nan;0;0
36299;191118;196;32;20;5;15;.750;3900000;0
36299;202830;196;0;0;0;0;.00nan;0;0
36299;213498;213;74;53;5;48;.906;3900000;0
36301;182467;185;72;17;0;17;1.000;1496000;0
36301;194893;191;0;0;0;0;.00nan;0;0
36301;201892;191;74;24;1;23;.958;3600000;0
36301;-1;185;43;35;6;29;.829;2104000;0
36303;188977;215;89;40;2;38;.950;3541000;0
36303;210794;215;0;0;0;0;.00nan;0;0
36303;197672;210;0;0;0;0;.00nan;0;0
36303;-1;210;93;24;0;24;1.000;3600000;0
36305;192939;208;80;20;1;19;.950;3600000;0
36305;196283;206;97;49;3;46;.939;3582000;0
36305;-1;208;0;0;0;0;.00nan;0;0
36305;202998;206;0;0;0;0;.00nan;0;0
36307;206800;225;0;0;0;0;.00nan;0;0
36307;-1;225;69;19;1;18;.947;3600000;0
36307;191130;186;0;0;0;0;.00nan;0;0
36307;213507;186;95;42;2;40;.952;3573000;0
36309;201525;203;0;0;0;0;.00nan;0;0
36309;206772;203;88;40;2;38;.950;3535000;0
36309;-1;219;0;0;0;0;.00nan;0;0
36309;-1;219;100;26;0;26;1.000;3600000;0
36311;210998;229;52;26;3;23;.885;3900000;0
36311;190038;181;81;37;3;34;.919;3900000;0
36311;185960;229;0;0;0;0;.00nan;0;0
36311;192552;181;0;0;0;0;.00nan;0;0
36313;183695;232;83;31;2;29;.935;3900000;0
36313;196571;177;0;0;0;0;.00nan;0;0
36313;-1;177;77;30;2;28;.933;3900000;0
36313;-1;232;0;0;0;0;.00nan;0;0
36315;211942;183;0;0;0;0;.00nan;0;0
36315;184874;212;67;28;2;26;.929;3599000;0
36315;196237;183;62;16;1;15;.938;3600000;0
36315;-1;212;0;0;0;0;.00nan;0;0
36317;184788;198;0;0;0;0;.00nan;0;0
36317;201585;197;0;0;0;0;.00nan;0;0
36317;206822;197;92;42;2;40;.952;3900000;0
36317;212143;198;59;17;2;15;.882;3900000;0
36319;200306;182;25;13;4;9;.692;683000;0
36319;207061;195;0;0;0;0;.00nan;0;0
36319;196465;195;69;21;2;19;.905;3600000;0
36319;185810;182;58;33;4;29;.879;2917000;0
36321;210134;1505;51;24;4;20;.833;3577000;0
36321;200333;194;77;39;3;36;.923;3600000;0
36321;196352;194;0;0;0;0;.00nan;0;0
36321;-1;1505;0;0;0;0;.00nan;0;0
36323;192915;179;96;31;1;30;.968;3600000;0
36323;195251;4949;0;0;0;0;.00nan;0;0
36323;187355;179;0;0;0;0;.00nan;0;0
36323;-1;4949;67;36;4;32;.889;3600000;0
36325;200437;201;0;0;0;0;.00nan;0;0
36325;200452;221;0;0;0;0;.00nan;0;0
36325;208048;201;72;38;4;34;.895;3560000;0
36325;-1;221;77;34;3;31;.912;3600000;0
36327;-1;220;91;36;1;35;.972;3600000;0
36327;-1;220;0;0;0;0;.00nan;0;0
36327;203063;209;83;29;2;27;.931;3546000;0
36327;213590;209;0;0;0;0;.00nan;0;0
36329;200444;224;59;45;6;39;.867;3600000;0
36329;190034;217;85;32;1;31;.969;3600000;0
36329;190041;217;0;0;0;0;.00nan;0;0
36329;208372;224;0;0;0;0;.00nan;0;0
36331;190164;4959;53;28;4;24;.857;3174000;0
36331;-1;189;0;0;0;0;.00nan;0;0
36331;-1;4959;57;7;0;7;1.000;359000;0
36331;-1;189;78;32;2;30;.938;3600000;0
36333;195164;218;0;0;0;0;.00nan;0;0
36333;208051;218;83;41;2;39;.951;3600000;0
36333;-1;2620;47;29;4;25;.862;3577000;0
36333;213550;2620;0;0;0;0;.00nan;0;0
36335;192929;222;98;49;2;47;.959;3600000;0
36335;192547;190;0;0;0;0;.00nan;0;0
36335;-1;190;51;27;3;24;.889;3559000;0
36335;213560;222;0;0;0;0;.00nan;0;0
36337;205681;226;0;0;0;0;.00nan;0;0
36337;195164;218;59;46;5;41;.891;3600000;0
36337;208051;218;0;0;0;0;.00nan;0;0
36337;-1;226;84;35;2;33;.943;3600000;0
36339;190164;4959;0;0;0;0;.00nan;0;0
36339;213399;216;0;0;0;0;.00nan;0;0
36339;-1;4959;77;24;2;22;.917;3600000;0
36339;-1;216;72;39;3;36;.923;3551000;0
36341;201514;227;58;31;4;27;.871;3582000;0
36341;201585;197;78;35;3;32;.914;3600000;0
36341;206822;197;0;0;0;0;.00nan;0;0
36341;213280;227;0;0;0;0;.00nan;0;0
36343;187689;230;0;0;0;0;.00nan;0;0
36343;183678;230;71;23;1;22;.957;3600000;0
36343;190034;217;0;0;0;0;.00nan;0;0
36343;190041;217;60;27;3;24;.889;3537000;0
36345;-1;192;0;0;0;0;.00nan;0;0
36345;207398;192;63;34;3;31;.912;3847000;0
36345;192547;190;58;30;4;26;.867;3847000;0
36345;-1;190;0;0;0;0;.00nan;0;0
36347;210998;229;0;0;0;0;.00nan;0;0
36347;180377;228;53;33;4;29;.879;3543000;0
36347;185960;229;80;34;3;31;.912;3600000;0
36347;208044;228;0;0;0;0;.00nan;0;0
36349;200452;221;100;43;1;42;.977;3600000;0
36349;201525;203;6;16;6;10;.625;3600000;0
36349;206772;203;0;0;0;0;.00nan;0;0
36349;-1;221;0;0;0;0;.00nan;0;0
36351;210504;193;75;29;2;27;.931;3600000;0
36351;189529;193;0;0;0;0;.00nan;0;0
36351;207061;195;22;18;5;13;.722;3600000;0
36351;196465;195;0;0;0;0;.00nan;0;0
36353;205788;207;0;0;0;0;.00nan;0;0
36353;201495;213;100;42;2;40;.952;3600000;0
36353;197853;207;54;23;3;20;.870;3543000;0
36353;213498;213;0;0;0;0;.00nan;0;0
36355;194219;4960;42;34;6;28;.824;3600000;0
36355;184788;198;0;0;0;0;.00nan;0;0
36355;212143;198;54;27;3;24;.889;3600000;0
36355;212304;4960;0;0;0;0;.00nan;0;0
36357;192862;187;36;21;4;17;.810;3579000;0
36357;198149;188;0;0;0;0;.00nan;0;0
36357;184409;188;100;48;3;45;.938;3600000;0
36357;-1;187;0;0;0;0;.00nan;0;0
36359;182467;185;45;32;5;27;.844;3570000;0
36359;-1;185;0;0;0;0;.00nan;0;0
36359;-1;1371;0;0;0;0;.00nan;0;0
36359;-1;1371;63;34;4;30;.882;3600000;0
36361;206800;225;0;0;0;0;.00nan;0;0
36361;-1;225;79;40;3;37;.925;3600000;0
36361;191130;186;0;0;0;0;.00nan;0;0
36361;213507;186;61;20;2;18;.900;3600000;0
36363;186332;4864;100;29;0;29;1.000;3600000;0
36363;-1;189;0;0;0;0;.00nan;0;0
36363;202801;4864;0;0;0;0;.00nan;0;0
36363;-1;189;77;22;1;21;.955;3600000;0
36365;190038;181;0;0;0;0;.00nan;0;0
36365;-1;220;0;0;0;0;.00nan;0;0
36365;-1;220;44;24;4;20;.833;3514000;0
36365;192552;181;76;34;2;32;.941;3600000;0
36367;200444;224;0;0;0;0;.00nan;0;0
36367;194893;191;66;26;2;24;.923;3600000;0
36367;201892;191;0;0;0;0;.00nan;0;0
36367;208372;224;74;45;4;41;.911;3558000;0
36369;196571;177;75;27;1;26;.963;3600000;0
36369;-1;178;0;0;0;0;.00nan;0;0
36369;-1;178;61;43;5;38;.884;3600000;0
36369;-1;177;0;0;0;0;.00nan;0;0
36371;205769;200;0;0;0;0;.00nan;0;0
36371;195238;200;99;35;1;34;.971;3600000;0
36371;197672;210;0;0;0;0;.00nan;0;0
36371;-1;210;67;42;4;38;.905;3600000;0
36373;200333;194;0;0;0;0;.00nan;0;0
36373;196352;194;82;34;2;32;.941;3900000;0
36373;203063;209;0;0;0;0;.00nan;0;0
36373;213590;209;57;24;2;22;.917;3900000;0
36375;195251;4949;81;35;3;32;.914;3900000;0
36375;201560;202;64;34;3;31;.912;3900000;0
36375;212028;202;0;0;0;0;.00nan;0;0
36375;-1;4949;0;0;0;0;.00nan;0;0
36377;192915;179;0;0;0;0;.00nan;0;0
36377;196283;206;73;30;2;28;.933;3600000;0
36377;187355;179;50;27;4;23;.852;3570000;0
36377;202998;206;0;0;0;0;.00nan;0;0
36379;206801;176;55;25;2;23;.920;3547000;0
36379;191120;223;0;0;0;0;.00nan;0;0
36379;187118;223;85;31;1;30;.968;3600000;0
36379;203099;176;0;0;0;0;.00nan;0;0
36381;188977;215;0;0;0;0;.00nan;0;0
36381;210794;215;97;27;0;27;1.000;3600000;0
36381;191063;211;0;0;0;0;.00nan;0;0
36381;-1;211;93;36;2;34;.944;3572000;0
36383;211942;183;96;39;2;37;.949;3600000;0
36383;184874;212;0;0;0;0;.00nan;0;0
36383;196237;183;0;0;0;0;.00nan;0;0
36383;-1;212;70;29;3;26;.897;3546000;0
36385;192939;208;0;0;0;0;.00nan;0;0
36385;-1;219;0;0;0;0;.00nan;0;0
36385;-1;219;68;25;2;23;.920;3600000;0
36385;-1;208;58;29;3;26;.897;3557000;0
36387;200437;201;99;48;1;47;.979;3600000;0
36387;-1;180;50;35;5;30;.857;3600000;0
36387;208048;201;0;0;0;0;.00nan;0;0
36387;208383;180;0;0;0;0;.00nan;0;0
36389;183695;232;0;0;0;0;.00nan;0;0
36389;201524;205;0;0;0;0;.00nan;0;0
36389;-1;205;100;25;0;25;1.000;3600000;0
36389;-1;232;82;27;1;26;.963;3565000;0
36391;210134;1505;0;0;0;0;.00nan;0;0
36391;191118;196;93;37;2;35;.946;3900000;0
36391;-1;1505;87;35;2;33;.943;3900000;0
36391;202830;196;0;0;0;0;.00nan;0;0
36393;192929;222;0;0;0;0;.00nan;0;0
36393;-1;199;0;0;0;0;.00nan;0;0
36393;-1;199;63;34;4;30;.882;3543000;0
36393;213560;222;70;30;2;28;.933;3600000;0
36395;209915;231;0;0;0;0;.00nan;0;0
36395;189773;231;60;24;3;21;.875;3900000;0
36395;189902;204;89;43;3;40;.930;3900000;0
36395;203120;204;0;0;0;0;.00nan;0;0
36397;191518;214;76;32;2;30;.938;3900000;0
36397;202914;214;0;0;0;0;.00nan;0;0
36397;-1;2620;0;0;0;0;.00nan;0;0
36397;213550;2620;60;20;2;18;.900;3900000;0
36399;209840;184;0;0;0;0;.00nan;0;0
36399;200306;182;0;0;0;0;.00nan;0;0
36399;205837;184;59;39;5;34;.872;3600000;0
36399;185810;182;79;15;0;15;1.000;3600000;0
36401;209915;231;0;0;0;0;.00nan;0;0
36401;189773;231;78;34;3;31;.912;3895000;0
36401;211942;183;62;35;4;31;.886;3895000;0
36401;196237;183;0;0;0;0;.00nan;0;0
36403;210134;1505;95;46;3;43;.935;3543000;0
36403;192547;190;99;39;2;37;.949;3600000;0
36403;-1;1505;0;0;0;0;.00nan;0;0
36403;-1;190;0;0;0;0;.00nan;0;0
36405;200437;201;0;0;0;0;.00nan;0;0
36405;210504;193;40;16;4;12;.750;3600000;0
36405;189529;193;0;0;0;0;.00nan;0;0
36405;208048;201;73;56;6;50;.893;3522000;0
36407;192915;179;91;43;3;40;.930;3573000;0
36407;201560;202;0;0;0;0;.00nan;0;0
36407;212028;202;80;19;1;18;.947;3600000;0
36407;187355;179;0;0;0;0;.00nan;0;0
36409;192862;187;0;0;0;0;.00nan;0;0
36409;183695;232;80;34;2;32;.941;3600000;0
36409;-1;187;63;29;3;26;.897;3580000;0
36409;-1;232;0;0;0;0;.00nan;0;0
36411;195164;218;71;36;4;32;.889;3551000;0
36411;195251;4949;0;0;0;0;.00nan;0;0
36411;208051;218;0;0;0;0;.00nan;0;0
36411;-1;4949;61;27;3;24;.889;3600000;0
36413;205769;200;0;0;0;0;.00nan;0;0
36413;195238;200;79;24;1;23;.958;3600000;0
36413;196571;177;64;35;4;31;.886;3600000;0
36413;-1;177;0;0;0;0;.00nan;0;0
36415;190164;4959;52;33;5;28;.848;3550000;0
36415;-1;189;65;32;3;29;.906;3600000;0
36415;-1;4959;0;0;0;0;.00nan;0;0
36415;-1;189;0;0;0;0;.00nan;0;0
36417;209840;184;0;0;0;0;.00nan;0;0
36417;205837;184;76;28;2;26;.929;3600000;0
36417;201585;197;53;39;5;34;.872;3600000;0
36417;206822;197;0;0;0;0;.00nan;0;0
36419;-1;199;0;0;0;0;.00nan;0;0
36419;-1;199;79;29;2;27;.931;3600000;0
36419;-1;2620;0;0;0;0;.00nan;0;0
36419;213550;2620;43;27;5;22;.815;3600000;0
36421;-1;219;88;38;2;36;.947;3873000;0
36421;-1;219;0;0;0;0;.00nan;0;0
36421;186332;4864;92;43;3;40;.930;3873000;0
36421;202801;4864;0;0;0;0;.00nan;0;0
36423;201495;213;40;30;6;24;.800;1689000;0
36423;191130;186;0;0;0;0;.00nan;0;0
36423;213498;213;66;28;2;26;.929;1911000;0
36423;213507;186;38;14;3;11;.786;3600000;0
36425;192939;208;0;0;0;0;.00nan;0;0
36425;206801;176;82;31;2;29;.935;3544000;0
36425;-1;208;81;30;1;29;.967;3600000;0
36425;203099;176;0;0;0;0;.00nan;0;0
36427;192929;222;0;0;0;0;.00nan;0;0
36427;180377;228;43;38;5;33;.868;3546000;0
36427;208044;228;0;0;0;0;.00nan;0;0
36427;213560;222;61;22;3;19;.864;3600000;0
36429;198149;188;0;0;0;0;.00nan;0;0
36429;184409;188;68;27;2;25;.926;3539000;0
36429;191118;196;100;30;0;30;1.000;3600000;0
36429;202830;196;0;0;0;0;.00nan;0;0
36431;200452;221;75;30;3;27;.900;3600000;0
36431;196283;206;45;27;4;23;.852;3547000;0
36431;202998;206;0;0;0;0;.00nan;0;0
36431;-1;221;0;0;0;0;.00nan;0;0
36433;201524;205;0;0;0;0;.00nan;0;0
36433;-1;178;75;31;3;28;.903;3900000;0
36433;-1;205;58;27;3;24;.889;3900000;0
36433;-1;178;0;0;0;0;.00nan;0;0
36435;-1;180;67;23;3;20;.870;3738000;0
36435;-1;1371;81;46;4;42;.913;3738000;0
36435;208383;180;0;0;0;0;.00nan;0;0
36435;-1;1371;0;0;0;0;.00nan;0;0
36437;200444;224;51;34;4;30;.882;3600000;0
36437;191120;223;0;0;0;0;.00nan;0;0
36437;187118;223;58;30;3;27;.900;3600000;0
36437;208372;224;0;0;0;0;.00nan;0;0
36439;-1;220;77;26;1;25;.962;3600000;0
36439;-1;220;0;0;0;0;.00nan;0;0
36439;191063;211;0;0;0;0;.00nan;0;0
36439;-1;211;87;40;2;38;.950;3600000;0
36441;189902;204;58;25;3;22;.880;3600000;0
36441;197672;210;0;0;0;0;.00nan;0;0
36441;203120;204;0;0;0;0;.00nan;0;0
36441;-1;210;78;26;1;25;.962;3600000;0
36443;182467;185;58;42;5;37;.881;3900000;0
36443;-1;185;0;0;0;0;.00nan;0;0
36443;213399;216;0;0;0;0;.00nan;0;0
36443;-1;216;45;29;5;24;.828;3900000;0
36445;-1;192;0;0;0;0;.00nan;0;0
36445;207398;192;61;18;1;17;.944;3558000;0
36445;191518;214;100;46;0;46;1.000;3600000;0
36445;202914;214;0;0;0;0;.00nan;0;0
36447;194219;4960;0;0;0;0;.00nan;0;0
36447;188977;215;0;0;0;0;.00nan;0;0
36447;210794;215;80;29;1;28;.966;3726000;0
36447;212304;4960;57;21;2;19;.905;3726000;0
36449;205681;226;0;0;0;0;.00nan;0;0
36449;190038;181;0;0;0;0;.00nan;0;0
36449;192552;181;61;26;3;23;.885;3569000;0
36449;-1;226;84;30;2;28;.933;3600000;0
36451;206800;225;0;0;0;0;.00nan;0;0
36451;-1;225;61;47;6;41;.872;3600000;0
36451;203063;209;0;0;0;0;.00nan;0;0
36451;213590;209;93;20;0;20;1.000;3600000;0
36453;205788;207;0;0;0;0;.00nan;0;0
36453;190034;217;0;0;0;0;.00nan;0;0
36453;190041;217;56;17;2;15;.882;3600000;0
36453;197853;207;98;70;4;66;.943;3551000;0
36455;187689;230;0;0;0;0;.00nan;0;0
36455;183678;230;44;26;4;22;.846;3537000;0
36455;200306;182;0;0;0;0;.00nan;0;0
36455;185810;182;93;41;2;39;.951;3600000;0
36457;201514;227;0;0;0;0;.00nan;0;0
36457;184874;212;0;0;0;0;.00nan;0;0
36457;-1;212;63;45;5;40;.889;3585000;0
36457;213280;227;68;30;3;27;.900;3600000;0
36459;200333;194;73;40;4;36;.900;3596000;0
36459;184788;198;0;0;0;0;.00nan;0;0
36459;212143;198;86;39;2;37;.949;3600000;0
36459;196352;194;0;0;0;0;.00nan;0;0
36461;210998;229;43;28;4;24;.857;3900000;0
36461;201525;203;92;44;4;40;.909;3900000;0
36461;206772;203;0;0;0;0;.00nan;0;0
36461;185960;229;0;0;0;0;.00nan;0;0
36463;194893;191;95;20;0;20;1.000;3600000;0
36463;201892;191;0;0;0;0;.00nan;0;0
36463;207061;195;45;30;4;26;.867;3600000;0
36463;196465;195;0;0;0;0;.00nan;0;0
1349;205681;226;0;0;0;0;.00nan;0;0
1349;-1;180;31;30;7;23;.767;2862000;0
1349;-1;226;69;31;2;29;.935;3600000;0
1349;208383;180;39;8;2;6;.750;738000;0
1350;209915;231;0;0;0;0;.00nan;0;0
1350;189773;231;87;13;0;13;1.000;3600000;0
1350;190034;217;98;55;4;51;.927;3600000;0
1350;190041;217;0;0;0;0;.00nan;0;0
1351;207061;195;60;21;2;19;.905;3600000;0
1351;196465;195;0;0;0;0;.00nan;0;0
1351;-1;1371;49;30;4;26;.867;3545000;0
1351;-1;1371;0;0;0;0;.00nan;0;0
1352;187689;230;53;23;3;20;.870;3600000;0
1352;183678;230;0;0;0;0;.00nan;0;0
1352;186332;4864;44;41;6;35;.854;3600000;0
1352;202801;4864;0;0;0;0;.00nan;0;0
1353;194893;191;71;13;1;12;.923;3600000;0
1353;201560;202;83;56;5;51;.911;3600000;0
1353;212028;202;0;0;0;0;.00nan;0;0
1353;201892;191;0;0;0;0;.00nan;0;0
1354;192939;208;60;31;4;27;.871;3600000;0
1354;210504;193;24;12;4;8;.667;990000;0
1354;189529;193;71;28;2;26;.929;2525000;0
1354;-1;208;0;0;0;0;.00nan;0;0
1355;210134;1505;51;2;0;2;1.000;291000;0
1355;211942;183;73;25;1;24;.960;3600000;0
1355;196237;183;0;0;0;0;.00nan;0;0
1355;-1;1505;28;28;6;22;.786;3309000;0
1356;-1;220;0;0;0;0;.00nan;0;0
1356;-1;220;88;53;3;50;.943;4927000;0
1356;197672;210;83;38;2;36;.947;4927000;0
1356;-1;210;0;0;0;0;.00nan;0;0
1599;209915;231;0;0;0;0;.00nan;0;0
1599;205681;226;0;0;0;0;.00nan;0;0
1599;189773;231;64;20;2;18;.900;3600000;0
1599;-1;226;69;42;4;38;.905;3600000;0
1600;187689;230;98;27;0;27;1.000;3600000;0
1600;183678;230;0;0;0;0;.00nan;0;0
1600;207061;195;79;25;1;24;.960;3544000;0
1600;196465;195;0;0;0;0;.00nan;0;0
1601;192939;208;84;50;4;46;.920;4184000;0
1601;194893;191;40;14;3;11;.786;4184000;0
1601;201892;191;0;0;0;0;.00nan;0;0
1601;-1;208;0;0;0;0;.00nan;0;0
1602;211942;183;70;18;1;17;.944;4301000;0
1602;196237;183;0;0;0;0;.00nan;0;0
1602;197672;210;86;36;2;34;.944;4301000;0
1602;-1;210;0;0;0;0;.00nan;0;0
1687;187689;230;83;37;2;35;.946;4152000;0
1687;183678;230;0;0;0;0;.00nan;0;0
1687;209915;231;0;0;0;0;.00nan;0;0
1687;189773;231;79;21;1;20;.952;4152000;0
1688;194893;191;63;33;3;30;.909;5898000;0
1688;211942;183;85;62;4;58;.935;5898000;0
1688;196237;183;0;0;0;0;.00nan;0;0
1688;201892;191;0;0;0;0;.00nan;0;0
1916;209915;231;0;0;0;0;.00nan;0;0
1916;194893;191;48;27;4;23;.852;3600000;0
1916;189773;231;60;29;3;26;.897;3600000;0
1916;201892;191;0;0;0;0;.00nan;0;0
36464;170548;712;64;28;3;25;.893;3600000;0
36464;-1;712;0;0;0;0;.00nan;0;0
36464;181748;714;55;28;4;24;.857;3586000;0
36464;145636;714;0;0;0;0;.00nan;0;0
36465;-1;713;0;0;0;0;.00nan;0;0
36465;-1;711;0;0;0;0;.00nan;0;0
36465;78251;711;100;25;0;25;1.000;3600000;0
36465;157000;713;53;44;5;39;.886;3600000;0
36466;-1;2465;88;26;1;25;.962;3600000;0
36466;-1;707;67;24;2;22;.917;3567000;0
36466;145733;2465;0;0;0;0;.00nan;0;0
36466;145843;707;0;0;0;0;.00nan;0;0
36467;166044;2474;93;53;4;49;.925;3600000;0
36467;26308;710;64;16;1;15;.938;3600000;0
36467;-1;710;0;0;0;0;.00nan;0;0
36467;70115;2474;0;0;0;0;.00nan;0;0
36468;72229;706;100;50;2;48;.960;3900000;0
36468;85507;2473;77;31;2;29;.935;3900000;0
36468;146001;2473;0;0;0;0;.00nan;0;0
36468;160866;706;0;0;0;0;.00nan;0;0
36469;166044;2474;68;56;6;50;.893;3600000;0
36469;-1;713;73;15;0;15;1.000;3600000;0
36469;70115;2474;0;0;0;0;.00nan;0;0
36469;157000;713;0;0;0;0;.00nan;0;0
36470;181748;714;99;46;1;45;.978;3600000;0
36470;85507;2473;54;29;4;25;.862;3600000;0
36470;145636;714;0;0;0;0;.00nan;0;0
36470;146001;2473;0;0;0;0;.00nan;0;0
36471;-1;713;52;20;3;17;.850;3900000;0
36471;-1;707;84;51;3;48;.941;3900000;0
36471;145843;707;0;0;0;0;.00nan;0;0
36471;157000;713;0;0;0;0;.00nan;0;0
36472;-1;711;0;0;0;0;.00nan;0;0
36472;26308;710;52;22;3;19;.864;3530000;0
36472;-1;710;0;0;0;0;.00nan;0;0
36472;78251;711;100;42;1;41;.976;3600000;0
36473;-1;2465;61;20;2;18;.900;3600000;0
36473;72229;706;75;43;4;39;.907;3576000;0
36473;145733;2465;0;0;0;0;.00nan;0;0
36473;160866;706;0;0;0;0;.00nan;0;0
36474;166044;2474;65;36;4;32;.889;3600000;0
36474;170548;712;100;35;0;35;1.000;3600000;0
36474;-1;712;0;0;0;0;.00nan;0;0
36474;70115;2474;0;0;0;0;.00nan;0;0
36475;-1;713;91;19;0;19;1.000;3600000;0
36475;85507;2473;72;30;3;27;.900;3600000;0
36475;146001;2473;0;0;0;0;.00nan;0;0
36475;157000;713;0;0;0;0;.00nan;0;0
36476;166044;2474;0;0;0;0;.00nan;0;0
36476;181748;714;50;24;4;20;.833;3734000;0
36476;70115;2474;59;35;5;30;.857;3734000;0
36476;145636;714;0;0;0;0;.00nan;0;0
36477;-1;711;36;16;4;12;.750;1172000;0
36477;72229;706;85;27;1;26;.963;3600000;0
36477;78251;711;52;21;3;18;.857;2428000;0
36477;160866;706;0;0;0;0;.00nan;0;0
36478;170548;712;41;39;6;33;.846;3600000;0
36478;-1;712;0;0;0;0;.00nan;0;0
36478;-1;2465;78;25;1;24;.960;3600000;0
36478;145733;2465;0;0;0;0;.00nan;0;0
36479;26308;710;70;21;1;20;.952;3600000;0
36479;-1;707;48;34;5;29;.853;3600000;0
36479;-1;710;0;0;0;0;.00nan;0;0
36479;145843;707;0;0;0;0;.00nan;0;0
36480;26308;710;49;24;3;21;.875;3600000;0
36480;-1;710;0;0;0;0;.00nan;0;0
36480;72229;706;44;31;5;26;.839;2342000;0
36480;160866;706;47;12;2;10;.833;1258000;0
36481;-1;2465;52;30;4;26;.867;3677000;0
36481;181748;714;67;34;3;31;.912;3677000;0
36481;145636;714;0;0;0;0;.00nan;0;0
36481;145733;2465;0;0;0;0;.00nan;0;0
36482;166044;2474;59;41;5;36;.878;3573000;0
36482;70115;2474;0;0;0;0;.00nan;0;0
36482;85507;2473;58;30;4;26;.867;3600000;0
36482;146001;2473;0;0;0;0;.00nan;0;0
36483;-1;707;29;31;6;25;.806;2255000;0
36483;72229;706;49;15;3;12;.800;3600000;0
36483;145843;707;55;6;0;6;1.000;1345000;0
36483;160866;706;0;0;0;0;.00nan;0;0
36484;170548;712;35;33;6;27;.818;2716000;0
36484;-1;711;0;0;0;0;.00nan;0;0
36484;-1;712;55;10;1;9;.900;884000;0
36484;78251;711;49;19;3;16;.842;3600000;0
36485;-1;713;30;36;7;29;.806;3151000;0
36485;26308;710;0;0;0;0;.00nan;0;0
36485;-1;710;83;28;1;27;.964;3600000;0
36485;157000;713;45;7;2;5;.714;449000;0
36486;170548;712;99;24;0;24;1.000;3600000;0
36486;-1;712;0;0;0;0;.00nan;0;0
36486;-1;707;0;0;0;0;.00nan;0;0
36486;145843;707;59;25;3;22;.880;3600000;0
36487;-1;2465;0;0;0;0;.00nan;0;0
36487;85507;2473;0;0;0;0;.00nan;0;0
36487;145733;2465;71;31;2;29;.935;3660000;0
36487;146001;2473;69;20;1;19;.950;3660000;0
36488;166044;2474;83;57;5;52;.912;3600000;0
36488;-1;713;0;0;0;0;.00nan;0;0
36488;70115;2474;0;0;0;0;.00nan;0;0
36488;157000;713;66;17;1;16;.941;3600000;0
36489;-1;711;0;0;0;0;.00nan;0;0
36489;181748;714;93;38;2;36;.947;3900000;0
36489;78251;711;76;33;2;31;.939;3880000;0
36489;145636;714;0;0;0;0;.00nan;0;0
36490;26308;710;67;17;1;16;.941;3600000;0
36490;-1;710;0;0;0;0;.00nan;0;0
36490;72229;706;23;4;3;1;.250;302000;0
36490;160866;706;71;41;5;36;.878;3298000;0
36491;-1;711;0;0;0;0;.00nan;0;0
36491;-1;2465;95;53;3;50;.943;3600000;0
36491;78251;711;43;21;4;17;.810;3566000;0
36491;145733;2465;0;0;0;0;.00nan;0;0
36492;181748;714;74;26;1;25;.962;3550000;0
36492;-1;707;100;51;0;51;1.000;3600000;0
36492;145636;714;0;0;0;0;.00nan;0;0
36492;145843;707;0;0;0;0;.00nan;0;0
36493;166044;2474;57;31;4;27;.871;3600000;0
36493;-1;2465;67;44;5;39;.886;3551000;0
36493;70115;2474;0;0;0;0;.00nan;0;0
36493;145733;2465;0;0;0;0;.00nan;0;0
36494;-1;711;0;0;0;0;.00nan;0;0
36494;78251;711;75;27;2;25;.926;3900000;0
36494;85507;2473;91;35;2;33;.943;3900000;0
36494;146001;2473;0;0;0;0;.00nan;0;0
36495;-1;713;67;34;4;30;.882;3550000;0
36495;72229;706;0;0;0;0;.00nan;0;0
36495;157000;713;0;0;0;0;.00nan;0;0
36495;160866;706;55;26;3;23;.885;3600000;0
36496;170548;712;46;42;6;36;.857;3600000;0
36496;-1;712;0;0;0;0;.00nan;0;0
36496;26308;710;65;16;1;15;.938;3600000;0
36496;-1;710;0;0;0;0;.00nan;0;0
36497;166044;2474;0;0;0;0;.00nan;0;0
36497;-1;711;0;0;0;0;.00nan;0;0
36497;70115;2474;83;54;4;50;.926;3600000;0
36497;78251;711;62;14;1;13;.929;3600000;0
36498;26308;710;67;16;1;15;.938;3600000;0
36498;181748;714;98;49;2;47;.959;3600000;0
36498;-1;710;0;0;0;0;.00nan;0;0
36498;145636;714;0;0;0;0;.00nan;0;0
36499;170548;712;97;44;2;42;.955;3568000;0
36499;-1;712;0;0;0;0;.00nan;0;0
36499;72229;706;83;25;1;24;.960;3600000;0
36499;160866;706;0;0;0;0;.00nan;0;0
36500;-1;713;37;17;4;13;.765;3600000;0
36500;-1;2465;56;43;5;38;.884;3564000;0
36500;145733;2465;0;0;0;0;.00nan;0;0
36500;157000;713;0;0;0;0;.00nan;0;0
36501;-1;707;62;38;4;34;.895;3600000;0
36501;85507;2473;0;0;0;0;.00nan;0;0
36501;145843;707;0;0;0;0;.00nan;0;0
36501;146001;2473;43;16;3;13;.813;3600000;0
36502;181748;714;52;36;5;31;.861;3547000;0
36502;72229;706;69;36;3;33;.917;3600000;0
36502;145636;714;0;0;0;0;.00nan;0;0
36502;160866;706;0;0;0;0;.00nan;0;0
36503;166044;2474;62;26;2;24;.923;3558000;0
36503;-1;707;82;27;1;26;.963;3600000;0
36503;70115;2474;0;0;0;0;.00nan;0;0
36503;145843;707;0;0;0;0;.00nan;0;0
36504;26308;710;76;22;2;20;.909;3600000;0
36504;-1;710;0;0;0;0;.00nan;0;0
36504;85507;2473;0;0;0;0;.00nan;0;0
36504;146001;2473;69;38;4;34;.895;3600000;0
36505;-1;713;100;25;0;25;1.000;3600000;0
36505;170548;712;68;37;4;33;.892;3600000;0
36505;-1;712;0;0;0;0;.00nan;0;0
36505;157000;713;0;0;0;0;.00nan;0;0
36506;170548;712;79;21;1;20;.952;3600000;0
36506;-1;712;0;0;0;0;.00nan;0;0
36506;181748;714;80;42;3;39;.929;3600000;0
36506;145636;714;0;0;0;0;.00nan;0;0
36507;166044;2474;0;0;0;0;.00nan;0;0
36507;26308;710;61;12;1;11;.917;3600000;0
36507;-1;710;0;0;0;0;.00nan;0;0
36507;70115;2474;76;53;6;47;.887;3600000;0
36508;-1;2465;0;0;0;0;.00nan;0;0
36508;-1;707;90;52;3;49;.942;3900000;0
36508;145733;2465;47;16;3;13;.813;3900000;0
36508;145843;707;0;0;0;0;.00nan;0;0
36509;72229;706;0;0;0;0;.00nan;0;0
36509;85507;2473;0;0;0;0;.00nan;0;0
36509;146001;2473;52;22;3;19;.864;3592000;0
36509;160866;706;95;42;2;40;.952;3600000;0
36510;-1;713;78;28;1;27;.964;3600000;0
36510;-1;711;0;0;0;0;.00nan;0;0
36510;78251;711;73;30;2;28;.933;3544000;0
36510;157000;713;0;0;0;0;.00nan;0;0
36511;-1;713;0;0;0;0;.00nan;0;0
36511;181748;714;85;37;2;35;.946;3553000;0
36511;145636;714;0;0;0;0;.00nan;0;0
36511;157000;713;72;19;1;18;.947;3600000;0
36512;-1;711;0;0;0;0;.00nan;0;0
36512;-1;707;51;28;4;24;.857;3600000;0
36512;78251;711;61;22;2;20;.909;3600000;0
36512;145843;707;0;0;0;0;.00nan;0;0
36513;166044;2474;88;44;1;43;.977;3900000;0
36513;70115;2474;0;0;0;0;.00nan;0;0
36513;72229;706;66;16;1;15;.938;3900000;0
36513;160866;706;0;0;0;0;.00nan;0;0
36514;170548;712;81;31;2;29;.935;3600000;0
36514;-1;712;0;0;0;0;.00nan;0;0
36514;85507;2473;56;27;3;24;.889;3565000;0
36514;146001;2473;0;0;0;0;.00nan;0;0
36515;-1;713;92;17;0;17;1.000;3600000;0
36515;-1;707;78;41;3;38;.927;3600000;0
36515;145843;707;0;0;0;0;.00nan;0;0
36515;157000;713;0;0;0;0;.00nan;0;0
36516;166044;2474;100;42;2;40;.952;3600000;0
36516;170548;712;40;23;4;19;.826;3520000;0
36516;-1;712;0;0;0;0;.00nan;0;0
36516;70115;2474;0;0;0;0;.00nan;0;0
36517;-1;2465;100;25;0;25;1.000;3600000;0
36517;72229;706;64;27;2;25;.926;3525000;0
36517;145733;2465;0;0;0;0;.00nan;0;0
36517;160866;706;0;0;0;0;.00nan;0;0
36518;181748;714;66;41;4;37;.902;3793000;0
36518;85507;2473;42;18;3;15;.833;3793000;0
36518;145636;714;0;0;0;0;.00nan;0;0
36518;146001;2473;0;0;0;0;.00nan;0;0
36519;-1;711;82;35;2;33;.943;3600000;0
36519;26308;710;71;37;3;34;.919;3567000;0
36519;-1;710;0;0;0;0;.00nan;0;0
36519;78251;711;0;0;0;0;.00nan;0;0
36520;-1;713;91;32;1;31;.969;3600000;0
36520;26308;710;69;34;3;31;.912;3546000;0
36520;-1;710;0;0;0;0;.00nan;0;0
36520;157000;713;0;0;0;0;.00nan;0;0
36521;166044;2474;97;47;2;45;.957;3593000;0
36521;70115;2474;0;0;0;0;.00nan;0;0
36521;85507;2473;0;0;0;0;.00nan;0;0
36521;146001;2473;66;17;1;16;.941;3600000;0
36522;170548;712;75;30;2;28;.933;3600000;0
36522;-1;711;0;0;0;0;.00nan;0;0
36522;-1;712;0;0;0;0;.00nan;0;0
36522;78251;711;41;21;3;18;.857;3549000;0
36523;-1;707;0;0;0;0;.00nan;0;0
36523;72229;706;89;31;2;29;.935;3900000;0
36523;145843;707;84;33;2;31;.939;3900000;0
36523;160866;706;0;0;0;0;.00nan;0;0
36524;-1;2465;55;28;3;25;.893;3580000;0
36524;181748;714;87;36;2;34;.944;3600000;0
36524;145636;714;0;0;0;0;.00nan;0;0
36524;145733;2465;0;0;0;0;.00nan;0;0
36525;166044;2474;47;24;4;20;.833;1159000;0
36525;70115;2474;33;30;5;25;.833;2441000;0
36525;72229;706;76;25;1;24;.960;3600000;0
36525;160866;706;0;0;0;0;.00nan;0;0
36526;-1;711;0;0;0;0;.00nan;0;0
36526;181748;714;96;30;0;30;1.000;3900000;0
36526;78251;711;100;24;0;24;1.000;3900000;0
36526;145636;714;0;0;0;0;.00nan;0;0
36527;-1;2465;61;35;3;32;.914;3900000;0
36527;85507;2473;0;0;0;0;.00nan;0;0
36527;145733;2465;0;0;0;0;.00nan;0;0
36527;146001;2473;50;25;3;22;.880;3900000;0
36528;170548;712;69;29;2;27;.931;3600000;0
36528;-1;712;0;0;0;0;.00nan;0;0
36528;-1;707;32;16;4;12;.750;1002000;0
36528;145843;707;46;14;2;12;.857;2598000;0
36529;26308;710;47;17;3;14;.824;3600000;0
36529;-1;2465;47;36;5;31;.861;3517000;0
36529;-1;710;0;0;0;0;.00nan;0;0
36529;145733;2465;0;0;0;0;.00nan;0;0
36530;-1;713;79;37;3;34;.919;3754000;0
36530;72229;706;75;29;2;27;.931;3754000;0
36530;157000;713;0;0;0;0;.00nan;0;0
36530;160866;706;0;0;0;0;.00nan;0;0
36531;-1;711;0;0;0;0;.00nan;0;0
36531;78251;711;81;29;2;27;.931;3600000;0
36531;85507;2473;66;32;3;29;.906;3573000;0
36531;146001;2473;0;0;0;0;.00nan;0;0
36532;181748;714;100;26;0;26;1.000;3600000;0
36532;-1;707;88;35;1;34;.971;3567000;0
36532;145636;714;0;0;0;0;.00nan;0;0
36532;145843;707;0;0;0;0;.00nan;0;0
36533;170548;712;97;53;3;50;.943;3565000;0
36533;-1;712;0;0;0;0;.00nan;0;0
36533;26308;710;72;19;1;18;.947;3600000;0
36533;-1;710;0;0;0;0;.00nan;0;0
36534;166044;2474;57;50;6;44;.880;3600000;0
36534;-1;2465;99;29;1;28;.966;3600000;0
36534;70115;2474;0;0;0;0;.00nan;0;0
36534;145733;2465;0;0;0;0;.00nan;0;0
36535;-1;713;56;19;2;17;.895;3600000;0
36535;-1;2465;72;43;5;38;.884;3600000;0
36535;145733;2465;0;0;0;0;.00nan;0;0
36535;157000;713;0;0;0;0;.00nan;0;0
36536;26308;710;49;20;3;17;.850;3600000;0
36536;181748;714;37;41;7;34;.829;3600000;0
36536;-1;710;0;0;0;0;.00nan;0;0
36536;145636;714;0;0;0;0;.00nan;0;0
36537;-1;707;63;48;6;42;.875;3600000;0
36537;85507;2473;0;0;0;0;.00nan;0;0
36537;145843;707;0;0;0;0;.00nan;0;0
36537;146001;2473;61;20;2;18;.900;3600000;0
36538;170548;712;88;22;1;21;.955;3600000;0
36538;-1;712;0;0;0;0;.00nan;0;0
36538;72229;706;76;25;2;23;.920;3567000;0
36538;160866;706;0;0;0;0;.00nan;0;0
36539;166044;2474;0;0;0;0;.00nan;0;0
36539;-1;711;0;0;0;0;.00nan;0;0
36539;70115;2474;52;51;7;44;.863;3600000;0
36539;78251;711;53;16;2;14;.875;3600000;0
36540;-1;713;77;31;2;29;.935;3600000;0
36540;170548;712;34;43;8;35;.814;3600000;0
36540;-1;712;0;0;0;0;.00nan;0;0
36540;157000;713;0;0;0;0;.00nan;0;0
36541;166044;2474;49;25;4;21;.840;3011000;0
36541;-1;707;94;27;1;26;.963;3600000;0
36541;70115;2474;26;7;3;4;.571;589000;0
36541;145843;707;0;0;0;0;.00nan;0;0
36542;26308;710;94;23;0;23;1.000;3600000;0
36542;-1;710;0;0;0;0;.00nan;0;0
36542;85507;2473;63;28;3;25;.893;3600000;0
36542;146001;2473;0;0;0;0;.00nan;0;0
36543;-1;711;0;0;0;0;.00nan;0;0
36543;-1;2465;28;30;6;24;.800;2827000;0
36543;78251;711;75;10;0;10;1.000;3600000;0
36543;145733;2465;66;11;0;11;1.000;773000;0
36544;181748;714;90;29;1;28;.966;3600000;0
36544;72229;706;0;0;0;0;.00nan;0;0
36544;145636;714;0;0;0;0;.00nan;0;0
36544;160866;706;71;30;3;27;.900;3534000;0
36545;-1;2465;38;20;4;16;.800;3542000;0
36545;-1;707;95;44;2;42;.955;3600000;0
36545;145733;2465;0;0;0;0;.00nan;0;0
36545;145843;707;0;0;0;0;.00nan;0;0
36546;166044;2474;0;0;0;0;.00nan;0;0
36546;26308;710;66;5;0;5;1.000;3600000;0
36546;-1;710;0;0;0;0;.00nan;0;0
36546;70115;2474;98;57;3;54;.947;3600000;0
36547;72229;706;82;33;1;32;.970;3566000;0
36547;85507;2473;97;22;0;22;1.000;3600000;0
36547;146001;2473;0;0;0;0;.00nan;0;0
36547;160866;706;0;0;0;0;.00nan;0;0
36548;170548;712;87;27;1;26;.963;3600000;0
36548;-1;712;0;0;0;0;.00nan;0;0
36548;181748;714;76;45;4;41;.911;3600000;0
36548;145636;714;0;0;0;0;.00nan;0;0
36549;-1;713;74;26;2;24;.923;3600000;0
36549;-1;711;0;0;0;0;.00nan;0;0
36549;78251;711;45;28;4;24;.857;3562000;0
36549;157000;713;0;0;0;0;.00nan;0;0
36550;170548;712;94;20;0;20;1.000;3600000;0
36550;-1;712;0;0;0;0;.00nan;0;0
36550;-1;2465;22;4;3;1;.250;308000;0
36550;145733;2465;48;27;4;23;.852;3292000;0
36551;-1;713;80;27;1;26;.963;3600000;0
36551;181748;714;0;0;0;0;.00nan;0;0
36551;145636;714;73;34;3;31;.912;3562000;0
36551;157000;713;0;0;0;0;.00nan;0;0
36552;166044;2474;0;0;0;0;.00nan;0;0
36552;70115;2474;100;51;2;49;.961;3900000;0
36552;72229;706;61;22;2;20;.909;3900000;0
36552;160866;706;0;0;0;0;.00nan;0;0
36553;-1;711;0;0;0;0;.00nan;0;0
36553;-1;707;76;52;5;47;.904;3600000;0
36553;78251;711;70;14;1;13;.929;3600000;0
36553;145843;707;0;0;0;0;.00nan;0;0
36554;26308;710;85;17;0;17;1.000;3600000;0
36554;-1;2465;67;11;0;11;1.000;943000;0
36554;-1;710;0;0;0;0;.00nan;0;0
36554;145733;2465;32;30;6;24;.800;2657000;0
36555;170548;712;70;40;4;36;.900;3562000;0
36555;-1;712;0;0;0;0;.00nan;0;0
36555;85507;2473;52;24;3;21;.875;3600000;0
36555;146001;2473;0;0;0;0;.00nan;0;0
36556;181748;714;82;30;2;28;.933;3600000;0
36556;85507;2473;52;26;4;22;.846;3600000;0
36556;145636;714;0;0;0;0;.00nan;0;0
36556;146001;2473;0;0;0;0;.00nan;0;0
36557;-1;711;0;0;0;0;.00nan;0;0
36557;26308;710;39;17;3;14;.824;3583000;0
36557;-1;710;0;0;0;0;.00nan;0;0
36557;78251;711;97;36;1;35;.972;3600000;0
36558;-1;2465;35;21;4;17;.810;3532000;0
36558;72229;706;73;29;2;27;.931;3600000;0
36558;145733;2465;0;0;0;0;.00nan;0;0
36558;160866;706;0;0;0;0;.00nan;0;0
36559;-1;713;63;14;1;13;.929;3600000;0
36559;-1;707;76;45;4;41;.911;3600000;0
36559;145843;707;0;0;0;0;.00nan;0;0
36559;157000;713;0;0;0;0;.00nan;0;0
36560;166044;2474;0;0;0;0;.00nan;0;0
36560;170548;712;0;0;0;0;.00nan;0;0
36560;-1;712;31;26;5;21;.808;3548000;0
36560;70115;2474;92;50;3;47;.940;3600000;0
36561;-1;713;0;0;0;0;.00nan;0;0
36561;85507;2473;0;0;0;0;.00nan;0;0
36561;146001;2473;100;33;0;33;1.000;3600000;0
36561;157000;713;74;31;2;29;.935;3553000;0
36562;166044;2474;69;30;2;28;.933;3789000;0
36562;181748;714;85;28;1;27;.964;3789000;0
36562;70115;2474;0;0;0;0;.00nan;0;0
36562;145636;714;0;0;0;0;.00nan;0;0
36563;-1;711;0;0;0;0;.00nan;0;0
36563;72229;706;49;30;5;25;.833;3600000;0
36563;78251;711;74;22;2;20;.909;3600000;0
36563;160866;706;0;0;0;0;.00nan;0;0
36564;26308;710;83;14;0;14;1.000;3600000;0
36564;-1;707;65;57;7;50;.877;3600000;0
36564;-1;710;0;0;0;0;.00nan;0;0
36564;145843;707;0;0;0;0;.00nan;0;0
36565;-1;2465;40;30;5;25;.833;3552000;0
36565;181748;714;86;39;3;36;.923;3600000;0
36565;145636;714;0;0;0;0;.00nan;0;0
36565;145733;2465;0;0;0;0;.00nan;0;0
36566;-1;713;12;29;7;22;.759;2673000;0
36566;26308;710;72;28;3;25;.893;3600000;0
36566;-1;710;0;0;0;0;.00nan;0;0
36566;157000;713;60;7;0;7;1.000;927000;0
36567;166044;2474;0;0;0;0;.00nan;0;0
36567;70115;2474;76;45;5;40;.889;3600000;0
36567;85507;2473;0;0;0;0;.00nan;0;0
36567;146001;2473;97;25;0;25;1.000;3600000;0
36568;-1;707;93;45;2;43;.956;3585000;0
36568;72229;706;77;10;0;10;1.000;3600000;0
36568;145843;707;0;0;0;0;.00nan;0;0
36568;160866;706;0;0;0;0;.00nan;0;0
36569;170548;712;83;36;2;34;.944;3559000;0
36569;-1;711;0;0;0;0;.00nan;0;0
36569;-1;712;0;0;0;0;.00nan;0;0
36569;78251;711;68;13;1;12;.923;3600000;0
36570;166044;2474;0;0;0;0;.00nan;0;0
36570;-1;713;60;15;1;14;.933;3600000;0
36570;70115;2474;95;41;2;39;.951;3600000;0
36570;157000;713;0;0;0;0;.00nan;0;0
36571;-1;711;0;0;0;0;.00nan;0;0
36571;181748;714;49;23;4;19;.826;3600000;0
36571;78251;711;100;31;0;31;1.000;3600000;0
36571;145636;714;0;0;0;0;.00nan;0;0
36572;170548;712;57;18;2;16;.889;3600000;0
36572;-1;712;0;0;0;0;.00nan;0;0
36572;-1;707;0;0;0;0;.00nan;0;0
36572;145843;707;45;38;6;32;.842;3600000;0
36573;26308;710;0;0;0;0;.00nan;0;0
36573;-1;710;45;12;2;10;.833;3600000;0
36573;72229;706;57;39;5;34;.872;3600000;0
36573;160866;706;0;0;0;0;.00nan;0;0
36574;-1;2465;0;0;0;0;.00nan;0;0
36574;85507;2473;0;0;0;0;.00nan;0;0
36574;145733;2465;95;22;0;22;1.000;3600000;0
36574;146001;2473;54;23;3;20;.870;3600000;0
36575;181748;714;82;24;1;23;.958;3600000;0
36575;-1;707;63;28;3;25;.893;3578000;0
36575;145636;714;0;0;0;0;.00nan;0;0
36575;145843;707;0;0;0;0;.00nan;0;0
36576;166044;2474;66;20;2;18;.900;1630000;0
36576;-1;2465;0;0;0;0;.00nan;0;0
36576;70115;2474;11;22;7;15;.682;1970000;0
36576;145733;2465;61;18;2;16;.889;3600000;0
36577;-1;711;0;0;0;0;.00nan;0;0
36577;78251;711;71;28;2;26;.929;3613000;0
36577;85507;2473;80;24;1;23;.958;3613000;0
36577;146001;2473;0;0;0;0;.00nan;0;0
36578;-1;713;70;27;1;26;.963;3600000;0
36578;72229;706;17;7;4;3;.429;1118000;0
36578;157000;713;0;0;0;0;.00nan;0;0
36578;160866;706;33;32;6;26;.813;2482000;0
36579;170548;712;73;55;6;49;.891;3600000;0
36579;-1;712;0;0;0;0;.00nan;0;0
36579;26308;710;76;11;0;11;1.000;3600000;0
36579;-1;710;0;0;0;0;.00nan;0;0
36580;166044;2474;71;38;4;34;.895;3697000;0
36580;-1;711;0;0;0;0;.00nan;0;0
36580;70115;2474;0;0;0;0;.00nan;0;0
36580;78251;711;44;19;3;16;.842;3697000;0
36581;-1;707;62;33;5;28;.848;2348000;0
36581;85507;2473;72;9;0;9;1.000;3600000;0
36581;145843;707;75;13;0;13;1.000;1252000;0
36581;146001;2473;0;0;0;0;.00nan;0;0
36582;26308;710;63;25;2;23;.920;3600000;0
36582;181748;714;29;9;3;6;.667;572000;0
36582;-1;710;0;0;0;0;.00nan;0;0
36582;145636;714;71;25;1;24;.960;2994000;0
36583;-1;713;46;17;3;14;.824;3600000;0
36583;-1;2465;33;31;6;25;.806;2820000;0
36583;145733;2465;56;5;0;5;1.000;780000;0
36583;157000;713;0;0;0;0;.00nan;0;0
36584;170548;712;67;29;3;26;.897;3514000;0
36584;-1;712;0;0;0;0;.00nan;0;0
36584;72229;706;0;0;0;0;.00nan;0;0
36584;160866;706;84;30;1;29;.967;3600000;0
36585;181748;714;58;27;3;24;.889;3600000;0
36585;72229;706;37;27;5;22;.815;3525000;0
36585;145636;714;0;0;0;0;.00nan;0;0
36585;160866;706;0;0;0;0;.00nan;0;0
36586;166044;2474;55;32;4;28;.875;3600000;0
36586;-1;707;80;25;1;24;.960;3600000;0
36586;70115;2474;0;0;0;0;.00nan;0;0
36586;145843;707;0;0;0;0;.00nan;0;0
36587;-1;711;0;0;0;0;.00nan;0;0
36587;-1;2465;65;35;3;32;.914;3600000;0
36587;78251;711;77;24;1;23;.958;3600000;0
36587;145733;2465;0;0;0;0;.00nan;0;0
36588;-1;713;85;25;1;24;.960;3600000;0
36588;170548;712;51;35;5;30;.857;3600000;0
36588;-1;712;0;0;0;0;.00nan;0;0
36588;157000;713;0;0;0;0;.00nan;0;0
36589;26308;710;68;17;1;16;.941;3600000;0
36589;-1;710;0;0;0;0;.00nan;0;0
36589;85507;2473;85;55;5;50;.909;3600000;0
36589;146001;2473;0;0;0;0;.00nan;0;0
36590;170548;712;54;36;5;31;.861;3600000;0
36590;-1;712;0;0;0;0;.00nan;0;0
36590;181748;714;56;27;4;23;.852;3600000;0
36590;145636;714;0;0;0;0;.00nan;0;0
36591;166044;2474;33;61;9;52;.852;3600000;0
36591;26308;710;77;11;0;11;1.000;3600000;0
36591;-1;710;0;0;0;0;.00nan;0;0
36591;70115;2474;0;0;0;0;.00nan;0;0
36592;-1;713;37;34;6;28;.824;3550000;0
36592;-1;711;0;0;0;0;.00nan;0;0
36592;78251;711;38;16;4;12;.750;3600000;0
36592;157000;713;0;0;0;0;.00nan;0;0
36593;-1;2465;0;0;0;0;.00nan;0;0
36593;-1;707;67;40;5;35;.875;3600000;0
36593;145733;2465;54;20;2;18;.900;3600000;0
36593;145843;707;0;0;0;0;.00nan;0;0
36594;72229;706;85;28;1;27;.964;3600000;0
36594;85507;2473;76;32;2;30;.938;3543000;0
36594;146001;2473;0;0;0;0;.00nan;0;0
36594;160866;706;0;0;0;0;.00nan;0;0
36595;-1;713;0;0;0;0;.00nan;0;0
36595;181748;714;61;45;5;40;.889;3590000;0
36595;145636;714;0;0;0;0;.00nan;0;0
36595;157000;713;54;21;3;18;.857;3600000;0
36596;-1;711;0;0;0;0;.00nan;0;0
36596;-1;707;0;0;0;0;.00nan;0;0
36596;78251;711;40;16;3;13;.813;3573000;0
36596;145843;707;99;49;2;47;.959;3600000;0
36597;26308;710;61;13;1;12;.923;3600000;0
36597;-1;2465;0;0;0;0;.00nan;0;0
36597;-1;710;0;0;0;0;.00nan;0;0
36597;145733;2465;78;47;3;44;.936;3556000;0
36598;166044;2474;0;0;0;0;.00nan;0;0
36598;70115;2474;86;50;5;45;.900;3600000;0
36598;72229;706;49;17;3;14;.824;3600000;0
36598;160866;706;0;0;0;0;.00nan;0;0
36599;170548;712;26;30;6;24;.800;3600000;0
36599;-1;712;0;0;0;0;.00nan;0;0
36599;85507;2473;66;28;3;25;.893;3600000;0
36599;146001;2473;0;0;0;0;.00nan;0;0
36600;-1;713;49;8;1;7;.875;3600000;0
36600;-1;707;71;65;7;58;.892;3600000;0
36600;145843;707;0;0;0;0;.00nan;0;0
36600;157000;713;0;0;0;0;.00nan;0;0
36601;166044;2474;45;27;4;23;.852;2146000;0
36601;170548;712;79;31;2;29;.935;3600000;0
36601;-1;712;0;0;0;0;.00nan;0;0
36601;70115;2474;54;17;2;15;.882;1454000;0
36602;-1;711;0;0;0;0;.00nan;0;0
36602;26308;710;65;24;2;22;.917;3600000;0
36602;-1;710;0;0;0;0;.00nan;0;0
36602;78251;711;44;28;5;23;.821;3600000;0
36603;-1;2465;70;24;2;22;.917;3600000;0
36603;72229;706;57;32;4;28;.875;3534000;0
36603;145733;2465;0;0;0;0;.00nan;0;0
36603;160866;706;0;0;0;0;.00nan;0;0
36604;181748;714;84;43;3;40;.930;3600000;0
36604;85507;2473;0;0;0;0;.00nan;0;0
36604;145636;714;0;0;0;0;.00nan;0;0
36604;146001;2473;52;28;4;24;.857;3571000;0
36605;166044;2474;79;46;3;43;.935;3600000;0
36605;181748;714;46;24;5;19;.792;3600000;0
36605;70115;2474;0;0;0;0;.00nan;0;0
36605;145636;714;0;0;0;0;.00nan;0;0
36606;26308;710;43;19;4;15;.789;3600000;0
36606;-1;707;65;60;8;52;.867;3600000;0
36606;-1;710;0;0;0;0;.00nan;0;0
36606;145843;707;0;0;0;0;.00nan;0;0
36607;-1;713;0;0;0;0;.00nan;0;0
36607;85507;2473;69;40;4;36;.900;3600000;0
36607;146001;2473;0;0;0;0;.00nan;0;0
36607;157000;713;81;34;2;32;.941;3600000;0
36608;-1;711;0;0;0;0;.00nan;0;0
36608;72229;706;93;41;1;40;.976;3569000;0
36608;78251;711;87;16;0;16;1.000;3600000;0
36608;160866;706;0;0;0;0;.00nan;0;0
36609;170548;712;64;33;3;30;.909;3900000;0
36609;-1;712;0;0;0;0;.00nan;0;0
36609;-1;2465;0;0;0;0;.00nan;0;0
36609;145733;2465;81;42;3;39;.929;3900000;0
36610;-1;713;0;0;0;0;.00nan;0;0
36610;26308;710;90;25;1;24;.960;3600000;0
36610;-1;710;0;0;0;0;.00nan;0;0
36610;157000;713;62;32;4;28;.875;3600000;0
36611;166044;2474;26;26;6;20;.769;1850000;0
36611;70115;2474;41;18;3;15;.833;1750000;0
36611;85507;2473;65;16;2;14;.875;3600000;0
36611;146001;2473;0;0;0;0;.00nan;0;0
36612;170548;712;22;12;4;8;.667;1028000;0
36612;-1;711;0;0;0;0;.00nan;0;0
36612;-1;712;47;31;6;25;.806;2572000;0
36612;78251;711;83;31;1;30;.968;3600000;0
36613;-1;707;27;33;6;27;.818;3600000;0
36613;72229;706;49;21;3;18;.857;3600000;0
36613;145843;707;0;0;0;0;.00nan;0;0
36613;160866;706;0;0;0;0;.00nan;0;0
36614;-1;2465;55;4;0;4;1.000;320000;0
36614;181748;714;86;33;2;31;.939;3600000;0
36614;145636;714;0;0;0;0;.00nan;0;0
36614;145733;2465;39;29;6;23;.793;3280000;0
36615;166044;2474;0;0;0;0;.00nan;0;0
36615;-1;713;63;15;0;15;1.000;3900000;0
36615;70115;2474;100;36;0;36;1.000;3900000;0
36615;157000;713;0;0;0;0;.00nan;0;0
36616;-1;2465;0;0;0;0;.00nan;0;0
36616;85507;2473;0;0;0;0;.00nan;0;0
36616;145733;2465;64;37;5;32;.865;3600000;0
36616;146001;2473;74;18;1;17;.944;3600000;0
36617;26308;710;63;13;1;12;.923;3600000;0
36617;-1;710;0;0;0;0;.00nan;0;0
36617;72229;706;0;0;0;0;.00nan;0;0
36617;160866;706;60;45;5;40;.889;3600000;0
36618;170548;712;61;18;2;16;.889;3600000;0
36618;-1;712;0;0;0;0;.00nan;0;0
36618;-1;707;74;36;3;33;.917;3546000;0
36618;145843;707;0;0;0;0;.00nan;0;0
36619;-1;711;0;0;0;0;.00nan;0;0
36619;181748;714;98;46;3;43;.935;3529000;0
36619;78251;711;79;29;1;28;.966;3600000;0
36619;145636;714;0;0;0;0;.00nan;0;0
36620;-1;713;47;28;4;24;.857;3579000;0
36620;72229;706;79;34;4;30;.882;3600000;0
36620;157000;713;0;0;0;0;.00nan;0;0
36620;160866;706;0;0;0;0;.00nan;0;0
36621;-1;711;73;18;1;17;.944;3600000;0
36621;78251;711;0;0;0;0;.00nan;0;0
36621;85507;2473;58;31;4;27;.871;3600000;0
36621;146001;2473;0;0;0;0;.00nan;0;0
36622;181748;714;37;17;4;13;.765;3581000;0
36622;-1;707;0;0;0;0;.00nan;0;0
36622;145636;714;0;0;0;0;.00nan;0;0
36622;145843;707;85;35;2;33;.943;3600000;0
36623;170548;712;58;31;4;27;.871;3682000;0
36623;-1;712;0;0;0;0;.00nan;0;0
36623;26308;710;45;23;5;18;.783;3682000;0
36623;-1;710;0;0;0;0;.00nan;0;0
36624;166044;2474;0;0;0;0;.00nan;0;0
36624;-1;2465;0;0;0;0;.00nan;0;0
36624;70115;2474;95;62;3;59;.952;3900000;0
36624;145733;2465;53;18;3;15;.833;3900000;0
36625;26308;710;78;24;1;23;.958;3600000;0
36625;181748;714;46;33;5;28;.848;3600000;0
36625;-1;710;0;0;0;0;.00nan;0;0
36625;145636;714;0;0;0;0;.00nan;0;0
36626;-1;713;0;0;0;0;.00nan;0;0
36626;-1;2465;0;0;0;0;.00nan;0;0
36626;145733;2465;91;42;2;40;.952;3900000;0
36626;157000;713;61;22;2;20;.909;3900000;0
36627;-1;707;81;45;3;42;.933;3564000;0
36627;85507;2473;65;25;2;23;.920;3600000;0
36627;145843;707;0;0;0;0;.00nan;0;0
36627;146001;2473;0;0;0;0;.00nan;0;0
36628;170548;712;68;28;3;25;.893;3600000;0
36628;-1;712;0;0;0;0;.00nan;0;0
36628;72229;706;55;26;4;22;.846;3600000;0
36628;160866;706;0;0;0;0;.00nan;0;0
36629;166044;2474;92;51;2;49;.961;3600000;0
36629;-1;711;0;0;0;0;.00nan;0;0
36629;70115;2474;0;0;0;0;.00nan;0;0
36629;78251;711;77;9;0;9;1.000;3600000;0
36630;-1;713;41;25;4;21;.840;3563000;0
36630;-1;711;0;0;0;0;.00nan;0;0
36630;78251;711;83;32;2;30;.938;3600000;0
36630;157000;713;0;0;0;0;.00nan;0;0
36631;-1;2465;0;0;0;0;.00nan;0;0
36631;-1;707;0;0;0;0;.00nan;0;0
36631;145733;2465;81;22;1;21;.955;3600000;0
36631;145843;707;79;45;5;40;.889;3600000;0
36632;166044;2474;84;63;6;57;.905;3600000;0
36632;26308;710;59;14;2;12;.857;3600000;0
36632;-1;710;0;0;0;0;.00nan;0;0
36632;70115;2474;0;0;0;0;.00nan;0;0
36633;72229;706;58;30;3;27;.900;3600000;0
36633;85507;2473;48;24;4;20;.833;3552000;0
36633;146001;2473;0;0;0;0;.00nan;0;0
36633;160866;706;0;0;0;0;.00nan;0;0
36634;170548;712;64;18;2;16;.889;3900000;0
36634;-1;712;0;0;0;0;.00nan;0;0
36634;181748;714;96;46;2;44;.957;3900000;0
36634;145636;714;0;0;0;0;.00nan;0;0
36635;166044;2474;51;35;4;31;.886;3583000;0
36635;70115;2474;0;0;0;0;.00nan;0;0
36635;72229;706;83;31;2;29;.935;3600000;0
36635;160866;706;0;0;0;0;.00nan;0;0
36636;26308;710;74;28;1;27;.964;3600000;0
36636;-1;2465;74;40;3;37;.925;3516000;0
36636;-1;710;0;0;0;0;.00nan;0;0
36636;145733;2465;0;0;0;0;.00nan;0;0
36637;170548;712;83;44;3;41;.932;3513000;0
36637;-1;712;0;0;0;0;.00nan;0;0
36637;85507;2473;0;0;0;0;.00nan;0;0
36637;146001;2473;79;27;1;26;.963;3600000;0
36638;-1;713;100;29;0;29;1.000;3600000;0
36638;181748;714;63;43;5;38;.884;3600000;0
36638;145636;714;0;0;0;0;.00nan;0;0
36638;157000;713;0;0;0;0;.00nan;0;0
36639;-1;711;0;0;0;0;.00nan;0;0
36639;-1;707;89;56;4;52;.929;3900000;0
36639;78251;711;43;15;4;11;.733;3900000;0
36639;145843;707;0;0;0;0;.00nan;0;0
36640;181748;714;65;25;2;23;.920;3600000;0
36640;85507;2473;40;22;4;18;.818;3600000;0
36640;145636;714;0;0;0;0;.00nan;0;0
36640;146001;2473;0;0;0;0;.00nan;0;0
36641;-1;713;89;19;0;19;1.000;3600000;0
36641;-1;707;42;38;6;32;.842;2841000;0
36641;145843;707;67;17;1;16;.941;759000;0
36641;157000;713;0;0;0;0;.00nan;0;0
36642;-1;711;0;0;0;0;.00nan;0;0
36642;26308;710;44;15;3;12;.800;3900000;0
36642;-1;710;0;0;0;0;.00nan;0;0
36642;78251;711;61;31;3;28;.903;3900000;0
36643;-1;2465;0;0;0;0;.00nan;0;0
36643;72229;706;80;32;2;30;.938;3783000;0
36643;145733;2465;77;38;3;35;.921;3767000;0
36643;160866;706;0;0;0;0;.00nan;0;0
36644;166044;2474;66;36;4;32;.889;3600000;0
36644;170548;712;74;24;1;23;.958;3600000;0
36644;-1;712;0;0;0;0;.00nan;0;0
36644;70115;2474;0;0;0;0;.00nan;0;0
36645;-1;713;88;27;1;26;.963;3600000;0
36645;85507;2473;67;36;3;33;.917;3534000;0
36645;146001;2473;0;0;0;0;.00nan;0;0
36645;157000;713;0;0;0;0;.00nan;0;0
36646;26308;710;46;18;3;15;.833;3632000;0
36646;-1;707;99;65;2;63;.969;3632000;0
36646;-1;710;0;0;0;0;.00nan;0;0
36646;145843;707;0;0;0;0;.00nan;0;0
36647;170548;712;78;33;2;31;.939;3600000;0
36647;-1;712;0;0;0;0;.00nan;0;0
36647;-1;2465;0;0;0;0;.00nan;0;0
36647;145733;2465;51;27;3;24;.889;3544000;0
36648;166044;2474;0;0;0;0;.00nan;0;0
36648;181748;714;71;29;3;26;.897;3572000;0
36648;70115;2474;77;39;2;37;.949;3600000;0
36648;145636;714;0;0;0;0;.00nan;0;0
36649;-1;711;0;0;0;0;.00nan;0;0
36649;72229;706;50;49;6;43;.878;3600000;0
36649;78251;711;64;13;1;12;.923;3600000;0
36649;160866;706;0;0;0;0;.00nan;0;0
36650;-1;2465;0;0;0;0;.00nan;0;0
36650;181748;714;31;23;5;18;.783;3600000;0
36650;145636;714;0;0;0;0;.00nan;0;0
36650;145733;2465;75;25;1;24;.960;3600000;0
36651;166044;2474;70;45;5;40;.889;3600000;0
36651;70115;2474;0;0;0;0;.00nan;0;0
36651;85507;2473;31;27;6;21;.778;3589000;0
36651;146001;2473;0;0;0;0;.00nan;0;0
36652;-1;707;26;32;7;25;.781;2106000;0
36652;72229;706;63;23;2;21;.913;3600000;0
36652;145843;707;48;12;2;10;.833;1494000;0
36652;160866;706;0;0;0;0;.00nan;0;0
36653;170548;712;88;39;2;37;.949;3600000;0
36653;-1;711;0;0;0;0;.00nan;0;0
36653;-1;712;0;0;0;0;.00nan;0;0
36653;78251;711;72;32;3;29;.906;3552000;0
36654;-1;713;98;48;3;45;.938;3600000;0
36654;26308;710;100;25;0;25;1.000;3600000;0
36654;-1;710;0;0;0;0;.00nan;0;0
36654;157000;713;0;0;0;0;.00nan;0;0
36655;-1;2465;0;0;0;0;.00nan;0;0
36655;85507;2473;100;31;0;31;1.000;3600000;0
36655;145733;2465;77;35;2;33;.943;3516000;0
36655;146001;2473;0;0;0;0;.00nan;0;0
36656;166044;2474;81;48;5;43;.896;3600000;0
36656;-1;713;0;0;0;0;.00nan;0;0
36656;70115;2474;0;0;0;0;.00nan;0;0
36656;157000;713;61;20;2;18;.900;3600000;0
36657;-1;711;0;0;0;0;.00nan;0;0
36657;181748;714;70;35;4;31;.886;3551000;0
36657;78251;711;44;14;3;11;.786;3600000;0
36657;145636;714;0;0;0;0;.00nan;0;0
36658;170548;712;100;35;0;35;1.000;3600000;0
36658;-1;712;0;0;0;0;.00nan;0;0
36658;-1;707;65;34;3;31;.912;3600000;0
36658;145843;707;0;0;0;0;.00nan;0;0
36659;26308;710;77;29;3;26;.897;3600000;0
36659;-1;710;0;0;0;0;.00nan;0;0
36659;72229;706;69;52;6;46;.885;3600000;0
36659;160866;706;0;0;0;0;.00nan;0;0
36660;181748;714;49;15;2;13;.867;3600000;0
36660;-1;707;45;29;5;24;.828;3600000;0
36660;145636;714;0;0;0;0;.00nan;0;0
36660;145843;707;0;0;0;0;.00nan;0;0
36661;166044;2474;82;55;4;51;.927;3600000;0
36661;-1;2465;31;19;5;14;.737;3566000;0
36661;70115;2474;0;0;0;0;.00nan;0;0
36661;145733;2465;0;0;0;0;.00nan;0;0
36662;-1;711;67;21;1;20;.952;3086000;0
36662;78251;711;31;6;3;3;.500;514000;0
36662;85507;2473;80;29;2;27;.931;3600000;0
36662;146001;2473;0;0;0;0;.00nan;0;0
36663;-1;713;47;20;3;17;.850;3600000;0
36663;72229;706;0;0;0;0;.00nan;0;0
36663;157000;713;0;0;0;0;.00nan;0;0
36663;160866;706;80;31;2;29;.935;3600000;0
36664;170548;712;71;47;5;42;.894;3600000;0
36664;-1;712;0;0;0;0;.00nan;0;0
36664;26308;710;65;21;2;19;.905;3600000;0
36664;-1;710;0;0;0;0;.00nan;0;0
36665;-1;707;98;56;3;53;.946;3600000;0
36665;85507;2473;74;9;0;9;1.000;3600000;0
36665;145843;707;0;0;0;0;.00nan;0;0
36665;146001;2473;0;0;0;0;.00nan;0;0
36666;26308;710;66;21;2;19;.905;3600000;0
36666;181748;714;68;44;4;40;.909;3600000;0
36666;-1;710;0;0;0;0;.00nan;0;0
36666;145636;714;0;0;0;0;.00nan;0;0
36667;170548;712;25;12;4;8;.667;801000;0
36667;-1;712;51;26;4;22;.846;2799000;0
36667;72229;706;87;31;2;29;.935;3600000;0
36667;160866;706;0;0;0;0;.00nan;0;0
36668;-1;713;62;23;2;21;.913;3574000;0
36668;-1;2465;100;32;0;32;1.000;3600000;0
36668;145733;2465;0;0;0;0;.00nan;0;0
36668;157000;713;0;0;0;0;.00nan;0;0
36669;166044;2474;84;55;5;50;.909;3521000;0
36669;-1;711;0;0;0;0;.00nan;0;0
36669;70115;2474;0;0;0;0;.00nan;0;0
36669;78251;711;67;26;3;23;.885;3600000;0
36670;181748;714;75;46;5;41;.891;3610000;0
36670;72229;706;59;33;4;29;.879;3610000;0
36670;145636;714;0;0;0;0;.00nan;0;0
36670;160866;706;0;0;0;0;.00nan;0;0
36671;166044;2474;0;0;0;0;.00nan;0;0
36671;-1;707;76;33;3;30;.909;3600000;0
36671;70115;2474;42;27;4;23;.852;3591000;0
36671;145843;707;0;0;0;0;.00nan;0;0
36672;-1;711;0;0;0;0;.00nan;0;0
36672;-1;2465;26;11;4;7;.636;1107000;0
36672;78251;711;92;19;0;19;1.000;3600000;0
36672;145733;2465;47;21;3;18;.857;2493000;0
36673;26308;710;53;25;4;21;.840;3600000;0
36673;-1;710;0;0;0;0;.00nan;0;0
36673;85507;2473;26;29;6;23;.793;2007000;0
36673;146001;2473;77;19;0;19;1.000;1520000;0
36674;-1;713;40;23;4;19;.826;3559000;0
36674;170548;712;91;41;3;38;.927;3600000;0
36674;-1;712;0;0;0;0;.00nan;0;0
36674;157000;713;0;0;0;0;.00nan;0;0
36675;-1;713;87;17;0;17;1.000;3600000;0
36675;181748;714;71;43;4;39;.907;3600000;0
36675;145636;714;0;0;0;0;.00nan;0;0
36675;157000;713;0;0;0;0;.00nan;0;0
36676;26308;710;57;21;3;18;.857;3600000;0
36676;-1;2465;0;0;0;0;.00nan;0;0
36676;-1;710;0;0;0;0;.00nan;0;0
36676;145733;2465;70;45;4;41;.911;3557000;0
36677;170548;712;54;38;6;32;.842;3261000;0
36677;-1;712;41;2;1;1;.500;339000;0
36677;85507;2473;72;31;3;28;.903;3600000;0
36677;146001;2473;0;0;0;0;.00nan;0;0
36678;-1;711;0;0;0;0;.00nan;0;0
36678;-1;707;61;47;6;41;.872;3600000;0
36678;78251;711;88;17;0;17;1.000;3600000;0
36678;145843;707;0;0;0;0;.00nan;0;0
36679;166044;2474;89;50;2;48;.960;3589000;0
36679;181748;714;96;26;0;26;1.000;3600000;0
36679;70115;2474;0;0;0;0;.00nan;0;0
36679;145636;714;0;0;0;0;.00nan;0;0
36680;26308;710;78;8;0;8;1.000;3600000;0
36680;-1;707;90;60;5;55;.917;3600000;0
36680;-1;710;0;0;0;0;.00nan;0;0
36680;145843;707;0;0;0;0;.00nan;0;0
36681;-1;713;100;28;0;28;1.000;3600000;0
36681;85507;2473;63;36;3;33;.917;3600000;0
36681;146001;2473;0;0;0;0;.00nan;0;0
36681;157000;713;0;0;0;0;.00nan;0;0
36682;-1;711;0;0;0;0;.00nan;0;0
36682;72229;706;58;40;5;35;.875;3600000;0
36682;78251;711;77;22;1;21;.955;3600000;0
36682;160866;706;0;0;0;0;.00nan;0;0
36683;170548;712;92;33;1;32;.970;3900000;0
36683;-1;712;0;0;0;0;.00nan;0;0
36683;-1;2465;92;31;1;30;.968;3900000;0
36683;145733;2465;0;0;0;0;.00nan;0;0
36684;-1;713;69;18;1;17;.944;3600000;0
36684;170548;712;86;38;3;35;.921;3572000;0
36684;-1;712;0;0;0;0;.00nan;0;0
36684;157000;713;0;0;0;0;.00nan;0;0
36685;-1;711;0;0;0;0;.00nan;0;0
36685;-1;2465;0;0;0;0;.00nan;0;0
36685;78251;711;73;10;0;10;1.000;3600000;0
36685;145733;2465;53;47;5;42;.894;3600000;0
36686;166044;2474;63;27;3;24;.889;3600000;0
36686;-1;707;0;0;0;0;.00nan;0;0
36686;70115;2474;0;0;0;0;.00nan;0;0
36686;145843;707;97;24;0;24;1.000;3600000;0
36687;26308;710;57;14;1;13;.929;3600000;0
36687;-1;710;0;0;0;0;.00nan;0;0
36687;85507;2473;66;44;5;39;.886;3600000;0
36687;146001;2473;0;0;0;0;.00nan;0;0
36688;181748;714;72;33;3;30;.909;3600000;0
36688;72229;706;58;35;5;30;.857;3528000;0
36688;145636;714;0;0;0;0;.00nan;0;0
36688;160866;706;0;0;0;0;.00nan;0;0
36692;181748;714;55;24;3;21;.875;3900000;0
36692;72229;706;59;25;3;22;.880;3900000;0
36692;145636;714;0;0;0;0;.00nan;0;0
36692;160866;706;0;0;0;0;.00nan;0;0
36694;166044;2474;72;39;3;36;.923;3600000;0
36694;-1;2465;87;30;2;28;.933;3600000;0
36694;70115;2474;0;0;0;0;.00nan;0;0
36694;145733;2465;0;0;0;0;.00nan;0;0
36696;170548;712;22;22;6;16;.727;3545000;0
36696;-1;712;0;0;0;0;.00nan;0;0
36696;-1;707;59;41;5;36;.878;3600000;0
36696;145843;707;0;0;0;0;.00nan;0;0
36698;-1;713;59;25;3;22;.880;3600000;0
36698;85507;2473;19;27;6;21;.778;2529000;0
36698;146001;2473;48;7;1;6;.857;1071000;0
36698;157000;713;0;0;0;0;.00nan;0;0
36700;170548;712;85;40;4;36;.900;3900000;0
36700;-1;712;0;0;0;0;.00nan;0;0
36700;-1;2465;40;20;4;16;.800;3896000;0
36700;145733;2465;0;0;0;0;.00nan;0;0
36702;-1;713;55;28;4;24;.857;3600000;0
36702;72229;706;60;39;5;34;.872;3565000;0
36702;157000;713;0;0;0;0;.00nan;0;0
36702;160866;706;0;0;0;0;.00nan;0;0
36704;166044;2474;0;0;0;0;.00nan;0;0
36704;-1;707;85;27;1;26;.963;3900000;0
36704;70115;2474;88;32;1;31;.969;3900000;0
36704;145843;707;0;0;0;0;.00nan;0;0
36706;26308;710;32;19;4;15;.789;3600000;0
36706;-1;710;0;0;0;0;.00nan;0;0
36706;85507;2473;0;0;0;0;.00nan;0;0
36706;146001;2473;53;51;6;45;.882;3600000;0
36710;-1;713;0;0;0;0;.00nan;0;0
36710;26308;710;0;0;0;0;.00nan;0;0
36710;-1;710;62;13;1;12;.923;3600000;0
36710;157000;713;67;57;7;50;.877;3600000;0
36712;166044;2474;84;41;3;38;.927;3555000;0
36712;70115;2474;0;0;0;0;.00nan;0;0
36712;72229;706;0;0;0;0;.00nan;0;0
36712;160866;706;48;15;2;13;.867;3600000;0
36716;181748;714;89;39;2;37;.949;3900000;0
36716;85507;2473;78;29;2;27;.931;3900000;0
36716;145636;714;0;0;0;0;.00nan;0;0
36716;146001;2473;0;0;0;0;.00nan;0;0
36718;170548;712;51;17;3;14;.824;3600000;0
36718;-1;712;0;0;0;0;.00nan;0;0
36718;-1;707;0;0;0;0;.00nan;0;0
36718;145843;707;72;39;4;35;.897;3600000;0
36720;-1;713;76;34;3;31;.912;3600000;0
36720;170548;712;93;20;0;20;1.000;3600000;0
36720;-1;712;0;0;0;0;.00nan;0;0
36720;157000;713;0;0;0;0;.00nan;0;0
36724;166044;2474;69;35;4;31;.886;2256000;0
36724;181748;714;65;20;2;18;.900;3600000;0
36724;70115;2474;68;9;0;9;1.000;1265000;0
36724;145636;714;0;0;0;0;.00nan;0;0
36726;26308;710;63;10;1;9;.900;3600000;0
36726;-1;707;85;43;3;40;.930;3558000;0
36726;-1;710;0;0;0;0;.00nan;0;0
36726;145843;707;0;0;0;0;.00nan;0;0
36728;72229;706;75;24;2;22;.917;3600000;0
36728;85507;2473;51;25;3;22;.880;3571000;0
36728;146001;2473;0;0;0;0;.00nan;0;0
36728;160866;706;0;0;0;0;.00nan;0;0
36730;-1;2465;43;28;5;23;.821;3600000;0
36730;72229;706;0;0;0;0;.00nan;0;0
36730;145733;2465;0;0;0;0;.00nan;0;0
36730;160866;706;72;31;3;28;.903;3600000;0
36732;170548;712;39;33;6;27;.818;3600000;0
36732;-1;712;0;0;0;0;.00nan;0;0
36732;181748;714;0;0;0;0;.00nan;0;0
36732;145636;714;93;22;0;22;1.000;3600000;0
36736;166044;2474;54;41;5;36;.878;3071000;0
36736;-1;713;0;0;0;0;.00nan;0;0
36736;70115;2474;26;7;3;4;.571;529000;0
36736;157000;713;92;22;0;22;1.000;3600000;0
36738;26308;710;0;0;0;0;.00nan;0;0
36738;-1;710;47;22;3;19;.864;3561000;0
36738;85507;2473;0;0;0;0;.00nan;0;0
36738;146001;2473;99;45;2;43;.956;3600000;0
36740;-1;711;0;0;0;0;.00nan;0;0
36740;-1;2465;54;30;3;27;.900;3600000;0
36740;78251;711;88;16;0;16;1.000;3600000;0
36740;145733;2465;0;0;0;0;.00nan;0;0
36742;170548;712;0;0;0;0;.00nan;0;0
36742;-1;712;36;27;5;22;.815;3600000;0
36742;-1;707;83;35;2;33;.943;3600000;0
36742;145843;707;0;0;0;0;.00nan;0;0
36744;-1;713;0;0;0;0;.00nan;0;0
36744;26308;710;74;17;1;16;.941;3600000;0
36744;-1;710;0;0;0;0;.00nan;0;0
36744;157000;713;44;35;5;30;.857;3600000;0
36746;166044;2474;63;31;3;28;.903;3600000;0
36746;70115;2474;0;0;0;0;.00nan;0;0
36746;72229;706;82;16;0;16;1.000;3600000;0
36746;160866;706;0;0;0;0;.00nan;0;0
36748;181748;714;64;25;3;22;.880;2466000;0
36748;85507;2473;37;17;3;14;.824;3600000;0
36748;145636;714;31;17;4;13;.765;1134000;0
36748;146001;2473;0;0;0;0;.00nan;0;0
36750;170548;712;55;39;5;34;.872;3020000;0
36750;-1;712;52;10;1;9;.900;580000;0
36750;26308;710;0;0;0;0;.00nan;0;0
36750;-1;710;60;21;3;18;.857;3600000;0
36752;-1;2465;0;0;0;0;.00nan;0;0
36752;85507;2473;0;0;0;0;.00nan;0;0
36752;145733;2465;87;40;2;38;.950;3600000;0
36752;146001;2473;63;14;1;13;.929;3600000;0
36754;-1;711;0;0;0;0;.00nan;0;0
36754;72229;706;84;42;3;39;.929;3598000;0
36754;78251;711;77;21;1;20;.952;3600000;0
36754;160866;706;0;0;0;0;.00nan;0;0
36756;166044;2474;0;0;0;0;.00nan;0;0
36756;181748;714;0;0;0;0;.00nan;0;0
36756;70115;2474;61;41;5;36;.878;3571000;0
36756;145636;714;59;20;3;17;.850;3600000;0
36758;-1;713;45;13;2;11;.846;3900000;0
36758;-1;707;0;0;0;0;.00nan;0;0
36758;145843;707;100;39;2;37;.949;3900000;0
36758;157000;713;0;0;0;0;.00nan;0;0
1272;26308;710;53;17;2;15;.882;3600000;0
1272;-1;2465;42;21;4;17;.810;1629000;0
1272;-1;710;0;0;0;0;.00nan;0;0
1272;145733;2465;46;31;5;26;.839;1971000;0
1273;-1;711;0;0;0;0;.00nan;0;0
1273;181748;714;75;28;2;26;.929;3600000;0
1273;78251;711;68;30;3;27;.900;3590000;0
1273;145636;714;0;0;0;0;.00nan;0;0
1274;-1;713;48;11;2;9;.818;3543000;0
1274;170548;712;91;41;1;40;.976;3600000;0
1274;-1;712;0;0;0;0;.00nan;0;0
1274;157000;713;0;0;0;0;.00nan;0;0
1275;72229;706;42;20;4;16;.800;3560000;0
1275;85507;2473;60;25;3;22;.880;3600000;0
1275;146001;2473;0;0;0;0;.00nan;0;0
1275;160866;706;0;0;0;0;.00nan;0;0
1276;26308;710;64;14;1;13;.929;3600000;0
1276;-1;2465;96;62;4;58;.935;3600000;0
1276;-1;710;0;0;0;0;.00nan;0;0
1276;145733;2465;0;0;0;0;.00nan;0;0
1277;-1;711;0;0;0;0;.00nan;0;0
1277;181748;714;82;29;1;28;.966;3600000;0
1277;78251;711;57;25;3;22;.880;3542000;0
1277;145636;714;0;0;0;0;.00nan;0;0
1278;-1;713;45;20;3;17;.850;3600000;0
1278;170548;712;79;44;4;40;.909;3577000;0
1278;-1;712;0;0;0;0;.00nan;0;0
1278;157000;713;0;0;0;0;.00nan;0;0
1279;72229;706;69;43;4;39;.907;3600000;0
1279;85507;2473;91;18;0;18;1.000;3600000;0
1279;146001;2473;0;0;0;0;.00nan;0;0
1279;160866;706;0;0;0;0;.00nan;0;0
1280;26308;710;65;4;0;4;1.000;3600000;0
1280;-1;2465;91;63;3;60;.952;3586000;0
1280;-1;710;0;0;0;0;.00nan;0;0
1280;145733;2465;0;0;0;0;.00nan;0;0
1281;-1;711;0;0;0;0;.00nan;0;0
1281;181748;714;91;41;3;38;.927;3600000;0
1281;78251;711;55;31;4;27;.871;3553000;0
1281;145636;714;0;0;0;0;.00nan;0;0
1282;-1;713;72;21;1;20;.952;3681000;0
1282;170548;712;86;40;2;38;.950;3681000;0
1282;-1;712;0;0;0;0;.00nan;0;0
1282;157000;713;0;0;0;0;.00nan;0;0
1283;72229;706;84;39;3;36;.923;3600000;0
1283;85507;2473;100;33;0;33;1.000;3600000;0
1283;146001;2473;0;0;0;0;.00nan;0;0
1283;160866;706;0;0;0;0;.00nan;0;0
1284;26308;710;73;26;2;24;.923;3964000;0
1284;-1;2465;81;40;3;37;.925;3964000;0
1284;-1;710;0;0;0;0;.00nan;0;0
1284;145733;2465;0;0;0;0;.00nan;0;0
1285;-1;711;0;0;0;0;.00nan;0;0
1285;181748;714;69;30;2;28;.933;3840000;0
1285;78251;711;71;20;1;19;.950;3840000;0
1285;145636;714;0;0;0;0;.00nan;0;0
1286;-1;713;52;31;4;27;.871;3518000;0
1286;170548;712;74;26;2;24;.923;3600000;0
1286;-1;712;0;0;0;0;.00nan;0;0
1286;157000;713;0;0;0;0;.00nan;0;0
1287;72229;706;65;32;4;28;.875;3600000;0
1287;85507;2473;84;28;1;27;.964;3600000;0
1287;146001;2473;0;0;0;0;.00nan;0;0
1287;160866;706;0;0;0;0;.00nan;0;0
1568;-1;711;0;0;0;0;.00nan;0;0
1568;181748;714;81;40;3;37;.925;3686000;0
1568;78251;711;57;18;2;16;.889;3686000;0
1568;145636;714;0;0;0;0;.00nan;0;0
1569;-1;713;55;31;4;27;.871;3548000;0
1569;170548;712;71;35;3;32;.914;3600000;0
1569;-1;712;0;0;0;0;.00nan;0;0
1569;157000;713;0;0;0;0;.00nan;0;0
1603;-1;711;0;0;0;0;.00nan;0;0
1603;181748;714;73;37;4;33;.892;5082000;0
1603;78251;711;57;30;3;27;.900;5086000;0
1603;145636;714;0;0;0;0;.00nan;0;0
1604;-1;713;63;32;3;29;.906;5081000;0
1604;170548;712;93;52;2;50;.962;5081000;0
1604;-1;712;0;0;0;0;.00nan;0;0
1604;157000;713;0;0;0;0;.00nan;0;0
1641;-1;711;0;0;0;0;.00nan;0;0
1641;181748;714;43;43;7;36;.837;3600000;0
1641;78251;711;62;30;3;27;.900;3600000;0
1641;145636;714;0;0;0;0;.00nan;0;0
1768;170548;712;97;61;4;57;.934;3600000;0
1768;-1;712;0;0;0;0;.00nan;0;0
1768;26308;710;86;13;0;13;1.000;3600000;0
1768;-1;710;0;0;0;0;.00nan;0;0
1769;-1;711;0;0;0;0;.00nan;0;0
1769;78251;711;68;32;3;29;.906;3854000;0
1769;85507;2473;65;33;4;29;.879;3854000;0
1769;146001;2473;0;0;0;0;.00nan;0;0
1770;170548;712;53;54;7;47;.870;3600000;0
1770;-1;712;0;0;0;0;.00nan;0;0
1770;26308;710;37;18;4;14;.778;3600000;0
1770;-1;710;0;0;0;0;.00nan;0;0
1771;-1;711;0;0;0;0;.00nan;0;0
1771;78251;711;62;22;2;20;.909;3600000;0
1771;85507;2473;88;34;3;31;.912;3568000;0
1771;146001;2473;0;0;0;0;.00nan;0;0
1772;170548;712;48;49;7;42;.857;3600000;0
1772;-1;712;0;0;0;0;.00nan;0;0
1772;26308;710;73;17;1;16;.941;3600000;0
1772;-1;710;0;0;0;0;.00nan;0;0
1773;-1;711;0;0;0;0;.00nan;0;0
1773;78251;711;81;20;0;20;1.000;3712000;0
1773;85507;2473;83;25;1;24;.960;3712000;0
1773;146001;2473;0;0;0;0;.00nan;0;0
1774;170548;712;98;60;3;57;.950;3547000;0
1774;-1;712;0;0;0;0;.00nan;0;0
1774;26308;710;59;17;2;15;.882;3600000;0
1774;-1;710;0;0;0;0;.00nan;0;0
1775;-1;711;0;0;0;0;.00nan;0;0
1775;78251;711;67;24;2;22;.917;3542000;0
1775;85507;2473;80;26;1;25;.962;3600000;0
1775;146001;2473;0;0;0;0;.00nan;0;0
1933;-1;711;0;0;0;0;.00nan;0;0
1933;78251;711;41;33;5;28;.848;3600000;0
1933;85507;2473;86;31;1;30;.968;3600000;0
1933;146001;2473;0;0;0;0;.00nan;0;0
1969;-1;711;0;0;0;0;.00nan;0;0
1969;78251;711;99;21;0;21;1.000;3600000;0
1969;85507;2473;62;32;4;28;.875;3600000;0
1969;146001;2473;0;0;0;0;.00nan;0;0
2010;-1;711;0;0;0;0;.00nan;0;0
2010;26308;710;70;26;2;24;.923;3514000;0
2010;-1;710;0;0;0;0;.00nan;0;0
2010;78251;711;100;22;0;22;1.000;3600000;0
2011;-1;711;0;0;0;0;.00nan;0;0
2011;26308;710;48;17;3;14;.824;3543000;0
2011;-1;710;0;0;0;0;.00nan;0;0
2011;78251;711;89;28;1;27;.964;3600000;0
2012;-1;711;0;0;0;0;.00nan;0;0
2012;26308;710;75;27;2;25;.926;3600000;0
2012;-1;710;0;0;0;0;.00nan;0;0
2012;78251;711;24;32;7;25;.781;3600000;0
2013;-1;711;0;0;0;0;.00nan;0;0
2013;26308;710;54;19;3;16;.842;3600000;0
2013;-1;710;0;0;0;0;.00nan;0;0
2013;78251;711;91;36;1;35;.972;3600000;0
2250;-1;711;0;0;0;0;.00nan;0;0
2250;26308;710;89;34;1;33;.971;3582000;0
2250;-1;710;0;0;0;0;.00nan;0;0
2250;78251;711;100;30;0;30;1.000;3600000;0
36759;176437;619;0;0;0;0;.00nan;0;0
36759;73187;620;0;0;0;0;.00nan;0;0
36759;149584;619;55;20;2;18;.900;3600000;0
36759;156298;620;84;48;4;44;.917;3538000;0
36760;10141;4644;0;0;0;0;.00nan;0;0
36760;173279;4644;75;45;3;42;.933;3600000;0
36760;76406;614;69;20;1;19;.950;3600000;0
36760;156221;614;0;0;0;0;.00nan;0;0
36761;175651;2319;0;0;0;0;.00nan;0;0
36761;32712;612;0;0;0;0;.00nan;0;0
36761;63402;612;91;43;2;41;.953;3585000;0
36761;73699;2319;67;17;1;16;.941;3600000;0
36762;173903;2310;100;33;1;32;.970;3600000;0
36762;181660;2310;0;0;0;0;.00nan;0;0
36762;84525;1910;58;8;0;8;1.000;878000;0
36762;144410;1910;57;46;6;40;.870;2722000;0
36763;192776;611;53;33;4;29;.879;4032000;0
36763;1061;2308;48;23;5;18;.783;4032000;0
36763;202587;2308;0;0;0;0;.00nan;0;0
36763;156254;611;0;0;0;0;.00nan;0;0
36764;1061;2308;61;24;2;22;.917;3600000;0
36764;202587;2308;0;0;0;0;.00nan;0;0
36764;73187;620;0;0;0;0;.00nan;0;0
36764;156298;620;76;41;3;38;.927;3600000;0
36765;2140;622;57;23;3;20;.870;3600000;0
36765;175651;2319;46;25;5;20;.800;3592000;0
36765;73699;2319;0;0;0;0;.00nan;0;0
36765;156322;622;0;0;0;0;.00nan;0;0
36766;173903;2310;65;28;3;25;.893;3600000;0
36766;181660;2310;0;0;0;0;.00nan;0;0
36766;73639;617;54;4;0;4;1.000;1372000;0
36766;78262;617;12;16;6;10;.625;2228000;0
36767;176437;619;0;0;0;0;.00nan;0;0
36767;32712;612;0;0;0;0;.00nan;0;0
36767;63402;612;100;45;1;44;.978;3600000;0
36767;149584;619;52;16;2;14;.875;3582000;0
36768;10141;4644;0;0;0;0;.00nan;0;0
36768;173279;4644;66;39;4;35;.897;3600000;0
36768;84525;1910;0;0;0;0;.00nan;0;0
36768;144410;1910;29;23;5;18;.783;3570000;0
36769;192776;611;57;33;5;28;.848;3600000;0
36769;76406;614;100;33;1;32;.970;3600000;0
36769;156221;614;0;0;0;0;.00nan;0;0
36769;156254;611;0;0;0;0;.00nan;0;0
36770;175651;2319;88;34;2;32;.941;3600000;0
36770;73699;2319;0;0;0;0;.00nan;0;0
36770;86422;619;0;0;0;0;.00nan;0;0
36770;149584;619;51;20;3;17;.850;3600000;0
36771;73187;620;62;22;2;20;.909;3600000;0
36771;76406;614;60;41;5;36;.878;3600000;0
36771;156221;614;0;0;0;0;.00nan;0;0
36771;156298;620;0;0;0;0;.00nan;0;0
36772;10141;4644;0;0;0;0;.00nan;0;0
36772;173279;4644;85;38;3;35;.921;3593000;0
36772;73639;617;75;24;2;22;.917;3600000;0
36772;78262;617;0;0;0;0;.00nan;0;0
36773;1061;2308;42;26;4;22;.846;3525000;0
36773;32712;612;0;0;0;0;.00nan;0;0
36773;202587;2308;0;0;0;0;.00nan;0;0
36773;63402;612;64;22;2;20;.909;3600000;0
36774;192776;611;22;4;3;1;.250;369000;0
36774;84525;1910;0;0;0;0;.00nan;0;0
36774;144410;1910;72;23;1;22;.957;3600000;0
36774;156254;611;69;21;1;20;.952;3231000;0
36775;2140;622;66;32;3;29;.906;3571000;0
36775;173903;2310;96;39;2;37;.949;3600000;0
36775;181660;2310;0;0;0;0;.00nan;0;0
36775;156322;622;0;0;0;0;.00nan;0;0
36776;2140;622;28;22;5;17;.773;2478000;0
36776;73639;617;76;29;2;27;.931;3600000;0
36776;78262;617;0;0;0;0;.00nan;0;0
36776;156322;622;20;9;4;5;.556;1122000;0
36777;1061;2308;99;30;1;29;.967;3600000;0
36777;175651;2319;66;38;3;35;.921;3553000;0
36777;202587;2308;0;0;0;0;.00nan;0;0
36777;73699;2319;0;0;0;0;.00nan;0;0
36778;192776;611;69;36;4;32;.889;3600000;0
36778;73639;617;72;24;1;23;.958;3600000;0
36778;78262;617;0;0;0;0;.00nan;0;0
36778;156254;611;0;0;0;0;.00nan;0;0
36779;2140;622;70;30;3;27;.900;3600000;0
36779;86422;619;0;0;0;0;.00nan;0;0
36779;149584;619;77;45;4;41;.911;3590000;0
36779;156322;622;0;0;0;0;.00nan;0;0
36780;73187;620;0;0;0;0;.00nan;0;0
36780;84525;1910;0;0;0;0;.00nan;0;0
36780;144410;1910;74;45;5;40;.889;3600000;0
36780;156298;620;100;30;0;30;1.000;3600000;0
36781;32712;612;0;0;0;0;.00nan;0;0
36781;63402;612;83;35;2;33;.943;3600000;0
36781;76406;614;38;31;6;25;.806;3600000;0
36781;156221;614;0;0;0;0;.00nan;0;0
36782;10141;4644;0;0;0;0;.00nan;0;0
36782;173279;4644;50;35;5;30;.857;3600000;0
36782;173903;2310;0;0;0;0;.00nan;0;0
36782;181660;2310;55;12;1;11;.917;3600000;0
36783;175651;2319;0;0;0;0;.00nan;0;0
36783;73699;2319;59;20;2;18;.900;3600000;0
36783;76406;614;80;43;4;39;.907;3578000;0
36783;156221;614;0;0;0;0;.00nan;0;0
36784;73187;620;0;0;0;0;.00nan;0;0
36784;73639;617;59;26;3;23;.885;3600000;0
36784;78262;617;0;0;0;0;.00nan;0;0
36784;156298;620;65;41;5;36;.878;3541000;0
36785;1061;2308;43;23;4;19;.826;4175000;0
36785;202587;2308;0;0;0;0;.00nan;0;0
36785;86422;619;0;0;0;0;.00nan;0;0
36785;149584;619;99;50;3;47;.940;4175000;0
36786;32712;612;0;0;0;0;.00nan;0;0
36786;63402;612;88;28;1;27;.964;3600000;0
36786;84525;1910;0;0;0;0;.00nan;0;0
36786;144410;1910;70;32;2;30;.938;3586000;0
36787;192776;611;99;28;0;28;1.000;3600000;0
36787;173903;2310;59;34;4;30;.882;3600000;0
36787;181660;2310;0;0;0;0;.00nan;0;0
36787;156254;611;0;0;0;0;.00nan;0;0
36788;2140;622;94;22;0;22;1.000;3600000;0
36788;10141;4644;0;0;0;0;.00nan;0;0
36788;173279;4644;92;48;4;44;.917;3600000;0
36788;156322;622;0;0;0;0;.00nan;0;0
36789;1061;2308;45;13;2;11;.846;2420000;0
36789;2140;622;58;26;3;23;.885;3600000;0
36789;202587;2308;26;14;4;10;.714;1180000;0
36789;156322;622;0;0;0;0;.00nan;0;0
36790;32712;612;0;0;0;0;.00nan;0;0
36790;63402;612;70;35;3;32;.914;3600000;0
36790;73639;617;0;0;0;0;.00nan;0;0
36790;78262;617;95;20;0;20;1.000;3600000;0
36791;192776;611;41;22;4;18;.818;3600000;0
36791;10141;4644;0;0;0;0;.00nan;0;0
36791;173279;4644;45;41;6;35;.854;3581000;0
36791;156254;611;0;0;0;0;.00nan;0;0
36792;175651;2319;81;13;0;13;1.000;3600000;0
36792;73699;2319;0;0;0;0;.00nan;0;0
36792;84525;1910;93;57;5;52;.912;3600000;0
36792;144410;1910;0;0;0;0;.00nan;0;0
36793;76406;614;56;26;3;23;.885;3600000;0
36793;86422;619;0;0;0;0;.00nan;0;0
36793;149584;619;18;31;8;23;.742;3600000;0
36793;156221;614;0;0;0;0;.00nan;0;0
36794;173903;2310;50;26;4;22;.846;3600000;0
36794;181660;2310;0;0;0;0;.00nan;0;0
36794;73187;620;0;0;0;0;.00nan;0;0
36794;156298;620;28;30;7;23;.767;3600000;0
36795;175651;2319;66;16;1;15;.938;3600000;0
36795;73639;617;54;10;1;9;.900;1401000;0
36795;73699;2319;0;0;0;0;.00nan;0;0
36795;78262;617;44;27;5;22;.815;2199000;0
36796;10141;4644;65;16;1;15;.938;1817000;0
36796;173279;4644;28;16;4;12;.750;1783000;0
36796;73187;620;28;32;6;26;.813;3167000;0
36796;156298;620;42;7;2;5;.714;433000;0
36797;84525;1910;82;57;6;51;.895;3600000;0
36797;86422;619;0;0;0;0;.00nan;0;0
36797;144410;1910;0;0;0;0;.00nan;0;0
36797;149584;619;66;14;1;13;.929;3600000;0
36798;173903;2310;70;19;1;18;.947;3600000;0
36798;32712;612;0;0;0;0;.00nan;0;0
36798;181660;2310;0;0;0;0;.00nan;0;0
36798;63402;612;49;25;4;21;.840;3600000;0
36799;192776;611;64;41;4;37;.902;3544000;0
36799;2140;622;0;0;0;0;.00nan;0;0
36799;156254;611;0;0;0;0;.00nan;0;0
36799;156322;622;57;16;2;14;.875;3600000;0
36800;73639;617;71;39;4;35;.897;3295000;0
36800;78262;617;57;4;0;4;1.000;260000;0
36800;86422;619;0;0;0;0;.00nan;0;0
36800;149584;619;81;34;2;32;.941;3600000;0
36801;10141;4644;0;0;0;0;.00nan;0;0
36801;173279;4644;29;29;6;23;.793;3600000;0
36801;32712;612;0;0;0;0;.00nan;0;0
36801;63402;612;91;46;1;45;.978;3600000;0
36802;1061;2308;57;16;2;14;.875;4200000;0
36802;202587;2308;0;0;0;0;.00nan;0;0
36802;84525;1910;0;0;0;0;.00nan;0;0
36802;144410;1910;90;65;2;63;.969;4200000;0
36803;2140;622;69;25;2;23;.920;3600000;0
36803;76406;614;79;39;3;36;.923;3600000;0
36803;156221;614;0;0;0;0;.00nan;0;0
36803;156322;622;0;0;0;0;.00nan;0;0
36804;173903;2310;0;0;0;0;.00nan;0;0
36804;175651;2319;0;0;0;0;.00nan;0;0
36804;181660;2310;59;29;4;25;.862;3560000;0
36804;73699;2319;70;23;2;21;.913;3600000;0
36805;192776;611;43;29;5;24;.828;2112000;0
36805;73187;620;0;0;0;0;.00nan;0;0
36805;156254;611;57;15;1;14;.933;1488000;0
36805;156298;620;69;25;3;22;.880;3600000;0
36806;1061;2308;74;17;1;16;.941;3600000;0
36806;202587;2308;0;0;0;0;.00nan;0;0
36806;73639;617;32;30;6;24;.800;3240000;0
36806;78262;617;51;2;0;2;1.000;360000;0
36807;10141;4644;0;0;0;0;.00nan;0;0
36807;173279;4644;85;48;3;45;.938;3691000;0
36807;175651;2319;0;0;0;0;.00nan;0;0
36807;73699;2319;56;25;4;21;.840;3691000;0
36808;173903;2310;51;36;5;31;.861;3545000;0
36808;181660;2310;0;0;0;0;.00nan;0;0
36808;86422;619;0;0;0;0;.00nan;0;0
36808;149584;619;67;30;3;27;.900;3600000;0
36809;192776;611;81;27;2;25;.926;4200000;0
36809;32712;612;0;0;0;0;.00nan;0;0
36809;63402;612;100;42;2;40;.952;4200000;0
36809;156254;611;0;0;0;0;.00nan;0;0
36810;76406;614;54;39;6;33;.846;3023000;0
36810;84525;1910;0;0;0;0;.00nan;0;0
36810;144410;1910;57;26;3;23;.885;3600000;0
36810;156221;614;55;4;0;4;1.000;577000;0
36811;2140;622;47;9;2;7;.778;2139000;0
36811;73187;620;86;38;3;35;.921;3600000;0
36811;156298;620;0;0;0;0;.00nan;0;0
36811;156322;622;10;15;6;9;.600;1461000;0
36812;32712;612;0;0;0;0;.00nan;0;0
36812;63402;612;73;35;3;32;.914;3565000;0
36812;73187;620;78;27;2;25;.926;3600000;0
36812;156298;620;0;0;0;0;.00nan;0;0
36813;73639;617;42;27;5;22;.815;3574000;0
36813;76406;614;77;42;3;39;.929;3600000;0
36813;78262;617;0;0;0;0;.00nan;0;0
36813;156221;614;0;0;0;0;.00nan;0;0
36814;10141;4644;0;0;0;0;.00nan;0;0
36814;173279;4644;60;27;3;24;.889;3600000;0
36814;176437;619;0;0;0;0;.00nan;0;0
36814;149584;619;66;33;4;29;.879;3561000;0
36815;1061;2308;20;24;6;18;.750;3295000;0
36815;173903;2310;92;49;3;46;.939;3600000;0
36815;181660;2310;0;0;0;0;.00nan;0;0
36815;202587;2308;42;3;1;2;.667;305000;0
36816;192776;611;98;37;1;36;.973;3600000;0
36816;175651;2319;35;28;5;23;.821;3600000;0
36816;73699;2319;0;0;0;0;.00nan;0;0
36816;156254;611;0;0;0;0;.00nan;0;0
36817;1061;2308;38;21;4;17;.810;3600000;0
36817;10141;4644;53;3;0;3;1.000;210000;0
36817;173279;4644;40;38;6;32;.842;3352000;0
36817;202587;2308;0;0;0;0;.00nan;0;0
36818;175651;2319;0;0;0;0;.00nan;0;0
36818;73187;620;76;22;1;21;.955;2378000;0
36818;73699;2319;43;16;4;12;.750;3600000;0
36818;156298;620;24;14;4;10;.714;1166000;0
36819;192776;611;25;10;4;6;.600;1148000;0
36819;168021;619;0;0;0;0;.00nan;0;0
36819;149584;619;35;30;5;25;.833;3686000;0
36819;156254;611;74;16;0;16;1.000;2538000;0
36820;73639;617;72;27;2;25;.926;3600000;0
36820;78262;617;0;0;0;0;.00nan;0;0
36820;84525;1910;48;33;5;28;.848;3600000;0
36820;144410;1910;0;0;0;0;.00nan;0;0
36821;173903;2310;86;30;1;29;.967;3600000;0
36821;181660;2310;0;0;0;0;.00nan;0;0
36821;76406;614;0;0;0;0;.00nan;0;0
36821;156221;614;54;30;4;26;.867;3600000;0
36822;2140;622;0;0;0;0;.00nan;0;0
36822;32712;612;58;12;1;11;.917;1306000;0
36822;63402;612;7;19;7;12;.632;2294000;0
36822;156322;622;55;30;4;26;.867;3600000;0
36823;175651;2319;71;19;1;18;.947;3600000;0
36823;73187;620;83;37;3;34;.919;3516000;0
36823;73699;2319;0;0;0;0;.00nan;0;0
36823;156298;620;0;0;0;0;.00nan;0;0
36824;73639;617;0;0;0;0;.00nan;0;0
36824;78262;617;69;18;2;16;.889;3600000;0
36824;84525;1910;0;0;0;0;.00nan;0;0
36824;144410;1910;68;41;4;37;.902;3544000;0
36825;1061;2308;79;31;3;28;.903;3692000;0
36825;10141;4644;0;0;0;0;.00nan;0;0
36825;173279;4644;70;27;2;25;.926;3692000;0
36825;202587;2308;0;0;0;0;.00nan;0;0
36826;173903;2310;0;0;0;0;.00nan;0;0
36826;181660;2310;60;37;4;33;.892;4200000;0
36826;76406;614;79;43;4;39;.907;4200000;0
36826;156221;614;0;0;0;0;.00nan;0;0
36827;192776;611;60;33;4;29;.879;3600000;0
36827;168021;619;0;0;0;0;.00nan;0;0
36827;149584;619;74;22;1;21;.955;3600000;0
36827;156254;611;0;0;0;0;.00nan;0;0
36828;1061;2308;71;17;1;16;.941;3600000;0
36828;173903;2310;55;46;6;40;.870;3600000;0
36828;181660;2310;0;0;0;0;.00nan;0;0
36828;202587;2308;0;0;0;0;.00nan;0;0
36829;192776;611;67;27;2;25;.926;4200000;0
36829;175651;2319;0;0;0;0;.00nan;0;0
36829;73699;2319;87;44;2;42;.955;4200000;0
36829;156254;611;0;0;0;0;.00nan;0;0
36830;10141;4644;0;0;0;0;.00nan;0;0
36830;168021;619;98;29;0;29;1.000;3600000;0
36830;173279;4644;66;45;4;41;.911;3600000;0
36830;149584;619;0;0;0;0;.00nan;0;0
36831;32712;612;100;32;1;31;.969;3600000;0
36831;63402;612;0;0;0;0;.00nan;0;0
36831;73187;620;0;0;0;0;.00nan;0;0
36831;156298;620;73;41;3;38;.927;3547000;0
36832;73639;617;74;36;4;32;.889;3600000;0
36832;76406;614;85;28;1;27;.964;3600000;0
36832;78262;617;0;0;0;0;.00nan;0;0
36832;156221;614;0;0;0;0;.00nan;0;0
36833;2140;622;80;24;1;23;.958;3600000;0
36833;84525;1910;0;0;0;0;.00nan;0;0
36833;144410;1910;47;35;5;30;.857;3600000;0
36833;156322;622;0;0;0;0;.00nan;0;0
36834;2140;622;43;25;4;21;.840;3600000;0
36834;84525;1910;0;0;0;0;.00nan;0;0
36834;144410;1910;88;42;3;39;.929;3600000;0
36834;156322;622;0;0;0;0;.00nan;0;0
36835;2140;622;71;24;2;22;.917;4123000;0
36835;73187;620;93;49;3;46;.939;4123000;0
36835;156298;620;0;0;0;0;.00nan;0;0
36835;156322;622;0;0;0;0;.00nan;0;0
36836;1061;2308;80;23;1;22;.957;3600000;0
36836;202587;2308;0;0;0;0;.00nan;0;0
36836;73639;617;53;26;4;22;.846;3573000;0
36836;78262;617;0;0;0;0;.00nan;0;0
36837;10141;4644;0;0;0;0;.00nan;0;0
36837;173279;4644;74;46;5;41;.891;3587000;0
36837;175651;2319;42;16;3;13;.813;3600000;0
36837;73699;2319;0;0;0;0;.00nan;0;0
36838;76406;614;58;23;2;21;.913;3600000;0
36838;84525;1910;0;0;0;0;.00nan;0;0
36838;144410;1910;42;40;7;33;.825;3600000;0
36838;156221;614;0;0;0;0;.00nan;0;0
36839;168021;619;81;28;1;27;.964;3600000;0
36839;173903;2310;49;35;5;30;.857;3600000;0
36839;181660;2310;0;0;0;0;.00nan;0;0
36839;149584;619;0;0;0;0;.00nan;0;0
36840;192776;611;0;0;0;0;.00nan;0;0
36840;32712;612;0;0;0;0;.00nan;0;0
36840;63402;612;86;32;2;30;.938;3571000;0
36840;156254;611;94;32;1;31;.969;3600000;0
36841;1061;2308;58;19;2;17;.895;3600000;0
36841;202587;2308;0;0;0;0;.00nan;0;0
36841;84525;1910;0;0;0;0;.00nan;0;0
36841;144410;1910;81;51;4;47;.922;3557000;0
36842;192776;611;35;36;6;30;.833;2895000;0
36842;73187;620;40;30;6;24;.800;3600000;0
36842;156254;611;47;6;1;5;.833;687000;0
36842;156298;620;0;0;0;0;.00nan;0;0
36843;168021;619;58;26;3;23;.885;3543000;0
36843;73639;617;99;40;2;38;.950;3600000;0
36843;78262;617;0;0;0;0;.00nan;0;0
36843;149584;619;0;0;0;0;.00nan;0;0
36844;10141;4644;0;0;0;0;.00nan;0;0
36844;173279;4644;63;26;2;24;.923;3578000;0
36844;32712;612;0;0;0;0;.00nan;0;0
36844;63402;612;93;31;1;30;.968;3600000;0
36845;2140;622;65;13;1;12;.923;3600000;0
36845;76406;614;68;43;5;38;.884;3600000;0
36845;156221;614;0;0;0;0;.00nan;0;0
36845;156322;622;0;0;0;0;.00nan;0;0
36846;175651;2319;100;30;0;30;1.000;3600000;0
36846;73639;617;0;0;0;0;.00nan;0;0
36846;73699;2319;0;0;0;0;.00nan;0;0
36846;78262;617;68;39;4;35;.897;3600000;0
36847;10141;4644;22;11;4;7;.636;903000;0
36847;173279;4644;80;36;2;34;.944;2697000;0
36847;73187;620;0;0;0;0;.00nan;0;0
36847;156298;620;63;22;2;20;.909;3600000;0
36848;168021;619;78;23;1;22;.957;3600000;0
36848;84525;1910;0;0;0;0;.00nan;0;0
36848;144410;1910;53;44;6;38;.864;3600000;0
36848;149584;619;0;0;0;0;.00nan;0;0
36849;1061;2308;90;43;3;40;.930;3600000;0
36849;202587;2308;0;0;0;0;.00nan;0;0
36849;76406;614;32;32;6;26;.813;3600000;0
36849;156221;614;0;0;0;0;.00nan;0;0
36850;173903;2310;56;36;4;32;.889;3564000;0
36850;32712;612;0;0;0;0;.00nan;0;0
36850;181660;2310;0;0;0;0;.00nan;0;0
36850;63402;612;68;29;3;26;.897;3600000;0
36851;192776;611;89;35;2;33;.943;4200000;0
36851;2140;622;66;25;2;23;.920;4200000;0
36851;156254;611;0;0;0;0;.00nan;0;0
36851;156322;622;0;0;0;0;.00nan;0;0
36852;175651;2319;51;21;3;18;.857;3600000;0
36852;73699;2319;0;0;0;0;.00nan;0;0
36852;84525;1910;79;29;1;28;.966;2555000;0
36852;144410;1910;45;21;4;17;.810;1045000;0
36853;173903;2310;63;26;3;23;.885;3547000;0
36853;181660;2310;0;0;0;0;.00nan;0;0
36853;73187;620;61;24;2;22;.917;3600000;0
36853;156298;620;0;0;0;0;.00nan;0;0
36854;32712;612;0;0;0;0;.00nan;0;0
36854;63402;612;76;33;2;31;.939;3600000;0
36854;73639;617;66;33;3;30;.909;3545000;0
36854;78262;617;0;0;0;0;.00nan;0;0
36855;192776;611;51;26;4;22;.846;3600000;0
36855;10141;4644;87;30;1;29;.967;3072000;0
36855;173279;4644;28;17;4;13;.765;528000;0
36855;156254;611;0;0;0;0;.00nan;0;0
36856;1061;2308;93;35;1;34;.971;3600000;0
36856;2140;622;89;43;3;40;.930;3557000;0
36856;202587;2308;0;0;0;0;.00nan;0;0
36856;156322;622;0;0;0;0;.00nan;0;0
36857;173903;2310;66;34;4;30;.882;3589000;0
36857;175651;2319;0;0;0;0;.00nan;0;0
36857;181660;2310;0;0;0;0;.00nan;0;0
36857;73699;2319;62;26;3;23;.885;3600000;0
36858;1061;2308;71;35;3;32;.914;4200000;0
36858;168021;619;50;21;3;18;.857;4200000;0
36858;202587;2308;0;0;0;0;.00nan;0;0
36858;149584;619;0;0;0;0;.00nan;0;0
36859;73187;620;46;27;4;23;.852;2586000;0
36859;73639;617;88;29;1;28;.966;3600000;0
36859;78262;617;0;0;0;0;.00nan;0;0
36859;156298;620;29;16;4;12;.750;1014000;0
36860;2140;622;43;23;4;19;.826;3560000;0
36860;10141;4644;0;0;0;0;.00nan;0;0
36860;173279;4644;85;42;3;39;.929;3600000;0
36860;156322;622;0;0;0;0;.00nan;0;0
36861;32712;612;0;0;0;0;.00nan;0;0
36861;63402;612;38;20;4;16;.800;3600000;0
36861;84525;1910;0;0;0;0;.00nan;0;0
36861;144410;1910;100;36;0;36;1.000;3600000;0
36862;175651;2319;49;28;4;24;.857;3600000;0
36862;73699;2319;0;0;0;0;.00nan;0;0
36862;76406;614;21;12;4;8;.667;951000;0
36862;156221;614;64;20;2;18;.900;2635000;0
36863;192776;611;68;35;3;32;.914;3576000;0
36863;173903;2310;91;33;2;31;.939;3600000;0
36863;181660;2310;0;0;0;0;.00nan;0;0
36863;156254;611;0;0;0;0;.00nan;0;0
36864;1061;2308;82;32;2;30;.938;3600000;0
36864;175651;2319;56;30;3;27;.900;3582000;0
36864;202587;2308;0;0;0;0;.00nan;0;0
36864;73699;2319;0;0;0;0;.00nan;0;0
36865;73187;620;78;28;2;26;.929;3600000;0
36865;84525;1910;0;0;0;0;.00nan;0;0
36865;144410;1910;86;64;4;60;.938;3553000;0
36865;156298;620;0;0;0;0;.00nan;0;0
36866;10141;4644;0;0;0;0;.00nan;0;0
36866;173279;4644;74;31;2;29;.935;3600000;0
36866;173903;2310;35;31;6;25;.806;3037000;0
36866;181660;2310;46;5;1;4;.800;563000;0
36867;32712;612;0;0;0;0;.00nan;0;0
36867;63402;612;74;41;4;37;.902;3600000;0
36867;76406;614;100;24;0;24;1.000;3600000;0
36867;156221;614;0;0;0;0;.00nan;0;0
36868;192776;611;91;41;2;39;.951;3600000;0
36868;73639;617;0;0;0;0;.00nan;0;0
36868;78262;617;79;36;3;33;.917;3559000;0
36868;156254;611;0;0;0;0;.00nan;0;0
36869;2140;622;0;0;0;0;.00nan;0;0
36869;168021;619;77;34;3;31;.912;3555000;0
36869;149584;619;0;0;0;0;.00nan;0;0
36869;156322;622;100;34;1;33;.971;3600000;0
36870;1061;2308;67;33;3;30;.909;3541000;0
36870;32712;612;0;0;0;0;.00nan;0;0
36870;202587;2308;0;0;0;0;.00nan;0;0
36870;63402;612;81;31;2;29;.935;3600000;0
36871;10141;4644;0;0;0;0;.00nan;0;0
36871;173279;4644;62;36;4;32;.889;3600000;0
36871;73639;617;0;0;0;0;.00nan;0;0
36871;78262;617;22;26;6;20;.769;3543000;0
36872;168021;619;100;36;2;34;.944;3838000;0
36872;175651;2319;0;0;0;0;.00nan;0;0
36872;73699;2319;64;32;3;29;.906;3838000;0
36872;149584;619;0;0;0;0;.00nan;0;0
36873;192776;611;67;18;1;17;.944;3600000;0
36873;84525;1910;34;43;7;36;.837;3600000;0
36873;144410;1910;0;0;0;0;.00nan;0;0
36873;156254;611;0;0;0;0;.00nan;0;0
36874;73187;620;0;0;0;0;.00nan;0;0
36874;76406;614;32;8;3;5;.625;539000;0
36874;156221;614;72;28;2;26;.929;3045000;0
36874;156298;620;59;31;3;28;.903;3600000;0
36875;2140;622;45;23;4;19;.826;3600000;0
36875;173903;2310;45;29;5;24;.828;3600000;0
36875;181660;2310;0;0;0;0;.00nan;0;0
36875;156322;622;0;0;0;0;.00nan;0;0
36876;1061;2308;39;30;6;24;.800;3600000;0
36876;202587;2308;0;0;0;0;.00nan;0;0
36876;73187;620;0;0;0;0;.00nan;0;0
36876;156298;620;78;38;3;35;.921;3600000;0
36877;10141;4644;0;0;0;0;.00nan;0;0
36877;173279;4644;56;19;3;16;.842;3542000;0
36877;84525;1910;0;0;0;0;.00nan;0;0
36877;144410;1910;99;37;1;36;.973;3600000;0
36878;168021;619;90;21;0;21;1.000;3600000;0
36878;32712;612;0;0;0;0;.00nan;0;0
36878;63402;612;71;28;2;26;.929;3584000;0
36878;149584;619;0;0;0;0;.00nan;0;0
36879;173903;2310;90;41;2;39;.951;4200000;0
36879;181660;2310;0;0;0;0;.00nan;0;0
36879;73639;617;70;33;2;31;.939;4200000;0
36879;78262;617;0;0;0;0;.00nan;0;0
36880;192776;611;67;25;3;22;.880;4200000;0
36880;76406;614;73;35;3;32;.914;4200000;0
36880;156221;614;0;0;0;0;.00nan;0;0
36880;156254;611;0;0;0;0;.00nan;0;0
36881;2140;622;26;23;6;17;.739;3308000;0
36881;175651;2319;0;0;0;0;.00nan;0;0
36881;73699;2319;67;29;3;26;.897;3600000;0
36881;156322;622;48;0;0;0;.00nan;292000;0
36882;192776;611;100;32;0;32;1.000;3600000;0
36882;1061;2308;0;0;0;0;.00nan;0;0
36882;202587;2308;79;26;1;25;.962;3549000;0
36882;156254;611;0;0;0;0;.00nan;0;0
36883;175651;2319;73;41;4;37;.902;4147000;0
36883;32712;612;0;0;0;0;.00nan;0;0
36883;63402;612;65;33;3;30;.909;4172000;0
36883;73699;2319;0;0;0;0;.00nan;0;0
36884;2140;622;82;38;3;35;.921;3600000;0
36884;73639;617;0;0;0;0;.00nan;0;0
36884;78262;617;54;45;6;39;.867;3600000;0
36884;156322;622;0;0;0;0;.00nan;0;0
36885;168021;619;100;26;0;26;1.000;3600000;0
36885;73187;620;0;0;0;0;.00nan;0;0
36885;149584;619;0;0;0;0;.00nan;0;0
36885;156298;620;50;37;5;32;.865;3600000;0
36886;173903;2310;46;20;3;17;.850;3600000;0
36886;181660;2310;0;0;0;0;.00nan;0;0
36886;84525;1910;58;26;4;22;.846;2881000;0
36886;144410;1910;21;11;4;7;.636;719000;0
36887;10141;4644;0;0;0;0;.00nan;0;0
36887;173279;4644;75;34;2;32;.941;3600000;0
36887;76406;614;0;0;0;0;.00nan;0;0
36887;156221;614;99;33;1;32;.970;3600000;0
36888;1061;2308;61;36;4;32;.889;3600000;0
36888;173903;2310;55;39;5;34;.872;3568000;0
36888;181660;2310;0;0;0;0;.00nan;0;0
36888;202587;2308;0;0;0;0;.00nan;0;0
36889;175651;2319;0;0;0;0;.00nan;0;0
36889;32712;612;0;0;0;0;.00nan;0;0
36889;63402;612;70;34;3;31;.912;3600000;0
36889;73699;2319;40;23;4;19;.826;3555000;0
36890;73187;620;60;31;3;28;.903;3600000;0
36890;73639;617;38;35;6;29;.829;3214000;0
36890;78262;617;51;2;0;2;1.000;386000;0
36890;156298;620;0;0;0;0;.00nan;0;0
36891;10141;4644;61;47;6;41;.872;3600000;0
36891;168021;619;85;15;0;15;1.000;3600000;0
36891;173279;4644;0;0;0;0;.00nan;0;0
36891;149584;619;0;0;0;0;.00nan;0;0
36892;192776;611;78;22;1;21;.955;3600000;0
36892;84525;1910;46;20;3;17;.850;1397000;0
36892;144410;1910;25;25;6;19;.760;2203000;0
36892;156254;611;0;0;0;0;.00nan;0;0
36893;2140;622;0;0;0;0;.00nan;0;0
36893;76406;614;96;35;2;33;.943;3600000;0
36893;156221;614;0;0;0;0;.00nan;0;0
36893;156322;622;36;19;4;15;.789;3513000;0
36894;1061;2308;70;26;2;24;.923;3600000;0
36894;202587;2308;0;0;0;0;.00nan;0;0
36894;73639;617;0;0;0;0;.00nan;0;0
36894;78262;617;73;43;5;38;.884;3600000;0
36895;168021;619;43;21;4;17;.810;3600000;0
36895;175651;2319;60;40;5;35;.875;3600000;0
36895;73699;2319;0;0;0;0;.00nan;0;0
36895;149584;619;0;0;0;0;.00nan;0;0
36896;2140;622;43;30;5;25;.833;3600000;0
36896;32712;612;0;0;0;0;.00nan;0;0
36896;63402;612;63;40;6;34;.850;3586000;0
36896;156322;622;0;0;0;0;.00nan;0;0
36897;73187;620;0;0;0;0;.00nan;0;0
36897;84525;1910;0;0;0;0;.00nan;0;0
36897;144410;1910;57;42;5;37;.881;3571000;0
36897;156298;620;59;28;3;25;.893;3600000;0
36898;192776;611;47;24;4;20;.833;3600000;0
36898;76406;614;62;43;5;38;.884;3573000;0
36898;156221;614;0;0;0;0;.00nan;0;0
36898;156254;611;0;0;0;0;.00nan;0;0
36899;10141;4644;0;0;0;0;.00nan;0;0
36899;173279;4644;80;42;3;39;.929;4200000;0
36899;173903;2310;54;33;3;30;.909;4200000;0
36899;181660;2310;0;0;0;0;.00nan;0;0
36900;1061;2308;81;29;1;28;.966;3681000;0
36900;202587;2308;0;0;0;0;.00nan;0;0
36900;84525;1910;0;0;0;0;.00nan;0;0
36900;144410;1910;85;35;2;33;.943;3681000;0
36901;73187;620;76;36;3;33;.917;3600000;0
36901;76406;614;68;26;2;24;.923;3600000;0
36901;156221;614;0;0;0;0;.00nan;0;0
36901;156298;620;0;0;0;0;.00nan;0;0
36902;10141;4644;0;0;0;0;.00nan;0;0
36902;173279;4644;91;47;3;44;.936;3993000;0
36902;175651;2319;0;0;0;0;.00nan;0;0
36902;73699;2319;64;25;2;23;.920;3993000;0
36903;173903;2310;0;0;0;0;.00nan;0;0
36903;181660;2310;53;41;5;36;.878;3600000;0
36903;73639;617;78;29;2;27;.931;3600000;0
36903;78262;617;0;0;0;0;.00nan;0;0
36904;192776;611;56;30;4;26;.867;3600000;0
36904;32712;612;48;7;1;6;.857;1016000;0
36904;63402;612;32;31;6;25;.806;2584000;0
36904;156254;611;0;0;0;0;.00nan;0;0
36905;2140;622;75;38;4;34;.895;3576000;0
36905;168021;619;78;25;2;23;.920;3600000;0
36905;149584;619;0;0;0;0;.00nan;0;0
36905;156322;622;0;0;0;0;.00nan;0;0
36906;2140;622;62;33;4;29;.879;3553000;0
36906;175651;2319;87;35;2;33;.943;3600000;0
36906;73699;2319;0;0;0;0;.00nan;0;0
36906;156322;622;0;0;0;0;.00nan;0;0
36907;10141;4644;0;0;0;0;.00nan;0;0
36907;173279;4644;53;44;6;38;.864;3600000;0
36907;73639;617;0;0;0;0;.00nan;0;0
36907;78262;617;72;34;3;31;.912;3600000;0
36908;192776;611;100;37;0;37;1.000;3600000;0
36908;168021;619;58;32;4;28;.875;3600000;0
36908;149584;619;0;0;0;0;.00nan;0;0
36908;156254;611;0;0;0;0;.00nan;0;0
36909;32712;612;0;0;0;0;.00nan;0;0
36909;63402;612;81;21;1;20;.952;3600000;0
36909;73187;620;93;50;3;47;.940;3538000;0
36909;156298;620;0;0;0;0;.00nan;0;0
36910;173903;2310;51;26;3;23;.885;3556000;0
36910;181660;2310;0;0;0;0;.00nan;0;0
36910;84525;1910;0;0;0;0;.00nan;0;0
36910;144410;1910;91;33;1;32;.970;3600000;0
36911;1061;2308;30;21;5;16;.762;3573000;0
36911;202587;2308;0;0;0;0;.00nan;0;0
36911;76406;614;69;33;3;30;.909;3600000;0
36911;156221;614;0;0;0;0;.00nan;0;0
36912;1061;2308;67;31;3;28;.903;3970000;0
36912;32712;612;0;0;0;0;.00nan;0;0
36912;202587;2308;0;0;0;0;.00nan;0;0
36912;63402;612;100;43;2;41;.953;3970000;0
36913;168021;619;32;25;5;20;.800;3543000;0
36913;73187;620;0;0;0;0;.00nan;0;0
36913;149584;619;0;0;0;0;.00nan;0;0
36913;156298;620;81;48;4;44;.917;3600000;0
36914;73639;617;0;0;0;0;.00nan;0;0
36914;78262;617;75;22;1;21;.955;3600000;0
36914;84525;1910;0;0;0;0;.00nan;0;0
36914;144410;1910;68;34;3;31;.912;3600000;0
36915;2140;622;90;26;1;25;.962;3600000;0
36915;10141;4644;0;0;0;0;.00nan;0;0
36915;173279;4644;47;30;4;26;.867;3600000;0
36915;156322;622;0;0;0;0;.00nan;0;0
36916;173903;2310;0;0;0;0;.00nan;0;0
36916;181660;2310;40;30;5;25;.833;3570000;0
36916;76406;614;78;38;3;35;.921;3600000;0
36916;156221;614;0;0;0;0;.00nan;0;0
36917;192776;611;57;18;2;16;.889;3600000;0
36917;175651;2319;28;26;6;20;.769;3600000;0
36917;73699;2319;0;0;0;0;.00nan;0;0
36917;156254;611;0;0;0;0;.00nan;0;0
36918;175651;2319;0;0;0;0;.00nan;0;0
36918;73187;620;71;46;5;41;.891;3600000;0
36918;73699;2319;58;18;2;16;.889;3600000;0
36918;156298;620;0;0;0;0;.00nan;0;0
36919;1061;2308;86;30;2;28;.933;3600000;0
36919;168021;619;69;30;3;27;.900;3569000;0
36919;202587;2308;0;0;0;0;.00nan;0;0
36919;149584;619;0;0;0;0;.00nan;0;0
36920;173903;2310;57;27;3;24;.889;4154000;0
36920;32712;612;0;0;0;0;.00nan;0;0
36920;181660;2310;0;0;0;0;.00nan;0;0
36920;63402;612;61;39;4;35;.897;4154000;0
36921;10141;4644;55;4;0;4;1.000;404000;0
36921;173279;4644;38;36;6;30;.833;3196000;0
36921;84525;1910;68;31;3;28;.903;3600000;0
36921;144410;1910;0;0;0;0;.00nan;0;0
36922;73639;617;0;0;0;0;.00nan;0;0
36922;76406;614;86;28;1;27;.964;3600000;0
36922;78262;617;62;27;3;24;.889;3600000;0
36922;156221;614;0;0;0;0;.00nan;0;0
36923;192776;611;68;26;3;23;.885;3588000;0
36923;2140;622;90;29;2;27;.931;3600000;0
36923;156254;611;0;0;0;0;.00nan;0;0
36923;156322;622;0;0;0;0;.00nan;0;0
36924;1061;2308;100;24;0;24;1.000;3600000;0
36924;175651;2319;52;22;3;19;.864;3600000;0
36924;202587;2308;0;0;0;0;.00nan;0;0
36924;73699;2319;0;0;0;0;.00nan;0;0
36925;2140;622;54;30;4;26;.867;3752000;0
36925;73187;620;0;0;0;0;.00nan;0;0
36925;156298;620;80;33;3;30;.909;3752000;0
36925;156322;622;0;0;0;0;.00nan;0;0
36926;32712;612;0;0;0;0;.00nan;0;0
36926;63402;612;42;23;4;19;.826;3600000;0
36926;73639;617;86;28;1;27;.964;3600000;0
36926;78262;617;0;0;0;0;.00nan;0;0
36927;192776;611;78;16;0;16;1.000;3600000;0
36927;10141;4644;78;49;4;45;.918;3600000;0
36927;173279;4644;0;0;0;0;.00nan;0;0
36927;156254;611;0;0;0;0;.00nan;0;0
36928;76406;614;66;26;2;24;.923;3553000;0
36928;84525;1910;0;0;0;0;.00nan;0;0
36928;144410;1910;85;26;1;25;.962;3600000;0
36928;156221;614;0;0;0;0;.00nan;0;0
36929;168021;619;43;15;3;12;.800;3600000;0
36929;173903;2310;56;50;7;43;.860;3600000;0
36929;181660;2310;0;0;0;0;.00nan;0;0
36929;149584;619;0;0;0;0;.00nan;0;0
36930;173903;2310;88;37;2;35;.946;3825000;0
36930;175651;2319;0;0;0;0;.00nan;0;0
36930;181660;2310;0;0;0;0;.00nan;0;0
36930;73699;2319;63;28;3;25;.893;3825000;0
36931;168021;619;0;0;0;0;.00nan;0;0
36931;73639;617;0;0;0;0;.00nan;0;0
36931;78262;617;100;35;0;35;1.000;3600000;0
36931;149584;619;72;17;1;16;.941;3551000;0
36932;32712;612;0;0;0;0;.00nan;0;0
36932;63402;612;61;22;2;20;.909;3600000;0
36932;84525;1910;0;0;0;0;.00nan;0;0
36932;144410;1910;48;37;5;32;.865;3600000;0
36933;10141;4644;0;0;0;0;.00nan;0;0
36933;173279;4644;97;51;1;50;.980;4200000;0
36933;76406;614;81;20;1;19;.950;4200000;0
36933;156221;614;0;0;0;0;.00nan;0;0
36934;192776;611;85;42;3;39;.929;3583000;0
36934;73187;620;0;0;0;0;.00nan;0;0
36934;156254;611;0;0;0;0;.00nan;0;0
36934;156298;620;77;21;1;20;.952;3600000;0
36935;1061;2308;89;30;1;29;.967;3600000;0
36935;2140;622;0;0;0;0;.00nan;0;0
36935;202587;2308;0;0;0;0;.00nan;0;0
36935;156322;622;82;37;3;34;.919;3577000;0
36936;192776;611;63;40;4;36;.900;3600000;0
36936;1061;2308;100;26;0;26;1.000;3600000;0
36936;202587;2308;0;0;0;0;.00nan;0;0
36936;156254;611;0;0;0;0;.00nan;0;0
36937;175651;2319;0;0;0;0;.00nan;0;0
36937;73639;617;0;0;0;0;.00nan;0;0
36937;73699;2319;58;32;4;28;.875;3600000;0
36937;78262;617;80;41;5;36;.878;3600000;0
36938;10141;4644;0;0;0;0;.00nan;0;0
36938;173279;4644;64;33;4;29;.879;3600000;0
36938;73187;620;29;21;5;16;.762;3558000;0
36938;156298;620;0;0;0;0;.00nan;0;0
36939;168021;619;81;20;1;19;.950;3600000;0
36939;84525;1910;82;49;4;45;.918;3600000;0
36939;144410;1910;0;0;0;0;.00nan;0;0
36939;149584;619;0;0;0;0;.00nan;0;0
36940;32712;612;0;0;0;0;.00nan;0;0
36940;63402;612;71;29;2;27;.931;3600000;0
36940;76406;614;0;0;0;0;.00nan;0;0
36940;156221;614;58;40;5;35;.875;3600000;0
36941;2140;622;57;18;2;16;.889;3600000;0
36941;173903;2310;79;40;3;37;.925;3600000;0
36941;181660;2310;0;0;0;0;.00nan;0;0
36941;156322;622;0;0;0;0;.00nan;0;0
36942;175651;2319;87;19;0;19;1.000;3600000;0
36942;73699;2319;0;0;0;0;.00nan;0;0
36942;84525;1910;0;0;0;0;.00nan;0;0
36942;144410;1910;73;55;5;50;.909;3600000;0
36943;1061;2308;77;38;3;35;.921;3600000;0
36943;202587;2308;0;0;0;0;.00nan;0;0
36943;73187;620;30;27;6;21;.778;3600000;0
36943;156298;620;0;0;0;0;.00nan;0;0
36944;168021;619;78;22;1;21;.955;3600000;0
36944;76406;614;78;44;3;41;.932;3600000;0
36944;149584;619;0;0;0;0;.00nan;0;0
36944;156221;614;0;0;0;0;.00nan;0;0
36945;10141;4644;0;0;0;0;.00nan;0;0
36945;173279;4644;96;35;3;32;.914;4200000;0
36945;32712;612;0;0;0;0;.00nan;0;0
36945;63402;612;60;34;3;31;.912;4200000;0
36946;192776;611;66;48;5;43;.896;3600000;0
36946;173903;2310;82;32;2;30;.938;3600000;0
36946;181660;2310;0;0;0;0;.00nan;0;0
36946;156254;611;0;0;0;0;.00nan;0;0
36947;2140;622;44;22;4;18;.818;3610000;0
36947;73639;617;58;41;5;36;.878;3598000;0
36947;78262;617;0;0;0;0;.00nan;0;0
36947;156322;622;0;0;0;0;.00nan;0;0
36948;192776;611;42;36;6;30;.833;3159000;0
36948;73639;617;0;0;0;0;.00nan;0;0
36948;78262;617;100;32;0;32;1.000;3600000;0
36948;156254;611;44;6;1;5;.833;441000;0
36949;1061;2308;40;30;6;24;.800;3600000;0
36949;10141;4644;62;17;1;16;.941;1490000;0
36949;173279;4644;1;18;8;10;.556;2110000;0
36949;202587;2308;0;0;0;0;.00nan;0;0
36950;168021;619;65;17;1;16;.941;3600000;0
36950;32712;612;0;0;0;0;.00nan;0;0
36950;63402;612;80;42;4;38;.905;3600000;0
36950;149584;619;0;0;0;0;.00nan;0;0
36951;2140;622;69;19;1;18;.947;3600000;0
36951;84525;1910;0;0;0;0;.00nan;0;0
36951;144410;1910;55;37;5;32;.865;3600000;0
36951;156322;622;0;0;0;0;.00nan;0;0
36952;175651;2319;82;33;1;32;.970;3600000;0
36952;73699;2319;0;0;0;0;.00nan;0;0
36952;76406;614;58;36;5;31;.861;3600000;0
36952;156221;614;0;0;0;0;.00nan;0;0
36953;173903;2310;99;46;1;45;.978;3600000;0
36953;181660;2310;0;0;0;0;.00nan;0;0
36953;73187;620;0;0;0;0;.00nan;0;0
36953;156298;620;49;28;5;23;.821;3600000;0
36954;1061;2308;76;37;3;34;.919;3600000;0
36954;202587;2308;0;0;0;0;.00nan;0;0
36954;76406;614;41;30;5;25;.833;3584000;0
36954;156221;614;0;0;0;0;.00nan;0;0
36955;1061;2308;56;33;5;28;.848;3576000;0
36955;202587;2308;0;0;0;0;.00nan;0;0
36955;73639;617;0;0;0;0;.00nan;0;0
36955;78262;617;73;33;3;30;.909;3600000;0
36956;168021;619;76;28;2;26;.929;3600000;0
36956;175651;2319;0;0;0;0;.00nan;0;0
36956;73699;2319;60;39;5;34;.872;3600000;0
36956;149584;619;0;0;0;0;.00nan;0;0
36957;73187;620;78;25;1;24;.960;3600000;0
36957;84525;1910;0;0;0;0;.00nan;0;0
36957;144410;1910;35;43;8;35;.814;3600000;0
36957;156298;620;0;0;0;0;.00nan;0;0
36958;10141;4644;77;39;4;35;.897;3600000;0
36958;173279;4644;0;0;0;0;.00nan;0;0
36958;173903;2310;33;31;6;25;.806;3518000;0
36958;181660;2310;0;0;0;0;.00nan;0;0
36959;192776;611;84;31;2;29;.935;3600000;0
36959;76406;614;76;44;4;40;.909;3514000;0
36959;156221;614;0;0;0;0;.00nan;0;0
36959;156254;611;0;0;0;0;.00nan;0;0
36960;2140;622;50;23;3;20;.870;3600000;0
36960;32712;612;0;0;0;0;.00nan;0;0
36960;63402;612;84;34;2;32;.941;3600000;0
36960;156322;622;0;0;0;0;.00nan;0;0
36961;10141;4644;0;0;0;0;.00nan;0;0
36961;173279;4644;46;42;6;36;.857;3564000;0
36961;175651;2319;52;21;4;17;.810;3600000;0
36961;73699;2319;0;0;0;0;.00nan;0;0
36962;173903;2310;45;30;5;25;.833;3570000;0
36962;181660;2310;0;0;0;0;.00nan;0;0
36962;73639;617;62;31;4;27;.871;3600000;0
36962;78262;617;0;0;0;0;.00nan;0;0
36963;2140;622;89;44;4;40;.909;3562000;0
36963;168021;619;72;33;3;30;.909;3600000;0
36963;149584;619;0;0;0;0;.00nan;0;0
36963;156322;622;0;0;0;0;.00nan;0;0
36964;192776;611;53;24;3;21;.875;3529000;0
36964;32712;612;77;25;1;24;.960;3600000;0
36964;63402;612;0;0;0;0;.00nan;0;0
36964;156254;611;0;0;0;0;.00nan;0;0
36965;1061;2308;61;20;2;18;.900;3557000;0
36965;202587;2308;0;0;0;0;.00nan;0;0
36965;84525;1910;0;0;0;0;.00nan;0;0
36965;144410;1910;82;30;1;29;.967;3600000;0
36966;73187;620;0;0;0;0;.00nan;0;0
36966;76406;614;74;28;2;26;.929;3523000;0
36966;156221;614;0;0;0;0;.00nan;0;0
36966;156298;620;100;27;0;27;1.000;3600000;0
36967;1061;2308;41;24;4;20;.833;3534000;0
36967;202587;2308;0;0;0;0;.00nan;0;0
36967;76406;614;84;34;2;32;.941;3600000;0
36967;156221;614;0;0;0;0;.00nan;0;0
36968;32712;612;0;0;0;0;.00nan;0;0
36968;63402;612;40;31;5;26;.839;3600000;0
36968;73187;620;0;0;0;0;.00nan;0;0
36968;156298;620;84;32;2;30;.938;3600000;0
36969;10141;4644;0;0;0;0;.00nan;0;0
36969;173279;4644;87;33;1;32;.970;3600000;0
36969;73639;617;0;0;0;0;.00nan;0;0
36969;78262;617;60;27;3;24;.889;3600000;0
36970;173903;2310;68;19;1;18;.947;3600000;0
36970;181660;2310;0;0;0;0;.00nan;0;0
36970;84525;1910;0;0;0;0;.00nan;0;0
36970;144410;1910;48;33;5;28;.848;3600000;0
36971;192776;611;0;0;0;0;.00nan;0;0
36971;168021;619;71;30;3;27;.900;4200000;0
36971;149584;619;0;0;0;0;.00nan;0;0
36971;156254;611;75;22;2;20;.909;4200000;0
36972;2140;622;91;36;1;35;.972;3600000;0
36972;175651;2319;0;0;0;0;.00nan;0;0
36972;73699;2319;71;34;3;31;.912;3514000;0
36972;156322;622;0;0;0;0;.00nan;0;0
36973;192776;611;42;35;6;29;.829;3600000;0
36973;175651;2319;79;40;3;37;.925;3600000;0
36973;73699;2319;0;0;0;0;.00nan;0;0
36973;156254;611;0;0;0;0;.00nan;0;0
36974;168021;619;44;13;2;11;.846;3600000;0
36974;73187;620;55;51;7;44;.863;3600000;0
36974;149584;619;0;0;0;0;.00nan;0;0
36974;156298;620;0;0;0;0;.00nan;0;0
36975;1061;2308;45;10;2;8;.800;3600000;0
36975;32712;612;0;0;0;0;.00nan;0;0
36975;202587;2308;0;0;0;0;.00nan;0;0
36975;63402;612;88;47;4;43;.915;3548000;0
36976;73639;617;73;18;1;17;.944;3600000;0
36976;78262;617;0;0;0;0;.00nan;0;0
36976;84525;1910;75;49;5;44;.898;3600000;0
36976;144410;1910;0;0;0;0;.00nan;0;0
36977;173903;2310;76;46;3;43;.935;4200000;0
36977;181660;2310;0;0;0;0;.00nan;0;0
36977;76406;614;88;48;3;45;.938;4200000;0
36977;156221;614;0;0;0;0;.00nan;0;0
36978;2140;622;0;0;0;0;.00nan;0;0
36978;10141;4644;0;0;0;0;.00nan;0;0
36978;173279;4644;96;59;3;56;.949;3563000;0
36978;156322;622;62;13;1;12;.923;3600000;0
36979;1061;2308;0;0;0;0;.00nan;0;0
36979;168021;619;88;21;1;20;.952;3600000;0
36979;202587;2308;58;39;5;34;.872;3600000;0
36979;149584;619;0;0;0;0;.00nan;0;0
36980;175651;2319;64;44;5;39;.886;3818000;0
36980;73187;620;28;29;6;23;.793;3818000;0
36980;73699;2319;0;0;0;0;.00nan;0;0
36980;156298;620;0;0;0;0;.00nan;0;0
36981;73639;617;0;0;0;0;.00nan;0;0
36981;76406;614;81;41;4;37;.902;3583000;0
36981;78262;617;83;41;3;38;.927;3600000;0
36981;156221;614;0;0;0;0;.00nan;0;0
36982;10141;4644;0;0;0;0;.00nan;0;0
36982;173279;4644;89;32;1;31;.969;3600000;0
36982;84525;1910;0;0;0;0;.00nan;0;0
36982;144410;1910;70;28;3;25;.893;3540000;0
36983;173903;2310;64;25;2;23;.920;3600000;0
36983;32712;612;0;0;0;0;.00nan;0;0
36983;181660;2310;0;0;0;0;.00nan;0;0
36983;63402;612;84;40;3;37;.925;3571000;0
36984;192776;611;92;47;2;45;.957;3600000;0
36984;2140;622;52;23;3;20;.870;3565000;0
36984;156254;611;0;0;0;0;.00nan;0;0
36984;156322;622;0;0;0;0;.00nan;0;0
36985;1061;2308;72;50;5;45;.900;3567000;0
36985;175651;2319;0;0;0;0;.00nan;0;0
36985;202587;2308;0;0;0;0;.00nan;0;0
36985;73699;2319;63;22;3;19;.864;3600000;0
36986;168021;619;61;20;2;18;.900;3600000;0
36986;173903;2310;67;31;3;28;.903;3600000;0
36986;181660;2310;0;0;0;0;.00nan;0;0
36986;149584;619;0;0;0;0;.00nan;0;0
36987;32712;612;0;0;0;0;.00nan;0;0
36987;63402;612;91;44;1;43;.977;3600000;0
36987;73639;617;80;37;3;34;.919;3544000;0
36987;78262;617;0;0;0;0;.00nan;0;0
36988;76406;614;76;26;2;24;.923;3600000;0
36988;84525;1910;0;0;0;0;.00nan;0;0
36988;144410;1910;29;33;7;26;.788;3600000;0
36988;156221;614;0;0;0;0;.00nan;0;0
36989;192776;611;99;18;0;18;1.000;3600000;0
36989;10141;4644;0;0;0;0;.00nan;0;0
36989;173279;4644;74;45;4;41;.911;3600000;0
36989;156254;611;0;0;0;0;.00nan;0;0
36990;2140;622;89;28;1;27;.964;3600000;0
36990;73187;620;0;0;0;0;.00nan;0;0
36990;156298;620;68;38;5;33;.868;3600000;0
36990;156322;622;0;0;0;0;.00nan;0;0
36991;1061;2308;79;30;2;28;.933;3600000;0
36991;2140;622;44;23;4;19;.826;3600000;0
36991;202587;2308;0;0;0;0;.00nan;0;0
36991;156322;622;0;0;0;0;.00nan;0;0
36992;192776;611;73;31;2;29;.935;4200000;0
36992;73187;620;0;0;0;0;.00nan;0;0
36992;156254;611;0;0;0;0;.00nan;0;0
36992;156298;620;77;37;2;35;.946;4200000;0
36993;168021;619;52;21;3;18;.857;3712000;0
36993;73639;617;70;40;4;36;.900;3712000;0
36993;78262;617;0;0;0;0;.00nan;0;0
36993;149584;619;0;0;0;0;.00nan;0;0
36994;10141;4644;0;0;0;0;.00nan;0;0
36994;173279;4644;81;39;2;37;.949;3600000;0
36994;76406;614;34;28;6;22;.786;2924000;0
36994;156221;614;59;6;0;6;1.000;676000;0
36995;32712;612;0;0;0;0;.00nan;0;0
36995;63402;612;44;29;5;24;.828;3568000;0
36995;84525;1910;73;34;3;31;.912;3600000;0
36995;144410;1910;0;0;0;0;.00nan;0;0
36996;173903;2310;0;0;0;0;.00nan;0;0
36996;175651;2319;45;31;5;26;.839;2783000;0
36996;181660;2310;84;31;2;29;.935;3600000;0
36996;73699;2319;58;4;0;4;1.000;817000;0
36997;175651;2319;0;0;0;0;.00nan;0;0
36997;73639;617;26;41;8;33;.805;3600000;0
36997;73699;2319;48;28;5;23;.821;3600000;0
36997;78262;617;0;0;0;0;.00nan;0;0
36998;10141;4644;0;0;0;0;.00nan;0;0
36998;173279;4644;78;40;3;37;.925;3571000;0
36998;73187;620;79;26;2;24;.923;3600000;0
36998;156298;620;0;0;0;0;.00nan;0;0
36999;168021;619;46;19;3;16;.842;3600000;0
36999;84525;1910;63;12;0;12;1.000;1069000;0
36999;144410;1910;38;43;7;36;.837;2531000;0
36999;149584;619;0;0;0;0;.00nan;0;0
37000;32712;612;0;0;0;0;.00nan;0;0
37000;63402;612;71;19;1;18;.947;3600000;0
37000;76406;614;69;48;5;43;.896;3600000;0
37000;156221;614;0;0;0;0;.00nan;0;0
37001;192776;611;66;33;3;30;.909;4155000;0
37001;1061;2308;78;26;2;24;.923;4155000;0
37001;202587;2308;0;0;0;0;.00nan;0;0
37001;156254;611;0;0;0;0;.00nan;0;0
37002;2140;622;99;40;1;39;.975;3600000;0
37002;173903;2310;75;30;2;28;.933;3546000;0
37002;181660;2310;0;0;0;0;.00nan;0;0
37002;156322;622;0;0;0;0;.00nan;0;0
37003;1061;2308;54;22;3;19;.864;3600000;0
37003;202587;2308;0;0;0;0;.00nan;0;0
37003;73187;620;0;0;0;0;.00nan;0;0
37003;156298;620;61;35;4;31;.886;3600000;0
37004;2140;622;67;29;3;26;.897;4200000;0
37004;73639;617;0;0;0;0;.00nan;0;0
37004;78262;617;97;56;3;53;.946;4200000;0
37004;156322;622;0;0;0;0;.00nan;0;0
37005;10141;4644;0;0;0;0;.00nan;0;0
37005;173279;4644;48;30;4;26;.867;3577000;0
37005;32712;612;0;0;0;0;.00nan;0;0
37005;63402;612;55;22;3;19;.864;3600000;0
37006;175651;2319;89;19;0;19;1.000;3600000;0
37006;73699;2319;0;0;0;0;.00nan;0;0
37006;84525;1910;0;0;0;0;.00nan;0;0
37006;144410;1910;55;37;5;32;.865;3600000;0
37007;168021;619;22;22;6;16;.727;1964000;0
37007;76406;614;0;0;0;0;.00nan;0;0
37007;149584;619;60;17;1;16;.941;1636000;0
37007;156221;614;48;24;4;20;.833;3600000;0
37008;192776;611;100;30;0;30;1.000;3600000;0
37008;173903;2310;76;25;2;23;.920;3513000;0
37008;181660;2310;0;0;0;0;.00nan;0;0
37008;156254;611;0;0;0;0;.00nan;0;0
37009;168021;619;27;23;6;17;.739;3518000;0
37009;76406;614;44;22;4;18;.818;3600000;0
37009;149584;619;0;0;0;0;.00nan;0;0
37009;156221;614;0;0;0;0;.00nan;0;0
37010;2140;622;78;21;1;20;.952;3600000;0
37010;32712;612;0;0;0;0;.00nan;0;0
37010;63402;612;79;29;2;27;.931;3600000;0
37010;156322;622;0;0;0;0;.00nan;0;0
37011;1061;2308;72;25;2;23;.920;4153000;0
37011;10141;4644;0;0;0;0;.00nan;0;0
37011;173279;4644;75;40;3;37;.925;4197000;0
37011;202587;2308;0;0;0;0;.00nan;0;0
37012;175651;2319;35;29;5;24;.828;2960000;0
37012;73699;2319;53;9;1;8;.889;640000;0
37012;76406;614;70;32;3;29;.906;3600000;0
37012;156221;614;0;0;0;0;.00nan;0;0
37013;173903;2310;81;43;5;38;.884;3600000;0
37013;181660;2310;0;0;0;0;.00nan;0;0
37013;73187;620;0;0;0;0;.00nan;0;0
37013;156298;620;73;23;2;21;.913;3600000;0
37014;168021;619;53;14;2;12;.857;3600000;0
37014;32712;612;0;0;0;0;.00nan;0;0
37014;63402;612;78;42;4;38;.905;3600000;0
37014;149584;619;0;0;0;0;.00nan;0;0
37015;192776;611;81;36;2;34;.944;3807000;0
37015;73639;617;58;23;3;20;.870;3807000;0
37015;78262;617;0;0;0;0;.00nan;0;0
37015;156254;611;0;0;0;0;.00nan;0;0
37016;2140;622;0;0;0;0;.00nan;0;0
37016;84525;1910;0;0;0;0;.00nan;0;0
37016;144410;1910;90;37;1;36;.973;3600000;0
37016;156322;622;59;21;2;19;.905;3544000;0
37017;73187;620;0;0;0;0;.00nan;0;0
37017;73639;617;0;0;0;0;.00nan;0;0
37017;78262;617;82;33;2;31;.939;3600000;0
37017;156298;620;50;52;7;45;.865;3600000;0
37018;10141;4644;0;0;0;0;.00nan;0;0
37018;168021;619;73;14;1;13;.929;3600000;0
37018;173279;4644;60;53;5;48;.906;3600000;0
37018;149584;619;0;0;0;0;.00nan;0;0
37019;175651;2319;60;28;3;25;.893;3536000;0
37019;32712;612;0;0;0;0;.00nan;0;0
37019;63402;612;98;36;1;35;.972;3600000;0
37019;73699;2319;0;0;0;0;.00nan;0;0
37020;192776;611;86;28;1;27;.964;3661000;0
37020;84525;1910;79;29;2;27;.931;3661000;0
37020;144410;1910;0;0;0;0;.00nan;0;0
37020;156254;611;0;0;0;0;.00nan;0;0
37021;2140;622;69;19;1;18;.947;3600000;0
37021;76406;614;34;17;4;13;.765;753000;0
37021;156221;614;74;31;3;28;.903;2847000;0
37021;156322;622;0;0;0;0;.00nan;0;0
37022;1061;2308;50;37;5;32;.865;3595000;0
37022;173903;2310;54;21;3;18;.857;3600000;0
37022;181660;2310;0;0;0;0;.00nan;0;0
37022;202587;2308;0;0;0;0;.00nan;0;0
37024;175651;2319;63;32;3;29;.906;4200000;0
37024;73699;2319;0;0;0;0;.00nan;0;0
37024;76406;614;73;34;3;31;.912;4200000;0
37024;156221;614;0;0;0;0;.00nan;0;0
37026;173903;2310;73;30;2;28;.933;3547000;0
37026;181660;2310;0;0;0;0;.00nan;0;0
37026;73639;617;76;27;1;26;.963;3600000;0
37026;78262;617;0;0;0;0;.00nan;0;0
37028;1061;2308;57;16;2;14;.875;3600000;0
37028;10141;1910;0;0;0;0;.00nan;0;0
37028;202587;2308;0;0;0;0;.00nan;0;0
37028;144410;1910;71;47;4;43;.915;3600000;0
37030;176437;619;0;0;0;0;.00nan;0;0
37030;63402;612;88;40;2;38;.950;3561000;0
37030;149584;619;82;23;1;22;.957;3600000;0
37030;156254;612;0;0;0;0;.00nan;0;0
37032;192776;611;41;33;5;28;.848;3610000;0
37032;173279;4644;29;30;6;24;.800;3610000;0
37032;32712;611;0;0;0;0;.00nan;0;0
37032;84525;4644;0;0;0;0;.00nan;0;0
37034;2140;622;76;26;1;25;.962;3600000;0
37034;73187;620;0;0;0;0;.00nan;0;0
37034;156298;620;60;37;4;33;.892;3600000;0
37034;156322;622;0;0;0;0;.00nan;0;0
37036;1061;2308;0;0;0;0;.00nan;0;0
37036;202587;2308;84;36;2;34;.944;3535000;0
37036;73187;620;98;22;0;22;1.000;3600000;0
37036;156298;620;0;0;0;0;.00nan;0;0
37040;192776;611;0;0;0;0;.00nan;0;0
37040;175651;2319;0;0;0;0;.00nan;0;0
37040;32712;611;56;31;4;27;.871;3519000;0
37040;73699;2319;70;30;2;28;.933;3600000;0
37042;63402;612;0;0;0;0;.00nan;0;0
37042;76406;614;0;0;0;0;.00nan;0;0
37042;156221;614;61;25;3;22;.880;3600000;0
37042;156254;612;41;35;6;29;.829;3600000;0
37044;173903;2310;0;0;0;0;.00nan;0;0
37044;181660;2310;74;23;1;22;.957;3570000;0
37044;73639;617;0;0;0;0;.00nan;0;0
37044;78262;617;100;34;0;34;1.000;3600000;0
37046;10141;1910;100;27;0;27;1.000;3600000;0
37046;173279;4644;58;23;3;20;.870;3600000;0
37046;84525;4644;0;0;0;0;.00nan;0;0
37046;144410;1910;0;0;0;0;.00nan;0;0
37050;192776;611;42;32;5;27;.844;4200000;0
37050;32712;612;0;0;0;0;.00nan;0;0
37050;63402;612;61;48;5;43;.896;4200000;0
37050;156254;611;0;0;0;0;.00nan;0;0
37052;10141;4644;85;49;4;45;.918;3600000;0
37052;173279;4644;0;0;0;0;.00nan;0;0
37052;173903;2310;59;29;3;26;.897;3600000;0
37052;181660;2310;0;0;0;0;.00nan;0;0
37054;1061;2308;43;18;4;14;.778;3600000;0
37054;176437;619;0;0;0;0;.00nan;0;0
37054;202587;2308;0;0;0;0;.00nan;0;0
37054;149584;619;50;44;6;38;.864;3562000;0
37056;175651;2319;0;0;0;0;.00nan;0;0
37056;73187;620;38;29;6;23;.793;3600000;0
37056;73699;2319;78;35;3;32;.914;3600000;0
37056;156298;620;0;0;0;0;.00nan;0;0
37058;73639;617;0;0;0;0;.00nan;0;0
37058;78262;617;80;20;1;19;.950;3600000;0
37058;84525;1910;0;0;0;0;.00nan;0;0
37058;144410;1910;62;41;4;37;.902;3600000;0
37060;192776;611;80;24;1;23;.958;3600000;0
37060;173903;2310;68;33;3;30;.909;3575000;0
37060;181660;2310;0;0;0;0;.00nan;0;0
37060;156254;611;0;0;0;0;.00nan;0;0
37062;176437;619;0;0;0;0;.00nan;0;0
37062;73187;620;0;0;0;0;.00nan;0;0
37062;149584;619;60;30;3;27;.900;3600000;0
37062;156298;620;80;31;2;29;.935;3600000;0
37064;10141;4644;0;0;0;0;.00nan;0;0
37064;173279;4644;58;38;5;33;.868;4200000;0
37064;32712;612;0;0;0;0;.00nan;0;0
37064;63402;612;57;44;5;39;.886;4200000;0
37068;175651;2319;100;29;0;29;1.000;3600000;0
37068;73699;2319;0;0;0;0;.00nan;0;0
37068;76406;614;98;42;1;41;.976;3579000;0
37068;156221;614;0;0;0;0;.00nan;0;0
37070;73639;617;71;30;2;28;.933;3600000;0
37070;78262;617;0;0;0;0;.00nan;0;0
37070;84525;1910;66;32;3;29;.906;3596000;0
37070;144410;1910;0;0;0;0;.00nan;0;0
37072;192776;611;0;0;0;0;.00nan;0;0
37072;175651;2319;100;28;0;28;1.000;3600000;0
37072;73699;2319;0;0;0;0;.00nan;0;0
37072;156254;611;77;31;2;29;.935;3562000;0
37076;176437;619;58;33;4;29;.879;3600000;0
37076;73187;620;14;12;5;7;.583;1606000;0
37076;149584;619;0;0;0;0;.00nan;0;0
37076;156298;620;4;14;6;8;.571;1994000;0
37078;10141;4644;85;44;3;41;.932;3540000;0
37078;173279;4644;0;0;0;0;.00nan;0;0
37078;73639;617;0;0;0;0;.00nan;0;0
37078;78262;617;73;21;1;20;.952;3600000;0
37080;32712;612;49;33;5;28;.848;3600000;0
37080;63402;612;0;0;0;0;.00nan;0;0
37080;84525;1910;61;11;0;11;1.000;884000;0
37080;144410;1910;38;29;6;23;.793;2716000;0
37082;1061;2308;51;30;4;26;.867;3592000;0
37082;202587;2308;0;0;0;0;.00nan;0;0
37082;76406;614;0;0;0;0;.00nan;0;0
37082;156221;614;92;42;2;40;.952;3600000;0
37084;73639;617;86;31;2;29;.935;3600000;0
37084;78262;617;0;0;0;0;.00nan;0;0
37084;84525;1910;0;0;0;0;.00nan;0;0
37084;144410;1910;55;33;4;29;.879;3580000;0
37086;1061;2308;27;9;4;5;.556;1174000;0
37086;176437;619;0;0;0;0;.00nan;0;0
37086;202587;2308;42;19;3;16;.842;2426000;0
37086;149584;619;100;35;0;35;1.000;3600000;0
37090;10141;4644;0;0;0;0;.00nan;0;0
37090;173279;4644;92;37;2;35;.946;3600000;0
37090;76406;614;41;25;4;21;.840;3532000;0
37090;156221;614;0;0;0;0;.00nan;0;0
37092;192776;611;67;28;2;26;.929;4126000;0
37092;175651;2319;73;33;3;30;.909;4126000;0
37092;73699;2319;0;0;0;0;.00nan;0;0
37092;156254;611;0;0;0;0;.00nan;0;0
37094;173903;2310;62;30;3;27;.900;3537000;0
37094;181660;2310;0;0;0;0;.00nan;0;0
37094;73187;620;79;22;1;21;.955;3600000;0
37094;156298;620;0;0;0;0;.00nan;0;0
37096;1061;2308;58;29;3;26;.897;4200000;0
37096;202587;2308;0;0;0;0;.00nan;0;0
37096;73639;617;0;0;0;0;.00nan;0;0
37096;78262;617;75;47;3;44;.936;4200000;0
37098;173903;2310;0;0;0;0;.00nan;0;0
37098;181660;2310;62;30;3;27;.900;3553000;0
37098;73187;620;0;0;0;0;.00nan;0;0
37098;156298;620;94;28;1;27;.964;3600000;0
37100;10141;4644;43;48;7;41;.854;3600000;0
37100;173279;4644;0;0;0;0;.00nan;0;0
37100;76406;614;0;0;0;0;.00nan;0;0
37100;156221;614;57;25;3;22;.880;3600000;0
37102;192776;611;97;42;2;40;.952;3540000;0
37102;176437;619;0;0;0;0;.00nan;0;0
37102;149584;619;93;17;0;17;1.000;3600000;0
37102;156254;611;0;0;0;0;.00nan;0;0
37106;175651;2319;0;0;0;0;.00nan;0;0
37106;73699;2319;95;18;0;18;1.000;3600000;0
37106;84525;1910;40;38;6;32;.842;2558000;0
37106;144410;1910;25;11;4;7;.636;1042000;0
977;168021;619;60;25;3;22;.880;3600000;0
977;73187;620;33;32;7;25;.781;2539000;0
977;149584;619;0;0;0;0;.00nan;0;0
977;156298;620;37;18;4;14;.778;1061000;0
978;175651;2319;32;35;6;29;.829;3560000;0
978;73639;617;53;26;4;22;.846;3600000;0
978;73699;2319;0;0;0;0;.00nan;0;0
978;78262;617;0;0;0;0;.00nan;0;0
979;1061;2308;79;24;1;23;.958;3600000;0
979;32712;612;29;8;3;5;.625;633000;0
979;202587;2308;0;0;0;0;.00nan;0;0
979;63402;612;47;42;6;36;.857;2967000;0
980;192776;611;21;10;4;6;.600;534000;0
980;2140;622;61;35;4;31;.886;3600000;0
980;156254;611;83;28;1;27;.964;3012000;0
980;156322;622;0;0;0;0;.00nan;0;0
981;168021;619;81;23;1;22;.957;3600000;0
981;73187;620;0;0;0;0;.00nan;0;0
981;149584;619;0;0;0;0;.00nan;0;0
981;156298;620;58;34;5;29;.853;3600000;0
982;175651;2319;60;27;3;24;.889;3600000;0
982;73639;617;72;41;4;37;.902;3565000;0
982;73699;2319;0;0;0;0;.00nan;0;0
982;78262;617;0;0;0;0;.00nan;0;0
983;1061;2308;72;34;3;31;.912;4041000;0
983;32712;612;0;0;0;0;.00nan;0;0
983;202587;2308;0;0;0;0;.00nan;0;0
983;63402;612;78;48;4;44;.917;4041000;0
984;192776;611;97;47;1;46;.979;3550000;0
984;2140;622;100;29;0;29;1.000;3600000;0
984;156254;611;0;0;0;0;.00nan;0;0
984;156322;622;0;0;0;0;.00nan;0;0
985;168021;619;42;21;4;17;.810;3600000;0
985;73187;620;0;0;0;0;.00nan;0;0
985;149584;619;0;0;0;0;.00nan;0;0
985;156298;620;43;38;6;32;.842;3535000;0
986;175651;2319;90;35;1;34;.971;3600000;0
986;73639;617;57;40;5;35;.875;3600000;0
986;73699;2319;0;0;0;0;.00nan;0;0
986;78262;617;0;0;0;0;.00nan;0;0
987;1061;2308;24;32;7;25;.781;3600000;0
987;32712;612;0;0;0;0;.00nan;0;0
987;202587;2308;0;0;0;0;.00nan;0;0
987;63402;612;57;32;4;28;.875;3600000;0
988;192776;611;82;47;4;43;.915;3600000;0
988;2140;622;80;21;1;20;.952;3600000;0
988;156254;611;0;0;0;0;.00nan;0;0
988;156322;622;0;0;0;0;.00nan;0;0
989;168021;619;86;24;1;23;.958;3600000;0
989;73187;620;0;0;0;0;.00nan;0;0
989;149584;619;0;0;0;0;.00nan;0;0
989;156298;620;53;38;5;33;.868;3600000;0
990;175651;2319;35;28;5;23;.821;2943000;0
990;73639;617;68;34;3;31;.912;3600000;0
990;73699;2319;45;6;1;5;.833;657000;0
990;78262;617;0;0;0;0;.00nan;0;0
991;1061;2308;45;22;4;18;.818;3600000;0
991;32712;612;0;0;0;0;.00nan;0;0
991;202587;2308;0;0;0;0;.00nan;0;0
991;63402;612;79;39;3;36;.923;3600000;0
992;192776;611;40;38;6;32;.842;3600000;0
992;2140;622;99;33;1;32;.970;3600000;0
992;156254;611;0;0;0;0;.00nan;0;0
992;156322;622;0;0;0;0;.00nan;0;0
1357;175651;2319;0;0;0;0;.00nan;0;0
1357;73639;617;76;25;1;24;.960;3911000;0
1357;73699;2319;82;36;2;34;.944;3911000;0
1357;78262;617;0;0;0;0;.00nan;0;0
1358;1061;2308;61;38;5;33;.868;3547000;0
1358;32712;612;0;0;0;0;.00nan;0;0
1358;202587;2308;0;0;0;0;.00nan;0;0
1358;63402;612;57;26;3;23;.885;3600000;0
1450;175651;2319;0;0;0;0;.00nan;0;0
1450;73639;617;46;21;3;18;.857;3536000;0
1450;73699;2319;80;34;1;33;.971;3600000;0
1450;78262;617;0;0;0;0;.00nan;0;0
1451;1061;2308;31;24;5;19;.792;3559000;0
1451;32712;612;0;0;0;0;.00nan;0;0
1451;202587;2308;0;0;0;0;.00nan;0;0
1451;63402;612;84;45;4;41;.911;3600000;0
1484;175651;2319;0;0;0;0;.00nan;0;0
1484;73639;617;67;35;3;32;.914;3573000;0
1484;73699;2319;75;24;1;23;.958;3600000;0
1484;78262;617;0;0;0;0;.00nan;0;0
1554;168021;619;68;22;1;21;.955;3600000;0
1554;32712;612;0;0;0;0;.00nan;0;0
1554;63402;612;54;49;6;43;.878;3600000;0
1554;149584;619;0;0;0;0;.00nan;0;0
1555;2140;622;85;29;1;28;.966;3600000;0
1555;175651;2319;58;29;3;26;.897;3556000;0
1555;73699;2319;0;0;0;0;.00nan;0;0
1555;156322;622;0;0;0;0;.00nan;0;0
1556;168021;619;59;14;2;12;.857;3600000;0
1556;32712;612;36;16;3;13;.813;899000;0
1556;63402;612;32;31;6;25;.806;2701000;0
1556;149584;619;0;0;0;0;.00nan;0;0
1557;2140;622;79;24;1;23;.958;3600000;0
1557;175651;2319;51;40;5;35;.875;3600000;0
1557;73699;2319;0;0;0;0;.00nan;0;0
1557;156322;622;0;0;0;0;.00nan;0;0
1558;168021;619;55;29;4;25;.862;3600000;0
1558;32712;612;0;0;0;0;.00nan;0;0
1558;63402;612;64;45;5;40;.889;3596000;0
1558;149584;619;0;0;0;0;.00nan;0;0
1559;2140;622;73;24;2;22;.917;3600000;0
1559;175651;2319;87;54;5;49;.907;3600000;0
1559;73699;2319;0;0;0;0;.00nan;0;0
1559;156322;622;0;0;0;0;.00nan;0;0
1560;168021;619;51;25;4;21;.840;3600000;0
1560;32712;612;0;0;0;0;.00nan;0;0
1560;63402;612;56;37;5;32;.865;3600000;0
1560;149584;619;0;0;0;0;.00nan;0;0
1561;2140;622;89;25;1;24;.960;3600000;0
1561;175651;2319;37;33;6;27;.818;3163000;0
1561;73699;2319;56;5;0;5;1.000;437000;0
1561;156322;622;0;0;0;0;.00nan;0;0
1842;2140;622;77;36;3;33;.917;3580000;0
1842;168021;619;72;21;1;20;.952;3600000;0
1842;149584;619;0;0;0;0;.00nan;0;0
1842;156322;622;0;0;0;0;.00nan;0;0
1843;2140;622;70;31;2;29;.935;3600000;0
1843;168021;619;30;34;6;28;.824;3600000;0
1843;149584;619;0;0;0;0;.00nan;0;0
1843;156322;622;0;0;0;0;.00nan;0;0
1844;2140;622;70;39;5;34;.872;3537000;0
1844;168021;619;72;30;3;27;.900;3600000;0
1844;149584;619;0;0;0;0;.00nan;0;0
1844;156322;622;0;0;0;0;.00nan;0;0
1845;2140;622;92;35;2;33;.943;3801000;0
1845;168021;619;95;36;1;35;.972;3801000;0
1845;149584;619;0;0;0;0;.00nan;0;0
1845;156322;622;0;0;0;0;.00nan;0;0
1979;2140;622;83;33;2;31;.939;3600000;0
1979;168021;619;39;23;4;19;.826;3533000;0
1979;149584;619;0;0;0;0;.00nan;0;0
1979;156322;622;0;0;0;0;.00nan;0;0
2066;2140;622;90;39;2;37;.949;3600000;0
2066;168021;619;43;24;4;20;.833;3552000;0
2066;149584;619;0;0;0;0;.00nan;0;0
2066;156322;622;0;0;0;0;.00nan;0;0
2127;2140;622;89;41;2;39;.951;3564000;0
2127;168021;619;85;27;1;26;.963;3600000;0
2127;149584;619;0;0;0;0;.00nan;0;0
2127;156322;622;0;0;0;0;.00nan;0;0
37107;179151;718;71;18;1;17;.944;3900000;0
37107;181446;2188;87;31;1;30;.968;3900000;0
37107;-1;2188;0;0;0;0;.00nan;0;0
37107;-1;718;0;0;0;0;.00nan;0;0
37108;182339;715;58;38;4;34;.895;3514000;0
37108;28394;719;0;0;0;0;.00nan;0;0
37108;66721;719;79;29;2;27;.931;3600000;0
37108;160650;715;0;0;0;0;.00nan;0;0
37109;168842;2529;45;31;6;25;.806;3600000;0
37109;185775;720;53;25;4;21;.840;3600000;0
37109;-1;2529;0;0;0;0;.00nan;0;0
37109;-1;720;0;0;0;0;.00nan;0;0
37110;184437;716;99;33;1;32;.970;3600000;0
37110;-1;721;73;29;2;27;.931;3543000;0
37110;55918;716;0;0;0;0;.00nan;0;0
37110;77009;721;0;0;0;0;.00nan;0;0
37111;883;717;0;0;0;0;.00nan;0;0
37111;175712;717;89;32;1;31;.969;3600000;0
37111;185775;720;58;25;3;22;.880;3556000;0
37111;-1;720;0;0;0;0;.00nan;0;0
37112;168842;2529;43;31;5;26;.839;3900000;0
37112;-1;721;0;0;0;0;.00nan;0;0
37112;-1;2529;0;0;0;0;.00nan;0;0
37112;77009;721;54;43;5;38;.884;3900000;0
37113;28394;719;0;0;0;0;.00nan;0;0
37113;181446;2188;47;30;4;26;.867;3562000;0
37113;-1;2188;0;0;0;0;.00nan;0;0
37113;66721;719;44;19;3;16;.842;3600000;0
37114;182339;715;87;27;1;26;.963;3600000;0
37114;184437;716;65;27;3;24;.889;3542000;0
37114;55918;716;0;0;0;0;.00nan;0;0
37114;160650;715;0;0;0;0;.00nan;0;0
37115;184437;716;76;27;1;26;.963;3600000;0
37115;181446;2188;76;34;3;31;.912;3545000;0
37115;-1;2188;0;0;0;0;.00nan;0;0
37115;55918;716;0;0;0;0;.00nan;0;0
37116;182339;715;0;0;0;0;.00nan;0;0
37116;168842;2529;67;38;4;34;.895;3600000;0
37116;-1;2529;0;0;0;0;.00nan;0;0
37116;160650;715;73;21;1;20;.952;3600000;0
37117;179151;718;79;28;2;26;.929;3600000;0
37117;28394;719;0;0;0;0;.00nan;0;0
37117;-1;718;0;0;0;0;.00nan;0;0
37117;66721;719;48;37;6;31;.838;3600000;0
37118;183905;721;92;46;3;43;.935;3600000;0
37118;175712;717;0;0;0;0;.00nan;0;0
37118;77009;721;0;0;0;0;.00nan;0;0
37118;86283;717;55;19;2;17;.895;3600000;0
37119;182339;715;32;17;4;13;.765;1015000;0
37119;175712;717;0;0;0;0;.00nan;0;0
37119;86283;717;99;28;0;28;1.000;3600000;0
37119;160650;715;97;28;0;28;1.000;2585000;0
37120;168842;2529;58;33;4;29;.879;3542000;0
37120;181446;2188;74;39;3;36;.923;3600000;0
37120;-1;2529;0;0;0;0;.00nan;0;0
37120;-1;2188;0;0;0;0;.00nan;0;0
37121;183905;721;69;52;6;46;.885;3600000;0
37121;185775;720;78;23;1;22;.957;3600000;0
37121;-1;720;0;0;0;0;.00nan;0;0
37121;77009;721;0;0;0;0;.00nan;0;0
37122;184437;716;100;40;1;39;.975;3600000;0
37122;179151;718;58;30;4;26;.867;3600000;0
37122;-1;718;0;0;0;0;.00nan;0;0
37122;55918;716;0;0;0;0;.00nan;0;0
37123;175712;717;0;0;0;0;.00nan;0;0
37123;181446;2188;71;39;4;35;.897;3577000;0
37123;-1;2188;0;0;0;0;.00nan;0;0
37123;86283;717;53;19;2;17;.895;3600000;0
37124;182339;715;73;45;4;41;.911;3738000;0
37124;185775;720;50;21;3;18;.857;3738000;0
37124;-1;720;0;0;0;0;.00nan;0;0
37124;160650;715;0;0;0;0;.00nan;0;0
37125;168842;2529;53;28;4;24;.857;3600000;0
37125;179151;718;95;31;1;30;.968;3600000;0
37125;-1;2529;0;0;0;0;.00nan;0;0
37125;-1;718;0;0;0;0;.00nan;0;0
37126;184437;716;47;35;6;29;.829;3600000;0
37126;28394;719;73;33;3;30;.909;3600000;0
37126;55918;716;0;0;0;0;.00nan;0;0
37126;66721;719;0;0;0;0;.00nan;0;0
37127;179151;718;91;56;2;54;.964;3600000;0
37127;175712;717;0;0;0;0;.00nan;0;0
37127;-1;718;0;0;0;0;.00nan;0;0
37127;86283;717;66;13;1;12;.923;3600000;0
37128;168842;2529;89;33;2;31;.939;3585000;0
37128;28394;719;0;0;0;0;.00nan;0;0
37128;-1;2529;0;0;0;0;.00nan;0;0
37128;66721;719;98;26;0;26;1.000;3600000;0
37129;181446;2188;50;32;5;27;.844;3856000;0
37129;185775;720;68;31;4;27;.871;3856000;0
37129;-1;720;0;0;0;0;.00nan;0;0
37129;-1;2188;0;0;0;0;.00nan;0;0
37130;182339;715;0;0;0;0;.00nan;0;0
37130;183905;721;67;26;2;24;.923;3600000;0
37130;77009;721;0;0;0;0;.00nan;0;0
37130;160650;715;48;22;3;19;.864;3600000;0
37131;183905;721;66;54;7;47;.870;3600000;0
37131;181446;2188;0;0;0;0;.00nan;0;0
37131;-1;2188;85;34;3;31;.912;3600000;0
37131;77009;721;0;0;0;0;.00nan;0;0
37132;179151;718;77;23;1;22;.957;3600000;0
37132;185775;720;69;27;2;25;.926;3600000;0
37132;-1;720;0;0;0;0;.00nan;0;0
37132;-1;718;0;0;0;0;.00nan;0;0
37133;28394;719;0;0;0;0;.00nan;0;0
37133;175712;717;0;0;0;0;.00nan;0;0
37133;66721;719;46;25;4;21;.840;3600000;0
37133;86283;717;88;29;1;28;.966;3600000;0
37134;168842;2529;60;22;2;20;.909;3600000;0
37134;184437;716;0;0;0;0;.00nan;0;0
37134;-1;2529;0;0;0;0;.00nan;0;0
37134;55918;716;73;37;3;34;.919;3600000;0
37135;184437;716;8;22;7;15;.682;2124000;0
37135;175712;717;0;0;0;0;.00nan;0;0
37135;55918;716;3;25;8;17;.680;1476000;0
37135;86283;717;65;34;4;30;.882;3600000;0
37136;182339;715;100;37;0;37;1.000;3600000;0
37136;181446;2188;46;33;6;27;.818;3266000;0
37136;-1;2188;49;1;0;1;1.000;334000;0
37136;160650;715;0;0;0;0;.00nan;0;0
37137;28394;719;47;5;1;4;.800;356000;0
37137;185775;720;81;22;1;21;.955;3600000;0
37137;-1;720;0;0;0;0;.00nan;0;0
37137;66721;719;30;34;7;27;.794;3244000;0
37138;183905;721;44;31;6;25;.806;3600000;0
37138;179151;718;92;32;1;31;.969;3600000;0
37138;-1;718;0;0;0;0;.00nan;0;0
37138;77009;721;0;0;0;0;.00nan;0;0
37139;168842;2529;53;36;5;31;.861;3611000;0
37139;175712;717;0;0;0;0;.00nan;0;0
37139;-1;2529;0;0;0;0;.00nan;0;0
37139;86283;717;63;38;4;34;.895;3611000;0
37140;182339;715;56;43;5;38;.884;3600000;0
37140;179151;718;16;22;6;16;.727;2777000;0
37140;-1;718;59;6;0;6;1.000;813000;0
37140;160650;715;0;0;0;0;.00nan;0;0
37141;183905;721;78;25;1;24;.960;3600000;0
37141;28394;719;63;36;4;32;.889;3600000;0
37141;66721;719;0;0;0;0;.00nan;0;0
37141;77009;721;0;0;0;0;.00nan;0;0
37142;184437;716;100;53;2;51;.962;3900000;0
37142;185775;720;66;23;2;21;.913;3900000;0
37142;-1;720;0;0;0;0;.00nan;0;0
37142;55918;716;0;0;0;0;.00nan;0;0
37143;168842;2529;47;26;4;22;.846;3529000;0
37143;185775;720;90;37;2;35;.946;3600000;0
37143;-1;2529;0;0;0;0;.00nan;0;0
37143;-1;720;0;0;0;0;.00nan;0;0
37144;179151;718;69;32;3;29;.906;3600000;0
37144;181446;2188;57;41;5;36;.878;3514000;0
37144;-1;2188;0;0;0;0;.00nan;0;0
37144;-1;718;0;0;0;0;.00nan;0;0
37145;182339;715;85;43;3;40;.930;3900000;0
37145;28394;719;0;0;0;0;.00nan;0;0
37145;66721;719;53;27;3;24;.889;3900000;0
37145;160650;715;0;0;0;0;.00nan;0;0
37146;183905;721;84;26;1;25;.962;3900000;0
37146;184437;716;97;36;1;35;.972;3900000;0
37146;55918;716;0;0;0;0;.00nan;0;0
37146;77009;721;0;0;0;0;.00nan;0;0
37147;28394;719;0;0;0;0;.00nan;0;0
37147;181446;2188;63;31;3;28;.903;3515000;0
37147;-1;2188;0;0;0;0;.00nan;0;0
37147;66721;719;76;23;1;22;.957;3600000;0
37148;182339;715;0;0;0;0;.00nan;0;0
37148;184437;716;83;38;3;35;.921;3556000;0
37148;55918;716;0;0;0;0;.00nan;0;0
37148;160650;715;68;20;1;19;.950;3600000;0
37149;175712;717;0;0;0;0;.00nan;0;0
37149;185775;720;99;23;0;23;1.000;3600000;0
37149;-1;720;0;0;0;0;.00nan;0;0
37149;86283;717;50;34;4;30;.882;3600000;0
37150;163784;721;0;0;0;0;.00nan;0;0
37150;183905;721;84;19;0;19;1.000;3600000;0
37150;168842;2529;82;35;2;33;.943;3580000;0
37150;-1;2529;0;0;0;0;.00nan;0;0
37151;163784;721;0;0;0;0;.00nan;0;0
37151;183905;721;90;48;4;44;.917;3600000;0
37151;175712;717;0;0;0;0;.00nan;0;0
37151;86283;717;53;22;3;19;.864;3600000;0
37152;182339;715;74;22;2;20;.909;3600000;0
37152;168842;2529;51;25;3;22;.880;3600000;0
37152;-1;2529;0;0;0;0;.00nan;0;0
37152;160650;715;0;0;0;0;.00nan;0;0
37153;179151;718;51;37;4;33;.892;3600000;0
37153;28394;719;72;20;1;19;.950;3600000;0
37153;-1;718;0;0;0;0;.00nan;0;0
37153;66721;719;0;0;0;0;.00nan;0;0
37154;184437;716;66;25;3;22;.880;3579000;0
37154;181446;2188;83;39;2;37;.949;3600000;0
37154;-1;2188;0;0;0;0;.00nan;0;0
37154;55918;716;0;0;0;0;.00nan;0;0
37155;168842;2529;58;36;4;32;.889;3571000;0
37155;181446;2188;0;0;0;0;.00nan;0;0
37155;-1;2529;0;0;0;0;.00nan;0;0
37155;-1;2188;91;40;3;37;.925;3600000;0
37156;182339;715;93;55;1;54;.982;3624000;0
37156;175712;717;0;0;0;0;.00nan;0;0
37156;86283;717;84;12;0;12;1.000;3624000;0
37156;160650;715;0;0;0;0;.00nan;0;0
37157;184437;716;73;33;3;30;.909;3587000;0
37157;179151;718;70;25;2;23;.920;3600000;0
37157;-1;718;0;0;0;0;.00nan;0;0
37157;55918;716;0;0;0;0;.00nan;0;0
37158;163784;721;0;0;0;0;.00nan;0;0
37158;183905;721;42;22;4;18;.818;3842000;0
37158;185775;720;64;31;3;28;.903;3842000;0
37158;-1;720;0;0;0;0;.00nan;0;0
37159;175712;717;0;0;0;0;.00nan;0;0
37159;181446;2188;93;41;2;39;.951;3900000;0
37159;-1;2188;0;0;0;0;.00nan;0;0
37159;86283;717;73;27;2;25;.926;3900000;0
37160;168842;2529;76;31;2;29;.935;3600000;0
37160;179151;718;49;22;3;19;.864;3547000;0
37160;-1;2529;0;0;0;0;.00nan;0;0
37160;-1;718;0;0;0;0;.00nan;0;0
37161;182339;715;60;54;7;47;.870;3237000;0
37161;185775;720;0;0;0;0;.00nan;0;0
37161;-1;720;58;17;2;15;.882;3600000;0
37161;160650;715;44;4;1;3;.750;363000;0
37162;184437;716;86;38;3;35;.921;3588000;0
37162;28394;719;71;25;2;23;.920;3600000;0
37162;55918;716;0;0;0;0;.00nan;0;0
37162;66721;719;0;0;0;0;.00nan;0;0
37163;181446;2188;33;27;6;21;.778;1976000;0
37163;185775;720;48;22;3;19;.864;3600000;0
37163;-1;720;0;0;0;0;.00nan;0;0
37163;-1;2188;34;14;4;10;.714;1624000;0
37164;182339;715;73;30;2;28;.933;3600000;0
37164;163784;721;0;0;0;0;.00nan;0;0
37164;183905;721;44;39;6;33;.846;3600000;0
37164;160650;715;0;0;0;0;.00nan;0;0
37165;179151;718;0;0;0;0;.00nan;0;0
37165;175712;717;0;0;0;0;.00nan;0;0
37165;-1;718;79;36;2;34;.944;3719000;0
37165;86283;717;54;21;3;18;.857;3719000;0
37166;168842;2529;49;33;5;28;.848;3566000;0
37166;28394;719;62;26;3;23;.885;3600000;0
37166;-1;2529;0;0;0;0;.00nan;0;0
37166;66721;719;0;0;0;0;.00nan;0;0
37167;28394;719;0;0;0;0;.00nan;0;0
37167;175712;717;0;0;0;0;.00nan;0;0
37167;66721;719;69;42;4;38;.905;3600000;0
37167;86283;717;89;27;1;26;.963;3600000;0
37168;168842;2529;78;34;2;32;.941;3600000;0
37168;184437;716;23;12;4;8;.667;1130000;0
37168;-1;2529;0;0;0;0;.00nan;0;0
37168;55918;716;56;23;2;21;.913;2470000;0
37169;179151;718;66;15;1;14;.933;3600000;0
37169;185775;720;50;37;5;32;.865;3600000;0
37169;-1;720;0;0;0;0;.00nan;0;0
37169;-1;718;0;0;0;0;.00nan;0;0
37170;163784;721;44;22;4;18;.818;3529000;0
37170;183905;721;0;0;0;0;.00nan;0;0
37170;181446;2188;76;28;2;26;.929;3600000;0
37170;-1;2188;0;0;0;0;.00nan;0;0
37171;182339;715;56;29;3;26;.897;3598000;0
37171;181446;2188;94;34;2;32;.941;3600000;0
37171;-1;2188;0;0;0;0;.00nan;0;0
37171;160650;715;0;0;0;0;.00nan;0;0
37172;163784;721;0;0;0;0;.00nan;0;0
37172;183905;721;83;31;1;30;.968;3600000;0
37172;179151;718;49;27;4;23;.852;3600000;0
37172;-1;718;0;0;0;0;.00nan;0;0
37173;28394;719;0;0;0;0;.00nan;0;0
37173;185775;720;95;36;2;34;.944;3600000;0
37173;-1;720;0;0;0;0;.00nan;0;0
37173;66721;719;72;34;3;31;.912;3572000;0
37174;184437;716;97;46;3;43;.935;3900000;0
37174;175712;717;0;0;0;0;.00nan;0;0
37174;55918;716;0;0;0;0;.00nan;0;0
37174;86283;717;62;22;3;19;.864;3900000;0
37175;168842;2529;37;45;7;38;.844;3600000;0
37175;175712;717;0;0;0;0;.00nan;0;0
37175;-1;2529;0;0;0;0;.00nan;0;0
37175;86283;717;83;25;1;24;.960;3600000;0
37176;182339;715;74;31;2;29;.935;3900000;0
37176;179151;718;74;26;2;24;.923;3900000;0
37176;-1;718;0;0;0;0;.00nan;0;0
37176;160650;715;0;0;0;0;.00nan;0;0
37177;163784;721;0;0;0;0;.00nan;0;0
37177;183905;721;57;26;3;23;.885;3544000;0
37177;28394;719;0;0;0;0;.00nan;0;0
37177;66721;719;66;24;2;22;.917;3600000;0
37178;184437;716;86;40;3;37;.925;3591000;0
37178;185775;720;75;20;1;19;.950;3600000;0
37178;-1;720;0;0;0;0;.00nan;0;0
37178;55918;716;0;0;0;0;.00nan;0;0
37179;179151;718;40;33;6;27;.818;3536000;0
37179;181446;2188;72;30;3;27;.900;3600000;0
37179;-1;2188;0;0;0;0;.00nan;0;0
37179;-1;718;0;0;0;0;.00nan;0;0
37180;182339;715;70;27;3;24;.889;3600000;0
37180;28394;719;35;28;5;23;.821;3516000;0
37180;66721;719;0;0;0;0;.00nan;0;0
37180;160650;715;0;0;0;0;.00nan;0;0
37181;168842;2529;83;44;3;41;.932;3600000;0
37181;185775;720;72;17;1;16;.941;3600000;0
37181;-1;2529;0;0;0;0;.00nan;0;0
37181;-1;720;0;0;0;0;.00nan;0;0
37182;163784;721;72;26;2;24;.923;3600000;0
37182;183905;721;0;0;0;0;.00nan;0;0
37182;184437;716;20;10;4;6;.600;787000;0
37182;55918;716;57;27;3;24;.889;2813000;0
37183;175712;717;0;0;0;0;.00nan;0;0
37183;185775;720;45;25;4;21;.840;3562000;0
37183;-1;720;0;0;0;0;.00nan;0;0
37183;86283;717;78;30;2;28;.933;3600000;0
37184;163784;721;0;0;0;0;.00nan;0;0
37184;183905;721;59;25;3;22;.880;3564000;0
37184;168842;2529;86;33;2;31;.939;3600000;0
37184;-1;2529;0;0;0;0;.00nan;0;0
37185;28394;719;58;17;2;15;.882;2664000;0
37185;181446;2188;80;28;1;27;.964;3600000;0
37185;-1;2188;0;0;0;0;.00nan;0;0
37185;66721;719;43;24;4;20;.833;936000;0
37186;182339;715;32;8;3;5;.625;543000;0
37186;184437;716;0;0;0;0;.00nan;0;0
37186;55918;716;51;25;4;21;.840;3882000;0
37186;160650;715;67;19;1;18;.947;3357000;0
37187;184437;716;100;45;0;45;1.000;3600000;0
37187;181446;2188;67;29;2;27;.931;3551000;0
37187;-1;2188;0;0;0;0;.00nan;0;0
37187;55918;716;0;0;0;0;.00nan;0;0
37188;182339;715;80;47;4;43;.915;3600000;0
37188;168842;2529;82;28;1;27;.964;3600000;0
37188;-1;2529;0;0;0;0;.00nan;0;0
37188;160650;715;0;0;0;0;.00nan;0;0
37189;179151;718;54;29;4;25;.862;3708000;0
37189;28394;719;0;0;0;0;.00nan;0;0
37189;-1;718;0;0;0;0;.00nan;0;0
37189;66721;719;70;33;3;30;.909;3708000;0
37190;163784;721;0;0;0;0;.00nan;0;0
37190;183905;721;86;33;2;31;.939;3600000;0
37190;175712;717;0;0;0;0;.00nan;0;0
37190;86283;717;42;33;5;28;.848;3600000;0
37191;182339;715;85;43;3;40;.930;3583000;0
37191;175712;717;0;0;0;0;.00nan;0;0
37191;86283;717;59;12;1;11;.917;3600000;0
37191;160650;715;0;0;0;0;.00nan;0;0
37192;168842;2529;59;19;2;17;.895;3600000;0
37192;181446;2188;23;12;4;8;.667;1020000;0
37192;-1;2529;0;0;0;0;.00nan;0;0
37192;-1;2188;66;29;2;27;.931;2580000;0
37193;163784;721;88;37;2;35;.946;3600000;0
37193;183905;721;0;0;0;0;.00nan;0;0
37193;185775;720;39;18;3;15;.833;3542000;0
37193;-1;720;0;0;0;0;.00nan;0;0
37194;184437;716;95;41;3;38;.927;3900000;0
37194;179151;718;56;28;3;25;.893;3900000;0
37194;-1;718;0;0;0;0;.00nan;0;0
37194;55918;716;0;0;0;0;.00nan;0;0
37195;175712;717;0;0;0;0;.00nan;0;0
37195;181446;2188;0;0;0;0;.00nan;0;0
37195;-1;2188;47;45;6;39;.867;3600000;0
37195;86283;717;71;21;1;20;.952;3600000;0
37196;182339;715;88;39;2;37;.949;3543000;0
37196;185775;720;78;24;1;23;.958;3600000;0
37196;-1;720;0;0;0;0;.00nan;0;0
37196;160650;715;0;0;0;0;.00nan;0;0
37197;168842;2529;66;36;4;32;.889;3600000;0
37197;179151;718;70;20;1;19;.950;3600000;0
37197;-1;2529;0;0;0;0;.00nan;0;0
37197;-1;718;0;0;0;0;.00nan;0;0
37198;184437;716;51;25;4;21;.840;3600000;0
37198;28394;719;0;0;0;0;.00nan;0;0
37198;55918;716;0;0;0;0;.00nan;0;0
37198;66721;719;54;26;3;23;.885;3600000;0
37199;179151;718;100;37;2;35;.946;3600000;0
37199;175712;717;56;27;3;24;.889;3599000;0
37199;-1;718;0;0;0;0;.00nan;0;0
37199;86283;717;0;0;0;0;.00nan;0;0
37200;168842;2529;97;49;4;45;.918;3600000;0
37200;28394;719;0;0;0;0;.00nan;0;0
37200;-1;2529;0;0;0;0;.00nan;0;0
37200;66721;719;66;27;3;24;.889;3600000;0
37201;181446;2188;41;34;6;28;.824;3600000;0
37201;185775;720;0;0;0;0;.00nan;0;0
37201;-1;720;56;23;2;21;.913;3600000;0
37201;-1;2188;0;0;0;0;.00nan;0;0
37202;182339;715;100;41;1;40;.976;3600000;0
37202;163784;721;0;0;0;0;.00nan;0;0
37202;183905;721;65;19;2;17;.895;3555000;0
37202;160650;715;0;0;0;0;.00nan;0;0
37203;163784;721;0;0;0;0;.00nan;0;0
37203;183905;721;68;25;2;23;.920;3731000;0
37203;181446;2188;54;30;3;27;.900;3731000;0
37203;-1;2188;0;0;0;0;.00nan;0;0
37204;179151;718;68;32;3;29;.906;3878000;0
37204;185775;720;80;34;2;32;.941;3878000;0
37204;-1;720;0;0;0;0;.00nan;0;0
37204;-1;718;0;0;0;0;.00nan;0;0
37205;28394;719;85;39;2;37;.949;3600000;0
37205;175712;717;0;0;0;0;.00nan;0;0
37205;66721;719;0;0;0;0;.00nan;0;0
37205;86283;717;70;21;1;20;.952;3600000;0
37206;168842;2529;76;32;2;30;.938;3600000;0
37206;184437;716;66;29;3;26;.897;3574000;0
37206;-1;2529;0;0;0;0;.00nan;0;0
37206;55918;716;0;0;0;0;.00nan;0;0
37207;184437;716;70;48;6;42;.875;3600000;0
37207;175712;717;0;0;0;0;.00nan;0;0
37207;55918;716;0;0;0;0;.00nan;0;0
37207;86283;717;100;29;0;29;1.000;3600000;0
37208;182339;715;0;0;0;0;.00nan;0;0
37208;181446;2188;44;30;5;25;.833;3515000;0
37208;-1;2188;0;0;0;0;.00nan;0;0
37208;160650;715;66;36;3;33;.917;3600000;0
37209;28394;719;0;0;0;0;.00nan;0;0
37209;185775;720;50;15;2;13;.867;3600000;0
37209;-1;720;0;0;0;0;.00nan;0;0
37209;66721;719;50;35;4;31;.886;3557000;0
37210;163784;721;0;0;0;0;.00nan;0;0
37210;183905;721;67;31;3;28;.903;3600000;0
37210;179151;718;76;23;1;22;.957;3600000;0
37210;-1;718;0;0;0;0;.00nan;0;0
37211;168842;2529;100;58;3;55;.948;3600000;0
37211;175712;717;0;0;0;0;.00nan;0;0
37211;-1;2529;0;0;0;0;.00nan;0;0
37211;86283;717;33;14;4;10;.714;3546000;0
37212;182339;715;96;47;3;44;.936;3600000;0
37212;179151;718;0;0;0;0;.00nan;0;0
37212;-1;718;38;19;4;15;.789;3547000;0
37212;160650;715;0;0;0;0;.00nan;0;0
37213;163784;721;0;0;0;0;.00nan;0;0
37213;183905;721;63;34;4;30;.882;3600000;0
37213;28394;719;31;24;5;19;.792;3557000;0
37213;66721;719;0;0;0;0;.00nan;0;0
37214;184437;716;75;48;5;43;.896;3600000;0
37214;185775;720;69;21;1;20;.952;3600000;0
37214;-1;720;0;0;0;0;.00nan;0;0
37214;55918;716;0;0;0;0;.00nan;0;0
37215;168842;2529;57;43;6;37;.860;3600000;0
37215;185775;720;64;26;2;24;.923;3600000;0
37215;-1;2529;0;0;0;0;.00nan;0;0
37215;-1;720;0;0;0;0;.00nan;0;0
37216;179151;718;100;24;0;24;1.000;3600000;0
37216;181446;2188;58;30;4;26;.867;3600000;0
37216;-1;2188;0;0;0;0;.00nan;0;0
37216;-1;718;0;0;0;0;.00nan;0;0
37217;182339;715;79;35;3;32;.914;3671000;0
37217;28394;719;0;0;0;0;.00nan;0;0
37217;66721;719;82;30;2;28;.933;3671000;0
37217;160650;715;0;0;0;0;.00nan;0;0
37218;163784;721;0;0;0;0;.00nan;0;0
37218;183905;721;90;19;0;19;1.000;3600000;0
37218;184437;716;63;34;4;30;.882;2278000;0
37218;55918;716;54;11;1;10;.909;1322000;0
37219;28394;719;0;0;0;0;.00nan;0;0
37219;181446;2188;34;31;6;25;.806;3543000;0
37219;-1;2188;0;0;0;0;.00nan;0;0
37219;66721;719;60;33;5;28;.848;3600000;0
37220;182339;715;87;23;0;23;1.000;3600000;0
37220;184437;716;22;14;5;9;.643;1078000;0
37220;55918;716;89;24;0;24;1.000;2522000;0
37220;160650;715;0;0;0;0;.00nan;0;0
37221;175712;717;0;0;0;0;.00nan;0;0
37221;185775;720;65;24;3;21;.875;3560000;0
37221;-1;720;0;0;0;0;.00nan;0;0
37221;86283;717;98;32;1;31;.969;3600000;0
37222;163784;721;0;0;0;0;.00nan;0;0
37222;183905;721;73;28;2;26;.929;3600000;0
37222;168842;2529;55;27;3;24;.889;3583000;0
37222;-1;2529;0;0;0;0;.00nan;0;0
37223;163784;721;0;0;0;0;.00nan;0;0
37223;183905;721;97;48;3;45;.938;3900000;0
37223;175712;717;0;0;0;0;.00nan;0;0
37223;86283;717;76;29;3;26;.897;3900000;0
37224;182339;715;62;43;6;37;.860;3600000;0
37224;168842;2529;0;0;0;0;.00nan;0;0
37224;-1;2529;96;34;1;33;.971;3600000;0
37224;160650;715;0;0;0;0;.00nan;0;0
37225;179151;718;79;25;1;24;.960;3600000;0
37225;28394;719;58;30;4;26;.867;3600000;0
37225;-1;718;0;0;0;0;.00nan;0;0
37225;66721;719;0;0;0;0;.00nan;0;0
37226;184437;716;0;0;0;0;.00nan;0;0
37226;181446;2188;17;7;4;3;.429;976000;0
37226;-1;2188;72;15;0;15;1.000;2624000;0
37226;55918;716;57;38;5;33;.868;3573000;0
37227;168842;2529;68;35;3;32;.914;3600000;0
37227;181446;2188;64;25;2;23;.920;3600000;0
37227;-1;2529;0;0;0;0;.00nan;0;0
37227;-1;2188;0;0;0;0;.00nan;0;0
37228;182339;715;74;33;3;30;.909;3546000;0
37228;175712;717;0;0;0;0;.00nan;0;0
37228;86283;717;68;20;2;18;.900;3600000;0
37228;160650;715;0;0;0;0;.00nan;0;0
37229;184437;716;64;40;4;36;.900;3600000;0
37229;179151;718;77;26;1;25;.962;3600000;0
37229;-1;718;0;0;0;0;.00nan;0;0
37229;55918;716;0;0;0;0;.00nan;0;0
37230;163784;721;0;0;0;0;.00nan;0;0
37230;183905;721;100;33;0;33;1.000;3600000;0
37230;185775;720;68;37;4;33;.892;3600000;0
37230;-1;720;0;0;0;0;.00nan;0;0
37231;175712;717;0;0;0;0;.00nan;0;0
37231;181446;2188;36;36;7;29;.806;3600000;0
37231;-1;2188;0;0;0;0;.00nan;0;0
37231;86283;717;73;22;1;21;.955;3600000;0
37232;168842;2529;100;29;0;29;1.000;3600000;0
37232;179151;718;59;36;4;32;.889;3600000;0
37232;-1;2529;0;0;0;0;.00nan;0;0
37232;-1;718;0;0;0;0;.00nan;0;0
37233;182339;715;87;54;4;50;.926;3600000;0
37233;185775;720;60;17;1;16;.941;3600000;0
37233;-1;720;0;0;0;0;.00nan;0;0
37233;160650;715;0;0;0;0;.00nan;0;0
37234;184437;716;39;23;5;18;.783;3844000;0
37234;28394;719;94;36;1;35;.972;3408000;0
37234;55918;716;0;0;0;0;.00nan;0;0
37234;66721;719;23;3;3;0;.000;431000;0
37235;181446;2188;74;31;2;29;.935;3562000;0
37235;185775;720;90;28;1;27;.964;3600000;0
37235;-1;720;0;0;0;0;.00nan;0;0
37235;-1;2188;0;0;0;0;.00nan;0;0
37236;182339;715;97;23;0;23;1.000;3600000;0
37236;163784;721;0;0;0;0;.00nan;0;0
37236;183905;721;39;39;7;32;.821;3600000;0
37236;160650;715;0;0;0;0;.00nan;0;0
37237;179151;718;17;40;8;32;.800;3077000;0
37237;175712;717;0;0;0;0;.00nan;0;0
37237;-1;718;54;4;0;4;1.000;523000;0
37237;86283;717;55;17;2;15;.882;3600000;0
37238;168842;2529;76;27;1;26;.963;3600000;0
37238;28394;719;0;0;0;0;.00nan;0;0
37238;-1;2529;0;0;0;0;.00nan;0;0
37238;66721;719;63;29;3;26;.897;3590000;0
37239;28394;719;48;32;5;27;.844;3600000;0
37239;175712;717;0;0;0;0;.00nan;0;0
37239;66721;719;0;0;0;0;.00nan;0;0
37239;86283;717;86;32;2;30;.938;3600000;0
37240;168842;2529;56;28;3;25;.893;3900000;0
37240;184437;716;66;30;3;27;.900;3900000;0
37240;-1;2529;0;0;0;0;.00nan;0;0
37240;55918;716;0;0;0;0;.00nan;0;0
37241;179151;718;55;24;3;21;.875;3600000;0
37241;185775;720;80;28;2;26;.929;3600000;0
37241;-1;720;0;0;0;0;.00nan;0;0
37241;-1;718;0;0;0;0;.00nan;0;0
37242;163784;721;0;0;0;0;.00nan;0;0
37242;183905;721;85;24;1;23;.958;3600000;0
37242;181446;2188;55;25;4;21;.840;3600000;0
37242;-1;2188;0;0;0;0;.00nan;0;0
37243;182339;715;100;49;2;47;.959;3600000;0
37243;181446;2188;0;0;0;0;.00nan;0;0
37243;-1;2188;38;18;4;14;.778;3563000;0
37243;160650;715;0;0;0;0;.00nan;0;0
37244;163784;721;0;0;0;0;.00nan;0;0
37244;183905;721;44;32;5;27;.844;3600000;0
37244;179151;718;100;29;0;29;1.000;3600000;0
37244;-1;718;0;0;0;0;.00nan;0;0
37245;28394;719;0;0;0;0;.00nan;0;0
37245;185775;720;77;35;3;32;.914;3600000;0
37245;-1;720;0;0;0;0;.00nan;0;0
37245;66721;719;53;28;4;24;.857;3554000;0
37246;184437;716;85;49;5;44;.898;3600000;0
37246;175712;717;0;0;0;0;.00nan;0;0
37246;55918;716;0;0;0;0;.00nan;0;0
37246;86283;717;84;14;0;14;1.000;3600000;0
37247;168842;2529;80;43;4;39;.907;3600000;0
37247;175712;717;0;0;0;0;.00nan;0;0
37247;-1;2529;0;0;0;0;.00nan;0;0
37247;86283;717;61;21;2;19;.905;3600000;0
37248;182339;715;0;0;0;0;.00nan;0;0
37248;179151;718;79;24;1;23;.958;3600000;0
37248;-1;718;0;0;0;0;.00nan;0;0
37248;160650;715;70;39;4;35;.897;3600000;0
37249;184437;716;87;40;3;37;.925;3514000;0
37249;185775;720;64;16;1;15;.938;3600000;0
37249;-1;720;0;0;0;0;.00nan;0;0
37249;55918;716;0;0;0;0;.00nan;0;0
37250;163784;721;0;0;0;0;.00nan;0;0
37250;183905;721;85;37;2;35;.946;3544000;0
37250;28394;719;100;41;1;40;.976;3600000;0
37250;66721;719;0;0;0;0;.00nan;0;0
37252;184437;716;89;28;1;27;.964;3732000;0
37252;-1;721;65;28;2;26;.929;3732000;0
37252;55918;716;0;0;0;0;.00nan;0;0
37252;77009;721;0;0;0;0;.00nan;0;0
37254;168842;2529;98;44;2;42;.955;3900000;0
37254;181446;2188;90;35;2;33;.943;3900000;0
37254;-1;2529;0;0;0;0;.00nan;0;0
37254;-1;2188;0;0;0;0;.00nan;0;0
37258;179151;718;65;39;4;35;.897;3600000;0
37258;28394;719;59;24;3;21;.875;3600000;0
37258;-1;718;0;0;0;0;.00nan;0;0
37258;66721;719;0;0;0;0;.00nan;0;0
37260;168842;2529;69;39;4;35;.897;3900000;0
37260;179151;718;55;30;4;26;.867;3891000;0
37260;-1;2529;0;0;0;0;.00nan;0;0
37260;-1;718;0;0;0;0;.00nan;0;0
37262;28394;719;0;0;0;0;.00nan;0;0
37262;-1;721;0;0;0;0;.00nan;0;0
37262;66721;719;79;36;3;33;.917;3600000;0
37262;77009;721;54;41;5;36;.878;3590000;0
37266;182339;715;0;0;0;0;.00nan;0;0
37266;181446;2188;55;18;2;16;.889;3600000;0
37266;-1;2188;0;0;0;0;.00nan;0;0
37266;160650;715;47;36;5;31;.861;3600000;0
37268;168842;2529;0;0;0;0;.00nan;0;0
37268;179151;718;79;32;2;30;.938;3600000;0
37268;-1;2529;61;26;3;23;.885;3572000;0
37268;-1;718;0;0;0;0;.00nan;0;0
37270;28394;719;46;19;3;16;.842;3586000;0
37270;-1;721;100;41;1;40;.976;3600000;0
37270;66721;719;0;0;0;0;.00nan;0;0
37270;77009;721;0;0;0;0;.00nan;0;0
37272;182339;715;59;29;3;26;.897;3600000;0
37272;184437;716;33;22;5;17;.773;3553000;0
37272;55918;716;0;0;0;0;.00nan;0;0
37272;160650;715;0;0;0;0;.00nan;0;0
37276;168842;2529;41;26;4;22;.846;3600000;0
37276;179151;718;74;19;1;18;.947;3600000;0
37276;-1;2529;0;0;0;0;.00nan;0;0
37276;-1;718;0;0;0;0;.00nan;0;0
37278;181446;2188;54;22;2;20;.909;3600000;0
37278;-1;721;78;39;3;36;.923;3576000;0
37278;-1;2188;0;0;0;0;.00nan;0;0
37278;77009;721;0;0;0;0;.00nan;0;0
37280;883;717;0;0;0;0;.00nan;0;0
37280;28394;719;0;0;0;0;.00nan;0;0
37280;175712;717;58;21;2;19;.905;3600000;0
37280;66721;719;61;34;3;31;.912;3600000;0
37284;185775;720;54;11;1;10;.909;3600000;0
37284;-1;721;0;0;0;0;.00nan;0;0
37284;-1;720;0;0;0;0;.00nan;0;0
37284;77009;721;49;32;5;27;.844;3600000;0
37286;883;717;61;15;1;14;.933;3600000;0
37286;182339;715;63;44;5;39;.886;3600000;0
37286;175712;717;0;0;0;0;.00nan;0;0
37286;160650;715;0;0;0;0;.00nan;0;0
37288;28394;719;94;29;1;28;.966;3600000;0
37288;181446;2188;0;0;0;0;.00nan;0;0
37288;-1;2188;28;44;8;36;.818;3600000;0
37288;66721;719;0;0;0;0;.00nan;0;0
37290;184437;716;47;19;3;16;.842;3600000;0
37290;179151;718;0;0;0;0;.00nan;0;0
37290;-1;718;39;35;5;30;.857;3534000;0
37290;55918;716;0;0;0;0;.00nan;0;0
552;28394;719;0;0;0;0;.00nan;0;0
552;185775;720;66;32;3;29;.906;3576000;0
552;-1;720;0;0;0;0;.00nan;0;0
552;66721;719;71;19;1;18;.947;3600000;0
553;182339;715;75;30;2;28;.933;3794000;0
553;179151;718;67;27;3;24;.889;3794000;0
553;-1;718;0;0;0;0;.00nan;0;0
553;160650;715;0;0;0;0;.00nan;0;0
554;28394;719;34;29;6;23;.793;2308000;0
554;175712;717;0;0;0;0;.00nan;0;0
554;66721;719;73;12;0;12;1.000;1244000;0
554;86283;717;46;27;4;23;.852;3600000;0
555;179151;718;100;34;1;33;.971;3600000;0
555;185775;720;79;39;3;36;.923;3598000;0
555;-1;720;0;0;0;0;.00nan;0;0
555;-1;718;0;0;0;0;.00nan;0;0
556;182339;715;87;46;3;43;.935;3541000;0
556;175712;717;0;0;0;0;.00nan;0;0
556;86283;717;86;26;2;24;.923;3600000;0
556;160650;715;0;0;0;0;.00nan;0;0
557;179151;718;89;27;1;26;.963;3600000;0
557;28394;719;0;0;0;0;.00nan;0;0
557;-1;718;0;0;0;0;.00nan;0;0
557;66721;719;87;34;2;32;.941;3548000;0
558;179151;718;81;31;3;28;.903;3600000;0
558;175712;717;51;18;2;16;.889;3237000;0
558;-1;718;0;0;0;0;.00nan;0;0
558;86283;717;32;9;3;6;.667;278000;0
559;182339;715;70;43;4;39;.907;3543000;0
559;185775;720;71;36;3;33;.917;3600000;0
559;-1;720;0;0;0;0;.00nan;0;0
559;160650;715;0;0;0;0;.00nan;0;0
560;175712;717;0;0;0;0;.00nan;0;0
560;185775;720;0;0;0;0;.00nan;0;0
560;-1;720;58;37;4;33;.892;3553000;0
560;86283;717;54;21;3;18;.857;3600000;0
561;182339;715;41;34;5;29;.853;3529000;0
561;28394;719;67;30;3;27;.900;3600000;0
561;66721;719;0;0;0;0;.00nan;0;0
561;160650;715;0;0;0;0;.00nan;0;0
562;28394;719;0;0;0;0;.00nan;0;0
562;185775;720;91;19;0;19;1.000;3600000;0
562;-1;720;0;0;0;0;.00nan;0;0
562;66721;719;55;27;4;23;.852;3600000;0
563;182339;715;99;43;1;42;.977;3600000;0
563;179151;718;50;17;2;15;.882;3546000;0
563;-1;718;0;0;0;0;.00nan;0;0
563;160650;715;0;0;0;0;.00nan;0;0
564;28394;719;0;0;0;0;.00nan;0;0
564;175712;717;0;0;0;0;.00nan;0;0
564;66721;719;67;40;5;35;.875;3600000;0
564;86283;717;42;21;4;17;.810;3600000;0
565;179151;718;46;32;5;27;.844;3600000;0
565;185775;720;50;29;4;25;.862;3600000;0
565;-1;720;0;0;0;0;.00nan;0;0
565;-1;718;0;0;0;0;.00nan;0;0
566;182339;715;49;46;6;40;.870;3600000;0
566;175712;717;71;22;2;20;.909;3600000;0
566;86283;717;0;0;0;0;.00nan;0;0
566;160650;715;0;0;0;0;.00nan;0;0
567;179151;718;93;37;2;35;.946;3600000;0
567;28394;719;39;20;4;16;.800;3525000;0
567;-1;718;0;0;0;0;.00nan;0;0
567;66721;719;0;0;0;0;.00nan;0;0
568;179151;718;43;38;6;32;.842;3262000;0
568;175712;717;0;0;0;0;.00nan;0;0
568;-1;718;66;11;0;11;1.000;338000;0
568;86283;717;43;15;3;12;.800;3600000;0
569;182339;715;55;37;5;32;.865;3600000;0
569;185775;720;76;22;1;21;.955;3600000;0
569;-1;720;0;0;0;0;.00nan;0;0
569;160650;715;0;0;0;0;.00nan;0;0
570;175712;717;0;0;0;0;.00nan;0;0
570;185775;720;82;35;2;33;.943;3578000;0
570;-1;720;0;0;0;0;.00nan;0;0
570;86283;717;63;15;1;14;.933;3600000;0
571;182339;715;81;35;3;32;.914;3600000;0
571;28394;719;0;0;0;0;.00nan;0;0
571;66721;719;45;24;4;20;.833;3552000;0
571;160650;715;0;0;0;0;.00nan;0;0
572;163784;721;0;0;0;0;.00nan;0;0
572;183905;721;42;28;5;23;.821;3600000;0
572;184437;716;73;24;2;22;.917;3600000;0
572;55918;716;0;0;0;0;.00nan;0;0
573;168842;2529;99;24;0;24;1.000;3600000;0
573;181446;2188;75;35;3;32;.914;3600000;0
573;-1;2529;0;0;0;0;.00nan;0;0
573;-1;2188;0;0;0;0;.00nan;0;0
574;163784;721;24;14;4;10;.714;732000;0
574;183905;721;89;28;1;27;.964;2868000;0
574;181446;2188;64;22;2;20;.909;3600000;0
574;-1;2188;0;0;0;0;.00nan;0;0
575;168842;2529;54;34;5;29;.853;3596000;0
575;184437;716;59;34;4;30;.882;3626000;0
575;-1;2529;0;0;0;0;.00nan;0;0
575;55918;716;0;0;0;0;.00nan;0;0
576;163784;721;0;0;0;0;.00nan;0;0
576;183905;721;58;29;4;25;.862;3635000;0
576;168842;2529;78;34;3;31;.912;3641000;0
576;-1;2529;0;0;0;0;.00nan;0;0
577;184437;716;0;0;0;0;.00nan;0;0
577;181446;2188;53;35;5;30;.857;3552000;0
577;-1;2188;0;0;0;0;.00nan;0;0
577;55918;716;37;22;4;18;.818;3600000;0
578;163784;721;0;0;0;0;.00nan;0;0
578;183905;721;47;35;5;30;.857;3513000;0
578;184437;716;66;31;3;28;.903;3600000;0
578;55918;716;0;0;0;0;.00nan;0;0
579;168842;2529;83;27;1;26;.963;3600000;0
579;181446;2188;27;22;5;17;.773;2336000;0
579;-1;2529;0;0;0;0;.00nan;0;0
579;-1;2188;51;9;1;8;.889;1264000;0
580;163784;721;0;0;0;0;.00nan;0;0
580;183905;721;64;20;2;18;.900;3600000;0
580;181446;2188;58;34;3;31;.912;3545000;0
580;-1;2188;0;0;0;0;.00nan;0;0
581;168842;2529;58;22;2;20;.909;3600000;0
581;184437;716;49;31;5;26;.839;3600000;0
581;-1;2529;0;0;0;0;.00nan;0;0
581;55918;716;0;0;0;0;.00nan;0;0
582;163784;721;0;0;0;0;.00nan;0;0
582;183905;721;96;37;1;36;.973;3632000;0
582;168842;2529;83;34;2;32;.941;3632000;0
582;-1;2529;0;0;0;0;.00nan;0;0
583;184437;716;91;40;3;37;.925;3900000;0
583;181446;2188;62;27;3;24;.889;3900000;0
583;-1;2188;0;0;0;0;.00nan;0;0
583;55918;716;0;0;0;0;.00nan;0;0
865;175712;717;0;0;0;0;.00nan;0;0
865;181446;2188;27;25;5;20;.800;3571000;0
865;-1;2188;0;0;0;0;.00nan;0;0
865;86283;717;46;28;4;24;.857;3600000;0
866;163784;721;37;21;4;17;.810;1200000;0
866;183905;721;49;34;5;29;.853;2400000;0
866;185775;720;58;14;1;13;.929;3600000;0
866;-1;720;0;0;0;0;.00nan;0;0
867;168842;2529;73;41;4;37;.902;3600000;0
867;179151;718;43;24;5;19;.792;3592000;0
867;-1;2529;0;0;0;0;.00nan;0;0
867;-1;718;0;0;0;0;.00nan;0;0
868;182339;715;39;23;4;19;.826;2188000;0
868;28394;719;0;0;0;0;.00nan;0;0
868;66721;719;80;30;2;28;.933;3600000;0
868;160650;715;61;16;1;15;.938;1412000;0
869;175712;717;0;0;0;0;.00nan;0;0
869;181446;2188;60;33;4;29;.879;3886000;0
869;-1;2188;0;0;0;0;.00nan;0;0
869;86283;717;51;23;3;20;.870;3886000;0
870;163784;721;0;0;0;0;.00nan;0;0
870;183905;721;77;32;2;30;.938;3600000;0
870;185775;720;62;29;3;26;.897;3554000;0
870;-1;720;0;0;0;0;.00nan;0;0
871;168842;2529;100;27;0;27;1.000;3600000;0
871;179151;718;39;30;5;25;.833;3600000;0
871;-1;2529;0;0;0;0;.00nan;0;0
871;-1;718;0;0;0;0;.00nan;0;0
872;182339;715;73;29;2;27;.931;3862000;0
872;28394;719;0;0;0;0;.00nan;0;0
872;66721;719;83;27;1;26;.963;3862000;0
872;160650;715;0;0;0;0;.00nan;0;0
873;175712;717;0;0;0;0;.00nan;0;0
873;181446;2188;50;37;6;31;.838;2650000;0
873;-1;2188;52;8;1;7;.875;1227000;0
873;86283;717;48;33;6;27;.818;3877000;0
874;163784;721;0;0;0;0;.00nan;0;0
874;183905;721;78;32;2;30;.938;3600000;0
874;185775;720;52;29;3;26;.897;3600000;0
874;-1;720;0;0;0;0;.00nan;0;0
875;168842;2529;81;39;3;36;.923;3585000;0
875;179151;718;74;23;1;22;.957;3600000;0
875;-1;2529;0;0;0;0;.00nan;0;0
875;-1;718;0;0;0;0;.00nan;0;0
876;182339;715;65;48;6;42;.875;3840000;0
876;28394;719;0;0;0;0;.00nan;0;0
876;66721;719;32;26;5;21;.808;3840000;0
876;160650;715;0;0;0;0;.00nan;0;0
877;175712;717;0;0;0;0;.00nan;0;0
877;181446;2188;60;33;4;29;.879;3562000;0
877;-1;2188;0;0;0;0;.00nan;0;0
877;86283;717;56;20;3;17;.850;3600000;0
878;163784;721;0;0;0;0;.00nan;0;0
878;183905;721;79;40;3;37;.925;3600000;0
878;185775;720;37;24;5;19;.792;3535000;0
878;-1;720;0;0;0;0;.00nan;0;0
879;168842;2529;80;22;1;21;.955;3600000;0
879;179151;718;82;43;3;40;.930;3600000;0
879;-1;2529;0;0;0;0;.00nan;0;0
879;-1;718;0;0;0;0;.00nan;0;0
880;182339;715;71;60;6;54;.900;3600000;0
880;28394;719;0;0;0;0;.00nan;0;0
880;66721;719;51;23;3;20;.870;3600000;0
880;160650;715;0;0;0;0;.00nan;0;0
1075;163784;721;0;0;0;0;.00nan;0;0
1075;183905;721;92;35;2;33;.943;3600000;0
1075;185775;720;51;24;3;21;.875;3565000;0
1075;-1;720;0;0;0;0;.00nan;0;0
1076;168842;2529;1;29;9;20;.690;3600000;0
1076;179151;718;81;24;1;23;.958;3600000;0
1076;-1;2529;0;0;0;0;.00nan;0;0
1076;-1;718;0;0;0;0;.00nan;0;0
1166;168842;2529;64;28;4;24;.857;3600000;0
1166;179151;718;59;31;5;26;.839;3557000;0
1166;-1;2529;0;0;0;0;.00nan;0;0
1166;-1;718;0;0;0;0;.00nan;0;0
1216;163784;721;0;0;0;0;.00nan;0;0
1216;183905;721;64;36;3;33;.917;3600000;0
1216;175712;717;34;5;2;3;.600;1583000;0
1216;86283;717;2;13;6;7;.538;2017000;0
1217;168842;2529;65;50;6;44;.880;3600000;0
1217;28394;719;0;0;0;0;.00nan;0;0
1217;-1;2529;0;0;0;0;.00nan;0;0
1217;66721;719;43;24;4;20;.833;3600000;0
1218;163784;721;0;0;0;0;.00nan;0;0
1218;183905;721;73;42;4;38;.905;3581000;0
1218;175712;717;0;0;0;0;.00nan;0;0
1218;86283;717;61;25;3;22;.880;3600000;0
1219;168842;2529;78;47;5;42;.894;3600000;0
1219;28394;719;0;0;0;0;.00nan;0;0
1219;-1;2529;0;0;0;0;.00nan;0;0
1219;66721;719;84;33;2;31;.939;3600000;0
1220;163784;721;0;0;0;0;.00nan;0;0
1220;183905;721;57;38;5;33;.868;3533000;0
1220;175712;717;0;0;0;0;.00nan;0;0
1220;86283;717;61;30;3;27;.900;3600000;0
1221;168842;2529;93;33;2;31;.939;3600000;0
1221;28394;719;0;0;0;0;.00nan;0;0
1221;-1;2529;0;0;0;0;.00nan;0;0
1221;66721;719;50;20;3;17;.850;3571000;0
1222;163784;721;64;11;0;11;1.000;857000;0
1222;183905;721;47;39;6;33;.846;2743000;0
1222;175712;717;0;0;0;0;.00nan;0;0
1222;86283;717;100;23;0;23;1.000;3600000;0
1223;168842;2529;93;49;2;47;.959;4000000;0
1223;28394;719;0;0;0;0;.00nan;0;0
1223;-1;2529;0;0;0;0;.00nan;0;0
1223;66721;719;60;16;1;15;.938;4000000;0
1562;163784;721;48;0;0;0;.00nan;245000;0
1562;183905;721;36;48;8;40;.833;3355000;0
1562;175712;717;0;0;0;0;.00nan;0;0
1562;86283;717;94;22;0;22;1.000;3600000;0
1563;168842;2529;77;45;5;40;.889;3579000;0
1563;28394;719;0;0;0;0;.00nan;0;0
1563;-1;2529;0;0;0;0;.00nan;0;0
1563;66721;719;57;27;3;24;.889;3600000;0
1573;28394;719;0;0;0;0;.00nan;0;0
1573;175712;717;0;0;0;0;.00nan;0;0
1573;66721;719;59;37;4;33;.892;3600000;0
1573;86283;717;76;20;1;19;.950;3600000;0
1574;28394;719;0;0;0;0;.00nan;0;0
1574;175712;717;0;0;0;0;.00nan;0;0
1574;66721;719;88;45;3;42;.933;3600000;0
1574;86283;717;79;31;2;29;.935;3600000;0
1575;28394;719;0;0;0;0;.00nan;0;0
1575;175712;717;0;0;0;0;.00nan;0;0
1575;66721;719;54;41;5;36;.878;3600000;0
1575;86283;717;53;19;2;17;.895;3600000;0
1576;28394;719;0;0;0;0;.00nan;0;0
1576;175712;717;0;0;0;0;.00nan;0;0
1576;66721;719;90;47;3;44;.936;3577000;0
1576;86283;717;70;23;1;22;.957;3600000;0
37291;173823;682;0;0;0;0;.00nan;0;0
37291;24593;676;79;32;1;31;.969;3572000;0
37291;43158;676;0;0;0;0;.00nan;0;0
37291;146184;682;95;24;0;24;1.000;3600000;0
37292;46139;473;98;39;2;37;.949;3560000;0
37292;66551;472;0;0;0;0;.00nan;0;0
37292;66552;473;0;0;0;0;.00nan;0;0
37292;71297;472;69;22;1;21;.955;3600000;0
37293;11500;474;92;44;4;40;.909;3600000;0
37293;20958;4535;0;0;0;0;.00nan;0;0
37293;70573;4535;73;19;1;18;.947;3600000;0
37293;85127;474;0;0;0;0;.00nan;0;0
37294;168926;5004;33;38;7;31;.816;2444000;0
37294;173840;5004;40;15;3;12;.800;1156000;0
37294;170042;481;94;24;0;24;1.000;3600000;0
37294;190235;481;0;0;0;0;.00nan;0;0
37295;172527;675;0;0;0;0;.00nan;0;0
37295;67222;482;99;38;1;37;.974;3600000;0
37295;87894;482;0;0;0;0;.00nan;0;0
37295;142583;675;39;27;5;22;.815;3600000;0
37296;176765;476;56;26;3;23;.885;3583000;0
37296;-1;480;100;44;2;42;.955;3600000;0
37296;-1;480;0;0;0;0;.00nan;0;0
37296;67276;476;0;0;0;0;.00nan;0;0
37297;172527;675;0;0;0;0;.00nan;0;0
37297;173823;682;0;0;0;0;.00nan;0;0
37297;142583;675;95;33;1;32;.970;3624000;0
37297;146184;682;80;29;2;27;.931;3624000;0
37298;11500;474;0;0;0;0;.00nan;0;0
37298;78422;490;0;0;0;0;.00nan;0;0
37298;85127;474;91;43;3;40;.930;3600000;0
37298;153779;490;70;23;2;21;.913;3600000;0
37299;170042;481;82;13;0;13;1.000;3600000;0
37299;190235;481;0;0;0;0;.00nan;0;0
37299;46139;473;68;56;7;49;.875;3600000;0
37299;66552;473;0;0;0;0;.00nan;0;0
37300;-1;480;59;38;5;33;.868;3646000;0
37300;-1;480;0;0;0;0;.00nan;0;0
37300;67222;482;49;25;4;21;.840;3661000;0
37300;87894;482;0;0;0;0;.00nan;0;0
37301;20958;4535;0;0;0;0;.00nan;0;0
37301;66551;472;0;0;0;0;.00nan;0;0
37301;70573;4535;99;46;2;44;.957;3600000;0
37301;71297;472;46;21;3;18;.857;3544000;0
37302;24593;676;56;37;5;32;.865;3560000;0
37302;176765;476;56;21;2;19;.905;3600000;0
37302;43158;676;0;0;0;0;.00nan;0;0
37302;67276;476;0;0;0;0;.00nan;0;0
37303;172527;675;0;0;0;0;.00nan;0;0
37303;78422;490;0;0;0;0;.00nan;0;0
37303;142583;675;44;19;3;16;.842;3571000;0
37303;153779;490;94;39;2;37;.949;3600000;0
37304;172527;675;0;0;0;0;.00nan;0;0
37304;168926;5004;91;50;4;46;.920;3600000;0
37304;173840;5004;0;0;0;0;.00nan;0;0
37304;142583;675;58;12;1;11;.917;3600000;0
37305;173823;682;0;0;0;0;.00nan;0;0
37305;170042;481;81;39;2;37;.949;3600000;0
37305;190235;481;0;0;0;0;.00nan;0;0
37305;146184;682;60;29;3;26;.897;3590000;0
37306;20958;4535;0;0;0;0;.00nan;0;0
37306;46139;473;98;34;1;33;.971;3600000;0
37306;66552;473;0;0;0;0;.00nan;0;0
37306;70573;4535;40;27;4;23;.852;3600000;0
37307;24593;676;40;31;5;26;.839;3600000;0
37307;-1;480;84;27;1;26;.963;3600000;0
37307;43158;676;0;0;0;0;.00nan;0;0
37307;-1;480;0;0;0;0;.00nan;0;0
37308;67222;482;49;38;5;33;.868;3518000;0
37308;78422;490;0;0;0;0;.00nan;0;0
37308;87894;482;0;0;0;0;.00nan;0;0
37308;153779;490;62;27;3;24;.889;3600000;0
37309;11500;474;0;0;0;0;.00nan;0;0
37309;176765;476;79;13;0;13;1.000;3600000;0
37309;67276;476;0;0;0;0;.00nan;0;0
37309;85127;474;82;48;4;44;.917;3600000;0
37310;20958;4535;81;32;2;30;.938;3600000;0
37310;67222;482;0;0;0;0;.00nan;0;0
37310;70573;4535;0;0;0;0;.00nan;0;0
37310;87894;482;51;27;3;24;.889;3569000;0
37311;172527;675;0;0;0;0;.00nan;0;0
37311;24593;676;47;25;3;22;.880;4020000;0
37311;43158;676;0;0;0;0;.00nan;0;0
37311;142583;675;73;38;3;35;.921;4020000;0
37312;11500;474;0;0;0;0;.00nan;0;0
37312;-1;480;77;31;2;29;.935;3600000;0
37312;-1;480;0;0;0;0;.00nan;0;0
37312;85127;474;81;44;3;41;.932;3600000;0
37313;168926;5004;73;49;4;45;.918;3600000;0
37313;173823;682;0;0;0;0;.00nan;0;0
37313;173840;5004;0;0;0;0;.00nan;0;0
37313;146184;682;71;19;1;18;.947;3600000;0
37314;170042;481;0;0;0;0;.00nan;0;0
37314;176765;476;92;27;1;26;.963;4020000;0
37314;190235;481;84;30;1;29;.967;4020000;0
37314;67276;476;0;0;0;0;.00nan;0;0
37315;66551;472;68;18;2;16;.889;4020000;0
37315;71297;472;0;0;0;0;.00nan;0;0
37315;78422;490;0;0;0;0;.00nan;0;0
37315;153779;490;92;55;2;53;.964;4020000;0
37316;172527;675;0;0;0;0;.00nan;0;0
37316;20958;4535;50;1;0;1;1.000;247000;0
37316;70573;4535;39;35;6;29;.829;3353000;0
37316;142583;675;72;29;2;27;.931;3600000;0
37317;173823;682;76;9;0;9;1.000;3600000;0
37317;46139;473;98;47;3;44;.936;3600000;0
37317;66552;473;0;0;0;0;.00nan;0;0
37317;146184;682;0;0;0;0;.00nan;0;0
37318;170042;481;80;37;3;34;.919;4020000;0
37318;190235;481;0;0;0;0;.00nan;0;0
37318;67222;482;80;36;3;33;.917;4020000;0
37318;87894;482;0;0;0;0;.00nan;0;0
37319;168926;5004;40;34;5;29;.853;3600000;0
37319;173840;5004;0;0;0;0;.00nan;0;0
37319;-1;480;56;19;2;17;.895;3600000;0
37319;-1;480;0;0;0;0;.00nan;0;0
37320;24593;676;61;22;2;20;.909;3549000;0
37320;43158;676;0;0;0;0;.00nan;0;0
37320;78422;490;92;37;1;36;.973;3600000;0
37320;153779;490;0;0;0;0;.00nan;0;0
37321;176765;476;81;38;3;35;.921;4020000;0
37321;66551;472;0;0;0;0;.00nan;0;0
37321;67276;476;0;0;0;0;.00nan;0;0
37321;71297;472;83;45;3;42;.933;4008000;0
37322;172527;675;0;0;0;0;.00nan;0;0
37322;-1;480;100;34;1;33;.971;4020000;0
37322;-1;480;0;0;0;0;.00nan;0;0
37322;142583;675;96;38;1;37;.974;4020000;0
37323;163695;482;68;23;2;21;.913;3557000;0
37323;46139;473;100;49;1;48;.980;3600000;0
37323;66552;473;0;0;0;0;.00nan;0;0
37323;67222;482;0;0;0;0;.00nan;0;0
37324;20958;4535;0;0;0;0;.00nan;0;0
37324;176765;476;76;16;1;15;.938;3600000;0
37324;67276;476;0;0;0;0;.00nan;0;0
37324;70573;4535;48;42;6;36;.857;3600000;0
37325;11500;474;0;0;0;0;.00nan;0;0
37325;168926;5004;0;0;0;0;.00nan;0;0
37325;173840;5004;100;35;0;35;1.000;3600000;0
37325;85127;474;85;28;1;27;.964;3546000;0
37326;163528;490;91;41;3;38;.927;3586000;0
37326;170042;481;78;21;1;20;.952;3600000;0
37326;190235;481;0;0;0;0;.00nan;0;0
37326;153779;490;0;0;0;0;.00nan;0;0
37327;173823;682;0;0;0;0;.00nan;0;0
37327;66551;472;0;0;0;0;.00nan;0;0
37327;71297;472;50;34;4;30;.882;4020000;0
37327;146184;682;49;31;4;27;.871;4020000;0
37328;163695;482;95;36;1;35;.972;3600000;0
37328;173823;682;75;30;2;28;.933;3558000;0
37328;67222;482;0;0;0;0;.00nan;0;0
37328;146184;682;0;0;0;0;.00nan;0;0
37329;11500;474;49;26;4;22;.846;4020000;0
37329;24593;676;53;24;4;20;.833;4020000;0
37329;43158;676;0;0;0;0;.00nan;0;0
37329;85127;474;0;0;0;0;.00nan;0;0
37330;176765;476;81;15;0;15;1.000;3600000;0
37330;46139;473;92;49;4;45;.918;3600000;0
37330;66552;473;0;0;0;0;.00nan;0;0
37330;67276;476;0;0;0;0;.00nan;0;0
37331;20958;4535;0;0;0;0;.00nan;0;0
37331;-1;480;80;34;2;32;.941;4020000;0
37331;-1;480;0;0;0;0;.00nan;0;0
37331;70573;4535;90;33;2;31;.939;4020000;0
37332;170042;481;47;41;7;34;.829;3600000;0
37332;190235;481;0;0;0;0;.00nan;0;0
37332;66551;472;0;0;0;0;.00nan;0;0
37332;71297;472;48;22;3;19;.864;3600000;0
37333;163528;490;93;30;1;29;.967;3600000;0
37333;168926;5004;0;0;0;0;.00nan;0;0
37333;173840;5004;87;30;2;28;.933;3566000;0
37333;153779;490;0;0;0;0;.00nan;0;0
37334;24593;676;0;0;0;0;.00nan;0;0
37334;43158;676;100;31;0;31;1.000;3600000;0
37334;46139;473;98;45;1;44;.978;3600000;0
37334;66552;473;0;0;0;0;.00nan;0;0
37335;168926;5004;89;63;5;58;.921;3563000;0
37335;173840;5004;0;0;0;0;.00nan;0;0
37335;66551;472;0;0;0;0;.00nan;0;0
37335;71297;472;43;9;2;7;.778;3600000;0
37336;170042;481;75;26;2;24;.923;3600000;0
37336;190235;481;0;0;0;0;.00nan;0;0
37336;-1;480;65;30;3;27;.900;3597000;0
37336;-1;480;0;0;0;0;.00nan;0;0
37337;163695;482;96;19;0;19;1.000;3600000;0
37337;11500;474;60;27;3;24;.889;3106000;0
37337;67222;482;0;0;0;0;.00nan;0;0
37337;85127;474;25;6;3;3;.500;494000;0
37338;163528;490;69;40;4;36;.900;3600000;0
37338;173823;682;0;0;0;0;.00nan;0;0
37338;146184;682;65;16;1;15;.938;3600000;0
37338;153779;490;0;0;0;0;.00nan;0;0
37339;172527;675;0;0;0;0;.00nan;0;0
37339;176765;476;82;38;3;35;.921;3890000;0
37339;67276;476;0;0;0;0;.00nan;0;0
37339;142583;675;90;43;2;41;.953;3890000;0
37340;24593;676;0;0;0;0;.00nan;0;0
37340;43158;676;63;36;3;33;.917;3600000;0
37340;66551;472;0;0;0;0;.00nan;0;0
37340;71297;472;53;27;4;23;.852;3544000;0
37341;11500;474;0;0;0;0;.00nan;0;0
37341;173823;682;0;0;0;0;.00nan;0;0
37341;85127;474;88;41;2;39;.951;3600000;0
37341;146184;682;70;8;0;8;1.000;3600000;0
37342;20958;4535;0;0;0;0;.00nan;0;0
37342;170042;481;66;21;2;19;.905;4020000;0
37342;190235;481;0;0;0;0;.00nan;0;0
37342;70573;4535;82;30;2;28;.933;4020000;0
37343;163695;482;84;20;1;19;.950;3600000;0
37343;168926;5004;75;42;3;39;.929;3562000;0
37343;173840;5004;0;0;0;0;.00nan;0;0
37343;67222;482;0;0;0;0;.00nan;0;0
37344;-1;480;54;31;3;28;.903;3600000;0
37344;46139;473;64;33;4;29;.879;3573000;0
37344;-1;480;0;0;0;0;.00nan;0;0
37344;66552;473;0;0;0;0;.00nan;0;0
37345;172527;675;0;0;0;0;.00nan;0;0
37345;66551;472;67;28;3;25;.893;3543000;0
37345;71297;472;0;0;0;0;.00nan;0;0
37345;142583;675;82;26;2;24;.923;3600000;0
37346;20958;4535;0;0;0;0;.00nan;0;0
37346;173823;682;0;0;0;0;.00nan;0;0
37346;70573;4535;61;28;3;25;.893;3600000;0
37346;146184;682;80;26;1;25;.962;3600000;0
37347;11500;474;58;35;4;31;.886;3546000;0
37347;46139;473;54;25;3;22;.880;3600000;0
37347;66552;473;0;0;0;0;.00nan;0;0
37347;85127;474;0;0;0;0;.00nan;0;0
37348;168926;5004;59;35;5;30;.857;3600000;0
37348;173840;5004;0;0;0;0;.00nan;0;0
37348;24593;676;70;24;2;22;.917;3600000;0
37348;43158;676;0;0;0;0;.00nan;0;0
37349;163528;490;66;32;3;29;.906;3600000;0
37349;-1;480;30;33;6;27;.818;3600000;0
37349;-1;480;0;0;0;0;.00nan;0;0
37349;153779;490;0;0;0;0;.00nan;0;0
37350;163695;482;15;13;5;8;.615;1004000;0
37350;176765;476;65;27;2;25;.926;3600000;0
37350;67222;482;41;30;5;25;.833;2596000;0
37350;67276;476;0;0;0;0;.00nan;0;0
37351;11500;474;70;46;4;42;.913;3572000;0
37351;20958;4535;0;0;0;0;.00nan;0;0
37351;70573;4535;54;18;3;15;.833;3600000;0
37351;85127;474;0;0;0;0;.00nan;0;0
37352;11500;474;70;49;5;44;.898;3600000;0
37352;170042;481;62;16;2;14;.875;3600000;0
37352;190235;481;0;0;0;0;.00nan;0;0
37352;85127;474;0;0;0;0;.00nan;0;0
37353;172527;675;75;20;1;19;.950;3600000;0
37353;46139;473;54;31;4;27;.871;3600000;0
37353;66552;473;0;0;0;0;.00nan;0;0
37353;142583;675;0;0;0;0;.00nan;0;0
37354;163528;490;86;26;1;25;.962;3600000;0
37354;20958;4535;0;0;0;0;.00nan;0;0
37354;70573;4535;73;38;3;35;.921;3529000;0
37354;153779;490;0;0;0;0;.00nan;0;0
37355;168926;5004;64;47;6;41;.872;3600000;0
37355;173840;5004;0;0;0;0;.00nan;0;0
37355;176765;476;86;15;0;15;1.000;3600000;0
37355;67276;476;0;0;0;0;.00nan;0;0
37356;-1;480;63;40;4;36;.900;3785000;0
37356;-1;480;0;0;0;0;.00nan;0;0
37356;66551;472;0;0;0;0;.00nan;0;0
37356;71297;472;53;22;3;19;.864;3785000;0
37357;173823;682;0;0;0;0;.00nan;0;0
37357;-1;480;0;0;0;0;.00nan;0;0
37357;-1;480;65;34;4;30;.882;4020000;0
37357;146184;682;48;29;4;25;.862;4020000;0
37358;163528;490;73;42;4;38;.905;3600000;0
37358;176765;476;89;18;0;18;1.000;3600000;0
37358;67276;476;0;0;0;0;.00nan;0;0
37358;153779;490;0;0;0;0;.00nan;0;0
37359;20958;4535;0;0;0;0;.00nan;0;0
37359;24593;676;50;31;4;27;.871;3598000;0
37359;43158;676;0;0;0;0;.00nan;0;0
37359;70573;4535;74;36;3;33;.917;3600000;0
37360;168926;5004;46;29;4;25;.862;3554000;0
37360;173840;5004;0;0;0;0;.00nan;0;0
37360;46139;473;69;30;2;28;.933;3600000;0
37360;66552;473;0;0;0;0;.00nan;0;0
37361;172527;675;0;0;0;0;.00nan;0;0
37361;170042;481;51;20;3;17;.850;3566000;0
37361;190235;481;0;0;0;0;.00nan;0;0
37361;142583;675;81;32;2;30;.938;3600000;0
37362;11500;474;65;16;1;15;.938;1307000;0
37362;66551;472;0;0;0;0;.00nan;0;0
37362;71297;472;42;24;4;20;.833;3600000;0
37362;85127;474;26;27;6;21;.778;2293000;0
37363;172527;675;0;0;0;0;.00nan;0;0
37363;11500;474;52;41;6;35;.854;3600000;0
37363;85127;474;0;0;0;0;.00nan;0;0
37363;142583;675;69;23;2;21;.913;3600000;0
37364;163528;490;64;25;2;23;.920;3600000;0
37364;46139;473;65;28;3;25;.893;3600000;0
37364;66552;473;0;0;0;0;.00nan;0;0
37364;153779;490;0;0;0;0;.00nan;0;0
37365;168926;5004;65;40;4;36;.900;3600000;0
37365;20958;4535;0;0;0;0;.00nan;0;0
37365;173840;5004;0;0;0;0;.00nan;0;0
37365;70573;4535;65;16;1;15;.938;3600000;0
37366;170042;481;68;21;1;20;.952;3744000;0
37366;24593;676;79;26;2;24;.923;3744000;0
37366;190235;481;0;0;0;0;.00nan;0;0
37366;43158;676;0;0;0;0;.00nan;0;0
37367;163695;482;44;31;5;26;.839;3593000;0
37367;66551;472;0;0;0;0;.00nan;0;0
37367;67222;482;0;0;0;0;.00nan;0;0
37367;71297;472;55;23;3;20;.870;3600000;0
37368;173823;682;0;0;0;0;.00nan;0;0
37368;176765;476;100;41;2;39;.951;4020000;0
37368;67276;476;0;0;0;0;.00nan;0;0
37368;146184;682;63;31;2;29;.935;4020000;0
37369;163695;482;86;43;3;40;.930;3600000;0
37369;173823;682;0;0;0;0;.00nan;0;0
37369;67222;482;0;0;0;0;.00nan;0;0
37369;146184;682;61;19;2;17;.895;3600000;0
37370;-1;480;59;39;5;34;.872;3568000;0
37370;-1;480;0;0;0;0;.00nan;0;0
37370;66551;472;0;0;0;0;.00nan;0;0
37370;71297;472;55;20;3;17;.850;3600000;0
37371;24593;676;75;30;3;27;.900;3600000;0
37371;176765;476;98;20;0;20;1.000;3600000;0
37371;43158;676;0;0;0;0;.00nan;0;0
37371;67276;476;0;0;0;0;.00nan;0;0
37372;11500;474;0;0;0;0;.00nan;0;0
37372;168926;5004;86;31;1;30;.968;3574000;0
37372;173840;5004;0;0;0;0;.00nan;0;0
37372;85127;474;100;31;0;31;1.000;3600000;0
37373;172527;675;0;0;0;0;.00nan;0;0
37373;20958;4535;0;0;0;0;.00nan;0;0
37373;70573;4535;72;28;2;26;.929;3600000;0
37373;142583;675;91;28;1;27;.964;3600000;0
37374;163528;490;28;27;6;21;.778;3142000;0
37374;170042;481;65;29;3;26;.897;3600000;0
37374;190235;481;0;0;0;0;.00nan;0;0
37374;153779;490;55;4;0;4;1.000;458000;0
37375;13033;474;0;0;0;0;.00nan;0;0
37375;46139;473;74;23;1;22;.957;3600000;0
37375;66552;473;0;0;0;0;.00nan;0;0
37375;85127;474;70;27;2;25;.926;3600000;0
37376;172527;675;0;0;0;0;.00nan;0;0
37376;24593;676;100;42;1;41;.976;4020000;0
37376;43158;676;0;0;0;0;.00nan;0;0
37376;142583;675;59;18;1;17;.944;4020000;0
37377;20958;4535;77;39;4;35;.897;3541000;0
37377;173823;682;0;0;0;0;.00nan;0;0
37377;70573;4535;0;0;0;0;.00nan;0;0
37377;146184;682;55;26;3;23;.885;3600000;0
37378;170042;481;71;37;3;34;.919;3565000;0
37378;190235;481;0;0;0;0;.00nan;0;0
37378;-1;480;66;19;1;18;.947;3600000;0
37378;-1;480;0;0;0;0;.00nan;0;0
37379;168926;5004;82;52;4;48;.923;3594000;0
37379;173840;5004;0;0;0;0;.00nan;0;0
37379;66551;472;58;26;3;23;.885;3600000;0
37379;71297;472;0;0;0;0;.00nan;0;0
37380;163528;490;33;7;3;4;.571;507000;0
37380;176765;476;53;30;4;26;.867;3600000;0
37380;67276;476;0;0;0;0;.00nan;0;0
37380;153779;490;77;34;3;31;.912;3029000;0
37381;24593;676;75;28;2;26;.929;4020000;0
37381;-1;480;61;19;2;17;.895;4020000;0
37381;43158;676;0;0;0;0;.00nan;0;0
37381;-1;480;0;0;0;0;.00nan;0;0
37382;172527;675;0;0;0;0;.00nan;0;0
37382;173823;682;0;0;0;0;.00nan;0;0
37382;142583;675;96;30;1;29;.967;3600000;0
37382;146184;682;53;27;4;23;.852;3600000;0
37383;168926;5004;55;34;4;30;.882;3600000;0
37383;173840;5004;0;0;0;0;.00nan;0;0
37383;46139;473;96;34;1;33;.971;3600000;0
37383;66552;473;0;0;0;0;.00nan;0;0
37384;170042;481;57;32;4;28;.875;3582000;0
37384;190235;481;0;0;0;0;.00nan;0;0
37384;66551;472;0;0;0;0;.00nan;0;0
37384;71297;472;71;26;2;24;.923;3600000;0
37385;163695;482;0;0;0;0;.00nan;0;0
37385;176765;476;63;19;2;17;.895;3576000;0
37385;67222;482;100;43;1;42;.977;3600000;0
37385;67276;476;0;0;0;0;.00nan;0;0
37386;163528;490;74;33;2;31;.939;3600000;0
37386;13033;474;43;23;4;19;.826;3517000;0
37386;85127;474;0;0;0;0;.00nan;0;0
37386;153779;490;0;0;0;0;.00nan;0;0
37387;163695;482;33;25;5;20;.800;3582000;0
37387;13033;474;77;48;4;44;.917;3600000;0
37387;67222;482;0;0;0;0;.00nan;0;0
37387;85127;474;0;0;0;0;.00nan;0;0
37388;170042;481;48;12;2;10;.833;3600000;0
37388;190235;481;0;0;0;0;.00nan;0;0
37388;46139;473;65;43;5;38;.884;3600000;0
37388;66552;473;0;0;0;0;.00nan;0;0
37389;20958;4535;0;0;0;0;.00nan;0;0
37389;24593;676;43;27;4;23;.852;3567000;0
37389;43158;676;0;0;0;0;.00nan;0;0
37389;70573;4535;84;36;2;34;.944;3600000;0
37390;173823;682;0;0;0;0;.00nan;0;0
37390;-1;480;68;34;3;31;.912;3592000;0
37390;-1;480;0;0;0;0;.00nan;0;0
37390;146184;682;81;28;1;27;.964;3600000;0
37391;172527;675;0;0;0;0;.00nan;0;0
37391;66551;472;100;40;0;40;1.000;3600000;0
37391;71297;472;0;0;0;0;.00nan;0;0
37391;142583;675;58;20;3;17;.850;3600000;0
37392;168926;5004;97;76;5;71;.934;3600000;0
37392;173840;5004;0;0;0;0;.00nan;0;0
37392;176765;476;28;7;3;4;.571;3600000;0
37392;67276;476;0;0;0;0;.00nan;0;0
37393;163528;490;62;32;4;28;.875;3572000;0
37393;24593;676;55;22;3;19;.864;3600000;0
37393;43158;676;0;0;0;0;.00nan;0;0
37393;153779;490;0;0;0;0;.00nan;0;0
37394;-1;480;0;0;0;0;.00nan;0;0
37394;46139;473;100;46;2;44;.957;4020000;0
37394;-1;480;63;24;2;22;.917;4020000;0
37394;66552;473;0;0;0;0;.00nan;0;0
37395;20958;4535;0;0;0;0;.00nan;0;0
37395;66551;472;0;0;0;0;.00nan;0;0
37395;70573;4535;34;32;6;26;.813;3584000;0
37395;71297;472;59;27;4;23;.852;3600000;0
37396;172527;675;0;0;0;0;.00nan;0;0
37396;168926;5004;51;51;7;44;.863;3325000;0
37396;173840;5004;56;6;0;6;1.000;274000;0
37396;142583;675;27;19;5;14;.737;3600000;0
37397;163695;482;72;29;2;27;.931;3600000;0
37397;170042;481;67;24;2;22;.917;3553000;0
37397;190235;481;0;0;0;0;.00nan;0;0
37397;67222;482;0;0;0;0;.00nan;0;0
37398;168926;5004;32;25;5;20;.800;1638000;0
37398;173840;5004;57;23;3;20;.870;1962000;0
37398;24593;676;83;11;0;11;1.000;3600000;0
37398;43158;676;0;0;0;0;.00nan;0;0
37399;13033;474;62;38;4;34;.895;3521000;0
37399;20958;4535;0;0;0;0;.00nan;0;0
37399;70573;4535;76;29;2;27;.931;3600000;0
37399;85127;474;0;0;0;0;.00nan;0;0
37400;172527;675;0;0;0;0;.00nan;0;0
37400;170042;481;67;31;4;27;.871;3600000;0
37400;190235;481;0;0;0;0;.00nan;0;0
37400;142583;675;33;22;5;17;.773;3582000;0
37401;163695;482;50;24;4;20;.833;3513000;0
37401;-1;480;65;24;2;22;.917;3600000;0
37401;-1;480;0;0;0;0;.00nan;0;0
37401;67222;482;0;0;0;0;.00nan;0;0
37402;176765;476;84;26;1;25;.962;3558000;0
37402;66551;472;0;0;0;0;.00nan;0;0
37402;67276;476;0;0;0;0;.00nan;0;0
37402;71297;472;100;35;0;35;1.000;3600000;0
37403;163528;490;41;18;3;15;.833;3560000;0
37403;46139;473;97;43;2;41;.953;3600000;0
37403;66552;473;0;0;0;0;.00nan;0;0
37403;153779;490;0;0;0;0;.00nan;0;0
37404;173823;682;0;0;0;0;.00nan;0;0
37404;176765;476;69;22;2;20;.909;4020000;0
37404;67276;476;0;0;0;0;.00nan;0;0
37404;146184;682;60;24;2;22;.917;3989000;0
37405;173823;682;62;21;2;19;.905;3600000;0
37405;66551;472;0;0;0;0;.00nan;0;0
37405;71297;472;52;33;4;29;.879;3534000;0
37405;146184;682;0;0;0;0;.00nan;0;0
37406;172527;675;0;0;0;0;.00nan;0;0
37406;46139;473;78;39;3;36;.923;3531000;0
37406;66552;473;0;0;0;0;.00nan;0;0
37406;142583;675;77;18;1;17;.944;3600000;0
37407;20958;4535;48;5;1;4;.800;391000;0
37407;-1;480;0;0;0;0;.00nan;0;0
37407;-1;480;60;26;3;23;.885;3600000;0
37407;70573;4535;37;33;6;27;.818;3209000;0
37408;163528;490;51;16;2;14;.875;3592000;0
37408;168926;5004;100;65;1;64;.985;3600000;0
37408;173840;5004;0;0;0;0;.00nan;0;0
37408;153779;490;0;0;0;0;.00nan;0;0
37409;13033;474;71;41;4;37;.902;3600000;0
37409;170042;481;66;18;1;17;.944;3600000;0
37409;190235;481;0;0;0;0;.00nan;0;0
37409;85127;474;0;0;0;0;.00nan;0;0
37410;163695;482;0;0;0;0;.00nan;0;0
37410;24593;676;85;30;1;29;.967;3600000;0
37410;43158;676;0;0;0;0;.00nan;0;0
37410;67222;482;70;38;4;34;.895;3600000;0
37411;13033;474;91;45;3;42;.933;3600000;0
37411;-1;480;21;13;4;9;.692;3600000;0
37411;-1;480;0;0;0;0;.00nan;0;0
37411;85127;474;0;0;0;0;.00nan;0;0
37412;163528;490;28;26;5;21;.808;2234000;0
37412;172527;675;0;0;0;0;.00nan;0;0
37412;142583;675;100;34;0;34;1.000;3600000;0
37412;153779;490;42;12;2;10;.833;1366000;0
37413;168926;5004;98;57;5;52;.912;3600000;0
37413;173823;682;89;15;0;15;1.000;3600000;0
37413;173840;5004;0;0;0;0;.00nan;0;0
37413;146184;682;0;0;0;0;.00nan;0;0
37414;163695;482;64;22;2;20;.909;3600000;0
37414;20958;4535;61;34;4;30;.882;3106000;0
37414;67222;482;0;0;0;0;.00nan;0;0
37414;70573;4535;29;8;3;5;.625;494000;0
37415;24593;676;81;41;3;38;.927;3557000;0
37415;43158;676;0;0;0;0;.00nan;0;0
37415;66551;472;64;22;2;20;.909;3600000;0
37415;71297;472;0;0;0;0;.00nan;0;0
37416;176765;476;84;18;0;18;1.000;3600000;0
37416;46139;473;45;37;6;31;.838;3600000;0
37416;66552;473;0;0;0;0;.00nan;0;0
37416;67276;476;0;0;0;0;.00nan;0;0
37417;173823;682;88;23;1;22;.957;4020000;0
37417;24593;676;0;0;0;0;.00nan;0;0
37417;43158;676;95;45;1;44;.978;4020000;0
37417;146184;682;0;0;0;0;.00nan;0;0
37418;163695;482;0;0;0;0;.00nan;0;0
37418;46139;473;84;38;2;36;.947;4020000;0
37418;66552;473;0;0;0;0;.00nan;0;0
37418;67222;482;60;28;2;26;.929;4020000;0
37419;20958;4535;0;0;0;0;.00nan;0;0
37419;176765;476;60;22;3;19;.864;3958000;0
37419;67276;476;0;0;0;0;.00nan;0;0
37419;70573;4535;69;41;4;37;.902;3969000;0
37420;13033;474;85;43;3;40;.930;3600000;0
37420;66551;472;0;0;0;0;.00nan;0;0
37420;71297;472;96;21;0;21;1.000;3600000;0
37420;85127;474;0;0;0;0;.00nan;0;0
37421;168926;5004;0;0;0;0;.00nan;0;0
37421;173840;5004;94;55;3;52;.945;3697000;0
37421;170042;481;58;14;2;12;.857;3697000;0
37421;190235;481;0;0;0;0;.00nan;0;0
37422;163528;490;37;25;5;20;.800;3600000;0
37422;-1;480;67;16;1;15;.938;3600000;0
37422;-1;480;0;0;0;0;.00nan;0;0
37422;153779;490;0;0;0;0;.00nan;0;0
37423;13033;474;79;43;3;40;.930;3540000;0
37423;176765;476;73;23;1;22;.957;3600000;0
37423;67276;476;0;0;0;0;.00nan;0;0
37423;85127;474;0;0;0;0;.00nan;0;0
37424;163695;482;32;37;7;30;.811;3600000;0
37424;172527;675;0;0;0;0;.00nan;0;0
37424;67222;482;0;0;0;0;.00nan;0;0
37424;142583;675;59;26;3;23;.885;3600000;0
37425;173823;682;0;0;0;0;.00nan;0;0
37425;46139;473;71;58;5;53;.914;3548000;0
37425;66552;473;0;0;0;0;.00nan;0;0
37425;146184;682;57;20;3;17;.850;3600000;0
37426;168926;5004;66;35;4;31;.886;3600000;0
37426;173840;5004;0;0;0;0;.00nan;0;0
37426;-1;480;67;20;1;19;.950;3600000;0
37426;-1;480;0;0;0;0;.00nan;0;0
37427;20958;4535;0;0;0;0;.00nan;0;0
37427;170042;481;61;25;3;22;.880;3600000;0
37427;190235;481;0;0;0;0;.00nan;0;0
37427;70573;4535;79;53;5;48;.906;3553000;0
37428;163528;490;72;46;4;42;.913;3600000;0
37428;66551;472;0;0;0;0;.00nan;0;0
37428;71297;472;54;28;3;25;.893;3600000;0
37428;153779;490;0;0;0;0;.00nan;0;0
37429;170042;481;44;17;3;14;.824;3582000;0
37429;24593;676;82;27;1;26;.963;3600000;0
37429;190235;481;0;0;0;0;.00nan;0;0
37429;43158;676;0;0;0;0;.00nan;0;0
37430;172527;675;0;0;0;0;.00nan;0;0
37430;176765;476;80;33;3;30;.909;3565000;0
37430;67276;476;0;0;0;0;.00nan;0;0
37430;142583;675;65;27;2;25;.926;3600000;0
37431;13033;474;98;51;1;50;.980;3595000;0
37431;173823;682;0;0;0;0;.00nan;0;0
37431;85127;474;0;0;0;0;.00nan;0;0
37431;146184;682;72;7;0;7;1.000;3600000;0
37432;168926;5004;73;42;4;38;.905;3600000;0
37432;20958;4535;0;0;0;0;.00nan;0;0
37432;173840;5004;0;0;0;0;.00nan;0;0
37432;70573;4535;63;16;1;15;.938;3600000;0
37433;163528;490;62;37;5;32;.865;3600000;0
37433;163695;482;41;47;8;39;.830;3600000;0
37433;67222;482;0;0;0;0;.00nan;0;0
37433;153779;490;0;0;0;0;.00nan;0;0
37434;46139;473;62;48;6;42;.875;3600000;0
37434;66551;472;0;0;0;0;.00nan;0;0
37434;66552;473;0;0;0;0;.00nan;0;0
37434;71297;472;52;11;1;10;.909;3600000;0
37435;172527;675;0;0;0;0;.00nan;0;0
37435;13033;474;92;33;2;31;.939;3903000;0
37435;85127;474;0;0;0;0;.00nan;0;0
37435;142583;675;64;17;1;16;.941;3903000;0
37436;24593;676;69;20;1;19;.950;3600000;0
37436;43158;676;0;0;0;0;.00nan;0;0
37436;46139;473;72;36;3;33;.917;3586000;0
37436;66552;473;0;0;0;0;.00nan;0;0
37437;163695;482;0;0;0;0;.00nan;0;0
37437;168926;5004;100;48;1;47;.979;3600000;0
37437;173840;5004;0;0;0;0;.00nan;0;0
37437;67222;482;36;22;5;17;.773;3600000;0
37438;173823;682;85;39;3;36;.923;3549000;0
37438;170042;481;75;28;2;26;.929;3600000;0
37438;190235;481;0;0;0;0;.00nan;0;0
37438;146184;682;0;0;0;0;.00nan;0;0
37439;163528;490;73;30;2;28;.933;3600000;0
37439;20958;4535;65;7;0;7;1.000;549000;0
37439;70573;4535;36;30;6;24;.800;3051000;0
37439;153779;490;0;0;0;0;.00nan;0;0
37440;176765;476;47;29;5;24;.828;3600000;0
37440;-1;480;27;12;4;8;.667;1056000;0
37440;-1;480;59;35;5;30;.857;2544000;0
37440;67276;476;0;0;0;0;.00nan;0;0
37441;13033;474;57;33;4;29;.879;3600000;0
37441;24593;676;89;16;0;16;1.000;3600000;0
37441;43158;676;0;0;0;0;.00nan;0;0
37441;85127;474;0;0;0;0;.00nan;0;0
37442;163528;490;43;33;5;28;.848;3571000;0
37442;173823;682;0;0;0;0;.00nan;0;0
37442;146184;682;80;44;4;40;.909;3600000;0
37442;153779;490;0;0;0;0;.00nan;0;0
37443;20958;4535;0;0;0;0;.00nan;0;0
37443;46139;473;61;33;4;29;.879;3612000;0
37443;66552;473;0;0;0;0;.00nan;0;0
37443;70573;4535;52;34;5;29;.853;3612000;0
37444;172527;675;0;0;0;0;.00nan;0;0
37444;-1;480;63;35;3;32;.914;4020000;0
37444;-1;480;0;0;0;0;.00nan;0;0
37444;142583;675;67;29;3;26;.897;4020000;0
37445;163695;482;68;40;4;36;.900;3569000;0
37445;66551;472;0;0;0;0;.00nan;0;0
37445;67222;482;0;0;0;0;.00nan;0;0
37445;71297;472;95;45;3;42;.933;3600000;0
37446;170042;481;71;27;3;24;.889;3554000;0
37446;176765;476;84;29;2;27;.931;3600000;0
37446;190235;481;0;0;0;0;.00nan;0;0
37446;67276;476;0;0;0;0;.00nan;0;0
37447;163695;482;62;29;2;27;.931;3600000;0
37447;173823;682;0;0;0;0;.00nan;0;0
37447;67222;482;0;0;0;0;.00nan;0;0
37447;146184;682;26;20;5;15;.750;3600000;0
37448;13033;474;90;39;2;37;.949;3600000;0
37448;-1;480;0;0;0;0;.00nan;0;0
37448;-1;480;82;26;1;25;.962;3600000;0
37448;85127;474;0;0;0;0;.00nan;0;0
37449;168926;5004;97;43;0;43;1.000;4020000;0
37449;173840;5004;0;0;0;0;.00nan;0;0
37449;24593;676;91;11;0;11;1.000;4020000;0
37449;43158;676;0;0;0;0;.00nan;0;0
37450;172527;675;0;0;0;0;.00nan;0;0
37450;46139;473;37;32;6;26;.813;2606000;0
37450;66552;473;18;8;4;4;.500;994000;0
37450;142583;675;55;17;2;15;.882;3600000;0
37451;176765;476;62;27;3;24;.889;3696000;0
37451;66551;472;0;0;0;0;.00nan;0;0
37451;67276;476;0;0;0;0;.00nan;0;0
37451;71297;472;75;37;4;33;.892;3696000;0
37452;163528;490;0;0;0;0;.00nan;0;0
37452;170042;481;100;36;1;35;.972;3600000;0
37452;190235;481;0;0;0;0;.00nan;0;0
37452;153779;490;89;34;2;32;.941;3600000;0
37453;173823;682;55;22;3;19;.864;3553000;0
37453;176765;476;82;31;2;29;.935;3600000;0
37453;67276;476;0;0;0;0;.00nan;0;0
37453;146184;682;0;0;0;0;.00nan;0;0
37454;13033;474;63;46;6;40;.870;3584000;0
37454;66551;472;0;0;0;0;.00nan;0;0
37454;71297;472;38;22;4;18;.818;3600000;0
37454;85127;474;0;0;0;0;.00nan;0;0
37455;173823;682;69;15;1;14;.933;3600000;0
37455;24593;676;56;28;4;24;.857;3600000;0
37455;43158;676;0;0;0;0;.00nan;0;0
37455;146184;682;0;0;0;0;.00nan;0;0
37456;-1;480;85;14;0;14;1.000;3600000;0
37456;46139;473;66;27;2;25;.926;3546000;0
37456;-1;480;0;0;0;0;.00nan;0;0
37456;66552;473;0;0;0;0;.00nan;0;0
37457;172527;675;0;0;0;0;.00nan;0;0
37457;168926;5004;57;51;7;44;.863;3600000;0
37457;173840;5004;0;0;0;0;.00nan;0;0
37457;142583;675;58;13;1;12;.923;3600000;0
37458;163695;482;74;26;2;24;.923;3600000;0
37458;20958;4535;0;0;0;0;.00nan;0;0
37458;67222;482;0;0;0;0;.00nan;0;0
37458;70573;4535;72;41;4;37;.902;3566000;0
37459;163528;490;90;31;2;29;.935;3600000;0
37459;176765;476;28;26;6;20;.769;3600000;0
37459;67276;476;0;0;0;0;.00nan;0;0
37459;153779;490;0;0;0;0;.00nan;0;0
37460;24593;676;21;11;4;7;.636;712000;0
37460;43158;676;47;22;3;19;.864;2888000;0
37460;66551;472;60;22;3;19;.864;3600000;0
37460;71297;472;0;0;0;0;.00nan;0;0
37461;20958;4535;0;0;0;0;.00nan;0;0
37461;176765;476;0;0;0;0;.00nan;0;0
37461;67276;476;81;18;0;18;1.000;3600000;0
37461;70573;4535;63;56;7;49;.875;3600000;0
37462;172527;675;0;0;0;0;.00nan;0;0
37462;13033;474;88;48;3;45;.938;4020000;0
37462;85127;474;0;0;0;0;.00nan;0;0
37462;142583;675;41;16;3;13;.813;4020000;0
37463;163695;482;73;37;3;34;.919;3531000;0
37463;170042;481;66;20;1;19;.950;3600000;0
37463;190235;481;0;0;0;0;.00nan;0;0
37463;67222;482;0;0;0;0;.00nan;0;0
37464;173823;682;0;0;0;0;.00nan;0;0
37464;-1;480;98;44;2;42;.955;3590000;0
37464;-1;480;0;0;0;0;.00nan;0;0
37464;146184;682;69;20;1;19;.950;3600000;0
37465;163528;490;74;10;0;10;1.000;3600000;0
37465;168926;5004;62;44;5;39;.886;3600000;0
37465;173840;5004;0;0;0;0;.00nan;0;0
37465;153779;490;0;0;0;0;.00nan;0;0
37466;163695;482;73;22;1;21;.955;3600000;0
37466;24593;676;51;26;4;22;.846;3600000;0
37466;43158;676;0;0;0;0;.00nan;0;0
37466;67222;482;0;0;0;0;.00nan;0;0
37467;24593;676;49;15;3;12;.800;3600000;0
37467;43158;676;0;0;0;0;.00nan;0;0
37467;46139;473;89;61;5;56;.918;3564000;0
37467;66552;473;0;0;0;0;.00nan;0;0
37468;168926;5004;78;46;4;42;.913;4020000;0
37468;173840;5004;0;0;0;0;.00nan;0;0
37468;170042;481;54;29;4;25;.862;4020000;0
37468;190235;481;0;0;0;0;.00nan;0;0
37469;163695;482;76;52;5;47;.904;3600000;0
37469;-1;480;84;35;2;33;.943;3600000;0
37469;-1;480;0;0;0;0;.00nan;0;0
37469;67222;482;0;0;0;0;.00nan;0;0
37470;172527;675;0;0;0;0;.00nan;0;0
37470;66551;472;0;0;0;0;.00nan;0;0
37470;71297;472;51;33;4;29;.879;3569000;0
37470;142583;675;85;35;2;33;.943;3600000;0
37471;173823;682;0;0;0;0;.00nan;0;0
37471;176765;476;0;0;0;0;.00nan;0;0
37471;67276;476;64;24;2;22;.917;3549000;0
37471;146184;682;79;26;1;25;.962;3600000;0
37472;13033;474;0;0;0;0;.00nan;0;0
37472;173823;682;68;23;2;21;.913;3600000;0
37472;85127;474;80;49;4;45;.918;3576000;0
37472;146184;682;0;0;0;0;.00nan;0;0
37473;172527;675;59;24;3;21;.875;3787000;0
37473;20958;4535;0;0;0;0;.00nan;0;0
37473;70573;4535;89;39;2;37;.949;3787000;0
37473;142583;675;0;0;0;0;.00nan;0;0
37474;168926;5004;100;47;1;46;.979;4020000;0
37474;173840;5004;0;0;0;0;.00nan;0;0
37474;46139;473;97;30;1;29;.967;4020000;0
37474;66552;473;0;0;0;0;.00nan;0;0
37475;170042;481;92;48;3;45;.938;3610000;0
37475;190235;481;0;0;0;0;.00nan;0;0
37475;-1;480;62;23;2;21;.913;3610000;0
37475;-1;480;0;0;0;0;.00nan;0;0
37476;163695;482;100;23;0;23;1.000;3600000;0
37476;66551;472;0;0;0;0;.00nan;0;0
37476;67222;482;0;0;0;0;.00nan;0;0
37476;71297;472;57;30;4;26;.867;3600000;0
37477;163528;490;70;23;1;22;.957;3653000;0
37477;24593;676;82;29;2;27;.931;3653000;0
37477;43158;676;0;0;0;0;.00nan;0;0
37477;153779;490;0;0;0;0;.00nan;0;0
37478;163695;482;30;29;6;23;.793;2510000;0
37478;13033;474;71;27;2;25;.926;3600000;0
37478;67222;482;55;11;1;10;.909;1090000;0
37478;85127;474;0;0;0;0;.00nan;0;0
37479;163528;490;83;28;1;27;.964;3600000;0
37479;172527;675;56;9;1;8;.889;1637000;0
37479;142583;675;42;20;4;16;.800;1963000;0
37479;153779;490;0;0;0;0;.00nan;0;0
37480;173823;682;0;0;0;0;.00nan;0;0
37480;46139;473;67;37;4;33;.892;3577000;0
37480;66552;473;0;0;0;0;.00nan;0;0
37480;146184;682;60;21;2;19;.905;3600000;0
37481;168926;5004;34;39;6;33;.846;2855000;0
37481;20958;4535;62;21;2;19;.905;3600000;0
37481;173840;5004;57;10;1;9;.900;745000;0
37481;70573;4535;0;0;0;0;.00nan;0;0
37482;176765;476;100;36;2;34;.944;3600000;0
37482;-1;480;51;27;4;23;.852;3600000;0
37482;-1;480;0;0;0;0;.00nan;0;0
37482;67276;476;0;0;0;0;.00nan;0;0
37483;170042;481;100;43;1;42;.977;3600000;0
37483;190235;481;0;0;0;0;.00nan;0;0
37483;66551;472;0;0;0;0;.00nan;0;0
37483;71297;472;68;29;2;27;.931;3600000;0
37484;172527;675;0;0;0;0;.00nan;0;0
37484;24593;676;100;35;0;35;1.000;3600000;0
37484;43158;676;0;0;0;0;.00nan;0;0
37484;142583;675;62;22;2;20;.909;3565000;0
37485;46139;473;32;26;5;21;.808;2176000;0
37485;66551;472;0;0;0;0;.00nan;0;0
37485;66552;473;68;19;1;18;.947;1424000;0
37485;71297;472;61;11;1;10;.909;3600000;0
37486;168926;5004;0;0;0;0;.00nan;0;0
37486;173840;5004;79;45;3;42;.933;3600000;0
37486;-1;480;81;16;0;16;1.000;3600000;0
37486;-1;480;0;0;0;0;.00nan;0;0
37487;20958;4535;0;0;0;0;.00nan;0;0
37487;170042;481;80;31;2;29;.935;3954000;0
37487;190235;481;0;0;0;0;.00nan;0;0
37487;70573;4535;71;37;3;34;.919;3954000;0
37488;163528;490;81;42;3;39;.929;3546000;0
37488;173823;682;0;0;0;0;.00nan;0;0
37488;146184;682;77;24;1;23;.958;3600000;0
37488;153779;490;0;0;0;0;.00nan;0;0
37489;13033;474;67;35;3;32;.914;3600000;0
37489;176765;476;45;23;4;19;.826;3566000;0
37489;67276;476;0;0;0;0;.00nan;0;0
37489;85127;474;0;0;0;0;.00nan;0;0
37490;13033;474;60;18;1;17;.944;3600000;0
37490;46139;473;45;33;5;28;.848;3600000;0
37490;66552;473;0;0;0;0;.00nan;0;0
37490;85127;474;0;0;0;0;.00nan;0;0
37491;168926;5004;23;13;4;9;.692;1147000;0
37491;173823;682;0;0;0;0;.00nan;0;0
37491;173840;5004;73;41;4;37;.902;2453000;0
37491;146184;682;74;7;0;7;1.000;3600000;0
37492;20958;4535;0;0;0;0;.00nan;0;0
37492;24593;676;100;25;0;25;1.000;3600000;0
37492;43158;676;0;0;0;0;.00nan;0;0
37492;70573;4535;64;27;3;24;.889;3600000;0
37493;172527;675;0;0;0;0;.00nan;0;0
37493;170042;481;73;31;4;27;.871;3764000;0
37493;190235;481;0;0;0;0;.00nan;0;0
37493;142583;675;64;29;3;26;.897;3764000;0
37494;163695;482;65;48;6;42;.875;3600000;0
37494;176765;476;90;23;1;22;.957;3600000;0
37494;67222;482;0;0;0;0;.00nan;0;0
37494;67276;476;0;0;0;0;.00nan;0;0
37495;163528;490;75;29;2;27;.931;3559000;0
37495;-1;480;85;18;0;18;1.000;3600000;0
37495;-1;480;0;0;0;0;.00nan;0;0
37495;153779;490;0;0;0;0;.00nan;0;0
37496;24593;676;80;32;1;31;.969;3600000;0
37496;176765;476;60;26;3;23;.885;3564000;0
37496;43158;676;0;0;0;0;.00nan;0;0
37496;67276;476;0;0;0;0;.00nan;0;0
37497;163695;482;81;41;3;38;.927;3789000;0
37497;172527;675;0;0;0;0;.00nan;0;0
37497;67222;482;0;0;0;0;.00nan;0;0
37497;142583;675;68;40;4;36;.900;3789000;0
37498;20958;4535;0;0;0;0;.00nan;0;0
37498;173823;682;0;0;0;0;.00nan;0;0
37498;70573;4535;62;36;4;32;.889;3600000;0
37498;146184;682;72;30;2;28;.933;3600000;0
37499;170042;481;53;27;5;22;.815;3600000;0
37499;190235;481;0;0;0;0;.00nan;0;0
37499;46139;473;0;0;0;0;.00nan;0;0
37499;66552;473;50;43;6;37;.860;3578000;0
37500;168926;5004;76;51;5;46;.902;3600000;0
37500;173840;5004;0;0;0;0;.00nan;0;0
37500;66551;472;0;0;0;0;.00nan;0;0
37500;71297;472;53;10;1;9;.900;3600000;0
37501;163528;490;70;26;2;24;.923;3600000;0
37501;13033;474;71;42;4;38;.905;3600000;0
37501;85127;474;0;0;0;0;.00nan;0;0
37501;153779;490;0;0;0;0;.00nan;0;0
37502;20958;4535;0;0;0;0;.00nan;0;0
37502;46139;473;65;38;4;34;.895;3600000;0
37502;66552;473;0;0;0;0;.00nan;0;0
37502;70573;4535;85;25;1;24;.960;3600000;0
37503;13033;474;51;31;4;27;.871;3600000;0
37503;170042;481;80;38;3;35;.921;3600000;0
37503;190235;481;0;0;0;0;.00nan;0;0
37503;85127;474;0;0;0;0;.00nan;0;0
37504;163528;490;55;24;4;20;.833;3515000;0
37504;163695;482;73;24;2;22;.917;3600000;0
37504;67222;482;0;0;0;0;.00nan;0;0
37504;153779;490;0;0;0;0;.00nan;0;0
37505;24593;676;100;35;0;35;1.000;3600000;0
37505;-1;480;95;31;2;29;.935;3514000;0
37505;43158;676;0;0;0;0;.00nan;0;0
37505;-1;480;0;0;0;0;.00nan;0;0
37506;173823;682;0;0;0;0;.00nan;0;0
37506;66551;472;0;0;0;0;.00nan;0;0
37506;71297;472;100;32;1;31;.969;3600000;0
37506;146184;682;83;36;2;34;.944;3592000;0
37507;172527;675;0;0;0;0;.00nan;0;0
37507;176765;476;61;34;5;29;.853;3730000;0
37507;67276;476;0;0;0;0;.00nan;0;0
37507;142583;675;58;42;4;38;.905;3730000;0
37508;163695;482;88;24;1;23;.958;3600000;0
37508;24593;676;68;25;2;23;.920;3600000;0
37508;43158;676;0;0;0;0;.00nan;0;0
37508;67222;482;0;0;0;0;.00nan;0;0
37509;172527;675;0;0;0;0;.00nan;0;0
37509;-1;480;25;6;3;3;.500;1220000;0
37509;-1;480;26;29;6;23;.793;2380000;0
37509;142583;675;65;31;3;28;.903;3600000;0
37510;163528;490;84;27;1;26;.963;4007000;0
37510;46139;473;97;44;1;43;.977;4020000;0
37510;66552;473;0;0;0;0;.00nan;0;0
37510;153779;490;0;0;0;0;.00nan;0;0
37511;13033;474;71;24;1;23;.958;3600000;0
37511;168926;5004;68;32;3;29;.906;3600000;0
37511;173840;5004;0;0;0;0;.00nan;0;0
37511;85127;474;0;0;0;0;.00nan;0;0
37512;20958;4535;54;4;0;4;1.000;765000;0
37512;66551;472;0;0;0;0;.00nan;0;0
37512;70573;4535;27;30;6;24;.800;2835000;0
37512;71297;472;68;27;3;24;.889;3600000;0
37513;170042;481;67;45;5;40;.889;3600000;0
37513;176765;476;62;24;2;22;.917;3600000;0
37513;190235;481;0;0;0;0;.00nan;0;0
37513;67276;476;0;0;0;0;.00nan;0;0
37514;172527;675;0;0;0;0;.00nan;0;0
37514;173823;682;0;0;0;0;.00nan;0;0
37514;142583;675;50;32;5;27;.844;3600000;0
37514;146184;682;81;23;1;22;.957;3600000;0
37515;170042;481;55;27;4;23;.852;3589000;0
37515;24593;676;93;46;2;44;.957;3600000;0
37515;190235;481;0;0;0;0;.00nan;0;0
37515;43158;676;0;0;0;0;.00nan;0;0
37516;163695;482;90;18;0;18;1.000;3600000;0
37516;168926;5004;92;52;4;48;.923;3600000;0
37516;173840;5004;0;0;0;0;.00nan;0;0
37516;67222;482;0;0;0;0;.00nan;0;0
37517;20958;4535;0;0;0;0;.00nan;0;0
37517;-1;480;59;23;3;20;.870;3600000;0
37517;-1;480;0;0;0;0;.00nan;0;0
37517;70573;4535;79;44;4;40;.909;3595000;0
37518;163528;490;0;0;0;0;.00nan;0;0
37518;66551;472;0;0;0;0;.00nan;0;0
37518;71297;472;51;14;2;12;.857;3600000;0
37518;153779;490;89;50;3;47;.940;3600000;0
37519;176765;476;43;8;2;6;.750;3600000;0
37519;46139;473;81;59;6;53;.898;3600000;0
37519;66552;473;0;0;0;0;.00nan;0;0
37519;67276;476;0;0;0;0;.00nan;0;0
37520;13033;474;79;43;4;39;.907;3600000;0
37520;24593;676;18;21;6;15;.714;3524000;0
37520;43158;676;0;0;0;0;.00nan;0;0
37520;85127;474;0;0;0;0;.00nan;0;0
37521;173823;682;70;21;1;20;.952;3548000;0
37521;170042;481;100;36;0;36;1.000;3600000;0
37521;190235;481;0;0;0;0;.00nan;0;0
37521;146184;682;0;0;0;0;.00nan;0;0
37522;163695;482;85;15;0;15;1.000;3600000;0
37522;46139;473;63;35;4;31;.886;3600000;0
37522;66552;473;0;0;0;0;.00nan;0;0
37522;67222;482;0;0;0;0;.00nan;0;0
37523;163528;490;56;33;5;28;.848;4020000;0
37523;20958;4535;19;14;5;9;.643;2024000;0
37523;70573;4535;64;14;0;14;1.000;1996000;0
37523;153779;490;0;0;0;0;.00nan;0;0
37524;168926;5004;66;27;2;25;.926;2420000;0
37524;173840;5004;36;18;4;14;.778;1180000;0
37524;176765;476;62;14;1;13;.929;3600000;0
37524;67276;476;0;0;0;0;.00nan;0;0
37525;-1;480;63;35;3;32;.914;4020000;0
37525;-1;480;0;0;0;0;.00nan;0;0
37525;66551;472;75;32;3;29;.906;4020000;0
37525;71297;472;0;0;0;0;.00nan;0;0
37526;173823;682;0;0;0;0;.00nan;0;0
37526;-1;480;0;0;0;0;.00nan;0;0
37526;-1;480;86;39;3;36;.923;3600000;0
37526;146184;682;71;20;1;19;.950;3600000;0
37527;163695;482;62;26;2;24;.923;3600000;0
37527;66551;472;0;0;0;0;.00nan;0;0
37527;67222;482;0;0;0;0;.00nan;0;0
37527;71297;472;46;20;3;17;.850;3553000;0
37528;163528;490;55;40;5;35;.875;3600000;0
37528;176765;476;93;22;1;21;.955;3600000;0
37528;67276;476;0;0;0;0;.00nan;0;0
37528;153779;490;0;0;0;0;.00nan;0;0
37529;13033;474;77;28;1;27;.964;3600000;0
37529;46139;473;54;30;4;26;.867;3600000;0
37529;66552;473;0;0;0;0;.00nan;0;0
37529;85127;474;0;0;0;0;.00nan;0;0
37530;172527;675;0;0;0;0;.00nan;0;0
37530;20958;4535;0;0;0;0;.00nan;0;0
37530;70573;4535;76;22;1;21;.955;3600000;0
37530;142583;675;67;26;2;24;.923;3541000;0
37531;168926;5004;43;39;6;33;.846;2907000;0
37531;173840;5004;28;15;4;11;.733;693000;0
37531;170042;481;0;0;0;0;.00nan;0;0
37531;190235;481;82;11;0;11;1.000;3600000;0
37532;20958;4535;69;10;0;10;1.000;1472000;0
37532;24593;676;100;36;2;34;.944;3600000;0
37532;43158;676;0;0;0;0;.00nan;0;0
37532;70573;4535;18;22;6;16;.727;2128000;0
37533;172527;675;72;31;2;29;.935;3600000;0
37533;173823;682;0;0;0;0;.00nan;0;0
37533;142583;675;0;0;0;0;.00nan;0;0
37533;146184;682;60;34;4;30;.882;3529000;0
37534;168926;5004;79;17;0;17;1.000;3600000;0
37534;173840;5004;0;0;0;0;.00nan;0;0
37534;46139;473;57;23;3;20;.870;3600000;0
37534;66552;473;0;0;0;0;.00nan;0;0
37535;163695;482;56;27;3;24;.889;4020000;0
37535;170042;481;0;0;0;0;.00nan;0;0
37535;190235;481;96;45;3;42;.933;4020000;0
37535;67222;482;0;0;0;0;.00nan;0;0
37536;163528;490;88;29;1;28;.966;3600000;0
37536;-1;480;45;18;3;15;.833;3556000;0
37536;-1;480;0;0;0;0;.00nan;0;0
37536;153779;490;0;0;0;0;.00nan;0;0
37537;176765;476;100;33;0;33;1.000;3600000;0
37537;66551;472;0;0;0;0;.00nan;0;0
37537;67276;476;0;0;0;0;.00nan;0;0
37537;71297;472;66;44;4;40;.909;3600000;0
37538;173823;682;71;35;3;32;.914;3600000;0
37538;24593;676;43;5;1;4;.800;519000;0
37538;43158;676;13;29;7;22;.759;3081000;0
37538;146184;682;0;0;0;0;.00nan;0;0
37539;172527;675;0;0;0;0;.00nan;0;0
37539;170042;481;85;41;3;38;.927;3735000;0
37539;190235;481;0;0;0;0;.00nan;0;0
37539;142583;675;64;37;4;33;.892;3735000;0
37540;-1;480;0;0;0;0;.00nan;0;0
37540;-1;480;48;26;4;22;.846;3541000;0
37540;66551;472;72;27;2;25;.926;3600000;0
37540;71297;472;0;0;0;0;.00nan;0;0
37541;20958;4535;0;0;0;0;.00nan;0;0
37541;46139;473;16;21;6;15;.714;2351000;0
37541;66552;473;56;10;1;9;.900;1249000;0
37541;70573;4535;67;24;2;22;.917;3600000;0
37542;163695;482;36;34;6;28;.824;3283000;0
37542;13033;474;57;37;5;32;.865;3600000;0
37542;67222;482;50;3;0;3;1.000;261000;0
37542;85127;474;0;0;0;0;.00nan;0;0
37543;168926;5004;39;32;6;26;.813;1609000;0
37543;173840;5004;97;37;0;37;1.000;1991000;0
37543;176765;476;74;20;1;19;.950;3600000;0
37543;67276;476;0;0;0;0;.00nan;0;0
37544;13033;474;74;37;3;34;.919;3548000;0
37544;170042;481;71;17;1;16;.941;3600000;0
37544;190235;481;0;0;0;0;.00nan;0;0
37544;85127;474;0;0;0;0;.00nan;0;0
37545;163528;490;28;8;3;5;.625;487000;0
37545;173823;682;0;0;0;0;.00nan;0;0
37545;146184;682;62;13;1;12;.923;3600000;0
37545;153779;490;56;27;3;24;.889;3113000;0
37546;20958;4535;0;0;0;0;.00nan;0;0
37546;-1;480;45;27;4;23;.852;3573000;0
37546;-1;480;0;0;0;0;.00nan;0;0
37546;70573;4535;82;33;2;31;.939;3600000;0
37547;168926;5004;32;11;3;8;.727;542000;0
37547;173840;5004;80;28;1;27;.964;3024000;0
37547;24593;676;68;26;3;23;.885;3600000;0
37547;43158;676;0;0;0;0;.00nan;0;0
37548;163695;482;0;0;0;0;.00nan;0;0
37548;172527;675;0;0;0;0;.00nan;0;0
37548;67222;482;73;34;3;31;.912;3707000;0
37548;142583;675;60;21;2;19;.905;3707000;0
37549;46139;473;26;36;7;29;.806;3600000;0
37549;66551;472;0;0;0;0;.00nan;0;0
37549;66552;473;0;0;0;0;.00nan;0;0
37549;71297;472;71;32;3;29;.906;3600000;0
37550;24593;676;73;46;5;41;.891;3600000;0
37550;43158;676;0;0;0;0;.00nan;0;0
37550;66551;472;0;0;0;0;.00nan;0;0
37550;71297;472;94;23;0;23;1.000;3600000;0
37551;20958;4535;0;0;0;0;.00nan;0;0
37551;176765;476;40;23;4;19;.826;3543000;0
37551;67276;476;0;0;0;0;.00nan;0;0
37551;70573;4535;74;34;3;31;.912;3600000;0
37552;163695;482;95;23;0;23;1.000;3600000;0
37552;168926;5004;43;24;4;20;.833;2378000;0
37552;173840;5004;64;15;1;14;.933;1222000;0
37552;67222;482;0;0;0;0;.00nan;0;0
37553;13033;474;81;45;4;41;.911;3600000;0
37553;-1;480;0;0;0;0;.00nan;0;0
37553;-1;480;82;11;0;11;1.000;3600000;0
37553;85127;474;0;0;0;0;.00nan;0;0
37554;163528;490;63;16;1;15;.938;3600000;0
37554;46139;473;41;46;7;39;.848;3600000;0
37554;66552;473;0;0;0;0;.00nan;0;0
37554;153779;490;0;0;0;0;.00nan;0;0
37555;172527;675;0;0;0;0;.00nan;0;0
37555;66551;472;0;0;0;0;.00nan;0;0
37555;71297;472;65;31;3;28;.903;3600000;0
37555;142583;675;75;9;0;9;1.000;3600000;0
37556;176765;476;63;22;2;20;.909;3600000;0
37556;46139;473;0;0;0;0;.00nan;0;0
37556;66552;473;62;43;5;38;.884;3600000;0
37556;67276;476;0;0;0;0;.00nan;0;0
37557;163695;482;77;36;3;33;.917;4020000;0
37557;20958;4535;58;30;3;27;.900;4020000;0
37557;67222;482;0;0;0;0;.00nan;0;0
37557;70573;4535;0;0;0;0;.00nan;0;0
37558;24593;676;90;30;1;29;.967;3600000;0
37558;-1;480;0;0;0;0;.00nan;0;0
37558;43158;676;0;0;0;0;.00nan;0;0
37558;-1;480;52;36;5;31;.861;3600000;0
37559;13033;474;52;24;3;21;.875;3600000;0
37559;168926;5004;65;45;4;41;.911;3588000;0
37559;173840;5004;0;0;0;0;.00nan;0;0
37559;85127;474;0;0;0;0;.00nan;0;0
37560;163528;490;74;26;2;24;.923;3600000;0
37560;170042;481;48;22;4;18;.818;3544000;0
37560;190235;481;0;0;0;0;.00nan;0;0
37560;153779;490;0;0;0;0;.00nan;0;0
37561;173823;682;0;0;0;0;.00nan;0;0
37561;170042;481;100;25;0;25;1.000;3600000;0
37561;190235;481;0;0;0;0;.00nan;0;0
37561;146184;682;59;27;3;24;.889;3600000;0
37562;172527;675;0;0;0;0;.00nan;0;0
37562;13033;474;60;29;4;25;.862;3600000;0
37562;85127;474;0;0;0;0;.00nan;0;0
37562;142583;675;79;23;1;22;.957;3600000;0
37563;173823;682;53;3;0;3;1.000;569000;0
37563;66551;472;0;0;0;0;.00nan;0;0
37563;71297;472;65;26;2;24;.923;3600000;0
37563;146184;682;35;33;6;27;.818;3031000;0
37564;170042;481;68;22;2;20;.909;3600000;0
37564;190235;481;0;0;0;0;.00nan;0;0
37564;46139;473;68;39;4;35;.897;3600000;0
37564;66552;473;0;0;0;0;.00nan;0;0
37565;168926;5004;89;48;3;45;.938;3582000;0
37565;173840;5004;0;0;0;0;.00nan;0;0
37565;-1;480;64;11;1;10;.909;3600000;0
37565;-1;480;0;0;0;0;.00nan;0;0
37566;163528;490;78;23;1;22;.957;3600000;0
37566;20958;4535;0;0;0;0;.00nan;0;0
37566;70573;4535;68;33;3;30;.909;3531000;0
37566;153779;490;0;0;0;0;.00nan;0;0
37567;24593;676;60;53;6;47;.887;3600000;0
37567;176765;476;74;25;1;24;.960;3600000;0
37567;43158;676;0;0;0;0;.00nan;0;0
37567;67276;476;0;0;0;0;.00nan;0;0
37568;170042;481;79;24;1;23;.958;3600000;0
37568;24593;676;54;24;3;21;.875;3565000;0
37568;190235;481;0;0;0;0;.00nan;0;0
37568;43158;676;0;0;0;0;.00nan;0;0
37569;172527;675;0;0;0;0;.00nan;0;0
37569;176765;476;53;31;4;27;.871;3600000;0
37569;67276;476;0;0;0;0;.00nan;0;0
37569;142583;675;100;36;1;35;.972;3600000;0
37570;163528;490;69;21;2;19;.905;3600000;0
37570;168926;5004;0;0;0;0;.00nan;0;0
37570;173840;5004;90;66;4;62;.939;3583000;0
37570;153779;490;0;0;0;0;.00nan;0;0
37571;163695;482;72;28;3;25;.893;3600000;0
37571;-1;480;41;30;5;25;.833;3565000;0
37571;-1;480;0;0;0;0;.00nan;0;0
37571;67222;482;0;0;0;0;.00nan;0;0
37572;13033;474;77;42;4;38;.905;3600000;0
37572;66551;472;0;0;0;0;.00nan;0;0
37572;71297;472;60;14;1;13;.929;3600000;0
37572;85127;474;0;0;0;0;.00nan;0;0
37573;163528;490;66;31;3;28;.903;3808000;0
37573;24593;676;78;28;2;26;.929;3808000;0
37573;43158;676;0;0;0;0;.00nan;0;0
37573;153779;490;0;0;0;0;.00nan;0;0
37574;13033;474;93;47;4;43;.915;3600000;0
37574;176765;476;98;21;0;21;1.000;3600000;0
37574;67276;476;0;0;0;0;.00nan;0;0
37574;85127;474;0;0;0;0;.00nan;0;0
37575;20958;4535;0;0;0;0;.00nan;0;0
37575;66551;472;0;0;0;0;.00nan;0;0
37575;70573;4535;37;30;5;25;.833;3589000;0
37575;71297;472;55;24;3;21;.875;3600000;0
37576;168926;5004;42;38;6;32;.842;2400000;0
37576;173823;682;0;0;0;0;.00nan;0;0
37576;173840;5004;58;11;1;10;.909;1200000;0
37576;146184;682;63;12;1;11;.917;3600000;0
37577;163695;482;75;18;1;17;.944;3600000;0
37577;46139;473;58;46;6;40;.870;3600000;0
37577;66552;473;0;0;0;0;.00nan;0;0
37577;67222;482;0;0;0;0;.00nan;0;0
37578;172527;675;0;0;0;0;.00nan;0;0
37578;-1;480;0;0;0;0;.00nan;0;0
37578;-1;480;92;25;0;25;1.000;3600000;0
37578;142583;675;70;23;2;21;.913;3550000;0
37579;13033;474;83;37;3;34;.919;3568000;0
37579;173823;682;0;0;0;0;.00nan;0;0
37579;85127;474;0;0;0;0;.00nan;0;0
37579;146184;682;58;21;2;19;.905;3600000;0
37580;24593;676;86;23;1;22;.957;3600000;0
37580;43158;676;0;0;0;0;.00nan;0;0
37580;46139;473;82;43;4;39;.907;3600000;0
37580;66552;473;0;0;0;0;.00nan;0;0
37581;20958;4535;0;0;0;0;.00nan;0;0
37581;170042;481;64;31;3;28;.903;3567000;0
37581;190235;481;0;0;0;0;.00nan;0;0
37581;70573;4535;83;38;2;36;.947;3600000;0
37582;168926;5004;87;50;4;46;.920;3600000;0
37582;173840;5004;0;0;0;0;.00nan;0;0
37582;66551;472;53;8;1;7;.875;3600000;0
37582;71297;472;0;0;0;0;.00nan;0;0
37583;163528;490;0;0;0;0;.00nan;0;0
37583;172527;675;0;0;0;0;.00nan;0;0
37583;142583;675;76;26;2;24;.923;3600000;0
37583;153779;490;47;33;5;28;.848;3600000;0
37584;163695;482;99;36;1;35;.972;3600000;0
37584;176765;476;69;27;2;25;.926;3571000;0
37584;67222;482;0;0;0;0;.00nan;0;0
37584;67276;476;0;0;0;0;.00nan;0;0
37585;163528;490;59;25;3;22;.880;3600000;0
37585;13033;474;0;0;0;0;.00nan;0;0
37585;85127;474;49;28;4;24;.857;3576000;0
37585;153779;490;0;0;0;0;.00nan;0;0
37586;172527;675;0;0;0;0;.00nan;0;0
37586;24593;676;45;21;4;17;.810;3585000;0
37586;43158;676;0;0;0;0;.00nan;0;0
37586;142583;675;78;22;1;21;.955;3600000;0
37587;168926;5004;0;0;0;0;.00nan;0;0
37587;20958;4535;0;0;0;0;.00nan;0;0
37587;173840;5004;83;49;5;44;.898;4020000;0
37587;70573;4535;41;25;5;20;.800;4020000;0
37588;170042;481;73;29;3;26;.897;3600000;0
37588;176765;476;43;25;4;21;.840;3547000;0
37588;190235;481;0;0;0;0;.00nan;0;0
37588;67276;476;0;0;0;0;.00nan;0;0
37589;163695;482;71;33;4;29;.879;3546000;0
37589;173823;682;0;0;0;0;.00nan;0;0
37589;67222;482;0;0;0;0;.00nan;0;0
37589;146184;682;66;26;2;24;.923;3600000;0
37590;-1;480;0;0;0;0;.00nan;0;0
37590;46139;473;62;46;5;41;.891;3600000;0
37590;-1;480;77;11;0;11;1.000;3600000;0
37590;66552;473;0;0;0;0;.00nan;0;0
37591;13033;474;50;22;3;19;.864;3541000;0
37591;24593;676;80;23;1;22;.957;3600000;0
37591;43158;676;0;0;0;0;.00nan;0;0
37591;85127;474;0;0;0;0;.00nan;0;0
37592;172527;675;0;0;0;0;.00nan;0;0
37592;46139;473;82;46;4;42;.913;3600000;0
37592;66552;473;0;0;0;0;.00nan;0;0
37592;142583;675;63;13;1;12;.923;3600000;0
37593;20958;4535;0;0;0;0;.00nan;0;0
37593;173823;682;0;0;0;0;.00nan;0;0
37593;70573;4535;77;45;4;41;.911;3600000;0
37593;146184;682;61;21;2;19;.905;3600000;0
37594;170042;481;95;32;1;31;.969;4020000;0
37594;190235;481;0;0;0;0;.00nan;0;0
37594;66551;472;0;0;0;0;.00nan;0;0
37594;71297;472;91;27;1;26;.963;4020000;0
37595;163528;490;23;24;6;18;.750;2274000;0
37595;163695;482;80;39;3;36;.923;3600000;0
37595;67222;482;0;0;0;0;.00nan;0;0
37595;153779;490;64;14;0;14;1.000;1326000;0
37596;176765;476;57;30;4;26;.867;3600000;0
37596;-1;480;0;0;0;0;.00nan;0;0
37596;-1;480;100;32;0;32;1.000;3600000;0
37596;67276;476;0;0;0;0;.00nan;0;0
37597;13033;474;21;28;7;21;.750;3600000;0
37597;20958;4535;0;0;0;0;.00nan;0;0
37597;70573;4535;60;20;2;18;.900;3600000;0
37597;85127;474;0;0;0;0;.00nan;0;0
37598;172527;675;0;0;0;0;.00nan;0;0
37598;168926;5004;84;44;3;41;.932;3600000;0
37598;173840;5004;0;0;0;0;.00nan;0;0
37598;142583;675;73;18;1;17;.944;3600000;0
37599;173823;682;0;0;0;0;.00nan;0;0
37599;46139;473;52;44;5;39;.886;3600000;0
37599;66552;473;0;0;0;0;.00nan;0;0
37599;146184;682;84;22;1;21;.955;3600000;0
37600;163695;482;72;27;2;25;.926;3863000;0
37600;24593;676;72;16;1;15;.938;3863000;0
37600;43158;676;0;0;0;0;.00nan;0;0
37600;67222;482;0;0;0;0;.00nan;0;0
37601;170042;481;64;44;5;39;.886;3600000;0
37601;190235;481;0;0;0;0;.00nan;0;0
37601;-1;480;0;0;0;0;.00nan;0;0
37601;-1;480;91;31;1;30;.968;3600000;0
37602;163528;490;65;24;2;22;.917;3546000;0
37602;66551;472;0;0;0;0;.00nan;0;0
37602;71297;472;75;22;1;21;.955;3600000;0
37602;153779;490;0;0;0;0;.00nan;0;0
37604;168926;5004;44;42;6;36;.857;2830000;0
37604;173840;5004;42;15;3;12;.800;770000;0
37604;24593;676;79;12;0;12;1.000;3600000;0
37604;43158;676;0;0;0;0;.00nan;0;0
37606;172527;675;0;0;0;0;.00nan;0;0
37606;66552;482;0;0;0;0;.00nan;0;0
37606;67222;482;63;39;4;35;.897;3563000;0
37606;142583;675;71;21;2;19;.905;3600000;0
37608;170042;481;74;48;5;43;.896;3600000;0
37608;190235;481;0;0;0;0;.00nan;0;0
37608;66551;472;0;0;0;0;.00nan;0;0
37608;71297;472;97;25;0;25;1.000;3600000;0
37610;11500;474;0;0;0;0;.00nan;0;0
37610;20958;4535;0;0;0;0;.00nan;0;0
37610;70573;4535;81;23;1;22;.957;3600000;0
37610;85127;474;82;50;4;46;.920;3600000;0
37612;193041;473;0;0;0;0;.00nan;0;0
37612;173823;682;0;0;0;0;.00nan;0;0
37612;46139;473;90;47;3;44;.936;3600000;0
37612;146184;682;56;17;2;15;.882;3600000;0
37614;176765;476;62;28;3;25;.893;3600000;0
37614;67276;476;0;0;0;0;.00nan;0;0
37614;87894;490;0;0;0;0;.00nan;0;0
37614;153779;490;50;40;6;34;.850;3600000;0
37616;24593;676;72;24;2;22;.917;3600000;0
37616;43158;676;0;0;0;0;.00nan;0;0
37616;87894;490;51;5;0;5;1.000;458000;0
37616;153779;490;40;37;6;31;.838;3142000;0
37618;20958;4535;0;0;0;0;.00nan;0;0
37618;170042;481;99;40;2;38;.950;3600000;0
37618;190235;481;0;0;0;0;.00nan;0;0
37618;70573;4535;80;45;4;41;.911;3600000;0
37620;172527;675;0;0;0;0;.00nan;0;0
37620;176765;476;90;30;1;29;.967;3600000;0
37620;67276;476;0;0;0;0;.00nan;0;0
37620;142583;675;21;28;7;21;.750;3600000;0
37622;193041;473;0;0;0;0;.00nan;0;0
37622;173823;682;0;0;0;0;.00nan;0;0
37622;46139;473;75;47;4;43;.915;3600000;0
37622;146184;682;54;13;2;11;.846;3600000;0
37624;168926;5004;85;43;4;39;.907;3600000;0
37624;173840;5004;0;0;0;0;.00nan;0;0
37624;66551;472;0;0;0;0;.00nan;0;0
37624;71297;472;71;17;1;16;.941;3600000;0
37626;11500;474;64;30;3;27;.900;3600000;0
37626;-1;480;57;36;5;31;.861;3528000;0
37626;-1;480;0;0;0;0;.00nan;0;0
37626;85127;474;0;0;0;0;.00nan;0;0
37628;193041;473;76;37;3;34;.919;3549000;0
37628;170042;481;0;0;0;0;.00nan;0;0
37628;190235;481;83;32;2;30;.938;3600000;0
37628;46139;473;0;0;0;0;.00nan;0;0
37630;176765;476;0;0;0;0;.00nan;0;0
37630;67276;476;70;20;1;19;.950;3600000;0
37630;87894;490;83;37;2;35;.946;3569000;0
37630;153779;490;0;0;0;0;.00nan;0;0
37632;172527;675;67;16;1;15;.938;3600000;0
37632;168926;5004;63;10;0;10;1.000;672000;0
37632;173840;5004;47;41;6;35;.854;2928000;0
37632;142583;675;0;0;0;0;.00nan;0;0
37634;20958;4535;14;5;4;1;.200;464000;0
37634;173823;682;100;35;0;35;1.000;3600000;0
37634;70573;4535;67;34;3;31;.912;3136000;0
37634;146184;682;0;0;0;0;.00nan;0;0
37636;11500;474;0;0;0;0;.00nan;0;0
37636;-1;480;0;0;0;0;.00nan;0;0
37636;-1;480;37;32;6;26;.813;4020000;0
37636;85127;474;46;32;5;27;.844;4020000;0
37638;66551;472;27;30;6;24;.800;3231000;0
37638;66552;482;0;0;0;0;.00nan;0;0
37638;67222;482;88;40;3;37;.925;3600000;0
37638;71297;472;44;3;1;2;.667;369000;0
37640;-1;480;83;39;2;37;.949;3600000;0
37640;-1;480;0;0;0;0;.00nan;0;0
37640;66551;472;67;9;0;9;1.000;877000;0
37640;71297;472;23;25;6;19;.760;2723000;0
37642;173823;682;44;27;4;23;.852;3600000;0
37642;87894;490;0;0;0;0;.00nan;0;0
37642;146184;682;0;0;0;0;.00nan;0;0
37642;153779;490;100;29;0;29;1.000;3600000;0
37644;193041;473;0;0;0;0;.00nan;0;0
37644;46139;473;93;46;2;44;.957;4020000;0
37644;66552;482;0;0;0;0;.00nan;0;0
37644;67222;482;60;24;2;22;.917;4020000;0
37646;168926;5004;86;46;3;43;.935;3548000;0
37646;173840;5004;0;0;0;0;.00nan;0;0
37646;176765;476;72;25;2;23;.920;3600000;0
37646;67276;476;0;0;0;0;.00nan;0;0
37648;170042;481;46;21;4;17;.810;2281000;0
37648;24593;676;47;31;5;26;.839;4020000;0
37648;190235;481;63;16;1;15;.938;1718000;0
37648;43158;676;0;0;0;0;.00nan;0;0
37650;172527;675;0;0;0;0;.00nan;0;0
37650;20958;4535;0;0;0;0;.00nan;0;0
37650;70573;4535;69;38;4;34;.895;3600000;0
37650;142583;675;75;24;1;23;.958;3600000;0
37652;173823;682;46;4;1;3;.750;537000;0
37652;24593;676;0;0;0;0;.00nan;0;0
37652;43158;676;73;31;3;28;.903;3600000;0
37652;146184;682;30;26;6;20;.769;3063000;0
37654;193041;473;57;49;6;43;.878;3224000;0
37654;46139;473;43;4;1;3;.750;376000;0
37654;66551;472;39;15;3;12;.800;3600000;0
37654;71297;472;0;0;0;0;.00nan;0;0
37656;11500;474;75;41;3;38;.927;3600000;0
37656;85127;474;0;0;0;0;.00nan;0;0
37656;87894;490;0;0;0;0;.00nan;0;0
37656;153779;490;100;27;0;27;1.000;3600000;0
37658;176765;476;0;0;0;0;.00nan;0;0
37658;-1;480;30;10;3;7;.700;1242000;0
37658;-1;480;40;33;6;27;.818;2358000;0
37658;67276;476;56;19;2;17;.895;3600000;0
37660;168926;5004;49;8;1;7;.875;643000;0
37660;173840;5004;60;49;6;43;.878;2957000;0
37660;66552;482;67;16;1;15;.938;3600000;0
37660;67222;482;0;0;0;0;.00nan;0;0
37662;172527;675;45;17;3;14;.824;3600000;0
37662;170042;481;80;51;5;46;.902;3582000;0
37662;190235;481;0;0;0;0;.00nan;0;0
37662;142583;675;0;0;0;0;.00nan;0;0
37664;11500;474;62;30;3;27;.900;3600000;0
37664;85127;474;0;0;0;0;.00nan;0;0
37664;87894;490;0;0;0;0;.00nan;0;0
37664;153779;490;45;23;4;19;.826;3600000;0
37666;176765;476;62;24;2;22;.917;3600000;0
37666;66552;482;29;14;4;10;.714;996000;0
37666;67222;482;55;42;6;36;.857;2604000;0
37666;67276;476;0;0;0;0;.00nan;0;0
37668;20958;4535;0;0;0;0;.00nan;0;0
37668;-1;480;65;32;3;29;.906;3565000;0
37668;-1;480;0;0;0;0;.00nan;0;0
37668;70573;4535;86;33;2;31;.939;3600000;0
37670;193041;473;0;0;0;0;.00nan;0;0
37670;168926;5004;61;29;3;26;.897;3600000;0
37670;173840;5004;0;0;0;0;.00nan;0;0
37670;46139;473;91;18;0;18;1.000;3600000;0
37672;24593;676;79;41;4;37;.902;3600000;0
37672;43158;676;0;0;0;0;.00nan;0;0
37672;66551;472;46;7;1;6;.857;708000;0
37672;71297;472;52;46;6;40;.870;2892000;0
37674;172527;675;0;0;0;0;.00nan;0;0
37674;173823;682;0;0;0;0;.00nan;0;0
37674;142583;675;56;24;3;21;.875;3597000;0
37674;146184;682;62;22;2;20;.909;3600000;0
37676;172527;675;62;12;1;11;.917;3600000;0
37676;87894;490;74;62;7;55;.887;3600000;0
37676;142583;675;0;0;0;0;.00nan;0;0
37676;153779;490;0;0;0;0;.00nan;0;0
37678;11500;474;0;0;0;0;.00nan;0;0
37678;66552;482;20;26;6;20;.769;2778000;0
37678;67222;482;49;14;2;12;.857;822000;0
37678;85127;474;86;27;1;26;.963;3600000;0
37686;193041;473;0;0;0;0;.00nan;0;0
37686;-1;480;0;0;0;0;.00nan;0;0
37686;46139;473;61;48;5;43;.896;3523000;0
37686;-1;480;81;31;3;28;.903;3600000;0
859;163695;482;34;19;4;15;.789;3563000;0
859;20958;4535;0;0;0;0;.00nan;0;0
859;67222;482;0;0;0;0;.00nan;0;0
859;70573;4535;91;40;2;38;.950;3600000;0
860;163528;490;61;29;3;26;.897;3600000;0
860;24593;676;54;27;4;23;.852;3555000;0
860;43158;676;0;0;0;0;.00nan;0;0
860;153779;490;0;0;0;0;.00nan;0;0
861;163695;482;93;24;0;24;1.000;3600000;0
861;20958;4535;0;0;0;0;.00nan;0;0
861;67222;482;0;0;0;0;.00nan;0;0
861;70573;4535;79;35;2;33;.943;3594000;0
862;163528;490;79;33;3;30;.909;3600000;0
862;24593;676;100;24;0;24;1.000;3600000;0
862;43158;676;0;0;0;0;.00nan;0;0
862;153779;490;0;0;0;0;.00nan;0;0
921;163695;482;77;28;3;25;.893;3543000;0
921;20958;4535;0;0;0;0;.00nan;0;0
921;67222;482;0;0;0;0;.00nan;0;0
921;70573;4535;67;29;2;27;.931;3600000;0
922;163528;490;84;55;5;50;.909;3600000;0
922;24593;676;60;25;2;23;.920;3600000;0
922;43158;676;0;0;0;0;.00nan;0;0
922;153779;490;0;0;0;0;.00nan;0;0
953;20958;4535;0;0;0;0;.00nan;0;0
953;66551;472;0;0;0;0;.00nan;0;0
953;70573;4535;89;41;2;39;.951;3600000;0
953;71297;472;59;15;1;14;.933;3600000;0
954;173823;682;0;0;0;0;.00nan;0;0
954;24593;676;65;43;4;39;.907;4546000;0
954;43158;676;0;0;0;0;.00nan;0;0
954;146184;682;47;22;3;19;.864;4546000;0
955;172527;675;0;0;0;0;.00nan;0;0
955;-1;480;0;0;0;0;.00nan;0;0
955;-1;480;100;34;0;34;1.000;3600000;0
955;142583;675;60;30;4;26;.867;3600000;0
956;170042;481;89;37;2;35;.946;3600000;0
956;176765;476;52;30;4;26;.867;3528000;0
956;190235;481;0;0;0;0;.00nan;0;0
956;67276;476;0;0;0;0;.00nan;0;0
957;20958;4535;0;0;0;0;.00nan;0;0
957;66551;472;0;0;0;0;.00nan;0;0
957;70573;4535;91;42;2;40;.952;3600000;0
957;71297;472;52;21;3;18;.857;3553000;0
958;173823;682;0;0;0;0;.00nan;0;0
958;24593;676;70;35;4;31;.886;3569000;0
958;43158;676;0;0;0;0;.00nan;0;0
958;146184;682;61;28;3;25;.893;3600000;0
959;172527;675;0;0;0;0;.00nan;0;0
959;-1;480;0;0;0;0;.00nan;0;0
959;-1;480;53;26;4;22;.846;4063000;0
959;142583;675;68;42;5;37;.881;4063000;0
960;170042;481;70;32;3;29;.906;3554000;0
960;176765;476;80;19;1;18;.947;3600000;0
960;190235;481;0;0;0;0;.00nan;0;0
960;67276;476;0;0;0;0;.00nan;0;0
961;20958;4535;0;0;0;0;.00nan;0;0
961;66551;472;0;0;0;0;.00nan;0;0
961;70573;4535;67;36;4;32;.889;3577000;0
961;71297;472;43;17;3;14;.824;3600000;0
962;173823;682;0;0;0;0;.00nan;0;0
962;24593;676;84;31;2;29;.935;3600000;0
962;43158;676;0;0;0;0;.00nan;0;0
962;146184;682;51;23;3;20;.870;3547000;0
963;172527;675;0;0;0;0;.00nan;0;0
963;-1;480;0;0;0;0;.00nan;0;0
963;-1;480;86;28;1;27;.964;3600000;0
963;142583;675;62;26;3;23;.885;3527000;0
964;170042;481;100;56;2;54;.964;4726000;0
964;176765;476;69;32;3;29;.906;4726000;0
964;190235;481;0;0;0;0;.00nan;0;0
964;67276;476;0;0;0;0;.00nan;0;0
965;20958;4535;0;0;0;0;.00nan;0;0
965;66551;472;0;0;0;0;.00nan;0;0
965;70573;4535;79;28;2;26;.929;3565000;0
965;71297;472;74;25;1;24;.960;3600000;0
966;173823;682;0;0;0;0;.00nan;0;0
966;24593;676;55;31;4;27;.871;3593000;0
966;43158;676;0;0;0;0;.00nan;0;0
966;146184;682;57;21;3;18;.857;3600000;0
967;172527;675;0;0;0;0;.00nan;0;0
967;-1;480;0;0;0;0;.00nan;0;0
967;-1;480;76;31;2;29;.935;3593000;0
967;142583;675;80;28;1;27;.964;3600000;0
968;170042;481;82;47;5;42;.894;4058000;0
968;176765;476;57;35;4;31;.886;4058000;0
968;190235;481;0;0;0;0;.00nan;0;0
968;67276;476;0;0;0;0;.00nan;0;0
1172;20958;4535;48;6;1;5;.833;827000;0
1172;66551;472;0;0;0;0;.00nan;0;0
1172;70573;4535;33;32;6;26;.813;2773000;0
1172;71297;472;83;27;1;26;.963;3600000;0
1173;173823;682;0;0;0;0;.00nan;0;0
1173;24593;676;97;44;2;42;.955;3565000;0
1173;43158;676;0;0;0;0;.00nan;0;0
1173;146184;682;72;19;1;18;.947;3600000;0
1174;172527;675;0;0;0;0;.00nan;0;0
1174;-1;480;0;0;0;0;.00nan;0;0
1174;-1;480;66;21;2;19;.905;3600000;0
1174;142583;675;38;29;5;24;.828;3600000;0
1175;170042;481;81;36;2;34;.944;3573000;0
1175;176765;476;73;17;1;16;.941;3600000;0
1175;190235;481;0;0;0;0;.00nan;0;0
1175;67276;476;0;0;0;0;.00nan;0;0
1300;170042;481;77;42;4;38;.905;3600000;0
1300;176765;476;44;23;5;18;.783;3571000;0
1300;190235;481;0;0;0;0;.00nan;0;0
1300;67276;476;0;0;0;0;.00nan;0;0
1359;170042;481;51;37;5;32;.865;4111000;0
1359;176765;476;52;30;4;26;.867;4111000;0
1359;190235;481;0;0;0;0;.00nan;0;0
1359;67276;476;0;0;0;0;.00nan;0;0
1452;-1;480;0;0;0;0;.00nan;0;0
1452;-1;480;68;19;1;18;.947;3600000;0
1452;66551;472;0;0;0;0;.00nan;0;0
1452;71297;472;51;25;3;22;.880;3600000;0
1453;173823;682;0;0;0;0;.00nan;0;0
1453;176765;476;86;32;1;31;.969;3600000;0
1453;67276;476;0;0;0;0;.00nan;0;0
1453;146184;682;35;20;4;16;.800;3600000;0
1454;-1;480;0;0;0;0;.00nan;0;0
1454;-1;480;62;28;3;25;.893;3543000;0
1454;66551;472;0;0;0;0;.00nan;0;0
1454;71297;472;80;32;2;30;.938;3600000;0
1455;173823;682;0;0;0;0;.00nan;0;0
1455;176765;476;85;36;2;34;.944;3577000;0
1455;67276;476;0;0;0;0;.00nan;0;0
1455;146184;682;86;27;1;26;.963;3600000;0
1456;-1;480;0;0;0;0;.00nan;0;0
1456;-1;480;100;25;0;25;1.000;3600000;0
1456;66551;472;0;0;0;0;.00nan;0;0
1456;71297;472;75;33;2;31;.939;3554000;0
1457;173823;682;0;0;0;0;.00nan;0;0
1457;176765;476;51;30;4;26;.867;3579000;0
1457;67276;476;0;0;0;0;.00nan;0;0
1457;146184;682;75;25;2;23;.920;3600000;0
1458;-1;480;0;0;0;0;.00nan;0;0
1458;-1;480;42;35;6;29;.829;3545000;0
1458;66551;472;0;0;0;0;.00nan;0;0
1458;71297;472;44;30;5;25;.833;3600000;0
1459;173823;682;0;0;0;0;.00nan;0;0
1459;176765;476;81;25;1;24;.960;3600000;0
1459;67276;476;0;0;0;0;.00nan;0;0
1459;146184;682;49;29;4;25;.862;3600000;0
1618;-1;480;0;0;0;0;.00nan;0;0
1618;-1;480;55;17;2;15;.882;3531000;0
1618;66551;472;0;0;0;0;.00nan;0;0
1618;71297;472;85;23;0;23;1.000;3600000;0
1619;173823;682;0;0;0;0;.00nan;0;0
1619;176765;476;100;28;0;28;1.000;3600000;0
1619;67276;476;0;0;0;0;.00nan;0;0
1619;146184;682;56;30;4;26;.867;3600000;0
1689;-1;480;0;0;0;0;.00nan;0;0
1689;-1;480;68;25;2;23;.920;3600000;0
1689;66551;472;0;0;0;0;.00nan;0;0
1689;71297;472;79;36;3;33;.917;3543000;0
1690;173823;682;0;0;0;0;.00nan;0;0
1690;176765;476;64;37;4;33;.892;3549000;0
1690;67276;476;0;0;0;0;.00nan;0;0
1690;146184;682;76;30;3;27;.900;3600000;0
1803;-1;480;0;0;0;0;.00nan;0;0
1803;-1;480;41;25;4;21;.840;3600000;0
1803;66551;472;0;0;0;0;.00nan;0;0
1803;71297;472;65;30;3;27;.900;3600000;0
1804;173823;682;0;0;0;0;.00nan;0;0
1804;176765;476;63;34;4;30;.882;3600000;0
1804;67276;476;0;0;0;0;.00nan;0;0
1804;146184;682;82;26;2;24;.923;3600000;0
1846;173823;682;0;0;0;0;.00nan;0;0
1846;66551;472;0;0;0;0;.00nan;0;0
1846;71297;472;71;58;5;53;.914;6465000;0
1846;146184;682;58;38;4;34;.895;6465000;0
1847;173823;682;0;0;0;0;.00nan;0;0
1847;66551;472;0;0;0;0;.00nan;0;0
1847;71297;472;81;31;1;30;.968;3600000;0
1847;146184;682;54;25;3;22;.880;3529000;0
1848;173823;682;0;0;0;0;.00nan;0;0
1848;66551;472;0;0;0;0;.00nan;0;0
1848;71297;472;88;83;4;79;.952;7548000;0
1848;146184;682;75;51;3;48;.941;7548000;0
1849;173823;682;0;0;0;0;.00nan;0;0
1849;66551;472;0;0;0;0;.00nan;0;0
1849;71297;472;93;44;3;41;.932;3600000;0
1849;146184;682;99;21;0;21;1.000;3600000;0
1948;173823;682;0;0;0;0;.00nan;0;0
1948;66551;472;0;0;0;0;.00nan;0;0
1948;71297;472;87;34;2;32;.941;3600000;0
1948;146184;682;95;32;1;31;.969;3600000;0
37687;3075;505;0;0;0;0;.00nan;0;0
37687;165611;4636;0;0;0;0;.00nan;0;0
37687;170536;4636;55;29;4;25;.862;3537000;0
37687;94508;505;84;38;2;36;.947;3600000;0
37688;504;496;99;31;0;31;1.000;3600000;0
37688;197409;502;47;31;4;27;.871;3600000;0
37688;148829;502;0;0;0;0;.00nan;0;0
37688;158630;496;0;0;0;0;.00nan;0;0
37689;185442;2591;27;24;5;19;.792;2168000;0
37689;71485;499;64;22;2;20;.909;3600000;0
37689;94018;2591;54;17;2;15;.882;1432000;0
37689;148652;499;0;0;0;0;.00nan;0;0
37690;-1;504;54;25;3;22;.880;3558000;0
37690;-1;504;0;0;0;0;.00nan;0;0
37690;196715;497;0;0;0;0;.00nan;0;0
37690;78596;497;98;34;1;33;.971;3600000;0
37691;170543;503;75;28;1;27;.964;3900000;0
37691;170547;500;0;0;0;0;.00nan;0;0
37691;175593;500;63;16;1;15;.938;3900000;0
37691;94134;503;0;0;0;0;.00nan;0;0
37692;-1;495;0;0;0;0;.00nan;0;0
37692;189433;498;41;23;4;19;.826;3553000;0
37692;196374;498;0;0;0;0;.00nan;0;0
37692;148508;495;61;26;3;23;.885;3600000;0
37693;-1;504;64;35;4;31;.886;3600000;0
37693;-1;504;0;0;0;0;.00nan;0;0
37693;185442;2591;0;0;0;0;.00nan;0;0
37693;94018;2591;64;23;2;21;.913;3600000;0
37694;170547;500;59;20;2;18;.900;3600000;0
37694;175593;500;0;0;0;0;.00nan;0;0
37694;196715;497;42;4;1;3;.750;255000;0
37694;78596;497;33;26;6;20;.769;3345000;0
37695;-1;495;0;0;0;0;.00nan;0;0
37695;170543;503;64;38;4;34;.895;3600000;0
37695;94134;503;0;0;0;0;.00nan;0;0
37695;148508;495;63;17;1;16;.941;3600000;0
37696;189433;498;82;28;1;27;.964;3600000;0
37696;196374;498;0;0;0;0;.00nan;0;0
37696;197409;502;0;0;0;0;.00nan;0;0
37696;148829;502;62;22;2;20;.909;3552000;0
37697;3075;505;67;39;5;34;.872;3600000;0
37697;71485;499;93;21;0;21;1.000;3600000;0
37697;94508;505;0;0;0;0;.00nan;0;0
37697;148652;499;0;0;0;0;.00nan;0;0
37698;504;496;87;33;1;32;.970;3600000;0
37698;165611;4636;49;23;4;19;.826;3600000;0
37698;170536;4636;0;0;0;0;.00nan;0;0
37698;158630;496;0;0;0;0;.00nan;0;0
37699;-1;504;95;36;2;34;.944;3900000;0
37699;-1;504;0;0;0;0;.00nan;0;0
37699;185442;2591;65;23;2;21;.913;3900000;0
37699;94018;2591;0;0;0;0;.00nan;0;0
37700;170547;500;80;29;1;28;.966;3861000;0
37700;175593;500;0;0;0;0;.00nan;0;0
37700;196715;497;0;0;0;0;.00nan;0;0
37700;78596;497;84;33;2;31;.939;3861000;0
37701;-1;495;71;20;1;19;.950;3600000;0
37701;170543;503;82;35;2;33;.943;3579000;0
37701;94134;503;0;0;0;0;.00nan;0;0
37701;148508;495;0;0;0;0;.00nan;0;0
37702;189433;498;90;30;1;29;.967;3600000;0
37702;196374;498;0;0;0;0;.00nan;0;0
37702;197409;502;0;0;0;0;.00nan;0;0
37702;148829;502;83;33;2;31;.939;3584000;0
37703;3075;505;0;0;0;0;.00nan;0;0
37703;71485;499;41;25;4;21;.840;3600000;0
37703;94508;505;62;23;2;21;.913;3600000;0
37703;148652;499;0;0;0;0;.00nan;0;0
37704;504;496;85;31;2;29;.935;3585000;0
37704;165611;4636;100;31;0;31;1.000;3600000;0
37704;170536;4636;0;0;0;0;.00nan;0;0
37704;158630;496;0;0;0;0;.00nan;0;0
37705;504;496;100;38;0;38;1.000;3600000;0
37705;71485;499;60;34;4;30;.882;3600000;0
37705;148652;499;0;0;0;0;.00nan;0;0
37705;158630;496;0;0;0;0;.00nan;0;0
37706;165611;4636;85;30;1;29;.967;3600000;0
37706;189433;498;0;0;0;0;.00nan;0;0
37706;170536;4636;0;0;0;0;.00nan;0;0
37706;196374;498;57;23;2;21;.913;3548000;0
37707;3075;505;67;28;4;24;.857;3600000;0
37707;185442;2591;97;31;1;30;.968;3600000;0
37707;94018;2591;0;0;0;0;.00nan;0;0
37707;94508;505;0;0;0;0;.00nan;0;0
37708;-1;495;0;0;0;0;.00nan;0;0
37708;196715;497;0;0;0;0;.00nan;0;0
37708;78596;497;94;34;1;33;.971;3600000;0
37708;148508;495;57;24;3;21;.875;3532000;0
37709;170547;500;56;20;2;18;.900;3600000;0
37709;175593;500;0;0;0;0;.00nan;0;0
37709;-1;504;57;25;3;22;.880;3558000;0
37709;-1;504;0;0;0;0;.00nan;0;0
37710;170543;503;91;39;3;36;.923;3600000;0
37710;197409;502;0;0;0;0;.00nan;0;0
37710;94134;503;0;0;0;0;.00nan;0;0
37710;148829;502;62;18;2;16;.889;3600000;0
37711;504;496;79;38;2;36;.947;3591000;0
37711;71485;499;94;24;0;24;1.000;3600000;0
37711;148652;499;0;0;0;0;.00nan;0;0
37711;158630;496;0;0;0;0;.00nan;0;0
37712;165611;4636;92;34;1;33;.971;3900000;0
37712;189433;498;71;25;1;24;.960;3900000;0
37712;170536;4636;0;0;0;0;.00nan;0;0
37712;196374;498;0;0;0;0;.00nan;0;0
37713;3075;505;53;18;2;16;.889;3563000;0
37713;185442;2591;99;38;1;37;.974;3600000;0
37713;94018;2591;0;0;0;0;.00nan;0;0
37713;94508;505;0;0;0;0;.00nan;0;0
37714;-1;495;0;0;0;0;.00nan;0;0
37714;196715;497;0;0;0;0;.00nan;0;0
37714;78596;497;75;24;1;23;.958;3600000;0
37714;148508;495;66;26;2;24;.923;3556000;0
37715;170547;500;70;18;1;17;.944;3600000;0
37715;175593;500;0;0;0;0;.00nan;0;0
37715;-1;504;0;0;0;0;.00nan;0;0
37715;-1;504;54;35;5;30;.857;3600000;0
37716;170543;503;81;39;3;36;.923;3900000;0
37716;197409;502;0;0;0;0;.00nan;0;0
37716;94134;503;0;0;0;0;.00nan;0;0
37716;148829;502;62;25;3;22;.880;3900000;0
37717;196715;497;0;0;0;0;.00nan;0;0
37717;197409;502;0;0;0;0;.00nan;0;0
37717;63529;502;58;35;5;30;.857;3517000;0
37717;78596;497;53;26;3;23;.885;3600000;0
37718;165611;4636;71;21;2;19;.905;3600000;0
37718;170536;4636;0;0;0;0;.00nan;0;0
37718;170543;503;57;25;3;22;.880;3557000;0
37718;94134;503;0;0;0;0;.00nan;0;0
37719;-1;495;100;31;0;31;1.000;3600000;0
37719;-1;504;82;30;2;28;.933;3545000;0
37719;-1;504;0;0;0;0;.00nan;0;0
37719;148508;495;0;0;0;0;.00nan;0;0
37720;504;496;99;37;1;36;.973;3600000;0
37720;3075;505;65;23;2;21;.913;3586000;0
37720;94508;505;0;0;0;0;.00nan;0;0
37720;158630;496;0;0;0;0;.00nan;0;0
37721;170547;500;0;0;0;0;.00nan;0;0
37721;175593;500;58;20;3;17;.850;3600000;0
37721;185442;2591;68;36;4;32;.889;3572000;0
37721;94018;2591;0;0;0;0;.00nan;0;0
37722;189433;498;69;27;2;25;.926;3600000;0
37722;196374;498;0;0;0;0;.00nan;0;0
37722;71485;499;0;0;0;0;.00nan;0;0
37722;148652;499;72;36;3;33;.917;3550000;0
37723;196715;497;0;0;0;0;.00nan;0;0
37723;197409;502;0;0;0;0;.00nan;0;0
37723;63529;502;85;26;1;25;.962;3600000;0
37723;78596;497;67;23;3;20;.870;3548000;0
37724;165611;4636;0;0;0;0;.00nan;0;0
37724;170536;4636;46;27;4;23;.852;3600000;0
37724;170543;503;100;25;0;25;1.000;3600000;0
37724;94134;503;0;0;0;0;.00nan;0;0
37725;-1;495;69;14;1;13;.929;3600000;0
37725;-1;504;71;40;5;35;.875;3600000;0
37725;-1;504;0;0;0;0;.00nan;0;0
37725;148508;495;0;0;0;0;.00nan;0;0
37726;504;496;98;46;1;45;.978;3600000;0
37726;3075;505;0;0;0;0;.00nan;0;0
37726;94508;505;82;16;0;16;1.000;3600000;0
37726;158630;496;0;0;0;0;.00nan;0;0
37727;170547;500;0;0;0;0;.00nan;0;0
37727;175593;500;56;26;3;23;.885;3600000;0
37727;185442;2591;45;26;5;21;.808;3579000;0
37727;94018;2591;0;0;0;0;.00nan;0;0
37728;189433;498;78;37;3;34;.919;3544000;0
37728;196374;498;0;0;0;0;.00nan;0;0
37728;71485;499;90;37;2;35;.946;3600000;0
37728;148652;499;0;0;0;0;.00nan;0;0
37729;-1;504;74;32;2;30;.938;3830000;0
37729;-1;504;0;0;0;0;.00nan;0;0
37729;197409;502;0;0;0;0;.00nan;0;0
37729;63529;502;87;29;1;28;.966;3830000;0
37730;170543;503;58;30;3;27;.900;3900000;0
37730;71485;499;76;39;3;36;.923;3900000;0
37730;94134;503;0;0;0;0;.00nan;0;0
37730;148652;499;0;0;0;0;.00nan;0;0
37731;3075;505;68;38;4;34;.895;3614000;0
37731;189433;498;44;20;3;17;.850;3614000;0
37731;196374;498;0;0;0;0;.00nan;0;0
37731;94508;505;0;0;0;0;.00nan;0;0
37732;165611;4636;39;20;4;16;.800;3600000;0
37732;170536;4636;0;0;0;0;.00nan;0;0
37732;196715;497;0;0;0;0;.00nan;0;0
37732;78596;497;80;23;1;22;.957;3600000;0
37733;-1;495;0;0;0;0;.00nan;0;0
37733;170547;500;76;30;1;29;.967;3900000;0
37733;175593;500;0;0;0;0;.00nan;0;0
37733;148508;495;100;41;1;40;.976;3900000;0
37734;504;496;0;0;0;0;.00nan;0;0
37734;185442;2591;0;0;0;0;.00nan;0;0
37734;94018;2591;74;34;3;31;.912;3600000;0
37734;158630;496;95;41;2;39;.951;3600000;0
37735;-1;504;0;0;0;0;.00nan;0;0
37735;-1;504;79;28;1;27;.964;3600000;0
37735;197409;502;0;0;0;0;.00nan;0;0
37735;63529;502;64;22;2;20;.909;3559000;0
37736;170543;503;0;0;0;0;.00nan;0;0
37736;71485;499;69;21;3;18;.857;3636000;0
37736;94134;503;71;36;4;32;.889;3636000;0
37736;148652;499;0;0;0;0;.00nan;0;0
37737;3075;505;0;0;0;0;.00nan;0;0
37737;189433;498;0;0;0;0;.00nan;0;0
37737;196374;498;69;20;1;19;.950;3600000;0
37737;94508;505;43;27;4;23;.852;3600000;0
37738;165611;4636;58;37;4;33;.892;3600000;0
37738;170536;4636;0;0;0;0;.00nan;0;0
37738;196715;497;0;0;0;0;.00nan;0;0
37738;78596;497;75;22;1;21;.955;3600000;0
37739;-1;495;77;28;2;26;.929;3600000;0
37739;170547;500;86;24;1;23;.958;3600000;0
37739;175593;500;0;0;0;0;.00nan;0;0
37739;148508;495;0;0;0;0;.00nan;0;0
37740;504;496;100;31;0;31;1.000;3600000;0
37740;185442;2591;75;26;2;24;.923;3600000;0
37740;94018;2591;0;0;0;0;.00nan;0;0
37740;158630;496;0;0;0;0;.00nan;0;0
37741;504;496;77;25;2;23;.920;3583000;0
37741;189433;498;0;0;0;0;.00nan;0;0
37741;196374;498;97;25;0;25;1.000;3600000;0
37741;158630;496;0;0;0;0;.00nan;0;0
37742;170547;500;0;0;0;0;.00nan;0;0
37742;175593;500;63;24;2;22;.917;3900000;0
37742;197409;502;73;33;2;31;.939;3900000;0
37742;63529;502;0;0;0;0;.00nan;0;0
37743;165611;4636;81;32;1;31;.969;3900000;0
37743;170536;4636;0;0;0;0;.00nan;0;0
37743;-1;504;87;32;1;31;.969;3900000;0
37743;-1;504;0;0;0;0;.00nan;0;0
37744;3075;505;0;0;0;0;.00nan;0;0
37744;170543;503;100;27;0;27;1.000;3600000;0
37744;94134;503;0;0;0;0;.00nan;0;0
37744;94508;505;60;29;3;26;.897;3600000;0
37745;196715;497;0;0;0;0;.00nan;0;0
37745;71485;499;81;24;1;23;.958;3824000;0
37745;78596;497;70;28;2;26;.929;3824000;0
37745;148652;499;0;0;0;0;.00nan;0;0
37746;-1;495;0;0;0;0;.00nan;0;0
37746;185442;2591;53;29;4;25;.862;3600000;0
37746;94018;2591;0;0;0;0;.00nan;0;0
37746;148508;495;50;30;5;25;.833;3544000;0
37747;504;496;49;35;5;30;.857;3600000;0
37747;189433;498;0;0;0;0;.00nan;0;0
37747;196374;498;58;19;2;17;.895;3600000;0
37747;158630;496;0;0;0;0;.00nan;0;0
37748;170547;500;88;34;1;33;.971;3600000;0
37748;175593;500;0;0;0;0;.00nan;0;0
37748;197409;502;0;0;0;0;.00nan;0;0
37748;63529;502;98;19;0;19;1.000;3600000;0
37749;165611;4636;100;19;0;19;1.000;3600000;0
37749;170536;4636;0;0;0;0;.00nan;0;0
37749;-1;504;63;21;2;19;.905;3567000;0
37749;-1;504;0;0;0;0;.00nan;0;0
37750;3075;505;62;23;2;21;.913;3545000;0
37750;170543;503;91;31;1;30;.968;3600000;0
37750;94134;503;0;0;0;0;.00nan;0;0
37750;94508;505;0;0;0;0;.00nan;0;0
37751;196715;497;0;0;0;0;.00nan;0;0
37751;71485;499;0;0;0;0;.00nan;0;0
37751;78596;497;55;26;4;22;.846;3788000;0
37751;148652;499;61;22;3;19;.864;3788000;0
37752;-1;495;61;28;3;25;.893;3566000;0
37752;185442;2591;88;30;1;29;.967;3600000;0
37752;94018;2591;0;0;0;0;.00nan;0;0
37752;148508;495;0;0;0;0;.00nan;0;0
37753;3075;505;0;0;0;0;.00nan;0;0
37753;196715;497;0;0;0;0;.00nan;0;0
37753;78596;497;100;30;0;30;1.000;3600000;0
37753;94508;505;78;31;2;29;.935;3521000;0
37754;504;496;91;21;0;21;1.000;3600000;0
37754;170543;503;35;12;3;9;.750;596000;0
37754;94134;503;67;16;0;16;1.000;3004000;0
37754;158630;496;0;0;0;0;.00nan;0;0
37755;-1;495;0;0;0;0;.00nan;0;0
37755;197409;502;0;0;0;0;.00nan;0;0
37755;63529;502;93;34;2;32;.941;3900000;0
37755;148508;495;79;40;2;38;.950;3900000;0
37756;-1;504;0;0;0;0;.00nan;0;0
37756;-1;504;52;28;3;25;.893;3572000;0
37756;71485;499;62;23;2;21;.913;3600000;0
37756;148652;499;0;0;0;0;.00nan;0;0
37757;165611;4636;65;33;4;29;.879;3545000;0
37757;170536;4636;0;0;0;0;.00nan;0;0
37757;170547;500;64;29;3;26;.897;3600000;0
37757;175593;500;0;0;0;0;.00nan;0;0
37758;189433;498;0;0;0;0;.00nan;0;0
37758;196374;498;100;31;0;31;1.000;3600000;0
37758;185442;2591;91;53;4;49;.925;3600000;0
37758;94018;2591;0;0;0;0;.00nan;0;0
37759;3075;505;84;27;1;26;.963;3600000;0
37759;196715;497;0;0;0;0;.00nan;0;0
37759;78596;497;70;32;3;29;.906;3527000;0
37759;94508;505;0;0;0;0;.00nan;0;0
37760;504;496;100;26;0;26;1.000;3600000;0
37760;170543;503;81;29;2;27;.931;3600000;0
37760;94134;503;0;0;0;0;.00nan;0;0
37760;158630;496;0;0;0;0;.00nan;0;0
37761;-1;495;83;25;1;24;.960;3600000;0
37761;197409;502;0;0;0;0;.00nan;0;0
37761;63529;502;71;25;2;23;.920;3553000;0
37761;148508;495;0;0;0;0;.00nan;0;0
37762;-1;504;64;34;4;30;.882;3600000;0
37762;-1;504;0;0;0;0;.00nan;0;0
37762;71485;499;70;19;1;18;.947;3600000;0
37762;148652;499;0;0;0;0;.00nan;0;0
37763;165611;4636;97;55;3;52;.945;3580000;0
37763;170536;4636;0;0;0;0;.00nan;0;0
37763;170547;500;59;9;1;8;.889;3600000;0
37763;175593;500;0;0;0;0;.00nan;0;0
37764;189433;498;0;0;0;0;.00nan;0;0
37764;196374;498;57;21;3;18;.857;3600000;0
37764;185442;2591;90;32;1;31;.969;3600000;0
37764;94018;2591;0;0;0;0;.00nan;0;0
37765;504;496;72;25;2;23;.920;3581000;0
37765;196715;497;0;0;0;0;.00nan;0;0
37765;78596;497;67;20;1;19;.950;3600000;0
37765;158630;496;0;0;0;0;.00nan;0;0
37766;170547;500;77;29;2;27;.931;3853000;0
37766;175593;500;0;0;0;0;.00nan;0;0
37766;71485;499;52;23;3;20;.870;3853000;0
37766;148652;499;0;0;0;0;.00nan;0;0
37767;165611;4636;61;35;4;31;.886;3600000;0
37767;-1;495;0;0;0;0;.00nan;0;0
37767;170536;4636;0;0;0;0;.00nan;0;0
37767;148508;495;85;29;1;28;.966;3600000;0
37768;3075;505;0;0;0;0;.00nan;0;0
37768;-1;504;62;35;4;31;.886;3595000;0
37768;-1;504;0;0;0;0;.00nan;0;0
37768;94508;505;51;20;3;17;.850;3600000;0
37769;185442;2591;99;39;1;38;.974;3600000;0
37769;197409;502;0;0;0;0;.00nan;0;0
37769;63529;502;53;28;3;25;.893;3538000;0
37769;94018;2591;0;0;0;0;.00nan;0;0
37770;189433;498;60;21;2;19;.905;3900000;0
37770;170543;503;87;41;2;39;.951;3900000;0
37770;196374;498;0;0;0;0;.00nan;0;0
37770;94134;503;0;0;0;0;.00nan;0;0
37771;504;496;0;0;0;0;.00nan;0;0
37771;196715;497;0;0;0;0;.00nan;0;0
37771;78596;497;45;17;3;14;.824;3556000;0
37771;158630;496;88;36;2;34;.944;3600000;0
37772;170547;500;75;32;2;30;.938;3526000;0
37772;175593;500;0;0;0;0;.00nan;0;0
37772;71485;499;85;17;0;17;1.000;3600000;0
37772;148652;499;0;0;0;0;.00nan;0;0
37773;165611;4636;0;0;0;0;.00nan;0;0
37773;-1;495;61;25;3;22;.880;3600000;0
37773;170536;4636;37;24;4;20;.833;3580000;0
37773;148508;495;0;0;0;0;.00nan;0;0
37774;3075;505;100;29;0;29;1.000;3600000;0
37774;-1;504;68;33;4;29;.879;3600000;0
37774;-1;504;0;0;0;0;.00nan;0;0
37774;94508;505;0;0;0;0;.00nan;0;0
37775;185442;2591;59;34;4;30;.882;3600000;0
37775;197409;502;0;0;0;0;.00nan;0;0
37775;63529;502;79;30;2;28;.933;3600000;0
37775;94018;2591;0;0;0;0;.00nan;0;0
37776;189433;498;0;0;0;0;.00nan;0;0
37776;170543;503;99;52;3;49;.942;3900000;0
37776;196374;498;33;14;3;11;.786;3900000;0
37776;94134;503;0;0;0;0;.00nan;0;0
37777;189433;498;52;15;2;13;.867;3600000;0
37777;196374;498;0;0;0;0;.00nan;0;0
37777;196715;497;0;0;0;0;.00nan;0;0
37777;78596;497;46;35;5;30;.857;3600000;0
37778;504;496;50;20;3;17;.850;3581000;0
37778;-1;504;78;31;2;29;.935;3600000;0
37778;-1;504;0;0;0;0;.00nan;0;0
37778;158630;496;0;0;0;0;.00nan;0;0
37779;3075;505;0;0;0;0;.00nan;0;0
37779;170547;500;74;32;2;30;.938;3600000;0
37779;175593;500;0;0;0;0;.00nan;0;0
37779;94508;505;63;30;3;27;.900;3554000;0
37780;165611;4636;44;16;3;13;.813;3600000;0
37780;170536;4636;0;0;0;0;.00nan;0;0
37780;197409;502;0;0;0;0;.00nan;0;0
37780;63529;502;95;22;0;22;1.000;3600000;0
37781;-1;495;0;0;0;0;.00nan;0;0
37781;71485;499;83;35;2;33;.943;3598000;0
37781;148508;495;83;30;1;29;.967;3600000;0
37781;148652;499;0;0;0;0;.00nan;0;0
37782;170543;503;94;37;2;35;.946;3600000;0
37782;185442;2591;45;23;4;19;.826;3193000;0
37782;94018;2591;48;0;0;0;.00nan;379000;0
37782;94134;503;0;0;0;0;.00nan;0;0
37783;189433;498;0;0;0;0;.00nan;0;0
37783;196374;498;90;20;0;20;1.000;3600000;0
37783;196715;497;0;0;0;0;.00nan;0;0
37783;78596;497;64;34;4;30;.882;3600000;0
37784;504;496;69;32;3;29;.906;3600000;0
37784;-1;504;20;10;4;6;.600;949000;0
37784;-1;504;95;28;1;27;.964;2633000;0
37784;158630;496;0;0;0;0;.00nan;0;0
37785;3075;505;69;30;2;28;.933;3600000;0
37785;170547;500;97;31;1;30;.968;3600000;0
37785;175593;500;0;0;0;0;.00nan;0;0
37785;94508;505;0;0;0;0;.00nan;0;0
37786;165611;4636;79;40;3;37;.925;3541000;0
37786;170536;4636;0;0;0;0;.00nan;0;0
37786;197409;502;0;0;0;0;.00nan;0;0
37786;63529;502;84;23;1;22;.957;3600000;0
37787;-1;495;63;32;3;29;.906;3600000;0
37787;71485;499;100;28;0;28;1.000;3600000;0
37787;148508;495;0;0;0;0;.00nan;0;0
37787;148652;499;0;0;0;0;.00nan;0;0
37788;170543;503;69;44;5;39;.886;3600000;0
37788;185442;2591;81;22;1;21;.955;3600000;0
37788;94018;2591;0;0;0;0;.00nan;0;0
37788;94134;503;0;0;0;0;.00nan;0;0
37789;3075;505;0;0;0;0;.00nan;0;0
37789;-1;495;0;0;0;0;.00nan;0;0
37789;94508;505;59;28;3;25;.893;3600000;0
37789;148508;495;84;16;0;16;1.000;3600000;0
37790;197409;502;0;0;0;0;.00nan;0;0
37790;63529;502;93;43;2;41;.953;3600000;0
37790;71485;499;76;37;3;34;.919;3564000;0
37790;148652;499;0;0;0;0;.00nan;0;0
37791;165611;4636;78;23;1;22;.957;3600000;0
37791;170536;4636;0;0;0;0;.00nan;0;0
37791;185442;2591;68;27;2;25;.926;3600000;0
37791;94018;2591;0;0;0;0;.00nan;0;0
37792;504;496;0;0;0;0;.00nan;0;0
37792;170547;500;76;29;2;27;.931;3811000;0
37792;175593;500;0;0;0;0;.00nan;0;0
37792;158630;496;100;39;1;38;.974;3811000;0
37793;170543;503;0;0;0;0;.00nan;0;0
37793;196715;497;0;0;0;0;.00nan;0;0
37793;78596;497;84;15;0;15;1.000;3600000;0
37793;94134;503;82;29;1;28;.966;3543000;0
37794;189433;498;0;0;0;0;.00nan;0;0
37794;-1;504;78;38;2;36;.947;3600000;0
37794;-1;504;0;0;0;0;.00nan;0;0
37794;196374;498;83;16;0;16;1.000;3600000;0
37795;3075;505;59;24;2;22;.917;3600000;0
37795;-1;495;0;0;0;0;.00nan;0;0
37795;94508;505;0;0;0;0;.00nan;0;0
37795;148508;495;51;33;5;28;.848;3600000;0
37796;197409;502;0;0;0;0;.00nan;0;0
37796;63529;502;80;27;1;26;.963;3900000;0
37796;71485;499;0;0;0;0;.00nan;0;0
37796;148652;499;77;25;1;24;.960;3900000;0
37797;165611;4636;55;34;5;29;.853;3600000;0
37797;170536;4636;0;0;0;0;.00nan;0;0
37797;185442;2591;91;19;0;19;1.000;3600000;0
37797;94018;2591;0;0;0;0;.00nan;0;0
37798;504;496;91;38;3;35;.921;3734000;0
37798;170547;500;65;21;2;19;.905;3734000;0
37798;175593;500;0;0;0;0;.00nan;0;0
37798;158630;496;0;0;0;0;.00nan;0;0
37799;170543;503;60;36;4;32;.889;3600000;0
37799;196715;497;0;0;0;0;.00nan;0;0
37799;78596;497;82;27;1;26;.963;3600000;0
37799;94134;503;0;0;0;0;.00nan;0;0
37800;189433;498;59;13;1;12;.923;3900000;0
37800;-1;504;87;32;1;31;.969;3900000;0
37800;-1;504;0;0;0;0;.00nan;0;0
37800;196374;498;0;0;0;0;.00nan;0;0
37801;170543;503;66;24;2;22;.917;3600000;0
37801;-1;504;0;0;0;0;.00nan;0;0
37801;-1;504;72;35;3;32;.914;3600000;0
37801;94134;503;0;0;0;0;.00nan;0;0
37802;189433;498;87;34;2;32;.941;3900000;0
37802;170547;500;0;0;0;0;.00nan;0;0
37802;175593;500;68;29;2;27;.931;3900000;0
37802;196374;498;0;0;0;0;.00nan;0;0
37803;185442;2591;98;39;2;37;.949;3588000;0
37803;196715;497;0;0;0;0;.00nan;0;0
37803;78596;497;93;19;0;19;1.000;3600000;0
37803;94018;2591;0;0;0;0;.00nan;0;0
37804;3075;505;55;37;4;33;.892;3600000;0
37804;197409;502;63;12;1;11;.917;3600000;0
37804;63529;502;0;0;0;0;.00nan;0;0
37804;94508;505;0;0;0;0;.00nan;0;0
37805;165611;4636;80;28;1;27;.964;3600000;0
37805;170536;4636;0;0;0;0;.00nan;0;0
37805;71485;499;75;26;2;24;.923;3549000;0
37805;148652;499;0;0;0;0;.00nan;0;0
37806;504;496;64;30;3;27;.900;3594000;0
37806;-1;495;77;31;2;29;.935;3600000;0
37806;148508;495;0;0;0;0;.00nan;0;0
37806;158630;496;0;0;0;0;.00nan;0;0
37807;170543;503;94;21;0;21;1.000;3600000;0
37807;-1;504;76;31;1;30;.968;3549000;0
37807;-1;504;0;0;0;0;.00nan;0;0
37807;94134;503;0;0;0;0;.00nan;0;0
37808;189433;498;80;26;1;25;.962;3600000;0
37808;170547;500;86;34;2;32;.941;3561000;0
37808;175593;500;0;0;0;0;.00nan;0;0
37808;196374;498;0;0;0;0;.00nan;0;0
37809;185442;2591;86;30;2;28;.933;3600000;0
37809;196715;497;0;0;0;0;.00nan;0;0
37809;78596;497;78;37;3;34;.919;3598000;0
37809;94018;2591;0;0;0;0;.00nan;0;0
37810;3075;505;66;25;2;23;.920;3532000;0
37810;197409;502;0;0;0;0;.00nan;0;0
37810;63529;502;93;20;0;20;1.000;3600000;0
37810;94508;505;0;0;0;0;.00nan;0;0
37811;165611;4636;61;36;3;33;.917;3600000;0
37811;170536;4636;0;0;0;0;.00nan;0;0
37811;71485;499;100;23;0;23;1.000;3600000;0
37811;148652;499;0;0;0;0;.00nan;0;0
37812;504;496;87;33;2;31;.939;3900000;0
37812;-1;495;0;0;0;0;.00nan;0;0
37812;148508;495;63;24;2;22;.917;3900000;0
37812;158630;496;0;0;0;0;.00nan;0;0
37813;-1;504;64;21;1;20;.952;3900000;0
37813;-1;504;0;0;0;0;.00nan;0;0
37813;196715;497;0;0;0;0;.00nan;0;0
37813;78596;497;77;22;1;21;.955;3900000;0
37814;170543;503;96;43;1;42;.977;3900000;0
37814;170547;500;75;19;1;18;.947;3900000;0
37814;175593;500;0;0;0;0;.00nan;0;0
37814;94134;503;0;0;0;0;.00nan;0;0
37815;-1;495;77;37;3;34;.919;3900000;0
37815;189433;498;60;27;3;24;.889;3900000;0
37815;196374;498;0;0;0;0;.00nan;0;0
37815;148508;495;0;0;0;0;.00nan;0;0
37816;504;496;85;37;3;34;.919;3600000;0
37816;197409;502;0;0;0;0;.00nan;0;0
37816;63529;502;37;18;4;14;.778;3563000;0
37816;158630;496;0;0;0;0;.00nan;0;0
37817;185442;2591;64;25;2;23;.920;3581000;0
37817;71485;499;78;26;1;25;.962;3600000;0
37817;94018;2591;0;0;0;0;.00nan;0;0
37817;148652;499;0;0;0;0;.00nan;0;0
37818;3075;505;86;17;0;17;1.000;3600000;0
37818;165611;4636;89;33;1;32;.970;3600000;0
37818;170536;4636;0;0;0;0;.00nan;0;0
37818;94508;505;0;0;0;0;.00nan;0;0
37819;-1;504;86;33;1;32;.970;3900000;0
37819;-1;504;0;0;0;0;.00nan;0;0
37819;196715;497;0;0;0;0;.00nan;0;0
37819;78596;497;79;25;1;24;.960;3900000;0
37820;170543;503;58;31;4;27;.871;3816000;0
37820;170547;500;0;0;0;0;.00nan;0;0
37820;175593;500;74;35;3;32;.914;3816000;0
37820;94134;503;0;0;0;0;.00nan;0;0
37821;-1;495;0;0;0;0;.00nan;0;0
37821;189433;498;0;0;0;0;.00nan;0;0
37821;196374;498;76;31;2;29;.935;3631000;0
37821;148508;495;64;25;3;22;.880;3631000;0
37822;504;496;59;35;4;31;.886;3555000;0
37822;197409;502;0;0;0;0;.00nan;0;0
37822;63529;502;64;23;2;21;.913;3600000;0
37822;158630;496;0;0;0;0;.00nan;0;0
37823;185442;2591;72;39;5;34;.872;3874000;0
37823;71485;499;0;0;0;0;.00nan;0;0
37823;94018;2591;0;0;0;0;.00nan;0;0
37823;148652;499;43;22;4;18;.818;3874000;0
37824;3075;505;75;23;1;22;.957;3600000;0
37824;165611;4636;77;30;2;28;.933;3600000;0
37824;170536;4636;0;0;0;0;.00nan;0;0
37824;94508;505;0;0;0;0;.00nan;0;0
37825;3075;505;57;33;4;29;.879;3600000;0
37825;71485;499;61;14;1;13;.929;3600000;0
37825;94508;505;0;0;0;0;.00nan;0;0
37825;148652;499;0;0;0;0;.00nan;0;0
37826;504;496;91;14;0;14;1.000;3600000;0
37826;165611;4636;68;30;3;27;.900;3600000;0
37826;170536;4636;0;0;0;0;.00nan;0;0
37826;158630;496;0;0;0;0;.00nan;0;0
37827;189433;498;79;40;3;37;.925;3600000;0
37827;196374;498;0;0;0;0;.00nan;0;0
37827;197409;502;0;0;0;0;.00nan;0;0
37827;63529;502;81;28;1;27;.964;3600000;0
37828;170547;500;63;30;4;26;.867;3900000;0
37828;175593;500;0;0;0;0;.00nan;0;0
37828;196715;497;52;25;4;21;.840;3900000;0
37828;78596;497;0;0;0;0;.00nan;0;0
37829;-1;495;51;19;3;16;.842;3600000;0
37829;170543;503;58;41;5;36;.878;3541000;0
37829;94134;503;0;0;0;0;.00nan;0;0
37829;148508;495;0;0;0;0;.00nan;0;0
37830;-1;504;42;37;6;31;.838;3600000;0
37830;-1;504;0;0;0;0;.00nan;0;0
37830;185442;2591;55;21;2;19;.905;3600000;0
37830;94018;2591;0;0;0;0;.00nan;0;0
37831;3075;505;0;0;0;0;.00nan;0;0
37831;71485;499;100;30;0;30;1.000;3600000;0
37831;94508;505;65;31;3;28;.903;3600000;0
37831;148652;499;0;0;0;0;.00nan;0;0
37832;504;496;85;33;1;32;.970;3900000;0
37832;165611;4636;66;12;1;11;.917;3900000;0
37832;170536;4636;0;0;0;0;.00nan;0;0
37832;158630;496;0;0;0;0;.00nan;0;0
37833;189433;498;0;0;0;0;.00nan;0;0
37833;196374;498;66;31;3;28;.903;3600000;0
37833;197409;502;0;0;0;0;.00nan;0;0
37833;63529;502;100;30;0;30;1.000;3600000;0
37834;170547;500;48;27;4;23;.852;3900000;0
37834;175593;500;0;0;0;0;.00nan;0;0
37834;196715;497;0;0;0;0;.00nan;0;0
37834;78596;497;68;37;4;33;.892;3900000;0
37835;-1;495;0;0;0;0;.00nan;0;0
37835;170543;503;0;0;0;0;.00nan;0;0
37835;94134;503;70;28;2;26;.929;3600000;0
37835;148508;495;87;32;1;31;.969;3600000;0
37836;-1;504;21;10;4;6;.600;1193000;0
37836;-1;504;92;36;1;35;.972;2407000;0
37836;185442;2591;61;13;1;12;.923;3600000;0
37836;94018;2591;0;0;0;0;.00nan;0;0
37837;170543;503;30;22;5;17;.773;2301000;0
37837;197409;502;0;0;0;0;.00nan;0;0
37837;63529;502;82;26;2;24;.923;3600000;0
37837;94134;503;65;9;0;9;1.000;1299000;0
37838;170547;500;62;24;2;22;.917;3586000;0
37838;175593;500;0;0;0;0;.00nan;0;0
37838;-1;504;87;31;1;30;.968;3600000;0
37838;-1;504;0;0;0;0;.00nan;0;0
37839;-1;495;77;23;1;22;.957;3600000;0
37839;196715;497;0;0;0;0;.00nan;0;0
37839;78596;497;56;26;3;23;.885;3552000;0
37839;148508;495;0;0;0;0;.00nan;0;0
37840;3075;505;80;16;0;16;1.000;3900000;0
37840;185442;2591;100;33;0;33;1.000;3900000;0
37840;94018;2591;0;0;0;0;.00nan;0;0
37840;94508;505;0;0;0;0;.00nan;0;0
37841;504;496;83;47;4;43;.915;3600000;0
37841;71485;499;75;20;1;19;.950;3600000;0
37841;148652;499;0;0;0;0;.00nan;0;0
37841;158630;496;0;0;0;0;.00nan;0;0
37842;165611;4636;64;23;2;21;.913;3886000;0
37842;189433;498;0;0;0;0;.00nan;0;0
37842;170536;4636;0;0;0;0;.00nan;0;0
37842;196374;498;74;31;2;29;.935;3900000;0
37843;170543;503;92;30;1;29;.967;3600000;0
37843;197409;502;0;0;0;0;.00nan;0;0
37843;63529;502;59;20;2;18;.900;3544000;0
37843;94134;503;0;0;0;0;.00nan;0;0
37844;170547;500;67;19;1;18;.947;3552000;0
37844;175593;500;0;0;0;0;.00nan;0;0
37844;-1;504;95;25;0;25;1.000;3600000;0
37844;-1;504;0;0;0;0;.00nan;0;0
37845;-1;495;0;0;0;0;.00nan;0;0
37845;196715;497;0;0;0;0;.00nan;0;0
37845;78596;497;97;43;2;41;.953;3900000;0
37845;148508;495;75;27;2;25;.926;3900000;0
37846;3075;505;31;21;4;17;.810;3600000;0
37846;185442;2591;98;35;1;34;.971;3600000;0
37846;94018;2591;0;0;0;0;.00nan;0;0
37846;94508;505;0;0;0;0;.00nan;0;0
37847;504;496;95;48;4;44;.917;3900000;0
37847;71485;499;0;0;0;0;.00nan;0;0
37847;148652;499;67;32;4;28;.875;3900000;0
37847;158630;496;0;0;0;0;.00nan;0;0
37848;165611;4636;79;25;1;24;.960;3674000;0
37848;189433;498;87;35;2;33;.943;3674000;0
37848;170536;4636;0;0;0;0;.00nan;0;0
37848;196374;498;0;0;0;0;.00nan;0;0
37849;504;496;81;31;1;30;.968;3900000;0
37849;3075;505;61;12;1;11;.917;3900000;0
37849;94508;505;0;0;0;0;.00nan;0;0
37849;158630;496;0;0;0;0;.00nan;0;0
37850;189433;498;0;0;0;0;.00nan;0;0
37850;196374;498;80;22;1;21;.955;3600000;0
37850;71485;499;80;38;3;35;.921;3533000;0
37850;148652;499;0;0;0;0;.00nan;0;0
37851;170547;500;99;42;2;40;.952;3600000;0
37851;175593;500;0;0;0;0;.00nan;0;0
37851;185442;2591;50;19;3;16;.842;3554000;0
37851;94018;2591;0;0;0;0;.00nan;0;0
37852;196715;497;0;0;0;0;.00nan;0;0
37852;197409;502;0;0;0;0;.00nan;0;0
37852;63529;502;85;29;1;28;.966;3600000;0
37852;78596;497;76;31;2;29;.935;3567000;0
37853;-1;495;70;23;2;21;.913;3600000;0
37853;-1;504;70;31;3;28;.903;3565000;0
37853;-1;504;0;0;0;0;.00nan;0;0
37853;148508;495;0;0;0;0;.00nan;0;0
37854;165611;4636;83;38;2;36;.947;3587000;0
37854;170536;4636;0;0;0;0;.00nan;0;0
37854;170543;503;100;37;1;36;.973;3600000;0
37854;94134;503;0;0;0;0;.00nan;0;0
37855;504;496;39;35;5;30;.857;3600000;0
37855;3075;505;61;15;1;14;.933;3600000;0
37855;94508;505;0;0;0;0;.00nan;0;0
37855;158630;496;0;0;0;0;.00nan;0;0
37856;189433;498;87;28;1;27;.964;3600000;0
37856;196374;498;0;0;0;0;.00nan;0;0
37856;71485;499;70;31;2;29;.935;3560000;0
37856;148652;499;0;0;0;0;.00nan;0;0
37857;170547;500;53;30;4;26;.867;3600000;0
37857;175593;500;0;0;0;0;.00nan;0;0
37857;185442;2591;98;35;1;34;.971;3600000;0
37857;94018;2591;0;0;0;0;.00nan;0;0
37858;196715;497;0;0;0;0;.00nan;0;0
37858;197409;502;0;0;0;0;.00nan;0;0
37858;63529;502;61;26;3;23;.885;3815000;0
37858;78596;497;63;22;2;20;.909;3815000;0
37859;-1;495;0;0;0;0;.00nan;0;0
37859;-1;504;0;0;0;0;.00nan;0;0
37859;-1;504;85;30;1;29;.967;3900000;0
37859;148508;495;91;31;1;30;.968;3900000;0
37860;165611;4636;97;34;1;33;.971;3566000;0
37860;170536;4636;0;0;0;0;.00nan;0;0
37860;170543;503;100;27;0;27;1.000;3600000;0
37860;94134;503;0;0;0;0;.00nan;0;0
37861;504;496;0;0;0;0;.00nan;0;0
37861;185442;2591;72;19;1;18;.947;3600000;0
37861;94018;2591;0;0;0;0;.00nan;0;0
37861;158630;496;81;44;3;41;.932;3580000;0
37862;165611;4636;100;31;0;31;1.000;3600000;0
37862;170536;4636;0;0;0;0;.00nan;0;0
37862;196715;497;0;0;0;0;.00nan;0;0
37862;78596;497;70;31;3;28;.903;3600000;0
37863;-1;495;74;23;2;21;.913;3600000;0
37863;170547;500;62;24;3;21;.875;3600000;0
37863;175593;500;0;0;0;0;.00nan;0;0
37863;148508;495;0;0;0;0;.00nan;0;0
37864;3075;505;0;0;0;0;.00nan;0;0
37864;189433;498;0;0;0;0;.00nan;0;0
37864;196374;498;71;26;2;24;.923;3900000;0
37864;94508;505;83;39;2;37;.949;3900000;0
37865;-1;504;96;41;1;40;.976;3900000;0
37865;-1;504;0;0;0;0;.00nan;0;0
37865;197409;502;0;0;0;0;.00nan;0;0
37865;63529;502;78;18;1;17;.944;3900000;0
37866;170543;503;91;45;3;42;.933;3546000;0
37866;71485;499;68;23;2;21;.913;3600000;0
37866;94134;503;0;0;0;0;.00nan;0;0
37866;148652;499;0;0;0;0;.00nan;0;0
37867;504;496;95;41;2;39;.951;3900000;0
37867;185442;2591;75;28;2;26;.929;3900000;0
37867;94018;2591;0;0;0;0;.00nan;0;0
37867;158630;496;0;0;0;0;.00nan;0;0
37868;165611;4636;71;35;2;33;.943;3900000;0
37868;170536;4636;0;0;0;0;.00nan;0;0
37868;196715;497;0;0;0;0;.00nan;0;0
37868;78596;497;71;30;2;28;.933;3900000;0
37869;-1;495;0;0;0;0;.00nan;0;0
37869;170547;500;42;24;4;20;.833;3600000;0
37869;175593;500;0;0;0;0;.00nan;0;0
37869;148508;495;83;27;1;26;.963;3600000;0
37870;3075;505;0;0;0;0;.00nan;0;0
37870;189433;498;74;35;3;32;.914;3600000;0
37870;196374;498;0;0;0;0;.00nan;0;0
37870;94508;505;36;32;5;27;.844;3538000;0
37871;-1;504;60;32;3;29;.906;3600000;0
37871;-1;504;0;0;0;0;.00nan;0;0
37871;197409;502;0;0;0;0;.00nan;0;0
37871;63529;502;100;22;0;22;1.000;3600000;0
37872;170543;503;79;25;1;24;.960;3575000;0
37872;71485;499;93;21;0;21;1.000;3600000;0
37872;94134;503;0;0;0;0;.00nan;0;0
37872;148652;499;0;0;0;0;.00nan;0;0
37873;196715;497;0;0;0;0;.00nan;0;0
37873;71485;499;57;30;4;26;.867;3600000;0
37873;78596;497;48;36;5;31;.861;3600000;0
37873;148652;499;0;0;0;0;.00nan;0;0
37874;3075;505;0;0;0;0;.00nan;0;0
37874;170543;503;0;0;0;0;.00nan;0;0
37874;94134;503;100;38;1;37;.974;3600000;0
37874;94508;505;39;22;4;18;.818;3600000;0
37875;-1;495;44;21;3;18;.857;3572000;0
37875;185442;2591;64;23;2;21;.913;3600000;0
37875;94018;2591;0;0;0;0;.00nan;0;0
37875;148508;495;0;0;0;0;.00nan;0;0
37876;165611;4636;76;27;1;26;.963;3900000;0
37876;170536;4636;0;0;0;0;.00nan;0;0
37876;-1;504;88;33;1;32;.970;3900000;0
37876;-1;504;0;0;0;0;.00nan;0;0
37877;170547;500;0;0;0;0;.00nan;0;0
37877;175593;500;82;26;1;25;.962;3600000;0
37877;197409;502;0;0;0;0;.00nan;0;0
37877;63529;502;66;22;2;20;.909;3559000;0
37878;504;496;100;39;1;38;.974;3600000;0
37878;189433;498;62;19;3;16;.842;3517000;0
37878;196374;498;0;0;0;0;.00nan;0;0
37878;158630;496;0;0;0;0;.00nan;0;0
37879;196715;497;0;0;0;0;.00nan;0;0
37879;71485;499;50;22;3;19;.864;3600000;0
37879;78596;497;81;23;1;22;.957;3600000;0
37879;148652;499;0;0;0;0;.00nan;0;0
37880;3075;505;0;0;0;0;.00nan;0;0
37880;170543;503;53;26;3;23;.885;3558000;0
37880;94134;503;0;0;0;0;.00nan;0;0
37880;94508;505;94;27;1;26;.963;3600000;0
37881;-1;495;0;0;0;0;.00nan;0;0
37881;185442;2591;78;27;2;25;.926;3600000;0
37881;94018;2591;0;0;0;0;.00nan;0;0
37881;148508;495;71;31;3;28;.903;3544000;0
37882;165611;4636;61;27;3;24;.889;3556000;0
37882;170536;4636;0;0;0;0;.00nan;0;0
37882;-1;504;0;0;0;0;.00nan;0;0
37882;-1;504;73;31;2;29;.935;3600000;0
37883;170547;500;76;48;5;43;.896;3600000;0
37883;175593;500;0;0;0;0;.00nan;0;0
37883;197409;502;0;0;0;0;.00nan;0;0
37883;63529;502;80;18;1;17;.944;3600000;0
37884;504;496;99;47;1;46;.979;3900000;0
37884;189433;498;0;0;0;0;.00nan;0;0
37884;196374;498;60;14;1;13;.929;3900000;0
37884;158630;496;0;0;0;0;.00nan;0;0
37885;-1;504;66;31;3;28;.903;3600000;0
37885;-1;504;0;0;0;0;.00nan;0;0
37885;71485;499;100;24;0;24;1.000;3600000;0
37885;148652;499;0;0;0;0;.00nan;0;0
37886;189433;498;0;0;0;0;.00nan;0;0
37886;196374;498;56;15;2;13;.867;3600000;0
37886;185442;2591;55;31;4;27;.871;3517000;0
37886;94018;2591;0;0;0;0;.00nan;0;0
37887;165611;4636;57;28;3;25;.893;3521000;0
37887;170536;4636;0;0;0;0;.00nan;0;0
37887;170547;500;87;30;1;29;.967;3600000;0
37887;175593;500;0;0;0;0;.00nan;0;0
37888;3075;505;0;0;0;0;.00nan;0;0
37888;196715;497;0;0;0;0;.00nan;0;0
37888;78596;497;71;27;2;25;.926;3738000;0
37888;94508;505;85;37;3;34;.919;3738000;0
37889;504;496;63;31;3;28;.903;3564000;0
37889;170543;503;71;26;2;24;.923;3600000;0
37889;94134;503;0;0;0;0;.00nan;0;0
37889;158630;496;0;0;0;0;.00nan;0;0
37890;-1;495;0;0;0;0;.00nan;0;0
37890;197409;502;0;0;0;0;.00nan;0;0
37890;63529;502;60;18;2;16;.889;3900000;0
37890;148508;495;67;19;2;17;.895;3900000;0
37891;-1;504;73;39;4;35;.897;3900000;0
37891;-1;504;0;0;0;0;.00nan;0;0
37891;71485;499;44;22;4;18;.818;3900000;0
37891;148652;499;0;0;0;0;.00nan;0;0
37892;189433;498;48;17;2;15;.882;3574000;0
37892;196374;498;0;0;0;0;.00nan;0;0
37892;185442;2591;78;24;1;23;.958;3600000;0
37892;94018;2591;0;0;0;0;.00nan;0;0
37893;165611;4636;74;32;2;30;.938;3600000;0
37893;170536;4636;0;0;0;0;.00nan;0;0
37893;170547;500;60;29;4;25;.862;3569000;0
37893;175593;500;0;0;0;0;.00nan;0;0
37894;3075;505;0;0;0;0;.00nan;0;0
37894;196715;497;0;0;0;0;.00nan;0;0
37894;78596;497;100;28;0;28;1.000;3600000;0
37894;94508;505;83;32;1;31;.969;3578000;0
37895;504;496;64;24;2;22;.917;3537000;0
37895;170543;503;89;17;0;17;1.000;3600000;0
37895;94134;503;0;0;0;0;.00nan;0;0
37895;158630;496;0;0;0;0;.00nan;0;0
37896;-1;495;63;30;3;27;.900;3600000;0
37896;197409;502;0;0;0;0;.00nan;0;0
37896;63529;502;99;24;0;24;1.000;3600000;0
37896;148508;495;0;0;0;0;.00nan;0;0
37897;3075;505;44;21;3;18;.857;3586000;0
37897;-1;504;0;0;0;0;.00nan;0;0
37897;-1;504;84;23;1;22;.957;3600000;0
37897;94508;505;0;0;0;0;.00nan;0;0
37898;189433;498;0;0;0;0;.00nan;0;0
37898;170543;503;87;33;2;31;.939;3581000;0
37898;196374;498;78;22;1;21;.955;3600000;0
37898;94134;503;0;0;0;0;.00nan;0;0
37899;165611;4636;77;27;2;25;.926;3600000;0
37899;-1;495;0;0;0;0;.00nan;0;0
37899;170536;4636;0;0;0;0;.00nan;0;0
37899;148508;495;48;27;4;23;.852;3577000;0
37900;504;496;66;31;3;28;.903;3822000;0
37900;196715;497;0;0;0;0;.00nan;0;0
37900;78596;497;79;35;2;33;.943;3822000;0
37900;158630;496;0;0;0;0;.00nan;0;0
37901;170547;500;77;33;3;30;.909;3536000;0
37901;175593;500;0;0;0;0;.00nan;0;0
37901;71485;499;74;21;1;20;.952;3600000;0
37901;148652;499;0;0;0;0;.00nan;0;0
37902;185442;2591;82;39;3;36;.923;3828000;0
37902;197409;502;0;0;0;0;.00nan;0;0
37902;63529;502;95;43;2;41;.953;3828000;0
37902;94018;2591;0;0;0;0;.00nan;0;0
37903;3075;505;0;0;0;0;.00nan;0;0
37903;-1;504;78;25;1;24;.960;3600000;0
37903;-1;504;0;0;0;0;.00nan;0;0
37903;94508;505;48;32;5;27;.844;3600000;0
37904;189433;498;85;25;1;24;.960;3600000;0
37904;170543;503;74;35;3;32;.914;3574000;0
37904;196374;498;0;0;0;0;.00nan;0;0
37904;94134;503;0;0;0;0;.00nan;0;0
37905;165611;4636;98;51;2;49;.961;3568000;0
37905;-1;495;0;0;0;0;.00nan;0;0
37905;170536;4636;0;0;0;0;.00nan;0;0
37905;148508;495;75;21;1;20;.952;3600000;0
37906;504;496;80;28;2;26;.929;3548000;0
37906;196715;497;0;0;0;0;.00nan;0;0
37906;78596;497;78;26;1;25;.962;3600000;0
37906;158630;496;0;0;0;0;.00nan;0;0
37907;170547;500;0;0;0;0;.00nan;0;0
37907;175593;500;76;23;1;22;.957;3600000;0
37907;71485;499;37;21;4;17;.810;3600000;0
37907;148652;499;0;0;0;0;.00nan;0;0
37908;185442;2591;92;31;1;30;.968;3600000;0
37908;197409;502;0;0;0;0;.00nan;0;0
37908;63529;502;91;37;2;35;.946;3600000;0
37908;94018;2591;0;0;0;0;.00nan;0;0
37909;-1;495;64;30;3;27;.900;3600000;0
37909;71485;499;55;30;4;26;.867;3591000;0
37909;148508;495;0;0;0;0;.00nan;0;0
37909;148652;499;0;0;0;0;.00nan;0;0
37910;170543;503;100;34;0;34;1.000;3600000;0
37910;185442;2591;49;25;4;21;.840;3600000;0
37910;94018;2591;0;0;0;0;.00nan;0;0
37910;94134;503;0;0;0;0;.00nan;0;0
37911;165611;4636;0;0;0;0;.00nan;0;0
37911;170536;4636;65;32;3;29;.906;3529000;0
37911;197409;502;0;0;0;0;.00nan;0;0
37911;63529;502;86;27;1;26;.963;3600000;0
37912;3075;505;61;24;2;22;.917;3600000;0
37912;170547;500;37;14;3;11;.786;3562000;0
37912;175593;500;0;0;0;0;.00nan;0;0
37912;94508;505;0;0;0;0;.00nan;0;0
37913;504;496;0;0;0;0;.00nan;0;0
37913;-1;504;100;27;0;27;1.000;3600000;0
37913;-1;504;0;0;0;0;.00nan;0;0
37913;158630;496;64;32;2;30;.938;3552000;0
37914;189433;498;0;0;0;0;.00nan;0;0
37914;196374;498;77;26;2;24;.923;3804000;0
37914;196715;497;0;0;0;0;.00nan;0;0
37914;78596;497;84;34;1;33;.971;3804000;0
37915;-1;495;94;30;1;29;.967;3544000;0
37915;71485;499;81;17;0;17;1.000;3600000;0
37915;148508;495;0;0;0;0;.00nan;0;0
37915;148652;499;0;0;0;0;.00nan;0;0
37916;170543;503;99;34;1;33;.971;3600000;0
37916;185442;2591;58;23;2;21;.913;3572000;0
37916;94018;2591;0;0;0;0;.00nan;0;0
37916;94134;503;0;0;0;0;.00nan;0;0
37917;165611;4636;94;40;2;38;.950;3600000;0
37917;170536;4636;0;0;0;0;.00nan;0;0
37917;197409;502;0;0;0;0;.00nan;0;0
37917;63529;502;79;21;1;20;.952;3600000;0
37918;3075;505;0;0;0;0;.00nan;0;0
37918;170547;500;81;31;2;29;.935;3600000;0
37918;175593;500;0;0;0;0;.00nan;0;0
37918;94508;505;43;30;5;25;.833;3600000;0
37919;504;496;77;35;2;33;.943;3555000;0
37919;-1;504;100;29;0;29;1.000;3600000;0
37919;-1;504;0;0;0;0;.00nan;0;0
37919;158630;496;0;0;0;0;.00nan;0;0
37920;189433;498;66;17;1;16;.941;3600000;0
37920;196374;498;0;0;0;0;.00nan;0;0
37920;196715;497;0;0;0;0;.00nan;0;0
37920;78596;497;73;31;2;29;.935;3600000;0
37921;197409;502;60;34;3;31;.912;3600000;0
37921;63529;502;0;0;0;0;.00nan;0;0
37921;71485;499;86;34;2;32;.941;3600000;0
37921;148652;499;0;0;0;0;.00nan;0;0
37922;3075;505;59;29;3;26;.897;3569000;0
37922;-1;495;0;0;0;0;.00nan;0;0
37922;94508;505;0;0;0;0;.00nan;0;0
37922;148508;495;79;21;1;20;.952;3600000;0
37923;165611;4636;85;43;3;40;.930;3600000;0
37923;170536;4636;0;0;0;0;.00nan;0;0
37923;185442;2591;0;0;0;0;.00nan;0;0
37923;94018;2591;88;22;0;22;1.000;3600000;0
37924;170543;503;78;30;2;28;.933;3600000;0
37924;196715;497;86;24;1;23;.958;3600000;0
37924;78596;497;0;0;0;0;.00nan;0;0
37924;94134;503;0;0;0;0;.00nan;0;0
37925;189433;498;97;21;0;21;1.000;3600000;0
37925;-1;504;77;36;3;33;.917;3600000;0
37925;-1;504;0;0;0;0;.00nan;0;0
37925;196374;498;0;0;0;0;.00nan;0;0
37926;504;496;90;33;2;31;.939;3600000;0
37926;170547;500;44;18;3;15;.833;3553000;0
37926;175593;500;0;0;0;0;.00nan;0;0
37926;158630;496;0;0;0;0;.00nan;0;0
37927;197409;502;0;0;0;0;.00nan;0;0
37927;63529;502;76;23;1;22;.957;3600000;0
37927;71485;499;91;39;2;37;.949;3600000;0
37927;148652;499;0;0;0;0;.00nan;0;0
37928;3075;505;0;0;0;0;.00nan;0;0
37928;-1;495;66;31;3;28;.903;3524000;0
37928;94508;505;83;28;1;27;.964;3600000;0
37928;148508;495;0;0;0;0;.00nan;0;0
37929;165611;4636;93;27;1;26;.963;3600000;0
37929;170536;4636;0;0;0;0;.00nan;0;0
37929;185442;2591;0;0;0;0;.00nan;0;0
37929;94018;2591;62;25;2;23;.920;3560000;0
37930;170543;503;77;29;2;27;.931;3574000;0
37930;196715;497;0;0;0;0;.00nan;0;0
37930;78596;497;86;25;1;24;.960;3600000;0
37930;94134;503;0;0;0;0;.00nan;0;0
37931;189433;498;71;22;2;20;.909;3900000;0
37931;-1;504;0;0;0;0;.00nan;0;0
37931;-1;504;100;42;2;40;.952;3900000;0
37931;196374;498;0;0;0;0;.00nan;0;0
37932;504;496;64;34;4;30;.882;3600000;0
37932;170547;500;94;30;1;29;.967;3600000;0
37932;175593;500;0;0;0;0;.00nan;0;0
37932;158630;496;0;0;0;0;.00nan;0;0
37933;185442;2591;61;28;3;25;.893;3600000;0
37933;196715;497;0;0;0;0;.00nan;0;0
37933;78596;497;100;30;0;30;1.000;3600000;0
37933;94018;2591;0;0;0;0;.00nan;0;0
37934;3075;505;91;20;0;20;1.000;3600000;0
37934;197409;502;53;4;0;4;1.000;446000;0
37934;63529;502;32;37;7;30;.811;3154000;0
37934;94508;505;0;0;0;0;.00nan;0;0
37935;165611;4636;56;27;3;24;.889;3580000;0
37935;170536;4636;0;0;0;0;.00nan;0;0
37935;71485;499;61;15;1;14;.933;3600000;0
37935;148652;499;0;0;0;0;.00nan;0;0
37936;504;496;100;47;2;45;.957;3850000;0
37936;-1;495;0;0;0;0;.00nan;0;0
37936;148508;495;70;25;2;23;.920;3900000;0
37936;158630;496;0;0;0;0;.00nan;0;0
37937;170543;503;0;0;0;0;.00nan;0;0
37937;-1;504;62;32;4;28;.875;3600000;0
37937;-1;504;0;0;0;0;.00nan;0;0
37937;94134;503;44;35;5;30;.857;3547000;0
37938;189433;498;0;0;0;0;.00nan;0;0
37938;170547;500;72;24;2;22;.917;3900000;0
37938;175593;500;0;0;0;0;.00nan;0;0
37938;196374;498;64;25;2;23;.920;3900000;0
37939;185442;2591;81;30;2;28;.933;3600000;0
37939;196715;497;0;0;0;0;.00nan;0;0
37939;78596;497;98;31;1;30;.968;3600000;0
37939;94018;2591;0;0;0;0;.00nan;0;0
37940;3075;505;70;26;2;24;.923;3600000;0
37940;197409;502;0;0;0;0;.00nan;0;0
37940;63529;502;78;33;3;30;.909;3600000;0
37940;94508;505;0;0;0;0;.00nan;0;0
37941;165611;4636;58;35;4;31;.886;3600000;0
37941;170536;4636;0;0;0;0;.00nan;0;0
37941;71485;499;0;0;0;0;.00nan;0;0
37941;148652;499;89;30;1;29;.967;3600000;0
37942;504;496;0;0;0;0;.00nan;0;0
37942;-1;495;72;26;2;24;.923;3600000;0
37942;148508;495;0;0;0;0;.00nan;0;0
37942;158630;496;87;46;3;43;.935;3600000;0
37943;170543;503;64;26;2;24;.923;3600000;0
37943;-1;504;55;28;3;25;.893;3557000;0
37943;-1;504;0;0;0;0;.00nan;0;0
37943;94134;503;0;0;0;0;.00nan;0;0
37944;189433;498;61;31;3;28;.903;3600000;0
37944;170547;500;65;43;4;39;.907;3544000;0
37944;175593;500;0;0;0;0;.00nan;0;0
37944;196374;498;0;0;0;0;.00nan;0;0
37945;189433;498;0;0;0;0;.00nan;0;0
37945;-1;504;62;28;3;25;.893;3600000;0
37945;-1;504;0;0;0;0;.00nan;0;0
37945;196374;498;100;30;0;30;1.000;3600000;0
37946;170543;503;100;38;1;37;.974;3900000;0
37946;170547;500;76;22;1;21;.955;3900000;0
37946;175593;500;0;0;0;0;.00nan;0;0
37946;94134;503;0;0;0;0;.00nan;0;0
37947;165611;4636;71;29;2;27;.931;3600000;0
37947;-1;495;0;0;0;0;.00nan;0;0
37947;170536;4636;0;0;0;0;.00nan;0;0
37947;148508;495;100;26;0;26;1.000;3600000;0
37948;3075;505;0;0;0;0;.00nan;0;0
37948;196715;497;0;0;0;0;.00nan;0;0
37948;78596;497;39;28;5;23;.821;3549000;0
37948;94508;505;55;29;4;25;.862;3600000;0
37949;504;496;80;35;2;33;.943;3600000;0
37949;197409;502;0;0;0;0;.00nan;0;0
37949;63529;502;71;29;3;26;.897;3568000;0
37949;158630;496;0;0;0;0;.00nan;0;0
37950;185442;2591;86;28;1;27;.964;3600000;0
37950;71485;499;62;24;3;21;.875;3576000;0
37950;94018;2591;0;0;0;0;.00nan;0;0
37950;148652;499;0;0;0;0;.00nan;0;0
37951;170547;500;71;33;3;30;.909;3543000;0
37951;175593;500;0;0;0;0;.00nan;0;0
37951;-1;504;80;32;2;30;.938;3600000;0
37951;-1;504;0;0;0;0;.00nan;0;0
37952;-1;495;0;0;0;0;.00nan;0;0
37952;170543;503;97;38;1;37;.974;3577000;0
37952;94134;503;0;0;0;0;.00nan;0;0
37952;148508;495;98;24;0;24;1.000;3600000;0
37953;165611;4636;59;40;5;35;.875;3600000;0
37953;189433;498;0;0;0;0;.00nan;0;0
37953;170536;4636;0;0;0;0;.00nan;0;0
37953;196374;498;82;34;2;32;.941;3600000;0
37954;3075;505;0;0;0;0;.00nan;0;0
37954;71485;499;70;31;2;29;.935;3538000;0
37954;94508;505;84;17;0;17;1.000;3600000;0
37954;148652;499;0;0;0;0;.00nan;0;0
37955;196715;497;0;0;0;0;.00nan;0;0
37955;197409;502;0;0;0;0;.00nan;0;0
37955;63529;502;74;39;3;36;.923;3600000;0
37955;78596;497;94;23;0;23;1.000;3600000;0
37956;504;496;76;32;2;30;.938;3563000;0
37956;185442;2591;100;28;0;28;1.000;3600000;0
37956;94018;2591;0;0;0;0;.00nan;0;0
37956;158630;496;0;0;0;0;.00nan;0;0
37957;-1;495;0;0;0;0;.00nan;0;0
37957;-1;504;0;0;0;0;.00nan;0;0
37957;-1;504;75;37;3;34;.919;3900000;0
37957;148508;495;74;38;3;35;.921;3900000;0
37958;189433;498;47;24;3;21;.875;3900000;0
37958;170543;503;85;33;3;30;.909;3900000;0
37958;196374;498;0;0;0;0;.00nan;0;0
37958;94134;503;0;0;0;0;.00nan;0;0
37959;165611;4636;86;34;1;33;.971;3900000;0
37959;170536;4636;0;0;0;0;.00nan;0;0
37959;170547;500;91;34;1;33;.971;3900000;0
37959;175593;500;0;0;0;0;.00nan;0;0
37960;504;496;100;40;1;39;.975;3900000;0
37960;3075;505;96;29;1;28;.966;3900000;0
37960;94508;505;0;0;0;0;.00nan;0;0
37960;158630;496;0;0;0;0;.00nan;0;0
37961;197409;502;0;0;0;0;.00nan;0;0
37961;63529;502;96;33;1;32;.970;3900000;0
37961;71485;499;73;21;1;20;.952;3900000;0
37961;148652;499;0;0;0;0;.00nan;0;0
37962;185442;2591;61;30;3;27;.900;3543000;0
37962;196715;497;0;0;0;0;.00nan;0;0
37962;78596;497;100;42;2;40;.952;3600000;0
37962;94018;2591;0;0;0;0;.00nan;0;0
37963;170547;500;0;0;0;0;.00nan;0;0
37963;175593;500;81;32;2;30;.938;3600000;0
37963;197409;502;0;0;0;0;.00nan;0;0
37963;63529;502;53;35;4;31;.886;3595000;0
37964;189433;498;66;24;2;22;.917;3600000;0
37964;196374;498;0;0;0;0;.00nan;0;0
37964;185442;2591;81;41;3;38;.927;3600000;0
37964;94018;2591;0;0;0;0;.00nan;0;0
37965;3075;505;0;0;0;0;.00nan;0;0
37965;-1;495;94;22;0;22;1.000;3600000;0
37965;94508;505;76;34;2;32;.941;3524000;0
37965;148508;495;0;0;0;0;.00nan;0;0
37966;-1;504;72;46;4;42;.913;3600000;0
37966;-1;504;0;0;0;0;.00nan;0;0
37966;196715;497;0;0;0;0;.00nan;0;0
37966;78596;497;71;29;2;27;.931;3600000;0
37967;504;496;68;28;3;25;.893;3600000;0
37967;170543;503;60;34;4;30;.882;3548000;0
37967;94134;503;0;0;0;0;.00nan;0;0
37967;158630;496;0;0;0;0;.00nan;0;0
37968;165611;4636;88;31;2;29;.935;3600000;0
37968;170536;4636;0;0;0;0;.00nan;0;0
37968;71485;499;85;25;1;24;.960;3600000;0
37968;148652;499;0;0;0;0;.00nan;0;0
37969;3075;505;68;18;1;17;.944;3600000;0
37969;170547;500;91;35;2;33;.943;3553000;0
37969;175593;500;0;0;0;0;.00nan;0;0
37969;94508;505;0;0;0;0;.00nan;0;0
37970;189433;498;0;0;0;0;.00nan;0;0
37970;196374;498;71;18;1;17;.944;3900000;0
37970;197409;502;0;0;0;0;.00nan;0;0
37970;63529;502;97;36;1;35;.972;3900000;0
37971;-1;495;88;34;2;32;.941;3891000;0
37971;185442;2591;86;28;2;26;.929;3900000;0
37971;94018;2591;0;0;0;0;.00nan;0;0
37971;148508;495;0;0;0;0;.00nan;0;0
37972;165611;4636;74;31;3;28;.903;3561000;0
37972;170536;4636;0;0;0;0;.00nan;0;0
37972;196715;497;62;22;2;20;.909;3600000;0
37972;78596;497;0;0;0;0;.00nan;0;0
37973;504;496;94;23;0;23;1.000;3600000;0
37973;-1;504;61;21;2;19;.905;3547000;0
37973;-1;504;0;0;0;0;.00nan;0;0
37973;158630;496;0;0;0;0;.00nan;0;0
37974;170543;503;63;27;3;24;.889;3600000;0
37974;71485;499;100;24;0;24;1.000;3600000;0
37974;94134;503;0;0;0;0;.00nan;0;0
37974;148652;499;0;0;0;0;.00nan;0;0
37975;170547;500;0;0;0;0;.00nan;0;0
37975;175593;500;83;31;2;29;.935;3600000;0
37975;185442;2591;51;26;4;22;.846;3538000;0
37975;94018;2591;0;0;0;0;.00nan;0;0
37976;3075;505;0;0;0;0;.00nan;0;0
37976;189433;498;71;29;2;27;.931;3600000;0
37976;196374;498;0;0;0;0;.00nan;0;0
37976;94508;505;58;33;4;29;.879;3600000;0
37977;-1;495;55;28;3;25;.893;3900000;0
37977;197409;502;0;0;0;0;.00nan;0;0
37977;63529;502;76;34;3;31;.912;3900000;0
37977;148508;495;0;0;0;0;.00nan;0;0
37978;170543;503;85;39;2;37;.949;3600000;0
37978;196715;497;0;0;0;0;.00nan;0;0
37978;78596;497;99;21;0;21;1.000;3600000;0
37978;94134;503;0;0;0;0;.00nan;0;0
37979;504;496;100;28;0;28;1.000;3600000;0
37979;165611;4636;75;26;2;24;.923;3571000;0
37979;170536;4636;0;0;0;0;.00nan;0;0
37979;158630;496;0;0;0;0;.00nan;0;0
37980;-1;504;66;34;4;30;.882;2228000;0
37980;-1;504;75;13;0;13;1.000;1372000;0
37980;71485;499;47;18;3;15;.833;3600000;0
37980;148652;499;0;0;0;0;.00nan;0;0
37981;504;496;53;42;5;37;.881;3600000;0
37981;196715;497;0;0;0;0;.00nan;0;0
37981;78596;497;72;21;1;20;.952;3600000;0
37981;158630;496;0;0;0;0;.00nan;0;0
37982;170547;500;81;26;1;25;.962;3600000;0
37982;175593;500;0;0;0;0;.00nan;0;0
37982;71485;499;76;37;3;34;.919;3562000;0
37982;148652;499;0;0;0;0;.00nan;0;0
37983;-1;495;0;0;0;0;.00nan;0;0
37983;189433;498;0;0;0;0;.00nan;0;0
37983;196374;498;74;19;1;18;.947;3600000;0
37983;148508;495;74;28;2;26;.929;3600000;0
37984;3075;505;43;17;3;14;.824;3522000;0
37984;165611;4636;86;34;1;33;.971;3600000;0
37984;170536;4636;0;0;0;0;.00nan;0;0
37984;94508;505;0;0;0;0;.00nan;0;0
37985;-1;504;89;39;2;37;.949;3739000;0
37985;-1;504;0;0;0;0;.00nan;0;0
37985;197409;502;57;24;3;21;.875;3739000;0
37985;63529;502;0;0;0;0;.00nan;0;0
37986;170543;503;99;36;1;35;.972;3600000;0
37986;185442;2591;55;15;2;13;.867;3587000;0
37986;94018;2591;0;0;0;0;.00nan;0;0
37986;94134;503;0;0;0;0;.00nan;0;0
37987;170547;500;86;27;1;26;.963;3900000;0
37987;175593;500;0;0;0;0;.00nan;0;0
37987;196715;497;0;0;0;0;.00nan;0;0
37987;78596;497;100;43;1;42;.977;3900000;0
37988;504;496;78;40;3;37;.925;3600000;0
37988;189433;498;48;24;4;20;.833;3561000;0
37988;196374;498;0;0;0;0;.00nan;0;0
37988;158630;496;0;0;0;0;.00nan;0;0
37989;-1;495;80;34;2;32;.941;3570000;0
37989;71485;499;85;26;1;25;.962;3600000;0
37989;148508;495;0;0;0;0;.00nan;0;0
37989;148652;499;0;0;0;0;.00nan;0;0
37990;170543;503;70;27;2;25;.926;3546000;0
37990;-1;504;0;0;0;0;.00nan;0;0
37990;-1;504;73;23;1;22;.957;3600000;0
37990;94134;503;0;0;0;0;.00nan;0;0
37991;3075;505;0;0;0;0;.00nan;0;0
37991;197409;502;0;0;0;0;.00nan;0;0
37991;63529;502;64;35;4;31;.886;3600000;0
37991;94508;505;94;33;1;32;.970;3600000;0
37992;165611;4636;100;34;1;33;.971;3900000;0
37992;170536;4636;0;0;0;0;.00nan;0;0
37992;185442;2591;89;31;1;30;.968;3900000;0
37992;94018;2591;0;0;0;0;.00nan;0;0
37993;-1;495;0;0;0;0;.00nan;0;0
37993;196715;497;0;0;0;0;.00nan;0;0
37993;78596;497;50;27;4;23;.852;3900000;0
37993;148508;495;59;32;4;28;.875;3900000;0
37994;504;496;82;36;3;33;.917;3547000;0
37994;170547;500;51;16;2;14;.875;3600000;0
37994;175593;500;0;0;0;0;.00nan;0;0
37994;158630;496;0;0;0;0;.00nan;0;0
37995;189433;498;100;26;0;26;1.000;3600000;0
37995;196374;498;0;0;0;0;.00nan;0;0
37995;71485;499;20;16;5;11;.688;2248000;0
37995;148652;499;61;7;0;7;1.000;1352000;0
37996;165611;4636;57;27;3;24;.889;3900000;0
37996;170536;4636;0;0;0;0;.00nan;0;0
37996;-1;504;67;34;3;31;.912;3900000;0
37996;-1;504;0;0;0;0;.00nan;0;0
37997;170543;503;0;0;0;0;.00nan;0;0
37997;197409;502;0;0;0;0;.00nan;0;0
37997;63529;502;100;22;0;22;1.000;3600000;0
37997;94134;503;73;29;2;27;.931;3532000;0
37998;3075;505;95;26;0;26;1.000;3600000;0
37998;185442;2591;91;32;1;31;.969;3558000;0
37998;94018;2591;0;0;0;0;.00nan;0;0
37998;94508;505;0;0;0;0;.00nan;0;0
37999;196715;497;0;0;0;0;.00nan;0;0
37999;71485;499;53;21;3;18;.857;3538000;0
37999;78596;497;86;35;1;34;.971;3600000;0
37999;148652;499;0;0;0;0;.00nan;0;0
38000;189433;498;61;31;5;26;.839;3600000;0
38000;170547;500;100;37;0;37;1.000;3600000;0
38000;175593;500;0;0;0;0;.00nan;0;0
38000;196374;498;0;0;0;0;.00nan;0;0
38001;504;496;60;42;5;37;.881;3600000;0
38001;-1;495;0;0;0;0;.00nan;0;0
38001;148508;495;64;21;2;19;.905;3600000;0
38001;158630;496;0;0;0;0;.00nan;0;0
38002;3075;505;85;23;1;22;.957;3600000;0
38002;170543;503;76;36;3;33;.917;3556000;0
38002;94134;503;0;0;0;0;.00nan;0;0
38002;94508;505;0;0;0;0;.00nan;0;0
38003;165611;4636;85;28;1;27;.964;3600000;0
38003;170536;4636;0;0;0;0;.00nan;0;0
38003;197409;502;0;0;0;0;.00nan;0;0
38003;63529;502;51;26;3;23;.885;3560000;0
38004;-1;504;65;35;4;31;.886;3517000;0
38004;-1;504;0;0;0;0;.00nan;0;0
38004;185442;2591;74;26;2;24;.923;3600000;0
38004;94018;2591;0;0;0;0;.00nan;0;0
38005;504;496;59;34;4;30;.882;3600000;0
38005;71485;499;71;21;1;20;.952;3600000;0
38005;148652;499;0;0;0;0;.00nan;0;0
38005;158630;496;0;0;0;0;.00nan;0;0
38006;189433;498;0;0;0;0;.00nan;0;0
38006;196374;498;90;19;0;19;1.000;3600000;0
38006;196715;497;0;0;0;0;.00nan;0;0
38006;78596;497;88;25;1;24;.960;3600000;0
38007;-1;495;62;21;2;19;.905;3552000;0
38007;170547;500;99;32;1;31;.969;3600000;0
38007;175593;500;0;0;0;0;.00nan;0;0
38007;148508;495;0;0;0;0;.00nan;0;0
38008;3075;505;0;0;0;0;.00nan;0;0
38008;-1;504;59;22;2;20;.909;3567000;0
38008;-1;504;0;0;0;0;.00nan;0;0
38008;94508;505;100;26;0;26;1.000;3600000;0
38009;165611;4636;0;0;0;0;.00nan;0;0
38009;170536;4636;85;34;2;32;.941;3600000;0
38009;170543;503;54;22;3;19;.864;3600000;0
38009;94134;503;0;0;0;0;.00nan;0;0
38010;185442;2591;56;27;4;23;.852;3564000;0
38010;197409;502;0;0;0;0;.00nan;0;0
38010;63529;502;93;32;2;30;.938;3600000;0
38010;94018;2591;0;0;0;0;.00nan;0;0
38011;3075;505;0;0;0;0;.00nan;0;0
38011;165611;4636;76;12;0;12;1.000;3600000;0
38011;170536;4636;0;0;0;0;.00nan;0;0
38011;94508;505;64;32;3;29;.906;3600000;0
38012;504;496;59;21;2;19;.905;3587000;0
38012;197409;502;0;0;0;0;.00nan;0;0
38012;63529;502;100;20;0;20;1.000;3600000;0
38012;158630;496;0;0;0;0;.00nan;0;0
38013;185442;2591;93;26;1;25;.962;3600000;0
38013;71485;499;87;39;2;37;.949;3580000;0
38013;94018;2591;0;0;0;0;.00nan;0;0
38013;148652;499;0;0;0;0;.00nan;0;0
38014;-1;504;78;45;4;41;.911;3600000;0
38014;-1;504;0;0;0;0;.00nan;0;0
38014;196715;497;0;0;0;0;.00nan;0;0
38014;78596;497;98;30;1;29;.967;3600000;0
38015;170543;503;62;24;2;22;.917;3600000;0
38015;170547;500;52;21;3;18;.857;3542000;0
38015;175593;500;0;0;0;0;.00nan;0;0
38015;94134;503;0;0;0;0;.00nan;0;0
38016;-1;495;61;20;2;18;.900;3600000;0
38016;189433;498;0;0;0;0;.00nan;0;0
38016;196374;498;45;24;3;21;.875;3569000;0
38016;148508;495;0;0;0;0;.00nan;0;0
38018;185442;2591;94;31;1;30;.968;3900000;0
38018;196715;497;0;0;0;0;.00nan;0;0
38018;78596;497;88;34;1;33;.971;3900000;0
38018;94018;2591;0;0;0;0;.00nan;0;0
38020;189433;498;79;33;2;31;.939;3550000;0
38020;170547;500;70;21;1;20;.952;3600000;0
38020;175593;500;0;0;0;0;.00nan;0;0
38020;196374;498;0;0;0;0;.00nan;0;0
38022;-1;504;61;21;2;19;.905;3562000;0
38022;-1;504;0;0;0;0;.00nan;0;0
38022;71485;499;83;18;0;18;1.000;3600000;0
38022;148652;499;0;0;0;0;.00nan;0;0
38024;3075;505;70;38;4;34;.895;3544000;0
38024;165611;4636;56;24;3;21;.875;3600000;0
38024;170536;4636;0;0;0;0;.00nan;0;0
38024;94508;505;0;0;0;0;.00nan;0;0
38026;-1;495;0;0;0;0;.00nan;0;0
38026;197409;502;0;0;0;0;.00nan;0;0
38026;148508;495;64;35;3;32;.914;3874000;0
38026;148829;502;72;24;2;22;.917;3874000;0
38028;504;496;72;41;4;37;.902;3549000;0
38028;170543;503;60;32;3;29;.906;3600000;0
38028;94134;503;0;0;0;0;.00nan;0;0
38028;158630;496;0;0;0;0;.00nan;0;0
38030;170543;503;0;0;0;0;.00nan;0;0
38030;185442;2591;75;27;2;25;.926;3900000;0
38030;94018;2591;0;0;0;0;.00nan;0;0
38030;94134;503;80;32;2;30;.938;3900000;0
38032;189433;498;0;0;0;0;.00nan;0;0
38032;196374;498;70;22;1;21;.955;3600000;0
38032;71485;499;80;31;2;29;.935;3582000;0
38032;148652;499;0;0;0;0;.00nan;0;0
38034;504;496;0;0;0;0;.00nan;0;0
38034;-1;495;74;21;1;20;.952;3900000;0
38034;148508;495;0;0;0;0;.00nan;0;0
38034;158630;496;82;25;1;24;.960;3900000;0
38036;3075;505;0;0;0;0;.00nan;0;0
38036;196715;497;79;43;3;40;.930;3579000;0
38036;78596;497;0;0;0;0;.00nan;0;0
38036;94508;505;76;19;1;18;.947;3600000;0
38038;165611;4636;0;0;0;0;.00nan;0;0
38038;170536;4636;40;24;4;20;.833;3564000;0
38038;-1;504;0;0;0;0;.00nan;0;0
38038;-1;504;62;32;3;29;.906;3600000;0
38040;170547;500;0;0;0;0;.00nan;0;0
38040;175593;500;69;33;3;30;.909;3900000;0
38040;197409;502;77;37;3;34;.919;3869000;0
38040;148829;502;0;0;0;0;.00nan;0;0
38042;170543;503;73;39;3;36;.923;3900000;0
38042;196715;497;0;0;0;0;.00nan;0;0
38042;78596;497;84;35;3;32;.914;3900000;0
38042;94134;503;0;0;0;0;.00nan;0;0
38044;170547;500;0;0;0;0;.00nan;0;0
38044;175593;500;80;33;2;31;.939;3900000;0
38044;185442;2591;62;24;2;22;.917;3900000;0
38044;94018;2591;0;0;0;0;.00nan;0;0
38046;189433;498;63;33;4;29;.879;3600000;0
38046;196374;498;0;0;0;0;.00nan;0;0
38046;197409;502;0;0;0;0;.00nan;0;0
38046;148829;502;45;37;6;31;.838;3524000;0
38048;504;496;73;40;4;36;.900;3796000;0
38048;-1;495;0;0;0;0;.00nan;0;0
38048;148508;495;68;28;3;25;.893;3796000;0
38048;158630;496;0;0;0;0;.00nan;0;0
38050;3075;505;78;23;1;22;.957;3600000;0
38050;-1;504;85;36;2;34;.944;3593000;0
38050;-1;504;0;0;0;0;.00nan;0;0
38050;94508;505;0;0;0;0;.00nan;0;0
38052;165611;4636;98;52;3;49;.942;3533000;0
38052;170536;4636;0;0;0;0;.00nan;0;0
38052;71485;499;55;12;1;11;.917;3600000;0
38052;148652;499;0;0;0;0;.00nan;0;0
38054;165611;4636;0;0;0;0;.00nan;0;0
38054;170536;4636;56;29;3;26;.897;3670000;0
38054;71485;499;0;0;0;0;.00nan;0;0
38054;148652;499;52;15;2;13;.867;3670000;0
38056;170543;503;0;0;0;0;.00nan;0;0
38056;185442;2591;81;21;1;20;.952;3600000;0
38056;94018;2591;0;0;0;0;.00nan;0;0
38056;94134;503;81;41;3;38;.927;3573000;0
38058;-1;504;0;0;0;0;.00nan;0;0
38058;-1;504;72;31;3;28;.903;3600000;0
38058;197409;502;100;27;0;27;1.000;3600000;0
38058;148829;502;0;0;0;0;.00nan;0;0
38060;3075;505;0;0;0;0;.00nan;0;0
38060;189433;498;0;0;0;0;.00nan;0;0
38060;196374;498;39;12;3;9;.750;3900000;0
38060;94508;505;64;37;3;34;.919;3900000;0
38062;-1;495;36;32;6;26;.813;3600000;0
38062;196715;497;69;30;3;27;.900;3600000;0
38062;78596;497;0;0;0;0;.00nan;0;0
38062;148508;495;0;0;0;0;.00nan;0;0
38064;504;496;0;0;0;0;.00nan;0;0
38064;170547;500;48;27;4;23;.852;3554000;0
38064;175593;500;0;0;0;0;.00nan;0;0
38064;158630;496;81;47;3;44;.936;3600000;0
38066;3075;505;60;21;2;19;.905;3600000;0
38066;-1;495;0;0;0;0;.00nan;0;0
38066;94508;505;0;0;0;0;.00nan;0;0
38066;148508;495;65;31;3;28;.903;3566000;0
38068;185442;2591;80;31;2;29;.935;3871000;0
38068;71485;499;95;30;1;29;.967;3871000;0
38068;94018;2591;0;0;0;0;.00nan;0;0
38068;148652;499;0;0;0;0;.00nan;0;0
38070;189433;498;71;25;1;24;.960;3600000;0
38070;196374;498;0;0;0;0;.00nan;0;0
38070;197409;502;45;28;4;24;.857;3235000;0
38070;148829;502;53;5;0;5;1.000;365000;0
38072;165611;4636;88;28;1;27;.964;3600000;0
38072;170536;4636;0;0;0;0;.00nan;0;0
38072;196715;497;0;0;0;0;.00nan;0;0
38072;78596;497;62;25;2;23;.920;3556000;0
38074;170543;503;76;35;3;32;.914;3600000;0
38074;-1;504;98;24;0;24;1.000;3600000;0
38074;-1;504;0;0;0;0;.00nan;0;0
38074;94134;503;0;0;0;0;.00nan;0;0
38076;504;496;46;29;4;25;.862;3600000;0
38076;170547;500;32;29;6;23;.793;3553000;0
38076;175593;500;0;0;0;0;.00nan;0;0
38076;158630;496;0;0;0;0;.00nan;0;0
38078;189433;498;49;22;3;19;.864;3540000;0
38078;-1;504;100;46;1;45;.978;3600000;0
38078;-1;504;0;0;0;0;.00nan;0;0
38078;196374;498;0;0;0;0;.00nan;0;0
38080;504;496;57;33;4;29;.879;3555000;0
38080;170543;503;81;32;2;30;.938;3600000;0
38080;94134;503;0;0;0;0;.00nan;0;0
38080;158630;496;0;0;0;0;.00nan;0;0
38082;3075;505;62;16;1;15;.938;3600000;0
38082;165611;4636;62;30;3;27;.900;3553000;0
38082;170536;4636;0;0;0;0;.00nan;0;0
38082;94508;505;0;0;0;0;.00nan;0;0
38084;-1;495;0;0;0;0;.00nan;0;0
38084;197409;502;0;0;0;0;.00nan;0;0
38084;148508;495;100;30;0;30;1.000;3600000;0
38084;148829;502;84;19;1;18;.947;3560000;0
38086;185442;2591;71;24;2;22;.917;3558000;0
38086;71485;499;0;0;0;0;.00nan;0;0
38086;94018;2591;0;0;0;0;.00nan;0;0
38086;148652;499;100;42;1;41;.976;3600000;0
38088;170547;500;66;19;1;18;.947;3600000;0
38088;175593;500;0;0;0;0;.00nan;0;0
38088;196715;497;0;0;0;0;.00nan;0;0
38088;78596;497;67;35;3;32;.914;3600000;0
38090;170543;503;0;0;0;0;.00nan;0;0
38090;185442;2591;0;0;0;0;.00nan;0;0
38090;94018;2591;78;13;0;13;1.000;3600000;0
38090;94134;503;78;34;3;31;.912;3600000;0
38092;504;496;0;0;0;0;.00nan;0;0
38092;165611;4636;0;0;0;0;.00nan;0;0
38092;170536;4636;100;29;0;29;1.000;3600000;0
38092;158630;496;90;35;1;34;.971;3555000;0
38094;170547;500;0;0;0;0;.00nan;0;0
38094;175593;500;100;28;0;28;1.000;3900000;0
38094;197409;502;82;30;0;30;1.000;3900000;0
38094;148829;502;0;0;0;0;.00nan;0;0
38096;196715;497;72;29;2;27;.931;3539000;0
38096;71485;499;100;27;0;27;1.000;3600000;0
38096;78596;497;0;0;0;0;.00nan;0;0
38096;148652;499;0;0;0;0;.00nan;0;0
38098;3075;505;0;0;0;0;.00nan;0;0
38098;189433;498;0;0;0;0;.00nan;0;0
38098;196374;498;92;34;1;33;.971;3900000;0
38098;94508;505;92;30;1;29;.967;3900000;0
38100;-1;495;0;0;0;0;.00nan;0;0
38100;-1;504;0;0;0;0;.00nan;0;0
38100;-1;504;85;33;2;31;.939;3900000;0
38100;148508;495;51;19;2;17;.895;3900000;0
923;189433;498;43;32;6;26;.813;3600000;0
923;196374;498;0;0;0;0;.00nan;0;0
923;71485;499;94;28;1;27;.964;3600000;0
923;148652;499;0;0;0;0;.00nan;0;0
924;-1;495;0;0;0;0;.00nan;0;0
924;196715;497;0;0;0;0;.00nan;0;0
924;78596;497;45;42;6;36;.857;3600000;0
924;148508;495;57;25;3;22;.880;3600000;0
925;189433;498;81;29;1;28;.966;3600000;0
925;196374;498;0;0;0;0;.00nan;0;0
925;71485;499;49;30;4;26;.867;3600000;0
925;148652;499;0;0;0;0;.00nan;0;0
926;-1;495;0;0;0;0;.00nan;0;0
926;196715;497;0;0;0;0;.00nan;0;0
926;78596;497;56;27;3;24;.889;3600000;0
926;148508;495;81;29;1;28;.966;3600000;0
927;189433;498;61;43;5;38;.884;3600000;0
927;196374;498;0;0;0;0;.00nan;0;0
927;71485;499;75;38;3;35;.921;3600000;0
927;148652;499;0;0;0;0;.00nan;0;0
928;-1;495;0;0;0;0;.00nan;0;0
928;196715;497;0;0;0;0;.00nan;0;0
928;78596;497;54;22;3;19;.864;3573000;0
928;148508;495;84;22;1;21;.955;3600000;0
929;189433;498;71;21;1;20;.952;3600000;0
929;196374;498;0;0;0;0;.00nan;0;0
929;71485;499;66;34;2;32;.941;3543000;0
929;148652;499;0;0;0;0;.00nan;0;0
930;-1;495;0;0;0;0;.00nan;0;0
930;196715;497;0;0;0;0;.00nan;0;0
930;78596;497;78;24;1;23;.958;3600000;0
930;148508;495;37;19;4;15;.789;3600000;0
1176;189433;498;87;38;2;36;.947;4514000;0
1176;196374;498;0;0;0;0;.00nan;0;0
1176;71485;499;100;41;1;40;.976;4514000;0
1176;148652;499;0;0;0;0;.00nan;0;0
1177;-1;495;0;0;0;0;.00nan;0;0
1177;196715;497;0;0;0;0;.00nan;0;0
1177;78596;497;88;23;1;22;.957;3600000;0
1177;148508;495;53;22;3;19;.864;3565000;0
1301;189433;498;75;27;2;25;.926;3600000;0
1301;196374;498;0;0;0;0;.00nan;0;0
1301;71485;499;67;37;4;33;.892;3600000;0
1301;148652;499;0;0;0;0;.00nan;0;0
1302;-1;495;0;0;0;0;.00nan;0;0
1302;196715;497;0;0;0;0;.00nan;0;0
1302;78596;497;55;25;4;21;.840;3771000;0
1302;148508;495;54;26;3;23;.885;3771000;0
1360;189433;498;52;37;5;32;.865;3530000;0
1360;196374;498;0;0;0;0;.00nan;0;0
1360;71485;499;53;23;3;20;.870;3600000;0
1360;148652;499;0;0;0;0;.00nan;0;0
1424;-1;495;0;0;0;0;.00nan;0;0
1424;71485;499;53;29;4;25;.862;4198000;0
1424;148508;495;72;29;3;26;.897;4198000;0
1424;148652;499;0;0;0;0;.00nan;0;0
1425;-1;495;0;0;0;0;.00nan;0;0
1425;71485;499;79;24;1;23;.958;3600000;0
1425;148508;495;54;20;3;17;.850;3578000;0
1425;148652;499;0;0;0;0;.00nan;0;0
1426;-1;495;0;0;0;0;.00nan;0;0
1426;71485;499;90;29;1;28;.966;3600000;0
1426;148508;495;63;23;2;21;.913;3553000;0
1426;148652;499;0;0;0;0;.00nan;0;0
1427;-1;495;0;0;0;0;.00nan;0;0
1427;71485;499;47;22;4;18;.818;3575000;0
1427;148508;495;64;26;3;23;.885;3600000;0
1427;148652;499;0;0;0;0;.00nan;0;0
1605;-1;495;0;0;0;0;.00nan;0;0
1605;71485;499;67;28;2;26;.929;4139000;0
1605;148508;495;67;23;1;22;.957;4139000;0
1605;148652;499;0;0;0;0;.00nan;0;0
1642;-1;495;0;0;0;0;.00nan;0;0
1642;71485;499;25;29;6;23;.793;3547000;0
1642;148508;495;52;30;4;26;.867;3600000;0
1642;148652;499;0;0;0;0;.00nan;0;0
38101;182780;548;79;22;1;21;.955;3900000;0
38101;13033;548;0;0;0;0;.00nan;0;0
38101;13041;551;93;32;1;31;.969;3900000;0
38101;150345;551;0;0;0;0;.00nan;0;0
38102;-1;549;0;0;0;0;.00nan;0;0
38102;-1;547;27;28;6;22;.786;3600000;0
38102;72108;549;76;23;1;22;.957;3600000;0
38102;150187;547;0;0;0;0;.00nan;0;0
38103;172303;2190;63;20;2;18;.900;3600000;0
38103;-1;2190;0;0;0;0;.00nan;0;0
38103;71660;546;96;49;3;46;.939;3545000;0
38103;73792;546;0;0;0;0;.00nan;0;0
38104;147;543;73;28;2;26;.929;3563000;0
38104;172303;2190;98;24;0;24;1.000;3600000;0
38104;-1;2190;0;0;0;0;.00nan;0;0
38104;158979;543;0;0;0;0;.00nan;0;0
38105;-1;547;56;27;4;23;.852;3737000;0
38105;71660;546;66;43;5;38;.884;3737000;0
38105;73792;546;0;0;0;0;.00nan;0;0
38105;150187;547;0;0;0;0;.00nan;0;0
38106;182780;548;80;30;1;29;.967;3600000;0
38106;6389;545;0;0;0;0;.00nan;0;0
38106;13033;548;0;0;0;0;.00nan;0;0
38106;143829;545;45;19;3;16;.842;3551000;0
38107;13041;551;0;0;0;0;.00nan;0;0
38107;169478;550;60;17;2;15;.882;3600000;0
38107;150203;550;0;0;0;0;.00nan;0;0
38107;150345;551;68;32;3;29;.906;3578000;0
38108;147;543;57;30;4;26;.867;3600000;0
38108;-1;549;0;0;0;0;.00nan;0;0
38108;72108;549;87;26;1;25;.962;3600000;0
38108;158979;543;0;0;0;0;.00nan;0;0
38109;147;543;91;31;1;30;.968;3600000;0
38109;182780;548;0;0;0;0;.00nan;0;0
38109;13033;548;50;16;2;14;.875;3550000;0
38109;158979;543;0;0;0;0;.00nan;0;0
38110;169478;550;18;27;7;20;.741;3600000;0
38110;71660;546;94;39;2;37;.949;3600000;0
38110;73792;546;0;0;0;0;.00nan;0;0
38110;150203;550;0;0;0;0;.00nan;0;0
38111;13041;551;0;0;0;0;.00nan;0;0
38111;-1;547;74;29;2;27;.931;3600000;0
38111;150187;547;0;0;0;0;.00nan;0;0
38111;150345;551;65;36;4;32;.889;3600000;0
38112;172303;2190;65;17;1;16;.941;3600000;0
38112;-1;549;0;0;0;0;.00nan;0;0
38112;-1;2190;0;0;0;0;.00nan;0;0
38112;72108;549;63;39;4;35;.897;3600000;0
38113;182780;548;63;19;2;17;.895;3600000;0
38113;13033;548;0;0;0;0;.00nan;0;0
38113;-1;547;63;41;5;36;.878;3600000;0
38113;150187;547;0;0;0;0;.00nan;0;0
38114;172303;2190;77;25;1;24;.960;3600000;0
38114;13041;551;0;0;0;0;.00nan;0;0
38114;-1;2190;0;0;0;0;.00nan;0;0
38114;150345;551;67;27;3;24;.889;3512000;0
38115;6389;545;0;0;0;0;.00nan;0;0
38115;71660;546;74;31;3;28;.903;3537000;0
38115;73792;546;0;0;0;0;.00nan;0;0
38115;143829;545;92;32;1;31;.969;3600000;0
38116;6389;545;0;0;0;0;.00nan;0;0
38116;-1;547;53;33;4;29;.879;3900000;0
38116;143829;545;57;31;4;27;.871;3900000;0
38116;150187;547;0;0;0;0;.00nan;0;0
38117;147;543;0;0;0;0;.00nan;0;0
38117;44487;543;91;30;2;28;.933;3600000;0
38117;71660;546;50;37;6;31;.838;3600000;0
38117;73792;546;0;0;0;0;.00nan;0;0
38118;182780;548;73;21;1;20;.952;3900000;0
38118;172303;2190;0;0;0;0;.00nan;0;0
38118;13033;548;0;0;0;0;.00nan;0;0
38118;-1;2190;86;25;1;24;.960;3900000;0
38119;169478;550;68;19;1;18;.947;3600000;0
38119;-1;549;0;0;0;0;.00nan;0;0
38119;72108;549;76;35;2;33;.943;3588000;0
38119;150203;550;0;0;0;0;.00nan;0;0
38120;147;543;0;0;0;0;.00nan;0;0
38120;13041;551;59;23;2;21;.913;3583000;0
38120;44487;543;99;34;1;33;.971;3600000;0
38120;150345;551;0;0;0;0;.00nan;0;0
38121;6389;545;0;0;0;0;.00nan;0;0
38121;172303;2190;47;17;3;14;.824;3703000;0
38121;-1;2190;0;0;0;0;.00nan;0;0
38121;143829;545;90;37;2;35;.946;3703000;0
38122;169478;550;68;28;2;26;.929;3600000;0
38122;-1;547;77;55;6;49;.891;3600000;0
38122;150187;547;0;0;0;0;.00nan;0;0
38122;150203;550;0;0;0;0;.00nan;0;0
38123;182780;548;66;15;1;14;.933;3600000;0
38123;13033;548;0;0;0;0;.00nan;0;0
38123;-1;549;0;0;0;0;.00nan;0;0
38123;72108;549;32;29;6;23;.793;3600000;0
38124;182780;548;0;0;0;0;.00nan;0;0
38124;13033;548;52;22;3;19;.864;3564000;0
38124;169478;550;70;27;2;25;.926;3600000;0
38124;150203;550;0;0;0;0;.00nan;0;0
38125;147;543;0;0;0;0;.00nan;0;0
38125;-1;547;69;18;1;17;.944;3600000;0
38125;44487;543;66;32;3;29;.906;3516000;0
38125;150187;547;0;0;0;0;.00nan;0;0
38126;13041;551;0;0;0;0;.00nan;0;0
38126;71660;546;0;0;0;0;.00nan;0;0
38126;73792;546;58;34;4;30;.882;3600000;0
38126;150345;551;64;28;3;25;.893;3600000;0
38127;6389;545;0;0;0;0;.00nan;0;0
38127;-1;549;98;36;1;35;.972;3600000;0
38127;72108;549;0;0;0;0;.00nan;0;0
38127;143829;545;71;33;3;30;.909;3568000;0
38128;147;543;0;0;0;0;.00nan;0;0
38128;169478;550;100;27;0;27;1.000;3600000;0
38128;44487;543;93;27;1;26;.963;3558000;0
38128;150203;550;0;0;0;0;.00nan;0;0
38129;6389;545;63;30;3;27;.900;3561000;0
38129;13041;551;0;0;0;0;.00nan;0;0
38129;143829;545;0;0;0;0;.00nan;0;0
38129;150345;551;84;35;2;33;.943;3600000;0
38130;172303;2190;72;8;0;8;1.000;3600000;0
38130;-1;547;46;46;6;40;.870;3600000;0
38130;-1;2190;0;0;0;0;.00nan;0;0
38130;150187;547;0;0;0;0;.00nan;0;0
38131;147;543;0;0;0;0;.00nan;0;0
38131;6389;545;0;0;0;0;.00nan;0;0
38131;44487;543;56;25;3;22;.880;3549000;0
38131;143829;545;88;31;1;30;.968;3600000;0
38132;172303;2190;44;24;4;20;.833;3640000;0
38132;169478;550;67;30;3;27;.900;3640000;0
38132;-1;2190;0;0;0;0;.00nan;0;0
38132;150203;550;0;0;0;0;.00nan;0;0
38133;182780;548;0;0;0;0;.00nan;0;0
38133;13033;548;59;13;1;12;.923;3600000;0
38133;71660;546;100;37;0;37;1.000;3600000;0
38133;73792;546;0;0;0;0;.00nan;0;0
38134;13041;551;82;35;2;33;.943;3600000;0
38134;-1;549;54;47;6;41;.872;3600000;0
38134;72108;549;0;0;0;0;.00nan;0;0
38134;150345;551;0;0;0;0;.00nan;0;0
38135;6389;545;0;0;0;0;.00nan;0;0
38135;169478;550;0;0;0;0;.00nan;0;0
38135;143829;545;61;24;2;22;.917;3572000;0
38135;150203;550;89;28;1;27;.964;3600000;0
38136;147;543;0;0;0;0;.00nan;0;0
38136;44487;543;56;24;3;21;.875;3600000;0
38136;71660;546;72;45;4;41;.911;3583000;0
38136;73792;546;0;0;0;0;.00nan;0;0
38137;182780;548;35;34;6;28;.824;3600000;0
38137;13033;548;0;0;0;0;.00nan;0;0
38137;-1;549;84;44;3;41;.932;3600000;0
38137;72108;549;0;0;0;0;.00nan;0;0
38138;6389;545;0;0;0;0;.00nan;0;0
38138;71660;546;82;41;2;39;.951;3600000;0
38138;73792;546;0;0;0;0;.00nan;0;0
38138;143829;545;74;22;1;21;.955;3600000;0
38139;169478;550;65;22;2;20;.909;3600000;0
38139;-1;547;56;2;0;2;1.000;327000;0
38139;150187;547;75;43;5;38;.884;3273000;0
38139;150203;550;0;0;0;0;.00nan;0;0
38140;172303;2190;0;0;0;0;.00nan;0;0
38140;13041;551;0;0;0;0;.00nan;0;0
38140;-1;2190;54;18;3;15;.833;3600000;0
38140;150345;551;83;48;4;44;.917;3545000;0
38141;147;543;69;20;1;19;.950;3600000;0
38141;-1;547;79;37;3;34;.919;3555000;0
38141;44487;543;0;0;0;0;.00nan;0;0
38141;150187;547;0;0;0;0;.00nan;0;0
38142;169478;550;68;28;3;25;.893;3600000;0
38142;-1;549;67;26;2;24;.923;3600000;0
38142;72108;549;0;0;0;0;.00nan;0;0
38142;150203;550;0;0;0;0;.00nan;0;0
38143;182780;548;94;33;1;32;.970;3600000;0
38143;6389;545;43;9;2;7;.778;1335000;0
38143;13033;548;0;0;0;0;.00nan;0;0
38143;143829;545;25;11;4;7;.636;2265000;0
38144;172303;2190;100;21;0;21;1.000;3600000;0
38144;-1;2190;0;0;0;0;.00nan;0;0
38144;71660;546;87;48;4;44;.917;3600000;0
38144;73792;546;0;0;0;0;.00nan;0;0
38145;6389;545;0;0;0;0;.00nan;0;0
38145;172303;2190;100;29;0;29;1.000;3600000;0
38145;-1;2190;0;0;0;0;.00nan;0;0
38145;143829;545;56;24;3;21;.875;3600000;0
38146;-1;549;0;0;0;0;.00nan;0;0
38146;71660;546;83;35;2;33;.943;3900000;0
38146;72108;549;72;29;2;27;.931;3900000;0
38146;73792;546;0;0;0;0;.00nan;0;0
38147;13041;551;0;0;0;0;.00nan;0;0
38147;169478;550;0;0;0;0;.00nan;0;0
38147;150203;550;69;20;1;19;.950;3600000;0
38147;150345;551;86;35;2;33;.943;3578000;0
38148;172303;2190;66;26;3;23;.885;3600000;0
38148;-1;547;85;48;4;44;.917;3589000;0
38148;-1;2190;0;0;0;0;.00nan;0;0
38148;150187;547;0;0;0;0;.00nan;0;0
38149;147;543;0;0;0;0;.00nan;0;0
38149;182780;548;12;21;6;15;.714;2999000;0
38149;193222;548;44;4;1;3;.750;601000;0
38149;44487;543;69;24;2;22;.917;3600000;0
38150;147;543;0;0;0;0;.00nan;0;0
38150;-1;549;100;33;0;33;1.000;3600000;0
38150;44487;543;45;22;4;18;.818;3600000;0
38150;72108;549;0;0;0;0;.00nan;0;0
38151;6389;545;0;0;0;0;.00nan;0;0
38151;-1;547;57;42;6;36;.857;3600000;0
38151;143829;545;99;21;0;21;1.000;3600000;0
38151;150187;547;0;0;0;0;.00nan;0;0
38152;182780;548;44;16;3;13;.813;3525000;0
38152;13041;551;97;34;1;33;.971;3600000;0
38152;85009;548;0;0;0;0;.00nan;0;0
38152;150345;551;0;0;0;0;.00nan;0;0
38153;172303;2190;60;6;0;6;1.000;864000;0
38153;169478;550;31;38;7;31;.816;3545000;0
38153;-1;2190;17;20;6;14;.700;2736000;0
38153;150203;550;0;0;0;0;.00nan;0;0
38154;-1;549;0;0;0;0;.00nan;0;0
38154;71660;546;48;40;6;34;.850;3551000;0
38154;72108;549;65;37;5;32;.865;3600000;0
38154;73792;546;0;0;0;0;.00nan;0;0
38155;147;543;0;0;0;0;.00nan;0;0
38155;169478;550;62;22;2;20;.909;3600000;0
38155;44487;543;34;20;4;16;.800;3582000;0
38155;150203;550;0;0;0;0;.00nan;0;0
38156;13041;551;0;0;0;0;.00nan;0;0
38156;-1;547;63;32;4;28;.875;3784000;0
38156;150187;547;0;0;0;0;.00nan;0;0
38156;150345;551;72;36;3;33;.917;3784000;0
38157;182780;548;38;19;4;15;.789;3559000;0
38157;172303;2190;80;37;2;35;.946;3600000;0
38157;-1;2190;0;0;0;0;.00nan;0;0
38157;85009;548;0;0;0;0;.00nan;0;0
38158;169478;550;47;11;2;9;.818;3600000;0
38158;71660;546;83;50;5;45;.900;3600000;0
38158;73792;546;0;0;0;0;.00nan;0;0
38158;150203;550;0;0;0;0;.00nan;0;0
38159;13041;551;0;0;0;0;.00nan;0;0
38159;-1;549;47;21;4;17;.810;1117000;0
38159;72108;549;75;20;1;19;.950;2483000;0
38159;150345;551;26;36;7;29;.806;3574000;0
38160;147;543;71;42;4;38;.905;3580000;0
38160;6389;545;0;0;0;0;.00nan;0;0
38160;44487;543;0;0;0;0;.00nan;0;0
38160;143829;545;63;28;3;25;.893;3600000;0
38161;147;543;0;0;0;0;.00nan;0;0
38161;172303;2190;82;29;1;28;.966;3600000;0
38161;44487;543;57;31;4;27;.871;3600000;0
38161;-1;2190;0;0;0;0;.00nan;0;0
38162;6389;545;0;0;0;0;.00nan;0;0
38162;-1;549;0;0;0;0;.00nan;0;0
38162;72108;549;50;43;6;37;.860;3600000;0
38162;143829;545;73;21;2;19;.905;3600000;0
38163;182780;548;68;19;1;18;.947;3600000;0
38163;-1;547;0;0;0;0;.00nan;0;0
38163;85009;548;0;0;0;0;.00nan;0;0
38163;150187;547;57;39;5;34;.872;3600000;0
38164;13041;551;82;24;1;23;.958;3600000;0
38164;71660;546;82;32;2;30;.938;3551000;0
38164;73792;546;0;0;0;0;.00nan;0;0
38164;150345;551;0;0;0;0;.00nan;0;0
38165;6389;545;0;0;0;0;.00nan;0;0
38165;169478;550;73;31;2;29;.935;3600000;0
38165;143829;545;72;24;1;23;.958;3600000;0
38165;150203;550;0;0;0;0;.00nan;0;0
38166;182780;548;39;19;3;16;.842;3545000;0
38166;71660;546;70;28;2;26;.929;3600000;0
38166;73792;546;0;0;0;0;.00nan;0;0
38166;85009;548;0;0;0;0;.00nan;0;0
38167;-1;549;83;31;2;29;.935;3600000;0
38167;-1;547;49;28;4;24;.857;3530000;0
38167;72108;549;0;0;0;0;.00nan;0;0
38167;150187;547;0;0;0;0;.00nan;0;0
38168;147;543;0;0;0;0;.00nan;0;0
38168;13041;551;0;0;0;0;.00nan;0;0
38168;44487;543;71;25;2;23;.920;3600000;0
38168;150345;551;39;29;5;24;.828;3600000;0
38169;182780;548;77;30;2;28;.933;3883000;0
38169;169478;550;87;26;1;25;.962;3883000;0
38169;85009;548;0;0;0;0;.00nan;0;0
38169;150203;550;0;0;0;0;.00nan;0;0
38170;-1;547;100;27;0;27;1.000;3600000;0
38170;71660;546;50;33;5;28;.848;3600000;0
38170;73792;546;0;0;0;0;.00nan;0;0
38170;150187;547;0;0;0;0;.00nan;0;0
38171;6389;545;0;0;0;0;.00nan;0;0
38171;13041;551;88;30;1;29;.967;3900000;0
38171;143829;545;89;25;1;24;.960;3900000;0
38171;150345;551;0;0;0;0;.00nan;0;0
38172;172303;2190;89;30;1;29;.967;3600000;0
38172;-1;549;52;14;2;12;.857;1243000;0
38172;-1;2190;0;0;0;0;.00nan;0;0
38172;72108;549;27;26;6;20;.769;2357000;0
38173;182780;548;0;0;0;0;.00nan;0;0
38173;169478;550;0;0;0;0;.00nan;0;0
38173;85009;548;78;26;1;25;.962;3600000;0
38173;150203;550;48;28;4;24;.857;3600000;0
38174;172303;2190;0;0;0;0;.00nan;0;0
38174;-1;549;0;0;0;0;.00nan;0;0
38174;-1;2190;100;41;0;41;1.000;3900000;0
38174;72108;549;95;30;0;30;1.000;3900000;0
38175;6389;545;0;0;0;0;.00nan;0;0
38175;13041;551;0;0;0;0;.00nan;0;0
38175;143829;545;85;28;2;26;.929;3577000;0
38175;150345;551;86;29;1;28;.966;3600000;0
38176;-1;547;82;25;1;24;.960;3600000;0
38176;71660;546;0;0;0;0;.00nan;0;0
38176;73792;546;48;26;4;22;.846;3600000;0
38176;150187;547;0;0;0;0;.00nan;0;0
38177;6389;545;0;0;0;0;.00nan;0;0
38177;169478;550;57;18;2;16;.889;3551000;0
38177;143829;545;81;26;1;25;.962;3600000;0
38177;150203;550;0;0;0;0;.00nan;0;0
38178;147;543;0;0;0;0;.00nan;0;0
38178;13041;551;75;33;3;30;.909;3600000;0
38178;44487;543;87;36;2;34;.944;3600000;0
38178;150345;551;0;0;0;0;.00nan;0;0
38179;172303;2190;0;0;0;0;.00nan;0;0
38179;-1;547;44;34;5;29;.853;3600000;0
38179;-1;2190;71;25;2;23;.920;3600000;0
38179;150187;547;0;0;0;0;.00nan;0;0
38180;-1;549;0;0;0;0;.00nan;0;0
38180;71660;546;66;31;4;27;.871;3578000;0
38180;72108;549;71;33;3;30;.909;3600000;0
38180;73792;546;0;0;0;0;.00nan;0;0
38181;6389;545;81;25;1;24;.960;3600000;0
38181;172303;2190;42;34;6;28;.824;2793000;0
38181;-1;2190;53;3;0;3;1.000;807000;0
38181;143829;545;0;0;0;0;.00nan;0;0
38182;147;543;0;0;0;0;.00nan;0;0
38182;182780;548;75;22;1;21;.955;3600000;0
38182;44487;543;65;33;4;29;.879;3600000;0
38182;85009;548;0;0;0;0;.00nan;0;0
38183;12406;551;0;0;0;0;.00nan;0;0
38183;13041;551;42;24;4;20;.833;3561000;0
38183;-1;546;79;36;3;33;.917;3600000;0
38183;73792;546;0;0;0;0;.00nan;0;0
38184;6389;545;0;0;0;0;.00nan;0;0
38184;-1;547;100;35;0;35;1.000;3600000;0
38184;143829;545;80;25;1;24;.960;3545000;0
38184;150187;547;0;0;0;0;.00nan;0;0
38185;147;543;7;27;8;19;.704;3600000;0
38185;44487;543;0;0;0;0;.00nan;0;0
38185;71660;546;93;46;3;43;.935;3600000;0
38185;73792;546;0;0;0;0;.00nan;0;0
38186;172303;2190;0;0;0;0;.00nan;0;0
38186;169478;550;76;28;1;27;.964;3600000;0
38186;-1;2190;35;17;4;13;.765;3600000;0
38186;150203;550;0;0;0;0;.00nan;0;0
38187;182780;548;29;15;4;11;.733;3600000;0
38187;-1;549;73;31;2;29;.935;3600000;0
38187;72108;549;0;0;0;0;.00nan;0;0
38187;85009;548;0;0;0;0;.00nan;0;0
38188;12406;551;0;0;0;0;.00nan;0;0
38188;169478;550;46;31;4;27;.871;3597000;0
38188;150203;550;0;0;0;0;.00nan;0;0
38188;150345;551;67;19;2;17;.895;3600000;0
38189;182780;548;0;0;0;0;.00nan;0;0
38189;172303;2190;55;29;4;25;.862;3900000;0
38189;-1;2190;0;0;0;0;.00nan;0;0
38189;85009;548;57;35;4;31;.886;3900000;0
38190;147;543;62;9;0;9;1.000;1250000;0
38190;-1;549;0;0;0;0;.00nan;0;0
38190;44487;543;35;30;6;24;.800;2321000;0
38190;72108;549;42;31;5;26;.839;3600000;0
38191;6389;545;0;0;0;0;.00nan;0;0
38191;71660;546;32;15;4;11;.733;978000;0
38191;73792;546;72;49;4;45;.918;2622000;0
38191;143829;545;74;18;1;17;.944;3600000;0
38192;169478;550;0;0;0;0;.00nan;0;0
38192;71660;546;81;24;1;23;.958;3600000;0
38192;73792;546;0;0;0;0;.00nan;0;0
38192;150203;550;53;19;2;17;.895;3590000;0
38193;147;543;0;0;0;0;.00nan;0;0
38193;172303;2190;63;23;2;21;.913;3600000;0
38193;44487;543;77;39;3;36;.923;3554000;0
38193;-1;2190;0;0;0;0;.00nan;0;0
38194;182780;548;0;0;0;0;.00nan;0;0
38194;-1;547;63;43;5;38;.884;3600000;0
38194;85009;548;91;21;0;21;1.000;3600000;0
38194;150187;547;0;0;0;0;.00nan;0;0
38195;6389;545;0;0;0;0;.00nan;0;0
38195;-1;549;0;0;0;0;.00nan;0;0
38195;72108;549;95;43;2;41;.953;3570000;0
38195;143829;545;77;24;1;23;.958;3600000;0
38196;182780;548;0;0;0;0;.00nan;0;0
38196;6389;545;35;29;5;24;.828;3522000;0
38196;85009;548;43;24;4;20;.833;3600000;0
38196;143829;545;0;0;0;0;.00nan;0;0
38197;147;543;0;0;0;0;.00nan;0;0
38197;-1;547;67;29;3;26;.897;3573000;0
38197;44487;543;72;29;2;27;.931;3600000;0
38197;150187;547;0;0;0;0;.00nan;0;0
38198;12406;551;0;0;0;0;.00nan;0;0
38198;-1;549;39;29;5;24;.828;3586000;0
38198;72108;549;0;0;0;0;.00nan;0;0
38198;150345;551;49;22;4;18;.818;3600000;0
38199;172303;2190;0;0;0;0;.00nan;0;0
38199;-1;2190;46;13;2;11;.846;3600000;0
38199;71660;546;98;50;3;47;.940;3556000;0
38199;73792;546;0;0;0;0;.00nan;0;0
38200;169478;550;67;18;1;17;.944;3600000;0
38200;-1;549;81;35;2;33;.943;3572000;0
38200;72108;549;0;0;0;0;.00nan;0;0
38200;150203;550;0;0;0;0;.00nan;0;0
38201;-1;547;72;22;1;21;.955;3569000;0
38201;71660;546;0;0;0;0;.00nan;0;0
38201;73792;546;80;18;0;18;1.000;3600000;0
38201;150187;547;0;0;0;0;.00nan;0;0
38202;172303;2190;43;14;3;11;.786;3900000;0
38202;-1;549;0;0;0;0;.00nan;0;0
38202;-1;2190;0;0;0;0;.00nan;0;0
38202;72108;549;92;45;3;42;.933;3894000;0
38203;147;543;0;0;0;0;.00nan;0;0
38203;169478;550;25;26;6;20;.769;2267000;0
38203;44487;543;90;28;1;27;.964;3600000;0
38203;150203;550;39;10;2;8;.800;1333000;0
38204;182780;548;44;20;4;16;.800;3574000;0
38204;12406;551;0;0;0;0;.00nan;0;0
38204;85009;548;0;0;0;0;.00nan;0;0
38204;150345;551;86;44;3;41;.932;3600000;0
38205;-1;549;0;0;0;0;.00nan;0;0
38205;-1;547;0;0;0;0;.00nan;0;0
38205;72108;549;71;35;4;31;.886;3600000;0
38205;150187;547;85;30;1;29;.967;3600000;0
38206;147;543;0;0;0;0;.00nan;0;0
38206;6389;545;0;0;0;0;.00nan;0;0
38206;44487;543;61;35;4;31;.886;3600000;0
38206;143829;545;80;28;1;27;.964;3600000;0
38207;169478;550;0;0;0;0;.00nan;0;0
38207;-1;547;77;44;4;40;.909;3578000;0
38207;150187;547;0;0;0;0;.00nan;0;0
38207;150203;550;43;21;3;18;.857;3600000;0
38208;182780;548;0;0;0;0;.00nan;0;0
38208;71660;546;0;0;0;0;.00nan;0;0
38208;73792;546;91;47;4;43;.915;3600000;0
38208;85009;548;59;12;1;11;.917;3600000;0
38209;172303;2190;82;21;1;20;.952;3600000;0
38209;12406;551;47;13;2;11;.846;1378000;0
38209;-1;2190;0;0;0;0;.00nan;0;0
38209;150345;551;39;23;4;19;.826;2222000;0
38210;-1;547;100;37;1;36;.973;3600000;0
38210;71660;546;80;38;2;36;.947;3576000;0
38210;73792;546;0;0;0;0;.00nan;0;0
38210;150187;547;0;0;0;0;.00nan;0;0
38211;182780;548;0;0;0;0;.00nan;0;0
38211;-1;549;92;44;3;41;.932;3569000;0
38211;72108;549;0;0;0;0;.00nan;0;0
38211;85009;548;77;26;2;24;.923;3600000;0
38212;172303;2190;68;25;2;23;.920;3600000;0
38212;169478;550;24;29;6;23;.793;3600000;0
38212;-1;2190;0;0;0;0;.00nan;0;0
38212;150203;550;0;0;0;0;.00nan;0;0
38213;-1;549;87;30;1;29;.967;3600000;0
38213;71660;546;59;19;2;17;.895;3582000;0
38213;72108;549;0;0;0;0;.00nan;0;0
38213;73792;546;0;0;0;0;.00nan;0;0
38214;182780;548;0;0;0;0;.00nan;0;0
38214;6389;545;0;0;0;0;.00nan;0;0
38214;85009;548;72;22;1;21;.955;3600000;0
38214;143829;545;64;34;3;31;.912;3572000;0
38215;6389;545;0;0;0;0;.00nan;0;0
38215;-1;547;89;43;4;39;.907;3600000;0
38215;143829;545;96;28;1;27;.964;3600000;0
38215;150187;547;0;0;0;0;.00nan;0;0
38216;182780;548;67;18;1;17;.944;3854000;0
38216;172303;2190;91;40;1;39;.975;3900000;0
38216;-1;2190;0;0;0;0;.00nan;0;0
38216;85009;548;0;0;0;0;.00nan;0;0
38217;147;543;0;0;0;0;.00nan;0;0
38217;44487;543;87;19;0;19;1.000;3600000;0
38217;71660;546;57;37;4;33;.892;3600000;0
38217;73792;546;0;0;0;0;.00nan;0;0
38218;12406;551;0;0;0;0;.00nan;0;0
38218;-1;549;0;0;0;0;.00nan;0;0
38218;72108;549;75;20;1;19;.950;3600000;0
38218;150345;551;85;39;3;36;.923;3522000;0
38219;169478;550;48;29;4;25;.862;3600000;0
38219;-1;549;90;31;1;30;.968;3600000;0
38219;72108;549;0;0;0;0;.00nan;0;0
38219;150203;550;0;0;0;0;.00nan;0;0
38220;6389;545;0;0;0;0;.00nan;0;0
38220;12406;551;0;0;0;0;.00nan;0;0
38220;143829;545;64;27;3;24;.889;3900000;0
38220;150345;551;74;37;3;34;.919;3900000;0
38221;147;543;0;0;0;0;.00nan;0;0
38221;6389;545;0;0;0;0;.00nan;0;0
38221;44487;543;81;43;4;39;.907;3566000;0
38221;143829;545;80;27;2;25;.926;3600000;0
38222;6389;545;82;12;0;12;1.000;3600000;0
38222;71660;546;98;51;2;49;.961;3568000;0
38222;73792;546;0;0;0;0;.00nan;0;0
38222;143829;545;0;0;0;0;.00nan;0;0
38223;12406;551;0;0;0;0;.00nan;0;0
38223;169478;550;0;0;0;0;.00nan;0;0
38223;150203;550;73;29;3;26;.897;3900000;0
38223;150345;551;82;32;3;29;.906;3900000;0
38224;182780;548;59;12;1;11;.917;3574000;0
38224;-1;547;100;41;0;41;1.000;3600000;0
38224;85009;548;0;0;0;0;.00nan;0;0
38224;150187;547;0;0;0;0;.00nan;0;0
38225;147;543;0;0;0;0;.00nan;0;0
38225;172303;2190;80;24;1;23;.958;3600000;0
38225;44487;543;61;49;6;43;.878;3600000;0
38225;-1;2190;0;0;0;0;.00nan;0;0
38226;12406;551;0;0;0;0;.00nan;0;0
38226;169478;550;67;28;1;27;.964;3900000;0
38226;150203;550;0;0;0;0;.00nan;0;0
38226;150345;551;98;33;1;32;.970;3900000;0
38227;147;543;0;0;0;0;.00nan;0;0
38227;-1;547;90;46;3;43;.935;3600000;0
38227;44487;543;48;23;4;19;.826;3550000;0
38227;150187;547;0;0;0;0;.00nan;0;0
38228;172303;2190;76;22;1;21;.955;3600000;0
38228;12406;551;0;0;0;0;.00nan;0;0
38228;-1;2190;0;0;0;0;.00nan;0;0
38228;150345;551;70;35;3;32;.914;3539000;0
38229;182780;548;55;21;2;19;.905;3600000;0
38229;169478;550;30;27;5;22;.815;3600000;0
38229;85009;548;0;0;0;0;.00nan;0;0
38229;150203;550;0;0;0;0;.00nan;0;0
38230;147;543;0;0;0;0;.00nan;0;0
38230;12406;551;0;0;0;0;.00nan;0;0
38230;44487;543;81;35;2;33;.943;3900000;0
38230;150345;551;89;32;2;30;.938;3900000;0
38231;169478;550;75;21;1;20;.952;3600000;0
38231;-1;547;76;38;3;35;.921;3521000;0
38231;150187;547;0;0;0;0;.00nan;0;0
38231;150203;550;0;0;0;0;.00nan;0;0
38232;182780;548;0;0;0;0;.00nan;0;0
38232;71660;546;70;39;4;35;.897;3600000;0
38232;73792;546;0;0;0;0;.00nan;0;0
38232;85009;548;56;11;1;10;.909;3600000;0
38233;172303;2190;71;24;2;22;.917;3600000;0
38233;-1;549;0;0;0;0;.00nan;0;0
38233;-1;2190;0;0;0;0;.00nan;0;0
38233;72108;549;60;25;3;22;.880;3565000;0
38234;6389;545;100;21;0;21;1.000;3600000;0
38234;-1;549;72;36;3;33;.917;3600000;0
38234;72108;549;0;0;0;0;.00nan;0;0
38234;143829;545;0;0;0;0;.00nan;0;0
38235;147;543;0;0;0;0;.00nan;0;0
38235;169478;550;65;38;3;35;.921;3561000;0
38235;44487;543;89;31;2;29;.935;3600000;0
38235;150203;550;0;0;0;0;.00nan;0;0
38236;182780;548;73;22;1;21;.955;3600000;0
38236;12406;551;0;0;0;0;.00nan;0;0
38236;85009;548;0;0;0;0;.00nan;0;0
38236;150345;551;79;38;3;35;.921;3577000;0
38237;172303;2190;54;20;3;17;.850;3600000;0
38237;-1;2190;0;0;0;0;.00nan;0;0
38237;71660;546;53;38;6;32;.842;2963000;0
38237;73792;546;48;0;0;0;.00nan;637000;0
38238;6389;545;52;26;4;22;.846;3698000;0
38238;169478;550;27;13;4;9;.692;1115000;0
38238;143829;545;0;0;0;0;.00nan;0;0
38238;150203;550;66;17;1;16;.941;2583000;0
38239;147;543;0;0;0;0;.00nan;0;0
38239;-1;549;0;0;0;0;.00nan;0;0
38239;44487;543;62;20;2;18;.900;3589000;0
38239;72108;549;73;19;1;18;.947;3600000;0
38240;12406;551;0;0;0;0;.00nan;0;0
38240;-1;547;97;43;2;41;.953;3600000;0
38240;150187;547;0;0;0;0;.00nan;0;0
38240;150345;551;57;11;1;10;.909;3600000;0
38241;172303;2190;0;0;0;0;.00nan;0;0
38241;-1;2190;100;27;0;27;1.000;3600000;0
38241;71660;546;65;33;4;29;.879;3600000;0
38241;73792;546;0;0;0;0;.00nan;0;0
38242;6389;545;0;0;0;0;.00nan;0;0
38242;169478;550;57;33;4;29;.879;3600000;0
38242;143829;545;20;17;5;12;.706;3554000;0
38242;150203;550;0;0;0;0;.00nan;0;0
38243;182780;548;50;12;2;10;.833;3900000;0
38243;71660;546;0;0;0;0;.00nan;0;0
38243;73792;546;96;48;2;46;.958;3900000;0
38243;85009;548;0;0;0;0;.00nan;0;0
38244;12406;551;0;0;0;0;.00nan;0;0
38244;-1;547;0;0;0;0;.00nan;0;0
38244;150187;547;80;33;2;31;.939;3552000;0
38244;150345;551;68;21;1;20;.952;3600000;0
38245;147;543;89;35;2;33;.943;3515000;0
38245;-1;549;98;22;0;22;1.000;3600000;0
38245;44487;543;0;0;0;0;.00nan;0;0
38245;72108;549;0;0;0;0;.00nan;0;0
38246;12406;551;0;0;0;0;.00nan;0;0
38246;71660;546;21;23;6;17;.739;2702000;0
38246;73792;546;53;3;0;3;1.000;898000;0
38246;150345;551;67;16;1;15;.938;3600000;0
38247;169478;550;0;0;0;0;.00nan;0;0
38247;71660;546;92;35;2;33;.943;3600000;0
38247;73792;546;0;0;0;0;.00nan;0;0
38247;150203;550;50;22;3;19;.864;3544000;0
38248;147;543;0;0;0;0;.00nan;0;0
38248;182780;548;0;0;0;0;.00nan;0;0
38248;44487;543;71;34;3;31;.912;3580000;0
38248;85009;548;69;23;2;21;.913;3600000;0
38249;6389;545;0;0;0;0;.00nan;0;0
38249;172303;2190;0;0;0;0;.00nan;0;0
38249;-1;2190;73;42;4;38;.905;3600000;0
38249;143829;545;55;25;3;22;.880;3600000;0
38250;-1;549;100;25;0;25;1.000;3600000;0
38250;-1;547;60;33;4;29;.879;3600000;0
38250;72108;549;0;0;0;0;.00nan;0;0
38250;150187;547;0;0;0;0;.00nan;0;0
38251;6389;545;73;20;1;19;.950;3600000;0
38251;172303;2190;79;45;4;41;.911;3600000;0
38251;-1;2190;0;0;0;0;.00nan;0;0
38251;143829;545;0;0;0;0;.00nan;0;0
38252;12406;551;0;0;0;0;.00nan;0;0
38252;-1;547;78;37;3;34;.919;3900000;0
38252;150187;547;0;0;0;0;.00nan;0;0
38252;150345;551;60;24;3;21;.875;3862000;0
38253;147;543;0;0;0;0;.00nan;0;0
38253;169478;550;56;39;5;34;.872;3600000;0
38253;44487;543;72;23;2;21;.913;3600000;0
38253;150203;550;0;0;0;0;.00nan;0;0
38254;182780;548;66;24;2;22;.917;3600000;0
38254;6389;545;46;30;4;26;.867;3566000;0
38254;85009;548;0;0;0;0;.00nan;0;0
38254;143829;545;0;0;0;0;.00nan;0;0
38255;147;543;0;0;0;0;.00nan;0;0
38255;-1;547;100;42;1;41;.976;3600000;0
38255;44487;543;64;27;2;25;.926;3560000;0
38255;150187;547;0;0;0;0;.00nan;0;0
38256;172303;2190;0;0;0;0;.00nan;0;0
38256;169478;550;100;37;1;36;.973;3600000;0
38256;-1;2190;48;26;4;22;.846;3600000;0
38256;150203;550;0;0;0;0;.00nan;0;0
38257;12406;551;0;0;0;0;.00nan;0;0
38257;-1;549;0;0;0;0;.00nan;0;0
38257;72108;549;85;45;4;41;.911;3600000;0
38257;150345;551;77;23;1;22;.957;3600000;0
38258;6389;545;0;0;0;0;.00nan;0;0
38258;71660;546;85;52;4;48;.923;3560000;0
38258;73792;546;0;0;0;0;.00nan;0;0
38258;143829;545;68;28;2;26;.929;3600000;0
38259;147;543;0;0;0;0;.00nan;0;0
38259;182780;548;73;20;1;19;.950;3600000;0
38259;44487;543;70;38;4;34;.895;3600000;0
38259;85009;548;0;0;0;0;.00nan;0;0
38260;172303;2190;44;19;4;15;.789;3600000;0
38260;-1;547;73;60;6;54;.900;3584000;0
38260;-1;2190;0;0;0;0;.00nan;0;0
38260;150187;547;0;0;0;0;.00nan;0;0
38261;-1;549;52;23;3;20;.870;3600000;0
38261;71660;546;69;46;5;41;.891;3573000;0
38261;72108;549;0;0;0;0;.00nan;0;0
38261;73792;546;0;0;0;0;.00nan;0;0
38262;182780;548;66;14;1;13;.929;3900000;0
38262;-1;549;0;0;0;0;.00nan;0;0
38262;72108;549;98;36;1;35;.972;3900000;0
38262;85009;548;0;0;0;0;.00nan;0;0
38263;172303;2190;55;26;3;23;.885;3900000;0
38263;-1;547;79;36;3;33;.917;3900000;0
38263;-1;2190;0;0;0;0;.00nan;0;0
38263;150187;547;0;0;0;0;.00nan;0;0
38264;12406;551;0;0;0;0;.00nan;0;0
38264;71660;546;51;32;5;27;.844;3561000;0
38264;73792;546;0;0;0;0;.00nan;0;0
38264;150345;551;73;30;3;27;.900;3600000;0
38265;6389;545;0;0;0;0;.00nan;0;0
38265;12406;551;0;0;0;0;.00nan;0;0
38265;143829;545;62;21;2;19;.905;3600000;0
38265;150345;551;86;47;3;44;.936;3600000;0
38266;147;543;67;41;5;36;.878;3555000;0
38266;172303;2190;0;0;0;0;.00nan;0;0
38266;44487;543;0;0;0;0;.00nan;0;0
38266;-1;2190;60;21;3;18;.857;3600000;0
38267;182780;548;71;18;1;17;.944;3600000;0
38267;-1;547;40;32;6;26;.813;2531000;0
38267;85009;548;0;0;0;0;.00nan;0;0
38267;150187;547;55;12;1;11;.917;1069000;0
38268;169478;550;95;38;2;36;.947;3600000;0
38268;-1;549;56;26;3;23;.885;3545000;0
38268;72108;549;0;0;0;0;.00nan;0;0
38268;150203;550;0;0;0;0;.00nan;0;0
38269;147;543;0;0;0;0;.00nan;0;0
38269;6389;545;0;0;0;0;.00nan;0;0
38269;44487;543;78;33;3;30;.909;3709000;0
38269;143829;545;83;42;4;38;.905;3709000;0
38270;-1;549;0;0;0;0;.00nan;0;0
38270;-1;547;100;36;0;36;1.000;3600000;0
38270;72108;549;83;38;2;36;.947;3516000;0
38270;150187;547;0;0;0;0;.00nan;0;0
38271;182780;548;81;25;1;24;.960;3600000;0
38271;12406;551;0;0;0;0;.00nan;0;0
38271;85009;548;0;0;0;0;.00nan;0;0
38271;150345;551;71;40;3;37;.925;3520000;0
38272;169478;550;100;32;0;32;1.000;3600000;0
38272;71660;546;98;47;3;44;.936;3600000;0
38272;73792;546;0;0;0;0;.00nan;0;0
38272;150203;550;0;0;0;0;.00nan;0;0
38273;182780;548;78;25;1;24;.960;3600000;0
38273;169478;550;39;36;6;30;.833;3600000;0
38273;85009;548;0;0;0;0;.00nan;0;0
38273;150203;550;0;0;0;0;.00nan;0;0
38274;147;543;0;0;0;0;.00nan;0;0
38274;44487;543;83;26;1;25;.962;3600000;0
38274;71660;546;24;12;4;8;.667;1050000;0
38274;73792;546;57;25;3;22;.880;2550000;0
38275;172303;2190;0;0;0;0;.00nan;0;0
38275;12406;551;100;28;0;28;1.000;3600000;0
38275;-1;2190;76;26;1;25;.962;3580000;0
38275;150345;551;0;0;0;0;.00nan;0;0
38276;6389;545;0;0;0;0;.00nan;0;0
38276;-1;549;0;0;0;0;.00nan;0;0
38276;72108;549;99;41;1;40;.976;3600000;0
38276;143829;545;58;27;3;24;.889;3526000;0
38277;6389;545;0;0;0;0;.00nan;0;0
38277;-1;547;25;5;3;2;.400;277000;0
38277;143829;545;65;23;3;20;.870;3600000;0
38277;150187;547;93;41;2;39;.951;3296000;0
38278;147;543;0;0;0;0;.00nan;0;0
38278;12406;551;58;34;4;30;.882;3545000;0
38278;44487;543;74;35;3;32;.914;3600000;0
38278;150345;551;0;0;0;0;.00nan;0;0
38279;182780;548;31;32;6;26;.813;3600000;0
38279;172303;2190;66;33;3;30;.909;3600000;0
38279;-1;2190;0;0;0;0;.00nan;0;0
38279;85009;548;0;0;0;0;.00nan;0;0
38280;6389;545;69;31;2;29;.935;3600000;0
38280;-1;549;54;35;5;30;.857;3600000;0
38280;72108;549;0;0;0;0;.00nan;0;0
38280;143829;545;0;0;0;0;.00nan;0;0
38281;12406;551;0;0;0;0;.00nan;0;0
38281;-1;547;29;27;6;21;.778;2606000;0
38281;150187;547;46;7;1;6;.857;994000;0
38281;150345;551;77;30;2;28;.933;3600000;0
38282;147;543;0;0;0;0;.00nan;0;0
38282;44487;543;87;18;0;18;1.000;3600000;0
38282;71660;546;71;37;3;34;.919;3600000;0
38282;73792;546;0;0;0;0;.00nan;0;0
38283;172303;2190;0;0;0;0;.00nan;0;0
38283;169478;550;55;29;4;25;.862;3600000;0
38283;-1;2190;85;27;1;26;.963;3600000;0
38283;150203;550;0;0;0;0;.00nan;0;0
38284;6389;545;0;0;0;0;.00nan;0;0
38284;-1;547;65;57;6;51;.895;2762000;0
38284;143829;545;63;13;1;12;.923;3600000;0
38284;150187;547;57;7;0;7;1.000;838000;0
38285;147;543;0;0;0;0;.00nan;0;0
38285;12406;551;0;0;0;0;.00nan;0;0
38285;44487;543;66;34;3;31;.912;3600000;0
38285;150345;551;48;27;4;23;.852;3600000;0
38286;169478;550;0;0;0;0;.00nan;0;0
38286;-1;549;0;0;0;0;.00nan;0;0
38286;72108;549;72;34;3;31;.912;3900000;0
38286;150203;550;50;23;3;20;.870;3900000;0
38287;182780;548;54;20;3;17;.850;3600000;0
38287;71660;546;52;38;5;33;.868;3583000;0
38287;73792;546;0;0;0;0;.00nan;0;0
38287;85009;548;0;0;0;0;.00nan;0;0
38288;147;543;0;0;0;0;.00nan;0;0
38288;169478;550;100;30;0;30;1.000;3600000;0
38288;44487;543;85;39;2;37;.949;3566000;0
38288;150203;550;0;0;0;0;.00nan;0;0
38289;182780;548;0;0;0;0;.00nan;0;0
38289;6389;545;0;0;0;0;.00nan;0;0
38289;85009;548;100;27;0;27;1.000;3600000;0
38289;143829;545;60;43;5;38;.884;3600000;0
38290;-1;547;49;33;5;28;.848;3541000;0
38290;71660;546;75;35;3;32;.914;3600000;0
38290;73792;546;0;0;0;0;.00nan;0;0
38290;150187;547;0;0;0;0;.00nan;0;0
38291;172303;2190;76;19;1;18;.947;3900000;0
38291;-1;549;100;41;1;40;.976;3900000;0
38291;-1;2190;0;0;0;0;.00nan;0;0
38291;72108;549;0;0;0;0;.00nan;0;0
38292;147;543;51;29;4;25;.862;3600000;0
38292;6389;545;0;0;0;0;.00nan;0;0
38292;44487;543;0;0;0;0;.00nan;0;0
38292;143829;545;54;35;5;30;.857;3565000;0
38293;169478;550;50;18;2;16;.889;3900000;0
38293;-1;547;97;48;2;46;.958;3900000;0
38293;150187;547;0;0;0;0;.00nan;0;0
38293;150203;550;0;0;0;0;.00nan;0;0
38294;172303;2190;0;0;0;0;.00nan;0;0
38294;12406;551;0;0;0;0;.00nan;0;0
38294;-1;2190;70;33;3;30;.909;3836000;0
38294;150345;551;65;24;2;22;.917;3836000;0
38295;182780;548;0;0;0;0;.00nan;0;0
38295;-1;549;0;0;0;0;.00nan;0;0
38295;72108;549;80;36;3;33;.917;3572000;0
38295;85009;548;68;24;2;22;.917;3600000;0
38296;6389;545;0;0;0;0;.00nan;0;0
38296;169478;550;80;29;2;27;.931;3695000;0
38296;143829;545;82;30;1;29;.967;3695000;0
38296;150203;550;0;0;0;0;.00nan;0;0
38297;147;543;0;0;0;0;.00nan;0;0
38297;-1;549;0;0;0;0;.00nan;0;0
38297;44487;543;86;15;0;15;1.000;3600000;0
38297;72108;549;80;49;5;44;.898;3600000;0
38298;182780;548;56;22;3;19;.864;3600000;0
38298;172303;2190;100;40;0;40;1.000;3600000;0
38298;-1;2190;0;0;0;0;.00nan;0;0
38298;85009;548;0;0;0;0;.00nan;0;0
38299;12406;551;0;0;0;0;.00nan;0;0
38299;71660;546;62;38;4;34;.895;3600000;0
38299;73792;546;0;0;0;0;.00nan;0;0
38299;150345;551;74;21;1;20;.952;3600000;0
38300;169478;550;71;21;1;20;.952;3600000;0
38300;-1;547;83;38;3;35;.921;3513000;0
38300;150187;547;0;0;0;0;.00nan;0;0
38300;150203;550;0;0;0;0;.00nan;0;0
38301;147;543;0;0;0;0;.00nan;0;0
38301;172303;2190;87;37;2;35;.946;3600000;0
38301;44487;543;50;29;4;25;.862;3519000;0
38301;-1;2190;0;0;0;0;.00nan;0;0
38302;182780;548;0;0;0;0;.00nan;0;0
38302;-1;547;80;31;2;29;.935;3600000;0
38302;85009;548;70;15;1;14;.933;3600000;0
38302;150187;547;0;0;0;0;.00nan;0;0
38303;6389;545;0;0;0;0;.00nan;0;0
38303;12406;551;0;0;0;0;.00nan;0;0
38303;143829;545;51;21;3;18;.857;3555000;0
38303;150345;551;89;40;2;38;.950;3600000;0
38304;-1;549;0;0;0;0;.00nan;0;0
38304;71660;546;84;30;2;28;.933;3600000;0
38304;72108;549;30;16;4;12;.750;3534000;0
38304;73792;546;0;0;0;0;.00nan;0;0
38305;147;543;0;0;0;0;.00nan;0;0
38305;-1;547;75;44;4;40;.909;3600000;0
38305;44487;543;73;20;1;19;.950;3600000;0
38305;150187;547;0;0;0;0;.00nan;0;0
38306;182780;548;0;0;0;0;.00nan;0;0
38306;169478;550;26;6;3;3;.500;238000;0
38306;85009;548;61;24;2;22;.917;3600000;0
38306;150203;550;97;36;0;36;1.000;3321000;0
38307;172303;2190;99;20;0;20;1.000;3600000;0
38307;-1;2190;0;0;0;0;.00nan;0;0
38307;71660;546;89;42;3;39;.929;3600000;0
38307;73792;546;0;0;0;0;.00nan;0;0
38308;12406;551;0;0;0;0;.00nan;0;0
38308;-1;549;84;40;2;38;.950;3526000;0
38308;72108;549;0;0;0;0;.00nan;0;0
38308;150345;551;86;21;0;21;1.000;3600000;0
38309;6389;545;0;0;0;0;.00nan;0;0
38309;71660;546;66;38;4;34;.895;3600000;0
38309;73792;546;0;0;0;0;.00nan;0;0
38309;143829;545;66;16;1;15;.938;3600000;0
38310;12406;551;0;0;0;0;.00nan;0;0
38310;169478;550;52;26;4;22;.846;3650000;0
38310;150203;550;0;0;0;0;.00nan;0;0
38310;150345;551;76;32;3;29;.906;3650000;0
38311;147;543;0;0;0;0;.00nan;0;0
38311;182780;548;54;20;3;17;.850;3600000;0
38311;44487;543;65;40;4;36;.900;3600000;0
38311;85009;548;0;0;0;0;.00nan;0;0
38312;172303;2190;70;23;1;22;.957;3600000;0
38312;-1;547;0;0;0;0;.00nan;0;0
38312;-1;2190;0;0;0;0;.00nan;0;0
38312;150187;547;89;40;2;38;.950;3600000;0
38313;182780;548;69;22;2;20;.909;3590000;0
38313;12406;551;0;0;0;0;.00nan;0;0
38313;85009;548;0;0;0;0;.00nan;0;0
38313;150345;551;92;31;1;30;.968;3600000;0
38314;169478;550;85;18;0;18;1.000;3600000;0
38314;71660;546;94;46;3;43;.935;3600000;0
38314;73792;546;0;0;0;0;.00nan;0;0
38314;150203;550;0;0;0;0;.00nan;0;0
38315;6389;545;0;0;0;0;.00nan;0;0
38315;172303;2190;68;28;3;25;.893;3900000;0
38315;-1;2190;0;0;0;0;.00nan;0;0
38315;143829;545;81;42;3;39;.929;3900000;0
38316;-1;549;50;1;0;1;1.000;342000;0
38316;-1;547;40;26;5;21;.808;3600000;0
38316;72108;549;44;38;6;32;.842;3203000;0
38316;150187;547;0;0;0;0;.00nan;0;0
38318;172303;2190;75;26;2;24;.923;3600000;0
38318;-1;2190;0;0;0;0;.00nan;0;0
38318;71660;546;62;36;4;32;.889;3600000;0
38318;150187;546;0;0;0;0;.00nan;0;0
38320;147;543;53;19;2;17;.895;3560000;0
38320;169478;550;98;22;0;22;1.000;3600000;0
38320;150203;550;0;0;0;0;.00nan;0;0
38320;158979;543;0;0;0;0;.00nan;0;0
38322;13041;551;0;0;0;0;.00nan;0;0
38322;-1;549;0;0;0;0;.00nan;0;0
38322;72108;549;99;44;2;42;.955;3600000;0
38322;150345;551;57;26;3;23;.885;3556000;0
38324;193222;548;0;0;0;0;.00nan;0;0
38324;6389;545;0;0;0;0;.00nan;0;0
38324;13033;548;75;33;3;30;.909;3900000;0
38324;143829;545;97;42;3;39;.929;3900000;0
38326;172303;2190;0;0;0;0;.00nan;0;0
38326;-1;549;0;0;0;0;.00nan;0;0
38326;-1;2190;63;15;1;14;.933;3600000;0
38326;72108;549;77;24;2;22;.917;3543000;0
38328;6389;545;0;0;0;0;.00nan;0;0
38328;169478;550;35;32;6;26;.813;3600000;0
38328;143829;545;96;19;0;19;1.000;3600000;0
38328;150203;550;0;0;0;0;.00nan;0;0
38330;147;543;85;36;3;33;.917;3600000;0
38330;13041;551;0;0;0;0;.00nan;0;0
38330;150345;551;55;29;4;25;.862;3563000;0
38330;158979;543;0;0;0;0;.00nan;0;0
38332;-1;547;8;21;7;14;.667;3600000;0
38332;71660;546;39;11;3;8;.727;461000;0
38332;73792;547;0;0;0;0;.00nan;0;0
38332;150187;546;65;31;3;28;.903;3139000;0
38334;147;543;0;0;0;0;.00nan;0;0
38334;71660;546;56;33;5;28;.848;3580000;0
38334;150187;546;0;0;0;0;.00nan;0;0
38334;158979;543;49;28;4;24;.857;3600000;0
38336;193222;548;0;0;0;0;.00nan;0;0
38336;13033;548;52;21;3;18;.857;3600000;0
38336;-1;547;0;0;0;0;.00nan;0;0
38336;73792;547;80;51;4;47;.922;3564000;0
38338;6389;545;0;0;0;0;.00nan;0;0
38338;169478;550;0;0;0;0;.00nan;0;0
38338;143829;545;48;20;3;17;.850;3542000;0
38338;150203;550;74;29;2;27;.931;3600000;0
38340;13041;551;38;20;4;16;.800;3600000;0
38340;-1;549;54;42;5;37;.881;3592000;0
38340;72108;549;0;0;0;0;.00nan;0;0
38340;150345;551;0;0;0;0;.00nan;0;0
38342;172303;2190;73;15;1;14;.933;3600000;0
38342;13041;551;0;0;0;0;.00nan;0;0
38342;-1;2190;0;0;0;0;.00nan;0;0
38342;150345;551;52;29;4;25;.862;3600000;0
38344;193222;548;0;0;0;0;.00nan;0;0
38344;6389;545;0;0;0;0;.00nan;0;0
38344;13033;548;87;36;2;34;.944;3600000;0
38344;143829;545;66;30;3;27;.900;3546000;0
38346;169478;550;49;15;2;13;.867;3559000;0
38346;71660;546;89;36;1;35;.972;3600000;0
38346;150187;546;0;0;0;0;.00nan;0;0
38346;150203;550;0;0;0;0;.00nan;0;0
38348;147;543;72;18;1;17;.944;3600000;0
38348;-1;547;90;54;3;51;.944;3524000;0
38348;73792;547;0;0;0;0;.00nan;0;0
38348;158979;543;0;0;0;0;.00nan;0;0
38350;147;543;0;0;0;0;.00nan;0;0
38350;169478;550;0;0;0;0;.00nan;0;0
38350;150203;550;75;31;3;28;.903;3600000;0
38350;158979;543;50;26;4;22;.846;3547000;0
38352;172303;2190;0;0;0;0;.00nan;0;0
38352;-1;547;0;0;0;0;.00nan;0;0
38352;-1;2190;62;21;2;19;.905;3600000;0
38352;73792;547;64;32;4;28;.875;3579000;0
38354;193222;548;76;29;2;27;.931;3600000;0
38354;6389;545;51;27;4;23;.852;3564000;0
38354;13033;548;0;0;0;0;.00nan;0;0
38354;143829;545;0;0;0;0;.00nan;0;0
38356;13041;551;71;8;0;8;1.000;3600000;0
38356;71660;546;0;0;0;0;.00nan;0;0
38356;150187;546;64;48;6;42;.875;3600000;0
38356;150345;551;0;0;0;0;.00nan;0;0
38358;193222;548;0;0;0;0;.00nan;0;0
38358;6389;545;0;0;0;0;.00nan;0;0
38358;13033;548;79;26;2;24;.923;3600000;0
38358;143829;545;65;30;3;27;.900;3572000;0
38360;169478;550;64;15;1;14;.933;3600000;0
38360;71660;546;64;45;5;40;.889;3600000;0
38360;150187;546;0;0;0;0;.00nan;0;0
38360;150203;550;0;0;0;0;.00nan;0;0
38362;13041;551;94;23;0;23;1.000;3600000;0
38362;-1;549;0;0;0;0;.00nan;0;0
38362;72108;549;63;32;3;29;.906;3600000;0
38362;150345;551;0;0;0;0;.00nan;0;0
38364;147;543;61;25;3;22;.880;3765000;0
38364;-1;547;78;41;4;37;.902;3765000;0
38364;73792;547;0;0;0;0;.00nan;0;0
38364;158979;543;0;0;0;0;.00nan;0;0
38366;13041;551;44;26;4;22;.846;3530000;0
38366;71660;546;0;0;0;0;.00nan;0;0
38366;150187;546;70;26;2;24;.923;3600000;0
38366;150345;551;0;0;0;0;.00nan;0;0
38368;193222;548;67;30;2;28;.933;3595000;0
38368;172303;2190;0;0;0;0;.00nan;0;0
38368;13033;548;0;0;0;0;.00nan;0;0
38368;-1;2190;85;24;1;23;.958;3600000;0
38370;147;543;0;0;0;0;.00nan;0;0
38370;-1;549;66;28;2;26;.929;3600000;0
38370;72108;549;0;0;0;0;.00nan;0;0
38370;158979;543;85;45;4;41;.911;3600000;0
38372;6389;545;59;12;1;11;.917;3600000;0
38372;-1;547;48;7;1;6;.857;883000;0
38372;73792;547;28;32;6;26;.813;2717000;0
38372;143829;545;0;0;0;0;.00nan;0;0
1115;172303;2190;95;20;0;20;1.000;3600000;0
1115;-1;547;27;13;4;9;.692;959000;0
1115;-1;2190;0;0;0;0;.00nan;0;0
1115;150187;547;83;32;1;31;.969;2641000;0
1116;147;543;0;0;0;0;.00nan;0;0
1116;182780;548;74;25;1;24;.960;3600000;0
1116;44487;543;83;33;2;31;.939;3553000;0
1116;85009;548;0;0;0;0;.00nan;0;0
1117;6389;545;0;0;0;0;.00nan;0;0
1117;-1;549;0;0;0;0;.00nan;0;0
1117;72108;549;63;46;6;40;.870;3600000;0
1117;143829;545;71;18;2;16;.889;3600000;0
1118;12406;551;0;0;0;0;.00nan;0;0
1118;169478;550;47;14;2;12;.857;3600000;0
1118;150203;550;0;0;0;0;.00nan;0;0
1118;150345;551;87;41;3;38;.927;3589000;0
1119;172303;2190;62;28;3;25;.893;3600000;0
1119;-1;547;40;41;7;34;.829;3600000;0
1119;-1;2190;0;0;0;0;.00nan;0;0
1119;150187;547;0;0;0;0;.00nan;0;0
1120;147;543;0;0;0;0;.00nan;0;0
1120;182780;548;50;27;4;23;.852;3600000;0
1120;44487;543;59;40;5;35;.875;3600000;0
1120;85009;548;0;0;0;0;.00nan;0;0
1121;6389;545;0;0;0;0;.00nan;0;0
1121;-1;549;0;0;0;0;.00nan;0;0
1121;72108;549;95;33;1;32;.970;3600000;0
1121;143829;545;67;28;3;25;.893;3594000;0
1122;12406;551;0;0;0;0;.00nan;0;0
1122;169478;550;66;34;4;30;.882;3560000;0
1122;150203;550;0;0;0;0;.00nan;0;0
1122;150345;551;55;23;3;20;.870;3600000;0
1123;172303;2190;66;34;3;31;.912;3600000;0
1123;-1;547;68;38;4;34;.895;3600000;0
1123;-1;2190;0;0;0;0;.00nan;0;0
1123;150187;547;0;0;0;0;.00nan;0;0
1124;147;543;0;0;0;0;.00nan;0;0
1124;182780;548;79;28;2;26;.929;3600000;0
1124;44487;543;56;35;5;30;.857;3600000;0
1124;85009;548;0;0;0;0;.00nan;0;0
1125;6389;545;0;0;0;0;.00nan;0;0
1125;-1;549;0;0;0;0;.00nan;0;0
1125;72108;549;68;40;4;36;.900;4029000;0
1125;143829;545;61;30;3;27;.900;4029000;0
1126;12406;551;0;0;0;0;.00nan;0;0
1126;169478;550;70;22;1;21;.955;3600000;0
1126;150203;550;0;0;0;0;.00nan;0;0
1126;150345;551;68;29;3;26;.897;3580000;0
1127;172303;2190;53;27;3;24;.889;3997000;0
1127;-1;547;84;44;4;40;.909;3997000;0
1127;-1;2190;0;0;0;0;.00nan;0;0
1127;150187;547;0;0;0;0;.00nan;0;0
1128;147;543;0;0;0;0;.00nan;0;0
1128;182780;548;66;15;1;14;.933;3600000;0
1128;44487;543;61;38;5;33;.868;3600000;0
1128;85009;548;0;0;0;0;.00nan;0;0
1129;6389;545;0;0;0;0;.00nan;0;0
1129;-1;549;0;0;0;0;.00nan;0;0
1129;72108;549;61;33;3;30;.909;3590000;0
1129;143829;545;81;26;1;25;.962;3600000;0
1130;12406;551;0;0;0;0;.00nan;0;0
1130;169478;550;70;22;2;20;.909;3600000;0
1130;150203;550;0;0;0;0;.00nan;0;0
1130;150345;551;58;31;4;27;.871;3573000;0
1480;6389;545;0;0;0;0;.00nan;0;0
1480;-1;549;0;0;0;0;.00nan;0;0
1480;72108;549;71;46;5;41;.891;4166000;0
1480;143829;545;52;36;4;32;.889;4166000;0
1481;12406;551;0;0;0;0;.00nan;0;0
1481;169478;550;64;21;2;19;.905;3915000;0
1481;150203;550;0;0;0;0;.00nan;0;0
1481;150345;551;78;38;3;35;.921;3936000;0
1503;172303;2190;72;35;3;32;.914;5172000;0
1503;169478;550;57;39;4;35;.897;5172000;0
1503;-1;2190;0;0;0;0;.00nan;0;0
1503;150203;550;0;0;0;0;.00nan;0;0
1504;182780;548;51;22;4;18;.818;3600000;0
1504;6389;545;0;0;0;0;.00nan;0;0
1504;85009;548;0;0;0;0;.00nan;0;0
1504;143829;545;88;35;1;34;.971;3600000;0
1505;172303;2190;80;53;4;49;.925;5110000;0
1505;169478;550;70;39;3;36;.923;5110000;0
1505;-1;2190;0;0;0;0;.00nan;0;0
1505;150203;550;0;0;0;0;.00nan;0;0
1506;182780;548;71;32;3;29;.906;3600000;0
1506;6389;545;0;0;0;0;.00nan;0;0
1506;85009;548;0;0;0;0;.00nan;0;0
1506;143829;545;55;20;2;18;.900;3600000;0
1507;172303;2190;81;38;2;36;.947;4831000;0
1507;169478;550;74;41;3;38;.927;4831000;0
1507;-1;2190;0;0;0;0;.00nan;0;0
1507;150203;550;0;0;0;0;.00nan;0;0
1508;182780;548;95;34;1;33;.971;3600000;0
1508;6389;545;0;0;0;0;.00nan;0;0
1508;85009;548;0;0;0;0;.00nan;0;0
1508;143829;545;87;32;2;30;.938;3600000;0
1509;172303;2190;54;39;6;33;.846;3600000;0
1509;169478;550;66;28;2;26;.929;3600000;0
1509;-1;2190;0;0;0;0;.00nan;0;0
1509;150203;550;0;0;0;0;.00nan;0;0
1510;182780;548;22;10;4;6;.600;953000;0
1510;6389;545;0;0;0;0;.00nan;0;0
1510;85009;548;70;23;1;22;.957;2647000;0
1510;143829;545;67;26;3;23;.885;3600000;0
1805;172303;2190;48;27;4;23;.852;3532000;0
1805;169478;550;56;20;2;18;.900;3600000;0
1805;-1;2190;0;0;0;0;.00nan;0;0
1805;150203;550;0;0;0;0;.00nan;0;0
1806;182780;548;58;29;4;25;.862;3580000;0
1806;6389;545;0;0;0;0;.00nan;0;0
1806;85009;548;0;0;0;0;.00nan;0;0
1806;143829;545;82;40;3;37;.925;3600000;0
1850;172303;2190;58;39;5;34;.872;3600000;0
1850;169478;550;82;21;1;20;.952;3600000;0
1850;-1;2190;0;0;0;0;.00nan;0;0
1850;150203;550;0;0;0;0;.00nan;0;0
1872;6389;545;0;0;0;0;.00nan;0;0
1872;169478;550;48;21;4;17;.810;4040000;0
1872;143829;545;67;28;3;25;.893;4040000;0
1872;150203;550;0;0;0;0;.00nan;0;0
1873;182780;548;100;53;1;52;.981;7102000;0
1873;172303;2190;92;61;2;59;.967;7102000;0
1873;-1;2190;0;0;0;0;.00nan;0;0
1873;85009;548;0;0;0;0;.00nan;0;0
1874;6389;545;0;0;0;0;.00nan;0;0
1874;169478;550;82;31;2;29;.935;3600000;0
1874;143829;545;27;17;5;12;.706;3600000;0
1874;150203;550;0;0;0;0;.00nan;0;0
1875;182780;548;85;25;1;24;.960;3600000;0
1875;172303;2190;72;38;3;35;.921;3534000;0
1875;-1;2190;0;0;0;0;.00nan;0;0
1875;85009;548;0;0;0;0;.00nan;0;0
1876;6389;545;0;0;0;0;.00nan;0;0
1876;169478;550;56;34;5;29;.853;3513000;0
1876;143829;545;57;25;3;22;.880;3600000;0
1876;150203;550;0;0;0;0;.00nan;0;0
1877;182780;548;84;27;1;26;.963;3600000;0
1877;172303;2190;94;36;2;34;.944;3587000;0
1877;-1;2190;0;0;0;0;.00nan;0;0
1877;85009;548;0;0;0;0;.00nan;0;0
1878;6389;545;0;0;0;0;.00nan;0;0
1878;169478;550;74;33;3;30;.909;3855000;0
1878;143829;545;74;40;4;36;.900;3855000;0
1878;150203;550;0;0;0;0;.00nan;0;0
1879;182780;548;91;39;2;37;.949;3558000;0
1879;172303;2190;86;32;1;31;.969;3600000;0
1879;-1;2190;0;0;0;0;.00nan;0;0
1879;85009;548;0;0;0;0;.00nan;0;0
1980;6389;545;0;0;0;0;.00nan;0;0
1980;169478;550;95;27;0;27;1.000;3600000;0
1980;143829;545;56;20;2;18;.900;3548000;0
1980;150203;550;0;0;0;0;.00nan;0;0
1981;182780;548;53;25;4;21;.840;3600000;0
1981;172303;2190;38;30;5;25;.833;3600000;0
1981;-1;2190;0;0;0;0;.00nan;0;0
1981;85009;548;0;0;0;0;.00nan;0;0
2122;6389;545;0;0;0;0;.00nan;0;0
2122;169478;550;73;41;4;37;.902;3876000;0
2122;143829;545;92;38;3;35;.921;3876000;0
2122;150203;550;0;0;0;0;.00nan;0;0
2145;6389;545;0;0;0;0;.00nan;0;0
2145;169478;550;72;30;3;27;.900;3600000;0
2145;143829;545;69;25;2;23;.920;3600000;0
2145;150203;550;0;0;0;0;.00nan;0;0
38373;161695;460;51;32;4;28;.875;3075000;0
38373;166839;4337;0;0;0;0;.00nan;0;0
38373;208725;460;24;7;3;4;.571;525000;0
38373;92283;4337;65;24;2;22;.917;3600000;0
38374;166839;4337;0;0;0;0;.00nan;0;0
38374;188429;2579;43;37;5;32;.865;3572000;0
38374;10565;2579;0;0;0;0;.00nan;0;0
38374;92283;4337;43;24;4;20;.833;3600000;0
38375;208713;458;0;0;0;0;.00nan;0;0
38375;167492;458;85;49;4;45;.918;3556000;0
38375;179652;452;50;20;3;17;.850;3600000;0
38375;75464;452;0;0;0;0;.00nan;0;0
38376;213957;457;0;0;0;0;.00nan;0;0
38376;172079;1086;0;0;0;0;.00nan;0;0
38376;15558;457;39;37;6;31;.838;3597000;0
38376;15564;1086;35;26;5;21;.808;3600000;0
38377;213956;455;66;34;3;31;.912;3600000;0
38377;203470;456;41;10;2;8;.800;711000;0
38377;203478;456;21;30;7;23;.767;2889000;0
38377;208723;455;0;0;0;0;.00nan;0;0
38378;2153;459;48;41;5;36;.878;3600000;0
38378;9216;459;0;0;0;0;.00nan;0;0
38378;179652;452;84;33;2;31;.939;3600000;0
38378;75464;452;0;0;0;0;.00nan;0;0
38379;161695;460;84;40;1;39;.975;3887000;0
38379;203470;456;65;20;1;19;.950;3900000;0
38379;203478;456;0;0;0;0;.00nan;0;0
38379;208725;460;0;0;0;0;.00nan;0;0
38380;161695;460;48;42;6;36;.857;3756000;0
38380;166839;4337;0;0;0;0;.00nan;0;0
38380;208725;460;0;0;0;0;.00nan;0;0
38380;92283;4337;46;28;5;23;.821;3756000;0
38381;213956;455;38;40;6;34;.850;3600000;0
38381;213957;457;78;24;1;23;.958;3600000;0
38381;208723;455;0;0;0;0;.00nan;0;0
38381;15558;457;0;0;0;0;.00nan;0;0
38382;161695;460;41;16;4;12;.750;949000;0
38382;166839;4337;38;22;4;18;.818;3600000;0
38382;208725;460;38;46;7;39;.848;2651000;0
38382;92283;4337;0;0;0;0;.00nan;0;0
38383;203470;456;22;4;3;1;.250;257000;0
38383;203478;456;37;28;5;23;.821;3330000;0
38383;188429;2579;67;50;6;44;.880;3600000;0
38383;10565;2579;0;0;0;0;.00nan;0;0
38384;208713;458;0;0;0;0;.00nan;0;0
38384;172079;1086;0;0;0;0;.00nan;0;0
38384;167492;458;71;57;6;51;.895;3584000;0
38384;15564;1086;35;16;4;12;.750;3600000;0
38385;2153;459;52;4;0;4;1.000;430000;0
38385;172079;1086;39;23;5;18;.783;3600000;0
38385;9216;459;39;36;6;30;.833;3151000;0
38385;15564;1086;0;0;0;0;.00nan;0;0
38386;213956;455;0;0;0;0;.00nan;0;0
38386;208723;455;40;24;4;20;.833;3600000;0
38386;188429;2579;0;0;0;0;.00nan;0;0
38386;10565;2579;28;27;6;21;.778;3563000;0
38387;166839;4337;0;0;0;0;.00nan;0;0
38387;213957;457;0;0;0;0;.00nan;0;0
38387;15558;457;74;35;3;32;.914;3600000;0
38387;92283;4337;47;32;5;27;.844;3527000;0
38388;2153;459;0;0;0;0;.00nan;0;0
38388;208713;458;0;0;0;0;.00nan;0;0
38388;167492;458;38;45;8;37;.822;3600000;0
38388;9216;459;39;24;4;20;.833;3600000;0
38389;166839;4337;72;36;3;33;.917;3600000;0
38389;213957;457;18;35;8;27;.771;2980000;0
38389;15558;457;51;5;0;5;1.000;620000;0
38389;92283;4337;0;0;0;0;.00nan;0;0
38390;208713;458;29;29;6;23;.793;3323000;0
38390;167492;458;49;8;1;7;.875;277000;0
38390;188429;2579;32;21;5;16;.762;3600000;0
38390;10565;2579;0;0;0;0;.00nan;0;0
38391;161695;460;0;0;0;0;.00nan;0;0
38391;172079;1086;0;0;0;0;.00nan;0;0
38391;208725;460;45;34;5;29;.853;3600000;0
38391;15564;1086;65;28;2;26;.929;3600000;0
38392;213956;455;20;35;8;27;.771;2891000;0
38392;208723;455;32;10;3;7;.700;709000;0
38392;179652;452;49;14;2;12;.857;3600000;0
38392;75464;452;0;0;0;0;.00nan;0;0
38393;2153;459;0;0;0;0;.00nan;0;0
38393;9216;459;74;33;3;30;.909;3710000;0
38393;188429;2579;0;0;0;0;.00nan;0;0
38393;10565;2579;56;36;4;32;.889;3710000;0
38394;161695;460;54;45;6;39;.867;3600000;0
38394;213957;457;72;25;2;23;.920;3600000;0
38394;208725;460;0;0;0;0;.00nan;0;0
38394;15558;457;0;0;0;0;.00nan;0;0
38395;213956;455;60;35;3;32;.914;3773000;0
38395;203470;456;65;34;4;30;.882;3783000;0
38395;203478;456;0;0;0;0;.00nan;0;0
38395;208723;455;0;0;0;0;.00nan;0;0
38396;161695;460;0;0;0;0;.00nan;0;0
38396;213957;457;0;0;0;0;.00nan;0;0
38396;208725;460;85;28;1;27;.964;3600000;0
38396;15558;457;41;31;5;26;.839;3600000;0
38397;188429;2579;88;46;3;43;.935;3600000;0
38397;10565;2579;0;0;0;0;.00nan;0;0
38397;179652;452;70;23;1;22;.957;3600000;0
38397;75464;452;0;0;0;0;.00nan;0;0
38398;166839;4337;0;0;0;0;.00nan;0;0
38398;179652;452;0;0;0;0;.00nan;0;0
38398;75464;452;51;38;5;33;.868;3587000;0
38398;92283;4337;66;23;3;20;.870;3600000;0
38399;2153;459;88;51;4;47;.922;3600000;0
38399;172079;1086;0;0;0;0;.00nan;0;0
38399;9216;459;0;0;0;0;.00nan;0;0
38399;15564;1086;45;19;3;16;.842;3600000;0
38400;213956;455;0;0;0;0;.00nan;0;0
38400;208713;458;0;0;0;0;.00nan;0;0
38400;208723;455;34;17;4;13;.765;3600000;0
38400;167492;458;59;40;5;35;.875;3562000;0
38401;2153;459;0;0;0;0;.00nan;0;0
38401;172079;1086;45;35;6;29;.829;3549000;0
38401;9216;459;48;28;5;23;.821;3600000;0
38401;15564;1086;0;0;0;0;.00nan;0;0
38402;203470;456;0;0;0;0;.00nan;0;0
38402;203478;456;59;23;3;20;.870;3600000;0
38402;208713;458;15;39;8;31;.795;3600000;0
38402;167492;458;0;0;0;0;.00nan;0;0
38403;166839;4337;60;23;2;21;.913;3600000;0
38403;188429;2579;53;35;5;30;.857;3600000;0
38403;10565;2579;0;0;0;0;.00nan;0;0
38403;92283;4337;0;0;0;0;.00nan;0;0
38404;213957;457;54;28;3;25;.893;3600000;0
38404;203470;456;19;26;6;20;.769;3186000;0
38404;203478;456;49;1;0;1;1.000;414000;0
38404;15558;457;0;0;0;0;.00nan;0;0
38405;161695;460;0;0;0;0;.00nan;0;0
38405;208713;458;0;0;0;0;.00nan;0;0
38405;167492;458;72;39;4;35;.897;3600000;0
38405;179373;460;43;25;5;20;.800;3545000;0
38406;172079;1086;0;0;0;0;.00nan;0;0
38406;15564;1086;46;32;5;27;.844;3600000;0
38406;179652;452;100;29;0;29;1.000;3600000;0
38406;75464;452;0;0;0;0;.00nan;0;0
38407;161695;460;0;0;0;0;.00nan;0;0
38407;2153;459;49;30;5;25;.833;3600000;0
38407;9216;459;0;0;0;0;.00nan;0;0
38407;179373;460;1;24;8;16;.667;3600000;0
38408;166839;4337;0;0;0;0;.00nan;0;0
38408;213956;455;0;0;0;0;.00nan;0;0
38408;168066;455;78;39;3;36;.923;3665000;0
38408;92283;4337;48;24;4;20;.833;3665000;0
38409;161695;460;0;0;0;0;.00nan;0;0
38409;172079;1086;0;0;0;0;.00nan;0;0
38409;15564;1086;73;31;2;29;.935;3600000;0
38409;179373;460;19;28;7;21;.750;3600000;0
38410;213956;455;0;0;0;0;.00nan;0;0
38410;208713;458;41;3;1;2;.667;301000;0
38410;167492;458;33;28;7;21;.750;3299000;0
38410;168066;455;57;29;3;26;.897;3600000;0
38411;166839;4337;64;27;3;24;.889;3600000;0
38411;179652;452;53;39;5;34;.872;3545000;0
38411;75464;452;0;0;0;0;.00nan;0;0
38411;92283;4337;0;0;0;0;.00nan;0;0
38412;203470;456;0;0;0;0;.00nan;0;0
38412;203478;456;96;24;0;24;1.000;3600000;0
38412;188429;2579;72;23;1;22;.957;3600000;0
38412;10565;2579;0;0;0;0;.00nan;0;0
38413;2153;459;57;4;0;4;1.000;727000;0
38413;213956;455;0;0;0;0;.00nan;0;0
38413;9216;459;31;29;6;23;.793;2873000;0
38413;168066;455;10;25;8;17;.680;3600000;0
38414;2153;459;56;10;1;9;.900;3600000;0
38414;208713;458;0;0;0;0;.00nan;0;0
38414;167492;458;85;36;2;34;.944;3572000;0
38414;9216;459;0;0;0;0;.00nan;0;0
38415;213957;457;58;29;4;25;.862;3600000;0
38415;208713;458;26;52;9;43;.827;3600000;0
38415;167492;458;0;0;0;0;.00nan;0;0
38415;15558;457;0;0;0;0;.00nan;0;0
38416;213956;455;0;0;0;0;.00nan;0;0
38416;188429;2579;0;0;0;0;.00nan;0;0
38416;10565;2579;62;27;2;25;.926;3600000;0
38416;168066;455;72;22;1;21;.955;3600000;0
38417;2153;459;0;0;0;0;.00nan;0;0
38417;172079;1086;0;0;0;0;.00nan;0;0
38417;9216;459;56;24;3;21;.875;3518000;0
38417;15564;1086;77;25;1;24;.960;3600000;0
38418;161695;460;38;23;4;19;.826;2634000;0
38418;179373;460;22;14;5;9;.643;966000;0
38418;179652;452;25;22;5;17;.773;3600000;0
38418;75464;452;0;0;0;0;.00nan;0;0
38419;166839;4337;42;32;5;27;.844;3600000;0
38419;203470;456;0;0;0;0;.00nan;0;0
38419;203478;456;80;33;1;32;.970;3600000;0
38419;92283;4337;0;0;0;0;.00nan;0;0
38420;208713;458;0;0;0;0;.00nan;0;0
38420;172079;1086;29;23;5;18;.783;3535000;0
38420;167492;458;85;40;3;37;.925;3600000;0
38420;15564;1086;0;0;0;0;.00nan;0;0
38421;161695;460;0;0;0;0;.00nan;0;0
38421;188429;2579;74;29;2;27;.931;3600000;0
38421;10565;2579;0;0;0;0;.00nan;0;0
38421;179373;460;33;38;7;31;.816;3600000;0
38422;203470;456;18;22;6;16;.727;3080000;0
38422;203478;456;49;1;0;1;1.000;476000;0
38422;208713;458;0;0;0;0;.00nan;0;0
38422;167492;458;92;50;4;46;.920;3600000;0
38423;213957;457;60;35;4;31;.886;3600000;0
38423;15558;457;0;0;0;0;.00nan;0;0
38423;179652;452;24;20;5;15;.750;3563000;0
38423;75464;452;0;0;0;0;.00nan;0;0
38424;166839;4337;0;0;0;0;.00nan;0;0
38424;172079;1086;0;0;0;0;.00nan;0;0
38424;15564;1086;51;26;4;22;.846;3900000;0
38424;92283;4337;61;36;4;32;.889;3900000;0
38425;2153;459;7;23;7;16;.696;3581000;0
38425;203470;456;45;27;4;23;.852;3600000;0
38425;203478;456;0;0;0;0;.00nan;0;0
38425;9216;459;0;0;0;0;.00nan;0;0
38426;213956;455;0;0;0;0;.00nan;0;0
38426;213957;457;0;0;0;0;.00nan;0;0
38426;168066;455;92;36;2;34;.944;3600000;0
38426;15558;457;58;36;5;31;.861;3600000;0
38427;161695;460;30;23;5;18;.783;2512000;0
38427;188429;2579;0;0;0;0;.00nan;0;0
38427;10565;2579;60;26;3;23;.885;3600000;0
38427;179373;460;19;9;4;5;.556;1088000;0
38428;166839;4337;0;0;0;0;.00nan;0;0
38428;213957;457;19;27;7;20;.741;3600000;0
38428;15558;457;0;0;0;0;.00nan;0;0
38428;92283;4337;74;34;3;31;.912;3600000;0
38429;161695;460;0;0;0;0;.00nan;0;0
38429;208713;458;59;6;0;6;1.000;405000;0
38429;167492;458;37;38;7;31;.816;3195000;0
38429;179373;460;63;19;2;17;.895;3600000;0
38430;2153;459;0;0;0;0;.00nan;0;0
38430;9216;459;43;32;5;27;.844;3900000;0
38430;188429;2579;46;29;5;24;.828;3900000;0
38430;10565;2579;0;0;0;0;.00nan;0;0
38431;172079;1086;0;0;0;0;.00nan;0;0
38431;15564;1086;44;38;6;32;.842;3600000;0
38431;179652;452;45;18;3;15;.833;3600000;0
38431;75464;452;0;0;0;0;.00nan;0;0
38432;2153;459;85;55;5;50;.909;3574000;0
38432;9216;459;0;0;0;0;.00nan;0;0
38432;179652;452;0;0;0;0;.00nan;0;0
38432;75464;452;55;35;4;31;.886;3600000;0
38433;172079;1086;0;0;0;0;.00nan;0;0
38433;168066;455;0;0;0;0;.00nan;0;0
38433;15564;1086;45;27;4;23;.852;3553000;0
38433;155769;455;68;34;3;31;.912;3600000;0
38434;166839;4337;68;28;2;26;.929;3600000;0
38434;213957;457;0;0;0;0;.00nan;0;0
38434;15558;457;46;23;4;19;.826;3537000;0
38434;92283;4337;0;0;0;0;.00nan;0;0
38435;203470;456;0;0;0;0;.00nan;0;0
38435;203478;456;61;23;2;21;.913;3600000;0
38435;208713;458;31;18;4;14;.778;2033000;0
38435;167492;458;16;19;6;13;.684;1567000;0
38436;166839;4337;0;0;0;0;.00nan;0;0
38436;208713;458;45;5;1;4;.800;621000;0
38436;167492;458;48;44;6;38;.864;2979000;0
38436;92283;4337;36;22;5;17;.773;3600000;0
38437;161695;460;0;0;0;0;.00nan;0;0
38437;213957;457;63;23;3;20;.870;3568000;0
38437;15558;457;0;0;0;0;.00nan;0;0
38437;179373;460;74;35;2;33;.943;3600000;0
38438;188429;2579;56;36;5;31;.861;3600000;0
38438;10565;2579;0;0;0;0;.00nan;0;0
38438;179652;452;62;24;2;22;.917;3600000;0
38438;75464;452;0;0;0;0;.00nan;0;0
38439;203470;456;18;14;5;9;.643;2150000;0
38439;203478;456;26;14;4;10;.714;1450000;0
38439;172079;1086;0;0;0;0;.00nan;0;0
38439;15564;1086;46;20;3;17;.850;3600000;0
38440;208713;458;0;0;0;0;.00nan;0;0
38440;167492;458;73;37;4;33;.892;3581000;0
38440;188429;2579;0;0;0;0;.00nan;0;0
38440;10565;2579;52;22;3;19;.864;3600000;0
38441;166839;4337;0;0;0;0;.00nan;0;0
38441;179652;452;35;29;6;23;.793;3252000;0
38441;75464;452;54;3;0;3;1.000;619000;0
38441;92283;4337;28;27;6;21;.778;3900000;0
38442;161695;460;0;0;0;0;.00nan;0;0
38442;213957;457;0;0;0;0;.00nan;0;0
38442;15558;457;80;12;0;12;1.000;3600000;0
38442;179373;460;50;42;6;36;.857;3600000;0
38443;172079;1086;0;0;0;0;.00nan;0;0
38443;168066;455;0;0;0;0;.00nan;0;0
38443;15564;1086;69;34;3;31;.912;3600000;0
38443;155769;455;45;28;4;24;.857;3575000;0
38444;2153;459;0;0;0;0;.00nan;0;0
38444;208713;458;0;0;0;0;.00nan;0;0
38444;167492;458;74;32;3;29;.906;3600000;0
38444;9216;459;42;21;4;17;.810;3555000;0
38445;161695;460;0;0;0;0;.00nan;0;0
38445;168066;455;0;0;0;0;.00nan;0;0
38445;179373;460;58;34;4;30;.882;3584000;0
38445;155769;455;62;28;3;25;.893;3600000;0
38446;166839;4337;49;7;1;6;.857;933000;0
38446;208713;458;23;24;6;18;.750;2216000;0
38446;167492;458;44;18;3;15;.833;1384000;0
38446;92283;4337;12;18;6;12;.667;2667000;0
38447;213957;457;0;0;0;0;.00nan;0;0
38447;15558;457;83;35;2;33;.943;3600000;0
38447;179652;452;35;26;5;21;.808;3600000;0
38447;75464;452;0;0;0;0;.00nan;0;0
38448;172079;1086;0;0;0;0;.00nan;0;0
38448;188429;2579;73;45;5;40;.889;3900000;0
38448;10565;2579;0;0;0;0;.00nan;0;0
38448;15564;1086;36;28;5;23;.821;3900000;0
38449;2153;459;33;38;7;31;.816;3600000;0
38449;166839;4337;66;28;3;25;.893;3600000;0
38449;9216;459;0;0;0;0;.00nan;0;0
38449;92283;4337;0;0;0;0;.00nan;0;0
38450;213957;457;55;21;3;18;.857;3600000;0
38450;203470;456;54;10;1;9;.900;1321000;0
38450;203478;456;8;23;7;16;.696;2279000;0
38450;15558;457;0;0;0;0;.00nan;0;0
38451;2153;459;0;0;0;0;.00nan;0;0
38451;166839;4337;0;0;0;0;.00nan;0;0
38451;9216;459;43;34;5;29;.853;3600000;0
38451;92283;4337;60;21;2;19;.905;3600000;0
38452;213957;457;89;34;2;32;.941;3600000;0
38452;172079;1086;0;0;0;0;.00nan;0;0
38452;15558;457;0;0;0;0;.00nan;0;0
38452;15564;1086;67;34;3;31;.912;3544000;0
38453;161695;460;13;16;6;10;.625;1644000;0
38453;188429;2579;49;35;5;30;.857;3600000;0
38453;10565;2579;0;0;0;0;.00nan;0;0
38453;179373;460;62;8;0;8;1.000;1930000;0
38454;203470;456;21;31;6;25;.806;3584000;0
38454;203478;456;0;0;0;0;.00nan;0;0
38454;179652;452;58;38;4;34;.895;3600000;0
38454;75464;452;0;0;0;0;.00nan;0;0
38455;208713;458;0;0;0;0;.00nan;0;0
38455;167492;458;47;35;6;29;.829;3600000;0
38455;168066;455;0;0;0;0;.00nan;0;0
38455;155769;455;71;26;2;24;.923;3600000;0
38456;166839;4337;0;0;0;0;.00nan;0;0
38456;203470;456;50;4;0;4;1.000;925000;0
38456;203478;456;28;26;6;20;.769;2975000;0
38456;92283;4337;11;18;6;12;.667;3900000;0
38457;208713;458;41;25;4;21;.840;2688000;0
38457;167492;458;33;16;4;12;.750;912000;0
38457;179652;452;0;0;0;0;.00nan;0;0
38457;75464;452;55;21;3;18;.857;3600000;0
38458;161695;460;0;0;0;0;.00nan;0;0
38458;188429;2579;0;0;0;0;.00nan;0;0
38458;10565;2579;53;22;3;19;.864;3577000;0
38458;179373;460;91;35;2;33;.943;3600000;0
38459;2153;459;66;45;5;40;.889;3900000;0
38459;9216;459;0;0;0;0;.00nan;0;0
38459;168066;455;0;0;0;0;.00nan;0;0
38459;155769;455;52;39;5;34;.872;3900000;0
38460;161695;460;0;0;0;0;.00nan;0;0
38460;2153;459;0;0;0;0;.00nan;0;0
38460;9216;459;67;25;3;22;.880;3600000;0
38460;179373;460;47;48;7;41;.854;3600000;0
38461;213957;457;41;27;5;22;.815;3549000;0
38461;188429;2579;83;37;3;34;.919;3600000;0
38461;10565;2579;0;0;0;0;.00nan;0;0
38461;15558;457;0;0;0;0;.00nan;0;0
38462;208713;458;0;0;0;0;.00nan;0;0
38462;172079;1086;0;0;0;0;.00nan;0;0
38462;167492;458;62;31;3;28;.903;3600000;0
38462;15564;1086;60;32;5;27;.844;3520000;0
38463;203470;456;54;39;5;34;.872;3600000;0
38463;203478;456;0;0;0;0;.00nan;0;0
38463;179652;452;62;20;2;18;.900;3600000;0
38463;75464;452;0;0;0;0;.00nan;0;0
38464;213957;457;49;13;2;11;.846;1420000;0
38464;188429;2579;0;0;0;0;.00nan;0;0
38464;10565;2579;54;26;3;23;.885;3600000;0
38464;15558;457;31;21;5;16;.762;2180000;0
38465;208713;458;0;0;0;0;.00nan;0;0
38465;172079;1086;68;26;3;23;.885;3600000;0
38465;167492;458;55;44;6;38;.864;3600000;0
38465;15564;1086;0;0;0;0;.00nan;0;0
38466;2153;459;79;35;2;33;.943;3600000;0
38466;203470;456;64;24;2;22;.917;2572000;0
38466;203478;456;15;6;4;2;.333;1028000;0
38466;9216;459;0;0;0;0;.00nan;0;0
38467;203470;456;36;27;5;22;.815;3534000;0
38467;203478;456;0;0;0;0;.00nan;0;0
38467;168066;455;0;0;0;0;.00nan;0;0
38467;155769;455;75;29;3;26;.897;3600000;0
38468;208716;457;0;0;0;0;.00nan;0;0
38468;15558;457;82;29;1;28;.966;3789000;0
38468;179652;452;76;29;2;27;.931;3789000;0
38468;75464;452;0;0;0;0;.00nan;0;0
38469;172079;1086;0;0;0;0;.00nan;0;0
38469;188429;2579;63;25;3;22;.880;3600000;0
38469;10565;2579;0;0;0;0;.00nan;0;0
38469;15564;1086;84;15;0;15;1.000;3600000;0
38470;2153;459;0;0;0;0;.00nan;0;0
38470;9216;459;79;32;2;30;.938;3600000;0
38470;168066;455;77;17;0;17;1.000;1091000;0
38470;155769;455;18;18;6;12;.667;2509000;0
38471;208716;457;23;27;6;21;.778;3567000;0
38471;15558;457;0;0;0;0;.00nan;0;0
38471;179652;452;66;33;4;29;.879;3600000;0
38471;75464;452;0;0;0;0;.00nan;0;0
38472;2153;459;27;28;6;22;.786;3043000;0
38472;203470;456;0;0;0;0;.00nan;0;0
38472;203478;456;30;31;7;24;.774;3600000;0
38472;9216;459;19;9;4;5;.556;557000;0
38473;2153;459;31;17;4;13;.765;3600000;0
38473;167492;458;0;0;0;0;.00nan;0;0
38473;9216;459;0;0;0;0;.00nan;0;0
38473;179705;458;73;32;3;29;.906;3600000;0
38474;161695;460;0;0;0;0;.00nan;0;0
38474;179373;460;71;39;4;35;.897;3553000;0
38474;179652;452;69;34;3;31;.912;3600000;0
38474;75464;452;0;0;0;0;.00nan;0;0
38475;166839;4337;0;0;0;0;.00nan;0;0
38475;188429;2579;44;35;6;29;.829;3199000;0
38475;10565;2579;53;3;0;3;1.000;401000;0
38475;92283;4337;56;25;3;22;.880;3600000;0
38476;167492;458;0;0;0;0;.00nan;0;0
38476;168066;455;0;0;0;0;.00nan;0;0
38476;179705;458;63;41;5;36;.878;3559000;0
38476;155769;455;67;33;4;29;.879;3600000;0
38477;203470;456;23;12;4;8;.667;757000;0
38477;203478;456;16;30;7;23;.767;2843000;0
38477;172079;1086;0;0;0;0;.00nan;0;0
38477;15564;1086;41;28;5;23;.821;3600000;0
38478;2153;459;0;0;0;0;.00nan;0;0
38478;9216;459;65;29;2;27;.931;3900000;0
38478;168066;455;71;32;2;30;.938;3900000;0
38478;155769;455;0;0;0;0;.00nan;0;0
38479;161695;460;25;14;4;10;.714;941000;0
38479;179373;460;66;28;4;24;.857;2659000;0
38479;179652;452;57;23;3;20;.870;3600000;0
38479;75464;452;0;0;0;0;.00nan;0;0
38480;203470;456;57;35;4;31;.886;3900000;0
38480;203478;456;0;0;0;0;.00nan;0;0
38480;172079;1086;66;34;4;30;.882;3900000;0
38480;15564;1086;0;0;0;0;.00nan;0;0
38481;166839;4337;70;22;1;21;.955;3600000;0
38481;172079;1086;0;0;0;0;.00nan;0;0
38481;15564;1086;76;54;6;48;.889;3600000;0
38481;92283;4337;0;0;0;0;.00nan;0;0
38482;203470;456;0;0;0;0;.00nan;0;0
38482;203478;456;60;32;5;27;.844;3577000;0
38482;168066;455;0;0;0;0;.00nan;0;0
38482;155769;455;66;29;3;26;.897;3600000;0
38483;166839;4337;0;0;0;0;.00nan;0;0
38483;168066;455;75;43;3;40;.930;3591000;0
38483;92283;4337;62;13;1;12;.923;3600000;0
38483;155769;455;0;0;0;0;.00nan;0;0
38484;213957;457;73;8;0;8;1.000;3600000;0
38484;167492;458;48;0;0;0;.00nan;254000;0
38484;15558;457;0;0;0;0;.00nan;0;0
38484;179705;458;32;38;7;31;.816;3346000;0
38485;188429;2579;61;25;3;22;.880;3779000;0
38485;10565;2579;0;0;0;0;.00nan;0;0
38485;179652;452;82;32;2;30;.938;3779000;0
38485;75464;452;0;0;0;0;.00nan;0;0
38486;2153;459;0;0;0;0;.00nan;0;0
38486;213957;457;53;33;4;29;.879;3566000;0
38486;9216;459;47;21;3;18;.857;3600000;0
38486;15558;457;0;0;0;0;.00nan;0;0
38487;161695;460;0;0;0;0;.00nan;0;0
38487;179373;460;69;28;3;25;.893;3600000;0
38487;179652;452;0;0;0;0;.00nan;0;0
38487;75464;452;36;27;5;22;.815;3539000;0
38488;203470;456;76;25;2;23;.920;3600000;0
38488;203478;456;0;0;0;0;.00nan;0;0
38488;172079;1086;0;0;0;0;.00nan;0;0
38488;15564;1086;66;38;5;33;.868;3600000;0
38489;161695;460;0;0;0;0;.00nan;0;0
38489;166839;4337;54;31;4;27;.871;3600000;0
38489;179373;460;19;39;8;31;.795;3600000;0
38489;92283;4337;0;0;0;0;.00nan;0;0
38490;168066;455;60;16;2;14;.875;1576000;0
38490;179652;452;75;34;3;31;.912;3600000;0
38490;75464;452;0;0;0;0;.00nan;0;0
38490;155769;455;1;16;7;9;.563;2024000;0
38491;213957;457;0;0;0;0;.00nan;0;0
38491;188429;2579;85;48;4;44;.917;3600000;0
38491;10565;2579;0;0;0;0;.00nan;0;0
38491;15558;457;29;26;5;21;.808;3545000;0
38492;166839;4337;0;0;0;0;.00nan;0;0
38492;179652;452;30;27;5;22;.815;3143000;0
38492;75464;452;45;5;1;4;.800;457000;0
38492;92283;4337;50;22;3;19;.864;3600000;0
38493;203470;456;0;0;0;0;.00nan;0;0
38493;203478;456;34;20;4;16;.800;3600000;0
38493;167492;458;0;0;0;0;.00nan;0;0
38493;179705;458;63;50;6;44;.880;3537000;0
38494;2153;459;0;0;0;0;.00nan;0;0
38494;203470;456;51;28;3;25;.893;3900000;0
38494;203478;456;0;0;0;0;.00nan;0;0
38494;9216;459;65;29;3;26;.897;3900000;0
38495;213957;457;76;20;1;19;.950;3600000;0
38495;188429;2579;0;0;0;0;.00nan;0;0
38495;10565;2579;47;28;4;24;.857;3596000;0
38495;15558;457;0;0;0;0;.00nan;0;0
38496;161695;460;0;0;0;0;.00nan;0;0
38496;168066;455;0;0;0;0;.00nan;0;0
38496;179373;460;74;28;2;26;.929;3600000;0
38496;155769;455;55;26;3;23;.885;3544000;0
38497;2153;459;29;28;6;22;.786;3310000;0
38497;213957;457;57;23;3;20;.870;3600000;0
38497;9216;459;55;3;0;3;1.000;290000;0
38497;15558;457;0;0;0;0;.00nan;0;0
38498;161695;460;0;0;0;0;.00nan;0;0
38498;203470;456;0;0;0;0;.00nan;0;0
38498;203478;456;27;23;5;18;.783;3578000;0
38498;179373;460;68;43;4;39;.907;3600000;0
38499;166839;4337;0;0;0;0;.00nan;0;0
38499;188429;2579;58;39;5;34;.872;3531000;0
38499;10565;2579;0;0;0;0;.00nan;0;0
38499;92283;4337;66;27;3;24;.889;3600000;0
38500;188429;2579;0;0;0;0;.00nan;0;0
38500;10565;2579;38;30;6;24;.800;3600000;0
38500;179652;452;93;34;1;33;.971;3600000;0
38500;75464;452;0;0;0;0;.00nan;0;0
38501;172079;1086;0;0;0;0;.00nan;0;0
38501;168066;455;0;0;0;0;.00nan;0;0
38501;15564;1086;60;32;5;27;.844;3900000;0
38501;155769;455;53;34;5;29;.853;3900000;0
38502;172079;1086;50;33;5;28;.848;3600000;0
38502;168066;455;18;26;7;19;.731;2451000;0
38502;15564;1086;0;0;0;0;.00nan;0;0
38502;155769;455;66;17;1;16;.941;1149000;0
38504;203470;456;31;18;4;14;.778;3600000;0
38504;203478;456;0;0;0;0;.00nan;0;0
38504;172079;1086;50;14;2;12;.857;1047000;0
38504;15564;1086;14;19;6;13;.684;2553000;0
38506;166839;4337;60;27;3;24;.889;3600000;0
38506;213956;455;19;31;7;24;.774;3600000;0
38506;208723;455;0;0;0;0;.00nan;0;0
38506;92283;4337;0;0;0;0;.00nan;0;0
38508;213957;457;40;23;4;19;.826;3600000;0
38508;15558;457;0;0;0;0;.00nan;0;0
38508;179652;452;65;32;3;29;.906;3600000;0
38508;75464;452;0;0;0;0;.00nan;0;0
38510;161695;460;55;34;4;30;.882;3600000;0
38510;2153;459;28;20;5;15;.750;3579000;0
38510;208725;460;0;0;0;0;.00nan;0;0
38510;9216;459;0;0;0;0;.00nan;0;0
38512;208713;458;0;0;0;0;.00nan;0;0
38512;167492;458;64;59;7;52;.881;3600000;0
38512;188429;2579;60;18;2;16;.889;3600000;0
38512;10565;2579;0;0;0;0;.00nan;0;0
38514;161695;460;0;0;0;0;.00nan;0;0
38514;208713;458;0;0;0;0;.00nan;0;0
38514;208725;460;91;30;1;29;.967;3900000;0
38514;167492;458;92;39;1;38;.974;3900000;0
38516;166839;4337;0;0;0;0;.00nan;0;0
38516;203470;456;74;29;2;27;.931;3600000;0
38516;203478;456;0;0;0;0;.00nan;0;0
38516;92283;4337;34;22;4;18;.818;3515000;0
38518;2153;459;0;0;0;0;.00nan;0;0
38518;172079;1086;0;0;0;0;.00nan;0;0
38518;9216;459;27;28;6;22;.786;3600000;0
38518;15564;1086;63;24;3;21;.875;3600000;0
38520;213957;457;33;8;3;5;.625;541000;0
38520;188429;2579;30;23;5;18;.783;3600000;0
38520;10565;2579;0;0;0;0;.00nan;0;0
38520;15558;457;55;24;3;21;.875;3059000;0
38522;213956;455;25;31;6;25;.806;3049000;0
38522;208723;455;29;7;3;4;.571;551000;0
38522;179652;452;58;19;2;17;.895;3600000;0
38522;75464;452;0;0;0;0;.00nan;0;0
38524;2153;459;18;36;8;28;.778;3600000;0
38524;166839;4337;71;31;2;29;.935;3600000;0
38524;9216;459;0;0;0;0;.00nan;0;0
38524;92283;4337;0;0;0;0;.00nan;0;0
38526;213957;457;24;20;5;15;.750;2381000;0
38526;203470;456;0;0;0;0;.00nan;0;0
38526;203478;456;44;34;5;29;.853;3600000;0
38526;15558;457;51;10;1;9;.900;1164000;0
38528;208713;458;52;43;6;37;.860;3164000;0
38528;167492;458;42;3;1;2;.667;436000;0
38528;179652;452;0;0;0;0;.00nan;0;0
38528;75464;452;40;22;4;18;.818;3600000;0
38530;161695;460;30;28;6;22;.786;3165000;0
38530;208725;460;48;0;0;0;.00nan;435000;0
38530;188429;2579;0;0;0;0;.00nan;0;0
38530;10565;2579;62;30;3;27;.900;3600000;0
38532;213956;455;0;0;0;0;.00nan;0;0
38532;172079;1086;71;30;2;28;.933;3600000;0
38532;208723;455;45;30;5;25;.833;3600000;0
38532;15564;1086;0;0;0;0;.00nan;0;0
38534;172079;1086;0;0;0;0;.00nan;0;0
38534;188429;2579;26;24;6;18;.750;3242000;0
38534;10565;2579;32;5;2;3;.600;318000;0
38534;15564;1086;43;36;6;30;.833;3600000;0
38536;161695;460;39;30;6;24;.800;3565000;0
38536;208713;458;0;0;0;0;.00nan;0;0
38536;208725;460;0;0;0;0;.00nan;0;0
38536;167492;458;44;21;4;17;.810;3600000;0
38538;2153;459;51;40;5;35;.875;3600000;0
38538;9216;459;0;0;0;0;.00nan;0;0
38538;179652;452;59;19;2;17;.895;3600000;0
38538;75464;452;0;0;0;0;.00nan;0;0
38540;166839;4337;0;0;0;0;.00nan;0;0
38540;213956;455;41;38;7;31;.816;3600000;0
38540;208723;455;0;0;0;0;.00nan;0;0
38540;92283;4337;59;31;3;28;.903;3600000;0
38542;213957;457;32;30;5;25;.833;3600000;0
38542;203470;456;38;35;6;29;.829;3552000;0
38542;203478;456;0;0;0;0;.00nan;0;0
38542;15558;457;0;0;0;0;.00nan;0;0
774;2153;459;86;40;3;37;.925;3600000;0
774;203470;456;0;0;0;0;.00nan;0;0
774;203478;456;42;19;4;15;.789;3573000;0
774;9216;459;0;0;0;0;.00nan;0;0
775;172079;1086;0;0;0;0;.00nan;0;0
775;15564;1086;41;32;5;27;.844;4134000;0
775;179652;452;27;5;3;2;.400;480000;0
775;75464;452;48;21;3;18;.857;3654000;0
781;2153;459;0;0;0;0;.00nan;0;0
781;9216;459;48;32;5;27;.844;3600000;0
781;168066;455;0;0;0;0;.00nan;0;0
781;155769;455;36;31;6;25;.806;3587000;0
782;166839;4337;0;0;0;0;.00nan;0;0
782;172079;1086;0;0;0;0;.00nan;0;0
782;15564;1086;63;33;3;30;.909;3600000;0
782;92283;4337;42;21;4;17;.810;3559000;0
858;2153;459;0;0;0;0;.00nan;0;0
858;172079;1086;68;13;1;12;.923;3048000;0
858;9216;459;51;37;5;32;.865;3635000;0
858;15564;1086;29;6;3;3;.500;587000;0
38543;20122;4715;0;0;0;0;.00nan;0;0
38543;200549;165;0;0;0;0;.00nan;0;0
38543;195283;4715;50;27;4;23;.852;3825000;0
38543;-1;165;64;29;3;26;.897;3825000;0
38544;188911;4998;79;44;4;40;.909;3600000;0
38544;194576;4998;0;0;0;0;.00nan;0;0
38544;-1;4919;0;0;0;0;.00nan;0;0
38544;202788;4919;82;24;1;23;.958;3600000;0
38545;20122;4715;0;0;0;0;.00nan;0;0
38545;200549;165;53;18;2;16;.889;3600000;0
38545;195283;4715;61;47;6;41;.872;3600000;0
38545;-1;165;0;0;0;0;.00nan;0;0
38546;188911;4998;46;32;6;26;.813;2086000;0
38546;194576;4998;70;22;1;21;.955;1514000;0
38546;-1;4919;0;0;0;0;.00nan;0;0
38546;202788;4919;62;21;2;19;.905;3600000;0
38547;164987;4714;26;26;6;20;.769;2141000;0
38547;178695;4246;0;0;0;0;.00nan;0;0
38547;86347;4714;76;18;0;18;1.000;1448000;0
38547;141850;4246;63;29;4;25;.862;3600000;0
38548;188911;4998;0;0;0;0;.00nan;0;0
38548;194576;4998;65;30;3;27;.900;3600000;0
38548;200549;165;0;0;0;0;.00nan;0;0
38548;-1;165;46;25;4;21;.840;3550000;0
38549;163462;4991;47;30;4;26;.867;3590000;0
38549;165532;4992;50;21;3;18;.857;3600000;0
38549;182210;4991;0;0;0;0;.00nan;0;0
38549;187391;4992;0;0;0;0;.00nan;0;0
38550;-1;4919;61;18;1;17;.944;3600000;0
38550;20122;4715;0;0;0;0;.00nan;0;0
38550;195283;4715;77;28;2;26;.929;3548000;0
38550;202788;4919;0;0;0;0;.00nan;0;0
38551;164987;4714;0;0;0;0;.00nan;0;0
38551;178695;4246;45;15;2;13;.867;1371000;0
38551;86347;4714;51;20;4;16;.800;3600000;0
38551;141850;4246;27;22;5;17;.773;2229000;0
38552;-1;4919;0;0;0;0;.00nan;0;0
38552;20122;4715;18;23;6;17;.739;3272000;0
38552;195283;4715;48;0;0;0;.00nan;303000;0
38552;202788;4919;57;28;4;24;.857;3600000;0
38553;188911;4998;37;32;6;26;.813;3171000;0
38553;194576;4998;55;5;0;5;1.000;398000;0
38553;200549;165;44;26;4;22;.846;3600000;0
38553;-1;165;0;0;0;0;.00nan;0;0
38554;163462;4991;81;21;1;20;.952;3600000;0
38554;165532;4992;87;44;3;41;.932;3569000;0
38554;182210;4991;0;0;0;0;.00nan;0;0
38554;187391;4992;0;0;0;0;.00nan;0;0
38555;20122;4715;80;27;2;25;.926;3865000;0
38555;200549;165;0;0;0;0;.00nan;0;0
38555;195283;4715;0;0;0;0;.00nan;0;0
38555;-1;165;74;34;3;31;.912;3879000;0
38556;176206;1368;24;30;7;23;.767;3600000;0
38556;186520;4997;82;34;3;31;.912;3600000;0
38556;-1;4997;0;0;0;0;.00nan;0;0
38556;-1;1368;0;0;0;0;.00nan;0;0
38557;20122;4715;0;0;0;0;.00nan;0;0
38557;200549;165;21;21;5;16;.762;3545000;0
38557;195283;4715;70;37;4;33;.892;3600000;0
38557;-1;165;0;0;0;0;.00nan;0;0
38558;163462;4991;41;16;4;12;.750;3600000;0
38558;164987;4714;67;18;1;17;.944;1388000;0
38558;182210;4991;0;0;0;0;.00nan;0;0
38558;86347;4714;46;24;4;20;.833;2195000;0
38559;188911;4998;35;25;6;19;.760;3247000;0
38559;194576;4998;44;4;1;3;.750;315000;0
38559;-1;4839;0;0;0;0;.00nan;0;0
38559;64925;4839;29;29;6;23;.793;3600000;0
38560;165532;4992;45;38;5;33;.868;3600000;0
38560;178695;4246;77;24;1;23;.958;3600000;0
38560;187391;4992;0;0;0;0;.00nan;0;0
38560;141850;4246;0;0;0;0;.00nan;0;0
38561;176206;1368;65;27;2;25;.926;3600000;0
38561;186520;4997;79;43;4;39;.907;3564000;0
38561;-1;4997;0;0;0;0;.00nan;0;0
38561;-1;1368;0;0;0;0;.00nan;0;0
38562;165532;4992;0;0;0;0;.00nan;0;0
38562;178695;4246;0;0;0;0;.00nan;0;0
38562;187391;4992;69;29;3;26;.897;4047000;0
38562;141850;4246;90;37;2;35;.946;4047000;0
38563;188911;4998;0;0;0;0;.00nan;0;0
38563;194576;4998;54;34;5;29;.853;3600000;0
38563;-1;4839;0;0;0;0;.00nan;0;0
38563;64925;4839;80;19;1;18;.947;3600000;0
38564;163462;4991;0;0;0;0;.00nan;0;0
38564;164987;4714;0;0;0;0;.00nan;0;0
38564;182210;4991;41;28;5;23;.821;3522000;0
38564;86347;4714;73;32;3;29;.906;3600000;0
38565;-1;4919;65;29;3;26;.897;3567000;0
38565;200549;165;0;0;0;0;.00nan;0;0
38565;-1;165;80;32;2;30;.938;3600000;0
38565;202788;4919;0;0;0;0;.00nan;0;0
38566;176206;1368;0;0;0;0;.00nan;0;0
38566;186520;4997;0;0;0;0;.00nan;0;0
38566;-1;4997;100;25;0;25;1.000;3600000;0
38566;-1;1368;39;23;4;19;.826;3600000;0
38567;20122;4715;0;0;0;0;.00nan;0;0
38567;178695;4246;47;41;6;35;.854;3317000;0
38567;195283;4715;73;20;2;18;.900;3600000;0
38567;141850;4246;39;1;1;0;.000;283000;0
38568;165532;4992;82;18;0;18;1.000;3600000;0
38568;187391;4992;0;0;0;0;.00nan;0;0
38568;-1;4839;0;0;0;0;.00nan;0;0
38568;64925;4839;61;31;4;27;.871;3600000;0
38569;188911;4998;64;51;6;45;.882;3600000;0
38569;194576;4998;0;0;0;0;.00nan;0;0
38569;-1;4919;0;0;0;0;.00nan;0;0
38569;202788;4919;68;14;1;13;.929;3600000;0
38570;163462;4991;78;25;2;23;.920;3600000;0
38570;182210;4991;0;0;0;0;.00nan;0;0
38570;186520;4997;88;39;3;36;.923;3559000;0
38570;-1;4997;0;0;0;0;.00nan;0;0
38571;165532;4992;57;27;3;24;.889;4200000;0
38571;187391;4992;0;0;0;0;.00nan;0;0
38571;-1;4839;79;37;3;34;.919;4200000;0
38571;64925;4839;0;0;0;0;.00nan;0;0
38572;20122;4715;80;37;3;34;.919;3765000;0
38572;178695;4246;0;0;0;0;.00nan;0;0
38572;195283;4715;0;0;0;0;.00nan;0;0
38572;141850;4246;67;26;2;24;.923;3765000;0
38573;188911;4998;0;0;0;0;.00nan;0;0
38573;194576;4998;78;38;3;35;.921;3600000;0
38573;200549;165;66;24;2;22;.917;3600000;0
38573;-1;165;0;0;0;0;.00nan;0;0
38574;176206;1368;45;20;4;16;.800;3857000;0
38574;186520;4997;81;36;3;33;.917;3857000;0
38574;-1;4997;0;0;0;0;.00nan;0;0
38574;-1;1368;0;0;0;0;.00nan;0;0
38575;200549;165;0;0;0;0;.00nan;0;0
38575;-1;4839;0;0;0;0;.00nan;0;0
38575;-1;165;61;33;3;30;.909;3550000;0
38575;64925;4839;59;23;2;21;.913;3600000;0
38576;-1;4919;0;0;0;0;.00nan;0;0
38576;20122;4715;0;0;0;0;.00nan;0;0
38576;195283;4715;72;39;3;36;.923;4143000;0
38576;202788;4919;59;24;2;22;.917;4143000;0
38577;163462;4991;99;38;1;37;.974;3600000;0
38577;165532;4992;53;25;3;22;.880;3600000;0
38577;182210;4991;0;0;0;0;.00nan;0;0
38577;187391;4992;0;0;0;0;.00nan;0;0
38578;164987;4714;0;0;0;0;.00nan;0;0
38578;178695;4246;22;21;6;15;.714;1646000;0
38578;86347;4714;58;30;5;25;.833;3600000;0
38578;141850;4246;75;21;1;20;.952;1928000;0
38579;176206;1368;46;25;4;21;.840;3546000;0
38579;186520;4997;0;0;0;0;.00nan;0;0
38579;-1;4997;70;26;2;24;.923;3600000;0
38579;-1;1368;0;0;0;0;.00nan;0;0
38580;164987;4714;63;36;4;32;.889;3600000;0
38580;178695;4246;0;0;0;0;.00nan;0;0
38580;86347;4714;0;0;0;0;.00nan;0;0
38580;141850;4246;76;28;1;27;.964;3600000;0
38581;188911;4998;44;44;6;38;.864;3154000;0
38581;194576;4998;67;10;0;10;1.000;1046000;0
38581;20122;4715;40;39;6;33;.846;4200000;0
38581;195283;4715;0;0;0;0;.00nan;0;0
38582;200549;165;60;34;5;29;.853;3571000;0
38582;-1;4839;47;18;3;15;.833;3600000;0
38582;-1;165;0;0;0;0;.00nan;0;0
38582;64925;4839;0;0;0;0;.00nan;0;0
38583;163462;4991;0;0;0;0;.00nan;0;0
38583;165532;4992;0;0;0;0;.00nan;0;0
38583;182210;4991;90;28;1;27;.964;3600000;0
38583;187391;4992;64;33;3;30;.909;3513000;0
38584;20122;4715;0;0;0;0;.00nan;0;0
38584;200549;165;55;26;4;22;.846;3778000;0
38584;195283;4715;46;19;3;16;.842;3778000;0
38584;-1;165;0;0;0;0;.00nan;0;0
38585;188911;4998;34;42;7;35;.833;2291000;0
38585;194576;4998;36;20;4;16;.800;1309000;0
38585;-1;4919;0;0;0;0;.00nan;0;0
38585;202788;4919;69;23;2;21;.913;3600000;0
38586;163462;4991;78;28;2;26;.929;3600000;0
38586;176206;1368;34;33;6;27;.818;3600000;0
38586;182210;4991;0;0;0;0;.00nan;0;0
38586;-1;1368;0;0;0;0;.00nan;0;0
38587;165532;4992;29;29;6;23;.793;3600000;0
38587;187391;4992;0;0;0;0;.00nan;0;0
38587;-1;4839;0;0;0;0;.00nan;0;0
38587;64925;4839;91;40;3;37;.925;3600000;0
38588;164987;4714;0;0;0;0;.00nan;0;0
38588;186520;4997;72;34;3;31;.912;3583000;0
38588;-1;4997;0;0;0;0;.00nan;0;0
38588;86347;4714;61;19;2;17;.895;3600000;0
38589;188911;4998;52;34;5;29;.853;3600000;0
38589;194576;4998;0;0;0;0;.00nan;0;0
38589;20122;4715;77;27;2;25;.926;3600000;0
38589;195283;4715;0;0;0;0;.00nan;0;0
38590;165532;4992;0;0;0;0;.00nan;0;0
38590;187391;4992;48;14;2;12;.857;3600000;0
38590;-1;4839;60;33;4;29;.879;3522000;0
38590;64925;4839;0;0;0;0;.00nan;0;0
38591;-1;4919;50;39;5;34;.872;3756000;0
38591;200549;165;0;0;0;0;.00nan;0;0
38591;-1;165;42;39;6;33;.846;3762000;0
38591;202788;4919;0;0;0;0;.00nan;0;0
38592;164987;4714;58;27;4;23;.852;3545000;0
38592;186520;4997;0;0;0;0;.00nan;0;0
38592;-1;4997;83;34;3;31;.912;3600000;0
38592;86347;4714;0;0;0;0;.00nan;0;0
38593;163462;4991;0;0;0;0;.00nan;0;0
38593;176206;1368;0;0;0;0;.00nan;0;0
38593;182210;4991;56;34;4;30;.882;3575000;0
38593;-1;1368;79;33;2;31;.939;3600000;0
38594;188911;4998;47;20;4;16;.800;961000;0
38594;194576;4998;71;41;5;36;.878;2639000;0
38594;200549;165;0;0;0;0;.00nan;0;0
38594;-1;165;69;22;2;20;.909;3600000;0
38595;-1;4919;52;4;0;4;1.000;823000;0
38595;178695;4246;0;0;0;0;.00nan;0;0
38595;202788;4919;16;22;6;16;.727;2777000;0
38595;141850;4246;63;32;3;29;.906;3600000;0
38596;163462;4991;57;19;3;16;.842;3600000;0
38596;182210;4991;0;0;0;0;.00nan;0;0
38596;186520;4997;22;40;8;32;.800;3309000;0
38596;-1;4997;52;3;0;3;1.000;291000;0
38597;20122;4715;46;11;2;9;.818;1235000;0
38597;178695;4246;0;0;0;0;.00nan;0;0
38597;195283;4715;1;26;8;18;.692;2365000;0
38597;141850;4246;74;32;2;30;.938;3600000;0
38598;188911;4998;0;0;0;0;.00nan;0;0
38598;194576;4998;61;40;5;35;.875;3607000;0
38598;200549;165;0;0;0;0;.00nan;0;0
38598;-1;165;47;24;4;20;.833;3607000;0
38599;176206;1368;72;20;1;19;.950;3600000;0
38599;-1;4839;0;0;0;0;.00nan;0;0
38599;-1;1368;0;0;0;0;.00nan;0;0
38599;64925;4839;68;34;4;30;.882;3600000;0
38600;163462;4991;74;25;1;24;.960;3600000;0
38600;164987;4714;0;0;0;0;.00nan;0;0
38600;182210;4991;0;0;0;0;.00nan;0;0
38600;86347;4714;39;28;5;23;.821;3600000;0
38601;165532;4992;34;29;6;23;.793;3600000;0
38601;186520;4997;100;44;0;44;1.000;3600000;0
38601;187391;4992;0;0;0;0;.00nan;0;0
38601;-1;4997;0;0;0;0;.00nan;0;0
38602;176206;1368;0;0;0;0;.00nan;0;0
38602;-1;4839;59;48;6;42;.875;3600000;0
38602;-1;1368;72;27;2;25;.926;3600000;0
38602;64925;4839;0;0;0;0;.00nan;0;0
38603;20122;4715;0;0;0;0;.00nan;0;0
38603;178695;4246;33;19;4;15;.789;3533000;0
38603;195283;4715;81;35;2;33;.943;3600000;0
38603;141850;4246;0;0;0;0;.00nan;0;0
38604;188911;4998;75;41;4;37;.902;3694000;0
38604;194576;4998;0;0;0;0;.00nan;0;0
38604;200549;165;49;31;5;26;.839;3694000;0
38604;-1;165;0;0;0;0;.00nan;0;0
38605;165532;4992;0;0;0;0;.00nan;0;0
38605;186520;4997;77;28;2;26;.929;4200000;0
38605;187391;4992;87;32;2;30;.938;4200000;0
38605;-1;4997;0;0;0;0;.00nan;0;0
38606;163462;4991;0;0;0;0;.00nan;0;0
38606;164987;4714;65;35;4;31;.886;3600000;0
38606;182210;4991;67;17;1;16;.941;3600000;0
38606;86347;4714;0;0;0;0;.00nan;0;0
38607;194625;165;66;29;2;27;.931;3551000;0
38607;20122;4715;0;0;0;0;.00nan;0;0
38607;200549;165;0;0;0;0;.00nan;0;0
38607;195283;4715;90;29;1;28;.966;3600000;0
38608;165532;4992;66;32;4;28;.875;3600000;0
38608;176206;1368;44;33;5;28;.848;3543000;0
38608;187391;4992;0;0;0;0;.00nan;0;0
38608;-1;1368;0;0;0;0;.00nan;0;0
38609;188911;4998;94;50;4;46;.920;3600000;0
38609;194576;4998;0;0;0;0;.00nan;0;0
38609;178695;4246;0;0;0;0;.00nan;0;0
38609;141850;4246;33;27;5;22;.815;3569000;0
38610;164987;4714;52;28;4;24;.857;3600000;0
38610;-1;4839;55;42;5;37;.881;3600000;0
38610;64925;4839;0;0;0;0;.00nan;0;0
38610;86347;4714;0;0;0;0;.00nan;0;0
38611;163462;4991;48;22;3;19;.864;3600000;0
38611;182210;4991;0;0;0;0;.00nan;0;0
38611;186520;4997;65;37;4;33;.892;3600000;0
38611;-1;4997;0;0;0;0;.00nan;0;0
38612;164987;4714;0;0;0;0;.00nan;0;0
38612;-1;4839;0;0;0;0;.00nan;0;0
38612;64925;4839;65;44;4;40;.909;4200000;0
38612;86347;4714;69;42;4;38;.905;4200000;0
38613;-1;4919;0;0;0;0;.00nan;0;0
38613;20122;4715;58;26;3;23;.885;3575000;0
38613;195283;4715;0;0;0;0;.00nan;0;0
38613;202788;4919;86;36;2;34;.944;3600000;0
38614;165532;4992;0;0;0;0;.00nan;0;0
38614;176206;1368;0;0;0;0;.00nan;0;0
38614;187391;4992;45;42;6;36;.857;3867000;0
38614;-1;1368;50;27;5;22;.815;3852000;0
38615;188911;4998;0;0;0;0;.00nan;0;0
38615;194576;4998;68;39;4;35;.897;3587000;0
38615;178695;4246;75;29;2;27;.931;3600000;0
38615;141850;4246;0;0;0;0;.00nan;0;0
38616;163462;4991;0;0;0;0;.00nan;0;0
38616;182210;4991;68;24;2;22;.917;3600000;0
38616;186520;4997;0;0;0;0;.00nan;0;0
38616;-1;4997;45;33;5;28;.848;3600000;0
38617;164987;4714;31;26;6;20;.769;1924000;0
38617;-1;4839;70;17;1;16;.941;3600000;0
38617;64925;4839;0;0;0;0;.00nan;0;0
38617;86347;4714;55;11;1;10;.909;1676000;0
38618;-1;4919;37;19;4;15;.789;1933000;0
38618;178695;4246;0;0;0;0;.00nan;0;0
38618;202788;4919;47;12;2;10;.833;1667000;0
38618;141850;4246;67;32;3;29;.906;3600000;0
38619;164987;4714;0;0;0;0;.00nan;0;0
38619;178695;4246;0;0;0;0;.00nan;0;0
38619;86347;4714;53;37;5;32;.865;3753000;0
38619;141850;4246;39;36;6;30;.833;3753000;0
38620;-1;4919;0;0;0;0;.00nan;0;0
38620;20122;4715;50;3;0;3;1.000;585000;0
38620;195283;4715;26;29;6;23;.793;3015000;0
38620;202788;4919;67;29;3;26;.897;3600000;0
38621;163462;4991;76;18;1;17;.944;4200000;0
38621;176206;1368;85;36;1;35;.972;4200000;0
38621;182210;4991;0;0;0;0;.00nan;0;0
38621;-1;1368;0;0;0;0;.00nan;0;0
38622;194625;165;0;0;0;0;.00nan;0;0
38622;200549;165;62;35;3;32;.914;3584000;0
38622;-1;4839;0;0;0;0;.00nan;0;0
38622;64925;4839;79;27;1;26;.963;3600000;0
38623;165532;4992;33;32;6;26;.813;3583000;0
38623;186520;4997;49;30;5;25;.833;3600000;0
38623;187391;4992;0;0;0;0;.00nan;0;0
38623;-1;4997;0;0;0;0;.00nan;0;0
38624;194625;165;61;28;3;25;.893;3804000;0
38624;200549;165;0;0;0;0;.00nan;0;0
38624;-1;4839;98;38;2;36;.947;3804000;0
38624;64925;4839;0;0;0;0;.00nan;0;0
38625;164987;4714;64;39;4;35;.897;3600000;0
38625;178695;4246;96;25;0;25;1.000;3600000;0
38625;86347;4714;0;0;0;0;.00nan;0;0
38625;141850;4246;0;0;0;0;.00nan;0;0
38626;163462;4991;0;0;0;0;.00nan;0;0
38626;176206;1368;0;0;0;0;.00nan;0;0
38626;182210;4991;80;24;1;23;.958;3600000;0
38626;-1;1368;74;41;3;38;.927;3552000;0
38627;188911;4998;86;49;4;45;.918;3559000;0
38627;194576;4998;0;0;0;0;.00nan;0;0
38627;-1;4919;64;24;2;22;.917;3600000;0
38627;202788;4919;0;0;0;0;.00nan;0;0
38628;165532;4992;0;0;0;0;.00nan;0;0
38628;186520;4997;0;0;0;0;.00nan;0;0
38628;187391;4992;88;27;1;26;.963;3600000;0
38628;-1;4997;38;34;6;28;.824;3600000;0
38629;163462;4991;37;19;4;15;.789;3567000;0
38629;182210;4991;0;0;0;0;.00nan;0;0
38629;186520;4997;95;37;3;34;.919;3600000;0
38629;-1;4997;0;0;0;0;.00nan;0;0
38630;188911;4998;51;39;6;33;.846;3525000;0
38630;194576;4998;0;0;0;0;.00nan;0;0
38630;194625;165;49;26;4;22;.846;3600000;0
38630;200549;165;0;0;0;0;.00nan;0;0
38631;-1;4919;0;0;0;0;.00nan;0;0
38631;20122;4715;0;0;0;0;.00nan;0;0
38631;195283;4715;36;38;8;30;.789;3600000;0
38631;202788;4919;54;36;5;31;.861;3600000;0
38632;178695;4246;86;30;2;28;.933;3600000;0
38632;-1;4839;0;0;0;0;.00nan;0;0
38632;64925;4839;68;42;4;38;.905;3600000;0
38632;141850;4246;0;0;0;0;.00nan;0;0
38633;163462;4991;0;0;0;0;.00nan;0;0
38633;176206;1368;0;0;0;0;.00nan;0;0
38633;182210;4991;49;33;5;28;.848;3600000;0
38633;-1;1368;36;31;6;25;.806;3555000;0
38634;165532;4992;66;22;2;20;.909;3600000;0
38634;186520;4997;0;0;0;0;.00nan;0;0
38634;187391;4992;0;0;0;0;.00nan;0;0
38634;-1;4997;49;33;5;28;.848;3600000;0
38635;164987;4714;0;0;0;0;.00nan;0;0
38635;-1;4839;27;30;6;24;.800;2267000;0
38635;64925;4839;51;11;1;10;.909;1333000;0
38635;86347;4714;50;17;2;15;.882;3600000;0
38636;188911;4998;41;9;2;7;.778;847000;0
38636;194576;4998;17;29;7;22;.759;2753000;0
38636;20122;4715;61;26;3;23;.885;3600000;0
38636;195283;4715;0;0;0;0;.00nan;0;0
38637;-1;4919;52;25;4;21;.840;3600000;0
38637;194625;165;0;0;0;0;.00nan;0;0
38637;200549;165;50;31;5;26;.839;3582000;0
38637;202788;4919;0;0;0;0;.00nan;0;0
38638;165532;4992;54;25;4;21;.840;3600000;0
38638;176206;1368;5;31;8;23;.742;3123000;0
38638;187391;4992;0;0;0;0;.00nan;0;0
38638;-1;1368;54;5;0;5;1.000;477000;0
38639;163462;4991;45;24;4;20;.833;3583000;0
38639;182210;4991;0;0;0;0;.00nan;0;0
38639;186520;4997;95;40;2;38;.950;3600000;0
38639;-1;4997;0;0;0;0;.00nan;0;0
38640;-1;4919;0;0;0;0;.00nan;0;0
38640;194625;165;53;12;1;11;.917;1328000;0
38640;200549;165;18;22;6;16;.727;2210000;0
38640;202788;4919;60;39;5;34;.872;3600000;0
38641;165532;4992;87;42;2;40;.952;3844000;0
38641;187391;4992;0;0;0;0;.00nan;0;0
38641;-1;4839;0;0;0;0;.00nan;0;0
38641;64925;4839;77;39;3;36;.923;3881000;0
38642;164987;4714;0;0;0;0;.00nan;0;0
38642;188911;4998;87;30;1;29;.967;3600000;0
38642;194576;4998;0;0;0;0;.00nan;0;0
38642;86347;4714;50;20;3;17;.850;3515000;0
38643;20122;4715;0;0;0;0;.00nan;0;0
38643;178695;4246;0;0;0;0;.00nan;0;0
38643;195283;4715;56;30;5;25;.833;3600000;0
38643;141850;4246;54;19;3;16;.842;3600000;0
38644;176206;1368;54;25;3;22;.880;3600000;0
38644;-1;4839;59;34;4;30;.882;3570000;0
38644;-1;1368;0;0;0;0;.00nan;0;0
38644;64925;4839;0;0;0;0;.00nan;0;0
38645;20122;4715;70;54;6;48;.889;3573000;0
38645;178695;4246;38;19;4;15;.789;3600000;0
38645;195283;4715;0;0;0;0;.00nan;0;0
38645;141850;4246;0;0;0;0;.00nan;0;0
38646;164987;4714;34;21;4;17;.810;3600000;0
38646;188911;4998;0;0;0;0;.00nan;0;0
38646;194576;4998;81;26;1;25;.962;3600000;0
38646;86347;4714;0;0;0;0;.00nan;0;0
38647;-1;4919;59;44;5;39;.886;3600000;0
38647;194625;165;64;24;2;22;.917;3600000;0
38647;200549;165;0;0;0;0;.00nan;0;0
38647;202788;4919;0;0;0;0;.00nan;0;0
38648;163462;4991;0;0;0;0;.00nan;0;0
38648;182210;4991;58;27;3;24;.889;3600000;0
38648;186520;4997;69;53;6;47;.887;3600000;0
38648;-1;4997;0;0;0;0;.00nan;0;0
38649;164987;4714;54;9;1;8;.889;525000;0
38649;178695;4246;53;4;0;4;1.000;686000;0
38649;86347;4714;12;21;6;15;.714;3197000;0
38649;141850;4246;33;25;6;19;.760;3036000;0
38650;194625;165;0;0;0;0;.00nan;0;0
38650;20122;4715;0;0;0;0;.00nan;0;0
38650;200549;165;40;24;4;20;.833;4087000;0
38650;195283;4715;48;38;5;33;.868;4087000;0
38651;188911;4998;46;25;4;21;.840;3600000;0
38651;194576;4998;0;0;0;0;.00nan;0;0
38651;-1;4919;29;23;5;18;.783;3592000;0
38651;202788;4919;0;0;0;0;.00nan;0;0
38652;176206;1368;0;0;0;0;.00nan;0;0
38652;-1;4839;0;0;0;0;.00nan;0;0
38652;-1;1368;59;29;3;26;.897;3600000;0
38652;64925;4839;61;36;4;32;.889;3592000;0
38653;163462;4991;65;27;3;24;.889;3600000;0
38653;182210;4991;0;0;0;0;.00nan;0;0
38653;186520;4997;43;31;5;26;.839;3600000;0
38653;-1;4997;0;0;0;0;.00nan;0;0
38654;176206;1368;22;17;5;12;.706;1850000;0
38654;-1;4839;0;0;0;0;.00nan;0;0
38654;-1;1368;79;22;1;21;.955;1750000;0
38654;64925;4839;66;27;2;25;.926;3600000;0
38655;188911;4998;70;54;6;48;.889;3939000;0
38655;194576;4998;0;0;0;0;.00nan;0;0
38655;194625;165;29;28;7;21;.750;3905000;0
38655;200549;165;0;0;0;0;.00nan;0;0
38656;164987;4714;81;40;3;37;.925;3600000;0
38656;178695;4246;36;29;6;23;.793;3600000;0
38656;86347;4714;0;0;0;0;.00nan;0;0
38656;141850;4246;0;0;0;0;.00nan;0;0
38657;-1;4919;0;0;0;0;.00nan;0;0
38657;20122;4715;0;0;0;0;.00nan;0;0
38657;195283;4715;49;36;5;31;.861;3600000;0
38657;202788;4919;68;34;4;30;.882;3600000;0
38658;163462;4991;0;0;0;0;.00nan;0;0
38658;182210;4991;28;27;6;21;.778;3525000;0
38658;186520;4997;57;30;4;26;.867;3600000;0
38658;-1;4997;0;0;0;0;.00nan;0;0
38659;164987;4714;60;17;2;15;.882;1337000;0
38659;178695;4246;0;0;0;0;.00nan;0;0
38659;86347;4714;19;26;7;19;.731;2263000;0
38659;141850;4246;48;24;3;21;.875;3600000;0
38660;176206;1368;72;29;3;26;.897;3600000;0
38660;-1;4839;53;36;5;31;.861;3541000;0
38660;-1;1368;0;0;0;0;.00nan;0;0
38660;64925;4839;0;0;0;0;.00nan;0;0
38661;188911;4998;80;32;2;30;.938;3600000;0
38661;194576;4998;0;0;0;0;.00nan;0;0
38661;194625;165;0;0;0;0;.00nan;0;0
38661;200549;165;43;27;4;23;.852;3524000;0
38662;-1;4919;51;23;3;20;.870;3600000;0
38662;20122;4715;0;0;0;0;.00nan;0;0
38662;195283;4715;65;35;4;31;.886;3600000;0
38662;202788;4919;0;0;0;0;.00nan;0;0
38663;163462;4991;0;0;0;0;.00nan;0;0
38663;164987;4714;0;0;0;0;.00nan;0;0
38663;182210;4991;53;15;2;13;.867;3787000;0
38663;86347;4714;72;33;3;30;.909;3787000;0
38664;163462;4991;81;30;2;28;.933;3600000;0
38664;164987;4714;65;34;3;31;.912;3545000;0
38664;182210;4991;0;0;0;0;.00nan;0;0
38664;86347;4714;0;0;0;0;.00nan;0;0
38665;188911;4998;78;33;3;30;.909;3600000;0
38665;194576;4998;0;0;0;0;.00nan;0;0
38665;20122;4715;39;20;4;16;.800;1764000;0
38665;195283;4715;19;14;5;9;.643;1836000;0
38666;-1;4919;0;0;0;0;.00nan;0;0
38666;178695;4246;0;0;0;0;.00nan;0;0
38666;202788;4919;53;37;6;31;.838;3600000;0
38666;141850;4246;57;25;3;22;.880;3600000;0
38667;165532;4992;58;36;5;31;.861;3600000;0
38667;176206;1368;0;0;0;0;.00nan;0;0
38667;187391;4992;0;0;0;0;.00nan;0;0
38667;-1;1368;60;22;2;20;.909;3600000;0
38668;164987;4714;0;0;0;0;.00nan;0;0
38668;-1;4839;0;0;0;0;.00nan;0;0
38668;64925;4839;77;28;2;26;.929;3600000;0
38668;86347;4714;73;30;3;27;.900;3564000;0
38669;163462;4991;0;0;0;0;.00nan;0;0
38669;182210;4991;92;14;0;14;1.000;3600000;0
38669;186520;4997;98;37;2;35;.946;3530000;0
38669;-1;4997;0;0;0;0;.00nan;0;0
38670;164987;4714;97;25;0;25;1.000;3600000;0
38670;-1;4839;7;16;6;10;.625;1628000;0
38670;64925;4839;51;13;2;11;.846;1972000;0
38670;86347;4714;0;0;0;0;.00nan;0;0
38671;194625;165;0;0;0;0;.00nan;0;0
38671;178695;4246;87;34;2;32;.941;4200000;0
38671;200549;165;79;30;2;28;.933;4200000;0
38671;141850;4246;0;0;0;0;.00nan;0;0
38672;165532;4992;0;0;0;0;.00nan;0;0
38672;176206;1368;87;32;2;30;.938;4200000;0
38672;187391;4992;64;27;2;25;.926;4200000;0
38672;-1;1368;0;0;0;0;.00nan;0;0
38673;188911;4998;54;44;6;38;.864;3600000;0
38673;194576;4998;0;0;0;0;.00nan;0;0
38673;-1;4919;51;15;2;13;.867;3600000;0
38673;202788;4919;0;0;0;0;.00nan;0;0
38674;163462;4991;0;0;0;0;.00nan;0;0
38674;182210;4991;80;31;2;29;.935;3600000;0
38674;186520;4997;67;44;5;39;.886;3600000;0
38674;-1;4997;0;0;0;0;.00nan;0;0
38675;163462;4991;33;18;4;14;.778;3586000;0
38675;165532;4992;81;34;2;32;.941;3600000;0
38675;182210;4991;0;0;0;0;.00nan;0;0
38675;187391;4992;0;0;0;0;.00nan;0;0
38676;165532;4992;71;30;3;27;.900;3961000;0
38676;187391;4992;0;0;0;0;.00nan;0;0
38676;-1;4839;0;0;0;0;.00nan;0;0
38676;64925;4839;88;39;2;37;.949;3961000;0
38677;164987;4714;55;30;3;27;.900;3600000;0
38677;-1;4919;0;0;0;0;.00nan;0;0
38677;202788;4919;41;28;5;23;.821;3568000;0
38677;86347;4714;0;0;0;0;.00nan;0;0
38678;188911;4998;74;36;4;32;.889;3600000;0
38678;194576;4998;0;0;0;0;.00nan;0;0
38678;194625;165;59;6;0;6;1.000;637000;0
38678;200549;165;43;26;5;21;.808;2916000;0
38679;165532;4992;0;0;0;0;.00nan;0;0
38679;178695;4246;0;0;0;0;.00nan;0;0
38679;187391;4992;53;18;2;16;.889;3600000;0
38679;141850;4246;87;42;3;39;.929;3600000;0
38680;20122;4715;56;13;1;12;.923;1631000;0
38680;195283;4715;11;25;7;18;.720;1969000;0
38680;176206;1368;0;0;0;0;.00nan;0;0
38680;-1;1368;64;19;2;17;.895;3600000;0
38681;163462;4991;0;0;0;0;.00nan;0;0
38681;182210;4991;69;30;3;27;.900;4200000;0
38681;186520;4997;82;33;3;30;.909;4200000;0
38681;-1;4997;0;0;0;0;.00nan;0;0
38682;164987;4714;0;0;0;0;.00nan;0;0
38682;-1;4919;60;24;2;22;.917;4200000;0
38682;202788;4919;0;0;0;0;.00nan;0;0
38682;86347;4714;72;29;2;27;.931;4200000;0
38683;188911;4998;70;34;3;31;.912;3590000;0
38683;194576;4998;0;0;0;0;.00nan;0;0
38683;194625;165;81;26;1;25;.962;3600000;0
38683;200549;165;0;0;0;0;.00nan;0;0
38684;165532;4992;80;27;1;26;.963;3600000;0
38684;178695;4246;61;26;3;23;.885;3533000;0
38684;187391;4992;0;0;0;0;.00nan;0;0
38684;141850;4246;0;0;0;0;.00nan;0;0
38685;20122;4715;0;0;0;0;.00nan;0;0
38685;195283;4715;72;35;5;30;.857;3893000;0
38685;176206;1368;63;31;4;27;.871;3893000;0
38685;-1;1368;0;0;0;0;.00nan;0;0
38686;163462;4991;78;27;1;26;.963;3600000;0
38686;182210;4991;0;0;0;0;.00nan;0;0
38686;186520;4997;87;34;2;32;.941;3600000;0
38686;-1;4997;0;0;0;0;.00nan;0;0
38687;164987;4714;71;30;3;27;.900;3577000;0
38687;-1;4919;0;0;0;0;.00nan;0;0
38687;202788;4919;75;19;1;18;.947;3600000;0
38687;86347;4714;0;0;0;0;.00nan;0;0
38688;188911;4998;50;38;5;33;.868;3554000;0
38688;194576;4998;0;0;0;0;.00nan;0;0
38688;194625;165;59;23;3;20;.870;3600000;0
38688;200549;165;0;0;0;0;.00nan;0;0
38689;-1;4919;0;0;0;0;.00nan;0;0
38689;20122;4715;77;30;2;28;.933;3600000;0
38689;195283;4715;0;0;0;0;.00nan;0;0
38689;202788;4919;60;33;4;29;.879;3586000;0
38690;165532;4992;12;28;9;19;.679;3600000;0
38690;176206;1368;0;0;0;0;.00nan;0;0
38690;187391;4992;0;0;0;0;.00nan;0;0
38690;-1;1368;81;25;1;24;.960;3600000;0
38691;164987;4714;45;20;4;16;.800;2479000;0
38691;178695;4246;0;0;0;0;.00nan;0;0
38691;86347;4714;26;11;4;7;.636;1121000;0
38691;141850;4246;59;22;2;20;.909;3600000;0
38692;163462;4991;0;0;0;0;.00nan;0;0
38692;182210;4991;43;29;5;24;.828;3600000;0
38692;-1;4839;56;3;0;3;1.000;477000;0
38692;64925;4839;21;25;7;18;.720;3117000;0
38693;163462;4991;61;27;3;24;.889;3600000;0
38693;182210;4991;0;0;0;0;.00nan;0;0
38693;-1;4839;47;29;5;24;.828;3574000;0
38693;64925;4839;0;0;0;0;.00nan;0;0
38694;165532;4992;0;0;0;0;.00nan;0;0
38694;176206;1368;57;26;3;23;.885;3600000;0
38694;187391;4992;34;34;6;28;.824;3600000;0
38694;-1;1368;0;0;0;0;.00nan;0;0
38695;188911;4998;52;42;7;35;.833;3600000;0
38695;194576;4998;0;0;0;0;.00nan;0;0
38695;194625;165;0;0;0;0;.00nan;0;0
38695;200549;165;76;28;1;27;.964;3600000;0
38696;-1;4919;95;39;3;36;.923;3600000;0
38696;20122;4715;0;0;0;0;.00nan;0;0
38696;195283;4715;24;18;5;13;.722;3570000;0
38696;202788;4919;0;0;0;0;.00nan;0;0
38697;164987;4714;0;0;0;0;.00nan;0;0
38697;178695;4246;74;24;1;23;.958;3600000;0
38697;86347;4714;36;32;6;26;.813;3600000;0
38697;141850;4246;0;0;0;0;.00nan;0;0
38698;164987;4714;52;30;4;26;.867;3535000;0
38698;20122;4715;0;0;0;0;.00nan;0;0
38698;195283;4715;84;31;2;29;.935;3600000;0
38698;86347;4714;0;0;0;0;.00nan;0;0
38699;164987;4714;0;0;0;0;.00nan;0;0
38699;20122;4715;0;0;0;0;.00nan;0;0
38699;195283;4715;50;42;6;36;.857;3600000;0
38699;86347;4714;45;12;2;10;.833;3600000;0
38700;-1;4919;0;0;0;0;.00nan;0;0
38700;194625;165;0;0;0;0;.00nan;0;0
38700;200549;165;79;29;2;27;.931;3600000;0
38700;202788;4919;71;27;3;24;.889;3600000;0
38701;165532;4992;99;35;1;34;.971;3600000;0
38701;178695;4246;48;16;2;14;.875;2691000;0
38701;187391;4992;0;0;0;0;.00nan;0;0
38701;141850;4246;25;9;4;5;.556;909000;0
38702;176206;1368;0;0;0;0;.00nan;0;0
38702;186520;4997;66;33;3;30;.909;3600000;0
38702;-1;4997;0;0;0;0;.00nan;0;0
38702;-1;1368;100;31;0;31;1.000;3600000;0
38703;163462;4991;0;0;0;0;.00nan;0;0
38703;182210;4991;49;19;3;16;.842;3600000;0
38703;-1;4839;0;0;0;0;.00nan;0;0
38703;64925;4839;85;50;4;46;.920;3600000;0
38704;165532;4992;0;0;0;0;.00nan;0;0
38704;178695;4246;0;0;0;0;.00nan;0;0
38704;187391;4992;60;36;4;32;.889;3600000;0
38704;141850;4246;26;28;6;22;.786;3600000;0
38705;188911;4998;50;34;5;29;.853;3600000;0
38705;194576;4998;0;0;0;0;.00nan;0;0
38705;-1;4919;56;19;2;17;.895;3600000;0
38705;202788;4919;0;0;0;0;.00nan;0;0
38706;194625;165;59;25;3;22;.880;3600000;0
38706;20122;4715;0;0;0;0;.00nan;0;0
38706;200549;165;0;0;0;0;.00nan;0;0
38706;195283;4715;56;37;5;32;.865;3588000;0
38707;176206;1368;65;17;1;16;.941;3050000;0
38707;186520;4997;0;0;0;0;.00nan;0;0
38707;-1;4997;38;36;5;31;.861;4200000;0
38707;-1;1368;19;9;4;5;.556;1150000;0
38708;163462;4991;79;27;1;26;.963;3600000;0
38708;182210;4991;0;0;0;0;.00nan;0;0
38708;-1;4839;53;35;5;30;.857;3600000;0
38708;64925;4839;0;0;0;0;.00nan;0;0
38709;165532;4992;33;36;6;30;.833;3550000;0
38709;178695;4246;73;43;5;38;.884;3600000;0
38709;187391;4992;0;0;0;0;.00nan;0;0
38709;141850;4246;0;0;0;0;.00nan;0;0
38710;194625;165;58;4;0;4;1.000;1014000;0
38710;178695;4246;0;0;0;0;.00nan;0;0
38710;200549;165;27;27;6;21;.778;2531000;0
38710;141850;4246;49;32;5;27;.844;3600000;0
38711;164987;4714;45;18;3;15;.833;4200000;0
38711;20122;4715;0;0;0;0;.00nan;0;0
38711;195283;4715;82;46;3;43;.935;4200000;0
38711;86347;4714;0;0;0;0;.00nan;0;0
38712;165532;4992;51;39;6;33;.846;3511000;0
38712;186520;4997;34;18;4;14;.778;3600000;0
38712;187391;4992;0;0;0;0;.00nan;0;0
38712;-1;4997;0;0;0;0;.00nan;0;0
38713;188911;4998;46;30;5;25;.833;3557000;0
38713;194576;4998;0;0;0;0;.00nan;0;0
38713;-1;4839;0;0;0;0;.00nan;0;0
38713;64925;4839;55;26;4;22;.846;3600000;0
38714;163462;4991;89;29;2;27;.931;3600000;0
38714;176206;1368;69;44;4;40;.909;3562000;0
38714;182210;4991;0;0;0;0;.00nan;0;0
38714;-1;1368;0;0;0;0;.00nan;0;0
38715;188911;4998;0;0;0;0;.00nan;0;0
38715;194576;4998;75;40;4;36;.900;3877000;0
38715;-1;4839;61;31;3;28;.903;3877000;0
38715;64925;4839;0;0;0;0;.00nan;0;0
38716;165532;4992;77;26;1;25;.962;3600000;0
38716;186520;4997;53;30;5;25;.833;3600000;0
38716;187391;4992;0;0;0;0;.00nan;0;0
38716;-1;4997;0;0;0;0;.00nan;0;0
38717;164987;4714;0;0;0;0;.00nan;0;0
38717;20122;4715;66;36;4;32;.889;3829000;0
38717;195283;4715;0;0;0;0;.00nan;0;0
38717;86347;4714;68;31;3;28;.903;3829000;0
38718;163462;4991;0;0;0;0;.00nan;0;0
38718;176206;1368;0;0;0;0;.00nan;0;0
38718;182210;4991;60;23;2;21;.913;3514000;0
38718;-1;1368;93;20;0;20;1.000;3600000;0
38719;-1;4919;0;0;0;0;.00nan;0;0
38719;178695;4246;54;32;5;27;.844;3600000;0
38719;202788;4919;74;26;3;23;.885;3600000;0
38719;141850;4246;0;0;0;0;.00nan;0;0
38720;165532;4992;32;17;4;13;.765;1231000;0
38720;186520;4997;41;32;6;26;.813;3330000;0
38720;187391;4992;35;19;4;15;.789;2331000;0
38720;-1;4997;55;3;0;3;1.000;270000;0
38721;-1;4919;36;26;6;20;.769;2540000;0
38721;178695;4246;0;0;0;0;.00nan;0;0
38721;202788;4919;54;10;1;9;.900;1037000;0
38721;141850;4246;34;23;5;18;.783;3600000;0
38722;176206;1368;0;0;0;0;.00nan;0;0
38722;-1;4839;0;0;0;0;.00nan;0;0
38722;-1;1368;98;19;0;19;1.000;3600000;0
38722;64925;4839;63;39;4;35;.897;3600000;0
38723;188911;4998;58;33;4;29;.879;3545000;0
38723;194576;4998;0;0;0;0;.00nan;0;0
38723;20122;4715;0;0;0;0;.00nan;0;0
38723;195283;4715;67;20;2;18;.900;3600000;0
38724;164987;4714;18;22;6;16;.727;2762000;0
38724;-1;4919;0;0;0;0;.00nan;0;0
38724;202788;4919;51;29;4;25;.862;3600000;0
38724;86347;4714;65;14;1;13;.929;838000;0
38725;176206;1368;32;24;5;19;.792;3562000;0
38725;186520;4997;54;21;3;18;.857;3600000;0
38725;-1;4997;0;0;0;0;.00nan;0;0
38725;-1;1368;0;0;0;0;.00nan;0;0
38726;194625;165;0;0;0;0;.00nan;0;0
38726;178695;4246;0;0;0;0;.00nan;0;0
38726;200549;165;70;31;3;28;.903;3865000;0
38726;141850;4246;85;33;2;31;.939;3865000;0
38727;194625;165;58;11;1;10;.909;3600000;0
38727;178695;4246;0;0;0;0;.00nan;0;0
38727;200549;165;0;0;0;0;.00nan;0;0
38727;141850;4246;58;36;5;31;.861;3600000;0
38728;164987;4714;0;0;0;0;.00nan;0;0
38728;-1;4919;34;29;5;24;.828;3600000;0
38728;202788;4919;0;0;0;0;.00nan;0;0
38728;86347;4714;83;31;2;29;.935;3600000;0
38729;188911;4998;52;3;0;3;1.000;261000;0
38729;194576;4998;28;29;6;23;.793;3290000;0
38729;20122;4715;61;40;5;35;.875;3600000;0
38729;195283;4715;0;0;0;0;.00nan;0;0
38730;165532;4992;79;30;3;27;.900;3520000;0
38730;187391;4992;0;0;0;0;.00nan;0;0
38730;-1;4839;0;0;0;0;.00nan;0;0
38730;64925;4839;91;35;1;34;.971;3600000;0
38731;163462;4991;45;22;4;18;.818;3848000;0
38731;176206;1368;0;0;0;0;.00nan;0;0
38731;182210;4991;0;0;0;0;.00nan;0;0
38731;-1;1368;93;45;3;42;.933;3848000;0
38732;194625;165;0;0;0;0;.00nan;0;0
38732;20122;4715;46;19;3;16;.842;1131000;0
38732;200549;165;96;32;1;31;.969;3600000;0
38732;195283;4715;16;20;6;14;.700;2469000;0
38733;194625;165;0;0;0;0;.00nan;0;0
38733;20122;4715;0;0;0;0;.00nan;0;0
38733;200549;165;96;32;1;31;.969;3600000;0
38733;195283;4715;77;29;2;27;.931;3558000;0
38734;165532;4992;83;33;2;31;.939;3600000;0
38734;187391;4992;0;0;0;0;.00nan;0;0
38734;-1;4839;0;0;0;0;.00nan;0;0
38734;64925;4839;59;26;3;23;.885;3561000;0
38735;164987;4714;74;29;3;26;.897;3695000;0
38735;178695;4246;0;0;0;0;.00nan;0;0
38735;86347;4714;0;0;0;0;.00nan;0;0
38735;141850;4246;67;33;2;31;.939;3695000;0
38736;165532;4992;54;13;2;11;.846;3600000;0
38736;20122;4715;52;2;0;2;1.000;404000;0
38736;195283;4715;19;35;8;27;.771;3196000;0
38736;187391;4992;0;0;0;0;.00nan;0;0
38737;188911;4998;0;0;0;0;.00nan;0;0
38737;194576;4998;63;29;3;26;.897;3600000;0
38737;-1;4919;0;0;0;0;.00nan;0;0
38737;202788;4919;62;24;2;22;.917;3600000;0
38738;176206;1368;75;28;2;26;.929;3600000;0
38738;186520;4997;72;40;4;36;.900;3544000;0
38738;-1;4997;0;0;0;0;.00nan;0;0
38738;-1;1368;0;0;0;0;.00nan;0;0
38739;163462;4991;80;11;0;11;1.000;3600000;0
38739;182210;4991;0;0;0;0;.00nan;0;0
38739;-1;4839;0;0;0;0;.00nan;0;0
38739;64925;4839;76;40;4;36;.900;3600000;0
38740;164987;4714;0;0;0;0;.00nan;0;0
38740;178695;4246;80;31;1;30;.968;3600000;0
38740;86347;4714;56;32;4;28;.875;3587000;0
38740;141850;4246;0;0;0;0;.00nan;0;0
38741;165532;4992;77;26;1;25;.962;3600000;0
38741;20122;4715;71;33;3;30;.909;3514000;0
38741;195283;4715;0;0;0;0;.00nan;0;0
38741;187391;4992;0;0;0;0;.00nan;0;0
38742;176206;1368;0;0;0;0;.00nan;0;0
38742;186520;4997;79;34;3;31;.912;3600000;0
38742;-1;4997;0;0;0;0;.00nan;0;0
38742;-1;1368;32;22;5;17;.773;3600000;0
38743;188911;4998;61;36;4;32;.889;3600000;0
38743;194576;4998;0;0;0;0;.00nan;0;0
38743;-1;4919;27;6;3;3;.500;431000;0
38743;202788;4919;64;24;2;22;.917;3169000;0
38744;163462;4991;21;23;6;17;.739;3600000;0
38744;182210;4991;0;0;0;0;.00nan;0;0
38744;-1;4839;71;29;2;27;.931;3600000;0
38744;64925;4839;0;0;0;0;.00nan;0;0
38745;188911;4998;0;0;0;0;.00nan;0;0
38745;194576;4998;59;60;8;52;.867;3600000;0
38745;-1;4919;0;0;0;0;.00nan;0;0
38745;202788;4919;64;19;2;17;.895;3600000;0
38746;-1;4919;0;0;0;0;.00nan;0;0
38746;194625;165;0;0;0;0;.00nan;0;0
38746;200549;165;16;15;5;10;.667;3563000;0
38746;202788;4919;72;34;4;30;.882;3600000;0
38747;188911;4998;74;39;4;35;.897;3600000;0
38747;194576;4998;0;0;0;0;.00nan;0;0
38747;20122;4715;0;0;0;0;.00nan;0;0
38747;195283;4715;49;33;5;28;.848;3558000;0
38748;163462;4991;42;33;6;27;.818;3579000;0
38748;165532;4992;39;22;4;18;.818;2306000;0
38748;182210;4991;0;0;0;0;.00nan;0;0
38748;187391;4992;74;20;1;19;.950;1294000;0
38749;186520;4997;60;19;2;17;.895;3600000;0
38749;-1;4839;49;35;5;30;.857;3600000;0
38749;-1;4997;0;0;0;0;.00nan;0;0
38749;64925;4839;0;0;0;0;.00nan;0;0
38750;178695;4246;0;0;0;0;.00nan;0;0
38750;176206;1368;58;28;4;24;.857;3871000;0
38750;-1;1368;0;0;0;0;.00nan;0;0
38750;141850;4246;84;40;3;37;.925;3871000;0
38751;163462;4991;0;0;0;0;.00nan;0;0
38751;182210;4991;86;27;1;26;.963;4200000;0
38751;-1;4839;0;0;0;0;.00nan;0;0
38751;64925;4839;96;43;1;42;.977;4200000;0
38752;178695;4246;0;0;0;0;.00nan;0;0
38752;176206;1368;0;0;0;0;.00nan;0;0
38752;-1;1368;81;38;3;35;.921;3600000;0
38752;141850;4246;40;22;4;18;.818;3566000;0
38753;-1;4919;0;0;0;0;.00nan;0;0
38753;194625;165;54;22;3;19;.864;3600000;0
38753;200549;165;0;0;0;0;.00nan;0;0
38753;202788;4919;59;45;6;39;.867;3600000;0
38754;188911;4998;0;0;0;0;.00nan;0;0
38754;194576;4998;75;30;2;28;.933;3561000;0
38754;20122;4715;62;16;1;15;.938;3600000;0
38754;195283;4715;0;0;0;0;.00nan;0;0
38755;165532;4992;0;0;0;0;.00nan;0;0
38755;186520;4997;21;20;6;14;.700;2878000;0
38755;187391;4992;80;32;2;30;.938;3600000;0
38755;-1;4997;15;11;5;6;.545;722000;0
38756;178695;4246;85;44;4;40;.909;3798000;0
38756;176206;1368;66;39;5;34;.872;3798000;0
38756;-1;1368;0;0;0;0;.00nan;0;0
38756;141850;4246;0;0;0;0;.00nan;0;0
38757;188911;4998;57;33;4;29;.879;3600000;0
38757;194576;4998;0;0;0;0;.00nan;0;0
38757;194625;165;0;0;0;0;.00nan;0;0
38757;200549;165;65;16;1;15;.938;3600000;0
38758;165532;4992;53;14;2;12;.857;3600000;0
38758;186520;4997;46;6;1;5;.833;851000;0
38758;187391;4992;0;0;0;0;.00nan;0;0
38758;-1;4997;16;22;6;16;.727;2749000;0
38759;186520;4997;85;30;2;28;.933;3600000;0
38759;-1;4839;56;34;4;30;.882;3563000;0
38759;-1;4997;0;0;0;0;.00nan;0;0
38759;64925;4839;0;0;0;0;.00nan;0;0
38760;-1;4919;0;0;0;0;.00nan;0;0
38760;20122;4715;0;0;0;0;.00nan;0;0
38760;195283;4715;79;28;2;26;.929;3682000;0
38760;202788;4919;95;38;1;37;.974;3682000;0
38761;164987;4714;100;27;0;27;1.000;3600000;0
38761;188911;4998;17;33;7;26;.788;3600000;0
38761;194576;4998;0;0;0;0;.00nan;0;0
38761;86347;4714;0;0;0;0;.00nan;0;0
38762;165532;4992;78;32;3;29;.906;3600000;0
38762;178695;4246;53;35;5;30;.857;3553000;0
38762;187391;4992;0;0;0;0;.00nan;0;0
38762;141850;4246;0;0;0;0;.00nan;0;0
38763;163462;4991;52;39;6;33;.846;3600000;0
38763;176206;1368;0;0;0;0;.00nan;0;0
38763;182210;4991;0;0;0;0;.00nan;0;0
38763;-1;1368;88;34;1;33;.971;3600000;0
38764;186520;4997;0;0;0;0;.00nan;0;0
38764;-1;4839;0;0;0;0;.00nan;0;0
38764;-1;4997;94;32;1;31;.969;3600000;0
38764;64925;4839;52;16;2;14;.875;3563000;0
38765;165532;4992;0;0;0;0;.00nan;0;0
38765;178695;4246;0;0;0;0;.00nan;0;0
38765;187391;4992;89;42;4;38;.905;4200000;0
38765;141850;4246;61;39;4;35;.897;4200000;0
38766;-1;4919;56;43;6;37;.860;3562000;0
38766;20122;4715;58;32;4;28;.875;3600000;0
38766;195283;4715;0;0;0;0;.00nan;0;0
38766;202788;4919;0;0;0;0;.00nan;0;0
38767;164987;4714;0;0;0;0;.00nan;0;0
38767;188911;4998;47;30;4;26;.867;1935000;0
38767;194576;4998;27;26;6;20;.769;1665000;0
38767;86347;4714;85;17;0;17;1.000;3600000;0
38768;186520;4997;52;30;5;25;.833;3585000;0
38768;-1;4839;73;36;3;33;.917;3600000;0
38768;-1;4997;0;0;0;0;.00nan;0;0
38768;64925;4839;0;0;0;0;.00nan;0;0
38769;164987;4714;0;0;0;0;.00nan;0;0
38769;188911;4998;38;35;6;29;.829;3556000;0
38769;194576;4998;0;0;0;0;.00nan;0;0
38769;86347;4714;62;31;4;27;.871;3600000;0
38770;-1;4919;0;0;0;0;.00nan;0;0
38770;194625;165;0;0;0;0;.00nan;0;0
38770;200549;165;58;28;3;25;.893;3565000;0
38770;202788;4919;96;29;1;28;.966;3600000;0
38771;176206;1368;35;28;6;22;.786;3551000;0
38771;-1;4839;55;36;5;31;.861;3600000;0
38771;-1;1368;0;0;0;0;.00nan;0;0
38771;64925;4839;0;0;0;0;.00nan;0;0
38772;194625;165;0;0;0;0;.00nan;0;0
38772;20122;4715;0;0;0;0;.00nan;0;0
38772;200549;165;76;39;3;36;.923;4063000;0
38772;195283;4715;55;29;4;25;.862;4065000;0
38773;164987;4714;52;27;4;23;.852;3550000;0
38773;165532;4992;76;44;3;41;.932;3600000;0
38773;187391;4992;0;0;0;0;.00nan;0;0
38773;86347;4714;0;0;0;0;.00nan;0;0
38774;-1;4919;0;0;0;0;.00nan;0;0
38774;178695;4246;0;0;0;0;.00nan;0;0
38774;202788;4919;92;44;3;41;.932;3600000;0
38774;141850;4246;35;25;5;20;.800;3542000;0
38775;163462;4991;62;21;2;19;.905;3600000;0
38775;182210;4991;0;0;0;0;.00nan;0;0
38775;186520;4997;77;42;4;38;.905;3557000;0
38775;-1;4997;0;0;0;0;.00nan;0;0
38776;186520;4997;0;0;0;0;.00nan;0;0
38776;-1;4839;0;0;0;0;.00nan;0;0
38776;-1;4997;10;31;8;23;.742;3600000;0
38776;64925;4839;54;16;2;14;.875;3600000;0
38777;-1;4919;23;38;8;30;.789;3600000;0
38777;178695;4246;52;27;4;23;.852;3600000;0
38777;202788;4919;0;0;0;0;.00nan;0;0
38777;141850;4246;0;0;0;0;.00nan;0;0
38778;188911;4998;13;25;7;18;.720;3600000;0
38778;194576;4998;0;0;0;0;.00nan;0;0
38778;194625;165;56;24;4;20;.833;3600000;0
38778;200549;165;0;0;0;0;.00nan;0;0
38779;164987;4714;0;0;0;0;.00nan;0;0
38779;165532;4992;0;0;0;0;.00nan;0;0
38779;187391;4992;94;37;2;35;.946;3600000;0
38779;86347;4714;67;29;3;26;.897;3600000;0
38780;163462;4991;0;0;0;0;.00nan;0;0
38780;176206;1368;79;38;3;35;.921;3600000;0
38780;182210;4991;50;27;4;23;.852;3549000;0
38780;-1;1368;0;0;0;0;.00nan;0;0
38781;165532;4992;58;25;3;22;.880;3600000;0
38781;178695;4246;0;0;0;0;.00nan;0;0
38781;187391;4992;0;0;0;0;.00nan;0;0
38781;141850;4246;72;38;4;34;.895;3600000;0
38782;186520;4997;60;36;4;32;.889;3564000;0
38782;-1;4839;56;25;3;22;.880;3600000;0
38782;-1;4997;0;0;0;0;.00nan;0;0
38782;64925;4839;0;0;0;0;.00nan;0;0
38783;164987;4714;61;21;2;19;.905;3600000;0
38783;-1;4919;49;10;1;9;.900;1268000;0
38783;202788;4919;39;16;4;12;.750;2332000;0
38783;86347;4714;0;0;0;0;.00nan;0;0
38784;163462;4991;60;18;2;16;.889;3600000;0
38784;176206;1368;0;0;0;0;.00nan;0;0
38784;182210;4991;0;0;0;0;.00nan;0;0
38784;-1;1368;32;34;6;28;.824;3600000;0
38785;163462;4991;64;37;4;33;.892;4200000;0
38785;194625;165;0;0;0;0;.00nan;0;0
38785;200549;165;79;46;4;42;.913;4200000;0
38785;182210;4991;0;0;0;0;.00nan;0;0
38786;164987;4714;0;0;0;0;.00nan;0;0
38786;178695;4246;0;0;0;0;.00nan;0;0
38786;86347;4714;55;20;3;17;.850;3686000;0
38786;141850;4246;55;26;4;22;.846;3686000;0
38787;188911;4998;80;46;4;42;.913;3597000;0
38787;194576;4998;0;0;0;0;.00nan;0;0
38787;20122;4715;0;0;0;0;.00nan;0;0
38787;195283;4715;47;21;3;18;.857;3600000;0
38788;165532;4992;72;30;2;28;.933;3600000;0
38788;187391;4992;0;0;0;0;.00nan;0;0
38788;-1;4839;39;25;5;20;.800;3600000;0
38788;64925;4839;0;0;0;0;.00nan;0;0
38789;176206;1368;67;25;2;23;.920;3600000;0
38789;186520;4997;84;41;4;37;.902;3569000;0
38789;-1;4997;0;0;0;0;.00nan;0;0
38789;-1;1368;0;0;0;0;.00nan;0;0
38790;164987;4714;60;52;6;46;.885;4200000;0
38790;178695;4246;35;34;6;28;.824;4200000;0
38790;86347;4714;0;0;0;0;.00nan;0;0
38790;141850;4246;0;0;0;0;.00nan;0;0
38791;165532;4992;60;16;1;15;.938;1441000;0
38791;187391;4992;32;19;5;14;.737;2159000;0
38791;-1;4839;0;0;0;0;.00nan;0;0
38791;64925;4839;67;16;1;15;.938;3600000;0
38792;176206;1368;0;0;0;0;.00nan;0;0
38792;186520;4997;0;0;0;0;.00nan;0;0
38792;-1;4997;35;44;8;36;.818;3600000;0
38792;-1;1368;72;21;1;20;.952;3600000;0
38793;163462;4991;53;32;5;27;.844;3516000;0
38793;194625;165;64;33;3;30;.909;3600000;0
38793;200549;165;0;0;0;0;.00nan;0;0
38793;182210;4991;0;0;0;0;.00nan;0;0
38794;188911;4998;0;0;0;0;.00nan;0;0
38794;194576;4998;94;39;2;37;.949;3830000;0
38794;-1;4919;0;0;0;0;.00nan;0;0
38794;202788;4919;81;28;1;27;.964;3830000;0
38795;164987;4714;0;0;0;0;.00nan;0;0
38795;178695;4246;56;2;0;2;1.000;459000;0
38795;86347;4714;89;34;2;32;.941;3600000;0
38795;141850;4246;35;37;7;30;.811;3141000;0
38796;-1;4919;44;32;6;26;.813;4159000;0
38796;194625;165;0;0;0;0;.00nan;0;0
38796;200549;165;59;51;6;45;.882;4200000;0
38796;202788;4919;0;0;0;0;.00nan;0;0
38797;176206;1368;66;23;2;21;.913;3600000;0
38797;186520;4997;57;37;5;32;.865;3600000;0
38797;-1;4997;0;0;0;0;.00nan;0;0
38797;-1;1368;0;0;0;0;.00nan;0;0
38798;188911;4998;67;49;6;43;.878;3600000;0
38798;194576;4998;0;0;0;0;.00nan;0;0
38798;20122;4715;0;0;0;0;.00nan;0;0
38798;195283;4715;44;19;3;16;.842;3600000;0
38799;165532;4992;50;24;3;21;.875;3600000;0
38799;187391;4992;0;0;0;0;.00nan;0;0
38799;-1;4839;45;32;5;27;.844;3515000;0
38799;64925;4839;0;0;0;0;.00nan;0;0
38800;-1;4919;0;0;0;0;.00nan;0;0
38800;194625;165;0;0;0;0;.00nan;0;0
38800;200549;165;35;25;5;20;.800;3573000;0
38800;202788;4919;60;30;3;27;.900;3600000;0
38801;164987;4714;87;29;2;27;.931;3600000;0
38801;20122;4715;0;0;0;0;.00nan;0;0
38801;195283;4715;36;27;5;22;.815;3600000;0
38801;86347;4714;0;0;0;0;.00nan;0;0
38802;165532;4992;65;32;3;29;.906;3600000;0
38802;188911;4998;61;35;4;31;.886;3569000;0
38802;194576;4998;0;0;0;0;.00nan;0;0
38802;187391;4992;0;0;0;0;.00nan;0;0
38803;186520;4997;100;27;0;27;1.000;3600000;0
38803;-1;4839;0;0;0;0;.00nan;0;0
38803;-1;4997;0;0;0;0;.00nan;0;0
38803;64925;4839;62;15;1;14;.933;3591000;0
38804;178695;4246;0;0;0;0;.00nan;0;0
38804;176206;1368;96;28;1;27;.964;3600000;0
38804;-1;1368;0;0;0;0;.00nan;0;0
38804;141850;4246;56;28;3;25;.893;3578000;0
38805;186520;4997;64;37;5;32;.865;3549000;0
38805;-1;4839;44;26;4;22;.846;3600000;0
38805;-1;4997;0;0;0;0;.00nan;0;0
38805;64925;4839;0;0;0;0;.00nan;0;0
38806;164987;4714;0;0;0;0;.00nan;0;0
38806;20122;4715;72;40;4;36;.900;3600000;0
38806;195283;4715;0;0;0;0;.00nan;0;0
38806;86347;4714;69;21;1;20;.952;3600000;0
38807;165532;4992;0;0;0;0;.00nan;0;0
38807;188911;4998;44;13;3;10;.769;1290000;0
38807;194576;4998;52;35;4;31;.886;2310000;0
38807;187391;4992;51;14;2;12;.857;3600000;0
38808;178695;4246;60;34;4;30;.882;3565000;0
38808;176206;1368;0;0;0;0;.00nan;0;0
38808;-1;1368;46;21;3;18;.857;3600000;0
38808;141850;4246;0;0;0;0;.00nan;0;0
38809;-1;4919;62;16;1;15;.938;3600000;0
38809;194625;165;67;25;2;23;.920;3562000;0
38809;200549;165;0;0;0;0;.00nan;0;0
38809;202788;4919;0;0;0;0;.00nan;0;0
38810;-1;4919;0;0;0;0;.00nan;0;0
38810;194625;165;0;0;0;0;.00nan;0;0
38810;200549;165;88;35;2;33;.943;3600000;0
38810;202788;4919;64;29;3;26;.897;3581000;0
38811;178695;4246;0;0;0;0;.00nan;0;0
38811;176206;1368;31;23;5;18;.783;3600000;0
38811;-1;1368;0;0;0;0;.00nan;0;0
38811;141850;4246;78;26;2;24;.923;3600000;0
38812;164987;4714;0;0;0;0;.00nan;0;0
38812;176206;1368;85;31;1;30;.968;3576000;0
38812;-1;1368;0;0;0;0;.00nan;0;0
38812;86347;4714;82;12;0;12;1.000;3600000;0
38813;163462;4991;58;30;3;27;.900;4200000;0
38813;182210;4991;0;0;0;0;.00nan;0;0
38813;186520;4997;81;39;3;36;.923;4200000;0
38813;-1;4997;0;0;0;0;.00nan;0;0
38814;164987;4714;0;0;0;0;.00nan;0;0
38814;194625;165;0;0;0;0;.00nan;0;0
38814;200549;165;55;31;5;26;.839;3600000;0
38814;86347;4714;69;25;2;23;.920;3600000;0
38815;188911;4998;38;35;6;29;.829;3570000;0
38815;194576;4998;0;0;0;0;.00nan;0;0
38815;-1;4919;0;0;0;0;.00nan;0;0
38815;202788;4919;56;22;3;19;.864;3600000;0
38816;178695;4246;0;0;0;0;.00nan;0;0
38816;176206;1368;0;0;0;0;.00nan;0;0
38816;-1;1368;97;35;1;34;.971;3600000;0
38816;141850;4246;69;49;6;43;.878;3600000;0
38817;165532;4992;54;38;5;33;.868;3513000;0
38817;187391;4992;0;0;0;0;.00nan;0;0
38817;-1;4839;0;0;0;0;.00nan;0;0
38817;64925;4839;74;29;3;26;.897;3600000;0
38818;163462;4991;0;0;0;0;.00nan;0;0
38818;182210;4991;64;23;2;21;.913;3600000;0
38818;186520;4997;0;0;0;0;.00nan;0;0
38818;-1;4997;53;28;4;24;.857;3552000;0
38819;194625;165;84;29;2;27;.931;3600000;0
38819;178695;4246;38;30;5;25;.833;3600000;0
38819;200549;165;0;0;0;0;.00nan;0;0
38819;141850;4246;0;0;0;0;.00nan;0;0
38820;-1;4919;67;17;1;16;.941;3600000;0
38820;20122;4715;0;0;0;0;.00nan;0;0
38820;195283;4715;82;36;2;34;.944;3562000;0
38820;202788;4919;0;0;0;0;.00nan;0;0
38821;165532;4992;0;0;0;0;.00nan;0;0
38821;187391;4992;45;31;5;26;.839;3521000;0
38821;-1;4839;91;41;3;38;.927;3600000;0
38821;64925;4839;0;0;0;0;.00nan;0;0
38822;164987;4714;57;21;2;19;.905;3600000;0
38822;176206;1368;55;27;4;23;.852;3537000;0
38822;-1;1368;0;0;0;0;.00nan;0;0
38822;86347;4714;0;0;0;0;.00nan;0;0
38823;163462;4991;55;24;3;21;.875;3600000;0
38823;182210;4991;0;0;0;0;.00nan;0;0
38823;186520;4997;40;40;7;33;.825;3600000;0
38823;-1;4997;0;0;0;0;.00nan;0;0
38824;188911;4998;78;25;2;23;.920;3600000;0
38824;194576;4998;0;0;0;0;.00nan;0;0
38824;20122;4715;0;0;0;0;.00nan;0;0
38824;195283;4715;45;43;6;37;.860;3600000;0
38825;163462;4991;0;0;0;0;.00nan;0;0
38825;182210;4991;62;17;2;15;.882;3531000;0
38825;186520;4997;0;0;0;0;.00nan;0;0
38825;-1;4997;100;44;0;44;1.000;3600000;0
38826;194625;165;0;0;0;0;.00nan;0;0
38826;20122;4715;100;25;0;25;1.000;3600000;0
38826;200549;165;72;31;2;29;.935;3544000;0
38826;195283;4715;0;0;0;0;.00nan;0;0
38827;188911;4998;25;23;6;17;.739;2555000;0
38827;194576;4998;56;12;1;11;.917;1045000;0
38827;194625;165;0;0;0;0;.00nan;0;0
38827;200549;165;61;18;2;16;.889;3600000;0
38828;-1;4919;0;0;0;0;.00nan;0;0
38828;20122;4715;100;31;0;31;1.000;3600000;0
38828;195283;4715;0;0;0;0;.00nan;0;0
38828;202788;4919;80;37;3;34;.919;3600000;0
38829;165532;4992;82;27;1;26;.963;3600000;0
38829;176206;1368;0;0;0;0;.00nan;0;0
38829;187391;4992;0;0;0;0;.00nan;0;0
38829;-1;1368;62;27;2;25;.926;3592000;0
38830;163462;4991;10;18;6;12;.667;3562000;0
38830;182210;4991;0;0;0;0;.00nan;0;0
38830;-1;4839;0;0;0;0;.00nan;0;0
38830;64925;4839;63;48;5;43;.896;3600000;0
38831;164987;4714;0;0;0;0;.00nan;0;0
38831;186520;4997;0;0;0;0;.00nan;0;0
38831;-1;4997;99;46;2;44;.957;3600000;0
38831;86347;4714;41;30;5;25;.833;3600000;0
38832;188911;4998;0;0;0;0;.00nan;0;0
38832;194576;4998;49;35;5;30;.857;3600000;0
38832;194625;165;71;18;1;17;.944;3600000;0
38832;200549;165;0;0;0;0;.00nan;0;0
38833;165532;4992;49;2;0;2;1.000;419000;0
38833;176206;1368;97;36;2;34;.944;3600000;0
38833;187391;4992;30;39;8;31;.795;3181000;0
38833;-1;1368;0;0;0;0;.00nan;0;0
38834;-1;4919;46;19;3;16;.842;3514000;0
38834;20122;4715;80;25;1;24;.960;3600000;0
38834;195283;4715;0;0;0;0;.00nan;0;0
38834;202788;4919;0;0;0;0;.00nan;0;0
38835;164987;4714;0;0;0;0;.00nan;0;0
38835;186520;4997;67;34;4;30;.882;3677000;0
38835;-1;4997;0;0;0;0;.00nan;0;0
38835;86347;4714;42;25;5;20;.800;3677000;0
38836;163462;4991;0;0;0;0;.00nan;0;0
38836;182210;4991;83;22;2;20;.909;3600000;0
38836;-1;4839;96;61;4;57;.934;3600000;0
38836;64925;4839;0;0;0;0;.00nan;0;0
38837;188911;4998;53;34;4;30;.882;3574000;0
38837;194576;4998;0;0;0;0;.00nan;0;0
38837;20122;4715;0;0;0;0;.00nan;0;0
38837;195283;4715;66;23;2;21;.913;3600000;0
38838;163462;4991;100;24;0;24;1.000;3600000;0
38838;176206;1368;0;0;0;0;.00nan;0;0
38838;182210;4991;0;0;0;0;.00nan;0;0
38838;-1;1368;33;34;6;28;.824;3600000;0
38839;176206;1368;45;26;3;23;.885;3554000;0
38839;-1;4839;0;0;0;0;.00nan;0;0
38839;-1;1368;0;0;0;0;.00nan;0;0
38839;64925;4839;92;35;2;33;.943;3600000;0
38840;163462;4991;71;33;5;28;.848;3786000;0
38840;182210;4991;0;0;0;0;.00nan;0;0
38840;186520;4997;41;33;6;27;.818;3786000;0
38840;-1;4997;0;0;0;0;.00nan;0;0
38841;164987;4714;0;0;0;0;.00nan;0;0
38841;178695;4246;48;8;1;7;.875;1477000;0
38841;86347;4714;65;22;2;20;.909;3600000;0
38841;141850;4246;13;23;6;17;.739;2123000;0
38842;165532;4992;97;34;1;33;.971;3600000;0
38842;-1;4919;0;0;0;0;.00nan;0;0
38842;187391;4992;0;0;0;0;.00nan;0;0
38842;202788;4919;57;32;4;28;.875;3600000;0
38843;188911;4998;60;34;4;30;.882;3912000;0
38843;194576;4998;0;0;0;0;.00nan;0;0
38843;194625;165;0;0;0;0;.00nan;0;0
38843;200549;165;83;34;3;31;.912;3912000;0
38844;176206;1368;0;0;0;0;.00nan;0;0
38844;-1;4839;90;34;2;32;.941;3600000;0
38844;-1;1368;54;38;6;32;.842;3600000;0
38844;64925;4839;0;0;0;0;.00nan;0;0
38845;163462;4991;0;0;0;0;.00nan;0;0
38845;182210;4991;67;22;3;19;.864;3600000;0
38845;186520;4997;0;0;0;0;.00nan;0;0
38845;-1;4997;69;32;4;28;.875;3557000;0
38846;164987;4714;0;0;0;0;.00nan;0;0
38846;178695;4246;34;26;5;21;.808;3638000;0
38846;86347;4714;59;30;4;26;.867;3638000;0
38846;141850;4246;0;0;0;0;.00nan;0;0
38847;165532;4992;81;38;3;35;.921;3871000;0
38847;-1;4919;77;25;2;23;.920;3871000;0
38847;187391;4992;0;0;0;0;.00nan;0;0
38847;202788;4919;0;0;0;0;.00nan;0;0
38848;194625;165;70;35;4;31;.886;3717000;0
38848;20122;4715;67;28;3;25;.893;3717000;0
38848;200549;165;0;0;0;0;.00nan;0;0
38848;195283;4715;0;0;0;0;.00nan;0;0
38849;176206;1368;66;42;5;37;.881;3600000;0
38849;-1;4839;0;0;0;0;.00nan;0;0
38849;-1;1368;0;0;0;0;.00nan;0;0
38849;64925;4839;75;26;2;24;.923;3600000;0
38850;163462;4991;73;30;3;27;.900;3600000;0
38850;182210;4991;0;0;0;0;.00nan;0;0
38850;186520;4997;59;43;6;37;.860;3600000;0
38850;-1;4997;0;0;0;0;.00nan;0;0
38852;164987;4714;91;20;0;20;1.000;3600000;0
38852;186520;4997;52;31;5;26;.839;3600000;0
38852;-1;4997;0;0;0;0;.00nan;0;0
38852;86347;4714;0;0;0;0;.00nan;0;0
38854;-1;4991;63;26;3;23;.885;3600000;0
38854;178695;4246;65;38;5;33;.868;3576000;0
38854;182210;4991;0;0;0;0;.00nan;0;0
38854;141850;4246;0;0;0;0;.00nan;0;0
38856;188911;4998;0;0;0;0;.00nan;0;0
38856;194576;4998;99;41;1;40;.976;3720000;0
38856;20122;4715;0;0;0;0;.00nan;0;0
38856;173918;4715;83;32;2;30;.938;3720000;0
38858;200549;165;74;19;1;18;.947;3600000;0
38858;171608;4919;61;31;3;28;.903;3561000;0
38858;-1;165;0;0;0;0;.00nan;0;0
38858;202788;4919;0;0;0;0;.00nan;0;0
38860;176206;1368;74;34;3;31;.912;3704000;0
38860;-1;4839;0;0;0;0;.00nan;0;0
38860;-1;1368;0;0;0;0;.00nan;0;0
38860;64925;4839;81;33;2;31;.939;3704000;0
2192;163462;4991;100;27;0;27;1.000;3600000;0
2192;164987;4714;0;0;0;0;.00nan;0;0
2192;182210;4991;0;0;0;0;.00nan;0;0
2192;86347;4714;83;42;3;39;.929;3600000;0
2193;178695;4246;0;0;0;0;.00nan;0;0
2193;176206;1368;63;32;4;28;.875;3600000;0
2193;-1;1368;0;0;0;0;.00nan;0;0
2193;141850;4246;87;28;1;27;.964;3600000;0
2194;-1;4919;57;7;0;7;1.000;510000;0
2194;194625;165;0;0;0;0;.00nan;0;0
2194;200549;165;63;33;4;29;.879;3600000;0
2194;202788;4919;23;34;8;26;.765;3090000;0
2195;165532;4992;67;40;5;35;.875;3600000;0
2195;20122;4715;0;0;0;0;.00nan;0;0
2195;195283;4715;84;30;2;28;.933;3600000;0
2195;187391;4992;0;0;0;0;.00nan;0;0
2196;163462;4991;61;26;3;23;.885;3600000;0
2196;164987;4714;0;0;0;0;.00nan;0;0
2196;182210;4991;0;0;0;0;.00nan;0;0
2196;86347;4714;60;35;4;31;.886;3600000;0
2197;178695;4246;0;0;0;0;.00nan;0;0
2197;176206;1368;36;32;6;26;.813;3514000;0
2197;-1;1368;0;0;0;0;.00nan;0;0
2197;141850;4246;54;31;4;27;.871;3600000;0
2198;-1;4919;0;0;0;0;.00nan;0;0
2198;194625;165;0;0;0;0;.00nan;0;0
2198;200549;165;46;23;4;19;.826;4255000;0
2198;202788;4919;53;35;5;30;.857;4255000;0
2199;165532;4992;58;18;2;16;.889;3600000;0
2199;20122;4715;0;0;0;0;.00nan;0;0
2199;195283;4715;58;44;5;39;.886;3600000;0
2199;187391;4992;0;0;0;0;.00nan;0;0
2310;165532;4992;42;28;5;23;.821;3600000;0
2310;20122;4715;0;0;0;0;.00nan;0;0
2310;195283;4715;51;30;4;26;.867;3600000;0
2310;187391;4992;0;0;0;0;.00nan;0;0
2372;163462;4991;62;20;2;18;.900;3600000;0
2372;178695;4246;0;0;0;0;.00nan;0;0
2372;182210;4991;0;0;0;0;.00nan;0;0
2372;141850;4246;69;43;4;39;.907;3538000;0
2373;194625;165;50;1;0;1;1.000;252000;0
2373;20122;4715;0;0;0;0;.00nan;0;0
2373;200549;165;60;47;6;41;.872;3348000;0
2373;195283;4715;84;29;1;28;.966;3600000;0
2374;163462;4991;75;28;2;26;.929;3600000;0
2374;178695;4246;0;0;0;0;.00nan;0;0
2374;182210;4991;0;0;0;0;.00nan;0;0
2374;141850;4246;66;37;4;33;.892;3600000;0
2375;194625;165;0;0;0;0;.00nan;0;0
2375;20122;4715;0;0;0;0;.00nan;0;0
2375;200549;165;56;26;3;23;.885;3600000;0
2375;195283;4715;59;29;4;25;.862;3585000;0
2453;194625;165;53;2;0;2;1.000;247000;0
2453;20122;4715;0;0;0;0;.00nan;0;0
2453;200549;165;44;40;7;33;.825;3353000;0
2453;195283;4715;57;22;2;20;.909;3600000;0
2470;163462;4991;67;21;2;19;.905;3600000;0
2470;20122;4715;0;0;0;0;.00nan;0;0
2470;195283;4715;54;28;4;24;.857;3570000;0
2470;182210;4991;0;0;0;0;.00nan;0;0
2471;163462;4991;70;21;1;20;.952;3600000;0
2471;20122;4715;0;0;0;0;.00nan;0;0
2471;195283;4715;43;25;4;21;.840;3600000;0
2471;182210;4991;0;0;0;0;.00nan;0;0
38861;175658;167;0;0;0;0;.00nan;0;0
38861;185744;175;100;43;1;42;.977;3600000;0
38861;78587;175;0;0;0;0;.00nan;0;0
38861;87164;167;58;45;6;39;.867;3600000;0
38862;2495;171;49;25;4;21;.840;2346000;0
38862;168001;171;72;10;0;10;1.000;1254000;0
38862;173918;3916;59;36;5;31;.861;3581000;0
38862;91358;3916;0;0;0;0;.00nan;0;0
38863;187657;4247;0;0;0;0;.00nan;0;0
38863;78094;169;74;37;3;34;.919;3552000;0
38863;91225;169;0;0;0;0;.00nan;0;0
38863;91703;4247;75;26;2;24;.923;3600000;0
38864;2495;171;76;27;2;25;.926;3900000;0
38864;163989;174;84;35;2;33;.943;3900000;0
38864;168001;171;0;0;0;0;.00nan;0;0
38864;161046;174;0;0;0;0;.00nan;0;0
38865;173918;3916;93;43;2;41;.953;3554000;0
38865;191692;170;100;33;0;33;1.000;3600000;0
38865;91358;3916;0;0;0;0;.00nan;0;0
38865;139467;170;0;0;0;0;.00nan;0;0
38866;187657;4247;17;24;6;18;.750;2094000;0
38866;169166;169;0;0;0;0;.00nan;0;0
38866;78094;169;79;25;1;24;.960;3600000;0
38866;91703;4247;78;19;1;18;.947;1506000;0
38867;181874;1527;79;25;1;24;.960;3600000;0
38867;57434;1527;0;0;0;0;.00nan;0;0
38867;78581;172;88;39;2;37;.949;3600000;0
38867;92313;172;0;0;0;0;.00nan;0;0
38868;175658;167;0;0;0;0;.00nan;0;0
38868;185744;175;76;39;3;36;.923;3794000;0
38868;78587;175;0;0;0;0;.00nan;0;0
38868;87164;167;70;26;2;24;.923;3794000;0
38869;2495;171;0;0;0;0;.00nan;0;0
38869;187657;4247;0;0;0;0;.00nan;0;0
38869;168001;171;34;27;5;22;.815;3544000;0
38869;91703;4247;61;27;3;24;.889;3600000;0
38870;191692;170;59;28;3;25;.893;3900000;0
38870;78581;172;73;29;3;26;.897;3900000;0
38870;92313;172;0;0;0;0;.00nan;0;0
38870;139467;170;0;0;0;0;.00nan;0;0
38871;169166;169;88;34;2;32;.941;3600000;0
38871;175658;167;0;0;0;0;.00nan;0;0
38871;78094;169;0;0;0;0;.00nan;0;0
38871;87164;167;77;49;5;44;.898;3600000;0
38872;163989;174;75;25;2;23;.920;3900000;0
38872;173918;3916;0;0;0;0;.00nan;0;0
38872;91358;3916;67;28;2;26;.929;3900000;0
38872;161046;174;0;0;0;0;.00nan;0;0
38873;181874;1527;64;27;2;25;.926;3549000;0
38873;185744;175;96;33;1;32;.970;3600000;0
38873;57434;1527;0;0;0;0;.00nan;0;0
38873;78587;175;0;0;0;0;.00nan;0;0
38874;169166;169;98;45;3;42;.933;3582000;0
38874;175658;167;79;23;1;22;.957;3600000;0
38874;78094;169;0;0;0;0;.00nan;0;0
38874;87164;167;0;0;0;0;.00nan;0;0
38875;163989;174;0;0;0;0;.00nan;0;0
38875;173918;3916;70;37;4;33;.892;3600000;0
38875;91358;3916;0;0;0;0;.00nan;0;0
38875;161046;174;91;33;1;32;.970;3600000;0
38876;2495;171;75;33;3;30;.909;3600000;0
38876;187657;4247;45;27;4;23;.852;3583000;0
38876;168001;171;0;0;0;0;.00nan;0;0
38876;91703;4247;0;0;0;0;.00nan;0;0
38877;181874;1527;0;0;0;0;.00nan;0;0
38877;185744;175;0;0;0;0;.00nan;0;0
38877;57434;1527;52;30;4;26;.867;3900000;0
38877;78587;175;52;28;4;24;.857;3900000;0
38878;181874;1527;73;28;2;26;.929;3563000;0
38878;57434;1527;0;0;0;0;.00nan;0;0
38878;78581;172;84;29;1;28;.966;3600000;0
38878;92313;172;0;0;0;0;.00nan;0;0
38879;2495;171;57;14;2;12;.857;3623000;0
38879;168001;171;0;0;0;0;.00nan;0;0
38879;173918;3916;0;0;0;0;.00nan;0;0
38879;91358;3916;94;49;3;46;.939;3623000;0
38880;187657;4247;91;48;1;47;.979;3600000;0
38880;175658;167;33;20;4;16;.800;2472000;0
38880;87164;167;14;12;5;7;.583;1128000;0
38880;91703;4247;0;0;0;0;.00nan;0;0
38881;169166;169;40;26;4;22;.846;3545000;0
38881;191692;170;58;27;3;24;.889;3600000;0
38881;78094;169;0;0;0;0;.00nan;0;0
38881;139467;170;0;0;0;0;.00nan;0;0
38882;163989;174;56;29;3;26;.897;3600000;0
38882;185744;175;46;33;5;28;.848;3546000;0
38882;78587;175;0;0;0;0;.00nan;0;0
38882;161046;174;0;0;0;0;.00nan;0;0
38883;181874;1527;88;38;3;35;.921;3576000;0
38883;57434;1527;0;0;0;0;.00nan;0;0
38883;78581;172;86;29;1;28;.966;3600000;0
38883;92313;172;0;0;0;0;.00nan;0;0
38884;2495;171;0;0;0;0;.00nan;0;0
38884;168001;171;69;24;2;22;.917;3600000;0
38884;173918;3916;62;26;3;23;.885;3600000;0
38884;91358;3916;0;0;0;0;.00nan;0;0
38885;187657;4247;0;0;0;0;.00nan;0;0
38885;175658;167;0;0;0;0;.00nan;0;0
38885;87164;167;91;36;1;35;.972;3600000;0
38885;91703;4247;72;27;2;25;.926;3590000;0
38886;169166;169;100;40;1;39;.975;3600000;0
38886;191692;170;0;0;0;0;.00nan;0;0
38886;78094;169;0;0;0;0;.00nan;0;0
38886;139467;170;70;25;2;23;.920;3542000;0
38887;163989;174;23;6;3;3;.500;418000;0
38887;185744;175;0;0;0;0;.00nan;0;0
38887;78587;175;60;20;2;18;.900;3600000;0
38887;161046;174;74;30;2;28;.933;3182000;0
38888;163989;174;64;27;3;24;.889;3600000;0
38888;175658;167;90;33;2;31;.939;3600000;0
38888;87164;167;0;0;0;0;.00nan;0;0
38888;161046;174;0;0;0;0;.00nan;0;0
38889;187657;4247;97;41;1;40;.976;3600000;0
38889;173918;3916;0;0;0;0;.00nan;0;0
38889;91358;3916;44;19;3;16;.842;3573000;0
38889;91703;4247;0;0;0;0;.00nan;0;0
38890;2495;171;0;0;0;0;.00nan;0;0
38890;163989;174;97;51;1;50;.980;3900000;0
38890;168001;171;86;22;1;21;.955;3900000;0
38890;161046;174;0;0;0;0;.00nan;0;0
38891;191692;170;52;17;3;14;.824;3900000;0
38891;78581;172;0;0;0;0;.00nan;0;0
38891;92313;172;60;28;3;25;.893;3867000;0
38891;139467;170;0;0;0;0;.00nan;0;0
38892;175658;167;58;43;6;37;.860;3600000;0
38892;181874;1527;0;0;0;0;.00nan;0;0
38892;57434;1527;76;24;1;23;.958;3600000;0
38892;87164;167;0;0;0;0;.00nan;0;0
38893;187657;4247;0;0;0;0;.00nan;0;0
38893;163989;174;0;0;0;0;.00nan;0;0
38893;91703;4247;100;37;2;35;.946;3900000;0
38893;161046;174;77;33;2;31;.939;3900000;0
38894;2495;171;66;39;3;36;.923;3600000;0
38894;168001;171;0;0;0;0;.00nan;0;0
38894;169166;169;48;23;4;19;.826;3544000;0
38894;78094;169;0;0;0;0;.00nan;0;0
38895;173918;3916;59;26;3;23;.885;3600000;0
38895;185744;175;20;29;7;22;.759;3600000;0
38895;78587;175;0;0;0;0;.00nan;0;0
38895;91358;3916;0;0;0;0;.00nan;0;0
38896;175658;167;0;0;0;0;.00nan;0;0
38896;181874;1527;89;40;2;38;.950;3600000;0
38896;57434;1527;0;0;0;0;.00nan;0;0
38896;87164;167;34;38;7;31;.816;3600000;0
38897;173918;3916;51;23;4;19;.826;3545000;0
38897;191692;170;73;32;3;29;.906;3600000;0
38897;91358;3916;0;0;0;0;.00nan;0;0
38897;139467;170;0;0;0;0;.00nan;0;0
38898;187657;4247;62;19;2;17;.895;3600000;0
38898;163989;174;82;46;3;43;.935;3550000;0
38898;91703;4247;0;0;0;0;.00nan;0;0
38898;161046;174;0;0;0;0;.00nan;0;0
38899;169166;169;0;0;0;0;.00nan;0;0
38899;185744;175;0;0;0;0;.00nan;0;0
38899;78094;169;59;39;5;34;.872;3600000;0
38899;78587;175;86;21;0;21;1.000;3600000;0
38900;191692;170;47;27;4;23;.852;3571000;0
38900;78581;172;61;26;3;23;.885;3600000;0
38900;92313;172;0;0;0;0;.00nan;0;0
38900;139467;170;0;0;0;0;.00nan;0;0
38901;187657;4247;61;27;3;24;.889;3600000;0
38901;175658;167;48;31;5;26;.839;3600000;0
38901;87164;167;0;0;0;0;.00nan;0;0
38901;91703;4247;0;0;0;0;.00nan;0;0
38902;187657;4247;53;43;6;37;.860;1929000;0
38902;191692;170;77;18;1;17;.944;3600000;0
38902;91703;4247;55;20;2;18;.900;1671000;0
38902;139467;170;0;0;0;0;.00nan;0;0
38903;173918;3916;78;31;2;29;.935;3900000;0
38903;175658;167;77;27;2;25;.926;3900000;0
38903;87164;167;0;0;0;0;.00nan;0;0
38903;91358;3916;0;0;0;0;.00nan;0;0
38904;2495;171;49;31;4;27;.871;3600000;0
38904;163989;174;100;32;0;32;1.000;3600000;0
38904;168001;171;0;0;0;0;.00nan;0;0
38904;161046;174;0;0;0;0;.00nan;0;0
38905;185744;175;0;0;0;0;.00nan;0;0
38905;78581;172;92;37;3;34;.919;3894000;0
38905;78587;175;69;26;3;23;.885;3900000;0
38905;92313;172;0;0;0;0;.00nan;0;0
38906;173918;3916;0;0;0;0;.00nan;0;0
38906;175658;167;0;0;0;0;.00nan;0;0
38906;87164;167;95;26;0;26;1.000;3600000;0
38906;91358;3916;47;32;4;28;.875;3600000;0
38907;2495;171;0;0;0;0;.00nan;0;0
38907;187657;4247;44;5;1;4;.800;721000;0
38907;168001;171;69;20;2;18;.900;3600000;0
38907;91703;4247;36;34;6;28;.824;2879000;0
38908;163989;174;65;43;5;38;.884;3568000;0
38908;169166;169;44;25;4;21;.840;3600000;0
38908;78094;169;0;0;0;0;.00nan;0;0
38908;161046;174;0;0;0;0;.00nan;0;0
38909;181874;1527;73;21;1;20;.952;3600000;0
38909;191692;170;0;0;0;0;.00nan;0;0
38909;91225;1527;0;0;0;0;.00nan;0;0
38909;139467;170;82;37;2;35;.946;3597000;0
38910;185744;175;33;31;6;25;.806;3186000;0
38910;78581;172;0;0;0;0;.00nan;0;0
38910;78587;175;61;8;0;8;1.000;414000;0
38910;92313;172;97;20;0;20;1.000;3600000;0
38911;2495;171;0;0;0;0;.00nan;0;0
38911;163989;174;94;38;1;37;.974;3600000;0
38911;168001;171;54;33;4;29;.879;3600000;0
38911;161046;174;0;0;0;0;.00nan;0;0
38912;181874;1527;46;34;5;29;.853;3594000;0
38912;191692;170;75;35;3;32;.914;3600000;0
38912;91225;1527;0;0;0;0;.00nan;0;0
38912;139467;170;0;0;0;0;.00nan;0;0
38913;173918;3916;62;34;4;30;.882;3881000;0
38913;185744;175;0;0;0;0;.00nan;0;0
38913;78587;175;77;42;4;38;.905;3900000;0
38913;91358;3916;0;0;0;0;.00nan;0;0
38914;169166;169;92;36;1;35;.972;3600000;0
38914;175658;167;0;0;0;0;.00nan;0;0
38914;78094;169;0;0;0;0;.00nan;0;0
38914;87164;167;20;23;6;17;.739;3600000;0
38915;187657;4247;0;0;0;0;.00nan;0;0
38915;78581;172;0;0;0;0;.00nan;0;0
38915;91703;4247;55;24;3;21;.875;3576000;0
38915;92313;172;75;24;1;23;.958;3600000;0
38916;173918;3916;0;0;0;0;.00nan;0;0
38916;78581;172;75;36;3;33;.917;3600000;0
38916;91358;3916;55;38;5;33;.868;3574000;0
38916;92313;172;0;0;0;0;.00nan;0;0
38917;181874;1527;0;0;0;0;.00nan;0;0
38917;191692;170;59;18;2;16;.889;3588000;0
38917;91225;1527;100;31;0;31;1.000;3600000;0
38917;139467;170;0;0;0;0;.00nan;0;0
38918;175658;167;77;28;2;26;.929;3900000;0
38918;185744;175;81;43;2;41;.953;3900000;0
38918;78587;175;0;0;0;0;.00nan;0;0
38918;87164;167;0;0;0;0;.00nan;0;0
38919;187657;4247;0;0;0;0;.00nan;0;0
38919;169166;169;73;30;2;28;.933;3900000;0
38919;78094;169;0;0;0;0;.00nan;0;0
38919;91703;4247;84;31;2;29;.935;3900000;0
38920;2495;171;19;33;7;26;.788;2466000;0
38920;163989;174;100;51;3;48;.941;3600000;0
38920;168001;171;39;8;2;6;.750;1134000;0
38920;161046;174;0;0;0;0;.00nan;0;0
38921;173918;3916;100;30;0;30;1.000;3600000;0
38921;78581;172;69;28;3;25;.893;3600000;0
38921;91358;3916;0;0;0;0;.00nan;0;0
38921;92313;172;0;0;0;0;.00nan;0;0
38922;181874;1527;0;0;0;0;.00nan;0;0
38922;191692;170;66;28;4;24;.857;3543000;0
38922;91225;1527;80;33;3;30;.909;3600000;0
38922;139467;170;0;0;0;0;.00nan;0;0
38923;187657;4247;0;0;0;0;.00nan;0;0
38923;169166;169;0;0;0;0;.00nan;0;0
38923;78094;169;83;28;2;26;.929;3689000;0
38923;91703;4247;78;40;3;37;.925;3689000;0
38924;163989;174;78;23;1;22;.957;3600000;0
38924;169166;169;69;35;4;31;.886;3600000;0
38924;78094;169;0;0;0;0;.00nan;0;0
38924;161046;174;0;0;0;0;.00nan;0;0
38925;2495;171;74;22;1;21;.955;3600000;0
38925;168001;171;0;0;0;0;.00nan;0;0
38925;169166;169;73;34;3;31;.912;3591000;0
38925;78094;169;0;0;0;0;.00nan;0;0
38926;163989;174;100;48;2;46;.958;3600000;0
38926;78581;172;58;26;3;23;.885;3569000;0
38926;92313;172;0;0;0;0;.00nan;0;0
38926;161046;174;0;0;0;0;.00nan;0;0
38927;185744;175;68;25;2;23;.920;3600000;0
38927;191692;170;50;23;3;20;.870;3533000;0
38927;78587;175;0;0;0;0;.00nan;0;0
38927;139467;170;0;0;0;0;.00nan;0;0
38928;2495;171;0;0;0;0;.00nan;0;0
38928;168001;171;66;32;3;29;.906;3900000;0
38928;169166;169;0;0;0;0;.00nan;0;0
38928;78094;169;67;33;3;30;.909;3900000;0
38929;173918;3916;75;20;1;19;.950;3600000;0
38929;175658;167;84;31;2;29;.935;3586000;0
38929;87164;167;0;0;0;0;.00nan;0;0
38929;91358;3916;0;0;0;0;.00nan;0;0
38930;163989;174;0;0;0;0;.00nan;0;0
38930;78581;172;0;0;0;0;.00nan;0;0
38930;92313;172;64;36;4;32;.889;3550000;0
38930;161046;174;87;39;2;37;.949;3600000;0
38931;185744;175;0;0;0;0;.00nan;0;0
38931;191692;170;0;0;0;0;.00nan;0;0
38931;78587;175;72;27;2;25;.926;3600000;0
38931;139467;170;39;35;6;29;.829;3600000;0
38932;173918;3916;0;0;0;0;.00nan;0;0
38932;175658;167;0;0;0;0;.00nan;0;0
38932;87164;167;49;27;5;22;.815;3591000;0
38932;91358;3916;56;31;4;27;.871;3600000;0
38933;191692;170;82;40;2;38;.950;3900000;0
38933;78581;172;77;28;2;26;.929;3900000;0
38933;92313;172;0;0;0;0;.00nan;0;0
38933;139467;170;0;0;0;0;.00nan;0;0
38934;2495;171;82;17;0;17;1.000;3600000;0
38934;168001;171;0;0;0;0;.00nan;0;0
38934;173918;3916;55;28;3;25;.893;3600000;0
38934;91358;3916;0;0;0;0;.00nan;0;0
38935;187657;4247;0;0;0;0;.00nan;0;0
38935;169166;169;73;38;4;34;.895;3600000;0
38935;78094;169;0;0;0;0;.00nan;0;0
38935;91703;4247;41;36;6;30;.833;3546000;0
38936;163989;174;83;28;2;26;.929;3900000;0
38936;181874;1527;89;39;2;37;.949;3900000;0
38936;91225;1527;0;0;0;0;.00nan;0;0
38936;161046;174;0;0;0;0;.00nan;0;0
38937;175658;167;63;13;1;12;.923;3600000;0
38937;185744;175;50;29;4;25;.862;3600000;0
38937;78587;175;0;0;0;0;.00nan;0;0
38937;87164;167;0;0;0;0;.00nan;0;0
38938;2495;171;59;37;4;33;.892;3896000;0
38938;168001;171;0;0;0;0;.00nan;0;0
38938;173918;3916;0;0;0;0;.00nan;0;0
38938;91358;3916;60;31;4;27;.871;3900000;0
38939;187657;4247;98;43;2;41;.953;3900000;0
38939;169166;169;0;0;0;0;.00nan;0;0
38939;78094;169;63;16;2;14;.875;3900000;0
38939;91703;4247;0;0;0;0;.00nan;0;0
38940;163989;174;0;0;0;0;.00nan;0;0
38940;181874;1527;0;0;0;0;.00nan;0;0
38940;91225;1527;67;27;2;25;.926;3600000;0
38940;161046;174;51;35;5;30;.857;3600000;0
38941;191692;170;69;34;3;31;.912;3600000;0
38941;78581;172;0;0;0;0;.00nan;0;0
38941;92313;172;87;26;1;25;.962;3600000;0
38941;139467;170;0;0;0;0;.00nan;0;0
38942;175658;167;0;0;0;0;.00nan;0;0
38942;185744;175;0;0;0;0;.00nan;0;0
38942;78587;175;60;26;3;23;.885;3660000;0
38942;87164;167;70;35;4;31;.886;3660000;0
38943;181874;1527;61;40;5;35;.875;3513000;0
38943;78581;172;73;32;3;29;.906;3600000;0
38943;91225;1527;0;0;0;0;.00nan;0;0
38943;92313;172;0;0;0;0;.00nan;0;0
38944;2495;171;72;15;0;15;1.000;1405000;0
38944;168001;171;13;17;6;11;.647;2195000;0
38944;175658;167;93;31;1;30;.968;3600000;0
38944;87164;167;0;0;0;0;.00nan;0;0
38945;173918;3916;37;24;5;19;.792;3600000;0
38945;191692;170;100;36;0;36;1.000;3600000;0
38945;91358;3916;0;0;0;0;.00nan;0;0
38945;139467;170;0;0;0;0;.00nan;0;0
38946;181874;1527;57;17;2;15;.882;1914000;0
38946;78581;172;0;0;0;0;.00nan;0;0
38946;91225;1527;26;20;5;15;.750;1686000;0
38946;92313;172;58;16;2;14;.875;3600000;0
38947;187657;4247;0;0;0;0;.00nan;0;0
38947;185744;175;72;26;2;24;.923;3600000;0
38947;78587;175;0;0;0;0;.00nan;0;0
38947;91703;4247;48;30;4;26;.867;3518000;0
38948;2495;171;66;26;3;23;.885;3600000;0
38948;168001;171;0;0;0;0;.00nan;0;0
38948;185744;175;0;0;0;0;.00nan;0;0
38948;78587;175;32;30;5;25;.833;3547000;0
38949;169166;169;93;35;1;34;.971;3600000;0
38949;175658;167;0;0;0;0;.00nan;0;0
38949;78094;169;0;0;0;0;.00nan;0;0
38949;87164;167;89;37;2;35;.946;3575000;0
38950;173918;3916;0;0;0;0;.00nan;0;0
38950;-1;174;73;29;2;27;.931;3900000;0
38950;91358;3916;88;32;2;30;.938;3900000;0
38950;161046;174;0;0;0;0;.00nan;0;0
38951;191692;170;0;0;0;0;.00nan;0;0
38951;78581;172;50;31;4;27;.871;3513000;0
38951;92313;172;0;0;0;0;.00nan;0;0
38951;139467;170;78;34;2;32;.941;3600000;0
38952;187657;4247;26;6;3;3;.500;284000;0
38952;181874;1527;53;21;3;18;.857;3600000;0
38952;91225;1527;0;0;0;0;.00nan;0;0
38952;91703;4247;75;24;1;23;.958;3260000;0
38953;2495;171;89;33;2;31;.939;3548000;0
38953;168001;171;0;0;0;0;.00nan;0;0
38953;181874;1527;100;22;0;22;1.000;3600000;0
38953;91225;1527;0;0;0;0;.00nan;0;0
38954;2495;171;0;0;0;0;.00nan;0;0
38954;187657;4247;0;0;0;0;.00nan;0;0
38954;168001;171;72;29;2;27;.931;3581000;0
38954;91703;4247;100;30;0;30;1.000;3600000;0
38955;191692;170;69;37;3;34;.919;3600000;0
38955;78581;172;88;34;2;32;.941;3600000;0
38955;92313;172;0;0;0;0;.00nan;0;0
38955;139467;170;0;0;0;0;.00nan;0;0
38956;169166;169;54;31;5;26;.839;3600000;0
38956;-1;174;0;0;0;0;.00nan;0;0
38956;78094;169;0;0;0;0;.00nan;0;0
38956;161046;174;61;24;3;21;.875;3600000;0
38957;173918;3916;19;9;4;5;.556;768000;0
38957;181874;1527;88;20;0;20;1.000;3600000;0
38957;91225;1527;0;0;0;0;.00nan;0;0
38957;91358;3916;65;22;1;21;.955;2832000;0
38958;175658;167;0;0;0;0;.00nan;0;0
38958;185744;175;100;45;0;45;1.000;3600000;0
38958;78587;175;0;0;0;0;.00nan;0;0
38958;87164;167;49;37;6;31;.838;3600000;0
38959;2495;171;83;25;1;24;.960;3600000;0
38959;168001;171;0;0;0;0;.00nan;0;0
38959;173918;3916;52;30;4;26;.867;3600000;0
38959;91358;3916;0;0;0;0;.00nan;0;0
38960;191692;170;99;40;2;38;.950;3600000;0
38960;78581;172;0;0;0;0;.00nan;0;0
38960;92313;172;66;27;3;24;.889;3565000;0
38960;139467;170;0;0;0;0;.00nan;0;0
38961;175658;167;65;44;4;40;.909;3600000;0
38961;185744;175;39;37;6;31;.838;3600000;0
38961;78587;175;0;0;0;0;.00nan;0;0
38961;87164;167;0;0;0;0;.00nan;0;0
38962;169166;169;0;0;0;0;.00nan;0;0
38962;-1;174;60;19;2;17;.895;3600000;0
38962;78094;169;71;37;3;34;.919;3570000;0
38962;161046;174;0;0;0;0;.00nan;0;0
38963;187657;4247;0;0;0;0;.00nan;0;0
38963;181874;1527;43;28;5;23;.821;3600000;0
38963;91225;1527;0;0;0;0;.00nan;0;0
38963;91703;4247;97;38;1;37;.974;3600000;0
38964;2495;171;64;27;2;25;.926;3600000;0
38964;168001;171;0;0;0;0;.00nan;0;0
38964;-1;174;0;0;0;0;.00nan;0;0
38964;161046;174;87;43;3;40;.930;3570000;0
38965;173918;3916;0;0;0;0;.00nan;0;0
38965;191692;170;43;34;6;28;.824;3600000;0
38965;91358;3916;93;29;1;28;.966;3600000;0
38965;139467;170;0;0;0;0;.00nan;0;0
38966;181874;1527;62;39;5;34;.872;3540000;0
38966;78581;172;66;34;4;30;.882;3600000;0
38966;91225;1527;0;0;0;0;.00nan;0;0
38966;92313;172;0;0;0;0;.00nan;0;0
38967;187657;4247;0;0;0;0;.00nan;0;0
38967;185744;175;36;33;6;27;.818;2784000;0
38967;78587;175;53;10;1;9;.900;816000;0
38967;91703;4247;71;35;3;32;.914;3600000;0
38968;181874;1527;0;0;0;0;.00nan;0;0
38968;191692;170;49;36;5;31;.861;3567000;0
38968;91225;1527;53;27;4;23;.852;3600000;0
38968;139467;170;0;0;0;0;.00nan;0;0
38969;187657;4247;0;0;0;0;.00nan;0;0
38969;175658;167;75;37;4;33;.892;3571000;0
38969;87164;167;0;0;0;0;.00nan;0;0
38969;91703;4247;76;27;2;25;.926;3600000;0
38970;173918;3916;0;0;0;0;.00nan;0;0
38970;185744;175;0;0;0;0;.00nan;0;0
38970;78587;175;82;27;1;26;.963;3600000;0
38970;91358;3916;66;22;2;20;.909;3554000;0
38971;169166;169;47;33;5;28;.848;3600000;0
38971;78094;169;0;0;0;0;.00nan;0;0
38971;78581;172;45;27;4;23;.852;3600000;0
38971;92313;172;0;0;0;0;.00nan;0;0
38972;2495;171;59;36;4;32;.889;3739000;0
38972;168001;171;0;0;0;0;.00nan;0;0
38972;-1;174;0;0;0;0;.00nan;0;0
38972;161046;174;63;37;5;32;.865;3739000;0
38973;2495;171;0;0;0;0;.00nan;0;0
38973;168001;171;68;40;4;36;.900;3600000;0
38973;-1;174;70;22;1;21;.955;3600000;0
38973;161046;174;0;0;0;0;.00nan;0;0
38974;181874;1527;70;25;1;24;.960;3900000;0
38974;191692;170;0;0;0;0;.00nan;0;0
38974;91225;1527;0;0;0;0;.00nan;0;0
38974;139467;170;100;38;1;37;.974;3900000;0
38975;173918;3916;58;31;4;27;.871;3600000;0
38975;185744;175;33;46;8;38;.826;3600000;0
38975;78587;175;0;0;0;0;.00nan;0;0
38975;91358;3916;0;0;0;0;.00nan;0;0
38976;187657;4247;62;32;3;29;.906;3585000;0
38976;175658;167;0;0;0;0;.00nan;0;0
38976;87164;167;81;35;1;34;.971;3600000;0
38976;91703;4247;0;0;0;0;.00nan;0;0
38977;169166;169;0;0;0;0;.00nan;0;0
38977;78094;169;80;27;1;26;.963;3600000;0
38977;78581;172;72;29;2;27;.931;3600000;0
38977;92313;172;0;0;0;0;.00nan;0;0
38978;187657;4247;0;0;0;0;.00nan;0;0
38978;185744;175;16;16;5;11;.688;1351000;0
38978;78587;175;36;20;4;16;.800;2249000;0
38978;91703;4247;75;31;2;29;.935;3600000;0
38979;169166;169;52;27;4;23;.852;3600000;0
38979;191692;170;50;30;5;25;.833;3528000;0
38979;78094;169;0;0;0;0;.00nan;0;0
38979;139467;170;0;0;0;0;.00nan;0;0
38980;181874;1527;0;0;0;0;.00nan;0;0
38980;78581;172;0;0;0;0;.00nan;0;0
38980;91225;1527;74;34;3;31;.912;3578000;0
38980;92313;172;83;17;1;16;.941;3600000;0
38981;-1;174;0;0;0;0;.00nan;0;0
38981;78581;172;52;24;4;20;.833;3600000;0
38981;92313;172;0;0;0;0;.00nan;0;0
38981;161046;174;98;33;1;32;.970;3600000;0
38982;2495;171;98;30;0;30;1.000;3600000;0
38982;168001;171;0;0;0;0;.00nan;0;0
38982;185744;175;64;40;6;34;.850;3224000;0
38982;78587;175;53;3;0;3;1.000;376000;0
38983;187657;4247;0;0;0;0;.00nan;0;0
38983;175658;167;80;31;1;30;.968;3583000;0
38983;87164;167;0;0;0;0;.00nan;0;0
38983;91703;4247;100;43;0;43;1.000;3600000;0
38984;169166;169;66;27;2;25;.926;3600000;0
38984;-1;174;83;26;1;25;.962;3600000;0
38984;78094;169;0;0;0;0;.00nan;0;0
38984;161046;174;0;0;0;0;.00nan;0;0
38985;173918;3916;56;37;5;32;.865;3817000;0
38985;78581;172;0;0;0;0;.00nan;0;0
38985;91358;3916;0;0;0;0;.00nan;0;0
38985;92313;172;71;41;4;37;.902;3820000;0
38986;181874;1527;72;31;3;28;.903;3580000;0
38986;191692;170;91;38;2;36;.947;3600000;0
38986;91225;1527;0;0;0;0;.00nan;0;0
38986;139467;170;0;0;0;0;.00nan;0;0
38987;187657;4247;0;0;0;0;.00nan;0;0
38987;185744;175;0;0;0;0;.00nan;0;0
38987;78587;175;76;37;3;34;.919;3541000;0
38987;91703;4247;57;16;1;15;.938;3600000;0
38988;169166;169;0;0;0;0;.00nan;0;0
38988;175658;167;0;0;0;0;.00nan;0;0
38988;78094;169;90;28;1;27;.964;3600000;0
38988;87164;167;46;33;5;28;.848;3600000;0
38989;2495;171;90;33;1;32;.970;3600000;0
38989;168001;171;0;0;0;0;.00nan;0;0
38989;-1;174;0;0;0;0;.00nan;0;0
38989;161046;174;71;40;4;36;.900;3600000;0
38990;173918;3916;0;0;0;0;.00nan;0;0
38990;78581;172;51;24;3;21;.875;3600000;0
38990;91358;3916;52;27;4;23;.852;3555000;0
38990;92313;172;0;0;0;0;.00nan;0;0
38991;181874;1527;0;0;0;0;.00nan;0;0
38991;191692;170;0;0;0;0;.00nan;0;0
38991;91225;1527;43;28;5;23;.821;3600000;0
38991;139467;170;75;29;2;27;.931;3600000;0
38992;187657;4247;0;0;0;0;.00nan;0;0
38992;191692;170;50;37;5;32;.865;3600000;0
38992;91703;4247;68;24;2;22;.917;3600000;0
38992;139467;170;0;0;0;0;.00nan;0;0
38993;169166;169;60;33;4;29;.879;3600000;0
38993;175658;167;80;33;3;30;.909;3600000;0
38993;78094;169;0;0;0;0;.00nan;0;0
38993;87164;167;0;0;0;0;.00nan;0;0
38994;173918;3916;0;0;0;0;.00nan;0;0
38994;78581;172;95;33;1;32;.970;3600000;0
38994;91358;3916;44;27;4;23;.852;3600000;0
38994;92313;172;0;0;0;0;.00nan;0;0
38995;2495;171;0;0;0;0;.00nan;0;0
38995;168001;171;80;30;1;29;.967;3900000;0
38995;181874;1527;0;0;0;0;.00nan;0;0
38995;91225;1527;99;34;1;33;.971;3900000;0
38996;185744;175;68;45;4;41;.911;3880000;0
38996;-1;174;0;0;0;0;.00nan;0;0
38996;78587;175;0;0;0;0;.00nan;0;0
38996;161046;174;50;22;3;19;.864;3880000;0
38997;187657;4247;10;17;6;11;.647;2901000;0
38997;191692;170;0;0;0;0;.00nan;0;0
38997;91703;4247;48;0;0;0;.00nan;699000;0
38997;139467;170;95;28;1;27;.964;3600000;0
38998;169166;169;0;0;0;0;.00nan;0;0
38998;175658;167;0;0;0;0;.00nan;0;0
38998;78094;169;73;22;1;21;.955;3600000;0
38998;87164;167;82;39;3;36;.923;3583000;0
38999;173918;3916;55;36;4;32;.889;3569000;0
38999;78581;172;0;0;0;0;.00nan;0;0
38999;91358;3916;0;0;0;0;.00nan;0;0
38999;92313;172;63;18;2;16;.889;3600000;0
39000;2495;171;52;31;4;27;.871;3513000;0
39000;168001;171;0;0;0;0;.00nan;0;0
39000;181874;1527;73;31;2;29;.935;3600000;0
39000;91225;1527;0;0;0;0;.00nan;0;0
39001;185744;175;0;0;0;0;.00nan;0;0
39001;-1;174;39;19;4;15;.789;3518000;0
39001;78587;175;71;26;2;24;.923;3600000;0
39001;161046;174;0;0;0;0;.00nan;0;0
39002;173918;3916;0;0;0;0;.00nan;0;0
39002;78581;172;51;23;3;20;.870;3547000;0
39002;91358;3916;91;38;2;36;.947;3600000;0
39002;92313;172;0;0;0;0;.00nan;0;0
39003;2495;171;67;28;4;24;.857;3600000;0
39003;187657;4247;0;0;0;0;.00nan;0;0
39003;168001;171;0;0;0;0;.00nan;0;0
39003;91703;4247;44;39;6;33;.846;3600000;0
39004;169166;169;82;24;1;23;.958;3706000;0
39004;181874;1527;0;0;0;0;.00nan;0;0
39004;78094;169;0;0;0;0;.00nan;0;0
39004;91225;1527;76;24;2;22;.917;3706000;0
39005;169166;169;0;0;0;0;.00nan;0;0
39005;185744;175;61;21;2;19;.905;3561000;0
39005;78094;169;100;28;0;28;1.000;3600000;0
39005;78587;175;0;0;0;0;.00nan;0;0
39006;2495;171;58;38;5;33;.868;3900000;0
39006;168001;171;0;0;0;0;.00nan;0;0
39006;175658;167;57;45;5;40;.889;3900000;0
39006;87164;167;0;0;0;0;.00nan;0;0
39007;191692;170;87;52;4;48;.923;3600000;0
39007;78581;172;100;19;0;19;1.000;3600000;0
39007;92313;172;0;0;0;0;.00nan;0;0
39007;139467;170;0;0;0;0;.00nan;0;0
39008;173918;3916;0;0;0;0;.00nan;0;0
39008;-1;174;57;33;4;29;.879;3600000;0
39008;91358;3916;80;25;1;24;.960;3600000;0
39008;161046;174;0;0;0;0;.00nan;0;0
39009;187657;4247;0;0;0;0;.00nan;0;0
39009;181874;1527;53;25;3;22;.880;3600000;0
39009;91225;1527;0;0;0;0;.00nan;0;0
39009;91703;4247;79;45;4;41;.911;3579000;0
39010;169166;169;0;0;0;0;.00nan;0;0
39010;185744;175;0;0;0;0;.00nan;0;0
39010;78094;169;70;16;1;15;.938;3775000;0
39010;78587;175;65;31;2;29;.935;3775000;0
39011;2495;171;82;27;1;26;.963;3600000;0
39011;168001;171;0;0;0;0;.00nan;0;0
39011;175658;167;0;0;0;0;.00nan;0;0
39011;87164;167;63;35;4;31;.886;3600000;0
39012;187657;4247;0;0;0;0;.00nan;0;0
39012;181874;1527;0;0;0;0;.00nan;0;0
39012;91225;1527;89;36;2;34;.944;3900000;0
39012;91703;4247;80;24;2;22;.917;3900000;0
39013;169166;169;77;20;1;19;.950;3600000;0
39013;-1;174;88;35;2;33;.943;3600000;0
39013;78094;169;0;0;0;0;.00nan;0;0
39013;161046;174;0;0;0;0;.00nan;0;0
39014;191692;170;0;0;0;0;.00nan;0;0
39014;78581;172;83;48;3;45;.938;3600000;0
39014;92313;172;0;0;0;0;.00nan;0;0
39014;139467;170;64;30;4;26;.867;3550000;0
39015;173918;3916;54;28;3;25;.893;3520000;0
39015;185744;175;90;35;1;34;.971;3600000;0
39015;78587;175;0;0;0;0;.00nan;0;0
39015;91358;3916;0;0;0;0;.00nan;0;0
39016;2495;171;0;0;0;0;.00nan;0;0
39016;168001;171;43;33;6;27;.818;3548000;0
39016;175658;167;75;44;5;39;.886;3600000;0
39016;87164;167;0;0;0;0;.00nan;0;0
39017;2495;171;51;32;5;27;.844;3600000;0
39017;168001;171;0;0;0;0;.00nan;0;0
39017;191692;170;91;39;2;37;.949;3600000;0
39017;139467;170;0;0;0;0;.00nan;0;0
39018;173918;3916;0;0;0;0;.00nan;0;0
39018;175658;167;65;26;3;23;.885;3581000;0
39018;87164;167;0;0;0;0;.00nan;0;0
39018;91358;3916;63;25;2;23;.920;3600000;0
39019;169166;169;56;38;5;33;.868;3600000;0
39019;181874;1527;22;30;7;23;.767;3167000;0
39019;78094;169;0;0;0;0;.00nan;0;0
39019;91225;1527;54;5;0;5;1.000;379000;0
39020;185744;175;72;28;2;26;.929;3600000;0
39020;-1;174;51;26;3;23;.885;3582000;0
39020;78587;175;0;0;0;0;.00nan;0;0
39020;161046;174;0;0;0;0;.00nan;0;0
39021;187657;4247;0;0;0;0;.00nan;0;0
39021;78581;172;38;27;5;22;.815;3600000;0
39021;91703;4247;57;46;6;40;.870;3559000;0
39021;92313;172;0;0;0;0;.00nan;0;0
39022;2495;171;0;0;0;0;.00nan;0;0
39022;168001;171;72;20;1;19;.950;3600000;0
39022;191692;170;0;0;0;0;.00nan;0;0
39022;139467;170;76;33;3;30;.909;3589000;0
39023;173918;3916;59;26;3;23;.885;3600000;0
39023;175658;167;0;0;0;0;.00nan;0;0
39023;87164;167;51;35;5;30;.857;3537000;0
39023;91358;3916;0;0;0;0;.00nan;0;0
39024;169166;169;0;0;0;0;.00nan;0;0
39024;181874;1527;0;0;0;0;.00nan;0;0
39024;78094;169;86;31;1;30;.968;3600000;0
39024;91225;1527;45;38;5;33;.868;3600000;0
39025;185744;175;0;0;0;0;.00nan;0;0
39025;-1;174;65;23;2;21;.913;3600000;0
39025;78587;175;58;24;3;21;.875;3595000;0
39025;161046;174;0;0;0;0;.00nan;0;0
39026;187657;4247;98;49;2;47;.959;3600000;0
39026;78581;172;35;17;4;13;.765;3568000;0
39026;91703;4247;0;0;0;0;.00nan;0;0
39026;92313;172;0;0;0;0;.00nan;0;0
39027;2495;171;59;23;4;19;.826;3621000;0
39027;168001;171;0;0;0;0;.00nan;0;0
39027;169166;169;86;39;3;36;.923;3621000;0
39027;78094;169;0;0;0;0;.00nan;0;0
39028;181874;1527;87;26;1;25;.962;3600000;0
39028;191692;170;63;36;4;32;.889;3600000;0
39028;91225;1527;0;0;0;0;.00nan;0;0
39028;139467;170;0;0;0;0;.00nan;0;0
39029;185744;175;57;35;5;30;.857;3600000;0
39029;78581;172;95;33;1;32;.970;3600000;0
39029;78587;175;0;0;0;0;.00nan;0;0
39029;92313;172;0;0;0;0;.00nan;0;0
39030;2495;171;0;0;0;0;.00nan;0;0
39030;168001;171;73;25;2;23;.920;3600000;0
39030;-1;174;51;29;4;25;.862;3537000;0
39030;161046;174;0;0;0;0;.00nan;0;0
39031;173918;3916;0;0;0;0;.00nan;0;0
39031;181874;1527;0;0;0;0;.00nan;0;0
39031;91225;1527;60;21;3;18;.857;3600000;0
39031;91358;3916;59;37;5;32;.865;3586000;0
39032;187657;4247;0;0;0;0;.00nan;0;0
39032;191692;170;22;29;6;23;.793;3194000;0
39032;91703;4247;48;28;4;24;.857;3600000;0
39032;139467;170;59;6;0;6;1.000;406000;0
39033;175658;167;0;0;0;0;.00nan;0;0
39033;78581;172;80;24;0;24;1.000;3900000;0
39033;87164;167;100;30;0;30;1.000;3900000;0
39033;92313;172;0;0;0;0;.00nan;0;0
39034;169166;169;0;0;0;0;.00nan;0;0
39034;185744;175;0;0;0;0;.00nan;0;0
39034;78094;169;64;18;1;17;.944;3600000;0
39034;78587;175;66;33;3;30;.909;3575000;0
39035;173918;3916;52;29;4;25;.862;2116000;0
39035;181874;1527;78;30;1;29;.967;3600000;0
39035;91225;1527;0;0;0;0;.00nan;0;0
39035;91358;3916;43;11;2;9;.818;1484000;0
39036;187657;4247;80;30;2;28;.933;3549000;0
39036;191692;170;0;0;0;0;.00nan;0;0
39036;91703;4247;0;0;0;0;.00nan;0;0
39036;139467;170;87;24;1;23;.958;3600000;0
39037;169166;169;50;26;4;22;.846;3892000;0
39037;-1;174;78;36;3;33;.917;3892000;0
39037;78094;169;0;0;0;0;.00nan;0;0
39037;161046;174;0;0;0;0;.00nan;0;0
39038;175658;167;0;0;0;0;.00nan;0;0
39038;78581;172;100;31;0;31;1.000;3600000;0
39038;87164;167;67;43;4;39;.907;3600000;0
39038;92313;172;0;0;0;0;.00nan;0;0
39039;2495;171;33;18;4;14;.778;3600000;0
39039;168001;171;0;0;0;0;.00nan;0;0
39039;185744;175;100;33;0;33;1.000;3600000;0
39039;78587;175;0;0;0;0;.00nan;0;0
39040;2495;171;61;18;2;16;.889;3546000;0
39040;168001;171;0;0;0;0;.00nan;0;0
39040;191692;170;85;27;1;26;.963;3600000;0
39040;139467;170;0;0;0;0;.00nan;0;0
39041;187657;4247;0;0;0;0;.00nan;0;0
39041;175658;167;0;0;0;0;.00nan;0;0
39041;87164;167;95;36;1;35;.972;3600000;0
39041;91703;4247;75;27;2;25;.926;3600000;0
39042;169166;169;62;11;1;10;.909;3600000;0
39042;185744;175;65;37;4;33;.892;3600000;0
39042;78094;169;0;0;0;0;.00nan;0;0
39042;78587;175;0;0;0;0;.00nan;0;0
39043;173918;3916;0;0;0;0;.00nan;0;0
39043;-1;174;84;33;2;31;.939;3556000;0
39043;91358;3916;90;19;0;19;1.000;3600000;0
39043;161046;174;0;0;0;0;.00nan;0;0
39044;181874;1527;73;34;3;31;.912;3600000;0
39044;78581;172;49;30;4;26;.867;3543000;0
39044;91225;1527;0;0;0;0;.00nan;0;0
39044;92313;172;0;0;0;0;.00nan;0;0
39045;2495;171;0;0;0;0;.00nan;0;0
39045;168001;171;66;27;3;24;.889;3571000;0
39045;191692;170;88;29;2;27;.931;3600000;0
39045;139467;170;0;0;0;0;.00nan;0;0
39046;187657;4247;65;32;3;29;.906;3600000;0
39046;185744;175;0;0;0;0;.00nan;0;0
39046;78587;175;61;39;4;35;.897;3548000;0
39046;91703;4247;0;0;0;0;.00nan;0;0
39047;169166;169;0;0;0;0;.00nan;0;0
39047;175658;167;74;39;3;36;.923;3900000;0
39047;78094;169;63;28;3;25;.893;3900000;0
39047;87164;167;0;0;0;0;.00nan;0;0
39048;173918;3916;0;0;0;0;.00nan;0;0
39048;-1;174;91;29;1;28;.966;3600000;0
39048;91358;3916;80;29;2;27;.931;3570000;0
39048;161046;174;0;0;0;0;.00nan;0;0
39049;181874;1527;0;0;0;0;.00nan;0;0
39049;78581;172;0;0;0;0;.00nan;0;0
39049;91225;1527;49;28;4;24;.857;3600000;0
39049;92313;172;72;25;1;24;.960;3600000;0
39050;181874;1527;68;23;2;21;.913;3600000;0
39050;191692;170;69;32;3;29;.906;3588000;0
39050;79280;170;0;0;0;0;.00nan;0;0
39050;91225;1527;0;0;0;0;.00nan;0;0
39051;185744;175;54;18;3;15;.833;3900000;0
39051;191692;170;70;27;3;24;.889;3892000;0
39051;78587;175;0;0;0;0;.00nan;0;0
39051;79280;170;0;0;0;0;.00nan;0;0
39052;175658;167;0;0;0;0;.00nan;0;0
39052;78581;172;38;35;5;30;.857;3600000;0
39052;87164;167;94;32;1;31;.969;3600000;0
39052;92313;172;0;0;0;0;.00nan;0;0
39053;2495;171;79;39;3;36;.923;3766000;0
39053;173918;3916;63;38;4;34;.895;3766000;0
39053;202059;171;0;0;0;0;.00nan;0;0
39053;91358;3916;0;0;0;0;.00nan;0;0
39054;187657;4247;0;0;0;0;.00nan;0;0
39054;169166;169;62;23;3;20;.870;3900000;0
39054;78094;169;0;0;0;0;.00nan;0;0
39054;91703;4247;73;37;3;34;.919;3900000;0
39055;181874;1527;44;41;6;35;.854;3600000;0
39055;-1;174;0;0;0;0;.00nan;0;0
39055;91225;1527;0;0;0;0;.00nan;0;0
39055;161046;174;73;26;1;25;.962;3600000;0
39056;185744;175;0;0;0;0;.00nan;0;0
39056;191692;170;0;0;0;0;.00nan;0;0
39056;78587;175;6;24;7;17;.708;3600000;0
39056;79280;170;90;31;1;30;.968;3600000;0
39057;175658;167;100;43;2;41;.953;3600000;0
39057;78581;172;35;24;5;19;.792;3600000;0
39057;87164;167;0;0;0;0;.00nan;0;0
39057;92313;172;0;0;0;0;.00nan;0;0
39058;2495;171;0;0;0;0;.00nan;0;0
39058;173918;3916;72;32;3;29;.906;3900000;0
39058;202059;171;70;35;3;32;.914;3900000;0
39058;91358;3916;0;0;0;0;.00nan;0;0
39059;187657;4247;79;25;1;24;.960;3600000;0
39059;169166;169;64;30;4;26;.867;3600000;0
39059;78094;169;0;0;0;0;.00nan;0;0
39059;91703;4247;0;0;0;0;.00nan;0;0
39060;181874;1527;0;0;0;0;.00nan;0;0
39060;-1;174;89;41;2;39;.951;3653000;0
39060;91225;1527;69;30;3;27;.900;3653000;0
39060;161046;174;0;0;0;0;.00nan;0;0
39061;175658;167;0;0;0;0;.00nan;0;0
39061;78581;172;0;0;0;0;.00nan;0;0
39061;87164;167;81;29;2;27;.931;3766000;0
39061;92313;172;62;28;3;25;.893;3766000;0
39062;187657;4247;0;0;0;0;.00nan;0;0
39062;173918;3916;0;0;0;0;.00nan;0;0
39062;91358;3916;86;41;2;39;.951;3582000;0
39062;91703;4247;92;36;1;35;.972;3600000;0
39063;181874;1527;48;35;5;30;.857;3600000;0
39063;-1;174;0;0;0;0;.00nan;0;0
39063;91225;1527;0;0;0;0;.00nan;0;0
39063;161046;174;60;21;2;19;.905;3600000;0
39064;2495;171;0;0;0;0;.00nan;0;0
39064;202059;171;63;23;2;21;.913;3600000;0
39064;191692;170;77;34;3;31;.912;3554000;0
39064;79280;170;0;0;0;0;.00nan;0;0
39065;169166;169;89;24;1;23;.958;3600000;0
39065;185744;175;48;39;7;32;.821;3600000;0
39065;78094;169;0;0;0;0;.00nan;0;0
39065;78587;175;0;0;0;0;.00nan;0;0
39066;2495;171;0;0;0;0;.00nan;0;0
39066;169166;169;48;23;4;19;.826;3534000;0
39066;202059;171;80;35;2;33;.943;3600000;0
39066;78094;169;0;0;0;0;.00nan;0;0
39067;191692;170;59;36;4;32;.889;3600000;0
39067;78581;172;61;25;3;22;.880;3600000;0
39067;79280;170;0;0;0;0;.00nan;0;0
39067;92313;172;0;0;0;0;.00nan;0;0
39068;187657;4247;0;0;0;0;.00nan;0;0
39068;-1;174;67;34;3;31;.912;3600000;0
39068;91703;4247;85;15;0;15;1.000;3600000;0
39068;161046;174;0;0;0;0;.00nan;0;0
39069;175658;167;0;0;0;0;.00nan;0;0
39069;181874;1527;73;36;3;33;.917;3600000;0
39069;87164;167;83;16;0;16;1.000;3600000;0
39069;91225;1527;0;0;0;0;.00nan;0;0
39070;173918;3916;75;23;1;22;.957;3600000;0
39070;185744;175;61;31;3;28;.903;3574000;0
39070;78587;175;0;0;0;0;.00nan;0;0
39070;91358;3916;0;0;0;0;.00nan;0;0
39071;2495;171;0;0;0;0;.00nan;0;0
39071;169166;169;97;46;1;45;.978;3900000;0
39071;202059;171;95;28;1;27;.964;3900000;0
39071;78094;169;0;0;0;0;.00nan;0;0
39072;187657;4247;0;0;0;0;.00nan;0;0
39072;-1;174;0;0;0;0;.00nan;0;0
39072;91703;4247;75;22;1;21;.955;3600000;0
39072;161046;174;40;28;5;23;.821;3600000;0
39073;191692;170;0;0;0;0;.00nan;0;0
39073;78581;172;100;30;0;30;1.000;3600000;0
39073;79280;170;79;44;3;41;.932;3600000;0
39073;92313;172;0;0;0;0;.00nan;0;0
39074;175658;167;0;0;0;0;.00nan;0;0
39074;181874;1527;0;0;0;0;.00nan;0;0
39074;87164;167;100;44;1;43;.977;3600000;0
39074;91225;1527;62;27;2;25;.926;3558000;0
39075;173918;3916;0;0;0;0;.00nan;0;0
39075;185744;175;0;0;0;0;.00nan;0;0
39075;78587;175;40;32;5;27;.844;3548000;0
39075;91358;3916;90;47;3;44;.936;3600000;0
39076;175658;167;88;33;2;31;.939;3600000;0
39076;181874;1527;66;43;5;38;.884;3600000;0
39076;87164;167;0;0;0;0;.00nan;0;0
39076;91225;1527;0;0;0;0;.00nan;0;0
39077;187657;4247;0;0;0;0;.00nan;0;0
39077;173918;3916;47;39;6;33;.846;3339000;0
39077;91358;3916;53;3;0;3;1.000;261000;0
39077;91703;4247;66;15;2;13;.867;3600000;0
39078;2495;171;0;0;0;0;.00nan;0;0
39078;202059;171;66;33;3;30;.909;3900000;0
39078;78581;172;80;28;3;25;.893;3900000;0
39078;92313;172;0;0;0;0;.00nan;0;0
39079;175658;167;70;30;3;27;.900;3600000;0
39079;-1;174;15;24;7;17;.708;2275000;0
39079;87164;167;0;0;0;0;.00nan;0;0
39079;161046;174;79;17;0;17;1.000;1325000;0
39080;169166;169;57;16;2;14;.875;3600000;0
39080;173918;3916;0;0;0;0;.00nan;0;0
39080;78094;169;0;0;0;0;.00nan;0;0
39080;91358;3916;68;41;4;37;.902;3547000;0
39081;187657;4247;68;34;4;30;.882;3900000;0
39081;185744;175;57;30;4;26;.867;3900000;0
39081;78587;175;0;0;0;0;.00nan;0;0
39081;91703;4247;0;0;0;0;.00nan;0;0
39082;181874;1527;50;20;3;17;.850;3600000;0
39082;191692;170;71;41;5;36;.878;3600000;0
39082;79280;170;0;0;0;0;.00nan;0;0
39082;91225;1527;0;0;0;0;.00nan;0;0
39083;2495;171;0;0;0;0;.00nan;0;0
39083;202059;171;68;35;3;32;.914;3526000;0
39083;78581;172;79;22;1;21;.955;3600000;0
39083;92313;172;0;0;0;0;.00nan;0;0
39084;175658;167;100;34;0;34;1.000;3600000;0
39084;-1;174;0;0;0;0;.00nan;0;0
39084;87164;167;0;0;0;0;.00nan;0;0
39084;161046;174;69;39;4;35;.897;3600000;0
39085;187657;4247;0;0;0;0;.00nan;0;0
39085;185744;175;0;0;0;0;.00nan;0;0
39085;78587;175;48;34;5;29;.853;3600000;0
39085;91703;4247;80;26;1;25;.962;3600000;0
39086;169166;169;0;0;0;0;.00nan;0;0
39086;173918;3916;22;24;6;18;.750;3600000;0
39086;78094;169;72;21;2;19;.905;3600000;0
39086;91358;3916;0;0;0;0;.00nan;0;0
39087;181874;1527;0;0;0;0;.00nan;0;0
39087;191692;170;0;0;0;0;.00nan;0;0
39087;79280;170;94;31;1;30;.968;3600000;0
39087;91225;1527;97;23;0;23;1.000;3600000;0
39088;173918;3916;0;0;0;0;.00nan;0;0
39088;191692;170;72;27;2;25;.926;3728000;0
39088;79280;170;0;0;0;0;.00nan;0;0
39088;91358;3916;72;32;3;29;.906;3728000;0
39089;2495;171;0;0;0;0;.00nan;0;0
39089;175658;167;63;35;4;31;.886;3588000;0
39089;202059;171;84;33;2;31;.939;3600000;0
39089;87164;167;0;0;0;0;.00nan;0;0
39090;169166;169;85;29;1;28;.966;3900000;0
39090;181874;1527;0;0;0;0;.00nan;0;0
39090;78094;169;0;0;0;0;.00nan;0;0
39090;91225;1527;86;27;1;26;.963;3900000;0
39091;-1;174;37;31;5;26;.839;3534000;0
39091;78581;172;85;37;3;34;.919;3600000;0
39091;92313;172;0;0;0;0;.00nan;0;0
39091;161046;174;0;0;0;0;.00nan;0;0
39092;187657;4247;0;0;0;0;.00nan;0;0
39092;185744;175;71;35;3;32;.914;3544000;0
39092;78587;175;0;0;0;0;.00nan;0;0
39092;91703;4247;87;38;2;36;.947;3600000;0
39093;173918;3916;72;28;2;26;.929;3600000;0
39093;191692;170;0;0;0;0;.00nan;0;0
39093;79280;170;82;36;3;33;.917;3543000;0
39093;91358;3916;0;0;0;0;.00nan;0;0
39094;2495;171;0;0;0;0;.00nan;0;0
39094;175658;167;91;32;1;31;.969;3900000;0
39094;202059;171;100;40;1;39;.975;3900000;0
39094;87164;167;0;0;0;0;.00nan;0;0
39095;169166;169;0;0;0;0;.00nan;0;0
39095;181874;1527;69;27;2;25;.926;3600000;0
39095;78094;169;63;32;3;29;.906;3570000;0
39095;91225;1527;0;0;0;0;.00nan;0;0
39096;-1;174;0;0;0;0;.00nan;0;0
39096;78581;172;80;40;2;38;.950;3900000;0
39096;92313;172;0;0;0;0;.00nan;0;0
39096;161046;174;74;25;2;23;.920;3900000;0
39097;187657;4247;90;39;3;36;.923;3900000;0
39097;185744;175;0;0;0;0;.00nan;0;0
39097;78587;175;74;34;3;31;.912;3900000;0
39097;91703;4247;0;0;0;0;.00nan;0;0
39098;191692;170;56;22;3;19;.864;3567000;0
39098;-1;174;79;26;2;24;.923;3600000;0
39098;79280;170;0;0;0;0;.00nan;0;0
39098;161046;174;0;0;0;0;.00nan;0;0
39099;175658;167;95;29;1;28;.966;3900000;0
39099;185744;175;97;40;1;39;.975;3900000;0
39099;78587;175;0;0;0;0;.00nan;0;0
39099;87164;167;0;0;0;0;.00nan;0;0
39100;169166;169;55;27;4;23;.852;3600000;0
39100;191692;170;100;35;1;34;.971;3600000;0
39100;78094;169;0;0;0;0;.00nan;0;0
39100;79280;170;0;0;0;0;.00nan;0;0
39101;187657;4247;0;0;0;0;.00nan;0;0
39101;175658;167;58;38;5;33;.868;3600000;0
39101;87164;167;0;0;0;0;.00nan;0;0
39101;91703;4247;65;26;2;24;.923;3600000;0
39102;173918;3916;92;35;2;33;.943;3600000;0
39102;-1;174;0;0;0;0;.00nan;0;0
39102;91358;3916;0;0;0;0;.00nan;0;0
39102;161046;174;90;30;1;29;.967;3600000;0
39103;181874;1527;87;30;1;29;.967;3600000;0
39103;78581;172;47;20;3;17;.850;3512000;0
39103;91225;1527;0;0;0;0;.00nan;0;0
39103;92313;172;0;0;0;0;.00nan;0;0
39104;2495;171;0;0;0;0;.00nan;0;0
39104;202059;171;55;24;3;21;.875;3515000;0
39104;185744;175;0;0;0;0;.00nan;0;0
39104;78587;175;93;36;1;35;.972;3600000;0
39105;169166;169;0;0;0;0;.00nan;0;0
39105;191692;170;0;0;0;0;.00nan;0;0
39105;78094;169;72;17;1;16;.941;3600000;0
39105;79280;170;72;33;3;30;.909;3548000;0
39106;173918;3916;0;0;0;0;.00nan;0;0
39106;-1;174;91;16;0;16;1.000;3600000;0
39106;91358;3916;17;30;7;23;.767;3600000;0
39106;161046;174;0;0;0;0;.00nan;0;0
39107;187657;4247;86;46;4;42;.913;3600000;0
39107;175658;167;45;28;5;23;.821;3600000;0
39107;87164;167;0;0;0;0;.00nan;0;0
39107;91703;4247;0;0;0;0;.00nan;0;0
39108;181874;1527;0;0;0;0;.00nan;0;0
39108;78581;172;59;27;3;24;.889;3900000;0
39108;91225;1527;75;36;3;33;.917;3900000;0
39108;92313;172;0;0;0;0;.00nan;0;0
39109;2495;171;0;0;0;0;.00nan;0;0
39109;202059;171;78;36;3;33;.917;3544000;0
39109;185744;175;100;46;1;45;.978;3600000;0
39109;78587;175;0;0;0;0;.00nan;0;0
39110;2495;171;0;0;0;0;.00nan;0;0
39110;175658;167;51;40;5;35;.875;3600000;0
39110;202059;171;88;29;1;28;.966;3600000;0
39110;87164;167;0;0;0;0;.00nan;0;0
39111;187657;4247;0;0;0;0;.00nan;0;0
39111;173918;3916;74;32;2;30;.938;3900000;0
39111;91358;3916;0;0;0;0;.00nan;0;0
39111;91703;4247;91;39;2;37;.949;3900000;0
39112;169166;169;31;21;5;16;.762;3600000;0
39112;-1;174;39;42;7;35;.833;3558000;0
39112;78094;169;0;0;0;0;.00nan;0;0
39112;161046;174;0;0;0;0;.00nan;0;0
39113;191692;170;48;34;5;29;.853;3600000;0
39113;78581;172;73;22;2;20;.909;3600000;0
39113;79280;170;0;0;0;0;.00nan;0;0
39113;92313;172;0;0;0;0;.00nan;0;0
39114;181874;1527;81;32;2;30;.938;3600000;0
39114;185744;175;58;42;5;37;.881;3600000;0
39114;78587;175;0;0;0;0;.00nan;0;0
39114;91225;1527;0;0;0;0;.00nan;0;0
39115;2495;171;0;0;0;0;.00nan;0;0
39115;187657;4247;57;36;5;31;.861;3876000;0
39115;202059;171;57;39;5;34;.872;3900000;0
39115;91703;4247;0;0;0;0;.00nan;0;0
39116;173918;3916;0;0;0;0;.00nan;0;0
39116;175658;167;66;31;2;29;.935;3639000;0
39116;87164;167;0;0;0;0;.00nan;0;0
39116;91358;3916;94;34;1;33;.971;3639000;0
39117;169166;169;0;0;0;0;.00nan;0;0
39117;-1;174;0;0;0;0;.00nan;0;0
39117;78094;169;77;27;3;24;.889;3563000;0
39117;161046;174;90;32;1;31;.969;3600000;0
39118;191692;170;0;0;0;0;.00nan;0;0
39118;78581;172;65;25;2;23;.920;3600000;0
39118;79280;170;75;45;4;41;.911;3530000;0
39118;92313;172;0;0;0;0;.00nan;0;0
39119;181874;1527;0;0;0;0;.00nan;0;0
39119;185744;175;0;0;0;0;.00nan;0;0
39119;78587;175;44;30;5;25;.833;3600000;0
39119;91225;1527;53;24;4;20;.833;3600000;0
39120;191692;170;76;33;3;30;.909;3578000;0
39120;-1;174;0;0;0;0;.00nan;0;0
39120;79280;170;0;0;0;0;.00nan;0;0
39120;161046;174;71;25;2;23;.920;3600000;0
39121;175658;167;0;0;0;0;.00nan;0;0
39121;185744;175;80;38;4;34;.895;3600000;0
39121;78587;175;0;0;0;0;.00nan;0;0
39121;87164;167;49;31;5;26;.839;3581000;0
39122;187657;4247;82;25;1;24;.960;3600000;0
39122;173918;3916;74;15;1;14;.933;1750000;0
39122;91358;3916;25;28;6;22;.786;1850000;0
39122;91703;4247;0;0;0;0;.00nan;0;0
39123;2495;171;0;0;0;0;.00nan;0;0
39123;169166;169;57;18;2;16;.889;3600000;0
39123;202059;171;40;25;5;20;.800;3600000;0
39123;78094;169;0;0;0;0;.00nan;0;0
39124;181874;1527;94;36;1;35;.972;3900000;0
39124;78581;172;100;40;1;39;.975;3900000;0
39124;91225;1527;0;0;0;0;.00nan;0;0
39124;92313;172;0;0;0;0;.00nan;0;0
39125;191692;170;0;0;0;0;.00nan;0;0
39125;-1;174;70;21;2;19;.905;3600000;0
39125;79280;170;60;36;5;31;.861;3600000;0
39125;161046;174;0;0;0;0;.00nan;0;0
39126;175658;167;58;27;4;23;.852;3591000;0
39126;185744;175;0;0;0;0;.00nan;0;0
39126;78587;175;86;36;2;34;.944;3600000;0
39126;87164;167;0;0;0;0;.00nan;0;0
39127;187657;4247;0;0;0;0;.00nan;0;0
39127;173918;3916;87;43;3;40;.930;3571000;0
39127;91358;3916;0;0;0;0;.00nan;0;0
39127;91703;4247;85;20;1;19;.950;3600000;0
39128;2495;171;0;0;0;0;.00nan;0;0
39128;169166;169;0;0;0;0;.00nan;0;0
39128;202059;171;100;30;0;30;1.000;3600000;0
39128;78094;169;58;27;3;24;.889;3600000;0
39129;181874;1527;0;0;0;0;.00nan;0;0
39129;78581;172;0;0;0;0;.00nan;0;0
39129;91225;1527;70;42;4;38;.905;3600000;0
39129;92313;172;75;22;1;21;.955;3600000;0
39130;169166;169;76;26;1;25;.962;3900000;0
39130;-1;174;91;33;1;32;.970;3900000;0
39130;78094;169;0;0;0;0;.00nan;0;0
39130;161046;174;0;0;0;0;.00nan;0;0
39131;2495;171;0;0;0;0;.00nan;0;0
39131;202059;171;36;29;5;24;.828;3600000;0
39131;191692;170;76;26;2;24;.923;3600000;0
39131;79280;170;0;0;0;0;.00nan;0;0
39132;187657;4247;0;0;0;0;.00nan;0;0
39132;185744;175;79;32;2;30;.938;3600000;0
39132;78587;175;0;0;0;0;.00nan;0;0
39132;91703;4247;44;23;4;19;.826;3531000;0
39133;169166;169;8;31;8;23;.742;3543000;0
39133;173918;3916;43;44;7;37;.841;3336000;0
39133;78094;169;0;0;0;0;.00nan;0;0
39133;91358;3916;51;1;0;1;1.000;264000;0
39134;175658;167;39;25;5;20;.800;3537000;0
39134;-1;174;60;24;3;21;.875;3600000;0
39134;87164;167;0;0;0;0;.00nan;0;0
39134;161046;174;0;0;0;0;.00nan;0;0
39135;181874;1527;96;38;1;37;.974;3600000;0
39135;78581;172;65;44;6;38;.864;3263000;0
39135;91225;1527;0;0;0;0;.00nan;0;0
39135;92313;172;50;1;0;1;1.000;337000;0
39136;2495;171;0;0;0;0;.00nan;0;0
39136;202059;171;32;26;5;21;.808;3600000;0
39136;191692;170;0;0;0;0;.00nan;0;0
39136;79280;170;75;27;2;25;.926;3600000;0
39137;169166;169;0;0;0;0;.00nan;0;0
39137;173918;3916;0;0;0;0;.00nan;0;0
39137;78094;169;74;26;2;24;.923;3600000;0
39137;91358;3916;49;37;5;32;.865;3600000;0
39138;175658;167;0;0;0;0;.00nan;0;0
39138;-1;174;0;0;0;0;.00nan;0;0
39138;87164;167;81;39;3;36;.923;3517000;0
39138;161046;174;92;29;1;28;.966;3600000;0
39139;181874;1527;0;0;0;0;.00nan;0;0
39139;78581;172;0;0;0;0;.00nan;0;0
39139;91225;1527;56;44;6;38;.864;3600000;0
39139;92313;172;93;34;1;33;.971;3600000;0
39140;187657;4247;46;26;4;22;.846;3600000;0
39140;185744;175;0;0;0;0;.00nan;0;0
39140;78587;175;48;43;6;37;.860;3548000;0
39140;91703;4247;0;0;0;0;.00nan;0;0
39142;175658;167;0;0;0;0;.00nan;0;0
39142;78581;172;72;20;1;19;.950;3600000;0
39142;87164;167;80;36;3;33;.917;3561000;0
39142;92313;172;0;0;0;0;.00nan;0;0
39144;181874;1527;93;33;1;32;.970;3600000;0
39144;57434;1527;0;0;0;0;.00nan;0;0
39144;78094;169;0;0;0;0;.00nan;0;0
39144;91225;169;83;34;2;32;.941;3600000;0
39146;2495;171;50;18;3;15;.833;3600000;0
39146;168001;171;0;0;0;0;.00nan;0;0
39146;173918;3916;38;27;5;22;.815;3600000;0
39146;91358;3916;0;0;0;0;.00nan;0;0
39148;187657;4247;66;21;2;19;.905;3600000;0
39148;191692;170;63;26;3;23;.885;3570000;0
39148;91703;4247;0;0;0;0;.00nan;0;0
39148;139467;170;0;0;0;0;.00nan;0;0
39150;163989;174;85;25;1;24;.960;3600000;0
39150;185744;175;45;36;6;30;.833;3174000;0
39150;78587;175;52;2;0;2;1.000;426000;0
39150;161046;174;0;0;0;0;.00nan;0;0
2014;185744;175;59;34;4;30;.882;3600000;0
2014;78581;172;100;28;0;28;1.000;3600000;0
2014;78587;175;0;0;0;0;.00nan;0;0
2014;92313;172;0;0;0;0;.00nan;0;0
2015;187657;4247;0;0;0;0;.00nan;0;0
2015;175658;167;69;28;2;26;.929;3600000;0
2015;87164;167;0;0;0;0;.00nan;0;0
2015;91703;4247;63;35;4;31;.886;3546000;0
2016;181874;1527;35;36;7;29;.806;3600000;0
2016;-1;174;0;0;0;0;.00nan;0;0
2016;91225;1527;0;0;0;0;.00nan;0;0
2016;161046;174;56;26;3;23;.885;3600000;0
2017;2495;171;0;0;0;0;.00nan;0;0
2017;169166;169;96;20;0;20;1.000;3600000;0
2017;202059;171;39;26;5;21;.808;3600000;0
2017;78094;169;0;0;0;0;.00nan;0;0
2018;185744;175;88;48;4;44;.917;3554000;0
2018;78581;172;53;20;2;18;.900;3600000;0
2018;78587;175;0;0;0;0;.00nan;0;0
2018;92313;172;0;0;0;0;.00nan;0;0
2019;187657;4247;0;0;0;0;.00nan;0;0
2019;175658;167;67;27;2;25;.926;3925000;0
2019;87164;167;0;0;0;0;.00nan;0;0
2019;91703;4247;58;26;3;23;.885;3925000;0
2020;181874;1527;66;19;2;17;.895;3600000;0
2020;-1;174;52;47;6;41;.872;3600000;0
2020;91225;1527;0;0;0;0;.00nan;0;0
2020;161046;174;0;0;0;0;.00nan;0;0
2021;2495;171;0;0;0;0;.00nan;0;0
2021;169166;169;78;29;2;27;.931;3600000;0
2021;202059;171;67;32;3;29;.906;3546000;0
2021;78094;169;0;0;0;0;.00nan;0;0
2152;181874;1527;44;30;5;25;.833;3600000;0
2152;-1;174;67;29;3;26;.897;3600000;0
2152;91225;1527;0;0;0;0;.00nan;0;0
2152;161046;174;0;0;0;0;.00nan;0;0
2159;175658;167;86;44;3;41;.932;3793000;0
2159;78581;172;72;33;4;29;.879;3793000;0
2159;87164;167;0;0;0;0;.00nan;0;0
2159;92313;172;0;0;0;0;.00nan;0;0
2160;169166;169;99;45;2;43;.956;3872000;0
2160;-1;174;89;34;3;31;.912;3872000;0
2160;78094;169;0;0;0;0;.00nan;0;0
2160;161046;174;0;0;0;0;.00nan;0;0
2161;175658;167;50;33;4;29;.879;4039000;0
2161;78581;172;76;44;5;39;.886;4039000;0
2161;87164;167;0;0;0;0;.00nan;0;0
2161;92313;172;0;0;0;0;.00nan;0;0
2162;169166;169;98;23;0;23;1.000;3600000;0
2162;-1;174;19;24;6;18;.750;2413000;0
2162;78094;169;0;0;0;0;.00nan;0;0
2162;161046;174;61;16;1;15;.938;1187000;0
2311;169166;169;64;28;3;25;.893;3554000;0
2311;175658;167;87;33;2;31;.939;3600000;0
2311;78094;169;0;0;0;0;.00nan;0;0
2311;87164;167;0;0;0;0;.00nan;0;0
2312;169166;169;79;25;1;24;.960;3600000;0
2312;175658;167;76;40;3;37;.925;3525000;0
2312;78094;169;0;0;0;0;.00nan;0;0
2312;87164;167;0;0;0;0;.00nan;0;0
2427;169166;169;54;19;2;17;.895;3600000;0
2427;175658;167;76;43;4;39;.907;3557000;0
2427;78094;169;0;0;0;0;.00nan;0;0
2427;87164;167;0;0;0;0;.00nan;0;0
39151;183832;436;71;23;1;22;.957;3600000;0
39151;179657;441;30;31;6;25;.806;3327000;0
39151;191713;441;52;3;0;3;1.000;273000;0
39151;191861;436;0;0;0;0;.00nan;0;0
39152;168414;444;0;0;0;0;.00nan;0;0
39152;189288;419;0;0;0;0;.00nan;0;0
39152;196975;419;89;36;1;35;.972;3600000;0
39152;191812;444;77;29;2;27;.931;3588000;0
39153;200179;420;61;21;2;19;.905;3600000;0
39153;194598;418;25;25;6;19;.760;3157000;0
39153;186076;420;0;0;0;0;.00nan;0;0
39153;191687;418;50;1;0;1;1.000;443000;0
39154;168414;444;62;28;3;25;.893;3836000;0
39154;189288;419;0;0;0;0;.00nan;0;0
39154;196975;419;82;33;2;31;.939;3836000;0
39154;191812;444;0;0;0;0;.00nan;0;0
39155;200179;420;71;35;2;33;.943;3544000;0
39155;194598;418;0;0;0;0;.00nan;0;0
39155;186076;420;0;0;0;0;.00nan;0;0
39155;191687;418;100;39;1;38;.974;3600000;0
39156;189318;421;0;0;0;0;.00nan;0;0
39156;179127;422;53;23;3;20;.870;3724000;0
39156;179169;421;91;32;2;30;.938;3724000;0
39156;180578;422;0;0;0;0;.00nan;0;0
39157;171877;423;0;0;0;0;.00nan;0;0
39157;188965;423;44;33;5;28;.848;3566000;0
39157;183885;449;74;25;3;22;.880;3600000;0
39157;-1;449;0;0;0;0;.00nan;0;0
39158;189318;421;0;0;0;0;.00nan;0;0
39158;179127;422;57;34;4;30;.882;3600000;0
39158;179169;421;36;31;5;26;.839;3565000;0
39158;180578;422;0;0;0;0;.00nan;0;0
39159;171877;423;0;0;0;0;.00nan;0;0
39159;188965;423;85;16;0;16;1.000;3600000;0
39159;183885;449;82;40;3;37;.925;3600000;0
39159;-1;449;0;0;0;0;.00nan;0;0
39160;194456;414;49;24;3;21;.875;3548000;0
39160;184033;411;0;0;0;0;.00nan;0;0
39160;181346;414;0;0;0;0;.00nan;0;0
39160;197699;411;80;33;2;31;.939;3600000;0
39161;184336;429;0;0;0;0;.00nan;0;0
39161;-1;429;75;31;2;29;.935;3600000;0
39161;-1;426;0;0;0;0;.00nan;0;0
39161;-1;426;41;32;5;27;.844;3600000;0
39162;178743;435;0;0;0;0;.00nan;0;0
39162;170499;427;60;22;3;19;.864;4200000;0
39162;186468;427;0;0;0;0;.00nan;0;0
39162;-1;435;64;34;3;31;.912;4200000;0
39163;194803;443;0;0;0;0;.00nan;0;0
39163;182180;443;64;44;4;40;.909;3600000;0
39163;-1;433;78;27;1;26;.963;3600000;0
39163;191212;433;0;0;0;0;.00nan;0;0
39164;194146;432;0;0;0;0;.00nan;0;0
39164;191171;431;79;32;1;31;.969;3818000;0
39164;197030;432;86;35;2;33;.943;3818000;0
39164;-1;431;0;0;0;0;.00nan;0;0
39165;190073;413;81;39;2;37;.949;4186000;0
39165;179689;415;0;0;0;0;.00nan;0;0
39165;191877;415;64;24;2;22;.917;4200000;0
39165;192627;413;0;0;0;0;.00nan;0;0
39166;183885;449;71;42;4;38;.905;3600000;0
39166;189318;421;0;0;0;0;.00nan;0;0
39166;179169;421;81;27;1;26;.963;3600000;0
39166;-1;449;0;0;0;0;.00nan;0;0
39167;-1;428;50;32;4;28;.875;3563000;0
39167;-1;439;0;0;0;0;.00nan;0;0
39167;202193;439;72;35;3;32;.914;3600000;0
39167;191702;428;0;0;0;0;.00nan;0;0
39168;171787;4849;0;0;0;0;.00nan;0;0
39168;168414;444;85;24;1;23;.958;4200000;0
39168;196412;4849;89;30;1;29;.967;4200000;0
39168;191812;444;0;0;0;0;.00nan;0;0
39169;165023;438;79;24;1;23;.958;3600000;0
39169;178743;435;0;0;0;0;.00nan;0;0
39169;176196;438;0;0;0;0;.00nan;0;0
39169;-1;435;61;37;4;33;.892;3600000;0
39170;163177;425;0;0;0;0;.00nan;0;0
39170;-1;434;0;0;0;0;.00nan;0;0
39170;-1;425;77;39;2;37;.949;4200000;0
39170;186671;434;86;37;2;35;.946;4200000;0
39171;171877;423;0;0;0;0;.00nan;0;0
39171;188965;423;80;27;1;26;.963;3600000;0
39171;179127;422;0;0;0;0;.00nan;0;0
39171;180578;422;56;19;2;17;.895;3598000;0
39172;194650;410;0;0;0;0;.00nan;0;0
39172;184183;410;70;28;3;25;.893;3548000;0
39172;-1;412;0;0;0;0;.00nan;0;0
39172;-1;412;67;31;2;29;.935;3600000;0
39173;200179;420;0;0;0;0;.00nan;0;0
39173;189288;419;0;0;0;0;.00nan;0;0
39173;186076;420;65;41;4;37;.902;3600000;0
39173;196975;419;59;16;1;15;.938;3600000;0
39174;200063;442;0;0;0;0;.00nan;0;0
39174;173339;430;0;0;0;0;.00nan;0;0
39174;190157;442;76;39;3;36;.923;3600000;0
39174;-1;430;63;32;4;28;.875;3552000;0
39175;182475;437;64;26;2;24;.923;3600000;0
39175;189783;440;77;27;2;25;.926;3569000;0
39175;175723;440;0;0;0;0;.00nan;0;0
39175;186571;437;0;0;0;0;.00nan;0;0
39176;184033;411;0;0;0;0;.00nan;0;0
39176;194854;417;0;0;0;0;.00nan;0;0
39176;178890;417;99;37;1;36;.973;3600000;0
39176;197699;411;53;16;2;14;.875;3584000;0
39177;194803;443;0;0;0;0;.00nan;0;0
39177;184336;429;100;36;1;35;.972;3600000;0
39177;182180;443;52;27;4;23;.852;3600000;0
39177;-1;429;0;0;0;0;.00nan;0;0
39178;-1;428;78;25;2;23;.920;3600000;0
39178;-1;439;0;0;0;0;.00nan;0;0
39178;202193;439;31;42;7;35;.833;3600000;0
39178;191702;428;0;0;0;0;.00nan;0;0
39179;171787;4849;62;25;2;23;.920;3600000;0
39179;168414;444;47;28;4;24;.857;3600000;0
39179;196412;4849;0;0;0;0;.00nan;0;0
39179;191812;444;0;0;0;0;.00nan;0;0
39180;165023;438;0;0;0;0;.00nan;0;0
39180;176196;438;88;27;2;25;.926;3600000;0
39180;-1;434;0;0;0;0;.00nan;0;0
39180;186671;434;48;30;4;26;.867;3571000;0
39181;194650;410;100;32;1;31;.969;3600000;0
39181;184183;410;0;0;0;0;.00nan;0;0
39181;179689;415;0;0;0;0;.00nan;0;0
39181;191877;415;77;39;3;36;.923;3597000;0
39182;173339;430;0;0;0;0;.00nan;0;0
39182;191171;431;62;30;3;27;.900;3600000;0
39182;-1;430;36;22;4;18;.818;3543000;0
39182;-1;431;0;0;0;0;.00nan;0;0
39183;183885;449;0;0;0;0;.00nan;0;0
39183;189318;421;85;29;1;28;.966;3600000;0
39183;179169;421;0;0;0;0;.00nan;0;0
39183;-1;449;83;35;2;33;.943;3562000;0
39184;171877;423;0;0;0;0;.00nan;0;0
39184;188965;423;100;31;0;31;1.000;3600000;0
39184;179127;422;78;33;2;31;.939;3547000;0
39184;180578;422;0;0;0;0;.00nan;0;0
39185;200179;420;56;14;2;12;.857;3595000;0
39185;189288;419;94;34;1;33;.971;3600000;0
39185;186076;420;0;0;0;0;.00nan;0;0
39185;196975;419;0;0;0;0;.00nan;0;0
39186;190073;413;65;22;2;20;.909;3568000;0
39186;-1;412;100;39;1;38;.974;3600000;0
39186;192627;413;0;0;0;0;.00nan;0;0
39186;-1;412;0;0;0;0;.00nan;0;0
39187;200063;442;0;0;0;0;.00nan;0;0
39187;189783;440;90;36;2;34;.944;3564000;0
39187;175723;440;0;0;0;0;.00nan;0;0
39187;190157;442;84;28;1;27;.964;3600000;0
39188;194456;414;69;20;1;19;.950;3600000;0
39188;194854;417;69;47;6;41;.872;3600000;0
39188;178890;417;0;0;0;0;.00nan;0;0
39188;181346;414;0;0;0;0;.00nan;0;0
39189;182475;437;0;0;0;0;.00nan;0;0
39189;194146;432;0;0;0;0;.00nan;0;0
39189;186571;437;45;18;3;15;.833;3567000;0
39189;197030;432;85;34;2;32;.941;3600000;0
39190;178743;435;0;0;0;0;.00nan;0;0
39190;-1;433;0;0;0;0;.00nan;0;0
39190;191212;433;55;26;2;24;.923;4200000;0
39190;-1;435;81;34;2;32;.941;4200000;0
39191;200063;442;0;0;0;0;.00nan;0;0
39191;190157;442;68;27;2;25;.926;3623000;0
39191;191171;431;62;30;3;27;.900;3623000;0
39191;-1;431;0;0;0;0;.00nan;0;0
39192;194456;414;0;0;0;0;.00nan;0;0
39192;181346;414;75;31;2;29;.935;4200000;0
39192;-1;412;84;35;2;33;.943;4200000;0
39192;-1;412;0;0;0;0;.00nan;0;0
39193;179657;441;70;45;5;40;.889;3600000;0
39193;-1;439;0;0;0;0;.00nan;0;0
39193;202193;439;83;28;1;27;.964;3600000;0
39193;191713;441;0;0;0;0;.00nan;0;0
39194;182475;437;0;0;0;0;.00nan;0;0
39194;200063;442;86;32;1;31;.969;3600000;0
39194;190157;442;0;0;0;0;.00nan;0;0
39194;186571;437;63;23;2;21;.913;3586000;0
39195;-1;434;0;0;0;0;.00nan;0;0
39195;-1;433;0;0;0;0;.00nan;0;0
39195;186671;434;53;24;3;21;.875;3784000;0
39195;191212;433;95;39;2;37;.949;3784000;0
39196;194456;414;94;39;1;38;.974;3600000;0
39196;179689;415;67;29;2;27;.931;3552000;0
39196;181346;414;0;0;0;0;.00nan;0;0
39196;191877;415;0;0;0;0;.00nan;0;0
39197;168414;444;0;0;0;0;.00nan;0;0
39197;189318;421;50;29;4;25;.862;4028000;0
39197;179169;421;0;0;0;0;.00nan;0;0
39197;191812;444;83;44;3;41;.932;4028000;0
39198;178743;435;96;40;1;39;.975;3600000;0
39198;184336;429;32;27;5;22;.815;3600000;0
39198;-1;429;0;0;0;0;.00nan;0;0
39198;-1;435;0;0;0;0;.00nan;0;0
39199;194146;432;0;0;0;0;.00nan;0;0
39199;-1;428;0;0;0;0;.00nan;0;0
39199;197030;432;85;30;2;28;.933;3600000;0
39199;191702;428;43;15;3;12;.800;3583000;0
39200;183885;449;37;27;5;22;.815;3600000;0
39200;189288;419;0;0;0;0;.00nan;0;0
39200;-1;449;0;0;0;0;.00nan;0;0
39200;196975;419;86;33;1;32;.970;3600000;0
39201;184033;411;100;45;2;43;.956;3995000;0
39201;190073;413;0;0;0;0;.00nan;0;0
39201;192627;413;80;34;3;31;.912;3995000;0
39201;197699;411;0;0;0;0;.00nan;0;0
39202;163177;425;0;0;0;0;.00nan;0;0
39202;194803;443;83;39;3;36;.923;3600000;0
39202;-1;425;31;23;5;18;.783;3584000;0
39202;182180;443;0;0;0;0;.00nan;0;0
39203;165023;438;100;30;0;30;1.000;3600000;0
39203;176196;438;0;0;0;0;.00nan;0;0
39203;-1;426;0;0;0;0;.00nan;0;0
39203;-1;426;59;20;2;18;.900;3550000;0
39204;171787;4849;100;33;0;33;1.000;3600000;0
39204;179127;422;45;24;3;21;.875;3600000;0
39204;180578;422;0;0;0;0;.00nan;0;0
39204;196412;4849;0;0;0;0;.00nan;0;0
39205;171877;423;0;0;0;0;.00nan;0;0
39205;188965;423;36;20;4;16;.800;3600000;0
39205;194598;418;0;0;0;0;.00nan;0;0
39205;191687;418;78;28;1;27;.964;3600000;0
39206;194650;410;78;33;4;29;.879;3581000;0
39206;194854;417;75;28;1;27;.964;3600000;0
39206;184183;410;0;0;0;0;.00nan;0;0
39206;178890;417;0;0;0;0;.00nan;0;0
39207;173339;430;98;36;1;35;.972;3600000;0
39207;-1;439;0;0;0;0;.00nan;0;0
39207;202193;439;63;21;2;19;.905;3549000;0
39207;-1;430;0;0;0;0;.00nan;0;0
39208;183832;436;74;26;1;25;.962;3566000;0
39208;189783;440;100;32;0;32;1.000;3600000;0
39208;175723;440;0;0;0;0;.00nan;0;0
39208;191861;436;0;0;0;0;.00nan;0;0
39209;183885;449;0;0;0;0;.00nan;0;0
39209;189288;419;0;0;0;0;.00nan;0;0
39209;-1;449;69;24;2;22;.917;4200000;0
39209;196975;419;57;23;2;21;.913;4200000;0
39210;179657;441;39;34;5;29;.853;3540000;0
39210;191171;431;58;26;3;23;.885;3600000;0
39210;191713;441;0;0;0;0;.00nan;0;0
39210;-1;431;0;0;0;0;.00nan;0;0
39211;194146;432;60;24;2;22;.917;3594000;0
39211;-1;428;97;18;0;18;1.000;3600000;0
39211;197030;432;0;0;0;0;.00nan;0;0
39211;191702;428;0;0;0;0;.00nan;0;0
39212;170499;427;89;22;1;21;.955;3600000;0
39212;-1;433;0;0;0;0;.00nan;0;0
39212;186468;427;0;0;0;0;.00nan;0;0
39212;191212;433;55;28;3;25;.893;3564000;0
39213;194650;410;90;54;5;49;.907;3600000;0
39213;184033;411;0;0;0;0;.00nan;0;0
39213;184183;410;0;0;0;0;.00nan;0;0
39213;197699;411;75;25;1;24;.960;3600000;0
39214;168414;444;77;44;5;39;.886;3524000;0
39214;189318;421;0;0;0;0;.00nan;0;0
39214;179169;421;61;24;3;21;.875;3600000;0
39214;191812;444;0;0;0;0;.00nan;0;0
39215;165023;438;47;13;2;11;.846;3600000;0
39215;194803;443;0;0;0;0;.00nan;0;0
39215;176196;438;0;0;0;0;.00nan;0;0
39215;182180;443;32;35;6;29;.829;3600000;0
39216;163177;425;43;34;5;29;.853;3600000;0
39216;-1;425;0;0;0;0;.00nan;0;0
39216;-1;426;83;34;2;32;.941;3600000;0
39216;-1;426;0;0;0;0;.00nan;0;0
39217;179689;415;0;0;0;0;.00nan;0;0
39217;-1;412;64;25;2;23;.920;3600000;0
39217;191877;415;69;34;3;31;.912;3545000;0
39217;-1;412;0;0;0;0;.00nan;0;0
39218;171787;4849;80;38;3;35;.921;3600000;0
39218;179127;422;0;0;0;0;.00nan;0;0
39218;180578;422;33;24;5;19;.792;3600000;0
39218;196412;4849;0;0;0;0;.00nan;0;0
39219;171877;423;78;31;2;29;.935;4170000;0
39219;188965;423;0;0;0;0;.00nan;0;0
39219;194598;418;0;0;0;0;.00nan;0;0
39219;191687;418;87;47;3;44;.936;4187000;0
39220;194854;417;52;37;6;31;.838;3075000;0
39220;178890;417;54;4;0;4;1.000;525000;0
39220;190073;413;16;23;7;16;.696;3554000;0
39220;192627;413;0;0;0;0;.00nan;0;0
39221;184336;429;62;35;4;31;.886;3600000;0
39221;-1;434;100;28;0;28;1.000;3600000;0
39221;-1;429;0;0;0;0;.00nan;0;0
39221;186671;434;0;0;0;0;.00nan;0;0
39222;183832;436;0;0;0;0;.00nan;0;0
39222;189783;440;29;33;6;27;.818;3600000;0
39222;175723;440;0;0;0;0;.00nan;0;0
39222;191861;436;71;23;1;22;.957;3600000;0
39223;194650;410;0;0;0;0;.00nan;0;0
39223;184183;410;73;41;4;37;.902;3600000;0
39223;190073;413;0;0;0;0;.00nan;0;0
39223;192627;413;51;33;5;28;.848;3600000;0
39224;170499;427;84;30;1;29;.967;3600000;0
39224;-1;434;56;24;2;22;.917;3567000;0
39224;186468;427;0;0;0;0;.00nan;0;0
39224;186671;434;0;0;0;0;.00nan;0;0
39225;182475;437;0;0;0;0;.00nan;0;0
39225;173339;430;0;0;0;0;.00nan;0;0
39225;186571;437;56;37;6;31;.838;3593000;0
39225;-1;430;71;34;4;30;.882;3600000;0
39226;171787;4849;0;0;0;0;.00nan;0;0
39226;171877;423;0;0;0;0;.00nan;0;0
39226;188965;423;46;33;5;28;.848;3600000;0
39226;196412;4849;62;26;3;23;.885;3600000;0
39227;200063;442;0;0;0;0;.00nan;0;0
39227;173339;430;60;27;3;24;.889;3548000;0
39227;190157;442;89;37;2;35;.946;3600000;0
39227;-1;430;0;0;0;0;.00nan;0;0
39228;194854;417;0;0;0;0;.00nan;0;0
39228;178890;417;79;26;1;25;.962;3600000;0
39228;179689;415;0;0;0;0;.00nan;0;0
39228;191877;415;78;30;2;28;.933;3545000;0
39229;168414;444;0;0;0;0;.00nan;0;0
39229;183885;449;72;32;3;29;.906;3600000;0
39229;-1;449;0;0;0;0;.00nan;0;0
39229;191812;444;48;29;5;24;.828;3600000;0
39230;194803;443;82;30;1;29;.967;4200000;0
39230;-1;439;100;36;1;35;.972;4200000;0
39230;202193;439;0;0;0;0;.00nan;0;0
39230;182180;443;0;0;0;0;.00nan;0;0
39231;165023;438;87;30;1;29;.967;3600000;0
39231;194146;432;0;0;0;0;.00nan;0;0
39231;176196;438;0;0;0;0;.00nan;0;0
39231;197030;432;82;35;2;33;.943;3600000;0
39232;179657;441;72;34;3;31;.912;3521000;0
39232;-1;426;0;0;0;0;.00nan;0;0
39232;-1;426;73;21;1;20;.952;3600000;0
39232;191713;441;0;0;0;0;.00nan;0;0
39233;194598;418;0;0;0;0;.00nan;0;0
39233;189288;419;48;7;1;6;.857;573000;0
39233;196975;419;51;36;6;30;.833;3027000;0
39233;191687;418;76;27;2;25;.926;3600000;0
39234;170499;427;64;26;2;24;.923;3543000;0
39234;-1;434;0;0;0;0;.00nan;0;0
39234;186468;427;0;0;0;0;.00nan;0;0
39234;186671;434;67;21;1;20;.952;3600000;0
39235;183832;436;70;36;3;33;.917;3600000;0
39235;184336;429;50;29;4;25;.862;3565000;0
39235;-1;429;0;0;0;0;.00nan;0;0
39235;191861;436;0;0;0;0;.00nan;0;0
39236;163177;425;0;0;0;0;.00nan;0;0
39236;-1;425;99;36;1;35;.972;3600000;0
39236;191171;431;40;27;5;22;.815;2226000;0
39236;-1;431;55;6;0;6;1.000;1374000;0
39237;184033;411;0;0;0;0;.00nan;0;0
39237;-1;412;0;0;0;0;.00nan;0;0
39237;-1;412;79;32;1;31;.969;4158000;0
39237;197699;411;77;31;2;29;.935;4158000;0
39238;200179;420;93;59;3;56;.949;3593000;0
39238;179127;422;75;23;1;22;.957;3600000;0
39238;180578;422;0;0;0;0;.00nan;0;0
39238;186076;420;0;0;0;0;.00nan;0;0
39239;200063;442;67;43;5;38;.884;3853000;0
39239;178743;435;0;0;0;0;.00nan;0;0
39239;190157;442;0;0;0;0;.00nan;0;0
39239;-1;435;51;30;4;26;.867;3805000;0
39240;194456;414;70;31;2;29;.935;3567000;0
39240;194650;410;89;34;1;33;.971;3600000;0
39240;184183;410;0;0;0;0;.00nan;0;0
39240;181346;414;0;0;0;0;.00nan;0;0
39241;184033;411;50;36;4;32;.889;3564000;0
39241;179689;415;66;27;2;25;.926;3600000;0
39241;191877;415;0;0;0;0;.00nan;0;0
39241;197699;411;0;0;0;0;.00nan;0;0
39242;-1;439;0;0;0;0;.00nan;0;0
39242;202193;439;58;24;3;21;.875;3549000;0
39242;-1;426;77;30;2;28;.933;3600000;0
39242;-1;426;0;0;0;0;.00nan;0;0
39243;168414;444;0;0;0;0;.00nan;0;0
39243;183885;449;0;0;0;0;.00nan;0;0
39243;-1;449;68;23;1;22;.957;3600000;0
39243;191812;444;51;37;5;32;.865;3600000;0
39244;165023;438;0;0;0;0;.00nan;0;0
39244;176196;438;65;25;2;23;.920;3600000;0
39244;191171;431;64;34;3;31;.912;3559000;0
39244;-1;431;0;0;0;0;.00nan;0;0
39245;194803;443;0;0;0;0;.00nan;0;0
39245;179657;441;0;0;0;0;.00nan;0;0
39245;182180;443;84;15;0;15;1.000;3600000;0
39245;191713;441;67;38;3;35;.921;3600000;0
39246;-1;428;62;32;3;29;.906;3600000;0
39246;-1;433;57;32;4;28;.875;3600000;0
39246;191212;433;0;0;0;0;.00nan;0;0
39246;191702;428;0;0;0;0;.00nan;0;0
39247;194598;418;74;24;2;22;.917;3600000;0
39247;189288;419;67;30;3;27;.900;3572000;0
39247;196975;419;0;0;0;0;.00nan;0;0
39247;191687;418;0;0;0;0;.00nan;0;0
39248;183832;436;0;0;0;0;.00nan;0;0
39248;178743;435;33;17;4;13;.765;985000;0
39248;191861;436;59;22;2;20;.909;3600000;0
39248;-1;435;88;43;3;40;.930;2615000;0
39249;163177;425;68;25;2;23;.920;3600000;0
39249;194146;432;77;46;4;42;.913;3570000;0
39249;-1;425;0;0;0;0;.00nan;0;0
39249;197030;432;0;0;0;0;.00nan;0;0
39250;200179;420;0;0;0;0;.00nan;0;0
39250;179127;422;0;0;0;0;.00nan;0;0
39250;180578;422;75;38;3;35;.921;3551000;0
39250;186076;420;83;28;2;26;.929;3600000;0
39251;194854;417;54;40;5;35;.875;3600000;0
39251;178890;417;0;0;0;0;.00nan;0;0
39251;-1;412;100;33;0;33;1.000;3600000;0
39251;-1;412;0;0;0;0;.00nan;0;0
39252;171787;4849;100;31;0;31;1.000;3600000;0
39252;171877;423;0;0;0;0;.00nan;0;0
39252;188965;423;89;27;1;26;.963;3551000;0
39252;196412;4849;0;0;0;0;.00nan;0;0
39253;194456;414;0;0;0;0;.00nan;0;0
39253;190073;413;53;10;1;9;.900;3600000;0
39253;181346;414;56;40;5;35;.875;3600000;0
39253;192627;413;0;0;0;0;.00nan;0;0
39254;194650;410;0;0;0;0;.00nan;0;0
39254;184183;410;97;52;2;50;.962;4200000;0
39254;190073;413;0;0;0;0;.00nan;0;0
39254;192627;413;70;25;2;23;.920;4200000;0
39255;184336;429;46;24;3;21;.875;3600000;0
39255;-1;429;0;0;0;0;.00nan;0;0
39255;191171;431;0;0;0;0;.00nan;0;0
39255;-1;431;100;35;0;35;1.000;3600000;0
39256;178743;435;0;0;0;0;.00nan;0;0
39256;179657;441;55;30;4;26;.867;3600000;0
39256;191713;441;0;0;0;0;.00nan;0;0
39256;-1;435;100;31;0;31;1.000;3600000;0
39257;171877;423;0;0;0;0;.00nan;0;0
39257;188965;423;68;18;1;17;.944;3600000;0
39257;189288;419;0;0;0;0;.00nan;0;0
39257;196975;419;64;35;4;31;.886;3600000;0
39258;194598;418;0;0;0;0;.00nan;0;0
39258;189318;421;0;0;0;0;.00nan;0;0
39258;179169;421;43;25;4;21;.840;3600000;0
39258;191687;418;67;32;3;29;.906;3600000;0
39259;170499;427;98;19;0;19;1.000;3600000;0
39259;-1;439;0;0;0;0;.00nan;0;0
39259;202193;439;80;31;2;29;.935;3595000;0
39259;186468;427;0;0;0;0;.00nan;0;0
39260;184033;411;62;30;2;28;.933;3574000;0
39260;-1;412;95;31;1;30;.968;3600000;0
39260;-1;412;0;0;0;0;.00nan;0;0
39260;197699;411;0;0;0;0;.00nan;0;0
39261;184336;429;0;0;0;0;.00nan;0;0
39261;-1;429;75;26;2;24;.923;3596000;0
39261;-1;433;0;0;0;0;.00nan;0;0
39261;191212;433;92;31;1;30;.968;3600000;0
39262;194803;443;0;0;0;0;.00nan;0;0
39262;-1;434;0;0;0;0;.00nan;0;0
39262;182180;443;77;25;1;24;.960;3600000;0
39262;186671;434;80;28;2;26;.929;3568000;0
39263;182475;437;0;0;0;0;.00nan;0;0
39263;186571;437;55;33;4;29;.879;3543000;0
39263;-1;426;0;0;0;0;.00nan;0;0
39263;-1;426;53;18;2;16;.889;3600000;0
39264;171787;4849;72;30;3;27;.900;3600000;0
39264;200179;420;37;23;5;18;.783;3584000;0
39264;196412;4849;0;0;0;0;.00nan;0;0
39264;186076;420;0;0;0;0;.00nan;0;0
39265;200063;442;0;0;0;0;.00nan;0;0
39265;-1;428;81;31;3;28;.903;3593000;0
39265;190157;442;72;27;2;25;.926;3600000;0
39265;191702;428;0;0;0;0;.00nan;0;0
39266;194854;417;0;0;0;0;.00nan;0;0
39266;178890;417;75;31;3;28;.903;3600000;0
39266;179689;415;24;26;6;20;.769;3600000;0
39266;191877;415;0;0;0;0;.00nan;0;0
39267;194456;414;74;32;3;29;.906;3880000;0
39267;194650;410;81;34;2;32;.941;3880000;0
39267;184183;410;0;0;0;0;.00nan;0;0
39267;181346;414;0;0;0;0;.00nan;0;0
39268;194146;432;0;0;0;0;.00nan;0;0
39268;183832;436;56;22;3;19;.864;3600000;0
39268;197030;432;29;30;6;24;.800;3567000;0
39268;191861;436;0;0;0;0;.00nan;0;0
39269;165023;438;93;49;2;47;.959;3577000;0
39269;173339;430;0;0;0;0;.00nan;0;0
39269;176196;438;0;0;0;0;.00nan;0;0
39269;-1;430;96;23;0;23;1.000;3600000;0
39270;163177;425;0;0;0;0;.00nan;0;0
39270;189783;440;49;37;6;31;.838;3600000;0
39270;175723;440;0;0;0;0;.00nan;0;0
39270;-1;425;50;14;2;12;.857;3600000;0
39271;178743;435;0;0;0;0;.00nan;0;0
39271;-1;439;0;0;0;0;.00nan;0;0
39271;202193;439;47;23;4;19;.826;3600000;0
39271;-1;435;42;36;6;30;.833;3563000;0
39272;183832;436;0;0;0;0;.00nan;0;0
39272;191171;431;0;0;0;0;.00nan;0;0
39272;191861;436;94;35;1;34;.971;3691000;0
39272;-1;431;100;30;0;30;1.000;3691000;0
39273;171877;423;0;0;0;0;.00nan;0;0
39273;188965;423;84;34;2;32;.941;3600000;0
39273;189288;419;73;30;3;27;.900;3559000;0
39273;196975;419;0;0;0;0;.00nan;0;0
39274;194598;418;99;38;1;37;.974;3600000;0
39274;189318;421;68;27;3;24;.889;3525000;0
39274;179169;421;0;0;0;0;.00nan;0;0
39274;191687;418;0;0;0;0;.00nan;0;0
39275;170499;427;83;19;0;19;1.000;3600000;0
39275;179657;441;32;36;7;29;.806;3600000;0
39275;186468;427;0;0;0;0;.00nan;0;0
39275;191713;441;0;0;0;0;.00nan;0;0
39276;184033;411;0;0;0;0;.00nan;0;0
39276;179689;415;0;0;0;0;.00nan;0;0
39276;191877;415;69;32;2;30;.938;3600000;0
39276;197699;411;33;19;4;15;.789;3551000;0
39277;194146;432;49;30;4;26;.867;3552000;0
39277;-1;433;82;35;3;32;.914;3600000;0
39277;191212;433;0;0;0;0;.00nan;0;0
39277;197030;432;0;0;0;0;.00nan;0;0
39278;182475;437;75;30;2;28;.933;3573000;0
39278;194803;443;71;21;1;20;.952;3600000;0
39278;182180;443;0;0;0;0;.00nan;0;0
39278;186571;437;0;0;0;0;.00nan;0;0
39279;-1;434;70;30;2;28;.933;3600000;0
39279;186671;434;0;0;0;0;.00nan;0;0
39279;-1;426;39;27;5;22;.815;3600000;0
39279;-1;426;0;0;0;0;.00nan;0;0
39280;171787;4849;0;0;0;0;.00nan;0;0
39280;200179;420;0;0;0;0;.00nan;0;0
39280;196412;4849;59;42;5;37;.881;3611000;0
39280;186076;420;37;31;6;25;.806;3611000;0
39281;200063;442;71;30;2;28;.933;3556000;0
39281;-1;428;0;0;0;0;.00nan;0;0
39281;190157;442;0;0;0;0;.00nan;0;0
39281;191702;428;81;21;1;20;.952;3600000;0
39282;194854;417;100;26;0;26;1.000;3600000;0
39282;178890;417;0;0;0;0;.00nan;0;0
39282;-1;412;0;0;0;0;.00nan;0;0
39282;-1;412;75;32;4;28;.875;3600000;0
39283;194456;414;0;0;0;0;.00nan;0;0
39283;190073;413;74;25;1;24;.960;3600000;0
39283;181346;414;67;31;3;28;.903;3557000;0
39283;192627;413;0;0;0;0;.00nan;0;0
39284;163177;425;80;29;2;27;.931;3599000;0
39284;173339;430;0;0;0;0;.00nan;0;0
39284;-1;425;0;0;0;0;.00nan;0;0
39284;-1;430;99;28;0;28;1.000;3600000;0
39285;165023;438;0;0;0;0;.00nan;0;0
39285;189783;440;0;0;0;0;.00nan;0;0
39285;175723;440;90;44;2;42;.955;4200000;0
39285;176196;438;81;26;2;24;.923;4200000;0
39286;194456;414;73;40;4;36;.900;3635000;0
39286;184033;411;62;26;3;23;.885;3635000;0
39286;181346;414;0;0;0;0;.00nan;0;0
39286;197699;411;0;0;0;0;.00nan;0;0
39287;-1;433;0;0;0;0;.00nan;0;0
39287;191212;433;55;40;5;35;.875;3600000;0
39287;-1;426;0;0;0;0;.00nan;0;0
39287;-1;426;40;24;4;20;.833;3600000;0
39288;178743;435;0;0;0;0;.00nan;0;0
39288;-1;434;0;0;0;0;.00nan;0;0
39288;186671;434;73;25;1;24;.960;3600000;0
39288;-1;435;74;37;3;34;.919;3541000;0
39289;194146;432;19;24;6;18;.750;1687000;0
39289;184336;429;100;23;0;23;1.000;3600000;0
39289;-1;429;0;0;0;0;.00nan;0;0
39289;197030;432;68;20;1;19;.950;1913000;0
39290;182475;437;0;0;0;0;.00nan;0;0
39290;186571;437;93;38;2;36;.947;3600000;0
39290;191171;431;0;0;0;0;.00nan;0;0
39290;-1;431;57;24;3;21;.875;3546000;0
39291;171787;4849;84;38;3;35;.921;3600000;0
39291;194598;418;0;0;0;0;.00nan;0;0
39291;196412;4849;0;0;0;0;.00nan;0;0
39291;191687;418;48;33;5;28;.848;3545000;0
39292;190073;413;81;36;2;34;.944;3600000;0
39292;179689;415;48;37;5;32;.865;3600000;0
39292;191877;415;0;0;0;0;.00nan;0;0
39292;192627;413;0;0;0;0;.00nan;0;0
39293;200179;420;64;26;2;24;.923;3600000;0
39293;183885;449;38;26;5;21;.808;3600000;0
39293;-1;449;0;0;0;0;.00nan;0;0
39293;186076;420;0;0;0;0;.00nan;0;0
39294;189783;440;62;36;4;32;.889;3600000;0
39294;175723;440;0;0;0;0;.00nan;0;0
39294;-1;439;90;29;1;28;.966;3600000;0
39294;202193;439;0;0;0;0;.00nan;0;0
39295;179657;441;39;23;4;19;.826;3527000;0
39295;-1;433;0;0;0;0;.00nan;0;0
39295;191212;433;66;31;2;29;.935;3600000;0
39295;191713;441;0;0;0;0;.00nan;0;0
39296;173339;430;0;0;0;0;.00nan;0;0
39296;-1;428;74;32;2;30;.938;4200000;0
39296;191702;428;0;0;0;0;.00nan;0;0
39296;-1;430;67;24;2;22;.917;4200000;0
39297;171787;4849;33;8;3;5;.625;408000;0
39297;194598;418;58;22;2;20;.909;3600000;0
39297;196412;4849;59;34;4;30;.882;3192000;0
39297;191687;418;0;0;0;0;.00nan;0;0
39298;171877;423;0;0;0;0;.00nan;0;0
39298;188965;423;58;32;4;28;.875;3736000;0
39298;189318;421;0;0;0;0;.00nan;0;0
39298;179169;421;55;25;3;22;.880;3736000;0
39299;163177;425;0;0;0;0;.00nan;0;0
39299;165023;438;83;35;2;33;.943;3600000;0
39299;176196;438;0;0;0;0;.00nan;0;0
39299;-1;425;45;27;4;23;.852;3547000;0
39300;183832;436;83;26;2;24;.923;3600000;0
39300;194803;443;0;0;0;0;.00nan;0;0
39300;182180;443;72;32;3;29;.906;3594000;0
39300;191861;436;0;0;0;0;.00nan;0;0
39301;168414;444;0;0;0;0;.00nan;0;0
39301;179127;422;78;27;1;26;.963;3566000;0
39301;180578;422;0;0;0;0;.00nan;0;0
39301;191812;444;100;32;0;32;1.000;3600000;0
39302;170499;427;71;27;2;25;.926;3544000;0
39302;186468;427;0;0;0;0;.00nan;0;0
39302;-1;426;77;28;1;27;.964;3600000;0
39302;-1;426;0;0;0;0;.00nan;0;0
39303;194650;410;0;0;0;0;.00nan;0;0
39303;184183;410;78;29;2;27;.931;3551000;0
39303;-1;412;87;29;1;28;.966;3600000;0
39303;-1;412;0;0;0;0;.00nan;0;0
39304;200063;442;0;0;0;0;.00nan;0;0
39304;190157;442;60;20;2;18;.900;3565000;0
39304;191171;431;89;31;1;30;.968;3600000;0
39304;-1;431;0;0;0;0;.00nan;0;0
39305;184033;411;0;0;0;0;.00nan;0;0
39305;194854;417;57;54;7;47;.870;3346000;0
39305;178890;417;53;3;0;3;1.000;254000;0
39305;197699;411;42;25;4;21;.840;3600000;0
39306;194650;410;67;31;3;28;.903;3884000;0
39306;184183;410;0;0;0;0;.00nan;0;0
39306;179689;415;0;0;0;0;.00nan;0;0
39306;191877;415;73;27;2;25;.926;3884000;0
39307;200179;420;0;0;0;0;.00nan;0;0
39307;183885;449;0;0;0;0;.00nan;0;0
39307;-1;449;46;25;4;21;.840;3600000;0
39307;186076;420;92;35;1;34;.971;3600000;0
39308;-1;439;0;0;0;0;.00nan;0;0
39308;202193;439;76;12;0;12;1.000;3600000;0
39308;-1;433;59;48;6;42;.875;3155000;0
39308;191212;433;52;11;1;10;.909;445000;0
39309;163177;425;69;33;3;30;.909;3600000;0
39309;165023;438;0;0;0;0;.00nan;0;0
39309;176196;438;66;23;2;21;.913;3600000;0
39309;-1;425;0;0;0;0;.00nan;0;0
39310;189783;440;0;0;0;0;.00nan;0;0
39310;175723;440;71;31;3;28;.903;3698000;0
39310;179657;441;0;0;0;0;.00nan;0;0
39310;191713;441;84;40;2;38;.950;3698000;0
39311;173339;430;59;18;2;16;.889;3600000;0
39311;-1;428;0;0;0;0;.00nan;0;0
39311;191702;428;66;31;3;28;.903;3560000;0
39311;-1;430;0;0;0;0;.00nan;0;0
39312;171877;423;87;38;3;35;.921;3600000;0
39312;188965;423;0;0;0;0;.00nan;0;0
39312;189318;421;77;23;2;21;.913;3600000;0
39312;179169;421;0;0;0;0;.00nan;0;0
39313;194803;443;92;20;0;20;1.000;3600000;0
39313;170499;427;88;32;1;31;.969;3588000;0
39313;182180;443;0;0;0;0;.00nan;0;0
39313;186468;427;0;0;0;0;.00nan;0;0
39314;168414;444;0;0;0;0;.00nan;0;0
39314;179127;422;0;0;0;0;.00nan;0;0
39314;180578;422;84;27;1;26;.963;3600000;0
39314;191812;444;66;30;3;27;.900;3568000;0
39315;183832;436;0;0;0;0;.00nan;0;0
39315;-1;426;0;0;0;0;.00nan;0;0
39315;-1;426;79;50;4;46;.920;4200000;0
39315;191861;436;67;38;4;34;.895;4200000;0
39316;190073;413;0;0;0;0;.00nan;0;0
39316;-1;412;54;4;0;4;1.000;658000;0
39316;192627;413;50;15;2;13;.867;3600000;0
39316;-1;412;39;32;6;26;.813;2942000;0
39317;182475;437;74;50;6;44;.880;3600000;0
39317;184336;429;89;18;0;18;1.000;3600000;0
39317;-1;429;0;0;0;0;.00nan;0;0
39317;186571;437;0;0;0;0;.00nan;0;0
39318;194456;414;56;40;5;35;.875;3600000;0
39318;194854;417;0;0;0;0;.00nan;0;0
39318;178890;417;73;24;2;22;.917;3600000;0
39318;181346;414;0;0;0;0;.00nan;0;0
39319;194146;432;0;0;0;0;.00nan;0;0
39319;200063;442;0;0;0;0;.00nan;0;0
39319;190157;442;65;25;3;22;.880;3564000;0
39319;197030;432;73;31;2;29;.935;3600000;0
39320;178743;435;0;0;0;0;.00nan;0;0
39320;-1;434;0;0;0;0;.00nan;0;0
39320;186671;434;78;35;2;33;.943;4200000;0
39320;-1;435;70;27;2;25;.926;4200000;0
39321;194456;414;68;26;3;23;.885;3600000;0
39321;181346;414;0;0;0;0;.00nan;0;0
39321;-1;412;55;28;5;23;.821;3555000;0
39321;-1;412;0;0;0;0;.00nan;0;0
39322;170499;427;70;47;5;42;.894;3523000;0
39322;-1;434;59;31;3;28;.903;3600000;0
39322;186468;427;0;0;0;0;.00nan;0;0
39322;186671;434;0;0;0;0;.00nan;0;0
39323;179657;441;54;34;4;30;.882;3580000;0
39323;191171;431;95;40;2;38;.950;3600000;0
39323;191713;441;0;0;0;0;.00nan;0;0
39323;-1;431;0;0;0;0;.00nan;0;0
39324;183832;436;92;21;0;21;1.000;3600000;0
39324;-1;428;56;26;3;23;.885;3600000;0
39324;191702;428;0;0;0;0;.00nan;0;0
39324;191861;436;0;0;0;0;.00nan;0;0
39325;200063;442;0;0;0;0;.00nan;0;0
39325;184336;429;28;20;5;15;.750;3600000;0
39325;190157;442;49;27;4;23;.852;3600000;0
39325;-1;429;0;0;0;0;.00nan;0;0
39326;194456;414;0;0;0;0;.00nan;0;0
39326;179689;415;0;0;0;0;.00nan;0;0
39326;181346;414;58;39;5;34;.872;3600000;0
39326;191877;415;100;35;0;35;1.000;3600000;0
39327;165023;438;92;26;0;26;1.000;3600000;0
39327;176196;438;0;0;0;0;.00nan;0;0
39327;-1;426;0;0;0;0;.00nan;0;0
39327;-1;426;82;36;2;34;.944;3527000;0
39328;194650;410;0;0;0;0;.00nan;0;0
39328;194854;417;0;0;0;0;.00nan;0;0
39328;184183;410;55;24;3;21;.875;3546000;0
39328;178890;417;82;36;2;34;.944;3600000;0
39329;182475;437;0;0;0;0;.00nan;0;0
39329;179657;441;50;1;0;1;1.000;274000;0
39329;186571;437;59;16;2;14;.875;3600000;0
39329;191713;441;70;39;4;35;.897;3323000;0
39330;183885;449;48;41;6;35;.854;3340000;0
39330;189318;421;0;0;0;0;.00nan;0;0
39330;179169;421;49;28;4;24;.857;3600000;0
39330;-1;449;52;3;0;3;1.000;232000;0
39331;183832;436;78;33;2;31;.939;3557000;0
39331;-1;428;0;0;0;0;.00nan;0;0
39331;191702;428;87;29;1;28;.966;3600000;0
39331;191861;436;0;0;0;0;.00nan;0;0
39332;163177;425;0;0;0;0;.00nan;0;0
39332;194803;443;0;0;0;0;.00nan;0;0
39332;-1;425;86;34;3;31;.912;3952000;0
39332;182180;443;96;58;2;56;.966;3952000;0
39333;194598;418;0;0;0;0;.00nan;0;0
39333;179127;422;81;23;1;22;.957;3600000;0
39333;180578;422;0;0;0;0;.00nan;0;0
39333;191687;418;65;31;3;28;.903;3588000;0
39334;168414;444;0;0;0;0;.00nan;0;0
39334;200179;420;55;34;3;31;.912;3600000;0
39334;186076;420;0;0;0;0;.00nan;0;0
39334;191812;444;41;23;4;19;.826;3569000;0
39335;184033;411;0;0;0;0;.00nan;0;0
39335;190073;413;76;31;2;29;.935;3600000;0
39335;192627;413;0;0;0;0;.00nan;0;0
39335;197699;411;56;42;5;37;.881;3600000;0
39336;171787;4849;74;32;2;30;.938;4200000;0
39336;189288;419;0;0;0;0;.00nan;0;0
39336;196412;4849;0;0;0;0;.00nan;0;0
39336;196975;419;100;43;2;41;.953;4200000;0
39337;194146;432;0;0;0;0;.00nan;0;0
39337;-1;439;0;0;0;0;.00nan;0;0
39337;202193;439;71;20;1;19;.950;3600000;0
39337;197030;432;43;33;5;28;.848;3600000;0
39338;173339;430;0;0;0;0;.00nan;0;0
39338;178743;435;0;0;0;0;.00nan;0;0
39338;-1;430;55;29;3;26;.897;3600000;0
39338;-1;435;62;31;4;27;.871;3574000;0
39339;189783;440;93;45;2;43;.956;4200000;0
39339;175723;440;0;0;0;0;.00nan;0;0
39339;-1;433;0;0;0;0;.00nan;0;0
39339;191212;433;76;34;2;32;.941;4200000;0
39340;183885;449;0;0;0;0;.00nan;0;0
39340;189318;421;77;30;2;28;.933;4200000;0
39340;179169;421;0;0;0;0;.00nan;0;0
39340;-1;449;90;40;2;38;.950;4200000;0
39341;165023;438;76;21;1;20;.952;3790000;0
39341;194803;443;80;34;2;32;.941;3790000;0
39341;176196;438;0;0;0;0;.00nan;0;0
39341;182180;443;0;0;0;0;.00nan;0;0
39342;194650;410;42;33;5;28;.848;3568000;0
39342;184033;411;48;18;3;15;.833;3600000;0
39342;184183;410;0;0;0;0;.00nan;0;0
39342;197699;411;0;0;0;0;.00nan;0;0
39343;170499;427;64;34;3;31;.912;3600000;0
39343;184336;429;27;31;7;24;.774;3600000;0
39343;-1;429;0;0;0;0;.00nan;0;0
39343;186468;427;0;0;0;0;.00nan;0;0
39344;163177;425;52;22;3;19;.864;3897000;0
39344;-1;425;0;0;0;0;.00nan;0;0
39344;-1;426;88;42;2;40;.952;3897000;0
39344;-1;426;0;0;0;0;.00nan;0;0
39345;194598;418;73;35;4;31;.886;3600000;0
39345;179127;422;0;0;0;0;.00nan;0;0
39345;180578;422;86;27;1;26;.963;3600000;0
39345;191687;418;0;0;0;0;.00nan;0;0
39346;179689;415;73;33;2;31;.939;3600000;0
39346;-1;412;49;25;4;21;.840;3551000;0
39346;191877;415;0;0;0;0;.00nan;0;0
39346;-1;412;0;0;0;0;.00nan;0;0
39347;168414;444;43;21;4;17;.810;3600000;0
39347;200179;420;0;0;0;0;.00nan;0;0
39347;186076;420;76;27;1;26;.963;3600000;0
39347;191812;444;0;0;0;0;.00nan;0;0
39348;194854;417;86;35;2;33;.943;3600000;0
39348;178890;417;0;0;0;0;.00nan;0;0
39348;190073;413;0;0;0;0;.00nan;0;0
39348;192627;413;53;26;3;23;.885;3567000;0
39349;182475;437;53;23;3;20;.870;3600000;0
39349;194146;432;37;35;6;29;.829;3600000;0
39349;186571;437;0;0;0;0;.00nan;0;0
39349;197030;432;0;0;0;0;.00nan;0;0
39350;171787;4849;0;0;0;0;.00nan;0;0
39350;189288;419;0;0;0;0;.00nan;0;0
39350;196412;4849;100;29;0;29;1.000;3600000;0
39350;196975;419;73;23;2;21;.913;3514000;0
39351;200063;442;0;0;0;0;.00nan;0;0
39351;190157;442;72;31;3;28;.903;3600000;0
39351;-1;434;0;0;0;0;.00nan;0;0
39351;186671;434;78;29;2;27;.931;3600000;0
39352;173339;430;79;21;1;20;.952;3600000;0
39352;-1;433;79;49;4;45;.918;3600000;0
39352;191212;433;0;0;0;0;.00nan;0;0
39352;-1;430;0;0;0;0;.00nan;0;0
39353;178743;435;73;35;3;32;.914;3514000;0
39353;189783;440;0;0;0;0;.00nan;0;0
39353;175723;440;81;25;1;24;.960;3600000;0
39353;-1;435;0;0;0;0;.00nan;0;0
39354;-1;439;0;0;0;0;.00nan;0;0
39354;202193;439;57;33;4;29;.879;3533000;0
39354;191171;431;63;31;3;28;.903;3600000;0
39354;-1;431;0;0;0;0;.00nan;0;0
39355;194650;410;0;0;0;0;.00nan;0;0
39355;184183;410;70;54;5;49;.907;4123000;0
39355;190073;413;43;24;4;20;.833;4123000;0
39355;192627;413;0;0;0;0;.00nan;0;0
39356;194803;443;54;7;0;7;1.000;361000;0
39356;182180;443;31;32;6;26;.813;3217000;0
39356;-1;426;0;0;0;0;.00nan;0;0
39356;-1;426;59;37;5;32;.865;3600000;0
39357;184336;429;18;9;4;5;.556;1180000;0
39357;-1;429;74;21;1;20;.952;2420000;0
39357;-1;433;100;36;0;36;1.000;3600000;0
39357;191212;433;0;0;0;0;.00nan;0;0
39358;200063;442;0;0;0;0;.00nan;0;0
39358;190157;442;54;29;4;25;.862;4121000;0
39358;179657;441;73;35;3;32;.914;4121000;0
39358;191713;441;0;0;0;0;.00nan;0;0
39359;182475;437;66;30;2;28;.933;3555000;0
39359;163177;425;0;0;0;0;.00nan;0;0
39359;-1;425;65;20;1;19;.950;3600000;0
39359;186571;437;0;0;0;0;.00nan;0;0
39360;183885;449;63;15;1;14;.933;3600000;0
39360;179127;422;73;41;3;38;.927;3593000;0
39360;-1;449;0;0;0;0;.00nan;0;0
39360;180578;422;0;0;0;0;.00nan;0;0
39361;179657;441;0;0;0;0;.00nan;0;0
39361;-1;439;0;0;0;0;.00nan;0;0
39361;202193;439;41;20;4;16;.800;3552000;0
39361;191713;441;81;46;3;43;.935;3600000;0
39362;168414;444;0;0;0;0;.00nan;0;0
39362;194598;418;0;0;0;0;.00nan;0;0
39362;191687;418;60;38;5;33;.868;4156000;0
39362;191812;444;74;45;4;41;.911;4156000;0
39363;170499;427;22;22;5;17;.773;3600000;0
39363;186468;427;0;0;0;0;.00nan;0;0
39363;191171;431;51;17;2;15;.882;2663000;0
39363;-1;431;17;14;5;9;.643;937000;0
39364;189288;419;0;0;0;0;.00nan;0;0
39364;189318;421;65;22;1;21;.955;4029000;0
39364;179169;421;0;0;0;0;.00nan;0;0
39364;196975;419;93;48;2;46;.958;4029000;0
39365;184033;411;46;21;4;17;.810;3870000;0
39365;-1;412;63;31;3;28;.903;3870000;0
39365;-1;412;0;0;0;0;.00nan;0;0
39365;197699;411;0;0;0;0;.00nan;0;0
39366;163177;425;61;26;3;23;.885;3600000;0
39366;183832;436;60;50;6;44;.880;3600000;0
39366;-1;425;0;0;0;0;.00nan;0;0
39366;191861;436;0;0;0;0;.00nan;0;0
39367;194803;443;0;0;0;0;.00nan;0;0
39367;182180;443;100;20;0;20;1.000;3600000;0
39367;-1;426;76;20;1;19;.950;3600000;0
39367;-1;426;0;0;0;0;.00nan;0;0
39368;194456;414;86;36;2;34;.944;3691000;0
39368;190073;413;0;0;0;0;.00nan;0;0
39368;181346;414;0;0;0;0;.00nan;0;0
39368;192627;413;65;29;3;26;.897;3691000;0
39369;182475;437;0;0;0;0;.00nan;0;0
39369;165023;438;60;15;1;14;.933;3600000;0
39369;176196;438;0;0;0;0;.00nan;0;0
39369;186571;437;80;31;2;29;.935;3568000;0
39370;171877;423;0;0;0;0;.00nan;0;0
39370;188965;423;60;34;3;31;.912;4200000;0
39370;200179;420;49;32;3;29;.906;4200000;0
39370;186076;420;0;0;0;0;.00nan;0;0
39371;194854;417;0;0;0;0;.00nan;0;0
39371;178890;417;73;24;2;22;.917;3600000;0
39371;179689;415;0;0;0;0;.00nan;0;0
39371;191877;415;72;33;3;30;.909;3600000;0
39372;194146;432;0;0;0;0;.00nan;0;0
39372;-1;434;0;0;0;0;.00nan;0;0
39372;186671;434;55;25;3;22;.880;3544000;0
39372;197030;432;85;37;2;35;.946;3600000;0
39373;173339;430;0;0;0;0;.00nan;0;0
39373;189783;440;80;38;3;35;.921;3523000;0
39373;175723;440;0;0;0;0;.00nan;0;0
39373;-1;430;64;13;1;12;.923;3600000;0
39374;-1;428;38;34;6;28;.824;3600000;0
39374;184336;429;0;0;0;0;.00nan;0;0
39374;-1;429;64;21;2;19;.905;3600000;0
39374;191702;428;0;0;0;0;.00nan;0;0
39375;183885;449;0;0;0;0;.00nan;0;0
39375;179127;422;0;0;0;0;.00nan;0;0
39375;-1;449;49;25;4;21;.840;3600000;0
39375;180578;422;46;28;5;23;.821;3555000;0
39376;168414;444;100;24;0;24;1.000;3600000;0
39376;194598;418;41;25;4;21;.840;3600000;0
39376;191687;418;0;0;0;0;.00nan;0;0
39376;191812;444;0;0;0;0;.00nan;0;0
39377;-1;428;0;0;0;0;.00nan;0;0
39377;178743;435;0;0;0;0;.00nan;0;0
39377;191702;428;44;36;6;30;.833;3600000;0
39377;-1;435;86;36;2;34;.944;3600000;0
39378;194456;414;0;0;0;0;.00nan;0;0
39378;194650;410;60;43;5;38;.884;3550000;0
39378;184183;410;0;0;0;0;.00nan;0;0
39378;181346;414;77;40;3;37;.925;3600000;0
39379;-1;434;83;28;1;27;.964;3600000;0
39379;186671;434;0;0;0;0;.00nan;0;0
39379;191171;431;0;0;0;0;.00nan;0;0
39379;-1;431;60;30;3;27;.900;3600000;0
39380;184033;411;0;0;0;0;.00nan;0;0
39380;179689;415;67;29;3;26;.897;3530000;0
39380;191877;415;0;0;0;0;.00nan;0;0
39380;197699;411;80;23;1;22;.957;3600000;0
39381;189288;419;56;18;2;16;.889;1437000;0
39381;189318;421;0;0;0;0;.00nan;0;0
39381;179169;421;49;22;3;19;.864;3600000;0
39381;196975;419;25;19;5;14;.737;2163000;0
39382;165023;438;0;0;0;0;.00nan;0;0
39382;183832;436;0;0;0;0;.00nan;0;0
39382;176196;438;55;41;5;36;.878;3600000;0
39382;191861;436;90;37;2;35;.946;3600000;0
39383;200063;442;99;37;2;35;.946;4200000;0
39383;190157;442;0;0;0;0;.00nan;0;0
39383;-1;439;61;25;2;23;.920;4200000;0
39383;202193;439;0;0;0;0;.00nan;0;0
39384;171877;423;67;27;2;25;.926;3526000;0
39384;188965;423;0;0;0;0;.00nan;0;0
39384;200179;420;0;0;0;0;.00nan;0;0
39384;186076;420;85;20;0;20;1.000;3600000;0
39385;194854;417;36;25;4;21;.840;3549000;0
39385;178890;417;0;0;0;0;.00nan;0;0
39385;-1;412;0;0;0;0;.00nan;0;0
39385;-1;412;72;41;3;38;.927;3600000;0
39386;194146;432;96;29;1;28;.966;3600000;0
39386;170499;427;0;0;0;0;.00nan;0;0
39386;186468;427;78;33;3;30;.909;3549000;0
39386;197030;432;0;0;0;0;.00nan;0;0
39387;173339;430;68;21;1;20;.952;3600000;0
39387;189783;440;0;0;0;0;.00nan;0;0
39387;175723;440;53;38;5;33;.868;3600000;0
39387;-1;430;0;0;0;0;.00nan;0;0
39388;-1;433;0;0;0;0;.00nan;0;0
39388;191212;433;40;38;6;32;.842;3600000;0
39388;-1;426;76;22;1;21;.955;3600000;0
39388;-1;426;0;0;0;0;.00nan;0;0
39389;194456;414;0;0;0;0;.00nan;0;0
39389;184033;411;0;0;0;0;.00nan;0;0
39389;181346;414;96;48;2;46;.958;4200000;0
39389;197699;411;71;27;2;25;.926;4200000;0
39390;194650;410;0;0;0;0;.00nan;0;0
39390;184183;410;65;23;2;21;.913;3548000;0
39390;179689;415;0;0;0;0;.00nan;0;0
39390;191877;415;99;47;1;46;.979;3600000;0
39391;182475;437;100;36;0;36;1.000;3600000;0
39391;200063;442;0;0;0;0;.00nan;0;0
39391;190157;442;56;28;3;25;.893;3600000;0
39391;186571;437;0;0;0;0;.00nan;0;0
39392;178743;435;59;10;1;9;.900;1513000;0
39392;170499;427;53;19;2;17;.895;3600000;0
39392;186468;427;0;0;0;0;.00nan;0;0
39392;-1;435;21;20;6;14;.700;2087000;0
39393;182475;437;0;0;0;0;.00nan;0;0
39393;-1;439;0;0;0;0;.00nan;0;0
39393;202193;439;43;29;5;24;.828;3600000;0
39393;186571;437;69;26;2;24;.923;3600000;0
39394;171877;423;0;0;0;0;.00nan;0;0
39394;188965;423;49;42;5;37;.881;3600000;0
39394;168414;444;77;21;1;20;.952;3600000;0
39394;191812;444;0;0;0;0;.00nan;0;0
39395;194650;410;96;21;0;21;1.000;3600000;0
39395;184183;410;0;0;0;0;.00nan;0;0
39395;-1;412;70;38;3;35;.921;3600000;0
39395;-1;412;0;0;0;0;.00nan;0;0
39396;-1;428;0;0;0;0;.00nan;0;0
39396;-1;434;0;0;0;0;.00nan;0;0
39396;186671;434;70;26;2;24;.923;3600000;0
39396;191702;428;65;30;3;27;.900;3564000;0
39397;183832;436;75;29;2;27;.931;3600000;0
39397;191171;431;64;33;3;30;.909;3600000;0
39397;191861;436;0;0;0;0;.00nan;0;0
39397;-1;431;0;0;0;0;.00nan;0;0
39398;183885;449;90;33;1;32;.970;3836000;0
39398;194598;418;94;38;2;36;.947;3836000;0
39398;-1;449;0;0;0;0;.00nan;0;0
39398;191687;418;0;0;0;0;.00nan;0;0
39399;171787;4849;96;40;2;38;.950;3600000;0
39399;189318;421;0;0;0;0;.00nan;0;0
39399;179169;421;50;17;3;14;.824;3574000;0
39399;196412;4849;0;0;0;0;.00nan;0;0
39400;165023;438;66;30;4;26;.867;3600000;0
39400;176196;438;0;0;0;0;.00nan;0;0
39400;-1;433;52;48;6;42;.875;3517000;0
39400;191212;433;0;0;0;0;.00nan;0;0
39401;194803;443;0;0;0;0;.00nan;0;0
39401;189783;440;64;40;4;36;.900;3554000;0
39401;175723;440;0;0;0;0;.00nan;0;0
39401;182180;443;67;25;2;23;.920;3600000;0
39402;189288;419;0;0;0;0;.00nan;0;0
39402;179127;422;55;25;3;22;.880;3600000;0
39402;180578;422;0;0;0;0;.00nan;0;0
39402;196975;419;58;40;5;35;.875;3518000;0
39403;173339;430;0;0;0;0;.00nan;0;0
39403;-1;426;0;0;0;0;.00nan;0;0
39403;-1;426;58;40;5;35;.875;3598000;0
39403;-1;430;53;22;3;19;.864;3600000;0
39404;190073;413;58;30;4;26;.867;3561000;0
39404;179689;415;63;32;3;29;.906;3600000;0
39404;191877;415;0;0;0;0;.00nan;0;0
39404;192627;413;0;0;0;0;.00nan;0;0
39405;194456;414;68;31;3;28;.903;3600000;0
39405;194854;417;0;0;0;0;.00nan;0;0
39405;178890;417;60;33;4;29;.879;3562000;0
39405;181346;414;0;0;0;0;.00nan;0;0
39406;194146;432;0;0;0;0;.00nan;0;0
39406;179657;441;69;30;3;27;.900;3553000;0
39406;197030;432;66;26;2;24;.923;3600000;0
39406;191713;441;0;0;0;0;.00nan;0;0
39407;163177;425;0;0;0;0;.00nan;0;0
39407;184336;429;75;32;2;30;.938;3600000;0
39407;-1;425;56;41;5;36;.878;3600000;0
39407;-1;429;0;0;0;0;.00nan;0;0
39408;171877;423;44;26;4;22;.846;3600000;0
39408;188965;423;0;0;0;0;.00nan;0;0
39408;168414;444;100;31;0;31;1.000;3600000;0
39408;191812;444;0;0;0;0;.00nan;0;0
39409;-1;428;85;40;2;38;.950;3600000;0
39409;170499;427;61;31;4;27;.871;3556000;0
39409;186468;427;0;0;0;0;.00nan;0;0
39409;191702;428;0;0;0;0;.00nan;0;0
39410;-1;439;70;18;1;17;.944;3600000;0
39410;202193;439;0;0;0;0;.00nan;0;0
39410;191171;431;0;0;0;0;.00nan;0;0
39410;-1;431;76;32;2;30;.938;3570000;0
39411;183885;449;0;0;0;0;.00nan;0;0
39411;194598;418;0;0;0;0;.00nan;0;0
39411;-1;449;65;29;3;26;.897;3644000;0
39411;191687;418;68;25;2;23;.920;3644000;0
39412;184033;411;62;24;2;22;.917;3600000;0
39412;194854;417;59;30;3;27;.900;3600000;0
39412;178890;417;0;0;0;0;.00nan;0;0
39412;197699;411;0;0;0;0;.00nan;0;0
39413;171787;4849;55;38;5;33;.868;3600000;0
39413;189318;421;72;22;1;21;.955;3600000;0
39413;179169;421;0;0;0;0;.00nan;0;0
39413;196412;4849;0;0;0;0;.00nan;0;0
39414;178743;435;0;0;0;0;.00nan;0;0
39414;-1;433;0;0;0;0;.00nan;0;0
39414;191212;433;80;20;1;19;.950;3732000;0
39414;-1;435;71;27;2;25;.926;3732000;0
39415;173339;430;86;38;3;35;.921;3600000;0
39415;194803;443;19;17;5;12;.706;1970000;0
39415;182180;443;32;18;4;14;.778;1630000;0
39415;-1;430;0;0;0;0;.00nan;0;0
39416;189288;419;99;45;2;43;.956;4200000;0
39416;179127;422;0;0;0;0;.00nan;0;0
39416;180578;422;54;23;2;21;.913;4200000;0
39416;196975;419;0;0;0;0;.00nan;0;0
39417;189783;440;0;0;0;0;.00nan;0;0
39417;175723;440;96;31;1;30;.968;3600000;0
39417;-1;426;60;32;3;29;.906;3559000;0
39417;-1;426;0;0;0;0;.00nan;0;0
39418;190073;413;0;0;0;0;.00nan;0;0
39418;-1;412;0;0;0;0;.00nan;0;0
39418;192627;413;61;22;2;20;.909;3600000;0
39418;-1;412;81;30;1;29;.967;3600000;0
39419;200063;442;0;0;0;0;.00nan;0;0
39419;190157;442;55;17;2;15;.882;3600000;0
39419;179657;441;69;19;2;17;.895;3250000;0
39419;191713;441;23;6;3;3;.500;350000;0
39420;194146;432;100;45;2;43;.956;3600000;0
39420;183832;436;0;0;0;0;.00nan;0;0
39420;197030;432;0;0;0;0;.00nan;0;0
39420;191861;436;64;26;3;23;.885;3582000;0
39421;165023;438;0;0;0;0;.00nan;0;0
39421;184336;429;0;0;0;0;.00nan;0;0
39421;176196;438;77;27;1;26;.963;3917000;0
39421;-1;429;78;33;2;31;.939;3917000;0
39422;183832;436;66;23;2;21;.913;3600000;0
39422;179657;441;50;21;3;18;.857;3600000;0
39422;191713;441;0;0;0;0;.00nan;0;0
39422;191861;436;0;0;0;0;.00nan;0;0
39423;194456;414;67;34;3;31;.912;3565000;0
39423;181346;414;0;0;0;0;.00nan;0;0
39423;-1;412;69;19;1;18;.947;3600000;0
39423;-1;412;0;0;0;0;.00nan;0;0
39424;184033;411;75;20;1;19;.950;3553000;0
39424;190073;413;100;41;0;41;1.000;3600000;0
39424;192627;413;0;0;0;0;.00nan;0;0
39424;197699;411;0;0;0;0;.00nan;0;0
39425;-1;433;78;38;4;34;.895;3865000;0
39425;191171;431;67;35;3;32;.914;3865000;0
39425;191212;433;0;0;0;0;.00nan;0;0
39425;-1;431;0;0;0;0;.00nan;0;0
39426;179689;415;75;18;0;18;1.000;3231000;0
39426;-1;412;0;0;0;0;.00nan;0;0
39426;191877;415;32;16;4;12;.750;969000;0
39426;-1;412;40;28;4;24;.857;4200000;0
39427;183885;449;81;24;1;23;.958;4200000;0
39427;189288;419;0;0;0;0;.00nan;0;0
39427;-1;449;0;0;0;0;.00nan;0;0
39427;196975;419;91;41;1;40;.976;4200000;0
39428;165023;438;79;10;0;10;1.000;3600000;0
39428;176196;438;0;0;0;0;.00nan;0;0
39428;179657;441;87;45;3;42;.933;3600000;0
39428;191713;441;0;0;0;0;.00nan;0;0
39429;178743;435;28;29;6;23;.793;3593000;0
39429;191171;431;0;0;0;0;.00nan;0;0
39429;-1;435;0;0;0;0;.00nan;0;0
39429;-1;431;66;40;4;36;.900;3600000;0
39430;194650;410;41;43;7;36;.837;3271000;0
39430;184033;411;0;0;0;0;.00nan;0;0
39430;184183;410;47;6;1;5;.833;329000;0
39430;197699;411;43;17;3;14;.824;3600000;0
39431;194803;443;0;0;0;0;.00nan;0;0
39431;170499;427;95;41;2;39;.951;3936000;0
39431;182180;443;74;35;3;32;.914;3936000;0
39431;186468;427;0;0;0;0;.00nan;0;0
39432;163177;425;0;0;0;0;.00nan;0;0
39432;-1;425;53;27;4;23;.852;3553000;0
39432;-1;439;0;0;0;0;.00nan;0;0
39432;202193;439;73;36;3;33;.917;3600000;0
39433;200179;420;0;0;0;0;.00nan;0;0
39433;189318;421;0;0;0;0;.00nan;0;0
39433;179169;421;79;25;1;24;.960;3600000;0
39433;186076;420;56;32;4;28;.875;3600000;0
39434;194854;417;79;41;3;38;.927;3526000;0
39434;178890;417;0;0;0;0;.00nan;0;0
39434;190073;413;86;28;1;27;.964;3600000;0
39434;192627;413;0;0;0;0;.00nan;0;0
39435;194146;432;0;0;0;0;.00nan;0;0
39435;200063;442;60;7;0;7;1.000;621000;0
39435;190157;442;34;29;6;23;.793;2979000;0
39435;197030;432;55;25;3;22;.880;3600000;0
39436;182475;437;92;37;2;35;.946;3600000;0
39436;-1;428;0;0;0;0;.00nan;0;0
39436;186571;437;0;0;0;0;.00nan;0;0
39436;191702;428;76;25;1;24;.960;3600000;0
39437;171787;4849;0;0;0;0;.00nan;0;0
39437;168414;444;99;38;1;37;.974;3600000;0
39437;196412;4849;63;25;2;23;.920;3545000;0
39437;191812;444;0;0;0;0;.00nan;0;0
39438;171877;423;0;0;0;0;.00nan;0;0
39438;188965;423;79;33;2;31;.939;3544000;0
39438;179127;422;99;29;1;28;.966;3600000;0
39438;180578;422;0;0;0;0;.00nan;0;0
39439;-1;434;0;0;0;0;.00nan;0;0
39439;186671;434;71;27;2;25;.926;3600000;0
39439;-1;426;0;0;0;0;.00nan;0;0
39439;-1;426;40;35;6;29;.829;3600000;0
39440;173339;430;0;0;0;0;.00nan;0;0
39440;189783;440;26;6;3;3;.500;487000;0
39440;175723;440;92;36;1;35;.972;3113000;0
39440;-1;430;82;27;1;26;.963;3600000;0
39441;165023;438;40;28;5;23;.821;3600000;0
39441;176196;438;0;0;0;0;.00nan;0;0
39441;-1;439;52;30;4;26;.867;3600000;0
39441;202193;439;0;0;0;0;.00nan;0;0
39442;194146;432;98;51;2;49;.961;3584000;0
39442;178743;435;0;0;0;0;.00nan;0;0
39442;197030;432;0;0;0;0;.00nan;0;0
39442;-1;435;85;21;1;20;.952;3600000;0
39443;194650;410;0;0;0;0;.00nan;0;0
39443;194854;417;0;0;0;0;.00nan;0;0
39443;184183;410;99;38;1;37;.974;3600000;0
39443;178890;417;39;16;3;13;.813;3528000;0
39444;183885;449;70;23;2;21;.913;3512000;0
39444;189288;419;100;26;0;26;1.000;3600000;0
39444;-1;449;0;0;0;0;.00nan;0;0
39444;196975;419;0;0;0;0;.00nan;0;0
39445;170499;427;74;28;2;26;.929;3676000;0
39445;186468;427;0;0;0;0;.00nan;0;0
39445;-1;426;93;31;1;30;.968;3676000;0
39445;-1;426;0;0;0;0;.00nan;0;0
39446;183832;436;54;16;2;14;.875;3600000;0
39446;-1;433;57;9;1;8;.889;638000;0
39446;191212;433;34;34;6;28;.824;2962000;0
39446;191861;436;0;0;0;0;.00nan;0;0
39447;163177;425;0;0;0;0;.00nan;0;0
39447;179657;441;0;0;0;0;.00nan;0;0
39447;-1;425;68;26;2;24;.923;4200000;0
39447;191713;441;81;38;2;36;.947;4200000;0
39448;200179;420;72;40;4;36;.900;3895000;0
39448;189318;421;40;30;5;25;.833;3895000;0
39448;179169;421;0;0;0;0;.00nan;0;0
39448;186076;420;0;0;0;0;.00nan;0;0
39449;182475;437;0;0;0;0;.00nan;0;0
39449;-1;428;35;29;5;24;.828;3600000;0
39449;186571;437;84;26;1;25;.962;3600000;0
39449;191702;428;0;0;0;0;.00nan;0;0
39450;171787;4849;91;43;2;41;.953;3758000;0
39450;168414;444;61;28;3;25;.893;3758000;0
39450;196412;4849;0;0;0;0;.00nan;0;0
39450;191812;444;0;0;0;0;.00nan;0;0
39451;171877;423;0;0;0;0;.00nan;0;0
39451;188965;423;68;26;2;24;.923;3600000;0
39451;179127;422;0;0;0;0;.00nan;0;0
39451;180578;422;42;31;5;26;.839;3600000;0
39452;194456;414;26;21;5;16;.762;3578000;0
39452;179689;415;0;0;0;0;.00nan;0;0
39452;181346;414;0;0;0;0;.00nan;0;0
39452;191877;415;79;38;3;35;.921;3600000;0
39453;194803;443;81;31;2;29;.935;3674000;0
39453;-1;434;73;39;3;36;.923;3674000;0
39453;182180;443;0;0;0;0;.00nan;0;0
39453;186671;434;0;0;0;0;.00nan;0;0
39454;173339;430;0;0;0;0;.00nan;0;0
39454;184336;429;67;20;2;18;.900;3600000;0
39454;-1;429;0;0;0;0;.00nan;0;0
39454;-1;430;50;31;4;27;.871;3569000;0
39455;184336;429;0;0;0;0;.00nan;0;0
39455;189783;440;46;30;5;25;.833;3600000;0
39455;175723;440;0;0;0;0;.00nan;0;0
39455;-1;429;74;33;2;31;.939;3600000;0
39456;163177;425;0;0;0;0;.00nan;0;0
39456;170499;427;100;32;0;32;1.000;3600000;0
39456;-1;425;68;24;2;22;.917;3600000;0
39456;186468;427;0;0;0;0;.00nan;0;0
39457;179689;415;0;0;0;0;.00nan;0;0
39457;-1;412;60;26;3;23;.885;3600000;0
39457;191877;415;48;23;4;19;.826;3600000;0
39457;-1;412;0;0;0;0;.00nan;0;0
39458;163177;425;0;0;0;0;.00nan;0;0
39458;165023;438;0;0;0;0;.00nan;0;0
39458;176196;438;100;26;0;26;1.000;3600000;0
39458;-1;425;55;29;3;26;.897;3600000;0
39459;182475;437;74;38;4;34;.895;4200000;0
39459;-1;439;0;0;0;0;.00nan;0;0
39459;202193;439;57;30;4;26;.867;4200000;0
39459;186571;437;0;0;0;0;.00nan;0;0
39460;171787;4849;82;40;2;38;.950;3563000;0
39460;183885;449;75;22;1;21;.955;3600000;0
39460;-1;449;0;0;0;0;.00nan;0;0
39460;196412;4849;0;0;0;0;.00nan;0;0
39461;168414;444;0;0;0;0;.00nan;0;0
39461;189288;419;82;40;3;37;.925;3600000;0
39461;196975;419;0;0;0;0;.00nan;0;0
39461;191812;444;100;34;0;34;1.000;3600000;0
39462;184336;429;97;24;0;24;1.000;3600000;0
39462;179657;441;98;46;1;45;.978;3600000;0
39462;-1;429;0;0;0;0;.00nan;0;0
39462;191713;441;0;0;0;0;.00nan;0;0
39463;-1;428;53;17;2;15;.882;3580000;0
39463;194803;443;0;0;0;0;.00nan;0;0
39463;182180;443;81;28;1;27;.964;3600000;0
39463;191702;428;0;0;0;0;.00nan;0;0
39464;171877;423;0;0;0;0;.00nan;0;0
39464;188965;423;76;41;4;37;.902;3541000;0
39464;194598;418;80;45;3;42;.933;3600000;0
39464;191687;418;0;0;0;0;.00nan;0;0
39465;173339;430;0;0;0;0;.00nan;0;0
39465;170499;427;70;31;3;28;.903;3553000;0
39465;186468;427;0;0;0;0;.00nan;0;0
39465;-1;430;61;21;2;19;.905;3600000;0
39466;194650;410;75;28;2;26;.929;3600000;0
39466;184033;411;0;0;0;0;.00nan;0;0
39466;184183;410;0;0;0;0;.00nan;0;0
39466;197699;411;67;35;3;32;.914;3544000;0
39467;200063;442;0;0;0;0;.00nan;0;0
39467;183832;436;0;0;0;0;.00nan;0;0
39467;190157;442;74;30;2;28;.933;3600000;0
39467;191861;436;45;29;4;25;.862;3583000;0
39468;182475;437;0;0;0;0;.00nan;0;0
39468;178743;435;0;0;0;0;.00nan;0;0
39468;186571;437;57;43;5;38;.884;3600000;0
39468;-1;435;88;31;1;30;.968;3600000;0
39469;194854;417;63;35;4;31;.886;3550000;0
39469;178890;417;0;0;0;0;.00nan;0;0
39469;190073;413;74;33;2;31;.939;3600000;0
39469;192627;413;0;0;0;0;.00nan;0;0
39470;194456;414;0;0;0;0;.00nan;0;0
39470;181346;414;62;31;3;28;.903;3600000;0
39470;-1;412;48;25;4;21;.840;3565000;0
39470;-1;412;0;0;0;0;.00nan;0;0
39471;189783;440;98;36;1;35;.972;4200000;0
39471;175723;440;0;0;0;0;.00nan;0;0
39471;-1;434;0;0;0;0;.00nan;0;0
39471;186671;434;60;23;1;22;.957;4200000;0
39472;194146;432;0;0;0;0;.00nan;0;0
39472;191171;431;55;32;4;28;.875;3550000;0
39472;197030;432;76;33;3;30;.909;3600000;0
39472;-1;431;0;0;0;0;.00nan;0;0
39473;171787;4849;0;0;0;0;.00nan;0;0
39473;183885;449;0;0;0;0;.00nan;0;0
39473;-1;449;78;22;1;21;.955;3600000;0
39473;196412;4849;52;39;6;33;.846;3600000;0
39474;179657;441;0;0;0;0;.00nan;0;0
39474;-1;439;0;0;0;0;.00nan;0;0
39474;202193;439;74;31;2;29;.935;3600000;0
39474;191713;441;56;24;3;21;.875;3552000;0
39475;165023;438;0;0;0;0;.00nan;0;0
39475;176196;438;51;23;3;20;.870;3600000;0
39475;-1;433;0;0;0;0;.00nan;0;0
39475;191212;433;65;50;5;45;.900;3600000;0
39476;-1;428;0;0;0;0;.00nan;0;0
39476;-1;426;0;0;0;0;.00nan;0;0
39476;-1;426;36;26;5;21;.808;3600000;0
39476;191702;428;85;34;2;32;.941;3600000;0
39477;168414;444;100;46;2;44;.957;3996000;0
39477;189288;419;0;0;0;0;.00nan;0;0
39477;196975;419;79;40;3;37;.925;3996000;0
39477;191812;444;0;0;0;0;.00nan;0;0
39478;171877;423;82;23;1;22;.957;3600000;0
39478;188965;423;0;0;0;0;.00nan;0;0
39478;194598;418;0;0;0;0;.00nan;0;0
39478;191687;418;69;23;2;21;.913;3556000;0
39479;170499;427;66;37;4;33;.892;3600000;0
39479;189783;440;0;0;0;0;.00nan;0;0
39479;175723;440;100;28;0;28;1.000;3600000;0
39479;186468;427;0;0;0;0;.00nan;0;0
39480;184033;411;56;25;3;22;.880;3600000;0
39480;190073;413;0;0;0;0;.00nan;0;0
39480;192627;413;55;29;4;25;.862;3600000;0
39480;197699;411;0;0;0;0;.00nan;0;0
39481;200063;442;41;20;4;16;.800;1177000;0
39481;183832;436;74;27;2;25;.926;3600000;0
39481;190157;442;79;26;1;25;.962;2398000;0
39481;191861;436;0;0;0;0;.00nan;0;0
39482;200179;420;0;0;0;0;.00nan;0;0
39482;179127;422;67;25;2;23;.920;3591000;0
39482;180578;422;0;0;0;0;.00nan;0;0
39482;186076;420;90;33;1;32;.970;3600000;0
39483;194650;410;0;0;0;0;.00nan;0;0
39483;194854;417;0;0;0;0;.00nan;0;0
39483;184183;410;60;39;4;35;.897;3556000;0
39483;178890;417;58;21;2;19;.905;3600000;0
39484;194456;414;96;24;0;24;1.000;3600000;0
39484;179689;415;0;0;0;0;.00nan;0;0
39484;181346;414;0;0;0;0;.00nan;0;0
39484;191877;415;73;26;2;24;.923;3569000;0
39485;173339;430;77;27;1;26;.963;3600000;0
39485;-1;434;47;30;5;25;.833;3600000;0
39485;186671;434;0;0;0;0;.00nan;0;0
39485;-1;430;0;0;0;0;.00nan;0;0
39486;178743;435;81;36;2;34;.944;3960000;0
39486;184336;429;63;33;3;30;.909;3960000;0
39486;-1;429;0;0;0;0;.00nan;0;0
39486;-1;435;0;0;0;0;.00nan;0;0
39487;163177;425;47;5;1;4;.800;3600000;0
39487;-1;425;0;0;0;0;.00nan;0;0
39487;-1;433;82;58;5;53;.914;3600000;0
39487;191212;433;0;0;0;0;.00nan;0;0
39488;200179;420;37;20;4;16;.800;1123000;0
39488;179127;422;0;0;0;0;.00nan;0;0
39488;180578;422;78;27;2;25;.926;3600000;0
39488;186076;420;48;23;3;20;.870;2477000;0
39489;194650;410;88;43;3;40;.930;3554000;0
39489;184183;410;0;0;0;0;.00nan;0;0
39489;190073;413;77;32;2;30;.938;3600000;0
39489;192627;413;0;0;0;0;.00nan;0;0
39490;184336;429;64;37;4;33;.892;3956000;0
39490;-1;439;0;0;0;0;.00nan;0;0
39490;202193;439;59;26;3;23;.885;3967000;0
39490;-1;429;0;0;0;0;.00nan;0;0
39491;184336;429;0;0;0;0;.00nan;0;0
39491;-1;429;43;28;5;23;.821;3600000;0
39491;-1;433;0;0;0;0;.00nan;0;0
39491;191212;433;55;27;4;23;.852;3600000;0
39492;163177;425;0;0;0;0;.00nan;0;0
39492;178743;435;0;0;0;0;.00nan;0;0
39492;-1;425;82;15;0;15;1.000;3600000;0
39492;-1;435;97;40;2;38;.950;3584000;0
39493;184033;411;0;0;0;0;.00nan;0;0
39493;179689;415;0;0;0;0;.00nan;0;0
39493;191877;415;66;33;3;30;.909;3546000;0
39493;197699;411;77;34;2;32;.941;3600000;0
39494;168414;444;12;19;6;13;.684;2216000;0
39494;183885;449;78;24;1;23;.958;3600000;0
39494;-1;449;0;0;0;0;.00nan;0;0
39494;191812;444;60;8;0;8;1.000;1384000;0
39495;194456;414;37;18;4;14;.778;3556000;0
39495;194650;410;0;0;0;0;.00nan;0;0
39495;184183;410;83;37;3;34;.919;3600000;0
39495;181346;414;0;0;0;0;.00nan;0;0
39496;179657;441;34;37;6;31;.838;3600000;0
39496;-1;434;0;0;0;0;.00nan;0;0
39496;186671;434;81;21;1;20;.952;3600000;0
39496;191713;441;0;0;0;0;.00nan;0;0
39497;-1;428;0;0;0;0;.00nan;0;0
39497;191171;431;38;16;3;13;.813;3517000;0
39497;191702;428;76;29;1;28;.966;3600000;0
39497;-1;431;0;0;0;0;.00nan;0;0
39498;194598;418;0;0;0;0;.00nan;0;0
39498;189318;421;0;0;0;0;.00nan;0;0
39498;179169;421;72;22;1;21;.955;3810000;0
39498;191687;418;86;37;2;35;.946;3810000;0
39499;194854;417;67;43;4;39;.907;3554000;0
39499;178890;417;0;0;0;0;.00nan;0;0
39499;-1;412;0;0;0;0;.00nan;0;0
39499;-1;412;63;36;3;33;.917;3600000;0
39500;200063;442;0;0;0;0;.00nan;0;0
39500;170499;427;59;29;3;26;.897;3600000;0
39500;190157;442;52;49;6;43;.878;3574000;0
39500;186468;427;0;0;0;0;.00nan;0;0
39501;171787;4849;39;27;5;22;.815;3559000;0
39501;200179;420;0;0;0;0;.00nan;0;0
39501;196412;4849;0;0;0;0;.00nan;0;0
39501;186076;420;69;33;3;30;.909;3600000;0
39502;171877;423;0;0;0;0;.00nan;0;0
39502;188965;423;47;20;3;17;.850;3600000;0
39502;189288;419;0;0;0;0;.00nan;0;0
39502;196975;419;78;45;4;41;.911;3599000;0
39503;183832;436;44;34;6;28;.824;2595000;0
39503;173339;430;0;0;0;0;.00nan;0;0
39503;191861;436;52;4;0;4;1.000;1005000;0
39503;-1;430;69;24;2;22;.917;3600000;0
39504;182475;437;0;0;0;0;.00nan;0;0
39504;189783;440;0;0;0;0;.00nan;0;0
39504;175723;440;87;27;1;26;.963;3825000;0
39504;186571;437;94;43;2;41;.953;3825000;0
39505;194854;417;0;0;0;0;.00nan;0;0
39505;178890;417;80;45;4;41;.911;3522000;0
39505;179689;415;69;28;2;26;.929;3600000;0
39505;191877;415;0;0;0;0;.00nan;0;0
39506;168414;444;0;0;0;0;.00nan;0;0
39506;183885;449;0;0;0;0;.00nan;0;0
39506;-1;449;51;36;5;31;.861;3600000;0
39506;191812;444;86;38;2;36;.947;3600000;0
39507;-1;434;43;21;3;18;.857;3600000;0
39507;-1;439;0;0;0;0;.00nan;0;0
39507;202193;439;80;25;2;23;.920;3600000;0
39507;186671;434;0;0;0;0;.00nan;0;0
39508;165023;438;81;28;1;27;.964;3600000;0
39508;178743;435;26;6;3;3;.500;395000;0
39508;176196;438;0;0;0;0;.00nan;0;0
39508;-1;435;38;19;4;15;.789;3205000;0
39509;194146;432;72;29;3;26;.897;3552000;0
39509;179657;441;0;0;0;0;.00nan;0;0
39509;197030;432;0;0;0;0;.00nan;0;0
39509;191713;441;78;28;1;27;.964;3600000;0
39510;-1;428;65;22;2;20;.909;3600000;0
39510;191171;431;0;0;0;0;.00nan;0;0
39510;191702;428;0;0;0;0;.00nan;0;0
39510;-1;431;46;27;4;23;.852;3600000;0
39511;194598;418;57;38;4;34;.895;3600000;0
39511;189318;421;84;20;0;20;1.000;3600000;0
39511;179169;421;0;0;0;0;.00nan;0;0
39511;191687;418;0;0;0;0;.00nan;0;0
39512;163177;425;0;0;0;0;.00nan;0;0
39512;-1;425;58;27;3;24;.889;4200000;0
39512;-1;433;75;39;3;36;.923;4200000;0
39512;191212;433;0;0;0;0;.00nan;0;0
39513;194803;443;0;0;0;0;.00nan;0;0
39513;182180;443;97;17;0;17;1.000;3600000;0
39513;-1;426;0;0;0;0;.00nan;0;0
39513;-1;426;74;43;4;39;.907;3600000;0
39514;184033;411;76;25;2;23;.920;3600000;0
39514;-1;412;54;28;3;25;.893;3552000;0
39514;-1;412;0;0;0;0;.00nan;0;0
39514;197699;411;0;0;0;0;.00nan;0;0
39515;194456;414;0;0;0;0;.00nan;0;0
39515;190073;413;0;0;0;0;.00nan;0;0
39515;181346;414;80;33;3;30;.909;3600000;0
39515;192627;413;78;33;2;31;.939;3600000;0
39516;182475;437;94;36;2;34;.944;3724000;0
39516;170499;427;67;21;1;20;.952;3724000;0
39516;186468;427;0;0;0;0;.00nan;0;0
39516;186571;437;0;0;0;0;.00nan;0;0
39517;171787;4849;0;0;0;0;.00nan;0;0
39517;200179;420;44;35;5;30;.857;3574000;0
39517;196412;4849;62;31;3;28;.903;3600000;0
39517;186076;420;0;0;0;0;.00nan;0;0
39518;171877;423;29;23;5;18;.783;4019000;0
39518;188965;423;0;0;0;0;.00nan;0;0
39518;189288;419;65;47;6;41;.872;4019000;0
39518;196975;419;0;0;0;0;.00nan;0;0
39519;183832;436;58;35;4;31;.886;3515000;0
39519;173339;430;97;31;2;29;.935;3600000;0
39519;191861;436;0;0;0;0;.00nan;0;0
39519;-1;430;0;0;0;0;.00nan;0;0
39520;200063;442;84;39;3;36;.923;3600000;0
39520;189783;440;46;30;4;26;.867;3545000;0
39520;175723;440;0;0;0;0;.00nan;0;0
39520;190157;442;0;0;0;0;.00nan;0;0
39521;194456;414;69;30;3;27;.900;3600000;0
39521;184033;411;0;0;0;0;.00nan;0;0
39521;181346;414;0;0;0;0;.00nan;0;0
39521;197699;411;61;38;4;34;.895;3586000;0
39522;173339;430;0;0;0;0;.00nan;0;0
39522;-1;439;77;33;2;31;.939;3648000;0
39522;202193;439;0;0;0;0;.00nan;0;0
39522;-1;430;65;30;3;27;.900;3648000;0
39523;178743;435;0;0;0;0;.00nan;0;0
39523;-1;426;0;0;0;0;.00nan;0;0
39523;-1;426;69;30;2;28;.933;3558000;0
39523;-1;435;73;19;1;18;.947;3600000;0
39524;-1;428;68;20;2;18;.900;3600000;0
39524;179657;441;56;26;3;23;.885;3579000;0
39524;191702;428;0;0;0;0;.00nan;0;0
39524;191713;441;0;0;0;0;.00nan;0;0
39525;182475;437;0;0;0;0;.00nan;0;0
39525;186571;437;52;26;4;22;.846;3600000;0
39525;191171;431;31;26;5;21;.808;3582000;0
39525;-1;431;0;0;0;0;.00nan;0;0
39526;171787;4849;74;50;5;45;.900;3600000;0
39526;171877;423;0;0;0;0;.00nan;0;0
39526;188965;423;80;31;2;29;.935;3600000;0
39526;196412;4849;0;0;0;0;.00nan;0;0
39527;165023;438;0;0;0;0;.00nan;0;0
39527;184336;429;71;30;2;28;.933;3562000;0
39527;176196;438;82;23;1;22;.957;3600000;0
39527;-1;429;0;0;0;0;.00nan;0;0
39528;194650;410;78;38;2;36;.947;3600000;0
39528;184183;410;0;0;0;0;.00nan;0;0
39528;179689;415;0;0;0;0;.00nan;0;0
39528;191877;415;81;31;3;28;.903;3600000;0
39529;-1;428;0;0;0;0;.00nan;0;0
39529;179657;441;0;0;0;0;.00nan;0;0
39529;191702;428;75;29;1;28;.966;4200000;0
39529;191713;441;92;36;1;35;.972;4200000;0
39530;200179;420;31;16;4;12;.750;3600000;0
39530;189288;419;0;0;0;0;.00nan;0;0
39530;186076;420;0;0;0;0;.00nan;0;0
39530;196975;419;99;36;1;35;.972;3600000;0
39531;168414;444;0;0;0;0;.00nan;0;0
39531;194598;418;0;0;0;0;.00nan;0;0
39531;191687;418;48;20;3;17;.850;3600000;0
39531;191812;444;63;39;4;35;.897;3579000;0
39532;163177;425;41;24;4;20;.833;3059000;0
39532;170499;427;71;29;2;27;.931;3600000;0
39532;-1;425;28;9;3;6;.667;541000;0
39532;186468;427;0;0;0;0;.00nan;0;0
39533;200063;442;0;0;0;0;.00nan;0;0
39533;194803;443;0;0;0;0;.00nan;0;0
39533;190157;442;56;40;5;35;.875;3574000;0
39533;182180;443;69;31;4;27;.871;3600000;0
39534;189318;421;85;37;3;34;.919;3600000;0
39534;179127;422;52;35;4;31;.886;3600000;0
39534;179169;421;0;0;0;0;.00nan;0;0
39534;180578;422;0;0;0;0;.00nan;0;0
39535;190073;413;63;33;4;29;.879;3600000;0
39535;-1;412;59;34;5;29;.853;3544000;0
39535;192627;413;0;0;0;0;.00nan;0;0
39535;-1;412;0;0;0;0;.00nan;0;0
39536;171787;4849;0;0;0;0;.00nan;0;0
39536;171877;423;71;36;3;33;.917;4080000;0
39536;188965;423;0;0;0;0;.00nan;0;0
39536;196412;4849;54;33;4;29;.879;4080000;0
39537;184033;411;0;0;0;0;.00nan;0;0
39537;194854;417;70;31;3;28;.903;3600000;0
39537;178890;417;0;0;0;0;.00nan;0;0
39537;197699;411;61;32;4;28;.875;3595000;0
39538;183832;436;40;34;6;28;.824;3600000;0
39538;-1;434;0;0;0;0;.00nan;0;0
39538;186671;434;69;26;2;24;.923;3600000;0
39538;191861;436;0;0;0;0;.00nan;0;0
39539;194146;432;0;0;0;0;.00nan;0;0
39539;189783;440;91;39;2;37;.949;3551000;0
39539;175723;440;0;0;0;0;.00nan;0;0
39539;197030;432;82;17;0;17;1.000;3600000;0
39540;190073;413;0;0;0;0;.00nan;0;0
39540;179689;415;100;34;0;34;1.000;3600000;0
39540;191877;415;0;0;0;0;.00nan;0;0
39540;192627;413;44;28;4;24;.857;3600000;0
39541;194146;432;0;0;0;0;.00nan;0;0
39541;-1;439;0;0;0;0;.00nan;0;0
39541;202193;439;31;21;5;16;.762;3600000;0
39541;197030;432;92;42;2;40;.952;3600000;0
39542;194803;443;51;22;3;19;.864;3600000;0
39542;178743;435;0;0;0;0;.00nan;0;0
39542;182180;443;0;0;0;0;.00nan;0;0
39542;-1;435;80;28;2;26;.929;3600000;0
39543;189783;440;0;0;0;0;.00nan;0;0
39543;175723;440;77;39;3;36;.923;4200000;0
39543;191171;431;0;0;0;0;.00nan;0;0
39543;-1;431;48;29;3;26;.897;4200000;0
39544;200179;420;59;8;0;8;1.000;620000;0
39544;189288;419;68;27;2;25;.926;3600000;0
39544;186076;420;32;29;6;23;.793;2980000;0
39544;196975;419;0;0;0;0;.00nan;0;0
39545;168414;444;0;0;0;0;.00nan;0;0
39545;194598;418;59;34;4;30;.882;3600000;0
39545;191687;418;0;0;0;0;.00nan;0;0
39545;191812;444;88;40;2;38;.950;3600000;0
39546;183832;436;91;28;1;27;.964;3600000;0
39546;170499;427;66;27;2;25;.926;3546000;0
39546;186468;427;0;0;0;0;.00nan;0;0
39546;191861;436;0;0;0;0;.00nan;0;0
39547;182475;437;60;5;0;5;1.000;1317000;0
39547;-1;433;0;0;0;0;.00nan;0;0
39547;186571;437;29;26;6;20;.769;2283000;0
39547;191212;433;48;30;4;26;.867;3600000;0
39548;163177;425;0;0;0;0;.00nan;0;0
39548;184336;429;0;0;0;0;.00nan;0;0
39548;-1;425;68;25;2;23;.920;3600000;0
39548;-1;429;82;27;1;26;.963;3600000;0
39549;189318;421;0;0;0;0;.00nan;0;0
39549;179127;422;0;0;0;0;.00nan;0;0
39549;179169;421;96;39;2;37;.949;4131000;0
39549;180578;422;75;32;3;29;.906;4131000;0
39550;200063;442;70;45;5;40;.889;3600000;0
39550;190157;442;0;0;0;0;.00nan;0;0
39550;-1;426;84;13;0;13;1.000;3600000;0
39550;-1;426;0;0;0;0;.00nan;0;0
39551;194650;410;0;0;0;0;.00nan;0;0
39551;184183;410;94;53;2;51;.962;4200000;0
39551;-1;412;0;0;0;0;.00nan;0;0
39551;-1;412;67;24;2;22;.917;4200000;0
39552;194456;414;56;37;4;33;.892;3600000;0
39552;194854;417;58;19;2;17;.895;1498000;0
39552;178890;417;51;28;4;24;.857;2077000;0
39552;181346;414;0;0;0;0;.00nan;0;0
39553;194146;432;0;0;0;0;.00nan;0;0
39553;191171;431;75;40;3;37;.925;3529000;0
39553;197030;432;77;18;1;17;.944;3600000;0
39553;-1;431;0;0;0;0;.00nan;0;0
39554;194650;410;60;32;3;29;.906;3600000;0
39554;184183;410;0;0;0;0;.00nan;0;0
39554;190073;413;31;27;6;21;.778;3183000;0
39554;192627;413;49;1;0;1;1.000;417000;0
39555;165023;438;82;19;1;18;.947;3600000;0
39555;200063;442;0;0;0;0;.00nan;0;0
39555;176196;438;0;0;0;0;.00nan;0;0
39555;190157;442;75;25;2;23;.920;3576000;0
39556;178743;435;0;0;0;0;.00nan;0;0
39556;-1;426;42;28;5;23;.821;3560000;0
39556;-1;426;0;0;0;0;.00nan;0;0
39556;-1;435;64;37;4;33;.892;3600000;0
39557;189288;419;0;0;0;0;.00nan;0;0
39557;179127;422;50;30;5;25;.833;4200000;0
39557;180578;422;0;0;0;0;.00nan;0;0
39557;196975;419;75;45;5;40;.889;4200000;0
39558;184033;411;0;0;0;0;.00nan;0;0
39558;179689;415;90;33;1;32;.970;3600000;0
39558;191877;415;0;0;0;0;.00nan;0;0
39558;197699;411;55;31;3;28;.903;3583000;0
39559;168414;444;0;0;0;0;.00nan;0;0
39559;189318;421;0;0;0;0;.00nan;0;0
39559;179169;421;55;23;3;20;.870;3600000;0
39559;191812;444;68;44;5;39;.886;3566000;0
39560;182475;437;95;32;1;31;.969;3600000;0
39560;183832;436;0;0;0;0;.00nan;0;0
39560;186571;437;0;0;0;0;.00nan;0;0
39560;191861;436;31;30;6;24;.800;3600000;0
39561;-1;434;0;0;0;0;.00nan;0;0
39561;-1;433;93;40;2;38;.950;3600000;0
39561;186671;434;66;19;1;18;.947;3600000;0
39561;191212;433;0;0;0;0;.00nan;0;0
39562;163177;425;35;26;4;22;.846;3543000;0
39562;-1;428;91;35;2;33;.943;3600000;0
39562;-1;425;0;0;0;0;.00nan;0;0
39562;191702;428;0;0;0;0;.00nan;0;0
39563;194803;443;0;0;0;0;.00nan;0;0
39563;178743;435;31;28;6;22;.786;3600000;0
39563;182180;443;94;22;0;22;1.000;3600000;0
39563;-1;435;0;0;0;0;.00nan;0;0
39564;200179;420;62;31;3;28;.903;3731000;0
39564;183885;449;67;29;2;27;.931;3731000;0
39564;-1;449;0;0;0;0;.00nan;0;0
39564;186076;420;0;0;0;0;.00nan;0;0
39565;171787;4849;81;42;3;39;.929;3554000;0
39565;194598;418;0;0;0;0;.00nan;0;0
39565;196412;4849;0;0;0;0;.00nan;0;0
39565;191687;418;86;27;1;26;.963;3600000;0
39566;194854;417;58;30;4;26;.867;3553000;0
39566;178890;417;0;0;0;0;.00nan;0;0
39566;-1;412;0;0;0;0;.00nan;0;0
39566;-1;412;64;26;3;23;.885;3600000;0
39567;194456;414;71;38;3;35;.921;3862000;0
39567;190073;413;75;38;4;34;.895;3862000;0
39567;181346;414;0;0;0;0;.00nan;0;0
39567;192627;413;0;0;0;0;.00nan;0;0
39568;173339;430;0;0;0;0;.00nan;0;0
39568;191171;431;72;47;4;43;.915;3600000;0
39568;-1;430;77;23;1;22;.957;3600000;0
39568;-1;431;0;0;0;0;.00nan;0;0
39569;189783;440;0;0;0;0;.00nan;0;0
39569;175723;440;79;32;2;30;.938;3600000;0
39569;179657;441;49;29;4;25;.862;3549000;0
39569;191713;441;0;0;0;0;.00nan;0;0
39570;170499;427;66;32;3;29;.906;3600000;0
39570;184336;429;100;29;0;29;1.000;3600000;0
39570;-1;429;0;0;0;0;.00nan;0;0
39570;186468;427;0;0;0;0;.00nan;0;0
39571;168414;444;0;0;0;0;.00nan;0;0
39571;189318;421;100;28;0;28;1.000;3600000;0
39571;179169;421;0;0;0;0;.00nan;0;0
39571;191812;444;73;39;3;36;.923;3600000;0
39572;165023;438;0;0;0;0;.00nan;0;0
39572;-1;428;0;0;0;0;.00nan;0;0
39572;176196;438;77;28;2;26;.929;3600000;0
39572;191702;428;70;52;5;47;.904;3600000;0
39573;189288;419;73;29;2;27;.931;3600000;0
39573;179127;422;0;0;0;0;.00nan;0;0
39573;180578;422;51;23;3;20;.870;3527000;0
39573;196975;419;0;0;0;0;.00nan;0;0
39574;184033;411;76;20;1;19;.950;3600000;0
39574;-1;412;65;25;3;22;.880;3600000;0
39574;-1;412;0;0;0;0;.00nan;0;0
39574;197699;411;0;0;0;0;.00nan;0;0
39575;182475;437;0;0;0;0;.00nan;0;0
39575;183832;436;100;21;0;21;1.000;3600000;0
39575;186571;437;46;27;4;23;.852;3600000;0
39575;191861;436;0;0;0;0;.00nan;0;0
39576;170499;427;67;6;0;6;1.000;3600000;0
39576;-1;433;0;0;0;0;.00nan;0;0
39576;186468;427;0;0;0;0;.00nan;0;0
39576;191212;433;61;36;3;33;.917;3600000;0
39577;200179;420;0;0;0;0;.00nan;0;0
39577;183885;449;0;0;0;0;.00nan;0;0
39577;-1;449;59;32;4;28;.875;4200000;0
39577;186076;420;68;40;4;36;.900;4200000;0
39578;163177;425;0;0;0;0;.00nan;0;0
39578;200063;442;0;0;0;0;.00nan;0;0
39578;190157;442;56;43;5;38;.884;3600000;0
39578;-1;425;61;23;3;20;.870;3600000;0
39579;171787;4849;0;0;0;0;.00nan;0;0
39579;194598;418;91;35;1;34;.971;4154000;0
39579;196412;4849;88;46;2;44;.957;4154000;0
39579;191687;418;0;0;0;0;.00nan;0;0
39580;194854;417;0;0;0;0;.00nan;0;0
39580;178890;417;95;47;4;43;.915;3531000;0
39580;179689;415;0;0;0;0;.00nan;0;0
39580;191877;415;74;27;2;25;.926;3600000;0
39581;194456;414;0;0;0;0;.00nan;0;0
39581;194650;410;0;0;0;0;.00nan;0;0
39581;184183;410;30;26;6;20;.769;3835000;0
39581;181346;414;20;30;7;23;.767;3834000;0
39582;194146;432;0;0;0;0;.00nan;0;0
39582;173339;430;56;27;3;24;.889;3600000;0
39582;197030;432;70;23;2;21;.913;3600000;0
39582;-1;430;0;0;0;0;.00nan;0;0
39583;189783;440;67;37;5;32;.865;3600000;0
39583;175723;440;0;0;0;0;.00nan;0;0
39583;-1;439;0;0;0;0;.00nan;0;0
39583;202193;439;99;25;0;25;1.000;3600000;0
39584;184336;429;78;32;2;30;.938;3943000;0
39584;-1;434;60;30;3;27;.900;3943000;0
39584;-1;429;0;0;0;0;.00nan;0;0
39584;186671;434;0;0;0;0;.00nan;0;0
39585;179689;415;29;30;6;24;.800;3840000;0
39585;-1;412;42;32;5;27;.844;3840000;0
39585;191877;415;0;0;0;0;.00nan;0;0
39585;-1;412;0;0;0;0;.00nan;0;0
39586;178743;435;0;0;0;0;.00nan;0;0
39586;170499;427;79;26;1;25;.962;3600000;0
39586;186468;427;0;0;0;0;.00nan;0;0
39586;-1;435;38;37;6;31;.838;3600000;0
39587;194803;443;0;0;0;0;.00nan;0;0
39587;184336;429;61;25;3;22;.880;3600000;0
39587;182180;443;44;22;5;17;.773;3578000;0
39587;-1;429;0;0;0;0;.00nan;0;0
39588;182475;437;69;33;3;30;.909;3600000;0
39588;173339;430;0;0;0;0;.00nan;0;0
39588;186571;437;0;0;0;0;.00nan;0;0
39588;-1;430;31;23;5;18;.783;3535000;0
39589;200063;442;0;0;0;0;.00nan;0;0
39589;190157;442;63;18;2;16;.889;3600000;0
39589;-1;433;68;41;4;37;.902;3600000;0
39589;191212;433;0;0;0;0;.00nan;0;0
39590;171877;423;0;0;0;0;.00nan;0;0
39590;188965;423;47;24;4;20;.833;3600000;0
39590;183885;449;76;11;0;11;1.000;3600000;0
39590;-1;449;0;0;0;0;.00nan;0;0
39591;194650;410;62;44;4;40;.909;3543000;0
39591;184033;411;0;0;0;0;.00nan;0;0
39591;184183;410;0;0;0;0;.00nan;0;0
39591;197699;411;47;15;3;12;.800;3600000;0
39592;-1;428;61;26;3;23;.885;3574000;0
39592;189783;440;76;26;1;25;.962;3600000;0
39592;175723;440;0;0;0;0;.00nan;0;0
39592;191702;428;0;0;0;0;.00nan;0;0
39593;191171;431;78;36;2;34;.944;3600000;0
39593;-1;426;0;0;0;0;.00nan;0;0
39593;-1;426;57;12;1;11;.917;3600000;0
39593;-1;431;0;0;0;0;.00nan;0;0
39594;194598;418;0;0;0;0;.00nan;0;0
39594;189288;419;0;0;0;0;.00nan;0;0
39594;196975;419;23;28;6;22;.786;3600000;0
39594;191687;418;90;31;2;29;.935;3600000;0
39595;200179;420;95;40;1;39;.975;3600000;0
39595;189318;421;52;19;3;16;.842;3567000;0
39595;179169;421;0;0;0;0;.00nan;0;0
39595;186076;420;0;0;0;0;.00nan;0;0
39596;183832;436;84;31;1;30;.968;3600000;0
39596;-1;439;0;0;0;0;.00nan;0;0
39596;202193;439;40;22;4;18;.818;3600000;0
39596;191861;436;0;0;0;0;.00nan;0;0
39597;171787;4849;88;22;1;21;.955;3600000;0
39597;179127;422;61;28;3;25;.893;3515000;0
39597;180578;422;0;0;0;0;.00nan;0;0
39597;196412;4849;0;0;0;0;.00nan;0;0
39598;194456;414;83;38;3;35;.921;4200000;0
39598;181346;414;0;0;0;0;.00nan;0;0
39598;-1;412;0;0;0;0;.00nan;0;0
39598;-1;412;61;31;3;28;.903;4200000;0
39599;194854;417;25;39;8;31;.795;3600000;0
39599;178890;417;0;0;0;0;.00nan;0;0
39599;190073;413;0;0;0;0;.00nan;0;0
39599;192627;413;56;24;3;21;.875;3600000;0
39600;182475;437;17;9;4;5;.556;844000;0
39600;200063;442;88;41;3;38;.927;3600000;0
39600;190157;442;0;0;0;0;.00nan;0;0
39600;186571;437;57;22;2;20;.909;2756000;0
39601;165023;438;16;19;6;13;.684;2156000;0
39601;176196;438;59;7;0;7;1.000;1358000;0
39601;-1;434;0;0;0;0;.00nan;0;0
39601;186671;434;48;24;4;20;.833;3600000;0
39602;194146;432;72;33;2;31;.939;3600000;0
39602;194803;443;0;0;0;0;.00nan;0;0
39602;182180;443;90;40;3;37;.925;3569000;0
39602;197030;432;0;0;0;0;.00nan;0;0
39603;173339;430;0;0;0;0;.00nan;0;0
39603;179657;441;88;34;3;31;.912;3568000;0
39603;191713;441;0;0;0;0;.00nan;0;0
39603;-1;430;75;22;1;21;.955;3600000;0
39604;194456;414;73;44;5;39;.886;3600000;0
39604;179689;415;0;0;0;0;.00nan;0;0
39604;181346;414;0;0;0;0;.00nan;0;0
39604;191877;415;66;20;2;18;.900;3600000;0
39605;171877;423;0;0;0;0;.00nan;0;0
39605;188965;423;68;32;2;30;.938;4200000;0
39605;183885;449;99;47;2;45;.957;4200000;0
39605;-1;449;0;0;0;0;.00nan;0;0
39606;163177;425;0;0;0;0;.00nan;0;0
39606;178743;435;83;42;3;39;.929;3258000;0
39606;-1;425;79;24;1;23;.958;3600000;0
39606;-1;435;26;7;3;4;.571;342000;0
39607;194650;410;0;0;0;0;.00nan;0;0
39607;194854;417;0;0;0;0;.00nan;0;0
39607;184183;410;67;30;3;27;.900;3600000;0
39607;178890;417;59;39;5;34;.872;3515000;0
39608;-1;428;97;31;1;30;.968;3600000;0
39608;189783;440;0;0;0;0;.00nan;0;0
39608;175723;440;76;34;3;31;.912;3551000;0
39608;191702;428;0;0;0;0;.00nan;0;0
39609;194803;443;83;30;1;29;.967;3600000;0
39609;182180;443;0;0;0;0;.00nan;0;0
39609;191171;431;0;0;0;0;.00nan;0;0
39609;-1;431;74;31;2;29;.935;3600000;0
39610;194598;418;70;24;1;23;.958;3577000;0
39610;189288;419;100;45;0;45;1.000;3600000;0
39610;196975;419;0;0;0;0;.00nan;0;0
39610;191687;418;0;0;0;0;.00nan;0;0
39611;165023;438;82;39;2;37;.949;3600000;0
39611;170499;427;57;22;3;19;.864;3553000;0
39611;176196;438;0;0;0;0;.00nan;0;0
39611;186468;427;0;0;0;0;.00nan;0;0
39612;200179;420;0;0;0;0;.00nan;0;0
39612;189318;421;0;0;0;0;.00nan;0;0
39612;179169;421;71;25;2;23;.920;3578000;0
39612;186076;420;75;26;1;25;.962;3600000;0
39613;183832;436;0;0;0;0;.00nan;0;0
39613;-1;439;64;47;5;42;.894;3569000;0
39613;202193;439;0;0;0;0;.00nan;0;0
39613;191861;436;58;22;3;19;.864;3600000;0
39614;171787;4849;0;0;0;0;.00nan;0;0
39614;179127;422;0;0;0;0;.00nan;0;0
39614;180578;422;43;30;5;25;.833;3619000;0
39614;196412;4849;74;39;4;35;.897;3619000;0
39615;184033;411;78;28;2;26;.929;3600000;0
39615;190073;413;59;29;4;25;.862;3519000;0
39615;192627;413;0;0;0;0;.00nan;0;0
39615;197699;411;0;0;0;0;.00nan;0;0
39616;182475;437;0;0;0;0;.00nan;0;0
39616;179657;441;0;0;0;0;.00nan;0;0
39616;186571;437;100;37;1;36;.973;4200000;0
39616;191713;441;84;27;1;26;.963;4200000;0
39617;194146;432;0;0;0;0;.00nan;0;0
39617;-1;426;61;29;4;25;.862;3600000;0
39617;-1;426;0;0;0;0;.00nan;0;0
39617;197030;432;62;41;5;36;.878;3560000;0
39618;184336;429;47;13;2;11;.846;3600000;0
39618;-1;429;0;0;0;0;.00nan;0;0
39618;-1;433;0;0;0;0;.00nan;0;0
39618;191212;433;77;56;6;50;.893;3600000;0
39619;163177;425;85;40;2;38;.950;3600000;0
39619;-1;434;0;0;0;0;.00nan;0;0
39619;-1;425;0;0;0;0;.00nan;0;0
39619;186671;434;47;24;3;21;.875;3590000;0
39620;184033;411;0;0;0;0;.00nan;0;0
39620;194854;417;33;26;5;21;.808;2018000;0
39620;178890;417;44;16;3;13;.813;1582000;0
39620;197699;411;48;23;4;19;.826;3600000;0
39621;178743;435;69;41;4;37;.902;3600000;0
39621;-1;434;0;0;0;0;.00nan;0;0
39621;186671;434;66;16;1;15;.938;3600000;0
39621;-1;435;0;0;0;0;.00nan;0;0
39622;173339;430;0;0;0;0;.00nan;0;0
39622;179657;441;100;39;0;39;1.000;3600000;0
39622;191713;441;0;0;0;0;.00nan;0;0
39622;-1;430;61;23;2;21;.913;3574000;0
39623;163177;425;0;0;0;0;.00nan;0;0
39623;165023;438;96;28;0;28;1.000;3600000;0
39623;176196;438;0;0;0;0;.00nan;0;0
39623;-1;425;60;22;2;20;.909;3528000;0
39624;194803;443;0;0;0;0;.00nan;0;0
39624;182180;443;50;31;4;27;.871;3600000;0
39624;-1;426;0;0;0;0;.00nan;0;0
39624;-1;426;83;29;1;28;.966;3600000;0
39625;194650;410;47;30;4;26;.867;3651000;0
39625;184183;410;0;0;0;0;.00nan;0;0
39625;179689;415;0;0;0;0;.00nan;0;0
39625;191877;415;65;29;3;26;.897;3651000;0
39626;200063;442;0;0;0;0;.00nan;0;0
39626;190157;442;86;28;1;27;.964;3600000;0
39626;-1;439;0;0;0;0;.00nan;0;0
39626;202193;439;56;25;3;22;.880;3555000;0
39627;168414;444;50;5;1;4;.800;804000;0
39627;179127;422;75;24;2;22;.917;3600000;0
39627;180578;422;0;0;0;0;.00nan;0;0
39627;191812;444;45;41;6;35;.854;2796000;0
39628;183832;436;79;23;1;22;.957;3600000;0
39628;-1;428;61;22;2;20;.909;3544000;0
39628;191702;428;0;0;0;0;.00nan;0;0
39628;191861;436;0;0;0;0;.00nan;0;0
39629;190073;413;0;0;0;0;.00nan;0;0
39629;-1;412;0;0;0;0;.00nan;0;0
39629;192627;413;100;29;0;29;1.000;3600000;0
39629;-1;412;69;35;3;32;.914;3600000;0
39630;200179;420;65;36;5;31;.861;3570000;0
39630;194598;418;0;0;0;0;.00nan;0;0
39630;186076;420;0;0;0;0;.00nan;0;0
39630;191687;418;55;23;3;20;.870;3600000;0
39631;171787;4849;61;34;4;30;.882;3565000;0
39631;183885;449;64;23;3;20;.870;3600000;0
39631;-1;449;0;0;0;0;.00nan;0;0
39631;196412;4849;0;0;0;0;.00nan;0;0
39632;171877;423;0;0;0;0;.00nan;0;0
39632;188965;423;48;31;4;27;.871;3600000;0
39632;189318;421;0;0;0;0;.00nan;0;0
39632;179169;421;80;29;1;28;.966;3600000;0
39633;194456;414;56;33;5;28;.848;3600000;0
39633;184033;411;0;0;0;0;.00nan;0;0
39633;181346;414;0;0;0;0;.00nan;0;0
39633;197699;411;69;19;1;18;.947;3600000;0
39634;182475;437;0;0;0;0;.00nan;0;0
39634;-1;434;70;23;2;21;.913;3600000;0
39634;186571;437;73;37;4;33;.892;3600000;0
39634;186671;434;0;0;0;0;.00nan;0;0
39635;194146;432;73;32;2;30;.938;3600000;0
39635;173339;430;67;33;3;30;.909;3545000;0
39635;197030;432;0;0;0;0;.00nan;0;0
39635;-1;430;0;0;0;0;.00nan;0;0
39636;189783;440;60;22;2;20;.909;3587000;0
39636;175723;440;0;0;0;0;.00nan;0;0
39636;191171;431;99;36;1;35;.972;3600000;0
39636;-1;431;0;0;0;0;.00nan;0;0
39637;168414;444;66;42;5;37;.881;3523000;0
39637;179127;422;0;0;0;0;.00nan;0;0
39637;180578;422;60;26;3;23;.885;3600000;0
39637;191812;444;0;0;0;0;.00nan;0;0
39638;165023;438;74;43;5;38;.884;3515000;0
39638;170499;427;40;13;3;10;.769;3600000;0
39638;176196;438;0;0;0;0;.00nan;0;0
39638;186468;427;0;0;0;0;.00nan;0;0
39639;194650;410;0;0;0;0;.00nan;0;0
39639;184183;410;38;25;4;21;.840;3563000;0
39639;-1;412;59;30;3;27;.900;3600000;0
39639;-1;412;0;0;0;0;.00nan;0;0
39640;194803;443;0;0;0;0;.00nan;0;0
39640;182180;443;65;18;1;17;.944;3600000;0
39640;-1;433;0;0;0;0;.00nan;0;0
39640;191212;433;85;45;3;42;.933;3586000;0
39641;184336;429;66;41;4;37;.902;3600000;0
39641;-1;429;0;0;0;0;.00nan;0;0
39641;-1;426;43;28;5;23;.821;3588000;0
39641;-1;426;0;0;0;0;.00nan;0;0
39642;200179;420;0;0;0;0;.00nan;0;0
39642;194598;418;47;39;5;34;.872;3600000;0
39642;186076;420;57;20;2;18;.900;3600000;0
39642;191687;418;0;0;0;0;.00nan;0;0
39643;190073;413;0;0;0;0;.00nan;0;0
39643;179689;415;71;34;2;32;.941;3541000;0
39643;191877;415;0;0;0;0;.00nan;0;0
39643;192627;413;100;23;0;23;1.000;3600000;0
39644;171787;4849;0;0;0;0;.00nan;0;0
39644;183885;449;71;34;4;30;.882;4200000;0
39644;-1;449;0;0;0;0;.00nan;0;0
39644;196412;4849;80;51;4;47;.922;4200000;0
39645;171877;423;60;34;4;30;.882;3600000;0
39645;188965;423;0;0;0;0;.00nan;0;0
39645;189318;421;42;32;5;27;.844;3544000;0
39645;179169;421;0;0;0;0;.00nan;0;0
39646;194456;414;72;36;4;32;.889;4200000;0
39646;194854;417;67;35;4;31;.886;4200000;0
39646;178890;417;0;0;0;0;.00nan;0;0
39646;181346;414;0;0;0;0;.00nan;0;0
39647;194146;432;0;0;0;0;.00nan;0;0
39647;189783;440;0;0;0;0;.00nan;0;0
39647;175723;440;92;39;2;37;.949;3848000;0
39647;197030;432;69;31;3;28;.903;3848000;0
39649;163177;425;0;0;0;0;.00nan;0;0
39649;194146;432;57;8;0;8;1.000;707000;0
39649;-1;425;66;21;2;19;.905;3600000;0
39649;197030;432;36;33;6;27;.818;2893000;0
39651;171787;4849;74;24;1;23;.958;3600000;0
39651;194598;418;0;0;0;0;.00nan;0;0
39651;196412;4849;0;0;0;0;.00nan;0;0
39651;191687;418;63;25;2;23;.920;3570000;0
39653;189288;419;0;0;0;0;.00nan;0;0
39653;-1;434;0;0;0;0;.00nan;0;0
39653;186671;434;58;12;1;11;.917;3600000;0
39653;196975;419;75;31;2;29;.935;3544000;0
39655;200063;442;24;13;4;9;.692;1139000;0
39655;194854;417;78;37;3;34;.919;3600000;0
39655;178890;417;0;0;0;0;.00nan;0;0
39655;190157;442;74;16;0;16;1.000;2432000;0
39657;189318;421;0;0;0;0;.00nan;0;0
39657;179169;421;95;21;0;21;1.000;3600000;0
39657;-1;433;98;46;2;44;.957;3547000;0
39657;191212;433;0;0;0;0;.00nan;0;0
39659;183832;436;0;0;0;0;.00nan;0;0
39659;179657;441;21;9;4;5;.556;949000;0
39659;191713;441;49;22;3;19;.864;2651000;0
39659;191861;436;79;26;1;25;.962;3600000;0
39661;190073;413;0;0;0;0;.00nan;0;0
39661;-1;426;0;0;0;0;.00nan;0;0
39661;-1;426;82;30;1;29;.967;3600000;0
39661;192627;413;68;40;4;36;.900;3600000;0
39663;-1;428;78;44;4;40;.909;3600000;0
39663;184336;429;86;27;1;26;.963;3600000;0
39663;-1;429;0;0;0;0;.00nan;0;0
39663;191702;428;0;0;0;0;.00nan;0;0
39665;-1;439;0;0;0;0;.00nan;0;0
39665;202193;439;60;26;3;23;.885;3556000;0
39665;191171;431;72;26;2;24;.923;3600000;0
39665;-1;431;0;0;0;0;.00nan;0;0
39667;200179;420;59;32;4;28;.875;3600000;0
39667;179127;422;70;19;1;18;.947;3600000;0
39667;180578;422;0;0;0;0;.00nan;0;0
39667;186076;420;0;0;0;0;.00nan;0;0
39669;171877;423;0;0;0;0;.00nan;0;0
39669;188965;423;58;30;3;27;.900;3600000;0
39669;170499;427;93;20;0;20;1.000;3600000;0
39669;186468;427;0;0;0;0;.00nan;0;0
39671;194803;443;0;0;0;0;.00nan;0;0
39671;182180;443;70;21;1;20;.952;3600000;0
39671;-1;412;57;27;3;24;.889;3543000;0
39671;-1;412;0;0;0;0;.00nan;0;0
39673;173339;430;0;0;0;0;.00nan;0;0
39673;189783;440;83;25;1;24;.960;3600000;0
39673;175723;440;0;0;0;0;.00nan;0;0
39673;-1;430;52;17;2;15;.882;3543000;0
39675;182475;437;0;0;0;0;.00nan;0;0
39675;184033;411;0;0;0;0;.00nan;0;0
39675;186571;437;55;38;5;33;.868;3600000;0
39675;197699;411;75;22;1;21;.955;3600000;0
39677;168414;444;89;33;1;32;.970;3600000;0
39677;179689;415;74;29;2;27;.931;3561000;0
39677;191812;444;0;0;0;0;.00nan;0;0
39677;191877;415;0;0;0;0;.00nan;0;0
39679;194456;414;42;29;5;24;.828;3569000;0
39679;194650;410;0;0;0;0;.00nan;0;0
39679;184183;410;64;28;4;24;.857;3600000;0
39679;181346;414;0;0;0;0;.00nan;0;0
39681;165023;438;28;18;5;13;.722;3750000;0
39681;178743;435;0;0;0;0;.00nan;0;0
39681;176196;438;0;0;0;0;.00nan;0;0
39681;-1;435;72;43;4;39;.907;3750000;0
39683;171787;4849;0;0;0;0;.00nan;0;0
39683;-1;428;0;0;0;0;.00nan;0;0
39683;196412;4849;53;21;3;18;.857;3645000;0
39683;191702;428;71;27;2;25;.926;3645000;0
39685;183832;436;50;26;4;22;.846;3532000;0
39685;184336;429;64;26;2;24;.923;3600000;0
39685;-1;429;0;0;0;0;.00nan;0;0
39685;191861;436;0;0;0;0;.00nan;0;0
39687;168414;444;58;26;3;23;.885;3600000;0
39687;183885;449;63;34;4;30;.882;3589000;0
39687;-1;449;0;0;0;0;.00nan;0;0
39687;191812;444;0;0;0;0;.00nan;0;0
39689;194650;410;82;37;2;35;.946;4200000;0
39689;184183;410;0;0;0;0;.00nan;0;0
39689;-1;434;0;0;0;0;.00nan;0;0
39689;186671;434;76;31;2;29;.935;4200000;0
39691;194598;418;61;9;0;9;1.000;1242000;0
39691;189288;419;0;0;0;0;.00nan;0;0
39691;196975;419;49;29;4;25;.862;3600000;0
39691;191687;418;25;23;5;18;.783;2303000;0
39693;184033;411;0;0;0;0;.00nan;0;0
39693;170499;427;74;33;3;30;.909;3600000;0
39693;186468;427;0;0;0;0;.00nan;0;0
39693;197699;411;56;43;5;38;.884;3573000;0
39695;190073;413;45;38;5;33;.868;3563000;0
39695;-1;439;77;34;3;31;.912;3600000;0
39695;202193;439;0;0;0;0;.00nan;0;0
39695;192627;413;0;0;0;0;.00nan;0;0
39697;194456;414;63;33;4;29;.879;3600000;0
39697;181346;414;0;0;0;0;.00nan;0;0
39697;191171;431;83;31;1;30;.968;3600000;0
39697;-1;431;0;0;0;0;.00nan;0;0
39699;171877;423;52;4;0;4;1.000;596000;0
39699;188965;423;33;31;6;25;.806;3004000;0
39699;179127;422;76;36;3;33;.917;3600000;0
39699;180578;422;0;0;0;0;.00nan;0;0
39701;178743;435;59;28;4;24;.857;3563000;0
39701;-1;426;58;27;3;24;.889;3600000;0
39701;-1;426;0;0;0;0;.00nan;0;0
39701;-1;435;0;0;0;0;.00nan;0;0
39703;200179;420;0;0;0;0;.00nan;0;0
39703;-1;412;0;0;0;0;.00nan;0;0
39703;186076;420;39;21;4;17;.810;3541000;0
39703;-1;412;77;29;2;27;.931;3600000;0
39705;165023;438;0;0;0;0;.00nan;0;0
39705;194146;432;0;0;0;0;.00nan;0;0
39705;176196;438;87;32;1;31;.969;3600000;0
39705;197030;432;79;37;3;34;.919;3520000;0
39707;200063;442;53;3;0;3;1.000;529000;0
39707;189318;421;0;0;0;0;.00nan;0;0
39707;179169;421;89;29;1;28;.966;3600000;0
39707;190157;442;20;24;6;18;.750;3071000;0
39709;182475;437;0;0;0;0;.00nan;0;0
39709;194803;443;65;23;2;21;.913;3600000;0
39709;182180;443;0;0;0;0;.00nan;0;0
39709;186571;437;39;39;6;33;.846;3600000;0
39711;194854;417;58;39;3;36;.923;4200000;0
39711;178890;417;0;0;0;0;.00nan;0;0
39711;179657;441;56;27;3;24;.889;4200000;0
39711;191713;441;0;0;0;0;.00nan;0;0
39713;173339;430;0;0;0;0;.00nan;0;0
39713;-1;433;98;62;3;59;.952;4200000;0
39713;191212;433;0;0;0;0;.00nan;0;0
39713;-1;430;61;34;3;31;.912;4200000;0
39715;163177;425;0;0;0;0;.00nan;0;0
39715;189783;440;51;28;4;24;.857;3634000;0
39715;175723;440;0;0;0;0;.00nan;0;0
39715;-1;425;32;24;5;19;.792;3634000;0
39717;-1;428;68;17;1;16;.941;3600000;0
39717;191171;431;0;0;0;0;.00nan;0;0
39717;191702;428;0;0;0;0;.00nan;0;0
39717;-1;431;78;39;3;36;.923;3569000;0
39719;165023;438;93;32;1;31;.969;3600000;0
39719;194456;414;0;0;0;0;.00nan;0;0
39719;176196;438;0;0;0;0;.00nan;0;0
39719;181346;414;64;25;2;23;.920;3572000;0
39721;194146;432;23;31;7;24;.774;2999000;0
39721;194598;418;72;27;3;24;.889;3600000;0
39721;197030;432;60;7;0;7;1.000;601000;0
39721;191687;418;0;0;0;0;.00nan;0;0
39723;179127;422;46;11;2;9;.818;1112000;0
39723;-1;434;42;18;4;14;.778;3600000;0
39723;180578;422;27;27;6;21;.778;2488000;0
39723;186671;434;0;0;0;0;.00nan;0;0
39725;183832;436;0;0;0;0;.00nan;0;0
39725;190073;413;0;0;0;0;.00nan;0;0
39725;191861;436;76;24;2;22;.917;3600000;0
39725;192627;413;56;24;3;21;.875;3543000;0
39727;189318;421;66;28;2;26;.929;3545000;0
39727;179169;421;0;0;0;0;.00nan;0;0
39727;179657;441;0;0;0;0;.00nan;0;0
39727;191713;441;96;25;0;25;1.000;3600000;0
39729;178743;435;0;0;0;0;.00nan;0;0
39729;170499;427;0;0;0;0;.00nan;0;0
39729;186468;427;44;24;4;20;.833;3600000;0
39729;-1;435;99;29;1;28;.966;3600000;0
39731;168414;444;0;0;0;0;.00nan;0;0
39731;179689;415;52;37;4;33;.892;3556000;0
39731;191812;444;70;34;3;31;.912;3600000;0
39731;191877;415;0;0;0;0;.00nan;0;0
39733;200063;442;64;24;3;21;.875;3658000;0
39733;190157;442;0;0;0;0;.00nan;0;0
39733;-1;412;48;29;4;25;.862;3658000;0
39733;-1;412;0;0;0;0;.00nan;0;0
39735;163177;425;49;22;3;19;.864;3543000;0
39735;184033;411;76;32;2;30;.938;3600000;0
39735;-1;425;0;0;0;0;.00nan;0;0
39735;197699;411;0;0;0;0;.00nan;0;0
39737;194803;443;0;0;0;0;.00nan;0;0
39737;182180;443;44;29;5;24;.828;3600000;0
39737;-1;433;0;0;0;0;.00nan;0;0
39737;191212;433;62;27;2;25;.926;3600000;0
39739;194650;410;0;0;0;0;.00nan;0;0
39739;184183;410;61;29;3;26;.897;3600000;0
39739;184336;429;0;0;0;0;.00nan;0;0
39739;-1;429;45;24;4;20;.833;3600000;0
39741;200179;420;80;38;3;35;.921;3600000;0
39741;186076;420;0;0;0;0;.00nan;0;0
39741;-1;426;0;0;0;0;.00nan;0;0
39741;-1;426;94;22;0;22;1.000;3600000;0
39743;171787;4849;39;36;6;30;.833;3600000;0
39743;194854;417;0;0;0;0;.00nan;0;0
39743;178890;417;80;40;3;37;.925;3600000;0
39743;196412;4849;0;0;0;0;.00nan;0;0
39745;173339;430;79;31;1;30;.968;3600000;0
39745;189783;440;0;0;0;0;.00nan;0;0
39745;175723;440;85;36;2;34;.944;3561000;0
39745;-1;430;0;0;0;0;.00nan;0;0
39747;171877;423;71;39;4;35;.897;3600000;0
39747;188965;423;0;0;0;0;.00nan;0;0
39747;-1;439;0;0;0;0;.00nan;0;0
39747;202193;439;49;21;3;18;.857;3600000;0
39749;182475;437;82;32;2;30;.938;3600000;0
39749;189288;419;65;33;3;30;.909;3573000;0
39749;186571;437;0;0;0;0;.00nan;0;0
39749;196975;419;0;0;0;0;.00nan;0;0
39751;168414;444;56;29;3;26;.897;3545000;0
39751;-1;412;73;25;1;24;.960;3600000;0
39751;191812;444;0;0;0;0;.00nan;0;0
39751;-1;412;0;0;0;0;.00nan;0;0
39753;182475;437;0;0;0;0;.00nan;0;0
39753;184033;411;0;0;0;0;.00nan;0;0
39753;186571;437;39;40;6;34;.850;3600000;0
39753;197699;411;87;31;1;30;.968;3600000;0
39755;194598;418;0;0;0;0;.00nan;0;0
39755;190073;413;56;36;5;31;.861;3600000;0
39755;191687;418;56;19;2;17;.895;3600000;0
39755;192627;413;0;0;0;0;.00nan;0;0
39757;194456;414;67;32;3;29;.906;3600000;0
39757;181346;414;0;0;0;0;.00nan;0;0
39757;191171;431;57;17;2;15;.882;3600000;0
39757;-1;431;0;0;0;0;.00nan;0;0
39759;200179;420;60;40;5;35;.875;3600000;0
39759;194650;410;0;0;0;0;.00nan;0;0
39759;184183;410;99;39;2;37;.949;3600000;0
39759;186076;420;0;0;0;0;.00nan;0;0
39761;-1;439;41;25;4;21;.840;3527000;0
39761;202193;439;0;0;0;0;.00nan;0;0
39761;-1;426;0;0;0;0;.00nan;0;0
39761;-1;426;92;37;2;35;.946;3600000;0
39763;171787;4849;0;0;0;0;.00nan;0;0
39763;171877;423;0;0;0;0;.00nan;0;0
39763;188965;423;74;22;1;21;.955;3600000;0
39763;196412;4849;60;32;4;28;.875;3600000;0
39765;189288;419;0;0;0;0;.00nan;0;0
39765;179127;422;56;34;4;30;.882;3581000;0
39765;180578;422;0;0;0;0;.00nan;0;0
39765;196975;419;73;29;2;27;.931;3600000;0
39767;183885;449;77;42;4;38;.905;3554000;0
39767;-1;449;0;0;0;0;.00nan;0;0
39767;179689;415;54;21;3;18;.857;3600000;0
39767;191877;415;0;0;0;0;.00nan;0;0
39769;194803;443;81;23;1;22;.957;3600000;0
39769;170499;427;28;29;6;23;.793;2679000;0
39769;182180;443;0;0;0;0;.00nan;0;0
39769;186468;427;49;1;0;1;1.000;921000;0
39771;200063;442;0;0;0;0;.00nan;0;0
39771;184336;429;94;38;1;37;.974;3600000;0
39771;190157;442;62;23;2;21;.913;3548000;0
39771;-1;429;0;0;0;0;.00nan;0;0
39773;165023;438;0;0;0;0;.00nan;0;0
39773;176196;438;70;26;2;24;.923;3570000;0
39773;-1;434;0;0;0;0;.00nan;0;0
39773;186671;434;77;11;0;11;1.000;3600000;0
39775;163177;425;0;0;0;0;.00nan;0;0
39775;178743;435;91;30;1;29;.967;3600000;0
39775;-1;425;59;30;3;27;.900;3526000;0
39775;-1;435;0;0;0;0;.00nan;0;0
39777;183832;436;83;36;3;33;.917;3551000;0
39777;-1;428;88;30;1;29;.967;3600000;0
39777;191702;428;0;0;0;0;.00nan;0;0
39777;191861;436;0;0;0;0;.00nan;0;0
39779;194854;417;63;32;3;29;.906;3550000;0
39779;178890;417;0;0;0;0;.00nan;0;0
39779;-1;433;67;28;2;26;.929;3600000;0
39779;191212;433;0;0;0;0;.00nan;0;0
39781;173339;430;0;0;0;0;.00nan;0;0
39781;189318;421;80;23;1;22;.957;3600000;0
39781;179169;421;0;0;0;0;.00nan;0;0
39781;-1;430;58;25;3;22;.880;3564000;0
39783;189783;440;72;31;2;29;.935;3600000;0
39783;175723;440;0;0;0;0;.00nan;0;0
39783;179657;441;0;0;0;0;.00nan;0;0
39783;191713;441;66;28;3;25;.893;3564000;0
39784;4219;880;68;52;4;48;.923;3578000;0
39784;164710;957;0;0;0;0;.00nan;0;0
39784;147492;880;0;0;0;0;.00nan;0;0
39784;154414;957;55;16;2;14;.875;3600000;0
39785;28701;966;0;0;0;0;.00nan;0;0
39785;-1;975;80;59;7;52;.881;3600000;0
39785;146591;975;0;0;0;0;.00nan;0;0
39785;147567;966;86;13;0;13;1.000;3600000;0
39786;196055;945;0;0;0;0;.00nan;0;0
39786;82245;872;0;0;0;0;.00nan;0;0
39786;90734;872;47;23;4;19;.826;3600000;0
39786;146479;945;100;37;0;37;1.000;3600000;0
39787;7037;894;0;0;0;0;.00nan;0;0
39787;11670;885;65;23;3;20;.870;3600000;0
39787;146445;894;47;30;5;25;.833;3596000;0
39787;151940;885;0;0;0;0;.00nan;0;0
39788;80596;3965;90;26;1;25;.962;1215000;0
39788;80834;897;71;19;1;18;.947;3600000;0
39788;149353;3965;66;44;6;38;.864;2385000;0
39788;159705;897;0;0;0;0;.00nan;0;0
39789;9858;978;98;42;1;41;.976;3600000;0
39789;71075;890;0;0;0;0;.00nan;0;0
39789;146386;890;60;28;3;25;.893;3552000;0
39789;161255;978;0;0;0;0;.00nan;0;0
39790;83678;879;47;20;3;17;.850;3511000;0
39790;147255;891;83;23;1;22;.957;3600000;0
39790;157295;879;0;0;0;0;.00nan;0;0
39790;160932;891;0;0;0;0;.00nan;0;0
39791;4219;880;0;0;0;0;.00nan;0;0
39791;83678;879;66;26;3;23;.885;3900000;0
39791;147492;880;92;47;3;44;.936;3900000;0
39791;157295;879;0;0;0;0;.00nan;0;0
39792;164715;966;0;0;0;0;.00nan;0;0
39792;11670;885;50;26;4;22;.846;3806000;0
39792;147567;966;48;21;3;18;.857;3806000;0
39792;151940;885;0;0;0;0;.00nan;0;0
39793;71075;890;48;17;3;14;.824;3600000;0
39793;80596;3965;0;0;0;0;.00nan;0;0
39793;146386;890;0;0;0;0;.00nan;0;0
39793;149353;3965;88;52;5;47;.904;3600000;0
39794;7037;894;0;0;0;0;.00nan;0;0
39794;82245;872;0;0;0;0;.00nan;0;0
39794;90734;872;83;24;1;23;.958;3900000;0
39794;146445;894;97;45;1;44;.978;3900000;0
39795;196055;945;54;21;3;18;.857;3600000;0
39795;-1;975;31;36;7;29;.806;2656000;0
39795;86686;975;53;25;3;22;.880;944000;0
39795;146479;945;0;0;0;0;.00nan;0;0
39796;164710;957;100;27;0;27;1.000;3600000;0
39796;80834;897;58;30;3;27;.900;3600000;0
39796;154414;957;0;0;0;0;.00nan;0;0
39796;159705;897;0;0;0;0;.00nan;0;0
39797;9858;978;0;0;0;0;.00nan;0;0
39797;147255;891;70;18;1;17;.944;3600000;0
39797;160932;891;0;0;0;0;.00nan;0;0
39797;161255;978;69;47;5;42;.894;3600000;0
39798;164715;966;0;0;0;0;.00nan;0;0
39798;80596;3965;0;0;0;0;.00nan;0;0
39798;147567;966;58;18;2;16;.889;3627000;0
39798;149353;3965;85;42;3;39;.929;3627000;0
39799;164710;957;99;33;1;32;.970;3600000;0
39799;82245;872;0;0;0;0;.00nan;0;0
39799;90734;872;48;25;3;22;.880;3516000;0
39799;154414;957;0;0;0;0;.00nan;0;0
39800;9858;978;0;0;0;0;.00nan;0;0
39800;83678;879;0;0;0;0;.00nan;0;0
39800;157295;879;53;23;3;20;.870;3600000;0
39800;161255;978;74;47;5;42;.894;3576000;0
39801;7037;894;0;0;0;0;.00nan;0;0
39801;-1;975;0;0;0;0;.00nan;0;0
39801;86686;975;98;48;3;45;.938;3600000;0
39801;146445;894;54;9;1;8;.889;3600000;0
39802;196055;945;15;21;6;15;.714;2263000;0
39802;80834;897;0;0;0;0;.00nan;0;0
39802;146479;945;72;15;1;14;.933;1337000;0
39802;159705;897;75;25;2;23;.920;3600000;0
39803;11670;885;34;26;6;20;.769;3094000;0
39803;147255;891;48;18;3;15;.833;2363000;0
39803;151940;885;59;7;0;7;1.000;506000;0
39803;160932;891;19;17;5;12;.706;1162000;0
39804;4219;880;0;0;0;0;.00nan;0;0
39804;71075;890;35;21;4;17;.810;3560000;0
39804;146386;890;0;0;0;0;.00nan;0;0
39804;147492;880;73;34;3;31;.912;3600000;0
39805;9858;978;0;0;0;0;.00nan;0;0
39805;83678;879;78;27;2;25;.926;3588000;0
39805;157295;879;0;0;0;0;.00nan;0;0
39805;161255;978;84;32;1;31;.969;3600000;0
39806;7037;894;0;0;0;0;.00nan;0;0
39806;-1;975;0;0;0;0;.00nan;0;0
39806;86686;975;91;57;5;52;.912;3600000;0
39806;146445;894;54;16;2;14;.875;3600000;0
39807;9858;978;0;0;0;0;.00nan;0;0
39807;-1;975;0;0;0;0;.00nan;0;0
39807;86686;975;84;28;1;27;.964;3547000;0
39807;161255;978;89;20;0;20;1.000;3600000;0
39808;196055;945;59;19;2;17;.895;3537000;0
39808;80596;3965;0;0;0;0;.00nan;0;0
39808;146479;945;0;0;0;0;.00nan;0;0
39808;149353;3965;100;33;0;33;1.000;3600000;0
39809;82245;872;0;0;0;0;.00nan;0;0
39809;90734;872;85;37;3;34;.919;3600000;0
39809;147255;891;55;42;5;37;.881;3600000;0
39809;160932;891;0;0;0;0;.00nan;0;0
39810;164715;966;0;0;0;0;.00nan;0;0
39810;71075;890;34;28;5;23;.821;3600000;0
39810;146386;890;0;0;0;0;.00nan;0;0
39810;147567;966;68;27;2;25;.926;3600000;0
39811;4219;880;0;0;0;0;.00nan;0;0
39811;7037;894;0;0;0;0;.00nan;0;0
39811;146445;894;69;24;2;22;.917;3600000;0
39811;147492;880;69;36;3;33;.917;3591000;0
39812;80834;897;56;21;3;18;.857;3600000;0
39812;83678;879;0;0;0;0;.00nan;0;0
39812;157295;879;63;35;4;31;.886;3544000;0
39812;159705;897;0;0;0;0;.00nan;0;0
39813;4219;880;77;22;1;21;.955;3550000;0
39813;11670;885;100;30;0;30;1.000;3600000;0
39813;147492;880;0;0;0;0;.00nan;0;0
39813;151940;885;0;0;0;0;.00nan;0;0
39814;7037;894;0;0;0;0;.00nan;0;0
39814;164715;966;0;0;0;0;.00nan;0;0
39814;146445;894;98;54;4;50;.926;3600000;0
39814;147567;966;100;19;0;19;1.000;3600000;0
39815;80596;3965;0;0;0;0;.00nan;0;0
39815;83678;879;84;21;1;20;.952;3600000;0
39815;149353;3965;77;40;4;36;.900;3600000;0
39815;157295;879;0;0;0;0;.00nan;0;0
39816;80834;897;0;0;0;0;.00nan;0;0
39816;82245;872;53;36;5;31;.861;3600000;0
39816;90734;872;0;0;0;0;.00nan;0;0
39816;159705;897;56;32;4;28;.875;3600000;0
39817;-1;975;0;0;0;0;.00nan;0;0
39817;86686;975;89;55;3;52;.945;3547000;0
39817;147255;891;0;0;0;0;.00nan;0;0
39817;160932;891;83;24;1;23;.958;3600000;0
39818;196055;945;0;0;0;0;.00nan;0;0
39818;71075;890;0;0;0;0;.00nan;0;0
39818;146386;890;86;22;1;21;.955;3692000;0
39818;146479;945;97;30;0;30;1.000;3692000;0
39819;9858;978;0;0;0;0;.00nan;0;0
39819;164710;957;77;12;0;12;1.000;3600000;0
39819;154414;957;0;0;0;0;.00nan;0;0
39819;161255;978;70;61;8;53;.869;3600000;0
39820;7037;894;0;0;0;0;.00nan;0;0
39820;196055;945;66;28;3;25;.893;3762000;0
39820;146445;894;82;35;2;33;.943;3792000;0
39820;146479;945;0;0;0;0;.00nan;0;0
39821;4219;880;0;0;0;0;.00nan;0;0
39821;80596;3965;0;0;0;0;.00nan;0;0
39821;147492;880;81;30;1;29;.967;3580000;0
39821;149353;3965;100;36;0;36;1.000;3600000;0
39822;164710;957;100;24;0;24;1.000;3600000;0
39822;164715;966;0;0;0;0;.00nan;0;0
39822;147567;966;76;31;2;29;.935;3598000;0
39822;154414;957;0;0;0;0;.00nan;0;0
39823;80834;897;35;20;4;16;.800;3568000;0
39823;147255;891;78;34;3;31;.912;3600000;0
39823;159705;897;0;0;0;0;.00nan;0;0
39823;160932;891;0;0;0;0;.00nan;0;0
39824;-1;975;76;17;0;17;1.000;1281000;0
39824;71075;890;35;19;4;15;.789;3600000;0
39824;86686;975;40;39;6;33;.846;2259000;0
39824;146386;890;0;0;0;0;.00nan;0;0
39825;11670;885;94;19;0;19;1.000;3900000;0
39825;83678;879;95;26;0;26;1.000;3900000;0
39825;151940;885;0;0;0;0;.00nan;0;0
39825;157295;879;0;0;0;0;.00nan;0;0
39826;9858;978;54;7;0;7;1.000;335000;0
39826;82245;872;0;0;0;0;.00nan;0;0
39826;90734;872;54;24;3;21;.875;3600000;0
39826;161255;978;35;40;7;33;.825;3265000;0
39827;9858;978;0;0;0;0;.00nan;0;0
39827;164715;966;0;0;0;0;.00nan;0;0
39827;147567;966;71;13;1;12;.923;3900000;0
39827;161255;978;79;39;1;38;.974;3900000;0
39828;71075;890;0;0;0;0;.00nan;0;0
39828;83678;879;44;25;4;21;.840;3600000;0
39828;146386;890;79;27;1;26;.963;3600000;0
39828;157295;879;0;0;0;0;.00nan;0;0
39829;80596;3965;0;0;0;0;.00nan;0;0
39829;82245;872;0;0;0;0;.00nan;0;0
39829;90734;872;65;30;3;27;.900;3855000;0
39829;149353;3965;68;40;4;36;.900;3855000;0
39830;7037;894;81;43;4;39;.907;3600000;0
39830;164710;957;79;27;1;26;.963;3600000;0
39830;146445;894;0;0;0;0;.00nan;0;0
39830;154414;957;0;0;0;0;.00nan;0;0
39831;11670;885;68;20;1;19;.950;3600000;0
39831;-1;975;0;0;0;0;.00nan;0;0
39831;86686;975;94;58;3;55;.948;3534000;0
39831;151940;885;0;0;0;0;.00nan;0;0
39832;4219;880;68;40;4;36;.900;3516000;0
39832;80834;897;0;0;0;0;.00nan;0;0
39832;147492;880;0;0;0;0;.00nan;0;0
39832;159705;897;99;45;2;43;.956;3600000;0
39833;196055;945;0;0;0;0;.00nan;0;0
39833;146479;945;65;40;4;36;.900;3900000;0
39833;147255;891;39;20;4;16;.800;3900000;0
39833;160932;891;0;0;0;0;.00nan;0;0
39834;164710;957;44;27;5;22;.815;3600000;0
39834;11670;885;57;27;4;23;.852;3600000;0
39834;151940;885;0;0;0;0;.00nan;0;0
39834;154414;957;0;0;0;0;.00nan;0;0
39835;4219;880;0;0;0;0;.00nan;0;0
39835;164715;966;0;0;0;0;.00nan;0;0
39835;147492;880;84;31;1;30;.968;3600000;0
39835;147567;966;32;30;6;24;.800;3600000;0
39836;164710;957;94;26;0;26;1.000;3600000;0
39836;147255;891;0;0;0;0;.00nan;0;0
39836;154414;957;0;0;0;0;.00nan;0;0
39836;160932;891;77;28;1;27;.964;3600000;0
39837;7037;894;0;0;0;0;.00nan;0;0
39837;83678;879;0;0;0;0;.00nan;0;0
39837;146445;894;83;40;3;37;.925;3527000;0
39837;157295;879;89;29;1;28;.966;3600000;0
39838;71075;890;99;24;0;24;1.000;3600000;0
39838;82245;872;0;0;0;0;.00nan;0;0
39838;90734;872;44;19;3;16;.842;3600000;0
39838;146386;890;0;0;0;0;.00nan;0;0
39839;-1;975;0;0;0;0;.00nan;0;0
39839;80596;3965;0;0;0;0;.00nan;0;0
39839;86686;975;82;29;1;28;.966;3600000;0
39839;149353;3965;76;29;2;27;.931;3576000;0
39840;11670;885;86;35;2;33;.943;3879000;0
39840;196055;945;76;28;2;26;.929;3900000;0
39840;146479;945;0;0;0;0;.00nan;0;0
39840;151940;885;0;0;0;0;.00nan;0;0
39841;9858;978;0;0;0;0;.00nan;0;0
39841;80834;897;49;14;2;12;.857;3600000;0
39841;159705;897;0;0;0;0;.00nan;0;0
39841;161255;978;54;41;5;36;.878;3600000;0
39842;4219;880;84;49;4;45;.918;3600000;0
39842;82245;872;0;0;0;0;.00nan;0;0
39842;90734;872;78;12;0;12;1.000;3600000;0
39842;147492;880;0;0;0;0;.00nan;0;0
39843;7037;894;0;0;0;0;.00nan;0;0
39843;80596;3965;0;0;0;0;.00nan;0;0
39843;146445;894;100;34;0;34;1.000;3600000;0
39843;149353;3965;44;34;5;29;.853;3600000;0
39844;164715;966;0;0;0;0;.00nan;0;0
39844;83678;879;99;40;1;39;.975;3600000;0
39844;147567;966;67;32;3;29;.906;3547000;0
39844;157295;879;0;0;0;0;.00nan;0;0
39845;164710;957;45;21;3;18;.857;3600000;0
39845;-1;975;0;0;0;0;.00nan;0;0
39845;86686;975;91;57;4;53;.930;3600000;0
39845;154414;957;0;0;0;0;.00nan;0;0
39846;11670;885;43;39;6;33;.846;3600000;0
39846;80834;897;0;0;0;0;.00nan;0;0
39846;151940;885;0;0;0;0;.00nan;0;0
39846;159705;897;97;27;1;26;.963;3600000;0
39847;9858;978;0;0;0;0;.00nan;0;0
39847;196055;945;0;0;0;0;.00nan;0;0
39847;146479;945;87;36;2;34;.944;3555000;0
39847;161255;978;86;32;1;31;.969;3600000;0
39848;71075;890;37;16;4;12;.750;3823000;0
39848;146386;890;0;0;0;0;.00nan;0;0
39848;147255;891;0;0;0;0;.00nan;0;0
39848;160932;891;70;37;3;34;.919;3823000;0
39849;11670;885;97;43;2;41;.953;3556000;0
39849;82245;872;0;0;0;0;.00nan;0;0
39849;90734;872;91;27;1;26;.963;3600000;0
39849;151940;885;0;0;0;0;.00nan;0;0
39850;11670;885;66;28;3;25;.893;3556000;0
39850;82245;872;0;0;0;0;.00nan;0;0
39850;90734;872;60;18;2;16;.889;3600000;0
39850;151940;885;0;0;0;0;.00nan;0;0
39851;9858;978;0;0;0;0;.00nan;0;0
39851;80596;3965;0;0;0;0;.00nan;0;0
39851;149353;3965;97;40;2;38;.950;3555000;0
39851;161255;978;100;25;0;25;1.000;3600000;0
39852;164715;966;0;0;0;0;.00nan;0;0
39852;196055;945;69;47;5;42;.894;3600000;0
39852;146479;945;0;0;0;0;.00nan;0;0
39852;147567;966;92;18;0;18;1.000;3600000;0
39853;4219;880;0;0;0;0;.00nan;0;0
39853;147255;891;99;36;1;35;.972;3600000;0
39853;147492;880;20;27;6;21;.778;3600000;0
39853;160932;891;0;0;0;0;.00nan;0;0
39854;-1;975;0;0;0;0;.00nan;0;0
39854;83678;879;77;12;0;12;1.000;3600000;0
39854;86686;975;92;55;3;52;.945;3600000;0
39854;157295;879;0;0;0;0;.00nan;0;0
39855;164710;957;60;25;2;23;.920;3900000;0
39855;71075;890;0;0;0;0;.00nan;0;0
39855;146386;890;73;27;2;25;.926;3900000;0
39855;154414;957;0;0;0;0;.00nan;0;0
39856;7037;894;0;0;0;0;.00nan;0;0
39856;80834;897;53;15;2;13;.867;3600000;0
39856;146445;894;72;35;3;32;.914;3596000;0
39856;159705;897;0;0;0;0;.00nan;0;0
39857;4219;880;0;0;0;0;.00nan;0;0
39857;196055;945;0;0;0;0;.00nan;0;0
39857;146479;945;52;24;3;21;.875;3600000;0
39857;147492;880;62;34;4;30;.882;3574000;0
39858;80596;3965;64;6;0;6;1.000;735000;0
39858;147255;891;0;0;0;0;.00nan;0;0
39858;149353;3965;34;33;6;27;.818;2865000;0
39858;160932;891;59;21;2;19;.905;3600000;0
39859;8487;885;0;0;0;0;.00nan;0;0
39859;11670;885;71;28;2;26;.929;3600000;0
39859;71075;890;37;19;4;15;.789;1145000;0
39859;146386;890;37;14;3;11;.786;2455000;0
39860;164715;966;0;0;0;0;.00nan;0;0
39860;80834;897;0;0;0;0;.00nan;0;0
39860;147567;966;82;28;1;27;.964;3600000;0
39860;159705;897;57;20;2;18;.900;3546000;0
39861;7037;894;0;0;0;0;.00nan;0;0
39861;9858;978;0;0;0;0;.00nan;0;0
39861;146445;894;82;32;4;28;.875;3600000;0
39861;161255;978;100;43;1;42;.977;3600000;0
39862;164710;957;0;0;0;0;.00nan;0;0
39862;83678;879;99;38;1;37;.974;3858000;0
39862;154414;957;63;23;2;21;.913;3858000;0
39862;157295;879;0;0;0;0;.00nan;0;0
39863;7624;975;0;0;0;0;.00nan;0;0
39863;82245;872;0;0;0;0;.00nan;0;0
39863;86686;975;92;50;3;47;.940;3600000;0
39863;90734;872;100;22;0;22;1.000;3600000;0
39864;4219;880;70;29;2;27;.931;3600000;0
39864;9858;978;0;0;0;0;.00nan;0;0
39864;147492;880;0;0;0;0;.00nan;0;0
39864;161255;978;80;36;3;33;.917;3563000;0
39865;8487;885;0;0;0;0;.00nan;0;0
39865;11670;885;61;17;2;15;.882;3600000;0
39865;80596;3965;0;0;0;0;.00nan;0;0
39865;149353;3965;93;58;5;53;.914;3600000;0
39866;164715;966;0;0;0;0;.00nan;0;0
39866;147255;891;42;27;5;22;.815;3096000;0
39866;147567;966;83;10;0;10;1.000;3600000;0
39866;160932;891;57;6;0;6;1.000;504000;0
39867;82245;872;0;0;0;0;.00nan;0;0
39867;83678;879;100;32;0;32;1.000;3600000;0
39867;90734;872;50;27;4;23;.852;3600000;0
39867;157295;879;0;0;0;0;.00nan;0;0
39868;7037;894;0;0;0;0;.00nan;0;0
39868;71075;890;0;0;0;0;.00nan;0;0
39868;146386;890;81;34;2;32;.941;3600000;0
39868;146445;894;71;34;4;30;.882;3567000;0
39869;164710;957;90;19;0;19;1.000;3600000;0
39869;196055;945;0;0;0;0;.00nan;0;0
39869;146479;945;77;42;4;38;.905;3600000;0
39869;154414;957;0;0;0;0;.00nan;0;0
39870;7624;975;0;0;0;0;.00nan;0;0
39870;80834;897;60;15;1;14;.933;3600000;0
39870;86686;975;88;53;3;50;.943;3538000;0
39870;159705;897;0;0;0;0;.00nan;0;0
39871;164710;957;62;14;1;13;.929;3578000;0
39871;80596;3965;0;0;0;0;.00nan;0;0
39871;149353;3965;100;33;0;33;1.000;3600000;0
39871;154414;957;0;0;0;0;.00nan;0;0
39872;7037;894;0;0;0;0;.00nan;0;0
39872;146445;894;65;31;3;28;.903;3540000;0
39872;147255;891;0;0;0;0;.00nan;0;0
39872;160932;891;85;24;1;23;.958;3600000;0
39873;196055;945;52;5;0;5;1.000;431000;0
39873;83678;879;82;12;0;12;1.000;3600000;0
39873;146479;945;35;31;6;25;.806;3169000;0
39873;157295;879;0;0;0;0;.00nan;0;0
39874;71075;890;0;0;0;0;.00nan;0;0
39874;80834;897;0;0;0;0;.00nan;0;0
39874;146386;890;99;42;1;41;.976;3600000;0
39874;159705;897;59;27;4;23;.852;3600000;0
39875;164715;966;0;0;0;0;.00nan;0;0
39875;82245;872;0;0;0;0;.00nan;0;0
39875;90734;872;45;35;6;29;.829;3600000;0
39875;147567;966;83;23;1;22;.957;3600000;0
39876;4219;880;57;24;3;21;.875;3600000;0
39876;7624;975;0;0;0;0;.00nan;0;0
39876;86686;975;95;57;4;53;.930;3600000;0
39876;147492;880;0;0;0;0;.00nan;0;0
39877;8487;885;0;0;0;0;.00nan;0;0
39877;9858;978;0;0;0;0;.00nan;0;0
39877;11670;885;60;25;3;22;.880;3600000;0
39877;161255;978;76;24;2;22;.917;3600000;0
39878;164710;957;63;25;3;22;.880;3515000;0
39878;82245;872;65;19;1;18;.947;3600000;0
39878;90734;872;0;0;0;0;.00nan;0;0
39878;154414;957;0;0;0;0;.00nan;0;0
39879;4219;880;0;0;0;0;.00nan;0;0
39879;80834;897;73;24;1;23;.958;3600000;0
39879;147492;880;63;49;5;44;.898;3600000;0
39879;159705;897;0;0;0;0;.00nan;0;0
39880;8487;885;0;0;0;0;.00nan;0;0
39880;164715;966;0;0;0;0;.00nan;0;0
39880;11670;885;54;28;4;24;.857;3600000;0
39880;147567;966;89;30;1;29;.967;3600000;0
39881;9858;978;0;0;0;0;.00nan;0;0
39881;71075;890;62;20;2;18;.900;3600000;0
39881;146386;890;0;0;0;0;.00nan;0;0
39881;161255;978;69;39;4;35;.897;3550000;0
39882;7037;894;97;22;0;22;1.000;3600000;0
39882;83678;879;53;27;4;23;.852;3600000;0
39882;146445;894;0;0;0;0;.00nan;0;0
39882;157295;879;0;0;0;0;.00nan;0;0
39883;7624;975;0;0;0;0;.00nan;0;0
39883;196055;945;0;0;0;0;.00nan;0;0
39883;86686;975;75;53;6;47;.887;3600000;0
39883;146479;945;69;18;1;17;.944;3600000;0
39884;8487;885;0;0;0;0;.00nan;0;0
39884;11670;885;87;26;1;25;.962;3600000;0
39884;147255;891;71;25;2;23;.920;3588000;0
39884;160932;891;0;0;0;0;.00nan;0;0
39885;9858;978;0;0;0;0;.00nan;0;0
39885;83678;879;50;16;2;14;.875;3600000;0
39885;157295;879;0;0;0;0;.00nan;0;0
39885;161255;978;69;45;5;40;.889;3600000;0
39886;4219;880;78;10;0;10;1.000;3600000;0
39886;80596;3965;0;0;0;0;.00nan;0;0
39886;147492;880;0;0;0;0;.00nan;0;0
39886;149353;3965;89;37;2;35;.946;3587000;0
39887;164715;966;0;0;0;0;.00nan;0;0
39887;80834;897;0;0;0;0;.00nan;0;0
39887;147567;966;45;30;6;24;.800;3600000;0
39887;159705;897;67;32;3;29;.906;3600000;0
39888;164715;966;0;0;0;0;.00nan;0;0
39888;82245;872;0;0;0;0;.00nan;0;0
39888;90734;872;51;36;5;31;.861;3600000;0
39888;147567;966;63;20;2;18;.900;3600000;0
39889;8487;885;0;0;0;0;.00nan;0;0
39889;164710;957;91;15;0;15;1.000;3600000;0
39889;11670;885;64;36;4;32;.889;3600000;0
39889;154414;957;0;0;0;0;.00nan;0;0
39890;83678;879;0;0;0;0;.00nan;0;0
39890;147255;891;0;0;0;0;.00nan;0;0
39890;157295;879;66;18;1;17;.944;3600000;0
39890;160932;891;76;30;2;28;.933;3600000;0
39891;7037;894;80;13;0;13;1.000;3600000;0
39891;7624;975;76;47;4;43;.915;3600000;0
39891;86686;975;0;0;0;0;.00nan;0;0
39891;146445;894;0;0;0;0;.00nan;0;0
39892;9858;978;0;0;0;0;.00nan;0;0
39892;196055;945;0;0;0;0;.00nan;0;0
39892;146479;945;70;27;1;26;.963;3600000;0
39892;161255;978;67;34;3;31;.912;3527000;0
39893;71075;890;0;0;0;0;.00nan;0;0
39893;80834;897;44;18;3;15;.833;3560000;0
39893;146386;890;76;36;2;34;.944;3600000;0
39893;159705;897;0;0;0;0;.00nan;0;0
39894;80596;3965;78;57;5;52;.912;3600000;0
39894;80834;897;0;0;0;0;.00nan;0;0
39894;149353;3965;0;0;0;0;.00nan;0;0
39894;159705;897;91;15;0;15;1.000;3600000;0
39895;4219;880;0;0;0;0;.00nan;0;0
39895;71075;890;0;0;0;0;.00nan;0;0
39895;146386;890;76;29;2;27;.931;3900000;0
39895;147492;880;79;30;2;28;.933;3900000;0
39896;82245;872;0;0;0;0;.00nan;0;0
39896;83678;879;80;39;3;36;.923;3568000;0
39896;90734;872;67;21;2;19;.905;3600000;0
39896;157295;879;0;0;0;0;.00nan;0;0
39897;7037;894;76;27;2;25;.926;3600000;0
39897;164715;966;0;0;0;0;.00nan;0;0
39897;146445;894;0;0;0;0;.00nan;0;0
39897;147567;966;50;26;3;23;.885;3588000;0
39898;8487;885;0;0;0;0;.00nan;0;0
39898;11670;885;59;23;2;21;.913;3900000;0
39898;196055;945;0;0;0;0;.00nan;0;0
39898;146479;945;95;38;2;36;.947;3900000;0
39899;9858;978;0;0;0;0;.00nan;0;0
39899;164710;957;56;17;2;15;.882;3600000;0
39899;154414;957;0;0;0;0;.00nan;0;0
39899;161255;978;95;35;1;34;.971;3600000;0
39900;8487;885;100;25;0;25;1.000;3600000;0
39900;11670;885;0;0;0;0;.00nan;0;0
39900;196055;945;82;45;3;42;.933;3600000;0
39900;146479;945;0;0;0;0;.00nan;0;0
39901;164715;966;0;0;0;0;.00nan;0;0
39901;83678;879;54;23;3;20;.870;3600000;0
39901;147567;966;57;35;4;31;.886;3563000;0
39901;157295;879;0;0;0;0;.00nan;0;0
39902;7624;975;0;0;0;0;.00nan;0;0
39902;9858;978;0;0;0;0;.00nan;0;0
39902;86686;975;78;35;3;32;.914;3846000;0
39902;161255;978;59;21;2;19;.905;3846000;0
39903;71075;890;0;0;0;0;.00nan;0;0
39903;80596;3965;0;0;0;0;.00nan;0;0
39903;146386;890;83;23;1;22;.957;3600000;0
39903;149353;3965;71;29;2;27;.931;3565000;0
39904;164710;957;63;22;2;20;.909;3600000;0
39904;196055;945;0;0;0;0;.00nan;0;0
39904;146479;945;66;42;5;37;.881;3573000;0
39904;154414;957;0;0;0;0;.00nan;0;0
39905;164715;966;0;0;0;0;.00nan;0;0
39905;147255;891;69;41;4;37;.902;3547000;0
39905;147567;966;63;25;2;23;.920;3600000;0
39905;160932;891;0;0;0;0;.00nan;0;0
39906;4219;880;73;44;4;40;.909;3600000;0
39906;83678;879;86;16;0;16;1.000;3600000;0
39906;147492;880;0;0;0;0;.00nan;0;0
39906;157295;879;0;0;0;0;.00nan;0;0
39907;7037;894;0;0;0;0;.00nan;0;0
39907;8487;885;75;29;2;27;.931;3600000;0
39907;11670;885;0;0;0;0;.00nan;0;0
39907;146445;894;77;35;3;32;.914;3554000;0
39908;80834;897;52;30;3;27;.900;3555000;0
39908;82245;872;0;0;0;0;.00nan;0;0
39908;90734;872;77;26;2;24;.923;3600000;0
39908;159705;897;0;0;0;0;.00nan;0;0
39909;196055;945;0;0;0;0;.00nan;0;0
39909;146479;945;50;15;2;13;.867;3600000;0
39909;147255;891;0;0;0;0;.00nan;0;0
39909;160932;891;86;29;1;28;.966;3600000;0
39910;164715;966;49;13;2;11;.846;3600000;0
39910;80596;3965;0;0;0;0;.00nan;0;0
39910;147567;966;0;0;0;0;.00nan;0;0
39910;149353;3965;80;51;5;46;.902;3600000;0
39911;80834;897;0;0;0;0;.00nan;0;0
39911;83678;879;77;36;3;33;.917;3898000;0
39911;157295;879;0;0;0;0;.00nan;0;0
39911;159705;897;53;18;2;16;.889;3898000;0
39912;8487;885;0;0;0;0;.00nan;0;0
39912;11670;885;76;27;2;25;.926;3600000;0
39912;71075;890;0;0;0;0;.00nan;0;0
39912;146386;890;79;52;4;48;.923;3600000;0
39913;1712;975;0;0;0;0;.00nan;0;0
39913;82245;872;0;0;0;0;.00nan;0;0
39913;86686;975;88;47;4;43;.915;3600000;0
39913;90734;872;87;18;0;18;1.000;3600000;0
39914;7037;894;0;0;0;0;.00nan;0;0
39914;9858;978;0;0;0;0;.00nan;0;0
39914;146445;894;100;24;0;24;1.000;3600000;0
39914;161255;978;70;40;4;36;.900;3600000;0
39915;4219;880;0;0;0;0;.00nan;0;0
39915;164710;957;66;19;1;18;.947;3600000;0
39915;147492;880;74;42;4;38;.905;3600000;0
39915;154414;957;0;0;0;0;.00nan;0;0
39916;7624;975;0;0;0;0;.00nan;0;0
39916;164715;966;0;0;0;0;.00nan;0;0
39916;86686;975;84;59;6;53;.898;3600000;0
39916;147567;966;85;16;0;16;1.000;3600000;0
39917;196055;945;0;0;0;0;.00nan;0;0
39917;80834;897;79;27;1;26;.963;3600000;0
39917;146479;945;53;32;4;28;.875;3600000;0
39917;159705;897;0;0;0;0;.00nan;0;0
39918;80596;3965;0;0;0;0;.00nan;0;0
39918;82245;872;0;0;0;0;.00nan;0;0
39918;90734;872;86;27;2;25;.926;3600000;0
39918;149353;3965;87;55;5;50;.909;3600000;0
39919;7037;894;0;0;0;0;.00nan;0;0
39919;164710;957;0;0;0;0;.00nan;0;0
39919;146445;894;82;45;4;41;.911;3600000;0
39919;154414;957;76;21;1;20;.952;3600000;0
39920;71075;890;0;0;0;0;.00nan;0;0
39920;146386;890;75;25;2;23;.920;3600000;0
39920;147255;891;57;30;4;26;.867;3522000;0
39920;160932;891;0;0;0;0;.00nan;0;0
39921;4219;880;62;21;2;19;.905;3600000;0
39921;8487;885;0;0;0;0;.00nan;0;0
39921;11670;885;49;34;5;29;.853;3600000;0
39921;147492;880;0;0;0;0;.00nan;0;0
39922;164715;966;0;0;0;0;.00nan;0;0
39922;71075;890;0;0;0;0;.00nan;0;0
39922;146386;890;89;44;3;41;.932;3575000;0
39922;147567;966;48;12;2;10;.833;3600000;0
39923;164710;957;40;28;5;23;.821;3573000;0
39923;83678;879;51;30;4;26;.867;3600000;0
39923;154414;957;0;0;0;0;.00nan;0;0
39923;157295;879;0;0;0;0;.00nan;0;0
39924;4219;880;0;0;0;0;.00nan;0;0
39924;82245;872;0;0;0;0;.00nan;0;0
39924;90734;872;100;25;0;25;1.000;3600000;0
39924;147492;880;77;24;1;23;.958;3594000;0
39925;7037;894;37;19;4;15;.789;2650000;0
39925;196055;945;0;0;0;0;.00nan;0;0
39925;146445;894;53;11;1;10;.909;873000;0
39925;146479;945;67;31;3;28;.903;3600000;0
39926;7624;975;85;25;1;24;.960;1231000;0
39926;80834;897;59;12;1;11;.917;3600000;0
39926;86686;975;55;42;6;36;.857;2369000;0
39926;159705;897;0;0;0;0;.00nan;0;0
39927;9858;978;0;0;0;0;.00nan;0;0
39927;80596;3965;0;0;0;0;.00nan;0;0
39927;149353;3965;45;36;6;30;.833;3900000;0
39927;161255;978;31;33;6;27;.818;3900000;0
39928;4219;880;0;0;0;0;.00nan;0;0
39928;7037;894;0;0;0;0;.00nan;0;0
39928;146445;894;100;26;0;26;1.000;3600000;0
39928;147492;880;67;25;2;23;.920;3527000;0
39929;80596;3965;79;43;4;39;.907;3690000;0
39929;83678;879;56;21;3;18;.857;3690000;0
39929;149353;3965;0;0;0;0;.00nan;0;0
39929;157295;879;0;0;0;0;.00nan;0;0
39930;7624;975;0;0;0;0;.00nan;0;0
39930;164710;957;59;13;1;12;.923;3600000;0
39930;86686;975;98;59;3;56;.949;3568000;0
39930;154414;957;0;0;0;0;.00nan;0;0
39931;71075;890;98;39;2;37;.949;3600000;0
39931;82245;872;0;0;0;0;.00nan;0;0
39931;90734;872;50;24;3;21;.875;3584000;0
39931;146386;890;0;0;0;0;.00nan;0;0
39932;8487;885;0;0;0;0;.00nan;0;0
39932;9858;978;57;5;0;5;1.000;702000;0
39932;11670;885;77;24;1;23;.958;3600000;0
39932;161255;978;39;37;6;31;.838;2898000;0
39933;80834;897;0;0;0;0;.00nan;0;0
39933;147255;891;0;0;0;0;.00nan;0;0
39933;159705;897;94;21;0;21;1.000;3600000;0
39933;160932;891;81;32;1;31;.969;3576000;0
39934;164715;966;0;0;0;0;.00nan;0;0
39934;196055;945;0;0;0;0;.00nan;0;0
39934;146479;945;66;47;4;43;.915;3600000;0
39934;147567;966;84;28;1;27;.964;3600000;0
39935;80596;3965;53;5;0;5;1.000;773000;0
39935;147255;891;35;21;4;17;.810;3600000;0
39935;149353;3965;38;34;6;28;.824;2787000;0
39935;160932;891;0;0;0;0;.00nan;0;0
39936;4219;880;74;28;2;26;.929;3584000;0
39936;196055;945;0;0;0;0;.00nan;0;0
39936;146479;945;92;29;1;28;.966;3600000;0
39936;147492;880;0;0;0;0;.00nan;0;0
39937;164710;957;65;26;2;24;.923;3600000;0
39937;80834;897;45;27;4;23;.852;3546000;0
39937;154414;957;0;0;0;0;.00nan;0;0
39937;159705;897;0;0;0;0;.00nan;0;0
39938;71075;890;0;0;0;0;.00nan;0;0
39938;83678;879;77;25;2;23;.920;3600000;0
39938;146386;890;87;40;3;37;.925;3580000;0
39938;157295;879;0;0;0;0;.00nan;0;0
39939;82245;872;0;0;0;0;.00nan;0;0
39939;90734;872;65;21;2;19;.905;3600000;0
39939;147255;891;40;33;6;27;.818;3600000;0
39939;160932;891;0;0;0;0;.00nan;0;0
39940;7037;894;0;0;0;0;.00nan;0;0
39940;80596;3965;0;0;0;0;.00nan;0;0
39940;146445;894;54;19;2;17;.895;3600000;0
39940;149353;3965;52;29;4;25;.862;3586000;0
39941;7624;975;0;0;0;0;.00nan;0;0
39941;8487;885;0;0;0;0;.00nan;0;0
39941;11670;885;46;11;2;9;.818;3547000;0
39941;86686;975;96;46;1;45;.978;3600000;0
39942;9858;978;0;0;0;0;.00nan;0;0
39942;164715;966;0;0;0;0;.00nan;0;0
39942;147567;966;71;6;0;6;1.000;3600000;0
39942;161255;978;97;46;3;43;.935;3600000;0
39943;4219;880;65;29;3;26;.897;2485000;0
39943;80596;3965;0;0;0;0;.00nan;0;0
39943;147492;880;20;9;4;5;.556;1115000;0
39943;149353;3965;79;22;1;21;.955;3600000;0
39944;164710;957;82;31;2;29;.935;3900000;0
39944;164715;966;0;0;0;0;.00nan;0;0
39944;147567;966;88;38;2;36;.947;3900000;0
39944;154414;957;0;0;0;0;.00nan;0;0
39945;9858;978;48;0;0;0;.00nan;359000;0
39945;147255;891;0;0;0;0;.00nan;0;0
39945;160932;891;73;19;1;18;.947;3600000;0
39945;161255;978;17;32;7;25;.781;3241000;0
39946;8487;885;0;0;0;0;.00nan;0;0
39946;11670;885;97;41;2;39;.951;3600000;0
39946;83678;879;65;16;1;15;.938;3600000;0
39946;157295;879;0;0;0;0;.00nan;0;0
39947;7624;975;0;0;0;0;.00nan;0;0
39947;71075;890;0;0;0;0;.00nan;0;0
39947;86686;975;63;44;5;39;.886;3560000;0
39947;146386;890;54;16;3;13;.813;3600000;0
39948;196055;945;80;30;1;29;.967;3600000;0
39948;82245;872;0;0;0;0;.00nan;0;0
39948;90734;872;53;23;3;20;.870;3529000;0
39948;146479;945;0;0;0;0;.00nan;0;0
39949;7037;894;0;0;0;0;.00nan;0;0
39949;80834;897;0;0;0;0;.00nan;0;0
39949;146445;894;72;47;5;42;.894;3600000;0
39949;159705;897;81;25;1;24;.960;3600000;0
39950;7624;975;0;0;0;0;.00nan;0;0
39950;80596;3965;0;0;0;0;.00nan;0;0
39950;86686;975;97;41;2;39;.951;3581000;0
39950;149353;3965;66;17;1;16;.941;3600000;0
39951;4219;880;66;23;2;21;.913;3580000;0
39951;164715;966;0;0;0;0;.00nan;0;0
39951;147492;880;0;0;0;0;.00nan;0;0
39951;147567;966;89;25;1;24;.960;3600000;0
39952;164710;957;87;15;0;15;1.000;3600000;0
39952;147255;891;0;0;0;0;.00nan;0;0
39952;154414;957;0;0;0;0;.00nan;0;0
39952;160932;891;62;28;3;25;.893;3600000;0
39953;7037;894;0;0;0;0;.00nan;0;0
39953;71075;890;67;29;3;26;.897;3064000;0
39953;146386;890;31;8;3;5;.625;536000;0
39953;146445;894;75;33;2;31;.939;3600000;0
39954;196055;945;0;0;0;0;.00nan;0;0
39954;83678;879;67;20;2;18;.900;3600000;0
39954;146479;945;43;35;6;29;.829;3600000;0
39954;157295;879;0;0;0;0;.00nan;0;0
39955;9858;978;0;0;0;0;.00nan;0;0
39955;80834;897;69;28;2;26;.929;3569000;0
39955;159705;897;0;0;0;0;.00nan;0;0
39955;161255;978;86;30;1;29;.967;3600000;0
39956;4219;880;0;0;0;0;.00nan;0;0
39956;7624;975;0;0;0;0;.00nan;0;0
39956;86686;975;88;51;3;48;.941;3579000;0
39956;147492;880;68;21;1;20;.952;3600000;0
39957;164710;957;69;13;1;12;.923;3600000;0
39957;80596;3965;0;0;0;0;.00nan;0;0
39957;149353;3965;78;48;4;44;.917;3600000;0
39957;154414;957;0;0;0;0;.00nan;0;0
39958;164715;966;0;0;0;0;.00nan;0;0
39958;83678;879;0;0;0;0;.00nan;0;0
39958;147567;966;38;23;4;19;.826;3600000;0
39958;157295;879;88;28;1;27;.964;3600000;0
39959;196055;945;0;0;0;0;.00nan;0;0
39959;71075;890;45;28;5;23;.821;3600000;0
39959;146386;890;0;0;0;0;.00nan;0;0
39959;146479;945;100;48;0;48;1.000;3600000;0
39960;9858;978;0;0;0;0;.00nan;0;0
39960;82245;872;0;0;0;0;.00nan;0;0
39960;90734;872;68;17;1;16;.941;3600000;0
39960;161255;978;45;27;4;23;.852;3600000;0
39961;7037;894;0;0;0;0;.00nan;0;0
39961;146445;894;83;27;2;25;.926;3900000;0
39961;147255;891;0;0;0;0;.00nan;0;0
39961;160932;891;77;31;2;29;.935;3900000;0
39962;8487;885;0;0;0;0;.00nan;0;0
39962;11670;885;96;42;2;40;.952;3600000;0
39962;80834;897;0;0;0;0;.00nan;0;0
39962;159705;897;55;22;3;19;.864;3600000;0
39963;4219;880;56;44;6;38;.864;2719000;0
39963;82245;872;0;0;0;0;.00nan;0;0
39963;90734;872;54;19;3;16;.842;3600000;0
39963;147492;880;55;5;0;5;1.000;881000;0
39964;196055;945;0;0;0;0;.00nan;0;0
39964;80596;3965;0;0;0;0;.00nan;0;0
39964;146479;945;100;25;0;25;1.000;3600000;0
39964;149353;3965;55;46;6;40;.870;3600000;0
39965;9858;978;0;0;0;0;.00nan;0;0
39965;147255;891;0;0;0;0;.00nan;0;0
39965;160932;891;80;26;1;25;.962;3600000;0
39965;161255;978;82;41;3;38;.927;3514000;0
39966;7037;894;0;0;0;0;.00nan;0;0
39966;8487;885;0;0;0;0;.00nan;0;0
39966;11670;885;61;35;5;30;.857;3600000;0
39966;146445;894;50;28;4;24;.857;3600000;0
39967;164710;957;72;26;2;24;.923;3548000;0
39967;71075;890;0;0;0;0;.00nan;0;0
39967;146386;890;94;30;1;29;.967;3600000;0
39967;154414;957;0;0;0;0;.00nan;0;0
39968;7624;975;78;51;5;46;.902;3215000;0
39968;83678;879;73;10;0;10;1.000;3600000;0
39968;86686;975;27;7;3;4;.571;385000;0
39968;157295;879;0;0;0;0;.00nan;0;0
39969;164710;957;89;14;0;14;1.000;3600000;0
39969;80596;3965;91;55;3;52;.945;3600000;0
39969;149353;3965;0;0;0;0;.00nan;0;0
39969;154414;957;0;0;0;0;.00nan;0;0
39970;7037;894;0;0;0;0;.00nan;0;0
39970;164715;966;0;0;0;0;.00nan;0;0
39970;146445;894;75;28;2;26;.929;3585000;0
39970;147567;966;76;12;0;12;1.000;3600000;0
39971;71075;890;0;0;0;0;.00nan;0;0
39971;146386;890;62;30;3;27;.900;3589000;0
39971;147255;891;0;0;0;0;.00nan;0;0
39971;160932;891;56;13;1;12;.923;3600000;0
39972;4219;880;0;0;0;0;.00nan;0;0
39972;7624;975;0;0;0;0;.00nan;0;0
39972;86686;975;87;48;3;45;.938;3600000;0
39972;147492;880;51;16;2;14;.875;3600000;0
39973;80834;897;82;28;1;27;.964;3600000;0
39973;82245;872;0;0;0;0;.00nan;0;0
39973;90734;872;86;51;4;47;.922;3600000;0
39973;159705;897;0;0;0;0;.00nan;0;0
39974;4219;880;96;27;1;26;.963;3600000;0
39974;147255;891;0;0;0;0;.00nan;0;0
39974;147492;880;0;0;0;0;.00nan;0;0
39974;160932;891;48;14;2;12;.857;3595000;0
39975;7624;975;0;0;0;0;.00nan;0;0
39975;164710;957;42;25;5;20;.800;3581000;0
39975;86686;975;88;46;4;42;.913;3600000;0
39975;154414;957;0;0;0;0;.00nan;0;0
39976;71075;890;53;29;4;25;.862;3600000;0
39976;80834;897;0;0;0;0;.00nan;0;0
39976;146386;890;0;0;0;0;.00nan;0;0
39976;159705;897;90;18;0;18;1.000;3600000;0
39977;82245;872;0;0;0;0;.00nan;0;0
39977;83678;879;56;33;4;29;.879;3569000;0
39977;90734;872;50;17;3;14;.824;3600000;0
39977;157295;879;0;0;0;0;.00nan;0;0
39978;7037;894;0;0;0;0;.00nan;0;0
39978;9858;978;79;37;4;33;.892;3577000;0
39978;146445;894;66;22;2;20;.909;3600000;0
39978;161255;978;0;0;0;0;.00nan;0;0
39979;164715;966;0;0;0;0;.00nan;0;0
39979;196055;945;0;0;0;0;.00nan;0;0
39979;146479;945;90;30;1;29;.967;3600000;0
39979;147567;966;84;35;2;33;.943;3563000;0
39980;164715;966;0;0;0;0;.00nan;0;0
39980;71075;890;0;0;0;0;.00nan;0;0
39980;146386;890;93;35;2;33;.943;3598000;0
39980;147567;966;70;20;1;19;.950;3600000;0
39981;196055;945;0;0;0;0;.00nan;0;0
39981;146479;945;69;23;2;21;.913;3591000;0
39981;147255;891;77;23;1;22;.957;3600000;0
39981;160932;891;0;0;0;0;.00nan;0;0
39982;7037;894;0;0;0;0;.00nan;0;0
39982;83678;879;64;27;3;24;.889;3600000;0
39982;146445;894;99;53;2;51;.962;3600000;0
39982;157295;879;0;0;0;0;.00nan;0;0
39983;7624;975;28;7;3;4;.571;830000;0
39983;82245;872;0;0;0;0;.00nan;0;0
39983;86686;975;52;41;6;35;.854;2770000;0
39983;90734;872;84;16;0;16;1.000;3600000;0
39984;8487;885;0;0;0;0;.00nan;0;0
39984;11670;885;58;20;2;18;.900;3600000;0
39984;80596;3965;0;0;0;0;.00nan;0;0
39984;149353;3965;96;50;3;47;.940;3553000;0
39985;4219;880;0;0;0;0;.00nan;0;0
39985;80834;897;79;13;0;13;1.000;3600000;0
39985;147492;880;96;38;2;36;.947;3575000;0
39985;159705;897;0;0;0;0;.00nan;0;0
39986;9858;978;0;0;0;0;.00nan;0;0
39986;164710;957;69;26;2;24;.923;3600000;0
39986;154414;957;0;0;0;0;.00nan;0;0
39986;161255;978;76;45;4;41;.911;3595000;0
39987;8487;885;74;25;2;23;.920;3600000;0
39987;11670;885;0;0;0;0;.00nan;0;0
39987;80596;3965;0;0;0;0;.00nan;0;0
39987;149353;3965;62;30;3;27;.900;3592000;0
39988;7624;975;0;0;0;0;.00nan;0;0
39988;86686;975;86;42;3;39;.929;3600000;0
39988;147255;891;0;0;0;0;.00nan;0;0
39988;160932;891;55;12;1;11;.917;3600000;0
39989;4219;880;0;0;0;0;.00nan;0;0
39989;83678;879;69;20;1;19;.950;3600000;0
39989;147492;880;80;43;3;40;.930;3584000;0
39989;157295;879;0;0;0;0;.00nan;0;0
39990;80596;3965;49;10;1;9;.900;1314000;0
39990;80834;897;21;14;5;9;.643;3600000;0
39990;149353;3965;48;26;5;21;.808;2273000;0
39990;159705;897;0;0;0;0;.00nan;0;0
39991;164710;957;0;0;0;0;.00nan;0;0
39991;82245;872;0;0;0;0;.00nan;0;0
39991;90734;872;86;34;2;32;.941;3600000;0
39991;154414;957;43;27;4;23;.852;3588000;0
39992;7037;894;100;38;1;37;.974;3900000;0
39992;146445;894;0;0;0;0;.00nan;0;0
39992;147255;891;89;29;1;28;.966;3900000;0
39992;160932;891;0;0;0;0;.00nan;0;0
39993;7624;975;0;0;0;0;.00nan;0;0
39993;196055;945;0;0;0;0;.00nan;0;0
39993;86686;975;88;35;1;34;.971;3600000;0
39993;146479;945;62;29;2;27;.931;3600000;0
39994;8487;885;0;0;0;0;.00nan;0;0
39994;164715;966;65;16;1;15;.938;2595000;0
39994;11670;885;76;36;4;32;.889;3600000;0
39994;147567;966;23;10;4;6;.600;955000;0
39995;9858;978;0;0;0;0;.00nan;0;0
39995;71075;890;0;0;0;0;.00nan;0;0
39995;146386;890;49;18;3;15;.833;3600000;0
39995;161255;978;68;37;4;33;.892;3549000;0
39996;80834;897;0;0;0;0;.00nan;0;0
39996;83678;879;65;41;5;36;.878;3600000;0
39996;157295;879;0;0;0;0;.00nan;0;0
39996;159705;897;66;22;2;20;.909;3600000;0
39997;9858;978;0;0;0;0;.00nan;0;0
39997;147255;891;0;0;0;0;.00nan;0;0
39997;160932;891;44;21;4;17;.810;3883000;0
39997;161255;978;65;38;4;34;.895;3900000;0
39998;4219;880;40;18;3;15;.833;3600000;0
39998;8487;885;0;0;0;0;.00nan;0;0
39998;11670;885;100;35;0;35;1.000;3600000;0
39998;147492;880;0;0;0;0;.00nan;0;0
39999;7624;975;0;0;0;0;.00nan;0;0
39999;80596;3965;0;0;0;0;.00nan;0;0
39999;86686;975;53;27;4;23;.852;3690000;0
39999;149353;3965;71;30;3;27;.900;3704000;0
40000;9858;978;70;16;0;16;1.000;1768000;0
40000;164715;966;0;0;0;0;.00nan;0;0
40000;147567;966;95;16;0;16;1.000;3600000;0
40000;161255;978;32;35;6;29;.829;1832000;0
40001;164710;957;82;22;1;21;.955;3600000;0
40001;71075;890;0;0;0;0;.00nan;0;0
40001;146386;890;54;39;5;34;.872;3600000;0
40001;154414;957;0;0;0;0;.00nan;0;0
40002;82245;872;0;0;0;0;.00nan;0;0
40002;90734;872;77;24;1;23;.958;3600000;0
40002;147255;891;80;23;1;22;.957;3010000;0
40002;160932;891;25;5;3;2;.400;590000;0
40003;7037;894;0;0;0;0;.00nan;0;0
40003;196055;945;54;33;4;29;.879;3692000;0
40003;146445;894;78;41;3;38;.927;3692000;0
40003;146479;945;0;0;0;0;.00nan;0;0
40004;4219;880;60;39;5;34;.872;3600000;0
40004;164710;957;51;14;2;12;.857;3600000;0
40004;147492;880;0;0;0;0;.00nan;0;0
40004;154414;957;0;0;0;0;.00nan;0;0
40005;164715;966;59;7;0;7;1.000;355000;0
40005;83678;879;74;29;2;27;.931;3600000;0
40005;147567;966;17;21;6;15;.714;3245000;0
40005;157295;879;0;0;0;0;.00nan;0;0
40006;7037;894;0;0;0;0;.00nan;0;0
40006;82245;872;0;0;0;0;.00nan;0;0
40006;90734;872;59;10;1;9;.900;3600000;0
40006;146445;894;98;46;2;44;.957;3600000;0
40007;7624;975;0;0;0;0;.00nan;0;0
40007;80834;897;0;0;0;0;.00nan;0;0
40007;86686;975;76;48;4;44;.917;3600000;0
40007;159705;897;77;8;0;8;1.000;3600000;0
40008;8487;885;0;0;0;0;.00nan;0;0
40008;11670;885;59;29;3;26;.897;3600000;0
40008;71075;890;0;0;0;0;.00nan;0;0
40008;146386;890;100;38;0;38;1.000;3600000;0
40009;9858;978;0;0;0;0;.00nan;0;0
40009;196055;945;0;0;0;0;.00nan;0;0
40009;146479;945;50;27;4;23;.852;3600000;0
40009;161255;978;94;36;1;35;.972;3600000;0
40010;80596;3965;0;0;0;0;.00nan;0;0
40010;147255;891;78;29;1;28;.966;3600000;0
40010;149353;3965;49;32;5;27;.844;3600000;0
40010;160932;891;0;0;0;0;.00nan;0;0
40011;7037;894;0;0;0;0;.00nan;0;0
40011;83678;879;40;11;3;8;.727;3900000;0
40011;146445;894;88;50;3;47;.940;3900000;0
40011;157295;879;0;0;0;0;.00nan;0;0
40012;4219;880;0;0;0;0;.00nan;0;0
40012;196055;945;0;0;0;0;.00nan;0;0
40012;146479;945;83;32;2;30;.938;3581000;0
40012;147492;880;100;29;0;29;1.000;3600000;0
40013;164715;966;0;0;0;0;.00nan;0;0
40013;147255;891;0;0;0;0;.00nan;0;0
40013;147567;966;75;23;1;22;.957;3900000;0
40013;160932;891;87;33;1;32;.970;3896000;0
40014;164710;957;46;32;5;27;.844;3600000;0
40014;80834;897;98;21;0;21;1.000;3600000;0
40014;154414;957;0;0;0;0;.00nan;0;0
40014;159705;897;0;0;0;0;.00nan;0;0
40015;71075;890;0;0;0;0;.00nan;0;0
40015;83678;879;70;17;1;16;.941;3600000;0
40015;146386;890;63;32;4;28;.875;3600000;0
40015;157295;879;0;0;0;0;.00nan;0;0
40016;80596;3965;0;0;0;0;.00nan;0;0
40016;82245;872;63;12;1;11;.917;3600000;0
40016;90734;872;0;0;0;0;.00nan;0;0
40016;149353;3965;83;38;2;36;.947;3600000;0
40017;8487;885;0;0;0;0;.00nan;0;0
40017;9858;978;91;35;1;34;.971;3021000;0
40017;11670;885;64;20;2;18;.900;3600000;0
40017;161255;978;25;5;3;2;.400;504000;0
40018;164715;966;0;0;0;0;.00nan;0;0
40018;80596;3965;0;0;0;0;.00nan;0;0
40018;147567;966;72;23;1;22;.957;3600000;0
40018;149353;3965;60;36;5;31;.861;3600000;0
40019;7624;975;20;14;5;9;.643;1065000;0
40019;71075;890;52;16;2;14;.875;3600000;0
40019;86686;975;11;27;7;20;.741;2535000;0
40019;146386;890;0;0;0;0;.00nan;0;0
40020;7037;894;0;0;0;0;.00nan;0;0
40020;82245;872;0;0;0;0;.00nan;0;0
40020;90734;872;82;24;1;23;.958;3600000;0
40020;146445;894;73;35;3;32;.914;3583000;0
40021;164710;957;34;22;5;17;.773;3550000;0
40021;196055;945;0;0;0;0;.00nan;0;0
40021;146479;945;79;45;4;41;.911;3600000;0
40021;154414;957;0;0;0;0;.00nan;0;0
40022;8487;885;0;0;0;0;.00nan;0;0
40022;11670;885;56;39;5;34;.872;3600000;0
40022;83678;879;81;23;1;22;.957;3600000;0
40022;157295;879;0;0;0;0;.00nan;0;0
40023;9858;978;0;0;0;0;.00nan;0;0
40023;80834;897;0;0;0;0;.00nan;0;0
40023;159705;897;53;17;3;14;.824;3600000;0
40023;161255;978;55;39;5;34;.872;3600000;0
40024;7624;975;0;0;0;0;.00nan;0;0
40024;9858;978;95;34;2;32;.941;3600000;0
40024;86686;975;43;27;5;22;.815;3600000;0
40024;161255;978;0;0;0;0;.00nan;0;0
40025;4219;880;0;0;0;0;.00nan;0;0
40025;147255;891;49;30;4;26;.867;3590000;0
40025;147492;880;73;33;3;30;.909;3600000;0
40025;160932;891;0;0;0;0;.00nan;0;0
40026;7037;894;0;0;0;0;.00nan;0;0
40026;164710;957;68;21;2;19;.905;3600000;0
40026;146445;894;73;48;5;43;.896;3600000;0
40026;154414;957;0;0;0;0;.00nan;0;0
40027;4219;880;65;29;3;26;.897;3600000;0
40027;71075;890;37;23;5;18;.783;2178000;0
40027;146386;890;45;12;2;10;.833;1422000;0
40027;147492;880;0;0;0;0;.00nan;0;0
40028;83678;879;0;0;0;0;.00nan;0;0
40028;147255;891;0;0;0;0;.00nan;0;0
40028;157295;879;74;22;2;20;.909;3600000;0
40028;160932;891;50;36;5;31;.861;3600000;0
40029;7624;975;0;0;0;0;.00nan;0;0
40029;164715;966;0;0;0;0;.00nan;0;0
40029;86686;975;62;52;7;45;.865;3600000;0
40029;147567;966;60;12;1;11;.917;3600000;0
40030;196055;945;0;0;0;0;.00nan;0;0
40030;80596;3965;0;0;0;0;.00nan;0;0
40030;146479;945;54;16;3;13;.813;3600000;0
40030;149353;3965;59;36;4;32;.889;3570000;0
40031;8487;885;0;0;0;0;.00nan;0;0
40031;11670;885;100;39;1;38;.974;3600000;0
40031;80834;897;53;21;3;18;.857;3568000;0
40031;159705;897;0;0;0;0;.00nan;0;0
40032;9858;978;71;52;5;47;.904;3540000;0
40032;82245;872;0;0;0;0;.00nan;0;0
40032;90734;872;50;20;3;17;.850;3600000;0
40032;161255;978;0;0;0;0;.00nan;0;0
40033;164710;957;91;31;1;30;.968;3600000;0
40033;147255;891;23;22;6;16;.727;2051000;0
40033;154414;957;0;0;0;0;.00nan;0;0
40033;160932;891;45;5;1;4;.800;1549000;0
40034;9858;978;0;0;0;0;.00nan;0;0
40034;80596;3965;0;0;0;0;.00nan;0;0
40034;149353;3965;100;36;0;36;1.000;3600000;0
40034;161255;978;63;27;4;23;.852;3600000;0
40035;164715;966;0;0;0;0;.00nan;0;0
40035;80834;897;0;0;0;0;.00nan;0;0
40035;147567;966;80;30;2;28;.933;3600000;0
40035;159705;897;68;30;3;27;.900;3545000;0
40036;71075;890;0;0;0;0;.00nan;0;0
40036;82245;872;0;0;0;0;.00nan;0;0
40036;90734;872;63;19;3;16;.842;3600000;0
40036;146386;890;82;45;4;41;.911;3600000;0
40037;4219;880;37;6;2;4;.667;1312000;0
40037;7037;894;0;0;0;0;.00nan;0;0
40037;146445;894;70;38;4;34;.895;3600000;0
40037;147492;880;31;26;6;20;.769;2288000;0
40038;7624;975;0;0;0;0;.00nan;0;0
40038;8487;885;0;0;0;0;.00nan;0;0
40038;11670;885;56;22;3;19;.864;3600000;0
40038;86686;975;88;43;4;39;.907;3600000;0
40039;196055;945;0;0;0;0;.00nan;0;0
40039;83678;879;63;27;3;24;.889;3600000;0
40039;146479;945;65;39;4;35;.897;3546000;0
40039;157295;879;0;0;0;0;.00nan;0;0
40040;4219;880;0;0;0;0;.00nan;0;0
40040;164715;966;0;0;0;0;.00nan;0;0
40040;147492;880;98;26;0;26;1.000;3600000;0
40040;147567;966;65;24;2;22;.917;3585000;0
40041;8487;885;0;0;0;0;.00nan;0;0
40041;11670;885;67;24;2;22;.917;3849000;0
40041;147255;891;0;0;0;0;.00nan;0;0
40041;160932;891;94;44;3;41;.932;3849000;0
40042;7037;894;0;0;0;0;.00nan;0;0
40042;80834;897;70;21;2;19;.905;3544000;0
40042;146445;894;98;39;1;38;.974;3600000;0
40042;159705;897;0;0;0;0;.00nan;0;0
40043;71075;890;0;0;0;0;.00nan;0;0
40043;80596;3965;0;0;0;0;.00nan;0;0
40043;146386;890;73;24;1;23;.958;3600000;0
40043;149353;3965;100;28;0;28;1.000;3600000;0
40044;164710;957;85;32;2;30;.938;3600000;0
40044;83678;879;49;25;4;21;.840;3531000;0
40044;154414;957;0;0;0;0;.00nan;0;0
40044;157295;879;0;0;0;0;.00nan;0;0
40045;196055;945;0;0;0;0;.00nan;0;0
40045;82245;872;0;0;0;0;.00nan;0;0
40045;90734;872;82;13;0;13;1.000;3600000;0
40045;146479;945;97;36;1;35;.972;3578000;0
40046;164710;957;86;31;1;30;.968;3600000;0
40046;164715;966;0;0;0;0;.00nan;0;0
40046;147567;966;64;25;2;23;.920;3546000;0
40046;154414;957;0;0;0;0;.00nan;0;0
40047;80834;897;0;0;0;0;.00nan;0;0
40047;147255;891;47;37;5;32;.865;3516000;0
40047;159705;897;66;29;3;26;.897;3600000;0
40047;160932;891;0;0;0;0;.00nan;0;0
40048;7624;975;0;0;0;0;.00nan;0;0
40048;83678;879;52;18;2;16;.889;3600000;0
40048;86686;975;81;42;4;38;.905;3594000;0
40048;157295;879;0;0;0;0;.00nan;0;0
40049;7037;894;0;0;0;0;.00nan;0;0
40049;80596;3965;0;0;0;0;.00nan;0;0
40049;146445;894;77;29;2;27;.931;3600000;0
40049;149353;3965;47;33;5;28;.848;3600000;0
40050;196055;945;29;23;5;18;.783;3600000;0
40050;71075;890;57;22;2;20;.909;3600000;0
40050;146386;890;0;0;0;0;.00nan;0;0
40050;146479;945;0;0;0;0;.00nan;0;0
40051;4219;880;0;0;0;0;.00nan;0;0
40051;9858;978;78;26;1;25;.962;3600000;0
40051;147492;880;66;27;2;25;.926;3561000;0
40051;161255;978;0;0;0;0;.00nan;0;0
40052;4219;880;50;31;5;26;.839;3531000;0
40052;9858;978;0;0;0;0;.00nan;0;0
40052;147492;880;0;0;0;0;.00nan;0;0
40052;161255;978;67;36;3;33;.917;3600000;0
40053;80596;3965;0;0;0;0;.00nan;0;0
40053;83678;879;100;29;0;29;1.000;3600000;0
40053;149353;3965;88;28;1;27;.964;3544000;0
40053;157295;879;0;0;0;0;.00nan;0;0
40054;8487;885;0;0;0;0;.00nan;0;0
40054;164710;957;91;37;2;35;.946;3600000;0
40054;11670;885;65;29;3;26;.897;3553000;0
40054;154414;957;0;0;0;0;.00nan;0;0
40055;7037;894;0;0;0;0;.00nan;0;0
40055;71075;890;0;0;0;0;.00nan;0;0
40055;146386;890;70;19;1;18;.947;3600000;0
40055;146445;894;85;37;2;35;.946;3570000;0
40056;164715;966;0;0;0;0;.00nan;0;0
40056;82245;872;0;0;0;0;.00nan;0;0
40056;90734;872;65;35;4;31;.886;3600000;0
40056;147567;966;66;32;3;29;.906;3600000;0
40057;7624;975;0;0;0;0;.00nan;0;0
40057;86686;975;82;37;3;34;.919;3521000;0
40057;147255;891;0;0;0;0;.00nan;0;0
40057;160932;891;68;17;1;16;.941;3600000;0
40058;196055;945;0;0;0;0;.00nan;0;0
40058;80834;897;64;19;2;17;.895;3600000;0
40058;146479;945;72;49;5;44;.898;3600000;0
40058;159705;897;0;0;0;0;.00nan;0;0
40059;196055;945;64;41;5;36;.878;3600000;0
40059;80834;897;78;27;2;25;.926;3600000;0
40059;146479;945;0;0;0;0;.00nan;0;0
40059;159705;897;0;0;0;0;.00nan;0;0
40060;8487;885;0;0;0;0;.00nan;0;0
40060;11670;885;88;35;2;33;.943;3600000;0
40060;147255;891;70;36;3;33;.917;3549000;0
40060;160932;891;0;0;0;0;.00nan;0;0
40061;4219;880;0;0;0;0;.00nan;0;0
40061;82245;872;0;0;0;0;.00nan;0;0
40061;90734;872;68;24;2;22;.917;3600000;0
40061;147492;880;63;44;5;39;.886;3600000;0
40062;7624;975;0;0;0;0;.00nan;0;0
40062;80596;3965;0;0;0;0;.00nan;0;0
40062;86686;975;74;46;4;42;.913;3559000;0
40062;149353;3965;64;24;2;22;.917;3600000;0
40063;164715;966;0;0;0;0;.00nan;0;0
40063;71075;890;57;17;2;15;.882;3900000;0
40063;146386;890;0;0;0;0;.00nan;0;0
40063;147567;966;77;20;2;18;.900;3900000;0
40064;164710;957;82;24;1;23;.958;3600000;0
40064;83678;879;67;23;2;21;.913;3558000;0
40064;154414;957;0;0;0;0;.00nan;0;0
40064;157295;879;0;0;0;0;.00nan;0;0
40065;7037;894;0;0;0;0;.00nan;0;0
40065;9858;978;49;31;4;27;.871;3600000;0
40065;146445;894;55;23;3;20;.870;3600000;0
40065;161255;978;0;0;0;0;.00nan;0;0
40066;4219;880;0;0;0;0;.00nan;0;0
40066;7624;975;0;0;0;0;.00nan;0;0
40066;86686;975;90;30;1;29;.967;3600000;0
40066;147492;880;60;21;2;19;.905;3558000;0
40067;164715;966;0;0;0;0;.00nan;0;0
40067;196055;945;0;0;0;0;.00nan;0;0
40067;146479;945;72;42;4;38;.905;3900000;0
40067;147567;966;41;23;4;19;.826;3900000;0
40068;164710;957;77;24;1;23;.958;3600000;0
40068;147255;891;0;0;0;0;.00nan;0;0
40068;154414;957;0;0;0;0;.00nan;0;0
40068;160932;891;54;31;4;27;.871;3600000;0
40069;80596;3965;0;0;0;0;.00nan;0;0
40069;83678;879;0;0;0;0;.00nan;0;0
40069;149353;3965;81;41;3;38;.927;3600000;0
40069;157295;879;71;17;1;16;.941;3600000;0
40070;7037;894;73;36;3;33;.917;3560000;0
40070;82245;872;0;0;0;0;.00nan;0;0
40070;90734;872;54;15;2;13;.867;3600000;0
40070;146445;894;0;0;0;0;.00nan;0;0
40071;8487;885;54;25;3;22;.880;3564000;0
40071;9858;978;100;44;1;43;.977;3600000;0
40071;11670;885;0;0;0;0;.00nan;0;0
40071;161255;978;0;0;0;0;.00nan;0;0
40072;71075;890;0;0;0;0;.00nan;0;0
40072;80834;897;0;0;0;0;.00nan;0;0
40072;146386;890;55;26;4;22;.846;3572000;0
40072;159705;897;51;20;3;17;.850;3600000;0
40073;7037;894;0;0;0;0;.00nan;0;0
40073;80596;3965;59;25;3;22;.880;3585000;0
40073;146445;894;86;27;1;26;.963;3600000;0
40073;149353;3965;0;0;0;0;.00nan;0;0
40074;164715;966;0;0;0;0;.00nan;0;0
40074;147255;891;88;36;1;35;.972;3600000;0
40074;147567;966;53;17;2;15;.882;3547000;0
40074;160932;891;0;0;0;0;.00nan;0;0
40075;8487;885;0;0;0;0;.00nan;0;0
40075;11670;885;89;29;1;28;.966;3600000;0
40075;71075;890;63;25;2;23;.920;3576000;0
40075;146386;890;0;0;0;0;.00nan;0;0
40076;164710;957;100;23;0;23;1.000;3600000;0
40076;82245;872;0;0;0;0;.00nan;0;0
40076;90734;872;58;20;2;18;.900;3583000;0
40076;154414;957;0;0;0;0;.00nan;0;0
40077;192739;879;58;18;2;16;.889;3585000;0
40077;7624;975;0;0;0;0;.00nan;0;0
40077;83678;879;0;0;0;0;.00nan;0;0
40077;86686;975;100;44;1;43;.977;3600000;0
40078;4219;880;0;0;0;0;.00nan;0;0
40078;196055;945;0;0;0;0;.00nan;0;0
40078;146479;945;62;38;4;34;.895;3600000;0
40078;147492;880;82;29;1;28;.966;3600000;0
40079;9858;978;97;38;1;37;.974;3600000;0
40079;80834;897;42;29;6;23;.793;3600000;0
40079;159705;897;0;0;0;0;.00nan;0;0
40079;161255;978;0;0;0;0;.00nan;0;0
40080;164710;957;65;25;3;22;.880;3600000;0
40080;80596;3965;0;0;0;0;.00nan;0;0
40080;149353;3965;59;28;4;24;.857;3599000;0
40080;154414;957;0;0;0;0;.00nan;0;0
40081;7624;975;62;54;6;48;.889;3600000;0
40081;82245;872;0;0;0;0;.00nan;0;0
40081;90734;872;82;15;0;15;1.000;3600000;0
40081;146684;975;0;0;0;0;.00nan;0;0
40082;7037;894;0;0;0;0;.00nan;0;0
40082;80834;897;0;0;0;0;.00nan;0;0
40082;146445;894;48;27;4;23;.852;3627000;0
40082;159705;897;53;31;5;26;.839;3627000;0
40083;4219;880;0;0;0;0;.00nan;0;0
40083;8487;885;0;0;0;0;.00nan;0;0
40083;11670;885;92;34;1;33;.971;3600000;0
40083;147492;880;57;24;3;21;.875;3532000;0
40084;196055;945;0;0;0;0;.00nan;0;0
40084;71075;890;78;27;2;25;.926;3600000;0
40084;146386;890;0;0;0;0;.00nan;0;0
40084;146479;945;65;34;4;30;.882;3516000;0
40085;80596;3965;0;0;0;0;.00nan;0;0
40085;82245;872;0;0;0;0;.00nan;0;0
40085;90734;872;53;21;3;18;.857;3543000;0
40085;149353;3965;93;46;2;44;.957;3600000;0
40086;164710;957;0;0;0;0;.00nan;0;0
40086;196055;945;0;0;0;0;.00nan;0;0
40086;146479;945;52;42;5;37;.881;3600000;0
40086;154414;957;57;17;1;16;.941;3600000;0
40087;7037;894;0;0;0;0;.00nan;0;0
40087;146445;894;81;36;3;33;.917;3600000;0
40087;147255;891;0;0;0;0;.00nan;0;0
40087;160932;891;40;32;5;27;.844;3536000;0
40088;192739;879;79;32;2;30;.938;3900000;0
40088;8487;885;0;0;0;0;.00nan;0;0
40088;11670;885;98;37;2;35;.946;3900000;0
40088;83678;879;0;0;0;0;.00nan;0;0
40089;7624;975;0;0;0;0;.00nan;0;0
40089;71075;890;59;21;3;18;.857;3600000;0
40089;146386;890;0;0;0;0;.00nan;0;0
40089;146684;975;74;43;4;39;.907;3581000;0
40090;164715;966;0;0;0;0;.00nan;0;0
40090;80834;897;100;28;0;28;1.000;3600000;0
40090;141496;966;69;28;2;26;.929;3569000;0
40090;159705;897;0;0;0;0;.00nan;0;0
40091;4219;880;0;0;0;0;.00nan;0;0
40091;9858;978;87;51;4;47;.922;3600000;0
40091;147492;880;82;26;1;25;.962;3600000;0
40091;161255;978;0;0;0;0;.00nan;0;0
40092;4219;880;56;13;2;11;.846;3600000;0
40092;147255;891;13;27;7;20;.741;2707000;0
40092;147492;880;0;0;0;0;.00nan;0;0
40092;160932;891;45;5;1;4;.800;893000;0
40093;164715;966;0;0;0;0;.00nan;0;0
40093;80596;3965;63;10;0;10;1.000;1479000;0
40093;141496;966;70;18;1;17;.944;3600000;0
40093;149353;3965;45;25;4;21;.840;2121000;0
40094;192739;879;46;20;3;17;.850;3600000;0
40094;71075;890;0;0;0;0;.00nan;0;0
40094;83678;879;0;0;0;0;.00nan;0;0
40094;146386;890;63;36;4;32;.889;3543000;0
40095;8487;885;0;0;0;0;.00nan;0;0
40095;11670;885;52;28;4;24;.857;3551000;0
40095;82245;872;63;26;3;23;.885;3600000;0
40095;90734;872;0;0;0;0;.00nan;0;0
40096;7037;894;0;0;0;0;.00nan;0;0
40096;164710;957;71;25;2;23;.920;3600000;0
40096;146445;894;59;45;6;39;.867;3600000;0
40096;154414;957;0;0;0;0;.00nan;0;0
40097;9858;978;100;29;0;29;1.000;3600000;0
40097;196055;945;67;26;2;24;.923;3550000;0
40097;146479;945;0;0;0;0;.00nan;0;0
40097;161255;978;0;0;0;0;.00nan;0;0
40098;7624;975;53;42;6;36;.857;3600000;0
40098;80834;897;60;16;1;15;.938;3600000;0
40098;146684;975;0;0;0;0;.00nan;0;0
40098;159705;897;0;0;0;0;.00nan;0;0
40099;8487;885;0;0;0;0;.00nan;0;0
40099;11670;885;75;49;5;44;.898;3600000;0
40099;82245;872;0;0;0;0;.00nan;0;0
40099;90734;872;95;19;0;19;1.000;3600000;0
40100;8487;885;0;0;0;0;.00nan;0;0
40100;11670;885;84;39;2;37;.949;3568000;0
40100;80834;897;94;21;0;21;1.000;3600000;0
40100;159705;897;0;0;0;0;.00nan;0;0
40101;196055;945;0;0;0;0;.00nan;0;0
40101;80596;3965;0;0;0;0;.00nan;0;0
40101;146479;945;81;25;1;24;.960;3600000;0
40101;149353;3965;77;40;3;37;.925;3581000;0
40102;4219;880;0;0;0;0;.00nan;0;0
40102;164715;966;0;0;0;0;.00nan;0;0
40102;141496;966;79;29;1;28;.966;3600000;0
40102;147492;880;70;43;4;39;.907;3600000;0
40103;82245;872;0;0;0;0;.00nan;0;0
40103;90734;872;80;12;0;12;1.000;3600000;0
40103;147255;891;62;21;2;19;.905;2467000;0
40103;160932;891;33;15;4;11;.733;1133000;0
40104;9858;978;64;32;4;28;.875;3591000;0
40104;71075;890;0;0;0;0;.00nan;0;0
40104;146386;890;90;35;2;33;.943;3600000;0
40104;161255;978;0;0;0;0;.00nan;0;0
40105;7624;975;0;0;0;0;.00nan;0;0
40105;164710;957;82;12;0;12;1.000;3600000;0
40105;146684;975;73;57;6;51;.895;3600000;0
40105;154414;957;0;0;0;0;.00nan;0;0
40106;192739;879;100;36;1;35;.972;3600000;0
40106;80834;897;59;29;4;25;.862;3600000;0
40106;83678;879;0;0;0;0;.00nan;0;0
40106;159705;897;0;0;0;0;.00nan;0;0
40107;4219;880;70;30;2;28;.933;3600000;0
40107;7037;894;0;0;0;0;.00nan;0;0
40107;146445;894;61;14;1;13;.929;3600000;0
40107;147492;880;0;0;0;0;.00nan;0;0
40108;164710;957;62;15;1;14;.933;3600000;0
40108;164715;966;0;0;0;0;.00nan;0;0
40108;141496;966;80;33;2;31;.939;3548000;0
40108;154414;957;0;0;0;0;.00nan;0;0
40109;71075;890;68;36;3;33;.917;3548000;0
40109;82245;872;0;0;0;0;.00nan;0;0
40109;90734;872;56;19;2;17;.895;3600000;0
40109;146386;890;0;0;0;0;.00nan;0;0
40110;7624;975;94;41;2;39;.951;3556000;0
40110;8487;885;0;0;0;0;.00nan;0;0
40110;11670;885;58;15;1;14;.933;3600000;0
40110;146684;975;0;0;0;0;.00nan;0;0
40111;9858;978;88;16;0;16;1.000;3600000;0
40111;80596;3965;0;0;0;0;.00nan;0;0
40111;149353;3965;55;23;3;20;.870;3600000;0
40111;161255;978;0;0;0;0;.00nan;0;0
40112;196055;945;0;0;0;0;.00nan;0;0
40112;146479;945;27;24;5;19;.792;3600000;0
40112;147255;891;68;24;2;22;.917;3600000;0
40112;160932;891;0;0;0;0;.00nan;0;0
40113;7624;975;0;0;0;0;.00nan;0;0
40113;164715;966;68;13;1;12;.923;3600000;0
40113;141496;966;0;0;0;0;.00nan;0;0
40113;146684;975;73;50;4;46;.920;3600000;0
40114;4219;880;0;0;0;0;.00nan;0;0
40114;164710;957;72;27;2;25;.926;3600000;0
40114;147492;880;69;43;4;39;.907;3559000;0
40114;154414;957;0;0;0;0;.00nan;0;0
40115;8487;885;0;0;0;0;.00nan;0;0
40115;11670;885;86;23;1;22;.957;3600000;0
40115;80596;3965;0;0;0;0;.00nan;0;0
40115;149353;3965;88;43;3;40;.930;3573000;0
40116;9858;978;98;47;2;45;.957;3570000;0
40116;82245;872;0;0;0;0;.00nan;0;0
40116;90734;872;73;14;1;13;.929;3600000;0
40116;161255;978;0;0;0;0;.00nan;0;0
40117;7037;894;0;0;0;0;.00nan;0;0
40117;71075;890;0;0;0;0;.00nan;0;0
40117;146386;890;68;29;3;26;.897;3513000;0
40117;146445;894;87;26;1;25;.962;3600000;0
40118;192739;879;53;19;3;16;.842;3642000;0
40118;196055;945;0;0;0;0;.00nan;0;0
40118;83678;879;0;0;0;0;.00nan;0;0
40118;146479;945;99;49;2;47;.959;3642000;0
40119;192739;879;20;20;5;15;.750;3545000;0
40119;83678;879;0;0;0;0;.00nan;0;0
40119;147255;891;0;0;0;0;.00nan;0;0
40119;160932;891;53;31;4;27;.871;3600000;0
40120;4219;880;57;40;5;35;.875;3600000;0
40120;71075;890;78;27;2;25;.926;3600000;0
40120;146386;890;0;0;0;0;.00nan;0;0
40120;147492;880;0;0;0;0;.00nan;0;0
40121;196055;945;0;0;0;0;.00nan;0;0
40121;82245;872;0;0;0;0;.00nan;0;0
40121;90734;872;72;27;2;25;.926;3900000;0
40121;146479;945;98;49;2;47;.959;3900000;0
40122;7037;894;0;0;0;0;.00nan;0;0
40122;7624;975;97;40;1;39;.975;3589000;0
40122;146445;894;100;25;0;25;1.000;3600000;0
40122;146684;975;0;0;0;0;.00nan;0;0
40123;8487;885;0;0;0;0;.00nan;0;0
40123;164710;957;45;26;4;22;.846;3514000;0
40123;11670;885;98;38;2;36;.947;3600000;0
40123;154414;957;0;0;0;0;.00nan;0;0
40124;80596;3965;0;0;0;0;.00nan;0;0
40124;80834;897;0;0;0;0;.00nan;0;0
40124;149353;3965;81;49;4;45;.918;3600000;0
40124;159705;897;41;15;3;12;.800;3600000;0
40125;9858;978;43;20;4;16;.800;1175000;0
40125;164715;966;0;0;0;0;.00nan;0;0
40125;141496;966;100;30;0;30;1.000;3600000;0
40125;161255;978;78;30;2;28;.933;2425000;0
40126;4219;880;61;47;5;42;.894;3600000;0
40126;80834;897;64;24;2;22;.917;3600000;0
40126;147492;880;0;0;0;0;.00nan;0;0
40126;159705;897;0;0;0;0;.00nan;0;0
40127;80596;3965;91;28;1;27;.964;3600000;0
40127;147255;891;52;28;4;24;.857;3600000;0
40127;149353;3965;0;0;0;0;.00nan;0;0
40127;160932;891;0;0;0;0;.00nan;0;0
40128;8487;885;0;0;0;0;.00nan;0;0
40128;164715;966;0;0;0;0;.00nan;0;0
40128;11670;885;76;27;2;25;.926;3600000;0
40128;141496;966;85;21;1;20;.952;3600000;0
40129;164710;957;72;17;1;16;.941;3900000;0
40129;71075;890;0;0;0;0;.00nan;0;0
40129;146386;890;89;34;1;33;.971;3900000;0
40129;154414;957;0;0;0;0;.00nan;0;0
40130;192739;879;100;39;0;39;1.000;3600000;0
40130;82245;872;0;0;0;0;.00nan;0;0
40130;83678;879;0;0;0;0;.00nan;0;0
40130;90734;872;80;24;1;23;.958;3549000;0
40131;7624;975;60;32;3;29;.906;3600000;0
40131;9858;978;99;26;0;26;1.000;3600000;0
40131;146684;975;0;0;0;0;.00nan;0;0
40131;161255;978;0;0;0;0;.00nan;0;0
40132;7037;894;0;0;0;0;.00nan;0;0
40132;196055;945;0;0;0;0;.00nan;0;0
40132;146445;894;84;31;2;29;.935;3600000;0
40132;146479;945;69;31;3;28;.903;3559000;0
40133;80834;897;0;0;0;0;.00nan;0;0
40133;147255;891;0;0;0;0;.00nan;0;0
40133;159705;897;89;30;1;29;.967;3600000;0
40133;160932;891;49;33;4;29;.879;3600000;0
40134;9858;978;100;49;2;47;.959;3600000;0
40134;164710;957;25;17;5;12;.706;3600000;0
40134;154414;957;0;0;0;0;.00nan;0;0
40134;161255;978;0;0;0;0;.00nan;0;0
40135;7624;975;56;29;5;24;.828;3600000;0
40135;146684;975;0;0;0;0;.00nan;0;0
40135;147255;891;0;0;0;0;.00nan;0;0
40135;160932;891;40;21;4;17;.810;3600000;0
40136;192739;879;76;20;1;19;.950;3600000;0
40136;4219;880;97;43;2;41;.953;3549000;0
40136;83678;879;0;0;0;0;.00nan;0;0
40136;147492;880;0;0;0;0;.00nan;0;0
40137;71075;890;75;29;3;26;.897;3564000;0
40137;80596;3965;0;0;0;0;.00nan;0;0
40137;146386;890;0;0;0;0;.00nan;0;0
40137;149353;3965;92;27;1;26;.963;3600000;0
40138;80834;897;99;35;1;34;.971;3600000;0
40138;82245;872;0;0;0;0;.00nan;0;0
40138;90734;872;89;38;3;35;.921;3600000;0
40138;159705;897;0;0;0;0;.00nan;0;0
40139;7037;894;86;38;2;36;.947;3579000;0
40139;164715;966;0;0;0;0;.00nan;0;0
40139;141496;966;77;26;1;25;.962;3600000;0
40139;146445;894;0;0;0;0;.00nan;0;0
40140;8487;885;0;0;0;0;.00nan;0;0
40140;11670;885;61;31;4;27;.871;3577000;0
40140;196055;945;0;0;0;0;.00nan;0;0
40140;146479;945;71;35;3;32;.914;3600000;0
40141;4219;880;0;0;0;0;.00nan;0;0
40141;80596;3965;0;0;0;0;.00nan;0;0
40141;147492;880;59;22;2;20;.909;3600000;0
40141;149353;3965;54;33;4;29;.879;3563000;0
40142;164715;966;80;34;2;32;.941;3517000;0
40142;82245;872;0;0;0;0;.00nan;0;0
40142;90734;872;97;17;0;17;1.000;3600000;0
40142;141496;966;0;0;0;0;.00nan;0;0
40143;71075;890;0;0;0;0;.00nan;0;0
40143;146386;890;100;30;0;30;1.000;3600000;0
40143;147255;891;0;0;0;0;.00nan;0;0
40143;160932;891;49;29;4;25;.862;3600000;0
40144;7624;975;0;0;0;0;.00nan;0;0
40144;196055;945;0;0;0;0;.00nan;0;0
40144;146479;945;93;28;2;26;.929;3900000;0
40144;146684;975;68;26;2;24;.923;3900000;0
40145;7037;894;0;0;0;0;.00nan;0;0
40145;8487;885;0;0;0;0;.00nan;0;0
40145;11670;885;55;26;3;23;.885;3563000;0
40145;146445;894;100;43;2;41;.953;3600000;0
40146;164710;957;71;31;3;28;.903;3600000;0
40146;80834;897;73;25;2;23;.920;3600000;0
40146;154414;957;0;0;0;0;.00nan;0;0
40146;159705;897;0;0;0;0;.00nan;0;0
40147;192739;879;92;16;0;16;1.000;3600000;0
40147;9858;978;82;63;6;57;.905;3600000;0
40147;83678;879;0;0;0;0;.00nan;0;0
40147;161255;978;0;0;0;0;.00nan;0;0
40149;28701;966;0;0;0;0;.00nan;0;0
40149;80596;3965;0;0;0;0;.00nan;0;0
40149;147567;966;51;21;3;18;.857;3600000;0
40149;149353;3965;100;29;0;29;1.000;3600000;0
40151;164710;957;65;10;1;9;.900;3600000;0
40151;-1;975;92;65;2;63;.969;3578000;0
40151;146591;975;0;0;0;0;.00nan;0;0
40151;154414;957;0;0;0;0;.00nan;0;0
40153;7037;894;0;0;0;0;.00nan;0;0
40153;71075;890;81;43;3;40;.930;3600000;0
40153;146386;890;0;0;0;0;.00nan;0;0
40153;146445;894;92;23;0;23;1.000;3600000;0
40155;80834;897;0;0;0;0;.00nan;0;0
40155;83678;879;0;0;0;0;.00nan;0;0
40155;157295;879;86;23;0;23;1.000;3900000;0
40155;159705;897;100;33;0;33;1.000;3900000;0
40157;196055;945;0;0;0;0;.00nan;0;0
40157;82245;872;0;0;0;0;.00nan;0;0
40157;90734;872;70;25;2;23;.920;3600000;0
40157;146479;945;72;56;6;50;.893;3600000;0
40159;9858;978;0;0;0;0;.00nan;0;0
40159;11670;885;36;24;5;19;.792;3600000;0
40159;151940;885;0;0;0;0;.00nan;0;0
40159;161255;978;100;44;0;44;1.000;3600000;0
40161;4219;880;72;25;2;23;.920;3600000;0
40161;147255;891;0;0;0;0;.00nan;0;0
40161;147492;880;0;0;0;0;.00nan;0;0
40161;160932;891;46;21;3;18;.857;3542000;0
40163;82245;872;0;0;0;0;.00nan;0;0
40163;83678;879;0;0;0;0;.00nan;0;0
40163;90734;872;76;24;1;23;.958;3555000;0
40163;157295;879;100;33;0;33;1.000;3600000;0
40165;4219;880;83;38;3;35;.921;3900000;0
40165;80834;897;0;0;0;0;.00nan;0;0
40165;147492;880;0;0;0;0;.00nan;0;0
40165;159705;897;72;40;3;37;.925;3900000;0
40167;9858;978;0;0;0;0;.00nan;0;0
40167;147255;891;0;0;0;0;.00nan;0;0
40167;160932;891;64;23;2;21;.913;3600000;0
40167;161255;978;52;33;4;29;.879;3541000;0
40169;71075;890;0;0;0;0;.00nan;0;0
40169;80596;3965;0;0;0;0;.00nan;0;0
40169;146386;890;62;18;2;16;.889;3741000;0
40169;149353;3965;86;41;3;38;.927;3741000;0
40171;196055;945;0;0;0;0;.00nan;0;0
40171;-1;975;0;0;0;0;.00nan;0;0
40171;146479;945;69;30;2;28;.933;3591000;0
40171;146591;975;99;46;1;45;.978;3600000;0
40173;7037;894;0;0;0;0;.00nan;0;0
40173;164710;957;0;0;0;0;.00nan;0;0
40173;146445;894;79;58;4;54;.931;3600000;0
40173;154414;957;100;29;0;29;1.000;3600000;0
40175;11670;885;88;31;1;30;.968;3600000;0
40175;28701;966;56;34;5;29;.853;3600000;0
40175;147567;966;0;0;0;0;.00nan;0;0
40175;151940;885;0;0;0;0;.00nan;0;0
40177;196055;945;43;17;3;14;.824;3545000;0
40177;-1;975;99;58;2;56;.966;3600000;0
40177;146479;945;0;0;0;0;.00nan;0;0
40177;146591;975;0;0;0;0;.00nan;0;0
40179;7037;894;54;22;3;19;.864;3532000;0
40179;11670;885;0;0;0;0;.00nan;0;0
40179;146445;894;0;0;0;0;.00nan;0;0
40179;151940;885;76;23;1;22;.957;3600000;0
40181;71075;890;92;43;2;41;.953;3600000;0
40181;83678;879;0;0;0;0;.00nan;0;0
40181;146386;890;0;0;0;0;.00nan;0;0
40181;157295;879;66;32;3;29;.906;3600000;0
40183;4219;880;0;0;0;0;.00nan;0;0
40183;9858;978;51;33;5;28;.848;3600000;0
40183;147492;880;95;42;1;41;.976;3600000;0
40183;161255;978;0;0;0;0;.00nan;0;0
40185;28701;966;0;0;0;0;.00nan;0;0
40185;147255;891;69;34;3;31;.912;3769000;0
40185;147567;966;69;26;2;24;.923;3769000;0
40185;160932;891;0;0;0;0;.00nan;0;0
40187;164710;957;0;0;0;0;.00nan;0;0
40187;80834;897;66;33;3;30;.909;3600000;0
40187;154414;957;36;28;5;23;.821;3560000;0
40187;159705;897;0;0;0;0;.00nan;0;0
40189;80596;3965;98;49;2;47;.959;3900000;0
40189;82245;872;66;29;2;27;.931;3900000;0
40189;90734;872;0;0;0;0;.00nan;0;0
40189;149353;3965;0;0;0;0;.00nan;0;0
40191;9858;978;0;0;0;0;.00nan;0;0
40191;11670;885;55;19;2;17;.895;3600000;0
40191;151940;885;0;0;0;0;.00nan;0;0
40191;161255;978;50;38;5;33;.868;3600000;0
40193;196055;945;0;0;0;0;.00nan;0;0
40193;80834;897;0;0;0;0;.00nan;0;0
40193;146479;945;91;37;2;35;.946;3514000;0
40193;159705;897;100;24;0;24;1.000;3600000;0
40195;164710;957;0;0;0;0;.00nan;0;0
40195;147255;891;77;38;3;35;.921;3600000;0
40195;154414;957;65;20;2;18;.900;3600000;0
40195;160932;891;0;0;0;0;.00nan;0;0
40197;4219;880;0;0;0;0;.00nan;0;0
40197;7037;894;49;8;1;7;.875;965000;0
40197;146445;894;22;29;7;22;.759;2635000;0
40197;147492;880;80;25;1;24;.960;3600000;0
40199;28701;966;0;0;0;0;.00nan;0;0
40199;71075;890;97;39;1;38;.974;3580000;0
40199;146386;890;0;0;0;0;.00nan;0;0
40199;147567;966;97;21;0;21;1.000;3600000;0
40201;82245;872;0;0;0;0;.00nan;0;0
40201;83678;879;0;0;0;0;.00nan;0;0
40201;90734;872;94;32;1;31;.969;3600000;0
40201;157295;879;78;44;4;40;.909;3600000;0
40203;-1;975;37;49;8;41;.837;3600000;0
40203;80596;3965;0;0;0;0;.00nan;0;0
40203;146591;975;0;0;0;0;.00nan;0;0
40203;149353;3965;72;29;2;27;.931;3600000;0
40205;7037;894;92;33;1;32;.970;3600000;0
40205;196055;945;30;28;6;22;.786;2883000;0
40205;146445;894;0;0;0;0;.00nan;0;0
40205;146479;945;54;14;1;13;.929;717000;0
40207;4219;880;48;26;3;23;.885;3530000;0
40207;28701;966;82;22;1;21;.955;3600000;0
40207;147492;880;0;0;0;0;.00nan;0;0
40207;147567;966;0;0;0;0;.00nan;0;0
40209;11670;885;0;0;0;0;.00nan;0;0
40209;80596;3965;62;32;4;28;.875;3600000;0
40209;149353;3965;0;0;0;0;.00nan;0;0
40209;151940;885;68;22;2;20;.909;3600000;0
40211;164710;957;69;16;1;15;.938;3600000;0
40211;-1;975;0;0;0;0;.00nan;0;0
40211;146591;975;83;57;4;53;.930;3600000;0
40211;154414;957;0;0;0;0;.00nan;0;0
40213;71075;890;0;0;0;0;.00nan;0;0
40213;83678;879;49;19;3;16;.842;3842000;0
40213;146386;890;65;39;4;35;.897;3842000;0
40213;157295;879;0;0;0;0;.00nan;0;0
40215;80834;897;0;0;0;0;.00nan;0;0
40215;82245;872;55;27;3;24;.889;3900000;0
40215;90734;872;0;0;0;0;.00nan;0;0
40215;159705;897;62;29;3;26;.897;3900000;0
40217;9858;978;64;39;4;35;.897;3545000;0
40217;147255;891;0;0;0;0;.00nan;0;0
40217;160932;891;55;20;2;18;.900;3600000;0
40217;161255;978;0;0;0;0;.00nan;0;0
40219;71075;890;39;31;5;26;.839;3600000;0
40219;80834;897;0;0;0;0;.00nan;0;0
40219;146386;890;0;0;0;0;.00nan;0;0
40219;159705;897;100;25;0;25;1.000;3600000;0
40221;28701;966;0;0;0;0;.00nan;0;0
40221;196055;945;0;0;0;0;.00nan;0;0
40221;146479;945;85;37;2;35;.946;3566000;0
40221;147567;966;95;22;0;22;1.000;3600000;0
40223;11670;885;93;16;0;16;1.000;3600000;0
40223;83678;879;0;0;0;0;.00nan;0;0
40223;151940;885;0;0;0;0;.00nan;0;0
40223;157295;879;78;31;3;28;.903;3600000;0
40225;4219;880;0;0;0;0;.00nan;0;0
40225;7037;894;0;0;0;0;.00nan;0;0
40225;146445;894;54;25;3;22;.880;3600000;0
40225;147492;880;59;31;4;27;.871;3544000;0
40227;-1;975;57;52;6;46;.885;2700000;0
40227;82245;872;0;0;0;0;.00nan;0;0
40227;90734;872;68;8;0;8;1.000;3600000;0
40227;146591;975;61;10;0;10;1.000;900000;0
40229;164710;957;0;0;0;0;.00nan;0;0
40229;80596;3965;0;0;0;0;.00nan;0;0
40229;149353;3965;92;51;2;49;.961;3833000;0
40229;154414;957;53;10;1;9;.900;3833000;0
40231;9858;978;0;0;0;0;.00nan;0;0
40231;147255;891;65;26;2;24;.923;3600000;0
40231;160932;891;0;0;0;0;.00nan;0;0
40231;161255;978;79;42;4;38;.905;3591000;0
40233;7037;894;48;35;5;30;.857;3600000;0
40233;164710;957;55;11;1;10;.909;3600000;0
40233;146445;894;0;0;0;0;.00nan;0;0
40233;154414;957;0;0;0;0;.00nan;0;0
40235;196055;945;95;40;2;38;.950;3568000;0
40235;83678;879;66;18;1;17;.944;3600000;0
40235;146479;945;0;0;0;0;.00nan;0;0
40235;157295;879;0;0;0;0;.00nan;0;0
40237;9858;978;79;38;3;35;.921;3828000;0
40237;147255;891;0;0;0;0;.00nan;0;0
40237;160932;891;74;36;4;32;.889;3828000;0
40237;161255;978;0;0;0;0;.00nan;0;0
40239;-1;975;0;0;0;0;.00nan;0;0
40239;82245;872;0;0;0;0;.00nan;0;0
40239;90734;872;79;9;0;9;1.000;3600000;0
40239;146591;975;91;50;4;46;.920;3600000;0
40241;11670;885;53;25;3;22;.880;3900000;0
40241;80596;3965;100;49;3;46;.939;3900000;0
40241;149353;3965;0;0;0;0;.00nan;0;0
40241;151940;885;0;0;0;0;.00nan;0;0
40243;4219;880;98;42;2;40;.952;3600000;0
40243;80834;897;0;0;0;0;.00nan;0;0
40243;147492;880;0;0;0;0;.00nan;0;0
40243;159705;897;73;19;1;18;.947;3600000;0
40245;28701;966;92;28;1;27;.964;3600000;0
40245;71075;890;0;0;0;0;.00nan;0;0
40245;146386;890;52;31;4;27;.871;3600000;0
40245;147567;966;0;0;0;0;.00nan;0;0
1228;7037;894;0;0;0;0;.00nan;0;0
1228;9858;978;99;78;3;75;.962;5487000;0
1228;146445;894;64;40;4;36;.900;5495000;0
1228;161255;978;0;0;0;0;.00nan;0;0
1229;71075;890;0;0;0;0;.00nan;0;0
1229;146386;890;93;41;2;39;.951;4458000;0
1229;147255;891;0;0;0;0;.00nan;0;0
1229;160932;891;78;27;1;26;.963;4458000;0
1230;7037;894;0;0;0;0;.00nan;0;0
1230;9858;978;0;0;0;0;.00nan;0;0
1230;146445;894;97;43;1;42;.977;3600000;0
1230;161255;978;46;21;4;17;.810;3600000;0
1231;71075;890;0;0;0;0;.00nan;0;0
1231;146386;890;74;33;3;30;.909;3600000;0
1231;147255;891;0;0;0;0;.00nan;0;0
1231;160932;891;92;24;0;24;1.000;3600000;0
1363;7037;894;0;0;0;0;.00nan;0;0
1363;9858;978;0;0;0;0;.00nan;0;0
1363;146445;894;100;22;0;22;1.000;3600000;0
1363;161255;978;88;30;2;28;.933;3530000;0
1462;80834;897;70;19;1;18;.947;3600000;0
1462;147255;891;44;6;1;5;.833;1183000;0
1462;159705;897;0;0;0;0;.00nan;0;0
1462;160932;891;44;34;6;28;.824;2417000;0
1463;8487;885;79;27;1;26;.963;2428000;0
1463;11670;885;34;17;4;13;.765;1172000;0
1463;82245;872;0;0;0;0;.00nan;0;0
1463;90734;872;100;27;0;27;1.000;3600000;0
1464;192739;879;84;28;1;27;.964;3600000;0
1464;164715;966;0;0;0;0;.00nan;0;0
1464;83678;879;0;0;0;0;.00nan;0;0
1464;141496;966;58;27;3;24;.889;3594000;0
1465;7037;894;0;0;0;0;.00nan;0;0
1465;164710;957;94;26;1;25;.962;3600000;0
1465;146445;894;75;34;3;31;.912;3563000;0
1465;154414;957;0;0;0;0;.00nan;0;0
1466;80834;897;64;21;2;19;.905;3600000;0
1466;147255;891;0;0;0;0;.00nan;0;0
1466;159705;897;0;0;0;0;.00nan;0;0
1466;160932;891;93;40;3;37;.925;3557000;0
1467;8487;885;0;0;0;0;.00nan;0;0
1467;11670;885;53;33;4;29;.879;3574000;0
1467;82245;872;0;0;0;0;.00nan;0;0
1467;90734;872;71;26;2;24;.923;3600000;0
1468;192739;879;91;27;1;26;.963;3600000;0
1468;164715;966;0;0;0;0;.00nan;0;0
1468;83678;879;0;0;0;0;.00nan;0;0
1468;141496;966;49;24;4;20;.833;3600000;0
1469;7037;894;0;0;0;0;.00nan;0;0
1469;164710;957;80;24;1;23;.958;3600000;0
1469;146445;894;76;29;2;27;.931;3594000;0
1469;154414;957;0;0;0;0;.00nan;0;0
1470;80834;897;70;28;2;26;.929;3545000;0
1470;147255;891;0;0;0;0;.00nan;0;0
1470;159705;897;0;0;0;0;.00nan;0;0
1470;160932;891;100;45;1;44;.978;3600000;0
1471;8487;885;0;0;0;0;.00nan;0;0
1471;11670;885;83;32;1;31;.969;3600000;0
1471;82245;872;0;0;0;0;.00nan;0;0
1471;90734;872;43;22;4;18;.818;3600000;0
1472;192739;879;60;26;3;23;.885;3557000;0
1472;164715;966;0;0;0;0;.00nan;0;0
1472;83678;879;0;0;0;0;.00nan;0;0
1472;141496;966;75;27;2;25;.926;3600000;0
1473;7037;894;0;0;0;0;.00nan;0;0
1473;164710;957;81;25;1;24;.960;3600000;0
1473;146445;894;95;44;2;42;.955;3586000;0
1473;154414;957;0;0;0;0;.00nan;0;0
1474;80834;897;76;43;3;40;.930;5323000;0
1474;147255;891;0;0;0;0;.00nan;0;0
1474;159705;897;0;0;0;0;.00nan;0;0
1474;160932;891;77;43;4;39;.907;5323000;0
1475;8487;885;0;0;0;0;.00nan;0;0
1475;11670;885;81;34;3;31;.912;3600000;0
1475;82245;872;0;0;0;0;.00nan;0;0
1475;90734;872;57;32;5;27;.844;3515000;0
1476;192739;879;75;21;1;20;.952;3600000;0
1476;164715;966;82;20;0;20;1.000;1539000;0
1476;83678;879;0;0;0;0;.00nan;0;0
1476;141496;966;32;15;4;11;.733;2061000;0
1477;7037;894;0;0;0;0;.00nan;0;0
1477;164710;957;52;35;5;30;.857;3600000;0
1477;146445;894;87;25;1;24;.960;3600000;0
1477;154414;957;0;0;0;0;.00nan;0;0
1606;80834;897;77;25;1;24;.960;3600000;0
1606;147255;891;0;0;0;0;.00nan;0;0
1606;159705;897;0;0;0;0;.00nan;0;0
1606;160932;891;66;30;3;27;.900;3600000;0
1607;8487;885;0;0;0;0;.00nan;0;0
1607;11670;885;68;38;4;34;.895;3551000;0
1607;82245;872;0;0;0;0;.00nan;0;0
1607;90734;872;82;34;2;32;.941;3600000;0
1608;192739;879;67;19;1;18;.947;3566000;0
1608;164715;966;0;0;0;0;.00nan;0;0
1608;83678;879;0;0;0;0;.00nan;0;0
1608;141496;966;95;22;0;22;1.000;3600000;0
1609;7037;894;0;0;0;0;.00nan;0;0
1609;164710;957;56;26;3;23;.885;4432000;0
1609;146445;894;83;48;4;44;.917;4432000;0
1609;154414;957;0;0;0;0;.00nan;0;0
1643;8487;885;0;0;0;0;.00nan;0;0
1643;11670;885;50;32;5;27;.844;3600000;0
1643;82245;872;0;0;0;0;.00nan;0;0
1643;90734;872;66;21;2;19;.905;3600000;0
1644;192739;879;54;19;3;16;.842;3945000;0
1644;164715;966;0;0;0;0;.00nan;0;0
1644;83678;879;0;0;0;0;.00nan;0;0
1644;141496;966;75;42;4;38;.905;3945000;0
1776;192739;879;44;23;4;19;.826;3560000;0
1776;80834;897;72;25;2;23;.920;3600000;0
1776;83678;879;0;0;0;0;.00nan;0;0
1776;159705;897;0;0;0;0;.00nan;0;0
1777;164710;957;89;43;3;40;.930;3580000;0
1777;82245;872;0;0;0;0;.00nan;0;0
1777;90734;872;69;27;2;25;.926;3600000;0
1777;154414;957;0;0;0;0;.00nan;0;0
1778;192739;879;69;26;3;23;.885;3600000;0
1778;80834;897;66;39;4;35;.897;3558000;0
1778;83678;879;0;0;0;0;.00nan;0;0
1778;159705;897;0;0;0;0;.00nan;0;0
1779;164710;957;53;38;6;32;.842;2705000;0
1779;82245;872;0;0;0;0;.00nan;0;0
1779;90734;872;80;22;1;21;.955;3600000;0
1779;154414;957;50;1;0;1;1.000;895000;0
1780;192739;879;98;21;0;21;1.000;3600000;0
1780;80834;897;69;32;3;29;.906;3600000;0
1780;83678;879;0;0;0;0;.00nan;0;0
1780;159705;897;0;0;0;0;.00nan;0;0
1781;164710;957;93;33;2;31;.939;3560000;0
1781;82245;872;0;0;0;0;.00nan;0;0
1781;90734;872;89;25;1;24;.960;3600000;0
1781;154414;957;0;0;0;0;.00nan;0;0
1782;192739;879;70;30;3;27;.900;3524000;0
1782;80834;897;100;32;1;31;.969;3600000;0
1782;83678;879;0;0;0;0;.00nan;0;0
1782;159705;897;0;0;0;0;.00nan;0;0
1783;164710;957;100;34;0;34;1.000;3600000;0
1783;82245;872;0;0;0;0;.00nan;0;0
1783;90734;872;77;19;1;18;.947;3561000;0
1783;154414;957;0;0;0;0;.00nan;0;0
1917;192739;879;58;34;5;29;.853;3850000;0
1917;80834;897;80;47;6;41;.872;3850000;0
1917;83678;879;0;0;0;0;.00nan;0;0
1917;159705;897;0;0;0;0;.00nan;0;0
1918;164710;957;91;39;2;37;.949;3575000;0
1918;82245;872;0;0;0;0;.00nan;0;0
1918;90734;872;68;18;1;17;.944;3600000;0
1918;154414;957;0;0;0;0;.00nan;0;0
1949;192739;879;84;25;1;24;.960;3767000;0
1949;80834;897;92;45;2;43;.956;3767000;0
1949;83678;879;0;0;0;0;.00nan;0;0
1949;159705;897;0;0;0;0;.00nan;0;0
1982;192739;879;100;25;0;25;1.000;3600000;0
1982;82245;872;0;0;0;0;.00nan;0;0
1982;83678;879;0;0;0;0;.00nan;0;0
1982;90734;872;34;19;4;15;.789;3600000;0
1983;192739;879;44;38;6;32;.842;3225000;0
1983;82245;872;0;0;0;0;.00nan;0;0
1983;83678;879;49;1;0;1;1.000;375000;0
1983;90734;872;93;33;2;31;.939;3600000;0
1984;192739;879;74;42;4;38;.905;3555000;0
1984;82245;872;0;0;0;0;.00nan;0;0
1984;83678;879;0;0;0;0;.00nan;0;0
1984;90734;872;77;28;3;25;.893;3600000;0
1985;192739;879;69;25;2;23;.920;3581000;0
1985;82245;872;0;0;0;0;.00nan;0;0
1985;83678;879;0;0;0;0;.00nan;0;0
1985;90734;872;100;30;0;30;1.000;3600000;0
2163;192739;879;75;35;3;32;.914;3593000;0
2163;82245;872;0;0;0;0;.00nan;0;0
2163;83678;879;0;0;0;0;.00nan;0;0
2163;90734;872;70;24;2;22;.917;3600000;0
40246;201075;760;59;15;2;13;.867;3600000;0
40246;175761;769;0;0;0;0;.00nan;0;0
40246;142810;760;0;0;0;0;.00nan;0;0
40246;145463;769;42;36;5;31;.861;3600000;0
40247;177124;775;77;33;2;31;.939;3600000;0
40247;-1;2199;51;29;4;25;.862;3551000;0
40247;80222;2199;0;0;0;0;.00nan;0;0
40247;146249;775;0;0;0;0;.00nan;0;0
40248;164424;772;62;22;3;19;.864;3900000;0
40248;11708;772;0;0;0;0;.00nan;0;0
40248;189264;4923;79;33;3;30;.909;3900000;0
40248;82711;4923;0;0;0;0;.00nan;0;0
40249;174894;754;72;40;4;36;.900;3600000;0
40249;212428;750;0;0;0;0;.00nan;0;0
40249;180738;750;30;34;7;27;.794;3600000;0
40249;207194;754;0;0;0;0;.00nan;0;0
40250;166226;1093;80;29;2;27;.931;3053000;0
40250;171113;759;0;0;0;0;.00nan;0;0
40250;176686;759;63;21;3;18;.857;3600000;0
40250;149103;1093;29;8;3;5;.625;532000;0
40251;1756;4989;62;34;4;30;.882;3579000;0
40251;169680;3730;98;49;2;47;.959;3600000;0
40251;190570;4989;0;0;0;0;.00nan;0;0
40251;149112;3730;0;0;0;0;.00nan;0;0
40252;162979;746;100;28;0;28;1.000;3600000;0
40252;8504;768;60;33;5;28;.848;3600000;0
40252;149191;746;0;0;0;0;.00nan;0;0
40252;149280;768;0;0;0;0;.00nan;0;0
40253;188815;762;56;28;3;25;.893;3581000;0
40253;180133;1492;0;0;0;0;.00nan;0;0
40253;181910;1492;83;26;2;24;.923;3600000;0
40253;186234;762;0;0;0;0;.00nan;0;0
40254;31;755;0;0;0;0;.00nan;0;0
40254;180154;755;65;20;2;18;.900;3544000;0
40254;180188;4924;100;28;0;28;1.000;3600000;0
40254;-1;4924;0;0;0;0;.00nan;0;0
40255;177356;2545;0;0;0;0;.00nan;0;0
40255;201075;760;37;21;4;17;.810;3527000;0
40255;142810;760;0;0;0;0;.00nan;0;0
40255;149048;2545;98;34;2;32;.941;3600000;0
40256;193545;774;0;0;0;0;.00nan;0;0
40256;-1;911;63;25;2;23;.920;3900000;0
40256;174858;911;0;0;0;0;.00nan;0;0
40256;201933;774;76;29;2;27;.931;3900000;0
40257;174898;1503;53;11;1;10;.909;3600000;0
40257;175761;769;0;0;0;0;.00nan;0;0
40257;192386;1503;0;0;0;0;.00nan;0;0
40257;145463;769;67;37;4;33;.892;3600000;0
40258;170530;766;70;24;2;22;.917;3748000;0
40258;187348;766;0;0;0;0;.00nan;0;0
40258;63932;3913;100;40;1;39;.975;3739000;0
40258;148576;3913;0;0;0;0;.00nan;0;0
40259;166226;1093;0;0;0;0;.00nan;0;0
40259;-1;2199;0;0;0;0;.00nan;0;0
40259;80222;2199;82;25;1;24;.960;3600000;0
40259;149103;1093;58;33;4;29;.879;3600000;0
40260;164521;3721;0;0;0;0;.00nan;0;0
40260;188815;762;73;17;1;16;.941;3600000;0
40260;186234;762;0;0;0;0;.00nan;0;0
40260;67818;3721;75;34;2;32;.941;3546000;0
40261;177124;775;60;53;6;47;.887;3148000;0
40261;171113;759;0;0;0;0;.00nan;0;0
40261;176686;759;51;26;4;22;.846;3600000;0
40261;146249;775;54;3;0;3;1.000;366000;0
40262;1756;4989;0;0;0;0;.00nan;0;0
40262;8504;768;66;21;2;19;.905;3600000;0
40262;190570;4989;98;61;3;58;.951;3544000;0
40262;149280;768;0;0;0;0;.00nan;0;0
40263;162979;746;76;18;1;17;.944;3600000;0
40263;169680;3730;74;57;6;51;.895;3600000;0
40263;149112;3730;0;0;0;0;.00nan;0;0
40263;149191;746;0;0;0;0;.00nan;0;0
40264;166023;767;0;0;0;0;.00nan;0;0
40264;180133;1492;0;0;0;0;.00nan;0;0
40264;181910;1492;90;44;3;41;.932;3517000;0
40264;149262;767;60;15;1;14;.933;3600000;0
40265;11882;758;41;27;5;22;.815;3600000;0
40265;170530;766;52;23;3;20;.870;3600000;0
40265;187348;766;0;0;0;0;.00nan;0;0
40265;93756;758;0;0;0;0;.00nan;0;0
40266;201075;760;68;29;2;27;.931;3900000;0
40266;175757;1497;66;19;2;17;.895;3900000;0
40266;67446;1497;0;0;0;0;.00nan;0;0
40266;142810;760;0;0;0;0;.00nan;0;0
40267;-1;911;55;18;2;16;.889;3564000;0
40267;174858;911;0;0;0;0;.00nan;0;0
40267;190589;2197;97;36;1;35;.972;3600000;0
40267;82817;2197;0;0;0;0;.00nan;0;0
40268;177356;2545;0;0;0;0;.00nan;0;0
40268;174898;1503;86;34;2;32;.941;3544000;0
40268;192386;1503;0;0;0;0;.00nan;0;0
40268;149048;2545;80;25;1;24;.960;3600000;0
40269;175761;769;67;29;2;27;.931;3600000;0
40269;63932;3913;62;32;3;29;.906;3549000;0
40269;145463;769;0;0;0;0;.00nan;0;0
40269;148576;3913;0;0;0;0;.00nan;0;0
40270;164521;3721;0;0;0;0;.00nan;0;0
40270;166023;767;0;0;0;0;.00nan;0;0
40270;67818;3721;68;36;3;33;.917;3600000;0
40270;149262;767;100;24;0;24;1.000;3600000;0
40271;188815;762;57;36;4;32;.889;3600000;0
40271;212428;750;0;0;0;0;.00nan;0;0
40271;180738;750;60;13;1;12;.923;3600000;0
40271;186234;762;0;0;0;0;.00nan;0;0
40272;1756;4989;0;0;0;0;.00nan;0;0
40272;164424;772;90;29;1;28;.966;3600000;0
40272;11708;772;0;0;0;0;.00nan;0;0
40272;190570;4989;54;32;4;28;.875;3600000;0
40273;162979;746;100;26;0;26;1.000;3600000;0
40273;189264;4923;58;39;4;35;.897;3600000;0
40273;82711;4923;0;0;0;0;.00nan;0;0
40273;149191;746;0;0;0;0;.00nan;0;0
40274;180133;1492;59;27;3;24;.889;3900000;0
40274;180188;4924;70;35;3;32;.914;3900000;0
40274;181910;1492;0;0;0;0;.00nan;0;0
40274;-1;4924;0;0;0;0;.00nan;0;0
40275;11882;758;50;16;2;14;.875;3600000;0
40275;175761;769;59;5;0;5;1.000;404000;0
40275;93756;758;0;0;0;0;.00nan;0;0
40275;145463;769;27;37;7;30;.811;3196000;0
40276;193545;774;96;31;0;31;1.000;3900000;0
40276;201933;774;0;0;0;0;.00nan;0;0
40276;190589;2197;100;32;0;32;1.000;3900000;0
40276;82817;2197;0;0;0;0;.00nan;0;0
40277;170530;766;79;15;0;15;1.000;3600000;0
40277;201075;760;0;0;0;0;.00nan;0;0
40277;187348;766;0;0;0;0;.00nan;0;0
40277;142810;760;88;32;1;31;.969;3546000;0
40278;174898;1503;75;23;1;22;.957;3600000;0
40278;175757;1497;68;31;4;27;.871;3600000;0
40278;192386;1503;0;0;0;0;.00nan;0;0
40278;67446;1497;0;0;0;0;.00nan;0;0
40279;177356;2545;0;0;0;0;.00nan;0;0
40279;63932;3913;40;30;6;24;.800;2548000;0
40279;148576;3913;76;16;0;16;1.000;1052000;0
40279;149048;2545;59;20;2;18;.900;3600000;0
40280;166226;1093;0;0;0;0;.00nan;0;0
40280;169680;3730;91;39;2;37;.949;3600000;0
40280;149103;1093;78;36;3;33;.917;3600000;0
40280;149112;3730;0;0;0;0;.00nan;0;0
40281;164521;3721;91;34;3;31;.912;3600000;0
40281;180188;4924;47;33;5;28;.848;3600000;0
40281;-1;4924;0;0;0;0;.00nan;0;0
40281;67818;3721;0;0;0;0;.00nan;0;0
40282;166023;767;0;0;0;0;.00nan;0;0
40282;212428;750;0;0;0;0;.00nan;0;0
40282;180738;750;86;16;0;16;1.000;3600000;0
40282;149262;767;84;31;1;30;.968;3587000;0
40283;171113;759;0;0;0;0;.00nan;0;0
40283;176686;759;65;36;4;32;.889;3808000;0
40283;-1;2199;0;0;0;0;.00nan;0;0
40283;80222;2199;83;41;3;38;.927;3808000;0
40284;1756;4989;0;0;0;0;.00nan;0;0
40284;189264;4923;72;23;1;22;.957;3600000;0
40284;190570;4989;92;41;2;39;.951;3580000;0
40284;82711;4923;0;0;0;0;.00nan;0;0
40285;162979;746;62;34;4;30;.882;3900000;0
40285;164424;772;100;46;4;42;.913;3900000;0
40285;11708;772;0;0;0;0;.00nan;0;0
40285;149191;746;0;0;0;0;.00nan;0;0
40286;188815;762;63;35;3;32;.914;3578000;0
40286;174894;754;73;23;2;21;.913;3600000;0
40286;207194;754;0;0;0;0;.00nan;0;0
40286;186234;762;0;0;0;0;.00nan;0;0
40287;31;755;0;0;0;0;.00nan;0;0
40287;180133;1492;0;0;0;0;.00nan;0;0
40287;180154;755;88;33;2;31;.939;3600000;0
40287;181910;1492;50;20;3;17;.850;3560000;0
40288;177356;2545;0;0;0;0;.00nan;0;0
40288;11882;758;56;17;2;15;.882;3600000;0
40288;93756;758;0;0;0;0;.00nan;0;0
40288;149048;2545;45;29;5;24;.828;3600000;0
40289;170530;766;48;25;4;21;.840;3600000;0
40289;174898;1503;0;0;0;0;.00nan;0;0
40289;187348;766;0;0;0;0;.00nan;0;0
40289;192386;1503;74;28;2;26;.929;3600000;0
40290;175757;1497;0;0;0;0;.00nan;0;0
40290;63932;3913;76;22;1;21;.955;3600000;0
40290;67446;1497;62;23;2;21;.913;3600000;0
40290;148576;3913;0;0;0;0;.00nan;0;0
40291;177124;775;88;18;0;18;1.000;3600000;0
40291;169680;3730;79;36;2;34;.944;3511000;0
40291;146249;775;0;0;0;0;.00nan;0;0
40291;149112;3730;0;0;0;0;.00nan;0;0
40292;31;755;0;0;0;0;.00nan;0;0
40292;164521;3721;0;0;0;0;.00nan;0;0
40292;180154;755;56;28;5;23;.821;3900000;0
40292;67818;3721;36;31;5;26;.839;3900000;0
40293;8504;768;84;18;0;18;1.000;3600000;0
40293;166226;1093;52;27;4;23;.852;2498000;0
40293;149103;1093;33;18;4;14;.778;1102000;0
40293;149280;768;0;0;0;0;.00nan;0;0
40294;180188;4924;70;23;1;22;.957;3600000;0
40294;212428;750;0;0;0;0;.00nan;0;0
40294;180738;750;84;33;2;31;.939;3599000;0
40294;-1;4924;0;0;0;0;.00nan;0;0
40295;166023;767;74;22;1;21;.955;3548000;0
40295;174894;754;0;0;0;0;.00nan;0;0
40295;207194;754;100;37;0;37;1.000;3600000;0
40295;149262;767;0;0;0;0;.00nan;0;0
40296;11882;758;0;0;0;0;.00nan;0;0
40296;175757;1497;43;33;6;27;.818;3600000;0
40296;67446;1497;0;0;0;0;.00nan;0;0
40296;93756;758;60;22;2;20;.909;3600000;0
40297;-1;911;64;18;1;17;.944;3600000;0
40297;201075;760;88;36;3;33;.917;3599000;0
40297;174858;911;0;0;0;0;.00nan;0;0
40297;142810;760;0;0;0;0;.00nan;0;0
40298;169680;3730;92;58;3;55;.948;3900000;0
40298;171113;759;0;0;0;0;.00nan;0;0
40298;176686;759;66;25;3;22;.880;3900000;0
40298;149112;3730;0;0;0;0;.00nan;0;0
40299;166226;1093;0;0;0;0;.00nan;0;0
40299;189264;4923;85;30;2;28;.933;3600000;0
40299;82711;4923;0;0;0;0;.00nan;0;0
40299;149103;1093;61;26;3;23;.885;3544000;0
40300;177124;775;95;49;3;46;.939;3600000;0
40300;8504;768;67;13;1;12;.923;3600000;0
40300;146249;775;0;0;0;0;.00nan;0;0
40300;149280;768;0;0;0;0;.00nan;0;0
40301;164424;772;78;29;2;27;.931;3600000;0
40301;11708;772;0;0;0;0;.00nan;0;0
40301;-1;2199;0;0;0;0;.00nan;0;0
40301;80222;2199;53;26;4;22;.846;3523000;0
40302;31;755;0;0;0;0;.00nan;0;0
40302;180154;755;94;36;2;34;.944;3778000;0
40302;212428;750;0;0;0;0;.00nan;0;0
40302;180738;750;78;26;3;23;.885;3778000;0
40303;175761;769;78;32;2;30;.938;3900000;0
40303;180133;1492;0;0;0;0;.00nan;0;0
40303;181910;1492;66;27;2;25;.926;3900000;0
40303;145463;769;0;0;0;0;.00nan;0;0
40304;174894;754;38;32;5;27;.844;3600000;0
40304;180188;4924;68;24;2;22;.917;3600000;0
40304;207194;754;0;0;0;0;.00nan;0;0
40304;-1;4924;0;0;0;0;.00nan;0;0
40305;162979;746;75;18;1;17;.944;3600000;0
40305;188815;762;0;0;0;0;.00nan;0;0
40305;186234;762;61;38;4;34;.895;3600000;0
40305;149191;746;0;0;0;0;.00nan;0;0
40306;193545;774;72;26;2;24;.923;3900000;0
40306;201075;760;88;30;2;28;.933;3900000;0
40306;201933;774;0;0;0;0;.00nan;0;0
40306;142810;760;0;0;0;0;.00nan;0;0
40307;-1;911;0;0;0;0;.00nan;0;0
40307;174858;911;51;32;5;27;.844;3600000;0
40307;174898;1503;100;32;0;32;1.000;3600000;0
40307;192386;1503;0;0;0;0;.00nan;0;0
40308;169680;3730;80;39;3;36;.923;3572000;0
40308;-1;2199;0;0;0;0;.00nan;0;0
40308;80222;2199;66;25;2;23;.920;3600000;0
40308;149112;3730;0;0;0;0;.00nan;0;0
40309;177124;775;83;29;1;28;.966;3573000;0
40309;189264;4923;100;38;0;38;1.000;3600000;0
40309;179406;4923;0;0;0;0;.00nan;0;0
40309;146249;775;0;0;0;0;.00nan;0;0
40310;8504;768;0;0;0;0;.00nan;0;0
40310;171113;759;0;0;0;0;.00nan;0;0
40310;176686;759;68;28;2;26;.929;3577000;0
40310;149280;768;94;31;1;30;.968;3600000;0
40311;164424;772;78;32;2;30;.938;3600000;0
40311;11708;772;0;0;0;0;.00nan;0;0
40311;166226;1093;63;28;3;25;.893;3550000;0
40311;149103;1093;0;0;0;0;.00nan;0;0
40312;164521;3721;47;27;4;23;.852;2997000;0
40312;175761;769;0;0;0;0;.00nan;0;0
40312;67818;3721;24;8;3;5;.625;603000;0
40312;145463;769;61;34;4;30;.882;3600000;0
40313;162979;746;96;41;2;39;.951;3600000;0
40313;166023;767;0;0;0;0;.00nan;0;0
40313;149191;746;0;0;0;0;.00nan;0;0
40313;149262;767;60;35;4;31;.886;3524000;0
40314;31;755;0;0;0;0;.00nan;0;0
40314;174894;754;0;0;0;0;.00nan;0;0
40314;180154;755;56;33;5;28;.848;3600000;0
40314;207194;754;79;25;1;24;.960;3600000;0
40315;1756;4989;86;37;2;35;.946;3544000;0
40315;188815;762;84;28;1;27;.964;3600000;0
40315;190570;4989;0;0;0;0;.00nan;0;0
40315;186234;762;0;0;0;0;.00nan;0;0
40316;177356;2545;95;42;1;41;.976;3900000;0
40316;180133;1492;0;0;0;0;.00nan;0;0
40316;181910;1492;87;30;1;29;.967;3900000;0
40316;149048;2545;0;0;0;0;.00nan;0;0
40317;193545;774;100;50;2;48;.960;3900000;0
40317;174898;1503;83;25;2;23;.920;3900000;0
40317;201933;774;0;0;0;0;.00nan;0;0
40317;192386;1503;0;0;0;0;.00nan;0;0
40318;201075;760;73;28;2;26;.929;3900000;0
40318;190589;2197;63;22;2;20;.909;3900000;0
40318;82817;2197;0;0;0;0;.00nan;0;0
40318;142810;760;0;0;0;0;.00nan;0;0
40319;-1;911;71;23;2;21;.913;3600000;0
40319;174858;911;0;0;0;0;.00nan;0;0
40319;63932;3913;0;0;0;0;.00nan;0;0
40319;86343;3913;52;35;4;31;.886;3585000;0
40320;189264;4923;0;0;0;0;.00nan;0;0
40320;171113;759;0;0;0;0;.00nan;0;0
40320;179406;4923;98;46;2;44;.957;3559000;0
40320;176686;759;69;15;1;14;.933;3600000;0
40321;162979;746;59;33;4;29;.879;3704000;0
40321;180188;4924;0;0;0;0;.00nan;0;0
40321;-1;4924;57;27;3;24;.889;3704000;0
40321;149191;746;0;0;0;0;.00nan;0;0
40322;8504;768;69;17;1;16;.941;3600000;0
40322;-1;2199;0;0;0;0;.00nan;0;0
40322;80222;2199;74;49;5;44;.898;3600000;0
40322;149280;768;0;0;0;0;.00nan;0;0
40323;177124;775;63;27;3;24;.889;3665000;0
40323;164424;772;78;32;2;30;.938;3665000;0
40323;11708;772;0;0;0;0;.00nan;0;0
40323;146249;775;0;0;0;0;.00nan;0;0
40324;175761;769;75;37;2;35;.946;3900000;0
40324;212428;750;0;0;0;0;.00nan;0;0
40324;180738;750;73;24;2;22;.917;3900000;0
40324;145463;769;0;0;0;0;.00nan;0;0
40325;1756;4989;81;42;4;38;.905;3600000;0
40325;166023;767;75;22;1;21;.955;3600000;0
40325;190570;4989;0;0;0;0;.00nan;0;0
40325;149262;767;0;0;0;0;.00nan;0;0
40326;177356;2545;0;0;0;0;.00nan;0;0
40326;164521;3721;0;0;0;0;.00nan;0;0
40326;67818;3721;60;18;2;16;.889;3788000;0
40326;149048;2545;100;39;1;38;.974;3788000;0
40327;170530;766;85;34;2;32;.941;3600000;0
40327;180133;1492;0;0;0;0;.00nan;0;0
40327;181910;1492;49;21;3;18;.857;3557000;0
40327;187348;766;0;0;0;0;.00nan;0;0
40328;193545;774;0;0;0;0;.00nan;0;0
40328;201933;774;43;35;5;30;.857;3543000;0
40328;63932;3913;0;0;0;0;.00nan;0;0
40328;86343;3913;51;17;3;14;.824;3600000;0
40329;174898;1503;67;17;1;16;.941;3600000;0
40329;190589;2197;77;46;4;42;.913;3600000;0
40329;192386;1503;0;0;0;0;.00nan;0;0
40329;82817;2197;0;0;0;0;.00nan;0;0
40330;11882;758;0;0;0;0;.00nan;0;0
40330;-1;911;76;19;1;18;.947;3600000;0
40330;189581;758;64;33;4;29;.879;3600000;0
40330;174858;911;0;0;0;0;.00nan;0;0
40331;175757;1497;77;25;1;24;.960;3600000;0
40331;180133;1492;0;0;0;0;.00nan;0;0
40331;181910;1492;49;37;5;32;.865;3600000;0
40331;67446;1497;0;0;0;0;.00nan;0;0
40332;189264;4923;0;0;0;0;.00nan;0;0
40332;179406;4923;96;36;2;34;.944;3600000;0
40332;-1;2199;0;0;0;0;.00nan;0;0
40332;80222;2199;69;31;3;28;.903;3584000;0
40333;1756;4989;59;29;3;26;.897;3600000;0
40333;180188;4924;52;35;5;30;.857;3538000;0
40333;190570;4989;0;0;0;0;.00nan;0;0
40333;-1;4924;0;0;0;0;.00nan;0;0
40334;164424;772;66;33;4;29;.879;3600000;0
40334;11708;772;0;0;0;0;.00nan;0;0
40334;171113;759;0;0;0;0;.00nan;0;0
40334;176686;759;99;20;0;20;1.000;3600000;0
40335;174894;754;47;29;4;25;.862;3600000;0
40335;175761;769;0;0;0;0;.00nan;0;0
40335;207194;754;0;0;0;0;.00nan;0;0
40335;145463;769;49;36;5;31;.861;3573000;0
40336;177356;2545;0;0;0;0;.00nan;0;0
40336;212428;750;0;0;0;0;.00nan;0;0
40336;180738;750;71;18;1;17;.944;3600000;0
40336;149048;2545;61;25;3;22;.880;3512000;0
40337;188815;762;59;25;3;22;.880;3584000;0
40337;166226;1093;0;0;0;0;.00nan;0;0
40337;186234;762;0;0;0;0;.00nan;0;0
40337;149103;1093;95;35;1;34;.971;3600000;0
40338;31;755;29;25;5;20;.800;3600000;0
40338;162979;746;82;34;2;32;.941;3600000;0
40338;180154;755;0;0;0;0;.00nan;0;0
40338;149191;746;0;0;0;0;.00nan;0;0
40339;164521;3721;0;0;0;0;.00nan;0;0
40339;170530;766;94;34;2;32;.941;3600000;0
40339;187348;766;0;0;0;0;.00nan;0;0
40339;67818;3721;69;37;4;33;.892;3576000;0
40340;193545;774;87;37;2;35;.946;3544000;0
40340;11882;758;0;0;0;0;.00nan;0;0
40340;189581;758;78;24;1;23;.958;3600000;0
40340;201933;774;0;0;0;0;.00nan;0;0
40341;190589;2197;0;0;0;0;.00nan;0;0
40341;63932;3913;0;0;0;0;.00nan;0;0
40341;82817;2197;78;39;3;36;.923;3516000;0
40341;86343;3913;79;22;1;21;.955;3600000;0
40342;164521;3721;0;0;0;0;.00nan;0;0
40342;175757;1497;0;0;0;0;.00nan;0;0
40342;67446;1497;47;23;3;20;.870;3763000;0
40342;67818;3721;60;34;4;30;.882;3763000;0
40343;8504;768;52;13;2;11;.846;3600000;0
40343;169680;3730;63;33;3;30;.909;3012000;0
40343;149112;3730;30;10;3;7;.700;588000;0
40343;149280;768;0;0;0;0;.00nan;0;0
40344;177124;775;0;0;0;0;.00nan;0;0
40344;188815;762;0;0;0;0;.00nan;0;0
40344;186234;762;100;32;0;32;1.000;3600000;0
40344;146249;775;56;27;3;24;.889;3600000;0
40345;177356;2545;50;23;4;19;.826;3600000;0
40345;174894;754;99;44;1;43;.977;3600000;0
40345;207194;754;0;0;0;0;.00nan;0;0
40345;149048;2545;0;0;0;0;.00nan;0;0
40346;166023;767;0;0;0;0;.00nan;0;0
40346;166226;1093;0;0;0;0;.00nan;0;0
40346;149103;1093;62;36;4;32;.889;3600000;0
40346;149262;767;94;20;0;20;1.000;3600000;0
40347;31;755;0;0;0;0;.00nan;0;0
40347;1756;4989;0;0;0;0;.00nan;0;0
40347;180154;755;70;26;3;23;.885;3587000;0
40347;190570;4989;84;40;2;38;.950;3600000;0
40348;170530;766;97;28;1;27;.964;3900000;0
40348;212428;750;0;0;0;0;.00nan;0;0
40348;180738;750;100;33;1;32;.970;3900000;0
40348;187348;766;0;0;0;0;.00nan;0;0
40349;11882;758;0;0;0;0;.00nan;0;0
40349;189581;758;83;28;1;27;.964;3900000;0
40349;190589;2197;98;40;1;39;.975;3900000;0
40349;82817;2197;0;0;0;0;.00nan;0;0
40350;175757;1497;77;21;1;20;.952;3900000;0
40350;212428;750;0;0;0;0;.00nan;0;0
40350;180738;750;78;25;1;24;.960;3900000;0
40350;67446;1497;0;0;0;0;.00nan;0;0
40351;8504;768;80;21;1;20;.952;3600000;0
40351;189264;4923;0;0;0;0;.00nan;0;0
40351;179406;4923;73;42;5;37;.881;3600000;0
40351;149280;768;0;0;0;0;.00nan;0;0
40352;188815;762;0;0;0;0;.00nan;0;0
40352;186234;762;89;39;2;37;.949;3572000;0
40352;-1;2199;0;0;0;0;.00nan;0;0
40352;80222;2199;85;27;1;26;.963;3600000;0
40353;164424;772;93;20;0;20;1.000;3600000;0
40353;11708;772;0;0;0;0;.00nan;0;0
40353;169680;3730;81;31;2;29;.935;3577000;0
40353;149112;3730;0;0;0;0;.00nan;0;0
40354;162979;746;69;20;2;18;.900;3600000;0
40354;175761;769;42;30;6;24;.800;3600000;0
40354;145463;769;0;0;0;0;.00nan;0;0
40354;149191;746;0;0;0;0;.00nan;0;0
40355;177124;775;79;36;2;34;.944;3600000;0
40355;166023;767;0;0;0;0;.00nan;0;0
40355;146249;775;0;0;0;0;.00nan;0;0
40355;149262;767;61;32;4;28;.875;3515000;0
40356;-1;911;100;39;1;38;.974;3600000;0
40356;174858;911;0;0;0;0;.00nan;0;0
40356;180133;1492;48;30;4;26;.867;3600000;0
40356;181910;1492;0;0;0;0;.00nan;0;0
40357;166226;1093;0;0;0;0;.00nan;0;0
40357;180188;4924;81;37;3;34;.919;3585000;0
40357;-1;4924;0;0;0;0;.00nan;0;0
40357;149103;1093;65;21;2;19;.905;3600000;0
40358;170530;766;0;0;0;0;.00nan;0;0
40358;174894;754;56;34;4;30;.882;3900000;0
40358;207194;754;0;0;0;0;.00nan;0;0
40358;187348;766;81;43;4;39;.907;3900000;0
40359;201075;760;60;24;3;21;.875;3539000;0
40359;174898;1503;70;25;1;24;.960;3600000;0
40359;192386;1503;0;0;0;0;.00nan;0;0
40359;142810;760;0;0;0;0;.00nan;0;0
40360;174894;754;30;25;6;19;.760;3042000;0
40360;175757;1497;0;0;0;0;.00nan;0;0
40360;207194;754;44;4;1;3;.750;551000;0
40360;67446;1497;47;30;5;25;.833;3600000;0
40361;189264;4923;0;0;0;0;.00nan;0;0
40361;169680;3730;88;34;2;32;.941;3900000;0
40361;179406;4923;70;23;2;21;.913;3900000;0
40361;149112;3730;0;0;0;0;.00nan;0;0
40362;166023;767;0;0;0;0;.00nan;0;0
40362;-1;2199;0;0;0;0;.00nan;0;0
40362;80222;2199;67;20;3;17;.850;3600000;0
40362;149262;767;41;40;7;33;.825;3600000;0
40363;164521;3721;62;34;3;31;.912;3594000;0
40363;-1;911;87;38;2;36;.947;3600000;0
40363;174858;911;0;0;0;0;.00nan;0;0
40363;67818;3721;0;0;0;0;.00nan;0;0
40364;8504;768;86;22;1;21;.955;3600000;0
40364;164424;772;64;51;6;45;.882;3600000;0
40364;11708;772;0;0;0;0;.00nan;0;0
40364;149280;768;0;0;0;0;.00nan;0;0
40365;188815;762;0;0;0;0;.00nan;0;0
40365;171113;759;0;0;0;0;.00nan;0;0
40365;176686;759;72;19;1;18;.947;3600000;0
40365;186234;762;42;34;5;29;.853;3600000;0
40366;1756;4989;72;44;4;40;.909;3600000;0
40366;175761;769;0;0;0;0;.00nan;0;0
40366;190570;4989;0;0;0;0;.00nan;0;0
40366;145463;769;53;19;3;16;.842;3600000;0
40367;177356;2545;73;38;3;35;.921;3571000;0
40367;162979;746;72;23;2;21;.913;3600000;0
40367;149048;2545;0;0;0;0;.00nan;0;0
40367;149191;746;0;0;0;0;.00nan;0;0
40368;177124;775;75;25;2;23;.920;3578000;0
40368;180188;4924;95;29;1;28;.966;3600000;0
40368;-1;4924;0;0;0;0;.00nan;0;0
40368;146249;775;0;0;0;0;.00nan;0;0
40369;193545;774;63;27;2;25;.926;3600000;0
40369;180133;1492;0;0;0;0;.00nan;0;0
40369;201933;774;0;0;0;0;.00nan;0;0
40369;181910;1492;80;27;1;26;.963;3600000;0
40370;31;755;43;39;6;33;.846;3326000;0
40370;166226;1093;90;31;1;30;.968;3600000;0
40370;180154;755;23;5;3;2;.400;274000;0
40370;149103;1093;0;0;0;0;.00nan;0;0
40371;201075;760;0;0;0;0;.00nan;0;0
40371;63932;3913;0;0;0;0;.00nan;0;0
40371;86343;3913;91;40;2;38;.950;3900000;0
40371;142810;760;73;30;2;28;.933;3900000;0
40372;180188;4924;79;35;2;33;.943;3600000;0
40372;-1;2199;0;0;0;0;.00nan;0;0
40372;-1;4924;0;0;0;0;.00nan;0;0
40372;80222;2199;100;30;0;30;1.000;3600000;0
40373;193545;774;0;0;0;0;.00nan;0;0
40373;164521;3721;0;0;0;0;.00nan;0;0
40373;201933;774;78;21;1;20;.952;3589000;0
40373;67818;3721;88;17;0;17;1.000;3600000;0
40374;-1;911;64;31;4;27;.871;3900000;0
40374;174858;911;0;0;0;0;.00nan;0;0
40374;212428;750;50;32;4;28;.875;3900000;0
40374;180738;750;0;0;0;0;.00nan;0;0
40375;166023;767;0;0;0;0;.00nan;0;0
40375;171113;759;65;17;1;16;.941;3600000;0
40375;176686;759;0;0;0;0;.00nan;0;0
40375;149262;767;90;42;3;39;.929;3541000;0
40376;1756;4989;0;0;0;0;.00nan;0;0
40376;177356;2545;0;0;0;0;.00nan;0;0
40376;190570;4989;69;31;3;28;.903;3517000;0
40376;149048;2545;85;26;1;25;.962;3600000;0
40377;162979;746;59;22;2;20;.909;3600000;0
40377;170530;766;67;42;4;38;.905;3583000;0
40377;187348;766;0;0;0;0;.00nan;0;0
40377;149191;746;0;0;0;0;.00nan;0;0
40378;31;755;0;0;0;0;.00nan;0;0
40378;177124;775;68;20;1;19;.950;3600000;0
40378;180154;755;68;37;4;33;.892;3600000;0
40378;146249;775;0;0;0;0;.00nan;0;0
40379;180133;1492;0;0;0;0;.00nan;0;0
40379;190589;2197;65;27;2;25;.926;3600000;0
40379;181910;1492;36;26;5;21;.808;3600000;0
40379;82817;2197;0;0;0;0;.00nan;0;0
40380;11882;758;0;0;0;0;.00nan;0;0
40380;189581;758;61;33;4;29;.879;3550000;0
40380;201075;760;69;33;3;30;.909;3600000;0
40380;142810;760;0;0;0;0;.00nan;0;0
40381;174898;1503;68;17;1;16;.941;3600000;0
40381;192386;1503;0;0;0;0;.00nan;0;0
40381;63932;3913;0;0;0;0;.00nan;0;0
40381;86343;3913;55;42;6;36;.857;3600000;0
40382;31;755;0;0;0;0;.00nan;0;0
40382;180154;755;76;35;4;31;.886;3545000;0
40382;-1;2199;0;0;0;0;.00nan;0;0
40382;80222;2199;99;46;3;43;.935;3600000;0
40383;164521;3721;0;0;0;0;.00nan;0;0
40383;190589;2197;85;43;5;38;.884;3600000;0
40383;67818;3721;100;27;0;27;1.000;3600000;0
40383;82817;2197;0;0;0;0;.00nan;0;0
40384;193545;774;56;24;2;22;.917;3583000;0
40384;212428;750;0;0;0;0;.00nan;0;0
40384;201933;774;0;0;0;0;.00nan;0;0
40384;180738;750;97;26;0;26;1.000;3600000;0
40385;171113;759;0;0;0;0;.00nan;0;0
40385;176686;759;49;21;3;18;.857;3900000;0
40385;180188;4924;100;51;3;48;.941;3900000;0
40385;-1;4924;0;0;0;0;.00nan;0;0
40386;166226;1093;0;0;0;0;.00nan;0;0
40386;175761;769;0;0;0;0;.00nan;0;0
40386;145463;769;62;30;3;27;.900;3579000;0
40386;149103;1093;81;33;2;31;.939;3600000;0
40387;1756;4989;82;39;3;36;.923;3595000;0
40387;170530;766;68;24;2;22;.917;3600000;0
40387;190570;4989;0;0;0;0;.00nan;0;0
40387;187348;766;0;0;0;0;.00nan;0;0
40388;162979;746;55;18;3;15;.833;3600000;0
40388;175757;1497;83;42;4;38;.905;3600000;0
40388;67446;1497;0;0;0;0;.00nan;0;0
40388;149191;746;0;0;0;0;.00nan;0;0
40389;-1;911;53;30;4;26;.867;3561000;0
40389;174858;911;0;0;0;0;.00nan;0;0
40389;174894;754;0;0;0;0;.00nan;0;0
40389;207194;754;61;28;3;25;.893;3600000;0
40390;11882;758;0;0;0;0;.00nan;0;0
40390;189581;758;100;39;1;38;.974;3600000;0
40390;174898;1503;33;14;4;10;.714;3600000;0
40390;192386;1503;0;0;0;0;.00nan;0;0
40391;212428;750;0;0;0;0;.00nan;0;0
40391;180738;750;55;24;3;21;.875;3514000;0
40391;190589;2197;93;25;1;24;.960;3600000;0
40391;82817;2197;0;0;0;0;.00nan;0;0
40392;31;755;0;0;0;0;.00nan;0;0
40392;171113;759;0;0;0;0;.00nan;0;0
40392;176686;759;59;14;1;13;.929;3600000;0
40392;180154;755;94;45;2;43;.956;3588000;0
40393;177124;775;69;19;1;18;.947;3544000;0
40393;175761;769;100;28;0;28;1.000;3600000;0
40393;145463;769;0;0;0;0;.00nan;0;0
40393;146249;775;0;0;0;0;.00nan;0;0
40394;1756;4989;0;0;0;0;.00nan;0;0
40394;175757;1497;0;0;0;0;.00nan;0;0
40394;190570;4989;79;39;3;36;.923;3588000;0
40394;67446;1497;78;16;1;15;.938;3600000;0
40395;8504;768;73;21;1;20;.952;3600000;0
40395;166023;767;39;35;6;29;.829;2146000;0
40395;149262;767;59;12;1;11;.917;1454000;0
40395;149280;768;0;0;0;0;.00nan;0;0
40396;193545;774;0;0;0;0;.00nan;0;0
40396;174894;754;70;19;1;18;.947;3600000;0
40396;201933;774;83;39;2;37;.949;3587000;0
40396;207194;754;0;0;0;0;.00nan;0;0
40397;188815;762;91;21;0;21;1.000;3600000;0
40397;169680;3730;70;39;4;35;.897;3600000;0
40397;186234;762;0;0;0;0;.00nan;0;0
40397;149112;3730;0;0;0;0;.00nan;0;0
40398;177356;2545;0;0;0;0;.00nan;0;0
40398;166226;1093;0;0;0;0;.00nan;0;0
40398;149048;2545;76;23;2;21;.913;3563000;0
40398;149103;1093;100;21;0;21;1.000;3600000;0
40399;201075;760;77;34;3;31;.912;3575000;0
40399;180133;1492;0;0;0;0;.00nan;0;0
40399;181910;1492;67;25;2;23;.920;3600000;0
40399;142810;760;0;0;0;0;.00nan;0;0
40400;11882;758;0;0;0;0;.00nan;0;0
40400;189581;758;52;22;3;19;.864;3575000;0
40400;63932;3913;0;0;0;0;.00nan;0;0
40400;86343;3913;79;35;2;33;.943;3600000;0
40401;8504;768;67;17;1;16;.941;3600000;0
40401;180188;4924;0;0;0;0;.00nan;0;0
40401;-1;4924;85;42;3;39;.929;3579000;0
40401;149280;768;0;0;0;0;.00nan;0;0
40402;175761;769;66;40;5;35;.875;3548000;0
40402;-1;2199;0;0;0;0;.00nan;0;0
40402;80222;2199;70;29;3;26;.897;3600000;0
40402;145463;769;0;0;0;0;.00nan;0;0
40403;166023;767;0;0;0;0;.00nan;0;0
40403;169680;3730;55;34;5;29;.853;3559000;0
40403;149112;3730;0;0;0;0;.00nan;0;0
40403;149262;767;47;26;4;22;.846;3600000;0
40404;174894;754;74;27;1;26;.963;3660000;0
40404;207194;754;0;0;0;0;.00nan;0;0
40404;190589;2197;66;24;2;22;.917;3660000;0
40404;82817;2197;0;0;0;0;.00nan;0;0
40405;164424;772;41;18;3;15;.833;3562000;0
40405;11708;772;0;0;0;0;.00nan;0;0
40405;188815;762;72;28;2;26;.929;3600000;0
40405;186234;762;0;0;0;0;.00nan;0;0
40406;177124;775;82;30;2;28;.933;3600000;0
40406;177356;2545;0;0;0;0;.00nan;0;0
40406;146249;775;0;0;0;0;.00nan;0;0
40406;149048;2545;61;45;5;40;.889;3600000;0
40407;166226;1093;0;0;0;0;.00nan;0;0
40407;170530;766;44;24;4;20;.833;3600000;0
40407;187348;766;0;0;0;0;.00nan;0;0
40407;149103;1093;97;36;1;35;.972;3600000;0
40408;164521;3721;0;0;0;0;.00nan;0;0
40408;201075;760;0;0;0;0;.00nan;0;0
40408;67818;3721;58;17;2;15;.882;3600000;0
40408;142810;760;38;23;4;19;.826;3559000;0
40409;162979;746;52;31;5;26;.839;3600000;0
40409;-1;911;0;0;0;0;.00nan;0;0
40409;174858;911;74;25;2;23;.920;3600000;0
40409;149191;746;0;0;0;0;.00nan;0;0
40410;174898;1503;87;32;1;31;.969;3600000;0
40410;180133;1492;0;0;0;0;.00nan;0;0
40410;181910;1492;88;29;2;27;.931;3600000;0
40410;192386;1503;0;0;0;0;.00nan;0;0
40411;166226;1093;0;0;0;0;.00nan;0;0
40411;175757;1497;46;25;4;21;.840;3552000;0
40411;67446;1497;0;0;0;0;.00nan;0;0
40411;149103;1093;69;29;3;26;.897;3600000;0
40412;169680;3730;85;40;3;37;.925;3900000;0
40412;180188;4924;58;23;3;20;.870;3900000;0
40412;-1;4924;0;0;0;0;.00nan;0;0
40412;149112;3730;0;0;0;0;.00nan;0;0
40413;171113;759;0;0;0;0;.00nan;0;0
40413;175761;769;0;0;0;0;.00nan;0;0
40413;176686;759;59;12;2;10;.833;3900000;0
40413;145463;769;93;43;2;41;.953;3900000;0
40414;164424;772;52;31;4;27;.871;3900000;0
40414;11708;772;0;0;0;0;.00nan;0;0
40414;166023;767;0;0;0;0;.00nan;0;0
40414;149262;767;49;25;4;21;.840;3900000;0
40415;188815;762;0;0;0;0;.00nan;0;0
40415;189264;4923;0;0;0;0;.00nan;0;0
40415;179406;4923;66;18;1;17;.944;3600000;0
40415;186234;762;56;24;3;21;.875;3522000;0
40416;177356;2545;78;47;3;44;.936;3600000;0
40416;-1;2199;0;0;0;0;.00nan;0;0
40416;80222;2199;81;11;0;11;1.000;3600000;0
40416;149048;2545;0;0;0;0;.00nan;0;0
40417;31;755;80;33;2;31;.939;3584000;0
40417;8504;768;97;28;1;27;.964;3600000;0
40417;180154;755;0;0;0;0;.00nan;0;0
40417;149280;768;0;0;0;0;.00nan;0;0
40418;177124;775;89;31;1;30;.968;3600000;0
40418;170530;766;0;0;0;0;.00nan;0;0
40418;187348;766;56;33;4;29;.879;3600000;0
40418;146249;775;0;0;0;0;.00nan;0;0
40419;11882;758;80;35;3;32;.914;3591000;0
40419;189581;758;0;0;0;0;.00nan;0;0
40419;180133;1492;0;0;0;0;.00nan;0;0
40419;181910;1492;80;27;2;25;.926;3600000;0
40420;162979;746;51;26;4;22;.846;3529000;0
40420;193545;774;0;0;0;0;.00nan;0;0
40420;201933;774;69;29;2;27;.931;3600000;0
40420;149191;746;0;0;0;0;.00nan;0;0
40421;201075;760;39;19;4;15;.789;3561000;0
40421;212428;750;0;0;0;0;.00nan;0;0
40421;180738;750;63;28;3;25;.893;3600000;0
40421;142810;760;0;0;0;0;.00nan;0;0
40422;1756;4989;0;0;0;0;.00nan;0;0
40422;-1;911;77;24;1;23;.958;3600000;0
40422;174858;911;0;0;0;0;.00nan;0;0
40422;190570;4989;38;31;5;26;.839;3600000;0
40423;164521;3721;0;0;0;0;.00nan;0;0
40423;174898;1503;0;0;0;0;.00nan;0;0
40423;192386;1503;55;17;3;14;.824;3600000;0
40423;67818;3721;73;44;4;40;.909;3600000;0
40424;177124;775;33;23;5;18;.783;3600000;0
40424;175757;1497;0;0;0;0;.00nan;0;0
40424;67446;1497;95;22;0;22;1.000;3600000;0
40424;146249;775;0;0;0;0;.00nan;0;0
40425;164424;772;40;21;4;17;.810;3523000;0
40425;11708;772;0;0;0;0;.00nan;0;0
40425;180188;4924;0;0;0;0;.00nan;0;0
40425;-1;4924;63;23;2;21;.913;3600000;0
40426;166023;767;100;26;0;26;1.000;3600000;0
40426;189264;4923;0;0;0;0;.00nan;0;0
40426;179406;4923;86;36;3;33;.917;3600000;0
40426;149262;767;0;0;0;0;.00nan;0;0
40427;8504;768;65;13;1;12;.923;3600000;0
40427;188815;762;73;48;5;43;.896;3600000;0
40427;186234;762;0;0;0;0;.00nan;0;0
40427;149280;768;0;0;0;0;.00nan;0;0
40428;177356;2545;0;0;0;0;.00nan;0;0
40428;171113;759;0;0;0;0;.00nan;0;0
40428;176686;759;61;17;2;15;.882;3900000;0
40428;149048;2545;97;50;2;48;.960;3900000;0
40429;31;755;0;0;0;0;.00nan;0;0
40429;169680;3730;57;43;5;38;.884;3556000;0
40429;180154;755;63;29;4;25;.862;3600000;0
40429;149112;3730;0;0;0;0;.00nan;0;0
40430;170530;766;49;18;3;15;.833;3600000;0
40430;187348;766;0;0;0;0;.00nan;0;0
40430;-1;2199;0;0;0;0;.00nan;0;0
40430;80222;2199;32;30;6;24;.800;3600000;0
40431;164521;3721;0;0;0;0;.00nan;0;0
40431;11882;758;82;27;1;26;.963;3600000;0
40431;189581;758;0;0;0;0;.00nan;0;0
40431;67818;3721;56;23;4;19;.826;3600000;0
40432;1756;4989;62;40;4;36;.900;3600000;0
40432;193545;774;47;41;6;35;.854;3580000;0
40432;201933;774;0;0;0;0;.00nan;0;0
40432;190570;4989;0;0;0;0;.00nan;0;0
40433;201075;760;63;25;3;22;.880;3600000;0
40433;174894;754;56;23;4;19;.826;3582000;0
40433;207194;754;0;0;0;0;.00nan;0;0
40433;142810;760;0;0;0;0;.00nan;0;0
40434;162979;746;70;23;2;21;.913;3600000;0
40434;190589;2197;39;38;6;32;.842;3600000;0
40434;82817;2197;0;0;0;0;.00nan;0;0
40434;149191;746;0;0;0;0;.00nan;0;0
40435;174898;1503;63;14;1;13;.929;3600000;0
40435;212428;750;0;0;0;0;.00nan;0;0
40435;180738;750;84;41;3;38;.927;3585000;0
40435;192386;1503;0;0;0;0;.00nan;0;0
40436;180133;1492;0;0;0;0;.00nan;0;0
40436;181910;1492;25;24;6;18;.750;3513000;0
40436;63932;3913;67;37;4;33;.892;3600000;0
40436;86343;3913;0;0;0;0;.00nan;0;0
40437;175757;1497;0;0;0;0;.00nan;0;0
40437;-1;2199;0;0;0;0;.00nan;0;0
40437;67446;1497;75;33;2;31;.939;3900000;0
40437;80222;2199;74;23;2;21;.913;3900000;0
40438;189264;4923;0;0;0;0;.00nan;0;0
40438;179406;4923;77;37;2;35;.946;3554000;0
40438;180188;4924;84;31;1;30;.968;3600000;0
40438;-1;4924;0;0;0;0;.00nan;0;0
40439;31;755;0;0;0;0;.00nan;0;0
40439;164424;772;80;25;1;24;.960;3900000;0
40439;11708;772;0;0;0;0;.00nan;0;0
40439;180154;755;89;30;1;29;.967;3900000;0
40440;170530;766;73;33;3;30;.909;3572000;0
40440;171113;759;0;0;0;0;.00nan;0;0
40440;176686;759;53;7;1;6;.857;3600000;0
40440;187348;766;0;0;0;0;.00nan;0;0
40441;11882;758;0;0;0;0;.00nan;0;0
40441;189581;758;55;40;5;35;.875;3592000;0
40441;212428;750;0;0;0;0;.00nan;0;0
40441;180738;750;66;32;3;29;.906;3600000;0
40442;1756;4989;100;32;0;32;1.000;3600000;0
40442;190570;4989;0;0;0;0;.00nan;0;0
40442;190589;2197;0;0;0;0;.00nan;0;0
40442;82817;2197;53;29;4;25;.862;3600000;0
40443;174894;754;85;30;1;29;.967;3600000;0
40443;174898;1503;91;19;0;19;1.000;3600000;0
40443;207194;754;0;0;0;0;.00nan;0;0
40443;192386;1503;0;0;0;0;.00nan;0;0
40444;164521;3721;0;0;0;0;.00nan;0;0
40444;63932;3913;0;0;0;0;.00nan;0;0
40444;67818;3721;80;26;1;25;.962;3600000;0
40444;86343;3913;67;25;2;23;.920;3573000;0
40445;166226;1093;72;35;3;32;.914;3568000;0
40445;-1;911;69;26;2;24;.923;3600000;0
40445;174858;911;0;0;0;0;.00nan;0;0
40445;149103;1093;0;0;0;0;.00nan;0;0
40446;171113;759;45;18;2;16;.889;3568000;0
40446;175757;1497;100;37;1;36;.973;3600000;0
40446;176686;759;0;0;0;0;.00nan;0;0
40446;67446;1497;0;0;0;0;.00nan;0;0
40447;177356;2545;0;0;0;0;.00nan;0;0
40447;169680;3730;86;17;0;17;1.000;3600000;0
40447;149048;2545;73;27;2;25;.926;3582000;0
40447;149112;3730;0;0;0;0;.00nan;0;0
40448;31;755;52;46;6;40;.870;3600000;0
40448;189264;4923;44;18;3;15;.833;3600000;0
40448;179406;4923;0;0;0;0;.00nan;0;0
40448;180154;755;0;0;0;0;.00nan;0;0
40449;11882;758;98;44;1;43;.977;3600000;0
40449;189581;758;0;0;0;0;.00nan;0;0
40449;174894;754;53;33;6;27;.818;3139000;0
40449;207194;754;53;2;0;2;1.000;461000;0
40450;162979;746;99;17;0;17;1.000;3600000;0
40450;201075;760;61;45;5;40;.889;3600000;0
40450;142810;760;0;0;0;0;.00nan;0;0
40450;149191;746;0;0;0;0;.00nan;0;0
40451;-1;911;60;15;2;13;.867;3600000;0
40451;174858;911;0;0;0;0;.00nan;0;0
40451;81691;775;0;0;0;0;.00nan;0;0
40451;146249;775;78;46;4;42;.913;3558000;0
40452;212428;750;0;0;0;0;.00nan;0;0
40452;180738;750;62;25;3;22;.880;3600000;0
40452;63932;3913;0;0;0;0;.00nan;0;0
40452;86343;3913;65;44;4;40;.909;3552000;0
40453;193545;774;77;39;3;36;.923;3600000;0
40453;166226;1093;0;0;0;0;.00nan;0;0
40453;201933;774;0;0;0;0;.00nan;0;0
40453;149103;1093;54;26;4;22;.846;3551000;0
40454;169680;3730;96;57;2;55;.965;3600000;0
40454;175761;769;0;0;0;0;.00nan;0;0
40454;145463;769;64;24;3;21;.875;3566000;0
40454;149112;3730;0;0;0;0;.00nan;0;0
40455;177356;2545;0;0;0;0;.00nan;0;0
40455;8504;768;0;0;0;0;.00nan;0;0
40455;149048;2545;88;54;2;52;.963;3600000;0
40455;149280;768;76;12;0;12;1.000;3600000;0
40456;164424;772;81;33;3;30;.909;3550000;0
40456;11708;772;0;0;0;0;.00nan;0;0
40456;170530;766;82;26;1;25;.962;3600000;0
40456;187348;766;0;0;0;0;.00nan;0;0
40457;-1;911;34;28;5;23;.821;3600000;0
40457;174858;911;0;0;0;0;.00nan;0;0
40457;-1;2199;87;31;1;30;.968;3600000;0
40457;80222;2199;0;0;0;0;.00nan;0;0
40458;1756;4989;72;29;2;27;.931;3600000;0
40458;201075;760;81;34;3;31;.912;3545000;0
40458;190570;4989;0;0;0;0;.00nan;0;0
40458;142810;760;0;0;0;0;.00nan;0;0
40459;162979;746;72;22;2;20;.909;3900000;0
40459;174898;1503;94;36;2;34;.944;3900000;0
40459;192386;1503;0;0;0;0;.00nan;0;0
40459;149191;746;0;0;0;0;.00nan;0;0
40460;193545;774;0;0;0;0;.00nan;0;0
40460;201933;774;87;34;2;32;.941;3600000;0
40460;81691;775;44;26;4;22;.846;3536000;0
40460;146249;775;0;0;0;0;.00nan;0;0
40461;174894;754;0;0;0;0;.00nan;0;0
40461;207194;754;46;32;5;27;.844;3600000;0
40461;63932;3913;0;0;0;0;.00nan;0;0
40461;86343;3913;86;29;1;28;.966;3600000;0
40462;166226;1093;0;0;0;0;.00nan;0;0
40462;190589;2197;43;24;4;20;.833;3600000;0
40462;82817;2197;0;0;0;0;.00nan;0;0
40462;149103;1093;61;17;1;16;.941;3600000;0
40463;169680;3730;74;34;3;31;.912;3600000;0
40463;175757;1497;46;25;4;21;.840;3589000;0
40463;67446;1497;0;0;0;0;.00nan;0;0
40463;149112;3730;0;0;0;0;.00nan;0;0
40464;189264;4923;0;0;0;0;.00nan;0;0
40464;170530;766;87;32;1;31;.969;3543000;0
40464;179406;4923;100;26;0;26;1.000;3600000;0
40464;187348;766;0;0;0;0;.00nan;0;0
40465;164521;3721;0;0;0;0;.00nan;0;0
40465;180133;1492;0;0;0;0;.00nan;0;0
40465;181910;1492;86;26;1;25;.962;3600000;0
40465;67818;3721;63;42;5;37;.881;3600000;0
40466;8504;768;0;0;0;0;.00nan;0;0
40466;175761;769;0;0;0;0;.00nan;0;0
40466;145463;769;64;43;5;38;.884;3600000;0
40466;149280;768;84;13;0;13;1.000;3600000;0
40467;177356;2545;0;0;0;0;.00nan;0;0
40467;164424;772;75;20;1;19;.950;3645000;0
40467;85281;772;0;0;0;0;.00nan;0;0
40467;149048;2545;68;28;2;26;.929;3645000;0
40468;166023;767;100;27;0;27;1.000;3600000;0
40468;180188;4924;0;0;0;0;.00nan;0;0
40468;-1;4924;92;38;1;37;.974;3544000;0
40468;149262;767;0;0;0;0;.00nan;0;0
40469;31;755;0;0;0;0;.00nan;0;0
40469;188815;762;71;17;1;16;.941;3600000;0
40469;180154;755;54;35;4;31;.886;3600000;0
40469;186234;762;0;0;0;0;.00nan;0;0
40470;193545;774;70;30;2;28;.933;3900000;0
40470;201933;774;0;0;0;0;.00nan;0;0
40470;-1;2199;0;0;0;0;.00nan;0;0
40470;80222;2199;61;15;2;13;.867;3900000;0
40471;-1;911;78;26;2;24;.923;3732000;0
40471;171113;759;0;0;0;0;.00nan;0;0
40471;174858;911;0;0;0;0;.00nan;0;0
40471;176686;759;71;31;3;28;.903;3732000;0
40472;1756;4989;78;34;3;31;.912;3546000;0
40472;174898;1503;51;13;2;11;.846;3600000;0
40472;190570;4989;0;0;0;0;.00nan;0;0
40472;192386;1503;0;0;0;0;.00nan;0;0
40473;162979;746;81;18;0;18;1.000;3600000;0
40473;11882;758;0;0;0;0;.00nan;0;0
40473;189581;758;88;42;3;39;.929;3600000;0
40473;149191;746;0;0;0;0;.00nan;0;0
40474;190589;2197;59;31;4;27;.871;3600000;0
40474;81691;775;0;0;0;0;.00nan;0;0
40474;82817;2197;0;0;0;0;.00nan;0;0
40474;146249;775;96;20;0;20;1.000;3600000;0
40475;169680;3730;62;31;4;27;.871;3600000;0
40475;170530;766;85;24;1;23;.958;3600000;0
40475;187348;766;0;0;0;0;.00nan;0;0
40475;149112;3730;0;0;0;0;.00nan;0;0
40476;177356;2545;0;0;0;0;.00nan;0;0
40476;189264;4923;0;0;0;0;.00nan;0;0
40476;179406;4923;73;24;1;23;.958;3600000;0
40476;149048;2545;82;33;2;31;.939;3597000;0
40477;8504;768;0;0;0;0;.00nan;0;0
40477;175757;1497;0;0;0;0;.00nan;0;0
40477;67446;1497;97;45;1;44;.978;3600000;0
40477;149280;768;96;19;0;19;1.000;3600000;0
40478;164424;772;92;20;0;20;1.000;3600000;0
40478;175761;769;0;0;0;0;.00nan;0;0
40478;85281;772;0;0;0;0;.00nan;0;0
40478;145463;769;76;35;3;32;.914;3600000;0
40479;180133;1492;0;0;0;0;.00nan;0;0
40479;212428;750;0;0;0;0;.00nan;0;0
40479;180738;750;46;24;4;20;.833;3600000;0
40479;181910;1492;40;35;6;29;.829;3525000;0
40480;31;755;79;36;3;33;.917;3600000;0
40480;166023;767;90;17;0;17;1.000;3600000;0
40480;180154;755;0;0;0;0;.00nan;0;0
40480;149262;767;0;0;0;0;.00nan;0;0
40481;188815;762;77;23;1;22;.957;3600000;0
40481;180188;4924;91;38;2;36;.947;3544000;0
40481;186234;762;0;0;0;0;.00nan;0;0
40481;-1;4924;0;0;0;0;.00nan;0;0
40482;190589;2197;96;42;1;41;.976;3900000;0
40482;-1;2199;0;0;0;0;.00nan;0;0
40482;80222;2199;79;21;1;20;.952;3900000;0
40482;82817;2197;0;0;0;0;.00nan;0;0
40483;193545;774;0;0;0;0;.00nan;0;0
40483;171113;759;0;0;0;0;.00nan;0;0
40483;176686;759;84;14;0;14;1.000;3600000;0
40483;201933;774;73;32;3;29;.906;3600000;0
40484;1756;4989;0;0;0;0;.00nan;0;0
40484;11882;758;45;25;4;21;.840;3600000;0
40484;189581;758;0;0;0;0;.00nan;0;0
40484;190570;4989;54;41;5;36;.878;3572000;0
40485;162979;746;79;9;0;9;1.000;3600000;0
40485;63932;3913;0;0;0;0;.00nan;0;0
40485;86343;3913;59;40;5;35;.875;3600000;0
40485;149191;746;0;0;0;0;.00nan;0;0
40486;189264;4923;65;16;1;15;.938;3600000;0
40486;179406;4923;0;0;0;0;.00nan;0;0
40486;175761;769;0;0;0;0;.00nan;0;0
40486;145463;769;74;32;3;29;.906;3600000;0
40487;8504;768;0;0;0;0;.00nan;0;0
40487;170530;766;84;52;4;48;.923;3900000;0
40487;187348;766;0;0;0;0;.00nan;0;0
40487;149280;768;42;21;4;17;.810;3900000;0
40488;164424;772;90;30;1;29;.967;3600000;0
40488;175757;1497;66;23;2;21;.913;3544000;0
40488;67446;1497;0;0;0;0;.00nan;0;0
40488;85281;772;0;0;0;0;.00nan;0;0
40489;164521;3721;0;0;0;0;.00nan;0;0
40489;212428;750;0;0;0;0;.00nan;0;0
40489;180738;750;100;19;0;19;1.000;3600000;0
40489;67818;3721;97;41;2;39;.951;3541000;0
40490;166226;1093;0;0;0;0;.00nan;0;0
40490;201075;760;0;0;0;0;.00nan;0;0
40490;142810;760;86;32;2;30;.938;3600000;0
40490;149103;1093;76;20;1;19;.950;3600000;0
40491;174894;754;61;34;4;30;.882;3600000;0
40491;180133;1492;0;0;0;0;.00nan;0;0
40491;207194;754;0;0;0;0;.00nan;0;0
40491;181910;1492;90;39;1;38;.974;3600000;0
40492;171113;759;0;0;0;0;.00nan;0;0
40492;176686;759;70;11;0;11;1.000;3900000;0
40492;190589;2197;100;47;0;47;1.000;3900000;0
40492;82817;2197;0;0;0;0;.00nan;0;0
40493;1756;4989;79;39;3;36;.923;3544000;0
40493;190570;4989;0;0;0;0;.00nan;0;0
40493;63932;3913;0;0;0;0;.00nan;0;0
40493;86343;3913;63;22;2;20;.909;3600000;0
40494;189264;4923;0;0;0;0;.00nan;0;0
40494;179406;4923;88;19;0;19;1.000;3600000;0
40494;175757;1497;0;0;0;0;.00nan;0;0
40494;67446;1497;59;19;2;17;.895;3579000;0
40495;201075;760;96;45;3;42;.933;3900000;0
40495;81691;775;0;0;0;0;.00nan;0;0
40495;142810;760;0;0;0;0;.00nan;0;0
40495;146249;775;74;30;3;27;.900;3900000;0
40496;164521;3721;0;0;0;0;.00nan;0;0
40496;174894;754;0;0;0;0;.00nan;0;0
40496;207194;754;58;25;3;22;.880;3627000;0
40496;67818;3721;86;33;2;31;.939;3627000;0
40497;-1;911;0;0;0;0;.00nan;0;0
40497;169680;3730;55;47;5;42;.894;3532000;0
40497;174858;911;53;25;3;22;.880;3600000;0
40497;149112;3730;0;0;0;0;.00nan;0;0
40498;166226;1093;0;0;0;0;.00nan;0;0
40498;174898;1503;96;23;0;23;1.000;3600000;0
40498;192386;1503;0;0;0;0;.00nan;0;0
40498;149103;1093;71;27;2;25;.926;3596000;0
40499;177356;2545;0;0;0;0;.00nan;0;0
40499;166023;767;62;25;3;22;.880;3514000;0
40499;149048;2545;100;46;1;45;.978;3600000;0
40499;149262;767;0;0;0;0;.00nan;0;0
40500;11882;758;0;0;0;0;.00nan;0;0
40500;166226;1093;0;0;0;0;.00nan;0;0
40500;189581;758;92;43;2;41;.953;3900000;0
40500;149103;1093;91;27;2;25;.926;3900000;0
40501;193545;774;0;0;0;0;.00nan;0;0
40501;169680;3730;90;33;1;32;.970;3600000;0
40501;201933;774;46;21;3;18;.857;3556000;0
40501;149112;3730;0;0;0;0;.00nan;0;0
40502;201075;760;87;38;2;36;.947;3600000;0
40502;-1;2199;0;0;0;0;.00nan;0;0
40502;80222;2199;78;22;1;21;.955;3600000;0
40502;142810;760;0;0;0;0;.00nan;0;0
40503;8504;768;0;0;0;0;.00nan;0;0
40503;-1;911;76;41;4;37;.902;3548000;0
40503;174858;911;0;0;0;0;.00nan;0;0
40503;149280;768;63;21;2;19;.905;3600000;0
40504;162979;746;63;22;3;19;.864;3544000;0
40504;180133;1492;77;32;2;30;.938;3600000;0
40504;181910;1492;0;0;0;0;.00nan;0;0
40504;149191;746;0;0;0;0;.00nan;0;0
40505;174898;1503;78;22;1;21;.955;3600000;0
40505;192386;1503;0;0;0;0;.00nan;0;0
40505;81691;775;0;0;0;0;.00nan;0;0
40505;146249;775;64;28;3;25;.893;3526000;0
40506;166023;767;62;16;2;14;.875;3600000;0
40506;175761;769;54;28;3;25;.893;3600000;0
40506;145463;769;0;0;0;0;.00nan;0;0
40506;149262;767;0;0;0;0;.00nan;0;0
40507;177356;2545;0;0;0;0;.00nan;0;0
40507;188815;762;57;19;3;16;.842;3569000;0
40507;186234;762;0;0;0;0;.00nan;0;0
40507;149048;2545;92;35;2;33;.943;3600000;0
40508;162979;746;62;30;3;27;.900;3900000;0
40508;164521;3721;96;50;3;47;.940;3900000;0
40508;67818;3721;0;0;0;0;.00nan;0;0
40508;149191;746;0;0;0;0;.00nan;0;0
40509;11882;758;89;39;2;37;.949;3589000;0
40509;189581;758;0;0;0;0;.00nan;0;0
40509;81691;775;0;0;0;0;.00nan;0;0
40509;146249;775;100;28;0;28;1.000;3600000;0
40510;8504;768;0;0;0;0;.00nan;0;0
40510;193545;774;85;42;3;39;.929;3600000;0
40510;201933;774;0;0;0;0;.00nan;0;0
40510;149280;768;52;9;1;8;.889;3600000;0
40511;171113;759;0;0;0;0;.00nan;0;0
40511;201075;760;27;14;4;10;.714;797000;0
40511;176686;759;42;21;4;17;.810;3600000;0
40511;142810;760;63;38;5;33;.868;2803000;0
40512;169680;3730;42;23;4;19;.826;3514000;0
40512;190589;2197;100;41;2;39;.951;3600000;0
40512;82817;2197;0;0;0;0;.00nan;0;0
40512;149112;3730;0;0;0;0;.00nan;0;0
40513;189264;4923;0;0;0;0;.00nan;0;0
40513;-1;911;47;20;3;17;.850;3545000;0
40513;174858;911;0;0;0;0;.00nan;0;0
40513;179406;4923;72;23;1;22;.957;3600000;0
40514;1756;4989;100;26;0;26;1.000;3600000;0
40514;180133;1492;0;0;0;0;.00nan;0;0
40514;190570;4989;0;0;0;0;.00nan;0;0
40514;181910;1492;46;24;4;20;.833;3600000;0
40515;174898;1503;70;15;1;14;.933;3600000;0
40515;192386;1503;0;0;0;0;.00nan;0;0
40515;-1;2199;0;0;0;0;.00nan;0;0
40515;80222;2199;65;34;3;31;.912;3600000;0
40516;166226;1093;0;0;0;0;.00nan;0;0
40516;63932;3913;100;30;0;30;1.000;3600000;0
40516;86343;3913;0;0;0;0;.00nan;0;0
40516;149103;1093;53;28;4;24;.857;3600000;0
40517;166023;767;59;25;3;22;.880;3600000;0
40517;175757;1497;33;10;3;7;.700;506000;0
40517;67446;1497;42;23;4;19;.826;3094000;0
40517;149262;767;0;0;0;0;.00nan;0;0
40518;188815;762;69;6;0;6;1.000;3600000;0
40518;175761;769;60;6;0;6;1.000;688000;0
40518;186234;762;0;0;0;0;.00nan;0;0
40518;145463;769;38;32;6;26;.813;2912000;0
40519;31;755;0;0;0;0;.00nan;0;0
40519;177356;2545;0;0;0;0;.00nan;0;0
40519;180154;755;58;26;3;23;.885;3600000;0
40519;149048;2545;67;24;2;22;.917;3600000;0
40520;170530;766;80;23;1;22;.957;3600000;0
40520;180188;4924;68;29;3;26;.897;3600000;0
40520;187348;766;0;0;0;0;.00nan;0;0
40520;-1;4924;0;0;0;0;.00nan;0;0
40521;1756;4989;58;31;4;27;.871;3525000;0
40521;164521;3721;0;0;0;0;.00nan;0;0
40521;190570;4989;0;0;0;0;.00nan;0;0
40521;67818;3721;73;29;2;27;.931;3600000;0
40522;11882;758;0;0;0;0;.00nan;0;0
40522;189581;758;98;26;0;26;1.000;3600000;0
40522;-1;2199;0;0;0;0;.00nan;0;0
40522;80222;2199;54;30;4;26;.867;3600000;0
40523;193545;774;43;33;5;28;.848;3600000;0
40523;189264;4923;0;0;0;0;.00nan;0;0
40523;179406;4923;61;21;2;19;.905;3600000;0
40523;201933;774;0;0;0;0;.00nan;0;0
40524;162979;746;59;22;3;19;.864;3600000;0
40524;174894;754;47;28;4;24;.857;2251000;0
40524;207194;754;81;17;0;17;1.000;1349000;0
40524;149191;746;0;0;0;0;.00nan;0;0
40525;8504;768;0;0;0;0;.00nan;0;0
40525;190589;2197;91;45;2;43;.956;3573000;0
40525;82817;2197;0;0;0;0;.00nan;0;0
40525;149280;768;76;10;0;10;1.000;3600000;0
40526;164424;772;76;48;5;43;.896;3600000;0
40526;-1;911;93;23;0;23;1.000;3600000;0
40526;174858;911;0;0;0;0;.00nan;0;0
40526;85281;772;0;0;0;0;.00nan;0;0
40527;171113;759;0;0;0;0;.00nan;0;0
40527;174898;1503;57;28;3;25;.893;3570000;0
40527;176686;759;84;23;1;22;.957;3600000;0
40527;192386;1503;0;0;0;0;.00nan;0;0
40528;63932;3913;100;29;0;29;1.000;3900000;0
40528;81691;775;0;0;0;0;.00nan;0;0
40528;86343;3913;0;0;0;0;.00nan;0;0
40528;146249;775;98;36;0;36;1.000;3900000;0
40529;188815;762;87;27;1;26;.963;3882000;0
40529;175757;1497;98;25;0;25;1.000;3882000;0
40529;186234;762;0;0;0;0;.00nan;0;0
40529;67446;1497;0;0;0;0;.00nan;0;0
40530;31;755;0;0;0;0;.00nan;0;0
40530;175761;769;48;28;4;24;.857;3578000;0
40530;180154;755;57;23;3;20;.870;3600000;0
40530;145463;769;0;0;0;0;.00nan;0;0
40531;177356;2545;0;0;0;0;.00nan;0;0
40531;180188;4924;0;0;0;0;.00nan;0;0
40531;-1;4924;45;28;4;24;.857;3589000;0
40531;149048;2545;65;28;3;25;.893;3600000;0
40532;166023;767;0;0;0;0;.00nan;0;0
40532;170530;766;78;30;2;28;.933;3600000;0
40532;187348;766;0;0;0;0;.00nan;0;0
40532;149262;767;48;21;3;18;.857;3582000;0
40533;11882;758;0;0;0;0;.00nan;0;0
40533;189581;758;74;44;5;39;.886;3600000;0
40533;171113;759;0;0;0;0;.00nan;0;0
40533;176686;759;77;9;0;9;1.000;3600000;0
40534;193545;774;0;0;0;0;.00nan;0;0
40534;164424;772;62;35;4;31;.886;3600000;0
40534;201933;774;57;25;3;22;.880;3600000;0
40534;85281;772;0;0;0;0;.00nan;0;0
40535;162979;746;85;22;1;21;.955;3900000;0
40535;212428;750;0;0;0;0;.00nan;0;0
40535;180738;750;97;35;1;34;.971;3900000;0
40535;149191;746;0;0;0;0;.00nan;0;0
40536;1756;4989;40;36;6;30;.833;2347000;0
40536;174894;754;55;24;3;21;.875;3600000;0
40536;190570;4989;51;11;1;10;.909;1253000;0
40536;207194;754;0;0;0;0;.00nan;0;0
40537;189264;4923;0;0;0;0;.00nan;0;0
40537;179406;4923;93;35;2;33;.943;3600000;0
40537;190589;2197;71;37;3;34;.919;3553000;0
40537;82817;2197;0;0;0;0;.00nan;0;0
40538;-1;2199;0;0;0;0;.00nan;0;0
40538;63932;3913;92;37;1;36;.973;3600000;0
40538;80222;2199;42;11;2;9;.818;3548000;0
40538;86343;3913;0;0;0;0;.00nan;0;0
40539;31;755;0;0;0;0;.00nan;0;0
40539;175757;1497;77;38;3;35;.921;3566000;0
40539;180154;755;71;27;2;25;.926;3600000;0
40539;67446;1497;0;0;0;0;.00nan;0;0
40540;175761;769;0;0;0;0;.00nan;0;0
40540;180188;4924;54;39;6;33;.846;3600000;0
40540;-1;4924;0;0;0;0;.00nan;0;0
40540;145463;769;91;21;0;21;1.000;3600000;0
40541;188815;762;48;33;4;29;.879;3600000;0
40541;170530;766;0;0;0;0;.00nan;0;0
40541;186234;762;0;0;0;0;.00nan;0;0
40541;187348;766;100;29;0;29;1.000;3600000;0
40542;169680;3730;64;43;5;38;.884;3568000;0
40542;174898;1503;47;20;3;17;.850;3600000;0
40542;192386;1503;0;0;0;0;.00nan;0;0
40542;149112;3730;0;0;0;0;.00nan;0;0
40543;8504;768;0;0;0;0;.00nan;0;0
40543;201075;760;71;59;6;53;.898;3600000;0
40543;142810;760;0;0;0;0;.00nan;0;0
40543;149280;768;72;18;1;17;.944;3600000;0
40544;1756;4989;76;44;4;40;.909;3600000;0
40544;212428;750;0;0;0;0;.00nan;0;0
40544;190570;4989;0;0;0;0;.00nan;0;0
40544;180738;750;80;25;1;24;.960;3600000;0
40545;164424;772;91;34;2;32;.941;3600000;0
40545;190589;2197;0;0;0;0;.00nan;0;0
40545;82817;2197;35;13;3;10;.769;3557000;0
40545;85281;772;0;0;0;0;.00nan;0;0
40546;171113;759;0;0;0;0;.00nan;0;0
40546;176686;759;43;16;3;13;.813;3889000;0
40546;63932;3913;91;43;3;40;.930;3900000;0
40546;86343;3913;0;0;0;0;.00nan;0;0
40547;175757;1497;70;34;3;31;.912;3545000;0
40547;180188;4924;79;28;1;27;.964;3600000;0
40547;-1;4924;0;0;0;0;.00nan;0;0
40547;67446;1497;0;0;0;0;.00nan;0;0
40548;177356;2545;0;0;0;0;.00nan;0;0
40548;175761;769;0;0;0;0;.00nan;0;0
40548;145463;769;78;38;3;35;.921;3582000;0
40548;149048;2545;88;23;1;22;.957;3600000;0
40549;164521;3721;0;0;0;0;.00nan;0;0
40549;67818;3721;100;31;0;31;1.000;3600000;0
40549;81691;775;0;0;0;0;.00nan;0;0
40549;146249;775;92;30;1;29;.967;3600000;0
40550;166226;1093;55;36;5;31;.861;3600000;0
40550;180133;1492;60;5;0;5;1.000;852000;0
40550;181910;1492;25;30;7;23;.767;2720000;0
40550;149103;1093;0;0;0;0;.00nan;0;0
40551;31;755;0;0;0;0;.00nan;0;0
40551;170530;766;0;0;0;0;.00nan;0;0
40551;180154;755;80;32;3;29;.906;3900000;0
40551;187348;766;56;26;3;23;.885;3900000;0
40552;359;760;0;0;0;0;.00nan;0;0
40552;169680;3730;97;40;2;38;.950;3597000;0
40552;142810;760;81;25;1;24;.960;3600000;0
40552;149112;3730;0;0;0;0;.00nan;0;0
40553;189264;4923;0;0;0;0;.00nan;0;0
40553;174898;1503;99;28;0;28;1.000;3600000;0
40553;179406;4923;79;20;1;19;.950;3565000;0
40553;192386;1503;0;0;0;0;.00nan;0;0
40554;8504;768;0;0;0;0;.00nan;0;0
40554;11882;758;0;0;0;0;.00nan;0;0
40554;189581;758;61;38;4;34;.895;3600000;0
40554;149280;768;57;21;3;18;.857;3600000;0
40555;166023;767;0;0;0;0;.00nan;0;0
40555;-1;911;81;31;1;30;.968;3600000;0
40555;174858;911;0;0;0;0;.00nan;0;0
40555;149262;767;87;29;2;27;.931;3541000;0
40556;174894;754;90;34;1;33;.971;3600000;0
40556;207194;754;0;0;0;0;.00nan;0;0
40556;-1;2199;0;0;0;0;.00nan;0;0
40556;80222;2199;77;33;2;31;.939;3553000;0
40557;180133;1492;0;0;0;0;.00nan;0;0
40557;181910;1492;63;24;3;21;.875;3689000;0
40557;81691;775;78;29;2;27;.931;3689000;0
40557;146249;775;0;0;0;0;.00nan;0;0
40558;164521;3721;0;0;0;0;.00nan;0;0
40558;166226;1093;0;0;0;0;.00nan;0;0
40558;67818;3721;53;33;4;29;.879;3600000;0
40558;149103;1093;68;19;1;18;.947;3600000;0
40559;11882;758;50;14;2;12;.857;3600000;0
40559;169680;3730;55;39;5;34;.872;3553000;0
40559;189581;758;0;0;0;0;.00nan;0;0
40559;149112;3730;0;0;0;0;.00nan;0;0
40560;359;760;81;30;2;28;.933;3540000;0
40560;189264;4923;0;0;0;0;.00nan;0;0
40560;179406;4923;84;21;0;21;1.000;3600000;0
40560;142810;760;0;0;0;0;.00nan;0;0
40561;8504;768;92;19;0;19;1.000;3600000;0
40561;63932;3913;56;11;1;10;.909;938000;0
40561;86343;3913;58;48;6;42;.875;2662000;0
40561;149280;768;0;0;0;0;.00nan;0;0
40562;164424;772;77;46;5;41;.891;3593000;0
40562;174898;1503;43;17;3;14;.824;3600000;0
40562;192386;1503;0;0;0;0;.00nan;0;0
40562;85281;772;0;0;0;0;.00nan;0;0
40563;193545;774;57;32;4;28;.875;3559000;0
40563;166023;767;80;28;2;26;.929;3600000;0
40563;201933;774;0;0;0;0;.00nan;0;0
40563;149262;767;0;0;0;0;.00nan;0;0
40564;188815;762;0;0;0;0;.00nan;0;0
40564;-1;911;39;23;5;18;.783;3600000;0
40564;174858;911;0;0;0;0;.00nan;0;0
40564;186234;762;49;29;4;25;.862;3600000;0
40565;180133;1492;65;34;3;31;.912;3600000;0
40565;181910;1492;0;0;0;0;.00nan;0;0
40565;-1;2199;0;0;0;0;.00nan;0;0
40565;80222;2199;96;25;0;25;1.000;3600000;0
40566;164521;3721;0;0;0;0;.00nan;0;0
40566;171113;759;74;22;1;21;.955;3600000;0
40566;176686;759;0;0;0;0;.00nan;0;0
40566;67818;3721;67;41;4;37;.902;3600000;0
40567;175757;1497;70;24;2;22;.917;3594000;0
40567;175761;769;86;32;1;31;.969;3600000;0
40567;67446;1497;0;0;0;0;.00nan;0;0
40567;145463;769;0;0;0;0;.00nan;0;0
40568;174894;754;59;39;4;35;.897;3600000;0
40568;207194;754;0;0;0;0;.00nan;0;0
40568;81691;775;0;0;0;0;.00nan;0;0
40568;146249;775;74;21;1;20;.952;3600000;0
40569;166226;1093;0;0;0;0;.00nan;0;0
40569;212428;750;0;0;0;0;.00nan;0;0
40569;180738;750;59;20;2;18;.900;3556000;0
40569;149103;1093;100;29;0;29;1.000;3600000;0
40570;169680;3730;67;26;2;24;.923;3515000;0
40570;63932;3913;100;30;0;30;1.000;3600000;0
40570;86343;3913;0;0;0;0;.00nan;0;0
40570;149112;3730;0;0;0;0;.00nan;0;0
40571;11882;758;94;22;0;22;1.000;3600000;0
40571;189264;4923;0;0;0;0;.00nan;0;0
40571;189581;758;0;0;0;0;.00nan;0;0
40571;179406;4923;69;32;3;29;.906;3600000;0
40572;8504;768;73;22;1;21;.955;3600000;0
40572;174898;1503;78;43;4;39;.907;3600000;0
40572;192386;1503;0;0;0;0;.00nan;0;0
40572;149280;768;0;0;0;0;.00nan;0;0
40573;359;760;71;37;4;33;.892;3600000;0
40573;164424;772;0;0;0;0;.00nan;0;0
40573;85281;772;74;32;3;29;.906;3600000;0
40573;142810;760;0;0;0;0;.00nan;0;0
40574;1756;4989;0;0;0;0;.00nan;0;0
40574;162979;746;75;25;1;24;.960;3600000;0
40574;190570;4989;90;51;4;47;.922;3600000;0
40574;149191;746;0;0;0;0;.00nan;0;0
40575;166023;767;0;0;0;0;.00nan;0;0
40575;190589;2197;24;35;8;27;.771;3600000;0
40575;82817;2197;0;0;0;0;.00nan;0;0
40575;149262;767;39;23;4;19;.826;3600000;0
40576;193545;774;62;25;3;22;.880;3530000;0
40576;188815;762;100;37;1;36;.973;3600000;0
40576;201933;774;0;0;0;0;.00nan;0;0
40576;186234;762;0;0;0;0;.00nan;0;0
40577;31;755;0;0;0;0;.00nan;0;0
40577;-1;911;26;26;6;20;.769;3544000;0
40577;174858;911;0;0;0;0;.00nan;0;0
40577;180154;755;47;36;5;31;.861;3600000;0
40578;164521;3721;0;0;0;0;.00nan;0;0
40578;-1;2199;0;0;0;0;.00nan;0;0
40578;67818;3721;84;46;4;42;.913;3561000;0
40578;80222;2199;66;25;3;22;.880;3600000;0
40579;171113;759;0;0;0;0;.00nan;0;0
40579;176686;759;53;23;3;20;.870;3702000;0
40579;180133;1492;0;0;0;0;.00nan;0;0
40579;181910;1492;79;43;4;39;.907;3702000;0
40580;170530;766;80;26;2;24;.923;3600000;0
40580;175761;769;43;29;5;24;.828;3600000;0
40580;187348;766;0;0;0;0;.00nan;0;0
40580;145463;769;0;0;0;0;.00nan;0;0
40581;212428;750;0;0;0;0;.00nan;0;0
40581;180738;750;67;28;3;25;.893;3600000;0
40581;81691;775;0;0;0;0;.00nan;0;0
40581;146249;775;74;45;5;40;.889;3544000;0
40582;177356;2545;54;18;2;16;.889;3702000;0
40582;175757;1497;82;32;3;29;.906;3702000;0
40582;67446;1497;0;0;0;0;.00nan;0;0
40582;149048;2545;0;0;0;0;.00nan;0;0
40583;166226;1093;0;0;0;0;.00nan;0;0
40583;174894;754;86;32;2;30;.938;3600000;0
40583;207194;754;0;0;0;0;.00nan;0;0
40583;149103;1093;56;26;4;22;.846;3595000;0
40584;189264;4923;0;0;0;0;.00nan;0;0
40584;179406;4923;47;24;4;20;.833;3680000;0
40584;63932;3913;0;0;0;0;.00nan;0;0
40584;86343;3913;62;30;3;27;.900;3680000;0
40585;-1;911;67;21;2;19;.905;3600000;0
40585;174858;911;0;0;0;0;.00nan;0;0
40585;180188;4924;54;39;4;35;.897;3600000;0
40585;91194;4924;0;0;0;0;.00nan;0;0
40586;164424;772;91;36;2;34;.944;3600000;0
40586;11882;758;0;0;0;0;.00nan;0;0
40586;189581;758;66;32;4;28;.875;3551000;0
40586;85281;772;0;0;0;0;.00nan;0;0
40587;188815;762;92;20;0;20;1.000;3600000;0
40587;190589;2197;78;38;4;34;.895;3600000;0
40587;186234;762;0;0;0;0;.00nan;0;0
40587;82817;2197;0;0;0;0;.00nan;0;0
40588;31;755;0;0;0;0;.00nan;0;0
40588;193545;774;0;0;0;0;.00nan;0;0
40588;180154;755;74;11;0;11;1.000;3600000;0
40588;201933;774;68;22;1;21;.955;3554000;0
40589;212428;750;0;0;0;0;.00nan;0;0
40589;180738;750;55;22;3;19;.864;3544000;0
40589;-1;2199;78;25;2;23;.920;3600000;0
40589;80222;2199;0;0;0;0;.00nan;0;0
40590;171113;759;0;0;0;0;.00nan;0;0
40590;174894;754;36;18;4;14;.778;1073000;0
40590;176686;759;79;13;0;13;1.000;3600000;0
40590;207194;754;56;30;4;26;.867;2527000;0
40591;177356;2545;0;0;0;0;.00nan;0;0
40591;170530;766;61;22;2;20;.909;3546000;0
40591;187348;766;0;0;0;0;.00nan;0;0
40591;149048;2545;93;30;1;29;.967;3600000;0
40592;193545;774;77;28;2;26;.929;3600000;0
40592;180188;4924;53;3;0;3;1.000;373000;0
40592;201933;774;0;0;0;0;.00nan;0;0
40592;91194;4924;41;24;5;19;.792;3227000;0
40593;164424;772;100;44;1;43;.977;3900000;0
40593;63932;3913;96;29;1;28;.966;3900000;0
40593;85281;772;0;0;0;0;.00nan;0;0
40593;86343;3913;0;0;0;0;.00nan;0;0
40594;31;755;0;0;0;0;.00nan;0;0
40594;180154;755;62;28;3;25;.893;3600000;0
40594;190589;2197;58;36;4;32;.889;3587000;0
40594;82817;2197;0;0;0;0;.00nan;0;0
40595;170530;766;73;18;1;17;.944;3600000;0
40595;175757;1497;0;0;0;0;.00nan;0;0
40595;187348;766;0;0;0;0;.00nan;0;0
40595;67446;1497;90;37;2;35;.946;3559000;0
40596;171113;759;0;0;0;0;.00nan;0;0
40596;176686;759;89;24;1;23;.958;3600000;0
40596;212428;750;0;0;0;0;.00nan;0;0
40596;180738;750;65;32;4;28;.875;3600000;0
40597;180188;4924;79;31;2;29;.935;3600000;0
40597;190589;2197;62;30;3;27;.900;3577000;0
40597;82817;2197;0;0;0;0;.00nan;0;0
40597;91194;4924;0;0;0;0;.00nan;0;0
40598;1756;4989;100;37;0;37;1.000;3600000;0
40598;190570;4989;0;0;0;0;.00nan;0;0
40598;81691;775;0;0;0;0;.00nan;0;0
40598;146249;775;92;36;2;34;.944;3550000;0
40599;-1;911;0;0;0;0;.00nan;0;0
40599;174858;911;48;14;2;12;.857;3600000;0
40599;175761;769;55;24;3;21;.875;3600000;0
40599;145463;769;0;0;0;0;.00nan;0;0
40600;166023;767;42;24;4;20;.833;3600000;0
40600;174898;1503;0;0;0;0;.00nan;0;0
40600;192386;1503;67;18;1;17;.944;3600000;0
40600;149262;767;0;0;0;0;.00nan;0;0
40601;164521;3721;60;31;3;28;.903;3900000;0
40601;169680;3730;47;20;3;17;.850;3900000;0
40601;67818;3721;0;0;0;0;.00nan;0;0
40601;149112;3730;0;0;0;0;.00nan;0;0
40602;189264;4923;0;0;0;0;.00nan;0;0
40602;174894;754;0;0;0;0;.00nan;0;0
40602;179406;4923;93;33;2;31;.939;3900000;0
40602;207194;754;78;41;2;39;.951;3871000;0
40603;8504;768;0;0;0;0;.00nan;0;0
40603;180133;1492;0;0;0;0;.00nan;0;0
40603;181910;1492;85;41;3;38;.927;3600000;0
40603;149280;768;80;10;0;10;1.000;3600000;0
40604;11882;758;78;31;2;29;.935;3538000;0
40604;188815;762;95;20;0;20;1.000;3600000;0
40604;189581;758;0;0;0;0;.00nan;0;0
40604;186234;762;0;0;0;0;.00nan;0;0
40605;193545;774;59;20;2;18;.900;3600000;0
40605;175761;769;0;0;0;0;.00nan;0;0
40605;201933;774;0;0;0;0;.00nan;0;0
40605;145463;769;51;41;5;36;.878;3600000;0
40606;1756;4989;0;0;0;0;.00nan;0;0
40606;166226;1093;0;0;0;0;.00nan;0;0
40606;190570;4989;96;56;4;52;.929;3900000;0
40606;149103;1093;45;32;4;28;.875;3900000;0
40607;359;760;99;37;1;36;.973;3600000;0
40607;166023;767;0;0;0;0;.00nan;0;0
40607;142810;760;0;0;0;0;.00nan;0;0
40607;149262;767;56;23;3;20;.870;3570000;0
40608;162979;746;78;32;2;30;.938;3600000;0
40608;81691;775;0;0;0;0;.00nan;0;0
40608;146249;775;88;48;4;44;.917;3537000;0
40608;149191;746;0;0;0;0;.00nan;0;0
40609;177356;2545;0;0;0;0;.00nan;0;0
40609;-1;911;80;29;2;27;.931;3900000;0
40609;174858;911;0;0;0;0;.00nan;0;0
40609;149048;2545;74;32;2;30;.938;3900000;0
40610;31;755;0;0;0;0;.00nan;0;0
40610;174898;1503;78;28;2;26;.929;3600000;0
40610;180154;755;84;30;1;29;.967;3600000;0
40610;192386;1503;0;0;0;0;.00nan;0;0
40611;8504;768;0;0;0;0;.00nan;0;0
40611;164521;3721;0;0;0;0;.00nan;0;0
40611;67818;3721;92;57;3;54;.947;3600000;0
40611;149280;768;56;11;1;10;.909;3600000;0
40612;189264;4923;0;0;0;0;.00nan;0;0
40612;179406;4923;55;26;3;23;.885;3900000;0
40612;212428;750;90;30;3;27;.900;3900000;0
40612;180738;750;0;0;0;0;.00nan;0;0
40613;169680;3730;64;36;4;32;.889;3600000;0
40613;174894;754;80;20;1;19;.950;3600000;0
40613;207194;754;0;0;0;0;.00nan;0;0
40613;149112;3730;0;0;0;0;.00nan;0;0
40614;164424;772;40;39;6;33;.846;3600000;0
40614;180133;1492;75;26;1;25;.962;3600000;0
40614;181910;1492;0;0;0;0;.00nan;0;0
40614;85281;772;0;0;0;0;.00nan;0;0
40615;11882;758;0;0;0;0;.00nan;0;0
40615;166023;767;75;28;1;27;.964;3600000;0
40615;189581;758;60;22;2;20;.909;3559000;0
40615;149262;767;0;0;0;0;.00nan;0;0
40616;177356;2545;0;0;0;0;.00nan;0;0
40616;193545;774;0;0;0;0;.00nan;0;0
40616;201933;774;49;35;5;30;.857;3600000;0
40616;149048;2545;78;21;1;20;.952;3600000;0
40617;1756;4989;95;43;2;41;.953;3571000;0
40617;171113;759;0;0;0;0;.00nan;0;0
40617;176686;759;54;9;1;8;.889;3600000;0
40617;190570;4989;0;0;0;0;.00nan;0;0
40618;31;755;0;0;0;0;.00nan;0;0
40618;359;760;100;36;1;35;.972;3600000;0
40618;180154;755;61;33;3;30;.909;3557000;0
40618;142810;760;0;0;0;0;.00nan;0;0
40619;162979;746;85;10;0;10;1.000;3600000;0
40619;166226;1093;0;0;0;0;.00nan;0;0
40619;149103;1093;98;50;3;47;.940;3600000;0
40619;149191;746;0;0;0;0;.00nan;0;0
40620;175761;769;0;0;0;0;.00nan;0;0
40620;190589;2197;73;27;1;26;.963;3900000;0
40620;82817;2197;0;0;0;0;.00nan;0;0
40620;145463;769;95;30;1;29;.967;3900000;0
40621;-1;911;92;38;1;37;.974;3600000;0
40621;174858;911;0;0;0;0;.00nan;0;0
40621;175757;1497;58;31;3;28;.903;3535000;0
40621;67446;1497;0;0;0;0;.00nan;0;0
40622;174898;1503;77;10;0;10;1.000;3600000;0
40622;180188;4924;0;0;0;0;.00nan;0;0
40622;192386;1503;0;0;0;0;.00nan;0;0
40622;91194;4924;75;25;1;24;.960;3600000;0
40623;188815;762;77;30;3;27;.900;3600000;0
40623;186234;762;0;0;0;0;.00nan;0;0
40623;63932;3913;0;0;0;0;.00nan;0;0
40623;86343;3913;73;40;4;36;.900;3544000;0
40624;164424;772;100;26;0;26;1.000;3600000;0
40624;164521;3721;0;0;0;0;.00nan;0;0
40624;67818;3721;58;28;4;24;.857;3600000;0
40624;85281;772;0;0;0;0;.00nan;0;0
40625;169680;3730;81;38;3;35;.921;3885000;0
40625;212428;750;0;0;0;0;.00nan;0;0
40625;180738;750;51;27;4;23;.852;3885000;0
40625;149112;3730;0;0;0;0;.00nan;0;0
40626;8504;768;76;21;1;20;.952;3600000;0
40626;174894;754;94;44;2;42;.955;3600000;0
40626;207194;754;0;0;0;0;.00nan;0;0
40626;149280;768;0;0;0;0;.00nan;0;0
40627;189264;4923;0;0;0;0;.00nan;0;0
40627;179406;4923;58;18;2;16;.889;3600000;0
40627;180133;1492;0;0;0;0;.00nan;0;0
40627;181910;1492;58;35;4;31;.886;3546000;0
40628;31;755;0;0;0;0;.00nan;0;0
40628;11882;758;50;25;4;21;.840;3900000;0
40628;189581;758;0;0;0;0;.00nan;0;0
40628;180154;755;49;34;4;30;.882;3900000;0
40629;193545;774;58;37;4;33;.892;3600000;0
40629;175757;1497;94;35;1;34;.971;3600000;0
40629;201933;774;0;0;0;0;.00nan;0;0
40629;67446;1497;0;0;0;0;.00nan;0;0
40630;1756;4989;0;0;0;0;.00nan;0;0
40630;190570;4989;98;43;1;42;.977;3600000;0
40630;-1;2199;0;0;0;0;.00nan;0;0
40630;80222;2199;100;27;0;27;1.000;3600000;0
40631;359;760;0;0;0;0;.00nan;0;0
40631;180188;4924;69;26;2;24;.923;3900000;0
40631;91194;4924;0;0;0;0;.00nan;0;0
40631;142810;760;76;29;2;27;.931;3900000;0
40632;162979;746;100;55;2;53;.964;3600000;0
40632;171113;759;48;0;0;0;.00nan;640000;0
40632;176686;759;24;25;6;19;.760;2960000;0
40632;149191;746;0;0;0;0;.00nan;0;0
40633;177356;2545;0;0;0;0;.00nan;0;0
40633;190589;2197;0;0;0;0;.00nan;0;0
40633;82817;2197;71;22;2;20;.909;3600000;0
40633;149048;2545;99;35;1;34;.971;3600000;0
40634;-1;911;58;27;3;24;.889;3600000;0
40634;170530;766;71;22;2;20;.909;3600000;0
40634;174858;911;0;0;0;0;.00nan;0;0
40634;187348;766;0;0;0;0;.00nan;0;0
40635;188815;762;73;20;1;19;.950;3600000;0
40635;174898;1503;59;24;3;21;.875;3584000;0
40635;186234;762;0;0;0;0;.00nan;0;0
40635;192386;1503;0;0;0;0;.00nan;0;0
40636;166023;767;0;0;0;0;.00nan;0;0
40636;63932;3913;54;37;5;32;.865;3578000;0
40636;86343;3913;0;0;0;0;.00nan;0;0
40636;149262;767;64;24;3;21;.875;3600000;0
40637;164521;3721;0;0;0;0;.00nan;0;0
40637;189264;4923;0;0;0;0;.00nan;0;0
40637;179406;4923;49;19;3;16;.842;3600000;0
40637;67818;3721;100;45;0;45;1.000;3600000;0
40638;8504;768;0;0;0;0;.00nan;0;0
40638;212428;750;0;0;0;0;.00nan;0;0
40638;180738;750;77;41;3;38;.927;3590000;0
40638;149280;768;60;16;2;14;.875;3600000;0
40639;164424;772;82;25;1;24;.960;3600000;0
40639;174894;754;65;29;2;27;.931;3600000;0
40639;207194;754;0;0;0;0;.00nan;0;0
40639;85281;772;0;0;0;0;.00nan;0;0
40640;169680;3730;38;24;4;20;.833;3556000;0
40640;180133;1492;0;0;0;0;.00nan;0;0
40640;181910;1492;66;32;3;29;.906;3600000;0
40640;149112;3730;0;0;0;0;.00nan;0;0
40641;11882;758;0;0;0;0;.00nan;0;0
40641;189581;758;81;35;3;32;.914;3576000;0
40641;180188;4924;0;0;0;0;.00nan;0;0
40641;91194;4924;55;19;2;17;.895;3600000;0
40642;193545;774;0;0;0;0;.00nan;0;0
40642;170530;766;93;38;2;36;.947;3900000;0
40642;201933;774;83;32;2;30;.938;3900000;0
40642;187348;766;0;0;0;0;.00nan;0;0
40643;359;760;44;20;3;17;.850;3600000;0
40643;188815;762;25;25;6;19;.760;2448000;0
40643;186234;762;60;9;0;9;1.000;1152000;0
40643;142810;760;0;0;0;0;.00nan;0;0
40644;162979;746;65;15;1;14;.933;3600000;0
40644;-1;2199;0;0;0;0;.00nan;0;0
40644;80222;2199;69;29;3;26;.897;3545000;0
40644;149191;746;0;0;0;0;.00nan;0;0
40645;175757;1497;84;34;3;31;.912;3555000;0
40645;190589;2197;89;36;2;34;.944;3600000;0
40645;67446;1497;0;0;0;0;.00nan;0;0
40645;82817;2197;0;0;0;0;.00nan;0;0
40646;31;755;0;0;0;0;.00nan;0;0
40646;180154;755;78;24;1;23;.958;3600000;0
40646;63932;3913;0;0;0;0;.00nan;0;0
40646;86343;3913;64;31;3;28;.903;3513000;0
40647;164424;772;78;38;3;35;.921;3600000;0
40647;212428;750;0;0;0;0;.00nan;0;0
40647;180738;750;53;26;4;22;.846;3555000;0
40647;85281;772;0;0;0;0;.00nan;0;0
40648;166226;1093;0;0;0;0;.00nan;0;0
40648;81691;775;0;0;0;0;.00nan;0;0
40648;146249;775;66;24;2;22;.917;3543000;0
40648;149103;1093;87;35;1;34;.971;3600000;0
40649;170530;766;70;24;2;22;.917;3622000;0
40649;190589;2197;71;31;3;28;.903;3622000;0
40649;187348;766;0;0;0;0;.00nan;0;0
40649;82817;2197;0;0;0;0;.00nan;0;0
40650;177356;2545;0;0;0;0;.00nan;0;0
40650;175761;769;0;0;0;0;.00nan;0;0
40650;145463;769;96;41;2;39;.951;3588000;0
40650;149048;2545;59;14;1;13;.929;3600000;0
40651;180188;4924;77;39;3;36;.923;3544000;0
40651;63932;3913;64;22;2;20;.909;3600000;0
40651;86343;3913;0;0;0;0;.00nan;0;0
40651;91194;4924;0;0;0;0;.00nan;0;0
40652;164521;3721;0;0;0;0;.00nan;0;0
40652;169680;3730;0;0;0;0;.00nan;0;0
40652;67818;3721;57;30;4;26;.867;3600000;0
40652;149112;3730;57;31;5;26;.839;3530000;0
40653;189264;4923;83;28;1;27;.964;3600000;0
40653;174894;754;0;0;0;0;.00nan;0;0
40653;179406;4923;0;0;0;0;.00nan;0;0
40653;207194;754;67;37;4;33;.892;3600000;0
40654;1756;4989;48;44;6;38;.864;3600000;0
40654;171113;759;0;0;0;0;.00nan;0;0
40654;176686;759;81;15;0;15;1.000;3600000;0
40654;190570;4989;0;0;0;0;.00nan;0;0
40655;193545;774;84;40;3;37;.925;3600000;0
40655;175757;1497;31;24;6;18;.750;3093000;0
40655;201933;774;0;0;0;0;.00nan;0;0
40655;67446;1497;59;6;0;6;1.000;507000;0
40656;11882;758;49;28;4;24;.857;3570000;0
40656;166023;767;72;33;3;30;.909;3600000;0
40656;189581;758;0;0;0;0;.00nan;0;0
40656;149262;767;0;0;0;0;.00nan;0;0
40657;188815;762;0;0;0;0;.00nan;0;0
40657;174898;1503;67;27;3;24;.889;3600000;0
40657;186234;762;59;31;4;27;.871;3545000;0
40657;192386;1503;0;0;0;0;.00nan;0;0
40658;177356;2545;0;0;0;0;.00nan;0;0
40658;-1;911;53;17;2;15;.882;3600000;0
40658;174858;911;0;0;0;0;.00nan;0;0
40658;149048;2545;61;46;5;41;.891;3600000;0
40659;31;755;94;26;0;26;1.000;3600000;0
40659;359;760;0;0;0;0;.00nan;0;0
40659;180154;755;0;0;0;0;.00nan;0;0
40659;142810;760;74;40;3;37;.925;3600000;0
40660;169680;3730;89;15;0;15;1.000;3600000;0
40660;180133;1492;0;0;0;0;.00nan;0;0
40660;181910;1492;61;26;3;23;.885;3600000;0
40660;149112;3730;0;0;0;0;.00nan;0;0
40661;164521;3721;0;0;0;0;.00nan;0;0
40661;189264;4923;0;0;0;0;.00nan;0;0
40661;179406;4923;77;19;2;17;.895;3600000;0
40661;67818;3721;98;48;3;45;.938;3570000;0
40662;1756;4989;0;0;0;0;.00nan;0;0
40662;190570;4989;85;38;4;34;.895;3600000;0
40662;-1;2199;0;0;0;0;.00nan;0;0
40662;80222;2199;81;24;1;23;.958;3600000;0
40663;8504;768;71;20;1;19;.950;3600000;0
40663;212428;750;0;0;0;0;.00nan;0;0
40663;180738;750;80;42;4;38;.905;3600000;0
40663;149280;768;0;0;0;0;.00nan;0;0
40664;164424;772;75;25;1;24;.960;3600000;0
40664;174894;754;46;40;6;34;.850;3600000;0
40664;207194;754;0;0;0;0;.00nan;0;0
40664;85281;772;0;0;0;0;.00nan;0;0
40665;162979;746;64;40;5;35;.875;3900000;0
40665;171113;759;0;0;0;0;.00nan;0;0
40665;176686;759;53;31;5;26;.839;3900000;0
40665;149191;746;0;0;0;0;.00nan;0;0
40666;175757;1497;0;0;0;0;.00nan;0;0
40666;190589;2197;67;33;3;30;.909;3532000;0
40666;67446;1497;83;28;1;27;.964;3600000;0
40666;82817;2197;0;0;0;0;.00nan;0;0
40667;359;760;75;45;5;40;.889;3600000;0
40667;180188;4924;84;16;0;16;1.000;3600000;0
40667;91194;4924;0;0;0;0;.00nan;0;0
40667;142810;760;0;0;0;0;.00nan;0;0
40668;-1;911;67;24;2;22;.917;3600000;0
40668;174858;911;0;0;0;0;.00nan;0;0
40668;175761;769;65;35;3;32;.914;3600000;0
40668;145463;769;0;0;0;0;.00nan;0;0
40669;166023;767;0;0;0;0;.00nan;0;0
40669;63932;3913;0;0;0;0;.00nan;0;0
40669;86343;3913;52;39;5;34;.872;3600000;0
40669;149262;767;45;20;3;17;.850;3600000;0
40670;11882;758;0;0;0;0;.00nan;0;0
40670;188815;762;79;26;2;24;.923;3900000;0
40670;189581;758;100;40;2;38;.950;3900000;0
40670;186234;762;0;0;0;0;.00nan;0;0
40671;31;755;70;32;3;29;.906;3600000;0
40671;174898;1503;53;36;6;30;.833;3600000;0
40671;180154;755;0;0;0;0;.00nan;0;0
40671;192386;1503;0;0;0;0;.00nan;0;0
40672;193545;774;0;0;0;0;.00nan;0;0
40672;170530;766;69;18;1;17;.944;3600000;0
40672;201933;774;59;31;4;27;.871;3600000;0
40672;187348;766;0;0;0;0;.00nan;0;0
40673;169680;3730;53;45;6;39;.867;3600000;0
40673;212428;750;0;0;0;0;.00nan;0;0
40673;180738;750;47;17;3;14;.824;3600000;0
40673;149112;3730;0;0;0;0;.00nan;0;0
40674;189264;4923;0;0;0;0;.00nan;0;0
40674;179406;4923;73;23;1;22;.957;3600000;0
40674;180133;1492;54;5;0;5;1.000;445000;0
40674;181910;1492;39;36;6;30;.833;3155000;0
40675;162979;746;91;35;1;34;.971;3600000;0
40675;-1;2199;0;0;0;0;.00nan;0;0
40675;80222;2199;56;29;4;25;.862;3600000;0
40675;149191;746;0;0;0;0;.00nan;0;0
40676;8504;768;0;0;0;0;.00nan;0;0
40676;174894;754;74;39;3;36;.923;3599000;0
40676;207194;754;0;0;0;0;.00nan;0;0
40676;149280;768;69;18;2;16;.889;3600000;0
40677;164424;772;72;25;2;23;.920;3819000;0
40677;164521;3721;0;0;0;0;.00nan;0;0
40677;67818;3721;94;35;1;34;.971;3819000;0
40677;85281;772;0;0;0;0;.00nan;0;0
40678;1756;4989;0;0;0;0;.00nan;0;0
40678;166226;1093;0;0;0;0;.00nan;0;0
40678;190570;4989;54;40;5;35;.875;3600000;0
40678;149103;1093;100;25;0;25;1.000;3600000;0
40679;-1;911;80;12;0;12;1.000;3600000;0
40679;174858;911;0;0;0;0;.00nan;0;0
40679;175757;1497;91;40;2;38;.950;3575000;0
40679;67446;1497;0;0;0;0;.00nan;0;0
40680;174898;1503;84;46;4;42;.913;3656000;0
40680;180188;4924;62;29;3;26;.897;3656000;0
40680;192386;1503;0;0;0;0;.00nan;0;0
40680;91194;4924;0;0;0;0;.00nan;0;0
40681;359;760;0;0;0;0;.00nan;0;0
40681;166023;767;83;30;2;28;.933;3600000;0
40681;142810;760;52;38;5;33;.868;3600000;0
40681;149262;767;0;0;0;0;.00nan;0;0
40682;188815;762;66;24;2;22;.917;3600000;0
40682;186234;762;0;0;0;0;.00nan;0;0
40682;63932;3913;92;27;1;26;.963;3600000;0
40682;86343;3913;0;0;0;0;.00nan;0;0
40683;177356;2545;59;24;3;21;.875;3516000;0
40683;193545;774;0;0;0;0;.00nan;0;0
40683;201933;774;91;27;1;26;.963;3600000;0
40683;94107;2545;0;0;0;0;.00nan;0;0
40684;31;755;0;0;0;0;.00nan;0;0
40684;11882;758;60;17;1;16;.941;3675000;0
40684;189581;758;0;0;0;0;.00nan;0;0
40684;180154;755;78;33;2;31;.939;3675000;0
40685;170530;766;39;23;4;19;.826;2314000;0
40685;190589;2197;64;34;3;31;.912;3600000;0
40685;187348;766;53;3;0;3;1.000;1261000;0
40685;82817;2197;0;0;0;0;.00nan;0;0
40686;169680;3730;0;0;0;0;.00nan;0;0
40686;174894;754;79;31;1;30;.968;3900000;0
40686;207194;754;0;0;0;0;.00nan;0;0
40686;149048;3730;100;36;1;35;.972;3900000;0
40687;189264;4923;0;0;0;0;.00nan;0;0
40687;179406;4923;100;26;0;26;1.000;3600000;0
40687;212428;750;0;0;0;0;.00nan;0;0
40687;180738;750;69;33;3;30;.909;3600000;0
40688;8504;768;56;17;2;15;.882;3600000;0
40688;164521;3721;0;0;0;0;.00nan;0;0
40688;67818;3721;40;35;6;29;.829;3600000;0
40688;149280;768;0;0;0;0;.00nan;0;0
40689;164424;772;100;36;0;36;1.000;3600000;0
40689;180133;1492;0;0;0;0;.00nan;0;0
40689;181910;1492;90;37;2;35;.946;3600000;0
40689;85281;772;0;0;0;0;.00nan;0;0
40690;1756;4989;49;8;1;7;.875;1520000;0
40690;190570;4989;25;28;6;22;.786;2080000;0
40690;81691;775;0;0;0;0;.00nan;0;0
40690;146249;775;90;19;0;19;1.000;3600000;0
40691;162979;746;72;18;1;17;.944;3600000;0
40691;166226;1093;0;0;0;0;.00nan;0;0
40691;149103;1093;74;41;3;38;.927;3576000;0
40691;149191;746;0;0;0;0;.00nan;0;0
40692;11882;758;0;0;0;0;.00nan;0;0
40692;189581;758;76;24;1;23;.958;3600000;0
40692;180188;4924;0;0;0;0;.00nan;0;0
40692;91194;4924;80;26;2;24;.923;3570000;0
40693;193545;774;72;29;2;27;.931;3554000;0
40693;175761;769;0;0;0;0;.00nan;0;0
40693;201933;774;0;0;0;0;.00nan;0;0
40693;145463;769;83;27;1;26;.963;3600000;0
40694;166023;767;0;0;0;0;.00nan;0;0
40694;174898;1503;71;24;2;22;.917;3600000;0
40694;192386;1503;0;0;0;0;.00nan;0;0
40694;149262;767;89;47;4;43;.915;3600000;0
40695;359;760;53;24;3;21;.875;3600000;0
40695;188815;762;100;29;0;29;1.000;3600000;0
40695;186234;762;0;0;0;0;.00nan;0;0
40695;142810;760;0;0;0;0;.00nan;0;0
40696;177356;2545;0;0;0;0;.00nan;0;0
40696;190589;2197;55;21;3;18;.857;3548000;0
40696;82817;2197;0;0;0;0;.00nan;0;0
40696;94107;2545;84;33;2;31;.939;3600000;0
40697;31;755;0;0;0;0;.00nan;0;0
40697;180154;755;79;37;3;34;.919;3522000;0
40697;63932;3913;0;0;0;0;.00nan;0;0
40697;86343;3913;83;27;1;26;.963;3600000;0
40698;-1;911;73;25;2;23;.920;3600000;0
40698;170530;766;77;43;4;39;.907;3523000;0
40698;174858;911;0;0;0;0;.00nan;0;0
40698;187348;766;0;0;0;0;.00nan;0;0
40699;8504;768;0;0;0;0;.00nan;0;0
40699;180133;1492;0;0;0;0;.00nan;0;0
40699;181910;1492;98;47;2;45;.957;3600000;0
40699;149280;768;57;10;1;9;.900;3600000;0
40700;164424;772;92;40;3;37;.925;3517000;0
40700;212428;750;0;0;0;0;.00nan;0;0
40700;180738;750;98;30;1;29;.967;3600000;0
40700;85281;772;0;0;0;0;.00nan;0;0
40701;162979;746;69;21;2;19;.905;3900000;0
40701;81691;775;0;0;0;0;.00nan;0;0
40701;146249;775;98;54;2;52;.963;3885000;0
40701;149191;746;0;0;0;0;.00nan;0;0
40702;180188;4924;100;27;0;27;1.000;3600000;0
40702;63932;3913;73;28;2;26;.929;3556000;0
40702;86343;3913;0;0;0;0;.00nan;0;0
40702;91194;4924;0;0;0;0;.00nan;0;0
40703;175761;769;0;0;0;0;.00nan;0;0
40703;190589;2197;48;28;4;24;.857;3600000;0
40703;82817;2197;0;0;0;0;.00nan;0;0
40703;145463;769;34;33;6;27;.818;3542000;0
40704;170530;766;82;35;2;33;.943;3600000;0
40704;175757;1497;0;0;0;0;.00nan;0;0
40704;187348;766;0;0;0;0;.00nan;0;0
40704;67446;1497;48;22;3;19;.864;3550000;0
40705;164521;3721;60;52;5;47;.904;3600000;0
40705;171113;759;0;0;0;0;.00nan;0;0
40705;176686;759;54;15;2;13;.867;3600000;0
40705;67818;3721;0;0;0;0;.00nan;0;0
40706;174894;754;94;32;1;31;.969;3600000;0
40706;207194;754;0;0;0;0;.00nan;0;0
40706;-1;2199;0;0;0;0;.00nan;0;0
40706;80222;2199;64;23;2;21;.913;3546000;0
40707;11882;758;70;29;2;27;.931;3600000;0
40707;189264;4923;0;0;0;0;.00nan;0;0
40707;189581;758;0;0;0;0;.00nan;0;0
40707;179406;4923;60;15;1;14;.933;3600000;0
40708;31;755;0;0;0;0;.00nan;0;0
40708;193545;774;0;0;0;0;.00nan;0;0
40708;180154;755;64;22;2;20;.909;3583000;0
40708;201933;774;88;29;1;28;.966;3600000;0
40709;188815;762;35;31;6;25;.806;3179000;0
40709;166023;767;75;24;1;23;.958;3600000;0
40709;186234;762;49;1;0;1;1.000;421000;0
40709;149262;767;0;0;0;0;.00nan;0;0
40710;359;760;0;0;0;0;.00nan;0;0
40710;169680;3730;100;37;0;37;1.000;3600000;0
40710;142810;760;53;12;1;11;.917;3545000;0
40710;149048;3730;0;0;0;0;.00nan;0;0
40711;164521;3721;0;0;0;0;.00nan;0;0
40711;67818;3721;75;44;4;40;.909;3600000;0
40711;81691;775;0;0;0;0;.00nan;0;0
40711;146249;775;48;17;3;14;.824;3600000;0
40712;212428;750;0;0;0;0;.00nan;0;0
40712;180738;750;78;34;2;32;.941;3546000;0
40712;-1;2199;0;0;0;0;.00nan;0;0
40712;80222;2199;78;26;1;25;.962;3600000;0
40713;171113;759;0;0;0;0;.00nan;0;0
40713;174894;754;48;29;4;25;.862;3580000;0
40713;176686;759;61;19;2;17;.895;3600000;0
40713;207194;754;0;0;0;0;.00nan;0;0
40714;166226;1093;0;0;0;0;.00nan;0;0
40714;180133;1492;70;38;3;35;.921;3900000;0
40714;181910;1492;0;0;0;0;.00nan;0;0
40714;149103;1093;54;25;3;22;.880;3900000;0
40715;177356;2545;93;33;1;32;.970;3900000;0
40715;175757;1497;89;27;1;26;.963;3900000;0
40715;67446;1497;0;0;0;0;.00nan;0;0
40715;94107;2545;0;0;0;0;.00nan;0;0
40716;8504;768;66;16;1;15;.938;3600000;0
40716;11882;758;70;17;0;17;1.000;1599000;0
40716;189581;758;18;21;6;15;.714;2001000;0
40716;149280;768;0;0;0;0;.00nan;0;0
40717;193545;774;77;26;1;25;.962;3600000;0
40717;180188;4924;58;20;2;18;.900;3545000;0
40717;201933;774;0;0;0;0;.00nan;0;0
40717;91194;4924;0;0;0;0;.00nan;0;0
40718;359;760;84;33;3;30;.909;3600000;0
40718;164424;772;46;31;5;26;.839;3552000;0
40718;85281;772;0;0;0;0;.00nan;0;0
40718;142810;760;0;0;0;0;.00nan;0;0
40719;31;755;0;0;0;0;.00nan;0;0
40719;180154;755;49;19;3;16;.842;3600000;0
40719;190589;2197;0;0;0;0;.00nan;0;0
40719;82817;2197;34;24;5;19;.792;3528000;0
40720;169680;3730;83;55;4;51;.927;3600000;0
40720;174898;1503;85;25;1;24;.960;3600000;0
40720;192386;1503;0;0;0;0;.00nan;0;0
40720;149048;3730;0;0;0;0;.00nan;0;0
40721;189264;4923;0;0;0;0;.00nan;0;0
40721;179406;4923;78;23;2;21;.913;3656000;0
40721;63932;3913;0;0;0;0;.00nan;0;0
40721;86343;3913;99;46;1;45;.978;3656000;0
40722;164521;3721;0;0;0;0;.00nan;0;0
40722;166226;1093;0;0;0;0;.00nan;0;0
40722;67818;3721;56;29;4;25;.862;3600000;0
40722;149103;1093;70;33;3;30;.909;3600000;0
40723;171113;759;0;0;0;0;.00nan;0;0
40723;176686;759;81;23;1;22;.957;3600000;0
40723;212428;750;0;0;0;0;.00nan;0;0
40723;180738;750;93;45;3;42;.933;3543000;0
40724;1756;4989;79;56;6;50;.893;3600000;0
40724;162979;746;0;0;0;0;.00nan;0;0
40724;190570;4989;0;0;0;0;.00nan;0;0
40724;149191;746;73;19;1;18;.947;3600000;0
40725;174894;754;0;0;0;0;.00nan;0;0
40725;207194;754;89;38;3;35;.921;3900000;0
40725;81691;775;0;0;0;0;.00nan;0;0
40725;146249;775;71;34;3;31;.912;3898000;0
40726;180133;1492;0;0;0;0;.00nan;0;0
40726;181910;1492;85;26;1;25;.962;3600000;0
40726;-1;2199;0;0;0;0;.00nan;0;0
40726;80222;2199;52;24;3;21;.875;3600000;0
40727;175757;1497;0;0;0;0;.00nan;0;0
40727;175761;769;0;0;0;0;.00nan;0;0
40727;67446;1497;73;33;4;29;.879;3544000;0
40727;145463;769;60;25;3;22;.880;3600000;0
40728;11882;758;63;9;1;8;.889;3600000;0
40728;169680;3730;0;0;0;0;.00nan;0;0
40728;189581;758;0;0;0;0;.00nan;0;0
40728;149048;3730;73;38;3;35;.921;3512000;0
40729;193545;774;0;0;0;0;.00nan;0;0
40729;166023;767;0;0;0;0;.00nan;0;0
40729;201933;774;64;41;5;36;.878;3568000;0
40729;149262;767;50;22;3;19;.864;3600000;0
40730;359;760;0;0;0;0;.00nan;0;0
40730;189264;4923;0;0;0;0;.00nan;0;0
40730;179406;4923;70;29;3;26;.897;3600000;0
40730;142810;760;40;44;6;38;.864;3591000;0
40731;180188;4924;92;17;0;17;1.000;3600000;0
40731;190589;2197;57;28;3;25;.893;3600000;0
40731;82817;2197;0;0;0;0;.00nan;0;0
40731;91194;4924;0;0;0;0;.00nan;0;0
40732;31;755;0;0;0;0;.00nan;0;0
40732;-1;911;0;0;0;0;.00nan;0;0
40732;174858;911;48;23;3;20;.870;3547000;0
40732;180154;755;100;39;1;38;.974;3600000;0
40733;164424;772;59;44;5;39;.886;3600000;0
40733;174898;1503;87;26;1;25;.962;3600000;0
40733;192386;1503;0;0;0;0;.00nan;0;0
40733;85281;772;0;0;0;0;.00nan;0;0
40734;8504;768;0;0;0;0;.00nan;0;0
40734;63932;3913;99;42;1;41;.976;3600000;0
40734;86343;3913;0;0;0;0;.00nan;0;0
40734;149280;768;76;27;2;25;.926;3600000;0
40735;177356;2545;0;0;0;0;.00nan;0;0
40735;170530;766;40;20;5;15;.750;3600000;0
40735;187348;766;0;0;0;0;.00nan;0;0
40735;94107;2545;69;27;2;25;.926;3600000;0
40736;164521;3721;0;0;0;0;.00nan;0;0
40736;-1;2199;0;0;0;0;.00nan;0;0
40736;67818;3721;72;23;2;21;.913;3587000;0
40736;80222;2199;73;21;1;20;.952;3600000;0
40737;212428;750;0;0;0;0;.00nan;0;0
40737;180738;750;92;36;1;35;.972;3600000;0
40737;81691;775;0;0;0;0;.00nan;0;0
40737;146249;775;66;21;2;19;.905;3569000;0
40738;166226;1093;0;0;0;0;.00nan;0;0
40738;174894;754;81;32;2;30;.938;3600000;0
40738;207194;754;0;0;0;0;.00nan;0;0
40738;149103;1093;53;36;4;32;.889;3564000;0
40739;171113;759;0;0;0;0;.00nan;0;0
40739;176686;759;53;20;3;17;.850;3600000;0
40739;180133;1492;69;35;4;31;.886;3588000;0
40739;181910;1492;0;0;0;0;.00nan;0;0
40740;164424;772;65;37;5;32;.865;3600000;0
40740;11882;758;0;0;0;0;.00nan;0;0
40740;189581;758;75;21;1;20;.952;3600000;0
40740;85281;772;0;0;0;0;.00nan;0;0
40741;193545;774;0;0;0;0;.00nan;0;0
40741;188815;762;68;18;1;17;.944;3600000;0
40741;201933;774;61;33;3;30;.909;3576000;0
40741;186234;762;0;0;0;0;.00nan;0;0
40742;359;760;88;39;2;37;.949;3900000;0
40742;8504;768;53;18;2;16;.889;3900000;0
40742;142810;760;0;0;0;0;.00nan;0;0
40742;149280;768;0;0;0;0;.00nan;0;0
40743;166023;767;96;30;1;29;.967;3813000;0
40743;190589;2197;78;32;2;30;.938;3813000;0
40743;82817;2197;0;0;0;0;.00nan;0;0
40743;149262;767;0;0;0;0;.00nan;0;0
40744;-1;911;58;26;3;23;.885;3600000;0
40744;174858;911;0;0;0;0;.00nan;0;0
40744;180188;4924;58;30;4;26;.867;3584000;0
40744;91194;4924;0;0;0;0;.00nan;0;0
40745;189264;4923;0;0;0;0;.00nan;0;0
40745;174898;1503;56;23;2;21;.913;3900000;0
40745;179406;4923;70;22;2;20;.909;3900000;0
40745;192386;1503;0;0;0;0;.00nan;0;0
40746;169680;3730;0;0;0;0;.00nan;0;0
40746;63932;3913;0;0;0;0;.00nan;0;0
40746;86343;3913;65;21;2;19;.905;3600000;0
40746;149048;3730;83;46;3;43;.935;3578000;0
40747;170530;766;92;21;0;21;1.000;3600000;0
40747;175761;769;0;0;0;0;.00nan;0;0
40747;187348;766;0;0;0;0;.00nan;0;0
40747;145463;769;66;33;3;30;.909;3600000;0
40748;166226;1093;0;0;0;0;.00nan;0;0
40748;212428;750;64;26;3;23;.885;3600000;0
40748;180738;750;0;0;0;0;.00nan;0;0
40748;149103;1093;35;25;4;21;.840;3600000;0
40749;180133;1492;0;0;0;0;.00nan;0;0
40749;181910;1492;65;44;5;39;.886;3600000;0
40749;81691;775;0;0;0;0;.00nan;0;0
40749;146249;775;76;38;3;35;.921;3600000;0
40750;188815;762;53;16;2;14;.875;3559000;0
40750;190589;2197;75;23;1;22;.957;3600000;0
40750;186234;762;0;0;0;0;.00nan;0;0
40750;82817;2197;0;0;0;0;.00nan;0;0
40751;166023;767;0;0;0;0;.00nan;0;0
40751;-1;911;60;33;4;29;.879;3561000;0
40751;174858;911;0;0;0;0;.00nan;0;0
40751;149262;767;68;37;3;34;.919;3600000;0
40752;8504;768;0;0;0;0;.00nan;0;0
40752;174898;1503;86;45;3;42;.933;3554000;0
40752;192386;1503;0;0;0;0;.00nan;0;0
40752;149280;768;65;19;2;17;.895;3600000;0
40753;164424;772;57;32;4;28;.875;3600000;0
40753;63932;3913;96;33;1;32;.970;3600000;0
40753;85281;772;0;0;0;0;.00nan;0;0
40753;86343;3913;0;0;0;0;.00nan;0;0
40754;1756;4989;64;24;2;22;.917;2946000;0
40754;174894;754;68;27;3;24;.889;3600000;0
40754;190570;4989;18;7;4;3;.429;654000;0
40754;207194;754;0;0;0;0;.00nan;0;0
40755;162979;746;100;27;0;27;1.000;3600000;0
40755;164521;3721;0;0;0;0;.00nan;0;0
40755;67818;3721;64;34;3;31;.912;3600000;0
40755;149191;746;0;0;0;0;.00nan;0;0
40756;193545;774;71;37;3;34;.919;3584000;0
40756;189264;4923;88;31;1;30;.968;3600000;0
40756;179406;4923;0;0;0;0;.00nan;0;0
40756;201933;774;0;0;0;0;.00nan;0;0
40757;11882;758;75;27;2;25;.926;3600000;0
40757;189581;758;0;0;0;0;.00nan;0;0
40757;-1;2199;0;0;0;0;.00nan;0;0
40757;80222;2199;45;28;5;23;.821;3600000;0
40758;175757;1497;63;25;3;22;.880;3600000;0
40758;180188;4924;64;22;2;20;.909;3600000;0
40758;67446;1497;0;0;0;0;.00nan;0;0
40758;91194;4924;0;0;0;0;.00nan;0;0
40759;359;760;0;0;0;0;.00nan;0;0
40759;171113;759;82;22;1;21;.955;3600000;0
40759;176686;759;0;0;0;0;.00nan;0;0
40759;142810;760;97;48;2;46;.958;3600000;0
40760;188815;762;67;39;4;35;.897;3549000;0
40760;-1;911;71;28;3;25;.893;3600000;0
40760;174858;911;0;0;0;0;.00nan;0;0
40760;186234;762;0;0;0;0;.00nan;0;0
40761;31;755;91;41;2;39;.951;3600000;0
40761;170530;766;62;29;3;26;.897;3548000;0
40761;180154;755;0;0;0;0;.00nan;0;0
40761;187348;766;0;0;0;0;.00nan;0;0
40762;1756;4989;0;0;0;0;.00nan;0;0
40762;164521;3721;0;0;0;0;.00nan;0;0
40762;190570;4989;44;28;5;23;.821;3600000;0
40762;67818;3721;68;25;2;23;.920;3600000;0
40763;162979;746;83;26;1;25;.962;3600000;0
40763;174894;754;77;48;4;44;.917;3600000;0
40763;207194;754;0;0;0;0;.00nan;0;0
40763;149191;746;0;0;0;0;.00nan;0;0
40764;189264;4923;0;0;0;0;.00nan;0;0
40764;179406;4923;100;27;0;27;1.000;3600000;0
40764;190589;2197;46;17;4;13;.765;1021000;0
40764;82817;2197;52;23;3;20;.870;2579000;0
40765;359;760;0;0;0;0;.00nan;0;0
40765;-1;2199;0;0;0;0;.00nan;0;0
40765;80222;2199;68;22;2;20;.909;3600000;0
40765;142810;760;70;36;3;33;.917;3600000;0
40766;170530;766;82;27;1;26;.963;3600000;0
40766;180188;4924;0;0;0;0;.00nan;0;0
40766;187348;766;0;0;0;0;.00nan;0;0
40766;91194;4924;56;24;2;22;.917;3557000;0
40767;193545;774;36;21;4;17;.810;3573000;0
40767;164424;772;0;0;0;0;.00nan;0;0
40767;201933;774;0;0;0;0;.00nan;0;0
40767;85281;772;49;35;5;30;.857;3611000;0
40768;171113;759;0;0;0;0;.00nan;0;0
40768;176686;759;78;25;2;23;.920;3600000;0
40768;63932;3913;0;0;0;0;.00nan;0;0
40768;86343;3913;82;41;3;38;.927;3596000;0
40769;166023;767;29;23;5;18;.783;3600000;0
40769;175757;1497;75;29;2;27;.931;3600000;0
40769;67446;1497;0;0;0;0;.00nan;0;0
40769;149262;767;0;0;0;0;.00nan;0;0
40770;11882;758;0;0;0;0;.00nan;0;0
40770;189581;758;74;19;1;18;.947;3600000;0
40770;81691;775;0;0;0;0;.00nan;0;0
40770;146249;775;74;30;2;28;.933;3600000;0
40771;166226;1093;30;23;5;18;.783;3600000;0
40771;174898;1503;100;28;0;28;1.000;3600000;0
40771;192386;1503;0;0;0;0;.00nan;0;0
40771;149103;1093;0;0;0;0;.00nan;0;0
40772;31;755;0;0;0;0;.00nan;0;0
40772;177356;2545;81;42;2;40;.952;3900000;0
40772;180154;755;75;26;2;24;.923;3900000;0
40772;94107;2545;0;0;0;0;.00nan;0;0
40773;1756;4989;0;0;0;0;.00nan;0;0
40773;212428;750;0;0;0;0;.00nan;0;0
40773;190570;4989;93;40;1;39;.975;3643000;0
40773;180738;750;78;28;2;26;.929;3643000;0
40774;162979;746;85;16;0;16;1.000;3600000;0
40774;180133;1492;0;0;0;0;.00nan;0;0
40774;181910;1492;78;40;3;37;.925;3600000;0
40774;149191;746;0;0;0;0;.00nan;0;0
40775;189264;4923;0;0;0;0;.00nan;0;0
40775;-1;911;73;20;1;19;.950;3600000;0
40775;174858;911;0;0;0;0;.00nan;0;0
40775;179406;4923;42;35;5;30;.857;3600000;0
40776;-1;2199;0;0;0;0;.00nan;0;0
40776;63932;3913;65;36;4;32;.889;3600000;0
40776;80222;2199;25;18;5;13;.722;3590000;0
40776;86343;3913;0;0;0;0;.00nan;0;0
40777;177356;2545;0;0;0;0;.00nan;0;0
40777;180188;4924;100;23;0;23;1.000;3600000;0
40777;91194;4924;0;0;0;0;.00nan;0;0
40777;94107;2545;62;31;3;28;.903;3600000;0
40778;8504;768;59;13;1;12;.923;3600000;0
40778;193545;774;0;0;0;0;.00nan;0;0
40778;201933;774;62;42;4;38;.905;3600000;0
40778;149280;768;0;0;0;0;.00nan;0;0
40779;164424;772;58;19;2;17;.895;3600000;0
40779;190589;2197;69;33;3;30;.909;3600000;0
40779;82817;2197;0;0;0;0;.00nan;0;0
40779;85281;772;0;0;0;0;.00nan;0;0
40780;171113;759;0;0;0;0;.00nan;0;0
40780;174898;1503;91;33;1;32;.970;3579000;0
40780;176686;759;87;23;0;23;1.000;3600000;0
40780;192386;1503;0;0;0;0;.00nan;0;0
40781;166023;767;0;0;0;0;.00nan;0;0
40781;170530;766;54;33;4;29;.879;3600000;0
40781;187348;766;0;0;0;0;.00nan;0;0
40781;149262;767;62;26;3;23;.885;3600000;0
40782;359;760;0;0;0;0;.00nan;0;0
40782;81691;775;100;29;0;29;1.000;3600000;0
40782;142810;760;60;33;3;30;.909;3600000;0
40782;146249;775;0;0;0;0;.00nan;0;0
40783;188815;762;0;0;0;0;.00nan;0;0
40783;175757;1497;0;0;0;0;.00nan;0;0
40783;186234;762;85;20;1;19;.950;3600000;0
40783;67446;1497;71;33;3;30;.909;3556000;0
40784;11882;758;23;33;7;26;.788;3160000;0
40784;166226;1093;0;0;0;0;.00nan;0;0
40784;189581;758;44;3;1;2;.667;440000;0
40784;149103;1093;79;28;2;26;.929;3600000;0
40785;31;755;0;0;0;0;.00nan;0;0
40785;175761;769;0;0;0;0;.00nan;0;0
40785;180154;755;63;26;4;22;.846;3600000;0
40785;145463;769;91;43;3;40;.930;3600000;0
40786;1756;4989;83;35;2;33;.943;3600000;0
40786;180133;1492;0;0;0;0;.00nan;0;0
40786;190570;4989;0;0;0;0;.00nan;0;0
40786;181910;1492;68;18;1;17;.944;3600000;0
40787;162979;746;48;21;3;18;.857;3900000;0
40787;212428;750;0;0;0;0;.00nan;0;0
40787;180738;750;98;51;3;48;.941;3900000;0
40787;149191;746;0;0;0;0;.00nan;0;0
40788;193545;774;35;17;4;13;.765;3549000;0
40788;169680;3730;0;0;0;0;.00nan;0;0
40788;201933;774;0;0;0;0;.00nan;0;0
40788;149048;3730;66;30;3;27;.900;3600000;0
40789;174898;1503;81;28;2;26;.929;3900000;0
40789;192386;1503;0;0;0;0;.00nan;0;0
40789;-1;2199;0;0;0;0;.00nan;0;0
40789;80222;2199;83;28;2;26;.929;3900000;0
40790;175761;769;0;0;0;0;.00nan;0;0
40790;180188;4924;33;29;6;23;.793;2174000;0
40790;91194;4924;53;9;1;8;.889;1426000;0
40790;145463;769;100;32;0;32;1.000;3600000;0
40791;8504;768;0;0;0;0;.00nan;0;0
40791;190589;2197;98;43;2;41;.953;3592000;0
40791;82817;2197;0;0;0;0;.00nan;0;0
40791;149280;768;63;14;1;13;.929;3600000;0
40792;164424;772;85;33;2;31;.939;3900000;0
40792;-1;911;100;35;2;33;.943;3900000;0
40792;174858;911;0;0;0;0;.00nan;0;0
40792;85281;772;0;0;0;0;.00nan;0;0
40793;11882;758;0;0;0;0;.00nan;0;0
40793;189581;758;95;39;2;37;.949;3594000;0
40793;171113;759;0;0;0;0;.00nan;0;0
40793;176686;759;94;18;0;18;1.000;3600000;0
40794;177356;2545;51;35;4;31;.886;3600000;0
40794;166023;767;0;0;0;0;.00nan;0;0
40794;94107;2545;0;0;0;0;.00nan;0;0
40794;149262;767;78;25;1;24;.960;3600000;0
40795;63932;3913;0;0;0;0;.00nan;0;0
40795;81691;775;47;30;4;26;.867;3593000;0
40795;86343;3913;61;34;3;31;.912;3600000;0
40795;146249;775;0;0;0;0;.00nan;0;0
40796;188815;762;33;25;5;20;.800;3600000;0
40796;170530;766;77;30;2;28;.933;3600000;0
40796;186234;762;0;0;0;0;.00nan;0;0
40796;187348;766;0;0;0;0;.00nan;0;0
40797;359;760;99;37;1;36;.973;3600000;0
40797;166226;1093;0;0;0;0;.00nan;0;0
40797;142810;760;0;0;0;0;.00nan;0;0
40797;149103;1093;34;24;5;19;.792;3600000;0
40798;31;755;48;26;4;22;.846;3565000;0
40798;175757;1497;86;30;2;28;.933;3600000;0
40798;180154;755;0;0;0;0;.00nan;0;0
40798;67446;1497;0;0;0;0;.00nan;0;0
40799;169680;3730;62;5;0;5;1.000;834000;0
40799;190589;2197;52;25;4;21;.840;3600000;0
40799;82817;2197;0;0;0;0;.00nan;0;0
40799;149048;3730;36;30;6;24;.800;2738000;0
40800;8504;768;100;33;0;33;1.000;3600000;0
40800;-1;911;25;28;6;22;.786;3600000;0
40800;174858;911;0;0;0;0;.00nan;0;0
40800;149280;768;0;0;0;0;.00nan;0;0
40801;166023;767;69;20;2;18;.900;3600000;0
40801;175761;769;0;0;0;0;.00nan;0;0
40801;145463;769;95;48;3;45;.938;3543000;0
40801;149262;767;0;0;0;0;.00nan;0;0
40802;174898;1503;74;34;3;31;.912;3585000;0
40802;192386;1503;0;0;0;0;.00nan;0;0
40802;81691;775;0;0;0;0;.00nan;0;0
40802;146249;775;92;32;1;31;.969;3600000;0
40803;177356;2545;32;11;3;8;.727;1104000;0
40803;188815;762;47;25;4;21;.840;3600000;0
40803;186234;762;0;0;0;0;.00nan;0;0
40803;94107;2545;20;24;6;18;.750;2496000;0
40804;166226;1093;0;0;0;0;.00nan;0;0
40804;63932;3913;0;0;0;0;.00nan;0;0
40804;86343;3913;97;43;1;42;.977;3900000;0
40804;149103;1093;90;31;1;30;.968;3900000;0
40805;164521;3721;70;34;3;31;.912;3634000;0
40805;174894;754;68;26;2;24;.923;3634000;0
40805;207194;754;0;0;0;0;.00nan;0;0
40805;67818;3721;0;0;0;0;.00nan;0;0
40806;3241;911;0;0;0;0;.00nan;0;0
40806;-1;911;88;16;0;16;1.000;3600000;0
40806;169680;3730;0;0;0;0;.00nan;0;0
40806;149048;3730;79;25;1;24;.960;3585000;0
40807;1756;4989;0;0;0;0;.00nan;0;0
40807;11882;758;0;0;0;0;.00nan;0;0
40807;189581;758;38;17;4;13;.765;3536000;0
40807;190570;4989;86;35;2;33;.943;3600000;0
40808;193545;774;95;50;4;46;.920;3555000;0
40808;171113;759;0;0;0;0;.00nan;0;0
40808;176686;759;70;24;2;22;.917;3600000;0
40808;201933;774;0;0;0;0;.00nan;0;0
40809;188815;762;68;21;1;20;.952;3600000;0
40809;175761;769;0;0;0;0;.00nan;0;0
40809;186234;762;0;0;0;0;.00nan;0;0
40809;145463;769;86;31;2;29;.935;3544000;0
40810;164521;3721;0;0;0;0;.00nan;0;0
40810;212428;750;0;0;0;0;.00nan;0;0
40810;180738;750;78;28;2;26;.929;3600000;0
40810;67818;3721;99;33;1;32;.970;3600000;0
40811;3199;754;0;0;0;0;.00nan;0;0
40811;174894;754;43;29;5;24;.828;3558000;0
40811;180133;1492;77;43;4;39;.907;3600000;0
40811;181910;1492;0;0;0;0;.00nan;0;0
40812;164424;772;85;28;2;26;.929;3554000;0
40812;170530;766;66;18;1;17;.944;3600000;0
40812;187348;766;0;0;0;0;.00nan;0;0
40812;85281;772;0;0;0;0;.00nan;0;0
40813;31;755;0;0;0;0;.00nan;0;0
40813;180154;755;62;27;3;24;.889;3533000;0
40813;180188;4924;92;30;1;29;.967;3600000;0
40813;91194;4924;0;0;0;0;.00nan;0;0
40814;193545;774;76;31;3;28;.903;3900000;0
40814;201933;774;0;0;0;0;.00nan;0;0
40814;-1;2199;0;0;0;0;.00nan;0;0
40814;80222;2199;51;18;3;15;.833;3900000;0
40815;171113;759;0;0;0;0;.00nan;0;0
40815;176686;759;68;23;1;22;.957;3632000;0
40815;190589;2197;0;0;0;0;.00nan;0;0
40815;82817;2197;80;34;2;32;.941;3632000;0
40816;1756;4989;94;32;2;30;.938;3900000;0
40816;190570;4989;0;0;0;0;.00nan;0;0
40816;86343;3913;53;20;2;18;.900;3900000;0
40816;87758;3913;0;0;0;0;.00nan;0;0
40817;164424;772;36;37;6;31;.838;3600000;0
40817;175757;1497;70;20;2;18;.900;3600000;0
40817;67446;1497;0;0;0;0;.00nan;0;0
40817;85281;772;0;0;0;0;.00nan;0;0
40818;180133;1492;0;0;0;0;.00nan;0;0
40818;212428;750;0;0;0;0;.00nan;0;0
40818;180738;750;72;22;1;21;.955;3600000;0
40818;181910;1492;44;20;3;17;.850;3533000;0
40819;63932;1093;88;26;1;25;.962;3600000;0
40819;81691;775;0;0;0;0;.00nan;0;0
40819;146249;775;64;25;2;23;.920;3567000;0
40819;149103;1093;0;0;0;0;.00nan;0;0
40820;189264;4923;0;0;0;0;.00nan;0;0
40820;170530;766;92;20;0;20;1.000;3600000;0
40820;179406;4923;41;27;5;22;.815;3600000;0
40820;81733;766;0;0;0;0;.00nan;0;0
40821;169680;3730;0;0;0;0;.00nan;0;0
40821;175761;769;84;43;3;40;.930;3600000;0
40821;145463;769;0;0;0;0;.00nan;0;0
40821;149048;3730;100;34;1;33;.971;3600000;0
40822;190589;2197;87;35;2;33;.943;3900000;0
40822;-1;2199;0;0;0;0;.00nan;0;0
40822;80222;2199;85;30;2;28;.933;3900000;0
40822;82817;2197;0;0;0;0;.00nan;0;0
40823;3241;911;0;0;0;0;.00nan;0;0
40823;-1;911;61;40;5;35;.875;3600000;0
40823;171113;759;0;0;0;0;.00nan;0;0
40823;176686;759;55;18;2;16;.889;3600000;0
40824;188815;762;71;23;1;22;.957;3600000;0
40824;166023;767;0;0;0;0;.00nan;0;0
40824;186234;762;0;0;0;0;.00nan;0;0
40824;149262;767;62;31;3;28;.903;3562000;0
40825;177356;2545;74;39;4;35;.897;3528000;0
40825;8504;768;64;18;2;16;.889;3600000;0
40825;94107;2545;0;0;0;0;.00nan;0;0
40825;149280;768;0;0;0;0;.00nan;0;0
40826;1756;4989;78;36;3;33;.917;3569000;0
40826;174898;1503;100;39;1;38;.974;3600000;0
40826;190570;4989;0;0;0;0;.00nan;0;0
40826;192386;1503;0;0;0;0;.00nan;0;0
40827;162979;746;58;20;2;18;.900;3600000;0
40827;86343;3913;74;36;4;32;.889;3537000;0
40827;87758;3913;0;0;0;0;.00nan;0;0
40827;149191;746;0;0;0;0;.00nan;0;0
40828;189264;4923;0;0;0;0;.00nan;0;0
40828;179406;4923;100;25;0;25;1.000;3600000;0
40828;175757;1497;71;34;3;31;.912;3600000;0
40828;67446;1497;0;0;0;0;.00nan;0;0
40829;3199;754;0;0;0;0;.00nan;0;0
40829;174894;754;67;30;3;27;.900;3548000;0
40829;212428;750;0;0;0;0;.00nan;0;0
40829;180738;750;66;26;2;24;.923;3600000;0
40830;164521;3721;0;0;0;0;.00nan;0;0
40830;180133;1492;0;0;0;0;.00nan;0;0
40830;181910;1492;100;28;0;28;1.000;3600000;0
40830;67818;3721;73;40;4;36;.900;3600000;0
40831;162979;746;40;14;3;11;.786;3600000;0
40831;11882;758;88;42;2;40;.952;3596000;0
40831;189581;758;0;0;0;0;.00nan;0;0
40831;149191;746;0;0;0;0;.00nan;0;0
40832;8504;768;0;0;0;0;.00nan;0;0
40832;175761;769;37;16;3;13;.813;861000;0
40832;145463;769;37;35;6;29;.829;2739000;0
40832;149280;768;82;14;0;14;1.000;3600000;0
40833;359;760;39;17;3;14;.824;3600000;0
40833;1756;4989;0;0;0;0;.00nan;0;0
40833;190570;4989;95;24;0;24;1.000;3600000;0
40833;142810;760;0;0;0;0;.00nan;0;0
40834;3241;911;0;0;0;0;.00nan;0;0
40834;-1;911;58;31;4;27;.871;3600000;0
40834;-1;2199;0;0;0;0;.00nan;0;0
40834;80222;2199;81;30;2;28;.933;3600000;0
40835;177356;2545;42;4;1;3;.750;334000;0
40835;169680;3730;0;0;0;0;.00nan;0;0
40835;94107;2545;21;28;6;22;.786;3266000;0
40835;149048;3730;100;46;2;44;.957;3600000;0
40836;201933;774;52;24;3;21;.875;3600000;0
40836;67294;774;0;0;0;0;.00nan;0;0
40836;81691;775;0;0;0;0;.00nan;0;0
40836;146249;775;95;43;2;41;.953;3600000;0
40837;166023;767;51;28;4;24;.857;3543000;0
40837;180188;4924;64;30;3;27;.900;3600000;0
40837;91194;4924;0;0;0;0;.00nan;0;0
40837;149262;767;0;0;0;0;.00nan;0;0
40838;31;755;55;45;6;39;.867;3600000;0
40838;188815;762;66;17;1;16;.941;3600000;0
40838;180154;755;0;0;0;0;.00nan;0;0
40838;186234;762;0;0;0;0;.00nan;0;0
40839;201933;774;53;27;4;23;.852;3600000;0
40839;63932;1093;44;29;5;24;.828;3544000;0
40839;67294;774;0;0;0;0;.00nan;0;0
40839;149103;1093;0;0;0;0;.00nan;0;0
40840;175761;769;0;0;0;0;.00nan;0;0
40840;85281;772;54;22;3;19;.864;3600000;0
40840;145463;769;78;41;4;37;.902;3562000;0
40840;149305;772;0;0;0;0;.00nan;0;0
40841;190589;2197;79;36;2;34;.944;3600000;0
40841;81691;775;0;0;0;0;.00nan;0;0
40841;82817;2197;0;0;0;0;.00nan;0;0
40841;146249;775;53;22;3;19;.864;3562000;0
40842;177356;2545;89;44;2;42;.955;3545000;0
40842;189264;4923;0;0;0;0;.00nan;0;0
40842;179406;4923;94;20;0;20;1.000;3600000;0
40842;94107;2545;0;0;0;0;.00nan;0;0
40843;169680;3730;0;0;0;0;.00nan;0;0
40843;175757;1497;87;30;1;29;.967;3900000;0
40843;180606;1497;0;0;0;0;.00nan;0;0
40843;149048;3730;82;27;1;26;.963;3900000;0
40844;164424;759;0;0;0;0;.00nan;0;0
40844;176686;759;69;26;3;23;.885;3900000;0
40844;-1;2199;73;37;3;34;.919;3900000;0
40844;80222;2199;0;0;0;0;.00nan;0;0
40845;188815;762;56;28;3;25;.893;3600000;0
40845;180188;4924;57;37;4;33;.892;3570000;0
40845;186234;762;0;0;0;0;.00nan;0;0
40845;91194;4924;0;0;0;0;.00nan;0;0
40846;212428;750;0;0;0;0;.00nan;0;0
40846;180738;750;100;37;0;37;1.000;3600000;0
40846;86343;3913;56;25;3;22;.880;3600000;0
40846;87758;3913;0;0;0;0;.00nan;0;0
40847;162979;746;74;25;1;24;.960;3600000;0
40847;174898;1503;100;36;0;36;1.000;3600000;0
40847;192386;1503;0;0;0;0;.00nan;0;0
40847;149280;746;0;0;0;0;.00nan;0;0
40848;31;755;0;0;0;0;.00nan;0;0
40848;166023;767;0;0;0;0;.00nan;0;0
40848;180154;755;40;38;6;32;.842;3573000;0
40848;149262;767;48;25;4;21;.840;3600000;0
40849;177124;768;0;0;0;0;.00nan;0;0
40849;8504;768;59;11;1;10;.909;3600000;0
40849;170530;766;58;35;4;31;.886;3600000;0
40849;81733;766;0;0;0;0;.00nan;0;0
40850;189264;4923;0;0;0;0;.00nan;0;0
40850;179406;4923;55;11;2;9;.818;3600000;0
40850;175761;769;91;60;3;57;.950;3600000;0
40850;145463;769;0;0;0;0;.00nan;0;0
40851;190589;2197;94;31;1;30;.968;3600000;0
40851;63932;1093;84;44;3;41;.932;3567000;0
40851;82817;2197;0;0;0;0;.00nan;0;0
40851;149103;1093;0;0;0;0;.00nan;0;0
40852;3241;911;0;0;0;0;.00nan;0;0
40852;-1;911;66;22;2;20;.909;3600000;0
40852;81691;775;0;0;0;0;.00nan;0;0
40852;146249;775;75;31;3;28;.903;3588000;0
40853;177356;2545;46;43;6;37;.860;3600000;0
40853;85281;772;75;19;1;18;.947;3600000;0
40853;94107;2545;0;0;0;0;.00nan;0;0
40853;149305;772;0;0;0;0;.00nan;0;0
40854;177124;768;0;0;0;0;.00nan;0;0
40854;8504;768;45;10;2;8;.800;3556000;0
40854;175757;1497;100;43;1;42;.977;3600000;0
40854;180606;1497;0;0;0;0;.00nan;0;0
40855;11882;758;0;0;0;0;.00nan;0;0
40855;189581;758;69;39;4;35;.897;3737000;0
40855;212428;750;0;0;0;0;.00nan;0;0
40855;180738;750;69;41;5;36;.878;3737000;0
40856;359;760;53;3;0;3;1.000;386000;0
40856;162979;746;86;29;1;28;.966;3600000;0
40856;142810;760;42;36;6;30;.833;3214000;0
40856;149280;746;0;0;0;0;.00nan;0;0
40857;174894;754;0;0;0;0;.00nan;0;0
40857;207194;754;75;30;3;27;.900;3891000;0
40857;86343;3913;80;32;3;29;.906;3900000;0
40857;87758;3913;0;0;0;0;.00nan;0;0
40858;169680;3730;0;0;0;0;.00nan;0;0
40858;170530;766;48;24;4;20;.833;3536000;0
40858;81733;766;0;0;0;0;.00nan;0;0
40858;149048;3730;69;26;2;24;.923;3600000;0
40859;3241;911;0;0;0;0;.00nan;0;0
40859;-1;911;47;26;4;22;.846;3566000;0
40859;63932;1093;82;41;3;38;.927;3600000;0
40859;149103;1093;0;0;0;0;.00nan;0;0
40860;164521;3721;0;0;0;0;.00nan;0;0
40860;67818;3721;53;27;3;24;.889;3600000;0
40860;86343;3913;85;39;2;37;.949;3600000;0
40860;87758;3913;0;0;0;0;.00nan;0;0
40861;174898;1503;49;42;6;36;.857;3600000;0
40861;212428;750;0;0;0;0;.00nan;0;0
40861;180738;750;97;21;0;21;1.000;3600000;0
40861;192386;1503;0;0;0;0;.00nan;0;0
40862;1756;4989;89;43;3;40;.930;3600000;0
40862;190570;4989;0;0;0;0;.00nan;0;0
40862;67294;774;0;0;0;0;.00nan;0;0
40862;149191;774;58;20;2;18;.900;3600000;0
40863;11882;758;29;29;6;23;.793;3600000;0
40863;189581;758;0;0;0;0;.00nan;0;0
40863;174894;754;71;34;3;31;.912;3600000;0
40863;207194;754;0;0;0;0;.00nan;0;0
40864;189264;4923;0;0;0;0;.00nan;0;0
40864;170530;755;26;29;6;23;.793;3197000;0
40864;179406;4923;100;31;0;31;1.000;3600000;0
40864;180154;755;42;3;1;2;.667;403000;0
40865;-1;2199;0;0;0;0;.00nan;0;0
40865;76628;766;69;29;2;27;.931;3581000;0
40865;80222;2199;100;33;1;32;.970;3600000;0
40865;81733;766;0;0;0;0;.00nan;0;0
40866;180188;4924;100;25;0;25;1.000;3600000;0
40866;85281;772;82;26;1;25;.962;3570000;0
40866;91194;4924;0;0;0;0;.00nan;0;0
40866;149305;772;0;0;0;0;.00nan;0;0
40867;164424;759;46;19;3;16;.842;3600000;0
40867;175757;1497;82;45;3;42;.933;2798000;0
40867;192386;1497;23;11;4;7;.636;802000;0
40867;148904;759;0;0;0;0;.00nan;0;0
40868;81691;775;44;16;3;13;.813;3600000;0
40868;94107;2545;82;33;2;31;.939;3600000;0
40868;146249;775;0;0;0;0;.00nan;0;0
40868;158276;2545;0;0;0;0;.00nan;0;0
40869;164521;3721;0;0;0;0;.00nan;0;0
40869;189581;758;0;0;0;0;.00nan;0;0
40869;176686;758;71;27;2;25;.926;3600000;0
40869;67818;3721;44;24;4;20;.833;3557000;0
40870;359;760;0;0;0;0;.00nan;0;0
40870;212428;750;0;0;0;0;.00nan;0;0
40870;180738;750;92;32;1;31;.969;3600000;0
40870;142810;760;79;42;3;39;.929;3570000;0
40871;1756;4989;0;0;0;0;.00nan;0;0
40871;190570;4989;69;25;2;23;.920;3600000;0
40871;190589;2197;33;20;4;16;.800;3531000;0
40871;82817;2197;0;0;0;0;.00nan;0;0
40872;162979;746;0;0;0;0;.00nan;0;0
40872;67294;774;0;0;0;0;.00nan;0;0
40872;149191;774;55;41;6;35;.854;3600000;0
40872;149280;746;96;16;0;16;1.000;3600000;0
40873;174894;754;0;0;0;0;.00nan;0;0
40873;174898;1503;66;30;3;27;.900;3564000;0
40873;207194;754;87;35;2;33;.943;3600000;0
40873;196698;1503;0;0;0;0;.00nan;0;0
40874;181910;1492;68;37;4;33;.892;3600000;0
40874;86343;1492;0;0;0;0;.00nan;0;0
40874;87758;3913;36;18;4;14;.778;2374000;0
40874;148675;3913;38;10;3;7;.700;1226000;0
40875;169680;3730;40;8;2;6;.750;1166000;0
40875;170530;755;64;25;3;22;.880;3600000;0
40875;180154;755;0;0;0;0;.00nan;0;0
40875;149048;3730;34;29;6;23;.793;2434000;0
40876;166023;767;50;24;4;20;.833;3549000;0
40876;189264;4923;0;0;0;0;.00nan;0;0
40876;179406;4923;76;24;2;22;.917;3600000;0
40876;149262;767;0;0;0;0;.00nan;0;0
40877;-1;2199;0;0;0;0;.00nan;0;0
40877;80222;2199;83;26;1;25;.962;3600000;0
40877;94107;2545;58;32;4;28;.875;3600000;0
40877;158276;2545;0;0;0;0;.00nan;0;0
40878;177124;768;0;0;0;0;.00nan;0;0
40878;8504;768;80;23;1;22;.957;3600000;0
40878;180188;4924;52;46;6;40;.870;3600000;0
40878;91194;4924;0;0;0;0;.00nan;0;0
40879;188815;762;58;23;3;20;.870;3848000;0
40879;186234;762;0;0;0;0;.00nan;0;0
40879;85281;772;0;0;0;0;.00nan;0;0
40879;149305;772;94;32;2;30;.938;3848000;0
40880;164424;759;67;19;1;18;.947;3600000;0
40880;76628;766;75;24;1;23;.958;3050000;0
40880;81733;766;26;7;3;4;.571;550000;0
40880;148904;759;0;0;0;0;.00nan;0;0
40881;175761;769;0;0;0;0;.00nan;0;0
40881;81691;775;0;0;0;0;.00nan;0;0
40881;145463;769;60;43;5;38;.884;3546000;0
40881;146249;775;46;17;3;14;.824;3600000;0
40882;175757;1497;81;35;3;32;.914;3900000;0
40882;192386;1497;0;0;0;0;.00nan;0;0
40882;63932;1093;70;28;3;25;.893;3900000;0
40882;149103;1093;0;0;0;0;.00nan;0;0
40883;164521;3721;0;0;0;0;.00nan;0;0
40883;174898;1503;96;17;0;17;1.000;3600000;0
40883;196698;1503;0;0;0;0;.00nan;0;0
40883;67818;3721;91;41;1;40;.976;3546000;0
40884;1756;4989;80;37;2;35;.946;3579000;0
40884;3241;911;0;0;0;0;.00nan;0;0
40884;-1;911;91;21;0;21;1.000;3600000;0
40884;190570;4989;0;0;0;0;.00nan;0;0
40885;162979;746;0;0;0;0;.00nan;0;0
40885;190589;2197;76;44;3;41;.932;3538000;0
40885;82817;2197;0;0;0;0;.00nan;0;0
40885;149280;746;78;19;1;18;.947;3600000;0
40886;359;760;88;40;2;38;.950;3551000;0
40886;174894;754;77;24;1;23;.958;3600000;0
40886;207194;754;0;0;0;0;.00nan;0;0
40886;142810;760;0;0;0;0;.00nan;0;0
40887;189581;758;0;0;0;0;.00nan;0;0
40887;176686;758;81;39;2;37;.949;3900000;0
40887;181910;1492;0;0;0;0;.00nan;0;0
40887;86343;1492;67;22;2;20;.909;3884000;0
40888;169680;3730;0;0;0;0;.00nan;0;0
40888;180188;4924;0;0;0;0;.00nan;0;0
40888;91194;4924;100;26;0;26;1.000;3600000;0
40888;149048;3730;48;24;3;21;.875;3600000;0
40889;188815;762;100;33;0;33;1.000;3600000;0
40889;189264;4923;0;0;0;0;.00nan;0;0
40889;179406;4923;59;28;4;24;.857;3600000;0
40889;186234;762;0;0;0;0;.00nan;0;0
40890;175761;769;0;0;0;0;.00nan;0;0
40890;-1;2199;0;0;0;0;.00nan;0;0
40890;80222;2199;61;25;4;21;.840;3623000;0
40890;145463;769;65;27;3;24;.889;3623000;0
40891;177124;768;0;0;0;0;.00nan;0;0
40891;8504;768;81;11;0;11;1.000;3600000;0
40891;170530;755;97;52;2;50;.962;3600000;0
40891;180154;755;0;0;0;0;.00nan;0;0
40892;166023;767;0;0;0;0;.00nan;0;0
40892;85281;772;93;42;4;38;.905;3546000;0
40892;149262;767;68;23;2;21;.913;3600000;0
40892;149305;772;0;0;0;0;.00nan;0;0
40893;164424;759;57;20;2;18;.900;3600000;0
40893;94107;2545;0;0;0;0;.00nan;0;0
40893;148904;759;0;0;0;0;.00nan;0;0
40893;158276;2545;56;36;5;31;.861;3600000;0
40894;175757;1497;50;40;6;34;.850;3124000;0
40894;192386;1497;42;3;1;2;.667;476000;0
40894;81691;775;84;26;1;25;.962;3600000;0
40894;146249;775;0;0;0;0;.00nan;0;0
40895;63932;1093;83;29;2;27;.931;3898000;0
40895;76628;766;0;0;0;0;.00nan;0;0
40895;81733;766;71;24;2;22;.917;3900000;0
40895;149103;1093;0;0;0;0;.00nan;0;0
40896;359;760;0;0;0;0;.00nan;0;0
40896;164521;3721;0;0;0;0;.00nan;0;0
40896;67818;3721;80;27;1;26;.963;3600000;0
40896;142810;760;72;32;2;30;.938;3567000;0
40897;212428;750;0;0;0;0;.00nan;0;0
40897;180738;750;46;19;3;16;.842;3550000;0
40897;67294;774;85;36;2;34;.944;3600000;0
40897;149191;774;0;0;0;0;.00nan;0;0
40898;3241;911;0;0;0;0;.00nan;0;0
40898;162979;746;83;26;1;25;.962;3600000;0
40898;-1;911;83;38;2;36;.947;3546000;0
40898;149280;746;0;0;0;0;.00nan;0;0
40899;174898;1503;76;20;1;19;.950;3900000;0
40899;181910;1492;0;0;0;0;.00nan;0;0
40899;196698;1503;0;0;0;0;.00nan;0;0
40899;86343;1492;72;28;1;27;.964;3900000;0
40900;188815;762;66;30;3;27;.900;3752000;0
40900;169680;3730;0;0;0;0;.00nan;0;0
40900;186234;762;0;0;0;0;.00nan;0;0
40900;149048;3730;51;25;4;21;.840;3752000;0
40901;189264;4923;0;0;0;0;.00nan;0;0
40901;179406;4923;65;15;1;14;.933;3600000;0
40901;180188;4924;58;39;5;34;.872;3600000;0
40901;91194;4924;0;0;0;0;.00nan;0;0
40902;175757;1497;69;47;5;42;.894;3600000;0
40902;192386;1497;0;0;0;0;.00nan;0;0
40902;-1;2199;0;0;0;0;.00nan;0;0
40902;80222;2199;77;25;1;24;.960;3600000;0
40903;177124;768;0;0;0;0;.00nan;0;0
40903;8504;768;68;23;2;21;.913;3562000;0
40903;166023;767;91;30;1;29;.967;3600000;0
40903;149262;767;0;0;0;0;.00nan;0;0
40904;170530;755;67;31;4;27;.871;3555000;0
40904;180154;755;0;0;0;0;.00nan;0;0
40904;85281;772;57;22;2;20;.909;3600000;0
40904;149305;772;0;0;0;0;.00nan;0;0
40905;164424;759;75;23;1;22;.957;3600000;0
40905;175761;769;77;20;0;20;1.000;807000;0
40905;145463;769;38;31;6;25;.806;2793000;0
40905;148904;759;0;0;0;0;.00nan;0;0
40906;206313;766;50;32;5;27;.844;3600000;0
40906;81691;775;0;0;0;0;.00nan;0;0
40906;81733;766;0;0;0;0;.00nan;0;0
40906;146249;775;85;29;1;28;.966;3600000;0
40907;63932;1093;100;38;0;38;1.000;3600000;0
40907;94107;2545;0;0;0;0;.00nan;0;0
40907;149103;1093;0;0;0;0;.00nan;0;0
40907;158276;2545;79;41;3;38;.927;3600000;0
40908;174894;754;98;27;0;27;1.000;3600000;0
40908;207194;754;0;0;0;0;.00nan;0;0
40908;67294;774;0;0;0;0;.00nan;0;0
40908;149191;774;44;23;3;20;.870;3600000;0
40909;212428;750;0;0;0;0;.00nan;0;0
40909;180738;750;38;14;3;11;.786;3600000;0
40909;190589;2197;52;51;7;44;.863;3344000;0
40909;82817;2197;50;1;0;1;1.000;256000;0
40910;359;760;0;0;0;0;.00nan;0;0
40910;181910;1492;0;0;0;0;.00nan;0;0
40910;86343;1492;89;34;2;32;.941;3900000;0
40910;142810;760;68;27;2;25;.926;3900000;0
40911;166023;767;0;0;0;0;.00nan;0;0
40911;169680;3730;0;0;0;0;.00nan;0;0
40911;149048;3730;74;38;3;35;.921;3553000;0
40911;149262;767;77;23;1;22;.957;3600000;0
40912;177124;768;0;0;0;0;.00nan;0;0
40912;8504;768;83;12;0;12;1.000;3600000;0
40912;188815;762;48;35;5;30;.857;3600000;0
40912;186234;762;0;0;0;0;.00nan;0;0
40913;189581;758;0;0;0;0;.00nan;0;0
40913;176686;758;94;48;1;47;.979;3600000;0
40913;87758;3913;60;20;2;18;.900;3600000;0
40913;148675;3913;0;0;0;0;.00nan;0;0
40914;175761;769;0;0;0;0;.00nan;0;0
40914;63932;1093;100;23;0;23;1.000;3600000;0
40914;145463;769;48;41;6;35;.854;3600000;0
40914;149103;1093;0;0;0;0;.00nan;0;0
40915;164521;3721;0;0;0;0;.00nan;0;0
40915;67294;774;0;0;0;0;.00nan;0;0
40915;67818;3721;85;46;4;42;.913;3600000;0
40915;149191;774;80;25;1;24;.960;3600000;0
40916;174894;754;62;18;2;16;.889;3600000;0
40916;207194;754;0;0;0;0;.00nan;0;0
40916;190589;2197;77;34;3;31;.912;3558000;0
40916;82817;2197;0;0;0;0;.00nan;0;0
40917;3241;911;52;20;3;17;.850;3600000;0
40917;-1;911;0;0;0;0;.00nan;0;0
40917;212428;750;0;0;0;0;.00nan;0;0
40917;180738;750;89;21;0;21;1.000;3600000;0
40918;162979;746;37;12;3;9;.750;3545000;0
40918;175757;1497;0;0;0;0;.00nan;0;0
40918;192386;1497;95;44;2;42;.955;3600000;0
40918;149280;746;0;0;0;0;.00nan;0;0
40919;164424;759;64;20;2;18;.900;3546000;0
40919;180188;4924;0;0;0;0;.00nan;0;0
40919;91194;4924;98;34;1;33;.971;3600000;0
40919;148904;759;0;0;0;0;.00nan;0;0
40920;174898;1503;71;27;2;25;.926;3600000;0
40920;196698;1503;0;0;0;0;.00nan;0;0
40920;87758;3913;0;0;0;0;.00nan;0;0
40920;148675;3913;68;41;4;37;.902;3600000;0
40921;170530;755;64;36;4;32;.889;3640000;0
40921;180154;755;0;0;0;0;.00nan;0;0
40921;-1;2199;0;0;0;0;.00nan;0;0
40921;80222;2199;44;17;3;14;.824;3640000;0
40922;1756;4989;0;0;0;0;.00nan;0;0
40922;206313;766;77;24;2;22;.917;3900000;0
40922;190570;4989;100;47;2;45;.957;3900000;0
40922;81733;766;0;0;0;0;.00nan;0;0
40923;181910;1492;0;0;0;0;.00nan;0;0
40923;67294;774;0;0;0;0;.00nan;0;0
40923;86343;1492;79;32;3;29;.906;3751000;0
40923;149191;774;60;21;2;19;.905;3750000;0
40924;164521;3721;0;0;0;0;.00nan;0;0
40924;190589;2197;0;0;0;0;.00nan;0;0
40924;67818;3721;39;36;6;30;.833;3571000;0
40924;82817;2197;75;35;3;32;.914;3600000;0
40925;3241;911;0;0;0;0;.00nan;0;0
40925;-1;911;83;36;3;33;.917;3600000;0
40925;174894;754;0;0;0;0;.00nan;0;0
40925;207194;754;48;28;5;23;.821;3520000;0
40926;1756;4989;86;28;2;26;.929;3600000;0
40926;175757;1497;55;28;4;24;.857;3514000;0
40926;190570;4989;0;0;0;0;.00nan;0;0
40926;192386;1497;0;0;0;0;.00nan;0;0
40927;180188;4924;0;0;0;0;.00nan;0;0
40927;63932;1093;77;22;2;20;.909;3900000;0
40927;91194;4924;87;37;2;35;.946;3900000;0
40927;149103;1093;0;0;0;0;.00nan;0;0
40928;189581;758;0;0;0;0;.00nan;0;0
40928;174898;1503;78;25;2;23;.920;3600000;0
40928;176686;758;100;31;0;31;1.000;3600000;0
40928;196698;1503;0;0;0;0;.00nan;0;0
40929;164424;759;90;23;0;23;1.000;3600000;0
40929;166023;767;69;38;4;34;.895;3355000;0
40929;148904;759;0;0;0;0;.00nan;0;0
40929;149262;767;50;1;0;1;1.000;245000;0
40930;188815;762;0;0;0;0;.00nan;0;0
40930;186234;762;93;39;1;38;.974;3600000;0
40930;-1;2199;0;0;0;0;.00nan;0;0
40930;80222;2199;54;22;3;19;.864;3600000;0
40931;359;760;54;3;0;3;1.000;615000;0
40931;87758;3913;85;36;2;34;.944;3600000;0
40931;142810;760;15;23;6;17;.739;2985000;0
40931;148675;3913;0;0;0;0;.00nan;0;0
40932;170530;755;54;29;4;25;.862;3685000;0
40932;180154;755;0;0;0;0;.00nan;0;0
40932;81691;775;0;0;0;0;.00nan;0;0
40932;146249;775;67;31;3;28;.903;3648000;0
40933;162979;746;54;25;4;21;.840;3900000;0
40933;206313;766;78;51;4;47;.922;3900000;0
40933;81733;766;0;0;0;0;.00nan;0;0
40933;149280;746;0;0;0;0;.00nan;0;0
40934;169680;3730;0;0;0;0;.00nan;0;0
40934;85281;772;58;18;2;16;.889;3600000;0
40934;149048;3730;75;41;4;37;.902;3538000;0
40934;149305;772;0;0;0;0;.00nan;0;0
40935;177124;768;0;0;0;0;.00nan;0;0
40935;8504;768;60;19;2;17;.895;3900000;0
40935;189264;4923;0;0;0;0;.00nan;0;0
40935;179406;4923;97;47;2;45;.957;3900000;0
40936;190589;2197;68;17;1;16;.941;3600000;0
40936;181910;1492;0;0;0;0;.00nan;0;0
40936;82817;2197;0;0;0;0;.00nan;0;0
40936;86343;1492;24;25;6;19;.760;3600000;0
40937;3241;911;0;0;0;0;.00nan;0;0
40937;164521;3721;0;0;0;0;.00nan;0;0
40937;-1;911;75;22;1;21;.955;3600000;0
40937;67818;3721;75;44;4;40;.909;3600000;0
40938;180188;4924;100;36;0;36;1.000;3600000;0
40938;81691;775;0;0;0;0;.00nan;0;0
40938;91194;4924;0;0;0;0;.00nan;0;0
40938;146249;775;56;22;3;19;.864;3600000;0
40939;359;760;0;0;0;0;.00nan;0;0
40939;189581;758;0;0;0;0;.00nan;0;0
40939;176686;758;98;23;0;23;1.000;3600000;0
40939;142810;760;71;36;4;32;.889;3600000;0
40940;1756;4989;0;0;0;0;.00nan;0;0
40940;175761;769;66;25;3;22;.880;3600000;0
40940;190570;4989;41;32;5;27;.844;3563000;0
40940;145463;769;0;0;0;0;.00nan;0;0
40941;166023;767;0;0;0;0;.00nan;0;0
40941;-1;2199;71;27;2;25;.926;2410000;0
40941;80222;2199;28;20;5;15;.750;1190000;0
40941;149262;767;57;16;2;14;.875;3600000;0
40942;164424;759;75;23;2;21;.913;3900000;0
40942;188815;762;95;46;2;44;.957;3900000;0
40942;186234;762;0;0;0;0;.00nan;0;0
40942;148904;759;0;0;0;0;.00nan;0;0
40943;162979;746;63;21;2;19;.905;3600000;0
40943;94107;2545;0;0;0;0;.00nan;0;0
40943;149280;746;0;0;0;0;.00nan;0;0
40943;158276;2545;71;42;4;38;.905;3538000;0
40944;170530;755;92;40;2;38;.950;3629000;0
40944;180154;755;0;0;0;0;.00nan;0;0
40944;63932;1093;90;37;1;36;.973;3630000;0
40944;149103;1093;0;0;0;0;.00nan;0;0
40945;189264;4923;0;0;0;0;.00nan;0;0
40945;169680;3730;0;0;0;0;.00nan;0;0
40945;179406;4923;74;25;2;23;.920;3537000;0
40945;149048;3730;100;28;0;28;1.000;3600000;0
40946;177124;768;0;0;0;0;.00nan;0;0
40946;8504;768;47;17;3;14;.824;3600000;0
40946;85281;772;41;23;4;19;.826;1064000;0
40946;149305;772;92;37;1;36;.973;2499000;0
40947;3241;911;0;0;0;0;.00nan;0;0
40947;-1;911;74;22;1;21;.955;3600000;0
40947;181910;1492;0;0;0;0;.00nan;0;0
40947;86343;1492;69;33;4;29;.879;3600000;0
40948;180188;4924;84;27;1;26;.963;3820000;0
40948;-1;2199;0;0;0;0;.00nan;0;0
40948;80222;2199;97;26;0;26;1.000;3820000;0
40948;91194;4924;0;0;0;0;.00nan;0;0
40949;162979;746;63;18;2;16;.889;3900000;0
40949;175761;769;0;0;0;0;.00nan;0;0
40949;145463;769;82;33;2;31;.939;3900000;0
40949;149280;746;0;0;0;0;.00nan;0;0
40950;166023;767;100;37;0;37;1.000;3600000;0
40950;81691;775;0;0;0;0;.00nan;0;0
40950;146249;775;67;35;4;31;.886;3600000;0
40950;149262;767;0;0;0;0;.00nan;0;0
40951;188815;762;74;21;1;20;.952;3600000;0
40951;186234;762;0;0;0;0;.00nan;0;0
40951;63932;1093;91;43;2;41;.953;3595000;0
40951;149103;1093;0;0;0;0;.00nan;0;0
40952;1756;4989;78;37;3;34;.919;3600000;0
40952;190570;4989;0;0;0;0;.00nan;0;0
40952;94107;2545;0;0;0;0;.00nan;0;0
40952;158276;2545;61;30;4;26;.867;3556000;0
40953;359;760;0;0;0;0;.00nan;0;0
40953;174898;1503;85;28;1;27;.964;3600000;0
40953;196698;1503;0;0;0;0;.00nan;0;0
40953;142810;760;66;30;3;27;.900;3583000;0
40954;164424;759;100;34;0;34;1.000;3600000;0
40954;170530;755;74;30;2;28;.933;3541000;0
40954;180154;755;0;0;0;0;.00nan;0;0
40954;148904;759;0;0;0;0;.00nan;0;0
40955;67294;774;0;0;0;0;.00nan;0;0
40955;87758;3913;0;0;0;0;.00nan;0;0
40955;148675;3913;65;41;4;37;.902;3600000;0
40955;149191;774;82;27;1;26;.963;3600000;0
40956;175757;1497;84;33;1;32;.970;3900000;0
40956;212428;750;0;0;0;0;.00nan;0;0
40956;180738;750;89;30;1;29;.967;3900000;0
40956;192386;1497;0;0;0;0;.00nan;0;0
40957;166023;767;74;31;2;29;.935;3600000;0
40957;63932;1093;49;30;4;26;.867;3600000;0
40957;149103;1093;0;0;0;0;.00nan;0;0
40957;149262;767;0;0;0;0;.00nan;0;0
40958;206313;766;78;35;3;32;.914;3600000;0
40958;174894;754;0;0;0;0;.00nan;0;0
40958;207194;754;100;26;0;26;1.000;3600000;0
40958;81733;766;0;0;0;0;.00nan;0;0
40959;188815;762;87;28;1;27;.964;3600000;0
40959;186234;762;0;0;0;0;.00nan;0;0
40959;81691;775;64;31;2;29;.935;3554000;0
40959;146249;775;0;0;0;0;.00nan;0;0
40960;177124;768;0;0;0;0;.00nan;0;0
40960;8504;768;51;14;2;12;.857;3610000;0
40960;169680;3730;0;0;0;0;.00nan;0;0
40960;149048;3730;94;63;3;60;.952;3610000;0
40961;189581;758;0;0;0;0;.00nan;0;0
40961;176686;758;83;35;2;33;.943;3600000;0
40961;67294;774;0;0;0;0;.00nan;0;0
40961;149191;774;63;28;3;25;.893;3577000;0
40962;174898;1503;74;15;1;14;.933;3900000;0
40962;190589;2197;94;42;1;41;.976;3900000;0
40962;196698;1503;0;0;0;0;.00nan;0;0
40962;82817;2197;0;0;0;0;.00nan;0;0
40963;3241;911;0;0;0;0;.00nan;0;0
40963;-1;911;75;33;3;30;.909;3787000;0
40963;87758;3913;95;40;2;38;.950;3787000;0
40963;148675;3913;0;0;0;0;.00nan;0;0
40964;-1;2199;0;0;0;0;.00nan;0;0
40964;80222;2199;67;25;3;22;.880;3600000;0
40964;85281;772;21;38;7;31;.816;3600000;0
40964;149305;772;0;0;0;0;.00nan;0;0
40965;164521;3721;42;26;4;22;.846;3807000;0
40965;206313;766;41;19;3;16;.842;3807000;0
40965;67818;3721;0;0;0;0;.00nan;0;0
40965;81733;766;0;0;0;0;.00nan;0;0
40966;212428;750;0;0;0;0;.00nan;0;0
40966;180738;750;56;17;2;15;.882;3600000;0
40966;94107;2545;0;0;0;0;.00nan;0;0
40966;158276;2545;78;42;3;39;.929;3567000;0
40967;164424;759;51;29;5;24;.828;3516000;0
40967;189264;4923;0;0;0;0;.00nan;0;0
40967;179406;4923;68;35;3;32;.914;3600000;0
40967;148904;759;0;0;0;0;.00nan;0;0
40968;1756;4989;80;34;2;32;.941;3600000;0
40968;170530;755;56;29;3;26;.897;3590000;0
40968;180154;755;0;0;0;0;.00nan;0;0
40968;190570;4989;0;0;0;0;.00nan;0;0
40969;162979;746;0;0;0;0;.00nan;0;0
40969;180188;4924;100;41;1;40;.976;3643000;0
40969;91194;4924;0;0;0;0;.00nan;0;0
40969;149280;746;73;26;2;24;.923;3643000;0
40970;174894;754;0;0;0;0;.00nan;0;0
40970;175761;769;0;0;0;0;.00nan;0;0
40970;207194;754;80;23;1;22;.957;3600000;0
40970;145463;769;74;29;2;27;.931;3565000;0
40971;175757;1497;51;29;4;25;.862;3600000;0
40971;181910;1492;0;0;0;0;.00nan;0;0
40971;192386;1497;0;0;0;0;.00nan;0;0
40971;86343;1492;95;22;0;22;1.000;3600000;0
40972;3241;911;0;0;0;0;.00nan;0;0
40972;-1;911;89;13;0;13;1.000;3600000;0
40972;189581;758;0;0;0;0;.00nan;0;0
40972;176686;758;66;22;1;21;.955;3599000;0
40973;359;760;0;0;0;0;.00nan;0;0
40973;190589;2197;97;32;1;31;.969;3576000;0
40973;82817;2197;0;0;0;0;.00nan;0;0
40973;142810;760;97;23;0;23;1.000;3600000;0
40974;174898;1503;96;36;2;34;.944;3600000;0
40974;196698;1503;0;0;0;0;.00nan;0;0
40974;67294;774;0;0;0;0;.00nan;0;0
40974;149191;774;89;37;3;34;.919;3600000;0
40975;189264;4923;0;0;0;0;.00nan;0;0
40975;179406;4923;56;25;3;22;.880;3600000;0
40975;-1;2199;65;32;4;28;.875;3570000;0
40975;80222;2199;0;0;0;0;.00nan;0;0
40976;164521;3721;0;0;0;0;.00nan;0;0
40976;175757;1497;73;16;0;16;1.000;2624000;0
40976;192386;1497;20;11;4;7;.636;964000;0
40976;67818;3721;64;27;3;24;.889;3600000;0
40977;175761;769;0;0;0;0;.00nan;0;0
40977;212428;750;0;0;0;0;.00nan;0;0
40977;180738;750;54;19;3;16;.842;3600000;0
40977;145463;769;75;39;4;35;.897;3556000;0
40978;164424;759;0;0;0;0;.00nan;0;0
40978;85281;772;67;28;2;26;.929;3572000;0
40978;148904;759;100;23;0;23;1.000;3600000;0
40978;149305;772;0;0;0;0;.00nan;0;0
40979;1756;4989;0;0;0;0;.00nan;0;0
40979;180188;4924;0;0;0;0;.00nan;0;0
40979;190570;4989;60;35;4;31;.886;3600000;0
40979;91194;4924;62;17;1;16;.941;3600000;0
40980;162979;746;89;30;2;28;.933;3900000;0
40980;170530;755;96;44;2;42;.955;3900000;0
40980;180154;755;0;0;0;0;.00nan;0;0
40980;149280;746;0;0;0;0;.00nan;0;0
40981;174894;754;76;24;1;23;.958;3600000;0
40981;207194;754;0;0;0;0;.00nan;0;0
40981;94107;2545;0;0;0;0;.00nan;0;0
40981;158276;2545;78;47;4;43;.915;3600000;0
40982;206313;766;50;23;3;20;.870;3567000;0
40982;181910;1492;0;0;0;0;.00nan;0;0
40982;81733;766;0;0;0;0;.00nan;0;0
40982;86343;1492;66;19;1;18;.947;3600000;0
40983;359;760;0;0;0;0;.00nan;0;0
40983;67294;774;0;0;0;0;.00nan;0;0
40983;142810;760;100;37;1;36;.973;3600000;0
40983;149191;774;43;21;4;17;.810;3600000;0
40984;3241;911;0;0;0;0;.00nan;0;0
40984;-1;911;77;24;2;22;.917;3900000;0
40984;174898;1503;69;31;2;29;.935;3900000;0
40984;196698;1503;0;0;0;0;.00nan;0;0
40985;190589;2197;0;0;0;0;.00nan;0;0
40985;82817;2197;65;30;3;27;.900;3694000;0
40985;87758;3913;0;0;0;0;.00nan;0;0
40985;148675;3913;66;22;2;20;.909;3694000;0
40986;169680;3730;0;0;0;0;.00nan;0;0
40986;-1;2199;0;0;0;0;.00nan;0;0
40986;80222;2199;59;17;2;15;.882;3596000;0
40986;149048;3730;100;40;0;40;1.000;3600000;0
40987;164521;3721;0;0;0;0;.00nan;0;0
40987;67818;3721;75;35;4;31;.886;3900000;0
40987;94107;2545;43;26;4;22;.846;3900000;0
40987;158276;2545;0;0;0;0;.00nan;0;0
40988;206313;766;37;32;5;27;.844;3589000;0
40988;212428;750;0;0;0;0;.00nan;0;0
40988;180738;750;65;25;3;22;.880;3600000;0
40988;81733;766;0;0;0;0;.00nan;0;0
40989;177124;768;0;0;0;0;.00nan;0;0
40989;8504;768;38;23;4;19;.826;3600000;0
40989;164424;759;0;0;0;0;.00nan;0;0
40989;148904;759;83;36;1;35;.972;3600000;0
40990;1756;4989;24;10;4;6;.600;766000;0
40990;188815;762;88;19;0;19;1.000;3600000;0
40990;190570;4989;95;45;2;43;.956;2834000;0
40990;186234;762;0;0;0;0;.00nan;0;0
40991;162979;746;0;0;0;0;.00nan;0;0
40991;166023;767;0;0;0;0;.00nan;0;0
40991;149262;767;46;28;4;24;.857;3600000;0
40991;149280;746;100;46;1;45;.978;3600000;0
40992;189264;4923;0;0;0;0;.00nan;0;0
40992;179406;4923;80;28;2;26;.929;3558000;0
40992;81691;775;92;38;1;37;.974;3600000;0
40992;146249;775;0;0;0;0;.00nan;0;0
40993;174894;754;0;0;0;0;.00nan;0;0
40993;175757;1497;0;0;0;0;.00nan;0;0
40993;207194;754;100;25;0;25;1.000;3600000;0
40993;192386;1497;85;28;1;27;.964;3568000;0
40994;175761;769;0;0;0;0;.00nan;0;0
40994;181910;1492;0;0;0;0;.00nan;0;0
40994;86343;1492;100;32;0;32;1.000;3600000;0
40994;145463;769;51;36;5;31;.861;3600000;0
40995;63932;1093;73;21;1;20;.952;3600000;0
40995;85281;772;27;21;5;16;.762;3600000;0
40995;149103;1093;0;0;0;0;.00nan;0;0
40995;149305;772;0;0;0;0;.00nan;0;0
40996;189581;758;0;0;0;0;.00nan;0;0
40996;176686;758;80;14;0;14;1.000;3600000;0
40996;190589;2197;94;37;2;35;.946;3600000;0
40996;82817;2197;0;0;0;0;.00nan;0;0
40997;359;760;0;0;0;0;.00nan;0;0
40997;3241;911;0;0;0;0;.00nan;0;0
40997;-1;911;65;31;3;28;.903;3600000;0
40997;142810;760;85;38;2;36;.947;3600000;0
40998;177124;768;24;26;6;20;.769;3627000;0
40998;186219;768;0;0;0;0;.00nan;0;0
40998;-1;2199;0;0;0;0;.00nan;0;0
40998;80222;2199;79;42;5;37;.881;3627000;0
40999;164521;3721;0;0;0;0;.00nan;0;0
40999;175761;769;0;0;0;0;.00nan;0;0
40999;67818;3721;100;29;0;29;1.000;3600000;0
40999;145463;769;66;29;2;27;.931;3570000;0
41000;164424;759;86;22;0;22;1.000;3600000;0
41000;169680;3730;56;4;0;4;1.000;569000;0
41000;148904;759;0;0;0;0;.00nan;0;0
41000;149048;3730;43;37;6;31;.838;3031000;0
41001;1756;4989;0;0;0;0;.00nan;0;0
41001;166023;767;0;0;0;0;.00nan;0;0
41001;190570;4989;100;40;1;39;.975;3600000;0
41001;149262;767;63;26;3;23;.885;3515000;0
41002;162979;746;86;18;0;18;1.000;3600000;0
41002;188815;762;66;23;2;21;.913;3528000;0
41002;186234;762;0;0;0;0;.00nan;0;0
41002;149280;746;0;0;0;0;.00nan;0;0
41003;81691;775;68;18;1;17;.944;3570000;0
41003;85281;772;100;40;0;40;1.000;3600000;0
41003;146249;775;0;0;0;0;.00nan;0;0
41003;149305;772;0;0;0;0;.00nan;0;0
41004;181910;1492;0;0;0;0;.00nan;0;0
41004;86343;1492;90;22;0;22;1.000;3600000;0
41004;94107;2545;85;30;1;29;.967;3581000;0
41004;158276;2545;0;0;0;0;.00nan;0;0
41005;189264;4923;0;0;0;0;.00nan;0;0
41005;179406;4923;49;20;3;17;.850;3600000;0
41005;63932;1093;51;37;5;32;.865;3518000;0
41005;149103;1093;0;0;0;0;.00nan;0;0
41006;177124;768;56;14;2;12;.857;3600000;0
41006;186219;768;0;0;0;0;.00nan;0;0
41006;81691;775;70;36;3;33;.917;3547000;0
41006;146249;775;0;0;0;0;.00nan;0;0
41007;169680;3730;0;0;0;0;.00nan;0;0
41007;63932;1093;72;24;2;22;.917;3600000;0
41007;149048;3730;78;47;5;42;.894;3600000;0
41007;149103;1093;0;0;0;0;.00nan;0;0
41008;359;760;0;0;0;0;.00nan;0;0
41008;175757;1497;92;29;1;28;.966;3600000;0
41008;192386;1497;0;0;0;0;.00nan;0;0
41008;142810;760;40;29;5;24;.828;3600000;0
41009;1756;4989;82;51;4;47;.922;3600000;0
41009;189264;4923;96;18;0;18;1.000;3600000;0
41009;179406;4923;0;0;0;0;.00nan;0;0
41009;190570;4989;0;0;0;0;.00nan;0;0
41010;164521;3721;0;0;0;0;.00nan;0;0
41010;180188;4924;100;25;0;25;1.000;3600000;0
41010;67818;3721;54;34;4;30;.882;3600000;0
41010;91194;4924;0;0;0;0;.00nan;0;0
41011;162979;746;96;22;0;22;1.000;3600000;0
41011;85281;772;89;33;2;31;.939;3539000;0
41011;149280;746;0;0;0;0;.00nan;0;0
41011;149305;772;0;0;0;0;.00nan;0;0
41012;189581;758;0;0;0;0;.00nan;0;0
41012;175761;769;47;12;2;10;.833;765000;0
41012;176686;758;60;22;2;20;.909;3600000;0
41012;145463;769;25;25;6;19;.760;2835000;0
41013;166023;767;56;35;5;30;.857;3587000;0
41013;212428;750;0;0;0;0;.00nan;0;0
41013;180738;750;50;29;4;25;.862;3600000;0
41013;149262;767;0;0;0;0;.00nan;0;0
41014;169680;3730;0;0;0;0;.00nan;0;0
41014;81691;775;91;27;1;26;.963;3900000;0
41014;146249;775;0;0;0;0;.00nan;0;0
41014;149048;3730;98;37;1;36;.973;3883000;0
41015;188815;762;0;0;0;0;.00nan;0;0
41015;174894;754;0;0;0;0;.00nan;0;0
41015;207194;754;81;28;2;26;.929;3600000;0
41015;186234;762;70;37;3;34;.919;3600000;0
41016;87758;3913;78;26;1;25;.962;3600000;0
41016;94107;2545;0;0;0;0;.00nan;0;0
41016;148675;3913;0;0;0;0;.00nan;0;0
41016;158276;2545;60;35;4;31;.886;3600000;0
41017;177124;768;60;21;2;19;.905;3537000;0
41017;186219;768;0;0;0;0;.00nan;0;0
41017;63932;1093;100;28;0;28;1.000;3600000;0
41017;149103;1093;0;0;0;0;.00nan;0;0
41018;170530;755;61;33;3;30;.909;3900000;0
41018;180154;755;0;0;0;0;.00nan;0;0
41018;181910;1492;0;0;0;0;.00nan;0;0
41018;86343;1492;61;25;3;22;.880;3900000;0
41019;206313;766;0;0;0;0;.00nan;0;0
41019;174898;1503;67;19;1;18;.947;3600000;0
41019;196698;1503;0;0;0;0;.00nan;0;0
41019;81733;766;65;28;2;26;.929;3580000;0
41020;190589;2197;50;28;4;24;.857;3600000;0
41020;67294;774;0;0;0;0;.00nan;0;0
41020;82817;2197;0;0;0;0;.00nan;0;0
41020;149191;774;50;23;3;20;.870;3600000;0
41021;174898;1503;75;21;1;20;.952;3600000;0
41021;175757;1497;0;0;0;0;.00nan;0;0
41021;196698;1503;0;0;0;0;.00nan;0;0
41021;192386;1497;60;36;4;32;.889;3600000;0
41022;162979;746;75;22;1;21;.955;3600000;0
41022;189264;4923;57;40;5;35;.875;3600000;0
41022;179406;4923;0;0;0;0;.00nan;0;0
41022;149280;746;0;0;0;0;.00nan;0;0
41023;180188;4924;66;25;2;23;.920;3600000;0
41023;181910;1492;0;0;0;0;.00nan;0;0
41023;86343;1492;53;33;4;29;.879;3547000;0
41023;91194;4924;0;0;0;0;.00nan;0;0
41024;1756;4989;100;54;2;52;.963;3900000;0
41024;190570;4989;0;0;0;0;.00nan;0;0
41024;85281;772;0;0;0;0;.00nan;0;0
41024;149305;772;50;16;2;14;.875;3900000;0
41025;175761;769;94;42;2;40;.952;3900000;0
41025;87758;3913;98;41;2;39;.951;3900000;0
41025;145463;769;0;0;0;0;.00nan;0;0
41025;148675;3913;0;0;0;0;.00nan;0;0
41026;166023;767;0;0;0;0;.00nan;0;0
41026;174894;754;75;38;3;35;.921;3538000;0
41026;207194;754;0;0;0;0;.00nan;0;0
41026;149262;767;96;36;1;35;.972;3600000;0
41027;188815;762;27;26;6;20;.769;3300000;0
41027;212428;750;0;0;0;0;.00nan;0;0
41027;180738;750;79;34;2;32;.941;3600000;0
41027;186234;762;51;3;0;3;1.000;300000;0
41028;189581;758;0;0;0;0;.00nan;0;0
41028;176686;758;78;29;2;27;.931;3600000;0
41028;94107;2545;14;17;6;11;.647;1760000;0
41028;158276;2545;43;12;2;10;.833;1840000;0
41029;164521;3721;0;0;0;0;.00nan;0;0
41029;170530;755;98;27;0;27;1.000;3600000;0
41029;180154;755;0;0;0;0;.00nan;0;0
41029;67818;3721;74;19;1;18;.947;3600000;0
41030;359;760;0;0;0;0;.00nan;0;0
41030;206313;766;85;30;1;29;.967;3600000;0
41030;81733;766;0;0;0;0;.00nan;0;0
41030;142810;760;83;43;3;40;.930;3545000;0
41031;3241;911;0;0;0;0;.00nan;0;0
41031;-1;911;68;17;1;16;.941;3600000;0
41031;190589;2197;90;58;4;54;.931;3600000;0
41031;82817;2197;0;0;0;0;.00nan;0;0
41032;175757;1497;97;51;3;48;.941;3900000;0
41032;192386;1497;0;0;0;0;.00nan;0;0
41032;87758;3913;0;0;0;0;.00nan;0;0
41032;148675;3913;77;30;3;27;.900;3900000;0
41033;162979;746;52;20;2;18;.900;3577000;0
41033;169680;3730;0;0;0;0;.00nan;0;0
41033;149048;3730;100;54;1;53;.981;3600000;0
41033;149280;746;0;0;0;0;.00nan;0;0
41034;174894;754;0;0;0;0;.00nan;0;0
41034;180188;4924;0;0;0;0;.00nan;0;0
41034;207194;754;92;24;0;24;1.000;3600000;0
41034;91194;4924;78;26;1;25;.962;3583000;0
41035;177124;768;0;0;0;0;.00nan;0;0
41035;1756;4989;0;0;0;0;.00nan;0;0
41035;8504;768;69;7;0;7;1.000;3600000;0
41035;190570;4989;70;63;6;57;.905;3600000;0
41036;174898;1503;65;25;3;22;.880;3549000;0
41036;175761;769;0;0;0;0;.00nan;0;0
41036;196698;1503;0;0;0;0;.00nan;0;0
41036;145463;769;76;28;2;26;.929;3600000;0
41037;166023;767;55;19;2;17;.895;3580000;0
41037;181910;1492;0;0;0;0;.00nan;0;0
41037;86343;1492;100;49;1;48;.980;3600000;0
41037;149262;767;0;0;0;0;.00nan;0;0
41038;164424;759;83;39;3;36;.923;3575000;0
41038;81691;775;84;26;1;25;.962;3600000;0
41038;146249;775;0;0;0;0;.00nan;0;0
41038;148904;759;0;0;0;0;.00nan;0;0
41039;164521;3721;0;0;0;0;.00nan;0;0
41039;188815;762;52;21;3;18;.857;3600000;0
41039;186234;762;0;0;0;0;.00nan;0;0
41039;67818;3721;82;33;2;31;.939;3600000;0
41040;359;760;0;0;0;0;.00nan;0;0
41040;94107;2545;49;23;4;19;.826;3600000;0
41040;142810;760;36;26;5;21;.808;3574000;0
41040;158276;2545;0;0;0;0;.00nan;0;0
41041;-1;2199;0;0;0;0;.00nan;0;0
41041;63932;1093;75;28;2;26;.929;3600000;0
41041;80222;2199;44;34;5;29;.853;3600000;0
41041;149103;1093;0;0;0;0;.00nan;0;0
41042;170530;755;72;31;3;28;.903;3565000;0
41042;180154;755;0;0;0;0;.00nan;0;0
41042;212428;750;0;0;0;0;.00nan;0;0
41042;180738;750;65;15;1;14;.933;3600000;0
41043;189581;758;0;0;0;0;.00nan;0;0
41043;206313;766;83;22;1;21;.955;3600000;0
41043;176686;758;73;34;3;31;.912;3536000;0
41043;81733;766;0;0;0;0;.00nan;0;0
41044;3241;911;0;0;0;0;.00nan;0;0
41044;-1;911;97;37;1;36;.973;3584000;0
41044;67294;774;100;29;0;29;1.000;3600000;0
41044;149191;774;0;0;0;0;.00nan;0;0
41045;189581;758;0;0;0;0;.00nan;0;0
41045;175757;1497;0;0;0;0;.00nan;0;0
41045;176686;758;60;32;4;28;.875;3600000;0
41045;192386;1497;77;23;1;22;.957;3600000;0
41046;1756;4989;62;35;4;31;.886;3521000;0
41046;169680;3730;0;0;0;0;.00nan;0;0
41046;190570;4989;0;0;0;0;.00nan;0;0
41046;149048;3730;77;32;2;30;.938;3600000;0
41047;189264;4923;0;0;0;0;.00nan;0;0
41047;179406;4923;48;17;3;14;.824;3600000;0
41047;85281;772;47;38;5;33;.868;3553000;0
41047;149305;772;0;0;0;0;.00nan;0;0
41048;180188;4924;68;38;4;34;.895;3600000;0
41048;212428;750;0;0;0;0;.00nan;0;0
41048;180738;750;76;19;1;18;.947;3600000;0
41048;91194;4924;0;0;0;0;.00nan;0;0
41049;177124;768;0;0;0;0;.00nan;0;0
41049;162979;746;82;43;4;39;.907;3600000;0
41049;8504;768;94;22;0;22;1.000;3600000;0
41049;149280;746;0;0;0;0;.00nan;0;0
41050;359;760;0;0;0;0;.00nan;0;0
41050;175761;769;0;0;0;0;.00nan;0;0
41050;142810;760;90;33;2;31;.939;3896000;0
41050;145463;769;74;22;1;21;.955;3896000;0
41051;164521;3721;0;0;0;0;.00nan;0;0
41051;166023;767;0;0;0;0;.00nan;0;0
41051;67818;3721;55;38;5;33;.868;3600000;0
41051;149262;767;67;20;2;18;.900;3600000;0
41052;-1;2199;67;12;0;12;1.000;1382000;0
41052;80222;2199;1;21;7;14;.667;2218000;0
41052;81691;775;61;25;3;22;.880;3600000;0
41052;146249;775;0;0;0;0;.00nan;0;0
41053;188815;762;73;28;2;26;.929;3598000;0
41053;181910;1492;0;0;0;0;.00nan;0;0
41053;186234;762;0;0;0;0;.00nan;0;0
41053;86343;1492;80;23;1;22;.957;3600000;0
41054;174898;1503;87;29;1;28;.966;3600000;0
41054;196698;1503;0;0;0;0;.00nan;0;0
41054;94107;2545;0;0;0;0;.00nan;0;0
41054;158276;2545;73;48;4;44;.917;3600000;0
41055;164424;759;59;22;3;19;.864;3752000;0
41055;63932;1093;63;35;4;31;.886;3752000;0
41055;148904;759;0;0;0;0;.00nan;0;0
41055;149103;1093;0;0;0;0;.00nan;0;0
41056;170530;755;44;30;5;25;.833;3600000;0
41056;174894;754;0;0;0;0;.00nan;0;0
41056;180154;755;0;0;0;0;.00nan;0;0
41056;207194;754;79;23;1;22;.957;3600000;0
41057;206313;766;64;15;1;14;.933;3600000;0
41057;81733;766;0;0;0;0;.00nan;0;0
41057;87758;3913;87;34;2;32;.941;3549000;0
41057;148675;3913;0;0;0;0;.00nan;0;0
41059;188815;762;67;32;3;29;.906;3550000;0
41059;174898;1503;87;26;1;25;.962;3600000;0
41059;186234;762;0;0;0;0;.00nan;0;0
41059;192386;1503;0;0;0;0;.00nan;0;0
41061;169680;3730;57;35;4;31;.886;3600000;0
41061;174894;754;0;0;0;0;.00nan;0;0
41061;207194;754;66;20;2;18;.900;3600000;0
41061;149112;3730;0;0;0;0;.00nan;0;0
41063;-1;2199;0;0;0;0;.00nan;0;0
41063;63932;3913;98;46;2;44;.957;3562000;0
41063;80222;2199;78;25;1;24;.960;3600000;0
41063;148576;3913;0;0;0;0;.00nan;0;0
41065;31;755;0;0;0;0;.00nan;0;0
41065;171113;759;0;0;0;0;.00nan;0;0
41065;176686;759;65;14;1;13;.929;3600000;0
41065;180154;755;98;56;3;53;.946;3540000;0
41067;1756;4989;73;51;5;46;.902;3600000;0
41067;162979;746;67;18;2;16;.889;3600000;0
41067;190570;4989;0;0;0;0;.00nan;0;0
41067;149191;746;0;0;0;0;.00nan;0;0
41069;164521;3721;0;0;0;0;.00nan;0;0
41069;-1;911;47;17;3;14;.824;3627000;0
41069;174858;911;0;0;0;0;.00nan;0;0
41069;67818;3721;90;44;4;40;.909;3627000;0
41071;164424;772;98;36;2;34;.944;3586000;0
41071;11708;772;0;0;0;0;.00nan;0;0
41071;170530;766;82;27;1;26;.963;3600000;0
41071;187348;766;0;0;0;0;.00nan;0;0
41073;193545;774;0;0;0;0;.00nan;0;0
41073;175757;1497;65;26;3;23;.885;3567000;0
41073;201933;774;74;31;2;29;.935;3600000;0
41073;67446;1497;0;0;0;0;.00nan;0;0
41075;177124;775;100;35;2;33;.943;3900000;0
41075;166023;767;0;0;0;0;.00nan;0;0
41075;146249;775;0;0;0;0;.00nan;0;0
41075;149262;767;58;21;2;19;.905;3900000;0
41077;189264;4923;100;30;0;30;1.000;3600000;0
41077;190589;2197;57;39;5;34;.872;3600000;0
41077;82711;4923;0;0;0;0;.00nan;0;0
41077;82817;2197;0;0;0;0;.00nan;0;0
41079;11882;758;36;28;5;23;.821;3626000;0
41079;180133;1492;0;0;0;0;.00nan;0;0
41079;181910;1492;63;33;4;29;.879;3626000;0
41079;93756;758;0;0;0;0;.00nan;0;0
41081;180188;4924;62;15;1;14;.933;820000;0
41081;212428;750;0;0;0;0;.00nan;0;0
41081;180738;750;77;20;1;19;.950;3600000;0
41081;63529;4924;27;26;6;20;.769;2780000;0
41083;201075;760;80;28;1;27;.964;3600000;0
41083;175761;769;0;0;0;0;.00nan;0;0
41083;142810;760;0;0;0;0;.00nan;0;0
41083;145463;769;40;25;4;21;.840;3600000;0
41085;177356;2545;68;42;4;38;.905;3600000;0
41085;8504;768;35;12;3;9;.750;3600000;0
41085;149048;2545;0;0;0;0;.00nan;0;0
41085;149280;768;0;0;0;0;.00nan;0;0
41087;8504;768;0;0;0;0;.00nan;0;0
41087;166226;1093;0;0;0;0;.00nan;0;0
41087;149103;1093;60;30;3;27;.900;3574000;0
41087;149280;768;75;19;1;18;.947;3600000;0
41089;170530;766;82;28;1;27;.964;3600000;0
41089;212428;750;0;0;0;0;.00nan;0;0
41089;180738;750;92;41;2;39;.951;3600000;0
41089;187348;766;0;0;0;0;.00nan;0;0
41091;188815;762;35;30;6;24;.800;3349000;0
41091;189264;4923;67;26;2;24;.923;3600000;0
41091;186234;762;56;4;0;4;1.000;251000;0
41091;82711;4923;0;0;0;0;.00nan;0;0
41093;164521;3721;0;0;0;0;.00nan;0;0
41093;171113;759;0;0;0;0;.00nan;0;0
41093;176686;759;68;20;1;19;.950;3600000;0
41093;67818;3721;81;54;5;49;.907;3600000;0
41095;-1;911;87;13;0;13;1.000;3600000;0
41095;201075;760;41;35;6;29;.829;2356000;0
41095;174858;911;0;0;0;0;.00nan;0;0
41095;142810;760;72;21;1;20;.952;1244000;0
41097;177356;2545;60;23;2;21;.913;3900000;0
41097;180188;4924;72;26;2;24;.923;3900000;0
41097;-1;4924;0;0;0;0;.00nan;0;0
41097;149048;2545;0;0;0;0;.00nan;0;0
41099;193545;774;0;0;0;0;.00nan;0;0
41099;11882;758;73;43;4;39;.907;3600000;0
41099;201933;774;72;19;1;18;.947;3600000;0
41099;93756;758;0;0;0;0;.00nan;0;0
41101;174898;1503;44;17;3;14;.824;3600000;0
41101;175757;1497;65;43;5;38;.884;3600000;0
41101;192386;1503;0;0;0;0;.00nan;0;0
41101;67446;1497;0;0;0;0;.00nan;0;0
41103;1756;4989;50;8;1;7;.875;1594000;0
41103;190570;4989;25;14;4;10;.714;2006000;0
41103;63932;3913;69;22;1;21;.955;3600000;0
41103;148576;3913;0;0;0;0;.00nan;0;0
41105;166023;767;0;0;0;0;.00nan;0;0
41105;-1;2199;0;0;0;0;.00nan;0;0
41105;80222;2199;93;36;1;35;.972;3600000;0
41105;149262;767;76;26;2;24;.923;3549000;0
41107;164424;772;66;31;3;28;.903;3600000;0
41107;11708;772;0;0;0;0;.00nan;0;0
41107;175761;769;0;0;0;0;.00nan;0;0
41107;145463;769;100;35;0;35;1.000;3600000;0
41109;169680;3730;68;30;3;27;.900;3537000;0
41109;190589;2197;73;24;1;23;.958;3600000;0
41109;82817;2197;0;0;0;0;.00nan;0;0
41109;149112;3730;0;0;0;0;.00nan;0;0
41111;31;755;0;0;0;0;.00nan;0;0
41111;180133;1492;0;0;0;0;.00nan;0;0
41111;180154;755;73;21;1;20;.952;3770000;0
41111;181910;1492;100;32;0;32;1.000;3770000;0
41113;177124;775;52;27;3;24;.889;3600000;0
41113;174894;754;91;26;0;26;1.000;3600000;0
41113;207194;754;0;0;0;0;.00nan;0;0
41113;146249;775;0;0;0;0;.00nan;0;0
41115;166226;1093;73;30;2;28;.933;3900000;0
41115;175761;769;0;0;0;0;.00nan;0;0
41115;145463;769;93;34;2;32;.941;3900000;0
41115;149103;1093;0;0;0;0;.00nan;0;0
41117;193545;774;59;31;3;28;.903;3542000;0
41117;170530;766;0;0;0;0;.00nan;0;0
41117;201933;774;0;0;0;0;.00nan;0;0
41117;187348;766;78;27;1;26;.963;3600000;0
41119;169680;3730;0;0;0;0;.00nan;0;0
41119;201075;760;0;0;0;0;.00nan;0;0
41119;142810;760;44;27;4;23;.852;3600000;0
41119;149112;3730;40;49;7;42;.857;3600000;0
41121;31;755;0;0;0;0;.00nan;0;0
41121;180154;755;74;23;1;22;.957;3600000;0
41121;-1;2199;70;33;3;30;.909;3540000;0
41121;80222;2199;0;0;0;0;.00nan;0;0
41123;164521;3721;80;45;4;41;.911;3600000;0
41123;166023;767;100;31;0;31;1.000;3600000;0
41123;67818;3721;0;0;0;0;.00nan;0;0
41123;149262;767;0;0;0;0;.00nan;0;0
41125;180133;1492;0;0;0;0;.00nan;0;0
41125;180188;4924;0;0;0;0;.00nan;0;0
41125;181910;1492;87;31;1;30;.968;3900000;0
41125;-1;4924;95;35;1;34;.971;3900000;0
41127;-1;911;59;25;3;22;.880;3558000;0
41127;174858;911;0;0;0;0;.00nan;0;0
41127;175757;1497;0;0;0;0;.00nan;0;0
41127;67446;1497;63;28;2;26;.929;3600000;0
41129;162979;746;50;30;4;26;.867;3900000;0
41129;11882;758;0;0;0;0;.00nan;0;0
41129;93756;758;74;37;4;33;.892;3900000;0
41129;149191;746;0;0;0;0;.00nan;0;0
41131;177356;2545;0;0;0;0;.00nan;0;0
41131;171113;759;69;16;1;15;.938;3600000;0
41131;176686;759;0;0;0;0;.00nan;0;0
41131;149048;2545;88;45;3;42;.933;3574000;0
41133;164424;772;0;0;0;0;.00nan;0;0
41133;11708;772;67;26;3;23;.885;3600000;0
41133;190589;2197;63;33;3;30;.909;3434000;0
41133;82817;2197;25;7;3;4;.571;166000;0
41135;177124;775;40;18;4;14;.778;3600000;0
41135;1756;4989;0;0;0;0;.00nan;0;0
41135;190570;4989;96;34;2;32;.941;3600000;0
41135;146249;775;0;0;0;0;.00nan;0;0
41137;174894;754;0;0;0;0;.00nan;0;0
41137;174898;1503;0;0;0;0;.00nan;0;0
41137;207194;754;66;43;5;38;.884;3600000;0
41137;192386;1503;67;20;1;19;.950;3600000;0
41139;189264;4923;0;0;0;0;.00nan;0;0
41139;63932;3913;66;29;3;26;.897;3600000;0
41139;82711;4923;38;24;5;19;.792;3513000;0
41139;148576;3913;0;0;0;0;.00nan;0;0
41141;188815;762;0;0;0;0;.00nan;0;0
41141;212428;750;64;23;2;21;.913;3548000;0
41141;180738;750;0;0;0;0;.00nan;0;0
41141;186234;762;90;29;1;28;.966;3600000;0
41143;31;755;0;0;0;0;.00nan;0;0
41143;193545;774;0;0;0;0;.00nan;0;0
41143;180154;755;94;19;0;19;1.000;3600000;0
41143;201933;774;55;32;4;28;.875;3600000;0
41145;1756;4989;62;22;2;20;.909;1755000;0
41145;170530;766;92;19;0;19;1.000;3600000;0
41145;190570;4989;37;27;5;22;.815;1845000;0
41145;187348;766;0;0;0;0;.00nan;0;0
41147;162979;746;100;31;0;31;1.000;3600000;0
41147;8504;768;65;25;2;23;.920;3552000;0
41147;149191;746;0;0;0;0;.00nan;0;0
41147;149280;768;0;0;0;0;.00nan;0;0
41149;177356;2545;66;27;2;25;.926;3547000;0
41149;166023;767;74;13;0;13;1.000;3600000;0
41149;149048;2545;0;0;0;0;.00nan;0;0
41149;149262;767;0;0;0;0;.00nan;0;0
41151;-1;911;0;0;0;0;.00nan;0;0
41151;174858;911;47;21;3;18;.857;3580000;0
41151;174898;1503;78;33;2;31;.939;3600000;0
41151;192386;1503;0;0;0;0;.00nan;0;0
41153;175761;769;88;42;4;38;.905;3592000;0
41153;63932;3913;61;27;3;24;.889;3600000;0
41153;145463;769;0;0;0;0;.00nan;0;0
41153;148576;3913;0;0;0;0;.00nan;0;0
41155;164424;772;76;28;2;26;.929;3600000;0
41155;11708;772;0;0;0;0;.00nan;0;0
41155;180133;1492;52;26;3;23;.885;3584000;0
41155;181910;1492;0;0;0;0;.00nan;0;0
41157;189264;4923;66;20;1;19;.950;3600000;0
41157;190589;2197;0;0;0;0;.00nan;0;0
41157;82711;4923;0;0;0;0;.00nan;0;0
41157;82817;2197;82;25;2;23;.920;3545000;0
41159;169680;3730;97;48;1;47;.979;3600000;0
41159;171113;759;0;0;0;0;.00nan;0;0
41159;176686;759;87;14;0;14;1.000;3600000;0
41159;149112;3730;0;0;0;0;.00nan;0;0
41161;164521;3721;0;0;0;0;.00nan;0;0
41161;188815;762;94;21;0;21;1.000;3600000;0
41161;186234;762;0;0;0;0;.00nan;0;0
41161;67818;3721;34;28;5;23;.821;3600000;0
41163;201075;760;100;27;0;27;1.000;3600000;0
41163;-1;2199;0;0;0;0;.00nan;0;0
41163;80222;2199;63;20;2;18;.900;3515000;0
41163;142810;760;0;0;0;0;.00nan;0;0
41165;166226;1093;0;0;0;0;.00nan;0;0
41165;174894;754;74;24;1;23;.958;3600000;0
41165;207194;754;0;0;0;0;.00nan;0;0
41165;149103;1093;69;31;2;29;.935;3600000;0
41167;11882;758;76;29;2;27;.931;3600000;0
41167;175757;1497;91;32;1;31;.969;3600000;0
41167;67446;1497;0;0;0;0;.00nan;0;0
41167;93756;758;0;0;0;0;.00nan;0;0
41169;177124;775;64;28;3;25;.893;3568000;0
41169;180188;4924;81;26;1;25;.962;3600000;0
41169;-1;4924;0;0;0;0;.00nan;0;0
41169;146249;775;0;0;0;0;.00nan;0;0
41171;193545;774;43;28;4;24;.857;3600000;0
41171;201075;760;83;27;1;26;.963;3600000;0
41171;201933;774;0;0;0;0;.00nan;0;0
41171;142810;760;0;0;0;0;.00nan;0;0
41173;190589;2197;76;29;2;27;.931;3552000;0
41173;63932;3913;0;0;0;0;.00nan;0;0
41173;82817;2197;0;0;0;0;.00nan;0;0
41173;148576;3913;80;27;1;26;.963;3600000;0
41175;177356;2545;0;0;0;0;.00nan;0;0
41175;175761;769;0;0;0;0;.00nan;0;0
41175;145463;769;48;29;4;25;.862;3570000;0
41175;149048;2545;55;21;3;18;.857;3600000;0
41177;188815;762;0;0;0;0;.00nan;0;0
41177;180133;1492;0;0;0;0;.00nan;0;0
41177;181910;1492;91;27;1;26;.963;3600000;0
41177;186234;762;63;29;3;26;.897;3600000;0
41179;31;755;42;4;1;3;.750;395000;0
41179;-1;911;49;20;3;17;.850;3600000;0
41179;174858;911;0;0;0;0;.00nan;0;0
41179;180154;755;36;33;6;27;.818;3205000;0
41181;177124;775;71;19;1;18;.947;3600000;0
41181;180188;4924;0;0;0;0;.00nan;0;0
41181;-1;4924;97;50;3;47;.940;3574000;0
41181;146249;775;0;0;0;0;.00nan;0;0
41183;164521;3721;91;30;1;29;.967;3600000;0
41183;169680;3730;0;0;0;0;.00nan;0;0
41183;67818;3721;0;0;0;0;.00nan;0;0
41183;149112;3730;44;27;4;23;.852;3600000;0
41185;11882;758;0;0;0;0;.00nan;0;0
41185;189264;4923;0;0;0;0;.00nan;0;0
41185;82711;4923;100;29;0;29;1.000;3600000;0
41185;93756;758;75;22;1;21;.955;3555000;0
41187;171113;759;0;0;0;0;.00nan;0;0
41187;175757;1497;0;0;0;0;.00nan;0;0
41187;176686;759;48;21;4;17;.810;3582000;0
41187;67446;1497;70;26;2;24;.923;3600000;0
41189;170530;766;66;34;4;30;.882;3600000;0
41189;212428;750;0;0;0;0;.00nan;0;0
41189;180738;750;67;15;1;14;.933;3600000;0
41189;187348;766;0;0;0;0;.00nan;0;0
41191;1756;4989;0;0;0;0;.00nan;0;0
41191;162979;746;86;13;0;13;1.000;3600000;0
41191;190570;4989;61;45;6;39;.867;3600000;0
41191;149191;746;0;0;0;0;.00nan;0;0
41193;166226;1093;70;31;3;28;.903;3600000;0
41193;174898;1503;0;0;0;0;.00nan;0;0
41193;192386;1503;60;20;2;18;.900;3600000;0
41193;149103;1093;0;0;0;0;.00nan;0;0
41195;164424;772;0;0;0;0;.00nan;0;0
41195;11708;772;69;32;3;29;.906;3600000;0
41195;166023;767;0;0;0;0;.00nan;0;0
41195;149262;767;33;17;4;13;.765;3568000;0
41197;8504;768;0;0;0;0;.00nan;0;0
41197;-1;2199;69;36;3;33;.917;3526000;0
41197;80222;2199;0;0;0;0;.00nan;0;0
41197;149280;768;60;17;1;16;.941;3600000;0
41199;193545;774;0;0;0;0;.00nan;0;0
41199;-1;911;67;22;2;20;.909;3600000;0
41199;174858;911;0;0;0;0;.00nan;0;0
41199;201933;774;50;28;4;24;.857;3600000;0
41201;177356;2545;41;23;4;19;.826;3600000;0
41201;-1;2199;0;0;0;0;.00nan;0;0
41201;80222;2199;76;30;2;28;.933;3600000;0
41201;149048;2545;0;0;0;0;.00nan;0;0
41203;1756;4989;0;0;0;0;.00nan;0;0
41203;169680;3730;64;24;2;22;.917;3900000;0
41203;190570;4989;100;52;2;50;.962;3900000;0
41203;149112;3730;0;0;0;0;.00nan;0;0
41205;189264;4923;0;0;0;0;.00nan;0;0
41205;175757;1497;95;20;0;20;1.000;3600000;0
41205;67446;1497;0;0;0;0;.00nan;0;0
41205;82711;4923;38;28;6;22;.786;3600000;0
41207;188815;762;53;16;2;14;.875;3600000;0
41207;175761;769;65;30;4;26;.867;3600000;0
41207;186234;762;0;0;0;0;.00nan;0;0
41207;145463;769;0;0;0;0;.00nan;0;0
41209;162979;746;91;29;1;28;.966;3600000;0
41209;174894;754;69;33;2;31;.939;3564000;0
41209;207194;754;0;0;0;0;.00nan;0;0
41209;149191;746;0;0;0;0;.00nan;0;0
41211;180188;4924;74;35;3;32;.914;3563000;0
41211;-1;4924;0;0;0;0;.00nan;0;0
41211;63932;3913;87;33;2;31;.939;3600000;0
41211;148576;3913;0;0;0;0;.00nan;0;0
41213;31;755;0;0;0;0;.00nan;0;0
41213;164521;3721;40;32;5;27;.844;3537000;0
41213;180154;755;56;24;3;21;.875;3600000;0
41213;67818;3721;0;0;0;0;.00nan;0;0
41215;166023;767;44;31;5;26;.839;3600000;0
41215;171113;759;0;0;0;0;.00nan;0;0
41215;176686;759;67;26;2;24;.923;3600000;0
41215;149262;767;0;0;0;0;.00nan;0;0
41217;166226;1093;0;0;0;0;.00nan;0;0
41217;174898;1503;88;18;0;18;1.000;3600000;0
41217;192386;1503;0;0;0;0;.00nan;0;0
41217;149103;1093;50;39;5;34;.872;3600000;0
41219;11882;758;95;15;0;15;1.000;3900000;0
41219;201075;760;0;0;0;0;.00nan;0;0
41219;93756;758;0;0;0;0;.00nan;0;0
41219;142810;760;94;30;0;30;1.000;3900000;0
41221;8504;768;77;19;1;18;.947;3600000;0
41221;212428;750;0;0;0;0;.00nan;0;0
41221;180738;750;93;41;3;38;.927;3600000;0
41221;149280;768;0;0;0;0;.00nan;0;0
41223;170530;766;100;27;0;27;1.000;3600000;0
41223;190589;2197;93;31;1;30;.968;3600000;0
41223;187348;766;0;0;0;0;.00nan;0;0
41223;82817;2197;0;0;0;0;.00nan;0;0
41225;164424;772;67;26;2;24;.923;3600000;0
41225;11708;772;0;0;0;0;.00nan;0;0
41225;180133;1492;0;0;0;0;.00nan;0;0
41225;181910;1492;46;31;5;26;.839;3600000;0
41227;8504;768;0;0;0;0;.00nan;0;0
41227;170530;766;60;47;6;41;.872;3105000;0
41227;187348;766;37;5;2;3;.600;495000;0
41227;149280;768;44;16;3;13;.813;3600000;0
41229;11882;758;73;28;2;26;.929;3556000;0
41229;175761;769;0;0;0;0;.00nan;0;0
41229;93756;758;0;0;0;0;.00nan;0;0
41229;145463;769;81;25;1;24;.960;3600000;0
41231;174894;754;0;0;0;0;.00nan;0;0
41231;207194;754;67;21;2;19;.905;3584000;0
41231;63932;3913;100;53;1;52;.981;3600000;0
41231;148576;3913;0;0;0;0;.00nan;0;0
41233;166226;1093;93;38;2;36;.947;3595000;0
41233;174898;1503;0;0;0;0;.00nan;0;0
41233;192386;1503;50;10;1;9;.900;3600000;0
41233;149103;1093;0;0;0;0;.00nan;0;0
41235;164424;772;0;0;0;0;.00nan;0;0
41235;11708;772;80;34;3;31;.912;3535000;0
41235;175757;1497;93;28;1;27;.964;3600000;0
41235;67446;1497;0;0;0;0;.00nan;0;0
41237;162979;746;0;0;0;0;.00nan;0;0
41237;188815;762;0;0;0;0;.00nan;0;0
41237;186234;762;52;36;5;31;.861;3600000;0
41237;149191;746;69;25;2;23;.920;3600000;0
41239;177124;775;53;27;4;23;.852;3552000;0
41239;189264;4923;54;32;3;29;.906;3600000;0
41239;82711;4923;0;0;0;0;.00nan;0;0
41239;146249;775;0;0;0;0;.00nan;0;0
41241;164521;3721;0;0;0;0;.00nan;0;0
41241;171113;759;68;16;1;15;.938;3631000;0
41241;176686;759;0;0;0;0;.00nan;0;0
41241;67818;3721;83;30;2;28;.933;3631000;0
41243;31;755;0;0;0;0;.00nan;0;0
41243;193545;774;77;28;2;26;.929;3571000;0
41243;180154;755;77;24;1;23;.958;3600000;0
41243;201933;774;0;0;0;0;.00nan;0;0
41245;180133;1492;73;35;3;32;.914;3900000;0
41245;190589;2197;0;0;0;0;.00nan;0;0
41245;181910;1492;0;0;0;0;.00nan;0;0
41245;82817;2197;64;32;3;29;.906;3900000;0
41247;169680;3730;0;0;0;0;.00nan;0;0
41247;180188;4924;0;0;0;0;.00nan;0;0
41247;-1;4924;73;25;2;23;.920;3600000;0
41247;149112;3730;52;26;3;23;.885;3547000;0
41249;177356;2545;64;9;0;9;1.000;581000;0
41249;-1;911;0;0;0;0;.00nan;0;0
41249;174858;911;53;16;2;14;.875;3600000;0
41249;149048;2545;34;35;6;29;.829;3019000;0
41251;212428;750;62;28;3;25;.893;3600000;0
41251;180738;750;0;0;0;0;.00nan;0;0
41251;-1;2199;100;33;0;33;1.000;3600000;0
41251;80222;2199;0;0;0;0;.00nan;0;0
41253;166023;767;0;0;0;0;.00nan;0;0
41253;201075;760;0;0;0;0;.00nan;0;0
41253;142810;760;76;39;3;36;.923;3600000;0
41253;149262;767;41;29;5;24;.828;3554000;0
800;177124;768;0;0;0;0;.00nan;0;0
800;8504;768;56;16;2;14;.875;3600000;0
800;188815;762;92;48;4;44;.917;3544000;0
800;186234;762;0;0;0;0;.00nan;0;0
801;164424;759;62;19;1;18;.947;4467000;0
801;180188;4924;87;39;2;37;.949;4467000;0
801;91194;4924;0;0;0;0;.00nan;0;0
801;148904;759;0;0;0;0;.00nan;0;0
802;162979;746;65;21;1;20;.952;3600000;0
802;189581;758;0;0;0;0;.00nan;0;0
802;176686;758;85;44;3;41;.932;3548000;0
802;149280;746;0;0;0;0;.00nan;0;0
803;174898;1503;58;21;3;18;.857;3600000;0
803;196698;1503;0;0;0;0;.00nan;0;0
803;63932;1093;62;37;4;33;.892;3559000;0
803;149103;1093;0;0;0;0;.00nan;0;0
804;189264;4923;0;0;0;0;.00nan;0;0
804;206313;766;69;36;3;33;.917;3559000;0
804;179406;4923;79;29;2;27;.931;3600000;0
804;81733;766;0;0;0;0;.00nan;0;0
805;212428;750;0;0;0;0;.00nan;0;0
805;180738;750;72;23;1;22;.957;4503000;0
805;87758;3913;88;37;2;35;.946;4503000;0
805;148675;3913;0;0;0;0;.00nan;0;0
806;3241;911;0;0;0;0;.00nan;0;0
806;-1;911;58;32;4;28;.875;3918000;0
806;-1;2199;0;0;0;0;.00nan;0;0
806;80222;2199;64;27;3;24;.889;3918000;0
807;166023;767;0;0;0;0;.00nan;0;0
807;174894;754;42;30;5;25;.833;3600000;0
807;207194;754;0;0;0;0;.00nan;0;0
807;149262;767;76;24;1;23;.958;3600000;0
808;177124;768;0;0;0;0;.00nan;0;0
808;8504;768;56;17;2;15;.882;3600000;0
808;188815;762;54;36;5;31;.861;3600000;0
808;186234;762;0;0;0;0;.00nan;0;0
809;164424;759;62;10;1;9;.900;3600000;0
809;180188;4924;0;0;0;0;.00nan;0;0
809;91194;4924;88;43;2;41;.953;3600000;0
809;148904;759;0;0;0;0;.00nan;0;0
810;162979;746;80;29;1;28;.966;3762000;0
810;189581;758;0;0;0;0;.00nan;0;0
810;176686;758;78;30;2;28;.933;3762000;0
810;149280;746;0;0;0;0;.00nan;0;0
811;174898;1503;81;31;2;29;.935;3600000;0
811;196698;1503;0;0;0;0;.00nan;0;0
811;63932;1093;98;52;3;49;.942;3564000;0
811;149103;1093;0;0;0;0;.00nan;0;0
812;189264;4923;0;0;0;0;.00nan;0;0
812;206313;766;19;20;5;15;.750;3545000;0
812;179406;4923;60;27;3;24;.889;3600000;0
812;81733;766;0;0;0;0;.00nan;0;0
813;212428;750;0;0;0;0;.00nan;0;0
813;180738;750;58;24;3;21;.875;3739000;0
813;87758;3913;79;34;2;32;.941;3739000;0
813;148675;3913;0;0;0;0;.00nan;0;0
814;3241;911;0;0;0;0;.00nan;0;0
814;-1;911;61;20;2;18;.900;3600000;0
814;-1;2199;0;0;0;0;.00nan;0;0
814;80222;2199;28;31;6;25;.806;3600000;0
815;166023;767;0;0;0;0;.00nan;0;0
815;174894;754;71;38;4;34;.895;3600000;0
815;207194;754;0;0;0;0;.00nan;0;0
815;149262;767;73;28;2;26;.929;3600000;0
816;177124;768;0;0;0;0;.00nan;0;0
816;8504;768;80;13;0;13;1.000;3600000;0
816;188815;762;64;51;6;45;.882;3600000;0
816;186234;762;0;0;0;0;.00nan;0;0
817;164424;759;89;21;0;21;1.000;3600000;0
817;180188;4924;0;0;0;0;.00nan;0;0
817;91194;4924;96;32;1;31;.969;3600000;0
817;148904;759;0;0;0;0;.00nan;0;0
818;162979;746;53;23;3;20;.870;3600000;0
818;189581;758;0;0;0;0;.00nan;0;0
818;176686;758;68;47;5;42;.894;3600000;0
818;149280;746;0;0;0;0;.00nan;0;0
819;174898;1503;56;25;4;21;.840;3600000;0
819;196698;1503;0;0;0;0;.00nan;0;0
819;63932;1093;44;38;6;32;.842;3543000;0
819;149103;1093;0;0;0;0;.00nan;0;0
820;189264;4923;0;0;0;0;.00nan;0;0
820;206313;766;71;42;4;38;.905;3600000;0
820;179406;4923;67;20;1;19;.950;3600000;0
820;81733;766;0;0;0;0;.00nan;0;0
821;212428;750;0;0;0;0;.00nan;0;0
821;180738;750;52;33;5;28;.848;3578000;0
821;87758;3913;58;31;4;27;.871;3600000;0
821;148675;3913;0;0;0;0;.00nan;0;0
822;3241;911;0;0;0;0;.00nan;0;0
822;-1;911;37;27;5;22;.815;3522000;0
822;-1;2199;0;0;0;0;.00nan;0;0
822;80222;2199;66;29;3;26;.897;3600000;0
823;166023;767;0;0;0;0;.00nan;0;0
823;174894;754;62;36;4;32;.889;3600000;0
823;207194;754;0;0;0;0;.00nan;0;0
823;149262;767;40;27;5;22;.815;3584000;0
824;177124;768;0;0;0;0;.00nan;0;0
824;8504;768;76;11;0;11;1.000;3600000;0
824;188815;762;51;42;7;35;.833;3600000;0
824;186234;762;0;0;0;0;.00nan;0;0
825;164424;759;66;17;2;15;.882;3600000;0
825;180188;4924;0;0;0;0;.00nan;0;0
825;91194;4924;86;43;3;40;.930;3572000;0
825;148904;759;0;0;0;0;.00nan;0;0
826;162979;746;66;30;4;26;.867;3600000;0
826;189581;758;0;0;0;0;.00nan;0;0
826;176686;758;69;24;1;23;.958;3600000;0
826;149280;746;0;0;0;0;.00nan;0;0
827;174898;1503;73;27;2;25;.926;3571000;0
827;196698;1503;0;0;0;0;.00nan;0;0
827;63932;1093;100;30;0;30;1.000;3600000;0
827;149103;1093;0;0;0;0;.00nan;0;0
828;189264;4923;0;0;0;0;.00nan;0;0
828;206313;766;83;31;2;29;.935;3567000;0
828;179406;4923;95;27;1;26;.963;3600000;0
828;81733;766;0;0;0;0;.00nan;0;0
829;212428;750;0;0;0;0;.00nan;0;0
829;180738;750;81;26;1;25;.962;3600000;0
829;87758;3913;79;32;2;30;.938;3559000;0
829;148675;3913;0;0;0;0;.00nan;0;0
830;3241;911;0;0;0;0;.00nan;0;0
830;-1;911;44;31;5;26;.839;3600000;0
830;-1;2199;0;0;0;0;.00nan;0;0
830;80222;2199;97;35;1;34;.971;3600000;0
831;166023;767;0;0;0;0;.00nan;0;0
831;174894;754;73;37;4;33;.892;3591000;0
831;207194;754;0;0;0;0;.00nan;0;0
831;149262;767;54;15;2;13;.867;3600000;0
969;162979;746;73;18;1;17;.944;3600000;0
969;189581;758;0;0;0;0;.00nan;0;0
969;176686;758;90;48;3;45;.938;3574000;0
969;149280;746;0;0;0;0;.00nan;0;0
970;174898;1503;60;16;1;15;.938;3600000;0
970;196698;1503;0;0;0;0;.00nan;0;0
970;63932;1093;98;43;2;41;.953;3567000;0
970;149103;1093;0;0;0;0;.00nan;0;0
971;212428;750;0;0;0;0;.00nan;0;0
971;180738;750;80;31;2;29;.935;3600000;0
971;87758;3913;92;21;0;21;1.000;3600000;0
971;148675;3913;0;0;0;0;.00nan;0;0
972;3241;911;0;0;0;0;.00nan;0;0
972;-1;911;76;35;3;32;.914;3590000;0
972;-1;2199;0;0;0;0;.00nan;0;0
972;80222;2199;57;19;2;17;.895;3600000;0
973;166023;767;0;0;0;0;.00nan;0;0
973;174894;754;99;44;1;43;.977;3600000;0
973;207194;754;0;0;0;0;.00nan;0;0
973;149262;767;50;11;2;9;.818;3572000;0
1006;212428;750;0;0;0;0;.00nan;0;0
1006;180738;750;63;31;3;28;.903;5013000;0
1006;87758;3913;74;49;4;45;.918;5013000;0
1006;148675;3913;0;0;0;0;.00nan;0;0
1007;166023;767;0;0;0;0;.00nan;0;0
1007;174894;754;63;41;4;37;.902;3543000;0
1007;207194;754;0;0;0;0;.00nan;0;0
1007;149262;767;52;24;3;21;.875;3600000;0
1058;212428;750;0;0;0;0;.00nan;0;0
1058;180738;750;38;26;5;21;.808;3600000;0
1058;87758;3913;84;26;1;25;.962;3600000;0
1058;148675;3913;0;0;0;0;.00nan;0;0
1131;177124;768;0;0;0;0;.00nan;0;0
1131;8504;768;85;16;0;16;1.000;3600000;0
1131;87758;3913;42;39;7;32;.821;3600000;0
1131;148675;3913;0;0;0;0;.00nan;0;0
1132;162979;746;84;14;0;14;1.000;3600000;0
1132;166023;767;0;0;0;0;.00nan;0;0
1132;149262;767;61;34;4;30;.882;3600000;0
1132;149280;746;0;0;0;0;.00nan;0;0
1133;189264;4923;0;0;0;0;.00nan;0;0
1133;174898;1503;67;22;2;20;.909;3600000;0
1133;179406;4923;57;30;4;26;.867;3514000;0
1133;196698;1503;0;0;0;0;.00nan;0;0
1134;164424;759;88;25;1;24;.960;3600000;0
1134;-1;2199;0;0;0;0;.00nan;0;0
1134;80222;2199;60;36;4;32;.889;3600000;0
1134;148904;759;0;0;0;0;.00nan;0;0
1135;177124;768;0;0;0;0;.00nan;0;0
1135;8504;768;77;19;1;18;.947;3600000;0
1135;87758;3913;80;39;4;35;.897;3560000;0
1135;148675;3913;0;0;0;0;.00nan;0;0
1136;162979;746;100;32;0;32;1.000;3600000;0
1136;166023;767;0;0;0;0;.00nan;0;0
1136;149262;767;71;35;3;32;.914;3600000;0
1136;149280;746;0;0;0;0;.00nan;0;0
1137;189264;4923;0;0;0;0;.00nan;0;0
1137;174898;1503;73;26;2;24;.923;3600000;0
1137;179406;4923;55;32;5;27;.844;3600000;0
1137;196698;1503;0;0;0;0;.00nan;0;0
1138;164424;759;54;23;3;20;.870;3600000;0
1138;-1;2199;0;0;0;0;.00nan;0;0
1138;80222;2199;35;25;5;20;.800;3548000;0
1138;148904;759;0;0;0;0;.00nan;0;0
1139;177124;768;0;0;0;0;.00nan;0;0
1139;8504;768;81;18;1;17;.944;3600000;0
1139;87758;3913;31;11;3;8;.727;489000;0
1139;148675;3913;73;34;3;31;.912;3111000;0
1140;162979;746;92;21;0;21;1.000;3600000;0
1140;166023;767;0;0;0;0;.00nan;0;0
1140;149262;767;50;39;5;34;.872;3600000;0
1140;149280;746;0;0;0;0;.00nan;0;0
1141;189264;4923;0;0;0;0;.00nan;0;0
1141;174898;1503;71;22;1;21;.955;3543000;0
1141;179406;4923;100;24;0;24;1.000;3600000;0
1141;196698;1503;0;0;0;0;.00nan;0;0
1142;164424;759;67;24;3;21;.875;3774000;0
1142;-1;2199;0;0;0;0;.00nan;0;0
1142;80222;2199;71;42;4;38;.905;3774000;0
1142;148904;759;0;0;0;0;.00nan;0;0
1143;177124;768;0;0;0;0;.00nan;0;0
1143;8504;768;69;17;1;16;.941;3600000;0
1143;87758;3913;0;0;0;0;.00nan;0;0
1143;148675;3913;47;39;5;34;.872;3600000;0
1144;162979;746;79;28;2;26;.929;3600000;0
1144;166023;767;0;0;0;0;.00nan;0;0
1144;149262;767;49;30;4;26;.867;3574000;0
1144;149280;746;0;0;0;0;.00nan;0;0
1145;189264;4923;0;0;0;0;.00nan;0;0
1145;174898;1503;72;28;2;26;.929;3600000;0
1145;179406;4923;47;20;3;17;.850;3563000;0
1145;196698;1503;0;0;0;0;.00nan;0;0
1146;164424;759;77;10;0;10;1.000;3600000;0
1146;-1;2199;0;0;0;0;.00nan;0;0
1146;80222;2199;57;35;4;31;.886;3600000;0
1146;148904;759;0;0;0;0;.00nan;0;0
1486;189264;4923;0;0;0;0;.00nan;0;0
1486;174898;1503;100;39;2;37;.949;3600000;0
1486;179406;4923;71;38;4;34;.895;3563000;0
1486;196698;1503;0;0;0;0;.00nan;0;0
1511;177124;768;0;0;0;0;.00nan;0;0
1511;8504;768;69;22;1;21;.955;3600000;0
1511;174898;1503;70;33;3;30;.909;3517000;0
1511;196698;1503;0;0;0;0;.00nan;0;0
1512;162979;746;78;30;2;28;.933;3600000;0
1512;164424;759;58;33;3;30;.909;3563000;0
1512;148904;759;0;0;0;0;.00nan;0;0
1512;149280;746;0;0;0;0;.00nan;0;0
1513;177124;768;0;0;0;0;.00nan;0;0
1513;8504;768;77;12;0;12;1.000;3600000;0
1513;174898;1503;80;42;4;38;.905;3600000;0
1513;196698;1503;0;0;0;0;.00nan;0;0
1514;162979;746;56;23;3;20;.870;3600000;0
1514;164424;759;97;36;1;35;.972;3600000;0
1514;148904;759;0;0;0;0;.00nan;0;0
1514;149280;746;0;0;0;0;.00nan;0;0
1515;177124;768;0;0;0;0;.00nan;0;0
1515;8504;768;74;17;1;16;.941;3561000;0
1515;174898;1503;100;32;0;32;1.000;3600000;0
1515;196698;1503;0;0;0;0;.00nan;0;0
1516;162979;746;79;33;3;30;.909;3572000;0
1516;164424;759;92;31;1;30;.968;3600000;0
1516;148904;759;0;0;0;0;.00nan;0;0
1516;149280;746;0;0;0;0;.00nan;0;0
1517;177124;768;0;0;0;0;.00nan;0;0
1517;8504;768;78;26;2;24;.923;3600000;0
1517;174898;1503;75;31;3;28;.903;3569000;0
1517;196698;1503;0;0;0;0;.00nan;0;0
1518;162979;746;85;48;4;44;.917;3535000;0
1518;164424;759;59;26;3;23;.885;3600000;0
1518;148904;759;0;0;0;0;.00nan;0;0
1518;149280;746;0;0;0;0;.00nan;0;0
1832;177124;768;0;0;0;0;.00nan;0;0
1832;8504;768;80;27;2;25;.926;3600000;0
1832;174898;1503;16;20;6;14;.700;1602000;0
1832;196698;1503;53;18;2;16;.889;1998000;0
1833;162979;746;87;48;3;45;.938;4853000;0
1833;164424;759;63;41;4;37;.902;4853000;0
1833;148904;759;0;0;0;0;.00nan;0;0
1833;149280;746;0;0;0;0;.00nan;0;0
1880;162979;746;28;8;3;5;.625;516000;0
1880;164424;759;66;14;1;13;.929;3600000;0
1880;148904;759;0;0;0;0;.00nan;0;0
1880;149280;746;64;36;3;33;.917;3084000;0
1883;177124;768;0;0;0;0;.00nan;0;0
1883;8504;768;96;33;1;32;.970;3683000;0
1883;164424;759;77;25;2;23;.920;3683000;0
1883;148904;759;0;0;0;0;.00nan;0;0
1884;177124;768;0;0;0;0;.00nan;0;0
1884;8504;768;62;29;3;26;.897;3578000;0
1884;164424;759;91;35;2;33;.943;3600000;0
1884;148904;759;0;0;0;0;.00nan;0;0
1885;177124;768;0;0;0;0;.00nan;0;0
1885;8504;768;45;17;3;14;.824;3600000;0
1885;164424;759;99;34;1;33;.971;3600000;0
1885;148904;759;0;0;0;0;.00nan;0;0
1886;177124;768;0;0;0;0;.00nan;0;0
1886;8504;768;73;32;2;30;.938;3600000;0
1886;164424;759;78;33;3;30;.909;3560000;0
1886;148904;759;0;0;0;0;.00nan;0;0
2123;177124;768;0;0;0;0;.00nan;0;0
2123;8504;768;61;21;2;19;.905;3600000;0
2123;164424;759;62;31;3;28;.903;3585000;0
2123;148904;759;0;0;0;0;.00nan;0;0
2146;177124;768;0;0;0;0;.00nan;0;0
2146;8504;768;85;32;2;30;.938;3600000;0
2146;164424;759;58;31;4;27;.871;3513000;0
2146;148904;759;0;0;0;0;.00nan;0;0
41254;19954;1922;91;17;0;17;1.000;3600000;0
41254;184159;583;77;34;2;32;.941;3563000;0
41254;-1;583;0;0;0;0;.00nan;0;0
41254;155943;1922;0;0;0;0;.00nan;0;0
41255;185240;1928;74;25;1;24;.960;3600000;0
41255;-1;2287;86;31;2;29;.935;3551000;0
41255;89930;2287;0;0;0;0;.00nan;0;0
41255;155769;1928;0;0;0;0;.00nan;0;0
41256;195672;582;24;26;6;20;.769;3600000;0
41256;-1;582;0;0;0;0;.00nan;0;0
41256;67625;567;79;27;2;25;.926;3600000;0
41256;143879;567;0;0;0;0;.00nan;0;0
41257;19954;1922;35;30;6;24;.800;3257000;0
41257;169493;580;62;13;1;12;.923;3600000;0
41257;72514;580;0;0;0;0;.00nan;0;0
41257;155943;1922;49;1;0;1;1.000;343000;0
41258;9597;584;0;0;0;0;.00nan;0;0
41258;11352;2277;42;31;5;26;.839;3600000;0
41258;180990;584;49;23;4;19;.826;3600000;0
41258;-1;2277;0;0;0;0;.00nan;0;0
41259;6202;1918;0;0;0;0;.00nan;0;0
41259;179981;1918;100;33;0;33;1.000;3600000;0
41259;185232;586;77;24;1;23;.958;3546000;0
41259;64923;586;0;0;0;0;.00nan;0;0
41260;6541;585;83;31;2;29;.935;3607000;0
41260;11687;585;0;0;0;0;.00nan;0;0
41260;14191;563;0;0;0;0;.00nan;0;0
41260;83199;563;67;27;3;24;.889;3607000;0
41261;6202;1918;0;0;0;0;.00nan;0;0
41261;195672;582;0;0;0;0;.00nan;0;0
41261;179981;1918;34;42;6;36;.857;3600000;0
41261;-1;582;86;37;3;34;.919;3600000;0
41262;6541;585;51;41;6;35;.854;3600000;0
41262;11687;585;0;0;0;0;.00nan;0;0
41262;185232;586;81;32;2;30;.938;3600000;0
41262;64923;586;0;0;0;0;.00nan;0;0
41263;14191;563;0;0;0;0;.00nan;0;0
41263;184159;583;74;32;2;30;.938;3581000;0
41263;-1;583;0;0;0;0;.00nan;0;0
41263;83199;563;71;23;1;22;.957;3600000;0
41264;11352;2277;36;25;5;20;.800;3600000;0
41264;-1;2287;0;0;0;0;.00nan;0;0
41264;-1;2277;0;0;0;0;.00nan;0;0
41264;89930;2287;66;27;2;25;.926;3600000;0
41265;185240;1928;60;29;3;26;.897;3582000;0
41265;67625;567;70;24;1;23;.958;3600000;0
41265;143879;567;0;0;0;0;.00nan;0;0
41265;155769;1928;0;0;0;0;.00nan;0;0
41266;195672;582;0;0;0;0;.00nan;0;0
41266;-1;2287;0;0;0;0;.00nan;0;0
41266;-1;582;71;25;2;23;.920;3600000;0
41266;89930;2287;66;36;4;32;.889;3560000;0
41267;9597;584;0;0;0;0;.00nan;0;0
41267;19954;1922;0;0;0;0;.00nan;0;0
41267;180990;584;71;37;4;33;.892;3518000;0
41267;155943;1922;71;25;2;23;.920;3600000;0
41268;6541;585;0;0;0;0;.00nan;0;0
41268;11687;585;59;21;3;18;.857;3517000;0
41268;184159;583;72;25;1;24;.960;3600000;0
41268;-1;583;0;0;0;0;.00nan;0;0
41269;11352;2277;92;36;1;35;.972;3600000;0
41269;169493;580;60;20;2;18;.900;3600000;0
41269;-1;2277;0;0;0;0;.00nan;0;0
41269;72514;580;0;0;0;0;.00nan;0;0
41270;185232;586;31;19;4;15;.789;3599000;0
41270;185240;1928;64;29;3;26;.897;3600000;0
41270;64923;586;0;0;0;0;.00nan;0;0
41270;155769;1928;0;0;0;0;.00nan;0;0
41271;6541;585;68;40;4;36;.900;3519000;0
41271;11687;585;0;0;0;0;.00nan;0;0
41271;-1;2287;0;0;0;0;.00nan;0;0
41271;89930;2287;62;20;2;18;.900;3600000;0
41272;169493;580;48;42;6;36;.857;3600000;0
41272;67625;567;0;0;0;0;.00nan;0;0
41272;72514;580;0;0;0;0;.00nan;0;0
41272;143879;567;88;36;2;34;.944;3600000;0
41273;9597;584;0;0;0;0;.00nan;0;0
41273;195672;582;0;0;0;0;.00nan;0;0
41273;180990;584;94;40;2;38;.950;3600000;0
41273;-1;582;51;32;4;28;.875;3600000;0
41274;6202;1918;0;0;0;0;.00nan;0;0
41274;19954;1922;49;36;6;30;.833;3900000;0
41274;179981;1918;38;41;6;35;.854;3900000;0
41274;155943;1922;0;0;0;0;.00nan;0;0
41275;184159;583;48;18;3;15;.833;3600000;0
41275;185240;1928;0;0;0;0;.00nan;0;0
41275;-1;583;0;0;0;0;.00nan;0;0
41275;155769;1928;54;30;4;26;.867;3575000;0
41276;169493;580;0;0;0;0;.00nan;0;0
41276;-1;2287;87;22;1;21;.955;3600000;0
41276;72514;580;75;31;3;28;.903;3596000;0
41276;89930;2287;0;0;0;0;.00nan;0;0
41277;6541;585;0;0;0;0;.00nan;0;0
41277;11687;585;68;41;4;37;.902;3688000;0
41277;67625;567;57;20;3;17;.850;3688000;0
41277;143879;567;0;0;0;0;.00nan;0;0
41278;19954;1922;0;0;0;0;.00nan;0;0
41278;185240;1928;69;34;3;31;.912;3548000;0
41278;155769;1928;0;0;0;0;.00nan;0;0
41278;155943;1922;80;34;2;32;.941;3600000;0
41279;9597;584;0;0;0;0;.00nan;0;0
41279;185232;586;0;0;0;0;.00nan;0;0
41279;180990;584;55;27;3;24;.889;3600000;0
41279;64923;586;99;22;0;22;1.000;3600000;0
41280;11352;2277;0;0;0;0;.00nan;0;0
41280;195672;582;60;20;2;18;.900;3600000;0
41280;-1;2277;93;55;4;51;.927;3522000;0
41280;-1;582;0;0;0;0;.00nan;0;0
41281;6202;1918;43;36;6;30;.833;3286000;0
41281;14191;563;0;0;0;0;.00nan;0;0
41281;179981;1918;57;6;0;6;1.000;314000;0
41281;83199;563;100;21;0;21;1.000;3600000;0
41282;-1;2287;0;0;0;0;.00nan;0;0
41282;67625;567;59;23;3;20;.870;3600000;0
41282;89930;2287;59;33;4;29;.879;3550000;0
41282;143879;567;0;0;0;0;.00nan;0;0
41283;169493;580;62;29;3;26;.897;3600000;0
41283;195672;582;0;0;0;0;.00nan;0;0
41283;-1;582;46;34;5;29;.853;3574000;0
41283;72514;580;0;0;0;0;.00nan;0;0
41284;195672;582;31;22;5;17;.773;3582000;0
41284;-1;582;0;0;0;0;.00nan;0;0
41284;67625;567;0;0;0;0;.00nan;0;0
41284;143879;567;56;32;4;28;.875;3600000;0
41285;184159;583;82;47;4;43;.915;3600000;0
41285;-1;2287;74;20;1;19;.950;3600000;0
41285;-1;583;0;0;0;0;.00nan;0;0
41285;89930;2287;0;0;0;0;.00nan;0;0
41286;19954;1922;71;27;2;25;.926;3600000;0
41286;185232;586;0;0;0;0;.00nan;0;0
41286;64923;586;48;31;4;27;.871;3541000;0
41286;155943;1922;0;0;0;0;.00nan;0;0
41287;9597;584;0;0;0;0;.00nan;0;0
41287;169493;580;74;23;1;22;.957;3600000;0
41287;180990;584;90;40;2;38;.950;3600000;0
41287;72514;580;0;0;0;0;.00nan;0;0
41288;6202;1918;0;0;0;0;.00nan;0;0
41288;14191;563;0;0;0;0;.00nan;0;0
41288;179981;1918;69;35;3;32;.914;3600000;0
41288;83199;563;72;35;4;31;.886;3556000;0
41289;11352;2277;100;32;0;32;1.000;3600000;0
41289;185240;1928;90;36;1;35;.972;3582000;0
41289;-1;2277;0;0;0;0;.00nan;0;0
41289;155769;1928;0;0;0;0;.00nan;0;0
41290;6541;585;95;25;0;25;1.000;3600000;0
41290;11687;585;0;0;0;0;.00nan;0;0
41290;185232;586;79;39;3;36;.923;3600000;0
41290;64923;586;0;0;0;0;.00nan;0;0
41291;11352;2277;68;19;1;18;.947;3600000;0
41291;195672;582;0;0;0;0;.00nan;0;0
41291;-1;2277;0;0;0;0;.00nan;0;0
41291;-1;582;69;33;3;30;.909;3529000;0
41292;184159;583;0;0;0;0;.00nan;0;0
41292;-1;583;46;21;3;18;.857;3525000;0
41292;67625;567;75;20;1;19;.950;3600000;0
41292;143879;567;0;0;0;0;.00nan;0;0
41293;6202;1918;65;32;3;29;.906;3600000;0
41293;9597;584;76;21;0;21;1.000;1711000;0
41293;179981;1918;0;0;0;0;.00nan;0;0
41293;180990;584;33;20;4;16;.800;1881000;0
41294;14191;563;55;32;4;28;.875;3600000;0
41294;19954;1922;0;0;0;0;.00nan;0;0
41294;83199;563;0;0;0;0;.00nan;0;0
41294;155943;1922;100;31;0;31;1.000;3600000;0
41295;9597;584;48;27;4;23;.852;3217000;0
41295;184159;583;64;27;2;25;.926;3600000;0
41295;180990;584;30;10;3;7;.700;383000;0
41295;-1;583;0;0;0;0;.00nan;0;0
41296;11352;2277;63;47;6;41;.872;3600000;0
41296;-1;2277;0;0;0;0;.00nan;0;0
41296;67625;567;51;24;3;21;.875;3600000;0
41296;143879;567;0;0;0;0;.00nan;0;0
41297;6541;585;53;44;6;38;.864;3600000;0
41297;11687;585;0;0;0;0;.00nan;0;0
41297;169493;580;87;24;1;23;.958;3600000;0
41297;72514;580;0;0;0;0;.00nan;0;0
41298;195672;582;74;19;1;18;.947;3600000;0
41298;185240;1928;60;47;5;42;.894;3600000;0
41298;-1;582;0;0;0;0;.00nan;0;0
41298;155769;1928;0;0;0;0;.00nan;0;0
41299;9597;584;0;0;0;0;.00nan;0;0
41299;180990;584;83;25;1;24;.960;3600000;0
41299;-1;2287;0;0;0;0;.00nan;0;0
41299;89930;2287;60;26;3;23;.885;3548000;0
41300;6541;585;0;0;0;0;.00nan;0;0
41300;11687;585;50;37;5;32;.865;3600000;0
41300;195672;582;0;0;0;0;.00nan;0;0
41300;-1;582;69;24;2;22;.917;3600000;0
41301;19954;1922;82;33;2;31;.939;3900000;0
41301;67625;567;0;0;0;0;.00nan;0;0
41301;155943;1922;0;0;0;0;.00nan;0;0
41301;161047;567;67;26;2;24;.923;3900000;0
41302;161583;583;0;0;0;0;.00nan;0;0
41302;184159;583;68;32;3;29;.906;3719000;0
41302;185232;586;86;36;2;34;.944;3719000;0
41302;64923;586;0;0;0;0;.00nan;0;0
41303;6202;1918;0;0;0;0;.00nan;0;0
41303;11352;2277;86;43;3;40;.930;3600000;0
41303;179981;1918;70;28;2;26;.929;3600000;0
41303;-1;2277;0;0;0;0;.00nan;0;0
41304;169493;580;64;32;3;29;.906;3600000;0
41304;185240;1928;0;0;0;0;.00nan;0;0
41304;72514;580;0;0;0;0;.00nan;0;0
41304;155769;1928;71;27;2;25;.926;3600000;0
41305;6541;585;24;28;6;22;.786;2174000;0
41305;163361;563;62;7;0;7;1.000;810000;0
41305;11687;585;47;12;2;10;.833;1426000;0
41305;83199;563;10;25;7;18;.720;2790000;0
41306;19954;1922;0;0;0;0;.00nan;0;0
41306;-1;2287;97;38;2;36;.947;3900000;0
41306;89930;2287;0;0;0;0;.00nan;0;0
41306;155943;1922;75;34;2;32;.941;3900000;0
41307;11352;2277;0;0;0;0;.00nan;0;0
41307;169096;584;0;0;0;0;.00nan;0;0
41307;180990;584;63;29;3;26;.897;3627000;0
41307;-1;2277;78;33;2;31;.939;3627000;0
41308;169493;580;54;25;3;22;.880;3600000;0
41308;185232;586;36;45;8;37;.822;3600000;0
41308;64923;586;0;0;0;0;.00nan;0;0
41308;72514;580;0;0;0;0;.00nan;0;0
41309;169096;584;0;0;0;0;.00nan;0;0
41309;180990;584;99;40;1;39;.975;3600000;0
41309;67625;567;0;0;0;0;.00nan;0;0
41309;161047;567;68;25;2;23;.920;3598000;0
41310;161583;583;0;0;0;0;.00nan;0;0
41310;6541;585;91;52;4;48;.923;3900000;0
41310;11687;585;0;0;0;0;.00nan;0;0
41310;184159;583;38;20;4;16;.800;3900000;0
41311;169096;584;0;0;0;0;.00nan;0;0
41311;195672;582;0;0;0;0;.00nan;0;0
41311;180990;584;80;24;1;23;.958;3600000;0
41311;-1;582;81;32;2;30;.938;3594000;0
41312;185232;586;0;0;0;0;.00nan;0;0
41312;-1;2287;69;30;3;27;.900;3600000;0
41312;64923;586;100;38;0;38;1.000;3600000;0
41312;89930;2287;0;0;0;0;.00nan;0;0
41313;163361;563;0;0;0;0;.00nan;0;0
41313;11352;2277;53;36;4;32;.889;3565000;0
41313;-1;2277;0;0;0;0;.00nan;0;0
41313;83199;563;82;36;3;33;.917;3600000;0
41314;19954;1922;87;29;1;28;.966;3600000;0
41314;185240;1928;60;31;4;27;.871;3600000;0
41314;155769;1928;0;0;0;0;.00nan;0;0
41314;155943;1922;0;0;0;0;.00nan;0;0
41315;6541;585;0;0;0;0;.00nan;0;0
41315;11687;585;85;49;4;45;.918;3864000;0
41315;169493;580;81;35;3;32;.914;3864000;0
41315;72514;580;0;0;0;0;.00nan;0;0
41316;163361;563;84;51;4;47;.922;3539000;0
41316;67625;567;0;0;0;0;.00nan;0;0
41316;83199;563;0;0;0;0;.00nan;0;0
41316;161047;567;75;32;2;30;.938;3600000;0
41317;6202;1918;0;0;0;0;.00nan;0;0
41317;169096;584;67;35;3;32;.914;3515000;0
41317;179981;1918;98;30;1;29;.967;3600000;0
41317;180990;584;0;0;0;0;.00nan;0;0
41318;161583;583;0;0;0;0;.00nan;0;0
41318;184159;583;51;17;2;15;.882;3669000;0
41318;-1;2287;77;35;3;32;.914;3684000;0
41318;89930;2287;0;0;0;0;.00nan;0;0
41319;19954;1922;0;0;0;0;.00nan;0;0
41319;185240;1928;0;0;0;0;.00nan;0;0
41319;155769;1928;75;40;3;37;.925;3600000;0
41319;155943;1922;70;26;2;24;.923;3600000;0
41320;169096;584;0;0;0;0;.00nan;0;0
41320;185232;586;0;0;0;0;.00nan;0;0
41320;180990;584;45;19;3;16;.842;3592000;0
41320;64923;586;88;30;1;29;.967;3600000;0
41321;161583;583;0;0;0;0;.00nan;0;0
41321;184159;583;48;26;3;23;.885;3561000;0
41321;169493;580;67;25;2;23;.920;3600000;0
41321;72514;580;0;0;0;0;.00nan;0;0
41322;11352;2277;63;24;2;22;.917;3600000;0
41322;185232;586;63;34;4;30;.882;3600000;0
41322;-1;2277;0;0;0;0;.00nan;0;0
41322;64923;586;0;0;0;0;.00nan;0;0
41323;195672;582;90;30;1;29;.967;3635000;0
41323;-1;2287;72;28;2;26;.929;3687000;0
41323;-1;582;0;0;0;0;.00nan;0;0
41323;89930;2287;0;0;0;0;.00nan;0;0
41324;6541;585;45;23;4;19;.826;2271000;0
41324;11687;585;44;4;1;3;.750;1329000;0
41324;169096;584;0;0;0;0;.00nan;0;0
41324;180990;584;88;31;2;29;.935;3600000;0
41325;161583;583;0;0;0;0;.00nan;0;0
41325;184159;583;97;27;0;27;1.000;3858000;0
41325;195672;582;0;0;0;0;.00nan;0;0
41325;-1;582;89;33;1;32;.970;3858000;0
41326;6202;1918;0;0;0;0;.00nan;0;0
41326;179981;1918;88;38;2;36;.947;3900000;0
41326;67625;567;0;0;0;0;.00nan;0;0
41326;161047;567;52;19;2;17;.895;3900000;0
41327;163361;563;0;0;0;0;.00nan;0;0
41327;185232;586;0;0;0;0;.00nan;0;0
41327;64923;586;99;32;1;31;.969;3600000;0
41327;83199;563;63;36;4;32;.889;3600000;0
41328;169493;580;64;25;2;23;.920;3548000;0
41328;185240;1928;78;30;1;29;.967;3600000;0
41328;72514;580;0;0;0;0;.00nan;0;0
41328;155769;1928;0;0;0;0;.00nan;0;0
41329;169493;580;0;0;0;0;.00nan;0;0
41329;-1;2287;72;26;2;24;.923;3600000;0
41329;72514;580;59;28;5;23;.821;3600000;0
41329;89930;2287;0;0;0;0;.00nan;0;0
41330;6541;585;56;40;5;35;.875;3600000;0
41330;11687;585;0;0;0;0;.00nan;0;0
41330;19954;1922;63;11;1;10;.909;3600000;0
41330;155943;1922;0;0;0;0;.00nan;0;0
41331;161583;583;0;0;0;0;.00nan;0;0
41331;6202;1918;46;22;4;18;.818;3600000;0
41331;184159;583;85;32;1;31;.969;3600000;0
41331;179981;1918;0;0;0;0;.00nan;0;0
41332;11352;2277;29;8;3;5;.625;594000;0
41332;-1;2277;69;24;2;22;.917;2969000;0
41332;67625;567;0;0;0;0;.00nan;0;0
41332;161047;567;40;25;4;21;.840;3600000;0
41333;163361;563;23;5;3;2;.400;509000;0
41333;169096;584;100;38;1;37;.974;3600000;0
41333;180990;584;0;0;0;0;.00nan;0;0
41333;83199;563;45;25;4;21;.840;3091000;0
41334;11352;2277;63;45;4;41;.911;3900000;0
41334;-1;2277;0;0;0;0;.00nan;0;0
41334;67625;567;0;0;0;0;.00nan;0;0
41334;161047;567;60;30;4;26;.867;3900000;0
41335;163361;563;0;0;0;0;.00nan;0;0
41335;19954;1922;0;0;0;0;.00nan;0;0
41335;83199;563;85;36;2;34;.944;3592000;0
41335;155943;1922;81;26;1;25;.962;3600000;0
41336;161583;583;0;0;0;0;.00nan;0;0
41336;184159;583;56;26;3;23;.885;3545000;0
41336;195672;582;0;0;0;0;.00nan;0;0
41336;-1;582;99;33;1;32;.970;3600000;0
41337;195672;582;58;32;4;28;.875;3542000;0
41337;185232;586;0;0;0;0;.00nan;0;0
41337;-1;582;0;0;0;0;.00nan;0;0
41337;64923;586;62;24;2;22;.917;3600000;0
41338;163361;563;0;0;0;0;.00nan;0;0
41338;185240;1928;0;0;0;0;.00nan;0;0
41338;83199;563;82;41;3;38;.927;3900000;0
41338;155769;1928;56;24;3;21;.875;3900000;0
41339;6541;585;0;0;0;0;.00nan;0;0
41339;11687;585;51;24;3;21;.875;3542000;0
41339;185240;1928;91;25;1;24;.960;3600000;0
41339;155769;1928;0;0;0;0;.00nan;0;0
41340;185232;586;82;47;4;43;.915;3544000;0
41340;64923;586;0;0;0;0;.00nan;0;0
41340;67625;567;0;0;0;0;.00nan;0;0
41340;161047;567;44;16;3;13;.813;3600000;0
41341;161583;583;0;0;0;0;.00nan;0;0
41341;169096;584;98;26;0;26;1.000;3600000;0
41341;184159;583;50;35;5;30;.857;3600000;0
41341;180990;584;0;0;0;0;.00nan;0;0
41342;6202;1918;0;0;0;0;.00nan;0;0
41342;179981;1918;95;39;2;37;.949;3600000;0
41342;-1;2287;48;36;5;31;.861;3600000;0
41342;89930;2287;0;0;0;0;.00nan;0;0
41343;19954;1922;54;23;3;20;.870;3528000;0
41343;169493;580;70;24;2;22;.917;3600000;0
41343;72514;580;0;0;0;0;.00nan;0;0
41343;155943;1922;0;0;0;0;.00nan;0;0
41344;19954;1922;0;0;0;0;.00nan;0;0
41344;195672;582;0;0;0;0;.00nan;0;0
41344;-1;582;54;30;4;26;.867;3749000;0
41344;155943;1922;62;27;3;24;.889;3749000;0
41345;6202;1918;61;24;2;22;.917;3600000;0
41345;179981;1918;0;0;0;0;.00nan;0;0
41345;-1;2287;0;0;0;0;.00nan;0;0
41345;89930;2287;57;32;4;28;.875;3523000;0
41346;161583;583;56;12;1;11;.917;3600000;0
41346;11352;2277;64;26;2;24;.923;3600000;0
41346;184159;583;0;0;0;0;.00nan;0;0
41346;-1;2277;0;0;0;0;.00nan;0;0
41347;169096;584;43;21;4;17;.810;2204000;0
41347;169493;580;0;0;0;0;.00nan;0;0
41347;180990;584;50;8;1;7;.875;1396000;0
41347;72514;580;72;26;2;24;.923;3600000;0
41348;163361;563;0;0;0;0;.00nan;0;0
41348;67625;567;0;0;0;0;.00nan;0;0
41348;83199;563;89;30;2;28;.933;3600000;0
41348;161047;567;42;25;4;21;.840;3527000;0
41349;163361;563;0;0;0;0;.00nan;0;0
41349;169493;580;86;28;1;27;.964;3876000;0
41349;72514;580;0;0;0;0;.00nan;0;0
41349;83199;563;97;34;1;33;.971;3900000;0
41350;6202;1918;0;0;0;0;.00nan;0;0
41350;6541;585;62;45;5;40;.889;3900000;0
41350;11687;585;0;0;0;0;.00nan;0;0
41350;179981;1918;46;28;5;23;.821;3900000;0
41351;185240;1928;59;27;2;25;.926;3542000;0
41351;67625;567;0;0;0;0;.00nan;0;0
41351;155769;1928;0;0;0;0;.00nan;0;0
41351;161047;567;67;19;1;18;.947;3600000;0
41352;11352;2277;78;39;2;37;.949;3900000;0
41352;-1;2287;52;17;2;15;.882;3900000;0
41352;-1;2277;0;0;0;0;.00nan;0;0
41352;89930;2287;0;0;0;0;.00nan;0;0
41353;161583;583;0;0;0;0;.00nan;0;0
41353;19954;1922;58;35;5;30;.857;3900000;0
41353;184159;583;66;40;5;35;.875;3900000;0
41353;155943;1922;0;0;0;0;.00nan;0;0
41354;6202;1918;0;0;0;0;.00nan;0;0
41354;179981;1918;35;26;5;21;.808;3600000;0
41354;185232;586;0;0;0;0;.00nan;0;0
41354;64923;586;50;15;2;13;.867;3600000;0
41355;6541;585;68;25;3;22;.880;3600000;0
41355;11352;2277;49;14;2;12;.857;2784000;0
41355;11687;585;0;0;0;0;.00nan;0;0
41355;-1;2277;24;13;4;9;.692;816000;0
41356;163361;563;0;0;0;0;.00nan;0;0
41356;195672;582;0;0;0;0;.00nan;0;0
41356;-1;582;66;36;3;33;.917;3570000;0
41356;83199;563;62;22;2;20;.909;3600000;0
41357;169493;580;32;32;6;26;.813;3169000;0
41357;67625;567;61;33;4;29;.879;3600000;0
41357;72514;580;48;0;0;0;.00nan;431000;0
41357;161047;567;0;0;0;0;.00nan;0;0
41358;6541;585;0;0;0;0;.00nan;0;0
41358;11687;585;87;34;2;32;.941;3600000;0
41358;169096;584;0;0;0;0;.00nan;0;0
41358;180990;584;63;31;3;28;.903;3546000;0
41359;6202;1918;92;27;1;26;.963;3600000;0
41359;195672;582;52;27;3;24;.889;3561000;0
41359;179981;1918;0;0;0;0;.00nan;0;0
41359;-1;582;0;0;0;0;.00nan;0;0
41360;185240;1928;0;0;0;0;.00nan;0;0
41360;-1;2287;92;52;3;49;.942;3569000;0
41360;89930;2287;0;0;0;0;.00nan;0;0
41360;155769;1928;93;33;1;32;.970;3600000;0
41361;11352;2277;74;30;2;28;.933;3565000;0
41361;-1;2287;62;13;1;12;.923;3600000;0
41361;-1;2277;0;0;0;0;.00nan;0;0
41361;89930;2287;0;0;0;0;.00nan;0;0
41362;163361;563;0;0;0;0;.00nan;0;0
41362;169096;584;76;37;3;34;.919;3600000;0
41362;180990;584;0;0;0;0;.00nan;0;0
41362;83199;563;67;38;4;34;.895;3566000;0
41363;6202;1918;0;0;0;0;.00nan;0;0
41363;169493;580;83;27;1;26;.963;3600000;0
41363;179981;1918;53;23;3;20;.870;3580000;0
41363;72514;580;0;0;0;0;.00nan;0;0
41364;11352;2277;57;32;4;28;.875;3600000;0
41364;19954;1922;0;0;0;0;.00nan;0;0
41364;-1;2277;0;0;0;0;.00nan;0;0
41364;155943;1922;59;16;1;15;.938;3600000;0
41365;169493;580;57;40;5;35;.875;3556000;0
41365;195672;582;0;0;0;0;.00nan;0;0
41365;-1;582;60;26;3;23;.885;3600000;0
41365;72514;580;0;0;0;0;.00nan;0;0
41366;169096;584;67;23;2;21;.913;3600000;0
41366;180990;584;0;0;0;0;.00nan;0;0
41366;-1;2287;66;51;6;45;.882;3600000;0
41366;89930;2287;0;0;0;0;.00nan;0;0
41367;185232;586;66;30;3;27;.900;3600000;0
41367;64923;586;0;0;0;0;.00nan;0;0
41367;67625;567;0;0;0;0;.00nan;0;0
41367;161047;567;78;36;2;34;.944;3600000;0
41368;6202;1918;0;0;0;0;.00nan;0;0
41368;19954;1922;63;22;3;19;.864;3797000;0
41368;179981;1918;57;32;4;28;.875;3797000;0
41368;155943;1922;0;0;0;0;.00nan;0;0
41369;6541;585;57;46;5;41;.891;3600000;0
41369;11687;585;0;0;0;0;.00nan;0;0
41369;185240;1928;76;24;1;23;.958;3600000;0
41369;155769;1928;0;0;0;0;.00nan;0;0
41370;163361;563;0;0;0;0;.00nan;0;0
41370;11352;2277;43;32;5;27;.844;3600000;0
41370;-1;2277;0;0;0;0;.00nan;0;0
41370;83199;563;51;15;2;13;.867;3600000;0
41371;185232;586;0;0;0;0;.00nan;0;0
41371;-1;2287;0;0;0;0;.00nan;0;0
41371;64923;586;32;24;5;19;.792;3600000;0
41371;89930;2287;82;28;1;27;.964;3600000;0
41372;169096;584;0;0;0;0;.00nan;0;0
41372;180990;584;90;32;2;30;.938;3600000;0
41372;67625;567;48;28;4;24;.857;3597000;0
41372;161047;567;0;0;0;0;.00nan;0;0
41373;6202;1918;25;15;5;10;.667;1185000;0
41373;195672;582;24;16;5;11;.688;3600000;0
41373;179981;1918;77;26;1;25;.962;2359000;0
41373;-1;582;0;0;0;0;.00nan;0;0
41374;6541;585;85;21;0;21;1.000;3368000;0
41374;11687;585;36;11;3;8;.727;532000;0
41374;185240;1928;0;0;0;0;.00nan;0;0
41374;155769;1928;85;39;3;36;.923;3900000;0
41375;161583;583;0;0;0;0;.00nan;0;0
41375;163361;563;94;26;1;25;.962;3900000;0
41375;184159;583;75;23;1;22;.957;3900000;0
41375;83199;563;0;0;0;0;.00nan;0;0
41376;6541;585;79;39;3;36;.923;3540000;0
41376;11687;585;0;0;0;0;.00nan;0;0
41376;185232;586;64;14;1;13;.929;3600000;0
41376;64923;586;0;0;0;0;.00nan;0;0
41377;169493;580;58;29;4;25;.862;3900000;0
41377;185232;586;0;0;0;0;.00nan;0;0
41377;64923;586;84;51;4;47;.922;3900000;0
41377;72514;580;0;0;0;0;.00nan;0;0
41378;11352;2277;67;25;2;23;.920;3538000;0
41378;185240;1928;100;26;0;26;1.000;3600000;0
41378;-1;2277;0;0;0;0;.00nan;0;0
41378;155769;1928;0;0;0;0;.00nan;0;0
41379;169493;580;0;0;0;0;.00nan;0;0
41379;-1;2287;73;28;2;26;.929;3600000;0
41379;72514;580;69;30;3;27;.900;3555000;0
41379;89930;2287;0;0;0;0;.00nan;0;0
41380;6541;585;0;0;0;0;.00nan;0;0
41380;11687;585;67;39;4;35;.897;3573000;0
41380;67625;567;0;0;0;0;.00nan;0;0
41380;161047;567;76;28;2;26;.929;3600000;0
41381;161583;583;0;0;0;0;.00nan;0;0
41381;184159;583;70;21;2;19;.905;3900000;0
41381;195672;582;0;0;0;0;.00nan;0;0
41381;-1;582;68;25;2;23;.920;3900000;0
41382;19954;1922;0;0;0;0;.00nan;0;0
41382;-1;2287;0;0;0;0;.00nan;0;0
41382;89930;2287;79;32;2;30;.938;3900000;0
41382;155943;1922;62;27;2;25;.926;3900000;0
41383;169096;584;0;0;0;0;.00nan;0;0
41383;185240;1928;70;45;5;40;.889;3600000;0
41383;180990;584;48;26;3;23;.885;3600000;0
41383;155769;1928;0;0;0;0;.00nan;0;0
41384;6202;1918;0;0;0;0;.00nan;0;0
41384;11352;2277;0;0;0;0;.00nan;0;0
41384;179981;1918;64;34;4;30;.882;3600000;0
41384;-1;2277;52;42;6;36;.857;3574000;0
41385;163361;563;0;0;0;0;.00nan;0;0
41385;185232;586;89;31;1;30;.968;3569000;0
41385;64923;586;0;0;0;0;.00nan;0;0
41385;83199;563;91;23;0;23;1.000;3600000;0
41386;19954;1922;82;29;1;28;.966;3600000;0
41386;67625;567;0;0;0;0;.00nan;0;0
41386;155943;1922;0;0;0;0;.00nan;0;0
41386;161047;567;55;21;3;18;.857;3580000;0
41387;169096;584;77;34;2;32;.941;3600000;0
41387;185240;1928;0;0;0;0;.00nan;0;0
41387;180990;584;0;0;0;0;.00nan;0;0
41387;155769;1928;49;27;4;23;.852;3593000;0
41388;161583;583;82;30;1;29;.967;3785000;0
41388;6202;1918;77;37;2;35;.946;3785000;0
41388;184159;583;0;0;0;0;.00nan;0;0
41388;179981;1918;0;0;0;0;.00nan;0;0
41389;163361;563;0;0;0;0;.00nan;0;0
41389;169493;580;63;19;2;17;.895;3900000;0
41389;72514;580;0;0;0;0;.00nan;0;0
41389;83199;563;79;25;2;23;.920;3900000;0
41390;6202;1918;0;0;0;0;.00nan;0;0
41390;179981;1918;77;32;2;30;.938;3600000;0
41390;185232;586;56;29;3;26;.897;3557000;0
41390;64923;586;0;0;0;0;.00nan;0;0
41391;169493;580;56;33;4;29;.879;3600000;0
41391;185232;586;0;0;0;0;.00nan;0;0
41391;64923;586;68;15;1;14;.933;3600000;0
41391;72514;580;0;0;0;0;.00nan;0;0
41392;6541;585;77;24;1;23;.958;3600000;0
41392;11352;2277;78;31;2;29;.935;3569000;0
41392;11687;585;0;0;0;0;.00nan;0;0
41392;-1;2277;0;0;0;0;.00nan;0;0
41393;195672;582;0;0;0;0;.00nan;0;0
41393;-1;2287;62;23;3;20;.870;3900000;0
41393;-1;582;84;38;3;35;.921;3900000;0
41393;89930;2287;0;0;0;0;.00nan;0;0
41394;19954;1922;75;25;2;23;.920;3600000;0
41394;169096;584;0;0;0;0;.00nan;0;0
41394;180990;584;77;33;3;30;.909;3544000;0
41394;155943;1922;0;0;0;0;.00nan;0;0
41395;161583;583;0;0;0;0;.00nan;0;0
41395;6202;1918;0;0;0;0;.00nan;0;0
41395;184159;583;79;25;2;23;.920;3600000;0
41395;179981;1918;63;29;3;26;.897;3600000;0
41396;163361;563;0;0;0;0;.00nan;0;0
41396;185240;1928;54;32;4;28;.875;3600000;0
41396;83199;563;95;29;1;28;.966;3600000;0
41396;155769;1928;0;0;0;0;.00nan;0;0
41397;195672;582;37;20;4;16;.800;2338000;0
41397;-1;582;57;6;0;6;1.000;1203000;0
41397;67625;567;0;0;0;0;.00nan;0;0
41397;161047;567;60;27;3;24;.889;3600000;0
41398;169096;584;63;39;4;35;.897;3600000;0
41398;185232;586;38;30;5;25;.833;3578000;0
41398;180990;584;0;0;0;0;.00nan;0;0
41398;64923;586;0;0;0;0;.00nan;0;0
41399;6202;1918;47;10;2;8;.800;3600000;0
41399;6541;585;0;0;0;0;.00nan;0;0
41399;11687;585;75;44;4;40;.909;3600000;0
41399;179981;1918;0;0;0;0;.00nan;0;0
41400;11352;2277;0;0;0;0;.00nan;0;0
41400;169493;580;50;23;4;19;.826;3900000;0
41400;-1;2277;69;40;4;36;.900;3900000;0
41400;72514;580;0;0;0;0;.00nan;0;0
41401;163361;563;100;38;0;38;1.000;3600000;0
41401;185240;1928;0;0;0;0;.00nan;0;0
41401;83199;563;0;0;0;0;.00nan;0;0
41401;155769;1928;56;15;1;14;.933;3549000;0
41402;161583;583;0;0;0;0;.00nan;0;0
41402;169096;584;0;0;0;0;.00nan;0;0
41402;184159;583;77;24;1;23;.958;3600000;0
41402;180990;584;61;37;4;33;.892;3600000;0
41403;19954;1922;72;30;2;28;.933;3549000;0
41403;169493;580;74;25;1;24;.960;3600000;0
41403;72514;580;0;0;0;0;.00nan;0;0
41403;155943;1922;0;0;0;0;.00nan;0;0
41404;6202;1918;0;0;0;0;.00nan;0;0
41404;11352;2277;46;29;5;24;.828;3736000;0
41404;179981;1918;62;28;4;24;.857;3736000;0
41404;-1;2277;0;0;0;0;.00nan;0;0
41405;7063;1928;80;26;1;25;.962;3600000;0
41405;19954;1922;0;0;0;0;.00nan;0;0
41405;185240;1928;0;0;0;0;.00nan;0;0
41405;155943;1922;62;38;4;34;.895;3600000;0
41406;163361;563;84;29;1;28;.966;3600000;0
41406;67625;567;0;0;0;0;.00nan;0;0
41406;83199;563;0;0;0;0;.00nan;0;0
41406;161047;567;73;34;2;32;.941;3558000;0
41407;6541;585;62;36;5;31;.861;3600000;0
41407;11687;585;0;0;0;0;.00nan;0;0
41407;-1;2287;0;0;0;0;.00nan;0;0
41407;89930;2287;70;26;2;24;.923;3600000;0
41408;169096;584;0;0;0;0;.00nan;0;0
41408;195672;582;0;0;0;0;.00nan;0;0
41408;180990;584;41;27;5;22;.815;3566000;0
41408;-1;582;41;27;4;23;.852;3600000;0
41409;11352;2277;87;46;2;44;.957;3600000;0
41409;185232;586;0;0;0;0;.00nan;0;0
41409;-1;2277;0;0;0;0;.00nan;0;0
41409;64923;586;74;33;3;30;.909;3599000;0
41410;161583;583;0;0;0;0;.00nan;0;0
41410;7063;1928;65;22;2;20;.909;3600000;0
41410;184159;583;74;31;3;28;.903;3596000;0
41410;185240;1928;0;0;0;0;.00nan;0;0
41411;169493;580;0;0;0;0;.00nan;0;0
41411;67625;567;0;0;0;0;.00nan;0;0
41411;72514;580;58;34;4;30;.882;3544000;0
41411;161047;567;51;25;3;22;.880;3600000;0
41412;6541;585;0;0;0;0;.00nan;0;0
41412;11687;585;61;38;4;34;.895;3600000;0
41412;19954;1922;86;18;0;18;1.000;3600000;0
41412;155943;1922;0;0;0;0;.00nan;0;0
41413;7063;1928;78;30;2;28;.933;3600000;0
41413;185232;586;96;18;0;18;1.000;3600000;0
41413;185240;1928;0;0;0;0;.00nan;0;0
41413;64923;586;0;0;0;0;.00nan;0;0
41414;6202;1918;0;0;0;0;.00nan;0;0
41414;169096;584;51;36;6;30;.833;3339000;0
41414;179981;1918;92;40;2;38;.950;3600000;0
41414;180990;584;48;0;0;0;.00nan;261000;0
41415;161583;583;96;18;0;18;1.000;3600000;0
41415;11352;2277;0;0;0;0;.00nan;0;0
41415;184159;583;0;0;0;0;.00nan;0;0
41415;-1;2277;85;46;4;42;.913;3600000;0
41416;163361;563;0;0;0;0;.00nan;0;0
41416;-1;2287;53;38;5;33;.868;3600000;0
41416;83199;563;54;17;2;15;.882;3600000;0
41416;89930;2287;0;0;0;0;.00nan;0;0
41417;19954;1922;78;34;3;31;.912;3600000;0
41417;185232;586;100;38;0;38;1.000;3600000;0
41417;64923;586;0;0;0;0;.00nan;0;0
41417;155943;1922;0;0;0;0;.00nan;0;0
41418;6541;585;64;31;3;28;.903;3900000;0
41418;163361;563;0;0;0;0;.00nan;0;0
41418;11687;585;0;0;0;0;.00nan;0;0
41418;83199;563;61;34;3;31;.912;3900000;0
41419;161583;583;99;34;1;33;.971;3600000;0
41419;184159;583;0;0;0;0;.00nan;0;0
41419;185232;586;55;33;4;29;.879;3599000;0
41419;64923;586;0;0;0;0;.00nan;0;0
41420;7063;1928;100;38;1;37;.974;3600000;0
41420;195672;582;0;0;0;0;.00nan;0;0
41420;185240;1928;0;0;0;0;.00nan;0;0
41420;-1;582;94;31;2;29;.935;3595000;0
41421;-1;2287;0;0;0;0;.00nan;0;0
41421;67625;567;0;0;0;0;.00nan;0;0
41421;89930;2287;98;50;2;48;.960;3900000;0
41421;161047;567;75;23;2;21;.913;3900000;0
41422;161583;583;0;0;0;0;.00nan;0;0
41422;184159;583;44;37;6;31;.838;3600000;0
41422;185232;586;0;0;0;0;.00nan;0;0
41422;64923;586;69;28;3;25;.893;3600000;0
41423;11352;2277;0;0;0;0;.00nan;0;0
41423;169096;584;0;0;0;0;.00nan;0;0
41423;190423;2277;62;37;3;34;.919;3891000;0
41423;180990;584;75;38;3;35;.921;3900000;0
41424;6202;1918;0;0;0;0;.00nan;0;0
41424;169493;580;30;22;5;17;.773;3565000;0
41424;179981;1918;66;31;3;28;.903;3600000;0
41424;72514;580;0;0;0;0;.00nan;0;0
41425;163361;563;28;22;5;17;.773;3600000;0
41425;19954;1922;68;22;2;20;.909;3600000;0
41425;83199;563;0;0;0;0;.00nan;0;0
41425;155943;1922;0;0;0;0;.00nan;0;0
41426;-1;2287;20;23;6;17;.739;3600000;0
41426;67625;567;75;26;2;24;.923;3600000;0
41426;89930;2287;0;0;0;0;.00nan;0;0
41426;161047;567;0;0;0;0;.00nan;0;0
41427;6541;585;87;30;2;28;.933;3600000;0
41427;11687;585;0;0;0;0;.00nan;0;0
41427;19954;1922;0;0;0;0;.00nan;0;0
41427;155943;1922;78;22;1;21;.955;3600000;0
41428;11352;2277;77;36;3;33;.917;3600000;0
41428;169096;584;36;19;4;15;.789;3538000;0
41428;190423;2277;0;0;0;0;.00nan;0;0
41428;180990;584;0;0;0;0;.00nan;0;0
41429;6202;1918;57;19;1;18;.947;3600000;0
41429;169493;580;0;0;0;0;.00nan;0;0
41429;179981;1918;0;0;0;0;.00nan;0;0
41429;72514;580;38;22;4;18;.818;3600000;0
41430;7063;1928;57;21;2;19;.905;3600000;0
41430;195672;582;78;50;5;45;.900;3600000;0
41430;185240;1928;0;0;0;0;.00nan;0;0
41430;-1;582;0;0;0;0;.00nan;0;0
41431;6202;1918;0;0;0;0;.00nan;0;0
41431;163361;563;0;0;0;0;.00nan;0;0
41431;179981;1918;91;20;0;20;1.000;3600000;0
41431;83199;563;73;29;3;26;.897;3600000;0
41432;19954;1922;0;0;0;0;.00nan;0;0
41432;67625;567;0;0;0;0;.00nan;0;0
41432;155943;1922;40;32;5;27;.844;3600000;0
41432;161047;567;75;27;2;25;.926;3600000;0
41433;163361;563;0;0;0;0;.00nan;0;0
41433;195672;582;0;0;0;0;.00nan;0;0
41433;-1;582;48;29;4;25;.862;3600000;0
41433;83199;563;77;26;1;25;.962;3600000;0
41434;185232;586;100;34;0;34;1.000;3600000;0
41434;-1;2287;0;0;0;0;.00nan;0;0
41434;64923;586;0;0;0;0;.00nan;0;0
41434;89930;2287;64;23;2;21;.913;3521000;0
41435;161583;583;58;23;3;20;.870;3574000;0
41435;184159;583;0;0;0;0;.00nan;0;0
41435;67625;567;0;0;0;0;.00nan;0;0
41435;161047;567;96;36;1;35;.972;3600000;0
41436;11352;2277;0;0;0;0;.00nan;0;0
41436;169493;580;81;26;2;24;.923;3900000;0
41436;190423;2277;72;27;2;25;.926;3900000;0
41436;72514;580;0;0;0;0;.00nan;0;0
41437;7063;1928;44;25;4;21;.840;3600000;0
41437;169096;584;0;0;0;0;.00nan;0;0
41437;185240;1928;0;0;0;0;.00nan;0;0
41437;180990;584;80;25;1;24;.960;3600000;0
41438;6541;585;76;38;3;35;.921;3900000;0
41438;11687;585;0;0;0;0;.00nan;0;0
41438;195672;582;83;34;3;31;.912;3900000;0
41438;-1;582;0;0;0;0;.00nan;0;0
41439;6202;1918;0;0;0;0;.00nan;0;0
41439;11352;2277;84;38;2;36;.947;3590000;0
41439;190423;2277;0;0;0;0;.00nan;0;0
41439;179981;1918;76;22;1;21;.955;3600000;0
41440;161583;583;0;0;0;0;.00nan;0;0
41440;184159;583;78;32;3;29;.906;3900000;0
41440;-1;2287;50;22;3;19;.864;3900000;0
41440;89930;2287;0;0;0;0;.00nan;0;0
41441;7063;1928;40;16;3;13;.813;3544000;0
41441;169096;584;68;25;2;23;.920;3600000;0
41441;185240;1928;0;0;0;0;.00nan;0;0
41441;180990;584;0;0;0;0;.00nan;0;0
41442;6202;1918;0;0;0;0;.00nan;0;0
41442;179981;1918;83;27;1;26;.963;3600000;0
41442;-1;2287;75;24;2;22;.917;3600000;0
41442;89930;2287;0;0;0;0;.00nan;0;0
41443;169096;584;0;0;0;0;.00nan;0;0
41443;195672;582;0;0;0;0;.00nan;0;0
41443;180990;584;38;20;4;16;.800;3559000;0
41443;-1;582;83;41;3;38;.927;3600000;0
41444;6202;1918;34;15;4;11;.733;3600000;0
41444;179981;1918;0;0;0;0;.00nan;0;0
41444;67625;567;0;0;0;0;.00nan;0;0
41444;161047;567;54;45;6;39;.867;3600000;0
41445;161583;583;100;37;1;36;.973;3600000;0
41445;6541;585;86;35;2;33;.943;3564000;0
41445;11687;585;0;0;0;0;.00nan;0;0
41445;184159;583;0;0;0;0;.00nan;0;0
41446;11352;2277;55;30;3;27;.900;3600000;0
41446;195672;582;78;34;2;32;.941;3600000;0
41446;190423;2277;0;0;0;0;.00nan;0;0
41446;-1;582;0;0;0;0;.00nan;0;0
41447;161583;583;0;0;0;0;.00nan;0;0
41447;184159;583;46;23;4;19;.826;3600000;0
41447;169493;580;0;0;0;0;.00nan;0;0
41447;72514;580;88;19;0;19;1.000;3600000;0
41448;185232;586;78;28;2;26;.929;3600000;0
41448;-1;2287;0;0;0;0;.00nan;0;0
41448;64923;586;0;0;0;0;.00nan;0;0
41448;89930;2287;52;21;3;18;.857;3558000;0
41449;19954;1922;42;10;2;8;.800;1383000;0
41449;178789;1922;28;20;5;15;.750;2217000;0
41449;67625;567;0;0;0;0;.00nan;0;0
41449;161047;567;58;26;3;23;.885;3600000;0
41450;6202;1918;0;0;0;0;.00nan;0;0
41450;7063;1928;79;12;0;12;1.000;3600000;0
41450;179981;1918;59;45;5;40;.889;3600000;0
41450;185240;1928;0;0;0;0;.00nan;0;0
41451;163361;563;0;0;0;0;.00nan;0;0
41451;169096;584;0;0;0;0;.00nan;0;0
41451;180990;584;73;28;2;26;.929;3872000;0
41451;83199;563;71;35;3;32;.914;3872000;0
41452;6541;585;0;0;0;0;.00nan;0;0
41452;11687;585;98;50;2;48;.960;3600000;0
41452;169096;584;76;20;1;19;.950;3600000;0
41452;180990;584;0;0;0;0;.00nan;0;0
41453;195672;582;89;20;0;20;1.000;3600000;0
41453;185232;586;0;0;0;0;.00nan;0;0
41453;-1;582;0;0;0;0;.00nan;0;0
41453;64923;586;50;29;4;25;.862;3600000;0
41454;7063;1928;68;27;3;24;.889;3600000;0
41454;185240;1928;0;0;0;0;.00nan;0;0
41454;-1;2287;46;29;4;25;.862;3568000;0
41454;89930;2287;0;0;0;0;.00nan;0;0
41455;161583;583;95;35;1;34;.971;3600000;0
41455;163361;563;27;37;7;30;.811;3600000;0
41455;184159;583;0;0;0;0;.00nan;0;0
41455;83199;563;0;0;0;0;.00nan;0;0
41456;11352;2277;29;31;6;25;.806;3033000;0
41456;19954;1922;0;0;0;0;.00nan;0;0
41456;178789;1922;55;28;4;24;.857;3600000;0
41456;190423;2277;38;7;2;5;.714;567000;0
41457;19954;1922;0;0;0;0;.00nan;0;0
41457;178789;1922;100;43;2;41;.953;3900000;0
41457;195672;582;63;25;2;23;.920;3900000;0
41457;-1;582;0;0;0;0;.00nan;0;0
41458;163361;563;0;0;0;0;.00nan;0;0
41458;169493;580;0;0;0;0;.00nan;0;0
41458;72514;580;94;35;1;34;.971;3600000;0
41458;83199;563;57;29;4;25;.862;3600000;0
41459;169096;584;0;0;0;0;.00nan;0;0
41459;180990;584;99;38;1;37;.974;3600000;0
41459;-1;2287;0;0;0;0;.00nan;0;0
41459;89930;2287;45;26;4;22;.846;3600000;0
41460;161583;583;53;21;2;19;.905;3600000;0
41460;184159;583;0;0;0;0;.00nan;0;0
41460;195672;582;0;0;0;0;.00nan;0;0
41460;-1;582;51;32;5;27;.844;3600000;0
41461;7063;1928;88;26;1;25;.962;3600000;0
41461;185240;1928;0;0;0;0;.00nan;0;0
41461;67625;567;0;0;0;0;.00nan;0;0
41461;161047;567;63;26;3;23;.885;3564000;0
41462;163361;563;0;0;0;0;.00nan;0;0
41462;195672;582;61;25;3;22;.880;3536000;0
41462;-1;582;0;0;0;0;.00nan;0;0
41462;83199;563;98;33;1;32;.970;3600000;0
41463;6541;585;75;44;4;40;.909;3600000;0
41463;11687;585;0;0;0;0;.00nan;0;0
41463;-1;2287;0;0;0;0;.00nan;0;0
41463;89930;2287;67;24;2;22;.917;3600000;0
41464;6202;1918;0;0;0;0;.00nan;0;0
41464;179981;1918;64;34;4;30;.882;3600000;0
41464;185232;586;100;25;0;25;1.000;3600000;0
41464;64923;586;0;0;0;0;.00nan;0;0
41465;161583;583;58;29;3;26;.897;3549000;0
41465;169096;584;56;20;2;18;.900;3600000;0
41465;184159;583;0;0;0;0;.00nan;0;0
41465;180990;584;0;0;0;0;.00nan;0;0
41466;7063;1928;62;20;2;18;.900;3600000;0
41466;169493;580;0;0;0;0;.00nan;0;0
41466;185240;1928;0;0;0;0;.00nan;0;0
41466;72514;580;63;35;4;31;.886;3525000;0
41467;163361;563;59;17;2;15;.882;3600000;0
41467;-1;2287;0;0;0;0;.00nan;0;0
41467;83199;563;0;0;0;0;.00nan;0;0
41467;89930;2287;54;25;3;22;.880;3544000;0
41468;6541;585;0;0;0;0;.00nan;0;0
41468;11687;585;82;44;3;41;.932;3900000;0
41468;67625;567;0;0;0;0;.00nan;0;0
41468;161047;567;63;24;3;21;.875;3900000;0
41469;19954;1922;0;0;0;0;.00nan;0;0
41469;178789;1922;72;35;4;31;.886;3600000;0
41469;185232;586;100;24;0;24;1.000;3600000;0
41469;64923;586;0;0;0;0;.00nan;0;0
41470;6202;1918;79;29;2;27;.931;3573000;0
41470;7063;1928;95;32;1;31;.969;3600000;0
41470;179981;1918;0;0;0;0;.00nan;0;0
41470;185240;1928;0;0;0;0;.00nan;0;0
41471;161583;583;0;0;0;0;.00nan;0;0
41471;11352;2277;0;0;0;0;.00nan;0;0
41471;184159;583;56;18;2;16;.889;3634000;0
41471;190423;2277;76;37;3;34;.919;3634000;0
41472;7063;1928;59;20;2;18;.900;3558000;0
41472;195672;582;79;21;1;20;.952;3600000;0
41472;185240;1928;0;0;0;0;.00nan;0;0
41472;-1;582;0;0;0;0;.00nan;0;0
41473;19954;1922;0;0;0;0;.00nan;0;0
41473;169493;580;59;26;3;23;.885;3600000;0
41473;178789;1922;34;26;5;21;.808;3522000;0
41473;72514;580;0;0;0;0;.00nan;0;0
41474;6541;585;99;38;1;37;.974;3600000;0
41474;163361;563;0;0;0;0;.00nan;0;0
41474;11687;585;0;0;0;0;.00nan;0;0
41474;83199;563;64;28;3;25;.893;3546000;0
41475;185232;586;55;23;3;20;.870;3854000;0
41475;64923;586;0;0;0;0;.00nan;0;0
41475;67625;567;0;0;0;0;.00nan;0;0
41475;161047;567;46;26;4;22;.846;3854000;0
41476;6541;585;0;0;0;0;.00nan;0;0
41476;11687;585;84;26;1;25;.962;3600000;0
41476;67625;567;0;0;0;0;.00nan;0;0
41476;161047;567;61;26;3;23;.885;3549000;0
41477;169493;580;0;0;0;0;.00nan;0;0
41477;195672;582;71;32;2;30;.938;3900000;0
41477;-1;582;0;0;0;0;.00nan;0;0
41477;72514;580;100;44;2;42;.955;3900000;0
41478;163361;563;0;0;0;0;.00nan;0;0
41478;-1;2287;0;0;0;0;.00nan;0;0
41478;83199;563;53;25;3;22;.880;3556000;0
41478;89930;2287;66;21;2;19;.905;3600000;0
41479;19954;1922;0;0;0;0;.00nan;0;0
41479;169096;584;0;0;0;0;.00nan;0;0
41479;178789;1922;78;46;3;43;.935;3851000;0
41479;180990;584;84;40;4;36;.900;3851000;0
41480;161583;583;46;33;6;27;.818;2947000;0
41480;184159;583;50;2;0;2;1.000;653000;0
41480;185232;586;0;0;0;0;.00nan;0;0
41480;64923;586;67;22;2;20;.909;3600000;0
41481;6202;1918;0;0;0;0;.00nan;0;0
41481;7063;1928;70;27;2;25;.926;3600000;0
41481;179981;1918;90;46;3;43;.935;3549000;0
41481;185240;1928;0;0;0;0;.00nan;0;0
41482;6541;585;100;35;0;35;1.000;3600000;0
41482;11687;585;0;0;0;0;.00nan;0;0
41482;195672;582;0;0;0;0;.00nan;0;0
41482;-1;582;28;28;6;22;.786;3600000;0
41483;6202;1918;50;27;4;23;.852;3600000;0
41483;179981;1918;0;0;0;0;.00nan;0;0
41483;-1;2287;0;0;0;0;.00nan;0;0
41483;89930;2287;41;28;5;23;.821;3542000;0
41484;161583;583;0;0;0;0;.00nan;0;0
41484;19954;1922;0;0;0;0;.00nan;0;0
41484;184159;583;53;20;3;17;.850;3900000;0
41484;178789;1922;86;40;3;37;.925;3900000;0
41485;163361;563;36;18;4;14;.778;3543000;0
41485;11352;2277;69;28;3;25;.893;3600000;0
41485;190423;2277;0;0;0;0;.00nan;0;0
41485;83199;563;0;0;0;0;.00nan;0;0
41486;7063;1928;66;21;1;20;.952;3600000;0
41486;169493;580;26;12;4;8;.667;410000;0
41486;185240;1928;0;0;0;0;.00nan;0;0
41486;72514;580;74;25;1;24;.960;3190000;0
41487;169493;580;46;41;6;35;.854;3518000;0
41487;185232;586;54;29;4;25;.862;3600000;0
41487;64923;586;0;0;0;0;.00nan;0;0
41487;72514;580;0;0;0;0;.00nan;0;0
41488;6541;585;52;28;4;24;.857;3563000;0
41488;11687;585;0;0;0;0;.00nan;0;0
41488;19954;1922;0;0;0;0;.00nan;0;0
41488;178789;1922;55;22;3;19;.864;3600000;0
41489;169096;584;0;0;0;0;.00nan;0;0
41489;180990;584;61;26;2;24;.923;3590000;0
41489;67625;567;0;0;0;0;.00nan;0;0
41489;161047;567;99;27;0;27;1.000;3600000;0
41490;169493;580;0;0;0;0;.00nan;0;0
41490;-1;2287;0;0;0;0;.00nan;0;0
41490;72514;580;59;30;4;26;.867;3600000;0
41490;89930;2287;61;34;3;31;.912;3600000;0
41491;19954;1922;0;0;0;0;.00nan;0;0
41491;178789;1922;89;37;2;35;.946;3544000;0
41491;-1;2287;0;0;0;0;.00nan;0;0
41491;89930;2287;76;23;1;22;.957;3600000;0
41492;195672;582;84;34;2;32;.941;3600000;0
41492;185232;586;63;16;1;15;.938;3600000;0
41492;-1;582;0;0;0;0;.00nan;0;0
41492;64923;586;0;0;0;0;.00nan;0;0
41493;6202;1918;0;0;0;0;.00nan;0;0
41493;6541;585;80;38;3;35;.921;3589000;0
41493;11687;585;0;0;0;0;.00nan;0;0
41493;179981;1918;78;29;2;27;.931;3600000;0
41494;161583;583;0;0;0;0;.00nan;0;0
41494;7063;1928;86;23;0;23;1.000;3900000;0
41494;184159;583;100;32;0;32;1.000;3900000;0
41494;185240;1928;0;0;0;0;.00nan;0;0
41495;163361;563;0;0;0;0;.00nan;0;0
41495;11352;2277;81;42;3;39;.929;3600000;0
41495;190423;2277;0;0;0;0;.00nan;0;0
41495;83199;563;69;24;1;23;.958;3600000;0
41496;6541;585;0;0;0;0;.00nan;0;0
41496;11352;2277;0;0;0;0;.00nan;0;0
41496;11687;585;100;33;0;33;1.000;3600000;0
41496;190423;2277;84;28;1;27;.964;3575000;0
41497;6202;1918;73;17;1;16;.941;3600000;0
41497;179981;1918;0;0;0;0;.00nan;0;0
41497;67625;567;0;0;0;0;.00nan;0;0
41497;161047;567;77;32;2;30;.938;3559000;0
41498;19954;1922;0;0;0;0;.00nan;0;0
41498;178789;1922;93;29;1;28;.966;3600000;0
41498;195672;582;0;0;0;0;.00nan;0;0
41498;-1;582;91;43;3;40;.930;3582000;0
41499;163361;563;60;28;3;25;.893;3576000;0
41499;185232;586;0;0;0;0;.00nan;0;0
41499;64923;586;76;23;1;22;.957;3600000;0
41499;83199;563;0;0;0;0;.00nan;0;0
41500;169096;584;0;0;0;0;.00nan;0;0
41500;169493;580;43;34;5;29;.853;3600000;0
41500;180990;584;83;25;1;24;.960;3600000;0
41500;72514;580;0;0;0;0;.00nan;0;0
41501;161583;583;0;0;0;0;.00nan;0;0
41501;7063;1928;100;28;0;28;1.000;3600000;0
41501;184159;583;38;30;5;25;.833;3600000;0
41501;185240;1928;0;0;0;0;.00nan;0;0
41502;169096;584;0;0;0;0;.00nan;0;0
41502;180990;584;81;28;1;27;.964;3600000;0
41502;-1;2287;0;0;0;0;.00nan;0;0
41502;89930;2287;55;31;4;27;.871;3600000;0
41503;169096;584;45;29;4;25;.862;3600000;0
41503;180990;584;0;0;0;0;.00nan;0;0
41503;67625;567;0;0;0;0;.00nan;0;0
41503;161047;567;91;29;1;28;.966;3600000;0
41504;161583;583;0;0;0;0;.00nan;0;0
41504;184159;583;58;22;2;20;.909;3585000;0
41504;169493;580;97;22;0;22;1.000;3600000;0
41504;72514;580;0;0;0;0;.00nan;0;0
41505;6202;1918;59;16;1;15;.938;1787000;0
41505;7063;1928;99;39;2;37;.949;3600000;0
41505;179981;1918;26;16;4;12;.750;1813000;0
41505;185240;1928;0;0;0;0;.00nan;0;0
41506;6541;585;51;3;0;3;1.000;389000;0
41506;7063;1928;0;0;0;0;.00nan;0;0
41506;11687;585;28;33;6;27;.818;3211000;0
41506;185240;1928;67;27;3;24;.889;3600000;0
41507;19954;1922;0;0;0;0;.00nan;0;0
41507;178789;1922;51;26;4;22;.846;3557000;0
41507;195672;582;0;0;0;0;.00nan;0;0
41507;-1;582;46;14;2;12;.857;3600000;0
41508;161583;583;54;6;0;6;1.000;464000;0
41508;184159;583;16;21;6;15;.714;3136000;0
41508;-1;2287;0;0;0;0;.00nan;0;0
41508;89930;2287;89;34;2;32;.941;3600000;0
41509;11352;2277;96;42;1;41;.976;3900000;0
41509;190423;2277;0;0;0;0;.00nan;0;0
41509;185232;586;78;24;1;23;.958;3900000;0
41509;64923;586;0;0;0;0;.00nan;0;0
41510;163361;563;100;40;0;40;1.000;3600000;0
41510;14191;563;0;0;0;0;.00nan;0;0
41510;169493;580;43;21;3;18;.857;3600000;0
41510;72514;580;0;0;0;0;.00nan;0;0
41511;19954;1922;0;0;0;0;.00nan;0;0
41511;178789;1922;48;36;6;30;.833;3552000;0
41511;-1;2287;0;0;0;0;.00nan;0;0
41511;89930;2287;59;29;4;25;.862;3600000;0
41512;161583;583;52;26;4;22;.846;3576000;0
41512;184159;583;0;0;0;0;.00nan;0;0
41512;67625;567;0;0;0;0;.00nan;0;0
41512;161047;567;70;31;3;28;.903;3600000;0
41513;169096;584;0;0;0;0;.00nan;0;0
41513;185232;586;0;0;0;0;.00nan;0;0
41513;180990;584;83;41;3;38;.927;3900000;0
41513;64923;586;65;26;3;23;.885;3900000;0
41514;6541;585;83;30;2;28;.933;3621000;0
41514;11687;585;0;0;0;0;.00nan;0;0
41514;169493;580;0;0;0;0;.00nan;0;0
41514;72514;580;79;21;1;20;.952;3621000;0
41515;7063;1928;82;31;1;30;.968;3874000;0
41515;163361;563;71;25;2;23;.920;3874000;0
41515;14191;563;0;0;0;0;.00nan;0;0
41515;185240;1928;0;0;0;0;.00nan;0;0
41516;11352;2277;74;32;2;30;.938;3600000;0
41516;169493;580;55;23;3;20;.870;3544000;0
41516;190423;2277;0;0;0;0;.00nan;0;0
41516;72514;580;0;0;0;0;.00nan;0;0
41517;161583;583;0;0;0;0;.00nan;0;0
41517;6202;1918;58;27;3;24;.889;3568000;0
41517;184159;583;65;25;2;23;.920;3600000;0
41517;179981;1918;0;0;0;0;.00nan;0;0
41518;195672;582;100;38;1;37;.974;3600000;0
41518;-1;2287;57;9;1;8;.889;1521000;0
41518;-1;582;0;0;0;0;.00nan;0;0
41518;89930;2287;39;31;5;26;.839;2079000;0
41519;11352;2277;45;37;6;31;.838;2885000;0
41519;190423;2277;39;1;1;0;.000;715000;0
41519;67625;567;72;41;4;37;.902;3600000;0
41519;161047;567;0;0;0;0;.00nan;0;0
41520;6541;585;45;44;7;37;.841;3164000;0
41520;11687;585;51;5;1;4;.800;436000;0
41520;169096;584;0;0;0;0;.00nan;0;0
41520;180990;584;42;16;3;13;.813;3600000;0
41521;6202;1918;0;0;0;0;.00nan;0;0
41521;19954;1922;51;9;1;8;.889;1012000;0
41521;178789;1922;36;30;6;24;.800;2588000;0
41521;179981;1918;77;35;2;33;.943;3600000;0
41522;161583;583;0;0;0;0;.00nan;0;0
41522;184159;583;42;36;6;30;.833;3600000;0
41522;169493;580;61;26;3;23;.885;3600000;0
41522;72514;580;0;0;0;0;.00nan;0;0
41523;7063;1928;36;25;5;20;.800;3600000;0
41523;185232;586;94;39;3;36;.923;3600000;0
41523;185240;1928;0;0;0;0;.00nan;0;0
41523;64923;586;0;0;0;0;.00nan;0;0
41524;6202;1918;82;28;2;26;.929;3600000;0
41524;195672;582;0;0;0;0;.00nan;0;0
41524;179981;1918;0;0;0;0;.00nan;0;0
41524;-1;582;65;35;3;32;.914;3561000;0
41525;-1;2287;0;0;0;0;.00nan;0;0
41525;67625;567;0;0;0;0;.00nan;0;0
41525;89930;2287;64;23;3;20;.870;3600000;0
41525;161047;567;70;40;5;35;.875;3535000;0
41526;163361;563;0;0;0;0;.00nan;0;0
41526;19954;1922;0;0;0;0;.00nan;0;0
41526;178789;1922;68;31;3;28;.903;3552000;0
41526;83199;563;69;22;1;21;.955;3600000;0
41527;6541;585;0;0;0;0;.00nan;0;0
41527;11352;2277;0;0;0;0;.00nan;0;0
41527;11687;585;66;24;3;21;.875;3600000;0
41527;190423;2277;66;22;2;20;.909;3600000;0
41528;7063;1928;0;0;0;0;.00nan;0;0
41528;185232;586;0;0;0;0;.00nan;0;0
41528;185240;1928;34;25;5;20;.800;3595000;0
41528;64923;586;80;44;4;40;.909;3600000;0
41529;6202;1918;0;0;0;0;.00nan;0;0
41529;163361;563;0;0;0;0;.00nan;0;0
41529;179981;1918;65;38;4;34;.895;3600000;0
41529;83199;563;47;31;5;26;.839;3558000;0
41530;163361;563;75;28;2;26;.929;3553000;0
41530;67625;567;0;0;0;0;.00nan;0;0
41530;83199;563;0;0;0;0;.00nan;0;0
41530;161047;567;70;18;1;17;.944;3600000;0
41531;6541;585;52;23;3;20;.870;3575000;0
41531;11687;585;0;0;0;0;.00nan;0;0
41531;185232;586;98;44;2;42;.955;3600000;0
41531;64923;586;0;0;0;0;.00nan;0;0
41532;11352;2277;47;38;6;32;.842;2621000;0
41532;19954;1922;0;0;0;0;.00nan;0;0
41532;178789;1922;100;21;0;21;1.000;3600000;0
41532;190423;2277;56;5;0;5;1.000;979000;0
41533;169096;584;0;0;0;0;.00nan;0;0
41533;169493;580;0;0;0;0;.00nan;0;0
41533;180990;584;72;33;3;30;.909;3600000;0
41533;72514;580;53;32;4;28;.875;3593000;0
41534;6541;585;0;0;0;0;.00nan;0;0
41534;11687;585;64;36;4;32;.889;3566000;0
41534;-1;2287;0;0;0;0;.00nan;0;0
41534;89930;2287;61;21;2;19;.905;3600000;0
41535;11352;2277;62;43;5;38;.884;3668000;0
41535;195672;582;66;30;4;26;.867;3668000;0
41535;190423;2277;0;0;0;0;.00nan;0;0
41535;-1;582;0;0;0;0;.00nan;0;0
41536;185232;586;42;33;5;28;.848;3600000;0
41536;64923;586;0;0;0;0;.00nan;0;0
41536;67625;567;0;0;0;0;.00nan;0;0
41536;161047;567;89;27;1;26;.963;3600000;0
41537;19954;1922;0;0;0;0;.00nan;0;0
41537;169096;584;72;20;1;19;.950;3900000;0
41537;178789;1922;95;40;1;39;.975;3900000;0
41537;180990;584;0;0;0;0;.00nan;0;0
41538;6541;585;53;30;4;26;.867;3550000;0
41538;11687;585;0;0;0;0;.00nan;0;0
41538;169493;580;66;30;2;28;.933;3600000;0
41538;72514;580;0;0;0;0;.00nan;0;0
41539;195672;582;0;0;0;0;.00nan;0;0
41539;185232;586;0;0;0;0;.00nan;0;0
41539;-1;582;67;35;3;32;.914;3900000;0
41539;64923;586;84;32;3;29;.906;3900000;0
41540;161583;583;0;0;0;0;.00nan;0;0
41540;19954;1922;0;0;0;0;.00nan;0;0
41540;184159;583;72;28;2;26;.929;3570000;0
41540;178789;1922;80;27;1;26;.963;3600000;0
41541;6202;1918;12;31;8;23;.742;3153000;0
41541;179981;1918;42;3;1;2;.667;447000;0
41541;67625;567;57;35;4;31;.886;3600000;0
41541;161047;567;0;0;0;0;.00nan;0;0
41542;7063;1928;73;18;1;17;.944;3600000;0
41542;11352;2277;0;0;0;0;.00nan;0;0
41542;190423;2277;75;37;3;34;.919;3600000;0
41542;185240;1928;0;0;0;0;.00nan;0;0
41543;163361;563;0;0;0;0;.00nan;0;0
41543;-1;2287;0;0;0;0;.00nan;0;0
41543;83199;563;65;23;2;21;.913;3600000;0
41543;89930;2287;68;31;3;28;.903;3543000;0
41544;161583;583;0;0;0;0;.00nan;0;0
41544;163361;563;0;0;0;0;.00nan;0;0
41544;184159;583;44;30;5;25;.833;3600000;0
41544;83199;563;75;27;2;25;.926;3600000;0
41545;161583;583;67;24;2;22;.917;3600000;0
41545;11352;2277;0;0;0;0;.00nan;0;0
41545;184159;583;0;0;0;0;.00nan;0;0
41545;190423;2277;67;37;4;33;.892;3564000;0
41546;11352;2277;67;50;5;45;.900;3600000;0
41546;190423;2277;0;0;0;0;.00nan;0;0
41546;185232;586;87;24;1;23;.958;3600000;0
41546;64923;586;0;0;0;0;.00nan;0;0
41547;6202;1918;51;2;0;2;1.000;764000;0
41547;6541;585;68;44;5;39;.886;3600000;0
41547;11687;585;0;0;0;0;.00nan;0;0
41547;179981;1918;14;24;7;17;.708;2813000;0
41548;11352;2277;0;0;0;0;.00nan;0;0
41548;19954;1922;0;0;0;0;.00nan;0;0
41548;178789;1922;73;20;1;19;.950;3600000;0
41548;190423;2277;73;30;2;28;.933;3544000;0
41549;169493;580;73;32;3;29;.906;3900000;0
41549;67625;567;0;0;0;0;.00nan;0;0
41549;72514;580;0;0;0;0;.00nan;0;0
41549;161047;567;80;36;3;33;.917;3900000;0
41550;7063;1928;73;28;3;25;.893;3600000;0
41550;185240;1928;0;0;0;0;.00nan;0;0
41550;-1;2287;0;0;0;0;.00nan;0;0
41550;89930;2287;52;35;5;30;.857;3533000;0
41551;163361;563;0;0;0;0;.00nan;0;0
41551;195672;582;41;24;4;20;.833;3600000;0
41551;-1;582;0;0;0;0;.00nan;0;0
41551;83199;563;99;41;2;39;.951;3600000;0
41552;6541;585;0;0;0;0;.00nan;0;0
41552;11687;585;54;19;2;17;.895;3586000;0
41552;195672;582;0;0;0;0;.00nan;0;0
41552;-1;582;85;26;1;25;.962;3600000;0
41553;19954;1922;0;0;0;0;.00nan;0;0
41553;178789;1922;75;33;3;30;.909;3600000;0
41553;185232;586;26;20;5;15;.750;3600000;0
41553;64923;586;0;0;0;0;.00nan;0;0
41554;163361;563;74;23;1;22;.957;3600000;0
41554;169096;584;0;0;0;0;.00nan;0;0
41554;180990;584;27;26;6;20;.769;3600000;0
41554;83199;563;0;0;0;0;.00nan;0;0
41555;6202;1918;0;0;0;0;.00nan;0;0
41555;169493;580;76;40;3;37;.925;3546000;0
41555;179981;1918;71;23;1;22;.957;3600000;0
41555;72514;580;0;0;0;0;.00nan;0;0
41556;161583;583;0;0;0;0;.00nan;0;0
41556;184159;583;74;25;2;23;.920;3590000;0
41556;67625;567;0;0;0;0;.00nan;0;0
41556;161047;567;81;23;1;22;.957;3600000;0
41557;195672;582;59;29;4;25;.862;3600000;0
41557;-1;582;0;0;0;0;.00nan;0;0
41557;67625;567;0;0;0;0;.00nan;0;0
41557;161047;567;100;29;0;29;1.000;3600000;0
41558;6202;1918;0;0;0;0;.00nan;0;0
41558;19954;1922;69;26;2;24;.923;3528000;0
41558;178789;1922;0;0;0;0;.00nan;0;0
41558;179981;1918;100;37;0;37;1.000;3600000;0
41559;7063;1928;55;10;1;9;.900;3900000;0
41559;11352;2277;100;41;1;40;.976;3900000;0
41559;190423;2277;0;0;0;0;.00nan;0;0
41559;185240;1928;0;0;0;0;.00nan;0;0
41560;161583;583;0;0;0;0;.00nan;0;0
41560;6541;585;92;41;2;39;.951;3900000;0
41560;11687;585;0;0;0;0;.00nan;0;0
41560;184159;583;80;31;2;29;.935;3900000;0
41561;11352;2277;51;2;0;2;1.000;818000;0
41561;190423;2277;46;39;6;33;.846;3082000;0
41561;-1;2287;44;40;6;34;.850;3900000;0
41561;89930;2287;0;0;0;0;.00nan;0;0
41562;7063;1928;61;27;3;24;.889;3613000;0
41562;185240;1928;0;0;0;0;.00nan;0;0
41562;67625;567;0;0;0;0;.00nan;0;0
41562;161047;567;94;33;2;31;.939;3613000;0
41563;6202;1918;0;0;0;0;.00nan;0;0
41563;169096;584;59;12;1;11;.917;1047000;0
41563;179981;1918;84;36;2;34;.944;3600000;0
41563;180990;584;35;29;6;23;.793;2553000;0
41564;169493;580;0;0;0;0;.00nan;0;0
41564;195672;582;0;0;0;0;.00nan;0;0
41564;-1;582;53;38;5;33;.868;3600000;0
41564;72514;580;69;21;2;19;.905;3600000;0
41565;163361;563;0;0;0;0;.00nan;0;0
41565;185232;586;65;34;4;30;.882;3600000;0
41565;64923;586;0;0;0;0;.00nan;0;0
41565;83199;563;88;31;2;29;.935;3600000;0
41567;14191;563;0;0;0;0;.00nan;0;0
41567;67625;567;0;0;0;0;.00nan;0;0
41567;83199;563;70;38;3;35;.921;3530000;0
41567;143879;567;79;26;1;25;.962;3600000;0
41569;170144;584;85;31;1;30;.968;3600000;0
41569;185240;1928;44;17;3;14;.824;3600000;0
41569;180990;584;0;0;0;0;.00nan;0;0
41569;155769;1928;0;0;0;0;.00nan;0;0
41571;6541;585;100;64;4;60;.938;3674000;0
41571;11687;585;0;0;0;0;.00nan;0;0
41571;19954;1922;0;0;0;0;.00nan;0;0
41571;155943;1922;47;32;5;27;.844;3674000;0
41573;169493;580;66;23;2;21;.913;3600000;0
41573;-1;2287;0;0;0;0;.00nan;0;0
41573;72514;580;0;0;0;0;.00nan;0;0
41573;89930;2287;59;25;3;22;.880;3566000;0
41575;184159;583;91;41;2;39;.951;3600000;0
41575;195672;582;0;0;0;0;.00nan;0;0
41575;-1;583;0;0;0;0;.00nan;0;0
41575;-1;582;39;21;4;17;.810;3553000;0
41577;6202;1918;0;0;0;0;.00nan;0;0
41577;11352;2277;50;1;0;1;1.000;241000;0
41577;179981;1918;93;34;1;33;.971;3600000;0
41577;-1;2277;21;24;6;18;.750;3359000;0
41579;195672;582;68;25;2;23;.920;3892000;0
41579;-1;2287;86;35;2;33;.943;3900000;0
41579;-1;582;0;0;0;0;.00nan;0;0
41579;89930;2287;0;0;0;0;.00nan;0;0
41581;19954;1922;69;16;1;15;.938;3600000;0
41581;184159;583;61;19;2;17;.895;1370000;0
41581;-1;583;4;20;7;13;.650;2230000;0
41581;155943;1922;0;0;0;0;.00nan;0;0
41583;185240;1928;0;0;0;0;.00nan;0;0
41583;67625;567;60;35;3;32;.914;3516000;0
41583;143879;567;0;0;0;0;.00nan;0;0
41583;155769;1928;73;25;1;24;.960;3600000;0
41585;6541;585;0;0;0;0;.00nan;0;0
41585;11687;585;98;38;2;36;.947;3600000;0
41585;169493;580;0;0;0;0;.00nan;0;0
41585;72514;580;47;21;3;18;.857;3600000;0
41587;6202;1918;100;20;0;20;1.000;3600000;0
41587;170144;584;0;0;0;0;.00nan;0;0
41587;179981;1918;0;0;0;0;.00nan;0;0
41587;180990;584;80;43;4;39;.907;3600000;0
41589;4504;586;0;0;0;0;.00nan;0;0
41589;14191;563;0;0;0;0;.00nan;0;0
41589;64923;586;100;28;0;28;1.000;3600000;0
41589;83199;563;61;29;4;25;.862;3600000;0
41591;4504;586;0;0;0;0;.00nan;0;0
41591;185240;1928;56;35;4;31;.886;3575000;0
41591;64923;586;50;18;3;15;.833;3600000;0
41591;155769;1928;0;0;0;0;.00nan;0;0
41593;6202;1918;53;22;3;19;.864;3600000;0
41593;179981;1918;0;0;0;0;.00nan;0;0
41593;67625;567;34;25;5;20;.800;3548000;0
41593;143879;567;0;0;0;0;.00nan;0;0
41595;9597;584;0;0;0;0;.00nan;0;0
41595;180990;584;81;28;2;26;.929;3600000;0
41595;-1;2287;59;34;4;30;.882;3552000;0
41595;89930;2287;0;0;0;0;.00nan;0;0
41597;19954;1922;0;0;0;0;.00nan;0;0
41597;195672;582;0;0;0;0;.00nan;0;0
41597;-1;582;51;22;3;19;.864;3600000;0
41597;155943;1922;91;37;2;35;.946;3600000;0
41599;11352;2277;80;23;1;22;.957;3600000;0
41599;184159;583;97;42;2;40;.952;3572000;0
41599;-1;583;0;0;0;0;.00nan;0;0
41599;-1;2277;0;0;0;0;.00nan;0;0
41601;14191;563;0;0;0;0;.00nan;0;0
41601;169493;580;61;29;3;26;.897;3600000;0
41601;72514;580;0;0;0;0;.00nan;0;0
41601;83199;563;45;26;4;22;.846;3553000;0
41603;4504;586;63;23;2;21;.913;3600000;0
41603;11352;2277;0;0;0;0;.00nan;0;0
41603;-1;2277;51;29;4;25;.862;3555000;0
41603;64923;586;0;0;0;0;.00nan;0;0
41605;6541;585;68;39;4;35;.897;3600000;0
41605;11687;585;0;0;0;0;.00nan;0;0
41605;19954;1922;65;19;1;18;.947;3600000;0
41605;155943;1922;0;0;0;0;.00nan;0;0
41607;14191;563;53;29;4;25;.862;3551000;0
41607;185240;1928;0;0;0;0;.00nan;0;0
41607;83199;563;0;0;0;0;.00nan;0;0
41607;155769;1928;78;34;2;32;.941;3600000;0
41609;195672;582;60;24;3;21;.875;3600000;0
41609;-1;2287;0;0;0;0;.00nan;0;0
41609;-1;582;0;0;0;0;.00nan;0;0
41609;89930;2287;82;26;1;25;.962;3600000;0
41611;169493;580;0;0;0;0;.00nan;0;0
41611;67625;567;0;0;0;0;.00nan;0;0
41611;72514;580;65;25;2;23;.920;3600000;0
41611;143879;567;63;30;3;27;.900;3549000;0
41613;9597;584;0;0;0;0;.00nan;0;0
41613;184159;583;0;0;0;0;.00nan;0;0
41613;180990;584;71;20;1;19;.950;3600000;0
41613;-1;583;60;23;2;21;.913;3561000;0
41615;184159;583;63;22;2;20;.909;3600000;0
41615;195672;582;0;0;0;0;.00nan;0;0
41615;-1;583;0;0;0;0;.00nan;0;0
41615;-1;582;52;26;3;23;.885;3581000;0
41617;6202;1918;0;0;0;0;.00nan;0;0
41617;169493;580;66;31;4;27;.871;3870000;0
41617;179981;1918;57;23;3;20;.870;3870000;0
41617;72514;580;0;0;0;0;.00nan;0;0
41619;11352;2277;61;44;5;39;.886;3543000;0
41619;185232;586;43;24;4;20;.833;3600000;0
41619;-1;2277;0;0;0;0;.00nan;0;0
41619;64923;586;0;0;0;0;.00nan;0;0
41621;14191;563;0;0;0;0;.00nan;0;0
41621;67625;567;49;23;3;20;.870;3900000;0
41621;83199;563;66;31;3;28;.903;3900000;0
41621;143879;567;0;0;0;0;.00nan;0;0
41623;185240;1928;53;18;2;16;.889;3600000;0
41623;-1;2287;0;0;0;0;.00nan;0;0
41623;89930;2287;100;31;0;31;1.000;3600000;0
41623;155769;1928;0;0;0;0;.00nan;0;0
41625;6541;585;57;43;6;37;.860;3600000;0
41625;11687;585;0;0;0;0;.00nan;0;0
41625;19954;1922;0;0;0;0;.00nan;0;0
41625;155943;1922;73;31;3;28;.903;3600000;0
41627;6202;1918;52;30;4;26;.867;3600000;0
41627;14191;563;30;24;5;19;.792;3596000;0
41627;179981;1918;0;0;0;0;.00nan;0;0
41627;83199;563;0;0;0;0;.00nan;0;0
41629;9597;584;0;0;0;0;.00nan;0;0
41629;185232;586;0;0;0;0;.00nan;0;0
41629;180990;584;67;33;4;29;.879;3600000;0
41629;64923;586;19;21;5;16;.762;3550000;0
41631;184159;583;0;0;0;0;.00nan;0;0
41631;195672;582;81;23;1;22;.957;3600000;0
41631;-1;583;48;25;3;22;.880;3600000;0
41631;-1;582;0;0;0;0;.00nan;0;0
41633;185240;1928;0;0;0;0;.00nan;0;0
41633;67625;567;0;0;0;0;.00nan;0;0
41633;143879;567;71;23;1;22;.957;3900000;0
41633;155769;1928;84;28;1;27;.964;3900000;0
41635;6541;585;0;0;0;0;.00nan;0;0
41635;11352;2277;0;0;0;0;.00nan;0;0
41635;11687;585;74;22;1;21;.955;3600000;0
41635;-1;2277;70;36;3;33;.917;3551000;0
41637;19954;1922;55;35;4;31;.886;3541000;0
41637;169493;580;0;0;0;0;.00nan;0;0
41637;72514;580;74;21;2;19;.905;3600000;0
41637;155943;1922;0;0;0;0;.00nan;0;0
41639;19954;1922;0;0;0;0;.00nan;0;0
41639;185232;586;100;19;0;19;1.000;3600000;0
41639;64923;586;0;0;0;0;.00nan;0;0
41639;155943;1922;57;21;2;19;.905;3545000;0
41641;6541;585;74;22;1;21;.955;3600000;0
41641;11352;2277;32;33;6;27;.818;3351000;0
41641;11687;585;0;0;0;0;.00nan;0;0
41641;-1;2277;46;4;1;3;.750;249000;0
41643;14191;563;0;0;0;0;.00nan;0;0
41643;169493;580;32;25;5;20;.800;3539000;0
41643;72514;580;0;0;0;0;.00nan;0;0
41643;83199;563;72;30;3;27;.900;3600000;0
41645;195672;582;60;34;4;30;.882;3600000;0
41645;-1;2287;0;0;0;0;.00nan;0;0
41645;-1;582;0;0;0;0;.00nan;0;0
41645;89930;2287;68;28;2;26;.929;3600000;0
41647;9597;584;0;0;0;0;.00nan;0;0
41647;185240;1928;78;29;2;27;.931;3600000;0
41647;180990;584;46;24;4;20;.833;3531000;0
41647;155769;1928;0;0;0;0;.00nan;0;0
41649;6202;1918;0;0;0;0;.00nan;0;0
41649;179981;1918;59;19;2;17;.895;3600000;0
41649;67625;567;2;23;7;16;.696;2541000;0
41649;143879;567;41;10;2;8;.800;1059000;0
1178;161583;583;0;0;0;0;.00nan;0;0
1178;169096;584;0;0;0;0;.00nan;0;0
1178;184159;583;63;41;5;36;.878;3600000;0
1178;180990;584;89;30;1;29;.967;3600000;0
1179;169493;580;74;21;1;20;.952;3600000;0
1179;-1;2287;0;0;0;0;.00nan;0;0
1179;72514;580;0;0;0;0;.00nan;0;0
1179;89930;2287;68;30;3;27;.900;3565000;0
1180;161583;583;0;0;0;0;.00nan;0;0
1180;169096;584;0;0;0;0;.00nan;0;0
1180;184159;583;67;34;2;32;.941;4260000;0
1180;180990;584;72;34;3;31;.912;4260000;0
1181;169493;580;77;42;3;39;.929;4986000;0
1181;-1;2287;0;0;0;0;.00nan;0;0
1181;72514;580;0;0;0;0;.00nan;0;0
1181;89930;2287;81;33;2;31;.939;4986000;0
1329;161583;583;0;0;0;0;.00nan;0;0
1329;169096;584;0;0;0;0;.00nan;0;0
1329;184159;583;47;20;3;17;.850;3600000;0
1329;180990;584;38;27;5;22;.815;3554000;0
1330;169493;580;46;36;5;31;.861;5155000;0
1330;-1;2287;0;0;0;0;.00nan;0;0
1330;72514;580;0;0;0;0;.00nan;0;0
1330;89930;2287;68;43;4;39;.907;5155000;0
1428;161583;583;0;0;0;0;.00nan;0;0
1428;184159;583;94;36;2;34;.944;3600000;0
1428;67625;567;0;0;0;0;.00nan;0;0
1428;161047;567;47;18;3;15;.833;3547000;0
1429;7063;1928;65;25;2;23;.920;3600000;0
1429;185232;586;32;24;5;19;.792;3600000;0
1429;185240;1928;0;0;0;0;.00nan;0;0
1429;64923;586;0;0;0;0;.00nan;0;0
1430;163361;563;0;0;0;0;.00nan;0;0
1430;19954;1922;0;0;0;0;.00nan;0;0
1430;178789;1922;92;28;1;27;.964;3600000;0
1430;83199;563;56;28;3;25;.893;3527000;0
1431;6202;1918;60;10;0;10;1.000;1072000;0
1431;179981;1918;18;23;6;17;.739;2528000;0
1431;-1;2287;0;0;0;0;.00nan;0;0
1431;89930;2287;70;24;2;22;.917;3600000;0
1432;161583;583;0;0;0;0;.00nan;0;0
1432;184159;583;87;35;1;34;.971;3600000;0
1432;67625;567;0;0;0;0;.00nan;0;0
1432;161047;567;56;20;2;18;.900;3543000;0
1433;7063;1928;56;35;5;30;.857;3600000;0
1433;185232;586;68;18;1;17;.944;3600000;0
1433;185240;1928;0;0;0;0;.00nan;0;0
1433;64923;586;0;0;0;0;.00nan;0;0
1434;163361;563;0;0;0;0;.00nan;0;0
1434;19954;1922;0;0;0;0;.00nan;0;0
1434;178789;1922;89;31;1;30;.968;3600000;0
1434;83199;563;56;22;2;20;.909;3556000;0
1435;6202;1918;0;0;0;0;.00nan;0;0
1435;179981;1918;74;23;2;21;.913;3600000;0
1435;-1;2287;0;0;0;0;.00nan;0;0
1435;89930;2287;57;43;5;38;.884;3600000;0
1436;161583;583;0;0;0;0;.00nan;0;0
1436;184159;583;84;32;1;31;.969;3600000;0
1436;67625;567;0;0;0;0;.00nan;0;0
1436;161047;567;34;27;6;21;.778;3600000;0
1437;7063;1928;62;37;4;33;.892;4007000;0
1437;185232;586;72;29;3;26;.897;4007000;0
1437;185240;1928;0;0;0;0;.00nan;0;0
1437;64923;586;0;0;0;0;.00nan;0;0
1438;163361;563;0;0;0;0;.00nan;0;0
1438;19954;1922;0;0;0;0;.00nan;0;0
1438;178789;1922;73;32;3;29;.906;3600000;0
1438;83199;563;57;33;4;29;.879;3566000;0
1439;6202;1918;39;8;2;6;.750;668000;0
1439;179981;1918;23;25;6;19;.760;2932000;0
1439;-1;2287;0;0;0;0;.00nan;0;0
1439;89930;2287;45;23;4;19;.826;3600000;0
1610;7063;1928;80;21;1;20;.952;3981000;0
1610;185232;586;70;29;2;27;.931;3981000;0
1610;185240;1928;0;0;0;0;.00nan;0;0
1610;64923;586;0;0;0;0;.00nan;0;0
1611;6202;1918;0;0;0;0;.00nan;0;0
1611;179981;1918;64;29;3;26;.897;3561000;0
1611;-1;2287;0;0;0;0;.00nan;0;0
1611;89930;2287;81;27;1;26;.963;3600000;0
1645;7063;1928;82;29;2;27;.931;3511000;0
1645;185232;586;100;25;0;25;1.000;3600000;0
1645;185240;1928;0;0;0;0;.00nan;0;0
1645;64923;586;0;0;0;0;.00nan;0;0
1784;161583;583;0;0;0;0;.00nan;0;0
1784;184159;583;52;24;3;21;.875;3573000;0
1784;185232;586;78;28;2;26;.929;3600000;0
1784;64923;586;0;0;0;0;.00nan;0;0
1785;19954;1922;0;0;0;0;.00nan;0;0
1785;178789;1922;55;25;3;22;.880;3600000;0
1785;-1;2287;0;0;0;0;.00nan;0;0
1785;89930;2287;49;31;4;27;.871;3563000;0
1786;161583;583;55;29;4;25;.862;2869000;0
1786;184159;583;20;12;4;8;.667;731000;0
1786;185232;586;69;18;2;16;.889;3600000;0
1786;64923;586;0;0;0;0;.00nan;0;0
1787;19954;1922;0;0;0;0;.00nan;0;0
1787;178789;1922;63;24;3;21;.875;3562000;0
1787;-1;2287;0;0;0;0;.00nan;0;0
1787;89930;2287;77;29;2;27;.931;3600000;0
1788;161583;583;0;0;0;0;.00nan;0;0
1788;184159;583;59;19;2;17;.895;3600000;0
1788;185232;586;50;26;3;23;.885;3600000;0
1788;64923;586;0;0;0;0;.00nan;0;0
1789;19954;1922;0;0;0;0;.00nan;0;0
1789;178789;1922;50;27;4;23;.852;3600000;0
1789;-1;2287;0;0;0;0;.00nan;0;0
1789;89930;2287;66;22;2;20;.909;3600000;0
1919;161583;583;0;0;0;0;.00nan;0;0
1919;184159;583;64;28;3;25;.893;3631000;0
1919;185232;586;57;22;2;20;.909;3631000;0
1919;64923;586;0;0;0;0;.00nan;0;0
1920;19954;1922;44;4;1;3;.750;1017000;0
1920;178789;1922;35;34;6;28;.824;2583000;0
1920;-1;2287;0;0;0;0;.00nan;0;0
1920;89930;2287;77;23;1;22;.957;3600000;0
1950;161583;583;0;0;0;0;.00nan;0;0
1950;19954;1922;0;0;0;0;.00nan;0;0
1950;184159;583;57;30;3;27;.900;3548000;0
1950;178789;1922;68;24;2;22;.917;3600000;0
1951;185232;586;53;34;5;29;.853;3600000;0
1951;-1;2287;52;3;0;3;1.000;253000;0
1951;64923;586;0;0;0;0;.00nan;0;0
1951;89930;2287;56;41;6;35;.854;3347000;0
1952;185232;586;67;21;2;19;.905;3600000;0
1952;-1;2287;0;0;0;0;.00nan;0;0
1952;64923;586;0;0;0;0;.00nan;0;0
1952;89930;2287;53;28;4;24;.857;3552000;0
1953;185232;586;31;32;6;26;.813;3563000;0
1953;-1;2287;0;0;0;0;.00nan;0;0
1953;64923;586;0;0;0;0;.00nan;0;0
1953;89930;2287;76;35;4;31;.886;3600000;0
1954;185232;586;72;31;2;29;.935;4326000;0
1954;-1;2287;0;0;0;0;.00nan;0;0
1954;64923;586;0;0;0;0;.00nan;0;0
1954;89930;2287;94;46;3;43;.935;4326000;0
2164;185232;586;70;33;2;31;.939;3600000;0
2164;-1;2287;35;5;2;3;.600;424000;0
2164;64923;586;0;0;0;0;.00nan;0;0
2164;89930;2287;40;32;6;26;.813;3176000;0
41650;164404;649;0;0;0;0;.00nan;0;0
41650;-1;638;10;20;6;14;.700;1481000;0
41650;58112;638;29;33;7;26;.788;2119000;0
41650;85947;649;58;9;1;8;.889;3600000;0
41651;211484;1809;60;23;3;20;.870;3600000;0
41651;190502;629;59;40;5;35;.875;3530000;0
41651;-1;1809;0;0;0;0;.00nan;0;0
41651;-1;629;0;0;0;0;.00nan;0;0
41652;174017;1838;80;12;0;12;1.000;3600000;0
41652;-1;1813;0;0;0;0;.00nan;0;0
41652;-1;1813;49;38;5;33;.868;3600000;0
41652;72747;1838;0;0;0;0;.00nan;0;0
41653;17625;644;0;0;0;0;.00nan;0;0
41653;185314;644;46;19;3;16;.842;3600000;0
41653;-1;648;0;0;0;0;.00nan;0;0
41653;-1;648;45;38;6;32;.842;3600000;0
41654;169552;1825;0;0;0;0;.00nan;0;0
41654;-1;1825;76;33;3;30;.909;3600000;0
41654;-1;4538;59;38;4;34;.895;3557000;0
41654;211456;4538;0;0;0;0;.00nan;0;0
41655;8942;1835;0;0;0;0;.00nan;0;0
41655;-1;1835;100;36;0;36;1.000;3600000;0
41655;-1;633;88;47;3;44;.936;3600000;0
41655;-1;633;0;0;0;0;.00nan;0;0
41656;182872;703;0;0;0;0;.00nan;0;0
41656;-1;703;100;48;2;46;.958;3600000;0
41656;-1;646;0;0;0;0;.00nan;0;0
41656;-1;646;25;22;5;17;.773;3600000;0
41657;211484;1809;66;36;3;33;.917;3600000;0
41657;-1;633;94;32;1;31;.969;3600000;0
41657;-1;633;0;0;0;0;.00nan;0;0
41657;-1;1809;0;0;0;0;.00nan;0;0
41658;164404;649;0;0;0;0;.00nan;0;0
41658;-1;4538;88;46;3;43;.935;3600000;0
41658;211456;4538;0;0;0;0;.00nan;0;0
41658;85947;649;69;21;2;19;.905;3600000;0
41659;17625;644;0;0;0;0;.00nan;0;0
41659;174017;1838;70;33;4;29;.879;2261000;0
41659;185314;644;57;26;3;23;.885;3600000;0
41659;72747;1838;83;19;0;19;1.000;1339000;0
41660;182872;703;57;32;4;28;.875;3547000;0
41660;-1;703;0;0;0;0;.00nan;0;0
41660;-1;638;0;0;0;0;.00nan;0;0
41660;58112;638;68;30;3;27;.900;3600000;0
41661;8942;1835;0;0;0;0;.00nan;0;0
41661;-1;1835;61;36;4;32;.889;3526000;0
41661;-1;646;0;0;0;0;.00nan;0;0
41661;-1;646;72;22;2;20;.909;3600000;0
41662;169552;1825;48;20;3;17;.850;2478000;0
41662;-1;1825;21;11;4;7;.636;1034000;0
41662;-1;1813;0;0;0;0;.00nan;0;0
41662;-1;1813;66;43;5;38;.884;3600000;0
41663;190502;629;0;0;0;0;.00nan;0;0
41663;-1;648;0;0;0;0;.00nan;0;0
41663;-1;648;50;14;2;12;.857;3600000;0
41663;-1;629;88;51;4;47;.922;3600000;0
41664;164404;649;0;0;0;0;.00nan;0;0
41664;-1;633;72;39;4;35;.897;3554000;0
41664;-1;633;0;0;0;0;.00nan;0;0
41664;85947;649;59;18;2;16;.889;3600000;0
41665;17625;644;0;0;0;0;.00nan;0;0
41665;211484;1809;0;0;0;0;.00nan;0;0
41665;185314;644;45;23;4;19;.826;3600000;0
41665;-1;1809;53;41;5;36;.878;3600000;0
41666;174017;1838;24;19;5;14;.737;3515000;0
41666;-1;638;0;0;0;0;.00nan;0;0
41666;58112;638;61;31;3;28;.903;3600000;0
41666;72747;1838;0;0;0;0;.00nan;0;0
41667;-1;648;0;0;0;0;.00nan;0;0
41667;-1;1813;86;38;2;36;.947;3088000;0
41667;-1;648;59;17;2;15;.882;3600000;0
41667;-1;1813;32;7;3;4;.571;512000;0
41668;169552;1825;0;0;0;0;.00nan;0;0
41668;-1;1825;77;23;1;22;.957;3600000;0
41668;-1;646;0;0;0;0;.00nan;0;0
41668;-1;646;57;31;4;27;.871;3600000;0
41669;8942;1835;0;0;0;0;.00nan;0;0
41669;-1;1835;81;25;1;24;.960;3600000;0
41669;190502;629;0;0;0;0;.00nan;0;0
41669;-1;629;58;30;3;27;.900;3562000;0
41670;182872;703;65;43;5;38;.884;4055000;0
41670;-1;4538;65;38;4;34;.895;4022000;0
41670;211456;4538;0;0;0;0;.00nan;0;0
41670;-1;703;0;0;0;0;.00nan;0;0
41671;174017;1838;85;21;1;20;.952;3600000;0
41671;-1;633;53;34;4;30;.882;3600000;0
41671;-1;633;0;0;0;0;.00nan;0;0
41671;72747;1838;0;0;0;0;.00nan;0;0
41672;8942;1835;0;0;0;0;.00nan;0;0
41672;-1;1835;61;34;5;29;.853;3600000;0
41672;-1;4538;21;26;7;19;.731;3514000;0
41672;211456;4538;0;0;0;0;.00nan;0;0
41673;182872;703;38;41;6;35;.854;3152000;0
41673;17625;644;0;0;0;0;.00nan;0;0
41673;185314;644;68;32;3;29;.906;3600000;0
41673;-1;703;56;5;0;5;1.000;448000;0
41674;-1;648;40;15;3;12;.800;3653000;0
41674;-1;638;0;0;0;0;.00nan;0;0
41674;-1;648;0;0;0;0;.00nan;0;0
41674;58112;638;76;36;4;32;.889;3653000;0
41675;164404;649;0;0;0;0;.00nan;0;0
41675;-1;646;66;34;4;30;.882;3600000;0
41675;-1;646;0;0;0;0;.00nan;0;0
41675;85947;649;56;36;5;31;.861;3598000;0
41676;169552;1825;0;0;0;0;.00nan;0;0
41676;-1;1825;43;18;3;15;.833;3558000;0
41676;190502;629;0;0;0;0;.00nan;0;0
41676;-1;629;59;22;2;20;.909;3600000;0
41677;211484;1809;47;32;5;27;.844;3588000;0
41677;-1;1809;0;0;0;0;.00nan;0;0
41677;-1;1813;28;11;4;7;.636;1098000;0
41677;-1;1813;92;33;0;33;1.000;2502000;0
41678;-1;4538;63;43;4;39;.907;6027000;0
41678;211456;4538;0;0;0;0;.00nan;0;0
41678;-1;633;76;60;5;55;.917;6027000;0
41678;-1;633;0;0;0;0;.00nan;0;0
41679;164404;649;0;0;0;0;.00nan;0;0
41679;-1;1813;0;0;0;0;.00nan;0;0
41679;-1;1813;85;53;5;48;.906;3600000;0
41679;85947;649;57;19;2;17;.895;3600000;0
41680;169552;1825;50;1;0;1;1.000;248000;0
41680;-1;1825;36;32;6;26;.813;3352000;0
41680;211484;1809;0;0;0;0;.00nan;0;0
41680;-1;1809;80;23;1;22;.957;3600000;0
41681;174017;1838;85;45;3;42;.933;3600000;0
41681;-1;646;28;7;3;4;.571;486000;0
41681;-1;646;33;33;6;27;.818;3114000;0
41681;72747;1838;0;0;0;0;.00nan;0;0
41682;8942;1835;0;0;0;0;.00nan;0;0
41682;-1;1835;83;49;4;45;.918;3600000;0
41682;17625;644;0;0;0;0;.00nan;0;0
41682;185314;644;69;19;1;18;.947;3600000;0
41683;182872;703;0;0;0;0;.00nan;0;0
41683;-1;703;68;30;4;26;.867;3600000;0
41683;-1;648;0;0;0;0;.00nan;0;0
41683;-1;648;47;35;5;30;.857;3570000;0
41684;190502;629;57;19;2;17;.895;3526000;0
41684;-1;638;0;0;0;0;.00nan;0;0
41684;-1;629;0;0;0;0;.00nan;0;0
41684;58112;638;100;28;0;28;1.000;3600000;0
41685;174017;1838;57;20;3;17;.850;3649000;0
41685;-1;4538;76;29;2;27;.931;3649000;0
41685;211456;4538;0;0;0;0;.00nan;0;0
41685;72747;1838;0;0;0;0;.00nan;0;0
41686;164404;649;0;0;0;0;.00nan;0;0
41686;-1;648;0;0;0;0;.00nan;0;0
41686;-1;648;100;46;1;45;.978;3600000;0
41686;85947;649;66;27;3;24;.889;3572000;0
41687;17625;644;64;21;3;18;.857;3600000;0
41687;-1;633;47;56;8;48;.857;3600000;0
41687;185314;644;0;0;0;0;.00nan;0;0
41687;-1;633;0;0;0;0;.00nan;0;0
41688;211484;1809;67;26;2;24;.923;3625000;0
41688;-1;1809;0;0;0;0;.00nan;0;0
41688;-1;638;0;0;0;0;.00nan;0;0
41688;58112;638;62;29;3;26;.897;3625000;0
41689;182872;703;88;38;2;36;.947;3584000;0
41689;169552;1825;73;24;1;23;.958;3600000;0
41689;-1;1825;0;0;0;0;.00nan;0;0
41689;-1;703;0;0;0;0;.00nan;0;0
41690;190502;629;0;0;0;0;.00nan;0;0
41690;-1;646;71;23;2;21;.913;3749000;0
41690;-1;646;0;0;0;0;.00nan;0;0
41690;-1;629;90;51;3;48;.941;3749000;0
41691;8942;1835;0;0;0;0;.00nan;0;0
41691;-1;1835;91;23;0;23;1.000;3600000;0
41691;-1;1813;0;0;0;0;.00nan;0;0
41691;-1;1813;51;36;5;31;.861;3600000;0
41692;-1;633;91;39;2;37;.949;3600000;0
41692;-1;633;0;0;0;0;.00nan;0;0
41692;-1;646;27;9;3;6;.667;3562000;0
41692;-1;646;0;0;0;0;.00nan;0;0
41693;211484;1809;0;0;0;0;.00nan;0;0
41693;-1;1809;72;23;1;22;.957;3600000;0
41693;-1;648;0;0;0;0;.00nan;0;0
41693;-1;648;54;34;5;29;.853;3600000;0
41694;169552;1825;0;0;0;0;.00nan;0;0
41694;174017;1838;69;28;2;26;.929;3550000;0
41694;-1;1825;64;16;1;15;.938;3600000;0
41694;72747;1838;0;0;0;0;.00nan;0;0
41695;17625;644;46;17;3;14;.824;3600000;0
41695;185314;644;0;0;0;0;.00nan;0;0
41695;-1;638;52;15;2;13;.867;826000;0
41695;58112;638;63;45;6;39;.867;2774000;0
41696;182872;703;46;44;6;38;.864;3054000;0
41696;8942;1835;0;0;0;0;.00nan;0;0
41696;-1;1835;58;25;3;22;.880;3600000;0
41696;-1;703;42;3;1;2;.667;546000;0
41697;-1;4538;73;29;3;26;.897;3600000;0
41697;211456;4538;0;0;0;0;.00nan;0;0
41697;-1;1813;20;24;6;18;.750;2213000;0
41697;-1;1813;68;14;0;14;1.000;1387000;0
41698;164404;649;0;0;0;0;.00nan;0;0
41698;190502;629;48;47;6;41;.872;3600000;0
41698;-1;629;0;0;0;0;.00nan;0;0
41698;85947;649;54;22;3;19;.864;3600000;0
41699;-1;633;72;42;3;39;.929;5684000;0
41699;-1;633;0;0;0;0;.00nan;0;0
41699;-1;1813;73;38;4;34;.895;5684000;0
41699;-1;1813;0;0;0;0;.00nan;0;0
41700;182872;703;74;47;5;42;.894;3600000;0
41700;164404;649;49;7;1;6;.857;568000;0
41700;-1;703;0;0;0;0;.00nan;0;0
41700;85947;649;28;26;6;20;.769;3002000;0
41701;174017;1838;87;36;2;34;.944;3600000;0
41701;211484;1809;64;29;3;26;.897;3557000;0
41701;-1;1809;0;0;0;0;.00nan;0;0
41701;72747;1838;0;0;0;0;.00nan;0;0
41702;17625;644;79;14;0;14;1.000;3600000;0
41702;169552;1825;43;18;3;15;.833;1430000;0
41702;-1;1825;24;25;6;19;.760;2170000;0
41702;185314;644;0;0;0;0;.00nan;0;0
41703;-1;646;0;0;0;0;.00nan;0;0
41703;-1;646;69;26;2;24;.923;3600000;0
41703;-1;638;0;0;0;0;.00nan;0;0
41703;58112;638;94;46;4;42;.913;3530000;0
41704;8942;1835;0;0;0;0;.00nan;0;0
41704;-1;1835;62;30;3;27;.900;3600000;0
41704;-1;648;0;0;0;0;.00nan;0;0
41704;-1;648;12;35;8;27;.771;3600000;0
41705;-1;4538;74;27;2;25;.926;3600000;0
41705;211456;4538;0;0;0;0;.00nan;0;0
41705;190502;629;0;0;0;0;.00nan;0;0
41705;-1;629;77;37;3;34;.919;3588000;0
41706;-1;4538;48;25;4;21;.840;3813000;0
41706;211456;4538;0;0;0;0;.00nan;0;0
41706;-1;638;0;0;0;0;.00nan;0;0
41706;58112;638;59;45;5;40;.889;3813000;0
41707;8942;1835;0;0;0;0;.00nan;0;0
41707;-1;1835;67;24;2;22;.917;3600000;0
41707;174017;1838;81;34;3;31;.912;3595000;0
41707;72747;1838;0;0;0;0;.00nan;0;0
41708;-1;633;53;34;4;30;.882;3600000;0
41708;-1;633;0;0;0;0;.00nan;0;0
41708;-1;648;70;18;1;17;.944;3600000;0
41708;-1;648;0;0;0;0;.00nan;0;0
41709;164404;649;0;0;0;0;.00nan;0;0
41709;169552;1825;84;31;2;29;.935;3590000;0
41709;-1;1825;0;0;0;0;.00nan;0;0
41709;85947;649;87;30;1;29;.967;3600000;0
41710;17625;644;61;23;3;20;.870;3600000;0
41710;185314;644;0;0;0;0;.00nan;0;0
41710;-1;646;26;30;6;24;.800;2808000;0
41710;-1;646;49;7;1;6;.857;792000;0
41711;190502;629;52;33;4;29;.879;3545000;0
41711;-1;1813;0;0;0;0;.00nan;0;0
41711;-1;629;0;0;0;0;.00nan;0;0
41711;-1;1813;62;29;3;26;.897;3600000;0
41712;182872;703;0;0;0;0;.00nan;0;0
41712;211484;1809;28;13;4;9;.692;2572000;0
41712;-1;703;68;36;4;32;.889;3600000;0
41712;-1;1809;18;8;4;4;.500;1028000;0
41713;174017;1838;64;19;2;17;.895;3600000;0
41713;-1;1813;31;29;6;23;.793;2895000;0
41713;-1;1813;60;10;0;10;1.000;705000;0
41713;72747;1838;0;0;0;0;.00nan;0;0
41714;182872;703;75;33;3;30;.909;3585000;0
41714;-1;633;85;29;1;28;.966;3600000;0
41714;-1;633;0;0;0;0;.00nan;0;0
41714;-1;703;0;0;0;0;.00nan;0;0
41715;164404;649;0;0;0;0;.00nan;0;0
41715;174017;1838;13;5;4;1;.200;824000;0
41715;72747;1838;75;28;1;27;.964;2776000;0
41715;85947;649;91;20;0;20;1.000;3600000;0
41716;169552;1825;0;0;0;0;.00nan;0;0
41716;-1;1825;67;26;3;23;.885;4138000;0
41716;-1;648;0;0;0;0;.00nan;0;0
41716;-1;648;69;36;4;32;.889;4138000;0
41717;17625;644;0;0;0;0;.00nan;0;0
41717;190502;629;48;9;1;8;.889;459000;0
41717;185314;644;74;9;0;9;1.000;3600000;0
41717;-1;629;59;47;6;41;.872;3141000;0
41718;-1;638;0;0;0;0;.00nan;0;0
41718;-1;1813;74;31;3;28;.903;3585000;0
41718;-1;1813;0;0;0;0;.00nan;0;0
41718;58112;638;85;37;2;35;.946;3600000;0
41719;-1;4538;50;44;7;37;.841;3721000;0
41719;211456;4538;0;0;0;0;.00nan;0;0
41719;-1;646;0;0;0;0;.00nan;0;0
41719;-1;646;36;28;6;22;.786;3721000;0
41720;8942;1835;0;0;0;0;.00nan;0;0
41720;-1;1835;88;38;2;36;.947;3600000;0
41720;211484;1809;65;35;4;31;.886;2352000;0
41720;-1;1809;50;8;1;7;.875;1248000;0
41721;8942;1835;0;0;0;0;.00nan;0;0
41721;164404;649;0;0;0;0;.00nan;0;0
41721;-1;1835;52;27;4;23;.852;4590000;0
41721;85947;649;48;43;5;38;.884;4590000;0
41722;-1;4538;78;32;2;30;.938;3557000;0
41722;211456;4538;0;0;0;0;.00nan;0;0
41722;-1;648;0;0;0;0;.00nan;0;0
41722;-1;648;91;30;1;29;.967;3600000;0
41723;211484;1809;0;0;0;0;.00nan;0;0
41723;-1;646;60;22;2;20;.909;3600000;0
41723;-1;1809;68;32;3;29;.906;3600000;0
41723;-1;646;0;0;0;0;.00nan;0;0
41724;169552;1825;57;26;3;23;.885;3600000;0
41724;-1;1825;0;0;0;0;.00nan;0;0
41724;-1;638;0;0;0;0;.00nan;0;0
41724;58112;638;52;33;4;29;.879;3581000;0
41725;17625;644;0;0;0;0;.00nan;0;0
41725;185314;644;48;18;3;15;.833;3600000;0
41725;-1;1813;0;0;0;0;.00nan;0;0
41725;-1;1813;74;49;5;44;.898;3561000;0
41726;182872;703;93;36;1;35;.972;3600000;0
41726;174017;1838;34;29;6;23;.793;2641000;0
41726;-1;703;0;0;0;0;.00nan;0;0
41726;72747;1838;46;9;2;7;.778;959000;0
41727;-1;633;85;14;0;14;1.000;3600000;0
41727;190502;629;63;41;5;36;.878;3600000;0
41727;-1;633;0;0;0;0;.00nan;0;0
41727;-1;629;0;0;0;0;.00nan;0;0
41728;164404;649;0;0;0;0;.00nan;0;0
41728;17625;644;75;29;2;27;.931;3600000;0
41728;185314;644;0;0;0;0;.00nan;0;0
41728;85947;649;95;45;3;42;.933;3600000;0
41729;-1;4538;59;25;3;22;.880;3600000;0
41729;211456;4538;0;0;0;0;.00nan;0;0
41729;211484;1809;36;21;4;17;.810;2281000;0
41729;-1;1809;52;17;2;15;.882;1319000;0
41730;174017;1838;63;18;1;17;.944;3600000;0
41730;190502;629;17;20;6;14;.700;2617000;0
41730;-1;629;11;10;5;5;.500;983000;0
41730;72747;1838;0;0;0;0;.00nan;0;0
41731;-1;646;0;0;0;0;.00nan;0;0
41731;-1;646;52;23;3;20;.870;4056000;0
41731;-1;648;0;0;0;0;.00nan;0;0
41731;-1;648;96;46;2;44;.957;4056000;0
41732;8942;1835;0;0;0;0;.00nan;0;0
41732;-1;1835;39;21;4;17;.810;3545000;0
41732;-1;638;95;48;3;45;.938;3600000;0
41732;58112;638;0;0;0;0;.00nan;0;0
41733;169552;1825;0;0;0;0;.00nan;0;0
41733;-1;1825;63;32;4;28;.875;3600000;0
41733;-1;633;47;32;5;27;.844;3553000;0
41733;-1;633;0;0;0;0;.00nan;0;0
41734;182872;703;99;31;1;30;.968;3600000;0
41734;-1;703;0;0;0;0;.00nan;0;0
41734;-1;1813;74;33;3;30;.909;3535000;0
41734;-1;1813;0;0;0;0;.00nan;0;0
41735;8942;1835;0;0;0;0;.00nan;0;0
41735;-1;1835;88;23;0;23;1.000;3600000;0
41735;-1;633;68;41;4;37;.902;3600000;0
41735;-1;633;0;0;0;0;.00nan;0;0
41736;169552;1825;54;21;3;18;.857;3600000;0
41736;-1;1825;0;0;0;0;.00nan;0;0
41736;-1;4538;0;0;0;0;.00nan;0;0
41736;211456;4538;86;53;4;49;.925;3574000;0
41737;17625;644;0;0;0;0;.00nan;0;0
41737;185314;644;66;17;1;16;.941;3600000;0
41737;-1;648;77;33;2;31;.939;2441000;0
41737;-1;648;30;17;4;13;.765;1159000;0
41738;164404;649;0;0;0;0;.00nan;0;0
41738;-1;638;0;0;0;0;.00nan;0;0
41738;58112;638;62;43;5;38;.884;3600000;0
41738;85947;649;67;21;1;20;.952;3600000;0
41739;182872;703;0;0;0;0;.00nan;0;0
41739;-1;703;83;42;3;39;.929;3567000;0
41739;-1;646;64;20;1;19;.950;3600000;0
41739;-1;646;0;0;0;0;.00nan;0;0
41740;211484;1809;74;35;2;33;.943;5863000;0
41740;190502;629;88;59;3;56;.949;5863000;0
41740;-1;1809;0;0;0;0;.00nan;0;0
41740;-1;629;0;0;0;0;.00nan;0;0
41741;164404;649;0;0;0;0;.00nan;0;0
41741;-1;633;51;31;4;27;.871;3573000;0
41741;-1;633;0;0;0;0;.00nan;0;0
41741;85947;649;60;28;3;25;.893;3600000;0
41742;182872;703;44;25;5;20;.800;3600000;0
41742;-1;4538;25;26;6;20;.769;3561000;0
41742;211456;4538;0;0;0;0;.00nan;0;0
41742;-1;703;0;0;0;0;.00nan;0;0
41743;17625;644;0;0;0;0;.00nan;0;0
41743;211484;1809;59;47;5;42;.894;3600000;0
41743;185314;644;100;30;0;30;1.000;3600000;0
41743;-1;1809;0;0;0;0;.00nan;0;0
41744;174017;1838;56;26;3;23;.885;3600000;0
41744;-1;638;0;0;0;0;.00nan;0;0
41744;58112;638;58;43;5;38;.884;3512000;0
41744;72747;1838;0;0;0;0;.00nan;0;0
41745;169552;1825;0;0;0;0;.00nan;0;0
41745;-1;1825;52;32;4;28;.875;3547000;0
41745;-1;646;0;0;0;0;.00nan;0;0
41745;-1;646;63;30;3;27;.900;3600000;0
41746;-1;648;0;0;0;0;.00nan;0;0
41746;-1;1813;0;0;0;0;.00nan;0;0
41746;-1;648;51;22;3;19;.864;3600000;0
41746;-1;1813;100;28;0;28;1.000;3600000;0
41747;8942;1835;0;0;0;0;.00nan;0;0
41747;-1;1835;33;28;6;22;.786;3600000;0
41747;190502;629;0;0;0;0;.00nan;0;0
41747;-1;629;73;36;3;33;.917;3600000;0
41748;164404;649;0;0;0;0;.00nan;0;0
41748;-1;646;48;29;4;25;.862;3600000;0
41748;-1;646;0;0;0;0;.00nan;0;0
41748;85947;649;93;22;0;22;1.000;3600000;0
41749;211484;1809;0;0;0;0;.00nan;0;0
41749;-1;1809;60;45;5;40;.889;3600000;0
41749;-1;1813;0;0;0;0;.00nan;0;0
41749;-1;1813;81;30;2;28;.933;3600000;0
41750;174017;1838;77;27;2;25;.926;4023000;0
41750;-1;633;73;33;3;30;.909;4023000;0
41750;-1;633;0;0;0;0;.00nan;0;0
41750;72747;1838;0;0;0;0;.00nan;0;0
41751;-1;648;89;30;1;29;.967;3600000;0
41751;-1;638;48;0;0;0;.00nan;338000;0
41751;-1;648;0;0;0;0;.00nan;0;0
41751;58112;638;39;28;6;22;.786;3262000;0
41752;169552;1825;0;0;0;0;.00nan;0;0
41752;-1;1825;44;26;5;21;.808;3929000;0
41752;190502;629;54;50;6;44;.880;3929000;0
41752;-1;629;0;0;0;0;.00nan;0;0
41753;8942;1835;0;0;0;0;.00nan;0;0
41753;-1;1835;50;29;4;25;.862;3590000;0
41753;-1;4538;87;35;2;33;.943;3600000;0
41753;211456;4538;0;0;0;0;.00nan;0;0
41754;182872;703;0;0;0;0;.00nan;0;0
41754;17625;644;0;0;0;0;.00nan;0;0
41754;185314;644;56;20;2;18;.900;3600000;0
41754;-1;703;76;37;3;34;.919;3600000;0
41755;164404;649;0;0;0;0;.00nan;0;0
41755;211484;1809;47;34;5;29;.853;3600000;0
41755;-1;1809;0;0;0;0;.00nan;0;0
41755;85947;649;57;17;2;15;.882;3600000;0
41756;-1;4538;41;25;4;21;.840;3569000;0
41756;211456;4538;0;0;0;0;.00nan;0;0
41756;-1;633;83;40;3;37;.925;3600000;0
41756;-1;633;0;0;0;0;.00nan;0;0
41757;182872;703;43;23;4;19;.826;3600000;0
41757;-1;703;0;0;0;0;.00nan;0;0
41757;-1;648;0;0;0;0;.00nan;0;0
41757;-1;648;93;31;1;30;.968;3600000;0
41758;8942;1835;0;0;0;0;.00nan;0;0
41758;-1;1835;70;44;5;39;.886;3548000;0
41758;17625;644;0;0;0;0;.00nan;0;0
41758;185314;644;66;35;4;31;.886;3600000;0
41759;11107;629;62;36;5;31;.861;3600000;0
41759;190502;629;0;0;0;0;.00nan;0;0
41759;-1;638;0;0;0;0;.00nan;0;0
41759;58112;638;70;26;2;24;.923;3600000;0
41760;169552;1825;0;0;0;0;.00nan;0;0
41760;-1;1825;99;31;1;30;.968;3600000;0
41760;211484;1809;47;33;6;27;.818;2569000;0
41760;-1;1809;47;5;1;4;.800;1031000;0
41761;174017;1838;98;31;1;30;.968;3600000;0
41761;-1;646;0;0;0;0;.00nan;0;0
41761;-1;646;72;31;3;28;.903;3513000;0
41761;72747;1838;0;0;0;0;.00nan;0;0
41762;164404;649;0;0;0;0;.00nan;0;0
41762;-1;1813;0;0;0;0;.00nan;0;0
41762;61683;1813;79;45;3;42;.933;3559000;0
41762;85947;649;60;16;2;14;.875;3600000;0
41763;17625;644;0;0;0;0;.00nan;0;0
41763;-1;633;41;40;6;34;.850;2860000;0
41763;185314;644;67;24;2;22;.917;3600000;0
41763;-1;633;23;11;4;7;.636;740000;0
41764;164404;649;45;27;4;23;.852;3554000;0
41764;-1;648;0;0;0;0;.00nan;0;0
41764;-1;648;77;38;3;35;.921;3600000;0
41764;85947;649;0;0;0;0;.00nan;0;0
41765;211484;1809;0;0;0;0;.00nan;0;0
41765;-1;1809;71;21;1;20;.952;3600000;0
41765;-1;638;0;0;0;0;.00nan;0;0
41765;58112;638;84;38;2;36;.947;3543000;0
41766;174017;1838;0;0;0;0;.00nan;0;0
41766;-1;4538;68;23;2;21;.913;3600000;0
41766;211456;4538;0;0;0;0;.00nan;0;0
41766;72747;1838;29;28;5;23;.821;3600000;0
41767;8942;1835;0;0;0;0;.00nan;0;0
41767;-1;1835;66;23;3;20;.870;3600000;0
41767;-1;1813;0;0;0;0;.00nan;0;0
41767;61683;1813;75;50;5;45;.900;3541000;0
41768;182872;703;0;0;0;0;.00nan;0;0
41768;169552;1825;0;0;0;0;.00nan;0;0
41768;-1;1825;54;39;5;34;.872;4068000;0
41768;-1;703;70;49;4;45;.918;4068000;0
41769;11107;629;59;43;5;38;.884;3600000;0
41769;190502;629;0;0;0;0;.00nan;0;0
41769;-1;646;78;20;1;19;.950;3600000;0
41769;-1;646;0;0;0;0;.00nan;0;0
41770;11107;629;58;41;5;36;.878;3600000;0
41770;-1;649;0;0;0;0;.00nan;0;0
41770;-1;629;0;0;0;0;.00nan;0;0
41770;85947;649;80;22;1;21;.955;3600000;0
41771;-1;4538;71;35;3;32;.914;3971000;0
41771;211456;4538;0;0;0;0;.00nan;0;0
41771;-1;1813;0;0;0;0;.00nan;0;0
41771;61683;1813;84;37;2;35;.946;3971000;0
41772;17625;644;0;0;0;0;.00nan;0;0
41772;185314;644;34;13;3;10;.769;3566000;0
41772;-1;638;94;42;2;40;.952;3600000;0
41772;58112;638;0;0;0;0;.00nan;0;0
41773;169552;1825;62;23;2;21;.913;4342000;0
41773;174017;1838;74;39;3;36;.923;4335000;0
41773;-1;1825;0;0;0;0;.00nan;0;0
41773;72747;1838;0;0;0;0;.00nan;0;0
41774;-1;633;56;26;3;23;.885;3570000;0
41774;-1;633;0;0;0;0;.00nan;0;0
41774;-1;646;0;0;0;0;.00nan;0;0
41774;-1;646;91;38;2;36;.947;3600000;0
41775;182872;703;49;35;5;30;.857;3600000;0
41775;8942;1835;0;0;0;0;.00nan;0;0
41775;-1;1835;100;26;0;26;1.000;3600000;0
41775;-1;703;0;0;0;0;.00nan;0;0
41776;-1;633;79;27;1;26;.963;3600000;0
41776;-1;633;0;0;0;0;.00nan;0;0
41776;-1;638;0;0;0;0;.00nan;0;0
41776;58112;638;56;42;6;36;.857;3600000;0
41777;211484;1809;62;35;4;31;.886;3600000;0
41777;-1;649;0;0;0;0;.00nan;0;0
41777;-1;1809;0;0;0;0;.00nan;0;0
41777;85947;649;76;36;3;33;.917;3600000;0
41778;174017;1838;94;29;1;28;.966;3600000;0
41778;-1;648;0;0;0;0;.00nan;0;0
41778;-1;648;62;21;2;19;.905;3583000;0
41778;72747;1838;0;0;0;0;.00nan;0;0
41779;17625;644;58;21;2;19;.905;3600000;0
41779;-1;4538;55;38;6;32;.842;3600000;0
41779;211456;4538;0;0;0;0;.00nan;0;0
41779;185314;644;0;0;0;0;.00nan;0;0
41780;8942;1835;0;0;0;0;.00nan;0;0
41780;-1;1835;86;26;1;25;.962;3600000;0
41780;169552;1825;0;0;0;0;.00nan;0;0
41780;-1;1825;78;34;2;32;.941;3578000;0
41781;-1;646;67;26;2;24;.923;3600000;0
41781;-1;646;0;0;0;0;.00nan;0;0
41781;-1;1813;0;0;0;0;.00nan;0;0
41781;61683;1813;81;48;4;44;.917;3580000;0
41782;182872;703;83;23;1;22;.957;3600000;0
41782;11107;629;62;34;4;30;.882;3600000;0
41782;-1;703;0;0;0;0;.00nan;0;0
41782;-1;629;0;0;0;0;.00nan;0;0
41783;211484;1809;40;27;5;22;.815;3600000;0
41783;-1;1809;0;0;0;0;.00nan;0;0
41783;-1;648;14;25;6;19;.760;2027000;0
41783;-1;648;50;9;1;8;.889;1547000;0
41784;174017;1838;39;18;3;15;.833;3793000;0
41784;-1;646;0;0;0;0;.00nan;0;0
41784;-1;646;51;30;4;26;.867;3793000;0
41784;72747;1838;0;0;0;0;.00nan;0;0
41785;11107;629;96;35;1;34;.971;3600000;0
41785;-1;4538;0;0;0;0;.00nan;0;0
41785;211456;4538;56;33;4;29;.879;3600000;0
41785;-1;629;0;0;0;0;.00nan;0;0
41786;174017;1838;36;21;4;17;.810;4087000;0
41786;211484;1809;48;37;5;32;.865;4087000;0
41786;-1;1809;0;0;0;0;.00nan;0;0
41786;72747;1838;0;0;0;0;.00nan;0;0
41787;8942;1835;0;0;0;0;.00nan;0;0
41787;-1;1835;90;28;1;27;.964;3600000;0
41787;-1;648;0;0;0;0;.00nan;0;0
41787;-1;648;59;36;5;31;.861;3600000;0
41788;17625;644;0;0;0;0;.00nan;0;0
41788;169552;1825;0;0;0;0;.00nan;0;0
41788;-1;1825;66;34;3;31;.912;3591000;0
41788;185314;644;72;29;2;27;.931;3600000;0
41789;-1;646;0;0;0;0;.00nan;0;0
41789;-1;646;52;25;3;22;.880;3556000;0
41789;-1;638;0;0;0;0;.00nan;0;0
41789;58112;638;82;37;2;35;.946;3600000;0
41790;-1;633;76;38;3;35;.921;3571000;0
41790;-1;633;0;0;0;0;.00nan;0;0
41790;-1;1813;0;0;0;0;.00nan;0;0
41790;61683;1813;66;18;2;16;.889;3600000;0
41791;182872;703;61;12;1;11;.917;933000;0
41791;-1;649;0;0;0;0;.00nan;0;0
41791;-1;703;63;49;6;43;.878;2882000;0
41791;85947;649;22;23;6;17;.739;3815000;0
41792;-1;633;70;32;3;29;.906;3600000;0
41792;-1;633;0;0;0;0;.00nan;0;0
41792;-1;648;45;20;3;17;.850;2746000;0
41792;-1;648;22;12;4;8;.667;854000;0
41793;169552;1825;0;0;0;0;.00nan;0;0
41793;-1;1825;64;43;4;39;.907;4363000;0
41793;-1;649;0;0;0;0;.00nan;0;0
41793;85947;649;48;31;5;26;.839;4363000;0
41794;182872;703;41;34;5;29;.853;3320000;0
41794;211484;1809;0;0;0;0;.00nan;0;0
41794;-1;703;27;7;3;4;.571;280000;0
41794;-1;1809;43;28;4;24;.857;3600000;0
41795;17625;644;0;0;0;0;.00nan;0;0
41795;185314;644;53;20;3;17;.850;3600000;0
41795;-1;646;90;54;4;50;.926;3581000;0
41795;-1;646;0;0;0;0;.00nan;0;0
41796;-1;4538;70;18;1;17;.944;3600000;0
41796;211456;4538;0;0;0;0;.00nan;0;0
41796;-1;638;0;0;0;0;.00nan;0;0
41796;58112;638;100;40;0;40;1.000;3600000;0
41797;8942;1835;0;0;0;0;.00nan;0;0
41797;-1;1835;59;27;3;24;.889;3600000;0
41797;174017;1838;61;34;4;30;.882;3563000;0
41797;72747;1838;0;0;0;0;.00nan;0;0
41798;11107;629;42;26;5;21;.808;3544000;0
41798;-1;629;0;0;0;0;.00nan;0;0
41798;-1;1813;0;0;0;0;.00nan;0;0
41798;61683;1813;69;33;3;30;.909;3600000;0
41799;17625;644;0;0;0;0;.00nan;0;0
41799;-1;4538;47;54;8;46;.852;3600000;0
41799;211456;4538;0;0;0;0;.00nan;0;0
41799;185314;644;42;12;3;9;.750;3600000;0
41800;174017;1838;88;32;3;29;.906;3600000;0
41800;-1;648;54;28;4;24;.857;3563000;0
41800;-1;648;0;0;0;0;.00nan;0;0
41800;72747;1838;0;0;0;0;.00nan;0;0
41801;-1;633;76;29;2;27;.931;3600000;0
41801;-1;633;0;0;0;0;.00nan;0;0
41801;-1;638;0;0;0;0;.00nan;0;0
41801;58112;638;83;40;3;37;.925;3546000;0
41802;8942;1835;0;0;0;0;.00nan;0;0
41802;-1;1835;80;25;1;24;.960;4364000;0
41802;169552;1825;93;46;2;44;.957;4364000;0
41802;-1;1825;0;0;0;0;.00nan;0;0
41803;-1;646;0;0;0;0;.00nan;0;0
41803;-1;646;35;28;5;23;.821;3751000;0
41803;-1;1813;0;0;0;0;.00nan;0;0
41803;61683;1813;86;55;4;51;.927;3751000;0
41804;182872;703;58;28;3;25;.893;3594000;0
41804;11107;629;82;29;2;27;.931;3600000;0
41804;-1;703;0;0;0;0;.00nan;0;0
41804;-1;629;0;0;0;0;.00nan;0;0
41805;174017;1838;100;36;1;35;.972;3600000;0
41805;-1;649;0;0;0;0;.00nan;0;0
41805;72747;1838;0;0;0;0;.00nan;0;0
41805;85947;649;25;18;5;13;.722;3600000;0
41806;-1;4538;78;43;3;40;.930;4445000;0
41806;211456;4538;0;0;0;0;.00nan;0;0
41806;-1;646;70;38;4;34;.895;4445000;0
41806;-1;646;0;0;0;0;.00nan;0;0
41807;8942;1835;51;2;0;2;1.000;567000;0
41807;-1;1835;22;20;6;14;.700;3033000;0
41807;211484;1809;65;34;3;31;.912;3600000;0
41807;-1;1809;0;0;0;0;.00nan;0;0
41808;169552;1825;0;0;0;0;.00nan;0;0
41808;-1;1825;48;27;4;23;.852;3600000;0
41808;-1;648;0;0;0;0;.00nan;0;0
41808;-1;648;36;26;5;21;.808;3574000;0
41809;-1;638;0;0;0;0;.00nan;0;0
41809;-1;1813;0;0;0;0;.00nan;0;0
41809;58112;638;50;24;4;20;.833;3600000;0
41809;61683;1813;31;27;5;22;.815;3600000;0
41810;182872;703;0;0;0;0;.00nan;0;0
41810;-1;633;62;23;2;21;.913;3600000;0
41810;-1;633;0;0;0;0;.00nan;0;0
41810;-1;703;54;29;4;25;.862;3600000;0
41811;11107;629;71;55;6;49;.891;3600000;0
41811;17625;644;0;0;0;0;.00nan;0;0
41811;185314;644;25;20;5;15;.750;3600000;0
41811;-1;629;0;0;0;0;.00nan;0;0
41812;11107;629;97;44;2;42;.955;3600000;0
41812;-1;633;0;0;0;0;.00nan;0;0
41812;-1;633;34;18;4;14;.778;3516000;0
41812;-1;629;0;0;0;0;.00nan;0;0
41813;182872;703;64;32;4;28;.875;3563000;0
41813;174017;1838;83;40;2;38;.950;3600000;0
41813;-1;703;0;0;0;0;.00nan;0;0
41813;72747;1838;0;0;0;0;.00nan;0;0
41814;-1;4538;77;21;1;20;.952;3600000;0
41814;211456;4538;0;0;0;0;.00nan;0;0
41814;-1;648;61;28;2;26;.929;3585000;0
41814;-1;648;0;0;0;0;.00nan;0;0
41815;17625;644;55;15;2;13;.867;3600000;0
41815;185314;644;0;0;0;0;.00nan;0;0
41815;-1;1813;0;0;0;0;.00nan;0;0
41815;61683;1813;77;56;5;51;.911;3600000;0
41816;169552;1825;0;0;0;0;.00nan;0;0
41816;-1;1825;58;12;1;11;.917;3600000;0
41816;-1;638;0;0;0;0;.00nan;0;0
41816;58112;638;85;40;3;37;.925;3600000;0
41817;211484;1809;61;34;4;30;.882;3600000;0
41817;-1;646;0;0;0;0;.00nan;0;0
41817;-1;1809;0;0;0;0;.00nan;0;0
41817;-1;646;73;26;2;24;.923;3600000;0
41818;8942;1835;0;0;0;0;.00nan;0;0
41818;-1;1835;81;25;1;24;.960;3600000;0
41818;-1;649;0;0;0;0;.00nan;0;0
41818;85947;649;70;27;2;25;.926;3545000;0
41819;169552;1825;0;0;0;0;.00nan;0;0
41819;-1;1825;84;15;0;15;1.000;3600000;0
41819;-1;633;40;33;7;26;.788;2340000;0
41819;-1;633;49;8;1;7;.875;1260000;0
41820;-1;4538;87;35;2;33;.943;3600000;0
41820;211456;4538;0;0;0;0;.00nan;0;0
41820;211484;1809;73;37;3;34;.919;3544000;0
41820;-1;1809;0;0;0;0;.00nan;0;0
41821;17625;644;0;0;0;0;.00nan;0;0
41821;-1;649;0;0;0;0;.00nan;0;0
41821;185314;644;81;19;1;18;.947;3600000;0
41821;85947;649;58;37;4;33;.892;3600000;0
41822;-1;646;100;36;0;36;1.000;3600000;0
41822;-1;646;0;0;0;0;.00nan;0;0
41822;-1;648;0;0;0;0;.00nan;0;0
41822;-1;648;65;32;3;29;.906;3600000;0
41823;8942;1835;0;0;0;0;.00nan;0;0
41823;-1;1835;94;20;0;20;1.000;3600000;0
41823;-1;638;0;0;0;0;.00nan;0;0
41823;58112;638;67;46;5;41;.891;3600000;0
41824;182872;703;0;0;0;0;.00nan;0;0
41824;-1;703;37;18;4;14;.778;3600000;0
41824;-1;1813;0;0;0;0;.00nan;0;0
41824;61683;1813;94;38;1;37;.974;3600000;0
41825;11107;629;46;38;6;32;.842;2914000;0
41825;174017;1838;69;23;2;21;.913;3600000;0
41825;-1;629;52;3;0;3;1.000;686000;0
41825;72747;1838;0;0;0;0;.00nan;0;0
41826;-1;4538;100;47;3;44;.936;3600000;0
41826;211456;4538;0;0;0;0;.00nan;0;0
41826;-1;649;31;18;4;14;.778;3587000;0
41826;85947;649;0;0;0;0;.00nan;0;0
41827;211484;1809;54;31;4;27;.871;3896000;0
41827;-1;633;84;43;3;40;.930;3896000;0
41827;-1;633;0;0;0;0;.00nan;0;0
41827;-1;1809;0;0;0;0;.00nan;0;0
41828;17625;644;0;0;0;0;.00nan;0;0
41828;174017;1838;90;54;3;51;.944;4712000;0
41828;185314;644;62;26;2;24;.923;4712000;0
41828;72747;1838;0;0;0;0;.00nan;0;0
41829;11107;629;86;43;4;39;.907;3592000;0
41829;-1;648;0;0;0;0;.00nan;0;0
41829;-1;648;53;21;3;18;.857;3600000;0
41829;-1;629;0;0;0;0;.00nan;0;0
41830;169552;1825;0;0;0;0;.00nan;0;0
41830;-1;1825;63;38;4;34;.895;5843000;0
41830;-1;1813;0;0;0;0;.00nan;0;0
41830;61683;1813;80;57;5;52;.912;5843000;0
41831;8942;1835;0;0;0;0;.00nan;0;0
41831;-1;1835;85;26;1;25;.962;3600000;0
41831;-1;646;0;0;0;0;.00nan;0;0
41831;-1;646;91;43;2;41;.953;3544000;0
41832;182872;703;89;13;0;13;1.000;3600000;0
41832;-1;703;0;0;0;0;.00nan;0;0
41832;-1;638;87;38;3;35;.921;3302000;0
41832;58112;638;22;4;3;1;.250;298000;0
41833;211484;1809;64;32;3;29;.906;3600000;0
41833;-1;633;54;33;4;29;.879;3561000;0
41833;-1;633;0;0;0;0;.00nan;0;0
41833;-1;1809;0;0;0;0;.00nan;0;0
41834;-1;4538;87;46;3;43;.935;3573000;0
41834;211456;4538;0;0;0;0;.00nan;0;0
41834;-1;649;0;0;0;0;.00nan;0;0
41834;85947;649;60;19;2;17;.895;3600000;0
41835;17625;644;0;0;0;0;.00nan;0;0
41835;174017;1838;87;38;2;36;.947;3571000;0
41835;185314;644;77;23;1;22;.957;3600000;0
41835;72747;1838;0;0;0;0;.00nan;0;0
41836;182872;703;79;22;1;21;.955;3600000;0
41836;-1;703;0;0;0;0;.00nan;0;0
41836;-1;638;0;0;0;0;.00nan;0;0
41836;58112;638;58;35;4;31;.886;3600000;0
41837;8942;1835;0;0;0;0;.00nan;0;0
41837;-1;1835;82;25;2;23;.920;3600000;0
41837;-1;646;58;28;3;25;.893;3600000;0
41837;-1;646;0;0;0;0;.00nan;0;0
41838;169552;1825;0;0;0;0;.00nan;0;0
41838;-1;1825;44;21;3;18;.857;3526000;0
41838;-1;1813;0;0;0;0;.00nan;0;0
41838;61683;1813;100;36;1;35;.972;3600000;0
41839;11107;629;71;35;3;32;.914;3578000;0
41839;-1;648;0;0;0;0;.00nan;0;0
41839;-1;648;57;21;2;19;.905;3600000;0
41839;-1;629;0;0;0;0;.00nan;0;0
41840;-1;649;0;0;0;0;.00nan;0;0
41840;-1;638;0;0;0;0;.00nan;0;0
41840;58112;638;88;44;2;42;.955;3555000;0
41840;85947;649;65;20;1;19;.950;3600000;0
41841;11107;629;53;35;5;30;.857;3600000;0
41841;211484;1809;40;2;1;1;.500;1085000;0
41841;-1;1809;12;30;7;23;.767;2515000;0
41841;-1;629;0;0;0;0;.00nan;0;0
41842;174017;1838;80;29;2;27;.931;3600000;0
41842;-1;1813;0;0;0;0;.00nan;0;0
41842;61683;1813;61;33;4;29;.879;3547000;0
41842;72747;1838;0;0;0;0;.00nan;0;0
41843;17625;644;0;0;0;0;.00nan;0;0
41843;185314;644;57;23;3;20;.870;3600000;0
41843;-1;648;22;38;7;31;.816;3600000;0
41843;-1;648;0;0;0;0;.00nan;0;0
41844;169552;1825;52;44;6;38;.864;4856000;0
41844;-1;1825;0;0;0;0;.00nan;0;0
41844;-1;4538;39;36;7;29;.806;4871000;0
41844;211456;4538;0;0;0;0;.00nan;0;0
41845;8942;1835;0;0;0;0;.00nan;0;0
41845;-1;1835;86;17;0;17;1.000;3600000;0
41845;-1;633;78;26;1;25;.962;3569000;0
41845;-1;633;0;0;0;0;.00nan;0;0
41846;182872;703;93;41;3;38;.927;3600000;0
41846;-1;703;0;0;0;0;.00nan;0;0
41846;-1;646;0;0;0;0;.00nan;0;0
41846;-1;646;54;31;4;27;.871;3549000;0
41847;174017;1838;98;16;0;16;1.000;3600000;0
41847;-1;633;32;10;3;7;.700;465000;0
41847;-1;633;72;31;3;28;.903;3135000;0
41847;72747;1838;0;0;0;0;.00nan;0;0
41848;8942;1835;0;0;0;0;.00nan;0;0
41848;-1;1835;89;27;1;26;.963;3600000;0
41848;-1;4538;67;37;3;34;.919;3537000;0
41848;211456;4538;0;0;0;0;.00nan;0;0
41849;182872;703;35;13;3;10;.769;331000;0
41849;17625;644;0;0;0;0;.00nan;0;0
41849;185314;644;56;12;1;11;.917;3600000;0
41849;-1;703;47;48;7;41;.854;3269000;0
41850;-1;648;0;0;0;0;.00nan;0;0
41850;-1;638;0;0;0;0;.00nan;0;0
41850;-1;648;58;15;2;13;.867;3600000;0
41850;58112;638;40;36;6;30;.833;3600000;0
41851;-1;649;0;0;0;0;.00nan;0;0
41851;-1;646;42;22;4;18;.818;1190000;0
41851;-1;646;44;21;4;17;.810;2410000;0
41851;85947;649;100;26;0;26;1.000;3600000;0
41852;211484;1809;90;43;3;40;.930;3828000;0
41852;-1;1809;0;0;0;0;.00nan;0;0
41852;-1;1813;76;26;2;24;.923;3828000;0
41852;61683;1813;0;0;0;0;.00nan;0;0
41853;11107;629;0;0;0;0;.00nan;0;0
41853;169552;1825;0;0;0;0;.00nan;0;0
41853;-1;1825;30;19;4;15;.789;3542000;0
41853;-1;629;73;35;3;32;.914;3600000;0
41854;-1;633;77;39;3;36;.923;3600000;0
41854;-1;649;0;0;0;0;.00nan;0;0
41854;-1;633;0;0;0;0;.00nan;0;0
41854;85947;649;85;15;0;15;1.000;3600000;0
41855;17625;644;0;0;0;0;.00nan;0;0
41855;185314;644;63;18;2;16;.889;3600000;0
41855;-1;1809;87;58;6;52;.897;3600000;0
41855;156545;1809;0;0;0;0;.00nan;0;0
41856;174017;1838;55;17;2;15;.882;3600000;0
41856;-1;638;0;0;0;0;.00nan;0;0
41856;58112;638;48;39;7;32;.821;3600000;0
41856;72747;1838;0;0;0;0;.00nan;0;0
41857;174806;648;0;0;0;0;.00nan;0;0
41857;-1;648;61;14;1;13;.929;3600000;0
41857;-1;1813;0;0;0;0;.00nan;0;0
41857;61683;1813;72;54;6;48;.889;3600000;0
41858;169552;1825;0;0;0;0;.00nan;0;0
41858;-1;1825;53;17;3;14;.824;3600000;0
41858;-1;646;0;0;0;0;.00nan;0;0
41858;-1;646;26;39;8;31;.795;3600000;0
41859;8942;1835;0;0;0;0;.00nan;0;0
41859;11107;629;94;54;4;50;.926;3600000;0
41859;-1;1835;72;18;1;17;.944;3600000;0
41859;-1;629;0;0;0;0;.00nan;0;0
41860;182872;703;0;0;0;0;.00nan;0;0
41860;-1;4538;78;29;2;27;.931;3600000;0
41860;211456;4538;0;0;0;0;.00nan;0;0
41860;-1;703;66;30;3;27;.900;3580000;0
41861;174017;1838;69;28;3;25;.893;3600000;0
41861;-1;4538;93;38;2;36;.947;3600000;0
41861;211456;4538;0;0;0;0;.00nan;0;0
41861;72747;1838;0;0;0;0;.00nan;0;0
41862;174806;648;0;0;0;0;.00nan;0;0
41862;-1;649;0;0;0;0;.00nan;0;0
41862;-1;648;36;33;6;27;.818;3600000;0
41862;85947;649;60;25;3;22;.880;3600000;0
41863;17625;644;68;24;2;22;.917;3600000;0
41863;-1;633;70;40;4;36;.900;3600000;0
41863;185314;644;0;0;0;0;.00nan;0;0
41863;-1;633;0;0;0;0;.00nan;0;0
41864;-1;1809;0;0;0;0;.00nan;0;0
41864;-1;638;43;5;1;4;.800;858000;0
41864;58112;638;29;28;6;22;.786;2742000;0
41864;156545;1809;62;25;3;22;.880;3600000;0
41865;182872;703;67;28;2;26;.929;3600000;0
41865;169552;1825;0;0;0;0;.00nan;0;0
41865;-1;1825;60;28;4;24;.857;3598000;0
41865;-1;703;0;0;0;0;.00nan;0;0
41866;11107;629;52;37;5;32;.865;3600000;0
41866;-1;646;71;26;2;24;.923;3600000;0
41866;-1;646;0;0;0;0;.00nan;0;0
41866;-1;629;0;0;0;0;.00nan;0;0
41867;8942;1835;0;0;0;0;.00nan;0;0
41867;-1;1835;67;19;1;18;.947;3600000;0
41867;-1;1813;0;0;0;0;.00nan;0;0
41867;61683;1813;66;44;5;39;.886;3600000;0
41868;-1;4538;41;15;3;12;.800;3600000;0
41868;211456;4538;0;0;0;0;.00nan;0;0
41868;-1;633;0;0;0;0;.00nan;0;0
41868;-1;633;65;42;4;38;.905;3558000;0
41869;-1;649;0;0;0;0;.00nan;0;0
41869;-1;1813;0;0;0;0;.00nan;0;0
41869;61683;1813;97;45;2;43;.956;3600000;0
41869;85947;649;74;19;1;18;.947;3600000;0
41870;169552;1825;0;0;0;0;.00nan;0;0
41870;-1;1825;49;30;5;25;.833;3600000;0
41870;-1;1809;20;34;7;27;.794;2951000;0
41870;156545;1809;66;8;0;8;1.000;568000;0
41871;174017;1838;0;0;0;0;.00nan;0;0
41871;-1;646;0;0;0;0;.00nan;0;0
41871;-1;646;49;34;5;29;.853;3547000;0
41871;72747;1838;53;21;3;18;.857;3600000;0
41872;8942;1835;0;0;0;0;.00nan;0;0
41872;-1;1835;91;44;2;42;.955;3600000;0
41872;17625;644;0;0;0;0;.00nan;0;0
41872;185314;644;91;31;1;30;.968;3600000;0
41873;182872;703;91;36;1;35;.972;4699000;0
41873;174806;648;0;0;0;0;.00nan;0;0
41873;-1;703;0;0;0;0;.00nan;0;0
41873;-1;648;76;38;2;36;.947;4699000;0
41874;11107;629;100;29;0;29;1.000;3600000;0
41874;-1;638;0;0;0;0;.00nan;0;0
41874;-1;629;0;0;0;0;.00nan;0;0
41874;58112;638;70;20;1;19;.950;3565000;0
41875;-1;4538;48;34;5;29;.853;3565000;0
41875;211456;4538;0;0;0;0;.00nan;0;0
41875;-1;638;0;0;0;0;.00nan;0;0
41875;58112;638;73;37;4;33;.892;3600000;0
41876;8942;1835;0;0;0;0;.00nan;0;0
41876;-1;1835;65;16;1;15;.938;3600000;0
41876;174017;1838;77;43;4;39;.907;3600000;0
41876;72747;1838;0;0;0;0;.00nan;0;0
41877;174806;648;100;24;0;24;1.000;3600000;0
41877;-1;633;67;45;5;40;.889;3600000;0
41877;-1;633;0;0;0;0;.00nan;0;0
41877;-1;648;0;0;0;0;.00nan;0;0
41878;169552;1825;0;0;0;0;.00nan;0;0
41878;-1;1825;94;37;1;36;.973;5150000;0
41878;-1;649;0;0;0;0;.00nan;0;0
41878;85947;649;91;38;2;36;.947;5150000;0
41879;17625;644;0;0;0;0;.00nan;0;0
41879;185314;644;70;28;2;26;.929;3600000;0
41879;-1;646;0;0;0;0;.00nan;0;0
41879;-1;646;76;46;4;42;.913;3577000;0
41880;11107;629;100;51;2;49;.961;3600000;0
41880;-1;629;0;0;0;0;.00nan;0;0
41880;-1;1813;0;0;0;0;.00nan;0;0
41880;61683;1813;74;25;3;22;.880;3569000;0
41881;182872;703;52;19;3;16;.842;3600000;0
41881;-1;703;0;0;0;0;.00nan;0;0
41881;-1;1809;0;0;0;0;.00nan;0;0
41881;156545;1809;59;39;5;34;.872;3517000;0
41882;211484;1809;0;0;0;0;.00nan;0;0
41882;-1;649;0;0;0;0;.00nan;0;0
41882;85947;649;73;14;1;13;.929;3600000;0
41882;156545;1809;62;48;6;42;.875;3600000;0
41883;17625;644;0;0;0;0;.00nan;0;0
41883;-1;4538;100;42;1;41;.976;3600000;0
41883;211456;4538;0;0;0;0;.00nan;0;0
41883;185314;644;63;24;2;22;.917;3579000;0
41884;174017;1838;69;32;2;30;.938;3543000;0
41884;174806;648;100;28;0;28;1.000;3600000;0
41884;-1;648;0;0;0;0;.00nan;0;0
41884;72747;1838;0;0;0;0;.00nan;0;0
41885;-1;633;79;47;4;43;.915;3948000;0
41885;-1;633;0;0;0;0;.00nan;0;0
41885;-1;638;65;27;3;24;.889;3948000;0
41885;58112;638;0;0;0;0;.00nan;0;0
41886;8942;1835;0;0;0;0;.00nan;0;0
41886;-1;1835;90;31;1;30;.968;3600000;0
41886;169552;1825;72;24;2;22;.917;3581000;0
41886;-1;1825;0;0;0;0;.00nan;0;0
41887;-1;646;74;27;2;25;.926;3600000;0
41887;-1;646;0;0;0;0;.00nan;0;0
41887;-1;1813;0;0;0;0;.00nan;0;0
41887;61683;1813;63;41;4;37;.902;3576000;0
41888;182872;703;56;26;3;23;.885;3600000;0
41888;11107;629;67;50;5;45;.900;3514000;0
41888;-1;703;0;0;0;0;.00nan;0;0
41888;-1;629;0;0;0;0;.00nan;0;0
41889;-1;633;88;39;2;37;.949;3574000;0
41889;-1;633;0;0;0;0;.00nan;0;0
41889;-1;646;0;0;0;0;.00nan;0;0
41889;-1;646;100;24;0;24;1.000;3600000;0
41890;174806;648;55;24;3;21;.875;3600000;0
41890;211484;1809;53;31;5;26;.839;3571000;0
41890;-1;648;0;0;0;0;.00nan;0;0
41890;156545;1809;0;0;0;0;.00nan;0;0
41891;169552;1825;0;0;0;0;.00nan;0;0
41891;174017;1838;83;32;2;30;.938;3703000;0
41891;-1;1825;63;26;3;23;.885;3703000;0
41891;72747;1838;0;0;0;0;.00nan;0;0
41892;17625;644;66;21;1;20;.952;3600000;0
41892;185314;644;0;0;0;0;.00nan;0;0
41892;-1;638;0;0;0;0;.00nan;0;0
41892;58112;638;84;51;4;47;.922;3600000;0
41893;182872;703;56;35;5;30;.857;3545000;0
41893;8942;1835;0;0;0;0;.00nan;0;0
41893;-1;1835;43;25;4;21;.840;3600000;0
41893;-1;703;0;0;0;0;.00nan;0;0
41894;-1;4538;78;28;2;26;.929;3600000;0
41894;211456;4538;0;0;0;0;.00nan;0;0
41894;-1;1813;46;37;6;31;.838;3600000;0
41894;61683;1813;0;0;0;0;.00nan;0;0
41895;11107;629;0;0;0;0;.00nan;0;0
41895;-1;649;0;0;0;0;.00nan;0;0
41895;-1;629;95;44;2;42;.955;3565000;0
41895;85947;649;77;20;1;19;.950;3600000;0
41896;-1;633;59;31;4;27;.871;3600000;0
41896;-1;633;0;0;0;0;.00nan;0;0
41896;-1;1813;74;23;1;22;.957;2405000;0
41896;61683;1813;30;19;4;15;.789;1186000;0
41897;8942;1835;0;0;0;0;.00nan;0;0
41897;-1;1835;48;35;5;30;.857;3600000;0
41897;-1;649;89;39;2;37;.949;3600000;0
41897;85947;649;0;0;0;0;.00nan;0;0
41898;-1;4538;82;36;2;34;.944;4194000;0
41898;174806;648;76;36;3;33;.917;4194000;0
41898;211456;4538;0;0;0;0;.00nan;0;0
41898;-1;648;0;0;0;0;.00nan;0;0
41899;211484;1809;61;41;5;36;.878;3583000;0
41899;-1;646;0;0;0;0;.00nan;0;0
41899;-1;646;85;34;3;31;.912;3600000;0
41899;156545;1809;0;0;0;0;.00nan;0;0
41900;169552;1825;0;0;0;0;.00nan;0;0
41900;-1;1825;64;21;2;19;.905;3600000;0
41900;-1;638;0;0;0;0;.00nan;0;0
41900;58112;638;77;41;4;37;.902;3513000;0
41901;17625;644;0;0;0;0;.00nan;0;0
41901;185314;644;45;15;3;12;.800;3600000;0
41901;-1;1813;52;11;1;10;.909;825000;0
41901;61683;1813;13;30;8;22;.733;2775000;0
41902;182872;703;0;0;0;0;.00nan;0;0
41902;174017;1838;62;36;4;32;.889;5112000;0
41902;-1;703;67;31;3;28;.903;5112000;0
41902;72747;1838;0;0;0;0;.00nan;0;0
41903;11107;629;66;29;3;26;.897;3600000;0
41903;-1;633;45;22;4;18;.818;3558000;0
41903;-1;633;0;0;0;0;.00nan;0;0
41903;-1;629;0;0;0;0;.00nan;0;0
41904;182872;703;40;35;6;29;.829;2172000;0
41904;-1;633;0;0;0;0;.00nan;0;0
41904;-1;633;65;24;2;22;.917;3600000;0
41904;-1;703;52;12;1;11;.917;1428000;0
41905;174017;1838;35;24;5;19;.792;2340000;0
41905;-1;649;0;0;0;0;.00nan;0;0
41905;72747;1838;74;12;0;12;1.000;1260000;0
41905;85947;649;85;16;0;16;1.000;3600000;0
41906;169552;1825;0;0;0;0;.00nan;0;0
41906;-1;1825;100;24;0;24;1.000;3600000;0
41906;174806;648;49;32;5;27;.844;3600000;0
41906;-1;648;0;0;0;0;.00nan;0;0
41907;11107;629;42;37;6;31;.838;1965000;0
41907;17625;644;58;21;2;19;.905;3600000;0
41907;185314;644;0;0;0;0;.00nan;0;0
41907;-1;629;61;19;2;17;.895;1635000;0
41908;-1;638;0;0;0;0;.00nan;0;0
41908;-1;1813;0;0;0;0;.00nan;0;0
41908;58112;638;64;51;5;46;.902;4648000;0
41908;61683;1813;58;32;4;28;.875;4648000;0
41909;-1;4538;53;25;4;21;.840;3600000;0
41909;211456;4538;0;0;0;0;.00nan;0;0
41909;-1;646;92;23;0;23;1.000;3600000;0
41909;-1;646;0;0;0;0;.00nan;0;0
41910;8942;1835;0;0;0;0;.00nan;0;0
41910;-1;1835;46;23;4;19;.826;3600000;0
41910;211484;1809;87;27;1;26;.963;3600000;0
41910;156545;1809;0;0;0;0;.00nan;0;0
41911;182872;703;74;41;4;37;.902;3600000;0
41911;-1;649;0;0;0;0;.00nan;0;0
41911;-1;703;0;0;0;0;.00nan;0;0
41911;85947;649;100;31;0;31;1.000;3600000;0
41912;174017;1838;72;25;2;23;.920;3571000;0
41912;211484;1809;0;0;0;0;.00nan;0;0
41912;72747;1838;0;0;0;0;.00nan;0;0
41912;156545;1809;80;27;1;26;.963;3600000;0
41913;17625;644;0;0;0;0;.00nan;0;0
41913;169552;1825;0;0;0;0;.00nan;0;0
41913;-1;1825;71;39;4;35;.897;3600000;0
41913;185314;644;63;21;1;20;.952;3600000;0
41914;-1;646;78;29;2;27;.931;3600000;0
41914;-1;646;0;0;0;0;.00nan;0;0
41914;-1;638;0;0;0;0;.00nan;0;0
41914;58112;638;59;39;5;34;.872;3564000;0
41915;8942;1835;0;0;0;0;.00nan;0;0
41915;-1;1835;67;24;2;22;.917;3600000;0
41915;174806;648;63;35;4;31;.886;3570000;0
41915;-1;648;0;0;0;0;.00nan;0;0
41916;11107;629;0;0;0;0;.00nan;0;0
41916;-1;4538;69;18;1;17;.944;3825000;0
41916;211456;4538;0;0;0;0;.00nan;0;0
41916;-1;629;94;48;2;46;.958;3825000;0
41917;8942;1835;0;0;0;0;.00nan;0;0
41917;-1;1835;85;23;1;22;.957;3600000;0
41917;-1;633;54;30;5;25;.833;3600000;0
41917;-1;633;0;0;0;0;.00nan;0;0
41918;169552;1825;0;0;0;0;.00nan;0;0
41918;-1;1825;28;16;4;12;.750;3600000;0
41918;-1;4538;44;4;1;3;.750;614000;0
41918;211456;4538;13;22;6;16;.727;2986000;0
41919;17625;644;0;0;0;0;.00nan;0;0
41919;174806;648;94;53;3;50;.943;3712000;0
41919;185314;644;71;21;2;19;.905;3712000;0
41919;-1;648;0;0;0;0;.00nan;0;0
41920;-1;649;0;0;0;0;.00nan;0;0
41920;-1;638;0;0;0;0;.00nan;0;0
41920;58112;638;82;47;4;43;.915;3549000;0
41920;85947;649;42;8;2;6;.750;3600000;0
41921;182872;703;64;40;4;36;.900;3600000;0
41921;-1;703;0;0;0;0;.00nan;0;0
41921;-1;646;0;0;0;0;.00nan;0;0
41921;-1;646;46;15;3;12;.800;3600000;0
41922;174017;1838;100;23;0;23;1.000;3600000;0
41922;-1;1813;0;0;0;0;.00nan;0;0
41922;61683;1813;97;50;3;47;.940;3600000;0
41922;72747;1838;0;0;0;0;.00nan;0;0
41923;11107;629;100;47;0;47;1.000;3600000;0
41923;211484;1809;64;23;2;21;.913;3600000;0
41923;-1;629;0;0;0;0;.00nan;0;0
41923;156545;1809;0;0;0;0;.00nan;0;0
41924;17625;644;42;34;6;28;.824;2848000;0
41924;-1;649;0;0;0;0;.00nan;0;0
41924;185314;644;48;7;1;6;.857;752000;0
41924;85947;649;81;37;3;34;.919;3600000;0
41925;-1;4538;78;26;1;25;.962;3600000;0
41925;211456;4538;0;0;0;0;.00nan;0;0
41925;211484;1809;29;31;6;25;.806;3336000;0
41925;156545;1809;48;0;0;0;.00nan;264000;0
41926;11107;629;63;38;3;35;.921;3518000;0
41926;174017;1838;71;21;1;20;.952;3600000;0
41926;-1;629;0;0;0;0;.00nan;0;0
41926;72747;1838;0;0;0;0;.00nan;0;0
41927;174806;648;68;27;2;25;.926;3884000;0
41927;-1;646;79;39;3;36;.923;3884000;0
41927;-1;646;0;0;0;0;.00nan;0;0
41927;-1;648;0;0;0;0;.00nan;0;0
41928;169552;1825;0;0;0;0;.00nan;0;0
41928;-1;1825;35;21;4;17;.810;3600000;0
41928;-1;633;99;37;1;36;.973;3600000;0
41928;-1;633;0;0;0;0;.00nan;0;0
41929;8942;1835;0;0;0;0;.00nan;0;0
41929;-1;1835;55;24;3;21;.875;4464000;0
41929;-1;638;0;0;0;0;.00nan;0;0
41929;58112;638;84;52;4;48;.923;4464000;0
41930;182872;703;0;0;0;0;.00nan;0;0
41930;-1;703;78;27;2;25;.926;3600000;0
41930;-1;1813;0;0;0;0;.00nan;0;0
41930;61683;1813;35;29;5;24;.828;3600000;0
41931;-1;649;0;0;0;0;.00nan;0;0
41931;-1;646;0;0;0;0;.00nan;0;0
41931;-1;646;62;49;6;43;.878;3600000;0
41931;85947;649;90;20;0;20;1.000;3600000;0
41932;211484;1809;87;35;2;33;.943;3600000;0
41932;-1;1813;0;0;0;0;.00nan;0;0
41932;61683;1813;61;30;3;27;.900;3584000;0
41932;156545;1809;0;0;0;0;.00nan;0;0
41933;174017;1838;66;26;2;24;.923;3599000;0
41933;-1;633;66;16;1;15;.938;3600000;0
41933;-1;633;0;0;0;0;.00nan;0;0
41933;72747;1838;0;0;0;0;.00nan;0;0
41934;174806;648;88;21;0;21;1.000;3600000;0
41934;-1;638;0;0;0;0;.00nan;0;0
41934;-1;648;0;0;0;0;.00nan;0;0
41934;58112;638;69;39;4;35;.897;3600000;0
41935;11107;629;93;30;1;29;.967;3600000;0
41935;169552;1825;0;0;0;0;.00nan;0;0
41935;-1;1825;58;24;3;21;.875;3519000;0
41935;-1;629;0;0;0;0;.00nan;0;0
41936;8942;1835;0;0;0;0;.00nan;0;0
41936;-1;1835;59;38;4;34;.895;3564000;0
41936;-1;4538;88;44;3;41;.932;3600000;0
41936;211456;4538;0;0;0;0;.00nan;0;0
41937;182872;703;84;53;4;49;.925;3557000;0
41937;17625;644;61;24;3;21;.875;3600000;0
41937;185314;644;0;0;0;0;.00nan;0;0
41937;-1;703;0;0;0;0;.00nan;0;0
41938;-1;633;94;61;2;59;.967;6600000;0
41938;-1;649;0;0;0;0;.00nan;0;0
41938;-1;633;0;0;0;0;.00nan;0;0
41938;85947;649;96;51;1;50;.980;6600000;0
41939;182872;703;90;34;1;33;.971;3600000;0
41939;-1;4538;50;39;5;34;.872;3600000;0
41939;211456;4538;0;0;0;0;.00nan;0;0
41939;-1;703;0;0;0;0;.00nan;0;0
41940;17625;644;0;0;0;0;.00nan;0;0
41940;211484;1809;78;44;3;41;.932;3552000;0
41940;185314;644;89;33;1;32;.970;3600000;0
41940;156545;1809;0;0;0;0;.00nan;0;0
41941;174017;1838;79;28;2;26;.929;4110000;0
41941;-1;638;0;0;0;0;.00nan;0;0
41941;58112;638;100;43;1;42;.977;4110000;0
41941;72747;1838;0;0;0;0;.00nan;0;0
41942;169552;1825;0;0;0;0;.00nan;0;0
41942;-1;1825;70;32;3;29;.906;3589000;0
41942;-1;646;0;0;0;0;.00nan;0;0
41942;-1;646;80;32;2;30;.938;3600000;0
41943;174806;648;81;37;3;34;.919;3520000;0
41943;-1;648;0;0;0;0;.00nan;0;0
41943;-1;1813;0;0;0;0;.00nan;0;0
41943;61683;1813;84;35;2;33;.943;3600000;0
41944;8942;1835;0;0;0;0;.00nan;0;0
41944;11107;629;0;0;0;0;.00nan;0;0
41944;-1;1835;99;24;0;24;1.000;3600000;0
41944;-1;629;59;40;5;35;.875;3600000;0
41945;-1;4538;49;16;3;13;.813;3600000;0
41945;211456;4538;0;0;0;0;.00nan;0;0
41945;-1;633;85;46;4;42;.913;3559000;0
41945;-1;633;0;0;0;0;.00nan;0;0
41946;182872;703;86;30;2;28;.933;3600000;0
41946;174806;648;49;33;5;28;.848;3600000;0
41946;-1;703;0;0;0;0;.00nan;0;0
41946;-1;648;0;0;0;0;.00nan;0;0
41947;8942;1835;57;13;1;12;.923;1291000;0
41947;-1;1835;76;40;4;36;.900;2271000;0
41947;17625;644;0;0;0;0;.00nan;0;0
41947;185314;644;58;24;3;21;.875;3600000;0
41948;11107;629;61;22;2;20;.909;3600000;0
41948;-1;638;0;0;0;0;.00nan;0;0
41948;-1;629;0;0;0;0;.00nan;0;0
41948;58112;638;45;36;6;30;.833;3600000;0
41949;169552;1825;52;12;2;10;.833;3600000;0
41949;-1;1825;0;0;0;0;.00nan;0;0
41949;211484;1809;57;45;6;39;.867;3173000;0
41949;156545;1809;48;10;2;8;.800;427000;0
41950;-1;649;0;0;0;0;.00nan;0;0
41950;-1;1813;0;0;0;0;.00nan;0;0
41950;61683;1813;58;41;5;36;.878;3579000;0
41950;85947;649;52;33;4;29;.879;3600000;0
41951;-1;633;98;55;3;52;.945;5866000;0
41951;-1;633;0;0;0;0;.00nan;0;0
41951;-1;638;0;0;0;0;.00nan;0;0
41951;58112;638;53;35;4;31;.886;5866000;0
41952;211484;1809;0;0;0;0;.00nan;0;0
41952;-1;649;0;0;0;0;.00nan;0;0
41952;85947;649;54;21;3;18;.857;3600000;0
41952;156545;1809;47;28;4;24;.857;3586000;0
41953;174017;1838;84;28;1;27;.964;3600000;0
41953;174806;648;59;20;2;18;.900;3551000;0
41953;-1;648;0;0;0;0;.00nan;0;0
41953;72747;1838;0;0;0;0;.00nan;0;0
41954;17625;644;68;20;2;18;.900;3600000;0
41954;-1;4538;71;45;5;40;.889;3600000;0
41954;211456;4538;0;0;0;0;.00nan;0;0
41954;185314;644;0;0;0;0;.00nan;0;0
41955;8942;1835;0;0;0;0;.00nan;0;0
41955;-1;1835;92;40;2;38;.950;3600000;0
41955;169552;1825;0;0;0;0;.00nan;0;0
41955;-1;1825;48;20;3;17;.850;3600000;0
41956;-1;646;0;0;0;0;.00nan;0;0
41956;-1;646;82;24;1;23;.958;3600000;0
41956;-1;1813;54;4;0;4;1.000;477000;0
41956;61683;1813;44;41;6;35;.854;3123000;0
41957;182872;703;67;25;2;23;.920;3600000;0
41957;11107;629;59;31;4;27;.871;3564000;0
41957;-1;703;0;0;0;0;.00nan;0;0
41957;-1;629;0;0;0;0;.00nan;0;0
41958;11107;629;82;58;6;52;.897;3600000;0
41958;-1;649;0;0;0;0;.00nan;0;0
41958;-1;629;0;0;0;0;.00nan;0;0
41958;85947;649;59;12;1;11;.917;3600000;0
41959;-1;4538;44;15;3;12;.800;585000;0
41959;211456;4538;67;29;2;27;.931;3405000;0
41959;-1;1813;0;0;0;0;.00nan;0;0
41959;61683;1813;44;40;6;34;.850;3990000;0
41960;174806;648;0;0;0;0;.00nan;0;0
41960;211484;1809;75;35;3;32;.914;3551000;0
41960;-1;648;51;20;2;18;.900;3600000;0
41960;156545;1809;0;0;0;0;.00nan;0;0
41961;17625;644;43;9;2;7;.778;3600000;0
41961;185314;644;0;0;0;0;.00nan;0;0
41961;-1;638;0;0;0;0;.00nan;0;0
41961;58112;638;93;59;5;54;.915;3600000;0
41962;169552;1825;0;0;0;0;.00nan;0;0
41962;174017;1838;100;21;0;21;1.000;3600000;0
41962;-1;1825;69;26;2;24;.923;3526000;0
41962;72747;1838;0;0;0;0;.00nan;0;0
41963;-1;633;84;38;2;36;.947;3600000;0
41963;-1;633;0;0;0;0;.00nan;0;0
41963;-1;646;0;0;0;0;.00nan;0;0
41963;-1;646;57;27;3;24;.889;3546000;0
41964;182872;703;76;34;2;32;.941;3600000;0
41964;8942;1835;0;0;0;0;.00nan;0;0
41964;-1;1835;83;33;3;30;.909;3570000;0
41964;-1;703;0;0;0;0;.00nan;0;0
41965;174806;648;0;0;0;0;.00nan;0;0
41965;-1;633;60;33;5;28;.848;3532000;0
41965;-1;633;0;0;0;0;.00nan;0;0
41965;-1;648;55;29;3;26;.897;3600000;0
41966;169552;1825;0;0;0;0;.00nan;0;0
41966;-1;1825;89;32;1;31;.969;3600000;0
41966;-1;649;0;0;0;0;.00nan;0;0
41966;85947;649;83;31;2;29;.935;3565000;0
41967;17625;644;0;0;0;0;.00nan;0;0
41967;185314;644;64;25;2;23;.920;3600000;0
41967;-1;646;0;0;0;0;.00nan;0;0
41967;-1;646;79;55;5;50;.909;3600000;0
41968;-1;4538;75;30;2;28;.933;3600000;0
41968;211456;4538;0;0;0;0;.00nan;0;0
41968;-1;638;54;26;3;23;.885;3547000;0
41968;58112;638;0;0;0;0;.00nan;0;0
41969;8942;1835;0;0;0;0;.00nan;0;0
41969;-1;1835;64;23;2;21;.913;3600000;0
41969;174017;1838;44;28;5;23;.821;3600000;0
41969;72747;1838;0;0;0;0;.00nan;0;0
41970;11107;629;35;34;6;28;.824;3600000;0
41970;-1;629;0;0;0;0;.00nan;0;0
41970;-1;1813;0;0;0;0;.00nan;0;0
41970;61683;1813;68;24;2;22;.917;3600000;0
41971;11107;629;83;48;4;44;.917;3600000;0
41971;-1;4538;47;26;5;21;.808;3544000;0
41971;211456;4538;0;0;0;0;.00nan;0;0
41971;-1;629;0;0;0;0;.00nan;0;0
41972;174017;1838;25;23;6;17;.739;3180000;0
41972;211484;1809;88;39;2;37;.949;3600000;0
41972;72747;1838;48;0;0;0;.00nan;420000;0
41972;156545;1809;0;0;0;0;.00nan;0;0
41973;8942;1835;0;0;0;0;.00nan;0;0
41973;-1;1835;61;21;2;19;.905;3600000;0
41973;174806;648;80;47;5;42;.894;3600000;0
41973;-1;648;0;0;0;0;.00nan;0;0
41974;17625;644;0;0;0;0;.00nan;0;0
41974;169552;1825;63;32;3;29;.906;3562000;0
41974;-1;1825;0;0;0;0;.00nan;0;0
41974;185314;644;68;23;2;21;.913;3600000;0
41975;-1;646;0;0;0;0;.00nan;0;0
41975;-1;646;33;23;5;18;.783;3514000;0
41975;-1;638;0;0;0;0;.00nan;0;0
41975;58112;638;61;31;3;28;.903;3600000;0
41976;-1;633;84;33;2;31;.939;3565000;0
41976;-1;633;0;0;0;0;.00nan;0;0
41976;-1;1813;0;0;0;0;.00nan;0;0
41976;61683;1813;92;32;1;31;.969;3600000;0
41977;182872;703;0;0;0;0;.00nan;0;0
41977;-1;649;0;0;0;0;.00nan;0;0
41977;-1;703;70;49;5;44;.898;3553000;0
41977;85947;649;67;34;4;30;.882;3600000;0
41978;182872;703;98;51;2;49;.961;3529000;0
41978;211484;1809;100;30;0;30;1.000;3600000;0
41978;-1;703;0;0;0;0;.00nan;0;0
41978;156545;1809;0;0;0;0;.00nan;0;0
41979;17625;644;0;0;0;0;.00nan;0;0
41979;-1;633;65;21;2;19;.905;1529000;0
41979;185314;644;64;15;1;14;.933;3600000;0
41979;-1;633;31;33;6;27;.818;2071000;0
41980;174806;648;75;43;4;39;.907;4327000;0
41980;-1;649;0;0;0;0;.00nan;0;0
41980;-1;648;0;0;0;0;.00nan;0;0
41980;85947;649;81;38;3;35;.921;4327000;0
41981;211484;1809;79;21;1;20;.952;3600000;0
41981;-1;638;0;0;0;0;.00nan;0;0
41981;58112;638;56;43;6;37;.860;3600000;0
41981;156545;1809;0;0;0;0;.00nan;0;0
41982;174017;1838;79;20;1;19;.950;3805000;0
41982;-1;4538;72;30;2;28;.933;3805000;0
41982;211456;4538;0;0;0;0;.00nan;0;0
41982;72747;1838;0;0;0;0;.00nan;0;0
41983;8942;1835;0;0;0;0;.00nan;0;0
41983;-1;1835;100;22;0;22;1.000;3600000;0
41983;-1;1813;98;39;1;38;.974;2698000;0
41983;61683;1813;31;15;4;11;.733;902000;0
41984;182872;703;28;14;4;10;.714;978000;0
41984;169552;1825;0;0;0;0;.00nan;0;0
41984;-1;1825;69;33;3;30;.909;3600000;0
41984;-1;703;70;21;1;20;.952;2558000;0
41985;11107;629;0;0;0;0;.00nan;0;0
41985;-1;646;0;0;0;0;.00nan;0;0
41985;-1;646;51;22;3;19;.864;4495000;0
41985;-1;629;89;41;2;39;.951;4495000;0
41986;11107;629;92;54;3;51;.944;4637000;0
41986;-1;633;58;20;2;18;.900;4637000;0
41986;-1;633;0;0;0;0;.00nan;0;0
41986;-1;629;0;0;0;0;.00nan;0;0
41987;182872;703;41;34;6;28;.824;3354000;0
41987;174017;1838;76;44;4;40;.909;3600000;0
41987;-1;703;49;2;0;2;1.000;207000;0
41987;72747;1838;0;0;0;0;.00nan;0;0
41988;-1;4538;63;42;5;37;.881;3607000;0
41988;174806;648;64;32;4;28;.875;3607000;0
41988;211456;4538;0;0;0;0;.00nan;0;0
41988;-1;648;0;0;0;0;.00nan;0;0
41989;17625;644;32;21;5;16;.762;3737000;0
41989;185314;644;0;0;0;0;.00nan;0;0
41989;-1;1813;0;0;0;0;.00nan;0;0
41989;61683;1813;100;59;4;55;.932;3737000;0
41990;169552;1825;0;0;0;0;.00nan;0;0
41990;-1;1825;77;25;2;23;.920;3946000;0
41990;-1;638;0;0;0;0;.00nan;0;0
41990;58112;638;95;38;1;37;.974;3946000;0
41991;211484;1809;69;40;5;35;.875;3689000;0
41991;-1;646;0;0;0;0;.00nan;0;0
41991;-1;646;60;29;4;25;.862;3689000;0
41991;156545;1809;0;0;0;0;.00nan;0;0
41992;8942;1835;0;0;0;0;.00nan;0;0
41992;-1;1835;72;34;3;31;.912;3560000;0
41992;-1;649;0;0;0;0;.00nan;0;0
41992;85947;649;74;28;2;26;.929;3600000;0
41993;174017;1838;45;34;5;29;.853;3600000;0
41993;-1;649;0;0;0;0;.00nan;0;0
41993;72747;1838;0;0;0;0;.00nan;0;0
41993;85947;649;100;23;0;23;1.000;3600000;0
41994;-1;4538;0;0;0;0;.00nan;0;0
41994;211456;4538;44;23;3;20;.870;3555000;0
41994;-1;646;0;0;0;0;.00nan;0;0
41994;-1;646;86;29;1;28;.966;3600000;0
41995;8942;1835;0;0;0;0;.00nan;0;0
41995;-1;1835;75;27;2;25;.926;3600000;0
41995;211484;1809;0;0;0;0;.00nan;0;0
41995;156545;1809;63;40;4;36;.900;3600000;0
41996;169552;1825;65;23;2;21;.913;3922000;0
41996;-1;1825;0;0;0;0;.00nan;0;0
41996;174806;648;0;0;0;0;.00nan;0;0
41996;-1;648;49;22;3;19;.864;3922000;0
41997;-1;638;0;0;0;0;.00nan;0;0
41997;-1;1813;84;27;1;26;.963;3600000;0
41997;58112;638;78;27;2;25;.926;3564000;0
41997;61683;1813;0;0;0;0;.00nan;0;0
41998;182872;703;0;0;0;0;.00nan;0;0
41998;-1;633;26;7;3;4;.571;444000;0
41998;-1;633;61;27;3;24;.889;3156000;0
41998;-1;703;78;29;2;27;.931;3600000;0
41999;11107;629;98;56;2;54;.964;3524000;0
41999;17625;644;0;0;0;0;.00nan;0;0
41999;185314;644;82;16;0;16;1.000;3600000;0
41999;-1;629;0;0;0;0;.00nan;0;0
42000;-1;4538;34;16;4;12;.750;1093000;0
42000;211456;4538;93;31;1;30;.968;2507000;0
42000;-1;649;0;0;0;0;.00nan;0;0
42000;85947;649;74;24;1;23;.958;3600000;0
42001;211484;1809;40;17;3;14;.824;3600000;0
42001;-1;633;100;42;0;42;1.000;3600000;0
42001;-1;633;0;0;0;0;.00nan;0;0
42001;156545;1809;0;0;0;0;.00nan;0;0
42002;17625;644;0;0;0;0;.00nan;0;0
42002;174017;1838;44;32;5;27;.844;3600000;0
42002;185314;644;47;25;4;21;.840;3600000;0
42002;72747;1838;0;0;0;0;.00nan;0;0
42003;11107;629;0;0;0;0;.00nan;0;0
42003;174806;648;59;21;2;19;.905;3600000;0
42003;-1;648;0;0;0;0;.00nan;0;0
42003;-1;629;86;37;3;34;.919;3597000;0
42004;169552;1825;0;0;0;0;.00nan;0;0
42004;-1;1825;71;31;3;28;.903;3600000;0
42004;-1;1813;48;0;0;0;.00nan;583000;0
42004;61683;1813;41;32;6;26;.813;3017000;0
42005;8942;1835;0;0;0;0;.00nan;0;0
42005;-1;1835;42;37;6;31;.838;3552000;0
42005;-1;646;0;0;0;0;.00nan;0;0
42005;-1;646;55;38;5;33;.868;3600000;0
42006;182872;703;99;43;1;42;.977;3600000;0
42006;-1;703;0;0;0;0;.00nan;0;0
42006;-1;638;0;0;0;0;.00nan;0;0
42006;58112;638;51;32;5;27;.844;3600000;0
42007;169552;1825;0;0;0;0;.00nan;0;0
42007;-1;1825;84;26;1;25;.962;3600000;0
42007;-1;633;65;22;2;20;.909;3582000;0
42007;-1;633;0;0;0;0;.00nan;0;0
42008;-1;4538;83;48;4;44;.917;3600000;0
42008;211456;4538;0;0;0;0;.00nan;0;0
42008;211484;1809;36;28;5;23;.821;3554000;0
42008;156545;1809;0;0;0;0;.00nan;0;0
42009;17625;644;81;34;2;32;.941;3922000;0
42009;-1;649;0;0;0;0;.00nan;0;0
42009;185314;644;0;0;0;0;.00nan;0;0
42009;85947;649;73;29;3;26;.897;3922000;0
42010;8942;1835;0;0;0;0;.00nan;0;0
42010;-1;1835;41;17;3;14;.824;3595000;0
42010;-1;638;0;0;0;0;.00nan;0;0
42010;58112;638;76;25;1;24;.960;3600000;0
42011;174806;648;36;23;4;19;.826;3600000;0
42011;-1;646;71;29;3;26;.897;3600000;0
42011;-1;646;0;0;0;0;.00nan;0;0
42011;-1;648;0;0;0;0;.00nan;0;0
42012;182872;703;41;31;5;26;.839;3600000;0
42012;-1;703;0;0;0;0;.00nan;0;0
42012;-1;1813;60;45;6;39;.867;3599000;0
42012;61683;1813;0;0;0;0;.00nan;0;0
42013;11107;629;80;56;5;51;.911;3600000;0
42013;174017;1838;49;14;2;12;.857;3600000;0
42013;-1;629;0;0;0;0;.00nan;0;0
42013;72747;1838;0;0;0;0;.00nan;0;0
42015;182872;703;56;30;4;26;.867;3600000;0
42015;-1;703;0;0;0;0;.00nan;0;0
42015;-1;646;0;0;0;0;.00nan;0;0
42015;-1;646;58;23;3;20;.870;3600000;0
42017;211484;1809;48;28;4;24;.857;3583000;0
42017;-1;1809;0;0;0;0;.00nan;0;0
42017;-1;648;0;0;0;0;.00nan;0;0
42017;-1;648;61;27;3;24;.889;3600000;0
42019;17625;644;0;0;0;0;.00nan;0;0
42019;185314;644;58;9;1;8;.889;3600000;0
42019;-1;638;0;0;0;0;.00nan;0;0
42019;58112;638;80;36;3;33;.917;3589000;0
42021;169552;1825;79;18;0;18;1.000;2746000;0
42021;-1;1825;22;9;4;5;.556;854000;0
42021;-1;633;80;57;5;52;.912;3600000;0
42021;-1;633;0;0;0;0;.00nan;0;0
42023;174017;1838;60;30;3;27;.900;3600000;0
42023;-1;1813;52;12;1;11;.917;1283000;0
42023;-1;1813;31;26;5;21;.808;2317000;0
42023;72747;1838;0;0;0;0;.00nan;0;0
42025;164404;649;0;0;0;0;.00nan;0;0
42025;190502;629;58;45;5;40;.889;3600000;0
42025;-1;629;0;0;0;0;.00nan;0;0
42025;85947;649;76;31;2;29;.935;3600000;0
42027;8942;1835;0;0;0;0;.00nan;0;0
42027;-1;1835;65;36;4;32;.889;3531000;0
42027;-1;4538;69;23;2;21;.913;3600000;0
42027;211456;4538;0;0;0;0;.00nan;0;0
42029;164404;649;0;0;0;0;.00nan;0;0
42029;-1;648;0;0;0;0;.00nan;0;0
42029;-1;648;100;25;0;25;1.000;3600000;0
42029;85947;649;57;21;2;19;.905;3513000;0
42031;17625;644;0;0;0;0;.00nan;0;0
42031;-1;4538;18;23;6;17;.739;2339000;0
42031;211456;4538;50;7;1;6;.857;1261000;0
42031;185314;644;79;29;1;28;.966;3600000;0
42033;8942;1835;86;26;1;25;.962;3600000;0
42033;-1;1835;0;0;0;0;.00nan;0;0
42033;-1;1813;80;39;3;36;.923;3553000;0
42033;-1;1813;0;0;0;0;.00nan;0;0
42035;174017;1838;75;23;1;22;.957;3600000;0
42035;-1;638;0;0;0;0;.00nan;0;0
42035;58112;638;53;45;6;39;.867;3600000;0
42035;72747;1838;0;0;0;0;.00nan;0;0
42037;169552;1825;0;0;0;0;.00nan;0;0
42037;-1;1825;82;24;1;23;.958;3600000;0
42037;-1;633;40;29;5;24;.828;3600000;0
42037;-1;633;0;0;0;0;.00nan;0;0
42039;182872;703;52;18;3;15;.833;3600000;0
42039;190502;629;0;0;0;0;.00nan;0;0
42039;-1;703;0;0;0;0;.00nan;0;0
42039;-1;629;66;49;5;44;.898;3576000;0
42041;211484;1809;40;18;3;15;.833;1413000;0
42041;-1;646;0;0;0;0;.00nan;0;0
42041;-1;1809;23;25;6;19;.760;2187000;0
42041;-1;646;46;16;3;13;.813;3600000;0
42043;174017;1838;99;29;1;28;.966;3600000;0
42043;190502;629;78;35;2;33;.943;3600000;0
42043;-1;629;0;0;0;0;.00nan;0;0
42043;72747;1838;0;0;0;0;.00nan;0;0
42045;8942;1835;0;0;0;0;.00nan;0;0
42045;-1;1835;69;27;3;24;.889;3698000;0
42045;169552;1825;66;39;4;35;.897;3698000;0
42045;-1;1825;0;0;0;0;.00nan;0;0
42047;182872;703;0;0;0;0;.00nan;0;0
42047;211484;1809;0;0;0;0;.00nan;0;0
42047;-1;703;23;21;5;16;.762;3542000;0
42047;-1;1809;49;29;4;25;.862;3600000;0
42049;17625;644;30;7;3;4;.571;414000;0
42049;185314;644;77;19;1;18;.947;3186000;0
42049;-1;638;61;47;6;41;.872;3558000;0
42049;58112;638;0;0;0;0;.00nan;0;0
42051;-1;4538;0;0;0;0;.00nan;0;0
42051;211456;4538;31;23;5;18;.783;3600000;0
42051;-1;648;0;0;0;0;.00nan;0;0
42051;-1;648;72;23;2;21;.913;3600000;0
42053;164404;649;15;15;6;9;.600;1540000;0
42053;-1;646;62;30;3;27;.900;3600000;0
42053;-1;646;0;0;0;0;.00nan;0;0
42053;85947;649;58;12;1;11;.917;2060000;0
42055;-1;633;0;0;0;0;.00nan;0;0
42055;-1;633;38;39;7;32;.821;4299000;0
42055;-1;1813;0;0;0;0;.00nan;0;0
42055;-1;1813;47;41;6;35;.854;4299000;0
42057;8942;1835;0;0;0;0;.00nan;0;0
42057;164404;649;0;0;0;0;.00nan;0;0
42057;-1;1835;66;27;2;25;.926;3600000;0
42057;85947;649;79;42;3;39;.929;3600000;0
42059;182872;703;70;29;3;26;.897;3600000;0
42059;-1;633;41;40;6;34;.850;3600000;0
42059;-1;633;0;0;0;0;.00nan;0;0
42059;-1;703;0;0;0;0;.00nan;0;0
42061;169552;1825;0;0;0;0;.00nan;0;0
42061;-1;1825;55;17;2;15;.882;3600000;0
42061;-1;638;71;14;0;14;1.000;1460000;0
42061;58112;638;17;29;7;22;.759;2140000;0
42063;174017;1838;69;37;2;35;.946;8756000;0
42063;-1;648;0;0;0;0;.00nan;0;0
42063;-1;648;93;81;3;78;.963;8756000;0
42063;72747;1838;0;0;0;0;.00nan;0;0
42065;211484;1809;51;27;3;24;.889;3600000;0
42065;-1;646;0;0;0;0;.00nan;0;0
42065;-1;1809;0;0;0;0;.00nan;0;0
42065;-1;646;79;36;2;34;.944;3600000;0
42067;17625;644;87;16;0;16;1.000;3600000;0
42067;190502;629;70;55;6;49;.891;3600000;0
42067;185314;644;0;0;0;0;.00nan;0;0
42067;-1;629;0;0;0;0;.00nan;0;0
42069;-1;4538;24;19;6;13;.684;3582000;0
42069;211456;4538;0;0;0;0;.00nan;0;0
42069;-1;1813;48;25;4;21;.840;3600000;0
42069;-1;1813;0;0;0;0;.00nan;0;0
42071;17625;644;63;16;1;15;.938;3600000;0
42071;-1;633;0;0;0;0;.00nan;0;0
42071;185314;644;0;0;0;0;.00nan;0;0
42071;-1;633;81;48;3;45;.938;3585000;0
42073;169552;1825;41;16;3;13;.813;3600000;0
42073;-1;1825;0;0;0;0;.00nan;0;0
42073;-1;648;63;39;4;35;.897;3568000;0
42073;-1;648;0;0;0;0;.00nan;0;0
42075;-1;646;74;20;1;19;.950;3600000;0
42075;-1;646;0;0;0;0;.00nan;0;0
42075;-1;638;0;0;0;0;.00nan;0;0
42075;58112;638;98;50;3;47;.940;3600000;0
42077;164404;649;82;16;0;16;1.000;3600000;0
42077;211484;1809;0;0;0;0;.00nan;0;0
42077;-1;1809;66;42;4;38;.905;3600000;0
42077;85947;649;0;0;0;0;.00nan;0;0
42079;182872;703;0;0;0;0;.00nan;0;0
42079;-1;703;85;24;1;23;.958;3600000;0
42079;-1;1813;48;13;3;10;.769;942000;0
42079;-1;1813;53;40;6;34;.850;2658000;0
42081;174017;1838;0;0;0;0;.00nan;0;0
42081;-1;4538;0;0;0;0;.00nan;0;0
42081;211456;4538;62;40;3;37;.925;4855000;0
42081;72747;1838;63;34;4;30;.882;4855000;0
42083;8942;1835;63;19;1;18;.947;3600000;0
42083;-1;1835;0;0;0;0;.00nan;0;0
42083;190502;629;0;0;0;0;.00nan;0;0
42083;-1;629;87;53;4;49;.925;3600000;0
42085;174017;1838;59;30;3;27;.900;3600000;0
42085;-1;4538;71;23;1;22;.957;3600000;0
42085;211456;4538;0;0;0;0;.00nan;0;0
42085;72747;1838;0;0;0;0;.00nan;0;0
42087;169552;1825;0;0;0;0;.00nan;0;0
42087;-1;1825;33;13;3;10;.769;3600000;0
42087;190502;629;72;58;6;52;.897;3600000;0
42087;-1;629;0;0;0;0;.00nan;0;0
42089;8942;1835;0;0;0;0;.00nan;0;0
42089;-1;1835;62;27;3;24;.889;3600000;0
42089;-1;646;0;0;0;0;.00nan;0;0
42089;-1;646;99;47;1;46;.979;3600000;0
42091;211484;1809;79;36;3;33;.917;3600000;0
42091;-1;1809;0;0;0;0;.00nan;0;0
42091;-1;648;0;0;0;0;.00nan;0;0
42091;-1;648;50;27;4;23;.852;3577000;0
42093;17625;644;88;25;1;24;.960;3600000;0
42093;185314;644;0;0;0;0;.00nan;0;0
42093;-1;1813;0;0;0;0;.00nan;0;0
42093;-1;1813;33;48;8;40;.833;3600000;0
42095;182872;703;100;24;0;24;1.000;3600000;0
42095;-1;633;70;39;4;35;.897;3600000;0
42095;-1;633;0;0;0;0;.00nan;0;0
42095;-1;703;0;0;0;0;.00nan;0;0
42097;164404;649;53;27;4;23;.852;3600000;0
42097;-1;638;0;0;0;0;.00nan;0;0
42097;58112;638;54;51;7;44;.863;3600000;0
42097;85947;649;0;0;0;0;.00nan;0;0
42099;8942;1835;20;19;6;13;.684;3600000;0
42099;-1;1835;0;0;0;0;.00nan;0;0
42099;169552;1825;17;31;7;24;.774;3344000;0
42099;-1;1825;58;5;0;5;1.000;223000;0
42101;17625;644;0;0;0;0;.00nan;0;0
42101;190502;629;0;0;0;0;.00nan;0;0
42101;185314;644;63;11;1;10;.909;3600000;0
42101;-1;629;72;48;5;43;.896;3600000;0
42103;-1;4538;0;0;0;0;.00nan;0;0
42103;211456;4538;55;29;3;26;.897;3556000;0
42103;-1;633;0;0;0;0;.00nan;0;0
42103;-1;633;88;27;1;26;.963;3600000;0
42105;182872;703;67;42;4;38;.905;3600000;0
42105;-1;703;0;0;0;0;.00nan;0;0
42105;-1;646;68;26;3;23;.885;3600000;0
42105;-1;646;0;0;0;0;.00nan;0;0
42107;174017;1838;0;0;0;0;.00nan;0;0
42107;-1;648;47;14;2;12;.857;3574000;0
42107;-1;648;0;0;0;0;.00nan;0;0
42107;72747;1838;81;25;1;24;.960;3600000;0
42109;211484;1809;0;0;0;0;.00nan;0;0
42109;-1;1809;51;27;3;24;.889;3600000;0
42109;-1;638;33;34;7;27;.794;3138000;0
42109;58112;638;44;4;1;3;.750;462000;0
42111;164404;649;0;0;0;0;.00nan;0;0
42111;-1;1813;93;59;4;55;.932;3985000;0
42111;-1;1813;0;0;0;0;.00nan;0;0
42111;85947;649;74;30;3;27;.900;3985000;0
1059;-1;4538;39;31;5;26;.839;3600000;0
1059;211456;4538;0;0;0;0;.00nan;0;0
1059;-1;633;98;40;2;38;.950;3600000;0
1059;-1;633;0;0;0;0;.00nan;0;0
1060;182872;703;52;33;4;29;.879;3600000;0
1060;174806;648;93;25;0;25;1.000;3600000;0
1060;-1;703;0;0;0;0;.00nan;0;0
1060;-1;648;0;0;0;0;.00nan;0;0
1061;-1;4538;61;41;5;36;.878;3600000;0
1061;211456;4538;0;0;0;0;.00nan;0;0
1061;-1;633;22;31;6;25;.806;3239000;0
1061;-1;633;48;0;0;0;.00nan;306000;0
1062;182872;703;47;43;6;37;.860;3600000;0
1062;174806;648;0;0;0;0;.00nan;0;0
1062;-1;703;0;0;0;0;.00nan;0;0
1062;-1;648;83;25;1;24;.960;3600000;0
1167;-1;4538;73;27;3;24;.889;3642000;0
1167;211456;4538;0;0;0;0;.00nan;0;0
1167;-1;633;77;49;4;45;.918;3646000;0
1167;-1;633;0;0;0;0;.00nan;0;0
1232;17625;644;0;0;0;0;.00nan;0;0
1232;174806;648;0;0;0;0;.00nan;0;0
1232;185314;644;89;24;1;23;.958;4200000;0
1232;-1;648;97;32;1;31;.969;4200000;0
1233;8942;1835;0;0;0;0;.00nan;0;0
1233;-1;1835;88;35;1;34;.971;3600000;0
1233;-1;646;0;0;0;0;.00nan;0;0
1233;-1;646;66;22;2;20;.909;3551000;0
1234;169552;1825;0;0;0;0;.00nan;0;0
1234;174017;1838;49;24;4;20;.833;3600000;0
1234;-1;1825;81;24;1;23;.958;3600000;0
1234;72747;1838;0;0;0;0;.00nan;0;0
1235;-1;4538;43;26;4;22;.846;3600000;0
1235;211456;4538;0;0;0;0;.00nan;0;0
1235;-1;649;0;0;0;0;.00nan;0;0
1235;85947;649;70;19;1;18;.947;3600000;0
1236;17625;644;0;0;0;0;.00nan;0;0
1236;174806;648;0;0;0;0;.00nan;0;0
1236;185314;644;58;24;3;21;.875;4200000;0
1236;-1;648;100;50;3;47;.940;4200000;0
1237;8942;1835;0;0;0;0;.00nan;0;0
1237;-1;1835;83;32;2;30;.938;3600000;0
1237;-1;646;51;19;3;16;.842;2491000;0
1237;-1;646;26;12;4;8;.667;1109000;0
1238;169552;1825;0;0;0;0;.00nan;0;0
1238;174017;1838;74;41;5;36;.878;3600000;0
1238;-1;1825;86;29;2;27;.931;3600000;0
1238;72747;1838;0;0;0;0;.00nan;0;0
1239;-1;4538;91;30;1;29;.967;3600000;0
1239;211456;4538;0;0;0;0;.00nan;0;0
1239;-1;649;0;0;0;0;.00nan;0;0
1239;85947;649;65;24;2;22;.917;3565000;0
1240;17625;644;0;0;0;0;.00nan;0;0
1240;174806;648;0;0;0;0;.00nan;0;0
1240;185314;644;56;29;4;25;.862;3551000;0
1240;-1;648;60;26;3;23;.885;3600000;0
1241;8942;1835;0;0;0;0;.00nan;0;0
1241;-1;1835;80;41;4;37;.902;3552000;0
1241;-1;646;0;0;0;0;.00nan;0;0
1241;-1;646;78;36;3;33;.917;3600000;0
1242;169552;1825;0;0;0;0;.00nan;0;0
1242;174017;1838;72;33;3;30;.909;3559000;0
1242;-1;1825;55;19;2;17;.895;3600000;0
1242;72747;1838;0;0;0;0;.00nan;0;0
1243;-1;4538;87;38;2;36;.947;3600000;0
1243;211456;4538;0;0;0;0;.00nan;0;0
1243;-1;649;0;0;0;0;.00nan;0;0
1243;85947;649;83;27;1;26;.963;3600000;0
1244;17625;644;0;0;0;0;.00nan;0;0
1244;174806;648;0;0;0;0;.00nan;0;0
1244;185314;644;77;32;2;30;.938;3600000;0
1244;-1;648;58;27;3;24;.889;3600000;0
1245;8942;1835;0;0;0;0;.00nan;0;0
1245;-1;1835;72;26;2;24;.923;3600000;0
1245;-1;646;0;0;0;0;.00nan;0;0
1245;-1;646;78;38;4;34;.895;3574000;0
1246;169552;1825;0;0;0;0;.00nan;0;0
1246;174017;1838;56;24;3;21;.875;3554000;0
1246;-1;1825;66;21;2;19;.905;3600000;0
1246;72747;1838;0;0;0;0;.00nan;0;0
1247;-1;4538;67;38;4;34;.895;3845000;0
1247;211456;4538;0;0;0;0;.00nan;0;0
1247;-1;649;0;0;0;0;.00nan;0;0
1247;85947;649;40;21;5;16;.762;3845000;0
1519;17625;644;67;21;1;20;.952;3445000;0
1519;174806;648;0;0;0;0;.00nan;0;0
1519;185314;644;22;4;3;1;.250;152000;0
1519;-1;648;96;38;2;36;.947;3600000;0
1520;8942;1835;0;0;0;0;.00nan;0;0
1520;-1;1835;45;31;5;26;.839;3541000;0
1520;-1;646;0;0;0;0;.00nan;0;0
1520;-1;646;91;39;3;36;.923;3600000;0
1521;-1;4538;92;33;1;32;.970;3600000;0
1521;211456;4538;0;0;0;0;.00nan;0;0
1521;-1;649;0;0;0;0;.00nan;0;0
1521;85947;649;45;28;5;23;.821;3600000;0
1570;17625;644;0;0;0;0;.00nan;0;0
1570;174806;648;0;0;0;0;.00nan;0;0
1570;185314;644;100;29;0;29;1.000;3600000;0
1570;-1;648;45;25;4;21;.840;3600000;0
1571;8942;1835;0;0;0;0;.00nan;0;0
1571;-1;1835;49;25;4;21;.840;3600000;0
1571;-1;646;0;0;0;0;.00nan;0;0
1571;-1;646;55;37;5;32;.865;3578000;0
1572;-1;4538;28;20;5;15;.750;1880000;0
1572;211456;4538;43;20;3;17;.850;1720000;0
1572;-1;649;0;0;0;0;.00nan;0;0
1572;85947;649;71;28;2;26;.929;3600000;0
1612;17625;644;0;0;0;0;.00nan;0;0
1612;174806;648;0;0;0;0;.00nan;0;0
1612;185314;644;61;22;3;19;.864;4200000;0
1612;-1;648;96;55;3;52;.945;4200000;0
1613;-1;4538;45;45;6;39;.867;4200000;0
1613;211456;4538;0;0;0;0;.00nan;0;0
1613;-1;649;76;16;0;16;1.000;2634000;0
1613;85947;649;17;21;6;15;.714;1566000;0
1646;17625;644;0;0;0;0;.00nan;0;0
1646;169552;1825;54;28;4;24;.857;2516000;0
1646;-1;1825;25;9;4;5;.556;1084000;0
1646;185314;644;86;25;1;24;.960;3600000;0
1647;8942;1835;0;0;0;0;.00nan;0;0
1647;-1;1835;42;28;5;23;.821;3512000;0
1647;-1;649;0;0;0;0;.00nan;0;0
1647;85947;649;64;35;4;31;.886;3600000;0
1648;17625;644;0;0;0;0;.00nan;0;0
1648;169552;1825;0;0;0;0;.00nan;0;0
1648;-1;1825;67;39;4;35;.897;3572000;0
1648;185314;644;59;23;2;21;.913;3600000;0
1649;8942;1835;42;4;1;3;.750;456000;0
1649;-1;1835;50;42;7;35;.833;3144000;0
1649;-1;649;0;0;0;0;.00nan;0;0
1649;85947;649;99;35;1;34;.971;3600000;0
1650;17625;644;0;0;0;0;.00nan;0;0
1650;169552;1825;60;40;4;36;.900;3258000;0
1650;-1;1825;26;5;3;2;.400;342000;0
1650;185314;644;71;15;1;14;.933;3600000;0
1651;8942;1835;0;0;0;0;.00nan;0;0
1651;-1;1835;61;28;3;25;.893;3543000;0
1651;-1;649;0;0;0;0;.00nan;0;0
1651;85947;649;62;23;2;21;.913;3600000;0
1652;17625;644;0;0;0;0;.00nan;0;0
1652;169552;1825;0;0;0;0;.00nan;0;0
1652;-1;1825;58;34;3;31;.912;4200000;0
1652;185314;644;73;37;3;34;.919;4168000;0
1653;8942;1835;0;0;0;0;.00nan;0;0
1653;-1;1835;74;20;1;19;.950;3600000;0
1653;-1;649;0;0;0;0;.00nan;0;0
1653;85947;649;75;34;3;31;.912;3552000;0
1887;8942;1835;0;0;0;0;.00nan;0;0
1887;-1;1835;91;27;1;26;.963;3600000;0
1887;-1;649;0;0;0;0;.00nan;0;0
1887;85947;649;67;29;3;26;.897;3536000;0
1921;8942;1835;0;0;0;0;.00nan;0;0
1921;-1;1835;60;20;2;18;.900;3528000;0
1921;-1;649;0;0;0;0;.00nan;0;0
1921;85947;649;100;37;0;37;1.000;3600000;0
1955;17625;644;66;8;0;8;1.000;973000;0
1955;-1;649;0;0;0;0;.00nan;0;0
1955;185314;644;17;18;6;12;.667;2541000;0
1955;85947;649;74;37;4;33;.892;3600000;0
1956;17625;644;71;30;2;28;.933;3600000;0
1956;-1;649;0;0;0;0;.00nan;0;0
1956;185314;644;0;0;0;0;.00nan;0;0
1956;85947;649;98;44;3;41;.932;3600000;0
1957;17625;644;72;24;1;23;.958;3600000;0
1957;-1;649;0;0;0;0;.00nan;0;0
1957;185314;644;0;0;0;0;.00nan;0;0
1957;85947;649;74;37;4;33;.892;3600000;0
1958;17625;644;57;25;3;22;.880;3727000;0
1958;-1;649;0;0;0;0;.00nan;0;0
1958;185314;644;0;0;0;0;.00nan;0;0
1958;85947;649;100;48;2;46;.958;3727000;0
2147;17625;644;71;23;1;22;.957;3600000;0
2147;-1;649;0;0;0;0;.00nan;0;0
2147;185314;644;0;0;0;0;.00nan;0;0
2147;85947;649;75;36;2;34;.944;3600000;0
2165;17625;644;52;16;2;14;.875;3600000;0
2165;-1;649;0;0;0;0;.00nan;0;0
2165;185314;644;0;0;0;0;.00nan;0;0
2165;85947;649;61;42;5;37;.881;3600000;0
42112;-1;841;53;32;4;28;.875;3600000;0
42112;47754;841;0;0;0;0;.00nan;0;0
42112;148069;844;72;39;3;36;.923;3600000;0
42112;152266;844;0;0;0;0;.00nan;0;0
42113;805;846;73;28;2;26;.929;3600000;0
42113;173073;843;26;25;6;19;.760;2203000;0
42113;-1;843;59;13;1;12;.923;1397000;0
42113;-1;846;0;0;0;0;.00nan;0;0
42114;8501;2488;0;0;0;0;.00nan;0;0
42114;180929;2488;69;33;3;30;.909;3591000;0
42114;94240;845;64;20;2;18;.900;3600000;0
42114;147962;845;0;0;0;0;.00nan;0;0
42115;175063;2508;75;42;3;39;.929;3600000;0
42115;-1;2493;0;0;0;0;.00nan;0;0
42115;180279;2493;75;16;1;15;.938;3600000;0
42115;147977;2508;0;0;0;0;.00nan;0;0
42116;193985;835;0;0;0;0;.00nan;0;0
42116;-1;2517;71;34;3;31;.912;3600000;0
42116;216931;835;50;12;2;10;.833;3600000;0
42116;61292;2517;0;0;0;0;.00nan;0;0
42117;8501;2488;0;0;0;0;.00nan;0;0
42117;180929;2488;62;38;5;33;.868;3600000;0
42117;148069;844;0;0;0;0;.00nan;0;0
42117;152266;844;69;24;2;22;.917;3600000;0
42118;805;846;41;29;5;24;.828;3600000;0
42118;-1;846;0;0;0;0;.00nan;0;0
42118;94240;845;83;27;1;26;.963;3600000;0
42118;147962;845;0;0;0;0;.00nan;0;0
42119;-1;2517;86;35;1;34;.971;3600000;0
42119;-1;841;52;24;3;21;.875;3521000;0
42119;47754;841;0;0;0;0;.00nan;0;0
42119;61292;2517;0;0;0;0;.00nan;0;0
42120;193985;835;67;26;2;24;.923;3558000;0
42120;175063;2508;99;40;1;39;.975;3600000;0
42120;216931;835;0;0;0;0;.00nan;0;0
42120;147977;2508;0;0;0;0;.00nan;0;0
42121;173073;843;0;0;0;0;.00nan;0;0
42121;-1;2493;0;0;0;0;.00nan;0;0
42121;180279;2493;64;15;1;14;.933;3588000;0
42121;-1;843;100;42;0;42;1.000;3600000;0
42122;805;846;82;40;3;37;.925;3567000;0
42122;193985;835;70;18;1;17;.944;3600000;0
42122;216931;835;0;0;0;0;.00nan;0;0
42122;-1;846;0;0;0;0;.00nan;0;0
42123;8501;2488;86;26;1;25;.962;3600000;0
42123;-1;2493;0;0;0;0;.00nan;0;0
42123;180279;2493;27;32;6;26;.813;3600000;0
42123;180929;2488;0;0;0;0;.00nan;0;0
42124;173073;843;0;0;0;0;.00nan;0;0
42124;-1;843;58;38;5;33;.868;3600000;0
42124;94240;845;68;24;3;21;.875;3600000;0
42124;147962;845;0;0;0;0;.00nan;0;0
42125;-1;2517;70;34;4;30;.882;3568000;0
42125;61292;2517;0;0;0;0;.00nan;0;0
42125;148069;844;0;0;0;0;.00nan;0;0
42125;152266;844;69;28;3;25;.893;3600000;0
42126;175063;2508;0;0;0;0;.00nan;0;0
42126;-1;841;77;22;1;21;.955;3600000;0
42126;47754;841;0;0;0;0;.00nan;0;0
42126;147977;2508;75;40;3;37;.925;3543000;0
42127;8501;2488;0;0;0;0;.00nan;0;0
42127;-1;841;76;31;2;29;.935;3600000;0
42127;180929;2488;73;32;3;29;.906;3574000;0
42127;47754;841;0;0;0;0;.00nan;0;0
42128;805;846;79;27;1;26;.963;3600000;0
42128;175063;2508;22;29;7;22;.759;2415000;0
42128;-1;846;0;0;0;0;.00nan;0;0
42128;147977;2508;62;18;1;17;.944;1185000;0
42129;173073;843;42;26;4;22;.846;3600000;0
42129;-1;2517;87;33;2;31;.939;3600000;0
42129;-1;843;0;0;0;0;.00nan;0;0
42129;61292;2517;0;0;0;0;.00nan;0;0
42130;-1;2493;79;33;3;30;.909;3557000;0
42130;180279;2493;0;0;0;0;.00nan;0;0
42130;94240;845;66;25;2;23;.920;3600000;0
42130;147962;845;0;0;0;0;.00nan;0;0
42131;193985;835;73;23;1;22;.957;3600000;0
42131;216931;835;0;0;0;0;.00nan;0;0
42131;148069;844;0;0;0;0;.00nan;0;0
42131;152266;844;79;39;3;36;.923;3583000;0
42132;805;846;61;40;5;35;.875;3600000;0
42132;-1;841;76;21;1;20;.952;3600000;0
42132;-1;846;0;0;0;0;.00nan;0;0
42132;47754;841;0;0;0;0;.00nan;0;0
42133;173073;843;0;0;0;0;.00nan;0;0
42133;-1;843;66;43;5;38;.884;3600000;0
42133;148069;844;73;18;1;17;.944;3600000;0
42133;152266;844;0;0;0;0;.00nan;0;0
42134;8501;2488;86;43;4;39;.907;3900000;0
42134;175063;2508;0;0;0;0;.00nan;0;0
42134;180929;2488;0;0;0;0;.00nan;0;0
42134;147977;2508;69;37;4;33;.892;3900000;0
42135;-1;2517;89;31;1;30;.968;3600000;0
42135;-1;2493;0;0;0;0;.00nan;0;0
42135;180279;2493;63;25;2;23;.920;3562000;0
42135;61292;2517;0;0;0;0;.00nan;0;0
42136;193985;835;67;16;1;15;.938;3600000;0
42136;216931;835;0;0;0;0;.00nan;0;0
42136;94240;845;96;47;3;44;.936;3600000;0
42136;147962;845;0;0;0;0;.00nan;0;0
42137;805;846;89;38;2;36;.947;3600000;0
42137;180279;2493;0;0;0;0;.00nan;0;0
42137;185506;2493;63;31;3;28;.903;3548000;0
42137;-1;846;0;0;0;0;.00nan;0;0
42138;-1;841;51;30;5;25;.833;3269000;0
42138;47754;841;58;7;0;7;1.000;331000;0
42138;94240;845;0;0;0;0;.00nan;0;0
42138;147962;845;69;20;1;19;.950;3600000;0
42139;8501;2488;0;0;0;0;.00nan;0;0
42139;-1;2517;65;35;4;31;.886;3900000;0
42139;180929;2488;44;25;4;21;.840;3900000;0
42139;61292;2517;0;0;0;0;.00nan;0;0
42140;175063;2508;99;40;1;39;.975;3600000;0
42140;147977;2508;0;0;0;0;.00nan;0;0
42140;148069;844;0;0;0;0;.00nan;0;0
42140;152266;844;44;12;2;10;.833;3565000;0
42141;94240;845;72;41;4;37;.902;3556000;0
42141;147962;845;0;0;0;0;.00nan;0;0
42141;148069;844;48;20;3;17;.850;3600000;0
42141;152266;844;0;0;0;0;.00nan;0;0
42142;173073;843;60;9;0;9;1.000;877000;0
42142;-1;841;0;0;0;0;.00nan;0;0
42142;-1;843;48;46;6;40;.870;2723000;0
42142;47754;841;48;11;2;9;.818;3600000;0
42143;805;846;46;22;4;18;.818;3600000;0
42143;8501;2488;0;0;0;0;.00nan;0;0
42143;180929;2488;56;36;5;31;.861;3549000;0
42143;-1;846;0;0;0;0;.00nan;0;0
42144;-1;2517;64;22;2;20;.909;3600000;0
42144;175063;2508;60;39;5;34;.872;3600000;0
42144;61292;2517;0;0;0;0;.00nan;0;0
42144;147977;2508;0;0;0;0;.00nan;0;0
42145;193985;835;60;36;4;32;.889;3574000;0
42145;216931;835;0;0;0;0;.00nan;0;0
42145;180279;2493;65;28;3;25;.893;3600000;0
42145;185506;2493;0;0;0;0;.00nan;0;0
42146;805;846;0;0;0;0;.00nan;0;0
42146;-1;2517;75;26;2;24;.923;3679000;0
42146;-1;846;70;36;3;33;.917;3679000;0
42146;61292;2517;0;0;0;0;.00nan;0;0
42147;8501;2488;0;0;0;0;.00nan;0;0
42147;173073;843;0;0;0;0;.00nan;0;0
42147;180929;2488;52;21;3;18;.857;3600000;0
42147;-1;843;55;39;6;33;.846;3600000;0
42148;180279;2493;40;29;5;24;.828;2144000;0
42148;185506;2493;47;6;1;5;.833;1456000;0
42148;148069;844;0;0;0;0;.00nan;0;0
42148;152266;844;61;27;3;24;.889;3600000;0
42149;193985;835;0;0;0;0;.00nan;0;0
42149;216931;835;79;21;1;20;.952;3600000;0
42149;-1;841;54;41;5;36;.878;3600000;0
42149;47754;841;0;0;0;0;.00nan;0;0
42150;805;846;81;40;4;36;.900;3900000;0
42150;-1;846;0;0;0;0;.00nan;0;0
42150;148069;844;47;28;4;24;.857;3900000;0
42150;152266;844;0;0;0;0;.00nan;0;0
42151;8501;2488;0;0;0;0;.00nan;0;0
42151;193985;835;0;0;0;0;.00nan;0;0
42151;216931;835;67;34;4;30;.882;3527000;0
42151;180929;2488;57;22;3;19;.864;3600000;0
42152;-1;2517;0;0;0;0;.00nan;0;0
42152;61292;2517;57;25;3;22;.880;3600000;0
42152;94240;845;51;30;4;26;.867;3544000;0
42152;147962;845;0;0;0;0;.00nan;0;0
42153;173073;843;51;44;6;38;.864;3259000;0
42153;175063;2508;49;27;5;22;.815;3600000;0
42153;-1;843;55;5;0;5;1.000;296000;0
42153;147977;2508;0;0;0;0;.00nan;0;0
42154;-1;841;62;27;3;24;.889;3600000;0
42154;47754;841;0;0;0;0;.00nan;0;0
42154;148069;844;0;0;0;0;.00nan;0;0
42154;152266;844;96;24;0;24;1.000;3600000;0
42155;8501;2488;0;0;0;0;.00nan;0;0
42155;180929;2488;55;44;6;38;.864;3600000;0
42155;94240;845;78;25;2;23;.920;3600000;0
42155;147962;845;0;0;0;0;.00nan;0;0
42156;193985;835;65;23;2;21;.913;3600000;0
42156;-1;2517;31;17;4;13;.765;1112000;0
42156;216931;835;0;0;0;0;.00nan;0;0
42156;61292;2517;66;11;0;11;1.000;2433000;0
42157;175063;2508;0;0;0;0;.00nan;0;0
42157;180279;2493;84;28;1;27;.964;3636000;0
42157;185506;2493;0;0;0;0;.00nan;0;0
42157;147977;2508;93;47;2;45;.957;3636000;0
42158;805;846;96;37;1;36;.973;3600000;0
42158;173073;843;0;0;0;0;.00nan;0;0
42158;-1;843;55;44;6;38;.864;3600000;0
42158;-1;846;0;0;0;0;.00nan;0;0
42159;-1;841;67;28;2;26;.929;3900000;0
42159;180279;2493;81;32;2;30;.938;3900000;0
42159;185506;2493;0;0;0;0;.00nan;0;0
42159;47754;841;0;0;0;0;.00nan;0;0
42160;805;846;100;33;1;32;.970;3600000;0
42160;-1;846;0;0;0;0;.00nan;0;0
42160;94240;845;50;32;4;28;.875;3600000;0
42160;147962;845;0;0;0;0;.00nan;0;0
42161;8501;2488;84;37;2;35;.946;3600000;0
42161;180929;2488;0;0;0;0;.00nan;0;0
42161;148069;844;0;0;0;0;.00nan;0;0
42161;152266;844;90;33;3;30;.909;3587000;0
42162;173073;843;61;8;0;8;1.000;474000;0
42162;180279;2493;80;31;2;29;.935;3600000;0
42162;185506;2493;0;0;0;0;.00nan;0;0
42162;-1;843;73;43;4;39;.907;3094000;0
42163;193985;835;62;22;3;19;.864;3600000;0
42163;175063;2508;73;52;6;46;.885;3600000;0
42163;216931;835;0;0;0;0;.00nan;0;0
42163;147977;2508;0;0;0;0;.00nan;0;0
42164;-1;2517;55;25;3;22;.880;3600000;0
42164;-1;841;0;0;0;0;.00nan;0;0
42164;47754;841;75;30;2;28;.933;3600000;0
42164;61292;2517;0;0;0;0;.00nan;0;0
42165;175063;2508;58;41;6;35;.854;3549000;0
42165;-1;841;58;37;5;32;.865;3600000;0
42165;47754;841;0;0;0;0;.00nan;0;0
42165;147977;2508;0;0;0;0;.00nan;0;0
42166;173073;843;70;35;3;32;.914;3600000;0
42166;-1;843;0;0;0;0;.00nan;0;0
42166;94240;845;73;21;1;20;.952;3600000;0
42166;147962;845;0;0;0;0;.00nan;0;0
42167;8501;2488;0;0;0;0;.00nan;0;0
42167;180279;2493;70;17;2;15;.882;3900000;0
42167;180929;2488;74;28;2;26;.929;3887000;0
42167;185506;2493;0;0;0;0;.00nan;0;0
42168;805;846;69;38;4;34;.895;3600000;0
42168;193985;835;0;0;0;0;.00nan;0;0
42168;216931;835;75;25;1;24;.960;3600000;0
42168;-1;846;0;0;0;0;.00nan;0;0
42169;805;846;84;33;2;31;.939;3900000;0
42169;-1;841;96;40;2;38;.950;3900000;0
42169;-1;846;0;0;0;0;.00nan;0;0
42169;47754;841;0;0;0;0;.00nan;0;0
42170;193985;835;0;0;0;0;.00nan;0;0
42170;216931;835;27;19;5;14;.737;3600000;0
42170;94240;845;61;47;6;41;.872;3584000;0
42170;147962;845;0;0;0;0;.00nan;0;0
42171;-1;2517;47;42;6;36;.857;3600000;0
42171;180279;2493;100;37;0;37;1.000;3600000;0
42171;185506;2493;0;0;0;0;.00nan;0;0
42171;61292;2517;0;0;0;0;.00nan;0;0
42172;8501;2488;0;0;0;0;.00nan;0;0
42172;175063;2508;0;0;0;0;.00nan;0;0
42172;180929;2488;74;19;1;18;.947;3600000;0
42172;147977;2508;71;35;3;32;.914;3600000;0
42173;173073;843;0;0;0;0;.00nan;0;0
42173;-1;843;94;48;3;45;.938;3710000;0
42173;148069;844;0;0;0;0;.00nan;0;0
42173;152266;844;90;35;2;33;.943;3710000;0
42174;-1;841;84;35;2;33;.943;3520000;0
42174;47754;841;0;0;0;0;.00nan;0;0
42174;94240;845;97;26;0;26;1.000;3600000;0
42174;147962;845;0;0;0;0;.00nan;0;0
42175;8501;2488;72;24;2;22;.917;3600000;0
42175;-1;2517;38;32;5;27;.844;3600000;0
42175;180929;2488;0;0;0;0;.00nan;0;0
42175;61292;2517;0;0;0;0;.00nan;0;0
42176;805;846;62;40;4;36;.900;3600000;0
42176;180279;2493;74;35;3;32;.914;3600000;0
42176;185506;2493;0;0;0;0;.00nan;0;0
42176;-1;846;0;0;0;0;.00nan;0;0
42177;193985;835;62;20;2;18;.900;3679000;0
42177;173073;843;92;50;3;47;.940;3679000;0
42177;216931;835;0;0;0;0;.00nan;0;0
42177;-1;843;0;0;0;0;.00nan;0;0
42178;805;846;94;17;0;17;1.000;3600000;0
42178;8501;2488;0;0;0;0;.00nan;0;0
42178;180929;2488;81;30;1;29;.967;3594000;0
42178;-1;846;0;0;0;0;.00nan;0;0
42179;94240;845;61;28;3;25;.893;3600000;0
42179;147962;845;0;0;0;0;.00nan;0;0
42179;148069;844;0;0;0;0;.00nan;0;0
42179;152266;844;58;34;5;29;.853;3566000;0
42180;-1;2517;20;24;6;18;.750;3576000;0
42180;175063;2508;61;38;4;34;.895;3600000;0
42180;61292;2517;0;0;0;0;.00nan;0;0
42180;147977;2508;0;0;0;0;.00nan;0;0
42181;173073;843;0;0;0;0;.00nan;0;0
42181;-1;841;48;29;4;25;.862;3600000;0
42181;-1;843;93;32;1;31;.969;3600000;0
42181;47754;841;0;0;0;0;.00nan;0;0
42182;193985;835;0;0;0;0;.00nan;0;0
42182;216931;835;63;22;2;20;.909;3600000;0
42182;180279;2493;61;30;3;27;.900;3578000;0
42182;185506;2493;0;0;0;0;.00nan;0;0
42183;193985;835;40;24;4;20;.833;3857000;0
42183;216931;835;0;0;0;0;.00nan;0;0
42183;-1;841;0;0;0;0;.00nan;0;0
42183;47754;841;65;22;3;19;.864;3857000;0
42184;8501;2488;0;0;0;0;.00nan;0;0
42184;173073;843;0;0;0;0;.00nan;0;0
42184;180929;2488;76;34;3;31;.912;3900000;0
42184;-1;843;61;21;3;18;.857;3900000;0
42185;805;846;93;23;2;21;.913;3900000;0
42185;-1;2517;82;36;2;34;.944;3900000;0
42185;-1;846;0;0;0;0;.00nan;0;0
42185;61292;2517;0;0;0;0;.00nan;0;0
42186;175063;2508;35;20;4;16;.800;3600000;0
42186;94240;845;83;30;1;29;.967;3600000;0
42186;147962;845;0;0;0;0;.00nan;0;0
42186;147977;2508;0;0;0;0;.00nan;0;0
42187;180279;2493;71;32;4;28;.875;3561000;0
42187;185506;2493;0;0;0;0;.00nan;0;0
42187;148069;844;0;0;0;0;.00nan;0;0
42187;152266;844;60;27;3;24;.889;3600000;0
42188;805;846;88;47;3;44;.936;3558000;0
42188;-1;846;0;0;0;0;.00nan;0;0
42188;148069;844;0;0;0;0;.00nan;0;0
42188;152266;844;60;21;2;19;.905;3600000;0
42189;-1;2517;66;28;2;26;.929;3900000;0
42189;61292;2517;0;0;0;0;.00nan;0;0
42189;94240;845;78;30;2;28;.933;3900000;0
42189;147962;845;0;0;0;0;.00nan;0;0
42190;173073;843;0;0;0;0;.00nan;0;0
42190;175063;2508;0;0;0;0;.00nan;0;0
42190;-1;843;64;25;2;23;.920;3600000;0
42190;147977;2508;66;31;4;27;.871;3566000;0
42191;-1;841;65;17;1;16;.941;3600000;0
42191;180279;2493;75;34;2;32;.941;3541000;0
42191;185506;2493;0;0;0;0;.00nan;0;0
42191;47754;841;0;0;0;0;.00nan;0;0
42192;8501;2488;65;30;3;27;.900;3580000;0
42192;193985;835;0;0;0;0;.00nan;0;0
42192;216931;835;60;22;2;20;.909;3600000;0
42192;180929;2488;0;0;0;0;.00nan;0;0
42193;193985;835;0;0;0;0;.00nan;0;0
42193;216931;835;90;40;2;38;.950;3577000;0
42193;148069;844;92;38;1;37;.974;3600000;0
42193;152266;844;0;0;0;0;.00nan;0;0
42194;8501;2488;0;0;0;0;.00nan;0;0
42194;-1;841;78;27;1;26;.963;3600000;0
42194;180929;2488;56;22;2;20;.909;3556000;0
42194;47754;841;0;0;0;0;.00nan;0;0
42195;180279;2493;35;35;6;29;.829;2459000;0
42195;185506;2493;52;9;1;8;.889;1100000;0
42195;94240;845;71;41;5;36;.878;3600000;0
42195;147962;845;0;0;0;0;.00nan;0;0
42196;173073;843;0;0;0;0;.00nan;0;0
42196;-1;2517;63;24;2;22;.917;3900000;0
42196;-1;843;70;26;2;24;.923;3900000;0
42196;61292;2517;0;0;0;0;.00nan;0;0
42197;805;846;63;17;2;15;.882;3600000;0
42197;175063;2508;78;46;4;42;.913;3599000;0
42197;-1;846;0;0;0;0;.00nan;0;0
42197;147977;2508;0;0;0;0;.00nan;0;0
42198;193985;835;45;33;5;28;.848;3559000;0
42198;216931;835;0;0;0;0;.00nan;0;0
42198;-1;841;81;39;4;35;.897;3600000;0
42198;47754;841;0;0;0;0;.00nan;0;0
42199;-1;841;0;0;0;0;.00nan;0;0
42199;47754;841;49;31;3;28;.903;3547000;0
42199;94240;845;72;25;2;23;.920;3600000;0
42199;147962;845;0;0;0;0;.00nan;0;0
42200;805;846;84;35;3;32;.914;3600000;0
42200;180279;2493;0;0;0;0;.00nan;0;0
42200;185506;2493;59;33;4;29;.879;3547000;0
42200;-1;846;0;0;0;0;.00nan;0;0
42201;8501;2488;0;0;0;0;.00nan;0;0
42201;180929;2488;91;32;1;31;.969;3600000;0
42201;148069;844;0;0;0;0;.00nan;0;0
42201;152266;844;78;30;3;27;.900;3576000;0
42202;-1;2517;68;21;1;20;.952;3600000;0
42202;175063;2508;92;38;2;36;.947;3600000;0
42202;61292;2517;0;0;0;0;.00nan;0;0
42202;147977;2508;0;0;0;0;.00nan;0;0
42203;193985;835;0;0;0;0;.00nan;0;0
42203;173073;843;91;41;2;39;.951;3900000;0
42203;216931;835;74;28;2;26;.929;3900000;0
42203;-1;843;0;0;0;0;.00nan;0;0
42204;-1;2517;65;34;4;30;.882;3600000;0
42204;61292;2517;0;0;0;0;.00nan;0;0
42204;148069;844;0;0;0;0;.00nan;0;0
42204;152266;844;82;13;0;13;1.000;3600000;0
42205;805;846;100;34;1;33;.971;3600000;0
42205;-1;846;0;0;0;0;.00nan;0;0
42205;94240;845;44;27;4;23;.852;3600000;0
42205;147962;845;0;0;0;0;.00nan;0;0
42206;8501;2488;36;30;6;24;.800;3730000;0
42206;175063;2508;50;34;5;29;.853;3730000;0
42206;180929;2488;0;0;0;0;.00nan;0;0
42206;147977;2508;0;0;0;0;.00nan;0;0
42207;173073;843;0;0;0;0;.00nan;0;0
42207;180279;2493;66;20;1;19;.950;3577000;0
42207;185506;2493;0;0;0;0;.00nan;0;0
42207;-1;843;100;29;0;29;1.000;3600000;0
42208;193985;835;90;31;1;30;.968;3600000;0
42208;-1;2517;40;39;6;33;.846;3600000;0
42208;216931;835;0;0;0;0;.00nan;0;0
42208;61292;2517;0;0;0;0;.00nan;0;0
42209;175063;2508;97;60;3;57;.950;3600000;0
42209;147977;2508;0;0;0;0;.00nan;0;0
42209;148069;844;0;0;0;0;.00nan;0;0
42209;152266;844;94;15;0;15;1.000;3600000;0
42210;805;846;39;33;5;28;.848;3600000;0
42210;8501;2488;0;0;0;0;.00nan;0;0
42210;180929;2488;75;26;1;25;.962;3600000;0
42210;-1;846;0;0;0;0;.00nan;0;0
42211;-1;2517;0;0;0;0;.00nan;0;0
42211;180279;2493;30;15;4;11;.733;857000;0
42211;185506;2493;87;24;0;24;1.000;2736000;0
42211;61292;2517;56;21;3;18;.857;3600000;0
42212;173073;843;0;0;0;0;.00nan;0;0
42212;-1;841;57;40;5;35;.875;3543000;0
42212;-1;843;54;30;4;26;.867;3600000;0
42212;47754;841;0;0;0;0;.00nan;0;0
42213;193985;835;0;0;0;0;.00nan;0;0
42213;216931;835;75;33;2;31;.939;3600000;0
42213;94240;845;58;38;5;33;.868;3600000;0
42213;147962;845;0;0;0;0;.00nan;0;0
42214;180279;2493;75;31;2;29;.935;3600000;0
42214;185506;2493;0;0;0;0;.00nan;0;0
42214;148069;844;0;0;0;0;.00nan;0;0
42214;152266;844;56;30;4;26;.867;3551000;0
42215;8501;2488;88;41;2;39;.951;3600000;0
42215;-1;841;37;34;6;28;.824;3600000;0
42215;180929;2488;0;0;0;0;.00nan;0;0
42215;47754;841;0;0;0;0;.00nan;0;0
42216;805;846;69;23;2;21;.913;3900000;0
42216;173073;843;0;0;0;0;.00nan;0;0
42216;-1;843;87;34;2;32;.941;3900000;0
42216;-1;846;0;0;0;0;.00nan;0;0
42217;-1;2517;51;33;5;28;.848;3572000;0
42217;61292;2517;0;0;0;0;.00nan;0;0
42217;94240;845;44;20;4;16;.800;3600000;0
42217;147962;845;0;0;0;0;.00nan;0;0
42218;193985;835;69;17;1;16;.941;3900000;0
42218;175063;2508;0;0;0;0;.00nan;0;0
42218;216931;835;0;0;0;0;.00nan;0;0
42218;147977;2508;93;38;1;37;.974;3900000;0
42219;805;846;100;29;0;29;1.000;3600000;0
42219;-1;846;0;0;0;0;.00nan;0;0
42219;148069;844;71;27;2;25;.926;3529000;0
42219;152266;844;0;0;0;0;.00nan;0;0
42220;-1;2517;86;32;1;31;.969;3600000;0
42220;180311;2488;0;0;0;0;.00nan;0;0
42220;180929;2488;51;31;4;27;.871;3600000;0
42220;61292;2517;0;0;0;0;.00nan;0;0
42221;173073;843;69;43;4;39;.907;3562000;0
42221;-1;843;0;0;0;0;.00nan;0;0
42221;94240;845;65;22;2;20;.909;3600000;0
42221;147962;845;0;0;0;0;.00nan;0;0
42222;175063;2508;98;46;1;45;.978;3559000;0
42222;180279;2493;91;20;0;20;1.000;3600000;0
42222;185506;2493;0;0;0;0;.00nan;0;0
42222;147977;2508;0;0;0;0;.00nan;0;0
42223;193985;835;0;0;0;0;.00nan;0;0
42223;216931;835;77;41;3;38;.927;3600000;0
42223;-1;841;42;35;6;29;.829;3321000;0
42223;47754;841;54;3;0;3;1.000;279000;0
42224;175063;2508;0;0;0;0;.00nan;0;0
42224;94240;845;71;22;2;20;.909;3900000;0
42224;147962;845;0;0;0;0;.00nan;0;0
42224;147977;2508;86;42;2;40;.952;3900000;0
42225;193985;835;0;0;0;0;.00nan;0;0
42225;216931;835;48;33;4;29;.879;3600000;0
42225;148069;844;1;27;8;19;.704;3600000;0
42225;152266;844;0;0;0;0;.00nan;0;0
42226;805;846;63;32;3;29;.906;3600000;0
42226;-1;841;27;20;5;15;.750;2908000;0
42226;-1;846;0;0;0;0;.00nan;0;0
42226;47754;841;40;8;2;6;.750;692000;0
42227;8501;2488;69;31;4;27;.871;3600000;0
42227;180279;2493;65;19;2;17;.895;3600000;0
42227;180929;2488;0;0;0;0;.00nan;0;0
42227;185506;2493;0;0;0;0;.00nan;0;0
42228;175063;2508;88;49;3;46;.939;3600000;0
42228;94240;845;56;16;2;14;.875;3600000;0
42228;147962;845;0;0;0;0;.00nan;0;0
42228;147977;2508;0;0;0;0;.00nan;0;0
42229;173073;843;0;0;0;0;.00nan;0;0
42229;-1;2517;70;38;4;34;.895;3600000;0
42229;-1;843;50;31;5;26;.839;3592000;0
42229;61292;2517;0;0;0;0;.00nan;0;0
42230;805;846;85;30;1;29;.967;3600000;0
42230;193985;835;54;31;4;27;.871;3600000;0
42230;216931;835;0;0;0;0;.00nan;0;0
42230;-1;846;0;0;0;0;.00nan;0;0
42231;8501;2488;0;0;0;0;.00nan;0;0
42231;180929;2488;45;26;4;22;.846;3600000;0
42231;94240;845;99;40;1;39;.975;3600000;0
42231;147962;845;0;0;0;0;.00nan;0;0
42232;-1;2517;99;41;1;40;.976;3600000;0
42232;61292;2517;0;0;0;0;.00nan;0;0
42232;148069;844;49;32;5;27;.844;3600000;0
42232;152266;844;0;0;0;0;.00nan;0;0
42233;173073;843;0;0;0;0;.00nan;0;0
42233;175063;2508;62;44;5;39;.886;3600000;0
42233;-1;843;74;20;2;18;.900;3600000;0
42233;147977;2508;0;0;0;0;.00nan;0;0
42234;-1;841;75;40;3;37;.925;3600000;0
42234;180279;2493;97;27;0;27;1.000;3600000;0
42234;185506;2493;0;0;0;0;.00nan;0;0
42234;47754;841;0;0;0;0;.00nan;0;0
42235;805;846;65;13;1;12;.923;3600000;0
42235;175063;2508;83;38;2;36;.947;3600000;0
42235;-1;846;0;0;0;0;.00nan;0;0
42235;147977;2508;0;0;0;0;.00nan;0;0
42236;180279;2493;60;22;2;20;.909;3600000;0
42236;185506;2493;0;0;0;0;.00nan;0;0
42236;94240;845;25;24;6;18;.750;2780000;0
42236;147962;845;69;14;0;14;1.000;820000;0
42237;173073;843;58;52;6;46;.885;3600000;0
42237;-1;843;0;0;0;0;.00nan;0;0
42237;148069;844;0;0;0;0;.00nan;0;0
42237;152266;844;62;18;2;16;.889;3600000;0
42238;8501;2488;78;33;2;31;.939;3900000;0
42238;193985;835;0;0;0;0;.00nan;0;0
42238;216931;835;64;22;2;20;.909;3900000;0
42238;180929;2488;0;0;0;0;.00nan;0;0
42239;-1;2517;81;28;1;27;.964;3600000;0
42239;-1;841;0;0;0;0;.00nan;0;0
42239;47754;841;44;31;5;26;.839;3600000;0
42239;61292;2517;0;0;0;0;.00nan;0;0
42240;94240;845;72;26;2;24;.923;3600000;0
42240;147962;845;0;0;0;0;.00nan;0;0
42240;148069;844;69;38;4;34;.895;3600000;0
42240;152266;844;0;0;0;0;.00nan;0;0
42241;8501;2488;0;0;0;0;.00nan;0;0
42241;173073;843;59;16;1;15;.938;2916000;0
42241;180929;2488;76;20;1;19;.950;3600000;0
42241;-1;843;17;8;4;4;.500;684000;0
42242;805;846;39;20;4;16;.800;3527000;0
42242;-1;2517;77;35;2;33;.943;3600000;0
42242;-1;846;0;0;0;0;.00nan;0;0
42242;61292;2517;0;0;0;0;.00nan;0;0
42243;175063;2508;8;26;7;19;.731;2448000;0
42243;-1;841;73;33;3;30;.909;3600000;0
42243;47754;841;0;0;0;0;.00nan;0;0
42243;147977;2508;56;10;1;9;.900;1152000;0
42244;193985;835;0;0;0;0;.00nan;0;0
42244;216931;835;72;28;2;26;.929;3719000;0
42244;180279;2493;87;27;1;26;.963;3719000;0
42244;185506;2493;0;0;0;0;.00nan;0;0
42245;180279;2493;90;46;3;43;.935;3587000;0
42245;185506;2493;0;0;0;0;.00nan;0;0
42245;94240;845;85;29;2;27;.931;3600000;0
42245;147962;845;0;0;0;0;.00nan;0;0
42246;173073;843;0;0;0;0;.00nan;0;0
42246;-1;841;40;21;4;17;.810;3600000;0
42246;-1;843;73;45;5;40;.889;3586000;0
42246;47754;841;0;0;0;0;.00nan;0;0
42247;805;846;0;0;0;0;.00nan;0;0
42247;-1;2517;70;36;4;32;.889;3575000;0
42247;-1;846;68;22;2;20;.909;3600000;0
42247;61292;2517;0;0;0;0;.00nan;0;0
42248;8501;2488;76;33;3;30;.909;3546000;0
42248;180929;2488;0;0;0;0;.00nan;0;0
42248;148069;844;0;0;0;0;.00nan;0;0
42248;152266;844;69;21;2;19;.905;3600000;0
42249;193985;835;75;29;2;27;.931;3600000;0
42249;175063;2508;70;43;4;39;.907;3600000;0
42249;216931;835;0;0;0;0;.00nan;0;0
42249;147977;2508;0;0;0;0;.00nan;0;0
42250;-1;841;76;33;2;31;.939;3600000;0
42250;47754;841;0;0;0;0;.00nan;0;0
42250;148069;844;26;25;5;20;.800;3600000;0
42250;152266;844;0;0;0;0;.00nan;0;0
42251;193985;835;78;22;1;21;.955;3600000;0
42251;216931;835;0;0;0;0;.00nan;0;0
42251;94240;845;59;38;5;33;.868;3600000;0
42251;147962;845;0;0;0;0;.00nan;0;0
42252;-1;2517;57;35;4;31;.886;3900000;0
42252;180279;2493;48;26;4;22;.846;3900000;0
42252;185506;2493;0;0;0;0;.00nan;0;0
42252;61292;2517;0;0;0;0;.00nan;0;0
42253;805;846;57;33;4;29;.879;3600000;0
42253;175063;2508;0;0;0;0;.00nan;0;0
42253;-1;846;0;0;0;0;.00nan;0;0
42253;147977;2508;92;35;1;34;.971;3600000;0
42254;8501;2488;0;0;0;0;.00nan;0;0
42254;173073;843;75;38;3;35;.921;3584000;0
42254;180929;2488;65;15;1;14;.933;3600000;0
42254;-1;843;0;0;0;0;.00nan;0;0
42255;175063;2508;92;57;4;53;.930;3600000;0
42255;147977;2508;0;0;0;0;.00nan;0;0
42255;148069;844;0;0;0;0;.00nan;0;0
42255;152266;844;90;16;0;16;1.000;3600000;0
42256;805;846;65;20;2;18;.900;3600000;0
42256;173073;843;0;0;0;0;.00nan;0;0
42256;-1;843;57;33;4;29;.879;3573000;0
42256;-1;846;0;0;0;0;.00nan;0;0
42257;193985;835;77;36;3;33;.917;3600000;0
42257;216931;835;0;0;0;0;.00nan;0;0
42257;148069;844;0;0;0;0;.00nan;0;0
42257;152266;844;100;28;1;27;.964;3600000;0
42258;8501;2488;0;0;0;0;.00nan;0;0
42258;180279;2493;95;38;2;36;.947;3600000;0
42258;180929;2488;61;30;3;27;.900;3586000;0
42258;185506;2493;0;0;0;0;.00nan;0;0
42259;-1;2517;85;41;2;39;.951;3514000;0
42259;-1;841;95;19;0;19;1.000;3600000;0
42259;47754;841;0;0;0;0;.00nan;0;0
42259;61292;2517;0;0;0;0;.00nan;0;0
42260;175063;2508;0;0;0;0;.00nan;0;0
42260;94240;845;89;28;1;27;.964;3600000;0
42260;147962;845;0;0;0;0;.00nan;0;0
42260;147977;2508;49;31;4;27;.871;3600000;0
42261;175063;2508;64;29;3;26;.897;3597000;0
42261;-1;841;84;29;1;28;.966;3600000;0
42261;47754;841;0;0;0;0;.00nan;0;0
42261;147977;2508;0;0;0;0;.00nan;0;0
42262;805;846;93;23;0;23;1.000;3600000;0
42262;8501;2488;0;0;0;0;.00nan;0;0
42262;180929;2488;62;24;3;21;.875;3600000;0
42262;-1;846;0;0;0;0;.00nan;0;0
42263;173073;843;0;0;0;0;.00nan;0;0
42263;-1;843;55;42;5;37;.881;3600000;0
42263;94240;845;0;0;0;0;.00nan;0;0
42263;147962;845;62;22;2;20;.909;3600000;0
42264;180279;2493;76;46;5;41;.891;3858000;0
42264;185506;2493;0;0;0;0;.00nan;0;0
42264;148069;844;0;0;0;0;.00nan;0;0
42264;152266;844;46;22;4;18;.818;3858000;0
42265;193985;835;0;0;0;0;.00nan;0;0
42265;-1;2517;41;41;7;34;.829;2798000;0
42265;216931;835;45;24;4;20;.833;3600000;0
42265;61292;2517;61;10;1;9;.900;802000;0
42266;805;846;81;35;2;33;.943;3535000;0
42266;-1;846;0;0;0;0;.00nan;0;0
42266;148069;844;91;34;1;33;.971;3600000;0
42266;152266;844;0;0;0;0;.00nan;0;0
42267;8501;2488;69;23;2;21;.913;3600000;0
42267;-1;841;54;23;3;20;.870;3585000;0
42267;180929;2488;0;0;0;0;.00nan;0;0
42267;47754;841;0;0;0;0;.00nan;0;0
42268;-1;2517;0;0;0;0;.00nan;0;0
42268;61292;2517;70;31;3;28;.903;3900000;0
42268;94240;845;66;24;3;21;.875;3900000;0
42268;147962;845;0;0;0;0;.00nan;0;0
42269;175063;2508;0;0;0;0;.00nan;0;0
42269;180279;2493;40;27;5;22;.815;3544000;0
42269;185506;2493;0;0;0;0;.00nan;0;0
42269;147977;2508;73;41;4;37;.902;3600000;0
42270;193985;835;75;31;2;29;.935;3600000;0
42270;173073;843;0;0;0;0;.00nan;0;0
42270;216931;835;0;0;0;0;.00nan;0;0
42270;-1;843;56;40;6;34;.850;3600000;0
42271;175063;2508;94;48;3;45;.938;3635000;0
42271;147977;2508;0;0;0;0;.00nan;0;0
42271;148069;844;0;0;0;0;.00nan;0;0
42271;152266;844;81;28;2;26;.929;3635000;0
42272;8501;2488;0;0;0;0;.00nan;0;0
42272;180929;2488;58;35;4;31;.886;3576000;0
42272;94240;845;49;17;3;14;.824;3600000;0
42272;147962;845;0;0;0;0;.00nan;0;0
42273;173073;843;64;25;2;23;.920;3550000;0
42273;-1;2517;100;41;1;40;.976;3600000;0
42273;-1;843;0;0;0;0;.00nan;0;0
42273;61292;2517;0;0;0;0;.00nan;0;0
42274;-1;841;48;27;3;24;.889;3553000;0
42274;180279;2493;59;22;2;20;.909;3600000;0
42274;185506;2493;0;0;0;0;.00nan;0;0
42274;47754;841;0;0;0;0;.00nan;0;0
42275;805;846;67;40;5;35;.875;3600000;0
42275;193985;835;72;30;2;28;.933;3600000;0
42275;216931;835;0;0;0;0;.00nan;0;0
42275;-1;846;0;0;0;0;.00nan;0;0
42276;-1;841;44;19;4;15;.789;1797000;0
42276;47754;841;66;14;0;14;1.000;1753000;0
42276;94240;845;61;22;3;19;.864;3600000;0
42276;147962;845;0;0;0;0;.00nan;0;0
42277;805;846;57;32;4;28;.875;3540000;0
42277;180279;2493;77;28;2;26;.929;3600000;0
42277;185506;2493;0;0;0;0;.00nan;0;0
42277;-1;846;0;0;0;0;.00nan;0;0
42278;8501;2488;0;0;0;0;.00nan;0;0
42278;193985;835;47;30;5;25;.833;3600000;0
42278;216931;835;0;0;0;0;.00nan;0;0
42278;180929;2488;79;28;2;26;.929;3600000;0
42279;-1;2517;38;19;4;15;.789;3600000;0
42279;175063;2508;34;31;6;25;.806;3261000;0
42279;61292;2517;0;0;0;0;.00nan;0;0
42279;147977;2508;55;5;0;5;1.000;339000;0
42280;173073;843;0;0;0;0;.00nan;0;0
42280;-1;843;78;31;2;29;.935;3600000;0
42280;148069;844;0;0;0;0;.00nan;0;0
42280;152266;844;19;17;5;12;.706;3600000;0
42281;-1;2517;82;41;3;38;.927;3600000;0
42281;61292;2517;0;0;0;0;.00nan;0;0
42281;148069;844;0;0;0;0;.00nan;0;0
42281;152266;844;45;25;4;21;.840;3595000;0
42282;8501;2488;0;0;0;0;.00nan;0;0
42282;175063;2508;0;0;0;0;.00nan;0;0
42282;180929;2488;69;32;3;29;.906;3900000;0
42282;147977;2508;52;24;3;21;.875;3900000;0
42283;173073;843;0;0;0;0;.00nan;0;0
42283;180279;2493;53;19;2;17;.895;3600000;0
42283;185506;2493;0;0;0;0;.00nan;0;0
42283;-1;843;80;46;5;41;.891;3600000;0
42284;193985;835;83;32;2;30;.938;3620000;0
42284;216931;835;0;0;0;0;.00nan;0;0
42284;-1;841;75;23;1;22;.957;3620000;0
42284;47754;841;0;0;0;0;.00nan;0;0
42285;-1;841;100;30;0;30;1.000;3600000;0
42285;47754;841;0;0;0;0;.00nan;0;0
42285;148069;844;38;28;5;23;.821;3600000;0
42285;152266;844;0;0;0;0;.00nan;0;0
42286;805;846;0;0;0;0;.00nan;0;0
42286;-1;846;72;28;2;26;.929;3600000;0
42286;94240;845;34;26;5;21;.808;3600000;0
42286;147962;845;0;0;0;0;.00nan;0;0
42287;805;846;63;26;3;23;.885;3600000;0
42287;-1;841;53;37;4;33;.892;3600000;0
42287;-1;846;0;0;0;0;.00nan;0;0
42287;47754;841;0;0;0;0;.00nan;0;0
42288;94240;845;48;35;5;30;.857;3600000;0
42288;147962;845;0;0;0;0;.00nan;0;0
42288;148069;844;0;0;0;0;.00nan;0;0
42288;152266;844;88;28;1;27;.964;3600000;0
42289;8501;2488;97;41;1;40;.976;3900000;0
42289;-1;2517;93;22;1;21;.955;3900000;0
42289;180929;2488;0;0;0;0;.00nan;0;0
42289;61292;2517;0;0;0;0;.00nan;0;0
42290;173073;843;0;0;0;0;.00nan;0;0
42290;175063;2508;0;0;0;0;.00nan;0;0
42290;-1;843;69;31;2;29;.935;3900000;0
42290;147977;2508;74;24;2;22;.917;3900000;0
42291;193985;835;61;20;2;18;.900;3600000;0
42291;216931;835;0;0;0;0;.00nan;0;0
42291;180279;2493;63;35;4;31;.886;3575000;0
42291;185506;2493;0;0;0;0;.00nan;0;0
42292;8501;2488;0;0;0;0;.00nan;0;0
42292;180929;2488;71;34;3;31;.912;3592000;0
42292;148069;844;0;0;0;0;.00nan;0;0
42292;152266;844;84;32;2;30;.938;3600000;0
42293;180279;2493;56;28;3;25;.893;3543000;0
42293;185506;2493;0;0;0;0;.00nan;0;0
42293;94240;845;82;31;2;29;.935;3600000;0
42293;147962;845;0;0;0;0;.00nan;0;0
42294;805;846;100;21;0;21;1.000;3600000;0
42294;-1;2517;45;36;5;31;.861;3600000;0
42294;-1;846;0;0;0;0;.00nan;0;0
42294;61292;2517;0;0;0;0;.00nan;0;0
42295;193985;835;65;37;4;33;.892;3600000;0
42295;175063;2508;23;19;5;14;.737;2319000;0
42295;216931;835;0;0;0;0;.00nan;0;0
42295;147977;2508;58;14;1;13;.929;1233000;0
42296;173073;843;57;43;6;37;.860;3600000;0
42296;-1;841;75;28;3;25;.893;3600000;0
42296;-1;843;0;0;0;0;.00nan;0;0
42296;47754;841;0;0;0;0;.00nan;0;0
42297;193985;835;68;24;2;22;.917;3600000;0
42297;173073;843;0;0;0;0;.00nan;0;0
42297;216931;835;0;0;0;0;.00nan;0;0
42297;-1;843;86;43;4;39;.907;3577000;0
42298;805;846;75;15;1;14;.933;3543000;0
42298;175063;2508;0;0;0;0;.00nan;0;0
42298;-1;846;0;0;0;0;.00nan;0;0
42298;147977;2508;100;53;0;53;1.000;3600000;0
42299;8501;2488;0;0;0;0;.00nan;0;0
42299;173073;843;64;34;3;31;.912;3573000;0
42299;180929;2488;89;31;1;30;.968;3600000;0
42299;-1;843;0;0;0;0;.00nan;0;0
42300;-1;2517;44;31;5;26;.839;3554000;0
42300;180279;2493;52;23;3;20;.870;3600000;0
42300;185506;2493;0;0;0;0;.00nan;0;0
42300;61292;2517;0;0;0;0;.00nan;0;0
42301;193985;835;0;0;0;0;.00nan;0;0
42301;216931;835;70;38;3;35;.921;3600000;0
42301;94240;845;92;29;1;28;.966;3600000;0
42301;147962;845;0;0;0;0;.00nan;0;0
42302;-1;841;0;0;0;0;.00nan;0;0
42302;47754;841;46;19;3;16;.842;3600000;0
42302;148069;844;67;50;6;44;.880;3600000;0
42302;152266;844;0;0;0;0;.00nan;0;0
42303;805;846;69;29;3;26;.897;3600000;0
42303;-1;846;0;0;0;0;.00nan;0;0
42303;94240;845;100;34;0;34;1.000;3600000;0
42303;147962;845;0;0;0;0;.00nan;0;0
42304;-1;2517;0;0;0;0;.00nan;0;0
42304;61292;2517;89;36;2;34;.944;3523000;0
42304;148069;844;0;0;0;0;.00nan;0;0
42304;152266;844;97;24;0;24;1.000;3600000;0
42305;8501;2488;61;18;1;17;.944;3600000;0
42305;175063;2508;0;0;0;0;.00nan;0;0
42305;180929;2488;0;0;0;0;.00nan;0;0
42305;147977;2508;73;43;4;39;.907;3600000;0
42306;173073;843;0;0;0;0;.00nan;0;0
42306;180279;2493;21;10;4;6;.600;1171000;0
42306;185506;2493;39;22;4;18;.818;2429000;0
42306;-1;843;64;28;4;24;.857;3600000;0
42307;94240;845;69;36;3;33;.917;3600000;0
42307;147962;845;0;0;0;0;.00nan;0;0
42307;148069;844;0;0;0;0;.00nan;0;0
42307;152266;844;100;32;0;32;1.000;3600000;0
42308;805;846;59;18;2;16;.889;3584000;0
42308;-1;841;96;33;1;32;.970;3600000;0
42308;-1;846;0;0;0;0;.00nan;0;0
42308;47754;841;0;0;0;0;.00nan;0;0
42309;8501;2488;87;25;1;24;.960;3600000;0
42309;-1;2517;51;27;4;23;.852;3600000;0
42309;180929;2488;0;0;0;0;.00nan;0;0
42309;61292;2517;0;0;0;0;.00nan;0;0
42310;173073;843;0;0;0;0;.00nan;0;0
42310;175063;2508;0;0;0;0;.00nan;0;0
42310;-1;843;75;38;3;35;.921;3557000;0
42310;147977;2508;85;28;1;27;.964;3600000;0
42311;193985;835;44;19;3;16;.842;3600000;0
42311;216931;835;0;0;0;0;.00nan;0;0
42311;180279;2493;89;43;4;39;.907;3587000;0
42311;185506;2493;0;0;0;0;.00nan;0;0
42312;-1;2517;60;28;4;24;.857;3600000;0
42312;-1;841;33;38;7;31;.816;3302000;0
42312;47754;841;48;0;0;0;.00nan;298000;0
42312;61292;2517;0;0;0;0;.00nan;0;0
42313;805;846;33;24;5;19;.792;3600000;0
42313;173073;843;0;0;0;0;.00nan;0;0
42313;-1;843;54;39;6;33;.846;3576000;0
42313;-1;846;0;0;0;0;.00nan;0;0
42314;175063;2508;0;0;0;0;.00nan;0;0
42314;94240;845;73;17;1;16;.941;3600000;0
42314;147962;845;0;0;0;0;.00nan;0;0
42314;147977;2508;86;46;5;41;.891;3600000;0
42315;8501;2488;0;0;0;0;.00nan;0;0
42315;180279;2493;100;29;0;29;1.000;3600000;0
42315;180929;2488;94;33;1;32;.970;3587000;0
42315;185506;2493;0;0;0;0;.00nan;0;0
42316;193985;835;66;28;3;25;.893;3718000;0
42316;216931;835;0;0;0;0;.00nan;0;0
42316;148069;844;0;0;0;0;.00nan;0;0
42316;152266;844;77;41;4;37;.902;3718000;0
42317;180279;2493;43;26;4;22;.846;3600000;0
42317;185506;2493;0;0;0;0;.00nan;0;0
42317;148069;844;100;22;0;22;1.000;3600000;0
42317;152266;844;0;0;0;0;.00nan;0;0
42318;805;846;61;22;2;20;.909;3600000;0
42318;8501;2488;76;35;3;32;.914;3600000;0
42318;180929;2488;0;0;0;0;.00nan;0;0
42318;-1;846;0;0;0;0;.00nan;0;0
42319;193985;835;42;26;5;21;.808;3600000;0
42319;-1;2517;74;33;2;31;.939;3600000;0
42319;216931;835;0;0;0;0;.00nan;0;0
42319;61292;2517;0;0;0;0;.00nan;0;0
42320;175063;2508;0;0;0;0;.00nan;0;0
42320;-1;841;93;25;0;25;1.000;3600000;0
42320;47754;841;0;0;0;0;.00nan;0;0
42320;147977;2508;90;53;5;48;.906;3600000;0
42321;173073;843;0;0;0;0;.00nan;0;0
42321;-1;843;73;34;3;31;.912;3565000;0
42321;94240;845;91;36;2;34;.944;3600000;0
42321;147962;845;0;0;0;0;.00nan;0;0
42322;8501;2488;47;33;4;29;.879;3580000;0
42322;-1;841;46;18;3;15;.833;3600000;0
42322;180929;2488;0;0;0;0;.00nan;0;0
42322;47754;841;0;0;0;0;.00nan;0;0
42323;805;846;94;29;1;28;.966;3600000;0
42323;-1;846;0;0;0;0;.00nan;0;0
42323;148069;844;74;31;2;29;.935;3549000;0
42323;152266;844;0;0;0;0;.00nan;0;0
42324;-1;2517;79;32;3;29;.906;3595000;0
42324;61292;2517;0;0;0;0;.00nan;0;0
42324;94240;845;0;0;0;0;.00nan;0;0
42324;147962;845;68;19;1;18;.947;3600000;0
42325;175063;2508;0;0;0;0;.00nan;0;0
42325;180279;2493;81;30;1;29;.967;3600000;0
42325;185506;2493;0;0;0;0;.00nan;0;0
42325;147977;2508;65;31;3;28;.903;3512000;0
42326;193985;835;96;19;0;19;1.000;3600000;0
42326;173073;843;0;0;0;0;.00nan;0;0
42326;216931;835;0;0;0;0;.00nan;0;0
42326;-1;843;61;36;4;32;.889;3600000;0
42327;-1;841;0;0;0;0;.00nan;0;0
42327;180279;2493;49;28;4;24;.857;3544000;0
42327;185506;2493;0;0;0;0;.00nan;0;0
42327;47754;841;63;29;3;26;.897;3600000;0
42328;805;846;87;30;1;29;.967;3600000;0
42328;193985;835;58;26;3;23;.885;3538000;0
42328;216931;835;0;0;0;0;.00nan;0;0
42328;-1;846;0;0;0;0;.00nan;0;0
42329;8501;2488;0;0;0;0;.00nan;0;0
42329;180929;2488;47;28;4;24;.857;3587000;0
42329;94240;845;73;29;2;27;.931;3600000;0
42329;147962;845;0;0;0;0;.00nan;0;0
42330;175063;2508;0;0;0;0;.00nan;0;0
42330;147977;2508;90;54;4;50;.926;3900000;0
42330;148069;844;35;21;4;17;.810;3900000;0
42330;152266;844;0;0;0;0;.00nan;0;0
42331;173073;843;0;0;0;0;.00nan;0;0
42331;-1;2517;31;23;5;18;.783;3537000;0
42331;-1;843;74;33;3;30;.909;3600000;0
42331;61292;2517;0;0;0;0;.00nan;0;0
42332;173073;843;0;0;0;0;.00nan;0;0
42332;-1;843;100;40;1;39;.975;3600000;0
42332;148069;844;0;0;0;0;.00nan;0;0
42332;152266;844;48;21;3;18;.857;3554000;0
42333;-1;841;62;26;3;23;.885;3600000;0
42333;47754;841;0;0;0;0;.00nan;0;0
42333;94240;845;66;39;4;35;.897;3600000;0
42333;147962;845;0;0;0;0;.00nan;0;0
42334;-1;2517;0;0;0;0;.00nan;0;0
42334;175063;2508;0;0;0;0;.00nan;0;0
42334;61292;2517;53;20;3;17;.850;3600000;0
42334;147977;2508;47;29;4;25;.862;3600000;0
42335;805;846;67;24;2;22;.917;3600000;0
42335;180279;2493;62;31;4;27;.871;3220000;0
42335;185506;2493;48;0;0;0;.00nan;309000;0
42335;-1;846;0;0;0;0;.00nan;0;0
42336;8501;2488;89;33;2;31;.939;3600000;0
42336;193985;835;42;20;4;16;.800;3592000;0
42336;216931;835;0;0;0;0;.00nan;0;0
42336;180929;2488;0;0;0;0;.00nan;0;0
42338;8501;2488;0;0;0;0;.00nan;0;0
42338;180929;2488;22;32;7;25;.781;3600000;0
42338;148069;844;0;0;0;0;.00nan;0;0
42338;152266;844;74;22;1;21;.955;3600000;0
42340;193985;835;100;27;0;27;1.000;3600000;0
42340;-1;2493;0;0;0;0;.00nan;0;0
42340;216931;835;0;0;0;0;.00nan;0;0
42340;180279;2493;65;28;3;25;.893;3600000;0
42342;805;846;79;30;3;27;.900;3646000;0
42342;175063;2508;67;24;2;22;.917;3646000;0
42342;-1;846;0;0;0;0;.00nan;0;0
42342;147977;2508;0;0;0;0;.00nan;0;0
42344;173073;843;0;0;0;0;.00nan;0;0
42344;-1;841;47;28;4;24;.857;3596000;0
42344;-1;843;75;35;3;32;.914;3600000;0
42344;47754;841;0;0;0;0;.00nan;0;0
42346;5573;845;0;0;0;0;.00nan;0;0
42346;-1;2517;68;25;2;23;.920;3574000;0
42346;61292;2517;0;0;0;0;.00nan;0;0
42346;94240;845;93;37;1;36;.973;3600000;0
42348;8501;2488;82;41;3;38;.927;3551000;0
42348;180929;2488;0;0;0;0;.00nan;0;0
42348;148069;844;92;30;2;28;.933;3600000;0
42348;152266;844;0;0;0;0;.00nan;0;0
42350;5573;845;40;23;4;19;.826;3575000;0
42350;175063;2508;0;0;0;0;.00nan;0;0
42350;94240;845;0;0;0;0;.00nan;0;0
42350;147977;2508;72;27;2;25;.926;3600000;0
42352;805;846;0;0;0;0;.00nan;0;0
42352;-1;841;0;0;0;0;.00nan;0;0
42352;-1;846;61;30;4;26;.867;3706000;0
42352;47754;841;57;28;3;25;.893;3706000;0
42354;173073;843;47;36;6;30;.833;2893000;0
42354;-1;2493;58;22;3;19;.864;3600000;0
42354;180279;2493;0;0;0;0;.00nan;0;0
42354;-1;843;52;2;0;2;1.000;707000;0
42356;193985;835;93;33;1;32;.970;3900000;0
42356;-1;2517;94;27;1;26;.963;3900000;0
42356;216931;835;0;0;0;0;.00nan;0;0
42356;61292;2517;0;0;0;0;.00nan;0;0
42358;805;846;77;23;1;22;.957;3600000;0
42358;-1;2493;0;0;0;0;.00nan;0;0
42358;180279;2493;76;33;2;31;.939;3574000;0
42358;-1;846;0;0;0;0;.00nan;0;0
42360;8501;2488;0;0;0;0;.00nan;0;0
42360;193985;835;0;0;0;0;.00nan;0;0
42360;216931;835;44;19;3;16;.842;3524000;0
42360;180929;2488;99;42;1;41;.976;3600000;0
42362;173073;843;0;0;0;0;.00nan;0;0
42362;175063;2508;0;0;0;0;.00nan;0;0
42362;-1;843;53;25;3;22;.880;3900000;0
42362;147977;2508;74;40;3;37;.925;3900000;0
42364;-1;2517;7;30;8;22;.733;3243000;0
42364;61292;2517;53;2;0;2;1.000;357000;0
42364;148069;844;88;31;1;30;.968;3600000;0
42364;152266;844;0;0;0;0;.00nan;0;0
42366;5573;845;0;0;0;0;.00nan;0;0
42366;-1;841;45;32;5;27;.844;3900000;0
42366;47754;841;0;0;0;0;.00nan;0;0
42366;94240;845;69;42;5;37;.881;3900000;0
42368;805;846;0;0;0;0;.00nan;0;0
42368;193985;835;52;32;4;28;.875;3545000;0
42368;216931;835;0;0;0;0;.00nan;0;0
42368;-1;846;93;37;2;35;.946;3600000;0
42370;8501;2488;60;28;3;25;.893;3600000;0
42370;180929;2488;0;0;0;0;.00nan;0;0
42370;148069;844;0;0;0;0;.00nan;0;0
42370;152266;844;100;26;0;26;1.000;3600000;0
42372;5573;845;66;18;1;17;.944;3600000;0
42372;173073;843;49;24;3;21;.875;3517000;0
42372;-1;843;0;0;0;0;.00nan;0;0
42372;94240;845;0;0;0;0;.00nan;0;0
42374;-1;2517;0;0;0;0;.00nan;0;0
42374;-1;841;0;0;0;0;.00nan;0;0
42374;47754;841;69;29;3;26;.897;3544000;0
42374;61292;2517;77;26;2;24;.923;3600000;0
42376;175063;2508;72;44;3;41;.932;3900000;0
42376;-1;2493;50;18;3;15;.833;3900000;0
42376;180279;2493;0;0;0;0;.00nan;0;0
42376;147977;2508;0;0;0;0;.00nan;0;0
42378;8501;2488;0;0;0;0;.00nan;0;0
42378;180929;2488;61;34;4;30;.882;3600000;0
42378;148069;844;0;0;0;0;.00nan;0;0
42378;152266;844;73;25;1;24;.960;3600000;0
42380;173073;843;0;0;0;0;.00nan;0;0
42380;-1;841;6;19;6;13;.684;2792000;0
42380;-1;843;84;41;3;38;.927;3600000;0
42380;47754;841;39;1;1;0;.000;808000;0
42382;805;846;57;25;3;22;.880;3600000;0
42382;193985;835;0;0;0;0;.00nan;0;0
42382;216931;835;74;23;1;22;.957;3600000;0
42382;-1;846;0;0;0;0;.00nan;0;0
42384;-1;2517;44;16;3;13;.813;3592000;0
42384;175063;2508;0;0;0;0;.00nan;0;0
42384;61292;2517;0;0;0;0;.00nan;0;0
42384;147977;2508;98;33;1;32;.970;3600000;0
42386;5573;845;0;0;0;0;.00nan;0;0
42386;-1;2493;0;0;0;0;.00nan;0;0
42386;180279;2493;69;20;1;19;.950;3900000;0
42386;94240;845;94;30;1;29;.967;3900000;0
42388;805;846;0;0;0;0;.00nan;0;0
42388;173073;843;87;30;1;29;.967;3900000;0
42388;-1;843;0;0;0;0;.00nan;0;0
42388;-1;846;86;25;1;24;.960;3900000;0
42390;5573;845;93;41;1;40;.976;3600000;0
42390;94240;845;0;0;0;0;.00nan;0;0
42390;148069;844;58;19;2;17;.895;3543000;0
42390;152266;844;0;0;0;0;.00nan;0;0
42392;193985;835;58;15;1;14;.933;3556000;0
42392;175063;2508;100;58;0;58;1.000;3600000;0
42392;216931;835;0;0;0;0;.00nan;0;0
42392;147977;2508;0;0;0;0;.00nan;0;0
42394;-1;2517;64;19;2;17;.895;3600000;0
42394;-1;841;0;0;0;0;.00nan;0;0
42394;47754;841;57;30;4;26;.867;3600000;0
42394;61292;2517;0;0;0;0;.00nan;0;0
42396;8501;2488;64;21;2;19;.905;3600000;0
42396;-1;2493;66;36;4;32;.889;3576000;0
42396;180279;2493;0;0;0;0;.00nan;0;0
42396;180929;2488;0;0;0;0;.00nan;0;0
42398;5573;845;0;0;0;0;.00nan;0;0
42398;-1;2517;69;35;3;32;.914;3600000;0
42398;61292;2517;0;0;0;0;.00nan;0;0
42398;94240;845;36;29;6;23;.793;3600000;0
42400;8501;2488;0;0;0;0;.00nan;0;0
42400;-1;2493;51;34;4;30;.882;3600000;0
42400;180279;2493;0;0;0;0;.00nan;0;0
42400;180929;2488;76;19;1;18;.947;3600000;0
42402;193985;835;0;0;0;0;.00nan;0;0
42402;216931;835;38;25;5;20;.800;3600000;0
42402;-1;841;73;28;1;27;.964;3600000;0
42402;47754;841;0;0;0;0;.00nan;0;0
42404;173073;843;0;0;0;0;.00nan;0;0
42404;175063;2508;51;36;4;32;.889;3563000;0
42404;-1;843;80;32;3;29;.906;3600000;0
42404;147977;2508;0;0;0;0;.00nan;0;0
42406;805;846;63;35;3;32;.914;3600000;0
42406;-1;846;0;0;0;0;.00nan;0;0
42406;148069;844;99;26;0;26;1.000;3600000;0
42406;152266;844;0;0;0;0;.00nan;0;0
536;180279;2493;100;36;0;36;1.000;3600000;0
536;185506;2493;0;0;0;0;.00nan;0;0
536;94240;845;76;23;2;21;.913;3519000;0
536;147962;845;0;0;0;0;.00nan;0;0
537;8501;2488;61;30;4;26;.867;3600000;0
537;193985;835;0;0;0;0;.00nan;0;0
537;216931;835;82;31;1;30;.968;3600000;0
537;180929;2488;0;0;0;0;.00nan;0;0
538;805;846;79;29;2;27;.931;3600000;0
538;-1;2517;54;35;5;30;.857;3600000;0
538;-1;846;0;0;0;0;.00nan;0;0
538;61292;2517;0;0;0;0;.00nan;0;0
539;-1;841;49;32;5;27;.844;3885000;0
539;47754;841;0;0;0;0;.00nan;0;0
539;148069;844;0;0;0;0;.00nan;0;0
539;152266;844;52;36;6;30;.833;3885000;0
540;180279;2493;69;33;3;30;.909;3600000;0
540;185506;2493;0;0;0;0;.00nan;0;0
540;94240;845;81;25;1;24;.960;3600000;0
540;147962;845;0;0;0;0;.00nan;0;0
541;8501;2488;67;39;4;35;.897;3564000;0
541;193985;835;0;0;0;0;.00nan;0;0
541;216931;835;58;26;3;23;.885;3600000;0
541;180929;2488;0;0;0;0;.00nan;0;0
542;805;846;74;26;2;24;.923;3600000;0
542;-1;2517;34;28;5;23;.821;3600000;0
542;-1;846;0;0;0;0;.00nan;0;0
542;61292;2517;0;0;0;0;.00nan;0;0
543;-1;841;94;38;1;37;.974;3600000;0
543;47754;841;0;0;0;0;.00nan;0;0
543;148069;844;0;0;0;0;.00nan;0;0
543;152266;844;79;30;2;28;.933;3543000;0
544;180279;2493;76;24;1;23;.958;3600000;0
544;185506;2493;0;0;0;0;.00nan;0;0
544;94240;845;58;24;3;21;.875;3563000;0
544;147962;845;0;0;0;0;.00nan;0;0
545;8501;2488;100;37;1;36;.973;3600000;0
545;193985;835;0;0;0;0;.00nan;0;0
545;216931;835;40;17;3;14;.824;3518000;0
545;180929;2488;0;0;0;0;.00nan;0;0
546;805;846;63;27;3;24;.889;3557000;0
546;-1;2517;84;38;2;36;.947;3600000;0
546;-1;846;0;0;0;0;.00nan;0;0
546;61292;2517;0;0;0;0;.00nan;0;0
547;-1;841;85;15;0;15;1.000;3600000;0
547;47754;841;0;0;0;0;.00nan;0;0
547;148069;844;0;0;0;0;.00nan;0;0
547;152266;844;62;32;3;29;.906;3600000;0
548;180279;2493;86;38;2;36;.947;3545000;0
548;185506;2493;0;0;0;0;.00nan;0;0
548;94240;845;71;22;1;21;.955;3600000;0
548;147962;845;0;0;0;0;.00nan;0;0
549;8501;2488;85;34;2;32;.941;3572000;0
549;193985;835;0;0;0;0;.00nan;0;0
549;216931;835;70;22;1;21;.955;3600000;0
549;180929;2488;0;0;0;0;.00nan;0;0
550;805;846;83;27;1;26;.963;3600000;0
550;-1;2517;89;18;0;18;1.000;3600000;0
550;-1;846;0;0;0;0;.00nan;0;0
550;61292;2517;0;0;0;0;.00nan;0;0
551;-1;841;64;42;5;37;.881;3565000;0
551;47754;841;0;0;0;0;.00nan;0;0
551;148069;844;0;0;0;0;.00nan;0;0
551;152266;844;58;26;3;23;.885;3600000;0
584;180279;2493;50;30;5;25;.833;3600000;0
584;185506;2493;0;0;0;0;.00nan;0;0
584;94240;845;92;34;2;32;.941;3600000;0
584;147962;845;0;0;0;0;.00nan;0;0
585;8501;2488;58;41;4;37;.902;3596000;0
585;193985;835;0;0;0;0;.00nan;0;0
585;216931;835;52;17;2;15;.882;3600000;0
585;180929;2488;0;0;0;0;.00nan;0;0
586;805;846;86;16;0;16;1.000;3600000;0
586;-1;2517;54;32;4;28;.875;3600000;0
586;-1;846;0;0;0;0;.00nan;0;0
586;61292;2517;0;0;0;0;.00nan;0;0
587;-1;841;62;31;3;28;.903;3568000;0
587;47754;841;0;0;0;0;.00nan;0;0
587;148069;844;0;0;0;0;.00nan;0;0
587;152266;844;89;24;1;23;.958;3600000;0
588;180279;2493;53;32;4;28;.875;3600000;0
588;185506;2493;0;0;0;0;.00nan;0;0
588;94240;845;76;31;3;28;.903;3600000;0
588;147962;845;0;0;0;0;.00nan;0;0
589;805;846;52;23;3;20;.870;3600000;0
589;-1;2517;53;34;4;30;.882;3576000;0
589;-1;846;0;0;0;0;.00nan;0;0
589;61292;2517;0;0;0;0;.00nan;0;0
590;-1;841;34;29;6;23;.793;3070000;0
590;47754;841;58;6;0;6;1.000;498000;0
590;148069;844;0;0;0;0;.00nan;0;0
590;152266;844;44;20;4;16;.800;3600000;0
603;-1;841;71;51;6;45;.882;3600000;0
603;47754;841;0;0;0;0;.00nan;0;0
603;148069;844;0;0;0;0;.00nan;0;0
603;152266;844;75;24;1;23;.958;3600000;0
604;94240;845;82;29;2;27;.931;3562000;0
604;147962;845;0;0;0;0;.00nan;0;0
604;148069;844;0;0;0;0;.00nan;0;0
604;152266;844;90;32;1;31;.969;3600000;0
605;805;846;78;24;1;23;.958;3600000;0
605;193985;835;0;0;0;0;.00nan;0;0
605;216931;835;72;33;3;30;.909;3600000;0
605;-1;846;0;0;0;0;.00nan;0;0
606;94240;845;54;33;5;28;.848;3600000;0
606;147962;845;0;0;0;0;.00nan;0;0
606;148069;844;0;0;0;0;.00nan;0;0
606;152266;844;82;29;2;27;.931;3600000;0
607;805;846;94;57;3;54;.947;7200000;0
607;193985;835;0;0;0;0;.00nan;0;0
607;216931;835;89;58;2;56;.966;7200000;0
607;-1;846;0;0;0;0;.00nan;0;0
608;94240;845;52;44;5;39;.886;5427000;0
608;147962;845;0;0;0;0;.00nan;0;0
608;148069;844;0;0;0;0;.00nan;0;0
608;152266;844;63;42;4;38;.905;5427000;0
609;805;846;66;41;4;37;.902;3600000;0
609;193985;835;0;0;0;0;.00nan;0;0
609;216931;835;61;12;1;11;.917;3600000;0
609;-1;846;0;0;0;0;.00nan;0;0
610;94240;845;70;30;4;26;.867;3600000;0
610;147962;845;0;0;0;0;.00nan;0;0
610;148069;844;0;0;0;0;.00nan;0;0
610;152266;844;72;20;1;19;.950;3600000;0
611;805;846;62;42;4;38;.905;3600000;0
611;193985;835;0;0;0;0;.00nan;0;0
611;216931;835;56;17;2;15;.882;3600000;0
611;-1;846;0;0;0;0;.00nan;0;0
761;805;846;78;53;5;48;.906;3600000;0
761;193985;835;0;0;0;0;.00nan;0;0
761;216931;835;61;20;2;18;.900;3600000;0
761;-1;846;0;0;0;0;.00nan;0;0
764;193985;835;0;0;0;0;.00nan;0;0
764;216931;835;65;22;2;20;.909;3543000;0
764;148069;844;0;0;0;0;.00nan;0;0
764;152266;844;90;29;1;28;.966;3600000;0
765;193985;835;0;0;0;0;.00nan;0;0
765;216931;835;52;27;4;23;.852;3600000;0
765;148069;844;0;0;0;0;.00nan;0;0
765;152266;844;100;29;0;29;1.000;3600000;0
766;193985;835;0;0;0;0;.00nan;0;0
766;216931;835;49;28;4;24;.857;3600000;0
766;148069;844;43;3;1;2;.667;259000;0
766;152266;844;36;27;6;21;.778;3341000;0
767;193985;835;48;0;0;0;.00nan;256000;0
767;216931;835;53;38;6;32;.842;3344000;0
767;148069;844;0;0;0;0;.00nan;0;0
767;152266;844;58;21;2;19;.905;3600000;0
850;193985;835;0;0;0;0;.00nan;0;0
850;216931;835;85;31;2;29;.935;3600000;0
850;148069;844;0;0;0;0;.00nan;0;0
850;152266;844;69;30;3;27;.900;3543000;0
857;193985;835;0;0;0;0;.00nan;0;0
857;216931;835;67;24;2;22;.917;3560000;0
857;148069;844;0;0;0;0;.00nan;0;0
857;152266;844;65;14;1;13;.929;3600000;0
42407;170294;521;56;18;2;16;.889;3600000;0
42407;174589;522;0;0;0;0;.00nan;0;0
42407;143523;521;0;0;0;0;.00nan;0;0
42407;155474;522;63;47;5;42;.894;3600000;0
42408;205990;1477;0;0;0;0;.00nan;0;0
42408;68565;2173;0;0;0;0;.00nan;0;0
42408;143063;2173;62;44;6;38;.864;3600000;0
42408;143479;1477;61;18;1;17;.944;3600000;0
42409;7534;1481;76;29;3;26;.897;3545000;0
42409;178789;1481;0;0;0;0;.00nan;0;0
42409;81096;523;83;22;1;21;.955;3600000;0
42409;152464;523;0;0;0;0;.00nan;0;0
42410;167036;1877;89;35;1;34;.971;3600000;0
42410;7332;1869;56;24;3;21;.875;3573000;0
42410;143412;1877;0;0;0;0;.00nan;0;0
42410;155529;1869;0;0;0;0;.00nan;0;0
42411;11851;1475;0;0;0;0;.00nan;0;0
42411;54290;1871;71;30;2;28;.933;3600000;0
42411;67764;1871;0;0;0;0;.00nan;0;0
42411;143036;1475;71;43;4;39;.907;3562000;0
42412;190258;1861;55;18;2;16;.889;3600000;0
42412;185041;3922;61;29;3;26;.897;3545000;0
42412;68627;1861;0;0;0;0;.00nan;0;0
42412;89998;3922;0;0;0;0;.00nan;0;0
42413;177504;524;0;0;0;0;.00nan;0;0
42413;8035;524;52;20;2;18;.900;3555000;0
42413;9373;1854;0;0;0;0;.00nan;0;0
42413;169325;1854;98;52;1;51;.981;3600000;0
42414;177504;524;0;0;0;0;.00nan;0;0
42414;8035;524;74;28;2;26;.929;3600000;0
42414;174589;522;0;0;0;0;.00nan;0;0
42414;155474;522;51;22;3;19;.864;3570000;0
42415;7332;1869;72;20;1;19;.950;3600000;0
42415;7534;1481;0;0;0;0;.00nan;0;0
42415;178789;1481;86;38;3;35;.921;3592000;0
42415;155529;1869;0;0;0;0;.00nan;0;0
42416;54290;1871;64;26;3;23;.885;3549000;0
42416;67764;1871;0;0;0;0;.00nan;0;0
42416;81096;523;75;29;2;27;.931;3600000;0
42416;152464;523;0;0;0;0;.00nan;0;0
42417;190258;1861;62;24;2;22;.917;3600000;0
42417;68565;2173;58;11;1;10;.909;3600000;0
42417;68627;1861;0;0;0;0;.00nan;0;0
42417;143063;2173;0;0;0;0;.00nan;0;0
42418;9373;1854;0;0;0;0;.00nan;0;0
42418;169325;1854;72;35;3;32;.914;3563000;0
42418;205990;1477;0;0;0;0;.00nan;0;0
42418;143479;1477;57;19;2;17;.895;3600000;0
42419;170294;521;0;0;0;0;.00nan;0;0
42419;185041;3922;31;30;6;24;.800;2154000;0
42419;89998;3922;48;16;2;14;.875;1446000;0
42419;143523;521;85;11;0;11;1.000;3600000;0
42420;167036;1877;0;0;0;0;.00nan;0;0
42420;11851;1475;67;26;3;23;.885;3600000;0
42420;143036;1475;0;0;0;0;.00nan;0;0
42420;143412;1877;70;40;4;36;.900;3579000;0
42421;174589;522;46;40;7;33;.825;2926000;0
42421;81096;523;48;19;3;16;.842;3600000;0
42421;152464;523;0;0;0;0;.00nan;0;0
42421;155474;522;62;11;0;11;1.000;674000;0
42422;177504;524;0;0;0;0;.00nan;0;0
42422;8035;524;62;27;3;24;.889;3600000;0
42422;68565;2173;92;21;0;21;1.000;3600000;0
42422;143063;2173;0;0;0;0;.00nan;0;0
42423;7534;1481;0;0;0;0;.00nan;0;0
42423;178789;1481;99;52;1;51;.981;3600000;0
42423;170294;521;0;0;0;0;.00nan;0;0
42423;143523;521;53;21;2;19;.905;3548000;0
42424;167036;1877;0;0;0;0;.00nan;0;0
42424;205990;1477;0;0;0;0;.00nan;0;0
42424;143412;1877;92;43;3;40;.930;3900000;0
42424;143479;1477;68;32;3;29;.906;3900000;0
42425;190258;1861;84;52;5;47;.904;3600000;0
42425;54290;1871;84;23;1;22;.957;3600000;0
42425;67764;1871;0;0;0;0;.00nan;0;0
42425;68627;1861;0;0;0;0;.00nan;0;0
42426;7332;1869;0;0;0;0;.00nan;0;0
42426;11851;1475;69;19;1;18;.947;3600000;0
42426;143036;1475;0;0;0;0;.00nan;0;0
42426;155529;1869;84;43;3;40;.930;3540000;0
42427;9373;1854;0;0;0;0;.00nan;0;0
42427;169325;1854;79;35;2;33;.943;3900000;0
42427;185041;3922;71;26;2;24;.923;3900000;0
42427;89998;3922;0;0;0;0;.00nan;0;0
42428;177504;524;0;0;0;0;.00nan;0;0
42428;8035;524;93;36;1;35;.972;3900000;0
42428;11851;1475;77;25;1;24;.960;3900000;0
42428;143036;1475;0;0;0;0;.00nan;0;0
42429;7332;1869;81;33;3;30;.909;3726000;0
42429;54290;1871;0;0;0;0;.00nan;0;0
42429;67764;1871;71;28;2;26;.929;3726000;0
42429;155529;1869;0;0;0;0;.00nan;0;0
42430;68565;2173;93;45;3;42;.933;3600000;0
42430;81096;523;0;0;0;0;.00nan;0;0
42430;143063;2173;0;0;0;0;.00nan;0;0
42430;152464;523;86;11;0;11;1.000;3600000;0
42431;167036;1877;0;0;0;0;.00nan;0;0
42431;190258;1861;95;16;0;16;1.000;3600000;0
42431;68627;1861;0;0;0;0;.00nan;0;0
42431;143412;1877;43;31;5;26;.839;3600000;0
42432;7534;1481;0;0;0;0;.00nan;0;0
42432;178789;1481;98;52;2;50;.962;3587000;0
42432;205990;1477;63;13;1;12;.923;3600000;0
42432;143479;1477;0;0;0;0;.00nan;0;0
42433;9373;1854;0;0;0;0;.00nan;0;0
42433;169325;1854;95;60;2;58;.967;3584000;0
42433;170294;521;0;0;0;0;.00nan;0;0
42433;143523;521;58;12;1;11;.917;3600000;0
42434;174589;522;69;28;2;26;.929;3600000;0
42434;185041;3922;39;22;4;18;.818;3540000;0
42434;89998;3922;0;0;0;0;.00nan;0;0
42434;155474;522;0;0;0;0;.00nan;0;0
42435;205990;1477;69;26;2;24;.923;3600000;0
42435;174589;522;41;27;4;23;.852;2420000;0
42435;143479;1477;0;0;0;0;.00nan;0;0
42435;155474;522;27;15;4;11;.733;1180000;0
42436;9373;1854;0;0;0;0;.00nan;0;0
42436;169325;1854;62;31;3;28;.903;3546000;0
42436;68565;2173;0;0;0;0;.00nan;0;0
42436;143063;2173;68;21;2;19;.905;3600000;0
42437;7332;1869;0;0;0;0;.00nan;0;0
42437;81096;523;0;0;0;0;.00nan;0;0
42437;152464;523;90;39;1;38;.974;3600000;0
42437;155529;1869;80;43;3;40;.930;3545000;0
42438;7534;1481;71;34;3;31;.912;3900000;0
42438;178789;1481;0;0;0;0;.00nan;0;0
42438;185041;3922;67;28;3;25;.893;3900000;0
42438;89998;3922;0;0;0;0;.00nan;0;0
42439;167036;1877;0;0;0;0;.00nan;0;0
42439;170294;521;0;0;0;0;.00nan;0;0
42439;143412;1877;98;59;4;55;.932;3600000;0
42439;143523;521;46;13;2;11;.846;3600000;0
42440;177504;524;0;0;0;0;.00nan;0;0
42440;8035;524;72;39;4;35;.897;3600000;0
42440;54290;1871;0;0;0;0;.00nan;0;0
42440;67764;1871;86;28;1;27;.964;3600000;0
42441;11851;1475;59;22;2;20;.909;3600000;0
42441;190258;1861;78;49;6;43;.878;3600000;0
42441;68627;1861;0;0;0;0;.00nan;0;0
42441;143036;1475;0;0;0;0;.00nan;0;0
42442;177504;524;69;18;1;17;.944;3600000;0
42442;7534;1481;0;0;0;0;.00nan;0;0
42442;8035;524;0;0;0;0;.00nan;0;0
42442;178789;1481;76;50;4;46;.920;3600000;0
42443;167036;1877;0;0;0;0;.00nan;0;0
42443;81096;523;67;20;2;18;.900;3600000;0
42443;143412;1877;82;37;3;34;.919;3567000;0
42443;152464;523;0;0;0;0;.00nan;0;0
42444;7332;1869;57;18;2;16;.889;3600000;0
42444;190258;1861;93;41;3;38;.927;3550000;0
42444;68627;1861;0;0;0;0;.00nan;0;0
42444;155529;1869;0;0;0;0;.00nan;0;0
42445;11851;1475;46;14;2;12;.857;1395000;0
42445;205990;1477;0;0;0;0;.00nan;0;0
42445;143036;1475;43;25;4;21;.840;2205000;0
42445;143479;1477;57;24;3;21;.875;3600000;0
42446;170294;521;53;28;4;24;.857;3600000;0
42446;54290;1871;46;37;6;31;.838;2463000;0
42446;67764;1871;66;16;1;15;.938;1137000;0
42446;143523;521;0;0;0;0;.00nan;0;0
42447;185041;3922;0;0;0;0;.00nan;0;0
42447;68565;2173;52;23;3;20;.870;3816000;0
42447;89998;3922;100;52;2;50;.962;3816000;0
42447;143063;2173;0;0;0;0;.00nan;0;0
42448;9373;1854;0;0;0;0;.00nan;0;0
42448;169325;1854;59;18;2;16;.889;3515000;0
42448;174589;522;86;20;0;20;1.000;3600000;0
42448;155474;522;0;0;0;0;.00nan;0;0
42449;170294;521;0;0;0;0;.00nan;0;0
42449;68565;2173;88;42;2;40;.952;3596000;0
42449;143063;2173;0;0;0;0;.00nan;0;0
42449;143523;521;69;20;1;19;.950;3600000;0
42450;177504;524;0;0;0;0;.00nan;0;0
42450;7332;1869;92;25;1;24;.960;3900000;0
42450;8035;524;98;50;1;49;.980;3900000;0
42450;155529;1869;0;0;0;0;.00nan;0;0
42451;205990;1477;45;28;4;24;.857;3600000;0
42451;190258;1861;0;0;0;0;.00nan;0;0
42451;68627;1861;85;33;2;31;.939;3600000;0
42451;143479;1477;0;0;0;0;.00nan;0;0
42452;7534;1481;0;0;0;0;.00nan;0;0
42452;178789;1481;85;26;1;25;.962;3600000;0
42452;174589;522;75;36;3;33;.917;3559000;0
42452;155474;522;0;0;0;0;.00nan;0;0
42453;167036;1877;0;0;0;0;.00nan;0;0
42453;185041;3922;62;21;2;19;.905;3549000;0
42453;89998;3922;0;0;0;0;.00nan;0;0
42453;143412;1877;97;29;1;28;.966;3600000;0
42454;9373;1854;62;43;4;39;.907;3600000;0
42454;169325;1854;0;0;0;0;.00nan;0;0
42454;54290;1871;72;19;1;18;.947;3600000;0
42454;67764;1871;0;0;0;0;.00nan;0;0
42455;11851;1475;64;31;3;28;.903;3600000;0
42455;81096;523;100;24;0;24;1.000;3600000;0
42455;143036;1475;0;0;0;0;.00nan;0;0
42455;152464;523;0;0;0;0;.00nan;0;0
42456;174589;522;33;28;6;22;.786;2773000;0
42456;68565;2173;85;34;2;32;.941;3600000;0
42456;143063;2173;0;0;0;0;.00nan;0;0
42456;155474;522;53;10;1;9;.900;827000;0
42457;167036;1877;0;0;0;0;.00nan;0;0
42457;177504;524;0;0;0;0;.00nan;0;0
42457;8035;524;77;31;3;28;.903;3522000;0
42457;143412;1877;90;25;1;24;.960;3600000;0
42458;190258;1861;100;50;0;50;1.000;3600000;0
42458;68627;1861;0;0;0;0;.00nan;0;0
42458;81096;523;71;14;1;13;.929;3565000;0
42458;152464;523;0;0;0;0;.00nan;0;0
42459;7332;1869;0;0;0;0;.00nan;0;0
42459;205990;1477;0;0;0;0;.00nan;0;0
42459;143479;1477;98;24;0;24;1.000;3600000;0
42459;155529;1869;64;40;5;35;.875;3600000;0
42460;11851;1475;21;21;6;15;.714;2118000;0
42460;170294;521;43;16;3;13;.813;3600000;0
42460;143036;1475;50;18;2;16;.889;1482000;0
42460;143523;521;0;0;0;0;.00nan;0;0
42461;185041;3922;72;38;4;34;.895;3600000;0
42461;54290;1871;63;22;2;20;.909;3600000;0
42461;67764;1871;0;0;0;0;.00nan;0;0
42461;89998;3922;0;0;0;0;.00nan;0;0
42462;7534;1481;0;0;0;0;.00nan;0;0
42462;9373;1854;0;0;0;0;.00nan;0;0
42462;169325;1854;100;34;0;34;1.000;3600000;0
42462;178789;1481;61;20;2;18;.900;3533000;0
42463;7534;1481;0;0;0;0;.00nan;0;0
42463;178789;1481;87;35;2;33;.943;3600000;0
42463;68565;2173;70;31;2;29;.935;2874000;0
42463;143063;2173;25;12;4;8;.667;726000;0
42464;7332;1869;70;36;4;32;.889;3522000;0
42464;170294;521;0;0;0;0;.00nan;0;0
42464;143523;521;70;19;2;17;.895;3600000;0
42464;155529;1869;0;0;0;0;.00nan;0;0
42465;177504;524;0;0;0;0;.00nan;0;0
42465;8035;524;99;19;0;19;1.000;3600000;0
42465;190258;1861;61;48;6;42;.875;3600000;0
42465;68627;1861;0;0;0;0;.00nan;0;0
42466;205990;1477;0;0;0;0;.00nan;0;0
42466;81096;523;79;25;2;23;.920;3900000;0
42466;143479;1477;81;36;2;34;.944;3900000;0
42466;152464;523;0;0;0;0;.00nan;0;0
42467;167036;1877;0;0;0;0;.00nan;0;0
42467;9373;1854;0;0;0;0;.00nan;0;0
42467;169325;1854;63;26;2;24;.923;3571000;0
42467;143412;1877;88;27;1;26;.963;3600000;0
42468;174589;522;42;36;6;30;.833;3600000;0
42468;54290;1871;94;44;3;41;.932;3600000;0
42468;67764;1871;0;0;0;0;.00nan;0;0
42468;155474;522;0;0;0;0;.00nan;0;0
42469;11851;1475;0;0;0;0;.00nan;0;0
42469;185041;3922;62;46;5;41;.891;3600000;0
42469;89998;3922;0;0;0;0;.00nan;0;0
42469;143036;1475;84;32;2;30;.938;3600000;0
42470;11851;1475;68;16;1;15;.938;3600000;0
42470;174589;522;76;31;2;29;.935;3566000;0
42470;143036;1475;0;0;0;0;.00nan;0;0
42470;155474;522;0;0;0;0;.00nan;0;0
42471;177504;524;0;0;0;0;.00nan;0;0
42471;8035;524;34;24;5;19;.792;3574000;0
42471;81096;523;60;26;4;22;.846;3600000;0
42471;152464;523;0;0;0;0;.00nan;0;0
42472;54290;1871;54;24;3;21;.875;3600000;0
42472;67764;1871;0;0;0;0;.00nan;0;0
42472;68565;2173;100;36;0;36;1.000;3600000;0
42472;143063;2173;0;0;0;0;.00nan;0;0
42473;167036;1877;0;0;0;0;.00nan;0;0
42473;7534;1481;99;27;0;27;1.000;3600000;0
42473;178789;1481;0;0;0;0;.00nan;0;0
42473;143412;1877;39;27;6;21;.778;3600000;0
42474;170294;521;57;17;2;15;.882;3600000;0
42474;205990;1477;54;32;5;27;.844;3600000;0
42474;143479;1477;0;0;0;0;.00nan;0;0
42474;143523;521;0;0;0;0;.00nan;0;0
42475;7332;1869;0;0;0;0;.00nan;0;0
42475;185041;3922;76;36;3;33;.917;3600000;0
42475;89998;3922;0;0;0;0;.00nan;0;0
42475;155529;1869;67;25;2;23;.920;3600000;0
42476;9373;1854;37;13;3;10;.769;3559000;0
42476;169325;1854;0;0;0;0;.00nan;0;0
42476;190258;1861;97;36;2;34;.944;3600000;0
42476;68627;1861;0;0;0;0;.00nan;0;0
42477;7332;1869;32;24;5;19;.792;3600000;0
42477;68565;2173;80;32;2;30;.938;3600000;0
42477;143063;2173;0;0;0;0;.00nan;0;0
42477;155529;1869;0;0;0;0;.00nan;0;0
42478;185041;3922;77;48;4;44;.917;3541000;0
42478;81096;523;48;15;3;12;.800;3600000;0
42478;89998;3922;0;0;0;0;.00nan;0;0
42478;152464;523;0;0;0;0;.00nan;0;0
42479;170294;521;0;0;0;0;.00nan;0;0
42479;190258;1861;0;0;0;0;.00nan;0;0
42479;68627;1861;82;51;4;47;.922;3600000;0
42479;143523;521;51;7;1;6;.857;3600000;0
42480;177504;524;0;0;0;0;.00nan;0;0
42480;8035;524;79;35;2;33;.943;3900000;0
42480;205990;1477;70;26;2;24;.923;3900000;0
42480;143479;1477;0;0;0;0;.00nan;0;0
42481;167036;1877;60;9;0;9;1.000;1691000;0
42481;174589;522;100;34;0;34;1.000;3600000;0
42481;143412;1877;23;26;6;20;.769;1909000;0
42481;155474;522;0;0;0;0;.00nan;0;0
42482;7534;1481;0;0;0;0;.00nan;0;0
42482;178789;1481;53;46;6;40;.870;3600000;0
42482;54290;1871;0;0;0;0;.00nan;0;0
42482;67764;1871;80;27;2;25;.926;3600000;0
42483;9373;1854;82;45;3;42;.933;3547000;0
42483;11851;1475;75;24;1;23;.958;3600000;0
42483;169325;1854;0;0;0;0;.00nan;0;0
42483;143036;1475;0;0;0;0;.00nan;0;0
42484;7332;1869;0;0;0;0;.00nan;0;0
42484;174589;522;51;39;5;34;.872;3900000;0
42484;155474;522;0;0;0;0;.00nan;0;0
42484;155529;1869;45;29;5;24;.828;3900000;0
42485;11851;1475;53;17;2;15;.882;3600000;0
42485;68565;2173;69;32;3;29;.906;3543000;0
42485;143036;1475;0;0;0;0;.00nan;0;0
42485;143063;2173;0;0;0;0;.00nan;0;0
42486;7534;1481;0;0;0;0;.00nan;0;0
42486;178789;1481;68;29;3;26;.897;3600000;0
42486;190258;1861;54;35;4;31;.886;3545000;0
42486;68627;1861;0;0;0;0;.00nan;0;0
42487;177504;524;66;18;1;17;.944;1793000;0
42487;8035;524;36;25;6;19;.760;1807000;0
42487;170294;521;0;0;0;0;.00nan;0;0
42487;143523;521;62;13;1;12;.923;3600000;0
42488;167036;1877;0;0;0;0;.00nan;0;0
42488;54290;1871;73;16;1;15;.938;3900000;0
42488;67764;1871;0;0;0;0;.00nan;0;0
42488;143412;1877;98;46;1;45;.978;3900000;0
42489;205990;1477;0;0;0;0;.00nan;0;0
42489;185041;3922;64;33;3;30;.909;3600000;0
42489;89998;3922;0;0;0;0;.00nan;0;0
42489;143479;1477;62;20;2;18;.900;3600000;0
42490;9373;1854;0;0;0;0;.00nan;0;0
42490;169325;1854;94;43;2;41;.953;3643000;0
42490;81096;523;63;18;1;17;.944;3643000;0
42490;152464;523;0;0;0;0;.00nan;0;0
42491;177504;524;0;0;0;0;.00nan;0;0
42491;8035;524;65;26;2;24;.923;3554000;0
42491;185041;3922;65;17;1;16;.941;3600000;0
42491;89998;3922;0;0;0;0;.00nan;0;0
42492;7332;1869;0;0;0;0;.00nan;0;0
42492;9373;1854;53;37;5;32;.865;3600000;0
42492;169325;1854;0;0;0;0;.00nan;0;0
42492;155529;1869;57;30;3;27;.900;3600000;0
42493;170294;521;0;0;0;0;.00nan;0;0
42493;81096;523;74;36;4;32;.889;3900000;0
42493;143523;521;61;34;4;30;.882;3854000;0
42493;152464;523;0;0;0;0;.00nan;0;0
42494;174589;522;61;22;2;20;.909;3600000;0
42494;190258;1861;50;27;4;23;.852;3513000;0
42494;68627;1861;0;0;0;0;.00nan;0;0
42494;155474;522;0;0;0;0;.00nan;0;0
42495;205990;1477;50;27;4;23;.852;3561000;0
42495;54290;1871;76;36;3;33;.917;3600000;0
42495;67764;1871;0;0;0;0;.00nan;0;0
42495;143479;1477;0;0;0;0;.00nan;0;0
42496;167036;1877;0;0;0;0;.00nan;0;0
42496;68565;2173;100;41;1;40;.976;3900000;0
42496;143063;2173;0;0;0;0;.00nan;0;0
42496;143412;1877;82;21;1;20;.952;3900000;0
42497;7534;1481;61;6;0;6;1.000;516000;0
42497;11851;1475;0;0;0;0;.00nan;0;0
42497;178789;1481;28;41;8;33;.805;3084000;0
42497;143036;1475;44;16;3;13;.813;3600000;0
42498;177504;524;0;0;0;0;.00nan;0;0
42498;8035;524;76;19;1;18;.947;3600000;0
42498;9373;1854;0;0;0;0;.00nan;0;0
42498;169325;1854;57;30;3;27;.900;3561000;0
42499;167036;1877;0;0;0;0;.00nan;0;0
42499;7332;1869;100;26;0;26;1.000;3600000;0
42499;143412;1877;70;36;3;33;.917;3600000;0
42499;155529;1869;0;0;0;0;.00nan;0;0
42500;7534;1481;0;0;0;0;.00nan;0;0
42500;178789;1481;91;40;2;38;.950;3552000;0
42500;81096;523;62;14;1;13;.929;3600000;0
42500;152464;523;0;0;0;0;.00nan;0;0
42501;190258;1861;49;35;5;30;.857;3600000;0
42501;185041;3922;83;33;2;31;.939;3600000;0
42501;68627;1861;0;0;0;0;.00nan;0;0
42501;89998;3922;0;0;0;0;.00nan;0;0
42502;205990;1477;0;0;0;0;.00nan;0;0
42502;68565;2173;85;48;5;43;.896;3600000;0
42502;143063;2173;0;0;0;0;.00nan;0;0
42502;143479;1477;62;16;2;14;.875;3600000;0
42503;170294;521;97;25;0;25;1.000;3600000;0
42503;174589;522;56;48;6;42;.875;3600000;0
42503;143523;521;0;0;0;0;.00nan;0;0
42503;155474;522;0;0;0;0;.00nan;0;0
42504;11851;1475;89;34;2;32;.941;3600000;0
42504;54290;1871;50;22;4;18;.818;3534000;0
42504;67764;1871;0;0;0;0;.00nan;0;0
42504;143036;1475;0;0;0;0;.00nan;0;0
42505;177504;524;0;0;0;0;.00nan;0;0
42505;8035;524;63;25;3;22;.880;3600000;0
42505;174589;522;39;32;5;27;.844;3600000;0
42505;155474;522;0;0;0;0;.00nan;0;0
42506;190258;1861;64;33;3;30;.909;3563000;0
42506;68565;2173;0;0;0;0;.00nan;0;0
42506;68627;1861;0;0;0;0;.00nan;0;0
42506;143063;2173;82;28;2;26;.929;3600000;0
42507;7332;1869;51;33;5;28;.848;3600000;0
42507;7534;1481;0;0;0;0;.00nan;0;0
42507;178789;1481;77;35;3;32;.914;3600000;0
42507;155529;1869;0;0;0;0;.00nan;0;0
42508;167036;1877;99;51;1;50;.980;3600000;0
42508;11851;1475;56;12;1;11;.917;2623000;0
42508;143036;1475;28;13;4;9;.692;977000;0
42508;143412;1877;0;0;0;0;.00nan;0;0
42509;54290;1871;0;0;0;0;.00nan;0;0
42509;67764;1871;90;44;3;41;.932;3600000;0
42509;81096;523;63;33;4;29;.879;3579000;0
42509;152464;523;0;0;0;0;.00nan;0;0
42510;170294;521;61;13;1;12;.923;3600000;0
42510;185041;3922;0;0;0;0;.00nan;0;0
42510;89998;3922;98;52;3;49;.942;3600000;0
42510;143523;521;0;0;0;0;.00nan;0;0
42511;9373;1854;84;30;1;29;.967;3600000;0
42511;169325;1854;0;0;0;0;.00nan;0;0
42511;205990;1477;64;31;3;28;.903;3523000;0
42511;143479;1477;0;0;0;0;.00nan;0;0
42512;177504;524;100;28;0;28;1.000;3600000;0
42512;8035;524;0;0;0;0;.00nan;0;0
42512;68565;2173;53;21;3;18;.857;3600000;0
42512;143063;2173;0;0;0;0;.00nan;0;0
42513;7332;1869;0;0;0;0;.00nan;0;0
42513;11851;1475;72;21;1;20;.952;3600000;0
42513;143036;1475;0;0;0;0;.00nan;0;0
42513;155529;1869;74;41;4;37;.902;3600000;0
42514;174589;522;29;14;4;10;.714;961000;0
42514;81096;523;0;0;0;0;.00nan;0;0
42514;152464;523;66;20;2;18;.900;3600000;0
42514;155474;522;68;45;4;41;.911;2639000;0
42515;190258;1861;0;0;0;0;.00nan;0;0
42515;54290;1871;60;18;2;16;.889;3600000;0
42515;67764;1871;0;0;0;0;.00nan;0;0
42515;68627;1861;75;44;4;40;.909;3600000;0
42516;167036;1877;0;0;0;0;.00nan;0;0
42516;205990;1477;0;0;0;0;.00nan;0;0
42516;143412;1877;66;37;3;34;.919;3549000;0
42516;143479;1477;75;29;2;27;.931;3600000;0
42517;7534;1481;60;16;1;15;.938;746000;0
42517;178789;1481;41;31;6;25;.806;2854000;0
42517;170294;521;62;12;1;11;.917;3600000;0
42517;143523;521;0;0;0;0;.00nan;0;0
42518;9373;1854;0;0;0;0;.00nan;0;0
42518;169325;1854;67;27;2;25;.926;3551000;0
42518;185041;3922;80;24;1;23;.958;3600000;0
42518;89998;3922;0;0;0;0;.00nan;0;0
42519;174589;522;66;18;1;17;.944;3600000;0
42519;185041;3922;67;33;4;29;.879;3600000;0
42519;89998;3922;0;0;0;0;.00nan;0;0
42519;155474;522;0;0;0;0;.00nan;0;0
42520;68565;2173;66;53;6;47;.887;3600000;0
42520;81096;523;77;20;1;19;.950;3600000;0
42520;143063;2173;0;0;0;0;.00nan;0;0
42520;152464;523;0;0;0;0;.00nan;0;0
42521;7534;1481;97;41;1;40;.976;3900000;0
42521;178789;1481;0;0;0;0;.00nan;0;0
42521;205990;1477;0;0;0;0;.00nan;0;0
42521;143479;1477;100;31;1;30;.968;3900000;0
42522;167036;1877;0;0;0;0;.00nan;0;0
42522;190258;1861;100;35;0;35;1.000;3600000;0
42522;68627;1861;0;0;0;0;.00nan;0;0
42522;143412;1877;79;38;2;36;.947;3543000;0
42523;7332;1869;91;45;3;42;.933;3600000;0
42523;54290;1871;46;26;5;21;.808;3549000;0
42523;67764;1871;0;0;0;0;.00nan;0;0
42523;155529;1869;0;0;0;0;.00nan;0;0
42524;177504;524;69;32;3;29;.906;3600000;0
42524;8035;524;0;0;0;0;.00nan;0;0
42524;11851;1475;0;0;0;0;.00nan;0;0
42524;143036;1475;99;15;0;15;1.000;3600000;0
42525;9373;1854;94;60;2;58;.967;3600000;0
42525;169325;1854;0;0;0;0;.00nan;0;0
42525;170294;521;32;10;3;7;.700;3545000;0
42525;143523;521;0;0;0;0;.00nan;0;0
42526;177504;524;0;0;0;0;.00nan;0;0
42526;8035;524;58;35;4;31;.886;3600000;0
42526;54290;1871;100;30;0;30;1.000;3600000;0
42526;67764;1871;0;0;0;0;.00nan;0;0
42527;7332;1869;69;10;0;10;1.000;759000;0
42527;81096;523;74;24;1;23;.958;3600000;0
42527;152464;523;0;0;0;0;.00nan;0;0
42527;155529;1869;39;28;6;22;.786;2841000;0
42528;11851;1475;0;0;0;0;.00nan;0;0
42528;190258;1861;49;41;6;35;.854;2535000;0
42528;68627;1861;54;6;0;6;1.000;1065000;0
42528;143036;1475;87;18;0;18;1.000;3600000;0
42529;205990;1477;83;24;1;23;.958;3600000;0
42529;174589;522;59;38;4;34;.895;3600000;0
42529;143479;1477;0;0;0;0;.00nan;0;0
42529;155474;522;0;0;0;0;.00nan;0;0
42530;167036;1877;79;18;0;18;1.000;1571000;0
42530;170294;521;0;0;0;0;.00nan;0;0
42530;143412;1877;59;35;4;31;.886;2328000;0
42530;143523;521;34;18;4;14;.778;3900000;0
42531;7534;1481;0;0;0;0;.00nan;0;0
42531;178789;1481;77;39;3;36;.923;3600000;0
42531;185041;3922;75;23;2;21;.913;3600000;0
42531;89998;3922;0;0;0;0;.00nan;0;0
42532;9373;1854;100;33;0;33;1.000;3600000;0
42532;169325;1854;0;0;0;0;.00nan;0;0
42532;68565;2173;48;20;3;17;.850;3600000;0
42532;143063;2173;0;0;0;0;.00nan;0;0
42533;9373;1854;46;30;5;25;.833;3900000;0
42533;169325;1854;0;0;0;0;.00nan;0;0
42533;174589;522;65;39;5;34;.872;3896000;0
42533;155474;522;0;0;0;0;.00nan;0;0
42534;185041;3922;18;23;6;17;.739;3600000;0
42534;68565;2173;74;22;2;20;.909;3600000;0
42534;89998;3922;0;0;0;0;.00nan;0;0
42534;143063;2173;0;0;0;0;.00nan;0;0
42535;7332;1869;0;0;0;0;.00nan;0;0
42535;190258;1861;92;30;1;29;.967;3600000;0
42535;68627;1861;0;0;0;0;.00nan;0;0
42535;155529;1869;53;27;4;23;.852;3600000;0
42536;177504;524;0;0;0;0;.00nan;0;0
42536;7534;1481;0;0;0;0;.00nan;0;0
42536;8035;524;65;24;2;22;.917;3600000;0
42536;178789;1481;43;25;4;21;.840;3538000;0
42537;167036;1877;0;0;0;0;.00nan;0;0
42537;81096;523;64;22;2;20;.909;3900000;0
42537;143412;1877;84;37;2;35;.946;3900000;0
42537;152464;523;0;0;0;0;.00nan;0;0
42538;170294;521;96;23;0;23;1.000;3600000;0
42538;54290;1871;63;46;5;41;.891;3600000;0
42538;67764;1871;0;0;0;0;.00nan;0;0
42538;143523;521;0;0;0;0;.00nan;0;0
42539;11851;1475;0;0;0;0;.00nan;0;0
42539;205990;1477;0;0;0;0;.00nan;0;0
42539;143036;1475;41;18;4;14;.778;3900000;0
42539;143479;1477;56;37;4;33;.892;3900000;0
42540;7534;1481;0;0;0;0;.00nan;0;0
42540;178789;1481;56;23;3;20;.870;3600000;0
42540;174589;522;51;35;5;30;.857;3558000;0
42540;155474;522;0;0;0;0;.00nan;0;0
42541;177504;524;0;0;0;0;.00nan;0;0
42541;7332;1869;0;0;0;0;.00nan;0;0
42541;8035;524;56;28;4;24;.857;3640000;0
42541;155529;1869;52;23;3;20;.870;3640000;0
42542;11851;1475;88;40;2;38;.950;3600000;0
42542;81096;523;46;29;4;25;.862;3530000;0
42542;143036;1475;0;0;0;0;.00nan;0;0
42542;152464;523;0;0;0;0;.00nan;0;0
42543;205990;1477;60;19;2;17;.895;3600000;0
42543;190258;1861;55;45;6;39;.867;2911000;0
42543;68627;1861;32;11;3;8;.727;689000;0
42543;143479;1477;0;0;0;0;.00nan;0;0
42544;170294;521;0;0;0;0;.00nan;0;0
42544;68565;2173;75;53;6;47;.887;3600000;0
42544;143063;2173;0;0;0;0;.00nan;0;0
42544;143523;521;87;19;1;18;.947;3600000;0
42545;167036;1877;0;0;0;0;.00nan;0;0
42545;185041;3922;73;39;3;36;.923;3546000;0
42545;89998;3922;0;0;0;0;.00nan;0;0
42545;143412;1877;76;32;2;30;.938;3600000;0
42546;9373;1854;0;0;0;0;.00nan;0;0
42546;169325;1854;97;57;3;54;.947;3600000;0
42546;54290;1871;79;11;0;11;1.000;3600000;0
42546;67764;1871;0;0;0;0;.00nan;0;0
42547;174589;522;96;37;1;36;.973;3600000;0
42547;68565;2173;52;9;1;8;.889;1638000;0
42547;143063;2173;19;17;5;12;.706;1962000;0
42547;155474;522;0;0;0;0;.00nan;0;0
42548;7332;1869;0;0;0;0;.00nan;0;0
42548;205990;1477;0;0;0;0;.00nan;0;0
42548;143479;1477;68;20;1;19;.950;3600000;0
42548;155529;1869;81;36;2;34;.944;3543000;0
42549;190258;1861;48;46;6;40;.870;3600000;0
42549;68627;1861;0;0;0;0;.00nan;0;0
42549;81096;523;63;11;1;10;.909;3600000;0
42549;152464;523;0;0;0;0;.00nan;0;0
42550;7534;1481;0;0;0;0;.00nan;0;0
42550;9373;1854;24;27;6;21;.778;2748000;0
42550;169325;1854;49;2;0;2;1.000;852000;0
42550;178789;1481;58;18;2;16;.889;3600000;0
42551;167036;1877;0;0;0;0;.00nan;0;0
42551;177504;524;0;0;0;0;.00nan;0;0
42551;8035;524;56;17;3;14;.824;3900000;0
42551;143412;1877;73;37;3;34;.919;3900000;0
42552;185041;3922;100;44;1;43;.977;3600000;0
42552;54290;1871;71;28;2;26;.929;3600000;0
42552;67764;1871;0;0;0;0;.00nan;0;0
42552;89998;3922;0;0;0;0;.00nan;0;0
42553;11851;1475;0;0;0;0;.00nan;0;0
42553;170294;521;0;0;0;0;.00nan;0;0
42553;143036;1475;78;28;2;26;.929;3600000;0
42553;143523;521;66;29;3;26;.897;3600000;0
42554;174589;522;88;50;3;47;.940;3566000;0
42554;54290;1871;54;9;2;7;.778;3600000;0
42554;67764;1871;0;0;0;0;.00nan;0;0
42554;155474;522;0;0;0;0;.00nan;0;0
42555;177504;524;0;0;0;0;.00nan;0;0
42555;8035;524;82;38;2;36;.947;3600000;0
42555;190258;1861;63;38;4;34;.895;3588000;0
42555;68627;1861;0;0;0;0;.00nan;0;0
42556;205990;1477;0;0;0;0;.00nan;0;0
42556;81096;523;70;37;4;33;.892;3600000;0
42556;143479;1477;51;24;3;21;.875;3600000;0
42556;152464;523;0;0;0;0;.00nan;0;0
42557;7534;1481;73;35;3;32;.914;3582000;0
42557;178789;1481;0;0;0;0;.00nan;0;0
42557;68565;2173;99;31;1;30;.968;3600000;0
42557;143063;2173;0;0;0;0;.00nan;0;0
42558;7332;1869;0;0;0;0;.00nan;0;0
42558;170294;521;53;15;2;13;.867;3600000;0
42558;143523;521;0;0;0;0;.00nan;0;0
42558;155529;1869;58;56;7;49;.875;3600000;0
42559;11851;1475;0;0;0;0;.00nan;0;0
42559;185041;3922;76;34;3;31;.912;3571000;0
42559;89998;3922;0;0;0;0;.00nan;0;0
42559;143036;1475;81;17;0;17;1.000;3600000;0
42560;167036;1877;0;0;0;0;.00nan;0;0
42560;9373;1854;0;0;0;0;.00nan;0;0
42560;169325;1854;52;28;4;24;.857;3515000;0
42560;143412;1877;67;25;2;23;.920;3600000;0
42561;7332;1869;0;0;0;0;.00nan;0;0
42561;185041;3922;61;26;2;24;.923;3900000;0
42561;89998;3922;0;0;0;0;.00nan;0;0
42561;155529;1869;61;25;2;23;.920;3900000;0
42562;177504;524;0;0;0;0;.00nan;0;0
42562;8035;524;72;31;2;29;.935;3600000;0
42562;81096;523;60;26;3;23;.885;3578000;0
42562;152464;523;0;0;0;0;.00nan;0;0
42563;9373;1854;0;0;0;0;.00nan;0;0
42563;169325;1854;100;24;0;24;1.000;3600000;0
42563;190258;1861;53;39;5;34;.872;3600000;0
42563;68627;1861;0;0;0;0;.00nan;0;0
42564;170294;521;0;0;0;0;.00nan;0;0
42564;205990;1477;99;46;1;45;.978;3600000;0
42564;143479;1477;0;0;0;0;.00nan;0;0
42564;143523;521;49;15;2;13;.867;3546000;0
42565;167036;1877;0;0;0;0;.00nan;0;0
42565;7534;1481;0;0;0;0;.00nan;0;0
42565;178789;1481;55;36;4;32;.889;3600000;0
42565;143412;1877;67;16;1;15;.938;3600000;0
42566;54290;1871;0;0;0;0;.00nan;0;0
42566;67764;1871;63;16;1;15;.938;3600000;0
42566;68565;2173;78;47;4;43;.915;3600000;0
42566;143063;2173;0;0;0;0;.00nan;0;0
42567;11851;1475;67;33;3;30;.909;3600000;0
42567;174589;522;42;34;7;27;.794;3600000;0
42567;143036;1475;0;0;0;0;.00nan;0;0
42567;155474;522;0;0;0;0;.00nan;0;0
42568;167036;1877;0;0;0;0;.00nan;0;0
42568;174589;522;71;24;2;22;.917;3600000;0
42568;143412;1877;68;53;6;47;.887;3600000;0
42568;155474;522;0;0;0;0;.00nan;0;0
42569;177504;524;0;0;0;0;.00nan;0;0
42569;8035;524;95;42;2;40;.952;3600000;0
42569;205990;1477;33;31;6;25;.806;3600000;0
42569;143479;1477;0;0;0;0;.00nan;0;0
42570;7332;1869;0;0;0;0;.00nan;0;0
42570;68565;2173;69;33;2;31;.939;3562000;0
42570;143063;2173;0;0;0;0;.00nan;0;0
42570;155529;1869;100;25;0;25;1.000;3600000;0
42571;7534;1481;0;0;0;0;.00nan;0;0
42571;178789;1481;45;26;4;22;.846;3553000;0
42571;54290;1871;68;32;3;29;.906;3600000;0
42571;67764;1871;0;0;0;0;.00nan;0;0
42572;170294;521;76;9;0;9;1.000;3600000;0
42572;190258;1861;51;46;7;39;.848;2425000;0
42572;68627;1861;66;19;1;18;.947;1175000;0
42572;143523;521;0;0;0;0;.00nan;0;0
42573;185041;3922;0;0;0;0;.00nan;0;0
42573;81096;523;90;16;0;16;1.000;3600000;0
42573;89998;3922;94;47;3;44;.936;3600000;0
42573;152464;523;0;0;0;0;.00nan;0;0
42574;9373;1854;51;2;0;2;1.000;505000;0
42574;11851;1475;0;0;0;0;.00nan;0;0
42574;169325;1854;38;38;6;32;.842;3095000;0
42574;143036;1475;62;23;3;20;.870;3600000;0
42575;177504;524;0;0;0;0;.00nan;0;0
42575;8035;524;97;56;3;53;.946;3594000;0
42575;170294;521;0;0;0;0;.00nan;0;0
42575;143523;521;63;18;1;17;.944;3600000;0
42576;7332;1869;0;0;0;0;.00nan;0;0
42576;174589;522;36;20;4;16;.800;3600000;0
42576;155474;522;0;0;0;0;.00nan;0;0
42576;155529;1869;27;25;5;20;.800;3558000;0
42577;9373;1854;65;32;3;29;.906;3546000;0
42577;169325;1854;0;0;0;0;.00nan;0;0
42577;81096;523;68;16;1;15;.938;3600000;0
42577;152464;523;0;0;0;0;.00nan;0;0
42578;7534;1481;0;0;0;0;.00nan;0;0
42578;178789;1481;60;31;3;28;.903;3574000;0
42578;190258;1861;80;29;2;27;.931;3600000;0
42578;68627;1861;0;0;0;0;.00nan;0;0
42579;205990;1477;0;0;0;0;.00nan;0;0
42579;185041;3922;47;34;6;28;.824;3600000;0
42579;89998;3922;0;0;0;0;.00nan;0;0
42579;143479;1477;59;20;2;18;.900;3600000;0
42580;167036;1877;29;14;4;10;.714;2250000;0
42580;54290;1871;45;23;4;19;.826;3600000;0
42580;67764;1871;0;0;0;0;.00nan;0;0
42580;143412;1877;70;22;1;21;.955;1328000;0
42581;11851;1475;63;20;2;18;.900;3600000;0
42581;68565;2173;58;45;5;40;.889;3600000;0
42581;143036;1475;0;0;0;0;.00nan;0;0
42581;143063;2173;0;0;0;0;.00nan;0;0
42582;174589;522;57;20;2;18;.900;3900000;0
42582;190258;1861;81;34;2;32;.941;3900000;0
42582;68627;1861;0;0;0;0;.00nan;0;0
42582;155474;522;0;0;0;0;.00nan;0;0
42583;167036;1877;0;0;0;0;.00nan;0;0
42583;68565;2173;0;0;0;0;.00nan;0;0
42583;143063;2173;64;28;3;25;.893;3600000;0
42583;143412;1877;56;34;4;30;.882;3587000;0
42584;7534;1481;95;30;1;29;.967;3900000;0
42584;11851;1475;0;0;0;0;.00nan;0;0
42584;178789;1481;0;0;0;0;.00nan;0;0
42584;143036;1475;86;23;1;22;.957;3900000;0
42585;170294;521;84;27;1;26;.963;3600000;0
42585;81096;523;74;30;2;28;.933;3600000;0
42585;143523;521;0;0;0;0;.00nan;0;0
42585;152464;523;0;0;0;0;.00nan;0;0
42586;205990;1477;35;24;5;19;.792;3556000;0
42586;54290;1871;0;0;0;0;.00nan;0;0
42586;67764;1871;73;34;4;30;.882;3600000;0
42586;143479;1477;0;0;0;0;.00nan;0;0
42587;177504;524;0;0;0;0;.00nan;0;0
42587;8035;524;51;24;4;20;.833;3543000;0
42587;185041;3922;83;32;3;29;.906;3600000;0
42587;89998;3922;0;0;0;0;.00nan;0;0
42588;7332;1869;0;0;0;0;.00nan;0;0
42588;9373;1854;53;26;3;23;.885;3589000;0
42588;169325;1854;0;0;0;0;.00nan;0;0
42588;155529;1869;93;35;2;33;.943;3600000;0
42589;170294;521;0;0;0;0;.00nan;0;0
42589;174589;522;97;49;2;47;.959;3543000;0
42589;143523;521;85;14;0;14;1.000;3600000;0
42589;155474;522;0;0;0;0;.00nan;0;0
42590;205990;1477;0;0;0;0;.00nan;0;0
42590;68565;2173;88;44;5;39;.886;3600000;0
42590;143063;2173;0;0;0;0;.00nan;0;0
42590;143479;1477;43;18;3;15;.833;3600000;0
42591;7534;1481;0;0;0;0;.00nan;0;0
42591;178789;1481;75;56;5;51;.911;3600000;0
42591;81096;523;57;21;2;19;.905;3600000;0
42591;152464;523;0;0;0;0;.00nan;0;0
42592;167036;1877;0;0;0;0;.00nan;0;0
42592;7332;1869;0;0;0;0;.00nan;0;0
42592;143412;1877;64;37;4;33;.892;3725000;0
42592;155529;1869;70;32;3;29;.906;3725000;0
42593;11851;1475;64;28;3;25;.893;3600000;0
42593;54290;1871;60;38;4;34;.895;3578000;0
42593;67764;1871;0;0;0;0;.00nan;0;0
42593;143036;1475;0;0;0;0;.00nan;0;0
42594;190258;1861;49;23;4;19;.826;3600000;0
42594;185041;3922;83;28;1;27;.964;3600000;0
42594;68627;1861;0;0;0;0;.00nan;0;0
42594;89998;3922;0;0;0;0;.00nan;0;0
42595;177504;524;0;0;0;0;.00nan;0;0
42595;8035;524;65;29;4;25;.862;3600000;0
42595;9373;1854;0;0;0;0;.00nan;0;0
42595;169325;1854;73;21;1;20;.952;3600000;0
42596;177504;524;0;0;0;0;.00nan;0;0
42596;8035;524;94;29;1;28;.966;3600000;0
42596;174589;522;68;32;4;28;.875;3600000;0
42596;155474;522;0;0;0;0;.00nan;0;0
42597;7332;1869;57;21;2;19;.905;3600000;0
42597;7534;1481;0;0;0;0;.00nan;0;0
42597;178789;1481;32;29;5;24;.828;3600000;0
42597;155529;1869;0;0;0;0;.00nan;0;0
42598;54290;1871;56;36;4;32;.889;3557000;0
42598;67764;1871;0;0;0;0;.00nan;0;0
42598;81096;523;0;0;0;0;.00nan;0;0
42598;152464;523;69;32;3;29;.906;3600000;0
42599;190258;1861;0;0;0;0;.00nan;0;0
42599;68565;2173;84;29;1;28;.966;3900000;0
42599;68627;1861;92;32;1;31;.969;3900000;0
42599;143063;2173;0;0;0;0;.00nan;0;0
42600;9373;1854;0;0;0;0;.00nan;0;0
42600;169325;1854;92;41;2;39;.951;3583000;0
42600;205990;1477;0;0;0;0;.00nan;0;0
42600;143479;1477;92;28;1;27;.964;3600000;0
42601;170294;521;0;0;0;0;.00nan;0;0
42601;185041;3922;22;4;3;1;.250;345000;0
42601;89998;3922;63;34;3;31;.912;3255000;0
42601;143523;521;74;19;1;18;.947;3600000;0
42602;167036;1877;0;0;0;0;.00nan;0;0
42602;11851;1475;0;0;0;0;.00nan;0;0
42602;143036;1475;53;13;2;11;.846;3600000;0
42602;143412;1877;53;25;3;22;.880;3547000;0
42603;174589;522;73;41;3;38;.927;3600000;0
42603;81096;523;69;19;1;18;.947;3600000;0
42603;152464;523;0;0;0;0;.00nan;0;0
42603;155474;522;0;0;0;0;.00nan;0;0
42604;177504;524;0;0;0;0;.00nan;0;0
42604;8035;524;63;22;2;20;.909;3600000;0
42604;68565;2173;72;39;4;35;.897;3541000;0
42604;143063;2173;0;0;0;0;.00nan;0;0
42605;7534;1481;0;0;0;0;.00nan;0;0
42605;178789;1481;95;49;3;46;.939;3600000;0
42605;170294;521;76;11;0;11;1.000;3600000;0
42605;143523;521;0;0;0;0;.00nan;0;0
42606;167036;1877;0;0;0;0;.00nan;0;0
42606;205990;1477;0;0;0;0;.00nan;0;0
42606;143412;1877;78;35;3;32;.914;3517000;0
42606;143479;1477;77;26;1;25;.962;3600000;0
42607;190258;1861;65;50;5;45;.900;3600000;0
42607;54290;1871;0;0;0;0;.00nan;0;0
42607;67764;1871;76;11;0;11;1.000;3600000;0
42607;68627;1861;0;0;0;0;.00nan;0;0
42608;7332;1869;0;0;0;0;.00nan;0;0
42608;11851;1475;53;26;3;23;.885;3600000;0
42608;143036;1475;0;0;0;0;.00nan;0;0
42608;155529;1869;81;49;4;45;.918;3551000;0
42609;9373;1854;15;21;6;15;.714;3254000;0
42609;169325;1854;49;1;0;1;1.000;346000;0
42609;185041;3922;92;43;3;40;.930;3600000;0
42609;89998;3922;0;0;0;0;.00nan;0;0
42610;177504;524;0;0;0;0;.00nan;0;0
42610;8035;524;97;44;1;43;.977;3900000;0
42610;11851;1475;0;0;0;0;.00nan;0;0
42610;143036;1475;82;24;1;23;.958;3900000;0
42611;7332;1869;0;0;0;0;.00nan;0;0
42611;54290;1871;0;0;0;0;.00nan;0;0
42611;67764;1871;79;22;1;21;.955;3900000;0
42611;155529;1869;97;42;1;41;.976;3900000;0
42612;68565;2173;71;39;3;36;.923;3600000;0
42612;81096;523;41;19;4;15;.789;3544000;0
42612;143063;2173;0;0;0;0;.00nan;0;0
42612;152464;523;0;0;0;0;.00nan;0;0
42613;167036;1877;0;0;0;0;.00nan;0;0
42613;190258;1861;96;36;1;35;.972;3600000;0
42613;68627;1861;0;0;0;0;.00nan;0;0
42613;143412;1877;47;38;5;33;.868;3600000;0
42614;7534;1481;0;0;0;0;.00nan;0;0
42614;178789;1481;65;38;5;33;.868;3600000;0
42614;205990;1477;0;0;0;0;.00nan;0;0
42614;143479;1477;52;15;2;13;.867;3600000;0
42615;9373;1854;80;43;3;40;.930;3600000;0
42615;169325;1854;0;0;0;0;.00nan;0;0
42615;170294;521;65;11;1;10;.909;3600000;0
42615;143523;521;0;0;0;0;.00nan;0;0
42616;174589;522;47;42;6;36;.857;3600000;0
42616;185041;3922;100;28;0;28;1.000;3600000;0
42616;89998;3922;0;0;0;0;.00nan;0;0
42616;155474;522;0;0;0;0;.00nan;0;0
42617;205990;1477;0;0;0;0;.00nan;0;0
42617;174589;522;92;35;1;34;.971;3589000;0
42617;143479;1477;79;15;0;15;1.000;3600000;0
42617;155474;522;0;0;0;0;.00nan;0;0
42618;9373;1854;64;27;3;24;.889;3600000;0
42618;169325;1854;0;0;0;0;.00nan;0;0
42618;68565;2173;0;0;0;0;.00nan;0;0
42618;143063;2173;34;25;6;19;.760;3600000;0
42619;7332;1869;0;0;0;0;.00nan;0;0
42619;81096;523;84;24;1;23;.958;3600000;0
42619;152464;523;0;0;0;0;.00nan;0;0
42619;155529;1869;60;40;5;35;.875;3600000;0
42620;7534;1481;71;26;2;24;.923;3600000;0
42620;178789;1481;0;0;0;0;.00nan;0;0
42620;185041;3922;63;24;3;21;.875;3555000;0
42620;89998;3922;0;0;0;0;.00nan;0;0
42621;167036;1877;0;0;0;0;.00nan;0;0
42621;170294;521;0;0;0;0;.00nan;0;0
42621;143412;1877;98;61;3;58;.951;3572000;0
42621;143523;521;58;14;2;12;.857;3600000;0
42622;177504;524;0;0;0;0;.00nan;0;0
42622;8035;524;96;35;0;35;1.000;3900000;0
42622;54290;1871;100;23;0;23;1.000;3900000;0
42622;67764;1871;0;0;0;0;.00nan;0;0
42623;11851;1475;69;19;2;17;.895;3600000;0
42623;190258;1861;46;38;5;33;.868;3600000;0
42623;68627;1861;0;0;0;0;.00nan;0;0
42623;143036;1475;0;0;0;0;.00nan;0;0
42624;177504;524;0;0;0;0;.00nan;0;0
42624;7534;1481;87;35;2;33;.943;3600000;0
42624;8035;524;63;29;3;26;.897;3567000;0
42624;178789;1481;0;0;0;0;.00nan;0;0
42625;167036;1877;69;20;1;19;.950;2539000;0
42625;81096;523;59;21;3;18;.857;3600000;0
42625;143412;1877;41;20;4;16;.800;1032000;0
42625;152464;523;0;0;0;0;.00nan;0;0
42626;7332;1869;0;0;0;0;.00nan;0;0
42626;190258;1861;69;33;3;30;.909;3600000;0
42626;68627;1861;0;0;0;0;.00nan;0;0
42626;155529;1869;59;32;4;28;.875;3550000;0
42627;11851;1475;0;0;0;0;.00nan;0;0
42627;63848;1477;0;0;0;0;.00nan;0;0
42627;143036;1475;40;25;4;21;.840;3589000;0
42627;143479;1477;80;26;2;24;.923;3600000;0
42628;170294;521;42;14;3;11;.786;3600000;0
42628;54290;1871;77;46;4;42;.913;3585000;0
42628;67764;1871;0;0;0;0;.00nan;0;0
42628;143523;521;0;0;0;0;.00nan;0;0
42629;185041;3922;83;19;0;19;1.000;3600000;0
42629;68565;2173;85;27;1;26;.963;3578000;0
42629;89998;3922;0;0;0;0;.00nan;0;0
42629;143063;2173;0;0;0;0;.00nan;0;0
42630;9373;1854;0;0;0;0;.00nan;0;0
42630;169325;1854;92;37;2;35;.946;3600000;0
42630;174589;522;59;30;3;27;.900;3566000;0
42630;155474;522;0;0;0;0;.00nan;0;0
42631;170294;521;0;0;0;0;.00nan;0;0
42631;68565;2173;62;32;3;29;.906;3600000;0
42631;143063;2173;0;0;0;0;.00nan;0;0
42631;143523;521;77;9;0;9;1.000;3600000;0
42632;177504;524;0;0;0;0;.00nan;0;0
42632;7332;1869;94;24;0;24;1.000;3600000;0
42632;8035;524;65;28;2;26;.929;3517000;0
42632;155529;1869;0;0;0;0;.00nan;0;0
42633;190258;1861;0;0;0;0;.00nan;0;0
42633;63848;1477;62;22;2;20;.909;3600000;0
42633;68627;1861;82;52;5;47;.904;3600000;0
42633;143479;1477;0;0;0;0;.00nan;0;0
42634;7534;1481;0;0;0;0;.00nan;0;0
42634;178789;1481;58;29;4;25;.862;3519000;0
42634;174589;522;83;33;2;31;.939;3600000;0
42634;155474;522;0;0;0;0;.00nan;0;0
42635;167036;1877;0;0;0;0;.00nan;0;0
42635;185041;3922;53;28;4;24;.857;3560000;0
42635;89998;3922;0;0;0;0;.00nan;0;0
42635;143412;1877;72;28;3;25;.893;3600000;0
42636;9373;1854;0;0;0;0;.00nan;0;0
42636;169325;1854;77;44;3;41;.932;3575000;0
42636;54290;1871;0;0;0;0;.00nan;0;0
42636;67764;1871;63;25;2;23;.920;3600000;0
42637;11851;1475;89;39;2;37;.949;3600000;0
42637;81096;523;66;31;3;28;.903;3546000;0
42637;143036;1475;0;0;0;0;.00nan;0;0
42637;152464;523;0;0;0;0;.00nan;0;0
42638;174589;522;83;33;1;32;.970;3600000;0
42638;68565;2173;75;40;4;36;.900;3600000;0
42638;143063;2173;0;0;0;0;.00nan;0;0
42638;155474;522;0;0;0;0;.00nan;0;0
42639;167036;1877;0;0;0;0;.00nan;0;0
42639;177504;524;81;32;2;30;.938;3600000;0
42639;8035;524;0;0;0;0;.00nan;0;0
42639;143412;1877;62;29;3;26;.897;3597000;0
42640;190258;1861;98;49;2;47;.959;3567000;0
42640;68627;1861;0;0;0;0;.00nan;0;0
42640;81096;523;70;6;0;6;1.000;3600000;0
42640;152464;523;0;0;0;0;.00nan;0;0
42641;7332;1869;83;47;4;43;.915;3600000;0
42641;63848;1477;72;20;1;19;.950;3600000;0
42641;143479;1477;0;0;0;0;.00nan;0;0
42641;155529;1869;0;0;0;0;.00nan;0;0
42642;11851;1475;0;0;0;0;.00nan;0;0
42642;170294;521;0;0;0;0;.00nan;0;0
42642;143036;1475;68;33;4;29;.879;3570000;0
42642;143523;521;55;22;3;19;.864;3600000;0
42643;185041;3922;0;0;0;0;.00nan;0;0
42643;54290;1871;99;28;0;28;1.000;3600000;0
42643;67764;1871;0;0;0;0;.00nan;0;0
42643;89998;3922;58;32;4;28;.875;3600000;0
42644;7534;1481;0;0;0;0;.00nan;0;0
42644;9373;1854;0;0;0;0;.00nan;0;0
42644;169325;1854;90;20;0;20;1.000;3600000;0
42644;178789;1481;83;25;1;24;.960;3555000;0
42645;7534;1481;0;0;0;0;.00nan;0;0
42645;178789;1481;63;41;4;37;.902;3562000;0
42645;68565;2173;0;0;0;0;.00nan;0;0
42645;143063;2173;60;22;2;20;.909;3600000;0
42646;7332;1869;0;0;0;0;.00nan;0;0
42646;170294;521;62;18;2;16;.889;3600000;0
42646;143523;521;0;0;0;0;.00nan;0;0
42646;155529;1869;65;44;5;39;.886;3600000;0
42647;177504;524;0;0;0;0;.00nan;0;0
42647;8035;524;80;29;2;27;.931;3557000;0
42647;190258;1861;87;24;1;23;.958;3600000;0
42647;68627;1861;0;0;0;0;.00nan;0;0
42648;63848;1477;70;27;2;25;.926;3512000;0
42648;81096;523;100;28;0;28;1.000;3600000;0
42648;143479;1477;0;0;0;0;.00nan;0;0
42648;152464;523;0;0;0;0;.00nan;0;0
42649;167036;1877;63;29;3;26;.897;3600000;0
42649;9373;1854;0;0;0;0;.00nan;0;0
42649;169325;1854;66;36;4;32;.889;3594000;0
42649;143412;1877;0;0;0;0;.00nan;0;0
42650;174589;522;73;28;2;26;.929;3600000;0
42650;54290;1871;67;32;4;28;.875;3600000;0
42650;67764;1871;0;0;0;0;.00nan;0;0
42650;155474;522;0;0;0;0;.00nan;0;0
42651;11851;1475;75;21;1;20;.952;3600000;0
42651;185041;3922;72;43;4;39;.907;3600000;0
42651;89998;3922;0;0;0;0;.00nan;0;0
42651;143036;1475;0;0;0;0;.00nan;0;0
42652;11851;1475;0;0;0;0;.00nan;0;0
42652;174589;522;56;30;4;26;.867;1944000;0
42652;143036;1475;66;15;1;14;.933;3600000;0
42652;155474;522;65;17;1;16;.941;1656000;0
42653;177504;524;0;0;0;0;.00nan;0;0
42653;8035;524;97;53;2;51;.962;3542000;0
42653;81096;523;62;15;1;14;.933;3600000;0
42653;152464;523;0;0;0;0;.00nan;0;0
42654;54290;1871;70;19;1;18;.947;3600000;0
42654;67764;1871;0;0;0;0;.00nan;0;0
42654;68565;2173;54;36;5;31;.861;3600000;0
42654;143063;2173;0;0;0;0;.00nan;0;0
42655;167036;1877;0;0;0;0;.00nan;0;0
42655;7534;1481;0;0;0;0;.00nan;0;0
42655;178789;1481;69;33;3;30;.909;3600000;0
42655;143412;1877;35;24;5;19;.792;3573000;0
42656;170294;521;64;11;1;10;.909;3600000;0
42656;63848;1477;86;57;4;53;.930;3600000;0
42656;143479;1477;0;0;0;0;.00nan;0;0
42656;143523;521;0;0;0;0;.00nan;0;0
42657;7332;1869;0;0;0;0;.00nan;0;0
42657;185041;3922;92;36;2;34;.944;3679000;0
42657;89998;3922;0;0;0;0;.00nan;0;0
42657;155529;1869;93;35;1;34;.971;3679000;0
42658;9373;1854;0;0;0;0;.00nan;0;0
42658;169325;1854;100;22;0;22;1.000;3600000;0
42658;190258;1861;54;36;4;32;.889;3600000;0
42658;68627;1861;0;0;0;0;.00nan;0;0
42659;7332;1869;76;21;1;20;.952;3600000;0
42659;68565;2173;60;41;5;36;.878;3600000;0
42659;143063;2173;0;0;0;0;.00nan;0;0
42659;155529;1869;0;0;0;0;.00nan;0;0
42660;185041;3922;71;47;5;42;.894;3600000;0
42660;81096;523;63;17;1;16;.941;3600000;0
42660;89998;3922;0;0;0;0;.00nan;0;0
42660;152464;523;0;0;0;0;.00nan;0;0
42661;170294;521;0;0;0;0;.00nan;0;0
42661;190258;1861;90;47;3;44;.936;3600000;0
42661;68627;1861;0;0;0;0;.00nan;0;0
42661;143523;521;90;18;0;18;1.000;3600000;0
42662;177504;524;0;0;0;0;.00nan;0;0
42662;8035;524;90;46;3;43;.935;3600000;0
42662;63848;1477;23;20;6;14;.700;2974000;0
42662;143479;1477;52;3;0;3;1.000;626000;0
42663;167036;1877;0;0;0;0;.00nan;0;0
42663;174589;522;100;39;1;38;.974;3900000;0
42663;143412;1877;83;27;1;26;.963;3900000;0
42663;155474;522;0;0;0;0;.00nan;0;0
42664;7534;1481;0;0;0;0;.00nan;0;0
42664;178789;1481;88;34;2;32;.941;3600000;0
42664;54290;1871;40;36;6;30;.833;3600000;0
42664;67764;1871;0;0;0;0;.00nan;0;0
42665;9373;1854;0;0;0;0;.00nan;0;0
42665;11851;1475;100;27;0;27;1.000;3600000;0
42665;169325;1854;72;30;2;28;.933;3549000;0
42665;143036;1475;0;0;0;0;.00nan;0;0
42666;7332;1869;0;0;0;0;.00nan;0;0
42666;174589;522;0;0;0;0;.00nan;0;0
42666;155474;522;56;35;5;30;.857;3600000;0
42666;155529;1869;67;23;2;21;.913;3600000;0
42667;11851;1475;82;22;1;21;.955;3600000;0
42667;68565;2173;75;43;4;39;.907;3600000;0
42667;143036;1475;0;0;0;0;.00nan;0;0
42667;143063;2173;0;0;0;0;.00nan;0;0
42668;7534;1481;63;17;1;16;.941;3600000;0
42668;206007;1481;0;0;0;0;.00nan;0;0
42668;190258;1861;28;29;6;23;.793;3600000;0
42668;68627;1861;0;0;0;0;.00nan;0;0
42669;177504;524;24;11;4;7;.636;875000;0
42669;8035;524;67;73;6;67;.918;2725000;0
42669;170294;521;0;0;0;0;.00nan;0;0
42669;143523;521;74;10;0;10;1.000;3600000;0
42670;167036;1877;0;0;0;0;.00nan;0;0
42670;54290;1871;47;14;2;12;.857;3600000;0
42670;67764;1871;0;0;0;0;.00nan;0;0
42670;143412;1877;65;39;4;35;.897;3600000;0
42671;185041;3922;0;0;0;0;.00nan;0;0
42671;63848;1477;90;17;0;17;1.000;3600000;0
42671;89998;3922;63;39;5;34;.872;3600000;0
42671;143479;1477;0;0;0;0;.00nan;0;0
42672;9373;1854;0;0;0;0;.00nan;0;0
42672;169325;1854;81;44;4;40;.909;3900000;0
42672;81096;523;54;28;4;24;.857;3900000;0
42672;152464;523;0;0;0;0;.00nan;0;0
42673;177504;524;0;0;0;0;.00nan;0;0
42673;8035;524;56;22;3;19;.864;3900000;0
42673;185041;3922;61;28;3;25;.893;3900000;0
42673;89998;3922;0;0;0;0;.00nan;0;0
42674;7332;1869;79;28;1;27;.964;3600000;0
42674;9373;1854;0;0;0;0;.00nan;0;0
42674;169325;1854;50;33;4;29;.879;3600000;0
42674;155529;1869;0;0;0;0;.00nan;0;0
42675;170294;521;0;0;0;0;.00nan;0;0
42675;81096;523;66;42;5;37;.881;3565000;0
42675;143523;521;43;18;4;14;.778;3600000;0
42675;152464;523;0;0;0;0;.00nan;0;0
42676;174589;522;58;17;1;16;.941;3600000;0
42676;190258;1861;0;0;0;0;.00nan;0;0
42676;68627;1861;71;30;2;28;.933;3600000;0
42676;155474;522;0;0;0;0;.00nan;0;0
42677;54290;1871;53;30;4;26;.867;3900000;0
42677;63848;1477;50;28;4;24;.857;3900000;0
42677;67764;1871;0;0;0;0;.00nan;0;0
42677;143479;1477;0;0;0;0;.00nan;0;0
42678;167036;1877;0;0;0;0;.00nan;0;0
42678;68565;2173;76;25;1;24;.960;3600000;0
42678;143063;2173;0;0;0;0;.00nan;0;0
42678;143412;1877;58;29;3;26;.897;3582000;0
42679;7534;1481;98;51;3;48;.941;3551000;0
42679;11851;1475;0;0;0;0;.00nan;0;0
42679;206007;1481;0;0;0;0;.00nan;0;0
42679;143036;1475;78;29;2;27;.931;3600000;0
42680;177504;524;0;0;0;0;.00nan;0;0
42680;8035;524;78;29;2;27;.931;3548000;0
42680;9373;1854;0;0;0;0;.00nan;0;0
42680;169325;1854;97;27;0;27;1.000;3600000;0
42681;167036;1877;52;5;0;5;1.000;306000;0
42681;7332;1869;78;31;2;29;.935;3600000;0
42681;143412;1877;47;40;6;34;.850;3294000;0
42681;155529;1869;0;0;0;0;.00nan;0;0
42682;7534;1481;25;23;6;17;.739;2277000;0
42682;206007;1481;66;17;1;16;.941;1323000;0
42682;81096;523;69;18;1;17;.944;3600000;0
42682;152464;523;0;0;0;0;.00nan;0;0
42683;190258;1861;99;43;2;41;.953;3600000;0
42683;185041;3922;42;25;4;21;.840;3567000;0
42683;68627;1861;0;0;0;0;.00nan;0;0
42683;89998;3922;0;0;0;0;.00nan;0;0
42684;63848;1477;55;29;4;25;.862;3600000;0
42684;68565;2173;69;45;5;40;.889;3600000;0
42684;143063;2173;0;0;0;0;.00nan;0;0
42684;143479;1477;0;0;0;0;.00nan;0;0
42685;170294;521;76;24;2;22;.917;3600000;0
42685;174589;522;0;0;0;0;.00nan;0;0
42685;143523;521;0;0;0;0;.00nan;0;0
42685;155474;522;42;41;6;35;.854;3600000;0
42686;11851;1475;61;21;2;19;.905;3600000;0
42686;54290;1871;80;46;4;42;.913;3586000;0
42686;67764;1871;0;0;0;0;.00nan;0;0
42686;143036;1475;0;0;0;0;.00nan;0;0
42687;177504;524;0;0;0;0;.00nan;0;0
42687;8035;524;61;25;3;22;.880;3563000;0
42687;174589;522;85;38;2;36;.947;3600000;0
42687;155474;522;0;0;0;0;.00nan;0;0
42688;190258;1861;89;33;1;32;.970;3600000;0
42688;68565;2173;0;0;0;0;.00nan;0;0
42688;68627;1861;0;0;0;0;.00nan;0;0
42688;143063;2173;58;25;3;22;.880;3546000;0
42689;7332;1869;69;27;2;25;.926;3545000;0
42689;7534;1481;85;29;1;28;.966;3600000;0
42689;206007;1481;0;0;0;0;.00nan;0;0
42689;155529;1869;0;0;0;0;.00nan;0;0
42690;167036;1877;39;38;7;31;.816;3011000;0
42690;11851;1475;0;0;0;0;.00nan;0;0
42690;143036;1475;65;15;1;14;.933;3600000;0
42690;143412;1877;53;3;0;3;1.000;589000;0
42691;54290;1871;94;44;3;41;.932;3870000;0
42691;67764;1871;0;0;0;0;.00nan;0;0
42691;81096;523;94;34;2;32;.941;3870000;0
42691;152464;523;0;0;0;0;.00nan;0;0
42692;170294;521;0;0;0;0;.00nan;0;0
42692;185041;3922;65;48;5;43;.896;3600000;0
42692;89998;3922;0;0;0;0;.00nan;0;0
42692;143523;521;76;10;0;10;1.000;3600000;0
42693;9373;1854;0;0;0;0;.00nan;0;0
42693;169325;1854;100;39;0;39;1.000;3600000;0
42693;63848;1477;89;31;1;30;.968;3589000;0
42693;143479;1477;0;0;0;0;.00nan;0;0
42694;177504;524;0;0;0;0;.00nan;0;0
42694;8035;524;69;29;2;27;.931;3600000;0
42694;68565;2173;83;31;1;30;.968;3600000;0
42694;143063;2173;0;0;0;0;.00nan;0;0
42695;7332;1869;0;0;0;0;.00nan;0;0
42695;11851;1475;71;26;2;24;.923;3900000;0
42695;143036;1475;0;0;0;0;.00nan;0;0
42695;155529;1869;80;29;2;27;.931;3900000;0
42696;174589;522;78;40;2;38;.950;3600000;0
42696;81096;523;49;18;3;15;.833;3568000;0
42696;152464;523;0;0;0;0;.00nan;0;0
42696;155474;522;0;0;0;0;.00nan;0;0
42697;190258;1861;71;35;3;32;.914;3600000;0
42697;54290;1871;78;23;2;21;.913;3600000;0
42697;67764;1871;0;0;0;0;.00nan;0;0
42697;68627;1861;0;0;0;0;.00nan;0;0
42698;167036;1877;0;0;0;0;.00nan;0;0
42698;63848;1477;92;21;0;21;1.000;3600000;0
42698;143412;1877;93;50;3;47;.940;3600000;0
42698;143479;1477;0;0;0;0;.00nan;0;0
42699;7534;1481;37;32;6;26;.813;2232000;0
42699;170294;521;0;0;0;0;.00nan;0;0
42699;206007;1481;63;13;0;13;1.000;1368000;0
42699;143523;521;44;16;3;13;.813;3600000;0
42700;9373;1854;0;0;0;0;.00nan;0;0
42700;169325;1854;74;24;2;22;.917;3570000;0
42700;185041;3922;0;0;0;0;.00nan;0;0
42700;89998;3922;93;29;1;28;.966;3600000;0
42701;174589;522;95;34;1;33;.971;3600000;0
42701;185041;3922;71;35;2;33;.943;3563000;0
42701;89998;3922;0;0;0;0;.00nan;0;0
42701;155474;522;0;0;0;0;.00nan;0;0
42702;68565;2173;97;50;2;48;.960;3580000;0
42702;81096;523;87;17;0;17;1.000;3600000;0
42702;143063;2173;0;0;0;0;.00nan;0;0
42702;152464;523;0;0;0;0;.00nan;0;0
42703;7534;1481;67;32;3;29;.906;3570000;0
42703;206007;1481;0;0;0;0;.00nan;0;0
42703;63848;1477;64;19;2;17;.895;3600000;0
42703;143479;1477;0;0;0;0;.00nan;0;0
42704;167036;1877;0;0;0;0;.00nan;0;0
42704;190258;1861;51;35;5;30;.857;3600000;0
42704;68627;1861;0;0;0;0;.00nan;0;0
42704;143412;1877;89;21;0;21;1.000;3600000;0
42705;7332;1869;86;46;3;43;.935;3570000;0
42705;54290;1871;0;0;0;0;.00nan;0;0
42705;67764;1871;78;22;1;21;.955;3600000;0
42705;155529;1869;0;0;0;0;.00nan;0;0
42706;177504;524;0;0;0;0;.00nan;0;0
42706;8035;524;48;34;5;29;.853;3551000;0
42706;11851;1475;0;0;0;0;.00nan;0;0
42706;143036;1475;63;30;3;27;.900;3600000;0
42707;9373;1854;0;0;0;0;.00nan;0;0
42707;169325;1854;78;46;4;42;.913;3600000;0
42707;170294;521;0;0;0;0;.00nan;0;0
42707;143523;521;62;18;1;17;.944;3600000;0
42708;177504;524;60;16;1;15;.938;1519000;0
42708;8035;524;38;26;5;21;.808;2081000;0
42708;54290;1871;75;28;2;26;.929;3600000;0
42708;67764;1871;0;0;0;0;.00nan;0;0
42709;7332;1869;88;52;3;49;.942;3600000;0
42709;81096;523;56;19;2;17;.895;3600000;0
42709;152464;523;0;0;0;0;.00nan;0;0
42709;155529;1869;0;0;0;0;.00nan;0;0
42710;11851;1475;80;30;2;28;.933;3877000;0
42710;190258;1861;83;39;3;36;.923;3895000;0
42710;68627;1861;0;0;0;0;.00nan;0;0
42710;143036;1475;0;0;0;0;.00nan;0;0
42711;174589;522;66;26;2;24;.923;3600000;0
42711;63848;1477;78;21;1;20;.952;3600000;0
42711;143479;1477;0;0;0;0;.00nan;0;0
42711;155474;522;0;0;0;0;.00nan;0;0
42712;167036;1877;0;0;0;0;.00nan;0;0
42712;170294;521;52;6;1;5;.833;3600000;0
42712;143412;1877;84;44;3;41;.932;3576000;0
42712;143523;521;0;0;0;0;.00nan;0;0
42713;7534;1481;73;28;2;26;.929;3900000;0
42713;206007;1481;0;0;0;0;.00nan;0;0
42713;185041;3922;89;35;2;33;.943;3900000;0
42713;89998;3922;0;0;0;0;.00nan;0;0
42714;9373;1854;0;0;0;0;.00nan;0;0
42714;169325;1854;73;21;1;20;.952;3600000;0
42714;68565;2173;62;33;4;29;.879;3600000;0
42714;143063;2173;0;0;0;0;.00nan;0;0
42715;9373;1854;0;0;0;0;.00nan;0;0
42715;169325;1854;74;26;1;25;.962;3600000;0
42715;174589;522;49;27;4;23;.852;3600000;0
42715;155474;522;0;0;0;0;.00nan;0;0
42716;185041;3922;72;35;3;32;.914;3561000;0
42716;68565;2173;0;0;0;0;.00nan;0;0
42716;89998;3922;0;0;0;0;.00nan;0;0
42716;143063;2173;54;15;2;13;.867;3600000;0
42717;7332;1869;0;0;0;0;.00nan;0;0
42717;190258;1861;48;32;4;28;.875;3900000;0
42717;68627;1861;0;0;0;0;.00nan;0;0
42717;155529;1869;53;30;4;26;.867;3900000;0
42718;177504;524;0;0;0;0;.00nan;0;0
42718;7534;1481;0;0;0;0;.00nan;0;0
42718;8035;524;51;29;4;25;.862;3523000;0
42718;206007;1481;86;36;2;34;.944;3600000;0
42719;167036;1877;0;0;0;0;.00nan;0;0
42719;81096;523;39;16;3;13;.813;3544000;0
42719;143412;1877;100;59;2;57;.966;3600000;0
42719;152464;523;0;0;0;0;.00nan;0;0
42720;170294;521;58;23;3;20;.870;3600000;0
42720;54290;1871;71;38;4;34;.895;3582000;0
42720;67764;1871;0;0;0;0;.00nan;0;0
42720;143523;521;0;0;0;0;.00nan;0;0
42721;11851;1475;0;0;0;0;.00nan;0;0
42721;63848;1477;64;15;1;14;.933;3600000;0
42721;143036;1475;91;48;3;45;.938;3536000;0
42721;143479;1477;0;0;0;0;.00nan;0;0
42722;7534;1481;53;29;3;26;.897;3581000;0
42722;206007;1481;0;0;0;0;.00nan;0;0
42722;174589;522;90;35;2;33;.943;3600000;0
42722;155474;522;0;0;0;0;.00nan;0;0
42723;177504;524;0;0;0;0;.00nan;0;0
42723;7332;1869;0;0;0;0;.00nan;0;0
42723;8035;524;85;41;3;38;.927;3600000;0
42723;155529;1869;91;19;0;19;1.000;3600000;0
42724;11851;1475;67;30;3;27;.900;3896000;0
42724;143036;1475;0;0;0;0;.00nan;0;0
42724;152464;523;51;21;3;18;.857;3900000;0
42724;152494;523;0;0;0;0;.00nan;0;0
42725;190258;1861;72;45;6;39;.867;3600000;0
42725;63848;1477;59;13;1;12;.923;3600000;0
42725;68627;1861;0;0;0;0;.00nan;0;0
42725;143479;1477;0;0;0;0;.00nan;0;0
42726;170294;521;0;0;0;0;.00nan;0;0
42726;68565;2173;44;42;7;35;.833;2193000;0
42726;143063;2173;65;19;1;18;.947;1407000;0
42726;143523;521;72;13;1;12;.923;3600000;0
42727;167036;1877;0;0;0;0;.00nan;0;0
42727;185041;3922;91;19;0;19;1.000;3600000;0
42727;89998;3922;0;0;0;0;.00nan;0;0
42727;143412;1877;91;35;2;33;.943;3600000;0
42728;9373;1854;0;0;0;0;.00nan;0;0
42728;169325;1854;68;20;1;19;.950;3600000;0
42728;54290;1871;63;30;3;27;.900;3535000;0
42728;67764;1871;0;0;0;0;.00nan;0;0
42729;174589;522;84;17;0;17;1.000;3600000;0
42729;68565;2173;81;31;2;29;.935;3518000;0
42729;143063;2173;0;0;0;0;.00nan;0;0
42729;155474;522;0;0;0;0;.00nan;0;0
42730;7332;1869;0;0;0;0;.00nan;0;0
42730;63848;1477;51;26;4;22;.846;3523000;0
42730;143479;1477;0;0;0;0;.00nan;0;0
42730;155529;1869;86;39;2;37;.949;3600000;0
42731;190258;1861;0;0;0;0;.00nan;0;0
42731;68627;1861;42;38;6;32;.842;3600000;0
42731;152464;523;91;26;1;25;.962;3600000;0
42731;152494;523;0;0;0;0;.00nan;0;0
42732;7534;1481;64;36;3;33;.917;3557000;0
42732;9373;1854;0;0;0;0;.00nan;0;0
42732;169325;1854;91;32;1;31;.969;3600000;0
42732;206007;1481;0;0;0;0;.00nan;0;0
42733;167036;1877;0;0;0;0;.00nan;0;0
42733;177504;524;0;0;0;0;.00nan;0;0
42733;8035;524;67;33;3;30;.909;3600000;0
42733;143412;1877;71;17;1;16;.941;3600000;0
42734;185041;3922;71;37;4;33;.892;3600000;0
42734;54290;1871;0;0;0;0;.00nan;0;0
42734;89998;3922;0;0;0;0;.00nan;0;0
42734;143100;1871;98;18;0;18;1.000;3600000;0
42735;11851;1475;52;3;0;3;1.000;503000;0
42735;170294;521;79;14;0;14;1.000;3600000;0
42735;143036;1475;37;30;6;24;.800;3097000;0
42735;143523;521;0;0;0;0;.00nan;0;0
42736;174589;522;77;23;1;22;.957;3600000;0
42736;54290;1871;0;0;0;0;.00nan;0;0
42736;143100;1871;94;23;0;23;1.000;3600000;0
42736;155474;522;0;0;0;0;.00nan;0;0
42737;177504;524;0;0;0;0;.00nan;0;0
42737;8035;524;82;31;2;29;.935;3600000;0
42737;190258;1861;47;38;5;33;.868;3600000;0
42737;68627;1861;0;0;0;0;.00nan;0;0
42738;63848;1477;24;6;3;3;.500;340000;0
42738;81096;523;63;14;1;13;.929;3600000;0
42738;143479;1477;46;23;4;19;.826;3260000;0
42738;152464;523;0;0;0;0;.00nan;0;0
42739;7534;1481;59;31;4;27;.871;3892000;0
42739;206007;1481;0;0;0;0;.00nan;0;0
42739;68565;2173;66;34;3;31;.912;3892000;0
42739;143063;2173;0;0;0;0;.00nan;0;0
42740;11851;1475;67;30;3;27;.900;3543000;0
42740;185041;3922;79;26;2;24;.923;3600000;0
42740;89998;3922;0;0;0;0;.00nan;0;0
42740;143036;1475;0;0;0;0;.00nan;0;0
42741;167036;1877;0;0;0;0;.00nan;0;0
42741;9373;1854;0;0;0;0;.00nan;0;0
42741;169325;1854;100;30;0;30;1.000;3600000;0
42741;143412;1877;92;34;1;33;.971;3553000;0
42742;7332;1869;0;0;0;0;.00nan;0;0
42742;170294;521;44;18;3;15;.833;3600000;0
42742;143523;521;0;0;0;0;.00nan;0;0
42742;155529;1869;99;60;2;58;.967;3600000;0
42743;7332;1869;0;0;0;0;.00nan;0;0
42743;185041;3922;62;34;4;30;.882;3600000;0
42743;89998;3922;0;0;0;0;.00nan;0;0
42743;155529;1869;100;24;0;24;1.000;3600000;0
42744;177504;524;0;0;0;0;.00nan;0;0
42744;8035;524;58;41;5;36;.878;3600000;0
42744;81096;523;96;14;0;14;1.000;3600000;0
42744;152464;523;0;0;0;0;.00nan;0;0
42745;9373;1854;0;0;0;0;.00nan;0;0
42745;169325;1854;73;27;2;25;.926;3600000;0
42745;190258;1861;63;26;3;23;.885;3551000;0
42745;68627;1861;0;0;0;0;.00nan;0;0
42746;170294;521;0;0;0;0;.00nan;0;0
42746;63848;1477;67;36;5;31;.861;3566000;0
42746;143479;1477;0;0;0;0;.00nan;0;0
42746;143523;521;40;21;4;17;.810;3600000;0
42747;167036;1877;0;0;0;0;.00nan;0;0
42747;7534;1481;69;29;2;27;.931;3719000;0
42747;206007;1481;0;0;0;0;.00nan;0;0
42747;143412;1877;75;33;3;30;.909;3719000;0
42748;54290;1871;0;0;0;0;.00nan;0;0
42748;68565;2173;72;41;4;37;.902;3600000;0
42748;143063;2173;0;0;0;0;.00nan;0;0
42748;143100;1871;74;16;1;15;.938;3600000;0
42749;11851;1475;0;0;0;0;.00nan;0;0
42749;174589;522;88;51;4;47;.922;3600000;0
42749;143036;1475;75;23;1;22;.957;3600000;0
42749;155474;522;0;0;0;0;.00nan;0;0
42750;167036;1877;0;0;0;0;.00nan;0;0
42750;174589;522;85;35;2;33;.943;3559000;0
42750;143412;1877;93;20;0;20;1.000;3600000;0
42750;155474;522;0;0;0;0;.00nan;0;0
42751;177504;524;0;0;0;0;.00nan;0;0
42751;8035;524;80;34;3;31;.912;3600000;0
42751;63848;1477;32;29;5;24;.828;3600000;0
42751;143479;1477;0;0;0;0;.00nan;0;0
42752;7332;1869;0;0;0;0;.00nan;0;0
42752;68565;2173;0;0;0;0;.00nan;0;0
42752;143063;2173;51;32;5;27;.844;3600000;0
42752;155529;1869;70;14;1;13;.929;3600000;0
42753;7534;1481;0;0;0;0;.00nan;0;0
42753;206007;1481;88;40;3;37;.925;3600000;0
42753;54290;1871;0;0;0;0;.00nan;0;0
42753;143100;1871;98;24;0;24;1.000;3600000;0
42754;170294;521;48;17;2;15;.882;3600000;0
42754;190258;1861;84;42;3;39;.929;3550000;0
42754;68627;1861;0;0;0;0;.00nan;0;0
42754;143523;521;0;0;0;0;.00nan;0;0
42755;185041;3922;26;26;6;20;.769;3600000;0
42755;81096;523;60;15;1;14;.933;3600000;0
42755;89998;3922;0;0;0;0;.00nan;0;0
42755;152464;523;0;0;0;0;.00nan;0;0
42756;9373;1854;0;0;0;0;.00nan;0;0
42756;11851;1475;70;19;1;18;.947;3600000;0
42756;169325;1854;41;36;6;30;.833;3600000;0
42756;143036;1475;0;0;0;0;.00nan;0;0
42757;177504;524;70;31;3;28;.903;3600000;0
42757;8035;524;0;0;0;0;.00nan;0;0
42757;170294;521;67;19;2;17;.895;3600000;0
42757;143523;521;0;0;0;0;.00nan;0;0
42758;7332;1869;43;28;4;24;.857;3549000;0
42758;174589;522;76;28;2;26;.929;3600000;0
42758;155474;522;0;0;0;0;.00nan;0;0
42758;155529;1869;0;0;0;0;.00nan;0;0
42759;9373;1854;0;0;0;0;.00nan;0;0
42759;169325;1854;93;38;2;36;.947;3600000;0
42759;81096;523;52;23;3;20;.870;3550000;0
42759;152464;523;0;0;0;0;.00nan;0;0
42760;7534;1481;76;39;3;36;.923;3600000;0
42760;206007;1481;0;0;0;0;.00nan;0;0
42760;190258;1861;77;39;4;35;.897;3550000;0
42760;68627;1861;0;0;0;0;.00nan;0;0
42761;185041;3922;55;43;5;38;.884;3600000;0
42761;63848;1477;57;18;2;16;.889;3600000;0
42761;89998;3922;0;0;0;0;.00nan;0;0
42761;143479;1477;0;0;0;0;.00nan;0;0
42762;167036;1877;0;0;0;0;.00nan;0;0
42762;54290;1871;0;0;0;0;.00nan;0;0
42762;143100;1871;57;18;2;16;.889;3600000;0
42762;143412;1877;64;38;4;34;.895;3579000;0
42763;11851;1475;0;0;0;0;.00nan;0;0
42763;68565;2173;84;39;2;37;.949;3600000;0
42763;143036;1475;84;25;1;24;.960;3600000;0
42763;143063;2173;0;0;0;0;.00nan;0;0
42764;174589;522;97;22;0;22;1.000;3600000;0
42764;190258;1861;63;26;3;23;.885;3600000;0
42764;68627;1861;0;0;0;0;.00nan;0;0
42764;155474;522;0;0;0;0;.00nan;0;0
42765;167036;1877;0;0;0;0;.00nan;0;0
42765;68565;2173;89;42;3;39;.929;3633000;0
42765;143063;2173;0;0;0;0;.00nan;0;0
42765;143412;1877;83;39;4;35;.897;3633000;0
42766;7534;1481;42;32;5;27;.844;3600000;0
42766;11851;1475;84;18;0;18;1.000;3600000;0
42766;206007;1481;0;0;0;0;.00nan;0;0
42766;143036;1475;0;0;0;0;.00nan;0;0
42767;170294;521;0;0;0;0;.00nan;0;0
42767;81096;523;63;39;5;34;.872;3600000;0
42767;143523;521;71;31;3;28;.903;3600000;0
42767;152464;523;0;0;0;0;.00nan;0;0
42768;54290;1871;0;0;0;0;.00nan;0;0
42768;63848;1477;57;36;4;32;.889;3600000;0
42768;143100;1871;73;19;1;18;.947;3600000;0
42768;143479;1477;0;0;0;0;.00nan;0;0
42769;177504;524;0;0;0;0;.00nan;0;0
42769;8035;524;52;23;3;20;.870;3565000;0
42769;185041;3922;76;23;1;22;.957;3600000;0
42769;89998;3922;0;0;0;0;.00nan;0;0
42770;7332;1869;0;0;0;0;.00nan;0;0
42770;9373;1854;0;0;0;0;.00nan;0;0
42770;169325;1854;74;27;2;25;.926;3600000;0
42770;155529;1869;63;30;3;27;.900;3558000;0
42772;7534;1481;100;49;1;48;.980;3600000;0
42772;206007;1481;0;0;0;0;.00nan;0;0
42772;81096;523;60;18;2;16;.889;3545000;0
42772;152464;523;0;0;0;0;.00nan;0;0
42774;177504;524;0;0;0;0;.00nan;0;0
42774;8035;524;54;44;5;39;.886;3600000;0
42774;185041;3922;92;20;0;20;1.000;3600000;0
42774;89998;3922;0;0;0;0;.00nan;0;0
42776;54290;1871;0;0;0;0;.00nan;0;0
42776;67764;1871;46;33;5;28;.848;3597000;0
42776;68565;2173;62;31;4;27;.871;3600000;0
42776;143063;2173;0;0;0;0;.00nan;0;0
42778;167036;1877;0;0;0;0;.00nan;0;0
42778;9373;1854;0;0;0;0;.00nan;0;0
42778;169325;1854;74;43;3;40;.930;3576000;0
42778;143412;1877;70;19;2;17;.895;3600000;0
42780;205990;1477;0;0;0;0;.00nan;0;0
42780;80859;521;0;0;0;0;.00nan;0;0
42780;143479;1477;59;35;4;31;.886;3600000;0
42780;143523;521;88;30;2;28;.933;3600000;0
42782;174589;522;73;33;2;31;.939;3900000;0
42782;190258;1861;73;31;2;29;.935;3900000;0
42782;68627;1861;0;0;0;0;.00nan;0;0
42782;155474;522;0;0;0;0;.00nan;0;0
42784;7332;1869;76;39;3;36;.923;3900000;0
42784;11851;1475;81;33;3;30;.909;3900000;0
42784;143036;1475;0;0;0;0;.00nan;0;0
42784;155529;1869;0;0;0;0;.00nan;0;0
42786;7534;1481;0;0;0;0;.00nan;0;0
42786;206007;1481;69;37;3;34;.919;3548000;0
42786;68565;2173;0;0;0;0;.00nan;0;0
42786;143063;2173;88;24;1;23;.958;3600000;0
42788;205990;1477;73;19;1;18;.947;3600000;0
42788;174589;522;50;1;0;1;1.000;268000;0
42788;143479;1477;0;0;0;0;.00nan;0;0
42788;155474;522;42;46;7;39;.848;3332000;0
42790;11851;1475;0;0;0;0;.00nan;0;0
42790;54290;1871;28;8;3;5;.625;494000;0
42790;67764;1871;36;33;6;27;.818;3106000;0
42790;143036;1475;74;26;2;24;.923;3600000;0
42792;177504;524;73;39;5;34;.872;3543000;0
42792;8035;524;0;0;0;0;.00nan;0;0
42792;185041;3922;51;23;4;19;.826;3600000;0
42792;89998;3922;0;0;0;0;.00nan;0;0
42794;167036;1877;0;0;0;0;.00nan;0;0
42794;7332;1869;0;0;0;0;.00nan;0;0
42794;143412;1877;88;53;4;49;.925;3600000;0
42794;155529;1869;63;31;3;28;.903;3600000;0
42796;9373;1854;80;53;4;49;.925;3562000;0
42796;169325;1854;0;0;0;0;.00nan;0;0
42796;80859;521;49;18;3;15;.833;3600000;0
42796;143523;521;0;0;0;0;.00nan;0;0
42798;190258;1861;41;10;2;8;.800;762000;0
42798;68627;1861;50;45;7;38;.844;2838000;0
42798;81096;523;0;0;0;0;.00nan;0;0
42798;152464;523;84;10;0;10;1.000;3600000;0
42800;7332;1869;57;20;3;17;.850;3577000;0
42800;68565;2173;0;0;0;0;.00nan;0;0
42800;143063;2173;100;48;2;46;.958;3600000;0
42800;155529;1869;0;0;0;0;.00nan;0;0
42802;80859;521;54;2;0;2;1.000;788000;0
42802;81096;523;56;17;2;15;.882;1830000;0
42802;143523;521;39;33;6;27;.818;2812000;0
42802;152464;523;4;13;6;7;.538;1770000;0
42804;167036;1877;0;0;0;0;.00nan;0;0
42804;177504;524;0;0;0;0;.00nan;0;0
42804;8035;524;34;20;4;16;.800;3600000;0
42804;143412;1877;91;31;1;30;.968;3600000;0
42806;11851;1475;95;23;0;23;1.000;3600000;0
42806;174589;522;0;0;0;0;.00nan;0;0
42806;143036;1475;0;0;0;0;.00nan;0;0
42806;155474;522;52;37;5;32;.865;3600000;0
42808;7534;1481;99;46;1;45;.978;3600000;0
42808;205990;1477;55;34;4;30;.882;3600000;0
42808;206007;1481;0;0;0;0;.00nan;0;0
42808;143479;1477;0;0;0;0;.00nan;0;0
42810;9373;1854;0;0;0;0;.00nan;0;0
42810;169325;1854;56;46;6;40;.870;3600000;0
42810;54290;1871;70;24;2;22;.917;3600000;0
42810;67764;1871;0;0;0;0;.00nan;0;0
42812;190258;1861;91;37;3;34;.919;3900000;0
42812;185041;3922;69;30;3;27;.900;3900000;0
42812;68627;1861;0;0;0;0;.00nan;0;0
42812;89998;3922;0;0;0;0;.00nan;0;0
42814;190258;1861;0;0;0;0;.00nan;0;0
42814;68565;2173;32;26;5;21;.808;3600000;0
42814;68627;1861;98;32;1;31;.969;3600000;0
42814;143063;2173;0;0;0;0;.00nan;0;0
42816;167036;1877;0;0;0;0;.00nan;0;0
42816;177504;524;70;34;3;31;.912;3584000;0
42816;8035;524;0;0;0;0;.00nan;0;0
42816;143412;1877;53;16;2;14;.875;3600000;0
42818;185041;3922;0;0;0;0;.00nan;0;0
42818;80859;521;39;13;3;10;.769;3600000;0
42818;89998;3922;48;42;6;36;.857;3600000;0
42818;143523;521;0;0;0;0;.00nan;0;0
42820;11851;1475;50;35;5;30;.857;3513000;0
42820;205990;1477;0;0;0;0;.00nan;0;0
42820;143036;1475;0;0;0;0;.00nan;0;0
42820;143479;1477;64;28;3;25;.893;3600000;0
42822;174589;522;77;27;2;25;.926;3600000;0
42822;54290;1871;0;0;0;0;.00nan;0;0
42822;67764;1871;66;36;4;32;.889;3556000;0
42822;155474;522;0;0;0;0;.00nan;0;0
42824;7534;1481;0;0;0;0;.00nan;0;0
42824;9373;1854;57;30;4;26;.867;3600000;0
42824;169325;1854;0;0;0;0;.00nan;0;0
42824;206007;1481;76;46;5;41;.891;3600000;0
42826;7332;1869;0;0;0;0;.00nan;0;0
42826;81096;523;100;24;0;24;1.000;3600000;0
42826;152464;523;0;0;0;0;.00nan;0;0
42826;155529;1869;77;43;4;39;.907;3600000;0
42828;9373;1854;0;0;0;0;.00nan;0;0
42828;169325;1854;42;31;5;26;.839;3600000;0
42828;185041;3922;61;27;2;25;.926;3600000;0
42828;89998;3922;0;0;0;0;.00nan;0;0
42830;190258;1861;86;45;3;42;.933;3600000;0
42830;54290;1871;27;17;4;13;.765;3575000;0
42830;67764;1871;0;0;0;0;.00nan;0;0
42830;68627;1861;0;0;0;0;.00nan;0;0
42832;7534;1481;62;35;4;31;.886;3600000;0
42832;11851;1475;0;0;0;0;.00nan;0;0
42832;206007;1481;0;0;0;0;.00nan;0;0
42832;143036;1475;63;20;2;18;.900;3600000;0
42834;177504;524;56;21;3;18;.857;1201000;0
42834;8035;524;34;35;7;28;.800;2399000;0
42834;205990;1477;63;22;2;20;.909;3600000;0
42834;143479;1477;0;0;0;0;.00nan;0;0
42836;174589;522;79;35;2;33;.943;3549000;0
42836;81096;523;74;19;1;18;.947;3600000;0
42836;152464;523;0;0;0;0;.00nan;0;0
42836;155474;522;0;0;0;0;.00nan;0;0
42838;68565;2173;58;45;6;39;.867;3600000;0
42838;80859;521;0;0;0;0;.00nan;0;0
42838;143063;2173;0;0;0;0;.00nan;0;0
42838;143523;521;57;21;2;19;.905;3600000;0
42840;167036;1877;0;0;0;0;.00nan;0;0
42840;7332;1869;84;34;1;33;.971;3600000;0
42840;143412;1877;69;30;2;28;.933;3594000;0
42840;155529;1869;0;0;0;0;.00nan;0;0
42842;54290;1871;0;0;0;0;.00nan;0;0
42842;67764;1871;99;50;2;48;.960;3900000;0
42842;81096;523;58;21;2;19;.905;3900000;0
42842;152464;523;0;0;0;0;.00nan;0;0
42844;205990;1477;0;0;0;0;.00nan;0;0
42844;143256;521;0;0;0;0;.00nan;0;0
42844;143479;1477;69;37;3;34;.919;3600000;0
42844;143523;521;100;25;0;25;1.000;3600000;0
42846;167036;1877;0;0;0;0;.00nan;0;0
42846;190258;1861;44;30;4;26;.867;3600000;0
42846;68627;1861;0;0;0;0;.00nan;0;0
42846;143412;1877;69;19;1;18;.947;3600000;0
42848;177504;524;0;0;0;0;.00nan;0;0
42848;7534;1481;59;27;3;24;.889;3571000;0
42848;8035;524;72;29;2;27;.931;3600000;0
42848;206007;1481;0;0;0;0;.00nan;0;0
42850;9373;1854;0;0;0;0;.00nan;0;0
42850;169325;1854;84;42;2;40;.952;3600000;0
42850;68565;2173;0;0;0;0;.00nan;0;0
42850;143063;2173;58;38;4;34;.895;3538000;0
42852;11851;1475;32;19;4;15;.789;3900000;0
42852;185041;3922;56;32;4;28;.875;3900000;0
42852;89998;3922;0;0;0;0;.00nan;0;0
42852;143036;1475;0;0;0;0;.00nan;0;0
42854;7332;1869;87;35;2;33;.943;3889000;0
42854;174589;522;0;0;0;0;.00nan;0;0
42854;155474;522;74;32;2;30;.938;3900000;0
42854;155529;1869;0;0;0;0;.00nan;0;0
42856;11851;1475;0;0;0;0;.00nan;0;0
42856;143036;1475;88;37;2;35;.946;3600000;0
42856;143256;521;0;0;0;0;.00nan;0;0
42856;143523;521;45;24;4;20;.833;3548000;0
42858;9373;1854;66;30;3;27;.900;3900000;0
42858;169325;1854;0;0;0;0;.00nan;0;0
42858;174589;522;56;31;3;28;.903;3900000;0
42858;155474;522;0;0;0;0;.00nan;0;0
42860;205990;1477;45;24;4;20;.833;3600000;0
42860;185041;3922;0;0;0;0;.00nan;0;0
42860;89998;3922;70;45;5;40;.889;3590000;0
42860;143479;1477;0;0;0;0;.00nan;0;0
42862;167036;1877;99;25;0;25;1.000;3600000;0
42862;7332;1869;0;0;0;0;.00nan;0;0
42862;143412;1877;0;0;0;0;.00nan;0;0
42862;155529;1869;34;24;5;19;.792;3600000;0
42864;177504;524;86;42;3;39;.929;3578000;0
42864;8035;524;0;0;0;0;.00nan;0;0
42864;81096;523;0;0;0;0;.00nan;0;0
42864;152464;523;78;21;1;20;.952;3600000;0
42866;7534;1481;0;0;0;0;.00nan;0;0
42866;206007;1481;98;42;2;40;.952;3900000;0
42866;54290;1871;78;26;2;24;.923;3900000;0
42866;67764;1871;0;0;0;0;.00nan;0;0
42868;190258;1861;0;0;0;0;.00nan;0;0
42868;68565;2173;75;38;3;35;.921;3600000;0
42868;68627;1861;100;28;0;28;1.000;3600000;0
42868;143063;2173;0;0;0;0;.00nan;0;0
1008;170294;521;0;0;0;0;.00nan;0;0
1008;174589;522;86;57;5;52;.912;3600000;0
1008;143523;521;35;5;2;3;.600;3600000;0
1008;155474;522;0;0;0;0;.00nan;0;0
1009;9373;1854;0;0;0;0;.00nan;0;0
1009;11851;1475;52;15;2;13;.867;3600000;0
1009;169325;1854;93;46;3;43;.935;3554000;0
1009;143036;1475;0;0;0;0;.00nan;0;0
1010;7332;1869;0;0;0;0;.00nan;0;0
1010;81096;523;45;12;2;10;.833;3600000;0
1010;152464;523;0;0;0;0;.00nan;0;0
1010;155529;1869;56;39;5;34;.872;3600000;0
1011;54290;1871;0;0;0;0;.00nan;0;0
1011;63848;1477;98;38;1;37;.974;4747000;0
1011;143100;1871;85;38;2;36;.947;4747000;0
1011;143479;1477;0;0;0;0;.00nan;0;0
1012;170294;521;0;0;0;0;.00nan;0;0
1012;174589;522;76;56;5;51;.911;3582000;0
1012;143523;521;43;15;3;12;.800;3600000;0
1012;155474;522;0;0;0;0;.00nan;0;0
1013;9373;1854;73;22;1;21;.955;3600000;0
1013;11851;1475;58;20;2;18;.900;3600000;0
1013;169325;1854;0;0;0;0;.00nan;0;0
1013;143036;1475;0;0;0;0;.00nan;0;0
1014;7332;1869;0;0;0;0;.00nan;0;0
1014;81096;523;35;24;5;19;.792;3600000;0
1014;152464;523;0;0;0;0;.00nan;0;0
1014;155529;1869;71;30;2;28;.933;3600000;0
1015;54290;1871;0;0;0;0;.00nan;0;0
1015;63848;1477;58;13;1;12;.923;3600000;0
1015;143100;1871;83;44;4;40;.909;3600000;0
1015;143479;1477;0;0;0;0;.00nan;0;0
1016;170294;521;0;0;0;0;.00nan;0;0
1016;174589;522;79;46;4;42;.913;3564000;0
1016;143523;521;59;15;2;13;.867;3600000;0
1016;155474;522;0;0;0;0;.00nan;0;0
1017;9373;1854;84;50;4;46;.920;3600000;0
1017;11851;1475;59;19;2;17;.895;3600000;0
1017;169325;1854;0;0;0;0;.00nan;0;0
1017;143036;1475;0;0;0;0;.00nan;0;0
1018;7332;1869;0;0;0;0;.00nan;0;0
1018;81096;523;69;31;3;28;.903;3778000;0
1018;152464;523;0;0;0;0;.00nan;0;0
1018;155529;1869;73;38;4;34;.895;3778000;0
1019;54290;1871;0;0;0;0;.00nan;0;0
1019;63848;1477;95;33;1;32;.970;3600000;0
1019;143100;1871;65;33;3;30;.909;3546000;0
1019;143479;1477;0;0;0;0;.00nan;0;0
1248;9373;1854;85;37;2;35;.946;3600000;0
1248;11851;1475;61;29;3;26;.897;3574000;0
1248;169325;1854;0;0;0;0;.00nan;0;0
1248;143036;1475;0;0;0;0;.00nan;0;0
1249;7332;1869;0;0;0;0;.00nan;0;0
1249;81096;523;29;7;3;4;.571;541000;0
1249;152464;523;64;16;1;15;.938;3040000;0
1249;155529;1869;90;41;2;39;.951;3600000;0
1331;9373;1854;34;20;4;16;.800;2188000;0
1331;11851;1475;74;18;1;17;.944;3600000;0
1331;169325;1854;54;5;0;5;1.000;1412000;0
1331;143036;1475;0;0;0;0;.00nan;0;0
1332;7332;1869;0;0;0;0;.00nan;0;0
1332;81096;523;90;33;2;31;.939;3600000;0
1332;152464;523;0;0;0;0;.00nan;0;0
1332;155529;1869;72;34;3;31;.912;3544000;0
1442;170294;521;0;0;0;0;.00nan;0;0
1442;63848;1477;90;32;1;31;.969;3600000;0
1442;143479;1477;0;0;0;0;.00nan;0;0
1442;143523;521;59;23;3;20;.870;3549000;0
1443;11851;1475;67;37;4;33;.892;3600000;0
1443;81096;523;91;35;2;33;.943;3600000;0
1443;143036;1475;0;0;0;0;.00nan;0;0
1443;152464;523;0;0;0;0;.00nan;0;0
1444;170294;521;0;0;0;0;.00nan;0;0
1444;63848;1477;63;41;5;36;.878;3600000;0
1444;143479;1477;0;0;0;0;.00nan;0;0
1444;143523;521;84;24;2;22;.917;3600000;0
1445;11851;1475;56;28;4;24;.857;3600000;0
1445;81096;523;97;31;1;30;.968;3600000;0
1445;143036;1475;0;0;0;0;.00nan;0;0
1445;152464;523;0;0;0;0;.00nan;0;0
1446;170294;521;0;0;0;0;.00nan;0;0
1446;63848;1477;74;45;4;41;.911;3600000;0
1446;143479;1477;0;0;0;0;.00nan;0;0
1446;143523;521;92;18;0;18;1.000;3600000;0
1447;11851;1475;94;63;3;60;.952;5478000;0
1447;81096;523;52;19;2;17;.895;5478000;0
1447;143036;1475;0;0;0;0;.00nan;0;0
1447;152464;523;0;0;0;0;.00nan;0;0
1448;170294;521;0;0;0;0;.00nan;0;0
1448;63848;1477;52;36;4;32;.889;3588000;0
1448;143479;1477;0;0;0;0;.00nan;0;0
1448;143523;521;53;20;3;17;.850;3600000;0
1449;11851;1475;73;33;3;30;.909;3600000;0
1449;81096;523;74;36;4;32;.889;3558000;0
1449;143036;1475;0;0;0;0;.00nan;0;0
1449;152464;523;0;0;0;0;.00nan;0;0
1620;170294;521;0;0;0;0;.00nan;0;0
1620;63848;1477;63;31;3;28;.903;3600000;0
1620;143479;1477;0;0;0;0;.00nan;0;0
1620;143523;521;92;24;0;24;1.000;3600000;0
1621;11851;1475;100;28;0;28;1.000;3600000;0
1621;81096;523;70;19;1;18;.947;3554000;0
1621;143036;1475;0;0;0;0;.00nan;0;0
1621;152464;523;0;0;0;0;.00nan;0;0
1691;11851;1475;61;42;5;37;.881;3600000;0
1691;81096;523;62;16;1;15;.938;3600000;0
1691;143036;1475;0;0;0;0;.00nan;0;0
1691;152464;523;0;0;0;0;.00nan;0;0
1807;170294;521;0;0;0;0;.00nan;0;0
1807;81096;523;65;48;6;42;.875;3526000;0
1807;143523;521;61;24;4;20;.833;3600000;0
1807;152464;523;0;0;0;0;.00nan;0;0
1808;170294;521;0;0;0;0;.00nan;0;0
1808;81096;523;100;43;1;42;.977;5083000;0
1808;143523;521;70;27;2;25;.926;5083000;0
1808;152464;523;0;0;0;0;.00nan;0;0
1809;170294;521;0;0;0;0;.00nan;0;0
1809;81096;523;90;29;1;28;.966;3600000;0
1809;143523;521;66;23;2;21;.913;3588000;0
1809;152464;523;0;0;0;0;.00nan;0;0
1810;170294;521;0;0;0;0;.00nan;0;0
1810;81096;523;49;30;5;25;.833;3600000;0
1810;143523;521;94;31;1;30;.968;3600000;0
1810;152464;523;0;0;0;0;.00nan;0;0
1934;170294;521;0;0;0;0;.00nan;0;0
1934;81096;523;34;31;6;25;.806;3128000;0
1934;143523;521;62;19;2;17;.895;3600000;0
1934;152464;523;43;5;1;4;.800;472000;0
1970;170294;521;0;0;0;0;.00nan;0;0
1970;81096;523;0;0;0;0;.00nan;0;0
1970;143523;521;60;14;1;13;.929;3661000;0
1970;152464;523;92;35;2;33;.943;3661000;0
42869;166545;1925;0;0;0;0;.00nan;0;0
42869;11438;1925;46;29;5;24;.828;3600000;0
42869;206110;1923;31;6;3;3;.500;538000;0
42869;-1;1923;54;31;4;27;.871;3049000;0
42870;206136;1927;76;34;2;32;.941;3600000;0
42870;56901;1930;0;0;0;0;.00nan;0;0
42870;67663;1930;50;28;4;24;.857;3535000;0
42870;90473;1927;0;0;0;0;.00nan;0;0
42871;164323;5013;0;0;0;0;.00nan;0;0
42871;28453;1920;0;0;0;0;.00nan;0;0
42871;66482;5013;61;25;3;22;.880;3900000;0
42871;160663;1920;73;33;3;30;.909;3900000;0
42872;218;4794;39;29;5;24;.828;3600000;0
42872;178950;4794;0;0;0;0;.00nan;0;0
42872;153963;1935;0;0;0;0;.00nan;0;0
42872;160661;1935;60;26;2;24;.923;3600000;0
42873;170037;1934;0;0;0;0;.00nan;0;0
42873;180535;2557;61;26;3;23;.885;3689000;0
42873;67162;2557;0;0;0;0;.00nan;0;0
42873;155945;1934;70;25;2;23;.920;3689000;0
42874;164323;5013;52;14;2;12;.857;3600000;0
42874;180535;2557;38;37;6;31;.838;3600000;0
42874;66482;5013;0;0;0;0;.00nan;0;0
42874;67162;2557;0;0;0;0;.00nan;0;0
42875;14259;2632;60;30;3;27;.900;3600000;0
42875;206136;1927;21;38;8;30;.789;3600000;0
42875;216592;2632;0;0;0;0;.00nan;0;0
42875;90473;1927;0;0;0;0;.00nan;0;0
42876;56901;1930;69;28;2;26;.929;3600000;0
42876;66353;579;10;19;6;13;.684;2342000;0
42876;67663;1930;0;0;0;0;.00nan;0;0
42876;67993;579;54;11;1;10;.909;1258000;0
42877;170037;1934;71;22;1;21;.955;3600000;0
42877;28453;1920;43;45;7;38;.844;3600000;0
42877;155945;1934;0;0;0;0;.00nan;0;0
42877;160663;1920;0;0;0;0;.00nan;0;0
42878;66353;579;61;32;4;28;.875;3900000;0
42878;67993;579;0;0;0;0;.00nan;0;0
42878;153963;1935;42;20;4;16;.800;3900000;0
42878;160661;1935;0;0;0;0;.00nan;0;0
42879;14259;2632;0;0;0;0;.00nan;0;0
42879;216592;2632;50;34;5;29;.853;3600000;0
42879;153963;1935;45;24;4;20;.833;3600000;0
42879;160661;1935;0;0;0;0;.00nan;0;0
42880;218;4794;0;0;0;0;.00nan;0;0
42880;164323;5013;0;0;0;0;.00nan;0;0
42880;178950;4794;63;25;3;22;.880;3900000;0
42880;66482;5013;72;41;3;38;.927;3900000;0
42881;166545;1925;0;0;0;0;.00nan;0;0
42881;164323;5013;52;31;4;27;.871;3600000;0
42881;11438;1925;37;28;5;23;.821;3559000;0
42881;66482;5013;0;0;0;0;.00nan;0;0
42882;14259;2632;0;0;0;0;.00nan;0;0
42882;216592;2632;68;38;4;34;.895;3543000;0
42882;66353;579;60;28;3;25;.893;3600000;0
42882;67993;579;0;0;0;0;.00nan;0;0
42883;218;4794;0;0;0;0;.00nan;0;0
42883;178950;4794;47;17;3;14;.824;3600000;0
42883;28453;1920;34;40;7;33;.825;3144000;0
42883;160663;1920;44;5;1;4;.800;456000;0
42884;170037;1934;54;18;2;16;.889;3600000;0
42884;56901;1930;67;40;4;36;.900;3584000;0
42884;67663;1930;0;0;0;0;.00nan;0;0
42884;155945;1934;0;0;0;0;.00nan;0;0
42885;206136;1927;32;31;6;25;.806;3721000;0
42885;180535;2557;0;0;0;0;.00nan;0;0
42885;67162;2557;40;28;5;23;.821;3721000;0
42885;90473;1927;0;0;0;0;.00nan;0;0
42886;206110;1923;90;27;2;25;.926;3900000;0
42886;206136;1927;0;0;0;0;.00nan;0;0
42886;-1;1923;0;0;0;0;.00nan;0;0
42886;90473;1927;66;24;2;22;.917;3900000;0
42887;56901;1930;47;33;6;27;.818;3600000;0
42887;66353;579;51;21;3;18;.857;3081000;0
42887;67663;1930;0;0;0;0;.00nan;0;0
42887;67993;579;12;11;5;6;.545;461000;0
42888;28453;1920;85;31;2;29;.935;3600000;0
42888;66353;579;64;25;3;22;.880;3548000;0
42888;67993;579;0;0;0;0;.00nan;0;0
42888;160663;1920;0;0;0;0;.00nan;0;0
42889;206110;1923;0;0;0;0;.00nan;0;0
42889;180535;2557;57;26;3;23;.885;3600000;0
42889;-1;1923;68;41;4;37;.902;3600000;0
42889;67162;2557;0;0;0;0;.00nan;0;0
42890;164323;5013;61;42;6;36;.857;3600000;0
42890;170037;1934;69;27;3;24;.889;3600000;0
42890;66482;5013;0;0;0;0;.00nan;0;0
42890;155945;1934;0;0;0;0;.00nan;0;0
42891;218;4794;0;0;0;0;.00nan;0;0
42891;14259;2632;0;0;0;0;.00nan;0;0
42891;178950;4794;68;20;2;18;.900;3600000;0
42891;216592;2632;54;34;4;30;.882;3557000;0
42892;166545;1925;43;25;4;21;.840;3551000;0
42892;11438;1925;0;0;0;0;.00nan;0;0
42892;206136;1927;74;33;3;30;.909;3600000;0
42892;90473;1927;0;0;0;0;.00nan;0;0
42893;164323;5013;0;0;0;0;.00nan;0;0
42893;14259;2632;55;21;3;18;.857;3600000;0
42893;216592;2632;0;0;0;0;.00nan;0;0
42893;66482;5013;40;24;4;20;.833;3596000;0
42894;28453;1920;0;0;0;0;.00nan;0;0
42894;180535;2557;0;0;0;0;.00nan;0;0
42894;67162;2557;76;27;2;25;.926;3600000;0
42894;160663;1920;89;57;5;52;.912;3600000;0
42895;170037;1934;0;0;0;0;.00nan;0;0
42895;153963;1935;53;25;4;21;.840;3600000;0
42895;155945;1934;87;33;1;32;.970;3600000;0
42895;160661;1935;0;0;0;0;.00nan;0;0
42896;166545;1925;0;0;0;0;.00nan;0;0
42896;11438;1925;94;25;0;25;1.000;3600000;0
42896;56901;1930;70;19;0;19;1.000;2523000;0
42896;67663;1930;29;11;4;7;.636;1077000;0
42897;166545;1925;0;0;0;0;.00nan;0;0
42897;11438;1925;75;21;2;19;.905;3600000;0
42897;180535;2557;62;38;4;34;.895;3537000;0
42897;67162;2557;0;0;0;0;.00nan;0;0
42898;164323;5013;27;11;4;7;.636;442000;0
42898;206136;1927;56;32;4;28;.875;3600000;0
42898;66482;5013;75;34;5;29;.853;3158000;0
42898;90473;1927;0;0;0;0;.00nan;0;0
42899;218;4794;56;27;4;23;.852;3519000;0
42899;170037;1934;71;33;2;31;.939;3600000;0
42899;178950;4794;0;0;0;0;.00nan;0;0
42899;155945;1934;0;0;0;0;.00nan;0;0
42900;166545;1925;80;27;1;26;.963;3600000;0
42900;11438;1925;0;0;0;0;.00nan;0;0
42900;170037;1934;0;0;0;0;.00nan;0;0
42900;155945;1934;53;33;4;29;.879;3600000;0
42901;14259;2632;0;0;0;0;.00nan;0;0
42901;28453;1920;81;39;4;35;.897;3900000;0
42901;216592;2632;66;34;4;30;.882;3900000;0
42901;160663;1920;0;0;0;0;.00nan;0;0
42902;164323;5013;68;36;3;33;.917;3600000;0
42902;-1;1930;64;27;2;25;.926;3600000;0
42902;56901;1930;0;0;0;0;.00nan;0;0
42902;66482;5013;0;0;0;0;.00nan;0;0
42903;206110;1923;19;26;6;20;.769;2293000;0
42903;-1;1923;59;11;0;11;1.000;1307000;0
42903;153963;1935;0;0;0;0;.00nan;0;0
42903;160661;1935;55;19;2;17;.895;3600000;0
42904;218;4794;0;0;0;0;.00nan;0;0
42904;178950;4794;47;34;5;29;.853;3548000;0
42904;180535;2557;0;0;0;0;.00nan;0;0
42904;67162;2557;60;28;3;25;.893;3600000;0
42905;206110;1923;30;24;5;19;.792;3749000;0
42905;-1;1923;0;0;0;0;.00nan;0;0
42905;66353;579;0;0;0;0;.00nan;0;0
42905;67993;579;60;33;4;29;.879;3749000;0
42906;206110;1923;0;0;0;0;.00nan;0;0
42906;28453;1920;0;0;0;0;.00nan;0;0
42906;-1;1923;97;24;0;24;1.000;3600000;0
42906;160663;1920;51;25;4;21;.840;3600000;0
42907;170037;1934;52;31;4;27;.871;3900000;0
42907;206136;1927;0;0;0;0;.00nan;0;0
42907;153618;1927;74;48;4;44;.917;3900000;0
42907;155945;1934;0;0;0;0;.00nan;0;0
42908;14259;2632;79;53;5;48;.906;3600000;0
42908;216592;2632;0;0;0;0;.00nan;0;0
42908;153963;1935;56;18;2;16;.889;3600000;0
42908;160661;1935;0;0;0;0;.00nan;0;0
42909;218;4794;42;22;4;18;.818;3600000;0
42909;178950;4794;0;0;0;0;.00nan;0;0
42909;-1;1930;22;22;6;16;.727;2905000;0
42909;149981;1930;44;4;1;3;.750;695000;0
42910;28453;1920;47;29;5;24;.828;3600000;0
42910;66353;579;49;27;4;23;.852;3600000;0
42910;67993;579;0;0;0;0;.00nan;0;0
42910;160663;1920;0;0;0;0;.00nan;0;0
42911;170037;1934;50;1;0;1;1.000;326000;0
42911;-1;1930;0;0;0;0;.00nan;0;0
42911;149981;1930;69;27;2;25;.926;3600000;0
42911;155945;1934;52;40;6;34;.850;3274000;0
42912;180535;2557;85;43;3;40;.930;3786000;0
42912;67162;2557;0;0;0;0;.00nan;0;0
42912;153963;1935;0;0;0;0;.00nan;0;0
42912;160661;1935;62;30;4;26;.867;3786000;0
42913;166545;1925;0;0;0;0;.00nan;0;0
42913;218;4794;0;0;0;0;.00nan;0;0
42913;11438;1925;81;33;2;31;.939;3600000;0
42913;178950;4794;59;31;3;28;.903;3600000;0
42914;164323;5013;68;24;3;21;.875;3600000;0
42914;206110;1923;0;0;0;0;.00nan;0;0
42914;-1;1923;65;34;4;30;.882;3567000;0
42914;66482;5013;0;0;0;0;.00nan;0;0
42915;166545;1925;47;23;4;19;.826;3600000;0
42915;11438;1925;0;0;0;0;.00nan;0;0
42915;14259;2632;37;18;4;14;.778;2467000;0
42915;216592;2632;35;19;4;15;.789;1133000;0
42916;180535;2557;77;36;3;33;.917;3563000;0
42916;66353;579;0;0;0;0;.00nan;0;0
42916;67162;2557;0;0;0;0;.00nan;0;0
42916;67993;579;68;25;2;23;.920;3600000;0
42917;166545;1925;0;0;0;0;.00nan;0;0
42917;11438;1925;74;28;2;26;.929;3551000;0
42917;-1;1930;100;25;0;25;1.000;3600000;0
42917;149981;1930;0;0;0;0;.00nan;0;0
42918;164323;5013;78;33;3;30;.909;3600000;0
42918;206110;1923;42;32;6;26;.813;2931000;0
42918;-1;1923;50;7;1;6;.857;669000;0
42918;66482;5013;0;0;0;0;.00nan;0;0
42919;170037;1934;69;28;2;26;.929;3600000;0
42919;206136;1927;0;0;0;0;.00nan;0;0
42919;153618;1927;80;50;6;44;.880;3600000;0
42919;155945;1934;0;0;0;0;.00nan;0;0
42920;14259;2632;90;46;3;43;.935;3552000;0
42920;216592;2632;0;0;0;0;.00nan;0;0
42920;180535;2557;47;11;2;9;.818;3600000;0
42920;67162;2557;0;0;0;0;.00nan;0;0
42921;218;4794;46;25;4;21;.840;3600000;0
42921;178950;4794;0;0;0;0;.00nan;0;0
42921;28453;1920;12;17;6;11;.647;2332000;0
42921;160663;1920;48;13;2;11;.846;1268000;0
42922;14259;2632;59;7;0;7;1.000;517000;0
42922;206110;1923;0;0;0;0;.00nan;0;0
42922;216592;2632;30;24;6;18;.750;3070000;0
42922;-1;1923;42;31;5;26;.839;3600000;0
42923;206136;1927;0;0;0;0;.00nan;0;0
42923;66353;579;62;26;2;24;.923;3600000;0
42923;67993;579;0;0;0;0;.00nan;0;0
42923;153618;1927;40;36;6;30;.833;3600000;0
42924;166545;1925;0;0;0;0;.00nan;0;0
42924;11438;1925;43;26;4;22;.846;3584000;0
42924;28453;1920;0;0;0;0;.00nan;0;0
42924;160663;1920;67;31;3;28;.903;3600000;0
42925;206136;1927;0;0;0;0;.00nan;0;0
42925;-1;1930;38;34;6;28;.824;3553000;0
42925;149981;1930;0;0;0;0;.00nan;0;0
42925;153618;1927;47;29;5;24;.828;3600000;0
42926;206110;1923;50;30;4;26;.867;3600000;0
42926;-1;1923;0;0;0;0;.00nan;0;0
42926;153963;1935;100;27;0;27;1.000;3600000;0
42926;160661;1935;0;0;0;0;.00nan;0;0
42927;218;4794;63;14;1;13;.929;2765000;0
42927;164323;5013;65;35;4;31;.886;3600000;0
42927;178950;4794;21;10;4;6;.600;782000;0
42927;66482;5013;0;0;0;0;.00nan;0;0
42928;14259;2632;86;16;0;16;1.000;3600000;0
42928;28453;1920;73;44;4;40;.909;3600000;0
42928;216592;2632;0;0;0;0;.00nan;0;0
42928;160663;1920;0;0;0;0;.00nan;0;0
42929;-1;1930;0;0;0;0;.00nan;0;0
42929;180535;2557;41;22;4;18;.818;3600000;0
42929;67162;2557;0;0;0;0;.00nan;0;0
42929;149981;1930;100;28;0;28;1.000;3600000;0
42930;166545;1925;0;0;0;0;.00nan;0;0
42930;11438;1925;35;37;7;30;.811;3600000;0
42930;153963;1935;26;26;6;20;.769;3124000;0
42930;160661;1935;57;5;0;5;1.000;476000;0
42931;206136;1927;0;0;0;0;.00nan;0;0
42931;180535;2557;60;34;4;30;.882;3600000;0
42931;67162;2557;0;0;0;0;.00nan;0;0
42931;153618;1927;52;32;5;27;.844;3570000;0
42932;166545;1925;0;0;0;0;.00nan;0;0
42932;11438;1925;86;41;2;39;.951;3900000;0
42932;180535;2557;0;0;0;0;.00nan;0;0
42932;67162;2557;78;34;2;32;.941;3900000;0
42933;218;4794;0;0;0;0;.00nan;0;0
42933;14259;2632;0;0;0;0;.00nan;0;0
42933;178950;4794;24;21;5;16;.762;3600000;0
42933;216592;2632;74;34;2;32;.941;3600000;0
42934;206110;1923;69;41;4;37;.902;3600000;0
42934;28453;1920;0;0;0;0;.00nan;0;0
42934;-1;1923;0;0;0;0;.00nan;0;0
42934;160663;1920;28;22;5;17;.773;3560000;0
42935;206110;1923;0;0;0;0;.00nan;0;0
42935;-1;1923;65;23;2;21;.913;3600000;0
42935;66353;579;54;44;6;38;.864;3600000;0
42935;67993;579;0;0;0;0;.00nan;0;0
42936;164323;5013;81;39;3;36;.923;3900000;0
42936;66482;5013;0;0;0;0;.00nan;0;0
42936;153963;1935;0;0;0;0;.00nan;0;0
42936;160661;1935;56;18;3;15;.833;3900000;0
42937;14259;2632;73;30;3;27;.900;3600000;0
42937;216592;2632;0;0;0;0;.00nan;0;0
42937;-1;1930;0;0;0;0;.00nan;0;0
42937;149981;1930;25;20;5;15;.750;3549000;0
42938;170037;1934;82;11;0;11;1.000;3600000;0
42938;180535;2557;42;22;4;18;.818;3600000;0
42938;67162;2557;0;0;0;0;.00nan;0;0
42938;155945;1934;0;0;0;0;.00nan;0;0
42939;166545;1925;0;0;0;0;.00nan;0;0
42939;11438;1925;72;35;3;32;.914;3600000;0
42939;153963;1935;39;45;7;38;.844;3600000;0
42939;160661;1935;0;0;0;0;.00nan;0;0
42940;218;4794;86;31;2;29;.935;3600000;0
42940;178950;4794;0;0;0;0;.00nan;0;0
42940;206136;1927;0;0;0;0;.00nan;0;0
42940;153618;1927;64;32;3;29;.906;3600000;0
42941;164323;5013;76;36;3;33;.917;3600000;0
42941;28453;1920;25;12;4;8;.667;1188000;0
42941;66482;5013;0;0;0;0;.00nan;0;0
42941;160663;1920;50;16;2;14;.875;2390000;0
42942;218;4794;0;0;0;0;.00nan;0;0
42942;178950;4794;64;27;3;24;.889;3600000;0
42942;206110;1923;41;28;5;23;.821;2115000;0
42942;-1;1923;35;7;2;5;.714;1485000;0
42943;206136;1927;0;0;0;0;.00nan;0;0
42943;28453;1920;52;30;4;26;.867;3571000;0
42943;153618;1927;67;27;3;24;.889;3600000;0
42943;160663;1920;0;0;0;0;.00nan;0;0
42944;-1;1930;61;25;2;23;.920;3600000;0
42944;149981;1930;0;0;0;0;.00nan;0;0
42944;153963;1935;34;26;5;21;.808;3600000;0
42944;160661;1935;0;0;0;0;.00nan;0;0
42945;14259;2632;66;21;2;19;.905;2527000;0
42945;170037;1934;81;30;2;28;.933;3600000;0
42945;216592;2632;50;25;4;21;.840;1073000;0
42945;155945;1934;0;0;0;0;.00nan;0;0
42946;180535;2557;27;36;7;29;.806;3515000;0
42946;66353;579;31;23;5;18;.783;3600000;0
42946;67162;2557;0;0;0;0;.00nan;0;0
42946;67993;579;0;0;0;0;.00nan;0;0
42947;166545;1925;67;31;2;29;.935;3600000;0
42947;218;4794;63;34;4;30;.882;3600000;0
42947;11438;1925;0;0;0;0;.00nan;0;0
42947;178950;4794;0;0;0;0;.00nan;0;0
42948;164323;5013;6;23;7;16;.696;2109000;0
42948;206136;1927;0;0;0;0;.00nan;0;0
42948;66482;5013;55;9;1;8;.889;1491000;0
42948;153618;1927;79;32;2;30;.938;3600000;0
42949;14259;2632;0;0;0;0;.00nan;0;0
42949;216592;2632;72;36;3;33;.917;3900000;0
42949;66353;579;0;0;0;0;.00nan;0;0
42949;67993;579;65;35;3;32;.914;3900000;0
42950;218;4794;0;0;0;0;.00nan;0;0
42950;170037;1934;98;40;2;38;.950;3600000;0
42950;178950;4794;50;28;4;24;.857;3513000;0
42950;155945;1934;0;0;0;0;.00nan;0;0
42951;166545;1925;53;2;0;2;1.000;260000;0
42951;11438;1925;20;21;6;15;.714;3262000;0
42951;66353;579;72;52;5;47;.904;3600000;0
42951;67993;579;0;0;0;0;.00nan;0;0
42952;206136;1927;42;30;6;24;.800;3341000;0
42952;28453;1920;33;10;3;7;.700;550000;0
42952;153618;1927;52;1;0;1;1.000;259000;0
42952;160663;1920;40;30;6;24;.800;3050000;0
42953;14259;2632;76;39;4;35;.897;3600000;0
42953;170037;1934;0;0;0;0;.00nan;0;0
42953;216592;2632;0;0;0;0;.00nan;0;0
42953;155945;1934;45;39;6;33;.846;3518000;0
42954;164323;5013;0;0;0;0;.00nan;0;0
42954;66482;5013;19;38;8;30;.789;3600000;0
42954;153963;1935;0;0;0;0;.00nan;0;0
42954;160661;1935;67;34;4;30;.882;3600000;0
42955;164323;5013;24;12;4;8;.667;1588000;0
42955;66353;579;0;0;0;0;.00nan;0;0
42955;66482;5013;25;18;5;13;.722;2012000;0
42955;67993;579;45;31;5;26;.839;3600000;0
42956;28453;1920;31;33;6;27;.818;3025000;0
42956;-1;1930;51;26;4;22;.846;3600000;0
42956;149981;1930;0;0;0;0;.00nan;0;0
42956;160663;1920;49;1;0;1;1.000;534000;0
42957;170037;1934;60;32;4;28;.875;3900000;0
42957;66353;579;87;41;4;37;.902;3900000;0
42957;67993;579;0;0;0;0;.00nan;0;0
42957;155945;1934;0;0;0;0;.00nan;0;0
42958;166545;1925;63;23;2;21;.913;3600000;0
42958;11438;1925;0;0;0;0;.00nan;0;0
42958;206136;1927;0;0;0;0;.00nan;0;0
42958;153618;1927;56;39;5;34;.872;3600000;0
42959;170037;1934;76;28;2;26;.929;3900000;0
42959;206110;1923;0;0;0;0;.00nan;0;0
42959;-1;1923;98;34;2;32;.941;3900000;0
42959;155945;1934;0;0;0;0;.00nan;0;0
42960;-1;1930;49;27;4;23;.852;3563000;0
42960;180535;2557;75;29;3;26;.897;3600000;0
42960;67162;2557;0;0;0;0;.00nan;0;0
42960;149981;1930;0;0;0;0;.00nan;0;0
42961;206110;1923;58;34;4;30;.882;3900000;0
42961;-1;1930;0;0;0;0;.00nan;0;0
42961;-1;1923;0;0;0;0;.00nan;0;0
42961;149981;1930;85;40;4;36;.900;3900000;0
42962;164323;5013;0;0;0;0;.00nan;0;0
42962;14259;2632;65;32;3;29;.906;3600000;0
42962;216592;2632;0;0;0;0;.00nan;0;0
42962;66482;5013;37;30;5;25;.833;3517000;0
42963;218;4794;0;0;0;0;.00nan;0;0
42963;178950;4794;66;21;2;19;.905;3600000;0
42963;66353;579;64;31;3;28;.903;3579000;0
42963;67993;579;0;0;0;0;.00nan;0;0
42964;28453;1920;30;33;7;26;.788;1679000;0
42964;153963;1935;0;0;0;0;.00nan;0;0
42964;160661;1935;54;24;3;21;.875;3600000;0
42964;160663;1920;35;27;5;22;.815;1921000;0
42965;166545;1925;70;22;2;20;.909;3600000;0
42965;11438;1925;0;0;0;0;.00nan;0;0
42965;206110;1923;0;0;0;0;.00nan;0;0
42965;-1;1923;71;39;3;36;.923;3600000;0
42966;28453;1920;29;29;6;23;.793;2108000;0
42966;153963;1935;0;0;0;0;.00nan;0;0
42966;160661;1935;81;29;1;28;.966;3600000;0
42966;160663;1920;53;13;2;11;.846;1492000;0
42967;218;4794;0;0;0;0;.00nan;0;0
42967;178950;4794;48;28;5;23;.821;3589000;0
42967;-1;1930;79;39;4;35;.897;3600000;0
42967;149981;1930;0;0;0;0;.00nan;0;0
42968;14259;2632;0;0;0;0;.00nan;0;0
42968;206136;1927;0;0;0;0;.00nan;0;0
42968;216592;2632;84;49;4;45;.918;3600000;0
42968;153618;1927;45;32;5;27;.844;3573000;0
42969;66353;579;28;32;6;26;.813;3143000;0
42969;67993;579;54;4;0;4;1.000;457000;0
42969;153963;1935;38;19;3;16;.842;3600000;0
42969;160661;1935;0;0;0;0;.00nan;0;0
42970;164323;5013;0;0;0;0;.00nan;0;0
42970;170037;1934;18;23;6;17;.739;3600000;0
42970;66482;5013;93;31;1;30;.968;3600000;0
42970;155945;1934;0;0;0;0;.00nan;0;0
42971;28453;1920;0;0;0;0;.00nan;0;0
42971;180535;2557;54;22;3;19;.864;3561000;0
42971;67162;2557;0;0;0;0;.00nan;0;0
42971;160663;1920;82;34;2;32;.941;3600000;0
42972;166545;1925;26;13;4;9;.692;2429000;0
42972;11438;1925;27;15;4;11;.733;1156000;0
42972;66353;579;0;0;0;0;.00nan;0;0
42972;67993;579;23;36;7;29;.806;3600000;0
42973;14259;2632;74;40;3;37;.925;3595000;0
42973;216592;2632;0;0;0;0;.00nan;0;0
42973;-1;1930;63;19;2;17;.895;3600000;0
42973;149981;1930;0;0;0;0;.00nan;0;0
42974;166545;1925;53;25;3;22;.880;3600000;0
42974;11438;1925;0;0;0;0;.00nan;0;0
42974;170037;1934;52;36;6;30;.833;2926000;0
42974;155945;1934;52;2;0;2;1.000;674000;0
42975;218;4794;0;0;0;0;.00nan;0;0
42975;178950;4794;64;33;4;29;.879;3593000;0
42975;153963;1935;0;0;0;0;.00nan;0;0
42975;160661;1935;78;38;3;35;.921;3600000;0
42976;166545;1925;0;0;0;0;.00nan;0;0
42976;11438;1925;37;21;5;16;.762;3636000;0
42976;28453;1920;79;56;6;50;.893;3636000;0
42976;160663;1920;0;0;0;0;.00nan;0;0
42977;14259;2632;0;0;0;0;.00nan;0;0
42977;206110;1923;0;0;0;0;.00nan;0;0
42977;216592;2632;47;33;5;28;.848;3566000;0
42977;-1;1923;61;26;3;23;.885;3600000;0
42978;206136;1927;0;0;0;0;.00nan;0;0
42978;153618;1927;22;28;6;22;.786;3600000;0
42978;153963;1935;34;40;7;33;.825;3575000;0
42978;160661;1935;0;0;0;0;.00nan;0;0
42979;170037;1934;0;0;0;0;.00nan;0;0
42979;66353;579;43;45;6;39;.867;3600000;0
42979;67993;579;0;0;0;0;.00nan;0;0
42979;155945;1934;79;26;2;24;.923;3600000;0
42980;164323;5013;0;0;0;0;.00nan;0;0
42980;180535;2557;0;0;0;0;.00nan;0;0
42980;66482;5013;89;31;1;30;.968;3600000;0
42980;67162;2557;71;26;3;23;.885;3514000;0
42981;206136;1927;56;24;3;21;.875;3900000;0
42981;66353;579;0;0;0;0;.00nan;0;0
42981;67993;579;71;43;3;40;.930;3900000;0
42981;153618;1927;0;0;0;0;.00nan;0;0
42982;218;4794;49;24;4;20;.833;3900000;0
42982;178950;4794;0;0;0;0;.00nan;0;0
42982;206110;1923;51;31;4;27;.871;3900000;0
42982;-1;1923;0;0;0;0;.00nan;0;0
42983;206110;1923;64;28;4;24;.857;3866000;0
42983;180535;2557;69;32;3;29;.906;3873000;0
42983;-1;1923;0;0;0;0;.00nan;0;0
42983;67162;2557;0;0;0;0;.00nan;0;0
42984;218;4794;0;0;0;0;.00nan;0;0
42984;178950;4794;49;30;4;26;.867;3600000;0
42984;66353;579;15;26;7;19;.731;2354000;0
42984;67993;579;58;8;0;8;1.000;1246000;0
42985;166545;1925;51;25;4;21;.840;3600000;0
42985;11438;1925;0;0;0;0;.00nan;0;0
42985;14259;2632;0;0;0;0;.00nan;0;0
42985;216592;2632;61;54;7;47;.870;3600000;0
42986;218;4794;42;37;6;31;.838;3544000;0
42986;178950;4794;0;0;0;0;.00nan;0;0
42986;206136;1927;0;0;0;0;.00nan;0;0
42986;153618;1927;49;27;4;23;.852;3600000;0
42987;164323;5013;0;0;0;0;.00nan;0;0
42987;-1;1930;88;29;2;27;.931;3840000;0
42987;66482;5013;70;39;3;36;.923;3840000;0
42987;149981;1930;0;0;0;0;.00nan;0;0
42988;170037;1934;90;40;3;37;.925;3600000;0
42988;67626;1934;0;0;0;0;.00nan;0;0
42988;153963;1935;0;0;0;0;.00nan;0;0
42988;155945;1935;66;30;4;26;.867;3600000;0
42989;170037;1934;0;0;0;0;.00nan;0;0
42989;206110;1923;0;0;0;0;.00nan;0;0
42989;-1;1923;77;36;3;33;.917;3600000;0
42989;67626;1934;13;24;7;17;.708;3600000;0
42990;28453;1920;45;39;6;33;.846;3600000;0
42990;-1;1930;0;0;0;0;.00nan;0;0
42990;149981;1930;52;20;3;17;.850;3600000;0
42990;160663;1920;0;0;0;0;.00nan;0;0
42991;180535;2557;0;0;0;0;.00nan;0;0
42991;67162;2557;41;30;5;25;.833;3581000;0
42991;153963;1935;0;0;0;0;.00nan;0;0
42991;155945;1935;66;32;3;29;.906;3600000;0
42992;166545;1925;62;16;2;14;.875;3600000;0
42992;164323;5013;68;11;0;11;1.000;1071000;0
42992;11438;1925;0;0;0;0;.00nan;0;0
42992;66482;5013;17;35;8;27;.771;2529000;0
42993;170037;1934;67;20;1;19;.950;3600000;0
42993;28453;1920;57;34;5;29;.853;3600000;0
42993;67626;1934;0;0;0;0;.00nan;0;0
42993;160663;1920;0;0;0;0;.00nan;0;0
42994;206136;1927;0;0;0;0;.00nan;0;0
42994;153618;1927;50;37;5;32;.865;3600000;0
42994;153963;1935;0;0;0;0;.00nan;0;0
42994;155945;1935;42;23;4;19;.826;3600000;0
42995;14259;2632;88;47;3;44;.936;3600000;0
42995;216592;2632;0;0;0;0;.00nan;0;0
42995;180535;2557;59;19;2;17;.895;3600000;0
42995;67162;2557;0;0;0;0;.00nan;0;0
42996;206110;1923;67;46;5;41;.891;3578000;0
42996;-1;1930;55;29;4;25;.862;3600000;0
42996;-1;1923;0;0;0;0;.00nan;0;0
42996;149981;1930;0;0;0;0;.00nan;0;0
42997;206110;1923;0;0;0;0;.00nan;0;0
42997;206136;1927;31;23;5;18;.783;3571000;0
42997;-1;1923;100;45;2;43;.956;3600000;0
42997;153618;1927;0;0;0;0;.00nan;0;0
42998;164323;5013;0;0;0;0;.00nan;0;0
42998;66353;579;0;0;0;0;.00nan;0;0
42998;66482;5013;45;35;6;29;.829;3600000;0
42998;67993;579;78;25;1;24;.960;3600000;0
42999;-1;1930;0;0;0;0;.00nan;0;0
42999;149981;1930;56;31;4;27;.871;3600000;0
42999;153963;1935;0;0;0;0;.00nan;0;0
42999;155945;1935;36;28;5;23;.821;3551000;0
43000;218;4794;51;21;3;18;.857;2604000;0
43000;178950;4794;21;11;4;7;.636;996000;0
43000;180535;2557;0;0;0;0;.00nan;0;0
43000;67162;2557;70;42;4;38;.905;3600000;0
43001;166545;1925;59;21;2;19;.905;3600000;0
43001;11438;1925;0;0;0;0;.00nan;0;0
43001;206110;1923;50;41;6;35;.854;3600000;0
43001;-1;1923;0;0;0;0;.00nan;0;0
43002;164323;5013;0;0;0;0;.00nan;0;0
43002;28453;1920;0;0;0;0;.00nan;0;0
43002;66482;5013;45;18;3;15;.833;3600000;0
43002;160663;1920;72;44;5;39;.886;3595000;0
43003;170037;1934;81;36;3;33;.917;3600000;0
43003;180535;2557;9;37;10;27;.730;2945000;0
43003;67162;2557;58;7;0;7;1.000;655000;0
43003;67626;1934;0;0;0;0;.00nan;0;0
43004;166545;1925;59;34;5;29;.853;3600000;0
43004;164323;5013;0;0;0;0;.00nan;0;0
43004;11438;1925;0;0;0;0;.00nan;0;0
43004;66482;5013;25;30;6;24;.800;3580000;0
43005;206136;1927;0;0;0;0;.00nan;0;0
43005;-1;1930;33;21;5;16;.762;3600000;0
43005;149981;1930;0;0;0;0;.00nan;0;0
43005;153618;1927;63;32;4;28;.875;3600000;0
43006;14259;2632;0;0;0;0;.00nan;0;0
43006;216592;2632;66;39;4;35;.897;3600000;0
43006;153963;1935;0;0;0;0;.00nan;0;0
43006;155945;1935;53;19;2;17;.895;3600000;0
43007;28453;1920;56;39;5;34;.872;3553000;0
43007;180535;2557;53;26;4;22;.846;3600000;0
43007;67162;2557;0;0;0;0;.00nan;0;0
43007;160663;1920;0;0;0;0;.00nan;0;0
43008;14259;2632;96;42;2;40;.952;3600000;0
43008;206136;1927;56;22;3;19;.864;3542000;0
43008;216592;2632;0;0;0;0;.00nan;0;0
43008;153618;1927;0;0;0;0;.00nan;0;0
43009;206110;1923;63;28;3;25;.893;3600000;0
43009;28453;1920;50;10;1;9;.900;1324000;0
43009;-1;1923;0;0;0;0;.00nan;0;0
43009;160663;1920;24;18;6;12;.667;2276000;0
43010;218;4794;0;0;0;0;.00nan;0;0
43010;178950;4794;73;30;2;28;.933;3600000;0
43010;66353;579;17;21;6;15;.714;2133000;0
43010;67993;579;33;15;4;11;.733;1467000;0
43011;166545;1925;55;29;4;25;.862;3900000;0
43011;11438;1925;0;0;0;0;.00nan;0;0
43011;170037;1934;48;28;4;24;.857;3900000;0
43011;67626;1934;0;0;0;0;.00nan;0;0
43012;164323;5013;0;0;0;0;.00nan;0;0
43012;170037;1934;100;29;0;29;1.000;3600000;0
43012;66482;5013;56;36;4;32;.889;3600000;0
43012;67626;1934;0;0;0;0;.00nan;0;0
43013;66353;579;0;0;0;0;.00nan;0;0
43013;67993;579;58;39;5;34;.872;3600000;0
43013;153963;1935;0;0;0;0;.00nan;0;0
43013;155945;1935;56;21;2;19;.905;3600000;0
43014;218;4794;41;28;4;24;.857;3576000;0
43014;178950;4794;0;0;0;0;.00nan;0;0
43014;-1;1930;60;25;3;22;.880;3600000;0
43014;149981;1930;0;0;0;0;.00nan;0;0
43015;206110;1923;0;0;0;0;.00nan;0;0
43015;180535;2557;0;0;0;0;.00nan;0;0
43015;-1;1923;27;34;7;27;.794;3600000;0
43015;67162;2557;55;27;4;23;.852;3600000;0
43016;206136;1927;0;0;0;0;.00nan;0;0
43016;-1;1930;50;40;6;34;.850;3600000;0
43016;149981;1930;0;0;0;0;.00nan;0;0
43016;153618;1927;80;35;2;33;.943;3600000;0
43017;170037;1934;43;24;5;19;.792;3600000;0
43017;28453;1920;0;0;0;0;.00nan;0;0
43017;67626;1934;0;0;0;0;.00nan;0;0
43017;160663;1920;79;65;6;59;.908;3589000;0
43018;218;4794;0;0;0;0;.00nan;0;0
43018;178950;4794;56;41;5;36;.878;3900000;0
43018;153963;1935;0;0;0;0;.00nan;0;0
43018;155945;1935;62;40;5;35;.875;3900000;0
43019;14259;2632;0;0;0;0;.00nan;0;0
43019;216592;2632;89;37;3;34;.919;3900000;0
43019;66353;579;55;22;3;19;.864;3900000;0
43019;67993;579;0;0;0;0;.00nan;0;0
43020;166545;1925;61;25;2;23;.920;3600000;0
43020;11438;1925;0;0;0;0;.00nan;0;0
43020;28453;1920;56;37;4;33;.892;3537000;0
43020;160663;1920;0;0;0;0;.00nan;0;0
43021;-1;1930;0;0;0;0;.00nan;0;0
43021;149981;1930;92;35;2;33;.943;3600000;0
43021;153963;1935;0;0;0;0;.00nan;0;0
43021;155945;1935;30;25;5;20;.800;3600000;0
43022;170037;1934;55;10;1;9;.900;3600000;0
43022;180535;2557;81;57;5;52;.912;3600000;0
43022;67162;2557;0;0;0;0;.00nan;0;0
43022;67626;1934;0;0;0;0;.00nan;0;0
43023;164323;5013;0;0;0;0;.00nan;0;0
43023;206110;1923;29;24;6;18;.750;2055000;0
43023;-1;1923;43;16;3;13;.813;1545000;0
43023;66482;5013;66;17;1;16;.941;3600000;0
43024;206136;1927;51;9;1;8;.889;1129000;0
43024;66353;579;37;4;2;2;.500;447000;0
43024;67993;579;31;33;6;27;.818;3229000;0
43024;153618;1927;32;24;6;18;.750;2547000;0
43025;218;4794;0;0;0;0;.00nan;0;0
43025;14259;2632;45;34;5;29;.853;3600000;0
43025;178950;4794;76;28;2;26;.929;3600000;0
43025;216592;2632;0;0;0;0;.00nan;0;0
43026;166545;1925;62;24;2;22;.917;3600000;0
43026;11438;1925;0;0;0;0;.00nan;0;0
43026;206110;1923;0;0;0;0;.00nan;0;0
43026;-1;1923;50;34;5;29;.853;3600000;0
43027;164323;5013;35;27;6;21;.778;3583000;0
43027;28453;1920;33;18;4;14;.778;3600000;0
43027;66482;5013;0;0;0;0;.00nan;0;0
43027;160663;1920;0;0;0;0;.00nan;0;0
43028;14259;2632;65;37;3;34;.919;2598000;0
43028;216592;2632;24;12;4;8;.667;1002000;0
43028;-1;1930;55;19;3;16;.842;3600000;0
43028;149981;1930;0;0;0;0;.00nan;0;0
43029;218;4794;0;0;0;0;.00nan;0;0
43029;178950;4794;54;34;5;29;.853;3557000;0
43029;153963;1935;0;0;0;0;.00nan;0;0
43029;155945;1935;80;32;3;29;.906;3600000;0
43030;166545;1925;63;16;1;15;.938;3600000;0
43030;11438;1925;0;0;0;0;.00nan;0;0
43030;180535;2557;38;28;5;23;.821;3600000;0
43030;67162;2557;0;0;0;0;.00nan;0;0
43031;170037;1934;67;23;2;21;.913;3600000;0
43031;206110;1923;0;0;0;0;.00nan;0;0
43031;-1;1923;39;35;7;28;.800;3600000;0
43031;67626;1934;0;0;0;0;.00nan;0;0
43032;164323;5013;56;32;4;28;.875;3600000;0
43032;180535;2557;0;0;0;0;.00nan;0;0
43032;66482;5013;0;0;0;0;.00nan;0;0
43032;67162;2557;86;31;1;30;.968;3600000;0
43033;-1;1930;0;0;0;0;.00nan;0;0
43033;66353;579;67;33;3;30;.909;3565000;0
43033;67993;579;0;0;0;0;.00nan;0;0
43033;149981;1930;94;29;1;28;.966;3600000;0
43034;206136;1927;43;21;4;17;.810;2595000;0
43034;153618;1927;22;13;4;9;.692;1005000;0
43034;153963;1935;0;0;0;0;.00nan;0;0
43034;155945;1935;88;31;1;30;.968;3600000;0
43035;218;4794;50;5;1;4;.800;800000;0
43035;178950;4794;67;49;6;43;.878;2800000;0
43035;206136;1927;0;0;0;0;.00nan;0;0
43035;153618;1927;79;41;4;37;.902;3600000;0
43036;14259;2632;22;15;5;10;.667;859000;0
43036;216592;2632;56;22;3;19;.864;2741000;0
43036;66353;579;0;0;0;0;.00nan;0;0
43036;67993;579;41;28;5;23;.821;3600000;0
43038;166545;1925;0;0;0;0;.00nan;0;0
43038;11438;1925;61;31;3;28;.903;3565000;0
43038;56901;1930;0;0;0;0;.00nan;0;0
43038;67663;1930;74;21;1;20;.952;3600000;0
43040;170037;1934;68;26;2;24;.923;3600000;0
43040;180535;2557;42;25;4;21;.840;3514000;0
43040;67162;2557;0;0;0;0;.00nan;0;0
43040;155945;1934;0;0;0;0;.00nan;0;0
43042;14259;2632;0;0;0;0;.00nan;0;0
43042;28453;1920;43;4;1;3;.750;868000;0
43042;216592;2632;75;29;2;27;.931;3600000;0
43042;160663;1920;13;30;8;22;.733;2732000;0
43044;206136;1927;33;35;6;29;.829;3900000;0
43044;66353;579;67;56;6;50;.893;3177000;0
43044;67993;579;54;2;0;2;1.000;723000;0
43044;90473;1927;0;0;0;0;.00nan;0;0
43046;218;4794;50;1;0;1;1.000;376000;0
43046;178950;4794;27;20;5;15;.750;3181000;0
43046;206110;1923;63;30;4;26;.867;3600000;0
43046;-1;1923;0;0;0;0;.00nan;0;0
43048;164323;5013;33;13;4;9;.692;1136000;0
43048;66482;5013;41;16;3;13;.813;2464000;0
43048;153963;1935;0;0;0;0;.00nan;0;0
43048;160661;1935;51;17;2;15;.882;3600000;0
43050;164323;5013;63;27;3;24;.889;3600000;0
43050;28453;1920;56;40;6;34;.850;3600000;0
43050;66482;5013;0;0;0;0;.00nan;0;0
43050;160663;1920;0;0;0;0;.00nan;0;0
43052;14259;2632;78;57;4;53;.930;3600000;0
43052;216592;2632;0;0;0;0;.00nan;0;0
43052;153963;1935;78;14;0;14;1.000;3600000;0
43052;160661;1935;0;0;0;0;.00nan;0;0
43054;206110;1923;0;0;0;0;.00nan;0;0
43054;-1;1923;34;26;5;21;.808;3551000;0
43054;66353;579;0;0;0;0;.00nan;0;0
43054;67993;579;64;36;4;32;.889;3600000;0
43056;166545;1925;43;27;5;22;.815;3162000;0
43056;11438;1925;60;4;0;4;1.000;738000;0
43056;180535;2557;0;0;0;0;.00nan;0;0
43056;67162;2557;92;47;5;42;.894;3900000;0
43058;206136;1927;0;0;0;0;.00nan;0;0
43058;56901;1930;34;29;5;24;.828;3617000;0
43058;67663;1930;0;0;0;0;.00nan;0;0
43058;90473;1927;66;42;6;36;.857;3617000;0
43060;218;4794;58;34;5;29;.853;3552000;0
43060;170037;1934;0;0;0;0;.00nan;0;0
43060;178950;4794;0;0;0;0;.00nan;0;0
43060;155945;1934;77;36;3;33;.917;3600000;0
43062;14259;2632;0;0;0;0;.00nan;0;0
43062;206136;1927;72;20;1;19;.950;3600000;0
43062;216592;2632;63;29;3;26;.897;3600000;0
43062;90473;1927;0;0;0;0;.00nan;0;0
43064;206110;1923;26;23;6;17;.739;1828000;0
43064;180535;2557;74;26;2;24;.923;3600000;0
43064;-1;1923;55;20;2;18;.900;1772000;0
43064;67162;2557;0;0;0;0;.00nan;0;0
43066;170037;1934;0;0;0;0;.00nan;0;0
43066;56901;1930;0;0;0;0;.00nan;0;0
43066;67663;1930;70;47;5;42;.894;3900000;0
43066;155945;1934;42;28;5;23;.821;3900000;0
43068;166545;1925;0;0;0;0;.00nan;0;0
43068;218;4794;89;51;5;46;.902;3555000;0
43068;11438;1925;63;33;4;29;.879;3600000;0
43068;178950;4794;0;0;0;0;.00nan;0;0
43070;28453;1920;53;10;1;9;.900;907000;0
43070;66353;579;54;28;3;25;.893;3600000;0
43070;67993;579;0;0;0;0;.00nan;0;0
43070;160663;1920;30;33;7;26;.788;2693000;0
43072;164323;5013;88;44;3;41;.932;3600000;0
43072;66482;5013;0;0;0;0;.00nan;0;0
43072;153963;1935;89;20;0;20;1.000;3600000;0
43072;160661;1935;0;0;0;0;.00nan;0;0
43074;166545;1925;51;23;3;20;.870;3600000;0
43074;11438;1925;0;0;0;0;.00nan;0;0
43074;180535;2557;0;0;0;0;.00nan;0;0
43074;67162;2557;22;25;6;19;.760;3600000;0
43076;164323;5013;0;0;0;0;.00nan;0;0
43076;206136;1927;0;0;0;0;.00nan;0;0
43076;66482;5013;50;40;5;35;.875;3600000;0
43076;90473;1927;91;33;1;32;.970;3600000;0
43078;56901;1930;53;21;3;18;.857;3600000;0
43078;66353;579;0;0;0;0;.00nan;0;0
43078;67663;1930;0;0;0;0;.00nan;0;0
43078;67993;579;40;23;4;19;.826;3556000;0
43080;14259;2632;71;22;1;21;.955;3600000;0
43080;28453;1920;21;34;8;26;.765;3600000;0
43080;216592;2632;0;0;0;0;.00nan;0;0
43080;160663;1920;0;0;0;0;.00nan;0;0
43082;170037;1934;68;31;3;28;.903;3600000;0
43082;206110;1923;26;30;7;23;.767;2811000;0
43082;-1;1923;46;7;1;6;.857;789000;0
43082;155945;1934;0;0;0;0;.00nan;0;0
43084;218;4794;63;10;1;9;.900;559000;0
43084;178950;4794;1;31;10;21;.677;3041000;0
43084;153963;1935;0;0;0;0;.00nan;0;0
43084;160661;1935;18;26;7;19;.731;3600000;0
614;166545;1925;71;23;2;21;.913;3600000;0
614;11438;1925;0;0;0;0;.00nan;0;0
614;180535;2557;74;41;4;37;.902;3591000;0
614;67162;2557;0;0;0;0;.00nan;0;0
615;170037;1934;13;29;7;22;.759;3600000;0
615;206136;1927;0;0;0;0;.00nan;0;0
615;67626;1934;0;0;0;0;.00nan;0;0
615;153618;1927;68;29;3;26;.897;3600000;0
616;-1;1930;48;28;4;24;.857;3803000;0
616;149981;1930;0;0;0;0;.00nan;0;0
616;153963;1935;0;0;0;0;.00nan;0;0
616;155945;1935;65;28;3;25;.893;3803000;0
617;166545;1925;79;28;2;26;.929;3513000;0
617;11438;1925;0;0;0;0;.00nan;0;0
617;206136;1927;0;0;0;0;.00nan;0;0
617;153618;1927;100;39;0;39;1.000;3600000;0
618;-1;1930;54;24;3;21;.875;3600000;0
618;180535;2557;37;16;4;12;.750;925000;0
618;67162;2557;49;23;3;20;.870;2675000;0
618;149981;1930;0;0;0;0;.00nan;0;0
619;170037;1934;62;31;3;28;.903;3900000;0
619;67626;1934;0;0;0;0;.00nan;0;0
619;153963;1935;0;0;0;0;.00nan;0;0
619;155945;1935;66;31;3;28;.903;3900000;0
620;166545;1925;46;35;5;30;.857;3578000;0
620;11438;1925;0;0;0;0;.00nan;0;0
620;-1;1930;69;42;4;38;.905;3600000;0
620;149981;1930;0;0;0;0;.00nan;0;0
621;206136;1927;0;0;0;0;.00nan;0;0
621;153618;1927;92;38;2;36;.947;3600000;0
621;153963;1935;0;0;0;0;.00nan;0;0
621;155945;1935;58;35;5;30;.857;3600000;0
622;170037;1934;34;26;5;21;.808;3600000;0
622;180535;2557;54;4;0;4;1.000;285000;0
622;67162;2557;26;30;6;24;.800;3305000;0
622;67626;1934;0;0;0;0;.00nan;0;0
623;166545;1925;0;0;0;0;.00nan;0;0
623;11438;1925;15;27;7;20;.741;3600000;0
623;153963;1935;0;0;0;0;.00nan;0;0
623;155945;1935;64;33;3;30;.909;3600000;0
624;170037;1934;40;27;5;22;.815;3600000;0
624;-1;1930;48;33;6;27;.818;2966000;0
624;67626;1934;0;0;0;0;.00nan;0;0
624;149981;1930;53;3;0;3;1.000;620000;0
625;206136;1927;82;35;2;33;.943;3600000;0
625;180535;2557;0;0;0;0;.00nan;0;0
625;67162;2557;42;32;5;27;.844;3600000;0
625;153618;1927;0;0;0;0;.00nan;0;0
626;166545;1925;62;16;1;15;.938;3600000;0
626;11438;1925;0;0;0;0;.00nan;0;0
626;170037;1934;77;38;3;35;.921;3571000;0
626;67626;1934;0;0;0;0;.00nan;0;0
627;180535;2557;25;30;6;24;.800;3600000;0
627;67162;2557;0;0;0;0;.00nan;0;0
627;153963;1935;0;0;0;0;.00nan;0;0
627;155945;1935;71;21;1;20;.952;3600000;0
628;206136;1927;0;0;0;0;.00nan;0;0
628;-1;1930;32;30;6;24;.800;3571000;0
628;149981;1930;0;0;0;0;.00nan;0;0
628;153618;1927;47;29;5;24;.828;3600000;0
629;166545;1925;75;22;1;21;.955;3600000;0
629;11438;1925;0;0;0;0;.00nan;0;0
629;180535;2557;75;45;4;41;.911;3600000;0
629;67162;2557;0;0;0;0;.00nan;0;0
630;170037;1934;0;0;0;0;.00nan;0;0
630;206136;1927;77;17;0;17;1.000;1368000;0
630;67626;1934;53;30;4;26;.867;3600000;0
630;153618;1927;15;27;7;20;.741;2232000;0
631;-1;1930;73;34;3;31;.912;3900000;0
631;149981;1930;0;0;0;0;.00nan;0;0
631;153963;1935;0;0;0;0;.00nan;0;0
631;155945;1935;76;41;3;38;.927;3900000;0
632;166545;1925;53;26;4;22;.846;3600000;0
632;11438;1925;0;0;0;0;.00nan;0;0
632;206136;1927;0;0;0;0;.00nan;0;0
632;153618;1927;94;38;2;36;.947;3600000;0
633;-1;1930;0;0;0;0;.00nan;0;0
633;180535;2557;43;34;5;29;.853;3568000;0
633;67162;2557;0;0;0;0;.00nan;0;0
633;149981;1930;59;20;3;17;.850;3600000;0
634;170037;1934;64;33;4;29;.879;3900000;0
634;67626;1934;0;0;0;0;.00nan;0;0
634;153963;1935;43;24;4;20;.833;3900000;0
634;155945;1935;0;0;0;0;.00nan;0;0
635;166545;1925;63;21;2;19;.905;3600000;0
635;11438;1925;0;0;0;0;.00nan;0;0
635;-1;1930;27;31;6;25;.806;3003000;0
635;149981;1930;23;4;3;1;.250;597000;0
636;206136;1927;0;0;0;0;.00nan;0;0
636;153618;1927;77;36;4;32;.889;3600000;0
636;153963;1935;0;0;0;0;.00nan;0;0
636;155945;1935;100;24;0;24;1.000;3600000;0
637;170037;1934;42;31;6;25;.806;3128000;0
637;180535;2557;47;37;6;31;.838;3886000;0
637;67162;2557;0;0;0;0;.00nan;0;0
637;67626;1934;62;13;1;12;.923;758000;0
638;166545;1925;53;27;4;23;.852;3600000;0
638;11438;1925;0;0;0;0;.00nan;0;0
638;153963;1935;0;0;0;0;.00nan;0;0
638;155945;1935;54;39;5;34;.872;3545000;0
639;170037;1934;70;19;1;18;.947;3600000;0
639;-1;1930;65;40;4;36;.900;3600000;0
639;67626;1934;0;0;0;0;.00nan;0;0
639;149981;1930;0;0;0;0;.00nan;0;0
640;206136;1927;0;0;0;0;.00nan;0;0
640;180535;2557;69;36;4;32;.889;3900000;0
640;67162;2557;0;0;0;0;.00nan;0;0
640;153618;1927;45;28;4;24;.857;3900000;0
641;166545;1925;28;33;6;27;.818;3532000;0
641;11438;1925;0;0;0;0;.00nan;0;0
641;170037;1934;60;31;4;27;.871;3600000;0
641;67626;1934;0;0;0;0;.00nan;0;0
642;180535;2557;59;48;6;42;.875;3573000;0
642;67162;2557;0;0;0;0;.00nan;0;0
642;153963;1935;0;0;0;0;.00nan;0;0
642;155945;1935;56;37;5;32;.865;3600000;0
643;206136;1927;0;0;0;0;.00nan;0;0
643;-1;1930;55;35;5;30;.857;3600000;0
643;149981;1930;0;0;0;0;.00nan;0;0
643;153618;1927;96;29;1;28;.966;3600000;0
644;28453;1920;21;29;7;22;.759;1806000;0
644;66353;579;79;30;2;28;.933;3600000;0
644;67993;579;0;0;0;0;.00nan;0;0
644;160663;1920;34;18;4;14;.778;1794000;0
645;218;4794;0;0;0;0;.00nan;0;0
645;14259;2632;0;0;0;0;.00nan;0;0
645;178950;4794;59;28;3;25;.893;3600000;0
645;216592;2632;47;40;6;34;.850;3600000;0
646;164323;5013;21;9;4;5;.556;826000;0
646;206110;1923;46;18;3;15;.833;3600000;0
646;-1;1923;0;0;0;0;.00nan;0;0
646;66482;5013;58;27;3;24;.889;2774000;0
647;14259;2632;0;0;0;0;.00nan;0;0
647;216592;2632;69;19;2;17;.895;3600000;0
647;66353;579;72;38;4;34;.895;3586000;0
647;67993;579;0;0;0;0;.00nan;0;0
648;206110;1923;55;4;0;4;1.000;612000;0
648;28453;1920;0;0;0;0;.00nan;0;0
648;-1;1923;20;23;6;17;.739;2988000;0
648;160663;1920;77;32;3;29;.906;3600000;0
649;218;4794;0;0;0;0;.00nan;0;0
649;164323;5013;31;10;3;7;.700;504000;0
649;178950;4794;95;33;1;32;.970;3600000;0
649;66482;5013;71;37;3;34;.919;3096000;0
650;206110;1923;41;26;4;22;.846;3781000;0
650;-1;1923;0;0;0;0;.00nan;0;0
650;66353;579;77;49;5;44;.898;3781000;0
650;67993;579;0;0;0;0;.00nan;0;0
651;164323;5013;72;28;2;26;.929;3600000;0
651;14259;2632;63;31;3;28;.903;3600000;0
651;216592;2632;0;0;0;0;.00nan;0;0
651;66482;5013;0;0;0;0;.00nan;0;0
652;218;4794;0;0;0;0;.00nan;0;0
652;178950;4794;90;30;1;29;.967;3600000;0
652;28453;1920;76;49;5;44;.898;3600000;0
652;160663;1920;0;0;0;0;.00nan;0;0
653;164323;5013;44;26;4;22;.846;3544000;0
653;66353;579;67;28;2;26;.929;3600000;0
653;66482;5013;0;0;0;0;.00nan;0;0
653;67993;579;0;0;0;0;.00nan;0;0
654;218;4794;0;0;0;0;.00nan;0;0
654;178950;4794;71;28;2;26;.929;3600000;0
654;206110;1923;0;0;0;0;.00nan;0;0
654;-1;1923;81;31;1;30;.968;3600000;0
655;14259;2632;0;0;0;0;.00nan;0;0
655;28453;1920;29;21;5;16;.762;3600000;0
655;216592;2632;100;37;0;37;1.000;3600000;0
655;160663;1920;0;0;0;0;.00nan;0;0
656;218;4794;33;30;6;24;.800;3584000;0
656;178950;4794;0;0;0;0;.00nan;0;0
656;66353;579;63;38;5;33;.868;3600000;0
656;67993;579;0;0;0;0;.00nan;0;0
657;164323;5013;52;29;5;24;.828;3594000;0
657;28453;1920;60;34;4;30;.882;3600000;0
657;66482;5013;0;0;0;0;.00nan;0;0
657;160663;1920;0;0;0;0;.00nan;0;0
658;14259;2632;0;0;0;0;.00nan;0;0
658;206110;1923;26;5;3;2;.400;364000;0
658;216592;2632;57;39;6;33;.846;3657000;0
658;-1;1923;55;19;2;17;.895;3293000;0
659;28453;1920;41;28;5;23;.821;3600000;0
659;66353;579;38;7;2;5;.714;1323000;0
659;67993;579;11;25;7;18;.720;2277000;0
659;160663;1920;0;0;0;0;.00nan;0;0
660;218;4794;0;0;0;0;.00nan;0;0
660;14259;2632;0;0;0;0;.00nan;0;0
660;178950;4794;80;32;3;29;.906;3600000;0
660;216592;2632;76;42;4;38;.905;3589000;0
661;164323;5013;0;0;0;0;.00nan;0;0
661;206110;1923;0;0;0;0;.00nan;0;0
661;-1;1923;46;30;5;25;.833;3600000;0
661;66482;5013;17;21;6;15;.714;3550000;0
662;14259;2632;0;0;0;0;.00nan;0;0
662;216592;2632;61;27;3;24;.889;3600000;0
662;66353;579;48;39;6;33;.846;3600000;0
662;67993;579;0;0;0;0;.00nan;0;0
663;206110;1923;72;25;2;23;.920;3600000;0
663;28453;1920;50;27;3;24;.889;3581000;0
663;-1;1923;0;0;0;0;.00nan;0;0
663;160663;1920;0;0;0;0;.00nan;0;0
664;218;4794;72;21;1;20;.952;3600000;0
664;164323;5013;80;38;3;35;.921;3553000;0
664;178950;4794;0;0;0;0;.00nan;0;0
664;66482;5013;0;0;0;0;.00nan;0;0
665;206110;1923;0;0;0;0;.00nan;0;0
665;-1;1923;63;28;3;25;.893;3600000;0
665;66353;579;63;28;2;26;.929;3600000;0
665;67993;579;0;0;0;0;.00nan;0;0
666;164323;5013;0;0;0;0;.00nan;0;0
666;14259;2632;0;0;0;0;.00nan;0;0
666;216592;2632;98;48;3;45;.938;3600000;0
666;66482;5013;88;18;0;18;1.000;3600000;0
667;218;4794;0;0;0;0;.00nan;0;0
667;178950;4794;72;19;1;18;.947;3600000;0
667;28453;1920;0;0;0;0;.00nan;0;0
667;160663;1920;78;48;4;44;.917;3600000;0
668;164323;5013;33;22;6;16;.727;2482000;0
668;66353;579;84;34;2;32;.941;3600000;0
668;66482;5013;36;6;2;4;.667;1118000;0
668;67993;579;0;0;0;0;.00nan;0;0
669;218;4794;0;0;0;0;.00nan;0;0
669;178950;4794;33;27;5;22;.815;3600000;0
669;206110;1923;72;25;2;23;.920;3600000;0
669;-1;1923;0;0;0;0;.00nan;0;0
670;14259;2632;0;0;0;0;.00nan;0;0
670;28453;1920;61;33;4;29;.879;3600000;0
670;216592;2632;40;38;6;32;.842;3550000;0
670;160663;1920;0;0;0;0;.00nan;0;0
671;218;4794;64;16;1;15;.938;3600000;0
671;178950;4794;0;0;0;0;.00nan;0;0
671;66353;579;95;49;3;46;.939;3551000;0
671;67993;579;0;0;0;0;.00nan;0;0
672;164323;5013;0;0;0;0;.00nan;0;0
672;28453;1920;0;0;0;0;.00nan;0;0
672;66482;5013;61;20;2;18;.900;3600000;0
672;160663;1920;56;57;7;50;.877;3600000;0
673;14259;2632;0;0;0;0;.00nan;0;0
673;206110;1923;0;0;0;0;.00nan;0;0
673;216592;2632;52;29;4;25;.862;3545000;0
673;-1;1923;50;17;3;14;.824;3600000;0
1309;170037;1934;62;22;2;20;.909;3530000;0
1309;66353;579;100;29;0;29;1.000;3600000;0
1309;67626;1934;0;0;0;0;.00nan;0;0
1309;67993;579;0;0;0;0;.00nan;0;0
1310;218;4794;0;0;0;0;.00nan;0;0
1310;178950;4794;42;28;4;24;.857;3924000;0
1310;153963;1935;0;0;0;0;.00nan;0;0
1310;155945;1935;61;32;3;29;.906;3924000;0
1311;166545;1925;94;22;0;22;1.000;3600000;0
1311;11438;1925;0;0;0;0;.00nan;0;0
1311;180535;2557;83;43;3;40;.930;3600000;0
1311;67162;2557;0;0;0;0;.00nan;0;0
1312;206136;1927;0;0;0;0;.00nan;0;0
1312;-1;1930;31;25;5;20;.800;3600000;0
1312;149981;1930;0;0;0;0;.00nan;0;0
1312;153618;1927;96;30;1;29;.967;3600000;0
1313;170037;1934;35;23;5;18;.783;3600000;0
1313;66353;579;31;40;7;33;.825;3525000;0
1313;67626;1934;0;0;0;0;.00nan;0;0
1313;67993;579;0;0;0;0;.00nan;0;0
1314;218;4794;0;0;0;0;.00nan;0;0
1314;178950;4794;49;35;5;30;.857;3546000;0
1314;153963;1935;0;0;0;0;.00nan;0;0
1314;155945;1935;43;26;4;22;.846;3600000;0
1315;166545;1925;90;15;0;15;1.000;3600000;0
1315;11438;1925;0;0;0;0;.00nan;0;0
1315;180535;2557;91;44;3;41;.932;3600000;0
1315;67162;2557;0;0;0;0;.00nan;0;0
1316;206136;1927;0;0;0;0;.00nan;0;0
1316;-1;1930;83;32;2;30;.938;3600000;0
1316;149981;1930;0;0;0;0;.00nan;0;0
1316;153618;1927;57;36;5;31;.861;3600000;0
1317;170037;1934;58;23;3;20;.870;3600000;0
1317;66353;579;78;51;4;47;.922;3600000;0
1317;67626;1934;0;0;0;0;.00nan;0;0
1317;67993;579;0;0;0;0;.00nan;0;0
1318;218;4794;0;0;0;0;.00nan;0;0
1318;178950;4794;69;48;5;43;.896;4104000;0
1318;153963;1935;0;0;0;0;.00nan;0;0
1318;155945;1935;33;31;6;25;.806;4104000;0
1319;166545;1925;55;33;4;29;.879;3600000;0
1319;11438;1925;0;0;0;0;.00nan;0;0
1319;180535;2557;35;36;7;29;.806;2870000;0
1319;67162;2557;26;14;4;10;.714;730000;0
1320;206136;1927;0;0;0;0;.00nan;0;0
1320;-1;1930;52;34;5;29;.853;3600000;0
1320;149981;1930;0;0;0;0;.00nan;0;0
1320;153618;1927;72;26;1;25;.962;3600000;0
1577;170037;1934;86;27;1;26;.963;3600000;0
1577;66353;579;77;41;4;37;.902;3600000;0
1577;67626;1934;0;0;0;0;.00nan;0;0
1577;67993;579;0;0;0;0;.00nan;0;0
1578;218;4794;0;0;0;0;.00nan;0;0
1578;178950;4794;79;35;3;32;.914;3600000;0
1578;153963;1935;52;4;0;4;1.000;1218000;0
1578;155945;1935;16;19;6;13;.684;2382000;0
1579;206136;1927;0;0;0;0;.00nan;0;0
1579;-1;1930;59;38;4;34;.895;3600000;0
1579;149981;1930;0;0;0;0;.00nan;0;0
1579;153618;1927;70;24;2;22;.917;3600000;0
1622;218;4794;0;0;0;0;.00nan;0;0
1622;178950;4794;97;48;4;44;.917;3600000;0
1622;153963;1935;0;0;0;0;.00nan;0;0
1622;155945;1935;62;23;3;20;.870;3600000;0
1692;170037;1934;56;39;5;34;.872;3564000;0
1692;206136;1927;0;0;0;0;.00nan;0;0
1692;67626;1934;0;0;0;0;.00nan;0;0
1692;153618;1927;83;42;4;38;.905;3600000;0
1693;166545;1925;62;32;4;28;.875;3600000;0
1693;11438;1925;0;0;0;0;.00nan;0;0
1693;153963;1935;0;0;0;0;.00nan;0;0
1693;155945;1935;39;30;5;25;.833;3553000;0
1694;170037;1934;62;38;4;34;.895;4301000;0
1694;206136;1927;0;0;0;0;.00nan;0;0
1694;67626;1934;0;0;0;0;.00nan;0;0
1694;153618;1927;64;45;5;40;.889;4301000;0
1695;166545;1925;61;33;4;29;.879;3578000;0
1695;11438;1925;0;0;0;0;.00nan;0;0
1695;153963;1935;0;0;0;0;.00nan;0;0
1695;155945;1935;70;29;2;27;.931;3600000;0
1696;170037;1934;72;38;4;34;.895;3600000;0
1696;206136;1927;0;0;0;0;.00nan;0;0
1696;67626;1934;0;0;0;0;.00nan;0;0
1696;153618;1927;37;27;5;22;.815;3543000;0
1697;166545;1925;25;25;6;19;.760;3514000;0
1697;11438;1925;0;0;0;0;.00nan;0;0
1697;153963;1935;0;0;0;0;.00nan;0;0
1697;155945;1935;49;27;4;23;.852;3600000;0
1935;170037;1934;76;27;2;25;.926;3600000;0
1935;206136;1927;0;0;0;0;.00nan;0;0
1935;67626;1934;0;0;0;0;.00nan;0;0
1935;153618;1927;66;32;3;29;.906;3543000;0
1936;166545;1925;53;24;3;21;.875;3600000;0
1936;11438;1925;0;0;0;0;.00nan;0;0
1936;153963;1935;52;13;2;11;.846;1092000;0
1936;155945;1935;28;27;6;21;.778;2508000;0
1971;166545;1925;28;7;3;4;.571;587000;0
1971;11438;1925;39;24;4;20;.833;3013000;0
1971;153963;1935;0;0;0;0;.00nan;0;0
1971;155945;1935;96;24;0;24;1.000;3600000;0
2022;170037;1934;32;30;6;24;.800;2266000;0
2022;67626;1934;64;8;0;8;1.000;1324000;0
2022;153963;1935;0;0;0;0;.00nan;0;0
2022;155945;1935;45;26;4;22;.846;3600000;0
2023;170037;1934;48;32;4;28;.875;3747000;0
2023;67626;1934;0;0;0;0;.00nan;0;0
2023;153963;1935;0;0;0;0;.00nan;0;0
2023;155945;1935;69;49;5;44;.898;3704000;0
2024;170037;1934;83;29;2;27;.931;3600000;0
2024;67626;1934;0;0;0;0;.00nan;0;0
2024;153963;1935;0;0;0;0;.00nan;0;0
2024;155945;1935;81;23;1;22;.957;3600000;0
2280;170037;1934;28;42;8;34;.810;3600000;0
2280;67626;1934;0;0;0;0;.00nan;0;0
2280;153963;1935;54;3;0;3;1.000;405000;0
2280;155945;1935;23;27;6;21;.778;3195000;0
43085;177771;2163;0;0;0;0;.00nan;0;0
43085;-1;2164;0;0;0;0;.00nan;0;0
43085;-1;2164;46;33;4;29;.879;3900000;0
43085;161081;2163;47;24;4;20;.833;3900000;0
43086;193486;2161;79;26;1;25;.962;3900000;0
43086;179350;4840;89;35;1;34;.971;3900000;0
43086;-1;4840;0;0;0;0;.00nan;0;0
43086;186275;2161;0;0;0;0;.00nan;0;0
43087;189333;2158;0;0;0;0;.00nan;0;0
43087;21607;2162;0;0;0;0;.00nan;0;0
43087;-1;2162;97;42;0;42;1.000;3900000;0
43087;196495;2158;86;11;0;11;1.000;3900000;0
43088;177771;2163;0;0;0;0;.00nan;0;0
43088;-1;2164;99;48;3;45;.938;3600000;0
43088;-1;2164;0;0;0;0;.00nan;0;0
43088;161081;2163;44;30;4;26;.867;3542000;0
43089;193486;2161;70;23;2;21;.913;3600000;0
43089;179350;4840;43;37;6;31;.838;3600000;0
43089;-1;4840;0;0;0;0;.00nan;0;0
43089;186275;2161;0;0;0;0;.00nan;0;0
43090;189333;2158;0;0;0;0;.00nan;0;0
43090;21607;2162;0;0;0;0;.00nan;0;0
43090;-1;2162;74;50;5;45;.900;3600000;0
43090;196495;2158;88;14;0;14;1.000;3600000;0
43091;193486;2161;53;31;4;27;.871;3900000;0
43091;189333;2158;0;0;0;0;.00nan;0;0
43091;196495;2158;47;22;4;18;.818;3900000;0
43091;186275;2161;0;0;0;0;.00nan;0;0
43092;-1;2164;78;44;3;41;.932;3559000;0
43092;179350;4840;81;28;2;26;.929;3600000;0
43092;-1;4840;0;0;0;0;.00nan;0;0
43092;-1;2164;0;0;0;0;.00nan;0;0
43093;177771;2163;0;0;0;0;.00nan;0;0
43093;21607;2162;0;0;0;0;.00nan;0;0
43093;-1;2162;63;28;4;24;.857;3552000;0
43093;161081;2163;89;32;2;30;.938;3600000;0
43094;193486;2161;0;0;0;0;.00nan;0;0
43094;189333;2158;73;20;1;19;.950;3900000;0
43094;196495;2158;0;0;0;0;.00nan;0;0
43094;186275;2161;100;39;1;38;.974;3900000;0
43095;-1;2164;23;4;3;1;.250;371000;0
43095;179350;4840;93;35;1;34;.971;3600000;0
43095;-1;4840;0;0;0;0;.00nan;0;0
43095;-1;2164;55;29;3;26;.897;3229000;0
43096;177771;2163;0;0;0;0;.00nan;0;0
43096;21607;2162;52;39;6;33;.846;2991000;0
43096;-1;2162;48;7;1;6;.857;609000;0
43096;161081;2163;64;14;1;13;.929;3600000;0
43097;177771;2163;0;0;0;0;.00nan;0;0
43097;189333;2158;0;0;0;0;.00nan;0;0
43097;196495;2158;85;14;0;14;1.000;3600000;0
43097;161081;2163;63;48;6;42;.875;3600000;0
43098;21607;2162;0;0;0;0;.00nan;0;0
43098;-1;2162;89;30;1;29;.967;3600000;0
43098;179350;4840;97;35;2;33;.943;3588000;0
43098;-1;4840;0;0;0;0;.00nan;0;0
43099;177771;2163;72;27;2;25;.926;3600000;0
43099;189333;2158;0;0;0;0;.00nan;0;0
43099;196495;2158;53;25;3;22;.880;3553000;0
43099;161081;2163;0;0;0;0;.00nan;0;0
43100;21607;2162;72;34;2;32;.941;3900000;0
43100;-1;2162;0;0;0;0;.00nan;0;0
43100;179350;4840;82;36;2;34;.944;3900000;0
43100;-1;4840;0;0;0;0;.00nan;0;0
43101;193486;2161;59;32;4;28;.875;3560000;0
43101;21607;2162;0;0;0;0;.00nan;0;0
43101;-1;2162;74;32;3;29;.906;3600000;0
43101;186275;2161;0;0;0;0;.00nan;0;0
43102;177771;2163;98;40;0;40;1.000;2554000;0
43102;189333;2158;0;0;0;0;.00nan;0;0
43102;196495;2158;59;21;2;19;.905;3600000;0
43102;161081;2163;28;16;4;12;.750;1035000;0
43103;193486;2161;52;1;0;1;1.000;263000;0
43103;21607;2162;39;43;7;36;.837;3600000;0
43103;-1;2162;0;0;0;0;.00nan;0;0
43103;186275;2161;27;22;6;16;.727;3337000;0
43104;177771;2163;0;0;0;0;.00nan;0;0
43104;189333;2158;74;27;2;25;.926;3683000;0
43104;196495;2158;0;0;0;0;.00nan;0;0
43104;161081;2163;99;48;1;47;.979;3683000;0
43105;193486;2161;44;21;4;17;.810;3546000;0
43105;-1;2164;0;0;0;0;.00nan;0;0
43105;186275;2161;0;0;0;0;.00nan;0;0
43105;-1;2164;75;33;3;30;.909;3600000;0
43106;189333;2158;0;0;0;0;.00nan;0;0
43106;179350;4840;94;46;2;44;.957;3600000;0
43106;-1;4840;0;0;0;0;.00nan;0;0
43106;196495;2158;66;18;1;17;.944;3600000;0
43107;177771;2163;0;0;0;0;.00nan;0;0
43107;21607;2162;0;0;0;0;.00nan;0;0
43107;-1;2162;56;24;4;20;.833;3541000;0
43107;161081;2163;61;33;3;30;.909;3600000;0
43108;193486;2161;0;0;0;0;.00nan;0;0
43108;-1;2164;78;42;3;39;.929;3600000;0
43108;186275;2161;98;18;0;18;1.000;3600000;0
43108;-1;2164;0;0;0;0;.00nan;0;0
43109;189333;2158;51;20;3;17;.850;3718000;0
43109;179350;4840;100;49;2;47;.959;3718000;0
43109;-1;4840;0;0;0;0;.00nan;0;0
43109;196495;2158;0;0;0;0;.00nan;0;0
43110;177771;2163;52;34;5;29;.853;3600000;0
43110;21607;2162;64;19;2;17;.895;3600000;0
43110;-1;2162;0;0;0;0;.00nan;0;0
43110;161081;2163;0;0;0;0;.00nan;0;0
43111;193486;2161;0;0;0;0;.00nan;0;0
43111;189333;2158;0;0;0;0;.00nan;0;0
43111;196495;2158;69;15;1;14;.933;3600000;0
43111;186275;2161;66;38;4;34;.895;3600000;0
43112;21607;2162;0;0;0;0;.00nan;0;0
43112;-1;2162;61;28;2;26;.929;3600000;0
43112;179350;4840;55;29;4;25;.862;3600000;0
43112;-1;4840;0;0;0;0;.00nan;0;0
43113;177771;2163;0;0;0;0;.00nan;0;0
43113;-1;2164;56;35;5;30;.857;3600000;0
43113;-1;2164;0;0;0;0;.00nan;0;0
43113;161081;2163;65;22;2;20;.909;3600000;0
43114;193486;2161;65;40;4;36;.900;3600000;0
43114;189333;2158;94;18;0;18;1.000;3600000;0
43114;196495;2158;0;0;0;0;.00nan;0;0
43114;186275;2161;0;0;0;0;.00nan;0;0
43115;21607;2162;67;27;2;25;.926;3600000;0
43115;-1;2162;0;0;0;0;.00nan;0;0
43115;179350;4840;60;32;3;29;.906;3600000;0
43115;-1;4840;0;0;0;0;.00nan;0;0
43116;177771;2163;83;25;1;24;.960;3600000;0
43116;-1;2164;0;0;0;0;.00nan;0;0
43116;-1;2164;88;37;2;35;.946;3567000;0
43116;161081;2163;0;0;0;0;.00nan;0;0
43117;189333;2158;33;11;3;8;.727;3600000;0
43117;-1;2164;96;60;4;56;.933;3594000;0
43117;196495;2158;0;0;0;0;.00nan;0;0
43117;-1;2164;0;0;0;0;.00nan;0;0
43118;193486;2161;100;30;0;30;1.000;3600000;0
43118;21607;2162;0;0;0;0;.00nan;0;0
43118;-1;2162;62;33;3;30;.909;3600000;0
43118;186275;2161;0;0;0;0;.00nan;0;0
43119;177771;2163;0;0;0;0;.00nan;0;0
43119;179350;4840;71;32;3;29;.906;3554000;0
43119;-1;4840;0;0;0;0;.00nan;0;0
43119;161081;2163;91;35;2;33;.943;3600000;0
43120;189333;2158;0;0;0;0;.00nan;0;0
43120;-1;2164;0;0;0;0;.00nan;0;0
43120;196495;2158;56;10;1;9;.900;3600000;0
43120;-1;2164;89;45;2;43;.956;3572000;0
43121;193486;2161;70;31;3;28;.903;3600000;0
43121;21607;2162;0;0;0;0;.00nan;0;0
43121;-1;2162;59;34;4;30;.882;3547000;0
43121;186275;2161;0;0;0;0;.00nan;0;0
43122;177771;2163;0;0;0;0;.00nan;0;0
43122;179350;4840;84;33;1;32;.970;3600000;0
43122;-1;4840;0;0;0;0;.00nan;0;0
43122;161081;2163;81;38;3;35;.921;3600000;0
43123;21607;2162;0;0;0;0;.00nan;0;0
43123;-1;2164;0;0;0;0;.00nan;0;0
43123;-1;2162;100;29;0;29;1.000;3600000;0
43123;-1;2164;74;35;3;32;.914;3600000;0
43124;193486;2161;76;29;1;28;.966;3600000;0
43124;177771;2163;0;0;0;0;.00nan;0;0
43124;186275;2161;0;0;0;0;.00nan;0;0
43124;161081;2163;42;41;6;35;.854;3600000;0
43125;189333;2158;0;0;0;0;.00nan;0;0
43125;179350;4840;80;36;3;33;.917;3532000;0
43125;-1;4840;0;0;0;0;.00nan;0;0
43125;196495;2158;82;21;1;20;.952;3600000;0
43126;21607;2162;0;0;0;0;.00nan;0;0
43126;-1;2164;62;27;3;24;.889;3573000;0
43126;-1;2162;77;27;1;26;.963;3600000;0
43126;-1;2164;0;0;0;0;.00nan;0;0
43127;193486;2161;0;0;0;0;.00nan;0;0
43127;177771;2163;77;36;3;33;.917;3600000;0
43127;186275;2161;57;26;4;22;.846;3542000;0
43127;161081;2163;0;0;0;0;.00nan;0;0
43128;189333;2158;0;0;0;0;.00nan;0;0
43128;179350;4840;74;42;3;39;.929;3600000;0
43128;-1;4840;0;0;0;0;.00nan;0;0
43128;196495;2158;82;14;0;14;1.000;3600000;0
43129;-1;2164;0;0;0;0;.00nan;0;0
43129;179350;4840;99;21;0;21;1.000;3600000;0
43129;-1;4840;0;0;0;0;.00nan;0;0
43129;-1;2164;80;26;1;25;.962;3600000;0
43130;189333;2158;0;0;0;0;.00nan;0;0
43130;21607;2162;0;0;0;0;.00nan;0;0
43130;-1;2162;97;49;2;47;.959;3600000;0
43130;196495;2158;86;17;0;17;1.000;3600000;0
43131;193486;2161;55;27;4;23;.852;3516000;0
43131;177771;2163;0;0;0;0;.00nan;0;0
43131;186275;2161;0;0;0;0;.00nan;0;0
43131;161081;2163;91;33;2;31;.939;3600000;0
43132;-1;2164;42;34;6;28;.824;3600000;0
43132;179350;4840;62;25;2;23;.920;3600000;0
43132;-1;4840;0;0;0;0;.00nan;0;0
43132;-1;2164;0;0;0;0;.00nan;0;0
43133;189333;2158;0;0;0;0;.00nan;0;0
43133;21607;2162;97;47;2;45;.957;3513000;0
43133;-1;2162;0;0;0;0;.00nan;0;0
43133;196495;2158;72;12;0;12;1.000;3600000;0
43134;193486;2161;0;0;0;0;.00nan;0;0
43134;177771;2163;80;26;1;25;.962;3600000;0
43134;186275;2161;63;26;2;24;.923;3547000;0
43134;161081;2163;0;0;0;0;.00nan;0;0
43135;193486;2161;56;24;3;21;.875;3752000;0
43135;179350;4840;88;48;2;46;.958;3752000;0
43135;-1;4840;0;0;0;0;.00nan;0;0
43135;186275;2161;0;0;0;0;.00nan;0;0
43136;21607;2162;0;0;0;0;.00nan;0;0
43136;-1;2164;55;30;4;26;.867;3564000;0
43136;-1;2162;46;20;3;17;.850;3600000;0
43136;-1;2164;0;0;0;0;.00nan;0;0
43137;193486;2161;0;0;0;0;.00nan;0;0
43137;179350;4840;98;51;2;49;.961;3600000;0
43137;-1;4840;0;0;0;0;.00nan;0;0
43137;186275;2161;37;17;3;14;.824;3600000;0
43138;21607;2162;73;25;2;23;.920;3600000;0
43138;-1;2164;0;0;0;0;.00nan;0;0
43138;-1;2162;0;0;0;0;.00nan;0;0
43138;-1;2164;83;45;3;42;.933;3596000;0
43139;193486;2161;41;13;3;10;.769;3900000;0
43139;-1;2164;0;0;0;0;.00nan;0;0
43139;186275;2161;0;0;0;0;.00nan;0;0
43139;-1;2164;73;44;3;41;.932;3900000;0
43140;177771;2163;0;0;0;0;.00nan;0;0
43140;179350;4840;78;44;4;40;.909;3664000;0
43140;-1;4840;0;0;0;0;.00nan;0;0
43140;161081;2163;82;42;3;39;.929;3664000;0
43141;193486;2161;0;0;0;0;.00nan;0;0
43141;-1;2164;71;39;4;35;.897;3561000;0
43141;186275;2161;75;33;3;30;.909;3600000;0
43141;-1;2164;0;0;0;0;.00nan;0;0
43142;177771;2163;0;0;0;0;.00nan;0;0
43142;179350;4840;59;27;4;23;.852;3547000;0
43142;-1;4840;0;0;0;0;.00nan;0;0
43142;161081;2163;68;31;3;28;.903;3600000;0
43143;189333;2158;0;0;0;0;.00nan;0;0
43143;-1;2164;44;5;1;4;.800;764000;0
43143;196495;2158;63;9;1;8;.889;3600000;0
43143;-1;2164;50;43;6;37;.860;2836000;0
43144;21607;2162;0;0;0;0;.00nan;0;0
43144;-1;2162;68;32;3;29;.906;3600000;0
43144;179350;4840;82;36;3;33;.917;3573000;0
43144;-1;4840;0;0;0;0;.00nan;0;0
43145;193486;2161;73;29;2;27;.931;3600000;0
43145;177771;2163;0;0;0;0;.00nan;0;0
43145;186275;2161;0;0;0;0;.00nan;0;0
43145;161081;2163;82;36;3;33;.917;3558000;0
43146;189333;2158;95;19;0;19;1.000;3600000;0
43146;-1;2164;75;39;2;37;.949;3535000;0
43146;196495;2158;0;0;0;0;.00nan;0;0
43146;-1;2164;0;0;0;0;.00nan;0;0
43147;21607;2162;72;30;2;28;.933;3600000;0
43147;-1;2162;0;0;0;0;.00nan;0;0
43147;179350;4840;100;38;1;37;.974;3600000;0
43147;-1;4840;0;0;0;0;.00nan;0;0
43148;193486;2161;0;0;0;0;.00nan;0;0
43148;177771;2163;0;0;0;0;.00nan;0;0
43148;186275;2161;94;37;1;36;.973;3600000;0
43148;161081;2163;51;35;6;29;.829;3600000;0
43149;177771;2163;0;0;0;0;.00nan;0;0
43149;189333;2158;0;0;0;0;.00nan;0;0
43149;196495;2158;88;17;0;17;1.000;3600000;0
43149;161081;2163;83;45;4;41;.911;3600000;0
43150;21607;2162;0;0;0;0;.00nan;0;0
43150;-1;2164;73;41;4;37;.902;3600000;0
43150;-1;2162;98;21;0;21;1.000;3600000;0
43150;-1;2164;0;0;0;0;.00nan;0;0
43151;177771;2163;0;0;0;0;.00nan;0;0
43151;189333;2158;69;23;2;21;.913;3715000;0
43151;196495;2158;0;0;0;0;.00nan;0;0
43151;161081;2163;100;34;1;33;.971;3715000;0
43152;21607;2162;0;0;0;0;.00nan;0;0
43152;-1;2164;0;0;0;0;.00nan;0;0
43152;-1;2162;71;32;3;29;.906;3600000;0
43152;-1;2164;55;28;4;24;.857;3575000;0
43153;189333;2158;0;0;0;0;.00nan;0;0
43153;-1;2164;97;61;4;57;.934;3600000;0
43153;196495;2158;60;13;1;12;.923;3600000;0
43153;-1;2164;0;0;0;0;.00nan;0;0
43154;193486;2161;52;26;3;23;.885;3536000;0
43154;21607;2162;0;0;0;0;.00nan;0;0
43154;-1;2162;78;24;1;23;.958;3600000;0
43154;186275;2161;0;0;0;0;.00nan;0;0
43155;177771;2163;0;0;0;0;.00nan;0;0
43155;179350;4840;78;38;3;35;.921;3600000;0
43155;-1;4840;0;0;0;0;.00nan;0;0
43155;161081;2163;52;31;4;27;.871;3546000;0
43156;189333;2158;62;2;0;2;1.000;3600000;0
43156;-1;2164;0;0;0;0;.00nan;0;0
43156;196495;2158;0;0;0;0;.00nan;0;0
43156;-1;2164;82;51;3;48;.941;3600000;0
43157;193486;2161;0;0;0;0;.00nan;0;0
43157;21607;2162;75;17;0;17;1.000;1385000;0
43157;-1;2162;35;28;6;22;.786;2215000;0
43157;186275;2161;65;26;2;24;.923;3600000;0
43158;177771;2163;0;0;0;0;.00nan;0;0
43158;179350;4840;0;0;0;0;.00nan;0;0
43158;-1;4840;64;27;3;24;.889;3600000;0
43158;161081;2163;61;27;4;23;.852;3550000;0
43159;193486;2161;39;33;6;27;.818;3600000;0
43159;-1;2164;45;41;7;34;.829;3600000;0
43159;186275;2161;0;0;0;0;.00nan;0;0
43159;-1;2164;0;0;0;0;.00nan;0;0
43160;189333;2158;67;24;2;22;.917;3600000;0
43160;179350;4840;86;51;5;46;.902;3600000;0
43160;-1;4840;0;0;0;0;.00nan;0;0
43160;196495;2158;0;0;0;0;.00nan;0;0
43161;177771;2163;0;0;0;0;.00nan;0;0
43161;21607;2162;0;0;0;0;.00nan;0;0
43161;-1;2162;45;28;5;23;.821;3804000;0
43161;161081;2163;81;46;4;42;.913;3804000;0
43162;193486;2161;0;0;0;0;.00nan;0;0
43162;-1;2164;0;0;0;0;.00nan;0;0
43162;186275;2161;90;38;2;36;.947;3600000;0
43162;-1;2164;61;25;3;22;.880;3570000;0
43163;189333;2158;0;0;0;0;.00nan;0;0
43163;179350;4840;29;16;4;12;.750;569000;0
43163;-1;4840;98;52;2;50;.962;3031000;0
43163;196495;2158;58;13;1;12;.923;3600000;0
43164;177771;2163;0;0;0;0;.00nan;0;0
43164;21607;2162;100;30;0;30;1.000;3600000;0
43164;-1;2162;0;0;0;0;.00nan;0;0
43164;161081;2163;72;19;1;18;.947;3544000;0
43165;-1;2164;85;34;2;32;.941;3600000;0
43165;179350;4840;78;21;1;20;.952;3600000;0
43165;-1;4840;0;0;0;0;.00nan;0;0
43165;-1;2164;0;0;0;0;.00nan;0;0
43166;193486;2161;66;23;2;21;.913;3600000;0
43166;177771;2163;47;28;4;24;.857;2519000;0
43166;186275;2161;0;0;0;0;.00nan;0;0
43166;161081;2163;37;21;4;17;.810;1081000;0
43167;189333;2158;43;16;4;12;.750;3900000;0
43167;21607;2162;95;56;4;52;.929;3900000;0
43167;-1;2162;0;0;0;0;.00nan;0;0
43167;196495;2158;0;0;0;0;.00nan;0;0
43168;-1;2164;0;0;0;0;.00nan;0;0
43168;179350;4840;73;25;2;23;.920;3600000;0
43168;-1;4840;0;0;0;0;.00nan;0;0
43168;-1;2164;77;37;3;34;.919;3600000;0
43169;193486;2161;0;0;0;0;.00nan;0;0
43169;177771;2163;0;0;0;0;.00nan;0;0
43169;186275;2161;88;34;1;33;.971;3600000;0
43169;161081;2163;87;43;3;40;.930;3600000;0
43170;189333;2158;0;0;0;0;.00nan;0;0
43170;21607;2162;0;0;0;0;.00nan;0;0
43170;-1;2162;100;43;0;43;1.000;3600000;0
43170;196495;2158;68;19;1;18;.947;3558000;0
43171;193486;2161;70;23;2;21;.913;3600000;0
43171;-1;2164;98;47;3;44;.936;3568000;0
43171;186275;2161;0;0;0;0;.00nan;0;0
43171;-1;2164;0;0;0;0;.00nan;0;0
43172;189333;2158;79;25;1;24;.960;3600000;0
43172;21607;2162;0;0;0;0;.00nan;0;0
43172;-1;2162;71;42;4;38;.905;3600000;0
43172;196495;2158;0;0;0;0;.00nan;0;0
43173;177771;2163;89;33;1;32;.970;3600000;0
43173;179350;4840;66;33;3;30;.909;3524000;0
43173;-1;4840;0;0;0;0;.00nan;0;0
43173;161081;2163;0;0;0;0;.00nan;0;0
43174;193486;2161;0;0;0;0;.00nan;0;0
43174;-1;2164;0;0;0;0;.00nan;0;0
43174;186275;2161;72;26;1;25;.962;3600000;0
43174;-1;2164;79;46;4;42;.913;3600000;0
43175;189333;2158;0;0;0;0;.00nan;0;0
43175;21607;2162;98;50;1;49;.980;3588000;0
43175;-1;2162;0;0;0;0;.00nan;0;0
43175;196495;2158;77;12;0;12;1.000;3600000;0
43176;177771;2163;0;0;0;0;.00nan;0;0
43176;179350;4840;65;37;4;33;.892;3600000;0
43176;-1;4840;0;0;0;0;.00nan;0;0
43176;161081;2163;80;26;1;25;.962;3600000;0
43177;193486;2161;42;35;6;29;.829;1563000;0
43177;189333;2158;0;0;0;0;.00nan;0;0
43177;196495;2158;86;13;0;13;1.000;3600000;0
43177;186275;2161;52;32;4;28;.875;2037000;0
43178;21607;2162;0;0;0;0;.00nan;0;0
43178;-1;2162;63;22;2;20;.909;3632000;0
43178;179350;4840;65;29;3;26;.897;3632000;0
43178;-1;4840;0;0;0;0;.00nan;0;0
43179;177771;2163;0;0;0;0;.00nan;0;0
43179;-1;2164;66;40;4;36;.900;3600000;0
43179;-1;2164;0;0;0;0;.00nan;0;0
43179;161081;2163;76;24;1;23;.958;3600000;0
43180;193486;2161;30;32;6;26;.813;1952000;0
43180;189333;2158;0;0;0;0;.00nan;0;0
43180;196495;2158;30;16;4;12;.750;3600000;0
43180;186275;2161;52;22;3;19;.864;1648000;0
43181;21607;2162;0;0;0;0;.00nan;0;0
43181;-1;2162;80;36;3;33;.917;3600000;0
43181;179350;4840;0;0;0;0;.00nan;0;0
43181;-1;4840;97;21;0;21;1.000;3600000;0
43182;177771;2163;0;0;0;0;.00nan;0;0
43182;-1;2164;0;0;0;0;.00nan;0;0
43182;-1;2164;96;60;2;58;.967;3900000;0
43182;161081;2163;65;24;2;22;.917;3900000;0
43183;189333;2158;61;13;1;12;.923;3600000;0
43183;-1;2164;95;52;3;49;.942;3552000;0
43183;196495;2158;0;0;0;0;.00nan;0;0
43183;-1;2164;0;0;0;0;.00nan;0;0
43184;193486;2161;0;0;0;0;.00nan;0;0
43184;179350;4840;0;0;0;0;.00nan;0;0
43184;-1;4840;84;32;2;30;.938;3878000;0
43184;186275;2161;85;28;2;26;.929;3900000;0
43185;189333;2158;0;0;0;0;.00nan;0;0
43185;-1;2164;0;0;0;0;.00nan;0;0
43185;196495;2158;63;11;1;10;.909;3600000;0
43185;-1;2164;84;50;3;47;.940;3600000;0
43186;193486;2161;75;23;2;21;.913;3600000;0
43186;179350;4840;70;49;5;44;.898;3600000;0
43186;-1;4840;0;0;0;0;.00nan;0;0
43186;186275;2161;0;0;0;0;.00nan;0;0
43187;177771;2163;0;0;0;0;.00nan;0;0
43187;-1;2164;82;44;3;41;.932;3600000;0
43187;-1;2164;0;0;0;0;.00nan;0;0
43187;161081;2163;64;23;2;21;.913;3600000;0
43188;189333;2158;0;0;0;0;.00nan;0;0
43188;179350;4840;93;49;3;46;.939;3600000;0
43188;-1;4840;0;0;0;0;.00nan;0;0
43188;196495;2158;90;18;0;18;1.000;3600000;0
43189;193486;2161;65;29;3;26;.897;3900000;0
43189;21607;2162;0;0;0;0;.00nan;0;0
43189;-1;2162;87;40;3;37;.925;3900000;0
43189;186275;2161;0;0;0;0;.00nan;0;0
43190;177771;2163;0;0;0;0;.00nan;0;0
43190;-1;2164;0;0;0;0;.00nan;0;0
43190;-1;2164;76;36;3;33;.917;3597000;0
43190;161081;2163;68;27;2;25;.926;3600000;0
43191;189333;2158;0;0;0;0;.00nan;0;0
43191;179350;4840;83;52;4;48;.923;3600000;0
43191;-1;4840;0;0;0;0;.00nan;0;0
43191;196495;2158;95;18;0;18;1.000;3600000;0
43192;193486;2161;0;0;0;0;.00nan;0;0
43192;21607;2162;82;32;1;31;.969;3600000;0
43192;-1;2162;0;0;0;0;.00nan;0;0
43192;186275;2161;56;26;3;23;.885;3552000;0
43193;193486;2161;68;56;6;50;.893;3600000;0
43193;189333;2158;0;0;0;0;.00nan;0;0
43193;196495;2158;84;14;0;14;1.000;3600000;0
43193;186275;2161;0;0;0;0;.00nan;0;0
43194;-1;2164;63;35;4;31;.886;3563000;0
43194;179350;4840;90;38;2;36;.947;3600000;0
43194;-1;4840;0;0;0;0;.00nan;0;0
43194;-1;2164;0;0;0;0;.00nan;0;0
43195;177771;2163;0;0;0;0;.00nan;0;0
43195;21607;2162;0;0;0;0;.00nan;0;0
43195;-1;2162;50;41;6;35;.854;3600000;0
43195;161081;2163;96;22;0;22;1.000;3600000;0
43196;193486;2161;73;27;1;26;.963;1660000;0
43196;189333;2158;0;0;0;0;.00nan;0;0
43196;196495;2158;77;21;1;20;.952;3600000;0
43196;186275;2161;33;28;5;23;.821;1940000;0
43197;-1;2164;0;0;0;0;.00nan;0;0
43197;179350;4840;61;23;3;20;.870;3600000;0
43197;-1;4840;0;0;0;0;.00nan;0;0
43197;-1;2164;61;36;4;32;.889;3594000;0
43198;177771;2163;0;0;0;0;.00nan;0;0
43198;21607;2162;0;0;0;0;.00nan;0;0
43198;-1;2162;68;57;5;52;.912;3600000;0
43198;161081;2163;76;18;1;17;.944;3600000;0
43199;21607;2162;0;0;0;0;.00nan;0;0
43199;-1;2164;44;24;4;20;.833;3693000;0
43199;-1;2162;60;38;5;33;.868;3693000;0
43199;-1;2164;0;0;0;0;.00nan;0;0
43200;193486;2161;80;28;2;26;.929;3600000;0
43200;179350;4840;66;32;4;28;.875;3547000;0
43200;-1;4840;0;0;0;0;.00nan;0;0
43200;186275;2161;0;0;0;0;.00nan;0;0
43201;177771;2163;0;0;0;0;.00nan;0;0
43201;189333;2158;71;21;2;19;.905;3600000;0
43201;196495;2158;0;0;0;0;.00nan;0;0
43201;161081;2163;74;57;6;51;.895;3600000;0
43202;21607;2162;70;27;2;25;.926;3600000;0
43202;-1;2164;62;43;5;38;.884;3600000;0
43202;-1;2162;0;0;0;0;.00nan;0;0
43202;-1;2164;0;0;0;0;.00nan;0;0
43203;193486;2161;0;0;0;0;.00nan;0;0
43203;179350;4840;100;44;2;42;.955;3600000;0
43203;-1;4840;0;0;0;0;.00nan;0;0
43203;186275;2161;64;29;3;26;.897;3600000;0
43204;177771;2163;21;12;4;8;.667;336000;0
43204;189333;2158;0;0;0;0;.00nan;0;0
43204;196495;2158;64;21;2;19;.905;3600000;0
43204;161081;2163;92;68;6;62;.912;3264000;0
43206;-1;2164;99;30;1;29;.967;3600000;0
43206;179350;4840;69;40;4;36;.900;3600000;0
43206;-1;4840;0;0;0;0;.00nan;0;0
43206;-1;2164;0;0;0;0;.00nan;0;0
43208;189333;2158;57;28;3;25;.893;3600000;0
43208;21607;2162;0;0;0;0;.00nan;0;0
43208;-1;2162;35;30;5;25;.833;3591000;0
43208;196495;2158;0;0;0;0;.00nan;0;0
43210;193486;2161;0;0;0;0;.00nan;0;0
43210;177771;2163;0;0;0;0;.00nan;0;0
43210;186275;2161;52;33;4;29;.879;3600000;0
43210;161081;2163;100;36;0;36;1.000;3600000;0
43212;189333;2158;0;0;0;0;.00nan;0;0
43212;21607;2162;70;46;3;43;.935;3600000;0
43212;-1;2162;0;0;0;0;.00nan;0;0
43212;196495;2158;80;12;0;12;1.000;3600000;0
43214;193486;2161;68;20;2;18;.900;3600000;0
43214;179350;4840;0;0;0;0;.00nan;0;0
43214;-1;4840;73;44;5;39;.886;3600000;0
43214;186275;2161;0;0;0;0;.00nan;0;0
43216;177771;2163;0;0;0;0;.00nan;0;0
43216;-1;2164;0;0;0;0;.00nan;0;0
43216;-1;2164;84;54;4;50;.926;3587000;0
43216;161081;2163;62;24;3;21;.875;3600000;0
43218;193486;2161;94;22;0;22;1.000;3600000;0
43218;177771;2163;97;45;3;42;.933;3600000;0
43218;186275;2161;0;0;0;0;.00nan;0;0
43218;161081;2163;0;0;0;0;.00nan;0;0
43220;21607;2162;0;0;0;0;.00nan;0;0
43220;-1;2162;88;35;1;34;.971;3600000;0
43220;179350;4840;86;44;3;41;.932;3554000;0
43220;-1;4840;0;0;0;0;.00nan;0;0
43222;189333;2158;0;0;0;0;.00nan;0;0
43222;-1;2164;98;68;2;66;.971;3566000;0
43222;196495;2158;76;7;0;7;1.000;3600000;0
43222;-1;2164;0;0;0;0;.00nan;0;0
43224;193486;2161;48;13;2;11;.846;3600000;0
43224;-1;2164;0;0;0;0;.00nan;0;0
43224;186275;2161;0;0;0;0;.00nan;0;0
43224;-1;2164;94;54;3;51;.944;3600000;0
43226;177771;2163;0;0;0;0;.00nan;0;0
43226;21607;2162;54;4;0;4;1.000;298000;0
43226;-1;2162;16;23;6;17;.739;3302000;0
43226;161081;2163;72;34;3;31;.912;3600000;0
43228;189333;2158;0;0;0;0;.00nan;0;0
43228;179350;4840;0;0;0;0;.00nan;0;0
43228;-1;4840;97;51;2;49;.961;3600000;0
43228;196495;2158;72;9;0;9;1.000;3600000;0
43230;193486;2161;0;0;0;0;.00nan;0;0
43230;21607;2162;0;0;0;0;.00nan;0;0
43230;-1;2162;68;31;2;29;.935;3600000;0
43230;186275;2161;83;16;0;16;1.000;3600000;0
43232;189333;2158;0;0;0;0;.00nan;0;0
43232;-1;2164;69;44;4;40;.909;3600000;0
43232;196495;2158;63;15;1;14;.933;3600000;0
43232;-1;2164;0;0;0;0;.00nan;0;0
43234;177771;2163;0;0;0;0;.00nan;0;0
43234;179350;4840;68;27;2;25;.926;3600000;0
43234;-1;4840;0;0;0;0;.00nan;0;0
43234;161081;2163;38;37;6;31;.838;3600000;0
43236;193486;2161;0;0;0;0;.00nan;0;0
43236;-1;2164;69;13;0;13;1.000;1338000;0
43236;186275;2161;49;15;2;13;.867;3600000;0
43236;-1;2164;55;41;6;35;.854;2262000;0
43238;177771;2163;64;50;6;44;.880;3600000;0
43238;189333;2158;23;17;5;12;.706;3600000;0
43238;196495;2158;0;0;0;0;.00nan;0;0
43238;161081;2163;0;0;0;0;.00nan;0;0
43240;21607;2162;29;32;6;26;.813;2535000;0
43240;-1;2162;23;12;4;8;.667;1065000;0
43240;179350;4840;0;0;0;0;.00nan;0;0
43240;-1;4840;96;29;1;28;.966;3600000;0
1791;189333;2158;0;0;0;0;.00nan;0;0
1791;21607;2162;44;11;2;9;.818;599000;0
1791;-1;2162;63;55;7;48;.873;3001000;0
1791;196495;2158;87;11;0;11;1.000;3600000;0
1792;193486;2161;68;41;5;36;.878;3600000;0
1792;177771;2163;0;0;0;0;.00nan;0;0
1792;186275;2161;0;0;0;0;.00nan;0;0
1792;161081;2163;99;45;2;43;.956;3600000;0
1793;189333;2158;0;0;0;0;.00nan;0;0
1793;21607;2162;0;0;0;0;.00nan;0;0
1793;-1;2162;90;58;4;54;.931;3600000;0
1793;196495;2158;78;10;0;10;1.000;3600000;0
1794;193486;2161;70;45;3;42;.933;4618000;0
1794;177771;2163;0;0;0;0;.00nan;0;0
1794;186275;2161;0;0;0;0;.00nan;0;0
1794;161081;2163;85;49;4;45;.918;4618000;0
1959;193486;2161;47;31;4;27;.871;3600000;0
1959;177771;2163;0;0;0;0;.00nan;0;0
1959;186275;2161;0;0;0;0;.00nan;0;0
1959;161081;2163;91;51;3;48;.941;3593000;0
1986;177771;2163;0;0;0;0;.00nan;0;0
1986;189333;2158;0;0;0;0;.00nan;0;0
1986;196495;2158;90;15;0;15;1.000;3600000;0
1986;161081;2163;69;47;5;42;.894;3600000;0
1987;177771;2163;0;0;0;0;.00nan;0;0
1987;189333;2158;0;0;0;0;.00nan;0;0
1987;196495;2158;91;13;0;13;1.000;3600000;0
1987;161081;2163;98;62;4;58;.935;3600000;0
1988;177771;2163;58;6;0;6;1.000;439000;0
1988;189333;2158;0;0;0;0;.00nan;0;0
1988;196495;2158;76;21;1;20;.952;3600000;0
1988;161081;2163;73;49;5;44;.898;3161000;0
43241;168021;3798;76;32;3;29;.906;3900000;0
43241;183730;3800;0;0;0;0;.00nan;0;0
43241;-1;3798;0;0;0;0;.00nan;0;0
43241;57390;3800;59;26;3;23;.885;3900000;0
43242;196456;3795;92;17;0;17;1.000;3600000;0
43242;57152;3797;0;0;0;0;.00nan;0;0
43242;59231;3797;97;39;1;38;.974;3568000;0
43242;85709;3795;0;0;0;0;.00nan;0;0
43243;183730;3800;0;0;0;0;.00nan;0;0
43243;175530;3796;0;0;0;0;.00nan;0;0
43243;191574;3796;44;20;3;17;.850;3600000;0
43243;57390;3800;74;42;4;38;.905;3550000;0
43244;168021;3798;83;34;2;32;.941;3600000;0
43244;-1;3798;0;0;0;0;.00nan;0;0
43244;-1;4635;0;0;0;0;.00nan;0;0
43244;91413;4635;59;37;4;33;.892;3523000;0
43245;-1;4635;0;0;0;0;.00nan;0;0
43245;57152;3797;0;0;0;0;.00nan;0;0
43245;59231;3797;51;33;5;28;.848;3600000;0
43245;91413;4635;99;39;1;38;.974;3600000;0
43246;196456;3795;0;0;0;0;.00nan;0;0
43246;191574;3796;0;0;0;0;.00nan;0;0
43246;64736;3796;84;50;4;46;.920;3857000;0
43246;85709;3795;61;28;3;25;.893;3857000;0
43247;183730;3800;0;0;0;0;.00nan;0;0
43247;57152;3797;31;13;4;9;.692;1133000;0
43247;57390;3800;40;19;4;15;.789;3600000;0
43247;59231;3797;80;35;3;32;.914;2467000;0
43248;-1;3798;67;28;2;26;.929;3600000;0
43248;-1;4635;0;0;0;0;.00nan;0;0
43248;91413;4635;68;34;3;31;.912;3600000;0
43248;94615;3798;0;0;0;0;.00nan;0;0
43249;-1;4635;69;39;3;36;.923;3600000;0
43249;191574;3796;50;28;4;24;.857;3600000;0
43249;64736;3796;0;0;0;0;.00nan;0;0
43249;91413;4635;0;0;0;0;.00nan;0;0
43250;-1;3798;0;0;0;0;.00nan;0;0
43250;196456;3795;0;0;0;0;.00nan;0;0
43250;85709;3795;46;28;4;24;.857;3600000;0
43250;94615;3798;100;39;1;38;.974;3600000;0
43251;183730;3800;0;0;0;0;.00nan;0;0
43251;57152;3797;0;0;0;0;.00nan;0;0
43251;57390;3800;69;22;2;20;.909;3600000;0
43251;59231;3797;52;26;4;22;.846;3600000;0
43252;196456;3795;0;0;0;0;.00nan;0;0
43252;-1;4635;0;0;0;0;.00nan;0;0
43252;85709;3795;54;24;3;21;.875;3583000;0
43252;91413;4635;96;40;1;39;.975;3600000;0
43253;-1;3798;0;0;0;0;.00nan;0;0
43253;191574;3796;73;26;2;24;.923;3600000;0
43253;64736;3796;0;0;0;0;.00nan;0;0
43253;94615;3798;67;37;4;33;.892;3530000;0
43254;196456;3795;96;34;1;33;.971;3600000;0
43254;57152;3797;72;37;4;33;.892;3600000;0
43254;59231;3797;0;0;0;0;.00nan;0;0
43254;85709;3795;0;0;0;0;.00nan;0;0
43255;-1;3798;0;0;0;0;.00nan;0;0
43255;191574;3796;0;0;0;0;.00nan;0;0
43255;64736;3796;39;28;5;23;.821;3900000;0
43255;94615;3798;56;38;5;33;.868;3900000;0
43256;183730;3800;100;30;0;30;1.000;3600000;0
43256;-1;4635;61;21;3;18;.857;3600000;0
43256;57390;3800;0;0;0;0;.00nan;0;0
43256;91413;4635;0;0;0;0;.00nan;0;0
43257;-1;3798;0;0;0;0;.00nan;0;0
43257;57152;3797;0;0;0;0;.00nan;0;0
43257;59231;3797;80;41;4;37;.902;3693000;0
43257;94615;3798;59;26;3;23;.885;3678000;0
43258;196456;3795;0;0;0;0;.00nan;0;0
43258;-1;4635;0;0;0;0;.00nan;0;0
43258;85709;3795;99;24;0;24;1.000;3600000;0
43258;91413;4635;98;38;1;37;.974;3557000;0
43259;183730;3800;59;30;4;26;.867;3600000;0
43259;191574;3796;32;21;5;16;.762;3545000;0
43259;57390;3800;0;0;0;0;.00nan;0;0
43259;64736;3796;0;0;0;0;.00nan;0;0
43260;-1;3798;100;30;0;30;1.000;3600000;0
43260;191574;3796;0;0;0;0;.00nan;0;0
43260;64736;3796;60;35;4;31;.886;3600000;0
43260;94615;3798;0;0;0;0;.00nan;0;0
43261;191574;3796;40;32;6;26;.813;3290000;0
43261;57152;3797;0;0;0;0;.00nan;0;0
43261;59231;3797;74;27;2;25;.926;3600000;0
43261;64736;3796;48;0;0;0;.00nan;310000;0
43262;183730;3800;0;0;0;0;.00nan;0;0
43262;-1;4635;53;2;0;2;1.000;260000;0
43262;57390;3800;93;41;2;39;.951;3600000;0
43262;91413;4635;19;34;7;27;.794;3340000;0
43263;-1;3798;79;37;4;33;.892;3600000;0
43263;196456;3795;0;0;0;0;.00nan;0;0
43263;85709;3795;72;27;3;24;.889;3600000;0
43263;94615;3798;0;0;0;0;.00nan;0;0
43264;196456;3795;57;19;2;17;.895;3600000;0
43264;57152;3797;76;51;4;47;.922;3563000;0
43264;59231;3797;0;0;0;0;.00nan;0;0
43264;85709;3795;0;0;0;0;.00nan;0;0
43265;-1;4635;0;0;0;0;.00nan;0;0
43265;57152;3797;0;0;0;0;.00nan;0;0
43265;59231;3797;54;30;5;25;.833;3559000;0
43265;91413;4635;70;39;3;36;.923;3600000;0
43266;196456;3795;72;37;3;34;.919;3600000;0
43266;191574;3796;0;0;0;0;.00nan;0;0
43266;64736;3796;42;48;8;40;.833;3600000;0
43266;85709;3795;0;0;0;0;.00nan;0;0
43267;183730;3800;43;29;5;24;.828;3534000;0
43267;-1;3798;0;0;0;0;.00nan;0;0
43267;57390;3800;0;0;0;0;.00nan;0;0
43267;94615;3798;93;45;4;41;.911;3600000;0
43268;-1;4635;36;36;6;30;.833;3600000;0
43268;191574;3796;92;27;1;26;.963;3600000;0
43268;64736;3796;0;0;0;0;.00nan;0;0
43268;91413;4635;0;0;0;0;.00nan;0;0
43269;183730;3800;0;0;0;0;.00nan;0;0
43269;196456;3795;0;0;0;0;.00nan;0;0
43269;57390;3800;86;40;3;37;.925;3574000;0
43269;85709;3795;66;25;2;23;.920;3600000;0
43270;-1;3798;0;0;0;0;.00nan;0;0
43270;57152;3797;64;23;2;21;.913;1948000;0
43270;59231;3797;28;29;6;23;.793;1652000;0
43270;94615;3798;70;24;2;22;.917;3600000;0
43271;-1;3798;0;0;0;0;.00nan;0;0
43271;191574;3796;0;0;0;0;.00nan;0;0
43271;64736;3796;97;24;0;24;1.000;3600000;0
43271;94615;3798;54;38;6;32;.842;3600000;0
43272;-1;4635;0;0;0;0;.00nan;0;0
43272;57152;3797;0;0;0;0;.00nan;0;0
43272;59231;3797;49;43;6;37;.860;3582000;0
43272;91413;4635;56;28;4;24;.857;3600000;0
43273;191574;3796;71;43;4;39;.907;3600000;0
43273;57152;3797;100;34;0;34;1.000;3600000;0
43273;59231;3797;0;0;0;0;.00nan;0;0
43273;64736;3796;0;0;0;0;.00nan;0;0
43274;183730;3800;0;0;0;0;.00nan;0;0
43274;196456;3795;56;30;4;26;.867;3668000;0
43274;57390;3800;78;32;3;29;.906;3668000;0
43274;85709;3795;0;0;0;0;.00nan;0;0
43275;-1;3798;0;0;0;0;.00nan;0;0
43275;-1;4635;0;0;0;0;.00nan;0;0
43275;91413;4635;40;30;5;25;.833;3531000;0
43275;94615;3798;83;39;3;36;.923;3600000;0
43276;196456;3795;36;24;5;19;.792;3600000;0
43276;57152;3797;55;29;4;25;.862;3600000;0
43276;59231;3797;0;0;0;0;.00nan;0;0
43276;85709;3795;0;0;0;0;.00nan;0;0
43277;-1;3798;0;0;0;0;.00nan;0;0
43277;191574;3796;0;0;0;0;.00nan;0;0
43277;64736;3796;60;41;5;36;.878;3600000;0
43277;94615;3798;71;26;2;24;.923;3600000;0
43278;196456;3795;79;22;1;21;.955;3600000;0
43278;-1;4635;0;0;0;0;.00nan;0;0
43278;85709;3795;0;0;0;0;.00nan;0;0
43278;91413;4635;61;35;4;31;.886;3600000;0
43279;183730;3800;0;0;0;0;.00nan;0;0
43279;57152;3797;64;40;5;35;.875;3600000;0
43279;57390;3800;72;33;2;31;.939;3600000;0
43279;59231;3797;0;0;0;0;.00nan;0;0
43280;-1;4635;64;34;3;31;.912;3600000;0
43280;191574;3796;24;33;7;26;.788;3600000;0
43280;64736;3796;0;0;0;0;.00nan;0;0
43280;91413;4635;0;0;0;0;.00nan;0;0
43281;183730;3800;18;22;6;16;.727;2565000;0
43281;196456;3795;49;19;3;16;.842;3600000;0
43281;57390;3800;51;14;2;12;.857;1035000;0
43281;85709;3795;0;0;0;0;.00nan;0;0
43282;191574;3796;0;0;0;0;.00nan;0;0
43282;57152;3797;75;44;4;40;.909;3600000;0
43282;59231;3797;0;0;0;0;.00nan;0;0
43282;64736;3796;67;33;3;30;.909;3600000;0
43283;-1;3798;0;0;0;0;.00nan;0;0
43283;196456;3795;0;0;0;0;.00nan;0;0
43283;85709;3795;85;33;2;31;.939;3600000;0
43283;94615;3798;48;21;3;18;.857;3549000;0
43284;183730;3800;0;0;0;0;.00nan;0;0
43284;-1;4635;0;0;0;0;.00nan;0;0
43284;57390;3800;59;31;4;27;.871;3555000;0
43284;91413;4635;77;28;2;26;.929;3600000;0
43285;183730;3800;76;23;1;22;.957;3559000;0
43285;-1;3798;0;0;0;0;.00nan;0;0
43285;57390;3800;23;4;3;1;.250;337000;0
43285;94615;3798;56;28;4;24;.857;3900000;0
43286;183730;3800;0;0;0;0;.00nan;0;0
43286;191574;3796;59;31;4;27;.871;3600000;0
43286;57390;3800;88;29;1;28;.966;3600000;0
43286;64736;3796;0;0;0;0;.00nan;0;0
43287;-1;3798;0;0;0;0;.00nan;0;0
43287;57152;3797;0;0;0;0;.00nan;0;0
43287;59231;3797;87;37;3;34;.919;3600000;0
43287;94615;3798;84;27;1;26;.963;3600000;0
43288;196456;3795;42;40;6;34;.850;3600000;0
43288;-1;4635;0;0;0;0;.00nan;0;0
43288;85709;3795;0;0;0;0;.00nan;0;0
43288;91413;4635;98;34;1;33;.971;3600000;0
43289;196456;3795;0;0;0;0;.00nan;0;0
43289;57152;3797;25;23;6;17;.739;1934000;0
43289;59231;3797;33;13;3;10;.769;1666000;0
43289;85709;3795;53;19;2;17;.895;3600000;0
43290;-1;4635;66;35;4;31;.886;3600000;0
43290;191574;3796;0;0;0;0;.00nan;0;0
43290;64736;3796;50;37;6;31;.838;3557000;0
43290;91413;4635;0;0;0;0;.00nan;0;0
43291;-1;4635;0;0;0;0;.00nan;0;0
43291;57152;3797;0;0;0;0;.00nan;0;0
43291;59231;3797;63;33;4;29;.879;3569000;0
43291;91413;4635;73;31;2;29;.935;3600000;0
43292;196456;3795;0;0;0;0;.00nan;0;0
43292;191574;3796;88;40;3;37;.925;3569000;0
43292;64736;3796;0;0;0;0;.00nan;0;0
43292;85709;3795;67;12;1;11;.917;3600000;0
43293;183730;3800;62;37;5;32;.865;3600000;0
43293;-1;3798;0;0;0;0;.00nan;0;0
43293;57390;3800;0;0;0;0;.00nan;0;0
43293;94615;3798;54;20;3;17;.850;3600000;0
43294;183730;3800;0;0;0;0;.00nan;0;0
43294;57152;3797;82;33;3;30;.909;3600000;0
43294;57390;3800;67;22;2;20;.909;3600000;0
43294;59231;3797;0;0;0;0;.00nan;0;0
43295;-1;4635;49;30;4;26;.867;3552000;0
43295;191574;3796;0;0;0;0;.00nan;0;0
43295;64736;3796;82;38;3;35;.921;3600000;0
43295;91413;4635;0;0;0;0;.00nan;0;0
43296;196456;3795;0;0;0;0;.00nan;0;0
43296;191574;3796;92;47;2;45;.957;3900000;0
43296;64736;3796;0;0;0;0;.00nan;0;0
43296;85709;3795;71;25;2;23;.920;3900000;0
43297;183730;3800;0;0;0;0;.00nan;0;0
43297;-1;4635;0;0;0;0;.00nan;0;0
43297;57390;3800;78;37;3;34;.919;3731000;0
43297;91413;4635;68;27;2;25;.926;3731000;0
43298;-1;3798;0;0;0;0;.00nan;0;0
43298;57152;3797;0;0;0;0;.00nan;0;0
43298;59231;3797;53;38;5;33;.868;3548000;0
43298;94615;3798;46;27;4;23;.852;3600000;0
43299;-1;4635;0;0;0;0;.00nan;0;0
43299;57152;3797;0;0;0;0;.00nan;0;0
43299;59231;3797;68;28;3;25;.893;3600000;0
43299;91413;4635;64;38;4;34;.895;3574000;0
43300;183730;3800;0;0;0;0;.00nan;0;0
43300;-1;3798;0;0;0;0;.00nan;0;0
43300;57390;3800;55;25;3;22;.880;3518000;0
43300;94615;3798;95;35;1;34;.971;3600000;0
43301;191574;3796;100;24;0;24;1.000;3600000;0
43301;57152;3797;0;0;0;0;.00nan;0;0
43301;59231;3797;97;38;1;37;.974;3566000;0
43301;64736;3796;0;0;0;0;.00nan;0;0
43302;183730;3800;47;13;2;11;.846;979000;0
43302;196456;3795;0;0;0;0;.00nan;0;0
43302;57390;3800;1;17;8;9;.529;2621000;0
43302;85709;3795;73;29;2;27;.931;3600000;0
43303;-1;3798;0;0;0;0;.00nan;0;0
43303;-1;4635;0;0;0;0;.00nan;0;0
43303;91413;4635;56;31;4;27;.871;3600000;0
43303;94615;3798;81;30;1;29;.967;3600000;0
43304;196456;3795;0;0;0;0;.00nan;0;0
43304;-1;4635;80;38;3;35;.921;3600000;0
43304;85709;3795;52;25;4;21;.840;3551000;0
43304;91413;4635;0;0;0;0;.00nan;0;0
43305;196456;3795;70;25;2;23;.920;3600000;0
43305;191574;3796;15;21;6;15;.714;2841000;0
43305;64736;3796;44;5;1;4;.800;759000;0
43305;85709;3795;0;0;0;0;.00nan;0;0
43306;183730;3800;0;0;0;0;.00nan;0;0
43306;-1;3798;0;0;0;0;.00nan;0;0
43306;57390;3800;100;56;1;55;.982;3779000;0
43306;94615;3798;76;30;2;28;.933;3779000;0
43307;-1;4635;53;2;0;2;1.000;377000;0
43307;57152;3797;53;27;4;23;.852;3600000;0
43307;59231;3797;0;0;0;0;.00nan;0;0
43307;91413;4635;36;31;6;25;.806;3212000;0
43308;183730;3800;35;39;7;32;.821;3600000;0
43308;196456;3795;0;0;0;0;.00nan;0;0
43308;57390;3800;0;0;0;0;.00nan;0;0
43308;85709;3795;69;16;1;15;.938;3600000;0
43309;-1;4635;0;0;0;0;.00nan;0;0
43309;57152;3797;99;42;2;40;.952;3600000;0
43309;59231;3797;0;0;0;0;.00nan;0;0
43309;91413;4635;53;32;5;27;.844;3600000;0
43310;183730;3800;0;0;0;0;.00nan;0;0
43310;191574;3796;0;0;0;0;.00nan;0;0
43310;57390;3800;56;29;3;26;.897;3600000;0
43310;64736;3796;78;23;1;22;.957;3600000;0
43311;-1;3798;0;0;0;0;.00nan;0;0
43311;196456;3795;67;31;3;28;.903;3600000;0
43311;85709;3795;0;0;0;0;.00nan;0;0
43311;94615;3798;54;29;4;25;.862;3600000;0
43312;191574;3796;0;0;0;0;.00nan;0;0
43312;57152;3797;0;0;0;0;.00nan;0;0
43312;59231;3797;53;25;4;21;.840;3837000;0
43312;64736;3796;99;44;3;41;.932;3837000;0
43313;-1;3798;82;40;2;38;.950;3007000;0
43313;196456;3795;0;0;0;0;.00nan;0;0
43313;85709;3795;38;36;7;29;.806;3572000;0
43313;94615;3798;19;6;4;2;.333;593000;0
43314;183730;3800;51;4;0;4;1.000;501000;0
43314;-1;4635;0;0;0;0;.00nan;0;0
43314;57390;3800;34;35;7;28;.800;3099000;0
43314;91413;4635;96;24;0;24;1.000;3600000;0
43315;-1;4635;0;0;0;0;.00nan;0;0
43315;191574;3796;45;36;5;31;.861;3600000;0
43315;64736;3796;0;0;0;0;.00nan;0;0
43315;91413;4635;86;33;2;31;.939;3600000;0
43316;183730;3800;21;24;6;18;.750;2751000;0
43316;196456;3795;49;24;4;20;.833;3600000;0
43316;57390;3800;53;4;0;4;1.000;846000;0
43316;85709;3795;0;0;0;0;.00nan;0;0
43317;-1;3798;64;22;2;20;.909;3600000;0
43317;57152;3797;37;41;7;34;.829;3600000;0
43317;59231;3797;0;0;0;0;.00nan;0;0
43317;94615;3798;0;0;0;0;.00nan;0;0
43318;183730;3800;0;0;0;0;.00nan;0;0
43318;-1;3798;0;0;0;0;.00nan;0;0
43318;57390;3800;81;34;2;32;.941;3600000;0
43318;94615;3798;33;24;5;19;.792;3600000;0
43319;-1;3798;91;35;2;33;.943;3600000;0
43319;191574;3796;0;0;0;0;.00nan;0;0
43319;64736;3796;67;34;4;30;.882;3600000;0
43319;94615;3798;0;0;0;0;.00nan;0;0
43320;196456;3795;0;0;0;0;.00nan;0;0
43320;-1;4635;0;0;0;0;.00nan;0;0
43320;85709;3795;58;28;4;24;.857;3600000;0
43320;91413;4635;59;46;6;40;.870;3532000;0
43321;183730;3800;0;0;0;0;.00nan;0;0
43321;191574;3796;78;38;3;35;.921;3600000;0
43321;57390;3800;54;28;4;24;.857;3545000;0
43321;64736;3796;0;0;0;0;.00nan;0;0
43322;183730;3800;50;0;0;0;.00nan;419000;0
43322;57152;3797;72;12;0;12;1.000;1715000;0
43322;57390;3800;57;36;5;31;.861;3181000;0
43322;59231;3797;31;26;6;20;.769;1885000;0
43323;191574;3796;0;0;0;0;.00nan;0;0
43323;57152;3797;60;29;3;26;.897;3564000;0
43323;59231;3797;0;0;0;0;.00nan;0;0
43323;64736;3796;95;34;1;33;.971;3600000;0
43324;183730;3800;67;32;3;29;.906;3600000;0
43324;-1;4635;0;0;0;0;.00nan;0;0
43324;57390;3800;0;0;0;0;.00nan;0;0
43324;91413;4635;51;32;4;28;.875;3543000;0
43325;-1;3798;0;0;0;0;.00nan;0;0
43325;196456;3795;67;36;3;33;.917;3600000;0
43325;85709;3795;0;0;0;0;.00nan;0;0
43325;94615;3798;30;39;7;32;.821;3600000;0
43326;-1;3798;73;19;1;18;.947;3600000;0
43326;196456;3795;0;0;0;0;.00nan;0;0
43326;85709;3795;56;35;4;31;.886;3600000;0
43326;94615;3798;0;0;0;0;.00nan;0;0
43327;-1;4635;55;30;4;26;.867;3620000;0
43327;191574;3796;74;38;5;33;.868;3620000;0
43327;64736;3796;0;0;0;0;.00nan;0;0
43327;91413;4635;0;0;0;0;.00nan;0;0
43328;191574;3796;0;0;0;0;.00nan;0;0
43328;57152;3797;0;0;0;0;.00nan;0;0
43328;59231;3797;69;40;4;36;.900;3600000;0
43328;64736;3796;87;26;1;25;.962;3600000;0
43329;183730;3800;0;0;0;0;.00nan;0;0
43329;196456;3795;43;22;4;18;.818;3600000;0
43329;57390;3800;97;35;1;34;.971;3600000;0
43329;85709;3795;0;0;0;0;.00nan;0;0
43330;-1;3798;0;0;0;0;.00nan;0;0
43330;-1;4635;0;0;0;0;.00nan;0;0
43330;91413;4635;100;41;1;40;.976;3600000;0
43330;94615;3798;81;32;2;30;.938;3542000;0
43331;183730;3800;54;32;5;27;.844;3583000;0
43331;191574;3796;62;30;3;27;.900;3600000;0
43331;57390;3800;0;0;0;0;.00nan;0;0
43331;64736;3796;0;0;0;0;.00nan;0;0
43332;196456;3795;0;0;0;0;.00nan;0;0
43332;57152;3797;76;31;3;28;.903;3600000;0
43332;59231;3797;0;0;0;0;.00nan;0;0
43332;85709;3795;54;26;4;22;.846;3561000;0
43333;-1;3798;84;33;2;31;.939;3900000;0
43333;-1;4635;82;36;2;34;.944;3900000;0
43333;91413;4635;0;0;0;0;.00nan;0;0
43333;94615;3798;0;0;0;0;.00nan;0;0
43334;-1;3798;0;0;0;0;.00nan;0;0
43334;57152;3797;52;2;0;2;1.000;392000;0
43334;59231;3797;40;39;7;32;.821;3208000;0
43334;94615;3798;67;23;2;21;.913;3600000;0
43335;-1;4635;0;0;0;0;.00nan;0;0
43335;191574;3796;0;0;0;0;.00nan;0;0
43335;64736;3796;56;33;5;28;.848;3536000;0
43335;91413;4635;89;37;3;34;.919;3600000;0
43336;183730;3800;0;0;0;0;.00nan;0;0
43336;-1;3798;28;29;6;23;.793;3551000;0
43336;57390;3800;51;30;4;26;.867;3600000;0
43336;94615;3798;0;0;0;0;.00nan;0;0
43337;196456;3795;83;23;2;21;.913;3600000;0
43337;57152;3797;25;12;4;8;.667;1173000;0
43337;59231;3797;36;18;4;14;.778;2427000;0
43337;85709;3795;0;0;0;0;.00nan;0;0
43338;183730;3800;0;0;0;0;.00nan;0;0
43338;57152;3797;0;0;0;0;.00nan;0;0
43338;57390;3800;54;18;3;15;.833;3600000;0
43338;59231;3797;81;48;4;44;.917;3600000;0
43339;-1;3798;0;0;0;0;.00nan;0;0
43339;-1;4635;0;0;0;0;.00nan;0;0
43339;91413;4635;39;32;5;27;.844;3600000;0
43339;94615;3798;71;39;4;35;.897;3600000;0
43340;196456;3795;60;10;1;9;.900;1475000;0
43340;191574;3796;83;35;2;33;.943;3600000;0
43340;64736;3796;0;0;0;0;.00nan;0;0
43340;85709;3795;37;19;4;15;.789;2125000;0
43341;183730;3800;52;27;4;23;.852;3600000;0
43341;57152;3797;65;19;1;18;.947;3600000;0
43341;57390;3800;0;0;0;0;.00nan;0;0
43341;59231;3797;0;0;0;0;.00nan;0;0
43342;196456;3795;100;28;0;28;1.000;3600000;0
43342;191574;3796;0;0;0;0;.00nan;0;0
43342;64736;3796;58;37;5;32;.865;3600000;0
43342;85709;3795;0;0;0;0;.00nan;0;0
43343;196456;3795;0;0;0;0;.00nan;0;0
43343;57152;3797;0;0;0;0;.00nan;0;0
43343;59231;3797;100;28;0;28;1.000;3600000;0
43343;85709;3795;44;27;4;23;.852;3600000;0
43344;183730;3800;0;0;0;0;.00nan;0;0
43344;-1;4635;48;7;1;6;.857;600000;0
43344;57390;3800;70;21;2;19;.905;3600000;0
43344;91413;4635;57;42;6;36;.857;3000000;0
43345;-1;3798;0;0;0;0;.00nan;0;0
43345;175530;3796;0;0;0;0;.00nan;0;0
43345;64736;3796;98;53;3;50;.943;3556000;0
43345;94615;3798;54;16;2;14;.875;3600000;0
43346;-1;3798;50;37;5;32;.865;3600000;0
43346;57152;3797;0;0;0;0;.00nan;0;0
43346;59231;3797;54;44;6;38;.864;3600000;0
43346;94615;3798;0;0;0;0;.00nan;0;0
43347;196456;3795;84;27;1;26;.963;3600000;0
43347;-1;4635;51;42;6;36;.857;3222000;0
43347;85709;3795;0;0;0;0;.00nan;0;0
43347;91413;4635;62;4;0;4;1.000;378000;0
43348;183730;3800;64;26;3;23;.885;3600000;0
43348;175530;3796;0;0;0;0;.00nan;0;0
43348;57390;3800;0;0;0;0;.00nan;0;0
43348;64736;3796;66;28;4;24;.857;3545000;0
43350;168021;3798;100;47;1;46;.979;3600000;0
43350;-1;3798;0;0;0;0;.00nan;0;0
43350;196456;3795;0;0;0;0;.00nan;0;0
43350;85709;3795;53;20;3;17;.850;3515000;0
43352;183730;3800;0;0;0;0;.00nan;0;0
43352;57152;3797;33;38;7;31;.816;3519000;0
43352;57390;3800;29;24;5;19;.792;3600000;0
43352;59231;3797;0;0;0;0;.00nan;0;0
43354;175530;3796;0;0;0;0;.00nan;0;0
43354;-1;4635;0;0;0;0;.00nan;0;0
43354;191574;3796;83;31;2;29;.935;3578000;0
43354;91413;4635;95;34;1;33;.971;3600000;0
43356;196456;3795;59;20;2;18;.900;3600000;0
43356;57152;3797;58;7;0;7;1.000;880000;0
43356;59231;3797;58;41;6;35;.854;2720000;0
43356;85709;3795;0;0;0;0;.00nan;0;0
43358;168021;3798;0;0;0;0;.00nan;0;0
43358;-1;3798;56;32;4;28;.875;3544000;0
43358;-1;4635;70;32;3;29;.906;3600000;0
43358;91413;4635;0;0;0;0;.00nan;0;0
43360;183730;3800;66;27;2;25;.926;3600000;0
43360;175530;3796;52;38;5;33;.868;3600000;0
43360;191574;3796;0;0;0;0;.00nan;0;0
43360;57390;3800;0;0;0;0;.00nan;0;0
43362;168021;3798;40;27;5;22;.815;3514000;0
43362;183730;3800;0;0;0;0;.00nan;0;0
43362;-1;3798;0;0;0;0;.00nan;0;0
43362;57390;3800;63;28;3;25;.893;3600000;0
43364;175530;3796;0;0;0;0;.00nan;0;0
43364;-1;4635;0;0;0;0;.00nan;0;0
43364;191574;3796;62;44;5;39;.886;3600000;0
43364;91413;4635;80;24;2;22;.917;3600000;0
43366;196456;3795;0;0;0;0;.00nan;0;0
43366;57152;3797;0;0;0;0;.00nan;0;0
43366;59231;3797;83;47;4;43;.915;3600000;0
43366;85709;3795;67;18;1;17;.944;3600000;0
43368;183730;3800;0;0;0;0;.00nan;0;0
43368;-1;4635;0;0;0;0;.00nan;0;0
43368;57390;3800;70;43;4;39;.907;3734000;0
43368;91413;4635;67;32;3;29;.906;3734000;0
43370;175530;3796;0;0;0;0;.00nan;0;0
43370;191574;3796;63;38;4;34;.895;3900000;0
43370;57152;3797;0;0;0;0;.00nan;0;0
43370;59231;3797;68;38;4;34;.895;3900000;0
43372;168021;3798;71;42;4;38;.905;3600000;0
43372;-1;3798;0;0;0;0;.00nan;0;0
43372;196456;3795;0;0;0;0;.00nan;0;0
43372;85709;3795;51;37;6;31;.838;3520000;0
43374;168021;3798;70;35;3;32;.914;3562000;0
43374;183730;3800;58;19;2;17;.895;3600000;0
43374;-1;3798;0;0;0;0;.00nan;0;0
43374;57390;3800;0;0;0;0;.00nan;0;0
43376;196456;3795;73;20;1;19;.950;3600000;0
43376;-1;4635;78;35;2;33;.943;3583000;0
43376;85709;3795;0;0;0;0;.00nan;0;0
43376;91413;4635;0;0;0;0;.00nan;0;0
43378;175530;3796;37;27;5;22;.815;3600000;0
43378;191574;3796;0;0;0;0;.00nan;0;0
43378;57152;3797;78;22;1;21;.955;3600000;0
43378;59231;3797;0;0;0;0;.00nan;0;0
43380;183730;3800;0;0;0;0;.00nan;0;0
43380;175530;3796;0;0;0;0;.00nan;0;0
43380;191574;3796;95;33;1;32;.970;3600000;0
43380;57390;3800;44;32;5;27;.844;3600000;0
43382;-1;4635;0;0;0;0;.00nan;0;0
43382;57152;3797;0;0;0;0;.00nan;0;0
43382;59231;3797;54;29;4;25;.862;3900000;0
43382;91413;4635;63;37;4;33;.892;3900000;0
43384;168021;3798;81;33;2;31;.939;3600000;0
43384;-1;3798;0;0;0;0;.00nan;0;0
43384;196456;3795;0;0;0;0;.00nan;0;0
43384;85709;3795;73;23;1;22;.957;3600000;0
1526;183730;3800;0;0;0;0;.00nan;0;0
1526;57152;3797;0;0;0;0;.00nan;0;0
1526;57390;3800;43;20;3;17;.850;3600000;0
1526;59231;3797;33;25;5;20;.800;3600000;0
1527;175530;3796;0;0;0;0;.00nan;0;0
1527;-1;4635;0;0;0;0;.00nan;0;0
1527;64736;3796;91;44;2;42;.955;3600000;0
1527;91413;4635;59;28;3;25;.893;3551000;0
1528;183730;3800;0;0;0;0;.00nan;0;0
1528;57152;3797;0;0;0;0;.00nan;0;0
1528;57390;3800;53;31;4;27;.871;4733000;0
1528;59231;3797;75;48;5;43;.896;4733000;0
1529;175530;3796;0;0;0;0;.00nan;0;0
1529;-1;4635;0;0;0;0;.00nan;0;0
1529;64736;3796;51;39;5;34;.872;3922000;0
1529;91413;4635;67;34;4;30;.882;3922000;0
1530;183730;3800;0;0;0;0;.00nan;0;0
1530;57152;3797;0;0;0;0;.00nan;0;0
1530;57390;3800;49;34;5;29;.853;3600000;0
1530;59231;3797;100;29;0;29;1.000;3600000;0
1531;175530;3796;0;0;0;0;.00nan;0;0
1531;-1;4635;0;0;0;0;.00nan;0;0
1531;64736;3796;61;23;3;20;.870;3600000;0
1531;91413;4635;82;16;0;16;1.000;3600000;0
1532;183730;3800;0;0;0;0;.00nan;0;0
1532;57152;3797;0;0;0;0;.00nan;0;0
1532;57390;3800;60;20;2;18;.900;3600000;0
1532;59231;3797;51;27;4;23;.852;3538000;0
1533;175530;3796;0;0;0;0;.00nan;0;0
1533;-1;4635;0;0;0;0;.00nan;0;0
1533;64736;3796;61;33;4;29;.879;3525000;0
1533;91413;4635;88;31;2;29;.935;3600000;0
1811;183730;3800;0;0;0;0;.00nan;0;0
1811;57152;3797;0;0;0;0;.00nan;0;0
1811;57390;3800;81;22;2;20;.909;3600000;0
1811;59231;3797;41;26;4;22;.846;3600000;0
1812;175530;3796;0;0;0;0;.00nan;0;0
1812;-1;4635;0;0;0;0;.00nan;0;0
1812;64736;3796;98;51;2;49;.961;3560000;0
1812;91413;4635;76;22;1;21;.955;3600000;0
1851;-1;3798;0;0;0;0;.00nan;0;0
1851;-1;4635;0;0;0;0;.00nan;0;0
1851;91413;4635;50;22;3;19;.864;3527000;0
1851;94615;3798;61;12;1;11;.917;3600000;0
1852;183730;3800;0;0;0;0;.00nan;0;0
1852;196456;3795;47;13;2;11;.846;3600000;0
1852;57390;3800;50;39;6;33;.846;3600000;0
1852;85709;3795;0;0;0;0;.00nan;0;0
1853;-1;3798;0;0;0;0;.00nan;0;0
1853;-1;4635;0;0;0;0;.00nan;0;0
1853;91413;4635;99;34;2;32;.941;3600000;0
1853;94615;3798;25;21;5;16;.762;3600000;0
1854;183730;3800;0;0;0;0;.00nan;0;0
1854;196456;3795;84;28;1;27;.964;3600000;0
1854;57390;3800;87;37;2;35;.946;3564000;0
1854;85709;3795;0;0;0;0;.00nan;0;0
1855;-1;3798;38;8;2;6;.750;1231000;0
1855;-1;4635;0;0;0;0;.00nan;0;0
1855;91413;4635;99;41;2;39;.951;3600000;0
1855;94615;3798;21;16;5;11;.688;2369000;0
1856;183730;3800;0;0;0;0;.00nan;0;0
1856;196456;3795;59;25;3;22;.880;3600000;0
1856;57390;3800;62;35;4;31;.886;3544000;0
1856;85709;3795;0;0;0;0;.00nan;0;0
1857;-1;3798;0;0;0;0;.00nan;0;0
1857;-1;4635;0;0;0;0;.00nan;0;0
1857;91413;4635;51;22;3;19;.864;3600000;0
1857;94615;3798;43;35;5;30;.857;3600000;0
1858;183730;3800;0;0;0;0;.00nan;0;0
1858;196456;3795;39;35;6;29;.829;3600000;0
1858;57390;3800;70;28;2;26;.929;3600000;0
1858;85709;3795;0;0;0;0;.00nan;0;0
1989;-1;3798;0;0;0;0;.00nan;0;0
1989;-1;4635;0;0;0;0;.00nan;0;0
1989;91413;4635;88;33;2;31;.939;3600000;0
1989;94615;3798;64;40;4;36;.900;3574000;0
1990;183730;3800;0;0;0;0;.00nan;0;0
1990;196456;3795;100;27;0;27;1.000;3600000;0
1990;57390;3800;74;36;3;33;.917;3600000;0
1990;85709;3795;0;0;0;0;.00nan;0;0
2067;196456;3795;87;35;2;33;.943;3600000;0
2067;-1;4635;0;0;0;0;.00nan;0;0
2067;85709;3795;0;0;0;0;.00nan;0;0
2067;91413;4635;44;19;3;16;.842;3543000;0
2068;196456;3795;72;33;3;30;.909;3645000;0
2068;-1;4635;0;0;0;0;.00nan;0;0
2068;85709;3795;0;0;0;0;.00nan;0;0
2068;91413;4635;78;42;4;38;.905;3645000;0
2069;196456;3795;65;25;3;22;.880;3600000;0
2069;-1;4635;55;3;0;3;1.000;334000;0
2069;85709;3795;0;0;0;0;.00nan;0;0
2069;91413;4635;26;28;6;22;.786;3266000;0
2070;196456;3795;50;29;5;24;.828;3624000;0
2070;-1;4635;0;0;0;0;.00nan;0;0
2070;85709;3795;0;0;0;0;.00nan;0;0
2070;91413;4635;41;36;6;30;.833;3624000;0
43385;169438;1422;66;14;1;13;.929;3600000;0
43385;211293;1430;0;0;0;0;.00nan;0;0
43385;176926;1430;46;44;7;37;.841;3600000;0
43385;157903;1422;0;0;0;0;.00nan;0;0
43386;182561;1426;47;30;4;26;.867;3546000;0
43386;169438;1422;0;0;0;0;.00nan;0;0
43386;185124;1426;0;0;0;0;.00nan;0;0
43386;157903;1422;57;25;3;22;.880;3600000;0
43387;2037;1425;0;0;0;0;.00nan;0;0
43387;10112;1453;0;0;0;0;.00nan;0;0
43387;165030;1453;69;33;3;30;.909;3600000;0
43387;64230;1425;77;40;4;36;.900;3582000;0
43388;174312;1443;0;0;0;0;.00nan;0;0
43388;72439;1443;49;6;1;5;.833;3600000;0
43388;148391;4742;39;29;5;24;.828;1820000;0
43388;157845;4742;42;34;6;28;.824;1780000;0
43389;-1;4961;52;22;3;19;.864;3570000;0
43389;200849;1440;0;0;0;0;.00nan;0;0
43389;195618;4961;0;0;0;0;.00nan;0;0
43389;185136;1440;64;24;2;22;.917;3600000;0
43390;1765;1427;0;0;0;0;.00nan;0;0
43390;4127;1429;50;35;5;30;.857;3600000;0
43390;9524;1427;88;18;0;18;1.000;3600000;0
43390;-1;1429;0;0;0;0;.00nan;0;0
43391;1765;1427;0;0;0;0;.00nan;0;0
43391;9524;1427;42;16;3;13;.813;3600000;0
43391;211293;1430;0;0;0;0;.00nan;0;0
43391;176926;1430;37;37;6;31;.838;3600000;0
43392;2037;1425;0;0;0;0;.00nan;0;0
43392;10112;1453;0;0;0;0;.00nan;0;0
43392;165030;1453;56;34;4;30;.882;3600000;0
43392;64230;1425;64;29;3;26;.897;3600000;0
43393;200849;1440;29;8;3;5;.625;309000;0
43393;174312;1443;0;0;0;0;.00nan;0;0
43393;185136;1440;88;64;3;61;.953;3291000;0
43393;72439;1443;62;3;0;3;1.000;3600000;0
43394;4127;1429;79;26;1;25;.962;3600000;0
43394;-1;1429;0;0;0;0;.00nan;0;0
43394;148391;4742;100;38;0;38;1.000;3600000;0
43394;157845;4742;0;0;0;0;.00nan;0;0
43395;182561;1426;37;27;5;22;.815;3600000;0
43395;-1;4961;77;31;2;29;.935;3600000;0
43395;195618;4961;0;0;0;0;.00nan;0;0
43395;185124;1426;0;0;0;0;.00nan;0;0
43396;211293;1430;0;0;0;0;.00nan;0;0
43396;176926;1430;60;29;3;26;.897;3600000;0
43396;148391;4742;36;25;5;20;.800;3514000;0
43396;157845;4742;0;0;0;0;.00nan;0;0
43397;182561;1426;83;36;1;35;.972;3900000;0
43397;10112;1453;0;0;0;0;.00nan;0;0
43397;165030;1453;91;39;1;38;.974;3900000;0
43397;185124;1426;0;0;0;0;.00nan;0;0
43398;2037;1425;0;0;0;0;.00nan;0;0
43398;169438;1422;0;0;0;0;.00nan;0;0
43398;64230;1425;71;26;2;24;.923;3600000;0
43398;157903;1422;39;24;4;20;.833;3513000;0
43399;4127;1429;70;23;2;21;.913;3600000;0
43399;200849;1440;0;0;0;0;.00nan;0;0
43399;185136;1440;34;42;6;36;.857;3600000;0
43399;-1;1429;0;0;0;0;.00nan;0;0
43400;1765;1427;0;0;0;0;.00nan;0;0
43400;9524;1427;67;26;3;23;.885;3600000;0
43400;148391;4742;67;39;4;35;.897;3549000;0
43400;157845;4742;0;0;0;0;.00nan;0;0
43401;-1;4961;18;45;9;36;.800;1986000;0
43401;174312;1443;0;0;0;0;.00nan;0;0
43401;195618;4961;80;26;1;25;.962;1614000;0
43401;72439;1443;82;11;0;11;1.000;3600000;0
43402;2037;1425;0;0;0;0;.00nan;0;0
43402;182561;1426;0;0;0;0;.00nan;0;0
43402;185124;1426;64;22;2;20;.909;3900000;0
43402;64230;1425;68;26;2;24;.923;3900000;0
43403;-1;4961;61;27;2;25;.926;3543000;0
43403;211293;1430;0;0;0;0;.00nan;0;0
43403;195618;4961;0;0;0;0;.00nan;0;0
43403;176926;1430;65;16;1;15;.938;3600000;0
43404;10112;1453;0;0;0;0;.00nan;0;0
43404;165030;1453;67;26;3;23;.885;3600000;0
43404;169438;1422;69;21;1;20;.952;3600000;0
43404;157903;1422;0;0;0;0;.00nan;0;0
43405;1765;1427;81;66;6;60;.909;3340000;0
43405;9524;1427;49;1;0;1;1.000;260000;0
43405;174312;1443;0;0;0;0;.00nan;0;0
43405;72439;1443;32;12;3;9;.750;3600000;0
43406;4127;1429;52;23;4;19;.826;3900000;0
43406;200849;1440;0;0;0;0;.00nan;0;0
43406;185136;1440;72;42;4;38;.905;3900000;0
43406;-1;1429;0;0;0;0;.00nan;0;0
43407;4127;1429;52;27;4;23;.852;3597000;0
43407;10112;1453;0;0;0;0;.00nan;0;0
43407;165030;1453;73;29;2;27;.931;3600000;0
43407;-1;1429;0;0;0;0;.00nan;0;0
43408;2037;1425;0;0;0;0;.00nan;0;0
43408;64230;1425;76;30;3;27;.900;3600000;0
43408;148391;4742;0;0;0;0;.00nan;0;0
43408;157845;4742;48;21;4;17;.810;3569000;0
43409;-1;4961;29;40;7;33;.825;3600000;0
43409;169438;1422;0;0;0;0;.00nan;0;0
43409;195618;4961;0;0;0;0;.00nan;0;0
43409;157903;1422;67;24;2;22;.917;3600000;0
43410;182561;1426;39;24;5;19;.792;3600000;0
43410;200849;1440;65;24;2;22;.917;3600000;0
43410;185124;1426;0;0;0;0;.00nan;0;0
43410;185136;1440;0;0;0;0;.00nan;0;0
43411;1765;1427;0;0;0;0;.00nan;0;0
43411;9524;1427;91;55;4;51;.927;3600000;0
43411;174312;1443;0;0;0;0;.00nan;0;0
43411;72439;1443;68;14;1;13;.929;3600000;0
43412;182561;1426;77;23;1;22;.957;3600000;0
43412;211293;1430;0;0;0;0;.00nan;0;0
43412;176926;1430;68;33;3;30;.909;3576000;0
43412;185124;1426;0;0;0;0;.00nan;0;0
43413;2037;1425;57;10;1;9;.900;1213000;0
43413;64230;1425;23;26;7;19;.731;2372000;0
43413;148391;4742;38;41;7;34;.829;3600000;0
43413;157845;4742;0;0;0;0;.00nan;0;0
43414;169438;1422;41;46;7;39;.848;3149000;0
43414;174312;1443;54;13;3;10;.769;3600000;0
43414;72439;1443;0;0;0;0;.00nan;0;0
43414;157903;1422;56;5;0;5;1.000;451000;0
43415;4127;1429;100;27;1;26;.963;3600000;0
43415;10112;1453;0;0;0;0;.00nan;0;0
43415;165030;1453;48;28;4;24;.857;3600000;0
43415;-1;1429;0;0;0;0;.00nan;0;0
43416;-1;4961;0;0;0;0;.00nan;0;0
43416;200849;1440;0;0;0;0;.00nan;0;0
43416;195618;4961;26;27;6;21;.778;3545000;0
43416;185136;1440;68;35;4;31;.886;3600000;0
43417;182561;1426;37;40;6;34;.850;2069000;0
43417;174312;1443;0;0;0;0;.00nan;0;0
43417;185124;1426;57;15;1;14;.933;1531000;0
43417;72439;1443;49;7;1;6;.857;3600000;0
43418;169438;1422;57;12;2;10;.833;3600000;0
43418;211293;1430;0;0;0;0;.00nan;0;0
43418;176926;1430;91;41;3;38;.927;3575000;0
43418;157903;1422;0;0;0;0;.00nan;0;0
43419;10112;1453;0;0;0;0;.00nan;0;0
43419;165030;1453;56;34;4;30;.882;3571000;0
43419;148391;4742;0;0;0;0;.00nan;0;0
43419;157845;4742;37;14;3;11;.786;3600000;0
43420;4127;1429;70;23;2;21;.913;3600000;0
43420;-1;4961;48;35;6;29;.829;3107000;0
43420;195618;4961;50;3;0;3;1.000;493000;0
43420;-1;1429;0;0;0;0;.00nan;0;0
43421;174312;1443;59;10;1;9;.900;3600000;0
43421;185136;1440;0;0;0;0;.00nan;0;0
43421;187263;1440;46;43;7;36;.837;3600000;0
43421;72439;1443;0;0;0;0;.00nan;0;0
43422;1765;1427;0;0;0;0;.00nan;0;0
43422;2037;1425;0;0;0;0;.00nan;0;0
43422;9524;1427;53;30;4;26;.867;3600000;0
43422;64230;1425;52;21;3;18;.857;3600000;0
43423;182561;1426;40;24;5;19;.792;3600000;0
43423;185124;1426;0;0;0;0;.00nan;0;0
43423;185136;1440;53;8;1;7;.875;742000;0
43423;187263;1440;13;25;7;18;.720;2858000;0
43424;10112;1453;0;0;0;0;.00nan;0;0
43424;165030;1453;65;14;1;13;.929;3600000;0
43424;148391;4742;58;35;4;31;.886;3600000;0
43424;157845;4742;0;0;0;0;.00nan;0;0
43425;2037;1425;0;0;0;0;.00nan;0;0
43425;4127;1429;52;17;2;15;.882;3600000;0
43425;-1;1429;0;0;0;0;.00nan;0;0
43425;64230;1425;77;39;3;36;.923;3572000;0
43426;1765;1427;0;0;0;0;.00nan;0;0
43426;9524;1427;73;23;1;22;.957;3679000;0
43426;169438;1422;0;0;0;0;.00nan;0;0
43426;157903;1422;78;22;2;20;.909;3679000;0
43427;-1;4961;0;0;0;0;.00nan;0;0
43427;211293;1430;0;0;0;0;.00nan;0;0
43427;195618;4961;60;24;4;20;.833;3600000;0
43427;176926;1430;100;29;0;29;1.000;3600000;0
43428;1765;1427;0;0;0;0;.00nan;0;0
43428;9524;1427;73;22;2;20;.909;3600000;0
43428;10112;1453;0;0;0;0;.00nan;0;0
43428;165030;1453;50;39;6;33;.846;3600000;0
43429;2037;1425;0;0;0;0;.00nan;0;0
43429;182561;1426;26;13;4;9;.692;1137000;0
43429;185124;1426;82;26;1;25;.962;2463000;0
43429;64230;1425;87;24;1;23;.958;3600000;0
43430;185136;1440;0;0;0;0;.00nan;0;0
43430;187263;1440;45;21;3;18;.857;3600000;0
43430;148391;4742;0;0;0;0;.00nan;0;0
43430;157845;4742;61;32;4;28;.875;3589000;0
43431;-1;4961;98;56;4;52;.929;3600000;0
43431;174312;1443;0;0;0;0;.00nan;0;0
43431;195618;4961;0;0;0;0;.00nan;0;0
43431;72439;1443;56;13;1;12;.923;3600000;0
43432;4127;1429;100;27;0;27;1.000;3600000;0
43432;169438;1422;68;35;3;32;.914;3600000;0
43432;-1;1429;0;0;0;0;.00nan;0;0
43432;157903;1422;0;0;0;0;.00nan;0;0
43433;182561;1426;34;28;5;23;.821;3600000;0
43433;211293;1430;0;0;0;0;.00nan;0;0
43433;176926;1430;77;26;2;24;.923;3600000;0
43433;185124;1426;0;0;0;0;.00nan;0;0
43434;169438;1422;0;0;0;0;.00nan;0;0
43434;174312;1443;67;17;1;16;.941;3600000;0
43434;72439;1443;0;0;0;0;.00nan;0;0
43434;157903;1422;97;56;3;53;.946;3600000;0
43435;2037;1425;0;0;0;0;.00nan;0;0
43435;185136;1440;0;0;0;0;.00nan;0;0
43435;187263;1440;42;32;5;27;.844;3600000;0
43435;64230;1425;100;33;1;32;.970;3600000;0
43436;1765;1427;21;31;7;24;.774;3541000;0
43436;9524;1427;0;0;0;0;.00nan;0;0
43436;10112;1453;0;0;0;0;.00nan;0;0
43436;165030;1453;49;39;5;34;.872;3600000;0
43437;-1;4961;0;0;0;0;.00nan;0;0
43437;195618;4961;92;36;1;35;.972;3600000;0
43437;148391;4742;36;27;5;22;.815;3600000;0
43437;157845;4742;0;0;0;0;.00nan;0;0
43438;2037;1425;0;0;0;0;.00nan;0;0
43438;4127;1429;69;29;2;27;.931;3600000;0
43438;-1;1429;0;0;0;0;.00nan;0;0
43438;64230;1425;78;35;3;32;.914;3545000;0
43439;182561;1426;65;28;4;24;.857;3564000;0
43439;4127;1429;80;30;2;28;.933;3600000;0
43439;185124;1426;0;0;0;0;.00nan;0;0
43439;-1;1429;0;0;0;0;.00nan;0;0
43440;10112;1453;0;0;0;0;.00nan;0;0
43440;165030;1453;98;59;5;54;.915;3600000;0
43440;174312;1443;0;0;0;0;.00nan;0;0
43440;72439;1443;48;12;2;10;.833;3600000;0
43441;-1;4961;52;28;4;24;.857;3555000;0
43441;195618;4961;0;0;0;0;.00nan;0;0
43441;148391;4742;65;25;2;23;.920;3600000;0
43441;157845;4742;0;0;0;0;.00nan;0;0
43442;211293;1430;0;0;0;0;.00nan;0;0
43442;176926;1430;94;23;0;23;1.000;3600000;0
43442;185136;1440;0;0;0;0;.00nan;0;0
43442;187263;1440;59;32;4;28;.875;3600000;0
43443;1765;1427;0;0;0;0;.00nan;0;0
43443;9524;1427;54;31;4;27;.871;3600000;0
43443;169438;1422;36;27;5;22;.815;3600000;0
43443;157903;1422;0;0;0;0;.00nan;0;0
43444;211293;1430;0;0;0;0;.00nan;0;0
43444;176926;1430;63;27;3;24;.889;3600000;0
43444;185136;1440;75;17;0;17;1.000;2937000;0
43444;187263;1440;22;14;4;10;.714;625000;0
43445;2037;1425;0;0;0;0;.00nan;0;0
43445;-1;4961;36;18;4;14;.778;1175000;0
43445;195618;4961;42;22;4;18;.818;2425000;0
43445;64230;1425;23;34;7;27;.794;3600000;0
43446;169438;1422;0;0;0;0;.00nan;0;0
43446;148391;4742;0;0;0;0;.00nan;0;0
43446;157845;4742;99;26;0;26;1.000;3600000;0
43446;157903;1422;40;15;3;12;.800;3600000;0
43447;10112;1453;0;0;0;0;.00nan;0;0
43447;165030;1453;69;55;5;50;.909;3600000;0
43447;174312;1443;50;12;2;10;.833;3600000;0
43447;72439;1443;0;0;0;0;.00nan;0;0
43448;1765;1427;54;18;2;16;.889;1269000;0
43448;4127;1429;0;0;0;0;.00nan;0;0
43448;9524;1427;38;29;5;24;.828;2331000;0
43448;-1;1429;57;25;3;22;.880;3600000;0
43449;-1;4961;47;19;3;16;.842;3556000;0
43449;169438;1422;77;35;2;33;.943;3600000;0
43449;195618;4961;0;0;0;0;.00nan;0;0
43449;157903;1422;0;0;0;0;.00nan;0;0
43450;10112;1453;0;0;0;0;.00nan;0;0
43450;165030;1453;84;34;2;32;.941;3600000;0
43450;211293;1430;0;0;0;0;.00nan;0;0
43450;176926;1430;92;43;3;40;.930;3554000;0
43451;182561;1426;53;24;3;21;.875;3600000;0
43451;185124;1426;0;0;0;0;.00nan;0;0
43451;148391;4742;0;0;0;0;.00nan;0;0
43451;157845;4742;98;24;0;24;1.000;3600000;0
43452;2037;1425;0;0;0;0;.00nan;0;0
43452;169438;1422;24;6;3;3;.500;376000;0
43452;64230;1425;74;30;2;28;.933;3600000;0
43452;157903;1422;59;19;2;17;.895;3224000;0
43453;4127;1429;100;50;1;49;.980;3600000;0
43453;174312;1443;0;0;0;0;.00nan;0;0
43453;-1;1429;0;0;0;0;.00nan;0;0
43453;72439;1443;50;12;2;10;.833;3543000;0
43454;1765;1427;0;0;0;0;.00nan;0;0
43454;9524;1427;51;28;4;24;.857;3589000;0
43454;185136;1440;0;0;0;0;.00nan;0;0
43454;187263;1440;74;33;2;31;.939;3600000;0
43455;182561;1426;60;35;4;31;.886;3576000;0
43455;169438;1422;79;24;2;22;.917;3600000;0
43455;185124;1426;0;0;0;0;.00nan;0;0
43455;157903;1422;0;0;0;0;.00nan;0;0
43456;211293;1430;0;0;0;0;.00nan;0;0
43456;176926;1430;69;28;2;26;.929;3600000;0
43456;148391;4742;52;27;3;24;.889;3600000;0
43456;157845;4742;0;0;0;0;.00nan;0;0
43457;4127;1429;59;41;6;35;.854;2145000;0
43457;174312;1443;42;10;3;7;.700;3600000;0
43457;-1;1429;60;27;3;24;.889;1455000;0
43457;72439;1443;0;0;0;0;.00nan;0;0
43458;1765;1427;47;15;2;13;.867;3600000;0
43458;9524;1427;0;0;0;0;.00nan;0;0
43458;185136;1440;0;0;0;0;.00nan;0;0
43458;187263;1440;28;47;8;39;.830;3600000;0
43459;2037;1425;0;0;0;0;.00nan;0;0
43459;-1;4961;50;35;5;30;.857;3600000;0
43459;195618;4961;0;0;0;0;.00nan;0;0
43459;64230;1425;81;30;2;28;.933;3600000;0
43460;1765;1427;0;0;0;0;.00nan;0;0
43460;9524;1427;65;21;2;19;.905;3600000;0
43460;148391;4742;0;0;0;0;.00nan;0;0
43460;157845;4742;57;36;4;32;.889;3514000;0
43461;182561;1426;63;21;2;19;.905;3600000;0
43461;-1;4961;64;36;4;32;.889;3524000;0
43461;195618;4961;0;0;0;0;.00nan;0;0
43461;185124;1426;0;0;0;0;.00nan;0;0
43462;10112;1453;0;0;0;0;.00nan;0;0
43462;165030;1453;77;27;2;25;.926;3600000;0
43462;169438;1422;0;0;0;0;.00nan;0;0
43462;157903;1422;51;28;3;25;.893;3555000;0
43463;2037;1425;0;0;0;0;.00nan;0;0
43463;174312;1443;0;0;0;0;.00nan;0;0
43463;64230;1425;95;50;4;46;.920;3600000;0
43463;72439;1443;64;12;1;11;.917;3600000;0
43464;4127;1429;62;15;2;13;.867;3600000;0
43464;211293;1430;0;0;0;0;.00nan;0;0
43464;176926;1430;69;39;4;35;.897;3585000;0
43464;-1;1429;0;0;0;0;.00nan;0;0
43465;1765;1427;91;35;1;34;.971;3600000;0
43465;9524;1427;0;0;0;0;.00nan;0;0
43465;185136;1440;0;0;0;0;.00nan;0;0
43465;187263;1440;61;33;3;30;.909;3579000;0
43466;10112;1453;0;0;0;0;.00nan;0;0
43466;165030;1453;80;32;1;31;.969;3600000;0
43466;211293;1430;0;0;0;0;.00nan;0;0
43466;176926;1430;66;24;2;22;.917;3550000;0
43467;2037;1425;0;0;0;0;.00nan;0;0
43467;174312;1443;69;17;1;16;.941;3600000;0
43467;64230;1425;45;37;6;31;.838;3600000;0
43467;72439;1443;0;0;0;0;.00nan;0;0
43468;182561;1426;72;34;3;31;.912;3600000;0
43468;169438;1422;26;27;6;21;.778;3600000;0
43468;185124;1426;0;0;0;0;.00nan;0;0
43468;157903;1422;0;0;0;0;.00nan;0;0
43469;185136;1440;0;0;0;0;.00nan;0;0
43469;187263;1440;49;33;4;29;.879;3600000;0
43469;148391;4742;88;18;0;18;1.000;3600000;0
43469;157845;4742;0;0;0;0;.00nan;0;0
43470;4127;1429;49;31;5;26;.839;3600000;0
43470;-1;4961;86;31;1;30;.968;3600000;0
43470;195618;4961;0;0;0;0;.00nan;0;0
43470;-1;1429;0;0;0;0;.00nan;0;0
43471;10112;1453;56;15;1;14;.933;3007000;0
43471;165030;1453;32;9;3;6;.667;593000;0
43471;-1;4961;97;25;0;25;1.000;3600000;0
43471;195618;4961;0;0;0;0;.00nan;0;0
43472;2037;1425;0;0;0;0;.00nan;0;0
43472;182561;1426;100;52;2;50;.962;3600000;0
43472;185124;1426;0;0;0;0;.00nan;0;0
43472;64230;1425;44;21;4;17;.810;3600000;0
43473;169438;1422;60;30;3;27;.900;3600000;0
43473;148391;4742;60;39;5;34;.872;3586000;0
43473;157845;4742;0;0;0;0;.00nan;0;0
43473;157903;1422;0;0;0;0;.00nan;0;0
43474;4127;1429;77;26;2;24;.923;3600000;0
43474;185136;1440;64;12;0;12;1.000;1061000;0
43474;187263;1440;54;42;6;36;.857;2539000;0
43474;-1;1429;0;0;0;0;.00nan;0;0
43475;1765;1427;0;0;0;0;.00nan;0;0
43475;9524;1427;58;21;3;18;.857;3600000;0
43475;211293;1430;0;0;0;0;.00nan;0;0
43475;176926;1430;74;44;4;40;.909;3600000;0
43476;182561;1426;61;33;4;29;.879;3600000;0
43476;185124;1426;0;0;0;0;.00nan;0;0
43476;148391;4742;0;0;0;0;.00nan;0;0
43476;157845;4742;53;22;3;19;.864;3600000;0
43477;4127;1429;79;29;2;27;.931;3600000;0
43477;211293;1430;0;0;0;0;.00nan;0;0
43477;176926;1430;52;33;4;29;.879;3562000;0
43477;-1;1429;0;0;0;0;.00nan;0;0
43478;169438;1422;0;0;0;0;.00nan;0;0
43478;185136;1440;0;0;0;0;.00nan;0;0
43478;187263;1440;97;39;1;38;.974;3600000;0
43478;157903;1422;55;20;3;17;.850;3521000;0
43479;1765;1427;61;33;4;29;.879;2287000;0
43479;9524;1427;54;18;2;16;.889;1313000;0
43479;174312;1443;0;0;0;0;.00nan;0;0
43479;72439;1443;50;12;2;10;.833;3600000;0
43480;10112;1453;0;0;0;0;.00nan;0;0
43480;165030;1453;30;30;6;24;.800;3555000;0
43480;-1;4961;65;43;5;38;.884;3600000;0
43480;195618;4961;0;0;0;0;.00nan;0;0
43481;4127;1429;82;24;1;23;.958;3600000;0
43481;10112;1453;0;0;0;0;.00nan;0;0
43481;165030;1453;73;33;2;31;.939;3600000;0
43481;-1;1429;0;0;0;0;.00nan;0;0
43482;2037;1425;0;0;0;0;.00nan;0;0
43482;211293;1430;0;0;0;0;.00nan;0;0
43482;176926;1430;70;38;4;34;.895;3600000;0
43482;64230;1425;99;21;0;21;1.000;3600000;0
43483;174312;1443;0;0;0;0;.00nan;0;0
43483;72439;1443;59;18;2;16;.889;3600000;0
43483;148391;4742;53;37;5;32;.865;2269000;0
43483;157845;4742;54;14;2;12;.857;1331000;0
43484;169438;1422;36;27;5;22;.815;3600000;0
43484;185136;1440;0;0;0;0;.00nan;0;0
43484;187263;1440;65;30;2;28;.933;3600000;0
43484;157903;1422;0;0;0;0;.00nan;0;0
43485;1765;1427;42;6;2;4;.667;637000;0
43485;182561;1426;56;33;4;29;.879;3600000;0
43485;9524;1427;33;28;6;22;.786;2963000;0
43485;185124;1426;0;0;0;0;.00nan;0;0
43486;182561;1426;0;0;0;0;.00nan;0;0
43486;10112;1453;0;0;0;0;.00nan;0;0
43486;165030;1453;52;30;4;26;.867;3548000;0
43486;185124;1426;73;27;3;24;.889;3600000;0
43487;169438;1422;0;0;0;0;.00nan;0;0
43487;211293;1430;0;0;0;0;.00nan;0;0
43487;176926;1430;60;30;3;27;.900;3576000;0
43487;157903;1422;71;31;2;29;.935;3600000;0
43488;174312;1443;78;12;0;12;1.000;3600000;0
43488;72439;1443;0;0;0;0;.00nan;0;0
43488;148391;4742;0;0;0;0;.00nan;0;0
43488;157845;4742;62;44;6;38;.864;3600000;0
43489;4127;1429;0;0;0;0;.00nan;0;0
43489;185136;1440;0;0;0;0;.00nan;0;0
43489;187263;1440;90;42;3;39;.929;3543000;0
43489;-1;1429;64;22;2;20;.909;3600000;0
43490;1765;1427;34;37;6;31;.838;3600000;0
43490;9524;1427;0;0;0;0;.00nan;0;0
43490;-1;4961;62;27;3;24;.889;3600000;0
43490;195618;4961;0;0;0;0;.00nan;0;0
43491;10112;1453;98;24;0;24;1.000;3600000;0
43491;165030;1453;0;0;0;0;.00nan;0;0
43491;185136;1440;0;0;0;0;.00nan;0;0
43491;187263;1440;59;34;4;30;.882;3600000;0
43492;174312;1443;84;14;0;14;1.000;3600000;0
43492;211293;1430;77;40;3;37;.925;2666000;0
43492;176926;1430;34;23;5;18;.783;934000;0
43492;72439;1443;0;0;0;0;.00nan;0;0
43493;2037;1425;0;0;0;0;.00nan;0;0
43493;64230;1425;67;30;3;27;.900;3900000;0
43493;148391;4742;73;38;3;35;.921;3894000;0
43493;157845;4742;0;0;0;0;.00nan;0;0
43494;1765;1427;0;0;0;0;.00nan;0;0
43494;4127;1429;65;31;3;28;.903;3600000;0
43494;9524;1427;68;38;4;34;.895;3600000;0
43494;-1;1429;0;0;0;0;.00nan;0;0
43495;182561;1426;37;22;5;17;.773;3666000;0
43495;-1;4961;53;36;4;32;.889;3666000;0
43495;195618;4961;0;0;0;0;.00nan;0;0
43495;185124;1426;0;0;0;0;.00nan;0;0
43496;1765;1427;0;0;0;0;.00nan;0;0
43496;182561;1426;75;33;3;30;.909;3655000;0
43496;9524;1427;70;29;2;27;.931;3680000;0
43496;185124;1426;0;0;0;0;.00nan;0;0
43497;2037;1425;61;34;4;30;.882;3526000;0
43497;64230;1425;0;0;0;0;.00nan;0;0
43497;148391;4742;0;0;0;0;.00nan;0;0
43497;157845;4742;68;18;2;16;.889;3600000;0
43498;4127;1429;48;31;5;26;.839;3600000;0
43498;169438;1422;78;40;2;38;.950;3600000;0
43498;-1;1429;0;0;0;0;.00nan;0;0
43498;157903;1422;0;0;0;0;.00nan;0;0
43499;174312;1443;0;0;0;0;.00nan;0;0
43499;211293;1430;0;0;0;0;.00nan;0;0
43499;176926;1430;82;61;5;56;.918;3600000;0
43499;72439;1443;84;12;0;12;1.000;3600000;0
43500;10112;1453;68;24;3;21;.875;3600000;0
43500;165030;1453;0;0;0;0;.00nan;0;0
43500;185136;1440;46;30;4;26;.867;3576000;0
43500;187263;1440;0;0;0;0;.00nan;0;0
43501;10112;1453;51;7;1;6;.857;599000;0
43501;165030;1453;46;41;6;35;.854;3001000;0
43501;174312;1443;0;0;0;0;.00nan;0;0
43501;72439;1443;50;13;2;11;.846;3600000;0
43502;2037;1425;0;0;0;0;.00nan;0;0
43502;-1;4961;64;28;3;25;.893;3600000;0
43502;195618;4961;0;0;0;0;.00nan;0;0
43502;64230;1425;50;27;4;23;.852;3549000;0
43503;4127;1429;85;19;0;19;1.000;3600000;0
43503;-1;1429;0;0;0;0;.00nan;0;0
43503;148391;4742;86;47;3;44;.936;3600000;0
43503;157845;4742;0;0;0;0;.00nan;0;0
43504;169438;1422;61;24;3;21;.875;3600000;0
43504;211293;1430;51;14;2;12;.857;897000;0
43504;176926;1430;23;30;7;23;.767;2703000;0
43504;157903;1422;0;0;0;0;.00nan;0;0
43505;1765;1427;0;0;0;0;.00nan;0;0
43505;9524;1427;68;22;2;20;.909;3600000;0
43505;185136;1440;60;7;0;7;1.000;556000;0
43505;187263;1440;56;40;6;34;.850;3044000;0
43506;2037;1425;0;0;0;0;.00nan;0;0
43506;182561;1426;60;25;3;22;.880;3541000;0
43506;185124;1426;0;0;0;0;.00nan;0;0
43506;64230;1425;87;24;1;23;.958;3600000;0
43507;211293;1430;0;0;0;0;.00nan;0;0
43507;176926;1430;50;26;4;22;.846;3862000;0
43507;148391;4742;0;0;0;0;.00nan;0;0
43507;157845;4742;58;38;5;33;.868;3862000;0
43508;10112;1453;80;54;5;49;.907;3600000;0
43508;165030;1453;0;0;0;0;.00nan;0;0
43508;174312;1443;73;9;0;9;1.000;3600000;0
43508;72439;1443;0;0;0;0;.00nan;0;0
43509;1765;1427;52;4;0;4;1.000;707000;0
43509;4127;1429;85;28;1;27;.964;3600000;0
43509;9524;1427;37;35;6;29;.829;2893000;0
43509;-1;1429;0;0;0;0;.00nan;0;0
43510;-1;4961;44;23;4;19;.826;3900000;0
43510;169438;1422;0;0;0;0;.00nan;0;0
43510;195618;4961;0;0;0;0;.00nan;0;0
43510;157903;1422;67;37;4;33;.892;3900000;0
43511;10112;1453;0;0;0;0;.00nan;0;0
43511;165030;1453;30;22;5;17;.773;3578000;0
43511;169438;1422;79;41;4;37;.902;3600000;0
43511;157903;1422;0;0;0;0;.00nan;0;0
43512;182561;1426;28;34;7;27;.794;3600000;0
43512;185124;1426;0;0;0;0;.00nan;0;0
43512;148391;4742;77;23;1;22;.957;3600000;0
43512;157845;4742;0;0;0;0;.00nan;0;0
43513;1765;1427;0;0;0;0;.00nan;0;0
43513;2037;1425;0;0;0;0;.00nan;0;0
43513;9524;1427;40;33;6;27;.818;3600000;0
43513;64230;1425;64;21;2;19;.905;3600000;0
43514;-1;4961;66;45;5;40;.889;3600000;0
43514;174312;1443;0;0;0;0;.00nan;0;0
43514;195618;4961;0;0;0;0;.00nan;0;0
43514;72439;1443;56;16;3;13;.813;3600000;0
43515;182561;1426;52;27;4;23;.852;3600000;0
43515;-1;4961;45;29;5;24;.828;3577000;0
43515;195618;4961;0;0;0;0;.00nan;0;0
43515;185124;1426;0;0;0;0;.00nan;0;0
43516;10112;1453;51;21;3;18;.857;3703000;0
43516;165030;1453;0;0;0;0;.00nan;0;0
43516;211293;1430;0;0;0;0;.00nan;0;0
43516;176926;1430;66;25;2;23;.920;3703000;0
43517;1765;1427;0;0;0;0;.00nan;0;0
43517;2037;1425;0;0;0;0;.00nan;0;0
43517;9524;1427;23;25;6;19;.760;3600000;0
43517;64230;1425;70;30;3;27;.900;3600000;0
43518;169438;1422;0;0;0;0;.00nan;0;0
43518;185136;1440;62;20;1;19;.950;1501000;0
43518;187263;1440;8;16;6;10;.625;2046000;0
43518;157903;1422;44;31;5;26;.839;3600000;0
43519;4127;1429;29;36;7;29;.806;2337000;0
43519;174312;1443;64;10;1;9;.900;3600000;0
43519;-1;1429;53;17;2;15;.882;1263000;0
43519;72439;1443;0;0;0;0;.00nan;0;0
43520;2037;1425;0;0;0;0;.00nan;0;0
43520;211293;1430;0;0;0;0;.00nan;0;0
43520;176926;1430;42;28;5;23;.821;3600000;0
43520;64230;1425;74;33;2;31;.939;3600000;0
43521;10112;1453;0;0;0;0;.00nan;0;0
43521;165030;1453;43;25;4;21;.840;3600000;0
43521;148391;4742;64;30;3;27;.900;3600000;0
43521;157845;4742;0;0;0;0;.00nan;0;0
43522;2037;1425;0;0;0;0;.00nan;0;0
43522;211293;1430;42;29;5;24;.828;3600000;0
43522;176926;1430;0;0;0;0;.00nan;0;0
43522;64230;1425;46;44;7;37;.841;3561000;0
43523;174312;1443;0;0;0;0;.00nan;0;0
43523;185136;1440;54;19;2;17;.895;1185000;0
43523;187263;1440;39;36;6;30;.833;2415000;0
43523;72439;1443;59;10;1;9;.900;3600000;0
43524;182561;1426;44;32;5;27;.844;3600000;0
43524;4127;1429;27;27;6;21;.778;3219000;0
43524;185124;1426;0;0;0;0;.00nan;0;0
43524;-1;1429;49;1;0;1;1.000;344000;0
43525;1765;1427;65;38;4;34;.895;3600000;0
43525;9524;1427;0;0;0;0;.00nan;0;0
43525;-1;4961;31;30;6;24;.800;3279000;0
43525;195618;4961;53;2;0;2;1.000;296000;0
43526;182561;1426;17;8;4;4;.500;649000;0
43526;174312;1443;0;0;0;0;.00nan;0;0
43526;185124;1426;59;32;3;29;.906;2951000;0
43526;72439;1443;43;15;3;12;.800;3600000;0
43527;4127;1429;39;12;3;9;.750;600000;0
43527;211293;1430;0;0;0;0;.00nan;0;0
43527;176926;1430;49;23;3;20;.870;3600000;0
43527;-1;1429;48;15;2;13;.867;2955000;0
43528;2037;1425;0;0;0;0;.00nan;0;0
43528;185136;1440;54;3;0;3;1.000;373000;0
43528;187263;1440;34;39;6;33;.846;3227000;0
43528;64230;1425;64;24;3;21;.875;3600000;0
43529;1765;1427;0;0;0;0;.00nan;0;0
43529;9524;1427;51;34;5;29;.853;3521000;0
43529;10112;1453;0;0;0;0;.00nan;0;0
43529;165030;1453;68;34;3;31;.912;3600000;0
43530;1765;1427;0;0;0;0;.00nan;0;0
43530;9524;1427;80;43;3;40;.930;3600000;0
43530;10112;1453;44;30;5;25;.833;3528000;0
43530;165030;1453;0;0;0;0;.00nan;0;0
43531;169438;1422;54;30;4;26;.867;3584000;0
43531;148391;4742;0;0;0;0;.00nan;0;0
43531;157845;4742;74;37;3;34;.919;3600000;0
43531;157903;1422;0;0;0;0;.00nan;0;0
43532;182561;1426;49;49;7;42;.857;2218000;0
43532;174312;1443;59;12;1;11;.917;3600000;0
43532;185124;1426;36;20;4;16;.800;1382000;0
43532;72439;1443;0;0;0;0;.00nan;0;0
43533;211293;1430;0;0;0;0;.00nan;0;0
43533;176926;1430;61;15;1;14;.933;3600000;0
43533;185136;1440;0;0;0;0;.00nan;0;0
43533;187263;1440;69;26;2;24;.923;3551000;0
43534;2037;1425;0;0;0;0;.00nan;0;0
43534;-1;4961;44;24;4;20;.833;3900000;0
43534;195618;4961;0;0;0;0;.00nan;0;0
43534;64230;1425;62;36;4;32;.889;3900000;0
43535;169438;1422;0;0;0;0;.00nan;0;0
43535;148391;4742;69;28;2;26;.929;3600000;0
43535;157845;4742;0;0;0;0;.00nan;0;0
43535;157903;1422;47;27;4;23;.852;3536000;0
43536;4127;1429;34;25;5;20;.800;3826000;0
43536;-1;4961;45;33;4;29;.879;3807000;0
43536;195618;4961;0;0;0;0;.00nan;0;0
43536;-1;1429;0;0;0;0;.00nan;0;0
43537;182561;1426;56;42;5;37;.881;3583000;0
43537;10112;1453;0;0;0;0;.00nan;0;0
43537;165030;1453;41;20;4;16;.800;3600000;0
43537;185124;1426;0;0;0;0;.00nan;0;0
43538;2037;1425;0;0;0;0;.00nan;0;0
43538;4127;1429;63;20;2;18;.900;3563000;0
43538;-1;1429;0;0;0;0;.00nan;0;0
43538;64230;1425;99;37;1;36;.973;3600000;0
43539;169438;1422;41;37;6;31;.838;1977000;0
43539;174312;1443;0;0;0;0;.00nan;0;0
43539;72439;1443;49;6;1;5;.833;3600000;0
43539;157903;1422;71;35;3;32;.914;1623000;0
43540;-1;4961;75;35;4;31;.886;3600000;0
43540;195618;4961;0;0;0;0;.00nan;0;0
43540;185136;1440;0;0;0;0;.00nan;0;0
43540;187263;1440;29;29;6;23;.793;3549000;0
43541;1765;1427;0;0;0;0;.00nan;0;0
43541;9524;1427;63;24;3;21;.875;3600000;0
43541;148391;4742;48;40;6;34;.850;3600000;0
43541;157845;4742;0;0;0;0;.00nan;0;0
43542;182561;1426;0;0;0;0;.00nan;0;0
43542;10112;1453;43;4;1;3;.750;405000;0
43542;165030;1453;24;22;6;16;.727;3118000;0
43542;185124;1426;50;35;5;30;.857;3600000;0
43543;2037;1425;0;0;0;0;.00nan;0;0
43543;4127;1429;0;0;0;0;.00nan;0;0
43543;-1;1429;57;26;3;23;.885;3586000;0
43543;64230;1425;61;20;2;18;.900;3600000;0
43544;211293;1430;0;0;0;0;.00nan;0;0
43544;176926;1430;92;24;0;24;1.000;3600000;0
43544;185136;1440;0;0;0;0;.00nan;0;0
43544;187263;1440;65;29;2;27;.931;3600000;0
43545;1765;1427;0;0;0;0;.00nan;0;0
43545;9524;1427;66;18;1;17;.944;3600000;0
43545;148391;4742;0;0;0;0;.00nan;0;0
43545;157845;4742;68;38;4;34;.895;3600000;0
43546;169438;1422;62;73;8;65;.890;3600000;0
43546;174312;1443;0;0;0;0;.00nan;0;0
43546;72439;1443;69;14;1;13;.929;3600000;0
43546;157903;1422;0;0;0;0;.00nan;0;0
43547;2037;1425;0;0;0;0;.00nan;0;0
43547;169438;1422;0;0;0;0;.00nan;0;0
43547;64230;1425;56;24;3;21;.875;3600000;0
43547;157903;1422;93;20;0;20;1.000;3600000;0
43548;4127;1429;36;12;3;9;.750;518000;0
43548;-1;1429;45;20;3;17;.850;3059000;0
43548;148391;4742;0;0;0;0;.00nan;0;0
43548;157845;4742;49;36;5;31;.861;3600000;0
43549;10112;1453;0;0;0;0;.00nan;0;0
43549;165030;1453;43;35;6;29;.829;3600000;0
43549;185136;1440;0;0;0;0;.00nan;0;0
43549;187263;1440;73;31;2;29;.935;3600000;0
43550;1765;1427;76;48;5;43;.896;3600000;0
43550;9524;1427;0;0;0;0;.00nan;0;0
43550;174312;1443;0;0;0;0;.00nan;0;0
43550;72439;1443;70;23;2;21;.913;3600000;0
43551;-1;4961;63;37;4;33;.892;3600000;0
43551;211293;1430;0;0;0;0;.00nan;0;0
43551;195618;4961;0;0;0;0;.00nan;0;0
43551;176926;1430;99;37;1;36;.973;3600000;0
43552;1765;1427;0;0;0;0;.00nan;0;0
43552;182561;1426;84;43;3;40;.930;3685000;0
43552;9524;1427;51;27;4;23;.852;3685000;0
43552;185124;1426;0;0;0;0;.00nan;0;0
43553;-1;4961;81;15;0;15;1.000;3600000;0
43553;211293;1430;0;0;0;0;.00nan;0;0
43553;195618;4961;0;0;0;0;.00nan;0;0
43553;176926;1430;50;30;4;26;.867;3600000;0
43554;2037;1425;0;0;0;0;.00nan;0;0
43554;169438;1422;0;0;0;0;.00nan;0;0
43554;64230;1425;61;33;5;28;.848;3803000;0
43554;157903;1422;60;31;4;27;.871;3803000;0
43555;4127;1429;28;53;9;44;.830;3600000;0
43555;174312;1443;40;9;2;7;.778;3600000;0
43555;-1;1429;0;0;0;0;.00nan;0;0
43555;72439;1443;0;0;0;0;.00nan;0;0
43556;10112;1453;0;0;0;0;.00nan;0;0
43556;165030;1453;84;35;2;33;.943;3600000;0
43556;185136;1440;0;0;0;0;.00nan;0;0
43556;187263;1440;62;38;4;34;.895;3587000;0
43557;2037;1425;0;0;0;0;.00nan;0;0
43557;185136;1440;0;0;0;0;.00nan;0;0
43557;187263;1440;77;31;2;29;.935;3600000;0
43557;64230;1425;44;22;4;18;.818;3564000;0
43558;10112;1453;0;0;0;0;.00nan;0;0
43558;165030;1453;57;26;3;23;.885;3600000;0
43558;185136;1440;0;0;0;0;.00nan;0;0
43558;187263;1440;70;42;4;38;.905;3590000;0
43559;-1;4961;47;28;4;24;.857;3527000;0
43559;195618;4961;0;0;0;0;.00nan;0;0
43559;148391;4742;65;25;3;22;.880;3600000;0
43559;157845;4742;0;0;0;0;.00nan;0;0
43560;174312;1443;0;0;0;0;.00nan;0;0
43560;211293;1430;0;0;0;0;.00nan;0;0
43560;176926;1430;86;45;3;42;.933;3600000;0
43560;72439;1443;80;13;0;13;1.000;3600000;0
43561;4127;1429;57;36;4;32;.889;3559000;0
43561;169438;1422;60;27;3;24;.889;3600000;0
43561;-1;1429;0;0;0;0;.00nan;0;0
43561;157903;1422;0;0;0;0;.00nan;0;0
43562;1765;1427;0;0;0;0;.00nan;0;0
43562;182561;1426;86;37;3;34;.919;3548000;0
43562;9524;1427;57;23;2;21;.913;3600000;0
43562;185124;1426;0;0;0;0;.00nan;0;0
43563;182561;1426;75;54;5;49;.907;3600000;0
43563;174312;1443;0;0;0;0;.00nan;0;0
43563;185124;1426;0;0;0;0;.00nan;0;0
43563;72439;1443;61;11;1;10;.909;3600000;0
43564;211293;1430;0;0;0;0;.00nan;0;0
43564;176926;1430;48;23;3;20;.870;3588000;0
43564;148391;4742;0;0;0;0;.00nan;0;0
43564;157845;4742;66;16;1;15;.938;3600000;0
43565;2037;1425;0;0;0;0;.00nan;0;0
43565;10112;1453;0;0;0;0;.00nan;0;0
43565;165030;1453;74;33;3;30;.909;3600000;0
43565;64230;1425;93;21;0;21;1.000;3600000;0
43566;1765;1427;57;37;4;33;.892;3581000;0
43566;9524;1427;0;0;0;0;.00nan;0;0
43566;169438;1422;0;0;0;0;.00nan;0;0
43566;157903;1422;65;31;3;28;.903;3600000;0
43567;4127;1429;74;22;1;21;.955;3600000;0
43567;-1;4961;53;36;5;31;.861;3600000;0
43567;195618;4961;0;0;0;0;.00nan;0;0
43567;-1;1429;0;0;0;0;.00nan;0;0
43568;2037;1425;0;0;0;0;.00nan;0;0
43568;10112;1453;0;0;0;0;.00nan;0;0
43568;165030;1453;40;35;6;29;.829;3563000;0
43568;64230;1425;55;23;4;19;.826;3600000;0
43569;182561;1426;76;41;3;38;.927;3900000;0
43569;211293;1430;0;0;0;0;.00nan;0;0
43569;176926;1430;76;29;3;26;.897;3900000;0
43569;185124;1426;0;0;0;0;.00nan;0;0
43570;174312;1443;0;0;0;0;.00nan;0;0
43570;72439;1443;55;12;2;10;.833;3600000;0
43570;148391;4742;0;0;0;0;.00nan;0;0
43570;157845;4742;80;50;4;46;.920;3576000;0
43571;4127;1429;62;10;1;9;.900;3600000;0
43571;185136;1440;0;0;0;0;.00nan;0;0
43571;187263;1440;61;43;5;38;.884;3600000;0
43571;-1;1429;0;0;0;0;.00nan;0;0
43572;1765;1427;75;23;1;22;.957;3600000;0
43572;-1;4961;95;43;2;41;.953;3551000;0
43572;169438;1427;0;0;0;0;.00nan;0;0
43572;195618;4961;0;0;0;0;.00nan;0;0
43573;182561;1426;48;21;3;18;.857;3600000;0
43573;211293;1430;0;0;0;0;.00nan;0;0
43573;176926;1430;40;23;4;19;.826;3594000;0
43573;185124;1426;0;0;0;0;.00nan;0;0
43574;9524;1422;56;19;2;17;.895;3600000;0
43574;10112;1453;0;0;0;0;.00nan;0;0
43574;165030;1453;89;47;3;44;.936;3600000;0
43574;157903;1422;0;0;0;0;.00nan;0;0
43575;174312;1443;41;13;3;10;.769;3600000;0
43575;72439;1443;0;0;0;0;.00nan;0;0
43575;148391;4742;91;61;5;56;.918;3600000;0
43575;157845;4742;0;0;0;0;.00nan;0;0
43576;4127;1429;34;21;5;16;.762;3555000;0
43576;185136;1440;0;0;0;0;.00nan;0;0
43576;187263;1440;85;47;3;44;.936;3600000;0
43576;-1;1429;0;0;0;0;.00nan;0;0
43577;1765;1427;0;0;0;0;.00nan;0;0
43577;-1;4961;25;44;8;36;.818;3600000;0
43577;169438;1427;76;28;1;27;.964;3600000;0
43577;195618;4961;0;0;0;0;.00nan;0;0
43578;2037;1425;0;0;0;0;.00nan;0;0
43578;64230;1425;100;29;0;29;1.000;3600000;0
43578;148391;4742;0;0;0;0;.00nan;0;0
43578;157845;4742;47;24;4;20;.833;3600000;0
43579;9524;1422;65;20;2;18;.900;3600000;0
43579;148391;4742;62;42;5;37;.881;3600000;0
43579;157845;4742;0;0;0;0;.00nan;0;0
43579;157903;1422;0;0;0;0;.00nan;0;0
43580;4127;1429;80;19;1;18;.947;3600000;0
43580;211293;1430;52;4;0;4;1.000;243000;0
43580;176926;1430;50;41;6;35;.854;3357000;0
43580;-1;1429;0;0;0;0;.00nan;0;0
43581;1765;1427;0;0;0;0;.00nan;0;0
43581;169438;1427;55;30;4;26;.867;3900000;0
43581;185136;1440;0;0;0;0;.00nan;0;0
43581;187263;1440;61;37;4;33;.892;3900000;0
43582;182561;1426;26;7;3;4;.571;267000;0
43582;-1;4961;90;34;1;33;.971;3600000;0
43582;195618;4961;0;0;0;0;.00nan;0;0
43582;185124;1426;38;18;4;14;.778;3333000;0
43583;182561;1426;55;23;3;20;.870;3514000;0
43583;-1;4961;92;34;1;33;.971;3600000;0
43583;195618;4961;0;0;0;0;.00nan;0;0
43583;185124;1426;0;0;0;0;.00nan;0;0
43584;10112;1453;0;0;0;0;.00nan;0;0
43584;165030;1453;49;11;2;9;.818;3600000;0
43584;185136;1440;0;0;0;0;.00nan;0;0
43584;187263;1440;37;40;7;33;.825;3600000;0
43585;1765;1427;0;0;0;0;.00nan;0;0
43585;169438;1427;68;38;4;34;.895;3900000;0
43585;211293;1430;64;42;4;38;.905;3900000;0
43585;176926;1430;0;0;0;0;.00nan;0;0
43586;4127;1429;55;30;3;27;.900;3900000;0
43586;9524;1422;48;21;3;18;.857;3900000;0
43586;-1;1429;0;0;0;0;.00nan;0;0
43586;157903;1422;0;0;0;0;.00nan;0;0
43587;2037;1425;37;8;2;6;.750;348000;0
43587;174312;1443;0;0;0;0;.00nan;0;0
43587;64230;1425;15;39;9;30;.769;3252000;0
43587;72439;1443;60;22;3;19;.864;3600000;0
43588;182561;1426;80;40;3;37;.925;3561000;0
43588;4127;1429;86;31;2;29;.935;3600000;0
43588;185124;1426;0;0;0;0;.00nan;0;0
43588;-1;1429;0;0;0;0;.00nan;0;0
43589;10112;1453;0;0;0;0;.00nan;0;0
43589;165030;1453;68;34;3;31;.912;3600000;0
43589;-1;4961;53;35;5;30;.857;3578000;0
43589;195618;4961;0;0;0;0;.00nan;0;0
43590;2037;1425;0;0;0;0;.00nan;0;0
43590;174312;1443;0;0;0;0;.00nan;0;0
43590;64230;1425;88;63;4;59;.937;3581000;0
43590;72439;1443;45;10;2;8;.800;3600000;0
43591;185136;1440;0;0;0;0;.00nan;0;0
43591;187263;1440;74;32;2;30;.938;3600000;0
43591;148391;4742;0;0;0;0;.00nan;0;0
43591;157845;4742;31;17;4;13;.765;3547000;0
43592;1765;1427;51;10;1;9;.900;901000;0
43592;9524;1422;44;35;5;30;.857;3600000;0
43592;169438;1427;17;25;6;19;.760;2612000;0
43592;157903;1422;0;0;0;0;.00nan;0;0
43593;10112;1453;0;0;0;0;.00nan;0;0
43593;165030;1453;63;27;3;24;.889;3600000;0
43593;211293;1430;0;0;0;0;.00nan;0;0
43593;176926;1430;57;12;1;11;.917;3600000;0
43594;9524;1422;31;25;6;19;.760;3582000;0
43594;148391;4742;55;29;4;25;.862;1943000;0
43594;157845;4742;65;17;1;16;.941;1657000;0
43594;157903;1422;0;0;0;0;.00nan;0;0
43595;1765;1427;0;0;0;0;.00nan;0;0
43595;169438;1427;75;46;4;42;.913;3600000;0
43595;174312;1443;68;22;2;20;.909;3600000;0
43595;72439;1443;0;0;0;0;.00nan;0;0
43596;182561;1426;89;44;3;41;.932;3900000;0
43596;4127;1429;76;24;0;24;1.000;3478000;0
43596;185124;1426;0;0;0;0;.00nan;0;0
43596;-1;1429;25;5;3;2;.400;422000;0
43597;-1;4961;0;0;0;0;.00nan;0;0
43597;195618;4961;60;36;4;32;.889;3600000;0
43597;185136;1440;54;11;1;10;.909;1134000;0
43597;187263;1440;28;29;6;23;.793;2466000;0
43598;182561;1426;64;22;2;20;.909;3600000;0
43598;185124;1426;0;0;0;0;.00nan;0;0
43598;185136;1440;0;0;0;0;.00nan;0;0
43598;187263;1440;36;31;6;25;.806;3600000;0
43599;10112;1453;0;0;0;0;.00nan;0;0
43599;165030;1453;32;29;6;23;.793;3600000;0
43599;148391;4742;86;29;1;28;.966;3600000;0
43599;157845;4742;0;0;0;0;.00nan;0;0
43600;4127;1429;89;17;0;17;1.000;3600000;0
43600;211293;1430;0;0;0;0;.00nan;0;0
43600;176926;1430;48;38;6;32;.842;3600000;0
43600;-1;1429;0;0;0;0;.00nan;0;0
43601;1765;1427;0;0;0;0;.00nan;0;0
43601;2037;1425;0;0;0;0;.00nan;0;0
43601;169438;1427;44;37;5;32;.865;3549000;0
43601;64230;1425;51;23;3;20;.870;3600000;0
43602;9524;1422;64;31;4;27;.871;3818000;0
43602;-1;4961;59;37;5;32;.865;3818000;0
43602;195618;4961;0;0;0;0;.00nan;0;0
43602;157903;1422;0;0;0;0;.00nan;0;0
43603;2037;1425;0;0;0;0;.00nan;0;0
43603;-1;4961;72;29;2;27;.931;3579000;0
43603;195618;4961;0;0;0;0;.00nan;0;0
43603;64230;1425;75;20;1;19;.950;3600000;0
43604;1765;1427;0;0;0;0;.00nan;0;0
43604;169438;1427;34;27;5;22;.815;3600000;0
43604;148391;4742;0;0;0;0;.00nan;0;0
43604;157845;4742;46;39;6;33;.846;3600000;0
43605;182561;1426;3;15;6;9;.600;1433000;0
43605;9524;1422;56;29;5;24;.828;3600000;0
43605;185124;1426;78;21;0;21;1.000;2113000;0
43605;157903;1422;0;0;0;0;.00nan;0;0
43606;174312;1443;0;0;0;0;.00nan;0;0
43606;211293;1430;60;46;6;40;.870;2226000;0
43606;176926;1430;47;31;5;26;.839;1374000;0
43606;72439;1443;65;4;0;4;1.000;3600000;0
43607;4127;1429;66;27;3;24;.889;3600000;0
43607;10112;1453;0;0;0;0;.00nan;0;0
43607;165030;1453;77;42;5;37;.881;3580000;0
43607;-1;1429;0;0;0;0;.00nan;0;0
43608;4127;1429;51;32;4;28;.875;3600000;0
43608;211293;1430;0;0;0;0;.00nan;0;0
43608;176926;1430;43;43;6;37;.860;3600000;0
43608;-1;1429;0;0;0;0;.00nan;0;0
43609;182561;1426;26;15;4;11;.733;1068000;0
43609;10112;1453;0;0;0;0;.00nan;0;0
43609;165030;1453;58;32;5;27;.844;3600000;0
43609;185124;1426;43;24;4;20;.833;2532000;0
43610;2037;1425;0;0;0;0;.00nan;0;0
43610;9524;1422;33;19;5;14;.737;2328000;0
43610;64230;1425;94;31;1;30;.968;3600000;0
43610;157903;1422;57;12;1;11;.917;1272000;0
43611;-1;4961;68;63;6;57;.905;3325000;0
43611;174312;1443;0;0;0;0;.00nan;0;0
43611;195618;4961;47;5;1;4;.800;275000;0
43611;72439;1443;53;8;1;7;.875;3600000;0
43612;185136;1440;0;0;0;0;.00nan;0;0
43612;187263;1440;92;45;1;44;.978;3600000;0
43612;148391;4742;31;28;6;22;.786;3600000;0
43612;157845;4742;0;0;0;0;.00nan;0;0
43613;1765;1427;0;0;0;0;.00nan;0;0
43613;169438;1427;73;29;3;26;.897;3600000;0
43613;211293;1430;0;0;0;0;.00nan;0;0
43613;176926;1430;9;22;7;15;.682;3600000;0
43614;182561;1426;21;23;6;17;.739;2551000;0
43614;211293;1430;0;0;0;0;.00nan;0;0
43614;176926;1430;48;19;3;16;.842;3600000;0
43614;185124;1426;63;10;0;10;1.000;1049000;0
43615;2037;1425;0;0;0;0;.00nan;0;0
43615;9524;1422;40;22;4;18;.818;3557000;0
43615;64230;1425;65;25;3;22;.880;3600000;0
43615;157903;1422;0;0;0;0;.00nan;0;0
43616;4127;1429;98;61;4;57;.934;3543000;0
43616;174312;1443;55;22;3;19;.864;3600000;0
43616;-1;1429;0;0;0;0;.00nan;0;0
43616;72439;1443;0;0;0;0;.00nan;0;0
43617;185136;1440;77;43;3;40;.930;3600000;0
43617;187263;1440;0;0;0;0;.00nan;0;0
43617;148391;4742;0;0;0;0;.00nan;0;0
43617;157845;4742;61;21;2;19;.905;3600000;0
43618;10112;1453;0;0;0;0;.00nan;0;0
43618;165030;1453;47;33;5;28;.848;3746000;0
43618;-1;4961;53;29;4;25;.862;3746000;0
43618;195618;4961;0;0;0;0;.00nan;0;0
43619;2037;1425;0;0;0;0;.00nan;0;0
43619;10112;1453;0;0;0;0;.00nan;0;0
43619;165030;1453;71;24;1;23;.958;3600000;0
43619;64230;1425;76;32;2;30;.938;3552000;0
43620;211293;1430;0;0;0;0;.00nan;0;0
43620;176926;1430;58;38;4;34;.895;3682000;0
43620;148391;4742;71;33;3;30;.909;3682000;0
43620;157845;4742;0;0;0;0;.00nan;0;0
43621;4127;1429;70;28;2;26;.929;3600000;0
43621;9524;1422;35;32;6;26;.813;2828000;0
43621;-1;1429;0;0;0;0;.00nan;0;0
43621;157903;1422;63;6;0;6;1.000;772000;0
43622;174312;1443;0;0;0;0;.00nan;0;0
43622;185136;1440;0;0;0;0;.00nan;0;0
43622;187263;1440;47;59;8;51;.864;3600000;0
43622;72439;1443;37;6;2;4;.667;3600000;0
43623;1765;1427;0;0;0;0;.00nan;0;0
43623;-1;4961;62;30;3;27;.900;3600000;0
43623;169438;1427;98;25;0;25;1.000;3600000;0
43623;195618;4961;0;0;0;0;.00nan;0;0
43624;1765;1427;0;0;0;0;.00nan;0;0
43624;182561;1426;0;0;0;0;.00nan;0;0
43624;169438;1427;75;29;2;27;.931;3600000;0
43624;185124;1426;67;35;3;32;.914;3583000;0
43625;211293;1430;0;0;0;0;.00nan;0;0
43625;176926;1430;73;24;1;23;.958;3600000;0
43625;185136;1440;0;0;0;0;.00nan;0;0
43625;187263;1440;43;19;3;16;.842;3531000;0
43626;2037;1425;92;53;2;51;.962;3752000;0
43626;174312;1443;61;13;1;12;.923;3752000;0
43626;64230;1425;0;0;0;0;.00nan;0;0
43626;72439;1443;0;0;0;0;.00nan;0;0
43627;9524;1422;60;21;2;19;.905;3533000;0
43627;10112;1453;0;0;0;0;.00nan;0;0
43627;165030;1453;91;38;1;37;.974;3600000;0
43627;157903;1422;0;0;0;0;.00nan;0;0
43628;-1;4961;59;22;2;20;.909;3600000;0
43628;195618;4961;0;0;0;0;.00nan;0;0
43628;148391;4742;0;0;0;0;.00nan;0;0
43628;157845;4742;37;31;5;26;.839;3600000;0
43629;4127;1429;64;29;4;25;.862;3600000;0
43629;10112;1453;55;33;5;28;.848;3547000;0
43629;165030;1453;0;0;0;0;.00nan;0;0
43629;-1;1429;0;0;0;0;.00nan;0;0
43630;174312;1443;0;0;0;0;.00nan;0;0
43630;211293;1430;43;18;3;15;.833;1219000;0
43630;176926;1430;55;40;6;34;.850;2381000;0
43630;72439;1443;84;8;0;8;1.000;3600000;0
43631;-1;4961;49;21;3;18;.857;3600000;0
43631;195618;4961;0;0;0;0;.00nan;0;0
43631;148391;4742;40;28;5;23;.821;3568000;0
43631;157845;4742;0;0;0;0;.00nan;0;0
43632;2037;1425;0;0;0;0;.00nan;0;0
43632;185136;1440;0;0;0;0;.00nan;0;0
43632;187263;1440;49;28;4;24;.857;3543000;0
43632;64230;1425;67;25;3;22;.880;3600000;0
43633;1765;1427;0;0;0;0;.00nan;0;0
43633;182561;1426;62;33;3;30;.909;3600000;0
43633;169438;1427;70;36;4;32;.889;3543000;0
43633;185124;1426;0;0;0;0;.00nan;0;0
43634;182561;1426;88;28;1;27;.964;3900000;0
43634;10112;1453;0;0;0;0;.00nan;0;0
43634;165030;1453;97;37;1;36;.973;3900000;0
43634;185124;1426;0;0;0;0;.00nan;0;0
43635;1765;1427;0;0;0;0;.00nan;0;0
43635;2037;1425;0;0;0;0;.00nan;0;0
43635;169438;1427;71;29;2;27;.931;3600000;0
43635;64230;1425;47;29;4;25;.862;3511000;0
43636;9524;1422;70;22;2;20;.909;3600000;0
43636;211293;1430;0;0;0;0;.00nan;0;0
43636;176926;1430;58;35;4;31;.886;3600000;0
43636;157903;1422;0;0;0;0;.00nan;0;0
43637;174312;1443;0;0;0;0;.00nan;0;0
43637;185136;1440;30;32;6;26;.813;2229000;0
43637;187263;1440;54;31;4;27;.871;1371000;0
43637;72439;1443;38;5;2;3;.600;3600000;0
43638;4127;1429;70;18;1;17;.944;3600000;0
43638;-1;4961;0;0;0;0;.00nan;0;0
43638;195618;4961;81;46;4;42;.913;3600000;0
43638;-1;1429;0;0;0;0;.00nan;0;0
43639;2037;1425;38;6;2;4;.667;1843000;0
43639;211293;1430;0;0;0;0;.00nan;0;0
43639;176926;1430;72;31;3;28;.903;3600000;0
43639;64230;1425;18;20;6;14;.700;1757000;0
43640;182561;1426;39;29;5;24;.828;3600000;0
43640;185124;1426;0;0;0;0;.00nan;0;0
43640;148391;4742;0;0;0;0;.00nan;0;0
43640;157845;4742;81;36;2;34;.944;3600000;0
43641;9524;1422;41;17;3;14;.824;3573000;0
43641;185136;1440;0;0;0;0;.00nan;0;0
43641;187263;1440;74;30;2;28;.933;3600000;0
43641;157903;1422;0;0;0;0;.00nan;0;0
43642;1765;1427;0;0;0;0;.00nan;0;0
43642;10112;1453;0;0;0;0;.00nan;0;0
43642;165030;1453;55;27;3;24;.889;3561000;0
43642;169438;1427;69;29;2;27;.931;3600000;0
43643;-1;4961;66;54;6;48;.889;2949000;0
43643;174312;1443;0;0;0;0;.00nan;0;0
43643;195618;4961;22;14;4;10;.714;651000;0
43643;72439;1443;71;6;0;6;1.000;3600000;0
43644;182561;1426;0;0;0;0;.00nan;0;0
43644;185124;1426;84;33;2;31;.939;3600000;0
43644;148391;4742;47;21;3;18;.857;3584000;0
43644;157845;4742;0;0;0;0;.00nan;0;0
43645;2037;1425;0;0;0;0;.00nan;0;0
43645;211293;1430;0;0;0;0;.00nan;0;0
43645;176926;1430;63;23;2;21;.913;3664000;0
43645;64230;1425;75;37;3;34;.919;3664000;0
43646;9524;1422;77;27;2;25;.926;3600000;0
43646;185136;1440;0;0;0;0;.00nan;0;0
43646;187263;1440;72;46;5;41;.891;3600000;0
43646;157903;1422;0;0;0;0;.00nan;0;0
43647;10112;1453;48;25;4;21;.840;1618000;0
43647;165030;1453;29;31;6;25;.806;1982000;0
43647;174312;1443;0;0;0;0;.00nan;0;0
43647;72439;1443;60;15;1;14;.933;3600000;0
43648;4127;1429;36;17;4;13;.765;3600000;0
43648;-1;4961;98;65;6;59;.908;3600000;0
43648;195618;4961;0;0;0;0;.00nan;0;0
43648;-1;1429;0;0;0;0;.00nan;0;0
43649;182561;1426;15;9;4;5;.556;648000;0
43649;174312;1443;0;0;0;0;.00nan;0;0
43649;185124;1426;81;31;1;30;.968;2952000;0
43649;72439;1443;43;9;2;7;.778;3600000;0
43650;10112;1453;0;0;0;0;.00nan;0;0
43650;165030;1453;67;31;3;28;.903;3600000;0
43650;211293;1430;0;0;0;0;.00nan;0;0
43650;176926;1430;34;35;7;28;.800;3600000;0
43651;2037;1425;0;0;0;0;.00nan;0;0
43651;64230;1425;60;21;3;18;.857;3900000;0
43651;148391;4742;73;31;3;28;.903;3900000;0
43651;157845;4742;0;0;0;0;.00nan;0;0
43652;9524;1422;62;25;3;22;.880;3600000;0
43652;-1;4961;69;40;4;36;.900;3576000;0
43652;195618;4961;0;0;0;0;.00nan;0;0
43652;157903;1422;0;0;0;0;.00nan;0;0
43653;182561;1426;58;29;4;25;.862;3600000;0
43653;185124;1426;0;0;0;0;.00nan;0;0
43653;185136;1440;0;0;0;0;.00nan;0;0
43653;187263;1440;48;39;7;32;.821;3600000;0
43654;1765;1427;42;38;6;32;.842;3553000;0
43654;4127;1429;45;27;5;22;.815;3600000;0
43654;169438;1427;0;0;0;0;.00nan;0;0
43654;-1;1429;0;0;0;0;.00nan;0;0
43655;1765;1427;0;0;0;0;.00nan;0;0
43655;169438;1427;69;29;3;26;.897;3900000;0
43655;211293;1430;0;0;0;0;.00nan;0;0
43655;176926;1430;84;37;3;34;.919;3900000;0
43656;2037;1425;0;0;0;0;.00nan;0;0
43656;182561;1426;43;34;6;28;.824;3600000;0
43656;185124;1426;0;0;0;0;.00nan;0;0
43656;64230;1425;97;31;2;29;.935;3600000;0
43657;9524;1422;80;49;4;45;.918;3600000;0
43657;174312;1443;63;15;1;14;.933;3600000;0
43657;72439;1443;0;0;0;0;.00nan;0;0
43657;157903;1422;0;0;0;0;.00nan;0;0
43658;4127;1429;0;0;0;0;.00nan;0;0
43658;-1;1429;65;28;3;25;.893;3600000;0
43658;148391;4742;0;0;0;0;.00nan;0;0
43658;157845;4742;48;30;4;26;.867;3545000;0
43659;-1;4961;0;0;0;0;.00nan;0;0
43659;195618;4961;33;22;4;18;.818;3557000;0
43659;185136;1440;0;0;0;0;.00nan;0;0
43659;187263;1440;66;38;3;35;.921;3600000;0
43660;1765;1427;0;0;0;0;.00nan;0;0
43660;10112;1453;0;0;0;0;.00nan;0;0
43660;165030;1453;62;24;2;22;.917;3600000;0
43660;169438;1427;62;32;4;28;.875;3551000;0
43661;9524;1422;66;24;2;22;.917;3600000;0
43661;211293;1430;0;0;0;0;.00nan;0;0
43661;176926;1430;65;30;3;27;.900;3571000;0
43661;157903;1422;0;0;0;0;.00nan;0;0
43662;182561;1426;45;51;7;44;.863;2349000;0
43662;174312;1443;0;0;0;0;.00nan;0;0
43662;185124;1426;69;23;1;22;.957;1251000;0
43662;72439;1443;67;5;0;5;1.000;3600000;0
43663;2037;1425;0;0;0;0;.00nan;0;0
43663;4127;1429;77;26;1;25;.962;3600000;0
43663;-1;1429;0;0;0;0;.00nan;0;0
43663;64230;1425;26;33;7;26;.788;3600000;0
43664;-1;4961;46;27;4;23;.852;3560000;0
43664;195618;4961;0;0;0;0;.00nan;0;0
43664;185136;1440;0;0;0;0;.00nan;0;0
43664;187263;1440;54;21;3;18;.857;3600000;0
43665;1765;1427;64;26;3;23;.885;3600000;0
43665;169438;1427;0;0;0;0;.00nan;0;0
43665;148391;4742;60;42;4;38;.905;3564000;0
43665;157845;4742;0;0;0;0;.00nan;0;0
43666;182561;1426;38;14;3;11;.786;3600000;0
43666;185124;1426;0;0;0;0;.00nan;0;0
43666;185136;1440;0;0;0;0;.00nan;0;0
43666;187263;1440;49;47;7;40;.851;3600000;0
43667;2037;1425;0;0;0;0;.00nan;0;0
43667;4127;1429;45;27;4;23;.852;3563000;0
43667;-1;1429;0;0;0;0;.00nan;0;0
43667;64230;1425;65;25;3;22;.880;3600000;0
43668;10112;1453;0;0;0;0;.00nan;0;0
43668;165030;1453;78;35;2;33;.943;3600000;0
43668;148391;4742;0;0;0;0;.00nan;0;0
43668;157845;4742;50;24;3;21;.875;3555000;0
43669;9524;1422;82;40;4;36;.900;3583000;0
43669;174312;1443;0;0;0;0;.00nan;0;0
43669;72439;1443;50;17;3;14;.824;3600000;0
43669;157903;1422;0;0;0;0;.00nan;0;0
43670;-1;4961;49;25;3;22;.880;3551000;0
43670;211293;1430;0;0;0;0;.00nan;0;0
43670;195618;4961;0;0;0;0;.00nan;0;0
43670;176926;1430;76;21;1;20;.952;3600000;0
43671;2037;1425;0;0;0;0;.00nan;0;0
43671;185136;1440;0;0;0;0;.00nan;0;0
43671;187263;1440;75;46;4;42;.913;3600000;0
43671;64230;1425;64;18;2;16;.889;3600000;0
43672;182561;1426;65;38;4;34;.895;3564000;0
43672;9524;1422;72;28;3;25;.893;3600000;0
43672;185124;1426;0;0;0;0;.00nan;0;0
43672;157903;1422;0;0;0;0;.00nan;0;0
43673;10112;1453;0;0;0;0;.00nan;0;0
43673;165030;1453;86;28;1;27;.964;3600000;0
43673;-1;4961;62;39;4;35;.897;3600000;0
43673;195618;4961;0;0;0;0;.00nan;0;0
43674;4127;1429;80;28;1;27;.964;3600000;0
43674;-1;1429;0;0;0;0;.00nan;0;0
43674;148391;4742;44;41;7;34;.829;3600000;0
43674;157845;4742;0;0;0;0;.00nan;0;0
43675;211293;1430;0;0;0;0;.00nan;0;0
43675;176926;1430;89;34;2;32;.941;3900000;0
43675;185136;1440;0;0;0;0;.00nan;0;0
43675;187263;1440;56;23;2;21;.913;3900000;0
43676;1765;1427;0;0;0;0;.00nan;0;0
43676;169438;1427;68;46;4;42;.913;3600000;0
43676;174312;1443;0;0;0;0;.00nan;0;0
43676;72439;1443;53;11;1;10;.909;3600000;0
43677;2037;1425;0;0;0;0;.00nan;0;0
43677;211293;1430;61;37;4;33;.892;3539000;0
43677;176926;1430;0;0;0;0;.00nan;0;0
43677;64230;1425;77;29;2;27;.931;3600000;0
43678;1765;1427;53;37;5;32;.865;3600000;0
43678;9524;1422;0;0;0;0;.00nan;0;0
43678;169438;1427;0;0;0;0;.00nan;0;0
43678;157903;1422;79;25;1;24;.960;3600000;0
43679;174312;1443;24;12;4;8;.667;3600000;0
43679;72439;1443;0;0;0;0;.00nan;0;0
43679;148391;4742;47;6;1;5;.833;313000;0
43679;157845;4742;56;45;6;39;.867;3287000;0
43680;182561;1426;0;0;0;0;.00nan;0;0
43680;4127;1429;0;0;0;0;.00nan;0;0
43680;185124;1426;77;41;3;38;.927;3600000;0
43680;-1;1429;17;23;6;17;.739;3600000;0
43681;10112;1453;0;0;0;0;.00nan;0;0
43681;165030;1453;72;44;4;40;.909;3600000;0
43681;-1;4961;60;26;3;23;.885;3600000;0
43681;195618;4961;0;0;0;0;.00nan;0;0
43683;4127;1429;56;24;3;21;.875;3600000;0
43683;10112;1453;0;0;0;0;.00nan;0;0
43683;165030;1453;50;31;4;27;.871;3557000;0
43683;-1;1429;0;0;0;0;.00nan;0;0
43685;1765;1427;0;0;0;0;.00nan;0;0
43685;2037;1425;0;0;0;0;.00nan;0;0
43685;9524;1427;32;23;5;18;.783;3600000;0
43685;64230;1425;69;21;2;19;.905;3600000;0
43687;169438;1422;67;27;2;25;.926;3900000;0
43687;148391;4742;0;0;0;0;.00nan;0;0
43687;157845;4742;86;38;2;36;.947;3900000;0
43687;157903;1422;0;0;0;0;.00nan;0;0
43689;182561;1426;80;28;1;27;.964;3600000;0
43689;-1;4961;59;47;5;42;.894;3600000;0
43689;195618;4961;0;0;0;0;.00nan;0;0
43689;185124;1426;0;0;0;0;.00nan;0;0
43691;200849;1440;30;14;4;10;.714;989000;0
43691;174312;1443;0;0;0;0;.00nan;0;0
43691;185136;1440;63;40;4;36;.900;2611000;0
43691;72439;1443;71;6;0;6;1.000;3600000;0
43693;-1;4961;73;45;5;40;.889;3600000;0
43693;174312;1443;0;0;0;0;.00nan;0;0
43693;195618;4961;0;0;0;0;.00nan;0;0
43693;72439;1443;73;23;1;22;.957;3600000;0
43695;182561;1426;68;33;3;30;.909;3600000;0
43695;10112;1453;0;0;0;0;.00nan;0;0
43695;165030;1453;51;40;5;35;.875;3569000;0
43695;185124;1426;0;0;0;0;.00nan;0;0
43697;2037;1425;0;0;0;0;.00nan;0;0
43697;200849;1440;0;0;0;0;.00nan;0;0
43697;185136;1440;67;49;5;44;.898;3600000;0
43697;64230;1425;60;13;1;12;.923;3600000;0
43699;4127;1429;80;12;0;12;1.000;3600000;0
43699;-1;1429;0;0;0;0;.00nan;0;0
43699;148391;4742;0;0;0;0;.00nan;0;0
43699;157845;4742;87;42;3;39;.929;3600000;0
43701;1765;1427;0;0;0;0;.00nan;0;0
43701;9524;1427;54;30;4;26;.867;3555000;0
43701;211293;1430;0;0;0;0;.00nan;0;0
43701;176926;1430;55;21;2;19;.905;3600000;0
43703;182561;1426;0;0;0;0;.00nan;0;0
43703;185124;1426;56;26;3;23;.885;3900000;0
43703;148391;4742;56;27;3;24;.889;3900000;0
43703;157845;4742;0;0;0;0;.00nan;0;0
43705;2037;1425;76;38;3;35;.921;3576000;0
43705;4127;1429;70;27;2;25;.926;3600000;0
43705;-1;1429;0;0;0;0;.00nan;0;0
43705;64230;1425;0;0;0;0;.00nan;0;0
43707;1765;1427;91;34;3;31;.912;3600000;0
43707;9524;1427;0;0;0;0;.00nan;0;0
43707;169438;1422;0;0;0;0;.00nan;0;0
43707;157903;1422;54;26;4;22;.846;3600000;0
43709;10112;1453;60;25;3;22;.880;3900000;0
43709;165030;1453;0;0;0;0;.00nan;0;0
43709;-1;4961;62;24;3;21;.875;3900000;0
43709;195618;4961;0;0;0;0;.00nan;0;0
43711;200849;1440;51;26;3;23;.885;3600000;0
43711;211293;1430;0;0;0;0;.00nan;0;0
43711;176926;1430;100;40;0;40;1.000;3600000;0
43711;185136;1440;0;0;0;0;.00nan;0;0
43713;169438;1422;50;7;1;6;.857;3600000;0
43713;200849;1440;0;0;0;0;.00nan;0;0
43713;185136;1440;74;51;4;47;.922;3600000;0
43713;157903;1422;0;0;0;0;.00nan;0;0
43715;4127;1429;27;24;6;18;.750;3600000;0
43715;211293;1430;0;0;0;0;.00nan;0;0
43715;176926;1430;81;45;3;42;.933;3600000;0
43715;-1;1429;0;0;0;0;.00nan;0;0
43717;182561;1426;73;30;2;28;.933;3578000;0
43717;10112;1453;0;0;0;0;.00nan;0;0
43717;165030;1453;65;16;1;15;.938;3600000;0
43717;185124;1426;0;0;0;0;.00nan;0;0
43719;1765;1427;60;8;0;8;1.000;706000;0
43719;9524;1427;71;49;6;43;.878;2894000;0
43719;174312;1443;0;0;0;0;.00nan;0;0
43719;72439;1443;64;27;3;24;.889;3600000;0
43721;-1;4961;85;36;4;32;.889;3600000;0
43721;195618;4961;0;0;0;0;.00nan;0;0
43721;148391;4742;0;0;0;0;.00nan;0;0
43721;157845;4742;82;25;1;24;.960;3600000;0
43723;-1;4961;50;55;8;47;.855;3134000;0
43723;174312;1443;40;7;2;5;.714;3600000;0
43723;195618;4961;62;8;0;8;1.000;466000;0
43723;72439;1443;0;0;0;0;.00nan;0;0
43725;2037;1425;0;0;0;0;.00nan;0;0
43725;200849;1440;89;31;1;30;.968;3600000;0
43725;185136;1440;0;0;0;0;.00nan;0;0
43725;64230;1425;64;34;4;30;.882;3600000;0
43727;182561;1426;0;0;0;0;.00nan;0;0
43727;185124;1426;32;23;5;18;.783;3600000;0
43727;148391;4742;62;21;2;19;.905;3600000;0
43727;157845;4742;0;0;0;0;.00nan;0;0
43729;1765;1427;73;29;2;27;.931;3600000;0
43729;4127;1429;0;0;0;0;.00nan;0;0
43729;9524;1427;0;0;0;0;.00nan;0;0
43729;-1;1429;6;20;6;14;.700;3600000;0
43731;10112;1453;60;22;2;20;.909;3600000;0
43731;165030;1453;0;0;0;0;.00nan;0;0
43731;211293;1430;69;33;3;30;.909;3600000;0
43731;176926;1430;0;0;0;0;.00nan;0;0
43733;200849;1440;0;0;0;0;.00nan;0;0
43733;185136;1440;45;32;5;27;.844;3600000;0
43733;148391;4742;0;0;0;0;.00nan;0;0
43733;157845;4742;51;42;6;36;.857;3548000;0
43735;-1;4961;74;56;6;50;.893;3202000;0
43735;174312;1443;0;0;0;0;.00nan;0;0
43735;195618;4961;38;14;3;11;.786;398000;0
43735;72439;1443;40;8;2;6;.750;3600000;0
43737;4127;1429;82;25;1;24;.960;3600000;0
43737;10112;1453;0;0;0;0;.00nan;0;0
43737;165030;1453;48;23;4;19;.826;3600000;0
43737;-1;1429;0;0;0;0;.00nan;0;0
43739;182561;1426;63;33;3;30;.909;3675000;0
43739;169438;1422;49;27;4;23;.852;3675000;0
43739;185124;1426;0;0;0;0;.00nan;0;0
43739;157903;1422;0;0;0;0;.00nan;0;0
43741;2037;1425;0;0;0;0;.00nan;0;0
43741;211293;1430;0;0;0;0;.00nan;0;0
43741;176926;1430;39;28;5;23;.821;3900000;0
43741;64230;1425;49;34;5;29;.853;3900000;0
43743;182561;1426;0;0;0;0;.00nan;0;0
43743;200849;1440;74;29;2;27;.931;3600000;0
43743;185124;1426;39;31;5;26;.839;3600000;0
43743;185136;1440;0;0;0;0;.00nan;0;0
43745;10112;1453;64;45;6;39;.867;2908000;0
43745;165030;1453;63;11;0;11;1.000;692000;0
43745;174312;1443;51;11;1;10;.909;3600000;0
43745;72439;1443;0;0;0;0;.00nan;0;0
43747;-1;4961;91;16;0;16;1.000;3600000;0
43747;211293;1430;59;48;5;43;.896;3600000;0
43747;195618;4961;0;0;0;0;.00nan;0;0
43747;176926;1430;0;0;0;0;.00nan;0;0
43749;169438;1422;55;12;1;11;.917;2652000;0
43749;148391;4742;48;42;6;36;.857;2032000;0
43749;157845;4742;60;22;2;20;.909;1568000;0
43749;157903;1422;18;8;4;4;.500;948000;0
43751;2037;1425;23;25;6;19;.760;3600000;0
43751;4127;1429;0;0;0;0;.00nan;0;0
43751;-1;1429;87;27;1;26;.963;3600000;0
43751;64230;1425;0;0;0;0;.00nan;0;0
1905;182561;1426;47;46;7;39;.848;3600000;0
1905;174312;1443;0;0;0;0;.00nan;0;0
1905;185124;1426;0;0;0;0;.00nan;0;0
1905;72439;1443;68;7;0;7;1.000;3600000;0
1906;4127;1429;36;25;5;20;.800;3580000;0
1906;211293;1430;0;0;0;0;.00nan;0;0
1906;176926;1430;50;29;4;25;.862;3600000;0
1906;-1;1429;0;0;0;0;.00nan;0;0
1907;2037;1425;0;0;0;0;.00nan;0;0
1907;10112;1453;79;26;1;25;.962;2955000;0
1907;165030;1453;9;9;5;4;.444;645000;0
1907;64230;1425;52;15;2;13;.867;3600000;0
1908;1765;1427;0;0;0;0;.00nan;0;0
1908;9524;1422;78;31;2;29;.935;3600000;0
1908;169438;1427;43;32;5;27;.844;3600000;0
1908;157903;1422;0;0;0;0;.00nan;0;0
1937;174312;1443;0;0;0;0;.00nan;0;0
1937;211293;1430;0;0;0;0;.00nan;0;0
1937;176926;1430;74;50;5;45;.900;3600000;0
1937;72439;1443;45;10;2;8;.800;3600000;0
1938;2037;1425;70;20;1;19;.950;3046000;0
1938;9524;1422;87;40;2;38;.950;3600000;0
1938;64230;1425;22;4;3;1;.250;505000;0
1938;157903;1422;0;0;0;0;.00nan;0;0
1972;9524;1422;37;29;6;23;.793;2400000;0
1972;174312;1443;0;0;0;0;.00nan;0;0
1972;72439;1443;86;18;0;18;1.000;3600000;0
1972;157903;1422;54;20;3;17;.850;1200000;0
